Timestamp,NAnimals,NResources,NFemales,NMales,MeanLifeSuccess,MeanAge,%MatingAccept
2024-12-08 14:52:44,100,0,43,57,0.00,0.00,0.00
2024-12-08 14:52:44,100,0,43,57,0.00,0.00,0.00
2024-12-08 14:52:44,100,1,43,57,0.99,1.00,0.00
2024-12-08 14:52:46,100,2,43,57,1.96,2.00,0.00
2024-12-08 14:52:46,100,3,43,57,2.91,3.00,0.00
2024-12-08 14:52:46,100,4,43,57,3.84,4.00,0.00
2024-12-08 14:52:46,100,5,43,57,4.75,5.00,0.00
2024-12-08 14:52:46,100,6,43,57,5.64,6.00,0.00
2024-12-08 14:52:46,100,7,43,57,6.51,7.00,0.00
2024-12-08 14:52:46,100,8,43,57,7.36,8.00,0.00
2024-12-08 14:52:46,100,9,43,57,8.19,9.00,0.00
2024-12-08 14:52:46,100,10,43,57,9.00,10.00,0.00
2024-12-08 14:52:46,101,10,44,57,8.91,10.01,0.00
2024-12-08 14:52:46,101,11,44,57,9.65,11.00,0.00
2024-12-08 14:52:46,102,11,45,57,9.56,11.01,0.00
2024-12-08 14:52:46,102,12,45,57,10.35,12.00,0.00
2024-12-08 14:52:46,103,12,46,57,10.25,12.01,0.00
2024-12-08 14:52:46,103,13,46,57,11.03,13.00,0.00
2024-12-08 14:52:46,104,13,47,57,10.92,13.01,0.00
2024-12-08 14:52:46,104,14,47,57,11.68,14.00,0.00
2024-12-08 14:52:46,105,14,48,57,11.57,14.01,0.00
2024-12-08 14:52:46,104,14,48,56,11.83,14.24,0.00
2024-12-08 14:52:46,104,15,48,56,12.44,15.00,0.00
2024-12-08 14:52:46,105,15,49,56,12.32,15.01,0.00
2024-12-08 14:52:46,105,16,49,56,13.08,16.00,0.00
2024-12-08 14:52:46,106,16,49,57,12.96,16.01,0.00
2024-12-08 14:52:47,106,17,49,57,13.67,17.00,0.00
2024-12-08 14:52:47,107,17,49,58,13.54,17.01,0.00
2024-12-08 14:52:47,106,17,48,58,13.93,17.49,0.00
2024-12-08 14:52:47,106,18,48,58,14.41,18.00,0.00
2024-12-08 14:52:47,107,18,48,59,14.28,18.01,0.00
2024-12-08 14:52:47,107,19,48,59,15.00,19.00,0.00
2024-12-08 14:52:47,108,19,48,60,14.86,19.01,0.00
2024-12-08 14:52:47,108,20,48,60,15.51,20.00,0.00
2024-12-08 14:52:47,109,20,49,60,15.37,20.01,0.00
2024-12-08 14:52:47,108,20,48,60,15.53,20.18,0.00
2024-12-08 14:52:47,108,21,48,60,16.19,21.00,0.00
2024-12-08 14:52:47,109,21,48,61,16.04,21.01,0.00
2024-12-08 14:52:47,108,21,48,60,16.20,21.09,0.00
2024-12-08 14:52:47,108,22,48,60,16.83,22.00,0.00
2024-12-08 14:52:47,109,22,49,60,16.68,22.01,0.00
2024-12-08 14:52:47,108,22,49,59,16.97,22.33,0.00
2024-12-08 14:52:47,108,23,49,59,17.46,23.00,0.00
2024-12-08 14:52:47,109,23,50,59,17.30,23.01,0.00
2024-12-08 14:52:47,109,24,50,59,17.95,24.00,0.00
2024-12-08 14:52:47,110,24,50,60,17.78,24.01,0.00
2024-12-08 14:52:47,110,25,50,60,18.37,25.00,0.00
2024-12-08 14:52:47,111,25,50,61,18.20,25.01,0.00
2024-12-08 14:52:47,111,26,50,61,18.77,26.00,0.00
2024-12-08 14:52:47,112,26,51,61,18.60,26.01,0.00
2024-12-08 14:52:47,111,26,51,60,18.95,26.46,0.00
2024-12-08 14:52:47,110,26,50,60,19.32,26.98,0.00
2024-12-08 14:52:47,110,27,50,60,19.57,27.00,0.00
2024-12-08 14:52:47,111,27,50,61,19.39,27.01,0.00
2024-12-08 14:52:47,111,28,50,61,19.98,28.00,0.00
2024-12-08 14:52:47,112,28,51,61,19.81,28.01,0.00
2024-12-08 14:52:47,112,29,51,61,20.33,29.00,0.00
2024-12-08 14:52:47,113,29,52,61,20.15,29.01,0.00
2024-12-08 14:52:47,113,30,52,61,20.65,30.00,0.00
2024-12-08 14:52:47,114,30,53,61,20.47,30.01,0.00
2024-12-08 14:52:47,113,30,52,61,20.86,30.84,0.00
2024-12-08 14:52:48,113,31,52,61,21.20,31.00,0.00
2024-12-08 14:52:48,114,31,52,62,21.02,31.01,0.00
2024-12-08 14:52:48,113,31,51,62,21.43,31.84,0.00
2024-12-08 14:52:48,113,32,51,62,21.68,32.00,0.00
2024-12-08 14:52:48,114,32,51,63,21.49,32.01,0.00
2024-12-08 14:52:48,114,33,51,63,21.95,33.00,0.00
2024-12-08 14:52:48,115,33,51,64,21.76,33.01,0.00
2024-12-08 14:52:48,114,33,51,63,21.96,33.09,0.00
2024-12-08 14:52:48,113,33,50,63,22.40,33.98,0.00
2024-12-08 14:52:48,113,34,50,63,22.70,34.00,0.00
2024-12-08 14:52:48,114,34,50,64,22.50,34.01,0.00
2024-12-08 14:52:48,113,34,50,63,22.87,34.61,0.00
2024-12-08 14:52:48,113,35,50,63,23.19,35.00,0.00
2024-12-08 14:52:48,114,35,50,64,22.99,35.01,0.00
2024-12-08 14:52:48,114,36,50,64,23.47,36.00,0.00
2024-12-08 14:52:48,115,36,51,64,23.27,36.01,0.00
2024-12-08 14:52:48,115,37,51,64,23.74,37.00,0.00
2024-12-08 14:52:48,116,37,52,64,23.54,37.01,0.00
2024-12-08 14:52:48,116,38,52,64,23.93,38.00,0.00
2024-12-08 14:52:48,117,38,52,65,23.72,38.01,0.00
2024-12-08 14:52:48,117,39,52,65,24.09,39.00,0.00
2024-12-08 14:52:48,118,39,52,66,23.89,39.01,0.00
2024-12-08 14:52:48,117,39,52,65,24.13,39.23,0.00
2024-12-08 14:52:48,117,40,52,65,24.52,40.00,0.00
2024-12-08 14:52:48,118,40,53,65,24.31,40.01,0.00
2024-12-08 14:52:48,118,41,53,65,24.71,41.00,0.00
2024-12-08 14:52:48,119,41,54,65,24.51,41.01,0.00
2024-12-08 14:52:48,118,41,53,65,24.62,41.27,0.00
2024-12-08 14:52:48,117,41,52,65,24.83,41.73,0.00
2024-12-08 14:52:48,117,42,52,65,25.27,42.00,0.00
2024-12-08 14:52:48,118,42,52,66,25.05,42.01,0.00
2024-12-08 14:52:48,117,42,52,65,25.28,42.59,0.00
2024-12-08 14:52:48,117,43,52,65,25.59,43.00,0.00
2024-12-08 14:52:48,118,43,52,66,25.38,43.01,0.00
2024-12-08 14:52:48,117,43,51,66,25.48,43.12,0.00
2024-12-08 14:52:48,117,44,51,66,25.92,44.00,0.00
2024-12-08 14:52:48,118,44,51,67,25.70,44.01,0.00
2024-12-08 14:52:48,118,45,51,67,26.10,45.00,0.00
2024-12-08 14:52:48,119,45,51,68,25.88,45.01,0.00
2024-12-08 14:52:48,118,45,50,68,26.09,45.77,0.00
2024-12-08 14:52:49,118,46,50,68,26.46,46.00,0.00
2024-12-08 14:52:49,119,46,51,68,26.24,46.01,0.00
2024-12-08 14:52:49,119,47,51,68,26.50,47.00,0.00
2024-12-08 14:52:49,120,47,52,68,26.28,47.01,0.00
2024-12-08 14:52:49,119,47,52,67,26.49,47.76,0.00
2024-12-08 14:52:49,119,48,52,67,26.79,48.00,0.00
2024-12-08 14:52:49,120,48,52,68,26.56,48.01,0.00
2024-12-08 14:52:49,120,49,52,68,26.92,49.00,0.00
2024-12-08 14:52:49,121,49,53,68,26.69,49.01,0.00
2024-12-08 14:52:49,121,50,53,68,26.96,50.00,0.00
2024-12-08 14:52:49,122,50,54,68,26.74,50.01,0.00
2024-12-08 14:52:49,122,51,54,68,27.01,51.00,0.00
2024-12-08 14:52:49,123,51,54,69,26.79,51.01,0.00
2024-12-08 14:52:49,123,52,54,69,26.96,52.00,0.00
2024-12-08 14:52:49,124,52,55,69,26.75,52.01,0.00
2024-12-08 14:52:49,123,52,55,68,26.89,52.70,0.00
2024-12-08 14:52:49,123,53,55,68,27.18,53.00,0.00
2024-12-08 14:52:49,124,53,55,69,26.96,53.01,0.00
2024-12-08 14:52:49,123,53,54,69,26.89,53.77,0.00
2024-12-08 14:52:49,123,54,54,69,27.37,54.00,0.00
2024-12-08 14:52:49,124,54,54,70,27.14,54.01,0.00
2024-12-08 14:52:49,123,54,54,69,27.27,54.73,0.00
2024-12-08 14:52:49,123,55,54,69,27.58,55.00,0.00
2024-12-08 14:52:49,124,55,55,69,27.35,55.01,0.00
2024-12-08 14:52:49,124,56,55,69,27.61,56.00,0.00
2024-12-08 14:52:49,125,56,56,69,27.39,56.01,0.00
2024-12-08 14:52:49,125,57,56,69,27.55,57.00,0.00
2024-12-08 14:52:49,126,57,56,70,27.34,57.01,0.00
2024-12-08 14:52:49,125,57,55,70,27.34,57.85,0.00
2024-12-08 14:52:49,125,58,55,70,27.64,58.00,0.00
2024-12-08 14:52:49,126,58,55,71,27.42,58.01,0.00
2024-12-08 14:52:49,125,58,55,70,27.51,58.72,0.00
2024-12-08 14:52:49,125,59,55,70,27.81,59.00,0.00
2024-12-08 14:52:49,126,59,55,71,27.59,59.01,0.00
2024-12-08 14:52:49,125,59,55,70,27.70,59.58,0.00
2024-12-08 14:52:49,125,60,55,70,28.01,60.00,0.00
2024-12-08 14:52:49,126,60,55,71,27.79,60.01,0.00
2024-12-08 14:52:49,125,60,54,71,27.75,60.98,0.00
2024-12-08 14:52:49,125,61,54,71,28.24,61.00,0.00
2024-12-08 14:52:50,126,61,54,72,28.01,61.01,0.00
2024-12-08 14:52:50,125,61,54,71,27.98,61.71,0.00
2024-12-08 14:52:50,125,62,54,71,28.29,62.00,0.00
2024-12-08 14:52:50,126,62,54,72,28.07,62.01,0.00
2024-12-08 14:52:50,125,62,53,72,28.07,62.71,0.00
2024-12-08 14:52:50,125,63,53,72,28.49,63.00,0.00
2024-12-08 14:52:50,126,63,53,73,28.26,63.01,0.00
2024-12-08 14:52:50,126,64,53,73,28.35,64.00,0.00
2024-12-08 14:52:50,127,64,54,73,28.13,64.01,0.00
2024-12-08 14:52:50,126,64,54,72,28.05,64.71,0.00
2024-12-08 14:52:50,125,64,53,72,28.27,64.94,0.00
2024-12-08 14:52:50,125,65,53,72,28.80,65.00,0.00
2024-12-08 14:52:50,126,65,53,73,28.58,65.01,0.00
2024-12-08 14:52:50,126,66,53,73,28.72,66.00,0.00
2024-12-08 14:52:50,127,66,54,73,28.49,66.01,0.00
2024-12-08 14:52:50,127,67,54,73,28.56,67.00,0.00
2024-12-08 14:52:50,128,67,55,73,28.33,67.01,0.00
2024-12-08 14:52:50,127,67,55,72,28.21,67.70,0.00
2024-12-08 14:52:50,126,67,54,72,28.43,67.71,0.00
2024-12-08 14:52:50,126,68,54,72,28.76,68.00,0.00
2024-12-08 14:52:50,127,68,54,73,28.53,68.01,0.00
2024-12-08 14:52:50,127,69,54,73,28.64,69.00,0.00
2024-12-08 14:52:50,128,69,55,73,28.42,69.01,0.00
2024-12-08 14:52:50,128,70,55,73,28.44,70.00,0.00
2024-12-08 14:52:50,129,70,55,74,28.22,70.01,0.00
2024-12-08 14:52:50,128,70,55,73,28.07,70.70,0.00
2024-12-08 14:52:50,127,70,54,73,28.26,70.87,0.00
2024-12-08 14:52:50,127,71,54,73,28.61,71.00,0.00
2024-12-08 14:52:50,128,71,54,74,28.39,71.01,0.00
2024-12-08 14:52:50,128,72,54,74,28.46,72.00,0.00
2024-12-08 14:52:50,129,72,55,74,28.24,72.01,0.00
2024-12-08 14:52:50,128,72,54,74,28.15,72.67,0.00
2024-12-08 14:52:50,127,72,53,74,28.15,72.70,0.00
2024-12-08 14:52:50,127,73,53,74,28.71,73.00,0.00
2024-12-08 14:52:50,128,73,53,75,28.49,73.01,0.00
2024-12-08 14:52:50,127,73,53,74,28.30,73.69,0.00
2024-12-08 14:52:50,127,74,53,74,28.64,74.00,0.00
2024-12-08 14:52:50,128,74,53,75,28.41,74.01,0.00
2024-12-08 14:52:50,127,74,52,75,28.28,74.63,0.00
2024-12-08 14:52:50,127,75,52,75,28.70,75.00,0.00
2024-12-08 14:52:50,128,75,52,76,28.48,75.01,0.00
2024-12-08 14:52:50,127,75,51,76,28.34,75.69,0.00
2024-12-08 14:52:50,127,76,51,76,28.79,76.00,0.00
2024-12-08 14:52:50,128,76,52,76,28.57,76.01,0.00
2024-12-08 14:52:50,128,77,52,76,28.55,77.00,0.00
2024-12-08 14:52:50,129,77,53,76,28.32,77.01,0.00
2024-12-08 14:52:50,128,77,53,75,28.06,77.70,0.00
2024-12-08 14:52:50,128,78,53,75,28.43,78.00,0.00
2024-12-08 14:52:50,129,78,53,76,28.21,78.01,0.00
2024-12-08 14:52:50,129,79,53,76,28.21,79.00,0.00
2024-12-08 14:52:50,130,79,53,77,28.00,79.01,0.00
2024-12-08 14:52:50,129,79,52,77,27.95,79.45,0.00
2024-12-08 14:52:50,128,79,51,77,27.99,79.70,0.00
2024-12-08 14:52:50,128,80,51,77,28.45,80.00,0.00
2024-12-08 14:52:50,129,80,51,78,28.23,80.01,0.00
2024-12-08 14:52:51,129,81,51,78,28.22,81.00,0.00
2024-12-08 14:52:51,130,81,51,79,28.00,81.01,0.00
2024-12-08 14:52:51,129,81,50,79,27.72,81.72,0.00
2024-12-08 14:52:51,129,82,50,79,28.19,82.00,0.00
2024-12-08 14:52:51,130,82,51,79,27.98,82.01,0.00
2024-12-08 14:52:51,129,82,50,79,27.91,82.44,0.00
2024-12-08 14:52:51,128,82,50,78,27.64,82.72,0.00
2024-12-08 14:52:51,128,83,50,78,28.26,83.00,0.00
2024-12-08 14:52:51,129,83,50,79,28.04,83.01,0.00
2024-12-08 14:52:51,129,84,50,79,28.00,84.00,0.00
2024-12-08 14:52:51,130,84,50,80,27.78,84.01,0.00
2024-12-08 14:52:51,130,85,50,80,27.72,85.00,0.00
2024-12-08 14:52:51,131,85,51,80,27.51,85.01,0.00
2024-12-08 14:52:51,130,85,50,80,27.64,85.08,0.00
2024-12-08 14:52:51,130,86,50,80,27.70,86.00,0.00
2024-12-08 14:52:51,131,86,51,80,27.48,86.01,0.00
2024-12-08 14:52:51,130,86,51,79,27.13,86.68,0.00
2024-12-08 14:52:51,130,87,51,79,27.52,87.00,0.00
2024-12-08 14:52:51,131,87,51,80,27.31,87.01,0.00
2024-12-08 14:52:51,130,87,51,79,26.94,87.68,0.00
2024-12-08 14:52:51,130,88,51,79,27.33,88.00,0.00
2024-12-08 14:52:51,131,88,51,80,27.12,88.01,0.00
2024-12-08 14:52:51,131,89,51,80,26.97,89.00,0.00
2024-12-08 14:52:51,132,89,52,80,26.77,89.01,0.00
2024-12-08 14:52:51,131,89,52,79,26.34,89.69,0.00
2024-12-08 14:52:51,131,90,52,79,26.76,90.00,0.00
2024-12-08 14:52:51,132,90,53,79,26.56,90.01,0.00
2024-12-08 14:52:51,132,91,53,79,26.43,91.00,0.00
2024-12-08 14:52:51,133,91,53,80,26.23,91.01,0.00
2024-12-08 14:52:51,132,91,52,80,25.66,91.71,0.00
2024-12-08 14:52:51,131,91,51,80,25.83,91.82,0.00
2024-12-08 14:52:51,131,92,51,80,26.51,92.00,0.00
2024-12-08 14:52:51,132,92,51,81,26.30,92.01,0.00
2024-12-08 14:52:51,131,92,51,80,25.85,92.69,0.00
2024-12-08 14:52:51,130,92,50,80,26.04,92.70,0.00
2024-12-08 14:52:51,130,93,50,80,26.48,93.00,0.00
2024-12-08 14:52:51,131,93,51,80,26.28,93.01,0.00
2024-12-08 14:52:51,131,94,51,80,26.13,94.00,0.00
2024-12-08 14:52:51,132,94,51,81,25.93,94.01,0.00
2024-12-08 14:52:51,132,95,51,81,25.72,95.00,0.00
2024-12-08 14:52:51,133,95,52,81,25.53,95.01,0.00
2024-12-08 14:52:51,132,95,52,80,25.02,95.69,0.00
2024-12-08 14:52:51,132,96,52,80,25.46,96.00,0.00
2024-12-08 14:52:51,133,96,52,81,25.27,96.01,0.00
2024-12-08 14:52:51,133,97,52,81,25.08,97.00,0.00
2024-12-08 14:52:51,134,97,52,82,24.89,97.01,0.00
2024-12-08 14:52:51,134,98,52,82,24.65,98.00,0.00
2024-12-08 14:52:51,135,98,53,82,24.47,98.01,0.00
2024-12-08 14:52:51,134,98,53,81,23.89,98.69,0.00
2024-12-08 14:52:51,134,99,53,81,24.35,99.00,0.00
2024-12-08 14:52:51,135,99,53,82,24.17,99.01,0.00
2024-12-08 14:52:51,134,99,52,82,24.35,99.01,0.00
2024-12-08 14:52:51,133,99,51,82,24.52,99.01,0.00
2024-12-08 14:52:51,132,99,50,82,24.70,99.01,0.00
2024-12-08 14:52:51,131,99,49,82,24.88,99.01,0.00
2024-12-08 14:52:51,130,99,48,82,25.07,99.01,0.00
2024-12-08 14:52:51,129,99,48,81,25.25,99.01,0.00
2024-12-08 14:52:51,128,99,47,81,25.44,99.01,0.00
2024-12-08 14:52:51,127,99,46,81,25.63,99.01,0.00
2024-12-08 14:52:51,126,99,46,80,25.83,99.01,0.00
2024-12-08 14:52:51,125,99,46,79,26.03,99.01,0.00
2024-12-08 14:52:51,124,99,46,78,26.23,99.01,0.00
2024-12-08 14:52:51,123,99,46,77,26.44,99.01,0.00
2024-12-08 14:52:51,122,99,46,76,26.64,99.01,0.00
2024-12-08 14:52:51,121,99,45,76,26.86,99.01,0.00
2024-12-08 14:52:51,120,99,44,76,27.07,99.01,0.00
2024-12-08 14:52:51,119,99,44,75,27.29,99.01,0.00
2024-12-08 14:52:51,118,99,43,75,27.51,99.01,0.00
2024-12-08 14:52:51,117,99,43,74,27.74,99.01,0.00
2024-12-08 14:52:51,116,99,43,73,27.97,99.01,0.00
2024-12-08 14:52:51,115,99,43,72,28.21,99.01,0.00
2024-12-08 14:52:51,114,99,43,71,28.44,99.01,0.00
2024-12-08 14:52:51,113,99,43,70,28.69,99.01,0.00
2024-12-08 14:52:51,112,99,42,70,28.93,99.01,0.00
2024-12-08 14:52:51,111,99,41,70,29.19,99.01,0.00
2024-12-08 14:52:51,110,99,41,69,29.44,99.01,0.00
2024-12-08 14:52:51,109,99,41,68,29.70,99.01,0.00
2024-12-08 14:52:51,108,99,41,67,29.97,99.01,0.00
2024-12-08 14:52:51,107,99,41,66,30.24,99.01,0.00
2024-12-08 14:52:51,106,99,41,65,30.52,99.01,0.00
2024-12-08 14:52:51,105,99,41,64,30.80,99.01,0.00
2024-12-08 14:52:51,104,99,41,63,31.08,99.01,0.00
2024-12-08 14:52:51,103,99,41,62,31.38,99.01,0.00
2024-12-08 14:52:52,102,99,40,62,31.67,99.01,0.00
2024-12-08 14:52:52,101,99,39,62,31.98,99.01,0.00
2024-12-08 14:52:52,100,99,38,62,32.29,99.01,0.00
2024-12-08 14:52:52,99,99,38,61,32.60,99.01,0.00
2024-12-08 14:52:52,98,99,37,61,32.93,99.01,0.00
2024-12-08 14:52:52,97,99,37,60,33.26,99.01,0.00
2024-12-08 14:52:52,96,99,37,59,33.59,99.01,0.00
2024-12-08 14:52:52,95,99,36,59,33.94,99.01,0.00
2024-12-08 14:52:52,94,99,36,58,34.29,99.01,0.00
2024-12-08 14:52:52,93,99,35,58,34.64,99.01,0.00
2024-12-08 14:52:52,92,99,35,57,35.01,99.01,0.00
2024-12-08 14:52:52,91,99,35,56,35.38,99.01,0.00
2024-12-08 14:52:52,90,99,34,56,35.77,99.01,0.00
2024-12-08 14:52:52,89,99,34,55,36.16,99.01,0.00
2024-12-08 14:52:52,88,99,33,55,36.56,99.01,0.00
2024-12-08 14:52:52,87,99,33,54,36.97,99.01,0.00
2024-12-08 14:52:52,86,99,32,54,37.38,99.01,0.00
2024-12-08 14:52:52,85,99,32,53,37.81,99.01,0.00
2024-12-08 14:52:52,84,99,31,53,38.25,99.01,0.00
2024-12-08 14:52:52,83,99,30,53,38.70,99.01,0.00
2024-12-08 14:52:52,82,99,30,52,39.16,99.01,0.00
2024-12-08 14:52:52,81,99,29,52,39.63,99.01,0.00
2024-12-08 14:52:52,80,99,29,51,40.11,99.01,0.00
2024-12-08 14:52:52,79,99,29,50,40.61,99.01,0.00
2024-12-08 14:52:52,78,99,28,50,41.12,99.01,0.00
2024-12-08 14:52:52,77,99,27,50,41.64,99.01,0.00
2024-12-08 14:52:52,76,99,27,49,42.17,99.01,0.00
2024-12-08 14:52:52,75,99,26,49,42.72,99.01,0.00
2024-12-08 14:52:52,74,99,25,49,43.29,99.01,0.00
2024-12-08 14:52:52,73,99,25,48,43.86,99.01,0.00
2024-12-08 14:52:52,72,99,25,47,44.46,99.01,0.00
2024-12-08 14:52:52,71,99,24,47,45.07,99.01,0.00
2024-12-08 14:52:52,70,99,23,47,45.70,99.01,0.00
2024-12-08 14:52:52,69,99,22,47,46.35,99.01,0.00
2024-12-08 14:52:52,68,99,22,46,47.02,99.01,0.00
2024-12-08 14:52:52,67,99,22,45,47.70,99.01,0.00
2024-12-08 14:52:52,66,99,22,44,48.41,99.02,0.00
2024-12-08 14:52:52,65,99,21,44,49.14,99.02,0.00
2024-12-08 14:52:52,64,99,21,43,49.89,99.02,0.00
2024-12-08 14:52:52,63,99,21,42,50.67,99.02,0.00
2024-12-08 14:52:52,62,99,21,41,51.47,99.02,0.00
2024-12-08 14:52:52,61,99,21,40,52.30,99.02,0.00
2024-12-08 14:52:52,60,99,21,39,53.15,99.02,0.00
2024-12-08 14:52:52,59,99,21,38,54.04,99.02,0.00
2024-12-08 14:52:52,58,99,21,37,54.95,99.02,0.00
2024-12-08 14:52:52,57,99,21,36,55.90,99.02,0.00
2024-12-08 14:52:52,56,99,20,36,56.88,99.02,0.00
2024-12-08 14:52:52,55,99,20,35,57.90,99.02,0.00
2024-12-08 14:52:52,54,99,19,35,58.95,99.02,0.00
2024-12-08 14:52:52,54,100,19,35,59.85,100.00,0.00
2024-12-08 14:52:52,55,100,19,36,58.77,100.02,0.00
2024-12-08 14:52:52,54,100,18,36,58.45,100.93,0.00
2024-12-08 14:52:52,54,101,18,36,60.30,101.00,0.00
2024-12-08 14:52:52,55,101,19,36,59.20,101.02,0.00
2024-12-08 14:52:52,54,101,19,35,59.89,101.22,0.00
2024-12-08 14:52:52,54,102,19,35,60.76,102.00,0.00
2024-12-08 14:52:52,55,102,19,36,59.66,102.02,0.00
2024-12-08 14:52:52,55,103,19,36,60.32,103.00,0.00
2024-12-08 14:52:52,56,103,19,37,59.25,103.02,0.00
2024-12-08 14:52:52,56,104,19,37,59.63,104.00,0.00
2024-12-08 14:52:52,57,104,20,37,58.59,104.02,0.00
2024-12-08 14:52:52,56,104,20,36,59.22,104.21,0.00
2024-12-08 14:52:52,55,104,19,36,60.16,104.33,0.00
2024-12-08 14:52:52,55,105,19,36,61.83,105.00,0.00
2024-12-08 14:52:52,56,105,20,36,60.73,105.02,0.00
2024-12-08 14:52:52,56,106,20,36,61.36,106.00,0.00
2024-12-08 14:52:52,57,106,21,36,60.28,106.02,0.00
2024-12-08 14:52:52,56,106,20,36,60.55,106.75,0.00
2024-12-08 14:52:52,56,107,20,36,61.71,107.00,0.00
2024-12-08 14:52:52,57,107,20,37,60.63,107.02,0.00
2024-12-08 14:52:52,56,107,19,37,61.58,107.16,0.00
2024-12-08 14:52:52,55,107,19,36,62.45,107.20,0.00
2024-12-08 14:52:52,55,108,19,36,63.30,108.00,0.00
2024-12-08 14:52:52,56,108,20,36,62.17,108.02,0.00
2024-12-08 14:52:52,56,109,20,36,62.77,109.00,0.00
2024-12-08 14:52:52,57,109,21,36,61.67,109.02,0.00
2024-12-08 14:52:52,57,110,21,36,61.96,110.00,0.00
2024-12-08 14:52:52,58,110,22,36,60.90,110.02,0.00
2024-12-08 14:52:52,57,110,22,35,61.61,110.19,0.00
2024-12-08 14:52:52,57,111,22,35,62.41,111.00,0.00
2024-12-08 14:52:52,58,111,22,36,61.34,111.02,0.00
2024-12-08 14:52:52,57,111,22,35,62.35,111.05,0.00
2024-12-08 14:52:52,56,111,21,35,63.41,111.11,0.00
2024-12-08 14:52:52,56,112,21,35,64.10,112.00,0.00
2024-12-08 14:52:52,57,112,21,36,62.97,112.02,0.00
2024-12-08 14:52:52,56,112,20,36,62.47,112.95,0.00
2024-12-08 14:52:52,56,113,20,36,64.46,113.00,0.00
2024-12-08 14:52:52,57,113,20,37,63.33,113.02,0.00
2024-12-08 14:52:52,56,113,19,37,64.44,113.02,0.00
2024-12-08 14:52:52,55,113,19,36,65.33,113.15,0.00
2024-12-08 14:52:52,55,114,19,36,66.15,114.00,0.00
2024-12-08 14:52:52,56,114,20,36,64.97,114.02,0.00
2024-12-08 14:52:52,55,114,19,36,66.13,114.02,0.00
2024-12-08 14:52:52,54,114,18,36,66.72,114.30,0.00
2024-12-08 14:52:52,53,114,17,36,67.42,114.89,0.00
2024-12-08 14:52:52,53,115,17,36,69.55,115.00,0.00
2024-12-08 14:52:52,54,115,18,36,68.26,115.02,0.00
2024-12-08 14:52:52,54,116,18,36,68.57,116.00,0.00
2024-12-08 14:52:52,55,116,18,37,67.33,116.02,0.00
2024-12-08 14:52:52,54,116,18,36,68.34,116.13,0.00
2024-12-08 14:52:52,54,117,18,36,69.19,117.00,0.00
2024-12-08 14:52:52,55,117,18,37,67.93,117.02,0.00
2024-12-08 14:52:52,55,118,18,37,68.43,118.00,0.00
2024-12-08 14:52:52,56,118,19,37,67.21,118.02,0.00
2024-12-08 14:52:52,55,118,18,37,67.27,118.80,0.00
2024-12-08 14:52:52,55,119,18,37,69.34,119.00,0.00
2024-12-08 14:52:52,56,119,19,37,68.10,119.02,0.00
2024-12-08 14:52:52,55,119,19,36,69.14,119.13,0.00
2024-12-08 14:52:52,55,120,19,36,69.96,120.00,0.00
2024-12-08 14:52:52,56,120,19,37,68.71,120.02,0.00
2024-12-08 14:52:52,55,120,18,37,69.17,120.47,0.00
2024-12-08 14:52:52,55,121,18,37,70.45,121.00,0.00
2024-12-08 14:52:52,56,121,19,37,69.19,121.02,0.00
2024-12-08 14:52:52,55,121,18,37,68.89,121.91,0.00
2024-12-08 14:52:53,55,122,18,37,71.06,122.00,0.00
2024-12-08 14:52:53,56,122,18,38,69.79,122.02,0.00
2024-12-08 14:52:53,55,122,18,37,70.90,122.13,0.00
2024-12-08 14:52:53,55,123,18,37,71.73,123.00,0.00
2024-12-08 14:52:53,56,123,18,38,70.45,123.02,0.00
2024-12-08 14:52:53,56,124,18,38,70.88,124.00,0.00
2024-12-08 14:52:53,57,124,19,38,69.64,124.02,0.00
2024-12-08 14:52:53,56,124,18,38,70.02,124.14,0.00
2024-12-08 14:52:53,56,125,18,38,71.73,125.00,0.00
2024-12-08 14:52:53,57,125,18,39,70.47,125.02,0.00
2024-12-08 14:52:53,56,125,18,38,71.59,125.13,0.00
2024-12-08 14:52:53,56,126,18,38,72.39,126.00,0.00
2024-12-08 14:52:53,57,126,19,38,71.12,126.02,0.00
2024-12-08 14:52:53,57,127,19,38,71.54,127.00,0.00
2024-12-08 14:52:53,58,127,19,39,70.31,127.02,0.00
2024-12-08 14:52:53,58,128,19,39,70.49,128.00,0.00
2024-12-08 14:52:53,59,128,19,40,69.30,128.02,0.00
2024-12-08 14:52:53,58,128,19,39,70.35,128.12,0.00
2024-12-08 14:52:53,58,129,19,39,71.08,129.00,0.00
2024-12-08 14:52:53,59,129,19,40,69.88,129.02,0.00
2024-12-08 14:52:53,58,129,18,40,69.53,129.97,0.00
2024-12-08 14:52:53,58,130,18,40,71.75,130.00,0.00
2024-12-08 14:52:53,59,130,18,41,70.53,130.02,0.00
2024-12-08 14:52:53,58,130,17,41,71.62,130.12,0.00
2024-12-08 14:52:53,57,130,17,40,72.40,130.12,0.00
2024-12-08 14:52:53,56,130,16,40,72.57,130.93,0.00
2024-12-08 14:52:53,56,131,16,40,74.87,131.00,0.00
2024-12-08 14:52:53,57,131,17,40,73.55,131.02,0.00
2024-12-08 14:52:53,57,132,17,40,73.95,132.00,0.00
2024-12-08 14:52:53,58,132,17,41,72.67,132.02,0.00
2024-12-08 14:52:53,57,132,17,40,73.92,132.02,0.00
2024-12-08 14:52:53,56,132,17,39,74.66,132.11,0.00
2024-12-08 14:52:53,56,133,17,39,75.46,133.00,0.00
2024-12-08 14:52:53,57,133,17,40,74.13,133.02,0.00
2024-12-08 14:52:53,56,133,17,39,75.43,133.02,0.00
2024-12-08 14:52:53,55,133,16,39,75.96,133.15,0.00
2024-12-08 14:52:53,55,134,16,39,77.79,134.00,0.00
2024-12-08 14:52:53,56,134,16,40,76.40,134.02,0.00
2024-12-08 14:52:53,55,134,16,39,77.22,134.09,0.00
2024-12-08 14:52:53,54,134,15,39,78.30,134.13,0.00
2024-12-08 14:52:53,54,135,15,39,80.18,135.00,0.00
2024-12-08 14:52:53,55,135,16,39,78.72,135.02,0.00
2024-12-08 14:52:53,54,135,16,38,80.16,135.02,0.00
2024-12-08 14:52:53,54,136,16,38,80.59,136.00,0.00
2024-12-08 14:52:53,55,136,16,39,79.12,136.02,0.00
2024-12-08 14:52:53,54,136,16,38,80.00,136.09,0.00
2024-12-08 14:52:53,54,137,16,38,80.85,137.00,0.00
2024-12-08 14:52:53,55,137,16,39,79.38,137.02,0.00
2024-12-08 14:52:53,55,138,16,39,79.79,138.00,0.00
2024-12-08 14:52:53,56,138,17,39,78.37,138.02,0.00
2024-12-08 14:52:53,55,138,17,38,79.18,138.09,0.00
2024-12-08 14:52:53,54,138,16,38,80.12,138.20,0.00
2024-12-08 14:52:53,54,139,16,38,82.11,139.00,0.00
2024-12-08 14:52:53,55,139,16,39,80.62,139.02,0.00
2024-12-08 14:52:53,55,140,16,39,81.02,140.00,0.00
2024-12-08 14:52:53,56,140,16,40,79.57,140.02,0.00
2024-12-08 14:52:53,55,140,16,39,80.42,140.09,0.00
2024-12-08 14:52:53,55,141,16,39,81.24,141.00,0.00
2024-12-08 14:52:53,56,141,17,39,79.79,141.02,0.00
2024-12-08 14:52:53,56,142,17,39,80.17,142.00,0.00
2024-12-08 14:52:53,57,142,18,39,78.76,142.02,0.00
2024-12-08 14:52:53,56,142,18,38,79.59,142.09,0.00
2024-12-08 14:52:53,56,143,18,38,80.37,143.00,0.00
2024-12-08 14:52:53,57,143,19,38,78.96,143.02,0.00
2024-12-08 14:52:53,56,143,19,37,80.35,143.02,0.00
2024-12-08 14:52:53,56,144,19,37,80.73,144.00,0.00
2024-12-08 14:52:53,57,144,20,37,79.32,144.02,0.00
2024-12-08 14:52:53,56,144,20,36,80.20,144.07,0.00
2024-12-08 14:52:53,56,145,20,36,80.96,145.00,0.00
2024-12-08 14:52:53,57,145,21,36,79.54,145.02,0.00
2024-12-08 14:52:53,57,146,21,36,79.89,146.00,0.00
2024-12-08 14:52:53,58,146,22,36,78.51,146.02,0.00
2024-12-08 14:52:53,57,146,22,35,79.33,146.09,0.00
2024-12-08 14:52:54,57,147,22,35,80.08,147.00,0.00
2024-12-08 14:52:54,58,147,22,36,78.70,147.02,0.00
2024-12-08 14:52:54,57,147,21,36,78.27,147.86,0.00
2024-12-08 14:52:54,57,148,21,36,80.75,148.00,0.00
2024-12-08 14:52:54,58,148,21,37,79.36,148.02,0.00
2024-12-08 14:52:54,57,148,20,37,79.80,148.14,0.00
2024-12-08 14:52:54,57,149,20,37,81.65,149.00,0.00
2024-12-08 14:52:54,58,149,21,37,80.24,149.02,0.00
2024-12-08 14:52:54,57,149,21,36,80.99,149.12,0.00
2024-12-08 14:52:54,57,150,21,36,81.78,150.00,0.00
2024-12-08 14:52:54,58,150,21,37,80.37,150.02,0.00
2024-12-08 14:52:54,57,150,20,37,81.69,150.07,0.00
2024-12-08 14:52:54,57,151,20,37,82.20,151.00,0.00
2024-12-08 14:52:54,58,151,21,37,80.78,151.02,0.00
2024-12-08 14:52:54,57,151,21,36,82.17,151.02,0.00
2024-12-08 14:52:54,56,151,21,35,82.98,151.09,0.00
2024-12-08 14:52:54,55,151,20,35,84.06,151.11,0.00
2024-12-08 14:52:54,55,152,20,35,86.00,152.00,0.00
2024-12-08 14:52:54,56,152,21,35,84.47,152.02,0.00
2024-12-08 14:52:54,55,152,20,35,85.98,152.02,0.00
2024-12-08 14:52:54,55,153,20,35,86.42,153.00,0.00
2024-12-08 14:52:54,56,153,20,36,84.88,153.02,0.00
2024-12-08 14:52:54,55,153,20,35,85.79,153.07,0.00
2024-12-08 14:52:54,54,153,19,35,85.92,153.89,0.00
2024-12-08 14:52:54,54,154,19,35,88.69,154.00,0.00
2024-12-08 14:52:54,55,154,19,36,87.08,154.02,0.00
2024-12-08 14:52:54,55,155,19,36,87.50,155.00,0.00
2024-12-08 14:52:54,56,155,19,37,85.94,155.02,0.00
2024-12-08 14:52:54,55,155,19,36,86.87,155.07,0.00
2024-12-08 14:52:54,55,156,19,36,87.67,156.00,0.00
2024-12-08 14:52:54,56,156,19,37,86.11,156.02,0.00
2024-12-08 14:52:54,55,156,18,37,85.47,156.93,0.00
2024-12-08 14:52:54,55,157,18,37,88.26,157.00,0.00
2024-12-08 14:52:54,56,157,18,38,86.69,157.02,0.00
2024-12-08 14:52:54,55,157,18,37,87.62,157.07,0.00
2024-12-08 14:52:54,55,158,18,37,88.42,158.00,0.00
2024-12-08 14:52:54,56,158,19,37,86.84,158.02,0.00
2024-12-08 14:52:54,55,158,18,37,87.56,158.15,0.00
2024-12-08 14:52:54,54,158,17,37,88.71,158.57,0.00
2024-12-08 14:52:54,54,159,17,37,91.29,159.00,0.00
2024-12-08 14:52:54,55,159,17,38,89.63,159.02,0.00
2024-12-08 14:52:54,54,159,17,37,90.65,159.07,0.00
2024-12-08 14:52:54,53,159,16,37,92.36,159.08,0.00
2024-12-08 14:52:54,53,160,16,37,93.27,160.00,0.00
2024-12-08 14:52:54,54,160,17,37,91.54,160.02,0.00
2024-12-08 14:52:54,54,161,17,37,91.96,161.00,0.00
2024-12-08 14:52:54,55,161,18,37,90.28,161.02,0.00
2024-12-08 14:52:54,54,161,18,36,91.31,161.07,0.00
2024-12-08 14:52:54,54,162,18,36,92.17,162.00,0.00
2024-12-08 14:52:54,55,162,19,36,90.49,162.02,0.00
2024-12-08 14:52:54,55,163,19,36,90.88,163.00,0.00
2024-12-08 14:52:54,56,163,20,36,89.25,163.02,0.00
2024-12-08 14:52:54,55,163,20,35,90.26,163.07,0.00
2024-12-08 14:52:54,55,164,20,35,91.08,164.00,0.00
2024-12-08 14:52:54,56,164,21,35,89.45,164.02,0.00
2024-12-08 14:52:54,55,164,21,34,91.02,164.04,0.00
2024-12-08 14:52:54,54,164,20,34,91.33,164.28,0.00
2024-12-08 14:52:54,54,165,20,34,93.67,165.00,0.00
2024-12-08 14:52:54,55,165,21,34,91.96,165.02,0.00
2024-12-08 14:52:54,54,165,21,33,93.06,165.06,0.00
2024-12-08 14:52:54,54,166,21,33,93.90,166.00,0.00
2024-12-08 14:52:54,55,166,21,34,92.19,166.02,0.00
2024-12-08 14:52:54,55,167,21,34,92.55,167.00,0.00
2024-12-08 14:52:54,56,167,21,35,90.89,167.02,0.00
2024-12-08 14:52:54,55,167,21,34,91.97,167.05,0.00
2024-12-08 14:52:54,55,168,21,34,92.77,168.00,0.00
2024-12-08 14:52:54,56,168,21,35,91.11,168.02,0.00
2024-12-08 14:52:54,55,168,20,35,91.38,168.27,0.00
2024-12-08 14:52:54,55,169,20,35,93.69,169.00,0.00
2024-12-08 14:52:54,56,169,20,36,92.01,169.02,0.00
2024-12-08 14:52:54,55,169,19,36,93.59,169.05,0.00
2024-12-08 14:52:54,54,169,19,35,94.73,169.06,0.00
2024-12-08 14:52:54,54,170,19,35,96.83,170.00,0.00
2024-12-08 14:52:54,55,170,20,35,95.07,170.02,0.00
2024-12-08 14:52:54,54,170,19,35,96.77,170.06,0.00
2024-12-08 14:52:54,54,171,19,35,97.31,171.00,0.00
2024-12-08 14:52:54,55,171,20,35,95.54,171.02,0.00
2024-12-08 14:52:54,54,171,20,34,96.56,171.07,0.00
2024-12-08 14:52:54,53,171,19,34,97.85,171.51,0.00
2024-12-08 14:52:54,53,172,19,34,99.30,172.00,0.00
2024-12-08 14:52:54,54,172,19,35,97.46,172.02,0.00
2024-12-08 14:52:54,53,172,18,35,98.41,172.11,0.00
2024-12-08 14:52:54,53,173,18,35,100.69,173.00,0.00
2024-12-08 14:52:54,54,173,18,36,98.82,173.02,0.00
2024-12-08 14:52:54,53,173,18,35,99.95,173.08,0.00
2024-12-08 14:52:54,52,173,17,35,101.22,173.13,0.00
2024-12-08 14:52:54,52,174,17,35,103.61,174.00,0.00
2024-12-08 14:52:54,53,174,18,35,101.66,174.02,0.00
2024-12-08 14:52:54,52,174,18,34,103.58,174.02,0.00
2024-12-08 14:52:55,52,175,18,34,104.02,175.00,0.00
2024-12-08 14:52:55,53,175,18,35,102.05,175.02,0.00
2024-12-08 14:52:55,52,175,18,34,103.31,175.06,0.00
2024-12-08 14:52:55,52,176,18,34,104.27,176.00,0.00
2024-12-08 14:52:55,53,176,18,35,102.31,176.02,0.00
2024-12-08 14:52:55,53,177,18,35,102.73,177.00,0.00
2024-12-08 14:52:55,54,177,18,36,100.83,177.02,0.00
2024-12-08 14:52:55,53,177,17,36,102.69,177.04,0.00
2024-12-08 14:52:55,52,177,17,35,103.98,177.04,0.00
2024-12-08 14:52:55,51,177,16,35,104.08,177.96,0.00
2024-12-08 14:52:55,51,178,16,35,107.52,178.00,0.00
2024-12-08 14:52:55,52,178,16,36,105.45,178.02,0.00
2024-12-08 14:52:55,52,179,16,36,105.86,179.00,0.00
2024-12-08 14:52:55,53,179,17,36,103.86,179.02,0.00
2024-12-08 14:52:55,52,179,17,35,105.17,179.04,0.00
2024-12-08 14:52:55,51,179,16,35,105.61,179.86,0.00
2024-12-08 14:52:55,51,180,16,35,109.01,180.00,0.00
2024-12-08 14:52:55,52,180,17,35,106.91,180.02,0.00
2024-12-08 14:52:55,52,181,17,35,107.35,181.00,0.00
2024-12-08 14:52:55,53,181,17,36,105.33,181.02,0.00
2024-12-08 14:52:55,52,181,17,35,106.62,181.04,0.00
2024-12-08 14:52:55,52,182,17,35,107.56,182.00,0.00
2024-12-08 14:52:55,53,182,18,35,105.53,182.02,0.00
2024-12-08 14:52:55,53,183,18,35,105.96,183.00,0.00
2024-12-08 14:52:55,54,183,19,35,104.00,183.02,0.00
2024-12-08 14:52:55,53,183,19,34,105.23,183.04,0.00
2024-12-08 14:52:55,52,183,18,34,106.07,183.69,0.00
2024-12-08 14:52:55,52,184,18,34,109.27,184.00,0.00
2024-12-08 14:52:55,53,184,19,34,107.21,184.02,0.00
2024-12-08 14:52:55,52,184,18,34,107.86,184.21,0.00
2024-12-08 14:52:55,52,185,18,34,110.47,185.00,0.00
2024-12-08 14:52:55,53,185,19,34,108.39,185.02,0.00
2024-12-08 14:52:55,53,186,19,34,108.55,186.00,0.00
2024-12-08 14:52:55,54,186,19,35,106.54,186.02,0.00
2024-12-08 14:52:55,53,186,19,34,108.11,186.15,0.00
2024-12-08 14:52:55,52,186,18,34,109.66,186.54,0.00
2024-12-08 14:52:55,52,187,18,34,111.28,187.00,0.00
2024-12-08 14:52:55,53,187,18,35,109.18,187.02,0.00
2024-12-08 14:52:55,52,187,18,34,111.24,187.02,0.00
2024-12-08 14:52:55,52,188,18,34,111.93,188.00,0.00
2024-12-08 14:52:55,53,188,18,35,109.82,188.02,0.00
2024-12-08 14:52:55,52,188,17,35,108.91,188.94,0.00
2024-12-08 14:52:55,52,189,17,35,112.47,189.00,0.00
2024-12-08 14:52:55,53,189,17,36,110.35,189.02,0.00
2024-12-08 14:52:55,52,189,17,35,111.95,189.17,0.00
2024-12-08 14:52:55,52,190,17,35,113.10,190.00,0.00
2024-12-08 14:52:55,53,190,17,36,110.97,190.02,0.00
2024-12-08 14:52:55,52,190,16,36,110.91,190.54,0.00
2024-12-08 14:52:55,52,191,16,36,114.04,191.00,0.00
2024-12-08 14:52:55,53,191,17,36,111.88,191.02,0.00
2024-12-08 14:52:55,53,192,17,36,112.20,192.00,0.00
2024-12-08 14:52:55,54,192,18,36,110.13,192.02,0.00
2024-12-08 14:52:55,53,192,18,35,111.12,192.32,0.00
2024-12-08 14:52:55,53,193,18,35,112.46,193.00,0.00
2024-12-08 14:52:55,54,193,18,36,110.38,193.02,0.00
2024-12-08 14:52:55,53,193,17,36,110.22,193.55,0.00
2024-12-08 14:52:55,53,194,17,36,113.34,194.00,0.00
2024-12-08 14:52:55,54,194,17,37,111.24,194.02,0.00
2024-12-08 14:52:55,54,195,17,37,111.52,195.00,0.00
2024-12-08 14:52:55,55,195,18,37,109.50,195.02,0.00
2024-12-08 14:52:55,54,195,18,36,110.45,195.33,0.00
2024-12-08 14:52:55,53,195,17,36,111.75,195.51,0.00
2024-12-08 14:52:55,53,196,17,36,114.85,196.00,0.00
2024-12-08 14:52:55,54,196,17,37,112.73,196.02,0.00
2024-12-08 14:52:55,54,197,17,37,113.57,197.00,0.00
2024-12-08 14:52:55,55,197,18,37,111.51,197.02,0.00
2024-12-08 14:52:55,54,197,17,37,111.87,197.31,0.00
2024-12-08 14:52:55,54,198,17,37,113.91,198.00,0.00
2024-12-08 14:52:55,55,198,17,38,111.84,198.02,0.00
2024-12-08 14:52:55,54,198,16,38,113.42,198.31,0.00
2024-12-08 14:52:55,53,198,16,37,114.96,198.32,0.00
2024-12-08 14:52:55,53,199,16,37,116.35,199.00,0.00
2024-12-08 14:52:55,54,199,17,37,114.19,199.02,0.00
2024-12-08 14:52:55,54,200,17,37,114.99,200.00,0.00
2024-12-08 14:52:55,55,200,18,37,112.90,200.02,0.00
2024-12-08 14:52:55,55,201,18,37,113.12,201.00,0.00
2024-12-08 14:52:55,56,201,19,37,111.10,201.02,0.00
2024-12-08 14:52:55,55,201,19,36,112.11,201.31,0.00
2024-12-08 14:52:55,54,201,18,36,111.96,201.91,0.00
2024-12-08 14:52:55,54,202,18,36,115.58,202.00,0.00
2024-12-08 14:52:55,55,202,18,37,113.48,202.02,0.00
2024-12-08 14:52:55,54,202,17,37,115.23,202.22,0.00
2024-12-08 14:52:55,54,203,17,37,116.36,203.00,0.00
2024-12-08 14:52:55,55,203,18,37,114.24,203.02,0.00
2024-12-08 14:52:56,55,204,18,37,114.41,204.00,0.00
2024-12-08 14:52:56,56,204,19,37,112.36,204.02,0.00
2024-12-08 14:52:56,55,204,19,36,113.48,204.29,0.00
2024-12-08 14:52:56,55,205,19,36,114.74,205.00,0.00
2024-12-08 14:52:56,56,205,20,36,112.69,205.02,0.00
2024-12-08 14:52:56,56,206,20,36,113.35,206.00,0.00
2024-12-08 14:52:56,57,206,20,37,111.36,206.02,0.00
2024-12-08 14:52:56,56,206,19,37,112.93,206.25,0.00
2024-12-08 14:52:56,55,206,18,37,113.64,206.65,0.00
2024-12-08 14:52:56,55,207,18,37,115.59,207.00,0.00
2024-12-08 14:52:56,56,207,18,38,113.53,207.02,0.00
2024-12-08 14:52:56,55,207,18,37,114.76,207.27,0.00
2024-12-08 14:52:56,55,208,18,37,116.00,208.00,0.00
2024-12-08 14:52:56,56,208,19,37,113.93,208.02,0.00
2024-12-08 14:52:56,56,209,19,37,114.53,209.00,0.00
2024-12-08 14:52:56,57,209,19,38,112.52,209.02,0.00
2024-12-08 14:52:56,57,210,19,38,112.55,210.00,0.00
2024-12-08 14:52:56,58,210,20,38,110.61,210.02,0.00
2024-12-08 14:52:56,57,210,20,37,111.79,210.26,0.00
2024-12-08 14:52:56,57,211,20,37,112.93,211.00,0.00
2024-12-08 14:52:56,58,211,21,37,110.99,211.02,0.00
2024-12-08 14:52:56,57,211,20,37,111.33,211.28,0.00
2024-12-08 14:52:56,57,212,20,37,113.99,212.00,0.00
2024-12-08 14:52:56,58,212,20,38,112.02,212.02,0.00
2024-12-08 14:52:56,58,213,20,38,112.01,213.00,0.00
2024-12-08 14:52:56,59,213,21,38,110.11,213.02,0.00
2024-12-08 14:52:56,58,213,21,37,111.29,213.26,0.00
2024-12-08 14:52:56,58,214,21,37,112.39,214.00,0.00
2024-12-08 14:52:56,59,214,22,37,110.49,214.02,0.00
2024-12-08 14:52:56,59,215,22,37,111.11,215.00,0.00
2024-12-08 14:52:56,60,215,23,37,109.26,215.02,0.00
2024-12-08 14:52:56,60,216,23,37,109.34,216.00,0.00
2024-12-08 14:52:56,61,216,24,37,107.55,216.02,0.00
2024-12-08 14:52:56,60,216,24,36,108.45,216.27,0.00
2024-12-08 14:52:56,60,217,24,36,109.48,217.00,0.00
2024-12-08 14:52:56,61,217,25,36,107.69,217.02,0.00
2024-12-08 14:52:56,61,218,25,36,108.22,218.00,0.00
2024-12-08 14:52:56,62,218,25,37,106.47,218.02,0.00
2024-12-08 14:52:56,62,219,25,37,106.47,219.00,0.00
2024-12-08 14:52:56,63,219,26,37,104.78,219.02,0.00
2024-12-08 14:52:56,62,219,26,36,105.67,219.26,0.00
2024-12-08 14:52:56,62,220,26,36,106.60,220.00,0.00
2024-12-08 14:52:56,63,220,27,36,104.91,220.02,0.00
2024-12-08 14:52:56,63,221,27,36,105.35,221.00,0.00
2024-12-08 14:52:56,64,221,27,37,103.70,221.02,0.00
2024-12-08 14:52:56,63,221,26,37,103.85,221.41,0.00
2024-12-08 14:52:56,63,222,26,37,105.28,222.00,0.00
2024-12-08 14:52:56,64,222,26,38,103.64,222.02,0.00
2024-12-08 14:52:56,63,222,26,37,104.54,222.25,0.00
2024-12-08 14:52:56,62,222,25,37,105.55,222.44,0.00
2024-12-08 14:52:56,62,223,25,37,108.24,223.00,0.00
2024-12-08 14:52:56,63,223,26,37,106.52,223.02,0.00
2024-12-08 14:52:56,62,223,26,36,108.20,223.02,0.00
2024-12-08 14:52:56,62,224,26,36,108.64,224.00,0.00
2024-12-08 14:52:56,63,224,26,37,106.91,224.02,0.00
2024-12-08 14:52:56,63,225,26,37,106.81,225.00,0.00
2024-12-08 14:52:56,64,225,27,37,105.15,225.02,0.00
2024-12-08 14:52:56,63,225,27,36,106.78,225.02,0.00
2024-12-08 14:52:56,62,225,27,35,107.88,225.23,0.00
2024-12-08 14:52:56,62,226,27,35,108.77,226.00,0.00
2024-12-08 14:52:56,63,226,28,35,107.04,226.02,0.00
2024-12-08 14:52:56,63,227,28,35,107.43,227.00,0.00
2024-12-08 14:52:56,64,227,28,36,105.75,227.02,0.00
2024-12-08 14:52:56,63,227,28,35,107.40,227.02,0.00
2024-12-08 14:52:56,62,227,27,35,106.57,227.32,0.00
2024-12-08 14:52:56,62,228,27,35,109.10,228.00,0.00
2024-12-08 14:52:56,63,228,28,35,107.37,228.02,0.00
2024-12-08 14:52:56,62,228,28,34,109.07,228.02,0.00
2024-12-08 14:52:56,61,228,28,33,110.24,228.21,0.00
2024-12-08 14:52:56,61,229,28,33,111.15,229.00,0.00
2024-12-08 14:52:56,62,229,28,34,109.36,229.02,0.00
2024-12-08 14:52:56,61,229,28,33,111.11,229.02,0.00
2024-12-08 14:52:56,60,229,27,33,111.02,229.62,0.00
2024-12-08 14:52:56,60,230,27,33,113.40,230.00,0.00
2024-12-08 14:52:56,61,230,28,33,111.54,230.02,0.00
2024-12-08 14:52:56,60,230,28,32,113.36,230.02,0.00
2024-12-08 14:52:56,60,231,28,32,113.28,231.00,0.00
2024-12-08 14:52:56,61,231,28,33,111.42,231.02,0.00
2024-12-08 14:52:56,60,231,28,32,112.79,231.18,0.00
2024-12-08 14:52:56,60,232,28,32,113.69,232.00,0.00
2024-12-08 14:52:56,61,232,29,32,111.83,232.02,0.00
2024-12-08 14:52:56,61,233,29,32,112.21,233.00,0.00
2024-12-08 14:52:56,62,233,29,33,110.40,233.02,0.00
2024-12-08 14:52:57,61,233,29,32,112.17,233.02,0.00
2024-12-08 14:52:57,61,234,29,32,112.07,234.00,0.00
2024-12-08 14:52:57,62,234,29,33,110.26,234.02,0.00
2024-12-08 14:52:57,61,234,29,32,112.03,234.02,0.00
2024-12-08 14:52:57,60,234,29,31,113.52,234.15,0.00
2024-12-08 14:52:57,59,234,28,31,114.56,234.63,0.00
2024-12-08 14:52:57,59,235,28,31,116.31,235.00,0.00
2024-12-08 14:52:57,60,235,28,32,114.37,235.02,0.00
2024-12-08 14:52:57,60,236,28,32,114.73,236.00,0.00
2024-12-08 14:52:57,61,236,29,32,112.85,236.02,0.00
2024-12-08 14:52:57,60,236,29,31,113.60,236.15,0.00
2024-12-08 14:52:57,59,236,28,31,114.52,236.20,0.00
2024-12-08 14:52:57,59,237,28,31,117.10,237.00,0.00
2024-12-08 14:52:57,60,237,28,32,115.15,237.02,0.00
2024-12-08 14:52:57,59,237,28,31,117.06,237.02,0.00
2024-12-08 14:52:57,58,237,27,31,117.45,237.40,0.00
2024-12-08 14:52:57,57,237,26,31,117.71,237.93,0.00
2024-12-08 14:52:57,57,238,26,31,121.77,238.00,0.00
2024-12-08 14:52:57,58,238,27,31,119.67,238.02,0.00
2024-12-08 14:52:57,57,238,26,31,121.50,238.12,0.00
2024-12-08 14:52:57,56,238,26,30,122.82,238.13,0.00
2024-12-08 14:52:57,56,239,26,30,123.86,239.00,0.00
2024-12-08 14:52:57,57,239,26,31,121.69,239.02,0.00
2024-12-08 14:52:57,56,239,26,30,123.82,239.02,0.00
2024-12-08 14:52:57,55,239,25,30,123.34,239.80,0.00
2024-12-08 14:52:57,55,239,25,30,127.38,240.00,0.00
2024-12-08 14:52:57,56,239,25,31,125.11,240.02,0.00
2024-12-08 14:52:57,55,239,25,30,127.34,240.02,0.00
2024-12-08 14:52:57,54,239,25,29,128.68,240.09,0.00
2024-12-08 14:52:57,53,239,24,29,130.49,240.40,0.00
2024-12-08 14:52:57,52,239,23,29,131.03,240.58,0.00
2024-12-08 14:52:57,52,240,23,29,134.94,241.00,0.00
2024-12-08 14:52:57,53,240,23,30,132.40,241.02,0.00
2024-12-08 14:52:57,53,241,23,30,132.90,242.00,0.00
2024-12-08 14:52:57,54,241,24,30,130.44,242.02,0.00
2024-12-08 14:52:57,53,241,24,29,131.81,242.09,0.00
2024-12-08 14:52:57,52,241,23,29,131.94,242.63,0.00
2024-12-08 14:52:57,52,242,23,29,135.99,243.00,0.00
2024-12-08 14:52:57,53,242,23,30,133.43,243.02,0.00
2024-12-08 14:52:57,52,242,22,30,135.95,243.02,0.00
2024-12-08 14:52:57,51,242,21,30,136.97,243.33,0.00
2024-12-08 14:52:57,51,243,21,30,139.30,244.00,0.00
2024-12-08 14:52:57,52,243,21,31,136.62,244.02,0.00
2024-12-08 14:52:57,51,243,20,31,139.25,244.02,0.00
2024-12-08 14:52:57,51,244,20,31,139.34,245.00,0.00
2024-12-08 14:52:57,52,244,21,31,136.66,245.02,0.00
2024-12-08 14:52:57,51,244,21,30,139.15,245.06,0.00
2024-12-08 14:52:57,50,244,20,30,141.02,245.52,0.00
2024-12-08 14:52:57,49,244,19,30,143.45,245.55,0.00
2024-12-08 14:52:57,48,244,18,30,146.25,245.65,0.00
2024-12-08 14:52:57,48,245,18,30,150.80,246.00,0.00
2024-12-08 14:52:57,49,245,18,31,147.73,246.02,0.00
2024-12-08 14:52:57,49,246,18,31,148.31,247.00,0.00
2024-12-08 14:52:57,50,246,19,31,145.35,247.02,0.00
2024-12-08 14:52:57,49,246,19,30,148.26,247.02,0.00
2024-12-08 14:52:57,48,246,19,29,150.22,247.04,0.00
2024-12-08 14:52:57,48,247,19,29,151.55,248.00,0.00
2024-12-08 14:52:57,49,247,19,30,148.46,248.02,0.00
2024-12-08 14:52:57,49,248,19,30,149.00,249.00,0.00
2024-12-08 14:52:57,50,248,19,31,146.02,249.02,0.00
2024-12-08 14:52:57,49,248,19,30,147.94,249.04,0.00
2024-12-08 14:52:57,48,248,18,30,149.97,249.54,0.00
2024-12-08 14:52:57,48,249,18,30,152.30,250.00,0.00
2024-12-08 14:52:57,49,249,19,30,149.20,250.02,0.00
2024-12-08 14:52:57,48,249,18,30,148.19,250.96,0.00
2024-12-08 14:52:57,48,250,18,30,153.34,251.00,0.00
2024-12-08 14:52:57,49,250,19,30,150.21,251.02,0.00
2024-12-08 14:52:57,48,250,19,29,152.29,251.04,0.00
2024-12-08 14:52:57,48,251,19,29,153.63,252.00,0.00
2024-12-08 14:52:57,49,251,19,30,150.50,252.02,0.00
2024-12-08 14:52:57,48,251,18,30,152.48,252.06,0.00
2024-12-08 14:52:57,49,250,19,30,146.49,252.65,0.00
2024-12-08 14:52:57,49,251,19,30,151.98,253.00,0.00
2024-12-08 14:52:57,50,251,20,30,148.94,253.02,0.00
2024-12-08 14:52:57,49,251,20,29,151.00,253.04,0.00
2024-12-08 14:52:57,48,251,19,29,153.87,253.04,0.00
2024-12-08 14:52:57,48,252,19,29,162.63,254.00,0.00
2024-12-08 14:52:57,49,252,19,30,159.31,254.02,0.00
2024-12-08 14:52:57,49,253,19,30,159.72,255.00,0.00
2024-12-08 14:52:57,50,253,19,31,156.53,255.02,0.00
2024-12-08 14:52:57,49,253,19,30,158.68,255.04,0.00
2024-12-08 14:52:57,48,253,18,30,160.20,255.31,0.00
2024-12-08 14:52:57,48,254,18,30,164.28,256.00,0.00
2024-12-08 14:52:57,49,254,19,30,160.93,256.02,0.00
2024-12-08 14:52:57,49,255,19,30,161.32,257.00,0.00
2024-12-08 14:52:57,50,255,20,30,158.09,257.02,0.00
2024-12-08 14:52:57,49,255,20,29,160.32,257.04,0.00
2024-12-08 14:52:57,49,256,20,29,161.63,258.00,0.00
2024-12-08 14:52:57,50,256,20,30,158.40,258.02,0.00
2024-12-08 14:52:57,49,256,19,30,161.37,258.02,0.00
2024-12-08 14:52:57,48,256,18,30,163.60,258.04,0.00
2024-12-08 14:52:57,48,257,18,30,167.15,259.00,0.00
2024-12-08 14:52:57,49,257,19,30,163.74,259.02,0.00
2024-12-08 14:52:57,48,257,19,29,166.18,259.02,0.00
2024-12-08 14:52:57,48,258,19,29,167.52,260.00,0.00
2024-12-08 14:52:57,49,258,19,30,164.10,260.02,0.00
2024-12-08 14:52:58,49,259,19,30,164.43,261.00,0.00
2024-12-08 14:52:58,50,259,19,31,161.15,261.02,0.00
2024-12-08 14:52:58,49,259,19,30,163.48,261.02,0.00
2024-12-08 14:52:58,49,260,19,30,164.74,262.00,0.00
2024-12-08 14:52:58,50,260,19,31,161.45,262.02,0.00
2024-12-08 14:52:58,50,261,19,31,161.86,263.00,0.00
2024-12-08 14:52:58,51,261,20,31,158.69,263.02,0.00
2024-12-08 14:52:58,50,261,20,30,160.76,263.04,0.00
2024-12-08 14:52:58,49,261,19,30,163.10,263.14,0.00
2024-12-08 14:52:58,48,261,18,30,166.45,263.17,0.00
2024-12-08 14:52:58,48,262,18,30,170.34,264.00,0.00
2024-12-08 14:52:58,49,262,18,31,166.86,264.02,0.00
2024-12-08 14:52:58,48,262,17,31,170.31,264.02,0.00
2024-12-08 14:52:58,47,262,16,31,172.27,264.09,0.00
2024-12-08 14:52:58,47,263,16,31,176.12,265.00,0.00
2024-12-08 14:52:58,48,263,17,31,172.45,265.02,0.00
2024-12-08 14:52:58,48,264,17,31,172.71,266.00,0.00
2024-12-08 14:52:58,49,264,17,32,169.19,266.02,0.00
2024-12-08 14:52:58,48,264,17,31,172.61,266.04,0.00
2024-12-08 14:52:58,48,265,17,31,174.03,267.00,0.00
2024-12-08 14:52:58,49,265,18,31,170.48,267.02,0.00
2024-12-08 14:52:58,49,266,18,31,170.83,268.00,0.00
2024-12-08 14:52:58,50,266,19,31,167.41,268.02,0.00
2024-12-08 14:52:58,50,267,19,31,167.55,269.00,0.00
2024-12-08 14:52:58,51,267,20,31,164.27,269.02,0.00
2024-12-08 14:52:58,50,267,20,30,167.41,269.06,0.00
2024-12-08 14:52:58,50,268,20,30,168.72,270.00,0.00
2024-12-08 14:52:58,51,268,21,30,165.41,270.02,0.00
2024-12-08 14:52:58,51,269,21,30,165.77,271.00,0.00
2024-12-08 14:52:58,52,269,22,30,162.58,271.02,0.00
2024-12-08 14:52:58,52,270,22,30,162.61,272.00,0.00
2024-12-08 14:52:58,53,270,22,31,159.54,272.02,0.00
2024-12-08 14:52:58,52,270,22,30,162.46,272.06,0.00
2024-12-08 14:52:58,52,271,22,30,163.63,273.00,0.00
2024-12-08 14:52:58,53,271,22,31,160.54,273.02,0.00
2024-12-08 14:52:58,52,271,21,31,159.92,273.48,0.00
2024-12-08 14:52:58,52,272,21,31,164.11,274.00,0.00
2024-12-08 14:52:58,53,272,22,31,161.01,274.02,0.00
2024-12-08 14:52:58,52,272,21,31,161.40,274.17,0.00
2024-12-08 14:52:58,52,273,21,31,164.94,275.00,0.00
2024-12-08 14:52:58,53,273,22,31,161.83,275.02,0.00
2024-12-08 14:52:58,52,273,22,30,164.59,275.08,0.00
2024-12-08 14:52:58,52,274,22,30,165.81,276.00,0.00
2024-12-08 14:52:58,53,274,22,31,162.68,276.02,0.00
2024-12-08 14:52:58,53,275,22,31,163.12,277.00,0.00
2024-12-08 14:52:58,54,275,23,31,160.10,277.02,0.00
2024-12-08 14:52:58,53,275,22,31,159.79,277.30,0.00
2024-12-08 14:52:58,53,276,22,31,163.55,278.00,0.00
2024-12-08 14:52:58,54,276,22,32,160.52,278.02,0.00
2024-12-08 14:52:58,53,276,22,31,163.20,278.08,0.00
2024-12-08 14:52:58,53,277,22,31,164.34,279.00,0.00
2024-12-08 14:52:58,54,277,23,31,161.30,279.02,0.00
2024-12-08 14:52:58,53,277,22,31,161.98,279.58,0.00
2024-12-08 14:52:58,53,278,22,31,164.72,280.00,0.00
2024-12-08 14:52:58,54,278,23,31,161.67,280.02,0.00
2024-12-08 14:52:58,54,279,23,31,161.57,281.00,0.00
2024-12-08 14:52:58,55,279,23,32,158.63,281.02,0.00
2024-12-08 14:52:58,54,279,22,32,159.60,281.06,0.00
2024-12-08 14:52:58,53,279,22,31,162.50,281.06,0.00
2024-12-08 14:52:58,53,280,22,31,165.73,282.00,0.00
2024-12-08 14:52:58,54,280,22,32,162.66,282.02,0.00
2024-12-08 14:52:58,53,280,21,32,161.64,282.58,0.00
2024-12-08 14:52:58,53,281,21,32,166.08,283.00,0.00
2024-12-08 14:52:58,54,281,22,32,163.01,283.02,0.00
2024-12-08 14:52:58,53,281,21,32,163.92,283.11,0.00
2024-12-08 14:52:58,53,282,21,32,167.32,284.00,0.00
2024-12-08 14:52:58,54,282,22,32,164.22,284.02,0.00
2024-12-08 14:52:58,53,282,22,31,167.16,284.06,0.00
2024-12-08 14:52:58,53,283,22,31,168.28,285.00,0.00
2024-12-08 14:52:58,54,283,22,32,165.17,285.02,0.00
2024-12-08 14:52:58,54,284,22,32,165.45,286.00,0.00
2024-12-08 14:52:58,55,284,23,32,162.45,286.02,0.00
2024-12-08 14:52:58,55,285,23,32,162.28,287.00,0.00
2024-12-08 14:52:58,56,285,24,32,159.39,287.02,0.00
2024-12-08 14:52:58,55,285,24,31,162.13,287.05,0.00
2024-12-08 14:52:58,55,286,24,31,163.11,288.00,0.00
2024-12-08 14:52:58,56,286,24,32,160.20,288.02,0.00
2024-12-08 14:52:58,56,287,24,32,160.44,289.00,0.00
2024-12-08 14:52:58,57,287,25,32,157.63,289.02,0.00
2024-12-08 14:52:58,56,287,25,31,159.26,289.05,0.00
2024-12-08 14:52:58,56,288,25,31,160.17,290.00,0.00
2024-12-08 14:52:58,57,288,25,32,157.36,290.02,0.00
2024-12-08 14:52:58,57,289,25,32,157.61,291.00,0.00
2024-12-08 14:52:58,58,289,25,33,154.89,291.02,0.00
2024-12-08 14:52:58,57,289,25,32,156.44,291.05,0.00
2024-12-08 14:52:58,57,290,25,32,157.28,292.00,0.00
2024-12-08 14:52:58,58,290,25,33,154.57,292.02,0.00
2024-12-08 14:52:59,58,291,25,33,155.49,293.00,0.00
2024-12-08 14:52:59,59,291,25,34,152.85,293.02,0.00
2024-12-08 14:52:59,59,292,25,34,153.02,294.00,0.00
2024-12-08 14:52:59,60,292,26,34,150.47,294.02,0.00
2024-12-08 14:52:59,59,292,26,33,151.98,294.05,0.00
2024-12-08 14:52:59,58,292,25,33,153.17,294.33,0.00
2024-12-08 14:52:59,58,293,25,33,156.67,295.00,0.00
2024-12-08 14:52:59,59,293,26,33,154.01,295.02,0.00
2024-12-08 14:52:59,58,293,25,33,155.29,295.09,0.00
2024-12-08 14:52:59,58,294,25,33,158.20,296.00,0.00
2024-12-08 14:52:59,59,294,25,34,155.52,296.02,0.00
2024-12-08 14:52:59,58,294,25,33,157.13,296.05,0.00
2024-12-08 14:52:59,58,295,25,33,157.91,297.00,0.00
2024-12-08 14:52:59,59,295,26,33,155.24,297.02,0.00
2024-12-08 14:52:59,59,296,26,33,155.37,298.00,0.00
2024-12-08 14:52:59,60,296,27,33,152.78,298.02,0.00
2024-12-08 14:52:59,59,296,27,32,154.37,298.05,0.00
2024-12-08 14:52:59,59,297,27,32,155.08,299.00,0.00
2024-12-08 14:52:59,60,297,28,32,152.50,299.02,0.00
2024-12-08 14:52:59,60,298,28,32,152.63,300.00,0.00
2024-12-08 14:52:59,61,298,29,32,150.13,300.02,0.00
2024-12-08 14:52:59,60,298,29,31,151.63,300.05,0.00
2024-12-08 14:52:59,60,299,29,31,152.29,301.00,0.00
2024-12-08 14:52:59,61,299,30,31,149.79,301.02,0.00
2024-12-08 14:52:59,61,300,30,31,149.91,302.00,0.00
2024-12-08 14:52:59,62,300,31,31,147.49,302.02,0.00
2024-12-08 14:52:59,61,300,31,30,148.92,302.05,0.00
2024-12-08 14:52:59,61,301,31,30,149.51,303.00,0.00
2024-12-08 14:52:59,62,301,31,31,147.10,303.02,0.00
2024-12-08 14:52:59,61,301,30,31,147.06,303.56,0.00
2024-12-08 14:52:59,61,302,30,31,150.98,304.00,0.00
2024-12-08 14:52:59,62,302,31,31,148.54,304.02,0.00
2024-12-08 14:52:59,61,302,30,31,150.93,304.02,0.00
2024-12-08 14:52:59,60,302,30,30,152.53,304.03,0.00
2024-12-08 14:52:59,60,303,30,30,153.14,305.00,0.00
2024-12-08 14:52:59,61,303,30,31,150.63,305.02,0.00
2024-12-08 14:52:59,60,303,29,31,149.32,305.52,0.00
2024-12-08 14:52:59,60,304,29,31,153.25,306.00,0.00
2024-12-08 14:52:59,61,304,30,31,150.73,306.02,0.00
2024-12-08 14:52:59,60,304,30,30,152.38,306.03,0.00
2024-12-08 14:52:59,59,304,29,30,154.51,306.03,0.00
2024-12-08 14:52:59,58,304,28,30,155.86,306.52,0.00
2024-12-08 14:52:59,58,305,28,30,159.98,307.00,0.00
2024-12-08 14:52:59,59,305,28,31,157.27,307.02,0.00
2024-12-08 14:52:59,58,305,28,30,159.93,307.02,0.00
2024-12-08 14:52:59,57,305,27,30,159.32,307.65,0.00
2024-12-08 14:52:59,57,306,27,30,163.89,308.00,0.00
2024-12-08 14:52:59,58,306,28,30,161.07,308.02,0.00
2024-12-08 14:52:59,57,306,28,29,163.03,308.02,0.00
2024-12-08 14:52:59,57,307,28,29,163.77,309.00,0.00
2024-12-08 14:52:59,58,307,29,29,160.95,309.02,0.00
2024-12-08 14:52:59,57,307,28,29,162.39,309.09,0.00
2024-12-08 14:52:59,57,308,28,29,165.50,310.00,0.00
2024-12-08 14:52:59,58,308,28,30,162.65,310.02,0.00
2024-12-08 14:52:59,57,308,28,29,164.68,310.02,0.00
2024-12-08 14:52:59,57,309,28,29,165.43,311.00,0.00
2024-12-08 14:52:59,58,309,29,29,162.58,311.02,0.00
2024-12-08 14:52:59,57,309,28,29,164.14,311.07,0.00
2024-12-08 14:52:59,57,310,28,29,167.22,312.00,0.00
2024-12-08 14:52:59,58,310,28,30,164.34,312.02,0.00
2024-12-08 14:52:59,57,310,28,29,166.40,312.02,0.00
2024-12-08 14:52:59,57,311,28,29,167.16,313.00,0.00
2024-12-08 14:52:59,58,311,28,30,164.27,313.02,0.00
2024-12-08 14:52:59,57,311,27,30,164.61,313.53,0.00
2024-12-08 14:52:59,57,312,27,30,167.25,314.00,0.00
2024-12-08 14:52:59,58,312,28,30,164.37,314.02,0.00
2024-12-08 14:52:59,57,312,28,29,166.42,314.02,0.00
2024-12-08 14:52:59,56,312,27,29,169.30,314.05,0.00
2024-12-08 14:52:59,56,313,27,29,170.22,315.00,0.00
2024-12-08 14:52:59,57,313,28,29,167.23,315.02,0.00
2024-12-08 14:52:59,57,314,28,29,167.32,316.00,0.00
2024-12-08 14:52:59,58,314,29,29,164.43,316.02,0.00
2024-12-08 14:52:59,57,314,29,28,166.54,316.02,0.00
2024-12-08 14:52:59,56,314,28,28,168.13,316.50,0.00
2024-12-08 14:52:59,56,315,28,28,170.28,317.00,0.00
2024-12-08 14:52:59,57,315,28,29,167.29,317.02,0.00
2024-12-08 14:52:59,56,315,27,29,167.48,317.30,0.00
2024-12-08 14:52:59,56,316,27,29,171.38,318.00,0.00
2024-12-08 14:52:59,57,316,27,30,168.38,318.02,0.00
2024-12-08 14:52:59,56,316,26,30,169.79,318.07,0.00
2024-12-08 14:52:59,56,317,26,30,173.05,319.00,0.00
2024-12-08 14:52:59,57,317,27,30,170.01,319.02,0.00
2024-12-08 14:52:59,56,317,27,29,172.08,319.04,0.00
2024-12-08 14:52:59,55,317,26,29,173.88,319.25,0.00
2024-12-08 14:52:59,55,318,26,29,177.79,320.00,0.00
2024-12-08 14:52:59,56,318,26,30,174.62,320.02,0.00
2024-12-08 14:52:59,55,318,26,29,177.04,320.02,0.00
2024-12-08 14:53:00,55,319,26,29,177.94,321.00,0.00
2024-12-08 14:53:00,56,319,26,30,174.76,321.02,0.00
2024-12-08 14:53:00,55,319,25,30,174.95,321.65,0.00
2024-12-08 14:53:00,55,320,25,30,178.04,322.00,0.00
2024-12-08 14:53:00,56,320,26,30,174.86,322.02,0.00
2024-12-08 14:53:00,55,320,26,29,177.22,322.02,0.00
2024-12-08 14:53:00,54,320,25,29,176.48,322.96,0.00
2024-12-08 14:53:00,54,321,25,29,182.36,323.00,0.00
2024-12-08 14:53:00,55,321,25,30,179.05,323.02,0.00
2024-12-08 14:53:00,54,321,24,30,180.66,323.13,0.00
2024-12-08 14:53:00,54,322,24,30,184.37,324.00,0.00
2024-12-08 14:53:00,55,322,24,31,181.02,324.02,0.00
2024-12-08 14:53:00,54,322,24,30,183.47,324.02,0.00
2024-12-08 14:53:00,53,322,23,30,186.77,324.08,0.00
2024-12-08 14:53:00,52,322,22,30,190.00,324.12,0.00
2024-12-08 14:53:00,52,323,22,30,193.93,325.00,0.00
2024-12-08 14:53:00,53,323,22,31,190.27,325.02,0.00
2024-12-08 14:53:00,52,323,21,31,191.41,325.46,0.00
2024-12-08 14:53:00,52,324,21,31,194.10,326.00,0.00
2024-12-08 14:53:00,53,324,21,32,190.44,326.02,0.00
2024-12-08 14:53:00,52,324,21,31,193.16,326.02,0.00
2024-12-08 14:53:00,52,325,21,31,194.32,327.00,0.00
2024-12-08 14:53:00,53,325,21,32,190.65,327.02,0.00
2024-12-08 14:53:00,52,325,20,32,189.33,327.92,0.00
2024-12-08 14:53:00,52,326,20,32,195.44,328.00,0.00
2024-12-08 14:53:00,53,326,21,32,191.75,328.02,0.00
2024-12-08 14:53:00,52,326,20,32,193.88,328.10,0.00
2024-12-08 14:53:00,52,327,20,32,197.81,329.00,0.00
2024-12-08 14:53:00,53,327,20,33,194.07,329.02,0.00
2024-12-08 14:53:00,52,327,20,32,196.86,329.04,0.00
2024-12-08 14:53:00,51,327,19,32,199.53,329.45,0.00
2024-12-08 14:53:00,51,328,19,32,202.01,330.00,0.00
2024-12-08 14:53:00,52,328,20,32,198.13,330.02,0.00
2024-12-08 14:53:00,51,328,19,32,196.87,330.51,0.00
2024-12-08 14:53:00,51,329,19,32,202.12,331.00,0.00
2024-12-08 14:53:00,52,329,19,33,198.23,331.02,0.00
2024-12-08 14:53:00,51,329,19,32,201.40,331.02,0.00
2024-12-08 14:53:00,51,330,19,32,202.66,332.00,0.00
2024-12-08 14:53:00,52,330,20,32,198.77,332.02,0.00
2024-12-08 14:53:00,52,331,20,32,198.67,333.00,0.00
2024-12-08 14:53:00,53,331,21,32,194.92,333.02,0.00
2024-12-08 14:53:00,52,331,21,31,197.91,333.02,0.00
2024-12-08 14:53:00,51,331,20,31,201.71,333.04,0.00
2024-12-08 14:53:00,51,332,20,31,203.03,334.00,0.00
2024-12-08 14:53:00,52,332,21,31,199.13,334.02,0.00
2024-12-08 14:53:00,51,332,21,30,202.18,334.02,0.00
2024-12-08 14:53:00,50,332,20,30,202.58,334.94,0.00
2024-12-08 14:53:00,50,333,20,30,209.11,335.00,0.00
2024-12-08 14:53:00,51,333,20,31,205.01,335.02,0.00
2024-12-08 14:53:00,51,334,20,31,205.09,336.00,0.00
2024-12-08 14:53:00,52,334,21,31,201.15,336.02,0.00
2024-12-08 14:53:00,51,334,21,30,203.97,336.02,0.00
2024-12-08 14:53:00,51,335,21,30,205.24,337.00,0.00
2024-12-08 14:53:00,52,335,22,30,201.29,337.02,0.00
2024-12-08 14:53:00,52,336,22,30,201.36,338.00,0.00
2024-12-08 14:53:00,53,336,22,31,197.56,338.02,0.00
2024-12-08 14:53:00,52,336,22,30,200.32,338.02,0.00
2024-12-08 14:53:00,52,337,22,30,201.49,339.00,0.00
2024-12-08 14:53:00,53,337,22,31,197.69,339.02,0.00
2024-12-08 14:53:00,53,338,22,31,197.80,340.00,0.00
2024-12-08 14:53:00,54,338,22,32,194.14,340.02,0.00
2024-12-08 14:53:00,53,338,22,31,196.71,340.02,0.00
2024-12-08 14:53:00,52,338,21,31,200.43,340.04,0.00
2024-12-08 14:53:00,51,338,20,31,201.16,340.41,0.00
2024-12-08 14:53:00,51,339,20,31,206.26,341.00,0.00
2024-12-08 14:53:00,52,339,21,31,202.29,341.02,0.00
2024-12-08 14:53:00,52,340,21,31,202.40,342.00,0.00
2024-12-08 14:53:00,53,340,21,32,198.58,342.02,0.00
2024-12-08 14:53:00,52,340,21,31,201.28,342.02,0.00
2024-12-08 14:53:00,51,340,20,31,205.05,342.02,0.00
2024-12-08 14:53:00,51,341,20,31,209.01,343.00,0.00
2024-12-08 14:53:00,52,341,20,32,204.99,343.02,0.00
2024-12-08 14:53:00,52,342,20,32,205.16,344.00,0.00
2024-12-08 14:53:00,53,342,21,32,201.29,344.02,0.00
2024-12-08 14:53:00,52,342,21,31,203.97,344.02,0.00
2024-12-08 14:53:00,51,342,20,31,207.91,344.04,0.00
2024-12-08 14:53:00,50,342,19,31,210.64,344.52,0.00
2024-12-08 14:53:00,50,343,19,31,216.25,345.00,0.00
2024-12-08 14:53:00,51,343,19,32,212.01,345.02,0.00
2024-12-08 14:53:00,50,343,18,32,213.16,345.24,0.00
2024-12-08 14:53:00,50,344,18,32,217.98,346.00,0.00
2024-12-08 14:53:00,51,344,19,32,213.71,346.02,0.00
2024-12-08 14:53:00,50,344,19,31,216.80,346.02,0.00
2024-12-08 14:53:00,50,345,19,31,218.19,347.00,0.00
2024-12-08 14:53:00,51,345,20,31,213.92,347.02,0.00
2024-12-08 14:53:00,51,346,20,31,214.07,348.00,0.00
2024-12-08 14:53:00,52,346,21,31,209.95,348.02,0.00
2024-12-08 14:53:00,51,346,21,30,212.84,348.02,0.00
2024-12-08 14:53:00,51,347,21,30,214.14,349.00,0.00
2024-12-08 14:53:00,52,347,22,30,210.02,349.02,0.00
2024-12-08 14:53:00,51,347,21,30,212.63,349.04,0.00
2024-12-08 14:53:01,51,348,21,30,216.74,350.00,0.00
2024-12-08 14:53:01,52,348,21,31,212.57,350.02,0.00
2024-12-08 14:53:01,51,348,21,30,215.44,350.02,0.00
2024-12-08 14:53:01,51,349,21,30,216.74,351.00,0.00
2024-12-08 14:53:01,52,349,22,30,212.57,351.02,0.00
2024-12-08 14:53:01,52,350,22,30,212.73,352.00,0.00
2024-12-08 14:53:01,53,350,22,31,208.72,352.02,0.00
2024-12-08 14:53:01,52,350,22,30,211.45,352.02,0.00
2024-12-08 14:53:01,52,351,22,30,212.66,353.00,0.00
2024-12-08 14:53:01,53,351,22,31,208.65,353.02,0.00
2024-12-08 14:53:01,53,352,22,31,208.74,354.00,0.00
2024-12-08 14:53:01,54,352,22,32,204.88,354.02,0.00
2024-12-08 14:53:01,53,352,22,31,207.54,354.02,0.00
2024-12-08 14:53:01,52,352,21,31,207.47,354.92,0.00
2024-12-08 14:53:01,52,353,21,31,214.07,355.00,0.00
2024-12-08 14:53:01,53,353,21,32,210.03,355.02,0.00
2024-12-08 14:53:01,52,353,20,32,212.51,355.06,0.00
2024-12-08 14:53:01,52,354,20,32,216.59,356.00,0.00
2024-12-08 14:53:01,53,354,20,33,212.50,356.02,0.00
2024-12-08 14:53:01,52,354,20,32,215.42,356.02,0.00
2024-12-08 14:53:01,51,354,19,32,217.92,356.59,0.00
2024-12-08 14:53:01,51,355,19,32,220.96,357.00,0.00
2024-12-08 14:53:01,52,355,19,33,216.72,357.02,0.00
2024-12-08 14:53:01,52,356,19,33,216.64,358.00,0.00
2024-12-08 14:53:01,53,356,19,34,212.55,358.02,0.00
2024-12-08 14:53:01,52,356,19,33,215.53,358.02,0.00
2024-12-08 14:53:01,51,356,18,33,216.69,358.80,0.00
2024-12-08 14:53:01,51,357,18,33,223.19,359.00,0.00
2024-12-08 14:53:01,52,357,19,33,218.90,359.02,0.00
2024-12-08 14:53:01,52,358,19,33,218.89,360.00,0.00
2024-12-08 14:53:01,53,358,20,33,214.76,360.02,0.00
2024-12-08 14:53:01,52,358,20,32,217.71,360.02,0.00
2024-12-08 14:53:01,51,358,19,32,221.90,360.02,0.00
2024-12-08 14:53:01,51,359,19,32,226.06,361.00,0.00
2024-12-08 14:53:01,52,359,20,32,221.71,361.02,0.00
2024-12-08 14:53:01,52,360,20,32,221.97,362.00,0.00
2024-12-08 14:53:01,53,360,21,32,217.78,362.02,0.00
2024-12-08 14:53:01,53,361,21,32,217.56,363.00,0.00
2024-12-08 14:53:01,54,361,21,33,213.54,363.02,0.00
2024-12-08 14:53:01,53,361,21,32,217.43,363.04,0.00
2024-12-08 14:53:01,52,361,20,32,219.93,363.56,0.00
2024-12-08 14:53:01,52,362,20,32,222.85,364.00,0.00
2024-12-08 14:53:01,53,362,20,33,218.65,364.02,0.00
2024-12-08 14:53:01,53,363,20,33,218.84,365.00,0.00
2024-12-08 14:53:01,54,363,21,33,214.78,365.02,0.00
2024-12-08 14:53:01,53,363,21,32,217.27,365.06,0.00
2024-12-08 14:53:01,52,363,20,32,217.02,365.96,0.00
2024-12-08 14:53:01,52,364,20,32,223.94,366.00,0.00
2024-12-08 14:53:01,53,364,21,32,219.71,366.02,0.00
2024-12-08 14:53:01,53,365,21,32,219.93,367.00,0.00
2024-12-08 14:53:01,54,365,21,33,215.86,367.02,0.00
2024-12-08 14:53:01,53,365,21,32,218.35,367.06,0.00
2024-12-08 14:53:01,53,366,21,32,219.63,368.00,0.00
2024-12-08 14:53:01,54,366,22,32,215.56,368.02,0.00
2024-12-08 14:53:01,53,366,21,32,217.64,368.11,0.00
2024-12-08 14:53:01,52,366,20,32,220.24,368.62,0.00
2024-12-08 14:53:01,52,367,20,32,226.22,369.00,0.00
2024-12-08 14:53:01,53,367,21,32,221.95,369.02,0.00
2024-12-08 14:53:01,53,368,21,32,221.71,370.00,0.00
2024-12-08 14:53:01,54,368,21,33,217.61,370.02,0.00
2024-12-08 14:53:01,53,368,20,33,221.52,370.08,0.00
2024-12-08 14:53:01,52,368,20,32,225.71,370.08,0.00
2024-12-08 14:53:01,52,369,20,32,227.16,371.00,0.00
2024-12-08 14:53:01,53,369,20,33,222.87,371.02,0.00
2024-12-08 14:53:01,53,370,20,33,222.93,372.00,0.00
2024-12-08 14:53:01,54,370,21,33,218.80,372.02,0.00
2024-12-08 14:53:01,53,370,21,32,221.26,372.08,0.00
2024-12-08 14:53:01,52,370,20,32,223.31,372.60,0.00
2024-12-08 14:53:01,52,371,20,32,229.28,373.00,0.00
2024-12-08 14:53:01,53,371,20,33,224.96,373.02,0.00
2024-12-08 14:53:01,53,372,20,33,224.98,374.00,0.00
2024-12-08 14:53:01,54,372,20,34,220.81,374.02,0.00
2024-12-08 14:53:01,53,372,20,33,223.37,374.08,0.00
2024-12-08 14:53:01,52,372,19,33,227.33,374.08,0.00
2024-12-08 14:53:01,52,373,19,33,231.67,375.00,0.00
2024-12-08 14:53:01,53,373,19,34,227.30,375.02,0.00
2024-12-08 14:53:01,52,373,18,34,227.90,375.33,0.00
2024-12-08 14:53:01,52,374,18,34,233.08,376.00,0.00
2024-12-08 14:53:01,53,374,19,34,228.68,376.02,0.00
2024-12-08 14:53:02,53,375,19,34,228.44,377.00,0.00
2024-12-08 14:53:02,54,375,20,34,224.21,377.02,0.00
2024-12-08 14:53:02,53,375,20,33,228.10,377.09,0.00
2024-12-08 14:53:02,53,376,20,33,229.54,378.00,0.00
2024-12-08 14:53:02,54,376,20,34,225.29,378.02,0.00
2024-12-08 14:53:02,53,376,19,34,225.68,378.34,0.00
2024-12-08 14:53:02,53,377,19,34,230.79,379.00,0.00
2024-12-08 14:53:02,54,377,20,34,226.52,379.02,0.00
2024-12-08 14:53:02,53,377,20,33,229.10,379.09,0.00
2024-12-08 14:53:02,53,378,20,33,230.54,380.00,0.00
2024-12-08 14:53:02,54,378,20,34,226.27,380.02,0.00
2024-12-08 14:53:02,53,378,19,34,227.75,380.23,0.00
2024-12-08 14:53:02,53,379,19,34,232.51,381.00,0.00
2024-12-08 14:53:02,54,379,19,35,228.21,381.02,0.00
2024-12-08 14:53:02,53,379,19,34,230.81,381.09,0.00
2024-12-08 14:53:02,53,380,19,34,232.26,382.00,0.00
2024-12-08 14:53:02,54,380,19,35,227.96,382.02,0.00
2024-12-08 14:53:02,54,381,19,35,227.94,383.00,0.00
2024-12-08 14:53:02,55,381,19,36,223.79,383.02,0.00
2024-12-08 14:53:02,54,381,19,35,226.32,383.09,0.00
2024-12-08 14:53:02,53,381,18,35,226.34,383.94,0.00
2024-12-08 14:53:02,53,382,18,35,233.40,384.00,0.00
2024-12-08 14:53:02,54,382,19,35,229.08,384.02,0.00
2024-12-08 14:53:02,54,383,19,35,229.09,385.00,0.00
2024-12-08 14:53:02,55,383,20,35,224.93,385.02,0.00
2024-12-08 14:53:02,54,383,20,34,227.47,385.09,0.00
2024-12-08 14:53:02,54,384,20,34,228.83,386.00,0.00
2024-12-08 14:53:02,55,384,21,34,224.67,386.02,0.00
2024-12-08 14:53:02,55,385,21,34,224.66,387.00,0.00
2024-12-08 14:53:02,56,385,22,34,220.64,387.02,0.00
2024-12-08 14:53:02,55,385,22,33,223.12,387.09,0.00
2024-12-08 14:53:02,55,386,22,33,224.39,388.00,0.00
2024-12-08 14:53:02,56,386,22,34,220.38,388.02,0.00
2024-12-08 14:53:02,55,386,21,34,221.90,388.18,0.00
2024-12-08 14:53:02,55,387,21,34,226.31,389.00,0.00
2024-12-08 14:53:02,56,387,22,34,222.27,389.02,0.00
2024-12-08 14:53:02,56,388,22,34,222.26,390.00,0.00
2024-12-08 14:53:02,57,388,23,34,218.36,390.02,0.00
2024-12-08 14:53:02,56,388,23,33,220.88,390.09,0.00
2024-12-08 14:53:02,55,388,22,33,220.60,390.93,0.00
2024-12-08 14:53:02,55,389,22,33,227.48,391.00,0.00
2024-12-08 14:53:02,56,389,22,34,223.42,391.02,0.00
2024-12-08 14:53:02,56,390,22,34,223.25,392.00,0.00
2024-12-08 14:53:02,57,390,22,35,219.33,392.02,0.00
2024-12-08 14:53:02,56,390,22,34,221.93,392.09,0.00
2024-12-08 14:53:02,56,391,22,34,223.12,393.00,0.00
2024-12-08 14:53:02,57,391,23,34,219.20,393.02,0.00
2024-12-08 14:53:02,56,391,23,33,221.79,393.09,0.00
2024-12-08 14:53:02,56,392,23,33,222.98,394.00,0.00
2024-12-08 14:53:02,57,392,23,34,219.07,394.02,0.00
2024-12-08 14:53:02,56,392,22,34,216.92,394.95,0.00
2024-12-08 14:53:02,56,393,22,34,223.80,395.00,0.00
2024-12-08 14:53:02,57,393,23,34,219.87,395.02,0.00
2024-12-08 14:53:02,57,394,23,34,219.77,396.00,0.00
2024-12-08 14:53:02,58,394,24,34,215.98,396.02,0.00
2024-12-08 14:53:02,57,394,24,33,218.32,396.11,0.00
2024-12-08 14:53:02,56,394,23,33,218.06,396.91,0.00
2024-12-08 14:53:02,56,395,23,33,224.86,397.00,0.00
2024-12-08 14:53:02,57,395,23,34,220.92,397.02,0.00
2024-12-08 14:53:02,57,396,23,34,220.94,398.00,0.00
2024-12-08 14:53:02,58,396,23,35,217.13,398.02,0.00
2024-12-08 14:53:02,57,396,23,34,219.34,398.11,0.00
2024-12-08 14:53:02,56,396,22,34,219.72,398.82,0.00
2024-12-08 14:53:02,56,397,22,34,226.28,399.00,0.00
2024-12-08 14:53:02,57,397,22,35,222.31,399.02,0.00
2024-12-08 14:53:02,56,397,21,35,221.67,399.45,0.00
2024-12-08 14:53:02,56,398,21,35,226.99,400.00,0.00
2024-12-08 14:53:02,57,398,22,35,223.01,400.02,0.00
2024-12-08 14:53:02,56,398,21,35,226.92,400.02,0.00
2024-12-08 14:53:02,55,398,21,34,229.38,400.09,0.00
2024-12-08 14:53:02,54,398,20,34,230.26,400.48,0.00
2024-12-08 14:53:02,54,399,20,34,235.98,401.00,0.00
2024-12-08 14:53:02,55,399,20,35,231.69,401.02,0.00
2024-12-08 14:53:02,54,399,19,35,229.76,401.65,0.00
2024-12-08 14:53:02,54,400,19,35,236.08,402.00,0.00
2024-12-08 14:53:02,55,400,20,35,231.79,402.02,0.00
2024-12-08 14:53:02,54,400,20,34,234.45,402.09,0.00
2024-12-08 14:53:02,53,400,19,34,235.80,402.40,0.00
2024-12-08 14:53:02,53,401,19,34,241.42,403.00,0.00
2024-12-08 14:53:02,54,401,19,35,236.95,403.02,0.00
2024-12-08 14:53:02,53,401,18,35,238.43,403.23,0.00
2024-12-08 14:53:02,53,402,18,35,243.47,404.00,0.00
2024-12-08 14:53:02,54,402,19,35,238.96,404.02,0.00
2024-12-08 14:53:02,53,402,18,35,243.39,404.02,0.00
2024-12-08 14:53:02,52,402,18,34,246.52,404.08,0.00
2024-12-08 14:53:02,52,403,18,34,248.06,405.00,0.00
2024-12-08 14:53:02,53,403,18,35,243.38,405.02,0.00
2024-12-08 14:53:02,52,403,17,35,247.72,405.08,0.00
2024-12-08 14:53:02,52,404,17,35,250.83,406.00,0.00
2024-12-08 14:53:02,53,404,17,36,246.10,406.02,0.00
2024-12-08 14:53:02,52,404,17,35,249.27,406.08,0.00
2024-12-08 14:53:03,52,405,17,35,250.82,407.00,0.00
2024-12-08 14:53:03,53,405,18,35,246.09,407.02,0.00
2024-12-08 14:53:03,53,406,18,35,245.96,408.00,0.00
2024-12-08 14:53:03,54,406,19,35,241.40,408.02,0.00
2024-12-08 14:53:03,53,406,18,35,245.88,408.02,0.00
2024-12-08 14:53:03,52,406,18,34,249.20,408.06,0.00
2024-12-08 14:53:03,52,407,18,34,250.67,409.00,0.00
2024-12-08 14:53:03,53,407,19,34,245.94,409.02,0.00
2024-12-08 14:53:03,52,407,19,33,250.52,409.04,0.00
2024-12-08 14:53:03,52,408,19,33,250.47,410.00,0.00
2024-12-08 14:53:03,53,408,19,34,245.74,410.02,0.00
2024-12-08 14:53:03,52,408,19,33,249.13,410.04,0.00
2024-12-08 14:53:03,52,409,19,33,250.53,411.00,0.00
2024-12-08 14:53:03,53,409,20,33,245.80,411.02,0.00
2024-12-08 14:53:03,52,409,19,33,247.38,411.21,0.00
2024-12-08 14:53:03,52,410,19,33,252.59,412.00,0.00
2024-12-08 14:53:03,53,410,20,33,247.82,412.02,0.00
2024-12-08 14:53:03,52,410,20,32,250.93,412.06,0.00
2024-12-08 14:53:03,52,411,20,32,252.41,413.00,0.00
2024-12-08 14:53:03,53,411,21,32,247.65,413.02,0.00
2024-12-08 14:53:03,53,412,21,32,247.58,414.00,0.00
2024-12-08 14:53:03,54,412,21,33,243.00,414.02,0.00
2024-12-08 14:53:03,53,412,21,32,245.95,414.06,0.00
2024-12-08 14:53:03,53,413,21,32,247.32,415.00,0.00
2024-12-08 14:53:03,54,413,22,32,242.74,415.02,0.00
2024-12-08 14:53:03,53,413,21,32,247.24,415.02,0.00
2024-12-08 14:53:03,53,414,21,32,247.17,416.00,0.00
2024-12-08 14:53:03,54,414,22,32,242.59,416.02,0.00
2024-12-08 14:53:03,53,414,22,31,245.68,416.04,0.00
2024-12-08 14:53:03,53,415,22,31,246.97,417.00,0.00
2024-12-08 14:53:03,54,415,23,31,242.40,417.02,0.00
2024-12-08 14:53:03,53,415,22,31,240.48,417.94,0.00
2024-12-08 14:53:03,53,416,22,31,248.16,418.00,0.00
2024-12-08 14:53:03,54,416,22,32,243.56,418.02,0.00
2024-12-08 14:53:03,53,416,22,31,246.74,418.04,0.00
2024-12-08 14:53:03,53,417,22,31,248.04,419.00,0.00
2024-12-08 14:53:03,54,417,23,31,243.45,419.02,0.00
2024-12-08 14:53:03,54,418,23,31,243.13,420.00,0.00
2024-12-08 14:53:03,55,418,23,32,238.71,420.02,0.00
2024-12-08 14:53:03,54,418,23,31,241.82,420.04,0.00
2024-12-08 14:53:03,54,419,23,31,243.01,421.00,0.00
2024-12-08 14:53:03,55,419,23,32,238.59,421.02,0.00
2024-12-08 14:53:03,55,420,23,32,238.28,422.00,0.00
2024-12-08 14:53:03,56,420,23,33,234.02,422.02,0.00
2024-12-08 14:53:03,55,420,23,32,237.05,422.04,0.00
2024-12-08 14:53:03,54,420,22,32,237.56,422.83,0.00
2024-12-08 14:53:03,54,421,22,32,244.79,423.00,0.00
2024-12-08 14:53:03,55,421,23,32,240.34,423.02,0.00
2024-12-08 14:53:03,55,422,23,32,240.01,424.00,0.00
2024-12-08 14:53:03,56,422,23,33,235.72,424.02,0.00
2024-12-08 14:53:03,55,422,23,32,238.85,424.04,0.00
2024-12-08 14:53:03,55,423,23,32,239.95,425.00,0.00
2024-12-08 14:53:03,56,423,24,32,235.67,425.02,0.00
2024-12-08 14:53:03,56,424,24,32,235.33,426.00,0.00
2024-12-08 14:53:03,57,424,25,32,231.20,426.02,0.00
2024-12-08 14:53:03,56,424,25,31,234.27,426.04,0.00
2024-12-08 14:53:03,56,425,25,31,235.27,427.00,0.00
2024-12-08 14:53:03,57,425,26,31,231.15,427.02,0.00
2024-12-08 14:53:03,57,426,26,31,231.00,428.00,0.00
2024-12-08 14:53:03,58,426,26,32,227.02,428.02,0.00
2024-12-08 14:53:03,57,426,26,31,229.73,428.04,0.00
2024-12-08 14:53:03,56,426,25,31,233.74,428.05,0.00
2024-12-08 14:53:03,56,427,25,31,234.81,429.00,0.00
2024-12-08 14:53:03,57,427,25,32,230.69,429.02,0.00
2024-12-08 14:53:03,56,427,24,32,233.06,429.07,0.00
2024-12-08 14:53:03,56,428,24,32,234.71,430.00,0.00
2024-12-08 14:53:03,57,428,25,32,230.59,430.02,0.00
2024-12-08 14:53:03,56,428,25,31,233.48,430.04,0.00
2024-12-08 14:53:03,55,428,24,31,237.66,430.05,0.00
2024-12-08 14:53:03,54,428,23,31,240.36,430.50,0.00
2024-12-08 14:53:03,53,428,22,31,241.24,430.96,0.00
2024-12-08 14:53:03,53,429,22,31,249.23,431.00,0.00
2024-12-08 14:53:03,54,429,22,32,244.62,431.02,0.00
2024-12-08 14:53:03,54,430,22,32,244.48,432.00,0.00
2024-12-08 14:53:03,55,430,23,32,240.03,432.02,0.00
2024-12-08 14:53:03,54,430,23,31,243.12,432.04,0.00
2024-12-08 14:53:03,53,430,22,31,245.55,432.60,0.00
2024-12-08 14:53:03,53,431,22,31,252.27,433.00,0.00
2024-12-08 14:53:03,54,431,23,31,247.60,433.02,0.00
2024-12-08 14:53:03,54,432,23,31,247.53,434.00,0.00
2024-12-08 14:53:03,55,432,24,31,243.03,434.02,0.00
2024-12-08 14:53:03,54,432,24,30,246.09,434.04,0.00
2024-12-08 14:53:03,54,433,24,30,247.30,435.00,0.00
2024-12-08 14:53:03,55,433,25,30,242.80,435.02,0.00
2024-12-08 14:53:03,55,434,25,30,242.84,436.00,0.00
2024-12-08 14:53:03,56,434,26,30,238.50,436.02,0.00
2024-12-08 14:53:04,56,435,26,30,238.37,437.00,0.00
2024-12-08 14:53:04,57,435,27,30,234.19,437.02,0.00
2024-12-08 14:53:04,56,435,27,29,237.13,437.04,0.00
2024-12-08 14:53:04,55,435,26,29,239.06,437.64,0.00
2024-12-08 14:53:04,55,436,26,29,242.51,438.00,0.00
2024-12-08 14:53:04,56,436,27,29,238.18,438.02,0.00
2024-12-08 14:53:04,55,436,26,29,242.42,438.04,0.00
2024-12-08 14:53:04,54,436,26,28,245.61,438.04,0.00
2024-12-08 14:53:04,54,437,26,28,246.82,439.00,0.00
2024-12-08 14:53:04,55,437,26,29,242.33,439.02,0.00
2024-12-08 14:53:04,55,438,26,29,242.17,440.00,0.00
2024-12-08 14:53:04,56,438,27,29,237.85,440.02,0.00
2024-12-08 14:53:04,55,438,27,28,240.89,440.04,0.00
2024-12-08 14:53:04,55,439,27,28,242.00,441.00,0.00
2024-12-08 14:53:04,56,439,28,28,237.68,441.02,0.00
2024-12-08 14:53:04,57,438,29,28,228.58,441.23,0.00
2024-12-08 14:53:04,57,439,29,28,237.42,442.00,0.00
2024-12-08 14:53:04,58,439,30,28,233.33,442.02,0.00
2024-12-08 14:53:04,57,439,30,27,236.26,442.04,0.00
2024-12-08 14:53:04,56,439,29,27,239.05,442.16,0.00
2024-12-08 14:53:04,56,440,29,27,251.65,443.00,0.00
2024-12-08 14:53:04,57,440,30,27,247.24,443.02,0.00
2024-12-08 14:53:04,57,441,30,27,247.02,444.00,0.00
2024-12-08 14:53:04,58,441,31,27,242.76,444.02,0.00
2024-12-08 14:53:04,57,441,30,27,246.90,444.04,0.00
2024-12-08 14:53:04,56,441,30,26,250.11,444.04,0.00
2024-12-08 14:53:04,56,442,30,26,251.15,445.00,0.00
2024-12-08 14:53:04,57,442,31,26,246.75,445.02,0.00
2024-12-08 14:53:04,57,443,31,26,246.53,446.00,0.00
2024-12-08 14:53:04,58,443,31,27,242.28,446.02,0.00
2024-12-08 14:53:04,57,443,31,26,245.28,446.04,0.00
2024-12-08 14:53:04,57,444,31,26,246.22,447.00,0.00
2024-12-08 14:53:04,58,444,32,26,241.98,447.02,0.00
2024-12-08 14:53:04,57,444,31,26,246.14,447.02,0.00
2024-12-08 14:53:04,56,444,30,26,246.64,447.59,0.00
2024-12-08 14:53:04,55,444,29,26,248.25,447.91,0.00
2024-12-08 14:53:04,55,445,29,26,256.05,448.00,0.00
2024-12-08 14:53:04,56,445,30,26,251.48,448.02,0.00
2024-12-08 14:53:04,55,445,30,25,254.91,448.02,0.00
2024-12-08 14:53:04,55,446,30,25,255.97,449.00,0.00
2024-12-08 14:53:04,56,446,31,25,251.40,449.02,0.00
2024-12-08 14:53:04,56,447,31,25,251.00,450.00,0.00
2024-12-08 14:53:04,57,447,31,26,246.60,450.02,0.00
2024-12-08 14:53:04,56,447,31,25,249.96,450.02,0.00
2024-12-08 14:53:04,56,448,31,25,250.92,451.00,0.00
2024-12-08 14:53:04,57,448,31,26,246.51,451.02,0.00
2024-12-08 14:53:04,57,449,31,26,246.09,452.00,0.00
2024-12-08 14:53:04,58,449,32,26,241.84,452.02,0.00
2024-12-08 14:53:04,57,449,32,25,245.13,452.02,0.00
2024-12-08 14:53:04,57,450,32,25,245.99,453.00,0.00
2024-12-08 14:53:04,58,450,33,25,241.75,453.02,0.00
2024-12-08 14:53:04,58,451,33,25,243.41,454.00,0.00
2024-12-08 14:53:04,59,451,33,26,239.28,454.02,0.00
2024-12-08 14:53:04,59,452,33,26,240.52,455.00,0.00
2024-12-08 14:53:04,60,452,33,27,236.51,455.02,0.00
2024-12-08 14:53:04,60,453,33,27,236.83,456.00,0.00
2024-12-08 14:53:04,61,453,33,28,232.95,456.02,0.00
2024-12-08 14:53:04,61,454,33,28,232.10,457.00,0.00
2024-12-08 14:53:04,62,454,33,29,228.36,457.02,0.00
2024-12-08 14:53:04,61,454,33,28,231.66,457.03,0.00
2024-12-08 14:53:04,61,455,33,28,232.23,458.00,0.00
2024-12-08 14:53:04,62,455,33,29,228.49,458.02,0.00
2024-12-08 14:53:04,62,456,33,29,228.08,459.00,0.00
2024-12-08 14:53:04,63,456,34,29,224.46,459.02,0.00
2024-12-08 14:53:04,62,456,34,28,227.05,459.03,0.00
2024-12-08 14:53:04,62,457,34,28,227.54,460.00,0.00
2024-12-08 14:53:04,63,457,34,29,223.92,460.02,0.00
2024-12-08 14:53:04,63,458,34,29,223.48,461.00,0.00
2024-12-08 14:53:04,64,458,34,30,219.98,461.02,0.00
2024-12-08 14:53:04,63,458,34,29,222.53,461.03,0.00
2024-12-08 14:53:04,63,459,34,29,222.93,462.00,0.00
2024-12-08 14:53:04,64,459,34,30,219.45,462.02,0.00
2024-12-08 14:53:04,63,459,33,30,219.03,462.59,0.00
2024-12-08 14:53:04,63,460,33,30,222.52,463.00,0.00
2024-12-08 14:53:04,64,460,33,31,219.05,463.02,0.00
2024-12-08 14:53:04,63,460,33,30,221.50,463.05,0.00
2024-12-08 14:53:04,62,460,32,30,224.66,463.15,0.00
2024-12-08 14:53:04,61,460,31,30,226.48,463.59,0.00
2024-12-08 14:53:04,60,460,30,30,228.18,463.78,0.00
2024-12-08 14:53:04,60,461,30,30,235.06,464.00,0.00
2024-12-08 14:53:04,61,461,30,31,231.21,464.02,0.00
2024-12-08 14:53:04,60,461,29,31,227.98,464.77,0.00
2024-12-08 14:53:04,60,462,29,31,234.81,465.00,0.00
2024-12-08 14:53:04,61,462,29,32,230.96,465.02,0.00
2024-12-08 14:53:04,60,462,29,31,233.51,465.08,0.00
2024-12-08 14:53:04,59,462,28,31,237.18,465.15,0.00
2024-12-08 14:53:05,58,462,27,31,237.83,465.74,0.00
2024-12-08 14:53:05,58,463,27,31,244.85,466.00,0.00
2024-12-08 14:53:05,59,463,28,31,240.70,466.02,0.00
2024-12-08 14:53:05,59,464,28,31,240.38,467.00,0.00
2024-12-08 14:53:05,60,464,29,31,236.38,467.02,0.00
2024-12-08 14:53:05,59,464,29,30,239.13,467.08,0.00
2024-12-08 14:53:05,59,465,29,30,240.11,468.00,0.00
2024-12-08 14:53:05,60,465,30,30,236.10,468.02,0.00
2024-12-08 14:53:05,60,466,30,30,235.73,469.00,0.00
2024-12-08 14:53:05,61,466,30,31,231.87,469.02,0.00
2024-12-08 14:53:05,60,466,30,30,234.58,469.08,0.00
2024-12-08 14:53:05,59,466,29,30,236.08,469.66,0.00
2024-12-08 14:53:05,59,467,29,30,239.51,470.00,0.00
2024-12-08 14:53:05,60,467,29,31,235.52,470.02,0.00
2024-12-08 14:53:05,59,467,28,31,237.24,470.17,0.00
2024-12-08 14:53:05,59,468,28,31,239.22,471.00,0.00
2024-12-08 14:53:05,60,468,29,31,235.24,471.02,0.00
2024-12-08 14:53:05,59,468,29,30,238.04,471.08,0.00
2024-12-08 14:53:05,58,468,28,30,238.99,471.36,0.00
2024-12-08 14:53:05,58,469,28,30,244.52,472.00,0.00
2024-12-08 14:53:05,59,469,28,31,240.37,472.02,0.00
2024-12-08 14:53:05,59,470,28,31,240.06,473.00,0.00
2024-12-08 14:53:05,60,470,28,32,236.06,473.02,0.00
2024-12-08 14:53:05,59,470,28,31,238.87,473.08,0.00
2024-12-08 14:53:05,58,470,27,31,240.76,473.59,0.00
2024-12-08 14:53:05,57,470,26,31,241.68,473.93,0.00
2024-12-08 14:53:05,57,471,26,31,249.72,474.00,0.00
2024-12-08 14:53:05,58,471,26,32,245.41,474.02,0.00
2024-12-08 14:53:05,57,471,25,32,244.04,474.42,0.00
2024-12-08 14:53:05,57,472,25,32,250.01,475.00,0.00
2024-12-08 14:53:05,58,472,25,33,245.70,475.02,0.00
2024-12-08 14:53:05,57,472,25,32,248.77,475.09,0.00
2024-12-08 14:53:05,56,472,24,32,253.02,475.11,0.00
2024-12-08 14:53:05,57,471,25,32,245.53,475.86,0.00
2024-12-08 14:53:05,57,472,25,32,254.09,476.00,0.00
2024-12-08 14:53:05,58,472,26,32,249.71,476.02,0.00
2024-12-08 14:53:05,57,472,25,32,251.90,476.12,0.00
2024-12-08 14:53:05,56,472,24,32,256.24,476.14,0.00
2024-12-08 14:53:05,56,473,24,32,269.70,477.00,0.00
2024-12-08 14:53:05,57,473,25,32,264.96,477.02,0.00
2024-12-08 14:53:05,56,473,25,31,268.51,477.09,0.00
2024-12-08 14:53:05,55,473,24,31,271.61,477.49,0.00
2024-12-08 14:53:05,55,474,24,31,274.78,478.00,0.00
2024-12-08 14:53:05,56,474,24,32,269.87,478.02,0.00
2024-12-08 14:53:05,55,474,23,32,272.54,478.13,0.00
2024-12-08 14:53:05,54,474,22,32,276.39,478.24,0.00
2024-12-08 14:53:05,54,475,22,32,282.14,479.00,0.00
2024-12-08 14:53:05,55,475,23,32,277.01,479.02,0.00
2024-12-08 14:53:05,54,475,23,31,280.73,479.09,0.00
2024-12-08 14:53:05,53,475,22,31,282.15,479.13,0.00
2024-12-08 14:53:05,52,475,21,31,285.89,479.52,0.00
2024-12-08 14:53:05,52,476,21,31,293.19,480.00,0.00
2024-12-08 14:53:05,53,476,21,32,287.66,480.02,0.00
2024-12-08 14:53:05,53,477,21,32,287.42,481.00,0.00
2024-12-08 14:53:05,54,477,21,33,282.10,481.02,0.00
2024-12-08 14:53:05,53,477,21,32,285.80,481.09,0.00
2024-12-08 14:53:05,53,478,21,32,287.47,482.00,0.00
2024-12-08 14:53:05,54,478,22,32,282.15,482.02,0.00
2024-12-08 14:53:05,53,478,21,32,280.53,482.91,0.00
2024-12-08 14:53:05,53,479,21,32,289.25,483.00,0.00
2024-12-08 14:53:05,54,479,21,33,283.90,483.02,0.00
2024-12-08 14:53:05,53,479,21,32,287.44,483.09,0.00
2024-12-08 14:53:05,53,480,21,32,289.12,484.00,0.00
2024-12-08 14:53:05,54,480,21,33,283.77,484.02,0.00
2024-12-08 14:53:05,54,481,21,33,283.65,485.00,0.00
2024-12-08 14:53:05,55,481,21,34,278.49,485.02,0.00
2024-12-08 14:53:05,54,481,21,33,281.86,485.09,0.00
2024-12-08 14:53:05,53,481,20,33,281.40,485.96,0.00
2024-12-08 14:53:05,53,482,20,33,290.41,486.00,0.00
2024-12-08 14:53:05,54,482,21,33,285.03,486.02,0.00
2024-12-08 14:53:05,53,482,20,33,290.32,486.02,0.00
2024-12-08 14:53:05,53,483,20,33,290.25,487.00,0.00
2024-12-08 14:53:05,54,483,21,33,284.88,487.02,0.00
2024-12-08 14:53:05,53,483,21,32,288.60,487.08,0.00
2024-12-08 14:53:05,53,484,21,32,290.21,488.00,0.00
2024-12-08 14:53:05,54,484,22,32,284.83,488.02,0.00
2024-12-08 14:53:05,54,485,22,32,284.57,489.00,0.00
2024-12-08 14:53:05,55,485,23,32,279.39,489.02,0.00
2024-12-08 14:53:05,54,485,23,31,283.03,489.07,0.00
2024-12-08 14:53:05,53,485,22,31,286.52,489.49,0.00
2024-12-08 14:53:05,53,486,22,31,289.95,490.00,0.00
2024-12-08 14:53:05,54,486,23,31,284.58,490.02,0.00
2024-12-08 14:53:05,54,487,23,31,284.25,491.00,0.00
2024-12-08 14:53:05,55,487,23,32,279.08,491.02,0.00
2024-12-08 14:53:05,54,487,23,31,282.71,491.07,0.00
2024-12-08 14:53:05,54,488,23,31,284.19,492.00,0.00
2024-12-08 14:53:05,55,488,24,31,279.03,492.02,0.00
2024-12-08 14:53:05,55,489,24,31,278.89,493.00,0.00
2024-12-08 14:53:05,56,489,24,32,273.91,493.02,0.00
2024-12-08 14:53:05,55,489,23,32,278.80,493.02,0.00
2024-12-08 14:53:05,54,489,23,31,282.32,493.06,0.00
2024-12-08 14:53:05,54,490,23,31,283.71,494.00,0.00
2024-12-08 14:53:05,55,490,23,32,278.56,494.02,0.00
2024-12-08 14:53:05,54,490,22,32,281.44,494.11,0.00
2024-12-08 14:53:05,53,490,21,32,284.51,494.60,0.00
2024-12-08 14:53:06,53,491,21,32,288.97,495.00,0.00
2024-12-08 14:53:06,54,491,21,33,283.62,495.02,0.00
2024-12-08 14:53:06,53,491,20,33,288.88,495.02,0.00
2024-12-08 14:53:06,52,491,20,32,292.91,495.04,0.00
2024-12-08 14:53:06,51,491,19,32,292.36,495.96,0.00
2024-12-08 14:53:06,51,492,19,32,301.92,496.00,0.00
2024-12-08 14:53:06,52,492,20,32,296.11,496.02,0.00
2024-12-08 14:53:06,51,492,19,32,301.82,496.02,0.00
2024-12-08 14:53:06,50,492,18,32,307.74,496.02,0.00
2024-12-08 14:53:06,50,493,18,32,311.44,497.00,0.00
2024-12-08 14:53:06,51,493,18,33,305.34,497.02,0.00
2024-12-08 14:53:06,50,493,18,32,309.95,497.02,0.00
2024-12-08 14:53:06,49,493,17,32,316.18,497.04,0.00
2024-12-08 14:53:06,49,494,17,32,318.13,498.00,0.00
2024-12-08 14:53:06,50,494,17,33,311.77,498.02,0.00
2024-12-08 14:53:06,50,495,17,33,311.70,499.00,0.00
2024-12-08 14:53:06,51,495,17,34,305.59,499.02,0.00
2024-12-08 14:53:06,50,495,17,33,309.42,499.06,0.00
2024-12-08 14:53:06,49,495,16,33,315.33,499.06,0.00
2024-12-08 14:53:06,49,496,16,33,321.45,500.00,0.00
2024-12-08 14:53:06,50,496,17,33,315.02,500.02,0.00
2024-12-08 14:53:06,50,497,17,33,315.39,501.00,0.00
2024-12-08 14:53:06,51,497,18,33,309.20,501.02,0.00
2024-12-08 14:53:06,51,498,18,33,308.84,502.00,0.00
2024-12-08 14:53:06,52,498,18,34,302.90,502.02,0.00
2024-12-08 14:53:06,51,498,18,33,307.98,502.10,0.00
2024-12-08 14:53:06,51,499,18,33,309.94,503.00,0.00
2024-12-08 14:53:06,52,499,18,34,303.98,503.02,0.00
2024-12-08 14:53:06,52,500,18,34,304.42,504.00,0.00
2024-12-08 14:53:06,53,500,18,35,298.68,504.02,0.00
2024-12-08 14:53:06,52,500,17,35,299.48,504.52,0.00
2024-12-08 14:53:06,52,501,17,35,307.10,505.00,0.00
2024-12-08 14:53:06,53,501,17,36,301.31,505.02,0.00
2024-12-08 14:53:06,52,501,17,35,306.16,505.10,0.00
2024-12-08 14:53:06,52,502,17,35,308.00,506.00,0.00
2024-12-08 14:53:06,53,502,17,36,302.19,506.02,0.00
2024-12-08 14:53:06,52,502,16,36,302.50,506.35,0.00
2024-12-08 14:53:06,52,503,16,36,309.39,507.00,0.00
2024-12-08 14:53:06,53,503,17,36,303.55,507.02,0.00
2024-12-08 14:53:06,53,504,17,36,303.00,508.00,0.00
2024-12-08 14:53:06,54,504,17,37,297.39,508.02,0.00
2024-12-08 14:53:06,53,504,17,36,302.26,508.09,0.00
2024-12-08 14:53:06,52,504,16,36,303.37,508.87,0.00
2024-12-08 14:53:06,52,505,16,36,312.57,509.00,0.00
2024-12-08 14:53:06,53,505,16,37,306.67,509.02,0.00
2024-12-08 14:53:06,53,506,16,37,306.98,510.00,0.00
2024-12-08 14:53:06,54,506,16,38,301.29,510.02,0.00
2024-12-08 14:53:06,54,507,16,38,300.65,511.00,0.00
2024-12-08 14:53:06,55,507,16,39,295.19,511.02,0.00
2024-12-08 14:53:06,54,507,16,38,299.82,511.11,0.00
2024-12-08 14:53:06,53,507,15,38,299.26,511.94,0.00
2024-12-08 14:53:06,53,508,15,38,308.67,512.00,0.00
2024-12-08 14:53:06,54,508,16,38,302.96,512.02,0.00
2024-12-08 14:53:06,53,508,15,38,308.21,512.09,0.00
2024-12-08 14:53:06,53,509,15,38,311.89,513.00,0.00
2024-12-08 14:53:06,54,509,15,39,306.11,513.02,0.00
2024-12-08 14:53:06,54,510,15,39,305.47,514.00,0.00
2024-12-08 14:53:06,55,510,16,39,299.92,514.02,0.00
2024-12-08 14:53:06,54,510,16,38,304.92,514.09,0.00
2024-12-08 14:53:06,54,511,16,38,306.54,515.00,0.00
2024-12-08 14:53:06,55,511,17,38,300.97,515.02,0.00
2024-12-08 14:53:06,55,512,17,38,300.94,516.00,0.00
2024-12-08 14:53:06,56,512,17,39,295.57,516.02,0.00
2024-12-08 14:53:06,55,512,17,38,298.61,516.09,0.00
2024-12-08 14:53:06,55,513,17,38,300.11,517.00,0.00
2024-12-08 14:53:06,56,513,18,38,294.76,517.02,0.00
2024-12-08 14:53:06,56,514,18,38,294.64,518.00,0.00
2024-12-08 14:53:06,57,514,19,38,289.47,518.02,0.00
2024-12-08 14:53:06,56,514,19,37,292.44,518.09,0.00
2024-12-08 14:53:06,55,514,18,37,291.35,518.96,0.00
2024-12-08 14:53:06,55,515,18,37,300.62,519.00,0.00
2024-12-08 14:53:06,56,515,18,38,295.25,519.02,0.00
2024-12-08 14:53:06,56,516,18,38,295.11,520.00,0.00
2024-12-08 14:53:06,57,516,19,38,289.93,520.02,0.00
2024-12-08 14:53:06,56,516,19,37,292.99,520.09,0.00
2024-12-08 14:53:06,56,517,19,37,294.37,521.00,0.00
2024-12-08 14:53:06,57,517,19,38,289.21,521.02,0.00
2024-12-08 14:53:06,56,517,18,38,285.75,521.96,0.00
2024-12-08 14:53:06,56,518,18,38,294.90,522.00,0.00
2024-12-08 14:53:06,57,518,18,39,289.73,522.02,0.00
2024-12-08 14:53:06,56,518,18,38,292.77,522.09,0.00
2024-12-08 14:53:06,55,518,17,38,291.47,522.69,0.00
2024-12-08 14:53:06,55,519,17,38,299.60,523.00,0.00
2024-12-08 14:53:06,56,519,18,38,294.25,523.02,0.00
2024-12-08 14:53:06,55,519,17,38,296.42,523.18,0.00
2024-12-08 14:53:06,55,520,17,38,302.18,524.00,0.00
2024-12-08 14:53:06,56,520,18,38,296.78,524.02,0.00
2024-12-08 14:53:06,55,520,18,37,300.09,524.09,0.00
2024-12-08 14:53:07,55,521,18,37,301.61,525.00,0.00
2024-12-08 14:53:07,56,521,19,37,296.22,525.02,0.00
2024-12-08 14:53:07,56,522,19,37,295.99,526.00,0.00
2024-12-08 14:53:07,57,522,20,37,290.80,526.02,0.00
2024-12-08 14:53:07,56,522,20,36,294.03,526.09,0.00
2024-12-08 14:53:07,56,523,20,36,295.42,527.00,0.00
2024-12-08 14:53:07,57,523,21,36,290.24,527.02,0.00
2024-12-08 14:53:07,57,524,21,36,289.96,528.00,0.00
2024-12-08 14:53:07,58,524,21,37,284.96,528.02,0.00
2024-12-08 14:53:07,57,524,21,36,288.11,528.09,0.00
2024-12-08 14:53:07,57,525,21,36,289.39,529.00,0.00
2024-12-08 14:53:07,58,525,22,36,284.40,529.02,0.00
2024-12-08 14:53:07,57,525,21,36,281.29,529.91,0.00
2024-12-08 14:53:07,57,526,21,36,290.17,530.00,0.00
2024-12-08 14:53:07,58,526,21,37,285.17,530.02,0.00
2024-12-08 14:53:07,57,526,21,36,288.41,530.09,0.00
2024-12-08 14:53:07,57,527,21,36,289.69,531.00,0.00
2024-12-08 14:53:07,58,527,22,36,284.70,531.02,0.00
2024-12-08 14:53:07,58,528,22,36,284.93,532.00,0.00
2024-12-08 14:53:07,59,528,23,36,280.10,532.02,0.00
2024-12-08 14:53:07,58,528,22,36,279.57,532.72,0.00
2024-12-08 14:53:07,58,529,22,36,283.82,533.00,0.00
2024-12-08 14:53:07,59,529,23,36,279.01,533.02,0.00
2024-12-08 14:53:07,58,529,23,35,283.18,533.09,0.00
2024-12-08 14:53:07,58,530,23,35,284.35,534.00,0.00
2024-12-08 14:53:07,59,530,24,35,279.53,534.02,0.00
2024-12-08 14:53:07,58,530,23,35,284.26,534.02,0.00
2024-12-08 14:53:07,57,530,22,35,282.94,534.47,0.00
2024-12-08 14:53:07,57,531,22,35,289.88,535.00,0.00
2024-12-08 14:53:07,58,531,23,35,284.88,535.02,0.00
2024-12-08 14:53:07,57,531,23,34,288.19,535.07,0.00
2024-12-08 14:53:07,57,532,23,34,289.39,536.00,0.00
2024-12-08 14:53:07,58,532,23,35,284.40,536.02,0.00
2024-12-08 14:53:07,57,532,22,35,284.68,536.33,0.00
2024-12-08 14:53:07,57,533,22,35,290.96,537.00,0.00
2024-12-08 14:53:07,58,533,22,36,285.95,537.02,0.00
2024-12-08 14:53:07,57,533,22,35,289.36,537.07,0.00
2024-12-08 14:53:07,57,534,22,35,290.56,538.00,0.00
2024-12-08 14:53:07,58,534,23,35,285.55,538.02,0.00
2024-12-08 14:53:07,57,534,22,35,290.47,538.02,0.00
2024-12-08 14:53:07,57,535,22,35,290.19,539.00,0.00
2024-12-08 14:53:07,58,535,22,36,285.19,539.02,0.00
2024-12-08 14:53:07,57,535,22,35,288.68,539.05,0.00
2024-12-08 14:53:07,57,536,22,35,289.78,540.00,0.00
2024-12-08 14:53:07,58,536,23,35,284.78,540.02,0.00
2024-12-08 14:53:07,57,536,22,35,287.35,540.11,0.00
2024-12-08 14:53:07,57,537,22,35,289.33,541.00,0.00
2024-12-08 14:53:07,58,537,23,35,284.35,541.02,0.00
2024-12-08 14:53:07,57,537,22,35,289.24,541.02,0.00
2024-12-08 14:53:07,56,537,22,34,293.05,541.04,0.00
2024-12-08 14:53:07,56,538,22,34,294.17,542.00,0.00
2024-12-08 14:53:07,57,538,22,35,289.01,542.02,0.00
2024-12-08 14:53:07,56,538,21,35,294.08,542.02,0.00
2024-12-08 14:53:07,57,537,22,35,285.58,542.33,0.00
2024-12-08 14:53:07,57,538,22,35,292.96,543.00,0.00
2024-12-08 14:53:07,58,538,22,36,287.91,543.02,0.00
2024-12-08 14:53:07,57,538,22,35,291.82,543.02,0.00
2024-12-08 14:53:07,57,539,22,35,302.28,544.00,0.00
2024-12-08 14:53:07,58,539,22,36,297.07,544.02,0.00
2024-12-08 14:53:07,57,539,21,36,300.11,544.05,0.00
2024-12-08 14:53:07,56,539,20,36,298.90,544.95,0.00
2024-12-08 14:53:07,56,540,20,36,308.38,545.00,0.00
2024-12-08 14:53:07,57,540,21,36,302.97,545.02,0.00
2024-12-08 14:53:07,56,540,21,35,307.30,545.02,0.00
2024-12-08 14:53:07,56,541,21,35,308.36,546.00,0.00
2024-12-08 14:53:07,57,541,22,35,302.95,546.02,0.00
2024-12-08 14:53:07,56,541,21,35,305.76,546.13,0.00
2024-12-08 14:53:07,56,542,21,35,311.27,547.00,0.00
2024-12-08 14:53:07,57,542,22,35,305.80,547.02,0.00
2024-12-08 14:53:07,56,542,22,34,310.09,547.02,0.00
2024-12-08 14:53:07,56,543,22,34,311.15,548.00,0.00
2024-12-08 14:53:07,57,543,23,34,305.69,548.02,0.00
2024-12-08 14:53:07,57,544,23,34,305.02,549.00,0.00
2024-12-08 14:53:07,58,544,23,35,299.76,549.02,0.00
2024-12-08 14:53:07,57,544,23,34,303.86,549.02,0.00
2024-12-08 14:53:07,57,545,23,34,304.80,550.00,0.00
2024-12-08 14:53:07,58,545,24,34,299.55,550.02,0.00
2024-12-08 14:53:07,57,545,23,34,302.23,550.12,0.00
2024-12-08 14:53:07,57,546,23,34,304.08,551.00,0.00
2024-12-08 14:53:07,58,546,24,34,298.84,551.02,0.00
2024-12-08 14:53:07,57,546,24,33,303.02,551.02,0.00
2024-12-08 14:53:07,56,546,23,33,308.09,551.07,0.00
2024-12-08 14:53:07,55,546,22,33,310.71,551.65,0.00
2024-12-08 14:53:07,54,546,21,33,312.81,551.96,0.00
2024-12-08 14:53:07,54,547,21,33,322.84,552.00,0.00
2024-12-08 14:53:07,55,547,21,34,316.97,552.02,0.00
2024-12-08 14:53:08,55,548,21,34,316.21,553.00,0.00
2024-12-08 14:53:08,56,548,21,35,310.57,553.02,0.00
2024-12-08 14:53:08,55,548,21,34,315.11,553.02,0.00
2024-12-08 14:53:08,55,549,21,34,316.28,554.00,0.00
2024-12-08 14:53:08,56,549,22,34,310.63,554.02,0.00
2024-12-08 14:53:08,55,549,21,34,307.68,554.96,0.00
2024-12-08 14:53:08,55,550,21,34,317.59,555.00,0.00
2024-12-08 14:53:08,56,550,21,35,311.91,555.02,0.00
2024-12-08 14:53:08,55,550,21,34,316.58,555.02,0.00
2024-12-08 14:53:08,55,551,21,34,317.75,556.00,0.00
2024-12-08 14:53:08,56,551,21,35,312.08,556.02,0.00
2024-12-08 14:53:08,55,551,20,35,311.12,556.76,0.00
2024-12-08 14:53:08,55,552,20,35,320.12,557.00,0.00
2024-12-08 14:53:08,56,552,21,35,314.41,557.02,0.00
2024-12-08 14:53:08,55,552,21,34,319.21,557.02,0.00
2024-12-08 14:53:08,55,553,21,34,320.39,558.00,0.00
2024-12-08 14:53:08,56,553,22,34,314.67,558.02,0.00
2024-12-08 14:53:08,55,553,21,34,317.15,558.02,0.00
2024-12-08 14:53:08,54,553,20,34,318.61,558.46,0.00
2024-12-08 14:53:08,54,554,20,34,326.32,559.00,0.00
2024-12-08 14:53:08,55,554,21,34,320.39,559.02,0.00
2024-12-08 14:53:08,54,554,21,33,324.97,559.02,0.00
2024-12-08 14:53:08,54,555,21,33,326.28,560.00,0.00
2024-12-08 14:53:08,55,555,21,34,320.35,560.02,0.00
2024-12-08 14:53:08,54,555,20,34,317.64,560.59,0.00
2024-12-08 14:53:08,54,556,20,34,326.03,561.00,0.00
2024-12-08 14:53:08,55,556,20,35,320.10,561.02,0.00
2024-12-08 14:53:08,54,556,20,34,324.68,561.02,0.00
2024-12-08 14:53:08,54,557,20,34,325.99,562.00,0.00
2024-12-08 14:53:08,55,557,21,34,320.06,562.02,0.00
2024-12-08 14:53:08,55,558,21,34,319.35,563.00,0.00
2024-12-08 14:53:08,56,558,22,34,313.65,563.02,0.00
2024-12-08 14:53:08,55,558,22,33,318.12,563.02,0.00
2024-12-08 14:53:08,54,558,21,33,321.21,563.56,0.00
2024-12-08 14:53:08,54,559,21,33,325.28,564.00,0.00
2024-12-08 14:53:08,55,559,21,34,319.37,564.02,0.00
2024-12-08 14:53:08,54,559,20,34,319.89,564.65,0.00
2024-12-08 14:53:08,54,560,20,34,327.51,565.00,0.00
2024-12-08 14:53:08,55,560,21,34,321.55,565.02,0.00
2024-12-08 14:53:08,54,560,20,34,322.39,565.59,0.00
2024-12-08 14:53:08,54,561,20,34,328.86,566.00,0.00
2024-12-08 14:53:08,55,561,20,35,322.88,566.02,0.00
2024-12-08 14:53:08,55,562,20,35,322.36,567.00,0.00
2024-12-08 14:53:08,56,562,21,35,316.61,567.02,0.00
2024-12-08 14:53:08,55,562,21,34,320.71,567.02,0.00
2024-12-08 14:53:08,55,563,21,34,321.90,568.00,0.00
2024-12-08 14:53:08,56,563,21,35,316.15,568.02,0.00
2024-12-08 14:53:08,56,564,21,35,315.18,569.00,0.00
2024-12-08 14:53:08,57,564,22,35,309.65,569.02,0.00
2024-12-08 14:53:08,56,564,22,34,314.27,569.02,0.00
2024-12-08 14:53:08,55,564,21,34,313.02,569.62,0.00
2024-12-08 14:53:08,55,565,21,34,321.48,570.00,0.00
2024-12-08 14:53:08,56,565,22,34,315.74,570.02,0.00
2024-12-08 14:53:08,56,566,22,34,315.02,571.00,0.00
2024-12-08 14:53:08,57,566,22,35,309.49,571.02,0.00
2024-12-08 14:53:08,56,566,22,34,313.60,571.05,0.00
2024-12-08 14:53:08,56,567,22,34,314.85,572.00,0.00
2024-12-08 14:53:08,57,567,23,34,309.33,572.02,0.00
2024-12-08 14:53:08,56,567,22,34,308.87,572.41,0.00
2024-12-08 14:53:08,56,568,22,34,316.12,573.00,0.00
2024-12-08 14:53:08,57,568,23,34,310.57,573.02,0.00
2024-12-08 14:53:08,56,568,23,33,314.80,573.05,0.00
2024-12-08 14:53:08,56,569,23,33,316.06,574.00,0.00
2024-12-08 14:53:08,57,569,24,33,310.51,574.02,0.00
2024-12-08 14:53:08,57,570,24,33,309.66,575.00,0.00
2024-12-08 14:53:08,58,570,24,34,304.32,575.02,0.00
2024-12-08 14:53:08,57,570,24,33,308.45,575.05,0.00
2024-12-08 14:53:08,57,571,24,33,309.59,576.00,0.00
2024-12-08 14:53:08,58,571,25,33,304.25,576.02,0.00
2024-12-08 14:53:08,57,571,24,33,304.33,576.30,0.00
2024-12-08 14:53:08,57,572,24,33,310.84,577.00,0.00
2024-12-08 14:53:08,58,572,24,34,305.48,577.02,0.00
2024-12-08 14:53:08,57,572,24,33,309.73,577.05,0.00
2024-12-08 14:53:08,57,573,24,33,310.87,578.00,0.00
2024-12-08 14:53:08,58,573,24,34,305.51,578.02,0.00
2024-12-08 14:53:08,58,574,24,34,304.45,579.00,0.00
2024-12-08 14:53:08,59,574,25,34,299.29,579.02,0.00
2024-12-08 14:53:08,58,574,25,33,303.46,579.05,0.00
2024-12-08 14:53:08,57,574,24,33,302.82,579.89,0.00
2024-12-08 14:53:08,57,575,24,33,312.45,580.00,0.00
2024-12-08 14:53:08,58,575,24,34,307.06,580.02,0.00
2024-12-08 14:53:08,58,576,24,34,306.08,581.00,0.00
2024-12-08 14:53:08,59,576,25,34,300.89,581.02,0.00
2024-12-08 14:53:08,58,576,25,33,305.08,581.05,0.00
2024-12-08 14:53:09,58,577,25,33,306.10,582.00,0.00
2024-12-08 14:53:09,59,577,26,33,300.92,582.02,0.00
2024-12-08 14:53:09,58,577,25,33,303.47,582.12,0.00
2024-12-08 14:53:09,57,577,24,33,306.46,582.30,0.00
2024-12-08 14:53:09,57,578,24,33,313.04,583.00,0.00
2024-12-08 14:53:09,58,578,25,33,307.64,583.02,0.00
2024-12-08 14:53:09,57,578,25,32,312.12,583.05,0.00
2024-12-08 14:53:09,57,579,25,32,313.27,584.00,0.00
2024-12-08 14:53:09,58,579,26,32,307.86,584.02,0.00
2024-12-08 14:53:09,58,580,26,32,306.71,585.00,0.00
2024-12-08 14:53:09,59,580,27,32,301.51,585.02,0.00
2024-12-08 14:53:09,58,580,27,31,305.91,585.05,0.00
2024-12-08 14:53:09,57,580,26,31,306.78,585.77,0.00
2024-12-08 14:53:09,57,581,26,31,315.88,586.00,0.00
2024-12-08 14:53:09,58,581,27,31,310.43,586.02,0.00
2024-12-08 14:53:09,58,582,27,31,309.26,587.00,0.00
2024-12-08 14:53:09,59,582,27,32,304.01,587.02,0.00
2024-12-08 14:53:09,58,582,27,31,308.55,587.05,0.00
2024-12-08 14:53:09,58,583,27,31,309.58,588.00,0.00
2024-12-08 14:53:09,59,583,27,32,304.33,588.02,0.00
2024-12-08 14:53:09,58,583,26,32,304.12,588.09,0.00
2024-12-08 14:53:09,57,583,25,32,308.96,588.18,0.00
2024-12-08 14:53:09,57,584,25,32,314.93,589.00,0.00
2024-12-08 14:53:09,58,584,26,32,309.50,589.02,0.00
2024-12-08 14:53:09,57,584,26,31,314.21,589.05,0.00
2024-12-08 14:53:09,56,584,25,31,316.25,589.09,0.00
2024-12-08 14:53:09,55,584,24,31,319.11,589.62,0.00
2024-12-08 14:53:09,55,585,24,31,327.85,590.00,0.00
2024-12-08 14:53:09,56,585,25,31,322.00,590.02,0.00
2024-12-08 14:53:09,56,586,25,31,320.96,591.00,0.00
2024-12-08 14:53:09,57,586,25,32,315.33,591.02,0.00
2024-12-08 14:53:09,56,586,25,31,320.12,591.05,0.00
2024-12-08 14:53:09,55,586,24,31,320.35,591.85,0.00
2024-12-08 14:53:09,55,587,24,31,330.36,592.00,0.00
2024-12-08 14:53:09,56,587,24,32,324.46,592.02,0.00
2024-12-08 14:53:09,56,588,24,32,323.44,593.00,0.00
2024-12-08 14:53:09,57,588,24,33,317.76,593.02,0.00
2024-12-08 14:53:09,56,588,24,32,322.49,593.05,0.00
2024-12-08 14:53:09,55,588,23,32,324.25,593.73,0.00
2024-12-08 14:53:09,55,589,23,32,333.64,594.00,0.00
2024-12-08 14:53:09,56,589,24,32,327.68,594.02,0.00
2024-12-08 14:53:09,55,589,23,32,326.56,594.76,0.00
2024-12-08 14:53:09,55,590,23,32,336.16,595.00,0.00
2024-12-08 14:53:09,56,590,24,32,330.16,595.02,0.00
2024-12-08 14:53:09,55,590,24,31,335.19,595.05,0.00
2024-12-08 14:53:09,55,591,24,31,336.62,596.00,0.00
2024-12-08 14:53:09,56,591,25,31,330.61,596.02,0.00
2024-12-08 14:53:09,56,592,25,31,329.56,597.00,0.00
2024-12-08 14:53:09,57,592,25,32,323.78,597.02,0.00
2024-12-08 14:53:09,56,592,25,31,328.71,597.05,0.00
2024-12-08 14:53:09,56,593,25,31,330.01,598.00,0.00
2024-12-08 14:53:09,57,593,26,31,324.22,598.02,0.00
2024-12-08 14:53:09,56,593,26,30,329.90,598.02,0.00
2024-12-08 14:53:09,56,594,26,30,329.24,599.00,0.00
2024-12-08 14:53:09,57,594,27,30,323.46,599.02,0.00
2024-12-08 14:53:09,56,594,27,29,329.13,599.02,0.00
2024-12-08 14:53:09,55,594,27,28,333.92,599.04,0.00
2024-12-08 14:53:09,55,595,27,28,335.24,600.00,0.00
2024-12-08 14:53:09,56,595,27,29,329.25,600.02,0.00
2024-12-08 14:53:09,55,595,26,29,325.98,600.58,0.00
2024-12-08 14:53:09,55,596,26,29,334.69,601.00,0.00
2024-12-08 14:53:09,56,596,27,29,328.71,601.02,0.00
2024-12-08 14:53:09,55,596,27,28,333.49,601.04,0.00
2024-12-08 14:53:09,54,596,26,28,336.08,601.67,0.00
2024-12-08 14:53:09,54,597,26,28,345.47,602.00,0.00
2024-12-08 14:53:09,55,597,27,28,339.19,602.02,0.00
2024-12-08 14:53:09,54,597,26,28,339.45,602.35,0.00
2024-12-08 14:53:09,54,598,26,28,347.16,603.00,0.00
2024-12-08 14:53:09,55,598,27,28,340.85,603.02,0.00
2024-12-08 14:53:09,54,598,27,27,345.38,603.06,0.00
2024-12-08 14:53:09,54,599,27,27,346.95,604.00,0.00
2024-12-08 14:53:09,55,599,27,28,340.64,604.02,0.00
2024-12-08 14:53:09,55,600,27,28,340.01,605.00,0.00
2024-12-08 14:53:09,56,600,28,28,333.94,605.02,0.00
2024-12-08 14:53:09,55,600,28,27,338.37,605.05,0.00
2024-12-08 14:53:09,54,600,27,27,337.31,605.96,0.00
2024-12-08 14:53:09,54,601,27,27,348.32,606.00,0.00
2024-12-08 14:53:09,55,601,28,27,341.99,606.02,0.00
2024-12-08 14:53:09,55,602,28,27,341.41,607.00,0.00
2024-12-08 14:53:09,56,602,28,28,335.32,607.02,0.00
2024-12-08 14:53:09,55,602,28,27,339.77,607.05,0.00
2024-12-08 14:53:09,54,602,27,27,345.74,607.11,0.00
2024-12-08 14:53:10,54,603,27,27,347.63,608.00,0.00
2024-12-08 14:53:10,55,603,28,27,341.31,608.02,0.00
2024-12-08 14:53:10,55,604,28,27,340.82,609.00,0.00
2024-12-08 14:53:10,56,604,28,28,334.74,609.02,0.00
2024-12-08 14:53:10,55,604,28,27,339.06,609.05,0.00
2024-12-08 14:53:10,55,605,28,27,340.50,610.00,0.00
2024-12-08 14:53:10,56,605,28,28,334.41,610.02,0.00
2024-12-08 14:53:10,56,606,28,28,333.87,611.00,0.00
2024-12-08 14:53:10,57,606,28,29,328.01,611.02,0.00
2024-12-08 14:53:10,56,606,28,28,332.24,611.05,0.00
2024-12-08 14:53:10,55,606,27,28,337.97,611.11,0.00
2024-12-08 14:53:10,54,606,26,28,336.93,611.96,0.00
2024-12-08 14:53:10,54,607,26,28,348.05,612.00,0.00
2024-12-08 14:53:10,55,607,26,29,341.72,612.02,0.00
2024-12-08 14:53:10,54,607,25,29,338.52,612.93,0.00
2024-12-08 14:53:10,54,608,25,29,349.47,613.00,0.00
2024-12-08 14:53:10,55,608,25,30,343.12,613.02,0.00
2024-12-08 14:53:10,54,608,25,29,347.89,613.06,0.00
2024-12-08 14:53:10,53,608,24,29,352.68,613.19,0.00
2024-12-08 14:53:10,53,609,24,29,359.81,614.00,0.00
2024-12-08 14:53:10,54,609,25,29,353.15,614.02,0.00
2024-12-08 14:53:10,53,609,24,29,353.74,614.26,0.00
2024-12-08 14:53:10,53,610,24,29,361.32,615.00,0.00
2024-12-08 14:53:10,54,610,24,30,354.63,615.02,0.00
2024-12-08 14:53:10,53,610,24,29,359.24,615.08,0.00
2024-12-08 14:53:10,52,610,23,29,365.93,615.12,0.00
2024-12-08 14:53:10,52,611,23,29,368.15,616.00,0.00
2024-12-08 14:53:10,53,611,24,29,361.21,616.02,0.00
2024-12-08 14:53:10,52,611,23,29,364.13,616.06,0.00
2024-12-08 14:53:10,52,612,23,29,368.40,617.00,0.00
2024-12-08 14:53:10,53,612,23,30,361.44,617.02,0.00
2024-12-08 14:53:10,52,612,23,29,366.26,617.06,0.00
2024-12-08 14:53:10,52,613,23,29,368.16,618.00,0.00
2024-12-08 14:53:10,53,613,23,30,361.21,618.02,0.00
2024-12-08 14:53:10,53,614,23,30,360.76,619.00,0.00
2024-12-08 14:53:10,54,614,24,30,354.08,619.02,0.00
2024-12-08 14:53:10,53,614,24,29,358.78,619.06,0.00
2024-12-08 14:53:10,53,615,24,29,360.52,620.00,0.00
2024-12-08 14:53:10,54,615,24,30,353.85,620.02,0.00
2024-12-08 14:53:10,54,616,24,30,353.48,621.00,0.00
2024-12-08 14:53:10,55,616,24,31,347.05,621.02,0.00
2024-12-08 14:53:10,54,616,24,30,351.53,621.06,0.00
2024-12-08 14:53:10,53,616,23,30,350.83,621.92,0.00
2024-12-08 14:53:10,53,617,23,30,362.16,622.00,0.00
2024-12-08 14:53:10,54,617,23,31,355.45,622.02,0.00
2024-12-08 14:53:10,53,617,22,31,355.20,622.72,0.00
2024-12-08 14:53:10,53,618,22,31,365.43,623.00,0.00
2024-12-08 14:53:10,54,618,23,31,358.66,623.02,0.00
2024-12-08 14:53:10,53,618,23,30,363.55,623.06,0.00
2024-12-08 14:53:10,52,618,22,30,370.20,623.12,0.00
2024-12-08 14:53:10,52,619,22,30,372.45,624.00,0.00
2024-12-08 14:53:10,53,619,22,31,365.43,624.02,0.00
2024-12-08 14:53:10,53,620,22,31,365.16,625.00,0.00
2024-12-08 14:53:10,54,620,23,31,358.40,625.02,0.00
2024-12-08 14:53:10,53,620,23,30,362.93,625.08,0.00
2024-12-08 14:53:10,53,621,23,30,364.80,626.00,0.00
2024-12-08 14:53:10,54,621,23,31,358.05,626.02,0.00
2024-12-08 14:53:10,53,621,22,31,364.68,626.02,0.00
2024-12-08 14:53:10,53,622,22,31,364.47,627.00,0.00
2024-12-08 14:53:10,54,622,22,32,357.72,627.02,0.00
2024-12-08 14:53:10,53,622,22,31,362.46,627.06,0.00
2024-12-08 14:53:10,52,622,21,31,367.99,627.13,0.00
2024-12-08 14:53:10,52,623,21,31,375.18,628.00,0.00
2024-12-08 14:53:10,53,623,21,32,368.10,628.02,0.00
2024-12-08 14:53:10,53,624,21,32,367.84,629.00,0.00
2024-12-08 14:53:10,54,624,21,33,361.03,629.02,0.00
2024-12-08 14:53:10,53,624,21,32,365.71,629.06,0.00
2024-12-08 14:53:10,52,624,20,32,372.16,629.08,0.00
2024-12-08 14:53:10,52,625,20,32,379.04,630.00,0.00
2024-12-08 14:53:10,53,625,21,32,371.89,630.02,0.00
2024-12-08 14:53:10,52,625,20,32,369.38,630.88,0.00
2024-12-08 14:53:10,52,626,20,32,380.88,631.00,0.00
2024-12-08 14:53:10,53,626,20,33,373.69,631.02,0.00
2024-12-08 14:53:10,52,626,20,32,378.70,631.06,0.00
2024-12-08 14:53:10,52,627,20,32,380.63,632.00,0.00
2024-12-08 14:53:10,53,627,20,33,373.45,632.02,0.00
2024-12-08 14:53:10,52,627,19,33,373.81,632.71,0.00
2024-12-08 14:53:10,52,628,19,33,384.40,633.00,0.00
2024-12-08 14:53:10,53,628,20,33,377.15,633.02,0.00
2024-12-08 14:53:10,52,628,19,33,384.28,633.02,0.00
2024-12-08 14:53:10,51,628,19,32,389.71,633.04,0.00
2024-12-08 14:53:10,51,629,19,32,391.69,634.00,0.00
2024-12-08 14:53:10,52,629,20,32,384.15,634.02,0.00
2024-12-08 14:53:10,52,630,20,32,383.90,635.00,0.00
2024-12-08 14:53:11,53,630,20,33,376.66,635.02,0.00
2024-12-08 14:53:11,52,630,20,32,381.71,635.04,0.00
2024-12-08 14:53:11,51,630,19,32,389.19,635.04,0.00
2024-12-08 14:53:11,51,631,19,32,391.17,636.00,0.00
2024-12-08 14:53:11,52,631,19,33,383.65,636.02,0.00
2024-12-08 14:53:11,51,631,18,33,384.43,636.33,0.00
2024-12-08 14:53:11,51,632,18,33,393.16,637.00,0.00
2024-12-08 14:53:11,52,632,19,33,385.60,637.02,0.00
2024-12-08 14:53:11,51,632,19,32,390.67,637.04,0.00
2024-12-08 14:53:11,51,633,19,32,392.65,638.00,0.00
2024-12-08 14:53:11,52,633,20,32,385.10,638.02,0.00
2024-12-08 14:53:11,52,634,20,32,385.04,639.00,0.00
2024-12-08 14:53:11,53,634,20,33,377.77,639.02,0.00
2024-12-08 14:53:11,52,634,20,32,382.58,639.04,0.00
2024-12-08 14:53:11,52,635,20,32,384.41,640.00,0.00
2024-12-08 14:53:11,53,635,21,32,377.15,640.02,0.00
2024-12-08 14:53:11,53,636,21,32,377.02,641.00,0.00
2024-12-08 14:53:11,54,636,22,32,370.04,641.02,0.00
2024-12-08 14:53:11,53,636,22,31,374.73,641.04,0.00
2024-12-08 14:53:11,52,636,21,31,380.70,641.06,0.00
2024-12-08 14:53:11,52,637,21,31,387.58,642.00,0.00
2024-12-08 14:53:11,53,637,21,32,380.27,642.02,0.00
2024-12-08 14:53:11,52,637,20,32,377.18,642.92,0.00
2024-12-08 14:53:11,52,638,20,32,389.11,643.00,0.00
2024-12-08 14:53:11,53,638,21,32,381.77,643.02,0.00
2024-12-08 14:53:11,52,638,21,31,386.76,643.04,0.00
2024-12-08 14:53:11,52,639,21,31,388.60,644.00,0.00
2024-12-08 14:53:11,53,639,21,32,381.27,644.02,0.00
2024-12-08 14:53:11,52,639,20,32,387.90,644.04,0.00
2024-12-08 14:53:11,52,640,20,32,392.22,645.00,0.00
2024-12-08 14:53:11,53,640,21,32,384.82,645.02,0.00
2024-12-08 14:53:11,52,640,20,32,391.96,645.04,0.00
2024-12-08 14:53:11,52,641,20,32,396.29,646.00,0.00
2024-12-08 14:53:11,53,641,21,32,388.82,646.02,0.00
2024-12-08 14:53:11,52,641,21,31,395.80,646.06,0.00
2024-12-08 14:53:11,52,642,21,31,397.78,647.00,0.00
2024-12-08 14:53:11,53,642,21,32,390.27,647.02,0.00
2024-12-08 14:53:11,52,642,20,32,397.65,647.04,0.00
2024-12-08 14:53:11,52,643,20,32,397.92,648.00,0.00
2024-12-08 14:53:11,53,643,21,32,390.42,648.02,0.00
2024-12-08 14:53:11,52,643,21,31,395.18,648.04,0.00
2024-12-08 14:53:11,51,643,20,31,401.76,648.04,0.00
2024-12-08 14:53:11,51,644,20,31,408.87,649.00,0.00
2024-12-08 14:53:11,52,644,20,32,401.00,649.02,0.00
2024-12-08 14:53:11,52,645,20,32,401.09,650.00,0.00
2024-12-08 14:53:11,53,645,20,33,393.52,650.02,0.00
2024-12-08 14:53:11,52,645,19,33,394.67,650.65,0.00
2024-12-08 14:53:11,52,646,19,33,400.20,651.00,0.00
2024-12-08 14:53:11,53,646,19,34,392.65,651.02,0.00
2024-12-08 14:53:11,52,646,19,33,399.83,651.06,0.00
2024-12-08 14:53:11,51,646,18,33,400.90,651.82,0.00
2024-12-08 14:53:11,51,647,18,33,412.67,652.00,0.00
2024-12-08 14:53:11,52,647,18,34,404.74,652.02,0.00
2024-12-08 14:53:11,52,648,18,34,404.58,653.00,0.00
2024-12-08 14:53:11,53,648,18,35,396.95,653.02,0.00
2024-12-08 14:53:11,52,648,18,34,401.82,653.06,0.00
2024-12-08 14:53:11,52,649,18,34,403.82,654.00,0.00
2024-12-08 14:53:11,53,649,18,35,396.20,654.02,0.00
2024-12-08 14:53:11,52,649,17,35,403.57,654.04,0.00
2024-12-08 14:53:11,51,649,16,35,407.04,654.18,0.00
2024-12-08 14:53:11,51,650,16,35,415.06,655.00,0.00
2024-12-08 14:53:11,52,650,17,35,407.08,655.02,0.00
2024-12-08 14:53:11,51,650,17,34,412.50,655.04,0.00
2024-12-08 14:53:11,50,650,16,34,415.38,655.04,0.00
2024-12-08 14:53:11,49,650,15,34,420.33,655.63,0.00
2024-12-08 14:53:11,49,651,15,34,431.59,656.00,0.00
2024-12-08 14:53:11,50,651,15,35,422.96,656.02,0.00
2024-12-08 14:53:11,50,652,15,35,422.77,657.00,0.00
2024-12-08 14:53:11,51,652,16,35,414.48,657.02,0.00
2024-12-08 14:53:11,50,652,16,34,419.76,657.06,0.00
2024-12-08 14:53:11,50,653,16,34,422.10,658.00,0.00
2024-12-08 14:53:11,51,653,16,35,413.82,658.02,0.00
2024-12-08 14:53:11,50,653,15,35,413.83,658.72,0.00
2024-12-08 14:53:11,50,654,15,35,425.40,659.00,0.00
2024-12-08 14:53:11,51,654,15,36,417.06,659.02,0.00
2024-12-08 14:53:11,50,654,14,36,425.27,659.02,0.00
2024-12-08 14:53:11,49,654,13,36,433.82,659.04,0.00
2024-12-08 14:53:11,49,655,13,36,433.53,660.00,0.00
2024-12-08 14:53:11,50,655,14,36,424.86,660.02,0.00
2024-12-08 14:53:11,49,655,14,35,433.14,660.06,0.00
2024-12-08 14:53:11,48,655,13,35,433.02,660.65,0.00
2024-12-08 14:53:11,48,656,13,35,444.75,661.00,0.00
2024-12-08 14:53:11,49,656,14,35,435.67,661.02,0.00
2024-12-08 14:53:11,48,656,13,35,433.14,661.60,0.00
2024-12-08 14:53:11,48,657,13,35,444.64,662.00,0.00
2024-12-08 14:53:11,49,657,13,36,435.57,662.02,0.00
2024-12-08 14:53:11,48,657,12,36,440.66,662.08,0.00
2024-12-08 14:53:11,48,658,12,36,449.04,663.00,0.00
2024-12-08 14:53:11,49,658,12,37,439.88,663.02,0.00
2024-12-08 14:53:11,50,657,13,37,430.96,663.08,0.00
2024-12-08 14:53:11,49,657,13,36,448.03,663.08,0.00
2024-12-08 14:53:12,49,658,13,36,450.71,664.00,0.00
2024-12-08 14:53:12,50,658,14,36,441.69,664.02,0.00
2024-12-08 14:53:12,50,659,14,36,454.65,665.00,0.00
2024-12-08 14:53:12,51,659,15,36,445.74,665.02,0.00
2024-12-08 14:53:12,51,660,15,36,445.10,666.00,0.00
2024-12-08 14:53:12,52,660,15,37,436.54,666.02,0.00
2024-12-08 14:53:12,51,660,15,36,444.61,666.06,0.00
2024-12-08 14:53:12,51,661,15,36,446.82,667.00,0.00
2024-12-08 14:53:12,52,661,16,36,438.23,667.02,0.00
2024-12-08 14:53:12,52,662,16,36,437.48,668.00,0.00
2024-12-08 14:53:12,53,662,16,37,429.23,668.02,0.00
2024-12-08 14:53:12,52,662,15,37,426.91,668.96,0.00
2024-12-08 14:53:12,52,663,15,37,439.54,669.00,0.00
2024-12-08 14:53:12,53,663,15,38,431.25,669.02,0.00
2024-12-08 14:53:12,52,663,15,37,439.18,669.06,0.00
2024-12-08 14:53:12,52,664,15,37,441.23,670.00,0.00
2024-12-08 14:53:12,53,664,16,37,432.90,670.02,0.00
2024-12-08 14:53:12,53,665,16,37,432.10,671.00,0.00
2024-12-08 14:53:12,54,665,16,38,424.10,671.02,0.00
2024-12-08 14:53:12,53,665,16,37,429.34,671.06,0.00
2024-12-08 14:53:12,53,666,16,37,431.23,672.00,0.00
2024-12-08 14:53:12,54,666,16,38,423.24,672.02,0.00
2024-12-08 14:53:12,54,667,16,38,422.33,673.00,0.00
2024-12-08 14:53:12,55,667,16,39,414.65,673.02,0.00
2024-12-08 14:53:12,54,667,16,38,419.74,673.06,0.00
2024-12-08 14:53:12,54,668,16,38,421.46,674.00,0.00
2024-12-08 14:53:12,55,668,17,38,413.80,674.02,0.00
2024-12-08 14:53:12,54,668,16,38,411.73,674.89,0.00
2024-12-08 14:53:12,54,669,16,38,423.56,675.00,0.00
2024-12-08 14:53:12,55,669,16,39,415.86,675.02,0.00
2024-12-08 14:53:12,54,669,16,38,421.08,675.06,0.00
2024-12-08 14:53:12,53,669,15,38,421.67,675.92,0.00
2024-12-08 14:53:12,53,670,15,38,433.97,676.00,0.00
2024-12-08 14:53:12,54,670,16,38,425.94,676.02,0.00
2024-12-08 14:53:12,53,670,15,38,426.80,676.36,0.00
2024-12-08 14:53:12,53,671,15,38,435.71,677.00,0.00
2024-12-08 14:53:12,54,671,15,39,427.64,677.02,0.00
2024-12-08 14:53:12,53,671,15,38,433.30,677.06,0.00
2024-12-08 14:53:12,53,672,15,38,435.20,678.00,0.00
2024-12-08 14:53:12,54,672,16,38,427.14,678.02,0.00
2024-12-08 14:53:12,55,671,16,39,411.85,678.87,0.00
2024-12-08 14:53:12,55,672,16,39,419.50,679.00,0.00
2024-12-08 14:53:12,56,672,17,39,412.01,679.02,0.00
2024-12-08 14:53:12,55,672,17,38,417.17,679.05,0.00
2024-12-08 14:53:12,55,673,17,38,431.12,680.00,0.00
2024-12-08 14:53:12,56,673,18,38,423.42,680.02,0.00
2024-12-08 14:53:12,56,674,18,38,422.32,681.00,0.00
2024-12-08 14:53:12,57,674,19,38,414.91,681.02,0.00
2024-12-08 14:53:12,56,674,19,37,420.02,681.05,0.00
2024-12-08 14:53:12,56,675,19,37,421.48,682.00,0.00
2024-12-08 14:53:12,57,675,19,38,414.08,682.02,0.00
2024-12-08 14:53:12,56,675,18,38,414.07,682.07,0.00
2024-12-08 14:53:12,56,676,18,38,420.51,683.00,0.00
2024-12-08 14:53:12,57,676,18,39,413.13,683.02,0.00
2024-12-08 14:53:12,56,676,18,38,418.33,683.05,0.00
2024-12-08 14:53:12,55,676,17,38,425.09,683.13,0.00
2024-12-08 14:53:12,56,675,18,38,415.81,683.43,0.00
2024-12-08 14:53:12,56,676,18,38,428.57,684.00,0.00
2024-12-08 14:53:12,57,676,18,39,421.06,684.02,0.00
2024-12-08 14:53:12,57,677,18,39,431.99,685.00,0.00
2024-12-08 14:53:12,58,677,19,39,424.54,685.02,0.00
2024-12-08 14:53:12,57,677,19,38,429.84,685.05,0.00
2024-12-08 14:53:12,57,678,19,38,431.17,686.00,0.00
2024-12-08 14:53:12,58,678,19,39,423.74,686.02,0.00
2024-12-08 14:53:12,58,679,19,39,422.52,687.00,0.00
2024-12-08 14:53:12,59,679,20,39,415.36,687.02,0.00
2024-12-08 14:53:12,58,679,20,38,420.29,687.07,0.00
2024-12-08 14:53:12,58,680,20,38,421.59,688.00,0.00
2024-12-08 14:53:12,59,680,21,38,414.45,688.02,0.00
2024-12-08 14:53:12,58,680,20,38,413.37,688.78,0.00
2024-12-08 14:53:12,58,681,20,38,423.87,689.00,0.00
2024-12-08 14:53:12,59,681,20,39,416.68,689.02,0.00
2024-12-08 14:53:12,58,681,20,38,421.63,689.07,0.00
2024-12-08 14:53:12,58,682,20,38,422.94,690.00,0.00
2024-12-08 14:53:12,59,682,21,38,415.77,690.02,0.00
2024-12-08 14:53:12,59,683,21,38,414.55,691.00,0.00
2024-12-08 14:53:12,60,683,21,39,407.64,691.02,0.00
2024-12-08 14:53:12,59,683,21,38,412.34,691.07,0.00
2024-12-08 14:53:12,59,684,21,38,413.50,692.00,0.00
2024-12-08 14:53:12,60,684,22,38,406.61,692.02,0.00
2024-12-08 14:53:12,60,685,22,38,405.37,693.00,0.00
2024-12-08 14:53:12,61,685,23,38,398.73,693.02,0.00
2024-12-08 14:53:12,60,685,23,37,403.31,693.07,0.00
2024-12-08 14:53:12,60,686,23,37,404.34,694.00,0.00
2024-12-08 14:53:12,61,686,24,37,397.71,694.02,0.00
2024-12-08 14:53:13,60,686,23,37,396.27,694.75,0.00
2024-12-08 14:53:13,60,687,23,37,406.29,695.00,0.00
2024-12-08 14:53:13,61,687,24,37,399.63,695.02,0.00
2024-12-08 14:53:13,60,687,24,36,404.34,695.07,0.00
2024-12-08 14:53:13,59,687,23,36,407.30,695.66,0.00
2024-12-08 14:53:13,59,688,23,36,412.26,696.00,0.00
2024-12-08 14:53:13,60,688,23,37,405.39,696.02,0.00
2024-12-08 14:53:13,59,688,22,37,412.14,696.02,0.00
2024-12-08 14:53:13,59,689,22,37,410.83,697.00,0.00
2024-12-08 14:53:13,60,689,23,37,403.98,697.02,0.00
2024-12-08 14:53:13,59,689,23,36,409.07,697.05,0.00
2024-12-08 14:53:13,59,690,23,36,410.12,698.00,0.00
2024-12-08 14:53:13,60,690,24,36,403.28,698.02,0.00
2024-12-08 14:53:13,60,691,24,36,401.87,699.00,0.00
2024-12-08 14:53:13,61,691,25,36,395.28,699.02,0.00
2024-12-08 14:53:13,60,691,25,35,400.14,699.05,0.00
2024-12-08 14:53:13,60,692,25,35,401.05,700.00,0.00
2024-12-08 14:53:13,61,692,25,36,394.47,700.02,0.00
2024-12-08 14:53:13,60,692,24,36,392.27,700.82,0.00
2024-12-08 14:53:13,60,693,24,36,402.80,701.00,0.00
2024-12-08 14:53:13,61,693,25,36,396.19,701.02,0.00
2024-12-08 14:53:13,60,693,25,35,401.17,701.05,0.00
2024-12-08 14:53:13,59,693,24,35,404.19,701.63,0.00
2024-12-08 14:53:13,59,694,24,35,408.97,702.00,0.00
2024-12-08 14:53:13,60,694,25,35,402.15,702.02,0.00
2024-12-08 14:53:13,60,695,25,35,400.72,703.00,0.00
2024-12-08 14:53:13,61,695,26,35,394.15,703.02,0.00
2024-12-08 14:53:13,60,695,26,34,398.98,703.05,0.00
2024-12-08 14:53:13,59,695,25,34,401.25,703.37,0.00
2024-12-08 14:53:13,58,695,24,34,406.41,703.64,0.00
2024-12-08 14:53:13,58,696,24,34,416.25,704.00,0.00
2024-12-08 14:53:13,59,696,24,35,409.20,704.02,0.00
2024-12-08 14:53:13,59,697,24,35,407.68,705.00,0.00
2024-12-08 14:53:13,60,697,25,35,400.89,705.02,0.00
2024-12-08 14:53:13,59,697,25,34,406.02,705.05,0.00
2024-12-08 14:53:13,59,698,25,34,407.06,706.00,0.00
2024-12-08 14:53:13,60,698,25,35,400.28,706.02,0.00
2024-12-08 14:53:13,59,698,24,35,404.10,706.10,0.00
2024-12-08 14:53:13,58,698,23,35,403.49,706.95,0.00
2024-12-08 14:53:13,58,699,23,35,415.34,707.00,0.00
2024-12-08 14:53:13,59,699,24,35,408.30,707.02,0.00
2024-12-08 14:53:13,58,699,24,34,413.53,707.05,0.00
2024-12-08 14:53:13,57,699,23,34,416.72,707.67,0.00
2024-12-08 14:53:13,57,700,23,34,422.05,708.00,0.00
2024-12-08 14:53:13,58,700,23,35,414.77,708.02,0.00
2024-12-08 14:53:13,58,701,23,35,413.34,709.00,0.00
2024-12-08 14:53:13,59,701,23,36,406.33,709.02,0.00
2024-12-08 14:53:13,58,701,23,35,411.39,709.05,0.00
2024-12-08 14:53:13,57,701,22,35,416.04,709.26,0.00
2024-12-08 14:53:13,57,702,22,35,423.74,710.00,0.00
2024-12-08 14:53:13,58,702,23,35,416.44,710.02,0.00
2024-12-08 14:53:13,57,702,22,35,416.28,710.07,0.00
2024-12-08 14:53:13,57,703,22,35,422.72,711.00,0.00
2024-12-08 14:53:13,58,703,23,35,415.43,711.02,0.00
2024-12-08 14:53:13,57,703,23,34,420.73,711.05,0.00
2024-12-08 14:53:13,57,704,23,34,422.06,712.00,0.00
2024-12-08 14:53:13,58,704,24,34,414.79,712.02,0.00
2024-12-08 14:53:13,57,704,23,34,414.58,712.07,0.00
2024-12-08 14:53:13,57,705,23,34,421.03,713.00,0.00
2024-12-08 14:53:13,58,705,23,35,413.77,713.02,0.00
2024-12-08 14:53:13,57,705,23,34,418.91,713.05,0.00
2024-12-08 14:53:13,58,704,24,34,408.72,713.53,0.00
2024-12-08 14:53:13,58,705,24,34,416.69,714.00,0.00
2024-12-08 14:53:13,59,705,24,35,409.63,714.02,0.00
2024-12-08 14:53:13,59,706,24,35,423.35,715.00,0.00
2024-12-08 14:53:13,60,706,25,35,416.29,715.02,0.00
2024-12-08 14:53:13,60,707,25,35,416.15,716.00,0.00
2024-12-08 14:53:13,61,707,25,36,409.33,716.02,0.00
2024-12-08 14:53:13,60,707,24,36,407.25,716.50,0.00
2024-12-08 14:53:13,60,708,24,36,415.96,717.00,0.00
2024-12-08 14:53:13,61,708,24,37,409.14,717.02,0.00
2024-12-08 14:53:13,60,708,24,36,414.90,717.05,0.00
2024-12-08 14:53:13,59,708,23,36,417.87,717.64,0.00
2024-12-08 14:53:13,59,709,23,36,422.89,718.00,0.00
2024-12-08 14:53:13,60,709,24,36,415.84,718.02,0.00
2024-12-08 14:53:13,60,710,24,36,414.23,719.00,0.00
2024-12-08 14:53:13,61,710,24,37,407.44,719.02,0.00
2024-12-08 14:53:13,60,710,24,36,412.56,719.05,0.00
2024-12-08 14:53:13,60,711,24,36,413.49,720.00,0.00
2024-12-08 14:53:13,61,711,25,36,406.71,720.02,0.00
2024-12-08 14:53:13,60,711,24,36,403.00,720.93,0.00
2024-12-08 14:53:13,60,712,24,36,414.57,721.00,0.00
2024-12-08 14:53:13,61,712,24,37,407.78,721.02,0.00
2024-12-08 14:53:13,60,712,24,36,414.34,721.03,0.00
2024-12-08 14:53:13,59,712,24,35,420.02,721.03,0.00
2024-12-08 14:53:13,59,713,24,35,420.96,722.00,0.00
2024-12-08 14:53:13,60,713,25,35,413.95,722.02,0.00
2024-12-08 14:53:13,59,713,24,35,417.58,722.15,0.00
2024-12-08 14:53:13,59,714,24,35,419.34,723.00,0.00
2024-12-08 14:53:13,60,714,24,36,412.35,723.02,0.00
2024-12-08 14:53:13,59,714,24,35,418.00,723.03,0.00
2024-12-08 14:53:14,59,715,24,35,418.94,724.00,0.00
2024-12-08 14:53:14,60,715,24,36,411.96,724.02,0.00
2024-12-08 14:53:14,59,715,23,36,410.51,724.78,0.00
2024-12-08 14:53:14,59,716,23,36,421.36,725.00,0.00
2024-12-08 14:53:14,60,716,24,36,414.34,725.02,0.00
2024-12-08 14:53:14,59,716,24,35,420.14,725.03,0.00
2024-12-08 14:53:14,58,716,23,35,426.43,725.17,0.00
2024-12-08 14:53:14,58,717,23,35,428.46,726.00,0.00
2024-12-08 14:53:14,59,717,23,36,421.20,726.02,0.00
2024-12-08 14:53:14,58,717,22,36,421.96,726.05,0.00
2024-12-08 14:53:14,58,718,22,36,428.18,727.00,0.00
2024-12-08 14:53:14,59,718,22,37,420.92,727.02,0.00
2024-12-08 14:53:14,58,718,22,36,427.06,727.03,0.00
2024-12-08 14:53:14,57,718,21,36,426.53,727.93,0.00
2024-12-08 14:53:14,57,719,21,36,438.84,728.00,0.00
2024-12-08 14:53:14,58,719,21,37,431.28,728.02,0.00
2024-12-08 14:53:14,58,720,21,37,429.73,729.00,0.00
2024-12-08 14:53:14,59,720,22,37,422.45,729.02,0.00
2024-12-08 14:53:14,58,720,22,36,428.61,729.03,0.00
2024-12-08 14:53:14,57,720,21,36,429.42,729.84,0.00
2024-12-08 14:53:14,57,721,21,36,441.20,730.00,0.00
2024-12-08 14:53:14,58,721,22,36,433.59,730.02,0.00
2024-12-08 14:53:14,58,722,22,36,432.05,731.00,0.00
2024-12-08 14:53:14,59,722,23,36,424.72,731.02,0.00
2024-12-08 14:53:14,58,722,23,35,430.92,731.03,0.00
2024-12-08 14:53:14,58,723,23,35,432.01,732.00,0.00
2024-12-08 14:53:14,59,723,24,35,424.68,732.02,0.00
2024-12-08 14:53:14,59,724,24,35,423.03,733.00,0.00
2024-12-08 14:53:14,60,724,25,35,415.98,733.02,0.00
2024-12-08 14:53:14,59,724,25,34,422.04,733.03,0.00
2024-12-08 14:53:14,59,725,25,34,422.98,734.00,0.00
2024-12-08 14:53:14,60,725,25,35,415.93,734.02,0.00
2024-12-08 14:53:14,60,726,25,35,414.17,735.00,0.00
2024-12-08 14:53:14,61,726,25,36,407.38,735.02,0.00
2024-12-08 14:53:14,60,726,25,35,413.07,735.03,0.00
2024-12-08 14:53:14,59,726,24,35,418.03,735.22,0.00
2024-12-08 14:53:14,59,727,24,35,425.26,736.00,0.00
2024-12-08 14:53:14,60,727,24,36,418.17,736.02,0.00
2024-12-08 14:53:14,60,728,24,36,416.40,737.00,0.00
2024-12-08 14:53:14,61,728,24,37,409.58,737.02,0.00
2024-12-08 14:53:14,60,728,24,36,415.43,737.03,0.00
2024-12-08 14:53:14,59,728,23,36,419.44,737.27,0.00
2024-12-08 14:53:14,59,729,23,36,427.04,738.00,0.00
2024-12-08 14:53:14,60,729,24,36,419.92,738.02,0.00
2024-12-08 14:53:14,60,730,24,36,418.15,739.00,0.00
2024-12-08 14:53:14,61,730,25,36,411.30,739.02,0.00
2024-12-08 14:53:14,60,730,25,35,416.93,739.05,0.00
2024-12-08 14:53:14,60,731,25,35,417.85,740.00,0.00
2024-12-08 14:53:14,61,731,25,36,411.00,740.02,0.00
2024-12-08 14:53:14,61,732,25,36,409.99,741.00,0.00
2024-12-08 14:53:14,62,732,26,36,403.38,741.02,0.00
2024-12-08 14:53:14,61,732,26,35,407.45,741.07,0.00
2024-12-08 14:53:14,61,733,26,35,408.35,742.00,0.00
2024-12-08 14:53:14,62,733,26,36,401.77,742.02,0.00
2024-12-08 14:53:14,62,734,26,36,399.79,743.00,0.00
2024-12-08 14:53:14,63,734,26,37,393.45,743.02,0.00
2024-12-08 14:53:14,62,734,26,36,398.84,743.05,0.00
2024-12-08 14:53:14,62,735,26,36,399.49,744.00,0.00
2024-12-08 14:53:14,63,735,27,36,393.15,744.02,0.00
2024-12-08 14:53:14,63,736,27,36,391.20,745.00,0.00
2024-12-08 14:53:14,64,736,27,37,385.09,745.02,0.00
2024-12-08 14:53:14,63,736,27,36,390.14,745.05,0.00
2024-12-08 14:53:14,63,737,27,36,390.66,746.00,0.00
2024-12-08 14:53:14,64,737,27,37,384.56,746.02,0.00
2024-12-08 14:53:14,63,737,26,37,384.37,746.33,0.00
2024-12-08 14:53:14,63,738,26,37,391.66,747.00,0.00
2024-12-08 14:53:14,64,738,26,38,385.54,747.02,0.00
2024-12-08 14:53:14,63,738,26,37,390.71,747.05,0.00
2024-12-08 14:53:14,63,739,26,37,391.23,748.00,0.00
2024-12-08 14:53:14,64,739,27,37,385.12,748.02,0.00
2024-12-08 14:53:14,63,739,26,37,380.31,748.95,0.00
2024-12-08 14:53:14,63,740,26,37,391.87,749.00,0.00
2024-12-08 14:53:14,64,740,27,37,385.75,749.02,0.00
2024-12-08 14:53:14,63,740,27,36,391.05,749.05,0.00
2024-12-08 14:53:14,63,741,27,36,391.56,750.00,0.00
2024-12-08 14:53:14,64,741,28,36,385.45,750.02,0.00
2024-12-08 14:53:14,64,742,28,36,383.45,751.00,0.00
2024-12-08 14:53:14,65,742,29,36,377.55,751.02,0.00
2024-12-08 14:53:14,64,742,29,35,382.64,751.05,0.00
2024-12-08 14:53:14,63,742,28,35,387.92,751.16,0.00
2024-12-08 14:53:14,63,743,28,35,389.22,752.00,0.00
2024-12-08 14:53:14,64,743,29,35,383.14,752.02,0.00
2024-12-08 14:53:14,63,743,28,35,383.69,752.29,0.00
2024-12-08 14:53:15,63,744,28,35,390.70,753.00,0.00
2024-12-08 14:53:15,64,744,29,35,384.59,753.02,0.00
2024-12-08 14:53:15,63,744,29,34,389.86,753.05,0.00
2024-12-08 14:53:15,63,745,29,34,390.38,754.00,0.00
2024-12-08 14:53:15,64,745,29,35,384.28,754.02,0.00
2024-12-08 14:53:15,64,746,29,35,382.12,755.00,0.00
2024-12-08 14:53:15,65,746,29,36,376.24,755.02,0.00
2024-12-08 14:53:15,64,746,29,35,381.42,755.05,0.00
2024-12-08 14:53:15,63,746,28,35,386.56,755.17,0.00
2024-12-08 14:53:15,62,746,27,35,387.86,755.77,0.00
2024-12-08 14:53:15,62,747,27,35,398.50,756.00,0.00
2024-12-08 14:53:15,63,747,27,36,392.18,756.02,0.00
2024-12-08 14:53:15,62,747,26,36,390.21,756.40,0.00
2024-12-08 14:53:15,62,748,26,36,398.29,757.00,0.00
2024-12-08 14:53:15,63,748,26,37,391.96,757.02,0.00
2024-12-08 14:53:15,62,748,26,36,397.31,757.05,0.00
2024-12-08 14:53:15,61,748,25,36,398.10,757.77,0.00
2024-12-08 14:53:15,61,749,25,36,408.95,758.00,0.00
2024-12-08 14:53:15,62,749,25,37,402.36,758.02,0.00
2024-12-08 14:53:15,62,750,25,37,403.00,759.00,0.00
2024-12-08 14:53:15,63,750,26,37,396.61,759.02,0.00
2024-12-08 14:53:15,62,750,25,37,399.25,759.19,0.00
2024-12-08 14:53:15,61,750,24,37,402.04,759.72,0.00
2024-12-08 14:53:15,61,751,24,37,408.55,760.00,0.00
2024-12-08 14:53:15,62,751,25,37,401.96,760.02,0.00
2024-12-08 14:53:15,61,751,25,36,406.56,760.05,0.00
2024-12-08 14:53:15,60,751,24,36,407.60,760.85,0.00
2024-12-08 14:53:15,60,752,24,36,419.27,761.00,0.00
2024-12-08 14:53:15,61,752,25,36,412.39,761.02,0.00
2024-12-08 14:53:15,61,753,25,36,410.44,762.00,0.00
2024-12-08 14:53:15,62,753,26,36,403.82,762.02,0.00
2024-12-08 14:53:15,61,753,26,35,409.81,762.05,0.00
2024-12-08 14:53:15,61,754,26,35,410.60,763.00,0.00
2024-12-08 14:53:15,62,754,26,36,403.98,763.02,0.00
2024-12-08 14:53:15,61,754,25,36,410.47,763.02,0.00
2024-12-08 14:53:15,60,754,24,36,417.19,763.02,0.00
2024-12-08 14:53:15,60,755,24,36,415.32,764.00,0.00
2024-12-08 14:53:15,61,755,25,36,408.51,764.02,0.00
2024-12-08 14:53:15,60,755,25,35,414.93,764.02,0.00
2024-12-08 14:53:15,59,755,24,35,421.10,764.14,0.00
2024-12-08 14:53:15,58,755,23,35,420.16,764.97,0.00
2024-12-08 14:53:15,58,756,23,35,433.10,765.00,0.00
2024-12-08 14:53:15,59,756,23,36,425.76,765.02,0.00
2024-12-08 14:53:15,59,757,23,36,423.98,766.00,0.00
2024-12-08 14:53:15,60,757,24,36,416.91,766.02,0.00
2024-12-08 14:53:15,59,757,24,35,423.46,766.02,0.00
2024-12-08 14:53:15,58,757,23,35,425.17,766.74,0.00
2024-12-08 14:53:15,58,758,23,35,436.61,767.00,0.00
2024-12-08 14:53:15,59,758,23,36,429.21,767.02,0.00
2024-12-08 14:53:15,58,758,22,36,430.40,767.03,0.00
2024-12-08 14:53:15,58,759,22,36,436.79,768.00,0.00
2024-12-08 14:53:15,59,759,23,36,429.38,768.02,0.00
2024-12-08 14:53:15,58,759,23,35,436.26,768.02,0.00
2024-12-08 14:53:15,57,759,22,35,440.41,768.02,0.00
2024-12-08 14:53:15,57,760,22,35,446.92,769.00,0.00
2024-12-08 14:53:15,58,760,22,36,439.21,769.02,0.00
2024-12-08 14:53:15,57,760,21,36,440.17,769.04,0.00
2024-12-08 14:53:15,57,761,21,36,446.82,770.00,0.00
2024-12-08 14:53:15,58,761,21,37,439.12,770.02,0.00
2024-12-08 14:53:15,57,761,21,36,445.88,770.02,0.00
2024-12-08 14:53:15,57,762,21,36,447.00,771.00,0.00
2024-12-08 14:53:15,58,762,21,37,439.29,771.02,0.00
2024-12-08 14:53:15,58,763,21,37,437.70,772.00,0.00
2024-12-08 14:53:15,59,763,21,38,430.28,772.02,0.00
2024-12-08 14:53:15,58,763,21,37,436.51,772.02,0.00
2024-12-08 14:53:15,57,763,20,37,439.52,772.65,0.00
2024-12-08 14:53:15,57,764,20,37,450.65,773.00,0.00
2024-12-08 14:53:15,58,764,21,37,442.88,773.02,0.00
2024-12-08 14:53:15,57,764,20,37,443.32,773.04,0.00
2024-12-08 14:53:15,56,764,19,37,450.58,773.13,0.00
2024-12-08 14:53:15,55,764,18,37,454.96,773.65,0.00
2024-12-08 14:53:15,55,765,18,37,466.65,774.00,0.00
2024-12-08 14:53:15,56,765,18,38,458.32,774.02,0.00
2024-12-08 14:53:15,55,765,18,37,465.10,774.02,0.00
2024-12-08 14:53:15,55,766,18,37,466.55,775.00,0.00
2024-12-08 14:53:15,56,766,19,37,458.22,775.02,0.00
2024-12-08 14:53:15,56,767,19,37,456.73,776.00,0.00
2024-12-08 14:53:15,57,767,20,37,448.72,776.02,0.00
2024-12-08 14:53:15,56,767,20,36,455.21,776.02,0.00
2024-12-08 14:53:15,56,768,20,36,456.49,777.00,0.00
2024-12-08 14:53:15,57,768,21,36,448.48,777.02,0.00
2024-12-08 14:53:15,57,769,21,36,447.04,778.00,0.00
2024-12-08 14:53:15,58,769,21,37,439.33,778.02,0.00
2024-12-08 14:53:15,57,769,21,36,445.40,778.04,0.00
2024-12-08 14:53:15,56,769,20,36,450.62,778.23,0.00
2024-12-08 14:53:15,56,770,20,36,459.05,779.00,0.00
2024-12-08 14:53:15,57,770,20,37,451.00,779.02,0.00
2024-12-08 14:53:15,57,771,20,37,449.50,780.00,0.00
2024-12-08 14:53:15,58,771,20,38,441.75,780.02,0.00
2024-12-08 14:53:15,57,771,20,37,448.00,780.04,0.00
2024-12-08 14:53:15,57,772,20,37,449.26,781.00,0.00
2024-12-08 14:53:15,58,772,21,37,441.51,781.02,0.00
2024-12-08 14:53:15,57,772,20,37,445.59,781.14,0.00
2024-12-08 14:53:15,56,772,19,37,451.23,781.27,0.00
2024-12-08 14:53:15,56,773,19,37,459.96,782.00,0.00
2024-12-08 14:53:15,57,773,19,38,451.89,782.02,0.00
2024-12-08 14:53:16,56,773,19,37,458.01,782.05,0.00
2024-12-08 14:53:16,56,774,19,37,459.57,783.00,0.00
2024-12-08 14:53:16,57,774,20,37,451.51,783.02,0.00
2024-12-08 14:53:16,56,774,19,37,453.49,783.27,0.00
2024-12-08 14:53:16,56,775,19,37,462.26,784.00,0.00
2024-12-08 14:53:16,57,775,20,37,454.15,784.02,0.00
2024-12-08 14:53:16,56,775,20,36,460.45,784.05,0.00
2024-12-08 14:53:16,56,776,20,36,462.00,785.00,0.00
2024-12-08 14:53:16,57,776,21,36,453.90,785.02,0.00
2024-12-08 14:53:16,57,777,21,36,452.35,786.00,0.00
2024-12-08 14:53:16,58,777,22,36,444.55,786.02,0.00
2024-12-08 14:53:16,57,777,22,35,450.56,786.05,0.00
2024-12-08 14:53:16,56,777,21,35,449.39,786.96,0.00
2024-12-08 14:53:16,56,778,21,35,463.18,787.00,0.00
2024-12-08 14:53:16,57,778,22,35,455.06,787.02,0.00
2024-12-08 14:53:16,57,779,22,35,453.47,788.00,0.00
2024-12-08 14:53:16,58,779,23,35,445.65,788.02,0.00
2024-12-08 14:53:16,57,779,23,34,451.82,788.05,0.00
2024-12-08 14:53:16,57,780,23,34,453.22,789.00,0.00
2024-12-08 14:53:16,58,780,24,34,445.40,789.02,0.00
2024-12-08 14:53:16,58,781,24,34,443.88,790.00,0.00
2024-12-08 14:53:16,59,781,24,35,436.36,790.02,0.00
2024-12-08 14:53:16,58,781,24,34,442.26,790.05,0.00
2024-12-08 14:53:16,57,781,23,34,449.22,790.16,0.00
2024-12-08 14:53:16,57,782,23,34,451.41,791.00,0.00
2024-12-08 14:53:16,58,782,24,34,443.63,791.02,0.00
2024-12-08 14:53:16,58,783,24,34,442.02,792.00,0.00
2024-12-08 14:53:16,59,783,24,35,434.53,792.02,0.00
2024-12-08 14:53:16,58,783,23,35,438.23,792.16,0.00
2024-12-08 14:53:16,58,784,23,35,440.65,793.00,0.00
2024-12-08 14:53:16,59,784,23,36,433.18,793.02,0.00
2024-12-08 14:53:16,58,784,23,35,439.15,793.05,0.00
2024-12-08 14:53:16,57,784,22,35,442.06,793.68,0.00
2024-12-08 14:53:16,57,785,22,35,448.11,794.00,0.00
2024-12-08 14:53:16,58,785,23,35,440.39,794.02,0.00
2024-12-08 14:53:16,57,785,23,34,446.45,794.05,0.00
2024-12-08 14:53:16,57,786,23,34,447.84,795.00,0.00
2024-12-08 14:53:16,58,786,24,34,440.12,795.02,0.00
2024-12-08 14:53:16,58,787,24,34,438.38,796.00,0.00
2024-12-08 14:53:16,59,787,25,34,430.95,796.02,0.00
2024-12-08 14:53:16,58,787,25,33,436.87,796.05,0.00
2024-12-08 14:53:16,58,788,25,33,438.10,797.00,0.00
2024-12-08 14:53:16,59,788,26,33,430.68,797.02,0.00
2024-12-08 14:53:16,59,789,26,33,428.90,798.00,0.00
2024-12-08 14:53:16,60,789,26,34,421.76,798.02,0.00
2024-12-08 14:53:16,59,789,26,33,427.42,798.05,0.00
2024-12-08 14:53:16,58,789,25,33,430.04,798.67,0.00
2024-12-08 14:53:16,57,789,24,33,433.13,798.95,0.00
2024-12-08 14:53:16,57,790,24,33,446.75,799.00,0.00
2024-12-08 14:53:16,58,790,24,34,439.05,799.02,0.00
2024-12-08 14:53:16,57,790,23,34,438.95,799.67,0.00
2024-12-08 14:53:16,57,791,23,34,444.94,800.00,0.00
2024-12-08 14:53:16,58,791,23,35,437.26,800.02,0.00
2024-12-08 14:53:16,57,791,23,34,443.53,800.05,0.00
2024-12-08 14:53:16,57,792,23,34,444.93,801.00,0.00
2024-12-08 14:53:16,58,792,23,35,437.26,801.02,0.00
2024-12-08 14:53:16,58,793,23,35,435.45,802.00,0.00
2024-12-08 14:53:16,59,793,23,36,428.07,802.02,0.00
2024-12-08 14:53:16,58,793,23,35,434.21,802.05,0.00
2024-12-08 14:53:16,57,793,22,35,435.90,802.74,0.00
2024-12-08 14:53:16,57,794,22,35,448.05,803.00,0.00
2024-12-08 14:53:16,58,794,22,36,440.33,803.02,0.00
2024-12-08 14:53:16,57,794,21,36,442.21,803.25,0.00
2024-12-08 14:53:16,57,795,21,36,450.73,804.00,0.00
2024-12-08 14:53:16,58,795,22,36,442.96,804.02,0.00
2024-12-08 14:53:16,57,795,22,35,448.76,804.07,0.00
2024-12-08 14:53:16,57,796,22,35,450.30,805.00,0.00
2024-12-08 14:53:16,58,796,23,35,442.54,805.02,0.00
2024-12-08 14:53:16,57,796,22,35,437.02,805.68,0.00
2024-12-08 14:53:16,57,797,22,35,448.84,806.00,0.00
2024-12-08 14:53:16,58,797,23,35,441.10,806.02,0.00
2024-12-08 14:53:16,57,797,23,34,447.01,806.07,0.00
2024-12-08 14:53:16,56,797,22,34,450.49,806.34,0.00
2024-12-08 14:53:16,56,798,22,34,460.00,807.00,0.00
2024-12-08 14:53:16,57,798,23,34,451.93,807.02,0.00
2024-12-08 14:53:16,56,798,22,34,459.86,807.02,0.00
2024-12-08 14:53:16,55,798,21,34,460.56,807.33,0.00
2024-12-08 14:53:16,55,799,21,34,470.27,808.00,0.00
2024-12-08 14:53:16,56,799,22,34,461.87,808.02,0.00
2024-12-08 14:53:16,55,799,22,33,468.66,808.05,0.00
2024-12-08 14:53:16,55,800,22,33,470.41,809.00,0.00
2024-12-08 14:53:16,56,800,22,34,462.01,809.02,0.00
2024-12-08 14:53:16,56,801,22,34,460.41,810.00,0.00
2024-12-08 14:53:16,57,801,23,34,452.34,810.02,0.00
2024-12-08 14:53:16,56,801,23,33,458.97,810.05,0.00
2024-12-08 14:53:16,56,802,23,33,460.55,811.00,0.00
2024-12-08 14:53:16,57,802,24,33,452.47,811.02,0.00
2024-12-08 14:53:16,56,802,23,33,460.40,811.02,0.00
2024-12-08 14:53:17,56,803,23,33,458.83,812.00,0.00
2024-12-08 14:53:17,57,803,24,33,450.78,812.02,0.00
2024-12-08 14:53:17,56,803,24,32,457.39,812.04,0.00
2024-12-08 14:53:17,56,804,24,32,458.82,813.00,0.00
2024-12-08 14:53:17,57,804,24,33,450.77,813.02,0.00
2024-12-08 14:53:17,56,804,23,33,447.49,813.88,0.00
2024-12-08 14:53:17,56,805,23,33,461.09,814.00,0.00
2024-12-08 14:53:17,57,805,23,34,453.00,814.02,0.00
2024-12-08 14:53:17,56,805,23,33,459.64,814.04,0.00
2024-12-08 14:53:17,56,806,23,33,461.07,815.00,0.00
2024-12-08 14:53:17,57,806,24,33,452.98,815.02,0.00
2024-12-08 14:53:17,57,807,24,33,451.25,816.00,0.00
2024-12-08 14:53:17,58,807,25,33,443.47,816.02,0.00
2024-12-08 14:53:17,57,807,25,32,449.96,816.04,0.00
2024-12-08 14:53:17,56,807,24,32,452.92,816.68,0.00
2024-12-08 14:53:17,56,808,24,32,459.29,817.00,0.00
2024-12-08 14:53:17,57,808,25,32,451.23,817.02,0.00
2024-12-08 14:53:17,57,809,25,32,449.48,818.00,0.00
2024-12-08 14:53:17,58,809,26,32,441.73,818.02,0.00
2024-12-08 14:53:17,57,809,26,31,448.19,818.04,0.00
2024-12-08 14:53:17,57,810,26,31,449.46,819.00,0.00
2024-12-08 14:53:17,58,810,27,31,441.71,819.02,0.00
2024-12-08 14:53:17,58,811,27,31,439.84,820.00,0.00
2024-12-08 14:53:17,59,811,28,31,432.39,820.02,0.00
2024-12-08 14:53:17,58,811,28,30,438.72,820.03,0.00
2024-12-08 14:53:17,58,812,28,30,439.82,821.00,0.00
2024-12-08 14:53:17,59,812,29,30,432.36,821.02,0.00
2024-12-08 14:53:17,59,813,29,30,430.38,822.00,0.00
2024-12-08 14:53:17,60,813,29,31,423.21,822.02,0.00
2024-12-08 14:53:17,59,813,29,30,429.41,822.03,0.00
2024-12-08 14:53:17,59,814,29,30,430.35,823.00,0.00
2024-12-08 14:53:17,60,814,29,31,423.17,823.02,0.00
2024-12-08 14:53:17,59,814,28,31,417.99,823.95,0.00
2024-12-08 14:53:17,59,815,28,31,431.57,824.00,0.00
2024-12-08 14:53:17,60,815,29,31,424.37,824.02,0.00
2024-12-08 14:53:17,59,815,29,30,429.76,824.05,0.00
2024-12-08 14:53:17,58,815,28,30,431.51,824.12,0.00
2024-12-08 14:53:17,58,816,28,30,438.97,825.00,0.00
2024-12-08 14:53:17,59,816,28,31,431.53,825.02,0.00
2024-12-08 14:53:17,59,817,28,31,430.05,826.00,0.00
2024-12-08 14:53:17,60,817,28,32,422.88,826.02,0.00
2024-12-08 14:53:17,59,817,28,31,428.38,826.05,0.00
2024-12-08 14:53:17,59,818,28,31,429.45,827.00,0.00
2024-12-08 14:53:17,60,818,28,32,422.29,827.02,0.00
2024-12-08 14:53:17,60,819,28,32,420.76,828.00,0.00
2024-12-08 14:53:17,61,819,29,32,413.86,828.02,0.00
2024-12-08 14:53:17,60,819,29,31,419.25,828.05,0.00
2024-12-08 14:53:17,59,819,28,31,421.18,828.69,0.00
2024-12-08 14:53:17,59,820,28,31,427.28,829.00,0.00
2024-12-08 14:53:17,60,820,29,31,420.16,829.02,0.00
2024-12-08 14:53:17,59,820,28,31,417.61,829.75,0.00
2024-12-08 14:53:17,59,821,28,31,429.74,830.00,0.00
2024-12-08 14:53:17,60,821,29,31,422.58,830.02,0.00
2024-12-08 14:53:17,59,821,29,30,428.34,830.05,0.00
2024-12-08 14:53:17,59,822,29,30,429.42,831.00,0.00
2024-12-08 14:53:17,60,822,30,30,422.26,831.02,0.00
2024-12-08 14:53:17,59,822,29,30,420.99,831.71,0.00
2024-12-08 14:53:17,58,822,28,30,424.40,831.90,0.00
2024-12-08 14:53:17,58,823,28,30,437.96,832.00,0.00
2024-12-08 14:53:17,59,823,29,30,430.54,832.02,0.00
2024-12-08 14:53:17,58,823,29,29,436.67,832.05,0.00
2024-12-08 14:53:17,58,824,29,29,437.91,833.00,0.00
2024-12-08 14:53:17,59,824,29,30,430.49,833.02,0.00
2024-12-08 14:53:17,58,824,28,30,437.77,833.02,0.00
2024-12-08 14:53:17,57,824,27,30,437.56,833.05,0.00
2024-12-08 14:53:17,57,825,27,30,444.81,834.00,0.00
2024-12-08 14:53:17,58,825,28,30,437.15,834.02,0.00
2024-12-08 14:53:17,57,825,28,29,443.21,834.04,0.00
2024-12-08 14:53:17,57,826,28,29,444.47,835.00,0.00
2024-12-08 14:53:17,58,826,28,30,436.81,835.02,0.00
2024-12-08 14:53:17,58,827,28,30,435.53,836.00,0.00
2024-12-08 14:53:17,59,827,29,30,428.15,836.02,0.00
2024-12-08 14:53:17,58,827,29,29,433.95,836.03,0.00
2024-12-08 14:53:17,57,827,28,29,440.44,836.18,0.00
2024-12-08 14:53:17,56,827,27,29,443.12,836.71,0.00
2024-12-08 14:53:17,56,828,27,29,455.88,837.00,0.00
2024-12-08 14:53:17,57,828,27,30,447.88,837.02,0.00
2024-12-08 14:53:17,56,828,26,30,447.67,837.07,0.00
2024-12-08 14:53:17,56,829,26,30,455.38,838.00,0.00
2024-12-08 14:53:17,57,829,26,31,447.39,838.02,0.00
2024-12-08 14:53:17,56,829,25,31,452.98,838.02,0.00
2024-12-08 14:53:17,55,829,25,30,459.55,838.04,0.00
2024-12-08 14:53:17,55,830,25,30,467.26,839.00,0.00
2024-12-08 14:53:17,56,830,26,30,458.92,839.02,0.00
2024-12-08 14:53:17,56,831,26,30,457.83,840.00,0.00
2024-12-08 14:53:17,57,831,27,30,449.80,840.02,0.00
2024-12-08 14:53:17,57,832,27,30,448.53,841.00,0.00
2024-12-08 14:53:17,58,832,27,31,440.80,841.02,0.00
2024-12-08 14:53:18,57,832,27,30,447.06,841.04,0.00
2024-12-08 14:53:18,57,833,27,30,448.33,842.00,0.00
2024-12-08 14:53:18,58,833,27,31,440.60,842.02,0.00
2024-12-08 14:53:18,57,833,27,30,446.85,842.04,0.00
2024-12-08 14:53:18,56,833,26,30,453.97,842.14,0.00
2024-12-08 14:53:18,55,833,25,30,458.17,842.65,0.00
2024-12-08 14:53:18,55,834,25,30,464.72,843.00,0.00
2024-12-08 14:53:18,56,834,25,31,456.42,843.02,0.00
2024-12-08 14:53:18,55,834,24,31,461.04,843.02,0.00
2024-12-08 14:53:18,55,835,24,31,465.58,844.00,0.00
2024-12-08 14:53:18,56,835,24,32,457.27,844.02,0.00
2024-12-08 14:53:18,55,835,24,31,464.35,844.02,0.00
2024-12-08 14:53:18,55,836,24,31,465.82,845.00,0.00
2024-12-08 14:53:18,56,836,24,32,457.51,845.02,0.00
2024-12-08 14:53:18,56,837,24,32,455.96,846.00,0.00
2024-12-08 14:53:18,57,837,24,33,447.96,846.02,0.00
2024-12-08 14:53:18,56,837,24,32,454.90,846.02,0.00
2024-12-08 14:53:18,55,837,23,32,458.59,846.58,0.00
2024-12-08 14:53:18,55,838,23,32,470.76,847.00,0.00
2024-12-08 14:53:18,56,838,24,32,462.36,847.02,0.00
2024-12-08 14:53:18,56,839,24,32,460.84,848.00,0.00
2024-12-08 14:53:18,57,839,24,33,452.76,848.02,0.00
2024-12-08 14:53:18,56,839,24,32,459.78,848.02,0.00
2024-12-08 14:53:18,55,839,23,32,467.53,848.09,0.00
2024-12-08 14:53:18,55,840,23,32,469.60,849.00,0.00
2024-12-08 14:53:18,56,840,24,32,461.22,849.02,0.00
2024-12-08 14:53:18,56,841,24,32,459.93,850.00,0.00
2024-12-08 14:53:18,57,841,24,33,451.86,850.02,0.00
2024-12-08 14:53:18,56,841,24,32,458.56,850.02,0.00
2024-12-08 14:53:18,55,841,23,32,466.16,850.11,0.00
2024-12-08 14:53:18,55,842,23,32,468.38,851.00,0.00
2024-12-08 14:53:18,56,842,23,33,460.01,851.02,0.00
2024-12-08 14:53:18,56,843,23,33,458.61,852.00,0.00
2024-12-08 14:53:18,57,843,23,34,450.57,852.02,0.00
2024-12-08 14:53:18,56,843,23,33,457.39,852.02,0.00
2024-12-08 14:53:18,55,843,22,33,464.97,852.11,0.00
2024-12-08 14:53:18,54,843,21,33,463.62,852.96,0.00
2024-12-08 14:53:18,54,844,21,33,479.12,853.00,0.00
2024-12-08 14:53:18,55,844,22,33,470.41,853.02,0.00
2024-12-08 14:53:18,54,844,21,33,465.88,853.93,0.00
2024-12-08 14:53:18,54,845,21,33,481.12,854.00,0.00
2024-12-08 14:53:18,55,845,21,34,472.37,854.02,0.00
2024-12-08 14:53:18,54,845,21,33,480.01,854.02,0.00
2024-12-08 14:53:18,54,846,21,33,481.68,855.00,0.00
2024-12-08 14:53:18,55,846,21,34,472.92,855.02,0.00
2024-12-08 14:53:18,54,846,20,34,473.13,855.04,0.00
2024-12-08 14:53:18,54,847,20,34,481.29,856.00,0.00
2024-12-08 14:53:18,55,847,21,34,472.54,856.02,0.00
2024-12-08 14:53:18,54,847,21,33,480.18,856.02,0.00
2024-12-08 14:53:18,53,847,20,33,483.91,856.02,0.00
2024-12-08 14:53:18,52,847,19,33,492.75,856.08,0.00
2024-12-08 14:53:18,52,848,19,33,501.87,857.00,0.00
2024-12-08 14:53:18,53,848,19,34,492.40,857.02,0.00
2024-12-08 14:53:18,53,849,19,34,491.57,858.00,0.00
2024-12-08 14:53:18,54,849,20,34,482.46,858.02,0.00
2024-12-08 14:53:18,53,849,20,33,489.46,858.02,0.00
2024-12-08 14:53:18,53,850,20,33,491.33,859.00,0.00
2024-12-08 14:53:18,54,850,20,34,482.23,859.02,0.00
2024-12-08 14:53:18,53,850,19,34,487.71,859.06,0.00
2024-12-08 14:53:18,53,851,19,34,490.61,860.00,0.00
2024-12-08 14:53:18,54,851,20,34,481.53,860.02,0.00
2024-12-08 14:53:18,53,851,20,33,488.50,860.02,0.00
2024-12-08 14:53:18,52,851,19,33,487.89,860.88,0.00
2024-12-08 14:53:18,52,852,19,33,503.53,861.00,0.00
2024-12-08 14:53:18,53,852,19,34,494.03,861.02,0.00
2024-12-08 14:53:18,53,853,19,34,493.13,862.00,0.00
2024-12-08 14:53:18,54,853,19,35,484.00,862.02,0.00
2024-12-08 14:53:18,53,853,19,34,491.18,862.02,0.00
2024-12-08 14:53:18,53,854,19,34,493.05,863.00,0.00
2024-12-08 14:53:18,54,854,20,34,483.92,863.02,0.00
2024-12-08 14:53:18,53,854,19,34,484.73,863.62,0.00
2024-12-08 14:53:18,53,855,19,34,492.54,864.00,0.00
2024-12-08 14:53:18,54,855,19,35,483.42,864.02,0.00
2024-12-08 14:53:18,53,855,19,34,490.10,864.02,0.00
2024-12-08 14:53:18,53,856,19,34,491.97,865.00,0.00
2024-12-08 14:53:18,54,856,20,34,482.86,865.02,0.00
2024-12-08 14:53:18,54,857,20,34,482.14,866.00,0.00
2024-12-08 14:53:18,55,857,21,34,473.37,866.02,0.00
2024-12-08 14:53:18,54,857,21,33,479.89,866.02,0.00
2024-12-08 14:53:18,53,857,20,33,488.00,866.11,0.00
2024-12-08 14:53:18,53,858,20,33,490.66,867.00,0.00
2024-12-08 14:53:18,54,858,20,34,481.57,867.02,0.00
2024-12-08 14:53:18,53,858,19,34,476.21,867.89,0.00
2024-12-08 14:53:19,53,859,19,34,491.68,868.00,0.00
2024-12-08 14:53:19,54,859,19,35,482.58,868.02,0.00
2024-12-08 14:53:19,53,859,19,34,489.55,868.02,0.00
2024-12-08 14:53:19,52,859,18,34,498.33,868.10,0.00
2024-12-08 14:53:19,52,860,18,34,501.05,869.00,0.00
2024-12-08 14:53:19,53,860,18,35,491.59,869.02,0.00
2024-12-08 14:53:19,52,860,17,35,489.55,869.79,0.00
2024-12-08 14:53:19,52,861,17,35,504.59,870.00,0.00
2024-12-08 14:53:19,53,861,18,35,495.07,870.02,0.00
2024-12-08 14:53:19,52,861,18,34,502.58,870.02,0.00
2024-12-08 14:53:19,52,862,18,34,504.66,871.00,0.00
2024-12-08 14:53:19,53,862,18,35,495.14,871.02,0.00
2024-12-08 14:53:19,53,863,18,35,494.03,872.00,0.00
2024-12-08 14:53:19,54,863,18,36,484.88,872.02,0.00
2024-12-08 14:53:19,53,863,18,35,492.22,872.02,0.00
2024-12-08 14:53:19,52,863,17,35,491.64,872.90,0.00
2024-12-08 14:53:19,52,864,17,35,507.67,873.00,0.00
2024-12-08 14:53:19,53,864,17,36,498.09,873.02,0.00
2024-12-08 14:53:19,52,864,16,36,498.39,873.35,0.00
2024-12-08 14:53:19,52,865,16,36,509.93,874.00,0.00
2024-12-08 14:53:19,53,865,16,37,500.31,874.02,0.00
2024-12-08 14:53:19,52,865,16,36,508.25,874.02,0.00
2024-12-08 14:53:19,52,866,16,36,510.35,875.00,0.00
2024-12-08 14:53:19,53,866,17,36,500.72,875.02,0.00
2024-12-08 14:53:19,52,866,16,36,500.59,875.06,0.00
2024-12-08 14:53:19,52,867,16,36,509.75,876.00,0.00
2024-12-08 14:53:19,53,867,16,37,500.13,876.02,0.00
2024-12-08 14:53:19,52,867,16,36,507.23,876.04,0.00
2024-12-08 14:53:19,51,867,15,36,516.85,876.08,0.00
2024-12-08 14:53:19,51,868,15,36,519.65,877.00,0.00
2024-12-08 14:53:19,52,868,16,36,509.66,877.02,0.00
2024-12-08 14:53:19,52,869,16,36,509.22,878.00,0.00
2024-12-08 14:53:19,53,869,17,36,499.61,878.02,0.00
2024-12-08 14:53:19,52,869,17,35,506.36,878.04,0.00
2024-12-08 14:53:19,52,870,17,35,508.62,879.00,0.00
2024-12-08 14:53:19,53,870,17,36,499.02,879.02,0.00
2024-12-08 14:53:19,52,870,16,36,504.40,879.06,0.00
2024-12-08 14:53:19,51,870,15,36,514.29,879.06,0.00
2024-12-08 14:53:19,51,871,15,36,523.84,880.00,0.00
2024-12-08 14:53:19,52,871,15,37,513.77,880.02,0.00
2024-12-08 14:53:19,51,871,15,36,521.09,880.04,0.00
2024-12-08 14:53:19,51,872,15,36,523.58,881.00,0.00
2024-12-08 14:53:19,52,872,16,36,513.51,881.02,0.00
2024-12-08 14:53:19,51,872,15,36,515.08,881.61,0.00
2024-12-08 14:53:19,50,872,14,36,519.81,881.94,0.00
2024-12-08 14:53:19,50,873,14,36,536.96,882.00,0.00
2024-12-08 14:53:19,51,873,15,36,526.43,882.02,0.00
2024-12-08 14:53:19,50,873,15,35,533.08,882.04,0.00
2024-12-08 14:53:19,50,874,15,35,535.80,883.00,0.00
2024-12-08 14:53:19,51,874,15,36,525.30,883.02,0.00
2024-12-08 14:53:19,51,875,15,36,525.26,884.00,0.00
2024-12-08 14:53:19,52,875,16,36,515.16,884.02,0.00
2024-12-08 14:53:19,51,875,16,35,521.63,884.04,0.00
2024-12-08 14:53:19,51,876,16,35,524.12,885.00,0.00
2024-12-08 14:53:19,52,876,16,36,514.04,885.02,0.00
2024-12-08 14:53:19,51,876,15,36,520.65,885.02,0.00
2024-12-08 14:53:19,50,876,14,36,522.01,885.66,0.00
2024-12-08 14:53:19,50,877,14,36,536.98,886.00,0.00
2024-12-08 14:53:19,51,877,14,37,526.45,886.02,0.00
2024-12-08 14:53:19,50,877,14,36,533.44,886.02,0.00
2024-12-08 14:53:19,49,877,13,36,541.48,886.16,0.00
2024-12-08 14:53:19,49,878,13,36,552.72,887.00,0.00
2024-12-08 14:53:19,50,878,14,36,541.67,887.02,0.00
2024-12-08 14:53:19,50,879,14,36,541.37,888.00,0.00
2024-12-08 14:53:19,51,879,14,37,530.75,888.02,0.00
2024-12-08 14:53:19,50,879,14,36,537.99,888.02,0.00
2024-12-08 14:53:19,49,879,13,36,538.64,888.88,0.00
2024-12-08 14:53:19,49,880,13,36,555.78,889.00,0.00
2024-12-08 14:53:19,50,880,13,37,544.67,889.02,0.00
2024-12-08 14:53:19,49,880,12,37,551.62,889.06,0.00
2024-12-08 14:53:19,49,881,12,37,562.04,890.00,0.00
2024-12-08 14:53:19,50,881,13,37,550.80,890.02,0.00
2024-12-08 14:53:19,49,881,13,36,558.77,890.02,0.00
2024-12-08 14:53:19,48,881,12,36,562.63,890.04,0.00
2024-12-08 14:53:19,48,882,12,36,573.28,891.00,0.00
2024-12-08 14:53:19,49,882,13,36,561.58,891.02,0.00
2024-12-08 14:53:19,49,883,13,36,561.60,892.00,0.00
2024-12-08 14:53:19,50,883,14,36,550.37,892.02,0.00
2024-12-08 14:53:19,49,883,13,36,561.24,892.04,0.00
2024-12-08 14:53:19,49,884,13,36,560.59,893.00,0.00
2024-12-08 14:53:19,50,884,13,37,549.38,893.02,0.00
2024-12-08 14:53:19,49,884,13,36,560.23,893.04,0.00
2024-12-08 14:53:19,49,885,13,36,563.23,894.00,0.00
2024-12-08 14:53:19,50,885,13,37,551.96,894.02,0.00
2024-12-08 14:53:19,49,885,12,37,556.84,894.02,0.00
2024-12-08 14:53:19,49,886,12,37,563.31,895.00,0.00
2024-12-08 14:53:19,50,886,13,37,552.04,895.02,0.00
2024-12-08 14:53:20,49,886,13,36,559.47,895.02,0.00
2024-12-08 14:53:20,49,887,13,36,562.29,896.00,0.00
2024-12-08 14:53:20,50,887,14,36,551.05,896.02,0.00
2024-12-08 14:53:20,50,888,14,36,550.73,897.00,0.00
2024-12-08 14:53:20,51,888,15,36,539.94,897.02,0.00
2024-12-08 14:53:20,50,888,15,35,546.80,897.04,0.00
2024-12-08 14:53:20,50,889,15,35,549.55,898.00,0.00
2024-12-08 14:53:20,51,889,15,36,538.78,898.02,0.00
2024-12-08 14:53:20,50,889,14,36,535.55,898.88,0.00
2024-12-08 14:53:20,50,890,14,36,552.53,899.00,0.00
2024-12-08 14:53:20,51,890,15,36,541.70,899.02,0.00
2024-12-08 14:53:20,50,890,15,35,548.76,899.04,0.00
2024-12-08 14:53:20,50,891,15,35,551.53,900.00,0.00
2024-12-08 14:53:20,51,891,15,36,540.71,900.02,0.00
2024-12-08 14:53:20,50,891,14,36,551.17,900.04,0.00
2024-12-08 14:53:20,50,892,14,36,557.54,901.00,0.00
2024-12-08 14:53:20,51,892,15,36,546.61,901.02,0.00
2024-12-08 14:53:20,50,892,15,35,553.59,901.04,0.00
2024-12-08 14:53:20,49,892,14,35,554.58,901.92,0.00
2024-12-08 14:53:20,49,893,14,35,572.32,902.00,0.00
2024-12-08 14:53:20,50,893,15,35,560.87,902.02,0.00
2024-12-08 14:53:20,50,894,15,35,560.35,903.00,0.00
2024-12-08 14:53:20,51,894,16,35,549.36,903.02,0.00
2024-12-08 14:53:20,50,894,16,34,556.56,903.04,0.00
2024-12-08 14:53:20,50,895,16,34,559.34,904.00,0.00
2024-12-08 14:53:20,51,895,16,35,548.37,904.02,0.00
2024-12-08 14:53:20,50,895,15,35,549.65,904.62,0.00
2024-12-08 14:53:20,50,896,15,35,564.60,905.00,0.00
2024-12-08 14:53:20,51,896,15,36,553.53,905.02,0.00
2024-12-08 14:53:20,50,896,15,35,560.98,905.04,0.00
2024-12-08 14:53:20,50,897,15,35,563.77,906.00,0.00
2024-12-08 14:53:20,51,897,16,35,552.72,906.02,0.00
2024-12-08 14:53:20,50,897,15,35,554.37,906.62,0.00
2024-12-08 14:53:20,50,898,15,35,569.35,907.00,0.00
2024-12-08 14:53:20,51,898,15,36,558.19,907.02,0.00
2024-12-08 14:53:20,50,898,15,35,565.91,907.04,0.00
2024-12-08 14:53:20,50,899,15,35,568.71,908.00,0.00
2024-12-08 14:53:20,51,899,16,35,557.56,908.02,0.00
2024-12-08 14:53:20,51,900,16,35,556.57,909.00,0.00
2024-12-08 14:53:20,52,900,17,35,545.87,909.02,0.00
2024-12-08 14:53:20,51,900,17,34,553.37,909.04,0.00
2024-12-08 14:53:20,51,901,17,34,555.93,910.00,0.00
2024-12-08 14:53:20,52,901,18,34,545.24,910.02,0.00
2024-12-08 14:53:20,52,902,18,34,544.24,911.00,0.00
2024-12-08 14:53:20,53,902,18,35,533.97,911.02,0.00
2024-12-08 14:53:20,52,902,18,34,541.26,911.04,0.00
2024-12-08 14:53:20,51,902,17,34,545.82,911.67,0.00
2024-12-08 14:53:20,51,903,17,34,560.91,912.00,0.00
2024-12-08 14:53:20,52,903,17,35,550.12,912.02,0.00
2024-12-08 14:53:20,52,904,17,35,549.14,913.00,0.00
2024-12-08 14:53:20,53,904,17,36,538.78,913.02,0.00
2024-12-08 14:53:20,52,904,17,35,546.16,913.04,0.00
2024-12-08 14:53:20,51,904,16,35,550.91,913.31,0.00
2024-12-08 14:53:20,51,905,16,35,563.04,914.00,0.00
2024-12-08 14:53:20,52,905,17,35,552.21,914.02,0.00
2024-12-08 14:53:20,51,905,16,35,555.94,914.22,0.00
2024-12-08 14:53:20,51,906,16,35,567.24,915.00,0.00
2024-12-08 14:53:20,52,906,17,35,556.33,915.02,0.00
2024-12-08 14:53:20,51,906,17,34,563.84,915.06,0.00
2024-12-08 14:53:20,51,907,17,34,566.60,916.00,0.00
2024-12-08 14:53:20,52,907,18,34,555.71,916.02,0.00
2024-12-08 14:53:20,52,908,18,34,554.39,917.00,0.00
2024-12-08 14:53:20,53,908,19,34,543.93,917.02,0.00
2024-12-08 14:53:20,52,908,19,33,551.75,917.04,0.00
2024-12-08 14:53:20,52,909,19,33,554.11,918.00,0.00
2024-12-08 14:53:20,53,909,20,33,543.66,918.02,0.00
2024-12-08 14:53:20,53,910,20,33,542.45,919.00,0.00
2024-12-08 14:53:20,54,910,21,33,532.40,919.02,0.00
2024-12-08 14:53:20,53,910,21,32,539.85,919.04,0.00
2024-12-08 14:53:20,53,911,21,32,542.00,920.00,0.00
2024-12-08 14:53:20,54,911,22,32,531.96,920.02,0.00
2024-12-08 14:53:21,54,912,22,32,530.71,921.00,0.00
2024-12-08 14:53:21,55,912,23,32,521.06,921.02,0.00
2024-12-08 14:53:21,54,912,23,31,528.15,921.04,0.00
2024-12-08 14:53:21,54,913,23,31,530.09,922.00,0.00
2024-12-08 14:53:21,55,913,23,32,520.45,922.02,0.00
2024-12-08 14:53:21,54,913,22,32,521.56,922.59,0.00
2024-12-08 14:53:21,54,914,22,32,528.70,923.00,0.00
2024-12-08 14:53:21,55,914,22,33,519.09,923.02,0.00
2024-12-08 14:53:21,54,914,22,32,526.31,923.04,0.00
2024-12-08 14:53:21,54,915,22,32,528.25,924.00,0.00
2024-12-08 14:53:21,55,915,22,33,518.64,924.02,0.00
2024-12-08 14:53:21,55,916,22,33,517.22,925.00,0.00
2024-12-08 14:53:21,56,916,23,33,507.99,925.02,0.00
2024-12-08 14:53:21,55,916,23,32,514.87,925.04,0.00
2024-12-08 14:53:21,54,916,22,32,514.18,925.87,0.00
2024-12-08 14:53:21,54,917,22,32,530.20,926.00,0.00
2024-12-08 14:53:21,55,917,22,33,520.56,926.02,0.00
2024-12-08 14:53:21,55,918,22,33,519.24,927.00,0.00
2024-12-08 14:53:21,56,918,23,33,509.97,927.02,0.00
2024-12-08 14:53:21,55,918,23,32,516.89,927.04,0.00
2024-12-08 14:53:21,54,918,22,32,516.81,927.85,0.00
2024-12-08 14:53:21,54,919,22,32,532.72,928.00,0.00
2024-12-08 14:53:21,55,919,22,33,523.04,928.02,0.00
2024-12-08 14:53:21,54,919,21,33,523.77,928.65,0.00
2024-12-08 14:53:21,53,919,20,33,529.58,928.87,0.00
2024-12-08 14:53:21,53,920,20,33,545.99,929.00,0.00
2024-12-08 14:53:21,54,920,21,33,535.88,929.02,0.00
2024-12-08 14:53:21,53,920,21,32,543.53,929.04,0.00
2024-12-08 14:53:21,53,921,21,32,545.70,930.00,0.00
2024-12-08 14:53:21,54,921,21,33,535.59,930.02,0.00
2024-12-08 14:53:21,54,922,21,33,534.05,931.00,0.00
2024-12-08 14:53:21,55,922,22,33,524.34,931.02,0.00
2024-12-08 14:53:21,54,922,22,32,531.81,931.04,0.00
2024-12-08 14:53:21,54,923,22,32,533.76,932.00,0.00
2024-12-08 14:53:21,55,923,22,33,524.05,932.02,0.00
2024-12-08 14:53:21,55,924,22,33,522.63,933.00,0.00
2024-12-08 14:53:21,56,924,23,33,513.30,933.02,0.00
2024-12-08 14:53:21,55,924,23,32,520.42,933.04,0.00
2024-12-08 14:53:21,55,925,23,32,522.17,934.00,0.00
2024-12-08 14:53:21,56,925,23,33,512.85,934.02,0.00
2024-12-08 14:53:21,56,926,23,33,511.68,935.00,0.00
2024-12-08 14:53:21,57,926,23,34,502.70,935.02,0.00
2024-12-08 14:53:21,56,926,23,33,509.34,935.04,0.00
2024-12-08 14:53:21,55,926,22,33,511.08,935.73,0.00
2024-12-08 14:53:21,55,927,22,33,525.74,936.00,0.00
2024-12-08 14:53:21,56,927,22,34,516.35,936.02,0.00
2024-12-08 14:53:21,55,927,21,34,525.57,936.02,0.00
2024-12-08 14:53:21,54,927,20,34,530.83,936.13,0.00
2024-12-08 14:53:21,53,927,19,34,535.85,936.70,0.00
2024-12-08 14:53:21,53,928,19,34,544.61,937.00,0.00
2024-12-08 14:53:21,54,928,19,35,534.52,937.02,0.00
2024-12-08 14:53:21,53,928,19,34,542.49,937.02,0.00
2024-12-08 14:53:21,53,929,19,34,544.48,938.00,0.00
2024-12-08 14:53:21,54,929,20,34,534.40,938.02,0.00
2024-12-08 14:53:21,54,930,20,34,533.18,939.00,0.00
2024-12-08 14:53:21,55,930,20,35,523.48,939.02,0.00
2024-12-08 14:53:21,54,930,20,34,530.75,939.04,0.00
2024-12-08 14:53:21,54,931,20,34,532.70,940.00,0.00
2024-12-08 14:53:21,55,931,20,35,523.01,940.02,0.00
2024-12-08 14:53:21,55,932,20,35,521.75,941.00,0.00
2024-12-08 14:53:21,56,932,21,35,512.43,941.02,0.00
2024-12-08 14:53:21,57,931,22,35,503.44,941.05,0.00
2024-12-08 14:53:21,56,931,22,34,522.37,941.05,0.00
2024-12-08 14:53:21,55,931,21,34,520.17,941.96,0.00
2024-12-08 14:53:21,55,932,21,34,536.97,942.00,0.00
2024-12-08 14:53:21,56,932,21,35,527.38,942.02,0.00
2024-12-08 14:53:21,55,932,20,35,528.15,942.62,0.00
2024-12-08 14:53:21,55,933,20,35,557.73,943.00,0.00
2024-12-08 14:53:21,56,933,21,35,547.77,943.02,0.00
2024-12-08 14:53:21,56,934,21,35,550.64,944.00,0.00
2024-12-08 14:53:21,57,934,21,36,540.98,944.02,0.00
2024-12-08 14:53:21,57,935,21,36,542.30,945.00,0.00
2024-12-08 14:53:21,58,935,22,36,532.95,945.02,0.00
2024-12-08 14:53:21,58,936,22,36,531.70,946.00,0.00
2024-12-08 14:53:21,59,936,23,36,522.69,946.02,0.00
2024-12-08 14:53:21,58,936,23,35,529.09,946.02,0.00
2024-12-08 14:53:21,57,936,22,35,532.59,946.65,0.00
2024-12-08 14:53:21,57,937,22,35,539.49,947.00,0.00
2024-12-08 14:53:21,58,937,22,36,530.19,947.02,0.00
2024-12-08 14:53:21,58,938,22,36,527.97,948.00,0.00
2024-12-08 14:53:21,59,938,23,36,519.02,948.02,0.00
2024-12-08 14:53:21,58,938,23,35,526.99,948.02,0.00
2024-12-08 14:53:21,57,938,22,35,534.95,948.16,0.00
2024-12-08 14:53:21,56,938,21,35,537.88,948.46,0.00
2024-12-08 14:53:21,56,939,21,35,550.12,949.00,0.00
2024-12-08 14:53:22,57,939,22,35,540.47,949.02,0.00
2024-12-08 14:53:22,57,940,22,35,538.37,950.00,0.00
2024-12-08 14:53:22,58,940,22,36,529.09,950.02,0.00
2024-12-08 14:53:22,57,940,22,35,537.54,950.02,0.00
2024-12-08 14:53:22,56,940,21,35,541.70,950.61,0.00
2024-12-08 14:53:22,56,941,21,35,548.44,951.00,0.00
2024-12-08 14:53:22,57,941,22,35,538.82,951.02,0.00
2024-12-08 14:53:22,57,942,22,35,536.72,952.00,0.00
2024-12-08 14:53:22,58,942,22,36,527.46,952.02,0.00
2024-12-08 14:53:22,57,942,22,35,535.88,952.02,0.00
2024-12-08 14:53:22,56,942,21,35,540.97,952.30,0.00
2024-12-08 14:53:22,56,943,21,35,551.81,953.00,0.00
2024-12-08 14:53:22,57,943,22,35,542.13,953.02,0.00
2024-12-08 14:53:22,57,944,22,35,540.02,954.00,0.00
2024-12-08 14:53:22,58,944,23,35,530.71,954.02,0.00
2024-12-08 14:53:22,57,944,23,34,538.85,954.04,0.00
2024-12-08 14:53:22,56,944,22,34,543.55,954.57,0.00
2024-12-08 14:53:22,57,943,23,34,531.86,954.84,0.00
2024-12-08 14:53:22,57,944,23,34,542.04,955.00,0.00
2024-12-08 14:53:22,58,944,23,35,532.69,955.02,0.00
2024-12-08 14:53:22,57,944,22,35,536.90,955.19,0.00
2024-12-08 14:53:22,57,945,22,35,556.53,956.00,0.00
2024-12-08 14:53:22,58,945,23,35,546.93,956.02,0.00
2024-12-08 14:53:22,57,945,23,34,555.53,956.04,0.00
2024-12-08 14:53:22,56,945,22,34,554.21,956.95,0.00
2024-12-08 14:53:22,56,946,22,34,570.82,957.00,0.00
2024-12-08 14:53:22,57,946,23,34,560.80,957.02,0.00
2024-12-08 14:53:22,57,947,23,34,558.70,958.00,0.00
2024-12-08 14:53:22,58,947,23,35,549.07,958.02,0.00
2024-12-08 14:53:22,57,947,23,34,557.53,958.04,0.00
2024-12-08 14:53:22,57,948,23,34,558.95,959.00,0.00
2024-12-08 14:53:22,58,948,24,34,549.31,959.02,0.00
2024-12-08 14:53:22,59,947,24,35,529.98,959.80,0.00
2024-12-08 14:53:22,59,948,24,35,539.91,960.00,0.00
2024-12-08 14:53:22,60,948,24,36,530.91,960.02,0.00
2024-12-08 14:53:22,59,948,24,35,538.78,960.03,0.00
2024-12-08 14:53:22,58,948,23,35,539.70,960.79,0.00
2024-12-08 14:53:22,58,949,23,35,571.00,961.00,0.00
2024-12-08 14:53:22,59,949,24,35,561.32,961.02,0.00
2024-12-08 14:53:22,58,949,23,35,560.43,961.14,0.00
2024-12-08 14:53:22,58,950,23,35,569.27,962.00,0.00
2024-12-08 14:53:22,59,950,23,36,559.62,962.02,0.00
2024-12-08 14:53:22,58,950,23,35,568.28,962.03,0.00
2024-12-08 14:53:22,58,951,23,35,569.53,963.00,0.00
2024-12-08 14:53:22,59,951,24,35,559.88,963.02,0.00
2024-12-08 14:53:22,59,952,24,35,557.52,964.00,0.00
2024-12-08 14:53:22,60,952,24,36,548.23,964.02,0.00
2024-12-08 14:53:22,59,952,24,35,556.54,964.03,0.00
2024-12-08 14:53:22,59,953,24,35,557.61,965.00,0.00
2024-12-08 14:53:22,60,953,24,36,548.31,965.02,0.00
2024-12-08 14:53:22,59,953,23,36,549.76,965.05,0.00
2024-12-08 14:53:22,59,954,23,36,557.53,966.00,0.00
2024-12-08 14:53:22,60,954,24,36,548.24,966.02,0.00
2024-12-08 14:53:22,59,954,24,35,556.71,966.03,0.00
2024-12-08 14:53:22,59,955,24,35,557.78,967.00,0.00
2024-12-08 14:53:22,60,955,24,36,548.48,967.02,0.00
2024-12-08 14:53:22,60,956,24,36,545.99,968.00,0.00
2024-12-08 14:53:22,61,956,24,37,537.04,968.02,0.00
2024-12-08 14:53:22,60,956,24,36,544.86,968.03,0.00
2024-12-08 14:53:22,60,957,24,36,545.74,969.00,0.00
2024-12-08 14:53:22,61,957,24,37,536.80,969.02,0.00
2024-12-08 14:53:22,60,957,23,37,541.10,969.17,0.00
2024-12-08 14:53:22,59,957,22,37,550.11,969.17,0.00
2024-12-08 14:53:22,59,958,22,37,552.44,970.00,0.00
2024-12-08 14:53:22,60,958,23,37,543.24,970.02,0.00
2024-12-08 14:53:22,59,958,23,36,551.46,970.03,0.00
2024-12-08 14:53:22,58,958,22,36,555.42,970.64,0.00
2024-12-08 14:53:22,57,958,21,36,560.58,970.89,0.00
2024-12-08 14:53:22,57,959,21,36,576.67,971.00,0.00
2024-12-08 14:53:22,58,959,22,36,566.73,971.02,0.00
2024-12-08 14:53:22,57,959,21,36,567.11,971.67,0.00
2024-12-08 14:53:22,57,960,21,36,581.19,972.00,0.00
2024-12-08 14:53:22,58,960,22,36,571.17,972.02,0.00
2024-12-08 14:53:22,57,960,22,35,579.83,972.04,0.00
2024-12-08 14:53:22,57,961,22,35,581.28,973.00,0.00
2024-12-08 14:53:22,58,961,22,36,571.25,973.02,0.00
2024-12-08 14:53:22,57,961,21,36,572.06,973.07,0.00
2024-12-08 14:53:22,57,962,21,36,580.68,974.00,0.00
2024-12-08 14:53:22,58,962,22,36,570.66,974.02,0.00
2024-12-08 14:53:22,57,962,22,35,579.31,974.04,0.00
2024-12-08 14:53:22,56,962,21,35,584.79,974.04,0.00
2024-12-08 14:53:22,56,963,21,35,593.39,975.00,0.00
2024-12-08 14:53:22,57,963,21,36,582.98,975.02,0.00
2024-12-08 14:53:22,56,963,20,36,588.73,975.14,0.00
2024-12-08 14:53:22,56,964,20,36,591.39,976.00,0.00
2024-12-08 14:53:22,57,964,21,36,581.01,976.02,0.00
2024-12-08 14:53:22,56,964,21,35,589.65,976.04,0.00
2024-12-08 14:53:22,56,965,21,35,591.30,977.00,0.00
2024-12-08 14:53:22,57,965,21,36,580.92,977.02,0.00
2024-12-08 14:53:22,56,965,20,36,575.04,977.64,0.00
2024-12-08 14:53:23,56,966,20,36,589.28,978.00,0.00
2024-12-08 14:53:23,57,966,21,36,578.94,978.02,0.00
2024-12-08 14:53:23,56,966,20,36,589.11,978.02,0.00
2024-12-08 14:53:23,55,966,20,35,598.40,978.02,0.00
2024-12-08 14:53:23,55,967,20,35,600.08,979.00,0.00
2024-12-08 14:53:23,56,967,21,35,589.36,979.02,0.00
2024-12-08 14:53:23,55,967,20,35,590.43,979.65,0.00
2024-12-08 14:53:23,55,968,20,35,598.02,980.00,0.00
2024-12-08 14:53:23,56,968,20,36,587.34,980.02,0.00
2024-12-08 14:53:23,55,968,20,35,596.59,980.02,0.00
2024-12-08 14:53:23,55,969,20,35,598.27,981.00,0.00
2024-12-08 14:53:23,56,969,20,36,587.59,981.02,0.00
2024-12-08 14:53:23,56,970,20,36,585.55,982.00,0.00
2024-12-08 14:53:23,57,970,20,37,575.28,982.02,0.00
2024-12-08 14:53:23,56,970,20,36,583.80,982.02,0.00
2024-12-08 14:53:23,56,971,20,36,585.27,983.00,0.00
2024-12-08 14:53:23,57,971,20,37,575.00,983.02,0.00
2024-12-08 14:53:23,57,972,20,37,572.83,984.00,0.00
2024-12-08 14:53:23,58,972,20,38,562.95,984.02,0.00
2024-12-08 14:53:23,57,972,20,37,571.27,984.02,0.00
2024-12-08 14:53:23,56,972,19,37,581.27,984.04,0.00
2024-12-08 14:53:23,55,972,18,37,586.07,984.31,0.00
2024-12-08 14:53:23,55,973,18,37,597.63,985.00,0.00
2024-12-08 14:53:23,56,973,18,38,586.96,985.02,0.00
2024-12-08 14:53:23,56,974,18,38,584.91,986.00,0.00
2024-12-08 14:53:23,57,974,19,38,574.65,986.02,0.00
2024-12-08 14:53:23,56,974,19,37,583.50,986.02,0.00
2024-12-08 14:53:23,55,974,18,37,584.59,986.38,0.00
2024-12-08 14:53:23,55,975,18,37,596.87,987.00,0.00
2024-12-08 14:53:23,56,975,19,37,586.21,987.02,0.00
2024-12-08 14:53:23,56,976,19,37,584.51,988.00,0.00
2024-12-08 14:53:23,57,976,20,37,574.26,988.02,0.00
2024-12-08 14:53:23,56,976,20,36,581.87,988.02,0.00
2024-12-08 14:53:23,56,977,20,36,583.34,989.00,0.00
2024-12-08 14:53:23,57,977,20,37,573.10,989.02,0.00
2024-12-08 14:53:23,57,978,20,37,571.24,990.00,0.00
2024-12-08 14:53:23,58,978,21,37,561.39,990.02,0.00
2024-12-08 14:53:23,57,978,21,36,568.81,990.02,0.00
2024-12-08 14:53:23,56,978,20,36,576.36,990.29,0.00
2024-12-08 14:53:23,55,978,19,36,577.04,990.96,0.00
2024-12-08 14:53:23,55,979,19,36,594.71,991.00,0.00
2024-12-08 14:53:23,56,979,19,37,584.09,991.02,0.00
2024-12-08 14:53:23,56,980,19,37,582.07,992.00,0.00
2024-12-08 14:53:23,57,980,19,38,571.86,992.02,0.00
2024-12-08 14:53:23,56,980,19,37,579.77,992.02,0.00
2024-12-08 14:53:23,56,981,19,37,581.24,993.00,0.00
2024-12-08 14:53:23,57,981,20,37,571.04,993.02,0.00
2024-12-08 14:53:23,56,981,19,37,565.61,993.96,0.00
2024-12-08 14:53:23,56,982,19,37,583.02,994.00,0.00
2024-12-08 14:53:23,57,982,19,38,572.79,994.02,0.00
2024-12-08 14:53:23,56,982,19,37,580.71,994.02,0.00
2024-12-08 14:53:23,56,983,19,37,582.19,995.00,0.00
2024-12-08 14:53:23,57,983,19,38,571.97,995.02,0.00
2024-12-08 14:53:23,57,984,19,38,570.17,996.00,0.00
2024-12-08 14:53:23,58,984,20,38,560.34,996.02,0.00
2024-12-08 14:53:23,57,984,20,37,567.90,996.02,0.00
2024-12-08 14:53:23,56,984,19,37,577.45,996.07,0.00
2024-12-08 14:53:23,55,984,18,37,581.95,996.69,0.00
2024-12-08 14:53:23,55,985,18,37,597.23,997.00,0.00
2024-12-08 14:53:23,56,985,18,38,586.56,997.02,0.00
2024-12-08 14:53:23,56,986,18,38,584.70,998.00,0.00
2024-12-08 14:53:23,57,986,19,38,574.44,998.02,0.00
2024-12-08 14:53:23,56,986,19,37,582.38,998.02,0.00
2024-12-08 14:53:23,56,987,19,37,583.85,999.00,0.00
2024-12-08 14:53:23,57,987,19,38,573.61,999.02,0.00
2024-12-08 14:53:23,56,987,18,38,570.91,999.82,0.00
2024-12-08 14:53:23,56,988,18,38,587.12,1000.00,0.00
2024-12-08 14:53:23,57,988,18,39,576.82,1000.02,0.00
2024-12-08 14:53:23,56,988,18,38,584.62,1000.04,0.00
2024-12-08 14:53:23,55,988,17,38,592.59,1000.20,0.00
2024-12-08 14:53:23,55,989,17,38,603.30,1001.00,0.00
2024-12-08 14:53:23,56,989,17,39,592.53,1001.02,0.00
2024-12-08 14:53:23,56,990,17,39,590.60,1002.00,0.00
2024-12-08 14:53:23,57,990,18,39,580.24,1002.02,0.00
2024-12-08 14:53:23,56,990,18,38,588.10,1002.04,0.00
2024-12-08 14:53:23,56,991,18,38,589.75,1003.00,0.00
2024-12-08 14:53:23,57,991,19,38,579.41,1003.02,0.00
2024-12-08 14:53:23,57,992,19,38,577.45,1004.00,0.00
2024-12-08 14:53:23,58,992,19,39,567.49,1004.02,0.00
2024-12-08 14:53:23,57,992,19,38,575.16,1004.04,0.00
2024-12-08 14:53:23,57,993,19,38,576.61,1005.00,0.00
2024-12-08 14:53:23,58,993,20,38,566.67,1005.02,0.00
2024-12-08 14:53:23,58,994,20,38,564.54,1006.00,0.00
2024-12-08 14:53:23,59,994,20,39,554.98,1006.02,0.00
2024-12-08 14:53:23,58,994,20,38,562.47,1006.03,0.00
2024-12-08 14:53:24,58,995,20,38,563.72,1007.00,0.00
2024-12-08 14:53:24,59,995,21,38,554.16,1007.02,0.00
2024-12-08 14:53:24,58,995,20,38,548.18,1007.95,0.00
2024-12-08 14:53:24,58,996,20,38,565.06,1008.00,0.00
2024-12-08 14:53:24,59,996,21,38,555.48,1008.02,0.00
2024-12-08 14:53:24,58,996,21,37,563.15,1008.03,0.00
2024-12-08 14:53:24,58,997,21,37,564.40,1009.00,0.00
2024-12-08 14:53:24,59,997,21,38,554.84,1009.02,0.00
2024-12-08 14:53:24,59,998,21,38,552.65,1010.00,0.00
2024-12-08 14:53:24,60,998,22,38,543.44,1010.02,0.00
2024-12-08 14:53:24,59,998,22,37,550.77,1010.03,0.00
2024-12-08 14:53:24,58,998,21,37,546.99,1010.67,0.00
2024-12-08 14:53:24,58,999,21,37,561.34,1011.00,0.00
2024-12-08 14:53:24,59,999,22,37,551.82,1011.02,0.00
2024-12-08 14:53:24,59,1000,22,37,549.63,1012.00,0.00
2024-12-08 14:53:24,60,1000,22,38,540.47,1012.02,0.00
2024-12-08 14:53:24,59,1000,22,37,547.92,1012.03,0.00
2024-12-08 14:53:24,59,1001,22,37,548.98,1013.00,0.00
2024-12-08 14:53:24,60,1001,23,37,539.83,1013.02,0.00
2024-12-08 14:53:24,59,1001,22,37,547.15,1013.03,0.00
2024-12-08 14:53:24,59,1002,22,37,551.64,1014.00,0.00
2024-12-08 14:53:24,60,1002,23,37,542.45,1014.02,0.00
2024-12-08 14:53:24,59,1002,23,36,547.70,1014.05,0.00
2024-12-08 14:53:24,58,1002,22,36,556.46,1014.10,0.00
2024-12-08 14:53:24,58,1003,22,36,558.38,1015.00,0.00
2024-12-08 14:53:24,59,1003,22,37,548.92,1015.02,0.00
2024-12-08 14:53:24,58,1003,21,37,542.33,1015.66,0.00
2024-12-08 14:53:24,58,1004,21,37,556.58,1016.00,0.00
2024-12-08 14:53:24,59,1004,22,37,547.15,1016.02,0.00
2024-12-08 14:53:24,58,1004,22,36,554.14,1016.05,0.00
2024-12-08 14:53:24,57,1004,21,36,559.15,1016.26,0.00
2024-12-08 14:53:24,57,1005,21,36,569.97,1017.00,0.00
2024-12-08 14:53:24,58,1005,21,37,560.14,1017.02,0.00
2024-12-08 14:53:24,59,1004,22,37,550.48,1017.07,0.00
2024-12-08 14:53:24,59,1005,22,37,561.88,1018.00,0.00
2024-12-08 14:53:24,60,1005,23,37,552.52,1018.02,0.00
2024-12-08 14:53:24,59,1005,22,37,557.43,1018.12,0.00
2024-12-08 14:53:24,59,1006,22,37,582.18,1019.00,0.00
2024-12-08 14:53:24,60,1006,23,37,572.47,1019.02,0.00
2024-12-08 14:53:24,59,1006,22,37,572.32,1019.66,0.00
2024-12-08 14:53:24,59,1007,22,37,584.52,1020.00,0.00
2024-12-08 14:53:24,60,1007,23,37,574.78,1020.02,0.00
2024-12-08 14:53:24,60,1008,23,37,575.71,1021.00,0.00
2024-12-08 14:53:24,61,1008,24,37,566.28,1021.02,0.00
2024-12-08 14:53:24,61,1009,24,37,564.48,1022.00,0.00
2024-12-08 14:53:24,62,1009,25,37,555.38,1022.02,0.00
2024-12-08 14:53:24,61,1009,25,36,561.63,1022.03,0.00
2024-12-08 14:53:24,60,1009,24,36,569.84,1022.15,0.00
2024-12-08 14:53:24,60,1010,24,36,571.89,1023.00,0.00
2024-12-08 14:53:24,61,1010,24,37,562.52,1023.02,0.00
2024-12-08 14:53:24,60,1010,24,36,570.36,1023.03,0.00
2024-12-08 14:53:24,60,1011,24,36,571.26,1024.00,0.00
2024-12-08 14:53:24,61,1011,25,36,561.89,1024.02,0.00
2024-12-08 14:53:24,60,1011,24,36,564.16,1024.25,0.00
2024-12-08 14:53:24,60,1012,24,36,574.03,1025.00,0.00
2024-12-08 14:53:24,61,1012,24,37,564.62,1025.02,0.00
2024-12-08 14:53:24,60,1012,24,36,572.50,1025.03,0.00
2024-12-08 14:53:24,60,1013,24,36,573.40,1026.00,0.00
2024-12-08 14:53:24,61,1013,25,36,564.00,1026.02,0.00
2024-12-08 14:53:24,60,1013,24,36,564.44,1026.33,0.00
2024-12-08 14:53:24,60,1014,24,36,575.15,1027.00,0.00
2024-12-08 14:53:24,61,1014,24,37,565.73,1027.02,0.00
2024-12-08 14:53:24,60,1014,24,36,573.28,1027.05,0.00
2024-12-08 14:53:24,60,1015,24,36,574.34,1028.00,0.00
2024-12-08 14:53:24,61,1015,24,37,564.93,1028.02,0.00
2024-12-08 14:53:24,60,1015,23,37,566.21,1028.30,0.00
2024-12-08 14:53:24,60,1016,23,37,576.62,1029.00,0.00
2024-12-08 14:53:24,61,1016,23,38,567.17,1029.02,0.00
2024-12-08 14:53:24,60,1016,23,37,574.56,1029.05,0.00
2024-12-08 14:53:24,60,1017,23,37,575.63,1030.00,0.00
2024-12-08 14:53:24,61,1017,23,38,566.20,1030.02,0.00
2024-12-08 14:53:24,61,1018,23,38,563.41,1031.00,0.00
2024-12-08 14:53:24,62,1018,23,39,554.33,1031.02,0.00
2024-12-08 14:53:24,61,1018,22,39,563.25,1031.02,0.00
2024-12-08 14:53:24,60,1018,22,38,570.92,1031.03,0.00
2024-12-08 14:53:24,60,1019,22,38,571.81,1032.00,0.00
2024-12-08 14:53:24,61,1019,22,39,562.44,1032.02,0.00
2024-12-08 14:53:25,61,1020,22,39,559.65,1033.00,0.00
2024-12-08 14:53:25,62,1020,23,39,550.62,1033.02,0.00
2024-12-08 14:53:25,61,1020,23,38,558.13,1033.03,0.00
2024-12-08 14:53:25,60,1020,22,38,557.14,1033.87,0.00
2024-12-08 14:53:25,60,1021,22,38,573.09,1034.00,0.00
2024-12-08 14:53:25,61,1021,22,39,563.70,1034.02,0.00
2024-12-08 14:53:25,60,1021,21,39,568.31,1034.13,0.00
2024-12-08 14:53:25,59,1021,20,39,571.11,1034.14,0.00
2024-12-08 14:53:25,58,1021,19,39,575.88,1034.66,0.00
2024-12-08 14:53:25,58,1022,19,39,590.40,1035.00,0.00
2024-12-08 14:53:25,59,1022,20,39,580.40,1035.02,0.00
2024-12-08 14:53:25,58,1022,20,38,588.80,1035.03,0.00
2024-12-08 14:53:25,57,1022,19,38,588.87,1035.86,0.00
2024-12-08 14:53:25,57,1023,19,38,605.70,1036.00,0.00
2024-12-08 14:53:25,58,1023,20,38,595.26,1036.02,0.00
2024-12-08 14:53:25,57,1023,19,38,588.03,1036.68,0.00
2024-12-08 14:53:25,57,1024,19,38,603.20,1037.00,0.00
2024-12-08 14:53:25,58,1024,20,38,592.80,1037.02,0.00
2024-12-08 14:53:25,57,1024,20,37,601.56,1037.04,0.00
2024-12-08 14:53:25,57,1025,20,37,603.05,1038.00,0.00
2024-12-08 14:53:25,58,1025,21,37,592.65,1038.02,0.00
2024-12-08 14:53:25,58,1026,21,37,590.18,1039.00,0.00
2024-12-08 14:53:25,59,1026,22,37,580.17,1039.02,0.00
2024-12-08 14:53:25,58,1026,22,36,588.75,1039.03,0.00
2024-12-08 14:53:25,58,1027,22,36,590.03,1040.00,0.00
2024-12-08 14:53:25,59,1027,22,37,580.03,1040.02,0.00
2024-12-08 14:53:25,59,1028,22,37,577.41,1041.00,0.00
2024-12-08 14:53:25,60,1028,22,38,567.79,1041.02,0.00
2024-12-08 14:53:25,59,1028,22,37,576.00,1041.03,0.00
2024-12-08 14:53:25,59,1029,22,37,577.08,1042.00,0.00
2024-12-08 14:53:25,60,1029,22,38,567.46,1042.02,0.00
2024-12-08 14:53:25,59,1029,21,38,562.36,1042.90,0.00
2024-12-08 14:53:25,59,1030,21,38,579.05,1043.00,0.00
2024-12-08 14:53:25,60,1030,21,39,569.40,1043.02,0.00
2024-12-08 14:53:25,59,1030,21,38,577.81,1043.03,0.00
2024-12-08 14:53:25,58,1030,20,38,581.67,1043.07,0.00
2024-12-08 14:53:25,58,1031,20,38,590.50,1044.00,0.00
2024-12-08 14:53:25,59,1031,20,39,580.49,1044.02,0.00
2024-12-08 14:53:25,59,1032,20,39,577.86,1045.00,0.00
2024-12-08 14:53:25,60,1032,20,40,568.23,1045.02,0.00
2024-12-08 14:53:25,59,1032,20,39,576.80,1045.03,0.00
2024-12-08 14:53:25,59,1033,20,39,577.88,1046.00,0.00
2024-12-08 14:53:25,60,1033,20,40,568.25,1046.02,0.00
2024-12-08 14:53:25,59,1033,19,40,568.04,1046.63,0.00
2024-12-08 14:53:25,59,1034,19,40,575.12,1047.00,0.00
2024-12-08 14:53:25,60,1034,20,40,565.54,1047.02,0.00
2024-12-08 14:53:25,59,1034,20,39,573.71,1047.03,0.00
2024-12-08 14:53:25,58,1034,19,39,574.73,1047.79,0.00
2024-12-08 14:53:25,58,1035,19,39,590.78,1048.00,0.00
2024-12-08 14:53:25,59,1035,19,40,580.77,1048.02,0.00
2024-12-08 14:53:25,59,1036,19,40,578.12,1049.00,0.00
2024-12-08 14:53:25,60,1036,19,41,568.48,1049.02,0.00
2024-12-08 14:53:25,59,1036,19,40,576.70,1049.03,0.00
2024-12-08 14:53:25,59,1037,19,40,577.78,1050.00,0.00
2024-12-08 14:53:25,60,1037,20,40,568.15,1050.02,0.00
2024-12-08 14:53:25,60,1038,20,40,565.52,1051.00,0.00
2024-12-08 14:53:25,61,1038,21,40,556.25,1051.02,0.00
2024-12-08 14:53:25,60,1038,21,39,564.12,1051.03,0.00
2024-12-08 14:53:25,60,1039,21,39,565.01,1052.00,0.00
2024-12-08 14:53:25,61,1039,22,39,555.74,1052.02,0.00
2024-12-08 14:53:25,61,1040,22,39,553.34,1053.00,0.00
2024-12-08 14:53:25,62,1040,22,40,544.41,1053.02,0.00
2024-12-08 14:53:25,61,1040,22,39,551.78,1053.03,0.00
2024-12-08 14:53:25,61,1041,22,39,552.48,1054.00,0.00
2024-12-08 14:53:25,62,1041,23,39,543.57,1054.02,0.00
2024-12-08 14:53:25,61,1041,22,39,552.31,1054.02,0.00
2024-12-08 14:53:25,60,1041,21,39,546.69,1054.90,0.00
2024-12-08 14:53:26,60,1042,21,39,563.28,1055.00,0.00
2024-12-08 14:53:26,61,1042,21,40,554.04,1055.02,0.00
2024-12-08 14:53:26,60,1042,21,39,562.05,1055.02,0.00
2024-12-08 14:53:26,60,1043,21,39,562.75,1056.00,0.00
2024-12-08 14:53:26,61,1043,21,40,553.53,1056.02,0.00
2024-12-08 14:53:26,61,1044,21,40,550.78,1057.00,0.00
2024-12-08 14:53:26,62,1044,22,40,541.89,1057.02,0.00
2024-12-08 14:53:26,61,1044,22,39,549.74,1057.02,0.00
2024-12-08 14:53:26,60,1044,21,39,552.00,1057.68,0.00
2024-12-08 14:53:26,59,1044,20,39,561.18,1057.70,0.00
2024-12-08 14:53:26,58,1044,19,39,564.84,1057.97,0.00
2024-12-08 14:53:26,58,1045,19,39,582.73,1058.00,0.00
2024-12-08 14:53:26,59,1045,20,39,572.86,1058.02,0.00
2024-12-08 14:53:26,58,1045,19,39,572.82,1058.38,0.00
2024-12-08 14:53:26,58,1046,19,39,584.93,1059.00,0.00
2024-12-08 14:53:26,59,1046,19,40,575.01,1059.02,0.00
2024-12-08 14:53:26,58,1046,19,39,584.02,1059.02,0.00
2024-12-08 14:53:26,58,1047,19,39,585.12,1060.00,0.00
2024-12-08 14:53:26,59,1047,19,40,575.20,1060.02,0.00
2024-12-08 14:53:26,59,1048,19,40,572.50,1061.00,0.00
2024-12-08 14:53:26,60,1048,20,40,562.96,1061.02,0.00
2024-12-08 14:53:26,59,1048,20,39,571.78,1061.02,0.00
2024-12-08 14:53:26,58,1048,19,39,568.81,1061.97,0.00
2024-12-08 14:53:26,58,1049,19,39,586.77,1062.00,0.00
2024-12-08 14:53:26,59,1049,19,40,576.82,1062.02,0.00
2024-12-08 14:53:26,59,1050,19,40,574.12,1063.00,0.00
2024-12-08 14:53:26,60,1050,19,41,564.56,1063.02,0.00
2024-12-08 14:53:26,59,1050,19,40,573.58,1063.02,0.00
2024-12-08 14:53:26,59,1051,19,40,574.48,1064.00,0.00
2024-12-08 14:53:26,60,1051,20,40,564.91,1064.02,0.00
2024-12-08 14:53:26,59,1051,19,40,569.01,1064.19,0.00
2024-12-08 14:53:26,59,1052,19,40,578.89,1065.00,0.00
2024-12-08 14:53:26,60,1052,20,40,569.24,1065.02,0.00
2024-12-08 14:53:26,59,1052,20,39,577.98,1065.02,0.00
2024-12-08 14:53:26,59,1053,20,39,578.89,1066.00,0.00
2024-12-08 14:53:26,60,1053,21,39,569.24,1066.02,0.00
2024-12-08 14:53:26,59,1053,20,39,573.52,1066.19,0.00
2024-12-08 14:53:26,59,1054,20,39,576.18,1067.00,0.00
2024-12-08 14:53:26,60,1054,21,39,566.57,1067.02,0.00
2024-12-08 14:53:26,59,1054,21,38,575.27,1067.02,0.00
2024-12-08 14:53:26,59,1055,21,38,576.17,1068.00,0.00
2024-12-08 14:53:26,60,1055,22,38,566.57,1068.02,0.00
2024-12-08 14:53:26,59,1055,21,38,570.79,1068.19,0.00
2024-12-08 14:53:26,59,1056,21,38,573.45,1069.00,0.00
2024-12-08 14:53:26,60,1056,21,39,563.89,1069.02,0.00
2024-12-08 14:53:26,59,1056,21,38,572.73,1069.02,0.00
2024-12-08 14:53:26,58,1056,20,38,569.66,1069.97,0.00
2024-12-08 14:53:26,58,1057,20,38,587.76,1070.00,0.00
2024-12-08 14:53:26,59,1057,20,39,577.80,1070.02,0.00
2024-12-08 14:53:26,58,1057,19,39,575.25,1070.17,0.00
2024-12-08 14:53:26,58,1058,19,39,585.35,1071.00,0.00
2024-12-08 14:53:26,59,1058,20,39,575.43,1071.02,0.00
2024-12-08 14:53:26,58,1058,20,38,584.61,1071.02,0.00
2024-12-08 14:53:26,57,1058,19,38,592.84,1071.18,0.00
2024-12-08 14:53:26,57,1059,19,38,603.32,1072.00,0.00
2024-12-08 14:53:26,58,1059,20,38,592.91,1072.02,0.00
2024-12-08 14:53:26,57,1059,19,38,594.67,1072.04,0.00
2024-12-08 14:53:26,57,1060,19,38,603.69,1073.00,0.00
2024-12-08 14:53:26,58,1060,19,39,593.28,1073.02,0.00
2024-12-08 14:53:26,57,1060,19,38,603.13,1073.02,0.00
2024-12-08 14:53:26,57,1061,19,38,604.44,1074.00,0.00
2024-12-08 14:53:26,58,1061,20,38,594.02,1074.02,0.00
2024-12-08 14:53:26,58,1062,20,38,591.42,1075.00,0.00
2024-12-08 14:53:26,59,1062,21,38,581.40,1075.02,0.00
2024-12-08 14:53:26,58,1062,21,37,590.87,1075.02,0.00
2024-12-08 14:53:26,57,1062,20,37,599.89,1075.14,0.00
2024-12-08 14:53:26,57,1063,20,37,602.49,1076.00,0.00
2024-12-08 14:53:26,58,1063,20,38,592.10,1076.02,0.00
2024-12-08 14:53:26,58,1064,20,38,589.50,1077.00,0.00
2024-12-08 14:53:26,59,1064,21,38,579.51,1077.02,0.00
2024-12-08 14:53:26,58,1064,21,37,588.94,1077.02,0.00
2024-12-08 14:53:26,58,1065,21,37,590.05,1078.00,0.00
2024-12-08 14:53:26,59,1065,22,37,580.04,1078.02,0.00
2024-12-08 14:53:26,59,1066,22,37,577.29,1079.00,0.00
2024-12-08 14:53:26,60,1066,23,37,567.67,1079.02,0.00
2024-12-08 14:53:26,59,1066,23,36,576.56,1079.03,0.00
2024-12-08 14:53:26,59,1067,23,36,577.64,1080.00,0.00
2024-12-08 14:53:26,60,1067,23,37,568.02,1080.02,0.00
2024-12-08 14:53:26,60,1068,23,37,565.12,1081.00,0.00
2024-12-08 14:53:26,61,1068,23,38,555.85,1081.02,0.00
2024-12-08 14:53:26,60,1068,23,37,564.22,1081.03,0.00
2024-12-08 14:53:26,59,1068,22,37,566.78,1081.70,0.00
2024-12-08 14:53:26,58,1068,21,37,575.46,1081.74,0.00
2024-12-08 14:53:27,58,1069,21,37,591.49,1082.00,0.00
2024-12-08 14:53:27,59,1069,22,37,581.46,1082.02,0.00
2024-12-08 14:53:27,58,1069,21,37,577.53,1082.83,0.00
2024-12-08 14:53:27,58,1070,21,37,594.46,1083.00,0.00
2024-12-08 14:53:27,59,1070,22,37,584.39,1083.02,0.00
2024-12-08 14:53:27,58,1070,22,36,593.53,1083.03,0.00
2024-12-08 14:53:27,58,1071,22,36,594.82,1084.00,0.00
2024-12-08 14:53:27,59,1071,22,37,584.74,1084.02,0.00
2024-12-08 14:53:27,59,1072,22,37,581.97,1085.00,0.00
2024-12-08 14:53:27,60,1072,23,37,572.27,1085.02,0.00
2024-12-08 14:53:27,59,1072,23,36,580.87,1085.03,0.00
2024-12-08 14:53:27,58,1072,22,36,583.17,1085.72,0.00
2024-12-08 14:53:27,58,1073,22,36,599.11,1086.00,0.00
2024-12-08 14:53:27,59,1073,22,37,588.95,1086.02,0.00
2024-12-08 14:53:27,58,1073,21,37,588.19,1086.71,0.00
2024-12-08 14:53:27,58,1074,21,37,596.47,1087.00,0.00
2024-12-08 14:53:27,59,1074,21,38,586.36,1087.02,0.00
2024-12-08 14:53:27,58,1074,21,37,595.16,1087.03,0.00
2024-12-08 14:53:27,58,1075,21,37,596.46,1088.00,0.00
2024-12-08 14:53:27,59,1075,21,38,586.35,1088.02,0.00
2024-12-08 14:53:27,59,1076,21,38,583.67,1089.00,0.00
2024-12-08 14:53:27,60,1076,22,38,573.94,1089.02,0.00
2024-12-08 14:53:27,59,1076,22,37,582.20,1089.03,0.00
2024-12-08 14:53:27,58,1076,21,37,580.90,1089.59,0.00
2024-12-08 14:53:27,58,1077,21,37,595.49,1090.00,0.00
2024-12-08 14:53:27,59,1077,21,38,585.39,1090.02,0.00
2024-12-08 14:53:27,59,1078,21,38,582.85,1091.00,0.00
2024-12-08 14:53:27,60,1078,21,39,573.13,1091.02,0.00
2024-12-08 14:53:27,59,1078,21,38,581.37,1091.03,0.00
2024-12-08 14:53:27,59,1079,21,38,582.46,1092.00,0.00
2024-12-08 14:53:27,60,1079,22,38,572.75,1092.02,0.00
2024-12-08 14:53:27,61,1078,23,38,557.68,1092.25,0.00
2024-12-08 14:53:27,60,1078,22,38,567.00,1092.97,0.00
2024-12-08 14:53:27,60,1079,22,38,584.87,1093.00,0.00
2024-12-08 14:53:27,61,1079,22,39,575.28,1093.02,0.00
2024-12-08 14:53:27,60,1079,22,38,581.79,1093.12,0.00
2024-12-08 14:53:27,60,1080,22,38,601.82,1094.00,0.00
2024-12-08 14:53:27,61,1080,23,38,591.95,1094.02,0.00
2024-12-08 14:53:27,61,1081,23,38,589.75,1095.00,0.00
2024-12-08 14:53:27,62,1081,23,39,580.24,1095.02,0.00
2024-12-08 14:53:27,61,1081,23,38,586.71,1095.12,0.00
2024-12-08 14:53:27,61,1082,23,38,588.31,1096.00,0.00
2024-12-08 14:53:27,62,1082,23,39,578.82,1096.02,0.00
2024-12-08 14:53:27,61,1082,22,39,576.95,1096.43,0.00
2024-12-08 14:53:27,61,1083,22,39,589.03,1097.00,0.00
2024-12-08 14:53:27,62,1083,23,39,579.53,1097.02,0.00
2024-12-08 14:53:27,61,1083,23,38,585.98,1097.12,0.00
2024-12-08 14:53:27,60,1083,22,38,589.65,1097.42,0.00
2024-12-08 14:53:27,59,1083,21,38,596.83,1097.68,0.00
2024-12-08 14:53:27,59,1084,21,38,612.16,1098.00,0.00
2024-12-08 14:53:27,60,1084,21,39,601.95,1098.02,0.00
2024-12-08 14:53:27,59,1084,20,39,601.86,1098.41,0.00
2024-12-08 14:53:27,59,1085,20,39,614.39,1099.00,0.00
2024-12-08 14:53:27,60,1085,20,40,604.15,1099.02,0.00
2024-12-08 14:53:27,59,1085,19,40,614.12,1099.03,0.00
2024-12-08 14:53:27,58,1085,19,39,622.06,1099.10,0.00
2024-12-08 14:53:27,57,1085,18,39,632.05,1099.19,0.00
2024-12-08 14:53:27,57,1086,18,39,635.28,1100.00,0.00
2024-12-08 14:53:27,58,1086,18,40,624.32,1100.02,0.00
2024-12-08 14:53:27,57,1086,18,39,635.08,1100.02,0.00
2024-12-08 14:53:27,57,1087,18,39,632.84,1101.00,0.00
2024-12-08 14:53:27,58,1087,19,39,621.93,1101.02,0.00
2024-12-08 14:53:27,57,1087,18,39,632.61,1101.04,0.00
2024-12-08 14:53:27,56,1087,18,38,641.76,1101.07,0.00
2024-12-08 14:53:27,55,1087,17,38,640.67,1101.95,0.00
2024-12-08 14:53:27,55,1088,17,38,660.14,1102.00,0.00
2024-12-08 14:53:27,56,1088,17,39,648.35,1102.02,0.00
2024-12-08 14:53:27,56,1089,17,39,652.04,1103.00,0.00
2024-12-08 14:53:27,57,1089,17,40,640.60,1103.02,0.00
2024-12-08 14:53:27,56,1089,16,40,637.69,1103.82,0.00
2024-12-08 14:53:27,56,1090,16,40,655.58,1104.00,0.00
2024-12-08 14:53:27,57,1090,17,40,644.08,1104.02,0.00
2024-12-08 14:53:27,56,1090,17,39,652.85,1104.11,0.00
2024-12-08 14:53:27,55,1090,16,39,664.38,1104.13,0.00
2024-12-08 14:53:27,55,1091,16,39,667.36,1105.00,0.00
2024-12-08 14:53:27,56,1091,16,40,655.45,1105.02,0.00
2024-12-08 14:53:27,56,1092,16,40,653.08,1106.00,0.00
2024-12-08 14:53:27,57,1092,16,41,641.62,1106.02,0.00
2024-12-08 14:53:27,56,1092,16,40,650.34,1106.11,0.00
2024-12-08 14:53:27,56,1093,16,40,652.88,1107.00,0.00
2024-12-08 14:53:27,57,1093,16,41,641.42,1107.02,0.00
2024-12-08 14:53:27,56,1093,15,41,636.58,1107.91,0.00
2024-12-08 14:53:28,56,1094,15,41,655.44,1108.00,0.00
2024-12-08 14:53:28,57,1094,15,42,643.95,1108.02,0.00
2024-12-08 14:53:28,57,1095,15,42,642.28,1109.00,0.00
2024-12-08 14:53:28,58,1095,16,42,631.21,1109.02,0.00
2024-12-08 14:53:28,57,1095,16,41,637.46,1109.18,0.00
2024-12-08 14:53:28,56,1095,15,41,640.39,1109.79,0.00
2024-12-08 14:53:28,56,1096,15,41,658.02,1110.00,0.00
2024-12-08 14:53:28,57,1096,15,42,646.47,1110.02,0.00
2024-12-08 14:53:28,57,1097,15,42,644.73,1111.00,0.00
2024-12-08 14:53:28,58,1097,16,42,633.61,1111.02,0.00
2024-12-08 14:53:28,57,1097,16,41,640.09,1111.18,0.00
2024-12-08 14:53:28,57,1098,16,41,643.16,1112.00,0.00
2024-12-08 14:53:28,58,1098,16,42,632.07,1112.02,0.00
2024-12-08 14:53:28,58,1099,16,42,630.66,1113.00,0.00
2024-12-08 14:53:28,59,1099,16,43,619.97,1113.02,0.00
2024-12-08 14:53:28,58,1099,16,42,625.33,1113.21,0.00
2024-12-08 14:53:28,57,1099,15,42,624.47,1113.95,0.00
2024-12-08 14:53:28,57,1100,15,42,643.46,1114.00,0.00
2024-12-08 14:53:28,58,1100,16,42,632.37,1114.02,0.00
2024-12-08 14:53:28,58,1101,16,42,631.64,1115.00,0.00
2024-12-08 14:53:28,59,1101,16,43,620.93,1115.02,0.00
2024-12-08 14:53:28,58,1101,16,42,629.54,1115.10,0.00
2024-12-08 14:53:28,58,1102,16,42,631.63,1116.00,0.00
2024-12-08 14:53:28,59,1102,16,43,620.92,1116.02,0.00
2024-12-08 14:53:28,59,1103,16,43,622.03,1117.00,0.00
2024-12-08 14:53:28,60,1103,16,44,611.66,1117.02,0.00
2024-12-08 14:53:28,60,1104,16,44,609.94,1118.00,0.00
2024-12-08 14:53:28,61,1104,17,44,599.94,1118.02,0.00
2024-12-08 14:53:28,60,1104,16,44,609.75,1118.02,0.00
2024-12-08 14:53:28,59,1104,16,43,616.68,1118.07,0.00
2024-12-08 14:53:28,58,1104,15,43,618.62,1118.64,0.00
2024-12-08 14:53:28,58,1105,15,43,634.15,1119.00,0.00
2024-12-08 14:53:28,59,1105,15,44,623.40,1119.02,0.00
2024-12-08 14:53:28,59,1106,15,44,620.54,1120.00,0.00
2024-12-08 14:53:28,60,1106,16,44,610.20,1120.02,0.00
2024-12-08 14:53:28,59,1106,16,43,619.60,1120.07,0.00
2024-12-08 14:53:28,58,1106,15,43,618.40,1120.91,0.00
2024-12-08 14:53:28,58,1107,15,43,636.83,1121.00,0.00
2024-12-08 14:53:28,59,1107,15,44,626.04,1121.02,0.00
2024-12-08 14:53:28,58,1107,14,44,636.64,1121.02,0.00
2024-12-08 14:53:28,58,1108,14,44,633.92,1122.00,0.00
2024-12-08 14:53:28,59,1108,14,45,623.17,1122.02,0.00
2024-12-08 14:53:28,58,1108,13,45,633.72,1122.02,0.00
2024-12-08 14:53:28,57,1108,13,44,644.45,1122.04,0.00
2024-12-08 14:53:28,57,1109,13,44,646.01,1123.00,0.00
2024-12-08 14:53:28,58,1109,14,44,634.87,1123.02,0.00
2024-12-08 14:53:28,57,1109,14,43,641.67,1123.04,0.00
2024-12-08 14:53:28,56,1109,13,43,639.64,1123.96,0.00
2024-12-08 14:53:28,56,1110,13,43,659.33,1124.00,0.00
2024-12-08 14:53:28,57,1110,14,43,647.76,1124.02,0.00
2024-12-08 14:53:28,57,1111,14,43,645.18,1125.00,0.00
2024-12-08 14:53:28,58,1111,15,43,634.06,1125.02,0.00
2024-12-08 14:53:28,57,1111,15,42,644.00,1125.05,0.00
2024-12-08 14:53:28,57,1112,15,42,645.76,1126.00,0.00
2024-12-08 14:53:28,58,1112,16,42,634.62,1126.02,0.00
2024-12-08 14:53:28,57,1112,15,42,628.12,1126.97,0.00
2024-12-08 14:53:28,57,1113,15,42,647.52,1127.00,0.00
2024-12-08 14:53:28,58,1113,15,43,636.35,1127.02,0.00
2024-12-08 14:53:28,57,1113,15,42,645.74,1127.05,0.00
2024-12-08 14:53:28,57,1114,15,42,647.50,1128.00,0.00
2024-12-08 14:53:28,58,1114,16,42,636.33,1128.02,0.00
2024-12-08 14:53:28,58,1115,16,42,633.59,1129.00,0.00
2024-12-08 14:53:28,59,1115,16,43,622.85,1129.02,0.00
2024-12-08 14:53:28,58,1115,16,42,631.84,1129.05,0.00
2024-12-08 14:53:28,58,1116,16,42,633.37,1130.00,0.00
2024-12-08 14:53:28,59,1116,17,42,622.63,1130.02,0.00
2024-12-08 14:53:28,58,1116,17,41,633.18,1130.02,0.00
2024-12-08 14:53:28,57,1116,17,40,642.70,1130.04,0.00
2024-12-08 14:53:28,56,1116,16,40,641.38,1130.93,0.00
2024-12-08 14:53:28,56,1117,16,40,660.81,1131.00,0.00
2024-12-08 14:53:28,57,1117,16,41,649.22,1131.02,0.00
2024-12-08 14:53:28,56,1117,15,41,653.99,1131.20,0.00
2024-12-08 14:53:28,56,1118,15,41,665.64,1132.00,0.00
2024-12-08 14:53:28,57,1118,16,41,653.96,1132.02,0.00
2024-12-08 14:53:28,56,1118,16,40,663.82,1132.04,0.00
2024-12-08 14:53:28,55,1118,15,40,672.46,1132.22,0.00
2024-12-08 14:53:28,55,1119,15,40,684.73,1133.00,0.00
2024-12-08 14:53:28,56,1119,15,41,672.50,1133.02,0.00
2024-12-08 14:53:28,55,1119,14,41,679.20,1133.15,0.00
2024-12-08 14:53:28,55,1120,14,41,682.45,1134.00,0.00
2024-12-08 14:53:28,56,1120,14,42,670.26,1134.02,0.00
2024-12-08 14:53:28,55,1120,14,41,680.80,1134.04,0.00
2024-12-08 14:53:28,54,1120,13,41,689.28,1134.24,0.00
2024-12-08 14:53:29,54,1121,13,41,702.21,1135.00,0.00
2024-12-08 14:53:29,55,1121,13,42,689.45,1135.02,0.00
2024-12-08 14:53:29,56,1120,14,42,671.11,1135.23,0.00
2024-12-08 14:53:29,56,1121,14,42,686.05,1136.00,0.00
2024-12-08 14:53:29,57,1121,15,42,674.01,1136.02,0.00
2024-12-08 14:53:29,56,1121,15,41,684.43,1136.04,0.00
2024-12-08 14:53:29,55,1121,14,41,683.80,1136.93,0.00
2024-12-08 14:53:29,55,1122,14,41,724.36,1137.00,0.00
2024-12-08 14:53:29,56,1122,14,42,711.42,1137.02,0.00
2024-12-08 14:53:29,55,1122,13,42,710.95,1137.13,0.00
2024-12-08 14:53:29,55,1123,13,42,722.30,1138.00,0.00
2024-12-08 14:53:29,56,1123,13,43,709.41,1138.02,0.00
2024-12-08 14:53:29,55,1123,13,42,720.86,1138.04,0.00
2024-12-08 14:53:29,55,1124,13,42,722.94,1139.00,0.00
2024-12-08 14:53:29,56,1124,14,42,710.03,1139.02,0.00
2024-12-08 14:53:29,55,1124,13,42,715.15,1139.22,0.00
2024-12-08 14:53:29,55,1125,13,42,727.51,1140.00,0.00
2024-12-08 14:53:29,56,1125,13,43,714.52,1140.02,0.00
2024-12-08 14:53:29,55,1125,12,43,721.29,1140.04,0.00
2024-12-08 14:53:29,54,1125,12,42,732.54,1140.04,0.00
2024-12-08 14:53:29,54,1126,12,42,743.32,1141.00,0.00
2024-12-08 14:53:29,55,1126,13,42,729.81,1141.02,0.00
2024-12-08 14:53:29,54,1126,13,41,742.06,1141.02,0.00
2024-12-08 14:53:29,54,1127,13,41,744.19,1142.00,0.00
2024-12-08 14:53:29,55,1127,13,42,730.66,1142.02,0.00
2024-12-08 14:53:29,54,1127,12,42,731.30,1142.07,0.00
2024-12-08 14:53:29,54,1128,12,42,742.51,1143.00,0.00
2024-12-08 14:53:29,55,1128,12,43,729.01,1143.02,0.00
2024-12-08 14:53:29,54,1128,12,42,740.82,1143.02,0.00
2024-12-08 14:53:29,54,1129,12,42,742.95,1144.00,0.00
2024-12-08 14:53:29,55,1129,13,42,729.44,1144.02,0.00
2024-12-08 14:53:29,54,1129,12,42,729.42,1144.09,0.00
2024-12-08 14:53:29,54,1130,12,42,740.84,1145.00,0.00
2024-12-08 14:53:29,55,1130,13,42,727.37,1145.02,0.00
2024-12-08 14:53:29,54,1130,13,41,738.93,1145.02,0.00
2024-12-08 14:53:29,54,1131,13,41,741.06,1146.00,0.00
2024-12-08 14:53:29,55,1131,13,42,727.59,1146.02,0.00
2024-12-08 14:53:29,55,1132,13,42,725.31,1147.00,0.00
2024-12-08 14:53:29,56,1132,14,42,712.35,1147.02,0.00
2024-12-08 14:53:29,55,1132,14,41,723.22,1147.02,0.00
2024-12-08 14:53:29,54,1132,13,41,725.84,1147.82,0.00
2024-12-08 14:53:29,54,1133,13,41,745.12,1148.00,0.00
2024-12-08 14:53:29,55,1133,14,41,731.57,1148.02,0.00
2024-12-08 14:53:29,54,1133,13,41,736.20,1148.43,0.00
2024-12-08 14:53:29,54,1134,13,41,749.19,1149.00,0.00
2024-12-08 14:53:29,55,1134,13,42,735.57,1149.02,0.00
2024-12-08 14:53:29,55,1135,13,42,737.94,1150.00,0.00
2024-12-08 14:53:29,56,1135,13,43,724.77,1150.02,0.00
2024-12-08 14:53:29,56,1136,13,43,723.37,1151.00,0.00
2024-12-08 14:53:29,57,1136,13,44,710.68,1151.02,0.00
2024-12-08 14:53:29,57,1137,13,44,708.06,1152.00,0.00
2024-12-08 14:53:29,58,1137,13,45,695.86,1152.02,0.00
2024-12-08 14:53:29,57,1137,13,44,707.26,1152.02,0.00
2024-12-08 14:53:29,57,1138,13,44,708.68,1153.00,0.00
2024-12-08 14:53:29,58,1138,13,45,696.46,1153.02,0.00
2024-12-08 14:53:29,58,1139,13,45,693.68,1154.00,0.00
2024-12-08 14:53:29,59,1139,14,45,681.92,1154.02,0.00
2024-12-08 14:53:29,58,1139,14,44,692.09,1154.02,0.00
2024-12-08 14:53:29,58,1140,14,44,693.29,1155.00,0.00
2024-12-08 14:53:29,59,1140,14,45,681.54,1155.02,0.00
2024-12-08 14:53:29,58,1140,13,45,681.69,1155.69,0.00
2024-12-08 14:53:29,58,1141,13,45,690.30,1156.00,0.00
2024-12-08 14:53:29,59,1141,13,46,678.60,1156.02,0.00
2024-12-08 14:53:29,58,1141,13,45,688.51,1156.02,0.00
2024-12-08 14:53:29,58,1142,13,45,689.70,1157.00,0.00
2024-12-08 14:53:29,59,1142,13,46,678.01,1157.02,0.00
2024-12-08 14:53:29,58,1142,12,46,674.40,1157.85,0.00
2024-12-08 14:53:29,58,1143,12,46,692.69,1158.00,0.00
2024-12-08 14:53:29,59,1143,13,46,680.95,1158.02,0.00
2024-12-08 14:53:29,58,1143,13,45,690.90,1158.02,0.00
2024-12-08 14:53:29,58,1144,13,45,692.09,1159.00,0.00
2024-12-08 14:53:29,59,1144,13,46,680.36,1159.02,0.00
2024-12-08 14:53:29,58,1144,12,46,680.45,1159.69,0.00
2024-12-08 14:53:29,58,1145,12,46,689.09,1160.00,0.00
2024-12-08 14:53:29,59,1145,13,46,677.41,1160.02,0.00
2024-12-08 14:53:29,58,1145,13,45,687.49,1160.02,0.00
2024-12-08 14:53:29,58,1146,13,45,688.68,1161.00,0.00
2024-12-08 14:53:29,59,1146,13,46,677.01,1161.02,0.00
2024-12-08 14:53:30,59,1147,13,46,674.05,1162.00,0.00
2024-12-08 14:53:30,60,1147,13,47,662.81,1162.02,0.00
2024-12-08 14:53:30,59,1147,13,46,672.67,1162.02,0.00
2024-12-08 14:53:30,58,1147,12,46,672.68,1162.53,0.00
2024-12-08 14:53:30,58,1148,12,46,687.66,1163.00,0.00
2024-12-08 14:53:30,59,1148,12,47,676.01,1163.02,0.00
2024-12-08 14:53:30,59,1149,12,47,673.04,1164.00,0.00
2024-12-08 14:53:30,60,1149,12,48,661.82,1164.02,0.00
2024-12-08 14:53:30,59,1149,12,47,671.66,1164.02,0.00
2024-12-08 14:53:30,58,1149,11,47,673.00,1164.48,0.00
2024-12-08 14:53:30,58,1150,11,47,687.44,1165.00,0.00
2024-12-08 14:53:30,59,1150,12,47,675.79,1165.02,0.00
2024-12-08 14:53:30,58,1150,11,47,674.75,1165.43,0.00
2024-12-08 14:53:30,58,1151,11,47,688.63,1166.00,0.00
2024-12-08 14:53:30,59,1151,11,48,676.96,1166.02,0.00
2024-12-08 14:53:30,58,1151,11,47,687.43,1166.02,0.00
2024-12-08 14:53:30,58,1152,11,47,688.62,1167.00,0.00
2024-12-08 14:53:30,59,1152,11,48,676.95,1167.02,0.00
2024-12-08 14:53:30,59,1153,11,48,673.96,1168.00,0.00
2024-12-08 14:53:30,60,1153,12,48,662.73,1168.02,0.00
2024-12-08 14:53:30,59,1153,12,47,672.78,1168.02,0.00
2024-12-08 14:53:30,58,1153,11,47,671.34,1168.57,0.00
2024-12-08 14:53:30,58,1154,11,47,686.78,1169.00,0.00
2024-12-08 14:53:30,59,1154,12,47,675.14,1169.02,0.00
2024-12-08 14:53:30,59,1155,12,47,672.14,1170.00,0.00
2024-12-08 14:53:30,60,1155,13,47,660.94,1170.02,0.00
2024-12-08 14:53:30,59,1155,13,46,670.95,1170.02,0.00
2024-12-08 14:53:30,59,1156,13,46,671.92,1171.00,0.00
2024-12-08 14:53:30,60,1156,14,46,660.73,1171.02,0.00
2024-12-08 14:53:30,60,1157,14,46,657.58,1172.00,0.00
2024-12-08 14:53:30,61,1157,14,47,646.80,1172.02,0.00
2024-12-08 14:53:30,60,1157,14,46,656.60,1172.02,0.00
2024-12-08 14:53:30,60,1158,14,46,657.36,1173.00,0.00
2024-12-08 14:53:30,61,1158,15,46,646.58,1173.02,0.00
2024-12-08 14:53:30,60,1158,14,46,646.92,1173.35,0.00
2024-12-08 14:53:30,60,1159,14,46,659.29,1174.00,0.00
2024-12-08 14:53:30,61,1159,14,47,648.48,1174.02,0.00
2024-12-08 14:53:30,60,1159,14,46,658.31,1174.02,0.00
2024-12-08 14:53:30,60,1160,14,46,659.07,1175.00,0.00
2024-12-08 14:53:30,61,1160,14,47,648.26,1175.02,0.00
2024-12-08 14:53:30,61,1161,14,47,644.96,1176.00,0.00
2024-12-08 14:53:30,62,1161,14,48,634.56,1176.02,0.00
2024-12-08 14:53:30,61,1161,14,47,644.19,1176.02,0.00
2024-12-08 14:53:30,60,1161,13,47,641.51,1176.93,0.00
2024-12-08 14:53:30,60,1162,13,47,660.38,1177.00,0.00
2024-12-08 14:53:30,61,1162,13,48,649.56,1177.02,0.00
2024-12-08 14:53:30,60,1162,12,48,645.51,1177.83,0.00
2024-12-08 14:53:30,60,1163,12,48,663.30,1178.00,0.00
2024-12-08 14:53:30,61,1163,12,49,652.43,1178.02,0.00
2024-12-08 14:53:30,60,1163,12,48,662.71,1178.02,0.00
2024-12-08 14:53:30,59,1163,11,48,665.90,1178.71,0.00
2024-12-08 14:53:30,58,1163,10,48,673.64,1178.86,0.00
2024-12-08 14:53:30,58,1164,10,48,692.45,1179.00,0.00
2024-12-08 14:53:30,59,1164,11,48,680.71,1179.02,0.00
2024-12-08 14:53:30,59,1165,11,48,677.69,1180.00,0.00
2024-12-08 14:53:30,60,1165,11,49,666.39,1180.02,0.00
2024-12-08 14:53:30,59,1165,11,48,676.69,1180.03,0.00
2024-12-08 14:53:30,59,1166,11,48,677.86,1181.00,0.00
2024-12-08 14:53:30,60,1166,12,48,666.57,1181.02,0.00
2024-12-08 14:53:30,60,1167,12,48,663.39,1182.00,0.00
2024-12-08 14:53:30,61,1167,13,48,652.51,1182.02,0.00
2024-12-08 14:53:30,60,1167,13,47,662.21,1182.05,0.00
2024-12-08 14:53:30,60,1168,13,47,663.36,1183.00,0.00
2024-12-08 14:53:30,61,1168,13,48,652.48,1183.02,0.00
2024-12-08 14:53:30,61,1169,13,48,649.15,1184.00,0.00
2024-12-08 14:53:30,62,1169,13,49,638.68,1184.02,0.00
2024-12-08 14:53:30,61,1169,13,48,648.19,1184.05,0.00
2024-12-08 14:53:30,61,1170,13,48,649.12,1185.00,0.00
2024-12-08 14:53:30,62,1170,14,48,638.65,1185.02,0.00
2024-12-08 14:53:30,61,1170,13,48,634.36,1185.82,0.00
2024-12-08 14:53:30,61,1171,13,48,651.80,1186.00,0.00
2024-12-08 14:53:30,62,1171,13,49,641.29,1186.02,0.00
2024-12-08 14:53:30,61,1171,13,48,651.03,1186.05,0.00
2024-12-08 14:53:30,61,1172,13,48,651.96,1187.00,0.00
2024-12-08 14:53:30,62,1172,13,49,641.45,1187.02,0.00
2024-12-08 14:53:30,62,1173,13,49,637.96,1188.00,0.00
2024-12-08 14:53:30,63,1173,14,49,627.84,1188.02,0.00
2024-12-08 14:53:30,62,1173,14,48,637.39,1188.05,0.00
2024-12-08 14:53:30,61,1173,13,48,635.45,1188.90,0.00
2024-12-08 14:53:30,61,1174,13,48,653.84,1189.00,0.00
2024-12-08 14:53:30,62,1174,14,48,643.30,1189.02,0.00
2024-12-08 14:53:30,61,1174,13,48,650.53,1189.03,0.00
2024-12-08 14:53:31,61,1175,13,48,655.17,1190.00,0.00
2024-12-08 14:53:31,62,1175,13,49,644.60,1190.02,0.00
2024-12-08 14:53:31,61,1175,13,48,654.78,1190.03,0.00
2024-12-08 14:53:31,60,1175,12,48,657.51,1190.73,0.00
2024-12-08 14:53:31,60,1176,12,48,666.45,1191.00,0.00
2024-12-08 14:53:31,61,1176,13,48,655.53,1191.02,0.00
2024-12-08 14:53:31,61,1177,13,48,652.17,1192.00,0.00
2024-12-08 14:53:31,62,1177,14,48,641.65,1192.02,0.00
2024-12-08 14:53:31,61,1177,14,47,651.78,1192.03,0.00
2024-12-08 14:53:31,61,1178,14,47,652.52,1193.00,0.00
2024-12-08 14:53:31,62,1178,15,47,642.00,1193.02,0.00
2024-12-08 14:53:31,61,1178,15,46,648.22,1193.03,0.00
2024-12-08 14:53:31,61,1179,15,46,648.96,1194.00,0.00
2024-12-08 14:53:31,62,1179,16,46,638.49,1194.02,0.00
2024-12-08 14:53:31,62,1180,16,46,634.98,1195.00,0.00
2024-12-08 14:53:31,63,1180,17,46,624.90,1195.02,0.00
2024-12-08 14:53:31,62,1180,17,45,634.59,1195.03,0.00
2024-12-08 14:53:31,61,1180,16,45,641.76,1195.31,0.00
2024-12-08 14:53:31,61,1181,16,45,645.73,1196.00,0.00
2024-12-08 14:53:31,62,1181,17,45,635.32,1196.02,0.00
2024-12-08 14:53:31,61,1181,17,44,641.42,1196.03,0.00
2024-12-08 14:53:31,60,1181,16,44,647.33,1196.05,0.00
2024-12-08 14:53:31,59,1181,15,44,655.07,1196.32,0.00
2024-12-08 14:53:31,59,1182,15,44,667.68,1197.00,0.00
2024-12-08 14:53:31,60,1182,16,44,656.55,1197.02,0.00
2024-12-08 14:53:31,60,1183,16,44,653.31,1198.00,0.00
2024-12-08 14:53:31,61,1183,17,44,642.60,1198.02,0.00
2024-12-08 14:53:31,60,1183,17,43,652.51,1198.05,0.00
2024-12-08 14:53:31,60,1184,17,43,653.65,1199.00,0.00
2024-12-08 14:53:31,61,1184,18,43,642.94,1199.02,0.00
2024-12-08 14:53:31,60,1184,17,43,641.60,1199.70,0.00
2024-12-08 14:53:31,60,1185,17,43,658.20,1200.00,0.00
2024-12-08 14:53:31,61,1185,18,43,647.41,1200.02,0.00
2024-12-08 14:53:31,60,1185,18,42,657.40,1200.05,0.00
2024-12-08 14:53:31,60,1186,18,42,658.55,1201.00,0.00
2024-12-08 14:53:31,61,1186,18,43,647.75,1201.02,0.00
2024-12-08 14:53:31,61,1187,18,43,644.35,1202.00,0.00
2024-12-08 14:53:31,62,1187,19,43,633.96,1202.02,0.00
2024-12-08 14:53:31,61,1187,19,42,644.15,1202.02,0.00
2024-12-08 14:53:31,60,1187,19,41,654.49,1202.03,0.00
2024-12-08 14:53:31,60,1188,19,41,655.43,1203.00,0.00
2024-12-08 14:53:31,61,1188,19,42,644.69,1203.02,0.00
2024-12-08 14:53:31,61,1189,19,42,641.28,1204.00,0.00
2024-12-08 14:53:31,62,1189,19,43,630.93,1204.02,0.00
2024-12-08 14:53:31,61,1189,19,42,640.29,1204.03,0.00
2024-12-08 14:53:31,60,1189,18,42,636.01,1204.65,0.00
2024-12-08 14:53:31,60,1190,18,42,652.11,1205.00,0.00
2024-12-08 14:53:31,61,1190,19,42,641.42,1205.02,0.00
2024-12-08 14:53:31,61,1191,19,42,637.99,1206.00,0.00
2024-12-08 14:53:31,62,1191,20,42,627.70,1206.02,0.00
2024-12-08 14:53:31,61,1191,20,41,637.01,1206.03,0.00
2024-12-08 14:53:31,61,1192,20,41,637.73,1207.00,0.00
2024-12-08 14:53:31,62,1192,21,41,627.44,1207.02,0.00
2024-12-08 14:53:31,62,1193,21,41,623.87,1208.00,0.00
2024-12-08 14:53:31,63,1193,22,41,613.97,1208.02,0.00
2024-12-08 14:53:31,62,1193,22,40,622.90,1208.03,0.00
2024-12-08 14:53:31,62,1194,22,40,623.41,1209.00,0.00
2024-12-08 14:53:31,63,1194,23,40,613.52,1209.02,0.00
2024-12-08 14:53:31,62,1194,22,40,615.31,1209.27,0.00
2024-12-08 14:53:31,62,1195,22,40,626.47,1210.00,0.00
2024-12-08 14:53:31,63,1195,23,40,616.52,1210.02,0.00
2024-12-08 14:53:31,62,1195,23,39,625.49,1210.03,0.00
2024-12-08 14:53:31,62,1196,23,39,626.01,1211.00,0.00
2024-12-08 14:53:31,63,1196,23,40,616.07,1211.02,0.00
2024-12-08 14:53:31,63,1197,23,40,612.35,1212.00,0.00
2024-12-08 14:53:31,64,1197,24,40,602.78,1212.02,0.00
2024-12-08 14:53:31,63,1197,24,39,611.58,1212.03,0.00
2024-12-08 14:53:31,62,1197,23,39,613.92,1212.68,0.00
2024-12-08 14:53:31,61,1197,22,39,623.79,1212.69,0.00
2024-12-08 14:53:31,61,1198,22,39,632.15,1213.00,0.00
2024-12-08 14:53:31,62,1198,22,40,621.96,1213.02,0.00
2024-12-08 14:53:31,62,1199,22,40,618.36,1214.00,0.00
2024-12-08 14:53:31,63,1199,22,41,608.54,1214.02,0.00
2024-12-08 14:53:31,62,1199,22,40,617.77,1214.03,0.00
2024-12-08 14:53:31,61,1199,21,40,620.04,1214.69,0.00
2024-12-08 14:53:31,61,1200,21,40,628.41,1215.00,0.00
2024-12-08 14:53:31,62,1200,21,41,618.28,1215.02,0.00
2024-12-08 14:53:31,61,1200,20,41,610.56,1215.93,0.00
2024-12-08 14:53:31,61,1201,20,41,629.73,1216.00,0.00
2024-12-08 14:53:31,62,1201,20,42,619.57,1216.02,0.00
2024-12-08 14:53:31,61,1201,20,41,629.13,1216.03,0.00
2024-12-08 14:53:31,61,1202,20,41,629.85,1217.00,0.00
2024-12-08 14:53:32,62,1202,21,41,619.69,1217.02,0.00
2024-12-08 14:53:32,61,1202,21,40,629.65,1217.02,0.00
2024-12-08 14:53:32,60,1202,20,40,623.14,1217.90,0.00
2024-12-08 14:53:32,60,1203,20,40,642.29,1218.00,0.00
2024-12-08 14:53:32,61,1203,20,41,631.76,1218.02,0.00
2024-12-08 14:53:32,60,1203,20,40,642.09,1218.02,0.00
2024-12-08 14:53:32,60,1204,20,40,642.82,1219.00,0.00
2024-12-08 14:53:32,61,1204,20,41,632.28,1219.02,0.00
2024-12-08 14:53:32,60,1204,19,41,625.58,1219.90,0.00
2024-12-08 14:53:32,60,1205,19,41,644.77,1220.00,0.00
2024-12-08 14:53:32,61,1205,19,42,634.20,1220.02,0.00
2024-12-08 14:53:32,60,1205,19,41,644.57,1220.02,0.00
2024-12-08 14:53:32,59,1205,18,41,652.66,1220.24,0.00
2024-12-08 14:53:32,59,1206,18,41,656.24,1221.00,0.00
2024-12-08 14:53:32,60,1206,19,41,645.30,1221.02,0.00
2024-12-08 14:53:32,59,1206,18,41,637.68,1221.95,0.00
2024-12-08 14:53:32,59,1207,18,41,657.81,1222.00,0.00
2024-12-08 14:53:32,60,1207,19,41,646.85,1222.02,0.00
2024-12-08 14:53:32,59,1207,19,40,657.60,1222.02,0.00
2024-12-08 14:53:32,59,1208,19,40,658.55,1223.00,0.00
2024-12-08 14:53:32,60,1208,19,41,647.58,1223.02,0.00
2024-12-08 14:53:32,59,1208,19,40,654.20,1223.02,0.00
2024-12-08 14:53:32,59,1209,19,40,655.15,1224.00,0.00
2024-12-08 14:53:32,60,1209,20,40,644.23,1224.02,0.00
2024-12-08 14:53:32,60,1210,20,40,640.88,1225.00,0.00
2024-12-08 14:53:32,61,1210,20,41,630.37,1225.02,0.00
2024-12-08 14:53:32,60,1210,20,40,640.27,1225.03,0.00
2024-12-08 14:53:32,60,1211,20,40,641.20,1226.00,0.00
2024-12-08 14:53:32,61,1211,21,40,630.69,1226.02,0.00
2024-12-08 14:53:32,61,1212,21,40,627.18,1227.00,0.00
2024-12-08 14:53:32,62,1212,21,41,617.06,1227.02,0.00
2024-12-08 14:53:32,61,1212,21,40,626.38,1227.03,0.00
2024-12-08 14:53:32,61,1213,21,40,627.09,1228.00,0.00
2024-12-08 14:53:32,62,1213,22,40,616.97,1228.02,0.00
2024-12-08 14:53:32,61,1213,21,40,609.41,1228.92,0.00
2024-12-08 14:53:32,61,1214,21,40,628.60,1229.00,0.00
2024-12-08 14:53:32,62,1214,21,41,618.46,1229.02,0.00
2024-12-08 14:53:32,61,1214,21,40,628.00,1229.03,0.00
2024-12-08 14:53:32,60,1214,20,40,635.67,1229.25,0.00
2024-12-08 14:53:32,60,1215,20,40,639.19,1230.00,0.00
2024-12-08 14:53:32,61,1215,21,40,628.71,1230.02,0.00
2024-12-08 14:53:32,61,1216,21,40,625.19,1231.00,0.00
2024-12-08 14:53:32,62,1216,22,40,615.10,1231.02,0.00
2024-12-08 14:53:32,61,1216,22,39,624.78,1231.03,0.00
2024-12-08 14:53:32,60,1216,21,39,620.50,1231.97,0.00
2024-12-08 14:53:32,60,1217,21,39,640.64,1232.00,0.00
2024-12-08 14:53:32,61,1217,22,39,630.14,1232.02,0.00
2024-12-08 14:53:32,60,1217,22,38,636.12,1232.03,0.00
2024-12-08 14:53:32,60,1218,22,38,637.05,1233.00,0.00
2024-12-08 14:53:32,61,1218,22,39,626.61,1233.02,0.00
2024-12-08 14:53:32,60,1218,22,38,632.53,1233.03,0.00
2024-12-08 14:53:32,60,1219,22,38,633.45,1234.00,0.00
2024-12-08 14:53:32,61,1219,22,39,623.07,1234.02,0.00
2024-12-08 14:53:32,61,1220,22,39,619.52,1235.00,0.00
2024-12-08 14:53:32,62,1220,22,40,609.53,1235.02,0.00
2024-12-08 14:53:32,61,1220,22,39,619.12,1235.03,0.00
2024-12-08 14:53:32,60,1220,21,39,615.08,1235.95,0.00
2024-12-08 14:53:32,60,1221,21,39,635.10,1236.00,0.00
2024-12-08 14:53:32,61,1221,22,39,624.69,1236.02,0.00
2024-12-08 14:53:32,60,1221,22,38,630.57,1236.03,0.00
2024-12-08 14:53:32,60,1222,22,38,631.49,1237.00,0.00
2024-12-08 14:53:32,61,1222,23,38,621.14,1237.02,0.00
2024-12-08 14:53:32,60,1222,23,37,626.95,1237.03,0.00
2024-12-08 14:53:32,59,1222,22,37,627.45,1237.80,0.00
2024-12-08 14:53:32,59,1223,22,37,646.07,1238.00,0.00
2024-12-08 14:53:32,60,1223,23,37,635.30,1238.02,0.00
2024-12-08 14:53:32,60,1224,23,37,631.89,1239.00,0.00
2024-12-08 14:53:32,61,1224,24,37,621.53,1239.02,0.00
2024-12-08 14:53:32,60,1224,24,36,631.48,1239.03,0.00
2024-12-08 14:53:32,60,1225,24,36,632.40,1240.00,0.00
2024-12-08 14:53:32,61,1225,24,37,622.03,1240.02,0.00
2024-12-08 14:53:32,61,1226,24,37,618.47,1241.00,0.00
2024-12-08 14:53:32,62,1226,24,38,608.49,1241.02,0.00
2024-12-08 14:53:32,61,1226,24,37,618.06,1241.03,0.00
2024-12-08 14:53:32,60,1226,23,37,619.80,1241.43,0.00
2024-12-08 14:53:32,60,1227,23,37,633.83,1242.00,0.00
2024-12-08 14:53:32,61,1227,23,38,623.44,1242.02,0.00
2024-12-08 14:53:32,60,1227,23,37,629.28,1242.03,0.00
2024-12-08 14:53:32,59,1227,22,37,632.89,1242.37,0.00
2024-12-08 14:53:32,59,1228,22,37,646.57,1243.00,0.00
2024-12-08 14:53:32,60,1228,23,37,635.79,1243.02,0.00
2024-12-08 14:53:32,59,1228,23,36,641.94,1243.03,0.00
2024-12-08 14:53:32,59,1229,23,36,643.08,1244.00,0.00
2024-12-08 14:53:32,60,1229,24,36,632.37,1244.02,0.00
2024-12-08 14:53:32,59,1229,24,35,638.45,1244.03,0.00
2024-12-08 14:53:32,59,1230,24,35,639.60,1245.00,0.00
2024-12-08 14:53:32,60,1230,25,35,628.94,1245.02,0.00
2024-12-08 14:53:32,59,1230,24,35,639.39,1245.02,0.00
2024-12-08 14:53:33,58,1230,23,35,638.02,1245.69,0.00
2024-12-08 14:53:33,58,1231,23,35,647.60,1246.00,0.00
2024-12-08 14:53:33,59,1231,24,35,636.62,1246.02,0.00
2024-12-08 14:53:33,58,1231,24,34,647.38,1246.02,0.00
2024-12-08 14:53:33,57,1231,23,34,656.61,1246.19,0.00
2024-12-08 14:53:33,57,1232,23,34,660.14,1247.00,0.00
2024-12-08 14:53:33,58,1232,24,34,648.76,1247.02,0.00
2024-12-08 14:53:33,57,1232,24,33,655.55,1247.02,0.00
2024-12-08 14:53:33,56,1232,23,33,664.42,1247.21,0.00
2024-12-08 14:53:33,56,1233,23,33,677.37,1248.00,0.00
2024-12-08 14:53:33,57,1233,24,33,665.49,1248.02,0.00
2024-12-08 14:53:33,57,1234,24,33,662.52,1249.00,0.00
2024-12-08 14:53:33,58,1234,25,33,651.10,1249.02,0.00
2024-12-08 14:53:33,57,1234,25,32,661.65,1249.02,0.00
2024-12-08 14:53:33,57,1235,25,32,663.05,1250.00,0.00
2024-12-08 14:53:33,58,1235,25,33,651.62,1250.02,0.00
2024-12-08 14:53:33,57,1235,24,33,656.53,1250.19,0.00
2024-12-08 14:53:33,56,1235,23,33,665.14,1250.27,0.00
2024-12-08 14:53:33,56,1236,23,33,678.79,1251.00,0.00
2024-12-08 14:53:33,57,1236,24,33,666.88,1251.02,0.00
2024-12-08 14:53:33,56,1236,24,32,677.89,1251.02,0.00
2024-12-08 14:53:33,55,1236,23,32,682.82,1251.35,0.00
2024-12-08 14:53:33,55,1237,23,32,697.83,1252.00,0.00
2024-12-08 14:53:33,56,1237,24,32,685.37,1252.02,0.00
2024-12-08 14:53:33,56,1238,24,32,682.56,1253.00,0.00
2024-12-08 14:53:33,57,1238,25,32,670.58,1253.02,0.00
2024-12-08 14:53:33,56,1238,25,31,681.88,1253.02,0.00
2024-12-08 14:53:33,56,1239,25,31,683.55,1254.00,0.00
2024-12-08 14:53:33,57,1239,26,31,671.56,1254.02,0.00
2024-12-08 14:53:33,56,1239,25,31,677.08,1254.18,0.00
2024-12-08 14:53:33,56,1240,25,31,680.72,1255.00,0.00
2024-12-08 14:53:33,57,1240,26,31,668.78,1255.02,0.00
2024-12-08 14:53:33,56,1240,26,30,680.27,1255.02,0.00
2024-12-08 14:53:33,56,1241,26,30,681.94,1256.00,0.00
2024-12-08 14:53:33,57,1241,26,31,669.97,1256.02,0.00
2024-12-08 14:53:33,56,1241,25,31,662.47,1256.95,0.00
2024-12-08 14:53:33,56,1242,25,31,684.27,1257.00,0.00
2024-12-08 14:53:33,57,1242,25,32,672.27,1257.02,0.00
2024-12-08 14:53:33,56,1242,25,31,684.05,1257.02,0.00
2024-12-08 14:53:33,56,1243,25,31,685.72,1258.00,0.00
2024-12-08 14:53:33,57,1243,25,32,673.69,1258.02,0.00
2024-12-08 14:53:33,56,1243,25,31,681.00,1258.02,0.00
2024-12-08 14:53:33,55,1243,24,31,691.82,1258.15,0.00
2024-12-08 14:53:33,55,1244,24,31,695.31,1259.00,0.00
2024-12-08 14:53:33,56,1244,24,32,682.89,1259.02,0.00
2024-12-08 14:53:33,56,1245,24,32,680.06,1260.00,0.00
2024-12-08 14:53:33,57,1245,24,33,668.13,1260.02,0.00
2024-12-08 14:53:33,56,1245,24,32,679.83,1260.02,0.00
2024-12-08 14:53:33,56,1246,24,32,681.50,1261.00,0.00
2024-12-08 14:53:33,57,1246,25,32,669.54,1261.02,0.00
2024-12-08 14:53:33,56,1246,24,32,666.11,1261.79,0.00
2024-12-08 14:53:33,56,1247,24,32,686.09,1262.00,0.00
2024-12-08 14:53:33,57,1247,25,32,674.06,1262.02,0.00
2024-12-08 14:53:33,56,1247,25,31,685.64,1262.02,0.00
2024-12-08 14:53:33,55,1247,24,31,696.31,1262.15,0.00
2024-12-08 14:53:33,55,1248,24,31,699.81,1263.00,0.00
2024-12-08 14:53:33,56,1248,24,32,687.31,1263.02,0.00
2024-12-08 14:53:33,56,1249,24,32,684.47,1264.00,0.00
2024-12-08 14:53:33,57,1249,24,33,672.46,1264.02,0.00
2024-12-08 14:53:33,56,1249,24,32,684.25,1264.02,0.00
2024-12-08 14:53:33,56,1250,24,32,685.92,1265.00,0.00
2024-12-08 14:53:33,57,1250,24,33,673.88,1265.02,0.00
2024-12-08 14:53:33,56,1250,23,33,672.38,1265.09,0.00
2024-12-08 14:53:33,56,1251,23,33,683.97,1266.00,0.00
2024-12-08 14:53:33,57,1251,24,33,671.97,1266.02,0.00
2024-12-08 14:53:33,56,1251,24,32,683.75,1266.02,0.00
2024-12-08 14:53:33,55,1251,23,32,694.60,1266.13,0.00
2024-12-08 14:53:33,55,1252,23,32,697.88,1267.00,0.00
2024-12-08 14:53:33,56,1252,23,33,685.42,1267.02,0.00
2024-12-08 14:53:33,55,1252,23,32,693.04,1267.02,0.00
2024-12-08 14:53:33,55,1253,23,32,694.97,1268.00,0.00
2024-12-08 14:53:33,56,1253,23,33,682.56,1268.02,0.00
2024-12-08 14:53:33,55,1253,22,33,689.23,1268.11,0.00
2024-12-08 14:53:33,54,1253,21,33,701.76,1268.11,0.00
2024-12-08 14:53:33,53,1253,20,33,699.25,1268.64,0.00
2024-12-08 14:53:33,53,1254,20,33,718.89,1269.00,0.00
2024-12-08 14:53:33,54,1254,20,34,705.57,1269.02,0.00
2024-12-08 14:53:33,53,1254,20,33,718.41,1269.02,0.00
2024-12-08 14:53:33,53,1255,20,33,720.89,1270.00,0.00
2024-12-08 14:53:33,54,1255,20,34,707.54,1270.02,0.00
2024-12-08 14:53:33,53,1255,19,34,700.80,1270.59,0.00
2024-12-08 14:53:33,53,1256,19,34,719.78,1271.00,0.00
2024-12-08 14:53:33,54,1256,20,34,706.45,1271.02,0.00
2024-12-08 14:53:33,53,1256,20,33,716.91,1271.04,0.00
2024-12-08 14:53:33,52,1256,19,33,722.93,1271.65,0.00
2024-12-08 14:53:33,51,1256,18,33,735.87,1271.69,0.00
2024-12-08 14:53:33,51,1257,18,33,757.07,1272.00,0.00
2024-12-08 14:53:33,52,1257,19,33,742.51,1272.02,0.00
2024-12-08 14:53:33,51,1257,18,33,737.02,1272.57,0.00
2024-12-08 14:53:33,51,1258,18,33,756.81,1273.00,0.00
2024-12-08 14:53:33,52,1258,19,33,742.26,1273.02,0.00
2024-12-08 14:53:33,51,1258,19,32,753.82,1273.04,0.00
2024-12-08 14:53:33,51,1259,19,32,757.16,1274.00,0.00
2024-12-08 14:53:33,52,1259,20,32,742.59,1274.02,0.00
2024-12-08 14:53:34,52,1260,20,32,740.48,1275.00,0.00
2024-12-08 14:53:34,53,1260,21,32,726.51,1275.02,0.00
2024-12-08 14:53:34,52,1260,21,31,737.79,1275.04,0.00
2024-12-08 14:53:34,52,1261,21,31,740.82,1276.00,0.00
2024-12-08 14:53:34,53,1261,22,31,726.84,1276.02,0.00
2024-12-08 14:53:34,52,1261,21,31,725.77,1276.40,0.00
2024-12-08 14:53:34,52,1262,21,31,743.12,1277.00,0.00
2024-12-08 14:53:34,53,1262,22,31,729.09,1277.02,0.00
2024-12-08 14:53:34,52,1262,22,30,739.19,1277.04,0.00
2024-12-08 14:53:34,52,1263,22,30,742.22,1278.00,0.00
2024-12-08 14:53:34,53,1263,22,31,728.22,1278.02,0.00
2024-12-08 14:53:34,53,1264,22,31,726.63,1279.00,0.00
2024-12-08 14:53:34,54,1264,23,31,713.17,1279.02,0.00
2024-12-08 14:53:34,53,1264,23,30,722.77,1279.04,0.00
2024-12-08 14:53:34,52,1264,22,30,732.05,1279.19,0.00
2024-12-08 14:53:34,52,1265,22,30,746.83,1280.00,0.00
2024-12-08 14:53:34,53,1265,22,31,732.74,1280.02,0.00
2024-12-08 14:53:34,53,1266,22,31,731.06,1281.00,0.00
2024-12-08 14:53:34,54,1266,23,31,717.53,1281.02,0.00
2024-12-08 14:53:34,53,1266,23,30,727.44,1281.04,0.00
2024-12-08 14:53:34,52,1266,22,30,726.00,1281.92,0.00
2024-12-08 14:53:34,52,1267,22,30,749.72,1282.00,0.00
2024-12-08 14:53:34,53,1267,23,30,735.58,1282.02,0.00
2024-12-08 14:53:34,53,1268,23,30,733.84,1283.00,0.00
2024-12-08 14:53:34,54,1268,24,30,720.25,1283.02,0.00
2024-12-08 14:53:34,53,1268,24,29,730.45,1283.04,0.00
2024-12-08 14:53:34,53,1269,24,29,733.20,1284.00,0.00
2024-12-08 14:53:34,54,1269,24,30,719.62,1284.02,0.00
2024-12-08 14:53:34,53,1269,23,30,713.69,1284.89,0.00
2024-12-08 14:53:34,53,1270,23,30,736.57,1285.00,0.00
2024-12-08 14:53:34,54,1270,24,30,722.93,1285.02,0.00
2024-12-08 14:53:34,53,1270,24,29,733.42,1285.04,0.00
2024-12-08 14:53:34,53,1271,24,29,736.17,1286.00,0.00
2024-12-08 14:53:34,54,1271,24,30,722.54,1286.02,0.00
2024-12-08 14:53:34,54,1272,24,30,720.69,1287.00,0.00
2024-12-08 14:53:34,55,1272,25,30,707.59,1287.02,0.00
2024-12-08 14:53:34,54,1272,25,29,717.59,1287.04,0.00
2024-12-08 14:53:34,54,1273,25,29,720.06,1288.00,0.00
2024-12-08 14:53:34,55,1273,25,30,706.97,1288.02,0.00
2024-12-08 14:53:34,54,1273,24,30,712.94,1288.15,0.00
2024-12-08 14:53:34,54,1274,24,30,726.35,1289.00,0.00
2024-12-08 14:53:34,55,1274,24,31,713.14,1289.02,0.00
2024-12-08 14:53:34,54,1274,24,30,723.48,1289.04,0.00
2024-12-08 14:53:34,54,1275,24,30,725.95,1290.00,0.00
2024-12-08 14:53:34,55,1275,25,30,712.75,1290.02,0.00
2024-12-08 14:53:34,55,1276,25,30,710.35,1291.00,0.00
2024-12-08 14:53:34,56,1276,26,30,697.66,1291.02,0.00
2024-12-08 14:53:34,55,1276,26,29,707.77,1291.04,0.00
2024-12-08 14:53:34,55,1277,26,29,709.96,1292.00,0.00
2024-12-08 14:53:34,56,1277,26,30,697.28,1292.02,0.00
2024-12-08 14:53:34,55,1277,25,30,690.15,1292.89,0.00
2024-12-08 14:53:34,55,1278,25,30,712.33,1293.00,0.00
2024-12-08 14:53:34,56,1278,25,31,699.61,1293.02,0.00
2024-12-08 14:53:34,55,1278,25,30,709.50,1293.04,0.00
2024-12-08 14:53:34,55,1279,25,30,711.70,1294.00,0.00
2024-12-08 14:53:34,56,1279,26,30,698.99,1294.02,0.00
2024-12-08 14:53:34,56,1280,26,30,697.02,1295.00,0.00
2024-12-08 14:53:34,57,1280,27,30,684.80,1295.02,0.00
2024-12-08 14:53:34,56,1280,27,29,694.25,1295.04,0.00
2024-12-08 14:53:34,55,1280,26,29,702.88,1295.18,0.00
2024-12-08 14:53:34,55,1281,26,29,716.33,1296.00,0.00
2024-12-08 14:53:34,56,1281,27,29,703.54,1296.02,0.00
2024-12-08 14:53:34,55,1281,26,29,716.10,1296.02,0.00
2024-12-08 14:53:34,55,1282,26,29,714.41,1297.00,0.00
2024-12-08 14:53:34,56,1282,27,29,701.65,1297.02,0.00
2024-12-08 14:53:34,55,1282,27,28,711.82,1297.02,0.00
2024-12-08 14:53:34,55,1283,27,28,713.78,1298.00,0.00
2024-12-08 14:53:34,56,1283,27,29,701.04,1298.02,0.00
2024-12-08 14:53:34,56,1284,27,29,699.16,1299.00,0.00
2024-12-08 14:53:34,57,1284,27,30,686.90,1299.02,0.00
2024-12-08 14:53:34,56,1284,27,29,696.61,1299.02,0.00
2024-12-08 14:53:34,55,1284,26,29,708.13,1299.11,0.00
2024-12-08 14:53:34,54,1284,25,29,709.43,1299.80,0.00
2024-12-08 14:53:34,54,1285,25,29,731.01,1300.00,0.00
2024-12-08 14:53:34,55,1285,26,29,717.72,1300.02,0.00
2024-12-08 14:53:34,55,1286,26,29,716.21,1301.00,0.00
2024-12-08 14:53:34,56,1286,26,30,703.42,1301.02,0.00
2024-12-08 14:53:34,55,1286,26,29,712.91,1301.04,0.00
2024-12-08 14:53:34,55,1287,26,29,715.11,1302.00,0.00
2024-12-08 14:53:34,56,1287,27,29,702.34,1302.02,0.00
2024-12-08 14:53:34,56,1288,27,29,700.62,1303.00,0.00
2024-12-08 14:53:34,57,1288,28,29,688.33,1303.02,0.00
2024-12-08 14:53:34,56,1288,28,28,697.60,1303.04,0.00
2024-12-08 14:53:34,56,1289,28,28,699.53,1304.00,0.00
2024-12-08 14:53:34,57,1289,29,28,687.26,1304.02,0.00
2024-12-08 14:53:34,56,1289,28,28,692.78,1304.02,0.00
2024-12-08 14:53:35,55,1289,27,28,692.39,1304.67,0.00
2024-12-08 14:53:35,55,1290,27,28,712.08,1305.00,0.00
2024-12-08 14:53:35,56,1290,28,28,699.37,1305.02,0.00
2024-12-08 14:53:35,55,1290,28,27,709.47,1305.02,0.00
2024-12-08 14:53:35,55,1291,28,27,711.44,1306.00,0.00
2024-12-08 14:53:35,56,1291,29,27,698.74,1306.02,0.00
2024-12-08 14:53:35,55,1291,28,27,705.76,1306.09,0.00
2024-12-08 14:53:35,54,1291,27,27,712.60,1306.28,0.00
2024-12-08 14:53:35,54,1292,27,27,727.83,1307.00,0.00
2024-12-08 14:53:35,55,1292,28,27,714.60,1307.02,0.00
2024-12-08 14:53:35,54,1292,28,26,724.21,1307.04,0.00
2024-12-08 14:53:35,54,1293,28,26,726.69,1308.00,0.00
2024-12-08 14:53:35,55,1293,28,27,713.48,1308.02,0.00
2024-12-08 14:53:35,55,1294,28,27,711.92,1309.00,0.00
2024-12-08 14:53:35,56,1294,29,27,699.20,1309.02,0.00
2024-12-08 14:53:35,55,1294,29,26,708.59,1309.04,0.00
2024-12-08 14:53:35,54,1294,28,26,721.48,1309.06,0.00
2024-12-08 14:53:35,54,1295,28,26,724.20,1310.00,0.00
2024-12-08 14:53:35,55,1295,28,27,711.03,1310.02,0.00
2024-12-08 14:53:35,54,1295,27,27,718.87,1310.06,0.00
2024-12-08 14:53:35,53,1295,26,27,721.48,1310.43,0.00
2024-12-08 14:53:35,53,1296,26,27,739.17,1311.00,0.00
2024-12-08 14:53:35,54,1296,26,28,725.48,1311.02,0.00
2024-12-08 14:53:35,53,1296,26,27,735.96,1311.04,0.00
2024-12-08 14:53:35,53,1297,26,27,738.74,1312.00,0.00
2024-12-08 14:53:35,54,1297,26,28,725.06,1312.02,0.00
2024-12-08 14:53:35,53,1297,25,28,723.55,1312.40,0.00
2024-12-08 14:53:35,53,1298,25,28,740.79,1313.00,0.00
2024-12-08 14:53:35,54,1298,26,28,727.07,1313.02,0.00
2024-12-08 14:53:35,53,1298,26,27,736.09,1313.04,0.00
2024-12-08 14:53:35,52,1298,25,27,749.99,1313.04,0.00
2024-12-08 14:53:35,51,1298,24,27,755.58,1313.35,0.00
2024-12-08 14:53:35,51,1299,24,27,773.26,1314.00,0.00
2024-12-08 14:53:35,52,1299,24,28,758.39,1314.02,0.00
2024-12-08 14:53:35,52,1300,24,28,758.50,1315.00,0.00
2024-12-08 14:53:35,53,1300,25,28,744.19,1315.02,0.00
2024-12-08 14:53:35,52,1300,24,28,742.91,1315.33,0.00
2024-12-08 14:53:35,51,1300,23,28,754.89,1315.53,0.00
2024-12-08 14:53:35,51,1301,23,28,774.83,1316.00,0.00
2024-12-08 14:53:35,52,1301,23,29,759.93,1316.02,0.00
2024-12-08 14:53:35,51,1301,22,29,774.57,1316.04,0.00
2024-12-08 14:53:35,50,1301,22,28,789.80,1316.04,0.00
2024-12-08 14:53:35,50,1302,22,28,793.56,1317.00,0.00
2024-12-08 14:53:35,51,1302,22,29,778.00,1317.02,0.00
2024-12-08 14:53:35,51,1303,22,29,777.54,1318.00,0.00
2024-12-08 14:53:35,52,1303,23,29,762.59,1318.02,0.00
2024-12-08 14:53:35,51,1303,23,28,772.12,1318.04,0.00
2024-12-08 14:53:35,51,1304,23,28,775.55,1319.00,0.00
2024-12-08 14:53:35,52,1304,23,29,760.63,1319.02,0.00
2024-12-08 14:53:35,52,1305,23,29,760.09,1320.00,0.00
2024-12-08 14:53:35,53,1305,24,29,745.75,1320.02,0.00
2024-12-08 14:53:35,52,1305,24,28,755.02,1320.04,0.00
2024-12-08 14:53:35,51,1305,23,28,752.83,1320.92,0.00
2024-12-08 14:53:35,51,1306,23,28,777.76,1321.00,0.00
2024-12-08 14:53:35,52,1306,24,28,762.80,1321.02,0.00
2024-12-08 14:53:35,51,1306,23,28,765.68,1321.26,0.00
2024-12-08 14:53:35,51,1307,23,28,782.23,1322.00,0.00
2024-12-08 14:53:35,52,1307,24,28,767.19,1322.02,0.00
2024-12-08 14:53:35,51,1307,24,27,777.31,1322.04,0.00
2024-12-08 14:53:35,51,1308,24,27,780.75,1323.00,0.00
2024-12-08 14:53:35,52,1308,25,27,765.74,1323.02,0.00
2024-12-08 14:53:35,52,1309,25,27,764.85,1324.00,0.00
2024-12-08 14:53:35,53,1309,25,28,750.42,1324.02,0.00
2024-12-08 14:53:35,52,1309,25,27,760.27,1324.04,0.00
2024-12-08 14:53:35,51,1309,24,27,772.03,1324.12,0.00
2024-12-08 14:53:35,51,1310,24,27,786.87,1325.00,0.00
2024-12-08 14:53:35,52,1310,24,28,771.74,1325.02,0.00
2024-12-08 14:53:35,52,1311,24,28,771.08,1326.00,0.00
2024-12-08 14:53:35,53,1311,25,28,756.53,1326.02,0.00
2024-12-08 14:53:35,52,1311,25,27,765.99,1326.06,0.00
2024-12-08 14:53:35,51,1311,24,27,774.94,1326.53,0.00
2024-12-08 14:53:35,51,1312,24,27,784.63,1327.00,0.00
2024-12-08 14:53:35,52,1312,25,27,769.54,1327.02,0.00
2024-12-08 14:53:35,51,1312,24,27,766.57,1327.77,0.00
2024-12-08 14:53:35,51,1313,24,27,789.66,1328.00,0.00
2024-12-08 14:53:35,52,1313,24,28,774.47,1328.02,0.00
2024-12-08 14:53:35,51,1313,24,27,784.72,1328.06,0.00
2024-12-08 14:53:35,51,1314,24,27,788.43,1329.00,0.00
2024-12-08 14:53:35,52,1314,24,28,773.27,1329.02,0.00
2024-12-08 14:53:35,51,1314,23,28,766.49,1329.90,0.00
2024-12-08 14:53:35,51,1315,23,28,791.33,1330.00,0.00
2024-12-08 14:53:35,52,1315,24,28,776.11,1330.02,0.00
2024-12-08 14:53:35,51,1315,24,27,786.65,1330.06,0.00
2024-12-08 14:53:35,51,1316,24,27,790.36,1331.00,0.00
2024-12-08 14:53:35,52,1316,25,27,775.16,1331.02,0.00
2024-12-08 14:53:35,52,1317,25,27,773.97,1332.00,0.00
2024-12-08 14:53:35,53,1317,25,28,759.37,1332.02,0.00
2024-12-08 14:53:35,52,1317,25,27,769.37,1332.06,0.00
2024-12-08 14:53:36,52,1318,25,27,772.76,1333.00,0.00
2024-12-08 14:53:36,53,1318,26,27,758.18,1333.02,0.00
2024-12-08 14:53:36,52,1318,25,27,751.99,1333.56,0.00
2024-12-08 14:53:36,51,1318,24,27,766.70,1333.57,0.00
2024-12-08 14:53:36,51,1319,24,27,787.42,1334.00,0.00
2024-12-08 14:53:36,52,1319,24,28,772.28,1334.02,0.00
2024-12-08 14:53:36,51,1319,24,27,782.98,1334.06,0.00
2024-12-08 14:53:36,51,1320,24,27,786.70,1335.00,0.00
2024-12-08 14:53:36,52,1320,24,28,771.57,1335.02,0.00
2024-12-08 14:53:36,52,1321,24,28,770.12,1336.00,0.00
2024-12-08 14:53:36,53,1321,24,29,755.59,1336.02,0.00
2024-12-08 14:53:36,52,1321,23,29,769.86,1336.02,0.00
2024-12-08 14:53:36,51,1321,23,28,781.03,1336.04,0.00
2024-12-08 14:53:36,50,1321,22,28,779.29,1336.96,0.00
2024-12-08 14:53:36,50,1322,22,28,805.51,1337.00,0.00
2024-12-08 14:53:36,51,1322,23,28,789.72,1337.02,0.00
2024-12-08 14:53:36,50,1322,22,28,790.05,1337.68,0.00
2024-12-08 14:53:36,50,1323,22,28,812.78,1338.00,0.00
2024-12-08 14:53:36,51,1323,23,28,796.84,1338.02,0.00
2024-12-08 14:53:36,50,1323,23,27,809.04,1338.04,0.00
2024-12-08 14:53:36,50,1324,23,27,812.85,1339.00,0.00
2024-12-08 14:53:36,51,1324,23,28,796.91,1339.02,0.00
2024-12-08 14:53:36,50,1324,22,28,806.70,1339.06,0.00
2024-12-08 14:53:36,50,1325,22,28,821.50,1340.00,0.00
2024-12-08 14:53:36,51,1325,23,28,805.39,1340.02,0.00
2024-12-08 14:53:36,50,1325,23,27,816.14,1340.04,0.00
2024-12-08 14:53:36,50,1326,23,27,819.97,1341.00,0.00
2024-12-08 14:53:36,51,1326,24,27,803.89,1341.02,0.00
2024-12-08 14:53:36,51,1327,24,27,803.16,1342.00,0.00
2024-12-08 14:53:36,52,1327,25,27,787.72,1342.02,0.00
2024-12-08 14:53:36,51,1327,25,26,797.90,1342.04,0.00
2024-12-08 14:53:36,50,1327,24,26,812.53,1342.04,0.00
2024-12-08 14:53:36,49,1327,23,26,828.84,1342.04,0.00
2024-12-08 14:53:36,49,1328,23,26,843.98,1343.00,0.00
2024-12-08 14:53:36,50,1328,23,27,827.10,1343.02,0.00
2024-12-08 14:53:36,50,1329,23,27,826.63,1344.00,0.00
2024-12-08 14:53:36,51,1329,24,27,810.42,1344.02,0.00
2024-12-08 14:53:36,50,1329,24,26,820.72,1344.04,0.00
2024-12-08 14:53:36,50,1330,24,26,824.55,1345.00,0.00
2024-12-08 14:53:36,51,1330,24,27,808.39,1345.02,0.00
2024-12-08 14:53:36,50,1330,23,27,809.62,1345.34,0.00
2024-12-08 14:53:36,50,1331,23,27,828.13,1346.00,0.00
2024-12-08 14:53:36,51,1331,23,28,811.89,1346.02,0.00
2024-12-08 14:53:36,50,1331,23,27,822.21,1346.04,0.00
2024-12-08 14:53:36,50,1332,23,27,826.05,1347.00,0.00
2024-12-08 14:53:36,51,1332,23,28,809.85,1347.02,0.00
2024-12-08 14:53:36,51,1333,23,28,809.46,1348.00,0.00
2024-12-08 14:53:36,52,1333,23,29,793.89,1348.02,0.00
2024-12-08 14:53:36,51,1333,23,28,803.64,1348.04,0.00
2024-12-08 14:53:36,50,1333,22,28,809.78,1348.30,0.00
2024-12-08 14:53:36,50,1334,22,28,827.82,1349.00,0.00
2024-12-08 14:53:36,51,1334,23,28,811.58,1349.02,0.00
2024-12-08 14:53:36,50,1334,22,28,806.73,1349.86,0.00
2024-12-08 14:53:36,50,1335,22,28,831.95,1350.00,0.00
2024-12-08 14:53:36,51,1335,22,29,815.64,1350.02,0.00
2024-12-08 14:53:36,50,1335,22,28,826.28,1350.04,0.00
2024-12-08 14:53:36,50,1336,22,28,830.13,1351.00,0.00
2024-12-08 14:53:36,51,1336,22,29,813.86,1351.02,0.00
2024-12-08 14:53:36,51,1337,22,29,813.48,1352.00,0.00
2024-12-08 14:53:36,52,1337,22,30,797.84,1352.02,0.00
2024-12-08 14:53:36,51,1337,22,29,807.39,1352.06,0.00
2024-12-08 14:53:36,51,1338,22,29,811.17,1353.00,0.00
2024-12-08 14:53:36,52,1338,23,29,795.57,1353.02,0.00
2024-12-08 14:53:36,52,1339,23,29,795.12,1354.00,0.00
2024-12-08 14:53:36,53,1339,23,30,780.12,1354.02,0.00
2024-12-08 14:53:36,52,1339,23,29,789.40,1354.06,0.00
2024-12-08 14:53:36,51,1339,22,29,791.22,1354.78,0.00
2024-12-08 14:53:36,51,1340,22,29,815.02,1355.00,0.00
2024-12-08 14:53:36,52,1340,23,29,799.35,1355.02,0.00
2024-12-08 14:53:36,51,1340,22,29,814.15,1355.04,0.00
2024-12-08 14:53:36,51,1341,22,29,822.99,1356.00,0.00
2024-12-08 14:53:36,52,1341,23,29,807.16,1356.02,0.00
2024-12-08 14:53:36,52,1342,23,29,804.89,1357.00,0.00
2024-12-08 14:53:36,53,1342,24,29,789.70,1357.02,0.00
2024-12-08 14:53:36,52,1342,23,29,804.12,1357.08,0.00
2024-12-08 14:53:36,51,1342,23,28,819.10,1357.10,0.00
2024-12-08 14:53:36,51,1343,23,28,823.41,1358.00,0.00
2024-12-08 14:53:36,52,1343,23,29,807.57,1358.02,0.00
2024-12-08 14:53:36,51,1343,22,29,805.08,1358.75,0.00
2024-12-08 14:53:36,51,1344,22,29,828.46,1359.00,0.00
2024-12-08 14:53:36,52,1344,23,29,812.52,1359.02,0.00
2024-12-08 14:53:36,51,1344,23,28,821.82,1359.10,0.00
2024-12-08 14:53:36,51,1345,23,28,826.13,1360.00,0.00
2024-12-08 14:53:36,52,1345,24,28,810.25,1360.02,0.00
2024-12-08 14:53:36,51,1345,23,28,818.69,1360.12,0.00
2024-12-08 14:53:36,52,1344,23,29,800.18,1360.37,0.00
2024-12-08 14:53:36,52,1345,23,29,838.59,1361.00,0.00
2024-12-08 14:53:36,53,1345,23,30,822.76,1361.02,0.00
2024-12-08 14:53:36,52,1345,23,29,832.06,1361.10,0.00
2024-12-08 14:53:37,52,1346,23,29,862.25,1362.00,0.00
2024-12-08 14:53:37,53,1346,23,30,845.98,1362.02,0.00
2024-12-08 14:53:37,52,1346,22,30,861.99,1362.02,0.00
2024-12-08 14:53:37,52,1347,22,30,861.95,1363.00,0.00
2024-12-08 14:53:37,53,1347,22,31,845.69,1363.02,0.00
2024-12-08 14:53:37,52,1347,21,31,841.08,1363.46,0.00
2024-12-08 14:53:37,52,1348,21,31,860.37,1364.00,0.00
2024-12-08 14:53:37,53,1348,22,31,844.14,1364.02,0.00
2024-12-08 14:53:37,52,1348,22,30,858.03,1364.10,0.00
2024-12-08 14:53:37,52,1349,22,30,862.05,1365.00,0.00
2024-12-08 14:53:37,53,1349,22,31,845.78,1365.02,0.00
2024-12-08 14:53:37,53,1350,22,31,845.36,1366.00,0.00
2024-12-08 14:53:37,54,1350,22,32,829.71,1366.02,0.00
2024-12-08 14:53:37,53,1350,21,32,826.47,1366.42,0.00
2024-12-08 14:53:37,53,1351,21,32,844.70,1367.00,0.00
2024-12-08 14:53:37,54,1351,21,33,829.06,1367.02,0.00
2024-12-08 14:53:37,53,1351,21,32,842.41,1367.11,0.00
2024-12-08 14:53:37,52,1351,20,32,850.57,1367.33,0.00
2024-12-08 14:53:37,52,1352,20,32,868.15,1368.00,0.00
2024-12-08 14:53:37,53,1352,21,32,851.77,1368.02,0.00
2024-12-08 14:53:37,52,1352,20,32,853.55,1368.33,0.00
2024-12-08 14:53:37,52,1353,20,32,871.16,1369.00,0.00
2024-12-08 14:53:37,53,1353,21,32,854.72,1369.02,0.00
2024-12-08 14:53:37,53,1354,21,32,852.24,1370.00,0.00
2024-12-08 14:53:37,54,1354,21,33,836.46,1370.02,0.00
2024-12-08 14:53:37,53,1354,21,32,850.46,1370.11,0.00
2024-12-08 14:53:37,52,1354,20,32,860.51,1370.60,0.00
2024-12-08 14:53:37,52,1355,20,32,871.11,1371.00,0.00
2024-12-08 14:53:37,53,1355,21,32,854.68,1371.02,0.00
2024-12-08 14:53:37,52,1355,20,32,848.77,1371.96,0.00
2024-12-08 14:53:37,52,1356,20,32,874.65,1372.00,0.00
2024-12-08 14:53:37,53,1356,21,32,858.15,1372.02,0.00
2024-12-08 14:53:37,52,1356,21,31,867.82,1372.12,0.00
2024-12-08 14:53:37,52,1357,21,31,872.12,1373.00,0.00
2024-12-08 14:53:37,53,1357,21,32,855.66,1373.02,0.00
2024-12-08 14:53:37,53,1358,21,32,854.25,1374.00,0.00
2024-12-08 14:53:37,54,1358,21,33,838.43,1374.02,0.00
2024-12-08 14:53:37,53,1358,21,32,847.53,1374.11,0.00
2024-12-08 14:53:37,52,1358,20,32,852.31,1374.40,0.00
2024-12-08 14:53:37,52,1359,20,32,871.01,1375.00,0.00
2024-12-08 14:53:37,53,1359,21,32,854.58,1375.02,0.00
2024-12-08 14:53:37,52,1359,20,32,854.77,1375.39,0.00
2024-12-08 14:53:37,52,1360,20,32,873.23,1376.00,0.00
2024-12-08 14:53:37,53,1360,21,32,856.75,1376.02,0.00
2024-12-08 14:53:37,52,1360,21,31,866.37,1376.12,0.00
2024-12-08 14:53:37,52,1361,21,31,870.69,1377.00,0.00
2024-12-08 14:53:37,53,1361,21,32,854.26,1377.02,0.00
2024-12-08 14:53:37,53,1362,21,32,852.73,1378.00,0.00
2024-12-08 14:53:37,54,1362,21,33,836.93,1378.02,0.00
2024-12-08 14:53:37,53,1362,21,32,846.25,1378.11,0.00
2024-12-08 14:53:37,53,1363,21,32,850.22,1379.00,0.00
2024-12-08 14:53:37,54,1363,22,32,834.48,1379.02,0.00
2024-12-08 14:53:37,54,1364,22,32,833.11,1380.00,0.00
2024-12-08 14:53:37,55,1364,22,33,817.97,1380.02,0.00
2024-12-08 14:53:37,54,1364,22,32,826.74,1380.11,0.00
2024-12-08 14:53:37,53,1364,21,32,840.70,1380.11,0.00
2024-12-08 14:53:37,53,1365,21,32,855.10,1381.00,0.00
2024-12-08 14:53:37,54,1365,22,32,839.27,1381.02,0.00
2024-12-08 14:53:37,53,1365,21,32,853.05,1381.13,0.00
2024-12-08 14:53:37,53,1366,21,32,862.50,1382.00,0.00
2024-12-08 14:53:37,54,1366,21,33,846.53,1382.02,0.00
2024-12-08 14:53:37,54,1367,21,33,843.81,1383.00,0.00
2024-12-08 14:53:37,55,1367,22,33,828.47,1383.02,0.00
2024-12-08 14:53:37,54,1367,22,32,841.79,1383.13,0.00
2024-12-08 14:53:37,54,1368,22,32,845.71,1384.00,0.00
2024-12-08 14:53:37,55,1368,22,33,830.33,1384.02,0.00
2024-12-08 14:53:37,55,1369,22,33,829.07,1385.00,0.00
2024-12-08 14:53:37,56,1369,23,33,814.27,1385.02,0.00
2024-12-08 14:53:37,55,1369,23,32,812.22,1385.13,0.00
2024-12-08 14:53:37,55,1370,23,32,825.89,1386.00,0.00
2024-12-08 14:53:37,56,1370,23,33,811.14,1386.02,0.00
2024-12-08 14:53:37,55,1370,22,33,824.23,1386.11,0.00
2024-12-08 14:53:37,55,1371,22,33,832.63,1387.00,0.00
2024-12-08 14:53:37,56,1371,22,34,817.76,1387.02,0.00
2024-12-08 14:53:37,56,1372,22,34,814.64,1388.00,0.00
2024-12-08 14:53:37,57,1372,22,35,800.34,1388.02,0.00
2024-12-08 14:53:37,56,1372,22,34,813.16,1388.11,0.00
2024-12-08 14:53:37,56,1373,22,34,816.22,1389.00,0.00
2024-12-08 14:53:37,57,1373,22,35,801.90,1389.02,0.00
2024-12-08 14:53:37,57,1374,22,35,800.57,1390.00,0.00
2024-12-08 14:53:37,58,1374,22,36,786.77,1390.02,0.00
2024-12-08 14:53:37,57,1374,22,35,794.49,1390.11,0.00
2024-12-08 14:53:37,57,1375,22,35,797.25,1391.00,0.00
2024-12-08 14:53:37,58,1375,22,36,783.50,1391.02,0.00
2024-12-08 14:53:37,58,1376,22,36,782.41,1392.00,0.00
2024-12-08 14:53:37,59,1376,23,36,769.15,1392.02,0.00
2024-12-08 14:53:37,58,1376,23,35,776.18,1392.10,0.00
2024-12-08 14:53:38,58,1377,23,35,778.65,1393.00,0.00
2024-12-08 14:53:38,59,1377,24,35,765.45,1393.02,0.00
2024-12-08 14:53:38,58,1377,23,35,773.61,1393.09,0.00
2024-12-08 14:53:38,58,1378,23,35,780.65,1394.00,0.00
2024-12-08 14:53:38,59,1378,23,36,767.42,1394.02,0.00
2024-12-08 14:53:38,58,1378,22,36,780.41,1394.02,0.00
2024-12-08 14:53:38,58,1379,22,36,779.47,1395.00,0.00
2024-12-08 14:53:38,59,1379,22,37,766.26,1395.02,0.00
2024-12-08 14:53:38,58,1379,21,37,779.23,1395.02,0.00
2024-12-08 14:53:38,57,1379,21,36,787.04,1395.07,0.00
2024-12-08 14:53:38,57,1380,21,36,789.31,1396.00,0.00
2024-12-08 14:53:38,58,1380,21,37,775.70,1396.02,0.00
2024-12-08 14:53:38,57,1380,20,37,776.43,1396.60,0.00
2024-12-08 14:53:38,56,1380,19,37,778.39,1396.96,0.00
2024-12-08 14:53:38,56,1381,19,37,802.86,1397.00,0.00
2024-12-08 14:53:38,57,1381,19,38,788.77,1397.02,0.00
2024-12-08 14:53:38,56,1381,18,38,802.61,1397.02,0.00
2024-12-08 14:53:38,55,1381,18,37,811.62,1397.06,0.00
2024-12-08 14:53:38,54,1381,17,37,814.13,1397.82,0.00
2024-12-08 14:53:38,54,1382,17,37,837.59,1398.00,0.00
2024-12-08 14:53:38,55,1382,18,37,822.36,1398.02,0.00
2024-12-08 14:53:38,55,1383,18,37,821.45,1399.00,0.00
2024-12-08 14:53:38,56,1383,18,38,806.78,1399.02,0.00
2024-12-08 14:53:38,55,1383,18,37,815.60,1399.06,0.00
2024-12-08 14:53:38,55,1384,18,37,818.22,1400.00,0.00
2024-12-08 14:53:38,56,1384,19,37,803.61,1400.02,0.00
2024-12-08 14:53:38,55,1384,18,37,805.84,1400.26,0.00
2024-12-08 14:53:38,54,1384,17,37,817.49,1400.50,0.00
2024-12-08 14:53:38,54,1385,17,37,836.79,1401.00,0.00
2024-12-08 14:53:38,55,1385,18,37,821.58,1401.02,0.00
2024-12-08 14:53:38,54,1385,17,37,822.34,1401.69,0.00
2024-12-08 14:53:38,54,1386,17,37,833.75,1402.00,0.00
2024-12-08 14:53:38,55,1386,18,37,818.60,1402.02,0.00
2024-12-08 14:53:38,54,1386,18,36,832.47,1402.07,0.00
2024-12-08 14:53:38,54,1387,18,36,835.65,1403.00,0.00
2024-12-08 14:53:38,55,1387,19,36,820.45,1403.02,0.00
2024-12-08 14:53:38,54,1387,18,36,835.39,1403.02,0.00
2024-12-08 14:53:38,54,1388,18,36,834.75,1404.00,0.00
2024-12-08 14:53:38,55,1388,19,36,819.57,1404.02,0.00
2024-12-08 14:53:38,54,1388,18,36,833.13,1404.04,0.00
2024-12-08 14:53:38,54,1389,18,36,841.00,1405.00,0.00
2024-12-08 14:53:38,55,1389,19,36,825.71,1405.02,0.00
2024-12-08 14:53:38,54,1389,19,35,840.48,1405.04,0.00
2024-12-08 14:53:38,54,1390,19,35,843.16,1406.00,0.00
2024-12-08 14:53:38,55,1390,20,35,827.83,1406.02,0.00
2024-12-08 14:53:38,54,1390,19,35,831.98,1406.15,0.00
2024-12-08 14:53:38,54,1391,19,35,846.60,1407.00,0.00
2024-12-08 14:53:38,55,1391,20,35,831.21,1407.02,0.00
2024-12-08 14:53:38,54,1391,20,34,841.13,1407.04,0.00
2024-12-08 14:53:38,54,1392,20,34,843.81,1408.00,0.00
2024-12-08 14:53:38,55,1392,20,35,828.47,1408.02,0.00
2024-12-08 14:53:38,55,1393,20,35,826.79,1409.00,0.00
2024-12-08 14:53:38,56,1393,20,36,812.02,1409.02,0.00
2024-12-08 14:53:38,55,1393,20,35,821.66,1409.04,0.00
2024-12-08 14:53:38,54,1393,19,35,830.64,1409.19,0.00
2024-12-08 14:53:38,54,1394,19,35,845.79,1410.00,0.00
2024-12-08 14:53:38,55,1394,19,36,830.42,1410.02,0.00
2024-12-08 14:53:38,54,1394,18,36,837.21,1410.13,0.00
2024-12-08 14:53:38,54,1395,18,36,851.62,1411.00,0.00
2024-12-08 14:53:38,55,1395,18,37,836.14,1411.02,0.00
2024-12-08 14:53:38,54,1395,18,36,846.66,1411.04,0.00
2024-12-08 14:53:38,54,1396,18,36,849.35,1412.00,0.00
2024-12-08 14:53:38,55,1396,19,36,833.91,1412.02,0.00
2024-12-08 14:53:38,54,1396,18,36,837.24,1412.52,0.00
2024-12-08 14:53:38,53,1396,17,36,845.03,1412.87,0.00
2024-12-08 14:53:38,53,1397,17,36,869.93,1413.00,0.00
2024-12-08 14:53:38,54,1397,17,37,853.82,1413.02,0.00
2024-12-08 14:53:38,53,1397,17,36,864.86,1413.04,0.00
2024-12-08 14:53:38,53,1398,17,36,867.88,1414.00,0.00
2024-12-08 14:53:38,54,1398,17,37,851.80,1414.02,0.00
2024-12-08 14:53:38,53,1398,17,36,867.61,1414.02,0.00
2024-12-08 14:53:38,53,1399,17,36,865.62,1415.00,0.00
2024-12-08 14:53:38,54,1399,18,36,849.59,1415.02,0.00
2024-12-08 14:53:38,53,1399,18,35,861.08,1415.02,0.00
2024-12-08 14:53:38,53,1400,18,35,863.83,1416.00,0.00
2024-12-08 14:53:38,54,1400,18,36,847.83,1416.02,0.00
2024-12-08 14:53:38,54,1401,18,36,845.43,1417.00,0.00
2024-12-08 14:53:38,55,1401,18,37,830.06,1417.02,0.00
2024-12-08 14:53:38,54,1401,18,36,841.23,1417.02,0.00
2024-12-08 14:53:38,53,1401,17,36,840.54,1417.93,0.00
2024-12-08 14:53:38,53,1402,17,36,866.27,1418.00,0.00
2024-12-08 14:53:38,54,1402,17,37,850.23,1418.02,0.00
2024-12-08 14:53:38,54,1403,17,37,847.71,1419.00,0.00
2024-12-08 14:53:38,55,1403,17,38,832.29,1419.02,0.00
2024-12-08 14:53:38,54,1403,17,37,843.50,1419.02,0.00
2024-12-08 14:53:38,54,1404,17,37,845.94,1420.00,0.00
2024-12-08 14:53:38,55,1404,18,37,830.56,1420.02,0.00
2024-12-08 14:53:39,55,1405,18,37,828.74,1421.00,0.00
2024-12-08 14:53:39,56,1405,19,37,813.94,1421.02,0.00
2024-12-08 14:53:39,55,1405,19,36,823.83,1421.04,0.00
2024-12-08 14:53:39,54,1405,18,36,839.09,1421.04,0.00
2024-12-08 14:53:39,54,1406,18,36,841.78,1422.00,0.00
2024-12-08 14:53:39,55,1406,19,36,826.48,1422.02,0.00
2024-12-08 14:53:39,55,1407,19,36,824.65,1423.00,0.00
2024-12-08 14:53:39,56,1407,20,36,809.93,1423.02,0.00
2024-12-08 14:53:39,55,1407,20,35,819.74,1423.04,0.00
2024-12-08 14:53:39,54,1407,19,35,832.39,1423.09,0.00
2024-12-08 14:53:39,54,1408,19,35,846.39,1424.00,0.00
2024-12-08 14:53:39,55,1408,19,36,831.00,1424.02,0.00
2024-12-08 14:53:39,55,1409,19,36,829.06,1425.00,0.00
2024-12-08 14:53:39,56,1409,19,37,814.25,1425.02,0.00
2024-12-08 14:53:39,55,1409,19,36,824.40,1425.04,0.00
2024-12-08 14:53:39,55,1410,19,36,826.79,1426.00,0.00
2024-12-08 14:53:39,56,1410,19,37,812.02,1426.02,0.00
2024-12-08 14:53:39,56,1411,19,37,810.15,1427.00,0.00
2024-12-08 14:53:39,57,1411,19,38,795.93,1427.02,0.00
2024-12-08 14:53:39,56,1411,19,37,805.82,1427.04,0.00
2024-12-08 14:53:39,55,1411,18,37,806.80,1427.44,0.00
2024-12-08 14:53:39,55,1412,18,37,825.09,1428.00,0.00
2024-12-08 14:53:39,56,1412,18,38,810.36,1428.02,0.00
2024-12-08 14:53:39,55,1412,17,38,817.34,1428.13,0.00
2024-12-08 14:53:39,54,1412,16,38,826.05,1428.59,0.00
2024-12-08 14:53:39,54,1413,16,38,846.98,1429.00,0.00
2024-12-08 14:53:39,55,1413,17,38,831.58,1429.02,0.00
2024-12-08 14:53:39,54,1413,17,37,842.75,1429.04,0.00
2024-12-08 14:53:39,53,1413,16,37,850.56,1429.62,0.00
2024-12-08 14:53:39,53,1414,16,37,861.65,1430.00,0.00
2024-12-08 14:53:39,54,1414,17,37,845.69,1430.02,0.00
2024-12-08 14:53:39,54,1415,17,37,843.38,1431.00,0.00
2024-12-08 14:53:39,55,1415,18,37,828.05,1431.02,0.00
2024-12-08 14:53:39,54,1415,18,36,839.14,1431.04,0.00
2024-12-08 14:53:39,54,1416,18,36,841.85,1432.00,0.00
2024-12-08 14:53:39,55,1416,18,37,826.54,1432.02,0.00
2024-12-08 14:53:39,55,1417,18,37,823.98,1433.00,0.00
2024-12-08 14:53:39,56,1417,18,38,809.26,1433.02,0.00
2024-12-08 14:53:39,55,1417,18,37,820.07,1433.04,0.00
2024-12-08 14:53:39,55,1418,18,37,822.47,1434.00,0.00
2024-12-08 14:53:39,56,1418,18,38,807.78,1434.02,0.00
2024-12-08 14:53:39,55,1418,17,38,799.03,1434.96,0.00
2024-12-08 14:53:39,55,1419,17,38,824.62,1435.00,0.00
2024-12-08 14:53:39,56,1419,18,38,809.89,1435.02,0.00
2024-12-08 14:53:39,55,1419,18,37,820.97,1435.04,0.00
2024-12-08 14:53:39,55,1420,18,37,823.37,1436.00,0.00
2024-12-08 14:53:39,56,1420,19,37,808.66,1436.02,0.00
2024-12-08 14:53:39,55,1420,18,37,817.12,1436.09,0.00
2024-12-08 14:53:39,55,1421,18,37,821.34,1437.00,0.00
2024-12-08 14:53:39,56,1421,19,37,806.67,1437.02,0.00
2024-12-08 14:53:39,55,1421,19,36,817.42,1437.04,0.00
2024-12-08 14:53:39,55,1422,19,36,819.82,1438.00,0.00
2024-12-08 14:53:39,56,1422,20,36,805.18,1438.02,0.00
2024-12-08 14:53:39,56,1423,20,36,802.96,1439.00,0.00
2024-12-08 14:53:39,57,1423,21,36,788.88,1439.02,0.00
2024-12-08 14:53:39,56,1423,21,35,798.85,1439.04,0.00
2024-12-08 14:53:39,56,1424,21,35,800.95,1440.00,0.00
2024-12-08 14:53:39,57,1424,22,35,786.90,1440.02,0.00
2024-12-08 14:53:39,56,1424,21,35,794.99,1440.05,0.00
2024-12-08 14:53:39,56,1425,21,35,807.63,1441.00,0.00
2024-12-08 14:53:39,57,1425,21,36,793.46,1441.02,0.00
2024-12-08 14:53:39,56,1425,21,35,803.77,1441.04,0.00
2024-12-08 14:53:39,56,1426,21,35,805.87,1442.00,0.00
2024-12-08 14:53:39,57,1426,22,35,791.74,1442.02,0.00
2024-12-08 14:53:39,56,1426,21,35,793.17,1442.55,0.00
2024-12-08 14:53:39,56,1427,21,35,803.86,1443.00,0.00
2024-12-08 14:53:39,57,1427,22,35,789.75,1443.02,0.00
2024-12-08 14:53:39,56,1427,22,34,799.74,1443.04,0.00
2024-12-08 14:53:39,56,1428,22,34,801.84,1444.00,0.00
2024-12-08 14:53:39,57,1428,22,35,787.77,1444.02,0.00
2024-12-08 14:53:39,57,1429,22,35,785.48,1445.00,0.00
2024-12-08 14:53:39,58,1429,22,36,771.94,1445.02,0.00
2024-12-08 14:53:39,57,1429,22,35,781.68,1445.04,0.00
2024-12-08 14:53:39,56,1429,21,35,786.57,1445.63,0.00
2024-12-08 14:53:39,56,1430,21,35,807.22,1446.00,0.00
2024-12-08 14:53:39,57,1430,22,35,793.06,1446.02,0.00
2024-12-08 14:53:39,56,1430,21,35,798.19,1446.04,0.00
2024-12-08 14:53:39,56,1431,21,35,805.45,1447.00,0.00
2024-12-08 14:53:39,57,1431,21,36,791.32,1447.02,0.00
2024-12-08 14:53:39,56,1431,21,35,801.58,1447.04,0.00
2024-12-08 14:53:39,56,1432,21,35,803.68,1448.00,0.00
2024-12-08 14:53:39,57,1432,21,36,789.58,1448.02,0.00
2024-12-08 14:53:39,57,1433,21,36,787.33,1449.00,0.00
2024-12-08 14:53:39,58,1433,21,37,773.75,1449.02,0.00
2024-12-08 14:53:39,57,1433,21,36,783.52,1449.04,0.00
2024-12-08 14:53:39,56,1433,20,36,783.66,1449.79,0.00
2024-12-08 14:53:39,56,1434,20,36,806.61,1450.00,0.00
2024-12-08 14:53:39,57,1434,20,37,792.46,1450.02,0.00
2024-12-08 14:53:40,57,1435,20,37,790.32,1451.00,0.00
2024-12-08 14:53:40,58,1435,21,37,776.69,1451.02,0.00
2024-12-08 14:53:40,57,1435,21,36,786.50,1451.04,0.00
2024-12-08 14:53:40,56,1435,20,36,791.53,1451.68,0.00
2024-12-08 14:53:40,56,1436,20,36,802.65,1452.00,0.00
2024-12-08 14:53:40,57,1436,21,36,788.57,1452.02,0.00
2024-12-08 14:53:40,57,1437,21,36,786.54,1453.00,0.00
2024-12-08 14:53:40,58,1437,22,36,772.97,1453.02,0.00
2024-12-08 14:53:40,57,1437,22,35,782.71,1453.04,0.00
2024-12-08 14:53:40,57,1438,22,35,784.53,1454.00,0.00
2024-12-08 14:53:40,58,1438,22,36,771.00,1454.02,0.00
2024-12-08 14:53:40,57,1438,21,36,763.34,1454.53,0.00
2024-12-08 14:53:40,57,1439,21,36,782.30,1455.00,0.00
2024-12-08 14:53:40,58,1439,22,36,768.81,1455.02,0.00
2024-12-08 14:53:40,57,1439,22,35,778.73,1455.04,0.00
2024-12-08 14:53:40,57,1440,22,35,780.54,1456.00,0.00
2024-12-08 14:53:40,58,1440,22,36,767.08,1456.02,0.00
2024-12-08 14:53:40,58,1441,22,36,764.73,1457.00,0.00
2024-12-08 14:53:40,59,1441,22,37,751.77,1457.02,0.00
2024-12-08 14:53:40,58,1441,21,37,764.48,1457.02,0.00
2024-12-08 14:53:40,57,1441,21,36,774.83,1457.02,0.00
2024-12-08 14:53:40,57,1442,21,36,776.38,1458.00,0.00
2024-12-08 14:53:40,58,1442,22,36,763.00,1458.02,0.00
2024-12-08 14:53:40,58,1443,22,36,760.65,1459.00,0.00
2024-12-08 14:53:40,59,1443,23,36,747.76,1459.02,0.00
2024-12-08 14:53:40,58,1443,23,35,757.88,1459.02,0.00
2024-12-08 14:53:40,57,1443,22,35,769.68,1459.12,0.00
2024-12-08 14:53:40,57,1444,22,35,772.73,1460.00,0.00
2024-12-08 14:53:40,58,1444,22,36,759.41,1460.02,0.00
2024-12-08 14:53:40,58,1445,22,36,756.79,1461.00,0.00
2024-12-08 14:53:40,59,1445,22,37,743.97,1461.02,0.00
2024-12-08 14:53:40,58,1445,22,36,754.27,1461.02,0.00
2024-12-08 14:53:40,57,1445,21,36,766.00,1461.12,0.00
2024-12-08 14:53:40,56,1445,20,36,762.00,1461.96,0.00
2024-12-08 14:53:40,56,1446,20,36,787.61,1462.00,0.00
2024-12-08 14:53:40,57,1446,21,36,773.79,1462.02,0.00
2024-12-08 14:53:40,56,1446,20,36,780.85,1462.13,0.00
2024-12-08 14:53:40,56,1447,20,36,785.12,1463.00,0.00
2024-12-08 14:53:40,57,1447,20,37,771.35,1463.02,0.00
2024-12-08 14:53:40,56,1447,20,36,782.77,1463.02,0.00
2024-12-08 14:53:40,55,1447,19,36,789.15,1463.56,0.00
2024-12-08 14:53:40,55,1448,19,36,799.02,1464.00,0.00
2024-12-08 14:53:40,56,1448,19,37,784.75,1464.02,0.00
2024-12-08 14:53:40,55,1448,18,37,775.59,1464.60,0.00
2024-12-08 14:53:40,55,1449,18,37,796.64,1465.00,0.00
2024-12-08 14:53:40,56,1449,19,37,782.41,1465.02,0.00
2024-12-08 14:53:40,55,1449,19,36,793.97,1465.02,0.00
2024-12-08 14:53:40,54,1449,18,36,791.82,1465.56,0.00
2024-12-08 14:53:40,54,1450,18,36,812.76,1466.00,0.00
2024-12-08 14:53:40,55,1450,19,36,797.98,1466.02,0.00
2024-12-08 14:53:40,55,1451,19,36,795.34,1467.00,0.00
2024-12-08 14:53:40,56,1451,20,36,781.13,1467.02,0.00
2024-12-08 14:53:40,55,1451,20,35,792.94,1467.02,0.00
2024-12-08 14:53:40,54,1451,19,35,806.29,1467.11,0.00
2024-12-08 14:53:40,54,1452,19,35,810.07,1468.00,0.00
2024-12-08 14:53:40,55,1452,20,35,795.35,1468.02,0.00
2024-12-08 14:53:40,54,1452,19,35,803.50,1468.09,0.00
2024-12-08 14:53:40,54,1453,19,35,807.17,1469.00,0.00
2024-12-08 14:53:40,55,1453,19,36,792.49,1469.02,0.00
2024-12-08 14:53:40,54,1453,19,35,804.99,1469.02,0.00
2024-12-08 14:53:40,54,1454,19,35,807.44,1470.00,0.00
2024-12-08 14:53:40,55,1454,19,36,792.76,1470.02,0.00
2024-12-08 14:53:40,55,1455,19,36,789.56,1471.00,0.00
2024-12-08 14:53:40,56,1455,19,37,775.46,1471.02,0.00
2024-12-08 14:53:40,55,1455,19,36,787.68,1471.02,0.00
2024-12-08 14:53:40,54,1455,18,36,783.99,1471.96,0.00
2024-12-08 14:53:40,54,1456,18,36,810.72,1472.00,0.00
2024-12-08 14:53:40,55,1456,19,36,795.98,1472.02,0.00
2024-12-08 14:53:40,55,1457,19,36,792.77,1473.00,0.00
2024-12-08 14:53:40,56,1457,20,36,778.62,1473.02,0.00
2024-12-08 14:53:40,55,1457,20,35,790.90,1473.02,0.00
2024-12-08 14:53:40,54,1457,19,35,795.76,1473.69,0.00
2024-12-08 14:53:40,54,1458,19,35,807.73,1474.00,0.00
2024-12-08 14:53:40,55,1458,20,35,793.04,1474.02,0.00
2024-12-08 14:53:40,54,1458,19,35,796.89,1474.24,0.00
2024-12-08 14:53:40,54,1459,19,35,813.47,1475.00,0.00
2024-12-08 14:53:40,55,1459,19,36,798.68,1475.02,0.00
2024-12-08 14:53:40,54,1459,19,35,809.37,1475.04,0.00
2024-12-08 14:53:40,54,1460,19,35,812.11,1476.00,0.00
2024-12-08 14:53:40,55,1460,20,35,797.34,1476.02,0.00
2024-12-08 14:53:40,55,1461,20,35,795.22,1477.00,0.00
2024-12-08 14:53:40,56,1461,21,35,781.02,1477.02,0.00
2024-12-08 14:53:40,55,1461,21,34,791.47,1477.04,0.00
2024-12-08 14:53:40,55,1462,21,34,793.88,1478.00,0.00
2024-12-08 14:53:40,56,1462,22,34,779.70,1478.02,0.00
2024-12-08 14:53:40,55,1462,21,34,780.01,1478.60,0.00
2024-12-08 14:53:40,56,1461,22,34,763.57,1478.80,0.00
2024-12-08 14:53:40,56,1462,22,34,791.07,1479.00,0.00
2024-12-08 14:53:40,57,1462,22,35,777.19,1479.02,0.00
2024-12-08 14:53:40,56,1462,22,34,787.64,1479.04,0.00
2024-12-08 14:53:41,56,1463,22,34,816.18,1480.00,0.00
2024-12-08 14:53:41,57,1463,22,35,801.87,1480.02,0.00
2024-12-08 14:53:41,57,1464,22,35,799.16,1481.00,0.00
2024-12-08 14:53:41,58,1464,23,35,785.38,1481.02,0.00
2024-12-08 14:53:41,57,1464,23,34,796.04,1481.04,0.00
2024-12-08 14:53:41,56,1464,22,34,808.71,1481.14,0.00
2024-12-08 14:53:41,56,1465,22,34,812.39,1482.00,0.00
2024-12-08 14:53:41,57,1465,23,34,798.14,1482.02,0.00
2024-12-08 14:53:41,56,1465,22,34,790.58,1482.86,0.00
2024-12-08 14:53:41,56,1466,22,34,815.03,1483.00,0.00
2024-12-08 14:53:41,57,1466,23,34,800.73,1483.02,0.00
2024-12-08 14:53:41,56,1466,23,33,811.85,1483.04,0.00
2024-12-08 14:53:41,56,1467,23,33,813.99,1484.00,0.00
2024-12-08 14:53:41,57,1467,24,33,799.71,1484.02,0.00
2024-12-08 14:53:41,56,1467,23,33,808.95,1484.02,0.00
2024-12-08 14:53:41,56,1468,23,33,816.13,1485.00,0.00
2024-12-08 14:53:41,57,1468,23,34,801.81,1485.02,0.00
2024-12-08 14:53:41,56,1468,23,33,813.48,1485.02,0.00
2024-12-08 14:53:41,56,1469,23,33,815.35,1486.00,0.00
2024-12-08 14:53:41,57,1469,23,34,801.05,1486.02,0.00
2024-12-08 14:53:41,57,1470,23,34,798.12,1487.00,0.00
2024-12-08 14:53:41,58,1470,23,35,784.36,1487.02,0.00
2024-12-08 14:53:41,57,1470,23,34,795.51,1487.02,0.00
2024-12-08 14:53:41,57,1471,23,34,797.09,1488.00,0.00
2024-12-08 14:53:41,58,1471,24,34,783.34,1488.02,0.00
2024-12-08 14:53:41,57,1471,23,34,773.88,1488.93,0.00
2024-12-08 14:53:41,57,1472,23,34,799.01,1489.00,0.00
2024-12-08 14:53:41,58,1472,24,34,785.23,1489.02,0.00
2024-12-08 14:53:41,57,1472,24,33,796.65,1489.02,0.00
2024-12-08 14:53:41,57,1473,24,33,798.24,1490.00,0.00
2024-12-08 14:53:41,58,1473,25,33,784.47,1490.02,0.00
2024-12-08 14:53:41,58,1474,25,33,781.28,1491.00,0.00
2024-12-08 14:53:41,59,1474,25,34,768.04,1491.02,0.00
2024-12-08 14:53:41,58,1474,25,33,779.22,1491.02,0.00
2024-12-08 14:53:41,58,1475,25,33,780.52,1492.00,0.00
2024-12-08 14:53:41,59,1475,25,34,767.29,1492.02,0.00
2024-12-08 14:53:41,58,1475,24,34,773.85,1492.12,0.00
2024-12-08 14:53:41,57,1475,23,34,777.27,1492.74,0.00
2024-12-08 14:53:41,57,1476,23,34,799.71,1493.00,0.00
2024-12-08 14:53:41,58,1476,23,35,785.92,1493.02,0.00
2024-12-08 14:53:41,57,1476,23,34,797.88,1493.02,0.00
2024-12-08 14:53:41,56,1476,22,34,799.02,1493.75,0.00
2024-12-08 14:53:41,56,1477,22,34,822.14,1494.00,0.00
2024-12-08 14:53:41,57,1477,23,34,807.72,1494.02,0.00
2024-12-08 14:53:41,57,1478,23,34,804.81,1495.00,0.00
2024-12-08 14:53:41,58,1478,23,35,790.93,1495.02,0.00
2024-12-08 14:53:41,57,1478,23,34,802.19,1495.02,0.00
2024-12-08 14:53:41,57,1479,23,34,803.77,1496.00,0.00
2024-12-08 14:53:41,58,1479,23,35,789.91,1496.02,0.00
2024-12-08 14:53:41,58,1480,23,35,786.77,1497.00,0.00
2024-12-08 14:53:41,59,1480,23,36,773.43,1497.02,0.00
2024-12-08 14:53:41,58,1480,23,35,784.45,1497.02,0.00
2024-12-08 14:53:41,57,1480,22,35,779.07,1497.97,0.00
2024-12-08 14:53:41,57,1481,22,35,804.85,1498.00,0.00
2024-12-08 14:53:41,58,1481,23,35,790.97,1498.02,0.00
2024-12-08 14:53:41,57,1481,22,35,786.36,1498.47,0.00
2024-12-08 14:53:41,57,1482,22,35,805.12,1499.00,0.00
2024-12-08 14:53:41,58,1482,23,35,791.24,1499.02,0.00
2024-12-08 14:53:41,57,1482,23,34,803.02,1499.02,0.00
2024-12-08 14:53:41,57,1483,23,34,804.61,1500.00,0.00
2024-12-08 14:53:41,58,1483,24,34,790.73,1500.02,0.00
2024-12-08 14:53:41,57,1483,23,34,798.04,1500.11,0.00
2024-12-08 14:53:41,57,1484,23,34,801.47,1501.00,0.00
2024-12-08 14:53:41,58,1484,23,35,787.66,1501.02,0.00
2024-12-08 14:53:41,57,1484,23,34,799.63,1501.02,0.00
2024-12-08 14:53:41,57,1485,23,34,801.22,1502.00,0.00
2024-12-08 14:53:41,58,1485,24,34,787.40,1502.02,0.00
2024-12-08 14:53:41,57,1485,23,34,794.13,1502.12,0.00
2024-12-08 14:53:41,57,1486,23,34,807.82,1503.00,0.00
2024-12-08 14:53:41,58,1486,23,35,793.89,1503.02,0.00
2024-12-08 14:53:41,57,1486,23,34,806.23,1503.02,0.00
2024-12-08 14:53:41,56,1486,22,34,818.13,1503.11,0.00
2024-12-08 14:53:41,56,1487,22,34,832.07,1504.00,0.00
2024-12-08 14:53:41,57,1487,23,34,817.47,1504.02,0.00
2024-12-08 14:53:41,57,1488,23,34,814.11,1505.00,0.00
2024-12-08 14:53:41,58,1488,24,34,800.07,1505.02,0.00
2024-12-08 14:53:41,57,1488,24,33,812.00,1505.02,0.00
2024-12-08 14:53:41,56,1488,23,33,817.94,1505.30,0.00
2024-12-08 14:53:42,56,1489,23,33,834.79,1506.00,0.00
2024-12-08 14:53:42,57,1489,23,34,820.15,1506.02,0.00
2024-12-08 14:53:42,57,1490,23,34,816.74,1507.00,0.00
2024-12-08 14:53:42,58,1490,23,35,802.65,1507.02,0.00
2024-12-08 14:53:42,57,1490,23,34,814.88,1507.02,0.00
2024-12-08 14:53:42,56,1490,22,34,828.12,1507.11,0.00
2024-12-08 14:53:42,55,1490,21,34,835.61,1507.62,0.00
2024-12-08 14:53:42,55,1491,21,34,846.58,1508.00,0.00
2024-12-08 14:53:42,56,1491,22,34,831.46,1508.02,0.00
2024-12-08 14:53:42,55,1491,21,34,822.14,1508.96,0.00
2024-12-08 14:53:42,55,1492,21,34,849.05,1509.00,0.00
2024-12-08 14:53:42,56,1492,22,34,833.89,1509.02,0.00
2024-12-08 14:53:42,55,1492,22,33,847.40,1509.02,0.00
2024-12-08 14:53:42,55,1493,22,33,849.61,1510.00,0.00
2024-12-08 14:53:42,56,1493,23,33,834.44,1510.02,0.00
2024-12-08 14:53:42,55,1493,22,33,841.38,1510.02,0.00
2024-12-08 14:53:42,55,1494,22,33,849.08,1511.00,0.00
2024-12-08 14:53:42,56,1494,22,34,833.91,1511.02,0.00
2024-12-08 14:53:42,55,1494,22,33,846.05,1511.02,0.00
2024-12-08 14:53:42,55,1495,22,33,848.26,1512.00,0.00
2024-12-08 14:53:42,56,1495,23,33,833.12,1512.02,0.00
2024-12-08 14:53:42,55,1495,22,33,828.55,1512.80,0.00
2024-12-08 14:53:42,55,1496,22,33,853.19,1513.00,0.00
2024-12-08 14:53:42,56,1496,23,33,837.96,1513.02,0.00
2024-12-08 14:53:42,55,1496,23,32,849.89,1513.02,0.00
2024-12-08 14:53:42,55,1497,23,32,852.11,1514.00,0.00
2024-12-08 14:53:42,56,1497,24,32,836.89,1514.02,0.00
2024-12-08 14:53:42,56,1498,24,32,834.01,1515.00,0.00
2024-12-08 14:53:42,57,1498,25,32,819.38,1515.02,0.00
2024-12-08 14:53:42,56,1498,25,31,831.04,1515.02,0.00
2024-12-08 14:53:42,56,1499,25,31,832.94,1516.00,0.00
2024-12-08 14:53:42,57,1499,25,32,818.32,1516.02,0.00
2024-12-08 14:53:42,57,1500,25,32,815.45,1517.00,0.00
2024-12-08 14:53:42,58,1500,25,33,801.39,1517.02,0.00
2024-12-08 14:53:42,57,1500,25,32,812.52,1517.02,0.00
2024-12-08 14:53:42,56,1500,24,32,826.00,1517.07,0.00
2024-12-08 14:53:42,55,1500,23,32,828.79,1517.73,0.00
2024-12-08 14:53:42,55,1501,23,32,852.46,1518.00,0.00
2024-12-08 14:53:42,56,1501,23,33,837.24,1518.02,0.00
2024-12-08 14:53:42,56,1502,23,33,834.18,1519.00,0.00
2024-12-08 14:53:42,57,1502,23,34,819.54,1519.02,0.00
2024-12-08 14:53:42,56,1502,23,33,831.46,1519.02,0.00
2024-12-08 14:53:42,55,1502,22,33,831.62,1519.82,0.00
2024-12-08 14:53:42,55,1503,22,33,856.62,1520.00,0.00
2024-12-08 14:53:42,56,1503,22,34,841.32,1520.02,0.00
2024-12-08 14:53:42,55,1503,21,34,849.84,1520.07,0.00
2024-12-08 14:53:42,55,1504,21,34,863.94,1521.00,0.00
2024-12-08 14:53:42,56,1504,22,34,848.51,1521.02,0.00
2024-12-08 14:53:42,55,1504,22,33,861.45,1521.02,0.00
2024-12-08 14:53:42,55,1505,22,33,863.67,1522.00,0.00
2024-12-08 14:53:42,56,1505,22,34,848.25,1522.02,0.00
2024-12-08 14:53:42,57,1504,23,34,804.51,1522.93,0.00
2024-12-08 14:53:42,57,1505,23,34,831.30,1523.00,0.00
2024-12-08 14:53:42,58,1505,24,34,816.96,1523.02,0.00
2024-12-08 14:53:42,57,1505,24,33,829.16,1523.02,0.00
2024-12-08 14:53:42,56,1505,23,33,833.36,1523.70,0.00
2024-12-08 14:53:42,56,1506,23,33,883.38,1524.00,0.00
2024-12-08 14:53:42,57,1506,23,34,867.89,1524.02,0.00
2024-12-08 14:53:42,57,1507,23,34,864.61,1525.00,0.00
2024-12-08 14:53:42,58,1507,23,35,849.70,1525.02,0.00
2024-12-08 14:53:42,57,1507,23,34,861.93,1525.02,0.00
2024-12-08 14:53:42,57,1508,23,34,863.57,1526.00,0.00
2024-12-08 14:53:42,58,1508,24,34,848.68,1526.02,0.00
2024-12-08 14:53:42,57,1508,23,34,839.04,1526.97,0.00
2024-12-08 14:53:42,57,1509,23,34,865.31,1527.00,0.00
2024-12-08 14:53:42,58,1509,24,34,850.39,1527.02,0.00
2024-12-08 14:53:42,57,1509,24,33,862.63,1527.02,0.00
2024-12-08 14:53:42,56,1509,23,33,876.44,1527.13,0.00
2024-12-08 14:53:42,56,1510,23,33,879.97,1528.00,0.00
2024-12-08 14:53:42,57,1510,23,34,864.53,1528.02,0.00
2024-12-08 14:53:42,56,1510,22,34,872.77,1528.13,0.00
2024-12-08 14:53:42,56,1511,22,34,876.52,1529.00,0.00
2024-12-08 14:53:42,57,1511,22,35,861.14,1529.02,0.00
2024-12-08 14:53:42,56,1511,22,34,874.06,1529.02,0.00
2024-12-08 14:53:42,56,1512,22,34,876.00,1530.00,0.00
2024-12-08 14:53:42,57,1512,23,34,860.63,1530.02,0.00
2024-12-08 14:53:42,56,1512,22,34,851.46,1530.96,0.00
2024-12-08 14:53:42,56,1513,22,34,878.27,1531.00,0.00
2024-12-08 14:53:42,57,1513,23,34,862.86,1531.02,0.00
2024-12-08 14:53:42,56,1513,23,33,875.54,1531.02,0.00
2024-12-08 14:53:42,56,1514,23,33,877.48,1532.00,0.00
2024-12-08 14:53:42,57,1514,24,33,862.08,1532.02,0.00
2024-12-08 14:53:43,57,1515,24,33,858.49,1533.00,0.00
2024-12-08 14:53:43,58,1515,24,34,843.69,1533.02,0.00
2024-12-08 14:53:43,57,1515,24,33,856.07,1533.02,0.00
2024-12-08 14:53:43,56,1515,23,33,869.76,1533.13,0.00
2024-12-08 14:53:43,56,1516,23,33,873.30,1534.00,0.00
2024-12-08 14:53:43,57,1516,23,34,857.98,1534.02,0.00
2024-12-08 14:53:43,56,1516,22,34,854.03,1534.48,0.00
2024-12-08 14:53:43,56,1517,22,34,873.87,1535.00,0.00
2024-12-08 14:53:43,57,1517,22,35,858.54,1535.02,0.00
2024-12-08 14:53:43,56,1517,22,34,871.40,1535.02,0.00
2024-12-08 14:53:43,55,1517,21,34,867.71,1535.62,0.00
2024-12-08 14:53:43,55,1518,21,34,890.06,1536.00,0.00
2024-12-08 14:53:43,56,1518,21,35,874.16,1536.02,0.00
2024-12-08 14:53:43,56,1519,21,35,870.61,1537.00,0.00
2024-12-08 14:53:43,57,1519,21,36,855.34,1537.02,0.00
2024-12-08 14:53:43,56,1519,21,35,868.42,1537.02,0.00
2024-12-08 14:53:43,55,1519,20,35,883.65,1537.02,0.00
2024-12-08 14:53:43,55,1520,20,35,897.09,1538.00,0.00
2024-12-08 14:53:43,56,1520,20,36,881.07,1538.02,0.00
2024-12-08 14:53:43,56,1521,20,36,877.90,1539.00,0.00
2024-12-08 14:53:43,57,1521,21,36,862.50,1539.02,0.00
2024-12-08 14:53:43,56,1521,21,35,874.87,1539.02,0.00
2024-12-08 14:53:43,55,1521,20,35,889.02,1539.11,0.00
2024-12-08 14:53:43,55,1522,20,35,903.85,1540.00,0.00
2024-12-08 14:53:43,56,1522,21,35,887.71,1540.02,0.00
2024-12-08 14:53:43,56,1523,21,35,884.40,1541.00,0.00
2024-12-08 14:53:43,57,1523,21,36,868.88,1541.02,0.00
2024-12-08 14:53:43,56,1523,21,35,881.64,1541.02,0.00
2024-12-08 14:53:43,56,1524,21,35,883.59,1542.00,0.00
2024-12-08 14:53:43,57,1524,21,36,868.09,1542.02,0.00
2024-12-08 14:53:43,56,1524,20,36,877.09,1542.07,0.00
2024-12-08 14:53:43,56,1525,20,36,880.04,1543.00,0.00
2024-12-08 14:53:43,57,1525,21,36,864.60,1543.02,0.00
2024-12-08 14:53:43,56,1525,21,35,877.56,1543.02,0.00
2024-12-08 14:53:43,55,1525,20,35,892.14,1543.11,0.00
2024-12-08 14:53:43,54,1525,19,35,891.03,1543.94,0.00
2024-12-08 14:53:43,54,1526,19,35,918.79,1544.00,0.00
2024-12-08 14:53:43,55,1526,19,36,902.09,1544.02,0.00
2024-12-08 14:53:43,54,1526,18,36,910.22,1544.02,0.00
2024-12-08 14:53:43,54,1527,18,36,918.53,1545.00,0.00
2024-12-08 14:53:43,55,1527,19,36,901.83,1545.02,0.00
2024-12-08 14:53:43,54,1527,19,35,915.38,1545.02,0.00
2024-12-08 14:53:43,53,1527,18,35,921.30,1545.06,0.00
2024-12-08 14:53:43,53,1528,18,35,936.47,1546.00,0.00
2024-12-08 14:53:43,54,1528,18,36,919.13,1546.02,0.00
2024-12-08 14:53:43,53,1528,17,36,926.92,1546.13,0.00
2024-12-08 14:53:43,53,1529,17,36,943.25,1547.00,0.00
2024-12-08 14:53:43,54,1529,18,36,925.78,1547.02,0.00
2024-12-08 14:53:43,53,1529,18,35,939.45,1547.02,0.00
2024-12-08 14:53:43,52,1529,17,35,955.76,1547.10,0.00
2024-12-08 14:53:43,52,1530,17,35,972.13,1548.00,0.00
2024-12-08 14:53:43,53,1530,18,35,953.79,1548.02,0.00
2024-12-08 14:53:43,53,1531,18,35,950.90,1549.00,0.00
2024-12-08 14:53:43,54,1531,18,36,933.29,1549.02,0.00
2024-12-08 14:53:43,53,1531,18,35,947.39,1549.02,0.00
2024-12-08 14:53:43,53,1532,18,35,950.34,1550.00,0.00
2024-12-08 14:53:43,54,1532,18,36,932.74,1550.02,0.00
2024-12-08 14:53:43,54,1533,18,36,929.70,1551.00,0.00
2024-12-08 14:53:43,55,1533,19,36,912.80,1551.02,0.00
2024-12-08 14:53:43,54,1533,19,35,925.39,1551.02,0.00
2024-12-08 14:53:43,53,1533,18,35,942.28,1551.06,0.00
2024-12-08 14:53:43,53,1534,18,35,945.81,1552.00,0.00
2024-12-08 14:53:43,54,1534,18,36,928.29,1552.02,0.00
2024-12-08 14:53:43,54,1535,18,36,925.15,1553.00,0.00
2024-12-08 14:53:43,55,1535,19,36,908.33,1553.02,0.00
2024-12-08 14:53:43,54,1535,19,35,921.12,1553.02,0.00
2024-12-08 14:53:43,54,1536,19,35,923.73,1554.00,0.00
2024-12-08 14:53:43,55,1536,20,35,906.94,1554.02,0.00
2024-12-08 14:53:43,54,1536,19,35,898.68,1554.96,0.00
2024-12-08 14:53:43,54,1537,19,35,926.92,1555.00,0.00
2024-12-08 14:53:43,55,1537,19,36,910.06,1555.02,0.00
2024-12-08 14:53:43,54,1537,19,35,923.17,1555.02,0.00
2024-12-08 14:53:43,54,1538,19,35,925.78,1556.00,0.00
2024-12-08 14:53:43,55,1538,19,36,908.95,1556.02,0.00
2024-12-08 14:53:43,55,1539,19,36,906.04,1557.00,0.00
2024-12-08 14:53:43,56,1539,19,37,889.86,1557.02,0.00
2024-12-08 14:53:43,55,1539,19,36,901.79,1557.02,0.00
2024-12-08 14:53:43,54,1539,18,36,902.34,1557.85,0.00
2024-12-08 14:53:43,54,1540,18,36,928.99,1558.00,0.00
2024-12-08 14:53:43,55,1540,19,36,912.10,1558.02,0.00
2024-12-08 14:53:43,55,1541,19,36,909.10,1559.00,0.00
2024-12-08 14:53:43,56,1541,20,36,892.87,1559.02,0.00
2024-12-08 14:53:43,55,1541,20,35,905.14,1559.02,0.00
2024-12-08 14:53:44,55,1542,20,35,907.42,1560.00,0.00
2024-12-08 14:53:44,56,1542,20,36,891.21,1560.02,0.00
2024-12-08 14:53:44,55,1542,19,36,888.45,1560.78,0.00
2024-12-08 14:53:44,55,1543,19,36,913.59,1561.00,0.00
2024-12-08 14:53:44,56,1543,20,36,897.27,1561.02,0.00
2024-12-08 14:53:44,55,1543,20,35,909.90,1561.02,0.00
2024-12-08 14:53:44,55,1544,20,35,912.18,1562.00,0.00
2024-12-08 14:53:44,56,1544,20,36,895.89,1562.02,0.00
2024-12-08 14:53:44,56,1545,20,36,892.68,1563.00,0.00
2024-12-08 14:53:44,57,1545,21,36,877.02,1563.02,0.00
2024-12-08 14:53:44,56,1545,21,35,889.06,1563.02,0.00
2024-12-08 14:53:44,55,1545,20,35,891.85,1563.76,0.00
2024-12-08 14:53:44,55,1546,20,35,916.76,1564.00,0.00
2024-12-08 14:53:44,56,1546,21,35,900.39,1564.02,0.00
2024-12-08 14:53:44,57,1545,21,36,867.45,1564.83,0.00
2024-12-08 14:53:44,57,1546,21,36,884.36,1565.00,0.00
2024-12-08 14:53:44,58,1546,21,37,869.12,1565.02,0.00
2024-12-08 14:53:44,57,1546,21,36,881.07,1565.02,0.00
2024-12-08 14:53:44,57,1547,21,36,910.20,1566.00,0.00
2024-12-08 14:53:44,58,1547,21,37,894.51,1566.02,0.00
2024-12-08 14:53:44,58,1548,21,37,890.68,1567.00,0.00
2024-12-08 14:53:44,59,1548,21,38,875.59,1567.02,0.00
2024-12-08 14:53:44,58,1548,21,37,887.71,1567.02,0.00
2024-12-08 14:53:44,57,1548,20,37,884.10,1567.95,0.00
2024-12-08 14:53:44,57,1549,20,37,910.82,1568.00,0.00
2024-12-08 14:53:44,58,1549,21,37,895.11,1568.02,0.00
2024-12-08 14:53:44,58,1550,21,37,891.84,1569.00,0.00
2024-12-08 14:53:44,59,1550,22,37,876.73,1569.02,0.00
2024-12-08 14:53:44,58,1550,22,36,888.33,1569.02,0.00
2024-12-08 14:53:44,58,1551,22,36,889.71,1570.00,0.00
2024-12-08 14:53:44,59,1551,23,36,874.63,1570.02,0.00
2024-12-08 14:53:44,58,1551,22,36,874.40,1570.36,0.00
2024-12-08 14:53:44,58,1552,22,36,891.90,1571.00,0.00
2024-12-08 14:53:44,59,1552,23,36,876.78,1571.02,0.00
2024-12-08 14:53:44,58,1552,23,35,888.11,1571.03,0.00
2024-12-08 14:53:44,57,1552,22,35,902.88,1571.09,0.00
2024-12-08 14:53:44,57,1553,22,35,905.64,1572.00,0.00
2024-12-08 14:53:44,58,1553,22,36,890.03,1572.02,0.00
2024-12-08 14:53:44,58,1554,22,36,886.99,1573.00,0.00
2024-12-08 14:53:44,59,1554,23,36,871.95,1573.02,0.00
2024-12-08 14:53:44,58,1554,23,35,882.92,1573.03,0.00
2024-12-08 14:53:44,57,1554,22,35,897.95,1573.05,0.00
2024-12-08 14:53:44,57,1555,22,35,911.21,1574.00,0.00
2024-12-08 14:53:44,58,1555,22,36,895.50,1574.02,0.00
2024-12-08 14:53:44,57,1555,21,36,895.05,1574.37,0.00
2024-12-08 14:53:44,57,1556,21,36,913.17,1575.00,0.00
2024-12-08 14:53:44,58,1556,21,37,897.43,1575.02,0.00
2024-12-08 14:53:44,57,1556,21,36,909.31,1575.04,0.00
2024-12-08 14:53:44,56,1556,20,36,925.00,1575.07,0.00
2024-12-08 14:53:44,55,1556,19,36,937.97,1575.18,0.00
2024-12-08 14:53:44,55,1557,19,36,954.27,1576.00,0.00
2024-12-08 14:53:44,56,1557,19,37,937.23,1576.02,0.00
2024-12-08 14:53:44,55,1557,18,37,946.53,1576.02,0.00
2024-12-08 14:53:44,54,1557,17,37,949.09,1576.61,0.00
2024-12-08 14:53:44,54,1558,17,37,972.45,1577.00,0.00
2024-12-08 14:53:44,55,1558,17,38,954.77,1577.02,0.00
2024-12-08 14:53:44,54,1558,17,37,968.07,1577.02,0.00
2024-12-08 14:53:44,53,1558,16,37,985.51,1577.04,0.00
2024-12-08 14:53:44,53,1559,16,37,1000.72,1578.00,0.00
2024-12-08 14:53:44,54,1559,17,37,982.19,1578.02,0.00
2024-12-08 14:53:44,54,1560,17,37,979.21,1579.00,0.00
2024-12-08 14:53:44,55,1560,17,38,961.40,1579.02,0.00
2024-12-08 14:53:44,54,1560,17,37,973.66,1579.04,0.00
2024-12-08 14:53:44,54,1561,17,37,976.61,1580.00,0.00
2024-12-08 14:53:44,55,1561,17,38,958.85,1580.02,0.00
2024-12-08 14:53:44,55,1562,17,38,956.89,1581.00,0.00
2024-12-08 14:53:44,56,1562,17,39,939.80,1581.02,0.00
2024-12-08 14:53:44,55,1562,16,39,947.42,1581.13,0.00
2024-12-08 14:53:44,55,1563,16,39,962.94,1582.00,0.00
2024-12-08 14:53:44,56,1563,16,40,945.74,1582.02,0.00
2024-12-08 14:53:44,55,1563,16,39,962.37,1582.04,0.00
2024-12-08 14:53:44,55,1564,16,39,964.99,1583.00,0.00
2024-12-08 14:53:44,56,1564,16,40,947.76,1583.02,0.00
2024-12-08 14:53:44,56,1565,16,40,944.43,1584.00,0.00
2024-12-08 14:53:44,57,1565,17,40,927.86,1584.02,0.00
2024-12-08 14:53:44,56,1565,17,39,939.91,1584.04,0.00
2024-12-08 14:53:44,56,1566,17,39,942.20,1585.00,0.00
2024-12-08 14:53:44,57,1566,17,40,925.67,1585.02,0.00
2024-12-08 14:53:44,57,1567,17,40,922.43,1586.00,0.00
2024-12-08 14:53:44,58,1567,18,40,906.53,1586.02,0.00
2024-12-08 14:53:44,57,1567,18,39,918.26,1586.04,0.00
2024-12-08 14:53:45,57,1568,18,39,920.23,1587.00,0.00
2024-12-08 14:53:45,58,1568,19,39,904.36,1587.02,0.00
2024-12-08 14:53:45,58,1569,19,39,901.16,1588.00,0.00
2024-12-08 14:53:45,59,1569,20,39,885.89,1588.02,0.00
2024-12-08 14:53:45,58,1569,20,38,897.33,1588.03,0.00
2024-12-08 14:53:45,58,1570,20,38,898.99,1589.00,0.00
2024-12-08 14:53:45,59,1570,21,38,883.75,1589.02,0.00
2024-12-08 14:53:45,58,1570,20,38,891.35,1589.12,0.00
2024-12-08 14:53:45,58,1571,20,38,905.31,1590.00,0.00
2024-12-08 14:53:45,59,1571,21,38,889.97,1590.02,0.00
2024-12-08 14:53:45,58,1571,21,37,901.48,1590.03,0.00
2024-12-08 14:53:45,58,1572,21,37,903.14,1591.00,0.00
2024-12-08 14:53:45,59,1572,21,38,887.83,1591.02,0.00
2024-12-08 14:53:45,59,1573,21,38,884.45,1592.00,0.00
2024-12-08 14:53:45,60,1573,21,39,869.71,1592.02,0.00
2024-12-08 14:53:45,59,1573,21,38,880.67,1592.03,0.00
2024-12-08 14:53:45,58,1573,20,38,876.76,1592.93,0.00
2024-12-08 14:53:45,58,1574,20,38,903.17,1593.00,0.00
2024-12-08 14:53:45,59,1574,20,39,887.87,1593.02,0.00
2024-12-08 14:53:45,58,1574,19,39,887.79,1593.66,0.00
2024-12-08 14:53:45,58,1575,19,39,899.93,1594.00,0.00
2024-12-08 14:53:45,59,1575,19,40,884.68,1594.02,0.00
2024-12-08 14:53:45,58,1575,19,39,896.36,1594.03,0.00
2024-12-08 14:53:45,58,1576,19,39,898.02,1595.00,0.00
2024-12-08 14:53:45,59,1576,19,40,882.80,1595.02,0.00
2024-12-08 14:53:45,59,1577,19,40,879.62,1596.00,0.00
2024-12-08 14:53:45,60,1577,20,40,864.96,1596.02,0.00
2024-12-08 14:53:45,59,1577,20,39,875.83,1596.03,0.00
2024-12-08 14:53:45,58,1577,19,39,890.61,1596.05,0.00
2024-12-08 14:53:45,57,1577,18,39,897.20,1596.63,0.00
2024-12-08 14:53:45,57,1578,18,39,919.61,1597.00,0.00
2024-12-08 14:53:45,58,1578,18,40,903.75,1597.02,0.00
2024-12-08 14:53:45,58,1579,18,40,900.33,1598.00,0.00
2024-12-08 14:53:45,59,1579,18,41,885.07,1598.02,0.00
2024-12-08 14:53:45,58,1579,18,40,896.75,1598.03,0.00
2024-12-08 14:53:45,58,1580,18,40,898.42,1599.00,0.00
2024-12-08 14:53:45,59,1580,19,40,883.19,1599.02,0.00
2024-12-08 14:53:45,58,1580,18,40,882.74,1599.67,0.00
2024-12-08 14:53:45,58,1581,18,40,895.62,1600.00,0.00
2024-12-08 14:53:45,59,1581,18,41,880.44,1600.02,0.00
2024-12-08 14:53:45,58,1581,18,40,891.48,1600.03,0.00
2024-12-08 14:53:45,58,1582,18,40,893.14,1601.00,0.00
2024-12-08 14:53:45,59,1582,19,40,878.00,1601.02,0.00
2024-12-08 14:53:45,58,1582,18,40,885.99,1601.12,0.00
2024-12-08 14:53:45,57,1582,17,40,886.94,1601.53,0.00
2024-12-08 14:53:45,57,1583,17,40,907.78,1602.00,0.00
2024-12-08 14:53:45,58,1583,18,40,892.13,1602.02,0.00
2024-12-08 14:53:45,57,1583,18,39,903.85,1602.04,0.00
2024-12-08 14:53:45,57,1584,18,39,905.82,1603.00,0.00
2024-12-08 14:53:45,58,1584,18,40,890.20,1603.02,0.00
2024-12-08 14:53:45,58,1585,18,40,886.76,1604.00,0.00
2024-12-08 14:53:45,59,1585,19,40,871.73,1604.02,0.00
2024-12-08 14:53:45,58,1585,19,39,883.17,1604.03,0.00
2024-12-08 14:53:45,57,1585,18,39,878.49,1604.97,0.00
2024-12-08 14:53:45,57,1586,18,39,906.10,1605.00,0.00
2024-12-08 14:53:45,58,1586,19,39,890.48,1605.02,0.00
2024-12-08 14:53:45,58,1587,19,39,887.01,1606.00,0.00
2024-12-08 14:53:45,59,1587,20,39,871.98,1606.02,0.00
2024-12-08 14:53:45,58,1587,20,38,883.69,1606.03,0.00
2024-12-08 14:53:45,57,1587,19,38,897.96,1606.11,0.00
2024-12-08 14:53:45,57,1588,19,38,901.03,1607.00,0.00
2024-12-08 14:53:45,58,1588,20,38,885.50,1607.02,0.00
2024-12-08 14:53:45,58,1589,20,38,881.93,1608.00,0.00
2024-12-08 14:53:45,59,1589,21,38,866.98,1608.02,0.00
2024-12-08 14:53:45,58,1589,21,37,878.88,1608.03,0.00
2024-12-08 14:53:45,58,1590,21,37,880.53,1609.00,0.00
2024-12-08 14:53:45,59,1590,21,38,865.61,1609.02,0.00
2024-12-08 14:53:45,59,1591,21,38,861.96,1610.00,0.00
2024-12-08 14:53:45,60,1591,22,38,847.59,1610.02,0.00
2024-12-08 14:53:45,59,1591,22,37,859.23,1610.03,0.00
2024-12-08 14:53:45,59,1592,22,37,860.58,1611.00,0.00
2024-12-08 14:53:45,60,1592,23,37,846.24,1611.02,0.00
2024-12-08 14:53:45,59,1592,22,37,834.69,1611.97,0.00
2024-12-08 14:53:45,59,1593,22,37,861.48,1612.00,0.00
2024-12-08 14:53:45,60,1593,23,37,847.13,1612.02,0.00
2024-12-08 14:53:45,59,1593,23,36,858.48,1612.03,0.00
2024-12-08 14:53:45,58,1593,22,36,863.76,1612.64,0.00
2024-12-08 14:53:45,58,1594,22,36,874.86,1613.00,0.00
2024-12-08 14:53:45,59,1594,23,36,860.03,1613.02,0.00
2024-12-08 14:53:45,58,1594,22,36,874.58,1613.02,0.00
2024-12-08 14:53:45,57,1594,21,36,875.45,1613.58,0.00
2024-12-08 14:53:45,57,1595,21,36,886.76,1614.00,0.00
2024-12-08 14:53:45,58,1595,22,36,871.47,1614.02,0.00
2024-12-08 14:53:45,57,1595,22,35,884.21,1614.02,0.00
2024-12-08 14:53:45,57,1596,22,35,885.89,1615.00,0.00
2024-12-08 14:53:45,58,1596,23,35,870.62,1615.02,0.00
2024-12-08 14:53:45,57,1596,22,35,876.03,1615.19,0.00
2024-12-08 14:53:46,57,1597,22,35,891.83,1616.00,0.00
2024-12-08 14:53:46,58,1597,22,36,876.45,1616.02,0.00
2024-12-08 14:53:46,57,1597,22,35,889.27,1616.02,0.00
2024-12-08 14:53:46,57,1598,22,35,890.96,1617.00,0.00
2024-12-08 14:53:46,58,1598,23,35,875.60,1617.02,0.00
2024-12-08 14:53:46,57,1598,22,35,879.66,1617.23,0.00
2024-12-08 14:53:46,57,1599,22,35,896.03,1618.00,0.00
2024-12-08 14:53:46,58,1599,23,35,880.58,1618.02,0.00
2024-12-08 14:53:46,57,1599,23,34,893.47,1618.02,0.00
2024-12-08 14:53:46,57,1600,23,34,895.16,1619.00,0.00
2024-12-08 14:53:46,58,1600,24,34,879.73,1619.02,0.00
2024-12-08 14:53:46,57,1600,23,34,876.40,1619.14,0.00
2024-12-08 14:53:46,57,1601,23,34,891.40,1620.00,0.00
2024-12-08 14:53:46,58,1601,23,35,876.03,1620.02,0.00
2024-12-08 14:53:46,57,1601,23,34,888.56,1620.02,0.00
2024-12-08 14:53:46,57,1602,23,34,890.24,1621.00,0.00
2024-12-08 14:53:46,58,1602,24,34,874.89,1621.02,0.00
2024-12-08 14:53:46,58,1603,24,34,870.78,1622.00,0.00
2024-12-08 14:53:46,59,1603,24,35,856.02,1622.02,0.00
2024-12-08 14:53:46,58,1603,24,34,868.27,1622.02,0.00
2024-12-08 14:53:46,57,1603,23,34,881.72,1622.12,0.00
2024-12-08 14:53:46,57,1604,23,34,885.08,1623.00,0.00
2024-12-08 14:53:46,58,1604,24,34,869.82,1623.02,0.00
2024-12-08 14:53:46,57,1604,23,34,878.29,1623.04,0.00
2024-12-08 14:53:46,57,1605,23,34,891.66,1624.00,0.00
2024-12-08 14:53:46,58,1605,23,35,876.28,1624.02,0.00
2024-12-08 14:53:46,57,1605,23,34,889.09,1624.02,0.00
2024-12-08 14:53:46,57,1606,23,34,890.78,1625.00,0.00
2024-12-08 14:53:46,58,1606,23,35,875.42,1625.02,0.00
2024-12-08 14:53:46,58,1607,23,35,871.49,1626.00,0.00
2024-12-08 14:53:46,59,1607,24,35,856.72,1626.02,0.00
2024-12-08 14:53:46,58,1607,24,34,868.68,1626.02,0.00
2024-12-08 14:53:46,57,1607,23,34,868.06,1626.83,0.00
2024-12-08 14:53:46,57,1608,23,34,893.87,1627.00,0.00
2024-12-08 14:53:46,58,1608,23,35,878.46,1627.02,0.00
2024-12-08 14:53:46,58,1609,23,35,874.73,1628.00,0.00
2024-12-08 14:53:46,59,1609,23,36,859.90,1628.02,0.00
2024-12-08 14:53:46,58,1609,23,35,871.65,1628.03,0.00
2024-12-08 14:53:46,57,1609,22,35,877.20,1628.65,0.00
2024-12-08 14:53:46,56,1609,21,35,883.52,1628.93,0.00
2024-12-08 14:53:46,56,1610,21,35,911.50,1629.00,0.00
2024-12-08 14:53:46,57,1610,21,36,895.51,1629.02,0.00
2024-12-08 14:53:46,56,1610,20,36,903.68,1629.14,0.00
2024-12-08 14:53:46,56,1611,20,36,908.26,1630.00,0.00
2024-12-08 14:53:46,57,1611,21,36,892.33,1630.02,0.00
2024-12-08 14:53:46,56,1611,21,35,904.77,1630.04,0.00
2024-12-08 14:53:46,55,1611,20,35,906.22,1630.80,0.00
2024-12-08 14:53:46,55,1612,20,35,932.77,1631.00,0.00
2024-12-08 14:53:46,56,1612,21,35,916.11,1631.02,0.00
2024-12-08 14:53:46,55,1612,20,35,925.09,1631.13,0.00
2024-12-08 14:53:46,55,1613,20,35,929.51,1632.00,0.00
2024-12-08 14:53:46,56,1613,20,36,912.91,1632.02,0.00
2024-12-08 14:53:46,55,1613,20,35,925.95,1632.04,0.00
2024-12-08 14:53:46,55,1614,20,35,928.59,1633.00,0.00
2024-12-08 14:53:46,56,1614,20,36,912.01,1633.02,0.00
2024-12-08 14:53:46,55,1614,19,36,908.17,1633.78,0.00
2024-12-08 14:53:46,55,1615,19,36,934.48,1634.00,0.00
2024-12-08 14:53:46,56,1615,20,36,917.80,1634.02,0.00
2024-12-08 14:53:46,55,1615,20,35,930.92,1634.04,0.00
2024-12-08 14:53:46,55,1616,20,35,933.57,1635.00,0.00
2024-12-08 14:53:46,56,1616,21,35,916.90,1635.02,0.00
2024-12-08 14:53:46,55,1616,20,35,907.93,1635.95,0.00
2024-12-08 14:53:46,55,1617,20,35,936.82,1636.00,0.00
2024-12-08 14:53:46,56,1617,20,36,920.09,1636.02,0.00
2024-12-08 14:53:46,55,1617,20,35,933.55,1636.04,0.00
2024-12-08 14:53:46,55,1618,20,35,936.20,1637.00,0.00
2024-12-08 14:53:46,56,1618,21,35,919.48,1637.02,0.00
2024-12-08 14:53:46,56,1619,21,35,915.65,1638.00,0.00
2024-12-08 14:53:46,57,1619,21,36,899.59,1638.02,0.00
2024-12-08 14:53:46,56,1619,21,35,912.73,1638.04,0.00
2024-12-08 14:53:46,56,1620,21,35,915.04,1639.00,0.00
2024-12-08 14:53:46,57,1620,22,35,898.99,1639.02,0.00
2024-12-08 14:53:46,57,1621,22,35,895.02,1640.00,0.00
2024-12-08 14:53:46,58,1621,22,36,879.59,1640.02,0.00
2024-12-08 14:53:46,57,1621,22,35,892.44,1640.04,0.00
2024-12-08 14:53:46,57,1622,22,35,894.42,1641.00,0.00
2024-12-08 14:53:46,58,1622,22,36,879.00,1641.02,0.00
2024-12-08 14:53:46,57,1622,21,36,876.72,1641.42,0.00
2024-12-08 14:53:46,57,1623,21,36,896.40,1642.00,0.00
2024-12-08 14:53:46,58,1623,22,36,880.95,1642.02,0.00
2024-12-08 14:53:46,57,1623,22,35,892.95,1642.04,0.00
2024-12-08 14:53:46,56,1623,21,35,902.81,1642.25,0.00
2024-12-08 14:53:46,56,1624,21,35,920.30,1643.00,0.00
2024-12-08 14:53:46,57,1624,21,36,904.15,1643.02,0.00
2024-12-08 14:53:46,57,1625,21,36,900.92,1644.00,0.00
2024-12-08 14:53:46,58,1625,21,37,885.38,1644.02,0.00
2024-12-08 14:53:46,57,1625,21,36,897.46,1644.04,0.00
2024-12-08 14:53:47,57,1626,21,36,899.45,1645.00,0.00
2024-12-08 14:53:47,58,1626,22,36,883.94,1645.02,0.00
2024-12-08 14:53:47,57,1626,21,36,872.58,1645.97,0.00
2024-12-08 14:53:47,57,1626,21,36,900.90,1646.00,0.00
2024-12-08 14:53:47,58,1626,21,37,885.36,1646.02,0.00
2024-12-08 14:53:47,57,1626,21,36,897.72,1646.04,0.00
2024-12-08 14:53:47,57,1627,21,36,899.71,1647.00,0.00
2024-12-08 14:53:47,58,1627,22,36,884.20,1647.02,0.00
2024-12-08 14:53:47,58,1628,22,36,880.66,1648.00,0.00
2024-12-08 14:53:47,59,1628,22,37,865.74,1648.02,0.00
2024-12-08 14:53:47,58,1628,22,36,877.82,1648.03,0.00
2024-12-08 14:53:47,58,1629,22,36,879.49,1649.00,0.00
2024-12-08 14:53:47,59,1629,22,37,864.58,1649.02,0.00
2024-12-08 14:53:47,59,1630,22,37,860.96,1650.00,0.00
2024-12-08 14:53:47,60,1630,22,38,846.61,1650.02,0.00
2024-12-08 14:53:47,59,1630,22,37,858.44,1650.03,0.00
2024-12-08 14:53:47,58,1630,21,37,871.29,1650.16,0.00
2024-12-08 14:53:47,57,1630,20,37,867.60,1650.97,0.00
2024-12-08 14:53:47,57,1631,20,37,896.01,1651.00,0.00
2024-12-08 14:53:47,58,1631,20,38,880.56,1651.02,0.00
2024-12-08 14:53:47,57,1631,19,38,881.14,1651.32,0.00
2024-12-08 14:53:47,57,1632,19,38,899.25,1652.00,0.00
2024-12-08 14:53:47,58,1632,20,38,883.75,1652.02,0.00
2024-12-08 14:53:47,57,1632,20,37,896.65,1652.04,0.00
2024-12-08 14:53:47,56,1632,19,37,907.26,1652.23,0.00
2024-12-08 14:53:47,56,1633,19,37,924.56,1653.00,0.00
2024-12-08 14:53:47,57,1633,20,37,908.34,1653.02,0.00
2024-12-08 14:53:47,57,1634,20,37,904.51,1654.00,0.00
2024-12-08 14:53:47,58,1634,20,38,888.91,1654.02,0.00
2024-12-08 14:53:47,57,1634,20,37,902.19,1654.04,0.00
2024-12-08 14:53:47,57,1635,20,37,904.18,1655.00,0.00
2024-12-08 14:53:47,58,1635,21,37,888.59,1655.02,0.00
2024-12-08 14:53:47,57,1635,20,37,875.66,1655.70,0.00
2024-12-08 14:53:47,57,1636,20,37,899.99,1656.00,0.00
2024-12-08 14:53:47,58,1636,20,38,884.47,1656.02,0.00
2024-12-08 14:53:47,57,1636,20,37,899.70,1656.02,0.00
2024-12-08 14:53:47,56,1636,20,36,913.99,1656.02,0.00
2024-12-08 14:53:47,55,1636,19,36,923.87,1656.26,0.00
2024-12-08 14:53:47,55,1637,19,36,942.11,1657.00,0.00
2024-12-08 14:53:47,56,1637,20,36,925.29,1657.02,0.00
2024-12-08 14:53:47,56,1638,20,36,921.41,1658.00,0.00
2024-12-08 14:53:47,57,1638,21,36,905.24,1658.02,0.00
2024-12-08 14:53:47,56,1638,21,35,919.93,1658.02,0.00
2024-12-08 14:53:47,55,1638,20,35,926.02,1658.67,0.00
2024-12-08 14:53:47,55,1639,20,35,938.93,1659.00,0.00
2024-12-08 14:53:47,56,1639,20,36,922.17,1659.02,0.00
2024-12-08 14:53:47,56,1640,20,36,918.28,1660.00,0.00
2024-12-08 14:53:47,57,1640,20,37,902.17,1660.02,0.00
2024-12-08 14:53:47,56,1640,20,36,917.09,1660.02,0.00
2024-12-08 14:53:47,55,1640,19,36,919.96,1660.76,0.00
2024-12-08 14:53:47,55,1641,19,36,946.41,1661.00,0.00
2024-12-08 14:53:47,56,1641,20,36,929.51,1661.02,0.00
2024-12-08 14:53:47,55,1641,19,36,932.22,1661.04,0.00
2024-12-08 14:53:47,55,1642,19,36,946.98,1662.00,0.00
2024-12-08 14:53:47,56,1642,19,37,930.07,1662.02,0.00
2024-12-08 14:53:47,55,1642,19,36,945.77,1662.02,0.00
2024-12-08 14:53:47,55,1643,19,36,948.15,1663.00,0.00
2024-12-08 14:53:47,56,1643,19,37,931.22,1663.02,0.00
2024-12-08 14:53:47,56,1644,19,37,927.40,1664.00,0.00
2024-12-08 14:53:47,57,1644,20,37,911.13,1664.02,0.00
2024-12-08 14:53:47,56,1644,20,36,925.02,1664.02,0.00
2024-12-08 14:53:47,56,1645,20,36,927.06,1665.00,0.00
2024-12-08 14:53:47,57,1645,20,37,910.80,1665.02,0.00
2024-12-08 14:53:47,57,1646,20,37,906.96,1666.00,0.00
2024-12-08 14:53:47,58,1646,21,37,891.33,1666.02,0.00
2024-12-08 14:53:47,57,1646,21,36,904.92,1666.02,0.00
2024-12-08 14:53:47,57,1647,21,36,906.63,1667.00,0.00
2024-12-08 14:53:47,58,1647,21,37,891.00,1667.02,0.00
2024-12-08 14:53:47,58,1648,21,37,887.06,1668.00,0.00
2024-12-08 14:53:47,59,1648,22,37,872.03,1668.02,0.00
2024-12-08 14:53:47,58,1648,22,36,885.34,1668.02,0.00
2024-12-08 14:53:47,57,1648,21,36,898.86,1668.14,0.00
2024-12-08 14:53:47,57,1649,21,36,902.58,1669.00,0.00
2024-12-08 14:53:47,58,1649,21,37,887.02,1669.02,0.00
2024-12-08 14:53:47,57,1649,20,37,875.72,1669.97,0.00
2024-12-08 14:53:47,57,1650,20,37,904.45,1670.00,0.00
2024-12-08 14:53:47,58,1650,20,38,888.86,1670.02,0.00
2024-12-08 14:53:47,57,1650,20,37,902.99,1670.02,0.00
2024-12-08 14:53:47,56,1650,19,37,899.62,1670.93,0.00
2024-12-08 14:53:47,56,1651,19,37,928.31,1671.00,0.00
2024-12-08 14:53:47,57,1651,19,38,912.03,1671.02,0.00
2024-12-08 14:53:47,56,1651,18,38,910.18,1671.71,0.00
2024-12-08 14:53:47,56,1652,18,38,935.47,1672.00,0.00
2024-12-08 14:53:47,57,1652,19,38,919.06,1672.02,0.00
2024-12-08 14:53:47,56,1652,19,37,934.27,1672.02,0.00
2024-12-08 14:53:47,55,1652,18,37,949.17,1672.15,0.00
2024-12-08 14:53:48,54,1652,17,37,955.85,1672.74,0.00
2024-12-08 14:53:48,54,1653,17,37,982.70,1673.00,0.00
2024-12-08 14:53:48,55,1653,18,37,964.83,1673.02,0.00
2024-12-08 14:53:48,55,1654,18,37,961.15,1674.00,0.00
2024-12-08 14:53:48,56,1654,19,37,943.99,1674.02,0.00
2024-12-08 14:53:48,55,1654,19,36,959.93,1674.02,0.00
2024-12-08 14:53:48,54,1654,18,36,975.57,1674.15,0.00
2024-12-08 14:53:48,54,1655,18,36,980.46,1675.00,0.00
2024-12-08 14:53:48,55,1655,18,37,962.64,1675.02,0.00
2024-12-08 14:53:48,54,1655,17,37,972.15,1675.13,0.00
2024-12-08 14:53:48,54,1656,17,37,976.74,1676.00,0.00
2024-12-08 14:53:48,55,1656,18,37,958.98,1676.02,0.00
2024-12-08 14:53:48,54,1656,18,36,975.80,1676.02,0.00
2024-12-08 14:53:48,53,1656,17,36,973.90,1676.94,0.00
2024-12-08 14:53:48,53,1657,17,36,1004.62,1677.00,0.00
2024-12-08 14:53:48,54,1657,17,37,986.01,1677.02,0.00
2024-12-08 14:53:48,54,1658,17,37,982.56,1678.00,0.00
2024-12-08 14:53:48,55,1658,17,38,964.70,1678.02,0.00
2024-12-08 14:53:48,54,1658,17,37,981.63,1678.02,0.00
2024-12-08 14:53:48,54,1659,17,37,984.39,1679.00,0.00
2024-12-08 14:53:48,55,1659,17,38,966.49,1679.02,0.00
2024-12-08 14:53:48,54,1659,16,38,955.48,1679.67,0.00
2024-12-08 14:53:48,54,1660,16,38,981.24,1680.00,0.00
2024-12-08 14:53:48,55,1660,16,39,963.40,1680.02,0.00
2024-12-08 14:53:48,54,1660,16,38,980.00,1680.02,0.00
2024-12-08 14:53:48,54,1661,16,38,982.76,1681.00,0.00
2024-12-08 14:53:48,55,1661,17,38,964.89,1681.02,0.00
2024-12-08 14:53:48,54,1661,16,38,965.03,1681.07,0.00
2024-12-08 14:53:48,54,1662,16,38,981.17,1682.00,0.00
2024-12-08 14:53:48,55,1662,16,39,963.33,1682.02,0.00
2024-12-08 14:53:48,54,1662,16,38,978.37,1682.04,0.00
2024-12-08 14:53:48,53,1662,15,38,995.58,1682.11,0.00
2024-12-08 14:53:48,53,1663,15,38,1000.27,1683.00,0.00
2024-12-08 14:53:48,54,1663,16,38,981.75,1683.02,0.00
2024-12-08 14:53:48,54,1664,16,38,978.41,1684.00,0.00
2024-12-08 14:53:48,55,1664,17,38,960.62,1684.02,0.00
2024-12-08 14:53:48,54,1664,17,37,973.74,1684.06,0.00
2024-12-08 14:53:48,53,1664,16,37,986.96,1684.23,0.00
2024-12-08 14:53:48,53,1665,16,37,1006.23,1685.00,0.00
2024-12-08 14:53:48,54,1665,17,37,987.60,1685.02,0.00
2024-12-08 14:53:48,53,1665,16,37,990.13,1685.32,0.00
2024-12-08 14:53:48,53,1666,16,37,1010.96,1686.00,0.00
2024-12-08 14:53:48,54,1666,16,38,992.24,1686.02,0.00
2024-12-08 14:53:48,53,1666,16,37,1005.25,1686.08,0.00
2024-12-08 14:53:48,53,1667,16,37,1009.34,1687.00,0.00
2024-12-08 14:53:48,54,1667,17,37,990.64,1687.02,0.00
2024-12-08 14:53:48,54,1668,17,37,987.76,1688.00,0.00
2024-12-08 14:53:48,55,1668,18,37,969.80,1688.02,0.00
2024-12-08 14:53:48,54,1668,18,36,982.15,1688.07,0.00
2024-12-08 14:53:48,54,1669,18,36,985.84,1689.00,0.00
2024-12-08 14:53:48,55,1669,18,37,967.92,1689.02,0.00
2024-12-08 14:53:48,55,1670,18,37,965.01,1690.00,0.00
2024-12-08 14:53:48,56,1670,18,38,947.77,1690.02,0.00
2024-12-08 14:53:48,55,1670,18,37,959.49,1690.07,0.00
2024-12-08 14:53:48,55,1671,18,37,962.81,1691.00,0.00
2024-12-08 14:53:48,56,1671,18,38,945.62,1691.02,0.00
2024-12-08 14:53:48,56,1672,18,38,942.66,1692.00,0.00
2024-12-08 14:53:48,57,1672,19,38,926.12,1692.02,0.00
2024-12-08 14:53:48,56,1672,19,37,937.53,1692.07,0.00
2024-12-08 14:53:48,55,1672,18,37,934.67,1692.93,0.00
2024-12-08 14:53:48,55,1673,18,37,964.26,1693.00,0.00
2024-12-08 14:53:48,56,1673,19,37,947.04,1693.02,0.00
2024-12-08 14:53:48,56,1674,19,37,944.26,1694.00,0.00
2024-12-08 14:53:48,57,1674,20,37,927.70,1694.02,0.00
2024-12-08 14:53:48,56,1674,20,36,938.83,1694.09,0.00
2024-12-08 14:53:48,55,1674,19,36,946.05,1694.67,0.00
2024-12-08 14:53:48,55,1675,19,36,959.23,1695.00,0.00
2024-12-08 14:53:48,56,1675,19,37,942.10,1695.02,0.00
2024-12-08 14:53:48,56,1676,19,37,939.14,1696.00,0.00
2024-12-08 14:53:48,57,1676,20,37,922.66,1696.02,0.00
2024-12-08 14:53:48,56,1676,20,36,934.00,1696.09,0.00
2024-12-08 14:53:48,55,1676,19,36,930.10,1696.96,0.00
2024-12-08 14:53:48,55,1677,19,36,960.36,1697.00,0.00
2024-12-08 14:53:48,56,1677,20,36,943.21,1697.02,0.00
2024-12-08 14:53:48,55,1677,19,36,952.96,1697.06,0.00
2024-12-08 14:53:48,55,1678,19,36,962.16,1698.00,0.00
2024-12-08 14:53:48,56,1678,20,36,944.98,1698.02,0.00
2024-12-08 14:53:48,55,1678,20,35,957.54,1698.07,0.00
2024-12-08 14:53:48,55,1679,20,35,960.87,1699.00,0.00
2024-12-08 14:53:48,56,1679,21,35,943.71,1699.02,0.00
2024-12-08 14:53:48,55,1679,20,35,942.04,1699.11,0.00
2024-12-08 14:53:48,55,1680,20,35,958.35,1700.00,0.00
2024-12-08 14:53:48,56,1680,21,35,941.23,1700.02,0.00
2024-12-08 14:53:48,55,1680,21,34,953.41,1700.07,0.00
2024-12-08 14:53:49,55,1681,21,34,956.75,1701.00,0.00
2024-12-08 14:53:49,56,1681,22,34,939.66,1701.02,0.00
2024-12-08 14:53:49,56,1682,22,34,936.73,1702.00,0.00
2024-12-08 14:53:49,57,1682,22,35,920.30,1702.02,0.00
2024-12-08 14:53:49,56,1682,22,34,932.18,1702.07,0.00
2024-12-08 14:53:49,56,1683,22,34,935.16,1703.00,0.00
2024-12-08 14:53:49,57,1683,23,34,918.75,1703.02,0.00
2024-12-08 14:53:49,56,1683,22,34,915.14,1703.73,0.00
2024-12-08 14:53:49,56,1684,22,34,941.19,1704.00,0.00
2024-12-08 14:53:49,57,1684,23,34,924.68,1704.02,0.00
2024-12-08 14:53:49,56,1684,23,33,936.33,1704.07,0.00
2024-12-08 14:53:49,56,1685,23,33,939.31,1705.00,0.00
2024-12-08 14:53:49,57,1685,24,33,922.83,1705.02,0.00
2024-12-08 14:53:49,57,1686,24,33,919.98,1706.00,0.00
2024-12-08 14:53:49,58,1686,25,33,904.12,1706.02,0.00
2024-12-08 14:53:49,57,1686,24,33,919.68,1706.02,0.00
2024-12-08 14:53:49,56,1686,24,32,931.54,1706.05,0.00
2024-12-08 14:53:49,56,1687,24,32,934.22,1707.00,0.00
2024-12-08 14:53:49,57,1687,24,33,917.83,1707.02,0.00
2024-12-08 14:53:49,57,1688,24,33,915.06,1708.00,0.00
2024-12-08 14:53:49,58,1688,24,34,899.28,1708.02,0.00
2024-12-08 14:53:49,57,1688,24,33,910.57,1708.05,0.00
2024-12-08 14:53:49,57,1689,24,33,912.89,1709.00,0.00
2024-12-08 14:53:49,58,1689,24,34,897.16,1709.02,0.00
2024-12-08 14:53:49,57,1689,23,34,892.08,1709.46,0.00
2024-12-08 14:53:49,57,1690,23,34,913.13,1710.00,0.00
2024-12-08 14:53:49,58,1690,24,34,897.39,1710.02,0.00
2024-12-08 14:53:49,57,1690,23,34,912.83,1710.02,0.00
2024-12-08 14:53:49,56,1690,23,33,925.16,1710.04,0.00
2024-12-08 14:53:49,56,1691,23,33,927.53,1711.00,0.00
2024-12-08 14:53:49,57,1691,24,33,911.26,1711.02,0.00
2024-12-08 14:53:49,56,1691,23,33,913.86,1711.27,0.00
2024-12-08 14:53:49,55,1691,22,33,924.56,1711.62,0.00
2024-12-08 14:53:49,55,1692,22,33,949.41,1712.00,0.00
2024-12-08 14:53:49,56,1692,22,34,932.46,1712.02,0.00
2024-12-08 14:53:49,55,1692,22,33,945.37,1712.04,0.00
2024-12-08 14:53:49,55,1693,22,33,948.10,1713.00,0.00
2024-12-08 14:53:49,56,1693,22,34,931.17,1713.02,0.00
2024-12-08 14:53:49,55,1693,21,34,931.70,1713.33,0.00
2024-12-08 14:53:49,55,1694,21,34,951.77,1714.00,0.00
2024-12-08 14:53:49,56,1694,21,35,934.77,1714.02,0.00
2024-12-08 14:53:49,55,1694,21,34,948.03,1714.04,0.00
2024-12-08 14:53:49,54,1694,20,34,964.03,1714.13,0.00
2024-12-08 14:53:49,54,1695,20,34,968.69,1715.00,0.00
2024-12-08 14:53:49,55,1695,20,35,951.08,1715.02,0.00
2024-12-08 14:53:49,54,1695,19,35,941.57,1715.94,0.00
2024-12-08 14:53:49,54,1696,19,35,972.43,1716.00,0.00
2024-12-08 14:53:49,55,1696,20,35,954.75,1716.02,0.00
2024-12-08 14:53:49,54,1696,20,34,968.62,1716.04,0.00
2024-12-08 14:53:49,54,1697,20,34,971.73,1717.00,0.00
2024-12-08 14:53:49,55,1697,20,35,954.06,1717.02,0.00
2024-12-08 14:53:49,54,1697,19,35,962.54,1717.15,0.00
2024-12-08 14:53:49,54,1698,19,35,980.25,1718.00,0.00
2024-12-08 14:53:49,55,1698,20,35,962.43,1718.02,0.00
2024-12-08 14:53:49,54,1698,20,34,976.43,1718.04,0.00
2024-12-08 14:53:49,54,1699,20,34,979.55,1719.00,0.00
2024-12-08 14:53:49,55,1699,21,34,961.74,1719.02,0.00
2024-12-08 14:53:49,55,1700,21,34,958.35,1720.00,0.00
2024-12-08 14:53:49,56,1700,21,35,941.24,1720.02,0.00
2024-12-08 14:53:49,55,1700,21,34,954.91,1720.04,0.00
2024-12-08 14:53:49,55,1701,21,34,957.66,1721.00,0.00
2024-12-08 14:53:49,56,1701,22,34,940.56,1721.02,0.00
2024-12-08 14:53:49,56,1702,22,34,936.86,1722.00,0.00
2024-12-08 14:53:49,57,1702,23,34,920.42,1722.02,0.00
2024-12-08 14:53:49,56,1702,23,33,933.78,1722.04,0.00
2024-12-08 14:53:49,56,1703,23,33,936.17,1723.00,0.00
2024-12-08 14:53:49,57,1703,23,34,919.75,1723.02,0.00
2024-12-08 14:53:49,57,1704,23,34,915.97,1724.00,0.00
2024-12-08 14:53:49,58,1704,24,34,900.18,1724.02,0.00
2024-12-08 14:53:49,57,1704,24,33,913.25,1724.04,0.00
2024-12-08 14:53:49,56,1704,23,33,907.98,1724.96,0.00
2024-12-08 14:53:49,56,1705,23,33,938.18,1725.00,0.00
2024-12-08 14:53:49,57,1705,23,34,921.72,1725.02,0.00
2024-12-08 14:53:49,56,1705,22,34,921.90,1725.61,0.00
2024-12-08 14:53:49,56,1706,22,34,934.84,1726.00,0.00
2024-12-08 14:53:49,57,1706,23,34,918.44,1726.02,0.00
2024-12-08 14:53:49,56,1706,22,34,934.54,1726.02,0.00
2024-12-08 14:53:49,55,1706,22,33,948.70,1726.02,0.00
2024-12-08 14:53:49,54,1706,21,33,945.94,1726.91,0.00
2024-12-08 14:53:49,54,1706,21,33,976.39,1727.00,0.00
2024-12-08 14:53:49,55,1706,21,34,958.64,1727.02,0.00
2024-12-08 14:53:49,55,1707,21,34,955.21,1728.00,0.00
2024-12-08 14:53:49,56,1707,21,35,938.15,1728.02,0.00
2024-12-08 14:53:49,55,1707,21,34,952.38,1728.02,0.00
2024-12-08 14:53:49,55,1708,21,34,954.82,1729.00,0.00
2024-12-08 14:53:49,56,1708,21,35,937.77,1729.02,0.00
2024-12-08 14:53:49,56,1709,21,35,934.71,1730.00,0.00
2024-12-08 14:53:49,57,1709,21,36,918.32,1730.02,0.00
2024-12-08 14:53:50,56,1709,21,35,931.62,1730.02,0.00
2024-12-08 14:53:50,55,1709,20,35,935.56,1730.71,0.00
2024-12-08 14:53:50,55,1710,20,35,962.22,1731.00,0.00
2024-12-08 14:53:50,56,1710,21,35,945.03,1731.02,0.00
2024-12-08 14:53:50,55,1710,20,35,945.19,1731.64,0.00
2024-12-08 14:53:50,54,1710,19,35,956.55,1731.82,0.00
2024-12-08 14:53:50,54,1711,19,35,985.56,1732.00,0.00
2024-12-08 14:53:50,55,1711,19,36,967.64,1732.02,0.00
2024-12-08 14:53:50,54,1711,19,35,982.67,1732.02,0.00
2024-12-08 14:53:50,54,1712,19,35,985.48,1733.00,0.00
2024-12-08 14:53:50,55,1712,19,36,967.57,1733.02,0.00
2024-12-08 14:53:50,55,1713,19,36,964.14,1734.00,0.00
2024-12-08 14:53:50,56,1713,20,36,946.92,1734.02,0.00
2024-12-08 14:53:50,55,1713,20,35,961.30,1734.02,0.00
2024-12-08 14:53:50,54,1713,19,35,957.04,1734.96,0.00
2024-12-08 14:53:50,54,1714,19,35,988.55,1735.00,0.00
2024-12-08 14:53:50,55,1714,20,35,970.58,1735.02,0.00
2024-12-08 14:53:50,55,1715,20,35,967.07,1736.00,0.00
2024-12-08 14:53:50,56,1715,21,35,949.80,1736.02,0.00
2024-12-08 14:53:50,55,1715,21,34,964.55,1736.02,0.00
2024-12-08 14:53:50,54,1715,20,34,980.20,1736.13,0.00
2024-12-08 14:53:50,54,1716,20,34,984.91,1737.00,0.00
2024-12-08 14:53:50,55,1716,21,34,967.00,1737.02,0.00
2024-12-08 14:53:50,55,1717,21,34,963.48,1738.00,0.00
2024-12-08 14:53:50,56,1717,21,35,946.28,1738.02,0.00
2024-12-08 14:53:50,55,1717,21,34,960.96,1738.02,0.00
2024-12-08 14:53:50,55,1718,21,34,963.41,1739.00,0.00
2024-12-08 14:53:50,56,1718,22,34,946.20,1739.02,0.00
2024-12-08 14:53:50,56,1719,22,34,942.58,1740.00,0.00
2024-12-08 14:53:50,57,1719,22,35,926.05,1740.02,0.00
2024-12-08 14:53:50,56,1719,22,34,940.10,1740.02,0.00
2024-12-08 14:53:50,56,1720,22,34,942.19,1741.00,0.00
2024-12-08 14:53:50,57,1720,23,34,925.66,1741.02,0.00
2024-12-08 14:53:50,57,1721,23,34,922.15,1742.00,0.00
2024-12-08 14:53:50,58,1721,24,34,906.25,1742.02,0.00
2024-12-08 14:53:50,57,1721,24,33,919.71,1742.02,0.00
2024-12-08 14:53:50,56,1721,23,33,934.00,1742.14,0.00
2024-12-08 14:53:50,56,1722,23,33,938.22,1743.00,0.00
2024-12-08 14:53:50,57,1722,23,34,921.76,1743.02,0.00
2024-12-08 14:53:50,57,1723,23,34,918.25,1744.00,0.00
2024-12-08 14:53:50,58,1723,24,34,902.42,1744.02,0.00
2024-12-08 14:53:50,57,1723,24,33,916.11,1744.02,0.00
2024-12-08 14:53:50,56,1723,23,33,921.76,1744.64,0.00
2024-12-08 14:53:50,56,1724,23,33,934.47,1745.00,0.00
2024-12-08 14:53:50,57,1724,24,33,918.07,1745.02,0.00
2024-12-08 14:53:50,57,1725,24,33,914.37,1746.00,0.00
2024-12-08 14:53:50,58,1725,24,34,898.61,1746.02,0.00
2024-12-08 14:53:50,57,1725,24,33,912.54,1746.02,0.00
2024-12-08 14:53:50,56,1725,23,33,926.41,1746.14,0.00
2024-12-08 14:53:50,56,1726,23,33,930.64,1747.00,0.00
2024-12-08 14:53:50,57,1726,23,34,914.32,1747.02,0.00
2024-12-08 14:53:50,56,1726,22,34,908.54,1747.79,0.00
2024-12-08 14:53:50,56,1727,22,34,936.13,1748.00,0.00
2024-12-08 14:53:50,57,1727,23,34,919.70,1748.02,0.00
2024-12-08 14:53:50,56,1727,23,33,933.63,1748.02,0.00
2024-12-08 14:53:50,56,1728,23,33,935.73,1749.00,0.00
2024-12-08 14:53:50,57,1728,24,33,919.31,1749.02,0.00
2024-12-08 14:53:50,56,1728,23,33,912.09,1749.84,0.00
2024-12-08 14:53:50,56,1729,23,33,940.64,1750.00,0.00
2024-12-08 14:53:50,57,1729,24,33,924.13,1750.02,0.00
2024-12-08 14:53:50,56,1729,24,32,938.14,1750.02,0.00
2024-12-08 14:53:50,56,1730,24,32,940.24,1751.00,0.00
2024-12-08 14:53:50,57,1730,24,33,923.74,1751.02,0.00
2024-12-08 14:53:50,57,1731,24,33,920.15,1752.00,0.00
2024-12-08 14:53:50,58,1731,24,34,904.29,1752.02,0.00
2024-12-08 14:53:50,57,1731,24,33,918.00,1752.02,0.00
2024-12-08 14:53:50,57,1732,24,33,919.75,1753.00,0.00
2024-12-08 14:53:50,58,1732,25,33,903.90,1753.02,0.00
2024-12-08 14:53:50,58,1733,25,33,900.24,1754.00,0.00
2024-12-08 14:53:50,59,1733,26,33,884.98,1754.02,0.00
2024-12-08 14:53:50,58,1733,26,32,898.43,1754.02,0.00
2024-12-08 14:53:50,58,1734,26,32,899.85,1755.00,0.00
2024-12-08 14:53:50,59,1734,26,33,884.59,1755.02,0.00
2024-12-08 14:53:50,59,1735,26,33,880.84,1756.00,0.00
2024-12-08 14:53:50,60,1735,27,33,866.16,1756.02,0.00
2024-12-08 14:53:50,59,1735,27,32,879.35,1756.02,0.00
2024-12-08 14:53:50,59,1736,27,32,880.45,1757.00,0.00
2024-12-08 14:53:50,60,1736,27,33,865.77,1757.02,0.00
2024-12-08 14:53:51,60,1737,27,33,862.16,1758.00,0.00
2024-12-08 14:53:51,61,1737,27,34,848.02,1758.02,0.00
2024-12-08 14:53:51,60,1737,27,33,860.69,1758.02,0.00
2024-12-08 14:53:51,59,1737,26,33,873.36,1758.12,0.00
2024-12-08 14:53:51,58,1737,25,33,887.82,1758.16,0.00
2024-12-08 14:53:51,58,1738,25,33,891.62,1759.00,0.00
2024-12-08 14:53:51,59,1738,26,33,876.51,1759.02,0.00
2024-12-08 14:53:51,58,1738,25,33,864.35,1759.64,0.00
2024-12-08 14:53:51,58,1739,25,33,888.55,1760.00,0.00
2024-12-08 14:53:51,59,1739,26,33,873.49,1760.02,0.00
2024-12-08 14:53:51,58,1739,26,32,886.12,1760.03,0.00
2024-12-08 14:53:51,57,1739,25,32,899.55,1760.16,0.00
2024-12-08 14:53:51,56,1739,24,32,907.42,1760.63,0.00
2024-12-08 14:53:51,56,1740,24,32,919.93,1761.00,0.00
2024-12-08 14:53:51,57,1740,24,33,903.79,1761.02,0.00
2024-12-08 14:53:51,56,1740,23,33,912.70,1761.02,0.00
2024-12-08 14:53:51,55,1740,22,33,912.78,1761.60,0.00
2024-12-08 14:53:51,55,1741,22,33,938.02,1762.00,0.00
2024-12-08 14:53:51,56,1741,22,34,921.27,1762.02,0.00
2024-12-08 14:53:51,55,1741,22,33,935.46,1762.02,0.00
2024-12-08 14:53:51,54,1741,21,33,942.02,1762.06,0.00
2024-12-08 14:53:51,53,1741,20,33,958.82,1762.11,0.00
2024-12-08 14:53:51,53,1742,20,33,976.96,1763.00,0.00
2024-12-08 14:53:51,54,1742,20,34,958.87,1763.02,0.00
2024-12-08 14:53:51,53,1742,19,34,964.72,1763.17,0.00
2024-12-08 14:53:51,53,1743,19,34,983.87,1764.00,0.00
2024-12-08 14:53:51,54,1743,19,35,965.65,1764.02,0.00
2024-12-08 14:53:51,53,1743,19,34,981.54,1764.02,0.00
2024-12-08 14:53:51,52,1743,18,34,998.75,1764.12,0.00
2024-12-08 14:53:51,51,1743,17,34,1010.35,1764.57,0.00
2024-12-08 14:53:51,51,1744,17,34,1023.79,1765.00,0.00
2024-12-08 14:53:51,52,1744,17,35,1004.11,1765.02,0.00
2024-12-08 14:53:51,51,1744,16,35,1004.08,1765.08,0.00
2024-12-08 14:53:51,50,1744,15,35,1015.73,1765.56,0.00
2024-12-08 14:53:51,49,1744,14,35,1035.40,1765.61,0.00
2024-12-08 14:53:51,49,1745,14,35,1064.88,1766.00,0.00
2024-12-08 14:53:51,50,1745,15,35,1043.59,1766.02,0.00
2024-12-08 14:53:51,49,1745,15,34,1062.72,1766.02,0.00
2024-12-08 14:53:51,48,1745,14,34,1065.13,1766.88,0.00
2024-12-08 14:53:51,48,1746,14,34,1099.83,1767.00,0.00
2024-12-08 14:53:51,49,1746,15,34,1077.39,1767.02,0.00
2024-12-08 14:53:51,48,1746,14,34,1081.06,1767.04,0.00
2024-12-08 14:53:51,48,1747,14,34,1101.56,1768.00,0.00
2024-12-08 14:53:51,49,1747,14,35,1079.08,1768.02,0.00
2024-12-08 14:53:51,48,1747,14,34,1098.61,1768.02,0.00
2024-12-08 14:53:51,48,1748,14,34,1104.03,1769.00,0.00
2024-12-08 14:53:51,49,1748,15,34,1081.50,1769.02,0.00
2024-12-08 14:53:51,48,1748,14,34,1087.34,1769.54,0.00
2024-12-08 14:53:51,48,1749,14,34,1101.71,1770.00,0.00
2024-12-08 14:53:51,49,1749,15,34,1079.23,1770.02,0.00
2024-12-08 14:53:51,48,1749,15,33,1096.92,1770.02,0.00
2024-12-08 14:53:51,48,1750,15,33,1102.33,1771.00,0.00
2024-12-08 14:53:51,49,1750,15,34,1079.83,1771.02,0.00
2024-12-08 14:53:51,49,1751,15,34,1077.85,1772.00,0.00
2024-12-08 14:53:51,50,1751,15,35,1056.30,1772.02,0.00
2024-12-08 14:53:51,49,1751,15,34,1071.71,1772.04,0.00
2024-12-08 14:53:51,48,1751,14,34,1071.42,1772.96,0.00
2024-12-08 14:53:51,48,1752,14,34,1107.64,1773.00,0.00
2024-12-08 14:53:51,49,1752,14,35,1085.03,1773.02,0.00
2024-12-08 14:53:51,48,1752,13,35,1089.13,1773.65,0.00
2024-12-08 14:53:51,48,1753,13,35,1105.47,1774.00,0.00
2024-12-08 14:53:51,49,1753,14,35,1082.91,1774.02,0.00
2024-12-08 14:53:51,48,1753,14,34,1099.56,1774.04,0.00
2024-12-08 14:53:51,47,1753,13,34,1102.94,1774.89,0.00
2024-12-08 14:53:51,47,1754,13,34,1138.90,1775.00,0.00
2024-12-08 14:53:51,48,1754,13,35,1115.18,1775.02,0.00
2024-12-08 14:53:51,47,1754,12,35,1122.48,1775.23,0.00
2024-12-08 14:53:51,47,1755,12,35,1147.22,1776.00,0.00
2024-12-08 14:53:51,48,1755,13,35,1123.32,1776.02,0.00
2024-12-08 14:53:51,47,1755,13,34,1141.56,1776.04,0.00
2024-12-08 14:53:51,47,1756,13,34,1147.87,1777.00,0.00
2024-12-08 14:53:51,48,1756,14,34,1123.95,1777.02,0.00
2024-12-08 14:53:51,47,1756,13,34,1119.37,1777.51,0.00
2024-12-08 14:53:51,47,1757,13,34,1148.89,1778.00,0.00
2024-12-08 14:53:51,48,1757,14,34,1124.96,1778.02,0.00
2024-12-08 14:53:51,47,1757,14,33,1142.84,1778.04,0.00
2024-12-08 14:53:51,47,1758,14,33,1149.16,1779.00,0.00
2024-12-08 14:53:51,48,1758,14,34,1125.22,1779.02,0.00
2024-12-08 14:53:51,48,1759,14,34,1123.25,1780.00,0.00
2024-12-08 14:53:51,49,1759,14,35,1100.33,1780.02,0.00
2024-12-08 14:53:51,48,1759,14,34,1117.70,1780.04,0.00
2024-12-08 14:53:51,48,1760,14,34,1123.51,1781.00,0.00
2024-12-08 14:53:51,49,1760,14,35,1100.59,1781.02,0.00
2024-12-08 14:53:51,49,1761,14,35,1098.29,1782.00,0.00
2024-12-08 14:53:51,50,1761,14,36,1076.33,1782.02,0.00
2024-12-08 14:53:51,49,1761,14,35,1093.21,1782.04,0.00
2024-12-08 14:53:51,48,1761,13,35,1095.00,1782.92,0.00
2024-12-08 14:53:51,48,1762,13,35,1130.72,1783.00,0.00
2024-12-08 14:53:51,49,1762,14,35,1107.64,1783.02,0.00
2024-12-08 14:53:51,49,1763,14,35,1105.35,1784.00,0.00
2024-12-08 14:53:51,50,1763,14,36,1083.24,1784.02,0.00
2024-12-08 14:53:51,49,1763,14,35,1100.62,1784.04,0.00
2024-12-08 14:53:52,49,1764,14,35,1105.97,1785.00,0.00
2024-12-08 14:53:52,50,1764,14,36,1083.85,1785.02,0.00
2024-12-08 14:53:52,50,1765,14,36,1081.24,1786.00,0.00
2024-12-08 14:53:52,51,1765,14,37,1060.04,1786.02,0.00
2024-12-08 14:53:52,50,1765,14,36,1076.25,1786.06,0.00
2024-12-08 14:53:52,50,1766,14,36,1081.49,1787.00,0.00
2024-12-08 14:53:52,51,1766,14,37,1060.29,1787.02,0.00
2024-12-08 14:53:52,50,1766,13,37,1056.93,1787.82,0.00
2024-12-08 14:53:52,50,1767,13,37,1089.61,1788.00,0.00
2024-12-08 14:53:52,51,1767,13,38,1068.24,1788.02,0.00
2024-12-08 14:53:52,50,1767,12,38,1078.88,1788.04,0.00
2024-12-08 14:53:52,49,1767,12,37,1096.16,1788.04,0.00
2024-12-08 14:53:52,49,1768,12,37,1116.12,1789.00,0.00
2024-12-08 14:53:52,50,1768,13,37,1093.79,1789.02,0.00
2024-12-08 14:53:52,49,1768,12,37,1091.11,1789.45,0.00
2024-12-08 14:53:52,49,1769,12,37,1118.20,1790.00,0.00
2024-12-08 14:53:52,50,1769,13,37,1095.84,1790.02,0.00
2024-12-08 14:53:52,49,1769,13,36,1112.73,1790.04,0.00
2024-12-08 14:53:52,49,1770,13,36,1118.10,1791.00,0.00
2024-12-08 14:53:52,50,1770,14,36,1095.73,1791.02,0.00
2024-12-08 14:53:52,50,1771,14,36,1093.12,1792.00,0.00
2024-12-08 14:53:52,51,1771,15,36,1071.69,1792.02,0.00
2024-12-08 14:53:52,50,1771,15,35,1087.75,1792.04,0.00
2024-12-08 14:53:52,50,1772,15,35,1092.65,1793.00,0.00
2024-12-08 14:53:52,51,1772,16,35,1071.23,1793.02,0.00
2024-12-08 14:53:52,51,1773,16,35,1068.67,1794.00,0.00
2024-12-08 14:53:52,52,1773,16,36,1048.11,1794.02,0.00
2024-12-08 14:53:52,51,1773,16,35,1063.05,1794.06,0.00
2024-12-08 14:53:52,51,1774,16,35,1067.85,1795.00,0.00
2024-12-08 14:53:52,52,1774,17,35,1047.32,1795.02,0.00
2024-12-08 14:53:52,52,1775,17,35,1044.39,1796.00,0.00
2024-12-08 14:53:52,53,1775,17,36,1024.68,1796.02,0.00
2024-12-08 14:53:52,52,1775,17,35,1039.22,1796.06,0.00
2024-12-08 14:53:52,51,1775,16,35,1037.65,1796.94,0.00
2024-12-08 14:53:52,51,1776,16,35,1071.86,1797.00,0.00
2024-12-08 14:53:52,52,1776,17,35,1051.24,1797.02,0.00
2024-12-08 14:53:52,52,1777,17,35,1048.22,1798.00,0.00
2024-12-08 14:53:52,53,1777,17,36,1028.44,1798.02,0.00
2024-12-08 14:53:52,52,1777,17,35,1043.39,1798.06,0.00
2024-12-08 14:53:52,52,1778,17,35,1047.77,1799.00,0.00
2024-12-08 14:53:52,53,1778,18,35,1028.00,1799.02,0.00
2024-12-08 14:53:52,52,1778,17,35,1026.50,1799.73,0.00
2024-12-08 14:53:52,52,1779,17,35,1056.46,1800.00,0.00
2024-12-08 14:53:52,53,1779,18,35,1036.53,1800.02,0.00
2024-12-08 14:53:52,52,1779,18,34,1051.97,1800.06,0.00
2024-12-08 14:53:52,52,1780,18,34,1056.36,1801.00,0.00
2024-12-08 14:53:52,53,1780,18,35,1036.42,1801.02,0.00
2024-12-08 14:53:52,53,1781,18,35,1033.12,1802.00,0.00
2024-12-08 14:53:52,54,1781,19,35,1013.98,1802.02,0.00
2024-12-08 14:53:52,53,1781,19,34,1028.70,1802.06,0.00
2024-12-08 14:53:52,52,1781,18,34,1044.02,1802.17,0.00
2024-12-08 14:53:52,52,1782,18,34,1064.32,1803.00,0.00
2024-12-08 14:53:52,53,1782,18,35,1044.24,1803.02,0.00
2024-12-08 14:53:52,53,1783,18,35,1040.73,1804.00,0.00
2024-12-08 14:53:52,54,1783,19,35,1021.46,1804.02,0.00
2024-12-08 14:53:52,53,1783,18,35,1040.39,1804.02,0.00
2024-12-08 14:53:52,52,1783,18,34,1056.59,1804.04,0.00
2024-12-08 14:53:53,52,1784,18,34,1060.64,1805.00,0.00
2024-12-08 14:53:53,53,1784,19,34,1040.63,1805.02,0.00
2024-12-08 14:53:53,52,1784,18,34,1030.99,1805.96,0.00
2024-12-08 14:53:53,52,1785,18,34,1065.05,1806.00,0.00
2024-12-08 14:53:53,53,1785,19,34,1044.95,1806.02,0.00
2024-12-08 14:53:53,52,1785,19,33,1060.19,1806.04,0.00
2024-12-08 14:53:53,52,1786,19,33,1064.25,1807.00,0.00
2024-12-08 14:53:53,53,1786,19,34,1044.17,1807.02,0.00
2024-12-08 14:53:53,53,1787,19,34,1041.23,1808.00,0.00
2024-12-08 14:53:53,54,1787,19,35,1021.94,1808.02,0.00
2024-12-08 14:53:53,53,1787,19,34,1036.45,1808.04,0.00
2024-12-08 14:53:53,52,1787,18,34,1038.51,1808.83,0.00
2024-12-08 14:53:53,52,1788,18,34,1070.29,1809.00,0.00
2024-12-08 14:53:53,53,1788,19,34,1050.10,1809.02,0.00
2024-12-08 14:53:53,52,1788,18,34,1051.17,1809.69,0.00
2024-12-08 14:53:53,52,1789,18,34,1067.68,1810.00,0.00
2024-12-08 14:53:53,53,1789,18,35,1047.54,1810.02,0.00
2024-12-08 14:53:53,52,1789,18,34,1062.47,1810.04,0.00
2024-12-08 14:53:53,51,1789,17,34,1082.25,1810.08,0.00
2024-12-08 14:53:53,51,1790,17,34,1087.44,1811.00,0.00
2024-12-08 14:53:53,52,1790,18,34,1066.53,1811.02,0.00
2024-12-08 14:53:53,51,1790,17,34,1063.18,1811.80,0.00
2024-12-08 14:53:53,51,1791,17,34,1095.30,1812.00,0.00
2024-12-08 14:53:53,52,1791,17,35,1074.24,1812.02,0.00
2024-12-08 14:53:53,51,1791,17,34,1089.62,1812.04,0.00
2024-12-08 14:53:53,51,1792,17,34,1094.13,1813.00,0.00
2024-12-08 14:53:53,52,1792,17,35,1073.09,1813.02,0.00
2024-12-08 14:53:53,52,1793,17,35,1069.84,1814.00,0.00
2024-12-08 14:53:53,53,1793,18,35,1049.66,1814.02,0.00
2024-12-08 14:53:53,52,1793,18,34,1064.61,1814.04,0.00
2024-12-08 14:53:53,51,1793,17,34,1062.93,1814.96,0.00
2024-12-08 14:53:53,51,1794,17,34,1097.83,1815.00,0.00
2024-12-08 14:53:53,52,1794,17,35,1076.71,1815.02,0.00
2024-12-08 14:53:53,52,1795,17,35,1074.07,1816.00,0.00
2024-12-08 14:53:53,53,1795,17,36,1053.80,1816.02,0.00
2024-12-08 14:53:53,52,1795,17,35,1068.13,1816.04,0.00
2024-12-08 14:53:53,52,1796,17,35,1072.21,1817.00,0.00
2024-12-08 14:53:53,53,1796,18,35,1051.98,1817.02,0.00
2024-12-08 14:53:53,52,1796,17,35,1041.76,1817.96,0.00
2024-12-08 14:53:53,52,1797,17,35,1076.05,1818.00,0.00
2024-12-08 14:53:53,53,1797,17,36,1055.74,1818.02,0.00
2024-12-08 14:53:53,52,1797,17,35,1070.45,1818.04,0.00
2024-12-08 14:53:53,52,1798,17,35,1074.54,1819.00,0.00
2024-12-08 14:53:53,53,1798,18,35,1054.26,1819.02,0.00
2024-12-08 14:53:53,52,1798,17,35,1061.60,1819.04,0.00
2024-12-08 14:53:53,52,1799,17,35,1072.68,1820.00,0.00
2024-12-08 14:53:53,53,1799,17,36,1052.44,1820.02,0.00
2024-12-08 14:53:53,52,1799,17,35,1066.73,1820.04,0.00
2024-12-08 14:53:53,51,1799,16,35,1086.59,1820.08,0.00
2024-12-08 14:53:53,51,1800,16,35,1091.81,1821.00,0.00
2024-12-08 14:53:53,52,1800,17,35,1070.82,1821.02,0.00
2024-12-08 14:53:53,52,1801,17,35,1068.11,1822.00,0.00
2024-12-08 14:53:53,53,1801,17,36,1047.96,1822.02,0.00
2024-12-08 14:53:53,52,1801,17,35,1062.16,1822.04,0.00
2024-12-08 14:53:53,52,1802,17,35,1066.24,1823.00,0.00
2024-12-08 14:53:53,53,1802,17,36,1046.13,1823.02,0.00
2024-12-08 14:53:53,53,1803,17,36,1043.51,1824.00,0.00
2024-12-08 14:53:53,54,1803,18,36,1024.18,1824.02,0.00
2024-12-08 14:53:53,53,1803,18,35,1038.00,1824.04,0.00
2024-12-08 14:53:53,52,1803,17,35,1034.40,1824.96,0.00
2024-12-08 14:53:53,52,1804,17,35,1068.82,1825.00,0.00
2024-12-08 14:53:53,53,1804,17,36,1048.65,1825.02,0.00
2024-12-08 14:53:53,53,1805,17,36,1046.50,1826.00,0.00
2024-12-08 14:53:53,54,1805,17,37,1027.12,1826.02,0.00
2024-12-08 14:53:53,53,1805,16,37,1046.16,1826.02,0.00
2024-12-08 14:53:53,52,1805,16,36,1060.66,1826.02,0.00
2024-12-08 14:53:53,51,1805,15,36,1078.23,1826.10,0.00
2024-12-08 14:53:53,51,1806,15,36,1098.13,1827.00,0.00
2024-12-08 14:53:53,52,1806,15,37,1077.02,1827.02,0.00
2024-12-08 14:53:53,51,1806,14,37,1066.28,1827.65,0.00
2024-12-08 14:53:53,51,1807,14,37,1095.95,1828.00,0.00
2024-12-08 14:53:53,52,1807,15,37,1074.87,1828.02,0.00
2024-12-08 14:53:53,51,1807,14,37,1084.93,1828.12,0.00
2024-12-08 14:53:53,51,1808,14,37,1105.22,1829.00,0.00
2024-12-08 14:53:53,52,1808,14,38,1083.96,1829.02,0.00
2024-12-08 14:53:53,51,1808,14,37,1100.20,1829.02,0.00
2024-12-08 14:53:53,51,1809,14,37,1104.39,1830.00,0.00
2024-12-08 14:53:53,52,1809,14,38,1083.15,1830.02,0.00
2024-12-08 14:53:53,51,1809,14,37,1099.36,1830.02,0.00
2024-12-08 14:53:53,51,1810,14,37,1103.55,1831.00,0.00
2024-12-08 14:53:53,52,1810,15,37,1082.33,1831.02,0.00
2024-12-08 14:53:53,51,1810,14,37,1073.25,1831.96,0.00
2024-12-08 14:53:53,51,1811,14,37,1108.47,1832.00,0.00
2024-12-08 14:53:53,52,1811,15,37,1087.15,1832.02,0.00
2024-12-08 14:53:53,51,1811,15,36,1103.80,1832.02,0.00
2024-12-08 14:53:53,51,1812,15,36,1107.99,1833.00,0.00
2024-12-08 14:53:53,52,1812,16,36,1086.69,1833.02,0.00
2024-12-08 14:53:54,52,1813,16,36,1083.40,1834.00,0.00
2024-12-08 14:53:54,53,1813,16,37,1062.96,1834.02,0.00
2024-12-08 14:53:54,52,1813,16,36,1079.17,1834.02,0.00
2024-12-08 14:53:54,52,1814,16,36,1082.93,1835.00,0.00
2024-12-08 14:53:54,53,1814,16,37,1062.50,1835.02,0.00
2024-12-08 14:53:54,53,1815,16,37,1059.41,1836.00,0.00
2024-12-08 14:53:54,54,1815,16,38,1039.79,1836.02,0.00
2024-12-08 14:53:54,53,1815,16,37,1054.90,1836.02,0.00
2024-12-08 14:53:54,52,1815,15,37,1074.01,1836.08,0.00
2024-12-08 14:53:54,52,1816,15,37,1092.94,1837.00,0.00
2024-12-08 14:53:54,53,1816,15,38,1072.32,1837.02,0.00
2024-12-08 14:53:54,52,1816,14,38,1064.84,1837.90,0.00
2024-12-08 14:53:54,52,1817,14,38,1098.49,1838.00,0.00
2024-12-08 14:53:54,53,1817,14,39,1077.76,1838.02,0.00
2024-12-08 14:53:54,52,1817,14,38,1093.54,1838.02,0.00
2024-12-08 14:53:54,52,1818,14,38,1097.32,1839.00,0.00
2024-12-08 14:53:54,53,1818,15,38,1076.61,1839.02,0.00
2024-12-08 14:53:54,52,1818,14,38,1089.20,1839.08,0.00
2024-12-08 14:53:54,52,1819,14,38,1094.43,1840.00,0.00
2024-12-08 14:53:54,53,1819,14,39,1073.78,1840.02,0.00
2024-12-08 14:53:54,52,1819,14,38,1089.83,1840.02,0.00
2024-12-08 14:53:54,52,1820,14,38,1093.61,1841.00,0.00
2024-12-08 14:53:54,53,1820,14,39,1072.98,1841.02,0.00
2024-12-08 14:53:54,53,1821,14,39,1069.49,1842.00,0.00
2024-12-08 14:53:54,54,1821,15,39,1049.69,1842.02,0.00
2024-12-08 14:53:54,53,1821,15,38,1065.32,1842.02,0.00
2024-12-08 14:53:54,52,1821,14,38,1062.53,1842.96,0.00
2024-12-08 14:53:54,52,1822,14,38,1097.28,1843.00,0.00
2024-12-08 14:53:54,53,1822,14,39,1076.58,1843.02,0.00
2024-12-08 14:53:54,52,1822,13,39,1066.03,1843.64,0.00
2024-12-08 14:53:54,52,1823,13,39,1095.04,1844.00,0.00
2024-12-08 14:53:54,53,1823,14,39,1074.38,1844.02,0.00
2024-12-08 14:53:54,52,1823,14,38,1090.78,1844.02,0.00
2024-12-08 14:53:54,52,1824,14,38,1094.57,1845.00,0.00
2024-12-08 14:53:54,53,1824,15,38,1073.91,1845.02,0.00
2024-12-08 14:53:54,53,1825,15,38,1071.42,1846.00,0.00
2024-12-08 14:53:54,54,1825,15,39,1051.58,1846.02,0.00
2024-12-08 14:53:54,53,1825,15,38,1066.54,1846.02,0.00
2024-12-08 14:53:54,53,1826,15,38,1069.91,1847.00,0.00
2024-12-08 14:53:54,54,1826,16,38,1050.09,1847.02,0.00
2024-12-08 14:53:54,53,1826,15,38,1048.37,1847.38,0.00
2024-12-08 14:53:54,53,1827,15,38,1072.17,1848.00,0.00
2024-12-08 14:53:54,54,1827,15,39,1052.32,1848.02,0.00
2024-12-08 14:53:54,53,1827,15,38,1067.64,1848.02,0.00
2024-12-08 14:53:54,53,1828,15,38,1071.01,1849.00,0.00
2024-12-08 14:53:54,54,1828,15,39,1051.18,1849.02,0.00
2024-12-08 14:53:54,54,1829,15,39,1048.26,1850.00,0.00
2024-12-08 14:53:54,55,1829,16,39,1029.20,1850.02,0.00
2024-12-08 14:53:54,54,1829,16,38,1044.15,1850.02,0.00
2024-12-08 14:53:54,53,1829,15,38,1039.67,1850.96,0.00
2024-12-08 14:53:54,53,1830,15,38,1073.91,1851.00,0.00
2024-12-08 14:53:54,54,1830,16,38,1054.03,1851.02,0.00
2024-12-08 14:53:54,54,1831,16,38,1051.02,1852.00,0.00
2024-12-08 14:53:54,55,1831,17,38,1031.91,1852.02,0.00
2024-12-08 14:53:54,54,1831,17,37,1047.24,1852.02,0.00
2024-12-08 14:53:54,53,1831,16,37,1064.95,1852.13,0.00
2024-12-08 14:53:54,53,1832,16,37,1070.38,1853.00,0.00
2024-12-08 14:53:54,54,1832,16,38,1050.55,1853.02,0.00
2024-12-08 14:53:54,53,1832,15,38,1051.61,1853.34,0.00
2024-12-08 14:53:54,53,1833,15,38,1074.80,1854.00,0.00
2024-12-08 14:53:54,54,1833,15,39,1054.90,1854.02,0.00
2024-12-08 14:53:54,53,1833,15,38,1070.95,1854.02,0.00
2024-12-08 14:53:54,52,1833,14,38,1089.80,1854.12,0.00
2024-12-08 14:53:54,51,1833,13,38,1097.12,1854.41,0.00
2024-12-08 14:53:54,50,1833,12,38,1115.44,1854.62,0.00
2024-12-08 14:53:54,50,1834,12,38,1145.78,1855.00,0.00
2024-12-08 14:53:54,51,1834,12,39,1123.31,1855.02,0.00
2024-12-08 14:53:54,50,1834,11,39,1120.96,1855.14,0.00
2024-12-08 14:53:54,50,1835,11,39,1142.69,1856.00,0.00
2024-12-08 14:53:54,51,1835,12,39,1120.28,1856.02,0.00
2024-12-08 14:53:54,50,1835,12,38,1138.97,1856.02,0.00
2024-12-08 14:53:54,49,1835,11,38,1155.09,1856.22,0.00
2024-12-08 14:53:54,49,1836,11,38,1179.14,1857.00,0.00
2024-12-08 14:53:54,50,1836,11,39,1155.56,1857.02,0.00
2024-12-08 14:53:54,50,1837,11,39,1152.84,1858.00,0.00
2024-12-08 14:53:54,51,1837,11,40,1130.23,1858.02,0.00
2024-12-08 14:53:54,50,1837,11,39,1149.49,1858.02,0.00
2024-12-08 14:53:54,50,1838,11,39,1154.20,1859.00,0.00
2024-12-08 14:53:54,51,1838,12,39,1131.57,1859.02,0.00
2024-12-08 14:53:54,50,1838,11,39,1131.56,1859.74,0.00
2024-12-08 14:53:54,50,1839,11,39,1164.12,1860.00,0.00
2024-12-08 14:53:54,51,1839,11,40,1141.30,1860.02,0.00
2024-12-08 14:53:54,50,1839,11,39,1161.15,1860.02,0.00
2024-12-08 14:53:54,50,1840,11,39,1165.86,1861.00,0.00
2024-12-08 14:53:54,51,1840,12,39,1143.00,1861.02,0.00
2024-12-08 14:53:55,51,1841,12,39,1139.97,1862.00,0.00
2024-12-08 14:53:55,52,1841,12,40,1118.04,1862.02,0.00
2024-12-08 14:53:55,51,1841,12,39,1137.41,1862.02,0.00
2024-12-08 14:53:55,51,1842,12,39,1141.68,1863.00,0.00
2024-12-08 14:53:55,52,1842,12,40,1119.72,1863.02,0.00
2024-12-08 14:53:55,51,1842,11,40,1132.64,1863.10,0.00
2024-12-08 14:53:55,51,1843,11,40,1138.34,1864.00,0.00
2024-12-08 14:53:55,52,1843,12,40,1116.45,1864.02,0.00
2024-12-08 14:53:55,51,1843,12,39,1133.96,1864.04,0.00
2024-12-08 14:53:55,50,1843,11,39,1134.82,1864.92,0.00
2024-12-08 14:53:55,50,1844,11,39,1170.68,1865.00,0.00
2024-12-08 14:53:55,51,1844,11,40,1147.73,1865.02,0.00
2024-12-08 14:53:55,51,1845,11,40,1144.68,1866.00,0.00
2024-12-08 14:53:55,52,1845,12,40,1122.67,1866.02,0.00
2024-12-08 14:53:55,51,1845,12,39,1140.30,1866.04,0.00
2024-12-08 14:53:55,51,1846,12,39,1144.93,1867.00,0.00
2024-12-08 14:53:55,52,1846,13,39,1122.91,1867.02,0.00
2024-12-08 14:53:55,52,1847,13,39,1119.56,1868.00,0.00
2024-12-08 14:53:55,53,1847,14,39,1098.44,1868.02,0.00
2024-12-08 14:53:55,52,1847,14,38,1115.26,1868.04,0.00
2024-12-08 14:53:55,52,1848,14,38,1119.44,1869.00,0.00
2024-12-08 14:53:55,53,1848,14,39,1098.32,1869.02,0.00
2024-12-08 14:53:55,53,1849,14,39,1094.68,1870.00,0.00
2024-12-08 14:53:55,54,1849,15,39,1074.40,1870.02,0.00
2024-12-08 14:53:55,53,1849,15,38,1090.09,1870.04,0.00
2024-12-08 14:53:55,52,1849,14,38,1087.88,1870.96,0.00
2024-12-08 14:53:55,52,1850,14,38,1123.16,1871.00,0.00
2024-12-08 14:53:55,53,1850,14,39,1101.97,1871.02,0.00
2024-12-08 14:53:55,52,1850,13,39,1094.89,1871.90,0.00
2024-12-08 14:53:55,52,1851,13,39,1129.16,1872.00,0.00
2024-12-08 14:53:55,53,1851,13,40,1107.86,1872.02,0.00
2024-12-08 14:53:55,52,1851,13,39,1124.48,1872.04,0.00
2024-12-08 14:53:55,52,1852,13,39,1128.68,1873.00,0.00
2024-12-08 14:53:55,53,1852,14,39,1107.39,1873.02,0.00
2024-12-08 14:53:55,52,1852,13,39,1110.07,1873.64,0.00
2024-12-08 14:53:55,52,1853,13,39,1125.32,1874.00,0.00
2024-12-08 14:53:55,53,1853,14,39,1104.09,1874.02,0.00
2024-12-08 14:53:55,52,1853,14,38,1119.92,1874.04,0.00
2024-12-08 14:53:55,52,1854,14,38,1124.12,1875.00,0.00
2024-12-08 14:53:55,53,1854,14,39,1102.91,1875.02,0.00
2024-12-08 14:53:55,53,1855,14,39,1099.25,1876.00,0.00
2024-12-08 14:53:55,54,1855,14,40,1078.90,1876.02,0.00
2024-12-08 14:53:55,53,1855,14,39,1094.30,1876.04,0.00
2024-12-08 14:53:55,52,1855,13,39,1092.09,1876.96,0.00
2024-12-08 14:53:55,52,1856,13,39,1127.49,1877.00,0.00
2024-12-08 14:53:55,53,1856,14,39,1106.21,1877.02,0.00
2024-12-08 14:53:55,53,1857,14,39,1102.61,1878.00,0.00
2024-12-08 14:53:55,54,1857,15,39,1082.19,1878.02,0.00
2024-12-08 14:53:55,53,1857,15,38,1097.65,1878.04,0.00
2024-12-08 14:53:55,53,1858,15,38,1101.42,1879.00,0.00
2024-12-08 14:53:55,54,1858,15,39,1081.03,1879.02,0.00
2024-12-08 14:53:55,53,1858,14,39,1076.11,1879.49,0.00
2024-12-08 14:53:55,53,1859,14,39,1102.36,1880.00,0.00
2024-12-08 14:53:55,54,1859,15,39,1081.95,1880.02,0.00
2024-12-08 14:53:55,53,1859,15,38,1097.40,1880.04,0.00
2024-12-08 14:53:55,53,1860,15,38,1101.18,1881.00,0.00
2024-12-08 14:53:55,54,1860,16,38,1080.78,1881.02,0.00
2024-12-08 14:53:55,54,1861,16,38,1076.83,1882.00,0.00
2024-12-08 14:53:55,55,1861,16,39,1057.25,1882.02,0.00
2024-12-08 14:53:55,54,1861,16,38,1072.30,1882.04,0.00
2024-12-08 14:53:55,54,1862,16,38,1075.66,1883.00,0.00
2024-12-08 14:53:55,55,1862,16,39,1056.10,1883.02,0.00
2024-12-08 14:53:55,55,1863,16,39,1052.41,1884.00,0.00
2024-12-08 14:53:55,56,1863,17,39,1033.62,1884.02,0.00
2024-12-08 14:53:55,55,1863,17,38,1047.96,1884.04,0.00
2024-12-08 14:53:55,54,1863,16,38,1043.62,1884.96,0.00
2024-12-08 14:53:55,54,1864,16,38,1077.85,1885.00,0.00
2024-12-08 14:53:55,55,1864,16,39,1058.25,1885.02,0.00
2024-12-08 14:53:55,55,1865,16,39,1054.52,1886.00,0.00
2024-12-08 14:53:55,56,1865,17,39,1035.69,1886.02,0.00
2024-12-08 14:53:55,55,1865,17,38,1050.40,1886.04,0.00
2024-12-08 14:53:55,55,1866,17,38,1053.36,1887.00,0.00
2024-12-08 14:53:55,56,1866,18,38,1034.55,1887.02,0.00
2024-12-08 14:53:55,56,1867,18,38,1030.99,1888.00,0.00
2024-12-08 14:53:55,57,1867,18,39,1012.90,1888.02,0.00
2024-12-08 14:53:55,56,1867,18,38,1026.95,1888.04,0.00
2024-12-08 14:53:55,56,1868,18,38,1029.51,1889.00,0.00
2024-12-08 14:53:55,57,1868,19,38,1011.45,1889.02,0.00
2024-12-08 14:53:55,56,1868,18,38,1000.16,1889.93,0.00
2024-12-08 14:53:56,56,1869,18,38,1032.60,1890.00,0.00
2024-12-08 14:53:56,57,1869,18,39,1014.48,1890.02,0.00
2024-12-08 14:53:56,56,1869,17,39,1032.26,1890.02,0.00
2024-12-08 14:53:56,55,1869,17,38,1047.25,1890.02,0.00
2024-12-08 14:53:56,55,1870,17,38,1049.87,1891.00,0.00
2024-12-08 14:53:56,56,1870,18,38,1031.12,1891.02,0.00
2024-12-08 14:53:56,55,1870,17,38,1030.62,1891.06,0.00
2024-12-08 14:53:56,54,1870,16,38,1037.93,1891.69,0.00
2024-12-08 14:53:56,54,1871,16,38,1067.22,1892.00,0.00
2024-12-08 14:53:56,55,1871,16,39,1047.82,1892.02,0.00
2024-12-08 14:53:56,54,1871,16,38,1063.37,1892.02,0.00
2024-12-08 14:53:56,54,1872,16,38,1066.39,1893.00,0.00
2024-12-08 14:53:56,55,1872,17,38,1047.00,1893.02,0.00
2024-12-08 14:53:56,54,1872,16,38,1043.29,1893.78,0.00
2024-12-08 14:53:56,54,1873,16,38,1074.31,1894.00,0.00
2024-12-08 14:53:56,55,1873,17,38,1054.78,1894.02,0.00
2024-12-08 14:53:56,54,1873,17,37,1070.80,1894.02,0.00
2024-12-08 14:53:56,53,1873,16,37,1089.25,1894.11,0.00
2024-12-08 14:53:56,53,1874,16,37,1094.45,1895.00,0.00
2024-12-08 14:53:56,54,1874,17,37,1074.18,1895.02,0.00
2024-12-08 14:53:56,54,1875,17,37,1072.60,1896.00,0.00
2024-12-08 14:53:56,55,1875,18,37,1053.10,1896.02,0.00
2024-12-08 14:53:56,54,1875,18,36,1063.51,1896.13,0.00
2024-12-08 14:53:56,54,1876,18,36,1068.60,1897.00,0.00
2024-12-08 14:53:56,55,1876,18,37,1049.17,1897.02,0.00
2024-12-08 14:53:56,54,1876,17,37,1053.25,1897.22,0.00
2024-12-08 14:53:56,54,1877,17,37,1074.12,1898.00,0.00
2024-12-08 14:53:56,55,1877,18,37,1054.59,1898.02,0.00
2024-12-08 14:53:56,54,1877,18,36,1065.37,1898.13,0.00
2024-12-08 14:53:56,54,1878,18,36,1070.47,1899.00,0.00
2024-12-08 14:53:56,55,1878,19,36,1051.00,1899.02,0.00
2024-12-08 14:53:56,55,1879,19,36,1049.04,1900.00,0.00
2024-12-08 14:53:56,56,1879,19,37,1030.30,1900.02,0.00
2024-12-08 14:53:56,56,1880,19,37,1025.76,1901.00,0.00
2024-12-08 14:53:56,57,1880,20,37,1007.76,1901.02,0.00
2024-12-08 14:53:56,56,1880,20,36,1022.71,1901.05,0.00
2024-12-08 14:53:56,56,1881,20,36,1025.62,1902.00,0.00
2024-12-08 14:53:56,57,1881,20,37,1007.62,1902.02,0.00
2024-12-08 14:53:56,57,1882,20,37,1002.89,1903.00,0.00
2024-12-08 14:53:56,58,1882,20,38,985.60,1903.02,0.00
2024-12-08 14:53:56,57,1882,20,37,999.89,1903.05,0.00
2024-12-08 14:53:56,57,1883,20,37,1002.42,1904.00,0.00
2024-12-08 14:53:56,58,1883,20,38,985.13,1904.02,0.00
2024-12-08 14:53:56,57,1883,19,38,973.49,1904.93,0.00
2024-12-08 14:53:56,57,1884,19,38,1005.62,1905.00,0.00
2024-12-08 14:53:56,58,1884,19,39,988.28,1905.02,0.00
2024-12-08 14:53:56,57,1884,19,38,1002.95,1905.05,0.00
2024-12-08 14:53:56,56,1884,18,38,998.47,1905.95,0.00
2024-12-08 14:53:56,56,1885,18,38,1031.52,1906.00,0.00
2024-12-08 14:53:56,57,1885,19,38,1013.42,1906.02,0.00
2024-12-08 14:53:56,56,1885,19,37,1026.42,1906.07,0.00
2024-12-08 14:53:56,56,1886,19,37,1029.67,1907.00,0.00
2024-12-08 14:53:56,57,1886,19,38,1011.61,1907.02,0.00
2024-12-08 14:53:56,58,1885,20,38,977.62,1907.59,0.00
2024-12-08 14:53:56,58,1886,20,38,1013.85,1908.00,0.00
2024-12-08 14:53:56,59,1886,21,38,996.67,1908.02,0.00
2024-12-08 14:53:56,58,1886,21,37,1009.26,1908.07,0.00
2024-12-08 14:53:56,58,1887,21,37,1044.66,1909.00,0.00
2024-12-08 14:53:56,59,1887,22,37,1026.96,1909.02,0.00
2024-12-08 14:53:56,58,1887,21,37,1026.25,1909.64,0.00
2024-12-08 14:53:56,58,1888,21,37,1040.83,1910.00,0.00
2024-12-08 14:53:56,59,1888,22,37,1023.19,1910.02,0.00
2024-12-08 14:53:56,58,1888,22,36,1036.23,1910.07,0.00
2024-12-08 14:53:56,58,1889,22,36,1038.74,1911.00,0.00
2024-12-08 14:53:56,59,1889,22,37,1021.13,1911.02,0.00
2024-12-08 14:53:56,58,1889,22,36,1033.14,1911.03,0.00
2024-12-08 14:53:56,58,1890,22,36,1034.99,1912.00,0.00
2024-12-08 14:53:56,59,1890,22,37,1017.45,1912.02,0.00
2024-12-08 14:53:56,58,1890,21,37,1026.12,1912.14,0.00
2024-12-08 14:53:56,58,1891,21,37,1029.93,1913.00,0.00
2024-12-08 14:53:56,59,1891,22,37,1012.47,1913.02,0.00
2024-12-08 14:53:56,58,1891,22,36,1028.94,1913.03,0.00
2024-12-08 14:53:56,57,1891,21,36,1023.68,1913.97,0.00
2024-12-08 14:53:57,57,1892,21,36,1056.60,1914.00,0.00
2024-12-08 14:53:57,58,1892,21,37,1038.39,1914.02,0.00
2024-12-08 14:53:57,58,1893,21,37,1033.63,1915.00,0.00
2024-12-08 14:53:57,59,1893,22,37,1016.11,1915.02,0.00
2024-12-08 14:53:57,58,1893,22,36,1030.99,1915.03,0.00
2024-12-08 14:53:57,57,1893,21,36,1035.32,1915.72,0.00
2024-12-08 14:53:57,57,1894,21,36,1063.76,1916.00,0.00
2024-12-08 14:53:57,58,1894,22,36,1045.42,1916.02,0.00
2024-12-08 14:53:57,57,1894,21,36,1034.78,1916.60,0.00
2024-12-08 14:53:57,57,1895,21,36,1060.95,1917.00,0.00
2024-12-08 14:53:57,58,1895,21,37,1042.66,1917.02,0.00
2024-12-08 14:53:57,57,1895,21,36,1058.26,1917.04,0.00
2024-12-08 14:53:57,56,1895,20,36,1074.80,1917.16,0.00
2024-12-08 14:53:57,56,1896,20,36,1079.77,1918.00,0.00
2024-12-08 14:53:57,57,1896,20,37,1060.83,1918.02,0.00
2024-12-08 14:53:57,57,1897,20,37,1056.35,1919.00,0.00
2024-12-08 14:53:57,58,1897,21,37,1038.14,1919.02,0.00
2024-12-08 14:53:57,57,1897,21,36,1053.33,1919.04,0.00
2024-12-08 14:53:57,56,1897,20,36,1056.53,1919.45,0.00
2024-12-08 14:53:57,56,1898,20,36,1080.56,1920.00,0.00
2024-12-08 14:53:57,57,1898,20,37,1061.60,1920.02,0.00
2024-12-08 14:53:57,57,1899,20,37,1057.31,1921.00,0.00
2024-12-08 14:53:57,58,1899,21,37,1039.08,1921.02,0.00
2024-12-08 14:53:57,57,1899,21,36,1054.28,1921.04,0.00
2024-12-08 14:53:57,56,1899,20,36,1050.50,1921.59,0.00
2024-12-08 14:53:57,56,1900,20,36,1077.22,1922.00,0.00
2024-12-08 14:53:57,57,1900,21,36,1058.32,1922.02,0.00
2024-12-08 14:53:57,56,1900,20,36,1059.03,1922.05,0.00
2024-12-08 14:53:57,55,1900,19,36,1076.23,1922.16,0.00
2024-12-08 14:53:57,55,1901,19,36,1095.63,1923.00,0.00
2024-12-08 14:53:57,56,1901,20,36,1076.06,1923.02,0.00
2024-12-08 14:53:57,55,1901,20,35,1092.83,1923.04,0.00
2024-12-08 14:53:57,55,1902,20,35,1095.85,1924.00,0.00
2024-12-08 14:53:57,56,1902,20,36,1076.28,1924.02,0.00
2024-12-08 14:53:57,55,1902,19,36,1079.79,1924.29,0.00
2024-12-08 14:53:57,55,1903,19,36,1101.61,1925.00,0.00
2024-12-08 14:53:57,56,1903,19,37,1081.94,1925.02,0.00
2024-12-08 14:53:57,55,1903,19,36,1101.26,1925.02,0.00
2024-12-08 14:53:57,54,1903,19,35,1118.45,1925.02,0.00
2024-12-08 14:53:57,53,1903,18,35,1129.37,1925.55,0.00
2024-12-08 14:53:57,53,1904,18,35,1142.79,1926.00,0.00
2024-12-08 14:53:57,54,1904,19,35,1121.63,1926.02,0.00
2024-12-08 14:53:57,54,1905,19,35,1117.57,1927.00,0.00
2024-12-08 14:53:57,55,1905,20,35,1097.25,1927.02,0.00
2024-12-08 14:53:57,54,1905,20,34,1114.72,1927.02,0.00
2024-12-08 14:53:57,53,1905,19,34,1121.36,1927.38,0.00
2024-12-08 14:53:57,54,1904,20,34,1096.45,1927.63,0.00
2024-12-08 14:53:57,54,1905,20,34,1159.48,1928.00,0.00
2024-12-08 14:53:57,55,1905,20,35,1138.40,1928.02,0.00
2024-12-08 14:53:57,54,1905,19,35,1135.95,1928.15,0.00
2024-12-08 14:53:57,54,1906,19,35,1191.51,1929.00,0.00
2024-12-08 14:53:57,55,1906,19,36,1169.85,1929.02,0.00
2024-12-08 14:53:57,54,1906,19,35,1189.01,1929.02,0.00
2024-12-08 14:53:57,54,1907,19,35,1192.13,1930.00,0.00
2024-12-08 14:53:57,55,1907,20,35,1170.46,1930.02,0.00
2024-12-08 14:53:57,54,1907,19,35,1168.93,1930.74,0.00
2024-12-08 14:53:57,54,1908,19,35,1199.90,1931.00,0.00
2024-12-08 14:53:57,55,1908,20,35,1178.09,1931.02,0.00
2024-12-08 14:53:57,54,1908,20,34,1197.40,1931.02,0.00
2024-12-08 14:53:57,54,1909,20,34,1200.52,1932.00,0.00
2024-12-08 14:53:57,55,1909,21,34,1178.70,1932.02,0.00
2024-12-08 14:53:57,55,1910,21,34,1174.39,1933.00,0.00
2024-12-08 14:53:57,56,1910,21,35,1153.41,1933.02,0.00
2024-12-08 14:53:57,55,1910,21,34,1172.28,1933.02,0.00
2024-12-08 14:53:57,54,1910,20,34,1183.34,1933.57,0.00
2024-12-08 14:53:57,54,1911,20,34,1196.93,1934.00,0.00
2024-12-08 14:53:57,55,1911,20,35,1175.17,1934.02,0.00
2024-12-08 14:53:57,55,1912,20,35,1170.85,1935.00,0.00
2024-12-08 14:53:57,56,1912,21,35,1149.94,1935.02,0.00
2024-12-08 14:53:57,55,1912,21,34,1168.74,1935.02,0.00
2024-12-08 14:53:57,54,1912,20,34,1166.24,1935.96,0.00
2024-12-08 14:53:57,54,1913,20,34,1201.40,1936.00,0.00
2024-12-08 14:53:57,55,1913,20,35,1179.55,1936.02,0.00
2024-12-08 14:53:57,55,1914,20,35,1175.23,1937.00,0.00
2024-12-08 14:53:57,56,1914,20,36,1154.24,1937.02,0.00
2024-12-08 14:53:57,55,1914,20,35,1173.12,1937.02,0.00
2024-12-08 14:53:57,55,1915,20,35,1175.84,1938.00,0.00
2024-12-08 14:53:57,56,1915,21,35,1154.84,1938.02,0.00
2024-12-08 14:53:57,56,1916,21,35,1150.24,1939.00,0.00
2024-12-08 14:53:57,57,1916,22,35,1130.06,1939.02,0.00
2024-12-08 14:53:57,56,1916,22,34,1148.51,1939.02,0.00
2024-12-08 14:53:57,56,1917,22,34,1150.84,1940.00,0.00
2024-12-08 14:53:57,57,1917,22,35,1130.65,1940.02,0.00
2024-12-08 14:53:57,56,1917,21,35,1121.22,1940.93,0.00
2024-12-08 14:53:57,56,1918,21,35,1154.55,1941.00,0.00
2024-12-08 14:53:57,57,1918,22,35,1134.29,1941.02,0.00
2024-12-08 14:53:57,56,1918,22,34,1152.81,1941.02,0.00
2024-12-08 14:53:58,56,1919,22,34,1155.14,1942.00,0.00
2024-12-08 14:53:58,57,1919,22,35,1134.88,1942.02,0.00
2024-12-08 14:53:58,56,1919,21,35,1145.78,1942.02,0.00
2024-12-08 14:53:58,56,1920,21,35,1155.04,1943.00,0.00
2024-12-08 14:53:58,57,1920,22,35,1134.78,1943.02,0.00
2024-12-08 14:53:58,56,1920,22,34,1152.62,1943.02,0.00
2024-12-08 14:53:58,55,1920,21,34,1165.18,1943.26,0.00
2024-12-08 14:53:58,55,1921,21,34,1186.55,1944.00,0.00
2024-12-08 14:53:58,56,1921,22,34,1165.36,1944.02,0.00
2024-12-08 14:53:58,56,1922,22,34,1160.75,1945.00,0.00
2024-12-08 14:53:58,57,1922,23,34,1140.38,1945.02,0.00
2024-12-08 14:53:58,56,1922,23,33,1158.32,1945.02,0.00
2024-12-08 14:53:58,56,1923,23,33,1160.65,1946.00,0.00
2024-12-08 14:53:58,57,1923,23,34,1140.29,1946.02,0.00
2024-12-08 14:53:58,57,1924,23,34,1135.41,1947.00,0.00
2024-12-08 14:53:58,58,1924,23,35,1115.83,1947.02,0.00
2024-12-08 14:53:58,57,1924,23,34,1133.36,1947.02,0.00
2024-12-08 14:53:58,57,1925,23,34,1135.31,1948.00,0.00
2024-12-08 14:53:58,58,1925,24,34,1115.73,1948.02,0.00
2024-12-08 14:53:58,58,1926,24,34,1110.59,1949.00,0.00
2024-12-08 14:53:58,59,1926,24,35,1091.77,1949.02,0.00
2024-12-08 14:53:58,58,1926,24,34,1108.24,1949.02,0.00
2024-12-08 14:53:58,58,1927,24,34,1109.82,1950.00,0.00
2024-12-08 14:53:58,59,1927,24,35,1091.01,1950.02,0.00
2024-12-08 14:53:58,58,1927,23,35,1096.71,1950.03,0.00
2024-12-08 14:53:58,57,1927,22,35,1102.96,1950.70,0.00
2024-12-08 14:53:58,57,1928,22,35,1131.58,1951.00,0.00
2024-12-08 14:53:58,58,1928,23,35,1112.07,1951.02,0.00
2024-12-08 14:53:58,57,1928,23,34,1129.53,1951.02,0.00
2024-12-08 14:53:58,56,1928,22,34,1125.27,1951.63,0.00
2024-12-08 14:53:58,55,1928,21,34,1144.35,1951.69,0.00
2024-12-08 14:53:58,55,1929,21,34,1174.04,1952.00,0.00
2024-12-08 14:53:58,56,1929,21,35,1153.07,1952.02,0.00
2024-12-08 14:53:58,55,1929,20,35,1164.84,1952.13,0.00
2024-12-08 14:53:58,55,1930,20,35,1169.67,1953.00,0.00
2024-12-08 14:53:58,56,1930,21,35,1148.78,1953.02,0.00
2024-12-08 14:53:58,55,1930,21,34,1167.18,1953.02,0.00
2024-12-08 14:53:58,55,1931,21,34,1169.91,1954.00,0.00
2024-12-08 14:53:58,56,1931,22,34,1149.02,1954.02,0.00
2024-12-08 14:53:58,56,1932,22,34,1144.37,1955.00,0.00
2024-12-08 14:53:58,57,1932,22,35,1124.30,1955.02,0.00
2024-12-08 14:53:58,56,1932,22,34,1141.58,1955.02,0.00
2024-12-08 14:53:58,56,1933,22,34,1143.91,1956.00,0.00
2024-12-08 14:53:58,57,1933,23,34,1123.84,1956.02,0.00
2024-12-08 14:53:58,56,1933,22,34,1135.20,1956.11,0.00
2024-12-08 14:53:58,55,1933,21,34,1136.52,1956.55,0.00
2024-12-08 14:53:58,55,1934,21,34,1163.53,1957.00,0.00
2024-12-08 14:53:58,56,1934,21,35,1142.75,1957.02,0.00
2024-12-08 14:53:58,55,1934,21,34,1161.03,1957.02,0.00
2024-12-08 14:53:58,55,1935,21,34,1163.76,1958.00,0.00
2024-12-08 14:53:58,56,1935,22,34,1142.98,1958.02,0.00
2024-12-08 14:53:58,56,1936,22,34,1138.32,1959.00,0.00
2024-12-08 14:53:58,57,1936,23,34,1118.35,1959.02,0.00
2024-12-08 14:53:58,56,1936,23,33,1135.87,1959.02,0.00
2024-12-08 14:53:58,55,1936,22,33,1144.04,1959.66,0.00
2024-12-08 14:53:58,55,1937,22,33,1158.89,1960.00,0.00
2024-12-08 14:53:58,56,1937,23,33,1138.20,1960.02,0.00
2024-12-08 14:53:58,55,1937,22,33,1137.17,1960.71,0.00
2024-12-08 14:53:58,55,1938,22,33,1167.33,1961.00,0.00
2024-12-08 14:53:58,56,1938,22,34,1146.48,1961.02,0.00
2024-12-08 14:53:58,55,1938,22,33,1164.48,1961.02,0.00
2024-12-08 14:53:58,55,1939,22,33,1167.21,1962.00,0.00
2024-12-08 14:53:58,56,1939,22,34,1146.37,1962.02,0.00
2024-12-08 14:53:58,56,1940,22,34,1141.69,1963.00,0.00
2024-12-08 14:53:58,57,1940,22,35,1121.66,1963.02,0.00
2024-12-08 14:53:58,56,1940,22,34,1138.89,1963.02,0.00
2024-12-08 14:53:58,56,1941,22,34,1141.22,1964.00,0.00
2024-12-08 14:53:58,57,1941,23,34,1121.20,1964.02,0.00
2024-12-08 14:53:58,57,1942,23,34,1116.26,1965.00,0.00
2024-12-08 14:53:58,58,1942,23,35,1097.01,1965.02,0.00
2024-12-08 14:53:58,57,1942,23,34,1113.50,1965.02,0.00
2024-12-08 14:53:58,57,1943,23,34,1115.45,1966.00,0.00
2024-12-08 14:53:58,58,1943,23,35,1096.21,1966.02,0.00
2024-12-08 14:53:58,58,1944,23,35,1091.18,1967.00,0.00
2024-12-08 14:53:58,59,1944,23,36,1072.69,1967.02,0.00
2024-12-08 14:53:58,58,1944,23,35,1087.45,1967.02,0.00
2024-12-08 14:53:58,57,1944,22,35,1103.82,1967.14,0.00
2024-12-08 14:53:58,56,1944,21,35,1118.47,1967.23,0.00
2024-12-08 14:53:58,56,1945,21,35,1138.98,1968.00,0.00
2024-12-08 14:53:58,57,1945,22,35,1119.00,1968.02,0.00
2024-12-08 14:53:58,57,1946,22,35,1114.20,1969.00,0.00
2024-12-08 14:53:58,58,1946,23,35,1094.99,1969.02,0.00
2024-12-08 14:53:58,57,1946,23,34,1110.06,1969.02,0.00
2024-12-08 14:53:58,57,1947,23,34,1112.00,1970.00,0.00
2024-12-08 14:53:59,58,1947,24,34,1092.83,1970.02,0.00
2024-12-08 14:53:59,58,1948,24,34,1088.56,1971.00,0.00
2024-12-08 14:53:59,59,1948,25,34,1070.11,1971.02,0.00
2024-12-08 14:53:59,58,1948,25,33,1083.81,1971.03,0.00
2024-12-08 14:53:59,57,1948,24,33,1100.84,1971.11,0.00
2024-12-08 14:53:59,57,1949,24,33,1118.32,1972.00,0.00
2024-12-08 14:53:59,58,1949,24,34,1099.04,1972.02,0.00
2024-12-08 14:53:59,58,1950,24,34,1094.64,1973.00,0.00
2024-12-08 14:53:59,59,1950,25,34,1076.09,1973.02,0.00
2024-12-08 14:53:59,58,1950,25,33,1090.22,1973.03,0.00
2024-12-08 14:53:59,58,1951,25,33,1092.13,1974.00,0.00
2024-12-08 14:53:59,59,1951,26,33,1073.62,1974.02,0.00
2024-12-08 14:53:59,59,1952,26,33,1069.15,1975.00,0.00
2024-12-08 14:53:59,60,1952,26,34,1051.33,1975.02,0.00
2024-12-08 14:53:59,59,1952,26,33,1065.14,1975.03,0.00
2024-12-08 14:53:59,58,1952,25,33,1071.55,1975.66,0.00
2024-12-08 14:53:59,58,1953,25,33,1085.41,1976.00,0.00
2024-12-08 14:53:59,59,1953,26,33,1067.01,1976.02,0.00
2024-12-08 14:53:59,59,1954,26,33,1062.37,1977.00,0.00
2024-12-08 14:53:59,60,1954,27,33,1044.67,1977.02,0.00
2024-12-08 14:53:59,59,1954,27,32,1058.03,1977.05,0.00
2024-12-08 14:53:59,59,1955,27,32,1059.89,1978.00,0.00
2024-12-08 14:53:59,60,1955,27,33,1042.23,1978.02,0.00
2024-12-08 14:53:59,60,1956,27,33,1036.49,1979.00,0.00
2024-12-08 14:53:59,61,1956,28,33,1019.50,1979.02,0.00
2024-12-08 14:53:59,60,1956,28,32,1035.17,1979.02,0.00
2024-12-08 14:53:59,59,1956,27,32,1039.61,1979.68,0.00
2024-12-08 14:53:59,59,1957,27,32,1053.58,1980.00,0.00
2024-12-08 14:53:59,60,1957,28,32,1036.02,1980.02,0.00
2024-12-08 14:53:59,59,1957,27,32,1034.47,1980.07,0.00
2024-12-08 14:53:59,59,1958,27,32,1050.09,1981.00,0.00
2024-12-08 14:53:59,60,1958,28,32,1032.58,1981.02,0.00
2024-12-08 14:53:59,59,1958,28,31,1046.06,1981.03,0.00
2024-12-08 14:53:59,59,1959,28,31,1047.59,1982.00,0.00
2024-12-08 14:53:59,60,1959,29,31,1030.13,1982.02,0.00
2024-12-08 14:53:59,60,1960,29,31,1025.72,1983.00,0.00
2024-12-08 14:53:59,61,1960,30,31,1008.91,1983.02,0.00
2024-12-08 14:53:59,60,1960,30,30,1022.09,1983.03,0.00
2024-12-08 14:53:59,59,1960,29,30,1037.43,1983.14,0.00
2024-12-08 14:53:59,58,1960,28,30,1031.82,1983.97,0.00
2024-12-08 14:53:59,58,1961,28,30,1065.36,1984.00,0.00
2024-12-08 14:53:59,59,1961,28,31,1047.30,1984.02,0.00
2024-12-08 14:53:59,59,1962,28,31,1043.04,1985.00,0.00
2024-12-08 14:53:59,60,1962,29,31,1025.65,1985.02,0.00
2024-12-08 14:53:59,59,1962,29,30,1039.34,1985.03,0.00
2024-12-08 14:53:59,58,1962,28,30,1039.57,1985.78,0.00
2024-12-08 14:53:59,58,1963,28,30,1069.52,1986.00,0.00
2024-12-08 14:53:59,59,1963,28,31,1051.39,1986.02,0.00
2024-12-08 14:53:59,59,1964,28,31,1047.53,1987.00,0.00
2024-12-08 14:53:59,60,1964,29,31,1030.07,1987.02,0.00
2024-12-08 14:53:59,59,1964,29,30,1043.49,1987.03,0.00
2024-12-08 14:53:59,58,1964,28,30,1046.88,1987.36,0.00
2024-12-08 14:53:59,58,1965,28,30,1068.88,1988.00,0.00
2024-12-08 14:53:59,59,1965,28,31,1050.76,1988.02,0.00
2024-12-08 14:53:59,58,1965,27,31,1050.38,1988.05,0.00
2024-12-08 14:53:59,57,1965,26,31,1066.93,1988.14,0.00
2024-12-08 14:53:59,57,1966,26,31,1085.22,1989.00,0.00
2024-12-08 14:53:59,58,1966,27,31,1066.51,1989.02,0.00
2024-12-08 14:53:59,57,1966,27,30,1081.39,1989.04,0.00
2024-12-08 14:53:59,56,1966,26,30,1074.01,1989.68,0.00
2024-12-08 14:53:59,56,1967,26,30,1103.38,1990.00,0.00
2024-12-08 14:53:59,57,1967,26,31,1084.02,1990.02,0.00
2024-12-08 14:53:59,57,1968,26,31,1080.24,1991.00,0.00
2024-12-08 14:53:59,58,1968,27,31,1061.61,1991.02,0.00
2024-12-08 14:53:59,57,1968,27,30,1076.40,1991.04,0.00
2024-12-08 14:53:59,56,1968,26,30,1082.01,1991.34,0.00
2024-12-08 14:53:59,56,1969,26,30,1104.84,1992.00,0.00
2024-12-08 14:53:59,57,1969,27,30,1085.46,1992.02,0.00
2024-12-08 14:53:59,56,1969,26,30,1091.40,1992.21,0.00
2024-12-08 14:53:59,56,1970,26,30,1111.81,1993.00,0.00
2024-12-08 14:53:59,57,1970,27,30,1092.30,1993.02,0.00
2024-12-08 14:53:59,56,1970,27,29,1106.48,1993.07,0.00
2024-12-08 14:53:59,56,1971,27,29,1109.87,1994.00,0.00
2024-12-08 14:53:59,57,1971,27,30,1090.40,1994.02,0.00
2024-12-08 14:53:59,56,1971,26,30,1090.75,1994.63,0.00
2024-12-08 14:53:59,56,1972,26,30,1106.51,1995.00,0.00
2024-12-08 14:53:59,57,1972,27,30,1087.10,1995.02,0.00
2024-12-08 14:53:59,56,1972,27,29,1101.54,1995.07,0.00
2024-12-08 14:53:59,56,1973,27,29,1104.93,1996.00,0.00
2024-12-08 14:53:59,57,1973,27,30,1085.54,1996.02,0.00
2024-12-08 14:53:59,57,1974,27,30,1082.30,1997.00,0.00
2024-12-08 14:53:59,58,1974,28,30,1063.64,1997.02,0.00
2024-12-08 14:53:59,57,1974,28,29,1077.05,1997.07,0.00
2024-12-08 14:53:59,56,1974,27,29,1085.82,1997.61,0.00
2024-12-08 14:54:00,56,1975,27,29,1099.67,1998.00,0.00
2024-12-08 14:54:00,57,1975,28,29,1080.38,1998.02,0.00
2024-12-08 14:54:00,56,1975,27,29,1078.74,1998.38,0.00
2024-12-08 14:54:00,56,1976,27,29,1102.36,1999.00,0.00
2024-12-08 14:54:00,57,1976,28,29,1083.02,1999.02,0.00
2024-12-08 14:54:00,56,1976,28,28,1097.38,1999.07,0.00
2024-12-08 14:54:00,56,1977,28,28,1100.77,2000.00,0.00
2024-12-08 14:54:00,57,1977,28,29,1081.46,2000.02,0.00
2024-12-08 14:54:00,56,1977,27,29,1070.00,2000.89,0.00
2024-12-08 14:54:00,56,1978,27,29,1103.67,2001.00,0.00
2024-12-08 14:54:00,57,1978,28,29,1084.30,2001.02,0.00
2024-12-08 14:54:00,56,1978,28,28,1097.96,2001.07,0.00
2024-12-08 14:54:00,56,1979,28,28,1101.36,2002.00,0.00
2024-12-08 14:54:00,57,1979,28,29,1082.04,2002.02,0.00
2024-12-08 14:54:00,56,1979,27,29,1091.74,2002.14,0.00
2024-12-08 14:54:00,56,1980,27,29,1098.65,2003.00,0.00
2024-12-08 14:54:00,57,1980,28,29,1079.38,2003.02,0.00
2024-12-08 14:54:00,56,1980,28,28,1093.30,2003.07,0.00
2024-12-08 14:54:00,56,1981,28,28,1096.70,2004.00,0.00
2024-12-08 14:54:00,57,1981,28,29,1077.46,2004.02,0.00
2024-12-08 14:54:00,57,1982,28,29,1074.46,2005.00,0.00
2024-12-08 14:54:00,58,1982,28,30,1055.93,2005.02,0.00
2024-12-08 14:54:00,57,1982,28,29,1069.19,2005.07,0.00
2024-12-08 14:54:00,56,1982,27,29,1087.23,2005.13,0.00
2024-12-08 14:54:00,56,1983,27,29,1091.68,2006.00,0.00
2024-12-08 14:54:00,57,1983,28,29,1072.53,2006.02,0.00
2024-12-08 14:54:00,57,1984,28,29,1069.32,2007.00,0.00
2024-12-08 14:54:00,58,1984,28,30,1050.88,2007.02,0.00
2024-12-08 14:54:00,57,1984,28,29,1064.40,2007.07,0.00
2024-12-08 14:54:00,57,1985,28,29,1067.39,2008.00,0.00
2024-12-08 14:54:00,58,1985,28,30,1048.98,2008.02,0.00
2024-12-08 14:54:00,57,1985,27,30,1039.13,2008.83,0.00
2024-12-08 14:54:00,57,1986,27,30,1070.96,2009.00,0.00
2024-12-08 14:54:00,58,1986,27,31,1052.50,2009.02,0.00
2024-12-08 14:54:00,57,1986,27,30,1065.68,2009.07,0.00
2024-12-08 14:54:00,57,1987,27,30,1068.67,2010.00,0.00
2024-12-08 14:54:00,58,1987,28,30,1050.25,2010.02,0.00
2024-12-08 14:54:00,57,1987,27,30,1064.09,2010.04,0.00
2024-12-08 14:54:00,57,1987,27,30,1073.44,2011.00,0.00
2024-12-08 14:54:00,58,1987,28,30,1054.93,2011.02,0.00
2024-12-08 14:54:00,57,1987,28,29,1068.51,2011.05,0.00
2024-12-08 14:54:00,56,1987,27,29,1085.82,2011.13,0.00
2024-12-08 14:54:00,56,1988,27,29,1090.28,2012.00,0.00
2024-12-08 14:54:00,57,1988,28,29,1071.15,2012.02,0.00
2024-12-08 14:54:00,56,1988,27,29,1079.89,2012.14,0.00
2024-12-08 14:54:00,56,1989,27,29,1099.09,2013.00,0.00
2024-12-08 14:54:00,57,1989,27,30,1079.81,2013.02,0.00
2024-12-08 14:54:00,56,1989,27,29,1093.34,2013.05,0.00
2024-12-08 14:54:00,55,1989,26,29,1102.80,2013.58,0.00
2024-12-08 14:54:00,55,1990,26,29,1116.63,2014.00,0.00
2024-12-08 14:54:00,56,1990,27,29,1096.69,2014.02,0.00
2024-12-08 14:54:00,56,1991,27,29,1093.84,2015.00,0.00
2024-12-08 14:54:00,57,1991,28,29,1074.65,2015.02,0.00
2024-12-08 14:54:00,56,1991,28,28,1088.45,2015.05,0.00
2024-12-08 14:54:00,56,1992,28,28,1091.51,2016.00,0.00
2024-12-08 14:54:00,57,1992,29,28,1072.36,2016.02,0.00
2024-12-08 14:54:00,57,1993,29,28,1069.65,2017.00,0.00
2024-12-08 14:54:00,58,1993,29,29,1051.20,2017.02,0.00
2024-12-08 14:54:00,57,1993,29,28,1064.34,2017.05,0.00
2024-12-08 14:54:00,57,1994,29,28,1066.99,2018.00,0.00
2024-12-08 14:54:00,58,1994,30,28,1048.59,2018.02,0.00
2024-12-08 14:54:00,57,1994,29,28,1048.29,2018.60,0.00
2024-12-08 14:54:00,56,1994,28,28,1065.60,2018.66,0.00
2024-12-08 14:54:00,56,1995,28,28,1083.20,2019.00,0.00
2024-12-08 14:54:00,57,1995,28,29,1064.19,2019.02,0.00
2024-12-08 14:54:00,56,1995,28,28,1078.15,2019.05,0.00
2024-12-08 14:54:00,55,1995,27,28,1096.67,2019.11,0.00
2024-12-08 14:54:00,55,1996,27,28,1101.23,2020.00,0.00
2024-12-08 14:54:00,56,1996,28,28,1081.57,2020.02,0.00
2024-12-08 14:54:00,56,1997,28,28,1078.65,2021.00,0.00
2024-12-08 14:54:00,57,1997,28,29,1059.72,2021.02,0.00
2024-12-08 14:54:00,56,1997,28,28,1073.59,2021.05,0.00
2024-12-08 14:54:00,55,1997,27,28,1092.39,2021.09,0.00
2024-12-08 14:54:00,54,1997,26,28,1091.70,2021.50,0.00
2024-12-08 14:54:00,54,1998,26,28,1119.37,2022.00,0.00
2024-12-08 14:54:00,55,1998,26,29,1099.02,2022.02,0.00
2024-12-08 14:54:00,54,1998,25,29,1096.11,2022.67,0.00
2024-12-08 14:54:00,54,1999,25,29,1127.06,2023.00,0.00
2024-12-08 14:54:00,55,1999,25,30,1106.57,2023.02,0.00
2024-12-08 14:54:00,54,1999,24,30,1126.31,2023.04,0.00
2024-12-08 14:54:00,53,1999,24,29,1142.60,2023.04,0.00
2024-12-08 14:54:00,53,2000,24,29,1146.60,2024.00,0.00
2024-12-08 14:54:00,54,2000,25,29,1125.37,2024.02,0.00
2024-12-08 14:54:00,53,2000,24,29,1114.39,2024.57,0.00
2024-12-08 14:54:00,53,2001,24,29,1144.11,2025.00,0.00
2024-12-08 14:54:00,54,2001,25,29,1122.92,2025.02,0.00
2024-12-08 14:54:00,53,2001,25,28,1138.76,2025.04,0.00
2024-12-08 14:54:00,52,2001,24,28,1159.51,2025.10,0.00
2024-12-08 14:54:01,52,2002,24,28,1165.13,2026.00,0.00
2024-12-08 14:54:01,53,2002,24,29,1143.15,2026.02,0.00
2024-12-08 14:54:01,53,2003,24,29,1141.05,2027.00,0.00
2024-12-08 14:54:01,54,2003,25,29,1119.92,2027.02,0.00
2024-12-08 14:54:01,53,2003,24,29,1140.67,2027.02,0.00
2024-12-08 14:54:01,52,2003,24,28,1156.75,2027.02,0.00
2024-12-08 14:54:01,51,2003,23,28,1159.34,2027.43,0.00
2024-12-08 14:54:01,50,2003,22,28,1180.60,2027.52,0.00
2024-12-08 14:54:01,50,2004,22,28,1211.76,2028.00,0.00
2024-12-08 14:54:01,51,2004,22,29,1188.00,2028.02,0.00
2024-12-08 14:54:01,51,2005,22,29,1185.46,2029.00,0.00
2024-12-08 14:54:01,52,2005,22,30,1162.67,2029.02,0.00
2024-12-08 14:54:01,51,2005,22,29,1179.89,2029.02,0.00
2024-12-08 14:54:01,51,2006,22,29,1184.45,2030.00,0.00
2024-12-08 14:54:01,52,2006,23,29,1161.68,2030.02,0.00
2024-12-08 14:54:01,51,2006,22,29,1151.47,2030.92,0.00
2024-12-08 14:54:01,51,2007,22,29,1189.75,2031.00,0.00
2024-12-08 14:54:01,52,2007,22,30,1166.87,2031.02,0.00
2024-12-08 14:54:01,51,2007,22,29,1184.58,2031.02,0.00
2024-12-08 14:54:01,51,2008,22,29,1189.14,2032.00,0.00
2024-12-08 14:54:01,52,2008,22,30,1166.28,2032.02,0.00
2024-12-08 14:54:01,51,2008,21,30,1179.78,2032.08,0.00
2024-12-08 14:54:01,51,2009,21,30,1186.52,2033.00,0.00
2024-12-08 14:54:01,52,2009,22,30,1163.70,2033.02,0.00
2024-12-08 14:54:01,51,2009,22,29,1181.33,2033.02,0.00
2024-12-08 14:54:01,50,2009,21,29,1187.25,2033.74,0.00
2024-12-08 14:54:01,50,2010,21,29,1222.85,2034.00,0.00
2024-12-08 14:54:01,51,2010,22,29,1198.87,2034.02,0.00
2024-12-08 14:54:01,51,2011,22,29,1195.64,2035.00,0.00
2024-12-08 14:54:01,52,2011,22,30,1172.65,2035.02,0.00
2024-12-08 14:54:01,51,2011,22,29,1190.85,2035.02,0.00
2024-12-08 14:54:01,50,2011,21,29,1213.69,2035.06,0.00
2024-12-08 14:54:01,50,2012,21,29,1219.57,2036.00,0.00
2024-12-08 14:54:01,51,2012,22,29,1195.66,2036.02,0.00
2024-12-08 14:54:01,51,2013,22,29,1192.25,2037.00,0.00
2024-12-08 14:54:01,52,2013,22,30,1169.32,2037.02,0.00
2024-12-08 14:54:01,51,2013,22,29,1187.86,2037.02,0.00
2024-12-08 14:54:01,50,2013,21,29,1210.81,2037.06,0.00
2024-12-08 14:54:01,50,2014,21,29,1216.69,2038.00,0.00
2024-12-08 14:54:01,51,2014,22,29,1192.84,2038.02,0.00
2024-12-08 14:54:01,51,2015,22,29,1190.19,2039.00,0.00
2024-12-08 14:54:01,52,2015,23,29,1167.30,2039.02,0.00
2024-12-08 14:54:01,51,2015,23,28,1184.59,2039.02,0.00
2024-12-08 14:54:01,50,2015,22,28,1198.00,2039.52,0.00
2024-12-08 14:54:01,50,2016,22,28,1213.02,2040.00,0.00
2024-12-08 14:54:01,51,2016,23,28,1189.24,2040.02,0.00
2024-12-08 14:54:01,51,2017,23,28,1186.97,2041.00,0.00
2024-12-08 14:54:01,52,2017,24,28,1164.14,2041.02,0.00
2024-12-08 14:54:01,51,2017,24,27,1180.97,2041.02,0.00
2024-12-08 14:54:01,50,2017,23,27,1203.41,2041.06,0.00
2024-12-08 14:54:01,50,2018,23,27,1209.29,2042.00,0.00
2024-12-08 14:54:01,51,2018,23,28,1185.58,2042.02,0.00
2024-12-08 14:54:01,51,2019,23,28,1183.67,2043.00,0.00
2024-12-08 14:54:01,52,2019,24,28,1160.90,2043.02,0.00
2024-12-08 14:54:01,51,2019,24,27,1176.86,2043.04,0.00
2024-12-08 14:54:01,51,2020,24,27,1181.84,2044.00,0.00
2024-12-08 14:54:01,52,2020,24,28,1159.11,2044.02,0.00
2024-12-08 14:54:01,51,2020,23,28,1163.96,2044.51,0.00
2024-12-08 14:54:01,51,2021,23,28,1181.62,2045.00,0.00
2024-12-08 14:54:01,52,2021,24,28,1158.89,2045.02,0.00
2024-12-08 14:54:01,51,2021,24,27,1172.02,2045.10,0.00
2024-12-08 14:54:01,50,2021,23,27,1169.29,2045.92,0.00
2024-12-08 14:54:01,50,2022,23,27,1208.63,2046.00,0.00
2024-12-08 14:54:01,51,2022,23,28,1184.93,2046.02,0.00
2024-12-08 14:54:01,50,2022,22,28,1185.84,2046.32,0.00
2024-12-08 14:54:01,50,2023,22,28,1213.31,2047.00,0.00
2024-12-08 14:54:01,51,2023,23,28,1189.52,2047.02,0.00
2024-12-08 14:54:01,50,2023,23,27,1203.11,2047.12,0.00
2024-12-08 14:54:01,49,2023,22,27,1209.86,2047.43,0.00
2024-12-08 14:54:01,49,2024,22,27,1240.35,2048.00,0.00
2024-12-08 14:54:01,50,2024,22,28,1215.54,2048.02,0.00
2024-12-08 14:54:01,49,2024,21,28,1238.34,2048.10,0.00
2024-12-08 14:54:01,49,2025,21,28,1239.91,2049.00,0.00
2024-12-08 14:54:01,50,2025,22,28,1215.11,2049.02,0.00
2024-12-08 14:54:01,49,2025,22,27,1229.90,2049.10,0.00
2024-12-08 14:54:01,50,2024,23,27,1178.15,2049.68,0.00
2024-12-08 14:54:01,50,2025,23,27,1219.80,2050.00,0.00
2024-12-08 14:54:01,51,2025,24,27,1195.89,2050.02,0.00
2024-12-08 14:54:01,50,2025,23,27,1196.98,2050.32,0.00
2024-12-08 14:54:01,50,2026,23,27,1265.52,2051.00,0.00
2024-12-08 14:54:01,51,2026,23,28,1240.71,2051.02,0.00
2024-12-08 14:54:01,50,2026,23,27,1255.70,2051.10,0.00
2024-12-08 14:54:01,50,2027,23,27,1262.44,2052.00,0.00
2024-12-08 14:54:01,51,2027,24,27,1237.69,2052.02,0.00
2024-12-08 14:54:01,51,2028,24,27,1237.30,2053.00,0.00
2024-12-08 14:54:01,52,2028,25,27,1213.51,2053.02,0.00
2024-12-08 14:54:02,52,2029,25,27,1209.75,2054.00,0.00
2024-12-08 14:54:02,53,2029,25,28,1186.93,2054.02,0.00
2024-12-08 14:54:02,52,2029,25,27,1207.80,2054.10,0.00
2024-12-08 14:54:02,51,2029,24,27,1223.49,2054.49,0.00
2024-12-08 14:54:02,50,2029,23,27,1245.17,2054.62,0.00
2024-12-08 14:54:02,50,2030,23,27,1262.30,2055.00,0.00
2024-12-08 14:54:02,51,2030,23,28,1237.55,2055.02,0.00
2024-12-08 14:54:02,51,2031,23,28,1236.82,2056.00,0.00
2024-12-08 14:54:02,52,2031,23,29,1213.04,2056.02,0.00
2024-12-08 14:54:02,51,2031,23,28,1226.36,2056.12,0.00
2024-12-08 14:54:02,50,2031,22,28,1236.30,2056.30,0.00
2024-12-08 14:54:02,50,2032,22,28,1263.53,2057.00,0.00
2024-12-08 14:54:02,51,2032,23,28,1238.76,2057.02,0.00
2024-12-08 14:54:02,51,2033,23,28,1238.75,2058.00,0.00
2024-12-08 14:54:02,52,2033,23,29,1214.93,2058.02,0.00
2024-12-08 14:54:02,52,2034,23,29,1211.16,2059.00,0.00
2024-12-08 14:54:02,53,2034,24,29,1188.31,2059.02,0.00
2024-12-08 14:54:02,52,2034,24,28,1208.41,2059.12,0.00
2024-12-08 14:54:02,51,2034,23,28,1210.14,2059.82,0.00
2024-12-08 14:54:02,51,2035,23,28,1247.03,2060.00,0.00
2024-12-08 14:54:02,52,2035,24,28,1223.04,2060.02,0.00
2024-12-08 14:54:02,52,2036,24,28,1222.70,2061.00,0.00
2024-12-08 14:54:02,53,2036,24,29,1199.63,2061.02,0.00
2024-12-08 14:54:02,53,2037,24,29,1195.55,2062.00,0.00
2024-12-08 14:54:02,54,2037,24,30,1173.41,2062.02,0.00
2024-12-08 14:54:02,53,2037,24,29,1193.23,2062.11,0.00
2024-12-08 14:54:02,53,2038,24,29,1198.85,2063.00,0.00
2024-12-08 14:54:02,54,2038,24,30,1176.65,2063.02,0.00
2024-12-08 14:54:02,53,2038,23,30,1197.10,2063.09,0.00
2024-12-08 14:54:02,52,2038,22,30,1202.22,2063.58,0.00
2024-12-08 14:54:02,52,2039,22,30,1221.45,2064.00,0.00
2024-12-08 14:54:02,53,2039,23,30,1198.40,2064.02,0.00
2024-12-08 14:54:02,52,2039,23,29,1211.54,2064.10,0.00
2024-12-08 14:54:02,53,2038,23,30,1182.22,2064.45,0.00
2024-12-08 14:54:02,52,2038,22,30,1187.73,2064.92,0.00
2024-12-08 14:54:02,52,2039,22,30,1225.89,2065.00,0.00
2024-12-08 14:54:02,53,2039,23,30,1202.76,2065.02,0.00
2024-12-08 14:54:02,52,2039,22,30,1193.85,2065.90,0.00
2024-12-08 14:54:02,52,2040,22,30,1271.38,2066.00,0.00
2024-12-08 14:54:02,53,2040,23,30,1247.40,2066.02,0.00
2024-12-08 14:54:02,52,2040,23,29,1261.86,2066.10,0.00
2024-12-08 14:54:02,52,2041,23,29,1267.63,2067.00,0.00
2024-12-08 14:54:02,53,2041,23,30,1243.71,2067.02,0.00
2024-12-08 14:54:02,52,2041,22,30,1242.58,2067.75,0.00
2024-12-08 14:54:02,52,2042,22,30,1277.39,2068.00,0.00
2024-12-08 14:54:02,53,2042,22,31,1253.29,2068.02,0.00
2024-12-08 14:54:02,52,2042,22,30,1267.85,2068.10,0.00
2024-12-08 14:54:02,52,2043,22,30,1273.63,2069.00,0.00
2024-12-08 14:54:02,53,2043,23,30,1249.60,2069.02,0.00
2024-12-08 14:54:02,53,2044,23,30,1247.59,2070.00,0.00
2024-12-08 14:54:02,54,2044,23,31,1224.49,2070.02,0.00
2024-12-08 14:54:02,53,2044,23,30,1238.61,2070.09,0.00
2024-12-08 14:54:02,54,2043,23,31,1207.45,2070.54,0.00
2024-12-08 14:54:02,54,2044,23,31,1231.60,2071.00,0.00
2024-12-08 14:54:02,55,2044,24,31,1209.20,2071.02,0.00
2024-12-08 14:54:02,54,2044,23,31,1197.88,2071.91,0.00
2024-12-08 14:54:02,54,2045,23,31,1272.75,2072.00,0.00
2024-12-08 14:54:02,55,2045,23,32,1249.60,2072.02,0.00
2024-12-08 14:54:02,54,2045,23,31,1264.31,2072.09,0.00
2024-12-08 14:54:02,54,2046,23,31,1269.14,2073.00,0.00
2024-12-08 14:54:02,55,2046,24,31,1246.06,2073.02,0.00
2024-12-08 14:54:02,55,2047,24,31,1243.88,2074.00,0.00
2024-12-08 14:54:02,56,2047,24,32,1221.67,2074.02,0.00
2024-12-08 14:54:02,55,2047,24,31,1234.47,2074.11,0.00
2024-12-08 14:54:02,55,2048,24,31,1239.20,2075.00,0.00
2024-12-08 14:54:02,56,2048,25,31,1217.07,2075.02,0.00
2024-12-08 14:54:02,56,2049,25,31,1215.44,2076.00,0.00
2024-12-08 14:54:02,57,2049,26,31,1194.12,2076.02,0.00
2024-12-08 14:54:02,57,2050,26,31,1188.86,2077.00,0.00
2024-12-08 14:54:02,58,2050,27,31,1168.36,2077.02,0.00
2024-12-08 14:54:02,57,2050,26,31,1188.50,2077.02,0.00
2024-12-08 14:54:02,56,2050,26,30,1207.87,2077.09,0.00
2024-12-08 14:54:02,56,2051,26,30,1211.79,2078.00,0.00
2024-12-08 14:54:02,57,2051,27,30,1190.53,2078.02,0.00
2024-12-08 14:54:02,57,2052,27,30,1188.55,2079.00,0.00
2024-12-08 14:54:02,58,2052,27,31,1168.06,2079.02,0.00
2024-12-08 14:54:02,57,2052,27,30,1179.44,2079.09,0.00
2024-12-08 14:54:02,56,2052,26,30,1176.96,2079.52,0.00
2024-12-08 14:54:02,56,2053,26,30,1204.41,2080.00,0.00
2024-12-08 14:54:02,57,2053,27,30,1183.28,2080.02,0.00
2024-12-08 14:54:02,57,2054,27,30,1181.52,2081.00,0.00
2024-12-08 14:54:02,58,2054,27,31,1161.15,2081.02,0.00
2024-12-08 14:54:02,57,2054,26,31,1181.15,2081.02,0.00
2024-12-08 14:54:02,56,2054,26,30,1192.97,2081.09,0.00
2024-12-08 14:54:02,56,2055,26,30,1196.87,2082.00,0.00
2024-12-08 14:54:03,57,2055,26,31,1175.87,2082.02,0.00
2024-12-08 14:54:03,56,2055,25,31,1196.50,2082.02,0.00
2024-12-08 14:54:03,56,2056,25,31,1194.96,2083.00,0.00
2024-12-08 14:54:03,57,2056,26,31,1174.00,2083.02,0.00
2024-12-08 14:54:03,56,2056,25,31,1194.59,2083.02,0.00
2024-12-08 14:54:03,55,2056,24,31,1201.54,2083.04,0.00
2024-12-08 14:54:03,54,2056,24,30,1216.08,2083.04,0.00
2024-12-08 14:54:03,54,2057,24,30,1235.18,2084.00,0.00
2024-12-08 14:54:03,55,2057,24,31,1212.72,2084.02,0.00
2024-12-08 14:54:03,55,2058,24,31,1210.61,2085.00,0.00
2024-12-08 14:54:03,56,2058,25,31,1188.99,2085.02,0.00
2024-12-08 14:54:03,55,2058,25,30,1203.03,2085.04,0.00
2024-12-08 14:54:03,54,2058,24,30,1225.31,2085.04,0.00
2024-12-08 14:54:03,53,2058,23,30,1224.54,2085.85,0.00
2024-12-08 14:54:03,53,2059,23,30,1260.88,2086.00,0.00
2024-12-08 14:54:03,54,2059,23,31,1237.53,2086.02,0.00
2024-12-08 14:54:03,54,2060,23,31,1235.70,2087.00,0.00
2024-12-08 14:54:03,55,2060,23,32,1213.24,2087.02,0.00
2024-12-08 14:54:03,54,2060,23,31,1227.59,2087.04,0.00
2024-12-08 14:54:03,53,2060,22,31,1236.62,2087.59,0.00
2024-12-08 14:54:03,53,2061,22,31,1267.65,2088.00,0.00
2024-12-08 14:54:03,54,2061,22,32,1244.18,2088.02,0.00
2024-12-08 14:54:03,54,2062,22,32,1242.19,2089.00,0.00
2024-12-08 14:54:03,55,2062,22,33,1219.60,2089.02,0.00
2024-12-08 14:54:03,54,2062,22,32,1234.07,2089.04,0.00
2024-12-08 14:54:03,54,2063,22,32,1237.75,2090.00,0.00
2024-12-08 14:54:03,55,2063,22,33,1215.24,2090.02,0.00
2024-12-08 14:54:03,54,2063,21,33,1228.85,2090.06,0.00
2024-12-08 14:54:03,54,2064,21,33,1248.41,2091.00,0.00
2024-12-08 14:54:03,55,2064,21,34,1225.71,2091.02,0.00
2024-12-08 14:54:03,54,2064,21,33,1240.67,2091.04,0.00
2024-12-08 14:54:03,53,2064,20,33,1245.33,2091.43,0.00
2024-12-08 14:54:03,53,2065,20,33,1273.36,2092.00,0.00
2024-12-08 14:54:03,54,2065,21,33,1249.78,2092.02,0.00
2024-12-08 14:54:03,53,2065,20,33,1254.94,2092.53,0.00
2024-12-08 14:54:03,53,2066,20,33,1279.53,2093.00,0.00
2024-12-08 14:54:03,54,2066,21,33,1255.84,2093.02,0.00
2024-12-08 14:54:03,54,2067,21,33,1256.90,2094.00,0.00
2024-12-08 14:54:03,55,2067,21,34,1234.04,2094.02,0.00
2024-12-08 14:54:03,55,2068,21,34,1229.30,2095.00,0.00
2024-12-08 14:54:03,56,2068,22,34,1207.35,2095.02,0.00
2024-12-08 14:54:03,55,2068,22,33,1225.11,2095.04,0.00
2024-12-08 14:54:03,54,2068,21,33,1216.48,2095.96,0.00
2024-12-08 14:54:03,54,2069,21,33,1254.53,2096.00,0.00
2024-12-08 14:54:03,55,2069,22,33,1231.72,2096.02,0.00
2024-12-08 14:54:03,54,2069,21,33,1230.73,2096.33,0.00
2024-12-08 14:54:03,54,2070,21,33,1256.05,2097.00,0.00
2024-12-08 14:54:03,55,2070,21,34,1233.21,2097.02,0.00
2024-12-08 14:54:03,54,2070,21,33,1249.45,2097.04,0.00
2024-12-08 14:54:03,53,2070,20,33,1272.25,2097.08,0.00
2024-12-08 14:54:03,53,2071,20,33,1277.19,2098.00,0.00
2024-12-08 14:54:03,54,2071,21,33,1253.54,2098.02,0.00
2024-12-08 14:54:03,54,2072,21,33,1250.58,2099.00,0.00
2024-12-08 14:54:03,55,2072,22,33,1227.85,2099.02,0.00
2024-12-08 14:54:03,54,2072,22,32,1243.21,2099.06,0.00
2024-12-08 14:54:03,53,2072,21,32,1266.27,2099.08,0.00
2024-12-08 14:54:03,52,2072,20,32,1282.75,2099.46,0.00
2024-12-08 14:54:03,52,2073,20,32,1296.07,2100.00,0.00
2024-12-08 14:54:03,53,2073,21,32,1271.61,2100.02,0.00
2024-12-08 14:54:03,53,2074,21,32,1268.43,2101.00,0.00
2024-12-08 14:54:03,54,2074,21,33,1244.94,2101.02,0.00
2024-12-08 14:54:03,53,2074,21,32,1260.91,2101.06,0.00
2024-12-08 14:54:03,53,2075,21,32,1265.46,2102.00,0.00
2024-12-08 14:54:03,54,2075,21,33,1242.03,2102.02,0.00
2024-12-08 14:54:03,54,2076,21,33,1247.55,2103.00,0.00
2024-12-08 14:54:03,55,2076,22,33,1224.87,2103.02,0.00
2024-12-08 14:54:03,55,2077,22,33,1224.69,2104.00,0.00
2024-12-08 14:54:03,56,2077,23,33,1202.82,2104.02,0.00
2024-12-08 14:54:03,55,2077,22,33,1210.92,2104.09,0.00
2024-12-08 14:54:03,55,2078,22,33,1230.63,2105.00,0.00
2024-12-08 14:54:03,56,2078,23,33,1208.65,2105.02,0.00
2024-12-08 14:54:03,55,2078,22,33,1229.54,2105.05,0.00
2024-12-08 14:54:03,54,2078,22,32,1249.97,2105.06,0.00
2024-12-08 14:54:03,54,2079,22,32,1254.07,2106.00,0.00
2024-12-08 14:54:03,55,2079,23,32,1231.27,2106.02,0.00
2024-12-08 14:54:03,55,2080,23,32,1228.24,2107.00,0.00
2024-12-08 14:54:03,56,2080,23,33,1206.30,2107.02,0.00
2024-12-08 14:54:03,55,2080,23,32,1220.58,2107.05,0.00
2024-12-08 14:54:03,55,2081,23,32,1224.22,2108.00,0.00
2024-12-08 14:54:03,56,2081,23,33,1202.36,2108.02,0.00
2024-12-08 14:54:03,56,2082,23,33,1199.55,2109.00,0.00
2024-12-08 14:54:03,57,2082,24,33,1178.51,2109.02,0.00
2024-12-08 14:54:03,56,2082,24,32,1191.65,2109.07,0.00
2024-12-08 14:54:03,55,2082,23,32,1192.01,2109.46,0.00
2024-12-08 14:54:03,55,2083,23,32,1219.24,2110.00,0.00
2024-12-08 14:54:03,56,2083,24,32,1197.47,2110.02,0.00
2024-12-08 14:54:03,55,2083,23,32,1194.46,2110.40,0.00
2024-12-08 14:54:03,55,2084,23,32,1220.59,2111.00,0.00
2024-12-08 14:54:03,56,2084,23,33,1198.79,2111.02,0.00
2024-12-08 14:54:03,55,2084,22,33,1220.20,2111.02,0.00
2024-12-08 14:54:03,54,2084,22,32,1234.61,2111.07,0.00
2024-12-08 14:54:03,53,2084,21,32,1257.90,2111.08,0.00
2024-12-08 14:54:04,53,2085,21,32,1262.86,2112.00,0.00
2024-12-08 14:54:04,54,2085,22,32,1239.48,2112.02,0.00
2024-12-08 14:54:04,54,2086,22,32,1236.90,2113.00,0.00
2024-12-08 14:54:04,55,2086,23,32,1214.41,2113.02,0.00
2024-12-08 14:54:04,54,2086,23,31,1228.30,2113.07,0.00
2024-12-08 14:54:04,53,2086,22,31,1245.15,2113.38,0.00
2024-12-08 14:54:04,53,2087,22,31,1256.36,2114.00,0.00
2024-12-08 14:54:04,54,2087,23,31,1233.09,2114.02,0.00
2024-12-08 14:54:04,53,2087,22,31,1242.00,2114.06,0.00
2024-12-08 14:54:04,53,2088,22,31,1254.56,2115.00,0.00
2024-12-08 14:54:04,54,2088,23,31,1231.32,2115.02,0.00
2024-12-08 14:54:04,53,2088,23,30,1245.78,2115.06,0.00
2024-12-08 14:54:04,53,2089,23,30,1250.36,2116.00,0.00
2024-12-08 14:54:04,54,2089,24,30,1227.20,2116.02,0.00
2024-12-08 14:54:04,54,2090,24,30,1224.87,2117.00,0.00
2024-12-08 14:54:04,55,2090,24,31,1202.60,2117.02,0.00
2024-12-08 14:54:04,54,2090,24,30,1216.65,2117.06,0.00
2024-12-08 14:54:04,54,2091,24,30,1220.75,2118.00,0.00
2024-12-08 14:54:04,55,2091,24,31,1198.55,2118.02,0.00
2024-12-08 14:54:04,55,2092,24,31,1195.92,2119.00,0.00
2024-12-08 14:54:04,56,2092,24,32,1174.56,2119.02,0.00
2024-12-08 14:54:04,55,2092,24,31,1188.22,2119.05,0.00
2024-12-08 14:54:04,54,2092,23,31,1190.10,2119.41,0.00
2024-12-08 14:54:04,54,2093,23,31,1217.19,2120.00,0.00
2024-12-08 14:54:04,55,2093,23,32,1195.06,2120.02,0.00
2024-12-08 14:54:04,55,2094,23,32,1192.70,2121.00,0.00
2024-12-08 14:54:04,56,2094,23,33,1171.41,2121.02,0.00
2024-12-08 14:54:04,55,2094,23,32,1185.00,2121.05,0.00
2024-12-08 14:54:04,54,2094,22,32,1182.25,2121.50,0.00
2024-12-08 14:54:04,54,2095,22,32,1211.26,2122.00,0.00
2024-12-08 14:54:04,55,2095,22,33,1189.24,2122.02,0.00
2024-12-08 14:54:04,55,2096,22,33,1187.45,2123.00,0.00
2024-12-08 14:54:04,56,2096,23,33,1166.25,2123.02,0.00
2024-12-08 14:54:04,55,2096,23,32,1179.35,2123.05,0.00
2024-12-08 14:54:04,54,2096,22,32,1176.89,2123.85,0.00
2024-12-08 14:54:04,54,2097,22,32,1213.19,2124.00,0.00
2024-12-08 14:54:04,55,2097,22,33,1191.13,2124.02,0.00
2024-12-08 14:54:04,54,2097,21,33,1198.69,2124.19,0.00
2024-12-08 14:54:04,54,2098,21,33,1221.24,2125.00,0.00
2024-12-08 14:54:04,55,2098,22,33,1199.03,2125.02,0.00
2024-12-08 14:54:04,54,2098,22,32,1213.37,2125.06,0.00
2024-12-08 14:54:04,54,2099,22,32,1217.48,2126.00,0.00
2024-12-08 14:54:04,55,2099,23,32,1195.35,2126.02,0.00
2024-12-08 14:54:04,54,2099,22,32,1201.75,2126.24,0.00
2024-12-08 14:54:04,54,2100,22,32,1225.48,2127.00,0.00
2024-12-08 14:54:04,55,2100,23,32,1203.20,2127.02,0.00
2024-12-08 14:54:04,54,2100,23,31,1218.00,2127.06,0.00
2024-12-08 14:54:04,54,2101,23,31,1222.12,2128.00,0.00
2024-12-08 14:54:04,55,2101,24,31,1199.90,2128.02,0.00
2024-12-08 14:54:04,54,2101,23,31,1202.45,2128.57,0.00
2024-12-08 14:54:04,54,2102,23,31,1219.50,2129.00,0.00
2024-12-08 14:54:04,55,2102,24,31,1197.33,2129.02,0.00
2024-12-08 14:54:04,54,2102,24,30,1212.41,2129.06,0.00
2024-12-08 14:54:04,53,2102,23,30,1207.12,2129.96,0.00
2024-12-08 14:54:04,53,2103,23,30,1246.53,2130.00,0.00
2024-12-08 14:54:04,54,2103,23,31,1223.44,2130.02,0.00
2024-12-08 14:54:04,54,2104,23,31,1221.04,2131.00,0.00
2024-12-08 14:54:04,55,2104,24,31,1198.84,2131.02,0.00
2024-12-08 14:54:04,54,2104,23,31,1220.38,2131.04,0.00
2024-12-08 14:54:04,53,2104,23,30,1236.57,2131.04,0.00
2024-12-08 14:54:04,53,2105,23,30,1240.77,2132.00,0.00
2024-12-08 14:54:04,54,2105,23,31,1217.80,2132.02,0.00
2024-12-08 14:54:04,54,2106,23,31,1215.26,2133.00,0.00
2024-12-08 14:54:04,55,2106,24,31,1193.16,2133.02,0.00
2024-12-08 14:54:04,54,2106,23,31,1214.86,2133.02,0.00
2024-12-08 14:54:04,53,2106,23,30,1231.34,2133.02,0.00
2024-12-08 14:54:04,52,2106,22,30,1239.85,2133.60,0.00
2024-12-08 14:54:04,52,2107,22,30,1272.56,2134.00,0.00
2024-12-08 14:54:04,53,2107,22,31,1248.55,2134.02,0.00
2024-12-08 14:54:04,53,2108,22,31,1245.94,2135.00,0.00
2024-12-08 14:54:04,54,2108,22,32,1222.86,2135.02,0.00
2024-12-08 14:54:04,53,2108,22,31,1239.49,2135.02,0.00
2024-12-08 14:54:04,52,2108,21,31,1241.55,2135.81,0.00
2024-12-08 14:54:04,52,2109,21,31,1278.68,2136.00,0.00
2024-12-08 14:54:04,53,2109,21,32,1254.56,2136.02,0.00
2024-12-08 14:54:04,52,2109,20,32,1269.25,2136.08,0.00
2024-12-08 14:54:04,52,2110,20,32,1275.95,2137.00,0.00
2024-12-08 14:54:04,53,2110,21,32,1251.88,2137.02,0.00
2024-12-08 14:54:04,52,2110,21,31,1270.20,2137.02,0.00
2024-12-08 14:54:04,51,2110,20,31,1272.30,2137.47,0.00
2024-12-08 14:54:04,51,2111,20,31,1303.30,2138.00,0.00
2024-12-08 14:54:04,52,2111,20,32,1278.24,2138.02,0.00
2024-12-08 14:54:05,52,2112,20,32,1275.11,2139.00,0.00
2024-12-08 14:54:05,53,2112,20,33,1251.06,2139.02,0.00
2024-12-08 14:54:05,52,2112,20,32,1269.35,2139.02,0.00
2024-12-08 14:54:05,52,2113,20,32,1273.65,2140.00,0.00
2024-12-08 14:54:05,53,2113,21,32,1249.62,2140.02,0.00
2024-12-08 14:54:05,52,2113,20,32,1242.59,2140.50,0.00
2024-12-08 14:54:05,52,2114,20,32,1273.42,2141.00,0.00
2024-12-08 14:54:05,53,2114,20,33,1249.40,2141.02,0.00
2024-12-08 14:54:05,52,2114,20,32,1267.66,2141.02,0.00
2024-12-08 14:54:05,51,2114,19,32,1281.23,2141.55,0.00
2024-12-08 14:54:05,51,2115,19,32,1297.13,2142.00,0.00
2024-12-08 14:54:05,52,2115,20,32,1272.18,2142.02,0.00
2024-12-08 14:54:05,52,2116,20,32,1269.98,2143.00,0.00
2024-12-08 14:54:05,53,2116,20,33,1246.02,2143.02,0.00
2024-12-08 14:54:05,52,2116,20,32,1262.97,2143.02,0.00
2024-12-08 14:54:05,51,2116,19,32,1284.72,2143.06,0.00
2024-12-08 14:54:05,51,2117,19,32,1307.17,2144.00,0.00
2024-12-08 14:54:05,52,2117,20,32,1282.03,2144.02,0.00
2024-12-08 14:54:05,51,2117,19,32,1277.09,2144.47,0.00
2024-12-08 14:54:05,51,2118,19,32,1308.20,2145.00,0.00
2024-12-08 14:54:05,52,2118,19,33,1283.04,2145.02,0.00
2024-12-08 14:54:05,51,2118,19,32,1301.05,2145.02,0.00
2024-12-08 14:54:05,51,2119,19,32,1305.86,2146.00,0.00
2024-12-08 14:54:05,52,2119,19,33,1280.75,2146.02,0.00
2024-12-08 14:54:05,52,2120,19,33,1278.27,2147.00,0.00
2024-12-08 14:54:05,53,2120,19,34,1254.15,2147.02,0.00
2024-12-08 14:54:05,52,2120,19,33,1271.67,2147.02,0.00
2024-12-08 14:54:05,52,2121,19,33,1275.98,2148.00,0.00
2024-12-08 14:54:05,53,2121,19,34,1251.90,2148.02,0.00
2024-12-08 14:54:05,52,2121,18,34,1249.52,2148.73,0.00
2024-12-08 14:54:05,52,2122,18,34,1285.27,2149.00,0.00
2024-12-08 14:54:05,53,2122,18,35,1261.02,2149.02,0.00
2024-12-08 14:54:05,52,2122,18,34,1278.65,2149.02,0.00
2024-12-08 14:54:05,52,2123,18,34,1282.97,2150.00,0.00
2024-12-08 14:54:05,53,2123,19,34,1258.76,2150.02,0.00
2024-12-08 14:54:05,53,2124,19,34,1256.52,2151.00,0.00
2024-12-08 14:54:05,54,2124,20,34,1233.25,2151.02,0.00
2024-12-08 14:54:05,53,2124,20,33,1250.03,2151.02,0.00
2024-12-08 14:54:05,53,2125,20,33,1253.85,2152.00,0.00
2024-12-08 14:54:05,54,2125,20,34,1230.64,2152.02,0.00
2024-12-08 14:54:05,53,2125,19,34,1222.80,2152.83,0.00
2024-12-08 14:54:05,53,2126,19,34,1259.90,2153.00,0.00
2024-12-08 14:54:05,54,2126,20,34,1236.57,2153.02,0.00
2024-12-08 14:54:05,53,2126,20,33,1253.81,2153.02,0.00
2024-12-08 14:54:05,53,2127,20,33,1257.64,2154.00,0.00
2024-12-08 14:54:05,54,2127,21,33,1234.35,2154.02,0.00
2024-12-08 14:54:05,54,2128,21,33,1231.58,2155.00,0.00
2024-12-08 14:54:05,55,2128,21,34,1209.19,2155.02,0.00
2024-12-08 14:54:05,54,2128,21,33,1225.99,2155.02,0.00
2024-12-08 14:54:05,54,2129,21,33,1229.35,2156.00,0.00
2024-12-08 14:54:05,55,2129,21,34,1207.00,2156.02,0.00
2024-12-08 14:54:05,55,2130,21,34,1203.98,2157.00,0.00
2024-12-08 14:54:05,56,2130,22,34,1182.48,2157.02,0.00
2024-12-08 14:54:05,55,2130,22,33,1198.88,2157.02,0.00
2024-12-08 14:54:05,54,2130,21,33,1219.51,2157.09,0.00
2024-12-08 14:54:05,53,2130,20,33,1218.20,2157.89,0.00
2024-12-08 14:54:05,53,2131,20,33,1256.56,2158.00,0.00
2024-12-08 14:54:05,54,2131,21,33,1233.29,2158.02,0.00
2024-12-08 14:54:05,54,2132,21,33,1230.03,2159.00,0.00
2024-12-08 14:54:05,55,2132,21,34,1207.67,2159.02,0.00
2024-12-08 14:54:05,54,2132,21,33,1225.24,2159.02,0.00
2024-12-08 14:54:05,53,2132,20,33,1247.38,2159.06,0.00
2024-12-08 14:54:05,52,2132,19,33,1270.96,2159.08,0.00
2024-12-08 14:54:05,52,2133,19,33,1276.51,2160.00,0.00
2024-12-08 14:54:05,53,2133,19,34,1252.43,2160.02,0.00
2024-12-08 14:54:05,53,2134,19,34,1248.80,2161.00,0.00
2024-12-08 14:54:05,54,2134,20,34,1225.68,2161.02,0.00
2024-12-08 14:54:05,53,2134,20,33,1244.32,2161.02,0.00
2024-12-08 14:54:05,52,2134,19,33,1267.02,2161.08,0.00
2024-12-08 14:54:05,51,2134,18,33,1279.88,2161.65,0.00
2024-12-08 14:54:05,50,2134,17,33,1290.73,2161.96,0.00
2024-12-08 14:54:05,50,2135,17,33,1333.13,2162.00,0.00
2024-12-08 14:54:05,51,2135,18,33,1306.99,2162.02,0.00
2024-12-08 14:54:05,50,2135,17,33,1323.43,2162.06,0.00
2024-12-08 14:54:05,50,2136,17,33,1329.66,2163.00,0.00
2024-12-08 14:54:05,51,2136,18,33,1303.59,2163.02,0.00
2024-12-08 14:54:05,50,2136,18,32,1324.47,2163.02,0.00
2024-12-08 14:54:05,50,2137,18,32,1329.84,2164.00,0.00
2024-12-08 14:54:05,51,2137,18,33,1303.76,2164.02,0.00
2024-12-08 14:54:05,51,2138,18,33,1300.29,2165.00,0.00
2024-12-08 14:54:05,52,2138,18,34,1275.29,2165.02,0.00
2024-12-08 14:54:05,51,2138,18,33,1294.77,2165.02,0.00
2024-12-08 14:54:05,50,2138,17,33,1319.82,2165.06,0.00
2024-12-08 14:54:05,49,2138,16,33,1326.86,2165.43,0.00
2024-12-08 14:54:05,49,2139,16,33,1359.12,2166.00,0.00
2024-12-08 14:54:05,50,2139,17,33,1331.94,2166.02,0.00
2024-12-08 14:54:06,50,2140,17,33,1329.24,2167.00,0.00
2024-12-08 14:54:06,51,2140,17,34,1303.18,2167.02,0.00
2024-12-08 14:54:06,50,2140,17,33,1321.88,2167.04,0.00
2024-12-08 14:54:06,49,2140,16,33,1325.03,2167.49,0.00
2024-12-08 14:54:06,49,2141,16,33,1358.60,2168.00,0.00
2024-12-08 14:54:06,50,2141,16,34,1331.43,2168.02,0.00
2024-12-08 14:54:06,49,2141,15,34,1333.49,2168.31,0.00
2024-12-08 14:54:06,49,2142,15,34,1363.20,2169.00,0.00
2024-12-08 14:54:06,50,2142,15,35,1335.94,2169.02,0.00
2024-12-08 14:54:06,49,2142,15,34,1353.04,2169.08,0.00
2024-12-08 14:54:06,49,2143,15,34,1360.29,2170.00,0.00
2024-12-08 14:54:06,50,2143,16,34,1333.08,2170.02,0.00
2024-12-08 14:54:06,50,2144,16,34,1332.23,2171.00,0.00
2024-12-08 14:54:06,51,2144,17,34,1306.10,2171.02,0.00
2024-12-08 14:54:06,50,2144,17,33,1321.83,2171.08,0.00
2024-12-08 14:54:06,50,2145,17,33,1328.50,2172.00,0.00
2024-12-08 14:54:06,51,2145,17,34,1302.45,2172.02,0.00
2024-12-08 14:54:06,50,2145,16,34,1312.86,2172.04,0.00
2024-12-08 14:54:06,50,2146,16,34,1327.37,2173.00,0.00
2024-12-08 14:54:06,51,2146,17,34,1301.34,2173.02,0.00
2024-12-08 14:54:06,50,2146,16,34,1324.34,2173.08,0.00
2024-12-08 14:54:06,50,2147,16,34,1339.72,2174.00,0.00
2024-12-08 14:54:06,51,2147,16,35,1313.45,2174.02,0.00
2024-12-08 14:54:06,50,2147,16,34,1333.20,2174.04,0.00
2024-12-08 14:54:06,50,2148,16,34,1339.03,2175.00,0.00
2024-12-08 14:54:06,51,2148,16,35,1312.78,2175.02,0.00
2024-12-08 14:54:06,51,2149,16,35,1309.11,2176.00,0.00
2024-12-08 14:54:06,52,2149,17,35,1283.94,2176.02,0.00
2024-12-08 14:54:06,51,2149,17,34,1307.41,2176.06,0.00
2024-12-08 14:54:06,51,2150,17,34,1313.13,2177.00,0.00
2024-12-08 14:54:06,52,2150,18,34,1287.88,2177.02,0.00
2024-12-08 14:54:06,51,2150,17,34,1277.02,2177.65,0.00
2024-12-08 14:54:06,51,2151,17,34,1312.31,2178.00,0.00
2024-12-08 14:54:06,52,2151,17,35,1287.08,2178.02,0.00
2024-12-08 14:54:06,51,2151,17,34,1302.50,2178.06,0.00
2024-12-08 14:54:06,51,2152,17,34,1308.22,2179.00,0.00
2024-12-08 14:54:06,52,2152,18,34,1283.06,2179.02,0.00
2024-12-08 14:54:06,51,2152,17,34,1307.53,2179.04,0.00
2024-12-08 14:54:06,50,2152,16,34,1314.87,2179.50,0.00
2024-12-08 14:54:06,50,2153,16,34,1333.62,2180.00,0.00
2024-12-08 14:54:06,51,2153,16,35,1307.48,2180.02,0.00
2024-12-08 14:54:06,50,2153,16,34,1324.47,2180.04,0.00
2024-12-08 14:54:06,50,2154,16,34,1330.31,2181.00,0.00
2024-12-08 14:54:06,51,2154,17,34,1304.23,2181.02,0.00
2024-12-08 14:54:06,51,2155,17,34,1302.49,2182.00,0.00
2024-12-08 14:54:06,52,2155,17,35,1277.44,2182.02,0.00
2024-12-08 14:54:06,51,2155,17,34,1293.93,2182.04,0.00
2024-12-08 14:54:06,51,2156,17,34,1299.23,2183.00,0.00
2024-12-08 14:54:06,52,2156,18,34,1274.25,2183.02,0.00
2024-12-08 14:54:06,52,2157,18,34,1272.24,2184.00,0.00
2024-12-08 14:54:06,53,2157,19,34,1248.24,2184.02,0.00
2024-12-08 14:54:06,52,2157,19,33,1264.26,2184.04,0.00
2024-12-08 14:54:06,52,2158,19,33,1269.04,2185.00,0.00
2024-12-08 14:54:06,53,2158,19,34,1245.10,2185.02,0.00
2024-12-08 14:54:06,53,2159,19,34,1242.96,2186.00,0.00
2024-12-08 14:54:06,54,2159,19,35,1219.94,2186.02,0.00
2024-12-08 14:54:06,53,2159,19,34,1235.54,2186.04,0.00
2024-12-08 14:54:06,53,2160,19,34,1239.81,2187.00,0.00
2024-12-08 14:54:06,54,2160,20,34,1216.86,2187.02,0.00
2024-12-08 14:54:06,54,2161,20,34,1215.21,2188.00,0.00
2024-12-08 14:54:06,55,2161,21,34,1193.11,2188.02,0.00
2024-12-08 14:54:06,54,2161,21,33,1207.92,2188.04,0.00
2024-12-08 14:54:06,54,2162,21,33,1211.71,2189.00,0.00
2024-12-08 14:54:06,55,2162,21,34,1189.68,2189.02,0.00
2024-12-08 14:54:06,54,2162,20,34,1210.10,2189.07,0.00
2024-12-08 14:54:06,53,2162,19,34,1202.53,2189.79,0.00
2024-12-08 14:54:06,53,2163,19,34,1239.45,2190.00,0.00
2024-12-08 14:54:06,54,2163,20,34,1216.50,2190.02,0.00
2024-12-08 14:54:06,53,2163,20,33,1229.54,2190.08,0.00
2024-12-08 14:54:06,52,2163,19,33,1244.07,2190.50,0.00
2024-12-08 14:54:06,52,2164,19,33,1258.74,2191.00,0.00
2024-12-08 14:54:06,53,2164,20,33,1234.99,2191.02,0.00
2024-12-08 14:54:06,53,2165,20,33,1234.59,2192.00,0.00
2024-12-08 14:54:06,54,2165,20,34,1211.73,2192.02,0.00
2024-12-08 14:54:06,53,2165,19,34,1233.93,2192.04,0.00
2024-12-08 14:54:06,52,2165,19,33,1248.39,2192.06,0.00
2024-12-08 14:54:06,51,2165,18,33,1259.01,2192.67,0.00
2024-12-08 14:54:06,51,2166,18,33,1294.94,2193.00,0.00
2024-12-08 14:54:06,52,2166,19,33,1270.04,2193.02,0.00
2024-12-08 14:54:06,52,2167,19,33,1269.32,2194.00,0.00
2024-12-08 14:54:06,53,2167,20,33,1245.38,2194.02,0.00
2024-12-08 14:54:06,52,2167,20,32,1259.63,2194.06,0.00
2024-12-08 14:54:06,52,2168,20,32,1264.84,2195.00,0.00
2024-12-08 14:54:06,53,2168,20,33,1240.97,2195.02,0.00
2024-12-08 14:54:06,53,2169,20,33,1240.30,2196.00,0.00
2024-12-08 14:54:06,54,2169,20,34,1217.33,2196.02,0.00
2024-12-08 14:54:06,53,2169,20,33,1231.19,2196.06,0.00
2024-12-08 14:54:07,52,2169,19,33,1243.96,2196.56,0.00
2024-12-08 14:54:07,52,2170,19,33,1259.90,2197.00,0.00
2024-12-08 14:54:07,53,2170,20,33,1236.13,2197.02,0.00
2024-12-08 14:54:07,52,2170,19,33,1228.84,2197.48,0.00
2024-12-08 14:54:07,52,2171,19,33,1260.05,2198.00,0.00
2024-12-08 14:54:07,53,2171,19,34,1236.27,2198.02,0.00
2024-12-08 14:54:07,52,2171,19,33,1251.18,2198.06,0.00
2024-12-08 14:54:07,52,2172,19,33,1256.39,2199.00,0.00
2024-12-08 14:54:07,53,2172,19,34,1232.69,2199.02,0.00
2024-12-08 14:54:07,52,2172,18,34,1220.47,2199.87,0.00
2024-12-08 14:54:07,52,2173,18,34,1259.92,2200.00,0.00
2024-12-08 14:54:07,53,2173,18,35,1236.15,2200.02,0.00
2024-12-08 14:54:07,52,2173,18,34,1251.04,2200.06,0.00
2024-12-08 14:54:07,51,2173,17,34,1263.36,2200.63,0.00
2024-12-08 14:54:07,51,2174,17,34,1281.32,2201.00,0.00
2024-12-08 14:54:07,52,2174,18,34,1256.68,2201.02,0.00
2024-12-08 14:54:07,51,2174,18,33,1280.89,2201.02,0.00
2024-12-08 14:54:07,50,2174,17,33,1273.59,2201.78,0.00
2024-12-08 14:54:07,50,2175,17,33,1312.97,2202.00,0.00
2024-12-08 14:54:07,51,2175,18,33,1287.23,2202.02,0.00
2024-12-08 14:54:07,50,2175,18,32,1304.61,2202.04,0.00
2024-12-08 14:54:07,50,2176,18,32,1310.48,2203.00,0.00
2024-12-08 14:54:07,51,2176,18,33,1284.79,2203.02,0.00
2024-12-08 14:54:07,51,2177,18,33,1283.56,2204.00,0.00
2024-12-08 14:54:07,52,2177,18,34,1258.87,2204.02,0.00
2024-12-08 14:54:07,51,2177,18,33,1275.35,2204.04,0.00
2024-12-08 14:54:07,51,2178,18,33,1280.68,2205.00,0.00
2024-12-08 14:54:07,52,2178,18,34,1256.05,2205.02,0.00
2024-12-08 14:54:07,51,2178,17,34,1271.18,2205.06,0.00
2024-12-08 14:54:07,50,2178,16,34,1276.49,2205.44,0.00
2024-12-08 14:54:07,50,2179,16,34,1308.65,2206.00,0.00
2024-12-08 14:54:07,51,2179,16,35,1282.99,2206.02,0.00
2024-12-08 14:54:07,50,2179,16,34,1300.27,2206.04,0.00
2024-12-08 14:54:07,49,2179,15,34,1315.44,2206.55,0.00
2024-12-08 14:54:07,48,2179,14,34,1331.60,2206.77,0.00
2024-12-08 14:54:07,48,2180,14,34,1372.70,2207.00,0.00
2024-12-08 14:54:07,49,2180,14,35,1344.68,2207.02,0.00
2024-12-08 14:54:07,48,2180,13,35,1353.46,2207.17,0.00
2024-12-08 14:54:07,48,2181,13,35,1381.63,2208.00,0.00
2024-12-08 14:54:07,49,2181,14,35,1353.43,2208.02,0.00
2024-12-08 14:54:07,48,2181,14,34,1372.89,2208.04,0.00
2024-12-08 14:54:07,49,2180,14,35,1340.89,2208.27,0.00
2024-12-08 14:54:07,49,2181,14,35,1373.43,2209.00,0.00
2024-12-08 14:54:07,50,2181,14,36,1345.96,2209.02,0.00
2024-12-08 14:54:07,50,2182,14,36,1388.27,2210.00,0.00
2024-12-08 14:54:07,51,2182,14,37,1361.05,2210.02,0.00
2024-12-08 14:54:07,50,2182,14,36,1380.32,2210.04,0.00
2024-12-08 14:54:07,49,2182,13,36,1391.55,2210.67,0.00
2024-12-08 14:54:07,49,2183,13,36,1429.72,2211.00,0.00
2024-12-08 14:54:07,50,2183,14,36,1401.13,2211.02,0.00
2024-12-08 14:54:07,49,2183,13,36,1416.67,2211.12,0.00
2024-12-08 14:54:07,49,2184,13,36,1443.01,2212.00,0.00
2024-12-08 14:54:07,50,2184,13,37,1414.15,2212.02,0.00
2024-12-08 14:54:07,49,2184,13,36,1435.34,2212.04,0.00
2024-12-08 14:54:07,50,2183,13,37,1388.17,2212.94,0.00
2024-12-08 14:54:07,50,2184,13,37,1414.79,2213.00,0.00
2024-12-08 14:54:07,51,2184,13,38,1387.05,2213.02,0.00
2024-12-08 14:54:07,51,2185,13,38,1426.85,2214.00,0.00
2024-12-08 14:54:07,52,2185,13,39,1399.41,2214.02,0.00
2024-12-08 14:54:07,51,2185,13,38,1419.91,2214.04,0.00
2024-12-08 14:54:07,50,2185,12,38,1430.00,2214.72,0.00
2024-12-08 14:54:07,50,2186,12,38,1468.34,2215.00,0.00
2024-12-08 14:54:07,51,2186,12,39,1439.55,2215.02,0.00
2024-12-08 14:54:07,51,2187,12,39,1435.85,2216.00,0.00
2024-12-08 14:54:07,52,2187,13,39,1408.24,2216.02,0.00
2024-12-08 14:54:07,51,2187,13,38,1429.34,2216.04,0.00
2024-12-08 14:54:07,50,2187,12,38,1432.34,2216.90,0.00
2024-12-08 14:54:07,50,2188,12,38,1474.54,2217.00,0.00
2024-12-08 14:54:07,51,2188,12,39,1445.63,2217.02,0.00
2024-12-08 14:54:07,51,2189,12,39,1441.93,2218.00,0.00
2024-12-08 14:54:07,52,2189,12,40,1414.20,2218.02,0.00
2024-12-08 14:54:07,51,2189,12,39,1434.98,2218.04,0.00
2024-12-08 14:54:07,51,2190,12,39,1440.41,2219.00,0.00
2024-12-08 14:54:07,52,2190,13,39,1412.71,2219.02,0.00
2024-12-08 14:54:07,51,2190,12,39,1403.60,2219.96,0.00
2024-12-08 14:54:07,51,2191,12,39,1446.28,2220.00,0.00
2024-12-08 14:54:07,52,2191,13,39,1418.47,2220.02,0.00
2024-12-08 14:54:07,51,2191,13,38,1438.88,2220.04,0.00
2024-12-08 14:54:07,51,2192,13,38,1444.32,2221.00,0.00
2024-12-08 14:54:07,52,2192,13,39,1416.54,2221.02,0.00
2024-12-08 14:54:07,52,2193,13,39,1412.48,2222.00,0.00
2024-12-08 14:54:07,53,2193,13,40,1385.83,2222.02,0.00
2024-12-08 14:54:07,52,2193,13,39,1405.65,2222.04,0.00
2024-12-08 14:54:07,52,2194,13,39,1410.55,2223.00,0.00
2024-12-08 14:54:07,53,2194,13,40,1383.94,2223.02,0.00
2024-12-08 14:54:07,53,2195,13,40,1379.98,2224.00,0.00
2024-12-08 14:54:07,54,2195,14,40,1354.42,2224.02,0.00
2024-12-08 14:54:07,53,2195,14,39,1372.84,2224.04,0.00
2024-12-08 14:54:07,52,2195,13,39,1372.84,2224.92,0.00
2024-12-08 14:54:08,52,2196,13,39,1413.96,2225.00,0.00
2024-12-08 14:54:08,53,2196,14,39,1387.28,2225.02,0.00
2024-12-08 14:54:08,53,2197,14,39,1394.99,2226.00,0.00
2024-12-08 14:54:08,54,2197,14,40,1369.15,2226.02,0.00
2024-12-08 14:54:08,53,2197,13,40,1385.53,2226.06,0.00
2024-12-08 14:54:08,53,2198,13,40,1399.18,2227.00,0.00
2024-12-08 14:54:08,54,2198,14,40,1373.27,2227.02,0.00
2024-12-08 14:54:08,54,2199,14,40,1370.60,2228.00,0.00
2024-12-08 14:54:08,55,2199,15,40,1345.68,2228.02,0.00
2024-12-08 14:54:08,54,2199,14,40,1370.19,2228.02,0.00
2024-12-08 14:54:08,53,2199,14,39,1387.22,2228.02,0.00
2024-12-08 14:54:08,53,2200,14,39,1391.20,2229.00,0.00
2024-12-08 14:54:08,54,2200,14,40,1365.44,2229.02,0.00
2024-12-08 14:54:08,54,2201,14,40,1360.68,2230.00,0.00
2024-12-08 14:54:08,55,2201,15,40,1335.94,2230.02,0.00
2024-12-08 14:54:08,54,2201,15,39,1354.08,2230.04,0.00
2024-12-08 14:54:08,53,2201,14,39,1363.78,2230.36,0.00
2024-12-08 14:54:08,53,2202,14,39,1392.03,2231.00,0.00
2024-12-08 14:54:08,54,2202,15,39,1366.25,2231.02,0.00
2024-12-08 14:54:08,54,2203,15,39,1361.49,2232.00,0.00
2024-12-08 14:54:08,55,2203,16,39,1336.74,2232.02,0.00
2024-12-08 14:54:08,54,2203,16,38,1355.29,2232.04,0.00
2024-12-08 14:54:08,53,2203,15,38,1358.33,2232.47,0.00
2024-12-08 14:54:08,53,2204,15,38,1389.07,2233.00,0.00
2024-12-08 14:54:08,54,2204,15,39,1363.34,2233.02,0.00
2024-12-08 14:54:08,54,2205,15,39,1358.99,2234.00,0.00
2024-12-08 14:54:08,55,2205,16,39,1334.28,2234.02,0.00
2024-12-08 14:54:08,54,2205,16,38,1351.96,2234.06,0.00
2024-12-08 14:54:08,54,2206,16,38,1356.28,2235.00,0.00
2024-12-08 14:54:08,55,2206,16,39,1331.62,2235.02,0.00
2024-12-08 14:54:08,54,2206,15,39,1320.42,2235.94,0.00
2024-12-08 14:54:08,54,2207,15,39,1360.62,2236.00,0.00
2024-12-08 14:54:08,55,2207,15,40,1335.88,2236.02,0.00
2024-12-08 14:54:08,54,2207,15,39,1354.00,2236.06,0.00
2024-12-08 14:54:08,54,2208,15,39,1358.33,2237.00,0.00
2024-12-08 14:54:08,55,2208,15,40,1333.63,2237.02,0.00
2024-12-08 14:54:08,55,2209,15,40,1330.32,2238.00,0.00
2024-12-08 14:54:08,56,2209,15,41,1306.57,2238.02,0.00
2024-12-08 14:54:08,55,2209,15,40,1321.39,2238.09,0.00
2024-12-08 14:54:08,54,2209,14,40,1344.45,2238.09,0.00
2024-12-08 14:54:08,54,2210,14,40,1366.18,2239.00,0.00
2024-12-08 14:54:08,55,2210,15,40,1341.34,2239.02,0.00
2024-12-08 14:54:08,55,2211,15,40,1338.38,2240.00,0.00
2024-12-08 14:54:08,56,2211,15,41,1314.48,2240.02,0.00
2024-12-08 14:54:08,55,2211,15,40,1329.03,2240.09,0.00
2024-12-08 14:54:08,54,2211,14,40,1340.70,2240.67,0.00
2024-12-08 14:54:08,54,2212,14,40,1358.38,2241.00,0.00
2024-12-08 14:54:08,55,2212,15,40,1333.68,2241.02,0.00
2024-12-08 14:54:08,54,2212,14,40,1321.39,2241.74,0.00
2024-12-08 14:54:08,54,2213,14,40,1357.30,2242.00,0.00
2024-12-08 14:54:08,55,2213,14,41,1332.62,2242.02,0.00
2024-12-08 14:54:08,54,2213,14,40,1347.77,2242.09,0.00
2024-12-08 14:54:08,54,2214,14,40,1352.92,2243.00,0.00
2024-12-08 14:54:08,55,2214,15,40,1328.32,2243.02,0.00
2024-12-08 14:54:08,55,2215,15,40,1325.29,2244.00,0.00
2024-12-08 14:54:08,56,2215,16,40,1301.62,2244.02,0.00
2024-12-08 14:54:08,55,2215,16,39,1315.92,2244.09,0.00
2024-12-08 14:54:08,54,2215,15,39,1340.29,2244.09,0.00
2024-12-08 14:54:08,54,2216,15,39,1345.44,2245.00,0.00
2024-12-08 14:54:08,55,2216,15,40,1320.98,2245.02,0.00
2024-12-08 14:54:08,55,2217,15,40,1318.34,2246.00,0.00
2024-12-08 14:54:08,56,2217,15,41,1294.80,2246.02,0.00
2024-12-08 14:54:08,55,2217,15,40,1308.15,2246.11,0.00
2024-12-08 14:54:08,55,2218,15,40,1313.21,2247.00,0.00
2024-12-08 14:54:08,56,2218,16,40,1289.76,2247.02,0.00
2024-12-08 14:54:08,56,2219,16,40,1287.11,2248.00,0.00
2024-12-08 14:54:08,57,2219,17,40,1264.53,2248.02,0.00
2024-12-08 14:54:08,56,2219,17,39,1277.50,2248.11,0.00
2024-12-08 14:54:08,55,2219,16,39,1300.72,2248.11,0.00
2024-12-08 14:54:09,55,2220,16,39,1305.78,2249.00,0.00
2024-12-08 14:54:09,56,2220,17,39,1282.46,2249.02,0.00
2024-12-08 14:54:09,55,2220,16,39,1275.15,2249.84,0.00
2024-12-08 14:54:09,55,2221,16,39,1312.50,2250.00,0.00
2024-12-08 14:54:09,56,2221,16,40,1289.06,2250.02,0.00
2024-12-08 14:54:09,55,2221,16,39,1302.29,2250.11,0.00
2024-12-08 14:54:09,55,2222,16,39,1307.35,2251.00,0.00
2024-12-08 14:54:09,56,2222,17,39,1284.01,2251.02,0.00
2024-12-08 14:54:09,57,2221,18,39,1240.83,2251.63,0.00
2024-12-08 14:54:09,57,2222,18,39,1298.63,2252.00,0.00
2024-12-08 14:54:09,58,2222,19,39,1276.24,2252.02,0.00
2024-12-08 14:54:09,57,2222,18,39,1298.29,2252.02,0.00
2024-12-08 14:54:09,56,2222,18,38,1311.44,2252.09,0.00
2024-12-08 14:54:09,56,2223,18,38,1355.85,2253.00,0.00
2024-12-08 14:54:09,57,2223,19,38,1332.07,2253.02,0.00
2024-12-08 14:54:09,56,2223,18,38,1328.95,2253.68,0.00
2024-12-08 14:54:09,56,2224,18,38,1362.20,2254.00,0.00
2024-12-08 14:54:09,57,2224,18,39,1338.30,2254.02,0.00
2024-12-08 14:54:09,58,2223,19,39,1314.46,2254.09,0.00
2024-12-08 14:54:09,58,2224,19,39,1340.70,2255.00,0.00
2024-12-08 14:54:09,59,2224,20,39,1317.97,2255.02,0.00
2024-12-08 14:54:09,58,2224,20,38,1335.64,2255.02,0.00
2024-12-08 14:54:09,57,2224,20,37,1357.52,2255.07,0.00
2024-12-08 14:54:09,56,2224,19,37,1380.15,2255.09,0.00
2024-12-08 14:54:09,56,2225,19,37,1440.76,2256.00,0.00
2024-12-08 14:54:09,57,2225,19,38,1415.48,2256.02,0.00
2024-12-08 14:54:09,57,2226,19,38,1422.40,2257.00,0.00
2024-12-08 14:54:09,58,2226,20,38,1397.88,2257.02,0.00
2024-12-08 14:54:09,58,2227,20,38,1402.76,2258.00,0.00
2024-12-08 14:54:09,59,2227,20,39,1378.98,2258.02,0.00
2024-12-08 14:54:09,59,2228,20,39,1373.41,2259.00,0.00
2024-12-08 14:54:09,60,2228,21,39,1350.52,2259.02,0.00
2024-12-08 14:54:09,59,2228,20,39,1353.73,2259.56,0.00
2024-12-08 14:54:09,59,2229,20,39,1373.61,2260.00,0.00
2024-12-08 14:54:09,60,2229,21,39,1350.72,2260.02,0.00
2024-12-08 14:54:09,59,2229,21,38,1365.96,2260.07,0.00
2024-12-08 14:54:09,58,2229,20,38,1365.97,2260.50,0.00
2024-12-08 14:54:09,58,2230,20,38,1394.02,2261.00,0.00
2024-12-08 14:54:09,59,2230,21,38,1370.39,2261.02,0.00
2024-12-08 14:54:09,59,2231,21,38,1364.10,2262.00,0.00
2024-12-08 14:54:09,60,2231,21,39,1341.36,2262.02,0.00
2024-12-08 14:54:09,60,2232,21,39,1335.81,2263.00,0.00
2024-12-08 14:54:09,61,2232,22,39,1313.91,2263.02,0.00
2024-12-08 14:54:09,60,2232,22,38,1330.91,2263.03,0.00
2024-12-08 14:54:09,60,2233,22,38,1332.25,2264.00,0.00
2024-12-08 14:54:09,61,2233,23,38,1310.41,2264.02,0.00
2024-12-08 14:54:09,60,2233,23,37,1325.09,2264.07,0.00
2024-12-08 14:54:09,60,2234,23,37,1327.17,2265.00,0.00
2024-12-08 14:54:09,61,2234,23,38,1305.42,2265.02,0.00
2024-12-08 14:54:09,61,2235,23,38,1299.52,2266.00,0.00
2024-12-08 14:54:09,62,2235,24,38,1278.56,2266.02,0.00
2024-12-08 14:54:09,61,2235,24,37,1292.84,2266.07,0.00
2024-12-08 14:54:09,61,2236,24,37,1294.52,2267.00,0.00
2024-12-08 14:54:09,62,2236,25,37,1273.64,2267.02,0.00
2024-12-08 14:54:09,62,2237,25,37,1268.46,2268.00,0.00
2024-12-08 14:54:09,63,2237,26,37,1248.33,2268.02,0.00
2024-12-08 14:54:09,62,2237,26,36,1261.52,2268.06,0.00
2024-12-08 14:54:09,62,2238,26,36,1262.80,2269.00,0.00
2024-12-08 14:54:09,63,2238,26,37,1242.75,2269.02,0.00
2024-12-08 14:54:09,62,2238,25,37,1237.28,2269.73,0.00
2024-12-08 14:54:09,63,2237,26,37,1215.19,2269.86,0.00
2024-12-08 14:54:09,63,2238,26,37,1265.75,2270.00,0.00
2024-12-08 14:54:09,64,2238,26,38,1245.97,2270.02,0.00
2024-12-08 14:54:09,63,2238,26,37,1259.27,2270.06,0.00
2024-12-08 14:54:09,63,2239,26,37,1296.23,2271.00,0.00
2024-12-08 14:54:09,64,2239,27,37,1275.97,2271.02,0.00
2024-12-08 14:54:09,63,2239,26,37,1275.40,2271.62,0.00
2024-12-08 14:54:09,62,2239,25,37,1292.77,2271.69,0.00
2024-12-08 14:54:09,62,2240,25,37,1322.69,2272.00,0.00
2024-12-08 14:54:09,63,2240,25,38,1301.70,2272.02,0.00
2024-12-08 14:54:09,62,2240,25,37,1322.33,2272.02,0.00
2024-12-08 14:54:09,61,2240,25,36,1338.05,2272.05,0.00
2024-12-08 14:54:09,60,2240,24,36,1338.99,2272.50,0.00
2024-12-08 14:54:09,60,2241,24,36,1365.87,2273.00,0.00
2024-12-08 14:54:09,61,2241,25,36,1343.48,2273.02,0.00
2024-12-08 14:54:10,61,2242,25,36,1336.61,2274.00,0.00
2024-12-08 14:54:10,62,2242,25,37,1315.05,2274.02,0.00
2024-12-08 14:54:10,61,2242,25,36,1331.03,2274.05,0.00
2024-12-08 14:54:10,60,2242,24,36,1339.70,2274.37,0.00
2024-12-08 14:54:10,60,2243,24,36,1363.66,2275.00,0.00
2024-12-08 14:54:10,61,2243,25,36,1341.30,2275.02,0.00
2024-12-08 14:54:10,60,2243,24,36,1342.05,2275.07,0.00
2024-12-08 14:54:10,60,2244,24,36,1359.33,2276.00,0.00
2024-12-08 14:54:10,61,2244,25,36,1337.04,2276.02,0.00
2024-12-08 14:54:10,60,2244,25,35,1354.02,2276.05,0.00
2024-12-08 14:54:10,60,2245,25,35,1355.75,2277.00,0.00
2024-12-08 14:54:10,61,2245,25,36,1333.52,2277.02,0.00
2024-12-08 14:54:10,61,2246,25,36,1327.43,2278.00,0.00
2024-12-08 14:54:10,62,2246,26,36,1306.02,2278.02,0.00
2024-12-08 14:54:10,61,2246,26,35,1321.09,2278.05,0.00
2024-12-08 14:54:10,60,2246,25,35,1323.12,2278.45,0.00
2024-12-08 14:54:10,61,2245,25,36,1297.79,2278.64,0.00
2024-12-08 14:54:10,61,2246,25,36,1335.07,2279.00,0.00
2024-12-08 14:54:10,62,2246,25,37,1313.54,2279.02,0.00
2024-12-08 14:54:10,62,2247,25,37,1343.32,2280.00,0.00
2024-12-08 14:54:10,63,2247,26,37,1321.99,2280.02,0.00
2024-12-08 14:54:10,62,2247,26,36,1338.91,2280.05,0.00
2024-12-08 14:54:10,61,2247,25,36,1341.08,2280.46,0.00
2024-12-08 14:54:10,61,2248,25,36,1366.53,2281.00,0.00
2024-12-08 14:54:10,62,2248,26,36,1344.49,2281.02,0.00
2024-12-08 14:54:10,62,2248,26,36,1337.35,2282.00,0.00
2024-12-08 14:54:10,63,2248,27,36,1316.12,2282.02,0.00
2024-12-08 14:54:10,62,2248,27,35,1333.30,2282.05,0.00
2024-12-08 14:54:10,62,2249,27,35,1334.25,2283.00,0.00
2024-12-08 14:54:10,63,2249,28,35,1313.07,2283.02,0.00
2024-12-08 14:54:10,63,2250,28,35,1305.67,2284.00,0.00
2024-12-08 14:54:10,64,2250,29,35,1285.27,2284.02,0.00
2024-12-08 14:54:10,63,2250,28,35,1305.31,2284.02,0.00
2024-12-08 14:54:10,62,2250,28,34,1322.68,2284.03,0.00
2024-12-08 14:54:10,62,2251,28,34,1323.26,2285.00,0.00
2024-12-08 14:54:10,63,2251,28,35,1302.25,2285.02,0.00
2024-12-08 14:54:10,63,2252,28,35,1294.84,2286.00,0.00
2024-12-08 14:54:10,64,2252,29,35,1274.61,2286.02,0.00
2024-12-08 14:54:10,63,2252,29,34,1291.94,2286.03,0.00
2024-12-08 14:54:10,63,2253,29,34,1292.14,2287.00,0.00
2024-12-08 14:54:10,64,2253,29,35,1271.95,2287.02,0.00
2024-12-08 14:54:10,64,2254,29,35,1264.29,2288.00,0.00
2024-12-08 14:54:10,65,2254,30,35,1244.83,2288.02,0.00
2024-12-08 14:54:10,64,2254,30,34,1261.78,2288.03,0.00
2024-12-08 14:54:10,63,2254,29,34,1264.88,2288.40,0.00
2024-12-08 14:54:10,62,2254,28,34,1279.89,2288.65,0.00
2024-12-08 14:54:10,62,2255,28,34,1308.96,2289.00,0.00
2024-12-08 14:54:10,63,2255,28,35,1288.18,2289.02,0.00
2024-12-08 14:54:10,63,2256,28,35,1280.75,2290.00,0.00
2024-12-08 14:54:10,64,2256,28,36,1260.74,2290.02,0.00
2024-12-08 14:54:10,63,2256,28,35,1278.57,2290.03,0.00
2024-12-08 14:54:10,62,2256,27,35,1296.90,2290.13,0.00
2024-12-08 14:54:10,62,2257,27,35,1299.66,2291.00,0.00
2024-12-08 14:54:10,63,2257,28,35,1279.03,2291.02,0.00
2024-12-08 14:54:10,63,2258,28,35,1271.58,2292.00,0.00
2024-12-08 14:54:10,64,2258,28,36,1251.71,2292.02,0.00
2024-12-08 14:54:10,63,2258,28,35,1269.76,2292.03,0.00
2024-12-08 14:54:10,62,2258,27,35,1263.88,2292.60,0.00
2024-12-08 14:54:10,62,2259,27,35,1291.91,2293.00,0.00
2024-12-08 14:54:10,63,2259,27,36,1271.41,2293.02,0.00
2024-12-08 14:54:10,63,2260,27,36,1263.95,2294.00,0.00
2024-12-08 14:54:10,64,2260,27,37,1244.20,2294.02,0.00
2024-12-08 14:54:10,63,2260,27,36,1262.13,2294.03,0.00
2024-12-08 14:54:10,63,2261,27,36,1262.32,2295.00,0.00
2024-12-08 14:54:10,64,2261,28,36,1242.59,2295.02,0.00
2024-12-08 14:54:10,63,2261,27,36,1241.65,2295.33,0.00
2024-12-08 14:54:10,63,2262,27,36,1263.23,2296.00,0.00
2024-12-08 14:54:10,64,2262,28,36,1243.49,2296.02,0.00
2024-12-08 14:54:10,63,2262,28,35,1261.77,2296.03,0.00
2024-12-08 14:54:10,63,2263,28,35,1261.96,2297.00,0.00
2024-12-08 14:54:10,64,2263,28,36,1242.24,2297.02,0.00
2024-12-08 14:54:10,63,2263,27,36,1228.89,2297.92,0.00
2024-12-08 14:54:10,63,2264,27,36,1263.60,2298.00,0.00
2024-12-08 14:54:10,64,2264,28,36,1243.86,2298.02,0.00
2024-12-08 14:54:10,63,2264,28,35,1263.24,2298.02,0.00
2024-12-08 14:54:10,62,2264,28,34,1282.13,2298.02,0.00
2024-12-08 14:54:10,62,2265,28,34,1282.32,2299.00,0.00
2024-12-08 14:54:10,63,2265,28,35,1261.96,2299.02,0.00
2024-12-08 14:54:11,63,2266,28,35,1254.48,2300.00,0.00
2024-12-08 14:54:11,64,2266,29,35,1234.88,2300.02,0.00
2024-12-08 14:54:11,63,2266,29,34,1253.38,2300.02,0.00
2024-12-08 14:54:11,64,2265,29,35,1226.73,2300.36,0.00
2024-12-08 14:54:11,63,2265,28,35,1261.75,2300.71,0.00
2024-12-08 14:54:11,63,2266,28,35,1277.29,2301.00,0.00
2024-12-08 14:54:11,64,2266,29,35,1257.33,2301.02,0.00
2024-12-08 14:54:11,64,2267,29,35,1285.57,2302.00,0.00
2024-12-08 14:54:11,65,2267,29,36,1265.80,2302.02,0.00
2024-12-08 14:54:11,64,2267,29,35,1284.85,2302.02,0.00
2024-12-08 14:54:11,64,2268,29,35,1284.33,2303.00,0.00
2024-12-08 14:54:11,65,2268,29,36,1264.57,2303.02,0.00
2024-12-08 14:54:11,64,2268,28,36,1252.56,2303.58,0.00
2024-12-08 14:54:11,64,2269,28,36,1279.13,2304.00,0.00
2024-12-08 14:54:11,65,2269,29,36,1259.45,2304.02,0.00
2024-12-08 14:54:11,64,2269,29,35,1278.05,2304.02,0.00
2024-12-08 14:54:11,63,2269,28,35,1295.09,2304.16,0.00
2024-12-08 14:54:11,63,2270,28,35,1298.17,2305.00,0.00
2024-12-08 14:54:11,64,2270,28,36,1277.89,2305.02,0.00
2024-12-08 14:54:11,64,2271,28,36,1270.15,2306.00,0.00
2024-12-08 14:54:11,65,2271,29,36,1250.61,2306.02,0.00
2024-12-08 14:54:11,64,2271,29,35,1268.35,2306.03,0.00
2024-12-08 14:54:11,63,2271,28,35,1267.47,2306.51,0.00
2024-12-08 14:54:11,63,2272,28,35,1293.07,2307.00,0.00
2024-12-08 14:54:11,64,2272,29,35,1272.87,2307.02,0.00
2024-12-08 14:54:11,63,2272,28,35,1281.03,2307.18,0.00
2024-12-08 14:54:11,63,2273,28,35,1299.13,2308.00,0.00
2024-12-08 14:54:11,64,2273,29,35,1278.83,2308.02,0.00
2024-12-08 14:54:11,63,2273,29,34,1296.56,2308.03,0.00
2024-12-08 14:54:11,62,2273,28,34,1302.18,2308.69,0.00
2024-12-08 14:54:11,62,2274,28,34,1317.67,2309.00,0.00
2024-12-08 14:54:11,63,2274,28,35,1296.76,2309.02,0.00
2024-12-08 14:54:11,63,2275,28,35,1289.25,2310.00,0.00
2024-12-08 14:54:11,64,2275,29,35,1269.11,2310.02,0.00
2024-12-08 14:54:11,63,2275,29,34,1286.69,2310.03,0.00
2024-12-08 14:54:11,62,2275,28,34,1279.66,2310.97,0.00
2024-12-08 14:54:11,62,2276,28,34,1316.20,2311.00,0.00
2024-12-08 14:54:11,63,2276,28,35,1295.31,2311.02,0.00
2024-12-08 14:54:11,62,2276,27,35,1315.83,2311.02,0.00
2024-12-08 14:54:11,62,2277,27,35,1308.57,2312.00,0.00
2024-12-08 14:54:11,63,2277,27,36,1287.80,2312.02,0.00
2024-12-08 14:54:11,62,2277,27,35,1306.71,2312.02,0.00
2024-12-08 14:54:11,62,2278,27,35,1306.90,2313.00,0.00
2024-12-08 14:54:11,63,2278,27,36,1286.15,2313.02,0.00
2024-12-08 14:54:11,63,2279,27,36,1278.63,2314.00,0.00
2024-12-08 14:54:11,64,2279,28,36,1258.65,2314.02,0.00
2024-12-08 14:54:11,63,2279,28,35,1277.16,2314.02,0.00
2024-12-08 14:54:11,62,2279,27,35,1287.41,2314.29,0.00
2024-12-08 14:54:11,62,2280,27,35,1308.77,2315.00,0.00
2024-12-08 14:54:11,63,2280,28,35,1288.00,2315.02,0.00
2024-12-08 14:54:11,62,2280,27,35,1285.59,2315.69,0.00
2024-12-08 14:54:11,62,2281,27,35,1301.12,2316.00,0.00
2024-12-08 14:54:11,63,2281,28,35,1280.47,2316.02,0.00
2024-12-08 14:54:11,62,2281,28,34,1300.00,2316.02,0.00
2024-12-08 14:54:11,62,2282,28,34,1300.19,2317.00,0.00
2024-12-08 14:54:11,63,2282,29,34,1279.55,2317.02,0.00
2024-12-08 14:54:11,63,2283,29,34,1272.01,2318.00,0.00
2024-12-08 14:54:11,64,2283,29,35,1252.13,2318.02,0.00
2024-12-08 14:54:11,63,2283,29,34,1270.91,2318.02,0.00
2024-12-08 14:54:11,62,2283,28,34,1275.67,2318.69,0.00
2024-12-08 14:54:11,62,2284,28,34,1291.21,2319.00,0.00
2024-12-08 14:54:11,63,2284,29,34,1270.72,2319.02,0.00
2024-12-08 14:54:11,63,2285,29,34,1263.16,2320.00,0.00
2024-12-08 14:54:11,64,2285,29,35,1243.43,2320.02,0.00
2024-12-08 14:54:11,63,2285,29,34,1262.06,2320.02,0.00
2024-12-08 14:54:11,62,2285,28,34,1254.13,2320.97,0.00
2024-12-08 14:54:11,62,2286,28,34,1290.83,2321.00,0.00
2024-12-08 14:54:11,63,2286,28,35,1270.34,2321.02,0.00
2024-12-08 14:54:11,62,2286,27,35,1267.94,2321.69,0.00
2024-12-08 14:54:11,61,2286,26,35,1287.98,2321.72,0.00
2024-12-08 14:54:11,61,2287,26,35,1304.56,2322.00,0.00
2024-12-08 14:54:11,62,2287,27,35,1283.52,2322.02,0.00
2024-12-08 14:54:11,61,2287,27,34,1303.04,2322.02,0.00
2024-12-08 14:54:11,60,2287,26,34,1320.94,2322.18,0.00
2024-12-08 14:54:11,60,2288,26,34,1325.71,2323.00,0.00
2024-12-08 14:54:11,61,2288,27,34,1303.98,2323.02,0.00
2024-12-08 14:54:11,60,2288,26,34,1298.24,2323.78,0.00
2024-12-08 14:54:11,61,2287,27,34,1275.48,2323.87,0.00
2024-12-08 14:54:11,61,2288,27,34,1314.07,2324.00,0.00
2024-12-08 14:54:11,62,2288,28,34,1292.87,2324.02,0.00
2024-12-08 14:54:11,61,2288,28,33,1312.92,2324.02,0.00
2024-12-08 14:54:11,61,2289,28,33,1351.60,2325.00,0.00
2024-12-08 14:54:11,62,2289,28,34,1329.80,2325.02,0.00
2024-12-08 14:54:11,62,2290,28,34,1322.50,2326.00,0.00
2024-12-08 14:54:11,63,2290,28,35,1301.50,2326.02,0.00
2024-12-08 14:54:11,62,2290,28,34,1320.62,2326.02,0.00
2024-12-08 14:54:11,61,2290,27,34,1339.53,2326.13,0.00
2024-12-08 14:54:11,60,2290,26,34,1356.85,2326.25,0.00
2024-12-08 14:54:12,60,2291,26,34,1378.68,2327.00,0.00
2024-12-08 14:54:12,61,2291,27,34,1356.08,2327.02,0.00
2024-12-08 14:54:12,60,2291,26,34,1367.11,2327.18,0.00
2024-12-08 14:54:12,60,2292,26,34,1387.42,2328.00,0.00
2024-12-08 14:54:12,61,2292,27,34,1364.68,2328.02,0.00
2024-12-08 14:54:12,60,2292,27,33,1384.71,2328.02,0.00
2024-12-08 14:54:12,60,2293,27,33,1385.69,2329.00,0.00
2024-12-08 14:54:12,61,2293,27,34,1362.98,2329.02,0.00
2024-12-08 14:54:12,61,2294,27,34,1355.92,2330.00,0.00
2024-12-08 14:54:12,62,2294,28,34,1334.05,2330.02,0.00
2024-12-08 14:54:12,61,2294,28,33,1350.98,2330.08,0.00
2024-12-08 14:54:12,60,2294,27,33,1359.45,2330.68,0.00
2024-12-08 14:54:12,59,2294,26,33,1369.28,2330.97,0.00
2024-12-08 14:54:12,59,2295,26,33,1408.02,2331.00,0.00
2024-12-08 14:54:12,60,2295,26,34,1384.55,2331.02,0.00
2024-12-08 14:54:12,60,2296,26,34,1377.76,2332.00,0.00
2024-12-08 14:54:12,61,2296,27,34,1355.17,2332.02,0.00
2024-12-08 14:54:12,60,2296,27,33,1371.57,2332.10,0.00
2024-12-08 14:54:12,59,2296,26,33,1379.35,2332.73,0.00
2024-12-08 14:54:12,59,2297,26,33,1412.78,2333.00,0.00
2024-12-08 14:54:12,60,2297,26,34,1389.24,2333.02,0.00
2024-12-08 14:54:12,60,2298,26,34,1382.44,2334.00,0.00
2024-12-08 14:54:12,61,2298,26,35,1359.78,2334.02,0.00
2024-12-08 14:54:12,60,2298,25,35,1382.12,2334.02,0.00
2024-12-08 14:54:12,59,2298,25,34,1398.85,2334.10,0.00
2024-12-08 14:54:12,59,2299,25,34,1402.19,2335.00,0.00
2024-12-08 14:54:12,60,2299,25,35,1378.82,2335.02,0.00
2024-12-08 14:54:12,60,2300,25,35,1372.48,2336.00,0.00
2024-12-08 14:54:12,61,2300,26,35,1349.98,2336.02,0.00
2024-12-08 14:54:12,60,2300,26,34,1365.11,2336.10,0.00
2024-12-08 14:54:12,60,2301,26,34,1368.00,2337.00,0.00
2024-12-08 14:54:12,61,2301,27,34,1345.57,2337.02,0.00
2024-12-08 14:54:12,60,2301,26,34,1348.16,2337.08,0.00
2024-12-08 14:54:12,60,2302,26,34,1366.25,2338.00,0.00
2024-12-08 14:54:12,61,2302,26,35,1343.85,2338.02,0.00
2024-12-08 14:54:12,60,2302,25,35,1333.15,2338.88,0.00
2024-12-08 14:54:12,60,2303,25,35,1369.48,2339.00,0.00
2024-12-08 14:54:12,61,2303,26,35,1347.03,2339.02,0.00
2024-12-08 14:54:12,60,2303,26,34,1361.30,2339.03,0.00
2024-12-08 14:54:12,60,2304,26,34,1362.66,2340.00,0.00
2024-12-08 14:54:12,61,2304,27,34,1340.32,2340.02,0.00
2024-12-08 14:54:12,60,2304,27,33,1356.83,2340.08,0.00
2024-12-08 14:54:12,59,2304,26,33,1356.50,2340.88,0.00
2024-12-08 14:54:12,59,2305,26,33,1393.49,2341.00,0.00
2024-12-08 14:54:12,60,2305,26,34,1370.26,2341.02,0.00
2024-12-08 14:54:12,60,2306,26,34,1363.43,2342.00,0.00
2024-12-08 14:54:12,61,2306,27,34,1341.08,2342.02,0.00
2024-12-08 14:54:12,60,2306,27,33,1357.60,2342.08,0.00
2024-12-08 14:54:12,59,2306,26,33,1378.26,2342.19,0.00
2024-12-08 14:54:12,59,2307,26,33,1383.56,2343.00,0.00
2024-12-08 14:54:12,60,2307,26,34,1360.50,2343.02,0.00
2024-12-08 14:54:12,60,2308,26,34,1353.66,2344.00,0.00
2024-12-08 14:54:12,61,2308,26,35,1331.47,2344.02,0.00
2024-12-08 14:54:12,60,2308,26,34,1347.82,2344.08,0.00
2024-12-08 14:54:12,59,2308,25,34,1368.31,2344.19,0.00
2024-12-08 14:54:12,58,2308,24,34,1375.89,2344.48,0.00
2024-12-08 14:54:12,58,2309,24,34,1404.57,2345.00,0.00
2024-12-08 14:54:12,59,2309,24,35,1380.77,2345.02,0.00
2024-12-08 14:54:12,58,2309,23,35,1380.34,2345.12,0.00
2024-12-08 14:54:12,58,2310,23,35,1400.72,2346.00,0.00
2024-12-08 14:54:12,59,2310,23,36,1376.98,2346.02,0.00
2024-12-08 14:54:12,58,2310,23,35,1393.87,2346.10,0.00
2024-12-08 14:54:12,58,2311,23,35,1397.68,2347.00,0.00
2024-12-08 14:54:12,59,2311,24,35,1373.99,2347.02,0.00
2024-12-08 14:54:12,58,2311,23,35,1387.57,2347.05,0.00
2024-12-08 14:54:12,58,2312,23,35,1398.27,2348.00,0.00
2024-12-08 14:54:12,59,2312,23,36,1374.57,2348.02,0.00
2024-12-08 14:54:12,59,2313,23,36,1368.12,2349.00,0.00
2024-12-08 14:54:12,60,2313,24,36,1345.32,2349.02,0.00
2024-12-08 14:54:12,59,2313,24,35,1362.57,2349.09,0.00
2024-12-08 14:54:12,59,2314,24,35,1365.52,2350.00,0.00
2024-12-08 14:54:12,60,2314,24,36,1342.76,2350.02,0.00
2024-12-08 14:54:12,59,2314,24,35,1359.96,2350.09,0.00
2024-12-08 14:54:12,59,2315,24,35,1362.91,2351.00,0.00
2024-12-08 14:54:12,60,2315,24,36,1340.20,2351.02,0.00
2024-12-08 14:54:12,59,2315,23,36,1335.40,2351.76,0.00
2024-12-08 14:54:12,59,2316,23,36,1369.87,2352.00,0.00
2024-12-08 14:54:12,60,2316,23,37,1347.04,2352.02,0.00
2024-12-08 14:54:12,59,2316,23,36,1360.34,2352.15,0.00
2024-12-08 14:54:12,59,2317,23,36,1364.87,2353.00,0.00
2024-12-08 14:54:12,60,2317,24,36,1342.12,2353.02,0.00
2024-12-08 14:54:12,59,2317,23,36,1350.18,2353.24,0.00
2024-12-08 14:54:12,59,2318,23,36,1372.63,2354.00,0.00
2024-12-08 14:54:12,60,2318,24,36,1349.75,2354.02,0.00
2024-12-08 14:54:12,59,2318,24,35,1363.09,2354.15,0.00
2024-12-08 14:54:13,59,2319,24,35,1367.63,2355.00,0.00
2024-12-08 14:54:13,60,2319,24,36,1344.83,2355.02,0.00
2024-12-08 14:54:13,59,2319,23,36,1367.23,2355.02,0.00
2024-12-08 14:54:13,59,2320,23,36,1362.33,2356.00,0.00
2024-12-08 14:54:13,60,2320,23,37,1339.63,2356.02,0.00
2024-12-08 14:54:13,59,2320,23,36,1353.58,2356.14,0.00
2024-12-08 14:54:13,58,2320,22,36,1348.89,2356.97,0.00
2024-12-08 14:54:13,58,2321,22,36,1388.73,2357.00,0.00
2024-12-08 14:54:13,59,2321,23,36,1365.19,2357.02,0.00
2024-12-08 14:54:13,58,2321,22,36,1354.43,2357.59,0.00
2024-12-08 14:54:13,58,2322,22,36,1385.66,2358.00,0.00
2024-12-08 14:54:13,59,2322,23,36,1362.17,2358.02,0.00
2024-12-08 14:54:13,58,2322,22,36,1368.66,2358.28,0.00
2024-12-08 14:54:13,58,2323,22,36,1392.76,2359.00,0.00
2024-12-08 14:54:13,59,2323,22,37,1369.15,2359.02,0.00
2024-12-08 14:54:13,58,2323,22,36,1387.89,2359.10,0.00
2024-12-08 14:54:13,58,2324,22,36,1391.72,2360.00,0.00
2024-12-08 14:54:13,59,2324,22,37,1368.13,2360.02,0.00
2024-12-08 14:54:13,58,2324,22,36,1384.01,2360.12,0.00
2024-12-08 14:54:13,58,2325,22,36,1388.24,2361.00,0.00
2024-12-08 14:54:13,59,2325,23,36,1364.71,2361.02,0.00
2024-12-08 14:54:13,59,2326,23,36,1358.47,2362.00,0.00
2024-12-08 14:54:13,60,2326,23,37,1335.83,2362.02,0.00
2024-12-08 14:54:13,59,2326,23,36,1351.28,2362.12,0.00
2024-12-08 14:54:13,59,2327,23,36,1355.04,2363.00,0.00
2024-12-08 14:54:13,60,2327,24,36,1332.46,2363.02,0.00
2024-12-08 14:54:13,59,2327,23,36,1319.91,2363.92,0.00
2024-12-08 14:54:13,59,2328,23,36,1358.03,2364.00,0.00
2024-12-08 14:54:13,60,2328,23,37,1335.39,2364.02,0.00
2024-12-08 14:54:13,59,2328,23,36,1351.24,2364.12,0.00
2024-12-08 14:54:13,59,2329,23,36,1354.99,2365.00,0.00
2024-12-08 14:54:13,60,2329,23,37,1332.41,2365.02,0.00
2024-12-08 14:54:13,60,2330,23,37,1326.36,2366.00,0.00
2024-12-08 14:54:13,61,2330,24,37,1304.62,2366.02,0.00
2024-12-08 14:54:13,60,2330,24,36,1319.28,2366.12,0.00
2024-12-08 14:54:13,60,2331,24,36,1322.58,2367.00,0.00
2024-12-08 14:54:13,61,2331,24,37,1300.90,2367.02,0.00
2024-12-08 14:54:13,60,2331,23,37,1302.56,2367.32,0.00
2024-12-08 14:54:13,60,2332,23,37,1326.30,2368.00,0.00
2024-12-08 14:54:13,61,2332,23,38,1304.56,2368.02,0.00
2024-12-08 14:54:13,60,2332,23,37,1319.21,2368.12,0.00
2024-12-08 14:54:13,60,2333,23,37,1322.52,2369.00,0.00
2024-12-08 14:54:13,61,2333,24,37,1300.84,2369.02,0.00
2024-12-08 14:54:13,60,2333,23,37,1309.88,2369.02,0.00
2024-12-08 14:54:13,59,2333,22,37,1331.68,2369.02,0.00
2024-12-08 14:54:13,59,2334,22,37,1341.08,2370.00,0.00
2024-12-08 14:54:13,60,2334,23,37,1318.73,2370.02,0.00
2024-12-08 14:54:13,60,2335,23,37,1313.23,2371.00,0.00
2024-12-08 14:54:13,61,2335,23,38,1291.70,2371.02,0.00
2024-12-08 14:54:13,60,2335,23,37,1307.70,2371.08,0.00
2024-12-08 14:54:13,60,2336,23,37,1310.23,2372.00,0.00
2024-12-08 14:54:13,61,2336,23,38,1288.75,2372.02,0.00
2024-12-08 14:54:13,60,2336,23,37,1304.30,2372.08,0.00
2024-12-08 14:54:13,60,2337,23,37,1306.82,2373.00,0.00
2024-12-08 14:54:13,61,2337,24,37,1285.40,2373.02,0.00
2024-12-08 14:54:13,61,2338,24,37,1279.39,2374.00,0.00
2024-12-08 14:54:13,62,2338,24,38,1258.76,2374.02,0.00
2024-12-08 14:54:13,61,2338,24,37,1273.95,2374.08,0.00
2024-12-08 14:54:13,60,2338,23,37,1267.12,2374.95,0.00
2024-12-08 14:54:13,60,2339,23,37,1305.55,2375.00,0.00
2024-12-08 14:54:13,61,2339,24,37,1284.15,2375.02,0.00
2024-12-08 14:54:13,60,2339,23,37,1288.99,2375.25,0.00
2024-12-08 14:54:13,60,2340,23,37,1311.25,2376.00,0.00
2024-12-08 14:54:13,61,2340,23,38,1289.75,2376.02,0.00
2024-12-08 14:54:13,60,2340,22,38,1310.85,2376.02,0.00
2024-12-08 14:54:13,59,2340,22,37,1327.84,2376.07,0.00
2024-12-08 14:54:13,58,2340,21,37,1349.12,2376.14,0.00
2024-12-08 14:54:13,59,2339,21,38,1320.72,2376.41,0.00
2024-12-08 14:54:13,59,2340,21,38,1362.64,2377.00,0.00
2024-12-08 14:54:13,60,2340,21,39,1339.93,2377.02,0.00
2024-12-08 14:54:13,60,2341,21,39,1373.82,2378.00,0.00
2024-12-08 14:54:13,61,2341,22,39,1351.30,2378.02,0.00
2024-12-08 14:54:13,60,2341,22,38,1367.88,2378.07,0.00
2024-12-08 14:54:13,59,2341,21,38,1384.62,2378.19,0.00
2024-12-08 14:54:13,59,2342,21,38,1406.12,2379.00,0.00
2024-12-08 14:54:13,60,2342,21,39,1382.69,2379.02,0.00
2024-12-08 14:54:13,60,2343,21,39,1376.51,2380.00,0.00
2024-12-08 14:54:13,61,2343,21,40,1353.94,2380.02,0.00
2024-12-08 14:54:13,60,2343,21,39,1370.56,2380.07,0.00
2024-12-08 14:54:13,60,2344,21,39,1372.72,2381.00,0.00
2024-12-08 14:54:13,61,2344,22,39,1350.22,2381.02,0.00
2024-12-08 14:54:13,60,2344,21,39,1334.79,2381.97,0.00
2024-12-08 14:54:14,60,2345,21,39,1373.71,2382.00,0.00
2024-12-08 14:54:14,61,2345,22,39,1351.19,2382.02,0.00
2024-12-08 14:54:14,60,2345,21,39,1373.31,2382.02,0.00
2024-12-08 14:54:14,59,2345,21,38,1391.34,2382.05,0.00
2024-12-08 14:54:14,59,2346,21,38,1393.54,2383.00,0.00
2024-12-08 14:54:14,60,2346,22,38,1370.32,2383.02,0.00
2024-12-08 14:54:14,60,2347,22,38,1366.48,2384.00,0.00
2024-12-08 14:54:14,61,2347,22,39,1344.08,2384.02,0.00
2024-12-08 14:54:14,60,2347,21,39,1366.08,2384.02,0.00
2024-12-08 14:54:14,59,2347,21,38,1380.75,2384.03,0.00
2024-12-08 14:54:14,58,2347,20,38,1390.39,2384.64,0.00
2024-12-08 14:54:14,58,2348,20,38,1406.69,2385.00,0.00
2024-12-08 14:54:14,59,2348,20,39,1382.85,2385.02,0.00
2024-12-08 14:54:14,58,2348,19,39,1395.89,2385.12,0.00
2024-12-08 14:54:14,58,2349,19,39,1400.92,2386.00,0.00
2024-12-08 14:54:14,59,2349,19,40,1377.17,2386.02,0.00
2024-12-08 14:54:14,58,2349,18,40,1400.50,2386.02,0.00
2024-12-08 14:54:14,57,2349,18,39,1419.22,2386.04,0.00
2024-12-08 14:54:14,57,2350,18,39,1421.90,2387.00,0.00
2024-12-08 14:54:14,58,2350,19,39,1397.39,2387.02,0.00
2024-12-08 14:54:14,57,2350,18,39,1392.22,2387.77,0.00
2024-12-08 14:54:14,57,2351,18,39,1428.85,2388.00,0.00
2024-12-08 14:54:14,58,2351,19,39,1404.21,2388.02,0.00
2024-12-08 14:54:14,57,2351,19,38,1422.99,2388.04,0.00
2024-12-08 14:54:14,57,2352,19,38,1425.67,2389.00,0.00
2024-12-08 14:54:14,58,2352,19,39,1401.09,2389.02,0.00
2024-12-08 14:54:14,58,2353,19,39,1394.67,2390.00,0.00
2024-12-08 14:54:14,59,2353,19,40,1371.04,2390.02,0.00
2024-12-08 14:54:14,58,2353,19,39,1389.32,2390.03,0.00
2024-12-08 14:54:14,57,2353,18,39,1399.47,2390.63,0.00
2024-12-08 14:54:14,56,2353,17,39,1414.38,2390.86,0.00
2024-12-08 14:54:14,56,2354,17,39,1453.77,2391.00,0.00
2024-12-08 14:54:14,57,2354,17,40,1428.26,2391.02,0.00
2024-12-08 14:54:14,56,2354,16,40,1452.96,2391.04,0.00
2024-12-08 14:54:14,55,2354,15,40,1443.58,2391.58,0.00
2024-12-08 14:54:14,55,2355,15,40,1477.39,2392.00,0.00
2024-12-08 14:54:14,56,2355,15,41,1451.00,2392.02,0.00
2024-12-08 14:54:14,55,2355,15,40,1470.87,2392.04,0.00
2024-12-08 14:54:14,55,2356,15,40,1474.52,2393.00,0.00
2024-12-08 14:54:14,56,2356,15,41,1448.19,2393.02,0.00
2024-12-08 14:54:14,56,2357,15,41,1442.38,2394.00,0.00
2024-12-08 14:54:14,57,2357,15,42,1417.08,2394.02,0.00
2024-12-08 14:54:14,56,2357,15,41,1436.40,2394.04,0.00
2024-12-08 14:54:14,55,2357,14,41,1440.76,2394.80,0.00
2024-12-08 14:54:14,55,2358,14,41,1479.67,2395.00,0.00
2024-12-08 14:54:14,56,2358,14,42,1453.25,2395.02,0.00
2024-12-08 14:54:14,56,2359,14,42,1447.44,2396.00,0.00
2024-12-08 14:54:14,57,2359,15,42,1422.05,2396.02,0.00
2024-12-08 14:54:14,56,2359,15,41,1441.03,2396.04,0.00
2024-12-08 14:54:14,55,2359,14,41,1450.40,2396.40,0.00
2024-12-08 14:54:14,55,2360,14,41,1480.04,2397.00,0.00
2024-12-08 14:54:14,56,2360,14,42,1453.61,2397.02,0.00
2024-12-08 14:54:14,55,2360,13,42,1471.32,2397.02,0.00
2024-12-08 14:54:14,55,2361,13,42,1483.27,2398.00,0.00
2024-12-08 14:54:14,56,2361,14,42,1456.78,2398.02,0.00
2024-12-08 14:54:14,55,2361,14,41,1477.17,2398.02,0.00
2024-12-08 14:54:14,55,2362,14,41,1480.40,2399.00,0.00
2024-12-08 14:54:14,56,2362,15,41,1453.96,2399.02,0.00
2024-12-08 14:54:14,55,2362,14,41,1452.86,2399.73,0.00
2024-12-08 14:54:14,55,2363,14,41,1490.18,2400.00,0.00
2024-12-08 14:54:14,56,2363,14,42,1463.57,2400.02,0.00
2024-12-08 14:54:14,55,2363,14,41,1484.07,2400.02,0.00
2024-12-08 14:54:14,55,2364,14,41,1487.31,2401.00,0.00
2024-12-08 14:54:14,56,2364,15,41,1460.75,2401.02,0.00
2024-12-08 14:54:14,56,2365,15,41,1454.93,2402.00,0.00
2024-12-08 14:54:14,57,2365,15,42,1429.40,2402.02,0.00
2024-12-08 14:54:14,56,2365,15,41,1449.35,2402.02,0.00
2024-12-08 14:54:14,55,2365,14,41,1472.69,2402.13,0.00
2024-12-08 14:54:14,55,2366,14,41,1478.50,2403.00,0.00
2024-12-08 14:54:14,56,2366,15,41,1452.10,2403.02,0.00
2024-12-08 14:54:14,55,2366,14,41,1451.44,2403.09,0.00
2024-12-08 14:54:14,55,2367,14,41,1473.87,2404.00,0.00
2024-12-08 14:54:14,56,2367,15,41,1447.55,2404.02,0.00
2024-12-08 14:54:14,55,2367,15,40,1468.63,2404.02,0.00
2024-12-08 14:54:14,56,2366,15,41,1442.40,2404.05,0.00
2024-12-08 14:54:14,56,2367,15,41,1457.60,2405.00,0.00
2024-12-08 14:54:14,57,2367,16,41,1432.03,2405.02,0.00
2024-12-08 14:54:14,57,2368,16,41,1468.31,2406.00,0.00
2024-12-08 14:54:14,58,2368,17,41,1442.99,2406.02,0.00
2024-12-08 14:54:14,57,2368,17,40,1462.42,2406.04,0.00
2024-12-08 14:54:14,57,2369,17,40,1465.12,2407.00,0.00
2024-12-08 14:54:14,58,2369,17,41,1439.86,2407.02,0.00
2024-12-08 14:54:15,58,2370,17,41,1433.42,2408.00,0.00
2024-12-08 14:54:15,59,2370,17,42,1409.13,2408.02,0.00
2024-12-08 14:54:15,58,2370,17,41,1426.80,2408.05,0.00
2024-12-08 14:54:15,57,2370,16,41,1450.17,2408.12,0.00
2024-12-08 14:54:15,56,2370,15,41,1452.43,2408.88,0.00
2024-12-08 14:54:15,56,2371,15,41,1492.52,2409.00,0.00
2024-12-08 14:54:15,57,2371,16,41,1466.34,2409.02,0.00
2024-12-08 14:54:15,56,2371,15,41,1461.75,2409.46,0.00
2024-12-08 14:54:15,56,2372,15,41,1492.28,2410.00,0.00
2024-12-08 14:54:15,57,2372,15,42,1466.10,2410.02,0.00
2024-12-08 14:54:15,56,2372,15,41,1485.42,2410.05,0.00
2024-12-08 14:54:15,56,2373,15,41,1489.02,2411.00,0.00
2024-12-08 14:54:15,57,2373,16,41,1462.90,2411.02,0.00
2024-12-08 14:54:15,57,2374,16,41,1456.74,2412.00,0.00
2024-12-08 14:54:15,58,2374,17,41,1431.62,2412.02,0.00
2024-12-08 14:54:15,57,2374,17,40,1450.41,2412.05,0.00
2024-12-08 14:54:15,56,2374,16,40,1447.15,2412.96,0.00
2024-12-08 14:54:15,56,2375,16,40,1489.40,2413.00,0.00
2024-12-08 14:54:15,57,2375,16,41,1463.27,2413.02,0.00
2024-12-08 14:54:15,57,2376,16,41,1457.10,2414.00,0.00
2024-12-08 14:54:15,58,2376,16,42,1431.98,2414.02,0.00
2024-12-08 14:54:15,57,2376,16,41,1451.19,2414.05,0.00
2024-12-08 14:54:15,57,2377,16,41,1454.31,2415.00,0.00
2024-12-08 14:54:15,58,2377,16,42,1429.24,2415.02,0.00
2024-12-08 14:54:15,58,2378,16,42,1422.75,2416.00,0.00
2024-12-08 14:54:15,59,2378,17,42,1398.63,2416.02,0.00
2024-12-08 14:54:15,58,2378,17,41,1417.35,2416.05,0.00
2024-12-08 14:54:15,57,2378,16,41,1426.86,2416.68,0.00
2024-12-08 14:54:15,57,2379,16,41,1461.88,2417.00,0.00
2024-12-08 14:54:15,58,2379,17,41,1436.67,2417.02,0.00
2024-12-08 14:54:15,58,2380,17,41,1430.18,2418.00,0.00
2024-12-08 14:54:15,59,2380,18,41,1405.94,2418.02,0.00
2024-12-08 14:54:15,58,2380,18,40,1424.78,2418.05,0.00
2024-12-08 14:54:15,58,2381,18,40,1427.43,2419.00,0.00
2024-12-08 14:54:15,59,2381,19,40,1403.24,2419.02,0.00
2024-12-08 14:54:15,58,2381,18,40,1415.81,2419.16,0.00
2024-12-08 14:54:15,58,2382,18,40,1421.09,2420.00,0.00
2024-12-08 14:54:15,59,2382,18,41,1397.01,2420.02,0.00
2024-12-08 14:54:15,58,2382,18,40,1415.27,2420.07,0.00
2024-12-08 14:54:15,58,2383,18,40,1418.34,2421.00,0.00
2024-12-08 14:54:15,59,2383,18,41,1394.30,2421.02,0.00
2024-12-08 14:54:15,59,2384,18,41,1387.49,2422.00,0.00
2024-12-08 14:54:15,60,2384,19,41,1364.36,2422.02,0.00
2024-12-08 14:54:15,59,2384,19,40,1382.17,2422.07,0.00
2024-12-08 14:54:15,59,2385,19,40,1384.78,2423.00,0.00
2024-12-08 14:54:15,60,2385,19,41,1361.70,2423.02,0.00
2024-12-08 14:54:15,59,2385,18,41,1357.62,2423.75,0.00
2024-12-08 14:54:15,59,2386,18,41,1392.74,2424.00,0.00
2024-12-08 14:54:15,60,2386,18,42,1369.53,2424.02,0.00
2024-12-08 14:54:15,59,2386,18,41,1387.83,2424.07,0.00
2024-12-08 14:54:15,59,2387,18,41,1390.44,2425.00,0.00
2024-12-08 14:54:15,60,2387,19,41,1367.27,2425.02,0.00
2024-12-08 14:54:15,59,2387,18,41,1366.29,2425.68,0.00
2024-12-08 14:54:15,59,2388,18,41,1383.76,2426.00,0.00
2024-12-08 14:54:15,60,2388,19,41,1360.69,2426.02,0.00
2024-12-08 14:54:15,59,2388,19,40,1378.43,2426.07,0.00
2024-12-08 14:54:15,59,2389,19,40,1381.04,2427.00,0.00
2024-12-08 14:54:15,60,2389,19,41,1358.02,2427.02,0.00
2024-12-08 14:54:15,60,2390,19,41,1350.89,2428.00,0.00
2024-12-08 14:54:15,61,2390,19,42,1328.74,2428.02,0.00
2024-12-08 14:54:15,60,2390,19,41,1346.05,2428.07,0.00
2024-12-08 14:54:15,59,2390,18,41,1347.10,2428.81,0.00
2024-12-08 14:54:15,59,2391,18,41,1383.87,2429.00,0.00
2024-12-08 14:54:15,60,2391,19,41,1360.80,2429.02,0.00
2024-12-08 14:54:15,59,2391,18,41,1345.05,2429.66,0.00
2024-12-08 14:54:15,59,2392,18,41,1378.26,2430.00,0.00
2024-12-08 14:54:15,60,2392,18,42,1355.29,2430.02,0.00
2024-12-08 14:54:15,59,2392,18,41,1372.10,2430.09,0.00
2024-12-08 14:54:15,58,2392,17,41,1393.69,2430.17,0.00
2024-12-08 14:54:15,58,2393,17,41,1399.24,2431.00,0.00
2024-12-08 14:54:15,59,2393,18,41,1375.53,2431.02,0.00
2024-12-08 14:54:15,59,2394,18,41,1368.97,2432.00,0.00
2024-12-08 14:54:15,60,2394,18,42,1346.16,2432.02,0.00
2024-12-08 14:54:15,59,2394,18,41,1362.81,2432.09,0.00
2024-12-08 14:54:15,58,2394,17,41,1357.59,2432.97,0.00
2024-12-08 14:54:15,58,2395,17,41,1398.72,2433.00,0.00
2024-12-08 14:54:15,59,2395,18,41,1375.01,2433.02,0.00
2024-12-08 14:54:15,59,2396,18,41,1368.73,2434.00,0.00
2024-12-08 14:54:15,60,2396,19,41,1345.91,2434.02,0.00
2024-12-08 14:54:15,59,2396,19,40,1362.56,2434.09,0.00
2024-12-08 14:54:15,59,2397,19,40,1365.57,2435.00,0.00
2024-12-08 14:54:15,60,2397,19,41,1342.81,2435.02,0.00
2024-12-08 14:54:16,60,2398,19,41,1335.65,2436.00,0.00
2024-12-08 14:54:16,61,2398,20,41,1313.76,2436.02,0.00
2024-12-08 14:54:16,60,2398,20,40,1332.82,2436.07,0.00
2024-12-08 14:54:16,60,2399,20,40,1334.98,2437.00,0.00
2024-12-08 14:54:16,61,2399,21,40,1313.10,2437.02,0.00
2024-12-08 14:54:16,61,2400,21,40,1306.17,2438.00,0.00
2024-12-08 14:54:16,62,2400,22,40,1285.10,2438.02,0.00
2024-12-08 14:54:16,61,2400,22,39,1301.79,2438.07,0.00
2024-12-08 14:54:16,60,2400,21,39,1308.60,2438.68,0.00
2024-12-08 14:54:16,60,2401,21,39,1325.48,2439.00,0.00
2024-12-08 14:54:16,61,2401,21,40,1303.75,2439.02,0.00
2024-12-08 14:54:16,60,2401,20,40,1324.68,2439.03,0.00
2024-12-08 14:54:16,59,2401,19,40,1328.61,2439.29,0.00
2024-12-08 14:54:16,59,2402,19,40,1353.05,2440.00,0.00
2024-12-08 14:54:16,60,2402,20,40,1330.50,2440.02,0.00
2024-12-08 14:54:16,59,2402,20,39,1348.93,2440.05,0.00
2024-12-08 14:54:16,59,2403,20,39,1351.12,2441.00,0.00
2024-12-08 14:54:16,60,2403,20,40,1328.60,2441.02,0.00
2024-12-08 14:54:16,59,2403,19,40,1313.56,2441.95,0.00
2024-12-08 14:54:16,59,2404,19,40,1353.74,2442.00,0.00
2024-12-08 14:54:16,60,2404,19,41,1331.18,2442.02,0.00
2024-12-08 14:54:16,59,2404,19,40,1350.03,2442.05,0.00
2024-12-08 14:54:16,59,2405,19,40,1352.23,2443.00,0.00
2024-12-08 14:54:16,60,2405,19,41,1329.69,2443.02,0.00
2024-12-08 14:54:16,60,2406,19,41,1322.78,2444.00,0.00
2024-12-08 14:54:16,61,2406,19,42,1301.09,2444.02,0.00
2024-12-08 14:54:16,60,2406,19,41,1317.91,2444.07,0.00
2024-12-08 14:54:16,59,2406,18,41,1323.31,2444.73,0.00
2024-12-08 14:54:16,59,2407,18,41,1358.31,2445.00,0.00
2024-12-08 14:54:16,60,2407,18,42,1335.67,2445.02,0.00
2024-12-08 14:54:16,60,2408,18,42,1328.96,2446.00,0.00
2024-12-08 14:54:16,61,2408,19,42,1307.18,2446.02,0.00
2024-12-08 14:54:16,60,2408,19,41,1324.08,2446.07,0.00
2024-12-08 14:54:16,61,2407,20,41,1301.98,2446.12,0.00
2024-12-08 14:54:16,60,2407,19,41,1337.05,2446.72,0.00
2024-12-08 14:54:16,59,2407,18,41,1348.57,2446.92,0.00
2024-12-08 14:54:16,59,2408,18,41,1388.04,2447.00,0.00
2024-12-08 14:54:16,60,2408,18,42,1364.90,2447.02,0.00
2024-12-08 14:54:16,60,2409,18,42,1399.03,2448.00,0.00
2024-12-08 14:54:16,61,2409,18,43,1376.10,2448.02,0.00
2024-12-08 14:54:16,60,2409,18,42,1394.15,2448.07,0.00
2024-12-08 14:54:16,59,2409,17,42,1414.93,2448.19,0.00
2024-12-08 14:54:16,59,2410,17,42,1420.42,2449.00,0.00
2024-12-08 14:54:16,60,2410,18,42,1396.75,2449.02,0.00
2024-12-08 14:54:16,59,2410,17,42,1419.60,2449.03,0.00
2024-12-08 14:54:16,59,2411,17,42,1426.40,2450.00,0.00
2024-12-08 14:54:16,60,2411,18,42,1402.63,2450.02,0.00
2024-12-08 14:54:16,60,2412,18,42,1407.12,2451.00,0.00
2024-12-08 14:54:16,61,2412,19,42,1384.05,2451.02,0.00
2024-12-08 14:54:16,61,2413,19,42,1376.57,2452.00,0.00
2024-12-08 14:54:16,62,2413,20,42,1354.37,2452.02,0.00
2024-12-08 14:54:16,62,2414,20,42,1354.46,2453.00,0.00
2024-12-08 14:54:16,63,2414,20,43,1332.96,2453.02,0.00
2024-12-08 14:54:16,62,2414,20,42,1351.31,2453.06,0.00
2024-12-08 14:54:16,62,2415,20,42,1352.64,2454.00,0.00
2024-12-08 14:54:16,63,2415,21,42,1331.17,2454.02,0.00
2024-12-08 14:54:16,63,2416,21,42,1324.78,2455.00,0.00
2024-12-08 14:54:16,64,2416,22,42,1304.08,2455.02,0.00
2024-12-08 14:54:16,65,2415,22,43,1262.71,2455.62,0.00
2024-12-08 14:54:16,65,2416,22,43,1286.43,2456.00,0.00
2024-12-08 14:54:16,66,2416,23,43,1266.94,2456.02,0.00
2024-12-08 14:54:16,65,2416,23,42,1281.53,2456.05,0.00
2024-12-08 14:54:16,64,2416,22,42,1286.35,2456.67,0.00
2024-12-08 14:54:16,64,2417,22,42,1339.95,2457.00,0.00
2024-12-08 14:54:16,65,2417,23,42,1319.34,2457.02,0.00
2024-12-08 14:54:16,64,2417,23,41,1338.04,2457.05,0.00
2024-12-08 14:54:16,64,2418,23,41,1338.20,2458.00,0.00
2024-12-08 14:54:16,65,2418,24,41,1317.61,2458.02,0.00
2024-12-08 14:54:16,65,2419,24,41,1309.06,2459.00,0.00
2024-12-08 14:54:16,66,2419,25,41,1289.23,2459.02,0.00
2024-12-08 14:54:16,65,2419,25,40,1307.56,2459.05,0.00
2024-12-08 14:54:16,64,2419,24,40,1300.03,2459.94,0.00
2024-12-08 14:54:16,64,2420,24,40,1336.98,2460.00,0.00
2024-12-08 14:54:16,65,2420,25,40,1316.41,2460.02,0.00
2024-12-08 14:54:16,64,2420,24,40,1309.36,2460.22,0.00
2024-12-08 14:54:16,63,2420,23,40,1330.14,2460.22,0.00
2024-12-08 14:54:16,63,2421,23,40,1350.55,2461.00,0.00
2024-12-08 14:54:16,64,2421,24,40,1329.45,2461.02,0.00
2024-12-08 14:54:16,63,2421,24,39,1348.21,2461.05,0.00
2024-12-08 14:54:16,63,2422,24,39,1348.75,2462.00,0.00
2024-12-08 14:54:16,64,2422,25,39,1327.68,2462.02,0.00
2024-12-08 14:54:16,64,2423,25,39,1319.37,2463.00,0.00
2024-12-08 14:54:16,65,2423,25,40,1299.07,2463.02,0.00
2024-12-08 14:54:16,64,2423,25,39,1317.45,2463.05,0.00
2024-12-08 14:54:16,65,2422,26,39,1280.83,2463.75,0.00
2024-12-08 14:54:16,65,2423,26,39,1306.80,2464.00,0.00
2024-12-08 14:54:16,66,2423,26,40,1287.00,2464.02,0.00
2024-12-08 14:54:16,65,2423,25,40,1294.34,2464.22,0.00
2024-12-08 14:54:16,65,2424,25,40,1336.15,2465.00,0.00
2024-12-08 14:54:17,66,2424,25,41,1315.91,2465.02,0.00
2024-12-08 14:54:17,65,2424,25,40,1334.64,2465.05,0.00
2024-12-08 14:54:17,64,2424,24,40,1326.72,2465.95,0.00
2024-12-08 14:54:17,64,2425,24,40,1364.13,2466.00,0.00
2024-12-08 14:54:17,65,2425,24,41,1343.14,2466.02,0.00
2024-12-08 14:54:17,66,2424,25,41,1294.46,2466.91,0.00
2024-12-08 14:54:17,66,2425,25,41,1331.92,2467.00,0.00
2024-12-08 14:54:17,67,2425,25,42,1312.05,2467.02,0.00
2024-12-08 14:54:17,66,2425,25,41,1330.06,2467.05,0.00
2024-12-08 14:54:17,66,2426,25,41,1366.87,2468.00,0.00
2024-12-08 14:54:17,67,2426,26,41,1346.47,2468.02,0.00
2024-12-08 14:54:17,67,2427,26,41,1337.43,2469.00,0.00
2024-12-08 14:54:17,68,2427,26,42,1317.76,2469.02,0.00
2024-12-08 14:54:17,69,2426,26,43,1298.66,2469.04,0.00
2024-12-08 14:54:17,68,2426,26,42,1339.93,2469.06,0.00
2024-12-08 14:54:17,68,2427,26,42,1339.00,2470.00,0.00
2024-12-08 14:54:17,69,2427,26,43,1319.59,2470.01,0.00
2024-12-08 14:54:17,69,2428,26,43,1345.91,2471.00,0.00
2024-12-08 14:54:17,70,2428,26,44,1326.69,2471.01,0.00
2024-12-08 14:54:17,69,2428,26,43,1345.21,2471.03,0.00
2024-12-08 14:54:17,68,2428,26,42,1364.63,2471.03,0.00
2024-12-08 14:54:17,67,2428,25,42,1380.62,2471.19,0.00
2024-12-08 14:54:17,66,2428,24,42,1389.45,2471.68,0.00
2024-12-08 14:54:17,66,2429,24,42,1404.29,2472.00,0.00
2024-12-08 14:54:17,67,2429,24,43,1383.33,2472.02,0.00
2024-12-08 14:54:17,66,2429,24,42,1396.06,2472.03,0.00
2024-12-08 14:54:17,65,2429,23,42,1397.74,2472.75,0.00
2024-12-08 14:54:17,65,2430,23,42,1429.90,2473.00,0.00
2024-12-08 14:54:17,66,2430,23,43,1408.23,2473.02,0.00
2024-12-08 14:54:17,65,2430,23,42,1421.54,2473.03,0.00
2024-12-08 14:54:17,64,2430,22,42,1426.12,2473.42,0.00
2024-12-08 14:54:17,64,2431,22,42,1450.89,2474.00,0.00
2024-12-08 14:54:17,65,2431,23,42,1428.57,2474.02,0.00
2024-12-08 14:54:17,64,2431,23,41,1442.40,2474.03,0.00
2024-12-08 14:54:17,65,2430,23,42,1415.70,2474.25,0.00
2024-12-08 14:54:17,64,2430,22,42,1453.98,2474.88,0.00
2024-12-08 14:54:17,64,2431,22,42,1489.65,2475.00,0.00
2024-12-08 14:54:17,65,2431,23,42,1466.74,2475.02,0.00
2024-12-08 14:54:17,64,2431,23,41,1481.16,2475.03,0.00
2024-12-08 14:54:17,63,2431,22,41,1495.72,2475.27,0.00
2024-12-08 14:54:17,63,2432,22,41,1556.75,2476.00,0.00
2024-12-08 14:54:17,64,2432,23,41,1532.42,2476.02,0.00
2024-12-08 14:54:17,64,2433,23,41,1524.14,2477.00,0.00
2024-12-08 14:54:17,65,2433,24,41,1500.69,2477.02,0.00
2024-12-08 14:54:17,64,2433,24,40,1523.38,2477.03,0.00
2024-12-08 14:54:17,64,2434,24,40,1523.21,2478.00,0.00
2024-12-08 14:54:17,65,2434,24,41,1499.77,2478.02,0.00
2024-12-08 14:54:17,66,2433,25,41,1477.05,2478.05,0.00
2024-12-08 14:54:17,66,2434,25,41,1472.01,2479.00,0.00
2024-12-08 14:54:17,67,2434,26,41,1450.04,2479.02,0.00
2024-12-08 14:54:17,66,2434,26,40,1470.90,2479.03,0.00
2024-12-08 14:54:17,66,2435,26,40,1507.55,2480.00,0.00
2024-12-08 14:54:17,67,2435,26,41,1485.05,2480.02,0.00
2024-12-08 14:54:17,66,2435,25,41,1495.97,2480.18,0.00
2024-12-08 14:54:17,66,2436,25,41,1498.76,2481.00,0.00
2024-12-08 14:54:17,67,2436,25,42,1476.39,2481.02,0.00
2024-12-08 14:54:17,66,2436,25,41,1497.65,2481.03,0.00
2024-12-08 14:54:17,65,2436,24,41,1505.73,2481.65,0.00
2024-12-08 14:54:17,65,2437,24,41,1535.42,2482.00,0.00
2024-12-08 14:54:17,66,2437,24,42,1512.15,2482.02,0.00
2024-12-08 14:54:17,66,2438,24,42,1503.36,2483.00,0.00
2024-12-08 14:54:17,67,2438,25,42,1480.92,2483.02,0.00
2024-12-08 14:54:17,66,2438,25,41,1500.74,2483.05,0.00
2024-12-08 14:54:17,65,2438,24,41,1497.97,2483.89,0.00
2024-12-08 14:54:17,65,2439,24,41,1533.60,2484.00,0.00
2024-12-08 14:54:17,66,2439,25,41,1510.36,2484.02,0.00
2024-12-08 14:54:17,66,2440,25,41,1501.55,2485.00,0.00
2024-12-08 14:54:17,67,2440,25,42,1479.14,2485.02,0.00
2024-12-08 14:54:17,66,2440,25,41,1499.31,2485.05,0.00
2024-12-08 14:54:17,66,2441,25,41,1498.77,2486.00,0.00
2024-12-08 14:54:17,67,2441,26,41,1476.40,2486.02,0.00
2024-12-08 14:54:17,66,2441,25,41,1479.95,2486.06,0.00
2024-12-08 14:54:17,65,2441,24,41,1489.59,2486.59,0.00
2024-12-08 14:54:17,65,2442,24,41,1517.85,2487.00,0.00
2024-12-08 14:54:17,66,2442,25,41,1494.85,2487.02,0.00
2024-12-08 14:54:17,65,2442,25,40,1515.57,2487.05,0.00
2024-12-08 14:54:17,65,2443,25,40,1515.40,2488.00,0.00
2024-12-08 14:54:17,66,2443,25,41,1492.44,2488.02,0.00
2024-12-08 14:54:17,65,2443,24,41,1498.27,2488.26,0.00
2024-12-08 14:54:17,65,2444,24,41,1518.69,2489.00,0.00
2024-12-08 14:54:17,66,2444,24,42,1495.67,2489.02,0.00
2024-12-08 14:54:17,65,2444,24,41,1516.02,2489.05,0.00
2024-12-08 14:54:17,65,2445,24,41,1515.85,2490.00,0.00
2024-12-08 14:54:17,66,2445,25,41,1492.88,2490.02,0.00
2024-12-08 14:54:17,65,2445,24,41,1502.36,2490.20,0.00
2024-12-08 14:54:17,65,2446,24,41,1521.29,2491.00,0.00
2024-12-08 14:54:17,66,2446,24,42,1498.24,2491.02,0.00
2024-12-08 14:54:17,65,2446,24,41,1519.00,2491.05,0.00
2024-12-08 14:54:17,65,2447,24,41,1518.83,2492.00,0.00
2024-12-08 14:54:17,66,2447,24,42,1495.82,2492.02,0.00
2024-12-08 14:54:17,67,2446,25,42,1443.50,2492.36,0.00
2024-12-08 14:54:18,67,2447,25,42,1475.57,2493.00,0.00
2024-12-08 14:54:18,68,2447,26,42,1453.87,2493.02,0.00
2024-12-08 14:54:18,67,2447,26,41,1471.14,2493.08,0.00
2024-12-08 14:54:18,66,2447,25,41,1488.18,2493.20,0.00
2024-12-08 14:54:18,66,2448,25,41,1544.25,2494.00,0.00
2024-12-08 14:54:18,67,2448,26,41,1521.20,2494.02,0.00
2024-12-08 14:54:18,67,2449,26,41,1512.13,2495.00,0.00
2024-12-08 14:54:18,68,2449,26,42,1489.89,2495.02,0.00
2024-12-08 14:54:18,67,2449,26,41,1508.06,2495.08,0.00
2024-12-08 14:54:18,67,2450,26,41,1507.89,2496.00,0.00
2024-12-08 14:54:18,68,2450,26,42,1485.72,2496.02,0.00
2024-12-08 14:54:18,69,2449,26,43,1444.53,2496.55,0.00
2024-12-08 14:54:18,68,2449,25,43,1462.01,2496.91,0.00
2024-12-08 14:54:18,68,2450,25,43,1496.60,2497.00,0.00
2024-12-08 14:54:18,69,2450,26,43,1474.91,2497.01,0.00
2024-12-08 14:54:18,68,2450,26,42,1492.58,2497.07,0.00
2024-12-08 14:54:18,68,2451,26,42,1528.79,2498.00,0.00
2024-12-08 14:54:18,69,2451,26,43,1506.63,2498.01,0.00
2024-12-08 14:54:18,69,2452,26,43,1497.09,2499.00,0.00
2024-12-08 14:54:18,70,2452,27,43,1475.71,2499.01,0.00
2024-12-08 14:54:18,69,2452,27,42,1493.50,2499.07,0.00
2024-12-08 14:54:18,69,2453,27,42,1492.62,2500.00,0.00
2024-12-08 14:54:18,70,2453,28,42,1471.30,2500.01,0.00
2024-12-08 14:54:18,70,2454,28,42,1467.91,2501.00,0.00
2024-12-08 14:54:18,71,2454,29,42,1447.24,2501.01,0.00
2024-12-08 14:54:18,71,2455,29,42,1438.30,2502.00,0.00
2024-12-08 14:54:18,72,2455,29,43,1418.33,2502.01,0.00
2024-12-08 14:54:18,71,2455,29,42,1431.98,2502.07,0.00
2024-12-08 14:54:18,71,2456,29,42,1430.42,2503.00,0.00
2024-12-08 14:54:18,72,2456,29,43,1410.55,2503.01,0.00
2024-12-08 14:54:18,72,2457,29,43,1400.33,2504.00,0.00
2024-12-08 14:54:18,73,2457,29,44,1381.15,2504.01,0.00
2024-12-08 14:54:18,72,2457,29,43,1399.65,2504.03,0.00
2024-12-08 14:54:18,71,2457,29,42,1416.90,2504.06,0.00
2024-12-08 14:54:18,70,2457,28,42,1408.34,2504.97,0.00
2024-12-08 14:54:18,70,2458,28,42,1443.42,2505.00,0.00
2024-12-08 14:54:18,71,2458,29,42,1423.09,2505.01,0.00
2024-12-08 14:54:18,71,2459,29,42,1413.07,2506.00,0.00
2024-12-08 14:54:18,72,2459,30,42,1393.45,2506.01,0.00
2024-12-08 14:54:18,71,2459,30,41,1410.27,2506.06,0.00
2024-12-08 14:54:18,71,2460,30,41,1408.34,2507.00,0.00
2024-12-08 14:54:18,72,2460,31,41,1388.78,2507.01,0.00
2024-12-08 14:54:18,72,2461,31,41,1378.54,2508.00,0.00
2024-12-08 14:54:18,73,2461,31,42,1359.65,2508.01,0.00
2024-12-08 14:54:18,72,2461,31,41,1375.77,2508.06,0.00
2024-12-08 14:54:18,72,2462,31,41,1373.51,2509.00,0.00
2024-12-08 14:54:18,73,2462,31,42,1354.69,2509.01,0.00
2024-12-08 14:54:18,73,2463,31,42,1344.23,2510.00,0.00
2024-12-08 14:54:18,74,2463,31,43,1326.07,2510.01,0.00
2024-12-08 14:54:18,73,2463,31,42,1341.16,2510.06,0.00
2024-12-08 14:54:18,72,2463,30,42,1334.42,2510.89,0.00
2024-12-08 14:54:18,72,2464,30,42,1366.58,2511.00,0.00
2024-12-08 14:54:18,73,2464,31,42,1347.86,2511.01,0.00
2024-12-08 14:54:18,73,2465,31,42,1337.88,2512.00,0.00
2024-12-08 14:54:18,74,2465,31,43,1319.80,2512.01,0.00
2024-12-08 14:54:18,73,2465,31,42,1334.11,2512.06,0.00
2024-12-08 14:54:18,73,2466,31,42,1331.53,2513.00,0.00
2024-12-08 14:54:18,74,2466,31,43,1313.53,2513.01,0.00
2024-12-08 14:54:18,73,2466,30,43,1305.57,2513.75,0.00
2024-12-08 14:54:18,73,2467,30,43,1333.98,2514.00,0.00
2024-12-08 14:54:18,74,2467,30,44,1315.95,2514.01,0.00
2024-12-08 14:54:18,73,2467,30,43,1330.20,2514.06,0.00
2024-12-08 14:54:18,72,2467,29,43,1331.20,2514.75,0.00
2024-12-08 14:54:18,72,2468,29,43,1346.05,2515.00,0.00
2024-12-08 14:54:18,73,2468,29,44,1327.62,2515.01,0.00
2024-12-08 14:54:18,72,2468,29,43,1345.36,2515.03,0.00
2024-12-08 14:54:18,71,2468,28,43,1344.14,2515.10,0.00
2024-12-08 14:54:18,70,2468,27,43,1360.86,2515.20,0.00
2024-12-08 14:54:18,70,2469,27,43,1377.16,2516.00,0.00
2024-12-08 14:54:18,71,2469,28,43,1357.76,2516.01,0.00
2024-12-08 14:54:18,70,2469,28,42,1373.94,2516.04,0.00
2024-12-08 14:54:18,69,2469,27,42,1376.16,2516.46,0.00
2024-12-08 14:54:18,69,2470,27,42,1399.49,2517.00,0.00
2024-12-08 14:54:18,70,2470,27,43,1379.50,2517.01,0.00
2024-12-08 14:54:18,69,2470,26,43,1388.52,2517.16,0.00
2024-12-08 14:54:18,70,2469,27,43,1356.00,2517.70,0.00
2024-12-08 14:54:18,69,2469,26,43,1383.00,2517.75,0.00
2024-12-08 14:54:18,69,2470,26,43,1398.88,2518.00,0.00
2024-12-08 14:54:18,70,2470,26,44,1378.89,2518.01,0.00
2024-12-08 14:54:18,69,2470,26,43,1395.97,2518.04,0.00
2024-12-08 14:54:18,68,2470,25,43,1390.31,2518.90,0.00
2024-12-08 14:54:18,68,2471,25,43,1461.87,2519.00,0.00
2024-12-08 14:54:18,69,2471,25,44,1440.69,2519.01,0.00
2024-12-08 14:54:18,69,2472,25,44,1431.03,2520.00,0.00
2024-12-08 14:54:18,70,2472,26,44,1410.59,2520.01,0.00
2024-12-08 14:54:18,69,2472,26,43,1428.49,2520.04,0.00
2024-12-08 14:54:18,70,2471,27,43,1407.73,2520.09,0.00
2024-12-08 14:54:19,69,2471,26,43,1415.36,2520.74,0.00
2024-12-08 14:54:19,69,2472,26,43,1445.53,2521.00,0.00
2024-12-08 14:54:19,70,2472,26,44,1424.88,2521.01,0.00
2024-12-08 14:54:19,69,2472,25,44,1433.53,2521.19,0.00
2024-12-08 14:54:19,69,2473,25,44,1472.05,2522.00,0.00
2024-12-08 14:54:19,70,2473,26,44,1451.02,2522.01,0.00
2024-12-08 14:54:19,69,2473,26,43,1469.87,2522.04,0.00
2024-12-08 14:54:19,68,2473,25,43,1471.83,2522.77,0.00
2024-12-08 14:54:19,68,2474,25,43,1503.20,2523.00,0.00
2024-12-08 14:54:19,69,2474,26,43,1481.41,2523.01,0.00
2024-12-08 14:54:19,69,2475,26,43,1471.75,2524.00,0.00
2024-12-08 14:54:19,70,2475,26,44,1450.73,2524.01,0.00
2024-12-08 14:54:19,69,2475,26,43,1469.22,2524.06,0.00
2024-12-08 14:54:19,69,2476,26,43,1467.95,2525.00,0.00
2024-12-08 14:54:19,70,2476,26,44,1446.98,2525.01,0.00
2024-12-08 14:54:19,69,2476,25,44,1439.97,2525.52,0.00
2024-12-08 14:54:19,69,2477,25,44,1464.87,2526.00,0.00
2024-12-08 14:54:19,70,2477,25,45,1443.94,2526.01,0.00
2024-12-08 14:54:19,69,2477,25,44,1462.69,2526.06,0.00
2024-12-08 14:54:19,69,2478,25,44,1461.42,2527.00,0.00
2024-12-08 14:54:19,70,2478,26,44,1440.54,2527.01,0.00
2024-12-08 14:54:19,70,2479,26,44,1430.64,2528.00,0.00
2024-12-08 14:54:19,71,2479,27,44,1410.49,2528.01,0.00
2024-12-08 14:54:19,70,2479,27,43,1426.69,2528.09,0.00
2024-12-08 14:54:19,69,2479,26,43,1432.26,2528.70,0.00
2024-12-08 14:54:19,69,2480,26,43,1446.81,2529.00,0.00
2024-12-08 14:54:19,70,2480,26,44,1426.15,2529.01,0.00
2024-12-08 14:54:19,69,2480,25,44,1434.42,2529.22,0.00
2024-12-08 14:54:19,69,2481,25,44,1437.12,2530.00,0.00
2024-12-08 14:54:19,70,2481,25,45,1416.59,2530.01,0.00
2024-12-08 14:54:19,69,2481,24,45,1435.37,2530.07,0.00
2024-12-08 14:54:19,68,2481,24,44,1454.25,2530.07,0.00
2024-12-08 14:54:19,68,2482,24,44,1453.68,2531.00,0.00
2024-12-08 14:54:19,69,2482,24,45,1432.62,2531.01,0.00
2024-12-08 14:54:19,68,2482,23,45,1422.11,2531.84,0.00
2024-12-08 14:54:19,68,2483,23,45,1455.37,2532.00,0.00
2024-12-08 14:54:19,69,2483,24,45,1434.28,2532.01,0.00
2024-12-08 14:54:19,68,2483,24,44,1448.70,2532.10,0.00
2024-12-08 14:54:19,67,2483,23,44,1444.12,2532.64,0.00
2024-12-08 14:54:19,67,2484,23,44,1473.14,2533.00,0.00
2024-12-08 14:54:19,68,2484,24,44,1451.48,2533.02,0.00
2024-12-08 14:54:19,68,2485,24,44,1442.63,2534.00,0.00
2024-12-08 14:54:19,69,2485,25,44,1421.72,2534.01,0.00
2024-12-08 14:54:19,68,2485,24,44,1441.89,2534.03,0.00
2024-12-08 14:54:19,67,2485,24,43,1457.38,2534.10,0.00
2024-12-08 14:54:19,66,2485,23,43,1475.02,2534.24,0.00
2024-12-08 14:54:19,66,2486,23,43,1494.72,2535.00,0.00
2024-12-08 14:54:19,67,2486,24,43,1472.41,2535.02,0.00
2024-12-08 14:54:19,67,2487,24,43,1463.28,2536.00,0.00
2024-12-08 14:54:19,68,2487,25,43,1441.77,2536.02,0.00
2024-12-08 14:54:19,67,2487,25,42,1457.26,2536.10,0.00
2024-12-08 14:54:19,67,2488,25,42,1457.80,2537.00,0.00
2024-12-08 14:54:19,68,2488,25,43,1436.36,2537.02,0.00
2024-12-08 14:54:19,67,2488,24,43,1442.37,2537.28,0.00
2024-12-08 14:54:19,67,2489,24,43,1462.54,2538.00,0.00
2024-12-08 14:54:19,68,2489,24,44,1441.04,2538.02,0.00
2024-12-08 14:54:19,67,2489,23,44,1461.58,2538.05,0.00
2024-12-08 14:54:19,66,2489,22,44,1475.27,2538.06,0.00
2024-12-08 14:54:19,65,2489,22,43,1494.06,2538.08,0.00
2024-12-08 14:54:19,65,2490,22,43,1510.25,2539.00,0.00
2024-12-08 14:54:19,66,2490,22,44,1487.37,2539.02,0.00
2024-12-08 14:54:19,66,2491,22,44,1485.86,2540.00,0.00
2024-12-08 14:54:19,67,2491,22,45,1463.68,2540.02,0.00
2024-12-08 14:54:19,66,2491,21,45,1447.59,2540.82,0.00
2024-12-08 14:54:19,66,2492,21,45,1481.61,2541.00,0.00
2024-12-08 14:54:19,67,2492,21,46,1459.50,2541.02,0.00
2024-12-08 14:54:19,66,2492,21,45,1473.94,2541.08,0.00
2024-12-08 14:54:19,66,2493,21,45,1474.11,2542.00,0.00
2024-12-08 14:54:19,67,2493,22,45,1452.11,2542.02,0.00
2024-12-08 14:54:19,67,2494,22,45,1442.81,2543.00,0.00
2024-12-08 14:54:19,68,2494,23,45,1421.59,2543.02,0.00
2024-12-08 14:54:19,67,2494,23,44,1438.65,2543.08,0.00
2024-12-08 14:54:19,66,2494,22,44,1455.50,2543.26,0.00
2024-12-08 14:54:19,66,2495,22,44,1460.23,2544.00,0.00
2024-12-08 14:54:19,67,2495,22,45,1438.44,2544.02,0.00
2024-12-08 14:54:19,66,2495,21,45,1446.05,2544.26,0.00
2024-12-08 14:54:19,66,2496,21,45,1466.21,2545.00,0.00
2024-12-08 14:54:19,67,2496,22,45,1444.32,2545.02,0.00
2024-12-08 14:54:19,66,2496,22,44,1461.99,2545.09,0.00
2024-12-08 14:54:19,66,2497,22,44,1462.54,2546.00,0.00
2024-12-08 14:54:19,67,2497,23,44,1440.71,2546.02,0.00
2024-12-08 14:54:19,67,2498,23,44,1431.39,2547.00,0.00
2024-12-08 14:54:19,68,2498,24,44,1410.34,2547.02,0.00
2024-12-08 14:54:19,69,2497,24,45,1388.81,2547.09,0.00
2024-12-08 14:54:19,68,2497,24,44,1438.09,2547.10,0.00
2024-12-08 14:54:20,67,2497,23,44,1455.42,2547.25,0.00
2024-12-08 14:54:20,67,2498,23,44,1459.72,2548.00,0.00
2024-12-08 14:54:20,68,2498,24,44,1438.25,2548.02,0.00
2024-12-08 14:54:20,67,2498,23,44,1434.59,2548.70,0.00
2024-12-08 14:54:20,67,2499,23,44,1488.06,2549.00,0.00
2024-12-08 14:54:20,68,2499,24,44,1466.18,2549.02,0.00
2024-12-08 14:54:20,67,2499,24,43,1484.67,2549.09,0.00
2024-12-08 14:54:20,66,2499,23,43,1478.72,2549.96,0.00
2024-12-08 14:54:20,66,2500,23,43,1516.22,2550.00,0.00
2024-12-08 14:54:20,67,2500,24,43,1493.59,2550.02,0.00
2024-12-08 14:54:20,67,2501,24,43,1484.28,2551.00,0.00
2024-12-08 14:54:20,68,2501,24,44,1462.45,2551.02,0.00
2024-12-08 14:54:20,67,2501,24,43,1481.27,2551.09,0.00
2024-12-08 14:54:20,66,2501,23,43,1477.14,2551.92,0.00
2024-12-08 14:54:20,66,2502,23,43,1513.93,2552.00,0.00
2024-12-08 14:54:20,67,2502,24,43,1491.34,2552.02,0.00
2024-12-08 14:54:20,66,2502,23,43,1478.65,2552.62,0.00
2024-12-08 14:54:20,66,2503,23,43,1507.95,2553.00,0.00
2024-12-08 14:54:20,67,2503,23,44,1485.44,2553.02,0.00
2024-12-08 14:54:20,66,2503,23,43,1505.27,2553.09,0.00
2024-12-08 14:54:20,66,2504,23,43,1505.83,2554.00,0.00
2024-12-08 14:54:20,67,2504,24,43,1483.36,2554.02,0.00
2024-12-08 14:54:20,66,2504,23,43,1479.75,2554.73,0.00
2024-12-08 14:54:20,66,2505,23,43,1511.71,2555.00,0.00
2024-12-08 14:54:20,67,2505,24,43,1489.15,2555.02,0.00
2024-12-08 14:54:20,66,2505,24,42,1507.87,2555.11,0.00
2024-12-08 14:54:20,66,2506,24,42,1508.81,2556.00,0.00
2024-12-08 14:54:20,67,2506,25,42,1486.29,2556.02,0.00
2024-12-08 14:54:20,66,2506,24,42,1507.67,2556.05,0.00
2024-12-08 14:54:20,66,2507,24,42,1499.33,2557.00,0.00
2024-12-08 14:54:20,67,2507,25,42,1476.95,2557.02,0.00
2024-12-08 14:54:20,68,2506,25,43,1454.86,2557.06,0.00
2024-12-08 14:54:20,67,2506,25,42,1487.30,2557.12,0.00
2024-12-08 14:54:20,67,2507,25,42,1488.22,2558.00,0.00
2024-12-08 14:54:20,68,2507,26,42,1466.34,2558.02,0.00
2024-12-08 14:54:20,67,2507,25,42,1450.97,2558.94,0.00
2024-12-08 14:54:20,67,2508,25,42,1525.85,2559.00,0.00
2024-12-08 14:54:20,68,2508,25,43,1503.41,2559.02,0.00
2024-12-08 14:54:20,67,2508,25,42,1522.45,2559.10,0.00
2024-12-08 14:54:20,67,2509,25,42,1523.01,2560.00,0.00
2024-12-08 14:54:20,68,2509,26,42,1500.61,2560.02,0.00
2024-12-08 14:54:20,68,2510,26,42,1491.03,2561.00,0.00
2024-12-08 14:54:20,69,2510,27,42,1469.42,2561.01,0.00
2024-12-08 14:54:20,68,2510,27,41,1488.05,2561.10,0.00
2024-12-08 14:54:20,68,2511,27,41,1488.22,2562.00,0.00
2024-12-08 14:54:20,69,2511,28,41,1466.65,2562.01,0.00
2024-12-08 14:54:20,69,2512,28,41,1456.82,2563.00,0.00
2024-12-08 14:54:20,70,2512,28,42,1436.01,2563.01,0.00
2024-12-08 14:54:20,69,2512,28,41,1453.51,2563.10,0.00
2024-12-08 14:54:20,68,2512,27,41,1459.38,2563.72,0.00
2024-12-08 14:54:20,68,2513,27,41,1475.05,2564.00,0.00
2024-12-08 14:54:20,69,2513,27,42,1453.68,2564.01,0.00
2024-12-08 14:54:20,69,2514,27,42,1443.83,2565.00,0.00
2024-12-08 14:54:20,70,2514,28,42,1423.21,2565.01,0.00
2024-12-08 14:54:20,69,2514,28,41,1440.15,2565.10,0.00
2024-12-08 14:54:20,68,2514,27,41,1436.30,2565.62,0.00
2024-12-08 14:54:20,68,2515,27,41,1464.51,2566.00,0.00
2024-12-08 14:54:20,69,2515,27,42,1443.28,2566.01,0.00
2024-12-08 14:54:20,68,2515,27,41,1461.89,2566.06,0.00
2024-12-08 14:54:20,67,2515,26,41,1478.35,2566.08,0.00
2024-12-08 14:54:20,67,2516,26,41,1493.46,2567.00,0.00
2024-12-08 14:54:20,68,2516,26,42,1471.49,2567.02,0.00
2024-12-08 14:54:20,67,2516,25,42,1460.38,2567.58,0.00
2024-12-08 14:54:20,67,2517,25,42,1488.29,2568.00,0.00
2024-12-08 14:54:20,68,2517,25,43,1466.40,2568.02,0.00
2024-12-08 14:54:20,67,2517,25,42,1486.02,2568.08,0.00
2024-12-08 14:54:20,67,2518,25,42,1485.80,2569.00,0.00
2024-12-08 14:54:20,68,2518,25,43,1463.95,2569.02,0.00
2024-12-08 14:54:21,68,2519,25,43,1454.32,2570.00,0.00
2024-12-08 14:54:21,69,2519,26,43,1433.24,2570.01,0.00
2024-12-08 14:54:21,68,2519,26,42,1452.08,2570.07,0.00
2024-12-08 14:54:21,67,2519,25,42,1453.61,2570.52,0.00
2024-12-08 14:54:21,67,2520,25,42,1480.05,2571.00,0.00
2024-12-08 14:54:21,68,2520,25,43,1458.29,2571.02,0.00
2024-12-08 14:54:21,68,2521,25,43,1448.64,2572.00,0.00
2024-12-08 14:54:21,69,2521,26,43,1427.65,2572.01,0.00
2024-12-08 14:54:21,68,2521,26,42,1444.89,2572.10,0.00
2024-12-08 14:54:21,68,2522,26,42,1445.04,2573.00,0.00
2024-12-08 14:54:21,69,2522,26,43,1424.10,2573.01,0.00
2024-12-08 14:54:21,68,2522,25,43,1406.60,2573.97,0.00
2024-12-08 14:54:21,68,2523,25,43,1443.71,2574.00,0.00
2024-12-08 14:54:21,69,2523,26,43,1422.79,2574.01,0.00
2024-12-08 14:54:21,68,2523,26,42,1440.34,2574.10,0.00
2024-12-08 14:54:21,68,2524,26,42,1440.49,2575.00,0.00
2024-12-08 14:54:21,69,2524,26,43,1419.61,2575.01,0.00
2024-12-08 14:54:21,69,2525,26,43,1409.71,2576.00,0.00
2024-12-08 14:54:21,70,2525,27,43,1389.57,2576.01,0.00
2024-12-08 14:54:21,69,2525,27,42,1407.12,2576.10,0.00
2024-12-08 14:54:21,68,2525,26,42,1408.47,2576.79,0.00
2024-12-08 14:54:21,68,2526,26,42,1441.22,2577.00,0.00
2024-12-08 14:54:21,69,2526,27,42,1420.34,2577.01,0.00
2024-12-08 14:54:21,68,2526,26,42,1439.73,2577.06,0.00
2024-12-08 14:54:21,68,2527,26,42,1431.17,2578.00,0.00
2024-12-08 14:54:21,69,2527,27,42,1410.43,2578.01,0.00
2024-12-08 14:54:21,68,2527,26,42,1430.79,2578.02,0.00
2024-12-08 14:54:21,67,2527,26,41,1450.25,2578.08,0.00
2024-12-08 14:54:21,67,2528,26,41,1450.01,2579.00,0.00
2024-12-08 14:54:21,68,2528,26,42,1428.69,2579.02,0.00
2024-12-08 14:54:21,67,2528,25,42,1411.44,2579.67,0.00
2024-12-08 14:54:21,66,2528,24,42,1431.69,2579.73,0.00
2024-12-08 14:54:21,66,2529,24,42,1463.95,2580.00,0.00
2024-12-08 14:54:21,67,2529,25,42,1442.10,2580.02,0.00
2024-12-08 14:54:21,66,2529,25,41,1461.25,2580.08,0.00
2024-12-08 14:54:21,65,2529,24,41,1469.17,2580.43,0.00
2024-12-08 14:54:21,65,2530,24,41,1494.60,2581.00,0.00
2024-12-08 14:54:21,66,2530,25,41,1471.95,2581.02,0.00
2024-12-08 14:54:21,66,2531,25,41,1462.74,2582.00,0.00
2024-12-08 14:54:21,67,2531,26,41,1440.91,2582.02,0.00
2024-12-08 14:54:21,66,2531,26,40,1460.42,2582.08,0.00
2024-12-08 14:54:21,66,2532,26,40,1460.57,2583.00,0.00
2024-12-08 14:54:21,67,2532,26,41,1438.77,2583.02,0.00
2024-12-08 14:54:21,67,2533,26,41,1429.30,2584.00,0.00
2024-12-08 14:54:21,68,2533,27,41,1408.28,2584.02,0.00
2024-12-08 14:54:21,67,2533,27,40,1427.40,2584.08,0.00
2024-12-08 14:54:21,67,2534,27,40,1427.15,2585.00,0.00
2024-12-08 14:54:21,68,2534,28,40,1406.16,2585.02,0.00
2024-12-08 14:54:21,68,2535,28,40,1396.44,2586.00,0.00
2024-12-08 14:54:21,69,2535,28,41,1376.20,2586.01,0.00
2024-12-08 14:54:21,68,2535,28,40,1393.80,2586.07,0.00
2024-12-08 14:54:21,67,2535,27,40,1398.32,2586.72,0.00
2024-12-08 14:54:21,67,2536,27,40,1414.35,2587.00,0.00
2024-12-08 14:54:21,68,2536,27,41,1393.56,2587.02,0.00
2024-12-08 14:54:21,68,2537,27,41,1383.82,2588.00,0.00
2024-12-08 14:54:21,69,2537,28,41,1363.76,2588.01,0.00
2024-12-08 14:54:21,68,2537,28,40,1381.56,2588.07,0.00
2024-12-08 14:54:21,68,2538,28,40,1380.93,2589.00,0.00
2024-12-08 14:54:21,69,2538,28,41,1360.91,2589.01,0.00
2024-12-08 14:54:21,69,2539,28,41,1350.93,2590.00,0.00
2024-12-08 14:54:21,70,2539,28,42,1331.63,2590.01,0.00
2024-12-08 14:54:21,69,2539,28,41,1349.07,2590.07,0.00
2024-12-08 14:54:21,69,2540,28,41,1348.07,2591.00,0.00
2024-12-08 14:54:21,70,2540,28,42,1328.81,2591.01,0.00
2024-12-08 14:54:21,70,2541,28,42,1318.59,2592.00,0.00
2024-12-08 14:54:21,71,2541,28,43,1300.02,2592.01,0.00
2024-12-08 14:54:21,70,2541,28,42,1317.49,2592.04,0.00
2024-12-08 14:54:21,69,2541,28,41,1335.84,2592.06,0.00
2024-12-08 14:54:21,68,2541,27,41,1334.51,2592.79,0.00
2024-12-08 14:54:21,68,2542,27,41,1367.43,2593.00,0.00
2024-12-08 14:54:21,69,2542,28,41,1347.61,2593.01,0.00
2024-12-08 14:54:21,68,2542,28,40,1358.30,2593.06,0.00
2024-12-08 14:54:21,67,2542,27,40,1354.58,2593.85,0.00
2024-12-08 14:54:22,67,2543,27,40,1389.53,2594.00,0.00
2024-12-08 14:54:22,68,2543,27,41,1369.10,2594.02,0.00
2024-12-08 14:54:22,67,2543,27,40,1380.26,2594.06,0.00
2024-12-08 14:54:22,67,2544,27,40,1379.61,2595.00,0.00
2024-12-08 14:54:22,68,2544,28,40,1359.32,2595.02,0.00
2024-12-08 14:54:22,67,2544,28,39,1370.33,2595.06,0.00
2024-12-08 14:54:22,67,2545,28,39,1369.68,2596.00,0.00
2024-12-08 14:54:22,68,2545,29,39,1349.54,2596.02,0.00
2024-12-08 14:54:22,69,2544,29,40,1309.85,2596.54,0.00
2024-12-08 14:54:22,69,2545,29,40,1335.01,2597.00,0.00
2024-12-08 14:54:22,70,2545,29,41,1315.94,2597.01,0.00
2024-12-08 14:54:22,69,2545,29,40,1333.15,2597.07,0.00
2024-12-08 14:54:22,69,2546,29,40,1369.79,2598.00,0.00
2024-12-08 14:54:22,70,2546,30,40,1350.22,2598.01,0.00
2024-12-08 14:54:22,69,2546,30,39,1360.02,2598.09,0.00
2024-12-08 14:54:22,68,2546,29,39,1361.25,2598.77,0.00
2024-12-08 14:54:22,68,2547,29,39,1393.52,2599.00,0.00
2024-12-08 14:54:22,69,2547,29,40,1373.33,2599.01,0.00
2024-12-08 14:54:22,68,2547,29,39,1383.61,2599.09,0.00
2024-12-08 14:54:22,67,2547,28,39,1372.75,2599.72,0.00
2024-12-08 14:54:22,67,2548,28,39,1404.39,2600.00,0.00
2024-12-08 14:54:22,68,2548,29,39,1383.74,2600.02,0.00
2024-12-08 14:54:22,68,2549,29,39,1373.94,2601.00,0.00
2024-12-08 14:54:22,69,2549,30,39,1354.03,2601.01,0.00
2024-12-08 14:54:22,68,2549,30,38,1371.29,2601.10,0.00
2024-12-08 14:54:22,68,2550,30,38,1371.41,2602.00,0.00
2024-12-08 14:54:22,69,2550,31,38,1351.53,2602.01,0.00
2024-12-08 14:54:22,69,2551,31,38,1341.49,2603.00,0.00
2024-12-08 14:54:22,70,2551,32,38,1322.32,2603.01,0.00
2024-12-08 14:54:22,69,2551,32,37,1338.12,2603.12,0.00
2024-12-08 14:54:22,69,2552,32,37,1338.23,2604.00,0.00
2024-12-08 14:54:22,70,2552,33,37,1319.11,2604.01,0.00
2024-12-08 14:54:22,69,2552,32,37,1312.48,2604.71,0.00
2024-12-08 14:54:22,69,2553,32,37,1327.79,2605.00,0.00
2024-12-08 14:54:22,70,2553,33,37,1308.83,2605.01,0.00
2024-12-08 14:54:22,69,2553,33,36,1324.80,2605.12,0.00
2024-12-08 14:54:22,69,2554,33,36,1324.91,2606.00,0.00
2024-12-08 14:54:22,70,2554,33,37,1305.98,2606.01,0.00
2024-12-08 14:54:22,69,2554,33,36,1314.35,2606.12,0.00
2024-12-08 14:54:22,69,2555,33,36,1314.46,2607.00,0.00
2024-12-08 14:54:22,70,2555,33,37,1295.68,2607.01,0.00
2024-12-08 14:54:22,69,2555,32,37,1287.93,2607.73,0.00
2024-12-08 14:54:22,69,2556,32,37,1318.74,2608.00,0.00
2024-12-08 14:54:22,70,2556,32,38,1299.90,2608.01,0.00
2024-12-08 14:54:22,69,2556,32,37,1315.36,2608.12,0.00
2024-12-08 14:54:22,68,2556,31,37,1330.15,2608.28,0.00
2024-12-08 14:54:22,68,2557,31,37,1334.81,2609.00,0.00
2024-12-08 14:54:22,69,2557,31,38,1315.46,2609.01,0.00
2024-12-08 14:54:22,70,2556,31,39,1296.67,2609.04,0.00
2024-12-08 14:54:22,69,2556,30,39,1304.49,2609.81,0.00
2024-12-08 14:54:22,70,2555,31,39,1285.13,2609.86,0.00
2024-12-08 14:54:22,70,2556,31,39,1322.52,2610.00,0.00
2024-12-08 14:54:22,71,2556,31,40,1303.90,2610.01,0.00
2024-12-08 14:54:22,70,2556,31,39,1319.57,2610.11,0.00
2024-12-08 14:54:22,69,2556,30,39,1334.20,2610.28,0.00
2024-12-08 14:54:22,68,2556,29,39,1338.97,2610.52,0.00
2024-12-08 14:54:22,68,2557,29,39,1441.81,2611.00,0.00
2024-12-08 14:54:22,69,2557,30,39,1420.91,2611.01,0.00
2024-12-08 14:54:22,68,2557,30,38,1431.08,2611.12,0.00
2024-12-08 14:54:22,68,2558,30,38,1431.61,2612.00,0.00
2024-12-08 14:54:22,69,2558,30,39,1410.86,2612.01,0.00
2024-12-08 14:54:22,68,2558,29,39,1407.06,2612.19,0.00
2024-12-08 14:54:22,68,2559,29,39,1424.85,2613.00,0.00
2024-12-08 14:54:22,69,2559,30,39,1404.20,2613.01,0.00
2024-12-08 14:54:22,68,2559,30,38,1420.27,2613.12,0.00
2024-12-08 14:54:22,67,2559,29,38,1437.99,2613.25,0.00
2024-12-08 14:54:22,67,2560,29,38,1442.38,2614.00,0.00
2024-12-08 14:54:22,68,2560,29,39,1421.17,2614.02,0.00
2024-12-08 14:54:22,68,2561,29,39,1411.50,2615.00,0.00
2024-12-08 14:54:22,69,2561,30,39,1391.04,2615.01,0.00
2024-12-08 14:54:22,68,2561,30,38,1407.29,2615.12,0.00
2024-12-08 14:54:22,68,2562,30,38,1407.81,2616.00,0.00
2024-12-08 14:54:22,69,2562,30,39,1387.40,2616.01,0.00
2024-12-08 14:54:22,68,2562,29,39,1406.29,2616.06,0.00
2024-12-08 14:54:22,67,2562,28,39,1414.43,2616.24,0.00
2024-12-08 14:54:22,67,2563,28,39,1418.75,2617.00,0.00
2024-12-08 14:54:22,68,2563,28,40,1397.89,2617.02,0.00
2024-12-08 14:54:22,67,2563,27,40,1417.60,2617.05,0.00
2024-12-08 14:54:22,66,2563,26,40,1438.68,2617.05,0.00
2024-12-08 14:54:22,65,2563,26,39,1458.80,2617.08,0.00
2024-12-08 14:54:22,65,2564,26,39,1459.34,2618.00,0.00
2024-12-08 14:54:22,66,2564,26,40,1437.23,2618.02,0.00
2024-12-08 14:54:22,65,2564,25,40,1419.26,2618.97,0.00
2024-12-08 14:54:23,65,2565,25,40,1458.76,2619.00,0.00
2024-12-08 14:54:23,66,2565,25,41,1436.65,2619.02,0.00
2024-12-08 14:54:23,65,2565,25,40,1456.36,2619.08,0.00
2024-12-08 14:54:23,64,2565,24,40,1450.78,2619.94,0.00
2024-12-08 14:54:23,64,2566,24,40,1490.12,2620.00,0.00
2024-12-08 14:54:23,65,2566,24,41,1467.20,2620.02,0.00
2024-12-08 14:54:23,64,2566,23,41,1488.91,2620.05,0.00
2024-12-08 14:54:23,63,2566,22,41,1485.13,2620.18,0.00
2024-12-08 14:54:23,63,2567,22,41,1505.62,2621.00,0.00
2024-12-08 14:54:23,64,2567,23,41,1482.09,2621.02,0.00
2024-12-08 14:54:23,63,2567,23,40,1503.97,2621.06,0.00
2024-12-08 14:54:23,62,2567,22,40,1523.63,2621.21,0.00
2024-12-08 14:54:23,62,2568,22,40,1545.71,2622.00,0.00
2024-12-08 14:54:23,63,2568,23,40,1521.18,2622.02,0.00
2024-12-08 14:54:23,62,2568,22,40,1544.46,2622.05,0.00
2024-12-08 14:54:23,62,2569,22,40,1536.99,2623.00,0.00
2024-12-08 14:54:23,63,2569,23,40,1512.60,2623.02,0.00
2024-12-08 14:54:23,62,2569,23,39,1535.32,2623.05,0.00
2024-12-08 14:54:23,62,2570,23,39,1536.31,2624.00,0.00
2024-12-08 14:54:23,63,2570,24,39,1511.92,2624.02,0.00
2024-12-08 14:54:23,62,2570,23,39,1493.03,2624.69,0.00
2024-12-08 14:54:23,62,2571,23,39,1527.58,2625.00,0.00
2024-12-08 14:54:23,63,2571,23,40,1503.33,2625.02,0.00
2024-12-08 14:54:23,62,2571,23,39,1522.53,2625.10,0.00
2024-12-08 14:54:23,61,2571,22,39,1533.83,2625.36,0.00
2024-12-08 14:54:23,61,2572,22,39,1560.53,2626.00,0.00
2024-12-08 14:54:23,62,2572,22,40,1535.36,2626.02,0.00
2024-12-08 14:54:23,63,2571,22,41,1510.59,2626.06,0.00
2024-12-08 14:54:23,62,2571,21,41,1528.88,2626.65,0.00
2024-12-08 14:54:23,62,2572,21,41,1562.22,2627.00,0.00
2024-12-08 14:54:23,63,2572,21,42,1537.42,2627.02,0.00
2024-12-08 14:54:23,62,2572,20,42,1552.50,2627.05,0.00
2024-12-08 14:54:23,61,2572,20,41,1574.08,2627.08,0.00
2024-12-08 14:54:23,61,2573,20,41,1636.68,2628.00,0.00
2024-12-08 14:54:23,62,2573,20,42,1610.29,2628.02,0.00
2024-12-08 14:54:23,61,2573,19,42,1598.62,2628.59,0.00
2024-12-08 14:54:23,61,2574,19,42,1631.27,2629.00,0.00
2024-12-08 14:54:23,62,2574,19,43,1604.96,2629.02,0.00
2024-12-08 14:54:23,61,2574,19,42,1624.42,2629.10,0.00
2024-12-08 14:54:23,61,2575,19,42,1627.15,2630.00,0.00
2024-12-08 14:54:23,62,2575,20,42,1600.91,2630.02,0.00
2024-12-08 14:54:23,62,2576,20,42,1592.75,2631.00,0.00
2024-12-08 14:54:23,63,2576,21,42,1567.47,2631.02,0.00
2024-12-08 14:54:23,62,2576,21,41,1584.74,2631.11,0.00
2024-12-08 14:54:23,62,2577,21,41,1587.41,2632.00,0.00
2024-12-08 14:54:23,63,2577,22,41,1562.22,2632.02,0.00
2024-12-08 14:54:23,62,2577,21,41,1559.15,2632.42,0.00
2024-12-08 14:54:23,62,2578,21,41,1586.74,2633.00,0.00
2024-12-08 14:54:23,63,2578,21,42,1561.56,2633.02,0.00
2024-12-08 14:54:23,62,2578,21,41,1579.14,2633.11,0.00
2024-12-08 14:54:23,62,2579,21,41,1581.82,2634.00,0.00
2024-12-08 14:54:23,63,2579,21,42,1556.71,2634.02,0.00
2024-12-08 14:54:23,63,2580,21,42,1548.91,2635.00,0.00
2024-12-08 14:54:23,64,2580,22,42,1524.71,2635.02,0.00
2024-12-08 14:54:23,63,2580,22,41,1540.59,2635.13,0.00
2024-12-08 14:54:23,62,2580,21,41,1563.76,2635.19,0.00
2024-12-08 14:54:23,61,2580,20,41,1560.99,2635.97,0.00
2024-12-08 14:54:23,61,2581,20,41,1603.36,2636.00,0.00
2024-12-08 14:54:23,62,2581,20,42,1577.50,2636.02,0.00
2024-12-08 14:54:23,62,2582,20,42,1569.38,2637.00,0.00
2024-12-08 14:54:23,63,2582,21,42,1544.47,2637.02,0.00
2024-12-08 14:54:23,62,2582,21,41,1561.35,2637.13,0.00
2024-12-08 14:54:23,62,2583,21,41,1564.45,2638.00,0.00
2024-12-08 14:54:23,63,2583,22,41,1539.61,2638.02,0.00
2024-12-08 14:54:23,63,2584,22,41,1531.45,2639.00,0.00
2024-12-08 14:54:23,64,2584,22,42,1507.52,2639.02,0.00
2024-12-08 14:54:23,63,2584,22,41,1523.95,2639.13,0.00
2024-12-08 14:54:23,63,2585,22,41,1526.58,2640.00,0.00
2024-12-08 14:54:23,64,2585,22,42,1502.73,2640.02,0.00
2024-12-08 14:54:23,63,2585,21,42,1498.68,2640.43,0.00
2024-12-08 14:54:23,63,2586,21,42,1525.90,2641.00,0.00
2024-12-08 14:54:23,64,2586,22,42,1502.06,2641.02,0.00
2024-12-08 14:54:23,63,2586,22,41,1518.40,2641.13,0.00
2024-12-08 14:54:23,63,2587,22,41,1521.03,2642.00,0.00
2024-12-08 14:54:23,64,2587,23,41,1497.26,2642.02,0.00
2024-12-08 14:54:23,63,2587,22,41,1495.22,2642.68,0.00
2024-12-08 14:54:24,62,2587,21,41,1516.74,2642.73,0.00
2024-12-08 14:54:24,62,2588,21,41,1552.34,2643.00,0.00
2024-12-08 14:54:24,63,2588,22,41,1527.70,2643.02,0.00
2024-12-08 14:54:24,62,2588,22,40,1544.71,2643.13,0.00
2024-12-08 14:54:24,61,2588,21,40,1555.60,2643.69,0.00
2024-12-08 14:54:24,61,2589,21,40,1573.62,2644.00,0.00
2024-12-08 14:54:24,62,2589,21,41,1548.24,2644.02,0.00
2024-12-08 14:54:24,61,2589,20,41,1547.22,2644.15,0.00
2024-12-08 14:54:24,61,2590,20,41,1568.58,2645.00,0.00
2024-12-08 14:54:24,62,2590,20,42,1543.28,2645.02,0.00
2024-12-08 14:54:24,61,2590,19,42,1559.07,2645.10,0.00
2024-12-08 14:54:24,60,2590,19,41,1579.77,2645.12,0.00
2024-12-08 14:54:24,60,2591,19,41,1601.06,2646.00,0.00
2024-12-08 14:54:24,61,2591,20,41,1574.81,2646.02,0.00
2024-12-08 14:54:24,61,2592,20,41,1567.07,2647.00,0.00
2024-12-08 14:54:24,62,2592,20,42,1541.79,2647.02,0.00
2024-12-08 14:54:24,61,2592,20,41,1565.79,2647.05,0.00
2024-12-08 14:54:24,60,2592,20,40,1584.84,2647.10,0.00
2024-12-08 14:54:24,61,2591,21,40,1553.73,2647.33,0.00
2024-12-08 14:54:24,61,2592,21,40,1595.88,2648.00,0.00
2024-12-08 14:54:24,62,2592,21,41,1570.14,2648.02,0.00
2024-12-08 14:54:24,62,2593,21,41,1605.51,2649.00,0.00
2024-12-08 14:54:24,63,2593,21,42,1580.02,2649.02,0.00
2024-12-08 14:54:24,62,2593,20,42,1604.25,2649.05,0.00
2024-12-08 14:54:24,61,2593,20,41,1623.17,2649.08,0.00
2024-12-08 14:54:24,61,2594,20,41,1625.49,2650.00,0.00
2024-12-08 14:54:24,62,2594,20,42,1599.27,2650.02,0.00
2024-12-08 14:54:24,62,2595,20,42,1591.62,2651.00,0.00
2024-12-08 14:54:24,63,2595,20,43,1566.36,2651.02,0.00
2024-12-08 14:54:24,62,2595,19,43,1574.98,2651.08,0.00
2024-12-08 14:54:24,61,2595,19,42,1593.85,2651.08,0.00
2024-12-08 14:54:24,62,2594,20,42,1555.16,2651.61,0.00
2024-12-08 14:54:24,62,2595,20,42,1598.21,2652.00,0.00
2024-12-08 14:54:24,63,2595,20,43,1572.84,2652.02,0.00
2024-12-08 14:54:24,62,2595,19,43,1562.16,2652.84,0.00
2024-12-08 14:54:24,62,2596,19,43,1643.58,2653.00,0.00
2024-12-08 14:54:24,63,2596,19,44,1617.49,2653.02,0.00
2024-12-08 14:54:24,62,2596,19,43,1635.48,2653.08,0.00
2024-12-08 14:54:24,62,2597,19,43,1637.35,2654.00,0.00
2024-12-08 14:54:24,63,2597,20,43,1611.36,2654.02,0.00
2024-12-08 14:54:24,63,2598,20,43,1603.42,2655.00,0.00
2024-12-08 14:54:24,64,2598,21,43,1578.37,2655.02,0.00
2024-12-08 14:54:24,63,2598,21,42,1595.44,2655.08,0.00
2024-12-08 14:54:24,62,2598,20,42,1619.06,2655.15,0.00
2024-12-08 14:54:24,61,2598,19,42,1621.76,2655.84,0.00
2024-12-08 14:54:24,61,2599,19,42,1661.09,2656.00,0.00
2024-12-08 14:54:24,62,2599,20,42,1634.30,2656.02,0.00
2024-12-08 14:54:24,61,2599,19,42,1635.10,2656.67,0.00
2024-12-08 14:54:24,61,2600,19,42,1652.83,2657.00,0.00
2024-12-08 14:54:24,62,2600,20,42,1626.17,2657.02,0.00
2024-12-08 14:54:24,61,2600,20,41,1645.02,2657.08,0.00
2024-12-08 14:54:24,61,2601,20,41,1647.35,2658.00,0.00
2024-12-08 14:54:24,62,2601,21,41,1620.78,2658.02,0.00
2024-12-08 14:54:24,61,2601,20,41,1604.13,2658.67,0.00
2024-12-08 14:54:24,61,2602,20,41,1639.25,2659.00,0.00
2024-12-08 14:54:24,62,2602,21,41,1612.81,2659.02,0.00
2024-12-08 14:54:24,61,2602,21,40,1631.87,2659.08,0.00
2024-12-08 14:54:24,61,2603,21,40,1634.20,2660.00,0.00
2024-12-08 14:54:24,62,2603,21,41,1607.84,2660.02,0.00
2024-12-08 14:54:24,62,2604,21,41,1599.44,2661.00,0.00
2024-12-08 14:54:24,63,2604,22,41,1574.05,2661.02,0.00
2024-12-08 14:54:24,62,2604,22,40,1592.59,2661.08,0.00
2024-12-08 14:54:24,62,2605,22,40,1594.45,2662.00,0.00
2024-12-08 14:54:24,63,2605,23,40,1569.15,2662.02,0.00
2024-12-08 14:54:24,63,2606,23,40,1560.44,2663.00,0.00
2024-12-08 14:54:24,64,2606,23,41,1536.05,2663.02,0.00
2024-12-08 14:54:24,63,2606,23,40,1553.70,2663.08,0.00
2024-12-08 14:54:24,63,2607,23,40,1555.10,2664.00,0.00
2024-12-08 14:54:24,64,2607,24,40,1530.80,2664.02,0.00
2024-12-08 14:54:24,63,2607,23,40,1543.31,2664.14,0.00
2024-12-08 14:54:24,62,2607,22,40,1554.44,2664.66,0.00
2024-12-08 14:54:24,62,2608,22,40,1572.28,2665.00,0.00
2024-12-08 14:54:24,63,2608,23,40,1547.32,2665.02,0.00
2024-12-08 14:54:24,62,2608,23,39,1564.57,2665.10,0.00
2024-12-08 14:54:25,62,2609,23,39,1566.85,2666.00,0.00
2024-12-08 14:54:25,63,2609,23,40,1541.98,2666.02,0.00
2024-12-08 14:54:25,62,2609,23,39,1565.15,2666.06,0.00
2024-12-08 14:54:25,62,2610,23,39,1557.97,2667.00,0.00
2024-12-08 14:54:25,63,2610,24,39,1533.24,2667.02,0.00
2024-12-08 14:54:25,62,2610,23,39,1538.64,2667.08,0.00
2024-12-08 14:54:25,61,2610,23,38,1558.18,2667.08,0.00
2024-12-08 14:54:25,61,2611,23,38,1577.99,2668.00,0.00
2024-12-08 14:54:25,62,2611,24,38,1552.53,2668.02,0.00
2024-12-08 14:54:25,62,2612,24,38,1545.66,2669.00,0.00
2024-12-08 14:54:25,63,2612,25,38,1521.12,2669.02,0.00
2024-12-08 14:54:25,62,2612,24,38,1543.67,2669.08,0.00
2024-12-08 14:54:25,61,2612,24,37,1561.10,2669.08,0.00
2024-12-08 14:54:25,61,2613,24,37,1563.41,2670.00,0.00
2024-12-08 14:54:25,62,2613,25,37,1538.19,2670.02,0.00
2024-12-08 14:54:25,62,2614,25,37,1531.19,2671.00,0.00
2024-12-08 14:54:25,63,2614,26,37,1506.89,2671.02,0.00
2024-12-08 14:54:25,62,2614,25,37,1514.39,2671.02,0.00
2024-12-08 14:54:25,62,2615,25,37,1523.15,2672.00,0.00
2024-12-08 14:54:25,63,2615,26,37,1498.97,2672.02,0.00
2024-12-08 14:54:25,62,2615,26,36,1514.97,2672.06,0.00
2024-12-08 14:54:25,62,2616,26,36,1516.39,2673.00,0.00
2024-12-08 14:54:25,63,2616,27,36,1492.32,2673.02,0.00
2024-12-08 14:54:25,62,2616,27,35,1514.24,2673.03,0.00
2024-12-08 14:54:25,63,2615,28,35,1476.05,2673.60,0.00
2024-12-08 14:54:25,63,2616,28,35,1501.36,2674.00,0.00
2024-12-08 14:54:25,64,2616,29,35,1477.91,2674.02,0.00
2024-12-08 14:54:25,64,2617,29,35,1512.20,2675.00,0.00
2024-12-08 14:54:25,65,2617,30,35,1488.94,2675.02,0.00
2024-12-08 14:54:25,64,2617,30,34,1505.53,2675.05,0.00
2024-12-08 14:54:25,64,2618,30,34,1505.66,2676.00,0.00
2024-12-08 14:54:25,65,2618,30,35,1482.49,2676.02,0.00
2024-12-08 14:54:25,65,2619,30,35,1474.45,2677.00,0.00
2024-12-08 14:54:25,66,2619,30,36,1452.11,2677.02,0.00
2024-12-08 14:54:25,65,2619,30,35,1468.29,2677.05,0.00
2024-12-08 14:54:25,65,2620,30,35,1468.00,2678.00,0.00
2024-12-08 14:54:25,66,2620,31,35,1445.76,2678.02,0.00
2024-12-08 14:54:25,65,2620,30,35,1441.55,2678.69,0.00
2024-12-08 14:54:25,65,2621,30,35,1474.73,2679.00,0.00
2024-12-08 14:54:25,66,2621,30,36,1452.39,2679.02,0.00
2024-12-08 14:54:25,65,2621,30,35,1468.16,2679.08,0.00
2024-12-08 14:54:25,64,2621,29,35,1475.97,2679.64,0.00
2024-12-08 14:54:25,63,2621,28,35,1498.14,2679.68,0.00
2024-12-08 14:54:25,63,2622,28,35,1515.38,2680.00,0.00
2024-12-08 14:54:25,64,2622,29,35,1491.70,2680.02,0.00
2024-12-08 14:54:25,63,2622,28,35,1488.73,2680.40,0.00
2024-12-08 14:54:25,63,2623,28,35,1515.52,2681.00,0.00
2024-12-08 14:54:25,64,2623,28,36,1491.84,2681.02,0.00
2024-12-08 14:54:25,63,2623,28,35,1508.30,2681.10,0.00
2024-12-08 14:54:25,63,2624,28,35,1510.12,2682.00,0.00
2024-12-08 14:54:25,64,2624,28,36,1486.53,2682.02,0.00
2024-12-08 14:54:25,64,2625,28,36,1477.62,2683.00,0.00
2024-12-08 14:54:25,65,2625,29,36,1454.88,2683.02,0.00
2024-12-08 14:54:25,64,2625,29,35,1470.51,2683.09,0.00
2024-12-08 14:54:25,63,2625,28,35,1477.62,2683.40,0.00
2024-12-08 14:54:25,63,2626,28,35,1504.43,2684.00,0.00
2024-12-08 14:54:25,64,2626,28,36,1480.92,2684.02,0.00
2024-12-08 14:54:25,64,2627,28,36,1472.43,2685.00,0.00
2024-12-08 14:54:25,65,2627,28,37,1449.77,2685.02,0.00
2024-12-08 14:54:25,64,2627,28,36,1465.31,2685.09,0.00
2024-12-08 14:54:25,63,2627,27,36,1459.03,2685.94,0.00
2024-12-08 14:54:25,63,2628,27,36,1500.01,2686.00,0.00
2024-12-08 14:54:25,64,2628,28,36,1476.57,2686.02,0.00
2024-12-08 14:54:25,64,2629,28,36,1467.46,2687.00,0.00
2024-12-08 14:54:25,65,2629,28,37,1444.89,2687.02,0.00
2024-12-08 14:54:25,64,2629,28,36,1465.37,2687.05,0.00
2024-12-08 14:54:25,64,2630,28,36,1465.49,2688.00,0.00
2024-12-08 14:54:25,65,2630,29,36,1442.94,2688.02,0.00
2024-12-08 14:54:25,64,2630,28,36,1438.64,2688.14,0.00
2024-12-08 14:54:25,64,2631,28,36,1458.05,2689.00,0.00
2024-12-08 14:54:25,65,2631,28,37,1435.62,2689.02,0.00
2024-12-08 14:54:25,64,2631,28,36,1452.60,2689.08,0.00
2024-12-08 14:54:25,64,2632,28,36,1453.55,2690.00,0.00
2024-12-08 14:54:25,65,2632,28,37,1431.19,2690.02,0.00
2024-12-08 14:54:26,65,2633,28,37,1422.37,2691.00,0.00
2024-12-08 14:54:26,66,2633,29,37,1400.82,2691.02,0.00
2024-12-08 14:54:26,65,2633,29,36,1417.41,2691.08,0.00
2024-12-08 14:54:26,64,2633,28,36,1407.93,2691.97,0.00
2024-12-08 14:54:26,64,2634,28,36,1449.16,2692.00,0.00
2024-12-08 14:54:26,65,2634,28,37,1426.87,2692.02,0.00
2024-12-08 14:54:26,64,2634,27,37,1435.01,2692.22,0.00
2024-12-08 14:54:26,64,2635,27,37,1440.31,2693.00,0.00
2024-12-08 14:54:26,65,2635,28,37,1418.15,2693.02,0.00
2024-12-08 14:54:26,64,2635,28,36,1438.21,2693.03,0.00
2024-12-08 14:54:26,63,2635,27,36,1442.54,2693.71,0.00
2024-12-08 14:54:26,63,2636,27,36,1477.82,2694.00,0.00
2024-12-08 14:54:26,64,2636,27,37,1454.73,2694.02,0.00
2024-12-08 14:54:26,63,2636,27,36,1473.99,2694.06,0.00
2024-12-08 14:54:26,64,2635,27,37,1447.22,2694.23,0.00
2024-12-08 14:54:26,64,2636,27,37,1477.17,2695.00,0.00
2024-12-08 14:54:26,65,2636,27,38,1454.44,2695.02,0.00
2024-12-08 14:54:26,64,2636,26,38,1436.63,2695.94,0.00
2024-12-08 14:54:26,64,2637,26,38,1519.23,2696.00,0.00
2024-12-08 14:54:26,65,2637,27,38,1495.85,2696.02,0.00
2024-12-08 14:54:26,64,2637,27,37,1515.87,2696.06,0.00
2024-12-08 14:54:26,64,2638,27,37,1516.42,2697.00,0.00
2024-12-08 14:54:26,65,2638,28,37,1493.09,2697.02,0.00
2024-12-08 14:54:26,65,2639,28,37,1483.86,2698.00,0.00
2024-12-08 14:54:26,66,2639,29,37,1461.37,2698.02,0.00
2024-12-08 14:54:26,65,2639,29,36,1479.30,2698.06,0.00
2024-12-08 14:54:26,64,2639,28,36,1480.26,2698.80,0.00
2024-12-08 14:54:26,64,2640,28,36,1517.12,2699.00,0.00
2024-12-08 14:54:26,65,2640,28,37,1493.78,2699.02,0.00
2024-12-08 14:54:26,66,2639,29,37,1447.27,2699.64,0.00
2024-12-08 14:54:26,66,2640,29,37,1489.79,2700.00,0.00
2024-12-08 14:54:26,67,2640,30,37,1467.55,2700.02,0.00
2024-12-08 14:54:26,66,2640,30,36,1485.70,2700.06,0.00
2024-12-08 14:54:26,66,2641,30,36,1526.35,2701.00,0.00
2024-12-08 14:54:26,67,2641,31,36,1503.57,2701.02,0.00
2024-12-08 14:54:26,67,2642,31,36,1493.65,2702.00,0.00
2024-12-08 14:54:26,68,2642,31,37,1471.69,2702.02,0.00
2024-12-08 14:54:26,67,2642,31,36,1489.63,2702.08,0.00
2024-12-08 14:54:26,67,2643,31,36,1489.36,2703.00,0.00
2024-12-08 14:54:26,68,2643,32,36,1467.46,2703.02,0.00
2024-12-08 14:54:26,68,2644,32,36,1463.73,2704.00,0.00
2024-12-08 14:54:26,69,2644,33,36,1442.51,2704.01,0.00
2024-12-08 14:54:26,68,2644,32,36,1425.93,2704.91,0.00
2024-12-08 14:54:26,68,2645,32,36,1463.38,2705.00,0.00
2024-12-08 14:54:26,69,2645,32,37,1442.17,2705.01,0.00
2024-12-08 14:54:26,69,2646,32,37,1432.38,2706.00,0.00
2024-12-08 14:54:26,70,2646,33,37,1411.92,2706.01,0.00
2024-12-08 14:54:26,69,2646,33,36,1428.86,2706.06,0.00
2024-12-08 14:54:26,69,2647,33,36,1427.42,2707.00,0.00
2024-12-08 14:54:26,70,2647,33,37,1407.03,2707.01,0.00
2024-12-08 14:54:26,69,2647,33,36,1425.46,2707.06,0.00
2024-12-08 14:54:26,69,2648,33,36,1424.02,2708.00,0.00
2024-12-08 14:54:26,70,2648,33,37,1403.68,2708.01,0.00
2024-12-08 14:54:26,69,2648,32,37,1387.75,2708.62,0.00
2024-12-08 14:54:26,69,2649,32,37,1417.09,2709.00,0.00
2024-12-08 14:54:26,70,2649,33,37,1396.85,2709.01,0.00
2024-12-08 14:54:26,69,2649,32,37,1416.31,2709.03,0.00
2024-12-08 14:54:26,68,2649,32,36,1436.34,2709.04,0.00
2024-12-08 14:54:26,68,2650,32,36,1434.87,2710.00,0.00
2024-12-08 14:54:26,69,2650,32,37,1414.08,2710.01,0.00
2024-12-08 14:54:26,68,2650,31,37,1410.69,2710.40,0.00
2024-12-08 14:54:26,68,2651,31,37,1434.61,2711.00,0.00
2024-12-08 14:54:26,69,2651,32,37,1413.81,2711.01,0.00
2024-12-08 14:54:26,68,2651,31,37,1433.81,2711.03,0.00
2024-12-08 14:54:26,67,2651,31,36,1453.60,2711.05,0.00
2024-12-08 14:54:26,66,2651,30,36,1460.54,2711.38,0.00
2024-12-08 14:54:26,66,2652,30,36,1485.20,2712.00,0.00
2024-12-08 14:54:26,67,2652,30,37,1463.03,2712.02,0.00
2024-12-08 14:54:26,68,2651,30,38,1413.52,2712.65,0.00
2024-12-08 14:54:26,68,2652,30,38,1454.09,2713.00,0.00
2024-12-08 14:54:26,69,2652,30,39,1433.01,2713.01,0.00
2024-12-08 14:54:26,68,2652,29,39,1437.36,2713.34,0.00
2024-12-08 14:54:26,68,2653,29,39,1499.65,2714.00,0.00
2024-12-08 14:54:26,69,2653,30,39,1477.92,2714.01,0.00
2024-12-08 14:54:26,69,2654,30,39,1471.65,2715.00,0.00
2024-12-08 14:54:26,70,2654,31,39,1450.63,2715.01,0.00
2024-12-08 14:54:26,69,2654,31,38,1463.00,2715.04,0.00
2024-12-08 14:54:26,69,2655,31,38,1461.17,2716.00,0.00
2024-12-08 14:54:26,70,2655,32,38,1440.30,2716.01,0.00
2024-12-08 14:54:26,69,2655,32,37,1452.12,2716.04,0.00
2024-12-08 14:54:27,69,2656,32,37,1450.29,2717.00,0.00
2024-12-08 14:54:27,70,2656,33,37,1429.57,2717.01,0.00
2024-12-08 14:54:27,69,2656,32,37,1436.18,2717.25,0.00
2024-12-08 14:54:27,69,2657,32,37,1439.84,2718.00,0.00
2024-12-08 14:54:27,70,2657,33,37,1419.27,2718.01,0.00
2024-12-08 14:54:27,69,2657,33,36,1438.27,2718.04,0.00
2024-12-08 14:54:27,68,2657,32,36,1454.52,2718.22,0.00
2024-12-08 14:54:27,69,2656,33,36,1414.57,2718.96,0.00
2024-12-08 14:54:27,69,2657,33,36,1469.77,2719.00,0.00
2024-12-08 14:54:27,70,2657,33,37,1448.77,2719.01,0.00
2024-12-08 14:54:27,69,2657,32,37,1456.06,2719.22,0.00
2024-12-08 14:54:27,69,2658,32,37,1498.32,2720.00,0.00
2024-12-08 14:54:27,70,2658,32,38,1476.92,2720.01,0.00
2024-12-08 14:54:27,69,2658,32,37,1497.14,2720.04,0.00
2024-12-08 14:54:27,68,2658,31,37,1487.67,2720.96,0.00
2024-12-08 14:54:27,68,2659,31,37,1526.52,2721.00,0.00
2024-12-08 14:54:27,69,2659,32,37,1504.39,2721.01,0.00
2024-12-08 14:54:27,68,2659,31,37,1486.73,2721.65,0.00
2024-12-08 14:54:27,68,2660,31,37,1517.42,2722.00,0.00
2024-12-08 14:54:27,69,2660,32,37,1495.43,2722.01,0.00
2024-12-08 14:54:27,68,2660,32,36,1515.42,2722.04,0.00
2024-12-08 14:54:27,68,2661,32,36,1513.98,2723.00,0.00
2024-12-08 14:54:27,69,2661,32,37,1492.04,2723.01,0.00
2024-12-08 14:54:27,69,2662,32,37,1481.53,2724.00,0.00
2024-12-08 14:54:27,70,2662,32,38,1460.37,2724.01,0.00
2024-12-08 14:54:27,69,2662,32,37,1479.95,2724.04,0.00
2024-12-08 14:54:27,69,2663,32,37,1478.12,2725.00,0.00
2024-12-08 14:54:27,70,2663,32,38,1457.01,2725.01,0.00
2024-12-08 14:54:27,69,2663,31,38,1460.81,2725.28,0.00
2024-12-08 14:54:27,68,2663,30,38,1471.42,2725.68,0.00
2024-12-08 14:54:27,68,2664,30,38,1502.94,2726.00,0.00
2024-12-08 14:54:27,69,2664,31,38,1481.16,2726.01,0.00
2024-12-08 14:54:27,68,2664,30,38,1502.54,2726.02,0.00
2024-12-08 14:54:27,67,2664,30,37,1523.75,2726.03,0.00
2024-12-08 14:54:27,66,2664,29,37,1513.67,2726.67,0.00
2024-12-08 14:54:27,66,2665,29,37,1546.16,2727.00,0.00
2024-12-08 14:54:27,67,2665,29,38,1523.09,2727.02,0.00
2024-12-08 14:54:27,67,2666,29,38,1518.68,2728.00,0.00
2024-12-08 14:54:27,68,2666,30,38,1496.35,2728.02,0.00
2024-12-08 14:54:27,67,2666,29,38,1495.21,2728.28,0.00
2024-12-08 14:54:27,67,2667,29,38,1516.87,2729.00,0.00
2024-12-08 14:54:27,68,2667,29,39,1494.57,2729.02,0.00
2024-12-08 14:54:27,67,2667,29,38,1514.02,2729.05,0.00
2024-12-08 14:54:27,66,2667,28,38,1532.46,2729.21,0.00
2024-12-08 14:54:27,66,2668,28,38,1536.28,2730.00,0.00
2024-12-08 14:54:27,67,2668,28,39,1513.35,2730.02,0.00
2024-12-08 14:54:27,66,2668,27,39,1535.87,2730.02,0.00
2024-12-08 14:54:27,65,2668,27,38,1550.68,2730.03,0.00
2024-12-08 14:54:27,64,2668,26,38,1558.72,2730.13,0.00
2024-12-08 14:54:27,64,2669,26,38,1578.04,2731.00,0.00
2024-12-08 14:54:27,65,2669,27,38,1553.77,2731.02,0.00
2024-12-08 14:54:27,64,2669,27,37,1569.09,2731.03,0.00
2024-12-08 14:54:27,63,2669,26,37,1570.35,2731.49,0.00
2024-12-08 14:54:27,63,2670,26,37,1600.21,2732.00,0.00
2024-12-08 14:54:27,64,2670,27,37,1575.21,2732.02,0.00
2024-12-08 14:54:27,63,2670,27,36,1591.11,2732.03,0.00
2024-12-08 14:54:27,63,2671,27,36,1591.25,2733.00,0.00
2024-12-08 14:54:27,64,2671,28,36,1566.39,2733.02,0.00
2024-12-08 14:54:27,63,2671,28,35,1581.71,2733.05,0.00
2024-12-08 14:54:27,63,2672,28,35,1582.29,2734.00,0.00
2024-12-08 14:54:27,64,2672,29,35,1557.56,2734.02,0.00
2024-12-08 14:54:27,63,2672,29,34,1572.75,2734.05,0.00
2024-12-08 14:54:27,63,2673,29,34,1573.32,2735.00,0.00
2024-12-08 14:54:27,64,2673,30,34,1548.73,2735.02,0.00
2024-12-08 14:54:27,63,2673,29,34,1560.76,2735.16,0.00
2024-12-08 14:54:27,63,2674,29,34,1564.34,2736.00,0.00
2024-12-08 14:54:27,64,2674,29,35,1539.89,2736.02,0.00
2024-12-08 14:54:27,63,2674,29,34,1561.30,2736.05,0.00
2024-12-08 14:54:27,63,2675,29,34,1561.87,2737.00,0.00
2024-12-08 14:54:27,64,2675,29,35,1537.46,2737.02,0.00
2024-12-08 14:54:27,63,2675,28,35,1517.88,2737.68,0.00
2024-12-08 14:54:27,63,2676,28,35,1552.88,2738.00,0.00
2024-12-08 14:54:27,64,2676,29,35,1528.61,2738.02,0.00
2024-12-08 14:54:27,63,2676,29,34,1549.40,2738.05,0.00
2024-12-08 14:54:27,62,2676,28,34,1573.65,2738.06,0.00
2024-12-08 14:54:27,62,2677,28,34,1575.10,2739.00,0.00
2024-12-08 14:54:27,63,2677,29,34,1550.10,2739.02,0.00
2024-12-08 14:54:27,62,2677,28,34,1563.58,2739.11,0.00
2024-12-08 14:54:27,62,2678,28,34,1566.34,2740.00,0.00
2024-12-08 14:54:27,63,2678,29,34,1541.47,2740.02,0.00
2024-12-08 14:54:27,62,2678,29,33,1562.36,2740.05,0.00
2024-12-08 14:54:27,61,2678,28,33,1554.16,2740.66,0.00
2024-12-08 14:54:27,61,2679,28,33,1589.90,2741.00,0.00
2024-12-08 14:54:27,62,2679,28,34,1564.26,2741.02,0.00
2024-12-08 14:54:28,62,2680,28,34,1557.35,2742.00,0.00
2024-12-08 14:54:28,63,2680,29,34,1532.63,2742.02,0.00
2024-12-08 14:54:28,62,2680,29,33,1548.52,2742.10,0.00
2024-12-08 14:54:28,61,2680,28,33,1557.60,2742.69,0.00
2024-12-08 14:54:28,60,2680,27,33,1576.27,2742.78,0.00
2024-12-08 14:54:28,60,2681,27,33,1616.21,2743.00,0.00
2024-12-08 14:54:28,61,2681,28,33,1589.71,2743.02,0.00
2024-12-08 14:54:28,61,2682,28,33,1582.49,2744.00,0.00
2024-12-08 14:54:28,62,2682,28,34,1556.97,2744.02,0.00
2024-12-08 14:54:28,61,2682,28,33,1573.96,2744.10,0.00
2024-12-08 14:54:28,61,2683,28,33,1576.77,2745.00,0.00
2024-12-08 14:54:28,62,2683,29,33,1551.34,2745.02,0.00
2024-12-08 14:54:28,62,2684,29,33,1544.48,2746.00,0.00
2024-12-08 14:54:28,63,2684,29,34,1519.97,2746.02,0.00
2024-12-08 14:54:28,62,2684,29,33,1536.08,2746.10,0.00
2024-12-08 14:54:28,62,2685,29,33,1538.40,2747.00,0.00
2024-12-08 14:54:28,63,2685,30,33,1513.98,2747.02,0.00
2024-12-08 14:54:28,62,2685,29,33,1537.96,2747.02,0.00
2024-12-08 14:54:28,62,2686,29,33,1531.49,2748.00,0.00
2024-12-08 14:54:28,63,2686,29,34,1507.18,2748.02,0.00
2024-12-08 14:54:28,62,2686,29,33,1523.52,2748.08,0.00
2024-12-08 14:54:28,62,2687,29,33,1525.39,2749.00,0.00
2024-12-08 14:54:28,63,2687,29,34,1501.18,2749.02,0.00
2024-12-08 14:54:28,63,2688,29,34,1494.07,2750.00,0.00
2024-12-08 14:54:28,64,2688,29,35,1470.73,2750.02,0.00
2024-12-08 14:54:28,63,2688,29,34,1486.66,2750.08,0.00
2024-12-08 14:54:28,62,2688,28,34,1476.79,2750.97,0.00
2024-12-08 14:54:28,62,2689,28,34,1520.29,2751.00,0.00
2024-12-08 14:54:28,63,2689,29,34,1496.16,2751.02,0.00
2024-12-08 14:54:28,62,2689,28,34,1519.85,2751.02,0.00
2024-12-08 14:54:28,61,2689,27,34,1507.04,2751.53,0.00
2024-12-08 14:54:28,61,2690,27,34,1539.40,2752.00,0.00
2024-12-08 14:54:28,62,2690,28,34,1514.57,2752.02,0.00
2024-12-08 14:54:28,61,2690,28,33,1532.19,2752.07,0.00
2024-12-08 14:54:28,61,2691,28,33,1534.09,2753.00,0.00
2024-12-08 14:54:28,62,2691,28,34,1509.35,2753.02,0.00
2024-12-08 14:54:28,61,2691,27,34,1497.76,2753.54,0.00
2024-12-08 14:54:28,61,2692,27,34,1530.58,2754.00,0.00
2024-12-08 14:54:28,62,2692,27,35,1505.90,2754.02,0.00
2024-12-08 14:54:28,61,2692,27,34,1523.82,2754.07,0.00
2024-12-08 14:54:28,61,2693,27,34,1525.72,2755.00,0.00
2024-12-08 14:54:28,62,2693,28,34,1501.11,2755.02,0.00
2024-12-08 14:54:28,61,2693,27,34,1481.37,2755.71,0.00
2024-12-08 14:54:28,61,2694,27,34,1518.65,2756.00,0.00
2024-12-08 14:54:28,62,2694,27,35,1494.16,2756.02,0.00
2024-12-08 14:54:28,61,2694,26,35,1475.84,2756.67,0.00
2024-12-08 14:54:28,61,2695,26,35,1512.25,2757.00,0.00
2024-12-08 14:54:28,62,2695,27,35,1487.86,2757.02,0.00
2024-12-08 14:54:28,61,2695,27,34,1505.48,2757.08,0.00
2024-12-08 14:54:28,60,2695,26,34,1515.54,2757.63,0.00
2024-12-08 14:54:28,60,2696,26,34,1533.29,2758.00,0.00
2024-12-08 14:54:28,61,2696,27,34,1508.15,2758.02,0.00
2024-12-08 14:54:28,60,2696,27,33,1525.94,2758.08,0.00
2024-12-08 14:54:28,60,2697,27,33,1528.79,2759.00,0.00
2024-12-08 14:54:28,61,2697,27,34,1503.72,2759.02,0.00
2024-12-08 14:54:28,61,2698,27,34,1496.86,2760.00,0.00
2024-12-08 14:54:28,62,2698,27,35,1472.71,2760.02,0.00
2024-12-08 14:54:28,61,2698,27,34,1490.08,2760.08,0.00
2024-12-08 14:54:28,61,2699,27,34,1492.42,2761.00,0.00
2024-12-08 14:54:28,62,2699,27,35,1468.35,2761.02,0.00
2024-12-08 14:54:28,61,2699,26,35,1478.42,2761.20,0.00
2024-12-08 14:54:28,60,2699,25,35,1477.86,2761.87,0.00
2024-12-08 14:54:28,60,2700,25,35,1520.31,2762.00,0.00
2024-12-08 14:54:28,61,2700,25,36,1495.39,2762.02,0.00
2024-12-08 14:54:28,60,2700,25,35,1513.41,2762.08,0.00
2024-12-08 14:54:28,59,2700,24,35,1536.29,2762.19,0.00
2024-12-08 14:54:28,59,2701,24,35,1542.42,2763.00,0.00
2024-12-08 14:54:28,60,2701,25,35,1516.72,2763.02,0.00
2024-12-08 14:54:28,59,2701,24,35,1500.77,2763.93,0.00
2024-12-08 14:54:28,59,2702,24,35,1545.79,2764.00,0.00
2024-12-08 14:54:28,60,2702,24,36,1520.03,2764.02,0.00
2024-12-08 14:54:28,59,2702,24,35,1538.31,2764.10,0.00
2024-12-08 14:54:28,59,2703,24,35,1542.13,2765.00,0.00
2024-12-08 14:54:28,60,2703,25,35,1516.43,2765.02,0.00
2024-12-08 14:54:28,60,2704,25,35,1509.08,2766.00,0.00
2024-12-08 14:54:28,61,2704,26,35,1484.34,2766.02,0.00
2024-12-08 14:54:28,60,2704,26,34,1502.64,2766.10,0.00
2024-12-08 14:54:28,59,2704,25,34,1514.66,2766.34,0.00
2024-12-08 14:54:29,59,2705,25,34,1543.72,2767.00,0.00
2024-12-08 14:54:29,60,2705,25,35,1517.99,2767.02,0.00
2024-12-08 14:54:29,60,2706,25,35,1510.56,2768.00,0.00
2024-12-08 14:54:29,61,2706,26,35,1485.79,2768.02,0.00
2024-12-08 14:54:29,60,2706,26,34,1504.57,2768.10,0.00
2024-12-08 14:54:29,59,2706,25,34,1499.26,2768.93,0.00
2024-12-08 14:54:29,59,2707,25,34,1544.36,2769.00,0.00
2024-12-08 14:54:29,60,2707,26,34,1518.63,2769.02,0.00
2024-12-08 14:54:29,59,2707,25,34,1543.89,2769.02,0.00
2024-12-08 14:54:29,58,2707,24,34,1555.28,2769.21,0.00
2024-12-08 14:54:29,58,2708,24,34,1564.20,2770.00,0.00
2024-12-08 14:54:29,59,2708,24,35,1537.69,2770.02,0.00
2024-12-08 14:54:29,58,2708,24,34,1557.52,2770.09,0.00
2024-12-08 14:54:29,58,2709,24,34,1561.42,2771.00,0.00
2024-12-08 14:54:29,59,2709,24,35,1534.96,2771.02,0.00
2024-12-08 14:54:29,59,2710,24,35,1528.37,2772.00,0.00
2024-12-08 14:54:29,60,2710,24,36,1502.90,2772.02,0.00
2024-12-08 14:54:29,59,2710,23,36,1527.43,2772.03,0.00
2024-12-08 14:54:29,58,2710,23,35,1547.09,2772.09,0.00
2024-12-08 14:54:29,57,2710,22,35,1557.53,2772.70,0.00
2024-12-08 14:54:29,56,2710,21,35,1568.33,2772.96,0.00
2024-12-08 14:54:29,56,2711,21,35,1616.87,2773.00,0.00
2024-12-08 14:54:29,57,2711,22,35,1588.51,2773.02,0.00
2024-12-08 14:54:29,56,2711,21,35,1587.67,2773.11,0.00
2024-12-08 14:54:29,56,2712,21,35,1613.00,2774.00,0.00
2024-12-08 14:54:29,57,2712,21,36,1584.70,2774.02,0.00
2024-12-08 14:54:29,57,2713,21,36,1578.97,2775.00,0.00
2024-12-08 14:54:29,58,2713,22,36,1551.74,2775.02,0.00
2024-12-08 14:54:29,57,2713,22,35,1571.67,2775.09,0.00
2024-12-08 14:54:29,57,2714,22,35,1576.13,2776.00,0.00
2024-12-08 14:54:29,58,2714,22,36,1548.95,2776.02,0.00
2024-12-08 14:54:29,57,2714,21,36,1576.01,2776.02,0.00
2024-12-08 14:54:29,56,2714,21,35,1596.72,2776.07,0.00
2024-12-08 14:54:29,55,2714,20,35,1607.67,2776.36,0.00
2024-12-08 14:54:29,55,2715,20,35,1640.95,2777.00,0.00
2024-12-08 14:54:29,56,2715,21,35,1611.64,2777.02,0.00
2024-12-08 14:54:29,55,2715,20,35,1640.88,2777.02,0.00
2024-12-08 14:54:29,54,2715,19,35,1640.40,2777.35,0.00
2024-12-08 14:54:29,54,2716,19,35,1674.31,2778.00,0.00
2024-12-08 14:54:29,55,2716,20,35,1643.87,2778.02,0.00
2024-12-08 14:54:29,54,2716,20,34,1667.63,2778.06,0.00
2024-12-08 14:54:29,54,2717,20,34,1672.85,2779.00,0.00
2024-12-08 14:54:29,55,2717,20,35,1642.44,2779.02,0.00
2024-12-08 14:54:29,55,2718,20,35,1635.95,2780.00,0.00
2024-12-08 14:54:29,56,2718,20,36,1606.74,2780.02,0.00
2024-12-08 14:54:29,55,2718,20,35,1629.39,2780.05,0.00
2024-12-08 14:54:29,54,2718,19,35,1639.63,2780.39,0.00
2024-12-08 14:54:29,54,2719,19,35,1674.57,2781.00,0.00
2024-12-08 14:54:29,55,2719,19,36,1644.13,2781.02,0.00
2024-12-08 14:54:29,55,2720,19,36,1637.64,2782.00,0.00
2024-12-08 14:54:29,56,2720,20,36,1608.39,2782.02,0.00
2024-12-08 14:54:29,55,2720,20,35,1630.57,2782.07,0.00
2024-12-08 14:54:29,54,2720,19,35,1643.87,2782.35,0.00
2024-12-08 14:54:29,54,2721,19,35,1677.84,2783.00,0.00
2024-12-08 14:54:29,55,2721,20,35,1647.33,2783.02,0.00
2024-12-08 14:54:29,54,2721,19,35,1672.17,2783.02,0.00
2024-12-08 14:54:29,54,2722,19,35,1686.69,2784.00,0.00
2024-12-08 14:54:29,55,2722,19,36,1656.02,2784.02,0.00
2024-12-08 14:54:29,55,2723,19,36,1649.53,2785.00,0.00
2024-12-08 14:54:29,56,2723,20,36,1620.07,2785.02,0.00
2024-12-08 14:54:29,55,2723,20,35,1644.47,2785.05,0.00
2024-12-08 14:54:29,55,2724,20,35,1649.11,2786.00,0.00
2024-12-08 14:54:29,56,2724,20,36,1619.66,2786.02,0.00
2024-12-08 14:54:29,55,2724,20,35,1644.05,2786.05,0.00
2024-12-08 14:54:29,54,2724,19,35,1637.66,2786.65,0.00
2024-12-08 14:54:29,54,2725,19,35,1679.74,2787.00,0.00
2024-12-08 14:54:29,55,2725,19,36,1649.19,2787.02,0.00
2024-12-08 14:54:29,54,2725,18,36,1665.32,2787.17,0.00
2024-12-08 14:54:29,54,2726,18,36,1673.65,2788.00,0.00
2024-12-08 14:54:29,55,2726,19,36,1643.22,2788.02,0.00
2024-12-08 14:54:29,54,2726,19,35,1665.92,2788.07,0.00
2024-12-08 14:54:29,54,2727,19,35,1671.67,2789.00,0.00
2024-12-08 14:54:29,55,2727,19,36,1641.27,2789.02,0.00
2024-12-08 14:54:29,55,2728,19,36,1634.76,2790.00,0.00
2024-12-08 14:54:29,56,2728,19,37,1605.57,2790.02,0.00
2024-12-08 14:54:29,55,2728,19,36,1627.67,2790.07,0.00
2024-12-08 14:54:29,54,2728,18,36,1641.27,2790.63,0.00
2024-12-08 14:54:29,54,2729,18,36,1682.89,2791.00,0.00
2024-12-08 14:54:29,55,2729,18,37,1652.30,2791.02,0.00
2024-12-08 14:54:29,55,2730,18,37,1645.99,2792.00,0.00
2024-12-08 14:54:29,56,2730,18,38,1616.60,2792.02,0.00
2024-12-08 14:54:29,55,2730,18,37,1638.38,2792.07,0.00
2024-12-08 14:54:29,54,2730,17,37,1657.21,2792.26,0.00
2024-12-08 14:54:30,54,2731,17,37,1688.75,2793.00,0.00
2024-12-08 14:54:30,55,2731,18,37,1658.05,2793.02,0.00
2024-12-08 14:54:30,55,2732,18,37,1651.55,2794.00,0.00
2024-12-08 14:54:30,56,2732,18,38,1622.06,2794.02,0.00
2024-12-08 14:54:30,55,2732,18,37,1644.45,2794.07,0.00
2024-12-08 14:54:30,55,2733,18,37,1649.60,2795.00,0.00
2024-12-08 14:54:30,56,2733,19,37,1620.14,2795.02,0.00
2024-12-08 14:54:30,56,2734,19,37,1613.23,2796.00,0.00
2024-12-08 14:54:30,57,2734,19,38,1584.93,2796.02,0.00
2024-12-08 14:54:30,56,2734,19,37,1606.75,2796.07,0.00
2024-12-08 14:54:30,57,2733,19,38,1564.60,2796.61,0.00
2024-12-08 14:54:30,57,2734,19,38,1613.96,2797.00,0.00
2024-12-08 14:54:30,58,2734,19,39,1586.13,2797.02,0.00
2024-12-08 14:54:30,58,2735,19,39,1627.73,2798.00,0.00
2024-12-08 14:54:30,59,2735,19,40,1600.14,2798.02,0.00
2024-12-08 14:54:30,58,2735,19,39,1621.46,2798.07,0.00
2024-12-08 14:54:30,57,2735,18,39,1643.54,2798.18,0.00
2024-12-08 14:54:30,57,2736,18,39,1670.11,2799.00,0.00
2024-12-08 14:54:30,58,2736,19,39,1641.32,2799.02,0.00
2024-12-08 14:54:30,57,2736,18,39,1669.62,2799.02,0.00
2024-12-08 14:54:30,56,2736,17,39,1672.73,2799.63,0.00
2024-12-08 14:54:30,55,2736,16,39,1693.59,2799.80,0.00
2024-12-08 14:54:30,55,2737,16,39,1739.05,2800.00,0.00
2024-12-08 14:54:30,56,2737,16,40,1708.00,2800.02,0.00
2024-12-08 14:54:30,55,2737,16,39,1732.95,2800.05,0.00
2024-12-08 14:54:30,55,2738,16,39,1737.64,2801.00,0.00
2024-12-08 14:54:30,56,2738,17,39,1706.61,2801.02,0.00
2024-12-08 14:54:30,55,2738,16,39,1692.60,2801.60,0.00
2024-12-08 14:54:30,55,2739,16,39,1732.65,2802.00,0.00
2024-12-08 14:54:30,56,2739,16,40,1701.71,2802.02,0.00
2024-12-08 14:54:30,55,2739,16,39,1727.05,2802.05,0.00
2024-12-08 14:54:30,55,2740,16,39,1731.74,2803.00,0.00
2024-12-08 14:54:30,56,2740,16,40,1700.82,2803.02,0.00
2024-12-08 14:54:30,56,2741,16,40,1693.92,2804.00,0.00
2024-12-08 14:54:30,57,2741,16,41,1664.20,2804.02,0.00
2024-12-08 14:54:30,56,2741,16,40,1686.41,2804.05,0.00
2024-12-08 14:54:30,55,2741,15,40,1681.69,2804.62,0.00
2024-12-08 14:54:30,55,2742,15,40,1722.27,2805.00,0.00
2024-12-08 14:54:30,56,2742,15,41,1691.51,2805.02,0.00
2024-12-08 14:54:30,55,2742,14,41,1693.20,2805.07,0.00
2024-12-08 14:54:30,55,2743,14,41,1718.80,2806.00,0.00
2024-12-08 14:54:30,56,2743,14,42,1688.11,2806.02,0.00
2024-12-08 14:54:30,55,2743,14,41,1711.66,2806.05,0.00
2024-12-08 14:54:30,54,2743,13,41,1742.33,2806.09,0.00
2024-12-08 14:54:30,54,2744,13,41,1769.45,2807.00,0.00
2024-12-08 14:54:30,55,2744,13,42,1737.28,2807.02,0.00
2024-12-08 14:54:30,55,2745,13,42,1730.75,2808.00,0.00
2024-12-08 14:54:30,56,2745,14,42,1699.84,2808.02,0.00
2024-12-08 14:54:30,57,2744,15,42,1669.53,2808.07,0.00
2024-12-08 14:54:30,56,2744,15,41,1738.47,2808.07,0.00
2024-12-08 14:54:30,56,2745,15,41,1743.08,2809.00,0.00
2024-12-08 14:54:30,57,2745,16,41,1712.50,2809.02,0.00
2024-12-08 14:54:30,56,2745,15,41,1705.45,2809.82,0.00
2024-12-08 14:54:30,56,2746,15,41,1800.91,2810.00,0.00
2024-12-08 14:54:30,57,2746,15,42,1769.31,2810.02,0.00
2024-12-08 14:54:30,56,2746,15,41,1792.40,2810.05,0.00
2024-12-08 14:54:30,56,2747,15,41,1796.53,2811.00,0.00
2024-12-08 14:54:30,57,2747,16,41,1765.01,2811.02,0.00
2024-12-08 14:54:30,56,2747,15,41,1796.03,2811.02,0.00
2024-12-08 14:54:30,55,2747,14,41,1790.84,2811.82,0.00
2024-12-08 14:54:30,55,2748,14,41,1837.00,2812.00,0.00
2024-12-08 14:54:30,56,2748,15,41,1804.20,2812.02,0.00
2024-12-08 14:54:30,55,2748,15,40,1828.84,2812.04,0.00
2024-12-08 14:54:30,55,2749,15,40,1833.05,2813.00,0.00
2024-12-08 14:54:30,56,2749,15,41,1800.32,2813.02,0.00
2024-12-08 14:54:30,56,2750,15,41,1793.42,2814.00,0.00
2024-12-08 14:54:30,57,2750,15,42,1761.96,2814.02,0.00
2024-12-08 14:54:30,56,2750,15,41,1785.40,2814.04,0.00
2024-12-08 14:54:30,55,2750,14,41,1801.31,2814.64,0.00
2024-12-08 14:54:30,55,2751,14,41,1842.55,2815.00,0.00
2024-12-08 14:54:30,56,2751,14,42,1809.64,2815.02,0.00
2024-12-08 14:54:30,56,2752,14,42,1802.74,2816.00,0.00
2024-12-08 14:54:30,57,2752,14,43,1771.12,2816.02,0.00
2024-12-08 14:54:30,56,2752,14,42,1795.22,2816.04,0.00
2024-12-08 14:54:30,55,2752,13,42,1826.34,2816.09,0.00
2024-12-08 14:54:30,54,2752,12,42,1845.35,2816.63,0.00
2024-12-08 14:54:30,54,2753,12,42,1887.39,2817.00,0.00
2024-12-08 14:54:30,55,2753,12,43,1853.07,2817.02,0.00
2024-12-08 14:54:30,55,2754,12,43,1846.56,2818.00,0.00
2024-12-08 14:54:30,56,2754,12,44,1813.58,2818.02,0.00
2024-12-08 14:54:30,55,2754,12,43,1839.40,2818.04,0.00
2024-12-08 14:54:30,55,2755,12,43,1843.63,2819.00,0.00
2024-12-08 14:54:30,56,2755,12,44,1810.70,2819.02,0.00
2024-12-08 14:54:30,55,2755,11,44,1803.16,2819.87,0.00
2024-12-08 14:54:31,55,2756,11,44,1850.94,2820.00,0.00
2024-12-08 14:54:31,56,2756,12,44,1817.89,2820.02,0.00
2024-12-08 14:54:31,55,2756,12,43,1840.72,2820.07,0.00
2024-12-08 14:54:31,55,2757,12,43,1845.96,2821.00,0.00
2024-12-08 14:54:31,56,2757,12,44,1813.00,2821.02,0.00
2024-12-08 14:54:31,56,2758,12,44,1806.08,2822.00,0.00
2024-12-08 14:54:31,57,2758,12,45,1774.39,2822.02,0.00
2024-12-08 14:54:31,56,2758,12,44,1795.03,2822.09,0.00
2024-12-08 14:54:31,55,2758,11,44,1804.00,2822.80,0.00
2024-12-08 14:54:31,55,2759,11,44,1849.83,2823.00,0.00
2024-12-08 14:54:31,56,2759,11,45,1816.80,2823.02,0.00
2024-12-08 14:54:31,55,2759,10,45,1812.34,2823.82,0.00
2024-12-08 14:54:31,55,2760,10,45,1858.70,2824.00,0.00
2024-12-08 14:54:31,56,2760,11,45,1825.51,2824.02,0.00
2024-12-08 14:54:31,56,2761,11,45,1818.59,2825.00,0.00
2024-12-08 14:54:31,57,2761,12,45,1786.69,2825.02,0.00
2024-12-08 14:54:31,57,2762,12,45,1779.39,2826.00,0.00
2024-12-08 14:54:31,58,2762,12,46,1748.71,2826.02,0.00
2024-12-08 14:54:31,57,2762,12,45,1774.94,2826.04,0.00
2024-12-08 14:54:31,57,2763,12,45,1778.03,2827.00,0.00
2024-12-08 14:54:31,58,2763,12,46,1747.38,2827.02,0.00
2024-12-08 14:54:31,58,2764,12,46,1739.71,2828.00,0.00
2024-12-08 14:54:31,59,2764,12,47,1710.22,2828.02,0.00
2024-12-08 14:54:31,58,2764,12,46,1735.82,2828.03,0.00
2024-12-08 14:54:31,57,2764,11,46,1731.63,2828.97,0.00
2024-12-08 14:54:31,57,2765,11,46,1780.28,2829.00,0.00
2024-12-08 14:54:31,58,2765,12,46,1749.59,2829.02,0.00
2024-12-08 14:54:31,58,2766,12,46,1741.91,2830.00,0.00
2024-12-08 14:54:31,59,2766,12,47,1712.39,2830.02,0.00
2024-12-08 14:54:31,58,2766,12,46,1735.59,2830.05,0.00
2024-12-08 14:54:31,58,2767,12,46,1738.62,2831.00,0.00
2024-12-08 14:54:31,59,2767,12,47,1709.16,2831.02,0.00
2024-12-08 14:54:31,58,2767,12,46,1724.52,2831.16,0.00
2024-12-08 14:54:31,58,2768,12,46,1730.45,2832.00,0.00
2024-12-08 14:54:31,59,2768,12,47,1701.12,2832.02,0.00
2024-12-08 14:54:31,58,2768,12,46,1724.61,2832.05,0.00
2024-12-08 14:54:31,57,2768,11,46,1720.66,2832.97,0.00
2024-12-08 14:54:31,57,2769,11,46,1769.38,2833.00,0.00
2024-12-08 14:54:31,58,2769,11,47,1738.88,2833.02,0.00
2024-12-08 14:54:31,57,2769,10,47,1729.15,2833.90,0.00
2024-12-08 14:54:31,57,2770,10,47,1775.97,2834.00,0.00
2024-12-08 14:54:31,58,2770,11,47,1745.35,2834.02,0.00
2024-12-08 14:54:31,57,2770,11,46,1770.52,2834.05,0.00
2024-12-08 14:54:31,57,2771,11,46,1774.11,2835.00,0.00
2024-12-08 14:54:31,58,2771,12,46,1743.52,2835.02,0.00
2024-12-08 14:54:31,58,2772,12,46,1735.83,2836.00,0.00
2024-12-08 14:54:31,59,2772,13,46,1706.41,2836.02,0.00
2024-12-08 14:54:31,58,2772,13,45,1730.46,2836.05,0.00
2024-12-08 14:54:31,58,2773,13,45,1733.50,2837.00,0.00
2024-12-08 14:54:31,59,2773,14,45,1704.12,2837.02,0.00
2024-12-08 14:54:31,59,2774,14,45,1696.06,2838.00,0.00
2024-12-08 14:54:31,60,2774,15,45,1667.80,2838.02,0.00
2024-12-08 14:54:31,59,2774,15,44,1689.83,2838.07,0.00
2024-12-08 14:54:31,59,2775,15,44,1692.81,2839.00,0.00
2024-12-08 14:54:31,60,2775,15,45,1664.60,2839.02,0.00
2024-12-08 14:54:31,59,2775,14,45,1649.09,2839.95,0.00
2024-12-08 14:54:31,59,2776,14,45,1695.82,2840.00,0.00
2024-12-08 14:54:31,60,2776,15,45,1667.55,2840.02,0.00
2024-12-08 14:54:31,59,2776,15,44,1689.10,2840.07,0.00
2024-12-08 14:54:31,59,2777,15,44,1692.08,2841.00,0.00
2024-12-08 14:54:31,60,2777,16,44,1663.88,2841.02,0.00
2024-12-08 14:54:31,60,2778,16,44,1655.46,2842.00,0.00
2024-12-08 14:54:31,61,2778,16,45,1628.33,2842.02,0.00
2024-12-08 14:54:31,60,2778,16,44,1648.85,2842.07,0.00
2024-12-08 14:54:31,59,2778,15,44,1645.03,2842.93,0.00
2024-12-08 14:54:31,59,2779,15,44,1691.34,2843.00,0.00
2024-12-08 14:54:31,60,2779,15,45,1663.15,2843.02,0.00
2024-12-08 14:54:31,60,2780,15,45,1654.73,2844.00,0.00
2024-12-08 14:54:31,61,2780,15,46,1627.61,2844.02,0.00
2024-12-08 14:54:31,60,2780,15,45,1647.65,2844.08,0.00
2024-12-08 14:54:31,59,2780,14,45,1673.19,2844.17,0.00
2024-12-08 14:54:31,59,2781,14,45,1679.03,2845.00,0.00
2024-12-08 14:54:31,60,2781,15,45,1651.05,2845.02,0.00
2024-12-08 14:54:31,59,2781,14,45,1640.93,2845.87,0.00
2024-12-08 14:54:31,59,2782,14,45,1685.41,2846.00,0.00
2024-12-08 14:54:31,60,2782,14,46,1657.32,2846.02,0.00
2024-12-08 14:54:31,59,2782,14,45,1677.72,2846.10,0.00
2024-12-08 14:54:31,59,2783,14,45,1681.66,2847.00,0.00
2024-12-08 14:54:31,60,2783,15,45,1653.63,2847.02,0.00
2024-12-08 14:54:31,59,2783,14,45,1637.58,2847.66,0.00
2024-12-08 14:54:32,59,2784,14,45,1676.46,2848.00,0.00
2024-12-08 14:54:32,60,2784,14,46,1648.52,2848.02,0.00
2024-12-08 14:54:32,59,2784,14,45,1668.28,2848.10,0.00
2024-12-08 14:54:32,59,2785,14,45,1672.22,2849.00,0.00
2024-12-08 14:54:32,60,2785,15,45,1644.35,2849.02,0.00
2024-12-08 14:54:32,60,2786,15,45,1635.90,2850.00,0.00
2024-12-08 14:54:32,61,2786,16,45,1609.08,2850.02,0.00
2024-12-08 14:54:32,60,2786,16,44,1628.33,2850.10,0.00
2024-12-08 14:54:32,59,2786,15,44,1623.12,2850.97,0.00
2024-12-08 14:54:32,59,2787,15,44,1670.49,2851.00,0.00
2024-12-08 14:54:32,60,2787,16,44,1642.65,2851.02,0.00
2024-12-08 14:54:32,60,2788,16,44,1634.20,2852.00,0.00
2024-12-08 14:54:32,61,2788,17,44,1607.41,2852.02,0.00
2024-12-08 14:54:32,60,2788,17,43,1627.09,2852.10,0.00
2024-12-08 14:54:32,60,2789,17,43,1630.49,2853.00,0.00
2024-12-08 14:54:32,61,2789,17,44,1603.76,2853.02,0.00
2024-12-08 14:54:32,61,2790,17,44,1595.05,2854.00,0.00
2024-12-08 14:54:32,62,2790,17,45,1569.32,2854.02,0.00
2024-12-08 14:54:32,61,2790,17,44,1587.58,2854.10,0.00
2024-12-08 14:54:32,62,2789,18,44,1552.90,2854.45,0.00
2024-12-08 14:54:32,61,2789,17,44,1577.71,2854.95,0.00
2024-12-08 14:54:32,61,2790,17,44,1623.14,2855.00,0.00
2024-12-08 14:54:32,62,2790,17,45,1596.96,2855.02,0.00
2024-12-08 14:54:32,62,2791,17,45,1634.86,2856.00,0.00
2024-12-08 14:54:32,63,2791,18,45,1608.91,2856.02,0.00
2024-12-08 14:54:32,62,2791,18,44,1627.05,2856.11,0.00
2024-12-08 14:54:32,62,2792,18,44,1629.90,2857.00,0.00
2024-12-08 14:54:32,63,2792,18,45,1604.03,2857.02,0.00
2024-12-08 14:54:32,62,2792,17,45,1628.99,2857.03,0.00
2024-12-08 14:54:32,62,2793,17,45,1620.89,2858.00,0.00
2024-12-08 14:54:32,63,2793,17,46,1595.16,2858.02,0.00
2024-12-08 14:54:32,62,2793,17,45,1614.00,2858.10,0.00
2024-12-08 14:54:32,61,2793,16,45,1605.06,2858.69,0.00
2024-12-08 14:54:32,61,2794,16,45,1643.25,2859.00,0.00
2024-12-08 14:54:32,62,2794,16,46,1616.75,2859.02,0.00
2024-12-08 14:54:32,61,2794,15,46,1613.14,2859.72,0.00
2024-12-08 14:54:32,61,2795,15,46,1652.27,2860.00,0.00
2024-12-08 14:54:32,62,2795,16,46,1625.62,2860.02,0.00
2024-12-08 14:54:32,61,2795,16,45,1645.25,2860.10,0.00
2024-12-08 14:54:32,61,2796,16,45,1648.15,2861.00,0.00
2024-12-08 14:54:32,62,2796,16,46,1621.57,2861.02,0.00
2024-12-08 14:54:32,62,2797,16,46,1612.62,2862.00,0.00
2024-12-08 14:54:32,63,2797,16,47,1587.03,2862.02,0.00
2024-12-08 14:54:32,62,2797,16,46,1606.18,2862.10,0.00
2024-12-08 14:54:32,62,2798,16,46,1608.57,2863.00,0.00
2024-12-08 14:54:32,63,2798,17,46,1583.04,2863.02,0.00
2024-12-08 14:54:32,62,2798,16,46,1577.53,2863.74,0.00
2024-12-08 14:54:32,62,2799,16,46,1616.52,2864.00,0.00
2024-12-08 14:54:32,63,2799,17,46,1590.86,2864.02,0.00
2024-12-08 14:54:32,62,2799,17,45,1610.53,2864.10,0.00
2024-12-08 14:54:32,62,2800,17,45,1612.93,2865.00,0.00
2024-12-08 14:54:32,63,2800,17,46,1587.33,2865.02,0.00
2024-12-08 14:54:32,63,2801,17,46,1577.87,2866.00,0.00
2024-12-08 14:54:32,64,2801,18,46,1553.22,2866.02,0.00
2024-12-08 14:54:32,63,2801,17,46,1576.97,2866.03,0.00
2024-12-08 14:54:32,62,2801,17,45,1597.79,2866.08,0.00
2024-12-08 14:54:32,61,2801,16,45,1591.37,2866.64,0.00
2024-12-08 14:54:32,61,2802,16,45,1628.29,2867.00,0.00
2024-12-08 14:54:32,62,2802,17,45,1602.03,2867.02,0.00
2024-12-08 14:54:32,62,2803,17,45,1592.88,2868.00,0.00
2024-12-08 14:54:32,63,2803,17,46,1567.59,2868.02,0.00
2024-12-08 14:54:32,62,2803,17,45,1587.80,2868.08,0.00
2024-12-08 14:54:32,61,2803,16,45,1608.25,2868.26,0.00
2024-12-08 14:54:32,60,2803,15,45,1611.33,2868.58,0.00
2024-12-08 14:54:32,60,2804,15,45,1647.50,2869.00,0.00
2024-12-08 14:54:32,61,2804,16,45,1620.49,2869.02,0.00
2024-12-08 14:54:32,61,2805,16,45,1611.65,2870.00,0.00
2024-12-08 14:54:32,62,2805,16,46,1585.65,2870.02,0.00
2024-12-08 14:54:32,61,2805,16,45,1606.49,2870.08,0.00
2024-12-08 14:54:32,61,2806,16,45,1608.92,2871.00,0.00
2024-12-08 14:54:32,62,2806,16,46,1582.96,2871.02,0.00
2024-12-08 14:54:32,62,2807,16,46,1573.79,2872.00,0.00
2024-12-08 14:54:32,63,2807,17,46,1548.81,2872.02,0.00
2024-12-08 14:54:32,62,2807,17,45,1568.71,2872.10,0.00
2024-12-08 14:54:32,62,2808,17,45,1571.09,2873.00,0.00
2024-12-08 14:54:32,63,2808,18,45,1546.16,2873.02,0.00
2024-12-08 14:54:32,63,2809,18,45,1536.74,2874.00,0.00
2024-12-08 14:54:32,64,2809,19,45,1512.73,2874.02,0.00
2024-12-08 14:54:32,63,2809,19,44,1532.19,2874.10,0.00
2024-12-08 14:54:32,63,2810,19,44,1534.08,2875.00,0.00
2024-12-08 14:54:32,64,2810,19,45,1510.11,2875.02,0.00
2024-12-08 14:54:32,63,2810,18,45,1532.72,2875.05,0.00
2024-12-08 14:54:33,62,2810,17,45,1531.71,2875.63,0.00
2024-12-08 14:54:33,61,2810,16,45,1547.53,2875.82,0.00
2024-12-08 14:54:33,61,2811,16,45,1589.62,2876.00,0.00
2024-12-08 14:54:33,62,2811,16,46,1563.98,2876.02,0.00
2024-12-08 14:54:33,61,2811,16,45,1585.39,2876.08,0.00
2024-12-08 14:54:33,60,2811,15,45,1586.80,2876.82,0.00
2024-12-08 14:54:33,60,2812,15,45,1629.62,2877.00,0.00
2024-12-08 14:54:33,61,2812,16,45,1602.90,2877.02,0.00
2024-12-08 14:54:33,60,2812,15,45,1587.58,2877.60,0.00
2024-12-08 14:54:33,60,2813,15,45,1624.34,2878.00,0.00
2024-12-08 14:54:33,61,2813,15,46,1597.71,2878.02,0.00
2024-12-08 14:54:33,60,2813,15,45,1620.03,2878.08,0.00
2024-12-08 14:54:33,60,2814,15,45,1622.98,2879.00,0.00
2024-12-08 14:54:33,61,2814,16,45,1596.38,2879.02,0.00
2024-12-08 14:54:33,61,2815,16,45,1587.49,2880.00,0.00
2024-12-08 14:54:33,62,2815,17,45,1561.89,2880.02,0.00
2024-12-08 14:54:33,61,2815,17,44,1583.72,2880.08,0.00
2024-12-08 14:54:33,61,2816,17,44,1586.15,2881.00,0.00
2024-12-08 14:54:33,62,2816,18,44,1560.57,2881.02,0.00
2024-12-08 14:54:33,61,2816,17,44,1557.00,2881.71,0.00
2024-12-08 14:54:33,61,2817,17,44,1577.07,2882.00,0.00
2024-12-08 14:54:33,62,2817,17,45,1551.63,2882.02,0.00
2024-12-08 14:54:33,61,2817,17,44,1573.77,2882.08,0.00
2024-12-08 14:54:33,61,2818,17,44,1576.20,2883.00,0.00
2024-12-08 14:54:33,62,2818,18,44,1550.77,2883.02,0.00
2024-12-08 14:54:33,62,2819,18,44,1541.54,2884.00,0.00
2024-12-08 14:54:33,63,2819,19,44,1517.07,2884.02,0.00
2024-12-08 14:54:33,62,2819,19,43,1538.76,2884.08,0.00
2024-12-08 14:54:33,62,2820,19,43,1540.68,2885.00,0.00
2024-12-08 14:54:33,63,2820,20,43,1516.23,2885.02,0.00
2024-12-08 14:54:33,62,2820,19,43,1539.29,2885.05,0.00
2024-12-08 14:54:33,62,2821,19,43,1530.98,2886.00,0.00
2024-12-08 14:54:33,63,2821,19,44,1506.67,2886.02,0.00
2024-12-08 14:54:33,62,2821,19,43,1529.12,2886.06,0.00
2024-12-08 14:54:33,61,2821,18,43,1520.15,2886.97,0.00
2024-12-08 14:54:33,61,2822,18,43,1566.55,2887.00,0.00
2024-12-08 14:54:33,62,2822,19,43,1541.29,2887.02,0.00
2024-12-08 14:54:33,61,2822,19,42,1555.20,2887.07,0.00
2024-12-08 14:54:33,61,2823,19,42,1557.15,2888.00,0.00
2024-12-08 14:54:33,62,2823,20,42,1532.04,2888.02,0.00
2024-12-08 14:54:33,62,2824,20,42,1522.78,2889.00,0.00
2024-12-08 14:54:33,63,2824,20,43,1498.61,2889.02,0.00
2024-12-08 14:54:33,62,2824,20,42,1520.00,2889.08,0.00
2024-12-08 14:54:33,62,2825,20,42,1521.91,2890.00,0.00
2024-12-08 14:54:33,63,2825,20,43,1497.75,2890.02,0.00
2024-12-08 14:54:33,62,2825,19,43,1474.67,2890.69,0.00
2024-12-08 14:54:33,62,2826,19,43,1512.65,2891.00,0.00
2024-12-08 14:54:33,63,2826,20,43,1488.64,2891.02,0.00
2024-12-08 14:54:33,62,2826,20,42,1509.40,2891.08,0.00
2024-12-08 14:54:33,61,2826,19,42,1500.28,2891.66,0.00
2024-12-08 14:54:33,61,2827,19,42,1537.97,2892.00,0.00
2024-12-08 14:54:33,62,2827,20,42,1513.17,2892.02,0.00
2024-12-08 14:54:33,62,2828,20,42,1503.89,2893.00,0.00
2024-12-08 14:54:33,63,2828,21,42,1480.02,2893.02,0.00
2024-12-08 14:54:33,62,2828,21,41,1501.11,2893.08,0.00
2024-12-08 14:54:33,62,2829,21,41,1503.01,2894.00,0.00
2024-12-08 14:54:33,63,2829,22,41,1479.16,2894.02,0.00
2024-12-08 14:54:33,63,2830,22,41,1469.56,2895.00,0.00
2024-12-08 14:54:33,64,2830,23,41,1446.59,2895.02,0.00
2024-12-08 14:54:33,63,2830,23,40,1467.27,2895.08,0.00
2024-12-08 14:54:33,63,2831,23,40,1468.69,2896.00,0.00
2024-12-08 14:54:33,64,2831,24,40,1445.74,2896.02,0.00
2024-12-08 14:54:33,63,2831,23,40,1467.77,2896.03,0.00
2024-12-08 14:54:33,62,2831,23,39,1490.97,2896.03,0.00
2024-12-08 14:54:33,61,2831,23,38,1504.98,2896.05,0.00
2024-12-08 14:54:33,61,2832,23,38,1506.44,2897.00,0.00
2024-12-08 14:54:33,62,2832,24,38,1482.14,2897.02,0.00
2024-12-08 14:54:33,61,2832,24,37,1495.53,2897.05,0.00
2024-12-08 14:54:33,61,2833,24,37,1496.98,2898.00,0.00
2024-12-08 14:54:33,62,2833,24,38,1472.84,2898.02,0.00
2024-12-08 14:54:33,61,2833,24,37,1486.07,2898.05,0.00
2024-12-08 14:54:33,60,2833,23,37,1492.77,2898.68,0.00
2024-12-08 14:54:33,60,2834,23,37,1512.79,2899.00,0.00
2024-12-08 14:54:33,61,2834,23,38,1487.99,2899.02,0.00
2024-12-08 14:54:33,60,2834,23,37,1501.69,2899.05,0.00
2024-12-08 14:54:33,60,2835,23,37,1503.65,2900.00,0.00
2024-12-08 14:54:33,61,2835,23,38,1479.00,2900.02,0.00
2024-12-08 14:54:33,61,2836,23,38,1470.00,2901.00,0.00
2024-12-08 14:54:33,62,2836,24,38,1446.29,2901.02,0.00
2024-12-08 14:54:33,61,2836,24,37,1468.58,2901.05,0.00
2024-12-08 14:54:33,60,2836,23,37,1467.80,2901.80,0.00
2024-12-08 14:54:33,60,2837,23,37,1510.49,2902.00,0.00
2024-12-08 14:54:33,61,2837,23,38,1485.73,2902.02,0.00
2024-12-08 14:54:33,60,2837,23,37,1499.38,2902.05,0.00
2024-12-08 14:54:33,59,2837,22,37,1506.39,2902.70,0.00
2024-12-08 14:54:33,59,2838,22,37,1527.27,2903.00,0.00
2024-12-08 14:54:33,60,2838,22,38,1501.82,2903.02,0.00
2024-12-08 14:54:33,59,2838,22,37,1515.97,2903.05,0.00
2024-12-08 14:54:34,59,2839,22,37,1518.45,2904.00,0.00
2024-12-08 14:54:34,60,2839,22,38,1493.14,2904.02,0.00
2024-12-08 14:54:34,60,2840,22,38,1484.45,2905.00,0.00
2024-12-08 14:54:34,61,2840,22,39,1460.12,2905.02,0.00
2024-12-08 14:54:34,60,2840,22,38,1482.53,2905.05,0.00
2024-12-08 14:54:34,60,2841,22,38,1484.48,2906.00,0.00
2024-12-08 14:54:34,61,2841,23,38,1460.15,2906.02,0.00
2024-12-08 14:54:34,61,2842,23,38,1451.12,2907.00,0.00
2024-12-08 14:54:34,62,2842,23,39,1427.71,2907.02,0.00
2024-12-08 14:54:34,61,2842,23,38,1449.70,2907.05,0.00
2024-12-08 14:54:34,61,2843,23,38,1451.14,2908.00,0.00
2024-12-08 14:54:34,62,2843,23,39,1427.73,2908.02,0.00
2024-12-08 14:54:34,61,2843,22,39,1450.66,2908.02,0.00
2024-12-08 14:54:34,60,2843,22,38,1464.19,2908.03,0.00
2024-12-08 14:54:34,59,2843,21,38,1464.18,2908.78,0.00
2024-12-08 14:54:34,59,2844,21,38,1507.26,2909.00,0.00
2024-12-08 14:54:34,60,2844,21,39,1482.13,2909.02,0.00
2024-12-08 14:54:34,59,2844,20,39,1473.55,2909.76,0.00
2024-12-08 14:54:34,59,2845,20,39,1516.16,2910.00,0.00
2024-12-08 14:54:34,60,2845,20,40,1490.89,2910.02,0.00
2024-12-08 14:54:34,59,2845,20,39,1515.18,2910.03,0.00
2024-12-08 14:54:34,58,2845,19,39,1520.54,2910.72,0.00
2024-12-08 14:54:34,58,2846,19,39,1562.91,2911.00,0.00
2024-12-08 14:54:34,59,2846,19,40,1536.42,2911.02,0.00
2024-12-08 14:54:34,58,2846,19,39,1551.87,2911.03,0.00
2024-12-08 14:54:34,57,2846,18,39,1558.46,2911.72,0.00
2024-12-08 14:54:34,57,2847,18,39,1601.60,2912.00,0.00
2024-12-08 14:54:34,58,2847,19,39,1573.99,2912.02,0.00
2024-12-08 14:54:34,57,2847,19,38,1590.37,2912.04,0.00
2024-12-08 14:54:34,56,2847,18,38,1615.16,2912.16,0.00
2024-12-08 14:54:34,56,2848,18,38,1622.44,2913.00,0.00
2024-12-08 14:54:34,57,2848,18,39,1593.97,2913.02,0.00
2024-12-08 14:54:34,56,2848,18,38,1611.00,2913.04,0.00
2024-12-08 14:54:34,55,2848,17,38,1611.89,2913.53,0.00
2024-12-08 14:54:34,55,2849,17,38,1651.44,2914.00,0.00
2024-12-08 14:54:34,56,2849,18,38,1621.95,2914.02,0.00
2024-12-08 14:54:34,56,2850,18,38,1614.70,2915.00,0.00
2024-12-08 14:54:34,57,2850,18,39,1586.37,2915.02,0.00
2024-12-08 14:54:34,56,2850,18,38,1611.58,2915.04,0.00
2024-12-08 14:54:34,55,2850,17,38,1622.60,2915.66,0.00
2024-12-08 14:54:34,55,2851,17,38,1644.62,2916.00,0.00
2024-12-08 14:54:34,56,2851,17,39,1615.26,2916.02,0.00
2024-12-08 14:54:34,55,2851,16,39,1628.24,2916.20,0.00
2024-12-08 14:54:34,55,2852,16,39,1637.23,2917.00,0.00
2024-12-08 14:54:34,56,2852,16,40,1608.00,2917.02,0.00
2024-12-08 14:54:34,55,2852,16,39,1633.53,2917.04,0.00
2024-12-08 14:54:34,54,2852,15,39,1627.58,2917.96,0.00
2024-12-08 14:54:34,54,2853,15,39,1680.55,2918.00,0.00
2024-12-08 14:54:34,55,2853,16,39,1650.00,2918.02,0.00
2024-12-08 14:54:34,55,2854,16,39,1643.13,2919.00,0.00
2024-12-08 14:54:34,56,2854,16,40,1613.79,2919.02,0.00
2024-12-08 14:54:34,55,2854,16,39,1639.95,2919.04,0.00
2024-12-08 14:54:34,55,2855,16,39,1644.23,2920.00,0.00
2024-12-08 14:54:34,56,2855,16,40,1614.86,2920.02,0.00
2024-12-08 14:54:34,56,2856,16,40,1607.59,2921.00,0.00
2024-12-08 14:54:34,57,2856,17,40,1579.39,2921.02,0.00
2024-12-08 14:54:34,56,2856,17,39,1604.99,2921.04,0.00
2024-12-08 14:54:34,55,2856,16,39,1598.05,2921.96,0.00
2024-12-08 14:54:34,55,2857,16,39,1650.13,2922.00,0.00
2024-12-08 14:54:34,56,2857,16,40,1620.67,2922.02,0.00
2024-12-08 14:54:34,56,2858,16,40,1613.39,2923.00,0.00
2024-12-08 14:54:34,57,2858,17,40,1585.09,2923.02,0.00
2024-12-08 14:54:34,56,2858,17,39,1610.79,2923.04,0.00
2024-12-08 14:54:34,56,2859,17,39,1614.47,2924.00,0.00
2024-12-08 14:54:34,57,2859,17,40,1586.14,2924.02,0.00
2024-12-08 14:54:34,57,2860,17,40,1578.47,2925.00,0.00
2024-12-08 14:54:34,58,2860,18,40,1551.26,2925.02,0.00
2024-12-08 14:54:34,57,2860,18,39,1575.91,2925.04,0.00
2024-12-08 14:54:34,56,2860,17,39,1571.86,2925.55,0.00
2024-12-08 14:54:34,56,2861,17,39,1611.39,2926.00,0.00
2024-12-08 14:54:34,57,2861,17,40,1583.12,2926.02,0.00
2024-12-08 14:54:34,56,2861,16,40,1587.45,2926.32,0.00
2024-12-08 14:54:34,56,2862,16,40,1620.30,2927.00,0.00
2024-12-08 14:54:34,57,2862,16,41,1591.88,2927.02,0.00
2024-12-08 14:54:34,56,2862,16,40,1616.13,2927.04,0.00
2024-12-08 14:54:34,56,2863,16,40,1619.81,2928.00,0.00
2024-12-08 14:54:34,57,2863,17,40,1591.39,2928.02,0.00
2024-12-08 14:54:34,56,2863,16,40,1598.45,2928.29,0.00
2024-12-08 14:54:34,56,2864,16,40,1630.30,2929.00,0.00
2024-12-08 14:54:34,57,2864,17,40,1601.70,2929.02,0.00
2024-12-08 14:54:34,56,2864,17,39,1626.65,2929.04,0.00
2024-12-08 14:54:34,56,2865,17,39,1630.34,2930.00,0.00
2024-12-08 14:54:34,57,2865,17,40,1601.73,2930.02,0.00
2024-12-08 14:54:34,56,2865,16,40,1605.32,2930.32,0.00
2024-12-08 14:54:35,56,2866,16,40,1638.22,2931.00,0.00
2024-12-08 14:54:35,57,2866,16,41,1609.48,2931.02,0.00
2024-12-08 14:54:35,56,2866,16,40,1634.56,2931.05,0.00
2024-12-08 14:54:35,55,2866,15,40,1647.86,2931.35,0.00
2024-12-08 14:54:35,55,2867,15,40,1682.43,2932.00,0.00
2024-12-08 14:54:35,56,2867,15,41,1652.39,2932.02,0.00
2024-12-08 14:54:35,55,2867,14,41,1664.90,2932.24,0.00
2024-12-08 14:54:35,56,2866,15,41,1625.92,2932.59,0.00
2024-12-08 14:54:35,56,2867,15,41,1679.67,2933.00,0.00
2024-12-08 14:54:35,57,2867,16,41,1650.20,2933.02,0.00
2024-12-08 14:54:35,56,2867,16,40,1676.01,2933.05,0.00
2024-12-08 14:54:35,56,2868,16,40,1732.63,2934.00,0.00
2024-12-08 14:54:35,57,2868,16,41,1702.23,2934.02,0.00
2024-12-08 14:54:35,57,2869,16,41,1694.58,2935.00,0.00
2024-12-08 14:54:35,58,2869,16,42,1665.36,2935.02,0.00
2024-12-08 14:54:35,57,2869,16,41,1691.49,2935.05,0.00
2024-12-08 14:54:35,57,2870,16,41,1695.15,2936.00,0.00
2024-12-08 14:54:35,58,2870,16,42,1665.93,2936.02,0.00
2024-12-08 14:54:35,58,2871,16,42,1657.89,2937.00,0.00
2024-12-08 14:54:35,59,2871,16,43,1629.79,2937.02,0.00
2024-12-08 14:54:35,58,2871,16,42,1655.36,2937.05,0.00
2024-12-08 14:54:35,58,2872,16,42,1658.45,2938.00,0.00
2024-12-08 14:54:35,59,2872,17,42,1630.34,2938.02,0.00
2024-12-08 14:54:35,58,2872,16,42,1626.38,2938.71,0.00
2024-12-08 14:54:35,58,2873,16,42,1668.64,2939.00,0.00
2024-12-08 14:54:35,59,2873,17,42,1640.36,2939.02,0.00
2024-12-08 14:54:35,58,2873,17,41,1666.11,2939.05,0.00
2024-12-08 14:54:35,58,2874,17,41,1669.21,2940.00,0.00
2024-12-08 14:54:35,59,2874,18,41,1640.92,2940.02,0.00
2024-12-08 14:54:35,58,2874,17,41,1635.10,2940.74,0.00
2024-12-08 14:54:35,58,2875,17,41,1678.40,2941.00,0.00
2024-12-08 14:54:35,59,2875,18,41,1649.95,2941.02,0.00
2024-12-08 14:54:35,58,2875,18,40,1676.37,2941.05,0.00
2024-12-08 14:54:35,58,2876,18,40,1679.48,2942.00,0.00
2024-12-08 14:54:35,59,2876,18,41,1651.01,2942.02,0.00
2024-12-08 14:54:35,58,2876,17,41,1655.13,2942.07,0.00
2024-12-08 14:54:35,58,2877,17,41,1679.03,2943.00,0.00
2024-12-08 14:54:35,59,2877,17,42,1650.57,2943.02,0.00
2024-12-08 14:54:35,58,2877,17,41,1676.50,2943.05,0.00
2024-12-08 14:54:35,57,2877,16,41,1676.70,2943.53,0.00
2024-12-08 14:54:35,56,2877,15,41,1702.53,2943.66,0.00
2024-12-08 14:54:35,56,2878,15,41,1745.37,2944.00,0.00
2024-12-08 14:54:35,57,2878,16,41,1714.75,2944.02,0.00
2024-12-08 14:54:35,56,2878,15,41,1729.64,2944.18,0.00
2024-12-08 14:54:35,56,2879,15,41,1737.55,2945.00,0.00
2024-12-08 14:54:35,57,2879,15,42,1707.07,2945.02,0.00
2024-12-08 14:54:35,56,2879,15,41,1734.40,2945.05,0.00
2024-12-08 14:54:35,56,2880,15,41,1738.67,2946.00,0.00
2024-12-08 14:54:35,57,2880,16,41,1708.16,2946.02,0.00
2024-12-08 14:54:35,56,2880,15,41,1716.10,2946.23,0.00
2024-12-08 14:54:35,56,2881,15,41,1746.62,2947.00,0.00
2024-12-08 14:54:35,57,2881,15,42,1715.98,2947.02,0.00
2024-12-08 14:54:35,56,2881,15,41,1743.47,2947.05,0.00
2024-12-08 14:54:35,56,2882,15,41,1747.74,2948.00,0.00
2024-12-08 14:54:35,57,2882,15,42,1717.08,2948.02,0.00
2024-12-08 14:54:35,56,2882,14,42,1733.03,2948.16,0.00
2024-12-08 14:54:35,56,2883,14,42,1740.44,2949.00,0.00
2024-12-08 14:54:35,57,2883,14,43,1709.90,2949.02,0.00
2024-12-08 14:54:35,56,2883,14,42,1737.80,2949.05,0.00
2024-12-08 14:54:35,55,2883,13,42,1733.51,2949.96,0.00
2024-12-08 14:54:35,55,2884,13,42,1786.09,2950.00,0.00
2024-12-08 14:54:35,56,2884,14,42,1754.20,2950.02,0.00
2024-12-08 14:54:35,56,2885,14,42,1746.89,2951.00,0.00
2024-12-08 14:54:35,57,2885,15,42,1716.24,2951.02,0.00
2024-12-08 14:54:35,56,2885,15,41,1743.20,2951.05,0.00
2024-12-08 14:54:35,56,2886,15,41,1747.48,2952.00,0.00
2024-12-08 14:54:35,57,2886,15,42,1716.82,2952.02,0.00
2024-12-08 14:54:35,57,2887,15,42,1709.11,2953.00,0.00
2024-12-08 14:54:35,58,2887,16,42,1679.65,2953.02,0.00
2024-12-08 14:54:35,57,2887,16,41,1706.01,2953.05,0.00
2024-12-08 14:54:35,56,2887,15,41,1717.83,2953.68,0.00
2024-12-08 14:54:35,56,2888,15,41,1740.22,2954.00,0.00
2024-12-08 14:54:35,57,2888,15,42,1709.69,2954.02,0.00
2024-12-08 14:54:35,56,2888,14,42,1739.69,2954.02,0.00
2024-12-08 14:54:35,55,2888,13,42,1770.79,2954.02,0.00
2024-12-08 14:54:35,54,2888,12,42,1783.94,2954.17,0.00
2024-12-08 14:54:35,54,2889,12,42,1814.59,2955.00,0.00
2024-12-08 14:54:35,55,2889,12,43,1781.60,2955.02,0.00
2024-12-08 14:54:35,54,2889,12,42,1812.40,2955.02,0.00
2024-12-08 14:54:35,54,2890,12,42,1816.84,2956.00,0.00
2024-12-08 14:54:35,55,2890,13,42,1783.81,2956.02,0.00
2024-12-08 14:54:35,54,2890,12,42,1773.30,2956.52,0.00
2024-12-08 14:54:35,54,2891,12,42,1814.17,2957.00,0.00
2024-12-08 14:54:35,55,2891,12,43,1781.19,2957.02,0.00
2024-12-08 14:54:35,54,2891,12,42,1810.89,2957.02,0.00
2024-12-08 14:54:35,54,2892,12,42,1815.33,2958.00,0.00
2024-12-08 14:54:35,55,2892,12,43,1782.33,2958.02,0.00
2024-12-08 14:54:36,55,2893,12,43,1775.40,2959.00,0.00
2024-12-08 14:54:36,56,2893,13,43,1743.70,2959.02,0.00
2024-12-08 14:54:36,55,2893,13,42,1771.10,2959.02,0.00
2024-12-08 14:54:36,54,2893,12,42,1783.45,2959.69,0.00
2024-12-08 14:54:36,54,2894,12,42,1829.17,2960.00,0.00
2024-12-08 14:54:36,55,2894,12,43,1795.91,2960.02,0.00
2024-12-08 14:54:36,54,2894,11,43,1788.54,2960.83,0.00
2024-12-08 14:54:36,54,2895,11,43,1838.56,2961.00,0.00
2024-12-08 14:54:36,55,2895,11,44,1805.13,2961.02,0.00
2024-12-08 14:54:36,54,2895,11,43,1833.63,2961.02,0.00
2024-12-08 14:54:36,54,2896,11,43,1838.09,2962.00,0.00
2024-12-08 14:54:36,55,2896,12,43,1804.67,2962.02,0.00
2024-12-08 14:54:36,55,2897,12,43,1797.73,2963.00,0.00
2024-12-08 14:54:36,56,2897,13,43,1765.63,2963.02,0.00
2024-12-08 14:54:36,55,2897,13,42,1793.42,2963.02,0.00
2024-12-08 14:54:36,54,2897,12,42,1788.55,2963.63,0.00
2024-12-08 14:54:36,54,2898,12,42,1832.74,2964.00,0.00
2024-12-08 14:54:36,55,2898,13,42,1799.42,2964.02,0.00
2024-12-08 14:54:36,55,2899,13,42,1792.48,2965.00,0.00
2024-12-08 14:54:36,56,2899,13,43,1760.47,2965.02,0.00
2024-12-08 14:54:36,55,2899,13,42,1784.93,2965.02,0.00
2024-12-08 14:54:36,54,2899,12,42,1799.12,2965.67,0.00
2024-12-08 14:54:36,54,2900,12,42,1822.44,2966.00,0.00
2024-12-08 14:54:36,55,2900,12,43,1789.31,2966.02,0.00
2024-12-08 14:54:36,55,2901,12,43,1782.36,2967.00,0.00
2024-12-08 14:54:36,56,2901,13,43,1750.53,2967.02,0.00
2024-12-08 14:54:36,55,2901,13,42,1775.34,2967.02,0.00
2024-12-08 14:54:36,54,2901,12,42,1779.55,2967.82,0.00
2024-12-08 14:54:36,54,2902,12,42,1829.17,2968.00,0.00
2024-12-08 14:54:36,55,2902,13,42,1795.91,2968.02,0.00
2024-12-08 14:54:36,54,2902,12,42,1795.47,2968.72,0.00
2024-12-08 14:54:36,54,2903,12,42,1842.43,2969.00,0.00
2024-12-08 14:54:36,55,2903,12,43,1808.93,2969.02,0.00
2024-12-08 14:54:36,54,2903,12,42,1835.83,2969.02,0.00
2024-12-08 14:54:36,54,2904,12,42,1840.30,2970.00,0.00
2024-12-08 14:54:36,55,2904,12,43,1806.84,2970.02,0.00
2024-12-08 14:54:36,55,2905,12,43,1799.89,2971.00,0.00
2024-12-08 14:54:36,56,2905,13,43,1767.74,2971.02,0.00
2024-12-08 14:54:36,55,2905,13,42,1793.40,2971.02,0.00
2024-12-08 14:54:36,54,2905,12,42,1789.23,2971.96,0.00
2024-12-08 14:54:36,54,2906,12,42,1843.19,2972.00,0.00
2024-12-08 14:54:36,55,2906,13,42,1809.68,2972.02,0.00
2024-12-08 14:54:36,55,2907,13,42,1802.72,2973.00,0.00
2024-12-08 14:54:36,56,2907,14,42,1770.53,2973.02,0.00
2024-12-08 14:54:36,55,2907,14,41,1796.77,2973.02,0.00
2024-12-08 14:54:36,55,2908,14,41,1800.62,2974.00,0.00
2024-12-08 14:54:36,56,2908,15,41,1768.47,2974.02,0.00
2024-12-08 14:54:36,55,2908,14,41,1761.91,2974.51,0.00
2024-12-08 14:54:36,55,2909,14,41,1801.77,2975.00,0.00
2024-12-08 14:54:36,56,2909,15,41,1769.59,2975.02,0.00
2024-12-08 14:54:36,55,2909,15,40,1796.36,2975.02,0.00
2024-12-08 14:54:36,56,2908,16,40,1723.72,2975.71,0.00
2024-12-08 14:54:36,56,2909,16,40,1777.63,2976.00,0.00
2024-12-08 14:54:36,57,2909,16,41,1746.44,2976.02,0.00
2024-12-08 14:54:36,57,2910,16,41,1790.90,2977.00,0.00
2024-12-08 14:54:36,58,2910,17,41,1760.02,2977.02,0.00
2024-12-08 14:54:36,57,2910,17,40,1786.20,2977.02,0.00
2024-12-08 14:54:36,56,2910,16,40,1809.59,2977.02,0.00
2024-12-08 14:54:36,56,2911,16,40,1834.13,2978.00,0.00
2024-12-08 14:54:36,57,2911,17,40,1801.95,2978.02,0.00
2024-12-08 14:54:36,56,2911,16,40,1805.55,2978.36,0.00
2024-12-08 14:54:36,56,2912,16,40,1840.06,2979.00,0.00
2024-12-08 14:54:36,57,2912,16,41,1807.78,2979.02,0.00
2024-12-08 14:54:36,56,2912,16,40,1835.28,2979.02,0.00
2024-12-08 14:54:36,56,2913,16,40,1838.55,2980.00,0.00
2024-12-08 14:54:36,57,2913,16,41,1806.30,2980.02,0.00
2024-12-08 14:54:36,58,2912,16,42,1739.20,2980.93,0.00
2024-12-08 14:54:36,58,2913,16,42,1770.10,2981.00,0.00
2024-12-08 14:54:36,59,2913,16,43,1740.10,2981.02,0.00
2024-12-08 14:54:36,58,2913,16,42,1765.98,2981.02,0.00
2024-12-08 14:54:36,58,2914,16,42,1819.53,2982.00,0.00
2024-12-08 14:54:36,59,2914,16,43,1788.69,2982.02,0.00
2024-12-08 14:54:36,58,2914,15,43,1774.82,2982.91,0.00
2024-12-08 14:54:36,58,2915,15,43,1823.74,2983.00,0.00
2024-12-08 14:54:36,59,2915,16,43,1792.83,2983.02,0.00
2024-12-08 14:54:36,58,2915,16,42,1820.14,2983.02,0.00
2024-12-08 14:54:36,58,2916,16,42,1822.30,2984.00,0.00
2024-12-08 14:54:36,59,2916,17,42,1791.41,2984.02,0.00
2024-12-08 14:54:36,58,2916,16,42,1782.62,2984.83,0.00
2024-12-08 14:54:36,58,2917,16,42,1829.08,2985.00,0.00
2024-12-08 14:54:36,59,2917,16,43,1798.08,2985.02,0.00
2024-12-08 14:54:36,58,2917,16,42,1826.00,2985.02,0.00
2024-12-08 14:54:36,58,2918,16,42,1828.15,2986.00,0.00
2024-12-08 14:54:36,59,2918,17,42,1797.17,2986.02,0.00
2024-12-08 14:54:36,58,2918,16,42,1779.06,2986.66,0.00
2024-12-08 14:54:37,58,2919,16,42,1820.52,2987.00,0.00
2024-12-08 14:54:37,59,2919,17,42,1789.67,2987.02,0.00
2024-12-08 14:54:37,58,2919,17,41,1817.95,2987.02,0.00
2024-12-08 14:54:37,58,2920,17,41,1820.10,2988.00,0.00
2024-12-08 14:54:37,59,2920,17,42,1789.25,2988.02,0.00
2024-12-08 14:54:37,59,2921,17,42,1780.73,2989.00,0.00
2024-12-08 14:54:37,60,2921,17,43,1751.06,2989.02,0.00
2024-12-08 14:54:37,59,2921,17,42,1778.20,2989.02,0.00
2024-12-08 14:54:37,59,2922,17,42,1779.81,2990.00,0.00
2024-12-08 14:54:37,60,2922,17,43,1750.15,2990.02,0.00
2024-12-08 14:54:37,60,2923,17,43,1741.26,2991.00,0.00
2024-12-08 14:54:37,61,2923,18,43,1712.72,2991.02,0.00
2024-12-08 14:54:37,60,2923,18,42,1738.77,2991.02,0.00
2024-12-08 14:54:37,59,2923,17,42,1735.28,2991.90,0.00
2024-12-08 14:54:37,59,2924,17,42,1783.03,2992.00,0.00
2024-12-08 14:54:37,60,2924,18,42,1753.31,2992.02,0.00
2024-12-08 14:54:37,60,2925,18,42,1744.42,2993.00,0.00
2024-12-08 14:54:37,61,2925,18,43,1715.82,2993.02,0.00
2024-12-08 14:54:37,60,2925,18,42,1742.42,2993.02,0.00
2024-12-08 14:54:37,59,2925,17,42,1751.50,2993.70,0.00
2024-12-08 14:54:37,59,2926,17,42,1773.06,2994.00,0.00
2024-12-08 14:54:37,60,2926,17,43,1743.51,2994.02,0.00
2024-12-08 14:54:37,60,2927,17,43,1734.60,2995.00,0.00
2024-12-08 14:54:37,61,2927,17,44,1706.17,2995.02,0.00
2024-12-08 14:54:37,60,2927,17,43,1733.11,2995.02,0.00
2024-12-08 14:54:37,60,2928,17,43,1734.18,2996.00,0.00
2024-12-08 14:54:37,61,2928,18,43,1705.75,2996.02,0.00
2024-12-08 14:54:37,61,2929,18,43,1696.50,2997.00,0.00
2024-12-08 14:54:37,62,2929,18,44,1669.14,2997.02,0.00
2024-12-08 14:54:37,61,2929,18,43,1695.02,2997.02,0.00
2024-12-08 14:54:37,61,2930,18,43,1695.59,2998.00,0.00
2024-12-08 14:54:37,62,2930,18,44,1668.24,2998.02,0.00
2024-12-08 14:54:37,61,2930,17,44,1652.83,2998.90,0.00
2024-12-08 14:54:37,61,2931,17,44,1699.10,2999.00,0.00
2024-12-08 14:54:37,62,2931,17,45,1671.70,2999.02,0.00
2024-12-08 14:54:37,61,2931,17,44,1698.12,2999.02,0.00
2024-12-08 14:54:37,61,2932,17,44,1698.69,3000.00,0.00
2024-12-08 14:54:37,62,2932,18,44,1671.29,3000.02,0.00
2024-12-08 14:54:37,61,2932,17,44,1652.98,3000.95,0.00
2024-12-08 14:54:37,61,2933,17,44,1700.73,3001.00,0.00
2024-12-08 14:54:37,62,2933,17,45,1673.30,3001.02,0.00
2024-12-08 14:54:37,61,2933,17,44,1699.75,3001.02,0.00
2024-12-08 14:54:37,61,2934,17,44,1700.31,3002.00,0.00
2024-12-08 14:54:37,62,2934,18,44,1672.89,3002.02,0.00
2024-12-08 14:54:37,62,2935,18,44,1663.27,3003.00,0.00
2024-12-08 14:54:37,63,2935,18,45,1636.87,3003.02,0.00
2024-12-08 14:54:37,62,2935,18,44,1662.30,3003.02,0.00
2024-12-08 14:54:37,62,2936,18,44,1662.37,3004.00,0.00
2024-12-08 14:54:37,63,2936,18,45,1635.99,3004.02,0.00
2024-12-08 14:54:37,62,2936,17,45,1626.72,3004.50,0.00
2024-12-08 14:54:37,62,2937,17,45,1660.50,3005.00,0.00
2024-12-08 14:54:37,63,2937,18,45,1634.15,3005.02,0.00
2024-12-08 14:54:37,62,2937,18,44,1659.53,3005.02,0.00
2024-12-08 14:54:37,62,2938,18,44,1659.60,3006.00,0.00
2024-12-08 14:54:37,63,2938,18,45,1633.26,3006.02,0.00
2024-12-08 14:54:37,63,2939,18,45,1623.30,3007.00,0.00
2024-12-08 14:54:37,64,2939,18,46,1597.94,3007.02,0.00
2024-12-08 14:54:37,63,2939,18,45,1622.82,3007.02,0.00
2024-12-08 14:54:37,62,2939,17,45,1628.47,3007.71,0.00
2024-12-08 14:54:37,62,2940,17,45,1649.06,3008.00,0.00
2024-12-08 14:54:37,63,2940,18,45,1622.89,3008.02,0.00
2024-12-08 14:54:37,62,2940,17,45,1602.52,3008.97,0.00
2024-12-08 14:54:37,62,2941,17,45,1650.10,3009.00,0.00
2024-12-08 14:54:37,63,2941,18,45,1623.90,3009.02,0.00
2024-12-08 14:54:37,62,2941,18,44,1648.64,3009.03,0.00
2024-12-08 14:54:37,61,2941,17,44,1649.72,3009.51,0.00
2024-12-08 14:54:37,61,2942,17,44,1684.61,3010.00,0.00
2024-12-08 14:54:37,62,2942,18,44,1657.44,3010.02,0.00
2024-12-08 14:54:37,62,2943,18,44,1647.79,3011.00,0.00
2024-12-08 14:54:37,63,2943,18,45,1621.64,3011.02,0.00
2024-12-08 14:54:37,62,2943,18,44,1646.83,3011.03,0.00
2024-12-08 14:54:37,62,2944,18,44,1647.37,3012.00,0.00
2024-12-08 14:54:37,63,2944,18,45,1621.22,3012.02,0.00
2024-12-08 14:54:37,62,2944,18,44,1636.68,3012.03,0.00
2024-12-08 14:54:37,61,2944,17,44,1642.61,3012.72,0.00
2024-12-08 14:54:37,61,2945,17,44,1664.06,3013.00,0.00
2024-12-08 14:54:37,62,2945,17,45,1637.22,3013.02,0.00
2024-12-08 14:54:37,62,2946,17,45,1627.56,3014.00,0.00
2024-12-08 14:54:37,63,2946,18,45,1601.73,3014.02,0.00
2024-12-08 14:54:37,62,2946,18,44,1626.59,3014.03,0.00
2024-12-08 14:54:37,61,2946,17,44,1647.87,3014.21,0.00
2024-12-08 14:54:37,60,2946,16,44,1670.34,3014.28,0.00
2024-12-08 14:54:37,60,2947,16,44,1699.45,3015.00,0.00
2024-12-08 14:54:37,61,2947,16,45,1671.59,3015.02,0.00
2024-12-08 14:54:37,60,2947,16,44,1688.40,3015.03,0.00
2024-12-08 14:54:37,61,2946,17,44,1646.58,3015.54,0.00
2024-12-08 14:54:38,61,2947,17,44,1679.57,3016.00,0.00
2024-12-08 14:54:38,62,2947,17,45,1652.48,3016.02,0.00
2024-12-08 14:54:38,61,2947,17,44,1668.69,3016.03,0.00
2024-12-08 14:54:38,60,2947,16,44,1672.75,3016.75,0.00
2024-12-08 14:54:38,60,2948,16,44,1765.95,3017.00,0.00
2024-12-08 14:54:38,61,2948,17,44,1737.00,3017.02,0.00
2024-12-08 14:54:38,60,2948,17,43,1754.89,3017.03,0.00
2024-12-08 14:54:38,60,2949,17,43,1756.48,3018.00,0.00
2024-12-08 14:54:38,61,2949,18,43,1727.68,3018.02,0.00
2024-12-08 14:54:38,60,2949,17,43,1723.43,3018.43,0.00
2024-12-08 14:54:38,60,2950,17,43,1757.06,3019.00,0.00
2024-12-08 14:54:38,61,2950,17,44,1728.25,3019.02,0.00
2024-12-08 14:54:38,60,2950,17,43,1754.04,3019.05,0.00
2024-12-08 14:54:38,60,2951,17,43,1756.13,3020.00,0.00
2024-12-08 14:54:38,61,2951,18,43,1727.34,3020.02,0.00
2024-12-08 14:54:38,61,2952,18,43,1718.01,3021.00,0.00
2024-12-08 14:54:38,62,2952,18,44,1690.30,3021.02,0.00
2024-12-08 14:54:38,62,2953,18,44,1680.62,3022.00,0.00
2024-12-08 14:54:38,63,2953,18,45,1653.94,3022.02,0.00
2024-12-08 14:54:38,62,2953,18,44,1678.68,3022.05,0.00
2024-12-08 14:54:38,62,2954,18,44,1679.71,3023.00,0.00
2024-12-08 14:54:38,63,2954,19,44,1653.05,3023.02,0.00
2024-12-08 14:54:38,62,2954,19,43,1677.28,3023.05,0.00
2024-12-08 14:54:38,63,2953,20,43,1632.72,3023.68,0.00
2024-12-08 14:54:38,62,2953,19,43,1690.50,3023.97,0.00
2024-12-08 14:54:38,62,2954,19,43,1738.31,3024.00,0.00
2024-12-08 14:54:38,63,2954,19,44,1710.72,3024.02,0.00
2024-12-08 14:54:38,62,2954,18,44,1715.97,3024.31,0.00
2024-12-08 14:54:38,62,2955,18,44,1793.04,3025.00,0.00
2024-12-08 14:54:38,63,2955,19,44,1764.58,3025.02,0.00
2024-12-08 14:54:38,62,2955,19,43,1790.61,3025.05,0.00
2024-12-08 14:54:38,62,2956,19,43,1791.68,3026.00,0.00
2024-12-08 14:54:38,63,2956,20,43,1763.24,3026.02,0.00
2024-12-08 14:54:38,63,2957,20,43,1753.26,3027.00,0.00
2024-12-08 14:54:38,64,2957,20,44,1725.86,3027.02,0.00
2024-12-08 14:54:38,63,2957,20,43,1751.34,3027.05,0.00
2024-12-08 14:54:38,63,2958,20,43,1751.91,3028.00,0.00
2024-12-08 14:54:38,64,2958,21,43,1724.54,3028.02,0.00
2024-12-08 14:54:38,64,2959,21,43,1714.22,3029.00,0.00
2024-12-08 14:54:38,65,2959,22,43,1687.85,3029.02,0.00
2024-12-08 14:54:38,64,2959,21,43,1713.75,3029.02,0.00
2024-12-08 14:54:38,63,2959,21,42,1739.99,3029.03,0.00
2024-12-08 14:54:38,62,2959,20,42,1732.45,3029.95,0.00
2024-12-08 14:54:38,62,2960,20,42,1779.88,3030.00,0.00
2024-12-08 14:54:38,63,2960,21,42,1751.63,3030.02,0.00
2024-12-08 14:54:38,63,2961,21,42,1741.62,3031.00,0.00
2024-12-08 14:54:38,64,2961,22,42,1714.41,3031.02,0.00
2024-12-08 14:54:38,63,2961,22,41,1740.18,3031.03,0.00
2024-12-08 14:54:38,62,2961,21,41,1733.57,3031.94,0.00
2024-12-08 14:54:38,62,2962,21,41,1780.57,3032.00,0.00
2024-12-08 14:54:38,63,2962,21,42,1752.30,3032.02,0.00
2024-12-08 14:54:38,63,2963,21,42,1742.29,3033.00,0.00
2024-12-08 14:54:38,64,2963,21,43,1715.07,3033.02,0.00
2024-12-08 14:54:38,63,2963,21,42,1740.85,3033.03,0.00
2024-12-08 14:54:38,63,2964,21,42,1740.94,3034.00,0.00
2024-12-08 14:54:38,64,2964,21,43,1713.74,3034.02,0.00
2024-12-08 14:54:38,63,2964,20,43,1694.28,3034.97,0.00
2024-12-08 14:54:38,63,2965,20,43,1741.51,3035.00,0.00
2024-12-08 14:54:38,64,2965,20,44,1714.30,3035.02,0.00
2024-12-08 14:54:38,63,2965,20,43,1740.55,3035.03,0.00
2024-12-08 14:54:38,63,2966,20,43,1740.64,3036.00,0.00
2024-12-08 14:54:38,64,2966,20,44,1713.44,3036.02,0.00
2024-12-08 14:54:38,63,2966,19,44,1722.86,3036.21,0.00
2024-12-08 14:54:38,63,2967,19,44,1747.48,3037.00,0.00
2024-12-08 14:54:38,64,2967,20,44,1720.18,3037.02,0.00
2024-12-08 14:54:38,63,2967,20,43,1737.84,3037.03,0.00
2024-12-08 14:54:38,62,2967,19,43,1733.80,3037.58,0.00
2024-12-08 14:54:38,62,2968,19,43,1770.37,3038.00,0.00
2024-12-08 14:54:38,63,2968,20,43,1742.27,3038.02,0.00
2024-12-08 14:54:38,62,2968,20,42,1759.59,3038.03,0.00
2024-12-08 14:54:38,61,2968,19,42,1746.96,3038.74,0.00
2024-12-08 14:54:38,61,2969,19,42,1789.02,3039.00,0.00
2024-12-08 14:54:38,62,2969,19,43,1760.17,3039.02,0.00
2024-12-08 14:54:38,62,2970,19,43,1750.45,3040.00,0.00
2024-12-08 14:54:38,63,2970,20,43,1722.67,3040.02,0.00
2024-12-08 14:54:38,62,2970,20,42,1749.47,3040.03,0.00
2024-12-08 14:54:38,61,2970,19,42,1747.72,3040.87,0.00
2024-12-08 14:54:38,61,2971,19,42,1793.69,3041.00,0.00
2024-12-08 14:54:38,62,2971,19,43,1764.76,3041.02,0.00
2024-12-08 14:54:38,61,2971,18,43,1793.19,3041.02,0.00
2024-12-08 14:54:38,60,2971,18,42,1812.44,3041.02,0.00
2024-12-08 14:54:39,60,2972,18,42,1813.54,3042.00,0.00
2024-12-08 14:54:39,61,2972,19,42,1783.81,3042.02,0.00
2024-12-08 14:54:39,61,2973,19,42,1774.42,3043.00,0.00
2024-12-08 14:54:39,62,2973,20,42,1745.80,3043.02,0.00
2024-12-08 14:54:39,61,2973,20,41,1771.93,3043.05,0.00
2024-12-08 14:54:39,60,2973,19,41,1795.94,3043.22,0.00
2024-12-08 14:54:39,60,2974,19,41,1803.06,3044.00,0.00
2024-12-08 14:54:39,61,2974,19,42,1773.50,3044.02,0.00
2024-12-08 14:54:39,60,2974,18,42,1764.21,3044.52,0.00
2024-12-08 14:54:39,60,2975,18,42,1800.61,3045.00,0.00
2024-12-08 14:54:39,61,2975,18,43,1771.09,3045.02,0.00
2024-12-08 14:54:39,60,2975,18,42,1798.59,3045.05,0.00
2024-12-08 14:54:39,60,2976,18,42,1800.69,3046.00,0.00
2024-12-08 14:54:39,61,2976,19,42,1771.17,3046.02,0.00
2024-12-08 14:54:39,61,2977,19,42,1761.76,3047.00,0.00
2024-12-08 14:54:39,62,2977,19,43,1733.35,3047.02,0.00
2024-12-08 14:54:39,61,2977,19,42,1759.27,3047.05,0.00
2024-12-08 14:54:39,60,2977,18,42,1783.57,3047.20,0.00
2024-12-08 14:54:39,60,2978,18,42,1790.19,3048.00,0.00
2024-12-08 14:54:39,61,2978,18,43,1760.84,3048.02,0.00
2024-12-08 14:54:39,61,2979,18,43,1751.42,3049.00,0.00
2024-12-08 14:54:39,62,2979,18,44,1723.18,3049.02,0.00
2024-12-08 14:54:39,61,2979,18,43,1749.43,3049.05,0.00
2024-12-08 14:54:39,61,2980,18,43,1751.00,3050.00,0.00
2024-12-08 14:54:39,62,2980,18,44,1722.76,3050.02,0.00
2024-12-08 14:54:39,61,2980,17,44,1710.74,3050.56,0.00
2024-12-08 14:54:39,61,2981,17,44,1747.57,3051.00,0.00
2024-12-08 14:54:39,62,2981,17,45,1719.39,3051.02,0.00
2024-12-08 14:54:39,61,2981,17,44,1743.08,3051.07,0.00
2024-12-08 14:54:39,61,2982,17,44,1745.14,3052.00,0.00
2024-12-08 14:54:39,62,2982,18,44,1717.00,3052.02,0.00
2024-12-08 14:54:39,61,2982,17,44,1732.14,3052.05,0.00
2024-12-08 14:54:39,61,2983,17,44,1743.71,3053.00,0.00
2024-12-08 14:54:39,62,2983,17,45,1715.59,3053.02,0.00
2024-12-08 14:54:39,61,2983,17,44,1739.21,3053.05,0.00
2024-12-08 14:54:39,61,2984,17,44,1740.78,3054.00,0.00
2024-12-08 14:54:39,62,2984,17,45,1712.70,3054.02,0.00
2024-12-08 14:54:39,61,2984,16,45,1699.47,3054.56,0.00
2024-12-08 14:54:39,61,2985,16,45,1736.34,3055.00,0.00
2024-12-08 14:54:39,62,2985,16,46,1708.34,3055.02,0.00
2024-12-08 14:54:39,61,2985,16,45,1732.34,3055.05,0.00
2024-12-08 14:54:39,61,2986,16,45,1733.90,3056.00,0.00
2024-12-08 14:54:39,62,2986,17,45,1705.94,3056.02,0.00
2024-12-08 14:54:39,62,2987,17,45,1707.31,3057.00,0.00
2024-12-08 14:54:39,63,2987,17,46,1680.21,3057.02,0.00
2024-12-08 14:54:39,63,2988,17,46,1674.21,3058.00,0.00
2024-12-08 14:54:39,64,2988,18,46,1648.05,3058.02,0.00
2024-12-08 14:54:39,63,2988,18,45,1664.50,3058.05,0.00
2024-12-08 14:54:39,62,2988,17,45,1675.15,3058.44,0.00
2024-12-08 14:54:39,62,2989,17,45,1707.61,3059.00,0.00
2024-12-08 14:54:39,63,2989,17,46,1680.51,3059.02,0.00
2024-12-08 14:54:39,63,2990,17,46,1670.37,3060.00,0.00
2024-12-08 14:54:39,64,2990,17,47,1644.27,3060.02,0.00
2024-12-08 14:54:39,63,2990,17,46,1668.43,3060.05,0.00
2024-12-08 14:54:39,62,2990,16,46,1675.43,3060.69,0.00
2024-12-08 14:54:39,61,2990,15,46,1690.98,3060.89,0.00
2024-12-08 14:54:39,61,2991,15,46,1737.74,3061.00,0.00
2024-12-08 14:54:39,62,2991,15,47,1709.72,3061.02,0.00
2024-12-08 14:54:39,61,2991,14,47,1705.46,3061.72,0.00
2024-12-08 14:54:39,61,2992,14,47,1747.35,3062.00,0.00
2024-12-08 14:54:39,62,2992,15,47,1719.16,3062.02,0.00
2024-12-08 14:54:39,61,2992,14,47,1746.85,3062.02,0.00
2024-12-08 14:54:39,60,2992,14,46,1774.94,3062.03,0.00
2024-12-08 14:54:39,60,2993,14,46,1796.96,3063.00,0.00
2024-12-08 14:54:39,61,2993,15,46,1767.50,3063.02,0.00
2024-12-08 14:54:39,60,2993,14,46,1796.45,3063.02,0.00
2024-12-08 14:54:39,60,2994,14,46,1787.33,3064.00,0.00
2024-12-08 14:54:39,61,2994,14,47,1758.03,3064.02,0.00
2024-12-08 14:54:39,60,2994,14,46,1786.31,3064.02,0.00
2024-12-08 14:54:39,59,2994,13,46,1775.88,3064.68,0.00
2024-12-08 14:54:39,59,2995,13,46,1818.22,3065.00,0.00
2024-12-08 14:54:39,60,2995,14,46,1787.92,3065.02,0.00
2024-12-08 14:54:39,59,2995,13,46,1797.52,3065.27,0.00
2024-12-08 14:54:39,59,2996,13,46,1827.65,3066.00,0.00
2024-12-08 14:54:39,60,2996,13,47,1797.19,3066.02,0.00
2024-12-08 14:54:39,59,2996,13,46,1826.09,3066.02,0.00
2024-12-08 14:54:39,58,2996,12,46,1836.76,3066.69,0.00
2024-12-08 14:54:39,58,2997,12,46,1859.24,3067.00,0.00
2024-12-08 14:54:39,59,2997,12,47,1827.72,3067.02,0.00
2024-12-08 14:54:40,59,2998,12,47,1818.96,3068.00,0.00
2024-12-08 14:54:40,60,2998,12,48,1788.64,3068.02,0.00
2024-12-08 14:54:40,59,2998,12,47,1817.92,3068.02,0.00
2024-12-08 14:54:40,58,2998,11,47,1811.22,3068.97,0.00
2024-12-08 14:54:40,58,2999,11,47,1863.09,3069.00,0.00
2024-12-08 14:54:40,59,2999,11,48,1831.52,3069.02,0.00
2024-12-08 14:54:40,59,3000,11,48,1822.75,3070.00,0.00
2024-12-08 14:54:40,60,3000,12,48,1792.37,3070.02,0.00
2024-12-08 14:54:40,59,3000,12,47,1822.23,3070.02,0.00
2024-12-08 14:54:40,59,3001,12,47,1823.86,3071.00,0.00
2024-12-08 14:54:40,60,3001,12,48,1793.46,3071.02,0.00
2024-12-08 14:54:40,60,3002,12,48,1784.32,3072.00,0.00
2024-12-08 14:54:40,61,3002,13,48,1755.07,3072.02,0.00
2024-12-08 14:54:40,60,3002,13,47,1783.30,3072.02,0.00
2024-12-08 14:54:40,60,3003,13,47,1784.39,3073.00,0.00
2024-12-08 14:54:40,61,3003,14,47,1755.14,3073.02,0.00
2024-12-08 14:54:40,60,3003,13,47,1736.28,3073.97,0.00
2024-12-08 14:54:40,60,3004,13,47,1786.51,3074.00,0.00
2024-12-08 14:54:40,61,3004,14,47,1757.22,3074.02,0.00
2024-12-08 14:54:40,60,3004,14,46,1785.99,3074.02,0.00
2024-12-08 14:54:40,60,3005,14,46,1787.09,3075.00,0.00
2024-12-08 14:54:40,61,3005,15,46,1757.79,3075.02,0.00
2024-12-08 14:54:40,60,3005,15,45,1776.32,3075.02,0.00
2024-12-08 14:54:40,60,3006,15,45,1777.41,3076.00,0.00
2024-12-08 14:54:40,61,3006,16,45,1748.28,3076.02,0.00
2024-12-08 14:54:40,61,3007,16,45,1738.76,3077.00,0.00
2024-12-08 14:54:40,62,3007,16,46,1710.71,3077.02,0.00
2024-12-08 14:54:40,61,3007,16,45,1738.25,3077.02,0.00
2024-12-08 14:54:40,61,3008,16,45,1738.82,3078.00,0.00
2024-12-08 14:54:40,62,3008,17,45,1710.77,3078.02,0.00
2024-12-08 14:54:40,61,3008,17,44,1728.22,3078.02,0.00
2024-12-08 14:54:40,61,3009,17,44,1728.78,3079.00,0.00
2024-12-08 14:54:40,62,3009,18,44,1700.90,3079.02,0.00
2024-12-08 14:54:40,61,3009,18,43,1718.18,3079.02,0.00
2024-12-08 14:54:40,61,3010,18,43,1718.74,3080.00,0.00
2024-12-08 14:54:40,62,3010,18,44,1691.02,3080.02,0.00
2024-12-08 14:54:40,62,3011,18,44,1681.13,3081.00,0.00
2024-12-08 14:54:40,63,3011,18,45,1654.45,3081.02,0.00
2024-12-08 14:54:40,62,3011,18,44,1680.64,3081.02,0.00
2024-12-08 14:54:40,61,3011,17,44,1670.33,3081.97,0.00
2024-12-08 14:54:40,61,3012,17,44,1719.86,3082.00,0.00
2024-12-08 14:54:40,62,3012,18,44,1692.12,3082.02,0.00
2024-12-08 14:54:40,62,3013,18,44,1682.22,3083.00,0.00
2024-12-08 14:54:40,63,3013,18,45,1655.52,3083.02,0.00
2024-12-08 14:54:40,62,3013,18,44,1681.23,3083.03,0.00
2024-12-08 14:54:40,61,3013,17,44,1690.23,3083.39,0.00
2024-12-08 14:54:40,60,3013,16,44,1707.83,3083.73,0.00
2024-12-08 14:54:40,60,3014,16,44,1751.20,3084.00,0.00
2024-12-08 14:54:40,61,3014,17,44,1722.49,3084.02,0.00
2024-12-08 14:54:40,60,3014,17,43,1739.90,3084.03,0.00
2024-12-08 14:54:40,59,3014,16,43,1750.70,3084.39,0.00
2024-12-08 14:54:40,59,3015,16,43,1784.59,3085.00,0.00
2024-12-08 14:54:40,60,3015,16,44,1754.85,3085.02,0.00
2024-12-08 14:54:40,60,3016,16,44,1745.65,3086.00,0.00
2024-12-08 14:54:40,61,3016,17,44,1717.03,3086.02,0.00
2024-12-08 14:54:40,60,3016,17,43,1744.62,3086.03,0.00
2024-12-08 14:54:40,60,3017,17,43,1746.21,3087.00,0.00
2024-12-08 14:54:40,61,3017,17,44,1717.59,3087.02,0.00
2024-12-08 14:54:40,60,3017,17,43,1734.90,3087.03,0.00
2024-12-08 14:54:40,59,3017,16,43,1726.65,3087.97,0.00
2024-12-08 14:54:40,59,3018,16,43,1777.95,3088.00,0.00
2024-12-08 14:54:40,60,3018,17,43,1748.32,3088.02,0.00
2024-12-08 14:54:40,59,3018,16,43,1760.22,3088.24,0.00
2024-12-08 14:54:40,59,3019,16,43,1768.58,3089.00,0.00
2024-12-08 14:54:40,60,3019,17,43,1739.11,3089.02,0.00
2024-12-08 14:54:40,59,3019,17,42,1766.49,3089.03,0.00
2024-12-08 14:54:40,59,3020,17,42,1768.63,3090.00,0.00
2024-12-08 14:54:40,60,3020,18,42,1739.15,3090.02,0.00
2024-12-08 14:54:40,59,3020,17,42,1730.98,3090.22,0.00
2024-12-08 14:54:40,59,3021,17,42,1759.77,3091.00,0.00
2024-12-08 14:54:40,60,3021,18,42,1730.44,3091.02,0.00
2024-12-08 14:54:40,59,3021,18,41,1758.21,3091.03,0.00
2024-12-08 14:54:40,59,3022,18,41,1760.34,3092.00,0.00
2024-12-08 14:54:40,60,3022,19,41,1731.00,3092.02,0.00
2024-12-08 14:54:40,59,3022,18,41,1726.13,3092.75,0.00
2024-12-08 14:54:40,59,3023,18,41,1770.87,3093.00,0.00
2024-12-08 14:54:40,60,3023,19,41,1741.36,3093.02,0.00
2024-12-08 14:54:40,59,3023,19,40,1769.83,3093.03,0.00
2024-12-08 14:54:41,59,3024,19,40,1771.97,3094.00,0.00
2024-12-08 14:54:41,60,3024,20,40,1742.44,3094.02,0.00
2024-12-08 14:54:41,59,3024,19,40,1742.10,3094.14,0.00
2024-12-08 14:54:41,59,3025,19,40,1768.35,3095.00,0.00
2024-12-08 14:54:41,60,3025,20,40,1738.87,3095.02,0.00
2024-12-08 14:54:41,59,3025,20,39,1766.78,3095.05,0.00
2024-12-08 14:54:41,59,3026,20,39,1769.44,3096.00,0.00
2024-12-08 14:54:41,60,3026,21,39,1739.95,3096.02,0.00
2024-12-08 14:54:41,59,3026,21,38,1757.38,3096.05,0.00
2024-12-08 14:54:41,58,3026,20,38,1767.21,3096.71,0.00
2024-12-08 14:54:41,58,3027,20,38,1790.39,3097.00,0.00
2024-12-08 14:54:41,59,3027,21,38,1760.04,3097.02,0.00
2024-12-08 14:54:41,59,3028,21,38,1751.16,3098.00,0.00
2024-12-08 14:54:41,60,3028,22,38,1721.97,3098.02,0.00
2024-12-08 14:54:41,59,3028,22,37,1749.06,3098.05,0.00
2024-12-08 14:54:41,59,3029,22,37,1751.72,3099.00,0.00
2024-12-08 14:54:41,60,3029,22,38,1722.53,3099.02,0.00
2024-12-08 14:54:41,59,3029,21,38,1713.59,3099.51,0.00
2024-12-08 14:54:41,59,3030,21,38,1751.24,3100.00,0.00
2024-12-08 14:54:41,60,3030,22,38,1722.05,3100.02,0.00
2024-12-08 14:54:41,59,3030,22,37,1749.14,3100.05,0.00
2024-12-08 14:54:41,59,3031,22,37,1751.80,3101.00,0.00
2024-12-08 14:54:41,60,3031,22,38,1722.61,3101.02,0.00
2024-12-08 14:54:41,59,3031,21,38,1743.92,3101.03,0.00
2024-12-08 14:54:41,59,3032,21,38,1756.57,3102.00,0.00
2024-12-08 14:54:41,60,3032,22,38,1727.30,3102.02,0.00
2024-12-08 14:54:41,59,3032,22,37,1755.52,3102.03,0.00
2024-12-08 14:54:41,58,3032,21,37,1750.23,3102.60,0.00
2024-12-08 14:54:41,58,3033,21,37,1791.71,3103.00,0.00
2024-12-08 14:54:41,59,3033,22,37,1761.35,3103.02,0.00
2024-12-08 14:54:41,59,3034,22,37,1752.44,3104.00,0.00
2024-12-08 14:54:41,60,3034,22,38,1723.24,3104.02,0.00
2024-12-08 14:54:41,59,3034,22,37,1751.40,3104.03,0.00
2024-12-08 14:54:41,59,3035,22,37,1753.53,3105.00,0.00
2024-12-08 14:54:41,60,3035,22,38,1724.31,3105.02,0.00
2024-12-08 14:54:41,60,3036,22,38,1715.03,3106.00,0.00
2024-12-08 14:54:41,61,3036,22,39,1686.91,3106.02,0.00
2024-12-08 14:54:41,60,3036,22,38,1713.48,3106.03,0.00
2024-12-08 14:54:41,59,3036,21,38,1722.32,3106.68,0.00
2024-12-08 14:54:41,59,3037,21,38,1744.13,3107.00,0.00
2024-12-08 14:54:41,60,3037,21,39,1715.06,3107.02,0.00
2024-12-08 14:54:41,59,3037,20,39,1735.71,3107.02,0.00
2024-12-08 14:54:41,59,3038,20,39,1747.85,3108.00,0.00
2024-12-08 14:54:41,60,3038,21,39,1718.72,3108.02,0.00
2024-12-08 14:54:41,59,3038,21,38,1745.22,3108.02,0.00
2024-12-08 14:54:41,59,3039,21,38,1746.84,3109.00,0.00
2024-12-08 14:54:41,60,3039,22,38,1717.72,3109.02,0.00
2024-12-08 14:54:41,59,3039,21,38,1714.51,3109.70,0.00
2024-12-08 14:54:41,59,3040,21,38,1757.94,3110.00,0.00
2024-12-08 14:54:41,60,3040,21,39,1728.64,3110.02,0.00
2024-12-08 14:54:41,59,3040,21,38,1755.83,3110.02,0.00
2024-12-08 14:54:41,59,3041,21,38,1757.45,3111.00,0.00
2024-12-08 14:54:41,60,3041,22,38,1728.16,3111.02,0.00
2024-12-08 14:54:41,60,3042,22,38,1718.86,3112.00,0.00
2024-12-08 14:54:41,61,3042,22,39,1690.68,3112.02,0.00
2024-12-08 14:54:41,60,3042,22,38,1717.31,3112.02,0.00
2024-12-08 14:54:41,60,3043,22,38,1718.38,3113.00,0.00
2024-12-08 14:54:41,61,3043,22,39,1690.21,3113.02,0.00
2024-12-08 14:54:41,60,3043,21,39,1688.07,3113.67,0.00
2024-12-08 14:54:41,59,3043,20,39,1699.48,3113.95,0.00
2024-12-08 14:54:41,59,3044,20,39,1750.70,3114.00,0.00
2024-12-08 14:54:41,60,3044,20,40,1721.52,3114.02,0.00
2024-12-08 14:54:41,59,3044,20,39,1749.65,3114.02,0.00
2024-12-08 14:54:41,59,3045,20,39,1751.26,3115.00,0.00
2024-12-08 14:54:41,60,3045,20,40,1722.08,3115.02,0.00
2024-12-08 14:54:41,60,3046,20,40,1712.76,3116.00,0.00
2024-12-08 14:54:41,61,3046,21,40,1684.68,3116.02,0.00
2024-12-08 14:54:41,60,3046,21,39,1712.24,3116.02,0.00
2024-12-08 14:54:41,59,3046,20,39,1711.38,3116.53,0.00
2024-12-08 14:54:41,58,3046,19,39,1735.61,3116.69,0.00
2024-12-08 14:54:41,58,3047,19,39,1779.91,3117.00,0.00
2024-12-08 14:54:41,59,3047,19,40,1749.75,3117.02,0.00
2024-12-08 14:54:41,58,3047,18,40,1733.65,3117.91,0.00
2024-12-08 14:54:41,58,3048,18,40,1784.79,3118.00,0.00
2024-12-08 14:54:41,59,3048,18,41,1754.54,3118.02,0.00
2024-12-08 14:54:41,58,3048,18,40,1783.71,3118.02,0.00
2024-12-08 14:54:41,58,3049,18,40,1785.90,3119.00,0.00
2024-12-08 14:54:41,59,3049,18,41,1755.63,3119.02,0.00
2024-12-08 14:54:41,60,3048,19,41,1711.84,3119.18,0.00
2024-12-08 14:54:41,59,3048,18,41,1744.79,3119.61,0.00
2024-12-08 14:54:41,59,3049,18,41,1785.80,3120.00,0.00
2024-12-08 14:54:41,60,3049,19,41,1756.04,3120.02,0.00
2024-12-08 14:54:41,59,3049,19,40,1784.75,3120.02,0.00
2024-12-08 14:54:42,59,3050,19,40,1839.27,3121.00,0.00
2024-12-08 14:54:42,60,3050,20,40,1808.62,3121.02,0.00
2024-12-08 14:54:42,60,3051,20,40,1799.31,3122.00,0.00
2024-12-08 14:54:42,61,3051,20,41,1769.82,3122.02,0.00
2024-12-08 14:54:42,60,3051,20,40,1797.75,3122.02,0.00
2024-12-08 14:54:42,60,3052,20,40,1798.85,3123.00,0.00
2024-12-08 14:54:42,61,3052,20,41,1769.36,3123.02,0.00
2024-12-08 14:54:42,61,3053,20,41,1759.68,3124.00,0.00
2024-12-08 14:54:42,62,3053,21,41,1731.30,3124.02,0.00
2024-12-08 14:54:42,61,3053,21,40,1758.66,3124.02,0.00
2024-12-08 14:54:42,60,3053,20,40,1749.46,3124.97,0.00
2024-12-08 14:54:42,60,3054,20,40,1800.52,3125.00,0.00
2024-12-08 14:54:42,61,3054,21,40,1771.00,3125.02,0.00
2024-12-08 14:54:42,60,3054,20,40,1749.25,3125.68,0.00
2024-12-08 14:54:42,60,3055,20,40,1791.72,3126.00,0.00
2024-12-08 14:54:42,61,3055,20,41,1762.35,3126.02,0.00
2024-12-08 14:54:42,60,3055,20,40,1790.68,3126.02,0.00
2024-12-08 14:54:42,60,3056,20,40,1791.77,3127.00,0.00
2024-12-08 14:54:42,61,3056,20,41,1762.40,3127.02,0.00
2024-12-08 14:54:42,61,3057,20,41,1752.71,3128.00,0.00
2024-12-08 14:54:42,62,3057,21,41,1724.44,3128.02,0.00
2024-12-08 14:54:42,61,3057,21,40,1752.19,3128.02,0.00
2024-12-08 14:54:42,60,3057,20,40,1759.30,3128.72,0.00
2024-12-08 14:54:42,60,3058,20,40,1802.82,3129.00,0.00
2024-12-08 14:54:42,61,3058,21,40,1773.27,3129.02,0.00
2024-12-08 14:54:42,60,3058,21,39,1791.87,3129.02,0.00
2024-12-08 14:54:42,60,3059,21,39,1792.97,3130.00,0.00
2024-12-08 14:54:42,61,3059,21,40,1763.57,3130.02,0.00
2024-12-08 14:54:42,60,3059,21,39,1782.01,3130.02,0.00
2024-12-08 14:54:42,59,3059,20,39,1801.18,3130.31,0.00
2024-12-08 14:54:42,59,3060,20,39,1832.96,3131.00,0.00
2024-12-08 14:54:42,60,3060,20,40,1802.41,3131.02,0.00
2024-12-08 14:54:42,59,3060,20,39,1821.82,3131.02,0.00
2024-12-08 14:54:42,60,3059,20,40,1789.91,3131.10,0.00
2024-12-08 14:54:42,60,3060,20,40,1832.22,3132.00,0.00
2024-12-08 14:54:42,61,3060,20,41,1802.18,3132.02,0.00
2024-12-08 14:54:42,61,3061,20,41,1859.34,3133.00,0.00
2024-12-08 14:54:42,62,3061,20,42,1829.35,3133.02,0.00
2024-12-08 14:54:42,62,3062,20,42,1831.75,3134.00,0.00
2024-12-08 14:54:42,63,3062,20,43,1802.68,3134.02,0.00
2024-12-08 14:54:42,63,3063,20,43,1798.30,3135.00,0.00
2024-12-08 14:54:42,64,3063,20,44,1770.20,3135.02,0.00
2024-12-08 14:54:42,63,3063,19,44,1777.48,3135.29,0.00
2024-12-08 14:54:42,63,3064,19,44,1805.34,3136.00,0.00
2024-12-08 14:54:42,64,3064,20,44,1777.13,3136.02,0.00
2024-12-08 14:54:42,63,3064,20,43,1803.35,3136.02,0.00
2024-12-08 14:54:42,62,3064,19,43,1794.46,3136.74,0.00
2024-12-08 14:54:42,62,3065,19,43,1837.17,3137.00,0.00
2024-12-08 14:54:42,63,3065,20,43,1808.01,3137.02,0.00
2024-12-08 14:54:42,62,3065,20,42,1828.06,3137.02,0.00
2024-12-08 14:54:42,62,3066,20,42,1828.14,3138.00,0.00
2024-12-08 14:54:42,63,3066,20,43,1799.12,3138.02,0.00
2024-12-08 14:54:42,62,3066,20,42,1819.03,3138.02,0.00
2024-12-08 14:54:42,62,3067,20,42,1819.10,3139.00,0.00
2024-12-08 14:54:42,63,3067,21,42,1790.23,3139.02,0.00
2024-12-08 14:54:42,62,3067,21,41,1808.99,3139.03,0.00
2024-12-08 14:54:42,61,3067,20,41,1828.35,3139.03,0.00
2024-12-08 14:54:42,61,3068,20,41,1850.03,3140.00,0.00
2024-12-08 14:54:42,62,3068,21,41,1820.19,3140.02,0.00
2024-12-08 14:54:42,61,3068,21,40,1839.23,3140.03,0.00
2024-12-08 14:54:42,61,3069,21,40,1840.32,3141.00,0.00
2024-12-08 14:54:42,62,3069,21,41,1810.63,3141.02,0.00
2024-12-08 14:54:42,61,3069,21,40,1829.52,3141.03,0.00
2024-12-08 14:54:42,61,3070,21,40,1830.60,3142.00,0.00
2024-12-08 14:54:42,62,3070,21,41,1801.07,3142.02,0.00
2024-12-08 14:54:42,61,3070,21,40,1819.80,3142.03,0.00
2024-12-08 14:54:42,60,3070,20,40,1827.21,3142.42,0.00
2024-12-08 14:54:42,60,3071,20,40,1861.70,3143.00,0.00
2024-12-08 14:54:42,61,3071,20,41,1831.18,3143.02,0.00
2024-12-08 14:54:42,60,3071,19,41,1830.39,3143.38,0.00
2024-12-08 14:54:42,60,3072,19,41,1863.87,3144.00,0.00
2024-12-08 14:54:42,61,3072,20,41,1833.31,3144.02,0.00
2024-12-08 14:54:42,60,3072,20,40,1862.83,3144.03,0.00
2024-12-08 14:54:42,60,3073,20,40,1864.46,3145.00,0.00
2024-12-08 14:54:42,61,3073,21,40,1833.90,3145.02,0.00
2024-12-08 14:54:42,60,3073,20,40,1845.14,3145.23,0.00
2024-12-08 14:54:42,60,3074,20,40,1873.97,3146.00,0.00
2024-12-08 14:54:42,61,3074,21,40,1843.25,3146.02,0.00
2024-12-08 14:54:42,60,3074,21,39,1872.93,3146.03,0.00
2024-12-08 14:54:42,59,3074,20,39,1885.78,3146.64,0.00
2024-12-08 14:54:42,59,3075,20,39,1906.87,3147.00,0.00
2024-12-08 14:54:42,60,3075,20,40,1875.09,3147.02,0.00
2024-12-08 14:54:42,59,3075,20,39,1895.15,3147.03,0.00
2024-12-08 14:54:43,59,3076,20,39,1897.34,3148.00,0.00
2024-12-08 14:54:43,60,3076,21,39,1865.71,3148.02,0.00
2024-12-08 14:54:43,59,3076,21,38,1885.61,3148.03,0.00
2024-12-08 14:54:43,59,3077,21,38,1887.80,3149.00,0.00
2024-12-08 14:54:43,60,3077,22,38,1856.33,3149.02,0.00
2024-12-08 14:54:43,59,3077,22,37,1876.07,3149.03,0.00
2024-12-08 14:54:43,58,3077,21,37,1894.85,3149.05,0.00
2024-12-08 14:54:43,58,3078,21,37,1919.87,3150.00,0.00
2024-12-08 14:54:43,59,3078,21,38,1887.33,3150.02,0.00
2024-12-08 14:54:43,59,3079,21,38,1878.32,3151.00,0.00
2024-12-08 14:54:43,60,3079,22,38,1847.01,3151.02,0.00
2024-12-08 14:54:43,59,3079,22,37,1877.26,3151.03,0.00
2024-12-08 14:54:43,59,3080,22,37,1879.45,3152.00,0.00
2024-12-08 14:54:43,60,3080,22,38,1848.12,3152.02,0.00
2024-12-08 14:54:43,59,3080,21,38,1858.67,3152.22,0.00
2024-12-08 14:54:43,59,3081,21,38,1888.06,3153.00,0.00
2024-12-08 14:54:43,60,3081,21,39,1856.59,3153.02,0.00
2024-12-08 14:54:43,59,3081,21,38,1884.87,3153.03,0.00
2024-12-08 14:54:43,58,3081,20,38,1913.59,3153.14,0.00
2024-12-08 14:54:43,57,3081,19,38,1925.96,3153.74,0.00
2024-12-08 14:54:43,57,3082,19,38,1973.19,3154.00,0.00
2024-12-08 14:54:43,58,3082,19,39,1939.17,3154.02,0.00
2024-12-08 14:54:43,58,3083,19,39,1930.53,3155.00,0.00
2024-12-08 14:54:43,59,3083,19,40,1897.81,3155.02,0.00
2024-12-08 14:54:43,58,3083,19,39,1926.74,3155.03,0.00
2024-12-08 14:54:43,57,3083,18,39,1957.80,3155.12,0.00
2024-12-08 14:54:43,56,3083,17,39,1968.69,3155.43,0.00
2024-12-08 14:54:43,56,3084,17,39,2007.44,3156.00,0.00
2024-12-08 14:54:43,57,3084,17,40,1972.22,3156.02,0.00
2024-12-08 14:54:43,57,3085,17,40,1963.99,3157.00,0.00
2024-12-08 14:54:43,58,3085,17,41,1930.12,3157.02,0.00
2024-12-08 14:54:43,57,3085,17,40,1960.67,3157.04,0.00
2024-12-08 14:54:43,57,3086,17,40,1964.05,3158.00,0.00
2024-12-08 14:54:43,58,3086,17,41,1930.19,3158.02,0.00
2024-12-08 14:54:43,57,3086,16,41,1949.68,3158.12,0.00
2024-12-08 14:54:43,57,3087,16,41,1955.81,3159.00,0.00
2024-12-08 14:54:43,58,3087,16,42,1922.09,3159.02,0.00
2024-12-08 14:54:43,57,3087,16,41,1952.50,3159.04,0.00
2024-12-08 14:54:43,56,3087,15,41,1957.12,3159.46,0.00
2024-12-08 14:54:43,56,3088,15,41,1997.01,3160.00,0.00
2024-12-08 14:54:43,57,3088,16,41,1961.97,3160.02,0.00
2024-12-08 14:54:43,56,3088,15,41,1967.12,3160.07,0.00
2024-12-08 14:54:43,56,3089,15,41,1994.82,3161.00,0.00
2024-12-08 14:54:43,57,3089,16,41,1959.82,3161.02,0.00
2024-12-08 14:54:43,56,3089,16,40,1991.44,3161.04,0.00
2024-12-08 14:54:43,56,3090,16,40,1995.45,3162.00,0.00
2024-12-08 14:54:43,57,3090,16,41,1960.44,3162.02,0.00
2024-12-08 14:54:43,57,3091,16,41,1952.18,3163.00,0.00
2024-12-08 14:54:43,58,3091,16,42,1918.52,3163.02,0.00
2024-12-08 14:54:43,57,3091,16,41,1948.86,3163.04,0.00
2024-12-08 14:54:43,56,3091,15,41,1961.23,3163.36,0.00
2024-12-08 14:54:43,56,3092,15,41,1997.84,3164.00,0.00
2024-12-08 14:54:43,57,3092,15,42,1962.79,3164.02,0.00
2024-12-08 14:54:43,57,3093,15,42,1954.53,3165.00,0.00
2024-12-08 14:54:43,58,3093,15,43,1920.83,3165.02,0.00
2024-12-08 14:54:43,57,3093,15,42,1945.10,3165.05,0.00
2024-12-08 14:54:43,56,3093,14,42,1947.31,3165.52,0.00
2024-12-08 14:54:43,56,3094,14,42,1988.93,3166.00,0.00
2024-12-08 14:54:43,57,3094,15,42,1954.03,3166.02,0.00
2024-12-08 14:54:43,56,3094,14,42,1941.16,3166.55,0.00
2024-12-08 14:54:43,56,3095,14,42,1983.90,3167.00,0.00
2024-12-08 14:54:43,57,3095,14,43,1949.09,3167.02,0.00
2024-12-08 14:54:43,56,3095,14,42,1974.30,3167.05,0.00
2024-12-08 14:54:43,56,3096,14,42,1978.87,3168.00,0.00
2024-12-08 14:54:43,57,3096,14,43,1944.15,3168.02,0.00
2024-12-08 14:54:43,57,3097,14,43,1936.01,3169.00,0.00
2024-12-08 14:54:43,58,3097,15,43,1902.63,3169.02,0.00
2024-12-08 14:54:43,57,3097,15,42,1926.02,3169.05,0.00
2024-12-08 14:54:43,56,3097,14,42,1940.95,3169.66,0.00
2024-12-08 14:54:43,56,3098,14,42,1964.41,3170.00,0.00
2024-12-08 14:54:43,57,3098,15,42,1929.95,3170.02,0.00
2024-12-08 14:54:43,57,3099,15,42,1921.66,3171.00,0.00
2024-12-08 14:54:43,58,3099,15,43,1888.53,3171.02,0.00
2024-12-08 14:54:43,57,3099,15,42,1912.22,3171.05,0.00
2024-12-08 14:54:43,56,3099,14,42,1926.88,3171.66,0.00
2024-12-08 14:54:43,55,3099,13,42,1944.82,3171.93,0.00
2024-12-08 14:54:43,55,3100,13,42,2000.24,3172.00,0.00
2024-12-08 14:54:43,56,3100,14,42,1964.52,3172.02,0.00
2024-12-08 14:54:44,56,3101,14,42,1956.64,3173.00,0.00
2024-12-08 14:54:44,57,3101,14,43,1922.31,3173.02,0.00
2024-12-08 14:54:44,56,3101,14,42,1947.59,3173.05,0.00
2024-12-08 14:54:44,56,3102,14,42,1952.16,3174.00,0.00
2024-12-08 14:54:44,57,3102,15,42,1917.91,3174.02,0.00
2024-12-08 14:54:44,57,3103,15,42,1909.60,3175.00,0.00
2024-12-08 14:54:44,58,3103,15,43,1876.68,3175.02,0.00
2024-12-08 14:54:44,57,3103,15,42,1901.26,3175.05,0.00
2024-12-08 14:54:44,57,3104,15,42,1905.19,3176.00,0.00
2024-12-08 14:54:44,58,3104,15,43,1872.34,3176.02,0.00
2024-12-08 14:54:44,58,3105,15,43,1863.67,3177.00,0.00
2024-12-08 14:54:44,59,3105,15,44,1832.08,3177.02,0.00
2024-12-08 14:54:44,58,3105,15,43,1854.92,3177.05,0.00
2024-12-08 14:54:44,57,3105,14,43,1873.56,3177.26,0.00
2024-12-08 14:54:44,57,3106,14,43,1906.39,3178.00,0.00
2024-12-08 14:54:44,58,3106,15,43,1873.52,3178.02,0.00
2024-12-08 14:54:44,57,3106,14,43,1861.16,3178.88,0.00
2024-12-08 14:54:44,57,3107,14,43,1913.12,3179.00,0.00
2024-12-08 14:54:44,58,3107,15,43,1880.14,3179.02,0.00
2024-12-08 14:54:44,57,3107,15,42,1904.21,3179.05,0.00
2024-12-08 14:54:44,57,3108,15,42,1908.14,3180.00,0.00
2024-12-08 14:54:44,58,3108,16,42,1875.25,3180.02,0.00
2024-12-08 14:54:44,58,3109,16,42,1866.51,3181.00,0.00
2024-12-08 14:54:44,59,3109,17,42,1834.88,3181.02,0.00
2024-12-08 14:54:44,58,3109,17,41,1858.30,3181.05,0.00
2024-12-08 14:54:44,58,3110,17,41,1861.61,3182.00,0.00
2024-12-08 14:54:44,59,3110,17,42,1830.06,3182.02,0.00
2024-12-08 14:54:44,58,3110,16,42,1829.44,3182.69,0.00
2024-12-08 14:54:44,58,3111,16,42,1852.72,3183.00,0.00
2024-12-08 14:54:44,59,3111,16,43,1821.32,3183.02,0.00
2024-12-08 14:54:44,58,3111,16,42,1845.05,3183.05,0.00
2024-12-08 14:54:44,58,3112,16,42,1848.37,3184.00,0.00
2024-12-08 14:54:44,59,3112,16,43,1817.04,3184.02,0.00
2024-12-08 14:54:44,58,3112,15,43,1797.08,3184.66,0.00
2024-12-08 14:54:44,58,3113,15,43,1841.26,3185.00,0.00
2024-12-08 14:54:44,59,3113,16,43,1810.05,3185.02,0.00
2024-12-08 14:54:44,58,3113,16,42,1834.13,3185.05,0.00
2024-12-08 14:54:44,58,3114,16,42,1837.44,3186.00,0.00
2024-12-08 14:54:44,59,3114,17,42,1806.30,3186.02,0.00
2024-12-08 14:54:44,58,3114,16,42,1789.06,3186.93,0.00
2024-12-08 14:54:44,58,3115,16,42,1841.87,3187.00,0.00
2024-12-08 14:54:44,59,3115,17,42,1810.65,3187.02,0.00
2024-12-08 14:54:44,58,3115,17,41,1834.19,3187.07,0.00
2024-12-08 14:54:44,58,3116,17,41,1838.05,3188.00,0.00
2024-12-08 14:54:44,59,3116,18,41,1806.89,3188.02,0.00
2024-12-08 14:54:44,59,3117,18,41,1797.73,3189.00,0.00
2024-12-08 14:54:44,60,3117,18,42,1767.77,3189.02,0.00
2024-12-08 14:54:44,59,3117,18,41,1790.72,3189.07,0.00
2024-12-08 14:54:44,59,3118,18,41,1793.97,3190.00,0.00
2024-12-08 14:54:44,60,3118,19,41,1764.07,3190.02,0.00
2024-12-08 14:54:44,60,3119,19,41,1754.52,3191.00,0.00
2024-12-08 14:54:44,61,3119,20,41,1725.76,3191.02,0.00
2024-12-08 14:54:44,60,3119,20,40,1748.15,3191.07,0.00
2024-12-08 14:54:44,59,3119,19,40,1750.07,3191.81,0.00
2024-12-08 14:54:44,59,3120,19,40,1798.34,3192.00,0.00
2024-12-08 14:54:44,60,3120,20,40,1768.37,3192.02,0.00
2024-12-08 14:54:44,59,3120,19,40,1783.74,3192.05,0.00
2024-12-08 14:54:44,59,3121,19,40,1797.28,3193.00,0.00
2024-12-08 14:54:44,60,3121,20,40,1767.32,3193.02,0.00
2024-12-08 14:54:44,59,3121,20,39,1790.79,3193.05,0.00
2024-12-08 14:54:44,59,3122,20,39,1793.51,3194.00,0.00
2024-12-08 14:54:44,60,3122,20,40,1763.62,3194.02,0.00
2024-12-08 14:54:44,60,3123,20,40,1754.05,3195.00,0.00
2024-12-08 14:54:44,61,3123,20,41,1725.30,3195.02,0.00
2024-12-08 14:54:44,60,3123,19,41,1753.00,3195.03,0.00
2024-12-08 14:54:44,59,3123,19,40,1777.83,3195.03,0.00
2024-12-08 14:54:44,59,3124,19,40,1780.01,3196.00,0.00
2024-12-08 14:54:44,60,3124,20,40,1750.34,3196.02,0.00
2024-12-08 14:54:44,59,3124,19,40,1744.09,3196.75,0.00
2024-12-08 14:54:44,59,3125,19,40,1790.32,3197.00,0.00
2024-12-08 14:54:44,60,3125,19,41,1760.48,3197.02,0.00
2024-12-08 14:54:44,59,3125,19,40,1784.36,3197.03,0.00
2024-12-08 14:54:44,59,3126,19,40,1786.54,3198.00,0.00
2024-12-08 14:54:44,60,3126,19,41,1756.77,3198.02,0.00
2024-12-08 14:54:44,60,3127,19,41,1747.19,3199.00,0.00
2024-12-08 14:54:44,61,3127,19,42,1718.54,3199.02,0.00
2024-12-08 14:54:44,60,3127,19,41,1741.86,3199.03,0.00
2024-12-08 14:54:44,59,3127,18,41,1740.90,3199.83,0.00
2024-12-08 14:54:45,59,3128,18,41,1789.83,3200.00,0.00
2024-12-08 14:54:45,60,3128,19,41,1760.00,3200.02,0.00
2024-12-08 14:54:45,59,3128,18,41,1740.22,3200.64,0.00
2024-12-08 14:54:45,59,3129,18,41,1783.34,3201.00,0.00
2024-12-08 14:54:45,60,3129,18,42,1753.61,3201.02,0.00
2024-12-08 14:54:45,59,3129,18,41,1777.37,3201.03,0.00
2024-12-08 14:54:45,59,3130,18,41,1779.55,3202.00,0.00
2024-12-08 14:54:45,60,3130,18,42,1749.89,3202.02,0.00
2024-12-08 14:54:45,60,3131,18,42,1740.38,3203.00,0.00
2024-12-08 14:54:45,61,3131,19,42,1711.85,3203.02,0.00
2024-12-08 14:54:45,60,3131,19,41,1735.05,3203.03,0.00
2024-12-08 14:54:45,59,3131,18,41,1725.25,3203.97,0.00
2024-12-08 14:54:45,59,3132,18,41,1778.49,3204.00,0.00
2024-12-08 14:54:45,60,3132,18,42,1748.85,3204.02,0.00
2024-12-08 14:54:45,59,3132,17,42,1763.29,3204.02,0.00
2024-12-08 14:54:45,59,3133,17,42,1775.79,3205.00,0.00
2024-12-08 14:54:45,60,3133,18,42,1746.19,3205.02,0.00
2024-12-08 14:54:45,59,3133,18,41,1771.98,3205.02,0.00
2024-12-08 14:54:45,58,3133,17,41,1780.46,3205.10,0.00
2024-12-08 14:54:45,58,3134,17,41,1807.52,3206.00,0.00
2024-12-08 14:54:45,59,3134,18,41,1776.88,3206.02,0.00
2024-12-08 14:54:45,58,3134,17,41,1770.52,3206.16,0.00
2024-12-08 14:54:45,57,3134,16,41,1801.59,3206.16,0.00
2024-12-08 14:54:45,57,3135,16,41,1831.36,3207.00,0.00
2024-12-08 14:54:45,58,3135,17,41,1799.79,3207.02,0.00
2024-12-08 14:54:45,57,3135,17,40,1827.99,3207.02,0.00
2024-12-08 14:54:45,56,3135,16,40,1856.66,3207.14,0.00
2024-12-08 14:54:45,56,3136,16,40,1864.08,3208.00,0.00
2024-12-08 14:54:45,57,3136,16,41,1831.37,3208.02,0.00
2024-12-08 14:54:45,57,3137,16,41,1822.94,3209.00,0.00
2024-12-08 14:54:45,58,3137,16,42,1791.51,3209.02,0.00
2024-12-08 14:54:45,57,3137,16,41,1820.12,3209.02,0.00
2024-12-08 14:54:45,57,3138,16,41,1822.94,3210.00,0.00
2024-12-08 14:54:45,58,3138,16,42,1791.51,3210.02,0.00
2024-12-08 14:54:45,57,3138,15,42,1771.67,3210.97,0.00
2024-12-08 14:54:45,57,3139,15,42,1826.89,3211.00,0.00
2024-12-08 14:54:45,58,3139,15,43,1795.39,3211.02,0.00
2024-12-08 14:54:45,57,3139,15,42,1824.64,3211.02,0.00
2024-12-08 14:54:45,57,3140,15,42,1827.46,3212.00,0.00
2024-12-08 14:54:45,58,3140,15,43,1795.95,3212.02,0.00
2024-12-08 14:54:45,58,3141,15,43,1787.09,3213.00,0.00
2024-12-08 14:54:45,59,3141,16,43,1756.80,3213.02,0.00
2024-12-08 14:54:45,58,3141,16,42,1785.43,3213.02,0.00
2024-12-08 14:54:45,57,3141,15,42,1794.54,3213.70,0.00
2024-12-08 14:54:45,56,3141,14,42,1815.80,3213.86,0.00
2024-12-08 14:54:45,56,3142,14,42,1868.71,3214.00,0.00
2024-12-08 14:54:45,57,3142,14,43,1835.93,3214.02,0.00
2024-12-08 14:54:45,57,3143,14,43,1827.47,3215.00,0.00
2024-12-08 14:54:45,58,3143,15,43,1795.96,3215.02,0.00
2024-12-08 14:54:45,57,3143,15,42,1825.22,3215.02,0.00
2024-12-08 14:54:45,57,3144,15,42,1828.04,3216.00,0.00
2024-12-08 14:54:45,58,3144,16,42,1796.52,3216.02,0.00
2024-12-08 14:54:45,58,3145,16,42,1787.65,3217.00,0.00
2024-12-08 14:54:45,59,3145,16,43,1757.35,3217.02,0.00
2024-12-08 14:54:45,58,3145,16,42,1784.88,3217.02,0.00
2024-12-08 14:54:45,58,3146,16,42,1787.10,3218.00,0.00
2024-12-08 14:54:45,59,3146,16,43,1756.81,3218.02,0.00
2024-12-08 14:54:45,59,3147,16,43,1747.53,3219.00,0.00
2024-12-08 14:54:45,60,3147,16,44,1718.41,3219.02,0.00
2024-12-08 14:54:45,59,3147,16,43,1745.35,3219.02,0.00
2024-12-08 14:54:45,58,3147,15,43,1736.55,3219.95,0.00
2024-12-08 14:54:45,58,3148,15,43,1790.43,3220.00,0.00
2024-12-08 14:54:45,59,3148,16,43,1760.08,3220.02,0.00
2024-12-08 14:54:45,59,3149,16,43,1750.80,3221.00,0.00
2024-12-08 14:54:45,60,3149,17,43,1721.62,3221.02,0.00
2024-12-08 14:54:45,59,3149,17,42,1749.17,3221.02,0.00
2024-12-08 14:54:45,58,3149,16,42,1741.50,3221.93,0.00
2024-12-08 14:54:45,58,3150,16,42,1794.88,3222.00,0.00
2024-12-08 14:54:45,59,3150,16,43,1764.45,3222.02,0.00
2024-12-08 14:54:45,58,3150,15,43,1768.21,3222.03,0.00
2024-12-08 14:54:45,58,3151,15,43,1793.21,3223.00,0.00
2024-12-08 14:54:45,59,3151,15,44,1762.82,3223.02,0.00
2024-12-08 14:54:45,58,3151,15,43,1790.43,3223.02,0.00
2024-12-08 14:54:45,57,3151,14,43,1809.50,3223.28,0.00
2024-12-08 14:54:45,57,3152,14,43,1843.34,3224.00,0.00
2024-12-08 14:54:45,58,3152,15,43,1811.55,3224.02,0.00
2024-12-08 14:54:45,58,3153,15,43,1802.66,3225.00,0.00
2024-12-08 14:54:45,59,3153,16,43,1772.11,3225.02,0.00
2024-12-08 14:54:45,58,3153,16,42,1799.33,3225.02,0.00
2024-12-08 14:54:45,58,3154,16,42,1801.55,3226.00,0.00
2024-12-08 14:54:45,59,3154,17,42,1771.02,3226.02,0.00
2024-12-08 14:54:45,59,3155,17,42,1761.72,3227.00,0.00
2024-12-08 14:54:46,60,3155,17,43,1732.36,3227.02,0.00
2024-12-08 14:54:46,59,3155,17,42,1758.44,3227.02,0.00
2024-12-08 14:54:46,59,3156,17,42,1760.08,3228.00,0.00
2024-12-08 14:54:46,60,3156,18,42,1730.75,3228.02,0.00
2024-12-08 14:54:46,60,3157,18,42,1721.06,3229.00,0.00
2024-12-08 14:54:46,61,3157,19,42,1692.84,3229.02,0.00
2024-12-08 14:54:46,60,3157,19,41,1718.37,3229.02,0.00
2024-12-08 14:54:46,60,3158,19,41,1719.44,3230.00,0.00
2024-12-08 14:54:46,61,3158,20,41,1691.25,3230.02,0.00
2024-12-08 14:54:46,61,3159,20,41,1681.18,3231.00,0.00
2024-12-08 14:54:46,62,3159,21,41,1654.06,3231.02,0.00
2024-12-08 14:54:46,61,3159,21,40,1679.06,3231.02,0.00
2024-12-08 14:54:46,61,3160,21,40,1679.58,3232.00,0.00
2024-12-08 14:54:46,62,3160,22,40,1652.49,3232.02,0.00
2024-12-08 14:54:46,61,3160,21,40,1662.15,3232.21,0.00
2024-12-08 14:54:46,61,3161,21,40,1668.97,3233.00,0.00
2024-12-08 14:54:46,62,3161,22,40,1642.05,3233.02,0.00
2024-12-08 14:54:46,61,3161,22,39,1667.38,3233.02,0.00
2024-12-08 14:54:46,60,3161,21,39,1672.33,3233.72,0.00
2024-12-08 14:54:46,59,3161,20,39,1687.63,3233.90,0.00
2024-12-08 14:54:46,59,3162,20,39,1739.23,3234.00,0.00
2024-12-08 14:54:46,60,3162,21,39,1710.25,3234.02,0.00
2024-12-08 14:54:46,60,3163,21,39,1700.53,3235.00,0.00
2024-12-08 14:54:46,61,3163,22,39,1672.65,3235.02,0.00
2024-12-08 14:54:46,60,3163,22,38,1699.45,3235.02,0.00
2024-12-08 14:54:46,60,3164,22,38,1700.52,3236.00,0.00
2024-12-08 14:54:46,61,3164,22,39,1672.64,3236.02,0.00
2024-12-08 14:54:46,61,3165,22,39,1662.54,3237.00,0.00
2024-12-08 14:54:46,62,3165,23,39,1635.73,3237.02,0.00
2024-12-08 14:54:46,61,3165,23,38,1662.01,3237.02,0.00
2024-12-08 14:54:46,61,3166,23,38,1662.53,3238.00,0.00
2024-12-08 14:54:46,62,3166,23,39,1635.71,3238.02,0.00
2024-12-08 14:54:46,61,3166,23,38,1651.38,3238.02,0.00
2024-12-08 14:54:46,60,3166,22,38,1659.05,3238.38,0.00
2024-12-08 14:54:46,60,3167,22,38,1693.46,3239.00,0.00
2024-12-08 14:54:46,61,3167,22,39,1665.70,3239.02,0.00
2024-12-08 14:54:46,60,3167,22,38,1682.12,3239.02,0.00
2024-12-08 14:54:46,59,3167,21,38,1688.26,3239.41,0.00
2024-12-08 14:54:46,59,3168,21,38,1724.34,3240.00,0.00
2024-12-08 14:54:46,60,3168,22,38,1695.60,3240.02,0.00
2024-12-08 14:54:46,59,3168,21,38,1701.90,3240.27,0.00
2024-12-08 14:54:46,59,3169,21,38,1733.66,3241.00,0.00
2024-12-08 14:54:46,60,3169,21,39,1704.77,3241.02,0.00
2024-12-08 14:54:46,59,3169,21,38,1732.56,3241.02,0.00
2024-12-08 14:54:46,58,3169,20,38,1756.90,3241.19,0.00
2024-12-08 14:54:46,58,3170,20,38,1764.65,3242.00,0.00
2024-12-08 14:54:46,59,3170,20,39,1734.74,3242.02,0.00
2024-12-08 14:54:46,59,3171,20,39,1725.39,3243.00,0.00
2024-12-08 14:54:46,60,3171,20,40,1696.63,3243.02,0.00
2024-12-08 14:54:46,59,3171,20,39,1724.84,3243.02,0.00
2024-12-08 14:54:46,58,3171,19,39,1714.27,3243.97,0.00
2024-12-08 14:54:46,58,3172,19,39,1769.10,3244.00,0.00
2024-12-08 14:54:46,59,3172,19,40,1739.11,3244.02,0.00
2024-12-08 14:54:46,58,3172,19,39,1757.35,3244.02,0.00
2024-12-08 14:54:46,57,3172,18,39,1746.37,3244.65,0.00
2024-12-08 14:54:46,57,3173,18,39,1792.15,3245.00,0.00
2024-12-08 14:54:46,58,3173,19,39,1761.25,3245.02,0.00
2024-12-08 14:54:46,57,3173,19,38,1780.19,3245.02,0.00
2024-12-08 14:54:46,56,3173,18,38,1790.87,3245.68,0.00
2024-12-08 14:54:46,55,3173,17,38,1822.84,3245.69,0.00
2024-12-08 14:54:46,54,3173,16,38,1848.85,3245.80,0.00
2024-12-08 14:54:46,54,3174,16,38,1902.52,3246.00,0.00
2024-12-08 14:54:46,55,3174,16,39,1867.92,3246.02,0.00
2024-12-08 14:54:46,55,3175,16,39,1860.24,3247.00,0.00
2024-12-08 14:54:46,56,3175,16,40,1827.02,3247.02,0.00
2024-12-08 14:54:46,55,3175,16,39,1859.64,3247.02,0.00
2024-12-08 14:54:46,54,3175,15,39,1888.72,3247.19,0.00
2024-12-08 14:54:46,53,3175,14,39,1920.70,3247.23,0.00
2024-12-08 14:54:46,53,3176,14,39,1957.38,3248.00,0.00
2024-12-08 14:54:46,54,3176,15,39,1921.13,3248.02,0.00
2024-12-08 14:54:46,53,3176,15,38,1944.51,3248.02,0.00
2024-12-08 14:54:46,53,3177,15,38,1950.01,3249.00,0.00
2024-12-08 14:54:46,54,3177,16,38,1913.90,3249.02,0.00
2024-12-08 14:54:46,54,3178,16,38,1906.67,3250.00,0.00
2024-12-08 14:54:46,55,3178,17,38,1872.00,3250.02,0.00
2024-12-08 14:54:46,54,3178,17,37,1905.46,3250.02,0.00
2024-12-08 14:54:46,54,3179,17,37,1910.26,3251.00,0.00
2024-12-08 14:54:46,55,3179,18,37,1875.53,3251.02,0.00
2024-12-08 14:54:46,56,3178,18,38,1829.85,3251.07,0.00
2024-12-08 14:54:46,55,3178,17,38,1887.09,3251.69,0.00
2024-12-08 14:54:46,55,3179,17,38,1912.77,3252.00,0.00
2024-12-08 14:54:46,56,3179,18,38,1878.61,3252.02,0.00
2024-12-08 14:54:46,55,3179,18,37,1911.58,3252.02,0.00
2024-12-08 14:54:46,55,3180,18,37,1974.87,3253.00,0.00
2024-12-08 14:54:46,56,3180,18,38,1939.60,3253.02,0.00
2024-12-08 14:54:46,56,3181,18,38,1949.90,3254.00,0.00
2024-12-08 14:54:46,57,3181,19,38,1915.70,3254.02,0.00
2024-12-08 14:54:47,57,3182,19,38,1923.23,3255.00,0.00
2024-12-08 14:54:47,58,3182,19,39,1890.07,3255.02,0.00
2024-12-08 14:54:47,57,3182,18,39,1879.68,3255.65,0.00
2024-12-08 14:54:47,57,3183,18,39,1925.67,3256.00,0.00
2024-12-08 14:54:47,58,3183,18,40,1892.47,3256.02,0.00
2024-12-08 14:54:47,57,3183,17,40,1899.43,3256.32,0.00
2024-12-08 14:54:47,57,3184,17,40,1934.77,3257.00,0.00
2024-12-08 14:54:47,58,3184,18,40,1901.41,3257.02,0.00
2024-12-08 14:54:47,57,3184,18,39,1926.20,3257.02,0.00
2024-12-08 14:54:47,57,3185,18,39,1929.08,3258.00,0.00
2024-12-08 14:54:47,58,3185,18,40,1895.82,3258.02,0.00
2024-12-08 14:54:47,57,3185,18,39,1918.22,3258.02,0.00
2024-12-08 14:54:47,56,3185,17,39,1932.71,3258.09,0.00
2024-12-08 14:54:47,56,3186,17,39,1961.80,3259.00,0.00
2024-12-08 14:54:47,57,3186,18,39,1927.38,3259.02,0.00
2024-12-08 14:54:47,56,3186,18,38,1950.74,3259.02,0.00
2024-12-08 14:54:47,55,3186,17,38,1964.31,3259.09,0.00
2024-12-08 14:54:47,55,3187,17,38,1994.53,3260.00,0.00
2024-12-08 14:54:47,56,3187,18,38,1958.91,3260.02,0.00
2024-12-08 14:54:47,56,3188,18,38,1950.78,3261.00,0.00
2024-12-08 14:54:47,57,3188,18,39,1916.55,3261.02,0.00
2024-12-08 14:54:47,56,3188,18,38,1949.61,3261.02,0.00
2024-12-08 14:54:47,56,3189,18,38,1953.12,3262.00,0.00
2024-12-08 14:54:47,57,3189,18,39,1918.86,3262.02,0.00
2024-12-08 14:54:47,57,3190,18,39,1910.29,3263.00,0.00
2024-12-08 14:54:47,58,3190,18,40,1877.35,3263.02,0.00
2024-12-08 14:54:47,57,3190,18,39,1909.71,3263.02,0.00
2024-12-08 14:54:47,56,3190,17,39,1903.01,3263.96,0.00
2024-12-08 14:54:47,56,3191,17,39,1960.15,3264.00,0.00
2024-12-08 14:54:47,57,3191,18,39,1925.76,3264.02,0.00
2024-12-08 14:54:47,56,3191,18,38,1947.91,3264.02,0.00
2024-12-08 14:54:47,56,3192,18,38,1951.42,3265.00,0.00
2024-12-08 14:54:47,57,3192,18,39,1917.18,3265.02,0.00
2024-12-08 14:54:47,57,3193,18,39,1908.60,3266.00,0.00
2024-12-08 14:54:47,58,3193,19,39,1875.70,3266.02,0.00
2024-12-08 14:54:47,57,3193,19,38,1906.31,3266.02,0.00
2024-12-08 14:54:47,56,3193,18,38,1903.54,3266.91,0.00
2024-12-08 14:54:47,56,3194,18,38,1959.03,3267.00,0.00
2024-12-08 14:54:47,57,3194,19,38,1924.66,3267.02,0.00
2024-12-08 14:54:47,56,3194,18,38,1942.74,3267.16,0.00
2024-12-08 14:54:47,55,3194,17,38,1955.02,3267.44,0.00
2024-12-08 14:54:47,55,3195,17,38,1996.45,3268.00,0.00
2024-12-08 14:54:47,56,3195,18,38,1960.80,3268.02,0.00
2024-12-08 14:54:47,55,3195,18,37,1992.29,3268.02,0.00
2024-12-08 14:54:47,55,3196,18,37,1996.47,3269.00,0.00
2024-12-08 14:54:47,56,3196,19,37,1960.82,3269.02,0.00
2024-12-08 14:54:47,55,3196,18,37,1962.92,3269.67,0.00
2024-12-08 14:54:47,55,3197,18,37,1988.16,3270.00,0.00
2024-12-08 14:54:47,56,3197,18,38,1952.66,3270.02,0.00
2024-12-08 14:54:47,55,3197,18,37,1984.59,3270.02,0.00
2024-12-08 14:54:47,55,3198,18,37,1988.77,3271.00,0.00
2024-12-08 14:54:47,56,3198,18,38,1953.25,3271.02,0.00
2024-12-08 14:54:47,56,3199,18,38,1945.09,3272.00,0.00
2024-12-08 14:54:47,57,3199,18,39,1910.96,3272.02,0.00
2024-12-08 14:54:47,56,3199,18,38,1941.58,3272.02,0.00
2024-12-08 14:54:47,56,3200,18,38,1945.10,3273.00,0.00
2024-12-08 14:54:47,57,3200,19,38,1910.97,3273.02,0.00
2024-12-08 14:54:47,57,3201,19,38,1902.37,3274.00,0.00
2024-12-08 14:54:47,58,3201,20,38,1869.57,3274.02,0.00
2024-12-08 14:54:47,57,3201,20,37,1899.49,3274.02,0.00
2024-12-08 14:54:47,57,3202,20,37,1902.37,3275.00,0.00
2024-12-08 14:54:47,58,3202,20,38,1869.57,3275.02,0.00
2024-12-08 14:54:47,58,3203,20,38,1860.54,3276.00,0.00
2024-12-08 14:54:47,59,3203,21,38,1829.01,3276.02,0.00
2024-12-08 14:54:47,58,3203,21,37,1858.28,3276.02,0.00
2024-12-08 14:54:47,57,3203,20,37,1850.05,3276.97,0.00
2024-12-08 14:54:47,57,3204,20,37,1906.41,3277.00,0.00
2024-12-08 14:54:47,58,3204,21,37,1873.54,3277.02,0.00
2024-12-08 14:54:47,58,3205,21,37,1864.50,3278.00,0.00
2024-12-08 14:54:47,59,3205,22,37,1832.90,3278.02,0.00
2024-12-08 14:54:47,58,3205,22,36,1862.24,3278.02,0.00
2024-12-08 14:54:47,58,3206,22,36,1864.51,3279.00,0.00
2024-12-08 14:54:47,59,3206,23,36,1832.90,3279.02,0.00
2024-12-08 14:54:47,59,3207,23,36,1823.46,3280.00,0.00
2024-12-08 14:54:47,60,3207,24,36,1793.07,3280.02,0.00
2024-12-08 14:54:47,59,3207,24,35,1821.79,3280.02,0.00
2024-12-08 14:54:47,59,3208,24,35,1823.46,3281.00,0.00
2024-12-08 14:54:47,60,3208,24,36,1793.07,3281.02,0.00
2024-12-08 14:54:47,59,3208,23,36,1806.82,3281.19,0.00
2024-12-08 14:54:48,59,3209,23,36,1814.00,3282.00,0.00
2024-12-08 14:54:48,60,3209,24,36,1783.77,3282.02,0.00
2024-12-08 14:54:48,59,3209,24,35,1812.33,3282.02,0.00
2024-12-08 14:54:48,58,3209,23,35,1803.13,3282.64,0.00
2024-12-08 14:54:48,58,3210,23,35,1848.10,3283.00,0.00
2024-12-08 14:54:48,59,3210,24,35,1816.78,3283.02,0.00
2024-12-08 14:54:48,59,3211,24,35,1807.31,3284.00,0.00
2024-12-08 14:54:48,60,3211,24,36,1777.19,3284.02,0.00
2024-12-08 14:54:48,59,3211,24,35,1804.53,3284.02,0.00
2024-12-08 14:54:48,58,3211,23,35,1818.75,3284.29,0.00
2024-12-08 14:54:48,58,3212,23,35,1852.63,3285.00,0.00
2024-12-08 14:54:48,59,3212,23,36,1821.23,3285.02,0.00
2024-12-08 14:54:48,59,3213,23,36,1811.76,3286.00,0.00
2024-12-08 14:54:48,60,3213,24,36,1781.56,3286.02,0.00
2024-12-08 14:54:48,59,3213,24,35,1809.53,3286.02,0.00
2024-12-08 14:54:48,58,3213,23,35,1818.40,3286.69,0.00
2024-12-08 14:54:48,58,3214,23,35,1842.42,3287.00,0.00
2024-12-08 14:54:48,59,3214,23,36,1811.19,3287.02,0.00
2024-12-08 14:54:48,58,3214,22,36,1808.74,3287.69,0.00
2024-12-08 14:54:48,58,3215,22,36,1832.78,3288.00,0.00
2024-12-08 14:54:48,59,3215,23,36,1801.71,3288.02,0.00
2024-12-08 14:54:48,58,3215,23,35,1831.07,3288.02,0.00
2024-12-08 14:54:48,58,3216,23,35,1833.33,3289.00,0.00
2024-12-08 14:54:48,59,3216,23,36,1802.26,3289.02,0.00
2024-12-08 14:54:48,58,3216,22,36,1816.93,3289.17,0.00
2024-12-08 14:54:48,57,3216,21,36,1823.22,3289.81,0.00
2024-12-08 14:54:48,57,3217,21,36,1874.72,3290.00,0.00
2024-12-08 14:54:48,58,3217,22,36,1842.40,3290.02,0.00
2024-12-08 14:54:48,57,3217,22,35,1873.57,3290.02,0.00
2024-12-08 14:54:48,57,3218,22,35,1876.45,3291.00,0.00
2024-12-08 14:54:48,58,3218,23,35,1844.09,3291.02,0.00
2024-12-08 14:54:48,58,3219,23,35,1835.01,3292.00,0.00
2024-12-08 14:54:48,59,3219,23,36,1803.90,3292.02,0.00
2024-12-08 14:54:48,58,3219,23,35,1834.44,3292.02,0.00
2024-12-08 14:54:48,58,3220,23,35,1836.70,3293.00,0.00
2024-12-08 14:54:48,59,3220,24,35,1805.57,3293.02,0.00
2024-12-08 14:54:48,59,3221,24,35,1796.07,3294.00,0.00
2024-12-08 14:54:48,60,3221,25,35,1766.13,3294.02,0.00
2024-12-08 14:54:48,59,3221,25,34,1795.51,3294.02,0.00
2024-12-08 14:54:48,59,3222,25,34,1797.17,3295.00,0.00
2024-12-08 14:54:48,60,3222,25,35,1767.22,3295.02,0.00
2024-12-08 14:54:48,59,3222,24,35,1781.01,3295.15,0.00
2024-12-08 14:54:48,58,3222,23,35,1785.40,3295.81,0.00
2024-12-08 14:54:48,58,3223,23,35,1836.10,3296.00,0.00
2024-12-08 14:54:48,59,3223,24,35,1804.98,3296.02,0.00
2024-12-08 14:54:48,58,3223,24,34,1834.96,3296.02,0.00
2024-12-08 14:54:48,57,3223,23,34,1834.07,3296.84,0.00
2024-12-08 14:54:48,57,3224,23,34,1886.81,3297.00,0.00
2024-12-08 14:54:48,58,3224,24,34,1854.28,3297.02,0.00
2024-12-08 14:54:48,57,3224,23,34,1850.15,3297.74,0.00
2024-12-08 14:54:48,57,3225,23,34,1899.53,3298.00,0.00
2024-12-08 14:54:48,58,3225,24,34,1866.78,3298.02,0.00
2024-12-08 14:54:48,57,3225,24,33,1898.95,3298.02,0.00
2024-12-08 14:54:48,57,3226,24,33,1901.84,3299.00,0.00
2024-12-08 14:54:48,58,3226,24,34,1869.05,3299.02,0.00
2024-12-08 14:54:48,57,3226,24,33,1889.69,3299.02,0.00
2024-12-08 14:54:48,56,3226,23,33,1900.48,3299.09,0.00
2024-12-08 14:54:48,56,3227,23,33,1929.91,3300.00,0.00
2024-12-08 14:54:48,57,3227,24,33,1896.05,3300.02,0.00
2024-12-08 14:54:48,57,3228,24,33,1887.36,3301.00,0.00
2024-12-08 14:54:48,58,3228,24,34,1854.82,3301.02,0.00
2024-12-08 14:54:48,57,3228,24,33,1886.20,3301.02,0.00
2024-12-08 14:54:48,56,3228,23,33,1887.09,3301.52,0.00
2024-12-08 14:54:48,56,3229,23,33,1930.49,3302.00,0.00
2024-12-08 14:54:48,57,3229,24,33,1896.62,3302.02,0.00
2024-12-08 14:54:48,57,3230,24,33,1887.92,3303.00,0.00
2024-12-08 14:54:48,58,3230,24,34,1855.37,3303.02,0.00
2024-12-08 14:54:48,57,3230,24,33,1887.34,3303.02,0.00
2024-12-08 14:54:48,57,3231,24,33,1890.24,3304.00,0.00
2024-12-08 14:54:48,58,3231,24,34,1857.65,3304.02,0.00
2024-12-08 14:54:49,58,3232,24,34,1848.52,3305.00,0.00
2024-12-08 14:54:49,59,3232,24,35,1817.19,3305.02,0.00
2024-12-08 14:54:49,58,3232,24,34,1846.81,3305.02,0.00
2024-12-08 14:54:49,58,3233,24,34,1849.08,3306.00,0.00
2024-12-08 14:54:49,59,3233,24,35,1817.74,3306.02,0.00
2024-12-08 14:54:49,58,3233,23,35,1804.48,3306.85,0.00
2024-12-08 14:54:49,58,3234,23,35,1856.48,3307.00,0.00
2024-12-08 14:54:49,59,3234,24,35,1825.01,3307.02,0.00
2024-12-08 14:54:49,58,3234,24,34,1850.21,3307.03,0.00
2024-12-08 14:54:49,58,3235,24,34,1853.05,3308.00,0.00
2024-12-08 14:54:49,59,3235,24,35,1821.64,3308.02,0.00
2024-12-08 14:54:49,58,3235,23,35,1835.42,3308.19,0.00
2024-12-08 14:54:49,57,3235,22,35,1846.84,3308.44,0.00
2024-12-08 14:54:49,57,3236,22,35,1886.71,3309.00,0.00
2024-12-08 14:54:49,58,3236,22,36,1854.18,3309.02,0.00
2024-12-08 14:54:49,57,3236,22,35,1880.33,3309.04,0.00
2024-12-08 14:54:49,56,3236,21,35,1902.76,3309.27,0.00
2024-12-08 14:54:49,56,3237,21,35,1938.12,3310.00,0.00
2024-12-08 14:54:49,57,3237,21,36,1904.12,3310.02,0.00
2024-12-08 14:54:49,57,3238,21,36,1895.40,3311.00,0.00
2024-12-08 14:54:49,58,3238,22,36,1862.72,3311.02,0.00
2024-12-08 14:54:49,57,3238,22,35,1889.60,3311.04,0.00
2024-12-08 14:54:49,56,3238,21,35,1918.07,3311.18,0.00
2024-12-08 14:54:49,55,3238,20,35,1927.81,3311.47,0.00
2024-12-08 14:54:49,54,3238,19,35,1956.89,3311.67,0.00
2024-12-08 14:54:49,54,3239,19,35,2007.44,3312.00,0.00
2024-12-08 14:54:49,55,3239,20,35,1970.94,3312.02,0.00
2024-12-08 14:54:49,55,3240,20,35,1963.10,3313.00,0.00
2024-12-08 14:54:49,56,3240,21,35,1928.05,3313.02,0.00
2024-12-08 14:54:49,55,3240,21,34,1957.08,3313.04,0.00
2024-12-08 14:54:49,54,3240,20,34,1961.85,3313.82,0.00
2024-12-08 14:54:49,54,3241,20,34,2017.24,3314.00,0.00
2024-12-08 14:54:49,55,3241,20,35,1980.57,3314.02,0.00
2024-12-08 14:54:49,55,3242,20,35,1972.73,3315.00,0.00
2024-12-08 14:54:49,56,3242,21,35,1937.50,3315.02,0.00
2024-12-08 14:54:49,55,3242,21,34,1967.30,3315.04,0.00
2024-12-08 14:54:49,55,3243,21,34,1972.12,3316.00,0.00
2024-12-08 14:54:49,56,3243,21,35,1936.90,3316.02,0.00
2024-12-08 14:54:49,55,3243,20,35,1919.60,3316.95,0.00
2024-12-08 14:54:49,55,3244,20,35,1978.14,3317.00,0.00
2024-12-08 14:54:49,56,3244,20,36,1942.81,3317.02,0.00
2024-12-08 14:54:49,55,3244,20,35,1973.31,3317.04,0.00
2024-12-08 14:54:49,55,3245,20,35,1978.13,3318.00,0.00
2024-12-08 14:54:49,56,3245,21,35,1942.81,3318.02,0.00
2024-12-08 14:54:49,55,3245,20,35,1947.97,3318.05,0.00
2024-12-08 14:54:49,55,3246,20,35,1977.52,3319.00,0.00
2024-12-08 14:54:49,56,3246,20,36,1942.21,3319.02,0.00
2024-12-08 14:54:49,55,3246,20,35,1973.30,3319.04,0.00
2024-12-08 14:54:49,55,3247,20,35,1978.12,3320.00,0.00
2024-12-08 14:54:49,56,3247,21,35,1942.79,3320.02,0.00
2024-12-08 14:54:49,55,3247,20,35,1972.08,3320.02,0.00
2024-12-08 14:54:49,55,3248,20,35,1988.37,3321.00,0.00
2024-12-08 14:54:49,56,3248,21,35,1952.87,3321.02,0.00
2024-12-08 14:54:49,55,3248,21,34,1984.75,3321.02,0.00
2024-12-08 14:54:49,55,3249,21,34,1988.97,3322.00,0.00
2024-12-08 14:54:49,56,3249,22,34,1953.45,3322.02,0.00
2024-12-08 14:54:49,56,3250,22,34,1945.14,3323.00,0.00
2024-12-08 14:54:49,57,3250,23,34,1911.02,3323.02,0.00
2024-12-08 14:54:49,56,3250,23,33,1942.17,3323.02,0.00
2024-12-08 14:54:49,56,3251,23,33,1945.73,3324.00,0.00
2024-12-08 14:54:49,57,3251,24,33,1911.59,3324.02,0.00
2024-12-08 14:54:49,57,3252,24,33,1902.83,3325.00,0.00
2024-12-08 14:54:49,58,3252,24,34,1870.03,3325.02,0.00
2024-12-08 14:54:49,57,3252,24,33,1895.85,3325.07,0.00
2024-12-08 14:54:49,56,3252,23,33,1909.64,3325.36,0.00
2024-12-08 14:54:49,56,3253,23,33,1948.08,3326.00,0.00
2024-12-08 14:54:49,57,3253,23,34,1913.91,3326.02,0.00
2024-12-08 14:54:49,57,3254,23,34,1905.14,3327.00,0.00
2024-12-08 14:54:49,58,3254,24,34,1872.30,3327.02,0.00
2024-12-08 14:54:49,57,3254,24,33,1896.99,3327.09,0.00
2024-12-08 14:54:49,57,3255,24,33,1902.21,3328.00,0.00
2024-12-08 14:54:49,58,3255,25,33,1869.42,3328.02,0.00
2024-12-08 14:54:49,58,3256,25,33,1860.50,3329.00,0.00
2024-12-08 14:54:49,59,3256,25,34,1828.96,3329.02,0.00
2024-12-08 14:54:49,58,3256,25,33,1852.48,3329.09,0.00
2024-12-08 14:54:49,58,3257,25,33,1857.04,3330.00,0.00
2024-12-08 14:54:49,59,3257,25,34,1825.56,3330.02,0.00
2024-12-08 14:54:49,59,3258,25,34,1817.19,3331.00,0.00
2024-12-08 14:54:49,60,3258,26,34,1786.90,3331.02,0.00
2024-12-08 14:54:49,59,3258,26,33,1808.73,3331.09,0.00
2024-12-08 14:54:49,58,3258,25,33,1799.54,3331.97,0.00
2024-12-08 14:54:49,58,3259,25,33,1855.85,3332.00,0.00
2024-12-08 14:54:49,59,3259,26,33,1824.40,3332.02,0.00
2024-12-08 14:54:49,59,3260,26,33,1815.99,3333.00,0.00
2024-12-08 14:54:49,60,3260,26,34,1785.72,3333.02,0.00
2024-12-08 14:54:49,59,3260,26,33,1808.09,3333.09,0.00
2024-12-08 14:54:50,59,3261,26,33,1812.01,3334.00,0.00
2024-12-08 14:54:50,60,3261,26,34,1781.81,3334.02,0.00
2024-12-08 14:54:50,60,3262,26,34,1772.91,3335.00,0.00
2024-12-08 14:54:50,61,3262,27,34,1743.85,3335.02,0.00
2024-12-08 14:54:50,60,3262,27,33,1765.70,3335.08,0.00
2024-12-08 14:54:50,59,3262,26,33,1755.41,3335.97,0.00
2024-12-08 14:54:50,59,3263,26,33,1810.84,3336.00,0.00
2024-12-08 14:54:50,60,3263,27,33,1780.66,3336.02,0.00
2024-12-08 14:54:50,59,3263,26,33,1758.27,3336.64,0.00
2024-12-08 14:54:50,59,3264,26,33,1803.19,3337.00,0.00
2024-12-08 14:54:50,60,3264,26,34,1773.14,3337.02,0.00
2024-12-08 14:54:50,59,3264,26,33,1795.29,3337.10,0.00
2024-12-08 14:54:50,59,3265,26,33,1799.77,3338.00,0.00
2024-12-08 14:54:50,60,3265,26,34,1769.78,3338.02,0.00
2024-12-08 14:54:50,60,3266,26,34,1762.71,3339.00,0.00
2024-12-08 14:54:50,61,3266,27,34,1733.82,3339.02,0.00
2024-12-08 14:54:50,60,3266,27,33,1753.27,3339.10,0.00
2024-12-08 14:54:50,59,3266,26,33,1763.81,3339.64,0.00
2024-12-08 14:54:50,59,3267,26,33,1808.78,3340.00,0.00
2024-12-08 14:54:50,60,3267,27,33,1778.63,3340.02,0.00
2024-12-08 14:54:50,59,3267,26,33,1802.55,3340.02,0.00
2024-12-08 14:54:50,59,3268,26,33,1815.55,3341.00,0.00
2024-12-08 14:54:50,60,3268,27,33,1785.29,3341.02,0.00
2024-12-08 14:54:50,59,3268,27,32,1807.06,3341.09,0.00
2024-12-08 14:54:50,58,3268,26,32,1817.22,3341.71,0.00
2024-12-08 14:54:50,58,3269,26,32,1842.22,3342.00,0.00
2024-12-08 14:54:50,59,3269,26,33,1810.99,3342.02,0.00
2024-12-08 14:54:50,59,3270,26,33,1803.10,3343.00,0.00
2024-12-08 14:54:50,60,3270,26,34,1773.04,3343.02,0.00
2024-12-08 14:54:50,59,3270,26,33,1795.17,3343.09,0.00
2024-12-08 14:54:50,59,3271,26,33,1799.10,3344.00,0.00
2024-12-08 14:54:50,60,3271,26,34,1769.12,3344.02,0.00
2024-12-08 14:54:50,59,3271,25,34,1779.27,3344.09,0.00
2024-12-08 14:54:50,58,3271,24,34,1777.39,3344.71,0.00
2024-12-08 14:54:50,58,3271,24,34,1825.48,3345.00,0.00
2024-12-08 14:54:50,59,3271,24,35,1794.54,3345.02,0.00
2024-12-08 14:54:50,58,3271,24,34,1816.83,3345.09,0.00
2024-12-08 14:54:50,58,3272,24,34,1821.41,3346.00,0.00
2024-12-08 14:54:50,59,3272,25,34,1790.54,3346.02,0.00
2024-12-08 14:54:50,59,3273,25,34,1785.03,3347.00,0.00
2024-12-08 14:54:50,60,3273,25,35,1755.28,3347.02,0.00
2024-12-08 14:54:50,59,3273,25,34,1773.13,3347.12,0.00
2024-12-08 14:54:50,59,3274,25,34,1778.18,3348.00,0.00
2024-12-08 14:54:50,60,3274,25,35,1748.55,3348.02,0.00
2024-12-08 14:54:50,60,3275,25,35,1743.48,3349.00,0.00
2024-12-08 14:54:50,61,3275,25,36,1714.90,3349.02,0.00
2024-12-08 14:54:50,60,3275,25,35,1731.22,3349.12,0.00
2024-12-08 14:54:50,59,3275,24,35,1754.34,3349.15,0.00
2024-12-08 14:54:50,60,3274,24,36,1708.60,3349.68,0.00
2024-12-08 14:54:50,60,3275,24,36,1784.02,3350.00,0.00
2024-12-08 14:54:50,61,3275,24,37,1754.77,3350.02,0.00
2024-12-08 14:54:50,60,3275,23,37,1739.55,3350.53,0.00
2024-12-08 14:54:50,60,3276,23,37,1835.93,3351.00,0.00
2024-12-08 14:54:50,61,3276,23,38,1805.83,3351.02,0.00
2024-12-08 14:54:50,60,3276,23,37,1835.37,3351.02,0.00
2024-12-08 14:54:50,59,3276,22,37,1847.18,3351.09,0.00
2024-12-08 14:54:50,58,3276,22,36,1870.36,3351.09,0.00
2024-12-08 14:54:50,57,3276,21,36,1902.01,3351.12,0.00
2024-12-08 14:54:50,57,3277,21,36,1931.96,3352.00,0.00
2024-12-08 14:54:50,58,3277,21,37,1898.65,3352.02,0.00
2024-12-08 14:54:50,57,3277,20,37,1931.37,3352.02,0.00
2024-12-08 14:54:50,57,3278,20,37,1925.99,3353.00,0.00
2024-12-08 14:54:50,58,3278,20,38,1892.78,3353.02,0.00
2024-12-08 14:54:50,57,3278,20,37,1915.40,3353.07,0.00
2024-12-08 14:54:50,56,3278,19,37,1912.77,3353.52,0.00
2024-12-08 14:54:50,56,3279,19,37,1956.85,3354.00,0.00
2024-12-08 14:54:50,57,3279,20,37,1922.52,3354.02,0.00
2024-12-08 14:54:50,56,3279,19,37,1940.68,3354.05,0.00
2024-12-08 14:54:50,55,3279,18,37,1962.56,3354.09,0.00
2024-12-08 14:54:50,56,3278,19,37,1902.79,3354.88,0.00
2024-12-08 14:54:50,56,3279,19,37,1962.23,3355.00,0.00
2024-12-08 14:54:50,57,3279,19,38,1927.80,3355.02,0.00
2024-12-08 14:54:50,56,3279,19,37,1961.63,3355.02,0.00
2024-12-08 14:54:50,55,3279,19,36,1987.53,3355.04,0.00
2024-12-08 14:54:50,55,3280,19,36,2053.42,3356.00,0.00
2024-12-08 14:54:50,56,3280,19,37,2016.75,3356.02,0.00
2024-12-08 14:54:50,56,3281,19,37,2010.41,3357.00,0.00
2024-12-08 14:54:50,57,3281,20,37,1975.14,3357.02,0.00
2024-12-08 14:54:50,56,3281,20,36,2000.22,3357.04,0.00
2024-12-08 14:54:50,55,3281,19,36,1993.55,3357.95,0.00
2024-12-08 14:54:50,55,3282,19,36,2052.81,3358.00,0.00
2024-12-08 14:54:50,56,3282,19,37,2016.15,3358.02,0.00
2024-12-08 14:54:50,55,3282,18,37,2038.78,3358.07,0.00
2024-12-08 14:54:50,55,3283,18,37,2047.64,3359.00,0.00
2024-12-08 14:54:50,56,3283,19,37,2011.07,3359.02,0.00
2024-12-08 14:54:50,55,3283,19,36,2036.04,3359.05,0.00
2024-12-08 14:54:51,55,3284,19,36,2041.53,3360.00,0.00
2024-12-08 14:54:51,56,3284,20,36,2005.07,3360.02,0.00
2024-12-08 14:54:51,55,3284,19,36,1984.35,3360.96,0.00
2024-12-08 14:54:51,55,3285,19,36,2044.25,3361.00,0.00
2024-12-08 14:54:51,56,3285,20,36,2007.75,3361.02,0.00
2024-12-08 14:54:51,55,3285,20,35,2030.82,3361.07,0.00
2024-12-08 14:54:51,54,3285,19,35,2068.43,3361.07,0.00
2024-12-08 14:54:51,54,3286,19,35,2075.26,3362.00,0.00
2024-12-08 14:54:51,55,3286,19,36,2037.53,3362.02,0.00
2024-12-08 14:54:51,55,3287,19,36,2032.36,3363.00,0.00
2024-12-08 14:54:51,56,3287,20,36,1996.07,3363.02,0.00
2024-12-08 14:54:51,55,3287,20,35,2018.92,3363.07,0.00
2024-12-08 14:54:51,55,3288,20,35,2025.02,3364.00,0.00
2024-12-08 14:54:51,56,3288,21,35,1988.85,3364.02,0.00
2024-12-08 14:54:51,55,3288,20,35,2024.40,3364.02,0.00
2024-12-08 14:54:51,55,3289,20,35,2020.26,3365.00,0.00
2024-12-08 14:54:51,56,3289,20,36,1984.19,3365.02,0.00
2024-12-08 14:54:51,55,3289,20,35,2007.42,3365.05,0.00
2024-12-08 14:54:51,54,3289,19,35,2027.34,3365.57,0.00
2024-12-08 14:54:51,54,3290,19,35,2050.74,3366.00,0.00
2024-12-08 14:54:51,55,3290,19,36,2013.45,3366.02,0.00
2024-12-08 14:54:51,55,3291,19,36,2008.12,3367.00,0.00
2024-12-08 14:54:51,56,3291,20,36,1972.26,3367.02,0.00
2024-12-08 14:54:51,55,3291,20,35,1995.89,3367.05,0.00
2024-12-08 14:54:51,54,3291,19,35,2013.82,3367.63,0.00
2024-12-08 14:54:51,54,3292,19,35,2039.05,3368.00,0.00
2024-12-08 14:54:51,55,3292,20,35,2001.98,3368.02,0.00
2024-12-08 14:54:51,54,3292,19,35,2019.10,3368.04,0.00
2024-12-08 14:54:51,54,3293,19,35,2037.16,3369.00,0.00
2024-12-08 14:54:51,55,3293,20,35,2000.12,3369.02,0.00
2024-12-08 14:54:51,54,3293,20,34,2025.94,3369.04,0.00
2024-12-08 14:54:51,54,3294,20,34,2031.53,3370.00,0.00
2024-12-08 14:54:51,55,3294,21,34,1994.59,3370.02,0.00
2024-12-08 14:54:51,55,3295,21,34,1988.49,3371.00,0.00
2024-12-08 14:54:51,56,3295,21,35,1952.98,3371.02,0.00
2024-12-08 14:54:51,55,3295,21,34,1978.07,3371.04,0.00
2024-12-08 14:54:51,55,3296,21,34,1982.95,3372.00,0.00
2024-12-08 14:54:51,56,3296,22,34,1947.54,3372.02,0.00
2024-12-08 14:54:51,55,3296,21,34,1942.64,3372.40,0.00
2024-12-08 14:54:51,55,3297,21,34,1984.15,3373.00,0.00
2024-12-08 14:54:51,56,3297,21,35,1948.72,3373.02,0.00
2024-12-08 14:54:51,55,3297,21,34,1973.12,3373.05,0.00
2024-12-08 14:54:51,55,3298,21,34,1978.60,3374.00,0.00
2024-12-08 14:54:51,56,3298,21,35,1943.27,3374.02,0.00
2024-12-08 14:54:51,56,3299,21,35,1937.14,3375.00,0.00
2024-12-08 14:54:51,57,3299,21,36,1903.15,3375.02,0.00
2024-12-08 14:54:51,56,3299,21,35,1926.90,3375.05,0.00
2024-12-08 14:54:51,55,3299,20,35,1936.84,3375.66,0.00
2024-12-08 14:54:51,55,3300,20,35,1986.80,3376.00,0.00
2024-12-08 14:54:51,56,3300,20,36,1951.32,3376.02,0.00
2024-12-08 14:54:51,55,3300,19,36,1951.32,3376.35,0.00
2024-12-08 14:54:51,55,3301,19,36,1991.07,3377.00,0.00
2024-12-08 14:54:51,56,3301,20,36,1955.51,3377.02,0.00
2024-12-08 14:54:51,55,3301,20,35,1981.25,3377.05,0.00
2024-12-08 14:54:51,54,3301,19,35,1999.81,3377.28,0.00
2024-12-08 14:54:51,54,3302,19,35,2038.46,3378.00,0.00
2024-12-08 14:54:51,55,3302,19,36,2001.40,3378.02,0.00
2024-12-08 14:54:51,55,3303,19,36,1995.72,3379.00,0.00
2024-12-08 14:54:51,56,3303,19,37,1960.09,3379.02,0.00
2024-12-08 14:54:51,55,3303,19,36,1984.06,3379.07,0.00
2024-12-08 14:54:51,54,3303,18,36,1982.62,3379.89,0.00
2024-12-08 14:54:51,54,3304,18,36,2041.54,3380.00,0.00
2024-12-08 14:54:51,55,3304,18,37,2004.42,3380.02,0.00
2024-12-08 14:54:51,54,3304,17,37,2040.15,3380.06,0.00
2024-12-08 14:54:51,54,3305,17,37,2036.47,3381.00,0.00
2024-12-08 14:54:51,55,3305,17,38,1999.44,3381.02,0.00
2024-12-08 14:54:51,54,3305,17,37,2025.21,3381.06,0.00
2024-12-08 14:54:51,53,3305,16,37,2062.16,3381.09,0.00
2024-12-08 14:54:51,52,3305,15,37,2080.34,3381.29,0.00
2024-12-08 14:54:51,52,3306,15,37,2121.81,3382.00,0.00
2024-12-08 14:54:51,53,3306,15,38,2081.78,3382.02,0.00
2024-12-08 14:54:51,54,3305,15,39,2017.12,3382.46,0.00
2024-12-08 14:54:52,54,3306,15,39,2057.60,3383.00,0.00
2024-12-08 14:54:52,55,3306,15,40,2020.19,3383.02,0.00
2024-12-08 14:54:52,54,3306,15,39,2046.96,3383.06,0.00
2024-12-08 14:54:52,53,3306,14,39,2063.59,3383.66,0.00
2024-12-08 14:54:52,53,3307,14,39,2180.06,3384.00,0.00
2024-12-08 14:54:52,54,3307,15,39,2139.69,3384.02,0.00
2024-12-08 14:54:52,53,3307,14,39,2148.87,3384.57,0.00
2024-12-08 14:54:52,52,3307,13,39,2190.14,3384.58,0.00
2024-12-08 14:54:52,52,3308,13,39,2215.56,3385.00,0.00
2024-12-08 14:54:52,53,3308,13,40,2173.75,3385.02,0.00
2024-12-08 14:54:52,52,3308,13,39,2204.50,3385.06,0.00
2024-12-08 14:54:52,53,3307,13,40,2162.27,3385.11,0.00
2024-12-08 14:54:52,53,3308,13,40,2208.89,3386.00,0.00
2024-12-08 14:54:52,54,3308,13,41,2167.99,3386.02,0.00
2024-12-08 14:54:52,53,3308,12,41,2203.15,3386.02,0.00
2024-12-08 14:54:52,53,3309,12,41,2285.59,3387.00,0.00
2024-12-08 14:54:52,54,3309,12,42,2243.27,3387.02,0.00
2024-12-08 14:54:52,53,3309,12,41,2270.93,3387.08,0.00
2024-12-08 14:54:52,53,3310,12,41,2278.60,3388.00,0.00
2024-12-08 14:54:52,54,3310,12,42,2236.40,3388.02,0.00
2024-12-08 14:54:52,54,3311,12,42,2229.97,3389.00,0.00
2024-12-08 14:54:52,55,3311,13,42,2189.42,3389.02,0.00
2024-12-08 14:54:52,54,3311,13,41,2214.32,3389.09,0.00
2024-12-08 14:54:52,54,3312,13,41,2221.84,3390.00,0.00
2024-12-08 14:54:52,55,3312,14,41,2181.44,3390.02,0.00
2024-12-08 14:54:52,55,3313,14,41,2175.21,3391.00,0.00
2024-12-08 14:54:52,56,3313,15,41,2136.37,3391.02,0.00
2024-12-08 14:54:52,55,3313,15,40,2160.45,3391.09,0.00
2024-12-08 14:54:52,54,3313,14,40,2182.85,3391.61,0.00
2024-12-08 14:54:52,54,3314,14,40,2207.66,3392.00,0.00
2024-12-08 14:54:52,55,3314,14,41,2167.52,3392.02,0.00
2024-12-08 14:54:52,55,3315,14,41,2161.25,3393.00,0.00
2024-12-08 14:54:52,56,3315,15,41,2122.66,3393.02,0.00
2024-12-08 14:54:52,55,3315,15,40,2145.86,3393.09,0.00
2024-12-08 14:54:52,55,3316,15,40,2152.63,3394.00,0.00
2024-12-08 14:54:52,56,3316,16,40,2114.19,3394.02,0.00
2024-12-08 14:54:53,56,3317,16,40,2107.90,3395.00,0.00
2024-12-08 14:54:53,57,3317,16,41,2070.92,3395.02,0.00
2024-12-08 14:54:53,56,3317,16,40,2093.38,3395.09,0.00
2024-12-08 14:54:53,56,3318,16,40,2099.43,3396.00,0.00
2024-12-08 14:54:53,57,3318,17,40,2062.59,3396.02,0.00
2024-12-08 14:54:53,56,3318,16,40,2046.25,3396.91,0.00
2024-12-08 14:54:53,56,3319,16,40,2103.93,3397.00,0.00
2024-12-08 14:54:53,57,3319,17,40,2067.02,3397.02,0.00
2024-12-08 14:54:53,56,3319,17,39,2088.79,3397.09,0.00
2024-12-08 14:54:53,56,3320,17,39,2094.84,3398.00,0.00
2024-12-08 14:54:53,57,3320,18,39,2058.09,3398.02,0.00
2024-12-08 14:54:53,58,3319,19,39,2003.36,3398.28,0.00
2024-12-08 14:54:53,58,3320,19,39,2026.11,3399.00,0.00
2024-12-08 14:54:53,59,3320,19,40,1991.77,3399.02,0.00
2024-12-08 14:54:53,60,3319,19,41,1956.90,3399.10,0.00
2024-12-08 14:54:53,59,3319,19,40,2006.79,3399.10,0.00
2024-12-08 14:54:53,58,3319,18,40,2024.27,3399.60,0.00
2024-12-08 14:54:53,58,3320,18,40,2104.86,3400.00,0.00
2024-12-08 14:54:53,59,3320,19,40,2069.18,3400.02,0.00
2024-12-08 14:54:53,58,3320,18,40,2090.79,3400.03,0.00
2024-12-08 14:54:53,58,3321,18,40,2164.11,3401.00,0.00
2024-12-08 14:54:53,59,3321,19,40,2127.43,3401.02,0.00
2024-12-08 14:54:53,58,3321,18,40,2162.39,3401.07,0.00
2024-12-08 14:54:53,58,3322,18,40,2154.78,3402.00,0.00
2024-12-08 14:54:53,59,3322,18,41,2118.26,3402.02,0.00
2024-12-08 14:54:53,58,3322,18,40,2152.46,3402.07,0.00
2024-12-08 14:54:53,58,3323,18,40,2156.58,3403.00,0.00
2024-12-08 14:54:53,59,3323,19,40,2120.03,3403.02,0.00
2024-12-08 14:54:53,59,3324,19,40,2111.61,3404.00,0.00
2024-12-08 14:54:53,60,3324,20,40,2076.41,3404.02,0.00
2024-12-08 14:54:53,59,3324,20,39,2098.37,3404.07,0.00
2024-12-08 14:54:53,59,3325,20,39,2101.84,3405.00,0.00
2024-12-08 14:54:53,60,3325,21,39,2066.81,3405.02,0.00
2024-12-08 14:54:53,60,3326,21,39,2058.45,3406.00,0.00
2024-12-08 14:54:53,61,3326,22,39,2024.71,3406.02,0.00
2024-12-08 14:54:53,60,3326,22,38,2045.99,3406.07,0.00
2024-12-08 14:54:53,60,3327,22,38,2048.83,3407.00,0.00
2024-12-08 14:54:53,61,3327,23,38,2015.25,3407.02,0.00
2024-12-08 14:54:53,60,3327,22,38,2048.27,3407.02,0.00
2024-12-08 14:54:53,59,3327,21,38,2043.67,3407.71,0.00
2024-12-08 14:54:53,60,3326,21,39,2005.71,3407.85,0.00
2024-12-08 14:54:53,60,3327,21,39,2062.04,3408.00,0.00
2024-12-08 14:54:53,61,3327,22,39,2028.24,3408.02,0.00
2024-12-08 14:54:53,60,3327,22,38,2050.71,3408.05,0.00
2024-12-08 14:54:53,60,3328,22,38,2109.81,3409.00,0.00
2024-12-08 14:54:53,61,3328,23,38,2075.22,3409.02,0.00
2024-12-08 14:54:54,61,3329,23,38,2068.88,3410.00,0.00
2024-12-08 14:54:54,62,3329,24,38,2035.51,3410.02,0.00
2024-12-08 14:54:54,62,3330,24,38,2024.55,3411.00,0.00
2024-12-08 14:54:54,63,3330,25,38,1992.42,3411.02,0.00
2024-12-08 14:54:54,62,3330,25,37,2021.28,3411.05,0.00
2024-12-08 14:54:54,62,3331,25,37,2022.39,3412.00,0.00
2024-12-08 14:54:54,63,3331,26,37,1990.29,3412.02,0.00
2024-12-08 14:54:54,62,3331,25,37,1992.26,3412.31,0.00
2024-12-08 14:54:54,63,3330,26,37,1951.60,3412.60,0.00
2024-12-08 14:54:54,63,3331,26,37,2005.50,3413.00,0.00
2024-12-08 14:54:54,64,3331,26,38,1974.17,3413.02,0.00
2024-12-08 14:54:54,64,3332,26,38,2030.32,3414.00,0.00
2024-12-08 14:54:54,65,3332,26,39,1999.08,3414.02,0.00
2024-12-08 14:54:54,65,3333,26,39,1994.96,3415.00,0.00
2024-12-08 14:54:54,66,3333,26,40,1964.74,3415.02,0.00
2024-12-08 14:54:54,66,3334,26,40,1952.42,3416.00,0.00
2024-12-08 14:54:54,67,3334,27,40,1923.28,3416.02,0.00
2024-12-08 14:54:54,66,3334,27,39,1947.25,3416.02,0.00
2024-12-08 14:54:54,65,3334,26,39,1935.53,3416.95,0.00
2024-12-08 14:54:54,65,3335,26,39,1986.55,3417.00,0.00
2024-12-08 14:54:54,66,3335,26,40,1956.45,3417.02,0.00
2024-12-08 14:54:54,65,3335,26,39,1979.73,3417.03,0.00
2024-12-08 14:54:54,65,3336,26,39,1978.72,3418.00,0.00
2024-12-08 14:54:54,66,3336,27,39,1948.74,3418.02,0.00
2024-12-08 14:54:54,66,3337,27,39,1937.03,3419.00,0.00
2024-12-08 14:54:54,67,3337,28,39,1908.12,3419.02,0.00
2024-12-08 14:54:54,66,3337,28,38,1930.83,3419.03,0.00
2024-12-08 14:54:54,65,3337,27,38,1948.35,3419.23,0.00
2024-12-08 14:54:54,64,3337,26,38,1965.14,3419.64,0.00
2024-12-08 14:54:54,64,3338,26,38,2006.54,3420.00,0.00
2024-12-08 14:54:54,65,3338,26,39,1975.67,3420.02,0.00
2024-12-08 14:54:54,65,3339,26,39,1978.80,3421.00,0.00
2024-12-08 14:54:54,66,3339,26,40,1948.82,3421.02,0.00
2024-12-08 14:54:54,65,3339,25,40,1963.07,3421.15,0.00
2024-12-08 14:54:54,65,3340,25,40,1977.14,3422.00,0.00
2024-12-08 14:54:54,66,3340,25,41,1947.19,3422.02,0.00
2024-12-08 14:54:54,66,3341,25,41,1937.28,3423.00,0.00
2024-12-08 14:54:54,67,3341,26,41,1908.37,3423.02,0.00
2024-12-08 14:54:54,66,3341,26,40,1928.48,3423.03,0.00
2024-12-08 14:54:54,65,3341,25,40,1928.71,3423.60,0.00
2024-12-08 14:54:54,64,3341,24,40,1957.63,3423.64,0.00
2024-12-08 14:54:54,64,3342,24,40,1999.08,3424.00,0.00
2024-12-08 14:54:54,65,3342,24,41,1968.33,3424.02,0.00
2024-12-08 14:54:54,65,3343,24,41,1956.26,3425.00,0.00
2024-12-08 14:54:54,66,3343,25,41,1926.62,3425.02,0.00
2024-12-08 14:54:54,65,3343,25,40,1952.58,3425.03,0.00
2024-12-08 14:54:54,65,3344,25,40,1951.56,3426.00,0.00
2024-12-08 14:54:54,66,3344,26,40,1921.99,3426.02,0.00
2024-12-08 14:54:54,65,3344,25,40,1918.51,3426.39,0.00
2024-12-08 14:54:54,65,3345,25,40,1950.55,3427.00,0.00
2024-12-08 14:54:54,66,3345,25,41,1920.99,3427.02,0.00
2024-12-08 14:54:54,65,3345,25,40,1947.39,3427.03,0.00
2024-12-08 14:54:54,65,3346,25,40,1946.37,3428.00,0.00
2024-12-08 14:54:54,66,3346,26,40,1916.88,3428.02,0.00
2024-12-08 14:54:54,65,3346,25,40,1898.64,3428.59,0.00
2024-12-08 14:54:54,64,3346,24,40,1927.14,3428.63,0.00
2024-12-08 14:54:54,64,3347,24,40,1968.14,3429.00,0.00
2024-12-08 14:54:54,65,3347,25,40,1937.86,3429.02,0.00
2024-12-08 14:54:54,64,3347,25,39,1965.47,3429.03,0.00
2024-12-08 14:54:54,64,3348,25,39,1964.96,3430.00,0.00
2024-12-08 14:54:54,65,3348,26,39,1934.73,3430.02,0.00
2024-12-08 14:54:54,65,3349,26,39,1922.63,3431.00,0.00
2024-12-08 14:54:54,66,3349,27,39,1893.50,3431.02,0.00
2024-12-08 14:54:54,65,3349,27,38,1920.53,3431.03,0.00
2024-12-08 14:54:54,64,3349,26,38,1948.10,3431.09,0.00
2024-12-08 14:54:54,63,3349,25,38,1939.79,3431.97,0.00
2024-12-08 14:54:55,63,3350,25,38,1993.19,3432.00,0.00
2024-12-08 14:54:55,64,3350,26,38,1962.05,3432.02,0.00
2024-12-08 14:54:55,64,3351,26,38,1950.28,3433.00,0.00
2024-12-08 14:54:55,65,3351,26,39,1920.28,3433.02,0.00
2024-12-08 14:54:55,64,3351,26,38,1948.15,3433.03,0.00
2024-12-08 14:54:55,64,3352,26,38,1947.63,3434.00,0.00
2024-12-08 14:54:55,65,3352,26,39,1917.67,3434.02,0.00
2024-12-08 14:54:55,65,3353,26,39,1905.54,3435.00,0.00
2024-12-08 14:54:55,66,3353,26,40,1876.67,3435.02,0.00
2024-12-08 14:54:55,65,3353,26,39,1903.97,3435.03,0.00
2024-12-08 14:54:55,64,3353,25,39,1892.38,3435.97,0.00
2024-12-08 14:54:55,64,3354,25,39,1945.01,3436.00,0.00
2024-12-08 14:54:55,65,3354,26,39,1915.08,3436.02,0.00
2024-12-08 14:54:55,64,3354,25,39,1892.16,3436.67,0.00
2024-12-08 14:54:55,64,3355,25,39,1934.83,3437.00,0.00
2024-12-08 14:54:55,65,3355,26,39,1905.07,3437.02,0.00
2024-12-08 14:54:55,64,3355,26,38,1933.23,3437.03,0.00
2024-12-08 14:54:55,64,3356,26,38,1932.71,3438.00,0.00
2024-12-08 14:54:55,65,3356,26,39,1902.98,3438.02,0.00
2024-12-08 14:54:55,66,3355,26,40,1874.14,3438.05,0.00
2024-12-08 14:54:55,65,3355,25,40,1888.51,3438.74,0.00
2024-12-08 14:54:55,65,3356,25,40,1932.63,3439.00,0.00
2024-12-08 14:54:55,66,3356,26,40,1903.35,3439.02,0.00
2024-12-08 14:54:55,65,3356,26,39,1908.83,3439.03,0.00
2024-12-08 14:54:55,65,3357,26,39,1981.88,3440.00,0.00
2024-12-08 14:54:55,66,3357,26,40,1951.85,3440.02,0.00
2024-12-08 14:54:55,65,3357,25,40,1935.03,3440.60,0.00
2024-12-08 14:54:55,65,3358,25,40,1974.52,3441.00,0.00
2024-12-08 14:54:55,66,3358,25,41,1944.60,3441.02,0.00
2024-12-08 14:54:55,65,3358,25,40,1971.35,3441.03,0.00
2024-12-08 14:54:55,66,3357,25,41,1935.29,3441.24,0.00
2024-12-08 14:54:55,65,3357,24,41,1973.86,3441.80,0.00
2024-12-08 14:54:55,65,3358,24,41,2020.10,3442.00,0.00
2024-12-08 14:54:55,66,3358,24,42,1989.49,3442.02,0.00
2024-12-08 14:54:55,66,3359,24,42,2029.20,3443.00,0.00
2024-12-08 14:54:55,67,3359,24,43,1998.91,3443.02,0.00
2024-12-08 14:54:55,66,3359,24,42,2026.60,3443.03,0.00
2024-12-08 14:54:55,66,3360,24,42,2025.09,3444.00,0.00
2024-12-08 14:54:55,67,3360,25,42,1994.86,3444.02,0.00
2024-12-08 14:54:55,67,3361,25,42,1982.07,3445.00,0.00
2024-12-08 14:54:55,68,3361,26,42,1952.93,3445.02,0.00
2024-12-08 14:54:55,67,3361,26,41,1977.46,3445.05,0.00
2024-12-08 14:54:55,67,3362,26,41,1975.96,3446.00,0.00
2024-12-08 14:54:55,68,3362,26,42,1946.90,3446.02,0.00
2024-12-08 14:54:55,67,3362,25,42,1948.31,3446.36,0.00
2024-12-08 14:54:55,68,3361,25,43,1909.20,3446.69,0.00
2024-12-08 14:54:55,68,3362,25,43,1960.65,3447.00,0.00
2024-12-08 14:54:55,69,3362,26,43,1932.23,3447.01,0.00
2024-12-08 14:54:55,68,3362,26,42,1956.10,3447.04,0.00
2024-12-08 14:54:55,69,3361,27,42,1891.97,3447.54,0.00
2024-12-08 14:54:55,69,3362,27,42,1992.76,3448.00,0.00
2024-12-08 14:54:55,70,3362,27,43,1964.29,3448.01,0.00
2024-12-08 14:54:55,69,3362,26,43,1954.47,3448.49,0.00
2024-12-08 14:54:55,69,3363,26,43,2037.33,3449.00,0.00
2024-12-08 14:54:55,70,3363,27,43,2008.22,3449.01,0.00
2024-12-08 14:54:55,69,3363,27,42,2033.34,3449.04,0.00
2024-12-08 14:54:55,69,3364,27,42,2030.92,3450.00,0.00
2024-12-08 14:54:55,70,3364,28,42,2001.90,3450.01,0.00
2024-12-08 14:54:56,70,3365,28,42,1988.19,3451.00,0.00
2024-12-08 14:54:56,71,3365,28,43,1960.18,3451.01,0.00
2024-12-08 14:54:56,70,3365,28,42,1984.74,3451.04,0.00
2024-12-08 14:54:56,70,3366,28,42,1981.86,3452.00,0.00
2024-12-08 14:54:56,71,3366,29,42,1953.94,3452.01,0.00
2024-12-08 14:54:56,70,3366,28,42,1964.25,3452.23,0.00
2024-12-08 14:54:56,70,3367,28,42,1967.71,3453.00,0.00
2024-12-08 14:54:56,71,3367,28,43,1939.99,3453.01,0.00
2024-12-08 14:54:56,70,3367,28,42,1964.75,3453.04,0.00
2024-12-08 14:54:56,70,3368,28,42,1961.86,3454.00,0.00
2024-12-08 14:54:56,71,3368,28,43,1934.23,3454.01,0.00
2024-12-08 14:54:56,71,3369,28,43,1920.19,3455.00,0.00
2024-12-08 14:54:56,72,3369,28,44,1893.52,3455.01,0.00
2024-12-08 14:54:56,71,3369,28,43,1917.28,3455.04,0.00
2024-12-08 14:54:56,70,3369,27,43,1938.31,3455.23,0.00
2024-12-08 14:54:56,70,3370,27,43,1941.77,3456.00,0.00
2024-12-08 14:54:56,71,3370,28,43,1914.42,3456.01,0.00
2024-12-08 14:54:56,70,3370,27,43,1896.80,3456.87,0.00
2024-12-08 14:54:56,70,3371,27,43,1941.83,3457.00,0.00
2024-12-08 14:54:56,71,3371,28,43,1914.48,3457.01,0.00
2024-12-08 14:54:56,70,3371,28,42,1939.37,3457.04,0.00
2024-12-08 14:54:56,69,3371,27,42,1960.53,3457.23,0.00
2024-12-08 14:54:56,69,3372,27,42,1964.53,3458.00,0.00
2024-12-08 14:54:56,70,3372,27,43,1936.47,3458.01,0.00
2024-12-08 14:54:56,69,3372,26,43,1947.56,3458.20,0.00
2024-12-08 14:54:56,68,3372,25,43,1967.60,3458.31,0.00
2024-12-08 14:54:56,68,3373,25,43,1995.03,3459.00,0.00
2024-12-08 14:54:56,69,3373,26,43,1966.11,3459.01,0.00
2024-12-08 14:54:56,68,3373,26,42,1993.00,3459.04,0.00
2024-12-08 14:54:56,69,3372,27,42,1917.92,3459.84,0.00
2024-12-08 14:54:56,69,3373,27,42,1968.19,3460.00,0.00
2024-12-08 14:54:56,70,3373,28,42,1940.07,3460.01,0.00
2024-12-08 14:54:56,69,3373,27,42,1948.20,3460.25,0.00
2024-12-08 14:54:56,69,3374,27,42,2022.93,3461.00,0.00
2024-12-08 14:54:56,70,3374,28,42,1994.03,3461.01,0.00
2024-12-08 14:54:56,69,3374,28,41,2021.43,3461.04,0.00
2024-12-08 14:54:56,69,3375,28,41,2019.00,3462.00,0.00
2024-12-08 14:54:56,70,3375,28,42,1990.15,3462.01,0.00
2024-12-08 14:54:56,69,3375,28,41,2007.46,3462.04,0.00
2024-12-08 14:54:56,68,3375,27,41,2028.90,3462.22,0.00
2024-12-08 14:54:56,68,3376,27,41,2053.35,3463.00,0.00
2024-12-08 14:54:56,69,3376,27,42,2023.60,3463.01,0.00
2024-12-08 14:54:56,69,3377,27,42,2024.56,3464.00,0.00
2024-12-08 14:54:56,70,3377,27,43,1995.64,3464.01,0.00
2024-12-08 14:54:56,71,3376,27,44,1951.96,3464.21,0.00
2024-12-08 14:54:56,71,3377,27,44,1995.57,3465.00,0.00
2024-12-08 14:54:56,72,3377,28,44,1967.85,3465.01,0.00
2024-12-08 14:54:56,71,3377,27,44,1970.74,3465.25,0.00
2024-12-08 14:54:56,71,3378,27,44,2042.99,3466.00,0.00
2024-12-08 14:54:56,72,3378,27,45,2014.61,3466.01,0.00
2024-12-08 14:54:56,71,3378,27,44,2034.21,3466.04,0.00
2024-12-08 14:54:56,71,3378,27,44,2030.88,3467.00,0.00
2024-12-08 14:54:56,72,3378,27,45,2002.67,3467.01,0.00
2024-12-08 14:54:56,71,3378,27,44,2021.61,3467.04,0.00
2024-12-08 14:54:56,71,3379,27,44,2018.28,3468.00,0.00
2024-12-08 14:54:56,72,3379,28,44,1990.25,3468.01,0.00
2024-12-08 14:54:56,71,3379,28,43,2008.51,3468.04,0.00
2024-12-08 14:54:56,70,3379,27,43,2012.12,3468.43,0.00
2024-12-08 14:54:56,70,3380,27,43,2042.25,3469.00,0.00
2024-12-08 14:54:56,71,3380,28,43,2013.49,3469.01,0.00
2024-12-08 14:54:56,70,3380,27,43,2041.26,3469.03,0.00
2024-12-08 14:54:56,69,3380,27,42,2062.30,3469.03,0.00
2024-12-08 14:54:56,68,3380,26,42,2049.10,3469.69,0.00
2024-12-08 14:54:56,68,3381,26,42,2089.65,3470.00,0.00
2024-12-08 14:54:56,69,3381,27,42,2059.37,3470.01,0.00
2024-12-08 14:54:56,69,3382,27,42,2049.66,3471.00,0.00
2024-12-08 14:54:56,70,3382,28,42,2020.38,3471.01,0.00
2024-12-08 14:54:56,70,3383,28,42,2006.58,3472.00,0.00
2024-12-08 14:54:56,71,3383,29,42,1978.32,3472.01,0.00
2024-12-08 14:54:57,70,3383,29,41,2005.10,3472.04,0.00
2024-12-08 14:54:57,70,3384,29,41,2002.20,3473.00,0.00
2024-12-08 14:54:57,71,3384,29,42,1974.00,3473.01,0.00
2024-12-08 14:54:57,70,3384,29,41,1993.27,3473.04,0.00
2024-12-08 14:54:57,69,3384,28,41,1980.21,3473.68,0.00
2024-12-08 14:54:57,69,3385,28,41,2019.72,3474.00,0.00
2024-12-08 14:54:57,70,3385,28,42,1990.86,3474.01,0.00
2024-12-08 14:54:57,69,3385,28,41,2009.15,3474.04,0.00
2024-12-08 14:54:57,69,3386,28,41,2006.70,3475.00,0.00
2024-12-08 14:54:57,70,3386,28,42,1978.03,3475.01,0.00
2024-12-08 14:54:57,69,3386,28,41,1995.12,3475.04,0.00
2024-12-08 14:54:57,69,3387,28,41,1992.67,3476.00,0.00
2024-12-08 14:54:57,70,3387,29,41,1964.20,3476.01,0.00
2024-12-08 14:54:57,69,3387,28,41,1976.60,3476.17,0.00
2024-12-08 14:54:57,70,3386,29,41,1945.91,3476.27,0.00
2024-12-08 14:54:57,70,3387,29,41,1965.26,3477.00,0.00
2024-12-08 14:54:57,71,3387,30,41,1937.58,3477.01,0.00
2024-12-08 14:54:57,70,3387,30,40,1962.78,3477.04,0.00
2024-12-08 14:54:57,70,3388,30,40,2009.55,3478.00,0.00
2024-12-08 14:54:57,71,3388,31,40,1981.25,3478.01,0.00
2024-12-08 14:54:57,72,3387,31,41,1924.06,3478.63,0.00
2024-12-08 14:54:57,72,3388,31,41,1966.60,3479.00,0.00
2024-12-08 14:54:57,73,3388,32,41,1939.66,3479.01,0.00
2024-12-08 14:54:57,72,3388,31,41,1933.60,3479.68,0.00
2024-12-08 14:54:57,72,3389,31,41,2012.27,3480.00,0.00
2024-12-08 14:54:57,73,3389,32,41,1984.71,3480.01,0.00
2024-12-08 14:54:57,72,3389,32,40,2008.41,3480.03,0.00
2024-12-08 14:54:57,73,3388,32,41,1980.90,3480.06,0.00
2024-12-08 14:54:57,73,3389,32,41,2003.40,3481.00,0.00
2024-12-08 14:54:57,74,3389,32,42,1976.32,3481.01,0.00
2024-12-08 14:54:57,73,3389,31,42,1971.30,3481.67,0.00
2024-12-08 14:54:57,73,3390,31,42,2051.72,3482.00,0.00
2024-12-08 14:54:57,74,3390,31,43,2023.99,3482.01,0.00
2024-12-08 14:54:57,75,3389,32,43,1997.00,3482.04,0.00
2024-12-08 14:54:57,76,3388,33,43,1983.32,3482.54,0.00
2024-12-08 14:54:57,76,3389,33,43,2018.37,3483.00,0.00
2024-12-08 14:54:57,77,3389,33,44,1992.16,3483.01,0.00
2024-12-08 14:54:57,77,3390,33,44,2076.23,3484.00,0.00
2024-12-08 14:54:57,78,3390,33,45,2049.61,3484.01,0.00
2024-12-08 14:54:57,78,3391,33,45,2035.61,3485.00,0.00
2024-12-08 14:54:57,79,3391,33,46,2009.84,3485.01,0.00
2024-12-08 14:54:57,78,3391,33,45,2028.02,3485.03,0.00
2024-12-08 14:54:57,77,3391,32,45,2015.15,3485.90,0.00
2024-12-08 14:54:57,77,3392,32,45,2056.89,3486.00,0.00
2024-12-08 14:54:57,78,3392,33,45,2030.52,3486.01,0.00
2024-12-08 14:54:57,77,3392,33,44,2048.75,3486.03,0.00
2024-12-08 14:54:57,78,3391,34,44,2003.08,3486.62,0.00
2024-12-08 14:54:57,78,3392,34,44,2042.93,3487.00,0.00
2024-12-08 14:54:57,79,3392,34,45,2017.07,3487.01,0.00
2024-12-08 14:54:57,78,3392,34,44,2014.78,3487.04,0.00
2024-12-08 14:54:57,78,3393,34,44,2071.24,3488.00,0.00
2024-12-08 14:54:57,79,3393,35,44,2045.03,3488.01,0.00
2024-12-08 14:54:57,79,3394,35,44,2038.07,3489.00,0.00
2024-12-08 14:54:57,80,3394,35,45,2012.59,3489.01,0.00
2024-12-08 14:54:57,80,3395,35,45,1999.17,3490.00,0.00
2024-12-08 14:54:57,81,3395,36,45,1974.49,3490.01,0.00
2024-12-08 14:54:57,80,3395,36,44,1990.02,3490.05,0.00
2024-12-08 14:54:57,79,3395,35,44,2009.52,3490.20,0.00
2024-12-08 14:54:57,79,3396,35,44,2008.71,3491.00,0.00
2024-12-08 14:54:57,80,3396,36,44,1983.60,3491.01,0.00
2024-12-08 14:54:57,80,3397,36,44,1967.14,3492.00,0.00
2024-12-08 14:54:57,81,3397,37,44,1942.86,3492.01,0.00
2024-12-08 14:54:57,80,3397,37,43,1964.53,3492.05,0.00
2024-12-08 14:54:57,80,3398,37,43,1958.10,3493.00,0.00
2024-12-08 14:54:57,81,3398,37,44,1933.93,3493.01,0.00
2024-12-08 14:54:57,81,3399,37,44,1917.23,3494.00,0.00
2024-12-08 14:54:57,82,3399,37,45,1893.85,3494.01,0.00
2024-12-08 14:54:57,81,3399,37,44,1915.08,3494.05,0.00
2024-12-08 14:54:58,82,3398,37,45,1868.60,3494.74,0.00
2024-12-08 14:54:58,81,3398,36,45,1883.68,3494.98,0.00
2024-12-08 14:54:58,81,3399,36,45,1925.97,3495.00,0.00
2024-12-08 14:54:58,82,3399,36,46,1902.49,3495.01,0.00
2024-12-08 14:54:58,81,3399,35,46,1904.84,3495.06,0.00
2024-12-08 14:54:58,81,3400,35,46,1958.90,3496.00,0.00
2024-12-08 14:54:58,82,3400,36,46,1935.01,3496.01,0.00
2024-12-08 14:54:58,81,3400,36,45,1956.75,3496.05,0.00
2024-12-08 14:54:58,80,3400,35,45,1963.32,3496.14,0.00
2024-12-08 14:54:58,80,3401,35,45,1977.39,3497.00,0.00
2024-12-08 14:54:58,81,3401,36,45,1952.98,3497.01,0.00
2024-12-08 14:54:58,80,3401,35,45,1963.02,3497.18,0.00
2024-12-08 14:54:58,80,3402,35,45,1960.90,3498.00,0.00
2024-12-08 14:54:58,81,3402,35,46,1936.70,3498.01,0.00
2024-12-08 14:54:58,80,3402,35,45,1958.29,3498.05,0.00
2024-12-08 14:54:58,79,3402,34,45,1979.13,3498.17,0.00
2024-12-08 14:54:58,79,3403,34,45,1976.99,3499.00,0.00
2024-12-08 14:54:58,80,3403,34,46,1952.28,3499.01,0.00
2024-12-08 14:54:58,79,3403,33,46,1961.54,3499.19,0.00
2024-12-08 14:54:58,80,3402,34,46,1918.50,3499.75,0.00
2024-12-08 14:54:58,80,3403,34,46,1943.65,3500.00,0.00
2024-12-08 14:54:58,81,3403,35,46,1919.66,3500.01,0.00
2024-12-08 14:54:58,80,3403,35,45,1941.47,3500.05,0.00
2024-12-08 14:54:58,79,3403,34,45,1926.70,3500.96,0.00
2024-12-08 14:54:58,79,3404,34,45,2014.02,3501.00,0.00
2024-12-08 14:54:58,80,3404,35,45,1988.84,3501.01,0.00
2024-12-08 14:54:58,80,3405,35,45,1972.34,3502.00,0.00
2024-12-08 14:54:58,81,3405,35,46,1947.99,3502.01,0.00
2024-12-08 14:54:58,80,3405,34,46,1971.90,3502.01,0.00
2024-12-08 14:54:58,79,3405,34,45,1995.53,3502.04,0.00
2024-12-08 14:54:58,79,3406,34,45,1989.01,3503.00,0.00
2024-12-08 14:54:58,80,3406,35,45,1964.15,3503.01,0.00
2024-12-08 14:54:58,80,3407,35,45,1947.62,3504.00,0.00
2024-12-08 14:54:58,81,3407,35,46,1923.58,3504.01,0.00
2024-12-08 14:54:58,80,3407,35,45,1945.88,3504.05,0.00
2024-12-08 14:54:58,80,3408,35,45,1939.42,3505.00,0.00
2024-12-08 14:54:58,81,3408,36,45,1915.47,3505.01,0.00
2024-12-08 14:54:58,80,3408,35,45,1924.14,3505.20,0.00
2024-12-08 14:54:58,79,3408,34,45,1930.30,3505.20,0.00
2024-12-08 14:54:58,79,3409,34,45,1947.22,3506.00,0.00
2024-12-08 14:54:58,80,3409,35,45,1922.88,3506.01,0.00
2024-12-08 14:54:58,79,3409,34,45,1946.78,3506.01,0.00
2024-12-08 14:54:58,78,3409,34,44,1969.50,3506.05,0.00
2024-12-08 14:54:58,78,3410,34,44,1963.75,3507.00,0.00
2024-12-08 14:54:58,79,3410,35,44,1938.90,3507.01,0.00
2024-12-08 14:54:58,79,3411,35,44,1922.58,3508.00,0.00
2024-12-08 14:54:58,80,3411,36,44,1898.54,3508.01,0.00
2024-12-08 14:54:58,79,3411,35,44,1922.13,3508.01,0.00
2024-12-08 14:54:58,78,3411,35,43,1943.19,3508.04,0.00
2024-12-08 14:54:58,77,3411,34,43,1929.75,3508.95,0.00
2024-12-08 14:54:58,77,3412,34,43,1973.53,3509.00,0.00
2024-12-08 14:54:58,78,3412,35,43,1948.23,3509.01,0.00
2024-12-08 14:54:58,78,3413,35,43,1932.13,3510.00,0.00
2024-12-08 14:54:58,79,3413,36,43,1907.68,3510.01,0.00
2024-12-08 14:54:58,78,3413,36,42,1928.99,3510.04,0.00
2024-12-08 14:54:58,77,3413,35,42,1948.17,3510.20,0.00
2024-12-08 14:54:58,78,3412,36,42,1907.22,3510.68,0.00
2024-12-08 14:54:58,78,3413,36,42,1934.48,3511.00,0.00
2024-12-08 14:54:58,79,3413,36,43,1910.00,3511.01,0.00
2024-12-08 14:54:58,79,3414,36,43,1938.10,3512.00,0.00
2024-12-08 14:54:58,80,3414,37,43,1913.88,3512.01,0.00
2024-12-08 14:54:58,79,3414,37,42,1935.45,3512.04,0.00
2024-12-08 14:54:58,78,3414,36,42,1944.32,3512.49,0.00
2024-12-08 14:54:58,79,3413,36,43,1915.78,3512.62,0.00
2024-12-08 14:54:58,79,3414,36,43,1942.30,3513.00,0.00
2024-12-08 14:54:58,80,3414,36,44,1918.02,3513.01,0.00
2024-12-08 14:54:58,80,3415,36,44,1945.37,3514.00,0.00
2024-12-08 14:54:58,81,3415,37,44,1921.35,3514.01,0.00
2024-12-08 14:54:58,80,3415,37,43,1942.30,3514.04,0.00
2024-12-08 14:54:58,79,3415,36,43,1940.81,3514.48,0.00
2024-12-08 14:54:58,79,3416,36,43,1967.44,3515.00,0.00
2024-12-08 14:54:58,80,3416,36,44,1942.84,3515.01,0.00
2024-12-08 14:54:58,79,3416,35,44,1917.92,3515.66,0.00
2024-12-08 14:54:58,79,3417,35,44,1950.67,3516.00,0.00
2024-12-08 14:54:58,80,3417,35,45,1926.29,3516.01,0.00
2024-12-08 14:54:58,79,3417,35,44,1948.46,3516.04,0.00
2024-12-08 14:54:58,78,3417,34,44,1947.90,3516.47,0.00
2024-12-08 14:54:58,78,3418,34,44,1974.89,3517.00,0.00
2024-12-08 14:54:58,79,3418,35,44,1949.89,3517.01,0.00
2024-12-08 14:54:58,80,3417,36,44,1912.80,3517.15,0.00
2024-12-08 14:54:58,79,3417,35,44,1949.96,3517.22,0.00
2024-12-08 14:54:59,79,3418,35,44,1949.56,3518.00,0.00
2024-12-08 14:54:59,80,3418,36,44,1925.19,3518.01,0.00
2024-12-08 14:54:59,79,3418,36,43,1947.34,3518.04,0.00
2024-12-08 14:54:59,80,3417,37,43,1897.86,3518.79,0.00
2024-12-08 14:54:59,80,3418,37,43,1967.52,3519.00,0.00
2024-12-08 14:54:59,81,3418,38,43,1943.23,3519.01,0.00
2024-12-08 14:54:59,81,3419,38,43,1969.86,3520.00,0.00
2024-12-08 14:54:59,82,3419,39,43,1945.84,3520.01,0.00
2024-12-08 14:54:59,81,3419,39,42,1968.13,3520.04,0.00
2024-12-08 14:54:59,80,3419,38,42,1960.14,3520.84,0.00
2024-12-08 14:54:59,80,3420,38,42,1998.57,3521.00,0.00
2024-12-08 14:54:59,81,3420,39,42,1973.90,3521.01,0.00
2024-12-08 14:54:59,80,3420,39,41,1988.45,3521.04,0.00
2024-12-08 14:54:59,79,3420,38,41,2007.45,3521.20,0.00
2024-12-08 14:54:59,79,3421,38,41,2006.61,3522.00,0.00
2024-12-08 14:54:59,80,3421,38,42,1981.53,3522.01,0.00
2024-12-08 14:54:59,79,3421,37,42,2004.39,3522.03,0.00
2024-12-08 14:54:59,78,3421,37,41,2020.60,3522.03,0.00
2024-12-08 14:54:59,78,3422,37,41,2032.01,3523.00,0.00
2024-12-08 14:54:59,79,3422,37,42,2006.29,3523.01,0.00
2024-12-08 14:54:59,78,3422,37,41,2022.08,3523.03,0.00
2024-12-08 14:54:59,78,3423,37,41,2015.42,3524.00,0.00
2024-12-08 14:54:59,79,3423,38,41,1989.91,3524.01,0.00
2024-12-08 14:54:59,78,3423,37,41,1987.00,3524.13,0.00
2024-12-08 14:54:59,78,3424,37,41,2001.98,3525.00,0.00
2024-12-08 14:54:59,79,3424,37,42,1976.64,3525.01,0.00
2024-12-08 14:54:59,78,3424,37,41,2000.63,3525.03,0.00
2024-12-08 14:54:59,78,3425,37,41,1993.96,3526.00,0.00
2024-12-08 14:54:59,79,3425,38,41,1968.72,3526.01,0.00
2024-12-08 14:54:59,78,3425,38,40,1984.02,3526.03,0.00
2024-12-08 14:54:59,77,3425,37,40,2004.35,3526.18,0.00
2024-12-08 14:54:59,77,3426,37,40,2003.48,3527.00,0.00
2024-12-08 14:54:59,78,3426,37,41,1977.79,3527.01,0.00
2024-12-08 14:54:59,78,3427,37,41,1961.62,3528.00,0.00
2024-12-08 14:54:59,79,3427,37,42,1936.79,3528.01,0.00
2024-12-08 14:54:59,78,3427,37,41,1960.28,3528.04,0.00
2024-12-08 14:54:59,77,3427,36,41,1979.83,3528.20,0.00
2024-12-08 14:54:59,77,3428,36,41,1979.41,3529.00,0.00
2024-12-08 14:54:59,78,3428,36,42,1954.03,3529.01,0.00
2024-12-08 14:54:59,77,3428,35,42,1963.43,3529.20,0.00
2024-12-08 14:54:59,76,3428,34,42,1970.96,3529.71,0.00
2024-12-08 14:54:59,76,3429,34,42,1988.84,3530.00,0.00
2024-12-08 14:54:59,77,3429,35,42,1963.01,3530.01,0.00
2024-12-08 14:54:59,76,3429,35,41,1987.00,3530.04,0.00
2024-12-08 14:54:59,75,3429,34,41,1989.80,3530.71,0.00
2024-12-08 14:54:59,75,3430,34,41,2007.92,3531.00,0.00
2024-12-08 14:54:59,76,3430,35,41,1981.50,3531.01,0.00
2024-12-08 14:54:59,75,3430,34,41,1992.45,3531.19,0.00
2024-12-08 14:54:59,75,3431,34,41,1999.10,3532.00,0.00
2024-12-08 14:54:59,76,3431,35,41,1972.80,3532.01,0.00
2024-12-08 14:54:59,75,3431,34,41,1983.62,3532.19,0.00
2024-12-08 14:54:59,75,3432,34,41,1983.65,3533.00,0.00
2024-12-08 14:54:59,76,3432,35,41,1957.55,3533.01,0.00
2024-12-08 14:54:59,75,3432,35,40,1979.90,3533.04,0.00
2024-12-08 14:54:59,75,3433,35,40,1974.79,3534.00,0.00
2024-12-08 14:54:59,76,3433,35,41,1948.80,3534.01,0.00
2024-12-08 14:54:59,75,3433,35,40,1963.97,3534.04,0.00
2024-12-08 14:54:59,74,3433,34,40,1966.48,3534.72,0.00
2024-12-08 14:54:59,73,3433,33,40,1976.07,3534.88,0.00
2024-12-08 14:54:59,73,3434,33,40,2020.23,3535.00,0.00
2024-12-08 14:54:59,74,3434,33,41,1992.93,3535.01,0.00
2024-12-08 14:54:59,73,3434,33,40,2009.11,3535.04,0.00
2024-12-08 14:54:59,72,3434,32,40,1996.79,3535.96,0.00
2024-12-08 14:54:59,72,3435,32,40,2044.45,3536.00,0.00
2024-12-08 14:54:59,73,3435,33,40,2016.45,3536.01,0.00
2024-12-08 14:54:59,74,3434,34,40,1964.05,3536.49,0.00
2024-12-08 14:54:59,74,3435,34,40,1994.54,3537.00,0.00
2024-12-08 14:54:59,75,3435,34,41,1967.95,3537.01,0.00
2024-12-08 14:54:59,74,3435,34,40,1992.64,3537.04,0.00
2024-12-08 14:54:59,75,3434,34,41,1958.13,3537.29,0.00
2024-12-08 14:54:59,76,3433,35,41,1968.34,3537.54,0.00
2024-12-08 14:54:59,76,3434,35,41,2044.09,3538.00,0.00
2024-12-08 14:54:59,77,3434,36,41,2017.54,3538.01,0.00
2024-12-08 14:54:59,76,3434,35,41,2019.54,3538.33,0.00
2024-12-08 14:54:59,76,3435,35,41,2135.93,3539.00,0.00
2024-12-08 14:54:59,77,3435,36,41,2108.19,3539.01,0.00
2024-12-08 14:54:59,76,3435,36,40,2132.69,3539.05,0.00
2024-12-08 14:54:59,76,3436,36,40,2127.69,3540.00,0.00
2024-12-08 14:54:59,77,3436,37,40,2100.05,3540.01,0.00
2024-12-08 14:54:59,76,3436,36,40,2111.44,3540.20,0.00
2024-12-08 14:55:00,76,3437,36,40,2111.51,3541.00,0.00
2024-12-08 14:55:00,77,3437,36,41,2084.09,3541.01,0.00
2024-12-08 14:55:00,76,3437,36,40,2108.74,3541.05,0.00
2024-12-08 14:55:00,76,3438,36,40,2103.72,3542.00,0.00
2024-12-08 14:55:00,77,3438,36,41,2076.40,3542.01,0.00
2024-12-08 14:55:00,78,3437,37,41,2049.33,3542.05,0.00
2024-12-08 14:55:00,77,3437,36,41,2053.62,3542.48,0.00
2024-12-08 14:55:00,77,3438,36,41,2081.59,3543.00,0.00
2024-12-08 14:55:00,78,3438,37,41,2054.90,3543.01,0.00
2024-12-08 14:55:00,77,3438,37,40,2079.31,3543.05,0.00
2024-12-08 14:55:00,77,3439,37,40,2119.92,3544.00,0.00
2024-12-08 14:55:00,78,3439,38,40,2092.74,3544.01,0.00
2024-12-08 14:55:00,77,3439,38,39,2108.89,3544.05,0.00
2024-12-08 14:55:00,77,3440,38,39,2103.48,3545.00,0.00
2024-12-08 14:55:00,78,3440,38,40,2076.51,3545.01,0.00
2024-12-08 14:55:00,78,3441,38,40,2060.28,3546.00,0.00
2024-12-08 14:55:00,79,3441,39,40,2034.20,3546.01,0.00
2024-12-08 14:55:00,78,3441,39,39,2057.57,3546.06,0.00
2024-12-08 14:55:00,77,3441,38,39,2049.31,3546.90,0.00
2024-12-08 14:55:00,77,3442,38,39,2091.77,3547.00,0.00
2024-12-08 14:55:00,78,3442,39,39,2064.95,3547.01,0.00
2024-12-08 14:55:00,78,3443,39,39,2048.70,3548.00,0.00
2024-12-08 14:55:00,79,3443,39,40,2022.77,3548.01,0.00
2024-12-08 14:55:00,78,3443,39,39,2043.72,3548.08,0.00
2024-12-08 14:55:00,78,3444,39,39,2038.82,3549.00,0.00
2024-12-08 14:55:00,79,3444,39,40,2013.01,3549.01,0.00
2024-12-08 14:55:00,79,3445,39,40,1996.50,3550.00,0.00
2024-12-08 14:55:00,80,3445,40,40,1971.54,3550.01,0.00
2024-12-08 14:55:00,79,3445,40,39,1992.03,3550.08,0.00
2024-12-08 14:55:00,79,3446,40,39,1986.72,3551.00,0.00
2024-12-08 14:55:00,80,3446,41,39,1961.89,3551.01,0.00
2024-12-08 14:55:00,80,3447,41,39,1945.12,3552.00,0.00
2024-12-08 14:55:00,81,3447,42,39,1921.11,3552.01,0.00
2024-12-08 14:55:00,80,3447,42,38,1941.15,3552.08,0.00
2024-12-08 14:55:00,79,3447,41,38,1942.66,3552.72,0.00
2024-12-08 14:55:00,80,3446,42,38,1916.63,3552.79,0.00
2024-12-08 14:55:00,80,3447,42,38,1942.56,3553.00,0.00
2024-12-08 14:55:00,81,3447,42,39,1918.58,3553.01,0.00
2024-12-08 14:55:00,80,3447,41,39,1908.70,3553.71,0.00
2024-12-08 14:55:00,80,3448,41,39,1987.54,3554.00,0.00
2024-12-08 14:55:00,81,3448,42,39,1963.00,3554.01,0.00
2024-12-08 14:55:00,80,3448,42,38,1982.67,3554.09,0.00
2024-12-08 14:55:00,80,3449,42,38,1977.43,3555.00,0.00
2024-12-08 14:55:00,81,3449,42,39,1953.02,3555.01,0.00
2024-12-08 14:55:00,80,3449,41,39,1975.23,3555.08,0.00
2024-12-08 14:55:00,80,3450,41,39,1960.65,3556.00,0.00
2024-12-08 14:55:00,81,3450,41,40,1936.44,3556.01,0.00
2024-12-08 14:55:00,80,3450,41,39,1956.22,3556.08,0.00
2024-12-08 14:55:00,80,3451,41,39,1950.53,3557.00,0.00
2024-12-08 14:55:00,81,3451,41,40,1926.45,3557.01,0.00
2024-12-08 14:55:00,81,3452,41,40,1914.63,3558.00,0.00
2024-12-08 14:55:00,82,3452,42,40,1891.28,3558.01,0.00
2024-12-08 14:55:00,82,3453,42,40,1874.02,3559.00,0.00
2024-12-08 14:55:00,83,3453,42,41,1851.44,3559.01,0.00
2024-12-08 14:55:00,82,3453,42,40,1871.43,3559.07,0.00
2024-12-08 14:55:00,82,3454,42,40,1865.00,3560.00,0.00
2024-12-08 14:55:00,83,3454,42,41,1842.53,3560.01,0.00
2024-12-08 14:55:00,82,3454,41,41,1826.30,3560.81,0.00
2024-12-08 14:55:00,83,3453,42,41,1800.92,3560.92,0.00
2024-12-08 14:55:00,83,3454,42,41,1843.90,3561.00,0.00
2024-12-08 14:55:00,84,3454,42,42,1821.95,3561.01,0.00
2024-12-08 14:55:00,83,3454,42,41,1840.91,3561.07,0.00
2024-12-08 14:55:00,84,3453,43,41,1816.06,3561.18,0.00
2024-12-08 14:55:00,83,3453,42,41,1848.72,3561.29,0.00
2024-12-08 14:55:00,83,3454,42,41,1909.65,3562.00,0.00
2024-12-08 14:55:00,84,3454,43,41,1886.92,3562.01,0.00
2024-12-08 14:55:01,84,3455,43,41,1911.62,3563.00,0.00
2024-12-08 14:55:01,85,3455,44,41,1889.13,3563.01,0.00
2024-12-08 14:55:01,84,3455,44,40,1908.25,3563.10,0.00
2024-12-08 14:55:01,83,3455,43,40,1911.64,3563.46,0.00
2024-12-08 14:55:01,83,3456,43,40,1935.63,3564.00,0.00
2024-12-08 14:55:01,84,3456,43,41,1912.58,3564.01,0.00
2024-12-08 14:55:01,84,3457,43,41,1901.47,3565.00,0.00
2024-12-08 14:55:01,85,3457,43,42,1879.10,3565.01,0.00
2024-12-08 14:55:01,85,3458,43,42,1862.16,3566.00,0.00
2024-12-08 14:55:01,86,3458,43,43,1840.51,3566.01,0.00
2024-12-08 14:55:01,85,3458,43,42,1860.49,3566.05,0.00
2024-12-08 14:55:01,84,3458,43,41,1879.25,3566.08,0.00
2024-12-08 14:55:01,83,3458,42,41,1895.09,3566.28,0.00
2024-12-08 14:55:01,82,3458,41,41,1917.77,3566.28,0.00
2024-12-08 14:55:01,81,3458,40,41,1925.39,3566.73,0.00
2024-12-08 14:55:01,81,3459,40,41,1942.33,3567.00,0.00
2024-12-08 14:55:01,82,3459,41,41,1918.65,3567.01,0.00
2024-12-08 14:55:01,81,3459,40,41,1941.06,3567.04,0.00
2024-12-08 14:55:01,80,3459,40,40,1955.53,3567.08,0.00
2024-12-08 14:55:01,79,3459,39,40,1940.43,3567.96,0.00
2024-12-08 14:55:01,79,3460,39,40,1984.27,3568.00,0.00
2024-12-08 14:55:01,80,3460,40,40,1959.46,3568.01,0.00
2024-12-08 14:55:01,79,3460,40,39,1972.55,3568.09,0.00
2024-12-08 14:55:01,78,3460,39,39,1957.42,3568.72,0.00
2024-12-08 14:55:01,78,3461,39,39,1993.34,3569.00,0.00
2024-12-08 14:55:01,79,3461,39,40,1968.11,3569.01,0.00
2024-12-08 14:55:01,78,3461,38,40,1971.21,3569.27,0.00
2024-12-08 14:55:01,77,3461,37,40,1984.54,3569.61,0.00
2024-12-08 14:55:01,77,3462,37,40,2017.29,3570.00,0.00
2024-12-08 14:55:01,78,3462,37,41,1991.42,3570.01,0.00
2024-12-08 14:55:01,77,3462,36,41,1999.02,3570.10,0.00
2024-12-08 14:55:01,77,3463,36,41,2013.93,3571.00,0.00
2024-12-08 14:55:01,78,3463,36,42,1988.11,3571.01,0.00
2024-12-08 14:55:01,78,3464,36,42,1979.30,3572.00,0.00
2024-12-08 14:55:01,79,3464,36,43,1954.25,3572.01,0.00
2024-12-08 14:55:01,78,3464,35,43,1977.94,3572.04,0.00
2024-12-08 14:55:01,78,3465,35,43,1963.30,3573.00,0.00
2024-12-08 14:55:01,79,3465,35,44,1938.45,3573.01,0.00
2024-12-08 14:55:01,78,3465,35,43,1956.91,3573.08,0.00
2024-12-08 14:55:01,77,3465,34,43,1941.71,3573.87,0.00
2024-12-08 14:55:01,77,3466,34,43,1983.59,3574.00,0.00
2024-12-08 14:55:01,78,3466,35,43,1958.16,3574.01,0.00
2024-12-08 14:55:01,77,3466,34,43,1972.47,3574.08,0.00
2024-12-08 14:55:01,76,3466,34,42,1989.02,3574.08,0.00
2024-12-08 14:55:01,76,3467,34,42,2003.67,3575.00,0.00
2024-12-08 14:55:01,77,3467,34,43,1977.65,3575.01,0.00
2024-12-08 14:55:01,76,3467,34,42,1973.11,3575.08,0.00
2024-12-08 14:55:01,76,3468,34,42,1987.76,3576.00,0.00
2024-12-08 14:55:01,77,3468,35,42,1961.95,3576.01,0.00
2024-12-08 14:55:01,76,3468,34,42,1987.29,3576.01,0.00
2024-12-08 14:55:01,76,3469,34,42,1982.50,3577.00,0.00
2024-12-08 14:55:01,77,3469,34,43,1956.75,3577.01,0.00
2024-12-08 14:55:01,77,3470,34,43,1944.84,3578.00,0.00
2024-12-08 14:55:01,78,3470,34,44,1919.91,3578.01,0.00
2024-12-08 14:55:01,77,3470,34,43,1934.17,3578.07,0.00
2024-12-08 14:55:01,76,3470,33,43,1953.08,3578.25,0.00
2024-12-08 14:55:01,76,3471,33,43,1954.97,3579.00,0.00
2024-12-08 14:55:01,77,3471,33,44,1929.58,3579.01,0.00
2024-12-08 14:55:01,76,3471,33,43,1945.09,3579.07,0.00
2024-12-08 14:55:01,75,3471,32,43,1962.44,3579.07,0.00
2024-12-08 14:55:01,76,3470,32,44,1936.15,3579.11,0.00
2024-12-08 14:55:01,77,3469,32,45,1923.91,3579.81,0.00
2024-12-08 14:55:01,77,3470,32,45,1971.04,3580.00,0.00
2024-12-08 14:55:01,78,3470,32,46,1945.77,3580.01,0.00
2024-12-08 14:55:01,77,3470,32,45,1960.35,3580.07,0.00
2024-12-08 14:55:01,76,3470,31,45,1980.09,3580.24,0.00
2024-12-08 14:55:01,76,3471,31,45,2075.74,3581.00,0.00
2024-12-08 14:55:01,77,3471,32,45,2048.79,3581.01,0.00
2024-12-08 14:55:01,77,3472,32,45,2047.55,3582.00,0.00
2024-12-08 14:55:01,78,3472,33,45,2021.30,3582.01,0.00
2024-12-08 14:55:01,78,3473,33,45,2018.13,3583.00,0.00
2024-12-08 14:55:01,79,3473,33,46,1992.59,3583.01,0.00
2024-12-08 14:55:01,79,3474,33,46,1985.42,3584.00,0.00
2024-12-08 14:55:01,80,3474,33,47,1960.60,3584.01,0.00
2024-12-08 14:55:01,80,3475,33,47,1946.56,3585.00,0.00
2024-12-08 14:55:01,81,3475,33,48,1922.53,3585.01,0.00
2024-12-08 14:55:01,80,3475,33,47,1938.05,3585.06,0.00
2024-12-08 14:55:01,80,3476,33,47,1931.86,3586.00,0.00
2024-12-08 14:55:01,81,3476,33,48,1908.01,3586.01,0.00
2024-12-08 14:55:01,80,3476,32,48,1930.07,3586.05,0.00
2024-12-08 14:55:01,79,3476,31,48,1922.42,3586.47,0.00
2024-12-08 14:55:02,79,3477,31,48,1949.14,3587.00,0.00
2024-12-08 14:55:02,80,3477,31,49,1924.78,3587.01,0.00
2024-12-08 14:55:02,79,3477,30,49,1943.69,3587.03,0.00
2024-12-08 14:55:02,78,3477,30,48,1962.18,3587.05,0.00
2024-12-08 14:55:02,78,3478,30,48,1974.68,3588.00,0.00
2024-12-08 14:55:02,79,3478,31,48,1949.68,3588.01,0.00
2024-12-08 14:55:02,78,3478,31,47,1965.49,3588.05,0.00
2024-12-08 14:55:02,77,3478,30,47,1978.44,3588.08,0.00
2024-12-08 14:55:02,78,3477,31,47,1936.25,3588.58,0.00
2024-12-08 14:55:02,78,3478,31,47,1981.67,3589.00,0.00
2024-12-08 14:55:02,79,3478,32,47,1956.59,3589.01,0.00
2024-12-08 14:55:02,79,3479,32,47,1985.31,3590.00,0.00
2024-12-08 14:55:02,80,3479,33,47,1960.49,3590.01,0.00
2024-12-08 14:55:02,79,3479,33,46,1982.59,3590.06,0.00
2024-12-08 14:55:02,79,3480,33,46,1976.77,3591.00,0.00
2024-12-08 14:55:02,80,3480,34,46,1952.06,3591.01,0.00
2024-12-08 14:55:02,79,3480,33,46,1966.32,3591.03,0.00
2024-12-08 14:55:02,79,3481,33,46,1968.23,3592.00,0.00
2024-12-08 14:55:02,80,3481,34,46,1943.62,3592.01,0.00
2024-12-08 14:55:02,79,3481,34,45,1966.41,3592.05,0.00
2024-12-08 14:55:02,79,3482,34,45,1960.13,3593.00,0.00
2024-12-08 14:55:02,80,3482,35,45,1935.63,3593.01,0.00
2024-12-08 14:55:02,79,3482,35,44,1949.22,3593.05,0.00
2024-12-08 14:55:02,79,3483,35,44,1942.94,3594.00,0.00
2024-12-08 14:55:02,80,3483,35,45,1918.65,3594.01,0.00
2024-12-08 14:55:02,80,3484,35,45,1901.66,3595.00,0.00
2024-12-08 14:55:02,81,3484,36,45,1878.18,3595.01,0.00
2024-12-08 14:55:02,80,3484,36,44,1899.86,3595.05,0.00
2024-12-08 14:55:02,79,3484,35,44,1886.61,3595.92,0.00
2024-12-08 14:55:02,80,3483,35,45,1861.71,3595.98,0.00
2024-12-08 14:55:02,80,3484,35,45,1906.68,3596.00,0.00
2024-12-08 14:55:02,81,3484,35,46,1883.14,3596.01,0.00
2024-12-08 14:55:02,80,3484,35,45,1895.90,3596.05,0.00
2024-12-08 14:55:02,80,3485,35,45,1934.19,3597.00,0.00
2024-12-08 14:55:02,81,3485,35,46,1910.31,3597.01,0.00
2024-12-08 14:55:02,80,3485,34,46,1928.34,3597.04,0.00
2024-12-08 14:55:02,80,3486,34,46,1930.23,3598.00,0.00
2024-12-08 14:55:02,81,3486,35,46,1906.40,3598.01,0.00
2024-12-08 14:55:02,80,3486,35,45,1925.29,3598.09,0.00
2024-12-08 14:55:02,81,3485,35,46,1881.79,3598.67,0.00
2024-12-08 14:55:02,81,3486,35,46,1907.37,3599.00,0.00
2024-12-08 14:55:02,82,3486,36,46,1884.11,3599.01,0.00
2024-12-08 14:55:02,81,3486,35,46,1863.36,3599.86,0.00
2024-12-08 14:55:02,81,3487,35,46,1947.46,3600.00,0.00
2024-12-08 14:55:02,82,3487,36,46,1923.71,3600.01,0.00
2024-12-08 14:55:02,81,3487,35,46,1946.57,3600.03,0.00
2024-12-08 14:55:02,80,3487,35,45,1967.31,3600.08,0.00
2024-12-08 14:55:02,81,3486,36,45,1935.97,3600.30,0.00
2024-12-08 14:55:02,81,3487,36,45,1963.11,3601.00,0.00
2024-12-08 14:55:02,82,3487,37,45,1939.17,3601.01,0.00
2024-12-08 14:55:02,81,3487,36,45,1932.47,3601.17,0.00
2024-12-08 14:55:02,80,3487,35,45,1954.84,3601.23,0.00
2024-12-08 14:55:02,80,3488,35,45,2017.47,3602.00,0.00
2024-12-08 14:55:02,81,3488,36,45,1992.56,3602.01,0.00
2024-12-08 14:55:02,80,3488,35,45,2017.02,3602.01,0.00
2024-12-08 14:55:02,79,3488,35,44,2038.91,3602.06,0.00
2024-12-08 14:55:02,80,3487,35,45,1988.58,3602.79,0.00
2024-12-08 14:55:02,80,3488,35,45,2014.88,3603.00,0.00
2024-12-08 14:55:02,81,3488,35,46,1990.00,3603.01,0.00
2024-12-08 14:55:02,80,3488,34,46,2000.69,3603.11,0.00
2024-12-08 14:55:02,80,3489,34,46,2059.34,3604.00,0.00
2024-12-08 14:55:02,81,3489,35,46,2033.91,3604.01,0.00
2024-12-08 14:55:02,80,3489,35,45,2055.29,3604.08,0.00
2024-12-08 14:55:02,81,3488,36,45,2020.24,3604.37,0.00
2024-12-08 14:55:02,81,3489,36,45,2045.16,3605.00,0.00
2024-12-08 14:55:02,82,3489,37,45,2020.22,3605.01,0.00
2024-12-08 14:55:02,82,3490,37,45,2046.73,3606.00,0.00
2024-12-08 14:55:02,83,3490,37,46,2022.07,3606.01,0.00
2024-12-08 14:55:02,82,3490,37,45,2043.22,3606.07,0.00
2024-12-08 14:55:02,83,3489,38,45,2004.01,3606.51,0.00
2024-12-08 14:55:02,84,3488,39,45,1994.77,3606.54,0.00
2024-12-08 14:55:02,83,3488,38,45,2031.79,3606.58,0.00
2024-12-08 14:55:02,83,3489,38,45,2042.97,3607.00,0.00
2024-12-08 14:55:02,84,3489,39,45,2018.65,3607.01,0.00
2024-12-08 14:55:02,83,3489,38,45,2037.32,3607.02,0.00
2024-12-08 14:55:02,83,3490,38,45,2124.39,3608.00,0.00
2024-12-08 14:55:02,84,3490,39,45,2099.10,3608.01,0.00
2024-12-08 14:55:02,83,3490,39,44,2121.79,3608.06,0.00
2024-12-08 14:55:02,82,3490,38,44,2127.95,3608.61,0.00
2024-12-08 14:55:02,82,3491,38,44,2140.58,3609.00,0.00
2024-12-08 14:55:02,83,3491,38,45,2114.79,3609.01,0.00
2024-12-08 14:55:02,84,3490,39,45,2062.35,3609.56,0.00
2024-12-08 14:55:02,84,3491,39,45,2085.46,3610.00,0.00
2024-12-08 14:55:02,85,3491,39,46,2060.93,3610.01,0.00
2024-12-08 14:55:02,84,3491,39,45,2081.60,3610.06,0.00
2024-12-08 14:55:03,84,3492,39,45,2116.99,3611.00,0.00
2024-12-08 14:55:03,85,3492,40,45,2092.08,3611.01,0.00
2024-12-08 14:55:03,84,3492,39,45,2101.99,3611.19,0.00
2024-12-08 14:55:03,83,3492,38,45,2099.01,3611.84,0.00
2024-12-08 14:55:03,83,3493,38,45,2137.00,3612.00,0.00
2024-12-08 14:55:03,84,3493,38,46,2111.56,3612.01,0.00
2024-12-08 14:55:03,83,3493,38,45,2133.52,3612.06,0.00
2024-12-08 14:55:03,82,3493,37,45,2155.17,3612.18,0.00
2024-12-08 14:55:03,83,3492,37,46,2121.48,3612.42,0.00
2024-12-08 14:55:03,83,3493,37,46,2145.42,3613.00,0.00
2024-12-08 14:55:03,84,3493,38,46,2119.88,3613.01,0.00
2024-12-08 14:55:03,85,3492,39,46,2070.07,3613.49,0.00
2024-12-08 14:55:03,85,3493,39,46,2135.06,3614.00,0.00
2024-12-08 14:55:03,86,3493,40,46,2110.24,3614.01,0.00
2024-12-08 14:55:03,85,3493,39,46,2132.96,3614.06,0.00
2024-12-08 14:55:03,84,3493,39,45,2156.63,3614.06,0.00
2024-12-08 14:55:03,84,3494,39,45,2192.08,3615.00,0.00
2024-12-08 14:55:03,85,3494,39,46,2166.29,3615.01,0.00
2024-12-08 14:55:03,85,3495,39,46,2148.17,3616.00,0.00
2024-12-08 14:55:03,86,3495,40,46,2123.20,3616.01,0.00
2024-12-08 14:55:03,85,3495,40,45,2145.62,3616.06,0.00
2024-12-08 14:55:03,84,3495,39,45,2161.78,3616.26,0.00
2024-12-08 14:55:03,83,3495,38,45,2174.13,3616.65,0.00
2024-12-08 14:55:03,83,3496,38,45,2205.34,3617.00,0.00
2024-12-08 14:55:03,84,3496,38,46,2179.08,3617.01,0.00
2024-12-08 14:55:03,83,3496,37,46,2204.90,3617.01,0.00
2024-12-08 14:55:03,82,3496,36,46,2200.52,3617.17,0.00
2024-12-08 14:55:03,82,3497,36,46,2215.20,3618.00,0.00
2024-12-08 14:55:03,83,3497,37,46,2188.51,3618.01,0.00
2024-12-08 14:55:03,82,3497,37,45,2211.68,3618.06,0.00
2024-12-08 14:55:03,83,3496,37,46,2165.29,3618.64,0.00
2024-12-08 14:55:03,83,3497,37,46,2188.25,3619.00,0.00
2024-12-08 14:55:03,84,3497,37,47,2162.20,3619.01,0.00
2024-12-08 14:55:03,83,3497,36,47,2183.89,3619.04,0.00
2024-12-08 14:55:03,82,3497,35,47,2196.45,3619.18,0.00
2024-12-08 14:55:03,82,3498,35,47,2255.72,3620.00,0.00
2024-12-08 14:55:03,83,3498,35,48,2228.54,3620.01,0.00
2024-12-08 14:55:03,82,3498,34,48,2255.27,3620.01,0.00
2024-12-08 14:55:03,81,3498,34,47,2280.89,3620.04,0.00
2024-12-08 14:55:03,82,3497,34,48,2233.95,3620.60,0.00
2024-12-08 14:55:03,82,3498,34,48,2246.62,3621.00,0.00
2024-12-08 14:55:03,83,3498,34,49,2219.56,3621.01,0.00
2024-12-08 14:55:03,82,3498,33,49,2246.18,3621.01,0.00
2024-12-08 14:55:03,81,3498,32,49,2265.42,3621.01,0.00
2024-12-08 14:55:03,81,3499,32,49,2310.76,3622.00,0.00
2024-12-08 14:55:03,82,3499,33,49,2282.58,3622.01,0.00
2024-12-08 14:55:03,81,3499,33,48,2308.54,3622.03,0.00
2024-12-08 14:55:03,81,3500,33,48,2300.67,3623.00,0.00
2024-12-08 14:55:03,82,3500,34,48,2272.61,3623.01,0.00
2024-12-08 14:55:03,81,3500,33,48,2276.97,3623.05,0.00
2024-12-08 14:55:03,81,3501,33,48,2287.88,3624.00,0.00
2024-12-08 14:55:03,82,3501,34,48,2259.98,3624.01,0.00
2024-12-08 14:55:03,81,3501,34,47,2285.20,3624.03,0.00
2024-12-08 14:55:03,81,3502,34,47,2277.32,3625.00,0.00
2024-12-08 14:55:03,82,3502,35,47,2249.55,3625.01,0.00
2024-12-08 14:55:03,81,3502,34,47,2230.22,3625.62,0.00
2024-12-08 14:55:03,81,3503,34,47,2261.39,3626.00,0.00
2024-12-08 14:55:03,82,3503,34,48,2233.81,3626.01,0.00
2024-12-08 14:55:03,81,3503,34,47,2259.16,3626.03,0.00
2024-12-08 14:55:03,81,3504,34,47,2251.26,3627.00,0.00
2024-12-08 14:55:03,82,3504,34,48,2223.81,3627.01,0.00
2024-12-08 14:55:03,82,3505,34,48,2206.28,3628.00,0.00
2024-12-08 14:55:03,83,3505,35,48,2179.70,3628.01,0.00
2024-12-08 14:55:03,82,3505,35,47,2202.75,3628.04,0.00
2024-12-08 14:55:03,81,3505,34,47,2224.63,3628.17,0.00
2024-12-08 14:55:03,81,3506,34,47,2222.04,3629.00,0.00
2024-12-08 14:55:03,82,3506,34,48,2194.94,3629.01,0.00
2024-12-08 14:55:03,81,3506,33,48,2190.29,3629.16,0.00
2024-12-08 14:55:03,81,3507,33,48,2205.17,3630.00,0.00
2024-12-08 14:55:03,82,3507,34,48,2178.28,3630.01,0.00
2024-12-08 14:55:03,81,3507,34,47,2201.60,3630.04,0.00
2024-12-08 14:55:03,82,3506,35,47,2159.91,3630.48,0.00
2024-12-08 14:55:03,81,3506,34,47,2170.98,3630.59,0.00
2024-12-08 14:55:03,81,3507,34,47,2201.30,3631.00,0.00
2024-12-08 14:55:03,82,3507,35,47,2174.45,3631.01,0.00
2024-12-08 14:55:03,81,3507,34,47,2167.16,3631.70,0.00
2024-12-08 14:55:03,81,3508,34,47,2246.30,3632.00,0.00
2024-12-08 14:55:03,82,3508,35,47,2218.90,3632.01,0.00
2024-12-08 14:55:03,83,3507,35,48,2176.93,3632.22,0.00
2024-12-08 14:55:03,83,3508,35,48,2190.17,3633.00,0.00
2024-12-08 14:55:03,84,3508,36,48,2164.10,3633.01,0.00
2024-12-08 14:55:03,83,3508,36,47,2182.30,3633.04,0.00
2024-12-08 14:55:03,83,3509,36,47,2217.92,3634.00,0.00
2024-12-08 14:55:03,84,3509,37,47,2191.51,3634.01,0.00
2024-12-08 14:55:03,83,3509,36,47,2183.27,3634.72,0.00
2024-12-08 14:55:03,83,3510,36,47,2199.70,3635.00,0.00
2024-12-08 14:55:03,84,3510,36,48,2173.51,3635.01,0.00
2024-12-08 14:55:03,83,3510,36,47,2195.34,3635.06,0.00
2024-12-08 14:55:03,83,3511,36,47,2188.03,3636.00,0.00
2024-12-08 14:55:04,84,3511,36,48,2161.99,3636.01,0.00
2024-12-08 14:55:04,84,3512,36,48,2143.96,3637.00,0.00
2024-12-08 14:55:04,85,3512,37,48,2118.74,3637.01,0.00
2024-12-08 14:55:04,84,3512,37,47,2140.08,3637.06,0.00
2024-12-08 14:55:04,83,3512,36,47,2129.56,3637.90,0.00
2024-12-08 14:55:04,83,3513,36,47,2169.95,3638.00,0.00
2024-12-08 14:55:04,84,3513,36,48,2144.12,3638.01,0.00
2024-12-08 14:55:04,85,3512,37,48,2118.47,3638.05,0.00
2024-12-08 14:55:04,85,3513,37,48,2141.47,3639.00,0.00
2024-12-08 14:55:04,86,3513,37,49,2116.57,3639.01,0.00
2024-12-08 14:55:04,85,3513,37,48,2136.79,3639.07,0.00
2024-12-08 14:55:04,84,3513,36,48,2121.85,3639.71,0.00
2024-12-08 14:55:04,84,3514,36,48,2198.32,3640.00,0.00
2024-12-08 14:55:04,85,3514,37,48,2172.46,3640.01,0.00
2024-12-08 14:55:04,85,3515,37,48,2154.21,3641.00,0.00
2024-12-08 14:55:04,86,3515,37,49,2129.16,3641.01,0.00
2024-12-08 14:55:04,85,3515,37,48,2149.96,3641.07,0.00
2024-12-08 14:55:04,86,3514,37,49,2105.32,3641.64,0.00
2024-12-08 14:55:04,86,3515,37,49,2129.75,3642.00,0.00
2024-12-08 14:55:04,87,3515,37,50,2105.27,3642.01,0.00
2024-12-08 14:55:04,87,3516,37,50,2128.46,3643.00,0.00
2024-12-08 14:55:04,88,3516,38,50,2104.27,3643.01,0.00
2024-12-08 14:55:04,87,3516,38,49,2124.72,3643.07,0.00
2024-12-08 14:55:04,86,3516,37,49,2115.14,3643.88,0.00
2024-12-08 14:55:04,86,3517,37,49,2153.37,3644.00,0.00
2024-12-08 14:55:04,87,3517,37,50,2128.62,3644.01,0.00
2024-12-08 14:55:04,87,3518,37,50,2120.67,3645.00,0.00
2024-12-08 14:55:04,88,3518,38,50,2096.57,3645.01,0.00
2024-12-08 14:55:04,88,3519,38,50,2083.04,3646.00,0.00
2024-12-08 14:55:04,89,3519,38,51,2059.64,3646.01,0.00
2024-12-08 14:55:04,89,3520,38,51,2040.53,3647.00,0.00
2024-12-08 14:55:04,90,3520,39,51,2017.86,3647.01,0.00
2024-12-08 14:55:04,89,3520,39,50,2036.05,3647.07,0.00
2024-12-08 14:55:04,88,3520,38,50,2031.96,3647.80,0.00
2024-12-08 14:55:04,88,3521,38,50,2066.12,3648.00,0.00
2024-12-08 14:55:04,89,3521,39,50,2042.90,3648.01,0.00
2024-12-08 14:55:04,89,3522,39,50,2032.78,3649.00,0.00
2024-12-08 14:55:04,90,3522,40,50,2010.19,3649.01,0.00
2024-12-08 14:55:04,89,3522,39,50,2015.26,3649.27,0.00
2024-12-08 14:55:04,89,3523,39,50,2016.81,3650.00,0.00
2024-12-08 14:55:04,90,3523,40,50,1994.40,3650.01,0.00
2024-12-08 14:55:04,89,3523,40,49,2007.82,3650.07,0.00
2024-12-08 14:55:04,88,3523,39,49,2023.24,3650.26,0.00
2024-12-08 14:55:04,88,3524,39,49,2021.62,3651.00,0.00
2024-12-08 14:55:04,89,3524,40,49,1998.90,3651.01,0.00
2024-12-08 14:55:04,89,3525,40,49,1988.32,3652.00,0.00
2024-12-08 14:55:04,90,3525,40,50,1966.22,3652.01,0.00
2024-12-08 14:55:04,89,3525,39,50,1971.17,3652.26,0.00
2024-12-08 14:55:04,89,3526,39,50,1971.85,3653.00,0.00
2024-12-08 14:55:04,90,3526,39,51,1949.94,3653.01,0.00
2024-12-08 14:55:04,89,3526,39,50,1963.67,3653.08,0.00
2024-12-08 14:55:04,88,3526,38,50,1979.00,3653.26,0.00
2024-12-08 14:55:04,87,3526,37,50,1994.92,3653.44,0.00
2024-12-08 14:55:04,86,3526,36,50,2007.64,3653.73,0.00
2024-12-08 14:55:04,86,3527,36,50,2040.57,3654.00,0.00
2024-12-08 14:55:04,87,3527,36,51,2017.11,3654.01,0.00
2024-12-08 14:55:04,88,3526,36,52,1992.55,3654.08,0.00
2024-12-08 14:55:04,88,3527,36,52,2006.78,3655.00,0.00
2024-12-08 14:55:04,89,3527,36,53,1984.23,3655.01,0.00
2024-12-08 14:55:04,88,3527,36,52,2003.09,3655.10,0.00
2024-12-08 14:55:04,87,3527,35,52,2014.86,3655.35,0.00
2024-12-08 14:55:04,87,3528,35,52,2075.37,3656.00,0.00
2024-12-08 14:55:04,88,3528,35,53,2051.78,3656.01,0.00
2024-12-08 14:55:04,87,3528,34,53,2045.28,3656.45,0.00
2024-12-08 14:55:04,87,3529,34,53,2067.53,3657.00,0.00
2024-12-08 14:55:04,88,3529,34,54,2044.03,3657.01,0.00
2024-12-08 14:55:04,87,3529,33,54,2012.13,3657.89,0.00
2024-12-08 14:55:04,87,3530,33,54,2050.07,3658.00,0.00
2024-12-08 14:55:04,88,3530,33,55,2026.77,3658.01,0.00
2024-12-08 14:55:04,87,3530,33,54,2041.29,3658.12,0.00
2024-12-08 14:55:04,88,3529,33,55,2013.14,3658.27,0.00
2024-12-08 14:55:04,88,3530,33,55,2023.17,3659.00,0.00
2024-12-08 14:55:04,89,3530,33,56,2000.44,3659.01,0.00
2024-12-08 14:55:04,88,3530,33,55,2021.53,3659.05,0.00
2024-12-08 14:55:04,87,3530,33,54,2033.86,3659.10,0.00
2024-12-08 14:55:04,88,3529,33,55,1979.70,3659.52,0.00
2024-12-08 14:55:04,88,3530,33,55,2062.40,3660.00,0.00
2024-12-08 14:55:04,89,3530,33,56,2039.23,3660.01,0.00
2024-12-08 14:55:04,88,3530,33,55,2050.80,3660.10,0.00
2024-12-08 14:55:04,87,3530,32,55,2063.86,3660.13,0.00
2024-12-08 14:55:04,86,3530,31,55,2082.81,3660.27,0.00
2024-12-08 14:55:04,85,3530,30,55,2106.88,3660.27,0.00
2024-12-08 14:55:04,85,3531,30,55,2166.79,3661.00,0.00
2024-12-08 14:55:04,86,3531,30,56,2141.59,3661.01,0.00
2024-12-08 14:55:04,85,3531,30,55,2155.21,3661.11,0.00
2024-12-08 14:55:04,86,3530,31,55,2090.02,3661.77,0.00
2024-12-08 14:55:04,86,3531,31,55,2131.96,3662.00,0.00
2024-12-08 14:55:04,87,3531,32,55,2107.45,3662.01,0.00
2024-12-08 14:55:04,86,3531,32,54,2103.47,3662.11,0.00
2024-12-08 14:55:04,85,3531,31,54,2107.04,3662.68,0.00
2024-12-08 14:55:04,86,3530,32,54,2077.54,3662.84,0.00
2024-12-08 14:55:05,86,3531,32,54,2161.17,3663.00,0.00
2024-12-08 14:55:05,87,3531,32,55,2136.33,3663.01,0.00
2024-12-08 14:55:05,86,3531,32,54,2131.81,3663.11,0.00
2024-12-08 14:55:05,86,3532,32,54,2184.77,3664.00,0.00
2024-12-08 14:55:05,87,3532,32,55,2159.65,3664.01,0.00
2024-12-08 14:55:05,86,3532,32,54,2172.44,3664.11,0.00
2024-12-08 14:55:05,87,3531,33,54,2142.47,3664.26,0.00
2024-12-08 14:55:05,87,3532,33,54,2166.14,3665.00,0.00
2024-12-08 14:55:05,88,3532,34,54,2141.53,3665.01,0.00
2024-12-08 14:55:05,88,3533,34,54,2166.72,3666.00,0.00
2024-12-08 14:55:05,89,3533,34,55,2142.37,3666.01,0.00
2024-12-08 14:55:05,90,3532,34,56,2117.76,3666.06,0.00
2024-12-08 14:55:05,89,3532,34,55,2157.24,3666.12,0.00
2024-12-08 14:55:05,88,3532,33,55,2177.23,3666.25,0.00
2024-12-08 14:55:05,89,3531,34,55,2130.90,3666.88,0.00
2024-12-08 14:55:05,88,3531,33,55,2146.40,3666.94,0.00
2024-12-08 14:55:05,88,3532,33,55,2186.03,3667.00,0.00
2024-12-08 14:55:05,89,3532,33,56,2161.47,3667.01,0.00
2024-12-08 14:55:05,88,3532,33,55,2173.57,3667.11,0.00
2024-12-08 14:55:05,87,3532,32,55,2168.43,3667.59,0.00
2024-12-08 14:55:05,87,3533,32,55,2280.06,3668.00,0.00
2024-12-08 14:55:05,88,3533,33,55,2254.15,3668.01,0.00
2024-12-08 14:55:05,87,3533,32,55,2262.87,3668.25,0.00
2024-12-08 14:55:05,86,3533,31,55,2288.76,3668.26,0.00
2024-12-08 14:55:05,86,3534,31,55,2287.58,3669.00,0.00
2024-12-08 14:55:05,87,3534,31,56,2261.28,3669.01,0.00
2024-12-08 14:55:05,86,3534,31,55,2280.79,3669.13,0.00
2024-12-08 14:55:05,87,3533,32,55,2252.49,3669.21,0.00
2024-12-08 14:55:05,87,3534,32,55,2277.09,3670.00,0.00
2024-12-08 14:55:05,88,3534,33,55,2251.21,3670.01,0.00
2024-12-08 14:55:05,88,3535,33,55,2286.39,3671.00,0.00
2024-12-08 14:55:05,89,3535,34,55,2260.70,3671.01,0.00
2024-12-08 14:55:05,88,3535,34,54,2284.32,3671.06,0.00
2024-12-08 14:55:05,88,3536,34,54,2276.89,3672.00,0.00
2024-12-08 14:55:05,89,3536,34,55,2251.30,3672.01,0.00
2024-12-08 14:55:05,90,3535,35,55,2201.19,3672.50,0.00
2024-12-08 14:55:05,90,3536,35,55,2227.49,3673.00,0.00
2024-12-08 14:55:05,91,3536,35,56,2203.02,3673.01,0.00
2024-12-08 14:55:05,91,3537,35,56,2223.80,3674.00,0.00
2024-12-08 14:55:05,92,3537,35,57,2199.63,3674.01,0.00
2024-12-08 14:55:05,91,3537,34,57,2221.41,3674.07,0.00
2024-12-08 14:55:05,90,3537,34,56,2242.83,3674.10,0.00
2024-12-08 14:55:05,89,3537,33,56,2262.73,3674.25,0.00
2024-12-08 14:55:05,88,3537,32,56,2258.78,3674.96,0.00
2024-12-08 14:55:05,88,3538,32,56,2298.90,3675.00,0.00
2024-12-08 14:55:05,89,3538,32,57,2273.07,3675.01,0.00
2024-12-08 14:55:05,89,3539,32,57,2253.86,3676.00,0.00
2024-12-08 14:55:05,90,3539,32,58,2228.82,3676.01,0.00
2024-12-08 14:55:05,89,3539,32,57,2250.18,3676.10,0.00
2024-12-08 14:55:05,88,3539,31,57,2247.56,3676.56,0.00
2024-12-08 14:55:05,88,3540,31,57,2273.41,3677.00,0.00
2024-12-08 14:55:05,89,3540,32,57,2247.86,3677.01,0.00
2024-12-08 14:55:05,88,3540,32,56,2261.32,3677.10,0.00
2024-12-08 14:55:05,88,3541,32,56,2253.96,3678.00,0.00
2024-12-08 14:55:05,89,3541,33,56,2228.64,3678.01,0.00
2024-12-08 14:55:05,90,3540,34,56,2158.48,3678.79,0.00
2024-12-08 14:55:05,90,3541,34,56,2197.91,3679.00,0.00
2024-12-08 14:55:05,91,3541,35,56,2173.76,3679.01,0.00
2024-12-08 14:55:05,91,3542,35,56,2206.74,3680.00,0.00
2024-12-08 14:55:05,92,3542,35,57,2182.75,3680.01,0.00
2024-12-08 14:55:05,92,3543,35,57,2172.65,3681.00,0.00
2024-12-08 14:55:05,93,3543,36,57,2149.29,3681.01,0.00
2024-12-08 14:55:05,94,3542,36,58,2083.91,3681.99,0.00
2024-12-08 14:55:05,94,3543,36,58,2129.24,3682.00,0.00
2024-12-08 14:55:05,95,3543,37,58,2106.83,3682.01,0.00
2024-12-08 14:55:05,94,3543,36,58,2110.15,3682.31,0.00
2024-12-08 14:55:05,94,3544,36,58,2147.84,3683.00,0.00
2024-12-08 14:55:05,95,3544,36,59,2125.24,3683.01,0.00
2024-12-08 14:55:05,94,3544,36,58,2145.50,3683.03,0.00
2024-12-08 14:55:05,94,3545,36,58,2133.93,3684.00,0.00
2024-12-08 14:55:05,95,3545,37,58,2111.46,3684.01,0.00
2024-12-08 14:55:05,94,3545,36,58,2115.60,3684.30,0.00
2024-12-08 14:55:05,95,3544,37,58,2073.89,3684.85,0.00
2024-12-08 14:55:05,95,3545,37,58,2096.13,3685.00,0.00
2024-12-08 14:55:05,96,3545,37,59,2074.30,3685.01,0.00
2024-12-08 14:55:05,95,3545,37,58,2091.87,3685.04,0.00
2024-12-08 14:55:05,94,3545,37,57,2113.35,3685.05,0.00
2024-12-08 14:55:06,94,3546,37,57,2141.75,3686.00,0.00
2024-12-08 14:55:06,95,3546,38,57,2119.21,3686.01,0.00
2024-12-08 14:55:06,94,3546,37,57,2140.16,3686.05,0.00
2024-12-08 14:55:06,93,3546,36,57,2146.99,3686.28,0.00
2024-12-08 14:55:06,94,3545,36,58,2116.04,3686.52,0.00
2024-12-08 14:55:06,94,3546,36,58,2152.49,3687.00,0.00
2024-12-08 14:55:06,95,3546,36,59,2129.83,3687.01,0.00
2024-12-08 14:55:06,95,3547,36,59,2157.30,3688.00,0.00
2024-12-08 14:55:06,96,3547,37,59,2134.83,3688.01,0.00
2024-12-08 14:55:06,97,3546,37,60,2102.19,3688.11,0.00
2024-12-08 14:55:06,97,3547,37,60,2104.63,3689.00,0.00
2024-12-08 14:55:06,98,3547,38,60,2083.15,3689.01,0.00
2024-12-08 14:55:06,97,3547,38,59,2094.37,3689.07,0.00
2024-12-08 14:55:06,97,3548,38,59,2121.56,3690.00,0.00
2024-12-08 14:55:06,98,3548,39,59,2099.91,3690.01,0.00
2024-12-08 14:55:06,97,3548,39,58,2113.96,3690.07,0.00
2024-12-08 14:55:06,96,3548,38,58,2121.10,3690.37,0.00
2024-12-08 14:55:06,96,3549,38,58,2136.55,3691.00,0.00
2024-12-08 14:55:06,97,3549,38,59,2114.52,3691.01,0.00
2024-12-08 14:55:06,96,3549,38,58,2127.72,3691.08,0.00
2024-12-08 14:55:06,97,3548,38,59,2082.16,3691.75,0.00
2024-12-08 14:55:06,97,3549,38,59,2098.35,3692.00,0.00
2024-12-08 14:55:06,98,3549,38,60,2076.93,3692.01,0.00
2024-12-08 14:55:06,99,3548,39,60,2054.10,3692.08,0.00
2024-12-08 14:55:06,98,3548,39,59,2102.58,3692.10,0.00
2024-12-08 14:55:06,97,3548,38,59,2104.51,3692.26,0.00
2024-12-08 14:55:06,97,3549,38,59,2153.74,3693.00,0.00
2024-12-08 14:55:06,98,3549,38,60,2131.76,3693.01,0.00
2024-12-08 14:55:06,98,3550,38,60,2160.70,3694.00,0.00
2024-12-08 14:55:06,99,3550,39,60,2138.87,3694.01,0.00
2024-12-08 14:55:06,100,3549,40,60,2084.95,3694.72,0.00
2024-12-08 14:55:06,100,3550,40,60,2115.44,3695.00,0.00
2024-12-08 14:55:06,101,3550,40,61,2094.49,3695.01,0.00
2024-12-08 14:55:06,102,3549,41,61,2060.96,3695.19,0.00
2024-12-08 14:55:06,102,3550,41,61,2124.14,3696.00,0.00
2024-12-08 14:55:06,103,3550,41,62,2103.51,3696.01,0.00
2024-12-08 14:55:06,103,3551,41,62,2119.67,3697.00,0.00
2024-12-08 14:55:06,104,3551,41,63,2099.28,3697.01,0.00
2024-12-08 14:55:06,103,3551,41,62,2112.13,3697.06,0.00
2024-12-08 14:55:06,103,3552,41,62,2099.42,3698.00,0.00
2024-12-08 14:55:06,104,3552,42,62,2079.23,3698.01,0.00
2024-12-08 14:55:06,103,3552,41,62,2098.70,3698.02,0.00
2024-12-08 14:55:06,102,3552,40,62,2118.19,3698.04,0.00
2024-12-08 14:55:06,101,3552,40,61,2133.68,3698.06,0.00
2024-12-08 14:55:06,102,3551,40,62,2103.79,3698.32,0.00
2024-12-08 14:55:07,102,3552,40,62,2120.21,3699.00,0.00
2024-12-08 14:55:07,103,3552,41,62,2099.62,3699.01,0.00
2024-12-08 14:55:07,102,3552,41,61,2113.33,3699.06,0.00
2024-12-08 14:55:07,102,3553,41,61,2137.11,3700.00,0.00
2024-12-08 14:55:07,103,3553,42,61,2116.36,3700.01,0.00
2024-12-08 14:55:07,102,3553,41,61,2136.74,3700.01,0.00
2024-12-08 14:55:07,101,3553,41,60,2152.41,3700.02,0.00
2024-12-08 14:55:07,100,3553,40,60,2165.81,3700.07,0.00
2024-12-08 14:55:07,100,3554,40,60,2168.96,3701.00,0.00
2024-12-08 14:55:07,101,3554,41,60,2147.49,3701.01,0.00
2024-12-08 14:55:07,102,3553,42,60,2088.29,3701.55,0.00
2024-12-08 14:55:07,101,3553,41,60,2108.36,3701.91,0.00
2024-12-08 14:55:07,101,3554,41,60,2141.79,3702.00,0.00
2024-12-08 14:55:07,102,3554,42,60,2120.79,3702.01,0.00
2024-12-08 14:55:07,101,3554,42,59,2133.37,3702.04,0.00
2024-12-08 14:55:07,101,3555,42,59,2157.03,3703.00,0.00
2024-12-08 14:55:07,102,3555,42,60,2135.89,3703.01,0.00
2024-12-08 14:55:07,101,3555,42,59,2150.81,3703.05,0.00
2024-12-08 14:55:07,102,3554,43,59,2105.39,3703.74,0.00
2024-12-08 14:55:07,101,3554,42,59,2119.22,3703.77,0.00
2024-12-08 14:55:07,101,3555,42,59,2147.63,3704.00,0.00
2024-12-08 14:55:07,102,3555,43,59,2126.58,3704.01,0.00
2024-12-08 14:55:07,101,3555,43,58,2141.04,3704.05,0.00
2024-12-08 14:55:07,101,3556,43,58,2165.09,3705.00,0.00
2024-12-08 14:55:07,102,3556,44,58,2143.86,3705.01,0.00
2024-12-08 14:55:07,102,3557,44,58,2128.79,3706.00,0.00
2024-12-08 14:55:07,103,3557,44,59,2108.12,3706.01,0.00
2024-12-08 14:55:07,102,3557,43,59,2127.71,3706.03,0.00
2024-12-08 14:55:07,102,3558,43,59,2108.12,3707.00,0.00
2024-12-08 14:55:07,103,3558,44,59,2087.65,3707.01,0.00
2024-12-08 14:55:07,102,3558,44,58,2102.31,3707.04,0.00
2024-12-08 14:55:07,102,3559,44,58,2089.05,3708.00,0.00
2024-12-08 14:55:07,103,3559,44,59,2068.77,3708.01,0.00
2024-12-08 14:55:07,103,3560,44,59,2058.08,3709.00,0.00
2024-12-08 14:55:07,104,3560,45,59,2038.30,3709.01,0.00
2024-12-08 14:55:07,105,3559,46,59,1976.25,3709.87,0.00
2024-12-08 14:55:07,105,3560,46,59,2010.63,3710.00,0.00
2024-12-08 14:55:07,106,3560,47,59,1991.66,3710.01,0.00
2024-12-08 14:55:07,106,3561,47,59,2009.54,3711.00,0.00
2024-12-08 14:55:07,107,3561,47,60,1990.76,3711.01,0.00
2024-12-08 14:55:07,106,3561,46,60,1975.56,3711.75,0.00
2024-12-08 14:55:07,106,3562,46,60,1987.32,3712.00,0.00
2024-12-08 14:55:07,107,3562,47,60,1968.74,3712.01,0.00
2024-12-08 14:55:07,106,3562,47,59,1984.87,3712.04,0.00
2024-12-08 14:55:07,107,3561,47,60,1939.95,3712.78,0.00
2024-12-08 14:55:07,107,3562,47,60,1965.75,3713.00,0.00
2024-12-08 14:55:07,108,3562,48,60,1947.55,3713.01,0.00
2024-12-08 14:55:07,107,3562,47,60,1964.72,3713.03,0.00
2024-12-08 14:55:07,106,3562,47,59,1980.45,3713.03,0.00
2024-12-08 14:55:07,105,3562,46,59,1993.27,3713.19,0.00
2024-12-08 14:55:07,106,3561,46,60,1956.50,3713.70,0.00
2024-12-08 14:55:07,105,3561,45,60,1981.72,3713.97,0.00
2024-12-08 14:55:07,105,3562,45,60,2051.41,3714.00,0.00
2024-12-08 14:55:07,106,3562,45,61,2032.06,3714.01,0.00
2024-12-08 14:55:07,105,3562,44,61,2051.06,3714.01,0.00
2024-12-08 14:55:07,104,3562,44,60,2067.93,3714.02,0.00
2024-12-08 14:55:07,105,3561,45,60,2038.07,3714.31,0.00
2024-12-08 14:55:07,104,3561,44,60,2047.50,3714.90,0.00
2024-12-08 14:55:07,104,3562,44,60,2115.44,3715.00,0.00
2024-12-08 14:55:07,105,3562,44,61,2095.29,3715.01,0.00
2024-12-08 14:55:07,104,3562,44,60,2112.59,3715.02,0.00
2024-12-08 14:55:07,104,3563,44,60,2133.87,3716.00,0.00
2024-12-08 14:55:07,105,3563,45,60,2113.55,3716.01,0.00
2024-12-08 14:55:07,104,3563,45,59,2129.24,3716.03,0.00
2024-12-08 14:55:07,104,3564,45,59,2115.15,3717.00,0.00
2024-12-08 14:55:07,105,3564,46,59,2095.00,3717.01,0.00
2024-12-08 14:55:07,104,3564,46,58,2110.51,3717.03,0.00
2024-12-08 14:55:07,103,3564,45,58,2102.87,3717.78,0.00
2024-12-08 14:55:07,103,3565,45,58,2130.84,3718.00,0.00
2024-12-08 14:55:07,104,3565,46,58,2110.35,3718.01,0.00
2024-12-08 14:55:07,103,3565,46,57,2125.80,3718.03,0.00
2024-12-08 14:55:07,103,3566,46,57,2111.92,3719.00,0.00
2024-12-08 14:55:07,104,3566,47,57,2091.61,3719.01,0.00
2024-12-08 14:55:07,103,3566,46,57,2068.37,3719.78,0.00
2024-12-08 14:55:07,103,3567,46,57,2096.36,3720.00,0.00
2024-12-08 14:55:07,104,3567,47,57,2076.21,3720.01,0.00
2024-12-08 14:55:08,104,3568,47,57,2055.36,3721.00,0.00
2024-12-08 14:55:08,105,3568,47,58,2035.78,3721.01,0.00
2024-12-08 14:55:08,104,3568,47,57,2050.00,3721.04,0.00
2024-12-08 14:55:08,104,3569,47,57,2036.23,3722.00,0.00
2024-12-08 14:55:08,105,3569,47,58,2016.83,3722.01,0.00
2024-12-08 14:55:08,106,3568,48,58,1997.81,3722.03,0.00
2024-12-08 14:55:08,105,3568,48,57,2021.81,3722.07,0.00
2024-12-08 14:55:08,104,3568,47,57,2032.74,3722.30,0.00
2024-12-08 14:55:08,103,3568,46,57,2036.69,3722.53,0.00
2024-12-08 14:55:08,103,3569,46,57,2055.82,3723.00,0.00
2024-12-08 14:55:08,104,3569,47,57,2036.06,3723.01,0.00
2024-12-08 14:55:08,103,3569,47,56,2048.25,3723.06,0.00
2024-12-08 14:55:08,104,3568,48,56,2002.42,3723.79,0.00
2024-12-08 14:55:08,105,3567,49,56,1987.66,3723.87,0.00
2024-12-08 14:55:08,105,3568,49,56,2043.10,3724.00,0.00
2024-12-08 14:55:08,106,3568,49,57,2023.82,3724.01,0.00
2024-12-08 14:55:08,105,3568,48,57,2042.40,3724.02,0.00
2024-12-08 14:55:08,104,3568,48,56,2055.24,3724.05,0.00
2024-12-08 14:55:08,105,3567,48,57,2025.83,3724.33,0.00
2024-12-08 14:55:08,104,3567,47,57,2022.65,3724.77,0.00
2024-12-08 14:55:08,104,3568,47,57,2121.68,3725.00,0.00
2024-12-08 14:55:08,105,3568,47,58,2101.47,3725.01,0.00
2024-12-08 14:55:08,104,3568,47,57,2114.17,3725.05,0.00
2024-12-08 14:55:08,103,3568,46,57,2122.51,3725.34,0.00
2024-12-08 14:55:08,103,3569,46,57,2170.71,3726.00,0.00
2024-12-08 14:55:08,104,3569,47,57,2149.84,3726.01,0.00
2024-12-08 14:55:08,103,3569,47,56,2163.48,3726.05,0.00
2024-12-08 14:55:08,103,3570,47,56,2150.30,3727.00,0.00
2024-12-08 14:55:08,104,3570,48,56,2129.63,3727.01,0.00
2024-12-08 14:55:08,104,3571,48,56,2108.94,3728.00,0.00
2024-12-08 14:55:08,105,3571,49,56,2088.85,3728.01,0.00
2024-12-08 14:55:08,104,3571,49,55,2102.50,3728.05,0.00
2024-12-08 14:55:08,104,3572,49,55,2089.07,3729.00,0.00
2024-12-08 14:55:08,105,3572,50,55,2069.17,3729.01,0.00
2024-12-08 14:55:08,104,3572,50,54,2085.49,3729.04,0.00
2024-12-08 14:55:08,104,3573,50,54,2071.69,3730.00,0.00
2024-12-08 14:55:08,105,3573,51,54,2051.96,3730.01,0.00
2024-12-08 14:55:08,105,3574,51,54,2039.32,3731.00,0.00
2024-12-08 14:55:08,106,3574,52,54,2020.09,3731.01,0.00
2024-12-08 14:55:08,107,3573,52,55,1980.07,3731.41,0.00
2024-12-08 14:55:08,107,3574,52,55,2016.90,3732.00,0.00
2024-12-08 14:55:08,108,3574,53,55,1998.22,3732.01,0.00
2024-12-08 14:55:08,107,3574,52,55,2016.21,3732.02,0.00
2024-12-08 14:55:08,107,3575,52,55,2029.17,3733.00,0.00
2024-12-08 14:55:08,108,3575,52,56,2010.38,3733.01,0.00
2024-12-08 14:55:08,107,3575,51,56,2028.48,3733.02,0.00
2024-12-08 14:55:08,106,3575,51,55,2045.50,3733.02,0.00
2024-12-08 14:55:08,107,3574,52,55,2011.88,3733.43,0.00
2024-12-08 14:55:08,108,3573,53,55,2023.68,3733.46,0.00
2024-12-08 14:55:08,109,3572,53,56,2010.63,3733.98,0.00
2024-12-08 14:55:08,109,3573,53,56,2030.86,3734.00,0.00
2024-12-08 14:55:08,110,3573,54,56,2012.40,3734.01,0.00
2024-12-08 14:55:08,109,3573,54,55,2026.07,3734.02,0.00
2024-12-08 14:55:08,108,3573,53,55,2038.27,3734.04,0.00
2024-12-08 14:55:08,109,3572,53,56,2014.81,3734.18,0.00
2024-12-08 14:55:08,109,3573,53,56,2140.72,3735.00,0.00
2024-12-08 14:55:08,110,3573,53,57,2121.25,3735.01,0.00
2024-12-08 14:55:08,109,3573,53,56,2131.48,3735.07,0.00
2024-12-08 14:55:08,110,3572,54,56,2106.73,3735.24,0.00
2024-12-08 14:55:08,110,3573,54,56,2159.57,3736.00,0.00
2024-12-08 14:55:08,111,3573,55,56,2140.12,3736.01,0.00
2024-12-08 14:55:08,110,3573,54,56,2158.60,3736.03,0.00
2024-12-08 14:55:08,109,3573,54,55,2170.19,3736.06,0.00
2024-12-08 14:55:08,110,3572,54,56,2105.44,3736.94,0.00
2024-12-08 14:55:08,110,3573,54,56,2171.74,3737.00,0.00
2024-12-08 14:55:08,111,3573,55,56,2152.18,3737.01,0.00
2024-12-08 14:55:08,110,3573,55,55,2162.93,3737.06,0.00
2024-12-08 14:55:08,110,3574,55,55,2182.86,3738.00,0.00
2024-12-08 14:55:08,111,3574,55,56,2163.19,3738.01,0.00
2024-12-08 14:55:08,110,3574,55,55,2174.04,3738.06,0.00
2024-12-08 14:55:08,109,3574,54,55,2166.11,3738.50,0.00
2024-12-08 14:55:08,109,3575,54,55,2181.91,3739.00,0.00
2024-12-08 14:55:08,110,3575,55,55,2162.07,3739.01,0.00
2024-12-08 14:55:08,109,3575,55,54,2174.72,3739.06,0.00
2024-12-08 14:55:08,109,3576,55,54,2160.53,3740.00,0.00
2024-12-08 14:55:08,110,3576,56,54,2140.89,3740.01,0.00
2024-12-08 14:55:08,109,3576,56,53,2152.31,3740.06,0.00
2024-12-08 14:55:09,109,3577,56,53,2138.12,3741.00,0.00
2024-12-08 14:55:09,110,3577,56,54,2118.68,3741.01,0.00
2024-12-08 14:55:09,111,3576,56,55,2063.41,3741.71,0.00
2024-12-08 14:55:09,111,3577,56,55,2106.05,3742.00,0.00
2024-12-08 14:55:09,112,3577,56,56,2087.25,3742.01,0.00
2024-12-08 14:55:09,112,3578,56,56,2103.53,3743.00,0.00
2024-12-08 14:55:09,113,3578,57,56,2084.92,3743.01,0.00
2024-12-08 14:55:09,112,3578,56,56,2066.42,3743.55,0.00
2024-12-08 14:55:09,112,3579,56,56,2083.46,3744.00,0.00
2024-12-08 14:55:09,113,3579,57,56,2065.02,3744.01,0.00
2024-12-08 14:55:09,112,3579,57,55,2078.13,3744.05,0.00
2024-12-08 14:55:09,112,3580,57,55,2063.29,3745.00,0.00
2024-12-08 14:55:09,113,3580,58,55,2045.03,3745.01,0.00
2024-12-08 14:55:09,112,3580,58,54,2056.61,3745.05,0.00
2024-12-08 14:55:09,111,3580,57,54,2056.98,3745.24,0.00
2024-12-08 14:55:09,110,3580,56,54,2073.33,3745.31,0.00
2024-12-08 14:55:09,110,3581,56,54,2081.95,3746.00,0.00
2024-12-08 14:55:09,111,3581,56,55,2063.20,3746.01,0.00
2024-12-08 14:55:09,110,3581,56,54,2075.49,3746.05,0.00
2024-12-08 14:55:09,110,3582,56,54,2061.05,3747.00,0.00
2024-12-08 14:55:09,111,3582,56,55,2042.48,3747.01,0.00
2024-12-08 14:55:09,110,3582,56,54,2054.59,3747.05,0.00
2024-12-08 14:55:09,109,3582,55,54,2065.20,3747.10,0.00
2024-12-08 14:55:09,109,3583,55,54,2066.41,3748.00,0.00
2024-12-08 14:55:09,110,3583,55,55,2047.63,3748.01,0.00
2024-12-08 14:55:09,109,3583,54,55,2065.73,3748.02,0.00
2024-12-08 14:55:09,108,3583,54,54,2078.96,3748.05,0.00
2024-12-08 14:55:09,107,3583,53,54,2081.29,3748.22,0.00
2024-12-08 14:55:09,106,3583,52,54,2081.76,3748.74,0.00
2024-12-08 14:55:09,106,3584,52,54,2107.43,3749.00,0.00
2024-12-08 14:55:09,107,3584,52,55,2087.73,3749.01,0.00
2024-12-08 14:55:09,106,3584,52,54,2100.37,3749.06,0.00
2024-12-08 14:55:09,105,3584,51,54,2110.48,3749.31,0.00
2024-12-08 14:55:09,105,3585,51,54,2106.64,3750.00,0.00
2024-12-08 14:55:09,106,3585,52,54,2086.76,3750.01,0.00
2024-12-08 14:55:09,105,3585,52,53,2099.51,3750.06,0.00
2024-12-08 14:55:09,104,3585,51,53,2102.48,3750.29,0.00
2024-12-08 14:55:09,104,3586,51,53,2112.31,3751.00,0.00
2024-12-08 14:55:09,105,3586,52,53,2092.19,3751.01,0.00
2024-12-08 14:55:09,104,3586,52,52,2104.40,3751.07,0.00
2024-12-08 14:55:09,105,3585,53,52,2078.69,3751.24,0.00
2024-12-08 14:55:09,106,3584,54,52,2048.35,3751.71,0.00
2024-12-08 14:55:09,106,3585,54,52,2067.34,3752.00,0.00
2024-12-08 14:55:09,107,3585,55,52,2048.02,3752.01,0.00
2024-12-08 14:55:09,106,3585,55,51,2066.29,3752.03,0.00
2024-12-08 14:55:09,106,3586,55,51,2125.22,3753.00,0.00
2024-12-08 14:55:09,107,3586,56,51,2105.36,3753.01,0.00
2024-12-08 14:55:09,106,3586,56,50,2124.16,3753.03,0.00
2024-12-08 14:55:09,107,3585,56,51,2088.96,3753.27,0.00
2024-12-08 14:55:09,107,3586,56,51,2111.54,3754.00,0.00
2024-12-08 14:55:09,108,3586,57,51,2091.98,3754.01,0.00
2024-12-08 14:55:09,109,3585,57,52,2052.61,3754.39,0.00
2024-12-08 14:55:09,109,3586,57,52,2103.77,3755.00,0.00
2024-12-08 14:55:09,110,3586,57,53,2084.64,3755.01,0.00
2024-12-08 14:55:09,109,3586,57,52,2098.96,3755.05,0.00
2024-12-08 14:55:09,109,3587,57,52,2118.80,3756.00,0.00
2024-12-08 14:55:09,110,3587,57,53,2099.54,3756.01,0.00
2024-12-08 14:55:09,109,3587,57,52,2112.97,3756.06,0.00
2024-12-08 14:55:09,108,3587,56,52,2098.72,3756.65,0.00
2024-12-08 14:55:09,108,3588,56,52,2120.55,3757.00,0.00
2024-12-08 14:55:09,109,3588,56,53,2101.10,3757.01,0.00
2024-12-08 14:55:09,108,3588,56,52,2114.32,3757.06,0.00
2024-12-08 14:55:09,109,3587,56,53,2054.25,3757.80,0.00
2024-12-08 14:55:09,109,3588,56,53,2087.18,3758.00,0.00
2024-12-08 14:55:09,110,3588,57,53,2068.20,3758.01,0.00
2024-12-08 14:55:09,109,3588,56,53,2080.30,3758.06,0.00
2024-12-08 14:55:09,110,3587,56,54,2025.25,3758.87,0.00
2024-12-08 14:55:09,110,3588,56,54,2091.99,3759.00,0.00
2024-12-08 14:55:09,111,3588,57,54,2073.14,3759.01,0.00
2024-12-08 14:55:09,110,3588,56,54,2089.99,3759.05,0.00
2024-12-08 14:55:09,109,3588,56,53,2104.68,3759.06,0.00
2024-12-08 14:55:09,109,3589,56,53,2124.88,3760.00,0.00
2024-12-08 14:55:09,110,3589,56,54,2105.56,3760.01,0.00
2024-12-08 14:55:09,109,3589,56,53,2118.01,3760.06,0.00
2024-12-08 14:55:09,110,3588,56,54,2078.31,3760.26,0.00
2024-12-08 14:55:09,111,3587,56,55,2068.90,3760.61,0.00
2024-12-08 14:55:09,111,3588,56,55,2119.99,3761.00,0.00
2024-12-08 14:55:09,112,3588,56,56,2101.06,3761.01,0.00
2024-12-08 14:55:09,111,3588,56,55,2113.24,3761.06,0.00
2024-12-08 14:55:09,110,3588,55,55,2118.46,3761.14,0.00
2024-12-08 14:55:09,110,3589,55,55,2189.08,3762.00,0.00
2024-12-08 14:55:09,111,3589,56,55,2169.36,3762.01,0.00
2024-12-08 14:55:09,110,3589,56,54,2182.26,3762.06,0.00
2024-12-08 14:55:09,109,3589,55,54,2194.77,3762.27,0.00
2024-12-08 14:55:10,108,3589,54,54,2214.40,3762.28,0.00
2024-12-08 14:55:10,107,3589,53,54,2218.42,3762.49,0.00
2024-12-08 14:55:10,108,3588,54,54,2194.12,3762.60,0.00
2024-12-08 14:55:10,108,3589,54,54,2223.00,3763.00,0.00
2024-12-08 14:55:10,109,3589,55,54,2202.61,3763.01,0.00
2024-12-08 14:55:10,108,3589,55,53,2216.06,3763.07,0.00
2024-12-08 14:55:10,109,3588,56,53,2187.88,3763.29,0.00
2024-12-08 14:55:10,110,3587,57,53,2181.34,3763.31,0.00
2024-12-08 14:55:10,110,3588,57,53,2229.70,3764.00,0.00
2024-12-08 14:55:10,111,3588,58,53,2209.61,3764.01,0.00
2024-12-08 14:55:10,110,3588,57,53,2228.35,3764.04,0.00
2024-12-08 14:55:10,109,3588,57,52,2241.55,3764.07,0.00
2024-12-08 14:55:10,109,3589,57,52,2297.04,3765.00,0.00
2024-12-08 14:55:10,110,3589,57,53,2276.16,3765.01,0.00
2024-12-08 14:55:10,109,3589,57,52,2288.78,3765.07,0.00
2024-12-08 14:55:10,109,3590,57,52,2275.19,3766.00,0.00
2024-12-08 14:55:10,110,3590,57,53,2254.51,3766.01,0.00
2024-12-08 14:55:10,109,3590,56,53,2267.62,3766.06,0.00
2024-12-08 14:55:10,109,3591,56,53,2260.59,3767.00,0.00
2024-12-08 14:55:10,110,3591,57,53,2240.04,3767.01,0.00
2024-12-08 14:55:10,109,3591,57,52,2238.50,3767.07,0.00
2024-12-08 14:55:10,109,3592,57,52,2238.72,3768.00,0.00
2024-12-08 14:55:10,110,3592,57,53,2218.37,3768.01,0.00
2024-12-08 14:55:10,109,3592,57,52,2230.10,3768.07,0.00
2024-12-08 14:55:10,109,3593,57,52,2216.49,3769.00,0.00
2024-12-08 14:55:10,110,3593,58,52,2196.34,3769.01,0.00
2024-12-08 14:55:10,109,3593,57,52,2213.62,3769.05,0.00
2024-12-08 14:55:10,108,3593,57,51,2227.14,3769.07,0.00
2024-12-08 14:55:10,107,3593,56,51,2240.99,3769.24,0.00
2024-12-08 14:55:10,108,3592,56,52,2200.65,3769.79,0.00
2024-12-08 14:55:10,108,3593,56,52,2232.95,3770.00,0.00
2024-12-08 14:55:10,109,3593,57,52,2212.46,3770.01,0.00
2024-12-08 14:55:10,108,3593,57,51,2224.59,3770.07,0.00
2024-12-08 14:55:10,107,3593,56,51,2216.38,3770.58,0.00
2024-12-08 14:55:10,107,3594,56,51,2271.33,3771.00,0.00
2024-12-08 14:55:10,108,3594,57,51,2250.30,3771.01,0.00
2024-12-08 14:55:10,107,3594,56,51,2269.24,3771.06,0.00
2024-12-08 14:55:10,107,3595,56,51,2258.55,3772.00,0.00
2024-12-08 14:55:10,108,3595,57,51,2237.64,3772.01,0.00
2024-12-08 14:55:10,109,3594,57,52,2174.19,3772.83,0.00
2024-12-08 14:55:10,109,3595,57,52,2206.88,3773.00,0.00
2024-12-08 14:55:10,110,3595,58,52,2186.82,3773.01,0.00
2024-12-08 14:55:10,110,3596,58,52,2200.82,3774.00,0.00
2024-12-08 14:55:10,111,3596,58,53,2180.99,3774.01,0.00
2024-12-08 14:55:10,110,3596,58,52,2192.26,3774.05,0.00
2024-12-08 14:55:10,109,3596,57,52,2204.15,3774.27,0.00
2024-12-08 14:55:10,110,3595,58,52,2182.06,3774.34,0.00
2024-12-08 14:55:10,110,3596,58,52,2195.91,3775.00,0.00
2024-12-08 14:55:10,111,3596,58,53,2176.13,3775.01,0.00
2024-12-08 14:55:10,110,3596,58,52,2188.04,3775.06,0.00
2024-12-08 14:55:10,109,3596,57,52,2184.41,3775.51,0.00
2024-12-08 14:55:10,109,3597,57,52,2235.35,3776.00,0.00
2024-12-08 14:55:10,110,3597,57,53,2215.03,3776.01,0.00
2024-12-08 14:55:10,109,3597,57,52,2227.40,3776.06,0.00
2024-12-08 14:55:10,108,3597,56,52,2239.02,3776.28,0.00
2024-12-08 14:55:10,109,3596,57,52,2196.68,3776.88,0.00
2024-12-08 14:55:10,109,3597,57,52,2230.40,3777.00,0.00
2024-12-08 14:55:10,110,3597,57,53,2210.12,3777.01,0.00
2024-12-08 14:55:10,109,3597,57,52,2223.49,3777.06,0.00
2024-12-08 14:55:10,108,3597,56,52,2236.11,3777.26,0.00
2024-12-08 14:55:10,108,3598,56,52,2264.59,3778.00,0.00
2024-12-08 14:55:10,109,3598,57,52,2243.81,3778.01,0.00
2024-12-08 14:55:10,108,3598,56,52,2250.61,3778.06,0.00
2024-12-08 14:55:10,107,3598,56,51,2266.00,3778.06,0.00
2024-12-08 14:55:10,107,3599,56,51,2266.23,3779.00,0.00
2024-12-08 14:55:10,108,3599,56,52,2245.24,3779.01,0.00
2024-12-08 14:55:10,109,3598,56,53,2197.45,3779.47,0.00
2024-12-08 14:55:10,109,3599,56,53,2226.98,3780.00,0.00
2024-12-08 14:55:10,110,3599,57,53,2206.73,3780.01,0.00
2024-12-08 14:55:10,109,3599,56,53,2223.86,3780.06,0.00
2024-12-08 14:55:10,109,3600,56,53,2251.14,3781.00,0.00
2024-12-08 14:55:10,110,3600,57,53,2230.68,3781.01,0.00
2024-12-08 14:55:10,111,3599,58,53,2199.72,3781.14,0.00
2024-12-08 14:55:10,110,3599,57,53,2221.48,3781.25,0.00
2024-12-08 14:55:10,111,3598,58,53,2198.77,3781.33,0.00
2024-12-08 14:55:10,111,3599,58,53,2206.51,3782.00,0.00
2024-12-08 14:55:10,112,3599,58,54,2186.81,3782.01,0.00
2024-12-08 14:55:10,111,3599,58,53,2198.35,3782.05,0.00
2024-12-08 14:55:10,110,3599,57,53,2210.85,3782.25,0.00
2024-12-08 14:55:10,110,3600,57,53,2272.21,3783.00,0.00
2024-12-08 14:55:10,111,3600,57,54,2251.74,3783.01,0.00
2024-12-08 14:55:10,112,3599,58,54,2230.30,3783.06,0.00
2024-12-08 14:55:10,111,3599,58,53,2263.01,3783.06,0.00
2024-12-08 14:55:10,110,3599,57,53,2276.43,3783.25,0.00
2024-12-08 14:55:11,110,3600,57,53,2269.03,3784.00,0.00
2024-12-08 14:55:11,111,3600,57,54,2248.59,3784.01,0.00
2024-12-08 14:55:11,110,3600,56,54,2257.54,3784.13,0.00
2024-12-08 14:55:11,111,3599,57,54,2213.03,3784.79,0.00
2024-12-08 14:55:11,112,3598,58,54,2182.18,3784.88,0.00
2024-12-08 14:55:11,112,3599,58,54,2248.18,3785.00,0.00
2024-12-08 14:55:11,113,3599,58,55,2228.29,3785.01,0.00
2024-12-08 14:55:11,112,3599,58,54,2244.82,3785.05,0.00
2024-12-08 14:55:11,113,3598,59,54,2183.84,3785.81,0.00
2024-12-08 14:55:11,113,3599,59,54,2305.56,3786.00,0.00
2024-12-08 14:55:11,114,3599,59,55,2285.34,3786.01,0.00
2024-12-08 14:55:11,113,3599,58,55,2304.90,3786.02,0.00
2024-12-08 14:55:11,112,3599,58,54,2320.08,3786.05,0.00
2024-12-08 14:55:11,113,3598,59,54,2278.72,3786.62,0.00
2024-12-08 14:55:11,113,3599,59,54,2322.59,3787.00,0.00
2024-12-08 14:55:11,114,3599,60,54,2302.22,3787.01,0.00
2024-12-08 14:55:11,113,3599,60,53,2314.91,3787.06,0.00
2024-12-08 14:55:11,112,3599,59,53,2312.11,3787.47,0.00
2024-12-08 14:55:11,112,3600,59,53,2360.18,3788.00,0.00
2024-12-08 14:55:11,113,3600,59,54,2339.30,3788.01,0.00
2024-12-08 14:55:11,113,3601,59,54,2324.79,3789.00,0.00
2024-12-08 14:55:11,114,3601,60,54,2304.40,3789.01,0.00
2024-12-08 14:55:11,113,3601,59,54,2282.81,3789.73,0.00
2024-12-08 14:55:11,113,3602,59,54,2306.19,3790.00,0.00
2024-12-08 14:55:11,114,3602,60,54,2285.96,3790.01,0.00
2024-12-08 14:55:11,114,3603,60,54,2262.41,3791.00,0.00
2024-12-08 14:55:11,115,3603,61,54,2242.74,3791.01,0.00
2024-12-08 14:55:11,114,3603,61,53,2255.79,3791.07,0.00
2024-12-08 14:55:11,114,3604,61,53,2241.06,3792.00,0.00
2024-12-08 14:55:11,115,3604,62,53,2221.57,3792.01,0.00
2024-12-08 14:55:11,114,3604,62,52,2233.11,3792.07,0.00
2024-12-08 14:55:11,115,3603,62,53,2211.06,3792.16,0.00
2024-12-08 14:55:11,115,3604,62,53,2215.89,3793.00,0.00
2024-12-08 14:55:11,116,3604,62,54,2196.79,3793.01,0.00
2024-12-08 14:55:11,115,3604,62,53,2207.34,3793.07,0.00
2024-12-08 14:55:11,114,3604,61,53,2220.45,3793.24,0.00
2024-12-08 14:55:11,114,3605,61,53,2245.23,3794.00,0.00
2024-12-08 14:55:11,115,3605,61,54,2225.71,3794.01,0.00
2024-12-08 14:55:11,114,3605,61,53,2236.28,3794.08,0.00
2024-12-08 14:55:11,115,3604,61,54,2201.19,3794.51,0.00
2024-12-08 14:55:11,115,3605,61,54,2215.08,3795.00,0.00
2024-12-08 14:55:11,116,3605,62,54,2195.98,3795.01,0.00
2024-12-08 14:55:11,115,3605,62,53,2205.87,3795.09,0.00
2024-12-08 14:55:11,115,3606,62,53,2224.57,3796.00,0.00
2024-12-08 14:55:11,116,3606,63,53,2205.40,3796.01,0.00
2024-12-08 14:55:11,115,3606,63,52,2215.36,3796.09,0.00
2024-12-08 14:55:11,115,3607,63,52,2201.06,3797.00,0.00
2024-12-08 14:55:11,116,3607,63,53,2182.08,3797.01,0.00
2024-12-08 14:55:11,115,3607,63,52,2191.84,3797.09,0.00
2024-12-08 14:55:11,114,3607,62,52,2204.41,3797.09,0.00
2024-12-08 14:55:11,114,3608,62,52,2203.62,3798.00,0.00
2024-12-08 14:55:11,115,3608,63,52,2184.46,3798.01,0.00
2024-12-08 14:55:11,116,3607,63,53,2165.31,3798.03,0.00
2024-12-08 14:55:11,115,3607,62,53,2191.51,3798.21,0.00
2024-12-08 14:55:11,114,3607,61,53,2190.37,3798.75,0.00
2024-12-08 14:55:11,114,3608,61,53,2210.33,3799.00,0.00
2024-12-08 14:55:11,115,3608,61,54,2191.11,3799.01,0.00
2024-12-08 14:55:11,115,3609,61,54,2206.48,3800.00,0.00
2024-12-08 14:55:11,116,3609,61,55,2187.46,3800.01,0.00
2024-12-08 14:55:11,115,3609,60,55,2204.85,3800.04,0.00
2024-12-08 14:55:11,115,3610,60,55,2183.36,3801.00,0.00
2024-12-08 14:55:11,116,3610,60,56,2164.53,3801.01,0.00
2024-12-08 14:55:11,115,3610,60,55,2175.80,3801.09,0.00
2024-12-08 14:55:11,116,3609,61,55,2130.86,3801.80,0.00
2024-12-08 14:55:11,115,3609,60,55,2135.30,3801.97,0.00
2024-12-08 14:55:11,115,3610,60,55,2167.38,3802.00,0.00
2024-12-08 14:55:11,116,3610,61,55,2148.70,3802.01,0.00
2024-12-08 14:55:11,115,3610,61,54,2157.51,3802.09,0.00
2024-12-08 14:55:11,114,3610,60,54,2144.38,3802.87,0.00
2024-12-08 14:55:11,114,3611,60,54,2206.19,3803.00,0.00
2024-12-08 14:55:11,115,3611,60,55,2187.01,3803.01,0.00
2024-12-08 14:55:11,114,3611,59,55,2173.72,3803.52,0.00
2024-12-08 14:55:11,114,3612,59,55,2189.09,3804.00,0.00
2024-12-08 14:55:11,115,3612,59,56,2170.05,3804.01,0.00
2024-12-08 14:55:11,114,3612,59,55,2185.46,3804.10,0.00
2024-12-08 14:55:11,113,3612,58,55,2197.80,3804.28,0.00
2024-12-08 14:55:12,112,3612,57,55,2201.90,3804.52,0.00
2024-12-08 14:55:12,112,3613,57,55,2217.89,3805.00,0.00
2024-12-08 14:55:12,113,3613,57,56,2198.26,3805.01,0.00
2024-12-08 14:55:12,112,3613,57,55,2207.74,3805.10,0.00
2024-12-08 14:55:12,112,3614,57,55,2194.35,3806.00,0.00
2024-12-08 14:55:12,113,3614,58,55,2174.93,3806.01,0.00
2024-12-08 14:55:12,112,3614,57,55,2149.14,3806.71,0.00
2024-12-08 14:55:12,112,3615,57,55,2172.15,3807.00,0.00
2024-12-08 14:55:12,113,3615,57,56,2152.93,3807.01,0.00
2024-12-08 14:55:12,112,3615,57,55,2165.41,3807.14,0.00
2024-12-08 14:55:12,113,3614,57,56,2139.24,3807.35,0.00
2024-12-08 14:55:12,113,3615,57,56,2153.49,3808.00,0.00
2024-12-08 14:55:12,114,3615,58,56,2134.60,3808.01,0.00
2024-12-08 14:55:12,114,3616,58,56,2150.61,3809.00,0.00
2024-12-08 14:55:12,115,3616,59,56,2131.91,3809.01,0.00
2024-12-08 14:55:12,114,3616,58,56,2136.22,3809.17,0.00
2024-12-08 14:55:12,114,3617,58,56,2138.40,3810.00,0.00
2024-12-08 14:55:12,115,3617,58,57,2119.80,3810.01,0.00
2024-12-08 14:55:12,114,3617,58,56,2129.09,3810.14,0.00
2024-12-08 14:55:12,114,3618,58,56,2116.89,3811.00,0.00
2024-12-08 14:55:12,115,3618,59,56,2098.49,3811.01,0.00
2024-12-08 14:55:12,114,3618,58,56,2085.57,3811.30,0.00
2024-12-08 14:55:12,114,3619,58,56,2092.70,3812.00,0.00
2024-12-08 14:55:12,115,3619,58,57,2074.51,3812.01,0.00
2024-12-08 14:55:12,114,3619,58,56,2086.73,3812.15,0.00
2024-12-08 14:55:12,114,3620,58,56,2074.86,3813.00,0.00
2024-12-08 14:55:12,115,3620,58,57,2056.82,3813.01,0.00
2024-12-08 14:55:12,114,3620,57,57,2072.21,3813.07,0.00
2024-12-08 14:55:12,114,3621,57,57,2050.64,3814.00,0.00
2024-12-08 14:55:12,115,3621,57,58,2032.81,3814.01,0.00
2024-12-08 14:55:12,114,3621,57,57,2044.67,3814.15,0.00
2024-12-08 14:55:12,115,3620,57,58,2018.35,3814.39,0.00
2024-12-08 14:55:12,114,3620,56,58,2020.53,3814.75,0.00
2024-12-08 14:55:12,114,3621,56,58,2044.49,3815.00,0.00
2024-12-08 14:55:12,115,3621,56,59,2026.71,3815.01,0.00
2024-12-08 14:55:12,114,3621,55,59,2022.46,3815.18,0.00
2024-12-08 14:55:12,113,3621,54,59,2035.67,3815.31,0.00
2024-12-08 14:55:12,113,3622,54,59,2077.31,3816.00,0.00
2024-12-08 14:55:12,114,3622,54,60,2059.08,3816.01,0.00
2024-12-08 14:55:12,115,3621,54,61,2038.22,3816.10,0.00
2024-12-08 14:55:12,116,3620,55,61,2050.27,3816.12,0.00
2024-12-08 14:55:12,115,3620,55,60,2076.08,3816.18,0.00
2024-12-08 14:55:12,114,3620,54,60,2089.88,3816.30,0.00
2024-12-08 14:55:12,114,3621,54,60,2083.62,3817.00,0.00
2024-12-08 14:55:12,115,3621,54,61,2065.51,3817.01,0.00
2024-12-08 14:55:12,114,3621,53,61,2063.99,3817.33,0.00
2024-12-08 14:55:12,114,3622,53,61,2139.43,3818.00,0.00
2024-12-08 14:55:12,115,3622,53,62,2120.83,3818.01,0.00
2024-12-08 14:55:12,114,3622,53,61,2131.79,3818.18,0.00
2024-12-08 14:55:12,114,3623,53,61,2120.90,3819.00,0.00
2024-12-08 14:55:12,115,3623,53,62,2102.45,3819.01,0.00
2024-12-08 14:55:12,114,3623,52,62,2101.59,3819.33,0.00
2024-12-08 14:55:12,115,3622,53,62,2075.44,3819.56,0.00
2024-12-08 14:55:12,114,3622,52,62,2096.89,3819.57,0.00
2024-12-08 14:55:12,114,3623,52,62,2114.30,3820.00,0.00
2024-12-08 14:55:12,115,3623,53,62,2095.92,3820.01,0.00
2024-12-08 14:55:12,114,3623,52,62,2109.99,3820.11,0.00
2024-12-08 14:55:12,113,3623,52,61,2125.97,3820.17,0.00
2024-12-08 14:55:12,113,3624,52,61,2148.79,3821.00,0.00
2024-12-08 14:55:12,114,3624,53,61,2129.94,3821.01,0.00
2024-12-08 14:55:12,114,3625,53,61,2106.02,3822.00,0.00
2024-12-08 14:55:12,115,3625,54,61,2087.71,3822.01,0.00
2024-12-08 14:55:12,114,3625,53,61,2105.69,3822.01,0.00
2024-12-08 14:55:12,113,3625,53,60,2118.29,3822.16,0.00
2024-12-08 14:55:12,112,3625,52,60,2130.10,3822.34,0.00
2024-12-08 14:55:12,112,3626,52,60,2125.76,3823.00,0.00
2024-12-08 14:55:12,113,3626,53,60,2106.94,3823.01,0.00
2024-12-08 14:55:12,112,3626,52,60,2123.73,3823.05,0.00
2024-12-08 14:55:12,111,3626,51,60,2142.18,3823.06,0.00
2024-12-08 14:55:12,110,3626,51,59,2154.38,3823.13,0.00
2024-12-08 14:55:12,109,3626,50,59,2156.71,3823.21,0.00
2024-12-08 14:55:12,109,3627,50,59,2162.10,3824.00,0.00
2024-12-08 14:55:12,110,3627,50,60,2142.45,3824.01,0.00
2024-12-08 14:55:12,111,3626,51,60,2083.47,3824.82,0.00
2024-12-08 14:55:12,111,3627,51,60,2116.70,3825.00,0.00
2024-12-08 14:55:12,112,3627,51,61,2097.80,3825.01,0.00
2024-12-08 14:55:12,113,3626,52,61,2052.90,3825.43,0.00
2024-12-08 14:55:12,113,3627,52,61,2116.26,3826.00,0.00
2024-12-08 14:55:12,114,3627,53,61,2097.70,3826.01,0.00
2024-12-08 14:55:12,113,3627,52,61,2098.21,3826.30,0.00
2024-12-08 14:55:12,112,3627,51,61,2111.00,3826.30,0.00
2024-12-08 14:55:12,112,3628,51,61,2153.13,3827.00,0.00
2024-12-08 14:55:12,113,3628,52,61,2134.08,3827.01,0.00
2024-12-08 14:55:13,114,3627,52,62,2091.03,3827.49,0.00
2024-12-08 14:55:13,114,3628,52,62,2107.58,3828.00,0.00
2024-12-08 14:55:13,115,3628,52,63,2089.26,3828.01,0.00
2024-12-08 14:55:13,114,3628,52,62,2102.57,3828.06,0.00
2024-12-08 14:55:13,113,3628,51,62,2120.51,3828.07,0.00
2024-12-08 14:55:13,113,3629,51,62,2139.67,3829.00,0.00
2024-12-08 14:55:13,114,3629,51,63,2120.90,3829.01,0.00
2024-12-08 14:55:13,113,3629,51,62,2128.87,3829.13,0.00
2024-12-08 14:55:13,114,3628,51,63,2065.66,3829.97,0.00
2024-12-08 14:55:13,114,3629,51,63,2125.41,3830.00,0.00
2024-12-08 14:55:13,115,3629,51,64,2106.93,3830.01,0.00
2024-12-08 14:55:13,114,3629,51,63,2114.70,3830.13,0.00
2024-12-08 14:55:13,113,3629,50,63,2126.03,3830.32,0.00
2024-12-08 14:55:13,112,3629,49,63,2125.33,3830.61,0.00
2024-12-08 14:55:13,111,3629,48,63,2139.40,3830.75,0.00
2024-12-08 14:55:13,111,3630,48,63,2198.96,3831.00,0.00
2024-12-08 14:55:13,112,3630,49,63,2179.33,3831.01,0.00
2024-12-08 14:55:13,113,3629,50,63,2156.35,3831.12,0.00
2024-12-08 14:55:13,114,3628,51,63,2131.28,3831.65,0.00
2024-12-08 14:55:13,114,3629,51,63,2162.16,3832.00,0.00
2024-12-08 14:55:13,115,3629,51,64,2143.35,3832.01,0.00
2024-12-08 14:55:13,114,3629,51,63,2155.14,3832.13,0.00
2024-12-08 14:55:13,114,3630,51,63,2209.79,3833.00,0.00
2024-12-08 14:55:13,115,3630,51,64,2190.58,3833.01,0.00
2024-12-08 14:55:13,114,3630,50,64,2207.13,3833.07,0.00
2024-12-08 14:55:13,113,3630,49,64,2226.32,3833.07,0.00
2024-12-08 14:55:13,112,3630,49,63,2238.69,3833.12,0.00
2024-12-08 14:55:13,111,3630,48,63,2250.98,3833.32,0.00
2024-12-08 14:55:13,110,3630,47,63,2256.58,3833.53,0.00
2024-12-08 14:55:13,110,3631,47,63,2273.67,3834.00,0.00
2024-12-08 14:55:13,111,3631,47,64,2253.18,3834.01,0.00
2024-12-08 14:55:13,110,3631,46,64,2265.31,3834.04,0.00
2024-12-08 14:55:13,109,3631,46,63,2284.70,3834.06,0.00
2024-12-08 14:55:13,109,3632,46,63,2277.53,3835.00,0.00
2024-12-08 14:55:13,110,3632,46,64,2256.83,3835.01,0.00
2024-12-08 14:55:13,109,3632,45,64,2276.83,3835.02,0.00
2024-12-08 14:55:13,108,3632,45,63,2289.08,3835.11,0.00
2024-12-08 14:55:13,109,3631,46,63,2224.89,3835.90,0.00
2024-12-08 14:55:13,109,3632,46,63,2258.77,3836.00,0.00
2024-12-08 14:55:13,110,3632,47,63,2238.24,3836.01,0.00
2024-12-08 14:55:13,109,3632,47,62,2248.26,3836.11,0.00
2024-12-08 14:55:13,108,3632,46,62,2259.89,3836.26,0.00
2024-12-08 14:55:13,108,3633,46,62,2303.02,3837.00,0.00
2024-12-08 14:55:13,109,3633,47,62,2281.89,3837.01,0.00
2024-12-08 14:55:13,108,3633,47,61,2292.40,3837.11,0.00
2024-12-08 14:55:13,108,3634,47,61,2280.16,3838.00,0.00
2024-12-08 14:55:13,109,3634,48,61,2259.24,3838.01,0.00
2024-12-08 14:55:13,108,3634,48,60,2268.48,3838.13,0.00
2024-12-08 14:55:13,108,3635,48,60,2256.94,3839.00,0.00
2024-12-08 14:55:13,109,3635,48,61,2236.23,3839.01,0.00
2024-12-08 14:55:13,110,3634,49,61,2194.08,3839.42,0.00
2024-12-08 14:55:13,110,3635,49,61,2221.42,3840.00,0.00
2024-12-08 14:55:13,111,3635,49,62,2201.41,3840.01,0.00
2024-12-08 14:55:13,111,3636,49,62,2218.68,3841.00,0.00
2024-12-08 14:55:13,112,3636,49,63,2198.87,3841.01,0.00
2024-12-08 14:55:13,111,3636,48,63,2192.06,3841.41,0.00
2024-12-08 14:55:13,111,3637,48,63,2204.58,3842.00,0.00
2024-12-08 14:55:13,112,3637,48,64,2184.90,3842.01,0.00
2024-12-08 14:55:13,111,3637,47,64,2201.15,3842.07,0.00
2024-12-08 14:55:13,112,3636,48,64,2181.16,3842.10,0.00
2024-12-08 14:55:13,111,3636,48,63,2218.48,3842.14,0.00
2024-12-08 14:55:13,111,3637,48,63,2220.39,3843.00,0.00
2024-12-08 14:55:13,112,3637,48,64,2200.56,3843.01,0.00
2024-12-08 14:55:13,111,3637,48,63,2209.36,3843.14,0.00
2024-12-08 14:55:13,110,3637,47,63,2201.71,3843.60,0.00
2024-12-08 14:55:13,110,3638,47,63,2256.53,3844.00,0.00
2024-12-08 14:55:13,111,3638,47,64,2236.20,3844.01,0.00
2024-12-08 14:55:13,110,3638,47,63,2245.40,3844.14,0.00
2024-12-08 14:55:13,110,3639,47,63,2233.70,3845.00,0.00
2024-12-08 14:55:13,111,3639,48,63,2213.58,3845.01,0.00
2024-12-08 14:55:13,110,3639,47,63,2230.94,3845.07,0.00
2024-12-08 14:55:13,111,3638,48,63,2199.44,3845.21,0.00
2024-12-08 14:55:13,110,3638,47,63,2232.04,3845.25,0.00
2024-12-08 14:55:13,110,3639,47,63,2238.48,3846.00,0.00
2024-12-08 14:55:13,111,3639,48,63,2218.31,3846.01,0.00
2024-12-08 14:55:13,110,3639,48,62,2229.79,3846.14,0.00
2024-12-08 14:55:13,111,3638,48,63,2193.61,3846.58,0.00
2024-12-08 14:55:13,111,3639,48,63,2244.53,3847.00,0.00
2024-12-08 14:55:13,112,3639,48,64,2224.49,3847.01,0.00
2024-12-08 14:55:13,111,3639,48,63,2232.80,3847.14,0.00
2024-12-08 14:55:13,111,3640,48,63,2255.52,3848.00,0.00
2024-12-08 14:55:13,112,3640,49,63,2235.38,3848.01,0.00
2024-12-08 14:55:13,113,3639,49,64,2178.48,3848.50,0.00
2024-12-08 14:55:13,113,3640,49,64,2208.15,3849.00,0.00
2024-12-08 14:55:13,114,3640,49,65,2188.78,3849.01,0.00
2024-12-08 14:55:13,115,3639,50,65,2166.10,3849.12,0.00
2024-12-08 14:55:13,114,3639,50,64,2210.44,3849.15,0.00
2024-12-08 14:55:13,113,3639,49,64,2224.46,3849.29,0.00
2024-12-08 14:55:13,114,3638,49,65,2186.32,3849.80,0.00
2024-12-08 14:55:14,114,3639,49,65,2238.51,3850.00,0.00
2024-12-08 14:55:14,115,3639,50,65,2219.04,3850.01,0.00
2024-12-08 14:55:14,114,3639,50,64,2232.47,3850.10,0.00
2024-12-08 14:55:14,113,3639,49,64,2243.46,3850.32,0.00
2024-12-08 14:55:14,113,3640,49,64,2306.27,3851.00,0.00
2024-12-08 14:55:14,114,3640,49,65,2286.04,3851.01,0.00
2024-12-08 14:55:14,113,3640,48,65,2303.24,3851.08,0.00
2024-12-08 14:55:14,113,3641,48,65,2292.85,3852.00,0.00
2024-12-08 14:55:14,114,3641,49,65,2272.73,3852.01,0.00
2024-12-08 14:55:14,113,3641,48,65,2274.56,3852.31,0.00
2024-12-08 14:55:14,114,3640,49,65,2240.62,3852.69,0.00
2024-12-08 14:55:14,114,3641,49,65,2267.02,3853.00,0.00
2024-12-08 14:55:14,115,3641,49,66,2247.30,3853.01,0.00
2024-12-08 14:55:14,116,3640,49,67,2203.55,3853.49,0.00
2024-12-08 14:55:14,116,3641,49,67,2245.79,3854.00,0.00
2024-12-08 14:55:14,117,3641,49,68,2226.59,3854.01,0.00
2024-12-08 14:55:14,117,3642,49,68,2236.38,3855.00,0.00
2024-12-08 14:55:14,118,3642,49,69,2217.43,3855.01,0.00
2024-12-08 14:55:14,117,3642,49,68,2228.51,3855.09,0.00
2024-12-08 14:55:14,118,3641,49,69,2196.36,3855.45,0.00
2024-12-08 14:55:14,117,3641,48,69,2200.93,3855.93,0.00
2024-12-08 14:55:14,117,3642,48,69,2231.31,3856.00,0.00
2024-12-08 14:55:14,118,3642,48,70,2212.40,3856.01,0.00
2024-12-08 14:55:14,117,3642,48,69,2222.77,3856.11,0.00
2024-12-08 14:55:14,117,3643,48,69,2241.77,3857.00,0.00
2024-12-08 14:55:14,118,3643,49,69,2222.78,3857.01,0.00
2024-12-08 14:55:14,119,3642,50,69,2182.06,3857.35,0.00
2024-12-08 14:55:14,119,3643,50,69,2198.07,3858.00,0.00
2024-12-08 14:55:14,120,3643,50,70,2179.76,3858.01,0.00
2024-12-08 14:55:14,120,3644,50,70,2195.37,3859.00,0.00
2024-12-08 14:55:14,121,3644,50,71,2177.22,3859.01,0.00
2024-12-08 14:55:14,121,3645,50,71,2156.50,3860.00,0.00
2024-12-08 14:55:14,122,3645,50,72,2138.83,3860.01,0.00
2024-12-08 14:55:14,121,3645,50,71,2153.34,3860.08,0.00
2024-12-08 14:55:14,122,3644,50,72,2105.60,3860.72,0.00
2024-12-08 14:55:14,122,3645,50,72,2121.66,3861.00,0.00
2024-12-08 14:55:14,123,3645,50,73,2104.41,3861.01,0.00
2024-12-08 14:55:14,124,3644,50,74,2087.13,3861.03,0.00
2024-12-08 14:55:14,123,3644,50,73,2117.94,3861.11,0.00
2024-12-08 14:55:14,123,3645,50,73,2147.03,3862.00,0.00
2024-12-08 14:55:14,124,3645,51,73,2129.71,3862.01,0.00
2024-12-08 14:55:14,123,3645,50,73,2143.29,3862.08,0.00
2024-12-08 14:55:14,124,3644,50,74,2093.64,3862.78,0.00
2024-12-08 14:55:14,125,3643,50,75,2079.72,3862.86,0.00
2024-12-08 14:55:14,125,3644,50,75,2139.80,3863.00,0.00
2024-12-08 14:55:14,126,3644,51,75,2122.82,3863.01,0.00
2024-12-08 14:55:14,126,3645,51,75,2162.29,3864.00,0.00
2024-12-08 14:55:14,127,3645,51,76,2145.27,3864.01,0.00
2024-12-08 14:55:14,127,3646,51,76,2119.65,3865.00,0.00
2024-12-08 14:55:14,128,3646,52,76,2103.09,3865.01,0.00
2024-12-08 14:55:14,127,3646,52,75,2116.03,3865.09,0.00
2024-12-08 14:55:14,126,3646,51,75,2107.35,3865.76,0.00
2024-12-08 14:55:14,127,3645,51,76,2087.78,3865.85,0.00
2024-12-08 14:55:14,127,3646,51,76,2104.04,3866.00,0.00
2024-12-08 14:55:14,128,3646,52,76,2087.61,3866.01,0.00
2024-12-08 14:55:14,129,3645,52,77,2071.13,3866.03,0.00
2024-12-08 14:55:14,128,3645,52,76,2090.76,3866.11,0.00
2024-12-08 14:55:14,129,3644,52,77,2068.31,3866.29,0.00
2024-12-08 14:55:14,128,3644,51,77,2091.52,3866.50,0.00
2024-12-08 14:55:14,128,3645,51,77,2132.96,3867.00,0.00
2024-12-08 14:55:14,129,3645,51,78,2116.43,3867.01,0.00
2024-12-08 14:55:14,128,3645,50,78,2129.97,3867.08,0.00
2024-12-08 14:55:14,127,3645,50,77,2143.09,3867.09,0.00
2024-12-08 14:55:14,126,3645,49,77,2151.28,3867.33,0.00
2024-12-08 14:55:14,126,3646,49,77,2205.45,3868.00,0.00
2024-12-08 14:55:14,127,3646,49,78,2188.08,3868.01,0.00
2024-12-08 14:55:14,126,3646,49,77,2199.03,3868.10,0.00
2024-12-08 14:55:14,126,3647,49,77,2182.99,3869.00,0.00
2024-12-08 14:55:14,127,3647,50,77,2165.80,3869.01,0.00
2024-12-08 14:55:14,127,3648,50,77,2145.21,3870.00,0.00
2024-12-08 14:55:14,128,3648,50,78,2128.45,3870.01,0.00
2024-12-08 14:55:14,129,3647,51,78,2077.77,3870.76,0.00
2024-12-08 14:55:15,129,3648,51,78,2089.70,3871.00,0.00
2024-12-08 14:55:15,130,3648,51,79,2073.62,3871.01,0.00
2024-12-08 14:55:15,129,3648,50,79,2086.73,3871.08,0.00
2024-12-08 14:55:15,128,3648,50,78,2100.00,3871.09,0.00
2024-12-08 14:55:15,128,3649,50,78,2113.53,3872.00,0.00
2024-12-08 14:55:15,129,3649,50,79,2097.14,3872.01,0.00
2024-12-08 14:55:15,130,3648,50,80,2080.13,3872.05,0.00
2024-12-08 14:55:15,129,3648,49,80,2117.27,3872.05,0.00
2024-12-08 14:55:15,128,3648,49,79,2130.20,3872.09,0.00
2024-12-08 14:55:15,128,3649,49,79,2125.57,3873.00,0.00
2024-12-08 14:55:15,129,3649,49,80,2109.09,3873.01,0.00
2024-12-08 14:55:15,128,3649,49,79,2119.25,3873.09,0.00
2024-12-08 14:55:15,127,3649,48,79,2134.94,3873.12,0.00
2024-12-08 14:55:15,126,3649,47,79,2139.39,3873.39,0.00
2024-12-08 14:55:15,126,3650,47,79,2177.61,3874.00,0.00
2024-12-08 14:55:15,127,3650,48,79,2160.46,3874.01,0.00
2024-12-08 14:55:15,126,3650,48,78,2171.19,3874.10,0.00
2024-12-08 14:55:15,125,3650,47,78,2155.34,3874.68,0.00
2024-12-08 14:55:15,126,3649,48,78,2136.43,3874.74,0.00
2024-12-08 14:55:15,126,3650,48,78,2159.72,3875.00,0.00
2024-12-08 14:55:15,127,3650,49,78,2142.71,3875.01,0.00
2024-12-08 14:55:15,126,3650,48,78,2137.03,3875.22,0.00
2024-12-08 14:55:15,126,3651,48,78,2168.89,3876.00,0.00
2024-12-08 14:55:15,127,3651,48,79,2151.81,3876.01,0.00
2024-12-08 14:55:15,126,3651,48,78,2163.39,3876.10,0.00
2024-12-08 14:55:15,126,3652,48,78,2147.60,3877.00,0.00
2024-12-08 14:55:15,127,3652,48,79,2130.69,3877.01,0.00
2024-12-08 14:55:15,126,3652,47,79,2142.10,3877.10,0.00
2024-12-08 14:55:15,125,3652,47,78,2156.44,3877.10,0.00
2024-12-08 14:55:15,126,3651,48,78,2121.05,3877.59,0.00
2024-12-08 14:55:15,126,3652,48,78,2146.92,3878.00,0.00
2024-12-08 14:55:15,127,3652,48,79,2130.02,3878.01,0.00
2024-12-08 14:55:15,128,3651,48,80,2097.96,3878.11,0.00
2024-12-08 14:55:15,127,3651,48,79,2123.34,3878.11,0.00
2024-12-08 14:55:15,128,3650,48,80,2092.34,3878.50,0.00
2024-12-08 14:55:15,128,3651,48,80,2147.26,3879.00,0.00
2024-12-08 14:55:15,129,3651,48,81,2130.61,3879.01,0.00
2024-12-08 14:55:15,128,3651,47,81,2145.75,3879.02,0.00
2024-12-08 14:55:15,127,3651,47,80,2156.87,3879.09,0.00
2024-12-08 14:55:15,127,3652,47,80,2213.91,3880.00,0.00
2024-12-08 14:55:15,128,3652,48,80,2196.61,3880.01,0.00
2024-12-08 14:55:15,127,3652,48,79,2206.61,3880.09,0.00
2024-12-08 14:55:15,128,3651,49,79,2166.32,3880.71,0.00
2024-12-08 14:55:15,128,3652,49,79,2180.50,3881.00,0.00
2024-12-08 14:55:15,129,3652,49,80,2163.60,3881.01,0.00
2024-12-08 14:55:15,128,3652,48,80,2177.80,3881.07,0.00
2024-12-08 14:55:15,127,3652,48,79,2177.54,3881.09,0.00
2024-12-08 14:55:15,128,3651,49,79,2130.63,3881.89,0.00
2024-12-08 14:55:15,128,3652,49,79,2189.56,3882.00,0.00
2024-12-08 14:55:15,129,3652,50,79,2172.58,3882.01,0.00
2024-12-08 14:55:15,128,3652,49,79,2172.07,3882.31,0.00
2024-12-08 14:55:15,127,3652,48,79,2165.34,3882.84,0.00
2024-12-08 14:55:15,127,3653,48,79,2220.50,3883.00,0.00
2024-12-08 14:55:15,128,3653,48,80,2203.15,3883.01,0.00
2024-12-08 14:55:15,127,3653,47,80,2184.79,3883.77,0.00
2024-12-08 14:55:15,127,3654,47,80,2201.78,3884.00,0.00
2024-12-08 14:55:15,128,3654,48,80,2184.57,3884.01,0.00
2024-12-08 14:55:15,127,3654,47,80,2199.35,3884.06,0.00
2024-12-08 14:55:15,127,3655,47,80,2179.11,3885.00,0.00
2024-12-08 14:55:15,128,3655,48,80,2162.09,3885.01,0.00
2024-12-08 14:55:15,127,3655,47,80,2160.25,3885.33,0.00
2024-12-08 14:55:15,127,3656,47,80,2153.05,3886.00,0.00
2024-12-08 14:55:15,128,3656,48,80,2136.23,3886.01,0.00
2024-12-08 14:55:15,127,3656,48,79,2148.80,3886.11,0.00
2024-12-08 14:55:15,127,3657,48,79,2133.10,3887.00,0.00
2024-12-08 14:55:15,128,3657,48,80,2116.44,3887.01,0.00
2024-12-08 14:55:15,127,3657,47,80,2130.67,3887.06,0.00
2024-12-08 14:55:15,127,3658,47,80,2115.34,3888.00,0.00
2024-12-08 14:55:15,128,3658,48,80,2098.82,3888.01,0.00
2024-12-08 14:55:15,128,3659,48,80,2078.17,3889.00,0.00
2024-12-08 14:55:15,129,3659,49,80,2062.06,3889.01,0.00
2024-12-08 14:55:15,128,3659,48,80,2060.03,3889.31,0.00
2024-12-08 14:55:15,128,3660,48,80,2053.06,3890.00,0.00
2024-12-08 14:55:15,129,3660,49,80,2037.14,3890.01,0.00
2024-12-08 14:55:15,128,3660,49,79,2047.01,3890.10,0.00
2024-12-08 14:55:15,129,3659,49,80,2007.00,3890.74,0.00
2024-12-08 14:55:16,129,3660,49,80,2022.59,3891.00,0.00
2024-12-08 14:55:16,130,3660,50,80,2007.03,3891.01,0.00
2024-12-08 14:55:16,129,3660,50,79,2015.98,3891.10,0.00
2024-12-08 14:55:16,130,3659,51,79,1990.36,3891.38,0.00
2024-12-08 14:55:16,129,3659,50,79,2005.42,3891.78,0.00
2024-12-08 14:55:16,129,3660,50,79,2057.48,3892.00,0.00
2024-12-08 14:55:16,130,3660,51,79,2041.65,3892.01,0.00
2024-12-08 14:55:16,129,3660,51,78,2049.05,3892.12,0.00
2024-12-08 14:55:16,128,3660,50,78,2056.92,3892.34,0.00
2024-12-08 14:55:16,127,3660,49,78,2073.11,3892.34,0.00
2024-12-08 14:55:16,126,3660,48,78,2084.97,3892.41,0.00
2024-12-08 14:55:16,126,3661,48,78,2124.00,3893.00,0.00
2024-12-08 14:55:16,127,3661,49,78,2107.27,3893.01,0.00
2024-12-08 14:55:16,126,3661,49,77,2121.54,3893.06,0.00
2024-12-08 14:55:16,125,3661,49,76,2137.90,3893.06,0.00
2024-12-08 14:55:16,125,3662,49,76,2120.67,3894.00,0.00
2024-12-08 14:55:16,126,3662,49,77,2103.84,3894.01,0.00
2024-12-08 14:55:16,125,3662,49,76,2118.20,3894.06,0.00
2024-12-08 14:55:16,125,3663,49,76,2100.96,3895.00,0.00
2024-12-08 14:55:16,126,3663,49,77,2084.28,3895.01,0.00
2024-12-08 14:55:16,125,3663,49,76,2094.75,3895.10,0.00
2024-12-08 14:55:16,124,3663,48,76,2104.78,3895.27,0.00
2024-12-08 14:55:16,124,3664,48,76,2095.51,3896.00,0.00
2024-12-08 14:55:16,125,3664,48,77,2078.74,3896.01,0.00
2024-12-08 14:55:16,124,3664,47,77,2093.02,3896.06,0.00
2024-12-08 14:55:16,123,3664,46,77,2069.75,3896.78,0.00
2024-12-08 14:55:16,123,3665,46,77,2093.05,3897.00,0.00
2024-12-08 14:55:16,124,3665,46,78,2076.17,3897.01,0.00
2024-12-08 14:55:16,123,3665,46,77,2090.53,3897.07,0.00
2024-12-08 14:55:16,122,3665,45,77,2095.37,3897.21,0.00
2024-12-08 14:55:16,121,3665,44,77,2097.39,3897.40,0.00
2024-12-08 14:55:16,120,3665,43,77,2096.68,3897.87,0.00
2024-12-08 14:55:16,120,3666,43,77,2124.06,3898.00,0.00
2024-12-08 14:55:16,121,3666,44,77,2106.51,3898.01,0.00
2024-12-08 14:55:16,120,3666,43,77,2123.74,3898.01,0.00
2024-12-08 14:55:16,119,3666,43,76,2135.38,3898.08,0.00
2024-12-08 14:55:16,118,3666,42,76,2149.19,3898.09,0.00
2024-12-08 14:55:16,118,3667,42,76,2147.40,3899.00,0.00
2024-12-08 14:55:16,119,3667,42,77,2129.36,3899.01,0.00
2024-12-08 14:55:16,118,3667,42,76,2141.81,3899.08,0.00
2024-12-08 14:55:16,119,3666,43,76,2118.27,3899.24,0.00
2024-12-08 14:55:16,118,3666,42,76,2146.85,3899.35,0.00
2024-12-08 14:55:16,118,3667,42,76,2141.67,3900.00,0.00
2024-12-08 14:55:16,119,3667,43,76,2123.68,3900.01,0.00
2024-12-08 14:55:16,119,3668,43,76,2138.34,3901.00,0.00
2024-12-08 14:55:16,120,3668,44,76,2120.52,3901.01,0.00
2024-12-08 14:55:16,119,3668,44,75,2136.07,3901.06,0.00
2024-12-08 14:55:16,119,3669,44,75,2114.89,3902.00,0.00
2024-12-08 14:55:16,120,3669,45,75,2097.26,3902.01,0.00
2024-12-08 14:55:16,119,3669,44,75,2112.61,3902.06,0.00
2024-12-08 14:55:16,118,3669,44,74,2125.89,3902.06,0.00
2024-12-08 14:55:16,118,3670,44,74,2109.54,3903.00,0.00
2024-12-08 14:55:16,119,3670,44,75,2091.81,3903.01,0.00
2024-12-08 14:55:16,118,3670,44,74,2104.93,3903.06,0.00
2024-12-08 14:55:16,118,3671,44,74,2088.58,3904.00,0.00
2024-12-08 14:55:16,119,3671,44,75,2071.03,3904.01,0.00
2024-12-08 14:55:16,118,3671,44,74,2082.32,3904.08,0.00
2024-12-08 14:55:16,119,3670,44,75,2053.75,3904.38,0.00
2024-12-08 14:55:16,119,3671,44,75,2067.95,3905.00,0.00
2024-12-08 14:55:16,120,3671,44,76,2050.71,3905.01,0.00
2024-12-08 14:55:16,119,3671,44,75,2060.43,3905.10,0.00
2024-12-08 14:55:16,118,3671,43,75,2066.68,3905.25,0.00
2024-12-08 14:55:16,119,3670,44,75,2034.75,3905.65,0.00
2024-12-08 14:55:16,119,3671,44,75,2097.69,3906.00,0.00
2024-12-08 14:55:16,120,3671,44,76,2080.21,3906.01,0.00
2024-12-08 14:55:16,119,3671,44,75,2089.84,3906.11,0.00
2024-12-08 14:55:16,118,3671,43,75,2106.20,3906.14,0.00
2024-12-08 14:55:16,119,3670,44,75,2085.90,3906.23,0.00
2024-12-08 14:55:16,118,3670,43,75,2109.25,3906.31,0.00
2024-12-08 14:55:16,119,3669,43,76,2061.90,3906.76,0.00
2024-12-08 14:55:16,119,3670,43,76,2126.11,3907.00,0.00
2024-12-08 14:55:16,120,3670,44,76,2108.39,3907.01,0.00
2024-12-08 14:55:16,119,3670,44,75,2120.22,3907.08,0.00
2024-12-08 14:55:16,120,3669,44,76,2100.93,3907.14,0.00
2024-12-08 14:55:16,121,3668,45,76,2104.30,3907.31,0.00
2024-12-08 14:55:16,121,3669,45,76,2175.79,3908.00,0.00
2024-12-08 14:55:16,122,3669,46,76,2157.96,3908.01,0.00
2024-12-08 14:55:16,121,3669,46,75,2171.62,3908.07,0.00
2024-12-08 14:55:16,122,3668,46,76,2128.52,3908.74,0.00
2024-12-08 14:55:16,122,3669,46,76,2221.95,3909.00,0.00
2024-12-08 14:55:16,123,3669,47,76,2203.89,3909.01,0.00
2024-12-08 14:55:16,122,3669,47,75,2216.85,3909.07,0.00
2024-12-08 14:55:16,122,3670,47,75,2232.46,3910.00,0.00
2024-12-08 14:55:16,123,3670,47,76,2214.31,3910.01,0.00
2024-12-08 14:55:16,122,3670,47,75,2226.71,3910.08,0.00
2024-12-08 14:55:16,121,3670,46,75,2223.01,3910.51,0.00
2024-12-08 14:55:17,121,3671,46,75,2236.62,3911.00,0.00
2024-12-08 14:55:17,122,3671,47,75,2218.28,3911.01,0.00
2024-12-08 14:55:17,121,3671,47,74,2230.82,3911.08,0.00
2024-12-08 14:55:17,121,3672,47,74,2214.88,3912.00,0.00
2024-12-08 14:55:17,122,3672,47,75,2196.72,3912.01,0.00
2024-12-08 14:55:17,121,3672,46,75,2178.40,3912.78,0.00
2024-12-08 14:55:17,121,3673,46,75,2199.52,3913.00,0.00
2024-12-08 14:55:17,122,3673,46,76,2181.49,3913.01,0.00
2024-12-08 14:55:17,122,3674,46,76,2165.12,3914.00,0.00
2024-12-08 14:55:17,123,3674,47,76,2147.52,3914.01,0.00
2024-12-08 14:55:17,122,3674,47,75,2162.57,3914.07,0.00
2024-12-08 14:55:17,122,3675,47,75,2145.58,3915.00,0.00
2024-12-08 14:55:17,123,3675,47,76,2128.13,3915.01,0.00
2024-12-08 14:55:17,123,3676,47,76,2103.96,3916.00,0.00
2024-12-08 14:55:17,124,3676,47,77,2086.99,3916.01,0.00
2024-12-08 14:55:17,123,3676,46,77,2103.01,3916.02,0.00
2024-12-08 14:55:17,124,3675,47,77,2084.80,3916.07,0.00
2024-12-08 14:55:17,123,3675,47,76,2129.14,3916.08,0.00
2024-12-08 14:55:17,123,3675,47,76,2112.78,3917.00,0.00
2024-12-08 14:55:17,124,3675,47,77,2095.74,3917.01,0.00
2024-12-08 14:55:17,123,3675,47,76,2107.39,3917.07,0.00
2024-12-08 14:55:17,122,3675,46,76,2105.55,3917.42,0.00
2024-12-08 14:55:17,122,3676,46,76,2147.36,3918.00,0.00
2024-12-08 14:55:17,123,3676,47,76,2129.90,3918.01,0.00
2024-12-08 14:55:17,122,3676,46,76,2146.72,3918.03,0.00
2024-12-08 14:55:17,122,3677,46,76,2131.55,3919.00,0.00
2024-12-08 14:55:17,123,3677,46,77,2114.22,3919.01,0.00
2024-12-08 14:55:17,123,3678,46,77,2096.32,3920.00,0.00
2024-12-08 14:55:17,124,3678,47,77,2079.42,3920.01,0.00
2024-12-08 14:55:17,124,3679,47,77,2056.97,3921.00,0.00
2024-12-08 14:55:17,125,3679,47,78,2040.51,3921.01,0.00
2024-12-08 14:55:17,124,3679,47,77,2048.77,3921.06,0.00
2024-12-08 14:55:17,124,3680,47,77,2031.55,3922.00,0.00
2024-12-08 14:55:17,125,3680,47,78,2015.30,3922.01,0.00
2024-12-08 14:55:17,124,3680,47,77,2027.15,3922.06,0.00
2024-12-08 14:55:17,123,3680,46,77,2027.42,3922.24,0.00
2024-12-08 14:55:17,124,3679,46,78,2003.87,3922.44,0.00
2024-12-08 14:55:17,124,3680,46,78,2031.44,3923.00,0.00
2024-12-08 14:55:17,125,3680,47,78,2015.19,3923.01,0.00
2024-12-08 14:55:17,124,3680,46,78,2029.25,3923.06,0.00
2024-12-08 14:55:17,123,3680,46,77,2043.19,3923.07,0.00
2024-12-08 14:55:17,122,3680,45,77,2026.12,3923.68,0.00
2024-12-08 14:55:17,122,3681,45,77,2078.13,3924.00,0.00
2024-12-08 14:55:17,123,3681,46,77,2061.24,3924.01,0.00
2024-12-08 14:55:17,122,3681,46,76,2073.65,3924.07,0.00
2024-12-08 14:55:17,122,3682,46,76,2056.79,3925.00,0.00
2024-12-08 14:55:17,123,3682,46,77,2040.07,3925.01,0.00
2024-12-08 14:55:17,123,3683,46,77,2023.07,3926.00,0.00
2024-12-08 14:55:17,124,3683,47,77,2006.75,3926.01,0.00
2024-12-08 14:55:17,123,3683,46,77,2022.75,3926.01,0.00
2024-12-08 14:55:17,123,3684,46,77,2002.28,3927.00,0.00
2024-12-08 14:55:17,124,3684,47,77,1986.13,3927.01,0.00
2024-12-08 14:55:17,125,3683,48,77,1951.80,3927.34,0.00
2024-12-08 14:55:17,124,3683,47,77,1970.02,3927.81,0.00
2024-12-08 14:55:17,124,3684,47,77,1982.05,3928.00,0.00
2024-12-08 14:55:17,125,3684,47,78,1966.19,3928.01,0.00
2024-12-08 14:55:17,124,3684,47,77,1978.58,3928.06,0.00
2024-12-08 14:55:17,124,3685,47,77,1993.01,3929.00,0.00
2024-12-08 14:55:17,125,3685,47,78,1977.06,3929.01,0.00
2024-12-08 14:55:17,126,3684,47,79,1961.07,3929.03,0.00
2024-12-08 14:55:17,125,3684,47,78,2002.55,3929.06,0.00
2024-12-08 14:55:17,125,3685,47,78,1987.94,3930.00,0.00
2024-12-08 14:55:17,126,3685,48,78,1972.16,3930.01,0.00
2024-12-08 14:55:17,127,3684,48,79,1933.89,3930.45,0.00
2024-12-08 14:55:17,126,3684,47,79,1965.72,3930.79,0.00
2024-12-08 14:55:17,126,3685,47,79,2014.84,3931.00,0.00
2024-12-08 14:55:17,127,3685,47,80,1998.97,3931.01,0.00
2024-12-08 14:55:17,127,3686,47,80,2006.74,3932.00,0.00
2024-12-08 14:55:17,128,3686,47,81,1991.06,3932.01,0.00
2024-12-08 14:55:17,127,3686,47,80,2000.26,3932.06,0.00
2024-12-08 14:55:17,127,3687,47,80,1982.16,3933.00,0.00
2024-12-08 14:55:17,128,3687,48,80,1966.68,3933.01,0.00
2024-12-08 14:55:17,127,3687,48,79,1979.71,3933.06,0.00
2024-12-08 14:55:17,126,3687,47,79,1993.86,3933.06,0.00
2024-12-08 14:55:17,126,3688,47,79,1988.72,3934.00,0.00
2024-12-08 14:55:17,127,3688,48,79,1973.06,3934.01,0.00
2024-12-08 14:55:17,126,3688,48,78,1986.25,3934.06,0.00
2024-12-08 14:55:17,125,3688,47,78,1987.78,3934.42,0.00
2024-12-08 14:55:18,125,3689,47,78,1984.05,3935.00,0.00
2024-12-08 14:55:18,126,3689,47,79,1968.30,3935.01,0.00
2024-12-08 14:55:18,125,3689,47,78,1980.30,3935.06,0.00
2024-12-08 14:55:18,126,3688,48,78,1922.14,3935.85,0.00
2024-12-08 14:55:18,126,3689,48,78,1952.25,3936.00,0.00
2024-12-08 14:55:18,127,3689,49,78,1936.88,3936.01,0.00
2024-12-08 14:55:18,126,3689,49,77,1948.52,3936.06,0.00
2024-12-08 14:55:18,126,3690,49,77,1962.12,3937.00,0.00
2024-12-08 14:55:18,127,3690,49,78,1946.67,3937.01,0.00
2024-12-08 14:55:18,126,3690,48,78,1959.95,3937.06,0.00
2024-12-08 14:55:18,125,3690,48,77,1973.43,3937.06,0.00
2024-12-08 14:55:18,124,3690,47,77,1975.80,3937.40,0.00
2024-12-08 14:55:18,123,3690,46,77,1976.89,3937.77,0.00
2024-12-08 14:55:18,123,3691,46,77,2000.12,3938.00,0.00
2024-12-08 14:55:18,124,3691,47,77,1983.99,3938.01,0.00
2024-12-08 14:55:18,124,3692,47,77,1967.10,3939.00,0.00
2024-12-08 14:55:18,125,3692,47,78,1951.37,3939.01,0.00
2024-12-08 14:55:18,125,3693,47,78,1931.57,3940.00,0.00
2024-12-08 14:55:18,126,3693,48,78,1916.24,3940.01,0.00
2024-12-08 14:55:18,127,3692,49,78,1888.78,3940.18,0.00
2024-12-08 14:55:18,126,3692,48,78,1920.13,3940.44,0.00
2024-12-08 14:55:18,125,3692,47,78,1935.17,3940.44,0.00
2024-12-08 14:55:18,124,3692,46,78,1929.15,3940.87,0.00
2024-12-08 14:55:18,124,3693,46,78,1955.95,3941.00,0.00
2024-12-08 14:55:18,125,3693,47,78,1940.30,3941.01,0.00
2024-12-08 14:55:18,124,3693,47,77,1951.20,3941.07,0.00
2024-12-08 14:55:18,124,3694,47,77,1965.98,3942.00,0.00
2024-12-08 14:55:18,125,3694,47,78,1950.25,3942.01,0.00
2024-12-08 14:55:18,125,3695,47,78,1932.58,3943.00,0.00
2024-12-08 14:55:18,126,3695,48,78,1917.25,3943.01,0.00
2024-12-08 14:55:18,125,3695,48,77,1930.08,3943.06,0.00
2024-12-08 14:55:18,126,3694,49,77,1892.05,3943.50,0.00
2024-12-08 14:55:18,126,3695,49,77,1912.54,3944.00,0.00
2024-12-08 14:55:18,127,3695,49,78,1897.48,3944.01,0.00
2024-12-08 14:55:18,126,3695,49,77,1903.17,3944.08,0.00
2024-12-08 14:55:18,125,3695,48,77,1878.18,3944.96,0.00
2024-12-08 14:55:18,125,3696,48,77,1939.74,3945.00,0.00
2024-12-08 14:55:18,126,3696,49,77,1924.35,3945.01,0.00
2024-12-08 14:55:18,125,3696,49,76,1935.03,3945.09,0.00
2024-12-08 14:55:18,124,3696,48,76,1943.34,3945.17,0.00
2024-12-08 14:55:18,123,3696,47,76,1948.64,3945.43,0.00
2024-12-08 14:55:18,123,3697,47,76,1958.63,3946.00,0.00
2024-12-08 14:55:18,124,3697,48,76,1942.84,3946.01,0.00
2024-12-08 14:55:18,123,3697,47,76,1956.09,3946.07,0.00
2024-12-08 14:55:18,122,3697,47,75,1971.80,3946.07,0.00
2024-12-08 14:55:18,121,3697,46,75,1974.08,3946.16,0.00
2024-12-08 14:55:18,121,3698,46,75,1973.90,3947.00,0.00
2024-12-08 14:55:18,122,3698,46,76,1957.72,3947.01,0.00
2024-12-08 14:55:18,121,3698,46,75,1970.00,3947.07,0.00
2024-12-08 14:55:18,122,3697,47,75,1941.01,3947.42,0.00
2024-12-08 14:55:18,122,3698,47,75,1957.24,3948.00,0.00
2024-12-08 14:55:18,123,3698,48,75,1941.33,3948.01,0.00
2024-12-08 14:55:18,122,3698,48,74,1954.67,3948.07,0.00
2024-12-08 14:55:18,123,3697,48,75,1921.84,3948.35,0.00
2024-12-08 14:55:18,124,3696,48,76,1925.17,3948.44,0.00
2024-12-08 14:55:18,125,3695,48,77,1901.68,3948.70,0.00
2024-12-08 14:55:18,125,3696,48,77,1960.32,3949.00,0.00
2024-12-08 14:55:18,126,3696,49,77,1944.76,3949.01,0.00
2024-12-08 14:55:18,125,3696,48,77,1958.44,3949.05,0.00
2024-12-08 14:55:18,126,3695,48,78,1908.42,3949.79,0.00
2024-12-08 14:55:18,126,3696,48,78,2027.86,3950.00,0.00
2024-12-08 14:55:18,127,3696,48,79,2011.90,3950.01,0.00
2024-12-08 14:55:18,126,3696,47,79,2006.35,3950.40,0.00
2024-12-08 14:55:18,126,3697,47,79,2039.37,3951.00,0.00
2024-12-08 14:55:18,127,3697,47,80,2023.31,3951.01,0.00
2024-12-08 14:55:18,126,3697,47,79,2037.19,3951.06,0.00
2024-12-08 14:55:18,126,3698,47,79,2014.85,3952.00,0.00
2024-12-08 14:55:18,127,3698,48,79,1998.98,3952.01,0.00
2024-12-08 14:55:18,126,3698,47,79,2012.67,3952.06,0.00
2024-12-08 14:55:18,125,3698,47,78,2024.98,3952.08,0.00
2024-12-08 14:55:18,125,3699,47,78,2008.08,3953.00,0.00
2024-12-08 14:55:18,126,3699,48,78,1992.14,3953.01,0.00
2024-12-08 14:55:18,125,3699,48,77,2006.82,3953.03,0.00
2024-12-08 14:55:18,124,3699,48,76,2021.74,3953.06,0.00
2024-12-08 14:55:18,123,3699,48,75,2037.86,3953.06,0.00
2024-12-08 14:55:18,123,3700,48,75,2015.63,3954.00,0.00
2024-12-08 14:55:18,124,3700,48,76,1999.37,3954.01,0.00
2024-12-08 14:55:19,123,3700,48,75,2010.82,3954.07,0.00
2024-12-08 14:55:19,124,3699,48,76,1971.25,3954.69,0.00
2024-12-08 14:55:19,124,3700,48,76,1987.76,3955.00,0.00
2024-12-08 14:55:19,125,3700,49,76,1971.86,3955.01,0.00
2024-12-08 14:55:19,124,3700,49,75,1985.54,3955.06,0.00
2024-12-08 14:55:19,123,3700,49,74,2001.36,3955.06,0.00
2024-12-08 14:55:19,122,3700,49,73,2016.47,3955.06,0.00
2024-12-08 14:55:19,123,3699,50,73,1952.61,3955.96,0.00
2024-12-08 14:55:19,123,3700,50,73,2016.65,3956.00,0.00
2024-12-08 14:55:19,124,3700,51,73,2000.38,3956.01,0.00
2024-12-08 14:55:19,123,3700,51,72,2013.45,3956.06,0.00
2024-12-08 14:55:19,122,3700,50,72,2011.80,3956.40,0.00
2024-12-08 14:55:19,122,3701,50,72,2053.37,3957.00,0.00
2024-12-08 14:55:19,123,3701,51,72,2036.68,3957.01,0.00
2024-12-08 14:55:19,123,3702,51,72,2019.76,3958.00,0.00
2024-12-08 14:55:19,124,3702,52,72,2003.48,3958.01,0.00
2024-12-08 14:55:19,124,3703,52,72,1983.74,3959.00,0.00
2024-12-08 14:55:19,125,3703,52,73,1967.87,3959.01,0.00
2024-12-08 14:55:19,126,3702,52,74,1930.06,3959.43,0.00
2024-12-08 14:55:19,126,3703,52,74,1945.97,3960.00,0.00
2024-12-08 14:55:19,127,3703,53,74,1930.64,3960.01,0.00
2024-12-08 14:55:19,126,3703,53,73,1943.78,3960.06,0.00
2024-12-08 14:55:19,125,3703,53,72,1956.80,3960.06,0.00
2024-12-08 14:55:19,124,3703,52,72,1948.08,3960.68,0.00
2024-12-08 14:55:19,125,3702,52,73,1923.49,3960.92,0.00
2024-12-08 14:55:19,125,3703,52,73,1973.30,3961.00,0.00
2024-12-08 14:55:19,126,3703,53,73,1957.64,3961.01,0.00
2024-12-08 14:55:19,125,3703,53,72,1971.09,3961.06,0.00
2024-12-08 14:55:19,124,3703,53,71,1986.67,3961.06,0.00
2024-12-08 14:55:19,123,3703,52,71,1989.01,3961.24,0.00
2024-12-08 14:55:19,123,3704,52,71,2023.61,3962.00,0.00
2024-12-08 14:55:19,124,3704,53,71,2007.29,3962.01,0.00
2024-12-08 14:55:19,123,3704,53,70,2021.37,3962.06,0.00
2024-12-08 14:55:19,122,3704,53,69,2037.61,3962.06,0.00
2024-12-08 14:55:19,121,3704,52,69,2042.75,3962.36,0.00
2024-12-08 14:55:19,121,3705,52,69,2037.27,3963.00,0.00
2024-12-08 14:55:19,122,3705,52,70,2020.57,3963.01,0.00
2024-12-08 14:55:19,121,3705,52,69,2034.66,3963.06,0.00
2024-12-08 14:55:19,120,3705,51,69,2050.62,3963.06,0.00
2024-12-08 14:55:19,120,3706,51,69,2046.83,3964.00,0.00
2024-12-08 14:55:19,121,3706,52,69,2029.92,3964.01,0.00
2024-12-08 14:55:19,120,3706,51,69,2044.84,3964.05,0.00
2024-12-08 14:55:19,120,3707,51,69,2034.11,3965.00,0.00
2024-12-08 14:55:19,121,3707,52,69,2017.30,3965.01,0.00
2024-12-08 14:55:19,120,3707,52,68,2030.49,3965.05,0.00
2024-12-08 14:55:19,119,3707,51,68,2034.65,3965.37,0.00
2024-12-08 14:55:19,119,3708,51,68,2030.06,3966.00,0.00
2024-12-08 14:55:19,120,3708,52,68,2013.14,3966.01,0.00
2024-12-08 14:55:19,119,3708,52,67,2022.56,3966.05,0.00
2024-12-08 14:55:19,118,3708,51,67,2022.36,3966.31,0.00
2024-12-08 14:55:19,118,3709,51,67,2029.18,3967.00,0.00
2024-12-08 14:55:19,119,3709,51,68,2012.13,3967.01,0.00
2024-12-08 14:55:19,118,3709,51,67,2020.11,3967.06,0.00
2024-12-08 14:55:19,117,3709,50,67,2025.60,3967.36,0.00
2024-12-08 14:55:19,117,3710,50,67,2024.32,3968.00,0.00
2024-12-08 14:55:19,118,3710,51,67,2007.16,3968.01,0.00
2024-12-08 14:55:19,117,3710,50,67,2012.30,3968.03,0.00
2024-12-08 14:55:19,116,3710,50,66,2024.17,3968.04,0.00
2024-12-08 14:55:19,115,3710,50,65,2041.43,3968.04,0.00
2024-12-08 14:55:19,114,3710,49,65,2046.55,3968.36,0.00
2024-12-08 14:55:19,114,3711,49,65,2056.36,3969.00,0.00
2024-12-08 14:55:19,115,3711,50,65,2038.48,3969.01,0.00
2024-12-08 14:55:19,114,3711,50,64,2054.28,3969.04,0.00
2024-12-08 14:55:19,114,3712,50,64,2037.73,3970.00,0.00
2024-12-08 14:55:19,115,3712,50,65,2020.01,3970.01,0.00
2024-12-08 14:55:19,116,3711,51,65,1951.17,3970.90,0.00
2024-12-08 14:55:19,116,3712,51,65,1984.80,3971.00,0.00
2024-12-08 14:55:19,117,3712,52,65,1967.84,3971.01,0.00
2024-12-08 14:55:19,116,3712,52,64,1978.31,3971.04,0.00
2024-12-08 14:55:19,115,3712,51,64,1988.78,3971.15,0.00
2024-12-08 14:55:19,115,3713,51,64,2024.48,3972.00,0.00
2024-12-08 14:55:19,116,3713,51,65,2007.03,3972.01,0.00
2024-12-08 14:55:19,115,3713,50,65,2024.14,3972.01,0.00
2024-12-08 14:55:19,114,3713,50,64,2037.37,3972.04,0.00
2024-12-08 14:55:19,113,3713,50,63,2055.05,3972.04,0.00
2024-12-08 14:55:19,113,3714,50,63,2038.33,3973.00,0.00
2024-12-08 14:55:19,114,3714,51,63,2020.45,3973.01,0.00
2024-12-08 14:55:20,113,3714,51,62,2036.93,3973.04,0.00
2024-12-08 14:55:20,112,3714,51,61,2051.23,3973.08,0.00
2024-12-08 14:55:20,111,3714,50,61,2056.92,3973.31,0.00
2024-12-08 14:55:20,111,3715,50,61,2065.59,3974.00,0.00
2024-12-08 14:55:20,112,3715,51,61,2047.14,3974.01,0.00
2024-12-08 14:55:20,113,3714,51,62,1990.35,3974.83,0.00
2024-12-08 14:55:20,113,3715,51,62,2027.94,3975.00,0.00
2024-12-08 14:55:20,114,3715,51,63,2010.15,3975.01,0.00
2024-12-08 14:55:20,114,3716,51,63,2027.78,3976.00,0.00
2024-12-08 14:55:20,115,3716,51,64,2010.15,3976.01,0.00
2024-12-08 14:55:20,114,3716,51,63,2026.05,3976.04,0.00
2024-12-08 14:55:20,113,3716,51,62,2042.57,3976.05,0.00
2024-12-08 14:55:20,112,3716,50,62,2045.54,3976.44,0.00
2024-12-08 14:55:20,111,3716,49,62,2053.67,3976.70,0.00
2024-12-08 14:55:20,111,3717,49,62,2063.57,3977.00,0.00
2024-12-08 14:55:20,112,3717,49,63,2045.15,3977.01,0.00
2024-12-08 14:55:20,111,3717,49,62,2062.50,3977.03,0.00
2024-12-08 14:55:20,110,3717,49,61,2080.53,3977.04,0.00
2024-12-08 14:55:20,110,3718,49,61,2059.48,3978.00,0.00
2024-12-08 14:55:20,111,3718,49,62,2040.92,3978.01,0.00
2024-12-08 14:55:20,110,3718,48,62,2058.76,3978.02,0.00
2024-12-08 14:55:20,109,3718,48,61,2073.27,3978.03,0.00
2024-12-08 14:55:20,110,3717,49,61,2052.27,3978.10,0.00
2024-12-08 14:55:20,111,3716,49,62,2013.74,3978.89,0.00
2024-12-08 14:55:20,111,3717,49,62,2034.63,3979.00,0.00
2024-12-08 14:55:20,112,3717,49,63,2016.46,3979.01,0.00
2024-12-08 14:55:20,111,3717,49,62,2033.56,3979.03,0.00
2024-12-08 14:55:20,110,3717,49,61,2047.72,3979.05,0.00
2024-12-08 14:55:20,109,3717,48,61,2034.96,3979.60,0.00
2024-12-08 14:55:20,109,3718,48,61,2128.71,3980.00,0.00
2024-12-08 14:55:20,110,3718,48,62,2109.36,3980.01,0.00
2024-12-08 14:55:20,109,3718,48,61,2122.17,3980.07,0.00
2024-12-08 14:55:20,108,3718,47,61,2124.14,3980.31,0.00
2024-12-08 14:55:20,109,3717,48,61,2092.39,3980.63,0.00
2024-12-08 14:55:20,110,3716,49,61,2078.90,3980.79,0.00
2024-12-08 14:55:20,110,3717,49,61,2113.82,3981.00,0.00
2024-12-08 14:55:20,111,3717,49,62,2094.77,3981.01,0.00
2024-12-08 14:55:20,110,3717,48,62,2106.97,3981.08,0.00
2024-12-08 14:55:20,109,3717,48,61,2121.18,3981.08,0.00
2024-12-08 14:55:20,108,3717,47,61,2132.41,3981.30,0.00
2024-12-08 14:55:20,108,3718,47,61,2215.44,3982.00,0.00
2024-12-08 14:55:20,109,3718,48,61,2195.12,3982.01,0.00
2024-12-08 14:55:20,108,3718,48,60,2205.89,3982.10,0.00
2024-12-08 14:55:20,108,3719,48,60,2192.77,3983.00,0.00
2024-12-08 14:55:20,109,3719,48,61,2172.65,3983.01,0.00
2024-12-08 14:55:20,108,3719,48,60,2191.30,3983.04,0.00
2024-12-08 14:55:20,107,3719,48,59,2202.87,3983.10,0.00
2024-12-08 14:55:20,106,3719,47,59,2189.34,3983.66,0.00
2024-12-08 14:55:20,105,3719,46,59,2201.81,3983.88,0.00
2024-12-08 14:55:20,106,3718,46,60,2181.04,3983.89,0.00
2024-12-08 14:55:20,106,3719,46,60,2217.23,3984.00,0.00
2024-12-08 14:55:20,107,3719,47,60,2196.51,3984.01,0.00
2024-12-08 14:55:20,108,3718,48,60,2142.16,3984.70,0.00
2024-12-08 14:55:20,108,3719,48,60,2204.87,3985.00,0.00
2024-12-08 14:55:20,109,3719,49,60,2184.64,3985.01,0.00
2024-12-08 14:55:20,110,3718,50,60,2136.00,3985.57,0.00
2024-12-08 14:55:20,109,3718,49,60,2152.96,3985.68,0.00
2024-12-08 14:55:20,108,3718,48,60,2170.36,3985.75,0.00
2024-12-08 14:55:20,108,3719,48,60,2227.08,3986.00,0.00
2024-12-08 14:55:20,109,3719,49,60,2206.65,3986.01,0.00
2024-12-08 14:55:20,109,3720,49,60,2220.90,3987.00,0.00
2024-12-08 14:55:20,110,3720,50,60,2200.71,3987.01,0.00
2024-12-08 14:55:20,109,3720,50,59,2212.86,3987.03,0.00
2024-12-08 14:55:20,109,3721,50,59,2196.58,3988.00,0.00
2024-12-08 14:55:20,110,3721,51,59,2176.61,3988.01,0.00
2024-12-08 14:55:20,109,3721,50,59,2195.13,3988.04,0.00
2024-12-08 14:55:20,108,3721,50,58,2208.82,3988.09,0.00
2024-12-08 14:55:20,109,3720,51,58,2167.55,3988.64,0.00
2024-12-08 14:55:20,109,3721,51,58,2201.52,3989.00,0.00
2024-12-08 14:55:20,110,3721,51,59,2181.50,3989.01,0.00
2024-12-08 14:55:20,109,3721,51,58,2192.39,3989.09,0.00
2024-12-08 14:55:20,109,3722,51,58,2215.25,3990.00,0.00
2024-12-08 14:55:20,110,3722,51,59,2195.11,3990.01,0.00
2024-12-08 14:55:20,109,3722,51,58,2206.49,3990.09,0.00
2024-12-08 14:55:20,108,3722,50,58,2220.20,3990.26,0.00
2024-12-08 14:55:20,109,3721,51,58,2199.47,3990.28,0.00
2024-12-08 14:55:20,109,3722,51,58,2229.61,3991.00,0.00
2024-12-08 14:55:20,110,3722,52,58,2209.34,3991.01,0.00
2024-12-08 14:55:20,109,3722,51,58,2227.80,3991.05,0.00
2024-12-08 14:55:21,108,3722,51,57,2241.40,3991.08,0.00
2024-12-08 14:55:21,108,3723,51,57,2264.49,3992.00,0.00
2024-12-08 14:55:21,109,3723,52,57,2243.71,3992.01,0.00
2024-12-08 14:55:21,108,3723,52,56,2256.01,3992.08,0.00
2024-12-08 14:55:21,107,3723,51,56,2259.67,3992.41,0.00
2024-12-08 14:55:21,107,3724,51,56,2273.91,3993.00,0.00
2024-12-08 14:55:21,108,3724,52,56,2252.86,3993.01,0.00
2024-12-08 14:55:21,107,3724,52,55,2265.72,3993.08,0.00
2024-12-08 14:55:21,107,3725,52,55,2252.08,3994.00,0.00
2024-12-08 14:55:21,108,3725,52,56,2231.23,3994.01,0.00
2024-12-08 14:55:21,107,3725,52,55,2243.89,3994.08,0.00
2024-12-08 14:55:21,106,3725,51,55,2256.84,3994.29,0.00
2024-12-08 14:55:21,106,3726,51,55,2251.66,3995.00,0.00
2024-12-08 14:55:21,107,3726,52,55,2230.62,3995.01,0.00
2024-12-08 14:55:21,106,3726,52,54,2249.80,3995.05,0.00
2024-12-08 14:55:21,105,3726,52,53,2264.76,3995.08,0.00
2024-12-08 14:55:21,105,3727,52,53,2251.22,3996.00,0.00
2024-12-08 14:55:21,106,3727,52,54,2229.99,3996.01,0.00
2024-12-08 14:55:21,105,3727,52,53,2249.34,3996.05,0.00
2024-12-08 14:55:21,104,3727,52,52,2262.90,3996.09,0.00
2024-12-08 14:55:21,103,3727,51,52,2274.86,3996.31,0.00
2024-12-08 14:55:21,103,3728,51,52,2286.59,3997.00,0.00
2024-12-08 14:55:21,104,3728,51,53,2264.60,3997.01,0.00
2024-12-08 14:55:21,103,3728,51,52,2276.91,3997.09,0.00
2024-12-08 14:55:21,103,3729,51,52,2264.26,3998.00,0.00
2024-12-08 14:55:21,104,3729,51,53,2242.48,3998.01,0.00
2024-12-08 14:55:21,103,3729,50,53,2262.33,3998.05,0.00
2024-12-08 14:55:21,102,3729,50,52,2276.29,3998.08,0.00
2024-12-08 14:55:21,102,3730,50,52,2263.50,3999.00,0.00
2024-12-08 14:55:21,103,3730,50,53,2241.53,3999.01,0.00
2024-12-08 14:55:21,103,3731,50,53,2224.00,4000.00,0.00
2024-12-08 14:55:21,104,3731,51,53,2202.61,4000.01,0.00
2024-12-08 14:55:21,103,3731,50,53,2169.56,4000.92,0.00
2024-12-08 14:55:21,103,3732,50,53,2205.36,4001.00,0.00
2024-12-08 14:55:21,104,3732,50,54,2184.15,4001.01,0.00
2024-12-08 14:55:21,103,3732,50,53,2199.55,4001.08,0.00
2024-12-08 14:55:21,102,3732,49,53,2212.16,4001.29,0.00
2024-12-08 14:55:21,103,3731,49,54,2180.32,4001.57,0.00
2024-12-08 14:55:21,103,3732,49,54,2205.02,4002.00,0.00
2024-12-08 14:55:21,104,3732,50,54,2183.82,4002.01,0.00
2024-12-08 14:55:21,103,3732,49,54,2203.10,4002.05,0.00
2024-12-08 14:55:21,102,3732,48,54,2196.10,4002.24,0.00
2024-12-08 14:55:21,102,3733,48,54,2244.46,4003.00,0.00
2024-12-08 14:55:21,103,3733,48,55,2222.67,4003.01,0.00
2024-12-08 14:55:21,102,3733,48,54,2236.24,4003.09,0.00
2024-12-08 14:55:21,102,3734,48,54,2223.83,4004.00,0.00
2024-12-08 14:55:21,103,3734,49,54,2202.24,4004.01,0.00
2024-12-08 14:55:21,102,3734,49,53,2213.64,4004.09,0.00
2024-12-08 14:55:21,102,3735,49,53,2201.22,4005.00,0.00
2024-12-08 14:55:21,103,3735,49,54,2179.84,4005.01,0.00
2024-12-08 14:55:21,102,3735,49,53,2191.03,4005.09,0.00
2024-12-08 14:55:21,102,3736,49,53,2178.59,4006.00,0.00
2024-12-08 14:55:21,103,3736,49,54,2157.44,4006.01,0.00
2024-12-08 14:55:21,102,3736,49,53,2168.79,4006.09,0.00
2024-12-08 14:55:21,103,3735,49,54,2118.94,4006.84,0.00
2024-12-08 14:55:21,103,3736,49,54,2142.03,4007.00,0.00
2024-12-08 14:55:21,104,3736,49,55,2121.43,4007.01,0.00
2024-12-08 14:55:21,103,3736,49,54,2138.93,4007.05,0.00
2024-12-08 14:55:21,103,3737,49,54,2163.58,4008.00,0.00
2024-12-08 14:55:21,104,3737,49,55,2142.77,4008.01,0.00
2024-12-08 14:55:21,103,3737,49,54,2153.48,4008.09,0.00
2024-12-08 14:55:21,102,3737,48,54,2162.13,4008.39,0.00
2024-12-08 14:55:21,102,3738,48,54,2161.75,4009.00,0.00
2024-12-08 14:55:21,103,3738,48,55,2140.76,4009.01,0.00
2024-12-08 14:55:21,102,3738,48,54,2150.38,4009.10,0.00
2024-12-08 14:55:21,102,3739,48,54,2138.31,4010.00,0.00
2024-12-08 14:55:21,103,3739,49,54,2117.55,4010.01,0.00
2024-12-08 14:55:21,102,3739,48,54,2114.44,4010.41,0.00
2024-12-08 14:55:21,102,3740,48,54,2119.15,4011.00,0.00
2024-12-08 14:55:22,103,3740,48,55,2098.58,4011.01,0.00
2024-12-08 14:55:22,102,3740,47,55,2117.20,4011.05,0.00
2024-12-08 14:55:22,101,3740,47,54,2129.04,4011.09,0.00
2024-12-08 14:55:22,101,3741,47,54,2116.83,4012.00,0.00
2024-12-08 14:55:22,102,3741,47,55,2096.08,4012.01,0.00
2024-12-08 14:55:22,101,3741,47,54,2105.73,4012.10,0.00
2024-12-08 14:55:22,100,3741,46,54,2088.96,4012.71,0.00
2024-12-08 14:55:22,100,3742,46,54,2117.67,4013.00,0.00
2024-12-08 14:55:22,101,3742,47,54,2096.70,4013.01,0.00
2024-12-08 14:55:22,100,3742,47,53,2106.45,4013.10,0.00
2024-12-08 14:55:22,99,3742,46,53,2118.88,4013.31,0.00
2024-12-08 14:55:22,100,3741,47,53,2089.37,4013.54,0.00
2024-12-08 14:55:22,100,3742,47,53,2126.22,4014.00,0.00
2024-12-08 14:55:22,101,3742,48,53,2105.17,4014.01,0.00
2024-12-08 14:55:22,100,3742,47,53,2123.42,4014.07,0.00
2024-12-08 14:55:22,99,3742,47,52,2136.37,4014.09,0.00
2024-12-08 14:55:22,99,3743,47,52,2165.27,4015.00,0.00
2024-12-08 14:55:22,100,3743,47,53,2143.61,4015.01,0.00
2024-12-08 14:55:22,99,3743,46,53,2122.27,4015.83,0.00
2024-12-08 14:55:22,99,3744,46,53,2156.07,4016.00,0.00
2024-12-08 14:55:22,100,3744,46,54,2134.51,4016.01,0.00
2024-12-08 14:55:22,99,3744,45,54,2154.05,4016.05,0.00
2024-12-08 14:55:22,98,3744,45,53,2166.21,4016.09,0.00
2024-12-08 14:55:22,97,3744,44,53,2179.85,4016.09,0.00
2024-12-08 14:55:22,97,3745,44,53,2185.34,4017.00,0.00
2024-12-08 14:55:22,98,3745,44,54,2163.04,4017.01,0.00
2024-12-08 14:55:22,97,3745,44,53,2183.28,4017.05,0.00
2024-12-08 14:55:22,96,3745,44,52,2204.36,4017.08,0.00
2024-12-08 14:55:22,95,3745,43,52,2223.97,4017.17,0.00
2024-12-08 14:55:22,96,3744,44,52,2200.39,4017.20,0.00
2024-12-08 14:55:22,95,3744,43,52,2228.69,4017.34,0.00
2024-12-08 14:55:22,95,3745,43,52,2244.78,4018.00,0.00
2024-12-08 14:55:22,96,3745,44,52,2221.40,4018.01,0.00
2024-12-08 14:55:22,95,3745,43,52,2203.58,4018.57,0.00
2024-12-08 14:55:22,95,3746,43,52,2271.14,4019.00,0.00
2024-12-08 14:55:22,96,3746,44,52,2247.49,4019.01,0.00
2024-12-08 14:55:22,95,3746,44,51,2267.78,4019.08,0.00
2024-12-08 14:55:22,95,3747,44,51,2256.90,4020.00,0.00
2024-12-08 14:55:22,96,3747,45,51,2233.39,4020.01,0.00
2024-12-08 14:55:22,95,3747,44,51,2235.84,4020.31,0.00
2024-12-08 14:55:22,95,3748,44,51,2250.69,4021.00,0.00
2024-12-08 14:55:22,96,3748,45,51,2227.24,4021.01,0.00
2024-12-08 14:55:22,95,3748,45,50,2246.48,4021.10,0.00
2024-12-08 14:55:22,95,3749,45,50,2236.01,4022.00,0.00
2024-12-08 14:55:22,96,3749,46,50,2212.71,4022.01,0.00
2024-12-08 14:55:22,95,3749,45,50,2197.00,4022.77,0.00
2024-12-08 14:55:22,95,3750,45,50,2213.27,4023.00,0.00
2024-12-08 14:55:22,96,3750,45,51,2190.22,4023.01,0.00
2024-12-08 14:55:22,95,3750,45,50,2208.63,4023.11,0.00
2024-12-08 14:55:22,95,3751,45,50,2198.57,4024.00,0.00
2024-12-08 14:55:22,96,3751,45,51,2175.67,4024.01,0.00
2024-12-08 14:55:22,96,3752,45,51,2166.60,4025.00,0.00
2024-12-08 14:55:22,97,3752,46,51,2144.26,4025.01,0.00
2024-12-08 14:55:22,97,3753,46,51,2133.41,4026.00,0.00
2024-12-08 14:55:22,98,3753,46,52,2111.64,4026.01,0.00
2024-12-08 14:55:22,97,3753,45,52,2111.43,4026.12,0.00
2024-12-08 14:55:22,97,3754,45,52,2118.16,4027.00,0.00
2024-12-08 14:55:22,98,3754,45,53,2096.55,4027.01,0.00
2024-12-08 14:55:22,97,3754,45,52,2113.62,4027.11,0.00
2024-12-08 14:55:22,97,3755,45,52,2103.00,4028.00,0.00
2024-12-08 14:55:22,98,3755,46,52,2081.54,4028.01,0.00
2024-12-08 14:55:23,98,3756,46,52,2060.17,4029.00,0.00
2024-12-08 14:55:23,99,3756,46,53,2039.36,4029.01,0.00
2024-12-08 14:55:23,98,3756,45,53,2059.76,4029.01,0.00
2024-12-08 14:55:23,97,3756,45,52,2078.93,4029.05,0.00
2024-12-08 14:55:23,96,3756,45,51,2094.71,4029.10,0.00
2024-12-08 14:55:23,96,3757,45,51,2084.30,4030.00,0.00
2024-12-08 14:55:23,97,3757,46,51,2062.81,4030.01,0.00
2024-12-08 14:55:23,96,3757,45,51,2083.88,4030.01,0.00
2024-12-08 14:55:23,95,3757,45,50,2094.80,4030.08,0.00
2024-12-08 14:55:23,96,3756,45,51,2066.73,4030.26,0.00
2024-12-08 14:55:23,96,3757,45,51,2083.98,4031.00,0.00
2024-12-08 14:55:23,97,3757,45,52,2062.49,4031.01,0.00
2024-12-08 14:55:23,96,3757,45,51,2073.50,4031.08,0.00
2024-12-08 14:55:23,96,3758,45,51,2104.24,4032.00,0.00
2024-12-08 14:55:23,97,3758,46,51,2082.54,4032.01,0.00
2024-12-08 14:55:23,96,3758,45,51,2102.19,4032.05,0.00
2024-12-08 14:55:23,95,3758,45,50,2115.83,4032.07,0.00
2024-12-08 14:55:23,94,3758,44,50,2124.27,4032.29,0.00
2024-12-08 14:55:23,94,3759,44,50,2138.86,4033.00,0.00
2024-12-08 14:55:23,95,3759,44,51,2116.35,4033.01,0.00
2024-12-08 14:55:23,96,3758,44,52,2093.06,4033.06,0.00
2024-12-08 14:55:23,95,3758,43,52,2134.63,4033.11,0.00
2024-12-08 14:55:23,95,3759,43,52,2141.50,4034.00,0.00
2024-12-08 14:55:23,96,3759,43,53,2119.20,4034.01,0.00
2024-12-08 14:55:23,95,3759,43,52,2129.21,4034.10,0.00
2024-12-08 14:55:23,95,3760,43,52,2161.15,4035.00,0.00
2024-12-08 14:55:23,96,3760,44,52,2138.63,4035.01,0.00
2024-12-08 14:55:23,95,3760,44,51,2158.20,4035.07,0.00
2024-12-08 14:55:23,95,3761,44,51,2145.88,4036.00,0.00
2024-12-08 14:55:23,96,3761,45,51,2123.52,4036.01,0.00
2024-12-08 14:55:23,96,3762,45,51,2102.10,4037.00,0.00
2024-12-08 14:55:23,97,3762,46,51,2080.43,4037.01,0.00
2024-12-08 14:55:23,96,3762,46,50,2094.56,4037.12,0.00
2024-12-08 14:55:23,95,3762,45,50,2114.92,4037.16,0.00
2024-12-08 14:55:23,95,3763,45,50,2106.90,4038.00,0.00
2024-12-08 14:55:23,96,3763,45,51,2084.95,4038.01,0.00
2024-12-08 14:55:23,96,3764,45,51,2062.32,4039.00,0.00
2024-12-08 14:55:23,97,3764,45,52,2041.06,4039.01,0.00
2024-12-08 14:55:23,96,3764,45,51,2057.73,4039.12,0.00
2024-12-08 14:55:23,95,3764,44,51,2062.92,4039.42,0.00
2024-12-08 14:55:23,94,3764,43,51,2070.45,4039.78,0.00
2024-12-08 14:55:23,94,3765,43,51,2104.58,4040.00,0.00
2024-12-08 14:55:23,95,3765,43,52,2082.42,4040.01,0.00
2024-12-08 14:55:23,96,3764,44,52,2043.55,4040.25,0.00
2024-12-08 14:55:23,95,3764,43,52,2043.59,4040.71,0.00
2024-12-08 14:55:23,95,3765,43,52,2074.43,4041.00,0.00
2024-12-08 14:55:23,96,3765,43,53,2052.82,4041.01,0.00
2024-12-08 14:55:23,95,3765,43,52,2065.52,4041.08,0.00
2024-12-08 14:55:23,94,3765,42,52,2080.31,4041.18,0.00
2024-12-08 14:55:23,94,3766,42,52,2133.66,4042.00,0.00
2024-12-08 14:55:23,95,3766,43,52,2111.20,4042.01,0.00
2024-12-08 14:55:23,94,3766,43,51,2128.52,4042.12,0.00
2024-12-08 14:55:23,94,3767,43,51,2119.13,4043.00,0.00
2024-12-08 14:55:23,95,3767,43,52,2096.82,4043.01,0.00
2024-12-08 14:55:23,94,3767,42,52,2113.26,4043.05,0.00
2024-12-08 14:55:23,94,3768,42,52,2109.90,4044.00,0.00
2024-12-08 14:55:23,95,3768,43,52,2087.69,4044.01,0.00
2024-12-08 14:55:23,94,3768,42,52,2082.12,4044.34,0.00
2024-12-08 14:55:23,94,3769,42,52,2098.87,4045.00,0.00
2024-12-08 14:55:23,95,3769,43,52,2076.78,4045.01,0.00
2024-12-08 14:55:23,94,3769,42,52,2096.74,4045.05,0.00
2024-12-08 14:55:23,94,3770,42,52,2083.09,4046.00,0.00
2024-12-08 14:55:23,95,3770,43,52,2061.16,4046.01,0.00
2024-12-08 14:55:23,95,3771,43,52,2039.06,4047.00,0.00
2024-12-08 14:55:24,96,3771,43,53,2017.82,4047.01,0.00
2024-12-08 14:55:24,95,3771,42,53,2038.64,4047.01,0.00
2024-12-08 14:55:24,94,3771,42,52,2055.19,4047.10,0.00
2024-12-08 14:55:24,93,3771,41,52,2068.22,4047.32,0.00
2024-12-08 14:55:24,93,3772,41,52,2067.33,4048.00,0.00
2024-12-08 14:55:24,94,3772,41,53,2045.33,4048.01,0.00
2024-12-08 14:55:24,93,3772,40,53,2043.18,4048.25,0.00
2024-12-08 14:55:24,93,3773,40,53,2056.67,4049.00,0.00
2024-12-08 14:55:24,94,3773,40,54,2034.79,4049.01,0.00
2024-12-08 14:55:24,93,3773,40,53,2051.48,4049.12,0.00
2024-12-08 14:55:24,92,3773,39,53,2063.65,4049.12,0.00
2024-12-08 14:55:24,93,3772,39,54,2025.51,4049.54,0.00
2024-12-08 14:55:24,93,3773,39,54,2068.07,4050.00,0.00
2024-12-08 14:55:24,94,3773,40,54,2046.07,4050.01,0.00
2024-12-08 14:55:24,93,3773,39,54,2045.96,4050.33,0.00
2024-12-08 14:55:24,92,3773,38,54,2042.37,4050.64,0.00
2024-12-08 14:55:24,92,3774,38,54,2116.16,4051.00,0.00
2024-12-08 14:55:24,93,3774,39,54,2093.41,4051.01,0.00
2024-12-08 14:55:24,92,3774,39,53,2114.41,4051.04,0.00
2024-12-08 14:55:24,91,3774,39,52,2134.10,4051.11,0.00
2024-12-08 14:55:24,90,3774,38,52,2151.36,4051.27,0.00
2024-12-08 14:55:24,90,3775,38,52,2149.11,4052.00,0.00
2024-12-08 14:55:24,91,3775,39,52,2125.49,4052.01,0.00
2024-12-08 14:55:24,90,3775,38,52,2136.97,4052.06,0.00
2024-12-08 14:55:24,90,3776,38,52,2135.23,4053.00,0.00
2024-12-08 14:55:24,91,3776,39,52,2111.77,4053.01,0.00
2024-12-08 14:55:24,90,3776,39,51,2126.70,4053.10,0.00
2024-12-08 14:55:24,90,3777,39,51,2117.74,4054.00,0.00
2024-12-08 14:55:24,91,3777,40,51,2094.47,4054.01,0.00
2024-12-08 14:55:24,92,3776,41,51,2069.08,4054.10,0.00
2024-12-08 14:55:24,93,3775,41,52,2073.88,4054.15,0.00
2024-12-08 14:55:24,93,3776,41,52,2112.86,4055.00,0.00
2024-12-08 14:55:24,94,3776,42,52,2090.38,4055.01,0.00
2024-12-08 14:55:24,93,3776,41,52,2111.13,4055.04,0.00
2024-12-08 14:55:24,92,3776,40,52,2114.33,4055.30,0.00
2024-12-08 14:55:24,93,3775,41,52,2079.11,4055.64,0.00
2024-12-08 14:55:24,93,3776,41,52,2201.81,4056.00,0.00
2024-12-08 14:55:24,94,3776,41,53,2178.39,4056.01,0.00
2024-12-08 14:55:24,94,3777,41,53,2205.16,4057.00,0.00
2024-12-08 14:55:24,95,3777,41,54,2181.95,4057.01,0.00
2024-12-08 14:55:24,94,3777,40,54,2204.95,4057.01,0.00
2024-12-08 14:55:24,94,3778,40,54,2182.61,4058.00,0.00
2024-12-08 14:55:24,95,3778,40,55,2159.64,4058.01,0.00
2024-12-08 14:55:24,94,3778,40,54,2178.76,4058.07,0.00
2024-12-08 14:55:24,93,3778,39,54,2152.58,4058.97,0.00
2024-12-08 14:55:24,93,3779,39,54,2194.94,4059.00,0.00
2024-12-08 14:55:24,94,3779,40,54,2171.58,4059.01,0.00
2024-12-08 14:55:24,93,3779,40,53,2184.49,4059.08,0.00
2024-12-08 14:55:24,92,3779,39,53,2185.78,4059.25,0.00
2024-12-08 14:55:24,92,3780,39,53,2199.92,4060.00,0.00
2024-12-08 14:55:24,93,3780,40,53,2176.27,4060.01,0.00
2024-12-08 14:55:24,93,3781,40,53,2168.03,4061.00,0.00
2024-12-08 14:55:24,94,3781,41,53,2144.96,4061.01,0.00
2024-12-08 14:55:24,94,3782,41,53,2134.95,4062.00,0.00
2024-12-08 14:55:24,95,3782,42,53,2112.47,4062.01,0.00
2024-12-08 14:55:24,95,3783,42,53,2098.74,4063.00,0.00
2024-12-08 14:55:24,96,3783,43,53,2076.88,4063.01,0.00
2024-12-08 14:55:24,96,3784,43,53,2056.90,4064.00,0.00
2024-12-08 14:55:24,97,3784,43,54,2035.70,4064.01,0.00
2024-12-08 14:55:24,96,3784,43,53,2049.73,4064.07,0.00
2024-12-08 14:55:24,96,3785,43,53,2037.93,4065.00,0.00
2024-12-08 14:55:24,97,3785,44,53,2016.92,4065.01,0.00
2024-12-08 14:55:24,96,3785,44,52,2029.49,4065.07,0.00
2024-12-08 14:55:24,95,3785,43,52,2047.39,4065.16,0.00
2024-12-08 14:55:24,94,3785,42,52,2026.54,4065.97,0.00
2024-12-08 14:55:24,94,3786,42,52,2068.52,4066.00,0.00
2024-12-08 14:55:24,95,3786,43,52,2046.74,4066.01,0.00
2024-12-08 14:55:24,94,3786,43,51,2059.89,4066.09,0.00
2024-12-08 14:55:24,93,3786,42,51,2036.88,4066.76,0.00
2024-12-08 14:55:24,93,3787,42,51,2071.18,4067.00,0.00
2024-12-08 14:55:24,94,3787,42,52,2049.15,4067.01,0.00
2024-12-08 14:55:24,93,3787,42,51,2062.46,4067.09,0.00
2024-12-08 14:55:24,93,3788,42,51,2052.01,4068.00,0.00
2024-12-08 14:55:24,94,3788,43,51,2030.18,4068.01,0.00
2024-12-08 14:55:24,93,3788,43,50,2043.29,4068.09,0.00
2024-12-08 14:55:24,92,3788,42,50,2041.66,4068.27,0.00
2024-12-08 14:55:24,91,3788,41,50,2054.81,4068.49,0.00
2024-12-08 14:55:24,92,3787,41,51,2026.37,4068.66,0.00
2024-12-08 14:55:24,92,3788,41,51,2069.97,4069.00,0.00
2024-12-08 14:55:24,93,3788,41,52,2047.71,4069.01,0.00
2024-12-08 14:55:24,92,3788,40,52,2067.34,4069.07,0.00
2024-12-08 14:55:24,91,3788,40,51,2082.01,4069.10,0.00
2024-12-08 14:55:24,90,3788,39,51,2079.97,4069.50,0.00
2024-12-08 14:55:25,90,3789,39,51,2150.41,4070.00,0.00
2024-12-08 14:55:25,91,3789,40,51,2126.77,4070.01,0.00
2024-12-08 14:55:25,90,3789,40,50,2140.48,4070.10,0.00
2024-12-08 14:55:25,90,3790,40,50,2131.48,4071.00,0.00
2024-12-08 14:55:25,91,3790,40,51,2108.06,4071.01,0.00
2024-12-08 14:55:25,90,3790,39,51,2110.31,4071.31,0.00
2024-12-08 14:55:25,90,3791,39,51,2113.98,4072.00,0.00
2024-12-08 14:55:25,91,3791,40,51,2090.75,4072.01,0.00
2024-12-08 14:55:25,90,3791,40,50,2102.69,4072.12,0.00
2024-12-08 14:55:25,90,3792,40,50,2094.58,4073.00,0.00
2024-12-08 14:55:25,91,3792,40,51,2071.57,4073.01,0.00
2024-12-08 14:55:25,90,3792,39,51,2087.80,4073.01,0.00
2024-12-08 14:55:25,89,3792,39,50,2098.92,4073.11,0.00
2024-12-08 14:55:25,89,3793,39,50,2109.03,4074.00,0.00
2024-12-08 14:55:25,90,3793,40,50,2085.59,4074.01,0.00
2024-12-08 14:55:25,89,3793,39,50,2088.05,4074.30,0.00
2024-12-08 14:55:25,88,3793,38,50,2111.32,4074.31,0.00
2024-12-08 14:55:25,87,3793,37,50,2131.39,4074.36,0.00
2024-12-08 14:55:25,87,3794,37,50,2152.42,4075.00,0.00
2024-12-08 14:55:25,88,3794,37,51,2127.96,4075.01,0.00
2024-12-08 14:55:25,87,3794,37,50,2138.39,4075.13,0.00
2024-12-08 14:55:25,88,3793,37,51,2101.71,4075.46,0.00
2024-12-08 14:55:25,89,3792,38,51,2091.47,4075.64,0.00
2024-12-08 14:55:25,89,3793,38,51,2147.56,4076.00,0.00
2024-12-08 14:55:25,90,3793,38,52,2123.70,4076.01,0.00
2024-12-08 14:55:25,89,3793,38,51,2142.55,4076.12,0.00
2024-12-08 14:55:25,89,3794,38,51,2226.42,4077.00,0.00
2024-12-08 14:55:25,90,3794,38,52,2201.68,4077.01,0.00
2024-12-08 14:55:25,89,3794,38,51,2212.24,4077.12,0.00
2024-12-08 14:55:25,88,3794,37,51,2195.71,4077.96,0.00
2024-12-08 14:55:25,88,3795,37,51,2240.23,4078.00,0.00
2024-12-08 14:55:25,89,3795,37,52,2215.05,4078.01,0.00
2024-12-08 14:55:25,88,3795,36,52,2237.93,4078.06,0.00
2024-12-08 14:55:25,87,3795,35,52,2212.83,4078.68,0.00
2024-12-08 14:55:25,87,3796,35,52,2246.84,4079.00,0.00
2024-12-08 14:55:25,88,3796,36,52,2221.31,4079.01,0.00
2024-12-08 14:55:25,87,3796,36,51,2241.71,4079.13,0.00
2024-12-08 14:55:25,86,3796,35,51,2244.77,4079.47,0.00
2024-12-08 14:55:25,86,3797,35,51,2270.77,4080.00,0.00
2024-12-08 14:55:25,87,3797,36,51,2244.67,4080.01,0.00
2024-12-08 14:55:25,86,3797,36,50,2269.83,4080.02,0.00
2024-12-08 14:55:25,85,3797,35,50,2295.10,4080.05,0.00
2024-12-08 14:55:25,84,3797,35,49,2311.26,4080.10,0.00
2024-12-08 14:55:25,84,3798,35,49,2304.03,4081.00,0.00
2024-12-08 14:55:25,85,3798,35,50,2276.92,4081.01,0.00
2024-12-08 14:55:25,84,3798,35,49,2302.10,4081.05,0.00
2024-12-08 14:55:25,83,3798,35,48,2318.04,4081.08,0.00
2024-12-08 14:55:25,83,3799,35,48,2310.72,4082.00,0.00
2024-12-08 14:55:25,84,3799,36,48,2283.21,4082.01,0.00
2024-12-08 14:55:25,83,3799,36,47,2297.95,4082.08,0.00
2024-12-08 14:55:25,83,3800,36,47,2290.62,4083.00,0.00
2024-12-08 14:55:25,84,3800,36,48,2263.35,4083.01,0.00
2024-12-08 14:55:25,83,3800,35,48,2280.79,4083.02,0.00
2024-12-08 14:55:25,82,3800,35,47,2296.17,4083.07,0.00
2024-12-08 14:55:25,82,3801,35,47,2308.67,4084.00,0.00
2024-12-08 14:55:25,83,3801,35,48,2280.85,4084.01,0.00
2024-12-08 14:55:25,84,3800,36,48,2237.21,4084.20,0.00
2024-12-08 14:55:25,83,3800,35,48,2259.23,4084.95,0.00
2024-12-08 14:55:25,83,3801,35,48,2306.51,4085.00,0.00
2024-12-08 14:55:25,84,3801,35,49,2279.05,4085.01,0.00
2024-12-08 14:55:25,83,3801,35,48,2303.57,4085.07,0.00
2024-12-08 14:55:26,83,3802,35,48,2344.98,4086.00,0.00
2024-12-08 14:55:26,84,3802,36,48,2317.07,4086.01,0.00
2024-12-08 14:55:26,83,3802,36,47,2332.20,4086.07,0.00
2024-12-08 14:55:26,84,3801,37,47,2253.30,4086.88,0.00
2024-12-08 14:55:26,84,3802,37,47,2302.06,4087.00,0.00
2024-12-08 14:55:26,85,3802,37,48,2274.98,4087.01,0.00
2024-12-08 14:55:26,84,3802,36,48,2300.62,4087.04,0.00
2024-12-08 14:55:26,83,3802,35,48,2324.89,4087.05,0.00
2024-12-08 14:55:26,82,3802,35,47,2342.28,4087.06,0.00
2024-12-08 14:55:26,82,3803,35,47,2404.16,4088.00,0.00
2024-12-08 14:55:26,83,3803,35,48,2375.19,4088.01,0.00
2024-12-08 14:55:26,82,3803,34,48,2402.67,4088.04,0.00
2024-12-08 14:55:26,82,3804,34,48,2394.99,4089.00,0.00
2024-12-08 14:55:26,83,3804,35,48,2366.13,4089.01,0.00
2024-12-08 14:55:26,83,3805,35,48,2349.88,4090.00,0.00
2024-12-08 14:55:26,84,3805,36,48,2321.90,4090.01,0.00
2024-12-08 14:55:26,83,3805,36,47,2338.56,4090.05,0.00
2024-12-08 14:55:26,82,3805,35,47,2343.82,4090.62,0.00
2024-12-08 14:55:26,82,3806,35,47,2358.59,4091.00,0.00
2024-12-08 14:55:26,83,3806,36,47,2330.17,4091.01,0.00
2024-12-08 14:55:26,82,3806,36,46,2347.62,4091.05,0.00
2024-12-08 14:55:26,81,3806,35,46,2361.97,4091.31,0.00
2024-12-08 14:55:26,81,3807,35,46,2384.66,4092.00,0.00
2024-12-08 14:55:26,82,3807,36,46,2355.58,4092.01,0.00
2024-12-08 14:55:26,81,3807,36,45,2372.05,4092.06,0.00
2024-12-08 14:55:26,80,3807,35,45,2386.88,4092.10,0.00
2024-12-08 14:55:26,80,3808,35,45,2401.75,4093.00,0.00
2024-12-08 14:55:26,81,3808,35,46,2372.10,4093.01,0.00
2024-12-08 14:55:26,81,3809,35,46,2352.46,4094.00,0.00
2024-12-08 14:55:26,82,3809,36,46,2323.78,4094.01,0.00
2024-12-08 14:55:26,81,3809,36,45,2349.45,4094.06,0.00
2024-12-08 14:55:26,80,3809,35,45,2344.93,4094.81,0.00
2024-12-08 14:55:26,80,3810,35,45,2388.59,4095.00,0.00
2024-12-08 14:55:26,81,3810,35,46,2359.11,4095.01,0.00
2024-12-08 14:55:26,81,3811,35,46,2355.04,4096.00,0.00
2024-12-08 14:55:26,82,3811,35,47,2326.32,4096.01,0.00
2024-12-08 14:55:26,82,3812,35,47,2319.48,4097.00,0.00
2024-12-08 14:55:26,83,3812,35,48,2291.54,4097.01,0.00
2024-12-08 14:55:26,82,3812,34,48,2299.58,4097.26,0.00
2024-12-08 14:55:26,82,3813,34,48,2306.66,4098.00,0.00
2024-12-08 14:55:26,83,3813,35,48,2278.87,4098.01,0.00
2024-12-08 14:55:26,82,3813,34,48,2244.49,4098.83,0.00
2024-12-08 14:55:26,82,3814,34,48,2287.62,4099.00,0.00
2024-12-08 14:55:26,83,3814,34,49,2260.06,4099.01,0.00
2024-12-08 14:55:26,82,3814,34,48,2282.64,4099.06,0.00
2024-12-08 14:55:26,82,3815,34,48,2274.68,4100.00,0.00
2024-12-08 14:55:26,83,3815,34,49,2247.28,4100.01,0.00
2024-12-08 14:55:26,82,3815,34,48,2263.70,4100.06,0.00
2024-12-08 14:55:26,82,3816,34,48,2255.73,4101.00,0.00
2024-12-08 14:55:26,83,3816,35,48,2228.55,4101.01,0.00
2024-12-08 14:55:26,82,3816,34,48,2235.31,4101.27,0.00
2024-12-08 14:55:26,82,3817,34,48,2235.77,4102.00,0.00
2024-12-08 14:55:26,83,3817,35,48,2208.83,4102.01,0.00
2024-12-08 14:55:26,82,3817,35,47,2231.79,4102.09,0.00
2024-12-08 14:55:26,82,3818,35,47,2224.81,4103.00,0.00
2024-12-08 14:55:26,83,3818,36,47,2198.00,4103.01,0.00
2024-12-08 14:55:26,84,3817,37,47,2127.81,4103.88,0.00
2024-12-08 14:55:26,84,3818,37,47,2176.76,4104.00,0.00
2024-12-08 14:55:26,85,3818,38,47,2151.15,4104.01,0.00
2024-12-08 14:55:26,84,3818,38,46,2173.36,4104.08,0.00
2024-12-08 14:55:26,85,3817,39,46,2140.13,4104.29,0.00
2024-12-08 14:55:26,85,3818,39,46,2202.39,4105.00,0.00
2024-12-08 14:55:26,86,3818,40,46,2176.78,4105.01,0.00
2024-12-08 14:55:26,86,3819,40,46,2212.43,4106.00,0.00
2024-12-08 14:55:27,87,3819,40,47,2187.00,4106.01,0.00
2024-12-08 14:55:27,86,3819,40,46,2211.01,4106.04,0.00
2024-12-08 14:55:27,85,3819,39,46,2217.29,4106.27,0.00
2024-12-08 14:55:27,85,3820,39,46,2218.58,4107.00,0.00
2024-12-08 14:55:27,86,3820,39,47,2192.78,4107.01,0.00
2024-12-08 14:55:27,85,3820,39,46,2211.83,4107.07,0.00
2024-12-08 14:55:27,85,3821,39,46,2203.17,4108.00,0.00
2024-12-08 14:55:27,86,3821,40,46,2177.55,4108.01,0.00
2024-12-08 14:55:27,85,3821,40,45,2191.10,4108.07,0.00
2024-12-08 14:55:27,85,3822,40,45,2182.44,4109.00,0.00
2024-12-08 14:55:27,86,3822,40,46,2157.06,4109.01,0.00
2024-12-08 14:55:27,85,3822,40,45,2169.88,4109.07,0.00
2024-12-08 14:55:27,86,3821,41,45,2139.44,4109.22,0.00
2024-12-08 14:55:27,87,3820,41,46,2143.10,4109.41,0.00
2024-12-08 14:55:27,87,3821,41,46,2171.37,4110.00,0.00
2024-12-08 14:55:27,88,3821,41,47,2146.70,4110.01,0.00
2024-12-08 14:55:27,88,3822,41,47,2231.04,4111.00,0.00
2024-12-08 14:55:27,89,3822,42,47,2205.97,4111.01,0.00
2024-12-08 14:55:27,88,3822,42,46,2229.64,4111.03,0.00
2024-12-08 14:55:27,87,3822,41,46,2236.45,4111.26,0.00
2024-12-08 14:55:27,86,3822,40,46,2261.98,4111.27,0.00
2024-12-08 14:55:27,86,3823,40,46,2267.72,4112.00,0.00
2024-12-08 14:55:27,87,3823,41,46,2241.65,4112.01,0.00
2024-12-08 14:55:27,87,3824,41,46,2220.45,4113.00,0.00
2024-12-08 14:55:27,88,3824,41,47,2195.22,4113.01,0.00
2024-12-08 14:55:27,87,3824,41,46,2216.68,4113.07,0.00
2024-12-08 14:55:27,86,3824,40,46,2234.39,4113.26,0.00
2024-12-08 14:55:27,85,3824,39,46,2256.71,4113.35,0.00
2024-12-08 14:55:27,86,3823,40,46,2213.05,4113.80,0.00
2024-12-08 14:55:27,86,3824,40,46,2239.99,4114.00,0.00
2024-12-08 14:55:27,87,3824,41,46,2214.24,4114.01,0.00
2024-12-08 14:55:27,86,3824,41,45,2229.00,4114.07,0.00
2024-12-08 14:55:27,87,3823,42,45,2162.49,4114.63,0.00
2024-12-08 14:55:27,87,3824,42,45,2254.98,4115.00,0.00
2024-12-08 14:55:27,88,3824,43,45,2229.36,4115.01,0.00
2024-12-08 14:55:27,87,3824,42,45,2246.00,4115.01,0.00
2024-12-08 14:55:27,86,3824,42,44,2260.16,4115.08,0.00
2024-12-08 14:55:27,86,3825,42,44,2318.61,4116.00,0.00
2024-12-08 14:55:27,87,3825,42,45,2291.96,4116.01,0.00
2024-12-08 14:55:27,86,3825,41,45,2288.10,4116.37,0.00
2024-12-08 14:55:27,86,3826,41,45,2310.56,4117.00,0.00
2024-12-08 14:55:27,87,3826,42,45,2284.00,4117.01,0.00
2024-12-08 14:55:27,86,3826,41,45,2302.42,4117.05,0.00
2024-12-08 14:55:27,86,3827,41,45,2302.02,4118.00,0.00
2024-12-08 14:55:27,87,3827,42,45,2275.56,4118.01,0.00
2024-12-08 14:55:27,88,3826,43,45,2249.70,4118.03,0.00
2024-12-08 14:55:27,87,3826,43,44,2300.67,4118.12,0.00
2024-12-08 14:55:27,88,3825,43,45,2251.88,4118.69,0.00
2024-12-08 14:55:27,88,3826,43,45,2277.40,4119.00,0.00
2024-12-08 14:55:27,89,3826,44,45,2251.81,4119.01,0.00
2024-12-08 14:55:27,88,3826,43,45,2256.89,4119.27,0.00
2024-12-08 14:55:27,88,3827,43,45,2349.11,4120.00,0.00
2024-12-08 14:55:27,89,3827,43,46,2322.72,4120.01,0.00
2024-12-08 14:55:27,88,3827,43,45,2344.45,4120.10,0.00
2024-12-08 14:55:27,88,3828,43,45,2336.10,4121.00,0.00
2024-12-08 14:55:27,89,3828,44,45,2309.85,4121.01,0.00
2024-12-08 14:55:27,88,3828,43,45,2335.18,4121.02,0.00
2024-12-08 14:55:27,87,3828,43,44,2350.66,4121.08,0.00
2024-12-08 14:55:27,87,3829,43,44,2341.73,4122.00,0.00
2024-12-08 14:55:27,88,3829,44,44,2315.12,4122.01,0.00
2024-12-08 14:55:27,87,3829,43,44,2340.80,4122.02,0.00
2024-12-08 14:55:27,88,3828,44,44,2257.85,4122.74,0.00
2024-12-08 14:55:27,88,3829,44,44,2302.10,4123.00,0.00
2024-12-08 14:55:27,89,3829,44,45,2276.23,4123.01,0.00
2024-12-08 14:55:27,88,3829,44,44,2298.84,4123.08,0.00
2024-12-08 14:55:27,87,3829,43,44,2319.16,4123.22,0.00
2024-12-08 14:55:27,88,3828,44,44,2277.99,4123.60,0.00
2024-12-08 14:55:28,88,3829,44,44,2338.74,4124.00,0.00
2024-12-08 14:55:28,89,3829,45,44,2312.46,4124.01,0.00
2024-12-08 14:55:28,88,3829,44,44,2304.22,4124.41,0.00
2024-12-08 14:55:28,88,3830,44,44,2374.00,4125.00,0.00
2024-12-08 14:55:28,89,3830,44,45,2347.32,4125.01,0.00
2024-12-08 14:55:28,88,3830,43,45,2325.46,4125.52,0.00
2024-12-08 14:55:28,88,3831,43,45,2353.00,4126.00,0.00
2024-12-08 14:55:28,89,3831,43,46,2326.56,4126.01,0.00
2024-12-08 14:55:28,88,3831,43,45,2349.73,4126.06,0.00
2024-12-08 14:55:28,88,3832,43,45,2339.50,4127.00,0.00
2024-12-08 14:55:28,89,3832,43,46,2313.22,4127.01,0.00
2024-12-08 14:55:28,88,3832,43,45,2336.25,4127.08,0.00
2024-12-08 14:55:28,87,3832,42,45,2357.23,4127.22,0.00
2024-12-08 14:55:28,86,3832,41,45,2350.78,4127.62,0.00
2024-12-08 14:55:28,86,3833,41,45,2383.23,4128.00,0.00
2024-12-08 14:55:28,87,3833,42,45,2355.84,4128.01,0.00
2024-12-08 14:55:28,86,3833,42,44,2370.30,4128.08,0.00
2024-12-08 14:55:28,85,3833,41,44,2359.10,4128.61,0.00
2024-12-08 14:55:28,85,3834,41,44,2391.93,4129.00,0.00
2024-12-08 14:55:28,86,3834,42,44,2364.12,4129.01,0.00
2024-12-08 14:55:28,85,3834,42,43,2378.85,4129.08,0.00
2024-12-08 14:55:28,84,3834,41,43,2384.46,4129.63,0.00
2024-12-08 14:55:28,84,3835,41,43,2399.01,4130.00,0.00
2024-12-08 14:55:28,85,3835,42,43,2370.78,4130.01,0.00
2024-12-08 14:55:28,84,3835,42,42,2386.25,4130.08,0.00
2024-12-08 14:55:28,85,3834,42,43,2349.50,4130.32,0.00
2024-12-08 14:55:28,85,3835,42,43,2371.84,4131.00,0.00
2024-12-08 14:55:28,86,3835,42,44,2344.26,4131.01,0.00
2024-12-08 14:55:28,85,3835,41,44,2338.36,4131.18,0.00
2024-12-08 14:55:28,85,3836,41,44,2402.07,4132.00,0.00
2024-12-08 14:55:28,86,3836,42,44,2374.14,4132.01,0.00
2024-12-08 14:55:28,85,3836,41,44,2401.11,4132.02,0.00
2024-12-08 14:55:28,84,3836,41,43,2425.29,4132.10,0.00
2024-12-08 14:55:28,83,3836,40,43,2449.07,4132.22,0.00
2024-12-08 14:55:28,83,3837,40,43,2447.10,4133.00,0.00
2024-12-08 14:55:28,84,3837,40,44,2417.97,4133.01,0.00
2024-12-08 14:55:28,83,3837,40,43,2446.11,4133.02,0.00
2024-12-08 14:55:28,83,3838,40,43,2426.28,4134.00,0.00
2024-12-08 14:55:28,84,3838,41,43,2397.39,4134.01,0.00
2024-12-08 14:55:28,83,3838,41,42,2425.29,4134.02,0.00
2024-12-08 14:55:28,82,3838,40,42,2436.72,4134.02,0.00
2024-12-08 14:55:28,81,3838,39,42,2464.99,4134.06,0.00
2024-12-08 14:55:28,80,3838,39,41,2494.25,4134.06,0.00
2024-12-08 14:55:28,80,3839,39,41,2507.76,4135.00,0.00
2024-12-08 14:55:28,81,3839,40,41,2476.80,4135.01,0.00
2024-12-08 14:55:28,81,3840,40,41,2456.97,4136.00,0.00
2024-12-08 14:55:28,82,3840,40,42,2427.01,4136.01,0.00
2024-12-08 14:55:28,81,3840,40,41,2453.93,4136.06,0.00
2024-12-08 14:55:28,81,3841,40,41,2446.33,4137.00,0.00
2024-12-08 14:55:28,82,3841,41,41,2416.49,4137.01,0.00
2024-12-08 14:55:28,82,3842,41,41,2410.00,4138.00,0.00
2024-12-08 14:55:28,83,3842,42,41,2380.96,4138.01,0.00
2024-12-08 14:55:28,82,3842,41,41,2371.99,4138.70,0.00
2024-12-08 14:55:28,82,3843,41,41,2397.94,4139.00,0.00
2024-12-08 14:55:28,83,3843,42,41,2369.05,4139.01,0.00
2024-12-08 14:55:28,83,3844,42,41,2348.90,4140.00,0.00
2024-12-08 14:55:28,84,3844,42,42,2320.94,4140.01,0.00
2024-12-08 14:55:28,83,3844,42,41,2341.93,4140.06,0.00
2024-12-08 14:55:28,82,3844,41,41,2343.57,4140.72,0.00
2024-12-08 14:55:28,82,3845,41,41,2362.46,4141.00,0.00
2024-12-08 14:55:28,83,3845,42,41,2334.00,4141.01,0.00
2024-12-08 14:55:28,82,3845,41,41,2361.08,4141.04,0.00
2024-12-08 14:55:28,81,3845,40,41,2363.24,4141.32,0.00
2024-12-08 14:55:28,82,3844,41,41,2326.95,4141.52,0.00
2024-12-08 14:55:28,82,3845,41,41,2394.47,4142.00,0.00
2024-12-08 14:55:28,83,3845,41,42,2365.62,4142.01,0.00
2024-12-08 14:55:28,82,3845,41,41,2391.46,4142.05,0.00
2024-12-08 14:55:29,82,3846,41,41,2433.45,4143.00,0.00
2024-12-08 14:55:29,83,3846,42,41,2404.13,4143.01,0.00
2024-12-08 14:55:29,84,3845,42,42,2355.87,4143.27,0.00
2024-12-08 14:55:29,85,3844,43,42,2309.80,4143.60,0.00
2024-12-08 14:55:29,85,3845,43,42,2356.41,4144.00,0.00
2024-12-08 14:55:29,86,3845,44,42,2329.01,4144.01,0.00
2024-12-08 14:55:29,85,3845,44,41,2353.02,4144.05,0.00
2024-12-08 14:55:29,85,3846,44,41,2440.86,4145.00,0.00
2024-12-08 14:55:29,86,3846,44,42,2412.48,4145.01,0.00
2024-12-08 14:55:29,86,3847,44,42,2391.36,4146.00,0.00
2024-12-08 14:55:29,87,3847,45,42,2363.88,4146.01,0.00
2024-12-08 14:55:29,86,3847,45,41,2387.53,4146.06,0.00
2024-12-08 14:55:29,86,3848,45,41,2377.96,4147.00,0.00
2024-12-08 14:55:29,87,3848,46,41,2350.62,4147.01,0.00
2024-12-08 14:55:29,86,3848,45,41,2364.47,4147.06,0.00
2024-12-08 14:55:29,87,3847,46,41,2297.65,4147.82,0.00
2024-12-08 14:55:29,87,3848,46,41,2344.04,4148.00,0.00
2024-12-08 14:55:29,88,3848,47,41,2317.40,4148.01,0.00
2024-12-08 14:55:29,87,3848,47,40,2338.81,4148.07,0.00
2024-12-08 14:55:29,87,3849,47,40,2377.03,4149.00,0.00
2024-12-08 14:55:29,88,3849,48,40,2350.02,4149.01,0.00
2024-12-08 14:55:29,87,3849,47,40,2337.80,4149.72,0.00
2024-12-08 14:55:29,87,3850,47,40,2355.19,4150.00,0.00
2024-12-08 14:55:29,88,3850,47,41,2328.42,4150.01,0.00
2024-12-08 14:55:29,87,3850,47,40,2352.34,4150.06,0.00
2024-12-08 14:55:29,86,3850,46,40,2373.00,4150.22,0.00
2024-12-08 14:55:29,87,3849,46,41,2318.46,4150.91,0.00
2024-12-08 14:55:29,87,3850,46,41,2346.21,4151.00,0.00
2024-12-08 14:55:29,88,3850,47,41,2319.55,4151.01,0.00
2024-12-08 14:55:29,87,3850,46,41,2325.30,4151.24,0.00
2024-12-08 14:55:29,87,3851,46,41,2389.73,4152.00,0.00
2024-12-08 14:55:29,88,3851,46,42,2362.57,4152.01,0.00
2024-12-08 14:55:29,87,3851,46,41,2385.93,4152.06,0.00
2024-12-08 14:55:29,87,3852,46,41,2375.98,4153.00,0.00
2024-12-08 14:55:29,88,3852,46,42,2348.98,4153.01,0.00
2024-12-08 14:55:29,87,3852,45,42,2340.35,4153.43,0.00
2024-12-08 14:55:29,87,3853,45,42,2364.62,4154.00,0.00
2024-12-08 14:55:29,88,3853,45,43,2337.75,4154.01,0.00
2024-12-08 14:55:29,87,3853,44,43,2363.20,4154.04,0.00
2024-12-08 14:55:29,86,3853,44,42,2389.23,4154.05,0.00
2024-12-08 14:55:29,86,3854,44,42,2379.16,4155.00,0.00
2024-12-08 14:55:29,87,3854,44,43,2351.82,4155.01,0.00
2024-12-08 14:55:29,87,3855,44,43,2330.41,4156.00,0.00
2024-12-08 14:55:29,88,3855,44,44,2303.93,4156.01,0.00
2024-12-08 14:55:29,87,3855,44,43,2328.04,4156.06,0.00
2024-12-08 14:55:29,86,3855,43,43,2310.67,4156.95,0.00
2024-12-08 14:55:29,86,3856,43,43,2357.11,4157.00,0.00
2024-12-08 14:55:29,87,3856,43,44,2330.01,4157.01,0.00
2024-12-08 14:55:29,86,3856,43,43,2345.04,4157.06,0.00
2024-12-08 14:55:29,86,3857,43,43,2335.43,4158.00,0.00
2024-12-08 14:55:29,87,3857,44,43,2308.59,4158.01,0.00
2024-12-08 14:55:29,86,3857,44,42,2323.37,4158.06,0.00
2024-12-08 14:55:29,85,3857,43,42,2330.19,4158.15,0.00
2024-12-08 14:55:29,85,3858,43,42,2344.39,4159.00,0.00
2024-12-08 14:55:29,86,3858,44,42,2317.13,4159.01,0.00
2024-12-08 14:55:29,85,3858,43,42,2326.85,4159.20,0.00
2024-12-08 14:55:29,85,3859,43,42,2323.42,4160.00,0.00
2024-12-08 14:55:29,86,3859,44,42,2296.41,4160.01,0.00
2024-12-08 14:55:29,85,3859,44,41,2320.51,4160.06,0.00
2024-12-08 14:55:29,85,3860,44,41,2311.25,4161.00,0.00
2024-12-08 14:55:29,86,3860,44,42,2284.38,4161.01,0.00
2024-12-08 14:55:29,87,3859,45,42,2229.62,4161.49,0.00
2024-12-08 14:55:29,86,3859,44,42,2280.25,4161.54,0.00
2024-12-08 14:55:29,86,3860,44,42,2309.61,4162.00,0.00
2024-12-08 14:55:29,87,3860,45,42,2283.06,4162.01,0.00
2024-12-08 14:55:29,86,3860,45,41,2306.73,4162.06,0.00
2024-12-08 14:55:29,85,3860,44,41,2328.04,4162.20,0.00
2024-12-08 14:55:29,86,3859,45,41,2262.50,4162.69,0.00
2024-12-08 14:55:29,86,3860,45,41,2376.48,4163.00,0.00
2024-12-08 14:55:29,87,3860,45,42,2349.17,4163.01,0.00
2024-12-08 14:55:29,86,3860,45,41,2372.62,4163.04,0.00
2024-12-08 14:55:29,86,3861,45,41,2410.46,4164.00,0.00
2024-12-08 14:55:29,87,3861,45,42,2382.75,4164.01,0.00
2024-12-08 14:55:29,86,3861,45,41,2398.86,4164.05,0.00
2024-12-08 14:55:29,85,3861,44,41,2420.77,4164.19,0.00
2024-12-08 14:55:29,85,3862,44,41,2416.87,4165.00,0.00
2024-12-08 14:55:29,86,3862,45,41,2388.76,4165.01,0.00
2024-12-08 14:55:29,85,3862,45,40,2405.12,4165.05,0.00
2024-12-08 14:55:29,85,3863,45,40,2395.39,4166.00,0.00
2024-12-08 14:55:29,86,3863,46,40,2367.54,4166.01,0.00
2024-12-08 14:55:30,85,3863,45,40,2365.15,4166.35,0.00
2024-12-08 14:55:30,85,3864,45,40,2387.63,4167.00,0.00
2024-12-08 14:55:30,86,3864,46,40,2359.87,4167.01,0.00
2024-12-08 14:55:30,85,3864,46,39,2384.72,4167.07,0.00
2024-12-08 14:55:30,85,3865,46,39,2375.95,4168.00,0.00
2024-12-08 14:55:30,86,3865,46,40,2348.32,4168.01,0.00
2024-12-08 14:55:30,85,3865,46,39,2363.23,4168.07,0.00
2024-12-08 14:55:30,84,3865,45,39,2351.93,4168.62,0.00
2024-12-08 14:55:30,83,3865,44,39,2374.82,4168.75,0.00
2024-12-08 14:55:30,83,3866,44,39,2414.69,4169.00,0.00
2024-12-08 14:55:30,84,3866,44,40,2385.95,4169.01,0.00
2024-12-08 14:55:30,83,3866,43,40,2382.10,4169.15,0.00
2024-12-08 14:55:30,83,3867,43,40,2397.19,4170.00,0.00
2024-12-08 14:55:30,84,3867,43,41,2368.65,4170.01,0.00
2024-12-08 14:55:30,83,3867,43,40,2392.69,4170.07,0.00
2024-12-08 14:55:30,82,3867,42,40,2383.66,4170.87,0.00
2024-12-08 14:55:30,82,3868,42,40,2429.04,4171.00,0.00
2024-12-08 14:55:30,83,3868,42,41,2399.77,4171.01,0.00
2024-12-08 14:55:30,83,3869,42,41,2379.24,4172.00,0.00
2024-12-08 14:55:30,84,3869,42,42,2350.91,4172.01,0.00
2024-12-08 14:55:30,83,3869,42,41,2374.74,4172.07,0.00
2024-12-08 14:55:30,82,3869,41,41,2380.36,4172.24,0.00
2024-12-08 14:55:30,82,3870,41,41,2400.18,4173.00,0.00
2024-12-08 14:55:30,83,3870,42,41,2371.26,4173.01,0.00
2024-12-08 14:55:30,82,3870,41,41,2381.43,4173.22,0.00
2024-12-08 14:55:30,82,3871,41,41,2387.77,4174.00,0.00
2024-12-08 14:55:30,83,3871,41,42,2359.00,4174.01,0.00
2024-12-08 14:55:30,82,3871,40,42,2367.49,4174.24,0.00
2024-12-08 14:55:30,82,3872,40,42,2366.96,4175.00,0.00
2024-12-08 14:55:30,83,3872,41,42,2338.44,4175.01,0.00
2024-12-08 14:55:30,82,3872,41,41,2359.85,4175.07,0.00
2024-12-08 14:55:30,82,3873,41,41,2352.24,4176.00,0.00
2024-12-08 14:55:30,83,3873,42,41,2323.90,4176.01,0.00
2024-12-08 14:55:30,83,3874,42,41,2303.32,4177.00,0.00
2024-12-08 14:55:30,84,3874,42,42,2275.90,4177.01,0.00
2024-12-08 14:55:30,83,3874,42,41,2297.82,4177.10,0.00
2024-12-08 14:55:30,83,3875,42,41,2290.79,4178.00,0.00
2024-12-08 14:55:30,84,3875,43,41,2263.51,4178.01,0.00
2024-12-08 14:55:30,85,3874,43,42,2197.14,4178.32,0.00
2024-12-08 14:55:30,85,3875,43,42,2245.26,4179.00,0.00
2024-12-08 14:55:30,86,3875,44,42,2219.15,4179.01,0.00
2024-12-08 14:55:30,85,3875,44,41,2234.48,4179.14,0.00
2024-12-08 14:55:30,85,3876,44,41,2277.76,4180.00,0.00
2024-12-08 14:55:30,86,3876,45,41,2251.27,4180.01,0.00
2024-12-08 14:55:30,86,3877,45,41,2232.51,4181.00,0.00
2024-12-08 14:55:30,87,3877,46,41,2206.85,4181.01,0.00
2024-12-08 14:55:30,88,3876,47,41,2181.77,4181.03,0.00
2024-12-08 14:55:30,87,3876,47,40,2228.02,4181.09,0.00
2024-12-08 14:55:30,86,3876,46,40,2246.69,4181.26,0.00
2024-12-08 14:55:30,87,3875,46,41,2218.02,4181.35,0.00
2024-12-08 14:55:30,87,3876,46,41,2245.35,4182.00,0.00
2024-12-08 14:55:30,88,3876,47,41,2219.83,4182.01,0.00
2024-12-08 14:55:30,87,3876,46,41,2219.09,4182.40,0.00
2024-12-08 14:55:30,86,3876,45,41,2235.44,4182.43,0.00
2024-12-08 14:55:30,87,3875,45,42,2205.00,4182.56,0.00
2024-12-08 14:55:30,87,3876,45,42,2366.85,4183.00,0.00
2024-12-08 14:55:30,88,3876,46,42,2339.95,4183.01,0.00
2024-12-08 14:55:30,87,3876,46,41,2358.24,4183.14,0.00
2024-12-08 14:55:30,87,3877,46,41,2399.63,4184.00,0.00
2024-12-08 14:55:30,88,3877,47,41,2372.37,4184.01,0.00
2024-12-08 14:55:30,88,3878,47,41,2350.58,4185.00,0.00
2024-12-08 14:55:30,89,3878,47,42,2324.17,4185.01,0.00
2024-12-08 14:55:30,88,3878,47,41,2342.53,4185.14,0.00
2024-12-08 14:55:30,89,3877,47,42,2314.34,4185.20,0.00
2024-12-08 14:55:30,89,3878,47,42,2340.72,4186.00,0.00
2024-12-08 14:55:30,90,3878,47,43,2314.71,4186.01,0.00
2024-12-08 14:55:30,89,3878,46,43,2338.85,4186.05,0.00
2024-12-08 14:55:30,88,3878,45,43,2312.46,4186.67,0.00
2024-12-08 14:55:30,88,3879,45,43,2394.05,4187.00,0.00
2024-12-08 14:55:30,89,3879,45,44,2367.15,4187.01,0.00
2024-12-08 14:55:30,90,3878,45,45,2340.39,4187.04,0.00
2024-12-08 14:55:30,91,3877,46,45,2333.63,4187.30,0.00
2024-12-08 14:55:30,90,3877,45,45,2344.45,4187.72,0.00
2024-12-08 14:55:30,90,3878,45,45,2362.31,4188.00,0.00
2024-12-08 14:55:30,91,3878,45,46,2336.35,4188.01,0.00
2024-12-08 14:55:30,90,3878,45,45,2350.71,4188.08,0.00
2024-12-08 14:55:31,90,3879,45,45,2433.62,4189.00,0.00
2024-12-08 14:55:31,91,3879,45,46,2406.88,4189.01,0.00
2024-12-08 14:55:31,90,3879,45,45,2422.01,4189.08,0.00
2024-12-08 14:55:31,91,3878,46,45,2390.83,4189.21,0.00
2024-12-08 14:55:31,90,3878,45,45,2419.76,4189.27,0.00
2024-12-08 14:55:31,90,3879,45,45,2417.44,4190.00,0.00
2024-12-08 14:55:31,91,3879,46,45,2390.88,4190.01,0.00
2024-12-08 14:55:31,90,3879,46,44,2407.25,4190.16,0.00
2024-12-08 14:55:31,90,3880,46,44,2446.89,4191.00,0.00
2024-12-08 14:55:31,91,3880,47,44,2420.00,4191.01,0.00
2024-12-08 14:55:31,91,3881,47,44,2397.97,4192.00,0.00
2024-12-08 14:55:31,92,3881,48,44,2371.91,4192.01,0.00
2024-12-08 14:55:31,91,3881,48,43,2387.89,4192.15,0.00
2024-12-08 14:55:31,91,3882,48,43,2380.57,4193.00,0.00
2024-12-08 14:55:31,92,3882,49,43,2354.70,4193.01,0.00
2024-12-08 14:55:31,93,3881,50,43,2326.70,4193.10,0.00
2024-12-08 14:55:31,92,3881,49,43,2358.49,4193.27,0.00
2024-12-08 14:55:31,91,3881,48,43,2366.22,4193.70,0.00
2024-12-08 14:55:31,91,3882,48,43,2400.08,4194.00,0.00
2024-12-08 14:55:31,92,3882,48,44,2374.00,4194.01,0.00
2024-12-08 14:55:31,91,3882,47,44,2379.88,4194.15,0.00
2024-12-08 14:55:31,90,3882,47,43,2401.20,4194.17,0.00
2024-12-08 14:55:31,90,3883,47,43,2459.97,4195.00,0.00
2024-12-08 14:55:31,91,3883,48,43,2432.94,4195.01,0.00
2024-12-08 14:55:31,91,3884,48,43,2411.16,4196.00,0.00
2024-12-08 14:55:31,92,3884,49,43,2384.96,4196.01,0.00
2024-12-08 14:55:31,91,3884,49,42,2405.68,4196.13,0.00
2024-12-08 14:55:31,90,3884,49,41,2426.37,4196.17,0.00
2024-12-08 14:55:31,91,3883,49,42,2377.39,4196.73,0.00
2024-12-08 14:55:31,92,3882,49,43,2357.96,4196.77,0.00
2024-12-08 14:55:31,92,3883,49,43,2382.33,4197.00,0.00
2024-12-08 14:55:31,93,3883,50,43,2356.71,4197.01,0.00
2024-12-08 14:55:31,92,3883,50,42,2380.07,4197.05,0.00
2024-12-08 14:55:31,91,3883,49,42,2396.10,4197.10,0.00
2024-12-08 14:55:31,91,3884,49,42,2487.97,4198.00,0.00
2024-12-08 14:55:31,92,3884,49,43,2460.93,4198.01,0.00
2024-12-08 14:55:31,91,3884,49,42,2474.21,4198.19,0.00
2024-12-08 14:55:31,90,3884,48,42,2482.85,4198.63,0.00
2024-12-08 14:55:31,90,3885,48,42,2495.73,4199.00,0.00
2024-12-08 14:55:31,91,3885,49,42,2468.30,4199.01,0.00
2024-12-08 14:55:31,90,3885,48,42,2490.42,4199.13,0.00
2024-12-08 14:55:31,90,3886,48,42,2479.38,4200.00,0.00
2024-12-08 14:55:31,91,3886,48,43,2452.13,4200.01,0.00
2024-12-08 14:55:31,92,3885,48,44,2389.28,4200.69,0.00
2024-12-08 14:55:31,92,3886,48,44,2430.62,4201.00,0.00
2024-12-08 14:55:31,93,3886,49,44,2404.49,4201.01,0.00
2024-12-08 14:55:31,92,3886,49,43,2420.65,4201.17,0.00
2024-12-08 14:55:31,92,3887,49,43,2459.52,4202.00,0.00
2024-12-08 14:55:31,93,3887,49,44,2433.07,4202.01,0.00
2024-12-08 14:55:31,94,3886,50,44,2405.42,4202.08,0.00
2024-12-08 14:55:31,93,3886,49,44,2447.18,4202.20,0.00
2024-12-08 14:55:31,93,3887,49,44,2459.43,4203.00,0.00
2024-12-08 14:55:31,94,3887,49,45,2433.27,4203.01,0.00
2024-12-08 14:55:31,93,3887,48,45,2457.64,4203.04,0.00
2024-12-08 14:55:31,92,3887,48,44,2472.54,4203.17,0.00
2024-12-08 14:55:31,91,3887,47,44,2460.71,4203.67,0.00
2024-12-08 14:55:31,91,3888,47,44,2539.49,4204.00,0.00
2024-12-08 14:55:31,92,3888,48,44,2511.89,4204.01,0.00
2024-12-08 14:55:31,91,3888,47,44,2521.57,4204.22,0.00
2024-12-08 14:55:31,91,3889,47,44,2518.97,4205.00,0.00
2024-12-08 14:55:31,92,3889,47,45,2491.59,4205.01,0.00
2024-12-08 14:55:31,91,3889,47,44,2504.27,4205.19,0.00
2024-12-08 14:55:31,91,3890,47,44,2498.31,4206.00,0.00
2024-12-08 14:55:31,92,3890,47,45,2471.15,4206.01,0.00
2024-12-08 14:55:31,91,3890,46,45,2479.68,4206.23,0.00
2024-12-08 14:55:31,90,3890,45,45,2495.15,4206.38,0.00
2024-12-08 14:55:31,90,3891,45,45,2516.14,4207.00,0.00
2024-12-08 14:55:31,91,3891,45,46,2488.49,4207.01,0.00
2024-12-08 14:55:31,90,3891,45,45,2500.81,4207.20,0.00
2024-12-08 14:55:31,89,3891,44,45,2506.98,4207.72,0.00
2024-12-08 14:55:31,89,3892,44,45,2523.74,4208.00,0.00
2024-12-08 14:55:31,90,3892,44,46,2495.70,4208.01,0.00
2024-12-08 14:55:31,90,3893,44,46,2477.24,4209.00,0.00
2024-12-08 14:55:31,91,3893,45,46,2450.02,4209.01,0.00
2024-12-08 14:55:31,90,3893,44,46,2455.76,4209.07,0.00
2024-12-08 14:55:31,89,3893,43,46,2468.12,4209.20,0.00
2024-12-08 14:55:32,89,3894,43,46,2482.35,4210.00,0.00
2024-12-08 14:55:32,90,3894,43,47,2454.77,4210.01,0.00
2024-12-08 14:55:32,91,3893,44,47,2425.51,4210.09,0.00
2024-12-08 14:55:32,90,3893,44,46,2492.28,4210.20,0.00
2024-12-08 14:55:32,91,3892,45,46,2448.90,4210.60,0.00
2024-12-08 14:55:32,91,3893,45,46,2473.26,4211.00,0.00
2024-12-08 14:55:32,92,3893,46,46,2446.37,4211.01,0.00
2024-12-08 14:55:32,93,3892,46,47,2419.18,4211.05,0.00
2024-12-08 14:55:32,93,3893,46,47,2539.30,4212.00,0.00
2024-12-08 14:55:32,94,3893,47,47,2512.29,4212.01,0.00
2024-12-08 14:55:32,94,3894,47,47,2546.61,4213.00,0.00
2024-12-08 14:55:32,95,3894,48,47,2519.80,4213.01,0.00
2024-12-08 14:55:32,95,3895,48,47,2504.73,4214.00,0.00
2024-12-08 14:55:32,96,3895,48,48,2478.64,4214.01,0.00
2024-12-08 14:55:32,96,3896,48,48,2456.79,4215.00,0.00
2024-12-08 14:55:32,97,3896,49,48,2431.46,4215.01,0.00
2024-12-08 14:55:32,96,3896,49,47,2447.60,4215.06,0.00
2024-12-08 14:55:32,95,3896,48,47,2472.93,4215.06,0.00
2024-12-08 14:55:32,94,3896,47,47,2449.25,4215.94,0.00
2024-12-08 14:55:32,94,3896,47,47,2491.46,4216.00,0.00
2024-12-08 14:55:32,95,3896,47,48,2465.24,4216.01,0.00
2024-12-08 14:55:32,94,3896,47,47,2483.44,4216.09,0.00
2024-12-08 14:55:32,95,3895,48,47,2423.14,4216.93,0.00
2024-12-08 14:55:32,95,3896,48,47,2448.96,4217.00,0.00
2024-12-08 14:55:32,96,3896,49,47,2423.45,4217.01,0.00
2024-12-08 14:55:32,97,3895,49,48,2356.71,4217.83,0.00
2024-12-08 14:55:32,97,3896,49,48,2436.70,4218.00,0.00
2024-12-08 14:55:32,98,3896,49,49,2411.84,4218.01,0.00
2024-12-08 14:55:32,97,3896,48,49,2397.93,4218.73,0.00
2024-12-08 14:55:32,97,3897,48,49,2462.87,4219.00,0.00
2024-12-08 14:55:32,98,3897,49,49,2437.74,4219.01,0.00
2024-12-08 14:55:32,99,3896,49,50,2412.70,4219.04,0.00
2024-12-08 14:55:32,100,3895,50,50,2376.08,4219.47,0.00
2024-12-08 14:55:32,99,3895,49,50,2397.71,4219.75,0.00
2024-12-08 14:55:32,99,3896,49,50,2412.84,4220.00,0.00
2024-12-08 14:55:32,100,3896,49,51,2388.71,4220.01,0.00
2024-12-08 14:55:32,99,3896,49,50,2406.49,4220.08,0.00
2024-12-08 14:55:32,98,3896,48,50,2423.35,4220.27,0.00
2024-12-08 14:55:32,97,3896,47,50,2405.78,4220.95,0.00
2024-12-08 14:55:32,97,3897,47,50,2534.17,4221.00,0.00
2024-12-08 14:55:32,98,3897,48,50,2508.31,4221.01,0.00
2024-12-08 14:55:32,97,3897,48,49,2526.39,4221.09,0.00
2024-12-08 14:55:32,98,3896,48,50,2486.94,4221.44,0.00
2024-12-08 14:55:32,97,3896,47,50,2479.96,4221.86,0.00
2024-12-08 14:55:32,97,3897,47,50,2517.52,4222.00,0.00
2024-12-08 14:55:32,98,3897,48,50,2491.83,4222.01,0.00
2024-12-08 14:55:32,97,3897,47,50,2484.60,4222.41,0.00
2024-12-08 14:55:32,98,3896,48,50,2443.14,4222.82,0.00
2024-12-08 14:55:32,98,3897,48,50,2527.33,4223.00,0.00
2024-12-08 14:55:32,99,3897,49,50,2501.80,4223.01,0.00
2024-12-08 14:55:32,98,3897,49,49,2521.35,4223.12,0.00
2024-12-08 14:55:32,98,3898,49,49,2553.78,4224.00,0.00
2024-12-08 14:55:32,99,3898,50,49,2527.99,4224.01,0.00
2024-12-08 14:55:32,100,3897,50,50,2501.47,4224.06,0.00
2024-12-08 14:55:32,100,3898,50,50,2518.41,4225.00,0.00
2024-12-08 14:55:32,101,3898,51,50,2493.47,4225.01,0.00
2024-12-08 14:55:32,100,3898,51,49,2509.19,4225.17,0.00
2024-12-08 14:55:32,100,3899,51,49,2542.24,4226.00,0.00
2024-12-08 14:55:32,101,3899,52,49,2517.07,4226.01,0.00
2024-12-08 14:55:32,101,3900,52,49,2492.56,4227.00,0.00
2024-12-08 14:55:32,102,3900,53,49,2468.12,4227.01,0.00
2024-12-08 14:55:32,101,3900,53,48,2483.42,4227.17,0.00
2024-12-08 14:55:32,101,3901,53,48,2473.89,4228.00,0.00
2024-12-08 14:55:32,102,3901,54,48,2449.64,4228.01,0.00
2024-12-08 14:55:32,102,3902,54,48,2424.93,4229.00,0.00
2024-12-08 14:55:32,103,3902,55,48,2401.38,4229.01,0.00
2024-12-08 14:55:32,102,3902,55,47,2416.29,4229.17,0.00
2024-12-08 14:55:32,102,3903,55,47,2406.42,4230.00,0.00
2024-12-08 14:55:32,103,3903,56,47,2383.06,4230.01,0.00
2024-12-08 14:55:32,102,3903,55,47,2403.15,4230.08,0.00
2024-12-08 14:55:32,101,3903,54,47,2394.38,4230.39,0.00
2024-12-08 14:55:33,101,3904,54,47,2410.72,4231.00,0.00
2024-12-08 14:55:33,102,3904,55,47,2387.08,4231.01,0.00
2024-12-08 14:55:33,101,3904,55,46,2402.82,4231.16,0.00
2024-12-08 14:55:33,101,3905,55,46,2392.85,4232.00,0.00
2024-12-08 14:55:33,102,3905,56,46,2369.39,4232.01,0.00
2024-12-08 14:55:33,102,3906,56,46,2344.64,4233.00,0.00
2024-12-08 14:55:33,103,3906,56,47,2321.87,4233.01,0.00
2024-12-08 14:55:33,102,3906,56,46,2337.23,4233.16,0.00
2024-12-08 14:55:33,102,3907,56,46,2326.92,4234.00,0.00
2024-12-08 14:55:33,103,3907,56,47,2304.33,4234.01,0.00
2024-12-08 14:55:33,102,3907,55,47,2323.65,4234.08,0.00
2024-12-08 14:55:33,102,3908,55,47,2301.73,4235.00,0.00
2024-12-08 14:55:33,103,3908,56,47,2279.39,4235.01,0.00
2024-12-08 14:55:33,102,3908,56,46,2295.15,4235.15,0.00
2024-12-08 14:55:33,101,3908,55,46,2275.57,4235.98,0.00
2024-12-08 14:55:33,101,3909,55,46,2316.68,4236.00,0.00
2024-12-08 14:55:33,102,3909,56,46,2293.97,4236.01,0.00
2024-12-08 14:55:33,101,3909,55,46,2287.39,4236.21,0.00
2024-12-08 14:55:33,101,3910,55,46,2296.25,4237.00,0.00
2024-12-08 14:55:33,102,3910,56,46,2273.74,4237.01,0.00
2024-12-08 14:55:33,101,3910,56,45,2284.99,4237.20,0.00
2024-12-08 14:55:33,100,3910,55,45,2304.90,4237.27,0.00
2024-12-08 14:55:33,100,3911,55,45,2299.84,4238.00,0.00
2024-12-08 14:55:33,101,3911,56,45,2277.07,4238.01,0.00
2024-12-08 14:55:33,100,3911,55,45,2266.96,4238.45,0.00
2024-12-08 14:55:33,100,3912,55,45,2286.40,4239.00,0.00
2024-12-08 14:55:33,101,3912,56,45,2263.76,4239.01,0.00
2024-12-08 14:55:33,100,3912,56,44,2273.75,4239.21,0.00
2024-12-08 14:55:33,100,3913,56,44,2266.16,4240.00,0.00
2024-12-08 14:55:33,101,3913,57,44,2243.73,4240.01,0.00
2024-12-08 14:55:33,101,3914,57,44,2219.99,4241.00,0.00
2024-12-08 14:55:33,102,3914,57,45,2198.22,4241.01,0.00
2024-12-08 14:55:33,101,3914,56,45,2216.25,4241.09,0.00
2024-12-08 14:55:33,100,3914,55,45,2234.11,4241.19,0.00
2024-12-08 14:55:33,99,3914,55,44,2252.82,4241.19,0.00
2024-12-08 14:55:33,100,3913,55,45,2206.84,4241.77,0.00
2024-12-08 14:55:33,100,3914,55,45,2231.61,4242.00,0.00
2024-12-08 14:55:33,101,3914,56,45,2209.51,4242.01,0.00
2024-12-08 14:55:33,101,3915,56,45,2227.81,4243.00,0.00
2024-12-08 14:55:33,102,3915,56,46,2205.97,4243.01,0.00
2024-12-08 14:55:33,101,3915,56,45,2216.94,4243.19,0.00
2024-12-08 14:55:33,102,3914,56,46,2177.92,4243.62,0.00
2024-12-08 14:55:33,101,3914,55,46,2190.75,4243.93,0.00
2024-12-08 14:55:33,101,3915,55,46,2229.88,4244.00,0.00
2024-12-08 14:55:33,102,3915,56,46,2208.02,4244.01,0.00
2024-12-08 14:55:33,103,3914,56,47,2135.02,4244.70,0.00
2024-12-08 14:55:33,103,3915,56,47,2215.60,4245.00,0.00
2024-12-08 14:55:33,104,3915,57,47,2194.30,4245.01,0.00
2024-12-08 14:55:33,103,3915,57,46,2204.53,4245.19,0.00
2024-12-08 14:55:33,102,3915,56,46,2224.02,4245.25,0.00
2024-12-08 14:55:33,101,3915,55,46,2244.79,4245.28,0.00
2024-12-08 14:55:33,101,3916,55,46,2281.80,4246.00,0.00
2024-12-08 14:55:33,102,3916,55,47,2259.43,4246.01,0.00
2024-12-08 14:55:33,101,3916,54,47,2278.06,4246.09,0.00
2024-12-08 14:55:33,100,3916,53,47,2269.55,4246.47,0.00
2024-12-08 14:55:33,100,3917,53,47,2289.87,4247.00,0.00
2024-12-08 14:55:33,101,3917,53,48,2267.20,4247.01,0.00
2024-12-08 14:55:33,100,3917,52,48,2285.67,4247.10,0.00
2024-12-08 14:55:33,101,3916,53,48,2243.77,4247.38,0.00
2024-12-08 14:55:33,101,3917,53,48,2277.32,4248.00,0.00
2024-12-08 14:55:33,102,3917,53,49,2255.00,4248.01,0.00
2024-12-08 14:55:33,101,3917,52,49,2244.91,4248.25,0.00
2024-12-08 14:55:33,101,3918,52,49,2297.53,4249.00,0.00
2024-12-08 14:55:33,102,3918,52,50,2275.01,4249.01,0.00
2024-12-08 14:55:33,101,3918,51,50,2293.76,4249.09,0.00
2024-12-08 14:55:33,100,3918,50,50,2316.27,4249.09,0.00
2024-12-08 14:55:33,99,3918,50,49,2328.11,4249.22,0.00
2024-12-08 14:55:33,99,3919,50,49,2338.47,4250.00,0.00
2024-12-08 14:55:33,100,3919,50,50,2315.08,4250.01,0.00
2024-12-08 14:55:33,99,3919,50,49,2334.64,4250.09,0.00
2024-12-08 14:55:33,99,3920,50,49,2316.51,4251.00,0.00
2024-12-08 14:55:33,100,3920,51,49,2293.34,4251.01,0.00
2024-12-08 14:55:33,101,3919,51,50,2270.64,4251.03,0.00
2024-12-08 14:55:33,100,3919,51,49,2308.29,4251.22,0.00
2024-12-08 14:55:33,99,3919,50,49,2303.61,4251.57,0.00
2024-12-08 14:55:34,100,3918,51,49,2275.97,4251.69,0.00
2024-12-08 14:55:34,100,3919,51,49,2317.44,4252.00,0.00
2024-12-08 14:55:34,101,3919,52,49,2294.50,4252.01,0.00
2024-12-08 14:55:34,101,3920,52,49,2353.99,4253.00,0.00
2024-12-08 14:55:34,102,3920,53,49,2330.91,4253.01,0.00
2024-12-08 14:55:34,101,3920,53,48,2344.35,4253.13,0.00
2024-12-08 14:55:34,101,3921,53,48,2333.06,4254.00,0.00
2024-12-08 14:55:34,102,3921,54,48,2310.19,4254.01,0.00
2024-12-08 14:55:34,101,3921,54,47,2327.21,4254.14,0.00
2024-12-08 14:55:34,102,3920,55,47,2301.50,4254.23,0.00
2024-12-08 14:55:34,102,3921,55,47,2321.58,4255.00,0.00
2024-12-08 14:55:34,103,3921,55,48,2299.04,4255.01,0.00
2024-12-08 14:55:34,102,3921,55,47,2314.95,4255.14,0.00
2024-12-08 14:55:34,101,3921,54,47,2301.90,4255.67,0.00
2024-12-08 14:55:34,101,3922,54,47,2372.51,4256.00,0.00
2024-12-08 14:55:34,102,3922,54,48,2349.25,4256.01,0.00
2024-12-08 14:55:34,103,3921,55,48,2321.11,4256.16,0.00
2024-12-08 14:55:34,102,3921,54,48,2351.86,4256.30,0.00
2024-12-08 14:55:34,103,3920,55,48,2301.70,4256.60,0.00
2024-12-08 14:55:34,103,3921,55,48,2340.43,4257.00,0.00
2024-12-08 14:55:34,104,3921,55,49,2317.93,4257.01,0.00
2024-12-08 14:55:34,103,3921,55,48,2336.75,4257.09,0.00
2024-12-08 14:55:34,104,3920,55,49,2301.63,4257.21,0.00
2024-12-08 14:55:34,105,3919,55,50,2298.46,4257.45,0.00
2024-12-08 14:55:34,105,3920,55,50,2399.00,4258.00,0.00
2024-12-08 14:55:34,106,3920,55,51,2376.37,4258.01,0.00
2024-12-08 14:55:34,107,3919,55,52,2324.93,4258.53,0.00
2024-12-08 14:55:34,106,3919,54,52,2355.32,4258.70,0.00
2024-12-08 14:55:34,106,3920,54,52,2458.67,4259.00,0.00
2024-12-08 14:55:34,107,3920,54,53,2435.69,4259.01,0.00
2024-12-08 14:55:34,108,3919,55,53,2384.17,4259.53,0.00
2024-12-08 14:55:34,108,3920,55,53,2435.61,4260.00,0.00
2024-12-08 14:55:34,109,3920,56,53,2413.26,4260.01,0.00
2024-12-08 14:55:34,108,3920,55,53,2410.42,4260.42,0.00
2024-12-08 14:55:34,108,3921,55,53,2451.89,4261.00,0.00
2024-12-08 14:55:34,109,3921,56,53,2429.40,4261.01,0.00
2024-12-08 14:55:34,108,3921,56,52,2448.37,4261.08,0.00
2024-12-08 14:55:34,107,3921,55,52,2470.86,4261.08,0.00
2024-12-08 14:55:34,106,3921,55,51,2486.93,4261.10,0.00
2024-12-08 14:55:34,107,3920,56,51,2446.36,4261.53,0.00
2024-12-08 14:55:34,108,3919,57,51,2430.94,4261.74,0.00
2024-12-08 14:55:34,107,3919,56,51,2443.74,4261.92,0.00
2024-12-08 14:55:34,107,3920,56,51,2480.06,4262.00,0.00
2024-12-08 14:55:34,108,3920,56,52,2457.09,4262.01,0.00
2024-12-08 14:55:34,107,3920,55,52,2476.90,4262.08,0.00
2024-12-08 14:55:34,106,3920,54,52,2499.87,4262.08,0.00
2024-12-08 14:55:34,105,3920,54,51,2519.61,4262.08,0.00
2024-12-08 14:55:34,106,3919,54,52,2479.13,4262.49,0.00
2024-12-08 14:55:34,107,3918,55,52,2441.09,4262.87,0.00
2024-12-08 14:55:34,107,3919,55,52,2557.93,4263.00,0.00
2024-12-08 14:55:34,108,3919,56,52,2534.24,4263.01,0.00
2024-12-08 14:55:34,107,3919,56,51,2552.79,4263.10,0.00
2024-12-08 14:55:34,108,3918,57,51,2522.12,4263.29,0.00
2024-12-08 14:55:34,107,3918,56,51,2544.45,4263.46,0.00
2024-12-08 14:55:34,107,3919,56,51,2641.29,4264.00,0.00
2024-12-08 14:55:34,108,3919,56,52,2616.83,4264.01,0.00
2024-12-08 14:55:34,107,3919,55,52,2609.19,4264.43,0.00
2024-12-08 14:55:34,107,3920,55,52,2665.03,4265.00,0.00
2024-12-08 14:55:34,108,3920,55,53,2640.35,4265.01,0.00
2024-12-08 14:55:34,107,3920,54,53,2645.21,4265.29,0.00
2024-12-08 14:55:34,108,3919,54,54,2598.54,4265.83,0.00
2024-12-08 14:55:34,108,3920,54,54,2630.20,4266.00,0.00
2024-12-08 14:55:34,109,3920,54,55,2606.07,4266.01,0.00
2024-12-08 14:55:34,108,3920,54,54,2625.89,4266.10,0.00
2024-12-08 14:55:34,108,3921,54,54,2653.03,4267.00,0.00
2024-12-08 14:55:34,109,3921,55,54,2628.69,4267.01,0.00
2024-12-08 14:55:34,109,3922,55,54,2606.80,4268.00,0.00
2024-12-08 14:55:34,110,3922,56,54,2583.10,4268.01,0.00
2024-12-08 14:55:34,111,3921,57,54,2558.69,4268.05,0.00
2024-12-08 14:55:34,111,3922,57,54,2550.82,4269.00,0.00
2024-12-08 14:55:34,112,3922,58,54,2528.04,4269.01,0.00
2024-12-08 14:55:34,111,3922,58,53,2544.70,4269.10,0.00
2024-12-08 14:55:34,112,3921,59,53,2492.64,4269.81,0.00
2024-12-08 14:55:34,112,3922,59,53,2549.98,4270.00,0.00
2024-12-08 14:55:34,113,3922,59,54,2527.42,4270.01,0.00
2024-12-08 14:55:34,112,3922,58,54,2530.26,4270.29,0.00
2024-12-08 14:55:34,112,3923,58,54,2573.04,4271.00,0.00
2024-12-08 14:55:34,113,3923,59,54,2550.26,4271.01,0.00
2024-12-08 14:55:34,114,3922,59,55,2498.52,4271.54,0.00
2024-12-08 14:55:35,114,3923,59,55,2537.88,4272.00,0.00
2024-12-08 14:55:35,115,3923,60,55,2515.81,4272.01,0.00
2024-12-08 14:55:35,115,3924,60,55,2530.20,4273.00,0.00
2024-12-08 14:55:35,116,3924,60,56,2508.39,4273.01,0.00
2024-12-08 14:55:35,116,3925,60,56,2481.34,4274.00,0.00
2024-12-08 14:55:35,117,3925,60,57,2460.13,4274.01,0.00
2024-12-08 14:55:35,116,3925,60,56,2476.21,4274.10,0.00
2024-12-08 14:55:35,116,3926,60,56,2460.18,4275.00,0.00
2024-12-08 14:55:35,117,3926,61,56,2439.15,4275.01,0.00
2024-12-08 14:55:35,116,3926,61,55,2451.36,4275.10,0.00
2024-12-08 14:55:35,117,3925,61,56,2420.26,4275.35,0.00
2024-12-08 14:55:35,117,3926,61,56,2435.33,4276.00,0.00
2024-12-08 14:55:35,118,3926,61,57,2414.70,4276.01,0.00
2024-12-08 14:55:35,117,3926,61,56,2426.59,4276.09,0.00
2024-12-08 14:55:35,116,3926,60,56,2426.19,4276.28,0.00
2024-12-08 14:55:35,116,3927,60,56,2469.44,4277.00,0.00
2024-12-08 14:55:35,117,3927,61,56,2448.33,4277.01,0.00
2024-12-08 14:55:35,116,3927,61,55,2457.31,4277.14,0.00
2024-12-08 14:55:35,117,3926,62,55,2396.42,4277.75,0.00
2024-12-08 14:55:35,117,3927,62,55,2429.16,4278.00,0.00
2024-12-08 14:55:35,118,3927,63,55,2408.57,4278.01,0.00
2024-12-08 14:55:35,117,3927,63,54,2416.40,4278.15,0.00
2024-12-08 14:55:35,116,3927,62,54,2417.00,4278.29,0.00
2024-12-08 14:55:35,117,3926,63,54,2394.91,4278.33,0.00
2024-12-08 14:55:35,117,3927,63,54,2462.28,4279.00,0.00
2024-12-08 14:55:35,118,3927,64,54,2441.41,4279.01,0.00
2024-12-08 14:55:35,119,3926,65,54,2420.54,4279.03,0.00
2024-12-08 14:55:35,118,3926,64,54,2460.30,4279.08,0.00
2024-12-08 14:55:35,119,3925,64,55,2439.26,4279.10,0.00
2024-12-08 14:55:35,118,3925,64,54,2475.91,4279.15,0.00
2024-12-08 14:55:35,118,3926,64,54,2498.20,4280.00,0.00
2024-12-08 14:55:35,119,3926,64,55,2477.21,4280.01,0.00
2024-12-08 14:55:35,118,3926,64,54,2485.92,4280.14,0.00
2024-12-08 14:55:35,118,3927,64,54,2543.77,4281.00,0.00
2024-12-08 14:55:35,119,3927,64,55,2522.40,4281.01,0.00
2024-12-08 14:55:35,118,3927,64,54,2531.12,4281.14,0.00
2024-12-08 14:55:35,119,3926,65,54,2468.83,4281.78,0.00
2024-12-08 14:55:35,119,3927,65,54,2501.76,4282.00,0.00
2024-12-08 14:55:35,120,3927,66,54,2480.91,4282.01,0.00
2024-12-08 14:55:35,119,3927,65,54,2492.43,4282.07,0.00
2024-12-08 14:55:35,118,3927,65,53,2504.13,4282.13,0.00
2024-12-08 14:55:35,118,3928,65,53,2539.88,4283.00,0.00
2024-12-08 14:55:35,119,3928,65,54,2518.54,4283.01,0.00
2024-12-08 14:55:35,120,3927,66,54,2483.33,4283.19,0.00
2024-12-08 14:55:35,119,3927,65,54,2521.90,4283.29,0.00
2024-12-08 14:55:35,119,3928,65,54,2513.36,4284.00,0.00
2024-12-08 14:55:35,120,3928,66,54,2492.42,4284.01,0.00
2024-12-08 14:55:35,119,3928,66,53,2505.86,4284.16,0.00
2024-12-08 14:55:35,118,3928,65,53,2509.06,4284.42,0.00
2024-12-08 14:55:35,118,3929,65,53,2557.41,4285.00,0.00
2024-12-08 14:55:35,119,3929,66,53,2535.92,4285.01,0.00
2024-12-08 14:55:35,118,3929,65,53,2555.25,4285.05,0.00
2024-12-08 14:55:35,119,3928,66,53,2530.56,4285.14,0.00
2024-12-08 14:55:35,118,3928,65,53,2546.28,4285.29,0.00
2024-12-08 14:55:35,118,3929,65,53,2538.03,4286.00,0.00
2024-12-08 14:55:35,119,3929,65,54,2516.70,4286.01,0.00
2024-12-08 14:55:35,118,3929,65,53,2531.18,4286.15,0.00
2024-12-08 14:55:35,118,3930,65,53,2553.51,4287.00,0.00
2024-12-08 14:55:35,119,3930,66,53,2532.06,4287.01,0.00
2024-12-08 14:55:35,119,3931,66,53,2515.75,4288.00,0.00
2024-12-08 14:55:35,120,3931,66,54,2494.79,4288.01,0.00
2024-12-08 14:55:35,119,3931,65,54,2496.77,4288.29,0.00
2024-12-08 14:55:35,119,3932,65,54,2498.11,4289.00,0.00
2024-12-08 14:55:35,120,3932,66,54,2477.29,4289.01,0.00
2024-12-08 14:55:35,119,3932,65,54,2495.97,4289.05,0.00
2024-12-08 14:55:35,118,3932,64,54,2516.40,4289.06,0.00
2024-12-08 14:55:35,117,3932,63,54,2521.50,4289.27,0.00
2024-12-08 14:55:35,118,3931,63,55,2495.09,4289.41,0.00
2024-12-08 14:55:35,119,3930,64,55,2487.85,4289.47,0.00
2024-12-08 14:55:35,120,3929,64,56,2475.07,4289.62,0.00
2024-12-08 14:55:35,120,3930,64,56,2497.22,4290.00,0.00
2024-12-08 14:55:35,121,3930,64,57,2476.59,4290.01,0.00
2024-12-08 14:55:35,120,3930,63,57,2494.75,4290.06,0.00
2024-12-08 14:55:36,121,3929,64,57,2445.66,4290.58,0.00
2024-12-08 14:55:36,122,3928,65,57,2429.25,4290.75,0.00
2024-12-08 14:55:36,122,3929,65,57,2567.46,4291.00,0.00
2024-12-08 14:55:36,123,3929,66,57,2546.59,4291.01,0.00
2024-12-08 14:55:36,122,3929,66,56,2558.01,4291.12,0.00
2024-12-08 14:55:36,121,3929,65,56,2573.54,4291.26,0.00
2024-12-08 14:55:36,120,3929,64,56,2593.21,4291.29,0.00
2024-12-08 14:55:36,120,3930,64,56,2656.28,4292.00,0.00
2024-12-08 14:55:36,121,3930,65,56,2634.33,4292.01,0.00
2024-12-08 14:55:36,120,3930,64,56,2653.81,4292.06,0.00
2024-12-08 14:55:36,121,3929,64,57,2616.70,4292.27,0.00
2024-12-08 14:55:36,120,3929,63,57,2639.87,4292.73,0.00
2024-12-08 14:55:36,120,3930,63,57,2658.24,4293.00,0.00
2024-12-08 14:55:36,121,3930,64,57,2636.27,4293.01,0.00
2024-12-08 14:55:36,120,3930,63,57,2656.47,4293.04,0.00
2024-12-08 14:55:36,119,3930,62,57,2677.72,4293.06,0.00
2024-12-08 14:55:36,120,3929,63,57,2653.63,4293.12,0.00
2024-12-08 14:55:36,120,3930,63,57,2696.32,4294.00,0.00
2024-12-08 14:55:36,121,3930,63,58,2674.03,4294.01,0.00
2024-12-08 14:55:36,121,3931,63,58,2692.90,4295.00,0.00
2024-12-08 14:55:36,122,3931,64,58,2670.82,4295.01,0.00
2024-12-08 14:55:36,122,3932,64,58,2652.61,4296.00,0.00
2024-12-08 14:55:36,123,3932,64,59,2631.05,4296.01,0.00
2024-12-08 14:55:36,122,3932,63,59,2650.18,4296.06,0.00
2024-12-08 14:55:36,123,3931,64,59,2617.49,4296.17,0.00
2024-12-08 14:55:36,124,3930,64,60,2599.93,4296.37,0.00
2024-12-08 14:55:36,124,3931,64,60,2616.56,4297.00,0.00
2024-12-08 14:55:36,125,3931,64,61,2595.63,4297.01,0.00
2024-12-08 14:55:36,126,3930,64,62,2572.67,4297.08,0.00
2024-12-08 14:55:36,126,3931,64,62,2620.55,4298.00,0.00
2024-12-08 14:55:36,127,3931,65,62,2599.91,4298.01,0.00
2024-12-08 14:55:36,126,3931,65,61,2611.72,4298.09,0.00
2024-12-08 14:55:36,126,3932,65,61,2627.64,4299.00,0.00
2024-12-08 14:55:36,127,3932,65,62,2606.95,4299.01,0.00
2024-12-08 14:55:36,126,3932,65,61,2619.83,4299.09,0.00
2024-12-08 14:55:36,126,3933,65,61,2601.63,4300.00,0.00
2024-12-08 14:55:36,127,3933,66,61,2581.15,4300.01,0.00
2024-12-08 14:55:36,126,3933,65,61,2593.48,4300.09,0.00
2024-12-08 14:55:36,125,3933,65,60,2609.07,4300.09,0.00
2024-12-08 14:55:36,126,3932,66,60,2561.41,4300.74,0.00
2024-12-08 14:55:36,127,3931,66,61,2539.04,4300.96,0.00
2024-12-08 14:55:36,127,3932,66,61,2572.26,4301.00,0.00
2024-12-08 14:55:36,128,3932,67,61,2552.17,4301.01,0.00
2024-12-08 14:55:36,127,3932,67,60,2563.49,4301.09,0.00
2024-12-08 14:55:36,128,3931,67,61,2542.80,4301.12,0.00
2024-12-08 14:55:36,129,3930,67,62,2522.27,4301.47,0.00
2024-12-08 14:55:36,129,3931,67,62,2600.00,4302.00,0.00
2024-12-08 14:55:36,130,3931,67,63,2580.00,4302.01,0.00
2024-12-08 14:55:36,129,3931,66,63,2596.01,4302.02,0.00
2024-12-08 14:55:36,128,3931,66,62,2614.96,4302.05,0.00
2024-12-08 14:55:36,128,3932,66,62,2668.66,4303.00,0.00
2024-12-08 14:55:36,129,3932,67,62,2647.97,4303.01,0.00
2024-12-08 14:55:36,128,3932,67,61,2666.34,4303.06,0.00
2024-12-08 14:55:36,127,3932,66,61,2635.67,4303.87,0.00
2024-12-08 14:55:36,127,3933,66,61,2664.24,4304.00,0.00
2024-12-08 14:55:36,128,3933,67,61,2643.43,4304.01,0.00
2024-12-08 14:55:36,127,3933,67,60,2661.56,4304.06,0.00
2024-12-08 14:55:36,128,3932,67,61,2640.11,4304.09,0.00
2024-12-08 14:55:36,127,3932,66,61,2635.49,4304.74,0.00
2024-12-08 14:55:36,127,3933,66,61,2644.86,4305.00,0.00
2024-12-08 14:55:36,128,3933,67,61,2624.20,4305.01,0.00
2024-12-08 14:55:36,127,3933,67,60,2642.52,4305.06,0.00
2024-12-08 14:55:36,126,3933,66,60,2649.89,4305.21,0.00
2024-12-08 14:55:36,127,3932,66,61,2599.98,4305.80,0.00
2024-12-08 14:55:36,127,3933,66,61,2664.23,4306.00,0.00
2024-12-08 14:55:36,128,3933,67,61,2643.42,4306.01,0.00
2024-12-08 14:55:36,127,3933,66,61,2648.40,4306.22,0.00
2024-12-08 14:55:36,128,3932,67,61,2625.05,4306.30,0.00
2024-12-08 14:55:36,128,3933,67,61,2671.16,4307.00,0.00
2024-12-08 14:55:36,129,3933,68,61,2650.45,4307.01,0.00
2024-12-08 14:55:36,128,3933,67,61,2654.44,4307.23,0.00
2024-12-08 14:55:36,127,3933,66,61,2666.48,4307.44,0.00
2024-12-08 14:55:36,127,3934,66,61,2697.07,4308.00,0.00
2024-12-08 14:55:36,128,3934,67,61,2675.99,4308.01,0.00
2024-12-08 14:55:37,127,3934,67,60,2692.35,4308.06,0.00
2024-12-08 14:55:37,128,3933,67,61,2658.99,4308.36,0.00
2024-12-08 14:55:37,129,3932,68,61,2636.01,4308.82,0.00
2024-12-08 14:55:37,129,3933,68,61,2652.86,4309.00,0.00
2024-12-08 14:55:37,130,3933,69,61,2632.45,4309.01,0.00
2024-12-08 14:55:37,131,3932,69,62,2600.52,4309.08,0.00
2024-12-08 14:55:37,131,3933,69,62,2661.30,4310.00,0.00
2024-12-08 14:55:37,132,3933,69,63,2641.14,4310.01,0.00
2024-12-08 14:55:37,133,3932,69,64,2593.97,4310.51,0.00
2024-12-08 14:55:37,133,3933,69,64,2646.12,4311.00,0.00
2024-12-08 14:55:37,134,3933,70,64,2626.37,4311.01,0.00
2024-12-08 14:55:37,134,3934,70,64,2633.28,4312.00,0.00
2024-12-08 14:55:37,135,3934,70,65,2613.77,4312.01,0.00
2024-12-08 14:55:37,136,3933,70,66,2573.15,4312.38,0.00
2024-12-08 14:55:37,135,3933,69,66,2575.53,4312.56,0.00
2024-12-08 14:55:37,135,3934,69,66,2588.64,4313.00,0.00
2024-12-08 14:55:37,136,3934,70,66,2569.61,4313.01,0.00
2024-12-08 14:55:37,135,3934,70,65,2583.87,4313.05,0.00
2024-12-08 14:55:37,134,3934,69,65,2594.55,4313.25,0.00
2024-12-08 14:55:37,135,3933,69,66,2557.04,4313.70,0.00
2024-12-08 14:55:37,135,3934,69,66,2597.55,4314.00,0.00
2024-12-08 14:55:37,136,3934,70,66,2578.45,4314.01,0.00
2024-12-08 14:55:37,135,3934,69,66,2563.22,4314.66,0.00
2024-12-08 14:55:37,135,3935,69,66,2609.99,4315.00,0.00
2024-12-08 14:55:37,136,3935,69,67,2590.79,4315.01,0.00
2024-12-08 14:55:37,135,3935,68,67,2592.83,4315.26,0.00
2024-12-08 14:55:37,134,3935,67,67,2603.56,4315.46,0.00
2024-12-08 14:55:37,135,3934,68,67,2564.79,4315.84,0.00
2024-12-08 14:55:37,135,3935,68,67,2594.02,4316.00,0.00
2024-12-08 14:55:37,136,3935,68,68,2574.95,4316.01,0.00
2024-12-08 14:55:37,135,3935,67,68,2546.57,4316.79,0.00
2024-12-08 14:55:37,135,3936,67,68,2601.74,4317.00,0.00
2024-12-08 14:55:37,136,3936,68,68,2582.61,4317.01,0.00
2024-12-08 14:55:37,137,3935,68,69,2544.65,4317.32,0.00
2024-12-08 14:55:37,138,3934,68,70,2537.57,4317.49,0.00
2024-12-08 14:55:37,138,3935,68,70,2548.27,4318.00,0.00
2024-12-08 14:55:37,139,3935,69,70,2529.94,4318.01,0.00
2024-12-08 14:55:37,139,3936,69,70,2569.13,4319.00,0.00
2024-12-08 14:55:37,140,3936,70,70,2550.78,4319.01,0.00
2024-12-08 14:55:37,140,3937,70,70,2522.85,4320.00,0.00
2024-12-08 14:55:37,141,3937,70,71,2504.96,4320.01,0.00
2024-12-08 14:55:37,142,3936,71,71,2487.31,4320.02,0.00
2024-12-08 14:55:37,141,3936,71,70,2519.06,4320.04,0.00
2024-12-08 14:55:37,141,3937,71,70,2496.34,4321.00,0.00
2024-12-08 14:55:37,142,3937,72,70,2478.76,4321.01,0.00
2024-12-08 14:55:37,141,3937,72,69,2492.07,4321.04,0.00
2024-12-08 14:55:37,142,3936,73,69,2451.94,4321.58,0.00
2024-12-08 14:55:37,143,3935,74,69,2443.29,4321.64,0.00
2024-12-08 14:55:37,143,3936,74,69,2485.57,4322.00,0.00
2024-12-08 14:55:37,144,3936,75,69,2468.31,4322.01,0.00
2024-12-08 14:55:37,143,3936,75,68,2481.97,4322.07,0.00
2024-12-08 14:55:37,144,3935,76,68,2422.79,4322.79,0.00
2024-12-08 14:55:37,144,3936,76,68,2508.81,4323.00,0.00
2024-12-08 14:55:37,145,3936,77,68,2491.51,4323.01,0.00
2024-12-08 14:55:37,144,3936,76,68,2506.14,4323.06,0.00
2024-12-08 14:55:37,143,3936,76,67,2519.43,4323.08,0.00
2024-12-08 14:55:37,142,3936,75,67,2530.78,4323.11,0.00
2024-12-08 14:55:37,142,3937,75,67,2553.56,4324.00,0.00
2024-12-08 14:55:37,143,3937,75,68,2535.71,4324.01,0.00
2024-12-08 14:55:37,142,3937,75,67,2546.89,4324.08,0.00
2024-12-08 14:55:37,143,3936,75,68,2520.10,4324.31,0.00
2024-12-08 14:55:37,142,3936,74,68,2538.12,4324.75,0.00
2024-12-08 14:55:37,142,3937,74,68,2545.63,4325.00,0.00
2024-12-08 14:55:37,143,3937,75,68,2527.83,4325.01,0.00
2024-12-08 14:55:37,142,3937,74,68,2542.91,4325.06,0.00
2024-12-08 14:55:37,141,3937,74,67,2554.51,4325.09,0.00
2024-12-08 14:55:37,141,3938,74,67,2564.89,4326.00,0.00
2024-12-08 14:55:37,142,3938,75,67,2546.82,4326.01,0.00
2024-12-08 14:55:37,141,3938,75,66,2556.33,4326.09,0.00
2024-12-08 14:55:37,140,3938,74,66,2556.12,4326.26,0.00
2024-12-08 14:55:38,140,3939,74,66,2555.68,4327.00,0.00
2024-12-08 14:55:38,141,3939,74,67,2537.55,4327.01,0.00
2024-12-08 14:55:38,140,3939,73,67,2549.22,4327.08,0.00
2024-12-08 14:55:38,139,3939,73,66,2561.95,4327.09,0.00
2024-12-08 14:55:38,139,3940,73,66,2554.11,4328.00,0.00
2024-12-08 14:55:38,140,3940,73,67,2535.87,4328.01,0.00
2024-12-08 14:55:38,139,3940,72,67,2522.28,4328.32,0.00
2024-12-08 14:55:38,139,3941,72,67,2524.60,4329.00,0.00
2024-12-08 14:55:38,140,3941,73,67,2506.57,4329.01,0.00
2024-12-08 14:55:38,139,3941,72,67,2513.92,4329.04,0.00
2024-12-08 14:55:38,138,3941,71,67,2530.89,4329.06,0.00
2024-12-08 14:55:38,137,3941,71,66,2544.62,4329.07,0.00
2024-12-08 14:55:38,136,3941,70,66,2553.25,4329.31,0.00
2024-12-08 14:55:38,136,3942,70,66,2555.62,4330.00,0.00
2024-12-08 14:55:38,137,3942,71,66,2536.97,4330.01,0.00
2024-12-08 14:55:38,138,3941,71,67,2504.84,4330.20,0.00
2024-12-08 14:55:38,139,3940,71,68,2472.57,4330.84,0.00
2024-12-08 14:55:38,139,3941,71,68,2501.37,4331.00,0.00
2024-12-08 14:55:38,140,3941,71,69,2483.50,4331.01,0.00
2024-12-08 14:55:38,141,3940,72,69,2433.02,4331.65,0.00
2024-12-08 14:55:38,141,3941,72,69,2508.94,4332.00,0.00
2024-12-08 14:55:38,142,3941,73,69,2491.27,4332.01,0.00
2024-12-08 14:55:38,141,3941,73,68,2500.66,4332.07,0.00
2024-12-08 14:55:38,141,3942,73,68,2510.13,4333.00,0.00
2024-12-08 14:55:38,142,3942,73,69,2492.45,4333.01,0.00
2024-12-08 14:55:38,141,3942,73,68,2502.47,4333.08,0.00
2024-12-08 14:55:38,140,3942,72,68,2505.82,4333.41,0.00
2024-12-08 14:55:38,140,3943,72,68,2499.42,4334.00,0.00
2024-12-08 14:55:38,141,3943,72,69,2481.69,4334.01,0.00
2024-12-08 14:55:38,140,3943,71,69,2495.10,4334.06,0.00
2024-12-08 14:55:38,140,3944,71,69,2479.87,4335.00,0.00
2024-12-08 14:55:38,141,3944,72,69,2462.28,4335.01,0.00
2024-12-08 14:55:38,140,3944,71,69,2477.64,4335.06,0.00
2024-12-08 14:55:38,141,3943,72,69,2452.39,4335.11,0.00
2024-12-08 14:55:38,141,3944,72,69,2460.82,4336.00,0.00
2024-12-08 14:55:38,142,3944,73,69,2443.49,4336.01,0.00
2024-12-08 14:55:38,141,3944,73,68,2451.92,4336.06,0.00
2024-12-08 14:55:38,142,3943,73,69,2405.99,4336.75,0.00
2024-12-08 14:55:38,142,3944,73,69,2451.08,4337.00,0.00
2024-12-08 14:55:38,143,3944,74,69,2433.94,4337.01,0.00
2024-12-08 14:55:38,142,3944,74,68,2444.69,4337.06,0.00
2024-12-08 14:55:38,141,3944,73,68,2442.44,4337.52,0.00
2024-12-08 14:55:38,141,3945,73,68,2471.08,4338.00,0.00
2024-12-08 14:55:38,142,3945,73,69,2453.67,4338.01,0.00
2024-12-08 14:55:38,141,3945,72,69,2469.88,4338.03,0.00
2024-12-08 14:55:38,140,3945,71,69,2475.45,4338.06,0.00
2024-12-08 14:55:38,141,3944,72,69,2425.08,4338.84,0.00
2024-12-08 14:55:38,141,3945,72,69,2453.83,4339.00,0.00
2024-12-08 14:55:38,142,3945,72,70,2436.55,4339.01,0.00
2024-12-08 14:55:38,141,3945,71,70,2444.52,4339.08,0.00
2024-12-08 14:55:38,141,3946,71,70,2454.62,4340.00,0.00
2024-12-08 14:55:38,142,3946,71,71,2437.33,4340.01,0.00
2024-12-08 14:55:38,141,3946,71,70,2449.40,4340.06,0.00
2024-12-08 14:55:38,140,3946,70,70,2455.21,4340.32,0.00
2024-12-08 14:55:38,141,3945,70,71,2437.79,4340.33,0.00
2024-12-08 14:55:38,141,3946,70,71,2458.55,4341.00,0.00
2024-12-08 14:55:38,142,3946,71,71,2441.24,4341.01,0.00
2024-12-08 14:55:38,142,3947,71,71,2451.22,4342.00,0.00
2024-12-08 14:55:38,143,3947,71,72,2434.08,4342.01,0.00
2024-12-08 14:55:38,144,3946,72,72,2406.66,4342.13,0.00
2024-12-08 14:55:38,145,3945,73,72,2370.07,4342.83,0.00
2024-12-08 14:55:38,145,3946,73,72,2394.48,4343.00,0.00
2024-12-08 14:55:38,146,3946,74,72,2378.08,4343.01,0.00
2024-12-08 14:55:38,147,3945,75,72,2332.89,4343.56,0.00
2024-12-08 14:55:38,146,3945,74,72,2350.22,4343.80,0.00
2024-12-08 14:55:38,146,3946,74,72,2424.67,4344.00,0.00
2024-12-08 14:55:38,147,3946,74,73,2408.17,4344.01,0.00
2024-12-08 14:55:38,146,3946,73,73,2413.37,4344.03,0.00
2024-12-08 14:55:38,145,3946,73,72,2428.52,4344.04,0.00
2024-12-08 14:55:38,146,3945,73,73,2396.26,4344.42,0.00
2024-12-08 14:55:38,146,3946,73,73,2437.43,4345.00,0.00
2024-12-08 14:55:38,147,3946,73,74,2420.85,4345.01,0.00
2024-12-08 14:55:38,148,3945,73,75,2396.87,4345.06,0.00
2024-12-08 14:55:38,149,3944,74,75,2372.23,4345.53,0.00
2024-12-08 14:55:38,149,3945,74,75,2412.04,4346.00,0.00
2024-12-08 14:55:38,150,3945,74,76,2395.96,4346.01,0.00
2024-12-08 14:55:38,149,3945,74,75,2407.67,4346.04,0.00
2024-12-08 14:55:38,150,3944,75,75,2377.55,4346.38,0.00
2024-12-08 14:55:38,151,3943,76,75,2369.40,4346.59,0.00
2024-12-08 14:55:38,152,3942,76,76,2363.84,4346.61,0.00
2024-12-08 14:55:39,152,3943,76,76,2431.90,4347.00,0.00
2024-12-08 14:55:39,153,3943,77,76,2416.00,4347.01,0.00
2024-12-08 14:55:39,152,3943,77,75,2427.34,4347.05,0.00
2024-12-08 14:55:39,153,3942,78,75,2383.10,4347.73,0.00
2024-12-08 14:55:39,153,3943,78,75,2480.78,4348.00,0.00
2024-12-08 14:55:39,154,3943,78,76,2464.67,4348.01,0.00
2024-12-08 14:55:39,153,3943,78,75,2473.70,4348.05,0.00
2024-12-08 14:55:39,152,3943,77,75,2478.57,4348.18,0.00
2024-12-08 14:55:39,152,3944,77,75,2500.54,4349.00,0.00
2024-12-08 14:55:39,153,3944,78,75,2484.20,4349.01,0.00
2024-12-08 14:55:39,152,3944,78,74,2495.69,4349.06,0.00
2024-12-08 14:55:39,152,3945,78,74,2472.50,4350.00,0.00
2024-12-08 14:55:39,153,3945,79,74,2456.34,4350.01,0.00
2024-12-08 14:55:39,154,3944,80,74,2431.66,4350.09,0.00
2024-12-08 14:55:39,155,3943,80,75,2405.11,4350.83,0.00
2024-12-08 14:55:39,155,3944,80,75,2438.24,4351.00,0.00
2024-12-08 14:55:39,156,3944,80,76,2422.61,4351.01,0.00
2024-12-08 14:55:39,155,3944,79,76,2436.84,4351.03,0.00
2024-12-08 14:55:39,156,3943,80,76,2385.03,4351.76,0.00
2024-12-08 14:55:39,156,3944,80,76,2459.01,4352.00,0.00
2024-12-08 14:55:39,157,3944,80,77,2443.35,4352.01,0.00
2024-12-08 14:55:39,157,3945,80,77,2441.88,4353.00,0.00
2024-12-08 14:55:39,158,3945,81,77,2426.43,4353.01,0.00
2024-12-08 14:55:39,157,3945,81,76,2434.96,4353.05,0.00
2024-12-08 14:55:39,156,3945,80,76,2439.89,4353.30,0.00
2024-12-08 14:55:39,157,3944,81,76,2409.83,4353.64,0.00
2024-12-08 14:55:39,158,3943,82,76,2399.33,4353.75,0.00
2024-12-08 14:55:39,158,3944,82,76,2411.12,4354.00,0.00
2024-12-08 14:55:39,159,3944,82,77,2395.96,4354.01,0.00
2024-12-08 14:55:39,160,3943,83,77,2373.38,4354.07,0.00
2024-12-08 14:55:39,161,3942,84,77,2367.04,4354.11,0.00
2024-12-08 14:55:39,160,3942,83,77,2382.25,4354.28,0.00
2024-12-08 14:55:39,160,3943,83,77,2430.46,4355.00,0.00
2024-12-08 14:55:39,161,3943,83,78,2415.37,4355.01,0.00
2024-12-08 14:55:39,162,3942,83,79,2376.43,4355.45,0.00
2024-12-08 14:55:39,161,3942,82,79,2386.77,4355.75,0.00
2024-12-08 14:55:39,161,3943,82,79,2453.45,4356.00,0.00
2024-12-08 14:55:39,162,3943,83,79,2438.31,4356.01,0.00
2024-12-08 14:55:39,161,3943,82,79,2451.57,4356.04,0.00
2024-12-08 14:55:39,161,3944,82,79,2452.19,4357.00,0.00
2024-12-08 14:55:39,162,3944,82,80,2437.06,4357.01,0.00
2024-12-08 14:55:39,163,3943,83,80,2389.24,4357.66,0.00
2024-12-08 14:55:39,162,3943,82,80,2406.35,4357.69,0.00
2024-12-08 14:55:39,162,3944,82,80,2409.51,4358.00,0.00
2024-12-08 14:55:39,163,3944,82,81,2394.73,4358.01,0.00
2024-12-08 14:55:39,162,3944,82,80,2406.56,4358.04,0.00
2024-12-08 14:55:39,163,3943,83,80,2382.77,4358.26,0.00
2024-12-08 14:55:39,164,3942,84,80,2373.34,4358.38,0.00
2024-12-08 14:55:39,165,3941,85,80,2374.55,4358.39,0.00
2024-12-08 14:55:39,165,3942,85,80,2406.14,4359.00,0.00
2024-12-08 14:55:39,166,3942,85,81,2391.64,4359.01,0.00
2024-12-08 14:55:39,167,3941,86,81,2370.03,4359.07,0.00
2024-12-08 14:55:39,168,3940,87,81,2369.44,4359.17,0.00
2024-12-08 14:55:39,169,3939,87,82,2352.98,4359.49,0.00
2024-12-08 14:55:39,169,3940,87,82,2448.13,4360.00,0.00
2024-12-08 14:55:39,170,3940,88,82,2433.73,4360.01,0.00
2024-12-08 14:55:39,170,3941,88,82,2485.17,4361.00,0.00
2024-12-08 14:55:39,171,3941,88,83,2470.64,4361.01,0.00
2024-12-08 14:55:39,170,3941,88,82,2484.15,4361.02,0.00
2024-12-08 14:55:39,169,3941,87,82,2491.65,4361.07,0.00
2024-12-08 14:55:39,169,3942,87,82,2471.64,4362.00,0.00
2024-12-08 14:55:39,170,3942,88,82,2457.10,4362.01,0.00
2024-12-08 14:55:39,169,3942,87,82,2470.35,4362.03,0.00
2024-12-08 14:55:39,168,3942,87,81,2478.07,4362.07,0.00
2024-12-08 14:55:39,167,3942,87,80,2492.65,4362.07,0.00
2024-12-08 14:55:39,168,3941,88,80,2456.46,4362.57,0.00
2024-12-08 14:55:39,167,3941,87,80,2470.02,4362.84,0.00
2024-12-08 14:55:39,167,3942,87,80,2480.47,4363.00,0.00
2024-12-08 14:55:39,168,3942,87,81,2465.71,4363.01,0.00
2024-12-08 14:55:39,167,3942,87,80,2476.30,4363.03,0.00
2024-12-08 14:55:39,166,3942,86,80,2489.66,4363.06,0.00
2024-12-08 14:55:39,167,3941,87,80,2470.33,4363.17,0.00
2024-12-08 14:55:39,168,3940,87,81,2447.46,4363.51,0.00
2024-12-08 14:55:39,168,3941,87,81,2480.04,4364.00,0.00
2024-12-08 14:55:39,169,3941,88,81,2465.36,4364.01,0.00
2024-12-08 14:55:39,168,3941,88,80,2472.02,4364.07,0.00
2024-12-08 14:55:39,168,3942,88,80,2507.04,4365.00,0.00
2024-12-08 14:55:39,169,3942,89,80,2492.21,4365.01,0.00
2024-12-08 14:55:39,168,3942,89,79,2499.02,4365.07,0.00
2024-12-08 14:55:39,167,3942,89,78,2513.72,4365.07,0.00
2024-12-08 14:55:39,168,3941,89,79,2481.76,4365.47,0.00
2024-12-08 14:55:39,169,3940,89,80,2479.89,4365.72,0.00
2024-12-08 14:55:40,169,3941,89,80,2495.47,4366.00,0.00
2024-12-08 14:55:40,170,3941,90,80,2480.79,4366.01,0.00
2024-12-08 14:55:40,169,3941,90,79,2487.48,4366.07,0.00
2024-12-08 14:55:40,168,3941,89,79,2474.45,4366.71,0.00
2024-12-08 14:55:40,168,3942,89,79,2532.79,4367.00,0.00
2024-12-08 14:55:40,169,3942,89,80,2517.80,4367.01,0.00
2024-12-08 14:55:40,170,3941,90,80,2486.63,4367.28,0.00
2024-12-08 14:55:40,169,3941,89,80,2514.57,4367.37,0.00
2024-12-08 14:55:40,169,3942,89,80,2502.87,4368.00,0.00
2024-12-08 14:55:40,170,3942,90,80,2488.15,4368.01,0.00
2024-12-08 14:55:40,169,3942,89,80,2502.10,4368.02,0.00
2024-12-08 14:55:40,168,3942,89,79,2515.95,4368.02,0.00
2024-12-08 14:55:40,167,3942,88,79,2516.50,4368.36,0.00
2024-12-08 14:55:40,167,3943,88,79,2530.81,4369.00,0.00
2024-12-08 14:55:40,168,3943,88,80,2515.74,4369.01,0.00
2024-12-08 14:55:40,169,3942,89,80,2494.66,4369.04,0.00
2024-12-08 14:55:40,168,3942,88,80,2529.03,4369.06,0.00
2024-12-08 14:55:40,168,3943,88,80,2512.03,4370.00,0.00
2024-12-08 14:55:40,169,3943,88,81,2497.16,4370.01,0.00
2024-12-08 14:55:40,169,3944,88,81,2497.21,4371.00,0.00
2024-12-08 14:55:40,170,3944,89,81,2482.52,4371.01,0.00
2024-12-08 14:55:40,169,3944,89,80,2489.22,4371.07,0.00
2024-12-08 14:55:40,170,3943,89,81,2455.73,4371.51,0.00
2024-12-08 14:55:40,170,3944,89,81,2466.32,4372.00,0.00
2024-12-08 14:55:40,171,3944,90,81,2451.90,4372.01,0.00
2024-12-08 14:55:40,172,3943,90,82,2426.50,4372.16,0.00
2024-12-08 14:55:40,171,3943,89,82,2455.60,4372.39,0.00
2024-12-08 14:55:40,171,3944,89,82,2470.47,4373.00,0.00
2024-12-08 14:55:40,172,3944,90,82,2456.10,4373.01,0.00
2024-12-08 14:55:40,171,3944,90,81,2467.92,4373.02,0.00
2024-12-08 14:55:40,172,3943,90,82,2441.21,4373.32,0.00
2024-12-08 14:55:40,172,3944,90,82,2456.92,4374.00,0.00
2024-12-08 14:55:40,173,3944,91,82,2442.72,4374.01,0.00
2024-12-08 14:55:40,172,3944,91,81,2440.80,4374.06,0.00
2024-12-08 14:55:40,173,3943,91,82,2410.40,4374.45,0.00
2024-12-08 14:55:40,173,3944,91,82,2442.39,4375.00,0.00
2024-12-08 14:55:40,174,3944,91,83,2428.36,4375.01,0.00
2024-12-08 14:55:40,173,3944,90,83,2432.15,4375.02,0.00
2024-12-08 14:55:40,172,3944,90,82,2441.22,4375.04,0.00
2024-12-08 14:55:40,171,3944,89,82,2454.73,4375.05,0.00
2024-12-08 14:55:40,170,3944,89,81,2468.92,4375.05,0.00
2024-12-08 14:55:40,171,3943,89,82,2430.68,4375.61,0.00
2024-12-08 14:55:40,172,3942,90,82,2420.68,4375.72,0.00
2024-12-08 14:55:40,172,3943,90,82,2472.00,4376.00,0.00
2024-12-08 14:55:40,173,3943,90,83,2457.71,4376.01,0.00
2024-12-08 14:55:40,174,3942,90,84,2442.84,4376.04,0.00
2024-12-08 14:55:40,173,3942,90,83,2466.58,4376.06,0.00
2024-12-08 14:55:40,173,3943,90,83,2499.13,4377.00,0.00
2024-12-08 14:55:40,174,3943,91,83,2484.77,4377.01,0.00
2024-12-08 14:55:40,173,3943,90,83,2491.82,4377.05,0.00
2024-12-08 14:55:40,172,3943,89,83,2496.30,4377.22,0.00
2024-12-08 14:55:40,171,3943,88,83,2508.46,4377.27,0.00
2024-12-08 14:55:40,172,3942,88,84,2490.35,4377.36,0.00
2024-12-08 14:55:40,171,3942,87,84,2499.33,4377.76,0.00
2024-12-08 14:55:40,172,3941,87,85,2482.05,4377.83,0.00
2024-12-08 14:55:40,172,3942,87,85,2529.53,4378.00,0.00
2024-12-08 14:55:40,173,3942,88,85,2514.91,4378.01,0.00
2024-12-08 14:55:40,172,3942,87,85,2522.17,4378.05,0.00
2024-12-08 14:55:40,171,3942,86,85,2536.66,4378.05,0.00
2024-12-08 14:55:40,170,3942,85,85,2538.32,4378.36,0.00
2024-12-08 14:55:40,171,3941,86,85,2521.69,4378.41,0.00
2024-12-08 14:55:40,171,3942,86,85,2569.20,4379.00,0.00
2024-12-08 14:55:40,172,3942,86,86,2554.26,4379.01,0.00
2024-12-08 14:55:40,171,3942,85,86,2568.69,4379.01,0.00
2024-12-08 14:55:40,170,3942,85,85,2577.12,4379.04,0.00
2024-12-08 14:55:40,170,3943,85,85,2576.91,4380.00,0.00
2024-12-08 14:55:40,171,3943,86,85,2561.84,4380.01,0.00
2024-12-08 14:55:40,170,3943,86,84,2574.62,4380.05,0.00
2024-12-08 14:55:40,169,3943,86,83,2589.34,4380.05,0.00
2024-12-08 14:55:40,170,3942,86,84,2563.63,4380.31,0.00
2024-12-08 14:55:40,171,3941,87,84,2558.65,4380.34,0.00
2024-12-08 14:55:40,170,3941,86,84,2576.80,4380.37,0.00
2024-12-08 14:55:40,170,3942,86,84,2564.88,4381.00,0.00
2024-12-08 14:55:40,171,3942,87,84,2549.88,4381.01,0.00
2024-12-08 14:55:40,170,3942,86,84,2563.60,4381.03,0.00
2024-12-08 14:55:40,169,3942,86,83,2574.64,4381.08,0.00
2024-12-08 14:55:41,170,3941,87,83,2544.19,4381.44,0.00
2024-12-08 14:55:41,171,3940,87,84,2530.92,4381.57,0.00
2024-12-08 14:55:41,170,3940,86,84,2540.32,4381.77,0.00
2024-12-08 14:55:41,170,3941,86,84,2607.77,4382.00,0.00
2024-12-08 14:55:41,171,3941,86,85,2592.52,4382.01,0.00
2024-12-08 14:55:41,170,3941,85,85,2605.73,4382.05,0.00
2024-12-08 14:55:41,169,3941,85,84,2618.05,4382.07,0.00
2024-12-08 14:55:41,168,3941,84,84,2626.89,4382.20,0.00
2024-12-08 14:55:41,169,3940,84,85,2605.96,4382.34,0.00
2024-12-08 14:55:41,170,3939,84,86,2569.33,4382.88,0.00
2024-12-08 14:55:41,170,3940,84,86,2643.68,4383.00,0.00
2024-12-08 14:55:41,171,3940,85,86,2628.22,4383.01,0.00
2024-12-08 14:55:41,170,3940,85,85,2641.64,4383.05,0.00
2024-12-08 14:55:41,171,3939,85,86,2613.44,4383.23,0.00
2024-12-08 14:55:41,172,3938,85,87,2605.94,4383.27,0.00
2024-12-08 14:55:41,172,3939,85,87,2668.63,4384.00,0.00
2024-12-08 14:55:41,173,3939,85,88,2653.20,4384.01,0.00
2024-12-08 14:55:41,174,3938,86,88,2636.96,4384.04,0.00
2024-12-08 14:55:41,173,3938,86,87,2671.74,4384.08,0.00
2024-12-08 14:55:41,173,3939,86,87,2697.66,4385.00,0.00
2024-12-08 14:55:41,174,3939,86,88,2682.15,4385.01,0.00
2024-12-08 14:55:41,173,3939,86,87,2693.39,4385.07,0.00
2024-12-08 14:55:41,172,3939,85,87,2699.06,4385.30,0.00
2024-12-08 14:55:41,171,3939,84,87,2712.31,4385.35,0.00
2024-12-08 14:55:41,170,3939,83,87,2727.75,4385.35,0.00
2024-12-08 14:55:41,170,3940,83,87,2751.41,4386.00,0.00
2024-12-08 14:55:41,171,3940,83,88,2735.32,4386.01,0.00
2024-12-08 14:55:41,170,3940,83,87,2748.87,4386.06,0.00
2024-12-08 14:55:41,169,3940,83,86,2762.03,4386.09,0.00
2024-12-08 14:55:41,168,3940,82,86,2764.44,4386.24,0.00
2024-12-08 14:55:41,168,3941,82,86,2757.91,4387.00,0.00
2024-12-08 14:55:41,169,3941,83,86,2741.59,4387.01,0.00
2024-12-08 14:55:41,168,3941,83,85,2752.71,4387.04,0.00
2024-12-08 14:55:41,169,3940,84,85,2710.01,4387.66,0.00
2024-12-08 14:55:41,169,3941,84,85,2718.33,4388.00,0.00
2024-12-08 14:55:41,170,3941,85,85,2702.34,4388.01,0.00
2024-12-08 14:55:41,169,3941,85,84,2709.28,4388.09,0.00
2024-12-08 14:55:41,169,3942,85,84,2711.42,4389.00,0.00
2024-12-08 14:55:41,170,3942,85,85,2695.47,4389.01,0.00
2024-12-08 14:55:41,169,3942,85,84,2695.35,4389.09,0.00
2024-12-08 14:55:41,170,3941,85,85,2678.99,4389.11,0.00
2024-12-08 14:55:41,171,3940,85,86,2658.05,4389.78,0.00
2024-12-08 14:55:41,171,3941,85,86,2688.65,4390.00,0.00
2024-12-08 14:55:41,172,3941,86,86,2673.02,4390.01,0.00
2024-12-08 14:55:41,173,3940,86,87,2657.32,4390.02,0.00
2024-12-08 14:55:41,172,3940,85,87,2675.61,4390.07,0.00
2024-12-08 14:55:41,171,3940,85,86,2688.44,4390.09,0.00
2024-12-08 14:55:41,172,3939,85,87,2665.74,4390.27,0.00
2024-12-08 14:55:41,173,3938,86,87,2651.61,4390.29,0.00
2024-12-08 14:55:41,172,3938,85,87,2668.07,4390.33,0.00
2024-12-08 14:55:41,172,3939,85,87,2705.54,4391.00,0.00
2024-12-08 14:55:41,173,3939,86,87,2689.90,4391.01,0.00
2024-12-08 14:55:41,172,3939,85,87,2702.77,4391.06,0.00
2024-12-08 14:55:41,173,3938,86,87,2670.96,4391.24,0.00
2024-12-08 14:55:41,173,3939,86,87,2758.28,4392.00,0.00
2024-12-08 14:55:41,174,3939,86,88,2742.43,4392.01,0.00
2024-12-08 14:55:41,173,3939,85,88,2755.53,4392.06,0.00
2024-12-08 14:55:41,174,3938,85,89,2709.45,4392.66,0.00
2024-12-08 14:55:41,174,3939,85,89,2744.19,4393.00,0.00
2024-12-08 14:55:41,175,3939,85,90,2728.51,4393.01,0.00
2024-12-08 14:55:41,174,3939,84,90,2741.45,4393.06,0.00
2024-12-08 14:55:41,173,3939,83,90,2737.54,4393.40,0.00
2024-12-08 14:55:41,174,3938,84,90,2715.58,4393.55,0.00
2024-12-08 14:55:41,174,3939,84,90,2746.22,4394.00,0.00
2024-12-08 14:55:41,175,3939,85,90,2730.53,4394.01,0.00
2024-12-08 14:55:41,176,3938,85,91,2712.55,4394.07,0.00
2024-12-08 14:55:41,175,3938,85,90,2732.84,4394.09,0.00
2024-12-08 14:55:41,174,3938,84,90,2703.51,4394.97,0.00
2024-12-08 14:55:41,174,3939,84,90,2752.78,4395.00,0.00
2024-12-08 14:55:41,175,3939,84,91,2737.05,4395.01,0.00
2024-12-08 14:55:41,176,3938,85,91,2673.72,4395.78,0.00
2024-12-08 14:55:41,176,3939,85,91,2718.61,4396.00,0.00
2024-12-08 14:55:41,177,3939,85,92,2703.25,4396.01,0.00
2024-12-08 14:55:41,176,3939,85,91,2701.17,4396.09,0.00
2024-12-08 14:55:41,177,3938,85,92,2665.77,4396.56,0.00
2024-12-08 14:55:41,177,3939,85,92,2705.61,4397.00,0.00
2024-12-08 14:55:41,178,3939,86,92,2690.41,4397.01,0.00
2024-12-08 14:55:41,177,3939,85,92,2702.40,4397.03,0.00
2024-12-08 14:55:41,178,3938,85,93,2685.52,4397.08,0.00
2024-12-08 14:55:41,177,3938,84,93,2693.85,4397.33,0.00
2024-12-08 14:55:41,177,3939,84,93,2714.68,4398.00,0.00
2024-12-08 14:55:41,178,3939,84,94,2699.43,4398.01,0.00
2024-12-08 14:55:41,179,3938,84,95,2682.90,4398.05,0.00
2024-12-08 14:55:41,180,3937,84,96,2652.58,4398.52,0.00
2024-12-08 14:55:42,180,3938,84,96,2681.29,4399.00,0.00
2024-12-08 14:55:42,181,3938,85,96,2666.47,4399.01,0.00
2024-12-08 14:55:42,180,3938,85,95,2676.20,4399.08,0.00
2024-12-08 14:55:42,181,3937,86,95,2638.35,4399.63,0.00
2024-12-08 14:55:42,182,3936,86,96,2629.69,4399.68,0.00
2024-12-08 14:55:42,183,3935,87,96,2623.63,4399.86,0.00
2024-12-08 14:55:42,183,3936,87,96,2682.89,4400.00,0.00
2024-12-08 14:55:42,184,3936,88,96,2668.31,4400.01,0.00
2024-12-08 14:55:42,183,3936,87,96,2679.81,4400.07,0.00
2024-12-08 14:55:42,182,3936,87,95,2690.43,4400.08,0.00
2024-12-08 14:55:42,182,3937,87,95,2737.42,4401.00,0.00
2024-12-08 14:55:42,183,3937,87,96,2722.46,4401.01,0.00
2024-12-08 14:55:42,182,3937,86,96,2734.32,4401.07,0.00
2024-12-08 14:55:42,183,3936,87,96,2705.04,4401.30,0.00
2024-12-08 14:55:42,184,3935,87,97,2699.26,4401.46,0.00
2024-12-08 14:55:42,185,3934,88,97,2695.15,4401.48,0.00
2024-12-08 14:55:42,185,3935,88,97,2712.55,4402.00,0.00
2024-12-08 14:55:42,186,3935,89,97,2697.96,4402.01,0.00
2024-12-08 14:55:42,185,3935,89,96,2708.31,4402.08,0.00
2024-12-08 14:55:42,186,3934,90,96,2686.95,4402.25,0.00
2024-12-08 14:55:42,186,3935,90,96,2744.26,4403.00,0.00
2024-12-08 14:55:42,187,3935,91,96,2729.59,4403.01,0.00
2024-12-08 14:55:42,186,3935,90,96,2710.22,4403.56,0.00
2024-12-08 14:55:42,186,3936,90,96,2738.49,4404.00,0.00
2024-12-08 14:55:42,187,3936,91,96,2723.85,4404.01,0.00
2024-12-08 14:55:42,186,3936,90,96,2736.39,4404.05,0.00
2024-12-08 14:55:42,185,3936,89,96,2715.38,4404.76,0.00
2024-12-08 14:55:42,186,3935,89,97,2697.07,4404.86,0.00
2024-12-08 14:55:42,186,3936,89,97,2707.85,4405.00,0.00
2024-12-08 14:55:42,187,3936,90,97,2693.37,4405.01,0.00
2024-12-08 14:55:42,186,3936,90,96,2703.87,4405.09,0.00
2024-12-08 14:55:42,187,3935,90,97,2679.38,4405.33,0.00
2024-12-08 14:55:42,188,3934,90,98,2673.18,4405.48,0.00
2024-12-08 14:55:42,188,3935,90,98,2699.11,4406.00,0.00
2024-12-08 14:55:42,189,3935,90,99,2684.82,4406.01,0.00
2024-12-08 14:55:42,188,3935,89,99,2691.18,4406.08,0.00
2024-12-08 14:55:42,187,3935,88,99,2693.20,4406.35,0.00
2024-12-08 14:55:42,188,3934,88,100,2673.10,4406.50,0.00
2024-12-08 14:55:42,188,3935,88,100,2735.23,4407.00,0.00
2024-12-08 14:55:42,189,3935,89,100,2720.76,4407.01,0.00
2024-12-08 14:55:42,188,3935,89,99,2728.71,4407.06,0.00
2024-12-08 14:55:42,189,3934,89,100,2696.97,4407.47,0.00
2024-12-08 14:55:42,188,3934,88,100,2709.51,4407.51,0.00
2024-12-08 14:55:42,188,3935,88,100,2735.20,4408.00,0.00
2024-12-08 14:55:42,189,3935,89,100,2720.73,4408.01,0.00
2024-12-08 14:55:42,190,3934,89,101,2706.41,4408.02,0.00
2024-12-08 14:55:42,189,3934,88,101,2738.26,4408.07,0.00
2024-12-08 14:55:42,190,3933,88,102,2693.10,4408.49,0.00
2024-12-08 14:55:42,190,3934,88,102,2728.51,4409.00,0.00
2024-12-08 14:55:42,191,3934,88,103,2714.23,4409.01,0.00
2024-12-08 14:55:42,192,3933,88,104,2698.28,4409.06,0.00
2024-12-08 14:55:42,191,3933,88,103,2710.35,4409.08,0.00
2024-12-08 14:55:42,192,3932,88,104,2685.31,4409.34,0.00
2024-12-08 14:55:42,193,3931,89,104,2678.13,4409.52,0.00
2024-12-08 14:55:42,194,3930,89,105,2658.45,4409.89,0.00
2024-12-08 14:55:42,194,3931,89,105,2714.92,4410.00,0.00
2024-12-08 14:55:42,195,3931,89,106,2700.99,4410.01,0.00
2024-12-08 14:55:42,194,3931,89,105,2711.55,4410.08,0.00
2024-12-08 14:55:42,193,3931,89,104,2725.37,4410.08,0.00
2024-12-08 14:55:42,194,3930,90,104,2694.69,4410.47,0.00
2024-12-08 14:55:42,193,3930,89,104,2708.54,4410.49,0.00
2024-12-08 14:55:42,194,3929,90,104,2693.24,4410.53,0.00
2024-12-08 14:55:42,194,3930,90,104,2795.67,4411.00,0.00
2024-12-08 14:55:42,195,3930,90,105,2781.33,4411.01,0.00
2024-12-08 14:55:42,196,3929,90,106,2766.70,4411.03,0.00
2024-12-08 14:55:42,197,3928,91,106,2730.80,4411.61,0.00
2024-12-08 14:55:42,198,3927,91,107,2720.63,4411.65,0.00
2024-12-08 14:55:42,199,3926,92,107,2713.18,4411.66,0.00
2024-12-08 14:55:42,199,3927,92,107,2771.53,4412.00,0.00
2024-12-08 14:55:42,200,3927,93,107,2757.68,4412.01,0.00
2024-12-08 14:55:42,201,3926,93,108,2743.31,4412.03,0.00
2024-12-08 14:55:42,202,3925,93,109,2742.19,4412.04,0.00
2024-12-08 14:55:42,201,3925,92,109,2733.92,4412.60,0.00
2024-12-08 14:55:42,202,3924,93,109,2715.23,4412.73,0.00
2024-12-08 14:55:42,202,3925,93,109,2817.25,4413.00,0.00
2024-12-08 14:55:42,203,3925,93,110,2803.37,4413.01,0.00
2024-12-08 14:55:42,202,3925,93,109,2809.22,4413.08,0.00
2024-12-08 14:55:42,203,3924,93,110,2795.16,4413.10,0.00
2024-12-08 14:55:42,204,3923,94,110,2773.84,4413.46,0.00
2024-12-08 14:55:42,205,3922,95,110,2757.83,4413.62,0.00
2024-12-08 14:55:42,206,3921,95,111,2744.14,4413.79,0.00
2024-12-08 14:55:42,207,3920,95,112,2726.98,4413.96,0.00
2024-12-08 14:55:42,207,3921,95,112,2803.86,4414.00,0.00
2024-12-08 14:55:42,208,3921,95,113,2790.38,4414.01,0.00
2024-12-08 14:55:42,209,3920,96,113,2750.68,4414.52,0.00
2024-12-08 14:55:42,210,3919,97,113,2738.96,4414.69,0.00
2024-12-08 14:55:42,211,3918,98,113,2721.47,4414.81,0.00
2024-12-08 14:55:43,211,3919,98,113,2832.73,4415.00,0.00
2024-12-08 14:55:43,212,3919,99,113,2819.37,4415.01,0.00
2024-12-08 14:55:43,211,3919,99,112,2830.04,4415.05,0.00
2024-12-08 14:55:43,210,3919,98,112,2799.62,4415.94,0.00
2024-12-08 14:55:43,210,3920,98,112,2881.05,4416.00,0.00
2024-12-08 14:55:43,211,3920,99,112,2867.39,4416.01,0.00
2024-12-08 14:55:43,211,3921,99,112,2832.79,4417.00,0.00
2024-12-08 14:55:43,212,3921,100,112,2819.43,4417.01,0.00
2024-12-08 14:55:43,211,3921,100,111,2827.18,4417.05,0.00
2024-12-08 14:55:43,210,3921,100,110,2838.77,4417.09,0.00
2024-12-08 14:55:43,209,3921,100,109,2852.14,4417.09,0.00
2024-12-08 14:55:43,208,3921,99,109,2837.74,4417.73,0.00
2024-12-08 14:55:43,208,3922,99,109,2838.83,4418.00,0.00
2024-12-08 14:55:43,209,3922,100,109,2825.24,4418.01,0.00
2024-12-08 14:55:43,210,3921,101,109,2790.10,4418.41,0.00
2024-12-08 14:55:43,211,3920,101,110,2795.32,4418.46,0.00
2024-12-08 14:55:43,211,3921,101,110,2807.55,4419.00,0.00
2024-12-08 14:55:43,212,3921,102,110,2794.31,4419.01,0.00
2024-12-08 14:55:43,213,3920,103,110,2755.70,4419.50,0.00
2024-12-08 14:55:43,213,3921,103,110,2798.68,4420.00,0.00
2024-12-08 14:55:43,214,3921,104,110,2785.60,4420.01,0.00
2024-12-08 14:55:43,213,3921,103,110,2796.40,4420.06,0.00
2024-12-08 14:55:43,212,3921,102,110,2803.77,4420.09,0.00
2024-12-08 14:55:43,213,3920,102,111,2780.31,4420.33,0.00
2024-12-08 14:55:43,213,3921,102,111,2789.93,4421.00,0.00
2024-12-08 14:55:43,214,3921,103,111,2776.90,4421.01,0.00
2024-12-08 14:55:43,215,3920,104,111,2762.16,4421.06,0.00
2024-12-08 14:55:43,214,3920,104,110,2780.65,4421.06,0.00
2024-12-08 14:55:43,215,3919,105,110,2767.72,4421.07,0.00
2024-12-08 14:55:43,214,3919,104,110,2787.70,4421.09,0.00
2024-12-08 14:55:43,214,3920,104,110,2781.24,4422.00,0.00
2024-12-08 14:55:43,215,3920,105,110,2768.31,4422.01,0.00
2024-12-08 14:55:43,216,3919,106,110,2732.56,4422.44,0.00
2024-12-08 14:55:43,216,3920,106,110,2774.63,4423.00,0.00
2024-12-08 14:55:43,217,3920,106,111,2761.84,4423.00,0.00
2024-12-08 14:55:43,218,3919,107,111,2721.05,4423.56,0.00
2024-12-08 14:55:43,217,3919,106,111,2733.11,4423.76,0.00
2024-12-08 14:55:43,217,3920,106,111,2760.72,4424.00,0.00
2024-12-08 14:55:43,218,3920,107,111,2748.06,4424.00,0.00
2024-12-08 14:55:43,217,3920,107,110,2752.22,4424.10,0.00
2024-12-08 14:55:43,218,3919,108,110,2733.94,4424.24,0.00
2024-12-08 14:55:43,219,3918,108,111,2732.02,4424.36,0.00
2024-12-08 14:55:43,219,3919,108,111,2743.41,4425.00,0.00
2024-12-08 14:55:43,220,3919,109,111,2730.94,4425.00,0.00
2024-12-08 14:55:43,221,3918,109,112,2704.66,4425.24,0.00
2024-12-08 14:55:43,221,3919,109,112,2727.08,4426.00,0.00
2024-12-08 14:55:43,222,3919,110,112,2714.79,4426.00,0.00
2024-12-08 14:55:43,221,3919,110,111,2722.10,4426.05,0.00
2024-12-08 14:55:43,222,3918,110,112,2675.00,4426.85,0.00
2024-12-08 14:55:43,222,3919,110,112,2703.04,4427.00,0.00
2024-12-08 14:55:43,223,3919,111,112,2690.92,4427.00,0.00
2024-12-08 14:55:43,222,3919,111,111,2694.72,4427.10,0.00
2024-12-08 14:55:43,223,3918,111,112,2673.37,4427.32,0.00
2024-12-08 14:55:43,222,3918,110,112,2688.65,4427.38,0.00
2024-12-08 14:55:43,223,3917,110,113,2654.51,4427.90,0.00
2024-12-08 14:55:43,223,3918,110,113,2690.13,4428.00,0.00
2024-12-08 14:55:43,224,3918,110,114,2678.12,4428.00,0.00
2024-12-08 14:55:43,223,3918,110,113,2681.84,4428.10,0.00
2024-12-08 14:55:43,224,3917,111,113,2665.35,4428.21,0.00
2024-12-08 14:55:43,225,3916,111,114,2657.20,4428.50,0.00
2024-12-08 14:55:43,226,3915,111,115,2642.98,4428.63,0.00
2024-12-08 14:55:43,226,3916,111,115,2689.42,4429.00,0.00
2024-12-08 14:55:43,227,3916,111,116,2677.57,4429.00,0.00
2024-12-08 14:55:43,228,3915,111,117,2634.86,4429.63,0.00
2024-12-08 14:55:43,228,3916,111,117,2697.85,4430.00,0.00
2024-12-08 14:55:43,229,3916,111,118,2686.07,4430.00,0.00
2024-12-08 14:55:43,230,3915,111,119,2662.32,4430.20,0.00
2024-12-08 14:55:43,230,3916,111,119,2674.42,4431.00,0.00
2024-12-08 14:55:43,231,3916,112,119,2662.84,4431.00,0.00
2024-12-08 14:55:43,230,3916,112,118,2670.40,4431.05,0.00
2024-12-08 14:55:43,229,3916,112,117,2679.57,4431.10,0.00
2024-12-08 14:55:43,228,3916,111,117,2691.12,4431.10,0.00
2024-12-08 14:55:43,227,3916,110,117,2700.83,4431.15,0.00
2024-12-08 14:55:43,228,3915,111,117,2680.72,4431.35,0.00
2024-12-08 14:55:43,229,3914,112,117,2661.81,4431.61,0.00
2024-12-08 14:55:43,230,3913,112,118,2652.06,4431.73,0.00
2024-12-08 14:55:43,231,3912,113,118,2645.12,4431.90,0.00
2024-12-08 14:55:43,230,3912,112,118,2659.40,4431.90,0.00
2024-12-08 14:55:43,230,3913,112,118,2693.78,4432.00,0.00
2024-12-08 14:55:43,231,3913,112,119,2682.12,4432.00,0.00
2024-12-08 14:55:43,232,3912,113,119,2664.47,4432.06,0.00
2024-12-08 14:55:43,231,3912,112,119,2683.89,4432.10,0.00
2024-12-08 14:55:43,231,3913,112,119,2738.48,4433.00,0.00
2024-12-08 14:55:43,232,3913,113,119,2726.67,4433.00,0.00
2024-12-08 14:55:43,233,3912,114,119,2713.28,4433.05,0.00
2024-12-08 14:55:43,234,3911,115,119,2705.50,4433.10,0.00
2024-12-08 14:55:43,233,3911,115,118,2730.81,4433.11,0.00
2024-12-08 14:55:43,234,3910,116,118,2718.58,4433.13,0.00
2024-12-08 14:55:44,235,3909,116,119,2699.42,4433.44,0.00
2024-12-08 14:55:44,236,3908,116,120,2693.68,4433.55,0.00
2024-12-08 14:55:44,236,3909,116,120,2715.75,4434.00,0.00
2024-12-08 14:55:44,237,3909,117,120,2704.30,4434.00,0.00
2024-12-08 14:55:44,238,3908,118,120,2692.57,4434.02,0.00
2024-12-08 14:55:44,237,3908,118,119,2700.60,4434.10,0.00
2024-12-08 14:55:44,238,3907,118,120,2668.26,4434.59,0.00
2024-12-08 14:55:44,238,3908,118,120,2762.24,4435.00,0.00
2024-12-08 14:55:44,239,3908,119,120,2750.69,4435.00,0.00
2024-12-08 14:55:44,238,3908,119,119,2756.68,4435.05,0.00
2024-12-08 14:55:44,237,3908,118,119,2767.09,4435.08,0.00
2024-12-08 14:55:44,238,3907,118,120,2754.72,4435.10,0.00
2024-12-08 14:55:44,239,3906,119,120,2750.00,4435.37,0.00
2024-12-08 14:55:44,240,3905,119,121,2726.39,4435.74,0.00
2024-12-08 14:55:44,240,3906,119,121,2767.27,4436.00,0.00
2024-12-08 14:55:44,241,3906,120,121,2755.79,4436.00,0.00
2024-12-08 14:55:44,242,3905,121,121,2744.40,4436.01,0.00
2024-12-08 14:55:44,243,3904,121,122,2699.90,4436.70,0.00
2024-12-08 14:55:44,244,3903,122,122,2688.01,4436.82,0.00
2024-12-08 14:55:44,244,3904,122,122,2755.62,4437.00,0.00
2024-12-08 14:55:44,245,3904,122,123,2744.38,4437.00,0.00
2024-12-08 14:55:44,246,3903,122,124,2713.37,4437.38,0.00
2024-12-08 14:55:44,246,3904,122,124,2758.91,4438.00,0.00
2024-12-08 14:55:44,247,3904,122,125,2747.74,4438.00,0.00
2024-12-08 14:55:44,246,3904,122,124,2754.25,4438.06,0.00
2024-12-08 14:55:44,245,3904,121,124,2764.95,4438.07,0.00
2024-12-08 14:55:44,244,3904,121,123,2775.02,4438.09,0.00
2024-12-08 14:55:44,243,3904,120,123,2786.26,4438.09,0.00
2024-12-08 14:55:44,244,3903,120,124,2771.23,4438.18,0.00
2024-12-08 14:55:44,244,3904,120,124,2780.15,4439.00,0.00
2024-12-08 14:55:44,245,3904,121,124,2768.80,4439.00,0.00
2024-12-08 14:55:44,244,3904,121,123,2772.55,4439.09,0.00
2024-12-08 14:55:44,244,3905,121,123,2767.43,4440.00,0.00
2024-12-08 14:55:44,245,3905,122,123,2756.14,4440.00,0.00
2024-12-08 14:55:44,244,3905,122,122,2759.84,4440.09,0.00
2024-12-08 14:55:44,243,3905,122,121,2771.01,4440.09,0.00
2024-12-08 14:55:44,242,3905,121,121,2769.75,4440.38,0.00
2024-12-08 14:55:44,243,3904,121,122,2746.82,4440.65,0.00
2024-12-08 14:55:44,244,3903,122,122,2738.52,4440.71,0.00
2024-12-08 14:55:44,245,3902,122,123,2727.77,4440.81,0.00
2024-12-08 14:55:44,246,3901,122,124,2733.06,4440.83,0.00
2024-12-08 14:55:44,246,3902,122,124,2743.50,4441.00,0.00
2024-12-08 14:55:44,247,3902,122,125,2732.39,4441.00,0.00
2024-12-08 14:55:44,248,3901,123,125,2711.23,4441.16,0.00
2024-12-08 14:55:44,249,3900,124,125,2713.40,4441.24,0.00
2024-12-08 14:55:44,250,3899,124,126,2698.70,4441.66,0.00
2024-12-08 14:55:44,250,3900,124,126,2773.23,4442.00,0.00
2024-12-08 14:55:44,251,3900,125,126,2762.18,4442.00,0.00
2024-12-08 14:55:44,252,3899,126,126,2749.14,4442.06,0.00
2024-12-08 14:55:44,253,3898,126,127,2716.66,4442.68,0.00
2024-12-08 14:55:44,254,3897,127,127,2693.21,4442.93,0.00
2024-12-08 14:55:44,254,3898,127,127,2761.13,4443.00,0.00
2024-12-08 14:55:44,255,3898,128,127,2750.31,4443.00,0.00
2024-12-08 14:55:44,256,3897,129,127,2704.38,4443.73,0.00
2024-12-08 14:55:44,256,3898,129,127,2770.25,4444.00,0.00
2024-12-08 14:55:44,257,3898,130,127,2759.47,4444.00,0.00
2024-12-08 14:55:44,258,3897,131,127,2748.10,4444.03,0.00
2024-12-08 14:55:44,257,3897,131,126,2757.27,4444.10,0.00
2024-12-08 14:55:44,256,3897,131,125,2767.87,4444.10,0.00
2024-12-08 14:55:44,257,3896,131,126,2741.01,4444.48,0.00
2024-12-08 14:55:44,258,3895,131,127,2719.92,4444.78,0.00
2024-12-08 14:55:44,258,3896,131,127,2745.68,4445.00,0.00
2024-12-08 14:55:44,259,3896,132,127,2735.08,4445.00,0.00
2024-12-08 14:55:44,260,3895,132,128,2718.27,4445.08,0.00
2024-12-08 14:55:44,261,3894,133,128,2691.77,4445.61,0.00
2024-12-08 14:55:44,261,3895,133,128,2744.97,4446.00,0.00
2024-12-08 14:55:44,262,3895,133,129,2734.50,4446.00,0.00
2024-12-08 14:55:44,261,3895,132,129,2743.63,4446.03,0.00
2024-12-08 14:55:44,260,3895,132,128,2747.38,4446.10,0.00
2024-12-08 14:55:44,260,3896,132,128,2753.07,4447.00,0.00
2024-12-08 14:55:44,261,3896,133,128,2742.52,4447.00,0.00
2024-12-08 14:55:44,260,3896,133,127,2748.48,4447.05,0.00
2024-12-08 14:55:44,259,3896,132,127,2758.75,4447.05,0.00
2024-12-08 14:55:44,258,3896,131,127,2766.88,4447.10,0.00
2024-12-08 14:55:44,257,3896,130,127,2777.47,4447.11,0.00
2024-12-08 14:55:44,256,3896,129,127,2779.40,4447.31,0.00
2024-12-08 14:55:44,255,3896,128,127,2754.39,4447.97,0.00
2024-12-08 14:55:44,255,3897,128,127,2770.63,4448.00,0.00
2024-12-08 14:55:44,256,3897,128,128,2759.81,4448.00,0.00
2024-12-08 14:55:44,255,3897,128,127,2767.52,4448.05,0.00
2024-12-08 14:55:44,256,3896,128,128,2755.68,4448.08,0.00
2024-12-08 14:55:44,255,3896,128,127,2779.59,4448.11,0.00
2024-12-08 14:55:44,256,3895,129,127,2765.11,4448.20,0.00
2024-12-08 14:55:44,257,3894,129,128,2739.19,4448.64,0.00
2024-12-08 14:55:44,256,3894,128,128,2743.32,4448.84,0.00
2024-12-08 14:55:44,256,3895,128,128,2753.54,4449.00,0.00
2024-12-08 14:55:45,257,3895,128,129,2742.82,4449.00,0.00
2024-12-08 14:55:45,256,3895,127,129,2751.84,4449.04,0.00
2024-12-08 14:55:45,255,3895,127,128,2761.76,4449.05,0.00
2024-12-08 14:55:45,256,3894,128,128,2749.26,4449.09,0.00
2024-12-08 14:55:45,255,3894,127,128,2763.89,4449.10,0.00
2024-12-08 14:55:45,254,3894,126,128,2770.24,4449.16,0.00
2024-12-08 14:55:45,255,3893,127,128,2755.75,4449.25,0.00
2024-12-08 14:55:45,256,3892,128,128,2726.60,4449.87,0.00
2024-12-08 14:55:45,256,3893,128,128,2792.59,4450.00,0.00
2024-12-08 14:55:45,257,3893,128,129,2781.72,4450.00,0.00
2024-12-08 14:55:45,256,3893,127,129,2786.88,4450.05,0.00
2024-12-08 14:55:45,255,3893,126,129,2794.18,4450.12,0.00
2024-12-08 14:55:45,255,3894,126,129,2825.29,4451.00,0.00
2024-12-08 14:55:45,256,3894,127,129,2814.25,4451.00,0.00
2024-12-08 14:55:45,255,3894,126,129,2817.32,4451.10,0.00
2024-12-08 14:55:45,256,3893,126,130,2798.91,4451.28,0.00
2024-12-08 14:55:45,257,3892,126,131,2764.56,4451.92,0.00
2024-12-08 14:55:45,257,3893,126,131,2783.37,4452.00,0.00
2024-12-08 14:55:45,258,3893,127,131,2772.59,4452.00,0.00
2024-12-08 14:55:45,257,3893,127,130,2775.47,4452.10,0.00
2024-12-08 14:55:45,258,3892,128,130,2739.63,4452.68,0.00
2024-12-08 14:55:45,259,3891,129,130,2733.37,4452.70,0.00
2024-12-08 14:55:45,260,3890,130,130,2718.07,4452.92,0.00
2024-12-08 14:55:45,260,3891,130,130,2762.81,4453.00,0.00
2024-12-08 14:55:45,261,3891,130,131,2752.22,4453.00,0.00
2024-12-08 14:55:45,262,3890,130,132,2740.54,4453.04,0.00
2024-12-08 14:55:45,261,3890,129,132,2751.77,4453.11,0.00
2024-12-08 14:55:45,262,3889,130,132,2727.07,4453.28,0.00
2024-12-08 14:55:45,263,3888,131,132,2722.69,4453.43,0.00
2024-12-08 14:55:45,263,3889,131,132,2774.58,4454.00,0.00
2024-12-08 14:55:45,264,3889,132,132,2764.07,4454.00,0.00
2024-12-08 14:55:45,263,3889,132,131,2770.71,4454.05,0.00
2024-12-08 14:55:45,262,3889,132,130,2778.77,4454.10,0.00
2024-12-08 14:55:45,261,3889,131,130,2781.60,4454.18,0.00
2024-12-08 14:55:45,261,3890,131,130,2813.88,4455.00,0.00
2024-12-08 14:55:45,262,3890,132,130,2803.14,4455.00,0.00
2024-12-08 14:55:45,261,3890,132,129,2805.58,4455.11,0.00
2024-12-08 14:55:45,262,3889,132,130,2770.90,4455.62,0.00
2024-12-08 14:55:45,262,3890,132,130,2777.16,4456.00,0.00
2024-12-08 14:55:45,263,3890,133,130,2766.60,4456.00,0.00
2024-12-08 14:55:45,264,3889,133,131,2750.25,4456.07,0.00
2024-12-08 14:55:45,263,3889,132,131,2755.43,4456.38,0.00
2024-12-08 14:55:45,264,3888,132,132,2740.98,4456.48,0.00
2024-12-08 14:55:45,265,3887,132,133,2723.98,4456.82,0.00
2024-12-08 14:55:45,265,3888,132,133,2748.68,4457.00,0.00
2024-12-08 14:55:45,266,3888,133,133,2738.35,4457.00,0.00
2024-12-08 14:55:45,265,3888,133,132,2740.51,4457.11,0.00
2024-12-08 14:55:45,266,3887,133,133,2718.75,4457.38,0.00
2024-12-08 14:55:45,267,3886,133,134,2710.10,4457.44,0.00
2024-12-08 14:55:45,268,3885,134,134,2696.02,4457.74,0.00
2024-12-08 14:55:45,267,3885,133,134,2708.00,4457.78,0.00
2024-12-08 14:55:45,267,3886,133,134,2758.93,4458.00,0.00
2024-12-08 14:55:45,268,3886,133,135,2748.64,4458.00,0.00
2024-12-08 14:55:45,267,3886,133,134,2754.29,4458.05,0.00
2024-12-08 14:55:45,266,3886,132,134,2761.50,4458.12,0.00
2024-12-08 14:55:45,267,3885,132,135,2742.22,4458.33,0.00
2024-12-08 14:55:45,268,3884,133,135,2714.24,4458.90,0.00
2024-12-08 14:55:45,268,3885,133,135,2771.22,4459.00,0.00
2024-12-08 14:55:45,269,3885,134,135,2760.92,4459.00,0.00
2024-12-08 14:55:45,268,3885,134,134,2766.42,4459.05,0.00
2024-12-08 14:55:45,267,3885,134,133,2773.32,4459.12,0.00
2024-12-08 14:55:45,268,3884,135,133,2737.39,4459.56,0.00
2024-12-08 14:55:45,268,3885,135,133,2781.72,4460.00,0.00
2024-12-08 14:55:45,269,3885,135,134,2771.38,4460.00,0.00
2024-12-08 14:55:45,270,3884,135,135,2751.78,4460.15,0.00
2024-12-08 14:55:45,270,3885,135,135,2745.38,4461.00,0.00
2024-12-08 14:55:45,271,3885,136,135,2735.25,4461.00,0.00
2024-12-08 14:55:45,270,3885,136,134,2742.94,4461.06,0.00
2024-12-08 14:55:45,271,3884,137,134,2729.07,4461.15,0.00
2024-12-08 14:55:45,270,3884,136,134,2727.94,4461.50,0.00
2024-12-08 14:55:45,271,3883,137,134,2712.84,4461.62,0.00
2024-12-08 14:55:45,271,3884,137,134,2730.43,4462.00,0.00
2024-12-08 14:55:45,272,3884,138,134,2720.39,4462.00,0.00
2024-12-08 14:55:45,272,3885,138,134,2719.53,4463.00,0.00
2024-12-08 14:55:45,273,3885,138,135,2709.57,4463.00,0.00
2024-12-08 14:55:45,272,3885,137,135,2710.57,4463.13,0.00
2024-12-08 14:55:45,271,3885,137,134,2720.41,4463.13,0.00
2024-12-08 14:55:45,272,3884,137,135,2708.95,4463.17,0.00
2024-12-08 14:55:45,273,3883,137,136,2677.76,4463.58,0.00
2024-12-08 14:55:45,274,3882,137,137,2672.72,4463.60,0.00
2024-12-08 14:55:46,274,3883,137,137,2677.61,4464.00,0.00
2024-12-08 14:55:46,275,3883,138,137,2667.87,4464.00,0.00
2024-12-08 14:55:46,276,3882,139,137,2638.79,4464.38,0.00
2024-12-08 14:55:46,277,3881,140,137,2635.25,4464.43,0.00
2024-12-08 14:55:46,276,3881,139,137,2640.53,4464.54,0.00
2024-12-08 14:55:46,276,3882,139,137,2685.03,4465.00,0.00
2024-12-08 14:55:46,277,3882,140,137,2675.34,4465.00,0.00
2024-12-08 14:55:46,276,3882,140,136,2682.16,4465.07,0.00
2024-12-08 14:55:46,277,3881,141,136,2671.36,4465.10,0.00
2024-12-08 14:55:46,278,3880,142,136,2658.50,4465.39,0.00
2024-12-08 14:55:46,279,3879,142,137,2658.10,4465.42,0.00
2024-12-08 14:55:46,280,3878,142,138,2646.06,4465.69,0.00
2024-12-08 14:55:46,280,3879,142,138,2678.85,4466.00,0.00
2024-12-08 14:55:46,281,3879,142,139,2669.32,4466.00,0.00
2024-12-08 14:55:46,282,3878,142,140,2648.53,4466.20,0.00
2024-12-08 14:55:46,283,3877,143,140,2641.72,4466.24,0.00
2024-12-08 14:55:46,283,3878,143,140,2691.97,4467.00,0.00
2024-12-08 14:55:46,284,3878,144,140,2682.49,4467.00,0.00
2024-12-08 14:55:46,285,3877,145,140,2665.61,4467.11,0.00
2024-12-08 14:55:46,284,3877,145,139,2676.75,4467.13,0.00
2024-12-08 14:55:46,285,3876,145,140,2659.42,4467.32,0.00
2024-12-08 14:55:46,286,3875,145,141,2646.92,4467.47,0.00
2024-12-08 14:55:46,287,3874,146,141,2636.71,4467.64,0.00
2024-12-08 14:55:46,288,3873,146,142,2615.16,4467.97,0.00
2024-12-08 14:55:46,288,3874,146,142,2660.63,4468.00,0.00
2024-12-08 14:55:46,289,3874,147,142,2651.43,4468.00,0.00
2024-12-08 14:55:46,288,3874,146,142,2652.01,4468.13,0.00
2024-12-08 14:55:46,289,3873,147,142,2640.07,4468.19,0.00
2024-12-08 14:55:46,290,3872,148,142,2615.65,4468.67,0.00
2024-12-08 14:55:46,291,3871,148,143,2607.95,4468.75,0.00
2024-12-08 14:55:46,292,3870,149,143,2596.21,4468.87,0.00
2024-12-08 14:55:46,292,3871,149,143,2678.44,4469.00,0.00
2024-12-08 14:55:46,293,3871,150,143,2669.30,4469.00,0.00
2024-12-08 14:55:46,292,3871,150,142,2673.73,4469.07,0.00
2024-12-08 14:55:46,291,3871,149,142,2680.18,4469.12,0.00
2024-12-08 14:55:46,292,3870,149,143,2667.82,4469.20,0.00
2024-12-08 14:55:46,293,3869,149,144,2663.07,4469.41,0.00
2024-12-08 14:55:46,294,3868,150,144,2654.96,4469.49,0.00
2024-12-08 14:55:46,295,3867,150,145,2643.07,4469.70,0.00
2024-12-08 14:55:46,296,3866,150,146,2632.88,4469.83,0.00
2024-12-08 14:55:46,296,3867,150,146,2697.20,4470.00,0.00
2024-12-08 14:55:46,297,3867,150,147,2688.12,4470.00,0.00
2024-12-08 14:55:46,298,3866,150,148,2671.06,4470.12,0.00
2024-12-08 14:55:46,297,3866,150,147,2688.79,4470.13,0.00
2024-12-08 14:55:46,298,3865,151,147,2677.09,4470.19,0.00
2024-12-08 14:55:46,298,3866,151,147,2737.84,4471.00,0.00
2024-12-08 14:55:46,299,3866,151,148,2728.69,4471.00,0.00
2024-12-08 14:55:46,298,3866,151,147,2729.36,4471.12,0.00
2024-12-08 14:55:46,297,3866,150,147,2726.79,4471.33,0.00
2024-12-08 14:55:46,298,3865,150,148,2701.36,4471.71,0.00
2024-12-08 14:55:46,298,3866,150,148,2737.77,4472.00,0.00
2024-12-08 14:55:46,299,3866,151,148,2728.61,4472.00,0.00
2024-12-08 14:55:46,298,3866,150,148,2736.88,4472.02,0.00
2024-12-08 14:55:46,297,3866,150,147,2738.32,4472.13,0.00
2024-12-08 14:55:46,298,3865,150,148,2715.16,4472.45,0.00
2024-12-08 14:55:46,299,3864,151,148,2708.99,4472.58,0.00
2024-12-08 14:55:46,300,3863,152,148,2705.49,4472.59,0.00
2024-12-08 14:55:46,299,3863,151,148,2707.76,4472.68,0.00
2024-12-08 14:55:46,300,3862,152,148,2695.80,4472.75,0.00
2024-12-08 14:55:46,300,3863,152,148,2718.08,4473.00,0.00
2024-12-08 14:55:46,301,3863,152,149,2709.05,4473.00,0.00
2024-12-08 14:55:46,302,3862,153,149,2679.08,4473.34,0.00
2024-12-08 14:55:46,303,3861,153,150,2671.82,4473.54,0.00
2024-12-08 14:55:46,304,3860,153,151,2661.54,4473.72,0.00
2024-12-08 14:55:46,304,3861,153,151,2726.67,4474.00,0.00
2024-12-08 14:55:46,305,3861,153,152,2717.73,4474.00,0.00
2024-12-08 14:55:46,304,3861,152,152,2718.05,4474.13,0.00
2024-12-08 14:55:46,303,3861,151,152,2722.87,4474.21,0.00
2024-12-08 14:55:46,304,3860,152,152,2710.12,4474.30,0.00
2024-12-08 14:55:46,303,3860,151,152,2725.90,4474.44,0.00
2024-12-08 14:55:46,304,3859,152,152,2715.33,4474.48,0.00
2024-12-08 14:55:46,305,3858,153,152,2698.79,4474.69,0.00
2024-12-08 14:55:46,306,3857,153,153,2686.31,4474.87,0.00
2024-12-08 14:55:46,306,3858,153,153,2740.53,4475.00,0.00
2024-12-08 14:55:46,307,3858,154,153,2731.61,4475.00,0.00
2024-12-08 14:55:46,306,3858,153,153,2738.07,4475.06,0.00
2024-12-08 14:55:46,305,3858,153,152,2746.46,4475.06,0.00
2024-12-08 14:55:46,304,3858,153,151,2752.30,4475.13,0.00
2024-12-08 14:55:46,303,3858,153,150,2761.23,4475.13,0.00
2024-12-08 14:55:46,302,3858,152,150,2770.23,4475.13,0.00
2024-12-08 14:55:46,303,3857,152,151,2752.16,4475.33,0.00
2024-12-08 14:55:46,304,3856,152,152,2747.58,4475.46,0.00
2024-12-08 14:55:46,304,3857,152,152,2791.57,4476.00,0.00
2024-12-08 14:55:46,305,3857,153,152,2782.42,4476.00,0.00
2024-12-08 14:55:46,306,3856,154,152,2765.34,4476.12,0.00
2024-12-08 14:55:46,305,3856,154,151,2779.99,4476.13,0.00
2024-12-08 14:55:46,306,3855,155,151,2770.76,4476.14,0.00
2024-12-08 14:55:46,305,3855,154,151,2779.13,4476.19,0.00
2024-12-08 14:55:46,304,3855,153,151,2786.32,4476.24,0.00
2024-12-08 14:55:46,305,3854,153,152,2776.17,4476.27,0.00
2024-12-08 14:55:46,305,3855,153,152,2791.06,4477.00,0.00
2024-12-08 14:55:46,306,3855,154,152,2781.94,4477.00,0.00
2024-12-08 14:55:46,305,3855,154,151,2788.01,4477.07,0.00
2024-12-08 14:55:46,304,3855,154,150,2794.27,4477.13,0.00
2024-12-08 14:55:46,303,3855,153,150,2796.89,4477.28,0.00
2024-12-08 14:55:46,302,3855,152,150,2800.59,4477.40,0.00
2024-12-08 14:55:47,303,3854,152,151,2790.91,4477.42,0.00
2024-12-08 14:55:47,303,3855,152,151,2832.86,4478.00,0.00
2024-12-08 14:55:47,304,3855,152,152,2823.54,4478.00,0.00
2024-12-08 14:55:47,303,3855,151,152,2815.68,4478.25,0.00
2024-12-08 14:55:47,304,3854,152,152,2792.30,4478.58,0.00
2024-12-08 14:55:47,305,3853,153,152,2788.74,4478.59,0.00
2024-12-08 14:55:47,306,3852,153,153,2782.45,4478.66,0.00
2024-12-08 14:55:47,306,3853,153,153,2801.47,4479.00,0.00
2024-12-08 14:55:47,307,3853,153,154,2792.34,4479.00,0.00
2024-12-08 14:55:47,306,3853,153,153,2792.75,4479.13,0.00
2024-12-08 14:55:47,307,3852,153,154,2767.27,4479.38,0.00
2024-12-08 14:55:47,308,3851,153,155,2762.43,4479.50,0.00
2024-12-08 14:55:47,309,3850,154,155,2743.62,4479.88,0.00
2024-12-08 14:55:47,309,3851,154,155,2797.80,4480.00,0.00
2024-12-08 14:55:47,310,3851,154,156,2788.77,4480.00,0.00
2024-12-08 14:55:47,309,3851,154,155,2793.77,4480.07,0.00
2024-12-08 14:55:47,310,3850,155,155,2778.74,4480.21,0.00
2024-12-08 14:55:47,311,3849,155,156,2778.50,4480.30,0.00
2024-12-08 14:55:47,310,3849,154,156,2789.50,4480.33,0.00
2024-12-08 14:55:47,311,3848,155,156,2776.54,4480.42,0.00
2024-12-08 14:55:47,312,3847,155,157,2771.52,4480.43,0.00
2024-12-08 14:55:47,312,3848,155,157,2806.13,4481.00,0.00
2024-12-08 14:55:47,313,3848,156,157,2797.16,4481.00,0.00
2024-12-08 14:55:47,312,3848,155,157,2800.69,4481.06,0.00
2024-12-08 14:55:47,313,3847,155,158,2787.18,4481.10,0.00
2024-12-08 14:55:47,312,3847,154,158,2799.67,4481.21,0.00
2024-12-08 14:55:47,313,3846,154,159,2785.77,4481.33,0.00
2024-12-08 14:55:47,312,3846,153,159,2797.33,4481.39,0.00
2024-12-08 14:55:47,313,3845,153,160,2778.65,4481.62,0.00
2024-12-08 14:55:47,314,3844,154,160,2772.41,4481.68,0.00
2024-12-08 14:55:47,315,3843,155,160,2763.25,4481.78,0.00
2024-12-08 14:55:47,315,3844,155,160,2827.18,4482.00,0.00
2024-12-08 14:55:47,316,3844,155,161,2818.24,4482.00,0.00
2024-12-08 14:55:47,317,3843,156,161,2806.55,4482.07,0.00
2024-12-08 14:55:47,316,3843,155,161,2822.40,4482.10,0.00
2024-12-08 14:55:47,315,3843,155,160,2829.82,4482.14,0.00
2024-12-08 14:55:47,314,3843,155,159,2838.69,4482.14,0.00
2024-12-08 14:55:47,313,3843,155,158,2847.61,4482.14,0.00
2024-12-08 14:55:47,313,3844,155,158,2890.36,4483.00,0.00
2024-12-08 14:55:47,314,3844,155,159,2881.16,4483.00,0.00
2024-12-08 14:55:47,315,3843,155,160,2871.73,4483.02,0.00
2024-12-08 14:55:47,314,3843,155,159,2885.18,4483.05,0.00
2024-12-08 14:55:47,313,3843,155,158,2890.30,4483.14,0.00
2024-12-08 14:55:47,314,3842,156,158,2876.42,4483.25,0.00
2024-12-08 14:55:47,314,3843,156,158,2877.23,4484.00,0.00
2024-12-08 14:55:47,315,3843,156,159,2868.10,4484.00,0.00
2024-12-08 14:55:47,314,3843,156,158,2868.45,4484.13,0.00
2024-12-08 14:55:47,313,3843,155,158,2877.47,4484.13,0.00
2024-12-08 14:55:47,313,3844,155,158,2880.92,4485.00,0.00
2024-12-08 14:55:47,314,3844,156,158,2871.74,4485.00,0.00
2024-12-08 14:55:47,313,3844,156,157,2872.11,4485.13,0.00
2024-12-08 14:55:47,314,3843,157,157,2862.39,4485.15,0.00
2024-12-08 14:55:47,314,3844,157,157,2850.92,4486.00,0.00
2024-12-08 14:55:47,315,3844,158,157,2841.87,4486.00,0.00
2024-12-08 14:55:47,316,3843,158,158,2830.62,4486.06,0.00
2024-12-08 14:55:47,317,3842,159,158,2824.85,4486.14,0.00
2024-12-08 14:55:47,316,3842,159,157,2836.35,4486.14,0.00
2024-12-08 14:55:47,315,3842,158,157,2836.30,4486.34,0.00
2024-12-08 14:55:47,315,3843,158,157,2832.26,4487.00,0.00
2024-12-08 14:55:47,316,3843,159,157,2823.30,4487.00,0.00
2024-12-08 14:55:47,317,3842,160,157,2798.25,4487.31,0.00
2024-12-08 14:55:47,318,3841,161,157,2794.13,4487.35,0.00
2024-12-08 14:55:47,317,3841,160,157,2803.60,4487.36,0.00
2024-12-08 14:55:47,318,3840,161,157,2793.95,4487.39,0.00
2024-12-08 14:55:47,318,3841,161,157,2810.09,4488.00,0.00
2024-12-08 14:55:47,319,3841,161,158,2801.29,4488.00,0.00
2024-12-08 14:55:47,320,3840,162,158,2792.39,4488.01,0.00
2024-12-08 14:55:47,321,3839,162,159,2796.70,4488.03,0.00
2024-12-08 14:55:47,320,3839,162,158,2806.45,4488.07,0.00
2024-12-08 14:55:47,319,3839,161,158,2812.19,4488.14,0.00
2024-12-08 14:55:47,320,3838,161,159,2797.43,4488.28,0.00
2024-12-08 14:55:47,321,3837,161,160,2771.93,4488.91,0.00
2024-12-08 14:55:47,321,3838,161,160,2819.41,4489.00,0.00
2024-12-08 14:55:47,322,3838,161,161,2810.66,4489.00,0.00
2024-12-08 14:55:47,321,3838,161,160,2805.36,4489.13,0.00
2024-12-08 14:55:47,320,3838,161,159,2813.98,4489.13,0.00
2024-12-08 14:55:47,321,3837,162,159,2802.72,4489.19,0.00
2024-12-08 14:55:47,322,3836,163,159,2803.38,4489.23,0.00
2024-12-08 14:55:47,322,3837,163,159,2850.61,4490.00,0.00
2024-12-08 14:55:47,323,3837,163,160,2841.78,4490.00,0.00
2024-12-08 14:55:47,322,3837,162,160,2849.09,4490.03,0.00
2024-12-08 14:55:47,321,3837,161,160,2857.68,4490.03,0.00
2024-12-08 14:55:47,320,3837,161,159,2864.95,4490.06,0.00
2024-12-08 14:55:47,319,3837,160,159,2871.15,4490.12,0.00
2024-12-08 14:55:47,318,3837,159,159,2879.76,4490.13,0.00
2024-12-08 14:55:47,319,3836,160,159,2863.49,4490.30,0.00
2024-12-08 14:55:48,320,3835,160,160,2843.63,4490.60,0.00
2024-12-08 14:55:48,321,3834,160,161,2836.92,4490.67,0.00
2024-12-08 14:55:48,320,3834,159,161,2847.14,4490.73,0.00
2024-12-08 14:55:48,320,3835,159,161,2877.39,4491.00,0.00
2024-12-08 14:55:48,321,3835,159,162,2868.43,4491.00,0.00
2024-12-08 14:55:48,322,3834,160,162,2853.15,4491.09,0.00
2024-12-08 14:55:48,323,3833,160,163,2804.37,4491.92,0.00
2024-12-08 14:55:48,323,3834,160,163,2857.56,4492.00,0.00
2024-12-08 14:55:48,324,3834,160,164,2848.74,4492.00,0.00
2024-12-08 14:55:48,325,3833,160,165,2838.75,4492.04,0.00
2024-12-08 14:55:48,326,3832,161,165,2835.42,4492.06,0.00
2024-12-08 14:55:48,325,3832,161,164,2843.88,4492.07,0.00
2024-12-08 14:55:48,326,3831,161,165,2833.80,4492.11,0.00
2024-12-08 14:55:48,325,3831,161,164,2846.41,4492.14,0.00
2024-12-08 14:55:48,324,3831,160,164,2844.46,4492.30,0.00
2024-12-08 14:55:48,325,3830,160,165,2826.42,4492.52,0.00
2024-12-08 14:55:48,326,3829,161,165,2802.74,4492.91,0.00
2024-12-08 14:55:48,326,3830,161,165,2841.54,4493.00,0.00
2024-12-08 14:55:48,327,3830,162,165,2832.85,4493.00,0.00
2024-12-08 14:55:48,326,3830,162,164,2833.07,4493.13,0.00
2024-12-08 14:55:48,325,3830,161,164,2835.20,4493.23,0.00
2024-12-08 14:55:48,326,3829,161,165,2817.37,4493.44,0.00
2024-12-08 14:55:48,327,3828,162,165,2810.60,4493.53,0.00
2024-12-08 14:55:48,328,3827,163,165,2806.70,4493.57,0.00
2024-12-08 14:55:48,329,3826,164,165,2793.76,4493.71,0.00
2024-12-08 14:55:48,330,3825,165,165,2784.55,4493.80,0.00
2024-12-08 14:55:48,330,3826,165,165,2860.02,4494.00,0.00
2024-12-08 14:55:48,331,3826,166,165,2851.38,4494.00,0.00
2024-12-08 14:55:48,332,3825,167,165,2840.11,4494.07,0.00
2024-12-08 14:55:48,333,3824,168,165,2838.34,4494.08,0.00
2024-12-08 14:55:48,334,3823,168,166,2827.37,4494.24,0.00
2024-12-08 14:55:48,334,3824,168,166,2877.68,4495.00,0.00
2024-12-08 14:55:48,335,3824,168,167,2869.09,4495.00,0.00
2024-12-08 14:55:48,334,3824,168,166,2869.28,4495.13,0.00
2024-12-08 14:55:48,333,3824,167,166,2866.14,4495.39,0.00
2024-12-08 14:55:48,333,3825,167,166,2892.15,4496.00,0.00
2024-12-08 14:55:48,334,3825,167,167,2883.49,4496.00,0.00
2024-12-08 14:55:48,335,3824,168,167,2866.76,4496.13,0.00
2024-12-08 14:55:48,336,3823,169,167,2859.07,4496.20,0.00
2024-12-08 14:55:48,337,3822,170,167,2840.06,4496.50,0.00
2024-12-08 14:55:48,337,3823,170,167,2832.72,4497.00,0.00
2024-12-08 14:55:48,338,3823,171,167,2824.34,4497.00,0.00
2024-12-08 14:55:48,339,3822,171,168,2808.25,4497.12,0.00
2024-12-08 14:55:48,340,3821,172,168,2787.85,4497.68,0.00
2024-12-08 14:55:48,341,3820,172,169,2782.60,4497.70,0.00
2024-12-08 14:55:48,341,3821,172,169,2821.28,4498.00,0.00
2024-12-08 14:55:48,342,3821,172,170,2813.03,4498.00,0.00
2024-12-08 14:55:48,341,3821,171,170,2820.50,4498.02,0.00
2024-12-08 14:55:48,340,3821,171,169,2820.79,4498.14,0.00
2024-12-08 14:55:48,341,3820,172,169,2797.64,4498.48,0.00
2024-12-08 14:55:48,342,3819,172,170,2788.72,4498.54,0.00
2024-12-08 14:55:48,343,3818,173,170,2781.57,4498.66,0.00
2024-12-08 14:55:48,343,3819,173,170,2817.84,4499.00,0.00
2024-12-08 14:55:48,344,3819,174,170,2809.65,4499.00,0.00
2024-12-08 14:55:48,343,3819,174,169,2813.28,4499.06,0.00
2024-12-08 14:55:48,342,3819,173,169,2818.00,4499.13,0.00
2024-12-08 14:55:48,341,3819,172,169,2816.25,4499.36,0.00
2024-12-08 14:55:48,341,3820,172,169,2835.30,4500.00,0.00
2024-12-08 14:55:48,342,3820,173,169,2827.01,4500.00,0.00
2024-12-08 14:55:48,343,3819,174,169,2811.22,4500.12,0.00
2024-12-08 14:55:48,342,3819,173,169,2820.77,4500.14,0.00
2024-12-08 14:55:48,343,3818,174,169,2806.84,4500.28,0.00
2024-12-08 14:55:48,344,3817,175,169,2777.94,4500.76,0.00
2024-12-08 14:55:48,344,3818,175,169,2783.38,4501.00,0.00
2024-12-08 14:55:48,345,3818,175,170,2775.31,4501.00,0.00
2024-12-08 14:55:48,346,3817,175,171,2766.14,4501.04,0.00
2024-12-08 14:55:48,345,3817,174,171,2779.51,4501.04,0.00
2024-12-08 14:55:48,344,3817,173,171,2780.32,4501.14,0.00
2024-12-08 14:55:48,343,3817,173,170,2788.29,4501.14,0.00
2024-12-08 14:55:48,343,3818,173,170,2798.14,4502.00,0.00
2024-12-08 14:55:48,344,3818,173,171,2790.00,4502.00,0.00
2024-12-08 14:55:48,343,3818,173,170,2793.18,4502.06,0.00
2024-12-08 14:55:48,344,3817,174,170,2749.82,4502.74,0.00
2024-12-08 14:55:48,344,3818,174,170,2767.71,4503.00,0.00
2024-12-08 14:55:48,345,3818,174,171,2759.69,4503.00,0.00
2024-12-08 14:55:48,346,3817,174,172,2740.63,4503.20,0.00
2024-12-08 14:55:48,347,3816,175,172,2737.21,4503.37,0.00
2024-12-08 14:55:48,348,3815,176,172,2736.35,4503.41,0.00
2024-12-08 14:55:48,349,3814,177,172,2726.58,4503.64,0.00
2024-12-08 14:55:48,350,3813,178,172,2723.29,4503.64,0.00
2024-12-08 14:55:48,350,3814,178,172,2736.33,4504.00,0.00
2024-12-08 14:55:48,351,3814,178,173,2728.54,4504.00,0.00
2024-12-08 14:55:48,352,3813,178,174,2714.81,4504.09,0.00
2024-12-08 14:55:48,353,3812,178,175,2709.20,4504.14,0.00
2024-12-08 14:55:48,354,3811,178,176,2694.04,4504.42,0.00
2024-12-08 14:55:49,355,3810,178,177,2675.12,4504.77,0.00
2024-12-08 14:55:49,355,3811,178,177,2742.20,4505.00,0.00
2024-12-08 14:55:49,356,3811,178,178,2734.50,4505.00,0.00
2024-12-08 14:55:49,355,3811,177,178,2733.40,4505.14,0.00
2024-12-08 14:55:49,354,3811,177,177,2740.99,4505.14,0.00
2024-12-08 14:55:49,354,3812,177,177,2762.68,4506.00,0.00
2024-12-08 14:55:49,355,3812,177,178,2754.90,4506.00,0.00
2024-12-08 14:55:49,356,3811,177,179,2741.62,4506.08,0.00
2024-12-08 14:55:49,357,3810,177,180,2736.23,4506.11,0.00
2024-12-08 14:55:49,356,3810,176,180,2707.56,4506.86,0.00
2024-12-08 14:55:49,356,3811,176,180,2713.89,4507.00,0.00
2024-12-08 14:55:49,357,3811,176,181,2706.29,4507.00,0.00
2024-12-08 14:55:49,356,3811,175,181,2706.95,4507.04,0.00
2024-12-08 14:55:49,355,3811,175,180,2713.19,4507.06,0.00
2024-12-08 14:55:49,356,3810,176,180,2689.78,4507.42,0.00
2024-12-08 14:55:49,357,3809,176,181,2689.08,4507.45,0.00
2024-12-08 14:55:49,358,3808,177,181,2682.63,4507.56,0.00
2024-12-08 14:55:49,357,3808,176,181,2685.21,4507.80,0.00
2024-12-08 14:55:49,357,3809,176,181,2714.05,4508.00,0.00
2024-12-08 14:55:49,358,3809,177,181,2706.47,4508.00,0.00
2024-12-08 14:55:49,359,3808,178,181,2697.31,4508.04,0.00
2024-12-08 14:55:49,358,3808,177,181,2709.89,4508.05,0.00
2024-12-08 14:55:49,357,3808,177,180,2710.22,4508.15,0.00
2024-12-08 14:55:49,356,3808,177,179,2717.70,4508.15,0.00
2024-12-08 14:55:49,357,3807,177,180,2707.34,4508.22,0.00
2024-12-08 14:55:49,358,3806,178,180,2699.94,4508.33,0.00
2024-12-08 14:55:49,359,3805,179,180,2684.05,4508.64,0.00
2024-12-08 14:55:49,359,3806,179,180,2720.62,4509.00,0.00
2024-12-08 14:55:49,360,3806,180,180,2713.06,4509.00,0.00
2024-12-08 14:55:49,361,3805,181,180,2698.11,4509.12,0.00
2024-12-08 14:55:49,360,3805,181,179,2706.50,4509.15,0.00
2024-12-08 14:55:49,359,3805,181,178,2713.92,4509.15,0.00
2024-12-08 14:55:49,360,3804,182,178,2701.66,4509.26,0.00
2024-12-08 14:55:49,361,3803,182,179,2688.49,4509.62,0.00
2024-12-08 14:55:49,361,3804,182,179,2734.89,4510.00,0.00
2024-12-08 14:55:49,362,3804,183,179,2727.33,4510.00,0.00
2024-12-08 14:55:49,361,3804,183,178,2730.28,4510.05,0.00
2024-12-08 14:55:49,360,3804,183,177,2733.17,4510.15,0.00
2024-12-08 14:55:49,361,3803,183,178,2695.73,4510.83,0.00
2024-12-08 14:55:49,362,3802,184,178,2689.18,4510.86,0.00
2024-12-08 14:55:49,363,3801,185,178,2687.40,4510.90,0.00
2024-12-08 14:55:49,363,3802,185,178,2728.99,4511.00,0.00
2024-12-08 14:55:49,364,3802,185,179,2721.49,4511.00,0.00
2024-12-08 14:55:49,365,3801,186,179,2712.08,4511.05,0.00
2024-12-08 14:55:49,364,3801,186,178,2721.89,4511.06,0.00
2024-12-08 14:55:49,363,3801,186,177,2728.41,4511.07,0.00
2024-12-08 14:55:49,362,3801,185,177,2732.26,4511.16,0.00
2024-12-08 14:55:49,361,3801,185,176,2739.70,4511.16,0.00
2024-12-08 14:55:49,360,3801,184,176,2740.96,4511.25,0.00
2024-12-08 14:55:49,361,3800,185,176,2705.37,4511.88,0.00
2024-12-08 14:55:49,361,3801,185,176,2751.59,4512.00,0.00
2024-12-08 14:55:49,362,3801,186,176,2743.99,4512.00,0.00
2024-12-08 14:55:49,361,3801,185,176,2751.10,4512.01,0.00
2024-12-08 14:55:49,362,3800,186,176,2742.14,4512.05,0.00
2024-12-08 14:55:49,361,3800,186,175,2754.06,4512.15,0.00
2024-12-08 14:55:49,360,3800,185,175,2761.46,4512.16,0.00
2024-12-08 14:55:49,361,3799,185,176,2749.72,4512.25,0.00
2024-12-08 14:55:49,360,3799,184,176,2763.14,4512.29,0.00
2024-12-08 14:55:49,361,3798,184,177,2744.36,4512.54,0.00
2024-12-08 14:55:49,361,3799,184,177,2767.21,4513.00,0.00
2024-12-08 14:55:49,362,3799,185,177,2759.56,4513.00,0.00
2024-12-08 14:55:49,361,3799,185,176,2760.51,4513.09,0.00
2024-12-08 14:55:49,360,3799,185,175,2765.08,4513.16,0.00
2024-12-08 14:55:49,359,3799,185,174,2772.66,4513.16,0.00
2024-12-08 14:55:49,360,3798,185,175,2750.06,4513.50,0.00
2024-12-08 14:55:49,361,3797,186,175,2737.64,4513.63,0.00
2024-12-08 14:55:49,362,3796,187,175,2727.21,4513.80,0.00
2024-12-08 14:55:49,362,3797,187,175,2765.79,4514.00,0.00
2024-12-08 14:55:49,363,3797,187,176,2758.17,4514.00,0.00
2024-12-08 14:55:49,362,3797,187,175,2762.08,4514.05,0.00
2024-12-08 14:55:49,361,3797,186,175,2764.67,4514.16,0.00
2024-12-08 14:55:49,362,3796,186,176,2751.84,4514.28,0.00
2024-12-08 14:55:49,361,3796,185,176,2759.48,4514.31,0.00
2024-12-08 14:55:49,362,3795,185,177,2728.97,4514.83,0.00
2024-12-08 14:55:49,362,3796,185,177,2768.28,4515.00,0.00
2024-12-08 14:55:49,363,3796,185,178,2760.65,4515.00,0.00
2024-12-08 14:55:49,364,3795,185,179,2729.36,4515.48,0.00
2024-12-08 14:55:49,365,3794,185,180,2709.86,4515.87,0.00
2024-12-08 14:55:49,365,3795,185,180,2742.88,4516.00,0.00
2024-12-08 14:55:49,366,3795,186,180,2735.39,4516.00,0.00
2024-12-08 14:55:49,367,3794,187,180,2713.30,4516.28,0.00
2024-12-08 14:55:49,368,3793,188,180,2714.16,4516.30,0.00
2024-12-08 14:55:49,369,3792,188,181,2697.90,4516.61,0.00
2024-12-08 14:55:49,369,3793,188,181,2715.66,4517.00,0.00
2024-12-08 14:55:49,370,3793,189,181,2708.32,4517.00,0.00
2024-12-08 14:55:50,370,3794,189,181,2706.93,4518.00,0.00
2024-12-08 14:55:50,371,3794,190,181,2699.63,4518.00,0.00
2024-12-08 14:55:50,370,3794,190,180,2697.25,4518.16,0.00
2024-12-08 14:55:50,371,3793,191,180,2685.74,4518.26,0.00
2024-12-08 14:55:50,370,3793,190,180,2686.73,4518.43,0.00
2024-12-08 14:55:50,371,3792,191,180,2673.95,4518.56,0.00
2024-12-08 14:55:50,372,3791,191,181,2661.74,4518.70,0.00
2024-12-08 14:55:50,373,3790,192,181,2656.47,4518.81,0.00
2024-12-08 14:55:50,373,3791,192,181,2667.36,4519.00,0.00
2024-12-08 14:55:50,374,3791,192,182,2660.23,4519.00,0.00
2024-12-08 14:55:50,373,3791,192,181,2664.36,4519.05,0.00
2024-12-08 14:55:50,374,3790,192,182,2647.55,4519.27,0.00
2024-12-08 14:55:50,373,3790,191,182,2648.65,4519.41,0.00
2024-12-08 14:55:50,374,3789,192,182,2618.00,4519.94,0.00
2024-12-08 14:55:50,374,3790,192,182,2671.82,4520.00,0.00
2024-12-08 14:55:50,375,3790,193,182,2664.69,4520.00,0.00
2024-12-08 14:55:50,376,3789,193,183,2626.77,4520.64,0.00
2024-12-08 14:55:50,377,3788,194,183,2612.40,4520.85,0.00
2024-12-08 14:55:50,377,3789,194,183,2642.13,4521.00,0.00
2024-12-08 14:55:50,378,3789,194,184,2635.14,4521.00,0.00
2024-12-08 14:55:50,377,3789,193,184,2632.38,4521.17,0.00
2024-12-08 14:55:50,378,3788,193,185,2608.71,4521.54,0.00
2024-12-08 14:55:50,379,3787,193,186,2597.44,4521.78,0.00
2024-12-08 14:55:50,379,3788,193,186,2621.06,4522.00,0.00
2024-12-08 14:55:50,380,3788,194,186,2614.16,4522.00,0.00
2024-12-08 14:55:50,381,3787,194,187,2598.35,4522.16,0.00
2024-12-08 14:55:50,382,3786,194,188,2598.42,4522.17,0.00
2024-12-08 14:55:50,382,3787,194,188,2594.69,4523.00,0.00
2024-12-08 14:55:50,383,3787,195,188,2587.91,4523.00,0.00
2024-12-08 14:55:50,382,3787,195,187,2591.40,4523.05,0.00
2024-12-08 14:55:50,383,3786,196,187,2581.60,4523.12,0.00
2024-12-08 14:55:50,382,3786,195,187,2592.41,4523.17,0.00
2024-12-08 14:55:50,383,3785,195,188,2574.51,4523.42,0.00
2024-12-08 14:55:50,384,3784,196,188,2565.10,4523.65,0.00
2024-12-08 14:55:50,385,3783,197,188,2563.02,4523.66,0.00
2024-12-08 14:55:50,386,3782,198,188,2552.89,4523.84,0.00
2024-12-08 14:55:50,386,3783,198,188,2578.45,4524.00,0.00
2024-12-08 14:55:50,387,3783,198,189,2571.79,4524.00,0.00
2024-12-08 14:55:50,388,3782,198,190,2559.71,4524.08,0.00
2024-12-08 14:55:50,387,3782,197,190,2565.21,4524.17,0.00
2024-12-08 14:55:50,388,3781,197,191,2552.23,4524.32,0.00
2024-12-08 14:55:50,389,3780,197,192,2535.92,4524.60,0.00
2024-12-08 14:55:50,388,3780,196,192,2546.97,4524.62,0.00
2024-12-08 14:55:50,389,3779,197,192,2528.41,4524.89,0.00
2024-12-08 14:55:50,389,3780,197,192,2592.89,4525.00,0.00
2024-12-08 14:55:50,390,3780,197,193,2586.24,4525.00,0.00
2024-12-08 14:55:50,391,3779,198,193,2574.79,4525.06,0.00
2024-12-08 14:55:50,392,3778,198,194,2572.04,4525.08,0.00
2024-12-08 14:55:50,391,3778,197,194,2577.71,4525.35,0.00
2024-12-08 14:55:50,390,3778,196,194,2580.41,4525.44,0.00
2024-12-08 14:55:50,391,3777,197,194,2559.65,4525.76,0.00
2024-12-08 14:55:50,391,3778,197,194,2606.30,4526.00,0.00
2024-12-08 14:55:50,392,3778,198,194,2599.65,4526.00,0.00
2024-12-08 14:55:50,391,3778,198,193,2601.46,4526.06,0.00
2024-12-08 14:55:50,392,3777,198,194,2594.71,4526.06,0.00
2024-12-08 14:55:50,391,3777,197,194,2604.07,4526.17,0.00
2024-12-08 14:55:50,390,3777,197,193,2610.63,4526.17,0.00
2024-12-08 14:55:50,391,3776,197,194,2597.86,4526.31,0.00
2024-12-08 14:55:50,392,3775,198,194,2587.90,4526.60,0.00
2024-12-08 14:55:50,393,3774,198,195,2582.30,4526.70,0.00
2024-12-08 14:55:50,393,3775,198,195,2613.99,4527.00,0.00
2024-12-08 14:55:50,394,3775,198,196,2607.36,4527.00,0.00
2024-12-08 14:55:50,393,3775,197,196,2603.11,4527.17,0.00
2024-12-08 14:55:50,392,3775,197,195,2609.52,4527.17,0.00
2024-12-08 14:55:50,391,3775,196,195,2604.03,4527.44,0.00
2024-12-08 14:55:50,392,3774,196,196,2595.79,4527.48,0.00
2024-12-08 14:55:50,392,3775,196,196,2632.42,4528.00,0.00
2024-12-08 14:55:50,393,3775,197,196,2625.73,4528.00,0.00
2024-12-08 14:55:50,392,3775,196,196,2631.28,4528.03,0.00
2024-12-08 14:55:50,391,3775,195,196,2635.51,4528.05,0.00
2024-12-08 14:55:50,390,3775,195,195,2634.32,4528.17,0.00
2024-12-08 14:55:50,389,3775,195,194,2640.97,4528.17,0.00
2024-12-08 14:55:50,390,3774,196,194,2631.20,4528.24,0.00
2024-12-08 14:55:50,391,3773,196,195,2616.80,4528.45,0.00
2024-12-08 14:55:50,392,3772,197,195,2601.38,4528.71,0.00
2024-12-08 14:55:50,393,3771,198,195,2590.07,4528.90,0.00
2024-12-08 14:55:50,393,3772,198,195,2614.47,4529.00,0.00
2024-12-08 14:55:50,394,3772,199,195,2607.83,4529.00,0.00
2024-12-08 14:55:50,393,3772,199,194,2602.18,4529.17,0.00
2024-12-08 14:55:50,392,3772,198,194,2602.58,4529.31,0.00
2024-12-08 14:55:50,391,3772,197,194,2583.64,4529.88,0.00
2024-12-08 14:55:51,391,3773,197,194,2636.23,4530.00,0.00
2024-12-08 14:55:51,392,3773,197,195,2629.50,4530.00,0.00
2024-12-08 14:55:51,391,3773,197,194,2621.96,4530.17,0.00
2024-12-08 14:55:51,390,3773,197,193,2628.56,4530.17,0.00
2024-12-08 14:55:51,391,3772,197,194,2607.60,4530.50,0.00
2024-12-08 14:55:51,392,3771,197,195,2596.70,4530.74,0.00
2024-12-08 14:55:51,393,3770,198,195,2584.49,4530.94,0.00
2024-12-08 14:55:51,393,3771,198,195,2594.23,4531.00,0.00
2024-12-08 14:55:51,394,3771,199,195,2587.65,4531.00,0.00
2024-12-08 14:55:51,393,3771,198,195,2592.07,4531.04,0.00
2024-12-08 14:55:51,392,3771,198,194,2596.49,4531.05,0.00
2024-12-08 14:55:51,391,3771,197,194,2597.52,4531.17,0.00
2024-12-08 14:55:51,390,3771,196,194,2603.83,4531.18,0.00
2024-12-08 14:55:51,391,3770,197,194,2583.04,4531.50,0.00
2024-12-08 14:55:51,392,3769,198,194,2573.28,4531.61,0.00
2024-12-08 14:55:51,393,3768,198,195,2561.93,4531.83,0.00
2024-12-08 14:55:51,393,3769,198,195,2601.17,4532.00,0.00
2024-12-08 14:55:51,394,3769,198,196,2594.56,4532.00,0.00
2024-12-08 14:55:51,393,3769,197,196,2600.48,4532.02,0.00
2024-12-08 14:55:51,392,3769,197,195,2605.40,4532.05,0.00
2024-12-08 14:55:51,391,3769,196,195,2606.66,4532.15,0.00
2024-12-08 14:55:51,390,3769,196,194,2612.19,4532.17,0.00
2024-12-08 14:55:51,391,3768,196,195,2602.75,4532.24,0.00
2024-12-08 14:55:51,390,3768,195,195,2615.97,4532.32,0.00
2024-12-08 14:55:51,391,3767,195,196,2602.40,4532.48,0.00
2024-12-08 14:55:51,392,3766,195,197,2591.29,4532.73,0.00
2024-12-08 14:55:51,392,3767,195,197,2628.85,4533.00,0.00
2024-12-08 14:55:51,393,3767,195,198,2622.16,4533.00,0.00
2024-12-08 14:55:51,394,3766,196,198,2607.86,4533.13,0.00
2024-12-08 14:55:51,393,3766,195,198,2617.17,4533.17,0.00
2024-12-08 14:55:51,392,3766,194,198,2623.73,4533.17,0.00
2024-12-08 14:55:51,391,3766,194,197,2630.32,4533.17,0.00
2024-12-08 14:55:51,390,3766,193,197,2633.83,4533.22,0.00
2024-12-08 14:55:51,391,3765,194,197,2618.36,4533.42,0.00
2024-12-08 14:55:51,390,3765,193,197,2628.11,4533.45,0.00
2024-12-08 14:55:51,390,3766,193,197,2649.89,4534.00,0.00
2024-12-08 14:55:51,391,3766,193,198,2643.12,4534.00,0.00
2024-12-08 14:55:51,390,3766,193,197,2644.81,4534.06,0.00
2024-12-08 14:55:51,389,3766,193,196,2643.75,4534.17,0.00
2024-12-08 14:55:51,390,3765,193,197,2632.01,4534.29,0.00
2024-12-08 14:55:51,391,3764,193,198,2629.69,4534.30,0.00
2024-12-08 14:55:51,392,3763,193,199,2621.66,4534.44,0.00
2024-12-08 14:55:51,391,3763,192,199,2628.61,4534.47,0.00
2024-12-08 14:55:51,391,3763,192,199,2639.54,4535.00,0.00
2024-12-08 14:55:51,392,3763,192,200,2632.81,4535.00,0.00
2024-12-08 14:55:51,391,3763,191,200,2638.85,4535.02,0.00
2024-12-08 14:55:51,392,3762,191,201,2627.29,4535.08,0.00
2024-12-08 14:55:51,393,3761,192,201,2628.01,4535.12,0.00
2024-12-08 14:55:51,392,3761,191,201,2637.47,4535.12,0.00
2024-12-08 14:55:51,391,3761,191,200,2641.69,4535.17,0.00
2024-12-08 14:55:51,392,3760,191,201,2634.84,4535.18,0.00
2024-12-08 14:55:51,393,3759,192,201,2628.61,4535.21,0.00
2024-12-08 14:55:51,393,3760,192,201,2643.17,4536.00,0.00
2024-12-08 14:55:51,394,3760,193,201,2636.47,4536.00,0.00
2024-12-08 14:55:51,393,3760,192,201,2643.06,4536.00,0.00
2024-12-08 14:55:51,392,3760,192,200,2646.58,4536.05,0.00
2024-12-08 14:55:51,391,3760,192,199,2649.80,4536.12,0.00
2024-12-08 14:55:51,390,3760,191,199,2654.52,4536.17,0.00
2024-12-08 14:55:51,389,3760,190,199,2656.45,4536.19,0.00
2024-12-08 14:55:51,389,3761,190,199,2678.41,4537.00,0.00
2024-12-08 14:55:51,390,3761,191,199,2671.54,4537.00,0.00
2024-12-08 14:55:51,391,3760,191,200,2660.09,4537.06,0.00
2024-12-08 14:55:51,390,3760,191,199,2668.60,4537.17,0.00
2024-12-08 14:55:51,389,3760,191,198,2675.34,4537.18,0.00
2024-12-08 14:55:51,390,3759,192,198,2656.95,4537.44,0.00
2024-12-08 14:55:51,389,3759,191,198,2663.44,4537.46,0.00
2024-12-08 14:55:51,390,3758,191,199,2638.74,4537.83,0.00
2024-12-08 14:55:51,390,3759,191,199,2645.05,4538.00,0.00
2024-12-08 14:55:51,391,3759,192,199,2638.29,4538.00,0.00
2024-12-08 14:55:51,392,3758,192,200,2620.31,4538.21,0.00
2024-12-08 14:55:51,393,3757,193,200,2598.43,4538.73,0.00
2024-12-08 14:55:51,394,3756,193,201,2593.75,4538.85,0.00
2024-12-08 14:55:51,394,3757,193,201,2633.16,4539.00,0.00
2024-12-08 14:55:51,395,3757,194,201,2626.49,4539.00,0.00
2024-12-08 14:55:51,394,3757,193,201,2622.99,4539.18,0.00
2024-12-08 14:55:51,395,3756,194,201,2615.89,4539.19,0.00
2024-12-08 14:55:51,395,3757,194,201,2622.98,4540.00,0.00
2024-12-08 14:55:51,396,3757,194,202,2616.36,4540.00,0.00
2024-12-08 14:55:51,397,3756,195,202,2604.20,4540.08,0.00
2024-12-08 14:55:51,396,3756,195,201,2615.26,4540.11,0.00
2024-12-08 14:55:51,395,3756,195,200,2618.70,4540.18,0.00
2024-12-08 14:55:51,394,3756,195,199,2625.23,4540.18,0.00
2024-12-08 14:55:51,395,3755,195,200,2614.25,4540.28,0.00
2024-12-08 14:55:51,396,3754,196,200,2585.25,4540.96,0.00
2024-12-08 14:55:51,396,3755,196,200,2602.37,4541.00,0.00
2024-12-08 14:55:51,397,3755,196,201,2595.82,4541.00,0.00
2024-12-08 14:55:51,396,3755,196,200,2599.98,4541.05,0.00
2024-12-08 14:55:51,397,3754,196,201,2592.98,4541.06,0.00
2024-12-08 14:55:51,398,3753,196,202,2590.28,4541.15,0.00
2024-12-08 14:55:52,397,3753,196,201,2603.22,4541.18,0.00
2024-12-08 14:55:52,398,3752,196,202,2581.42,4541.52,0.00
2024-12-08 14:55:52,399,3751,196,203,2570.99,4541.75,0.00
2024-12-08 14:55:52,399,3752,196,203,2609.91,4542.00,0.00
2024-12-08 14:55:52,400,3752,196,204,2603.38,4542.00,0.00
2024-12-08 14:55:52,399,3752,196,203,2606.17,4542.05,0.00
2024-12-08 14:55:52,398,3752,195,203,2606.97,4542.17,0.00
2024-12-08 14:55:52,397,3752,195,202,2613.30,4542.17,0.00
2024-12-08 14:55:52,396,3752,194,202,2619.45,4542.18,0.00
2024-12-08 14:55:52,396,3753,194,202,2640.01,4543.00,0.00
2024-12-08 14:55:52,397,3753,195,202,2633.36,4543.00,0.00
2024-12-08 14:55:52,398,3752,195,203,2622.09,4543.06,0.00
2024-12-08 14:55:52,397,3752,194,203,2630.55,4543.11,0.00
2024-12-08 14:55:52,397,3753,194,203,2601.04,4544.00,0.00
2024-12-08 14:55:52,398,3753,194,204,2594.50,4544.00,0.00
2024-12-08 14:55:52,397,3753,193,204,2600.70,4544.01,0.00
2024-12-08 14:55:52,398,3752,193,205,2587.25,4544.12,0.00
2024-12-08 14:55:52,397,3752,193,204,2600.53,4544.12,0.00
2024-12-08 14:55:52,396,3752,193,203,2604.60,4544.18,0.00
2024-12-08 14:55:52,397,3751,194,203,2574.79,4544.66,0.00
2024-12-08 14:55:52,398,3750,194,204,2561.32,4544.92,0.00
2024-12-08 14:55:52,398,3751,194,204,2581.49,4545.00,0.00
2024-12-08 14:55:52,399,3751,194,205,2575.02,4545.00,0.00
2024-12-08 14:55:52,398,3751,194,204,2571.19,4545.18,0.00
2024-12-08 14:55:52,399,3750,195,204,2564.18,4545.20,0.00
2024-12-08 14:55:52,400,3749,196,204,2542.97,4545.66,0.00
2024-12-08 14:55:52,401,3748,196,205,2532.46,4545.85,0.00
2024-12-08 14:55:52,401,3749,196,205,2569.73,4546.00,0.00
2024-12-08 14:55:52,402,3749,196,206,2563.34,4546.00,0.00
2024-12-08 14:55:52,403,3748,196,207,2556.64,4546.02,0.00
2024-12-08 14:55:52,402,3748,196,206,2565.39,4546.05,0.00
2024-12-08 14:55:52,403,3747,197,206,2556.02,4546.12,0.00
2024-12-08 14:55:52,404,3746,197,207,2548.41,4546.31,0.00
2024-12-08 14:55:52,405,3745,197,208,2535.71,4546.54,0.00
2024-12-08 14:55:52,406,3744,198,208,2531.28,4546.58,0.00
2024-12-08 14:55:52,407,3743,199,208,2527.31,4546.60,0.00
2024-12-08 14:55:52,408,3742,200,208,2513.71,4546.86,0.00
2024-12-08 14:55:52,408,3743,200,208,2549.49,4547.00,0.00
2024-12-08 14:55:52,409,3743,200,209,2543.26,4547.00,0.00
2024-12-08 14:55:52,410,3742,201,209,2523.85,4547.25,0.00
2024-12-08 14:55:52,411,3741,201,210,2506.44,4547.72,0.00
2024-12-08 14:55:52,412,3740,202,210,2495.51,4547.89,0.00
2024-12-08 14:55:52,412,3741,202,210,2580.15,4548.00,0.00
2024-12-08 14:55:52,413,3741,202,211,2573.90,4548.00,0.00
2024-12-08 14:55:52,412,3741,201,211,2579.82,4548.01,0.00
2024-12-08 14:55:52,411,3741,200,211,2580.16,4548.09,0.00
2024-12-08 14:55:52,410,3741,200,210,2582.51,4548.17,0.00
2024-12-08 14:55:52,409,3741,200,209,2588.71,4548.17,0.00
2024-12-08 14:55:52,410,3740,201,209,2576.56,4548.31,0.00
2024-12-08 14:55:52,411,3739,202,209,2568.00,4548.54,0.00
2024-12-08 14:55:52,412,3738,202,210,2564.03,4548.62,0.00
2024-12-08 14:55:52,412,3739,202,210,2594.49,4549.00,0.00
2024-12-08 14:55:52,413,3739,203,210,2588.21,4549.00,0.00
2024-12-08 14:55:52,412,3739,202,210,2593.95,4549.01,0.00
2024-12-08 14:55:52,413,3738,203,210,2579.25,4549.16,0.00
2024-12-08 14:55:52,412,3738,202,210,2589.17,4549.18,0.00
2024-12-08 14:55:52,411,3738,201,210,2595.36,4549.18,0.00
2024-12-08 14:55:52,412,3737,202,210,2580.51,4549.37,0.00
2024-12-08 14:55:52,412,3738,202,210,2598.88,4550.00,0.00
2024-12-08 14:55:52,413,3738,202,211,2592.59,4550.00,0.00
2024-12-08 14:55:52,412,3738,202,210,2588.70,4550.18,0.00
2024-12-08 14:55:52,413,3737,202,211,2568.77,4550.48,0.00
2024-12-08 14:55:52,414,3736,203,211,2561.45,4550.66,0.00
2024-12-08 14:55:52,415,3735,203,212,2551.57,4550.84,0.00
2024-12-08 14:55:52,416,3734,203,213,2544.72,4550.90,0.00
2024-12-08 14:55:52,416,3735,203,213,2569.97,4551.00,0.00
2024-12-08 14:55:52,417,3735,204,213,2563.81,4551.00,0.00
2024-12-08 14:55:52,416,3735,204,212,2567.69,4551.04,0.00
2024-12-08 14:55:52,415,3735,203,212,2568.89,4551.15,0.00
2024-12-08 14:55:52,414,3735,203,211,2573.79,4551.17,0.00
2024-12-08 14:55:52,413,3735,203,210,2579.91,4551.17,0.00
2024-12-08 14:55:52,414,3734,203,211,2558.74,4551.51,0.00
2024-12-08 14:55:52,415,3733,203,212,2556.55,4551.56,0.00
2024-12-08 14:55:52,416,3732,203,213,2552.75,4551.64,0.00
2024-12-08 14:55:52,416,3733,203,213,2595.59,4552.00,0.00
2024-12-08 14:55:52,417,3733,203,214,2589.37,4552.00,0.00
2024-12-08 14:55:52,418,3732,203,215,2582.09,4552.03,0.00
2024-12-08 14:55:52,417,3732,202,215,2584.76,4552.17,0.00
2024-12-08 14:55:52,416,3732,201,215,2590.76,4552.18,0.00
2024-12-08 14:55:52,415,3732,200,215,2596.89,4552.18,0.00
2024-12-08 14:55:52,414,3732,199,215,2595.17,4552.31,0.00
2024-12-08 14:55:53,414,3733,199,215,2608.04,4553.00,0.00
2024-12-08 14:55:53,415,3733,200,215,2601.76,4553.00,0.00
2024-12-08 14:55:53,416,3732,200,216,2588.44,4553.12,0.00
2024-12-08 14:55:53,417,3731,200,217,2589.34,4553.14,0.00
2024-12-08 14:55:53,416,3731,199,217,2601.51,4553.19,0.00
2024-12-08 14:55:53,415,3731,198,217,2600.33,4553.35,0.00
2024-12-08 14:55:53,416,3730,198,218,2569.62,4553.82,0.00
2024-12-08 14:55:53,417,3729,199,218,2565.01,4553.83,0.00
2024-12-08 14:55:53,417,3730,199,218,2581.42,4554.00,0.00
2024-12-08 14:55:53,418,3730,200,218,2575.24,4554.00,0.00
2024-12-08 14:55:53,417,3730,200,217,2578.16,4554.04,0.00
2024-12-08 14:55:53,416,3730,199,217,2577.86,4554.18,0.00
2024-12-08 14:55:53,417,3729,200,217,2556.84,4554.51,0.00
2024-12-08 14:55:53,417,3730,200,217,2585.92,4555.00,0.00
2024-12-08 14:55:53,418,3730,201,217,2579.73,4555.00,0.00
2024-12-08 14:55:53,417,3730,201,216,2574.70,4555.18,0.00
2024-12-08 14:55:53,417,3731,201,216,2559.55,4556.00,0.00
2024-12-08 14:55:53,418,3731,202,216,2553.43,4556.00,0.00
2024-12-08 14:55:53,417,3731,202,215,2551.42,4556.13,0.00
2024-12-08 14:55:53,416,3731,202,214,2555.50,4556.18,0.00
2024-12-08 14:55:53,415,3731,202,213,2561.44,4556.18,0.00
2024-12-08 14:55:53,414,3731,201,213,2556.25,4556.43,0.00
2024-12-08 14:55:53,415,3730,202,213,2547.59,4556.49,0.00
2024-12-08 14:55:53,416,3729,202,214,2542.15,4556.54,0.00
2024-12-08 14:55:53,417,3728,202,215,2537.81,4556.56,0.00
2024-12-08 14:55:53,416,3728,201,215,2538.99,4556.69,0.00
2024-12-08 14:55:53,417,3727,201,216,2530.96,4556.74,0.00
2024-12-08 14:55:53,418,3726,201,217,2527.32,4556.76,0.00
2024-12-08 14:55:53,419,3725,202,217,2517.71,4556.91,0.00
2024-12-08 14:55:53,419,3726,202,217,2524.08,4557.00,0.00
2024-12-08 14:55:53,420,3726,202,218,2518.07,4557.00,0.00
2024-12-08 14:55:53,421,3725,203,218,2511.23,4557.03,0.00
2024-12-08 14:55:53,422,3724,204,218,2511.66,4557.04,0.00
2024-12-08 14:55:53,423,3723,204,219,2503.92,4557.11,0.00
2024-12-08 14:55:53,422,3723,204,218,2513.79,4557.18,0.00
2024-12-08 14:55:53,421,3723,204,217,2519.65,4557.18,0.00
2024-12-08 14:55:53,420,3723,203,217,2525.54,4557.18,0.00
2024-12-08 14:55:53,421,3722,204,217,2513.41,4557.32,0.00
2024-12-08 14:55:53,422,3721,204,218,2514.27,4557.37,0.00
2024-12-08 14:55:53,423,3720,205,218,2498.85,4557.76,0.00
2024-12-08 14:55:53,424,3719,206,218,2491.85,4557.86,0.00
2024-12-08 14:55:53,424,3720,206,218,2559.62,4558.00,0.00
2024-12-08 14:55:53,425,3720,206,219,2553.60,4558.00,0.00
2024-12-08 14:55:53,426,3719,207,219,2542.60,4558.07,0.00
2024-12-08 14:55:53,425,3719,207,218,2550.47,4558.18,0.00
2024-12-08 14:55:53,424,3719,207,217,2556.38,4558.18,0.00
2024-12-08 14:55:53,425,3718,207,218,2545.35,4558.29,0.00
2024-12-08 14:55:53,426,3717,207,219,2529.95,4558.70,0.00
2024-12-08 14:55:53,426,3718,207,219,2604.98,4559.00,0.00
2024-12-08 14:55:53,427,3718,207,220,2598.88,4559.00,0.00
2024-12-08 14:55:53,426,3718,206,220,2594.90,4559.18,0.00
2024-12-08 14:55:53,427,3717,206,221,2586.91,4559.22,0.00
2024-12-08 14:55:53,428,3716,207,221,2580.73,4559.45,0.00
2024-12-08 14:55:53,429,3715,208,221,2576.38,4559.57,0.00
2024-12-08 14:55:53,430,3714,209,221,2566.70,4559.77,0.00
2024-12-08 14:55:53,429,3714,208,221,2571.98,4559.82,0.00
2024-12-08 14:55:53,429,3715,208,221,2605.13,4560.00,0.00
2024-12-08 14:55:53,430,3715,209,221,2599.07,4560.00,0.00
2024-12-08 14:55:53,429,3715,208,221,2603.92,4560.03,0.00
2024-12-08 14:55:53,430,3714,208,222,2595.54,4560.04,0.00
2024-12-08 14:55:53,431,3713,208,223,2585.25,4560.18,0.00
2024-12-08 14:55:53,430,3713,208,222,2594.97,4560.18,0.00
2024-12-08 14:55:53,429,3713,208,221,2600.91,4560.18,0.00
2024-12-08 14:55:53,430,3712,208,222,2570.31,4560.73,0.00
2024-12-08 14:55:53,431,3711,208,223,2554.15,4560.99,0.00
2024-12-08 14:55:53,431,3712,208,223,2606.54,4561.00,0.00
2024-12-08 14:55:53,432,3712,208,224,2600.51,4561.00,0.00
2024-12-08 14:55:53,431,3712,208,223,2600.33,4561.09,0.00
2024-12-08 14:55:53,430,3712,207,223,2602.50,4561.17,0.00
2024-12-08 14:55:53,429,3712,206,223,2608.46,4561.18,0.00
2024-12-08 14:55:53,430,3711,206,224,2594.50,4561.35,0.00
2024-12-08 14:55:53,431,3710,207,224,2585.38,4561.51,0.00
2024-12-08 14:55:53,432,3709,207,225,2578.27,4561.58,0.00
2024-12-08 14:55:53,433,3708,208,225,2568.49,4561.71,0.00
2024-12-08 14:55:53,433,3709,208,225,2608.10,4562.00,0.00
2024-12-08 14:55:53,434,3709,209,225,2602.09,4562.00,0.00
2024-12-08 14:55:53,433,3709,209,224,2605.26,4562.03,0.00
2024-12-08 14:55:53,432,3709,208,224,2604.71,4562.17,0.00
2024-12-08 14:55:53,433,3708,208,225,2598.49,4562.18,0.00
2024-12-08 14:55:53,434,3707,208,226,2589.61,4562.36,0.00
2024-12-08 14:55:53,433,3707,207,226,2601.09,4562.41,0.00
2024-12-08 14:55:53,434,3706,208,226,2591.56,4562.50,0.00
2024-12-08 14:55:53,435,3705,208,227,2584.44,4562.66,0.00
2024-12-08 14:55:53,436,3704,209,227,2580.11,4562.70,0.00
2024-12-08 14:55:53,437,3703,210,227,2571.29,4562.84,0.00
2024-12-08 14:55:53,438,3702,210,228,2565.55,4562.88,0.00
2024-12-08 14:55:53,438,3703,210,228,2609.30,4563.00,0.00
2024-12-08 14:55:53,439,3703,211,228,2603.36,4563.00,0.00
2024-12-08 14:55:53,438,3703,211,227,2605.77,4563.03,0.00
2024-12-08 14:55:53,437,3703,211,226,2605.54,4563.17,0.00
2024-12-08 14:55:54,438,3702,211,227,2596.28,4563.24,0.00
2024-12-08 14:55:54,439,3701,212,227,2577.53,4563.74,0.00
2024-12-08 14:55:54,439,3702,212,227,2647.18,4564.00,0.00
2024-12-08 14:55:54,440,3702,212,228,2641.16,4564.00,0.00
2024-12-08 14:55:54,441,3701,213,228,2634.15,4564.03,0.00
2024-12-08 14:55:54,440,3701,213,227,2638.79,4564.04,0.00
2024-12-08 14:55:54,441,3700,214,227,2632.60,4564.05,0.00
2024-12-08 14:55:54,440,3700,213,227,2640.87,4564.05,0.00
2024-12-08 14:55:54,441,3699,214,227,2631.81,4564.12,0.00
2024-12-08 14:55:54,442,3698,214,228,2626.10,4564.20,0.00
2024-12-08 14:55:54,443,3697,214,229,2617.56,4564.41,0.00
2024-12-08 14:55:54,442,3697,213,229,2620.06,4564.44,0.00
2024-12-08 14:55:54,443,3696,213,230,2604.48,4564.66,0.00
2024-12-08 14:55:54,444,3695,214,230,2595.64,4564.81,0.00
2024-12-08 14:55:54,445,3694,215,230,2587.43,4564.91,0.00
2024-12-08 14:55:54,445,3695,215,230,2614.90,4565.00,0.00
2024-12-08 14:55:54,446,3695,216,230,2609.03,4565.00,0.00
2024-12-08 14:55:54,445,3695,215,230,2613.47,4565.03,0.00
2024-12-08 14:55:54,444,3695,215,229,2618.33,4565.03,0.00
2024-12-08 14:55:54,443,3695,215,228,2624.14,4565.03,0.00
2024-12-08 14:55:54,442,3695,214,228,2624.05,4565.17,0.00
2024-12-08 14:55:54,441,3695,213,228,2629.90,4565.17,0.00
2024-12-08 14:55:54,440,3695,212,228,2635.77,4565.17,0.00
2024-12-08 14:55:54,439,3695,212,227,2641.67,4565.17,0.00
2024-12-08 14:55:54,438,3695,212,226,2647.60,4565.17,0.00
2024-12-08 14:55:54,439,3694,213,226,2633.69,4565.25,0.00
2024-12-08 14:55:54,438,3694,212,226,2633.22,4565.43,0.00
2024-12-08 14:55:54,439,3693,213,226,2621.06,4565.57,0.00
2024-12-08 14:55:54,440,3692,214,226,2621.06,4565.64,0.00
2024-12-08 14:55:54,441,3691,215,226,2617.11,4565.69,0.00
2024-12-08 14:55:54,441,3692,215,226,2697.39,4566.00,0.00
2024-12-08 14:55:54,442,3692,215,227,2691.29,4566.00,0.00
2024-12-08 14:55:54,443,3691,215,228,2670.39,4566.29,0.00
2024-12-08 14:55:54,443,3692,215,228,2693.68,4567.00,0.00
2024-12-08 14:55:54,444,3692,215,229,2687.61,4567.00,0.00
2024-12-08 14:55:54,443,3692,214,229,2692.96,4567.02,0.00
2024-12-08 14:55:54,442,3692,214,228,2695.35,4567.05,0.00
2024-12-08 14:55:54,441,3692,214,227,2699.93,4567.08,0.00
2024-12-08 14:55:54,440,3692,213,227,2702.67,4567.16,0.00
2024-12-08 14:55:54,439,3692,213,226,2708.21,4567.17,0.00
2024-12-08 14:55:54,438,3692,212,226,2707.98,4567.31,0.00
2024-12-08 14:55:54,439,3691,212,227,2687.41,4567.63,0.00
2024-12-08 14:55:54,440,3690,212,228,2675.04,4567.86,0.00
2024-12-08 14:55:54,440,3691,212,228,2692.12,4568.00,0.00
2024-12-08 14:55:54,441,3691,212,229,2686.02,4568.00,0.00
2024-12-08 14:55:54,440,3691,211,229,2691.20,4568.02,0.00
2024-12-08 14:55:54,441,3690,212,229,2681.49,4568.06,0.00
2024-12-08 14:55:54,442,3689,213,229,2680.91,4568.08,0.00
2024-12-08 14:55:54,443,3688,213,230,2684.24,4568.09,0.00
2024-12-08 14:55:54,442,3688,212,230,2699.93,4568.09,0.00
2024-12-08 14:55:54,441,3688,211,230,2702.16,4568.18,0.00
2024-12-08 14:55:54,440,3688,210,230,2708.20,4568.18,0.00
2024-12-08 14:55:54,439,3688,210,229,2714.27,4568.18,0.00
2024-12-08 14:55:54,438,3688,209,229,2720.36,4568.18,0.00
2024-12-08 14:55:54,439,3687,209,230,2699.62,4568.50,0.00
2024-12-08 14:55:54,439,3688,209,230,2712.04,4569.00,0.00
2024-12-08 14:55:54,440,3688,210,230,2705.88,4569.00,0.00
2024-12-08 14:55:54,439,3688,210,229,2704.10,4569.13,0.00
2024-12-08 14:55:54,438,3688,209,229,2708.52,4569.17,0.00
2024-12-08 14:55:54,437,3688,209,228,2714.51,4569.17,0.00
2024-12-08 14:55:54,436,3688,208,228,2720.63,4569.17,0.00
2024-12-08 14:55:54,435,3688,208,227,2726.78,4569.17,0.00
2024-12-08 14:55:54,436,3687,208,228,2716.67,4569.26,0.00
2024-12-08 14:55:54,437,3686,208,229,2691.87,4569.70,0.00
2024-12-08 14:55:54,436,3686,207,229,2696.96,4569.79,0.00
2024-12-08 14:55:54,437,3685,207,230,2684.94,4569.93,0.00
2024-12-08 14:55:54,437,3686,207,230,2730.84,4570.00,0.00
2024-12-08 14:55:54,438,3686,207,231,2724.60,4570.00,0.00
2024-12-08 14:55:54,437,3686,207,230,2728.03,4570.03,0.00
2024-12-08 14:55:54,438,3685,207,231,2720.35,4570.07,0.00
2024-12-08 14:55:54,439,3684,207,232,2713.88,4570.13,0.00
2024-12-08 14:55:54,440,3683,208,232,2710.94,4570.14,0.00
2024-12-08 14:55:54,439,3683,208,231,2716.51,4570.18,0.00
2024-12-08 14:55:54,440,3682,208,232,2695.00,4570.52,0.00
2024-12-08 14:55:54,441,3681,208,233,2688.55,4570.65,0.00
2024-12-08 14:55:54,442,3680,209,233,2676.94,4570.86,0.00
2024-12-08 14:55:54,442,3681,209,233,2709.33,4571.00,0.00
2024-12-08 14:55:54,443,3681,210,233,2703.21,4571.00,0.00
2024-12-08 14:55:54,442,3681,209,233,2700.41,4571.15,0.00
2024-12-08 14:55:54,443,3680,209,234,2693.50,4571.17,0.00
2024-12-08 14:55:54,442,3680,209,233,2703.83,4571.17,0.00
2024-12-08 14:55:54,443,3679,210,233,2672.72,4571.73,0.00
2024-12-08 14:55:54,443,3680,210,233,2735.38,4572.00,0.00
2024-12-08 14:55:54,444,3680,211,233,2729.22,4572.00,0.00
2024-12-08 14:55:54,443,3680,211,232,2733.64,4572.03,0.00
2024-12-08 14:55:54,444,3679,212,232,2726.06,4572.07,0.00
2024-12-08 14:55:54,443,3679,212,231,2731.11,4572.12,0.00
2024-12-08 14:55:54,442,3679,211,231,2734.94,4572.17,0.00
2024-12-08 14:55:54,441,3679,210,231,2741.04,4572.17,0.00
2024-12-08 14:55:54,440,3679,209,231,2747.16,4572.17,0.00
2024-12-08 14:55:54,441,3678,209,232,2737.43,4572.25,0.00
2024-12-08 14:55:54,442,3677,210,232,2729.57,4572.47,0.00
2024-12-08 14:55:54,443,3676,211,232,2720.02,4572.67,0.00
2024-12-08 14:55:54,442,3676,210,232,2727.99,4572.71,0.00
2024-12-08 14:55:54,443,3675,211,232,2713.62,4572.89,0.00
2024-12-08 14:55:54,444,3674,212,232,2707.02,4572.93,0.00
2024-12-08 14:55:55,444,3675,212,232,2731.29,4573.00,0.00
2024-12-08 14:55:55,445,3675,212,233,2725.15,4573.00,0.00
2024-12-08 14:55:55,444,3675,212,232,2721.70,4573.17,0.00
2024-12-08 14:55:55,445,3674,212,233,2699.58,4573.47,0.00
2024-12-08 14:55:55,445,3675,212,233,2753.62,4574.00,0.00
2024-12-08 14:55:55,446,3675,213,233,2747.45,4574.00,0.00
2024-12-08 14:55:55,447,3674,214,233,2732.48,4574.16,0.00
2024-12-08 14:55:55,446,3674,214,232,2740.26,4574.18,0.00
2024-12-08 14:55:55,445,3674,214,231,2746.11,4574.18,0.00
2024-12-08 14:55:55,444,3674,213,231,2735.41,4574.46,0.00
2024-12-08 14:55:55,445,3673,213,232,2721.85,4574.63,0.00
2024-12-08 14:55:55,445,3674,213,232,2728.42,4575.00,0.00
2024-12-08 14:55:55,446,3674,214,232,2722.31,4575.00,0.00
2024-12-08 14:55:55,445,3674,214,231,2726.17,4575.03,0.00
2024-12-08 14:55:55,444,3674,213,231,2725.70,4575.18,0.00
2024-12-08 14:55:55,445,3673,214,231,2715.89,4575.26,0.00
2024-12-08 14:55:55,446,3672,215,231,2710.85,4575.34,0.00
2024-12-08 14:55:55,447,3671,216,231,2688.75,4575.74,0.00
2024-12-08 14:55:55,448,3670,217,231,2682.79,4575.80,0.00
2024-12-08 14:55:55,448,3671,217,231,2702.27,4576.00,0.00
2024-12-08 14:55:55,449,3671,217,232,2696.25,4576.00,0.00
2024-12-08 14:55:55,448,3671,217,231,2700.13,4576.04,0.00
2024-12-08 14:55:55,449,3670,217,232,2692.61,4576.07,0.00
2024-12-08 14:55:55,450,3669,217,233,2685.73,4576.11,0.00
2024-12-08 14:55:55,449,3669,217,232,2691.55,4576.18,0.00
2024-12-08 14:55:55,448,3669,216,232,2683.24,4576.42,0.00
2024-12-08 14:55:55,449,3668,216,233,2674.34,4576.49,0.00
2024-12-08 14:55:55,449,3669,216,233,2706.22,4577.00,0.00
2024-12-08 14:55:55,450,3669,216,234,2700.20,4577.00,0.00
2024-12-08 14:55:55,449,3669,216,233,2703.68,4577.03,0.00
2024-12-08 14:55:55,450,3668,217,233,2694.25,4577.11,0.00
2024-12-08 14:55:55,449,3668,216,233,2704.17,4577.18,0.00
2024-12-08 14:55:55,448,3668,216,232,2710.10,4577.18,0.00
2024-12-08 14:55:55,447,3668,215,232,2702.22,4577.41,0.00
2024-12-08 14:55:55,448,3667,215,233,2683.58,4577.69,0.00
2024-12-08 14:55:55,449,3666,215,234,2678.43,4577.71,0.00
2024-12-08 14:55:55,449,3667,215,234,2709.15,4578.00,0.00
2024-12-08 14:55:55,450,3667,216,234,2703.13,4578.00,0.00
2024-12-08 14:55:55,451,3666,217,234,2696.83,4578.01,0.00
2024-12-08 14:55:55,450,3666,216,234,2704.50,4578.10,0.00
2024-12-08 14:55:55,449,3666,216,233,2707.00,4578.18,0.00
2024-12-08 14:55:55,448,3666,215,233,2712.94,4578.18,0.00
2024-12-08 14:55:55,447,3666,214,233,2718.91,4578.18,0.00
2024-12-08 14:55:55,446,3666,213,233,2708.95,4578.53,0.00
2024-12-08 14:55:55,447,3665,213,234,2697.43,4578.65,0.00
2024-12-08 14:55:55,448,3664,214,234,2691.57,4578.73,0.00
2024-12-08 14:55:55,448,3665,214,234,2719.08,4579.00,0.00
2024-12-08 14:55:55,449,3665,214,235,2713.02,4579.00,0.00
2024-12-08 14:55:55,448,3665,214,234,2717.15,4579.03,0.00
2024-12-08 14:55:55,449,3664,214,235,2707.88,4579.11,0.00
2024-12-08 14:55:55,448,3664,214,234,2711.61,4579.18,0.00
2024-12-08 14:55:55,447,3664,214,233,2717.57,4579.18,0.00
2024-12-08 14:55:55,446,3664,214,232,2723.56,4579.18,0.00
2024-12-08 14:55:55,447,3663,214,233,2716.05,4579.21,0.00
2024-12-08 14:55:55,448,3662,215,233,2710.73,4579.32,0.00
2024-12-08 14:55:55,449,3661,215,234,2707.40,4579.45,0.00
2024-12-08 14:55:55,450,3660,216,234,2697.33,4579.74,0.00
2024-12-08 14:55:55,451,3659,216,235,2687.11,4579.90,0.00
2024-12-08 14:55:55,451,3660,216,235,2720.00,4580.00,0.00
2024-12-08 14:55:55,452,3660,217,235,2713.98,4580.00,0.00
2024-12-08 14:55:55,451,3660,216,235,2718.69,4580.03,0.00
2024-12-08 14:55:55,452,3659,217,235,2706.14,4580.13,0.00
2024-12-08 14:55:55,451,3659,217,234,2711.66,4580.18,0.00
2024-12-08 14:55:55,450,3659,216,234,2717.58,4580.18,0.00
2024-12-08 14:55:55,449,3659,216,233,2723.53,4580.18,0.00
2024-12-08 14:55:55,450,3658,216,234,2711.58,4580.26,0.00
2024-12-08 14:55:55,451,3657,216,235,2708.43,4580.32,0.00
2024-12-08 14:55:55,452,3656,217,235,2702.87,4580.38,0.00
2024-12-08 14:55:55,453,3655,218,235,2697.45,4580.46,0.00
2024-12-08 14:55:55,453,3656,218,235,2749.92,4581.00,0.00
2024-12-08 14:55:55,454,3656,218,236,2743.86,4581.00,0.00
2024-12-08 14:55:55,453,3656,218,235,2742.40,4581.12,0.00
2024-12-08 14:55:55,452,3656,218,234,2745.86,4581.18,0.00
2024-12-08 14:55:55,451,3656,218,233,2751.85,4581.18,0.00
2024-12-08 14:55:55,450,3656,217,233,2757.86,4581.18,0.00
2024-12-08 14:55:55,451,3655,217,234,2735.85,4581.53,0.00
2024-12-08 14:55:55,452,3654,218,234,2728.17,4581.68,0.00
2024-12-08 14:55:55,453,3653,219,234,2724.39,4581.70,0.00
2024-12-08 14:55:55,454,3652,220,234,2711.80,4581.92,0.00
2024-12-08 14:55:55,454,3653,220,234,2765.66,4582.00,0.00
2024-12-08 14:55:55,455,3653,221,234,2759.58,4582.00,0.00
2024-12-08 14:55:55,454,3653,221,233,2762.95,4582.03,0.00
2024-12-08 14:55:55,453,3653,221,232,2762.35,4582.18,0.00
2024-12-08 14:55:55,454,3652,221,233,2739.07,4582.56,0.00
2024-12-08 14:55:55,454,3653,221,233,2767.47,4583.00,0.00
2024-12-08 14:55:55,455,3653,222,233,2761.39,4583.00,0.00
2024-12-08 14:55:55,454,3653,221,233,2767.27,4583.00,0.00
2024-12-08 14:55:55,455,3652,222,233,2753.60,4583.13,0.00
2024-12-08 14:55:56,454,3652,222,232,2762.92,4583.18,0.00
2024-12-08 14:55:56,455,3651,222,233,2747.29,4583.33,0.00
2024-12-08 14:55:56,454,3651,221,233,2751.98,4583.45,0.00
2024-12-08 14:55:56,455,3650,222,233,2743.64,4583.50,0.00
2024-12-08 14:55:56,456,3649,222,234,2737.36,4583.56,0.00
2024-12-08 14:55:56,457,3648,222,235,2730.06,4583.69,0.00
2024-12-08 14:55:56,457,3649,222,235,2739.33,4584.00,0.00
2024-12-08 14:55:56,458,3649,223,235,2733.35,4584.00,0.00
2024-12-08 14:55:56,457,3649,223,234,2729.19,4584.18,0.00
2024-12-08 14:55:56,458,3648,224,234,2710.13,4584.47,0.00
2024-12-08 14:55:56,459,3647,225,234,2705.44,4584.49,0.00
2024-12-08 14:55:56,459,3648,225,234,2743.98,4585.00,0.00
2024-12-08 14:55:56,460,3648,225,235,2738.01,4585.00,0.00
2024-12-08 14:55:56,459,3648,225,234,2741.89,4585.03,0.00
2024-12-08 14:55:56,459,3649,225,234,2723.89,4586.00,0.00
2024-12-08 14:55:56,460,3649,226,234,2717.97,4586.00,0.00
2024-12-08 14:55:56,461,3648,226,235,2710.40,4586.04,0.00
2024-12-08 14:55:56,462,3647,226,236,2705.04,4586.07,0.00
2024-12-08 14:55:56,463,3646,226,237,2708.02,4586.08,0.00
2024-12-08 14:55:56,462,3646,226,236,2713.64,4586.18,0.00
2024-12-08 14:55:56,461,3646,225,236,2716.83,4586.24,0.00
2024-12-08 14:55:56,462,3645,226,236,2701.90,4586.45,0.00
2024-12-08 14:55:56,463,3644,227,236,2690.39,4586.71,0.00
2024-12-08 14:55:56,463,3645,227,236,2688.98,4587.00,0.00
2024-12-08 14:55:56,464,3645,227,237,2683.18,4587.00,0.00
2024-12-08 14:55:56,463,3645,226,237,2687.50,4587.03,0.00
2024-12-08 14:55:56,462,3645,225,237,2684.66,4587.18,0.00
2024-12-08 14:55:56,461,3645,224,237,2690.29,4587.18,0.00
2024-12-08 14:55:56,462,3644,224,238,2679.82,4587.29,0.00
2024-12-08 14:55:56,463,3643,224,239,2671.44,4587.56,0.00
2024-12-08 14:55:56,462,3643,223,239,2674.00,4587.73,0.00
2024-12-08 14:55:56,461,3643,222,239,2677.62,4587.78,0.00
2024-12-08 14:55:56,462,3642,223,239,2665.30,4587.93,0.00
2024-12-08 14:55:56,462,3643,223,239,2723.51,4588.00,0.00
2024-12-08 14:55:56,463,3643,223,240,2717.62,4588.00,0.00
2024-12-08 14:55:56,462,3643,222,240,2723.41,4588.00,0.00
2024-12-08 14:55:56,461,3643,222,239,2720.43,4588.15,0.00
2024-12-08 14:55:56,460,3643,222,238,2725.07,4588.18,0.00
2024-12-08 14:55:56,459,3643,221,238,2730.90,4588.18,0.00
2024-12-08 14:55:56,458,3643,221,237,2736.77,4588.18,0.00
2024-12-08 14:55:56,457,3643,221,236,2742.66,4588.18,0.00
2024-12-08 14:55:56,456,3643,221,235,2748.57,4588.18,0.00
2024-12-08 14:55:56,457,3642,222,235,2732.39,4588.41,0.00
2024-12-08 14:55:56,458,3641,223,235,2727.01,4588.54,0.00
2024-12-08 14:55:56,459,3640,223,236,2725.28,4588.56,0.00
2024-12-08 14:55:56,460,3639,223,237,2716.67,4588.73,0.00
2024-12-08 14:55:56,461,3638,224,237,2709.84,4588.81,0.00
2024-12-08 14:55:56,461,3639,224,237,2740.77,4589.00,0.00
2024-12-08 14:55:56,462,3639,224,238,2734.84,4589.00,0.00
2024-12-08 14:55:56,461,3639,224,237,2730.71,4589.18,0.00
2024-12-08 14:55:56,460,3639,223,237,2736.54,4589.18,0.00
2024-12-08 14:55:56,461,3638,224,237,2723.98,4589.33,0.00
2024-12-08 14:55:56,462,3637,224,238,2720.09,4589.37,0.00
2024-12-08 14:55:56,463,3636,224,239,2698.19,4589.75,0.00
2024-12-08 14:55:56,463,3637,224,239,2746.76,4590.00,0.00
2024-12-08 14:55:56,464,3637,225,239,2740.84,4590.00,0.00
2024-12-08 14:55:56,463,3637,224,239,2740.17,4590.10,0.00
2024-12-08 14:55:56,462,3637,224,238,2742.66,4590.18,0.00
2024-12-08 14:55:56,461,3637,223,238,2748.51,4590.18,0.00
2024-12-08 14:55:56,460,3637,223,237,2754.29,4590.18,0.00
2024-12-08 14:55:56,461,3636,223,238,2736.17,4590.45,0.00
2024-12-08 14:55:56,462,3635,223,239,2719.42,4590.75,0.00
2024-12-08 14:55:56,462,3636,223,239,2746.96,4591.00,0.00
2024-12-08 14:55:56,463,3636,224,239,2741.03,4591.00,0.00
2024-12-08 14:55:56,464,3635,224,240,2734.04,4591.03,0.00
2024-12-08 14:55:56,463,3635,224,239,2744.81,4591.04,0.00
2024-12-08 14:55:56,464,3634,224,240,2733.71,4591.16,0.00
2024-12-08 14:55:56,463,3634,223,240,2745.67,4591.16,0.00
2024-12-08 14:55:56,462,3634,223,239,2750.72,4591.18,0.00
2024-12-08 14:55:56,461,3634,223,238,2756.59,4591.18,0.00
2024-12-08 14:55:56,462,3633,224,238,2735.96,4591.50,0.00
2024-12-08 14:55:56,463,3632,225,238,2723.29,4591.78,0.00
2024-12-08 14:55:56,463,3633,225,238,2741.32,4592.00,0.00
2024-12-08 14:55:56,464,3633,225,239,2735.42,4592.00,0.00
2024-12-08 14:55:56,463,3633,224,239,2741.03,4592.01,0.00
2024-12-08 14:55:56,464,3632,224,240,2734.63,4592.02,0.00
2024-12-08 14:55:56,465,3631,224,241,2731.23,4592.04,0.00
2024-12-08 14:55:56,464,3631,224,240,2737.22,4592.04,0.00
2024-12-08 14:55:56,465,3630,225,240,2731.04,4592.05,0.00
2024-12-08 14:55:56,464,3630,224,240,2740.70,4592.07,0.00
2024-12-08 14:55:56,465,3629,225,240,2732.17,4592.14,0.00
2024-12-08 14:55:56,466,3628,226,240,2731.54,4592.16,0.00
2024-12-08 14:55:56,465,3628,226,239,2738.91,4592.18,0.00
2024-12-08 14:55:56,464,3628,226,238,2744.71,4592.18,0.00
2024-12-08 14:55:56,463,3628,225,238,2750.25,4592.18,0.00
2024-12-08 14:55:56,464,3627,225,239,2743.24,4592.21,0.00
2024-12-08 14:55:56,465,3626,225,240,2743.39,4592.29,0.00
2024-12-08 14:55:56,464,3626,224,240,2754.07,4592.32,0.00
2024-12-08 14:55:56,464,3627,224,240,2772.84,4593.00,0.00
2024-12-08 14:55:56,465,3627,224,241,2766.87,4593.00,0.00
2024-12-08 14:55:56,466,3626,225,241,2754.78,4593.10,0.00
2024-12-08 14:55:56,465,3626,225,240,2763.27,4593.11,0.00
2024-12-08 14:55:56,464,3626,224,240,2767.96,4593.13,0.00
2024-12-08 14:55:56,465,3625,225,240,2760.93,4593.16,0.00
2024-12-08 14:55:56,464,3625,225,239,2769.17,4593.17,0.00
2024-12-08 14:55:56,463,3625,224,239,2775.05,4593.17,0.00
2024-12-08 14:55:56,462,3625,223,239,2780.86,4593.18,0.00
2024-12-08 14:55:56,463,3624,224,239,2761.69,4593.47,0.00
2024-12-08 14:55:57,463,3625,224,239,2816.75,4594.00,0.00
2024-12-08 14:55:57,464,3625,224,240,2810.68,4594.00,0.00
2024-12-08 14:55:57,465,3624,225,240,2798.26,4594.10,0.00
2024-12-08 14:55:57,466,3623,226,240,2794.66,4594.16,0.00
2024-12-08 14:55:57,465,3623,225,240,2807.00,4594.18,0.00
2024-12-08 14:55:57,464,3623,225,239,2812.95,4594.18,0.00
2024-12-08 14:55:57,463,3623,224,239,2805.63,4594.47,0.00
2024-12-08 14:55:57,464,3622,224,240,2795.48,4594.57,0.00
2024-12-08 14:55:57,465,3621,225,240,2793.92,4594.57,0.00
2024-12-08 14:55:57,466,3620,226,240,2776.70,4594.81,0.00
2024-12-08 14:55:57,467,3619,227,240,2767.99,4594.92,0.00
2024-12-08 14:55:57,467,3620,227,240,2804.27,4595.00,0.00
2024-12-08 14:55:57,468,3620,228,240,2798.28,4595.00,0.00
2024-12-08 14:55:57,469,3619,228,241,2791.44,4595.03,0.00
2024-12-08 14:55:57,470,3618,228,242,2780.31,4595.18,0.00
2024-12-08 14:55:57,471,3617,228,243,2757.08,4595.65,0.00
2024-12-08 14:55:57,470,3617,227,243,2760.28,4595.71,0.00
2024-12-08 14:55:57,471,3616,227,244,2747.90,4595.86,0.00
2024-12-08 14:55:57,471,3617,227,244,2811.15,4596.00,0.00
2024-12-08 14:55:57,472,3617,228,244,2805.19,4596.00,0.00
2024-12-08 14:55:57,471,3617,228,243,2808.44,4596.03,0.00
2024-12-08 14:55:57,470,3617,227,243,2812.67,4596.07,0.00
2024-12-08 14:55:57,471,3616,227,244,2802.75,4596.16,0.00
2024-12-08 14:55:57,470,3616,226,244,2809.50,4596.17,0.00
2024-12-08 14:55:57,469,3616,225,244,2815.30,4596.18,0.00
2024-12-08 14:55:57,470,3615,226,244,2807.17,4596.23,0.00
2024-12-08 14:55:57,471,3614,226,245,2791.20,4596.52,0.00
2024-12-08 14:55:57,472,3613,227,245,2779.55,4596.69,0.00
2024-12-08 14:55:57,473,3612,228,245,2766.71,4596.86,0.00
2024-12-08 14:55:57,473,3613,228,245,2806.48,4597.00,0.00
2024-12-08 14:55:57,474,3613,229,245,2800.56,4597.00,0.00
2024-12-08 14:55:57,473,3613,228,245,2805.80,4597.02,0.00
2024-12-08 14:55:57,472,3613,228,244,2809.42,4597.03,0.00
2024-12-08 14:55:57,471,3613,227,244,2812.49,4597.09,0.00
2024-12-08 14:55:57,470,3613,227,243,2814.90,4597.17,0.00
2024-12-08 14:55:57,471,3612,228,243,2808.25,4597.19,0.00
2024-12-08 14:55:57,472,3611,228,244,2789.25,4597.43,0.00
2024-12-08 14:55:57,473,3610,228,245,2783.02,4597.53,0.00
2024-12-08 14:55:57,474,3609,228,246,2776.35,4597.66,0.00
2024-12-08 14:55:57,474,3610,228,246,2822.32,4598.00,0.00
2024-12-08 14:55:57,475,3610,229,246,2816.37,4598.00,0.00
2024-12-08 14:55:57,474,3610,229,245,2818.65,4598.04,0.00
2024-12-08 14:55:57,473,3610,228,245,2822.98,4598.07,0.00
2024-12-08 14:55:57,472,3610,228,244,2824.53,4598.17,0.00
2024-12-08 14:55:57,471,3610,228,243,2830.33,4598.17,0.00
2024-12-08 14:55:57,472,3609,229,243,2793.00,4598.78,0.00
2024-12-08 14:55:57,473,3608,230,243,2785.51,4598.86,0.00
2024-12-08 14:55:57,473,3609,230,243,2829.19,4599.00,0.00
2024-12-08 14:55:57,474,3609,230,244,2823.22,4599.00,0.00
2024-12-08 14:55:57,475,3608,230,245,2817.28,4599.01,0.00
2024-12-08 14:55:57,476,3607,231,245,2810.54,4599.10,0.00
2024-12-08 14:55:57,477,3606,231,246,2804.30,4599.16,0.00
2024-12-08 14:55:57,478,3605,232,246,2780.96,4599.57,0.00
2024-12-08 14:55:57,479,3604,232,247,2777.28,4599.60,0.00
2024-12-08 14:55:57,480,3603,233,247,2772.97,4599.65,0.00
2024-12-08 14:55:57,481,3602,233,248,2765.38,4599.77,0.00
2024-12-08 14:55:57,482,3601,234,248,2759.68,4599.82,0.00
2024-12-08 14:55:57,482,3602,234,248,2780.55,4600.00,0.00
2024-12-08 14:55:57,483,3602,235,248,2774.79,4600.00,0.00
2024-12-08 14:55:57,482,3602,235,247,2777.32,4600.04,0.00
2024-12-08 14:55:57,483,3601,236,247,2769.97,4600.08,0.00
2024-12-08 14:55:57,482,3601,235,247,2782.04,4600.11,0.00
2024-12-08 14:55:57,481,3601,234,247,2785.28,4600.17,0.00
2024-12-08 14:55:57,480,3601,233,247,2773.37,4600.53,0.00
2024-12-08 14:55:57,481,3600,234,247,2766.47,4600.56,0.00
2024-12-08 14:55:57,482,3599,235,247,2761.45,4600.75,0.00
2024-12-08 14:55:57,483,3598,236,247,2756.70,4600.78,0.00
2024-12-08 14:55:57,483,3599,236,247,2834.52,4601.00,0.00
2024-12-08 14:55:57,484,3599,237,247,2828.66,4601.00,0.00
2024-12-08 14:55:57,483,3599,237,246,2824.90,4601.17,0.00
2024-12-08 14:55:57,482,3599,237,245,2830.66,4601.17,0.00
2024-12-08 14:55:57,483,3598,238,245,2824.52,4601.18,0.00
2024-12-08 14:55:57,484,3597,239,245,2811.44,4601.52,0.00
2024-12-08 14:55:57,485,3596,239,246,2808.05,4601.58,0.00
2024-12-08 14:55:57,486,3595,240,246,2799.42,4601.70,0.00
2024-12-08 14:55:57,486,3596,240,246,2836.22,4602.00,0.00
2024-12-08 14:55:57,487,3596,241,246,2830.39,4602.00,0.00
2024-12-08 14:55:57,488,3595,241,247,2819.35,4602.08,0.00
2024-12-08 14:55:57,487,3595,241,246,2821.70,4602.17,0.00
2024-12-08 14:55:57,488,3594,241,247,2815.64,4602.18,0.00
2024-12-08 14:55:57,489,3593,242,247,2815.18,4602.27,0.00
2024-12-08 14:55:57,490,3592,242,248,2801.73,4602.43,0.00
2024-12-08 14:55:57,491,3591,242,249,2795.67,4602.47,0.00
2024-12-08 14:55:57,491,3592,242,249,2822.02,4603.00,0.00
2024-12-08 14:55:57,492,3592,243,249,2816.29,4603.00,0.00
2024-12-08 14:55:57,493,3591,244,249,2809.10,4603.04,0.00
2024-12-08 14:55:57,494,3590,244,250,2798.73,4603.16,0.00
2024-12-08 14:55:57,493,3590,243,250,2805.82,4603.18,0.00
2024-12-08 14:55:57,492,3590,242,250,2811.43,4603.18,0.00
2024-12-08 14:55:57,491,3590,241,250,2806.51,4603.40,0.00
2024-12-08 14:55:57,492,3589,242,250,2799.61,4603.43,0.00
2024-12-08 14:55:57,493,3588,243,250,2792.71,4603.59,0.00
2024-12-08 14:55:58,493,3589,243,250,2834.02,4604.00,0.00
2024-12-08 14:55:58,494,3589,244,250,2828.29,4604.00,0.00
2024-12-08 14:55:58,495,3588,245,250,2822.11,4604.02,0.00
2024-12-08 14:55:58,494,3588,245,249,2821.77,4604.19,0.00
2024-12-08 14:55:58,495,3587,245,250,2811.64,4604.29,0.00
2024-12-08 14:55:58,496,3586,246,250,2801.94,4604.41,0.00
2024-12-08 14:55:58,495,3586,245,250,2793.03,4604.76,0.00
2024-12-08 14:55:58,495,3587,245,250,2825.05,4605.00,0.00
2024-12-08 14:55:58,496,3587,246,250,2819.35,4605.00,0.00
2024-12-08 14:55:58,495,3587,246,249,2823.21,4605.04,0.00
2024-12-08 14:55:58,496,3586,246,250,2815.95,4605.08,0.00
2024-12-08 14:55:58,497,3585,247,250,2799.27,4605.33,0.00
2024-12-08 14:55:58,498,3584,248,250,2796.89,4605.33,0.00
2024-12-08 14:55:58,499,3583,249,250,2795.63,4605.34,0.00
2024-12-08 14:55:58,499,3584,249,250,2800.80,4606.00,0.00
2024-12-08 14:55:58,500,3584,249,251,2795.19,4606.00,0.00
2024-12-08 14:55:58,499,3584,249,250,2790.65,4606.18,0.00
2024-12-08 14:55:58,498,3584,249,249,2796.16,4606.18,0.00
2024-12-08 14:55:58,497,3584,249,248,2801.69,4606.18,0.00
2024-12-08 14:55:58,498,3583,250,248,2780.86,4606.52,0.00
2024-12-08 14:55:58,499,3582,250,249,2773.35,4606.67,0.00
2024-12-08 14:55:58,500,3581,251,249,2769.76,4606.70,0.00
2024-12-08 14:55:58,500,3582,251,249,2802.97,4607.00,0.00
2024-12-08 14:55:58,501,3582,252,249,2797.38,4607.00,0.00
2024-12-08 14:55:58,500,3582,252,248,2798.85,4607.05,0.00
2024-12-08 14:55:58,501,3581,252,249,2790.08,4607.12,0.00
2024-12-08 14:55:58,500,3581,252,248,2794.13,4607.18,0.00
2024-12-08 14:55:58,499,3581,251,248,2799.64,4607.18,0.00
2024-12-08 14:55:58,498,3581,251,247,2805.17,4607.18,0.00
2024-12-08 14:55:58,499,3580,252,247,2798.81,4607.20,0.00
2024-12-08 14:55:58,500,3579,253,247,2787.10,4607.53,0.00
2024-12-08 14:55:58,501,3578,254,247,2769.48,4607.90,0.00
2024-12-08 14:55:58,501,3579,254,247,2799.38,4608.00,0.00
2024-12-08 14:55:58,502,3579,255,247,2793.80,4608.00,0.00
2024-12-08 14:55:58,501,3579,254,247,2799.11,4608.01,0.00
2024-12-08 14:55:58,500,3579,254,246,2801.68,4608.04,0.00
2024-12-08 14:55:58,501,3578,255,246,2791.73,4608.14,0.00
2024-12-08 14:55:58,500,3578,254,246,2804.16,4608.18,0.00
2024-12-08 14:55:58,499,3578,254,245,2809.68,4608.18,0.00
2024-12-08 14:55:58,498,3578,253,245,2815.14,4608.19,0.00
2024-12-08 14:55:58,499,3577,253,246,2785.12,4608.72,0.00
2024-12-08 14:55:58,500,3576,253,247,2778.32,4608.81,0.00
2024-12-08 14:55:58,500,3577,253,247,2813.79,4609.00,0.00
2024-12-08 14:55:58,501,3577,253,248,2808.17,4609.00,0.00
2024-12-08 14:55:58,502,3576,254,248,2795.25,4609.05,0.00
2024-12-08 14:55:58,503,3575,255,248,2793.02,4609.10,0.00
2024-12-08 14:55:58,504,3574,255,249,2788.85,4609.10,0.00
2024-12-08 14:55:58,503,3574,255,248,2797.38,4609.19,0.00
2024-12-08 14:55:58,504,3573,255,249,2781.59,4609.42,0.00
2024-12-08 14:55:58,504,3574,255,249,2797.46,4610.00,0.00
2024-12-08 14:55:58,505,3574,256,249,2791.92,4610.00,0.00
2024-12-08 14:55:58,504,3574,255,249,2794.91,4610.02,0.00
2024-12-08 14:55:58,503,3574,255,248,2799.19,4610.04,0.00
2024-12-08 14:55:58,502,3574,254,248,2800.87,4610.12,0.00
2024-12-08 14:55:58,503,3573,254,249,2793.85,4610.16,0.00
2024-12-08 14:55:58,502,3573,253,249,2802.92,4610.18,0.00
2024-12-08 14:55:58,501,3573,252,249,2808.43,4610.18,0.00
2024-12-08 14:55:58,502,3572,252,250,2784.02,4610.60,0.00
2024-12-08 14:55:58,503,3571,252,251,2775.92,4610.74,0.00
2024-12-08 14:55:58,503,3572,252,251,2812.52,4611.00,0.00
2024-12-08 14:55:58,504,3572,253,251,2806.94,4611.00,0.00
2024-12-08 14:55:58,503,3572,252,251,2804.35,4611.14,0.00
2024-12-08 14:55:58,504,3571,253,251,2797.43,4611.17,0.00
2024-12-08 14:55:58,503,3571,253,250,2805.29,4611.18,0.00
2024-12-08 14:55:58,504,3570,253,251,2785.04,4611.51,0.00
2024-12-08 14:55:58,505,3569,254,251,2771.40,4611.79,0.00
2024-12-08 14:55:58,505,3570,254,251,2799.16,4612.00,0.00
2024-12-08 14:55:58,506,3570,254,252,2793.62,4612.00,0.00
2024-12-08 14:55:58,505,3570,253,252,2798.89,4612.01,0.00
2024-12-08 14:55:58,506,3569,254,252,2790.09,4612.04,0.00
2024-12-08 14:55:58,507,3568,255,252,2790.06,4612.07,0.00
2024-12-08 14:55:58,508,3567,255,253,2783.17,4612.17,0.00
2024-12-08 14:55:58,509,3566,255,254,2781.00,4612.27,0.00
2024-12-08 14:55:58,510,3565,255,255,2770.02,4612.45,0.00
2024-12-08 14:55:58,511,3564,255,256,2761.52,4612.59,0.00
2024-12-08 14:55:58,512,3563,256,256,2760.18,4612.59,0.00
2024-12-08 14:55:58,513,3562,257,256,2754.29,4612.64,0.00
2024-12-08 14:55:58,514,3561,257,257,2743.87,4612.83,0.00
2024-12-08 14:55:58,515,3560,258,257,2739.89,4612.84,0.00
2024-12-08 14:55:58,515,3561,258,257,2767.80,4613.00,0.00
2024-12-08 14:55:58,516,3561,259,257,2762.43,4613.00,0.00
2024-12-08 14:55:58,517,3560,260,257,2751.60,4613.09,0.00
2024-12-08 14:55:58,516,3560,260,256,2759.14,4613.18,0.00
2024-12-08 14:55:58,515,3560,259,256,2764.41,4613.19,0.00
2024-12-08 14:55:58,514,3560,258,256,2769.70,4613.19,0.00
2024-12-08 14:55:58,515,3559,258,257,2747.47,4613.56,0.00
2024-12-08 14:55:58,516,3558,259,257,2741.05,4613.68,0.00
2024-12-08 14:55:58,517,3557,259,258,2742.55,4613.71,0.00
2024-12-08 14:55:58,518,3556,259,259,2737.26,4613.72,0.00
2024-12-08 14:55:58,519,3555,260,259,2731.66,4613.86,0.00
2024-12-08 14:55:58,519,3556,260,259,2821.04,4614.00,0.00
2024-12-08 14:55:58,520,3556,261,259,2815.62,4614.00,0.00
2024-12-08 14:55:58,521,3555,261,260,2808.99,4614.03,0.00
2024-12-08 14:55:58,520,3555,261,259,2821.94,4614.04,0.00
2024-12-08 14:55:58,519,3555,261,258,2820.62,4614.18,0.00
2024-12-08 14:55:58,518,3555,261,257,2825.97,4614.18,0.00
2024-12-08 14:55:58,517,3555,261,256,2831.35,4614.18,0.00
2024-12-08 14:55:58,518,3554,261,257,2822.08,4614.27,0.00
2024-12-08 14:55:58,519,3553,261,258,2814.44,4614.34,0.00
2024-12-08 14:55:58,520,3552,262,258,2809.48,4614.35,0.00
2024-12-08 14:55:58,519,3552,261,258,2817.43,4614.43,0.00
2024-12-08 14:55:58,518,3552,260,258,2822.42,4614.44,0.00
2024-12-08 14:55:59,519,3551,260,259,2814.44,4614.50,0.00
2024-12-08 14:55:59,520,3550,260,260,2800.53,4614.79,0.00
2024-12-08 14:55:59,521,3549,260,261,2795.10,4614.84,0.00
2024-12-08 14:55:59,521,3550,260,261,2847.50,4615.00,0.00
2024-12-08 14:55:59,522,3550,260,262,2842.04,4615.00,0.00
2024-12-08 14:55:59,521,3550,260,261,2844.77,4615.04,0.00
2024-12-08 14:55:59,522,3549,261,261,2836.62,4615.10,0.00
2024-12-08 14:55:59,523,3548,261,262,2835.35,4615.12,0.00
2024-12-08 14:55:59,522,3548,261,261,2843.74,4615.18,0.00
2024-12-08 14:55:59,523,3547,261,262,2825.27,4615.47,0.00
2024-12-08 14:55:59,522,3547,260,262,2827.50,4615.61,0.00
2024-12-08 14:55:59,522,3548,260,262,2880.41,4616.00,0.00
2024-12-08 14:55:59,523,3548,261,262,2874.91,4616.00,0.00
2024-12-08 14:55:59,522,3548,260,262,2870.35,4616.18,0.00
2024-12-08 14:55:59,521,3548,260,261,2875.77,4616.18,0.00
2024-12-08 14:55:59,522,3547,260,262,2858.34,4616.45,0.00
2024-12-08 14:55:59,523,3546,261,262,2851.11,4616.60,0.00
2024-12-08 14:55:59,524,3545,262,262,2841.53,4616.74,0.00
2024-12-08 14:55:59,524,3546,262,262,2863.33,4617.00,0.00
2024-12-08 14:55:59,525,3546,262,263,2857.87,4617.00,0.00
2024-12-08 14:55:59,526,3545,263,263,2839.48,4617.25,0.00
2024-12-08 14:55:59,527,3544,264,263,2816.87,4617.65,0.00
2024-12-08 14:55:59,528,3543,265,263,2809.95,4617.76,0.00
2024-12-08 14:55:59,528,3544,265,263,2833.00,4618.00,0.00
2024-12-08 14:55:59,529,3544,266,263,2827.65,4618.00,0.00
2024-12-08 14:55:59,530,3543,267,263,2821.19,4618.03,0.00
2024-12-08 14:55:59,529,3543,267,262,2825.49,4618.04,0.00
2024-12-08 14:55:59,528,3543,267,261,2829.54,4618.07,0.00
2024-12-08 14:55:59,527,3543,266,261,2829.63,4618.18,0.00
2024-12-08 14:55:59,526,3543,265,261,2834.92,4618.18,0.00
2024-12-08 14:55:59,525,3543,265,260,2840.23,4618.18,0.00
2024-12-08 14:55:59,526,3542,266,260,2819.10,4618.53,0.00
2024-12-08 14:55:59,527,3541,266,261,2808.82,4618.65,0.00
2024-12-08 14:55:59,527,3542,266,261,2827.68,4619.00,0.00
2024-12-08 14:55:59,528,3542,266,262,2822.33,4619.00,0.00
2024-12-08 14:55:59,527,3542,266,261,2820.96,4619.04,0.00
2024-12-08 14:55:59,526,3542,265,261,2825.11,4619.07,0.00
2024-12-08 14:55:59,525,3542,264,261,2829.20,4619.10,0.00
2024-12-08 14:55:59,524,3542,264,260,2830.77,4619.18,0.00
2024-12-08 14:55:59,523,3542,263,260,2836.01,4619.18,0.00
2024-12-08 14:55:59,522,3542,262,260,2830.21,4619.43,0.00
2024-12-08 14:55:59,523,3541,263,260,2821.22,4619.51,0.00
2024-12-08 14:55:59,524,3540,264,260,2799.87,4619.87,0.00
2024-12-08 14:55:59,524,3541,264,260,2830.40,4620.00,0.00
2024-12-08 14:55:59,525,3541,265,260,2825.01,4620.00,0.00
2024-12-08 14:55:59,524,3541,265,259,2826.72,4620.04,0.00
2024-12-08 14:55:59,523,3541,265,258,2827.85,4620.13,0.00
2024-12-08 14:55:59,522,3541,265,257,2831.26,4620.18,0.00
2024-12-08 14:55:59,521,3541,264,257,2836.60,4620.18,0.00
2024-12-08 14:55:59,522,3540,264,258,2823.61,4620.35,0.00
2024-12-08 14:55:59,523,3539,264,259,2812.39,4620.52,0.00
2024-12-08 14:55:59,522,3539,263,259,2818.15,4620.55,0.00
2024-12-08 14:55:59,522,3540,263,259,2824.24,4621.00,0.00
2024-12-08 14:55:59,523,3540,264,259,2818.84,4621.00,0.00
2024-12-08 14:55:59,522,3540,264,258,2817.49,4621.11,0.00
2024-12-08 14:55:59,521,3540,264,257,2819.74,4621.18,0.00
2024-12-08 14:55:59,522,3539,265,257,2808.19,4621.31,0.00
2024-12-08 14:55:59,523,3538,265,258,2806.44,4621.32,0.00
2024-12-08 14:55:59,524,3537,266,258,2796.80,4621.54,0.00
2024-12-08 14:55:59,525,3536,266,259,2787.42,4621.67,0.00
2024-12-08 14:55:59,526,3535,266,260,2773.62,4621.93,0.00
2024-12-08 14:55:59,526,3536,266,260,2797.32,4622.00,0.00
2024-12-08 14:55:59,527,3536,267,260,2792.01,4622.00,0.00
2024-12-08 14:55:59,526,3536,266,260,2796.54,4622.02,0.00
2024-12-08 14:55:59,527,3535,267,260,2787.23,4622.07,0.00
2024-12-08 14:55:59,528,3534,268,260,2781.96,4622.09,0.00
2024-12-08 14:55:59,527,3534,268,259,2786.76,4622.18,0.00
2024-12-08 14:55:59,526,3534,268,258,2791.97,4622.18,0.00
2024-12-08 14:55:59,527,3533,269,258,2780.06,4622.33,0.00
2024-12-08 14:55:59,528,3532,270,258,2774.18,4622.49,0.00
2024-12-08 14:55:59,528,3533,270,258,2806.59,4623.00,0.00
2024-12-08 14:55:59,529,3533,271,258,2801.28,4623.00,0.00
2024-12-08 14:55:59,530,3532,272,258,2794.71,4623.03,0.00
2024-12-08 14:55:59,531,3531,272,259,2790.23,4623.05,0.00
2024-12-08 14:55:59,532,3530,272,260,2785.91,4623.13,0.00
2024-12-08 14:55:59,533,3529,272,261,2785.63,4623.14,0.00
2024-12-08 14:55:59,532,3529,271,261,2792.45,4623.18,0.00
2024-12-08 14:55:59,531,3529,270,261,2797.62,4623.18,0.00
2024-12-08 14:55:59,530,3529,269,261,2802.73,4623.18,0.00
2024-12-08 14:55:59,529,3529,268,261,2807.94,4623.18,0.00
2024-12-08 14:55:59,530,3528,268,262,2782.10,4623.64,0.00
2024-12-08 14:55:59,531,3527,269,262,2777.56,4623.64,0.00
2024-12-08 14:55:59,532,3526,269,263,2770.34,4623.76,0.00
2024-12-08 14:55:59,531,3526,268,263,2775.16,4623.82,0.00
2024-12-08 14:55:59,531,3527,268,263,2807.16,4624.00,0.00
2024-12-08 14:55:59,532,3527,269,263,2801.88,4624.00,0.00
2024-12-08 14:55:59,531,3527,268,263,2805.61,4624.03,0.00
2024-12-08 14:55:59,530,3527,268,262,2809.08,4624.04,0.00
2024-12-08 14:55:59,531,3526,269,262,2803.70,4624.05,0.00
2024-12-08 14:55:59,530,3526,268,262,2813.37,4624.07,0.00
2024-12-08 14:55:59,529,3526,268,261,2813.94,4624.17,0.00
2024-12-08 14:55:59,528,3526,268,260,2819.18,4624.17,0.00
2024-12-08 14:55:59,527,3526,268,259,2824.44,4624.18,0.00
2024-12-08 14:55:59,528,3525,268,260,2800.54,4624.58,0.00
2024-12-08 14:55:59,529,3524,268,261,2796.08,4624.65,0.00
2024-12-08 14:55:59,530,3523,269,261,2793.60,4624.66,0.00
2024-12-08 14:55:59,530,3524,269,261,2847.45,4625.00,0.00
2024-12-08 14:56:00,531,3524,270,261,2842.09,4625.00,0.00
2024-12-08 14:56:00,530,3524,270,260,2839.95,4625.10,0.00
2024-12-08 14:56:00,531,3523,270,261,2832.36,4625.16,0.00
2024-12-08 14:56:00,530,3523,270,260,2838.68,4625.18,0.00
2024-12-08 14:56:00,529,3523,270,259,2843.87,4625.18,0.00
2024-12-08 14:56:00,530,3522,270,260,2838.33,4625.19,0.00
2024-12-08 14:56:00,531,3521,270,261,2809.24,4625.74,0.00
2024-12-08 14:56:00,532,3520,271,261,2796.06,4625.97,0.00
2024-12-08 14:56:00,532,3521,271,261,2838.34,4626.00,0.00
2024-12-08 14:56:00,533,3521,271,262,2833.02,4626.00,0.00
2024-12-08 14:56:00,534,3520,271,263,2820.17,4626.13,0.00
2024-12-08 14:56:00,533,3520,271,262,2824.53,4626.18,0.00
2024-12-08 14:56:00,532,3520,270,262,2829.66,4626.18,0.00
2024-12-08 14:56:00,533,3519,270,263,2820.56,4626.27,0.00
2024-12-08 14:56:00,534,3518,270,264,2815.94,4626.38,0.00
2024-12-08 14:56:00,533,3518,269,264,2805.88,4626.75,0.00
2024-12-08 14:56:00,534,3517,270,264,2796.62,4626.85,0.00
2024-12-08 14:56:00,535,3516,271,264,2786.93,4626.97,0.00
2024-12-08 14:56:00,535,3517,271,264,2827.34,4627.00,0.00
2024-12-08 14:56:00,536,3517,272,264,2822.07,4627.00,0.00
2024-12-08 14:56:00,537,3516,272,265,2799.05,4627.36,0.00
2024-12-08 14:56:00,538,3515,272,266,2795.83,4627.37,0.00
2024-12-08 14:56:00,539,3514,272,267,2792.22,4627.43,0.00
2024-12-08 14:56:00,540,3513,273,267,2784.16,4627.62,0.00
2024-12-08 14:56:00,540,3514,273,267,2818.47,4628.00,0.00
2024-12-08 14:56:00,541,3514,274,267,2813.26,4628.00,0.00
2024-12-08 14:56:00,540,3514,274,266,2815.15,4628.04,0.00
2024-12-08 14:56:00,539,3514,273,266,2815.28,4628.15,0.00
2024-12-08 14:56:00,540,3513,273,267,2809.98,4628.16,0.00
2024-12-08 14:56:00,539,3513,273,266,2818.22,4628.18,0.00
2024-12-08 14:56:00,540,3512,274,266,2805.60,4628.35,0.00
2024-12-08 14:56:00,541,3511,274,267,2783.47,4628.77,0.00
2024-12-08 14:56:00,540,3511,273,267,2778.17,4628.97,0.00
2024-12-08 14:56:00,540,3512,273,267,2819.77,4629.00,0.00
2024-12-08 14:56:00,541,3512,274,267,2814.55,4629.00,0.00
2024-12-08 14:56:00,542,3511,275,267,2779.01,4629.63,0.00
2024-12-08 14:56:00,543,3510,276,267,2764.39,4629.92,0.00
2024-12-08 14:56:00,543,3511,276,267,2794.67,4630.00,0.00
2024-12-08 14:56:00,544,3511,276,268,2789.53,4630.00,0.00
2024-12-08 14:56:00,543,3511,275,268,2788.16,4630.11,0.00
2024-12-08 14:56:00,542,3511,275,267,2789.59,4630.19,0.00
2024-12-08 14:56:00,541,3511,275,266,2794.66,4630.19,0.00
2024-12-08 14:56:00,540,3511,275,265,2799.75,4630.19,0.00
2024-12-08 14:56:00,541,3510,275,266,2784.90,4630.40,0.00
2024-12-08 14:56:00,540,3510,274,266,2790.09,4630.46,0.00
2024-12-08 14:56:00,541,3509,274,267,2777.66,4630.62,0.00
2024-12-08 14:56:00,542,3508,274,268,2768.46,4630.79,0.00
2024-12-08 14:56:00,543,3507,274,269,2765.63,4630.86,0.00
2024-12-08 14:56:00,543,3508,274,269,2784.95,4631.00,0.00
2024-12-08 14:56:00,544,3508,275,269,2779.83,4631.00,0.00
2024-12-08 14:56:00,545,3507,276,269,2769.00,4631.09,0.00
2024-12-08 14:56:00,544,3507,275,269,2774.71,4631.14,0.00
2024-12-08 14:56:00,545,3506,276,269,2768.69,4631.16,0.00
2024-12-08 14:56:00,544,3506,275,269,2776.18,4631.19,0.00
2024-12-08 14:56:00,543,3506,274,269,2781.21,4631.19,0.00
2024-12-08 14:56:00,544,3505,275,269,2755.96,4631.63,0.00
2024-12-08 14:56:00,545,3504,276,269,2738.27,4631.98,0.00
2024-12-08 14:56:00,545,3505,276,269,2778.10,4632.00,0.00
2024-12-08 14:56:00,546,3505,276,270,2773.01,4632.00,0.00
2024-12-08 14:56:00,547,3504,276,271,2758.46,4632.18,0.00
2024-12-08 14:56:00,546,3504,276,270,2764.29,4632.19,0.00
2024-12-08 14:56:00,545,3504,276,269,2769.27,4632.19,0.00
2024-12-08 14:56:00,544,3504,276,268,2774.19,4632.19,0.00
2024-12-08 14:56:00,545,3503,276,269,2766.99,4632.24,0.00
2024-12-08 14:56:00,546,3502,276,270,2763.13,4632.27,0.00
2024-12-08 14:56:00,547,3501,276,271,2754.88,4632.50,0.00
2024-12-08 14:56:00,548,3500,277,271,2746.80,4632.63,0.00
2024-12-08 14:56:00,548,3501,277,271,2772.14,4633.00,0.00
2024-12-08 14:56:00,549,3501,278,271,2767.09,4633.00,0.00
2024-12-08 14:56:00,548,3501,278,270,2769.37,4633.04,0.00
2024-12-08 14:56:00,547,3501,278,269,2774.02,4633.05,0.00
2024-12-08 14:56:00,546,3501,277,269,2772.63,4633.19,0.00
2024-12-08 14:56:00,545,3501,276,269,2777.64,4633.19,0.00
2024-12-08 14:56:00,546,3500,277,269,2771.87,4633.21,0.00
2024-12-08 14:56:00,547,3499,277,270,2770.11,4633.21,0.00
2024-12-08 14:56:00,548,3498,278,270,2771.67,4633.25,0.00
2024-12-08 14:56:00,549,3497,278,271,2755.85,4633.65,0.00
2024-12-08 14:56:00,550,3496,279,271,2751.88,4633.70,0.00
2024-12-08 14:56:00,551,3495,280,271,2747.93,4633.74,0.00
2024-12-08 14:56:00,552,3494,280,272,2739.90,4633.81,0.00
2024-12-08 14:56:00,553,3493,281,272,2736.46,4633.82,0.00
2024-12-08 14:56:00,554,3492,281,273,2729.50,4633.90,0.00
2024-12-08 14:56:00,554,3493,281,273,2772.49,4634.00,0.00
2024-12-08 14:56:00,555,3493,281,274,2767.49,4634.00,0.00
2024-12-08 14:56:00,554,3493,281,273,2768.58,4634.05,0.00
2024-12-08 14:56:00,555,3492,281,274,2761.28,4634.10,0.00
2024-12-08 14:56:00,554,3492,281,273,2764.22,4634.19,0.00
2024-12-08 14:56:00,555,3491,282,273,2753.12,4634.32,0.00
2024-12-08 14:56:00,556,3490,282,274,2729.42,4634.79,0.00
2024-12-08 14:56:00,556,3491,282,274,2804.87,4635.00,0.00
2024-12-08 14:56:00,557,3491,282,275,2799.83,4635.00,0.00
2024-12-08 14:56:00,556,3491,281,275,2804.37,4635.01,0.00
2024-12-08 14:56:00,557,3490,281,276,2799.34,4635.01,0.00
2024-12-08 14:56:00,558,3489,282,276,2788.42,4635.18,0.00
2024-12-08 14:56:00,557,3489,282,275,2798.26,4635.19,0.00
2024-12-08 14:56:00,556,3489,281,275,2803.21,4635.19,0.00
2024-12-08 14:56:00,555,3489,281,274,2808.18,4635.19,0.00
2024-12-08 14:56:00,556,3488,281,275,2770.74,4635.84,0.00
2024-12-08 14:56:00,557,3487,281,276,2767.02,4635.85,0.00
2024-12-08 14:56:00,558,3486,281,277,2760.30,4635.92,0.00
2024-12-08 14:56:01,558,3487,281,277,2790.44,4636.00,0.00
2024-12-08 14:56:01,559,3487,282,277,2785.45,4636.00,0.00
2024-12-08 14:56:01,558,3487,282,276,2787.22,4636.04,0.00
2024-12-08 14:56:01,559,3486,282,277,2764.83,4636.42,0.00
2024-12-08 14:56:01,560,3485,283,277,2765.27,4636.42,0.00
2024-12-08 14:56:01,559,3485,282,277,2764.93,4636.61,0.00
2024-12-08 14:56:01,560,3484,282,278,2750.29,4636.83,0.00
2024-12-08 14:56:01,561,3483,283,278,2745.66,4636.86,0.00
2024-12-08 14:56:01,561,3484,283,278,2789.92,4637.00,0.00
2024-12-08 14:56:01,562,3484,283,279,2784.96,4637.00,0.00
2024-12-08 14:56:01,563,3483,284,279,2772.91,4637.13,0.00
2024-12-08 14:56:01,562,3483,284,278,2781.09,4637.19,0.00
2024-12-08 14:56:01,563,3482,285,278,2745.89,4637.80,0.00
2024-12-08 14:56:01,564,3481,286,278,2740.73,4637.85,0.00
2024-12-08 14:56:01,564,3482,286,278,2776.14,4638.00,0.00
2024-12-08 14:56:01,565,3482,287,278,2771.23,4638.00,0.00
2024-12-08 14:56:01,566,3481,287,279,2761.45,4638.08,0.00
2024-12-08 14:56:01,565,3481,287,278,2766.71,4638.14,0.00
2024-12-08 14:56:01,566,3480,287,279,2761.33,4638.15,0.00
2024-12-08 14:56:01,567,3479,287,280,2755.98,4638.19,0.00
2024-12-08 14:56:01,566,3479,286,280,2765.86,4638.19,0.00
2024-12-08 14:56:01,567,3478,286,281,2757.33,4638.28,0.00
2024-12-08 14:56:01,568,3477,286,282,2751.12,4638.35,0.00
2024-12-08 14:56:01,569,3476,287,282,2749.80,4638.40,0.00
2024-12-08 14:56:01,568,3476,286,282,2753.38,4638.47,0.00
2024-12-08 14:56:01,567,3476,285,282,2754.77,4638.52,0.00
2024-12-08 14:56:01,568,3475,285,283,2749.92,4638.52,0.00
2024-12-08 14:56:01,569,3474,285,284,2742.49,4638.67,0.00
2024-12-08 14:56:01,569,3475,285,284,2763.14,4639.00,0.00
2024-12-08 14:56:01,570,3475,286,284,2758.29,4639.00,0.00
2024-12-08 14:56:01,571,3474,286,285,2752.73,4639.02,0.00
2024-12-08 14:56:01,570,3474,286,284,2763.19,4639.04,0.00
2024-12-08 14:56:01,571,3473,286,285,2756.26,4639.09,0.00
2024-12-08 14:56:01,572,3472,287,285,2751.18,4639.20,0.00
2024-12-08 14:56:01,571,3472,286,285,2748.14,4639.46,0.00
2024-12-08 14:56:01,572,3471,286,286,2733.49,4639.68,0.00
2024-12-08 14:56:01,573,3470,286,287,2728.97,4639.69,0.00
2024-12-08 14:56:01,574,3469,286,288,2725.69,4639.72,0.00
2024-12-08 14:56:01,575,3468,286,289,2723.29,4639.72,0.00
2024-12-08 14:56:01,575,3469,286,289,2782.34,4640.00,0.00
2024-12-08 14:56:01,576,3469,287,289,2777.51,4640.00,0.00
2024-12-08 14:56:01,577,3468,287,290,2771.51,4640.03,0.00
2024-12-08 14:56:01,578,3467,288,290,2765.13,4640.08,0.00
2024-12-08 14:56:01,579,3466,288,291,2760.62,4640.13,0.00
2024-12-08 14:56:01,578,3466,288,290,2768.56,4640.19,0.00
2024-12-08 14:56:01,577,3466,288,289,2773.20,4640.19,0.00
2024-12-08 14:56:01,578,3465,289,289,2750.99,4640.58,0.00
2024-12-08 14:56:01,579,3464,289,290,2742.03,4640.75,0.00
2024-12-08 14:56:01,579,3465,289,290,2796.94,4641.00,0.00
2024-12-08 14:56:01,580,3465,290,290,2792.12,4641.00,0.00
2024-12-08 14:56:01,579,3465,290,289,2794.32,4641.04,0.00
2024-12-08 14:56:01,578,3465,289,289,2793.67,4641.16,0.00
2024-12-08 14:56:01,577,3465,289,288,2796.93,4641.19,0.00
2024-12-08 14:56:01,576,3465,289,287,2801.70,4641.19,0.00
2024-12-08 14:56:01,577,3464,289,288,2793.57,4641.27,0.00
2024-12-08 14:56:01,578,3463,290,288,2785.36,4641.45,0.00
2024-12-08 14:56:01,579,3462,291,288,2777.98,4641.58,0.00
2024-12-08 14:56:01,580,3461,292,288,2771.17,4641.67,0.00
2024-12-08 14:56:01,581,3460,292,289,2768.41,4641.69,0.00
2024-12-08 14:56:01,581,3461,292,289,2801.74,4642.00,0.00
2024-12-08 14:56:01,582,3461,292,290,2796.92,4642.00,0.00
2024-12-08 14:56:01,583,3460,293,290,2788.72,4642.04,0.00
2024-12-08 14:56:01,584,3459,294,290,2785.24,4642.08,0.00
2024-12-08 14:56:01,583,3459,294,289,2790.64,4642.19,0.00
2024-12-08 14:56:01,584,3458,294,290,2778.21,4642.36,0.00
2024-12-08 14:56:01,583,3458,293,290,2770.61,4642.77,0.00
2024-12-08 14:56:01,584,3457,294,290,2763.99,4642.81,0.00
2024-12-08 14:56:01,585,3456,295,290,2753.22,4642.89,0.00
2024-12-08 14:56:01,585,3457,295,290,2796.50,4643.00,0.00
2024-12-08 14:56:01,586,3457,295,291,2791.72,4643.00,0.00
2024-12-08 14:56:01,587,3456,296,291,2786.73,4643.01,0.00
2024-12-08 14:56:01,586,3456,296,290,2793.01,4643.04,0.00
2024-12-08 14:56:01,587,3455,296,291,2772.35,4643.39,0.00
2024-12-08 14:56:01,588,3454,297,291,2765.63,4643.50,0.00
2024-12-08 14:56:01,589,3453,297,292,2759.01,4643.58,0.00
2024-12-08 14:56:01,588,3453,296,292,2766.25,4643.60,0.00
2024-12-08 14:56:01,589,3452,296,293,2757.90,4643.69,0.00
2024-12-08 14:56:01,590,3451,297,293,2754.74,4643.71,0.00
2024-12-08 14:56:01,589,3451,296,293,2754.60,4643.80,0.00
2024-12-08 14:56:01,589,3452,296,293,2792.84,4644.00,0.00
2024-12-08 14:56:01,590,3452,296,294,2788.11,4644.00,0.00
2024-12-08 14:56:01,589,3452,295,294,2792.22,4644.01,0.00
2024-12-08 14:56:01,588,3452,295,293,2787.35,4644.19,0.00
2024-12-08 14:56:01,587,3452,294,293,2791.94,4644.19,0.00
2024-12-08 14:56:01,588,3451,294,294,2779.67,4644.36,0.00
2024-12-08 14:56:01,589,3450,294,295,2775.67,4644.39,0.00
2024-12-08 14:56:01,590,3449,295,295,2775.54,4644.41,0.00
2024-12-08 14:56:01,589,3449,294,295,2781.31,4644.47,0.00
2024-12-08 14:56:01,589,3450,294,295,2811.46,4645.00,0.00
2024-12-08 14:56:01,590,3450,295,295,2806.70,4645.00,0.00
2024-12-08 14:56:01,589,3450,295,294,2803.57,4645.14,0.00
2024-12-08 14:56:01,590,3449,295,295,2796.95,4645.18,0.00
2024-12-08 14:56:01,589,3449,295,294,2801.63,4645.19,0.00
2024-12-08 14:56:01,590,3448,295,295,2778.94,4645.58,0.00
2024-12-08 14:56:01,591,3447,295,296,2766.48,4645.83,0.00
2024-12-08 14:56:02,591,3448,295,296,2790.73,4646.00,0.00
2024-12-08 14:56:02,592,3448,296,296,2786.01,4646.00,0.00
2024-12-08 14:56:02,591,3448,295,296,2785.58,4646.08,0.00
2024-12-08 14:56:02,592,3447,295,297,2779.09,4646.12,0.00
2024-12-08 14:56:02,591,3447,294,297,2783.02,4646.14,0.00
2024-12-08 14:56:02,590,3447,293,297,2785.32,4646.20,0.00
2024-12-08 14:56:02,589,3447,293,296,2789.90,4646.20,0.00
2024-12-08 14:56:02,588,3447,292,296,2794.56,4646.20,0.00
2024-12-08 14:56:02,587,3447,291,296,2799.24,4646.20,0.00
2024-12-08 14:56:02,586,3447,290,296,2803.94,4646.20,0.00
2024-12-08 14:56:02,587,3446,291,296,2783.71,4646.54,0.00
2024-12-08 14:56:02,588,3445,291,297,2772.19,4646.78,0.00
2024-12-08 14:56:02,589,3444,291,298,2766.87,4646.80,0.00
2024-12-08 14:56:02,590,3443,292,298,2760.73,4646.88,0.00
2024-12-08 14:56:02,590,3444,292,298,2786.03,4647.00,0.00
2024-12-08 14:56:02,591,3444,292,299,2781.32,4647.00,0.00
2024-12-08 14:56:02,592,3443,292,300,2773.27,4647.04,0.00
2024-12-08 14:56:02,593,3442,293,300,2769.93,4647.10,0.00
2024-12-08 14:56:02,592,3442,293,299,2775.47,4647.12,0.00
2024-12-08 14:56:02,591,3442,293,298,2776.36,4647.20,0.00
2024-12-08 14:56:02,590,3442,292,298,2780.99,4647.20,0.00
2024-12-08 14:56:02,591,3441,292,299,2752.64,4647.71,0.00
2024-12-08 14:56:02,591,3442,292,299,2786.39,4648.00,0.00
2024-12-08 14:56:02,592,3442,292,300,2781.68,4648.00,0.00
2024-12-08 14:56:02,591,3442,292,299,2783.58,4648.04,0.00
2024-12-08 14:56:02,592,3441,292,300,2774.53,4648.14,0.00
2024-12-08 14:56:02,591,3441,292,299,2778.70,4648.20,0.00
2024-12-08 14:56:02,590,3441,291,299,2783.34,4648.20,0.00
2024-12-08 14:56:02,589,3441,290,299,2787.98,4648.20,0.00
2024-12-08 14:56:02,590,3440,291,299,2764.22,4648.61,0.00
2024-12-08 14:56:02,591,3439,291,300,2754.49,4648.80,0.00
2024-12-08 14:56:02,591,3440,291,300,2778.45,4649.00,0.00
2024-12-08 14:56:02,592,3440,291,301,2773.76,4649.00,0.00
2024-12-08 14:56:02,593,3439,291,302,2756.26,4649.25,0.00
2024-12-08 14:56:02,594,3438,292,302,2739.31,4649.56,0.00
2024-12-08 14:56:02,595,3437,293,302,2728.77,4649.71,0.00
2024-12-08 14:56:02,596,3436,294,302,2726.07,4649.73,0.00
2024-12-08 14:56:02,597,3435,294,303,2720.22,4649.78,0.00
2024-12-08 14:56:02,597,3436,294,303,2743.08,4650.00,0.00
2024-12-08 14:56:02,598,3436,294,304,2738.49,4650.00,0.00
2024-12-08 14:56:02,597,3436,294,303,2738.82,4650.06,0.00
2024-12-08 14:56:02,598,3435,294,304,2733.86,4650.07,0.00
2024-12-08 14:56:02,597,3435,293,304,2739.33,4650.14,0.00
2024-12-08 14:56:02,596,3435,293,303,2742.92,4650.16,0.00
2024-12-08 14:56:02,595,3435,293,302,2745.83,4650.20,0.00
2024-12-08 14:56:02,594,3435,292,302,2750.38,4650.20,0.00
2024-12-08 14:56:02,593,3435,292,301,2754.93,4650.20,0.00
2024-12-08 14:56:02,592,3435,292,300,2759.51,4650.20,0.00
2024-12-08 14:56:02,593,3434,293,300,2744.28,4650.43,0.00
2024-12-08 14:56:02,594,3433,294,300,2726.41,4650.79,0.00
2024-12-08 14:56:02,595,3432,294,301,2721.71,4650.84,0.00
2024-12-08 14:56:02,596,3431,295,301,2717.86,4650.85,0.00
2024-12-08 14:56:02,597,3430,295,302,2711.78,4650.89,0.00
2024-12-08 14:56:02,597,3431,295,302,2754.33,4651.00,0.00
2024-12-08 14:56:02,598,3431,296,302,2749.73,4651.00,0.00
2024-12-08 14:56:02,599,3430,296,303,2739.67,4651.09,0.00
2024-12-08 14:56:02,600,3429,297,303,2737.97,4651.10,0.00
2024-12-08 14:56:02,599,3429,296,303,2746.82,4651.10,0.00
2024-12-08 14:56:02,598,3429,296,302,2746.71,4651.20,0.00
2024-12-08 14:56:02,599,3428,296,303,2740.51,4651.24,0.00
2024-12-08 14:56:02,600,3427,296,304,2741.77,4651.27,0.00
2024-12-08 14:56:02,601,3426,297,304,2735.22,4651.35,0.00
2024-12-08 14:56:02,600,3426,296,304,2740.46,4651.47,0.00
2024-12-08 14:56:02,601,3425,296,305,2731.76,4651.56,0.00
2024-12-08 14:56:02,602,3424,297,305,2713.70,4651.88,0.00
2024-12-08 14:56:02,603,3423,298,305,2707.10,4651.94,0.00
2024-12-08 14:56:02,603,3424,298,305,2758.98,4652.00,0.00
2024-12-08 14:56:02,604,3424,299,305,2754.42,4652.00,0.00
2024-12-08 14:56:02,603,3424,298,305,2758.22,4652.02,0.00
2024-12-08 14:56:02,602,3424,298,304,2761.11,4652.04,0.00
2024-12-08 14:56:02,601,3424,297,304,2730.86,4652.79,0.00
2024-12-08 14:56:02,602,3423,297,305,2722.38,4652.88,0.00
2024-12-08 14:56:02,602,3424,297,305,2784.31,4653.00,0.00
2024-12-08 14:56:02,603,3424,298,305,2779.69,4653.00,0.00
2024-12-08 14:56:02,602,3424,297,305,2780.30,4653.02,0.00
2024-12-08 14:56:02,601,3424,297,304,2783.85,4653.04,0.00
2024-12-08 14:56:02,600,3424,297,303,2781.20,4653.19,0.00
2024-12-08 14:56:02,599,3424,297,302,2785.76,4653.19,0.00
2024-12-08 14:56:02,598,3424,296,302,2790.27,4653.19,0.00
2024-12-08 14:56:02,599,3423,297,302,2782.91,4653.26,0.00
2024-12-08 14:56:02,600,3422,298,302,2771.29,4653.43,0.00
2024-12-08 14:56:02,601,3421,298,303,2770.94,4653.45,0.00
2024-12-08 14:56:02,602,3420,299,303,2766.91,4653.50,0.00
2024-12-08 14:56:02,603,3419,299,304,2763.13,4653.58,0.00
2024-12-08 14:56:02,603,3420,299,304,2763.18,4654.00,0.00
2024-12-08 14:56:02,604,3420,300,304,2758.61,4654.00,0.00
2024-12-08 14:56:02,603,3420,299,304,2752.78,4654.19,0.00
2024-12-08 14:56:02,604,3419,300,304,2748.14,4654.20,0.00
2024-12-08 14:56:02,605,3418,300,305,2740.18,4654.32,0.00
2024-12-08 14:56:02,606,3417,300,306,2737.20,4654.34,0.00
2024-12-08 14:56:02,607,3416,300,307,2730.60,4654.45,0.00
2024-12-08 14:56:02,608,3415,300,308,2728.16,4654.46,0.00
2024-12-08 14:56:02,609,3414,301,308,2724.11,4654.55,0.00
2024-12-08 14:56:02,610,3413,301,309,2720.07,4654.63,0.00
2024-12-08 14:56:03,610,3414,301,309,2752.03,4655.00,0.00
2024-12-08 14:56:03,611,3414,302,309,2747.53,4655.00,0.00
2024-12-08 14:56:03,610,3414,301,309,2750.13,4655.00,0.00
2024-12-08 14:56:03,609,3414,301,308,2752.44,4655.03,0.00
2024-12-08 14:56:03,610,3413,301,309,2741.59,4655.17,0.00
2024-12-08 14:56:03,611,3412,301,310,2723.41,4655.57,0.00
2024-12-08 14:56:03,612,3411,301,311,2716.67,4655.68,0.00
2024-12-08 14:56:03,612,3412,301,311,2765.54,4656.00,0.00
2024-12-08 14:56:03,613,3412,302,311,2761.03,4656.00,0.00
2024-12-08 14:56:03,612,3412,302,310,2762.74,4656.03,0.00
2024-12-08 14:56:03,611,3412,302,309,2765.45,4656.07,0.00
2024-12-08 14:56:03,610,3412,301,309,2768.40,4656.11,0.00
2024-12-08 14:56:03,609,3412,301,308,2770.37,4656.16,0.00
2024-12-08 14:56:03,608,3412,300,308,2773.72,4656.18,0.00
2024-12-08 14:56:03,607,3412,300,307,2778.21,4656.19,0.00
2024-12-08 14:56:03,606,3412,299,307,2782.49,4656.19,0.00
2024-12-08 14:56:03,607,3411,299,308,2771.43,4656.33,0.00
2024-12-08 14:56:03,606,3411,298,308,2773.15,4656.43,0.00
2024-12-08 14:56:03,605,3411,297,308,2776.06,4656.47,0.00
2024-12-08 14:56:03,606,3410,297,309,2761.77,4656.68,0.00
2024-12-08 14:56:03,606,3411,297,309,2779.40,4657.00,0.00
2024-12-08 14:56:03,607,3411,297,310,2774.82,4657.00,0.00
2024-12-08 14:56:03,606,3411,296,310,2779.25,4657.00,0.00
2024-12-08 14:56:03,605,3411,296,309,2781.47,4657.03,0.00
2024-12-08 14:56:03,604,3411,295,309,2782.19,4657.12,0.00
2024-12-08 14:56:03,603,3411,294,309,2783.28,4657.19,0.00
2024-12-08 14:56:03,604,3410,294,310,2776.15,4657.25,0.00
2024-12-08 14:56:03,603,3410,293,310,2784.07,4657.28,0.00
2024-12-08 14:56:03,604,3409,294,310,2779.00,4657.29,0.00
2024-12-08 14:56:03,605,3408,295,310,2771.06,4657.40,0.00
2024-12-08 14:56:03,606,3407,296,310,2754.00,4657.72,0.00
2024-12-08 14:56:03,607,3406,296,311,2743.01,4657.90,0.00
2024-12-08 14:56:03,606,3406,295,311,2747.21,4657.90,0.00
2024-12-08 14:56:03,606,3407,295,311,2765.90,4658.00,0.00
2024-12-08 14:56:03,607,3407,296,311,2761.34,4658.00,0.00
2024-12-08 14:56:03,606,3407,296,310,2758.45,4658.10,0.00
2024-12-08 14:56:03,605,3407,295,310,2758.59,4658.20,0.00
2024-12-08 14:56:03,604,3407,295,309,2763.00,4658.20,0.00
2024-12-08 14:56:03,605,3406,295,310,2743.48,4658.52,0.00
2024-12-08 14:56:03,606,3405,296,310,2733.55,4658.73,0.00
2024-12-08 14:56:03,607,3404,297,310,2726.07,4658.85,0.00
2024-12-08 14:56:03,607,3405,297,310,2766.57,4659.00,0.00
2024-12-08 14:56:03,608,3405,298,310,2762.02,4659.00,0.00
2024-12-08 14:56:03,609,3404,299,310,2753.38,4659.06,0.00
2024-12-08 14:56:03,608,3404,298,310,2761.75,4659.08,0.00
2024-12-08 14:56:03,607,3404,298,309,2764.40,4659.12,0.00
2024-12-08 14:56:03,608,3403,298,310,2758.34,4659.15,0.00
2024-12-08 14:56:03,607,3403,298,309,2765.06,4659.20,0.00
2024-12-08 14:56:03,606,3403,297,309,2769.54,4659.20,0.00
2024-12-08 14:56:03,605,3403,296,309,2774.04,4659.20,0.00
2024-12-08 14:56:03,606,3402,296,310,2761.91,4659.37,0.00
2024-12-08 14:56:03,607,3401,296,311,2749.48,4659.57,0.00
2024-12-08 14:56:03,608,3400,297,311,2742.58,4659.68,0.00
2024-12-08 14:56:03,609,3399,297,312,2733.83,4659.83,0.00
2024-12-08 14:56:03,610,3398,297,313,2729.97,4659.85,0.00
2024-12-08 14:56:03,611,3397,298,313,2725.60,4659.88,0.00
2024-12-08 14:56:03,612,3396,299,313,2721.32,4659.90,0.00
2024-12-08 14:56:03,612,3397,299,313,2745.79,4660.00,0.00
2024-12-08 14:56:03,613,3397,300,313,2741.31,4660.00,0.00
2024-12-08 14:56:03,612,3397,299,313,2739.22,4660.11,0.00
2024-12-08 14:56:03,611,3397,299,312,2739.78,4660.19,0.00
2024-12-08 14:56:03,610,3397,299,311,2744.20,4660.19,0.00
2024-12-08 14:56:03,611,3396,299,312,2727.68,4660.46,0.00
2024-12-08 14:56:03,612,3395,300,312,2720.94,4660.60,0.00
2024-12-08 14:56:03,613,3394,300,313,2714.81,4660.68,0.00
2024-12-08 14:56:03,614,3393,300,314,2710.35,4660.74,0.00
2024-12-08 14:56:03,614,3394,300,314,2773.49,4661.00,0.00
2024-12-08 14:56:03,615,3394,301,314,2768.98,4661.00,0.00
2024-12-08 14:56:03,614,3394,301,313,2771.83,4661.03,0.00
2024-12-08 14:56:03,613,3394,301,312,2768.91,4661.19,0.00
2024-12-08 14:56:03,612,3394,301,311,2773.36,4661.19,0.00
2024-12-08 14:56:03,611,3394,300,311,2777.82,4661.20,0.00
2024-12-08 14:56:03,610,3394,300,310,2782.30,4661.20,0.00
2024-12-08 14:56:03,609,3394,299,310,2786.79,4661.20,0.00
2024-12-08 14:56:03,610,3393,299,311,2752.78,4661.84,0.00
2024-12-08 14:56:03,610,3394,299,311,2781.88,4662.00,0.00
2024-12-08 14:56:03,611,3394,299,312,2777.33,4662.00,0.00
2024-12-08 14:56:03,610,3394,298,312,2775.97,4662.10,0.00
2024-12-08 14:56:03,611,3393,299,312,2769.08,4662.15,0.00
2024-12-08 14:56:03,610,3393,298,312,2776.38,4662.16,0.00
2024-12-08 14:56:03,609,3393,297,312,2778.89,4662.20,0.00
2024-12-08 14:56:03,608,3393,296,312,2783.24,4662.20,0.00
2024-12-08 14:56:03,609,3392,297,312,2766.37,4662.47,0.00
2024-12-08 14:56:03,609,3393,297,312,2758.19,4663.00,0.00
2024-12-08 14:56:03,610,3393,297,313,2753.66,4663.00,0.00
2024-12-08 14:56:03,611,3392,298,313,2745.59,4663.05,0.00
2024-12-08 14:56:03,610,3392,297,313,2745.28,4663.20,0.00
2024-12-08 14:56:03,609,3392,297,312,2749.71,4663.20,0.00
2024-12-08 14:56:03,608,3392,296,312,2754.15,4663.20,0.00
2024-12-08 14:56:03,609,3391,297,312,2743.02,4663.35,0.00
2024-12-08 14:56:03,610,3390,298,312,2740.55,4663.44,0.00
2024-12-08 14:56:03,611,3389,298,313,2726.13,4663.72,0.00
2024-12-08 14:56:03,612,3388,299,313,2721.19,4663.78,0.00
2024-12-08 14:56:03,612,3389,299,313,2736.01,4664.00,0.00
2024-12-08 14:56:03,613,3389,299,314,2731.54,4664.00,0.00
2024-12-08 14:56:03,614,3388,300,314,2725.29,4664.04,0.00
2024-12-08 14:56:03,615,3387,300,315,2720.20,4664.10,0.00
2024-12-08 14:56:03,616,3386,300,316,2717.61,4664.11,0.00
2024-12-08 14:56:03,615,3386,300,315,2724.94,4664.17,0.00
2024-12-08 14:56:03,614,3386,300,314,2727.88,4664.20,0.00
2024-12-08 14:56:03,613,3386,299,314,2732.18,4664.21,0.00
2024-12-08 14:56:03,612,3386,299,313,2736.56,4664.21,0.00
2024-12-08 14:56:03,611,3386,299,312,2740.89,4664.21,0.00
2024-12-08 14:56:04,612,3385,299,313,2735.05,4664.24,0.00
2024-12-08 14:56:04,613,3384,299,314,2723.97,4664.43,0.00
2024-12-08 14:56:04,612,3384,298,314,2729.84,4664.48,0.00
2024-12-08 14:56:04,613,3383,298,315,2716.90,4664.67,0.00
2024-12-08 14:56:04,614,3382,299,315,2710.80,4664.77,0.00
2024-12-08 14:56:04,615,3381,299,316,2701.36,4664.92,0.00
2024-12-08 14:56:04,615,3382,299,316,2744.05,4665.00,0.00
2024-12-08 14:56:04,616,3382,300,316,2739.60,4665.00,0.00
2024-12-08 14:56:04,617,3381,301,316,2729.90,4665.09,0.00
2024-12-08 14:56:04,616,3381,300,316,2740.85,4665.10,0.00
2024-12-08 14:56:04,615,3381,300,315,2744.86,4665.11,0.00
2024-12-08 14:56:04,616,3380,301,315,2737.26,4665.18,0.00
2024-12-08 14:56:04,615,3380,300,315,2741.50,4665.21,0.00
2024-12-08 14:56:04,614,3380,299,315,2745.89,4665.21,0.00
2024-12-08 14:56:04,613,3380,298,315,2750.29,4665.21,0.00
2024-12-08 14:56:04,614,3379,298,316,2745.51,4665.22,0.00
2024-12-08 14:56:04,615,3378,299,316,2740.85,4665.31,0.00
2024-12-08 14:56:04,616,3377,299,317,2733.68,4665.48,0.00
2024-12-08 14:56:04,617,3376,299,318,2728.56,4665.60,0.00
2024-12-08 14:56:04,618,3375,300,318,2718.42,4665.74,0.00
2024-12-08 14:56:04,618,3376,300,318,2775.92,4666.00,0.00
2024-12-08 14:56:04,619,3376,301,318,2771.44,4666.00,0.00
2024-12-08 14:56:04,620,3375,302,318,2759.36,4666.14,0.00
2024-12-08 14:56:04,621,3374,303,318,2757.86,4666.17,0.00
2024-12-08 14:56:04,622,3373,303,319,2756.13,4666.17,0.00
2024-12-08 14:56:04,621,3373,303,318,2763.97,4666.21,0.00
2024-12-08 14:56:04,622,3372,303,319,2749.78,4666.42,0.00
2024-12-08 14:56:04,623,3371,303,320,2733.29,4666.77,0.00
2024-12-08 14:56:04,623,3372,303,320,2782.12,4667.00,0.00
2024-12-08 14:56:04,624,3372,303,321,2777.66,4667.00,0.00
2024-12-08 14:56:04,623,3372,303,320,2771.13,4667.21,0.00
2024-12-08 14:56:04,624,3371,304,320,2750.61,4667.56,0.00
2024-12-08 14:56:04,624,3372,304,320,2774.80,4668.00,0.00
2024-12-08 14:56:04,625,3372,304,321,2770.36,4668.00,0.00
2024-12-08 14:56:04,624,3372,303,321,2769.82,4668.08,0.00
2024-12-08 14:56:04,623,3372,302,321,2768.19,4668.21,0.00
2024-12-08 14:56:04,622,3372,302,320,2772.57,4668.21,0.00
2024-12-08 14:56:04,621,3372,302,319,2776.96,4668.21,0.00
2024-12-08 14:56:04,622,3371,303,319,2771.15,4668.24,0.00
2024-12-08 14:56:04,623,3370,304,319,2769.51,4668.33,0.00
2024-12-08 14:56:04,624,3369,305,319,2751.66,4668.70,0.00
2024-12-08 14:56:04,625,3368,305,320,2747.13,4668.73,0.00
2024-12-08 14:56:04,626,3367,306,320,2743.21,4668.77,0.00
2024-12-08 14:56:04,627,3366,306,321,2735.00,4668.90,0.00
2024-12-08 14:56:04,628,3365,307,321,2730.15,4668.93,0.00
2024-12-08 14:56:04,628,3366,307,321,2739.74,4669.00,0.00
2024-12-08 14:56:04,629,3366,307,322,2735.39,4669.00,0.00
2024-12-08 14:56:04,628,3366,307,321,2736.78,4669.04,0.00
2024-12-08 14:56:04,627,3366,306,321,2737.76,4669.11,0.00
2024-12-08 14:56:04,626,3366,306,320,2738.89,4669.18,0.00
2024-12-08 14:56:04,627,3365,306,321,2734.22,4669.19,0.00
2024-12-08 14:56:04,626,3365,306,320,2745.16,4669.20,0.00
2024-12-08 14:56:04,625,3365,306,319,2749.48,4669.20,0.00
2024-12-08 14:56:04,624,3365,306,318,2753.81,4669.20,0.00
2024-12-08 14:56:04,625,3364,306,319,2735.49,4669.51,0.00
2024-12-08 14:56:04,626,3363,307,319,2730.40,4669.55,0.00
2024-12-08 14:56:04,627,3362,307,320,2722.06,4669.72,0.00
2024-12-08 14:56:04,628,3361,307,321,2718.70,4669.73,0.00
2024-12-08 14:56:04,628,3362,307,321,2765.02,4670.00,0.00
2024-12-08 14:56:04,629,3362,307,322,2760.62,4670.00,0.00
2024-12-08 14:56:04,628,3362,306,322,2763.91,4670.02,0.00
2024-12-08 14:56:04,627,3362,306,321,2767.21,4670.04,0.00
2024-12-08 14:56:04,628,3361,307,321,2760.67,4670.09,0.00
2024-12-08 14:56:04,627,3361,307,320,2762.60,4670.20,0.00
2024-12-08 14:56:04,626,3361,306,320,2766.94,4670.20,0.00
2024-12-08 14:56:04,627,3360,307,320,2736.09,4670.78,0.00
2024-12-08 14:56:04,628,3359,308,320,2729.56,4670.86,0.00
2024-12-08 14:56:04,627,3359,307,320,2730.06,4670.97,0.00
2024-12-08 14:56:04,627,3360,307,320,2770.24,4671.00,0.00
2024-12-08 14:56:04,628,3360,307,321,2765.83,4671.00,0.00
2024-12-08 14:56:04,627,3360,307,320,2763.07,4671.12,0.00
2024-12-08 14:56:04,626,3360,307,319,2762.86,4671.20,0.00
2024-12-08 14:56:04,625,3360,306,319,2767.21,4671.20,0.00
2024-12-08 14:56:04,626,3359,306,320,2753.61,4671.40,0.00
2024-12-08 14:56:04,627,3358,307,320,2741.48,4671.69,0.00
2024-12-08 14:56:04,628,3357,307,321,2726.41,4671.98,0.00
2024-12-08 14:56:04,628,3358,307,321,2755.37,4672.00,0.00
2024-12-08 14:56:04,629,3358,307,322,2750.99,4672.00,0.00
2024-12-08 14:56:04,628,3358,306,322,2753.97,4672.03,0.00
2024-12-08 14:56:04,627,3358,306,321,2754.95,4672.07,0.00
2024-12-08 14:56:04,626,3358,305,321,2751.81,4672.20,0.00
2024-12-08 14:56:04,625,3358,304,321,2756.14,4672.20,0.00
2024-12-08 14:56:04,624,3358,303,321,2760.34,4672.20,0.00
2024-12-08 14:56:04,625,3357,304,321,2752.87,4672.27,0.00
2024-12-08 14:56:04,625,3358,304,321,2753.57,4673.00,0.00
2024-12-08 14:56:04,626,3358,305,321,2749.17,4673.00,0.00
2024-12-08 14:56:04,627,3357,305,322,2740.56,4673.06,0.00
2024-12-08 14:56:04,626,3357,305,321,2748.15,4673.07,0.00
2024-12-08 14:56:04,625,3357,305,320,2743.64,4673.21,0.00
2024-12-08 14:56:04,626,3356,305,321,2734.59,4673.31,0.00
2024-12-08 14:56:05,626,3357,305,321,2722.50,4674.00,0.00
2024-12-08 14:56:05,627,3357,305,322,2718.16,4674.00,0.00
2024-12-08 14:56:05,626,3357,305,321,2719.38,4674.04,0.00
2024-12-08 14:56:05,625,3357,305,320,2721.29,4674.09,0.00
2024-12-08 14:56:05,624,3357,304,320,2721.48,4674.14,0.00
2024-12-08 14:56:05,625,3356,304,321,2714.90,4674.19,0.00
2024-12-08 14:56:05,624,3356,304,320,2720.01,4674.21,0.00
2024-12-08 14:56:05,625,3355,304,321,2712.61,4674.27,0.00
2024-12-08 14:56:05,626,3354,305,321,2711.59,4674.33,0.00
2024-12-08 14:56:05,627,3353,305,322,2711.44,4674.34,0.00
2024-12-08 14:56:05,628,3352,305,323,2708.69,4674.36,0.00
2024-12-08 14:56:05,629,3351,306,323,2698.90,4674.53,0.00
2024-12-08 14:56:05,630,3350,306,324,2688.13,4674.73,0.00
2024-12-08 14:56:05,631,3349,306,325,2680.67,4674.81,0.00
2024-12-08 14:56:05,631,3350,306,325,2695.87,4675.00,0.00
2024-12-08 14:56:05,632,3350,307,325,2691.61,4675.00,0.00
2024-12-08 14:56:05,631,3350,306,325,2691.29,4675.04,0.00
2024-12-08 14:56:05,632,3349,306,326,2682.85,4675.10,0.00
2024-12-08 14:56:05,633,3348,306,327,2677.91,4675.18,0.00
2024-12-08 14:56:05,632,3348,305,327,2683.64,4675.20,0.00
2024-12-08 14:56:05,631,3348,304,327,2687.75,4675.21,0.00
2024-12-08 14:56:05,632,3347,305,327,2671.83,4675.46,0.00
2024-12-08 14:56:05,633,3346,305,328,2667.01,4675.58,0.00
2024-12-08 14:56:05,634,3345,306,328,2655.51,4675.82,0.00
2024-12-08 14:56:05,635,3344,307,328,2647.31,4675.94,0.00
2024-12-08 14:56:05,635,3345,307,328,2711.42,4676.00,0.00
2024-12-08 14:56:05,636,3345,308,328,2707.16,4676.00,0.00
2024-12-08 14:56:05,635,3345,307,328,2710.55,4676.02,0.00
2024-12-08 14:56:05,634,3345,306,328,2713.92,4676.04,0.00
2024-12-08 14:56:05,633,3345,306,327,2717.40,4676.05,0.00
2024-12-08 14:56:05,632,3345,306,326,2714.53,4676.20,0.00
2024-12-08 14:56:05,631,3345,306,325,2718.75,4676.20,0.00
2024-12-08 14:56:05,630,3345,306,324,2723.00,4676.20,0.00
2024-12-08 14:56:05,629,3345,306,323,2727.25,4676.20,0.00
2024-12-08 14:56:05,630,3344,307,323,2719.97,4676.27,0.00
2024-12-08 14:56:05,631,3343,307,324,2715.72,4676.41,0.00
2024-12-08 14:56:05,632,3342,307,325,2701.57,4676.66,0.00
2024-12-08 14:56:05,633,3341,307,326,2699.89,4676.67,0.00
2024-12-08 14:56:05,634,3340,308,326,2697.35,4676.69,0.00
2024-12-08 14:56:05,635,3339,309,326,2691.76,4676.78,0.00
2024-12-08 14:56:05,635,3340,309,326,2732.08,4677.00,0.00
2024-12-08 14:56:05,636,3340,310,326,2727.79,4677.00,0.00
2024-12-08 14:56:05,635,3340,310,325,2728.42,4677.05,0.00
2024-12-08 14:56:05,634,3340,310,324,2729.66,4677.11,0.00
2024-12-08 14:56:05,635,3339,310,325,2724.56,4677.13,0.00
2024-12-08 14:56:05,634,3339,310,324,2726.60,4677.20,0.00
2024-12-08 14:56:05,633,3339,310,323,2730.84,4677.20,0.00
2024-12-08 14:56:05,632,3339,310,322,2735.09,4677.20,0.00
2024-12-08 14:56:05,631,3339,309,322,2735.42,4677.22,0.00
2024-12-08 14:56:05,632,3338,309,323,2715.77,4677.55,0.00
2024-12-08 14:56:05,633,3337,310,323,2714.23,4677.58,0.00
2024-12-08 14:56:05,634,3336,311,323,2697.01,4677.94,0.00
2024-12-08 14:56:05,634,3337,311,323,2746.28,4678.00,0.00
2024-12-08 14:56:05,635,3337,312,323,2741.95,4678.00,0.00
2024-12-08 14:56:05,634,3337,311,323,2745.69,4678.01,0.00
2024-12-08 14:56:05,635,3336,311,324,2733.55,4678.15,0.00
2024-12-08 14:56:05,634,3336,310,324,2737.74,4678.20,0.00
2024-12-08 14:56:05,633,3336,309,324,2741.92,4678.20,0.00
2024-12-08 14:56:05,634,3335,309,325,2737.08,4678.21,0.00
2024-12-08 14:56:05,633,3335,308,325,2742.87,4678.33,0.00
2024-12-08 14:56:05,634,3334,309,325,2733.79,4678.44,0.00
2024-12-08 14:56:05,635,3333,309,326,2728.86,4678.51,0.00
2024-12-08 14:56:05,636,3332,309,327,2718.22,4678.71,0.00
2024-12-08 14:56:05,637,3331,309,328,2716.16,4678.72,0.00
2024-12-08 14:56:05,638,3330,310,328,2713.01,4678.73,0.00
2024-12-08 14:56:05,639,3329,310,329,2703.89,4678.87,0.00
2024-12-08 14:56:05,639,3330,310,329,2735.42,4679.00,0.00
2024-12-08 14:56:05,640,3330,310,330,2731.14,4679.00,0.00
2024-12-08 14:56:05,639,3330,309,330,2734.62,4679.02,0.00
2024-12-08 14:56:05,640,3329,309,331,2725.19,4679.10,0.00
2024-12-08 14:56:05,639,3329,309,330,2729.21,4679.19,0.00
2024-12-08 14:56:05,638,3329,309,329,2733.42,4679.19,0.00
2024-12-08 14:56:05,637,3329,309,328,2737.64,4679.20,0.00
2024-12-08 14:56:05,636,3329,309,327,2741.65,4679.20,0.00
2024-12-08 14:56:05,637,3328,309,328,2734.43,4679.27,0.00
2024-12-08 14:56:05,638,3327,309,329,2713.98,4679.66,0.00
2024-12-08 14:56:05,639,3326,310,329,2711.44,4679.68,0.00
2024-12-08 14:56:05,640,3325,311,329,2707.68,4679.73,0.00
2024-12-08 14:56:05,641,3324,312,329,2702.48,4679.80,0.00
2024-12-08 14:56:05,640,3324,311,329,2707.38,4679.82,0.00
2024-12-08 14:56:05,640,3325,311,329,2763.34,4680.00,0.00
2024-12-08 14:56:05,641,3325,312,329,2759.03,4680.00,0.00
2024-12-08 14:56:05,640,3325,312,328,2758.98,4680.06,0.00
2024-12-08 14:56:05,641,3324,313,328,2748.97,4680.19,0.00
2024-12-08 14:56:05,640,3324,313,327,2755.24,4680.20,0.00
2024-12-08 14:56:05,639,3324,312,327,2759.48,4680.20,0.00
2024-12-08 14:56:05,640,3323,312,328,2752.85,4680.25,0.00
2024-12-08 14:56:05,641,3322,312,329,2737.09,4680.58,0.00
2024-12-08 14:56:05,642,3321,312,330,2728.14,4680.76,0.00
2024-12-08 14:56:05,642,3322,312,330,2767.28,4681.00,0.00
2024-12-08 14:56:05,643,3322,312,331,2762.98,4681.00,0.00
2024-12-08 14:56:05,642,3322,312,330,2764.45,4681.05,0.00
2024-12-08 14:56:05,641,3322,312,329,2765.66,4681.11,0.00
2024-12-08 14:56:05,640,3322,312,328,2769.76,4681.11,0.00
2024-12-08 14:56:05,639,3322,311,328,2771.35,4681.17,0.00
2024-12-08 14:56:05,638,3322,311,327,2774.67,4681.19,0.00
2024-12-08 14:56:05,637,3322,310,327,2778.81,4681.20,0.00
2024-12-08 14:56:05,636,3322,309,327,2783.11,4681.20,0.00
2024-12-08 14:56:05,637,3321,309,328,2774.29,4681.30,0.00
2024-12-08 14:56:05,638,3320,309,329,2747.36,4681.92,0.00
2024-12-08 14:56:06,638,3321,309,329,2777.96,4682.00,0.00
2024-12-08 14:56:06,639,3321,310,329,2773.61,4682.00,0.00
2024-12-08 14:56:06,640,3320,311,329,2762.31,4682.12,0.00
2024-12-08 14:56:06,639,3320,310,329,2763.45,4682.20,0.00
2024-12-08 14:56:06,638,3320,310,328,2767.71,4682.20,0.00
2024-12-08 14:56:06,638,3321,310,328,2751.97,4683.00,0.00
2024-12-08 14:56:06,639,3321,310,329,2747.66,4683.00,0.00
2024-12-08 14:56:06,638,3321,309,329,2751.16,4683.02,0.00
2024-12-08 14:56:06,637,3321,309,328,2751.24,4683.08,0.00
2024-12-08 14:56:06,638,3320,310,328,2746.71,4683.08,0.00
2024-12-08 14:56:06,637,3320,310,327,2753.17,4683.11,0.00
2024-12-08 14:56:06,636,3320,310,326,2753.57,4683.20,0.00
2024-12-08 14:56:06,637,3319,310,327,2740.28,4683.35,0.00
2024-12-08 14:56:06,638,3318,311,327,2738.04,4683.36,0.00
2024-12-08 14:56:06,637,3318,310,327,2736.74,4683.49,0.00
2024-12-08 14:56:06,638,3317,311,327,2725.85,4683.63,0.00
2024-12-08 14:56:06,638,3318,311,327,2726.73,4684.00,0.00
2024-12-08 14:56:06,639,3318,311,328,2722.46,4684.00,0.00
2024-12-08 14:56:06,640,3317,312,328,2705.73,4684.24,0.00
2024-12-08 14:56:06,639,3317,311,328,2699.76,4684.48,0.00
2024-12-08 14:56:06,640,3316,312,328,2684.13,4684.73,0.00
2024-12-08 14:56:06,640,3317,312,328,2710.70,4685.00,0.00
2024-12-08 14:56:06,641,3317,312,329,2706.47,4685.00,0.00
2024-12-08 14:56:06,642,3316,312,330,2702.18,4685.01,0.00
2024-12-08 14:56:06,641,3316,312,329,2707.07,4685.04,0.00
2024-12-08 14:56:06,642,3315,312,330,2697.22,4685.17,0.00
2024-12-08 14:56:06,641,3315,311,330,2695.96,4685.31,0.00
2024-12-08 14:56:06,642,3314,312,330,2689.22,4685.37,0.00
2024-12-08 14:56:06,643,3313,313,330,2666.52,4685.84,0.00
2024-12-08 14:56:06,644,3312,313,331,2661.40,4685.90,0.00
2024-12-08 14:56:06,645,3311,313,332,2656.08,4685.94,0.00
2024-12-08 14:56:06,645,3312,313,332,2675.82,4686.00,0.00
2024-12-08 14:56:06,646,3312,313,333,2671.68,4686.00,0.00
2024-12-08 14:56:06,647,3311,313,334,2661.29,4686.11,0.00
2024-12-08 14:56:06,646,3311,312,334,2667.20,4686.20,0.00
2024-12-08 14:56:06,645,3311,312,333,2671.19,4686.20,0.00
2024-12-08 14:56:06,644,3311,312,332,2675.27,4686.20,0.00
2024-12-08 14:56:06,645,3310,313,332,2670.18,4686.23,0.00
2024-12-08 14:56:06,646,3309,314,332,2665.77,4686.24,0.00
2024-12-08 14:56:06,647,3308,315,332,2663.76,4686.28,0.00
2024-12-08 14:56:06,646,3308,314,332,2660.73,4686.47,0.00
2024-12-08 14:56:06,647,3307,315,332,2654.90,4686.51,0.00
2024-12-08 14:56:06,648,3306,316,332,2638.31,4686.87,0.00
2024-12-08 14:56:06,648,3307,316,332,2683.16,4687.00,0.00
2024-12-08 14:56:06,649,3307,316,333,2679.03,4687.00,0.00
2024-12-08 14:56:06,648,3307,315,333,2681.44,4687.04,0.00
2024-12-08 14:56:06,649,3306,315,334,2674.43,4687.07,0.00
2024-12-08 14:56:06,648,3306,315,333,2676.09,4687.20,0.00
2024-12-08 14:56:06,647,3306,315,332,2680.09,4687.20,0.00
2024-12-08 14:56:06,648,3305,315,333,2665.98,4687.42,0.00
2024-12-08 14:56:06,649,3304,315,334,2659.07,4687.60,0.00
2024-12-08 14:56:06,650,3303,315,335,2650.59,4687.72,0.00
2024-12-08 14:56:06,650,3304,315,335,2686.94,4688.00,0.00
2024-12-08 14:56:06,651,3304,315,336,2682.81,4688.00,0.00
2024-12-08 14:56:06,652,3303,315,337,2672.77,4688.10,0.00
2024-12-08 14:56:06,651,3303,314,337,2677.90,4688.13,0.00
2024-12-08 14:56:06,650,3303,314,336,2678.45,4688.20,0.00
2024-12-08 14:56:06,649,3303,313,336,2682.50,4688.20,0.00
2024-12-08 14:56:06,648,3303,313,335,2686.50,4688.21,0.00
2024-12-08 14:56:06,647,3303,313,334,2690.58,4688.21,0.00
2024-12-08 14:56:06,646,3303,312,334,2694.67,4688.21,0.00
2024-12-08 14:56:06,647,3302,312,335,2681.52,4688.40,0.00
2024-12-08 14:56:06,648,3301,313,335,2669.34,4688.66,0.00
2024-12-08 14:56:06,649,3300,313,336,2660.93,4688.82,0.00
2024-12-08 14:56:06,649,3301,313,336,2685.80,4689.00,0.00
2024-12-08 14:56:06,650,3301,314,336,2681.67,4689.00,0.00
2024-12-08 14:56:06,649,3301,314,335,2683.64,4689.04,0.00
2024-12-08 14:56:06,648,3301,314,334,2687.50,4689.05,0.00
2024-12-08 14:56:06,649,3300,314,335,2681.78,4689.08,0.00
2024-12-08 14:56:06,650,3299,315,335,2681.92,4689.09,0.00
2024-12-08 14:56:06,651,3298,316,335,2682.27,4689.10,0.00
2024-12-08 14:56:06,650,3298,315,335,2686.56,4689.14,0.00
2024-12-08 14:56:06,651,3297,316,335,2668.58,4689.44,0.00
2024-12-08 14:56:06,652,3296,317,335,2657.30,4689.70,0.00
2024-12-08 14:56:06,651,3296,316,335,2651.68,4689.95,0.00
2024-12-08 14:56:06,651,3297,316,335,2685.36,4690.00,0.00
2024-12-08 14:56:06,652,3297,316,336,2681.24,4690.00,0.00
2024-12-08 14:56:06,651,3297,315,336,2680.12,4690.06,0.00
2024-12-08 14:56:06,652,3296,315,337,2662.68,4690.35,0.00
2024-12-08 14:56:06,653,3295,316,337,2663.00,4690.38,0.00
2024-12-08 14:56:06,653,3296,316,337,2683.02,4691.00,0.00
2024-12-08 14:56:06,654,3296,316,338,2678.92,4691.00,0.00
2024-12-08 14:56:07,653,3296,315,338,2682.66,4691.01,0.00
2024-12-08 14:56:07,652,3296,314,338,2686.13,4691.02,0.00
2024-12-08 14:56:07,651,3296,313,338,2689.76,4691.02,0.00
2024-12-08 14:56:07,650,3296,313,337,2684.10,4691.20,0.00
2024-12-08 14:56:07,649,3296,312,337,2688.02,4691.21,0.00
2024-12-08 14:56:07,650,3295,313,337,2681.23,4691.27,0.00
2024-12-08 14:56:07,650,3296,313,337,2675.41,4692.00,0.00
2024-12-08 14:56:07,651,3296,313,338,2671.30,4692.00,0.00
2024-12-08 14:56:07,650,3296,312,338,2675.19,4692.00,0.00
2024-12-08 14:56:07,649,3296,311,338,2679.17,4692.01,0.00
2024-12-08 14:56:07,650,3295,312,338,2674.05,4692.03,0.00
2024-12-08 14:56:07,649,3295,312,337,2670.95,4692.20,0.00
2024-12-08 14:56:07,648,3295,312,336,2674.93,4692.21,0.00
2024-12-08 14:56:07,647,3295,311,336,2678.99,4692.21,0.00
2024-12-08 14:56:07,646,3295,310,336,2683.07,4692.21,0.00
2024-12-08 14:56:07,645,3295,309,336,2687.16,4692.21,0.00
2024-12-08 14:56:07,644,3295,309,335,2691.26,4692.21,0.00
2024-12-08 14:56:07,643,3295,309,334,2695.37,4692.21,0.00
2024-12-08 14:56:07,644,3294,309,335,2685.97,4692.32,0.00
2024-12-08 14:56:07,645,3293,310,335,2686.41,4692.36,0.00
2024-12-08 14:56:07,644,3293,309,335,2689.06,4692.48,0.00
2024-12-08 14:56:07,645,3292,309,336,2681.44,4692.56,0.00
2024-12-08 14:56:07,645,3293,309,336,2674.76,4693.00,0.00
2024-12-08 14:56:07,646,3293,310,336,2670.62,4693.00,0.00
2024-12-08 14:56:07,645,3293,310,335,2672.08,4693.04,0.00
2024-12-08 14:56:07,644,3293,310,334,2675.29,4693.06,0.00
2024-12-08 14:56:07,643,3293,310,333,2672.67,4693.20,0.00
2024-12-08 14:56:07,642,3293,309,333,2676.61,4693.21,0.00
2024-12-08 14:56:07,643,3292,309,334,2669.04,4693.28,0.00
2024-12-08 14:56:07,644,3291,310,334,2660.89,4693.45,0.00
2024-12-08 14:56:07,645,3290,310,335,2655.63,4693.52,0.00
2024-12-08 14:56:07,646,3289,310,336,2652.00,4693.61,0.00
2024-12-08 14:56:07,647,3288,310,337,2641.26,4693.77,0.00
2024-12-08 14:56:07,647,3289,310,337,2666.19,4694.00,0.00
2024-12-08 14:56:07,648,3289,311,337,2662.07,4694.00,0.00
2024-12-08 14:56:07,647,3289,310,337,2665.32,4694.02,0.00
2024-12-08 14:56:07,648,3288,311,337,2660.56,4694.04,0.00
2024-12-08 14:56:07,647,3288,311,336,2666.86,4694.04,0.00
2024-12-08 14:56:07,646,3288,311,335,2669.05,4694.08,0.00
2024-12-08 14:56:07,645,3288,310,335,2673.11,4694.08,0.00
2024-12-08 14:56:07,644,3288,310,334,2671.78,4694.20,0.00
2024-12-08 14:56:07,643,3288,310,333,2675.79,4694.20,0.00
2024-12-08 14:56:07,642,3288,309,333,2679.74,4694.21,0.00
2024-12-08 14:56:07,643,3287,310,333,2673.69,4694.25,0.00
2024-12-08 14:56:07,644,3286,311,333,2666.09,4694.37,0.00
2024-12-08 14:56:07,645,3285,311,334,2642.87,4694.85,0.00
2024-12-08 14:56:07,646,3284,312,334,2638.02,4694.90,0.00
2024-12-08 14:56:07,646,3285,312,334,2677.86,4695.00,0.00
2024-12-08 14:56:07,647,3285,312,335,2673.73,4695.00,0.00
2024-12-08 14:56:07,648,3284,313,335,2667.88,4695.04,0.00
2024-12-08 14:56:07,647,3284,313,334,2671.02,4695.11,0.00
2024-12-08 14:56:07,648,3283,313,335,2662.45,4695.20,0.00
2024-12-08 14:56:07,647,3283,313,334,2670.27,4695.21,0.00
2024-12-08 14:56:07,646,3283,313,333,2674.33,4695.21,0.00
2024-12-08 14:56:07,645,3283,313,332,2678.40,4695.21,0.00
2024-12-08 14:56:07,646,3282,314,332,2673.68,4695.22,0.00
2024-12-08 14:56:07,647,3281,314,333,2666.73,4695.44,0.00
2024-12-08 14:56:07,648,3280,315,333,2659.30,4695.62,0.00
2024-12-08 14:56:07,649,3279,316,333,2654.31,4695.69,0.00
2024-12-08 14:56:07,649,3280,316,333,2685.25,4696.00,0.00
2024-12-08 14:56:07,650,3280,316,334,2681.12,4696.00,0.00
2024-12-08 14:56:07,649,3280,315,334,2674.28,4696.21,0.00
2024-12-08 14:56:07,648,3280,314,334,2678.19,4696.21,0.00
2024-12-08 14:56:07,649,3279,315,334,2668.18,4696.34,0.00
2024-12-08 14:56:07,650,3278,315,335,2663.95,4696.40,0.00
2024-12-08 14:56:07,651,3277,316,335,2648.85,4696.71,0.00
2024-12-08 14:56:07,652,3276,317,335,2641.14,4696.85,0.00
2024-12-08 14:56:07,652,3277,317,335,2684.35,4697.00,0.00
2024-12-08 14:56:07,653,3277,318,335,2680.24,4697.00,0.00
2024-12-08 14:56:07,652,3277,318,334,2680.48,4697.05,0.00
2024-12-08 14:56:07,653,3276,318,335,2639.60,4697.85,0.00
2024-12-08 14:56:07,653,3277,318,335,2667.16,4698.00,0.00
2024-12-08 14:56:07,654,3277,318,336,2663.08,4698.00,0.00
2024-12-08 14:56:07,655,3276,318,337,2654.10,4698.08,0.00
2024-12-08 14:56:07,656,3275,319,337,2648.50,4698.13,0.00
2024-12-08 14:56:07,655,3275,318,337,2653.13,4698.17,0.00
2024-12-08 14:56:07,656,3274,319,337,2647.75,4698.20,0.00
2024-12-08 14:56:07,657,3273,319,338,2642.75,4698.26,0.00
2024-12-08 14:56:07,658,3272,320,338,2613.60,4698.81,0.00
2024-12-08 14:56:07,659,3271,321,338,2609.03,4698.86,0.00
2024-12-08 14:56:07,660,3270,321,339,2603.77,4698.92,0.00
2024-12-08 14:56:07,660,3271,321,339,2615.02,4699.00,0.00
2024-12-08 14:56:07,661,3271,321,340,2611.07,4699.00,0.00
2024-12-08 14:56:07,660,3271,320,340,2614.95,4699.00,0.00
2024-12-08 14:56:07,659,3271,319,340,2618.35,4699.01,0.00
2024-12-08 14:56:07,660,3270,320,340,2610.07,4699.08,0.00
2024-12-08 14:56:07,659,3270,320,339,2613.40,4699.10,0.00
2024-12-08 14:56:07,660,3269,321,339,2607.54,4699.15,0.00
2024-12-08 14:56:07,659,3269,321,338,2612.85,4699.15,0.00
2024-12-08 14:56:07,658,3269,321,337,2613.93,4699.21,0.00
2024-12-08 14:56:07,657,3269,321,336,2617.84,4699.21,0.00
2024-12-08 14:56:07,656,3269,320,336,2621.55,4699.22,0.00
2024-12-08 14:56:07,655,3269,320,335,2625.48,4699.22,0.00
2024-12-08 14:56:07,654,3269,319,335,2629.42,4699.22,0.00
2024-12-08 14:56:07,655,3268,320,335,2620.25,4699.27,0.00
2024-12-08 14:56:07,654,3268,319,335,2620.04,4699.50,0.00
2024-12-08 14:56:08,654,3269,319,335,2654.31,4700.00,0.00
2024-12-08 14:56:08,655,3269,320,335,2650.26,4700.00,0.00
2024-12-08 14:56:08,654,3269,320,334,2652.10,4700.04,0.00
2024-12-08 14:56:08,653,3269,319,334,2651.81,4700.13,0.00
2024-12-08 14:56:08,652,3269,318,334,2652.25,4700.21,0.00
2024-12-08 14:56:08,651,3269,317,334,2654.29,4700.21,0.00
2024-12-08 14:56:08,650,3269,316,334,2658.30,4700.21,0.00
2024-12-08 14:56:08,651,3268,316,335,2653.00,4700.24,0.00
2024-12-08 14:56:08,652,3267,317,335,2650.03,4700.30,0.00
2024-12-08 14:56:08,653,3266,317,336,2650.88,4700.33,0.00
2024-12-08 14:56:08,652,3266,316,336,2655.68,4700.36,0.00
2024-12-08 14:56:08,653,3265,317,336,2647.97,4700.44,0.00
2024-12-08 14:56:08,654,3264,317,337,2643.17,4700.52,0.00
2024-12-08 14:56:08,655,3263,318,337,2639.54,4700.60,0.00
2024-12-08 14:56:08,655,3264,318,337,2653.40,4701.00,0.00
2024-12-08 14:56:08,656,3264,318,338,2649.35,4701.00,0.00
2024-12-08 14:56:08,655,3264,318,337,2650.97,4701.04,0.00
2024-12-08 14:56:08,654,3264,318,336,2652.82,4701.09,0.00
2024-12-08 14:56:08,655,3263,319,336,2646.85,4701.13,0.00
2024-12-08 14:56:08,656,3262,319,337,2646.65,4701.20,0.00
2024-12-08 14:56:08,657,3261,320,337,2645.13,4701.21,0.00
2024-12-08 14:56:08,656,3261,319,337,2649.60,4701.21,0.00
2024-12-08 14:56:08,655,3261,318,337,2653.57,4701.21,0.00
2024-12-08 14:56:08,654,3261,318,336,2657.48,4701.21,0.00
2024-12-08 14:56:08,653,3261,317,336,2661.48,4701.21,0.00
2024-12-08 14:56:08,654,3260,318,336,2648.71,4701.40,0.00
2024-12-08 14:56:08,653,3260,317,336,2653.18,4701.51,0.00
2024-12-08 14:56:08,654,3259,318,336,2640.60,4701.69,0.00
2024-12-08 14:56:08,655,3258,318,337,2636.89,4701.75,0.00
2024-12-08 14:56:08,656,3257,318,338,2629.80,4701.86,0.00
2024-12-08 14:56:08,655,3257,317,338,2629.40,4701.94,0.00
2024-12-08 14:56:08,655,3258,317,338,2676.69,4702.00,0.00
2024-12-08 14:56:08,656,3258,317,339,2672.61,4702.00,0.00
2024-12-08 14:56:08,657,3257,317,340,2667.55,4702.03,0.00
2024-12-08 14:56:08,656,3257,316,340,2672.19,4702.03,0.00
2024-12-08 14:56:08,655,3257,315,340,2673.55,4702.05,0.00
2024-12-08 14:56:08,656,3256,315,341,2667.21,4702.10,0.00
2024-12-08 14:56:08,655,3256,314,341,2667.50,4702.21,0.00
2024-12-08 14:56:08,654,3256,314,340,2671.44,4702.21,0.00
2024-12-08 14:56:08,653,3256,313,340,2675.45,4702.21,0.00
2024-12-08 14:56:08,652,3256,313,339,2679.49,4702.21,0.00
2024-12-08 14:56:08,651,3256,313,338,2683.53,4702.21,0.00
2024-12-08 14:56:08,652,3255,314,338,2674.26,4702.32,0.00
2024-12-08 14:56:08,653,3254,315,338,2656.92,4702.74,0.00
2024-12-08 14:56:08,654,3253,315,339,2651.47,4702.82,0.00
2024-12-08 14:56:08,654,3254,315,339,2702.46,4703.00,0.00
2024-12-08 14:56:08,655,3254,316,339,2698.34,4703.00,0.00
2024-12-08 14:56:08,654,3254,315,339,2701.53,4703.02,0.00
2024-12-08 14:56:08,653,3254,315,338,2700.95,4703.09,0.00
2024-12-08 14:56:08,652,3254,314,338,2702.69,4703.13,0.00
2024-12-08 14:56:08,653,3253,315,338,2698.55,4703.14,0.00
2024-12-08 14:56:08,652,3253,315,337,2699.56,4703.21,0.00
2024-12-08 14:56:08,653,3252,315,338,2680.15,4703.54,0.00
2024-12-08 14:56:08,654,3251,316,338,2672.55,4703.70,0.00
2024-12-08 14:56:08,654,3252,316,338,2704.58,4704.00,0.00
2024-12-08 14:56:08,655,3252,317,338,2700.45,4704.00,0.00
2024-12-08 14:56:08,654,3252,317,337,2701.36,4704.04,0.00
2024-12-08 14:56:08,655,3251,318,337,2695.53,4704.08,0.00
2024-12-08 14:56:08,654,3251,317,337,2695.18,4704.21,0.00
2024-12-08 14:56:08,653,3251,316,337,2699.24,4704.21,0.00
2024-12-08 14:56:08,654,3250,316,338,2681.56,4704.50,0.00
2024-12-08 14:56:08,655,3249,317,338,2678.27,4704.52,0.00
2024-12-08 14:56:08,656,3248,317,339,2674.43,4704.57,0.00
2024-12-08 14:56:08,657,3247,318,339,2668.21,4704.70,0.00
2024-12-08 14:56:08,658,3246,318,340,2660.96,4704.83,0.00
2024-12-08 14:56:08,658,3247,318,340,2680.35,4705.00,0.00
2024-12-08 14:56:08,659,3247,318,341,2676.28,4705.00,0.00
2024-12-08 14:56:08,660,3246,319,341,2665.71,4705.11,0.00
2024-12-08 14:56:08,659,3246,318,341,2666.74,4705.21,0.00
2024-12-08 14:56:08,658,3246,317,341,2670.58,4705.21,0.00
2024-12-08 14:56:08,659,3245,317,342,2640.69,4705.75,0.00
2024-12-08 14:56:08,660,3244,318,342,2637.36,4705.79,0.00
2024-12-08 14:56:08,660,3245,318,342,2679.25,4706.00,0.00
2024-12-08 14:56:08,661,3245,318,343,2675.19,4706.00,0.00
2024-12-08 14:56:08,660,3245,318,342,2674.43,4706.07,0.00
2024-12-08 14:56:08,659,3245,318,341,2672.13,4706.21,0.00
2024-12-08 14:56:08,658,3245,317,341,2676.12,4706.21,0.00
2024-12-08 14:56:08,657,3245,317,340,2680.12,4706.21,0.00
2024-12-08 14:56:08,656,3245,316,340,2684.14,4706.21,0.00
2024-12-08 14:56:08,657,3244,317,340,2672.59,4706.37,0.00
2024-12-08 14:56:08,656,3244,316,340,2675.96,4706.48,0.00
2024-12-08 14:56:08,657,3243,316,341,2668.91,4706.54,0.00
2024-12-08 14:56:08,658,3242,317,341,2661.24,4706.73,0.00
2024-12-08 14:56:08,658,3243,317,341,2678.70,4707.00,0.00
2024-12-08 14:56:08,659,3243,318,341,2674.64,4707.00,0.00
2024-12-08 14:56:08,658,3243,317,341,2677.43,4707.03,0.00
2024-12-08 14:56:08,657,3243,317,340,2671.56,4707.21,0.00
2024-12-08 14:56:08,656,3243,316,340,2675.49,4707.21,0.00
2024-12-08 14:56:08,657,3242,316,341,2647.97,4707.67,0.00
2024-12-08 14:56:09,658,3241,316,342,2644.90,4707.71,0.00
2024-12-08 14:56:09,658,3242,316,342,2662.81,4708.00,0.00
2024-12-08 14:56:09,659,3242,317,342,2658.77,4708.00,0.00
2024-12-08 14:56:09,658,3242,317,341,2659.67,4708.04,0.00
2024-12-08 14:56:09,657,3242,317,340,2659.67,4708.12,0.00
2024-12-08 14:56:09,658,3241,317,341,2651.74,4708.21,0.00
2024-12-08 14:56:09,657,3241,316,341,2660.44,4708.21,0.00
2024-12-08 14:56:09,658,3240,316,342,2638.88,4708.59,0.00
2024-12-08 14:56:09,659,3239,316,343,2630.27,4708.77,0.00
2024-12-08 14:56:09,660,3238,317,343,2627.63,4708.88,0.00
2024-12-08 14:56:09,660,3239,317,343,2641.79,4709.00,0.00
2024-12-08 14:56:09,661,3239,317,344,2637.80,4709.00,0.00
2024-12-08 14:56:09,662,3238,317,345,2633.53,4709.01,0.00
2024-12-08 14:56:09,663,3237,318,345,2625.86,4709.17,0.00
2024-12-08 14:56:09,662,3237,317,345,2630.21,4709.22,0.00
2024-12-08 14:56:09,661,3237,316,345,2634.12,4709.22,0.00
2024-12-08 14:56:09,660,3237,316,344,2638.04,4709.22,0.00
2024-12-08 14:56:09,659,3237,316,343,2641.97,4709.22,0.00
2024-12-08 14:56:09,660,3236,317,343,2617.05,4709.67,0.00
2024-12-08 14:56:09,661,3235,317,344,2615.52,4709.68,0.00
2024-12-08 14:56:09,661,3236,317,344,2639.28,4710.00,0.00
2024-12-08 14:56:09,662,3236,317,345,2635.30,4710.00,0.00
2024-12-08 14:56:09,663,3235,317,346,2625.63,4710.06,0.00
2024-12-08 14:56:09,664,3234,317,347,2617.47,4710.17,0.00
2024-12-08 14:56:09,665,3233,317,348,2613.05,4710.19,0.00
2024-12-08 14:56:09,664,3233,316,348,2620.05,4710.22,0.00
2024-12-08 14:56:09,663,3233,316,347,2623.87,4710.22,0.00
2024-12-08 14:56:09,664,3232,316,348,2608.16,4710.47,0.00
2024-12-08 14:56:09,665,3231,316,349,2607.86,4710.50,0.00
2024-12-08 14:56:09,666,3230,316,350,2602.98,4710.55,0.00
2024-12-08 14:56:09,667,3229,316,351,2600.38,4710.61,0.00
2024-12-08 14:56:09,668,3228,317,351,2592.88,4710.71,0.00
2024-12-08 14:56:09,669,3227,317,352,2587.66,4710.80,0.00
2024-12-08 14:56:09,669,3228,317,352,2614.09,4711.00,0.00
2024-12-08 14:56:09,670,3228,317,353,2610.19,4711.00,0.00
2024-12-08 14:56:09,669,3228,316,353,2612.01,4711.02,0.00
2024-12-08 14:56:09,668,3228,316,352,2611.65,4711.08,0.00
2024-12-08 14:56:09,669,3227,316,353,2603.98,4711.16,0.00
2024-12-08 14:56:09,670,3226,317,353,2598.57,4711.21,0.00
2024-12-08 14:56:09,669,3226,316,353,2603.80,4711.21,0.00
2024-12-08 14:56:09,668,3226,315,353,2607.62,4711.21,0.00
2024-12-08 14:56:09,667,3226,314,353,2611.39,4711.22,0.00
2024-12-08 14:56:09,668,3225,315,353,2604.19,4711.29,0.00
2024-12-08 14:56:09,669,3224,315,354,2601.17,4711.35,0.00
2024-12-08 14:56:09,670,3223,316,354,2585.45,4711.73,0.00
2024-12-08 14:56:09,670,3224,316,354,2645.72,4712.00,0.00
2024-12-08 14:56:09,671,3224,317,354,2641.78,4712.00,0.00
2024-12-08 14:56:09,670,3224,316,354,2645.24,4712.01,0.00
2024-12-08 14:56:09,669,3224,315,354,2648.14,4712.03,0.00
2024-12-08 14:56:09,668,3224,315,353,2651.05,4712.04,0.00
2024-12-08 14:56:09,667,3224,314,353,2649.05,4712.10,0.00
2024-12-08 14:56:09,668,3223,314,354,2644.59,4712.12,0.00
2024-12-08 14:56:09,667,3223,314,353,2647.10,4712.16,0.00
2024-12-08 14:56:09,668,3222,315,353,2641.46,4712.20,0.00
2024-12-08 14:56:09,667,3222,315,352,2645.64,4712.21,0.00
2024-12-08 14:56:09,666,3222,315,351,2649.33,4712.21,0.00
2024-12-08 14:56:09,665,3222,314,351,2653.11,4712.22,0.00
2024-12-08 14:56:09,664,3222,313,351,2656.89,4712.22,0.00
2024-12-08 14:56:09,665,3221,314,351,2646.63,4712.36,0.00
2024-12-08 14:56:09,666,3220,315,351,2644.16,4712.40,0.00
2024-12-08 14:56:09,665,3220,314,351,2646.06,4712.51,0.00
2024-12-08 14:56:09,666,3219,315,351,2635.86,4712.65,0.00
2024-12-08 14:56:09,666,3220,315,351,2665.15,4713.00,0.00
2024-12-08 14:56:09,667,3220,316,351,2661.16,4713.00,0.00
2024-12-08 14:56:09,666,3220,316,350,2663.40,4713.04,0.00
2024-12-08 14:56:09,667,3219,317,350,2656.18,4713.11,0.00
2024-12-08 14:56:09,666,3219,316,350,2662.23,4713.11,0.00
2024-12-08 14:56:09,665,3219,315,350,2663.29,4713.17,0.00
2024-12-08 14:56:09,666,3218,315,351,2658.10,4713.20,0.00
2024-12-08 14:56:09,665,3218,314,351,2665.08,4713.22,0.00
2024-12-08 14:56:09,664,3218,314,350,2669.03,4713.22,0.00
2024-12-08 14:56:09,663,3218,314,349,2672.84,4713.22,0.00
2024-12-08 14:56:09,662,3218,313,349,2676.81,4713.22,0.00
2024-12-08 14:56:09,663,3217,313,350,2655.51,4713.59,0.00
2024-12-08 14:56:09,664,3216,313,351,2655.45,4713.63,0.00
2024-12-08 14:56:09,665,3215,313,352,2648.73,4713.70,0.00
2024-12-08 14:56:09,666,3214,313,353,2639.37,4713.88,0.00
2024-12-08 14:56:09,666,3215,313,353,2677.20,4714.00,0.00
2024-12-08 14:56:09,667,3215,314,353,2673.18,4714.00,0.00
2024-12-08 14:56:09,666,3215,313,353,2676.92,4714.01,0.00
2024-12-08 14:56:09,665,3215,312,353,2679.54,4714.04,0.00
2024-12-08 14:56:09,666,3214,312,354,2673.04,4714.06,0.00
2024-12-08 14:56:09,665,3214,312,353,2683.34,4714.07,0.00
2024-12-08 14:56:09,664,3214,311,353,2686.39,4714.08,0.00
2024-12-08 14:56:09,663,3214,310,353,2684.12,4714.21,0.00
2024-12-08 14:56:09,662,3214,310,352,2688.10,4714.21,0.00
2024-12-08 14:56:09,661,3214,310,351,2692.03,4714.22,0.00
2024-12-08 14:56:09,660,3214,309,351,2696.03,4714.22,0.00
2024-12-08 14:56:09,659,3214,309,350,2699.98,4714.22,0.00
2024-12-08 14:56:09,660,3213,309,351,2689.72,4714.35,0.00
2024-12-08 14:56:09,661,3212,309,352,2682.60,4714.54,0.00
2024-12-08 14:56:09,662,3211,309,353,2676.28,4714.68,0.00
2024-12-08 14:56:09,661,3211,308,353,2674.73,4714.81,0.00
2024-12-08 14:56:10,661,3212,308,353,2715.84,4715.00,0.00
2024-12-08 14:56:10,662,3212,309,353,2711.73,4715.00,0.00
2024-12-08 14:56:10,661,3212,308,353,2715.34,4715.01,0.00
2024-12-08 14:56:10,660,3212,308,352,2717.53,4715.04,0.00
2024-12-08 14:56:10,661,3211,309,352,2712.08,4715.07,0.00
2024-12-08 14:56:10,660,3211,309,351,2720.62,4715.07,0.00
2024-12-08 14:56:10,659,3211,309,350,2717.82,4715.21,0.00
2024-12-08 14:56:10,659,3212,309,350,2714.13,4716.00,0.00
2024-12-08 14:56:10,660,3212,310,350,2710.02,4716.00,0.00
2024-12-08 14:56:10,661,3211,310,351,2704.72,4716.03,0.00
2024-12-08 14:56:10,660,3211,309,351,2710.25,4716.03,0.00
2024-12-08 14:56:10,659,3211,309,350,2713.07,4716.04,0.00
2024-12-08 14:56:10,660,3210,310,350,2708.11,4716.06,0.00
2024-12-08 14:56:10,659,3210,309,350,2712.08,4716.06,0.00
2024-12-08 14:56:10,658,3210,309,349,2708.83,4716.22,0.00
2024-12-08 14:56:10,659,3209,310,349,2701.45,4716.29,0.00
2024-12-08 14:56:10,660,3208,310,350,2702.16,4716.32,0.00
2024-12-08 14:56:10,661,3207,310,351,2699.22,4716.35,0.00
2024-12-08 14:56:10,662,3206,310,352,2698.66,4716.40,0.00
2024-12-08 14:56:10,661,3206,309,352,2698.34,4716.58,0.00
2024-12-08 14:56:10,662,3205,310,352,2691.66,4716.64,0.00
2024-12-08 14:56:10,663,3204,310,353,2685.02,4716.71,0.00
2024-12-08 14:56:10,663,3205,310,353,2688.53,4717.00,0.00
2024-12-08 14:56:10,664,3205,310,354,2684.48,4717.00,0.00
2024-12-08 14:56:10,663,3205,310,353,2677.11,4717.21,0.00
2024-12-08 14:56:10,662,3205,309,353,2681.01,4717.22,0.00
2024-12-08 14:56:10,663,3204,310,353,2676.96,4717.22,0.00
2024-12-08 14:56:10,664,3203,310,354,2665.60,4717.46,0.00
2024-12-08 14:56:10,665,3202,311,354,2662.55,4717.54,0.00
2024-12-08 14:56:10,666,3201,311,355,2652.39,4717.76,0.00
2024-12-08 14:56:10,666,3202,311,355,2707.13,4718.00,0.00
2024-12-08 14:56:10,667,3202,311,356,2703.07,4718.00,0.00
2024-12-08 14:56:10,668,3201,312,356,2698.32,4718.02,0.00
2024-12-08 14:56:10,669,3200,312,357,2698.32,4718.05,0.00
2024-12-08 14:56:10,668,3200,312,356,2700.41,4718.10,0.00
2024-12-08 14:56:10,669,3199,313,356,2693.51,4718.16,0.00
2024-12-08 14:56:10,668,3199,312,356,2699.34,4718.22,0.00
2024-12-08 14:56:10,667,3199,311,356,2703.32,4718.22,0.00
2024-12-08 14:56:10,666,3199,310,356,2707.30,4718.22,0.00
2024-12-08 14:56:10,667,3198,310,357,2700.64,4718.28,0.00
2024-12-08 14:56:10,668,3197,310,358,2695.48,4718.31,0.00
2024-12-08 14:56:10,669,3196,310,359,2678.94,4718.69,0.00
2024-12-08 14:56:10,670,3195,311,359,2672.44,4718.75,0.00
2024-12-08 14:56:10,671,3194,311,360,2664.33,4718.87,0.00
2024-12-08 14:56:10,671,3195,311,360,2694.55,4719.00,0.00
2024-12-08 14:56:10,672,3195,312,360,2690.54,4719.00,0.00
2024-12-08 14:56:10,673,3194,312,361,2683.33,4719.04,0.00
2024-12-08 14:56:10,672,3194,311,361,2690.21,4719.07,0.00
2024-12-08 14:56:10,673,3193,311,362,2682.68,4719.15,0.00
2024-12-08 14:56:10,672,3193,311,361,2685.02,4719.22,0.00
2024-12-08 14:56:10,671,3193,310,361,2688.95,4719.22,0.00
2024-12-08 14:56:10,672,3192,311,361,2659.47,4719.75,0.00
2024-12-08 14:56:10,672,3193,311,361,2713.12,4720.00,0.00
2024-12-08 14:56:10,673,3193,311,362,2709.09,4720.00,0.00
2024-12-08 14:56:10,672,3193,311,361,2708.31,4720.07,0.00
2024-12-08 14:56:10,673,3192,311,362,2700.26,4720.16,0.00
2024-12-08 14:56:10,674,3191,312,362,2697.31,4720.17,0.00
2024-12-08 14:56:10,673,3191,311,362,2699.66,4720.22,0.00
2024-12-08 14:56:10,674,3190,312,362,2693.84,4720.26,0.00
2024-12-08 14:56:10,675,3189,312,363,2692.31,4720.30,0.00
2024-12-08 14:56:10,676,3188,313,363,2686.95,4720.34,0.00
2024-12-08 14:56:10,677,3187,313,364,2678.47,4720.56,0.00
2024-12-08 14:56:10,678,3186,314,364,2675.16,4720.59,0.00
2024-12-08 14:56:10,679,3185,315,364,2673.95,4720.61,0.00
2024-12-08 14:56:10,680,3184,315,365,2671.00,4720.64,0.00
2024-12-08 14:56:10,681,3183,315,366,2655.48,4720.90,0.00
2024-12-08 14:56:10,681,3184,315,366,2677.74,4721.00,0.00
2024-12-08 14:56:10,682,3184,315,367,2673.82,4721.00,0.00
2024-12-08 14:56:10,683,3183,316,367,2660.10,4721.19,0.00
2024-12-08 14:56:10,682,3183,315,367,2665.25,4721.19,0.00
2024-12-08 14:56:10,683,3182,315,368,2660.26,4721.21,0.00
2024-12-08 14:56:10,682,3182,315,367,2666.10,4721.22,0.00
2024-12-08 14:56:10,681,3182,314,367,2669.95,4721.22,0.00
2024-12-08 14:56:10,680,3182,314,366,2673.80,4721.22,0.00
2024-12-08 14:56:10,679,3182,314,365,2677.67,4721.22,0.00
2024-12-08 14:56:10,680,3181,315,365,2668.22,4721.34,0.00
2024-12-08 14:56:10,681,3180,316,365,2653.68,4721.61,0.00
2024-12-08 14:56:10,682,3179,316,366,2649.77,4721.68,0.00
2024-12-08 14:56:10,683,3178,316,367,2647.70,4721.70,0.00
2024-12-08 14:56:10,684,3177,317,367,2642.85,4721.78,0.00
2024-12-08 14:56:10,685,3176,317,368,2639.56,4721.81,0.00
2024-12-08 14:56:10,685,3177,317,368,2704.51,4722.00,0.00
2024-12-08 14:56:10,686,3177,318,368,2700.56,4722.00,0.00
2024-12-08 14:56:10,685,3177,318,367,2702.31,4722.03,0.00
2024-12-08 14:56:10,684,3177,317,367,2705.71,4722.04,0.00
2024-12-08 14:56:10,685,3176,317,368,2696.10,4722.16,0.00
2024-12-08 14:56:10,684,3176,316,368,2700.21,4722.21,0.00
2024-12-08 14:56:10,685,3175,317,368,2694.28,4722.26,0.00
2024-12-08 14:56:10,686,3174,318,368,2690.57,4722.28,0.00
2024-12-08 14:56:10,685,3174,317,368,2696.46,4722.37,0.00
2024-12-08 14:56:10,686,3173,317,369,2691.91,4722.38,0.00
2024-12-08 14:56:10,687,3172,318,369,2688.70,4722.43,0.00
2024-12-08 14:56:10,688,3171,319,369,2676.84,4722.70,0.00
2024-12-08 14:56:10,689,3170,320,369,2669.56,4722.83,0.00
2024-12-08 14:56:10,690,3169,321,369,2666.99,4722.83,0.00
2024-12-08 14:56:10,691,3168,321,370,2659.26,4722.95,0.00
2024-12-08 14:56:10,691,3169,321,370,2718.56,4723.00,0.00
2024-12-08 14:56:11,692,3169,321,371,2714.64,4723.00,0.00
2024-12-08 14:56:11,691,3169,320,371,2712.86,4723.09,0.00
2024-12-08 14:56:11,690,3169,319,371,2716.73,4723.09,0.00
2024-12-08 14:56:11,689,3169,319,370,2718.70,4723.13,0.00
2024-12-08 14:56:11,688,3169,319,369,2719.19,4723.21,0.00
2024-12-08 14:56:11,687,3169,319,368,2723.01,4723.21,0.00
2024-12-08 14:56:11,686,3169,319,367,2726.91,4723.21,0.00
2024-12-08 14:56:11,685,3169,318,367,2730.83,4723.21,0.00
2024-12-08 14:56:11,684,3169,318,366,2734.75,4723.21,0.00
2024-12-08 14:56:11,685,3168,318,367,2730.00,4723.23,0.00
2024-12-08 14:56:11,686,3167,319,367,2727.61,4723.24,0.00
2024-12-08 14:56:11,685,3167,318,367,2727.03,4723.30,0.00
2024-12-08 14:56:11,686,3166,319,367,2720.80,4723.35,0.00
2024-12-08 14:56:11,685,3166,318,367,2724.86,4723.38,0.00
2024-12-08 14:56:11,685,3167,318,367,2764.72,4724.00,0.00
2024-12-08 14:56:11,686,3167,318,368,2760.69,4724.00,0.00
2024-12-08 14:56:11,685,3167,318,367,2758.49,4724.10,0.00
2024-12-08 14:56:11,686,3166,318,368,2752.90,4724.14,0.00
2024-12-08 14:56:11,685,3166,317,368,2755.16,4724.21,0.00
2024-12-08 14:56:11,684,3166,316,368,2758.92,4724.21,0.00
2024-12-08 14:56:11,685,3165,316,369,2746.95,4724.39,0.00
2024-12-08 14:56:11,686,3164,317,369,2744.74,4724.39,0.00
2024-12-08 14:56:11,687,3163,318,369,2736.62,4724.55,0.00
2024-12-08 14:56:11,688,3162,319,369,2728.63,4724.72,0.00
2024-12-08 14:56:11,689,3161,320,369,2722.95,4724.80,0.00
2024-12-08 14:56:11,689,3162,320,369,2741.72,4725.00,0.00
2024-12-08 14:56:11,690,3162,320,370,2737.75,4725.00,0.00
2024-12-08 14:56:11,689,3162,319,370,2740.70,4725.02,0.00
2024-12-08 14:56:11,690,3161,320,370,2729.93,4725.14,0.00
2024-12-08 14:56:11,689,3161,320,369,2736.33,4725.21,0.00
2024-12-08 14:56:11,688,3161,319,369,2740.24,4725.21,0.00
2024-12-08 14:56:11,689,3160,320,369,2735.86,4725.23,0.00
2024-12-08 14:56:11,690,3159,321,369,2731.71,4725.29,0.00
2024-12-08 14:56:11,691,3158,322,369,2707.09,4725.78,0.00
2024-12-08 14:56:11,692,3157,322,370,2704.41,4725.79,0.00
2024-12-08 14:56:11,693,3156,323,370,2701.34,4725.81,0.00
2024-12-08 14:56:11,694,3155,324,370,2701.00,4725.82,0.00
2024-12-08 14:56:11,694,3156,324,370,2739.71,4726.00,0.00
2024-12-08 14:56:11,695,3156,324,371,2735.77,4726.00,0.00
2024-12-08 14:56:11,694,3156,324,370,2728.91,4726.20,0.00
2024-12-08 14:56:11,693,3156,324,369,2732.44,4726.21,0.00
2024-12-08 14:56:11,692,3156,323,369,2736.05,4726.22,0.00
2024-12-08 14:56:11,693,3155,324,369,2714.00,4726.60,0.00
2024-12-08 14:56:11,692,3155,323,369,2705.84,4726.84,0.00
2024-12-08 14:56:11,692,3156,323,369,2752.91,4727.00,0.00
2024-12-08 14:56:11,693,3156,324,369,2748.93,4727.00,0.00
2024-12-08 14:56:11,694,3155,324,370,2744.77,4727.01,0.00
2024-12-08 14:56:11,693,3155,324,369,2748.60,4727.03,0.00
2024-12-08 14:56:11,692,3155,324,368,2751.35,4727.06,0.00
2024-12-08 14:56:11,693,3154,324,369,2740.43,4727.21,0.00
2024-12-08 14:56:11,694,3153,324,370,2739.35,4727.22,0.00
2024-12-08 14:56:11,693,3153,323,370,2742.09,4727.27,0.00
2024-12-08 14:56:11,694,3152,324,370,2729.02,4727.47,0.00
2024-12-08 14:56:11,695,3151,325,370,2724.16,4727.51,0.00
2024-12-08 14:56:11,696,3150,325,371,2716.64,4727.63,0.00
2024-12-08 14:56:11,697,3149,326,371,2710.38,4727.75,0.00
2024-12-08 14:56:11,698,3148,327,371,2703.41,4727.86,0.00
2024-12-08 14:56:11,698,3149,327,371,2711.26,4728.00,0.00
2024-12-08 14:56:11,699,3149,328,371,2707.38,4728.00,0.00
2024-12-08 14:56:11,698,3149,327,371,2710.18,4728.02,0.00
2024-12-08 14:56:11,697,3149,327,370,2713.40,4728.03,0.00
2024-12-08 14:56:11,696,3149,327,369,2708.42,4728.22,0.00
2024-12-08 14:56:11,697,3148,328,369,2700.42,4728.31,0.00
2024-12-08 14:56:11,698,3147,329,369,2696.70,4728.35,0.00
2024-12-08 14:56:11,699,3146,330,369,2696.45,4728.39,0.00
2024-12-08 14:56:11,698,3146,329,369,2703.10,4728.44,0.00
2024-12-08 14:56:11,699,3145,330,369,2698.22,4728.47,0.00
2024-12-08 14:56:11,700,3144,331,369,2698.76,4728.47,0.00
2024-12-08 14:56:11,699,3144,330,369,2702.91,4728.51,0.00
2024-12-08 14:56:11,700,3143,331,369,2692.78,4728.64,0.00
2024-12-08 14:56:11,701,3142,332,369,2686.92,4728.75,0.00
2024-12-08 14:56:11,702,3141,333,369,2677.03,4728.92,0.00
2024-12-08 14:56:11,702,3142,333,369,2734.49,4729.00,0.00
2024-12-08 14:56:11,703,3142,334,369,2730.60,4729.00,0.00
2024-12-08 14:56:11,702,3142,334,368,2728.60,4729.10,0.00
2024-12-08 14:56:11,701,3142,333,368,2727.72,4729.18,0.00
2024-12-08 14:56:11,700,3142,332,368,2730.08,4729.22,0.00
2024-12-08 14:56:11,699,3142,331,368,2733.92,4729.22,0.00
2024-12-08 14:56:11,699,3143,331,368,2758.21,4730.00,0.00
2024-12-08 14:56:11,700,3143,332,368,2754.27,4730.00,0.00
2024-12-08 14:56:11,701,3142,333,368,2749.54,4730.02,0.00
2024-12-08 14:56:11,700,3142,332,368,2748.72,4730.14,0.00
2024-12-08 14:56:11,701,3141,332,369,2744.74,4730.15,0.00
2024-12-08 14:56:11,700,3141,332,368,2746.74,4730.22,0.00
2024-12-08 14:56:11,699,3141,332,367,2750.60,4730.22,0.00
2024-12-08 14:56:11,698,3141,332,366,2754.47,4730.22,0.00
2024-12-08 14:56:11,697,3141,332,365,2758.29,4730.22,0.00
2024-12-08 14:56:11,698,3140,332,366,2751.85,4730.28,0.00
2024-12-08 14:56:11,699,3139,332,367,2748.79,4730.28,0.00
2024-12-08 14:56:11,700,3138,333,367,2741.07,4730.43,0.00
2024-12-08 14:56:11,699,3138,332,367,2745.64,4730.52,0.00
2024-12-08 14:56:11,699,3139,332,367,2729.00,4731.00,0.00
2024-12-08 14:56:11,700,3139,332,368,2725.10,4731.00,0.00
2024-12-08 14:56:12,701,3138,333,368,2716.71,4731.07,0.00
2024-12-08 14:56:12,700,3138,332,368,2717.90,4731.22,0.00
2024-12-08 14:56:12,699,3138,331,368,2721.65,4731.22,0.00
2024-12-08 14:56:12,700,3137,331,369,2701.48,4731.57,0.00
2024-12-08 14:56:12,701,3136,331,370,2699.00,4731.61,0.00
2024-12-08 14:56:12,702,3135,331,371,2694.20,4731.70,0.00
2024-12-08 14:56:12,703,3134,332,371,2692.66,4731.70,0.00
2024-12-08 14:56:12,704,3133,333,371,2687.42,4731.78,0.00
2024-12-08 14:56:12,704,3134,333,371,2717.59,4732.00,0.00
2024-12-08 14:56:12,705,3134,334,371,2713.74,4732.00,0.00
2024-12-08 14:56:12,704,3134,333,371,2716.52,4732.02,0.00
2024-12-08 14:56:12,703,3134,333,370,2718.64,4732.03,0.00
2024-12-08 14:56:12,702,3134,333,369,2713.70,4732.22,0.00
2024-12-08 14:56:12,701,3134,332,369,2717.31,4732.22,0.00
2024-12-08 14:56:12,702,3133,333,369,2713.30,4732.23,0.00
2024-12-08 14:56:12,703,3132,333,370,2712.10,4732.31,0.00
2024-12-08 14:56:12,704,3131,333,371,2706.60,4732.41,0.00
2024-12-08 14:56:12,705,3130,333,372,2684.86,4732.87,0.00
2024-12-08 14:56:12,706,3129,333,373,2680.48,4732.90,0.00
2024-12-08 14:56:12,706,3130,333,373,2720.75,4733.00,0.00
2024-12-08 14:56:12,707,3130,333,374,2716.90,4733.00,0.00
2024-12-08 14:56:12,706,3130,333,373,2719.01,4733.03,0.00
2024-12-08 14:56:12,705,3130,332,373,2719.28,4733.10,0.00
2024-12-08 14:56:12,704,3130,332,372,2722.27,4733.12,0.00
2024-12-08 14:56:12,703,3130,332,371,2724.55,4733.15,0.00
2024-12-08 14:56:12,704,3129,332,372,2718.75,4733.20,0.00
2024-12-08 14:56:12,703,3129,331,372,2722.22,4733.22,0.00
2024-12-08 14:56:12,702,3129,330,372,2725.97,4733.22,0.00
2024-12-08 14:56:12,701,3129,330,371,2729.79,4733.22,0.00
2024-12-08 14:56:12,700,3129,329,371,2733.62,4733.22,0.00
2024-12-08 14:56:12,699,3129,328,371,2737.47,4733.22,0.00
2024-12-08 14:56:12,698,3129,328,370,2741.32,4733.22,0.00
2024-12-08 14:56:12,697,3129,328,369,2745.12,4733.22,0.00
2024-12-08 14:56:12,698,3128,329,369,2736.61,4733.32,0.00
2024-12-08 14:56:12,699,3127,329,370,2729.06,4733.53,0.00
2024-12-08 14:56:12,700,3126,330,370,2726.39,4733.56,0.00
2024-12-08 14:56:12,701,3125,331,370,2722.21,4733.64,0.00
2024-12-08 14:56:12,702,3124,331,371,2718.98,4733.69,0.00
2024-12-08 14:56:12,703,3123,331,372,2709.32,4733.87,0.00
2024-12-08 14:56:12,704,3122,332,372,2709.61,4733.88,0.00
2024-12-08 14:56:12,704,3123,332,372,2742.46,4734.00,0.00
2024-12-08 14:56:12,705,3123,333,372,2738.57,4734.00,0.00
2024-12-08 14:56:12,706,3122,334,372,2733.49,4734.03,0.00
2024-12-08 14:56:12,705,3122,334,371,2739.99,4734.04,0.00
2024-12-08 14:56:12,706,3121,334,372,2732.72,4734.12,0.00
2024-12-08 14:56:12,705,3121,333,372,2737.16,4734.15,0.00
2024-12-08 14:56:12,704,3121,333,371,2737.59,4734.22,0.00
2024-12-08 14:56:12,703,3121,333,370,2741.41,4734.22,0.00
2024-12-08 14:56:12,704,3120,334,370,2736.19,4734.25,0.00
2024-12-08 14:56:12,705,3119,334,371,2707.87,4734.90,0.00
2024-12-08 14:56:12,705,3120,334,371,2764.30,4735.00,0.00
2024-12-08 14:56:12,706,3120,335,371,2760.39,4735.00,0.00
2024-12-08 14:56:12,705,3120,334,371,2764.17,4735.00,0.00
2024-12-08 14:56:12,704,3120,334,370,2756.69,4735.22,0.00
2024-12-08 14:56:12,703,3120,334,369,2760.55,4735.22,0.00
2024-12-08 14:56:12,702,3120,334,368,2764.21,4735.22,0.00
2024-12-08 14:56:12,703,3119,334,369,2746.06,4735.53,0.00
2024-12-08 14:56:12,704,3118,335,369,2743.98,4735.54,0.00
2024-12-08 14:56:12,705,3117,336,369,2731.12,4735.79,0.00
2024-12-08 14:56:12,705,3118,336,369,2755.30,4736.00,0.00
2024-12-08 14:56:12,706,3118,337,369,2751.39,4736.00,0.00
2024-12-08 14:56:12,707,3117,337,370,2746.57,4736.02,0.00
2024-12-08 14:56:12,708,3116,337,371,2744.77,4736.04,0.00
2024-12-08 14:56:12,707,3116,336,371,2744.82,4736.16,0.00
2024-12-08 14:56:12,708,3115,337,371,2740.88,4736.17,0.00
2024-12-08 14:56:12,709,3114,338,371,2739.02,4736.18,0.00
2024-12-08 14:56:12,708,3114,338,370,2744.26,4736.23,0.00
2024-12-08 14:56:12,707,3114,337,370,2748.07,4736.23,0.00
2024-12-08 14:56:12,708,3113,338,370,2740.87,4736.30,0.00
2024-12-08 14:56:12,707,3113,337,370,2740.73,4736.51,0.00
2024-12-08 14:56:12,708,3112,338,370,2730.45,4736.65,0.00
2024-12-08 14:56:12,709,3111,339,370,2728.61,4736.66,0.00
2024-12-08 14:56:12,710,3110,339,371,2722.77,4736.76,0.00
2024-12-08 14:56:12,709,3110,338,371,2719.75,4736.95,0.00
2024-12-08 14:56:12,709,3111,338,371,2742.03,4737.00,0.00
2024-12-08 14:56:12,710,3111,338,372,2738.16,4737.00,0.00
2024-12-08 14:56:12,709,3111,337,372,2741.16,4737.02,0.00
2024-12-08 14:56:12,708,3111,337,371,2744.64,4737.02,0.00
2024-12-08 14:56:12,707,3111,336,371,2746.25,4737.04,0.00
2024-12-08 14:56:12,708,3110,336,372,2735.61,4737.19,0.00
2024-12-08 14:56:12,709,3109,336,373,2732.29,4737.19,0.00
2024-12-08 14:56:12,708,3109,336,372,2740.92,4737.22,0.00
2024-12-08 14:56:12,707,3109,335,372,2744.73,4737.22,0.00
2024-12-08 14:56:12,708,3108,335,373,2736.67,4737.31,0.00
2024-12-08 14:56:12,709,3107,336,373,2733.88,4737.33,0.00
2024-12-08 14:56:12,710,3106,337,373,2726.30,4737.49,0.00
2024-12-08 14:56:12,711,3105,338,373,2721.85,4737.60,0.00
2024-12-08 14:56:12,711,3106,338,373,2766.28,4738.00,0.00
2024-12-08 14:56:12,712,3106,339,373,2762.40,4738.00,0.00
2024-12-08 14:56:12,711,3106,339,372,2763.82,4738.02,0.00
2024-12-08 14:56:12,710,3106,339,371,2767.52,4738.03,0.00
2024-12-08 14:56:12,711,3105,340,371,2757.55,4738.16,0.00
2024-12-08 14:56:12,710,3105,340,370,2759.81,4738.22,0.00
2024-12-08 14:56:12,709,3105,340,369,2763.43,4738.23,0.00
2024-12-08 14:56:12,710,3104,340,370,2747.82,4738.48,0.00
2024-12-08 14:56:12,711,3103,340,371,2721.67,4738.99,0.00
2024-12-08 14:56:12,711,3104,340,371,2767.93,4739.00,0.00
2024-12-08 14:56:12,712,3104,341,371,2764.04,4739.00,0.00
2024-12-08 14:56:12,711,3104,340,371,2767.80,4739.00,0.00
2024-12-08 14:56:12,710,3104,339,371,2771.30,4739.01,0.00
2024-12-08 14:56:12,711,3103,339,372,2763.36,4739.07,0.00
2024-12-08 14:56:12,710,3103,339,371,2770.14,4739.11,0.00
2024-12-08 14:56:12,709,3103,339,370,2773.45,4739.13,0.00
2024-12-08 14:56:12,710,3102,340,370,2767.10,4739.18,0.00
2024-12-08 14:56:12,711,3101,341,370,2762.22,4739.21,0.00
2024-12-08 14:56:12,710,3101,340,370,2766.13,4739.22,0.00
2024-12-08 14:56:12,709,3101,340,369,2769.96,4739.22,0.00
2024-12-08 14:56:12,710,3100,341,369,2762.22,4739.31,0.00
2024-12-08 14:56:12,711,3099,341,370,2754.71,4739.44,0.00
2024-12-08 14:56:13,712,3098,341,371,2746.01,4739.60,0.00
2024-12-08 14:56:13,712,3099,341,371,2757.17,4740.00,0.00
2024-12-08 14:56:13,713,3099,342,371,2753.30,4740.00,0.00
2024-12-08 14:56:13,712,3099,341,371,2756.97,4740.00,0.00
2024-12-08 14:56:13,711,3099,340,371,2760.65,4740.01,0.00
2024-12-08 14:56:13,710,3099,339,371,2757.25,4740.13,0.00
2024-12-08 14:56:13,709,3099,339,370,2756.84,4740.22,0.00
2024-12-08 14:56:13,708,3099,338,370,2760.67,4740.22,0.00
2024-12-08 14:56:13,707,3099,338,369,2764.51,4740.22,0.00
2024-12-08 14:56:13,706,3099,337,369,2768.36,4740.22,0.00
2024-12-08 14:56:13,707,3098,338,369,2746.64,4740.61,0.00
2024-12-08 14:56:13,708,3097,339,369,2741.75,4740.69,0.00
2024-12-08 14:56:13,709,3096,339,370,2738.05,4740.74,0.00
2024-12-08 14:56:13,710,3095,339,371,2727.05,4740.91,0.00
2024-12-08 14:56:13,710,3096,339,371,2767.72,4741.00,0.00
2024-12-08 14:56:13,711,3096,340,371,2763.83,4741.00,0.00
2024-12-08 14:56:13,710,3096,340,370,2766.46,4741.02,0.00
2024-12-08 14:56:13,709,3096,340,369,2770.30,4741.02,0.00
2024-12-08 14:56:13,708,3096,340,368,2772.62,4741.05,0.00
2024-12-08 14:56:13,709,3095,340,369,2766.12,4741.11,0.00
2024-12-08 14:56:13,710,3094,341,369,2767.23,4741.11,0.00
2024-12-08 14:56:13,711,3093,342,369,2767.14,4741.12,0.00
2024-12-08 14:56:13,710,3093,341,369,2767.03,4741.23,0.00
2024-12-08 14:56:13,709,3093,340,369,2770.86,4741.23,0.00
2024-12-08 14:56:13,710,3092,340,370,2760.20,4741.37,0.00
2024-12-08 14:56:13,709,3092,339,370,2758.27,4741.51,0.00
2024-12-08 14:56:13,710,3091,340,370,2741.68,4741.79,0.00
2024-12-08 14:56:13,711,3090,340,371,2737.13,4741.84,0.00
2024-12-08 14:56:13,712,3089,341,371,2729.90,4741.94,0.00
2024-12-08 14:56:13,712,3090,341,371,2758.06,4742.00,0.00
2024-12-08 14:56:13,713,3090,342,371,2754.20,4742.00,0.00
2024-12-08 14:56:13,712,3090,341,371,2757.80,4742.01,0.00
2024-12-08 14:56:13,713,3089,341,372,2753.41,4742.02,0.00
2024-12-08 14:56:13,712,3089,340,372,2758.15,4742.03,0.00
2024-12-08 14:56:13,713,3088,341,372,2754.15,4742.04,0.00
2024-12-08 14:56:13,714,3087,341,373,2753.03,4742.09,0.00
2024-12-08 14:56:13,715,3086,341,374,2748.88,4742.14,0.00
2024-12-08 14:56:13,716,3085,342,374,2746.58,4742.18,0.00
2024-12-08 14:56:13,715,3085,341,374,2751.48,4742.18,0.00
2024-12-08 14:56:13,716,3084,342,374,2746.53,4742.21,0.00
2024-12-08 14:56:13,715,3084,342,373,2750.71,4742.23,0.00
2024-12-08 14:56:13,714,3084,341,373,2754.50,4742.23,0.00
2024-12-08 14:56:13,713,3084,341,372,2758.30,4742.23,0.00
2024-12-08 14:56:13,714,3083,341,373,2747.05,4742.39,0.00
2024-12-08 14:56:13,715,3082,341,374,2741.49,4742.52,0.00
2024-12-08 14:56:13,716,3081,342,374,2736.96,4742.58,0.00
2024-12-08 14:56:13,716,3082,342,374,2773.72,4743.00,0.00
2024-12-08 14:56:13,717,3082,342,375,2769.85,4743.00,0.00
2024-12-08 14:56:13,716,3082,341,375,2769.57,4743.06,0.00
2024-12-08 14:56:13,715,3082,341,374,2770.95,4743.11,0.00
2024-12-08 14:56:13,714,3082,341,373,2769.77,4743.22,0.00
2024-12-08 14:56:13,713,3082,340,373,2773.59,4743.22,0.00
2024-12-08 14:56:13,712,3082,340,372,2777.42,4743.22,0.00
2024-12-08 14:56:13,711,3082,339,372,2781.26,4743.22,0.00
2024-12-08 14:56:13,710,3082,338,372,2784.98,4743.22,0.00
2024-12-08 14:56:13,711,3081,339,372,2759.91,4743.66,0.00
2024-12-08 14:56:13,712,3080,340,372,2758.37,4743.66,0.00
2024-12-08 14:56:13,713,3079,341,372,2741.35,4743.95,0.00
2024-12-08 14:56:13,713,3080,341,372,2805.86,4744.00,0.00
2024-12-08 14:56:13,714,3080,342,372,2801.93,4744.00,0.00
2024-12-08 14:56:13,713,3080,342,371,2803.08,4744.03,0.00
2024-12-08 14:56:13,712,3080,341,371,2806.62,4744.04,0.00
2024-12-08 14:56:13,713,3079,341,372,2798.73,4744.13,0.00
2024-12-08 14:56:13,712,3079,341,371,2801.72,4744.22,0.00
2024-12-08 14:56:13,713,3078,342,371,2797.26,4744.24,0.00
2024-12-08 14:56:13,714,3077,343,371,2787.79,4744.49,0.00
2024-12-08 14:56:13,713,3077,342,371,2793.04,4744.50,0.00
2024-12-08 14:56:13,714,3076,342,372,2776.15,4744.78,0.00
2024-12-08 14:56:13,714,3077,342,372,2793.88,4745.00,0.00
2024-12-08 14:56:13,715,3077,343,372,2789.97,4745.00,0.00
2024-12-08 14:56:13,716,3076,343,373,2781.40,4745.08,0.00
2024-12-08 14:56:13,717,3075,344,373,2772.92,4745.28,0.00
2024-12-08 14:56:13,718,3074,344,374,2760.44,4745.54,0.00
2024-12-08 14:56:13,719,3073,344,375,2745.60,4745.85,0.00
2024-12-08 14:56:13,719,3074,344,375,2770.38,4746.00,0.00
2024-12-08 14:56:13,720,3074,344,376,2766.54,4746.00,0.00
2024-12-08 14:56:13,719,3074,344,375,2768.81,4746.02,0.00
2024-12-08 14:56:13,720,3073,344,376,2764.77,4746.03,0.00
2024-12-08 14:56:13,719,3073,343,376,2767.55,4746.14,0.00
2024-12-08 14:56:13,718,3073,343,375,2767.48,4746.22,0.00
2024-12-08 14:56:13,717,3073,343,374,2771.21,4746.23,0.00
2024-12-08 14:56:13,716,3073,342,374,2774.95,4746.23,0.00
2024-12-08 14:56:13,717,3072,343,374,2765.09,4746.36,0.00
2024-12-08 14:56:13,718,3071,344,374,2761.04,4746.37,0.00
2024-12-08 14:56:13,719,3070,344,375,2759.22,4746.44,0.00
2024-12-08 14:56:13,720,3069,344,376,2755.17,4746.54,0.00
2024-12-08 14:56:13,720,3070,344,376,2767.78,4747.00,0.00
2024-12-08 14:56:13,721,3070,345,376,2763.94,4747.00,0.00
2024-12-08 14:56:13,720,3070,344,376,2767.58,4747.00,0.00
2024-12-08 14:56:13,719,3070,344,375,2769.46,4747.02,0.00
2024-12-08 14:56:13,720,3069,345,375,2765.48,4747.02,0.00
2024-12-08 14:56:13,721,3068,346,375,2758.12,4747.10,0.00
2024-12-08 14:56:13,720,3068,346,374,2761.31,4747.12,0.00
2024-12-08 14:56:14,719,3068,346,373,2760.25,4747.22,0.00
2024-12-08 14:56:14,720,3067,347,373,2756.41,4747.23,0.00
2024-12-08 14:56:14,719,3067,347,372,2760.98,4747.23,0.00
2024-12-08 14:56:14,719,3068,347,372,2761.78,4748.00,0.00
2024-12-08 14:56:14,720,3068,348,372,2757.94,4748.00,0.00
2024-12-08 14:56:14,719,3068,348,371,2760.40,4748.02,0.00
2024-12-08 14:56:14,720,3067,348,372,2753.75,4748.09,0.00
2024-12-08 14:56:14,721,3066,349,372,2751.40,4748.11,0.00
2024-12-08 14:56:14,720,3066,348,372,2755.70,4748.15,0.00
2024-12-08 14:56:14,719,3066,348,371,2755.88,4748.22,0.00
2024-12-08 14:56:14,718,3066,347,371,2759.59,4748.23,0.00
2024-12-08 14:56:14,717,3066,347,370,2763.37,4748.23,0.00
2024-12-08 14:56:14,716,3066,346,370,2765.25,4748.26,0.00
2024-12-08 14:56:14,717,3065,347,370,2759.02,4748.31,0.00
2024-12-08 14:56:14,718,3064,347,371,2752.37,4748.40,0.00
2024-12-08 14:56:14,719,3063,348,371,2741.20,4748.63,0.00
2024-12-08 14:56:14,720,3062,349,371,2738.93,4748.66,0.00
2024-12-08 14:56:14,721,3061,349,372,2728.30,4748.86,0.00
2024-12-08 14:56:14,722,3060,350,372,2723.25,4748.91,0.00
2024-12-08 14:56:14,723,3059,350,373,2716.59,4748.99,0.00
2024-12-08 14:56:14,723,3060,350,373,2742.48,4749.00,0.00
2024-12-08 14:56:14,724,3060,351,373,2738.69,4749.00,0.00
2024-12-08 14:56:14,723,3060,350,373,2741.89,4749.01,0.00
2024-12-08 14:56:14,722,3060,349,373,2739.57,4749.08,0.00
2024-12-08 14:56:14,721,3060,348,373,2743.14,4749.09,0.00
2024-12-08 14:56:14,722,3059,349,373,2737.59,4749.13,0.00
2024-12-08 14:56:14,721,3059,349,372,2742.84,4749.13,0.00
2024-12-08 14:56:14,722,3058,349,373,2735.39,4749.21,0.00
2024-12-08 14:56:14,721,3058,349,372,2741.76,4749.22,0.00
2024-12-08 14:56:14,720,3058,348,372,2745.44,4749.22,0.00
2024-12-08 14:56:14,719,3058,347,372,2749.13,4749.22,0.00
2024-12-08 14:56:14,718,3058,347,371,2752.89,4749.22,0.00
2024-12-08 14:56:14,719,3057,347,372,2741.39,4749.39,0.00
2024-12-08 14:56:14,720,3056,347,373,2738.46,4749.43,0.00
2024-12-08 14:56:14,721,3055,347,374,2720.88,4749.75,0.00
2024-12-08 14:56:14,721,3056,347,374,2776.69,4750.00,0.00
2024-12-08 14:56:14,722,3056,348,374,2772.84,4750.00,0.00
2024-12-08 14:56:14,723,3055,348,375,2765.74,4750.05,0.00
2024-12-08 14:56:14,722,3055,348,374,2774.57,4750.05,0.00
2024-12-08 14:56:14,721,3055,348,373,2773.80,4750.14,0.00
2024-12-08 14:56:14,720,3055,347,373,2776.93,4750.16,0.00
2024-12-08 14:56:14,719,3055,347,372,2779.94,4750.17,0.00
2024-12-08 14:56:14,718,3055,346,372,2781.66,4750.22,0.00
2024-12-08 14:56:14,717,3055,346,371,2785.27,4750.22,0.00
2024-12-08 14:56:14,717,3056,346,371,2786.11,4751.00,0.00
2024-12-08 14:56:14,718,3056,347,371,2782.23,4751.00,0.00
2024-12-08 14:56:14,717,3056,346,371,2785.78,4751.01,0.00
2024-12-08 14:56:14,716,3056,346,370,2788.29,4751.02,0.00
2024-12-08 14:56:14,715,3056,346,369,2791.72,4751.03,0.00
2024-12-08 14:56:14,716,3055,347,369,2784.54,4751.10,0.00
2024-12-08 14:56:14,717,3054,347,370,2781.63,4751.18,0.00
2024-12-08 14:56:14,716,3054,347,369,2785.20,4751.22,0.00
2024-12-08 14:56:14,715,3054,347,368,2788.97,4751.22,0.00
2024-12-08 14:56:14,714,3054,346,368,2792.74,4751.22,0.00
2024-12-08 14:56:14,713,3054,345,368,2796.46,4751.23,0.00
2024-12-08 14:56:14,714,3053,346,368,2790.62,4751.27,0.00
2024-12-08 14:56:14,715,3052,346,369,2784.20,4751.46,0.00
2024-12-08 14:56:14,715,3053,346,369,2770.83,4752.00,0.00
2024-12-08 14:56:14,716,3053,347,369,2766.96,4752.00,0.00
2024-12-08 14:56:14,715,3053,347,368,2761.22,4752.18,0.00
2024-12-08 14:56:14,714,3053,346,368,2762.85,4752.22,0.00
2024-12-08 14:56:14,713,3053,345,368,2755.26,4752.43,0.00
2024-12-08 14:56:14,714,3052,346,368,2744.82,4752.57,0.00
2024-12-08 14:56:14,715,3051,347,368,2740.48,4752.62,0.00
2024-12-08 14:56:14,716,3050,347,369,2726.09,4752.89,0.00
2024-12-08 14:56:14,716,3051,347,369,2754.99,4753.00,0.00
2024-12-08 14:56:14,717,3051,347,370,2751.15,4753.00,0.00
2024-12-08 14:56:14,716,3051,347,369,2753.94,4753.02,0.00
2024-12-08 14:56:14,715,3051,346,369,2756.54,4753.05,0.00
2024-12-08 14:56:14,714,3051,346,368,2760.14,4753.05,0.00
2024-12-08 14:56:14,713,3051,345,368,2763.41,4753.06,0.00
2024-12-08 14:56:14,714,3050,346,368,2758.36,4753.09,0.00
2024-12-08 14:56:14,715,3049,346,369,2757.51,4753.12,0.00
2024-12-08 14:56:14,716,3048,347,369,2753.64,4753.20,0.00
2024-12-08 14:56:14,715,3048,346,369,2758.37,4753.22,0.00
2024-12-08 14:56:14,714,3048,346,368,2762.16,4753.22,0.00
2024-12-08 14:56:14,715,3047,346,369,2758.23,4753.23,0.00
2024-12-08 14:56:14,716,3046,346,370,2760.49,4753.24,0.00
2024-12-08 14:56:14,717,3045,346,371,2755.37,4753.41,0.00
2024-12-08 14:56:14,716,3045,345,371,2763.28,4753.43,0.00
2024-12-08 14:56:14,717,3044,346,371,2754.96,4753.52,0.00
2024-12-08 14:56:14,718,3043,347,371,2740.54,4753.83,0.00
2024-12-08 14:56:14,718,3044,347,371,2757.76,4754.00,0.00
2024-12-08 14:56:14,719,3044,347,372,2753.93,4754.00,0.00
2024-12-08 14:56:14,718,3044,347,371,2755.13,4754.03,0.00
2024-12-08 14:56:15,717,3044,347,370,2757.92,4754.05,0.00
2024-12-08 14:56:15,718,3043,347,371,2749.69,4754.15,0.00
2024-12-08 14:56:15,719,3042,348,371,2745.51,4754.21,0.00
2024-12-08 14:56:15,718,3042,347,371,2753.44,4754.22,0.00
2024-12-08 14:56:15,717,3042,346,371,2757.22,4754.22,0.00
2024-12-08 14:56:15,716,3042,346,370,2761.00,4754.22,0.00
2024-12-08 14:56:15,715,3042,346,369,2764.73,4754.22,0.00
2024-12-08 14:56:15,714,3042,346,368,2768.54,4754.22,0.00
2024-12-08 14:56:15,713,3042,345,368,2772.35,4754.23,0.00
2024-12-08 14:56:15,712,3042,344,368,2772.92,4754.30,0.00
2024-12-08 14:56:15,713,3041,345,368,2764.73,4754.39,0.00
2024-12-08 14:56:15,714,3040,346,368,2749.30,4754.68,0.00
2024-12-08 14:56:15,715,3039,347,368,2745.55,4754.73,0.00
2024-12-08 14:56:15,716,3038,347,369,2743.39,4754.74,0.00
2024-12-08 14:56:15,716,3039,347,369,2792.30,4755.00,0.00
2024-12-08 14:56:15,717,3039,347,370,2788.41,4755.00,0.00
2024-12-08 14:56:15,716,3039,346,370,2780.53,4755.22,0.00
2024-12-08 14:56:15,715,3039,346,369,2784.35,4755.22,0.00
2024-12-08 14:56:15,716,3038,347,369,2772.95,4755.38,0.00
2024-12-08 14:56:15,717,3037,347,370,2757.82,4755.66,0.00
2024-12-08 14:56:15,718,3036,347,371,2753.49,4755.72,0.00
2024-12-08 14:56:15,718,3037,347,371,2787.96,4756.00,0.00
2024-12-08 14:56:15,719,3037,348,371,2784.08,4756.00,0.00
2024-12-08 14:56:15,718,3037,347,371,2785.19,4756.03,0.00
2024-12-08 14:56:15,717,3037,347,370,2779.82,4756.23,0.00
2024-12-08 14:56:15,718,3036,347,371,2761.04,4756.54,0.00
2024-12-08 14:56:15,719,3035,347,372,2750.57,4756.73,0.00
2024-12-08 14:56:15,720,3034,348,372,2748.22,4756.75,0.00
2024-12-08 14:56:15,721,3033,349,372,2741.45,4756.85,0.00
2024-12-08 14:56:15,721,3034,349,372,2760.36,4757.00,0.00
2024-12-08 14:56:15,722,3034,350,372,2756.54,4757.00,0.00
2024-12-08 14:56:15,721,3034,350,371,2758.00,4757.02,0.00
2024-12-08 14:56:15,720,3034,349,371,2761.04,4757.04,0.00
2024-12-08 14:56:15,721,3033,349,372,2751.60,4757.16,0.00
2024-12-08 14:56:15,720,3033,349,371,2755.96,4757.18,0.00
2024-12-08 14:56:15,719,3033,349,370,2757.90,4757.22,0.00
2024-12-08 14:56:15,718,3033,348,370,2761.61,4757.22,0.00
2024-12-08 14:56:15,717,3033,347,370,2765.33,4757.23,0.00
2024-12-08 14:56:15,716,3033,347,369,2769.13,4757.23,0.00
2024-12-08 14:56:15,717,3032,347,370,2761.64,4757.31,0.00
2024-12-08 14:56:15,718,3031,347,371,2760.40,4757.38,0.00
2024-12-08 14:56:15,719,3030,348,371,2750.40,4757.62,0.00
2024-12-08 14:56:15,720,3029,348,372,2747.66,4757.66,0.00
2024-12-08 14:56:15,721,3028,349,372,2738.92,4757.79,0.00
2024-12-08 14:56:15,722,3027,350,372,2731.47,4757.90,0.00
2024-12-08 14:56:15,722,3028,350,372,2758.04,4758.00,0.00
2024-12-08 14:56:15,723,3028,351,372,2754.23,4758.00,0.00
2024-12-08 14:56:15,722,3028,351,371,2756.86,4758.02,0.00
2024-12-08 14:56:15,723,3027,352,371,2752.33,4758.04,0.00
2024-12-08 14:56:15,724,3026,353,371,2748.48,4758.07,0.00
2024-12-08 14:56:15,725,3025,353,372,2746.14,4758.08,0.00
2024-12-08 14:56:15,726,3024,354,372,2744.92,4758.09,0.00
2024-12-08 14:56:15,725,3024,354,371,2751.09,4758.13,0.00
2024-12-08 14:56:15,724,3024,354,370,2750.47,4758.23,0.00
2024-12-08 14:56:15,723,3024,353,370,2754.14,4758.23,0.00
2024-12-08 14:56:15,724,3023,354,370,2736.46,4758.52,0.00
2024-12-08 14:56:15,724,3024,354,370,2764.41,4759.00,0.00
2024-12-08 14:56:15,725,3024,355,370,2760.60,4759.00,0.00
2024-12-08 14:56:15,724,3024,355,369,2761.66,4759.03,0.00
2024-12-08 14:56:15,725,3023,356,369,2755.00,4759.09,0.00
2024-12-08 14:56:15,724,3023,355,369,2761.84,4759.11,0.00
2024-12-08 14:56:15,723,3023,354,369,2762.98,4759.17,0.00
2024-12-08 14:56:15,722,3023,353,369,2764.21,4759.22,0.00
2024-12-08 14:56:15,721,3023,353,368,2767.97,4759.22,0.00
2024-12-08 14:56:15,720,3023,353,367,2771.69,4759.22,0.00
2024-12-08 14:56:15,719,3023,352,367,2775.48,4759.22,0.00
2024-12-08 14:56:15,718,3023,352,366,2779.21,4759.22,0.00
2024-12-08 14:56:15,717,3023,351,366,2783.02,4759.22,0.00
2024-12-08 14:56:15,718,3022,352,366,2775.39,4759.31,0.00
2024-12-08 14:56:15,719,3021,352,367,2771.32,4759.43,0.00
2024-12-08 14:56:15,720,3020,352,368,2748.11,4759.85,0.00
2024-12-08 14:56:15,720,3021,352,368,2781.96,4760.00,0.00
2024-12-08 14:56:15,721,3021,353,368,2778.10,4760.00,0.00
2024-12-08 14:56:15,722,3020,353,369,2773.60,4760.02,0.00
2024-12-08 14:56:15,721,3020,353,368,2782.27,4760.02,0.00
2024-12-08 14:56:15,720,3020,353,367,2781.95,4760.11,0.00
2024-12-08 14:56:15,719,3020,352,367,2780.45,4760.22,0.00
2024-12-08 14:56:15,718,3020,352,366,2784.25,4760.22,0.00
2024-12-08 14:56:15,717,3020,351,366,2788.07,4760.22,0.00
2024-12-08 14:56:15,716,3020,351,365,2791.83,4760.22,0.00
2024-12-08 14:56:15,717,3019,352,365,2784.64,4760.30,0.00
2024-12-08 14:56:15,716,3019,351,365,2784.76,4760.50,0.00
2024-12-08 14:56:15,717,3018,351,366,2780.16,4760.52,0.00
2024-12-08 14:56:15,718,3017,352,366,2769.70,4760.71,0.00
2024-12-08 14:56:16,718,3018,352,366,2788.90,4761.00,0.00
2024-12-08 14:56:16,719,3018,352,367,2785.02,4761.00,0.00
2024-12-08 14:56:16,718,3018,352,366,2787.12,4761.02,0.00
2024-12-08 14:56:16,717,3018,351,366,2784.24,4761.16,0.00
2024-12-08 14:56:16,716,3018,350,366,2785.37,4761.22,0.00
2024-12-08 14:56:16,715,3018,349,366,2786.81,4761.27,0.00
2024-12-08 14:56:16,716,3017,349,367,2776.66,4761.41,0.00
2024-12-08 14:56:16,717,3016,350,367,2773.52,4761.42,0.00
2024-12-08 14:56:16,718,3015,351,367,2766.79,4761.52,0.00
2024-12-08 14:56:16,719,3014,351,368,2760.56,4761.65,0.00
2024-12-08 14:56:16,719,3015,351,368,2776.40,4762.00,0.00
2024-12-08 14:56:16,720,3015,352,368,2772.54,4762.00,0.00
2024-12-08 14:56:16,721,3014,352,369,2764.63,4762.06,0.00
2024-12-08 14:56:16,720,3014,352,368,2763.33,4762.22,0.00
2024-12-08 14:56:16,720,3015,352,368,2757.76,4763.00,0.00
2024-12-08 14:56:16,721,3015,353,368,2753.93,4763.00,0.00
2024-12-08 14:56:16,720,3015,353,367,2749.56,4763.15,0.00
2024-12-08 14:56:16,719,3015,353,366,2749.78,4763.22,0.00
2024-12-08 14:56:16,718,3015,352,366,2753.48,4763.22,0.00
2024-12-08 14:56:16,717,3015,351,366,2757.25,4763.22,0.00
2024-12-08 14:56:16,716,3015,351,365,2761.04,4763.22,0.00
2024-12-08 14:56:16,715,3015,350,365,2764.83,4763.22,0.00
2024-12-08 14:56:16,716,3014,351,365,2756.61,4763.32,0.00
2024-12-08 14:56:16,717,3013,352,365,2742.06,4763.59,0.00
2024-12-08 14:56:16,718,3012,353,365,2734.23,4763.74,0.00
2024-12-08 14:56:16,719,3011,353,366,2727.65,4763.85,0.00
2024-12-08 14:56:16,720,3010,354,366,2724.02,4763.87,0.00
2024-12-08 14:56:16,720,3011,354,366,2729.75,4764.00,0.00
2024-12-08 14:56:16,721,3011,354,367,2725.97,4764.00,0.00
2024-12-08 14:56:16,720,3011,354,366,2728.77,4764.02,0.00
2024-12-08 14:56:16,719,3011,353,366,2731.05,4764.05,0.00
2024-12-08 14:56:16,720,3010,353,367,2724.45,4764.11,0.00
2024-12-08 14:56:16,719,3010,353,366,2726.69,4764.20,0.00
2024-12-08 14:56:16,718,3010,353,365,2729.37,4764.22,0.00
2024-12-08 14:56:16,717,3010,353,364,2733.11,4764.22,0.00
2024-12-08 14:56:16,716,3010,353,363,2736.86,4764.22,0.00
2024-12-08 14:56:16,715,3010,353,362,2740.56,4764.22,0.00
2024-12-08 14:56:16,714,3010,352,362,2744.27,4764.22,0.00
2024-12-08 14:56:16,713,3010,352,361,2748.05,4764.23,0.00
2024-12-08 14:56:16,714,3009,352,362,2742.34,4764.27,0.00
2024-12-08 14:56:16,715,3008,353,362,2735.85,4764.46,0.00
2024-12-08 14:56:16,716,3007,354,362,2733.58,4764.49,0.00
2024-12-08 14:56:16,717,3006,354,363,2708.03,4764.96,0.00
2024-12-08 14:56:16,717,3007,354,363,2743.75,4765.00,0.00
2024-12-08 14:56:16,718,3007,354,364,2739.93,4765.00,0.00
2024-12-08 14:56:16,717,3007,353,364,2742.56,4765.03,0.00
2024-12-08 14:56:16,716,3007,353,363,2741.70,4765.10,0.00
2024-12-08 14:56:16,715,3007,353,362,2739.47,4765.22,0.00
2024-12-08 14:56:16,716,3006,354,362,2730.43,4765.34,0.00
2024-12-08 14:56:16,716,3007,354,362,2744.12,4766.00,0.00
2024-12-08 14:56:16,717,3007,355,362,2740.29,4766.00,0.00
2024-12-08 14:56:16,716,3007,355,361,2740.35,4766.05,0.00
2024-12-08 14:56:16,717,3006,356,361,2734.69,4766.09,0.00
2024-12-08 14:56:16,718,3005,356,362,2730.57,4766.14,0.00
2024-12-08 14:56:16,717,3005,356,361,2734.58,4766.15,0.00
2024-12-08 14:56:16,718,3004,357,361,2727.95,4766.21,0.00
2024-12-08 14:56:16,717,3004,356,361,2733.36,4766.23,0.00
2024-12-08 14:56:16,716,3004,356,360,2737.11,4766.23,0.00
2024-12-08 14:56:16,717,3003,357,360,2733.16,4766.23,0.00
2024-12-08 14:56:16,718,3002,358,360,2729.97,4766.29,0.00
2024-12-08 14:56:16,719,3001,358,361,2725.37,4766.43,0.00
2024-12-08 14:56:16,720,3000,359,361,2709.51,4766.73,0.00
2024-12-08 14:56:16,721,2999,359,362,2706.89,4766.76,0.00
2024-12-08 14:56:16,722,2998,359,363,2704.86,4766.77,0.00
2024-12-08 14:56:16,723,2997,359,364,2700.80,4766.87,0.00
2024-12-08 14:56:16,723,2998,359,364,2708.18,4767.00,0.00
2024-12-08 14:56:16,724,2998,359,365,2704.44,4767.00,0.00
2024-12-08 14:56:16,725,2997,359,366,2696.01,4767.08,0.00
2024-12-08 14:56:16,726,2996,359,367,2682.36,4767.31,0.00
2024-12-08 14:56:16,727,2995,359,368,2672.52,4767.49,0.00
2024-12-08 14:56:16,728,2994,359,369,2662.12,4767.66,0.00
2024-12-08 14:56:16,729,2993,360,369,2656.26,4767.76,0.00
2024-12-08 14:56:17,730,2992,360,370,2648.73,4767.89,0.00
2024-12-08 14:56:17,730,2993,360,370,2714.63,4768.00,0.00
2024-12-08 14:56:17,731,2993,360,371,2710.92,4768.00,0.00
2024-12-08 14:56:17,730,2993,359,371,2711.90,4768.03,0.00
2024-12-08 14:56:17,729,2993,358,371,2711.28,4768.12,0.00
2024-12-08 14:56:17,728,2993,357,371,2714.49,4768.13,0.00
2024-12-08 14:56:17,729,2992,358,371,2709.53,4768.16,0.00
2024-12-08 14:56:17,728,2992,358,370,2713.86,4768.19,0.00
2024-12-08 14:56:17,727,2992,358,369,2717.14,4768.20,0.00
2024-12-08 14:56:17,726,2992,357,369,2719.45,4768.23,0.00
2024-12-08 14:56:17,725,2992,356,369,2723.01,4768.23,0.00
2024-12-08 14:56:17,724,2992,355,369,2714.43,4768.49,0.00
2024-12-08 14:56:17,725,2991,356,369,2708.40,4768.54,0.00
2024-12-08 14:56:17,726,2990,356,370,2688.42,4768.96,0.00
2024-12-08 14:56:17,726,2991,356,370,2730.45,4769.00,0.00
2024-12-08 14:56:17,727,2991,356,371,2726.69,4769.00,0.00
2024-12-08 14:56:17,728,2990,356,372,2722.43,4769.02,0.00
2024-12-08 14:56:17,727,2990,356,371,2726.57,4769.03,0.00
2024-12-08 14:56:17,726,2990,356,370,2728.18,4769.07,0.00
2024-12-08 14:56:17,725,2990,356,369,2731.43,4769.08,0.00
2024-12-08 14:56:17,726,2989,357,369,2727.53,4769.09,0.00
2024-12-08 14:56:17,725,2989,357,368,2724.85,4769.23,0.00
2024-12-08 14:56:17,724,2989,357,367,2728.36,4769.23,0.00
2024-12-08 14:56:17,725,2988,358,367,2707.77,4769.59,0.00
2024-12-08 14:56:17,726,2987,358,368,2703.30,4769.67,0.00
2024-12-08 14:56:17,727,2986,358,369,2700.79,4769.71,0.00
2024-12-08 14:56:17,728,2985,358,370,2697.16,4769.73,0.00
2024-12-08 14:56:17,729,2984,358,371,2690.85,4769.83,0.00
2024-12-08 14:56:17,728,2984,357,371,2687.13,4769.97,0.00
2024-12-08 14:56:17,728,2985,357,371,2711.98,4770.00,0.00
2024-12-08 14:56:17,729,2985,358,371,2708.26,4770.00,0.00
2024-12-08 14:56:17,728,2985,358,370,2710.29,4770.03,0.00
2024-12-08 14:56:17,727,2985,357,370,2706.94,4770.18,0.00
2024-12-08 14:56:17,728,2984,358,370,2701.54,4770.21,0.00
2024-12-08 14:56:17,727,2984,358,369,2708.41,4770.23,0.00
2024-12-08 14:56:17,726,2984,357,369,2712.01,4770.23,0.00
2024-12-08 14:56:17,727,2983,358,369,2702.74,4770.35,0.00
2024-12-08 14:56:17,728,2982,358,370,2695.85,4770.43,0.00
2024-12-08 14:56:17,729,2981,358,371,2677.37,4770.78,0.00
2024-12-08 14:56:17,730,2980,358,372,2671.74,4770.86,0.00
2024-12-08 14:56:17,730,2981,358,372,2718.78,4771.00,0.00
2024-12-08 14:56:17,731,2981,359,372,2715.06,4771.00,0.00
2024-12-08 14:56:17,732,2980,360,372,2710.45,4771.02,0.00
2024-12-08 14:56:17,731,2980,360,371,2718.14,4771.03,0.00
2024-12-08 14:56:17,732,2979,361,371,2710.37,4771.12,0.00
2024-12-08 14:56:17,731,2979,361,370,2715.97,4771.12,0.00
2024-12-08 14:56:17,730,2979,361,369,2715.10,4771.22,0.00
2024-12-08 14:56:17,729,2979,361,368,2718.37,4771.23,0.00
2024-12-08 14:56:17,728,2979,360,368,2719.82,4771.27,0.00
2024-12-08 14:56:17,729,2978,361,368,2714.27,4771.31,0.00
2024-12-08 14:56:17,730,2977,361,369,2694.59,4771.69,0.00
2024-12-08 14:56:17,731,2976,361,370,2689.14,4771.78,0.00
2024-12-08 14:56:17,731,2977,361,370,2719.74,4772.00,0.00
2024-12-08 14:56:17,732,2977,361,371,2716.02,4772.00,0.00
2024-12-08 14:56:17,731,2977,361,370,2717.92,4772.03,0.00
2024-12-08 14:56:17,732,2976,362,370,2713.56,4772.05,0.00
2024-12-08 14:56:17,731,2976,362,369,2709.47,4772.23,0.00
2024-12-08 14:56:17,732,2975,362,370,2698.97,4772.37,0.00
2024-12-08 14:56:17,733,2974,363,370,2694.73,4772.43,0.00
2024-12-08 14:56:17,734,2973,364,370,2692.26,4772.51,0.00
2024-12-08 14:56:17,735,2972,365,370,2682.53,4772.69,0.00
2024-12-08 14:56:17,736,2971,365,371,2675.73,4772.81,0.00
2024-12-08 14:56:17,737,2970,366,371,2672.06,4772.84,0.00
2024-12-08 14:56:17,737,2971,366,371,2704.90,4773.00,0.00
2024-12-08 14:56:17,738,2971,366,372,2701.24,4773.00,0.00
2024-12-08 14:56:17,739,2970,367,372,2655.98,4773.84,0.00
2024-12-08 14:56:17,739,2971,367,372,2700.24,4774.00,0.00
2024-12-08 14:56:17,740,2971,367,373,2696.59,4774.00,0.00
2024-12-08 14:56:17,741,2970,368,373,2692.50,4774.01,0.00
2024-12-08 14:56:17,740,2970,368,372,2699.41,4774.03,0.00
2024-12-08 14:56:17,739,2970,367,372,2702.81,4774.03,0.00
2024-12-08 14:56:17,740,2969,367,373,2697.48,4774.04,0.00
2024-12-08 14:56:17,741,2968,368,373,2695.91,4774.05,0.00
2024-12-08 14:56:17,740,2968,367,373,2700.40,4774.08,0.00
2024-12-08 14:56:17,739,2968,367,372,2701.50,4774.13,0.00
2024-12-08 14:56:17,738,2968,366,372,2703.81,4774.16,0.00
2024-12-08 14:56:17,737,2968,366,371,2704.28,4774.23,0.00
2024-12-08 14:56:17,736,2968,366,370,2707.82,4774.23,0.00
2024-12-08 14:56:17,735,2968,365,370,2711.44,4774.23,0.00
2024-12-08 14:56:17,734,2968,365,369,2715.07,4774.23,0.00
2024-12-08 14:56:17,733,2968,365,368,2718.58,4774.23,0.00
2024-12-08 14:56:17,734,2967,366,368,2713.78,4774.26,0.00
2024-12-08 14:56:17,733,2967,365,368,2709.46,4774.45,0.00
2024-12-08 14:56:17,732,2967,364,368,2711.12,4774.46,0.00
2024-12-08 14:56:17,733,2966,365,368,2698.72,4774.65,0.00
2024-12-08 14:56:17,734,2965,366,368,2696.62,4774.67,0.00
2024-12-08 14:56:17,735,2964,366,369,2680.29,4774.94,0.00
2024-12-08 14:56:17,735,2965,366,369,2690.87,4775.00,0.00
2024-12-08 14:56:17,736,2965,366,370,2687.22,4775.00,0.00
2024-12-08 14:56:18,737,2964,367,370,2679.65,4775.06,0.00
2024-12-08 14:56:18,736,2964,367,369,2688.42,4775.06,0.00
2024-12-08 14:56:18,735,2964,367,368,2690.98,4775.08,0.00
2024-12-08 14:56:18,736,2963,368,368,2683.02,4775.18,0.00
2024-12-08 14:56:18,735,2963,368,367,2686.29,4775.20,0.00
2024-12-08 14:56:18,734,2963,368,366,2688.47,4775.23,0.00
2024-12-08 14:56:18,733,2963,367,366,2692.01,4775.23,0.00
2024-12-08 14:56:18,732,2963,367,365,2695.62,4775.23,0.00
2024-12-08 14:56:18,731,2963,366,365,2699.25,4775.23,0.00
2024-12-08 14:56:18,732,2962,366,366,2692.90,4775.29,0.00
2024-12-08 14:56:18,731,2962,365,366,2690.20,4775.50,0.00
2024-12-08 14:56:18,732,2961,366,366,2679.69,4775.64,0.00
2024-12-08 14:56:18,733,2960,367,366,2669.68,4775.79,0.00
2024-12-08 14:56:18,733,2961,367,366,2713.44,4776.00,0.00
2024-12-08 14:56:18,734,2961,368,366,2709.74,4776.00,0.00
2024-12-08 14:56:18,733,2961,368,365,2711.44,4776.03,0.00
2024-12-08 14:56:18,734,2960,369,365,2704.98,4776.10,0.00
2024-12-08 14:56:18,733,2960,368,365,2710.05,4776.11,0.00
2024-12-08 14:56:18,732,2960,367,365,2713.68,4776.11,0.00
2024-12-08 14:56:18,731,2960,367,364,2716.94,4776.12,0.00
2024-12-08 14:56:18,730,2960,367,363,2719.37,4776.15,0.00
2024-12-08 14:56:18,729,2960,366,363,2719.34,4776.22,0.00
2024-12-08 14:56:18,728,2960,366,362,2723.01,4776.22,0.00
2024-12-08 14:56:18,727,2960,366,361,2726.69,4776.22,0.00
2024-12-08 14:56:18,726,2960,365,361,2726.50,4776.31,0.00
2024-12-08 14:56:18,727,2959,365,362,2719.62,4776.38,0.00
2024-12-08 14:56:18,728,2958,365,363,2708.47,4776.64,0.00
2024-12-08 14:56:18,729,2957,366,363,2699.83,4776.73,0.00
2024-12-08 14:56:18,730,2956,366,364,2697.07,4776.76,0.00
2024-12-08 14:56:18,731,2955,367,364,2694.24,4776.78,0.00
2024-12-08 14:56:18,732,2954,368,364,2690.98,4776.81,0.00
2024-12-08 14:56:18,731,2954,367,364,2694.75,4776.84,0.00
2024-12-08 14:56:18,732,2953,367,365,2690.55,4776.86,0.00
2024-12-08 14:56:18,732,2954,367,365,2724.15,4777.00,0.00
2024-12-08 14:56:18,733,2954,368,365,2720.44,4777.00,0.00
2024-12-08 14:56:18,732,2954,368,364,2719.66,4777.03,0.00
2024-12-08 14:56:18,731,2954,367,364,2720.67,4777.09,0.00
2024-12-08 14:56:18,730,2954,367,363,2719.48,4777.19,0.00
2024-12-08 14:56:18,731,2953,367,364,2715.69,4777.20,0.00
2024-12-08 14:56:18,732,2952,367,365,2715.64,4777.20,0.00
2024-12-08 14:56:18,731,2952,366,365,2722.11,4777.22,0.00
2024-12-08 14:56:18,730,2952,365,365,2725.65,4777.23,0.00
2024-12-08 14:56:18,731,2951,366,365,2716.40,4777.35,0.00
2024-12-08 14:56:18,732,2950,366,366,2709.05,4777.54,0.00
2024-12-08 14:56:18,733,2949,367,366,2705.85,4777.60,0.00
2024-12-08 14:56:18,734,2948,367,367,2699.30,4777.71,0.00
2024-12-08 14:56:18,734,2949,367,367,2746.59,4778.00,0.00
2024-12-08 14:56:18,735,2949,367,368,2742.86,4778.00,0.00
2024-12-08 14:56:18,734,2949,367,367,2739.43,4778.12,0.00
2024-12-08 14:56:18,733,2949,367,366,2743.04,4778.13,0.00
2024-12-08 14:56:18,732,2949,366,366,2744.85,4778.17,0.00
2024-12-08 14:56:18,731,2949,366,365,2745.70,4778.23,0.00
2024-12-08 14:56:18,730,2949,365,365,2749.26,4778.23,0.00
2024-12-08 14:56:18,729,2949,364,365,2744.14,4778.42,0.00
2024-12-08 14:56:18,730,2948,364,366,2734.48,4778.54,0.00
2024-12-08 14:56:18,731,2947,365,366,2727.85,4778.64,0.00
2024-12-08 14:56:18,732,2946,365,367,2724.93,4778.68,0.00
2024-12-08 14:56:18,733,2945,366,367,2708.82,4778.97,0.00
2024-12-08 14:56:18,733,2946,366,367,2753.24,4779.00,0.00
2024-12-08 14:56:18,734,2946,367,367,2749.49,4779.00,0.00
2024-12-08 14:56:18,735,2945,368,367,2741.04,4779.08,0.00
2024-12-08 14:56:18,734,2945,368,366,2744.86,4779.11,0.00
2024-12-08 14:56:18,733,2945,368,365,2743.06,4779.23,0.00
2024-12-08 14:56:18,732,2945,368,364,2746.74,4779.23,0.00
2024-12-08 14:56:18,731,2945,368,363,2750.37,4779.23,0.00
2024-12-08 14:56:18,730,2945,367,363,2754.01,4779.23,0.00
2024-12-08 14:56:18,731,2944,367,364,2749.66,4779.25,0.00
2024-12-08 14:56:18,732,2943,367,365,2746.13,4779.38,0.00
2024-12-08 14:56:18,733,2942,367,366,2735.42,4779.54,0.00
2024-12-08 14:56:18,734,2941,367,367,2732.23,4779.57,0.00
2024-12-08 14:56:18,735,2940,367,368,2727.89,4779.61,0.00
2024-12-08 14:56:18,736,2939,367,369,2724.71,4779.63,0.00
2024-12-08 14:56:18,737,2938,368,369,2722.78,4779.65,0.00
2024-12-08 14:56:18,738,2937,369,369,2716.26,4779.77,0.00
2024-12-08 14:56:18,739,2936,370,369,2713.38,4779.80,0.00
2024-12-08 14:56:18,740,2935,371,369,2711.32,4779.80,0.00
2024-12-08 14:56:18,741,2934,371,370,2706.80,4779.85,0.00
2024-12-08 14:56:18,742,2933,372,370,2701.28,4779.92,0.00
2024-12-08 14:56:18,743,2932,373,370,2695.52,4779.96,0.00
2024-12-08 14:56:18,743,2932,373,370,2726.18,4780.00,0.00
2024-12-08 14:56:18,744,2932,374,370,2722.52,4780.00,0.00
2024-12-08 14:56:18,745,2931,374,371,2718.41,4780.01,0.00
2024-12-08 14:56:18,746,2930,375,371,2711.78,4780.06,0.00
2024-12-08 14:56:18,747,2929,376,371,2709.50,4780.06,0.00
2024-12-08 14:56:18,746,2929,376,370,2707.00,4780.23,0.00
2024-12-08 14:56:18,747,2928,376,371,2686.44,4780.59,0.00
2024-12-08 14:56:18,748,2927,377,371,2680.96,4780.64,0.00
2024-12-08 14:56:18,749,2926,377,372,2667.18,4780.92,0.00
2024-12-08 14:56:18,749,2927,377,372,2758.09,4781.00,0.00
2024-12-08 14:56:18,750,2927,377,373,2754.41,4781.00,0.00
2024-12-08 14:56:18,749,2927,376,373,2747.66,4781.19,0.00
2024-12-08 14:56:18,750,2926,377,373,2743.80,4781.20,0.00
2024-12-08 14:56:18,749,2926,377,372,2749.85,4781.23,0.00
2024-12-08 14:56:18,750,2925,377,373,2726.47,4781.65,0.00
2024-12-08 14:56:19,751,2924,377,374,2719.23,4781.78,0.00
2024-12-08 14:56:19,751,2925,377,374,2752.60,4782.00,0.00
2024-12-08 14:56:19,752,2925,377,375,2748.94,4782.00,0.00
2024-12-08 14:56:19,751,2925,377,374,2750.26,4782.04,0.00
2024-12-08 14:56:19,752,2924,377,375,2745.03,4782.07,0.00
2024-12-08 14:56:19,753,2923,378,375,2742.48,4782.11,0.00
2024-12-08 14:56:19,754,2922,379,375,2733.65,4782.24,0.00
2024-12-08 14:56:19,755,2921,379,376,2712.84,4782.65,0.00
2024-12-08 14:56:19,756,2920,379,377,2708.67,4782.72,0.00
2024-12-08 14:56:19,757,2919,379,378,2701.74,4782.81,0.00
2024-12-08 14:56:19,758,2918,379,379,2696.34,4782.88,0.00
2024-12-08 14:56:19,757,2918,378,379,2694.34,4782.97,0.00
2024-12-08 14:56:19,757,2919,378,379,2718.06,4783.00,0.00
2024-12-08 14:56:19,758,2919,379,379,2714.48,4783.00,0.00
2024-12-08 14:56:19,757,2919,378,379,2711.74,4783.11,0.00
2024-12-08 14:56:19,756,2919,378,378,2709.69,4783.23,0.00
2024-12-08 14:56:19,755,2919,377,378,2713.21,4783.23,0.00
2024-12-08 14:56:19,754,2919,376,378,2716.62,4783.23,0.00
2024-12-08 14:56:19,755,2918,377,378,2711.95,4783.25,0.00
2024-12-08 14:56:19,756,2917,377,379,2710.73,4783.33,0.00
2024-12-08 14:56:19,757,2916,378,379,2687.58,4783.82,0.00
2024-12-08 14:56:19,758,2915,378,380,2684.36,4783.84,0.00
2024-12-08 14:56:19,759,2914,379,380,2679.55,4783.90,0.00
2024-12-08 14:56:19,759,2915,379,380,2724.39,4784.00,0.00
2024-12-08 14:56:19,760,2915,380,380,2720.80,4784.00,0.00
2024-12-08 14:56:19,759,2915,379,380,2723.14,4784.03,0.00
2024-12-08 14:56:19,760,2914,380,380,2714.62,4784.11,0.00
2024-12-08 14:56:19,761,2913,381,380,2714.01,4784.11,0.00
2024-12-08 14:56:19,762,2912,381,381,2713.10,4784.14,0.00
2024-12-08 14:56:19,761,2912,381,380,2715.20,4784.23,0.00
2024-12-08 14:56:19,760,2912,380,380,2718.71,4784.23,0.00
2024-12-08 14:56:19,759,2912,379,380,2719.31,4784.29,0.00
2024-12-08 14:56:19,760,2911,380,380,2715.05,4784.31,0.00
2024-12-08 14:56:19,761,2910,381,380,2690.42,4784.87,0.00
2024-12-08 14:56:19,761,2911,381,380,2721.02,4785.00,0.00
2024-12-08 14:56:19,762,2911,382,380,2717.44,4785.00,0.00
2024-12-08 14:56:19,761,2911,381,380,2720.95,4785.00,0.00
2024-12-08 14:56:19,762,2910,381,381,2711.71,4785.10,0.00
2024-12-08 14:56:19,763,2909,381,382,2708.35,4785.11,0.00
2024-12-08 14:56:19,764,2908,382,382,2706.33,4785.15,0.00
2024-12-08 14:56:19,763,2908,382,381,2710.36,4785.23,0.00
2024-12-08 14:56:19,762,2908,382,380,2713.85,4785.23,0.00
2024-12-08 14:56:19,761,2908,381,380,2717.36,4785.23,0.00
2024-12-08 14:56:19,760,2908,380,380,2720.87,4785.23,0.00
2024-12-08 14:56:19,759,2908,380,379,2724.39,4785.23,0.00
2024-12-08 14:56:19,760,2907,381,379,2719.30,4785.27,0.00
2024-12-08 14:56:19,761,2906,381,380,2709.44,4785.45,0.00
2024-12-08 14:56:19,762,2905,382,380,2708.47,4785.47,0.00
2024-12-08 14:56:19,763,2904,383,380,2702.40,4785.57,0.00
2024-12-08 14:56:19,764,2903,384,380,2686.21,4785.86,0.00
2024-12-08 14:56:19,764,2904,384,380,2715.80,4786.00,0.00
2024-12-08 14:56:19,765,2904,384,381,2712.25,4786.00,0.00
2024-12-08 14:56:19,764,2904,383,381,2714.68,4786.02,0.00
2024-12-08 14:56:19,763,2904,383,380,2718.18,4786.02,0.00
2024-12-08 14:56:19,764,2903,383,381,2714.43,4786.03,0.00
2024-12-08 14:56:19,763,2903,383,380,2723.26,4786.03,0.00
2024-12-08 14:56:19,764,2902,384,380,2712.82,4786.18,0.00
2024-12-08 14:56:19,763,2902,384,379,2715.84,4786.23,0.00
2024-12-08 14:56:19,762,2902,384,378,2719.34,4786.23,0.00
2024-12-08 14:56:19,761,2902,383,378,2722.85,4786.23,0.00
2024-12-08 14:56:19,760,2902,382,378,2726.37,4786.23,0.00
2024-12-08 14:56:19,759,2902,381,378,2729.83,4786.23,0.00
2024-12-08 14:56:19,760,2901,382,378,2725.11,4786.25,0.00
2024-12-08 14:56:19,759,2901,381,378,2714.09,4786.59,0.00
2024-12-08 14:56:19,760,2900,381,379,2708.96,4786.63,0.00
2024-12-08 14:56:19,761,2899,382,379,2706.75,4786.66,0.00
2024-12-08 14:56:19,762,2898,383,379,2699.27,4786.80,0.00
2024-12-08 14:56:19,763,2897,383,380,2695.08,4786.85,0.00
2024-12-08 14:56:19,764,2896,383,381,2688.37,4786.94,0.00
2024-12-08 14:56:19,764,2897,383,381,2739.74,4787.00,0.00
2024-12-08 14:56:19,765,2897,384,381,2736.16,4787.00,0.00
2024-12-08 14:56:19,766,2896,385,381,2731.90,4787.02,0.00
2024-12-08 14:56:19,767,2895,385,382,2727.80,4787.06,0.00
2024-12-08 14:56:19,766,2895,384,382,2736.80,4787.06,0.00
2024-12-08 14:56:19,767,2894,385,382,2729.96,4787.13,0.00
2024-12-08 14:56:19,766,2894,385,381,2736.03,4787.13,0.00
2024-12-08 14:56:19,767,2893,385,382,2732.21,4787.14,0.00
2024-12-08 14:56:19,766,2893,385,381,2734.89,4787.23,0.00
2024-12-08 14:56:19,765,2893,385,380,2738.40,4787.23,0.00
2024-12-08 14:56:19,764,2893,385,379,2741.86,4787.23,0.00
2024-12-08 14:56:19,765,2892,385,380,2734.79,4787.31,0.00
2024-12-08 14:56:19,766,2891,386,380,2730.80,4787.34,0.00
2024-12-08 14:56:19,767,2890,387,380,2728.99,4787.36,0.00
2024-12-08 14:56:19,768,2889,388,380,2725.97,4787.45,0.00
2024-12-08 14:56:19,767,2889,387,380,2728.41,4787.46,0.00
2024-12-08 14:56:19,768,2888,388,380,2713.21,4787.71,0.00
2024-12-08 14:56:19,769,2887,388,381,2708.71,4787.83,0.00
2024-12-08 14:56:19,770,2886,388,382,2701.37,4787.94,0.00
2024-12-08 14:56:19,770,2887,388,382,2754.84,4788.00,0.00
2024-12-08 14:56:19,771,2887,389,382,2751.26,4788.00,0.00
2024-12-08 14:56:19,772,2886,389,383,2746.72,4788.02,0.00
2024-12-08 14:56:19,773,2885,390,383,2745.40,4788.03,0.00
2024-12-08 14:56:19,772,2885,390,382,2752.68,4788.04,0.00
2024-12-08 14:56:19,773,2884,391,382,2743.91,4788.15,0.00
2024-12-08 14:56:19,772,2884,390,382,2751.75,4788.15,0.00
2024-12-08 14:56:19,773,2883,390,383,2747.94,4788.16,0.00
2024-12-08 14:56:19,772,2883,390,382,2752.90,4788.23,0.00
2024-12-08 14:56:19,771,2883,390,381,2756.41,4788.23,0.00
2024-12-08 14:56:19,770,2883,389,381,2759.93,4788.23,0.00
2024-12-08 14:56:19,769,2883,388,381,2749.49,4788.52,0.00
2024-12-08 14:56:19,770,2882,389,381,2739.66,4788.66,0.00
2024-12-08 14:56:20,770,2883,389,381,2797.08,4789.00,0.00
2024-12-08 14:56:20,771,2883,390,381,2793.45,4789.00,0.00
2024-12-08 14:56:20,772,2882,390,382,2786.75,4789.04,0.00
2024-12-08 14:56:20,773,2881,391,382,2781.84,4789.15,0.00
2024-12-08 14:56:20,772,2881,391,381,2785.98,4789.23,0.00
2024-12-08 14:56:20,771,2881,390,381,2789.53,4789.23,0.00
2024-12-08 14:56:20,770,2881,389,381,2793.10,4789.23,0.00
2024-12-08 14:56:20,771,2880,390,381,2769.65,4789.65,0.00
2024-12-08 14:56:20,771,2881,390,381,2792.28,4790.00,0.00
2024-12-08 14:56:20,772,2881,391,381,2788.67,4790.00,0.00
2024-12-08 14:56:20,771,2881,390,381,2788.64,4790.05,0.00
2024-12-08 14:56:20,772,2880,390,382,2782.95,4790.10,0.00
2024-12-08 14:56:20,771,2880,390,381,2782.77,4790.23,0.00
2024-12-08 14:56:20,772,2879,391,381,2771.83,4790.38,0.00
2024-12-08 14:56:20,773,2878,392,381,2760.53,4790.58,0.00
2024-12-08 14:56:20,772,2878,391,381,2765.72,4790.61,0.00
2024-12-08 14:56:20,773,2877,392,381,2752.50,4790.82,0.00
2024-12-08 14:56:20,774,2876,392,382,2748.84,4790.85,0.00
2024-12-08 14:56:20,774,2877,392,382,2766.42,4791.00,0.00
2024-12-08 14:56:20,775,2877,392,383,2762.85,4791.00,0.00
2024-12-08 14:56:20,774,2877,391,383,2765.62,4791.02,0.00
2024-12-08 14:56:20,773,2877,390,383,2758.03,4791.23,0.00
2024-12-08 14:56:20,774,2876,390,384,2747.82,4791.37,0.00
2024-12-08 14:56:20,775,2875,390,385,2746.13,4791.37,0.00
2024-12-08 14:56:20,776,2874,390,386,2738.38,4791.49,0.00
2024-12-08 14:56:20,777,2873,390,387,2731.24,4791.65,0.00
2024-12-08 14:56:20,778,2872,391,387,2722.90,4791.79,0.00
2024-12-08 14:56:20,778,2873,391,387,2749.48,4792.00,0.00
2024-12-08 14:56:20,779,2873,391,388,2745.95,4792.00,0.00
2024-12-08 14:56:20,780,2872,391,389,2731.60,4792.21,0.00
2024-12-08 14:56:20,779,2872,391,388,2735.42,4792.23,0.00
2024-12-08 14:56:20,778,2872,390,388,2738.88,4792.23,0.00
2024-12-08 14:56:20,777,2872,390,387,2742.34,4792.23,0.00
2024-12-08 14:56:20,776,2872,390,386,2745.75,4792.23,0.00
2024-12-08 14:56:20,777,2871,391,386,2724.97,4792.59,0.00
2024-12-08 14:56:20,778,2870,392,386,2710.17,4792.90,0.00
2024-12-08 14:56:20,779,2869,392,387,2705.86,4792.93,0.00
2024-12-08 14:56:20,779,2870,392,387,2737.54,4793.00,0.00
2024-12-08 14:56:20,780,2870,393,387,2734.03,4793.00,0.00
2024-12-08 14:56:20,779,2870,393,386,2735.90,4793.03,0.00
2024-12-08 14:56:20,778,2870,393,385,2737.89,4793.06,0.00
2024-12-08 14:56:20,779,2869,394,385,2728.47,4793.19,0.00
2024-12-08 14:56:20,780,2868,395,385,2726.03,4793.22,0.00
2024-12-08 14:56:20,779,2868,394,385,2730.46,4793.23,0.00
2024-12-08 14:56:20,778,2868,394,384,2733.90,4793.23,0.00
2024-12-08 14:56:20,777,2868,394,383,2737.30,4793.23,0.00
2024-12-08 14:56:20,776,2868,394,382,2740.76,4793.23,0.00
2024-12-08 14:56:20,777,2867,395,382,2711.28,4793.78,0.00
2024-12-08 14:56:20,778,2866,395,383,2705.40,4793.86,0.00
2024-12-08 14:56:20,779,2865,395,384,2699.89,4793.93,0.00
2024-12-08 14:56:20,778,2865,394,384,2700.43,4793.97,0.00
2024-12-08 14:56:20,778,2866,394,384,2730.02,4794.00,0.00
2024-12-08 14:56:20,779,2866,395,384,2726.52,4794.00,0.00
2024-12-08 14:56:20,780,2865,396,384,2713.58,4794.18,0.00
2024-12-08 14:56:20,781,2864,397,384,2711.46,4794.19,0.00
2024-12-08 14:56:20,780,2864,397,383,2717.09,4794.20,0.00
2024-12-08 14:56:20,779,2864,396,383,2719.12,4794.23,0.00
2024-12-08 14:56:20,778,2864,396,382,2722.49,4794.23,0.00
2024-12-08 14:56:20,777,2864,395,382,2725.94,4794.23,0.00
2024-12-08 14:56:20,778,2863,395,383,2718.02,4794.32,0.00
2024-12-08 14:56:20,779,2862,396,383,2713.90,4794.45,0.00
2024-12-08 14:56:20,780,2861,396,384,2712.53,4794.49,0.00
2024-12-08 14:56:20,781,2860,396,385,2707.97,4794.54,0.00
2024-12-08 14:56:20,782,2859,397,385,2699.10,4794.73,0.00
2024-12-08 14:56:20,783,2858,398,385,2695.81,4794.77,0.00
2024-12-08 14:56:20,783,2859,398,385,2722.54,4795.00,0.00
2024-12-08 14:56:20,784,2859,399,385,2719.06,4795.00,0.00
2024-12-08 14:56:20,783,2859,398,385,2722.23,4795.01,0.00
2024-12-08 14:56:20,782,2859,397,385,2724.86,4795.02,0.00
2024-12-08 14:56:20,783,2858,398,385,2717.68,4795.08,0.00
2024-12-08 14:56:20,782,2858,398,384,2722.71,4795.12,0.00
2024-12-08 14:56:20,783,2857,398,385,2717.29,4795.17,0.00
2024-12-08 14:56:20,782,2857,398,384,2720.92,4795.22,0.00
2024-12-08 14:56:20,781,2857,398,383,2724.28,4795.22,0.00
2024-12-08 14:56:20,780,2857,397,383,2727.71,4795.22,0.00
2024-12-08 14:56:20,781,2856,398,383,2723.61,4795.24,0.00
2024-12-08 14:56:20,782,2855,398,384,2723.75,4795.25,0.00
2024-12-08 14:56:20,783,2854,398,385,2710.49,4795.48,0.00
2024-12-08 14:56:20,784,2853,399,385,2706.17,4795.59,0.00
2024-12-08 14:56:21,785,2852,399,386,2701.24,4795.66,0.00
2024-12-08 14:56:21,786,2851,399,387,2693.33,4795.81,0.00
2024-12-08 14:56:21,786,2852,399,387,2739.41,4796.00,0.00
2024-12-08 14:56:21,787,2852,400,387,2735.93,4796.00,0.00
2024-12-08 14:56:21,788,2851,401,387,2726.30,4796.11,0.00
2024-12-08 14:56:21,789,2850,402,387,2722.10,4796.20,0.00
2024-12-08 14:56:21,788,2850,401,387,2724.90,4796.23,0.00
2024-12-08 14:56:21,787,2850,400,387,2728.30,4796.23,0.00
2024-12-08 14:56:21,788,2849,400,388,2717.22,4796.39,0.00
2024-12-08 14:56:21,789,2848,401,388,2711.00,4796.46,0.00
2024-12-08 14:56:22,790,2847,402,388,2703.44,4796.58,0.00
2024-12-08 14:56:22,791,2846,403,388,2698.93,4796.67,0.00
2024-12-08 14:56:22,792,2845,404,388,2695.73,4796.72,0.00
2024-12-08 14:56:22,793,2844,404,389,2692.13,4796.76,0.00
2024-12-08 14:56:22,794,2843,405,389,2682.57,4796.87,0.00
2024-12-08 14:56:22,794,2844,405,389,2731.61,4797.00,0.00
2024-12-08 14:56:22,795,2844,405,390,2728.18,4797.00,0.00
2024-12-08 14:56:22,796,2843,406,390,2723.56,4797.03,0.00
2024-12-08 14:56:22,795,2843,406,389,2727.47,4797.04,0.00
2024-12-08 14:56:22,794,2843,406,388,2724.39,4797.17,0.00
2024-12-08 14:56:22,793,2843,405,388,2725.37,4797.23,0.00
2024-12-08 14:56:22,794,2842,405,389,2720.38,4797.26,0.00
2024-12-08 14:56:22,795,2841,406,389,2703.08,4797.58,0.00
2024-12-08 14:56:22,796,2840,407,389,2696.78,4797.65,0.00
2024-12-08 14:56:22,795,2840,406,389,2693.53,4797.80,0.00
2024-12-08 14:56:22,796,2839,407,389,2689.97,4797.80,0.00
2024-12-08 14:56:22,797,2838,408,389,2681.83,4797.93,0.00
2024-12-08 14:56:22,798,2837,408,390,2676.77,4797.98,0.00
2024-12-08 14:56:22,798,2838,408,390,2736.00,4798.00,0.00
2024-12-08 14:56:22,799,2838,408,391,2732.58,4798.00,0.00
2024-12-08 14:56:22,798,2838,407,391,2734.69,4798.03,0.00
2024-12-08 14:56:22,799,2837,408,391,2725.43,4798.13,0.00
2024-12-08 14:56:22,798,2837,408,390,2727.57,4798.22,0.00
2024-12-08 14:56:22,797,2837,407,390,2730.94,4798.23,0.00
2024-12-08 14:56:22,796,2837,406,390,2734.31,4798.23,0.00
2024-12-08 14:56:22,795,2837,406,389,2737.69,4798.23,0.00
2024-12-08 14:56:22,794,2837,405,389,2741.01,4798.23,0.00
2024-12-08 14:56:22,793,2837,405,388,2744.41,4798.23,0.00
2024-12-08 14:56:22,794,2836,406,388,2732.60,4798.40,0.00
2024-12-08 14:56:22,795,2835,406,389,2727.38,4798.47,0.00
2024-12-08 14:56:22,796,2834,407,389,2715.57,4798.67,0.00
2024-12-08 14:56:22,797,2833,407,390,2711.19,4798.74,0.00
2024-12-08 14:56:22,798,2832,407,391,2702.01,4798.87,0.00
2024-12-08 14:56:22,799,2831,407,392,2696.06,4798.94,0.00
2024-12-08 14:56:22,799,2832,407,392,2741.75,4799.00,0.00
2024-12-08 14:56:22,800,2832,407,393,2738.32,4799.00,0.00
2024-12-08 14:56:22,801,2831,407,394,2731.69,4799.05,0.00
2024-12-08 14:56:22,802,2830,407,395,2728.31,4799.10,0.00
2024-12-08 14:56:22,803,2829,407,396,2721.44,4799.21,0.00
2024-12-08 14:56:22,802,2829,407,395,2727.36,4799.23,0.00
2024-12-08 14:56:22,801,2829,406,395,2730.58,4799.23,0.00
2024-12-08 14:56:22,802,2828,406,396,2726.17,4799.25,0.00
2024-12-08 14:56:22,803,2827,406,397,2723.79,4799.28,0.00
2024-12-08 14:56:22,804,2826,407,397,2720.50,4799.40,0.00
2024-12-08 14:56:22,805,2825,407,398,2715.89,4799.45,0.00
2024-12-08 14:56:22,806,2824,408,398,2710.39,4799.58,0.00
2024-12-08 14:56:22,807,2823,409,398,2700.12,4799.75,0.00
2024-12-08 14:56:22,808,2822,410,398,2697.80,4799.77,0.00
2024-12-08 14:56:22,808,2823,410,398,2734.82,4800.00,0.00
2024-12-08 14:56:22,809,2823,410,399,2731.44,4800.00,0.00
2024-12-08 14:56:22,810,2822,411,399,2727.83,4800.01,0.00
2024-12-08 14:56:22,809,2822,411,398,2730.88,4800.07,0.00
2024-12-08 14:56:22,810,2821,412,398,2726.45,4800.09,0.00
2024-12-08 14:56:22,809,2821,411,398,2733.44,4800.10,0.00
2024-12-08 14:56:22,808,2821,410,398,2731.07,4800.22,0.00
2024-12-08 14:56:22,807,2821,410,397,2734.27,4800.23,0.00
2024-12-08 14:56:22,806,2821,409,397,2737.61,4800.23,0.00
2024-12-08 14:56:22,805,2821,409,396,2740.95,4800.23,0.00
2024-12-08 14:56:22,804,2821,408,396,2730.96,4800.51,0.00
2024-12-08 14:56:22,805,2820,409,396,2724.39,4800.58,0.00
2024-12-08 14:56:22,806,2819,410,396,2715.72,4800.70,0.00
2024-12-08 14:56:22,806,2820,410,396,2766.81,4801.00,0.00
2024-12-08 14:56:22,807,2820,411,396,2763.38,4801.00,0.00
2024-12-08 14:56:22,806,2820,411,395,2764.03,4801.04,0.00
2024-12-08 14:56:22,807,2819,411,396,2757.36,4801.11,0.00
2024-12-08 14:56:22,806,2819,410,396,2762.58,4801.12,0.00
2024-12-08 14:56:22,805,2819,410,395,2761.24,4801.22,0.00
2024-12-08 14:56:22,804,2819,409,395,2764.61,4801.22,0.00
2024-12-08 14:56:22,803,2819,408,395,2767.93,4801.23,0.00
2024-12-08 14:56:22,802,2819,407,395,2771.33,4801.23,0.00
2024-12-08 14:56:22,801,2819,406,395,2774.73,4801.23,0.00
2024-12-08 14:56:22,800,2819,406,394,2778.13,4801.23,0.00
2024-12-08 14:56:22,801,2818,407,394,2763.60,4801.46,0.00
2024-12-08 14:56:22,800,2818,406,394,2768.33,4801.51,0.00
2024-12-08 14:56:22,801,2817,407,394,2764.70,4801.51,0.00
2024-12-08 14:56:22,802,2816,408,394,2761.99,4801.55,0.00
2024-12-08 14:56:22,803,2815,408,395,2759.71,4801.60,0.00
2024-12-08 14:56:22,804,2814,408,396,2749.77,4801.77,0.00
2024-12-08 14:56:22,803,2814,407,396,2751.27,4801.81,0.00
2024-12-08 14:56:22,804,2813,408,396,2743.15,4801.91,0.00
2024-12-08 14:56:22,804,2814,408,396,2769.09,4802.00,0.00
2024-12-08 14:56:22,805,2814,409,396,2765.65,4802.00,0.00
2024-12-08 14:56:22,804,2814,408,396,2768.97,4802.00,0.00
2024-12-08 14:56:22,803,2814,408,395,2769.63,4802.04,0.00
2024-12-08 14:56:22,802,2814,408,394,2765.77,4802.14,0.00
2024-12-08 14:56:22,801,2814,408,393,2767.62,4802.17,0.00
2024-12-08 14:56:22,802,2813,408,394,2762.63,4802.21,0.00
2024-12-08 14:56:22,801,2813,408,393,2769.33,4802.23,0.00
2024-12-08 14:56:22,800,2813,408,392,2772.61,4802.23,0.00
2024-12-08 14:56:22,801,2812,408,393,2767.95,4802.26,0.00
2024-12-08 14:56:22,802,2811,408,394,2757.69,4802.46,0.00
2024-12-08 14:56:23,803,2810,409,394,2738.91,4802.87,0.00
2024-12-08 14:56:23,803,2811,409,394,2781.56,4803.00,0.00
2024-12-08 14:56:23,804,2811,410,394,2778.10,4803.00,0.00
2024-12-08 14:56:23,803,2811,410,393,2772.55,4803.13,0.00
2024-12-08 14:56:23,804,2810,411,393,2766.92,4803.17,0.00
2024-12-08 14:56:23,805,2809,411,394,2764.15,4803.21,0.00
2024-12-08 14:56:23,804,2809,410,394,2768.80,4803.23,0.00
2024-12-08 14:56:23,803,2809,409,394,2772.13,4803.23,0.00
2024-12-08 14:56:23,804,2808,409,395,2746.78,4803.69,0.00
2024-12-08 14:56:23,805,2807,409,396,2737.71,4803.86,0.00
2024-12-08 14:56:23,806,2806,409,397,2729.24,4803.99,0.00
2024-12-08 14:56:23,806,2807,409,397,2758.40,4804.00,0.00
2024-12-08 14:56:23,807,2807,409,398,2754.98,4804.00,0.00
2024-12-08 14:56:23,808,2806,410,398,2750.39,4804.03,0.00
2024-12-08 14:56:23,807,2806,410,397,2756.96,4804.04,0.00
2024-12-08 14:56:23,808,2805,410,398,2751.66,4804.08,0.00
2024-12-08 14:56:23,807,2805,410,397,2755.97,4804.09,0.00
2024-12-08 14:56:23,808,2804,410,398,2746.38,4804.22,0.00
2024-12-08 14:56:23,807,2804,409,398,2751.99,4804.23,0.00
2024-12-08 14:56:23,806,2804,409,397,2755.29,4804.23,0.00
2024-12-08 14:56:23,805,2804,409,396,2758.59,4804.23,0.00
2024-12-08 14:56:23,806,2803,409,397,2752.68,4804.28,0.00
2024-12-08 14:56:23,806,2804,409,397,2752.83,4805.00,0.00
2024-12-08 14:56:23,807,2804,409,398,2749.42,4805.00,0.00
2024-12-08 14:56:23,808,2803,409,399,2744.49,4805.04,0.00
2024-12-08 14:56:23,809,2802,410,399,2739.87,4805.09,0.00
2024-12-08 14:56:23,808,2802,410,398,2741.49,4805.23,0.00
2024-12-08 14:56:23,807,2802,409,398,2744.83,4805.23,0.00
2024-12-08 14:56:23,806,2802,409,397,2748.18,4805.23,0.00
2024-12-08 14:56:23,805,2802,408,397,2751.53,4805.23,0.00
2024-12-08 14:56:23,806,2801,409,397,2746.39,4805.27,0.00
2024-12-08 14:56:23,807,2800,410,397,2743.06,4805.31,0.00
2024-12-08 14:56:23,808,2799,410,398,2740.09,4805.33,0.00
2024-12-08 14:56:23,807,2799,409,398,2740.92,4805.41,0.00
2024-12-08 14:56:23,806,2799,408,398,2742.39,4805.45,0.00
2024-12-08 14:56:23,806,2800,408,398,2746.11,4806.00,0.00
2024-12-08 14:56:23,807,2800,408,399,2742.71,4806.00,0.00
2024-12-08 14:56:23,806,2800,408,398,2738.25,4806.14,0.00
2024-12-08 14:56:23,805,2800,408,397,2737.45,4806.23,0.00
2024-12-08 14:56:23,804,2800,407,397,2740.80,4806.23,0.00
2024-12-08 14:56:23,805,2799,407,398,2731.87,4806.35,0.00
2024-12-08 14:56:23,804,2799,406,398,2734.40,4806.36,0.00
2024-12-08 14:56:23,805,2798,407,398,2726.39,4806.46,0.00
2024-12-08 14:56:23,806,2797,408,398,2722.43,4806.51,0.00
2024-12-08 14:56:23,805,2797,407,398,2729.37,4806.51,0.00
2024-12-08 14:56:23,804,2797,406,398,2732.52,4806.51,0.00
2024-12-08 14:56:23,805,2796,407,398,2728.83,4806.52,0.00
2024-12-08 14:56:23,806,2795,407,399,2725.52,4806.54,0.00
2024-12-08 14:56:23,807,2794,408,399,2719.24,4806.68,0.00
2024-12-08 14:56:23,808,2793,408,400,2711.32,4806.79,0.00
2024-12-08 14:56:23,808,2794,408,400,2738.27,4807.00,0.00
2024-12-08 14:56:23,809,2794,408,401,2734.89,4807.00,0.00
2024-12-08 14:56:23,808,2794,407,401,2731.36,4807.12,0.00
2024-12-08 14:56:23,809,2793,408,401,2725.22,4807.18,0.00
2024-12-08 14:56:23,808,2793,408,400,2727.67,4807.23,0.00
2024-12-08 14:56:23,809,2792,408,401,2722.17,4807.27,0.00
2024-12-08 14:56:23,810,2791,408,402,2717.28,4807.33,0.00
2024-12-08 14:56:23,811,2790,409,402,2706.48,4807.52,0.00
2024-12-08 14:56:23,812,2789,410,402,2702.53,4807.58,0.00
2024-12-08 14:56:23,813,2788,410,403,2699.38,4807.65,0.00
2024-12-08 14:56:23,814,2787,410,404,2692.23,4807.74,0.00
2024-12-08 14:56:23,814,2788,410,404,2727.40,4808.00,0.00
2024-12-08 14:56:23,815,2788,410,405,2724.05,4808.00,0.00
2024-12-08 14:56:23,814,2788,410,404,2721.24,4808.10,0.00
2024-12-08 14:56:23,813,2788,409,404,2722.19,4808.15,0.00
2024-12-08 14:56:23,812,2788,409,403,2723.96,4808.19,0.00
2024-12-08 14:56:23,811,2788,409,402,2725.39,4808.23,0.00
2024-12-08 14:56:23,810,2788,408,402,2728.69,4808.23,0.00
2024-12-08 14:56:23,811,2787,409,402,2723.14,4808.27,0.00
2024-12-08 14:56:23,812,2786,410,402,2720.70,4808.37,0.00
2024-12-08 14:56:23,813,2785,411,402,2716.58,4808.49,0.00
2024-12-08 14:56:23,814,2784,411,403,2714.81,4808.54,0.00
2024-12-08 14:56:23,815,2783,411,404,2709.22,4808.71,0.00
2024-12-08 14:56:23,815,2784,411,404,2743.26,4809.00,0.00
2024-12-08 14:56:23,816,2784,412,404,2739.90,4809.00,0.00
2024-12-08 14:56:23,815,2784,411,404,2736.35,4809.12,0.00
2024-12-08 14:56:23,814,2784,410,404,2739.36,4809.13,0.00
2024-12-08 14:56:23,815,2783,410,405,2735.59,4809.14,0.00
2024-12-08 14:56:23,816,2782,411,405,2731.87,4809.22,0.00
2024-12-08 14:56:23,815,2782,411,404,2739.54,4809.23,0.00
2024-12-08 14:56:23,816,2781,411,405,2727.74,4809.40,0.00
2024-12-08 14:56:23,817,2780,411,406,2724.60,4809.45,0.00
2024-12-08 14:56:23,818,2779,412,406,2721.06,4809.49,0.00
2024-12-08 14:56:23,819,2778,412,407,2719.05,4809.55,0.00
2024-12-08 14:56:23,819,2779,412,407,2732.97,4810.00,0.00
2024-12-08 14:56:24,820,2779,413,407,2729.64,4810.00,0.00
2024-12-08 14:56:24,819,2779,413,406,2730.22,4810.04,0.00
2024-12-08 14:56:24,820,2778,414,406,2726.02,4810.06,0.00
2024-12-08 14:56:24,819,2778,413,406,2730.24,4810.08,0.00
2024-12-08 14:56:24,818,2778,412,406,2732.53,4810.10,0.00
2024-12-08 14:56:24,819,2777,412,407,2723.85,4810.21,0.00
2024-12-08 14:56:24,818,2777,412,406,2730.60,4810.22,0.00
2024-12-08 14:56:24,817,2777,412,405,2733.82,4810.22,0.00
2024-12-08 14:56:24,816,2777,412,404,2737.11,4810.22,0.00
2024-12-08 14:56:24,815,2777,412,403,2740.41,4810.23,0.00
2024-12-08 14:56:24,814,2777,412,402,2743.72,4810.23,0.00
2024-12-08 14:56:24,813,2777,412,401,2747.03,4810.23,0.00
2024-12-08 14:56:24,812,2777,412,400,2750.36,4810.23,0.00
2024-12-08 14:56:24,811,2777,411,400,2753.69,4810.23,0.00
2024-12-08 14:56:24,810,2777,411,399,2757.03,4810.23,0.00
2024-12-08 14:56:24,811,2776,411,400,2753.51,4810.23,0.00
2024-12-08 14:56:24,812,2775,412,400,2745.44,4810.42,0.00
2024-12-08 14:56:24,813,2774,413,400,2741.44,4810.47,0.00
2024-12-08 14:56:24,814,2773,413,401,2739.75,4810.52,0.00
2024-12-08 14:56:24,815,2772,414,401,2730.55,4810.72,0.00
2024-12-08 14:56:24,816,2771,414,402,2725.26,4810.80,0.00
2024-12-08 14:56:24,817,2770,414,403,2720.73,4810.86,0.00
2024-12-08 14:56:24,816,2770,413,403,2719.00,4810.96,0.00
2024-12-08 14:56:24,816,2771,413,403,2758.41,4811.00,0.00
2024-12-08 14:56:24,817,2771,414,403,2755.04,4811.00,0.00
2024-12-08 14:56:24,818,2770,415,403,2748.75,4811.04,0.00
2024-12-08 14:56:24,817,2770,414,403,2755.82,4811.05,0.00
2024-12-08 14:56:24,816,2770,414,402,2758.62,4811.06,0.00
2024-12-08 14:56:24,817,2769,415,402,2753.02,4811.11,0.00
2024-12-08 14:56:24,816,2769,415,401,2758.07,4811.14,0.00
2024-12-08 14:56:24,815,2769,415,400,2757.66,4811.22,0.00
2024-12-08 14:56:24,814,2769,415,399,2760.98,4811.22,0.00
2024-12-08 14:56:24,813,2769,414,399,2764.26,4811.22,0.00
2024-12-08 14:56:24,812,2769,414,398,2767.61,4811.22,0.00
2024-12-08 14:56:24,811,2769,413,398,2770.96,4811.22,0.00
2024-12-08 14:56:24,812,2768,413,399,2764.78,4811.28,0.00
2024-12-08 14:56:24,813,2767,414,399,2765.70,4811.31,0.00
2024-12-08 14:56:24,812,2767,413,399,2764.40,4811.51,0.00
2024-12-08 14:56:24,813,2766,413,400,2746.87,4811.80,0.00
2024-12-08 14:56:24,814,2765,413,401,2741.61,4811.87,0.00
2024-12-08 14:56:24,814,2766,413,401,2795.45,4812.00,0.00
2024-12-08 14:56:24,815,2766,413,402,2792.02,4812.00,0.00
2024-12-08 14:56:24,816,2765,414,402,2788.43,4812.01,0.00
2024-12-08 14:56:24,815,2765,413,402,2791.97,4812.02,0.00
2024-12-08 14:56:24,816,2764,413,403,2785.21,4812.07,0.00
2024-12-08 14:56:24,817,2763,413,404,2781.17,4812.11,0.00
2024-12-08 14:56:24,818,2762,413,405,2776.74,4812.16,0.00
2024-12-08 14:56:24,819,2761,414,405,2775.00,4812.18,0.00
2024-12-08 14:56:24,820,2760,414,406,2772.74,4812.20,0.00
2024-12-08 14:56:24,819,2760,413,406,2775.85,4812.23,0.00
2024-12-08 14:56:24,818,2760,412,406,2779.12,4812.23,0.00
2024-12-08 14:56:24,817,2760,411,406,2782.47,4812.23,0.00
2024-12-08 14:56:24,816,2760,410,406,2785.76,4812.23,0.00
2024-12-08 14:56:24,817,2759,411,406,2771.71,4812.45,0.00
2024-12-08 14:56:24,816,2759,410,406,2773.03,4812.50,0.00
2024-12-08 14:56:24,817,2758,411,406,2766.49,4812.57,0.00
2024-12-08 14:56:24,818,2757,411,407,2766.34,4812.58,0.00
2024-12-08 14:56:24,819,2756,411,408,2763.68,4812.58,0.00
2024-12-08 14:56:24,820,2755,411,409,2763.85,4812.62,0.00
2024-12-08 14:56:24,821,2754,411,410,2761.15,4812.66,0.00
2024-12-08 14:56:24,822,2753,412,410,2757.71,4812.71,0.00
2024-12-08 14:56:24,823,2752,412,411,2752.78,4812.79,0.00
2024-12-08 14:56:24,824,2751,413,411,2745.04,4812.91,0.00
2024-12-08 14:56:24,824,2752,413,411,2782.38,4813.00,0.00
2024-12-08 14:56:24,825,2752,414,411,2779.01,4813.00,0.00
2024-12-08 14:56:24,824,2752,413,411,2781.68,4813.02,0.00
2024-12-08 14:56:24,823,2752,412,411,2780.71,4813.08,0.00
2024-12-08 14:56:24,822,2752,411,411,2781.54,4813.13,0.00
2024-12-08 14:56:24,823,2751,411,412,2773.63,4813.20,0.00
2024-12-08 14:56:24,822,2751,410,412,2778.89,4813.22,0.00
2024-12-08 14:56:24,821,2751,409,412,2782.21,4813.22,0.00
2024-12-08 14:56:24,820,2751,409,411,2785.49,4813.22,0.00
2024-12-08 14:56:24,819,2751,409,410,2788.83,4813.22,0.00
2024-12-08 14:56:24,818,2751,409,409,2792.18,4813.22,0.00
2024-12-08 14:56:24,819,2750,410,409,2786.02,4813.28,0.00
2024-12-08 14:56:24,820,2749,411,409,2766.84,4813.73,0.00
2024-12-08 14:56:24,821,2748,411,410,2764.76,4813.74,0.00
2024-12-08 14:56:24,822,2747,411,411,2762.46,4813.75,0.00
2024-12-08 14:56:24,823,2746,411,412,2759.77,4813.77,0.00
2024-12-08 14:56:24,824,2745,412,412,2757.25,4813.79,0.00
2024-12-08 14:56:24,825,2744,412,413,2753.81,4813.82,0.00
2024-12-08 14:56:24,826,2743,412,414,2743.51,4813.97,0.00
2024-12-08 14:56:24,826,2744,412,414,2835.43,4814.00,0.00
2024-12-08 14:56:24,827,2744,413,414,2832.00,4814.00,0.00
2024-12-08 14:56:24,828,2743,413,415,2828.06,4814.02,0.00
2024-12-08 14:56:24,827,2743,413,414,2829.64,4814.06,0.00
2024-12-08 14:56:24,826,2743,413,413,2831.33,4814.09,0.00
2024-12-08 14:56:24,827,2742,414,413,2826.41,4814.13,0.00
2024-12-08 14:56:24,828,2741,414,414,2823.42,4814.16,0.00
2024-12-08 14:56:24,829,2740,414,415,2825.30,4814.17,0.00
2024-12-08 14:56:24,828,2740,414,414,2826.25,4814.22,0.00
2024-12-08 14:56:24,827,2740,414,413,2829.61,4814.22,0.00
2024-12-08 14:56:24,826,2740,414,412,2832.97,4814.22,0.00
2024-12-08 14:56:24,825,2740,414,411,2836.35,4814.22,0.00
2024-12-08 14:56:24,826,2739,415,411,2828.05,4814.32,0.00
2024-12-08 14:56:24,827,2738,415,412,2828.42,4814.35,0.00
2024-12-08 14:56:24,828,2737,415,413,2824.56,4814.40,0.00
2024-12-08 14:56:24,829,2736,415,414,2813.86,4814.56,0.00
2024-12-08 14:56:24,830,2735,416,414,2813.12,4814.62,0.00
2024-12-08 14:56:24,831,2734,416,415,2809.82,4814.67,0.00
2024-12-08 14:56:24,832,2733,416,416,2802.83,4814.79,0.00
2024-12-08 14:56:24,833,2732,417,416,2799.66,4814.81,0.00
2024-12-08 14:56:24,833,2733,417,416,2847.59,4815.00,0.00
2024-12-08 14:56:24,834,2733,417,417,2844.18,4815.00,0.00
2024-12-08 14:56:24,833,2733,416,417,2847.07,4815.01,0.00
2024-12-08 14:56:24,832,2733,416,416,2849.00,4815.03,0.00
2024-12-08 14:56:24,831,2733,415,416,2843.71,4815.21,0.00
2024-12-08 14:56:24,832,2732,415,417,2839.43,4815.23,0.00
2024-12-08 14:56:24,833,2731,415,418,2831.89,4815.33,0.00
2024-12-08 14:56:24,834,2730,416,418,2813.17,4815.70,0.00
2024-12-08 14:56:24,835,2729,416,419,2809.17,4815.72,0.00
2024-12-08 14:56:24,835,2730,416,419,2870.19,4816.00,0.00
2024-12-08 14:56:24,836,2730,416,420,2866.76,4816.00,0.00
2024-12-08 14:56:24,835,2730,415,420,2869.79,4816.01,0.00
2024-12-08 14:56:24,834,2730,415,419,2869.79,4816.06,0.00
2024-12-08 14:56:24,833,2730,415,418,2872.83,4816.06,0.00
2024-12-08 14:56:24,834,2729,416,418,2868.30,4816.09,0.00
2024-12-08 14:56:24,835,2728,416,419,2865.74,4816.11,0.00
2024-12-08 14:56:24,836,2727,417,419,2863.77,4816.13,0.00
2024-12-08 14:56:24,837,2726,418,419,2863.00,4816.15,0.00
2024-12-08 14:56:24,836,2726,417,419,2869.06,4816.21,0.00
2024-12-08 14:56:24,835,2726,417,418,2872.43,4816.21,0.00
2024-12-08 14:56:24,834,2726,416,418,2875.76,4816.21,0.00
2024-12-08 14:56:24,833,2726,416,417,2879.16,4816.21,0.00
2024-12-08 14:56:25,832,2726,416,416,2882.56,4816.21,0.00
2024-12-08 14:56:25,831,2726,416,415,2885.97,4816.21,0.00
2024-12-08 14:56:25,830,2726,415,415,2889.39,4816.21,0.00
2024-12-08 14:56:25,831,2725,415,416,2872.12,4816.51,0.00
2024-12-08 14:56:25,832,2724,416,416,2854.93,4816.85,0.00
2024-12-08 14:56:25,833,2723,416,417,2850.21,4816.90,0.00
2024-12-08 14:56:25,834,2722,417,417,2845.16,4816.94,0.00
2024-12-08 14:56:25,834,2723,417,417,2871.50,4817.00,0.00
2024-12-08 14:56:25,835,2723,417,418,2868.06,4817.00,0.00
2024-12-08 14:56:25,836,2722,417,419,2863.77,4817.02,0.00
2024-12-08 14:56:25,837,2721,418,419,2861.10,4817.03,0.00
2024-12-08 14:56:25,836,2721,418,418,2864.02,4817.08,0.00
2024-12-08 14:56:25,835,2721,417,418,2863.97,4817.15,0.00
2024-12-08 14:56:25,834,2721,417,417,2864.38,4817.21,0.00
2024-12-08 14:56:25,833,2721,417,416,2867.71,4817.21,0.00
2024-12-08 14:56:25,832,2721,416,416,2871.09,4817.21,0.00
2024-12-08 14:56:25,833,2720,417,416,2853.48,4817.51,0.00
2024-12-08 14:56:25,834,2719,417,417,2850.96,4817.52,0.00
2024-12-08 14:56:25,835,2718,418,417,2847.00,4817.58,0.00
2024-12-08 14:56:25,836,2717,418,418,2835.74,4817.80,0.00
2024-12-08 14:56:25,836,2718,418,418,2879.36,4818.00,0.00
2024-12-08 14:56:25,837,2718,418,419,2875.92,4818.00,0.00
2024-12-08 14:56:25,836,2718,417,419,2879.25,4818.00,0.00
2024-12-08 14:56:25,837,2717,417,420,2875.24,4818.02,0.00
2024-12-08 14:56:25,836,2717,416,420,2880.38,4818.02,0.00
2024-12-08 14:56:25,835,2717,415,420,2881.24,4818.05,0.00
2024-12-08 14:56:25,834,2717,415,419,2880.75,4818.13,0.00
2024-12-08 14:56:25,833,2717,415,418,2881.98,4818.17,0.00
2024-12-08 14:56:25,834,2716,415,419,2877.78,4818.19,0.00
2024-12-08 14:56:25,833,2716,414,419,2884.43,4818.21,0.00
2024-12-08 14:56:25,832,2716,414,418,2887.84,4818.21,0.00
2024-12-08 14:56:25,831,2716,413,418,2891.26,4818.21,0.00
2024-12-08 14:56:25,830,2716,413,417,2894.68,4818.21,0.00
2024-12-08 14:56:25,829,2716,413,416,2898.12,4818.21,0.00
2024-12-08 14:56:25,828,2716,413,415,2901.56,4818.21,0.00
2024-12-08 14:56:25,827,2716,412,415,2905.01,4818.21,0.00
2024-12-08 14:56:25,826,2716,412,414,2908.47,4818.21,0.00
2024-12-08 14:56:25,825,2716,411,414,2906.35,4818.33,0.00
2024-12-08 14:56:25,826,2715,412,414,2884.06,4818.67,0.00
2024-12-08 14:56:25,827,2714,413,414,2882.62,4818.68,0.00
2024-12-08 14:56:25,828,2713,414,414,2882.35,4818.68,0.00
2024-12-08 14:56:25,829,2712,414,415,2877.82,4818.74,0.00
2024-12-08 14:56:25,830,2711,415,415,2875.46,4818.75,0.00
2024-12-08 14:56:25,830,2712,415,415,2905.40,4819.00,0.00
2024-12-08 14:56:25,831,2712,416,415,2901.90,4819.00,0.00
2024-12-08 14:56:25,830,2712,416,414,2904.08,4819.03,0.00
2024-12-08 14:56:25,831,2711,416,415,2892.66,4819.20,0.00
2024-12-08 14:56:25,830,2711,416,414,2897.14,4819.21,0.00
2024-12-08 14:56:25,829,2711,416,413,2900.58,4819.21,0.00
2024-12-08 14:56:25,830,2710,416,414,2893.74,4819.28,0.00
2024-12-08 14:56:25,831,2709,416,415,2875.94,4819.56,0.00
2024-12-08 14:56:25,832,2708,416,416,2874.13,4819.59,0.00
2024-12-08 14:56:25,833,2707,417,416,2868.60,4819.69,0.00
2024-12-08 14:56:25,834,2706,418,416,2860.53,4819.83,0.00
2024-12-08 14:56:25,835,2705,419,416,2857.69,4819.84,0.00
2024-12-08 14:56:25,836,2704,419,417,2848.07,4819.99,0.00
2024-12-08 14:56:25,836,2705,419,417,2893.79,4820.00,0.00
2024-12-08 14:56:25,837,2705,419,418,2890.34,4820.00,0.00
2024-12-08 14:56:25,836,2705,418,418,2892.77,4820.02,0.00
2024-12-08 14:56:25,835,2705,418,417,2894.39,4820.04,0.00
2024-12-08 14:56:25,834,2705,418,416,2897.40,4820.04,0.00
2024-12-08 14:56:25,833,2705,418,415,2900.65,4820.05,0.00
2024-12-08 14:56:25,834,2704,419,415,2893.74,4820.12,0.00
2024-12-08 14:56:25,835,2703,420,415,2890.63,4820.15,0.00
2024-12-08 14:56:25,836,2702,420,416,2886.68,4820.18,0.00
2024-12-08 14:56:25,835,2702,419,416,2889.98,4820.21,0.00
2024-12-08 14:56:25,836,2701,419,417,2886.35,4820.21,0.00
2024-12-08 14:56:25,835,2701,418,417,2895.46,4820.21,0.00
2024-12-08 14:56:25,834,2701,417,417,2898.88,4820.21,0.00
2024-12-08 14:56:25,835,2700,418,417,2887.44,4820.38,0.00
2024-12-08 14:56:25,834,2700,417,417,2887.48,4820.48,0.00
2024-12-08 14:56:25,835,2699,418,417,2881.85,4820.53,0.00
2024-12-08 14:56:25,836,2698,419,417,2880.72,4820.55,0.00
2024-12-08 14:56:25,837,2697,419,418,2873.85,4820.68,0.00
2024-12-08 14:56:25,837,2698,419,418,2911.92,4821.00,0.00
2024-12-08 14:56:25,838,2698,420,418,2908.45,4821.00,0.00
2024-12-08 14:56:25,839,2697,421,418,2904.30,4821.02,0.00
2024-12-08 14:56:25,838,2697,420,418,2905.16,4821.10,0.00
2024-12-08 14:56:25,837,2697,420,417,2907.66,4821.12,0.00
2024-12-08 14:56:25,836,2697,419,417,2909.94,4821.15,0.00
2024-12-08 14:56:25,837,2696,420,417,2903.90,4821.20,0.00
2024-12-08 14:56:25,836,2696,420,416,2907.50,4821.21,0.00
2024-12-08 14:56:25,835,2696,420,415,2910.92,4821.21,0.00
2024-12-08 14:56:26,834,2696,419,415,2914.30,4821.21,0.00
2024-12-08 14:56:26,833,2696,419,414,2917.74,4821.21,0.00
2024-12-08 14:56:26,832,2696,419,413,2921.19,4821.21,0.00
2024-12-08 14:56:26,831,2696,418,413,2924.64,4821.21,0.00
2024-12-08 14:56:26,832,2695,418,414,2903.44,4821.58,0.00
2024-12-08 14:56:26,833,2694,418,415,2892.79,4821.76,0.00
2024-12-08 14:56:26,834,2693,418,416,2883.10,4821.90,0.00
2024-12-08 14:56:26,835,2692,418,417,2879.03,4821.93,0.00
2024-12-08 14:56:26,835,2693,418,417,2928.00,4822.00,0.00
2024-12-08 14:56:26,836,2693,418,418,2924.50,4822.00,0.00
2024-12-08 14:56:26,837,2692,418,419,2920.10,4822.02,0.00
2024-12-08 14:56:26,838,2691,418,420,2920.70,4822.03,0.00
2024-12-08 14:56:26,837,2691,418,419,2925.87,4822.04,0.00
2024-12-08 14:56:26,836,2691,418,418,2928.74,4822.06,0.00
2024-12-08 14:56:26,835,2691,418,417,2931.79,4822.06,0.00
2024-12-08 14:56:26,836,2690,418,418,2926.51,4822.10,0.00
2024-12-08 14:56:26,835,2690,418,417,2930.26,4822.13,0.00
2024-12-08 14:56:26,834,2690,417,417,2932.06,4822.16,0.00
2024-12-08 14:56:26,833,2690,417,416,2934.38,4822.19,0.00
2024-12-08 14:56:26,832,2690,416,416,2936.82,4822.21,0.00
2024-12-08 14:56:26,831,2690,416,415,2940.30,4822.21,0.00
2024-12-08 14:56:26,830,2690,415,415,2943.72,4822.21,0.00
2024-12-08 14:56:26,829,2690,414,415,2947.16,4822.21,0.00
2024-12-08 14:56:26,828,2690,414,414,2950.66,4822.21,0.00
2024-12-08 14:56:26,829,2689,415,414,2926.25,4822.65,0.00
2024-12-08 14:56:26,830,2688,416,414,2919.67,4822.76,0.00
2024-12-08 14:56:26,831,2687,416,415,2914.76,4822.82,0.00
2024-12-08 14:56:26,831,2688,416,415,2946.41,4823.00,0.00
2024-12-08 14:56:26,832,2688,416,416,2942.87,4823.00,0.00
2024-12-08 14:56:26,831,2688,416,415,2943.59,4823.04,0.00
2024-12-08 14:56:26,830,2688,416,414,2938.80,4823.21,0.00
2024-12-08 14:56:26,829,2688,416,413,2942.29,4823.21,0.00
2024-12-08 14:56:26,828,2688,415,413,2945.78,4823.21,0.00
2024-12-08 14:56:26,829,2687,416,413,2904.40,4823.96,0.00
2024-12-08 14:56:26,829,2688,416,413,2943.30,4824.00,0.00
2024-12-08 14:56:26,830,2688,416,414,2939.76,4824.00,0.00
2024-12-08 14:56:26,829,2688,416,413,2941.63,4824.03,0.00
2024-12-08 14:56:26,830,2687,416,414,2938.09,4824.03,0.00
2024-12-08 14:56:26,829,2687,415,414,2941.84,4824.09,0.00
2024-12-08 14:56:26,830,2686,415,415,2935.01,4824.16,0.00
2024-12-08 14:56:26,829,2686,414,415,2935.73,4824.21,0.00
2024-12-08 14:56:26,828,2686,414,414,2939.16,4824.21,0.00
2024-12-08 14:56:26,827,2686,413,414,2942.60,4824.21,0.00
2024-12-08 14:56:26,826,2686,412,414,2946.11,4824.21,0.00
2024-12-08 14:56:26,825,2686,411,414,2949.62,4824.21,0.00
2024-12-08 14:56:26,826,2685,411,415,2943.20,4824.27,0.00
2024-12-08 14:56:26,827,2684,411,416,2929.48,4824.52,0.00
2024-12-08 14:56:26,828,2683,411,417,2923.33,4824.62,0.00
2024-12-08 14:56:26,828,2684,411,417,2919.33,4825.00,0.00
2024-12-08 14:56:26,829,2684,412,417,2915.81,4825.00,0.00
2024-12-08 14:56:26,828,2684,411,417,2910.90,4825.15,0.00
2024-12-08 14:56:26,827,2684,410,417,2914.13,4825.16,0.00
2024-12-08 14:56:26,826,2684,410,416,2917.37,4825.16,0.00
2024-12-08 14:56:26,825,2684,410,415,2918.77,4825.21,0.00
2024-12-08 14:56:26,824,2684,409,415,2922.19,4825.21,0.00
2024-12-08 14:56:26,823,2684,408,415,2925.63,4825.21,0.00
2024-12-08 14:56:26,822,2684,408,414,2929.13,4825.21,0.00
2024-12-08 14:56:26,821,2684,407,414,2932.64,4825.21,0.00
2024-12-08 14:56:26,820,2684,406,414,2936.15,4825.21,0.00
2024-12-08 14:56:26,821,2683,406,415,2931.41,4825.24,0.00
2024-12-08 14:56:26,822,2682,407,415,2925.41,4825.33,0.00
2024-12-08 14:56:26,823,2681,408,415,2914.15,4825.50,0.00
2024-12-08 14:56:26,824,2680,408,416,2904.81,4825.69,0.00
2024-12-08 14:56:26,825,2679,408,417,2900.34,4825.75,0.00
2024-12-08 14:56:26,824,2679,407,417,2900.07,4825.86,0.00
2024-12-08 14:56:26,825,2678,407,418,2895.06,4825.90,0.00
2024-12-08 14:56:26,825,2679,407,418,2925.87,4826.00,0.00
2024-12-08 14:56:26,826,2679,407,419,2922.33,4826.00,0.00
2024-12-08 14:56:26,827,2678,407,420,2915.60,4826.05,0.00
2024-12-08 14:56:26,826,2678,407,419,2916.83,4826.21,0.00
2024-12-08 14:56:26,825,2678,406,419,2920.30,4826.21,0.00
2024-12-08 14:56:26,826,2677,406,420,2914.22,4826.27,0.00
2024-12-08 14:56:26,827,2676,406,421,2900.76,4826.50,0.00
2024-12-08 14:56:26,828,2675,407,421,2900.40,4826.51,0.00
2024-12-08 14:56:26,829,2674,407,422,2898.54,4826.52,0.00
2024-12-08 14:56:26,830,2673,408,422,2886.59,4826.72,0.00
2024-12-08 14:56:26,830,2674,408,422,2915.55,4827.00,0.00
2024-12-08 14:56:26,831,2674,409,422,2912.04,4827.00,0.00
2024-12-08 14:56:26,830,2674,408,422,2915.49,4827.00,0.00
2024-12-08 14:56:26,829,2674,408,421,2916.98,4827.03,0.00
2024-12-08 14:56:26,828,2674,408,420,2920.33,4827.03,0.00
2024-12-08 14:56:26,829,2673,409,420,2915.95,4827.05,0.00
2024-12-08 14:56:26,828,2673,409,419,2919.54,4827.08,0.00
2024-12-08 14:56:26,827,2673,408,419,2921.57,4827.11,0.00
2024-12-08 14:56:26,828,2672,409,419,2914.58,4827.19,0.00
2024-12-08 14:56:26,827,2672,408,419,2918.88,4827.21,0.00
2024-12-08 14:56:26,826,2672,408,418,2922.30,4827.21,0.00
2024-12-08 14:56:26,825,2672,408,417,2925.78,4827.21,0.00
2024-12-08 14:56:26,824,2672,407,417,2929.21,4827.21,0.00
2024-12-08 14:56:26,823,2672,406,417,2932.66,4827.21,0.00
2024-12-08 14:56:26,824,2671,407,417,2920.32,4827.40,0.00
2024-12-08 14:56:26,825,2670,408,417,2920.70,4827.40,0.00
2024-12-08 14:56:26,826,2669,408,418,2913.34,4827.57,0.00
2024-12-08 14:56:26,827,2668,409,418,2911.46,4827.59,0.00
2024-12-08 14:56:26,828,2667,409,419,2906.26,4827.68,0.00
2024-12-08 14:56:26,829,2666,409,420,2897.37,4827.81,0.00
2024-12-08 14:56:26,829,2667,409,420,2927.71,4828.00,0.00
2024-12-08 14:56:26,830,2667,410,420,2924.18,4828.00,0.00
2024-12-08 14:56:26,829,2667,410,419,2925.92,4828.03,0.00
2024-12-08 14:56:26,828,2667,409,419,2928.01,4828.06,0.00
2024-12-08 14:56:26,829,2666,410,419,2922.46,4828.10,0.00
2024-12-08 14:56:27,828,2666,410,418,2924.05,4828.18,0.00
2024-12-08 14:56:27,829,2665,410,419,2920.35,4828.19,0.00
2024-12-08 14:56:27,830,2664,410,420,2922.13,4828.19,0.00
2024-12-08 14:56:27,829,2664,409,420,2926.25,4828.21,0.00
2024-12-08 14:56:27,828,2664,408,420,2929.66,4828.21,0.00
2024-12-08 14:56:27,827,2664,407,420,2933.15,4828.21,0.00
2024-12-08 14:56:27,826,2664,406,420,2936.58,4828.21,0.00
2024-12-08 14:56:27,825,2664,405,420,2940.08,4828.21,0.00
2024-12-08 14:56:27,824,2664,404,420,2943.59,4828.21,0.00
2024-12-08 14:56:27,823,2664,403,420,2946.59,4828.22,0.00
2024-12-08 14:56:27,824,2663,403,421,2928.43,4828.52,0.00
2024-12-08 14:56:27,825,2662,404,421,2922.94,4828.60,0.00
2024-12-08 14:56:27,826,2661,405,421,2919.36,4828.62,0.00
2024-12-08 14:56:27,827,2660,405,422,2917.76,4828.63,0.00
2024-12-08 14:56:27,828,2659,405,423,2910.11,4828.74,0.00
2024-12-08 14:56:27,829,2658,406,423,2906.28,4828.78,0.00
2024-12-08 14:56:27,829,2659,406,423,2949.69,4829.00,0.00
2024-12-08 14:56:27,830,2659,407,423,2946.14,4829.00,0.00
2024-12-08 14:56:27,829,2659,407,422,2948.02,4829.03,0.00
2024-12-08 14:56:27,830,2658,407,423,2944.24,4829.04,0.00
2024-12-08 14:56:27,831,2657,408,423,2927.47,4829.36,0.00
2024-12-08 14:56:27,832,2656,408,424,2925.41,4829.36,0.00
2024-12-08 14:56:27,832,2657,408,424,2955.05,4830.00,0.00
2024-12-08 14:56:27,833,2657,409,424,2951.50,4830.00,0.00
2024-12-08 14:56:27,832,2657,408,424,2954.99,4830.00,0.00
2024-12-08 14:56:27,831,2657,408,423,2956.65,4830.03,0.00
2024-12-08 14:56:27,830,2657,407,423,2958.65,4830.06,0.00
2024-12-08 14:56:27,829,2657,407,422,2955.37,4830.20,0.00
2024-12-08 14:56:27,828,2657,406,422,2958.82,4830.20,0.00
2024-12-08 14:56:27,827,2657,405,422,2957.86,4830.28,0.00
2024-12-08 14:56:27,828,2656,406,422,2950.88,4830.36,0.00
2024-12-08 14:56:27,829,2655,406,423,2948.17,4830.43,0.00
2024-12-08 14:56:27,830,2654,407,423,2936.37,4830.66,0.00
2024-12-08 14:56:27,831,2653,407,424,2933.27,4830.70,0.00
2024-12-08 14:56:27,832,2652,408,424,2930.63,4830.72,0.00
2024-12-08 14:56:27,833,2651,409,424,2925.09,4830.80,0.00
2024-12-08 14:56:27,833,2652,409,424,2940.11,4831.00,0.00
2024-12-08 14:56:27,834,2652,410,424,2936.58,4831.00,0.00
2024-12-08 14:56:27,835,2651,410,425,2927.16,4831.10,0.00
2024-12-08 14:56:27,834,2651,410,424,2932.11,4831.10,0.00
2024-12-08 14:56:27,833,2651,410,423,2934.49,4831.13,0.00
2024-12-08 14:56:27,834,2650,410,424,2929.08,4831.17,0.00
2024-12-08 14:56:27,833,2650,410,423,2936.56,4831.20,0.00
2024-12-08 14:56:27,832,2650,409,423,2939.86,4831.21,0.00
2024-12-08 14:56:27,833,2649,410,423,2934.37,4831.25,0.00
2024-12-08 14:56:27,834,2648,411,423,2923.59,4831.47,0.00
2024-12-08 14:56:27,835,2647,412,423,2920.04,4831.49,0.00
2024-12-08 14:56:27,836,2646,412,424,2918.29,4831.50,0.00
2024-12-08 14:56:27,837,2645,412,425,2916.26,4831.54,0.00
2024-12-08 14:56:27,838,2644,413,425,2904.47,4831.77,0.00
2024-12-08 14:56:27,838,2645,413,425,2935.51,4832.00,0.00
2024-12-08 14:56:27,839,2645,414,425,2932.01,4832.00,0.00
2024-12-08 14:56:27,838,2645,414,424,2933.91,4832.03,0.00
2024-12-08 14:56:27,839,2644,415,424,2928.02,4832.08,0.00
2024-12-08 14:56:27,840,2643,416,424,2922.16,4832.16,0.00
2024-12-08 14:56:27,841,2642,416,425,2922.14,4832.18,0.00
2024-12-08 14:56:27,840,2642,415,425,2924.66,4832.21,0.00
2024-12-08 14:56:27,839,2642,415,424,2927.86,4832.21,0.00
2024-12-08 14:56:27,840,2641,416,424,2924.09,4832.22,0.00
2024-12-08 14:56:27,841,2640,416,425,2920.48,4832.34,0.00
2024-12-08 14:56:27,842,2639,416,426,2917.19,4832.37,0.00
2024-12-08 14:56:27,843,2638,416,427,2917.12,4832.39,0.00
2024-12-08 14:56:27,844,2637,416,428,2902.58,4832.71,0.00
2024-12-08 14:56:27,845,2636,417,428,2900.86,4832.71,0.00
2024-12-08 14:56:27,846,2635,418,428,2886.24,4832.99,0.00
2024-12-08 14:56:27,846,2636,418,428,2934.91,4833.00,0.00
2024-12-08 14:56:27,847,2636,418,429,2931.45,4833.00,0.00
2024-12-08 14:56:27,848,2635,419,429,2927.99,4833.00,0.00
2024-12-08 14:56:27,849,2634,419,430,2922.80,4833.04,0.00
2024-12-08 14:56:27,850,2633,420,430,2920.33,4833.06,0.00
2024-12-08 14:56:27,851,2632,421,430,2918.67,4833.08,0.00
2024-12-08 14:56:27,850,2632,421,429,2922.28,4833.09,0.00
2024-12-08 14:56:27,849,2632,420,429,2924.54,4833.11,0.00
2024-12-08 14:56:27,850,2631,421,429,2920.88,4833.12,0.00
2024-12-08 14:56:27,849,2631,421,428,2929.16,4833.13,0.00
2024-12-08 14:56:27,848,2631,421,427,2928.79,4833.21,0.00
2024-12-08 14:56:27,847,2631,421,426,2932.19,4833.21,0.00
2024-12-08 14:56:27,846,2631,421,425,2935.54,4833.21,0.00
2024-12-08 14:56:27,845,2631,421,424,2938.85,4833.21,0.00
2024-12-08 14:56:27,844,2631,421,423,2942.27,4833.21,0.00
2024-12-08 14:56:27,843,2631,420,423,2945.70,4833.21,0.00
2024-12-08 14:56:27,844,2630,421,423,2938.70,4833.28,0.00
2024-12-08 14:56:27,845,2629,421,424,2934.55,4833.32,0.00
2024-12-08 14:56:27,846,2628,422,424,2931.24,4833.42,0.00
2024-12-08 14:56:27,847,2627,422,425,2925.08,4833.51,0.00
2024-12-08 14:56:27,848,2626,423,425,2914.84,4833.68,0.00
2024-12-08 14:56:27,849,2625,424,425,2912.11,4833.71,0.00
2024-12-08 14:56:27,849,2626,424,425,2962.63,4834.00,0.00
2024-12-08 14:56:27,850,2626,425,425,2959.14,4834.00,0.00
2024-12-08 14:56:27,849,2626,424,425,2953.16,4834.17,0.00
2024-12-08 14:56:27,850,2625,425,425,2947.42,4834.21,0.00
2024-12-08 14:56:27,849,2625,425,424,2954.65,4834.21,0.00
2024-12-08 14:56:27,850,2624,425,425,2946.88,4834.30,0.00
2024-12-08 14:56:27,851,2623,425,426,2940.20,4834.47,0.00
2024-12-08 14:56:27,852,2622,426,426,2934.27,4834.59,0.00
2024-12-08 14:56:27,853,2621,427,426,2933.04,4834.60,0.00
2024-12-08 14:56:27,854,2620,427,427,2928.02,4834.68,0.00
2024-12-08 14:56:27,855,2619,428,427,2925.41,4834.70,0.00
2024-12-08 14:56:28,855,2620,428,427,2980.27,4835.00,0.00
2024-12-08 14:56:28,856,2620,429,427,2976.79,4835.00,0.00
2024-12-08 14:56:28,857,2619,429,428,2967.55,4835.10,0.00
2024-12-08 14:56:28,856,2619,428,428,2968.21,4835.21,0.00
2024-12-08 14:56:28,857,2618,428,429,2950.54,4835.51,0.00
2024-12-08 14:56:28,858,2617,428,430,2944.19,4835.63,0.00
2024-12-08 14:56:28,859,2616,428,431,2942.57,4835.64,0.00
2024-12-08 14:56:28,860,2615,428,432,2938.40,4835.71,0.00
2024-12-08 14:56:28,861,2614,429,432,2934.85,4835.75,0.00
2024-12-08 14:56:28,862,2613,429,433,2931.58,4835.78,0.00
2024-12-08 14:56:28,863,2612,430,433,2926.55,4835.84,0.00
2024-12-08 14:56:28,863,2613,430,433,2963.36,4836.00,0.00
2024-12-08 14:56:28,864,2613,430,434,2959.93,4836.00,0.00
2024-12-08 14:56:28,863,2613,430,433,2955.42,4836.14,0.00
2024-12-08 14:56:28,862,2613,430,432,2955.75,4836.21,0.00
2024-12-08 14:56:28,861,2613,429,432,2959.12,4836.21,0.00
2024-12-08 14:56:28,860,2613,428,432,2962.51,4836.21,0.00
2024-12-08 14:56:28,859,2613,427,432,2965.90,4836.21,0.00
2024-12-08 14:56:28,858,2613,426,432,2969.30,4836.21,0.00
2024-12-08 14:56:28,857,2613,425,432,2972.71,4836.21,0.00
2024-12-08 14:56:28,856,2613,424,432,2972.59,4836.28,0.00
2024-12-08 14:56:28,857,2612,424,433,2964.59,4836.38,0.00
2024-12-08 14:56:28,858,2611,425,433,2961.90,4836.45,0.00
2024-12-08 14:56:28,859,2610,425,434,2961.44,4836.46,0.00
2024-12-08 14:56:28,860,2609,425,435,2944.90,4836.81,0.00
2024-12-08 14:56:28,861,2608,425,436,2941.28,4836.84,0.00
2024-12-08 14:56:28,862,2607,425,437,2937.28,4836.87,0.00
2024-12-08 14:56:28,862,2608,425,437,2980.15,4837.00,0.00
2024-12-08 14:56:28,863,2608,426,437,2976.69,4837.00,0.00
2024-12-08 14:56:28,862,2608,425,437,2978.81,4837.03,0.00
2024-12-08 14:56:28,861,2608,425,436,2981.49,4837.03,0.00
2024-12-08 14:56:28,862,2607,425,437,2976.86,4837.06,0.00
2024-12-08 14:56:28,861,2607,424,437,2980.11,4837.08,0.00
2024-12-08 14:56:28,862,2606,425,437,2974.37,4837.13,0.00
2024-12-08 14:56:28,861,2606,425,436,2976.98,4837.21,0.00
2024-12-08 14:56:28,860,2606,425,435,2980.33,4837.21,0.00
2024-12-08 14:56:28,861,2605,425,436,2974.86,4837.25,0.00
2024-12-08 14:56:28,860,2605,424,436,2974.93,4837.34,0.00
2024-12-08 14:56:28,859,2605,423,436,2978.12,4837.35,0.00
2024-12-08 14:56:28,860,2604,423,437,2970.42,4837.44,0.00
2024-12-08 14:56:28,861,2603,423,438,2970.35,4837.44,0.00
2024-12-08 14:56:28,862,2602,423,439,2969.67,4837.47,0.00
2024-12-08 14:56:28,863,2601,424,439,2966.36,4837.51,0.00
2024-12-08 14:56:28,864,2600,425,439,2963.78,4837.53,0.00
2024-12-08 14:56:28,865,2599,425,440,2948.47,4837.82,0.00
2024-12-08 14:56:28,865,2600,425,440,2976.92,4838.00,0.00
2024-12-08 14:56:28,866,2600,425,441,2973.48,4838.00,0.00
2024-12-08 14:56:28,865,2600,425,440,2972.03,4838.08,0.00
2024-12-08 14:56:28,866,2599,426,440,2963.63,4838.19,0.00
2024-12-08 14:56:28,865,2599,426,439,2970.21,4838.21,0.00
2024-12-08 14:56:28,864,2599,426,438,2973.59,4838.21,0.00
2024-12-08 14:56:28,865,2598,427,438,2970.04,4838.22,0.00
2024-12-08 14:56:28,866,2597,427,439,2971.08,4838.24,0.00
2024-12-08 14:56:28,867,2596,428,439,2959.05,4838.45,0.00
2024-12-08 14:56:28,868,2595,429,439,2952.83,4838.52,0.00
2024-12-08 14:56:28,869,2594,430,439,2944.76,4838.72,0.00
2024-12-08 14:56:28,869,2595,430,439,2988.76,4839.00,0.00
2024-12-08 14:56:28,870,2595,430,440,2985.32,4839.00,0.00
2024-12-08 14:56:28,869,2595,430,439,2985.44,4839.05,0.00
2024-12-08 14:56:28,868,2595,430,438,2987.83,4839.07,0.00
2024-12-08 14:56:28,869,2594,431,438,2982.08,4839.12,0.00
2024-12-08 14:56:28,870,2593,431,439,2979.40,4839.15,0.00
2024-12-08 14:56:28,871,2592,432,439,2976.42,4839.16,0.00
2024-12-08 14:56:28,870,2592,432,438,2977.93,4839.21,0.00
2024-12-08 14:56:28,869,2592,431,438,2981.30,4839.21,0.00
2024-12-08 14:56:28,868,2592,430,438,2984.62,4839.21,0.00
2024-12-08 14:56:28,867,2592,430,437,2988.01,4839.21,0.00
2024-12-08 14:56:28,868,2591,430,438,2982.07,4839.27,0.00
2024-12-08 14:56:28,869,2590,431,438,2978.66,4839.31,0.00
2024-12-08 14:56:28,870,2589,432,438,2978.97,4839.33,0.00
2024-12-08 14:56:28,871,2588,433,438,2975.36,4839.40,0.00
2024-12-08 14:56:28,872,2587,434,438,2969.44,4839.52,0.00
2024-12-08 14:56:28,873,2586,435,438,2963.97,4839.57,0.00
2024-12-08 14:56:28,874,2585,436,438,2957.99,4839.68,0.00
2024-12-08 14:56:28,875,2584,436,439,2952.68,4839.77,0.00
2024-12-08 14:56:28,876,2583,437,439,2948.90,4839.81,0.00
2024-12-08 14:56:28,877,2582,438,439,2939.81,4839.95,0.00
2024-12-08 14:56:28,877,2583,438,439,2976.39,4840.00,0.00
2024-12-08 14:56:28,878,2583,438,440,2973.00,4840.00,0.00
2024-12-08 14:56:28,879,2582,439,440,2960.12,4840.18,0.00
2024-12-08 14:56:28,880,2581,440,440,2957.66,4840.21,0.00
2024-12-08 14:56:28,879,2581,439,440,2963.89,4840.21,0.00
2024-12-08 14:56:28,878,2581,438,440,2967.21,4840.21,0.00
2024-12-08 14:56:28,879,2580,439,440,2962.08,4840.25,0.00
2024-12-08 14:56:28,878,2580,438,440,2960.55,4840.44,0.00
2024-12-08 14:56:28,879,2579,439,440,2953.53,4840.52,0.00
2024-12-08 14:56:28,880,2578,439,441,2950.16,4840.58,0.00
2024-12-08 14:56:28,880,2579,439,441,3008.68,4841.00,0.00
2024-12-08 14:56:28,881,2579,439,442,3005.27,4841.00,0.00
2024-12-08 14:56:28,880,2579,438,442,3007.92,4841.02,0.00
2024-12-08 14:56:28,879,2579,438,441,3010.58,4841.03,0.00
2024-12-08 14:56:28,878,2579,437,441,3010.30,4841.11,0.00
2024-12-08 14:56:28,877,2579,437,440,3011.33,4841.16,0.00
2024-12-08 14:56:28,876,2579,436,440,3013.45,4841.16,0.00
2024-12-08 14:56:28,875,2579,435,440,3014.71,4841.21,0.00
2024-12-08 14:56:28,874,2579,435,439,3018.10,4841.21,0.00
2024-12-08 14:56:28,875,2578,435,440,3014.65,4841.21,0.00
2024-12-08 14:56:28,874,2578,434,440,3020.70,4841.21,0.00
2024-12-08 14:56:28,873,2578,434,439,3024.11,4841.21,0.00
2024-12-08 14:56:28,872,2578,434,438,3027.47,4841.21,0.00
2024-12-08 14:56:28,871,2578,433,438,3030.89,4841.21,0.00
2024-12-08 14:56:28,872,2577,434,438,3024.33,4841.28,0.00
2024-12-08 14:56:28,873,2576,435,438,3018.85,4841.37,0.00
2024-12-08 14:56:28,874,2575,435,439,3013.24,4841.48,0.00
2024-12-08 14:56:28,875,2574,436,439,3004.10,4841.67,0.00
2024-12-08 14:56:28,876,2573,436,440,2997.65,4841.77,0.00
2024-12-08 14:56:28,877,2572,437,440,2988.56,4841.92,0.00
2024-12-08 14:56:29,877,2573,437,440,3018.34,4842.00,0.00
2024-12-08 14:56:29,878,2573,437,441,3014.90,4842.00,0.00
2024-12-08 14:56:29,877,2573,436,441,3016.92,4842.03,0.00
2024-12-08 14:56:29,878,2572,436,442,3007.47,4842.13,0.00
2024-12-08 14:56:29,879,2571,436,443,3005.70,4842.15,0.00
2024-12-08 14:56:29,880,2570,436,444,3004.88,4842.16,0.00
2024-12-08 14:56:29,879,2570,436,443,3007.18,4842.21,0.00
2024-12-08 14:56:29,878,2570,435,443,3010.49,4842.22,0.00
2024-12-08 14:56:29,879,2569,436,443,2993.84,4842.45,0.00
2024-12-08 14:56:29,880,2568,436,444,2987.71,4842.58,0.00
2024-12-08 14:56:29,881,2567,436,445,2985.36,4842.59,0.00
2024-12-08 14:56:29,882,2566,436,446,2983.57,4842.59,0.00
2024-12-08 14:56:29,883,2565,436,447,2981.69,4842.61,0.00
2024-12-08 14:56:29,884,2564,437,447,2979.43,4842.64,0.00
2024-12-08 14:56:29,885,2563,437,448,2972.91,4842.75,0.00
2024-12-08 14:56:29,886,2562,438,448,2966.66,4842.82,0.00
2024-12-08 14:56:29,886,2563,438,448,3002.89,4843.00,0.00
2024-12-08 14:56:29,887,2563,439,448,2999.50,4843.00,0.00
2024-12-08 14:56:29,888,2562,439,449,2994.89,4843.03,0.00
2024-12-08 14:56:29,889,2561,440,449,2989.85,4843.08,0.00
2024-12-08 14:56:29,890,2560,440,450,2990.68,4843.08,0.00
2024-12-08 14:56:29,889,2560,440,449,2989.16,4843.21,0.00
2024-12-08 14:56:29,888,2560,439,449,2992.37,4843.22,0.00
2024-12-08 14:56:29,889,2559,439,450,2983.92,4843.32,0.00
2024-12-08 14:56:29,888,2559,438,450,2985.67,4843.38,0.00
2024-12-08 14:56:29,889,2558,439,450,2979.19,4843.45,0.00
2024-12-08 14:56:29,890,2557,439,451,2975.77,4843.52,0.00
2024-12-08 14:56:29,891,2556,439,452,2968.59,4843.64,0.00
2024-12-08 14:56:29,892,2555,440,452,2958.77,4843.82,0.00
2024-12-08 14:56:29,892,2556,440,452,3016.32,4844.00,0.00
2024-12-08 14:56:29,893,2556,440,453,3012.94,4844.00,0.00
2024-12-08 14:56:29,892,2556,440,452,3014.92,4844.03,0.00
2024-12-08 14:56:29,891,2556,440,451,3017.93,4844.04,0.00
2024-12-08 14:56:29,890,2556,440,450,3019.11,4844.08,0.00
2024-12-08 14:56:29,891,2555,440,451,3009.54,4844.21,0.00
2024-12-08 14:56:29,892,2554,440,452,3002.55,4844.40,0.00
2024-12-08 14:56:29,893,2553,440,453,2992.12,4844.57,0.00
2024-12-08 14:56:29,894,2552,441,453,2987.67,4844.62,0.00
2024-12-08 14:56:29,895,2551,441,454,2980.95,4844.74,0.00
2024-12-08 14:56:29,896,2550,442,454,2969.37,4844.95,0.00
2024-12-08 14:56:29,896,2551,442,454,3013.59,4845.00,0.00
2024-12-08 14:56:29,897,2551,443,454,3010.23,4845.00,0.00
2024-12-08 14:56:29,896,2551,442,454,3013.16,4845.01,0.00
2024-12-08 14:56:29,895,2551,442,453,3011.58,4845.09,0.00
2024-12-08 14:56:29,894,2551,442,452,3009.11,4845.21,0.00
2024-12-08 14:56:29,893,2551,441,452,3012.43,4845.21,0.00
2024-12-08 14:56:29,894,2550,442,452,3000.68,4845.39,0.00
2024-12-08 14:56:29,895,2549,442,453,2997.74,4845.46,0.00
2024-12-08 14:56:29,896,2548,442,454,2991.02,4845.60,0.00
2024-12-08 14:56:29,897,2547,442,455,2988.35,4845.64,0.00
2024-12-08 14:56:29,898,2546,442,456,2987.02,4845.64,0.00
2024-12-08 14:56:29,899,2545,443,456,2973.59,4845.86,0.00
2024-12-08 14:56:29,899,2546,443,456,3005.41,4846.00,0.00
2024-12-08 14:56:29,900,2546,444,456,3002.07,4846.00,0.00
2024-12-08 14:56:29,899,2546,444,455,3003.05,4846.03,0.00
2024-12-08 14:56:29,900,2545,445,455,2998.86,4846.05,0.00
2024-12-08 14:56:29,899,2545,445,454,3005.11,4846.05,0.00
2024-12-08 14:56:29,898,2545,444,454,3008.40,4846.05,0.00
2024-12-08 14:56:29,897,2545,443,454,3011.01,4846.07,0.00
2024-12-08 14:56:29,896,2545,443,453,3007.58,4846.21,0.00
2024-12-08 14:56:29,895,2545,442,453,3010.78,4846.21,0.00
2024-12-08 14:56:29,894,2545,442,452,3014.09,4846.21,0.00
2024-12-08 14:56:29,893,2545,441,452,3014.80,4846.22,0.00
2024-12-08 14:56:29,894,2544,442,452,3006.31,4846.33,0.00
2024-12-08 14:56:29,895,2543,442,453,3001.49,4846.42,0.00
2024-12-08 14:56:29,894,2543,441,453,3006.71,4846.46,0.00
2024-12-08 14:56:29,895,2542,442,453,2996.56,4846.60,0.00
2024-12-08 14:56:29,896,2541,442,454,2978.65,4846.94,0.00
2024-12-08 14:56:29,896,2542,442,454,3013.98,4847.00,0.00
2024-12-08 14:56:29,897,2542,442,455,3010.62,4847.00,0.00
2024-12-08 14:56:29,896,2542,442,454,3011.29,4847.03,0.00
2024-12-08 14:56:29,897,2541,443,454,3007.18,4847.05,0.00
2024-12-08 14:56:29,898,2540,444,454,3000.97,4847.15,0.00
2024-12-08 14:56:29,897,2540,443,454,3002.78,4847.21,0.00
2024-12-08 14:56:29,896,2540,442,454,3006.08,4847.21,0.00
2024-12-08 14:56:29,897,2539,443,454,2997.52,4847.32,0.00
2024-12-08 14:56:29,898,2538,443,455,2987.53,4847.49,0.00
2024-12-08 14:56:29,899,2537,443,456,2984.51,4847.55,0.00
2024-12-08 14:56:29,900,2536,443,457,2982.82,4847.58,0.00
2024-12-08 14:56:29,901,2535,443,458,2976.98,4847.65,0.00
2024-12-08 14:56:29,902,2534,444,458,2974.50,4847.68,0.00
2024-12-08 14:56:29,903,2533,445,458,2972.24,4847.69,0.00
2024-12-08 14:56:29,902,2533,444,458,2973.55,4847.73,0.00
2024-12-08 14:56:29,903,2532,444,459,2968.41,4847.77,0.00
2024-12-08 14:56:29,903,2533,444,459,2991.04,4848.00,0.00
2024-12-08 14:56:29,904,2533,445,459,2987.73,4848.00,0.00
2024-12-08 14:56:29,903,2533,445,458,2989.66,4848.03,0.00
2024-12-08 14:56:29,902,2533,444,458,2992.12,4848.04,0.00
2024-12-08 14:56:29,901,2533,444,457,2989.22,4848.17,0.00
2024-12-08 14:56:29,902,2532,444,458,2984.73,4848.20,0.00
2024-12-08 14:56:29,901,2532,443,458,2987.73,4848.21,0.00
2024-12-08 14:56:29,900,2532,443,457,2991.00,4848.21,0.00
2024-12-08 14:56:29,899,2532,443,456,2994.22,4848.21,0.00
2024-12-08 14:56:29,898,2532,442,456,2997.50,4848.21,0.00
2024-12-08 14:56:29,897,2532,442,455,3000.73,4848.21,0.00
2024-12-08 14:56:29,896,2532,442,454,3004.03,4848.21,0.00
2024-12-08 14:56:29,895,2532,441,454,2995.31,4848.46,0.00
2024-12-08 14:56:29,896,2531,441,455,2984.45,4848.58,0.00
2024-12-08 14:56:29,897,2530,441,456,2979.39,4848.65,0.00
2024-12-08 14:56:29,898,2529,442,456,2975.30,4848.71,0.00
2024-12-08 14:56:30,899,2528,442,457,2969.68,4848.79,0.00
2024-12-08 14:56:30,900,2527,443,457,2965.34,4848.84,0.00
2024-12-08 14:56:30,901,2526,443,458,2957.84,4848.95,0.00
2024-12-08 14:56:30,901,2527,443,458,3014.77,4849.00,0.00
2024-12-08 14:56:30,902,2527,443,459,3011.42,4849.00,0.00
2024-12-08 14:56:30,901,2527,443,458,3012.25,4849.03,0.00
2024-12-08 14:56:30,902,2526,444,458,3008.65,4849.04,0.00
2024-12-08 14:56:30,903,2525,444,459,3003.09,4849.10,0.00
2024-12-08 14:56:30,904,2524,444,460,3003.59,4849.12,0.00
2024-12-08 14:56:30,905,2523,444,461,3005.26,4849.13,0.00
2024-12-08 14:56:30,904,2523,443,461,3009.45,4849.13,0.00
2024-12-08 14:56:30,905,2522,444,461,3004.48,4849.17,0.00
2024-12-08 14:56:30,906,2521,445,461,3003.20,4849.18,0.00
2024-12-08 14:56:30,905,2521,444,461,3005.68,4849.21,0.00
2024-12-08 14:56:30,904,2521,444,460,3008.95,4849.21,0.00
2024-12-08 14:56:30,903,2521,444,459,3012.12,4849.22,0.00
2024-12-08 14:56:30,904,2520,445,459,2992.27,4849.56,0.00
2024-12-08 14:56:30,905,2519,445,460,2989.99,4849.56,0.00
2024-12-08 14:56:30,906,2518,446,460,2986.53,4849.65,0.00
2024-12-08 14:56:30,907,2517,446,461,2973.64,4849.89,0.00
2024-12-08 14:56:30,908,2516,447,461,2970.32,4849.91,0.00
2024-12-08 14:56:30,908,2517,447,461,3009.19,4850.00,0.00
2024-12-08 14:56:30,909,2517,447,462,3005.87,4850.00,0.00
2024-12-08 14:56:30,910,2516,447,463,3002.57,4850.00,0.00
2024-12-08 14:56:30,909,2516,447,462,2994.75,4850.21,0.00
2024-12-08 14:56:30,910,2515,448,462,2989.23,4850.26,0.00
2024-12-08 14:56:30,911,2514,449,462,2977.47,4850.45,0.00
2024-12-08 14:56:30,910,2514,448,462,2982.73,4850.48,0.00
2024-12-08 14:56:30,911,2513,449,462,2970.15,4850.67,0.00
2024-12-08 14:56:30,911,2514,449,462,3020.26,4851.00,0.00
2024-12-08 14:56:30,912,2514,449,463,3016.95,4851.00,0.00
2024-12-08 14:56:30,913,2513,450,463,3009.84,4851.06,0.00
2024-12-08 14:56:30,914,2512,451,463,3006.36,4851.11,0.00
2024-12-08 14:56:30,915,2511,451,464,2998.62,4851.21,0.00
2024-12-08 14:56:30,914,2511,450,464,3005.57,4851.21,0.00
2024-12-08 14:56:30,913,2511,449,464,3008.76,4851.21,0.00
2024-12-08 14:56:30,914,2510,450,464,3004.89,4851.23,0.00
2024-12-08 14:56:30,913,2510,449,464,3006.63,4851.34,0.00
2024-12-08 14:56:30,914,2509,449,465,3001.03,4851.39,0.00
2024-12-08 14:56:30,915,2508,450,465,2995.87,4851.45,0.00
2024-12-08 14:56:30,916,2507,450,466,2986.63,4851.64,0.00
2024-12-08 14:56:30,917,2506,450,467,2979.91,4851.76,0.00
2024-12-08 14:56:30,917,2507,450,467,2996.25,4852.00,0.00
2024-12-08 14:56:30,918,2507,450,468,2992.98,4852.00,0.00
2024-12-08 14:56:30,917,2507,449,468,2987.98,4852.12,0.00
2024-12-08 14:56:30,918,2506,449,469,2980.13,4852.22,0.00
2024-12-08 14:56:30,919,2505,449,470,2966.10,4852.52,0.00
2024-12-08 14:56:30,920,2504,449,471,2954.90,4852.75,0.00
2024-12-08 14:56:30,921,2503,450,471,2945.86,4852.90,0.00
2024-12-08 14:56:30,921,2504,450,471,2989.25,4853.00,0.00
2024-12-08 14:56:30,922,2504,451,471,2986.01,4853.00,0.00
2024-12-08 14:56:30,921,2504,450,471,2988.47,4853.02,0.00
2024-12-08 14:56:30,920,2504,449,471,2991.46,4853.02,0.00
2024-12-08 14:56:30,919,2504,449,470,2994.50,4853.02,0.00
2024-12-08 14:56:30,920,2503,449,471,2990.99,4853.03,0.00
2024-12-08 14:56:30,919,2503,449,470,2996.78,4853.03,0.00
2024-12-08 14:56:30,918,2503,449,469,2999.99,4853.03,0.00
2024-12-08 14:56:30,917,2503,449,468,3001.95,4853.06,0.00
2024-12-08 14:56:30,916,2503,449,467,3004.29,4853.08,0.00
2024-12-08 14:56:30,917,2502,449,468,3000.85,4853.08,0.00
2024-12-08 14:56:30,918,2501,449,469,3000.39,4853.09,0.00
2024-12-08 14:56:30,919,2500,450,469,2994.42,4853.16,0.00
2024-12-08 14:56:30,920,2499,451,469,2991.17,4853.18,0.00
2024-12-08 14:56:30,919,2499,451,468,2994.39,4853.21,0.00
2024-12-08 14:56:30,918,2499,450,468,2997.50,4853.21,0.00
2024-12-08 14:56:30,917,2499,449,468,3000.56,4853.22,0.00
2024-12-08 14:56:30,918,2498,449,469,2997.13,4853.22,0.00
2024-12-08 14:56:30,919,2497,449,470,2994.15,4853.28,0.00
2024-12-08 14:56:30,920,2496,449,471,2995.06,4853.29,0.00
2024-12-08 14:56:30,920,2497,449,471,2991.91,4854.00,0.00
2024-12-08 14:56:30,921,2497,450,471,2988.66,4854.00,0.00
2024-12-08 14:56:30,922,2496,451,471,2984.74,4854.02,0.00
2024-12-08 14:56:30,923,2495,451,472,2979.56,4854.11,0.00
2024-12-08 14:56:30,922,2495,451,471,2984.48,4854.12,0.00
2024-12-08 14:56:30,921,2495,451,470,2983.45,4854.21,0.00
2024-12-08 14:56:30,920,2495,451,469,2986.64,4854.21,0.00
2024-12-08 14:56:30,919,2495,450,469,2989.78,4854.21,0.00
2024-12-08 14:56:30,918,2495,449,469,2992.94,4854.21,0.00
2024-12-08 14:56:30,919,2494,450,469,2989.57,4854.22,0.00
2024-12-08 14:56:30,920,2493,451,469,2983.13,4854.30,0.00
2024-12-08 14:56:30,921,2492,451,470,2976.47,4854.41,0.00
2024-12-08 14:56:30,922,2491,452,470,2956.76,4854.75,0.00
2024-12-08 14:56:30,923,2490,453,470,2952.75,4854.80,0.00
2024-12-08 14:56:30,924,2489,454,470,2947.82,4854.86,0.00
2024-12-08 14:56:30,925,2488,454,471,2941.97,4854.93,0.00
2024-12-08 14:56:30,925,2489,454,471,2986.32,4855.00,0.00
2024-12-08 14:56:30,926,2489,455,471,2983.10,4855.00,0.00
2024-12-08 14:56:30,927,2488,455,472,2979.05,4855.02,0.00
2024-12-08 14:56:30,926,2488,455,471,2983.06,4855.03,0.00
2024-12-08 14:56:30,927,2487,455,472,2978.23,4855.06,0.00
2024-12-08 14:56:30,928,2486,455,473,2975.92,4855.08,0.00
2024-12-08 14:56:30,927,2486,455,472,2975.33,4855.22,0.00
2024-12-08 14:56:30,928,2485,455,473,2961.44,4855.44,0.00
2024-12-08 14:56:30,927,2485,454,473,2964.06,4855.46,0.00
2024-12-08 14:56:30,928,2484,455,473,2958.69,4855.51,0.00
2024-12-08 14:56:30,929,2483,455,474,2955.21,4855.54,0.00
2024-12-08 14:56:31,930,2482,456,474,2949.31,4855.61,0.00
2024-12-08 14:56:31,931,2481,456,475,2935.80,4855.88,0.00
2024-12-08 14:56:31,931,2482,456,475,2980.61,4856.00,0.00
2024-12-08 14:56:31,932,2482,456,476,2977.41,4856.00,0.00
2024-12-08 14:56:31,931,2482,455,476,2970.56,4856.16,0.00
2024-12-08 14:56:31,932,2481,456,476,2966.60,4856.18,0.00
2024-12-08 14:56:31,933,2480,457,476,2963.63,4856.19,0.00
2024-12-08 14:56:31,932,2480,457,475,2965.99,4856.21,0.00
2024-12-08 14:56:31,931,2480,456,475,2969.08,4856.21,0.00
2024-12-08 14:56:31,930,2480,455,475,2972.22,4856.21,0.00
2024-12-08 14:56:31,931,2479,456,475,2968.04,4856.24,0.00
2024-12-08 14:56:31,932,2478,457,475,2962.13,4856.34,0.00
2024-12-08 14:56:31,933,2477,458,475,2956.88,4856.47,0.00
2024-12-08 14:56:31,934,2476,458,476,2953.60,4856.54,0.00
2024-12-08 14:56:31,933,2476,457,476,2944.78,4856.81,0.00
2024-12-08 14:56:31,933,2477,457,476,2982.48,4857.00,0.00
2024-12-08 14:56:31,934,2477,458,476,2979.28,4857.00,0.00
2024-12-08 14:56:31,933,2477,458,475,2979.43,4857.04,0.00
2024-12-08 14:56:31,932,2477,458,474,2979.48,4857.11,0.00
2024-12-08 14:56:31,933,2476,459,474,2973.74,4857.12,0.00
2024-12-08 14:56:31,932,2476,459,473,2974.98,4857.17,0.00
2024-12-08 14:56:31,931,2476,458,473,2976.37,4857.21,0.00
2024-12-08 14:56:31,930,2476,458,472,2979.52,4857.21,0.00
2024-12-08 14:56:31,929,2476,458,471,2982.67,4857.21,0.00
2024-12-08 14:56:31,928,2476,458,470,2985.73,4857.21,0.00
2024-12-08 14:56:31,927,2476,457,470,2988.90,4857.21,0.00
2024-12-08 14:56:31,928,2475,458,470,2967.49,4857.59,0.00
2024-12-08 14:56:31,929,2474,459,470,2959.57,4857.72,0.00
2024-12-08 14:56:31,930,2473,459,471,2956.82,4857.74,0.00
2024-12-08 14:56:31,931,2472,459,472,2950.84,4857.83,0.00
2024-12-08 14:56:31,931,2473,459,472,2980.31,4858.00,0.00
2024-12-08 14:56:31,932,2473,459,473,2977.12,4858.00,0.00
2024-12-08 14:56:31,931,2473,459,472,2978.71,4858.03,0.00
2024-12-08 14:56:31,932,2472,459,473,2972.16,4858.10,0.00
2024-12-08 14:56:31,933,2471,460,473,2968.70,4858.17,0.00
2024-12-08 14:56:31,932,2471,459,473,2972.43,4858.21,0.00
2024-12-08 14:56:31,931,2471,458,473,2975.52,4858.22,0.00
2024-12-08 14:56:31,932,2470,459,473,2960.50,4858.46,0.00
2024-12-08 14:56:31,933,2469,460,473,2957.73,4858.52,0.00
2024-12-08 14:56:31,934,2468,460,474,2951.58,4858.59,0.00
2024-12-08 14:56:31,935,2467,461,474,2940.77,4858.80,0.00
2024-12-08 14:56:31,935,2468,461,474,2961.42,4859.00,0.00
2024-12-08 14:56:31,936,2468,461,475,2958.26,4859.00,0.00
2024-12-08 14:56:31,937,2467,461,476,2949.19,4859.10,0.00
2024-12-08 14:56:31,938,2466,462,476,2946.98,4859.12,0.00
2024-12-08 14:56:31,939,2465,462,477,2942.01,4859.18,0.00
2024-12-08 14:56:31,938,2465,461,477,2947.45,4859.22,0.00
2024-12-08 14:56:31,937,2465,461,476,2950.55,4859.22,0.00
2024-12-08 14:56:31,936,2465,461,475,2953.65,4859.22,0.00
2024-12-08 14:56:31,937,2464,462,475,2949.82,4859.23,0.00
2024-12-08 14:56:31,938,2463,462,476,2941.64,4859.43,0.00
2024-12-08 14:56:31,939,2462,463,476,2938.19,4859.51,0.00
2024-12-08 14:56:31,940,2461,464,476,2935.18,4859.62,0.00
2024-12-08 14:56:31,941,2460,464,477,2923.29,4859.85,0.00
2024-12-08 14:56:31,942,2459,465,477,2920.66,4859.86,0.00
2024-12-08 14:56:31,943,2458,466,477,2917.77,4859.86,0.00
2024-12-08 14:56:31,943,2459,466,477,2948.19,4860.00,0.00
2024-12-08 14:56:31,944,2459,466,478,2945.07,4860.00,0.00
2024-12-08 14:56:31,943,2459,465,478,2947.99,4860.00,0.00
2024-12-08 14:56:31,944,2458,466,478,2942.72,4860.03,0.00
2024-12-08 14:56:31,943,2458,466,477,2945.64,4860.04,0.00
2024-12-08 14:56:31,944,2457,467,477,2942.47,4860.05,0.00
2024-12-08 14:56:31,945,2456,467,478,2934.84,4860.17,0.00
2024-12-08 14:56:31,946,2455,467,479,2931.44,4860.19,0.00
2024-12-08 14:56:31,945,2455,466,479,2935.02,4860.21,0.00
2024-12-08 14:56:31,944,2455,466,478,2938.08,4860.21,0.00
2024-12-08 14:56:31,943,2455,465,478,2941.14,4860.21,0.00
2024-12-08 14:56:31,944,2454,466,478,2933.94,4860.30,0.00
2024-12-08 14:56:31,945,2453,466,479,2933.78,4860.33,0.00
2024-12-08 14:56:31,946,2452,466,480,2926.73,4860.41,0.00
2024-12-08 14:56:31,947,2451,466,481,2903.70,4860.84,0.00
2024-12-08 14:56:31,947,2452,466,481,2953.37,4861.00,0.00
2024-12-08 14:56:31,948,2452,466,482,2950.25,4861.00,0.00
2024-12-08 14:56:31,949,2451,467,482,2942.36,4861.08,0.00
2024-12-08 14:56:31,948,2451,467,481,2941.64,4861.21,0.00
2024-12-08 14:56:31,947,2451,467,480,2944.70,4861.21,0.00
2024-12-08 14:56:31,946,2451,466,480,2947.76,4861.21,0.00
2024-12-08 14:56:31,945,2451,466,479,2950.78,4861.21,0.00
2024-12-08 14:56:31,946,2450,466,480,2945.11,4861.27,0.00
2024-12-08 14:56:31,947,2449,466,481,2932.58,4861.50,0.00
2024-12-08 14:56:31,948,2448,466,482,2920.26,4861.76,0.00
2024-12-08 14:56:31,948,2449,466,482,2955.96,4862.00,0.00
2024-12-08 14:56:31,949,2449,467,482,2952.84,4862.00,0.00
2024-12-08 14:56:31,950,2448,468,482,2945.67,4862.07,0.00
2024-12-08 14:56:31,951,2447,469,482,2935.83,4862.29,0.00
2024-12-08 14:56:31,952,2446,470,482,2934.99,4862.30,0.00
2024-12-08 14:56:31,951,2446,469,482,2939.27,4862.33,0.00
2024-12-08 14:56:31,952,2445,470,482,2935.32,4862.35,0.00
2024-12-08 14:56:32,953,2444,471,482,2915.63,4862.74,0.00
2024-12-08 14:56:32,954,2443,471,483,2913.30,4862.76,0.00
2024-12-08 14:56:32,955,2442,472,483,2907.16,4862.85,0.00
2024-12-08 14:56:32,955,2443,472,483,2926.53,4863.00,0.00
2024-12-08 14:56:32,956,2443,472,484,2923.47,4863.00,0.00
2024-12-08 14:56:32,957,2442,473,484,2920.17,4863.01,0.00
2024-12-08 14:56:32,956,2442,473,483,2925.57,4863.03,0.00
2024-12-08 14:56:32,957,2441,474,483,2915.42,4863.18,0.00
2024-12-08 14:56:32,958,2440,474,484,2913.97,4863.20,0.00
2024-12-08 14:56:32,957,2440,473,484,2918.70,4863.22,0.00
2024-12-08 14:56:32,956,2440,473,483,2921.65,4863.22,0.00
2024-12-08 14:56:32,957,2439,473,484,2913.86,4863.32,0.00
2024-12-08 14:56:32,958,2438,474,484,2903.93,4863.46,0.00
2024-12-08 14:56:32,959,2437,475,484,2901.29,4863.52,0.00
2024-12-08 14:56:32,960,2436,475,485,2898.45,4863.58,0.00
2024-12-08 14:56:32,961,2435,476,485,2886.32,4863.80,0.00
2024-12-08 14:56:32,961,2436,476,485,2916.20,4864.00,0.00
2024-12-08 14:56:32,962,2436,476,486,2913.17,4864.00,0.00
2024-12-08 14:56:32,963,2435,476,487,2909.44,4864.02,0.00
2024-12-08 14:56:32,962,2435,475,487,2914.39,4864.02,0.00
2024-12-08 14:56:32,961,2435,475,486,2916.11,4864.03,0.00
2024-12-08 14:56:32,960,2435,474,486,2918.45,4864.04,0.00
2024-12-08 14:56:32,959,2435,473,486,2919.93,4864.07,0.00
2024-12-08 14:56:32,960,2434,474,486,2914.54,4864.12,0.00
2024-12-08 14:56:32,959,2434,473,486,2915.74,4864.20,0.00
2024-12-08 14:56:32,958,2434,473,485,2918.08,4864.21,0.00
2024-12-08 14:56:32,957,2434,473,484,2921.08,4864.21,0.00
2024-12-08 14:56:32,956,2434,472,484,2924.08,4864.21,0.00
2024-12-08 14:56:32,955,2434,472,483,2927.04,4864.21,0.00
2024-12-08 14:56:32,956,2433,473,483,2923.58,4864.22,0.00
2024-12-08 14:56:32,955,2433,472,483,2916.18,4864.42,0.00
2024-12-08 14:56:32,954,2433,471,483,2916.06,4864.48,0.00
2024-12-08 14:56:32,955,2432,471,484,2900.98,4864.74,0.00
2024-12-08 14:56:32,955,2433,471,484,2935.74,4865.00,0.00
2024-12-08 14:56:32,956,2433,471,485,2932.67,4865.00,0.00
2024-12-08 14:56:32,957,2432,471,486,2926.98,4865.04,0.00
2024-12-08 14:56:32,958,2431,471,487,2921.38,4865.12,0.00
2024-12-08 14:56:32,959,2430,471,488,2916.19,4865.20,0.00
2024-12-08 14:56:32,958,2430,471,487,2918.48,4865.21,0.00
2024-12-08 14:56:32,959,2429,472,487,2912.32,4865.28,0.00
2024-12-08 14:56:32,960,2428,472,488,2907.48,4865.34,0.00
2024-12-08 14:56:32,961,2427,473,488,2900.06,4865.46,0.00
2024-12-08 14:56:32,962,2426,473,489,2894.96,4865.54,0.00
2024-12-08 14:56:32,963,2425,473,490,2894.58,4865.54,0.00
2024-12-08 14:56:32,964,2424,474,490,2887.71,4865.67,0.00
2024-12-08 14:56:32,965,2423,474,491,2876.26,4865.89,0.00
