Timestamp,NAnimals,NResources,NFemales,NMales,MeanLifeSuccess,MeanAge,%MatingAccept
2024-12-10 20:49:55,100,0,43,57,0.00,0.00,0.00
2024-12-10 20:49:55,100,0,43,57,0.00,0.00,0.00
2024-12-10 20:49:55,100,1,43,57,0.74,1.00,0.00
2024-12-10 20:49:55,101,1,43,58,0.73,1.01,0.00
2024-12-10 20:49:55,100,1,43,57,0.76,1.14,1.00
2024-12-10 20:49:55,99,1,43,56,0.80,1.18,1.00
2024-12-10 20:49:55,98,1,43,55,0.82,1.22,1.00
2024-12-10 20:49:55,97,1,42,55,0.83,1.23,1.00
2024-12-10 20:49:55,96,1,42,54,0.83,1.24,1.00
2024-12-10 20:49:55,95,1,42,53,0.84,1.25,1.00
2024-12-10 20:49:55,94,1,41,53,0.87,1.31,1.00
2024-12-10 20:49:55,93,1,40,53,0.89,1.32,1.00
2024-12-10 20:49:55,92,1,40,52,0.93,1.39,1.00
2024-12-10 20:49:55,91,1,40,51,0.94,1.40,1.00
2024-12-10 20:49:55,90,1,40,50,0.96,1.48,1.00
2024-12-10 20:49:55,89,1,40,49,0.96,1.48,1.00
2024-12-10 20:49:55,88,1,40,48,0.98,1.50,1.00
2024-12-10 20:49:55,87,1,39,48,1.08,1.63,1.00
2024-12-10 20:49:55,86,1,38,48,1.10,1.66,1.00
2024-12-10 20:49:55,85,1,38,47,1.22,1.91,1.00
2024-12-10 20:49:55,84,1,38,46,1.24,1.93,1.00
2024-12-10 20:49:55,83,1,37,46,1.26,1.95,1.00
2024-12-10 20:49:55,82,1,36,46,1.27,1.96,1.00
2024-12-10 20:49:56,82,2,36,46,1.28,2.00,1.00
2024-12-10 20:49:56,83,2,37,46,1.27,2.01,1.00
2024-12-10 20:49:56,82,2,37,45,1.30,2.05,1.00
2024-12-10 20:49:56,81,2,37,44,1.32,2.07,1.00
2024-12-10 20:49:56,80,2,36,44,1.33,2.09,1.00
2024-12-10 20:49:56,79,2,36,43,1.34,2.09,1.00
2024-12-10 20:49:56,78,2,36,42,1.38,2.18,1.00
2024-12-10 20:49:56,77,2,35,42,1.42,2.22,1.00
2024-12-10 20:49:56,76,2,35,41,1.48,2.28,1.00
2024-12-10 20:49:56,75,2,34,41,1.54,2.39,1.00
2024-12-10 20:49:56,74,2,33,41,1.57,2.41,1.00
2024-12-10 20:49:56,73,2,33,40,1.59,2.41,1.00
2024-12-10 20:49:56,72,2,32,40,1.61,2.42,1.00
2024-12-10 20:49:56,71,2,32,39,1.68,2.49,1.00
2024-12-10 20:49:56,70,2,32,38,1.82,2.69,1.00
2024-12-10 20:49:56,69,2,32,37,1.85,2.74,1.00
2024-12-10 20:49:56,68,2,31,37,1.86,2.75,1.00
2024-12-10 20:49:56,67,2,31,36,1.92,2.82,1.00
2024-12-10 20:49:56,66,2,30,36,1.94,2.85,1.00
2024-12-10 20:49:56,65,2,29,36,2.02,2.95,1.00
2024-12-10 20:49:56,65,3,29,36,2.07,3.00,1.00
2024-12-10 20:49:56,66,3,29,37,2.04,3.02,0.00
2024-12-10 20:49:56,65,3,29,36,2.10,3.05,0.00
2024-12-10 20:49:56,64,3,29,35,2.13,3.08,0.00
2024-12-10 20:49:56,63,3,29,34,2.17,3.08,0.00
2024-12-10 20:49:56,62,3,28,34,2.20,3.10,0.00
2024-12-10 20:49:56,61,3,27,34,2.27,3.13,0.00
2024-12-10 20:49:56,60,3,26,34,2.38,3.32,0.00
2024-12-10 20:49:56,59,3,25,34,2.42,3.32,0.00
2024-12-10 20:49:56,58,3,25,33,2.63,3.57,0.00
2024-12-10 20:49:56,57,3,25,32,2.68,3.60,0.00
2024-12-10 20:49:56,56,3,25,31,2.80,3.73,0.00
2024-12-10 20:49:56,55,3,24,31,2.88,3.78,0.00
2024-12-10 20:49:56,54,3,24,30,2.94,3.81,0.00
2024-12-10 20:49:56,54,4,24,30,3.06,4.00,0.00
2024-12-10 20:49:56,55,4,24,31,3.00,4.02,0.00
2024-12-10 20:49:56,54,4,24,30,3.15,4.24,0.00
2024-12-10 20:49:56,53,4,23,30,3.37,4.64,0.00
2024-12-10 20:49:56,52,4,22,30,3.59,4.87,0.00
2024-12-10 20:49:56,51,4,22,29,3.67,4.92,0.00
2024-12-10 20:49:56,51,5,22,29,3.78,5.00,0.00
2024-12-10 20:49:56,52,5,23,29,3.70,5.02,0.00
2024-12-10 20:49:56,51,5,22,29,3.82,5.29,0.00
2024-12-10 20:49:56,50,5,21,29,4.23,5.96,0.00
2024-12-10 20:49:56,50,6,21,29,4.37,6.00,0.00
2024-12-10 20:49:56,51,6,22,29,4.28,6.02,0.00
2024-12-10 20:49:56,50,6,21,29,4.45,6.40,0.00
2024-12-10 20:49:56,49,6,21,28,4.54,6.43,0.00
2024-12-10 20:49:56,49,7,21,28,4.97,7.00,0.00
2024-12-10 20:49:56,50,7,21,29,4.88,7.02,0.00
2024-12-10 20:49:56,49,7,21,28,5.06,7.39,0.00
2024-12-10 20:49:56,48,7,21,27,5.37,7.71,0.00
2024-12-10 20:49:56,48,8,21,27,5.62,8.00,0.00
2024-12-10 20:49:56,49,8,21,28,5.51,8.02,0.00
2024-12-10 20:49:56,48,8,21,27,5.73,8.21,0.00
2024-12-10 20:49:56,47,8,20,27,5.80,8.26,0.00
2024-12-10 20:49:56,46,8,20,26,6.17,8.76,0.00
2024-12-10 20:49:56,46,9,20,26,6.48,9.00,0.00
2024-12-10 20:49:56,47,9,20,27,6.35,9.02,0.00
2024-12-10 20:49:56,46,9,19,27,6.57,9.24,0.00
2024-12-10 20:49:56,45,9,19,26,6.72,9.38,0.00
2024-12-10 20:49:56,45,10,19,26,7.30,10.00,0.00
2024-12-10 20:49:56,46,10,19,27,7.14,10.02,0.00
2024-12-10 20:49:56,45,10,18,27,7.30,10.07,0.00
2024-12-10 20:49:56,45,11,18,27,7.93,11.00,0.00
2024-12-10 20:49:56,46,11,18,28,7.75,11.02,0.00
2024-12-10 20:49:57,46,12,18,28,8.29,12.00,0.00
2024-12-10 20:49:57,47,12,18,29,8.11,12.02,0.00
2024-12-10 20:49:57,46,12,18,28,8.32,12.07,0.00
2024-12-10 20:49:57,45,12,17,28,8.60,12.29,0.00
2024-12-10 20:49:57,44,12,16,28,8.75,12.30,0.00
2024-12-10 20:49:57,44,13,16,28,9.32,13.00,0.00
2024-12-10 20:49:57,45,13,17,28,9.11,13.02,0.00
2024-12-10 20:49:57,44,13,16,28,9.62,13.70,0.00
2024-12-10 20:49:57,44,14,16,28,10.02,14.00,0.00
2024-12-10 20:49:57,45,14,16,29,9.80,14.02,0.00
2024-12-10 20:49:57,45,15,16,29,10.45,15.00,0.00
2024-12-10 20:49:57,46,15,16,30,10.22,15.02,0.00
2024-12-10 20:49:57,45,15,16,29,10.78,15.64,0.00
2024-12-10 20:49:57,45,16,16,29,11.04,16.00,0.00
2024-12-10 20:49:57,46,16,16,30,10.80,16.02,0.00
2024-12-10 20:49:57,46,17,16,30,11.41,17.00,0.00
2024-12-10 20:49:57,47,17,16,31,11.17,17.02,0.00
2024-12-10 20:49:57,46,17,15,31,11.53,17.65,0.00
2024-12-10 20:49:57,45,17,15,30,11.85,17.82,0.00
2024-12-10 20:49:57,45,18,15,30,12.35,18.00,0.00
2024-12-10 20:49:57,46,18,16,30,12.08,18.02,0.00
2024-12-10 20:49:57,46,19,16,30,12.72,19.00,0.00
2024-12-10 20:49:57,47,19,17,30,12.45,19.02,0.00
2024-12-10 20:49:57,46,19,17,29,12.80,19.20,0.00
2024-12-10 20:49:57,45,19,17,28,13.11,19.24,0.00
2024-12-10 20:49:57,44,19,17,27,13.35,19.34,0.00
2024-12-10 20:49:57,43,19,17,26,13.80,19.58,0.00
2024-12-10 20:49:57,43,20,17,26,14.30,20.00,0.00
2024-12-10 20:49:57,44,20,17,27,13.98,20.02,0.00
2024-12-10 20:49:57,44,21,17,27,14.66,21.00,0.00
2024-12-10 20:49:57,45,21,17,28,14.34,21.02,0.00
2024-12-10 20:49:57,44,21,17,27,14.95,21.64,0.00
2024-12-10 20:49:57,43,21,16,27,15.28,21.67,0.00
2024-12-10 20:49:57,43,22,16,27,15.97,22.00,0.00
2024-12-10 20:49:57,44,22,16,28,15.61,22.02,0.00
2024-12-10 20:49:57,43,22,15,28,16.02,22.19,0.00
2024-12-10 20:49:57,43,23,15,28,16.87,23.00,0.00
2024-12-10 20:49:57,44,23,16,28,16.48,23.02,0.00
2024-12-10 20:49:57,44,24,16,28,17.19,24.00,0.00
2024-12-10 20:49:57,45,24,17,28,16.81,24.02,0.00
2024-12-10 20:49:57,45,25,17,28,17.43,25.00,0.00
2024-12-10 20:49:57,46,25,18,28,17.05,25.02,0.00
2024-12-10 20:49:57,45,25,18,27,17.55,25.60,0.00
2024-12-10 20:49:57,45,26,18,27,18.07,26.00,0.00
2024-12-10 20:49:57,46,26,19,27,17.67,26.02,0.00
2024-12-10 20:49:57,46,27,19,27,18.43,27.00,0.00
2024-12-10 20:49:57,47,27,19,28,18.03,27.02,0.00
2024-12-10 20:49:57,47,28,19,28,18.69,28.00,0.00
2024-12-10 20:49:57,48,28,20,28,18.30,28.02,0.00
2024-12-10 20:49:57,47,28,19,28,18.74,28.21,0.00
2024-12-10 20:49:57,46,28,18,28,19.03,28.70,0.00
2024-12-10 20:49:57,46,29,18,28,19.81,29.00,0.00
2024-12-10 20:49:57,47,29,18,29,19.39,29.02,0.00
2024-12-10 20:49:57,46,29,18,28,19.84,29.59,0.00
2024-12-10 20:49:57,46,30,18,28,20.41,30.00,0.00
2024-12-10 20:49:57,47,30,18,29,19.98,30.02,0.00
2024-12-10 20:49:57,47,31,18,29,20.76,31.00,0.00
2024-12-10 20:49:57,48,31,19,29,20.32,31.02,0.00
2024-12-10 20:49:57,48,32,19,29,21.02,32.00,0.00
2024-12-10 20:49:57,49,32,20,29,20.59,32.02,0.00
2024-12-10 20:49:57,48,32,19,29,20.96,32.94,0.00
2024-12-10 20:49:57,48,33,19,29,21.67,33.00,0.00
2024-12-10 20:49:57,49,33,19,30,21.23,33.02,0.00
2024-12-10 20:49:57,49,34,19,30,21.70,34.00,0.00
2024-12-10 20:49:57,50,34,20,30,21.26,34.02,0.00
2024-12-10 20:49:57,49,34,20,29,21.75,34.63,0.00
2024-12-10 20:49:57,49,35,20,29,22.33,35.00,0.00
2024-12-10 20:49:57,50,35,21,29,21.88,35.02,0.00
2024-12-10 20:49:57,50,36,21,29,22.58,36.00,0.00
2024-12-10 20:49:57,51,36,22,29,22.13,36.02,0.00
2024-12-10 20:49:57,51,37,22,29,22.71,37.00,0.00
2024-12-10 20:49:57,52,37,23,29,22.27,37.02,0.00
2024-12-10 20:49:57,52,38,23,29,22.76,38.00,0.00
2024-12-10 20:49:57,53,38,23,30,22.33,38.02,0.00
2024-12-10 20:49:57,52,38,22,30,22.78,38.50,0.00
2024-12-10 20:49:57,51,38,22,29,23.11,38.59,0.00
2024-12-10 20:49:58,51,39,22,29,23.70,39.00,0.00
2024-12-10 20:49:58,52,39,22,30,23.25,39.02,0.00
2024-12-10 20:49:58,52,40,22,30,23.94,40.00,0.00
2024-12-10 20:49:58,53,40,23,30,23.49,40.02,0.00
2024-12-10 20:49:58,52,40,23,29,23.93,40.25,0.00
2024-12-10 20:49:58,52,41,23,29,24.56,41.00,0.00
2024-12-10 20:49:58,53,41,23,30,24.09,41.02,0.00
2024-12-10 20:49:58,53,42,23,30,24.59,42.00,0.00
2024-12-10 20:49:58,54,42,23,31,24.13,42.02,0.00
2024-12-10 20:49:58,53,42,23,30,24.52,42.55,0.00
2024-12-10 20:49:58,53,43,23,30,25.11,43.00,0.00
2024-12-10 20:49:58,54,43,23,31,24.65,43.02,0.00
2024-12-10 20:49:58,54,44,23,31,25.26,44.00,0.00
2024-12-10 20:49:58,55,44,24,31,24.80,44.02,0.00
2024-12-10 20:49:58,54,44,23,31,25.15,44.43,0.00
2024-12-10 20:49:58,54,45,23,31,25.75,45.00,0.00
2024-12-10 20:49:58,55,45,23,32,25.28,45.02,0.00
2024-12-10 20:49:58,54,45,22,32,25.59,45.54,0.00
2024-12-10 20:49:58,54,46,22,32,26.22,46.00,0.00
2024-12-10 20:49:58,55,46,22,33,25.74,46.02,0.00
2024-12-10 20:49:58,54,46,22,32,26.13,46.52,0.00
2024-12-10 20:49:58,54,47,22,32,26.74,47.00,0.00
2024-12-10 20:49:58,55,47,23,32,26.26,47.02,0.00
2024-12-10 20:49:58,55,48,23,32,26.94,48.00,0.00
2024-12-10 20:49:58,56,48,23,33,26.46,48.02,0.00
2024-12-10 20:49:58,56,49,23,33,27.04,49.00,0.00
2024-12-10 20:49:58,57,49,24,33,26.56,49.02,0.00
2024-12-10 20:49:58,57,50,24,33,26.98,50.00,0.00
2024-12-10 20:49:58,58,50,24,34,26.51,50.02,0.00
2024-12-10 20:49:58,57,50,24,33,26.85,50.51,0.00
2024-12-10 20:49:58,57,51,24,33,27.46,51.00,0.00
2024-12-10 20:49:58,58,51,25,33,26.98,51.02,0.00
2024-12-10 20:49:58,58,52,25,33,27.61,52.00,0.00
2024-12-10 20:49:58,59,52,25,34,27.14,52.02,0.00
2024-12-10 20:49:58,58,52,24,34,27.33,52.67,0.00
2024-12-10 20:49:58,58,53,24,34,28.08,53.00,0.00
2024-12-10 20:49:58,59,53,25,34,27.61,53.02,0.00
2024-12-10 20:49:58,58,53,24,34,27.65,53.74,0.00
2024-12-10 20:49:58,58,54,24,34,28.61,54.00,0.00
2024-12-10 20:49:58,59,54,25,34,28.12,54.02,0.00
2024-12-10 20:49:58,58,54,25,33,28.47,54.50,0.00
2024-12-10 20:49:58,58,55,25,33,28.92,55.00,0.00
2024-12-10 20:49:58,59,55,26,33,28.43,55.02,0.00
2024-12-10 20:49:58,58,55,25,33,28.64,55.53,0.00
2024-12-10 20:49:58,58,56,25,33,29.49,56.00,0.00
2024-12-10 20:49:58,59,56,25,34,28.99,56.02,0.00
2024-12-10 20:49:58,59,57,25,34,29.42,57.00,0.00
2024-12-10 20:49:58,60,57,25,35,28.93,57.02,0.00
2024-12-10 20:49:58,60,58,25,35,29.15,58.00,0.00
2024-12-10 20:49:58,61,58,26,35,28.67,58.02,0.00
2024-12-10 20:49:58,60,58,26,34,28.94,58.48,0.00
2024-12-10 20:49:58,59,58,25,34,29.00,58.97,0.00
2024-12-10 20:49:58,59,59,25,34,29.99,59.00,0.00
2024-12-10 20:49:58,60,59,25,35,29.49,59.02,0.00
2024-12-10 20:49:58,60,60,25,35,29.87,60.00,0.00
2024-12-10 20:49:58,61,60,25,36,29.38,60.02,0.00
2024-12-10 20:49:58,60,60,24,36,29.84,60.07,0.00
2024-12-10 20:49:58,59,60,23,36,29.86,60.61,0.00
2024-12-10 20:49:58,59,61,23,36,30.80,61.00,0.00
2024-12-10 20:49:58,60,61,23,37,30.28,61.02,0.00
2024-12-10 20:49:58,59,61,22,37,30.41,61.68,0.00
2024-12-10 20:49:58,59,62,22,37,30.95,62.00,0.00
2024-12-10 20:49:58,60,62,23,37,30.43,62.02,0.00
2024-12-10 20:49:58,59,62,23,36,30.69,62.53,0.00
2024-12-10 20:49:58,58,62,23,35,31.15,62.71,0.00
2024-12-10 20:49:58,57,62,22,35,31.57,62.81,0.00
2024-12-10 20:49:58,57,63,22,35,32.71,63.00,0.00
2024-12-10 20:49:58,58,63,23,35,32.15,63.02,0.00
2024-12-10 20:49:58,57,63,23,34,32.68,63.07,0.00
2024-12-10 20:49:58,57,64,23,34,33.31,64.00,0.00
2024-12-10 20:49:58,58,64,23,35,32.73,64.02,0.00
2024-12-10 20:49:58,58,65,23,35,33.20,65.00,0.00
2024-12-10 20:49:58,59,65,23,36,32.63,65.02,0.00
2024-12-10 20:49:58,58,65,22,36,32.99,65.50,0.00
2024-12-10 20:49:58,58,66,22,36,33.49,66.00,0.00
2024-12-10 20:49:58,59,66,22,37,32.92,66.02,0.00
2024-12-10 20:49:58,58,66,22,36,33.27,66.50,0.00
2024-12-10 20:49:58,57,66,21,36,33.84,66.67,0.00
2024-12-10 20:49:59,57,67,21,36,34.50,67.00,0.00
2024-12-10 20:49:59,58,67,21,37,33.91,67.02,0.00
2024-12-10 20:49:59,58,68,21,37,34.37,68.00,0.00
2024-12-10 20:49:59,59,68,21,38,33.79,68.02,0.00
2024-12-10 20:49:59,59,69,21,38,34.06,69.00,0.00
2024-12-10 20:49:59,60,69,21,39,33.49,69.02,0.00
2024-12-10 20:49:59,59,69,21,38,33.96,69.22,0.00
2024-12-10 20:49:59,58,69,20,38,33.73,69.50,0.00
2024-12-10 20:49:59,58,70,20,38,34.72,70.00,0.00
2024-12-10 20:49:59,59,70,20,39,34.14,70.02,0.00
2024-12-10 20:49:59,58,70,20,38,34.55,70.41,0.00
2024-12-10 20:49:59,57,70,20,37,35.12,70.47,0.00
2024-12-10 20:49:59,56,70,19,37,35.48,70.89,0.00
2024-12-10 20:49:59,56,71,19,37,36.76,71.00,0.00
2024-12-10 20:49:59,57,71,20,37,36.11,71.02,0.00
2024-12-10 20:49:59,57,72,20,37,36.51,72.00,0.00
2024-12-10 20:49:59,58,72,21,37,35.88,72.02,0.00
2024-12-10 20:49:59,57,72,20,37,36.31,72.44,0.00
2024-12-10 20:49:59,56,72,19,37,36.54,72.71,0.00
2024-12-10 20:49:59,56,73,19,37,37.55,73.00,0.00
2024-12-10 20:49:59,57,73,20,37,36.89,73.02,0.00
2024-12-10 20:49:59,56,73,20,36,37.06,73.46,0.00
2024-12-10 20:49:59,56,74,20,36,37.84,74.00,0.00
2024-12-10 20:49:59,57,74,21,36,37.18,74.02,0.00
2024-12-10 20:49:59,57,75,21,36,37.82,75.00,0.00
2024-12-10 20:49:59,58,75,22,36,37.17,75.02,0.00
2024-12-10 20:49:59,58,76,22,36,37.66,76.00,0.00
2024-12-10 20:49:59,59,76,23,36,37.02,76.02,0.00
2024-12-10 20:49:59,59,77,23,36,37.31,77.00,0.00
2024-12-10 20:49:59,60,77,24,36,36.69,77.02,0.00
2024-12-10 20:49:59,59,77,24,35,37.04,77.47,0.00
2024-12-10 20:49:59,59,78,24,35,37.79,78.00,0.00
2024-12-10 20:49:59,60,78,24,36,37.16,78.02,0.00
2024-12-10 20:49:59,59,78,23,36,37.44,78.41,0.00
2024-12-10 20:49:59,59,79,23,36,38.44,79.00,0.00
2024-12-10 20:49:59,60,79,23,37,37.80,79.02,0.00
2024-12-10 20:49:59,60,80,23,37,38.39,80.00,0.00
2024-12-10 20:49:59,61,80,24,37,37.76,80.02,0.00
2024-12-10 20:49:59,60,80,24,36,38.37,80.05,0.00
2024-12-10 20:49:59,60,81,24,36,38.88,81.00,0.00
2024-12-10 20:49:59,61,81,25,36,38.25,81.02,0.00
2024-12-10 20:49:59,61,82,25,36,38.53,82.00,0.00
2024-12-10 20:49:59,62,82,26,36,37.91,82.02,0.00
2024-12-10 20:49:59,61,82,26,35,38.13,82.52,0.00
2024-12-10 20:49:59,61,83,26,35,38.90,83.00,0.00
2024-12-10 20:49:59,62,83,26,36,38.27,83.02,0.00
2024-12-10 20:49:59,62,84,26,36,38.80,84.00,0.00
2024-12-10 20:49:59,63,84,26,37,38.18,84.02,0.00
2024-12-10 20:49:59,62,84,26,36,38.59,84.29,0.00
2024-12-10 20:49:59,62,85,26,36,39.17,85.00,0.00
2024-12-10 20:49:59,63,85,27,36,38.55,85.02,0.00
2024-12-10 20:49:59,62,85,26,36,38.08,85.95,0.00
2024-12-10 20:49:59,62,86,26,36,39.45,86.00,0.00
2024-12-10 20:49:59,63,86,27,36,38.83,86.02,0.00
2024-12-10 20:49:59,62,86,27,35,39.06,86.50,0.00
2024-12-10 20:49:59,62,87,27,35,39.74,87.00,0.00
2024-12-10 20:49:59,63,87,28,35,39.11,87.02,0.00
2024-12-10 20:49:59,63,88,28,35,39.55,88.00,0.00
2024-12-10 20:49:59,64,88,29,35,38.93,88.02,0.00
2024-12-10 20:49:59,64,89,29,35,39.24,89.00,0.00
2024-12-10 20:49:59,65,89,30,35,38.64,89.02,0.00
2024-12-10 20:49:59,64,89,29,35,39.19,89.06,0.00
2024-12-10 20:49:59,63,89,29,34,39.47,89.27,0.00
2024-12-10 20:49:59,63,90,29,34,40.57,90.00,0.00
2024-12-10 20:49:59,64,90,30,34,39.93,90.02,0.00
2024-12-10 20:49:59,63,90,29,34,40.40,90.21,0.00
2024-12-10 20:49:59,62,90,28,34,40.40,90.81,0.00
2024-12-10 20:49:59,62,91,28,34,41.36,91.00,0.00
2024-12-10 20:49:59,63,91,29,34,40.70,91.02,0.00
2024-12-10 20:49:59,62,91,29,33,41.19,91.06,0.00
2024-12-10 20:49:59,61,91,28,33,41.60,91.21,0.00
2024-12-10 20:49:59,61,92,28,33,42.80,92.00,0.00
2024-12-10 20:49:59,62,92,28,34,42.11,92.02,0.00
2024-12-10 20:49:59,61,92,28,33,42.46,92.44,0.00
2024-12-10 20:49:59,61,93,28,33,43.14,93.00,0.00
2024-12-10 20:49:59,62,93,29,33,42.44,93.02,0.00
2024-12-10 20:49:59,62,94,29,33,42.81,94.00,0.00
2024-12-10 20:49:59,63,94,29,34,42.13,94.02,0.00
2024-12-10 20:49:59,63,95,29,34,42.36,95.00,0.00
2024-12-10 20:49:59,64,95,29,35,41.69,95.02,0.00
2024-12-10 20:49:59,63,95,28,35,42.03,95.40,0.00
2024-12-10 20:49:59,63,96,28,35,42.41,96.00,0.00
2024-12-10 20:49:59,64,96,28,36,41.74,96.02,0.00
2024-12-10 20:49:59,63,96,28,35,41.89,96.43,0.00
2024-12-10 20:50:00,63,97,28,35,42.65,97.00,0.00
2024-12-10 20:50:00,64,97,29,35,41.98,97.02,0.00
2024-12-10 20:50:00,63,97,29,34,42.52,97.14,0.00
2024-12-10 20:50:00,62,97,28,34,42.63,97.40,0.00
2024-12-10 20:50:00,62,98,28,34,43.71,98.00,0.00
2024-12-10 20:50:00,63,98,28,35,43.01,98.02,0.00
2024-12-10 20:50:00,63,99,28,35,43.38,99.00,0.00
2024-12-10 20:50:00,64,99,28,36,42.71,99.02,0.00
2024-12-10 20:50:00,63,99,27,36,43.37,99.02,0.00
2024-12-10 20:50:00,62,99,27,35,44.05,99.02,0.00
2024-12-10 20:50:00,61,99,27,34,44.76,99.02,0.00
2024-12-10 20:50:00,60,99,27,33,45.49,99.02,0.00
2024-12-10 20:50:00,59,99,26,33,46.24,99.02,0.00
2024-12-10 20:50:00,58,99,25,33,47.02,99.02,0.00
2024-12-10 20:50:00,57,99,24,33,47.83,99.02,0.00
2024-12-10 20:50:00,56,99,24,32,48.67,99.02,0.00
2024-12-10 20:50:00,55,99,24,31,49.53,99.02,0.00
2024-12-10 20:50:00,54,99,24,30,50.43,99.02,0.00
2024-12-10 20:50:00,53,99,24,29,51.36,99.02,0.00
2024-12-10 20:50:00,52,99,23,29,52.33,99.02,0.00
2024-12-10 20:50:00,51,99,22,29,53.26,99.12,0.00
2024-12-10 20:50:00,50,99,22,28,53.86,99.24,0.00
2024-12-10 20:50:00,49,99,21,28,54.73,99.90,0.00
2024-12-10 20:50:00,49,100,21,28,56.05,100.00,0.00
2024-12-10 20:50:00,50,100,21,29,54.93,100.02,0.00
2024-12-10 20:50:00,50,101,21,29,55.75,101.00,0.00
2024-12-10 20:50:00,51,101,22,29,54.66,101.02,0.00
2024-12-10 20:50:00,50,101,21,29,55.67,101.10,0.00
2024-12-10 20:50:00,49,101,21,28,56.69,101.18,0.00
2024-12-10 20:50:00,48,101,20,28,56.64,101.71,0.00
2024-12-10 20:50:00,48,102,20,28,58.68,102.00,0.00
2024-12-10 20:50:00,49,102,21,28,57.48,102.02,0.00
2024-12-10 20:50:00,48,102,21,27,58.14,102.23,0.00
2024-12-10 20:50:00,48,103,21,27,59.15,103.00,0.00
2024-12-10 20:50:00,49,103,22,27,57.94,103.02,0.00
2024-12-10 20:50:00,48,103,21,27,58.37,103.44,0.00
2024-12-10 20:50:00,48,104,21,27,60.35,104.00,0.00
2024-12-10 20:50:00,49,104,21,28,59.12,104.02,0.00
2024-12-10 20:50:00,48,104,20,28,60.20,104.19,0.00
2024-12-10 20:50:00,48,105,20,28,60.90,105.00,0.00
2024-12-10 20:50:00,49,105,20,29,59.66,105.02,0.00
2024-12-10 20:50:00,48,105,20,28,60.40,105.21,0.00
2024-12-10 20:50:00,48,106,20,28,61.42,106.00,0.00
2024-12-10 20:50:00,49,106,21,28,60.16,106.02,0.00
2024-12-10 20:50:00,49,107,21,28,60.98,107.00,0.00
2024-12-10 20:50:00,50,107,22,28,59.76,107.02,0.00
2024-12-10 20:50:00,50,108,22,28,60.25,108.00,0.00
2024-12-10 20:50:00,51,108,22,29,59.07,108.02,0.00
2024-12-10 20:50:00,50,108,22,28,59.79,108.20,0.00
2024-12-10 20:50:00,50,109,22,28,60.74,109.00,0.00
2024-12-10 20:50:00,51,109,23,28,59.55,109.02,0.00
2024-12-10 20:50:00,50,109,23,27,60.72,109.02,0.00
2024-12-10 20:50:00,50,110,23,27,61.51,110.00,0.00
2024-12-10 20:50:00,51,110,24,27,60.30,110.02,0.00
2024-12-10 20:50:00,50,110,24,26,61.49,110.02,0.00
2024-12-10 20:50:00,49,110,23,26,61.05,110.84,0.00
2024-12-10 20:50:00,49,111,23,26,63.24,111.00,0.00
2024-12-10 20:50:00,50,111,24,26,61.97,111.02,0.00
2024-12-10 20:50:00,49,111,24,25,63.22,111.02,0.00
2024-12-10 20:50:00,48,111,24,24,64.09,111.17,0.00
2024-12-10 20:50:00,48,112,24,24,65.06,112.00,0.00
2024-12-10 20:50:00,49,112,25,24,63.73,112.02,0.00
2024-12-10 20:50:00,49,113,25,24,64.51,113.00,0.00
2024-12-10 20:50:00,50,113,26,24,63.22,113.02,0.00
2024-12-10 20:50:00,50,114,26,24,63.64,114.00,0.00
2024-12-10 20:50:00,51,114,26,25,62.39,114.02,0.00
2024-12-10 20:50:00,50,114,26,24,63.24,114.16,0.00
2024-12-10 20:50:00,50,115,26,24,64.12,115.00,0.00
2024-12-10 20:50:00,51,115,26,25,62.86,115.02,0.00
2024-12-10 20:50:00,51,116,26,25,63.50,116.00,0.00
2024-12-10 20:50:00,52,116,26,26,62.28,116.02,0.00
2024-12-10 20:50:00,52,117,26,26,62.55,117.00,0.00
2024-12-10 20:50:00,53,117,26,27,61.37,117.02,0.00
2024-12-10 20:50:00,52,117,26,26,62.20,117.15,0.00
2024-12-10 20:50:00,51,117,25,26,61.90,117.94,0.00
2024-12-10 20:50:00,51,118,25,26,64.18,118.00,0.00
2024-12-10 20:50:00,52,118,26,26,62.95,118.02,0.00
2024-12-10 20:50:00,52,119,26,26,63.39,119.00,0.00
2024-12-10 20:50:00,53,119,26,27,62.19,119.02,0.00
2024-12-10 20:50:00,52,119,26,26,63.35,119.04,0.00
2024-12-10 20:50:00,52,120,26,26,63.45,120.00,0.00
2024-12-10 20:50:00,53,120,26,27,62.26,120.02,0.00
2024-12-10 20:50:00,52,120,26,26,63.15,120.13,0.00
2024-12-10 20:50:00,52,121,26,26,63.69,121.00,0.00
2024-12-10 20:50:00,53,121,27,26,62.49,121.02,0.00
2024-12-10 20:50:00,52,121,26,26,62.23,121.60,0.00
2024-12-10 20:50:00,52,122,26,26,64.05,122.00,0.00
2024-12-10 20:50:00,53,122,26,27,62.84,122.02,0.00
2024-12-10 20:50:00,53,123,26,27,62.78,123.00,0.00
2024-12-10 20:50:00,54,123,27,27,61.61,123.02,0.00
2024-12-10 20:50:00,53,123,27,26,62.52,123.13,0.00
2024-12-10 20:50:00,53,124,27,26,62.80,124.00,0.00
2024-12-10 20:50:00,54,124,28,26,61.64,124.02,0.00
2024-12-10 20:50:00,53,124,27,26,61.93,124.30,0.00
2024-12-10 20:50:00,53,125,27,26,63.28,125.00,0.00
2024-12-10 20:50:00,54,125,28,26,62.11,125.02,0.00
2024-12-10 20:50:00,53,125,27,26,63.26,125.02,0.00
2024-12-10 20:50:00,53,126,27,26,62.79,126.00,0.00
2024-12-10 20:50:00,54,126,27,27,61.63,126.02,0.00
2024-12-10 20:50:00,53,126,27,26,62.60,126.11,0.00
2024-12-10 20:50:00,52,126,27,25,62.65,126.69,0.00
2024-12-10 20:50:00,52,127,27,25,63.92,127.00,0.00
2024-12-10 20:50:00,53,127,27,26,62.72,127.02,0.00
2024-12-10 20:50:00,54,126,27,27,60.95,127.19,0.00
2024-12-10 20:50:00,53,126,26,27,62.42,127.66,0.00
2024-12-10 20:50:00,52,126,25,27,63.17,127.75,0.00
2024-12-10 20:50:00,52,127,25,27,65.50,128.00,0.00
2024-12-10 20:50:00,53,127,26,27,64.26,128.02,0.00
2024-12-10 20:50:00,52,127,26,26,64.50,128.25,0.00
2024-12-10 20:50:00,51,127,25,26,65.01,128.69,0.00
2024-12-10 20:50:00,51,128,25,26,69.89,129.00,0.00
2024-12-10 20:50:00,52,128,25,27,68.54,129.02,0.00
2024-12-10 20:50:00,51,128,25,26,69.66,129.12,0.00
2024-12-10 20:50:01,50,128,24,26,70.16,129.64,0.00
2024-12-10 20:50:01,50,129,24,26,71.52,130.00,0.00
2024-12-10 20:50:01,51,129,25,26,70.12,130.02,0.00
2024-12-10 20:50:01,50,129,24,26,69.50,130.58,0.00
2024-12-10 20:50:01,50,130,24,26,71.87,131.00,0.00
2024-12-10 20:50:01,51,130,24,27,70.46,131.02,0.00
2024-12-10 20:50:01,50,130,24,26,71.82,131.06,0.00
2024-12-10 20:50:01,50,131,24,26,71.81,132.00,0.00
2024-12-10 20:50:01,51,131,25,26,70.40,132.02,0.00
2024-12-10 20:50:01,50,131,25,25,70.84,132.24,0.00
2024-12-10 20:50:01,50,132,25,25,71.70,133.00,0.00
2024-12-10 20:50:01,51,132,26,25,70.29,133.02,0.00
2024-12-10 20:50:01,50,132,25,25,71.24,133.22,0.00
2024-12-10 20:50:01,49,132,25,24,71.44,133.37,0.00
2024-12-10 20:50:01,49,133,25,24,73.77,134.00,0.00
2024-12-10 20:50:01,50,133,26,24,72.29,134.02,0.00
2024-12-10 20:50:01,50,134,26,24,72.73,135.00,0.00
2024-12-10 20:50:01,51,134,26,25,71.31,135.02,0.00
2024-12-10 20:50:01,50,134,26,24,72.24,135.22,0.00
2024-12-10 20:50:01,50,135,26,24,73.30,136.00,0.00
2024-12-10 20:50:01,51,135,27,24,71.86,136.02,0.00
2024-12-10 20:50:01,51,136,27,24,72.73,137.00,0.00
2024-12-10 20:50:01,52,136,28,24,71.33,137.02,0.00
2024-12-10 20:50:01,52,137,28,24,71.82,138.00,0.00
2024-12-10 20:50:01,53,137,29,24,70.47,138.02,0.00
2024-12-10 20:50:01,52,137,28,24,71.67,138.13,0.00
2024-12-10 20:50:01,51,137,28,23,72.37,138.31,0.00
2024-12-10 20:50:01,51,138,28,23,73.51,139.00,0.00
2024-12-10 20:50:01,52,138,28,24,72.10,139.02,0.00
2024-12-10 20:50:01,51,138,27,24,73.37,139.14,0.00
2024-12-10 20:50:01,51,139,27,24,74.80,140.00,0.00
2024-12-10 20:50:01,52,139,27,25,73.36,140.02,0.00
2024-12-10 20:50:01,51,139,26,25,74.22,140.06,0.00
2024-12-10 20:50:01,51,140,26,25,75.57,141.00,0.00
2024-12-10 20:50:01,52,140,26,26,74.12,141.02,0.00
2024-12-10 20:50:01,51,140,26,25,75.54,141.02,0.00
2024-12-10 20:50:01,50,140,25,25,76.11,141.16,0.00
2024-12-10 20:50:01,49,140,25,24,77.06,141.24,0.00
2024-12-10 20:50:01,49,141,25,24,79.38,142.00,0.00
2024-12-10 20:50:01,50,141,26,24,77.79,142.02,0.00
2024-12-10 20:50:01,49,141,26,23,79.35,142.02,0.00
2024-12-10 20:50:01,49,142,26,23,80.17,143.00,0.00
2024-12-10 20:50:01,50,142,27,23,78.57,143.02,0.00
2024-12-10 20:50:01,50,143,27,23,78.93,144.00,0.00
2024-12-10 20:50:01,51,143,28,23,77.38,144.02,0.00
2024-12-10 20:50:01,50,143,28,22,78.19,144.22,0.00
2024-12-10 20:50:01,50,144,28,22,79.30,145.00,0.00
2024-12-10 20:50:01,51,144,28,23,77.74,145.02,0.00
2024-12-10 20:50:01,51,145,28,23,78.46,146.00,0.00
2024-12-10 20:50:01,52,145,29,23,76.95,146.02,0.00
2024-12-10 20:50:01,51,145,28,23,78.33,146.12,0.00
2024-12-10 20:50:01,50,145,27,23,79.80,146.14,0.00
2024-12-10 20:50:01,49,145,26,23,79.28,146.76,0.00
2024-12-10 20:50:01,49,146,26,23,82.09,147.00,0.00
2024-12-10 20:50:01,50,146,26,24,80.45,147.02,0.00
2024-12-10 20:50:01,49,146,26,23,81.53,147.18,0.00
2024-12-10 20:50:01,48,146,25,23,83.11,147.29,0.00
2024-12-10 20:50:01,48,147,25,23,84.38,148.00,0.00
2024-12-10 20:50:01,49,147,26,23,82.66,148.02,0.00
2024-12-10 20:50:01,48,147,25,23,84.36,148.02,0.00
2024-12-10 20:50:01,48,148,25,23,85.25,149.00,0.00
2024-12-10 20:50:01,49,148,26,23,83.51,149.02,0.00
2024-12-10 20:50:01,49,149,26,23,83.89,150.00,0.00
2024-12-10 20:50:01,50,149,26,24,82.21,150.02,0.00
2024-12-10 20:50:01,49,149,25,24,83.87,150.02,0.00
2024-12-10 20:50:01,48,149,25,23,85.15,150.15,0.00
2024-12-10 20:50:01,48,150,25,23,86.28,151.00,0.00
2024-12-10 20:50:01,49,150,25,24,84.52,151.02,0.00
2024-12-10 20:50:01,48,150,24,24,86.18,151.10,0.00
2024-12-10 20:50:01,48,151,24,24,87.12,152.00,0.00
2024-12-10 20:50:01,49,151,24,25,85.34,152.02,0.00
2024-12-10 20:50:01,48,151,23,25,85.85,152.38,0.00
2024-12-10 20:50:01,48,152,23,25,88.48,153.00,0.00
2024-12-10 20:50:01,49,152,23,26,86.67,153.02,0.00
2024-12-10 20:50:01,48,152,23,25,88.09,153.13,0.00
2024-12-10 20:50:01,47,152,22,25,88.54,153.40,0.00
2024-12-10 20:50:01,48,151,22,26,86.39,153.77,0.00
2024-12-10 20:50:01,48,152,22,26,89.77,154.00,0.00
2024-12-10 20:50:01,49,152,23,26,87.94,154.02,0.00
2024-12-10 20:50:01,49,153,23,26,91.92,155.00,0.00
2024-12-10 20:50:01,50,153,24,26,90.08,155.02,0.00
2024-12-10 20:50:01,49,153,23,26,91.81,155.08,0.00
2024-12-10 20:50:01,49,154,23,26,92.23,156.00,0.00
2024-12-10 20:50:01,50,154,24,26,90.38,156.02,0.00
2024-12-10 20:50:01,49,154,24,25,91.81,156.12,0.00
2024-12-10 20:50:01,49,155,24,25,92.92,157.00,0.00
2024-12-10 20:50:01,50,155,25,25,91.06,157.02,0.00
2024-12-10 20:50:01,49,155,24,25,90.92,157.47,0.00
2024-12-10 20:50:01,49,156,24,25,93.67,158.00,0.00
2024-12-10 20:50:01,50,156,24,26,91.80,158.02,0.00
2024-12-10 20:50:01,50,157,24,26,92.09,159.00,0.00
2024-12-10 20:50:01,51,157,25,26,90.29,159.02,0.00
2024-12-10 20:50:01,50,157,25,25,91.74,159.12,0.00
2024-12-10 20:50:01,50,158,25,25,92.69,160.00,0.00
2024-12-10 20:50:01,51,158,25,26,90.87,160.02,0.00
2024-12-10 20:50:01,50,158,24,26,91.54,160.40,0.00
2024-12-10 20:50:01,50,159,24,26,93.95,161.00,0.00
2024-12-10 20:50:01,51,159,25,26,92.10,161.02,0.00
2024-12-10 20:50:01,51,160,25,26,92.13,162.00,0.00
2024-12-10 20:50:01,52,160,26,26,90.36,162.02,0.00
2024-12-10 20:50:01,51,160,26,25,91.56,162.14,0.00
2024-12-10 20:50:02,51,161,26,25,92.25,163.00,0.00
2024-12-10 20:50:02,52,161,27,25,90.47,163.02,0.00
2024-12-10 20:50:02,52,162,27,25,90.96,164.00,0.00
2024-12-10 20:50:02,53,162,28,25,89.25,164.02,0.00
2024-12-10 20:50:02,52,162,27,25,89.42,164.71,0.00
2024-12-10 20:50:02,52,163,27,25,91.19,165.00,0.00
2024-12-10 20:50:02,53,163,27,26,89.47,165.02,0.00
2024-12-10 20:50:02,52,163,26,26,91.13,165.04,0.00
2024-12-10 20:50:02,51,163,26,25,92.46,165.12,0.00
2024-12-10 20:50:02,51,164,26,25,93.45,166.00,0.00
2024-12-10 20:50:02,52,164,27,25,91.65,166.02,0.00
2024-12-10 20:50:02,52,165,27,25,92.28,167.00,0.00
2024-12-10 20:50:02,53,165,27,26,90.54,167.02,0.00
2024-12-10 20:50:02,53,166,27,26,90.60,168.00,0.00
2024-12-10 20:50:02,54,166,28,26,88.92,168.02,0.00
2024-12-10 20:50:02,53,166,28,25,90.18,168.11,0.00
2024-12-10 20:50:02,53,167,28,25,90.86,169.00,0.00
2024-12-10 20:50:02,54,167,29,25,89.18,169.02,0.00
2024-12-10 20:50:02,54,168,29,25,89.56,170.00,0.00
2024-12-10 20:50:02,55,168,29,26,87.93,170.02,0.00
2024-12-10 20:50:02,55,169,29,26,87.78,171.00,0.00
2024-12-10 20:50:02,56,169,30,26,86.21,171.02,0.00
2024-12-10 20:50:02,55,169,30,25,87.43,171.11,0.00
2024-12-10 20:50:02,54,169,29,25,88.72,171.37,0.00
2024-12-10 20:50:02,54,170,29,25,89.72,172.00,0.00
2024-12-10 20:50:02,55,170,30,25,88.09,172.02,0.00
2024-12-10 20:50:02,55,171,30,25,88.44,173.00,0.00
2024-12-10 20:50:02,56,171,30,26,86.86,173.02,0.00
2024-12-10 20:50:02,56,172,30,26,86.70,174.00,0.00
2024-12-10 20:50:02,57,172,30,27,85.18,174.02,0.00
2024-12-10 20:50:02,56,172,30,26,86.35,174.13,0.00
2024-12-10 20:50:02,55,172,29,26,87.07,174.55,0.00
2024-12-10 20:50:02,55,173,29,26,88.46,175.00,0.00
2024-12-10 20:50:02,56,173,29,27,86.88,175.02,0.00
2024-12-10 20:50:02,55,173,28,27,87.23,175.18,0.00
2024-12-10 20:50:02,54,173,27,27,88.31,175.63,0.00
2024-12-10 20:50:02,54,174,27,27,91.13,176.00,0.00
2024-12-10 20:50:02,55,174,27,28,89.47,176.02,0.00
2024-12-10 20:50:02,54,174,26,28,88.40,176.87,0.00
2024-12-10 20:50:02,54,175,26,28,91.54,177.00,0.00
2024-12-10 20:50:02,55,175,27,28,89.87,177.02,0.00
2024-12-10 20:50:02,54,175,27,27,91.23,177.13,0.00
2024-12-10 20:50:02,53,175,26,27,92.27,177.66,0.00
2024-12-10 20:50:02,53,176,26,27,95.23,178.00,0.00
2024-12-10 20:50:02,54,176,26,28,93.47,178.02,0.00
2024-12-10 20:50:02,53,176,26,27,95.17,178.04,0.00
2024-12-10 20:50:02,52,176,25,27,95.93,178.31,0.00
2024-12-10 20:50:02,52,177,25,27,97.67,179.00,0.00
2024-12-10 20:50:02,53,177,26,27,95.83,179.02,0.00
2024-12-10 20:50:02,53,178,26,27,95.88,180.00,0.00
2024-12-10 20:50:02,54,178,27,27,94.10,180.02,0.00
2024-12-10 20:50:02,53,178,27,26,95.62,180.11,0.00
2024-12-10 20:50:02,53,179,27,26,96.54,181.00,0.00
2024-12-10 20:50:02,54,179,27,27,94.75,181.02,0.00
2024-12-10 20:50:02,53,179,26,27,94.38,181.68,0.00
2024-12-10 20:50:02,53,180,26,27,97.44,182.00,0.00
2024-12-10 20:50:02,54,180,27,27,95.64,182.02,0.00
2024-12-10 20:50:02,53,180,26,27,97.29,182.09,0.00
2024-12-10 20:50:02,53,181,26,27,97.58,183.00,0.00
2024-12-10 20:50:02,54,181,26,28,95.77,183.02,0.00
2024-12-10 20:50:02,53,181,26,27,97.29,183.11,0.00
2024-12-10 20:50:02,53,182,26,27,98.19,184.00,0.00
2024-12-10 20:50:02,54,182,27,27,96.37,184.02,0.00
2024-12-10 20:50:02,53,182,26,27,96.94,184.40,0.00
2024-12-10 20:50:02,52,182,25,27,97.79,184.65,0.00
2024-12-10 20:50:02,52,183,25,27,100.95,185.00,0.00
2024-12-10 20:50:02,53,183,26,27,99.04,185.02,0.00
2024-12-10 20:50:02,53,184,26,27,99.11,186.00,0.00
2024-12-10 20:50:02,54,184,27,27,97.28,186.02,0.00
2024-12-10 20:50:02,53,184,27,26,98.89,186.11,0.00
2024-12-10 20:50:02,53,185,27,26,99.84,187.00,0.00
2024-12-10 20:50:02,54,185,28,26,97.99,187.02,0.00
2024-12-10 20:50:02,53,185,27,26,99.25,187.02,0.00
2024-12-10 20:50:02,54,184,27,27,96.04,187.52,0.00
2024-12-10 20:50:02,54,185,27,27,99.97,188.00,0.00
2024-12-10 20:50:02,55,185,27,28,98.15,188.02,0.00
2024-12-10 20:50:02,54,185,27,27,99.15,188.09,0.00
2024-12-10 20:50:02,54,186,27,27,103.53,189.00,0.00
2024-12-10 20:50:02,55,186,28,27,101.65,189.02,0.00
2024-12-10 20:50:02,54,186,27,27,101.97,189.59,0.00
2024-12-10 20:50:02,54,187,27,27,104.00,190.00,0.00
2024-12-10 20:50:02,55,187,28,27,102.11,190.02,0.00
2024-12-10 20:50:02,54,187,28,26,103.17,190.09,0.00
2024-12-10 20:50:02,53,187,27,26,103.11,190.89,0.00
2024-12-10 20:50:02,53,188,27,26,106.57,191.00,0.00
2024-12-10 20:50:02,54,188,28,26,104.60,191.02,0.00
2024-12-10 20:50:02,53,188,27,26,106.54,191.02,0.00
2024-12-10 20:50:02,53,189,27,26,107.06,192.00,0.00
2024-12-10 20:50:02,54,189,27,27,105.08,192.02,0.00
2024-12-10 20:50:02,53,189,27,26,106.24,192.08,0.00
2024-12-10 20:50:02,52,189,26,26,107.52,192.13,0.00
2024-12-10 20:50:02,52,190,26,26,110.10,193.00,0.00
2024-12-10 20:50:02,53,190,26,27,108.02,193.02,0.00
2024-12-10 20:50:02,52,190,25,27,109.89,193.10,0.00
2024-12-10 20:50:02,52,191,25,27,111.67,194.00,0.00
2024-12-10 20:50:02,53,191,25,28,109.57,194.02,0.00
2024-12-10 20:50:02,52,191,24,28,110.74,194.08,0.00
2024-12-10 20:50:02,52,192,24,28,112.50,195.00,0.00
2024-12-10 20:50:02,53,192,24,29,110.38,195.02,0.00
2024-12-10 20:50:02,52,192,24,28,112.36,195.08,0.00
2024-12-10 20:50:02,51,192,23,28,114.10,195.16,0.00
2024-12-10 20:50:03,51,193,23,28,116.83,196.00,0.00
2024-12-10 20:50:03,52,193,23,29,114.58,196.02,0.00
2024-12-10 20:50:03,51,193,22,29,115.36,196.14,0.00
2024-12-10 20:50:03,51,194,22,29,118.08,197.00,0.00
2024-12-10 20:50:03,52,194,22,30,115.81,197.02,0.00
2024-12-10 20:50:03,51,194,21,30,114.97,197.53,0.00
2024-12-10 20:50:03,51,195,21,30,118.28,198.00,0.00
2024-12-10 20:50:03,52,195,22,30,116.01,198.02,0.00
2024-12-10 20:50:03,51,195,22,29,118.10,198.08,0.00
2024-12-10 20:50:03,50,195,21,29,120.12,198.12,0.00
2024-12-10 20:50:03,50,196,21,29,122.93,199.00,0.00
2024-12-10 20:50:03,51,196,22,29,120.52,199.02,0.00
2024-12-10 20:50:03,51,197,22,29,121.03,200.00,0.00
2024-12-10 20:50:03,52,197,22,30,118.70,200.02,0.00
2024-12-10 20:50:03,51,197,22,29,120.10,200.08,0.00
2024-12-10 20:50:03,50,197,21,29,122.04,200.34,0.00
2024-12-10 20:50:03,50,198,21,29,123.60,201.00,0.00
2024-12-10 20:50:03,51,198,22,29,121.18,201.02,0.00
2024-12-10 20:50:03,50,198,21,29,122.24,201.30,0.00
2024-12-10 20:50:03,49,198,20,29,124.35,201.57,0.00
2024-12-10 20:50:03,49,199,20,29,126.89,202.00,0.00
2024-12-10 20:50:03,50,199,20,30,124.35,202.02,0.00
2024-12-10 20:50:03,49,199,19,30,126.85,202.02,0.00
2024-12-10 20:50:03,48,199,18,30,125.61,202.94,0.00
2024-12-10 20:50:03,48,200,18,30,129.74,203.00,0.00
2024-12-10 20:50:03,49,200,18,31,127.10,203.02,0.00
2024-12-10 20:50:03,48,200,18,30,129.20,203.06,0.00
2024-12-10 20:50:03,48,201,18,30,130.35,204.00,0.00
2024-12-10 20:50:03,49,201,19,30,127.69,204.02,0.00
2024-12-10 20:50:03,49,202,19,30,128.07,205.00,0.00
2024-12-10 20:50:03,50,202,19,31,125.51,205.02,0.00
2024-12-10 20:50:03,49,202,19,30,127.11,205.06,0.00
2024-12-10 20:50:03,49,203,19,30,128.22,206.00,0.00
2024-12-10 20:50:03,50,203,20,30,125.66,206.02,0.00
2024-12-10 20:50:03,49,203,20,29,127.46,206.06,0.00
2024-12-10 20:50:03,49,204,20,29,128.67,207.00,0.00
2024-12-10 20:50:03,50,204,21,29,126.10,207.02,0.00
2024-12-10 20:50:03,50,205,21,29,126.55,208.00,0.00
2024-12-10 20:50:03,51,205,22,29,124.07,208.02,0.00
2024-12-10 20:50:03,51,206,22,29,124.16,209.00,0.00
2024-12-10 20:50:03,52,206,23,29,121.77,209.02,0.00
2024-12-10 20:50:03,51,206,23,28,124.00,209.06,0.00
2024-12-10 20:50:03,51,207,23,28,125.00,210.00,0.00
2024-12-10 20:50:03,52,207,23,29,122.60,210.02,0.00
2024-12-10 20:50:03,52,208,23,29,122.97,211.00,0.00
2024-12-10 20:50:03,53,208,24,29,120.65,211.02,0.00
2024-12-10 20:50:03,52,208,23,29,122.93,211.02,0.00
2024-12-10 20:50:03,51,208,23,28,124.43,211.04,0.00
2024-12-10 20:50:03,50,208,22,28,124.73,211.42,0.00
2024-12-10 20:50:03,50,209,22,28,128.08,212.00,0.00
2024-12-10 20:50:03,51,209,22,29,125.57,212.02,0.00
2024-12-10 20:50:03,51,210,22,29,125.98,213.00,0.00
2024-12-10 20:50:03,52,210,22,30,123.56,213.02,0.00
2024-12-10 20:50:03,51,210,22,29,125.10,213.04,0.00
2024-12-10 20:50:03,50,210,21,29,125.32,213.92,0.00
2024-12-10 20:50:03,50,211,21,29,129.49,214.00,0.00
2024-12-10 20:50:03,51,211,21,30,126.95,214.02,0.00
2024-12-10 20:50:03,50,211,20,30,126.72,214.42,0.00
2024-12-10 20:50:03,50,212,20,30,130.18,215.00,0.00
2024-12-10 20:50:03,51,212,21,30,127.62,215.02,0.00
2024-12-10 20:50:03,50,212,21,29,129.32,215.04,0.00
2024-12-10 20:50:03,49,212,20,29,130.87,215.20,0.00
2024-12-10 20:50:03,49,213,20,29,134.09,216.00,0.00
2024-12-10 20:50:03,50,213,20,30,131.41,216.02,0.00
2024-12-10 20:50:03,50,214,20,30,131.76,217.00,0.00
2024-12-10 20:50:03,51,214,21,30,129.18,217.02,0.00
2024-12-10 20:50:03,50,214,21,29,130.98,217.04,0.00
2024-12-10 20:50:03,50,215,21,29,132.11,218.00,0.00
2024-12-10 20:50:03,51,215,21,30,129.52,218.02,0.00
2024-12-10 20:50:03,51,216,21,30,129.99,219.00,0.00
2024-12-10 20:50:03,52,216,22,30,127.49,219.02,0.00
2024-12-10 20:50:03,51,216,22,29,129.02,219.08,0.00
2024-12-10 20:50:03,50,216,21,29,129.21,219.48,0.00
2024-12-10 20:50:03,50,217,21,29,132.84,220.00,0.00
2024-12-10 20:50:03,51,217,21,30,130.23,220.02,0.00
2024-12-10 20:50:03,50,217,20,30,130.22,220.36,0.00
2024-12-10 20:50:03,49,217,19,30,132.50,220.61,0.00
2024-12-10 20:50:03,48,217,18,30,135.05,220.75,0.00
2024-12-10 20:50:03,48,218,18,30,139.31,221.00,0.00
2024-12-10 20:50:03,49,218,18,31,136.47,221.02,0.00
2024-12-10 20:50:03,48,218,18,30,138.27,221.08,0.00
2024-12-10 20:50:03,48,219,18,30,139.62,222.00,0.00
2024-12-10 20:50:03,49,219,18,31,136.77,222.02,0.00
2024-12-10 20:50:03,48,219,17,31,139.19,222.08,0.00
2024-12-10 20:50:03,48,220,17,31,141.47,223.00,0.00
2024-12-10 20:50:03,49,220,18,31,138.59,223.02,0.00
2024-12-10 20:50:03,48,220,17,31,141.43,223.02,0.00
2024-12-10 20:50:03,47,220,16,31,142.87,223.02,0.00
2024-12-10 20:50:03,47,221,16,31,145.13,224.00,0.00
2024-12-10 20:50:03,48,221,17,31,142.11,224.02,0.00
2024-12-10 20:50:03,47,221,17,30,145.00,224.04,0.00
2024-12-10 20:50:03,46,221,16,30,147.12,224.63,0.00
2024-12-10 20:50:03,46,222,16,30,149.54,225.00,0.00
2024-12-10 20:50:03,47,222,16,31,146.35,225.02,0.00
2024-12-10 20:50:03,47,223,16,31,146.80,226.00,0.00
2024-12-10 20:50:03,48,223,17,31,143.74,226.02,0.00
2024-12-10 20:50:04,48,224,17,31,144.05,227.00,0.00
2024-12-10 20:50:04,49,224,17,32,141.11,227.02,0.00
2024-12-10 20:50:04,48,224,17,31,143.97,227.04,0.00
2024-12-10 20:50:04,48,225,17,31,145.25,228.00,0.00
2024-12-10 20:50:04,49,225,18,31,142.29,228.02,0.00
2024-12-10 20:50:04,48,225,17,31,142.33,228.33,0.00
2024-12-10 20:50:04,48,226,17,31,146.06,229.00,0.00
2024-12-10 20:50:04,49,226,17,32,143.08,229.02,0.00
2024-12-10 20:50:04,49,227,17,32,143.33,230.00,0.00
2024-12-10 20:50:04,50,227,17,33,140.46,230.02,0.00
2024-12-10 20:50:04,49,227,17,32,143.25,230.04,0.00
2024-12-10 20:50:04,49,228,17,32,144.47,231.00,0.00
2024-12-10 20:50:04,50,228,18,32,141.58,231.02,0.00
2024-12-10 20:50:04,49,228,17,32,141.10,231.96,0.00
2024-12-10 20:50:04,49,229,17,32,145.76,232.00,0.00
2024-12-10 20:50:04,50,229,18,32,142.84,232.02,0.00
2024-12-10 20:50:04,50,230,18,32,143.04,233.00,0.00
2024-12-10 20:50:04,51,230,18,33,140.24,233.02,0.00
2024-12-10 20:50:04,50,230,18,32,142.92,233.06,0.00
2024-12-10 20:50:04,50,231,18,32,144.12,234.00,0.00
2024-12-10 20:50:04,51,231,18,33,141.30,234.02,0.00
2024-12-10 20:50:04,51,232,18,33,141.64,235.00,0.00
2024-12-10 20:50:04,52,232,18,34,138.92,235.02,0.00
2024-12-10 20:50:04,51,232,18,33,140.65,235.06,0.00
2024-12-10 20:50:04,50,232,17,33,141.53,235.80,0.00
2024-12-10 20:50:04,50,233,17,33,145.92,236.00,0.00
2024-12-10 20:50:04,51,233,17,34,143.06,236.02,0.00
2024-12-10 20:50:04,51,234,17,34,143.38,237.00,0.00
2024-12-10 20:50:04,52,234,17,35,140.63,237.02,0.00
2024-12-10 20:50:04,51,234,17,34,142.42,237.06,0.00
2024-12-10 20:50:04,50,234,16,34,142.53,237.54,0.00
2024-12-10 20:50:04,49,234,15,34,145.30,237.61,0.00
2024-12-10 20:50:04,49,235,15,34,149.54,238.00,0.00
2024-12-10 20:50:04,50,235,15,35,146.55,238.02,0.00
2024-12-10 20:50:04,49,235,14,35,147.85,238.04,0.00
2024-12-10 20:50:04,49,236,14,35,150.07,239.00,0.00
2024-12-10 20:50:04,50,236,15,35,147.07,239.02,0.00
2024-12-10 20:50:04,49,236,15,34,149.15,239.04,0.00
2024-12-10 20:50:04,48,236,14,34,151.60,239.15,0.00
2024-12-10 20:50:04,48,237,14,34,155.14,240.00,0.00
2024-12-10 20:50:04,49,237,15,34,151.97,240.02,0.00
2024-12-10 20:50:04,49,238,15,34,152.22,241.00,0.00
2024-12-10 20:50:04,50,238,16,34,149.18,241.02,0.00
2024-12-10 20:50:04,49,238,16,33,151.25,241.06,0.00
2024-12-10 20:50:04,49,239,16,33,152.56,242.00,0.00
2024-12-10 20:50:04,50,239,17,33,149.51,242.02,0.00
2024-12-10 20:50:04,50,240,17,33,149.82,243.00,0.00
2024-12-10 20:50:04,51,240,17,34,146.88,243.02,0.00
2024-12-10 20:50:04,50,240,17,33,148.81,243.06,0.00
2024-12-10 20:50:04,50,241,17,33,150.05,244.00,0.00
2024-12-10 20:50:04,51,241,17,34,147.10,244.02,0.00
2024-12-10 20:50:04,50,241,16,34,147.55,244.68,0.00
2024-12-10 20:50:04,50,242,16,34,151.90,245.00,0.00
2024-12-10 20:50:04,51,242,17,34,148.92,245.02,0.00
2024-12-10 20:50:04,50,242,17,33,150.88,245.06,0.00
2024-12-10 20:50:04,50,243,17,33,152.12,246.00,0.00
2024-12-10 20:50:04,51,243,17,34,149.14,246.02,0.00
2024-12-10 20:50:04,50,243,16,34,151.99,246.06,0.00
2024-12-10 20:50:04,50,244,16,34,152.54,247.00,0.00
2024-12-10 20:50:04,51,244,17,34,149.55,247.02,0.00
2024-12-10 20:50:04,50,244,17,33,151.42,247.06,0.00
2024-12-10 20:50:04,50,245,17,33,152.66,248.00,0.00
2024-12-10 20:50:04,51,245,17,34,149.67,248.02,0.00
2024-12-10 20:50:04,51,246,17,34,150.06,249.00,0.00
2024-12-10 20:50:04,52,246,18,34,147.18,249.02,0.00
2024-12-10 20:50:04,51,246,18,33,149.00,249.06,0.00
2024-12-10 20:50:04,51,247,18,33,150.13,250.00,0.00
2024-12-10 20:50:04,52,247,18,34,147.24,250.02,0.00
2024-12-10 20:50:04,51,247,17,34,146.42,250.55,0.00
2024-12-10 20:50:04,51,248,17,34,150.53,251.00,0.00
2024-12-10 20:50:04,52,248,18,34,147.64,251.02,0.00
2024-12-10 20:50:04,51,248,17,34,149.98,251.06,0.00
2024-12-10 20:50:04,51,249,17,34,152.05,252.00,0.00
2024-12-10 20:50:04,52,249,18,34,149.12,252.02,0.00
2024-12-10 20:50:04,51,249,18,33,151.91,252.06,0.00
2024-12-10 20:50:04,51,250,18,33,152.97,253.00,0.00
2024-12-10 20:50:04,52,250,18,34,150.03,253.02,0.00
2024-12-10 20:50:04,51,250,17,34,150.96,253.18,0.00
2024-12-10 20:50:04,51,251,17,34,154.23,254.00,0.00
2024-12-10 20:50:04,52,251,18,34,151.26,254.02,0.00
2024-12-10 20:50:04,52,252,18,34,151.43,255.00,0.00
2024-12-10 20:50:04,53,252,19,34,148.57,255.02,0.00
2024-12-10 20:50:04,53,253,19,34,148.98,256.00,0.00
2024-12-10 20:50:04,54,253,20,34,146.22,256.02,0.00
2024-12-10 20:50:04,54,254,20,34,145.98,257.00,0.00
2024-12-10 20:50:04,55,254,21,34,143.32,257.02,0.00
2024-12-10 20:50:04,54,254,21,33,145.36,257.17,0.00
2024-12-10 20:50:04,54,255,21,33,146.40,258.00,0.00
2024-12-10 20:50:04,55,255,22,33,143.74,258.02,0.00
2024-12-10 20:50:05,54,255,21,33,143.30,258.33,0.00
2024-12-10 20:50:05,54,256,21,33,146.81,259.00,0.00
2024-12-10 20:50:05,55,256,22,33,144.14,259.02,0.00
2024-12-10 20:50:05,55,257,22,33,143.81,260.00,0.00
2024-12-10 20:50:05,56,257,23,33,141.24,260.02,0.00
2024-12-10 20:50:05,55,257,23,32,143.06,260.05,0.00
2024-12-10 20:50:05,54,257,22,32,144.24,260.63,0.00
2024-12-10 20:50:05,54,258,22,32,146.43,261.00,0.00
2024-12-10 20:50:05,55,258,23,32,143.76,261.02,0.00
2024-12-10 20:50:05,54,258,23,31,145.66,261.06,0.00
2024-12-10 20:50:05,54,259,23,31,146.32,262.00,0.00
2024-12-10 20:50:05,55,259,24,31,143.66,262.02,0.00
2024-12-10 20:50:05,54,259,23,31,143.62,262.65,0.00
2024-12-10 20:50:05,54,260,23,31,146.03,263.00,0.00
2024-12-10 20:50:05,55,260,23,32,143.37,263.02,0.00
2024-12-10 20:50:05,54,260,23,31,145.30,263.06,0.00
2024-12-10 20:50:05,53,260,23,30,147.87,263.11,0.00
2024-12-10 20:50:05,52,260,23,29,150.36,263.25,0.00
2024-12-10 20:50:05,52,261,23,29,151.73,264.00,0.00
2024-12-10 20:50:05,53,261,23,30,148.87,264.02,0.00
2024-12-10 20:50:05,52,261,22,30,147.39,264.94,0.00
2024-12-10 20:50:05,52,262,22,30,152.37,265.00,0.00
2024-12-10 20:50:05,53,262,23,30,149.49,265.02,0.00
2024-12-10 20:50:05,52,262,23,29,151.37,265.10,0.00
2024-12-10 20:50:05,52,263,23,29,152.23,266.00,0.00
2024-12-10 20:50:05,53,263,23,30,149.35,266.02,0.00
2024-12-10 20:50:05,53,264,23,30,149.32,267.00,0.00
2024-12-10 20:50:05,54,264,23,31,146.55,267.02,0.00
2024-12-10 20:50:05,53,264,23,30,148.17,267.09,0.00
2024-12-10 20:50:05,52,264,22,30,147.64,267.92,0.00
2024-12-10 20:50:05,52,265,22,30,152.65,268.00,0.00
2024-12-10 20:50:05,53,265,22,31,149.77,268.02,0.00
2024-12-10 20:50:05,52,265,21,31,152.46,268.10,0.00
2024-12-10 20:50:05,52,266,21,31,152.77,269.00,0.00
2024-12-10 20:50:05,53,266,22,31,149.89,269.02,0.00
2024-12-10 20:50:05,53,267,22,31,149.41,270.00,0.00
2024-12-10 20:50:05,54,267,23,31,146.65,270.02,0.00
2024-12-10 20:50:05,53,267,23,30,149.13,270.11,0.00
2024-12-10 20:50:05,53,268,23,30,149.87,271.00,0.00
2024-12-10 20:50:05,54,268,23,31,147.10,271.02,0.00
2024-12-10 20:50:05,53,268,22,31,147.75,271.49,0.00
2024-12-10 20:50:05,53,269,22,31,149.84,272.00,0.00
2024-12-10 20:50:05,54,269,22,32,147.07,272.02,0.00
2024-12-10 20:50:05,53,269,22,31,148.53,272.11,0.00
2024-12-10 20:50:05,53,270,22,31,149.15,273.00,0.00
2024-12-10 20:50:05,54,270,22,32,146.38,273.02,0.00
2024-12-10 20:50:05,53,270,21,32,146.85,273.57,0.00
2024-12-10 20:50:05,52,270,20,32,148.74,273.77,0.00
2024-12-10 20:50:05,52,271,20,32,153.54,274.00,0.00
2024-12-10 20:50:05,53,271,20,33,150.64,274.02,0.00
2024-12-10 20:50:05,52,271,20,32,152.30,274.12,0.00
2024-12-10 20:50:05,51,271,19,32,152.07,274.69,0.00
2024-12-10 20:50:05,51,272,19,32,156.45,275.00,0.00
2024-12-10 20:50:05,52,272,20,32,153.44,275.02,0.00
2024-12-10 20:50:05,52,273,20,32,153.11,276.00,0.00
2024-12-10 20:50:05,53,273,21,32,150.23,276.02,0.00
2024-12-10 20:50:05,52,273,21,31,151.86,276.12,0.00
2024-12-10 20:50:05,52,274,21,31,152.25,277.00,0.00
2024-12-10 20:50:05,53,274,21,32,149.38,277.02,0.00
2024-12-10 20:50:05,52,274,20,32,152.15,277.04,0.00
2024-12-10 20:50:05,51,274,19,32,152.30,277.27,0.00
2024-12-10 20:50:05,51,275,19,32,155.59,278.00,0.00
2024-12-10 20:50:05,52,275,20,32,152.60,278.02,0.00
2024-12-10 20:50:05,51,275,20,31,154.24,278.10,0.00
2024-12-10 20:50:05,51,276,20,31,154.66,279.00,0.00
2024-12-10 20:50:05,52,276,20,32,151.68,279.02,0.00
2024-12-10 20:50:05,51,276,19,32,154.40,279.10,0.00
2024-12-10 20:50:05,50,276,19,31,156.32,279.10,0.00
2024-12-10 20:50:05,49,276,18,31,158.43,279.22,0.00
2024-12-10 20:50:05,48,276,17,31,160.75,279.65,0.00
2024-12-10 20:50:05,48,277,17,31,165.30,280.00,0.00
2024-12-10 20:50:05,49,277,18,31,161.93,280.02,0.00
2024-12-10 20:50:05,49,278,18,31,161.93,281.00,0.00
2024-12-10 20:50:05,50,278,18,32,158.69,281.02,0.00
2024-12-10 20:50:05,49,278,18,31,160.51,281.10,0.00
2024-12-10 20:50:05,49,279,18,31,161.38,282.00,0.00
2024-12-10 20:50:05,50,279,18,32,158.15,282.02,0.00
2024-12-10 20:50:05,50,280,18,32,158.08,283.00,0.00
2024-12-10 20:50:05,51,280,19,32,154.98,283.02,0.00
2024-12-10 20:50:05,50,280,19,31,156.73,283.10,0.00
2024-12-10 20:50:05,50,281,19,31,157.48,284.00,0.00
2024-12-10 20:50:05,51,281,20,31,154.39,284.02,0.00
2024-12-10 20:50:05,50,281,19,31,153.61,284.46,0.00
2024-12-10 20:50:05,49,281,19,30,155.58,284.82,0.00
2024-12-10 20:50:05,49,282,19,30,160.99,285.00,0.00
2024-12-10 20:50:05,50,282,20,30,157.77,285.02,0.00
2024-12-10 20:50:05,49,282,20,29,159.55,285.10,0.00
2024-12-10 20:50:05,48,282,19,29,162.28,285.35,0.00
2024-12-10 20:50:05,48,283,19,29,164.44,286.00,0.00
2024-12-10 20:50:05,49,283,20,29,161.08,286.02,0.00
2024-12-10 20:50:05,49,284,20,29,161.72,287.00,0.00
2024-12-10 20:50:05,50,284,20,30,158.49,287.02,0.00
2024-12-10 20:50:05,49,284,19,30,161.67,287.02,0.00
2024-12-10 20:50:05,48,284,19,29,163.61,287.08,0.00
2024-12-10 20:50:05,48,285,19,29,165.13,288.00,0.00
2024-12-10 20:50:05,49,285,20,29,161.76,288.02,0.00
2024-12-10 20:50:05,48,285,19,29,162.85,288.46,0.00
2024-12-10 20:50:06,48,286,19,29,165.86,289.00,0.00
2024-12-10 20:50:06,49,286,19,30,162.47,289.02,0.00
2024-12-10 20:50:06,48,286,19,29,164.42,289.08,0.00
2024-12-10 20:50:06,48,287,19,29,165.95,290.00,0.00
2024-12-10 20:50:06,49,287,20,29,162.56,290.02,0.00
2024-12-10 20:50:06,49,288,20,29,163.15,291.00,0.00
2024-12-10 20:50:06,50,288,21,29,159.89,291.02,0.00
2024-12-10 20:50:06,49,288,21,28,161.79,291.08,0.00
2024-12-10 20:50:06,49,289,21,28,163.14,292.00,0.00
2024-12-10 20:50:06,50,289,22,28,159.88,292.02,0.00
2024-12-10 20:50:06,50,290,22,28,160.32,293.00,0.00
2024-12-10 20:50:06,51,290,23,28,157.17,293.02,0.00
2024-12-10 20:50:06,50,290,23,27,158.92,293.08,0.00
2024-12-10 20:50:06,50,291,23,27,159.99,294.00,0.00
2024-12-10 20:50:06,51,291,23,28,156.85,294.02,0.00
2024-12-10 20:50:06,51,292,23,28,157.06,295.00,0.00
2024-12-10 20:50:06,52,292,24,28,154.04,295.02,0.00
2024-12-10 20:50:06,51,292,24,27,155.73,295.08,0.00
2024-12-10 20:50:06,51,293,24,27,156.54,296.00,0.00
2024-12-10 20:50:06,52,293,24,28,153.53,296.02,0.00
2024-12-10 20:50:06,51,293,24,27,156.48,296.02,0.00
2024-12-10 20:50:06,50,293,23,27,154.22,296.90,0.00
2024-12-10 20:50:06,50,294,23,27,159.92,297.00,0.00
2024-12-10 20:50:06,51,294,23,28,156.79,297.02,0.00
2024-12-10 20:50:06,50,294,23,27,159.86,297.02,0.00
2024-12-10 20:50:06,49,294,23,26,161.92,297.04,0.00
2024-12-10 20:50:06,49,295,23,26,162.59,298.00,0.00
2024-12-10 20:50:06,50,295,23,27,159.34,298.02,0.00
2024-12-10 20:50:06,49,295,23,26,157.50,298.55,0.00
2024-12-10 20:50:06,49,296,23,26,162.54,299.00,0.00
2024-12-10 20:50:06,50,296,23,27,159.29,299.02,0.00
2024-12-10 20:50:06,49,296,23,26,161.38,299.04,0.00
2024-12-10 20:50:06,48,296,22,26,163.87,299.08,0.00
2024-12-10 20:50:06,47,296,21,26,166.35,299.47,0.00
2024-12-10 20:50:06,47,297,21,26,171.48,300.00,0.00
2024-12-10 20:50:06,48,297,21,27,167.91,300.02,0.00
2024-12-10 20:50:06,48,298,21,27,168.45,301.00,0.00
2024-12-10 20:50:06,49,298,21,28,165.01,301.02,0.00
2024-12-10 20:50:06,48,298,21,27,167.32,301.04,0.00
2024-12-10 20:50:06,47,298,20,27,167.85,301.70,0.00
2024-12-10 20:50:06,47,299,20,27,173.60,302.00,0.00
2024-12-10 20:50:06,48,299,20,28,169.98,302.02,0.00
2024-12-10 20:50:06,48,300,20,28,170.50,303.00,0.00
2024-12-10 20:50:06,49,300,20,29,167.02,303.02,0.00
2024-12-10 20:50:06,48,300,20,28,169.42,303.04,0.00
2024-12-10 20:50:06,47,300,19,28,170.23,303.77,0.00
2024-12-10 20:50:06,47,301,19,28,176.17,304.00,0.00
2024-12-10 20:50:06,48,301,20,28,172.50,304.02,0.00
2024-12-10 20:50:06,48,302,20,28,173.16,305.00,0.00
2024-12-10 20:50:06,49,302,20,29,169.63,305.02,0.00
2024-12-10 20:50:06,48,302,20,28,171.89,305.04,0.00
2024-12-10 20:50:06,47,302,19,28,174.40,305.47,0.00
2024-12-10 20:50:06,47,303,19,28,177.05,306.00,0.00
2024-12-10 20:50:06,48,303,19,29,173.36,306.02,0.00
2024-12-10 20:50:06,48,304,19,29,173.96,307.00,0.00
2024-12-10 20:50:06,49,304,19,30,170.41,307.02,0.00
2024-12-10 20:50:06,48,304,19,29,172.74,307.04,0.00
2024-12-10 20:50:06,47,304,18,29,174.63,307.60,0.00
2024-12-10 20:50:06,47,305,18,29,180.24,308.00,0.00
2024-12-10 20:50:06,48,305,19,29,176.48,308.02,0.00
2024-12-10 20:50:06,48,306,19,29,177.08,309.00,0.00
2024-12-10 20:50:06,49,306,20,29,173.47,309.02,0.00
2024-12-10 20:50:06,48,306,19,29,177.02,309.02,0.00
2024-12-10 20:50:06,47,306,19,28,179.60,309.02,0.00
2024-12-10 20:50:06,47,307,19,28,181.10,310.00,0.00
2024-12-10 20:50:06,48,307,19,29,177.33,310.02,0.00
2024-12-10 20:50:06,47,307,18,29,177.10,310.38,0.00
2024-12-10 20:50:06,46,307,17,29,180.76,310.46,0.00
2024-12-10 20:50:06,46,308,17,29,186.22,311.00,0.00
2024-12-10 20:50:06,47,308,18,29,182.26,311.02,0.00
2024-12-10 20:50:06,46,308,18,28,185.01,311.02,0.00
2024-12-10 20:50:06,46,309,18,28,186.62,312.00,0.00
2024-12-10 20:50:06,47,309,18,29,182.65,312.02,0.00
2024-12-10 20:50:06,47,310,18,29,183.27,313.00,0.00
2024-12-10 20:50:06,48,310,18,30,179.45,313.02,0.00
2024-12-10 20:50:06,47,310,18,29,182.01,313.04,0.00
2024-12-10 20:50:06,47,311,18,29,183.59,314.00,0.00
2024-12-10 20:50:06,48,311,18,30,179.77,314.02,0.00
2024-12-10 20:50:06,47,311,17,30,181.93,314.09,0.00
2024-12-10 20:50:06,47,312,17,30,186.32,315.00,0.00
2024-12-10 20:50:06,48,312,17,31,182.44,315.02,0.00
2024-12-10 20:50:06,47,312,17,30,184.92,315.06,0.00
2024-12-10 20:50:06,47,313,17,30,186.58,316.00,0.00
2024-12-10 20:50:06,48,313,17,31,182.69,316.02,0.00
2024-12-10 20:50:06,47,313,16,31,184.19,316.15,0.00
2024-12-10 20:50:06,47,314,16,31,188.78,317.00,0.00
2024-12-10 20:50:06,48,314,17,31,184.85,317.02,0.00
2024-12-10 20:50:06,47,314,16,31,188.76,317.02,0.00
2024-12-10 20:50:06,46,314,15,31,192.40,317.07,0.00
2024-12-10 20:50:06,46,315,15,31,195.54,318.00,0.00
2024-12-10 20:50:06,47,315,15,32,191.38,318.02,0.00
2024-12-10 20:50:06,46,315,15,31,195.01,318.07,0.00
2024-12-10 20:50:06,46,316,15,31,196.78,319.00,0.00
2024-12-10 20:50:06,47,316,16,31,192.60,319.02,0.00
2024-12-10 20:50:07,47,317,16,31,193.55,320.00,0.00
2024-12-10 20:50:07,48,317,16,32,189.52,320.02,0.00
2024-12-10 20:50:07,47,317,15,32,187.77,320.96,0.00
2024-12-10 20:50:07,47,318,15,32,194.49,321.00,0.00
2024-12-10 20:50:07,48,318,15,33,190.44,321.02,0.00
2024-12-10 20:50:07,47,318,15,32,193.90,321.09,0.00
2024-12-10 20:50:07,47,319,15,32,195.64,322.00,0.00
2024-12-10 20:50:07,48,319,15,33,191.57,322.02,0.00
2024-12-10 20:50:07,48,320,15,33,192.40,323.00,0.00
2024-12-10 20:50:07,49,320,15,34,188.47,323.02,0.00
2024-12-10 20:50:07,48,320,14,34,189.94,323.40,0.00
2024-12-10 20:50:07,47,320,13,34,190.76,323.94,0.00
2024-12-10 20:50:07,47,321,13,34,197.49,324.00,0.00
2024-12-10 20:50:07,48,321,14,34,193.37,324.02,0.00
2024-12-10 20:50:07,47,321,13,34,193.04,324.79,0.00
2024-12-10 20:50:07,47,322,13,34,199.44,325.00,0.00
2024-12-10 20:50:07,48,322,14,34,195.28,325.02,0.00
2024-12-10 20:50:07,48,323,14,34,195.41,326.00,0.00
2024-12-10 20:50:07,49,323,15,34,191.42,326.02,0.00
2024-12-10 20:50:07,48,323,15,33,194.95,326.10,0.00
2024-12-10 20:50:07,48,324,15,33,196.69,327.00,0.00
2024-12-10 20:50:07,49,324,15,34,192.68,327.02,0.00
2024-12-10 20:50:07,48,324,15,33,194.40,327.08,0.00
2024-12-10 20:50:07,48,325,15,33,197.44,328.00,0.00
2024-12-10 20:50:07,49,325,15,34,193.42,328.02,0.00
2024-12-10 20:50:07,48,325,14,34,197.37,328.04,0.00
2024-12-10 20:50:07,47,325,13,34,198.40,328.66,0.00
2024-12-10 20:50:07,47,326,13,34,204.55,329.00,0.00
2024-12-10 20:50:07,48,326,13,35,200.29,329.02,0.00
2024-12-10 20:50:07,47,326,12,35,202.87,329.02,0.00
2024-12-10 20:50:07,46,326,12,34,206.93,329.07,0.00
2024-12-10 20:50:07,46,327,12,34,211.64,330.00,0.00
2024-12-10 20:50:07,47,327,12,35,207.14,330.02,0.00
2024-12-10 20:50:07,46,327,11,35,211.58,330.04,0.00
2024-12-10 20:50:07,45,327,10,35,212.50,330.20,0.00
2024-12-10 20:50:07,45,328,10,35,217.78,331.00,0.00
2024-12-10 20:50:07,46,328,10,36,213.04,331.02,0.00
2024-12-10 20:50:07,45,328,9,36,214.83,331.09,0.00
2024-12-10 20:50:07,45,329,9,36,219.82,332.00,0.00
2024-12-10 20:50:07,46,329,9,37,215.04,332.02,0.00
2024-12-10 20:50:07,45,329,9,36,219.09,332.07,0.00
2024-12-10 20:50:07,44,329,8,36,222.47,332.18,0.00
2024-12-10 20:50:07,44,330,8,36,227.91,333.00,0.00
2024-12-10 20:50:07,45,330,8,37,222.84,333.02,0.00
2024-12-10 20:50:07,45,331,8,37,223.31,334.00,0.00
2024-12-10 20:50:07,46,331,9,37,218.46,334.02,0.00
2024-12-10 20:50:07,45,331,8,37,219.06,334.24,0.00
2024-12-10 20:50:07,45,332,8,37,224.54,335.00,0.00
2024-12-10 20:50:07,46,332,8,38,219.66,335.02,0.00
2024-12-10 20:50:07,45,332,8,37,223.80,335.07,0.00
2024-12-10 20:50:07,45,333,8,37,225.80,336.00,0.00
2024-12-10 20:50:07,46,333,8,38,220.89,336.02,0.00
2024-12-10 20:50:07,45,333,7,38,222.32,336.18,0.00
2024-12-10 20:50:07,45,334,7,38,227.64,337.00,0.00
2024-12-10 20:50:07,46,334,8,38,222.69,337.02,0.00
2024-12-10 20:50:07,46,335,8,38,222.66,338.00,0.00
2024-12-10 20:50:07,47,335,9,38,217.92,338.02,0.00
2024-12-10 20:50:07,46,335,9,37,221.66,338.07,0.00
2024-12-10 20:50:07,45,335,8,37,222.99,338.93,0.00
2024-12-10 20:50:07,45,336,8,37,230.34,339.00,0.00
2024-12-10 20:50:07,46,336,9,37,225.33,339.02,0.00
2024-12-10 20:50:07,45,336,9,36,230.29,339.02,0.00
2024-12-10 20:50:07,45,337,9,36,230.82,340.00,0.00
2024-12-10 20:50:07,46,337,10,36,225.80,340.02,0.00
2024-12-10 20:50:07,45,337,9,36,226.92,340.69,0.00
2024-12-10 20:50:07,45,338,9,36,233.70,341.00,0.00
2024-12-10 20:50:07,46,338,9,37,228.62,341.02,0.00
2024-12-10 20:50:07,45,338,9,36,233.48,341.04,0.00
2024-12-10 20:50:07,45,339,9,36,235.45,342.00,0.00
2024-12-10 20:50:07,46,339,10,36,230.33,342.02,0.00
2024-12-10 20:50:07,46,340,10,36,230.73,343.00,0.00
2024-12-10 20:50:07,47,340,11,36,225.82,343.02,0.00
2024-12-10 20:50:07,47,341,11,36,226.04,344.00,0.00
2024-12-10 20:50:07,48,341,11,37,221.33,344.02,0.00
2024-12-10 20:50:07,47,341,11,36,225.61,344.06,0.00
2024-12-10 20:50:07,47,342,11,36,227.43,345.00,0.00
2024-12-10 20:50:07,48,342,11,37,222.69,345.02,0.00
2024-12-10 20:50:07,47,342,10,37,227.34,345.04,0.00
2024-12-10 20:50:07,47,343,10,37,227.89,346.00,0.00
2024-12-10 20:50:07,48,343,10,38,223.14,346.02,0.00
2024-12-10 20:50:07,48,344,10,38,223.28,347.00,0.00
2024-12-10 20:50:07,49,344,11,38,218.73,347.02,0.00
2024-12-10 20:50:07,48,344,11,37,223.00,347.04,0.00
2024-12-10 20:50:07,47,344,10,37,224.38,347.83,0.00
2024-12-10 20:50:07,47,345,10,37,231.31,348.00,0.00
2024-12-10 20:50:07,48,345,11,37,226.49,348.02,0.00
2024-12-10 20:50:07,48,346,11,37,226.93,349.00,0.00
2024-12-10 20:50:07,49,346,12,37,222.29,349.02,0.00
2024-12-10 20:50:07,49,347,12,37,222.36,350.00,0.00
2024-12-10 20:50:07,50,347,12,38,217.91,350.02,0.00
2024-12-10 20:50:07,49,347,12,37,221.94,350.04,0.00
2024-12-10 20:50:07,49,348,12,37,223.50,351.00,0.00
2024-12-10 20:50:07,50,348,13,37,219.03,351.02,0.00
2024-12-10 20:50:07,50,349,13,37,219.49,352.00,0.00
2024-12-10 20:50:07,51,349,13,38,215.18,352.02,0.00
2024-12-10 20:50:08,51,350,13,38,215.10,353.00,0.00
2024-12-10 20:50:08,52,350,13,39,210.96,353.02,0.00
2024-12-10 20:50:08,51,350,13,38,214.76,353.04,0.00
2024-12-10 20:50:08,51,351,13,38,216.13,354.00,0.00
2024-12-10 20:50:08,52,351,14,38,211.97,354.02,0.00
2024-12-10 20:50:08,51,351,13,38,210.73,354.96,0.00
2024-12-10 20:50:08,51,352,13,38,217.57,355.00,0.00
2024-12-10 20:50:08,52,352,13,39,213.39,355.02,0.00
2024-12-10 20:50:08,52,353,13,39,213.24,356.00,0.00
2024-12-10 20:50:08,53,353,13,40,209.21,356.02,0.00
2024-12-10 20:50:08,52,353,13,39,213.03,356.04,0.00
2024-12-10 20:50:08,52,354,13,39,214.32,357.00,0.00
2024-12-10 20:50:08,53,354,14,39,210.27,357.02,0.00
2024-12-10 20:50:08,52,354,13,39,209.59,357.46,0.00
2024-12-10 20:50:08,52,355,13,39,214.92,358.00,0.00
2024-12-10 20:50:08,53,355,14,39,210.86,358.02,0.00
2024-12-10 20:50:08,52,355,14,38,213.40,358.04,0.00
2024-12-10 20:50:08,52,356,14,38,214.69,359.00,0.00
2024-12-10 20:50:08,53,356,14,39,210.64,359.02,0.00
2024-12-10 20:50:08,53,357,14,39,210.84,360.00,0.00
2024-12-10 20:50:08,54,357,14,40,206.93,360.02,0.00
2024-12-10 20:50:08,53,357,14,39,209.41,360.04,0.00
2024-12-10 20:50:08,53,358,14,39,210.61,361.00,0.00
2024-12-10 20:50:08,54,358,15,39,206.71,361.02,0.00
2024-12-10 20:50:08,54,359,15,39,206.90,362.00,0.00
2024-12-10 20:50:08,55,359,16,39,203.14,362.02,0.00
2024-12-10 20:50:08,54,359,16,38,205.56,362.04,0.00
2024-12-10 20:50:08,54,360,16,38,206.38,363.00,0.00
2024-12-10 20:50:08,55,360,16,39,202.63,363.02,0.00
2024-12-10 20:50:08,54,360,15,39,201.10,363.85,0.00
2024-12-10 20:50:08,54,361,15,39,207.41,364.00,0.00
2024-12-10 20:50:08,55,361,15,40,203.64,364.02,0.00
2024-12-10 20:50:08,54,361,15,39,206.13,364.04,0.00
2024-12-10 20:50:08,53,361,14,39,208.18,364.60,0.00
2024-12-10 20:50:08,53,362,14,39,213.18,365.00,0.00
2024-12-10 20:50:08,54,362,14,40,209.23,365.02,0.00
2024-12-10 20:50:08,53,362,13,40,211.61,365.08,0.00
2024-12-10 20:50:08,53,363,13,40,212.48,366.00,0.00
2024-12-10 20:50:08,54,363,14,40,208.55,366.02,0.00
2024-12-10 20:50:08,53,363,14,39,211.24,366.04,0.00
2024-12-10 20:50:08,52,363,13,39,213.66,366.56,0.00
2024-12-10 20:50:08,52,364,13,39,215.58,367.00,0.00
2024-12-10 20:50:08,53,364,14,39,211.52,367.02,0.00
2024-12-10 20:50:08,53,365,14,39,210.50,368.00,0.00
2024-12-10 20:50:08,54,365,15,39,206.60,368.02,0.00
2024-12-10 20:50:08,53,365,15,38,209.32,368.04,0.00
2024-12-10 20:50:08,52,365,15,37,210.59,368.62,0.00
2024-12-10 20:50:08,51,365,14,37,214.53,368.67,0.00
2024-12-10 20:50:08,51,366,14,37,217.89,369.00,0.00
2024-12-10 20:50:08,52,366,15,37,213.70,369.02,0.00
2024-12-10 20:50:08,52,367,15,37,213.75,370.00,0.00
2024-12-10 20:50:08,53,367,16,37,209.72,370.02,0.00
2024-12-10 20:50:08,52,367,16,36,212.54,370.04,0.00
2024-12-10 20:50:08,51,367,15,36,215.06,370.55,0.00
2024-12-10 20:50:08,51,368,15,36,218.07,371.00,0.00
2024-12-10 20:50:08,52,368,15,37,213.88,371.02,0.00
2024-12-10 20:50:08,52,369,15,37,213.80,372.00,0.00
2024-12-10 20:50:08,53,369,16,37,209.77,372.02,0.00
2024-12-10 20:50:08,52,369,16,36,213.73,372.02,0.00
2024-12-10 20:50:08,51,369,16,35,216.83,372.02,0.00
2024-12-10 20:50:08,50,369,15,35,216.55,372.58,0.00
2024-12-10 20:50:08,50,370,15,35,222.74,373.00,0.00
2024-12-10 20:50:08,51,370,15,36,218.37,373.02,0.00
2024-12-10 20:50:08,51,371,15,36,218.23,374.00,0.00
2024-12-10 20:50:08,52,371,16,36,214.04,374.02,0.00
2024-12-10 20:50:08,51,371,16,35,217.21,374.02,0.00
2024-12-10 20:50:08,50,371,15,35,218.58,374.76,0.00
2024-12-10 20:50:08,50,372,15,35,225.36,375.00,0.00
2024-12-10 20:50:08,51,372,15,36,220.94,375.02,0.00
2024-12-10 20:50:08,50,372,14,36,219.12,375.56,0.00
2024-12-10 20:50:08,50,373,14,36,225.32,376.00,0.00
2024-12-10 20:50:08,51,373,14,37,220.90,376.02,0.00
2024-12-10 20:50:08,50,373,14,36,224.12,376.04,0.00
2024-12-10 20:50:08,49,373,13,36,227.06,376.24,0.00
2024-12-10 20:50:08,49,374,13,36,232.42,377.00,0.00
2024-12-10 20:50:08,50,374,14,36,227.78,377.02,0.00
2024-12-10 20:50:08,49,374,13,36,227.32,377.47,0.00
2024-12-10 20:50:08,49,375,13,36,233.43,378.00,0.00
2024-12-10 20:50:08,50,375,13,37,228.76,378.02,0.00
2024-12-10 20:50:08,49,375,13,36,232.05,378.06,0.00
2024-12-10 20:50:08,49,376,13,36,233.73,379.00,0.00
2024-12-10 20:50:08,50,376,13,37,229.06,379.02,0.00
2024-12-10 20:50:08,50,377,13,37,229.96,380.00,0.00
2024-12-10 20:50:08,51,377,14,37,225.45,380.02,0.00
2024-12-10 20:50:08,51,378,14,37,225.30,381.00,0.00
2024-12-10 20:50:08,52,378,15,37,220.97,381.02,0.00
2024-12-10 20:50:08,51,378,15,36,223.68,381.27,0.00
2024-12-10 20:50:08,51,379,15,36,225.72,382.00,0.00
2024-12-10 20:50:08,52,379,15,37,221.38,382.02,0.00
2024-12-10 20:50:08,52,380,15,37,221.47,383.00,0.00
2024-12-10 20:50:09,53,380,15,38,217.29,383.02,0.00
2024-12-10 20:50:09,52,380,14,38,218.05,383.37,0.00
2024-12-10 20:50:09,52,381,14,38,220.48,384.00,0.00
2024-12-10 20:50:09,53,381,14,39,216.32,384.02,0.00
2024-12-10 20:50:09,52,381,14,38,219.02,384.27,0.00
2024-12-10 20:50:09,52,382,14,38,221.13,385.00,0.00
2024-12-10 20:50:09,53,382,15,38,216.95,385.02,0.00
2024-12-10 20:50:09,53,383,15,38,217.59,386.00,0.00
2024-12-10 20:50:09,54,383,16,38,213.56,386.02,0.00
2024-12-10 20:50:09,54,384,16,38,213.13,387.00,0.00
2024-12-10 20:50:09,55,384,16,39,209.26,387.02,0.00
2024-12-10 20:50:09,54,384,16,38,211.85,387.26,0.00
2024-12-10 20:50:09,54,385,16,38,213.75,388.00,0.00
2024-12-10 20:50:09,55,385,16,39,209.86,388.02,0.00
2024-12-10 20:50:09,55,386,16,39,210.41,389.00,0.00
2024-12-10 20:50:09,56,386,17,39,206.65,389.02,0.00
2024-12-10 20:50:09,55,386,16,39,206.01,389.62,0.00
2024-12-10 20:50:09,55,387,16,39,211.87,390.00,0.00
2024-12-10 20:50:09,56,387,16,40,208.08,390.02,0.00
2024-12-10 20:50:09,55,387,16,39,210.73,390.25,0.00
2024-12-10 20:50:09,54,387,15,39,213.26,390.65,0.00
2024-12-10 20:50:09,54,388,15,39,216.49,391.00,0.00
2024-12-10 20:50:09,55,388,15,40,212.55,391.02,0.00
2024-12-10 20:50:09,54,388,14,40,213.51,391.44,0.00
2024-12-10 20:50:09,54,389,14,40,217.02,392.00,0.00
2024-12-10 20:50:09,55,389,15,40,213.07,392.02,0.00
2024-12-10 20:50:09,56,388,15,41,208.94,392.14,0.00
2024-12-10 20:50:09,55,388,14,41,211.59,392.96,0.00
2024-12-10 20:50:09,55,389,14,41,218.61,393.00,0.00
2024-12-10 20:50:09,56,389,15,41,214.70,393.02,0.00
2024-12-10 20:50:09,55,389,15,40,217.54,393.25,0.00
2024-12-10 20:50:09,56,388,16,40,212.34,393.68,0.00
2024-12-10 20:50:09,56,389,16,40,228.51,394.00,0.00
2024-12-10 20:50:09,57,389,17,40,224.50,394.02,0.00
2024-12-10 20:50:09,57,390,17,40,231.47,395.00,0.00
2024-12-10 20:50:09,58,390,17,41,227.48,395.02,0.00
2024-12-10 20:50:09,58,391,17,41,226.69,396.00,0.00
2024-12-10 20:50:09,59,391,17,42,222.84,396.02,0.00
2024-12-10 20:50:09,58,391,17,41,225.80,396.24,0.00
2024-12-10 20:50:09,57,391,16,41,227.58,396.81,0.00
2024-12-10 20:50:09,57,392,16,41,231.15,397.00,0.00
2024-12-10 20:50:09,58,392,17,41,227.16,397.02,0.00
2024-12-10 20:50:09,58,393,17,41,227.37,398.00,0.00
2024-12-10 20:50:09,59,393,17,42,223.52,398.02,0.00
2024-12-10 20:50:09,59,394,17,42,222.86,399.00,0.00
2024-12-10 20:50:09,60,394,17,43,219.15,399.02,0.00
2024-12-10 20:50:09,59,394,17,42,221.84,399.24,0.00
2024-12-10 20:50:09,59,395,17,42,223.35,400.00,0.00
2024-12-10 20:50:09,60,395,17,43,219.63,400.02,0.00
2024-12-10 20:50:09,60,396,17,43,219.80,401.00,0.00
2024-12-10 20:50:09,61,396,17,44,216.20,401.02,0.00
2024-12-10 20:50:09,60,396,16,44,215.62,401.62,0.00
2024-12-10 20:50:09,60,397,16,44,221.06,402.00,0.00
2024-12-10 20:50:09,61,397,16,45,217.44,402.02,0.00
2024-12-10 20:50:09,60,397,16,44,220.04,402.23,0.00
2024-12-10 20:50:09,59,397,15,44,221.46,402.34,0.00
2024-12-10 20:50:09,58,397,14,44,224.92,402.45,0.00
2024-12-10 20:50:09,58,398,14,44,230.04,403.00,0.00
2024-12-10 20:50:09,59,398,14,45,226.14,403.02,0.00
2024-12-10 20:50:09,59,399,14,45,226.30,404.00,0.00
2024-12-10 20:50:09,60,399,14,46,222.53,404.02,0.00
2024-12-10 20:50:09,60,400,14,46,221.80,405.00,0.00
2024-12-10 20:50:09,61,400,14,47,218.16,405.02,0.00
2024-12-10 20:50:09,60,400,14,46,220.83,405.23,0.00
2024-12-10 20:50:09,59,400,13,46,222.08,405.68,0.00
2024-12-10 20:50:09,59,401,13,46,227.89,406.00,0.00
2024-12-10 20:50:09,60,401,14,46,224.10,406.02,0.00
2024-12-10 20:50:09,60,402,14,46,224.28,407.00,0.00
2024-12-10 20:50:09,61,402,15,46,220.60,407.02,0.00
2024-12-10 20:50:09,61,403,15,46,219.89,408.00,0.00
2024-12-10 20:50:09,62,403,16,46,216.34,408.02,0.00
2024-12-10 20:50:09,61,403,16,45,218.86,408.23,0.00
2024-12-10 20:50:09,61,404,16,45,220.23,409.00,0.00
2024-12-10 20:50:09,62,404,17,45,216.67,409.02,0.00
2024-12-10 20:50:09,61,404,16,45,220.16,409.02,0.00
2024-12-10 20:50:09,61,405,16,45,220.32,410.00,0.00
2024-12-10 20:50:09,62,405,16,46,216.76,410.02,0.00
2024-12-10 20:50:09,62,406,16,46,215.96,411.00,0.00
2024-12-10 20:50:09,63,406,17,46,212.53,411.02,0.00
2024-12-10 20:50:09,62,406,17,45,215.06,411.21,0.00
2024-12-10 20:50:09,62,407,17,45,216.28,412.00,0.00
2024-12-10 20:50:09,63,407,17,46,212.85,412.02,0.00
2024-12-10 20:50:09,62,407,17,45,216.22,412.02,0.00
2024-12-10 20:50:09,61,407,16,45,215.25,412.77,0.00
2024-12-10 20:50:09,61,408,16,45,221.24,413.00,0.00
2024-12-10 20:50:09,62,408,16,46,217.67,413.02,0.00
2024-12-10 20:50:09,61,408,16,45,219.10,413.20,0.00
2024-12-10 20:50:10,60,408,15,45,220.78,413.72,0.00
2024-12-10 20:50:10,60,409,15,45,226.72,414.00,0.00
2024-12-10 20:50:10,61,409,15,46,223.00,414.02,0.00
2024-12-10 20:50:10,60,409,15,45,226.65,414.02,0.00
2024-12-10 20:50:10,60,410,15,45,226.73,415.00,0.00
2024-12-10 20:50:10,61,410,16,45,223.01,415.02,0.00
2024-12-10 20:50:10,60,410,16,44,226.66,415.02,0.00
2024-12-10 20:50:10,59,410,16,43,228.42,415.17,0.00
2024-12-10 20:50:10,59,411,16,43,229.72,416.00,0.00
2024-12-10 20:50:10,60,411,17,43,225.89,416.02,0.00
2024-12-10 20:50:10,59,411,17,42,229.65,416.02,0.00
2024-12-10 20:50:10,58,411,16,42,226.84,416.93,0.00
2024-12-10 20:50:10,58,412,16,42,233.79,417.00,0.00
2024-12-10 20:50:10,59,412,16,43,229.83,417.02,0.00
2024-12-10 20:50:10,58,412,16,42,231.80,417.16,0.00
2024-12-10 20:50:10,58,413,16,42,233.12,418.00,0.00
2024-12-10 20:50:10,59,413,16,43,229.17,418.02,0.00
2024-12-10 20:50:10,59,414,16,43,229.25,419.00,0.00
2024-12-10 20:50:10,60,414,17,43,225.43,419.02,0.00
2024-12-10 20:50:10,59,414,17,42,227.21,419.15,0.00
2024-12-10 20:50:10,58,414,16,42,229.25,419.24,0.00
2024-12-10 20:50:10,59,413,17,42,225.05,419.36,0.00
2024-12-10 20:50:10,59,414,17,42,232.97,420.00,0.00
2024-12-10 20:50:10,60,414,18,42,229.09,420.02,0.00
2024-12-10 20:50:10,59,414,18,41,232.84,420.03,0.00
2024-12-10 20:50:10,59,415,18,41,240.13,421.00,0.00
2024-12-10 20:50:10,60,415,19,41,236.12,421.02,0.00
2024-12-10 20:50:10,59,415,19,40,239.99,421.03,0.00
2024-12-10 20:50:10,58,415,19,39,242.32,421.12,0.00
2024-12-10 20:50:10,58,416,19,39,243.49,422.00,0.00
2024-12-10 20:50:10,59,416,19,40,239.36,422.02,0.00
2024-12-10 20:50:10,58,416,19,39,243.36,422.03,0.00
2024-12-10 20:50:10,58,417,19,39,243.45,423.00,0.00
2024-12-10 20:50:10,59,417,19,40,239.32,423.02,0.00
2024-12-10 20:50:10,58,417,19,39,243.32,423.03,0.00
2024-12-10 20:50:10,57,417,19,38,245.73,423.11,0.00
2024-12-10 20:50:10,56,417,18,38,246.42,423.77,0.00
2024-12-10 20:50:10,56,418,18,38,253.19,424.00,0.00
2024-12-10 20:50:10,57,418,18,39,248.75,424.02,0.00
2024-12-10 20:50:10,57,419,18,39,248.73,425.00,0.00
2024-12-10 20:50:10,58,419,19,39,244.44,425.02,0.00
2024-12-10 20:50:10,57,419,19,38,246.88,425.11,0.00
2024-12-10 20:50:10,56,419,18,38,245.83,425.89,0.00
2024-12-10 20:50:10,56,420,18,38,253.06,426.00,0.00
2024-12-10 20:50:10,57,420,18,39,248.62,426.02,0.00
2024-12-10 20:50:10,56,420,17,39,252.72,426.09,0.00
2024-12-10 20:50:10,55,420,16,39,255.38,426.11,0.00
2024-12-10 20:50:10,54,420,15,39,258.90,426.43,0.00
2024-12-10 20:50:10,54,421,15,39,264.78,427.00,0.00
2024-12-10 20:50:10,55,421,16,39,259.96,427.02,0.00
2024-12-10 20:50:10,54,421,16,38,264.63,427.04,0.00
2024-12-10 20:50:10,53,421,16,37,267.93,427.08,0.00
2024-12-10 20:50:10,53,422,16,37,269.44,428.00,0.00
2024-12-10 20:50:10,54,422,16,38,264.45,428.02,0.00
2024-12-10 20:50:10,53,422,16,37,269.29,428.04,0.00
2024-12-10 20:50:10,53,423,16,37,269.38,429.00,0.00
2024-12-10 20:50:10,54,423,17,37,264.39,429.02,0.00
2024-12-10 20:50:10,53,423,17,36,269.23,429.04,0.00
2024-12-10 20:50:10,52,423,17,35,272.73,429.04,0.00
2024-12-10 20:50:10,51,423,16,35,274.34,429.37,0.00
2024-12-10 20:50:10,51,424,16,35,280.52,430.00,0.00
2024-12-10 20:50:10,52,424,16,36,275.13,430.02,0.00
2024-12-10 20:50:10,52,425,16,36,275.18,431.00,0.00
2024-12-10 20:50:10,53,425,17,36,269.98,431.02,0.00
2024-12-10 20:50:10,52,425,16,36,271.06,431.08,0.00
2024-12-10 20:50:10,52,426,16,36,275.99,432.00,0.00
2024-12-10 20:50:10,53,426,16,37,270.79,432.02,0.00
2024-12-10 20:50:10,52,426,16,36,275.68,432.06,0.00
2024-12-10 20:50:10,52,427,16,36,277.22,433.00,0.00
2024-12-10 20:50:10,53,427,17,36,271.99,433.02,0.00
2024-12-10 20:50:10,53,428,17,36,274.07,434.00,0.00
2024-12-10 20:50:10,54,428,17,37,269.00,434.02,0.00
2024-12-10 20:50:10,54,429,17,37,270.40,435.00,0.00
2024-12-10 20:50:10,55,429,18,37,265.49,435.02,0.00
2024-12-10 20:50:10,54,429,17,37,264.54,435.74,0.00
2024-12-10 20:50:10,54,430,17,37,271.70,436.00,0.00
2024-12-10 20:50:10,55,430,18,37,266.76,436.02,0.00
2024-12-10 20:50:10,55,431,18,37,266.26,437.00,0.00
2024-12-10 20:50:10,56,431,18,38,261.51,437.02,0.00
2024-12-10 20:50:10,55,431,18,37,265.88,437.05,0.00
2024-12-10 20:50:10,55,432,18,37,267.11,438.00,0.00
2024-12-10 20:50:10,56,432,19,37,262.34,438.02,0.00
2024-12-10 20:50:10,56,433,19,37,262.03,439.00,0.00
2024-12-10 20:50:10,57,433,20,37,257.43,439.02,0.00
2024-12-10 20:50:10,56,433,20,36,260.47,439.05,0.00
2024-12-10 20:50:10,56,434,20,36,261.61,440.00,0.00
2024-12-10 20:50:10,57,434,20,37,257.02,440.02,0.00
2024-12-10 20:50:10,57,435,20,37,256.74,441.00,0.00
2024-12-10 20:50:10,58,435,20,38,252.31,441.02,0.00
2024-12-10 20:50:10,57,435,20,37,255.20,441.05,0.00
2024-12-10 20:50:11,56,435,19,37,259.69,441.07,0.00
2024-12-10 20:50:11,55,435,18,37,260.22,441.84,0.00
2024-12-10 20:50:11,55,436,18,37,267.65,442.00,0.00
2024-12-10 20:50:11,56,436,19,37,262.87,442.02,0.00
2024-12-10 20:50:11,56,437,19,37,262.52,443.00,0.00
2024-12-10 20:50:11,57,437,19,38,257.92,443.02,0.00
2024-12-10 20:50:11,56,437,19,37,261.03,443.05,0.00
2024-12-10 20:50:11,56,438,19,37,262.12,444.00,0.00
2024-12-10 20:50:11,57,438,20,37,257.52,444.02,0.00
2024-12-10 20:50:11,56,438,19,37,258.80,444.45,0.00
2024-12-10 20:50:11,56,439,19,37,261.90,445.00,0.00
2024-12-10 20:50:11,57,439,20,37,257.30,445.02,0.00
2024-12-10 20:50:11,56,439,19,37,261.74,445.05,0.00
2024-12-10 20:50:11,55,439,19,36,265.04,445.05,0.00
2024-12-10 20:50:11,55,440,19,36,266.08,446.00,0.00
2024-12-10 20:50:11,56,440,20,36,261.33,446.02,0.00
2024-12-10 20:50:11,55,440,19,36,265.95,446.04,0.00
2024-12-10 20:50:11,55,441,19,36,265.51,447.00,0.00
2024-12-10 20:50:11,56,441,19,37,260.77,447.02,0.00
2024-12-10 20:50:11,55,441,19,36,264.06,447.04,0.00
2024-12-10 20:50:11,55,442,19,36,264.81,448.00,0.00
2024-12-10 20:50:11,56,442,20,36,260.08,448.02,0.00
2024-12-10 20:50:11,56,443,20,36,259.32,449.00,0.00
2024-12-10 20:50:11,57,443,20,37,254.77,449.02,0.00
2024-12-10 20:50:11,56,443,20,36,257.96,449.04,0.00
2024-12-10 20:50:11,56,444,20,36,258.58,450.00,0.00
2024-12-10 20:50:11,57,444,20,37,254.05,450.02,0.00
2024-12-10 20:50:11,57,445,20,37,253.41,451.00,0.00
2024-12-10 20:50:11,58,445,21,37,249.04,451.02,0.00
2024-12-10 20:50:11,57,445,21,36,251.99,451.04,0.00
2024-12-10 20:50:11,56,445,20,36,251.12,451.93,0.00
2024-12-10 20:50:11,56,446,20,36,258.91,452.00,0.00
2024-12-10 20:50:11,57,446,20,37,254.37,452.02,0.00
2024-12-10 20:50:11,56,446,19,37,254.82,452.30,0.00
2024-12-10 20:50:11,56,447,19,37,259.92,453.00,0.00
2024-12-10 20:50:11,57,447,20,37,255.36,453.02,0.00
2024-12-10 20:50:11,56,447,20,36,258.55,453.04,0.00
2024-12-10 20:50:11,55,447,19,36,260.98,453.29,0.00
2024-12-10 20:50:11,55,448,19,36,266.21,454.00,0.00
2024-12-10 20:50:11,56,448,19,37,261.46,454.02,0.00
2024-12-10 20:50:11,56,449,19,37,260.96,455.00,0.00
2024-12-10 20:50:11,57,449,19,38,256.39,455.02,0.00
2024-12-10 20:50:11,56,449,19,37,259.59,455.04,0.00
2024-12-10 20:50:11,55,449,18,37,260.97,455.35,0.00
2024-12-10 20:50:11,55,450,18,37,266.49,456.00,0.00
2024-12-10 20:50:11,56,450,18,38,261.73,456.02,0.00
2024-12-10 20:50:11,56,451,18,38,261.22,457.00,0.00
2024-12-10 20:50:11,57,451,18,39,256.63,457.02,0.00
2024-12-10 20:50:11,56,451,18,38,259.92,457.04,0.00
2024-12-10 20:50:11,56,452,18,38,260.79,458.00,0.00
2024-12-10 20:50:11,57,452,19,38,256.22,458.02,0.00
2024-12-10 20:50:11,57,453,19,38,255.88,459.00,0.00
2024-12-10 20:50:11,58,453,20,38,251.47,459.02,0.00
2024-12-10 20:50:11,57,453,20,37,254.29,459.07,0.00
2024-12-10 20:50:11,57,454,20,37,255.24,460.00,0.00
2024-12-10 20:50:11,58,454,21,37,250.84,460.02,0.00
2024-12-10 20:50:11,57,454,20,37,248.46,460.61,0.00
2024-12-10 20:50:11,57,455,20,37,255.03,461.00,0.00
2024-12-10 20:50:11,58,455,20,38,250.64,461.02,0.00
2024-12-10 20:50:11,57,455,20,37,253.51,461.07,0.00
2024-12-10 20:50:11,56,455,19,37,255.97,461.55,0.00
2024-12-10 20:50:11,56,456,19,37,262.46,462.00,0.00
2024-12-10 20:50:11,57,456,20,37,257.85,462.02,0.00
2024-12-10 20:50:11,57,457,20,37,257.68,463.00,0.00
2024-12-10 20:50:11,58,457,21,37,253.24,463.02,0.00
2024-12-10 20:50:11,57,457,21,36,256.15,463.07,0.00
2024-12-10 20:50:11,57,458,21,36,257.26,464.00,0.00
2024-12-10 20:50:11,58,458,21,37,252.82,464.02,0.00
2024-12-10 20:50:11,57,458,20,37,253.23,464.58,0.00
2024-12-10 20:50:11,56,458,19,37,256.57,464.70,0.00
2024-12-10 20:50:11,56,459,19,37,263.70,465.00,0.00
2024-12-10 20:50:11,57,459,19,38,259.07,465.02,0.00
2024-12-10 20:50:11,56,459,19,37,262.22,465.07,0.00
2024-12-10 20:50:11,56,460,19,37,263.43,466.00,0.00
2024-12-10 20:50:11,57,460,19,38,258.81,466.02,0.00
2024-12-10 20:50:11,56,460,18,38,256.33,466.63,0.00
2024-12-10 20:50:11,56,461,18,38,263.19,467.00,0.00
2024-12-10 20:50:11,57,461,18,39,258.57,467.02,0.00
2024-12-10 20:50:11,56,461,18,38,261.78,467.07,0.00
2024-12-10 20:50:11,55,461,17,38,261.18,467.56,0.00
2024-12-10 20:50:11,55,462,17,38,267.96,468.00,0.00
2024-12-10 20:50:11,56,462,18,38,263.18,468.02,0.00
2024-12-10 20:50:11,56,463,18,38,262.88,469.00,0.00
2024-12-10 20:50:11,57,463,18,39,258.27,469.02,0.00
2024-12-10 20:50:11,56,463,18,38,261.55,469.07,0.00
2024-12-10 20:50:12,56,464,18,38,262.77,470.00,0.00
2024-12-10 20:50:12,57,464,19,38,258.16,470.02,0.00
2024-12-10 20:50:12,57,465,19,38,257.81,471.00,0.00
2024-12-10 20:50:12,58,465,19,39,253.37,471.02,0.00
2024-12-10 20:50:12,57,465,19,38,256.58,471.07,0.00
2024-12-10 20:50:12,56,465,18,38,258.96,471.57,0.00
2024-12-10 20:50:12,56,466,18,38,262.30,472.00,0.00
2024-12-10 20:50:12,57,466,19,38,257.70,472.02,0.00
2024-12-10 20:50:12,56,466,18,38,260.29,472.05,0.00
2024-12-10 20:50:12,56,467,18,38,263.11,473.00,0.00
2024-12-10 20:50:12,57,467,19,38,258.49,473.02,0.00
2024-12-10 20:50:12,56,467,19,37,262.02,473.05,0.00
2024-12-10 20:50:12,56,468,19,37,263.16,474.00,0.00
2024-12-10 20:50:12,57,468,20,37,258.54,474.02,0.00
2024-12-10 20:50:12,56,468,19,37,259.13,474.55,0.00
2024-12-10 20:50:12,56,469,19,37,262.75,475.00,0.00
2024-12-10 20:50:12,57,469,19,38,258.14,475.02,0.00
2024-12-10 20:50:12,56,469,19,37,261.74,475.05,0.00
2024-12-10 20:50:12,56,470,19,37,262.88,476.00,0.00
2024-12-10 20:50:12,57,470,19,38,258.27,476.02,0.00
2024-12-10 20:50:12,57,471,19,38,257.69,477.00,0.00
2024-12-10 20:50:12,58,471,20,38,253.25,477.02,0.00
2024-12-10 20:50:12,57,471,20,37,256.78,477.05,0.00
2024-12-10 20:50:12,56,471,19,37,261.05,477.13,0.00
2024-12-10 20:50:12,55,471,18,37,260.34,477.95,0.00
2024-12-10 20:50:12,55,472,18,37,268.79,478.00,0.00
2024-12-10 20:50:12,56,472,18,38,263.99,478.02,0.00
2024-12-10 20:50:12,55,472,17,38,266.23,478.16,0.00
2024-12-10 20:50:12,54,472,16,38,270.44,478.31,0.00
2024-12-10 20:50:12,53,472,15,38,274.51,478.57,0.00
2024-12-10 20:50:12,53,473,15,38,281.78,479.00,0.00
2024-12-10 20:50:12,54,473,16,38,276.56,479.02,0.00
2024-12-10 20:50:12,53,473,16,37,280.52,479.06,0.00
2024-12-10 20:50:12,53,474,16,37,282.01,480.00,0.00
2024-12-10 20:50:12,54,474,16,38,276.79,480.02,0.00
2024-12-10 20:50:12,54,475,16,38,276.31,481.00,0.00
2024-12-10 20:50:12,55,475,16,39,271.29,481.02,0.00
2024-12-10 20:50:12,54,475,16,38,275.07,481.06,0.00
2024-12-10 20:50:12,53,475,15,38,276.20,481.13,0.00
2024-12-10 20:50:12,53,476,15,38,281.66,482.00,0.00
2024-12-10 20:50:12,54,476,15,39,276.44,482.02,0.00
2024-12-10 20:50:12,53,476,14,39,275.50,482.77,0.00
2024-12-10 20:50:12,53,477,14,39,283.69,483.00,0.00
2024-12-10 20:50:12,54,477,15,39,278.43,483.02,0.00
2024-12-10 20:50:12,53,477,15,38,282.51,483.06,0.00
2024-12-10 20:50:12,52,477,14,38,284.76,483.67,0.00
2024-12-10 20:50:12,52,478,14,38,292.75,484.00,0.00
2024-12-10 20:50:12,53,478,15,38,287.22,484.02,0.00
2024-12-10 20:50:12,53,479,15,38,286.72,485.00,0.00
2024-12-10 20:50:12,54,479,16,38,281.41,485.02,0.00
2024-12-10 20:50:12,53,479,16,37,285.62,485.06,0.00
2024-12-10 20:50:12,53,480,16,37,287.13,486.00,0.00
2024-12-10 20:50:12,54,480,16,38,281.81,486.02,0.00
2024-12-10 20:50:12,54,481,16,38,281.23,487.00,0.00
2024-12-10 20:50:12,55,481,16,39,276.12,487.02,0.00
2024-12-10 20:50:12,54,481,16,38,280.06,487.06,0.00
2024-12-10 20:50:12,54,482,16,38,281.45,488.00,0.00
2024-12-10 20:50:12,55,482,16,39,276.33,488.02,0.00
2024-12-10 20:50:12,56,481,17,39,267.81,488.46,0.00
2024-12-10 20:50:12,56,482,17,39,273.77,489.00,0.00
2024-12-10 20:50:12,57,482,17,40,268.96,489.02,0.00
2024-12-10 20:50:12,56,482,17,39,272.72,489.05,0.00
2024-12-10 20:50:12,55,482,16,39,272.52,489.91,0.00
2024-12-10 20:50:12,55,483,16,39,289.93,490.00,0.00
2024-12-10 20:50:12,56,483,17,39,284.76,490.02,0.00
2024-12-10 20:50:12,56,484,17,39,284.22,491.00,0.00
2024-12-10 20:50:12,57,484,18,39,279.24,491.02,0.00
2024-12-10 20:50:12,56,484,18,38,283.00,491.05,0.00
2024-12-10 20:50:12,56,485,18,38,284.19,492.00,0.00
2024-12-10 20:50:12,57,485,19,38,279.20,492.02,0.00
2024-12-10 20:50:12,56,485,19,37,284.10,492.02,0.00
2024-12-10 20:50:12,55,485,19,36,289.18,492.02,0.00
2024-12-10 20:50:12,55,486,19,36,288.72,493.00,0.00
2024-12-10 20:50:12,56,486,20,36,283.56,493.02,0.00
2024-12-10 20:50:12,55,486,20,35,287.73,493.02,0.00
2024-12-10 20:50:12,54,486,19,35,287.11,493.96,0.00
2024-12-10 20:50:12,54,487,19,35,296.10,494.00,0.00
2024-12-10 20:50:12,55,487,19,36,290.71,494.02,0.00
2024-12-10 20:50:12,54,487,18,36,291.25,494.04,0.00
2024-12-10 20:50:12,54,488,18,36,296.24,495.00,0.00
2024-12-10 20:50:12,55,488,19,36,290.85,495.02,0.00
2024-12-10 20:50:12,54,488,19,35,295.32,495.02,0.00
2024-12-10 20:50:12,53,488,18,35,300.28,495.13,0.00
2024-12-10 20:50:12,52,488,17,35,302.30,495.42,0.00
2024-12-10 20:50:12,53,487,18,35,295.95,495.60,0.00
2024-12-10 20:50:12,53,488,18,35,305.80,496.00,0.00
2024-12-10 20:50:12,54,488,19,35,300.14,496.02,0.00
2024-12-10 20:50:12,53,488,18,35,300.85,496.04,0.00
2024-12-10 20:50:12,53,489,18,35,315.42,497.00,0.00
2024-12-10 20:50:12,54,489,19,35,309.58,497.02,0.00
2024-12-10 20:50:12,53,489,19,34,314.49,497.02,0.00
2024-12-10 20:50:12,53,490,19,34,315.87,498.00,0.00
2024-12-10 20:50:12,54,490,19,35,310.02,498.02,0.00
2024-12-10 20:50:12,54,491,19,35,309.44,499.00,0.00
2024-12-10 20:50:13,55,491,20,35,303.82,499.02,0.00
2024-12-10 20:50:13,54,491,20,34,308.52,499.02,0.00
2024-12-10 20:50:13,53,491,19,34,312.25,499.21,0.00
2024-12-10 20:50:13,53,492,19,34,318.27,500.00,0.00
2024-12-10 20:50:13,54,492,20,34,312.38,500.02,0.00
2024-12-10 20:50:13,54,493,20,34,311.80,501.00,0.00
2024-12-10 20:50:13,55,493,21,34,306.13,501.02,0.00
2024-12-10 20:50:13,54,493,21,33,310.87,501.02,0.00
2024-12-10 20:50:13,54,494,21,33,312.14,502.00,0.00
2024-12-10 20:50:13,55,494,21,34,306.46,502.02,0.00
2024-12-10 20:50:13,55,495,21,34,305.79,503.00,0.00
2024-12-10 20:50:13,56,495,21,35,300.33,503.02,0.00
2024-12-10 20:50:13,55,495,21,34,304.88,503.02,0.00
2024-12-10 20:50:13,55,496,21,34,306.04,504.00,0.00
2024-12-10 20:50:13,56,496,21,35,300.57,504.02,0.00
2024-12-10 20:50:13,56,497,21,35,299.81,505.00,0.00
2024-12-10 20:50:13,57,497,21,36,294.55,505.02,0.00
2024-12-10 20:50:13,56,497,21,35,298.91,505.02,0.00
2024-12-10 20:50:13,56,498,21,35,299.96,506.00,0.00
2024-12-10 20:50:13,57,498,22,35,294.69,506.02,0.00
2024-12-10 20:50:13,56,498,21,35,291.79,506.63,0.00
2024-12-10 20:50:13,56,499,21,35,299.22,507.00,0.00
2024-12-10 20:50:13,57,499,21,36,293.97,507.02,0.00
2024-12-10 20:50:13,56,499,21,35,298.22,507.02,0.00
2024-12-10 20:50:13,56,500,21,35,299.27,508.00,0.00
2024-12-10 20:50:13,57,500,21,36,294.02,508.02,0.00
2024-12-10 20:50:13,57,501,21,36,293.28,509.00,0.00
2024-12-10 20:50:13,58,501,22,36,288.22,509.02,0.00
2024-12-10 20:50:13,57,501,22,35,292.20,509.02,0.00
2024-12-10 20:50:13,56,501,21,35,292.42,509.86,0.00
2024-12-10 20:50:13,56,502,21,35,300.90,510.00,0.00
2024-12-10 20:50:13,57,502,21,36,295.62,510.02,0.00
2024-12-10 20:50:13,56,502,20,36,295.23,510.39,0.00
2024-12-10 20:50:13,56,503,20,36,301.67,511.00,0.00
2024-12-10 20:50:13,57,503,20,37,296.38,511.02,0.00
2024-12-10 20:50:13,56,503,20,36,300.40,511.04,0.00
2024-12-10 20:50:13,55,503,19,36,302.02,511.38,0.00
2024-12-10 20:50:13,55,504,19,36,308.60,512.00,0.00
2024-12-10 20:50:13,56,504,19,37,303.09,512.02,0.00
2024-12-10 20:50:13,55,504,18,37,302.15,512.82,0.00
2024-12-10 20:50:13,55,505,18,37,310.69,513.00,0.00
2024-12-10 20:50:13,56,505,18,38,305.14,513.02,0.00
2024-12-10 20:50:13,55,505,18,37,309.20,513.04,0.00
2024-12-10 20:50:13,54,505,17,37,308.31,513.65,0.00
2024-12-10 20:50:13,54,506,17,37,316.30,514.00,0.00
2024-12-10 20:50:13,55,506,17,38,310.55,514.02,0.00
2024-12-10 20:50:13,55,507,17,38,310.04,515.00,0.00
2024-12-10 20:50:13,56,507,18,38,304.51,515.02,0.00
2024-12-10 20:50:13,55,507,18,37,308.55,515.04,0.00
2024-12-10 20:50:13,54,507,17,37,310.79,515.70,0.00
2024-12-10 20:50:13,54,508,17,37,319.06,516.00,0.00
2024-12-10 20:50:13,55,508,18,37,313.26,516.02,0.00
2024-12-10 20:50:13,55,509,18,37,312.69,517.00,0.00
2024-12-10 20:50:13,56,509,19,37,307.11,517.02,0.00
2024-12-10 20:50:13,55,509,19,36,311.29,517.04,0.00
2024-12-10 20:50:13,55,510,19,36,312.55,518.00,0.00
2024-12-10 20:50:13,56,510,19,37,306.96,518.02,0.00
2024-12-10 20:50:13,56,511,19,37,306.39,519.00,0.00
2024-12-10 20:50:13,57,511,20,37,301.02,519.02,0.00
2024-12-10 20:50:13,56,511,20,36,305.01,519.04,0.00
2024-12-10 20:50:13,55,511,19,36,310.02,519.13,0.00
2024-12-10 20:50:13,54,511,18,36,310.09,519.57,0.00
2024-12-10 20:50:13,54,512,18,36,317.83,520.00,0.00
2024-12-10 20:50:13,55,512,19,36,312.05,520.02,0.00
2024-12-10 20:50:13,54,512,18,36,315.43,520.11,0.00
2024-12-10 20:50:13,54,513,18,36,319.57,521.00,0.00
2024-12-10 20:50:13,55,513,19,36,313.76,521.02,0.00
2024-12-10 20:50:13,55,514,19,36,314.06,522.00,0.00
2024-12-10 20:50:13,56,514,19,37,308.45,522.02,0.00
2024-12-10 20:50:13,56,515,19,37,307.64,523.00,0.00
2024-12-10 20:50:13,57,515,20,37,302.25,523.02,0.00
2024-12-10 20:50:13,56,515,20,36,306.99,523.04,0.00
2024-12-10 20:50:13,55,515,19,36,312.17,523.11,0.00
2024-12-10 20:50:13,55,516,19,36,313.79,524.00,0.00
2024-12-10 20:50:13,56,516,19,37,308.18,524.02,0.00
2024-12-10 20:50:13,56,517,19,37,307.37,525.00,0.00
2024-12-10 20:50:13,57,517,19,38,301.97,525.02,0.00
2024-12-10 20:50:13,56,517,19,37,306.24,525.04,0.00
2024-12-10 20:50:13,56,518,19,37,307.39,526.00,0.00
2024-12-10 20:50:13,57,518,19,38,302.00,526.02,0.00
2024-12-10 20:50:13,56,518,18,38,300.09,526.89,0.00
2024-12-10 20:50:13,56,519,18,38,309.01,527.00,0.00
2024-12-10 20:50:13,57,519,19,38,303.59,527.02,0.00
2024-12-10 20:50:13,56,519,19,37,307.98,527.04,0.00
2024-12-10 20:50:13,56,520,19,37,309.12,528.00,0.00
2024-12-10 20:50:13,57,520,19,38,303.70,528.02,0.00
2024-12-10 20:50:14,57,521,19,38,302.79,529.00,0.00
2024-12-10 20:50:14,58,521,19,39,297.57,529.02,0.00
2024-12-10 20:50:14,57,521,19,38,301.86,529.04,0.00
2024-12-10 20:50:14,57,522,19,38,302.90,530.00,0.00
2024-12-10 20:50:14,58,522,19,39,297.67,530.02,0.00
2024-12-10 20:50:14,57,522,18,39,296.48,530.46,0.00
2024-12-10 20:50:14,57,523,18,39,303.28,531.00,0.00
2024-12-10 20:50:14,58,523,18,40,298.05,531.02,0.00
2024-12-10 20:50:14,57,523,18,39,302.17,531.04,0.00
2024-12-10 20:50:14,56,523,17,39,307.12,531.13,0.00
2024-12-10 20:50:14,55,523,16,39,311.17,531.22,0.00
2024-12-10 20:50:14,55,524,16,39,317.20,532.00,0.00
2024-12-10 20:50:14,56,524,17,39,311.53,532.02,0.00
2024-12-10 20:50:14,56,525,17,39,310.71,533.00,0.00
2024-12-10 20:50:14,57,525,18,39,305.26,533.02,0.00
2024-12-10 20:50:14,56,525,18,38,309.47,533.04,0.00
2024-12-10 20:50:14,55,525,17,38,309.35,533.55,0.00
2024-12-10 20:50:14,55,526,17,38,316.95,534.00,0.00
2024-12-10 20:50:14,56,526,17,39,311.29,534.02,0.00
2024-12-10 20:50:14,56,527,17,39,310.49,535.00,0.00
2024-12-10 20:50:14,57,527,17,40,305.04,535.02,0.00
2024-12-10 20:50:14,56,527,17,39,309.34,535.04,0.00
2024-12-10 20:50:14,56,528,17,39,310.49,536.00,0.00
2024-12-10 20:50:14,57,528,18,39,305.04,536.02,0.00
2024-12-10 20:50:14,56,528,17,39,302.28,536.96,0.00
2024-12-10 20:50:14,56,529,17,39,311.70,537.00,0.00
2024-12-10 20:50:14,57,529,18,39,306.23,537.02,0.00
2024-12-10 20:50:14,56,529,18,38,310.64,537.04,0.00
2024-12-10 20:50:14,56,530,18,38,311.80,538.00,0.00
2024-12-10 20:50:14,57,530,18,39,306.33,538.02,0.00
2024-12-10 20:50:14,57,531,18,39,305.39,539.00,0.00
2024-12-10 20:50:14,58,531,18,40,300.13,539.02,0.00
2024-12-10 20:50:14,57,531,18,39,304.45,539.04,0.00
2024-12-10 20:50:14,56,531,17,39,303.68,539.96,0.00
2024-12-10 20:50:14,56,532,17,39,313.15,540.00,0.00
2024-12-10 20:50:14,57,532,17,40,307.66,540.02,0.00
2024-12-10 20:50:14,57,533,17,40,306.76,541.00,0.00
2024-12-10 20:50:14,58,533,17,41,301.48,541.02,0.00
2024-12-10 20:50:14,57,533,17,40,306.67,541.02,0.00
2024-12-10 20:50:14,56,533,17,39,311.28,541.02,0.00
2024-12-10 20:50:14,55,533,16,39,313.94,541.31,0.00
2024-12-10 20:50:14,54,533,15,39,317.88,541.69,0.00
2024-12-10 20:50:14,54,534,15,39,326.45,542.00,0.00
2024-12-10 20:50:14,55,534,16,39,320.52,542.02,0.00
2024-12-10 20:50:14,54,534,15,39,323.50,542.17,0.00
2024-12-10 20:50:14,54,535,15,39,329.57,543.00,0.00
2024-12-10 20:50:14,55,535,15,40,323.58,543.02,0.00
2024-12-10 20:50:14,55,536,15,40,322.79,544.00,0.00
2024-12-10 20:50:14,56,536,15,41,317.02,544.02,0.00
2024-12-10 20:50:14,55,536,15,40,321.60,544.02,0.00
2024-12-10 20:50:14,55,537,15,40,322.79,545.00,0.00
2024-12-10 20:50:14,56,537,15,41,317.02,545.02,0.00
2024-12-10 20:50:14,55,537,14,41,317.34,545.05,0.00
2024-12-10 20:50:14,55,538,14,41,322.68,546.00,0.00
2024-12-10 20:50:14,56,538,14,42,316.92,546.02,0.00
2024-12-10 20:50:14,55,538,14,41,321.69,546.02,0.00
2024-12-10 20:50:14,54,538,13,41,324.77,546.28,0.00
2024-12-10 20:50:14,54,539,13,41,331.44,547.00,0.00
2024-12-10 20:50:14,55,539,14,41,325.41,547.02,0.00
2024-12-10 20:50:14,54,539,13,41,323.88,547.52,0.00
2024-12-10 20:50:14,53,539,12,41,329.16,547.68,0.00
2024-12-10 20:50:14,53,540,12,41,338.00,548.00,0.00
2024-12-10 20:50:14,54,540,12,42,331.74,548.02,0.00
2024-12-10 20:50:14,53,540,12,41,337.07,548.02,0.00
2024-12-10 20:50:14,53,541,12,41,338.51,549.00,0.00
2024-12-10 20:50:14,54,541,12,42,332.24,549.02,0.00
2024-12-10 20:50:14,54,542,12,42,331.52,550.00,0.00
2024-12-10 20:50:14,55,542,12,43,325.50,550.02,0.00
2024-12-10 20:50:14,54,542,12,42,330.61,550.02,0.00
2024-12-10 20:50:14,53,542,11,42,335.86,550.17,0.00
2024-12-10 20:50:14,53,543,11,42,342.24,551.00,0.00
2024-12-10 20:50:14,54,543,12,42,335.90,551.02,0.00
2024-12-10 20:50:14,54,544,12,42,335.18,552.00,0.00
2024-12-10 20:50:14,55,544,12,43,329.09,552.02,0.00
2024-12-10 20:50:14,54,544,12,42,334.26,552.02,0.00
2024-12-10 20:50:14,53,544,11,42,338.20,552.49,0.00
2024-12-10 20:50:14,53,545,11,42,342.02,553.00,0.00
2024-12-10 20:50:14,54,545,12,42,335.69,553.02,0.00
2024-12-10 20:50:14,54,546,12,42,334.96,554.00,0.00
2024-12-10 20:50:14,55,546,13,42,328.87,554.02,0.00
2024-12-10 20:50:14,54,546,13,41,334.14,554.02,0.00
2024-12-10 20:50:14,54,547,13,41,335.46,555.00,0.00
2024-12-10 20:50:14,55,547,14,41,329.36,555.02,0.00
2024-12-10 20:50:14,54,547,13,41,327.07,555.94,0.00
2024-12-10 20:50:14,54,548,13,41,337.10,556.00,0.00
2024-12-10 20:50:14,55,548,13,42,330.97,556.02,0.00
2024-12-10 20:50:14,54,548,13,41,336.37,556.02,0.00
2024-12-10 20:50:14,54,549,13,41,337.70,557.00,0.00
2024-12-10 20:50:14,55,549,13,42,331.56,557.02,0.00
2024-12-10 20:50:14,54,549,12,42,328.92,557.61,0.00
2024-12-10 20:50:15,54,550,12,42,337.38,558.00,0.00
2024-12-10 20:50:15,55,550,12,43,331.24,558.02,0.00
2024-12-10 20:50:15,54,550,12,42,336.45,558.02,0.00
2024-12-10 20:50:15,54,551,12,42,337.78,559.00,0.00
2024-12-10 20:50:15,55,551,13,42,331.63,559.02,0.00
2024-12-10 20:50:15,54,551,12,42,333.96,559.06,0.00
2024-12-10 20:50:15,54,552,12,42,339.63,560.00,0.00
2024-12-10 20:50:15,55,552,13,42,333.45,560.02,0.00
2024-12-10 20:50:15,54,552,13,41,338.80,560.02,0.00
2024-12-10 20:50:15,54,553,13,41,340.13,561.00,0.00
2024-12-10 20:50:15,55,553,14,41,333.95,561.02,0.00
2024-12-10 20:50:15,55,554,14,41,333.11,562.00,0.00
2024-12-10 20:50:15,56,554,15,41,327.16,562.02,0.00
2024-12-10 20:50:15,55,554,15,40,332.40,562.02,0.00
2024-12-10 20:50:15,54,554,14,40,335.15,562.67,0.00
2024-12-10 20:50:15,54,555,14,40,339.78,563.00,0.00
2024-12-10 20:50:15,55,555,15,40,333.60,563.02,0.00
2024-12-10 20:50:15,55,556,15,40,332.76,564.00,0.00
2024-12-10 20:50:15,56,556,15,41,326.82,564.02,0.00
2024-12-10 20:50:15,55,556,15,40,332.14,564.02,0.00
2024-12-10 20:50:15,55,557,15,40,333.35,565.00,0.00
2024-12-10 20:50:15,56,557,16,40,327.40,565.02,0.00
2024-12-10 20:50:15,55,557,15,40,325.18,565.55,0.00
2024-12-10 20:50:15,55,558,15,40,333.22,566.00,0.00
2024-12-10 20:50:15,56,558,16,40,327.27,566.02,0.00
2024-12-10 20:50:15,55,558,16,39,332.29,566.02,0.00
2024-12-10 20:50:15,55,559,16,39,333.50,567.00,0.00
2024-12-10 20:50:15,56,559,16,40,327.54,567.02,0.00
2024-12-10 20:50:15,56,560,16,40,326.60,568.00,0.00
2024-12-10 20:50:15,57,560,17,40,320.87,568.02,0.00
2024-12-10 20:50:15,56,560,17,39,325.39,568.04,0.00
2024-12-10 20:50:15,55,560,16,39,329.02,568.27,0.00
2024-12-10 20:50:15,55,561,16,39,335.71,569.00,0.00
2024-12-10 20:50:15,56,561,16,40,329.72,569.02,0.00
2024-12-10 20:50:15,57,560,17,40,317.36,569.95,0.00
2024-12-10 20:50:15,57,561,17,40,327.54,570.00,0.00
2024-12-10 20:50:15,58,561,18,40,321.89,570.02,0.00
2024-12-10 20:50:15,57,561,18,39,325.95,570.05,0.00
2024-12-10 20:50:15,57,562,18,39,337.13,571.00,0.00
2024-12-10 20:50:15,58,562,18,40,331.31,571.02,0.00
2024-12-10 20:50:15,58,563,18,40,330.38,572.00,0.00
2024-12-10 20:50:15,59,563,18,41,324.78,572.02,0.00
2024-12-10 20:50:15,58,563,18,40,328.91,572.05,0.00
2024-12-10 20:50:15,57,563,17,40,330.16,572.77,0.00
2024-12-10 20:50:15,57,564,17,40,339.07,573.00,0.00
2024-12-10 20:50:15,58,564,17,41,333.23,573.02,0.00
2024-12-10 20:50:15,58,565,17,41,332.25,574.00,0.00
2024-12-10 20:50:15,59,565,17,42,326.62,574.02,0.00
2024-12-10 20:50:15,58,565,17,41,330.88,574.05,0.00
2024-12-10 20:50:15,58,566,17,41,331.94,575.00,0.00
2024-12-10 20:50:15,59,566,17,42,326.31,575.02,0.00
2024-12-10 20:50:15,59,567,17,42,325.30,576.00,0.00
2024-12-10 20:50:15,60,567,18,42,319.88,576.02,0.00
2024-12-10 20:50:15,59,567,18,41,323.94,576.05,0.00
2024-12-10 20:50:15,59,568,18,41,324.62,577.00,0.00
2024-12-10 20:50:15,60,568,19,41,319.21,577.02,0.00
2024-12-10 20:50:15,59,568,18,41,319.01,577.64,0.00
2024-12-10 20:50:15,58,568,17,41,321.42,577.88,0.00
2024-12-10 20:50:15,58,569,17,41,330.79,578.00,0.00
2024-12-10 20:50:15,59,569,17,42,325.18,578.02,0.00
2024-12-10 20:50:15,58,569,17,41,329.50,578.05,0.00
2024-12-10 20:50:15,57,569,16,41,330.07,578.84,0.00
2024-12-10 20:50:15,57,570,16,41,335.39,579.00,0.00
2024-12-10 20:50:15,58,570,17,41,329.61,579.02,0.00
2024-12-10 20:50:15,57,570,16,41,326.63,579.53,0.00
2024-12-10 20:50:15,57,571,16,41,334.40,580.00,0.00
2024-12-10 20:50:15,58,571,16,42,328.63,580.02,0.00
2024-12-10 20:50:15,57,571,16,41,332.98,580.07,0.00
2024-12-10 20:50:15,57,572,16,41,332.84,581.00,0.00
2024-12-10 20:50:15,58,572,17,41,327.10,581.02,0.00
2024-12-10 20:50:15,57,572,17,40,329.50,581.16,0.00
2024-12-10 20:50:15,57,573,17,40,331.41,582.00,0.00
2024-12-10 20:50:15,58,573,18,40,325.70,582.02,0.00
2024-12-10 20:50:15,57,573,18,39,330.10,582.07,0.00
2024-12-10 20:50:15,56,573,17,39,332.67,582.68,0.00
2024-12-10 20:50:15,56,574,17,39,337.29,583.00,0.00
2024-12-10 20:50:15,57,574,18,39,331.37,583.02,0.00
2024-12-10 20:50:15,57,575,18,39,330.30,584.00,0.00
2024-12-10 20:50:15,58,575,19,39,324.60,584.02,0.00
2024-12-10 20:50:15,57,575,19,38,329.08,584.07,0.00
2024-12-10 20:50:15,56,575,18,38,334.56,584.14,0.00
2024-12-10 20:50:15,55,575,17,38,335.28,584.89,0.00
2024-12-10 20:50:15,55,576,17,38,345.34,585.00,0.00
2024-12-10 20:50:15,56,576,17,39,339.17,585.02,0.00
2024-12-10 20:50:15,55,576,16,39,343.96,585.02,0.00
2024-12-10 20:50:15,55,577,16,39,347.04,586.00,0.00
2024-12-10 20:50:15,56,577,16,40,340.85,586.02,0.00
2024-12-10 20:50:15,55,577,16,39,345.98,586.05,0.00
2024-12-10 20:50:15,54,577,15,39,349.03,586.07,0.00
2024-12-10 20:50:16,54,578,15,39,354.31,587.00,0.00
2024-12-10 20:50:16,55,578,16,39,347.87,587.02,0.00
2024-12-10 20:50:16,55,579,16,39,346.04,588.00,0.00
2024-12-10 20:50:16,56,579,17,39,339.86,588.02,0.00
2024-12-10 20:50:16,55,579,17,38,345.08,588.05,0.00
2024-12-10 20:50:16,55,580,17,38,345.45,589.00,0.00
2024-12-10 20:50:16,56,580,18,38,339.28,589.02,0.00
2024-12-10 20:50:16,56,581,18,38,337.30,590.00,0.00
2024-12-10 20:50:16,57,581,19,38,331.39,590.02,0.00
2024-12-10 20:50:16,56,581,19,37,335.73,590.05,0.00
2024-12-10 20:50:16,56,582,19,37,335.87,591.00,0.00
2024-12-10 20:50:16,57,582,20,37,329.98,591.02,0.00
2024-12-10 20:50:16,56,582,19,37,326.72,591.59,0.00
2024-12-10 20:50:16,56,583,19,37,334.05,592.00,0.00
2024-12-10 20:50:16,57,583,19,38,328.19,592.02,0.00
2024-12-10 20:50:16,56,583,19,37,332.47,592.05,0.00
2024-12-10 20:50:16,56,584,19,37,332.73,593.00,0.00
2024-12-10 20:50:16,57,584,19,38,326.89,593.02,0.00
2024-12-10 20:50:16,56,584,19,37,326.62,593.61,0.00
2024-12-10 20:50:16,56,585,19,37,331.24,594.00,0.00
2024-12-10 20:50:16,57,585,20,37,325.43,594.02,0.00
2024-12-10 20:50:16,56,585,20,36,329.76,594.05,0.00
2024-12-10 20:50:16,55,585,19,36,328.63,594.96,0.00
2024-12-10 20:50:16,55,586,19,36,339.25,595.00,0.00
2024-12-10 20:50:16,56,586,19,37,333.19,595.02,0.00
2024-12-10 20:50:16,55,586,18,37,331.32,595.49,0.00
2024-12-10 20:50:16,55,587,18,37,339.49,596.00,0.00
2024-12-10 20:50:16,56,587,19,37,333.42,596.02,0.00
2024-12-10 20:50:16,55,587,19,36,338.08,596.05,0.00
2024-12-10 20:50:16,55,588,19,36,339.51,597.00,0.00
2024-12-10 20:50:16,56,588,20,36,333.45,597.02,0.00
2024-12-10 20:50:16,55,588,19,36,331.77,597.49,0.00
2024-12-10 20:50:16,55,589,19,36,339.97,598.00,0.00
2024-12-10 20:50:16,56,589,19,37,333.90,598.02,0.00
2024-12-10 20:50:16,55,589,19,36,338.56,598.05,0.00
2024-12-10 20:50:16,55,590,19,36,340.00,599.00,0.00
2024-12-10 20:50:16,56,590,19,37,333.93,599.02,0.00
2024-12-10 20:50:16,56,591,19,37,332.90,600.00,0.00
2024-12-10 20:50:16,57,591,20,37,327.06,600.02,0.00
2024-12-10 20:50:16,56,591,20,36,331.62,600.05,0.00
2024-12-10 20:50:16,55,591,19,36,330.36,600.96,0.00
2024-12-10 20:50:16,55,592,19,36,341.09,601.00,0.00
2024-12-10 20:50:16,56,592,20,36,335.00,601.02,0.00
2024-12-10 20:50:16,55,592,19,36,330.70,601.65,0.00
2024-12-10 20:50:16,55,593,19,36,339.83,602.00,0.00
2024-12-10 20:50:16,56,593,19,37,333.76,602.02,0.00
2024-12-10 20:50:16,55,593,19,36,339.72,602.02,0.00
2024-12-10 20:50:16,54,593,19,35,344.89,602.04,0.00
2024-12-10 20:50:16,53,593,18,35,345.55,602.45,0.00
2024-12-10 20:50:16,53,594,18,35,354.04,603.00,0.00
2024-12-10 20:50:16,54,594,19,35,347.48,603.02,0.00
2024-12-10 20:50:16,53,594,18,35,346.66,603.42,0.00
2024-12-10 20:50:16,53,595,18,35,354.95,604.00,0.00
2024-12-10 20:50:16,54,595,19,35,348.38,604.02,0.00
2024-12-10 20:50:16,53,595,19,34,353.93,604.04,0.00
2024-12-10 20:50:16,53,596,19,34,354.78,605.00,0.00
2024-12-10 20:50:16,54,596,20,34,348.21,605.02,0.00
2024-12-10 20:50:16,54,597,20,34,346.48,606.00,0.00
2024-12-10 20:50:16,55,597,20,35,340.18,606.02,0.00
2024-12-10 20:50:16,54,597,20,34,345.36,606.04,0.00
2024-12-10 20:50:16,54,598,20,34,345.89,607.00,0.00
2024-12-10 20:50:16,55,598,20,35,339.60,607.02,0.00
2024-12-10 20:50:16,54,598,20,34,342.15,607.22,0.00
2024-12-10 20:50:16,53,598,19,34,343.60,607.51,0.00
2024-12-10 20:50:16,53,599,19,34,352.45,608.00,0.00
2024-12-10 20:50:16,54,599,19,35,345.92,608.02,0.00
2024-12-10 20:50:16,53,599,19,34,351.42,608.04,0.00
2024-12-10 20:50:16,53,600,19,34,353.03,609.00,0.00
2024-12-10 20:50:16,54,600,19,35,346.49,609.02,0.00
2024-12-10 20:50:16,53,600,18,35,352.91,609.02,0.00
2024-12-10 20:50:16,52,600,17,35,350.28,609.94,0.00
2024-12-10 20:50:16,52,601,17,35,361.70,610.00,0.00
2024-12-10 20:50:16,53,601,17,36,354.87,610.02,0.00
2024-12-10 20:50:16,52,601,17,35,360.64,610.02,0.00
2024-12-10 20:50:16,52,602,17,35,362.29,611.00,0.00
2024-12-10 20:50:16,53,602,18,35,355.46,611.02,0.00
2024-12-10 20:50:16,52,602,17,35,353.11,611.54,0.00
2024-12-10 20:50:16,52,603,17,35,362.41,612.00,0.00
2024-12-10 20:50:16,53,603,17,36,355.58,612.02,0.00
2024-12-10 20:50:16,52,603,17,35,361.47,612.02,0.00
2024-12-10 20:50:16,52,604,17,35,363.12,613.00,0.00
2024-12-10 20:50:16,53,604,18,35,356.27,613.02,0.00
2024-12-10 20:50:16,53,605,18,35,355.46,614.00,0.00
2024-12-10 20:50:16,54,605,19,35,348.88,614.02,0.00
2024-12-10 20:50:16,53,605,19,34,354.65,614.02,0.00
2024-12-10 20:50:16,52,605,18,34,360.58,614.17,0.00
2024-12-10 20:50:16,51,605,17,34,361.18,614.96,0.00
2024-12-10 20:50:17,51,606,17,34,373.02,615.00,0.00
2024-12-10 20:50:17,52,606,17,35,365.85,615.02,0.00
2024-12-10 20:50:17,52,607,17,35,365.14,616.00,0.00
2024-12-10 20:50:17,53,607,17,36,358.25,616.02,0.00
2024-12-10 20:50:17,52,607,17,35,364.43,616.02,0.00
2024-12-10 20:50:17,51,607,16,35,370.73,616.16,0.00
2024-12-10 20:50:17,51,608,16,35,373.35,617.00,0.00
2024-12-10 20:50:17,52,608,16,36,366.17,617.02,0.00
2024-12-10 20:50:17,51,608,15,36,363.73,617.94,0.00
2024-12-10 20:50:17,51,609,15,36,375.53,618.00,0.00
2024-12-10 20:50:17,52,609,15,37,368.30,618.02,0.00
2024-12-10 20:50:17,51,609,15,36,374.80,618.02,0.00
2024-12-10 20:50:17,51,610,15,36,376.62,619.00,0.00
2024-12-10 20:50:17,52,610,15,37,369.38,619.02,0.00
2024-12-10 20:50:17,52,611,15,37,368.66,620.00,0.00
2024-12-10 20:50:17,53,611,16,37,361.71,620.02,0.00
2024-12-10 20:50:17,52,611,16,36,368.07,620.02,0.00
2024-12-10 20:50:17,51,611,15,36,368.51,620.90,0.00
2024-12-10 20:50:17,51,612,15,36,380.15,621.00,0.00
2024-12-10 20:50:17,52,612,15,37,372.84,621.02,0.00
2024-12-10 20:50:17,52,613,15,37,372.12,622.00,0.00
2024-12-10 20:50:17,53,613,16,37,365.10,622.02,0.00
2024-12-10 20:50:17,52,613,16,36,371.64,622.02,0.00
2024-12-10 20:50:17,51,613,15,36,376.80,622.20,0.00
2024-12-10 20:50:17,51,614,15,36,384.55,623.00,0.00
2024-12-10 20:50:17,52,614,16,36,377.15,623.02,0.00
2024-12-10 20:50:17,52,615,16,36,376.44,624.00,0.00
2024-12-10 20:50:17,53,615,17,36,369.34,624.02,0.00
2024-12-10 20:50:17,52,615,17,35,376.08,624.02,0.00
2024-12-10 20:50:17,52,616,17,35,377.76,625.00,0.00
2024-12-10 20:50:17,53,616,18,35,370.64,625.02,0.00
2024-12-10 20:50:17,52,616,17,35,371.63,625.31,0.00
2024-12-10 20:50:17,52,617,17,35,379.81,626.00,0.00
2024-12-10 20:50:17,53,617,17,36,372.65,626.02,0.00
2024-12-10 20:50:17,52,617,17,35,379.45,626.02,0.00
2024-12-10 20:50:17,52,618,17,35,381.14,627.00,0.00
2024-12-10 20:50:17,53,618,17,36,373.95,627.02,0.00
2024-12-10 20:50:17,53,619,17,36,373.13,628.00,0.00
2024-12-10 20:50:17,54,619,18,36,366.22,628.02,0.00
2024-12-10 20:50:17,53,619,18,35,372.77,628.02,0.00
2024-12-10 20:50:17,52,619,17,35,375.14,628.38,0.00
2024-12-10 20:50:17,52,620,17,35,383.81,629.00,0.00
2024-12-10 20:50:17,53,620,18,35,376.57,629.02,0.00
2024-12-10 20:50:17,53,621,18,35,375.74,630.00,0.00
2024-12-10 20:50:17,54,621,18,36,368.78,630.02,0.00
2024-12-10 20:50:17,53,621,18,35,375.38,630.02,0.00
2024-12-10 20:50:17,53,622,18,35,376.93,631.00,0.00
2024-12-10 20:50:17,54,622,18,36,369.95,631.02,0.00
2024-12-10 20:50:17,54,623,18,36,369.02,632.00,0.00
2024-12-10 20:50:17,55,623,18,37,362.31,632.02,0.00
2024-12-10 20:50:17,54,623,18,36,368.43,632.02,0.00
2024-12-10 20:50:17,53,623,17,36,372.48,632.25,0.00
2024-12-10 20:50:17,53,624,17,36,380.16,633.00,0.00
2024-12-10 20:50:17,54,624,17,37,373.12,633.02,0.00
2024-12-10 20:50:17,54,625,17,37,372.18,634.00,0.00
2024-12-10 20:50:17,55,625,17,38,365.41,634.02,0.00
2024-12-10 20:50:17,54,625,17,37,371.71,634.02,0.00
2024-12-10 20:50:17,53,625,16,37,371.83,634.91,0.00
2024-12-10 20:50:17,53,626,16,37,383.28,635.00,0.00
2024-12-10 20:50:17,54,626,16,38,376.18,635.02,0.00
2024-12-10 20:50:17,54,627,16,38,375.24,636.00,0.00
2024-12-10 20:50:17,55,627,17,38,368.42,636.02,0.00
2024-12-10 20:50:17,54,627,17,37,374.89,636.02,0.00
2024-12-10 20:50:17,53,627,16,37,377.30,636.38,0.00
2024-12-10 20:50:17,53,628,16,37,385.81,637.00,0.00
2024-12-10 20:50:17,54,628,17,37,378.66,637.02,0.00
2024-12-10 20:50:17,54,629,17,37,377.72,638.00,0.00
2024-12-10 20:50:17,55,629,17,38,370.85,638.02,0.00
2024-12-10 20:50:17,54,629,17,37,376.89,638.02,0.00
2024-12-10 20:50:17,54,630,17,37,378.31,639.00,0.00
2024-12-10 20:50:17,55,630,17,38,371.43,639.02,0.00
2024-12-10 20:50:17,55,631,17,38,370.39,640.00,0.00
2024-12-10 20:50:17,56,631,17,39,363.77,640.02,0.00
2024-12-10 20:50:17,55,631,17,38,369.45,640.02,0.00
2024-12-10 20:50:17,54,631,16,38,371.69,640.72,0.00
2024-12-10 20:50:17,54,632,16,38,381.99,641.00,0.00
2024-12-10 20:50:17,55,632,17,38,375.04,641.02,0.00
2024-12-10 20:50:17,55,633,17,38,373.99,642.00,0.00
2024-12-10 20:50:17,56,633,18,38,367.32,642.02,0.00
2024-12-10 20:50:17,55,633,18,37,372.83,642.02,0.00
2024-12-10 20:50:17,55,634,18,37,374.11,643.00,0.00
2024-12-10 20:50:17,56,634,19,37,367.43,643.02,0.00
2024-12-10 20:50:17,55,634,18,37,371.10,643.13,0.00
2024-12-10 20:50:17,54,634,17,37,375.76,643.26,0.00
2024-12-10 20:50:17,54,635,17,37,383.42,644.00,0.00
2024-12-10 20:50:17,55,635,17,38,376.45,644.02,0.00
2024-12-10 20:50:17,54,635,17,37,382.35,644.02,0.00
2024-12-10 20:50:17,54,636,17,37,383.77,645.00,0.00
2024-12-10 20:50:17,55,636,17,38,376.80,645.02,0.00
2024-12-10 20:50:18,55,637,17,38,375.74,646.00,0.00
2024-12-10 20:50:18,56,637,17,39,369.03,646.02,0.00
2024-12-10 20:50:18,55,637,17,38,374.80,646.02,0.00
2024-12-10 20:50:18,54,637,16,38,377.44,646.35,0.00
2024-12-10 20:50:18,54,638,16,38,385.68,647.00,0.00
2024-12-10 20:50:18,55,638,17,38,378.67,647.02,0.00
2024-12-10 20:50:18,55,639,17,38,377.61,648.00,0.00
2024-12-10 20:50:18,56,639,18,38,370.86,648.02,0.00
2024-12-10 20:50:18,55,639,18,37,376.78,648.02,0.00
2024-12-10 20:50:18,54,639,17,37,383.19,648.11,0.00
2024-12-10 20:50:18,54,640,17,37,385.19,649.00,0.00
2024-12-10 20:50:18,55,640,18,37,378.19,649.02,0.00
2024-12-10 20:50:18,55,641,18,37,377.12,650.00,0.00
2024-12-10 20:50:18,56,641,18,38,370.38,650.02,0.00
2024-12-10 20:50:18,55,641,18,37,376.41,650.02,0.00
2024-12-10 20:50:18,54,641,17,37,382.69,650.11,0.00
2024-12-10 20:50:18,54,642,17,37,384.69,651.00,0.00
2024-12-10 20:50:18,55,642,18,37,377.70,651.02,0.00
2024-12-10 20:50:18,54,642,17,37,375.87,651.48,0.00
2024-12-10 20:50:18,54,643,17,37,384.92,652.00,0.00
2024-12-10 20:50:18,55,643,18,37,377.92,652.02,0.00
2024-12-10 20:50:18,54,643,18,36,384.08,652.02,0.00
2024-12-10 20:50:18,54,644,18,36,385.51,653.00,0.00
2024-12-10 20:50:18,55,644,19,36,378.50,653.02,0.00
2024-12-10 20:50:18,54,644,18,36,376.07,653.52,0.00
2024-12-10 20:50:18,54,645,18,36,385.38,654.00,0.00
2024-12-10 20:50:18,55,645,18,37,378.37,654.02,0.00
2024-12-10 20:50:18,54,645,18,36,384.53,654.02,0.00
2024-12-10 20:50:18,54,646,18,36,385.96,655.00,0.00
2024-12-10 20:50:18,55,646,19,36,378.95,655.02,0.00
2024-12-10 20:50:18,54,646,18,36,378.00,655.78,0.00
2024-12-10 20:50:18,54,647,18,36,388.86,656.00,0.00
2024-12-10 20:50:18,55,647,19,36,381.79,656.02,0.00
2024-12-10 20:50:18,54,647,19,35,387.65,656.02,0.00
2024-12-10 20:50:18,54,648,19,35,389.09,657.00,0.00
2024-12-10 20:50:18,55,648,20,35,382.02,657.02,0.00
2024-12-10 20:50:18,55,649,20,35,380.92,658.00,0.00
2024-12-10 20:50:18,56,649,20,36,374.12,658.02,0.00
2024-12-10 20:50:18,55,649,20,35,379.85,658.02,0.00
2024-12-10 20:50:18,55,650,20,35,380.95,659.00,0.00
2024-12-10 20:50:18,56,650,20,36,374.15,659.02,0.00
2024-12-10 20:50:18,56,651,20,36,372.40,660.00,0.00
2024-12-10 20:50:18,57,651,21,36,365.87,660.02,0.00
2024-12-10 20:50:18,56,651,21,35,370.76,660.04,0.00
2024-12-10 20:50:18,56,652,21,35,371.00,661.00,0.00
2024-12-10 20:50:18,57,652,21,36,364.49,661.02,0.00
2024-12-10 20:50:18,56,652,20,36,367.85,661.13,0.00
2024-12-10 20:50:18,55,652,19,36,369.28,661.69,0.00
2024-12-10 20:50:18,55,653,19,36,379.50,662.00,0.00
2024-12-10 20:50:18,56,653,20,36,372.72,662.02,0.00
2024-12-10 20:50:18,55,653,20,35,377.94,662.04,0.00
2024-12-10 20:50:18,55,654,20,35,377.94,663.00,0.00
2024-12-10 20:50:18,56,654,21,35,371.19,663.02,0.00
2024-12-10 20:50:18,55,654,20,35,365.49,663.65,0.00
2024-12-10 20:50:18,55,655,20,35,375.51,664.00,0.00
2024-12-10 20:50:18,56,655,20,36,368.81,664.02,0.00
2024-12-10 20:50:18,55,655,20,35,373.95,664.04,0.00
2024-12-10 20:50:18,54,655,19,35,380.41,664.11,0.00
2024-12-10 20:50:18,54,656,19,35,381.07,665.00,0.00
2024-12-10 20:50:18,55,656,19,36,374.14,665.02,0.00
2024-12-10 20:50:18,55,657,19,36,371.97,666.00,0.00
2024-12-10 20:50:18,56,657,20,36,365.33,666.02,0.00
2024-12-10 20:50:18,55,657,20,35,370.28,666.04,0.00
2024-12-10 20:50:18,54,657,20,34,373.60,666.57,0.00
2024-12-10 20:50:18,53,657,19,34,375.89,666.96,0.00
2024-12-10 20:50:18,53,658,19,34,388.24,667.00,0.00
2024-12-10 20:50:18,54,658,19,35,381.05,667.02,0.00
2024-12-10 20:50:18,54,659,19,35,380.13,668.00,0.00
2024-12-10 20:50:18,55,659,20,35,373.21,668.02,0.00
2024-12-10 20:50:18,54,659,20,34,378.52,668.04,0.00
2024-12-10 20:50:18,54,660,20,34,380.08,669.00,0.00
2024-12-10 20:50:18,55,660,20,35,373.16,669.02,0.00
2024-12-10 20:50:18,54,660,19,35,371.13,669.50,0.00
2024-12-10 20:50:18,54,661,19,35,380.52,670.00,0.00
2024-12-10 20:50:18,55,661,20,35,373.60,670.02,0.00
2024-12-10 20:50:18,54,661,20,34,378.67,670.06,0.00
2024-12-10 20:50:18,53,661,19,34,381.39,670.36,0.00
2024-12-10 20:50:18,53,662,19,34,390.18,671.00,0.00
2024-12-10 20:50:18,54,662,20,34,382.95,671.02,0.00
2024-12-10 20:50:18,54,663,20,34,382.39,672.00,0.00
2024-12-10 20:50:18,55,663,20,35,375.44,672.02,0.00
2024-12-10 20:50:18,54,663,20,34,380.28,672.06,0.00
2024-12-10 20:50:18,53,663,19,34,383.82,672.60,0.00
2024-12-10 20:50:19,53,664,19,34,394.13,673.00,0.00
2024-12-10 20:50:19,54,664,20,34,386.83,673.02,0.00
2024-12-10 20:50:19,54,665,20,34,386.20,674.00,0.00
2024-12-10 20:50:19,55,665,21,34,379.18,674.02,0.00
2024-12-10 20:50:19,54,665,21,33,384.21,674.06,0.00
2024-12-10 20:50:19,54,666,21,33,385.90,675.00,0.00
2024-12-10 20:50:19,55,666,21,34,378.88,675.02,0.00
2024-12-10 20:50:19,54,666,20,34,379.21,675.67,0.00
2024-12-10 20:50:19,54,667,20,34,385.17,676.00,0.00
2024-12-10 20:50:19,55,667,21,34,378.16,676.02,0.00
2024-12-10 20:50:19,54,667,21,33,383.29,676.06,0.00
2024-12-10 20:50:19,53,667,20,33,382.19,676.96,0.00
2024-12-10 20:50:19,53,668,20,33,394.73,677.00,0.00
2024-12-10 20:50:19,54,668,20,34,387.42,677.02,0.00
2024-12-10 20:50:19,54,669,20,34,386.62,678.00,0.00
2024-12-10 20:50:19,55,669,20,35,379.59,678.02,0.00
2024-12-10 20:50:19,54,669,20,34,384.86,678.06,0.00
2024-12-10 20:50:19,54,670,20,34,386.56,679.00,0.00
2024-12-10 20:50:19,55,670,21,34,379.53,679.02,0.00
2024-12-10 20:50:19,55,671,21,34,378.68,680.00,0.00
2024-12-10 20:50:19,56,671,22,34,371.92,680.02,0.00
2024-12-10 20:50:19,55,671,22,33,377.08,680.05,0.00
2024-12-10 20:50:19,55,672,22,33,378.62,681.00,0.00
2024-12-10 20:50:19,56,672,22,34,371.86,681.02,0.00
2024-12-10 20:50:19,56,673,22,34,371.01,682.00,0.00
2024-12-10 20:50:19,57,673,23,34,364.51,682.02,0.00
2024-12-10 20:50:19,56,673,23,33,369.44,682.05,0.00
2024-12-10 20:50:19,56,674,23,33,370.83,683.00,0.00
2024-12-10 20:50:19,57,674,23,34,364.32,683.02,0.00
2024-12-10 20:50:19,56,674,22,34,367.45,683.16,0.00
2024-12-10 20:50:19,56,675,22,34,370.21,684.00,0.00
2024-12-10 20:50:19,57,675,22,35,363.72,684.02,0.00
2024-12-10 20:50:19,56,675,22,34,368.51,684.05,0.00
2024-12-10 20:50:19,55,675,21,34,368.37,684.47,0.00
2024-12-10 20:50:19,55,676,21,34,377.55,685.00,0.00
2024-12-10 20:50:19,56,676,22,34,370.81,685.02,0.00
2024-12-10 20:50:19,55,676,21,34,368.49,685.82,0.00
2024-12-10 20:50:19,55,677,21,34,379.85,686.00,0.00
2024-12-10 20:50:19,56,677,22,34,373.06,686.02,0.00
2024-12-10 20:50:19,55,677,22,33,378.23,686.05,0.00
2024-12-10 20:50:19,55,678,22,33,379.78,687.00,0.00
2024-12-10 20:50:19,56,678,22,34,372.99,687.02,0.00
2024-12-10 20:50:19,55,678,21,34,372.96,687.67,0.00
2024-12-10 20:50:19,55,679,21,34,378.90,688.00,0.00
2024-12-10 20:50:19,56,679,22,34,372.14,688.02,0.00
2024-12-10 20:50:19,55,679,21,34,378.78,688.02,0.00
2024-12-10 20:50:19,54,679,21,33,384.39,688.04,0.00
2024-12-10 20:50:19,53,679,20,33,383.03,688.96,0.00
2024-12-10 20:50:19,53,680,20,33,395.79,689.00,0.00
2024-12-10 20:50:19,54,680,21,33,388.46,689.02,0.00
2024-12-10 20:50:19,54,681,21,33,387.36,690.00,0.00
2024-12-10 20:50:19,55,681,22,33,380.31,690.02,0.00
2024-12-10 20:50:19,54,681,22,32,386.08,690.04,0.00
2024-12-10 20:50:19,54,682,22,32,387.30,691.00,0.00
2024-12-10 20:50:19,55,682,23,32,380.26,691.02,0.00
2024-12-10 20:50:19,54,682,22,32,378.45,691.41,0.00
2024-12-10 20:50:19,54,683,22,32,387.57,692.00,0.00
2024-12-10 20:50:19,55,683,23,32,380.52,692.02,0.00
2024-12-10 20:50:19,54,683,23,31,386.41,692.04,0.00
2024-12-10 20:50:19,54,684,23,31,387.35,693.00,0.00
2024-12-10 20:50:19,55,684,24,31,380.30,693.02,0.00
2024-12-10 20:50:19,54,684,23,31,380.42,693.06,0.00
2024-12-10 20:50:19,54,685,23,31,386.40,694.00,0.00
2024-12-10 20:50:19,55,685,23,32,379.37,694.02,0.00
2024-12-10 20:50:19,54,685,23,31,385.24,694.04,0.00
2024-12-10 20:50:19,55,684,24,31,376.37,694.22,0.00
2024-12-10 20:50:19,55,685,24,31,391.14,695.00,0.00
2024-12-10 20:50:19,56,685,25,31,384.15,695.02,0.00
2024-12-10 20:50:19,56,686,25,31,394.67,696.00,0.00
2024-12-10 20:50:19,57,686,25,32,387.75,696.02,0.00
2024-12-10 20:50:19,56,686,25,31,393.18,696.04,0.00
2024-12-10 20:50:19,55,686,25,30,398.97,696.15,0.00
2024-12-10 20:50:19,54,686,24,30,398.56,696.94,0.00
2024-12-10 20:50:19,54,687,24,30,411.12,697.00,0.00
2024-12-10 20:50:19,55,687,24,31,403.64,697.02,0.00
2024-12-10 20:50:19,54,687,23,31,405.53,697.26,0.00
2024-12-10 20:50:19,54,688,23,31,413.77,698.00,0.00
2024-12-10 20:50:19,55,688,23,32,406.25,698.02,0.00
2024-12-10 20:50:19,54,688,23,31,412.35,698.04,0.00
2024-12-10 20:50:19,53,688,22,31,415.43,698.32,0.00
2024-12-10 20:50:19,53,689,22,31,424.34,699.00,0.00
2024-12-10 20:50:19,54,689,23,31,416.48,699.02,0.00
2024-12-10 20:50:19,54,690,23,31,415.40,700.00,0.00
2024-12-10 20:50:19,55,690,23,32,407.85,700.02,0.00
2024-12-10 20:50:19,54,690,22,32,415.27,700.02,0.00
2024-12-10 20:50:19,53,690,22,31,421.66,700.02,0.00
2024-12-10 20:50:19,52,690,21,31,426.07,700.58,0.00
2024-12-10 20:50:19,51,690,20,31,434.17,700.63,0.00
2024-12-10 20:50:19,51,691,20,31,440.10,701.00,0.00
2024-12-10 20:50:19,52,691,20,32,431.64,701.02,0.00
2024-12-10 20:50:19,52,692,20,32,430.77,702.00,0.00
2024-12-10 20:50:19,53,692,21,32,422.64,702.02,0.00
2024-12-10 20:50:19,52,692,21,31,429.42,702.02,0.00
2024-12-10 20:50:20,52,693,21,31,431.25,703.00,0.00
2024-12-10 20:50:20,53,693,21,32,423.11,703.02,0.00
2024-12-10 20:50:20,53,694,21,32,421.99,704.00,0.00
2024-12-10 20:50:20,54,694,21,33,414.18,704.02,0.00
2024-12-10 20:50:20,53,694,21,32,420.80,704.02,0.00
2024-12-10 20:50:20,53,695,21,32,421.83,705.00,0.00
2024-12-10 20:50:20,54,695,21,33,414.01,705.02,0.00
2024-12-10 20:50:20,53,695,20,33,416.69,705.25,0.00
2024-12-10 20:50:20,53,696,20,33,419.86,706.00,0.00
2024-12-10 20:50:20,54,696,21,33,412.08,706.02,0.00
2024-12-10 20:50:20,53,696,21,32,418.79,706.02,0.00
2024-12-10 20:50:20,53,697,21,32,420.45,707.00,0.00
2024-12-10 20:50:20,54,697,22,32,412.67,707.02,0.00
2024-12-10 20:50:20,54,698,22,32,411.54,708.00,0.00
2024-12-10 20:50:20,55,698,23,32,404.06,708.02,0.00
2024-12-10 20:50:20,54,698,23,31,410.63,708.02,0.00
2024-12-10 20:50:20,54,699,23,31,412.12,709.00,0.00
2024-12-10 20:50:20,55,699,24,31,404.63,709.02,0.00
2024-12-10 20:50:20,54,699,23,31,403.50,709.13,0.00
2024-12-10 20:50:20,54,700,23,31,410.99,710.00,0.00
2024-12-10 20:50:20,55,700,23,32,403.52,710.02,0.00
2024-12-10 20:50:20,54,700,23,31,409.64,710.04,0.00
2024-12-10 20:50:20,54,701,23,31,411.26,711.00,0.00
2024-12-10 20:50:20,55,701,24,31,403.78,711.02,0.00
2024-12-10 20:50:20,55,702,24,31,402.57,712.00,0.00
2024-12-10 20:50:20,56,702,24,32,395.38,712.02,0.00
2024-12-10 20:50:20,55,702,24,31,401.29,712.04,0.00
2024-12-10 20:50:20,54,702,23,31,404.55,712.65,0.00
2024-12-10 20:50:20,54,703,23,31,410.20,713.00,0.00
2024-12-10 20:50:20,55,703,24,31,402.75,713.02,0.00
2024-12-10 20:50:20,56,702,24,32,389.34,713.61,0.00
2024-12-10 20:50:20,56,703,24,32,402.64,714.00,0.00
2024-12-10 20:50:20,57,703,24,33,395.58,714.02,0.00
2024-12-10 20:50:20,56,703,24,32,401.13,714.04,0.00
2024-12-10 20:50:20,55,703,23,32,408.05,714.09,0.00
2024-12-10 20:50:20,55,704,23,32,422.89,715.00,0.00
2024-12-10 20:50:20,56,704,24,32,415.34,715.02,0.00
2024-12-10 20:50:20,55,704,23,32,416.37,715.29,0.00
2024-12-10 20:50:20,55,705,23,32,424.78,716.00,0.00
2024-12-10 20:50:20,56,705,24,32,417.20,716.02,0.00
2024-12-10 20:50:20,55,705,24,31,423.36,716.04,0.00
2024-12-10 20:50:20,55,706,24,31,424.85,717.00,0.00
2024-12-10 20:50:20,56,706,24,32,417.27,717.02,0.00
2024-12-10 20:50:20,56,707,24,32,415.93,718.00,0.00
2024-12-10 20:50:20,57,707,25,32,408.63,718.02,0.00
2024-12-10 20:50:20,56,707,25,31,414.66,718.04,0.00
2024-12-10 20:50:20,56,708,25,31,415.99,719.00,0.00
2024-12-10 20:50:20,57,708,26,31,408.69,719.02,0.00
2024-12-10 20:50:20,56,708,25,31,409.14,719.64,0.00
2024-12-10 20:50:20,56,709,25,31,419.66,720.00,0.00
2024-12-10 20:50:20,57,709,26,31,412.29,720.02,0.00
2024-12-10 20:50:20,56,709,26,30,418.13,720.04,0.00
2024-12-10 20:50:20,56,710,26,30,418.86,721.00,0.00
2024-12-10 20:50:20,57,710,26,31,411.51,721.02,0.00
2024-12-10 20:50:20,56,710,25,31,415.80,721.09,0.00
2024-12-10 20:50:20,55,710,24,31,415.96,721.53,0.00
2024-12-10 20:50:20,55,711,24,31,424.87,722.00,0.00
2024-12-10 20:50:20,56,711,25,31,417.29,722.02,0.00
2024-12-10 20:50:20,55,711,25,30,423.05,722.04,0.00
2024-12-10 20:50:20,54,711,24,30,421.45,722.63,0.00
2024-12-10 20:50:20,54,712,24,30,430.82,723.00,0.00
2024-12-10 20:50:20,55,712,24,31,422.98,723.02,0.00
2024-12-10 20:50:20,55,713,24,31,420.67,724.00,0.00
2024-12-10 20:50:20,56,713,25,31,413.16,724.02,0.00
2024-12-10 20:50:20,55,713,25,30,418.58,724.04,0.00
2024-12-10 20:50:20,55,714,25,30,418.93,725.00,0.00
2024-12-10 20:50:20,56,714,26,30,411.45,725.02,0.00
2024-12-10 20:50:20,55,714,25,30,411.00,725.75,0.00
2024-12-10 20:50:20,55,715,25,30,417.66,726.00,0.00
2024-12-10 20:50:20,56,715,26,30,410.20,726.02,0.00
2024-12-10 20:50:20,55,715,26,29,415.69,726.04,0.00
2024-12-10 20:50:20,54,715,25,29,417.04,726.76,0.00
2024-12-10 20:50:20,54,716,25,29,428.93,727.00,0.00
2024-12-10 20:50:20,55,716,25,30,421.13,727.02,0.00
2024-12-10 20:50:20,54,716,24,30,421.14,727.06,0.00
2024-12-10 20:50:20,54,717,24,30,428.31,728.00,0.00
2024-12-10 20:50:20,55,717,25,30,420.52,728.02,0.00
2024-12-10 20:50:20,54,717,25,29,426.30,728.04,0.00
2024-12-10 20:50:20,53,717,24,29,430.37,728.62,0.00
2024-12-10 20:50:20,52,717,23,29,438.37,728.65,0.00
2024-12-10 20:50:20,52,718,23,29,444.52,729.00,0.00
2024-12-10 20:50:20,53,718,23,30,436.13,729.02,0.00
2024-12-10 20:50:20,52,718,22,30,435.57,729.10,0.00
2024-12-10 20:50:20,52,719,22,30,443.58,730.00,0.00
2024-12-10 20:50:20,53,719,23,30,435.21,730.02,0.00
2024-12-10 20:50:20,52,719,23,29,441.35,730.04,0.00
2024-12-10 20:50:20,52,720,23,29,443.35,731.00,0.00
2024-12-10 20:50:20,53,720,23,30,434.98,731.02,0.00
2024-12-10 20:50:20,53,721,23,30,433.92,732.00,0.00
2024-12-10 20:50:20,54,721,24,30,425.88,732.02,0.00
2024-12-10 20:50:20,53,721,24,29,431.86,732.04,0.00
2024-12-10 20:50:21,53,722,24,29,433.68,733.00,0.00
2024-12-10 20:50:21,54,722,25,29,425.65,733.02,0.00
2024-12-10 20:50:21,53,722,24,29,422.07,733.96,0.00
2024-12-10 20:50:21,53,723,24,29,435.66,734.00,0.00
2024-12-10 20:50:21,54,723,25,29,427.59,734.02,0.00
2024-12-10 20:50:21,53,723,25,28,433.59,734.04,0.00
2024-12-10 20:50:21,53,724,25,28,435.42,735.00,0.00
2024-12-10 20:50:21,54,724,26,28,427.36,735.02,0.00
2024-12-10 20:50:21,53,724,25,28,424.04,735.57,0.00
2024-12-10 20:50:21,53,725,25,28,435.04,736.00,0.00
2024-12-10 20:50:21,54,725,25,29,426.98,736.02,0.00
2024-12-10 20:50:21,53,725,25,28,432.97,736.04,0.00
2024-12-10 20:50:21,53,726,25,28,434.80,737.00,0.00
2024-12-10 20:50:21,54,726,26,28,426.75,737.02,0.00
2024-12-10 20:50:21,54,727,26,28,425.77,738.00,0.00
2024-12-10 20:50:21,55,727,27,28,418.03,738.02,0.00
2024-12-10 20:50:21,54,727,27,27,423.47,738.06,0.00
2024-12-10 20:50:21,53,727,26,27,429.87,738.15,0.00
2024-12-10 20:50:21,53,728,26,27,438.07,739.00,0.00
2024-12-10 20:50:21,54,728,27,27,429.96,739.02,0.00
2024-12-10 20:50:21,53,728,26,27,432.31,739.23,0.00
2024-12-10 20:50:21,53,729,26,27,441.05,740.00,0.00
2024-12-10 20:50:21,54,729,27,27,432.88,740.02,0.00
2024-12-10 20:50:21,53,729,27,26,438.55,740.06,0.00
2024-12-10 20:50:21,53,730,27,26,440.53,741.00,0.00
2024-12-10 20:50:21,54,730,28,26,432.37,741.02,0.00
2024-12-10 20:50:21,54,731,28,26,431.54,742.00,0.00
2024-12-10 20:50:21,55,731,29,26,423.69,742.02,0.00
2024-12-10 20:50:21,54,731,29,25,429.08,742.06,0.00
2024-12-10 20:50:21,54,732,29,25,430.88,743.00,0.00
2024-12-10 20:50:21,55,732,29,26,423.05,743.02,0.00
2024-12-10 20:50:21,55,733,29,26,422.19,744.00,0.00
2024-12-10 20:50:21,56,733,30,26,414.65,744.02,0.00
2024-12-10 20:50:21,55,733,30,25,419.90,744.05,0.00
2024-12-10 20:50:21,55,734,30,25,421.54,745.00,0.00
2024-12-10 20:50:21,56,734,31,25,414.01,745.02,0.00
2024-12-10 20:50:21,56,735,31,25,413.24,746.00,0.00
2024-12-10 20:50:21,57,735,31,26,405.99,746.02,0.00
2024-12-10 20:50:21,56,735,31,25,410.73,746.07,0.00
2024-12-10 20:50:21,56,736,31,25,412.32,747.00,0.00
2024-12-10 20:50:21,57,736,31,26,405.09,747.02,0.00
2024-12-10 20:50:21,57,737,31,26,404.38,748.00,0.00
2024-12-10 20:50:21,58,737,32,26,397.41,748.02,0.00
2024-12-10 20:50:21,57,737,32,25,401.90,748.07,0.00
2024-12-10 20:50:21,56,737,31,25,400.39,748.91,0.00
2024-12-10 20:50:21,56,738,31,25,413.16,749.00,0.00
2024-12-10 20:50:21,57,738,32,25,405.91,749.02,0.00
2024-12-10 20:50:21,57,739,32,25,405.18,750.00,0.00
2024-12-10 20:50:21,58,739,33,25,398.19,750.02,0.00
2024-12-10 20:50:21,57,739,33,24,402.82,750.07,0.00
2024-12-10 20:50:21,57,740,33,24,404.27,751.00,0.00
2024-12-10 20:50:21,58,740,33,25,397.30,751.02,0.00
2024-12-10 20:50:21,58,741,33,25,396.64,752.00,0.00
2024-12-10 20:50:21,59,741,33,26,389.92,752.02,0.00
2024-12-10 20:50:21,58,741,33,25,394.07,752.09,0.00
2024-12-10 20:50:21,57,741,32,25,400.73,752.12,0.00
2024-12-10 20:50:21,57,742,32,25,402.55,753.00,0.00
2024-12-10 20:50:21,58,742,33,25,395.61,753.02,0.00
2024-12-10 20:50:21,58,743,33,25,395.53,754.00,0.00
2024-12-10 20:50:21,59,743,33,26,388.82,754.02,0.00
2024-12-10 20:50:21,58,743,33,25,392.05,754.12,0.00
2024-12-10 20:50:21,58,744,33,25,393.71,755.00,0.00
2024-12-10 20:50:21,59,744,33,26,387.04,755.02,0.00
2024-12-10 20:50:21,60,743,34,26,380.59,755.05,0.00
2024-12-10 20:50:21,59,743,33,26,392.61,755.05,0.00
2024-12-10 20:50:21,58,743,32,26,398.75,755.12,0.00
2024-12-10 20:50:21,58,744,32,26,403.02,756.00,0.00
2024-12-10 20:50:21,59,744,33,26,396.19,756.02,0.00
2024-12-10 20:50:21,58,744,33,25,399.67,756.10,0.00
2024-12-10 20:50:21,58,745,33,25,414.26,757.00,0.00
2024-12-10 20:50:21,59,745,33,26,407.23,757.02,0.00
2024-12-10 20:50:21,58,745,32,26,406.81,757.33,0.00
2024-12-10 20:50:21,58,746,32,26,415.20,758.00,0.00
2024-12-10 20:50:21,59,746,33,26,408.16,758.02,0.00
2024-12-10 20:50:21,58,746,32,26,414.60,758.09,0.00
2024-12-10 20:50:21,57,746,32,25,419.21,758.09,0.00
2024-12-10 20:50:21,56,746,31,25,422.86,758.29,0.00
2024-12-10 20:50:21,56,747,31,25,431.42,759.00,0.00
2024-12-10 20:50:21,57,747,32,25,423.85,759.02,0.00
2024-12-10 20:50:21,57,748,32,25,423.49,760.00,0.00
2024-12-10 20:50:21,58,748,33,25,416.19,760.02,0.00
2024-12-10 20:50:21,57,748,33,24,420.46,760.09,0.00
2024-12-10 20:50:21,57,749,33,24,422.05,761.00,0.00
2024-12-10 20:50:21,58,749,33,25,414.77,761.02,0.00
2024-12-10 20:50:21,57,749,32,25,419.26,761.04,0.00
2024-12-10 20:50:21,57,750,32,25,423.14,762.00,0.00
2024-12-10 20:50:21,58,750,32,26,415.84,762.02,0.00
2024-12-10 20:50:21,57,750,32,25,420.23,762.07,0.00
2024-12-10 20:50:21,57,751,32,25,421.69,763.00,0.00
2024-12-10 20:50:22,58,751,33,25,414.42,763.02,0.00
2024-12-10 20:50:22,57,751,32,25,410.57,763.61,0.00
2024-12-10 20:50:22,57,752,32,25,421.30,764.00,0.00
2024-12-10 20:50:22,58,752,32,26,414.04,764.02,0.00
2024-12-10 20:50:22,57,752,32,25,418.51,764.07,0.00
2024-12-10 20:50:22,57,753,32,25,419.97,765.00,0.00
2024-12-10 20:50:22,58,753,32,26,412.73,765.02,0.00
2024-12-10 20:50:22,58,754,32,26,412.32,766.00,0.00
2024-12-10 20:50:22,59,754,32,27,405.33,766.02,0.00
2024-12-10 20:50:22,58,754,32,26,409.57,766.07,0.00
2024-12-10 20:50:22,57,754,31,26,406.66,766.96,0.00
2024-12-10 20:50:22,57,755,31,26,419.86,767.00,0.00
2024-12-10 20:50:22,58,755,32,26,412.62,767.02,0.00
2024-12-10 20:50:22,58,756,32,26,412.17,768.00,0.00
2024-12-10 20:50:22,59,756,33,26,405.19,768.02,0.00
2024-12-10 20:50:22,58,756,33,25,409.55,768.07,0.00
2024-12-10 20:50:22,57,756,32,25,416.61,768.09,0.00
2024-12-10 20:50:22,56,756,31,25,420.74,768.54,0.00
2024-12-10 20:50:22,56,757,31,25,425.74,769.00,0.00
2024-12-10 20:50:22,57,757,31,26,418.27,769.02,0.00
2024-12-10 20:50:22,56,757,30,26,416.03,769.46,0.00
2024-12-10 20:50:22,55,757,29,26,422.16,769.65,0.00
2024-12-10 20:50:22,55,758,29,26,433.76,770.00,0.00
2024-12-10 20:50:22,56,758,30,26,426.02,770.02,0.00
2024-12-10 20:50:22,55,758,30,25,431.13,770.07,0.00
2024-12-10 20:50:22,55,759,30,25,432.92,771.00,0.00
2024-12-10 20:50:22,56,759,31,25,425.19,771.02,0.00
2024-12-10 20:50:22,56,760,31,25,425.06,772.00,0.00
2024-12-10 20:50:22,57,760,31,26,417.60,772.02,0.00
2024-12-10 20:50:22,56,760,31,25,422.05,772.07,0.00
2024-12-10 20:50:22,56,761,31,25,423.68,773.00,0.00
2024-12-10 20:50:22,57,761,32,25,416.24,773.02,0.00
2024-12-10 20:50:22,56,761,31,25,417.77,773.21,0.00
2024-12-10 20:50:22,55,761,30,25,422.05,773.65,0.00
2024-12-10 20:50:22,55,762,30,25,433.73,774.00,0.00
2024-12-10 20:50:22,56,762,30,26,425.98,774.02,0.00
2024-12-10 20:50:22,55,762,30,25,430.65,774.07,0.00
2024-12-10 20:50:22,55,763,30,25,432.45,775.00,0.00
2024-12-10 20:50:22,56,763,30,26,424.73,775.02,0.00
2024-12-10 20:50:22,56,764,30,26,424.50,776.00,0.00
2024-12-10 20:50:22,57,764,31,26,417.06,776.02,0.00
2024-12-10 20:50:22,56,764,30,26,422.85,776.04,0.00
2024-12-10 20:50:22,55,764,30,25,427.86,776.05,0.00
2024-12-10 20:50:22,55,765,30,25,435.18,777.00,0.00
2024-12-10 20:50:22,56,765,31,25,427.41,777.02,0.00
2024-12-10 20:50:22,56,766,31,25,427.12,778.00,0.00
2024-12-10 20:50:22,57,766,31,26,419.63,778.02,0.00
2024-12-10 20:50:22,56,766,31,25,424.49,778.05,0.00
2024-12-10 20:50:22,56,767,31,25,426.00,779.00,0.00
2024-12-10 20:50:22,57,767,31,26,418.52,779.02,0.00
2024-12-10 20:50:22,56,767,30,26,422.27,779.11,0.00
2024-12-10 20:50:22,56,768,30,26,429.75,780.00,0.00
2024-12-10 20:50:22,57,768,31,26,422.21,780.02,0.00
2024-12-10 20:50:22,56,768,31,25,426.98,780.05,0.00
2024-12-10 20:50:22,55,768,30,25,434.61,780.07,0.00
2024-12-10 20:50:22,54,768,29,25,436.85,780.31,0.00
2024-12-10 20:50:22,53,768,28,25,443.90,780.47,0.00
2024-12-10 20:50:22,53,769,28,25,454.91,781.00,0.00
2024-12-10 20:50:22,54,769,28,26,446.49,781.02,0.00
2024-12-10 20:50:22,54,770,28,26,446.47,782.00,0.00
2024-12-10 20:50:22,55,770,28,27,438.35,782.02,0.00
2024-12-10 20:50:22,54,770,28,26,443.16,782.07,0.00
2024-12-10 20:50:22,53,770,27,26,446.61,782.60,0.00
2024-12-10 20:50:22,53,771,27,26,458.59,783.00,0.00
2024-12-10 20:50:22,54,771,27,27,450.09,783.02,0.00
2024-12-10 20:50:22,53,771,26,27,458.39,783.04,0.00
2024-12-10 20:50:22,52,771,25,27,461.75,783.08,0.00
2024-12-10 20:50:22,52,772,25,27,470.15,784.00,0.00
2024-12-10 20:50:22,53,772,26,27,461.28,784.02,0.00
2024-12-10 20:50:22,52,772,26,26,466.86,784.06,0.00
2024-12-10 20:50:22,51,772,25,26,470.68,784.25,0.00
2024-12-10 20:50:22,51,773,25,26,480.75,785.00,0.00
2024-12-10 20:50:22,52,773,25,27,471.50,785.02,0.00
2024-12-10 20:50:22,52,774,25,27,471.70,786.00,0.00
2024-12-10 20:50:22,53,774,26,27,462.80,786.02,0.00
2024-12-10 20:50:22,52,774,25,27,460.23,786.71,0.00
2024-12-10 20:50:22,52,775,25,27,473.32,787.00,0.00
2024-12-10 20:50:22,53,775,25,28,464.39,787.02,0.00
2024-12-10 20:50:22,52,775,24,28,472.89,787.08,0.00
2024-12-10 20:50:22,51,775,24,27,482.00,787.08,0.00
2024-12-10 20:50:22,51,776,24,27,484.60,788.00,0.00
2024-12-10 20:50:22,52,776,25,27,475.28,788.02,0.00
2024-12-10 20:50:22,52,777,25,27,475.32,789.00,0.00
2024-12-10 20:50:22,53,777,25,28,466.35,789.02,0.00
2024-12-10 20:50:22,52,777,24,28,474.88,789.08,0.00
2024-12-10 20:50:22,51,777,24,27,480.94,789.08,0.00
2024-12-10 20:50:22,51,778,24,27,483.55,790.00,0.00
2024-12-10 20:50:22,52,778,25,27,474.25,790.02,0.00
2024-12-10 20:50:22,52,779,25,27,474.28,791.00,0.00
2024-12-10 20:50:22,53,779,26,27,465.34,791.02,0.00
2024-12-10 20:50:22,52,779,26,26,470.65,791.08,0.00
2024-12-10 20:50:22,52,780,26,26,472.62,792.00,0.00
2024-12-10 20:50:22,53,780,26,27,463.71,792.02,0.00
2024-12-10 20:50:22,52,780,25,27,471.73,792.10,0.00
2024-12-10 20:50:22,52,781,25,27,476.34,793.00,0.00
2024-12-10 20:50:22,53,781,26,27,467.35,793.02,0.00
2024-12-10 20:50:22,53,782,26,27,464.87,794.00,0.00
2024-12-10 20:50:22,54,782,26,28,456.26,794.02,0.00
2024-12-10 20:50:22,53,782,25,28,464.14,794.09,0.00
2024-12-10 20:50:22,52,782,25,27,472.61,794.10,0.00
2024-12-10 20:50:22,51,782,24,27,471.58,794.94,0.00
2024-12-10 20:50:22,51,783,24,27,486.74,795.00,0.00
2024-12-10 20:50:22,52,783,24,28,477.38,795.02,0.00
2024-12-10 20:50:23,51,783,23,28,486.43,795.06,0.00
2024-12-10 20:50:23,51,784,23,28,485.71,796.00,0.00
2024-12-10 20:50:23,52,784,23,29,476.37,796.02,0.00
2024-12-10 20:50:23,52,785,23,29,472.89,797.00,0.00
2024-12-10 20:50:23,53,785,23,30,463.97,797.02,0.00
2024-12-10 20:50:23,52,785,23,29,471.22,797.10,0.00
2024-12-10 20:50:23,51,785,22,29,471.76,797.63,0.00
2024-12-10 20:50:23,51,786,22,29,484.72,798.00,0.00
2024-12-10 20:50:23,52,786,22,30,475.40,798.02,0.00
2024-12-10 20:50:23,51,786,21,30,474.48,798.29,0.00
2024-12-10 20:50:23,51,787,21,30,483.60,799.00,0.00
2024-12-10 20:50:23,52,787,21,31,474.30,799.02,0.00
2024-12-10 20:50:23,52,788,21,31,471.99,800.00,0.00
2024-12-10 20:50:23,53,788,22,31,463.08,800.02,0.00
2024-12-10 20:50:23,52,788,21,31,471.66,800.06,0.00
2024-12-10 20:50:23,51,788,21,30,479.34,800.12,0.00
2024-12-10 20:50:23,50,788,20,30,480.96,800.42,0.00
2024-12-10 20:50:23,50,789,20,30,492.76,801.00,0.00
2024-12-10 20:50:23,51,789,21,30,483.10,801.02,0.00
2024-12-10 20:50:23,50,789,20,30,492.29,801.06,0.00
2024-12-10 20:50:23,50,790,20,30,491.83,802.00,0.00
2024-12-10 20:50:23,51,790,21,30,482.19,802.02,0.00
2024-12-10 20:50:23,50,790,20,30,485.90,802.28,0.00
2024-12-10 20:50:23,50,791,20,30,490.09,803.00,0.00
2024-12-10 20:50:23,51,791,21,30,480.48,803.02,0.00
2024-12-10 20:50:23,50,791,21,29,488.66,803.10,0.00
2024-12-10 20:50:23,50,792,21,29,491.18,804.00,0.00
2024-12-10 20:50:23,51,792,21,30,481.55,804.02,0.00
2024-12-10 20:50:23,51,793,21,30,481.60,805.00,0.00
2024-12-10 20:50:23,52,793,22,30,472.34,805.02,0.00
2024-12-10 20:50:23,51,793,21,30,472.75,805.24,0.00
2024-12-10 20:50:23,51,794,21,30,482.06,806.00,0.00
2024-12-10 20:50:23,52,794,21,31,472.79,806.02,0.00
2024-12-10 20:50:23,51,794,20,31,481.59,806.08,0.00
2024-12-10 20:50:23,50,794,20,30,490.10,806.10,0.00
2024-12-10 20:50:23,50,795,20,30,492.23,807.00,0.00
2024-12-10 20:50:23,51,795,20,31,482.58,807.02,0.00
2024-12-10 20:50:23,51,796,20,31,482.14,808.00,0.00
2024-12-10 20:50:23,52,796,21,31,472.87,808.02,0.00
2024-12-10 20:50:23,52,797,21,31,470.76,809.00,0.00
2024-12-10 20:50:23,53,797,22,31,461.88,809.02,0.00
2024-12-10 20:50:23,52,797,22,30,469.53,809.10,0.00
2024-12-10 20:50:23,52,798,22,30,471.05,810.00,0.00
2024-12-10 20:50:23,53,798,22,31,462.16,810.02,0.00
2024-12-10 20:50:23,53,799,22,31,461.65,811.00,0.00
2024-12-10 20:50:23,54,799,23,31,453.10,811.02,0.00
2024-12-10 20:50:23,53,799,22,31,461.31,811.06,0.00
2024-12-10 20:50:23,53,800,22,31,459.38,812.00,0.00
2024-12-10 20:50:23,54,800,22,32,450.87,812.02,0.00
2024-12-10 20:50:23,53,800,22,31,458.47,812.08,0.00
2024-12-10 20:50:23,53,801,22,31,459.75,813.00,0.00
2024-12-10 20:50:23,54,801,23,31,451.24,813.02,0.00
2024-12-10 20:50:23,53,801,22,31,451.27,813.30,0.00
2024-12-10 20:50:23,53,802,22,31,460.43,814.00,0.00
2024-12-10 20:50:23,54,802,23,31,451.90,814.02,0.00
2024-12-10 20:50:23,53,802,23,30,453.63,814.43,0.00
2024-12-10 20:50:23,52,802,22,30,461.86,814.50,0.00
2024-12-10 20:50:23,52,803,22,30,467.55,815.00,0.00
2024-12-10 20:50:23,53,803,22,31,458.73,815.02,0.00
2024-12-10 20:50:23,52,803,22,30,466.93,815.08,0.00
2024-12-10 20:50:23,52,804,22,30,469.38,816.00,0.00
2024-12-10 20:50:23,53,804,23,30,460.52,816.02,0.00
2024-12-10 20:50:23,52,804,22,30,468.76,816.04,0.00
2024-12-10 20:50:23,51,804,21,30,471.63,816.43,0.00
2024-12-10 20:50:23,51,805,21,30,483.40,817.00,0.00
2024-12-10 20:50:23,52,805,21,31,474.10,817.02,0.00
2024-12-10 20:50:23,51,805,21,30,479.57,817.08,0.00
2024-12-10 20:50:23,52,804,22,30,468.12,817.40,0.00
2024-12-10 20:50:23,52,805,22,30,478.61,818.00,0.00
2024-12-10 20:50:23,53,805,22,31,469.58,818.02,0.00
2024-12-10 20:50:23,52,805,21,31,467.08,818.75,0.00
2024-12-10 20:50:23,52,806,21,31,496.69,819.00,0.00
2024-12-10 20:50:23,53,806,21,32,487.32,819.02,0.00
2024-12-10 20:50:23,52,806,20,32,489.98,819.21,0.00
2024-12-10 20:50:23,52,807,20,32,499.82,820.00,0.00
2024-12-10 20:50:23,53,807,21,32,490.39,820.02,0.00
2024-12-10 20:50:23,52,807,21,31,499.04,820.08,0.00
2024-12-10 20:50:23,51,807,20,31,504.57,820.25,0.00
2024-12-10 20:50:23,51,808,20,31,515.07,821.00,0.00
2024-12-10 20:50:23,52,808,21,31,505.16,821.02,0.00
2024-12-10 20:50:23,51,808,20,31,514.80,821.04,0.00
2024-12-10 20:50:23,50,808,19,31,517.22,821.62,0.00
2024-12-10 20:50:23,50,809,19,31,525.23,822.00,0.00
2024-12-10 20:50:23,51,809,20,31,514.93,822.02,0.00
2024-12-10 20:50:23,52,808,20,32,505.03,822.06,0.00
2024-12-10 20:50:23,51,808,20,31,522.05,822.08,0.00
2024-12-10 20:50:23,51,809,20,31,524.76,823.00,0.00
2024-12-10 20:50:23,52,809,21,31,514.67,823.02,0.00
2024-12-10 20:50:23,52,810,21,31,530.10,824.00,0.00
2024-12-10 20:50:23,53,810,21,32,520.09,824.02,0.00
2024-12-10 20:50:23,52,810,21,31,526.48,824.06,0.00
2024-12-10 20:50:23,52,811,21,31,528.84,825.00,0.00
2024-12-10 20:50:23,53,811,22,31,518.86,825.02,0.00
2024-12-10 20:50:23,53,812,22,31,518.01,826.00,0.00
2024-12-10 20:50:23,54,812,22,32,508.42,826.02,0.00
2024-12-10 20:50:23,53,812,22,31,514.61,826.06,0.00
2024-12-10 20:50:23,52,812,21,31,514.35,826.96,0.00
2024-12-10 20:50:23,52,813,21,31,529.96,827.00,0.00
2024-12-10 20:50:23,53,813,22,31,519.96,827.02,0.00
2024-12-10 20:50:24,53,814,22,31,519.05,828.00,0.00
2024-12-10 20:50:24,54,814,23,31,509.44,828.02,0.00
2024-12-10 20:50:24,53,814,23,30,515.80,828.06,0.00
2024-12-10 20:50:24,52,814,22,30,525.56,828.06,0.00
2024-12-10 20:50:24,52,815,22,30,527.92,829.00,0.00
2024-12-10 20:50:24,53,815,23,30,517.96,829.02,0.00
2024-12-10 20:50:24,53,816,23,30,517.02,830.00,0.00
2024-12-10 20:50:24,54,816,24,30,507.44,830.02,0.00
2024-12-10 20:50:24,53,816,24,29,513.59,830.06,0.00
2024-12-10 20:50:24,53,817,24,29,515.76,831.00,0.00
2024-12-10 20:50:24,54,817,24,30,506.21,831.02,0.00
2024-12-10 20:50:24,54,818,24,30,505.50,832.00,0.00
2024-12-10 20:50:24,55,818,24,31,496.31,832.02,0.00
2024-12-10 20:50:24,54,818,24,30,501.97,832.06,0.00
2024-12-10 20:50:24,54,819,24,30,503.94,833.00,0.00
2024-12-10 20:50:24,55,819,24,31,494.78,833.02,0.00
2024-12-10 20:50:24,54,819,23,31,495.94,833.63,0.00
2024-12-10 20:50:24,54,820,23,31,508.56,834.00,0.00
2024-12-10 20:50:24,55,820,24,31,499.32,834.02,0.00
2024-12-10 20:50:24,54,820,24,30,505.03,834.06,0.00
2024-12-10 20:50:24,54,821,24,30,507.01,835.00,0.00
2024-12-10 20:50:24,55,821,25,30,497.79,835.02,0.00
2024-12-10 20:50:24,55,822,25,30,497.02,836.00,0.00
2024-12-10 20:50:24,56,822,26,30,488.14,836.02,0.00
2024-12-10 20:50:24,55,822,26,29,493.69,836.05,0.00
2024-12-10 20:50:24,55,823,26,29,495.48,837.00,0.00
2024-12-10 20:50:24,56,823,26,30,486.63,837.02,0.00
2024-12-10 20:50:24,55,823,25,30,489.31,837.18,0.00
2024-12-10 20:50:24,55,824,25,30,498.21,838.00,0.00
2024-12-10 20:50:24,56,824,25,31,489.31,838.02,0.00
2024-12-10 20:50:24,55,824,25,30,494.72,838.05,0.00
2024-12-10 20:50:24,55,825,25,30,496.51,839.00,0.00
2024-12-10 20:50:24,56,825,26,30,487.65,839.02,0.00
2024-12-10 20:50:24,55,825,25,30,485.85,839.35,0.00
2024-12-10 20:50:24,55,826,25,30,496.05,840.00,0.00
2024-12-10 20:50:24,56,826,25,31,487.20,840.02,0.00
2024-12-10 20:50:24,55,826,25,30,492.71,840.05,0.00
2024-12-10 20:50:24,54,826,24,30,501.68,840.06,0.00
2024-12-10 20:50:24,54,827,24,30,509.89,841.00,0.00
2024-12-10 20:50:24,55,827,25,30,500.62,841.02,0.00
2024-12-10 20:50:24,55,828,25,30,503.38,842.00,0.00
2024-12-10 20:50:24,56,828,26,30,494.39,842.02,0.00
2024-12-10 20:50:24,55,828,25,30,493.32,842.49,0.00
2024-12-10 20:50:24,55,829,25,30,504.72,843.00,0.00
2024-12-10 20:50:24,56,829,25,31,495.71,843.02,0.00
2024-12-10 20:50:24,57,828,25,32,478.50,843.75,0.00
2024-12-10 20:50:24,57,829,25,32,487.86,844.00,0.00
2024-12-10 20:50:24,58,829,26,32,479.45,844.02,0.00
2024-12-10 20:50:24,57,829,26,31,485.50,844.05,0.00
2024-12-10 20:50:24,57,830,26,31,501.78,845.00,0.00
2024-12-10 20:50:24,58,830,27,31,493.13,845.02,0.00
2024-12-10 20:50:24,58,831,27,31,492.08,846.00,0.00
2024-12-10 20:50:24,59,831,28,31,483.74,846.02,0.00
2024-12-10 20:50:24,58,831,28,30,489.17,846.05,0.00
2024-12-10 20:50:24,58,832,28,30,490.47,847.00,0.00
2024-12-10 20:50:24,59,832,28,31,482.16,847.02,0.00
2024-12-10 20:50:24,60,831,28,32,474.12,847.05,0.00
2024-12-10 20:50:24,59,831,27,32,480.62,847.15,0.00
2024-12-10 20:50:24,59,832,27,32,488.33,848.00,0.00
2024-12-10 20:50:24,60,832,28,32,480.19,848.02,0.00
2024-12-10 20:50:24,59,832,28,31,485.47,848.05,0.00
2024-12-10 20:50:24,59,833,28,31,500.99,849.00,0.00
2024-12-10 20:50:24,60,833,29,31,492.64,849.02,0.00
2024-12-10 20:50:24,60,834,29,31,491.53,850.00,0.00
2024-12-10 20:50:24,61,834,29,32,483.47,850.02,0.00
2024-12-10 20:50:24,60,834,29,31,488.71,850.05,0.00
2024-12-10 20:50:24,59,834,28,31,491.37,850.63,0.00
2024-12-10 20:50:24,59,835,28,31,502.90,851.00,0.00
2024-12-10 20:50:24,60,835,29,31,494.51,851.02,0.00
2024-12-10 20:50:24,59,835,28,31,499.45,851.07,0.00
2024-12-10 20:50:24,59,836,28,31,501.79,852.00,0.00
2024-12-10 20:50:24,60,836,28,32,493.42,852.02,0.00
2024-12-10 20:50:24,59,836,28,31,498.92,852.05,0.00
2024-12-10 20:50:24,58,836,27,31,499.85,852.40,0.00
2024-12-10 20:50:24,58,837,27,31,509.83,853.00,0.00
2024-12-10 20:50:24,59,837,27,32,501.19,853.02,0.00
2024-12-10 20:50:24,58,837,26,32,501.94,853.59,0.00
2024-12-10 20:50:24,58,838,26,32,513.45,854.00,0.00
2024-12-10 20:50:24,59,838,27,32,504.75,854.02,0.00
2024-12-10 20:50:24,58,838,27,31,510.38,854.05,0.00
2024-12-10 20:50:24,59,837,27,32,489.45,854.90,0.00
2024-12-10 20:50:24,59,838,27,32,504.04,855.00,0.00
2024-12-10 20:50:24,60,838,28,32,495.64,855.02,0.00
2024-12-10 20:50:24,59,838,27,32,503.76,855.03,0.00
2024-12-10 20:50:24,58,838,26,32,503.86,855.33,0.00
2024-12-10 20:50:24,58,839,26,32,528.09,856.00,0.00
2024-12-10 20:50:24,59,839,27,32,519.14,856.02,0.00
2024-12-10 20:50:24,58,839,27,31,525.15,856.03,0.00
2024-12-10 20:50:24,58,840,27,31,526.34,857.00,0.00
2024-12-10 20:50:24,59,840,27,32,517.42,857.02,0.00
2024-12-10 20:50:24,58,840,26,32,520.06,857.21,0.00
2024-12-10 20:50:25,58,841,26,32,528.58,858.00,0.00
2024-12-10 20:50:25,59,841,26,33,519.62,858.02,0.00
2024-12-10 20:50:25,58,841,26,32,525.79,858.03,0.00
2024-12-10 20:50:25,57,841,25,32,527.32,858.42,0.00
2024-12-10 20:50:25,57,842,25,32,537.85,859.00,0.00
2024-12-10 20:50:25,58,842,26,32,528.58,859.02,0.00
2024-12-10 20:50:25,58,843,26,32,527.27,860.00,0.00
2024-12-10 20:50:25,59,843,27,32,518.34,860.02,0.00
2024-12-10 20:50:25,58,843,27,31,524.62,860.03,0.00
2024-12-10 20:50:25,58,844,27,31,525.81,861.00,0.00
2024-12-10 20:50:25,59,844,27,32,516.90,861.02,0.00
2024-12-10 20:50:25,58,844,26,32,518.62,861.53,0.00
2024-12-10 20:50:25,58,845,26,32,524.63,862.00,0.00
2024-12-10 20:50:25,59,845,27,32,515.74,862.02,0.00
2024-12-10 20:50:25,58,845,27,31,522.12,862.03,0.00
2024-12-10 20:50:25,57,845,26,31,530.84,862.07,0.00
2024-12-10 20:50:25,57,846,26,31,532.49,863.00,0.00
2024-12-10 20:50:25,58,846,27,31,523.30,863.02,0.00
2024-12-10 20:50:25,58,847,27,31,521.87,864.00,0.00
2024-12-10 20:50:25,59,847,28,31,513.02,864.02,0.00
2024-12-10 20:50:25,58,847,28,30,519.50,864.03,0.00
2024-12-10 20:50:25,57,847,27,30,523.94,864.58,0.00
2024-12-10 20:50:25,57,848,27,30,529.74,865.00,0.00
2024-12-10 20:50:25,58,848,27,31,520.61,865.02,0.00
2024-12-10 20:50:25,57,848,26,31,525.81,865.05,0.00
2024-12-10 20:50:25,57,849,26,31,533.03,866.00,0.00
2024-12-10 20:50:25,58,849,26,32,523.84,866.02,0.00
2024-12-10 20:50:25,57,849,26,31,530.76,866.04,0.00
2024-12-10 20:50:25,56,849,25,31,531.58,866.45,0.00
2024-12-10 20:50:25,56,850,25,31,542.67,867.00,0.00
2024-12-10 20:50:25,57,850,26,31,533.15,867.02,0.00
2024-12-10 20:50:25,56,850,25,31,532.83,867.34,0.00
2024-12-10 20:50:25,55,850,24,31,541.09,867.51,0.00
2024-12-10 20:50:25,55,851,24,31,552.99,868.00,0.00
2024-12-10 20:50:25,56,851,25,31,543.12,868.02,0.00
2024-12-10 20:50:25,55,851,25,30,550.16,868.04,0.00
2024-12-10 20:50:25,55,852,25,30,550.80,869.00,0.00
2024-12-10 20:50:25,56,852,25,31,540.96,869.02,0.00
2024-12-10 20:50:25,55,852,24,31,545.11,869.11,0.00
2024-12-10 20:50:25,55,853,24,31,553.77,870.00,0.00
2024-12-10 20:50:25,56,853,24,32,543.88,870.02,0.00
2024-12-10 20:50:25,55,853,24,31,550.94,870.04,0.00
2024-12-10 20:50:25,55,854,24,31,551.16,871.00,0.00
2024-12-10 20:50:25,56,854,24,32,541.32,871.02,0.00
2024-12-10 20:50:25,55,854,24,31,547.11,871.07,0.00
2024-12-10 20:50:25,55,855,24,31,549.43,872.00,0.00
2024-12-10 20:50:25,56,855,24,32,539.62,872.02,0.00
2024-12-10 20:50:25,55,855,24,31,546.75,872.04,0.00
2024-12-10 20:50:25,55,856,24,31,548.47,873.00,0.00
2024-12-10 20:50:25,56,856,24,32,538.68,873.02,0.00
2024-12-10 20:50:25,55,856,23,32,542.02,873.15,0.00
2024-12-10 20:50:25,55,857,23,32,551.01,874.00,0.00
2024-12-10 20:50:25,56,857,24,32,541.17,874.02,0.00
2024-12-10 20:50:25,55,857,23,32,550.80,874.04,0.00
2024-12-10 20:50:25,54,857,23,31,557.93,874.04,0.00
2024-12-10 20:50:25,54,858,23,31,559.85,875.00,0.00
2024-12-10 20:50:25,55,858,23,32,549.67,875.02,0.00
2024-12-10 20:50:25,55,859,23,32,548.62,876.00,0.00
2024-12-10 20:50:25,56,859,23,33,538.83,876.02,0.00
2024-12-10 20:50:25,55,859,23,32,545.29,876.04,0.00
2024-12-10 20:50:25,55,860,23,32,547.02,877.00,0.00
2024-12-10 20:50:25,56,860,24,32,537.25,877.02,0.00
2024-12-10 20:50:25,56,861,24,32,536.28,878.00,0.00
2024-12-10 20:50:25,57,861,24,33,526.87,878.02,0.00
2024-12-10 20:50:25,56,861,24,32,533.00,878.04,0.00
2024-12-10 20:50:25,55,861,23,32,537.60,878.60,0.00
2024-12-10 20:50:25,55,862,23,32,550.34,879.00,0.00
2024-12-10 20:50:25,56,862,24,32,540.52,879.02,0.00
2024-12-10 20:50:25,55,862,23,32,536.60,879.93,0.00
2024-12-10 20:50:25,55,863,23,32,552.01,880.00,0.00
2024-12-10 20:50:25,56,863,23,33,542.15,880.02,0.00
2024-12-10 20:50:25,55,863,23,32,548.82,880.04,0.00
2024-12-10 20:50:25,55,864,23,32,550.56,881.00,0.00
2024-12-10 20:50:25,56,864,24,32,540.72,881.02,0.00
2024-12-10 20:50:25,55,864,23,32,546.89,881.05,0.00
2024-12-10 20:50:26,55,865,23,32,555.19,882.00,0.00
2024-12-10 20:50:26,56,865,24,32,545.28,882.02,0.00
2024-12-10 20:50:26,55,865,24,31,552.16,882.04,0.00
2024-12-10 20:50:26,55,866,24,31,553.89,883.00,0.00
2024-12-10 20:50:26,56,866,24,32,544.00,883.02,0.00
2024-12-10 20:50:26,56,867,24,32,542.75,884.00,0.00
2024-12-10 20:50:26,57,867,25,32,533.23,884.02,0.00
2024-12-10 20:50:26,56,867,24,32,538.46,884.02,0.00
2024-12-10 20:50:26,55,867,24,31,545.04,884.04,0.00
2024-12-10 20:50:26,55,868,24,31,553.22,885.00,0.00
2024-12-10 20:50:26,56,868,25,31,543.34,885.02,0.00
2024-12-10 20:50:26,55,868,24,31,544.81,885.62,0.00
2024-12-10 20:50:26,54,868,23,31,554.77,885.63,0.00
2024-12-10 20:50:26,54,869,23,31,568.19,886.00,0.00
2024-12-10 20:50:26,55,869,24,31,557.86,886.02,0.00
2024-12-10 20:50:26,54,869,24,30,564.92,886.04,0.00
2024-12-10 20:50:26,53,869,23,30,571.03,886.58,0.00
2024-12-10 20:50:26,53,870,23,30,577.72,887.00,0.00
2024-12-10 20:50:26,54,870,23,31,567.02,887.02,0.00
2024-12-10 20:50:26,54,871,23,31,565.52,888.00,0.00
2024-12-10 20:50:26,55,871,24,31,555.24,888.02,0.00
2024-12-10 20:50:26,54,871,24,30,562.24,888.04,0.00
2024-12-10 20:50:26,53,871,23,30,567.60,888.28,0.00
2024-12-10 20:50:26,54,870,24,30,554.50,888.63,0.00
2024-12-10 20:50:26,54,871,24,30,571.43,889.00,0.00
2024-12-10 20:50:26,55,871,25,30,561.04,889.02,0.00
2024-12-10 20:50:26,55,872,25,30,576.20,890.00,0.00
2024-12-10 20:50:26,56,872,25,31,565.91,890.02,0.00
2024-12-10 20:50:26,55,872,24,31,570.86,890.02,0.00
2024-12-10 20:50:26,55,873,24,31,575.72,891.00,0.00
2024-12-10 20:50:26,56,873,24,32,565.44,891.02,0.00
2024-12-10 20:50:26,55,873,24,31,575.40,891.04,0.00
2024-12-10 20:50:26,55,874,24,31,577.17,892.00,0.00
2024-12-10 20:50:26,56,874,25,31,566.87,892.02,0.00
2024-12-10 20:50:26,55,874,24,31,564.88,892.82,0.00
2024-12-10 20:50:26,55,875,24,31,579.64,893.00,0.00
2024-12-10 20:50:26,56,875,25,31,569.29,893.02,0.00
2024-12-10 20:50:26,55,875,25,30,576.24,893.04,0.00
2024-12-10 20:50:26,55,876,25,30,578.01,894.00,0.00
2024-12-10 20:50:26,56,876,26,30,567.69,894.02,0.00
2024-12-10 20:50:26,56,877,26,30,565.97,895.00,0.00
2024-12-10 20:50:26,57,877,26,31,556.04,895.02,0.00
2024-12-10 20:50:26,56,877,26,30,562.78,895.04,0.00
2024-12-10 20:50:26,56,878,26,30,564.36,896.00,0.00
2024-12-10 20:50:26,57,878,26,31,554.46,896.02,0.00
2024-12-10 20:50:26,57,879,26,31,553.17,897.00,0.00
2024-12-10 20:50:26,58,879,26,32,543.64,897.02,0.00
2024-12-10 20:50:26,57,879,26,31,549.57,897.05,0.00
2024-12-10 20:50:26,56,879,25,31,555.45,897.21,0.00
2024-12-10 20:50:26,56,880,25,31,564.98,898.00,0.00
2024-12-10 20:50:26,57,880,25,32,555.07,898.02,0.00
2024-12-10 20:50:26,57,881,25,32,553.72,899.00,0.00
2024-12-10 20:50:26,58,881,25,33,544.18,899.02,0.00
2024-12-10 20:50:26,57,881,25,32,550.27,899.05,0.00
2024-12-10 20:50:26,56,881,24,32,559.93,899.05,0.00
2024-12-10 20:50:26,55,881,23,32,564.42,899.31,0.00
2024-12-10 20:50:26,55,882,23,32,575.06,900.00,0.00
2024-12-10 20:50:26,56,882,24,32,564.79,900.02,0.00
2024-12-10 20:50:26,56,883,24,32,563.40,901.00,0.00
2024-12-10 20:50:26,57,883,25,32,553.52,901.02,0.00
2024-12-10 20:50:26,56,883,25,31,559.88,901.05,0.00
2024-12-10 20:50:26,56,884,25,31,561.61,902.00,0.00
2024-12-10 20:50:26,57,884,25,32,551.76,902.02,0.00
2024-12-10 20:50:26,56,884,24,32,556.97,902.11,0.00
2024-12-10 20:50:26,56,885,24,32,565.62,903.00,0.00
2024-12-10 20:50:26,57,885,25,32,555.70,903.02,0.00
2024-12-10 20:50:26,56,885,25,31,561.93,903.05,0.00
2024-12-10 20:50:26,56,886,25,31,563.67,904.00,0.00
2024-12-10 20:50:26,57,886,26,31,553.78,904.02,0.00
2024-12-10 20:50:26,57,887,26,31,552.37,905.00,0.00
2024-12-10 20:50:26,58,887,26,32,542.84,905.02,0.00
2024-12-10 20:50:26,57,887,25,32,552.01,905.02,0.00
2024-12-10 20:50:26,56,887,25,31,558.64,905.04,0.00
2024-12-10 20:50:26,55,887,24,31,568.75,905.04,0.00
2024-12-10 20:50:26,55,888,24,31,577.12,906.00,0.00
2024-12-10 20:50:26,56,888,25,31,566.81,906.02,0.00
2024-12-10 20:50:26,56,889,25,31,565.55,907.00,0.00
2024-12-10 20:50:26,57,889,25,32,555.63,907.02,0.00
2024-12-10 20:50:26,56,889,25,31,561.99,907.04,0.00
2024-12-10 20:50:26,57,888,26,31,552.13,907.07,0.00
2024-12-10 20:50:26,57,889,26,31,562.13,908.00,0.00
2024-12-10 20:50:26,58,889,27,31,552.44,908.02,0.00
2024-12-10 20:50:26,58,890,27,31,571.05,909.00,0.00
2024-12-10 20:50:26,59,890,28,31,561.37,909.02,0.00
2024-12-10 20:50:26,59,891,28,31,563.53,910.00,0.00
2024-12-10 20:50:26,60,891,28,32,554.14,910.02,0.00
2024-12-10 20:50:27,60,892,28,32,554.56,911.00,0.00
2024-12-10 20:50:27,61,892,29,32,545.47,911.02,0.00
2024-12-10 20:50:27,61,893,29,32,543.44,912.00,0.00
2024-12-10 20:50:27,62,893,29,33,534.68,912.02,0.00
2024-12-10 20:50:27,61,893,29,32,540.90,912.03,0.00
2024-12-10 20:50:27,61,894,29,32,541.64,913.00,0.00
2024-12-10 20:50:27,62,894,30,32,532.91,913.02,0.00
2024-12-10 20:50:27,61,894,29,32,541.44,913.03,0.00
2024-12-10 20:50:27,61,895,29,32,545.18,914.00,0.00
2024-12-10 20:50:27,62,895,30,32,536.39,914.02,0.00
2024-12-10 20:50:27,61,895,30,31,542.49,914.03,0.00
2024-12-10 20:50:27,61,896,30,31,542.94,915.00,0.00
2024-12-10 20:50:27,62,896,31,31,534.19,915.02,0.00
2024-12-10 20:50:27,61,896,30,31,532.77,915.41,0.00
2024-12-10 20:50:27,60,896,29,31,539.88,915.62,0.00
2024-12-10 20:50:27,60,897,29,31,551.06,916.00,0.00
2024-12-10 20:50:27,61,897,30,31,542.03,916.02,0.00
2024-12-10 20:50:27,60,897,30,30,548.17,916.05,0.00
2024-12-10 20:50:27,60,898,30,30,548.04,917.00,0.00
2024-12-10 20:50:27,61,898,31,30,539.05,917.02,0.00
2024-12-10 20:50:27,60,898,30,30,538.73,917.07,0.00
2024-12-10 20:50:27,60,899,30,30,544.58,918.00,0.00
2024-12-10 20:50:27,61,899,31,30,535.65,918.02,0.00
2024-12-10 20:50:27,60,899,31,29,541.84,918.05,0.00
2024-12-10 20:50:27,59,899,30,29,544.40,918.59,0.00
2024-12-10 20:50:27,59,900,30,29,550.32,919.00,0.00
2024-12-10 20:50:27,60,900,30,30,541.14,919.02,0.00
2024-12-10 20:50:27,60,901,30,30,538.91,920.00,0.00
2024-12-10 20:50:27,61,901,31,30,530.08,920.02,0.00
2024-12-10 20:50:27,62,900,32,30,521.24,920.08,0.00
2024-12-10 20:50:27,61,900,31,30,533.21,920.84,0.00
2024-12-10 20:50:27,61,901,31,30,546.91,921.00,0.00
2024-12-10 20:50:27,62,901,32,30,538.09,921.02,0.00
2024-12-10 20:50:27,62,902,32,30,555.05,922.00,0.00
2024-12-10 20:50:27,63,902,33,30,546.24,922.02,0.00
2024-12-10 20:50:27,63,903,33,30,547.35,923.00,0.00
2024-12-10 20:50:27,64,903,34,30,538.80,923.02,0.00
2024-12-10 20:50:27,64,904,34,30,537.89,924.00,0.00
2024-12-10 20:50:27,65,904,34,31,529.61,924.02,0.00
2024-12-10 20:50:27,66,903,35,31,511.41,924.89,0.00
2024-12-10 20:50:27,66,904,35,31,525.11,925.00,0.00
2024-12-10 20:50:27,67,904,36,31,517.27,925.02,0.00
2024-12-10 20:50:27,66,904,36,30,523.51,925.05,0.00
2024-12-10 20:50:27,65,904,35,30,519.76,925.92,0.00
2024-12-10 20:50:27,65,905,35,30,547.30,926.00,0.00
2024-12-10 20:50:27,66,905,36,30,539.01,926.02,0.00
2024-12-10 20:50:27,65,905,35,30,538.07,926.11,0.00
2024-12-10 20:50:27,65,906,35,30,543.90,927.00,0.00
2024-12-10 20:50:27,66,906,35,31,535.66,927.02,0.00
2024-12-10 20:50:27,65,906,35,30,542.05,927.05,0.00
2024-12-10 20:50:27,65,907,35,30,541.42,928.00,0.00
2024-12-10 20:50:27,66,907,35,31,533.22,928.02,0.00
2024-12-10 20:50:27,65,907,34,31,537.60,928.12,0.00
2024-12-10 20:50:27,65,908,34,31,537.41,929.00,0.00
2024-12-10 20:50:27,66,908,35,31,529.27,929.02,0.00
2024-12-10 20:50:27,65,908,35,30,535.70,929.05,0.00
2024-12-10 20:50:27,64,908,34,30,532.13,929.97,0.00
2024-12-10 20:50:27,64,909,34,30,546.38,930.00,0.00
2024-12-10 20:50:27,65,909,35,30,537.98,930.02,0.00
2024-12-10 20:50:27,65,910,35,30,533.41,931.00,0.00
2024-12-10 20:50:27,66,910,36,30,525.33,931.02,0.00
2024-12-10 20:50:27,65,910,36,29,531.41,931.06,0.00
2024-12-10 20:50:27,65,911,36,29,529.48,932.00,0.00
2024-12-10 20:50:27,66,911,37,29,521.45,932.02,0.00
2024-12-10 20:50:27,66,912,37,29,516.08,933.00,0.00
2024-12-10 20:50:27,67,912,37,30,508.38,933.02,0.00
2024-12-10 20:50:27,66,912,37,29,513.83,933.06,0.00
2024-12-10 20:50:27,65,912,36,29,515.27,933.74,0.00
2024-12-10 20:50:27,65,913,36,29,519.86,934.00,0.00
2024-12-10 20:50:27,66,913,36,30,511.98,934.02,0.00
2024-12-10 20:50:27,65,913,35,30,519.71,934.02,0.00
2024-12-10 20:50:27,65,914,35,30,518.06,935.00,0.00
2024-12-10 20:50:27,66,914,35,31,510.21,935.02,0.00
2024-12-10 20:50:27,67,913,36,31,490.63,935.93,0.00
2024-12-10 20:50:27,67,914,36,31,505.18,936.00,0.00
2024-12-10 20:50:27,68,914,36,32,497.75,936.01,0.00
2024-12-10 20:50:27,67,914,36,31,503.09,936.04,0.00
2024-12-10 20:50:27,66,914,35,31,501.35,936.94,0.00
2024-12-10 20:50:27,66,915,35,31,529.20,937.00,0.00
2024-12-10 20:50:27,67,915,36,31,521.30,937.02,0.00
2024-12-10 20:50:27,66,915,35,31,524.85,937.17,0.00
2024-12-10 20:50:27,66,916,35,31,525.17,938.00,0.00
2024-12-10 20:50:27,67,916,36,31,517.33,938.02,0.00
2024-12-10 20:50:27,66,916,36,30,523.05,938.06,0.00
2024-12-10 20:50:27,65,916,35,30,524.21,938.68,0.00
2024-12-10 20:50:28,65,917,35,30,529.84,939.00,0.00
2024-12-10 20:50:28,66,917,36,30,521.81,939.02,0.00
2024-12-10 20:50:28,66,918,36,30,518.86,940.00,0.00
2024-12-10 20:50:28,67,918,36,31,511.11,940.02,0.00
2024-12-10 20:50:28,66,918,36,30,516.87,940.06,0.00
2024-12-10 20:50:28,66,919,36,30,516.76,941.00,0.00
2024-12-10 20:50:28,67,919,36,31,509.05,941.02,0.00
2024-12-10 20:50:28,67,920,36,31,505.97,942.00,0.00
2024-12-10 20:50:28,68,920,37,31,498.53,942.01,0.00
2024-12-10 20:50:28,67,920,37,30,504.15,942.06,0.00
2024-12-10 20:50:28,66,920,36,30,510.96,942.15,0.00
2024-12-10 20:50:28,66,921,36,30,511.69,943.00,0.00
2024-12-10 20:50:28,67,921,37,30,504.05,943.02,0.00
2024-12-10 20:50:28,66,921,36,30,509.12,943.03,0.00
2024-12-10 20:50:28,66,922,36,30,511.61,944.00,0.00
2024-12-10 20:50:28,67,922,36,31,503.97,944.02,0.00
2024-12-10 20:50:28,66,922,36,30,510.04,944.05,0.00
2024-12-10 20:50:28,66,923,36,30,509.86,945.00,0.00
2024-12-10 20:50:28,67,923,36,31,502.25,945.02,0.00
2024-12-10 20:50:28,67,924,36,31,499.12,946.00,0.00
2024-12-10 20:50:28,68,924,37,31,491.78,946.01,0.00
2024-12-10 20:50:28,67,924,37,30,497.72,946.04,0.00
2024-12-10 20:50:28,66,924,36,30,504.43,946.14,0.00
2024-12-10 20:50:28,65,924,35,30,507.88,946.34,0.00
2024-12-10 20:50:28,65,925,35,30,516.26,947.00,0.00
2024-12-10 20:50:28,66,925,36,30,508.44,947.02,0.00
2024-12-10 20:50:28,65,925,35,30,506.86,947.68,0.00
2024-12-10 20:50:28,65,926,35,30,513.08,948.00,0.00
2024-12-10 20:50:28,66,926,35,31,505.31,948.02,0.00
2024-12-10 20:50:28,65,926,35,30,511.63,948.05,0.00
2024-12-10 20:50:28,65,927,35,30,511.37,949.00,0.00
2024-12-10 20:50:28,66,927,35,31,503.62,949.02,0.00
2024-12-10 20:50:28,66,928,35,31,500.11,950.00,0.00
2024-12-10 20:50:28,67,928,35,32,492.64,950.02,0.00
2024-12-10 20:50:28,66,928,35,31,498.81,950.05,0.00
2024-12-10 20:50:28,65,928,34,31,494.76,950.97,0.00
2024-12-10 20:50:28,65,929,34,31,509.12,951.00,0.00
2024-12-10 20:50:28,66,929,35,31,501.40,951.02,0.00
2024-12-10 20:50:28,65,929,34,31,508.97,951.02,0.00
2024-12-10 20:50:28,64,929,33,31,512.68,951.14,0.00
2024-12-10 20:50:28,64,930,33,31,519.15,952.00,0.00
2024-12-10 20:50:28,65,930,33,32,511.17,952.02,0.00
2024-12-10 20:50:28,64,930,33,31,517.97,952.03,0.00
2024-12-10 20:50:28,64,931,33,31,517.52,953.00,0.00
2024-12-10 20:50:28,65,931,33,32,509.56,953.02,0.00
2024-12-10 20:50:28,65,932,33,32,506.05,954.00,0.00
2024-12-10 20:50:28,66,932,34,32,498.39,954.02,0.00
2024-12-10 20:50:28,65,932,34,31,504.88,954.03,0.00
2024-12-10 20:50:28,64,932,33,31,511.62,954.16,0.00
2024-12-10 20:50:28,63,932,32,31,509.05,954.97,0.00
2024-12-10 20:50:28,63,933,32,31,523.93,955.00,0.00
2024-12-10 20:50:28,64,933,32,32,515.74,955.02,0.00
2024-12-10 20:50:28,63,933,31,32,516.05,955.05,0.00
2024-12-10 20:50:28,63,934,31,32,522.05,956.00,0.00
2024-12-10 20:50:28,64,934,32,32,513.90,956.02,0.00
2024-12-10 20:50:28,63,934,32,31,520.69,956.03,0.00
2024-12-10 20:50:28,62,934,31,31,524.94,956.32,0.00
2024-12-10 20:50:28,62,935,31,31,533.62,957.00,0.00
2024-12-10 20:50:28,63,935,31,32,525.15,957.02,0.00
2024-12-10 20:50:28,62,935,30,32,527.44,957.21,0.00
2024-12-10 20:50:28,62,936,30,32,534.96,958.00,0.00
2024-12-10 20:50:28,63,936,31,32,526.47,958.02,0.00
2024-12-10 20:50:28,62,936,31,31,533.12,958.05,0.00
2024-12-10 20:50:28,61,936,30,31,528.60,958.70,0.00
2024-12-10 20:50:28,61,937,30,31,541.72,959.00,0.00
2024-12-10 20:50:28,62,937,31,31,532.99,959.02,0.00
2024-12-10 20:50:28,61,937,30,31,534.33,959.44,0.00
2024-12-10 20:50:29,61,938,30,31,538.74,960.00,0.00
2024-12-10 20:50:29,62,938,31,31,530.05,960.02,0.00
2024-12-10 20:50:29,61,938,31,30,536.40,960.08,0.00
2024-12-10 20:50:29,61,939,31,30,536.67,961.00,0.00
2024-12-10 20:50:29,62,939,32,30,528.02,961.02,0.00
2024-12-10 20:50:29,62,940,32,30,524.70,962.00,0.00
2024-12-10 20:50:29,63,940,32,31,516.37,962.02,0.00
2024-12-10 20:50:29,62,940,32,30,522.54,962.08,0.00
2024-12-10 20:50:29,62,941,32,30,522.49,963.00,0.00
2024-12-10 20:50:29,63,941,33,30,514.19,963.02,0.00
2024-12-10 20:50:29,64,940,33,31,492.56,963.52,0.00
2024-12-10 20:50:29,64,941,33,31,508.43,964.00,0.00
2024-12-10 20:50:29,65,941,34,31,500.61,964.02,0.00
2024-12-10 20:50:29,64,941,34,30,506.03,964.08,0.00
2024-12-10 20:50:29,64,942,34,30,520.82,965.00,0.00
2024-12-10 20:50:29,65,942,35,30,512.80,965.02,0.00
2024-12-10 20:50:29,64,942,34,30,512.75,965.31,0.00
2024-12-10 20:50:29,64,943,34,30,520.70,966.00,0.00
2024-12-10 20:50:29,65,943,35,30,512.69,966.02,0.00
2024-12-10 20:50:29,64,943,35,29,518.44,966.08,0.00
2024-12-10 20:50:29,64,944,35,29,518.19,967.00,0.00
2024-12-10 20:50:29,65,944,36,29,510.22,967.02,0.00
2024-12-10 20:50:29,64,944,35,29,513.55,967.19,0.00
2024-12-10 20:50:29,64,945,35,29,515.16,968.00,0.00
2024-12-10 20:50:29,65,945,35,30,507.23,968.02,0.00
2024-12-10 20:50:29,64,945,34,30,515.01,968.02,0.00
2024-12-10 20:50:29,63,945,34,29,521.19,968.06,0.00
2024-12-10 20:50:29,62,945,33,29,516.92,968.97,0.00
2024-12-10 20:50:29,62,946,33,29,532.25,969.00,0.00
2024-12-10 20:50:29,63,946,34,29,523.80,969.02,0.00
2024-12-10 20:50:29,62,946,33,29,522.74,969.11,0.00
2024-12-10 20:50:29,61,946,33,28,528.45,969.34,0.00
2024-12-10 20:50:29,61,947,33,28,538.44,970.00,0.00
2024-12-10 20:50:29,62,947,34,28,529.75,970.02,0.00
2024-12-10 20:50:29,61,947,34,27,536.54,970.07,0.00
2024-12-10 20:50:29,61,948,34,27,537.16,971.00,0.00
2024-12-10 20:50:29,62,948,35,27,528.50,971.02,0.00
