Timestamp,NAnimals,NResources,NFemales,NMales,MeanLifeSuccess,MeanAge,%MatingAccept
2024-12-10 17:17:43,100,0,51,49,0.00,0.00,0.00
2024-12-10 17:17:43,100,0,51,49,0.00,0.00,0.00
2024-12-10 17:17:43,100,1,51,49,0.78,1.00,0.00
2024-12-10 17:17:43,99,1,50,49,0.80,1.05,0.00
2024-12-10 17:17:43,98,1,50,48,0.81,1.06,0.00
2024-12-10 17:17:43,97,1,50,47,0.88,1.14,0.00
2024-12-10 17:17:43,96,1,50,46,0.89,1.16,0.00
2024-12-10 17:17:43,95,1,49,46,0.90,1.16,0.00
2024-12-10 17:17:43,94,1,48,46,0.90,1.16,0.00
2024-12-10 17:17:43,93,1,48,45,0.92,1.17,0.00
2024-12-10 17:17:43,92,1,47,45,1.00,1.27,0.00
2024-12-10 17:17:43,91,1,47,44,1.02,1.36,0.00
2024-12-10 17:17:43,90,1,47,43,1.03,1.37,0.00
2024-12-10 17:17:43,89,1,47,42,1.10,1.46,0.00
2024-12-10 17:17:43,88,1,46,42,1.12,1.51,0.00
2024-12-10 17:17:43,87,1,46,41,1.14,1.56,0.00
2024-12-10 17:17:43,86,1,45,41,1.17,1.59,0.00
2024-12-10 17:17:43,85,1,44,41,1.29,1.78,0.00
2024-12-10 17:17:43,84,1,43,41,1.35,1.86,0.00
2024-12-10 17:17:43,83,1,43,40,1.36,1.88,0.00
2024-12-10 17:17:43,82,1,42,40,1.38,1.90,0.00
2024-12-10 17:17:43,81,1,42,39,1.40,1.93,0.00
2024-12-10 17:17:44,81,2,42,39,1.42,2.00,0.00
2024-12-10 17:17:44,80,2,41,39,1.44,2.00,0.00
2024-12-10 17:17:44,79,2,41,38,1.62,2.33,0.00
2024-12-10 17:17:44,78,2,40,38,1.64,2.33,0.00
2024-12-10 17:17:44,77,2,40,37,1.66,2.34,0.00
2024-12-10 17:17:44,76,2,40,36,1.67,2.36,0.00
2024-12-10 17:17:44,75,2,40,35,1.71,2.40,0.00
2024-12-10 17:17:44,74,2,39,35,1.79,2.50,0.00
2024-12-10 17:17:44,73,2,38,35,1.80,2.51,0.00
2024-12-10 17:17:44,72,2,38,34,1.81,2.51,0.00
2024-12-10 17:17:44,71,2,37,34,1.85,2.54,0.00
2024-12-10 17:17:44,70,2,37,33,1.91,2.61,0.00
2024-12-10 17:17:44,69,2,37,32,1.96,2.65,0.00
2024-12-10 17:17:44,68,2,36,32,2.12,2.88,0.00
2024-12-10 17:17:44,67,2,35,32,2.20,2.96,0.00
2024-12-10 17:17:44,66,2,35,31,2.23,2.97,0.00
2024-12-10 17:17:44,65,2,34,31,2.26,2.98,0.00
2024-12-10 17:17:44,65,3,34,31,2.28,3.00,0.00
2024-12-10 17:17:44,64,3,33,31,2.31,3.00,0.00
2024-12-10 17:17:44,63,3,32,31,2.43,3.19,0.00
2024-12-10 17:17:44,62,3,32,30,2.56,3.32,0.00
2024-12-10 17:17:44,61,3,32,29,2.59,3.33,0.00
2024-12-10 17:17:44,60,3,32,28,2.64,3.40,0.00
2024-12-10 17:17:44,59,3,32,27,2.76,3.51,0.00
2024-12-10 17:17:44,58,3,31,27,2.87,3.60,0.00
2024-12-10 17:17:44,57,3,30,27,3.04,3.77,0.00
2024-12-10 17:17:44,56,3,30,26,3.18,3.89,0.00
2024-12-10 17:17:44,56,4,30,26,3.26,4.00,0.00
2024-12-10 17:17:44,55,4,30,25,3.35,4.11,0.00
2024-12-10 17:17:44,54,4,29,25,3.60,4.39,0.00
2024-12-10 17:17:44,54,5,29,25,4.03,5.00,0.00
2024-12-10 17:17:44,53,5,29,24,4.12,5.08,0.00
2024-12-10 17:17:44,52,5,29,23,4.37,5.35,0.00
2024-12-10 17:17:44,52,6,29,23,4.76,6.00,0.00
2024-12-10 17:17:44,51,6,28,23,5.08,6.33,0.00
2024-12-10 17:17:44,50,6,28,22,5.32,6.54,0.00
2024-12-10 17:17:44,50,7,28,22,5.58,7.00,0.00
2024-12-10 17:17:44,49,7,27,22,6.13,7.76,0.00
2024-12-10 17:17:44,49,8,27,22,6.28,8.00,0.00
2024-12-10 17:17:44,48,8,26,22,6.41,8.06,0.00
2024-12-10 17:17:44,47,8,26,21,6.99,8.72,0.00
2024-12-10 17:17:44,47,9,26,21,7.14,9.00,0.00
2024-12-10 17:17:44,46,9,25,21,7.31,9.02,0.00
2024-12-10 17:17:44,46,10,25,21,7.87,10.00,0.00
2024-12-10 17:17:44,47,10,25,22,7.70,10.02,0.00
2024-12-10 17:17:44,46,10,24,22,8.31,10.80,0.00
2024-12-10 17:17:44,46,11,24,22,8.38,11.00,0.00
2024-12-10 17:17:44,47,11,25,22,8.20,11.02,0.00
2024-12-10 17:17:44,46,11,25,21,8.48,11.20,0.00
2024-12-10 17:17:44,45,11,24,21,9.02,11.96,0.00
2024-12-10 17:17:44,45,12,24,21,9.30,12.00,0.00
2024-12-10 17:17:44,46,12,25,21,9.10,12.02,0.00
2024-12-10 17:17:44,45,12,25,20,9.61,12.58,0.00
2024-12-10 17:17:45,44,12,24,20,10.01,12.91,0.00
2024-12-10 17:17:45,44,13,24,20,10.36,13.00,0.00
2024-12-10 17:17:45,45,13,25,20,10.13,13.02,0.00
2024-12-10 17:17:45,45,14,25,20,10.96,14.00,0.00
2024-12-10 17:17:45,46,14,25,21,10.72,14.02,0.00
2024-12-10 17:17:45,46,15,25,21,11.48,15.00,0.00
2024-12-10 17:17:45,47,15,26,21,11.24,15.02,0.00
2024-12-10 17:17:45,46,15,25,21,11.55,15.20,0.00
2024-12-10 17:17:45,46,16,25,21,12.24,16.00,0.00
2024-12-10 17:17:45,47,16,26,21,11.98,16.02,0.00
2024-12-10 17:17:45,46,16,26,20,12.46,16.41,0.00
2024-12-10 17:17:45,46,17,26,20,13.03,17.00,0.00
2024-12-10 17:17:45,47,17,26,21,12.75,17.02,0.00
2024-12-10 17:17:45,47,18,26,21,13.56,18.00,0.00
2024-12-10 17:17:45,48,18,27,21,13.28,18.02,0.00
2024-12-10 17:17:45,47,18,27,20,13.75,18.40,0.00
2024-12-10 17:17:45,47,19,27,20,14.37,19.00,0.00
2024-12-10 17:17:45,48,19,27,21,14.07,19.02,0.00
2024-12-10 17:17:45,47,19,27,20,14.55,19.40,0.00
2024-12-10 17:17:45,47,20,27,20,15.18,20.00,0.00
2024-12-10 17:17:45,48,20,27,21,14.86,20.02,0.00
2024-12-10 17:17:45,48,21,27,21,15.63,21.00,0.00
2024-12-10 17:17:45,49,21,27,22,15.32,21.02,0.00
2024-12-10 17:17:45,49,22,27,22,16.03,22.00,0.00
2024-12-10 17:17:45,50,22,27,23,15.71,22.02,0.00
2024-12-10 17:17:45,49,22,26,23,16.15,22.71,0.00
2024-12-10 17:17:45,49,23,26,23,16.79,23.00,0.00
2024-12-10 17:17:45,50,23,26,24,16.46,23.02,0.00
2024-12-10 17:17:45,49,23,25,24,16.87,23.43,0.00
2024-12-10 17:17:45,48,23,24,24,17.25,23.65,0.00
2024-12-10 17:17:45,48,24,24,24,17.97,24.00,0.00
2024-12-10 17:17:45,49,24,25,24,17.60,24.02,0.00
2024-12-10 17:17:45,49,25,25,24,18.49,25.00,0.00
2024-12-10 17:17:45,50,25,25,25,18.12,25.02,0.00
2024-12-10 17:17:45,50,26,25,25,19.01,26.00,0.00
2024-12-10 17:17:45,51,26,25,26,18.64,26.02,0.00
2024-12-10 17:17:45,51,27,25,26,19.52,27.00,0.00
2024-12-10 17:17:45,52,27,26,26,19.15,27.02,0.00
2024-12-10 17:17:45,51,27,26,25,19.61,27.45,0.00
2024-12-10 17:17:45,51,28,26,25,20.44,28.00,0.00
2024-12-10 17:17:45,52,28,26,26,20.05,28.02,0.00
2024-12-10 17:17:45,51,28,25,26,20.55,28.35,0.00
2024-12-10 17:17:45,51,29,25,26,21.44,29.00,0.00
2024-12-10 17:17:45,52,29,26,26,21.03,29.02,0.00
2024-12-10 17:17:45,52,30,26,26,22.03,30.00,0.00
2024-12-10 17:17:45,53,30,27,26,21.62,30.02,0.00
2024-12-10 17:17:45,53,31,27,26,22.62,31.00,0.00
2024-12-10 17:17:45,54,31,28,26,22.20,31.02,0.00
2024-12-10 17:17:45,54,32,28,26,23.20,32.00,0.00
2024-12-10 17:17:45,55,32,28,27,22.77,32.02,0.00
2024-12-10 17:17:45,55,33,28,27,23.76,33.00,0.00
2024-12-10 17:17:45,56,33,28,28,23.33,33.02,0.00
2024-12-10 17:17:45,56,34,28,28,24.30,34.00,0.00
2024-12-10 17:17:45,57,34,29,28,23.87,34.02,0.00
2024-12-10 17:17:45,57,35,29,28,24.82,35.00,0.00
2024-12-10 17:17:45,58,35,29,29,24.39,35.02,0.00
2024-12-10 17:17:45,58,36,29,29,25.36,36.00,0.00
2024-12-10 17:17:45,59,36,29,30,24.93,36.02,0.00
2024-12-10 17:17:45,59,37,29,30,25.87,37.00,0.00
2024-12-10 17:17:45,60,37,30,30,25.44,37.02,0.00
2024-12-10 17:17:45,60,38,30,30,26.36,38.00,0.00
2024-12-10 17:17:45,61,38,30,31,25.92,38.02,0.00
2024-12-10 17:17:45,61,39,30,31,26.86,39.00,0.00
2024-12-10 17:17:45,62,39,30,32,26.43,39.02,0.00
2024-12-10 17:17:45,62,40,30,32,27.34,40.00,0.00
2024-12-10 17:17:45,63,40,30,33,26.91,40.02,0.00
2024-12-10 17:17:45,63,41,30,33,27.81,41.00,0.00
2024-12-10 17:17:45,64,41,31,33,27.38,41.02,0.00
2024-12-10 17:17:45,64,42,31,33,28.27,42.00,0.00
2024-12-10 17:17:45,65,42,32,33,27.84,42.02,0.00
2024-12-10 17:17:45,65,43,32,33,28.71,43.00,0.00
2024-12-10 17:17:45,66,43,33,33,28.28,43.02,0.00
2024-12-10 17:17:45,66,44,33,33,29.14,44.00,0.00
2024-12-10 17:17:45,67,44,34,33,28.71,44.01,0.00
2024-12-10 17:17:45,66,44,34,32,29.14,44.11,0.00
2024-12-10 17:17:45,66,45,34,32,30.00,45.00,0.00
2024-12-10 17:17:45,67,45,34,33,29.56,45.01,0.00
2024-12-10 17:17:45,66,45,33,33,30.02,45.38,0.00
2024-12-10 17:17:45,66,46,33,33,30.91,46.00,0.00
2024-12-10 17:17:45,67,46,33,34,30.45,46.01,0.00
2024-12-10 17:17:45,67,47,33,34,31.34,47.00,0.00
2024-12-10 17:17:45,68,47,34,34,30.88,47.01,0.00
2024-12-10 17:17:45,68,48,34,34,31.77,48.00,0.00
2024-12-10 17:17:45,69,48,35,34,31.31,48.01,0.00
2024-12-10 17:17:45,69,49,35,34,32.19,49.00,0.00
2024-12-10 17:17:45,70,49,35,35,31.73,49.01,0.00
2024-12-10 17:17:45,70,50,35,35,32.59,50.00,0.00
2024-12-10 17:17:45,71,50,35,36,32.13,50.01,0.00
2024-12-10 17:17:46,71,51,35,36,32.98,51.00,0.00
2024-12-10 17:17:46,72,51,35,37,32.52,51.01,0.00
2024-12-10 17:17:46,72,52,35,37,33.33,52.00,0.00
2024-12-10 17:17:46,73,52,36,37,32.88,52.01,0.00
2024-12-10 17:17:46,73,53,36,37,33.68,53.00,0.00
2024-12-10 17:17:46,74,53,36,38,33.22,53.01,0.00
2024-12-10 17:17:46,74,54,36,38,34.02,54.00,0.00
2024-12-10 17:17:46,75,54,36,39,33.57,54.01,0.00
2024-12-10 17:17:46,75,55,36,39,34.37,55.00,0.00
2024-12-10 17:17:46,76,55,36,40,33.92,55.01,0.00
2024-12-10 17:17:46,76,56,36,40,34.71,56.00,0.00
2024-12-10 17:17:46,77,56,37,40,34.26,56.01,0.00
2024-12-10 17:17:46,77,57,37,40,35.04,57.00,0.00
2024-12-10 17:17:46,78,57,38,40,34.59,57.01,0.00
2024-12-10 17:17:46,78,58,38,40,35.34,58.00,0.00
2024-12-10 17:17:46,79,58,39,40,34.90,58.01,0.00
2024-12-10 17:17:46,79,59,39,40,35.64,59.00,0.00
2024-12-10 17:17:46,80,59,40,40,35.19,59.01,0.00
2024-12-10 17:17:46,80,60,40,40,35.93,60.00,0.00
2024-12-10 17:17:46,81,60,40,41,35.49,60.01,0.00
2024-12-10 17:17:46,81,61,40,41,36.22,61.00,0.00
2024-12-10 17:17:46,82,61,40,42,35.77,61.01,0.00
2024-12-10 17:17:46,82,62,40,42,36.47,62.00,0.00
2024-12-10 17:17:46,83,62,41,42,36.03,62.01,0.00
2024-12-10 17:17:46,83,63,41,42,36.71,63.00,0.00
2024-12-10 17:17:46,84,63,42,42,36.27,63.01,0.00
2024-12-10 17:17:46,83,63,42,41,36.64,63.20,0.00
2024-12-10 17:17:46,83,64,42,41,37.42,64.00,0.00
2024-12-10 17:17:46,84,64,42,42,36.98,64.01,0.00
2024-12-10 17:17:46,84,65,42,42,37.69,65.00,0.00
2024-12-10 17:17:46,85,65,42,43,37.24,65.01,0.00
2024-12-10 17:17:46,85,66,42,43,37.94,66.00,0.00
2024-12-10 17:17:46,86,66,43,43,37.50,66.01,0.00
2024-12-10 17:17:46,86,67,43,43,38.18,67.00,0.00
2024-12-10 17:17:46,87,67,44,43,37.74,67.01,0.00
2024-12-10 17:17:46,87,68,44,43,38.42,68.00,0.00
2024-12-10 17:17:46,88,68,44,44,37.98,68.01,0.00
2024-12-10 17:17:46,89,67,45,44,37.49,68.20,0.00
2024-12-10 17:17:46,89,68,45,44,38.74,69.00,0.00
2024-12-10 17:17:46,90,68,45,45,38.31,69.01,0.00
2024-12-10 17:17:46,90,69,45,45,39.73,70.00,0.00
2024-12-10 17:17:46,91,69,46,45,39.29,70.01,0.00
2024-12-10 17:17:46,91,70,46,45,39.93,71.00,0.00
2024-12-10 17:17:46,92,70,47,45,39.50,71.01,0.00
2024-12-10 17:17:46,92,71,47,45,40.13,72.00,0.00
2024-12-10 17:17:46,93,71,47,46,39.69,72.01,0.00
2024-12-10 17:17:46,93,72,47,46,40.31,73.00,0.00
2024-12-10 17:17:46,94,72,47,47,39.88,73.01,0.00
2024-12-10 17:17:46,94,73,47,47,40.48,74.00,0.00
2024-12-10 17:17:46,95,73,47,48,40.05,74.01,0.00
2024-12-10 17:17:46,94,73,46,48,40.46,74.04,0.00
2024-12-10 17:17:46,93,73,45,48,40.88,74.05,0.00
2024-12-10 17:17:46,93,74,45,48,41.52,75.00,0.00
2024-12-10 17:17:46,94,74,45,49,41.08,75.01,0.00
2024-12-10 17:17:46,94,75,45,49,41.68,76.00,0.00
2024-12-10 17:17:46,95,75,46,49,41.25,76.01,0.00
2024-12-10 17:17:46,95,76,46,49,41.82,77.00,0.00
2024-12-10 17:17:46,96,76,46,50,41.39,77.01,0.00
2024-12-10 17:17:46,96,77,46,50,41.96,78.00,0.00
2024-12-10 17:17:46,97,77,47,50,41.52,78.01,0.00
2024-12-10 17:17:46,97,78,47,50,42.08,79.00,0.00
2024-12-10 17:17:46,98,78,48,50,41.65,79.01,0.00
2024-12-10 17:17:46,98,79,48,50,42.20,80.00,0.00
2024-12-10 17:17:46,99,79,48,51,41.78,80.01,0.00
2024-12-10 17:17:46,99,80,48,51,42.31,81.00,0.00
2024-12-10 17:17:46,100,80,48,52,41.89,81.01,0.00
2024-12-10 17:17:46,100,81,48,52,42.41,82.00,0.00
2024-12-10 17:17:46,101,81,49,52,41.99,82.01,0.00
2024-12-10 17:17:46,101,82,49,52,42.49,83.00,0.00
2024-12-10 17:17:46,102,82,49,53,42.07,83.01,0.00
2024-12-10 17:17:46,102,83,49,53,42.57,84.00,0.00
2024-12-10 17:17:46,103,83,49,54,42.15,84.01,0.00
2024-12-10 17:17:46,103,84,49,54,42.64,85.00,0.00
2024-12-10 17:17:46,104,84,50,54,42.23,85.01,0.00
2024-12-10 17:17:46,104,85,50,54,42.70,86.00,0.00
2024-12-10 17:17:46,105,85,50,55,42.30,86.01,0.00
2024-12-10 17:17:46,104,85,50,54,42.42,86.24,0.00
2024-12-10 17:17:46,104,86,50,54,43.06,87.00,0.00
2024-12-10 17:17:46,105,86,51,54,42.65,87.01,0.00
2024-12-10 17:17:46,105,87,51,54,43.10,88.00,0.00
2024-12-10 17:17:46,106,87,52,54,42.70,88.01,0.00
2024-12-10 17:17:47,106,88,52,54,43.14,89.00,0.00
2024-12-10 17:17:47,107,88,53,54,42.74,89.01,0.00
2024-12-10 17:17:47,107,89,53,54,43.17,90.00,0.00
2024-12-10 17:17:47,108,89,53,55,42.77,90.01,0.00
2024-12-10 17:17:47,108,90,53,55,43.18,91.00,0.00
2024-12-10 17:17:47,109,90,53,56,42.79,91.01,0.00
2024-12-10 17:17:47,108,90,53,55,43.07,91.15,0.00
2024-12-10 17:17:47,108,91,53,55,43.59,92.00,0.00
2024-12-10 17:17:47,109,91,54,55,43.19,92.01,0.00
2024-12-10 17:17:47,109,92,54,55,43.59,93.00,0.00
2024-12-10 17:17:47,110,92,55,55,43.20,93.01,0.00
2024-12-10 17:17:47,109,92,55,54,43.49,93.12,0.00
2024-12-10 17:17:47,109,93,55,54,43.99,94.00,0.00
2024-12-10 17:17:47,110,93,55,55,43.59,94.01,0.00
2024-12-10 17:17:47,110,94,55,55,43.97,95.00,0.00
2024-12-10 17:17:47,111,94,56,55,43.58,95.01,0.00
2024-12-10 17:17:47,111,95,56,55,43.95,96.00,0.00
2024-12-10 17:17:47,112,95,56,56,43.56,96.01,0.00
2024-12-10 17:17:47,112,96,56,56,43.92,97.00,0.00
2024-12-10 17:17:47,113,96,57,56,43.53,97.01,0.00
2024-12-10 17:17:47,113,97,57,56,43.87,98.00,0.00
2024-12-10 17:17:47,114,97,57,57,43.49,98.01,0.00
2024-12-10 17:17:47,113,97,57,56,43.76,98.12,0.00
2024-12-10 17:17:47,113,98,57,56,44.21,99.00,0.00
2024-12-10 17:17:47,114,98,58,56,43.82,99.01,0.00
2024-12-10 17:17:47,113,98,57,56,44.20,99.01,0.00
2024-12-10 17:17:47,112,98,56,56,44.59,99.01,0.00
2024-12-10 17:17:47,111,98,56,55,44.98,99.01,0.00
2024-12-10 17:17:47,110,98,56,54,45.38,99.01,0.00
2024-12-10 17:17:47,109,98,56,53,45.79,99.01,0.00
2024-12-10 17:17:47,108,98,55,53,46.20,99.01,0.00
2024-12-10 17:17:47,107,98,55,52,46.62,99.01,0.00
2024-12-10 17:17:47,106,98,54,52,47.05,99.01,0.00
2024-12-10 17:17:47,105,98,54,51,47.49,99.01,0.00
2024-12-10 17:17:47,104,98,53,51,47.94,99.01,0.00
2024-12-10 17:17:47,103,98,53,50,48.39,99.01,0.00
2024-12-10 17:17:47,102,98,52,50,48.86,99.01,0.00
2024-12-10 17:17:47,101,98,51,50,49.33,99.02,0.00
2024-12-10 17:17:47,100,98,50,50,49.81,99.02,0.00
2024-12-10 17:17:47,99,98,49,50,50.31,99.02,0.00
2024-12-10 17:17:47,98,98,48,50,50.81,99.02,0.00
2024-12-10 17:17:47,97,98,48,49,51.32,99.02,0.00
2024-12-10 17:17:47,96,98,47,49,51.85,99.02,0.00
2024-12-10 17:17:47,95,98,46,49,52.38,99.02,0.00
2024-12-10 17:17:47,94,98,45,49,52.93,99.02,0.00
2024-12-10 17:17:47,93,98,45,48,53.49,99.02,0.00
2024-12-10 17:17:47,92,98,44,48,54.06,99.02,0.00
2024-12-10 17:17:47,92,99,44,48,54.71,100.00,0.00
2024-12-10 17:17:47,93,99,45,48,54.12,100.01,0.00
2024-12-10 17:17:47,93,100,45,48,54.75,101.00,0.00
2024-12-10 17:17:47,94,100,45,49,54.16,101.01,0.00
2024-12-10 17:17:47,94,101,45,49,54.78,102.00,0.00
2024-12-10 17:17:47,95,101,45,50,54.20,102.01,0.00
2024-12-10 17:17:47,95,102,45,50,54.80,103.00,0.00
2024-12-10 17:17:47,96,102,45,51,54.23,103.01,0.00
2024-12-10 17:17:47,96,103,45,51,54.81,104.00,0.00
2024-12-10 17:17:47,97,103,46,51,54.24,104.01,0.00
2024-12-10 17:17:47,97,104,46,51,54.81,105.00,0.00
2024-12-10 17:17:47,98,104,47,51,54.25,105.01,0.00
2024-12-10 17:17:47,98,105,47,51,54.80,106.00,0.00
2024-12-10 17:17:47,99,105,47,52,54.24,106.01,0.00
2024-12-10 17:17:47,99,106,47,52,54.78,107.00,0.00
2024-12-10 17:17:47,100,106,48,52,54.23,107.01,0.00
2024-12-10 17:17:47,100,107,48,52,54.75,108.00,0.00
2024-12-10 17:17:47,101,107,48,53,54.20,108.01,0.00
2024-12-10 17:17:47,101,108,48,53,54.71,109.00,0.00
2024-12-10 17:17:47,102,108,48,54,54.17,109.01,0.00
2024-12-10 17:17:47,102,109,48,54,54.65,110.00,0.00
2024-12-10 17:17:47,103,109,48,55,54.12,110.01,0.00
2024-12-10 17:17:47,102,109,48,54,54.64,110.02,0.00
2024-12-10 17:17:47,102,110,48,54,55.13,111.00,0.00
2024-12-10 17:17:47,103,110,48,55,54.59,111.01,0.00
2024-12-10 17:17:47,102,110,47,55,55.11,111.02,0.00
2024-12-10 17:17:47,102,111,47,55,55.60,112.00,0.00
2024-12-10 17:17:47,103,111,47,56,55.06,112.01,0.00
2024-12-10 17:17:47,102,111,46,56,55.59,112.02,0.00
2024-12-10 17:17:47,102,112,46,56,56.08,113.00,0.00
2024-12-10 17:17:47,103,112,46,57,55.53,113.01,0.00
2024-12-10 17:17:47,102,112,45,57,56.06,113.02,0.00
2024-12-10 17:17:47,102,113,45,57,56.55,114.00,0.00
2024-12-10 17:17:47,103,113,45,58,56.00,114.01,0.00
2024-12-10 17:17:47,102,113,45,57,56.54,114.02,0.00
2024-12-10 17:17:47,102,114,45,57,57.03,115.00,0.00
2024-12-10 17:17:47,103,114,46,57,56.47,115.01,0.00
2024-12-10 17:17:47,102,114,45,57,57.01,115.02,0.00
2024-12-10 17:17:47,102,115,45,57,57.50,116.00,0.00
2024-12-10 17:17:47,103,115,46,57,56.94,116.01,0.00
2024-12-10 17:17:47,102,115,45,57,57.48,116.02,0.00
2024-12-10 17:17:47,102,116,45,57,57.97,117.00,0.00
2024-12-10 17:17:47,103,116,46,57,57.41,117.01,0.00
2024-12-10 17:17:47,102,116,46,56,57.95,117.02,0.00
2024-12-10 17:17:47,102,117,46,56,58.44,118.00,0.00
2024-12-10 17:17:47,103,117,47,56,57.88,118.01,0.00
2024-12-10 17:17:47,102,117,46,56,58.43,118.02,0.00
2024-12-10 17:17:47,102,118,46,56,58.92,119.00,0.00
2024-12-10 17:17:47,103,118,47,56,58.34,119.01,0.00
2024-12-10 17:17:47,102,118,47,55,58.90,119.02,0.00
2024-12-10 17:17:47,102,119,47,55,59.39,120.00,0.00
2024-12-10 17:17:47,103,119,47,56,58.81,120.01,0.00
2024-12-10 17:17:47,102,119,47,55,59.37,120.02,0.00
2024-12-10 17:17:47,102,120,47,55,59.86,121.00,0.00
2024-12-10 17:17:47,103,120,47,56,59.28,121.01,0.00
2024-12-10 17:17:47,102,120,47,55,59.84,121.02,0.00
2024-12-10 17:17:48,102,121,47,55,60.33,122.00,0.00
2024-12-10 17:17:48,103,121,48,55,59.74,122.01,0.00
2024-12-10 17:17:48,102,121,48,54,60.31,122.02,0.00
2024-12-10 17:17:48,103,120,49,54,59.37,122.38,0.00
2024-12-10 17:17:48,103,121,49,54,60.97,123.00,0.00
2024-12-10 17:17:48,104,121,50,54,60.39,123.01,0.00
2024-12-10 17:17:48,103,121,50,53,60.96,123.02,0.00
2024-12-10 17:17:48,103,122,50,53,62.64,124.00,0.00
2024-12-10 17:17:48,104,122,51,53,62.04,124.01,0.00
2024-12-10 17:17:48,103,122,50,53,62.62,124.02,0.00
2024-12-10 17:17:48,103,123,50,53,63.11,125.00,0.00
2024-12-10 17:17:48,104,123,51,53,62.50,125.01,0.00
2024-12-10 17:17:48,103,123,51,52,63.09,125.02,0.00
2024-12-10 17:17:48,103,124,51,52,63.57,126.00,0.00
2024-12-10 17:17:48,104,124,52,52,62.96,126.01,0.00
2024-12-10 17:17:48,103,124,52,51,63.55,126.02,0.00
2024-12-10 17:17:48,103,125,52,51,64.04,127.00,0.00
2024-12-10 17:17:48,104,125,53,51,63.43,127.01,0.00
2024-12-10 17:17:48,103,125,52,51,64.02,127.02,0.00
2024-12-10 17:17:48,103,126,52,51,64.51,128.00,0.00
2024-12-10 17:17:48,104,126,52,52,63.89,128.01,0.00
2024-12-10 17:17:48,103,126,52,51,64.49,128.02,0.00
2024-12-10 17:17:48,103,127,52,51,64.98,129.00,0.00
2024-12-10 17:17:48,104,127,52,52,64.35,129.01,0.00
2024-12-10 17:17:48,103,127,51,52,64.95,129.02,0.00
2024-12-10 17:17:48,103,128,51,52,65.44,130.00,0.00
2024-12-10 17:17:48,104,128,51,53,64.81,130.01,0.00
2024-12-10 17:17:48,103,128,50,53,65.42,130.02,0.00
2024-12-10 17:17:48,103,129,50,53,65.91,131.00,0.00
2024-12-10 17:17:48,104,129,51,53,65.27,131.01,0.00
2024-12-10 17:17:48,103,129,50,53,65.89,131.02,0.00
2024-12-10 17:17:48,103,130,50,53,66.37,132.00,0.00
2024-12-10 17:17:48,104,130,51,53,65.73,132.01,0.00
2024-12-10 17:17:48,103,130,51,52,66.35,132.02,0.00
2024-12-10 17:17:48,103,131,51,52,66.84,133.00,0.00
2024-12-10 17:17:48,104,131,51,53,66.19,133.01,0.00
2024-12-10 17:17:48,103,131,51,52,66.81,133.02,0.00
2024-12-10 17:17:48,103,132,51,52,67.30,134.00,0.00
2024-12-10 17:17:48,104,132,51,53,66.65,134.01,0.00
2024-12-10 17:17:48,103,132,50,53,67.28,134.02,0.00
2024-12-10 17:17:48,103,133,50,53,67.76,135.00,0.00
2024-12-10 17:17:48,104,133,51,53,67.11,135.01,0.00
2024-12-10 17:17:48,103,133,51,52,67.74,135.02,0.00
2024-12-10 17:17:48,103,134,51,52,68.22,136.00,0.00
2024-12-10 17:17:48,104,134,51,53,67.57,136.01,0.00
2024-12-10 17:17:48,103,134,51,52,68.20,136.02,0.00
2024-12-10 17:17:48,103,135,51,52,68.69,137.00,0.00
2024-12-10 17:17:48,104,135,52,52,68.03,137.01,0.00
2024-12-10 17:17:48,103,135,51,52,68.66,137.02,0.00
2024-12-10 17:17:48,103,136,51,52,69.15,138.00,0.00
2024-12-10 17:17:48,104,136,51,53,68.48,138.01,0.00
2024-12-10 17:17:48,103,136,51,52,69.12,138.02,0.00
2024-12-10 17:17:48,103,137,51,52,69.61,139.00,0.00
2024-12-10 17:17:48,104,137,51,53,68.94,139.01,0.00
2024-12-10 17:17:48,103,137,51,52,69.58,139.02,0.00
2024-12-10 17:17:48,103,138,51,52,70.07,140.00,0.00
2024-12-10 17:17:48,104,138,52,52,69.39,140.01,0.00
2024-12-10 17:17:48,103,138,52,51,70.04,140.02,0.00
2024-12-10 17:17:48,103,139,52,51,70.53,141.00,0.00
2024-12-10 17:17:48,104,139,52,52,69.85,141.01,0.00
2024-12-10 17:17:48,103,139,51,52,70.50,141.02,0.00
2024-12-10 17:17:48,103,140,51,52,70.99,142.00,0.00
2024-12-10 17:17:48,104,140,52,52,70.30,142.01,0.00
2024-12-10 17:17:48,103,140,51,52,70.96,142.02,0.00
2024-12-10 17:17:48,103,141,51,52,71.44,143.00,0.00
2024-12-10 17:17:48,104,141,52,52,70.76,143.01,0.00
2024-12-10 17:17:48,103,141,51,52,71.42,143.02,0.00
2024-12-10 17:17:48,103,142,51,52,71.90,144.00,0.00
2024-12-10 17:17:48,104,142,51,53,71.21,144.01,0.00
2024-12-10 17:17:48,103,142,50,53,71.88,144.02,0.00
2024-12-10 17:17:48,103,143,50,53,72.36,145.00,0.00
2024-12-10 17:17:48,104,143,50,54,71.66,145.01,0.00
2024-12-10 17:17:48,103,143,50,53,72.33,145.02,0.00
2024-12-10 17:17:48,103,144,50,53,72.82,146.00,0.00
2024-12-10 17:17:48,104,144,51,53,72.12,146.01,0.00
2024-12-10 17:17:48,103,144,51,52,72.79,146.02,0.00
2024-12-10 17:17:48,103,145,51,52,73.27,147.00,0.00
2024-12-10 17:17:48,104,145,52,52,72.57,147.01,0.00
2024-12-10 17:17:48,103,145,51,52,73.25,147.02,0.00
2024-12-10 17:17:48,103,146,51,52,73.73,148.00,0.00
2024-12-10 17:17:48,104,146,52,52,73.02,148.01,0.00
2024-12-10 17:17:48,103,146,51,52,73.70,148.02,0.00
2024-12-10 17:17:48,103,147,51,52,74.18,149.00,0.00
2024-12-10 17:17:48,104,147,52,52,73.47,149.01,0.00
2024-12-10 17:17:48,103,147,52,51,74.15,149.02,0.00
2024-12-10 17:17:48,103,148,52,51,74.64,150.00,0.00
2024-12-10 17:17:48,104,148,53,51,73.92,150.01,0.00
2024-12-10 17:17:48,103,148,53,50,74.61,150.02,0.00
2024-12-10 17:17:48,103,149,53,50,75.09,151.00,0.00
2024-12-10 17:17:48,104,149,53,51,74.37,151.01,0.00
2024-12-10 17:17:48,103,149,53,50,75.06,151.02,0.00
2024-12-10 17:17:49,103,150,53,50,75.54,152.00,0.00
2024-12-10 17:17:49,104,150,54,50,74.82,152.01,0.00
2024-12-10 17:17:49,103,150,53,50,75.51,152.02,0.00
2024-12-10 17:17:49,103,151,53,50,75.99,153.00,0.00
2024-12-10 17:17:49,104,151,53,51,75.26,153.01,0.00
2024-12-10 17:17:49,103,151,53,50,75.97,153.02,0.00
2024-12-10 17:17:49,103,152,53,50,76.45,154.00,0.00
2024-12-10 17:17:49,104,152,54,50,75.71,154.01,0.00
2024-12-10 17:17:49,103,152,54,49,76.42,154.02,0.00
2024-12-10 17:17:49,103,153,54,49,76.90,155.00,0.00
2024-12-10 17:17:49,104,153,55,49,76.16,155.01,0.00
2024-12-10 17:17:49,103,153,55,48,76.87,155.02,0.00
2024-12-10 17:17:49,103,154,55,48,77.35,156.00,0.00
2024-12-10 17:17:49,104,154,55,49,76.60,156.01,0.00
2024-12-10 17:17:49,103,154,54,49,77.32,156.02,0.00
2024-12-10 17:17:49,103,155,54,49,77.80,157.00,0.00
2024-12-10 17:17:49,104,155,54,50,77.05,157.01,0.00
2024-12-10 17:17:49,103,155,53,50,77.77,157.02,0.00
2024-12-10 17:17:49,103,156,53,50,78.25,158.00,0.00
2024-12-10 17:17:49,104,156,53,51,77.50,158.01,0.00
2024-12-10 17:17:49,104,157,53,51,77.94,159.00,0.00
2024-12-10 17:17:49,105,157,53,52,77.20,159.01,0.00
2024-12-10 17:17:49,104,157,52,52,77.90,159.03,0.00
2024-12-10 17:17:49,104,158,52,52,78.37,160.00,0.00
2024-12-10 17:17:49,105,158,53,52,77.62,160.01,0.00
2024-12-10 17:17:49,104,158,53,51,78.33,160.03,0.00
2024-12-10 17:17:49,104,159,53,51,78.80,161.00,0.00
2024-12-10 17:17:49,105,159,53,52,78.05,161.01,0.00
2024-12-10 17:17:49,104,159,53,51,78.76,161.03,0.00
2024-12-10 17:17:49,104,160,53,51,79.22,162.00,0.00
2024-12-10 17:17:49,105,160,54,51,78.47,162.01,0.00
2024-12-10 17:17:49,104,160,53,51,79.18,162.03,0.00
2024-12-10 17:17:49,104,161,53,51,79.65,163.00,0.00
2024-12-10 17:17:49,105,161,53,52,78.89,163.01,0.00
2024-12-10 17:17:49,104,161,52,52,79.61,163.03,0.00
2024-12-10 17:17:49,104,162,52,52,80.08,164.00,0.00
2024-12-10 17:17:49,105,162,53,52,79.31,164.01,0.00
2024-12-10 17:17:49,104,162,53,51,80.03,164.03,0.00
2024-12-10 17:17:49,104,163,53,51,80.50,165.00,0.00
2024-12-10 17:17:49,105,163,53,52,79.73,165.01,0.00
2024-12-10 17:17:49,104,163,53,51,80.46,165.03,0.00
2024-12-10 17:17:49,104,164,53,51,80.92,166.00,0.00
2024-12-10 17:17:49,105,164,53,52,80.15,166.01,0.00
2024-12-10 17:17:49,104,164,52,52,80.88,166.03,0.00
2024-12-10 17:17:49,104,165,52,52,81.35,167.00,0.00
2024-12-10 17:17:49,105,165,52,53,80.57,167.01,0.00
2024-12-10 17:17:49,104,165,51,53,81.31,167.03,0.00
2024-12-10 17:17:49,104,166,51,53,81.77,168.00,0.00
2024-12-10 17:17:49,105,166,51,54,80.99,168.01,0.00
2024-12-10 17:17:49,104,166,51,53,81.75,168.01,0.00
2024-12-10 17:17:49,103,166,51,52,82.52,168.02,0.00
2024-12-10 17:17:49,102,166,50,52,83.31,168.02,0.00
2024-12-10 17:17:49,102,167,50,52,83.80,169.00,0.00
2024-12-10 17:17:49,103,167,50,53,82.99,169.01,0.00
2024-12-10 17:17:49,102,167,50,52,83.78,169.02,0.00
2024-12-10 17:17:49,102,168,50,52,84.27,170.00,0.00
2024-12-10 17:17:49,103,168,51,52,83.45,170.01,0.00
2024-12-10 17:17:49,102,168,50,52,84.24,170.02,0.00
2024-12-10 17:17:49,102,169,50,52,84.73,171.00,0.00
2024-12-10 17:17:49,103,169,51,52,83.91,171.01,0.00
2024-12-10 17:17:49,102,169,50,52,84.70,171.02,0.00
2024-12-10 17:17:49,102,170,50,52,85.19,172.00,0.00
2024-12-10 17:17:49,103,170,51,52,84.36,172.01,0.00
2024-12-10 17:17:49,102,170,51,51,85.16,172.02,0.00
2024-12-10 17:17:49,102,171,51,51,85.65,173.00,0.00
2024-12-10 17:17:49,103,171,51,52,84.82,173.01,0.00
2024-12-10 17:17:49,102,171,51,51,85.62,173.02,0.00
2024-12-10 17:17:49,102,172,51,51,86.11,174.00,0.00
2024-12-10 17:17:49,103,172,52,51,85.28,174.01,0.00
2024-12-10 17:17:49,102,172,52,50,86.08,174.02,0.00
2024-12-10 17:17:49,102,173,52,50,86.57,175.00,0.00
2024-12-10 17:17:49,103,173,52,51,85.73,175.01,0.00
2024-12-10 17:17:49,102,173,52,50,86.54,175.02,0.00
2024-12-10 17:17:49,102,174,52,50,87.03,176.00,0.00
2024-12-10 17:17:49,103,174,53,50,86.19,176.01,0.00
2024-12-10 17:17:49,102,174,52,50,87.00,176.02,0.00
2024-12-10 17:17:49,102,175,52,50,87.49,177.00,0.00
2024-12-10 17:17:49,103,175,53,50,86.64,177.01,0.00
2024-12-10 17:17:49,102,175,53,49,87.46,177.02,0.00
2024-12-10 17:17:49,102,176,53,49,87.95,178.00,0.00
2024-12-10 17:17:49,103,176,54,49,87.10,178.01,0.00
2024-12-10 17:17:49,102,176,53,49,87.92,178.02,0.00
2024-12-10 17:17:49,102,177,53,49,88.41,179.00,0.00
2024-12-10 17:17:49,103,177,53,50,87.55,179.01,0.00
2024-12-10 17:17:49,102,177,52,50,88.38,179.02,0.00
2024-12-10 17:17:50,102,178,52,50,88.87,180.00,0.00
2024-12-10 17:17:50,103,178,53,50,88.01,180.01,0.00
2024-12-10 17:17:50,102,178,53,49,88.84,180.02,0.00
2024-12-10 17:17:50,102,179,53,49,89.33,181.00,0.00
2024-12-10 17:17:50,103,179,53,50,88.46,181.01,0.00
2024-12-10 17:17:50,102,179,53,49,89.30,181.02,0.00
2024-12-10 17:17:50,102,180,53,49,89.79,182.00,0.00
2024-12-10 17:17:50,103,180,53,50,88.91,182.01,0.00
2024-12-10 17:17:50,102,180,52,50,89.75,182.02,0.00
2024-12-10 17:17:50,102,181,52,50,90.24,183.00,0.00
2024-12-10 17:17:50,103,181,53,50,89.37,183.01,0.00
2024-12-10 17:17:50,102,181,53,49,90.21,183.02,0.00
2024-12-10 17:17:50,102,182,53,49,90.70,184.00,0.00
2024-12-10 17:17:50,103,182,54,49,89.82,184.01,0.00
2024-12-10 17:17:50,102,182,54,48,90.67,184.02,0.00
2024-12-10 17:17:50,102,183,54,48,91.16,185.00,0.00
2024-12-10 17:17:50,103,183,55,48,90.27,185.01,0.00
2024-12-10 17:17:50,102,183,54,48,91.13,185.02,0.00
2024-12-10 17:17:50,102,184,54,48,91.61,186.00,0.00
2024-12-10 17:17:50,103,184,54,49,90.72,186.01,0.00
2024-12-10 17:17:50,102,184,54,48,91.58,186.02,0.00
2024-12-10 17:17:50,102,185,54,48,92.07,187.00,0.00
2024-12-10 17:17:50,103,185,54,49,91.18,187.01,0.00
2024-12-10 17:17:50,102,185,53,49,92.04,187.02,0.00
2024-12-10 17:17:50,102,186,53,49,92.53,188.00,0.00
2024-12-10 17:17:50,103,186,53,50,91.63,188.01,0.00
2024-12-10 17:17:50,102,186,52,50,92.49,188.02,0.00
2024-12-10 17:17:50,102,187,52,50,92.98,189.00,0.00
2024-12-10 17:17:50,103,187,53,50,92.08,189.01,0.00
2024-12-10 17:17:50,102,187,52,50,92.95,189.02,0.00
2024-12-10 17:17:50,102,188,52,50,93.44,190.00,0.00
2024-12-10 17:17:50,103,188,53,50,92.53,190.01,0.00
2024-12-10 17:17:50,102,188,53,49,93.40,190.02,0.00
2024-12-10 17:17:50,102,189,53,49,93.89,191.00,0.00
2024-12-10 17:17:50,103,189,54,49,92.98,191.01,0.00
2024-12-10 17:17:50,102,189,54,48,93.86,191.02,0.00
2024-12-10 17:17:50,102,190,54,48,94.34,192.00,0.00
2024-12-10 17:17:50,103,190,54,49,93.43,192.01,0.00
2024-12-10 17:17:50,102,190,53,49,94.31,192.02,0.00
2024-12-10 17:17:50,102,191,53,49,94.80,193.00,0.00
2024-12-10 17:17:50,103,191,53,50,93.88,193.01,0.00
2024-12-10 17:17:50,102,191,52,50,94.76,193.02,0.00
2024-12-10 17:17:50,102,192,52,50,95.25,194.00,0.00
2024-12-10 17:17:50,103,192,52,51,94.33,194.01,0.00
2024-12-10 17:17:50,102,192,52,50,95.21,194.02,0.00
2024-12-10 17:17:50,102,193,52,50,95.70,195.00,0.00
2024-12-10 17:17:50,103,193,53,50,94.77,195.01,0.00
2024-12-10 17:17:50,102,193,52,50,95.67,195.02,0.00
2024-12-10 17:17:50,102,194,52,50,96.16,196.00,0.00
2024-12-10 17:17:50,103,194,53,50,95.22,196.01,0.00
2024-12-10 17:17:50,102,194,53,49,96.12,196.02,0.00
2024-12-10 17:17:50,102,195,53,49,96.61,197.00,0.00
2024-12-10 17:17:50,103,195,53,50,95.67,197.01,0.00
2024-12-10 17:17:50,102,195,52,50,96.57,197.02,0.00
2024-12-10 17:17:50,102,196,52,50,97.06,198.00,0.00
2024-12-10 17:17:50,103,196,53,50,96.12,198.01,0.00
2024-12-10 17:17:50,102,196,53,49,97.02,198.02,0.00
2024-12-10 17:17:50,102,197,53,49,97.51,199.00,0.00
2024-12-10 17:17:50,103,197,54,49,96.56,199.01,0.00
2024-12-10 17:17:50,102,197,53,49,97.47,199.02,0.00
2024-12-10 17:17:50,102,198,53,49,97.96,200.00,0.00
2024-12-10 17:17:50,103,198,54,49,97.01,200.01,0.00
2024-12-10 17:17:50,102,198,53,49,97.92,200.02,0.00
2024-12-10 17:17:50,102,199,53,49,98.41,201.00,0.00
2024-12-10 17:17:50,103,199,54,49,97.46,201.01,0.00
2024-12-10 17:17:50,102,199,54,48,98.37,201.02,0.00
2024-12-10 17:17:50,102,200,54,48,98.86,202.00,0.00
2024-12-10 17:17:50,103,200,54,49,97.90,202.01,0.00
2024-12-10 17:17:50,102,200,54,48,98.82,202.02,0.00
2024-12-10 17:17:50,102,201,54,48,99.31,203.00,0.00
2024-12-10 17:17:50,103,201,54,49,98.35,203.01,0.00
2024-12-10 17:17:50,102,201,54,48,99.27,203.02,0.00
2024-12-10 17:17:50,102,202,54,48,99.76,204.00,0.00
2024-12-10 17:17:50,103,202,54,49,98.79,204.01,0.00
2024-12-10 17:17:50,102,202,53,49,99.72,204.02,0.00
2024-12-10 17:17:50,102,203,53,49,100.21,205.00,0.00
2024-12-10 17:17:50,103,203,53,50,99.24,205.01,0.00
2024-12-10 17:17:50,102,203,52,50,100.17,205.02,0.00
2024-12-10 17:17:50,102,204,52,50,100.66,206.00,0.00
2024-12-10 17:17:50,103,204,53,50,99.68,206.01,0.00
2024-12-10 17:17:50,102,204,53,49,100.62,206.02,0.00
2024-12-10 17:17:50,102,205,53,49,101.11,207.00,0.00
2024-12-10 17:17:50,103,205,53,50,100.12,207.01,0.00
2024-12-10 17:17:50,102,205,52,50,101.07,207.02,0.00
2024-12-10 17:17:50,102,206,52,50,101.55,208.00,0.00
2024-12-10 17:17:50,103,206,53,50,100.57,208.01,0.00
2024-12-10 17:17:50,102,206,53,49,101.51,208.02,0.00
2024-12-10 17:17:51,102,207,53,49,102.00,209.00,0.00
2024-12-10 17:17:51,103,207,54,49,101.01,209.01,0.00
2024-12-10 17:17:51,102,207,54,48,101.96,209.02,0.00
2024-12-10 17:17:51,102,208,54,48,102.45,210.00,0.00
2024-12-10 17:17:51,103,208,54,49,101.45,210.01,0.00
2024-12-10 17:17:51,102,208,54,48,102.41,210.02,0.00
2024-12-10 17:17:51,102,209,54,48,102.89,211.00,0.00
2024-12-10 17:17:51,103,209,55,48,101.89,211.01,0.00
2024-12-10 17:17:51,102,209,55,47,102.85,211.02,0.00
2024-12-10 17:17:51,102,210,55,47,103.34,212.00,0.00
2024-12-10 17:17:51,103,210,55,48,102.34,212.01,0.00
2024-12-10 17:17:51,102,210,55,47,103.30,212.02,0.00
2024-12-10 17:17:51,102,211,55,47,103.79,213.00,0.00
2024-12-10 17:17:51,103,211,56,47,102.78,213.01,0.00
2024-12-10 17:17:51,102,211,56,46,103.74,213.02,0.00
2024-12-10 17:17:51,102,212,56,46,104.23,214.00,0.00
2024-12-10 17:17:51,103,212,57,46,103.22,214.01,0.00
2024-12-10 17:17:51,102,212,57,45,104.19,214.02,0.00
2024-12-10 17:17:51,103,211,58,45,103.10,214.08,0.00
2024-12-10 17:17:51,103,212,58,45,105.64,215.00,0.00
2024-12-10 17:17:51,104,212,58,46,104.63,215.01,0.00
2024-12-10 17:17:51,103,212,57,46,105.60,215.02,0.00
2024-12-10 17:17:51,103,213,57,46,108.17,216.00,0.00
2024-12-10 17:17:51,104,213,57,47,107.13,216.01,0.00
2024-12-10 17:17:51,103,213,56,47,108.13,216.02,0.00
2024-12-10 17:17:51,103,214,56,47,108.61,217.00,0.00
2024-12-10 17:17:51,104,214,57,47,107.56,217.01,0.00
2024-12-10 17:17:51,103,214,56,47,108.56,217.02,0.00
2024-12-10 17:17:51,103,215,56,47,109.04,218.00,0.00
2024-12-10 17:17:51,104,215,56,48,107.99,218.01,0.00
2024-12-10 17:17:51,103,215,55,48,109.00,218.02,0.00
2024-12-10 17:17:51,103,216,55,48,109.48,219.00,0.00
2024-12-10 17:17:51,104,216,56,48,108.43,219.01,0.00
2024-12-10 17:17:51,104,217,56,48,108.86,220.00,0.00
2024-12-10 17:17:51,105,217,56,49,107.82,220.01,0.00
2024-12-10 17:17:51,104,217,56,48,108.80,220.03,0.00
2024-12-10 17:17:51,105,216,56,49,107.00,220.43,0.00
2024-12-10 17:17:51,105,217,56,49,109.49,221.00,0.00
2024-12-10 17:17:51,106,217,56,50,108.46,221.01,0.00
2024-12-10 17:17:51,105,217,56,49,109.44,221.03,0.00
2024-12-10 17:17:51,105,218,56,49,111.99,222.00,0.00
2024-12-10 17:17:51,106,218,57,49,110.94,222.01,0.00
2024-12-10 17:17:51,105,218,56,49,111.97,222.01,0.00
2024-12-10 17:17:51,104,218,55,49,113.02,222.02,0.00
2024-12-10 17:17:51,103,218,54,49,114.09,222.02,0.00
2024-12-10 17:17:51,103,219,54,49,114.57,223.00,0.00
2024-12-10 17:17:51,104,219,55,49,113.47,223.01,0.00
2024-12-10 17:17:51,103,219,54,49,114.54,223.02,0.00
2024-12-10 17:17:51,103,220,54,49,115.02,224.00,0.00
2024-12-10 17:17:51,104,220,55,49,113.92,224.01,0.00
2024-12-10 17:17:51,103,220,54,49,114.99,224.02,0.00
2024-12-10 17:17:51,103,221,54,49,115.47,225.00,0.00
2024-12-10 17:17:51,104,221,54,50,114.36,225.01,0.00
2024-12-10 17:17:51,103,221,53,50,115.44,225.02,0.00
2024-12-10 17:17:51,103,222,53,50,115.92,226.00,0.00
2024-12-10 17:17:51,104,222,54,50,114.80,226.01,0.00
2024-12-10 17:17:51,103,222,53,50,115.88,226.02,0.00
2024-12-10 17:17:51,103,223,53,50,116.37,227.00,0.00
2024-12-10 17:17:51,104,223,53,51,115.25,227.01,0.00
2024-12-10 17:17:51,103,223,52,51,116.33,227.02,0.00
2024-12-10 17:17:51,103,224,52,51,116.81,228.00,0.00
2024-12-10 17:17:51,104,224,53,51,115.69,228.01,0.00
2024-12-10 17:17:51,103,224,53,50,116.78,228.02,0.00
2024-12-10 17:17:51,103,225,53,50,117.26,229.00,0.00
2024-12-10 17:17:51,104,225,54,50,116.13,229.01,0.00
2024-12-10 17:17:51,103,225,54,49,117.22,229.02,0.00
2024-12-10 17:17:51,103,226,54,49,117.70,230.00,0.00
2024-12-10 17:17:51,104,226,55,49,116.57,230.01,0.00
2024-12-10 17:17:51,103,226,55,48,117.67,230.02,0.00
2024-12-10 17:17:51,103,227,55,48,118.15,231.00,0.00
2024-12-10 17:17:51,104,227,56,48,117.01,231.01,0.00
2024-12-10 17:17:51,103,227,55,48,118.11,231.02,0.00
2024-12-10 17:17:51,103,228,55,48,118.59,232.00,0.00
2024-12-10 17:17:51,104,228,55,49,117.45,232.01,0.00
2024-12-10 17:17:51,103,228,54,49,118.55,232.02,0.00
2024-12-10 17:17:51,103,229,54,49,119.03,233.00,0.00
2024-12-10 17:17:51,104,229,55,49,117.89,233.01,0.00
2024-12-10 17:17:51,103,229,55,48,119.00,233.02,0.00
2024-12-10 17:17:51,103,230,55,48,119.48,234.00,0.00
2024-12-10 17:17:51,104,230,56,48,118.33,234.01,0.00
2024-12-10 17:17:51,103,230,56,47,119.44,234.02,0.00
2024-12-10 17:17:51,103,231,56,47,119.92,235.00,0.00
2024-12-10 17:17:51,104,231,56,48,118.77,235.01,0.00
2024-12-10 17:17:51,103,231,55,48,119.88,235.02,0.00
2024-12-10 17:17:51,103,232,55,48,120.36,236.00,0.00
2024-12-10 17:17:51,104,232,55,49,119.20,236.01,0.00
2024-12-10 17:17:51,103,232,55,48,120.32,236.02,0.00
2024-12-10 17:17:51,103,233,55,48,120.80,237.00,0.00
2024-12-10 17:17:51,104,233,55,49,119.64,237.01,0.00
2024-12-10 17:17:51,103,233,54,49,120.76,237.02,0.00
2024-12-10 17:17:51,103,234,54,49,121.24,238.00,0.00
2024-12-10 17:17:51,104,234,54,50,120.08,238.01,0.00
2024-12-10 17:17:51,103,234,54,49,121.20,238.02,0.00
2024-12-10 17:17:52,103,235,54,49,121.68,239.00,0.00
2024-12-10 17:17:52,104,235,54,50,120.51,239.01,0.00
2024-12-10 17:17:52,103,235,54,49,121.64,239.02,0.00
2024-12-10 17:17:52,103,236,54,49,122.12,240.00,0.00
2024-12-10 17:17:52,104,236,55,49,120.95,240.01,0.00
2024-12-10 17:17:52,103,236,54,49,122.08,240.02,0.00
2024-12-10 17:17:52,103,237,54,49,122.56,241.00,0.00
2024-12-10 17:17:52,104,237,54,50,121.38,241.01,0.00
2024-12-10 17:17:52,103,237,54,49,122.52,241.02,0.00
2024-12-10 17:17:52,103,238,54,49,123.00,242.00,0.00
2024-12-10 17:17:52,104,238,54,50,121.81,242.01,0.00
2024-12-10 17:17:52,103,238,53,50,122.96,242.02,0.00
2024-12-10 17:17:52,103,239,53,50,123.43,243.00,0.00
2024-12-10 17:17:52,104,239,54,50,122.25,243.01,0.00
2024-12-10 17:17:52,103,239,53,50,123.39,243.02,0.00
2024-12-10 17:17:52,103,240,53,50,123.87,244.00,0.00
2024-12-10 17:17:52,104,240,53,51,122.68,244.01,0.00
2024-12-10 17:17:52,103,240,53,50,123.83,244.02,0.00
2024-12-10 17:17:52,103,241,53,50,124.31,245.00,0.00
2024-12-10 17:17:52,104,241,53,51,123.11,245.01,0.00
2024-12-10 17:17:52,103,241,53,50,124.27,245.02,0.00
2024-12-10 17:17:52,103,242,53,50,124.74,246.00,0.00
2024-12-10 17:17:52,104,242,54,50,123.54,246.01,0.00
2024-12-10 17:17:52,103,242,53,50,124.70,246.02,0.00
2024-12-10 17:17:52,103,243,53,50,125.18,247.00,0.00
2024-12-10 17:17:52,104,243,54,50,123.97,247.01,0.00
2024-12-10 17:17:52,103,243,53,50,125.14,247.02,0.00
2024-12-10 17:17:52,103,244,53,50,125.61,248.00,0.00
2024-12-10 17:17:52,104,244,53,51,124.41,248.01,0.00
2024-12-10 17:17:52,103,244,52,51,125.57,248.02,0.00
2024-12-10 17:17:52,103,245,52,51,126.05,249.00,0.00
2024-12-10 17:17:52,104,245,53,51,124.84,249.01,0.00
2024-12-10 17:17:52,103,245,52,51,126.01,249.02,0.00
2024-12-10 17:17:52,103,246,52,51,126.48,250.00,0.00
2024-12-10 17:17:52,104,246,52,52,125.26,250.01,0.00
2024-12-10 17:17:52,103,246,51,52,126.44,250.02,0.00
2024-12-10 17:17:52,103,247,51,52,126.91,251.00,0.00
2024-12-10 17:17:52,104,247,51,53,125.69,251.01,0.00
2024-12-10 17:17:52,103,247,51,52,126.87,251.02,0.00
2024-12-10 17:17:52,103,248,51,52,127.35,252.00,0.00
2024-12-10 17:17:52,104,248,52,52,126.12,252.01,0.00
2024-12-10 17:17:52,103,248,51,52,127.30,252.02,0.00
2024-12-10 17:17:52,103,249,51,52,127.78,253.00,0.00
2024-12-10 17:17:52,104,249,51,53,126.55,253.01,0.00
2024-12-10 17:17:52,103,249,51,52,127.73,253.02,0.00
2024-12-10 17:17:52,103,250,51,52,128.21,254.00,0.00
2024-12-10 17:17:52,104,250,51,53,126.98,254.01,0.00
2024-12-10 17:17:52,103,250,50,53,128.16,254.02,0.00
2024-12-10 17:17:52,103,251,50,53,128.64,255.00,0.00
2024-12-10 17:17:52,104,251,51,53,127.40,255.01,0.00
2024-12-10 17:17:52,103,251,50,53,128.60,255.02,0.00
2024-12-10 17:17:52,103,252,50,53,129.07,256.00,0.00
2024-12-10 17:17:52,104,252,51,53,127.83,256.01,0.00
2024-12-10 17:17:52,103,252,51,52,129.02,256.02,0.00
2024-12-10 17:17:52,103,253,51,52,129.50,257.00,0.00
2024-12-10 17:17:52,104,253,52,52,128.25,257.01,0.00
2024-12-10 17:17:52,103,253,52,51,129.45,257.02,0.00
2024-12-10 17:17:52,103,254,52,51,129.93,258.00,0.00
2024-12-10 17:17:52,104,254,52,52,128.68,258.01,0.00
2024-12-10 17:17:52,103,254,52,51,129.88,258.02,0.00
2024-12-10 17:17:52,103,255,52,51,130.35,259.00,0.00
2024-12-10 17:17:52,104,255,52,52,129.10,259.01,0.00
2024-12-10 17:17:52,103,255,52,51,130.31,259.02,0.00
2024-12-10 17:17:52,103,256,52,51,130.78,260.00,0.00
2024-12-10 17:17:52,104,256,52,52,129.52,260.01,0.00
2024-12-10 17:17:52,104,257,52,52,129.95,261.00,0.00
2024-12-10 17:17:52,105,257,53,52,128.71,261.01,0.00
2024-12-10 17:17:52,104,257,53,51,129.88,261.03,0.00
2024-12-10 17:17:52,104,258,53,51,130.34,262.00,0.00
2024-12-10 17:17:52,105,258,53,52,129.10,262.01,0.00
2024-12-10 17:17:52,104,258,52,52,130.28,262.03,0.00
2024-12-10 17:17:52,104,259,52,52,130.74,263.00,0.00
2024-12-10 17:17:52,105,259,52,53,129.50,263.01,0.00
2024-12-10 17:17:52,104,259,52,52,130.68,263.03,0.00
2024-12-10 17:17:52,104,260,52,52,131.14,264.00,0.00
2024-12-10 17:17:52,105,260,52,53,129.89,264.01,0.00
2024-12-10 17:17:52,104,260,51,53,131.07,264.03,0.00
2024-12-10 17:17:52,104,261,51,53,131.53,265.00,0.00
2024-12-10 17:17:52,105,261,52,53,130.28,265.01,0.00
2024-12-10 17:17:52,104,261,52,52,131.47,265.03,0.00
2024-12-10 17:17:52,104,262,52,52,131.93,266.00,0.00
2024-12-10 17:17:52,105,262,53,52,130.67,266.01,0.00
2024-12-10 17:17:52,104,262,53,51,131.86,266.03,0.00
2024-12-10 17:17:52,104,263,53,51,132.32,267.00,0.00
2024-12-10 17:17:52,105,263,54,51,131.06,267.01,0.00
2024-12-10 17:17:52,104,263,54,50,132.25,267.03,0.00
2024-12-10 17:17:52,104,264,54,50,132.71,268.00,0.00
2024-12-10 17:17:52,105,264,54,51,131.45,268.01,0.00
2024-12-10 17:17:52,104,264,54,50,132.64,268.03,0.00
2024-12-10 17:17:53,104,265,54,50,133.10,269.00,0.00
2024-12-10 17:17:53,105,265,55,50,131.84,269.01,0.00
2024-12-10 17:17:53,104,265,55,49,133.03,269.03,0.00
2024-12-10 17:17:53,104,266,55,49,133.49,270.00,0.00
2024-12-10 17:17:53,105,266,55,50,132.22,270.01,0.00
2024-12-10 17:17:53,104,266,54,50,133.43,270.03,0.00
2024-12-10 17:17:53,104,267,54,50,133.88,271.00,0.00
2024-12-10 17:17:53,105,267,54,51,132.61,271.01,0.00
2024-12-10 17:17:53,104,267,53,51,133.82,271.03,0.00
2024-12-10 17:17:53,104,268,53,51,134.27,272.00,0.00
2024-12-10 17:17:53,105,268,53,52,132.99,272.01,0.00
2024-12-10 17:17:53,104,268,52,52,134.20,272.03,0.00
2024-12-10 17:17:53,104,269,52,52,134.66,273.00,0.00
2024-12-10 17:17:53,105,269,53,52,133.38,273.01,0.00
2024-12-10 17:17:53,104,269,53,51,134.59,273.03,0.00
2024-12-10 17:17:53,104,270,53,51,135.05,274.00,0.00
2024-12-10 17:17:53,105,270,53,52,133.76,274.01,0.00
2024-12-10 17:17:53,104,270,52,52,134.98,274.03,0.00
2024-12-10 17:17:53,104,271,52,52,135.44,275.00,0.00
2024-12-10 17:17:53,105,271,53,52,134.15,275.01,0.00
2024-12-10 17:17:53,104,271,53,51,135.37,275.03,0.00
2024-12-10 17:17:53,104,272,53,51,135.82,276.00,0.00
2024-12-10 17:17:53,105,272,54,51,134.53,276.01,0.00
2024-12-10 17:17:53,104,272,53,51,135.75,276.03,0.00
2024-12-10 17:17:53,104,273,53,51,136.21,277.00,0.00
2024-12-10 17:17:53,105,273,53,52,134.91,277.01,0.00
2024-12-10 17:17:53,104,273,52,52,136.14,277.03,0.00
2024-12-10 17:17:53,104,274,52,52,136.59,278.00,0.00
2024-12-10 17:17:53,105,274,53,52,135.29,278.01,0.00
2024-12-10 17:17:53,104,274,52,52,136.52,278.03,0.00
2024-12-10 17:17:53,104,275,52,52,136.98,279.00,0.00
2024-12-10 17:17:53,105,275,53,52,135.67,279.01,0.00
2024-12-10 17:17:53,104,275,53,51,136.91,279.03,0.00
2024-12-10 17:17:53,104,276,53,51,137.36,280.00,0.00
2024-12-10 17:17:53,105,276,54,51,136.05,280.01,0.00
2024-12-10 17:17:53,104,276,53,51,137.29,280.03,0.00
2024-12-10 17:17:53,104,277,53,51,137.74,281.00,0.00
2024-12-10 17:17:53,105,277,54,51,136.43,281.01,0.00
2024-12-10 17:17:53,104,277,54,50,137.67,281.03,0.00
2024-12-10 17:17:53,104,278,54,50,138.13,282.00,0.00
2024-12-10 17:17:53,105,278,54,51,136.81,282.01,0.00
2024-12-10 17:17:53,104,278,54,50,138.05,282.03,0.00
2024-12-10 17:17:53,104,279,54,50,138.51,283.00,0.00
2024-12-10 17:17:53,105,279,54,51,137.19,283.01,0.00
2024-12-10 17:17:53,104,279,53,51,138.43,283.03,0.00
2024-12-10 17:17:53,104,280,53,51,138.89,284.00,0.00
2024-12-10 17:17:53,105,280,54,51,137.56,284.01,0.00
2024-12-10 17:17:53,104,280,53,51,138.81,284.03,0.00
2024-12-10 17:17:53,104,281,53,51,139.27,285.00,0.00
2024-12-10 17:17:53,105,281,54,51,137.94,285.01,0.00
2024-12-10 17:17:53,104,281,53,51,139.19,285.03,0.00
2024-12-10 17:17:53,104,282,53,51,139.64,286.00,0.00
2024-12-10 17:17:53,105,282,53,52,138.32,286.01,0.00
2024-12-10 17:17:53,104,282,53,51,139.57,286.03,0.00
2024-12-10 17:17:53,104,283,53,51,140.02,287.00,0.00
2024-12-10 17:17:53,105,283,53,52,138.69,287.01,0.00
2024-12-10 17:17:53,104,283,53,51,139.95,287.03,0.00
2024-12-10 17:17:53,104,284,53,51,140.40,288.00,0.00
2024-12-10 17:17:53,105,284,53,52,139.06,288.01,0.00
2024-12-10 17:17:53,104,284,53,51,140.32,288.03,0.00
2024-12-10 17:17:53,104,285,53,51,140.78,289.00,0.00
2024-12-10 17:17:53,105,285,54,51,139.44,289.01,0.00
2024-12-10 17:17:53,104,285,53,51,140.70,289.03,0.00
2024-12-10 17:17:53,104,286,53,51,141.15,290.00,0.00
2024-12-10 17:17:53,105,286,54,51,139.81,290.01,0.00
2024-12-10 17:17:53,104,286,53,51,141.07,290.03,0.00
2024-12-10 17:17:53,104,287,53,51,141.53,291.00,0.00
2024-12-10 17:17:53,105,287,54,51,140.18,291.01,0.00
2024-12-10 17:17:53,104,287,53,51,141.45,291.03,0.00
2024-12-10 17:17:53,104,288,53,51,141.90,292.00,0.00
2024-12-10 17:17:53,105,288,53,52,140.55,292.01,0.00
2024-12-10 17:17:53,104,288,53,51,141.82,292.03,0.00
2024-12-10 17:17:53,104,289,53,51,142.27,293.00,0.00
2024-12-10 17:17:53,105,289,54,51,140.92,293.01,0.00
2024-12-10 17:17:53,104,289,54,50,142.19,293.03,0.00
2024-12-10 17:17:53,104,290,54,50,142.65,294.00,0.00
2024-12-10 17:17:53,105,290,54,51,141.29,294.01,0.00
2024-12-10 17:17:53,104,290,54,50,142.57,294.03,0.00
2024-12-10 17:17:53,104,291,54,50,143.02,295.00,0.00
2024-12-10 17:17:53,105,291,55,50,141.66,295.01,0.00
2024-12-10 17:17:53,104,291,54,50,142.94,295.03,0.00
2024-12-10 17:17:53,104,292,54,50,143.39,296.00,0.00
2024-12-10 17:17:53,105,292,55,50,142.02,296.01,0.00
2024-12-10 17:17:53,104,292,54,50,143.31,296.03,0.00
2024-12-10 17:17:53,104,293,54,50,143.76,297.00,0.00
2024-12-10 17:17:53,105,293,55,50,142.39,297.01,0.00
2024-12-10 17:17:53,104,293,55,49,143.68,297.03,0.00
2024-12-10 17:17:53,104,294,55,49,144.13,298.00,0.00
2024-12-10 17:17:53,105,294,56,49,142.76,298.01,0.00
2024-12-10 17:17:53,104,294,55,49,144.05,298.03,0.00
2024-12-10 17:17:54,104,295,55,49,144.50,299.00,0.00
2024-12-10 17:17:54,105,295,56,49,143.12,299.01,0.00
2024-12-10 17:17:54,104,295,55,49,144.41,299.03,0.00
2024-12-10 17:17:54,104,296,55,49,144.87,300.00,0.00
2024-12-10 17:17:54,105,296,55,50,143.49,300.01,0.00
2024-12-10 17:17:54,104,296,54,50,144.78,300.03,0.00
2024-12-10 17:17:54,104,297,54,50,145.23,301.00,0.00
2024-12-10 17:17:54,105,297,54,51,143.85,301.01,0.00
2024-12-10 17:17:54,104,297,53,51,145.15,301.03,0.00
2024-12-10 17:17:54,104,298,53,51,145.60,302.00,0.00
2024-12-10 17:17:54,105,298,54,51,144.21,302.01,0.00
2024-12-10 17:17:54,104,298,54,50,145.51,302.03,0.00
2024-12-10 17:17:54,104,299,54,50,145.96,303.00,0.00
2024-12-10 17:17:54,105,299,54,51,144.57,303.01,0.00
2024-12-10 17:17:54,104,299,54,50,145.88,303.03,0.00
2024-12-10 17:17:54,104,300,54,50,146.33,304.00,0.00
2024-12-10 17:17:54,105,300,55,50,144.94,304.01,0.00
2024-12-10 17:17:54,104,300,55,49,146.24,304.03,0.00
2024-12-10 17:17:54,104,301,55,49,146.69,305.00,0.00
2024-12-10 17:17:54,105,301,56,49,145.30,305.01,0.00
2024-12-10 17:17:54,104,301,56,48,146.61,305.03,0.00
2024-12-10 17:17:54,104,302,56,48,147.06,306.00,0.00
2024-12-10 17:17:54,105,302,57,48,145.66,306.01,0.00
2024-12-10 17:17:54,104,302,56,48,146.97,306.03,0.00
2024-12-10 17:17:54,104,303,56,48,147.42,307.00,0.00
2024-12-10 17:17:54,105,303,57,48,146.01,307.01,0.00
2024-12-10 17:17:54,104,303,57,47,147.33,307.03,0.00
2024-12-10 17:17:54,104,304,57,47,147.78,308.00,0.00
2024-12-10 17:17:54,105,304,57,48,146.37,308.01,0.00
2024-12-10 17:17:54,104,304,56,48,147.69,308.03,0.00
2024-12-10 17:17:54,104,305,56,48,148.14,309.00,0.00
2024-12-10 17:17:54,105,305,56,49,146.73,309.01,0.00
2024-12-10 17:17:54,104,305,55,49,148.05,309.03,0.00
2024-12-10 17:17:54,104,306,55,49,148.50,310.00,0.00
2024-12-10 17:17:54,105,306,55,50,147.09,310.01,0.00
2024-12-10 17:17:54,104,306,55,49,148.41,310.03,0.00
2024-12-10 17:17:54,104,307,55,49,148.86,311.00,0.00
2024-12-10 17:17:54,105,307,55,50,147.44,311.01,0.00
2024-12-10 17:17:54,104,307,54,50,148.77,311.03,0.00
2024-12-10 17:17:54,104,308,54,50,149.22,312.00,0.00
2024-12-10 17:17:54,105,308,54,51,147.80,312.01,0.00
2024-12-10 17:17:54,104,308,54,50,149.13,312.03,0.00
2024-12-10 17:17:54,104,309,54,50,149.58,313.00,0.00
2024-12-10 17:17:54,105,309,54,51,148.15,313.01,0.00
2024-12-10 17:17:54,104,309,53,51,149.49,313.03,0.00
2024-12-10 17:17:54,104,310,53,51,149.93,314.00,0.00
2024-12-10 17:17:54,105,310,53,52,148.51,314.01,0.00
2024-12-10 17:17:54,104,310,52,52,149.90,314.01,0.00
2024-12-10 17:17:54,103,310,51,52,151.30,314.02,0.00
2024-12-10 17:17:54,102,310,50,52,152.75,314.02,0.00
2024-12-10 17:17:54,102,311,50,52,153.24,315.00,0.00
2024-12-10 17:17:54,103,311,50,53,151.75,315.01,0.00
2024-12-10 17:17:54,102,311,50,52,153.18,315.02,0.00
2024-12-10 17:17:54,102,312,50,52,153.66,316.00,0.00
2024-12-10 17:17:54,103,312,50,53,152.17,316.01,0.00
2024-12-10 17:17:54,102,312,50,52,153.60,316.02,0.00
2024-12-10 17:17:54,102,313,50,52,154.09,317.00,0.00
2024-12-10 17:17:54,103,313,51,52,152.59,317.01,0.00
2024-12-10 17:17:54,102,313,50,52,154.02,317.02,0.00
2024-12-10 17:17:54,102,314,50,52,154.51,318.00,0.00
2024-12-10 17:17:54,103,314,50,53,153.01,318.01,0.00
2024-12-10 17:17:54,102,314,50,52,154.45,318.02,0.00
2024-12-10 17:17:54,102,315,50,52,154.93,319.00,0.00
2024-12-10 17:17:54,103,315,50,53,153.43,319.01,0.00
2024-12-10 17:17:54,102,315,49,53,154.87,319.02,0.00
2024-12-10 17:17:54,102,316,49,53,155.36,320.00,0.00
2024-12-10 17:17:54,103,316,50,53,153.85,320.01,0.00
2024-12-10 17:17:54,102,316,49,53,155.33,320.01,0.00
2024-12-10 17:17:54,101,316,49,52,156.83,320.01,0.00
2024-12-10 17:17:54,100,316,49,51,158.37,320.01,0.00
2024-12-10 17:17:54,100,317,49,51,158.89,321.00,0.00
2024-12-10 17:17:54,101,317,49,52,157.32,321.01,0.00
2024-12-10 17:17:54,100,317,49,51,158.86,321.01,0.00
2024-12-10 17:17:54,100,318,49,51,159.39,322.00,0.00
2024-12-10 17:17:54,101,318,49,52,157.81,322.01,0.00
2024-12-10 17:17:54,100,318,48,52,159.36,322.01,0.00
2024-12-10 17:17:54,100,319,48,52,159.88,323.00,0.00
2024-12-10 17:17:54,101,319,49,52,158.30,323.01,0.00
2024-12-10 17:17:54,100,319,48,52,159.85,323.01,0.00
2024-12-10 17:17:54,100,320,48,52,160.38,324.00,0.00
2024-12-10 17:17:54,101,320,48,53,158.79,324.01,0.00
2024-12-10 17:17:54,100,320,47,53,160.35,324.01,0.00
2024-12-10 17:17:54,100,321,47,53,160.88,325.00,0.00
2024-12-10 17:17:54,101,321,48,53,159.28,325.01,0.00
2024-12-10 17:17:54,100,321,48,52,160.84,325.01,0.00
2024-12-10 17:17:54,100,322,48,52,161.37,326.00,0.00
2024-12-10 17:17:54,101,322,48,53,159.77,326.01,0.00
2024-12-10 17:17:54,100,322,47,53,161.34,326.01,0.00
2024-12-10 17:17:54,100,323,47,53,161.86,327.00,0.00
2024-12-10 17:17:54,101,323,47,54,160.26,327.01,0.00
2024-12-10 17:17:54,100,323,47,53,161.83,327.01,0.00
2024-12-10 17:17:54,100,324,47,53,162.36,328.00,0.00
2024-12-10 17:17:54,101,324,47,54,160.75,328.01,0.00
2024-12-10 17:17:54,100,324,46,54,162.33,328.01,0.00
2024-12-10 17:17:54,100,325,46,54,162.85,329.00,0.00
2024-12-10 17:17:54,101,325,46,55,161.24,329.01,0.00
2024-12-10 17:17:55,100,325,45,55,162.82,329.01,0.00
2024-12-10 17:17:55,100,326,45,55,163.35,330.00,0.00
2024-12-10 17:17:55,101,326,45,56,161.73,330.01,0.00
2024-12-10 17:17:55,100,326,44,56,163.32,330.01,0.00
2024-12-10 17:17:55,100,327,44,56,163.84,331.00,0.00
2024-12-10 17:17:55,101,327,45,56,162.22,331.01,0.00
2024-12-10 17:17:55,100,327,44,56,163.81,331.01,0.00
2024-12-10 17:17:55,100,328,44,56,164.34,332.00,0.00
2024-12-10 17:17:55,101,328,45,56,162.71,332.01,0.00
2024-12-10 17:17:55,100,328,45,55,164.31,332.01,0.00
2024-12-10 17:17:55,100,329,45,55,164.83,333.00,0.00
2024-12-10 17:17:55,101,329,46,55,163.20,333.01,0.00
2024-12-10 17:17:55,100,329,45,55,164.80,333.01,0.00
2024-12-10 17:17:55,100,330,45,55,165.33,334.00,0.00
2024-12-10 17:17:55,101,330,45,56,163.69,334.01,0.00
2024-12-10 17:17:55,100,330,44,56,165.30,334.01,0.00
2024-12-10 17:17:55,100,331,44,56,165.82,335.00,0.00
2024-12-10 17:17:55,101,331,44,57,164.18,335.01,0.00
2024-12-10 17:17:55,100,331,44,56,165.79,335.01,0.00
2024-12-10 17:17:55,100,332,44,56,166.32,336.00,0.00
2024-12-10 17:17:55,101,332,45,56,164.67,336.01,0.00
2024-12-10 17:17:55,100,332,45,55,166.29,336.01,0.00
2024-12-10 17:17:55,100,333,45,55,166.81,337.00,0.00
2024-12-10 17:17:55,101,333,46,55,165.16,337.01,0.00
2024-12-10 17:17:55,100,333,46,54,166.78,337.01,0.00
2024-12-10 17:17:55,100,334,46,54,167.31,338.00,0.00
2024-12-10 17:17:55,101,334,46,55,165.65,338.01,0.00
2024-12-10 17:17:55,100,334,46,54,167.28,338.01,0.00
2024-12-10 17:17:55,100,335,46,54,167.80,339.00,0.00
2024-12-10 17:17:55,101,335,46,55,166.14,339.01,0.00
2024-12-10 17:17:55,100,335,46,54,167.77,339.01,0.00
2024-12-10 17:17:55,100,336,46,54,168.30,340.00,0.00
2024-12-10 17:17:55,101,336,46,55,166.63,340.01,0.00
2024-12-10 17:17:55,100,336,45,55,168.27,340.01,0.00
2024-12-10 17:17:55,100,337,45,55,168.79,341.00,0.00
2024-12-10 17:17:55,101,337,46,55,167.12,341.01,0.00
2024-12-10 17:17:55,100,337,46,54,168.76,341.01,0.00
2024-12-10 17:17:55,100,338,46,54,169.29,342.00,0.00
2024-12-10 17:17:55,101,338,46,55,167.61,342.01,0.00
2024-12-10 17:17:55,100,338,46,54,169.26,342.01,0.00
2024-12-10 17:17:55,100,339,46,54,169.78,343.00,0.00
2024-12-10 17:17:55,101,339,47,54,168.10,343.01,0.00
2024-12-10 17:17:55,100,339,46,54,169.75,343.01,0.00
2024-12-10 17:17:55,100,340,46,54,170.28,344.00,0.00
2024-12-10 17:17:55,101,340,47,54,168.59,344.01,0.00
2024-12-10 17:17:55,100,340,47,53,170.25,344.01,0.00
2024-12-10 17:17:55,100,341,47,53,170.77,345.00,0.00
2024-12-10 17:17:55,101,341,47,54,169.08,345.01,0.00
2024-12-10 17:17:55,100,341,47,53,170.74,345.01,0.00
2024-12-10 17:17:55,100,342,47,53,171.27,346.00,0.00
2024-12-10 17:17:55,101,342,47,54,169.57,346.01,0.00
2024-12-10 17:17:55,100,342,46,54,171.24,346.01,0.00
2024-12-10 17:17:55,100,343,46,54,171.76,347.00,0.00
2024-12-10 17:17:55,101,343,46,55,170.06,347.01,0.00
2024-12-10 17:17:55,100,343,45,55,171.73,347.01,0.00
2024-12-10 17:17:55,100,344,45,55,172.26,348.00,0.00
2024-12-10 17:17:55,101,344,45,56,170.55,348.01,0.00
2024-12-10 17:17:55,100,344,45,55,172.23,348.01,0.00
2024-12-10 17:17:55,100,345,45,55,172.75,349.00,0.00
2024-12-10 17:17:55,101,345,46,55,171.04,349.01,0.00
2024-12-10 17:17:55,100,345,45,55,172.72,349.01,0.00
2024-12-10 17:17:55,100,346,45,55,173.25,350.00,0.00
2024-12-10 17:17:55,101,346,45,56,171.53,350.01,0.00
2024-12-10 17:17:55,100,346,45,55,173.22,350.01,0.00
2024-12-10 17:17:55,100,347,45,55,173.72,351.00,0.00
2024-12-10 17:17:55,101,347,45,56,172.00,351.01,0.00
2024-12-10 17:17:55,100,347,45,55,173.68,351.01,0.00
2024-12-10 17:17:55,100,348,45,55,174.21,352.00,0.00
2024-12-10 17:17:55,101,348,46,55,172.49,352.01,0.00
2024-12-10 17:17:55,100,348,45,55,174.17,352.01,0.00
2024-12-10 17:17:55,100,349,45,55,174.70,353.00,0.00
2024-12-10 17:17:55,101,349,46,55,172.98,353.01,0.00
2024-12-10 17:17:55,100,349,46,54,174.67,353.01,0.00
2024-12-10 17:17:55,100,350,46,54,175.20,354.00,0.00
2024-12-10 17:17:55,101,350,47,54,173.47,354.01,0.00
2024-12-10 17:17:55,100,350,47,53,175.16,354.01,0.00
2024-12-10 17:17:55,100,351,47,53,175.69,355.00,0.00
2024-12-10 17:17:55,101,351,47,54,173.96,355.01,0.00
2024-12-10 17:17:55,100,351,46,54,175.66,355.01,0.00
2024-12-10 17:17:55,100,352,46,54,176.19,356.00,0.00
2024-12-10 17:17:55,101,352,46,55,174.45,356.01,0.00
2024-12-10 17:17:55,100,352,45,55,176.15,356.01,0.00
2024-12-10 17:17:55,100,353,45,55,176.68,357.00,0.00
2024-12-10 17:17:55,101,353,46,55,174.94,357.01,0.00
2024-12-10 17:17:55,100,353,45,55,176.65,357.01,0.00
2024-12-10 17:17:56,100,354,45,55,177.18,358.00,0.00
2024-12-10 17:17:56,101,354,45,56,175.43,358.01,0.00
2024-12-10 17:17:56,100,354,45,55,177.14,358.01,0.00
2024-12-10 17:17:56,100,355,45,55,177.67,359.00,0.00
2024-12-10 17:17:56,101,355,45,56,175.92,359.01,0.00
2024-12-10 17:17:56,100,355,45,55,177.64,359.01,0.00
2024-12-10 17:17:56,100,356,45,55,178.17,360.00,0.00
2024-12-10 17:17:56,101,356,45,56,176.41,360.01,0.00
2024-12-10 17:17:56,100,356,45,55,178.13,360.01,0.00
2024-12-10 17:17:56,100,357,45,55,178.66,361.00,0.00
2024-12-10 17:17:56,101,357,45,56,176.90,361.01,0.00
2024-12-10 17:17:56,100,357,44,56,178.63,361.01,0.00
2024-12-10 17:17:56,100,358,44,56,179.16,362.00,0.00
2024-12-10 17:17:56,101,358,44,57,177.39,362.01,0.00
2024-12-10 17:17:56,100,358,44,56,179.12,362.01,0.00
2024-12-10 17:17:56,100,359,44,56,179.65,363.00,0.00
2024-12-10 17:17:56,101,359,45,56,177.88,363.01,0.00
2024-12-10 17:17:56,100,359,45,55,179.62,363.01,0.00
2024-12-10 17:17:56,100,360,45,55,180.15,364.00,0.00
2024-12-10 17:17:56,101,360,45,56,178.37,364.01,0.00
2024-12-10 17:17:56,100,360,45,55,180.11,364.01,0.00
2024-12-10 17:17:56,100,361,45,55,180.64,365.00,0.00
2024-12-10 17:17:56,101,361,45,56,178.86,365.01,0.00
2024-12-10 17:17:56,100,361,44,56,180.61,365.01,0.00
2024-12-10 17:17:56,100,362,44,56,181.14,366.00,0.00
2024-12-10 17:17:56,101,362,45,56,179.35,366.01,0.00
2024-12-10 17:17:56,100,362,44,56,181.10,366.01,0.00
2024-12-10 17:17:56,100,363,44,56,181.63,367.00,0.00
2024-12-10 17:17:56,101,363,45,56,179.84,367.01,0.00
2024-12-10 17:17:56,100,363,44,56,181.60,367.01,0.00
2024-12-10 17:17:56,100,364,44,56,182.13,368.00,0.00
2024-12-10 17:17:56,101,364,45,56,180.33,368.01,0.00
2024-12-10 17:17:56,100,364,45,55,182.09,368.01,0.00
2024-12-10 17:17:56,100,365,45,55,182.62,369.00,0.00
2024-12-10 17:17:56,101,365,46,55,180.82,369.01,0.00
2024-12-10 17:17:56,100,365,45,55,182.59,369.01,0.00
2024-12-10 17:17:56,100,366,45,55,183.12,370.00,0.00
2024-12-10 17:17:56,101,366,45,56,181.31,370.01,0.00
2024-12-10 17:17:56,100,366,45,55,183.08,370.01,0.00
2024-12-10 17:17:56,100,367,45,55,183.61,371.00,0.00
2024-12-10 17:17:56,101,367,45,56,181.80,371.01,0.00
2024-12-10 17:17:56,100,367,45,55,183.61,371.01,0.00
2024-12-10 17:17:56,100,368,45,55,184.14,372.00,0.00
2024-12-10 17:17:56,101,368,46,55,182.32,372.01,0.00
2024-12-10 17:17:56,100,368,46,54,184.10,372.01,0.00
2024-12-10 17:17:56,100,369,46,54,184.63,373.00,0.00
2024-12-10 17:17:56,101,369,46,55,182.81,373.01,0.00
2024-12-10 17:17:56,100,369,45,55,184.60,373.01,0.00
2024-12-10 17:17:56,100,370,45,55,185.13,374.00,0.00
2024-12-10 17:17:56,101,370,45,56,183.30,374.01,0.00
2024-12-10 17:17:56,100,370,45,55,185.09,374.01,0.00
2024-12-10 17:17:56,100,371,45,55,185.63,375.00,0.00
2024-12-10 17:17:56,101,371,45,56,183.79,375.01,0.00
2024-12-10 17:17:56,100,371,44,56,185.59,375.01,0.00
2024-12-10 17:17:56,100,372,44,56,186.12,376.00,0.00
2024-12-10 17:17:56,101,372,44,57,184.28,376.01,0.00
2024-12-10 17:17:56,100,372,43,57,186.08,376.01,0.00
2024-12-10 17:17:56,100,373,43,57,186.61,377.00,0.00
2024-12-10 17:17:56,101,373,43,58,184.77,377.01,0.00
2024-12-10 17:17:56,100,373,43,57,186.58,377.01,0.00
2024-12-10 17:17:57,100,374,43,57,187.11,378.00,0.00
2024-12-10 17:17:57,101,374,44,57,185.26,378.01,0.00
2024-12-10 17:17:57,100,374,43,57,187.07,378.01,0.00
2024-12-10 17:17:57,100,375,43,57,187.60,379.00,0.00
2024-12-10 17:17:57,101,375,44,57,185.75,379.01,0.00
2024-12-10 17:17:57,100,375,43,57,187.57,379.01,0.00
2024-12-10 17:17:57,100,376,43,57,188.10,380.00,0.00
2024-12-10 17:17:57,101,376,44,57,186.24,380.01,0.00
2024-12-10 17:17:57,100,376,43,57,188.06,380.01,0.00
2024-12-10 17:17:57,100,377,43,57,188.59,381.00,0.00
2024-12-10 17:17:57,101,377,43,58,186.73,381.01,0.00
2024-12-10 17:17:57,100,377,42,58,188.56,381.01,0.00
2024-12-10 17:17:57,100,378,42,58,189.09,382.00,0.00
2024-12-10 17:17:57,101,378,42,59,187.22,382.01,0.00
2024-12-10 17:17:57,100,378,42,58,189.05,382.01,0.00
2024-12-10 17:17:57,100,379,42,58,189.58,383.00,0.00
2024-12-10 17:17:57,101,379,43,58,187.71,383.01,0.00
2024-12-10 17:17:57,100,379,43,57,189.55,383.01,0.00
2024-12-10 17:17:57,100,380,43,57,190.08,384.00,0.00
2024-12-10 17:17:57,101,380,44,57,188.20,384.01,0.00
2024-12-10 17:17:57,100,380,43,57,190.04,384.01,0.00
2024-12-10 17:17:57,100,381,43,57,190.57,385.00,0.00
2024-12-10 17:17:57,101,381,44,57,188.69,385.01,0.00
2024-12-10 17:17:57,100,381,43,57,190.54,385.01,0.00
2024-12-10 17:17:57,100,382,43,57,191.07,386.00,0.00
2024-12-10 17:17:57,101,382,44,57,189.18,386.01,0.00
2024-12-10 17:17:57,100,382,44,56,191.03,386.01,0.00
2024-12-10 17:17:57,100,383,44,56,191.56,387.00,0.00
2024-12-10 17:17:57,101,383,44,57,189.67,387.01,0.00
2024-12-10 17:17:57,100,383,44,56,191.53,387.01,0.00
2024-12-10 17:17:57,100,384,44,56,192.06,388.00,0.00
2024-12-10 17:17:57,101,384,44,57,190.16,388.01,0.00
2024-12-10 17:17:57,100,384,44,56,192.02,388.01,0.00
2024-12-10 17:17:57,100,385,44,56,192.55,389.00,0.00
2024-12-10 17:17:57,101,385,45,56,190.65,389.01,0.00
2024-12-10 17:17:57,100,385,44,56,192.52,389.01,0.00
2024-12-10 17:17:57,100,386,44,56,193.05,390.00,0.00
2024-12-10 17:17:57,101,386,45,56,191.14,390.01,0.00
2024-12-10 17:17:57,100,386,44,56,193.01,390.01,0.00
2024-12-10 17:17:57,100,387,44,56,193.54,391.00,0.00
2024-12-10 17:17:57,101,387,45,56,191.63,391.01,0.00
2024-12-10 17:17:57,100,387,44,56,193.51,391.01,0.00
2024-12-10 17:17:57,100,388,44,56,194.04,392.00,0.00
2024-12-10 17:17:57,101,388,44,57,192.12,392.01,0.00
2024-12-10 17:17:57,100,388,44,56,194.00,392.01,0.00
2024-12-10 17:17:57,100,389,44,56,194.53,393.00,0.00
2024-12-10 17:17:57,101,389,44,57,192.61,393.01,0.00
2024-12-10 17:17:57,100,389,43,57,194.50,393.01,0.00
2024-12-10 17:17:57,100,390,43,57,195.03,394.00,0.00
2024-12-10 17:17:57,101,390,44,57,193.10,394.01,0.00
2024-12-10 17:17:57,100,390,44,56,194.99,394.01,0.00
2024-12-10 17:17:57,100,391,44,56,195.52,395.00,0.00
2024-12-10 17:17:57,101,391,44,57,193.59,395.01,0.00
2024-12-10 17:17:57,100,391,43,57,195.49,395.01,0.00
2024-12-10 17:17:57,100,392,43,57,196.02,396.00,0.00
2024-12-10 17:17:57,101,392,44,57,194.08,396.01,0.00
2024-12-10 17:17:57,100,392,43,57,195.98,396.01,0.00
2024-12-10 17:17:57,100,393,43,57,196.51,397.00,0.00
2024-12-10 17:17:57,101,393,44,57,194.57,397.01,0.00
2024-12-10 17:17:57,100,393,43,57,196.48,397.01,0.00
2024-12-10 17:17:57,100,394,43,57,197.01,398.00,0.00
2024-12-10 17:17:57,101,394,44,57,195.06,398.01,0.00
2024-12-10 17:17:57,100,394,43,57,196.97,398.01,0.00
2024-12-10 17:17:57,100,395,43,57,197.50,399.00,0.00
2024-12-10 17:17:57,101,395,43,58,195.55,399.01,0.00
2024-12-10 17:17:57,100,395,42,58,197.47,399.01,0.00
2024-12-10 17:17:57,100,396,42,58,198.00,400.00,0.00
2024-12-10 17:17:57,101,396,42,59,196.04,400.01,0.00
2024-12-10 17:17:57,100,396,42,58,197.96,400.01,0.00
2024-12-10 17:17:57,100,397,42,58,198.49,401.00,0.00
2024-12-10 17:17:57,101,397,42,59,196.53,401.01,0.00
2024-12-10 17:17:57,100,397,42,58,198.45,401.01,0.00
2024-12-10 17:17:57,100,398,42,58,198.99,402.00,0.00
2024-12-10 17:17:57,101,398,42,59,197.02,402.01,0.00
2024-12-10 17:17:57,100,398,41,59,198.95,402.01,0.00
2024-12-10 17:17:57,100,399,41,59,199.48,403.00,0.00
2024-12-10 17:17:57,101,399,42,59,197.51,403.01,0.00
2024-12-10 17:17:57,100,399,42,58,199.44,403.01,0.00
2024-12-10 17:17:57,100,400,42,58,199.98,404.00,0.00
2024-12-10 17:17:58,101,400,42,59,198.00,404.01,0.00
2024-12-10 17:17:58,100,400,41,59,199.94,404.01,0.00
2024-12-10 17:17:58,100,401,41,59,200.47,405.00,0.00
2024-12-10 17:17:58,101,401,42,59,198.49,405.01,0.00
2024-12-10 17:17:58,100,401,41,59,200.43,405.01,0.00
2024-12-10 17:17:58,100,402,41,59,200.97,406.00,0.00
2024-12-10 17:17:58,101,402,41,60,198.98,406.01,0.00
2024-12-10 17:17:58,100,402,40,60,200.93,406.01,0.00
2024-12-10 17:17:58,100,403,40,60,201.46,407.00,0.00
2024-12-10 17:17:58,101,403,40,61,199.47,407.01,0.00
2024-12-10 17:17:58,100,403,39,61,201.42,407.01,0.00
2024-12-10 17:17:58,100,404,39,61,201.96,408.00,0.00
2024-12-10 17:17:58,101,404,40,61,199.96,408.01,0.00
2024-12-10 17:17:58,100,404,40,60,201.92,408.01,0.00
2024-12-10 17:17:58,100,405,40,60,202.45,409.00,0.00
2024-12-10 17:17:58,101,405,41,60,200.45,409.01,0.00
2024-12-10 17:17:58,100,405,41,59,202.41,409.01,0.00
2024-12-10 17:17:58,100,406,41,59,202.95,410.00,0.00
2024-12-10 17:17:58,101,406,42,59,200.94,410.01,0.00
2024-12-10 17:17:58,100,406,42,58,202.91,410.01,0.00
2024-12-10 17:17:58,100,407,42,58,203.44,411.00,0.00
2024-12-10 17:17:58,101,407,42,59,201.43,411.01,0.00
2024-12-10 17:17:58,100,407,42,58,203.40,411.01,0.00
2024-12-10 17:17:58,100,408,42,58,203.94,412.00,0.00
2024-12-10 17:17:58,101,408,42,59,201.92,412.01,0.00
2024-12-10 17:17:58,100,408,42,58,203.90,412.01,0.00
2024-12-10 17:17:58,100,409,42,58,204.43,413.00,0.00
2024-12-10 17:17:58,101,409,42,59,202.41,413.01,0.00
2024-12-10 17:17:58,100,409,42,58,204.39,413.01,0.00
2024-12-10 17:17:58,100,410,42,58,204.93,414.00,0.00
2024-12-10 17:17:58,101,410,42,59,202.90,414.01,0.00
2024-12-10 17:17:58,100,410,42,58,204.89,414.01,0.00
2024-12-10 17:17:58,100,411,42,58,205.42,415.00,0.00
2024-12-10 17:17:58,101,411,42,59,203.39,415.01,0.00
2024-12-10 17:17:58,100,411,42,58,205.38,415.01,0.00
2024-12-10 17:17:58,100,412,42,58,205.92,416.00,0.00
2024-12-10 17:17:58,101,412,43,58,203.88,416.01,0.00
2024-12-10 17:17:58,100,412,43,57,205.88,416.01,0.00
2024-12-10 17:17:58,100,413,43,57,206.41,417.00,0.00
2024-12-10 17:17:58,101,413,44,57,204.37,417.01,0.00
2024-12-10 17:17:58,100,413,43,57,206.37,417.01,0.00
2024-12-10 17:17:58,100,414,43,57,206.91,418.00,0.00
2024-12-10 17:17:58,101,414,43,58,204.86,418.01,0.00
2024-12-10 17:17:58,100,414,43,57,206.87,418.01,0.00
2024-12-10 17:17:58,100,415,43,57,207.40,419.00,0.00
2024-12-10 17:17:58,101,415,44,57,205.35,419.01,0.00
2024-12-10 17:17:58,100,415,44,56,207.36,419.01,0.00
2024-12-10 17:17:58,100,416,44,56,207.90,420.00,0.00
2024-12-10 17:17:58,101,416,44,57,205.84,420.01,0.00
2024-12-10 17:17:58,100,416,43,57,207.86,420.01,0.00
2024-12-10 17:17:58,100,417,43,57,208.39,421.00,0.00
2024-12-10 17:17:58,101,417,44,57,206.33,421.01,0.00
2024-12-10 17:17:58,100,417,44,56,208.35,421.01,0.00
2024-12-10 17:17:58,100,418,44,56,208.89,422.00,0.00
2024-12-10 17:17:58,101,418,44,57,206.82,422.01,0.00
2024-12-10 17:17:58,100,418,44,56,208.85,422.01,0.00
2024-12-10 17:17:58,100,419,44,56,209.38,423.00,0.00
2024-12-10 17:17:58,101,419,45,56,207.31,423.01,0.00
2024-12-10 17:17:58,100,419,44,56,209.34,423.01,0.00
2024-12-10 17:17:58,100,420,44,56,209.88,424.00,0.00
2024-12-10 17:17:58,101,420,44,57,207.80,424.01,0.00
2024-12-10 17:17:58,100,420,44,56,209.84,424.01,0.00
2024-12-10 17:17:58,100,421,44,56,210.37,425.00,0.00
2024-12-10 17:17:58,101,421,44,57,208.29,425.01,0.00
2024-12-10 17:17:58,100,421,43,57,210.33,425.01,0.00
2024-12-10 17:17:58,100,422,43,57,210.87,426.00,0.00
2024-12-10 17:17:58,101,422,44,57,208.78,426.01,0.00
2024-12-10 17:17:58,100,422,44,56,210.83,426.01,0.00
2024-12-10 17:17:58,100,423,44,56,211.36,427.00,0.00
2024-12-10 17:17:58,101,423,44,57,209.27,427.01,0.00
2024-12-10 17:17:58,100,423,44,56,211.32,427.01,0.00
2024-12-10 17:17:58,100,424,44,56,211.86,428.00,0.00
2024-12-10 17:17:58,101,424,44,57,209.76,428.01,0.00
2024-12-10 17:17:58,100,424,44,56,211.82,428.01,0.00
2024-12-10 17:17:58,100,425,44,56,212.35,429.00,0.00
2024-12-10 17:17:58,101,425,45,56,210.25,429.01,0.00
2024-12-10 17:17:58,100,425,45,55,212.31,429.01,0.00
2024-12-10 17:17:58,100,426,45,55,212.85,430.00,0.00
2024-12-10 17:17:58,101,426,46,55,210.74,430.01,0.00
2024-12-10 17:17:58,100,426,46,54,212.81,430.01,0.00
2024-12-10 17:17:58,100,427,46,54,213.34,431.00,0.00
2024-12-10 17:17:58,101,427,46,55,211.23,431.01,0.00
2024-12-10 17:17:58,100,427,45,55,213.30,431.01,0.00
2024-12-10 17:17:58,100,428,45,55,213.84,432.00,0.00
2024-12-10 17:17:58,101,428,45,56,211.72,432.01,0.00
2024-12-10 17:17:58,100,428,44,56,213.80,432.01,0.00
2024-12-10 17:17:58,100,429,44,56,214.33,433.00,0.00
2024-12-10 17:17:58,101,429,45,56,212.21,433.01,0.00
2024-12-10 17:17:58,100,429,44,56,214.29,433.01,0.00
2024-12-10 17:17:58,101,428,45,56,209.31,433.75,0.00
2024-12-10 17:17:58,101,429,45,56,213.82,434.00,0.00
2024-12-10 17:17:59,102,429,45,57,211.72,434.01,0.00
2024-12-10 17:17:59,101,429,45,56,213.78,434.01,0.00
2024-12-10 17:17:59,101,430,45,56,218.58,435.00,0.00
2024-12-10 17:17:59,102,430,46,56,216.43,435.01,0.00
2024-12-10 17:17:59,101,430,46,55,218.53,435.01,0.00
2024-12-10 17:17:59,101,431,46,55,219.04,436.00,0.00
2024-12-10 17:17:59,102,431,46,56,216.89,436.01,0.00
2024-12-10 17:17:59,101,431,45,56,218.99,436.01,0.00
2024-12-10 17:17:59,101,432,45,56,219.50,437.00,0.00
2024-12-10 17:17:59,102,432,45,57,217.34,437.01,0.00
2024-12-10 17:17:59,101,432,44,57,219.45,437.01,0.00
2024-12-10 17:17:59,101,433,44,57,219.95,438.00,0.00
2024-12-10 17:17:59,102,433,45,57,217.80,438.01,0.00
2024-12-10 17:17:59,101,433,45,56,219.91,438.01,0.00
2024-12-10 17:17:59,101,434,45,56,220.41,439.00,0.00
2024-12-10 17:17:59,102,434,45,57,218.25,439.01,0.00
2024-12-10 17:17:59,101,434,45,56,220.37,439.01,0.00
2024-12-10 17:17:59,101,435,45,56,220.87,440.00,0.00
2024-12-10 17:17:59,102,435,46,56,218.71,440.01,0.00
2024-12-10 17:17:59,101,435,46,55,220.83,440.01,0.00
2024-12-10 17:17:59,101,436,46,55,221.33,441.00,0.00
2024-12-10 17:17:59,102,436,47,55,219.16,441.01,0.00
2024-12-10 17:17:59,101,436,46,55,221.29,441.01,0.00
2024-12-10 17:17:59,101,437,46,55,221.79,442.00,0.00
2024-12-10 17:17:59,102,437,46,56,219.61,442.01,0.00
2024-12-10 17:17:59,101,437,46,55,221.74,442.01,0.00
2024-12-10 17:17:59,101,438,46,55,222.25,443.00,0.00
2024-12-10 17:17:59,102,438,47,55,220.07,443.01,0.00
2024-12-10 17:17:59,101,438,46,55,222.20,443.01,0.00
2024-12-10 17:17:59,101,439,46,55,222.70,444.00,0.00
2024-12-10 17:17:59,102,439,46,56,220.52,444.01,0.00
2024-12-10 17:17:59,101,439,45,56,222.66,444.01,0.00
2024-12-10 17:17:59,101,440,45,56,223.16,445.00,0.00
2024-12-10 17:17:59,102,440,46,56,220.97,445.01,0.00
2024-12-10 17:17:59,101,440,46,55,223.12,445.01,0.00
2024-12-10 17:17:59,101,441,46,55,223.62,446.00,0.00
2024-12-10 17:17:59,102,441,47,55,221.43,446.01,0.00
2024-12-10 17:17:59,101,441,47,54,223.57,446.01,0.00
2024-12-10 17:17:59,101,442,47,54,224.08,447.00,0.00
2024-12-10 17:17:59,102,442,48,54,221.88,447.01,0.00
2024-12-10 17:17:59,101,442,48,53,224.03,447.01,0.00
2024-12-10 17:17:59,101,443,48,53,224.53,448.00,0.00
2024-12-10 17:17:59,102,443,48,54,222.33,448.01,0.00
2024-12-10 17:17:59,101,443,48,53,224.49,448.01,0.00
2024-12-10 17:17:59,101,444,48,53,224.99,449.00,0.00
2024-12-10 17:17:59,102,444,49,53,222.78,449.01,0.00
2024-12-10 17:17:59,101,444,48,53,224.94,449.01,0.00
2024-12-10 17:17:59,101,445,48,53,225.45,450.00,0.00
2024-12-10 17:17:59,102,445,48,54,223.24,450.01,0.00
2024-12-10 17:17:59,101,445,48,53,225.40,450.01,0.00
2024-12-10 17:17:59,101,446,48,53,225.90,451.00,0.00
2024-12-10 17:17:59,102,446,48,54,223.69,451.01,0.00
2024-12-10 17:17:59,101,446,48,53,225.86,451.01,0.00
2024-12-10 17:17:59,101,447,48,53,226.36,452.00,0.00
2024-12-10 17:17:59,102,447,48,54,224.14,452.01,0.00
2024-12-10 17:17:59,101,447,47,54,226.31,452.01,0.00
2024-12-10 17:17:59,101,448,47,54,226.81,453.00,0.00
2024-12-10 17:17:59,102,448,48,54,224.59,453.01,0.00
2024-12-10 17:17:59,101,448,47,54,226.77,453.01,0.00
2024-12-10 17:17:59,101,449,47,54,227.27,454.00,0.00
2024-12-10 17:17:59,102,449,48,54,225.04,454.01,0.00
2024-12-10 17:17:59,101,449,47,54,227.22,454.01,0.00
2024-12-10 17:17:59,101,450,47,54,227.73,455.00,0.00
2024-12-10 17:17:59,102,450,47,55,225.49,455.01,0.00
2024-12-10 17:17:59,101,450,47,54,227.68,455.01,0.00
2024-12-10 17:17:59,101,451,47,54,228.18,456.00,0.00
2024-12-10 17:17:59,102,451,48,54,225.94,456.01,0.00
2024-12-10 17:17:59,101,451,48,53,228.14,456.01,0.00
2024-12-10 17:17:59,101,452,48,53,228.64,457.00,0.00
2024-12-10 17:17:59,102,452,49,53,226.39,457.01,0.00
2024-12-10 17:17:59,101,452,48,53,228.59,457.01,0.00
2024-12-10 17:17:59,101,453,48,53,229.09,458.00,0.00
2024-12-10 17:17:59,102,453,48,54,226.84,458.01,0.00
2024-12-10 17:17:59,101,453,48,53,229.05,458.01,0.00
2024-12-10 17:17:59,101,454,48,53,229.55,459.00,0.00
2024-12-10 17:17:59,102,454,48,54,227.29,459.01,0.00
2024-12-10 17:17:59,101,454,48,53,229.50,459.01,0.00
2024-12-10 17:17:59,101,455,48,53,230.00,460.00,0.00
2024-12-10 17:17:59,102,455,48,54,227.74,460.01,0.00
2024-12-10 17:17:59,101,455,48,53,229.95,460.01,0.00
2024-12-10 17:17:59,101,456,48,53,230.45,461.00,0.00
2024-12-10 17:17:59,102,456,49,53,228.19,461.01,0.00
2024-12-10 17:17:59,101,456,49,52,230.41,461.01,0.00
2024-12-10 17:17:59,101,457,49,52,230.91,462.00,0.00
2024-12-10 17:17:59,102,457,49,53,228.64,462.01,0.00
2024-12-10 17:17:59,101,457,49,52,230.86,462.01,0.00
2024-12-10 17:17:59,101,458,49,52,231.36,463.00,0.00
2024-12-10 17:17:59,102,458,50,52,229.09,463.01,0.00
2024-12-10 17:17:59,101,458,49,52,231.32,463.01,0.00
2024-12-10 17:17:59,101,459,49,52,231.82,464.00,0.00
2024-12-10 17:17:59,102,459,50,52,229.54,464.01,0.00
2024-12-10 17:17:59,101,459,50,51,231.77,464.01,0.00
2024-12-10 17:18:00,101,460,50,51,232.27,465.00,0.00
2024-12-10 17:18:00,102,460,51,51,229.99,465.01,0.00
2024-12-10 17:18:00,101,460,51,50,232.22,465.01,0.00
2024-12-10 17:18:00,102,459,52,50,227.04,465.71,0.00
2024-12-10 17:18:00,102,460,52,50,231.86,466.00,0.00
2024-12-10 17:18:00,103,460,53,50,229.61,466.01,0.00
2024-12-10 17:18:00,102,460,52,50,231.81,466.01,0.00
2024-12-10 17:18:00,102,461,52,50,236.84,467.00,0.00
2024-12-10 17:18:00,103,461,53,50,234.54,467.01,0.00
2024-12-10 17:18:00,102,461,52,50,236.80,467.01,0.00
2024-12-10 17:18:00,102,462,52,50,237.26,468.00,0.00
2024-12-10 17:18:00,103,462,53,50,234.95,468.01,0.00
2024-12-10 17:18:00,102,462,52,50,237.21,468.01,0.00
2024-12-10 17:18:00,102,463,52,50,237.67,469.00,0.00
2024-12-10 17:18:00,103,463,53,50,235.37,469.01,0.00
2024-12-10 17:18:00,102,463,52,50,237.63,469.01,0.00
2024-12-10 17:18:00,102,464,52,50,238.09,470.00,0.00
2024-12-10 17:18:00,103,464,52,51,235.78,470.01,0.00
2024-12-10 17:18:00,102,464,52,50,238.04,470.01,0.00
2024-12-10 17:18:00,102,465,52,50,238.50,471.00,0.00
2024-12-10 17:18:00,103,465,53,50,236.19,471.01,0.00
2024-12-10 17:18:00,102,465,53,49,238.46,471.01,0.00
2024-12-10 17:18:00,102,466,53,49,238.92,472.00,0.00
2024-12-10 17:18:00,103,466,54,49,236.60,472.01,0.00
2024-12-10 17:18:00,102,466,53,49,238.87,472.01,0.00
2024-12-10 17:18:00,102,467,53,49,239.33,473.00,0.00
2024-12-10 17:18:00,103,467,53,50,237.01,473.01,0.00
2024-12-10 17:18:00,102,467,53,49,239.28,473.01,0.00
2024-12-10 17:18:00,102,468,53,49,239.74,474.00,0.00
2024-12-10 17:18:00,103,468,53,50,237.41,474.01,0.00
2024-12-10 17:18:00,102,468,53,49,239.70,474.01,0.00
2024-12-10 17:18:00,102,469,53,49,240.15,475.00,0.00
2024-12-10 17:18:00,103,469,54,49,237.82,475.01,0.00
2024-12-10 17:18:00,102,469,54,48,240.11,475.01,0.00
2024-12-10 17:18:00,102,470,54,48,240.57,476.00,0.00
2024-12-10 17:18:00,103,470,55,48,238.23,476.01,0.00
2024-12-10 17:18:00,102,470,55,47,240.52,476.01,0.00
2024-12-10 17:18:00,102,471,55,47,240.98,477.00,0.00
2024-12-10 17:18:00,103,471,55,48,238.64,477.01,0.00
2024-12-10 17:18:00,102,471,55,47,240.93,477.01,0.00
2024-12-10 17:18:00,102,472,55,47,241.39,478.00,0.00
2024-12-10 17:18:00,103,472,56,47,239.05,478.01,0.00
2024-12-10 17:18:00,102,472,55,47,241.34,478.01,0.00
2024-12-10 17:18:00,102,473,55,47,241.80,479.00,0.00
2024-12-10 17:18:00,103,473,56,47,239.45,479.01,0.00
2024-12-10 17:18:00,102,473,55,47,241.75,479.01,0.00
2024-12-10 17:18:00,102,474,55,47,242.21,480.00,0.00
2024-12-10 17:18:00,103,474,55,48,239.86,480.01,0.00
2024-12-10 17:18:00,102,474,54,48,242.16,480.01,0.00
2024-12-10 17:18:00,102,475,54,48,242.62,481.00,0.00
2024-12-10 17:18:00,103,475,54,49,240.27,481.01,0.00
2024-12-10 17:18:00,102,475,54,48,242.57,481.01,0.00
2024-12-10 17:18:00,103,474,54,49,237.89,481.54,0.00
2024-12-10 17:18:00,103,475,54,49,241.42,482.00,0.00
2024-12-10 17:18:00,104,475,55,49,239.10,482.01,0.00
2024-12-10 17:18:00,103,475,55,48,241.37,482.01,0.00
2024-12-10 17:18:00,103,476,55,48,246.47,483.00,0.00
2024-12-10 17:18:00,104,476,56,48,244.10,483.01,0.00
2024-12-10 17:18:00,103,476,55,48,246.42,483.01,0.00
2024-12-10 17:18:00,103,477,55,48,246.84,484.00,0.00
2024-12-10 17:18:00,104,477,55,49,244.47,484.01,0.00
2024-12-10 17:18:00,103,477,54,49,246.79,484.01,0.00
2024-12-10 17:18:00,103,478,54,49,247.21,485.00,0.00
2024-12-10 17:18:00,104,478,55,49,244.83,485.01,0.00
2024-12-10 17:18:00,103,478,54,49,247.16,485.01,0.00
2024-12-10 17:18:00,103,479,54,49,247.58,486.00,0.00
2024-12-10 17:18:00,104,479,54,50,245.20,486.01,0.00
2024-12-10 17:18:00,103,479,53,50,247.53,486.01,0.00
2024-12-10 17:18:00,103,480,53,50,247.94,487.00,0.00
2024-12-10 17:18:00,104,480,53,51,245.56,487.01,0.00
2024-12-10 17:18:00,103,480,53,50,247.90,487.01,0.00
2024-12-10 17:18:00,103,481,53,50,248.31,488.00,0.00
2024-12-10 17:18:00,104,481,53,51,245.92,488.01,0.00
2024-12-10 17:18:00,103,481,53,50,248.26,488.01,0.00
2024-12-10 17:18:00,103,482,53,50,248.68,489.00,0.00
2024-12-10 17:18:00,104,482,54,50,246.29,489.01,0.00
2024-12-10 17:18:00,103,482,53,50,248.63,489.01,0.00
2024-12-10 17:18:00,103,483,53,50,249.04,490.00,0.00
2024-12-10 17:18:00,104,483,53,51,246.65,490.01,0.00
2024-12-10 17:18:00,103,483,52,51,249.00,490.01,0.00
2024-12-10 17:18:00,103,484,52,51,249.41,491.00,0.00
2024-12-10 17:18:00,104,484,53,51,247.01,491.01,0.00
2024-12-10 17:18:00,103,484,52,51,249.36,491.01,0.00
2024-12-10 17:18:00,103,485,52,51,249.77,492.00,0.00
2024-12-10 17:18:00,104,485,53,51,247.37,492.01,0.00
2024-12-10 17:18:00,103,485,53,50,249.73,492.01,0.00
2024-12-10 17:18:00,103,486,53,50,250.14,493.00,0.00
2024-12-10 17:18:00,104,486,54,50,247.73,493.01,0.00
2024-12-10 17:18:00,103,486,54,49,250.09,493.01,0.00
2024-12-10 17:18:01,103,487,54,49,250.50,494.00,0.00
2024-12-10 17:18:01,104,487,55,49,248.09,494.01,0.00
2024-12-10 17:18:01,103,487,54,49,250.45,494.01,0.00
2024-12-10 17:18:01,103,488,54,49,250.86,495.00,0.00
2024-12-10 17:18:01,104,488,54,50,248.45,495.01,0.00
2024-12-10 17:18:01,103,488,54,49,250.82,495.01,0.00
2024-12-10 17:18:01,103,489,54,49,251.23,496.00,0.00
2024-12-10 17:18:01,104,489,54,50,248.81,496.01,0.00
2024-12-10 17:18:01,103,489,53,50,251.18,496.01,0.00
2024-12-10 17:18:01,104,488,53,51,245.42,496.76,0.00
2024-12-10 17:18:01,104,489,53,51,250.36,497.00,0.00
2024-12-10 17:18:01,105,489,54,51,247.98,497.01,0.00
2024-12-10 17:18:01,104,489,53,51,250.32,497.01,0.00
2024-12-10 17:18:01,104,490,53,51,255.46,498.00,0.00
2024-12-10 17:18:01,105,490,54,51,253.03,498.01,0.00
2024-12-10 17:18:01,104,490,53,51,255.42,498.01,0.00
2024-12-10 17:18:01,104,491,53,51,255.79,499.00,0.00
2024-12-10 17:18:01,105,491,53,52,253.35,499.01,0.00
2024-12-10 17:18:01,104,491,53,51,255.74,499.01,0.00
2024-12-10 17:18:01,104,492,53,51,256.11,500.00,0.00
2024-12-10 17:18:01,105,492,54,51,253.67,500.01,0.00
2024-12-10 17:18:01,104,492,54,50,256.06,500.01,0.00
2024-12-10 17:18:01,104,493,54,50,256.43,501.00,0.00
2024-12-10 17:18:01,105,493,55,50,253.98,501.01,0.00
2024-12-10 17:18:01,104,493,55,49,256.38,501.01,0.00
2024-12-10 17:18:01,104,494,55,49,256.74,502.00,0.00
2024-12-10 17:18:01,105,494,55,50,254.30,502.01,0.00
2024-12-10 17:18:01,104,494,55,49,256.70,502.01,0.00
2024-12-10 17:18:01,104,495,55,49,257.06,503.00,0.00
2024-12-10 17:18:01,105,495,56,49,254.61,503.01,0.00
2024-12-10 17:18:01,104,495,55,49,257.01,503.01,0.00
2024-12-10 17:18:01,104,496,55,49,257.38,504.00,0.00
2024-12-10 17:18:01,105,496,55,50,254.93,504.01,0.00
2024-12-10 17:18:01,104,496,55,49,257.33,504.01,0.00
2024-12-10 17:18:01,104,497,55,49,257.70,505.00,0.00
2024-12-10 17:18:01,105,497,56,49,255.24,505.01,0.00
2024-12-10 17:18:01,104,497,55,49,257.65,505.01,0.00
2024-12-10 17:18:01,104,498,55,49,258.01,506.00,0.00
2024-12-10 17:18:01,105,498,56,49,255.55,506.01,0.00
2024-12-10 17:18:01,104,498,56,48,257.96,506.01,0.00
2024-12-10 17:18:01,104,499,56,48,258.33,507.00,0.00
2024-12-10 17:18:01,105,499,57,48,255.87,507.01,0.00
2024-12-10 17:18:01,105,500,57,48,256.18,508.00,0.00
2024-12-10 17:18:01,106,500,57,49,253.76,508.01,0.00
2024-12-10 17:18:01,105,500,56,49,256.08,508.02,0.00
2024-12-10 17:18:01,105,501,56,49,256.44,509.00,0.00
2024-12-10 17:18:01,106,501,56,50,254.02,509.01,0.00
2024-12-10 17:18:01,105,501,55,50,256.34,509.02,0.00
2024-12-10 17:18:01,105,502,55,50,256.61,510.00,0.00
2024-12-10 17:18:01,106,502,56,50,254.19,510.01,0.00
2024-12-10 17:18:01,105,502,55,50,256.51,510.02,0.00
2024-12-10 17:18:01,105,503,55,50,256.47,511.00,0.00
2024-12-10 17:18:01,106,503,56,50,254.05,511.01,0.00
2024-12-10 17:18:01,105,503,56,49,256.37,511.02,0.00
2024-12-10 17:18:01,105,504,56,49,256.17,512.00,0.00
2024-12-10 17:18:01,106,504,57,49,253.75,512.01,0.00
2024-12-10 17:18:01,105,504,57,48,256.07,512.02,0.00
2024-12-10 17:18:01,105,505,57,48,256.18,513.00,0.00
2024-12-10 17:18:01,106,505,58,48,253.77,513.01,0.00
2024-12-10 17:18:01,105,505,58,47,256.09,513.02,0.00
2024-12-10 17:18:01,105,506,58,47,256.40,514.00,0.00
2024-12-10 17:18:01,106,506,58,48,253.98,514.01,0.00
2024-12-10 17:18:01,105,506,58,47,256.30,514.02,0.00
2024-12-10 17:18:01,105,507,58,47,256.65,515.00,0.00
2024-12-10 17:18:01,106,507,58,48,254.23,515.01,0.00
2024-12-10 17:18:01,105,507,58,47,256.56,515.02,0.00
2024-12-10 17:18:01,106,506,58,48,253.00,515.26,0.00
2024-12-10 17:18:01,106,507,58,48,258.18,516.00,0.00
2024-12-10 17:18:01,107,507,58,49,255.77,516.01,0.00
2024-12-10 17:18:01,106,507,57,49,258.08,516.02,0.00
2024-12-10 17:18:01,106,508,57,49,263.21,517.00,0.00
2024-12-10 17:18:01,107,508,58,49,260.75,517.01,0.00
2024-12-10 17:18:01,106,508,57,49,263.11,517.02,0.00
2024-12-10 17:18:01,106,509,57,49,263.35,518.00,0.00
2024-12-10 17:18:01,107,509,58,49,260.89,518.01,0.00
2024-12-10 17:18:01,106,509,58,48,263.26,518.02,0.00
2024-12-10 17:18:01,106,510,58,48,263.46,519.00,0.00
2024-12-10 17:18:01,107,510,59,48,261.00,519.01,0.00
2024-12-10 17:18:01,106,510,58,48,263.37,519.02,0.00
2024-12-10 17:18:01,106,511,58,48,263.40,520.00,0.00
2024-12-10 17:18:01,107,511,58,49,260.94,520.01,0.00
2024-12-10 17:18:01,106,511,58,48,263.30,520.02,0.00
2024-12-10 17:18:01,106,512,58,48,263.36,521.00,0.00
2024-12-10 17:18:01,107,512,59,48,260.90,521.01,0.00
2024-12-10 17:18:01,106,512,58,48,263.26,521.02,0.00
2024-12-10 17:18:01,106,513,58,48,263.49,522.00,0.00
2024-12-10 17:18:01,107,513,59,48,261.03,522.01,0.00
2024-12-10 17:18:01,106,513,59,47,263.39,522.02,0.00
2024-12-10 17:18:01,106,514,59,47,263.70,523.00,0.00
2024-12-10 17:18:01,107,514,60,47,261.23,523.01,0.00
2024-12-10 17:18:01,106,514,59,47,263.60,523.02,0.00
2024-12-10 17:18:02,106,515,59,47,263.90,524.00,0.00
2024-12-10 17:18:02,107,515,60,47,261.44,524.01,0.00
2024-12-10 17:18:02,106,515,60,46,263.81,524.02,0.00
2024-12-10 17:18:02,106,516,60,46,264.11,525.00,0.00
2024-12-10 17:18:02,107,516,60,47,261.64,525.01,0.00
2024-12-10 17:18:02,106,516,60,46,264.01,525.02,0.00
2024-12-10 17:18:02,106,517,60,46,264.32,526.00,0.00
2024-12-10 17:18:02,107,517,60,47,261.84,526.01,0.00
2024-12-10 17:18:02,106,517,59,47,264.22,526.02,0.00
2024-12-10 17:18:02,105,517,59,46,264.56,526.45,0.00
2024-12-10 17:18:02,105,518,59,46,267.06,527.00,0.00
2024-12-10 17:18:02,106,518,60,46,264.54,527.01,0.00
2024-12-10 17:18:02,105,518,60,45,266.96,527.02,0.00
2024-12-10 17:18:02,105,519,60,45,267.32,528.00,0.00
2024-12-10 17:18:02,106,519,61,45,264.80,528.01,0.00
2024-12-10 17:18:02,105,519,61,44,267.22,528.02,0.00
2024-12-10 17:18:02,105,520,61,44,267.55,529.00,0.00
2024-12-10 17:18:02,106,520,61,45,265.03,529.01,0.00
2024-12-10 17:18:02,105,520,60,45,267.45,529.02,0.00
2024-12-10 17:18:02,105,521,60,45,267.73,530.00,0.00
2024-12-10 17:18:02,106,521,60,46,265.21,530.01,0.00
2024-12-10 17:18:02,105,521,59,46,267.63,530.02,0.00
2024-12-10 17:18:02,105,522,59,46,267.88,531.00,0.00
2024-12-10 17:18:02,106,522,60,46,265.35,531.01,0.00
2024-12-10 17:18:02,105,522,60,45,267.78,531.02,0.00
2024-12-10 17:18:02,105,523,60,45,267.93,532.00,0.00
2024-12-10 17:18:02,106,523,61,45,265.40,532.01,0.00
2024-12-10 17:18:02,105,523,61,44,267.83,532.02,0.00
2024-12-10 17:18:02,105,524,61,44,268.04,533.00,0.00
2024-12-10 17:18:02,106,524,62,44,265.51,533.01,0.00
2024-12-10 17:18:02,105,524,62,43,267.99,533.01,0.00
2024-12-10 17:18:02,104,524,61,43,270.52,533.01,0.00
2024-12-10 17:18:02,103,524,60,43,273.09,533.01,0.00
2024-12-10 17:18:02,103,525,60,43,273.36,534.00,0.00
2024-12-10 17:18:02,104,525,61,43,270.73,534.01,0.00
2024-12-10 17:18:02,104,526,61,43,270.93,535.00,0.00
2024-12-10 17:18:02,105,526,61,44,268.35,535.01,0.00
2024-12-10 17:18:02,104,526,60,44,270.83,535.02,0.00
2024-12-10 17:18:02,104,527,60,44,271.09,536.00,0.00
2024-12-10 17:18:02,105,527,61,44,268.51,536.01,0.00
2024-12-10 17:18:02,104,527,61,43,270.99,536.02,0.00
2024-12-10 17:18:02,104,528,61,43,271.27,537.00,0.00
2024-12-10 17:18:02,105,528,62,43,268.68,537.01,0.00
2024-12-10 17:18:02,104,528,62,42,271.17,537.02,0.00
2024-12-10 17:18:02,104,529,62,42,271.50,538.00,0.00
2024-12-10 17:18:02,105,529,63,42,268.92,538.01,0.00
2024-12-10 17:18:02,104,529,62,42,271.40,538.02,0.00
2024-12-10 17:18:02,104,530,62,42,271.78,539.00,0.00
2024-12-10 17:18:02,105,530,62,43,269.19,539.01,0.00
2024-12-10 17:18:02,105,531,62,43,269.49,540.00,0.00
2024-12-10 17:18:02,106,531,63,43,266.94,540.01,0.00
2024-12-10 17:18:02,105,531,62,43,269.34,540.03,0.00
2024-12-10 17:18:02,105,532,62,43,269.73,541.00,0.00
2024-12-10 17:18:02,106,532,63,43,267.18,541.01,0.00
2024-12-10 17:18:02,105,532,62,43,269.58,541.03,0.00
2024-12-10 17:18:02,105,533,62,43,269.97,542.00,0.00
2024-12-10 17:18:02,106,533,62,44,267.42,542.01,0.00
2024-12-10 17:18:02,105,533,62,43,269.82,542.03,0.00
2024-12-10 17:18:02,105,534,62,43,270.21,543.00,0.00
2024-12-10 17:18:02,106,534,62,44,267.66,543.01,0.00
2024-12-10 17:18:02,105,534,61,44,270.06,543.03,0.00
2024-12-10 17:18:02,105,535,61,44,270.32,544.00,0.00
2024-12-10 17:18:02,106,535,61,45,267.77,544.01,0.00
2024-12-10 17:18:02,105,535,61,44,270.17,544.03,0.00
2024-12-10 17:18:02,105,536,61,44,270.00,545.00,0.00
2024-12-10 17:18:02,106,536,62,44,267.45,545.01,0.00
2024-12-10 17:18:02,105,536,61,44,269.86,545.03,0.00
2024-12-10 17:18:02,105,537,61,44,269.52,546.00,0.00
2024-12-10 17:18:02,106,537,62,44,266.98,546.01,0.00
2024-12-10 17:18:02,105,537,61,44,269.38,546.03,0.00
2024-12-10 17:18:02,104,537,60,44,270.68,546.26,0.00
2024-12-10 17:18:02,104,538,60,44,272.34,547.00,0.00
2024-12-10 17:18:02,105,538,60,45,269.75,547.01,0.00
2024-12-10 17:18:02,104,538,59,45,272.19,547.03,0.00
2024-12-10 17:18:02,104,539,59,45,272.63,548.00,0.00
2024-12-10 17:18:02,105,539,59,46,270.03,548.01,0.00
2024-12-10 17:18:02,104,539,59,45,272.48,548.03,0.00
2024-12-10 17:18:02,104,540,59,45,272.92,549.00,0.00
2024-12-10 17:18:02,105,540,60,45,270.32,549.01,0.00
2024-12-10 17:18:02,104,540,59,45,272.77,549.03,0.00
2024-12-10 17:18:02,104,541,59,45,273.20,550.00,0.00
2024-12-10 17:18:02,105,541,60,45,270.60,550.01,0.00
2024-12-10 17:18:02,104,541,60,44,273.05,550.03,0.00
2024-12-10 17:18:02,104,542,60,44,273.49,551.00,0.00
2024-12-10 17:18:02,105,542,61,44,270.88,551.01,0.00
2024-12-10 17:18:02,104,542,61,43,273.34,551.03,0.00
2024-12-10 17:18:02,104,543,61,43,273.77,552.00,0.00
2024-12-10 17:18:02,105,543,62,43,271.16,552.01,0.00
2024-12-10 17:18:02,104,543,62,42,273.62,552.03,0.00
2024-12-10 17:18:02,104,544,62,42,274.05,553.00,0.00
2024-12-10 17:18:02,105,544,62,43,271.44,553.01,0.00
2024-12-10 17:18:02,104,544,61,43,273.90,553.03,0.00
2024-12-10 17:18:03,104,545,61,43,274.34,554.00,0.00
2024-12-10 17:18:03,105,545,61,44,271.72,554.01,0.00
2024-12-10 17:18:03,104,545,60,44,274.19,554.03,0.00
2024-12-10 17:18:03,104,546,60,44,274.62,555.00,0.00
2024-12-10 17:18:03,105,546,60,45,272.00,555.01,0.00
2024-12-10 17:18:03,104,546,60,44,274.47,555.03,0.00
2024-12-10 17:18:03,105,545,60,45,269.87,555.42,0.00
2024-12-10 17:18:03,105,546,60,45,275.46,556.00,0.00
2024-12-10 17:18:03,106,546,60,46,272.86,556.01,0.00
2024-12-10 17:18:03,105,546,59,46,275.31,556.03,0.00
2024-12-10 17:18:03,105,547,59,46,280.99,557.00,0.00
2024-12-10 17:18:03,106,547,59,47,278.34,557.01,0.00
2024-12-10 17:18:03,105,547,58,47,280.84,557.03,0.00
2024-12-10 17:18:03,105,548,58,47,281.23,558.00,0.00
2024-12-10 17:18:03,106,548,59,47,278.58,558.01,0.00
2024-12-10 17:18:03,105,548,59,46,281.08,558.03,0.00
2024-12-10 17:18:03,105,549,59,46,281.47,559.00,0.00
2024-12-10 17:18:03,106,549,59,47,278.81,559.01,0.00
2024-12-10 17:18:03,105,549,59,46,281.32,559.03,0.00
2024-12-10 17:18:03,105,550,59,46,281.71,560.00,0.00
2024-12-10 17:18:03,106,550,60,46,279.05,560.01,0.00
2024-12-10 17:18:03,105,550,60,45,281.55,560.03,0.00
2024-12-10 17:18:03,105,551,60,45,281.94,561.00,0.00
2024-12-10 17:18:03,106,551,61,45,279.28,561.01,0.00
2024-12-10 17:18:03,105,551,60,45,281.79,561.03,0.00
2024-12-10 17:18:03,105,552,60,45,282.18,562.00,0.00
2024-12-10 17:18:03,106,552,61,45,279.52,562.01,0.00
2024-12-10 17:18:03,105,552,61,44,282.02,562.03,0.00
2024-12-10 17:18:03,105,553,61,44,282.41,563.00,0.00
2024-12-10 17:18:03,106,553,62,44,279.75,563.01,0.00
2024-12-10 17:18:03,105,553,61,44,282.26,563.03,0.00
2024-12-10 17:18:03,105,554,61,44,282.64,564.00,0.00
2024-12-10 17:18:03,106,554,61,45,279.98,564.01,0.00
2024-12-10 17:18:03,105,554,60,45,282.49,564.03,0.00
2024-12-10 17:18:03,105,555,60,45,282.88,565.00,0.00
2024-12-10 17:18:03,106,555,60,46,280.21,565.01,0.00
2024-12-10 17:18:03,105,555,59,46,282.72,565.03,0.00
2024-12-10 17:18:03,104,555,58,46,285.39,565.03,0.00
2024-12-10 17:18:03,104,556,58,46,285.83,566.00,0.00
2024-12-10 17:18:03,105,556,59,46,283.11,566.01,0.00
2024-12-10 17:18:03,104,556,58,46,285.67,566.03,0.00
2024-12-10 17:18:03,104,557,58,46,286.12,567.00,0.00
2024-12-10 17:18:03,105,557,59,46,283.39,567.01,0.00
2024-12-10 17:18:03,104,557,58,46,285.96,567.03,0.00
2024-12-10 17:18:03,104,558,58,46,286.40,568.00,0.00
2024-12-10 17:18:03,105,558,58,47,283.68,568.01,0.00
2024-12-10 17:18:03,104,558,57,47,286.24,568.03,0.00
2024-12-10 17:18:03,104,559,57,47,286.69,569.00,0.00
2024-12-10 17:18:03,105,559,57,48,283.96,569.01,0.00
2024-12-10 17:18:03,104,559,56,48,286.53,569.03,0.00
2024-12-10 17:18:03,104,560,56,48,286.97,570.00,0.00
2024-12-10 17:18:03,105,560,56,49,284.24,570.01,0.00
2024-12-10 17:18:03,105,561,56,49,284.52,571.00,0.00
2024-12-10 17:18:03,106,561,57,49,281.84,571.01,0.00
2024-12-10 17:18:03,106,562,57,49,282.06,572.00,0.00
2024-12-10 17:18:03,107,562,58,49,279.42,572.01,0.00
2024-12-10 17:18:03,106,562,57,49,281.90,572.03,0.00
2024-12-10 17:18:03,106,563,57,49,282.23,573.00,0.00
2024-12-10 17:18:03,107,563,58,49,279.59,573.01,0.00
2024-12-10 17:18:03,106,563,58,48,282.07,573.03,0.00
2024-12-10 17:18:03,106,564,58,48,282.40,574.00,0.00
2024-12-10 17:18:03,107,564,59,48,279.76,574.01,0.00
2024-12-10 17:18:03,106,564,59,47,282.24,574.03,0.00
2024-12-10 17:18:03,106,565,59,47,282.56,575.00,0.00
2024-12-10 17:18:03,107,565,60,47,279.92,575.01,0.00
2024-12-10 17:18:03,106,565,59,47,282.41,575.03,0.00
2024-12-10 17:18:03,106,566,59,47,282.73,576.00,0.00
2024-12-10 17:18:03,107,566,59,48,280.09,576.01,0.00
2024-12-10 17:18:03,106,566,58,48,282.57,576.03,0.00
2024-12-10 17:18:03,106,567,58,48,282.89,577.00,0.00
2024-12-10 17:18:03,107,567,58,49,280.25,577.01,0.00
2024-12-10 17:18:03,106,567,58,48,282.73,577.03,0.00
2024-12-10 17:18:03,106,568,58,48,283.06,578.00,0.00
2024-12-10 17:18:03,107,568,58,49,280.41,578.01,0.00
2024-12-10 17:18:03,106,568,57,49,282.90,578.03,0.00
2024-12-10 17:18:03,106,569,57,49,283.22,579.00,0.00
2024-12-10 17:18:03,107,569,58,49,280.57,579.01,0.00
2024-12-10 17:18:03,106,569,57,49,283.06,579.03,0.00
2024-12-10 17:18:03,106,570,57,49,283.38,580.00,0.00
2024-12-10 17:18:03,107,570,58,49,280.73,580.01,0.00
2024-12-10 17:18:03,106,570,58,48,283.22,580.03,0.00
2024-12-10 17:18:04,106,571,58,48,283.54,581.00,0.00
2024-12-10 17:18:04,107,571,58,49,280.89,581.01,0.00
2024-12-10 17:18:04,106,571,58,48,283.48,581.01,0.00
2024-12-10 17:18:04,105,571,58,47,286.08,581.02,0.00
2024-12-10 17:18:04,104,571,58,46,288.77,581.02,0.00
2024-12-10 17:18:04,104,572,58,46,289.15,582.00,0.00
2024-12-10 17:18:04,105,572,58,47,286.40,582.01,0.00
2024-12-10 17:18:04,104,572,57,47,289.04,582.02,0.00
2024-12-10 17:18:04,104,573,57,47,289.43,583.00,0.00
2024-12-10 17:18:04,105,573,58,47,286.67,583.01,0.00
2024-12-10 17:18:04,104,573,57,47,289.32,583.02,0.00
2024-12-10 17:18:04,104,574,57,47,289.70,584.00,0.00
2024-12-10 17:18:04,105,574,57,48,286.94,584.01,0.00
2024-12-10 17:18:04,104,574,57,47,289.59,584.02,0.00
2024-12-10 17:18:04,104,575,57,47,289.97,585.00,0.00
2024-12-10 17:18:04,105,575,58,47,287.21,585.01,0.00
2024-12-10 17:18:04,104,575,57,47,289.86,585.02,0.00
2024-12-10 17:18:04,104,576,57,47,290.20,586.00,0.00
2024-12-10 17:18:04,105,576,58,47,287.43,586.01,0.00
2024-12-10 17:18:04,104,576,58,46,290.09,586.02,0.00
2024-12-10 17:18:04,104,577,58,46,290.35,587.00,0.00
2024-12-10 17:18:04,105,577,58,47,287.58,587.01,0.00
2024-12-10 17:18:04,104,577,58,46,290.24,587.02,0.00
2024-12-10 17:18:04,104,578,58,46,290.47,588.00,0.00
2024-12-10 17:18:04,105,578,59,46,287.70,588.01,0.00
2024-12-10 17:18:04,104,578,59,45,290.36,588.02,0.00
2024-12-10 17:18:04,104,579,59,45,290.58,589.00,0.00
2024-12-10 17:18:04,105,579,60,45,287.81,589.01,0.00
2024-12-10 17:18:04,104,579,59,45,290.46,589.02,0.00
2024-12-10 17:18:04,104,580,59,45,290.70,590.00,0.00
2024-12-10 17:18:04,105,580,60,45,287.94,590.01,0.00
2024-12-10 17:18:04,104,580,60,44,290.59,590.02,0.00
2024-12-10 17:18:04,104,581,60,44,290.79,591.00,0.00
2024-12-10 17:18:04,105,581,60,45,288.02,591.01,0.00
2024-12-10 17:18:04,104,581,59,45,290.68,591.02,0.00
2024-12-10 17:18:04,104,582,59,45,290.81,592.00,0.00
2024-12-10 17:18:04,105,582,60,45,288.04,592.01,0.00
2024-12-10 17:18:04,104,582,59,45,290.70,592.02,0.00
2024-12-10 17:18:04,104,583,59,45,290.74,593.00,0.00
2024-12-10 17:18:04,105,583,60,45,287.97,593.01,0.00
2024-12-10 17:18:04,104,583,59,45,290.63,593.02,0.00
2024-12-10 17:18:04,104,584,59,45,290.61,594.00,0.00
2024-12-10 17:18:04,105,584,59,46,287.84,594.01,0.00
2024-12-10 17:18:04,104,584,58,46,290.50,594.02,0.00
2024-12-10 17:18:04,104,585,58,46,290.43,595.00,0.00
2024-12-10 17:18:04,105,585,59,46,287.67,595.01,0.00
2024-12-10 17:18:04,105,586,59,46,287.51,596.00,0.00
2024-12-10 17:18:04,106,586,60,46,284.79,596.01,0.00
2024-12-10 17:18:04,105,586,60,45,287.34,596.03,0.00
2024-12-10 17:18:04,104,586,60,44,290.05,596.03,0.00
2024-12-10 17:18:04,104,587,60,44,290.10,597.00,0.00
2024-12-10 17:18:04,105,587,61,44,287.34,597.01,0.00
2024-12-10 17:18:04,104,587,60,44,289.93,597.03,0.00
2024-12-10 17:18:04,104,588,60,44,290.08,598.00,0.00
2024-12-10 17:18:04,105,588,61,44,287.31,598.01,0.00
2024-12-10 17:18:04,104,588,60,44,289.91,598.03,0.00
2024-12-10 17:18:04,105,587,60,45,281.85,598.98,0.00
2024-12-10 17:18:04,105,588,60,45,287.58,599.00,0.00
2024-12-10 17:18:04,106,588,61,45,284.86,599.01,0.00
2024-12-10 17:18:04,105,588,61,44,287.41,599.03,0.00
2024-12-10 17:18:04,105,589,61,44,293.46,600.00,0.00
2024-12-10 17:18:04,106,589,62,44,290.69,600.01,0.00
2024-12-10 17:18:04,105,589,61,44,293.29,600.03,0.00
2024-12-10 17:18:04,105,590,61,44,293.66,601.00,0.00
2024-12-10 17:18:04,106,590,61,45,290.89,601.01,0.00
2024-12-10 17:18:04,105,590,60,45,293.49,601.03,0.00
2024-12-10 17:18:04,105,591,60,45,293.86,602.00,0.00
2024-12-10 17:18:04,106,591,60,46,291.09,602.01,0.00
2024-12-10 17:18:04,105,591,60,45,293.69,602.03,0.00
2024-12-10 17:18:04,105,592,60,45,294.06,603.00,0.00
2024-12-10 17:18:04,106,592,61,45,291.29,603.01,0.00
2024-12-10 17:18:04,105,592,60,45,293.89,603.03,0.00
2024-12-10 17:18:04,104,592,60,44,294.65,603.38,0.00
2024-12-10 17:18:04,104,593,60,44,297.11,604.00,0.00
2024-12-10 17:18:04,105,593,60,45,294.28,604.01,0.00
2024-12-10 17:18:04,104,593,60,44,296.94,604.03,0.00
2024-12-10 17:18:04,104,594,60,44,297.37,605.00,0.00
2024-12-10 17:18:04,105,594,60,45,294.53,605.01,0.00
2024-12-10 17:18:04,104,594,59,45,297.20,605.03,0.00
2024-12-10 17:18:05,104,595,59,45,297.63,606.00,0.00
2024-12-10 17:18:05,105,595,60,45,294.79,606.01,0.00
2024-12-10 17:18:05,104,595,59,45,297.46,606.03,0.00
2024-12-10 17:18:05,105,594,59,46,289.68,606.92,0.00
2024-12-10 17:18:05,105,595,59,46,295.47,607.00,0.00
2024-12-10 17:18:05,106,595,60,46,292.68,607.01,0.00
2024-12-10 17:18:05,105,595,59,46,295.30,607.03,0.00
2024-12-10 17:18:05,105,596,59,46,301.26,608.00,0.00
2024-12-10 17:18:05,106,596,60,46,298.42,608.01,0.00
2024-12-10 17:18:05,105,596,60,45,301.10,608.03,0.00
2024-12-10 17:18:05,105,597,60,45,301.09,609.00,0.00
2024-12-10 17:18:05,106,597,60,46,298.25,609.01,0.00
2024-12-10 17:18:05,105,597,60,45,300.92,609.03,0.00
2024-12-10 17:18:05,105,598,60,45,300.75,610.00,0.00
2024-12-10 17:18:05,106,598,60,46,297.92,610.01,0.00
2024-12-10 17:18:05,105,598,59,46,300.58,610.03,0.00
2024-12-10 17:18:05,106,597,60,46,291.99,610.95,0.00
2024-12-10 17:18:05,106,598,60,46,297.74,611.00,0.00
2024-12-10 17:18:05,107,598,60,47,294.96,611.01,0.00
2024-12-10 17:18:05,106,598,59,47,297.58,611.03,0.00
2024-12-10 17:18:05,107,597,59,48,294.40,611.11,0.00
2024-12-10 17:18:05,107,598,59,48,305.41,612.00,0.00
2024-12-10 17:18:05,108,598,60,48,302.58,612.01,0.00
2024-12-10 17:18:05,107,598,59,48,305.24,612.03,0.00
2024-12-10 17:18:05,107,599,59,48,310.47,613.00,0.00
2024-12-10 17:18:05,108,599,60,48,307.60,613.01,0.00
2024-12-10 17:18:05,107,599,59,48,310.31,613.03,0.00
2024-12-10 17:18:05,107,600,59,48,309.79,614.00,0.00
2024-12-10 17:18:05,108,600,59,49,306.92,614.01,0.00
2024-12-10 17:18:05,107,600,59,48,309.62,614.03,0.00
2024-12-10 17:18:05,106,600,59,47,310.67,614.30,0.00
2024-12-10 17:18:05,106,601,59,47,312.14,615.00,0.00
2024-12-10 17:18:05,107,601,59,48,309.22,615.01,0.00
2024-12-10 17:18:05,106,601,59,47,312.08,615.01,0.00
2024-12-10 17:18:05,105,601,59,46,314.94,615.02,0.00
2024-12-10 17:18:05,104,601,59,45,317.91,615.02,0.00
2024-12-10 17:18:05,103,601,58,45,319.04,615.32,0.00
2024-12-10 17:18:05,103,602,58,45,320.94,616.00,0.00
2024-12-10 17:18:05,104,602,59,45,317.85,616.01,0.00
2024-12-10 17:18:05,103,602,59,44,320.82,616.02,0.00
2024-12-10 17:18:05,102,602,58,44,322.63,616.24,0.00
2024-12-10 17:18:05,102,603,58,44,324.01,617.00,0.00
2024-12-10 17:18:05,103,603,58,45,320.86,617.01,0.00
2024-12-10 17:18:05,102,603,57,45,323.89,617.02,0.00
2024-12-10 17:18:05,102,604,57,45,323.91,618.00,0.00
2024-12-10 17:18:05,103,604,58,45,320.77,618.01,0.00
2024-12-10 17:18:05,102,604,57,45,322.12,618.30,0.00
2024-12-10 17:18:05,102,605,57,45,324.23,619.00,0.00
2024-12-10 17:18:05,103,605,58,45,321.08,619.01,0.00
2024-12-10 17:18:05,102,605,57,45,324.06,619.03,0.00
2024-12-10 17:18:05,102,606,57,45,324.55,620.00,0.00
2024-12-10 17:18:05,103,606,58,45,321.40,620.01,0.00
2024-12-10 17:18:05,102,606,58,44,324.38,620.03,0.00
2024-12-10 17:18:05,102,607,58,44,324.93,621.00,0.00
2024-12-10 17:18:05,103,607,58,45,321.77,621.01,0.00
2024-12-10 17:18:05,102,607,57,45,324.75,621.03,0.00
2024-12-10 17:18:05,102,608,57,45,325.33,622.00,0.00
2024-12-10 17:18:05,103,608,58,45,322.17,622.01,0.00
2024-12-10 17:18:05,102,608,57,45,325.16,622.03,0.00
2024-12-10 17:18:05,102,609,57,45,325.73,623.00,0.00
2024-12-10 17:18:05,103,609,58,45,322.56,623.01,0.00
2024-12-10 17:18:05,102,609,57,45,325.56,623.03,0.00
2024-12-10 17:18:05,102,610,57,45,326.13,624.00,0.00
2024-12-10 17:18:05,103,610,57,46,322.96,624.01,0.00
2024-12-10 17:18:05,102,610,56,46,325.96,624.03,0.00
2024-12-10 17:18:05,102,611,56,46,326.53,625.00,0.00
2024-12-10 17:18:05,103,611,57,46,323.36,625.01,0.00
2024-12-10 17:18:05,102,611,57,45,326.36,625.03,0.00
2024-12-10 17:18:05,102,612,57,45,326.93,626.00,0.00
2024-12-10 17:18:05,103,612,58,45,323.75,626.01,0.00
2024-12-10 17:18:05,102,612,58,44,326.75,626.03,0.00
2024-12-10 17:18:05,102,613,58,44,327.19,627.00,0.00
2024-12-10 17:18:05,103,613,59,44,324.02,627.01,0.00
2024-12-10 17:18:05,102,613,58,44,327.02,627.03,0.00
2024-12-10 17:18:05,102,614,58,44,327.40,628.00,0.00
2024-12-10 17:18:05,103,614,59,44,324.22,628.01,0.00
2024-12-10 17:18:05,102,614,58,44,327.23,628.03,0.00
2024-12-10 17:18:05,102,615,58,44,327.53,629.00,0.00
2024-12-10 17:18:05,103,615,59,44,324.35,629.01,0.00
2024-12-10 17:18:05,102,615,59,43,327.36,629.03,0.00
2024-12-10 17:18:05,101,615,59,42,329.05,629.23,0.00
2024-12-10 17:18:05,101,616,59,42,330.91,630.00,0.00
2024-12-10 17:18:05,102,616,59,43,327.66,630.01,0.00
2024-12-10 17:18:05,101,616,59,42,330.73,630.03,0.00
2024-12-10 17:18:05,101,617,59,42,331.31,631.00,0.00
2024-12-10 17:18:05,102,617,59,43,328.06,631.01,0.00
2024-12-10 17:18:05,101,617,58,43,331.13,631.03,0.00
2024-12-10 17:18:05,101,618,58,43,331.65,632.00,0.00
2024-12-10 17:18:05,102,618,59,43,328.40,632.01,0.00
2024-12-10 17:18:05,101,618,58,43,331.47,632.03,0.00
2024-12-10 17:18:05,101,619,58,43,331.95,633.00,0.00
2024-12-10 17:18:05,102,619,58,44,328.70,633.01,0.00
2024-12-10 17:18:05,101,619,57,44,331.78,633.03,0.00
2024-12-10 17:18:05,101,620,57,44,332.22,634.00,0.00
2024-12-10 17:18:05,102,620,58,44,328.97,634.01,0.00
2024-12-10 17:18:05,101,620,57,44,332.05,634.03,0.00
2024-12-10 17:18:05,101,621,57,44,332.48,635.00,0.00
2024-12-10 17:18:05,102,621,58,44,329.22,635.01,0.00
2024-12-10 17:18:05,101,621,58,43,332.30,635.03,0.00
2024-12-10 17:18:06,101,622,58,43,332.74,636.00,0.00
2024-12-10 17:18:06,102,622,59,43,329.48,636.01,0.00
2024-12-10 17:18:06,101,622,58,43,332.56,636.03,0.00
2024-12-10 17:18:06,101,623,58,43,333.01,637.00,0.00
2024-12-10 17:18:06,102,623,58,44,329.75,637.01,0.00
2024-12-10 17:18:06,101,623,57,44,332.83,637.03,0.00
2024-12-10 17:18:06,101,624,57,44,333.30,638.00,0.00
2024-12-10 17:18:06,102,624,58,44,330.04,638.01,0.00
2024-12-10 17:18:06,101,624,57,44,333.12,638.03,0.00
2024-12-10 17:18:06,100,624,57,43,335.42,638.18,0.00
2024-12-10 17:18:06,100,625,57,43,337.07,639.00,0.00
2024-12-10 17:18:06,101,625,57,44,333.73,639.01,0.00
2024-12-10 17:18:06,101,626,57,44,334.26,640.00,0.00
2024-12-10 17:18:06,102,626,58,44,330.98,640.01,0.00
2024-12-10 17:18:06,102,627,58,44,331.41,641.00,0.00
2024-12-10 17:18:06,103,627,58,45,328.19,641.01,0.00
2024-12-10 17:18:06,102,627,57,45,331.23,641.03,0.00
2024-12-10 17:18:06,102,628,57,45,331.77,642.00,0.00
2024-12-10 17:18:06,103,628,58,45,328.55,642.01,0.00
2024-12-10 17:18:06,102,628,58,44,331.59,642.03,0.00
2024-12-10 17:18:06,102,629,58,44,332.14,643.00,0.00
2024-12-10 17:18:06,103,629,58,45,328.92,643.01,0.00
2024-12-10 17:18:06,102,629,58,44,331.96,643.03,0.00
2024-12-10 17:18:06,103,628,58,45,324.63,643.73,0.00
2024-12-10 17:18:06,103,629,58,45,331.12,644.00,0.00
2024-12-10 17:18:06,104,629,59,45,327.93,644.01,0.00
2024-12-10 17:18:06,104,630,59,45,334.44,645.00,0.00
2024-12-10 17:18:06,105,630,59,46,331.26,645.01,0.00
2024-12-10 17:18:06,104,630,58,46,334.17,645.03,0.00
2024-12-10 17:18:06,104,631,58,46,334.62,646.00,0.00
2024-12-10 17:18:06,105,631,59,46,331.43,646.01,0.00
2024-12-10 17:18:06,104,631,58,46,334.31,646.03,0.00
2024-12-10 17:18:06,104,632,58,46,334.76,647.00,0.00
2024-12-10 17:18:06,105,632,58,47,331.57,647.01,0.00
2024-12-10 17:18:06,104,632,58,46,334.42,647.03,0.00
2024-12-10 17:18:06,104,633,58,46,334.87,648.00,0.00
2024-12-10 17:18:06,105,633,58,47,331.68,648.01,0.00
2024-12-10 17:18:06,104,633,58,46,334.55,648.03,0.00
2024-12-10 17:18:06,104,634,58,46,335.00,649.00,0.00
2024-12-10 17:18:06,105,634,58,47,331.81,649.01,0.00
2024-12-10 17:18:06,105,635,58,47,331.96,650.00,0.00
2024-12-10 17:18:06,106,635,58,48,328.82,650.01,0.00
2024-12-10 17:18:06,105,635,57,48,331.70,650.03,0.00
2024-12-10 17:18:06,105,636,57,48,332.08,651.00,0.00
2024-12-10 17:18:06,106,636,58,48,328.94,651.01,0.00
2024-12-10 17:18:06,106,637,58,48,329.05,652.00,0.00
2024-12-10 17:18:06,107,637,58,49,325.98,652.01,0.00
2024-12-10 17:18:06,106,637,57,49,328.77,652.03,0.00
2024-12-10 17:18:06,106,638,57,49,329.09,653.00,0.00
2024-12-10 17:18:06,107,638,57,50,326.01,653.01,0.00
2024-12-10 17:18:06,106,638,57,49,328.79,653.03,0.00
2024-12-10 17:18:06,106,639,57,49,329.10,654.00,0.00
2024-12-10 17:18:06,107,639,57,50,326.03,654.01,0.00
2024-12-10 17:18:06,106,639,57,49,328.86,654.03,0.00
2024-12-10 17:18:06,106,640,57,49,329.17,655.00,0.00
2024-12-10 17:18:06,107,640,58,49,326.10,655.01,0.00
2024-12-10 17:18:06,106,640,58,48,329.11,655.01,0.00
2024-12-10 17:18:06,105,640,58,47,332.13,655.02,0.00
2024-12-10 17:18:06,105,641,58,47,332.44,656.00,0.00
2024-12-10 17:18:06,106,641,59,47,329.30,656.01,0.00
2024-12-10 17:18:06,105,641,59,46,332.32,656.02,0.00
2024-12-10 17:18:06,105,642,59,46,332.61,657.00,0.00
2024-12-10 17:18:06,106,642,59,47,329.47,657.01,0.00
2024-12-10 17:18:06,105,642,59,46,332.48,657.02,0.00
2024-12-10 17:18:06,105,643,59,46,332.73,658.00,0.00
2024-12-10 17:18:06,106,643,59,47,329.59,658.01,0.00
2024-12-10 17:18:06,105,643,58,47,332.61,658.02,0.00
2024-12-10 17:18:06,105,644,58,47,332.82,659.00,0.00
2024-12-10 17:18:06,106,644,59,47,329.68,659.01,0.00
2024-12-10 17:18:06,107,643,59,48,324.33,659.38,0.00
2024-12-10 17:18:06,107,644,59,48,330.48,660.00,0.00
2024-12-10 17:18:06,108,644,59,49,327.42,660.01,0.00
2024-12-10 17:18:06,107,644,58,49,330.36,660.02,0.00
2024-12-10 17:18:06,108,643,59,49,323.13,660.69,0.00
2024-12-10 17:18:06,108,644,59,49,335.50,661.00,0.00
2024-12-10 17:18:06,109,644,60,49,332.42,661.01,0.00
2024-12-10 17:18:06,108,644,59,49,335.38,661.02,0.00
2024-12-10 17:18:06,108,645,59,49,341.53,662.00,0.00
2024-12-10 17:18:06,109,645,60,49,338.39,662.01,0.00
2024-12-10 17:18:06,108,645,59,49,341.41,662.02,0.00
2024-12-10 17:18:06,108,646,59,49,341.49,663.00,0.00
2024-12-10 17:18:06,109,646,59,50,338.35,663.01,0.00
2024-12-10 17:18:06,108,646,58,50,341.37,663.02,0.00
2024-12-10 17:18:06,108,647,58,50,341.50,664.00,0.00
2024-12-10 17:18:06,109,647,58,51,338.37,664.01,0.00
2024-12-10 17:18:06,108,647,58,50,341.38,664.02,0.00
2024-12-10 17:18:06,108,648,58,50,341.52,665.00,0.00
2024-12-10 17:18:06,109,648,59,50,338.39,665.01,0.00
2024-12-10 17:18:06,108,648,59,49,341.40,665.02,0.00
2024-12-10 17:18:06,108,649,59,49,341.54,666.00,0.00
2024-12-10 17:18:06,109,649,59,50,338.41,666.01,0.00
2024-12-10 17:18:06,108,649,58,50,341.42,666.02,0.00
2024-12-10 17:18:07,108,650,58,50,341.56,667.00,0.00
2024-12-10 17:18:07,109,650,59,50,338.43,667.01,0.00
2024-12-10 17:18:07,108,650,58,50,341.44,667.02,0.00
2024-12-10 17:18:07,108,651,58,50,341.58,668.00,0.00
2024-12-10 17:18:07,109,651,58,51,338.44,668.01,0.00
2024-12-10 17:18:07,108,651,58,50,341.41,668.02,0.00
2024-12-10 17:18:07,109,650,59,50,333.03,668.88,0.00
2024-12-10 17:18:07,109,651,59,50,339.15,669.00,0.00
2024-12-10 17:18:07,110,651,59,51,336.07,669.01,0.00
2024-12-10 17:18:07,109,651,59,50,338.92,669.02,0.00
2024-12-10 17:18:07,109,652,59,50,345.14,670.00,0.00
2024-12-10 17:18:07,110,652,59,51,342.00,670.01,0.00
2024-12-10 17:18:07,109,652,59,50,344.83,670.02,0.00
2024-12-10 17:18:07,109,653,59,50,344.91,671.00,0.00
2024-12-10 17:18:07,110,653,59,51,341.77,671.01,0.00
2024-12-10 17:18:07,109,653,58,51,344.61,671.02,0.00
2024-12-10 17:18:07,109,654,58,51,344.70,672.00,0.00
2024-12-10 17:18:07,110,654,58,52,341.56,672.01,0.00
2024-12-10 17:18:07,109,654,57,52,344.44,672.02,0.00
2024-12-10 17:18:07,109,655,57,52,344.52,673.00,0.00
2024-12-10 17:18:07,110,655,58,52,341.39,673.01,0.00
2024-12-10 17:18:07,109,655,57,52,344.40,673.02,0.00
2024-12-10 17:18:07,109,656,57,52,344.48,674.00,0.00
2024-12-10 17:18:07,110,656,58,52,341.35,674.01,0.00
2024-12-10 17:18:07,109,656,57,52,344.36,674.02,0.00
2024-12-10 17:18:07,109,657,57,52,344.43,675.00,0.00
2024-12-10 17:18:07,110,657,57,53,341.30,675.01,0.00
2024-12-10 17:18:07,109,657,56,53,344.31,675.02,0.00
2024-12-10 17:18:07,110,656,57,53,339.50,675.29,0.00
2024-12-10 17:18:07,110,657,57,53,345.68,676.00,0.00
2024-12-10 17:18:07,111,657,58,53,342.56,676.01,0.00
2024-12-10 17:18:07,110,657,58,52,345.56,676.02,0.00
2024-12-10 17:18:07,110,658,58,52,351.73,677.00,0.00
2024-12-10 17:18:07,111,658,59,52,348.56,677.01,0.00
2024-12-10 17:18:07,110,658,59,51,351.61,677.02,0.00
2024-12-10 17:18:07,110,659,59,51,351.63,678.00,0.00
2024-12-10 17:18:07,111,659,60,51,348.46,678.01,0.00
2024-12-10 17:18:07,110,659,60,50,351.51,678.02,0.00
2024-12-10 17:18:07,110,660,60,50,351.52,679.00,0.00
2024-12-10 17:18:07,111,660,61,50,348.36,679.01,0.00
2024-12-10 17:18:07,110,660,60,50,351.40,679.02,0.00
2024-12-10 17:18:07,110,661,60,50,351.32,680.00,0.00
2024-12-10 17:18:07,111,661,61,50,348.16,680.01,0.00
2024-12-10 17:18:07,110,661,60,50,351.20,680.02,0.00
2024-12-10 17:18:07,110,662,60,50,351.01,681.00,0.00
2024-12-10 17:18:07,111,662,60,51,347.84,681.01,0.00
2024-12-10 17:18:07,110,662,60,50,350.88,681.02,0.00
2024-12-10 17:18:07,110,663,60,50,350.79,682.00,0.00
2024-12-10 17:18:07,111,663,60,51,347.63,682.01,0.00
2024-12-10 17:18:07,110,663,60,50,350.66,682.02,0.00
2024-12-10 17:18:07,110,664,60,50,350.60,683.00,0.00
2024-12-10 17:18:07,111,664,60,51,347.44,683.01,0.00
2024-12-10 17:18:07,110,664,59,51,350.57,683.01,0.00
2024-12-10 17:18:07,109,664,58,51,353.72,683.01,0.00
2024-12-10 17:18:07,109,665,58,51,353.69,684.00,0.00
2024-12-10 17:18:07,110,665,59,51,350.47,684.01,0.00
2024-12-10 17:18:07,109,665,59,50,353.63,684.01,0.00
2024-12-10 17:18:07,109,666,59,50,353.46,685.00,0.00
2024-12-10 17:18:07,110,666,59,51,350.24,685.01,0.00
2024-12-10 17:18:07,109,666,58,51,353.39,685.01,0.00
2024-12-10 17:18:07,108,666,58,50,354.67,685.28,0.00
2024-12-10 17:18:07,108,667,58,50,356.53,686.00,0.00
2024-12-10 17:18:07,109,667,59,50,353.26,686.01,0.00
2024-12-10 17:18:07,108,667,58,50,356.47,686.01,0.00
2024-12-10 17:18:07,108,668,58,50,356.54,687.00,0.00
2024-12-10 17:18:07,109,668,59,50,353.27,687.01,0.00
2024-12-10 17:18:07,108,668,59,49,356.48,687.01,0.00
2024-12-10 17:18:07,108,669,59,49,356.55,688.00,0.00
2024-12-10 17:18:07,109,669,59,50,353.28,688.01,0.00
2024-12-10 17:18:07,108,669,58,50,356.49,688.01,0.00
2024-12-10 17:18:07,108,670,58,50,356.56,689.00,0.00
2024-12-10 17:18:07,109,670,59,50,353.29,689.01,0.00
2024-12-10 17:18:07,108,670,58,50,356.49,689.01,0.00
2024-12-10 17:18:07,108,671,58,50,356.56,690.00,0.00
2024-12-10 17:18:07,109,671,58,51,353.29,690.01,0.00
2024-12-10 17:18:07,108,671,57,51,356.50,690.01,0.00
2024-12-10 17:18:07,108,672,57,51,356.57,691.00,0.00
2024-12-10 17:18:07,109,672,58,51,353.30,691.01,0.00
2024-12-10 17:18:07,108,672,58,50,356.50,691.01,0.00
2024-12-10 17:18:07,108,673,58,50,356.57,692.00,0.00
2024-12-10 17:18:07,109,673,59,50,353.30,692.01,0.00
2024-12-10 17:18:07,108,673,58,50,356.51,692.01,0.00
2024-12-10 17:18:07,108,674,58,50,356.57,693.00,0.00
2024-12-10 17:18:07,109,674,58,51,353.30,693.01,0.00
2024-12-10 17:18:07,108,674,57,51,356.51,693.01,0.00
2024-12-10 17:18:07,108,675,57,51,356.57,694.00,0.00
2024-12-10 17:18:07,109,675,58,51,353.30,694.01,0.00
2024-12-10 17:18:07,108,675,58,50,356.51,694.01,0.00
2024-12-10 17:18:07,108,676,58,50,356.57,695.00,0.00
2024-12-10 17:18:07,109,676,59,50,353.30,695.01,0.00
2024-12-10 17:18:08,109,677,59,50,353.30,696.00,0.00
2024-12-10 17:18:08,110,677,59,51,350.09,696.01,0.00
2024-12-10 17:18:08,109,677,58,51,353.17,696.02,0.00
2024-12-10 17:18:08,109,678,58,51,353.23,697.00,0.00
2024-12-10 17:18:08,110,678,58,52,350.02,697.01,0.00
2024-12-10 17:18:08,110,679,58,52,349.95,698.00,0.00
2024-12-10 17:18:08,111,679,59,52,346.80,698.01,0.00
2024-12-10 17:18:08,110,679,58,52,349.89,698.01,0.00
2024-12-10 17:18:08,109,679,58,51,352.91,698.03,0.00
2024-12-10 17:18:08,109,680,58,51,353.03,699.00,0.00
2024-12-10 17:18:08,110,680,59,51,349.82,699.01,0.00
2024-12-10 17:18:08,109,680,58,51,352.84,699.03,0.00
2024-12-10 17:18:08,109,681,58,51,352.95,700.00,0.00
2024-12-10 17:18:08,110,681,59,51,349.75,700.01,0.00
2024-12-10 17:18:08,109,681,58,51,352.77,700.03,0.00
2024-12-10 17:18:08,109,682,58,51,352.88,701.00,0.00
2024-12-10 17:18:08,110,682,58,52,349.67,701.01,0.00
2024-12-10 17:18:08,109,682,58,51,352.69,701.03,0.00
2024-12-10 17:18:08,109,683,58,51,352.80,702.00,0.00
2024-12-10 17:18:08,110,683,58,52,349.60,702.01,0.00
2024-12-10 17:18:08,109,683,58,51,352.62,702.03,0.00
2024-12-10 17:18:08,109,684,58,51,352.73,703.00,0.00
2024-12-10 17:18:08,110,684,58,52,349.52,703.01,0.00
2024-12-10 17:18:08,110,685,58,52,349.44,704.00,0.00
2024-12-10 17:18:08,111,685,59,52,346.29,704.01,0.00
2024-12-10 17:18:08,110,685,59,51,349.20,704.04,0.00
2024-12-10 17:18:08,110,686,59,51,349.29,705.00,0.00
2024-12-10 17:18:08,111,686,60,51,346.15,705.01,0.00
2024-12-10 17:18:08,111,687,60,51,345.93,706.00,0.00
2024-12-10 17:18:08,112,687,61,51,342.84,706.01,0.00
2024-12-10 17:18:08,111,687,60,51,345.81,706.02,0.00
2024-12-10 17:18:08,110,687,59,51,348.76,706.04,0.00
2024-12-10 17:18:08,109,687,59,50,351.90,706.04,0.00
2024-12-10 17:18:08,109,688,59,50,351.89,707.00,0.00
2024-12-10 17:18:08,110,688,60,50,348.69,707.01,0.00
2024-12-10 17:18:08,109,688,59,50,351.64,707.04,0.00
2024-12-10 17:18:08,109,689,59,50,351.49,708.00,0.00
2024-12-10 17:18:08,110,689,59,51,348.30,708.01,0.00
2024-12-10 17:18:08,109,689,58,51,351.25,708.04,0.00
2024-12-10 17:18:08,109,690,58,51,350.99,709.00,0.00
2024-12-10 17:18:08,110,690,58,52,347.80,709.01,0.00
2024-12-10 17:18:08,109,690,58,51,350.74,709.04,0.00
2024-12-10 17:18:08,109,691,58,51,350.41,710.00,0.00
2024-12-10 17:18:08,110,691,58,52,347.23,710.01,0.00
2024-12-10 17:18:08,109,691,58,51,350.23,710.03,0.00
2024-12-10 17:18:08,108,691,58,50,353.41,710.03,0.00
2024-12-10 17:18:08,107,691,57,50,356.64,710.03,0.00
2024-12-10 17:18:08,107,692,57,50,356.30,711.00,0.00
2024-12-10 17:18:08,108,692,57,51,353.00,711.01,0.00
2024-12-10 17:18:08,107,692,57,50,356.11,711.03,0.00
2024-12-10 17:18:08,107,693,57,50,355.53,712.00,0.00
2024-12-10 17:18:08,108,693,57,51,352.24,712.01,0.00
2024-12-10 17:18:08,107,693,56,51,355.34,712.03,0.00
2024-12-10 17:18:08,107,694,56,51,354.54,713.00,0.00
2024-12-10 17:18:08,108,694,56,52,351.25,713.01,0.00
2024-12-10 17:18:08,107,694,55,52,354.35,713.03,0.00
2024-12-10 17:18:08,107,695,55,52,353.33,714.00,0.00
2024-12-10 17:18:08,108,695,55,53,350.06,714.01,0.00
2024-12-10 17:18:08,108,696,55,53,348.70,715.00,0.00
2024-12-10 17:18:08,109,696,55,54,345.50,715.01,0.00
2024-12-10 17:18:08,108,696,55,53,348.45,715.04,0.00
2024-12-10 17:18:08,108,697,55,53,347.13,716.00,0.00
2024-12-10 17:18:08,109,697,55,54,343.94,716.01,0.00
2024-12-10 17:18:08,108,697,54,54,346.87,716.04,0.00
2024-12-10 17:18:08,107,697,53,54,345.39,716.55,0.00
2024-12-10 17:18:08,107,698,53,54,349.02,717.00,0.00
2024-12-10 17:18:08,108,698,54,54,345.79,717.01,0.00
2024-12-10 17:18:08,107,698,54,53,348.77,717.04,0.00
2024-12-10 17:18:08,106,698,54,52,348.83,717.49,0.00
2024-12-10 17:18:08,106,699,54,52,352.15,718.00,0.00
2024-12-10 17:18:08,107,699,54,53,348.85,718.01,0.00
2024-12-10 17:18:08,106,699,53,53,351.89,718.04,0.00
2024-12-10 17:18:08,106,700,53,53,352.09,719.00,0.00
2024-12-10 17:18:08,107,700,54,53,348.80,719.01,0.00
2024-12-10 17:18:08,106,700,53,53,351.83,719.04,0.00
2024-12-10 17:18:08,106,701,53,53,352.06,720.00,0.00
2024-12-10 17:18:08,107,701,53,54,348.77,720.01,0.00
2024-12-10 17:18:08,106,701,52,54,351.80,720.04,0.00
2024-12-10 17:18:08,106,702,52,54,352.03,721.00,0.00
2024-12-10 17:18:08,107,702,53,54,348.74,721.01,0.00
2024-12-10 17:18:08,106,702,53,53,351.77,721.04,0.00
2024-12-10 17:18:08,106,703,53,53,351.96,722.00,0.00
2024-12-10 17:18:08,107,703,53,54,348.67,722.01,0.00
2024-12-10 17:18:08,106,703,52,54,351.70,722.04,0.00
2024-12-10 17:18:08,105,703,51,54,351.06,722.58,0.00
2024-12-10 17:18:08,105,704,51,54,355.23,723.00,0.00
2024-12-10 17:18:08,106,704,52,54,351.88,723.01,0.00
2024-12-10 17:18:08,105,704,51,54,354.97,723.04,0.00
2024-12-10 17:18:08,105,705,51,54,355.38,724.00,0.00
2024-12-10 17:18:08,106,705,52,54,352.03,724.01,0.00
2024-12-10 17:18:08,105,705,52,53,355.11,724.04,0.00
2024-12-10 17:18:08,105,706,52,53,355.53,725.00,0.00
2024-12-10 17:18:08,106,706,53,53,352.17,725.01,0.00
2024-12-10 17:18:08,105,706,52,53,355.26,725.04,0.00
2024-12-10 17:18:09,105,707,52,53,355.67,726.00,0.00
2024-12-10 17:18:09,106,707,53,53,352.32,726.01,0.00
2024-12-10 17:18:09,105,707,52,53,355.40,726.04,0.00
2024-12-10 17:18:09,105,708,52,53,355.81,727.00,0.00
2024-12-10 17:18:09,106,708,53,53,352.46,727.01,0.00
2024-12-10 17:18:09,106,709,53,53,352.57,728.00,0.00
2024-12-10 17:18:09,107,709,54,53,349.27,728.01,0.00
2024-12-10 17:18:09,106,709,53,53,352.23,728.05,0.00
2024-12-10 17:18:09,106,710,53,53,352.39,729.00,0.00
2024-12-10 17:18:09,107,710,53,54,349.10,729.01,0.00
2024-12-10 17:18:09,106,710,52,54,352.06,729.05,0.00
2024-12-10 17:18:09,106,711,52,54,351.98,730.00,0.00
2024-12-10 17:18:09,107,711,53,54,348.69,730.01,0.00
2024-12-10 17:18:09,106,711,53,53,351.64,730.05,0.00
2024-12-10 17:18:09,106,712,53,53,351.30,731.00,0.00
2024-12-10 17:18:09,107,712,54,53,348.02,731.01,0.00
2024-12-10 17:18:09,106,712,54,52,350.97,731.05,0.00
2024-12-10 17:18:09,106,713,54,52,350.36,732.00,0.00
2024-12-10 17:18:09,107,713,55,52,347.09,732.01,0.00
2024-12-10 17:18:09,106,713,54,52,350.03,732.05,0.00
2024-12-10 17:18:09,105,713,53,52,349.66,732.49,0.00
2024-12-10 17:18:09,105,714,53,52,353.24,733.00,0.00
2024-12-10 17:18:09,106,714,53,53,349.90,733.01,0.00
2024-12-10 17:18:09,105,714,53,52,352.90,733.05,0.00
2024-12-10 17:18:09,105,715,53,52,353.37,734.00,0.00
2024-12-10 17:18:09,106,715,53,53,350.03,734.01,0.00
2024-12-10 17:18:09,105,715,52,53,353.03,734.05,0.00
2024-12-10 17:18:09,105,716,52,53,353.49,735.00,0.00
2024-12-10 17:18:09,106,716,53,53,350.15,735.01,0.00
2024-12-10 17:18:09,105,716,52,53,353.14,735.05,0.00
2024-12-10 17:18:09,105,717,52,53,353.44,736.00,0.00
2024-12-10 17:18:09,106,717,52,54,350.11,736.01,0.00
2024-12-10 17:18:09,105,717,51,54,353.10,736.05,0.00
2024-12-10 17:18:09,105,718,51,54,353.23,737.00,0.00
2024-12-10 17:18:09,106,718,52,54,349.89,737.01,0.00
2024-12-10 17:18:09,105,718,52,53,352.88,737.05,0.00
2024-12-10 17:18:09,104,718,51,53,355.76,737.12,0.00
2024-12-10 17:18:09,104,719,51,53,356.79,738.00,0.00
2024-12-10 17:18:09,105,719,52,53,353.40,738.01,0.00
2024-12-10 17:18:09,104,719,51,53,356.45,738.05,0.00
2024-12-10 17:18:09,104,720,51,53,356.99,739.00,0.00
2024-12-10 17:18:09,105,720,51,54,353.59,739.01,0.00
2024-12-10 17:18:09,104,720,51,53,356.65,739.05,0.00
2024-12-10 17:18:09,104,721,51,53,357.19,740.00,0.00
2024-12-10 17:18:09,105,721,52,53,353.79,740.01,0.00
2024-12-10 17:18:09,104,721,51,53,356.84,740.05,0.00
2024-12-10 17:18:09,104,722,51,53,357.39,741.00,0.00
2024-12-10 17:18:09,105,722,51,54,353.99,741.01,0.00
2024-12-10 17:18:09,104,722,51,53,357.04,741.05,0.00
2024-12-10 17:18:09,104,723,51,53,357.59,742.00,0.00
2024-12-10 17:18:09,105,723,52,53,354.18,742.01,0.00
2024-12-10 17:18:09,104,723,51,53,357.24,742.05,0.00
2024-12-10 17:18:09,104,724,51,53,357.78,743.00,0.00
2024-12-10 17:18:09,105,724,51,54,354.38,743.01,0.00
2024-12-10 17:18:09,104,724,51,53,357.57,743.03,0.00
2024-12-10 17:18:09,103,724,51,52,360.90,743.04,0.00
2024-12-10 17:18:09,102,724,51,51,364.37,743.04,0.00
2024-12-10 17:18:09,102,725,51,51,365.00,744.00,0.00
2024-12-10 17:18:09,103,725,51,52,361.45,744.01,0.00
2024-12-10 17:18:09,103,726,51,52,361.79,745.00,0.00
2024-12-10 17:18:09,104,726,51,53,358.32,745.01,0.00
2024-12-10 17:18:09,103,726,51,52,361.51,745.04,0.00
2024-12-10 17:18:09,103,727,51,52,362.04,746.00,0.00
2024-12-10 17:18:09,104,727,51,53,358.56,746.01,0.00
2024-12-10 17:18:09,103,727,50,53,361.75,746.04,0.00
2024-12-10 17:18:09,103,728,50,53,362.20,747.00,0.00
2024-12-10 17:18:09,104,728,51,53,358.72,747.01,0.00
2024-12-10 17:18:09,103,728,51,52,361.92,747.04,0.00
2024-12-10 17:18:09,103,729,51,52,362.30,748.00,0.00
2024-12-10 17:18:09,104,729,52,52,358.82,748.01,0.00
2024-12-10 17:18:09,103,729,52,51,362.02,748.04,0.00
2024-12-10 17:18:09,103,730,52,51,362.37,749.00,0.00
2024-12-10 17:18:09,104,730,53,51,358.89,749.01,0.00
2024-12-10 17:18:09,103,730,53,50,362.09,749.04,0.00
2024-12-10 17:18:09,103,731,53,50,362.42,750.00,0.00
2024-12-10 17:18:09,104,731,54,50,358.93,750.01,0.00
2024-12-10 17:18:09,103,731,54,49,362.13,750.04,0.00
2024-12-10 17:18:09,104,730,55,49,356.18,750.39,0.00
2024-12-10 17:18:09,104,731,55,49,363.61,751.00,0.00
2024-12-10 17:18:09,105,731,56,49,360.14,751.01,0.00
2024-12-10 17:18:09,104,731,55,49,363.32,751.04,0.00
2024-12-10 17:18:09,104,732,55,49,370.87,752.00,0.00
2024-12-10 17:18:09,105,732,56,49,367.34,752.01,0.00
2024-12-10 17:18:09,104,732,56,48,370.59,752.04,0.00
2024-12-10 17:18:09,104,733,56,48,370.98,753.00,0.00
2024-12-10 17:18:09,105,733,56,49,367.45,753.01,0.00
2024-12-10 17:18:09,104,733,56,48,370.70,753.04,0.00
2024-12-10 17:18:09,104,734,56,48,371.19,754.00,0.00
2024-12-10 17:18:09,105,734,56,49,367.65,754.01,0.00
2024-12-10 17:18:09,104,734,56,48,370.90,754.04,0.00
2024-12-10 17:18:09,104,735,56,48,371.36,755.00,0.00
2024-12-10 17:18:09,105,735,57,48,367.83,755.01,0.00
2024-12-10 17:18:09,104,735,56,48,371.08,755.04,0.00
2024-12-10 17:18:09,104,736,56,48,371.57,756.00,0.00
2024-12-10 17:18:09,105,736,57,48,368.03,756.01,0.00
2024-12-10 17:18:10,105,737,57,48,368.23,757.00,0.00
2024-12-10 17:18:10,106,737,57,49,364.75,757.01,0.00
2024-12-10 17:18:10,105,737,57,48,367.87,757.05,0.00
2024-12-10 17:18:10,105,738,57,48,368.35,758.00,0.00
2024-12-10 17:18:10,106,738,57,49,364.88,758.01,0.00
2024-12-10 17:18:10,105,738,57,48,367.99,758.05,0.00
2024-12-10 17:18:10,105,739,57,48,368.42,759.00,0.00
2024-12-10 17:18:10,106,739,58,48,364.94,759.01,0.00
2024-12-10 17:18:10,105,739,57,48,368.34,759.01,0.00
2024-12-10 17:18:10,104,739,56,48,371.60,759.04,0.00
2024-12-10 17:18:10,103,739,56,47,375.13,759.04,0.00
2024-12-10 17:18:10,103,740,56,47,375.60,760.00,0.00
2024-12-10 17:18:10,104,740,57,47,371.98,760.01,0.00
2024-12-10 17:18:10,103,740,56,47,375.45,760.02,0.00
2024-12-10 17:18:10,102,740,56,46,378.98,760.03,0.00
2024-12-10 17:18:10,101,740,55,46,382.66,760.03,0.00
2024-12-10 17:18:10,101,741,55,46,383.20,761.00,0.00
2024-12-10 17:18:10,102,741,56,46,379.44,761.01,0.00
2024-12-10 17:18:10,101,741,55,46,382.97,761.03,0.00
2024-12-10 17:18:10,101,742,55,46,383.52,762.00,0.00
2024-12-10 17:18:10,102,742,55,47,379.76,762.01,0.00
2024-12-10 17:18:10,101,742,54,47,383.30,762.03,0.00
2024-12-10 17:18:10,101,743,54,47,383.88,763.00,0.00
2024-12-10 17:18:10,102,743,54,48,380.12,763.01,0.00
2024-12-10 17:18:10,102,744,54,48,380.35,764.00,0.00
2024-12-10 17:18:10,103,744,55,48,376.66,764.01,0.00
2024-12-10 17:18:10,102,744,55,47,380.13,764.03,0.00
2024-12-10 17:18:10,102,745,55,47,380.45,765.00,0.00
2024-12-10 17:18:10,103,745,56,47,376.75,765.01,0.00
2024-12-10 17:18:10,102,745,55,47,380.22,765.03,0.00
2024-12-10 17:18:10,102,746,55,47,380.57,766.00,0.00
2024-12-10 17:18:10,103,746,56,47,376.88,766.01,0.00
2024-12-10 17:18:10,102,746,56,46,380.35,766.03,0.00
2024-12-10 17:18:10,102,747,56,46,380.92,767.00,0.00
2024-12-10 17:18:10,103,747,56,47,377.22,767.01,0.00
2024-12-10 17:18:10,102,747,55,47,380.69,767.03,0.00
2024-12-10 17:18:10,103,746,55,48,372.03,767.73,0.00
2024-12-10 17:18:10,103,747,55,48,379.65,768.00,0.00
2024-12-10 17:18:10,104,747,55,49,376.00,768.01,0.00
2024-12-10 17:18:10,103,747,54,49,379.50,768.02,0.00
2024-12-10 17:18:10,102,747,54,48,383.15,768.02,0.00
2024-12-10 17:18:10,102,748,54,48,391.18,769.00,0.00
2024-12-10 17:18:10,103,748,55,48,387.39,769.01,0.00
2024-12-10 17:18:10,102,748,55,47,391.03,769.02,0.00
2024-12-10 17:18:10,102,749,55,47,391.23,770.00,0.00
2024-12-10 17:18:10,103,749,56,47,387.43,770.01,0.00
2024-12-10 17:18:10,102,749,56,46,391.08,770.02,0.00
2024-12-10 17:18:10,102,750,56,46,390.79,771.00,0.00
2024-12-10 17:18:10,103,750,56,47,386.99,771.01,0.00
2024-12-10 17:18:10,102,750,56,46,390.63,771.02,0.00
2024-12-10 17:18:10,102,751,56,46,389.98,772.00,0.00
2024-12-10 17:18:10,103,751,56,47,386.19,772.01,0.00
2024-12-10 17:18:10,102,751,56,46,389.83,772.02,0.00
2024-12-10 17:18:10,101,751,55,46,388.34,772.55,0.00
2024-12-10 17:18:10,101,752,55,46,392.89,773.00,0.00
2024-12-10 17:18:10,102,752,55,47,389.04,773.01,0.00
2024-12-10 17:18:10,101,752,54,47,392.74,773.02,0.00
2024-12-10 17:18:10,101,753,54,47,393.24,774.00,0.00
2024-12-10 17:18:10,102,753,55,47,389.39,774.01,0.00
2024-12-10 17:18:10,101,753,54,47,393.09,774.02,0.00
2024-12-10 17:18:10,101,754,54,47,393.51,775.00,0.00
2024-12-10 17:18:10,102,754,55,47,389.66,775.01,0.00
2024-12-10 17:18:10,101,754,54,47,393.44,775.01,0.00
2024-12-10 17:18:10,100,754,54,46,397.29,775.01,0.00
2024-12-10 17:18:10,99,754,53,46,401.23,775.01,0.00
2024-12-10 17:18:10,99,755,53,46,401.66,776.00,0.00
2024-12-10 17:18:10,100,755,53,47,397.64,776.01,0.00
2024-12-10 17:18:10,100,756,53,47,397.85,777.00,0.00
2024-12-10 17:18:10,101,756,54,47,393.91,777.01,0.00
2024-12-10 17:18:10,101,757,54,47,393.83,778.00,0.00
2024-12-10 17:18:10,102,757,54,48,389.97,778.01,0.00
2024-12-10 17:18:10,101,757,53,48,393.75,778.01,0.00
2024-12-10 17:18:10,101,758,53,48,393.40,779.00,0.00
2024-12-10 17:18:10,102,758,54,48,389.54,779.01,0.00
2024-12-10 17:18:10,101,758,53,48,393.32,779.01,0.00
2024-12-10 17:18:10,101,759,53,48,392.47,780.00,0.00
2024-12-10 17:18:10,102,759,54,48,388.62,780.01,0.00
2024-12-10 17:18:10,101,759,53,48,392.39,780.01,0.00
2024-12-10 17:18:10,101,760,53,48,390.93,781.00,0.00
2024-12-10 17:18:10,102,760,54,48,387.10,781.01,0.00
2024-12-10 17:18:10,101,760,54,47,390.86,781.01,0.00
2024-12-10 17:18:10,101,761,54,47,388.89,782.00,0.00
2024-12-10 17:18:10,102,761,55,47,385.08,782.01,0.00
2024-12-10 17:18:10,101,761,55,46,388.81,782.01,0.00
2024-12-10 17:18:10,100,761,54,46,388.51,782.47,0.00
2024-12-10 17:18:10,100,762,54,46,390.27,783.00,0.00
2024-12-10 17:18:10,101,762,54,47,386.41,783.01,0.00
2024-12-10 17:18:10,100,762,54,46,390.19,783.01,0.00
2024-12-10 17:18:10,100,763,54,46,387.99,784.00,0.00
2024-12-10 17:18:10,101,763,54,47,384.15,784.01,0.00
2024-12-10 17:18:10,100,763,53,47,387.91,784.01,0.00
2024-12-10 17:18:10,99,763,52,47,385.90,784.77,0.00
2024-12-10 17:18:10,98,763,52,46,389.24,784.78,0.00
2024-12-10 17:18:10,98,764,52,46,395.11,785.00,0.00
2024-12-10 17:18:10,99,764,52,47,391.12,785.01,0.00
2024-12-10 17:18:10,98,764,52,46,395.03,785.01,0.00
2024-12-10 17:18:10,98,765,52,46,394.92,786.00,0.00
2024-12-10 17:18:10,99,765,52,47,390.93,786.01,0.00
2024-12-10 17:18:10,100,764,52,48,383.44,786.50,0.00
2024-12-10 17:18:10,100,765,52,48,390.58,787.00,0.00
2024-12-10 17:18:10,101,765,53,48,386.71,787.01,0.00
2024-12-10 17:18:11,100,765,52,48,390.42,787.02,0.00
2024-12-10 17:18:11,100,766,52,48,397.59,788.00,0.00
2024-12-10 17:18:11,101,766,52,49,393.65,788.01,0.00
2024-12-10 17:18:11,102,765,52,50,389.72,788.04,0.00
2024-12-10 17:18:11,103,764,53,50,390.26,788.49,0.00
2024-12-10 17:18:11,103,765,53,50,392.79,789.00,0.00
2024-12-10 17:18:11,104,765,53,51,389.01,789.01,0.00
2024-12-10 17:18:11,103,765,52,51,392.58,789.03,0.00
2024-12-10 17:18:11,102,765,51,51,391.14,789.73,0.00
2024-12-10 17:18:11,102,766,51,51,412.43,790.00,0.00
2024-12-10 17:18:11,103,766,51,52,408.42,790.01,0.00
2024-12-10 17:18:11,102,766,51,51,412.21,790.03,0.00
2024-12-10 17:18:11,102,767,51,51,412.79,791.00,0.00
2024-12-10 17:18:11,103,767,51,52,408.79,791.01,0.00
2024-12-10 17:18:11,102,767,50,52,412.58,791.03,0.00
2024-12-10 17:18:11,102,768,50,52,413.16,792.00,0.00
2024-12-10 17:18:11,103,768,50,53,409.15,792.01,0.00
2024-12-10 17:18:11,102,768,49,53,412.94,792.03,0.00
2024-12-10 17:18:11,102,769,49,53,413.53,793.00,0.00
2024-12-10 17:18:11,103,769,49,54,409.51,793.01,0.00
2024-12-10 17:18:11,102,769,49,53,413.31,793.03,0.00
2024-12-10 17:18:11,102,770,49,53,413.89,794.00,0.00
2024-12-10 17:18:11,103,770,49,54,409.87,794.01,0.00
2024-12-10 17:18:11,102,770,48,54,413.67,794.03,0.00
2024-12-10 17:18:11,102,771,48,54,414.26,795.00,0.00
2024-12-10 17:18:11,103,771,49,54,410.24,795.01,0.00
2024-12-10 17:18:11,102,771,48,54,414.04,795.03,0.00
2024-12-10 17:18:11,102,772,48,54,414.62,796.00,0.00
2024-12-10 17:18:11,103,772,49,54,410.60,796.01,0.00
2024-12-10 17:18:11,102,772,49,53,414.40,796.03,0.00
2024-12-10 17:18:11,102,773,49,53,414.99,797.00,0.00
2024-12-10 17:18:11,103,773,49,54,410.96,797.01,0.00
2024-12-10 17:18:11,102,773,49,53,414.77,797.03,0.00
2024-12-10 17:18:11,103,772,49,54,406.29,797.63,0.00
2024-12-10 17:18:11,103,773,49,54,414.26,798.00,0.00
2024-12-10 17:18:11,104,773,49,55,410.28,798.01,0.00
2024-12-10 17:18:11,103,773,48,55,414.04,798.03,0.00
2024-12-10 17:18:11,103,774,48,55,422.31,799.00,0.00
2024-12-10 17:18:11,104,774,49,55,418.25,799.01,0.00
2024-12-10 17:18:11,103,774,48,55,422.09,799.03,0.00
2024-12-10 17:18:11,103,775,48,55,422.60,800.00,0.00
2024-12-10 17:18:11,104,775,48,56,418.54,800.01,0.00
2024-12-10 17:18:11,103,775,47,56,422.38,800.03,0.00
2024-12-10 17:18:11,103,776,47,56,422.90,801.00,0.00
2024-12-10 17:18:11,104,776,47,57,418.83,801.01,0.00
2024-12-10 17:18:11,103,776,47,56,422.68,801.03,0.00
2024-12-10 17:18:11,103,777,47,56,423.19,802.00,0.00
2024-12-10 17:18:11,104,777,48,56,419.12,802.01,0.00
2024-12-10 17:18:11,103,777,48,55,422.97,802.03,0.00
2024-12-10 17:18:11,104,776,48,56,413.56,802.75,0.00
2024-12-10 17:18:11,104,777,48,56,421.19,803.00,0.00
2024-12-10 17:18:11,105,777,49,56,417.18,803.01,0.00
2024-12-10 17:18:11,104,777,49,55,420.97,803.03,0.00
2024-12-10 17:18:11,104,778,49,55,429.13,804.00,0.00
2024-12-10 17:18:11,105,778,50,55,425.05,804.01,0.00
2024-12-10 17:18:11,104,778,49,55,428.92,804.03,0.00
2024-12-10 17:18:11,104,779,49,55,429.36,805.00,0.00
2024-12-10 17:18:11,105,779,49,56,425.27,805.01,0.00
2024-12-10 17:18:11,104,779,48,56,429.14,805.03,0.00
2024-12-10 17:18:11,104,780,48,56,429.58,806.00,0.00
2024-12-10 17:18:11,105,780,48,57,425.49,806.01,0.00
2024-12-10 17:18:11,104,780,47,57,429.36,806.03,0.00
2024-12-10 17:18:11,104,781,47,57,429.80,807.00,0.00
2024-12-10 17:18:11,105,781,48,57,425.71,807.01,0.00
2024-12-10 17:18:11,104,781,47,57,429.58,807.03,0.00
2024-12-10 17:18:11,104,782,47,57,430.03,808.00,0.00
2024-12-10 17:18:11,105,782,48,57,425.93,808.01,0.00
2024-12-10 17:18:11,104,782,48,56,429.81,808.03,0.00
2024-12-10 17:18:11,104,783,48,56,430.25,809.00,0.00
2024-12-10 17:18:11,105,783,48,57,426.15,809.01,0.00
2024-12-10 17:18:11,104,783,48,56,430.03,809.03,0.00
2024-12-10 17:18:11,104,784,48,56,430.47,810.00,0.00
2024-12-10 17:18:11,105,784,49,56,426.37,810.01,0.00
2024-12-10 17:18:11,104,784,49,55,430.25,810.03,0.00
2024-12-10 17:18:11,104,785,49,55,430.69,811.00,0.00
2024-12-10 17:18:11,105,785,50,55,426.59,811.01,0.00
2024-12-10 17:18:11,104,785,50,54,430.46,811.03,0.00
2024-12-10 17:18:11,104,786,50,54,430.91,812.00,0.00
2024-12-10 17:18:11,105,786,51,54,426.80,812.01,0.00
2024-12-10 17:18:11,104,786,51,53,430.68,812.03,0.00
2024-12-10 17:18:11,104,787,51,53,431.12,813.00,0.00
2024-12-10 17:18:11,105,787,51,54,427.02,813.01,0.00
2024-12-10 17:18:11,104,787,51,53,430.90,813.03,0.00
2024-12-10 17:18:11,104,788,51,53,431.34,814.00,0.00
2024-12-10 17:18:11,105,788,52,53,427.23,814.01,0.00
2024-12-10 17:18:11,104,788,52,52,431.12,814.03,0.00
2024-12-10 17:18:11,104,789,52,52,431.56,815.00,0.00
2024-12-10 17:18:11,105,789,53,52,427.45,815.01,0.00
2024-12-10 17:18:11,104,789,53,51,431.33,815.03,0.00
2024-12-10 17:18:11,104,790,53,51,431.77,816.00,0.00
2024-12-10 17:18:11,105,790,53,52,427.66,816.01,0.00
2024-12-10 17:18:12,104,790,53,51,431.55,816.03,0.00
2024-12-10 17:18:12,104,791,53,51,431.99,817.00,0.00
2024-12-10 17:18:12,105,791,54,51,427.87,817.01,0.00
2024-12-10 17:18:12,104,791,53,51,431.76,817.03,0.00
2024-12-10 17:18:12,104,792,53,51,432.20,818.00,0.00
2024-12-10 17:18:12,105,792,54,51,428.09,818.01,0.00
2024-12-10 17:18:12,104,792,54,50,431.98,818.03,0.00
2024-12-10 17:18:12,104,793,54,50,432.42,819.00,0.00
2024-12-10 17:18:12,105,793,54,51,428.30,819.01,0.00
2024-12-10 17:18:12,104,793,53,51,432.19,819.03,0.00
2024-12-10 17:18:12,104,794,53,51,432.63,820.00,0.00
2024-12-10 17:18:12,105,794,53,52,428.51,820.01,0.00
2024-12-10 17:18:12,106,793,53,53,424.32,820.05,0.00
2024-12-10 17:18:12,106,794,53,53,432.42,821.00,0.00
2024-12-10 17:18:12,107,794,54,53,428.38,821.01,0.00
2024-12-10 17:18:12,106,794,53,53,432.13,821.04,0.00
2024-12-10 17:18:12,107,793,54,53,422.56,821.77,0.00
2024-12-10 17:18:12,107,794,54,53,437.96,822.00,0.00
2024-12-10 17:18:12,108,794,54,54,433.91,822.01,0.00
2024-12-10 17:18:12,107,794,54,53,437.68,822.04,0.00
2024-12-10 17:18:12,107,795,54,53,445.65,823.00,0.00
2024-12-10 17:18:12,108,795,54,54,441.52,823.01,0.00
2024-12-10 17:18:12,107,795,53,54,445.36,823.04,0.00
2024-12-10 17:18:12,107,796,53,54,445.65,824.00,0.00
2024-12-10 17:18:12,108,796,53,55,441.53,824.01,0.00
2024-12-10 17:18:12,107,796,52,55,445.36,824.04,0.00
2024-12-10 17:18:12,107,797,52,55,445.65,825.00,0.00
2024-12-10 17:18:12,108,797,53,55,441.53,825.01,0.00
2024-12-10 17:18:12,107,797,52,55,445.36,825.04,0.00
2024-12-10 17:18:12,107,798,52,55,445.65,826.00,0.00
2024-12-10 17:18:12,108,798,52,56,441.53,826.01,0.00
2024-12-10 17:18:12,107,798,51,56,445.36,826.04,0.00
2024-12-10 17:18:12,107,799,51,56,445.65,827.00,0.00
2024-12-10 17:18:12,108,799,51,57,441.53,827.01,0.00
2024-12-10 17:18:12,107,799,50,57,445.36,827.04,0.00
2024-12-10 17:18:12,108,798,51,57,435.78,827.75,0.00
2024-12-10 17:18:12,108,799,51,57,443.44,828.00,0.00
2024-12-10 17:18:12,109,799,51,58,439.37,828.01,0.00
2024-12-10 17:18:12,109,800,51,58,446.90,829.00,0.00
2024-12-10 17:18:12,110,800,52,58,442.84,829.01,0.00
2024-12-10 17:18:12,109,800,52,57,446.61,829.04,0.00
2024-12-10 17:18:12,109,801,52,57,446.75,830.00,0.00
2024-12-10 17:18:12,110,801,53,57,442.69,830.01,0.00
2024-12-10 17:18:12,110,802,53,57,442.55,831.00,0.00
2024-12-10 17:18:12,111,802,53,58,438.56,831.01,0.00
2024-12-10 17:18:12,110,802,52,58,442.26,831.04,0.00
2024-12-10 17:18:12,110,803,52,58,442.32,832.00,0.00
2024-12-10 17:18:12,111,803,53,58,438.34,832.01,0.00
2024-12-10 17:18:12,110,803,52,58,442.03,832.04,0.00
2024-12-10 17:18:12,110,804,52,58,442.10,833.00,0.00
2024-12-10 17:18:12,111,804,53,58,438.11,833.01,0.00
2024-12-10 17:18:12,110,804,53,57,441.81,833.04,0.00
2024-12-10 17:18:12,110,805,53,57,441.87,834.00,0.00
2024-12-10 17:18:12,111,805,53,58,437.89,834.01,0.00
2024-12-10 17:18:12,110,805,53,57,441.58,834.04,0.00
2024-12-10 17:18:12,110,806,53,57,441.64,835.00,0.00
2024-12-10 17:18:12,111,806,54,57,437.66,835.01,0.00
2024-12-10 17:18:12,111,807,54,57,437.43,836.00,0.00
2024-12-10 17:18:12,112,807,54,58,433.53,836.01,0.00
2024-12-10 17:18:12,111,807,54,57,437.07,836.05,0.00
2024-12-10 17:18:12,111,808,54,57,437.12,837.00,0.00
2024-12-10 17:18:12,112,808,55,57,433.22,837.01,0.00
2024-12-10 17:18:12,111,808,54,57,436.77,837.05,0.00
2024-12-10 17:18:12,111,809,54,57,436.82,838.00,0.00
2024-12-10 17:18:12,112,809,55,57,432.92,838.01,0.00
2024-12-10 17:18:12,111,809,54,57,436.46,838.05,0.00
2024-12-10 17:18:12,111,810,54,57,436.51,839.00,0.00
2024-12-10 17:18:12,112,810,55,57,432.61,839.01,0.00
2024-12-10 17:18:12,112,811,55,57,432.30,840.00,0.00
2024-12-10 17:18:12,113,811,55,58,428.47,840.01,0.00
2024-12-10 17:18:12,112,811,54,58,431.87,840.05,0.00
2024-12-10 17:18:12,112,812,54,58,431.91,841.00,0.00
2024-12-10 17:18:12,113,812,54,59,428.09,841.01,0.00
2024-12-10 17:18:12,112,812,54,58,431.48,841.05,0.00
2024-12-10 17:18:12,112,813,54,58,431.52,842.00,0.00
2024-12-10 17:18:12,113,813,54,59,427.71,842.01,0.00
2024-12-10 17:18:12,112,813,53,59,431.09,842.05,0.00
2024-12-10 17:18:12,113,812,53,60,425.45,842.29,0.00
2024-12-10 17:18:12,113,813,53,60,432.76,843.00,0.00
2024-12-10 17:18:12,114,813,54,60,428.97,843.01,0.00
2024-12-10 17:18:12,113,813,54,59,432.33,843.05,0.00
2024-12-10 17:18:12,114,812,54,60,427.30,843.22,0.00
2024-12-10 17:18:12,114,813,54,60,442.06,844.00,0.00
2024-12-10 17:18:12,115,813,54,61,438.22,844.01,0.00
2024-12-10 17:18:12,114,813,54,60,441.64,844.05,0.00
2024-12-10 17:18:12,114,814,54,60,448.96,845.00,0.00
2024-12-10 17:18:12,115,814,55,60,445.06,845.01,0.00
2024-12-10 17:18:12,114,814,55,59,448.53,845.05,0.00
2024-12-10 17:18:12,114,815,55,59,448.45,846.00,0.00
2024-12-10 17:18:12,115,815,55,60,444.55,846.01,0.00
2024-12-10 17:18:12,114,815,55,59,448.02,846.05,0.00
2024-12-10 17:18:13,114,816,55,59,447.94,847.00,0.00
2024-12-10 17:18:13,115,816,55,60,444.05,847.01,0.00
2024-12-10 17:18:13,114,816,54,60,447.51,847.05,0.00
2024-12-10 17:18:13,114,817,54,60,447.43,848.00,0.00
2024-12-10 17:18:13,115,817,54,61,443.54,848.01,0.00
2024-12-10 17:18:13,114,817,53,61,447.00,848.05,0.00
2024-12-10 17:18:13,114,818,53,61,446.92,849.00,0.00
2024-12-10 17:18:13,115,818,53,62,443.03,849.01,0.00
2024-12-10 17:18:13,114,818,52,62,446.48,849.05,0.00
2024-12-10 17:18:13,114,819,52,62,446.40,850.00,0.00
2024-12-10 17:18:13,115,819,53,62,442.52,850.01,0.00
2024-12-10 17:18:13,114,819,52,62,446.32,850.01,0.00
2024-12-10 17:18:13,113,819,51,62,449.91,850.04,0.00
2024-12-10 17:18:13,112,819,50,62,453.85,850.04,0.00
2024-12-10 17:18:13,112,820,50,62,453.84,851.00,0.00
2024-12-10 17:18:13,113,820,50,63,449.82,851.01,0.00
2024-12-10 17:18:13,112,820,49,63,453.48,851.04,0.00
2024-12-10 17:18:13,112,821,49,63,453.46,852.00,0.00
2024-12-10 17:18:13,113,821,49,64,449.45,852.01,0.00
2024-12-10 17:18:13,112,821,48,64,453.09,852.04,0.00
2024-12-10 17:18:13,112,822,48,64,453.08,853.00,0.00
2024-12-10 17:18:13,113,822,49,64,449.07,853.01,0.00
2024-12-10 17:18:13,112,822,49,63,452.71,853.04,0.00
2024-12-10 17:18:13,112,823,49,63,452.70,854.00,0.00
2024-12-10 17:18:13,113,823,50,63,448.69,854.01,0.00
2024-12-10 17:18:13,112,823,50,62,452.33,854.04,0.00
2024-12-10 17:18:13,112,824,50,62,452.31,855.00,0.00
2024-12-10 17:18:13,113,824,50,63,448.31,855.01,0.00
2024-12-10 17:18:13,112,824,49,63,451.94,855.04,0.00
2024-12-10 17:18:13,112,825,49,63,451.92,856.00,0.00
2024-12-10 17:18:13,113,825,50,63,447.92,856.01,0.00
2024-12-10 17:18:13,112,825,49,63,451.55,856.04,0.00
2024-12-10 17:18:13,112,826,49,63,451.53,857.00,0.00
2024-12-10 17:18:13,113,826,50,63,447.54,857.01,0.00
2024-12-10 17:18:13,112,826,50,62,451.16,857.04,0.00
2024-12-10 17:18:13,112,827,50,62,451.14,858.00,0.00
2024-12-10 17:18:13,113,827,50,63,447.15,858.01,0.00
2024-12-10 17:18:13,112,827,50,62,450.77,858.04,0.00
2024-12-10 17:18:13,112,828,50,62,450.74,859.00,0.00
2024-12-10 17:18:13,113,828,51,62,446.76,859.01,0.00
2024-12-10 17:18:13,113,829,51,62,446.36,860.00,0.00
2024-12-10 17:18:13,114,829,51,63,442.45,860.01,0.00
2024-12-10 17:18:13,114,830,51,63,441.98,861.00,0.00
2024-12-10 17:18:13,115,830,52,63,438.14,861.01,0.00
2024-12-10 17:18:13,115,831,52,63,437.60,862.00,0.00
2024-12-10 17:18:13,116,831,52,64,433.82,862.01,0.00
2024-12-10 17:18:13,116,832,52,64,433.21,863.00,0.00
2024-12-10 17:18:13,117,832,52,65,429.51,863.01,0.00
2024-12-10 17:18:13,116,832,52,64,432.71,863.06,0.00
2024-12-10 17:18:13,116,833,52,64,432.52,864.00,0.00
2024-12-10 17:18:13,117,833,53,64,428.82,864.01,0.00
2024-12-10 17:18:13,117,834,53,64,428.14,865.00,0.00
2024-12-10 17:18:13,118,834,53,65,424.51,865.01,0.00
2024-12-10 17:18:13,117,834,52,65,427.64,865.06,0.00
2024-12-10 17:18:13,117,835,52,65,427.37,866.00,0.00
2024-12-10 17:18:13,118,835,52,66,423.75,866.01,0.00
2024-12-10 17:18:13,117,835,51,66,426.87,866.06,0.00
2024-12-10 17:18:13,117,836,51,66,426.61,867.00,0.00
2024-12-10 17:18:13,118,836,51,67,422.99,867.01,0.00
2024-12-10 17:18:13,117,836,51,66,426.32,867.03,0.00
2024-12-10 17:18:13,116,836,51,65,429.78,867.05,0.00
2024-12-10 17:18:13,115,836,51,64,433.44,867.05,0.00
2024-12-10 17:18:13,115,837,51,64,433.24,868.00,0.00
2024-12-10 17:18:13,116,837,51,65,429.51,868.01,0.00
2024-12-10 17:18:13,117,836,52,65,425.55,868.06,0.00
2024-12-10 17:18:13,116,836,52,64,430.95,868.06,0.00
2024-12-10 17:18:13,116,837,52,64,430.75,869.00,0.00
2024-12-10 17:18:13,117,837,53,64,427.07,869.01,0.00
2024-12-10 17:18:13,117,838,53,64,433.81,870.00,0.00
2024-12-10 17:18:13,118,838,54,64,430.13,870.01,0.00
2024-12-10 17:18:13,117,838,53,64,433.31,870.06,0.00
2024-12-10 17:18:13,117,839,53,64,433.04,871.00,0.00
2024-12-10 17:18:13,118,839,54,64,429.37,871.01,0.00
2024-12-10 17:18:13,117,839,54,63,432.55,871.06,0.00
2024-12-10 17:18:13,117,840,54,63,432.27,872.00,0.00
2024-12-10 17:18:13,118,840,54,64,428.61,872.01,0.00
2024-12-10 17:18:13,117,840,54,63,431.77,872.06,0.00
2024-12-10 17:18:13,117,841,54,63,431.50,873.00,0.00
2024-12-10 17:18:13,118,841,55,63,427.84,873.01,0.00
2024-12-10 17:18:13,117,841,55,62,431.00,873.06,0.00
2024-12-10 17:18:13,117,842,55,62,430.72,874.00,0.00
2024-12-10 17:18:13,118,842,56,62,427.07,874.01,0.00
2024-12-10 17:18:13,117,842,55,62,430.22,874.06,0.00
2024-12-10 17:18:13,117,843,55,62,429.95,875.00,0.00
2024-12-10 17:18:13,118,843,55,63,426.30,875.01,0.00
2024-12-10 17:18:13,117,843,54,63,429.44,875.06,0.00
2024-12-10 17:18:13,117,844,54,63,429.16,876.00,0.00
2024-12-10 17:18:13,118,844,55,63,425.53,876.01,0.00
2024-12-10 17:18:13,117,844,55,62,428.66,876.06,0.00
2024-12-10 17:18:14,117,845,55,62,428.38,877.00,0.00
2024-12-10 17:18:14,118,845,56,62,424.75,877.01,0.00
2024-12-10 17:18:14,117,845,55,62,427.88,877.06,0.00
2024-12-10 17:18:14,117,846,55,62,427.59,878.00,0.00
2024-12-10 17:18:14,118,846,55,63,423.97,878.01,0.00
2024-12-10 17:18:14,117,846,55,62,427.09,878.06,0.00
2024-12-10 17:18:14,117,847,55,62,426.80,879.00,0.00
2024-12-10 17:18:14,118,847,56,62,423.19,879.01,0.00
2024-12-10 17:18:14,118,848,56,62,422.40,880.00,0.00
2024-12-10 17:18:14,119,848,56,63,418.85,880.01,0.00
2024-12-10 17:18:14,118,848,55,63,421.82,880.07,0.00
2024-12-10 17:18:14,118,849,55,63,421.54,881.00,0.00
2024-12-10 17:18:14,119,849,55,64,417.99,881.01,0.00
2024-12-10 17:18:14,118,849,54,64,420.96,881.07,0.00
2024-12-10 17:18:14,118,850,54,64,420.67,882.00,0.00
2024-12-10 17:18:14,119,850,55,64,417.13,882.01,0.00
2024-12-10 17:18:14,118,850,54,64,420.09,882.07,0.00
2024-12-10 17:18:14,118,851,54,64,419.80,883.00,0.00
2024-12-10 17:18:14,119,851,54,65,416.27,883.01,0.00
2024-12-10 17:18:14,118,851,54,64,419.22,883.07,0.00
2024-12-10 17:18:14,118,852,54,64,418.93,884.00,0.00
2024-12-10 17:18:14,119,852,54,65,415.41,884.01,0.00
2024-12-10 17:18:14,118,852,54,64,418.34,884.07,0.00
2024-12-10 17:18:14,118,853,54,64,418.05,885.00,0.00
2024-12-10 17:18:14,119,853,55,64,414.54,885.01,0.00
2024-12-10 17:18:14,118,853,55,63,417.47,885.07,0.00
2024-12-10 17:18:14,118,854,55,63,417.17,886.00,0.00
2024-12-10 17:18:14,119,854,56,63,413.66,886.01,0.00
2024-12-10 17:18:14,118,854,56,62,416.59,886.07,0.00
2024-12-10 17:18:14,117,854,56,61,420.07,886.07,0.00
2024-12-10 17:18:14,117,855,56,61,419.85,887.00,0.00
2024-12-10 17:18:14,118,855,56,62,416.29,887.01,0.00
2024-12-10 17:18:14,117,855,55,62,419.26,887.07,0.00
2024-12-10 17:18:14,117,856,55,62,419.03,888.00,0.00
2024-12-10 17:18:14,118,856,55,63,415.48,888.01,0.00
2024-12-10 17:18:14,117,856,55,62,418.95,888.01,0.00
2024-12-10 17:18:14,116,856,54,62,422.41,888.02,0.00
2024-12-10 17:18:14,115,856,54,61,425.72,888.05,0.00
2024-12-10 17:18:14,114,856,54,60,429.37,888.05,0.00
2024-12-10 17:18:14,113,856,53,60,433.09,888.05,0.00
2024-12-10 17:18:14,113,857,53,60,433.01,889.00,0.00
2024-12-10 17:18:14,114,857,54,60,429.22,889.01,0.00
2024-12-10 17:18:14,113,857,54,59,432.56,889.05,0.00
2024-12-10 17:18:14,114,856,54,60,426.84,889.29,0.00
2024-12-10 17:18:14,114,857,54,60,434.62,890.00,0.00
2024-12-10 17:18:14,115,857,55,60,430.84,890.01,0.00
2024-12-10 17:18:14,114,857,55,59,434.16,890.05,0.00
2024-12-10 17:18:14,115,856,56,59,424.11,890.81,0.00
2024-12-10 17:18:14,115,857,56,59,439.69,891.00,0.00
2024-12-10 17:18:14,116,857,56,60,435.90,891.01,0.00
2024-12-10 17:18:14,115,857,56,59,439.24,891.05,0.00
2024-12-10 17:18:14,116,856,57,59,434.99,891.12,0.00
2024-12-10 17:18:14,116,857,57,59,448.31,892.00,0.00
2024-12-10 17:18:14,117,857,57,60,444.47,892.01,0.00
2024-12-10 17:18:14,116,857,57,59,447.86,892.05,0.00
2024-12-10 17:18:14,116,858,57,59,455.28,893.00,0.00
2024-12-10 17:18:14,117,858,58,59,451.38,893.01,0.00
2024-12-10 17:18:14,116,858,58,58,454.83,893.05,0.00
2024-12-10 17:18:14,116,859,58,58,454.55,894.00,0.00
2024-12-10 17:18:14,117,859,59,58,450.67,894.01,0.00
2024-12-10 17:18:14,116,859,59,57,454.10,894.05,0.00
2024-12-10 17:18:14,116,860,59,57,453.83,895.00,0.00
2024-12-10 17:18:14,117,860,59,58,449.95,895.01,0.00
2024-12-10 17:18:14,116,860,58,58,453.38,895.05,0.00
2024-12-10 17:18:14,116,861,58,58,453.10,896.00,0.00
2024-12-10 17:18:14,117,861,58,59,449.22,896.01,0.00
2024-12-10 17:18:14,116,861,57,59,452.65,896.05,0.00
2024-12-10 17:18:14,116,862,57,59,452.37,897.00,0.00
2024-12-10 17:18:14,117,862,58,59,448.50,897.01,0.00
2024-12-10 17:18:14,116,862,57,59,452.21,897.02,0.00
2024-12-10 17:18:14,115,862,57,58,455.84,897.04,0.00
2024-12-10 17:18:14,116,861,58,58,451.23,897.14,0.00
2024-12-10 17:18:14,116,862,58,58,458.75,898.00,0.00
2024-12-10 17:18:14,117,862,58,59,454.83,898.01,0.00
2024-12-10 17:18:14,116,862,58,58,458.31,898.05,0.00
2024-12-10 17:18:14,116,863,58,58,465.77,899.00,0.00
2024-12-10 17:18:14,117,863,58,59,461.79,899.01,0.00
2024-12-10 17:18:14,116,863,57,59,465.33,899.05,0.00
2024-12-10 17:18:14,116,864,57,59,465.05,900.00,0.00
2024-12-10 17:18:14,117,864,57,60,461.08,900.01,0.00
2024-12-10 17:18:14,116,864,57,59,464.61,900.05,0.00
2024-12-10 17:18:14,116,865,57,59,464.33,901.00,0.00
2024-12-10 17:18:14,117,865,58,59,460.36,901.01,0.00
2024-12-10 17:18:14,116,865,58,58,463.88,901.05,0.00
2024-12-10 17:18:14,116,866,58,58,463.60,902.00,0.00
2024-12-10 17:18:14,117,866,58,59,459.63,902.01,0.00
2024-12-10 17:18:14,116,866,57,59,463.30,902.03,0.00
2024-12-10 17:18:14,115,866,57,58,467.10,902.05,0.00
2024-12-10 17:18:14,115,867,57,58,466.89,903.00,0.00
2024-12-10 17:18:14,116,867,58,58,462.87,903.01,0.00
2024-12-10 17:18:14,115,867,57,58,466.44,903.05,0.00
2024-12-10 17:18:14,115,868,57,58,466.23,904.00,0.00
2024-12-10 17:18:14,116,868,58,58,462.21,904.01,0.00
2024-12-10 17:18:14,115,868,57,58,465.78,904.05,0.00
2024-12-10 17:18:15,115,869,57,58,465.56,905.00,0.00
2024-12-10 17:18:15,116,869,58,58,461.55,905.01,0.00
2024-12-10 17:18:15,116,870,58,58,460.89,906.00,0.00
2024-12-10 17:18:15,117,870,59,58,456.95,906.01,0.00
2024-12-10 17:18:15,118,869,60,58,452.86,906.05,0.00
2024-12-10 17:18:15,117,869,60,57,457.60,906.07,0.00
2024-12-10 17:18:15,117,870,60,57,457.30,907.00,0.00
2024-12-10 17:18:15,118,870,61,57,453.42,907.01,0.00
2024-12-10 17:18:15,117,870,60,57,456.78,907.06,0.00
2024-12-10 17:18:15,117,871,60,57,464.01,908.00,0.00
2024-12-10 17:18:15,118,871,61,57,460.08,908.01,0.00
2024-12-10 17:18:15,117,871,60,57,463.49,908.06,0.00
2024-12-10 17:18:15,117,872,60,57,462.66,909.00,0.00
2024-12-10 17:18:15,118,872,61,57,458.74,909.01,0.00
2024-12-10 17:18:15,117,872,61,56,462.14,909.06,0.00
2024-12-10 17:18:15,117,873,61,56,461.00,910.00,0.00
2024-12-10 17:18:15,118,873,62,56,457.10,910.01,0.00
2024-12-10 17:18:15,117,873,61,56,460.48,910.06,0.00
2024-12-10 17:18:15,116,873,61,55,460.89,910.36,0.00
2024-12-10 17:18:15,116,874,61,55,463.35,911.00,0.00
2024-12-10 17:18:15,117,874,61,56,459.39,911.01,0.00
2024-12-10 17:18:15,116,874,60,56,462.83,911.06,0.00
2024-12-10 17:18:15,116,875,60,56,462.60,912.00,0.00
2024-12-10 17:18:15,117,875,60,57,458.65,912.01,0.00
2024-12-10 17:18:15,116,875,59,57,462.08,912.06,0.00
2024-12-10 17:18:15,116,876,59,57,461.85,913.00,0.00
2024-12-10 17:18:15,117,876,59,58,457.90,913.01,0.00
2024-12-10 17:18:15,117,877,59,58,457.16,914.00,0.00
2024-12-10 17:18:15,118,877,60,58,453.28,914.01,0.00
2024-12-10 17:18:15,117,877,59,58,456.56,914.07,0.00
2024-12-10 17:18:15,117,878,59,58,456.33,915.00,0.00
2024-12-10 17:18:15,118,878,60,58,452.46,915.01,0.00
2024-12-10 17:18:15,117,878,59,58,455.73,915.07,0.00
2024-12-10 17:18:15,117,879,59,58,455.49,916.00,0.00
2024-12-10 17:18:15,118,879,60,58,451.63,916.01,0.00
2024-12-10 17:18:15,117,879,60,57,454.90,916.07,0.00
2024-12-10 17:18:15,117,880,60,57,454.66,917.00,0.00
2024-12-10 17:18:15,118,880,61,57,450.81,917.01,0.00
2024-12-10 17:18:15,117,880,60,57,454.06,917.07,0.00
2024-12-10 17:18:15,117,881,60,57,453.82,918.00,0.00
2024-12-10 17:18:15,118,881,60,58,449.98,918.01,0.00
2024-12-10 17:18:15,117,881,59,58,453.22,918.07,0.00
2024-12-10 17:18:15,117,882,59,58,452.98,919.00,0.00
2024-12-10 17:18:15,118,882,60,58,449.14,919.01,0.00
2024-12-10 17:18:15,117,882,60,57,452.38,919.07,0.00
2024-12-10 17:18:15,117,883,60,57,452.14,920.00,0.00
2024-12-10 17:18:15,118,883,61,57,448.30,920.01,0.00
2024-12-10 17:18:15,117,883,61,56,452.06,920.01,0.00
2024-12-10 17:18:15,116,883,61,55,455.43,920.06,0.00
2024-12-10 17:18:15,115,883,61,54,459.31,920.06,0.00
2024-12-10 17:18:15,115,884,61,54,459.14,921.00,0.00
2024-12-10 17:18:15,116,884,62,54,455.18,921.01,0.00
2024-12-10 17:18:15,115,884,61,54,458.60,921.06,0.00
2024-12-10 17:18:15,114,884,60,54,462.55,921.06,0.00
2024-12-10 17:18:15,114,885,60,54,462.46,922.00,0.00
2024-12-10 17:18:15,115,885,60,55,458.43,922.01,0.00
2024-12-10 17:18:15,114,885,60,54,461.92,922.06,0.00
2024-12-10 17:18:15,114,886,60,54,461.82,923.00,0.00
2024-12-10 17:18:15,115,886,61,54,457.81,923.01,0.00
2024-12-10 17:18:15,114,886,61,53,461.28,923.06,0.00
2024-12-10 17:18:15,114,887,61,53,461.19,924.00,0.00
2024-12-10 17:18:15,115,887,62,53,457.18,924.01,0.00
2024-12-10 17:18:15,114,887,62,52,460.65,924.06,0.00
2024-12-10 17:18:15,114,888,62,52,460.55,925.00,0.00
2024-12-10 17:18:15,115,888,63,52,456.55,925.01,0.00
2024-12-10 17:18:15,114,888,62,52,460.01,925.06,0.00
2024-12-10 17:18:15,114,889,62,52,459.91,926.00,0.00
2024-12-10 17:18:15,115,889,63,52,455.91,926.01,0.00
2024-12-10 17:18:15,114,889,63,51,459.37,926.06,0.00
2024-12-10 17:18:15,114,890,63,51,459.27,927.00,0.00
2024-12-10 17:18:15,115,890,63,52,455.28,927.01,0.00
2024-12-10 17:18:15,114,890,62,52,458.96,927.04,0.00
2024-12-10 17:18:15,113,890,62,51,462.78,927.05,0.00
2024-12-10 17:18:15,112,890,61,51,466.83,927.05,0.00
2024-12-10 17:18:15,112,891,61,51,466.82,928.00,0.00
2024-12-10 17:18:15,113,891,62,51,462.69,928.01,0.00
2024-12-10 17:18:15,112,891,62,50,466.34,928.05,0.00
2024-12-10 17:18:15,112,892,62,50,466.32,929.00,0.00
2024-12-10 17:18:15,113,892,63,50,462.20,929.01,0.00
2024-12-10 17:18:15,112,892,62,50,465.85,929.05,0.00
2024-12-10 17:18:15,112,893,62,50,465.83,930.00,0.00
2024-12-10 17:18:15,113,893,63,50,461.71,930.01,0.00
2024-12-10 17:18:15,112,893,62,50,465.35,930.05,0.00
2024-12-10 17:18:15,112,894,62,50,465.33,931.00,0.00
2024-12-10 17:18:15,113,894,63,50,461.22,931.01,0.00
2024-12-10 17:18:15,112,894,63,49,464.86,931.05,0.00
2024-12-10 17:18:15,112,895,63,49,464.83,932.00,0.00
2024-12-10 17:18:15,113,895,63,50,460.72,932.01,0.00
2024-12-10 17:18:15,112,895,62,50,464.36,932.05,0.00
2024-12-10 17:18:15,112,896,62,50,464.33,933.00,0.00
2024-12-10 17:18:15,113,896,62,51,460.22,933.01,0.00
2024-12-10 17:18:15,112,896,61,51,463.86,933.05,0.00
2024-12-10 17:18:16,112,897,61,51,463.83,934.00,0.00
2024-12-10 17:18:16,113,897,61,52,459.73,934.01,0.00
2024-12-10 17:18:16,112,897,61,51,463.35,934.05,0.00
2024-12-10 17:18:16,112,898,61,51,463.33,935.00,0.00
2024-12-10 17:18:16,113,898,61,52,459.23,935.01,0.00
2024-12-10 17:18:16,112,898,60,52,462.84,935.05,0.00
2024-12-10 17:18:16,112,899,60,52,462.82,936.00,0.00
2024-12-10 17:18:16,113,899,61,52,458.72,936.01,0.00
2024-12-10 17:18:16,112,899,61,51,462.34,936.05,0.00
2024-12-10 17:18:16,112,900,61,51,462.31,937.00,0.00
2024-12-10 17:18:16,113,900,61,52,458.22,937.01,0.00
2024-12-10 17:18:16,112,900,60,52,461.83,937.05,0.00
2024-12-10 17:18:16,112,901,60,52,461.80,938.00,0.00
2024-12-10 17:18:16,113,901,61,52,457.71,938.01,0.00
2024-12-10 17:18:16,112,901,60,52,461.31,938.05,0.00
2024-12-10 17:18:16,113,900,61,52,452.95,938.54,0.00
2024-12-10 17:18:16,113,901,61,52,461.27,939.00,0.00
2024-12-10 17:18:16,114,901,62,52,457.23,939.01,0.00
2024-12-10 17:18:16,113,901,61,52,460.79,939.05,0.00
2024-12-10 17:18:16,113,902,61,52,469.00,940.00,0.00
2024-12-10 17:18:16,114,902,61,53,464.89,940.01,0.00
2024-12-10 17:18:16,113,902,61,52,468.52,940.05,0.00
2024-12-10 17:18:16,113,903,61,52,468.42,941.00,0.00
2024-12-10 17:18:16,114,903,61,53,464.31,941.01,0.00
2024-12-10 17:18:16,113,903,61,52,467.94,941.05,0.00
2024-12-10 17:18:16,113,904,61,52,467.83,942.00,0.00
2024-12-10 17:18:16,114,904,61,53,463.73,942.01,0.00
2024-12-10 17:18:16,113,904,60,53,467.67,942.02,0.00
2024-12-10 17:18:16,112,904,60,52,471.52,942.04,0.00
2024-12-10 17:18:16,112,905,60,52,471.42,943.00,0.00
2024-12-10 17:18:16,113,905,61,52,467.24,943.01,0.00
2024-12-10 17:18:16,112,905,60,52,471.01,943.04,0.00
2024-12-10 17:18:16,111,905,60,51,475.17,943.05,0.00
2024-12-10 17:18:16,111,906,60,51,475.15,944.00,0.00
2024-12-10 17:18:16,112,906,60,52,470.90,944.01,0.00
2024-12-10 17:18:16,111,906,60,51,474.74,944.05,0.00
2024-12-10 17:18:16,111,907,60,51,474.71,945.00,0.00
2024-12-10 17:18:16,112,907,60,52,470.47,945.01,0.00
2024-12-10 17:18:16,111,907,59,52,474.30,945.05,0.00
2024-12-10 17:18:16,111,908,59,52,474.28,946.00,0.00
2024-12-10 17:18:16,112,908,60,52,470.04,946.01,0.00
2024-12-10 17:18:16,113,907,61,52,465.88,946.03,0.00
2024-12-10 17:18:16,112,907,61,51,476.23,946.05,0.00
2024-12-10 17:18:16,112,908,61,51,476.21,947.00,0.00
2024-12-10 17:18:16,113,908,62,51,471.99,947.01,0.00
2024-12-10 17:18:16,112,908,62,50,475.80,947.04,0.00
2024-12-10 17:18:16,112,909,62,50,484.16,948.00,0.00
2024-12-10 17:18:16,113,909,63,50,479.87,948.01,0.00
2024-12-10 17:18:16,112,909,63,49,483.76,948.04,0.00
2024-12-10 17:18:16,112,910,63,49,483.65,949.00,0.00
2024-12-10 17:18:16,113,910,63,50,479.37,949.01,0.00
2024-12-10 17:18:16,112,910,63,49,483.25,949.04,0.00
2024-12-10 17:18:16,112,911,63,49,483.14,950.00,0.00
2024-12-10 17:18:16,113,911,63,50,478.87,950.01,0.00
2024-12-10 17:18:16,112,911,62,50,482.74,950.04,0.00
2024-12-10 17:18:16,112,912,62,50,482.63,951.00,0.00
2024-12-10 17:18:16,113,912,62,51,478.36,951.01,0.00
2024-12-10 17:18:16,112,912,62,50,482.23,951.04,0.00
2024-12-10 17:18:16,112,913,62,50,482.12,952.00,0.00
2024-12-10 17:18:16,113,913,63,50,477.85,952.01,0.00
2024-12-10 17:18:16,112,913,63,49,481.72,952.04,0.00
2024-12-10 17:18:16,113,912,63,50,474.24,952.41,0.00
2024-12-10 17:18:16,113,913,63,50,482.57,953.00,0.00
2024-12-10 17:18:16,114,913,63,51,478.34,953.01,0.00
2024-12-10 17:18:16,113,913,62,51,482.17,953.04,0.00
2024-12-10 17:18:16,113,914,62,51,490.42,954.00,0.00
2024-12-10 17:18:16,114,914,63,51,486.12,954.01,0.00
2024-12-10 17:18:16,113,914,62,51,490.02,954.04,0.00
2024-12-10 17:18:16,113,915,62,51,489.84,955.00,0.00
2024-12-10 17:18:16,114,915,62,52,485.54,955.01,0.00
2024-12-10 17:18:16,113,915,62,51,489.44,955.04,0.00
2024-12-10 17:18:16,113,916,62,51,489.25,956.00,0.00
2024-12-10 17:18:16,114,916,63,51,484.96,956.01,0.00
2024-12-10 17:18:16,113,916,62,51,488.85,956.04,0.00
2024-12-10 17:18:16,113,917,62,51,488.66,957.00,0.00
2024-12-10 17:18:16,114,917,63,51,484.38,957.01,0.00
2024-12-10 17:18:16,113,917,62,51,488.26,957.04,0.00
2024-12-10 17:18:16,113,918,62,51,488.07,958.00,0.00
2024-12-10 17:18:16,114,918,63,51,483.79,958.01,0.00
2024-12-10 17:18:16,113,918,63,50,487.67,958.04,0.00
2024-12-10 17:18:16,113,919,63,50,487.48,959.00,0.00
2024-12-10 17:18:16,114,919,64,50,483.20,959.01,0.00
2024-12-10 17:18:16,113,919,63,50,487.07,959.04,0.00
2024-12-10 17:18:16,114,918,64,50,477.36,959.65,0.00
2024-12-10 17:18:16,114,919,64,50,485.81,960.00,0.00
2024-12-10 17:18:16,115,919,64,51,481.59,960.01,0.00
2024-12-10 17:18:16,114,919,64,50,485.41,960.04,0.00
2024-12-10 17:18:16,114,920,64,50,493.57,961.00,0.00
2024-12-10 17:18:16,115,920,64,51,489.27,961.01,0.00
2024-12-10 17:18:16,114,920,63,51,493.16,961.04,0.00
2024-12-10 17:18:16,114,921,63,51,492.90,962.00,0.00
2024-12-10 17:18:16,115,921,64,51,488.61,962.01,0.00
2024-12-10 17:18:16,114,921,64,50,492.49,962.04,0.00
2024-12-10 17:18:16,114,922,64,50,492.23,963.00,0.00
2024-12-10 17:18:16,115,922,64,51,487.95,963.01,0.00
2024-12-10 17:18:16,114,922,64,50,491.82,963.04,0.00
2024-12-10 17:18:17,114,923,64,50,491.56,964.00,0.00
2024-12-10 17:18:17,115,923,64,51,487.28,964.01,0.00
2024-12-10 17:18:17,114,923,63,51,491.15,964.04,0.00
2024-12-10 17:18:17,114,924,63,51,490.88,965.00,0.00
2024-12-10 17:18:17,115,924,64,51,486.61,965.01,0.00
2024-12-10 17:18:17,114,924,64,50,490.47,965.04,0.00
2024-12-10 17:18:17,114,925,64,50,490.20,966.00,0.00
2024-12-10 17:18:17,115,925,64,51,485.94,966.01,0.00
2024-12-10 17:18:17,114,925,64,50,489.79,966.04,0.00
2024-12-10 17:18:17,114,926,64,50,489.52,967.00,0.00
2024-12-10 17:18:17,115,926,65,50,485.27,967.01,0.00
2024-12-10 17:18:17,114,926,65,49,489.11,967.04,0.00
2024-12-10 17:18:17,114,927,65,49,488.84,968.00,0.00
2024-12-10 17:18:17,115,927,65,50,484.59,968.01,0.00
2024-12-10 17:18:17,114,927,65,49,488.43,968.04,0.00
2024-12-10 17:18:17,114,928,65,49,488.15,969.00,0.00
2024-12-10 17:18:17,115,928,65,50,483.91,969.01,0.00
2024-12-10 17:18:17,114,928,64,50,487.66,969.05,0.00
2024-12-10 17:18:17,114,929,64,50,487.47,970.00,0.00
2024-12-10 17:18:17,115,929,65,50,483.23,970.01,0.00
2024-12-10 17:18:17,114,929,64,50,486.97,970.05,0.00
2024-12-10 17:18:17,114,930,64,50,486.78,971.00,0.00
2024-12-10 17:18:17,115,930,65,50,482.54,971.01,0.00
2024-12-10 17:18:17,114,930,64,50,486.28,971.05,0.00
2024-12-10 17:18:17,114,931,64,50,486.08,972.00,0.00
2024-12-10 17:18:17,115,931,64,51,481.86,972.01,0.00
2024-12-10 17:18:17,114,931,64,50,485.59,972.05,0.00
2024-12-10 17:18:17,114,932,64,50,485.39,973.00,0.00
2024-12-10 17:18:17,115,932,65,50,481.17,973.01,0.00
2024-12-10 17:18:17,114,932,64,50,484.89,973.05,0.00
2024-12-10 17:18:17,114,933,64,50,484.69,974.00,0.00
2024-12-10 17:18:17,115,933,65,50,480.48,974.01,0.00
2024-12-10 17:18:17,114,933,64,50,484.19,974.05,0.00
2024-12-10 17:18:17,114,934,64,50,483.99,975.00,0.00
2024-12-10 17:18:17,115,934,65,50,479.78,975.01,0.00
2024-12-10 17:18:17,114,934,65,49,483.49,975.05,0.00
2024-12-10 17:18:17,114,935,65,49,483.29,976.00,0.00
2024-12-10 17:18:17,115,935,66,49,479.09,976.01,0.00
2024-12-10 17:18:17,114,935,65,49,482.79,976.05,0.00
2024-12-10 17:18:17,114,936,65,49,482.59,977.00,0.00
2024-12-10 17:18:17,115,936,65,50,478.39,977.01,0.00
2024-12-10 17:18:17,114,936,64,50,482.08,977.05,0.00
2024-12-10 17:18:17,114,937,64,50,481.88,978.00,0.00
2024-12-10 17:18:17,115,937,64,51,477.69,978.01,0.00
2024-12-10 17:18:17,116,936,65,51,473.57,978.03,0.00
2024-12-10 17:18:17,115,936,65,50,479.91,978.06,0.00
2024-12-10 17:18:17,115,937,65,50,479.71,979.00,0.00
2024-12-10 17:18:17,116,937,66,50,475.57,979.01,0.00
2024-12-10 17:18:17,115,937,65,50,479.21,979.05,0.00
2024-12-10 17:18:17,115,938,65,50,487.44,980.00,0.00
2024-12-10 17:18:17,116,938,65,51,483.24,980.01,0.00
2024-12-10 17:18:17,115,938,65,50,486.95,980.05,0.00
2024-12-10 17:18:17,115,939,65,50,486.66,981.00,0.00
2024-12-10 17:18:17,116,939,66,50,482.47,981.01,0.00
2024-12-10 17:18:17,115,939,66,49,486.16,981.05,0.00
2024-12-10 17:18:17,115,940,66,49,485.88,982.00,0.00
2024-12-10 17:18:17,116,940,66,50,481.69,982.01,0.00
2024-12-10 17:18:17,115,940,65,50,485.38,982.05,0.00
2024-12-10 17:18:17,115,941,65,50,485.09,983.00,0.00
2024-12-10 17:18:17,116,941,66,50,480.91,983.01,0.00
2024-12-10 17:18:17,115,941,66,49,484.59,983.05,0.00
2024-12-10 17:18:17,115,942,66,49,484.30,984.00,0.00
2024-12-10 17:18:17,116,942,67,49,480.12,984.01,0.00
2024-12-10 17:18:17,115,942,67,48,483.80,984.05,0.00
2024-12-10 17:18:17,115,943,67,48,483.51,985.00,0.00
2024-12-10 17:18:17,116,943,68,48,479.34,985.01,0.00
2024-12-10 17:18:17,115,943,67,48,483.00,985.05,0.00
2024-12-10 17:18:17,115,944,67,48,482.71,986.00,0.00
2024-12-10 17:18:17,116,944,68,48,478.55,986.01,0.00
2024-12-10 17:18:17,115,944,67,48,482.21,986.05,0.00
2024-12-10 17:18:17,115,945,67,48,481.91,987.00,0.00
2024-12-10 17:18:17,116,945,67,49,477.76,987.01,0.00
2024-12-10 17:18:17,115,945,67,48,481.41,987.05,0.00
2024-12-10 17:18:17,115,946,67,48,481.11,988.00,0.00
2024-12-10 17:18:17,116,946,68,48,476.97,988.01,0.00
2024-12-10 17:18:17,115,946,68,47,480.61,988.05,0.00
2024-12-10 17:18:17,115,947,68,47,480.31,989.00,0.00
2024-12-10 17:18:17,116,947,69,47,476.17,989.01,0.00
2024-12-10 17:18:17,115,947,69,46,479.98,989.03,0.00
2024-12-10 17:18:17,114,947,68,46,484.01,989.04,0.00
2024-12-10 17:18:17,114,948,68,46,483.71,990.00,0.00
2024-12-10 17:18:17,115,948,68,47,479.50,990.01,0.00
2024-12-10 17:18:17,114,948,67,47,483.37,990.04,0.00
2024-12-10 17:18:17,113,948,66,47,487.40,990.05,0.00
2024-12-10 17:18:17,113,949,66,47,487.26,991.00,0.00
2024-12-10 17:18:17,114,949,67,47,482.98,991.01,0.00
2024-12-10 17:18:17,113,949,67,46,486.75,991.05,0.00
2024-12-10 17:18:17,112,949,66,46,491.01,991.05,0.00
2024-12-10 17:18:17,113,948,67,46,483.90,991.35,0.00
2024-12-10 17:18:17,113,949,67,46,492.66,992.00,0.00
2024-12-10 17:18:17,114,949,68,46,488.34,992.01,0.00
2024-12-10 17:18:17,113,949,68,45,492.16,992.05,0.00
2024-12-10 17:18:18,113,950,68,45,500.81,993.00,0.00
2024-12-10 17:18:18,114,950,68,46,496.41,993.01,0.00
2024-12-10 17:18:18,113,950,67,46,500.30,993.05,0.00
2024-12-10 17:18:18,113,951,67,46,500.17,994.00,0.00
2024-12-10 17:18:18,114,951,67,47,495.78,994.01,0.00
2024-12-10 17:18:18,113,951,66,47,499.66,994.05,0.00
2024-12-10 17:18:18,113,952,66,47,499.52,995.00,0.00
2024-12-10 17:18:18,114,952,67,47,495.14,995.01,0.00
2024-12-10 17:18:18,113,952,67,46,499.01,995.05,0.00
2024-12-10 17:18:18,113,953,67,46,498.88,996.00,0.00
2024-12-10 17:18:18,114,953,67,47,494.50,996.01,0.00
2024-12-10 17:18:18,113,953,67,46,498.37,996.05,0.00
2024-12-10 17:18:18,113,954,67,46,498.23,997.00,0.00
2024-12-10 17:18:18,114,954,67,47,493.86,997.01,0.00
2024-12-10 17:18:18,113,954,67,46,497.98,997.03,0.00
2024-12-10 17:18:18,112,954,66,46,502.17,997.04,0.00
2024-12-10 17:18:18,111,954,65,46,506.60,997.05,0.00
2024-12-10 17:18:18,111,955,65,46,506.55,998.00,0.00
2024-12-10 17:18:18,112,955,66,46,502.03,998.01,0.00
2024-12-10 17:18:18,111,955,66,45,506.12,998.05,0.00
2024-12-10 17:18:18,111,956,66,45,506.07,999.00,0.00
2024-12-10 17:18:18,112,956,66,46,501.55,999.01,0.00
2024-12-10 17:18:18,111,956,66,45,505.64,999.05,0.00
2024-12-10 17:18:18,111,957,66,45,505.59,1000.00,0.00
2024-12-10 17:18:18,112,957,67,45,501.07,1000.01,0.00
2024-12-10 17:18:18,111,957,67,44,505.15,1000.05,0.00
2024-12-10 17:18:18,111,958,67,44,505.10,1001.00,0.00
2024-12-10 17:18:18,112,958,68,44,500.59,1001.01,0.00
2024-12-10 17:18:18,111,958,67,44,504.66,1001.05,0.00
2024-12-10 17:18:18,111,959,67,44,504.61,1002.00,0.00
2024-12-10 17:18:18,112,959,68,44,500.11,1002.01,0.00
2024-12-10 17:18:18,111,959,68,43,504.17,1002.05,0.00
2024-12-10 17:18:18,111,960,68,43,504.12,1003.00,0.00
2024-12-10 17:18:18,112,960,69,43,499.62,1003.01,0.00
2024-12-10 17:18:18,111,960,68,43,503.68,1003.05,0.00
2024-12-10 17:18:18,111,961,68,43,503.63,1004.00,0.00
2024-12-10 17:18:18,112,961,69,43,499.13,1004.01,0.00
2024-12-10 17:18:18,111,961,68,43,503.19,1004.05,0.00
2024-12-10 17:18:18,111,962,68,43,503.13,1005.00,0.00
2024-12-10 17:18:18,112,962,68,44,498.64,1005.01,0.00
2024-12-10 17:18:18,111,962,67,44,502.69,1005.05,0.00
2024-12-10 17:18:18,111,963,67,44,502.64,1006.00,0.00
2024-12-10 17:18:18,112,963,68,44,498.15,1006.01,0.00
2024-12-10 17:18:18,111,963,68,43,502.46,1006.02,0.00
2024-12-10 17:18:18,110,963,67,43,506.76,1006.04,0.00
2024-12-10 17:18:18,109,963,66,43,511.32,1006.04,0.00
2024-12-10 17:18:18,109,964,66,43,511.35,1007.00,0.00
2024-12-10 17:18:18,110,964,66,44,506.70,1007.01,0.00
2024-12-10 17:18:18,109,964,65,44,511.00,1007.04,0.00
2024-12-10 17:18:18,109,965,65,44,511.03,1008.00,0.00
2024-12-10 17:18:18,110,965,65,45,506.38,1008.01,0.00
2024-12-10 17:18:18,109,965,64,45,510.67,1008.04,0.00
2024-12-10 17:18:18,109,966,64,45,510.70,1009.00,0.00
2024-12-10 17:18:18,110,966,64,46,506.06,1009.01,0.00
2024-12-10 17:18:18,109,966,63,46,510.34,1009.04,0.00
2024-12-10 17:18:18,109,967,63,46,510.37,1010.00,0.00
2024-12-10 17:18:18,110,967,64,46,505.73,1010.01,0.00
2024-12-10 17:18:18,109,967,63,46,510.02,1010.04,0.00
2024-12-10 17:18:18,109,968,63,46,510.04,1011.00,0.00
2024-12-10 17:18:18,110,968,63,47,505.41,1011.01,0.00
2024-12-10 17:18:18,109,968,63,46,509.69,1011.04,0.00
2024-12-10 17:18:18,109,969,63,46,509.71,1012.00,0.00
2024-12-10 17:18:18,110,969,63,47,505.08,1012.01,0.00
2024-12-10 17:18:18,109,969,63,46,509.35,1012.04,0.00
2024-12-10 17:18:18,109,970,63,46,509.38,1013.00,0.00
2024-12-10 17:18:18,110,970,63,47,504.75,1013.01,0.00
2024-12-10 17:18:18,109,970,63,46,509.02,1013.04,0.00
2024-12-10 17:18:18,109,971,63,46,509.05,1014.00,0.00
2024-12-10 17:18:18,110,971,64,46,504.42,1014.01,0.00
2024-12-10 17:18:18,109,971,63,46,508.69,1014.04,0.00
2024-12-10 17:18:18,110,970,63,47,500.90,1014.37,0.00
2024-12-10 17:18:18,110,971,63,47,510.18,1015.00,0.00
2024-12-10 17:18:18,111,971,64,47,505.58,1015.01,0.00
2024-12-10 17:18:18,110,971,63,47,509.82,1015.04,0.00
2024-12-10 17:18:18,110,972,63,47,518.99,1016.00,0.00
2024-12-10 17:18:18,111,972,64,47,514.32,1016.01,0.00
2024-12-10 17:18:18,110,972,63,47,518.63,1016.04,0.00
2024-12-10 17:18:18,110,973,63,47,518.58,1017.00,0.00
2024-12-10 17:18:18,111,973,63,48,513.91,1017.01,0.00
2024-12-10 17:18:18,110,973,62,48,518.22,1017.04,0.00
2024-12-10 17:18:18,110,974,62,48,518.16,1018.00,0.00
2024-12-10 17:18:18,111,974,63,48,513.49,1018.01,0.00
2024-12-10 17:18:18,110,974,63,47,517.80,1018.04,0.00
2024-12-10 17:18:18,111,973,63,48,510.44,1018.32,0.00
2024-12-10 17:18:18,111,974,63,48,519.60,1019.00,0.00
2024-12-10 17:18:18,112,974,64,48,514.96,1019.01,0.00
2024-12-10 17:18:18,111,974,63,48,519.24,1019.04,0.00
2024-12-10 17:18:18,111,975,63,48,528.29,1020.00,0.00
2024-12-10 17:18:18,112,975,63,49,523.57,1020.01,0.00
2024-12-10 17:18:18,111,975,62,49,527.93,1020.04,0.00
2024-12-10 17:18:18,111,976,62,49,527.79,1021.00,0.00
2024-12-10 17:18:18,112,976,62,50,523.08,1021.01,0.00
2024-12-10 17:18:19,112,977,62,50,522.59,1022.00,0.00
2024-12-10 17:18:19,113,977,63,50,517.96,1022.01,0.00
2024-12-10 17:18:19,113,978,63,50,517.38,1023.00,0.00
2024-12-10 17:18:19,114,978,64,50,512.85,1023.01,0.00
2024-12-10 17:18:19,113,978,63,50,516.86,1023.05,0.00
2024-12-10 17:18:19,113,979,63,50,516.71,1024.00,0.00
2024-12-10 17:18:19,114,979,63,51,512.18,1024.01,0.00
2024-12-10 17:18:19,113,979,62,51,516.19,1024.05,0.00
2024-12-10 17:18:19,113,980,62,51,516.04,1025.00,0.00
2024-12-10 17:18:19,114,980,62,52,511.51,1025.01,0.00
2024-12-10 17:18:19,113,980,61,52,515.51,1025.05,0.00
2024-12-10 17:18:19,113,981,61,52,515.36,1026.00,0.00
2024-12-10 17:18:19,114,981,62,52,510.84,1026.01,0.00
2024-12-10 17:18:19,113,981,61,52,514.83,1026.05,0.00
2024-12-10 17:18:19,113,982,61,52,514.68,1027.00,0.00
2024-12-10 17:18:19,114,982,61,53,510.17,1027.01,0.00
2024-12-10 17:18:19,113,982,61,52,514.15,1027.05,0.00
2024-12-10 17:18:19,113,983,61,52,514.00,1028.00,0.00
2024-12-10 17:18:19,114,983,62,52,509.49,1028.01,0.00
2024-12-10 17:18:19,113,983,61,52,513.47,1028.05,0.00
2024-12-10 17:18:19,113,984,61,52,513.32,1029.00,0.00
2024-12-10 17:18:19,114,984,61,53,508.81,1029.01,0.00
2024-12-10 17:18:19,113,984,60,53,512.78,1029.05,0.00
2024-12-10 17:18:19,113,985,60,53,512.63,1030.00,0.00
2024-12-10 17:18:19,114,985,60,54,508.13,1030.01,0.00
2024-12-10 17:18:19,113,985,59,54,512.10,1030.05,0.00
2024-12-10 17:18:19,113,986,59,54,511.94,1031.00,0.00
2024-12-10 17:18:19,114,986,60,54,507.45,1031.01,0.00
2024-12-10 17:18:19,113,986,59,54,511.41,1031.05,0.00
2024-12-10 17:18:19,113,987,59,54,511.25,1032.00,0.00
2024-12-10 17:18:19,114,987,60,54,506.77,1032.01,0.00
2024-12-10 17:18:19,113,987,60,53,510.72,1032.05,0.00
2024-12-10 17:18:19,113,988,60,53,510.56,1033.00,0.00
2024-12-10 17:18:19,114,988,61,53,506.08,1033.01,0.00
2024-12-10 17:18:19,113,988,61,52,510.02,1033.05,0.00
2024-12-10 17:18:19,113,989,61,52,509.86,1034.00,0.00
2024-12-10 17:18:19,114,989,62,52,505.39,1034.01,0.00
2024-12-10 17:18:19,113,989,62,51,509.33,1034.05,0.00
2024-12-10 17:18:19,114,988,62,52,502.36,1034.32,0.00
2024-12-10 17:18:19,114,989,62,52,511.51,1035.00,0.00
2024-12-10 17:18:19,115,989,62,53,507.06,1035.01,0.00
2024-12-10 17:18:19,114,989,62,52,510.98,1035.05,0.00
2024-12-10 17:18:19,114,990,62,52,519.82,1036.00,0.00
2024-12-10 17:18:19,115,990,62,53,515.30,1036.01,0.00
2024-12-10 17:18:19,114,990,61,53,519.28,1036.05,0.00
2024-12-10 17:18:19,115,989,62,53,507.92,1036.76,0.00
2024-12-10 17:18:19,115,990,62,53,516.88,1037.00,0.00
2024-12-10 17:18:19,116,990,62,54,512.42,1037.01,0.00
2024-12-10 17:18:19,115,990,62,53,516.35,1037.05,0.00
2024-12-10 17:18:19,116,989,62,54,503.37,1037.93,0.00
2024-12-10 17:18:19,116,990,62,54,521.15,1038.00,0.00
2024-12-10 17:18:19,117,990,62,55,516.69,1038.01,0.00
2024-12-10 17:18:19,116,990,62,54,520.97,1038.02,0.00
2024-12-10 17:18:19,115,990,61,54,525.15,1038.04,0.00
2024-12-10 17:18:19,114,990,60,54,529.66,1038.04,0.00
2024-12-10 17:18:19,114,991,60,54,538.46,1039.00,0.00
2024-12-10 17:18:19,115,991,61,54,533.77,1039.01,0.00
2024-12-10 17:18:19,114,991,60,54,538.01,1039.04,0.00
2024-12-10 17:18:19,114,992,60,54,537.70,1040.00,0.00
2024-12-10 17:18:19,115,992,60,55,533.02,1040.01,0.00
2024-12-10 17:18:19,114,992,60,54,537.25,1040.04,0.00
2024-12-10 17:18:19,114,993,60,54,536.94,1041.00,0.00
2024-12-10 17:18:19,115,993,60,55,532.27,1041.01,0.00
2024-12-10 17:18:19,114,993,60,54,536.49,1041.04,0.00
2024-12-10 17:18:19,114,994,60,54,536.11,1042.00,0.00
2024-12-10 17:18:19,115,994,61,54,531.44,1042.01,0.00
2024-12-10 17:18:19,114,994,61,53,535.66,1042.04,0.00
2024-12-10 17:18:19,114,995,61,53,535.14,1043.00,0.00
2024-12-10 17:18:19,115,995,61,54,530.49,1043.01,0.00
2024-12-10 17:18:19,114,995,60,54,534.70,1043.04,0.00
2024-12-10 17:18:19,115,994,60,55,527.82,1043.28,0.00
2024-12-10 17:18:19,115,995,60,55,536.40,1044.00,0.00
2024-12-10 17:18:19,116,995,60,56,531.78,1044.01,0.00
2024-12-10 17:18:19,115,995,60,55,535.96,1044.04,0.00
2024-12-10 17:18:19,115,996,60,55,544.21,1045.00,0.00
2024-12-10 17:18:19,116,996,61,55,539.52,1045.01,0.00
2024-12-10 17:18:19,115,996,61,54,543.77,1045.04,0.00
2024-12-10 17:18:19,115,997,61,54,542.90,1046.00,0.00
2024-12-10 17:18:19,116,997,62,54,538.22,1046.01,0.00
2024-12-10 17:18:19,115,997,61,54,542.45,1046.04,0.00
2024-12-10 17:18:19,114,997,60,54,547.12,1046.04,0.00
2024-12-10 17:18:19,114,998,60,54,546.32,1047.00,0.00
2024-12-10 17:18:19,115,998,61,54,541.57,1047.01,0.00
2024-12-10 17:18:19,115,999,61,54,540.29,1048.00,0.00
2024-12-10 17:18:19,116,999,61,55,535.63,1048.01,0.00
2024-12-10 17:18:19,116,1000,61,55,534.29,1049.00,0.00
2024-12-10 17:18:19,117,1000,61,56,529.73,1049.01,0.00
2024-12-10 17:18:19,116,1000,61,55,533.68,1049.06,0.00
2024-12-10 17:18:19,116,1001,61,55,532.86,1050.00,0.00
2024-12-10 17:18:19,117,1001,61,56,528.31,1050.01,0.00
2024-12-10 17:18:19,116,1001,61,55,532.25,1050.06,0.00
2024-12-10 17:18:19,115,1001,60,55,532.68,1050.44,0.00
2024-12-10 17:18:19,115,1002,60,55,536.28,1051.00,0.00
2024-12-10 17:18:19,116,1002,60,56,531.66,1051.01,0.00
2024-12-10 17:18:19,115,1002,60,55,535.66,1051.06,0.00
2024-12-10 17:18:20,115,1003,60,55,535.42,1052.00,0.00
2024-12-10 17:18:20,116,1003,61,55,530.81,1052.01,0.00
2024-12-10 17:18:20,115,1003,60,55,535.24,1052.02,0.00
2024-12-10 17:18:20,114,1003,59,55,539.49,1052.05,0.00
2024-12-10 17:18:20,113,1003,59,54,544.17,1052.05,0.00
2024-12-10 17:18:20,113,1004,59,54,544.02,1053.00,0.00
2024-12-10 17:18:20,114,1004,59,55,539.25,1053.01,0.00
2024-12-10 17:18:20,113,1004,59,54,543.48,1053.05,0.00
2024-12-10 17:18:20,114,1003,60,54,537.52,1053.18,0.00
2024-12-10 17:18:20,114,1004,60,54,539.48,1054.00,0.00
2024-12-10 17:18:20,115,1004,60,55,534.79,1054.01,0.00
2024-12-10 17:18:20,114,1004,59,55,538.94,1054.05,0.00
2024-12-10 17:18:20,114,1005,59,55,547.95,1055.00,0.00
2024-12-10 17:18:20,115,1005,60,55,543.19,1055.01,0.00
2024-12-10 17:18:20,114,1005,60,54,547.41,1055.05,0.00
2024-12-10 17:18:20,114,1006,60,54,547.17,1056.00,0.00
2024-12-10 17:18:20,115,1006,60,55,542.42,1056.01,0.00
2024-12-10 17:18:20,114,1006,59,55,546.63,1056.05,0.00
2024-12-10 17:18:20,114,1007,59,55,546.39,1057.00,0.00
2024-12-10 17:18:20,115,1007,60,55,541.64,1057.01,0.00
2024-12-10 17:18:20,114,1007,59,55,545.85,1057.05,0.00
2024-12-10 17:18:20,114,1008,59,55,545.61,1058.00,0.00
2024-12-10 17:18:20,115,1008,60,55,540.87,1058.01,0.00
2024-12-10 17:18:20,114,1008,59,55,545.07,1058.05,0.00
2024-12-10 17:18:20,114,1009,59,55,544.83,1059.00,0.00
2024-12-10 17:18:20,115,1009,60,55,540.09,1059.01,0.00
2024-12-10 17:18:20,114,1009,59,55,544.64,1059.02,0.00
2024-12-10 17:18:20,113,1009,58,55,549.10,1059.04,0.00
2024-12-10 17:18:20,113,1010,58,55,548.85,1060.00,0.00
2024-12-10 17:18:20,114,1010,59,55,544.04,1060.01,0.00
2024-12-10 17:18:20,113,1010,59,54,548.31,1060.05,0.00
2024-12-10 17:18:20,113,1011,59,54,548.15,1061.00,0.00
2024-12-10 17:18:20,114,1011,59,55,543.34,1061.01,0.00
2024-12-10 17:18:20,113,1011,59,54,547.61,1061.05,0.00
2024-12-10 17:18:20,113,1012,59,54,547.45,1062.00,0.00
2024-12-10 17:18:20,114,1012,60,54,542.64,1062.01,0.00
2024-12-10 17:18:20,113,1012,59,54,546.90,1062.05,0.00
2024-12-10 17:18:20,113,1013,59,54,546.74,1063.00,0.00
2024-12-10 17:18:20,114,1013,59,55,541.94,1063.01,0.00
2024-12-10 17:18:20,113,1013,59,54,546.19,1063.05,0.00
2024-12-10 17:18:20,113,1014,59,54,546.03,1064.00,0.00
2024-12-10 17:18:20,114,1014,60,54,541.24,1064.01,0.00
2024-12-10 17:18:20,113,1014,60,53,545.48,1064.05,0.00
2024-12-10 17:18:20,113,1015,60,53,545.32,1065.00,0.00
2024-12-10 17:18:20,114,1015,60,54,540.53,1065.01,0.00
2024-12-10 17:18:20,113,1015,59,54,544.77,1065.05,0.00
2024-12-10 17:18:20,113,1016,59,54,544.60,1066.00,0.00
2024-12-10 17:18:20,114,1016,59,55,539.83,1066.01,0.00
2024-12-10 17:18:20,114,1017,59,55,539.12,1067.00,0.00
2024-12-10 17:18:20,115,1017,59,56,534.43,1067.01,0.00
2024-12-10 17:18:20,114,1017,58,56,538.49,1067.06,0.00
2024-12-10 17:18:20,114,1018,58,56,538.31,1068.00,0.00
2024-12-10 17:18:20,115,1018,59,56,533.63,1068.01,0.00
2024-12-10 17:18:20,114,1018,59,55,537.68,1068.06,0.00
2024-12-10 17:18:20,114,1019,59,55,537.50,1069.00,0.00
2024-12-10 17:18:20,115,1019,60,55,532.83,1069.01,0.00
2024-12-10 17:18:20,114,1019,60,54,536.87,1069.06,0.00
2024-12-10 17:18:20,114,1020,60,54,536.69,1070.00,0.00
2024-12-10 17:18:20,115,1020,60,55,532.02,1070.01,0.00
2024-12-10 17:18:20,114,1020,59,55,536.06,1070.06,0.00
2024-12-10 17:18:20,114,1021,59,55,535.88,1071.00,0.00
2024-12-10 17:18:20,115,1021,60,55,531.22,1071.01,0.00
2024-12-10 17:18:20,114,1021,59,55,535.24,1071.06,0.00
2024-12-10 17:18:20,114,1022,59,55,535.06,1072.00,0.00
2024-12-10 17:18:20,115,1022,60,55,530.41,1072.01,0.00
2024-12-10 17:18:20,114,1022,60,54,534.42,1072.06,0.00
2024-12-10 17:18:20,114,1023,60,54,534.24,1073.00,0.00
2024-12-10 17:18:20,115,1023,60,55,529.60,1073.01,0.00
2024-12-10 17:18:20,114,1023,59,55,533.60,1073.06,0.00
2024-12-10 17:18:20,115,1022,60,55,525.30,1073.43,0.00
2024-12-10 17:18:20,115,1023,60,55,534.38,1074.00,0.00
2024-12-10 17:18:20,116,1023,61,55,529.78,1074.01,0.00
2024-12-10 17:18:20,115,1023,60,55,533.75,1074.06,0.00
2024-12-10 17:18:20,115,1024,60,55,542.83,1075.00,0.00
2024-12-10 17:18:20,116,1024,61,55,538.15,1075.01,0.00
2024-12-10 17:18:20,115,1024,60,55,542.19,1075.06,0.00
2024-12-10 17:18:20,115,1025,60,55,541.93,1076.00,0.00
2024-12-10 17:18:20,116,1025,61,55,537.26,1076.01,0.00
2024-12-10 17:18:20,115,1025,60,55,541.29,1076.06,0.00
2024-12-10 17:18:20,115,1026,60,55,541.03,1077.00,0.00
2024-12-10 17:18:20,116,1026,61,55,536.36,1077.01,0.00
2024-12-10 17:18:20,115,1026,61,54,540.39,1077.06,0.00
2024-12-10 17:18:20,115,1027,61,54,540.12,1078.00,0.00
2024-12-10 17:18:20,116,1027,62,54,535.47,1078.01,0.00
2024-12-10 17:18:20,115,1027,61,54,540.03,1078.01,0.00
2024-12-10 17:18:20,114,1027,61,53,544.22,1078.05,0.00
2024-12-10 17:18:20,113,1027,60,53,548.94,1078.05,0.00
2024-12-10 17:18:20,113,1028,60,53,548.76,1079.00,0.00
2024-12-10 17:18:20,114,1028,61,53,543.95,1079.01,0.00
2024-12-10 17:18:20,113,1028,60,53,548.21,1079.05,0.00
2024-12-10 17:18:20,113,1029,60,53,548.03,1080.00,0.00
2024-12-10 17:18:20,114,1029,60,54,543.22,1080.01,0.00
2024-12-10 17:18:20,113,1029,60,53,547.47,1080.05,0.00
2024-12-10 17:18:21,113,1030,60,53,547.29,1081.00,0.00
2024-12-10 17:18:21,114,1030,60,54,542.49,1081.01,0.00
2024-12-10 17:18:21,113,1030,59,54,546.74,1081.05,0.00
2024-12-10 17:18:21,113,1031,59,54,546.55,1082.00,0.00
2024-12-10 17:18:21,114,1031,59,55,541.76,1082.01,0.00
2024-12-10 17:18:21,113,1031,59,54,546.00,1082.05,0.00
2024-12-10 17:18:21,113,1032,59,54,545.81,1083.00,0.00
2024-12-10 17:18:21,114,1032,59,55,541.02,1083.01,0.00
2024-12-10 17:18:21,113,1032,58,55,545.25,1083.05,0.00
2024-12-10 17:18:21,113,1033,58,55,545.07,1084.00,0.00
2024-12-10 17:18:21,114,1033,58,56,540.29,1084.01,0.00
2024-12-10 17:18:21,113,1033,57,56,544.51,1084.05,0.00
2024-12-10 17:18:21,113,1034,57,56,544.32,1085.00,0.00
2024-12-10 17:18:21,114,1034,57,57,539.55,1085.01,0.00
2024-12-10 17:18:21,113,1034,56,57,543.76,1085.05,0.00
2024-12-10 17:18:21,113,1035,56,57,543.58,1086.00,0.00
2024-12-10 17:18:21,114,1035,56,58,538.81,1086.01,0.00
2024-12-10 17:18:21,113,1035,55,58,543.02,1086.05,0.00
2024-12-10 17:18:21,113,1036,55,58,542.83,1087.00,0.00
2024-12-10 17:18:21,114,1036,55,59,538.06,1087.01,0.00
2024-12-10 17:18:21,113,1036,55,58,542.26,1087.05,0.00
2024-12-10 17:18:21,113,1037,55,58,542.07,1088.00,0.00
2024-12-10 17:18:21,114,1037,56,58,537.32,1088.01,0.00
2024-12-10 17:18:21,113,1037,55,58,541.51,1088.05,0.00
2024-12-10 17:18:21,113,1038,55,58,541.32,1089.00,0.00
2024-12-10 17:18:21,114,1038,55,59,536.57,1089.01,0.00
2024-12-10 17:18:21,113,1038,54,59,540.76,1089.05,0.00
2024-12-10 17:18:21,113,1039,54,59,540.56,1090.00,0.00
2024-12-10 17:18:21,114,1039,54,60,535.82,1090.01,0.00
2024-12-10 17:18:21,113,1039,54,59,540.00,1090.05,0.00
2024-12-10 17:18:21,113,1040,54,59,539.80,1091.00,0.00
2024-12-10 17:18:21,114,1040,55,59,535.07,1091.01,0.00
2024-12-10 17:18:21,113,1040,55,58,539.71,1091.01,0.00
2024-12-10 17:18:21,112,1040,54,58,544.05,1091.05,0.00
2024-12-10 17:18:21,112,1041,54,58,543.85,1092.00,0.00
2024-12-10 17:18:21,113,1041,55,58,539.04,1092.01,0.00
2024-12-10 17:18:21,112,1041,54,58,543.38,1092.05,0.00
2024-12-10 17:18:21,112,1042,54,58,543.18,1093.00,0.00
2024-12-10 17:18:21,113,1042,55,58,538.37,1093.01,0.00
2024-12-10 17:18:21,112,1042,55,57,542.71,1093.05,0.00
2024-12-10 17:18:21,113,1041,55,58,535.81,1093.26,0.00
2024-12-10 17:18:21,113,1042,55,58,545.26,1094.00,0.00
2024-12-10 17:18:21,114,1042,56,58,540.47,1094.01,0.00
2024-12-10 17:18:21,113,1042,56,57,544.79,1094.04,0.00
2024-12-10 17:18:21,113,1043,56,57,554.19,1095.00,0.00
2024-12-10 17:18:21,114,1043,56,58,549.32,1095.01,0.00
2024-12-10 17:18:21,113,1043,55,58,553.71,1095.04,0.00
2024-12-10 17:18:21,113,1044,55,58,553.43,1096.00,0.00
2024-12-10 17:18:21,114,1044,56,58,548.58,1096.01,0.00
2024-12-10 17:18:21,113,1044,56,57,552.96,1096.04,0.00
2024-12-10 17:18:21,113,1045,56,57,552.62,1097.00,0.00
2024-12-10 17:18:21,114,1045,57,57,547.77,1097.01,0.00
2024-12-10 17:18:21,113,1045,57,56,552.15,1097.04,0.00
2024-12-10 17:18:21,113,1046,57,56,551.76,1098.00,0.00
2024-12-10 17:18:21,114,1046,58,56,546.92,1098.01,0.00
2024-12-10 17:18:21,113,1046,57,56,551.29,1098.04,0.00
2024-12-10 17:18:21,113,1047,57,56,551.00,1099.00,0.00
2024-12-10 17:18:21,114,1047,57,57,546.17,1099.01,0.00
2024-12-10 17:18:21,113,1047,57,56,550.53,1099.04,0.00
2024-12-10 17:18:21,113,1048,57,56,550.24,1100.00,0.00
2024-12-10 17:18:21,114,1048,58,56,545.41,1100.01,0.00
2024-12-10 17:18:21,113,1048,57,56,549.76,1100.04,0.00
2024-12-10 17:18:21,113,1049,57,56,549.47,1101.00,0.00
2024-12-10 17:18:21,114,1049,58,56,544.65,1101.01,0.00
2024-12-10 17:18:21,113,1049,57,56,548.99,1101.04,0.00
2024-12-10 17:18:21,113,1050,57,56,548.70,1102.00,0.00
2024-12-10 17:18:21,114,1050,57,57,543.89,1102.01,0.00
2024-12-10 17:18:21,113,1050,56,57,548.22,1102.04,0.00
2024-12-10 17:18:21,113,1051,56,57,547.93,1103.00,0.00
2024-12-10 17:18:21,114,1051,56,58,543.12,1103.01,0.00
2024-12-10 17:18:21,113,1051,55,58,547.45,1103.04,0.00
2024-12-10 17:18:21,114,1050,56,58,539.99,1103.31,0.00
2024-12-10 17:18:21,114,1051,56,58,548.75,1104.00,0.00
2024-12-10 17:18:21,115,1051,56,59,543.98,1104.01,0.00
2024-12-10 17:18:21,114,1051,55,59,548.27,1104.04,0.00
2024-12-10 17:18:21,114,1052,55,59,557.58,1105.00,0.00
2024-12-10 17:18:21,115,1052,56,59,552.73,1105.01,0.00
2024-12-10 17:18:21,114,1052,56,58,557.11,1105.04,0.00
2024-12-10 17:18:21,114,1053,56,58,556.73,1106.00,0.00
2024-12-10 17:18:21,115,1053,57,58,551.89,1106.01,0.00
2024-12-10 17:18:21,114,1053,56,58,556.25,1106.04,0.00
2024-12-10 17:18:21,114,1054,56,58,555.87,1107.00,0.00
2024-12-10 17:18:21,115,1054,57,58,551.04,1107.01,0.00
2024-12-10 17:18:21,114,1054,57,57,555.39,1107.04,0.00
2024-12-10 17:18:21,114,1055,57,57,555.01,1108.00,0.00
2024-12-10 17:18:21,115,1055,57,58,550.19,1108.01,0.00
2024-12-10 17:18:21,114,1055,57,57,554.54,1108.04,0.00
2024-12-10 17:18:21,114,1056,57,57,554.12,1109.00,0.00
2024-12-10 17:18:21,115,1056,58,57,549.30,1109.01,0.00
2024-12-10 17:18:21,114,1056,58,56,553.64,1109.04,0.00
2024-12-10 17:18:22,114,1057,58,56,553.14,1110.00,0.00
2024-12-10 17:18:22,115,1057,59,56,548.33,1110.01,0.00
2024-12-10 17:18:22,115,1058,59,56,547.47,1111.00,0.00
2024-12-10 17:18:22,116,1058,60,56,542.75,1111.01,0.00
2024-12-10 17:18:22,115,1058,60,55,546.90,1111.05,0.00
2024-12-10 17:18:22,115,1059,60,55,546.51,1112.00,0.00
2024-12-10 17:18:22,116,1059,61,55,541.80,1112.01,0.00
2024-12-10 17:18:22,115,1059,61,54,545.94,1112.05,0.00
2024-12-10 17:18:22,115,1060,61,54,545.55,1113.00,0.00
2024-12-10 17:18:22,116,1060,61,55,540.85,1113.01,0.00
2024-12-10 17:18:22,116,1061,61,55,539.89,1114.00,0.00
2024-12-10 17:18:22,117,1061,61,56,535.28,1114.01,0.00
2024-12-10 17:18:22,116,1061,60,56,539.70,1114.02,0.00
2024-12-10 17:18:22,115,1061,59,56,543.92,1114.05,0.00
2024-12-10 17:18:22,114,1061,59,55,548.60,1114.05,0.00
2024-12-10 17:18:22,115,1060,59,56,541.16,1114.31,0.00
2024-12-10 17:18:22,115,1061,59,56,550.80,1115.00,0.00
2024-12-10 17:18:22,116,1061,60,56,546.05,1115.01,0.00
2024-12-10 17:18:22,116,1062,60,56,554.72,1116.00,0.00
2024-12-10 17:18:22,117,1062,61,56,549.97,1116.01,0.00
2024-12-10 17:18:22,116,1062,60,56,554.06,1116.06,0.00
2024-12-10 17:18:22,116,1063,60,56,553.67,1117.00,0.00
2024-12-10 17:18:22,117,1063,61,56,548.94,1117.01,0.00
2024-12-10 17:18:22,116,1063,61,55,553.02,1117.06,0.00
2024-12-10 17:18:22,116,1064,61,55,552.63,1118.00,0.00
2024-12-10 17:18:22,117,1064,62,55,547.90,1118.01,0.00
2024-12-10 17:18:22,116,1064,61,55,552.53,1118.01,0.00
2024-12-10 17:18:22,115,1064,60,55,556.77,1118.05,0.00
2024-12-10 17:18:22,114,1064,60,54,561.55,1118.05,0.00
2024-12-10 17:18:22,114,1065,60,54,561.25,1119.00,0.00
2024-12-10 17:18:22,115,1065,60,55,556.37,1119.01,0.00
2024-12-10 17:18:22,114,1065,59,55,560.68,1119.05,0.00
2024-12-10 17:18:22,114,1066,59,55,560.38,1120.00,0.00
2024-12-10 17:18:22,115,1066,60,55,555.51,1120.01,0.00
2024-12-10 17:18:22,114,1066,60,54,559.81,1120.05,0.00
2024-12-10 17:18:22,114,1067,60,54,559.50,1121.00,0.00
2024-12-10 17:18:22,115,1067,60,55,554.64,1121.01,0.00
2024-12-10 17:18:22,114,1067,60,54,558.93,1121.05,0.00
2024-12-10 17:18:22,114,1068,60,54,558.62,1122.00,0.00
2024-12-10 17:18:22,115,1068,61,54,553.77,1122.01,0.00
2024-12-10 17:18:22,114,1068,60,54,558.05,1122.05,0.00
2024-12-10 17:18:22,115,1067,60,55,551.08,1122.26,0.00
2024-12-10 17:18:22,115,1068,60,55,560.71,1123.00,0.00
2024-12-10 17:18:22,116,1068,61,55,555.87,1123.01,0.00
2024-12-10 17:18:22,115,1068,60,55,560.13,1123.05,0.00
2024-12-10 17:18:22,115,1069,60,55,569.51,1124.00,0.00
2024-12-10 17:18:22,116,1069,60,56,564.60,1124.01,0.00
2024-12-10 17:18:22,115,1069,60,55,568.94,1124.05,0.00
2024-12-10 17:18:22,115,1070,60,55,568.55,1125.00,0.00
2024-12-10 17:18:22,116,1070,61,55,563.65,1125.01,0.00
2024-12-10 17:18:22,115,1070,61,54,567.98,1125.05,0.00
2024-12-10 17:18:22,115,1071,61,54,567.59,1126.00,0.00
2024-12-10 17:18:22,116,1071,62,54,562.70,1126.01,0.00
2024-12-10 17:18:22,115,1071,61,54,567.01,1126.05,0.00
2024-12-10 17:18:22,115,1072,61,54,566.62,1127.00,0.00
2024-12-10 17:18:22,116,1072,61,55,561.74,1127.01,0.00
2024-12-10 17:18:22,115,1072,61,54,566.05,1127.05,0.00
2024-12-10 17:18:22,115,1073,61,54,565.65,1128.00,0.00
2024-12-10 17:18:22,116,1073,61,55,560.78,1128.01,0.00
2024-12-10 17:18:22,115,1073,60,55,565.08,1128.05,0.00
2024-12-10 17:18:22,116,1072,60,56,551.52,1128.87,0.00
2024-12-10 17:18:22,116,1073,60,56,561.18,1129.00,0.00
2024-12-10 17:18:22,117,1073,60,57,556.38,1129.01,0.00
2024-12-10 17:18:22,116,1073,60,56,560.61,1129.05,0.00
2024-12-10 17:18:22,117,1072,61,56,547.71,1129.81,0.00
2024-12-10 17:18:22,117,1073,61,56,566.90,1130.00,0.00
2024-12-10 17:18:22,118,1073,61,57,562.10,1130.01,0.00
2024-12-10 17:18:22,118,1074,61,57,570.25,1131.00,0.00
2024-12-10 17:18:22,119,1074,61,58,565.46,1131.01,0.00
2024-12-10 17:18:22,118,1074,60,58,569.59,1131.06,0.00
2024-12-10 17:18:22,118,1075,60,58,568.93,1132.00,0.00
2024-12-10 17:18:22,119,1075,61,58,564.15,1132.01,0.00
2024-12-10 17:18:22,118,1075,60,58,568.27,1132.06,0.00
2024-12-10 17:18:22,118,1076,60,58,567.65,1133.00,0.00
2024-12-10 17:18:22,119,1076,61,58,562.88,1133.01,0.00
2024-12-10 17:18:22,118,1076,60,58,567.00,1133.06,0.00
2024-12-10 17:18:22,117,1076,60,57,571.50,1133.09,0.00
2024-12-10 17:18:22,118,1075,60,58,564.77,1133.27,0.00
2024-12-10 17:18:22,118,1076,60,58,574.16,1134.00,0.00
2024-12-10 17:18:22,119,1076,60,59,569.34,1134.01,0.00
2024-12-10 17:18:22,118,1076,59,59,574.06,1134.01,0.00
2024-12-10 17:18:22,117,1076,58,59,578.41,1134.05,0.00
2024-12-10 17:18:22,116,1076,58,58,583.29,1134.05,0.00
2024-12-10 17:18:22,116,1077,58,58,592.60,1135.00,0.00
2024-12-10 17:18:22,117,1077,58,59,587.53,1135.01,0.00
2024-12-10 17:18:22,116,1077,58,58,592.03,1135.05,0.00
2024-12-10 17:18:22,116,1078,58,58,591.44,1136.00,0.00
2024-12-10 17:18:22,117,1078,59,58,586.38,1136.01,0.00
2024-12-10 17:18:22,116,1078,58,58,591.25,1136.02,0.00
2024-12-10 17:18:22,115,1078,57,58,596.01,1136.04,0.00
2024-12-10 17:18:22,114,1078,57,57,601.19,1136.04,0.00
2024-12-10 17:18:22,114,1079,57,57,600.59,1137.00,0.00
2024-12-10 17:18:22,115,1079,57,58,595.37,1137.01,0.00
2024-12-10 17:18:23,114,1079,57,57,600.11,1137.04,0.00
2024-12-10 17:18:23,113,1079,57,56,604.70,1137.09,0.00
2024-12-10 17:18:23,113,1080,57,56,604.90,1138.00,0.00
2024-12-10 17:18:23,114,1080,58,56,599.59,1138.01,0.00
2024-12-10 17:18:23,113,1080,58,55,604.41,1138.04,0.00
2024-12-10 17:18:23,113,1081,58,55,604.12,1139.00,0.00
2024-12-10 17:18:23,114,1081,59,55,598.82,1139.01,0.00
2024-12-10 17:18:23,114,1082,59,55,598.04,1140.00,0.00
2024-12-10 17:18:23,115,1082,59,56,592.84,1140.01,0.00
2024-12-10 17:18:23,114,1082,59,55,597.46,1140.05,0.00
2024-12-10 17:18:23,114,1083,59,55,597.17,1141.00,0.00
2024-12-10 17:18:23,115,1083,59,56,591.97,1141.01,0.00
2024-12-10 17:18:23,114,1083,59,55,596.59,1141.05,0.00
2024-12-10 17:18:23,114,1084,59,55,596.29,1142.00,0.00
2024-12-10 17:18:23,115,1084,60,55,591.10,1142.01,0.00
2024-12-10 17:18:23,115,1085,60,55,590.23,1143.00,0.00
2024-12-10 17:18:23,116,1085,61,55,585.14,1143.01,0.00
2024-12-10 17:18:23,115,1085,61,54,589.56,1143.06,0.00
2024-12-10 17:18:23,115,1086,61,54,589.25,1144.00,0.00
2024-12-10 17:18:23,116,1086,62,54,584.17,1144.01,0.00
2024-12-10 17:18:23,115,1086,62,53,588.58,1144.06,0.00
2024-12-10 17:18:23,115,1087,62,53,588.27,1145.00,0.00
2024-12-10 17:18:23,116,1087,62,54,583.20,1145.01,0.00
2024-12-10 17:18:23,115,1087,61,54,587.60,1145.06,0.00
2024-12-10 17:18:23,114,1087,60,54,592.71,1145.06,0.00
2024-12-10 17:18:23,114,1088,60,54,592.50,1146.00,0.00
2024-12-10 17:18:23,115,1088,61,54,587.35,1146.01,0.00
2024-12-10 17:18:23,116,1087,61,55,572.62,1146.91,0.00
2024-12-10 17:18:23,116,1088,61,55,582.60,1147.00,0.00
2024-12-10 17:18:23,117,1088,62,55,577.62,1147.01,0.00
2024-12-10 17:18:23,116,1088,61,55,581.83,1147.06,0.00
2024-12-10 17:18:23,116,1089,61,55,591.32,1148.00,0.00
2024-12-10 17:18:23,117,1089,62,55,586.26,1148.01,0.00
2024-12-10 17:18:23,116,1089,62,54,590.52,1148.06,0.00
2024-12-10 17:18:23,116,1090,62,54,590.12,1149.00,0.00
2024-12-10 17:18:23,117,1090,62,55,585.08,1149.01,0.00
2024-12-10 17:18:23,116,1090,62,54,589.42,1149.06,0.00
2024-12-10 17:18:23,116,1091,62,54,589.02,1150.00,0.00
2024-12-10 17:18:23,117,1091,63,54,583.99,1150.01,0.00
2024-12-10 17:18:23,116,1091,63,53,588.35,1150.06,0.00
2024-12-10 17:18:23,116,1092,63,53,587.94,1151.00,0.00
2024-12-10 17:18:23,117,1092,63,54,582.92,1151.01,0.00
2024-12-10 17:18:23,116,1092,63,53,587.27,1151.06,0.00
2024-12-10 17:18:23,116,1093,63,53,586.87,1152.00,0.00
2024-12-10 17:18:23,117,1093,64,53,581.85,1152.01,0.00
2024-12-10 17:18:23,116,1093,63,53,586.19,1152.06,0.00
2024-12-10 17:18:23,116,1094,63,53,585.78,1153.00,0.00
2024-12-10 17:18:23,117,1094,63,54,580.78,1153.01,0.00
2024-12-10 17:18:23,116,1094,63,53,585.69,1153.01,0.00
2024-12-10 17:18:23,115,1094,63,52,590.03,1153.05,0.00
2024-12-10 17:18:23,115,1095,63,52,589.61,1154.00,0.00
2024-12-10 17:18:23,116,1095,63,53,584.53,1154.01,0.00
2024-12-10 17:18:23,115,1095,63,52,588.37,1154.06,0.00
2024-12-10 17:18:23,115,1096,63,52,588.05,1155.00,0.00
2024-12-10 17:18:23,116,1096,63,53,582.98,1155.01,0.00
2024-12-10 17:18:23,115,1096,62,53,586.51,1155.06,0.00
2024-12-10 17:18:23,115,1097,62,53,586.19,1156.00,0.00
2024-12-10 17:18:23,116,1097,63,53,581.14,1156.01,0.00
2024-12-10 17:18:23,115,1097,63,52,584.88,1156.06,0.00
2024-12-10 17:18:23,115,1098,63,52,584.55,1157.00,0.00
2024-12-10 17:18:23,116,1098,64,52,579.51,1157.01,0.00
2024-12-10 17:18:23,115,1098,63,52,583.66,1157.06,0.00
2024-12-10 17:18:23,115,1099,63,52,583.34,1158.00,0.00
2024-12-10 17:18:23,116,1099,63,53,578.31,1158.01,0.00
2024-12-10 17:18:23,115,1099,62,53,582.66,1158.06,0.00
2024-12-10 17:18:23,115,1100,62,53,582.33,1159.00,0.00
2024-12-10 17:18:23,116,1100,62,54,577.31,1159.01,0.00
2024-12-10 17:18:23,115,1100,61,54,581.65,1159.06,0.00
2024-12-10 17:18:23,115,1101,61,54,581.32,1160.00,0.00
2024-12-10 17:18:23,116,1101,62,54,576.31,1160.01,0.00
2024-12-10 17:18:23,115,1101,61,54,580.64,1160.06,0.00
2024-12-10 17:18:23,115,1102,61,54,580.31,1161.00,0.00
2024-12-10 17:18:23,116,1102,61,55,575.31,1161.01,0.00
2024-12-10 17:18:23,115,1102,61,54,579.62,1161.06,0.00
2024-12-10 17:18:23,115,1103,61,54,579.29,1162.00,0.00
2024-12-10 17:18:23,116,1103,61,55,574.30,1162.01,0.00
2024-12-10 17:18:23,115,1103,60,55,578.61,1162.06,0.00
2024-12-10 17:18:23,115,1104,60,55,578.27,1163.00,0.00
2024-12-10 17:18:23,116,1104,60,56,573.29,1163.01,0.00
2024-12-10 17:18:23,115,1104,60,55,577.59,1163.06,0.00
2024-12-10 17:18:23,115,1105,60,55,577.25,1164.00,0.00
2024-12-10 17:18:23,116,1105,60,56,572.28,1164.01,0.00
2024-12-10 17:18:23,115,1105,59,56,576.36,1164.06,0.00
2024-12-10 17:18:23,116,1104,59,57,566.38,1164.52,0.00
2024-12-10 17:18:23,116,1105,59,57,576.18,1165.00,0.00
2024-12-10 17:18:23,117,1105,60,57,571.26,1165.01,0.00
2024-12-10 17:18:23,116,1105,60,56,575.02,1165.06,0.00
2024-12-10 17:18:23,116,1106,60,56,584.64,1166.00,0.00
2024-12-10 17:18:23,117,1106,60,57,579.64,1166.01,0.00
2024-12-10 17:18:23,116,1106,60,56,583.19,1166.06,0.00
2024-12-10 17:18:24,116,1107,60,56,582.76,1167.00,0.00
2024-12-10 17:18:24,117,1107,60,57,577.78,1167.01,0.00
2024-12-10 17:18:24,116,1107,60,56,581.24,1167.06,0.00
2024-12-10 17:18:24,116,1108,60,56,580.82,1168.00,0.00
2024-12-10 17:18:24,117,1108,60,57,575.85,1168.01,0.00
2024-12-10 17:18:24,116,1108,59,57,579.68,1168.04,0.00
2024-12-10 17:18:24,115,1108,58,57,584.52,1168.05,0.00
2024-12-10 17:18:24,115,1109,58,57,584.09,1169.00,0.00
2024-12-10 17:18:24,116,1109,58,58,579.05,1169.01,0.00
2024-12-10 17:18:24,115,1109,57,58,583.49,1169.05,0.00
2024-12-10 17:18:24,116,1108,57,59,570.20,1169.80,0.00
2024-12-10 17:18:24,116,1109,57,59,580.36,1170.00,0.00
2024-12-10 17:18:24,117,1109,57,60,575.40,1170.01,0.00
2024-12-10 17:18:24,116,1109,57,59,579.77,1170.05,0.00
2024-12-10 17:18:24,116,1110,57,59,589.33,1171.00,0.00
2024-12-10 17:18:24,117,1110,57,60,584.30,1171.01,0.00
2024-12-10 17:18:24,116,1110,56,60,588.74,1171.05,0.00
2024-12-10 17:18:24,116,1111,56,60,588.22,1172.00,0.00
2024-12-10 17:18:24,117,1111,57,60,583.19,1172.01,0.00
2024-12-10 17:18:24,116,1111,56,60,587.63,1172.05,0.00
2024-12-10 17:18:24,116,1112,56,60,587.10,1173.00,0.00
2024-12-10 17:18:24,117,1112,57,60,582.09,1173.01,0.00
2024-12-10 17:18:24,116,1112,57,59,587.00,1173.01,0.00
2024-12-10 17:18:24,115,1112,57,58,591.61,1173.04,0.00
2024-12-10 17:18:24,114,1112,56,58,596.70,1173.04,0.00
2024-12-10 17:18:24,115,1111,56,59,588.59,1173.31,0.00
2024-12-10 17:18:24,115,1112,56,59,598.33,1174.00,0.00
2024-12-10 17:18:24,116,1112,56,60,593.17,1174.01,0.00
2024-12-10 17:18:24,115,1112,55,60,597.83,1174.04,0.00
2024-12-10 17:18:24,116,1111,56,60,586.00,1174.65,0.00
2024-12-10 17:18:24,117,1110,56,61,583.58,1174.76,0.00
2024-12-10 17:18:24,117,1111,56,61,603.56,1175.00,0.00
2024-12-10 17:18:24,118,1111,57,61,598.45,1175.01,0.00
2024-12-10 17:18:24,117,1111,56,61,603.07,1175.04,0.00
2024-12-10 17:18:24,117,1112,56,61,622.47,1176.00,0.00
2024-12-10 17:18:24,118,1112,57,61,617.20,1176.01,0.00
2024-12-10 17:18:24,117,1112,56,61,621.98,1176.04,0.00
2024-12-10 17:18:24,117,1113,56,61,621.29,1177.00,0.00
2024-12-10 17:18:24,118,1113,57,61,616.03,1177.01,0.00
2024-12-10 17:18:24,117,1113,56,61,620.80,1177.04,0.00
2024-12-10 17:18:24,117,1114,56,61,620.11,1178.00,0.00
2024-12-10 17:18:24,118,1114,57,61,614.85,1178.01,0.00
2024-12-10 17:18:24,117,1114,56,61,619.61,1178.04,0.00
2024-12-10 17:18:24,117,1115,56,61,618.92,1179.00,0.00
2024-12-10 17:18:24,118,1115,56,62,613.68,1179.01,0.00
2024-12-10 17:18:24,117,1115,55,62,618.43,1179.04,0.00
2024-12-10 17:18:24,117,1116,55,62,617.73,1180.00,0.00
2024-12-10 17:18:24,118,1116,56,62,612.50,1180.01,0.00
2024-12-10 17:18:24,117,1116,56,61,617.24,1180.04,0.00
2024-12-10 17:18:24,117,1117,56,61,616.54,1181.00,0.00
2024-12-10 17:18:24,118,1117,56,62,611.31,1181.01,0.00
2024-12-10 17:18:24,117,1117,56,61,616.04,1181.04,0.00
2024-12-10 17:18:24,117,1118,56,61,615.34,1182.00,0.00
2024-12-10 17:18:24,118,1118,56,62,610.13,1182.01,0.00
2024-12-10 17:18:24,117,1118,56,61,614.85,1182.04,0.00
2024-12-10 17:18:24,117,1119,56,61,614.15,1183.00,0.00
2024-12-10 17:18:24,118,1119,57,61,608.94,1183.01,0.00
2024-12-10 17:18:24,117,1119,57,60,613.65,1183.04,0.00
2024-12-10 17:18:24,117,1120,57,60,612.82,1184.00,0.00
2024-12-10 17:18:24,118,1120,58,60,607.62,1184.01,0.00
2024-12-10 17:18:24,117,1120,58,59,612.32,1184.04,0.00
2024-12-10 17:18:24,117,1121,58,59,611.58,1185.00,0.00
2024-12-10 17:18:24,118,1121,59,59,606.39,1185.01,0.00
2024-12-10 17:18:24,117,1121,59,58,611.08,1185.04,0.00
2024-12-10 17:18:24,117,1122,59,58,610.37,1186.00,0.00
2024-12-10 17:18:24,118,1122,59,59,605.20,1186.01,0.00
2024-12-10 17:18:24,117,1122,59,58,609.87,1186.04,0.00
2024-12-10 17:18:24,117,1123,59,58,609.16,1187.00,0.00
2024-12-10 17:18:24,118,1123,60,58,604.00,1187.01,0.00
2024-12-10 17:18:24,117,1123,60,57,608.66,1187.04,0.00
2024-12-10 17:18:24,117,1124,60,57,607.95,1188.00,0.00
2024-12-10 17:18:24,118,1124,60,58,602.79,1188.01,0.00
2024-12-10 17:18:24,117,1124,59,58,607.45,1188.04,0.00
2024-12-10 17:18:24,117,1125,59,58,606.73,1189.00,0.00
2024-12-10 17:18:24,118,1125,60,58,601.59,1189.01,0.00
2024-12-10 17:18:24,117,1125,60,57,606.23,1189.04,0.00
2024-12-10 17:18:24,117,1126,60,57,605.51,1190.00,0.00
2024-12-10 17:18:24,118,1126,60,58,600.38,1190.01,0.00
2024-12-10 17:18:24,117,1126,60,57,605.01,1190.04,0.00
2024-12-10 17:18:24,117,1127,60,57,604.29,1191.00,0.00
2024-12-10 17:18:24,118,1127,60,58,599.17,1191.01,0.00
2024-12-10 17:18:24,117,1127,59,58,603.79,1191.04,0.00
2024-12-10 17:18:24,117,1128,59,58,603.07,1192.00,0.00
2024-12-10 17:18:24,118,1128,60,58,597.95,1192.01,0.00
2024-12-10 17:18:24,117,1128,59,58,602.56,1192.04,0.00
2024-12-10 17:18:24,117,1129,59,58,601.84,1193.00,0.00
2024-12-10 17:18:24,118,1129,59,59,596.74,1193.01,0.00
2024-12-10 17:18:24,117,1129,58,59,601.74,1193.01,0.00
2024-12-10 17:18:24,116,1129,57,59,606.52,1193.03,0.00
2024-12-10 17:18:24,115,1129,57,58,611.69,1193.04,0.00
2024-12-10 17:18:24,116,1128,57,59,597.18,1193.85,0.00
2024-12-10 17:18:24,116,1129,57,59,607.61,1194.00,0.00
2024-12-10 17:18:24,117,1129,57,60,602.41,1194.01,0.00
2024-12-10 17:18:24,116,1129,56,60,607.20,1194.03,0.00
2024-12-10 17:18:24,116,1130,56,60,616.70,1195.00,0.00
2024-12-10 17:18:25,117,1130,56,61,611.43,1195.01,0.00
2024-12-10 17:18:25,116,1130,56,60,616.29,1195.03,0.00
2024-12-10 17:18:25,116,1131,56,60,615.45,1196.00,0.00
2024-12-10 17:18:25,117,1131,57,60,610.19,1196.01,0.00
2024-12-10 17:18:25,116,1131,56,60,615.05,1196.03,0.00
2024-12-10 17:18:25,116,1132,56,60,614.16,1197.00,0.00
2024-12-10 17:18:25,117,1132,57,60,608.91,1197.01,0.00
2024-12-10 17:18:25,116,1132,56,60,613.75,1197.03,0.00
2024-12-10 17:18:25,116,1133,56,60,612.81,1198.00,0.00
2024-12-10 17:18:25,117,1133,57,60,607.57,1198.01,0.00
2024-12-10 17:18:25,116,1133,56,60,612.40,1198.03,0.00
2024-12-10 17:18:25,116,1134,56,60,611.42,1199.00,0.00
2024-12-10 17:18:25,117,1134,57,60,606.19,1199.01,0.00
2024-12-10 17:18:25,116,1134,57,59,611.01,1199.03,0.00
2024-12-10 17:18:25,116,1135,57,59,610.00,1200.00,0.00
2024-12-10 17:18:25,117,1135,58,59,604.79,1200.01,0.00
2024-12-10 17:18:25,116,1135,57,59,609.59,1200.03,0.00
2024-12-10 17:18:25,116,1136,57,59,608.60,1201.00,0.00
2024-12-10 17:18:25,117,1136,57,60,603.40,1201.01,0.00
2024-12-10 17:18:25,116,1136,57,59,608.50,1201.01,0.00
2024-12-10 17:18:25,115,1136,56,59,613.48,1201.03,0.00
2024-12-10 17:18:25,116,1135,57,59,605.30,1201.27,0.00
2024-12-10 17:18:25,116,1136,57,59,615.09,1202.00,0.00
2024-12-10 17:18:25,117,1136,58,59,609.83,1202.01,0.00
2024-12-10 17:18:25,117,1137,58,59,618.75,1203.00,0.00
2024-12-10 17:18:25,118,1137,58,60,613.51,1203.01,0.00
2024-12-10 17:18:25,117,1137,58,59,618.12,1203.03,0.00
2024-12-10 17:18:25,116,1137,57,59,623.35,1203.03,0.00
2024-12-10 17:18:25,116,1138,57,59,622.61,1204.00,0.00
2024-12-10 17:18:25,117,1138,57,60,617.29,1204.01,0.00
2024-12-10 17:18:25,116,1138,57,59,621.97,1204.03,0.00
2024-12-10 17:18:25,116,1139,57,59,621.23,1205.00,0.00
2024-12-10 17:18:25,117,1139,58,59,615.92,1205.01,0.00
2024-12-10 17:18:25,116,1139,57,59,620.57,1205.03,0.00
2024-12-10 17:18:25,116,1140,57,59,619.60,1206.00,0.00
2024-12-10 17:18:25,117,1140,57,60,614.30,1206.01,0.00
2024-12-10 17:18:25,116,1140,56,60,618.92,1206.03,0.00
2024-12-10 17:18:25,116,1141,56,60,617.60,1207.00,0.00
2024-12-10 17:18:25,117,1141,57,60,612.33,1207.01,0.00
2024-12-10 17:18:25,116,1141,56,60,616.92,1207.03,0.00
2024-12-10 17:18:25,117,1140,56,61,600.95,1207.97,0.00
2024-12-10 17:18:25,117,1141,56,61,610.46,1208.00,0.00
2024-12-10 17:18:25,118,1141,56,62,605.29,1208.01,0.00
2024-12-10 17:18:25,117,1141,56,61,609.74,1208.03,0.00
2024-12-10 17:18:25,117,1142,56,61,617.49,1209.00,0.00
2024-12-10 17:18:25,118,1142,57,61,612.25,1209.01,0.00
2024-12-10 17:18:25,118,1143,57,61,608.38,1210.00,0.00
2024-12-10 17:18:25,119,1143,57,62,603.27,1210.01,0.00
2024-12-10 17:18:25,118,1143,56,62,607.38,1210.04,0.00
2024-12-10 17:18:25,118,1144,56,62,603.86,1211.00,0.00
2024-12-10 17:18:25,119,1144,57,62,598.78,1211.01,0.00
2024-12-10 17:18:25,118,1144,56,62,602.76,1211.04,0.00
2024-12-10 17:18:25,118,1145,56,62,598.93,1212.00,0.00
2024-12-10 17:18:25,119,1145,56,63,593.89,1212.01,0.00
2024-12-10 17:18:25,118,1145,55,63,597.70,1212.04,0.00
2024-12-10 17:18:25,117,1145,54,63,602.45,1212.07,0.00
2024-12-10 17:18:25,117,1146,54,63,598.62,1213.00,0.00
2024-12-10 17:18:25,118,1146,55,63,593.55,1213.01,0.00
2024-12-10 17:18:25,117,1146,55,62,597.71,1213.03,0.00
2024-12-10 17:18:25,118,1145,56,62,581.89,1213.92,0.00
2024-12-10 17:18:25,118,1146,56,62,589.37,1214.00,0.00
2024-12-10 17:18:25,119,1146,56,63,584.41,1214.01,0.00
2024-12-10 17:18:25,118,1146,55,63,589.26,1214.01,0.00
2024-12-10 17:18:25,117,1146,55,62,593.79,1214.04,0.00
2024-12-10 17:18:25,117,1147,55,62,599.91,1215.00,0.00
2024-12-10 17:18:25,118,1147,55,63,594.82,1215.01,0.00
2024-12-10 17:18:25,118,1148,55,63,590.11,1216.00,0.00
2024-12-10 17:18:25,119,1148,55,64,585.15,1216.01,0.00
2024-12-10 17:18:25,118,1148,54,64,589.60,1216.04,0.00
2024-12-10 17:18:25,119,1147,55,64,577.48,1216.66,0.00
2024-12-10 17:18:25,119,1148,55,64,584.33,1217.00,0.00
2024-12-10 17:18:25,120,1148,55,65,579.46,1217.01,0.00
2024-12-10 17:18:25,119,1148,54,65,583.82,1217.04,0.00
2024-12-10 17:18:25,119,1149,54,65,589.94,1218.00,0.00
2024-12-10 17:18:25,120,1149,55,65,585.02,1218.01,0.00
2024-12-10 17:18:25,119,1149,54,65,589.43,1218.04,0.00
2024-12-10 17:18:25,119,1150,54,65,585.61,1219.00,0.00
2024-12-10 17:18:25,120,1150,54,66,580.73,1219.01,0.00
2024-12-10 17:18:25,119,1150,54,65,585.11,1219.04,0.00
2024-12-10 17:18:25,120,1149,55,65,578.22,1219.23,0.00
2024-12-10 17:18:25,120,1150,55,65,581.12,1220.00,0.00
2024-12-10 17:18:25,121,1150,55,66,576.31,1220.01,0.00
2024-12-10 17:18:25,120,1150,54,66,580.61,1220.04,0.00
2024-12-10 17:18:25,121,1149,55,66,574.42,1220.17,0.00
2024-12-10 17:18:25,120,1149,55,65,579.99,1220.84,0.00
2024-12-10 17:18:25,120,1150,55,65,596.21,1221.00,0.00
2024-12-10 17:18:25,121,1150,55,66,591.28,1221.01,0.00
2024-12-10 17:18:25,120,1150,55,65,595.70,1221.04,0.00
2024-12-10 17:18:25,121,1149,56,65,588.00,1221.29,0.00
2024-12-10 17:18:25,121,1150,56,65,604.95,1222.00,0.00
2024-12-10 17:18:25,122,1150,56,66,599.99,1222.01,0.00
2024-12-10 17:18:25,121,1150,55,66,604.45,1222.04,0.00
2024-12-10 17:18:25,120,1150,55,65,609.39,1222.04,0.00
2024-12-10 17:18:25,120,1151,55,65,616.27,1223.00,0.00
2024-12-10 17:18:26,121,1151,55,66,611.18,1223.01,0.00
2024-12-10 17:18:26,120,1151,54,66,615.77,1223.04,0.00
2024-12-10 17:18:26,120,1152,54,66,612.35,1224.00,0.00
2024-12-10 17:18:26,121,1152,54,67,607.29,1224.01,0.00
2024-12-10 17:18:26,120,1152,54,66,611.85,1224.04,0.00
2024-12-10 17:18:26,119,1152,53,66,605.77,1224.86,0.00
2024-12-10 17:18:26,119,1153,53,66,614.20,1225.00,0.00
2024-12-10 17:18:26,120,1153,54,66,609.08,1225.01,0.00
2024-12-10 17:18:26,121,1152,55,66,602.65,1225.14,0.00
2024-12-10 17:18:26,122,1151,55,67,603.61,1225.42,0.00
2024-12-10 17:18:26,121,1151,55,66,609.88,1225.81,0.00
2024-12-10 17:18:26,121,1152,55,66,617.69,1226.00,0.00
2024-12-10 17:18:26,122,1152,55,67,612.63,1226.01,0.00
2024-12-10 17:18:26,121,1152,54,67,617.09,1226.05,0.00
2024-12-10 17:18:26,120,1152,54,66,619.92,1226.24,0.00
2024-12-10 17:18:26,120,1153,54,66,641.55,1227.00,0.00
2024-12-10 17:18:26,121,1153,54,67,636.25,1227.01,0.00
2024-12-10 17:18:26,120,1153,54,66,640.95,1227.05,0.00
2024-12-10 17:18:26,120,1154,54,66,639.67,1228.00,0.00
2024-12-10 17:18:26,121,1154,55,66,634.38,1228.01,0.00
2024-12-10 17:18:26,120,1154,55,65,639.26,1228.03,0.00
2024-12-10 17:18:26,119,1154,55,64,644.43,1228.04,0.00
2024-12-10 17:18:26,118,1154,55,63,649.79,1228.04,0.00
2024-12-10 17:18:26,118,1155,55,63,648.27,1229.00,0.00
2024-12-10 17:18:26,119,1155,56,63,642.82,1229.01,0.00
2024-12-10 17:18:26,118,1155,55,63,648.06,1229.02,0.00
2024-12-10 17:18:26,117,1155,55,62,653.30,1229.03,0.00
2024-12-10 17:18:26,116,1155,54,62,658.82,1229.03,0.00
2024-12-10 17:18:26,116,1156,54,62,657.00,1230.00,0.00
2024-12-10 17:18:26,117,1156,55,62,651.38,1230.01,0.00
2024-12-10 17:18:26,116,1156,55,61,656.58,1230.03,0.00
2024-12-10 17:18:26,116,1157,55,61,654.41,1231.00,0.00
2024-12-10 17:18:26,117,1157,55,62,648.82,1231.01,0.00
2024-12-10 17:18:26,118,1156,56,62,643.21,1231.03,0.00
2024-12-10 17:18:26,117,1156,56,61,655.46,1231.04,0.00
2024-12-10 17:18:26,118,1155,56,62,639.44,1231.81,0.00
2024-12-10 17:18:26,118,1156,56,62,649.43,1232.00,0.00
2024-12-10 17:18:26,119,1156,57,62,643.97,1232.01,0.00
2024-12-10 17:18:26,120,1155,57,63,631.35,1232.63,0.00
2024-12-10 17:18:26,120,1156,57,63,660.06,1233.00,0.00
2024-12-10 17:18:26,121,1156,58,63,654.60,1233.01,0.00
2024-12-10 17:18:26,120,1156,57,63,659.96,1233.01,0.00
2024-12-10 17:18:26,119,1156,57,62,665.01,1233.04,0.00
2024-12-10 17:18:26,118,1156,57,61,668.83,1233.19,0.00
2024-12-10 17:18:26,119,1155,57,62,655.67,1233.72,0.00
2024-12-10 17:18:26,119,1156,57,62,682.92,1234.00,0.00
2024-12-10 17:18:26,120,1156,58,62,677.23,1234.01,0.00
2024-12-10 17:18:26,120,1157,58,62,684.63,1235.00,0.00
2024-12-10 17:18:26,121,1157,59,62,678.97,1235.01,0.00
2024-12-10 17:18:26,120,1157,59,61,684.04,1235.05,0.00
2024-12-10 17:18:26,121,1156,59,62,676.28,1235.24,0.00
2024-12-10 17:18:26,122,1155,59,63,673.13,1235.65,0.00
2024-12-10 17:18:26,122,1156,59,63,681.73,1236.00,0.00
2024-12-10 17:18:26,123,1156,60,63,676.19,1236.01,0.00
2024-12-10 17:18:26,124,1155,61,63,663.60,1236.62,0.00
2024-12-10 17:18:26,124,1156,61,63,695.92,1237.00,0.00
2024-12-10 17:18:26,125,1156,61,64,690.36,1237.01,0.00
2024-12-10 17:18:26,124,1156,61,63,695.26,1237.06,0.00
2024-12-10 17:18:26,124,1157,61,63,701.92,1238.00,0.00
2024-12-10 17:18:26,125,1157,62,63,696.30,1238.01,0.00
2024-12-10 17:18:26,124,1157,61,63,701.25,1238.06,0.00
2024-12-10 17:18:26,124,1158,61,63,697.76,1239.00,0.00
2024-12-10 17:18:26,125,1158,61,64,692.18,1239.01,0.00
2024-12-10 17:18:26,124,1158,60,64,697.09,1239.06,0.00
2024-12-10 17:18:26,124,1159,60,64,693.12,1240.00,0.00
2024-12-10 17:18:26,125,1159,61,64,687.57,1240.01,0.00
2024-12-10 17:18:26,124,1159,61,63,692.45,1240.06,0.00
2024-12-10 17:18:26,125,1158,62,63,675.29,1240.78,0.00
2024-12-10 17:18:26,125,1159,62,63,684.25,1241.00,0.00
2024-12-10 17:18:26,126,1159,63,63,678.82,1241.01,0.00
2024-12-10 17:18:26,125,1159,63,62,683.59,1241.06,0.00
2024-12-10 17:18:26,125,1160,63,62,688.27,1242.00,0.00
2024-12-10 17:18:26,126,1160,64,62,682.81,1242.01,0.00
2024-12-10 17:18:26,125,1160,63,62,687.60,1242.06,0.00
2024-12-10 17:18:26,125,1161,63,62,682.88,1243.00,0.00
2024-12-10 17:18:26,126,1161,63,63,677.46,1243.01,0.00
2024-12-10 17:18:26,125,1161,62,63,682.22,1243.06,0.00
2024-12-10 17:18:26,125,1162,62,63,677.78,1244.00,0.00
2024-12-10 17:18:26,126,1162,63,63,672.40,1244.01,0.00
2024-12-10 17:18:26,125,1162,62,63,677.12,1244.06,0.00
2024-12-10 17:18:26,125,1163,62,63,672.51,1245.00,0.00
2024-12-10 17:18:26,126,1163,62,64,667.17,1245.01,0.00
2024-12-10 17:18:26,125,1163,62,63,671.84,1245.06,0.00
2024-12-10 17:18:26,124,1163,61,63,670.85,1245.53,0.00
2024-12-10 17:18:26,123,1163,60,63,675.82,1245.58,0.00
2024-12-10 17:18:26,123,1164,60,63,680.21,1246.00,0.00
2024-12-10 17:18:26,124,1164,61,63,674.72,1246.01,0.00
2024-12-10 17:18:26,123,1164,61,62,679.73,1246.04,0.00
2024-12-10 17:18:26,123,1165,61,62,677.14,1247.00,0.00
2024-12-10 17:18:26,124,1165,61,63,671.68,1247.01,0.00
2024-12-10 17:18:26,123,1165,60,63,676.47,1247.06,0.00
2024-12-10 17:18:26,123,1166,60,63,673.96,1248.00,0.00
2024-12-10 17:18:26,124,1166,60,64,668.53,1248.01,0.00
2024-12-10 17:18:27,124,1167,60,64,665.17,1249.00,0.00
2024-12-10 17:18:27,125,1167,60,65,659.85,1249.01,0.00
2024-12-10 17:18:27,124,1167,60,64,664.40,1249.07,0.00
2024-12-10 17:18:27,123,1167,59,64,665.76,1249.30,0.00
2024-12-10 17:18:27,123,1168,59,64,667.05,1250.00,0.00
2024-12-10 17:18:27,124,1168,60,64,661.67,1250.01,0.00
2024-12-10 17:18:27,123,1168,59,64,666.27,1250.07,0.00
2024-12-10 17:18:27,123,1169,59,64,664.76,1251.00,0.00
2024-12-10 17:18:27,124,1169,60,64,659.39,1251.01,0.00
2024-12-10 17:18:27,125,1168,60,65,652.36,1251.17,0.00
2024-12-10 17:18:27,126,1167,61,65,650.56,1251.59,0.00
2024-12-10 17:18:27,126,1168,61,65,663.60,1252.00,0.00
2024-12-10 17:18:27,127,1168,62,65,658.37,1252.01,0.00
2024-12-10 17:18:27,126,1168,61,65,662.84,1252.06,0.00
2024-12-10 17:18:27,126,1169,61,65,681.16,1253.00,0.00
2024-12-10 17:18:27,127,1169,61,66,675.79,1253.01,0.00
2024-12-10 17:18:27,126,1169,61,65,680.40,1253.06,0.00
2024-12-10 17:18:27,125,1169,61,64,679.74,1253.54,0.00
2024-12-10 17:18:27,125,1170,61,64,683.94,1254.00,0.00
2024-12-10 17:18:27,126,1170,62,64,678.52,1254.01,0.00
2024-12-10 17:18:27,125,1170,62,63,683.18,1254.06,0.00
2024-12-10 17:18:27,125,1171,62,63,681.61,1255.00,0.00
2024-12-10 17:18:27,126,1171,62,64,676.20,1255.01,0.00
2024-12-10 17:18:27,125,1171,62,63,680.84,1255.06,0.00
2024-12-10 17:18:27,125,1172,62,63,679.46,1256.00,0.00
2024-12-10 17:18:27,126,1172,62,64,674.07,1256.01,0.00
2024-12-10 17:18:27,125,1172,61,64,678.69,1256.06,0.00
2024-12-10 17:18:27,124,1172,61,63,679.07,1256.48,0.00
2024-12-10 17:18:27,125,1171,61,64,670.96,1256.71,0.00
2024-12-10 17:18:27,125,1172,61,64,679.93,1257.00,0.00
2024-12-10 17:18:27,126,1172,62,64,674.54,1257.01,0.00
2024-12-10 17:18:27,125,1172,61,64,679.16,1257.06,0.00
2024-12-10 17:18:27,125,1173,61,64,687.58,1258.00,0.00
2024-12-10 17:18:27,126,1173,62,64,682.12,1258.01,0.00
2024-12-10 17:18:27,126,1174,62,64,679.79,1259.00,0.00
2024-12-10 17:18:27,127,1174,62,65,674.43,1259.01,0.00
2024-12-10 17:18:27,126,1174,62,64,678.92,1259.07,0.00
2024-12-10 17:18:27,127,1173,63,64,670.45,1259.34,0.00
2024-12-10 17:18:27,127,1174,63,64,679.06,1260.00,0.00
2024-12-10 17:18:27,128,1174,64,64,673.76,1260.01,0.00
2024-12-10 17:18:27,127,1174,63,64,678.20,1260.07,0.00
2024-12-10 17:18:27,127,1175,63,64,686.22,1261.00,0.00
2024-12-10 17:18:27,128,1175,63,65,680.86,1261.01,0.00
2024-12-10 17:18:27,127,1175,63,64,685.36,1261.07,0.00
2024-12-10 17:18:27,126,1175,63,63,685.90,1261.47,0.00
2024-12-10 17:18:27,126,1176,63,63,689.06,1262.00,0.00
2024-12-10 17:18:27,127,1176,63,64,683.63,1262.01,0.00
2024-12-10 17:18:27,126,1176,63,63,688.19,1262.07,0.00
2024-12-10 17:18:27,126,1177,63,63,686.88,1263.00,0.00
2024-12-10 17:18:27,127,1177,63,64,681.47,1263.01,0.00
2024-12-10 17:18:27,127,1178,63,64,679.42,1264.00,0.00
2024-12-10 17:18:27,128,1178,63,65,674.12,1264.01,0.00
2024-12-10 17:18:27,127,1178,63,64,678.37,1264.09,0.00
2024-12-10 17:18:27,127,1179,63,64,677.27,1265.00,0.00
2024-12-10 17:18:27,128,1179,63,65,671.98,1265.01,0.00
2024-12-10 17:18:27,127,1179,62,65,676.22,1265.09,0.00
2024-12-10 17:18:27,127,1180,62,65,675.10,1266.00,0.00
2024-12-10 17:18:27,128,1180,63,65,669.83,1266.01,0.00
2024-12-10 17:18:27,129,1179,63,66,664.63,1266.02,0.00
2024-12-10 17:18:27,128,1179,63,65,672.24,1266.09,0.00
2024-12-10 17:18:27,128,1180,63,65,670.72,1267.00,0.00
2024-12-10 17:18:27,129,1180,63,66,665.52,1267.01,0.00
2024-12-10 17:18:27,128,1180,63,65,669.68,1267.09,0.00
2024-12-10 17:18:27,128,1181,63,65,677.84,1268.00,0.00
2024-12-10 17:18:27,129,1181,63,66,672.59,1268.01,0.00
2024-12-10 17:18:27,128,1181,63,65,676.79,1268.09,0.00
2024-12-10 17:18:27,128,1182,63,65,674.92,1269.00,0.00
2024-12-10 17:18:27,129,1182,64,65,669.69,1269.01,0.00
2024-12-10 17:18:27,128,1182,64,64,673.87,1269.09,0.00
2024-12-10 17:18:27,127,1182,64,63,679.08,1269.09,0.00
2024-12-10 17:18:27,127,1183,64,63,677.08,1270.00,0.00
2024-12-10 17:18:27,128,1183,64,64,671.79,1270.01,0.00
2024-12-10 17:18:27,127,1183,64,63,676.02,1270.09,0.00
2024-12-10 17:18:27,127,1184,64,63,674.11,1271.00,0.00
2024-12-10 17:18:27,128,1184,65,63,668.84,1271.01,0.00
2024-12-10 17:18:27,127,1184,65,62,673.05,1271.09,0.00
2024-12-10 17:18:27,126,1184,65,61,676.99,1271.18,0.00
2024-12-10 17:18:27,126,1185,65,61,677.04,1272.00,0.00
2024-12-10 17:18:27,127,1185,65,62,671.71,1272.01,0.00
2024-12-10 17:18:27,126,1185,64,62,675.97,1272.09,0.00
2024-12-10 17:18:27,126,1186,64,62,674.95,1273.00,0.00
2024-12-10 17:18:27,127,1186,64,63,669.63,1273.01,0.00
2024-12-10 17:18:27,126,1186,63,63,673.87,1273.09,0.00
2024-12-10 17:18:27,125,1186,63,62,679.16,1273.09,0.00
2024-12-10 17:18:27,125,1187,63,62,678.23,1274.00,0.00
2024-12-10 17:18:27,126,1187,63,63,672.85,1274.01,0.00
2024-12-10 17:18:27,125,1187,62,63,677.54,1274.06,0.00
2024-12-10 17:18:27,124,1187,62,62,682.61,1274.08,0.00
2024-12-10 17:18:27,123,1187,61,62,688.05,1274.08,0.00
2024-12-10 17:18:27,122,1187,61,61,693.59,1274.08,0.00
2024-12-10 17:18:27,122,1188,61,61,692.84,1275.00,0.00
2024-12-10 17:18:27,123,1188,61,62,687.21,1275.01,0.00
2024-12-10 17:18:27,123,1189,61,62,685.46,1276.00,0.00
2024-12-10 17:18:27,124,1189,61,63,679.94,1276.01,0.00
2024-12-10 17:18:27,123,1189,60,63,684.47,1276.08,0.00
2024-12-10 17:18:27,122,1189,59,63,690.04,1276.08,0.00
2024-12-10 17:18:28,122,1190,59,63,689.28,1277.00,0.00
2024-12-10 17:18:28,123,1190,59,64,683.68,1277.01,0.00
2024-12-10 17:18:28,122,1190,58,64,688.14,1277.10,0.00
2024-12-10 17:18:28,122,1191,58,64,687.59,1278.00,0.00
2024-12-10 17:18:28,123,1191,59,64,682.00,1278.01,0.00
2024-12-10 17:18:28,123,1192,59,64,680.25,1279.00,0.00
2024-12-10 17:18:28,124,1192,60,64,674.76,1279.01,0.00
2024-12-10 17:18:28,123,1192,60,63,679.14,1279.09,0.00
2024-12-10 17:18:28,123,1193,60,63,678.35,1280.00,0.00
2024-12-10 17:18:28,124,1193,61,63,672.88,1280.01,0.00
2024-12-10 17:18:28,124,1194,61,63,670.85,1281.00,0.00
2024-12-10 17:18:28,125,1194,61,64,665.48,1281.01,0.00
2024-12-10 17:18:28,124,1194,61,63,669.75,1281.09,0.00
2024-12-10 17:18:28,125,1193,61,64,659.16,1281.50,0.00
2024-12-10 17:18:28,125,1194,61,64,668.44,1282.00,0.00
2024-12-10 17:18:28,126,1194,62,64,663.14,1282.01,0.00
2024-12-10 17:18:28,126,1195,62,64,670.95,1283.00,0.00
2024-12-10 17:18:28,127,1195,62,65,665.66,1283.01,0.00
2024-12-10 17:18:28,126,1195,61,65,669.86,1283.09,0.00
2024-12-10 17:18:28,125,1195,61,64,672.93,1283.26,0.00
2024-12-10 17:18:28,125,1196,61,64,674.05,1284.00,0.00
2024-12-10 17:18:28,126,1196,61,65,668.70,1284.01,0.00
2024-12-10 17:18:28,125,1196,60,65,672.95,1284.09,0.00
2024-12-10 17:18:28,125,1197,60,65,671.90,1285.00,0.00
2024-12-10 17:18:28,126,1197,61,65,666.57,1285.01,0.00
2024-12-10 17:18:28,125,1197,60,65,670.81,1285.09,0.00
2024-12-10 17:18:28,125,1198,60,65,669.72,1286.00,0.00
2024-12-10 17:18:28,126,1198,60,66,664.40,1286.01,0.00
2024-12-10 17:18:28,125,1198,60,65,668.62,1286.09,0.00
2024-12-10 17:18:28,125,1199,60,65,667.51,1287.00,0.00
2024-12-10 17:18:28,126,1199,61,65,662.21,1287.01,0.00
2024-12-10 17:18:28,125,1199,60,65,666.41,1287.09,0.00
2024-12-10 17:18:28,125,1200,60,65,665.29,1288.00,0.00
2024-12-10 17:18:28,126,1200,60,66,660.01,1288.01,0.00
2024-12-10 17:18:28,125,1200,59,66,658.52,1288.54,0.00
2024-12-10 17:18:28,125,1201,59,66,663.18,1289.00,0.00
2024-12-10 17:18:28,126,1201,60,66,657.92,1289.01,0.00
2024-12-10 17:18:28,125,1201,59,66,661.98,1289.10,0.00
2024-12-10 17:18:28,125,1202,59,66,661.01,1290.00,0.00
2024-12-10 17:18:28,126,1202,59,67,655.76,1290.01,0.00
2024-12-10 17:18:28,125,1202,59,66,659.81,1290.10,0.00
2024-12-10 17:18:28,124,1202,58,66,663.54,1290.22,0.00
2024-12-10 17:18:28,125,1201,59,66,655.72,1290.43,0.00
2024-12-10 17:18:28,125,1202,59,66,665.09,1291.00,0.00
2024-12-10 17:18:28,126,1202,59,67,659.82,1291.01,0.00
2024-12-10 17:18:28,125,1202,59,66,663.89,1291.10,0.00
2024-12-10 17:18:28,125,1203,59,66,673.36,1292.00,0.00
2024-12-10 17:18:28,126,1203,60,66,668.02,1292.01,0.00
2024-12-10 17:18:28,125,1203,59,66,672.15,1292.10,0.00
2024-12-10 17:18:28,124,1203,59,65,674.25,1292.36,0.00
2024-12-10 17:18:28,125,1202,60,65,664.87,1292.68,0.00
2024-12-10 17:18:28,125,1203,60,65,674.96,1293.00,0.00
2024-12-10 17:18:28,126,1203,60,66,669.60,1293.01,0.00
2024-12-10 17:18:28,125,1203,60,65,673.75,1293.10,0.00
2024-12-10 17:18:28,124,1203,60,64,679.08,1293.10,0.00
2024-12-10 17:18:28,125,1202,61,64,670.70,1293.34,0.00
2024-12-10 17:18:28,125,1203,61,64,690.01,1294.00,0.00
2024-12-10 17:18:28,126,1203,61,65,684.54,1294.01,0.00
2024-12-10 17:18:28,125,1203,61,64,688.80,1294.10,0.00
2024-12-10 17:18:28,125,1204,61,64,697.91,1295.00,0.00
2024-12-10 17:18:28,126,1204,61,65,692.37,1295.01,0.00
2024-12-10 17:18:28,126,1205,61,65,689.83,1296.00,0.00
2024-12-10 17:18:28,127,1205,62,65,684.40,1296.01,0.00
2024-12-10 17:18:28,126,1205,61,65,688.53,1296.10,0.00
2024-12-10 17:18:28,126,1206,61,65,687.08,1297.00,0.00
2024-12-10 17:18:28,127,1206,62,65,681.67,1297.01,0.00
2024-12-10 17:18:28,126,1206,61,65,685.77,1297.10,0.00
2024-12-10 17:18:28,126,1207,61,65,684.26,1298.00,0.00
2024-12-10 17:18:28,127,1207,62,65,678.87,1298.01,0.00
2024-12-10 17:18:28,126,1207,61,65,682.95,1298.10,0.00
2024-12-10 17:18:28,126,1208,61,65,681.36,1299.00,0.00
2024-12-10 17:18:28,127,1208,61,66,676.00,1299.01,0.00
2024-12-10 17:18:28,126,1208,60,66,680.05,1299.10,0.00
2024-12-10 17:18:28,126,1209,60,66,678.44,1300.00,0.00
2024-12-10 17:18:28,127,1209,60,67,673.10,1300.01,0.00
2024-12-10 17:18:28,126,1209,59,67,676.92,1300.13,0.00
2024-12-10 17:18:28,126,1210,59,67,675.60,1301.00,0.00
2024-12-10 17:18:28,127,1210,59,68,670.28,1301.01,0.00
2024-12-10 17:18:28,126,1210,58,68,675.40,1301.02,0.00
2024-12-10 17:18:28,125,1210,57,68,679.58,1301.10,0.00
2024-12-10 17:18:28,124,1210,57,67,679.13,1301.54,0.00
2024-12-10 17:18:28,124,1211,57,67,683.99,1302.00,0.00
2024-12-10 17:18:28,125,1211,58,67,678.51,1302.01,0.00
2024-12-10 17:18:28,125,1212,58,67,676.53,1303.00,0.00
2024-12-10 17:18:28,126,1212,58,68,671.16,1303.01,0.00
2024-12-10 17:18:28,126,1213,58,68,669.09,1304.00,0.00
2024-12-10 17:18:28,127,1213,59,68,663.82,1304.01,0.00
2024-12-10 17:18:28,127,1214,59,68,661.66,1305.00,0.00
2024-12-10 17:18:28,128,1214,59,69,656.49,1305.01,0.00
2024-12-10 17:18:28,128,1215,59,69,654.24,1306.00,0.00
2024-12-10 17:18:28,129,1215,59,70,649.17,1306.01,0.00
2024-12-10 17:18:29,129,1216,59,70,646.83,1307.00,0.00
2024-12-10 17:18:29,130,1216,59,71,641.85,1307.01,0.00
2024-12-10 17:18:29,129,1216,58,71,645.54,1307.10,0.00
2024-12-10 17:18:29,129,1217,58,71,644.38,1308.00,0.00
2024-12-10 17:18:29,130,1217,58,72,639.43,1308.01,0.00
2024-12-10 17:18:29,131,1216,58,73,628.09,1308.53,0.00
2024-12-10 17:18:29,131,1217,58,73,637.73,1309.00,0.00
2024-12-10 17:18:29,132,1217,58,74,632.90,1309.01,0.00
2024-12-10 17:18:29,132,1218,58,74,640.23,1310.00,0.00
2024-12-10 17:18:29,133,1218,59,74,635.41,1310.01,0.00
2024-12-10 17:18:29,133,1219,59,74,632.53,1311.00,0.00
2024-12-10 17:18:29,134,1219,59,75,627.81,1311.01,0.00
2024-12-10 17:18:29,134,1220,59,75,620.47,1312.00,0.00
2024-12-10 17:18:29,135,1220,59,76,615.87,1312.01,0.00
2024-12-10 17:18:29,134,1220,59,75,610.60,1312.68,0.00
2024-12-10 17:18:29,134,1221,59,75,616.44,1313.00,0.00
2024-12-10 17:18:29,135,1221,59,76,611.87,1313.01,0.00
2024-12-10 17:18:29,134,1221,58,76,614.99,1313.11,0.00
2024-12-10 17:18:29,134,1222,58,76,610.29,1314.00,0.00
2024-12-10 17:18:29,135,1222,58,77,605.77,1314.01,0.00
2024-12-10 17:18:29,134,1222,58,76,609.10,1314.10,0.00
2024-12-10 17:18:29,133,1222,58,75,601.80,1314.74,0.00
2024-12-10 17:18:29,133,1223,58,75,608.54,1315.00,0.00
2024-12-10 17:18:29,134,1223,59,75,604.00,1315.01,0.00
2024-12-10 17:18:29,133,1223,59,74,607.08,1315.11,0.00
2024-12-10 17:18:29,133,1224,59,74,605.74,1316.00,0.00
2024-12-10 17:18:29,134,1224,60,74,601.22,1316.01,0.00
2024-12-10 17:18:29,133,1224,59,74,604.86,1316.07,0.00
2024-12-10 17:18:29,132,1224,59,73,608.85,1316.11,0.00
2024-12-10 17:18:29,131,1224,58,73,613.40,1316.11,0.00
2024-12-10 17:18:29,131,1225,58,73,612.13,1317.00,0.00
2024-12-10 17:18:29,132,1225,59,73,607.50,1317.01,0.00
2024-12-10 17:18:29,131,1225,59,72,610.75,1317.11,0.00
2024-12-10 17:18:29,131,1226,59,72,609.48,1318.00,0.00
2024-12-10 17:18:29,132,1226,60,72,604.86,1318.01,0.00
2024-12-10 17:18:29,131,1226,59,72,608.09,1318.11,0.00
2024-12-10 17:18:29,131,1227,59,72,606.82,1319.00,0.00
2024-12-10 17:18:29,132,1227,60,72,602.22,1319.01,0.00
2024-12-10 17:18:29,131,1227,59,72,606.42,1319.03,0.00
2024-12-10 17:18:29,130,1227,59,71,610.09,1319.10,0.00
2024-12-10 17:18:29,129,1227,58,71,614.71,1319.10,0.00
2024-12-10 17:18:29,129,1228,58,71,613.53,1320.00,0.00
2024-12-10 17:18:29,130,1228,58,72,608.81,1320.01,0.00
2024-12-10 17:18:29,129,1228,57,72,613.32,1320.02,0.00
2024-12-10 17:18:29,128,1228,57,71,616.99,1320.09,0.00
2024-12-10 17:18:29,127,1228,56,71,621.75,1320.09,0.00
2024-12-10 17:18:29,127,1229,56,71,620.64,1321.00,0.00
2024-12-10 17:18:29,128,1229,56,72,615.79,1321.01,0.00
2024-12-10 17:18:29,127,1229,55,72,620.33,1321.02,0.00
2024-12-10 17:18:29,126,1229,55,71,624.33,1321.09,0.00
2024-12-10 17:18:29,126,1230,55,71,622.95,1322.00,0.00
2024-12-10 17:18:29,127,1230,55,72,618.04,1322.01,0.00
2024-12-10 17:18:29,126,1230,55,71,621.71,1322.10,0.00
2024-12-10 17:18:29,126,1231,55,71,618.85,1323.00,0.00
2024-12-10 17:18:29,127,1231,56,71,613.97,1323.01,0.00
2024-12-10 17:18:29,126,1231,56,70,617.60,1323.10,0.00
2024-12-10 17:18:29,126,1232,56,70,613.76,1324.00,0.00
2024-12-10 17:18:29,127,1232,56,71,608.92,1324.01,0.00
2024-12-10 17:18:29,126,1232,56,70,612.51,1324.10,0.00
2024-12-10 17:18:29,125,1232,55,70,606.31,1324.65,0.00
2024-12-10 17:18:29,125,1233,55,70,612.52,1325.00,0.00
2024-12-10 17:18:29,126,1233,56,70,607.66,1325.01,0.00
2024-12-10 17:18:29,125,1233,55,70,612.31,1325.02,0.00
2024-12-10 17:18:29,124,1233,55,69,616.93,1325.03,0.00
2024-12-10 17:18:29,123,1233,54,69,621.20,1325.08,0.00
2024-12-10 17:18:29,122,1233,54,68,620.12,1325.46,0.00
2024-12-10 17:18:29,122,1234,54,68,624.18,1326.00,0.00
2024-12-10 17:18:29,123,1234,55,68,619.10,1326.01,0.00
2024-12-10 17:18:29,122,1234,55,67,623.00,1326.09,0.00
2024-12-10 17:18:29,122,1235,55,67,619.81,1327.00,0.00
2024-12-10 17:18:29,123,1235,55,68,614.77,1327.01,0.00
2024-12-10 17:18:29,122,1235,55,67,618.63,1327.09,0.00
2024-12-10 17:18:29,121,1235,55,66,615.03,1327.55,0.00
2024-12-10 17:18:29,121,1236,55,66,620.30,1328.00,0.00
2024-12-10 17:18:29,122,1236,55,67,615.21,1328.01,0.00
2024-12-10 17:18:29,121,1236,54,67,619.11,1328.09,0.00
2024-12-10 17:18:29,121,1237,54,67,618.46,1329.00,0.00
2024-12-10 17:18:29,122,1237,55,67,613.39,1329.01,0.00
2024-12-10 17:18:29,122,1238,55,67,611.56,1330.00,0.00
2024-12-10 17:18:29,123,1238,56,67,606.59,1330.01,0.00
2024-12-10 17:18:29,124,1237,56,68,597.45,1330.35,0.00
2024-12-10 17:18:29,124,1238,56,68,609.61,1331.00,0.00
2024-12-10 17:18:29,125,1238,56,69,604.74,1331.01,0.00
2024-12-10 17:18:29,124,1238,56,68,608.76,1331.07,0.00
2024-12-10 17:18:29,123,1238,55,68,613.08,1331.11,0.00
2024-12-10 17:18:29,122,1238,55,67,618.00,1331.11,0.00
2024-12-10 17:18:29,122,1239,55,67,625.41,1332.00,0.00
2024-12-10 17:18:29,123,1239,55,68,620.32,1332.01,0.00
2024-12-10 17:18:29,122,1239,55,67,624.87,1332.04,0.00
2024-12-10 17:18:29,121,1239,54,67,629.17,1332.10,0.00
2024-12-10 17:18:29,120,1239,54,66,634.30,1332.10,0.00
2024-12-10 17:18:29,121,1238,54,67,612.95,1332.85,0.00
2024-12-10 17:18:29,121,1239,54,67,623.99,1333.00,0.00
2024-12-10 17:18:29,122,1239,54,68,618.88,1333.01,0.00
2024-12-10 17:18:29,121,1239,53,68,622.70,1333.10,0.00
2024-12-10 17:18:29,120,1239,53,67,627.83,1333.10,0.00
2024-12-10 17:18:29,119,1239,52,67,620.64,1333.59,0.00
2024-12-10 17:18:29,119,1240,52,67,635.07,1334.00,0.00
2024-12-10 17:18:29,120,1240,52,68,629.77,1334.01,0.00
2024-12-10 17:18:29,119,1240,51,68,633.74,1334.10,0.00
2024-12-10 17:18:29,118,1240,50,68,636.47,1334.28,0.00
2024-12-10 17:18:29,117,1240,49,68,629.50,1334.79,0.00
2024-12-10 17:18:29,117,1241,49,68,638.24,1335.00,0.00
2024-12-10 17:18:29,118,1241,50,68,632.83,1335.01,0.00
2024-12-10 17:18:29,117,1241,50,67,638.02,1335.02,0.00
2024-12-10 17:18:29,116,1241,50,66,643.17,1335.03,0.00
2024-12-10 17:18:30,115,1241,49,66,647.97,1335.09,0.00
2024-12-10 17:18:30,114,1241,49,65,653.54,1335.09,0.00
2024-12-10 17:18:30,113,1241,49,64,659.20,1335.09,0.00
2024-12-10 17:18:30,113,1242,49,64,659.32,1336.00,0.00
2024-12-10 17:18:30,114,1242,50,64,653.54,1336.01,0.00
2024-12-10 17:18:30,113,1242,49,64,658.16,1336.09,0.00
2024-12-10 17:18:30,113,1243,49,64,656.38,1337.00,0.00
2024-12-10 17:18:30,114,1243,49,65,650.62,1337.01,0.00
2024-12-10 17:18:30,113,1243,49,64,655.22,1337.09,0.00
2024-12-10 17:18:30,114,1242,49,65,646.69,1337.32,0.00
2024-12-10 17:18:30,113,1242,48,65,658.69,1337.32,0.00
2024-12-10 17:18:30,112,1242,47,65,653.99,1337.68,0.00
2024-12-10 17:18:30,112,1243,47,65,661.90,1338.00,0.00
2024-12-10 17:18:30,113,1243,48,65,656.04,1338.01,0.00
2024-12-10 17:18:30,112,1243,47,65,660.73,1338.09,0.00
2024-12-10 17:18:30,112,1244,47,65,668.89,1339.00,0.00
2024-12-10 17:18:30,113,1244,47,66,662.97,1339.01,0.00
2024-12-10 17:18:30,112,1244,47,65,665.30,1339.09,0.00
2024-12-10 17:18:30,113,1243,48,65,655.80,1339.38,0.00
2024-12-10 17:18:30,112,1243,47,65,663.65,1339.63,0.00
2024-12-10 17:18:30,112,1244,47,65,670.66,1340.00,0.00
2024-12-10 17:18:30,113,1244,47,66,664.73,1340.01,0.00
2024-12-10 17:18:30,112,1244,46,66,670.07,1340.05,0.00
2024-12-10 17:18:30,111,1244,45,66,673.24,1340.06,0.00
2024-12-10 17:18:30,110,1244,44,66,679.12,1340.07,0.00
2024-12-10 17:18:30,109,1244,43,66,685.22,1340.07,0.00
2024-12-10 17:18:30,109,1245,43,66,693.56,1341.00,0.00
2024-12-10 17:18:30,110,1245,44,66,687.26,1341.01,0.00
2024-12-10 17:18:30,109,1245,43,66,692.59,1341.07,0.00
2024-12-10 17:18:30,108,1245,43,65,681.20,1341.89,0.00
2024-12-10 17:18:30,108,1246,43,65,692.23,1342.00,0.00
2024-12-10 17:18:30,109,1246,44,65,685.88,1342.01,0.00
2024-12-10 17:18:30,108,1246,43,65,691.25,1342.07,0.00
2024-12-10 17:18:30,109,1245,43,66,683.69,1342.18,0.00
2024-12-10 17:18:30,109,1246,43,66,694.80,1343.00,0.00
2024-12-10 17:18:30,110,1246,44,66,688.48,1343.01,0.00
2024-12-10 17:18:30,109,1246,44,65,691.28,1343.07,0.00
2024-12-10 17:18:30,109,1247,44,65,695.89,1344.00,0.00
2024-12-10 17:18:30,110,1247,44,66,689.57,1344.01,0.00
2024-12-10 17:18:30,109,1247,44,65,695.61,1344.01,0.00
2024-12-10 17:18:30,108,1247,43,65,701.19,1344.07,0.00
2024-12-10 17:18:30,109,1246,43,66,691.47,1344.28,0.00
2024-12-10 17:18:30,108,1246,42,66,698.52,1344.55,0.00
2024-12-10 17:18:30,107,1246,42,65,699.48,1344.77,0.00
2024-12-10 17:18:30,107,1247,42,65,694.41,1345.00,0.00
2024-12-10 17:18:30,108,1247,43,65,687.98,1345.01,0.00
2024-12-10 17:18:30,107,1247,43,64,693.54,1345.07,0.00
2024-12-10 17:18:30,106,1247,43,63,696.45,1345.22,0.00
2024-12-10 17:18:30,105,1247,43,62,692.57,1345.55,0.00
2024-12-10 17:18:30,104,1247,42,62,690.39,1345.81,0.00
2024-12-10 17:18:30,103,1247,42,61,690.90,1345.85,0.00
2024-12-10 17:18:30,103,1248,42,61,692.20,1346.00,0.00
2024-12-10 17:18:30,104,1248,42,62,685.54,1346.01,0.00
2024-12-10 17:18:30,103,1248,41,62,691.30,1346.07,0.00
2024-12-10 17:18:30,102,1248,41,61,683.95,1346.91,0.00
2024-12-10 17:18:30,101,1248,40,61,687.76,1346.97,0.00
2024-12-10 17:18:30,100,1248,40,60,689.59,1346.98,0.00
2024-12-10 17:18:30,100,1249,40,60,702.80,1347.00,0.00
2024-12-10 17:18:30,101,1249,40,61,695.84,1347.01,0.00
2024-12-10 17:18:30,100,1249,40,60,701.87,1347.07,0.00
2024-12-10 17:18:30,100,1250,40,60,698.64,1348.00,0.00
2024-12-10 17:18:30,101,1250,41,60,691.72,1348.01,0.00
2024-12-10 17:18:30,100,1250,41,59,697.71,1348.07,0.00
2024-12-10 17:18:30,100,1251,41,59,684.08,1349.00,0.00
2024-12-10 17:18:30,101,1251,42,59,677.31,1349.01,0.00
2024-12-10 17:18:30,100,1251,42,58,683.15,1349.07,0.00
2024-12-10 17:18:30,99,1251,41,58,677.51,1349.87,0.00
2024-12-10 17:18:30,98,1251,40,58,681.62,1349.90,0.00
2024-12-10 17:18:30,98,1252,40,58,693.50,1350.00,0.00
2024-12-10 17:18:30,99,1252,40,59,686.50,1350.01,0.00
2024-12-10 17:18:30,98,1252,39,59,692.55,1350.07,0.00
2024-12-10 17:18:30,98,1253,39,59,691.70,1351.00,0.00
2024-12-10 17:18:30,99,1253,39,60,684.71,1351.01,0.00
2024-12-10 17:18:30,98,1253,39,59,691.56,1351.01,0.00
2024-12-10 17:18:30,97,1253,38,59,698.41,1351.02,0.00
2024-12-10 17:18:30,96,1253,37,59,705.13,1351.05,0.00
2024-12-10 17:18:30,96,1254,37,59,703.16,1352.00,0.00
2024-12-10 17:18:30,97,1254,37,60,695.92,1352.01,0.00
2024-12-10 17:18:30,98,1253,38,60,686.51,1352.20,0.00
2024-12-10 17:18:30,98,1254,38,60,693.46,1353.00,0.00
2024-12-10 17:18:30,99,1254,39,60,686.45,1353.01,0.00
2024-12-10 17:18:30,98,1254,39,59,677.11,1353.82,0.00
2024-12-10 17:18:30,98,1255,39,59,700.96,1354.00,0.00
2024-12-10 17:18:30,99,1255,40,59,693.88,1354.01,0.00
2024-12-10 17:18:30,98,1255,39,59,700.01,1354.07,0.00
2024-12-10 17:18:30,98,1256,39,59,697.94,1355.00,0.00
2024-12-10 17:18:30,99,1256,40,59,690.89,1355.01,0.00
2024-12-10 17:18:30,98,1256,40,58,696.99,1355.07,0.00
2024-12-10 17:18:30,98,1257,40,58,693.83,1356.00,0.00
2024-12-10 17:18:30,99,1257,41,58,686.82,1356.01,0.00
2024-12-10 17:18:30,98,1257,40,58,693.42,1356.03,0.00
2024-12-10 17:18:30,97,1257,40,57,699.89,1356.07,0.00
2024-12-10 17:18:30,97,1258,40,57,691.67,1357.00,0.00
2024-12-10 17:18:30,98,1258,40,58,684.61,1357.01,0.00
2024-12-10 17:18:30,97,1258,39,58,690.71,1357.07,0.00
2024-12-10 17:18:30,96,1258,39,57,693.47,1357.34,0.00
2024-12-10 17:18:30,95,1258,39,56,685.19,1357.79,0.00
2024-12-10 17:18:30,95,1259,39,56,693.42,1358.00,0.00
2024-12-10 17:18:30,96,1259,39,57,686.19,1358.01,0.00
2024-12-10 17:18:30,95,1259,38,57,692.44,1358.07,0.00
2024-12-10 17:18:30,94,1259,37,57,684.75,1358.83,0.00
2024-12-10 17:18:30,94,1260,37,57,697.04,1359.00,0.00
2024-12-10 17:18:30,95,1260,38,57,689.71,1359.01,0.00
2024-12-10 17:18:30,94,1260,38,56,696.90,1359.01,0.00
2024-12-10 17:18:30,93,1260,38,55,703.54,1359.07,0.00
2024-12-10 17:18:30,92,1260,38,54,702.32,1359.71,0.00
2024-12-10 17:18:30,92,1261,38,54,712.49,1360.00,0.00
2024-12-10 17:18:30,93,1261,39,54,704.83,1360.01,0.00
2024-12-10 17:18:30,93,1262,39,54,705.19,1361.00,0.00
2024-12-10 17:18:30,94,1262,40,54,697.68,1361.01,0.00
2024-12-10 17:18:30,94,1263,40,54,697.82,1362.00,0.00
2024-12-10 17:18:30,95,1263,41,54,690.48,1362.01,0.00
2024-12-10 17:18:30,95,1264,41,54,690.47,1363.00,0.00
2024-12-10 17:18:30,96,1264,42,54,683.27,1363.01,0.00
2024-12-10 17:18:30,95,1264,42,53,689.49,1363.07,0.00
2024-12-10 17:18:30,95,1265,42,53,689.49,1364.00,0.00
2024-12-10 17:18:30,96,1265,43,53,682.31,1364.01,0.00
2024-12-10 17:18:30,95,1265,43,52,688.52,1364.07,0.00
2024-12-10 17:18:31,95,1266,43,52,688.50,1365.00,0.00
2024-12-10 17:18:31,96,1266,44,52,681.33,1365.01,0.00
2024-12-10 17:18:31,95,1266,44,51,687.52,1365.07,0.00
2024-12-10 17:18:31,95,1267,44,51,685.95,1366.00,0.00
2024-12-10 17:18:31,96,1267,45,51,678.80,1366.01,0.00
2024-12-10 17:18:31,95,1267,44,51,675.04,1366.75,0.00
2024-12-10 17:18:31,95,1268,44,51,686.19,1367.00,0.00
2024-12-10 17:18:31,96,1268,44,52,679.04,1367.01,0.00
2024-12-10 17:18:31,95,1268,44,51,684.94,1367.10,0.00
2024-12-10 17:18:31,95,1269,44,51,687.00,1368.00,0.00
2024-12-10 17:18:31,96,1269,44,52,679.84,1368.01,0.00
2024-12-10 17:18:31,95,1269,44,51,685.75,1368.10,0.00
2024-12-10 17:18:31,96,1268,45,51,669.10,1368.76,0.00
2024-12-10 17:18:31,96,1269,45,51,683.43,1369.00,0.00
2024-12-10 17:18:31,97,1269,46,51,676.38,1369.01,0.00
2024-12-10 17:18:31,97,1270,46,51,690.87,1370.00,0.00
2024-12-10 17:18:31,98,1270,46,52,683.82,1370.01,0.00
2024-12-10 17:18:31,97,1270,46,51,689.51,1370.10,0.00
2024-12-10 17:18:31,97,1271,46,51,691.48,1371.00,0.00
2024-12-10 17:18:31,98,1271,46,52,684.42,1371.01,0.00
2024-12-10 17:18:31,97,1271,45,52,690.11,1371.10,0.00
2024-12-10 17:18:31,97,1272,45,52,692.40,1372.00,0.00
2024-12-10 17:18:31,98,1272,45,53,685.33,1372.01,0.00
2024-12-10 17:18:31,97,1272,45,52,691.03,1372.10,0.00
2024-12-10 17:18:31,96,1272,44,52,696.64,1372.22,0.00
2024-12-10 17:18:31,96,1273,44,52,698.00,1373.00,0.00
2024-12-10 17:18:31,97,1273,44,53,690.80,1373.01,0.00
2024-12-10 17:18:31,97,1274,44,53,690.83,1374.00,0.00
2024-12-10 17:18:31,98,1274,45,53,683.78,1374.01,0.00
2024-12-10 17:18:31,98,1275,45,53,684.34,1375.00,0.00
2024-12-10 17:18:31,99,1275,46,53,677.42,1375.01,0.00
2024-12-10 17:18:31,98,1275,46,52,682.98,1375.10,0.00
2024-12-10 17:18:31,98,1276,46,52,684.46,1376.00,0.00
2024-12-10 17:18:31,99,1276,46,53,677.55,1376.01,0.00
2024-12-10 17:18:31,98,1276,46,52,683.10,1376.10,0.00
2024-12-10 17:18:31,98,1277,46,52,683.81,1377.00,0.00
2024-12-10 17:18:31,99,1277,47,52,676.90,1377.01,0.00
2024-12-10 17:18:31,98,1277,47,51,682.44,1377.10,0.00
2024-12-10 17:18:31,97,1277,47,50,678.63,1377.42,0.00
2024-12-10 17:18:31,97,1278,47,50,685.28,1378.00,0.00
2024-12-10 17:18:31,98,1278,47,51,678.28,1378.01,0.00
2024-12-10 17:18:31,97,1278,46,51,683.90,1378.10,0.00
2024-12-10 17:18:31,97,1279,46,51,685.88,1379.00,0.00
2024-12-10 17:18:31,98,1279,47,51,678.88,1379.01,0.00
2024-12-10 17:18:31,97,1279,46,51,684.50,1379.10,0.00
2024-12-10 17:18:31,97,1280,46,51,686.48,1380.00,0.00
2024-12-10 17:18:31,98,1280,46,52,679.47,1380.01,0.00
2024-12-10 17:18:31,97,1280,45,52,685.10,1380.10,0.00
2024-12-10 17:18:31,97,1281,45,52,680.54,1381.00,0.00
2024-12-10 17:18:31,98,1281,45,53,673.59,1381.01,0.00
2024-12-10 17:18:31,97,1281,45,52,679.15,1381.10,0.00
2024-12-10 17:18:31,96,1281,45,51,686.08,1381.10,0.00
2024-12-10 17:18:31,95,1281,45,50,685.79,1381.54,0.00
2024-12-10 17:18:31,95,1282,45,50,692.87,1382.00,0.00
2024-12-10 17:18:31,96,1282,45,51,685.66,1382.01,0.00
2024-12-10 17:18:31,97,1281,46,51,677.89,1382.08,0.00
2024-12-10 17:18:31,97,1282,46,51,685.87,1383.00,0.00
2024-12-10 17:18:31,98,1282,47,51,678.88,1383.01,0.00
2024-12-10 17:18:31,98,1283,47,51,693.83,1384.00,0.00
2024-12-10 17:18:31,99,1283,48,51,686.82,1384.01,0.00
2024-12-10 17:18:31,98,1283,48,50,692.45,1384.10,0.00
2024-12-10 17:18:31,98,1284,48,50,693.75,1385.00,0.00
2024-12-10 17:18:31,99,1284,49,50,686.74,1385.01,0.00
2024-12-10 17:18:31,98,1284,48,50,692.38,1385.10,0.00
2024-12-10 17:18:31,98,1285,48,50,692.59,1386.00,0.00
2024-12-10 17:18:31,99,1285,48,51,685.59,1386.01,0.00
2024-12-10 17:18:31,98,1285,48,50,691.21,1386.10,0.00
2024-12-10 17:18:31,97,1285,47,50,691.35,1386.56,0.00
2024-12-10 17:18:31,97,1286,47,50,699.85,1387.00,0.00
2024-12-10 17:18:31,98,1286,48,50,692.71,1387.01,0.00
2024-12-10 17:18:31,98,1287,48,50,693.59,1388.00,0.00
2024-12-10 17:18:31,99,1287,48,51,686.59,1388.01,0.00
2024-12-10 17:18:31,99,1288,48,51,686.87,1389.00,0.00
2024-12-10 17:18:31,100,1288,48,52,680.00,1389.01,0.00
2024-12-10 17:18:31,100,1289,48,52,680.01,1390.00,0.00
2024-12-10 17:18:31,101,1289,48,53,673.28,1390.01,0.00
2024-12-10 17:18:31,100,1289,48,52,679.74,1390.02,0.00
2024-12-10 17:18:31,101,1288,48,53,672.47,1390.08,0.00
2024-12-10 17:18:31,100,1288,48,52,683.94,1390.10,0.00
2024-12-10 17:18:31,99,1288,47,52,690.71,1390.10,0.00
2024-12-10 17:18:31,99,1289,47,52,692.72,1391.00,0.00
2024-12-10 17:18:31,100,1289,48,52,685.79,1391.01,0.00
2024-12-10 17:18:31,99,1289,48,51,691.49,1391.09,0.00
2024-12-10 17:18:31,99,1290,48,51,707.42,1392.00,0.00
2024-12-10 17:18:31,100,1290,48,52,700.34,1392.01,0.00
2024-12-10 17:18:31,99,1290,48,51,706.86,1392.04,0.00
2024-12-10 17:18:31,98,1290,47,51,713.39,1392.08,0.00
2024-12-10 17:18:31,97,1290,46,51,720.60,1392.08,0.00
2024-12-10 17:18:31,97,1291,46,51,722.66,1393.00,0.00
2024-12-10 17:18:31,98,1291,47,51,715.29,1393.01,0.00
2024-12-10 17:18:31,97,1291,46,51,722.52,1393.01,0.00
2024-12-10 17:18:31,96,1291,46,50,729.07,1393.07,0.00
2024-12-10 17:18:31,95,1291,45,50,736.59,1393.07,0.00
2024-12-10 17:18:31,95,1292,45,50,738.85,1394.00,0.00
2024-12-10 17:18:31,96,1292,45,51,731.15,1394.01,0.00
2024-12-10 17:18:31,95,1292,45,50,737.86,1394.07,0.00
2024-12-10 17:18:31,95,1293,45,50,740.11,1395.00,0.00
2024-12-10 17:18:31,96,1293,45,51,732.40,1395.01,0.00
2024-12-10 17:18:31,95,1293,45,50,739.12,1395.07,0.00
2024-12-10 17:18:31,94,1293,45,49,745.86,1395.15,0.00
2024-12-10 17:18:31,94,1294,45,49,749.33,1396.00,0.00
2024-12-10 17:18:31,95,1294,45,50,741.44,1396.01,0.00
2024-12-10 17:18:32,95,1295,45,50,742.85,1397.00,0.00
2024-12-10 17:18:32,96,1295,46,50,735.11,1397.01,0.00
2024-12-10 17:18:32,95,1295,45,50,741.86,1397.07,0.00
2024-12-10 17:18:32,94,1295,44,50,745.48,1397.38,0.00
2024-12-10 17:18:32,94,1296,44,50,752.17,1398.00,0.00
2024-12-10 17:18:32,95,1296,45,50,744.25,1398.01,0.00
2024-12-10 17:18:32,96,1295,46,50,736.36,1398.04,0.00
2024-12-10 17:18:32,96,1296,46,50,746.06,1399.00,0.00
2024-12-10 17:18:32,97,1296,47,50,738.37,1399.01,0.00
2024-12-10 17:18:32,96,1296,47,49,745.08,1399.07,0.00
2024-12-10 17:18:32,96,1297,47,49,761.76,1400.00,0.00
2024-12-10 17:18:32,97,1297,47,50,753.91,1400.01,0.00
2024-12-10 17:18:32,97,1298,47,50,755.03,1401.00,0.00
2024-12-10 17:18:32,98,1298,48,50,747.32,1401.01,0.00
2024-12-10 17:18:32,97,1298,48,49,754.05,1401.07,0.00
2024-12-10 17:18:32,97,1299,48,49,755.97,1402.00,0.00
2024-12-10 17:18:32,98,1299,48,50,748.25,1402.01,0.00
2024-12-10 17:18:32,98,1300,48,50,748.37,1403.00,0.00
2024-12-10 17:18:32,99,1300,48,51,740.81,1403.01,0.00
2024-12-10 17:18:32,98,1300,48,50,747.40,1403.07,0.00
2024-12-10 17:18:32,97,1300,48,49,750.49,1403.34,0.00
2024-12-10 17:18:32,98,1299,49,49,741.58,1403.45,0.00
2024-12-10 17:18:32,98,1300,49,49,755.75,1404.00,0.00
2024-12-10 17:18:32,99,1300,50,49,748.12,1404.01,0.00
2024-12-10 17:18:32,98,1300,49,49,754.78,1404.07,0.00
2024-12-10 17:18:32,98,1301,49,49,770.91,1405.00,0.00
2024-12-10 17:18:32,99,1301,49,50,763.12,1405.01,0.00
2024-12-10 17:18:32,98,1301,49,49,769.94,1405.07,0.00
2024-12-10 17:18:32,99,1300,50,49,756.46,1405.51,0.00
2024-12-10 17:18:32,99,1301,50,49,770.34,1406.00,0.00
2024-12-10 17:18:32,100,1301,50,50,762.64,1406.01,0.00
2024-12-10 17:18:32,99,1301,50,49,769.38,1406.07,0.00
2024-12-10 17:18:32,99,1302,50,49,785.24,1407.00,0.00
2024-12-10 17:18:32,100,1302,50,50,777.39,1407.01,0.00
2024-12-10 17:18:32,101,1301,51,50,760.24,1407.72,0.00
2024-12-10 17:18:32,101,1302,51,50,773.87,1408.00,0.00
2024-12-10 17:18:32,102,1302,52,50,766.28,1408.01,0.00
2024-12-10 17:18:32,101,1302,52,49,772.92,1408.07,0.00
2024-12-10 17:18:32,100,1302,52,48,780.51,1408.07,0.00
2024-12-10 17:18:32,100,1303,52,48,796.11,1409.00,0.00
2024-12-10 17:18:32,101,1303,52,49,788.23,1409.01,0.00
2024-12-10 17:18:32,100,1303,52,48,795.15,1409.07,0.00
2024-12-10 17:18:32,100,1304,52,48,796.67,1410.00,0.00
2024-12-10 17:18:32,101,1304,52,49,788.79,1410.01,0.00
2024-12-10 17:18:32,101,1305,52,49,789.35,1411.00,0.00
2024-12-10 17:18:32,102,1305,52,50,781.61,1411.01,0.00
2024-12-10 17:18:32,101,1305,52,49,788.40,1411.07,0.00
2024-12-10 17:18:32,101,1306,52,49,789.77,1412.00,0.00
2024-12-10 17:18:32,102,1306,53,49,782.02,1412.01,0.00
2024-12-10 17:18:32,101,1306,53,48,788.82,1412.07,0.00
2024-12-10 17:18:32,101,1307,53,48,790.18,1413.00,0.00
2024-12-10 17:18:32,102,1307,54,48,782.44,1413.01,0.00
2024-12-10 17:18:32,101,1307,53,48,789.38,1413.06,0.00
2024-12-10 17:18:32,100,1307,53,47,797.13,1413.06,0.00
2024-12-10 17:18:32,101,1306,54,47,780.69,1413.70,0.00
2024-12-10 17:18:32,101,1307,54,47,794.25,1414.00,0.00
2024-12-10 17:18:32,102,1307,55,47,786.46,1414.01,0.00
2024-12-10 17:18:32,101,1307,54,47,791.83,1414.18,0.00
2024-12-10 17:18:32,101,1308,54,47,808.75,1415.00,0.00
2024-12-10 17:18:32,102,1308,55,47,800.82,1415.01,0.00
2024-12-10 17:18:32,101,1308,54,47,807.94,1415.06,0.00
2024-12-10 17:18:32,101,1309,54,47,809.18,1416.00,0.00
2024-12-10 17:18:32,102,1309,55,47,801.25,1416.01,0.00
2024-12-10 17:18:32,101,1309,54,47,808.37,1416.06,0.00
2024-12-10 17:18:32,101,1310,54,47,809.61,1417.00,0.00
2024-12-10 17:18:32,102,1310,54,48,801.67,1417.01,0.00
2024-12-10 17:18:32,101,1310,53,48,808.80,1417.06,0.00
2024-12-10 17:18:32,101,1311,53,48,810.04,1418.00,0.00
2024-12-10 17:18:32,102,1311,54,48,802.10,1418.01,0.00
2024-12-10 17:18:32,101,1311,53,48,809.23,1418.06,0.00
2024-12-10 17:18:32,101,1312,53,48,810.47,1419.00,0.00
2024-12-10 17:18:32,102,1312,53,49,802.53,1419.01,0.00
2024-12-10 17:18:32,101,1312,52,49,809.66,1419.06,0.00
2024-12-10 17:18:32,102,1311,52,50,799.79,1419.22,0.00
2024-12-10 17:18:32,102,1312,52,50,812.98,1420.00,0.00
2024-12-10 17:18:32,103,1312,53,50,805.09,1420.01,0.00
2024-12-10 17:18:32,102,1312,53,49,812.17,1420.06,0.00
2024-12-10 17:18:32,102,1313,53,49,827.20,1421.00,0.00
2024-12-10 17:18:32,103,1313,54,49,819.17,1421.01,0.00
2024-12-10 17:18:32,102,1313,54,48,826.39,1421.06,0.00
2024-12-10 17:18:32,102,1314,54,48,827.51,1422.00,0.00
2024-12-10 17:18:32,103,1314,54,49,819.47,1422.01,0.00
2024-12-10 17:18:32,102,1314,53,49,826.46,1422.08,0.00
2024-12-10 17:18:32,101,1314,53,48,834.48,1422.09,0.00
2024-12-10 17:18:32,101,1315,53,48,836.17,1423.00,0.00
2024-12-10 17:18:32,102,1315,53,49,827.98,1423.01,0.00
2024-12-10 17:18:32,101,1315,52,49,835.35,1423.06,0.00
2024-12-10 17:18:32,101,1316,52,49,836.62,1424.00,0.00
2024-12-10 17:18:32,102,1316,52,50,828.42,1424.01,0.00
2024-12-10 17:18:32,101,1316,52,49,835.80,1424.06,0.00
2024-12-10 17:18:32,101,1317,52,49,837.07,1425.00,0.00
2024-12-10 17:18:32,102,1317,53,49,828.86,1425.01,0.00
2024-12-10 17:18:32,102,1318,53,49,829.30,1426.00,0.00
2024-12-10 17:18:32,103,1318,53,50,821.25,1426.01,0.00
2024-12-10 17:18:32,102,1318,52,50,828.48,1426.06,0.00
2024-12-10 17:18:32,102,1319,52,50,829.60,1427.00,0.00
2024-12-10 17:18:32,103,1319,53,50,821.55,1427.01,0.00
2024-12-10 17:18:32,104,1318,54,50,811.50,1427.18,0.00
2024-12-10 17:18:32,104,1319,54,50,824.38,1428.00,0.00
2024-12-10 17:18:32,105,1319,55,50,816.53,1428.01,0.00
2024-12-10 17:18:33,105,1320,55,50,830.17,1429.00,0.00
2024-12-10 17:18:33,106,1320,56,50,822.34,1429.01,0.00
2024-12-10 17:18:33,106,1321,56,50,822.24,1430.00,0.00
2024-12-10 17:18:33,107,1321,57,50,814.55,1430.01,0.00
2024-12-10 17:18:33,106,1321,56,50,822.10,1430.01,0.00
2024-12-10 17:18:33,105,1321,56,49,829.27,1430.05,0.00
2024-12-10 17:18:33,105,1322,56,49,829.83,1431.00,0.00
2024-12-10 17:18:33,106,1322,56,50,822.00,1431.01,0.00
2024-12-10 17:18:33,105,1322,55,50,829.04,1431.06,0.00
2024-12-10 17:18:33,105,1323,55,50,829.74,1432.00,0.00
2024-12-10 17:18:33,106,1323,55,51,821.91,1432.01,0.00
2024-12-10 17:18:33,105,1323,55,50,829.08,1432.05,0.00
2024-12-10 17:18:33,105,1324,55,50,829.64,1433.00,0.00
2024-12-10 17:18:33,106,1324,56,50,821.81,1433.01,0.00
2024-12-10 17:18:33,106,1325,56,50,821.71,1434.00,0.00
2024-12-10 17:18:33,107,1325,56,51,814.03,1434.01,0.00
2024-12-10 17:18:33,107,1326,56,51,813.79,1435.00,0.00
2024-12-10 17:18:33,108,1326,56,52,806.26,1435.01,0.00
2024-12-10 17:18:33,108,1327,56,52,805.89,1436.00,0.00
2024-12-10 17:18:33,109,1327,56,53,798.49,1436.01,0.00
2024-12-10 17:18:33,109,1328,56,53,798.00,1437.00,0.00
2024-12-10 17:18:33,110,1328,57,53,790.74,1437.01,0.00
2024-12-10 17:18:33,109,1328,57,52,797.35,1437.05,0.00
2024-12-10 17:18:33,109,1329,57,52,797.36,1438.00,0.00
2024-12-10 17:18:33,110,1329,58,52,790.12,1438.01,0.00
2024-12-10 17:18:33,110,1330,58,52,789.49,1439.00,0.00
2024-12-10 17:18:33,111,1330,59,52,782.37,1439.01,0.00
2024-12-10 17:18:33,111,1331,59,52,781.62,1440.00,0.00
2024-12-10 17:18:33,112,1331,60,52,774.64,1440.01,0.00
2024-12-10 17:18:33,112,1332,60,52,773.77,1441.00,0.00
2024-12-10 17:18:33,113,1332,61,52,766.92,1441.01,0.00
2024-12-10 17:18:33,113,1333,61,52,765.92,1442.00,0.00
2024-12-10 17:18:33,114,1333,61,53,759.20,1442.01,0.00
2024-12-10 17:18:33,113,1333,61,52,765.29,1442.04,0.00
2024-12-10 17:18:33,113,1334,61,52,764.79,1443.00,0.00
2024-12-10 17:18:33,114,1334,62,52,758.08,1443.01,0.00
2024-12-10 17:18:33,114,1335,62,52,756.96,1444.00,0.00
2024-12-10 17:18:33,115,1335,63,52,750.38,1444.01,0.00
2024-12-10 17:18:33,114,1335,63,51,756.46,1444.04,0.00
2024-12-10 17:18:33,113,1335,63,50,763.03,1444.04,0.00
2024-12-10 17:18:33,113,1336,63,50,762.40,1445.00,0.00
2024-12-10 17:18:33,114,1336,64,50,755.71,1445.01,0.00
2024-12-10 17:18:33,114,1337,64,50,754.58,1446.00,0.00
2024-12-10 17:18:33,115,1337,64,51,748.02,1446.01,0.00
2024-12-10 17:18:33,114,1337,64,50,754.09,1446.04,0.00
2024-12-10 17:18:33,115,1336,65,50,742.83,1446.38,0.00
2024-12-10 17:18:33,116,1335,66,50,735.31,1446.82,0.00
2024-12-10 17:18:33,116,1336,66,50,747.82,1447.00,0.00
2024-12-10 17:18:33,117,1336,66,51,741.43,1447.01,0.00
2024-12-10 17:18:33,118,1335,67,51,725.84,1447.69,0.00
2024-12-10 17:18:33,118,1336,67,51,762.41,1448.00,0.00
2024-12-10 17:18:33,119,1336,67,52,756.00,1448.01,0.00
2024-12-10 17:18:33,118,1336,66,52,761.81,1448.04,0.00
2024-12-10 17:18:33,118,1337,66,52,773.00,1449.00,0.00
2024-12-10 17:18:33,119,1337,66,53,766.51,1449.01,0.00
2024-12-10 17:18:33,118,1337,65,53,772.41,1449.04,0.00
2024-12-10 17:18:33,119,1336,65,54,761.13,1449.40,0.00
2024-12-10 17:18:33,119,1337,65,54,769.23,1450.00,0.00
2024-12-10 17:18:33,120,1337,65,55,762.82,1450.01,0.00
2024-12-10 17:18:33,119,1337,65,54,768.64,1450.04,0.00
2024-12-10 17:18:33,119,1338,65,54,779.64,1451.00,0.00
2024-12-10 17:18:33,120,1338,66,54,773.14,1451.01,0.00
2024-12-10 17:18:33,120,1339,66,54,771.37,1452.00,0.00
2024-12-10 17:18:33,121,1339,67,54,765.00,1452.01,0.00
2024-12-10 17:18:33,120,1339,67,53,770.67,1452.05,0.00
2024-12-10 17:18:33,121,1338,68,53,754.17,1452.79,0.00
2024-12-10 17:18:33,121,1339,68,53,765.89,1453.00,0.00
2024-12-10 17:18:33,122,1339,69,53,759.61,1453.01,0.00
2024-12-10 17:18:33,121,1339,68,53,765.07,1453.06,0.00
2024-12-10 17:18:33,121,1340,68,53,775.91,1454.00,0.00
2024-12-10 17:18:33,122,1340,69,53,769.55,1454.01,0.00
2024-12-10 17:18:33,121,1340,68,53,775.09,1454.06,0.00
2024-12-10 17:18:33,122,1339,69,53,766.37,1454.24,0.00
2024-12-10 17:18:33,122,1340,69,53,777.11,1455.00,0.00
2024-12-10 17:18:33,123,1340,70,53,770.79,1455.01,0.00
2024-12-10 17:18:33,122,1340,69,53,776.30,1455.06,0.00
2024-12-10 17:18:33,122,1341,69,53,786.96,1456.00,0.00
2024-12-10 17:18:33,123,1341,69,54,780.56,1456.01,0.00
2024-12-10 17:18:33,122,1341,68,54,786.14,1456.06,0.00
2024-12-10 17:18:33,123,1340,69,54,778.81,1456.14,0.00
2024-12-10 17:18:33,123,1341,69,54,789.27,1457.00,0.00
2024-12-10 17:18:33,124,1341,69,55,782.90,1457.01,0.00
2024-12-10 17:18:33,123,1341,69,54,788.46,1457.06,0.00
2024-12-10 17:18:33,123,1342,69,54,798.94,1458.00,0.00
2024-12-10 17:18:33,124,1342,69,55,792.49,1458.01,0.00
2024-12-10 17:18:33,123,1342,69,54,798.13,1458.06,0.00
2024-12-10 17:18:33,123,1343,69,54,796.76,1459.00,0.00
2024-12-10 17:18:33,124,1343,70,54,790.33,1459.01,0.00
2024-12-10 17:18:33,123,1343,69,54,795.95,1459.06,0.00
2024-12-10 17:18:34,123,1344,69,54,794.57,1460.00,0.00
2024-12-10 17:18:34,124,1344,70,54,788.16,1460.01,0.00
2024-12-10 17:18:34,125,1343,71,54,770.22,1460.85,0.00
2024-12-10 17:18:34,125,1344,71,54,781.34,1461.00,0.00
2024-12-10 17:18:34,126,1344,72,54,775.14,1461.01,0.00
2024-12-10 17:18:34,125,1344,71,54,780.43,1461.06,0.00
2024-12-10 17:18:34,126,1343,71,55,768.56,1461.48,0.00
2024-12-10 17:18:34,126,1344,71,55,790.76,1462.00,0.00
2024-12-10 17:18:34,127,1344,72,55,784.53,1462.01,0.00
2024-12-10 17:18:34,126,1344,71,55,789.85,1462.06,0.00
2024-12-10 17:18:34,127,1343,71,56,771.97,1462.91,0.00
2024-12-10 17:18:34,127,1344,71,56,794.63,1463.00,0.00
2024-12-10 17:18:34,128,1344,72,56,788.42,1463.01,0.00
2024-12-10 17:18:34,127,1344,71,56,793.73,1463.06,0.00
2024-12-10 17:18:34,127,1345,71,56,803.59,1464.00,0.00
2024-12-10 17:18:34,128,1345,72,56,797.31,1464.01,0.00
2024-12-10 17:18:34,127,1345,71,56,802.69,1464.06,0.00
2024-12-10 17:18:34,127,1346,71,56,801.02,1465.00,0.00
2024-12-10 17:18:34,128,1346,71,57,794.76,1465.01,0.00
2024-12-10 17:18:34,128,1347,71,57,792.21,1466.00,0.00
2024-12-10 17:18:34,129,1347,71,58,786.07,1466.01,0.00
2024-12-10 17:18:34,128,1347,70,58,791.21,1466.07,0.00
2024-12-10 17:18:34,128,1348,70,58,789.54,1467.00,0.00
2024-12-10 17:18:34,129,1348,70,59,783.42,1467.01,0.00
2024-12-10 17:18:34,128,1348,70,58,788.54,1467.07,0.00
2024-12-10 17:18:34,128,1349,70,58,786.87,1468.00,0.00
2024-12-10 17:18:34,129,1349,70,59,780.77,1468.01,0.00
2024-12-10 17:18:34,128,1349,70,58,785.86,1468.07,0.00
2024-12-10 17:18:34,127,1349,69,58,791.94,1468.07,0.00
2024-12-10 17:18:34,127,1350,69,58,790.37,1469.00,0.00
2024-12-10 17:18:34,128,1350,69,59,784.19,1469.01,0.00
2024-12-10 17:18:34,127,1350,68,59,789.35,1469.07,0.00
2024-12-10 17:18:34,127,1351,68,59,787.78,1470.00,0.00
2024-12-10 17:18:34,128,1351,69,59,781.63,1470.01,0.00
2024-12-10 17:18:34,127,1351,69,58,786.76,1470.07,0.00
2024-12-10 17:18:34,127,1352,69,58,785.19,1471.00,0.00
2024-12-10 17:18:34,128,1352,70,58,779.05,1471.01,0.00
2024-12-10 17:18:34,129,1351,71,58,772.68,1471.05,0.00
2024-12-10 17:18:34,128,1351,71,57,784.02,1471.08,0.00
2024-12-10 17:18:34,128,1352,71,57,782.46,1472.00,0.00
2024-12-10 17:18:34,129,1352,72,57,776.39,1472.01,0.00
2024-12-10 17:18:34,128,1352,72,56,781.45,1472.07,0.00
2024-12-10 17:18:34,129,1351,72,57,766.62,1472.70,0.00
2024-12-10 17:18:34,129,1352,72,57,788.45,1473.00,0.00
2024-12-10 17:18:34,130,1352,72,58,782.39,1473.01,0.00
2024-12-10 17:18:34,129,1352,72,57,787.45,1473.07,0.00
2024-12-10 17:18:34,130,1351,72,58,772.47,1473.71,0.00
2024-12-10 17:18:34,130,1352,72,58,794.03,1474.00,0.00
2024-12-10 17:18:34,131,1352,72,59,787.97,1474.01,0.00
2024-12-10 17:18:34,131,1353,72,59,796.39,1475.00,0.00
2024-12-10 17:18:34,132,1353,73,59,790.35,1475.01,0.00
2024-12-10 17:18:34,131,1353,72,59,795.29,1475.08,0.00
2024-12-10 17:18:34,131,1354,72,59,793.43,1476.00,0.00
2024-12-10 17:18:34,132,1354,72,60,787.42,1476.01,0.00
2024-12-10 17:18:34,131,1354,72,59,792.34,1476.08,0.00
2024-12-10 17:18:34,132,1353,72,60,775.83,1476.83,0.00
2024-12-10 17:18:34,132,1354,72,60,786.50,1477.00,0.00
2024-12-10 17:18:34,133,1354,72,61,780.59,1477.01,0.00
2024-12-10 17:18:34,132,1354,71,61,785.41,1477.08,0.00
2024-12-10 17:18:34,132,1355,71,61,794.65,1478.00,0.00
2024-12-10 17:18:34,133,1355,72,61,788.67,1478.01,0.00
2024-12-10 17:18:34,132,1355,72,60,793.56,1478.08,0.00
2024-12-10 17:18:34,132,1356,72,60,791.60,1479.00,0.00
2024-12-10 17:18:34,133,1356,72,61,785.65,1479.01,0.00
2024-12-10 17:18:34,132,1356,71,61,790.51,1479.08,0.00
2024-12-10 17:18:34,133,1355,71,62,780.51,1479.37,0.00
2024-12-10 17:18:34,133,1356,71,62,790.19,1480.00,0.00
2024-12-10 17:18:34,134,1356,71,63,784.29,1480.01,0.00
2024-12-10 17:18:34,133,1356,71,62,789.10,1480.08,0.00
2024-12-10 17:18:34,133,1357,71,62,798.18,1481.00,0.00
2024-12-10 17:18:34,134,1357,72,62,792.22,1481.01,0.00
2024-12-10 17:18:34,133,1357,72,61,797.09,1481.08,0.00
2024-12-10 17:18:34,133,1358,72,61,795.04,1482.00,0.00
2024-12-10 17:18:34,134,1358,73,61,789.11,1482.01,0.00
2024-12-10 17:18:34,133,1358,72,61,794.82,1482.02,0.00
2024-12-10 17:18:34,132,1358,72,60,799.97,1482.07,0.00
2024-12-10 17:18:34,132,1359,72,60,797.90,1483.00,0.00
2024-12-10 17:18:34,133,1359,72,61,791.90,1483.01,0.00
2024-12-10 17:18:34,132,1359,71,61,796.81,1483.08,0.00
2024-12-10 17:18:34,132,1360,71,61,794.84,1484.00,0.00
2024-12-10 17:18:34,133,1360,71,62,788.86,1484.01,0.00
2024-12-10 17:18:34,132,1360,70,62,793.74,1484.08,0.00
2024-12-10 17:18:34,132,1361,70,62,791.77,1485.00,0.00
2024-12-10 17:18:34,133,1361,70,63,785.82,1485.01,0.00
2024-12-10 17:18:34,132,1361,69,63,790.68,1485.08,0.00
2024-12-10 17:18:34,132,1362,69,63,788.71,1486.00,0.00
2024-12-10 17:18:34,133,1362,70,63,782.78,1486.01,0.00
2024-12-10 17:18:34,132,1362,70,62,787.61,1486.08,0.00
2024-12-10 17:18:34,133,1361,70,63,781.69,1486.09,0.00
2024-12-10 17:18:34,133,1362,70,63,783.86,1487.00,0.00
2024-12-10 17:18:34,134,1362,71,63,778.01,1487.01,0.00
2024-12-10 17:18:34,134,1363,71,63,785.97,1488.00,0.00
2024-12-10 17:18:34,135,1363,71,64,780.15,1488.01,0.00
2024-12-10 17:18:35,134,1363,71,63,784.79,1488.08,0.00
2024-12-10 17:18:35,134,1364,71,63,782.72,1489.00,0.00
2024-12-10 17:18:35,135,1364,72,63,776.93,1489.01,0.00
2024-12-10 17:18:35,134,1364,72,62,781.54,1489.08,0.00
2024-12-10 17:18:35,134,1365,72,62,779.47,1490.00,0.00
2024-12-10 17:18:35,135,1365,72,63,773.70,1490.01,0.00
2024-12-10 17:18:35,134,1365,71,63,779.25,1490.02,0.00
2024-12-10 17:18:35,133,1365,71,62,784.13,1490.08,0.00
2024-12-10 17:18:35,132,1365,71,61,789.96,1490.08,0.00
2024-12-10 17:18:35,132,1366,71,61,787.97,1491.00,0.00
2024-12-10 17:18:35,133,1366,71,62,782.05,1491.01,0.00
2024-12-10 17:18:35,132,1366,70,62,786.87,1491.08,0.00
2024-12-10 17:18:35,132,1367,70,62,784.88,1492.00,0.00
2024-12-10 17:18:35,133,1367,70,63,778.98,1492.01,0.00
2024-12-10 17:18:35,134,1366,71,63,773.06,1492.03,0.00
2024-12-10 17:18:35,135,1365,71,64,769.22,1492.07,0.00
2024-12-10 17:18:35,134,1365,71,63,778.44,1492.09,0.00
2024-12-10 17:18:35,134,1366,71,63,776.47,1493.00,0.00
2024-12-10 17:18:35,135,1366,71,64,770.72,1493.01,0.00
2024-12-10 17:18:35,134,1366,70,64,775.39,1493.08,0.00
2024-12-10 17:18:35,134,1367,70,64,795.50,1494.00,0.00
2024-12-10 17:18:35,135,1367,70,65,789.61,1494.01,0.00
2024-12-10 17:18:35,134,1367,70,64,794.42,1494.08,0.00
2024-12-10 17:18:35,134,1368,70,64,792.24,1495.00,0.00
2024-12-10 17:18:35,135,1368,70,65,786.37,1495.01,0.00
2024-12-10 17:18:35,134,1368,70,64,791.16,1495.08,0.00
2024-12-10 17:18:35,134,1369,70,64,788.97,1496.00,0.00
2024-12-10 17:18:35,135,1369,71,64,783.13,1496.01,0.00
2024-12-10 17:18:35,134,1369,71,63,787.89,1496.08,0.00
2024-12-10 17:18:35,134,1370,71,63,785.70,1497.00,0.00
2024-12-10 17:18:35,135,1370,72,63,779.88,1497.01,0.00
2024-12-10 17:18:35,134,1370,71,63,784.62,1497.08,0.00
2024-12-10 17:18:35,135,1369,71,64,772.50,1497.52,0.00
2024-12-10 17:18:35,135,1370,71,64,782.18,1498.00,0.00
2024-12-10 17:18:35,136,1370,72,64,776.43,1498.01,0.00
2024-12-10 17:18:35,135,1370,72,63,782.07,1498.01,0.00
2024-12-10 17:18:35,134,1370,71,63,786.93,1498.07,0.00
2024-12-10 17:18:35,133,1370,70,63,792.73,1498.07,0.00
2024-12-10 17:18:35,132,1370,69,63,797.49,1498.11,0.00
2024-12-10 17:18:35,133,1369,69,64,784.90,1498.57,0.00
2024-12-10 17:18:35,133,1370,69,64,806.19,1499.00,0.00
2024-12-10 17:18:35,134,1370,69,65,800.17,1499.01,0.00
2024-12-10 17:18:35,133,1370,68,65,805.21,1499.07,0.00
2024-12-10 17:18:35,134,1369,68,66,799.20,1499.08,0.00
2024-12-10 17:18:35,134,1370,68,66,819.29,1500.00,0.00
2024-12-10 17:18:35,135,1370,69,66,813.22,1500.01,0.00
2024-12-10 17:18:35,135,1371,69,66,821.10,1501.00,0.00
2024-12-10 17:18:35,136,1371,69,67,815.06,1501.01,0.00
2024-12-10 17:18:35,135,1371,68,67,820.03,1501.07,0.00
2024-12-10 17:18:35,135,1372,68,67,817.75,1502.00,0.00
2024-12-10 17:18:35,136,1372,69,67,811.74,1502.01,0.00
2024-12-10 17:18:35,135,1372,69,66,816.68,1502.07,0.00
2024-12-10 17:18:35,136,1371,70,66,802.28,1502.66,0.00
2024-12-10 17:18:35,137,1370,71,66,799.64,1502.72,0.00
2024-12-10 17:18:35,137,1371,71,66,809.75,1503.00,0.00
2024-12-10 17:18:35,138,1371,71,67,803.89,1503.01,0.00
2024-12-10 17:18:35,137,1371,70,67,809.43,1503.02,0.00
2024-12-10 17:18:35,136,1371,70,66,814.64,1503.07,0.00
2024-12-10 17:18:35,137,1370,70,67,805.55,1503.29,0.00
2024-12-10 17:18:35,137,1371,70,67,836.42,1504.00,0.00
2024-12-10 17:18:35,138,1371,71,67,830.36,1504.01,0.00
2024-12-10 17:18:35,137,1371,70,67,835.47,1504.07,0.00
2024-12-10 17:18:35,137,1372,70,67,843.90,1505.00,0.00
2024-12-10 17:18:35,138,1372,71,67,837.78,1505.01,0.00
2024-12-10 17:18:35,137,1372,70,67,843.58,1505.02,0.00
2024-12-10 17:18:35,136,1372,70,66,849.14,1505.06,0.00
2024-12-10 17:18:35,135,1372,69,66,855.32,1505.06,0.00
2024-12-10 17:18:35,136,1371,70,66,843.82,1505.43,0.00
2024-12-10 17:18:35,136,1372,70,66,852.99,1506.00,0.00
2024-12-10 17:18:35,137,1372,70,67,846.77,1506.01,0.00
2024-12-10 17:18:35,137,1373,70,67,854.37,1507.00,0.00
2024-12-10 17:18:35,138,1373,71,67,848.18,1507.01,0.00
2024-12-10 17:18:35,137,1373,71,66,853.42,1507.07,0.00
2024-12-10 17:18:35,136,1373,70,66,859.58,1507.07,0.00
2024-12-10 17:18:35,136,1374,70,66,857.12,1508.00,0.00
2024-12-10 17:18:35,137,1374,70,67,850.86,1508.01,0.00
2024-12-10 17:18:35,136,1374,69,67,856.16,1508.07,0.00
2024-12-10 17:18:35,136,1375,69,67,853.69,1509.00,0.00
2024-12-10 17:18:35,137,1375,69,68,847.46,1509.01,0.00
2024-12-10 17:18:35,136,1375,69,67,852.73,1509.07,0.00
2024-12-10 17:18:35,136,1376,69,67,850.26,1510.00,0.00
2024-12-10 17:18:35,137,1376,69,68,844.06,1510.01,0.00
2024-12-10 17:18:35,136,1376,69,67,849.30,1510.07,0.00
2024-12-10 17:18:35,136,1377,69,67,846.80,1511.00,0.00
2024-12-10 17:18:35,137,1377,69,68,840.62,1511.01,0.00
2024-12-10 17:18:35,137,1378,69,68,837.20,1512.00,0.00
2024-12-10 17:18:35,138,1378,69,69,831.13,1512.01,0.00
2024-12-10 17:18:35,137,1378,68,69,836.14,1512.07,0.00
2024-12-10 17:18:35,137,1379,68,69,833.67,1513.00,0.00
2024-12-10 17:18:35,138,1379,69,69,827.63,1513.01,0.00
2024-12-10 17:18:35,137,1379,68,69,832.60,1513.07,0.00
2024-12-10 17:18:35,137,1380,68,69,830.13,1514.00,0.00
2024-12-10 17:18:35,138,1380,68,70,824.12,1514.01,0.00
2024-12-10 17:18:35,137,1380,67,70,828.96,1514.08,0.00
2024-12-10 17:18:35,137,1381,67,70,826.59,1515.00,0.00
2024-12-10 17:18:35,138,1381,67,71,820.60,1515.01,0.00
2024-12-10 17:18:35,137,1381,66,71,825.41,1515.08,0.00
2024-12-10 17:18:36,137,1382,66,71,822.82,1516.00,0.00
2024-12-10 17:18:36,138,1382,66,72,816.86,1516.01,0.00
2024-12-10 17:18:36,137,1382,65,72,821.64,1516.08,0.00
2024-12-10 17:18:36,137,1383,65,72,818.46,1517.00,0.00
2024-12-10 17:18:36,138,1383,66,72,812.53,1517.01,0.00
2024-12-10 17:18:36,137,1383,66,71,817.28,1517.08,0.00
2024-12-10 17:18:36,137,1384,66,71,813.44,1518.00,0.00
2024-12-10 17:18:36,138,1384,66,72,807.54,1518.01,0.00
2024-12-10 17:18:36,137,1384,65,72,812.25,1518.08,0.00
2024-12-10 17:18:36,136,1384,64,72,812.46,1518.38,0.00
2024-12-10 17:18:36,136,1385,64,72,814.56,1519.00,0.00
2024-12-10 17:18:36,137,1385,65,72,808.62,1519.01,0.00
2024-12-10 17:18:36,136,1385,65,71,813.37,1519.08,0.00
2024-12-10 17:18:36,135,1385,65,70,819.28,1519.08,0.00
2024-12-10 17:18:36,135,1386,65,70,817.08,1520.00,0.00
2024-12-10 17:18:36,136,1386,66,70,811.08,1520.01,0.00
2024-12-10 17:18:36,135,1386,65,70,815.88,1520.08,0.00
2024-12-10 17:18:36,135,1387,65,70,813.68,1521.00,0.00
2024-12-10 17:18:36,136,1387,66,70,807.70,1521.01,0.00
2024-12-10 17:18:36,135,1387,65,70,812.47,1521.08,0.00
2024-12-10 17:18:36,135,1388,65,70,810.27,1522.00,0.00
2024-12-10 17:18:36,136,1388,65,71,804.31,1522.01,0.00
2024-12-10 17:18:36,135,1388,65,70,809.06,1522.08,0.00
2024-12-10 17:18:36,135,1389,65,70,806.85,1523.00,0.00
2024-12-10 17:18:36,136,1389,65,71,800.92,1523.01,0.00
2024-12-10 17:18:36,135,1389,65,70,805.64,1523.08,0.00
2024-12-10 17:18:36,135,1390,65,70,803.43,1524.00,0.00
2024-12-10 17:18:36,136,1390,66,70,797.52,1524.01,0.00
2024-12-10 17:18:36,137,1389,66,71,791.59,1524.03,0.00
2024-12-10 17:18:36,136,1389,66,70,807.20,1524.09,0.00
2024-12-10 17:18:36,136,1390,66,70,805.00,1525.00,0.00
2024-12-10 17:18:36,137,1390,67,70,799.12,1525.01,0.00
2024-12-10 17:18:36,137,1391,67,70,806.77,1526.00,0.00
2024-12-10 17:18:36,138,1391,67,71,800.93,1526.01,0.00
2024-12-10 17:18:36,137,1391,67,70,805.48,1526.09,0.00
2024-12-10 17:18:36,137,1392,67,70,803.18,1527.00,0.00
2024-12-10 17:18:36,138,1392,68,70,797.36,1527.01,0.00
2024-12-10 17:18:36,137,1392,67,70,801.88,1527.09,0.00
2024-12-10 17:18:36,136,1392,66,70,807.66,1527.09,0.00
2024-12-10 17:18:36,136,1393,66,70,805.46,1528.00,0.00
2024-12-10 17:18:36,137,1393,66,71,799.58,1528.01,0.00
2024-12-10 17:18:36,137,1394,66,71,796.08,1529.00,0.00
2024-12-10 17:18:36,138,1394,66,72,790.32,1529.01,0.00
2024-12-10 17:18:36,139,1393,67,72,770.89,1529.95,0.00
2024-12-10 17:18:36,139,1394,67,72,781.84,1530.00,0.00
2024-12-10 17:18:36,140,1394,68,72,776.26,1530.01,0.00
2024-12-10 17:18:36,139,1394,67,72,780.34,1530.10,0.00
2024-12-10 17:18:36,139,1395,67,72,789.07,1531.00,0.00
2024-12-10 17:18:36,140,1395,67,73,783.43,1531.01,0.00
2024-12-10 17:18:36,139,1395,67,72,787.57,1531.10,0.00
2024-12-10 17:18:36,139,1396,67,72,785.29,1532.00,0.00
2024-12-10 17:18:36,140,1396,68,72,779.68,1532.01,0.00
2024-12-10 17:18:36,139,1396,68,71,783.78,1532.10,0.00
2024-12-10 17:18:36,139,1397,68,71,781.50,1533.00,0.00
2024-12-10 17:18:36,140,1397,68,72,775.92,1533.01,0.00
2024-12-10 17:18:36,139,1397,67,72,779.99,1533.10,0.00
2024-12-10 17:18:36,139,1398,67,72,777.70,1534.00,0.00
2024-12-10 17:18:36,140,1398,68,72,772.15,1534.01,0.00
2024-12-10 17:18:36,139,1398,68,71,776.20,1534.10,0.00
2024-12-10 17:18:36,139,1399,68,71,773.90,1535.00,0.00
2024-12-10 17:18:36,140,1399,68,72,768.38,1535.01,0.00
2024-12-10 17:18:36,139,1399,68,71,772.40,1535.10,0.00
2024-12-10 17:18:36,139,1400,68,71,770.10,1536.00,0.00
2024-12-10 17:18:36,140,1400,68,72,764.60,1536.01,0.00
2024-12-10 17:18:36,139,1400,68,71,768.59,1536.10,0.00
2024-12-10 17:18:36,139,1401,68,71,766.29,1537.00,0.00
2024-12-10 17:18:36,140,1401,69,71,760.81,1537.01,0.00
2024-12-10 17:18:36,139,1401,68,71,764.78,1537.10,0.00
2024-12-10 17:18:36,139,1402,68,71,762.47,1538.00,0.00
2024-12-10 17:18:36,140,1402,69,71,757.03,1538.01,0.00
2024-12-10 17:18:36,139,1402,68,71,760.96,1538.10,0.00
2024-12-10 17:18:36,139,1403,68,71,758.65,1539.00,0.00
2024-12-10 17:18:36,140,1403,69,71,753.23,1539.01,0.00
2024-12-10 17:18:36,141,1402,70,71,747.47,1539.05,0.00
2024-12-10 17:18:36,140,1402,69,71,761.77,1539.11,0.00
2024-12-10 17:18:36,140,1403,69,71,759.47,1540.00,0.00
2024-12-10 17:18:36,141,1403,69,72,754.08,1540.01,0.00
2024-12-10 17:18:36,140,1403,68,72,757.54,1540.10,0.00
2024-12-10 17:18:36,140,1404,68,72,766.14,1541.00,0.00
2024-12-10 17:18:36,141,1404,69,72,760.70,1541.01,0.00
2024-12-10 17:18:36,140,1404,68,72,763.98,1541.10,0.00
2024-12-10 17:18:36,140,1405,68,72,761.57,1542.00,0.00
2024-12-10 17:18:36,141,1405,69,72,756.17,1542.01,0.00
2024-12-10 17:18:36,140,1405,69,71,759.25,1542.10,0.00
2024-12-10 17:18:36,140,1406,69,71,756.84,1543.00,0.00
2024-12-10 17:18:36,141,1406,69,72,751.47,1543.01,0.00
2024-12-10 17:18:36,141,1407,69,72,746.56,1544.00,0.00
2024-12-10 17:18:36,142,1407,69,73,741.31,1544.01,0.00
2024-12-10 17:18:37,141,1407,69,72,744.83,1544.06,0.00
2024-12-10 17:18:37,140,1407,68,72,749.50,1544.10,0.00
2024-12-10 17:18:37,140,1408,68,72,746.92,1545.00,0.00
2024-12-10 17:18:37,141,1408,69,72,741.62,1545.01,0.00
2024-12-10 17:18:37,140,1408,68,72,745.41,1545.10,0.00
2024-12-10 17:18:37,140,1409,68,72,742.67,1546.00,0.00
2024-12-10 17:18:37,141,1409,69,72,737.40,1546.01,0.00
2024-12-10 17:18:37,140,1409,68,72,741.59,1546.07,0.00
2024-12-10 17:18:37,139,1409,67,72,746.27,1546.11,0.00
2024-12-10 17:18:37,139,1410,67,72,743.56,1547.00,0.00
2024-12-10 17:18:37,140,1410,67,73,738.25,1547.01,0.00
2024-12-10 17:18:37,139,1410,66,73,742.59,1547.07,0.00
2024-12-10 17:18:37,139,1411,66,73,739.05,1548.00,0.00
2024-12-10 17:18:37,140,1411,67,73,733.77,1548.01,0.00
2024-12-10 17:18:37,139,1411,67,72,737.31,1548.12,0.00
2024-12-10 17:18:37,139,1412,67,72,734.30,1549.00,0.00
2024-12-10 17:18:37,140,1412,67,73,729.05,1549.01,0.00
2024-12-10 17:18:37,139,1412,67,72,732.56,1549.12,0.00
2024-12-10 17:18:37,138,1412,67,71,737.75,1549.12,0.00
2024-12-10 17:18:37,138,1413,67,71,734.66,1550.00,0.00
2024-12-10 17:18:37,139,1413,67,72,729.38,1550.01,0.00
2024-12-10 17:18:37,138,1413,67,71,732.91,1550.12,0.00
2024-12-10 17:18:37,139,1412,68,71,716.61,1550.78,0.00
2024-12-10 17:18:37,139,1413,68,71,727.62,1551.00,0.00
2024-12-10 17:18:37,140,1413,68,72,722.43,1551.01,0.00
2024-12-10 17:18:37,139,1413,67,72,725.88,1551.12,0.00
2024-12-10 17:18:37,138,1413,67,71,723.51,1551.57,0.00
2024-12-10 17:18:37,138,1414,67,71,739.67,1552.00,0.00
2024-12-10 17:18:37,139,1414,67,72,734.35,1552.01,0.00
2024-12-10 17:18:37,138,1414,66,72,738.58,1552.07,0.00
2024-12-10 17:18:37,137,1414,65,72,743.30,1552.11,0.00
2024-12-10 17:18:37,137,1415,65,72,741.25,1553.00,0.00
2024-12-10 17:18:37,138,1415,66,72,735.87,1553.01,0.00
2024-12-10 17:18:37,138,1416,66,72,732.18,1554.00,0.00
2024-12-10 17:18:37,139,1416,67,72,726.91,1554.01,0.00
2024-12-10 17:18:37,138,1416,66,72,731.74,1554.03,0.00
2024-12-10 17:18:37,137,1416,65,72,735.64,1554.12,0.00
2024-12-10 17:18:37,137,1417,65,72,733.69,1555.00,0.00
2024-12-10 17:18:37,138,1417,66,72,728.37,1555.01,0.00
2024-12-10 17:18:37,137,1417,65,72,731.91,1555.12,0.00
2024-12-10 17:18:37,137,1418,65,72,729.96,1556.00,0.00
2024-12-10 17:18:37,138,1418,65,73,724.67,1556.01,0.00
2024-12-10 17:18:37,137,1418,65,72,728.18,1556.12,0.00
2024-12-10 17:18:37,136,1418,64,72,733.42,1556.12,0.00
2024-12-10 17:18:37,136,1419,64,72,731.56,1557.00,0.00
2024-12-10 17:18:37,137,1419,64,73,726.22,1557.01,0.00
2024-12-10 17:18:37,136,1419,64,72,729.77,1557.12,0.00
2024-12-10 17:18:37,136,1420,64,72,727.91,1558.00,0.00
2024-12-10 17:18:37,137,1420,64,73,722.59,1558.01,0.00
2024-12-10 17:18:37,137,1421,64,73,718.96,1559.00,0.00
2024-12-10 17:18:37,138,1421,65,73,713.75,1559.01,0.00
2024-12-10 17:18:37,137,1421,64,73,717.06,1559.12,0.00
2024-12-10 17:18:37,137,1422,64,73,715.21,1560.00,0.00
2024-12-10 17:18:37,138,1422,64,74,710.03,1560.01,0.00
2024-12-10 17:18:37,137,1422,63,74,713.98,1560.08,0.00
2024-12-10 17:18:37,136,1422,62,74,718.55,1560.12,0.00
2024-12-10 17:18:37,135,1422,61,74,723.76,1560.12,0.00
2024-12-10 17:18:37,135,1423,61,74,721.99,1561.00,0.00
2024-12-10 17:18:37,136,1423,62,74,716.68,1561.01,0.00
2024-12-10 17:18:37,135,1423,62,73,721.20,1561.05,0.00
2024-12-10 17:18:37,134,1423,61,73,725.55,1561.11,0.00
2024-12-10 17:18:37,133,1423,61,72,730.89,1561.11,0.00
2024-12-10 17:18:37,133,1424,61,72,729.21,1562.00,0.00
2024-12-10 17:18:37,134,1424,61,73,723.77,1562.01,0.00
2024-12-10 17:18:37,133,1424,60,73,727.83,1562.09,0.00
2024-12-10 17:18:37,132,1424,59,73,732.99,1562.11,0.00
2024-12-10 17:18:37,131,1424,59,72,738.47,1562.11,0.00
2024-12-10 17:18:37,131,1425,59,72,736.88,1563.00,0.00
2024-12-10 17:18:37,132,1425,60,72,731.29,1563.01,0.00
2024-12-10 17:18:37,131,1425,59,72,735.24,1563.11,0.00
2024-12-10 17:18:37,131,1426,59,72,733.65,1564.00,0.00
2024-12-10 17:18:37,132,1426,59,73,728.09,1564.01,0.00
2024-12-10 17:18:37,131,1426,58,73,732.01,1564.11,0.00
2024-12-10 17:18:37,132,1425,59,73,717.98,1564.67,0.00
2024-12-10 17:18:37,132,1426,59,73,729.62,1565.00,0.00
2024-12-10 17:18:37,133,1426,59,74,724.14,1565.01,0.00
2024-12-10 17:18:37,132,1426,59,73,727.99,1565.11,0.00
2024-12-10 17:18:37,132,1427,59,73,738.16,1566.00,0.00
2024-12-10 17:18:37,133,1427,59,74,732.61,1566.01,0.00
2024-12-10 17:18:37,134,1426,60,74,720.80,1566.43,0.00
2024-12-10 17:18:37,134,1427,60,74,731.81,1567.00,0.00
2024-12-10 17:18:37,135,1427,60,75,726.39,1567.01,0.00
2024-12-10 17:18:37,134,1427,60,74,730.09,1567.11,0.00
2024-12-10 17:18:37,134,1428,60,74,740.00,1568.00,0.00
2024-12-10 17:18:37,135,1428,60,75,734.52,1568.01,0.00
2024-12-10 17:18:37,134,1428,60,74,738.28,1568.11,0.00
2024-12-10 17:18:37,134,1429,60,74,736.49,1569.00,0.00
2024-12-10 17:18:37,135,1429,61,74,731.04,1569.01,0.00
2024-12-10 17:18:37,134,1429,61,73,734.77,1569.11,0.00
2024-12-10 17:18:38,134,1430,61,73,732.98,1570.00,0.00
2024-12-10 17:18:38,135,1430,62,73,727.55,1570.01,0.00
2024-12-10 17:18:38,134,1430,61,73,731.25,1570.11,0.00
2024-12-10 17:18:38,134,1431,61,73,729.46,1571.00,0.00
2024-12-10 17:18:38,135,1431,62,73,724.06,1571.01,0.00
2024-12-10 17:18:38,136,1430,63,73,717.83,1571.08,0.00
2024-12-10 17:18:38,135,1430,62,73,733.75,1571.12,0.00
2024-12-10 17:18:38,134,1430,61,73,739.11,1571.12,0.00
2024-12-10 17:18:38,134,1431,61,73,737.43,1572.00,0.00
2024-12-10 17:18:38,135,1431,62,73,731.97,1572.01,0.00
2024-12-10 17:18:38,134,1431,61,73,736.51,1572.06,0.00
2024-12-10 17:18:38,133,1431,61,72,741.12,1572.11,0.00
2024-12-10 17:18:38,133,1432,61,72,751.25,1573.00,0.00
2024-12-10 17:18:38,134,1432,61,73,745.65,1573.01,0.00
2024-12-10 17:18:38,133,1432,61,72,749.52,1573.11,0.00
2024-12-10 17:18:38,132,1432,61,71,755.07,1573.11,0.00
2024-12-10 17:18:38,132,1433,61,71,753.49,1574.00,0.00
2024-12-10 17:18:38,133,1433,61,72,747.83,1574.01,0.00
2024-12-10 17:18:38,132,1433,61,71,751.74,1574.11,0.00
2024-12-10 17:18:38,132,1434,61,71,750.15,1575.00,0.00
2024-12-10 17:18:38,133,1434,61,72,744.51,1575.01,0.00
2024-12-10 17:18:38,132,1434,60,72,748.40,1575.11,0.00
2024-12-10 17:18:38,132,1435,60,72,746.81,1576.00,0.00
2024-12-10 17:18:38,133,1435,60,73,741.19,1576.01,0.00
2024-12-10 17:18:38,132,1435,60,72,745.40,1576.09,0.00
2024-12-10 17:18:38,131,1435,60,71,750.74,1576.11,0.00
2024-12-10 17:18:38,130,1435,60,70,756.39,1576.11,0.00
2024-12-10 17:18:38,130,1436,60,70,754.90,1577.00,0.00
2024-12-10 17:18:38,131,1436,61,70,749.13,1577.01,0.00
2024-12-10 17:18:38,130,1436,61,69,753.23,1577.11,0.00
2024-12-10 17:18:38,130,1437,61,69,751.73,1578.00,0.00
2024-12-10 17:18:38,131,1437,61,70,746.00,1578.01,0.00
2024-12-10 17:18:38,130,1437,60,70,750.07,1578.11,0.00
2024-12-10 17:18:38,130,1438,60,70,748.57,1579.00,0.00
2024-12-10 17:18:38,131,1438,61,70,742.85,1579.01,0.00
2024-12-10 17:18:38,130,1438,61,69,746.90,1579.11,0.00
2024-12-10 17:18:38,129,1438,61,68,752.56,1579.11,0.00
2024-12-10 17:18:38,129,1439,61,68,751.17,1580.00,0.00
2024-12-10 17:18:38,130,1439,62,68,745.40,1580.01,0.00
2024-12-10 17:18:38,129,1439,62,67,749.49,1580.11,0.00
2024-12-10 17:18:38,129,1440,62,67,748.09,1581.00,0.00
2024-12-10 17:18:38,130,1440,63,67,742.34,1581.01,0.00
2024-12-10 17:18:38,129,1440,62,67,746.41,1581.11,0.00
2024-12-10 17:18:38,129,1441,62,67,745.01,1582.00,0.00
2024-12-10 17:18:38,130,1441,62,68,739.28,1582.01,0.00
2024-12-10 17:18:38,129,1441,61,68,743.32,1582.11,0.00
2024-12-10 17:18:38,129,1442,61,68,741.92,1583.00,0.00
2024-12-10 17:18:38,130,1442,61,69,736.22,1583.01,0.00
2024-12-10 17:18:38,129,1442,61,68,740.23,1583.11,0.00
2024-12-10 17:18:38,130,1441,62,68,732.24,1583.27,0.00
2024-12-10 17:18:38,130,1442,62,68,735.22,1584.00,0.00
2024-12-10 17:18:38,131,1442,62,69,729.61,1584.01,0.00
2024-12-10 17:18:38,130,1442,62,68,733.54,1584.11,0.00
2024-12-10 17:18:38,130,1443,62,68,744.22,1585.00,0.00
2024-12-10 17:18:38,131,1443,63,68,738.54,1585.01,0.00
2024-12-10 17:18:38,130,1443,63,67,742.53,1585.11,0.00
2024-12-10 17:18:38,130,1444,63,67,741.03,1586.00,0.00
2024-12-10 17:18:38,131,1444,64,67,735.37,1586.01,0.00
2024-12-10 17:18:38,130,1444,63,67,740.43,1586.04,0.00
2024-12-10 17:18:38,129,1444,62,67,745.07,1586.10,0.00
2024-12-10 17:18:38,128,1444,62,66,750.77,1586.10,0.00
2024-12-10 17:18:38,128,1445,62,66,749.36,1587.00,0.00
2024-12-10 17:18:38,129,1445,63,66,743.55,1587.01,0.00
2024-12-10 17:18:38,128,1445,62,66,747.77,1587.10,0.00
2024-12-10 17:18:38,128,1446,62,66,746.36,1588.00,0.00
2024-12-10 17:18:38,129,1446,62,67,740.57,1588.01,0.00
2024-12-10 17:18:38,128,1446,62,66,744.77,1588.10,0.00
2024-12-10 17:18:38,128,1447,62,66,739.06,1589.00,0.00
2024-12-10 17:18:38,129,1447,62,67,733.33,1589.01,0.00
2024-12-10 17:18:38,128,1447,61,67,737.47,1589.10,0.00
2024-12-10 17:18:38,127,1447,60,67,729.79,1589.71,0.00
2024-12-10 17:18:38,127,1448,60,67,737.91,1590.00,0.00
2024-12-10 17:18:38,128,1448,60,68,732.14,1590.01,0.00
2024-12-10 17:18:38,127,1448,60,67,736.30,1590.10,0.00
2024-12-10 17:18:38,127,1449,60,67,734.90,1591.00,0.00
2024-12-10 17:18:38,128,1449,61,67,729.16,1591.01,0.00
2024-12-10 17:18:38,127,1449,61,66,733.29,1591.10,0.00
2024-12-10 17:18:38,127,1450,61,66,731.98,1592.00,0.00
2024-12-10 17:18:38,128,1450,62,66,726.26,1592.01,0.00
2024-12-10 17:18:38,127,1450,62,65,731.86,1592.01,0.00
2024-12-10 17:18:38,126,1450,61,65,737.41,1592.02,0.00
2024-12-10 17:18:38,125,1450,61,64,742.05,1592.09,0.00
2024-12-10 17:18:38,124,1450,60,64,747.91,1592.09,0.00
2024-12-10 17:18:38,123,1450,60,63,753.86,1592.09,0.00
2024-12-10 17:18:38,123,1451,60,63,752.72,1593.00,0.00
2024-12-10 17:18:38,124,1451,61,63,746.65,1593.01,0.00
2024-12-10 17:18:38,123,1451,61,62,751.31,1593.09,0.00
2024-12-10 17:18:38,123,1452,61,62,750.04,1594.00,0.00
2024-12-10 17:18:38,124,1452,62,62,743.99,1594.01,0.00
2024-12-10 17:18:38,123,1452,62,61,748.63,1594.09,0.00
2024-12-10 17:18:38,123,1453,62,61,746.92,1595.00,0.00
2024-12-10 17:18:38,124,1453,63,61,740.89,1595.01,0.00
2024-12-10 17:18:38,123,1453,63,60,745.50,1595.09,0.00
2024-12-10 17:18:38,123,1454,63,60,743.74,1596.00,0.00
2024-12-10 17:18:38,124,1454,63,61,737.75,1596.01,0.00
2024-12-10 17:18:38,123,1454,62,61,742.33,1596.09,0.00
2024-12-10 17:18:38,122,1454,62,60,746.07,1596.17,0.00
2024-12-10 17:18:38,122,1455,62,60,745.77,1597.00,0.00
2024-12-10 17:18:38,123,1455,62,61,739.70,1597.01,0.00
2024-12-10 17:18:39,122,1455,62,60,744.99,1597.05,0.00
2024-12-10 17:18:39,121,1455,61,60,750.49,1597.08,0.00
2024-12-10 17:18:39,120,1455,61,59,756.61,1597.08,0.00
2024-12-10 17:18:39,120,1456,61,59,755.07,1598.00,0.00
2024-12-10 17:18:39,121,1456,62,59,748.83,1598.01,0.00
2024-12-10 17:18:39,120,1456,61,59,754.15,1598.06,0.00
2024-12-10 17:18:39,119,1456,60,59,760.09,1598.08,0.00
2024-12-10 17:18:39,119,1457,60,59,758.52,1599.00,0.00
2024-12-10 17:18:39,120,1457,60,60,752.20,1599.01,0.00
2024-12-10 17:18:39,119,1457,60,59,758.12,1599.03,0.00
2024-12-10 17:18:39,118,1457,60,58,763.61,1599.08,0.00
2024-12-10 17:18:39,118,1458,60,58,762.22,1600.00,0.00
2024-12-10 17:18:39,119,1458,60,59,755.81,1600.01,0.00
2024-12-10 17:18:39,118,1458,59,59,761.01,1600.08,0.00
2024-12-10 17:18:39,119,1457,60,59,744.85,1600.68,0.00
2024-12-10 17:18:39,119,1458,60,59,758.16,1601.00,0.00
2024-12-10 17:18:39,120,1458,60,60,751.85,1601.01,0.00
2024-12-10 17:18:39,119,1458,60,59,756.97,1601.08,0.00
2024-12-10 17:18:39,118,1458,59,59,758.07,1601.39,0.00
2024-12-10 17:18:39,118,1459,59,59,775.85,1602.00,0.00
2024-12-10 17:18:39,119,1459,60,59,769.33,1602.01,0.00
2024-12-10 17:18:39,118,1459,60,58,775.05,1602.05,0.00
2024-12-10 17:18:39,117,1459,59,58,781.53,1602.05,0.00
2024-12-10 17:18:39,116,1459,58,58,788.00,1602.06,0.00
2024-12-10 17:18:39,115,1459,57,58,794.72,1602.06,0.00
2024-12-10 17:18:39,114,1459,56,58,801.55,1602.06,0.00
2024-12-10 17:18:39,114,1460,56,58,801.04,1603.00,0.00
2024-12-10 17:18:39,115,1460,57,58,794.08,1603.01,0.00
2024-12-10 17:18:39,114,1460,56,58,800.63,1603.03,0.00
2024-12-10 17:18:39,113,1460,56,57,807.16,1603.05,0.00
2024-12-10 17:18:39,112,1460,55,57,813.68,1603.09,0.00
2024-12-10 17:18:39,112,1461,55,57,813.89,1604.00,0.00
2024-12-10 17:18:39,113,1461,55,58,806.68,1604.01,0.00
2024-12-10 17:18:39,112,1461,54,58,813.04,1604.05,0.00
2024-12-10 17:18:39,112,1462,54,58,812.67,1605.00,0.00
2024-12-10 17:18:39,113,1462,55,58,805.48,1605.01,0.00
2024-12-10 17:18:39,112,1462,54,58,812.11,1605.04,0.00
2024-12-10 17:18:39,111,1462,53,58,819.15,1605.05,0.00
2024-12-10 17:18:39,110,1462,52,58,826.45,1605.05,0.00
2024-12-10 17:18:39,110,1463,52,58,826.21,1606.00,0.00
2024-12-10 17:18:39,111,1463,53,58,818.77,1606.01,0.00
2024-12-10 17:18:39,110,1463,53,57,825.50,1606.05,0.00
2024-12-10 17:18:39,110,1464,53,57,825.27,1607.00,0.00
2024-12-10 17:18:39,111,1464,53,58,817.83,1607.01,0.00
2024-12-10 17:18:39,111,1465,53,58,816.89,1608.00,0.00
2024-12-10 17:18:39,112,1465,53,59,809.60,1608.01,0.00
2024-12-10 17:18:39,111,1465,53,58,816.18,1608.05,0.00
2024-12-10 17:18:39,111,1466,53,58,815.57,1609.00,0.00
2024-12-10 17:18:39,112,1466,54,58,808.28,1609.01,0.00
2024-12-10 17:18:39,111,1466,54,57,814.86,1609.05,0.00
2024-12-10 17:18:39,111,1467,54,57,813.69,1610.00,0.00
2024-12-10 17:18:39,112,1467,54,58,806.43,1610.01,0.00
2024-12-10 17:18:39,111,1467,54,57,812.98,1610.05,0.00
2024-12-10 17:18:39,111,1468,54,57,811.59,1611.00,0.00
2024-12-10 17:18:39,112,1468,55,57,804.34,1611.01,0.00
2024-12-10 17:18:39,111,1468,55,56,810.88,1611.05,0.00
2024-12-10 17:18:39,111,1469,55,56,809.39,1612.00,0.00
2024-12-10 17:18:39,112,1469,56,56,802.17,1612.01,0.00
2024-12-10 17:18:39,111,1469,56,55,808.68,1612.05,0.00
2024-12-10 17:18:39,110,1469,55,55,811.04,1612.30,0.00
2024-12-10 17:18:39,110,1470,55,55,814.86,1613.00,0.00
2024-12-10 17:18:39,111,1470,55,56,807.52,1613.01,0.00
2024-12-10 17:18:39,110,1470,54,56,814.14,1613.05,0.00
2024-12-10 17:18:39,110,1471,54,56,813.90,1614.00,0.00
2024-12-10 17:18:39,111,1471,55,56,806.56,1614.01,0.00
2024-12-10 17:18:39,110,1471,55,55,813.18,1614.05,0.00
2024-12-10 17:18:39,111,1470,56,55,793.26,1614.87,0.00
2024-12-10 17:18:39,111,1471,56,55,807.79,1615.00,0.00
2024-12-10 17:18:39,112,1471,57,55,800.58,1615.01,0.00
2024-12-10 17:18:39,111,1471,57,54,807.08,1615.05,0.00
2024-12-10 17:18:39,111,1472,57,54,821.22,1616.00,0.00
2024-12-10 17:18:39,112,1472,58,54,813.89,1616.01,0.00
2024-12-10 17:18:39,111,1472,58,53,820.51,1616.05,0.00
2024-12-10 17:18:39,111,1473,58,53,820.07,1617.00,0.00
2024-12-10 17:18:39,112,1473,58,54,812.75,1617.01,0.00
2024-12-10 17:18:39,111,1473,57,54,819.36,1617.05,0.00
2024-12-10 17:18:39,111,1474,57,54,818.12,1618.00,0.00
2024-12-10 17:18:39,112,1474,57,55,810.81,1618.01,0.00
2024-12-10 17:18:39,111,1474,57,54,817.40,1618.05,0.00
2024-12-10 17:18:39,111,1475,57,54,811.05,1619.00,0.00
2024-12-10 17:18:39,112,1475,57,55,803.81,1619.01,0.00
2024-12-10 17:18:39,111,1475,56,55,810.33,1619.05,0.00
2024-12-10 17:18:39,110,1475,55,55,806.24,1619.56,0.00
2024-12-10 17:18:39,110,1476,55,55,814.09,1620.00,0.00
2024-12-10 17:18:39,111,1476,56,55,806.76,1620.01,0.00
2024-12-10 17:18:39,110,1476,55,55,813.37,1620.05,0.00
2024-12-10 17:18:39,110,1477,55,55,812.40,1621.00,0.00
2024-12-10 17:18:39,111,1477,56,55,805.08,1621.01,0.00
2024-12-10 17:18:39,111,1478,56,55,803.29,1622.00,0.00
2024-12-10 17:18:39,112,1478,56,56,796.12,1622.01,0.00
2024-12-10 17:18:39,112,1479,56,56,794.04,1623.00,0.00
2024-12-10 17:18:39,113,1479,56,57,787.01,1623.01,0.00
2024-12-10 17:18:39,112,1479,56,56,793.04,1623.06,0.00
2024-12-10 17:18:39,113,1478,57,56,781.52,1623.32,0.00
2024-12-10 17:18:39,113,1479,57,56,794.89,1624.00,0.00
2024-12-10 17:18:39,114,1479,58,56,787.92,1624.01,0.00
2024-12-10 17:18:39,113,1479,58,55,794.75,1624.01,0.00
2024-12-10 17:18:39,112,1479,58,54,800.85,1624.06,0.00
2024-12-10 17:18:39,111,1479,57,54,805.88,1624.14,0.00
2024-12-10 17:18:39,111,1480,57,54,820.65,1625.00,0.00
2024-12-10 17:18:39,112,1480,58,54,813.32,1625.01,0.00
2024-12-10 17:18:39,111,1480,57,54,819.64,1625.06,0.00
2024-12-10 17:18:39,110,1480,57,53,826.44,1625.09,0.00
2024-12-10 17:18:39,109,1480,56,53,828.50,1625.37,0.00
2024-12-10 17:18:39,109,1481,56,53,833.56,1626.00,0.00
2024-12-10 17:18:39,110,1481,57,53,825.98,1626.01,0.00
2024-12-10 17:18:39,109,1481,57,52,832.53,1626.06,0.00
2024-12-10 17:18:40,109,1482,57,52,830.60,1627.00,0.00
2024-12-10 17:18:40,110,1482,57,53,823.05,1627.01,0.00
2024-12-10 17:18:40,109,1482,56,53,829.57,1627.06,0.00
2024-12-10 17:18:40,108,1482,55,53,835.89,1627.13,0.00
2024-12-10 17:18:40,108,1483,55,53,835.54,1628.00,0.00
2024-12-10 17:18:40,109,1483,55,54,827.88,1628.01,0.00
2024-12-10 17:18:40,108,1483,55,53,834.50,1628.07,0.00
2024-12-10 17:18:40,108,1484,55,53,832.43,1629.00,0.00
2024-12-10 17:18:40,109,1484,56,53,824.79,1629.01,0.00
2024-12-10 17:18:40,108,1484,56,52,831.69,1629.05,0.00
2024-12-10 17:18:40,107,1484,55,52,839.16,1629.06,0.00
2024-12-10 17:18:40,107,1485,55,52,837.68,1630.00,0.00
2024-12-10 17:18:40,108,1485,56,52,829.93,1630.01,0.00
2024-12-10 17:18:40,107,1485,55,52,836.78,1630.06,0.00
2024-12-10 17:18:40,107,1486,55,52,836.37,1631.00,0.00
2024-12-10 17:18:40,108,1486,56,52,828.62,1631.01,0.00
2024-12-10 17:18:40,107,1486,56,51,835.47,1631.06,0.00
2024-12-10 17:18:40,107,1487,56,51,835.37,1632.00,0.00
2024-12-10 17:18:40,108,1487,56,52,827.63,1632.01,0.00
2024-12-10 17:18:40,108,1488,56,52,826.75,1633.00,0.00
2024-12-10 17:18:40,109,1488,57,52,819.17,1633.01,0.00
2024-12-10 17:18:40,110,1487,57,53,811.72,1633.03,0.00
2024-12-10 17:18:40,109,1487,57,52,832.37,1633.06,0.00
2024-12-10 17:18:40,109,1488,57,52,831.94,1634.00,0.00
2024-12-10 17:18:40,110,1488,58,52,824.37,1634.01,0.00
2024-12-10 17:18:40,110,1489,58,52,837.91,1635.00,0.00
2024-12-10 17:18:40,111,1489,59,52,830.36,1635.01,0.00
2024-12-10 17:18:40,110,1489,59,51,837.04,1635.06,0.00
2024-12-10 17:18:40,110,1490,59,51,836.42,1636.00,0.00
2024-12-10 17:18:40,111,1490,59,52,828.89,1636.01,0.00
2024-12-10 17:18:40,110,1490,59,51,835.55,1636.06,0.00
2024-12-10 17:18:40,109,1490,58,51,840.31,1636.21,0.00
2024-12-10 17:18:40,109,1491,58,51,842.88,1637.00,0.00
2024-12-10 17:18:40,110,1491,59,51,835.22,1637.01,0.00
2024-12-10 17:18:40,110,1492,59,51,834.39,1638.00,0.00
2024-12-10 17:18:40,111,1492,60,51,826.87,1638.01,0.00
2024-12-10 17:18:40,110,1492,59,51,833.52,1638.06,0.00
2024-12-10 17:18:40,109,1492,58,51,839.81,1638.14,0.00
2024-12-10 17:18:40,109,1493,58,51,841.20,1639.00,0.00
2024-12-10 17:18:40,110,1493,59,51,833.55,1639.01,0.00
2024-12-10 17:18:40,109,1493,58,51,840.32,1639.06,0.00
2024-12-10 17:18:40,109,1494,58,51,840.36,1640.00,0.00
2024-12-10 17:18:40,110,1494,59,51,832.72,1640.01,0.00
2024-12-10 17:18:40,109,1494,59,50,839.48,1640.06,0.00
2024-12-10 17:18:40,109,1495,59,50,839.52,1641.00,0.00
2024-12-10 17:18:40,110,1495,59,51,831.89,1641.01,0.00
2024-12-10 17:18:40,109,1495,58,51,838.63,1641.06,0.00
2024-12-10 17:18:40,109,1496,58,51,838.63,1642.00,0.00
2024-12-10 17:18:40,110,1496,58,52,831.01,1642.01,0.00
2024-12-10 17:18:40,109,1496,57,52,837.74,1642.06,0.00
2024-12-10 17:18:40,109,1497,57,52,837.66,1643.00,0.00
2024-12-10 17:18:40,110,1497,58,52,830.04,1643.01,0.00
2024-12-10 17:18:40,109,1497,58,51,836.77,1643.06,0.00
2024-12-10 17:18:40,110,1496,58,52,826.79,1643.21,0.00
2024-12-10 17:18:40,109,1496,58,51,846.26,1643.22,0.00
2024-12-10 17:18:40,109,1497,58,51,848.98,1644.00,0.00
2024-12-10 17:18:40,110,1497,59,51,841.27,1644.01,0.00
2024-12-10 17:18:40,109,1497,59,50,848.10,1644.06,0.00
2024-12-10 17:18:40,108,1497,59,49,855.33,1644.08,0.00
2024-12-10 17:18:40,107,1497,59,48,854.47,1644.32,0.00
2024-12-10 17:18:40,107,1498,59,48,874.41,1645.00,0.00
2024-12-10 17:18:40,108,1498,60,48,866.32,1645.01,0.00
2024-12-10 17:18:40,107,1498,59,48,873.51,1645.06,0.00
2024-12-10 17:18:40,106,1498,59,47,879.43,1645.20,0.00
2024-12-10 17:18:40,106,1499,59,47,882.24,1646.00,0.00
2024-12-10 17:18:40,107,1499,59,48,874.00,1646.01,0.00
2024-12-10 17:18:40,106,1499,58,48,881.33,1646.06,0.00
2024-12-10 17:18:40,106,1500,58,48,881.80,1647.00,0.00
2024-12-10 17:18:40,107,1500,58,49,873.55,1647.01,0.00
2024-12-10 17:18:40,106,1500,58,48,880.88,1647.06,0.00
2024-12-10 17:18:40,106,1501,58,48,881.40,1648.00,0.00
2024-12-10 17:18:40,107,1501,58,49,873.16,1648.01,0.00
2024-12-10 17:18:40,107,1502,58,49,872.77,1649.00,0.00
2024-12-10 17:18:40,108,1502,58,50,864.69,1649.01,0.00
2024-12-10 17:18:40,108,1503,58,50,864.07,1650.00,0.00
2024-12-10 17:18:40,109,1503,59,50,856.14,1650.01,0.00
2024-12-10 17:18:40,108,1503,58,50,863.47,1650.04,0.00
2024-12-10 17:18:40,107,1503,57,50,871.09,1650.06,0.00
2024-12-10 17:18:40,106,1503,57,49,878.56,1650.09,0.00
2024-12-10 17:18:40,106,1504,57,49,879.10,1651.00,0.00
2024-12-10 17:18:40,107,1504,57,50,870.88,1651.01,0.00
2024-12-10 17:18:40,106,1504,57,49,878.18,1651.06,0.00
2024-12-10 17:18:40,106,1505,57,49,877.70,1652.00,0.00
2024-12-10 17:18:40,107,1505,58,49,869.50,1652.01,0.00
2024-12-10 17:18:40,106,1505,58,48,876.78,1652.06,0.00
2024-12-10 17:18:40,106,1506,58,48,875.93,1653.00,0.00
2024-12-10 17:18:40,107,1506,58,49,867.74,1653.01,0.00
2024-12-10 17:18:40,106,1506,57,49,875.01,1653.06,0.00
2024-12-10 17:18:40,106,1507,57,49,874.05,1654.00,0.00
2024-12-10 17:18:40,107,1507,57,50,865.88,1654.01,0.00
2024-12-10 17:18:40,107,1508,57,50,864.69,1655.00,0.00
2024-12-10 17:18:40,108,1508,58,50,856.68,1655.01,0.00
2024-12-10 17:18:40,108,1509,58,50,855.50,1656.00,0.00
2024-12-10 17:18:40,109,1509,58,51,847.66,1656.01,0.00
2024-12-10 17:18:40,108,1509,58,50,854.60,1656.06,0.00
2024-12-10 17:18:40,108,1510,58,50,854.27,1657.00,0.00
2024-12-10 17:18:40,109,1510,59,50,846.43,1657.01,0.00
2024-12-10 17:18:41,109,1511,59,50,844.94,1658.00,0.00
2024-12-10 17:18:41,110,1511,60,50,837.26,1658.01,0.00
2024-12-10 17:18:41,109,1511,60,49,844.05,1658.06,0.00
2024-12-10 17:18:41,110,1510,61,49,826.61,1658.65,0.00
2024-12-10 17:18:41,110,1511,61,49,841.53,1659.00,0.00
2024-12-10 17:18:41,111,1511,62,49,833.95,1659.01,0.00
2024-12-10 17:18:41,110,1511,61,49,840.64,1659.06,0.00
2024-12-10 17:18:41,110,1512,61,49,855.40,1660.00,0.00
2024-12-10 17:18:41,111,1512,61,50,847.69,1660.01,0.00
2024-12-10 17:18:41,110,1512,61,49,854.51,1660.06,0.00
2024-12-10 17:18:41,109,1512,60,49,847.36,1660.50,0.00
2024-12-10 17:18:41,109,1513,60,49,854.60,1661.00,0.00
2024-12-10 17:18:41,110,1513,61,49,846.83,1661.01,0.00
2024-12-10 17:18:41,110,1514,61,49,845.83,1662.00,0.00
2024-12-10 17:18:41,111,1514,61,50,838.21,1662.01,0.00
2024-12-10 17:18:41,111,1515,61,50,837.06,1663.00,0.00
2024-12-10 17:18:41,112,1515,61,51,829.59,1663.01,0.00
2024-12-10 17:18:41,111,1515,60,51,835.69,1663.06,0.00
2024-12-10 17:18:41,111,1516,60,51,835.58,1664.00,0.00
2024-12-10 17:18:41,112,1516,61,51,828.12,1664.01,0.00
2024-12-10 17:18:41,111,1516,60,51,834.99,1664.04,0.00
2024-12-10 17:18:41,111,1517,60,51,833.93,1665.00,0.00
2024-12-10 17:18:41,112,1517,61,51,826.48,1665.01,0.00
2024-12-10 17:18:41,112,1518,61,51,824.64,1666.00,0.00
2024-12-10 17:18:41,113,1518,61,52,817.34,1666.01,0.00
2024-12-10 17:18:41,112,1518,61,51,822.70,1666.06,0.00
2024-12-10 17:18:41,111,1518,60,51,829.96,1666.06,0.00
2024-12-10 17:18:41,111,1519,60,51,829.78,1667.00,0.00
2024-12-10 17:18:41,112,1519,61,51,822.37,1667.01,0.00
2024-12-10 17:18:41,111,1519,61,50,828.25,1667.05,0.00
2024-12-10 17:18:41,110,1519,61,49,835.48,1667.06,0.00
2024-12-10 17:18:41,110,1520,61,49,835.17,1668.00,0.00
2024-12-10 17:18:41,111,1520,61,50,827.64,1668.01,0.00
2024-12-10 17:18:41,110,1520,61,49,834.27,1668.06,0.00
2024-12-10 17:18:41,110,1521,61,49,833.54,1669.00,0.00
2024-12-10 17:18:41,111,1521,61,50,826.03,1669.01,0.00
2024-12-10 17:18:41,110,1521,60,50,832.64,1669.06,0.00
2024-12-10 17:18:41,110,1522,60,50,831.85,1670.00,0.00
2024-12-10 17:18:41,111,1522,60,51,824.35,1670.01,0.00
2024-12-10 17:18:41,110,1522,59,51,830.95,1670.06,0.00
2024-12-10 17:18:41,110,1523,59,51,819.96,1671.00,0.00
2024-12-10 17:18:41,111,1523,59,52,812.57,1671.01,0.00
2024-12-10 17:18:41,110,1523,59,51,819.66,1671.02,0.00
2024-12-10 17:18:41,109,1523,58,51,826.58,1671.05,0.00
2024-12-10 17:18:41,108,1523,57,51,834.08,1671.05,0.00
2024-12-10 17:18:41,107,1523,56,51,820.24,1671.89,0.00
2024-12-10 17:18:41,107,1524,56,51,834.09,1672.00,0.00
2024-12-10 17:18:41,108,1524,56,52,826.37,1672.01,0.00
2024-12-10 17:18:41,108,1525,56,52,821.27,1673.00,0.00
2024-12-10 17:18:41,109,1525,56,53,813.74,1673.01,0.00
2024-12-10 17:18:41,108,1525,56,52,820.51,1673.05,0.00
2024-12-10 17:18:41,107,1525,55,52,817.27,1673.50,0.00
2024-12-10 17:18:41,107,1526,55,52,824.84,1674.00,0.00
2024-12-10 17:18:41,108,1526,56,52,817.20,1674.01,0.00
2024-12-10 17:18:41,107,1526,56,51,824.07,1674.05,0.00
2024-12-10 17:18:41,107,1527,56,51,823.31,1675.00,0.00
2024-12-10 17:18:41,108,1527,57,51,815.69,1675.01,0.00
2024-12-10 17:18:41,107,1527,57,50,822.54,1675.05,0.00
2024-12-10 17:18:41,107,1528,57,50,821.06,1676.00,0.00
2024-12-10 17:18:41,108,1528,57,51,813.46,1676.01,0.00
2024-12-10 17:18:41,107,1528,56,51,816.18,1676.30,0.00
2024-12-10 17:18:41,107,1529,56,51,820.54,1677.00,0.00
2024-12-10 17:18:41,108,1529,57,51,812.94,1677.01,0.00
2024-12-10 17:18:41,107,1529,56,51,819.77,1677.05,0.00
2024-12-10 17:18:41,107,1530,56,51,819.93,1678.00,0.00
2024-12-10 17:18:41,108,1530,56,52,812.34,1678.01,0.00
2024-12-10 17:18:41,107,1530,56,51,819.16,1678.05,0.00
2024-12-10 17:18:41,107,1531,56,51,819.32,1679.00,0.00
2024-12-10 17:18:41,108,1531,57,51,811.74,1679.01,0.00
2024-12-10 17:18:41,107,1531,56,51,818.55,1679.05,0.00
2024-12-10 17:18:41,107,1532,56,51,818.71,1680.00,0.00
2024-12-10 17:18:41,108,1532,57,51,811.13,1680.01,0.00
2024-12-10 17:18:41,107,1532,56,51,817.94,1680.05,0.00
2024-12-10 17:18:41,107,1533,56,51,818.10,1681.00,0.00
2024-12-10 17:18:41,108,1533,57,51,810.53,1681.01,0.00
2024-12-10 17:18:41,107,1533,56,51,817.33,1681.05,0.00
2024-12-10 17:18:41,107,1534,56,51,817.49,1682.00,0.00
2024-12-10 17:18:41,108,1534,56,52,809.92,1682.01,0.00
2024-12-10 17:18:41,107,1534,56,51,816.71,1682.05,0.00
2024-12-10 17:18:41,107,1535,56,51,816.87,1683.00,0.00
2024-12-10 17:18:41,108,1535,56,52,809.31,1683.01,0.00
2024-12-10 17:18:41,107,1535,56,51,816.56,1683.02,0.00
2024-12-10 17:18:41,106,1535,56,50,823.79,1683.04,0.00
2024-12-10 17:18:41,105,1535,55,50,831.48,1683.04,0.00
2024-12-10 17:18:41,105,1536,55,50,831.80,1684.00,0.00
2024-12-10 17:18:41,106,1536,55,51,823.96,1684.01,0.00
2024-12-10 17:18:41,105,1536,55,50,831.17,1684.04,0.00
2024-12-10 17:18:41,104,1536,55,49,823.73,1684.49,0.00
2024-12-10 17:18:41,104,1537,55,49,831.71,1685.00,0.00
2024-12-10 17:18:41,105,1537,56,49,823.79,1685.01,0.00
2024-12-10 17:18:41,104,1537,55,49,831.07,1685.04,0.00
2024-12-10 17:18:41,104,1538,55,49,831.56,1686.00,0.00
2024-12-10 17:18:41,105,1538,55,50,823.64,1686.01,0.00
2024-12-10 17:18:41,104,1538,54,50,830.92,1686.04,0.00
2024-12-10 17:18:41,104,1539,54,50,831.40,1687.00,0.00
2024-12-10 17:18:41,105,1539,55,50,823.48,1687.01,0.00
2024-12-10 17:18:41,104,1539,54,50,830.76,1687.04,0.00
2024-12-10 17:18:42,104,1540,54,50,831.25,1688.00,0.00
2024-12-10 17:18:42,105,1540,54,51,823.33,1688.01,0.00
2024-12-10 17:18:42,104,1540,54,50,830.61,1688.04,0.00
2024-12-10 17:18:42,104,1541,54,50,831.09,1689.00,0.00
2024-12-10 17:18:42,105,1541,54,51,823.17,1689.01,0.00
2024-12-10 17:18:42,104,1541,54,50,830.45,1689.04,0.00
2024-12-10 17:18:42,104,1542,54,50,830.93,1690.00,0.00
2024-12-10 17:18:42,105,1542,54,51,823.02,1690.01,0.00
2024-12-10 17:18:42,104,1542,54,50,830.29,1690.04,0.00
2024-12-10 17:18:42,104,1543,54,50,830.74,1691.00,0.00
2024-12-10 17:18:42,105,1543,55,50,822.83,1691.01,0.00
2024-12-10 17:18:42,104,1543,54,50,830.10,1691.04,0.00
2024-12-10 17:18:42,104,1544,54,50,830.37,1692.00,0.00
2024-12-10 17:18:42,105,1544,55,50,822.46,1692.01,0.00
2024-12-10 17:18:42,104,1544,54,50,829.73,1692.04,0.00
2024-12-10 17:18:42,104,1545,54,50,829.63,1693.00,0.00
2024-12-10 17:18:42,105,1545,55,50,821.73,1693.01,0.00
2024-12-10 17:18:42,104,1545,54,50,828.98,1693.04,0.00
2024-12-10 17:18:42,104,1546,54,50,828.30,1694.00,0.00
2024-12-10 17:18:42,105,1546,54,51,820.41,1694.01,0.00
2024-12-10 17:18:42,104,1546,53,51,827.66,1694.04,0.00
2024-12-10 17:18:42,103,1546,53,50,832.62,1694.18,0.00
2024-12-10 17:18:42,104,1545,53,51,820.76,1694.42,0.00
2024-12-10 17:18:42,104,1546,53,51,837.30,1695.00,0.00
2024-12-10 17:18:42,105,1546,53,52,829.33,1695.01,0.00
2024-12-10 17:18:42,104,1546,52,52,836.66,1695.04,0.00
2024-12-10 17:18:42,104,1547,52,52,853.45,1696.00,0.00
2024-12-10 17:18:42,105,1547,52,53,845.32,1696.01,0.00
2024-12-10 17:18:42,104,1547,52,52,852.80,1696.04,0.00
2024-12-10 17:18:42,104,1548,52,52,853.30,1697.00,0.00
2024-12-10 17:18:42,105,1548,53,52,845.17,1697.01,0.00
2024-12-10 17:18:42,104,1548,53,51,852.65,1697.04,0.00
2024-12-10 17:18:42,104,1549,53,51,853.15,1698.00,0.00
2024-12-10 17:18:42,105,1549,54,51,845.03,1698.01,0.00
2024-12-10 17:18:42,104,1549,53,51,852.50,1698.04,0.00
2024-12-10 17:18:42,104,1550,53,51,853.00,1699.00,0.00
2024-12-10 17:18:42,105,1550,54,51,844.88,1699.01,0.00
2024-12-10 17:18:42,105,1551,54,51,844.73,1700.00,0.00
2024-12-10 17:18:42,106,1551,55,51,836.76,1700.01,0.00
2024-12-10 17:18:42,105,1551,54,51,844.25,1700.03,0.00
2024-12-10 17:18:42,104,1551,54,50,852.04,1700.04,0.00
2024-12-10 17:18:42,103,1551,53,50,860.14,1700.04,0.00
2024-12-10 17:18:42,103,1552,53,50,860.81,1701.00,0.00
2024-12-10 17:18:42,104,1552,54,50,852.53,1701.01,0.00
2024-12-10 17:18:42,103,1552,54,49,860.15,1701.04,0.00
2024-12-10 17:18:42,103,1553,54,49,860.82,1702.00,0.00
2024-12-10 17:18:42,104,1553,54,50,852.54,1702.01,0.00
2024-12-10 17:18:42,105,1552,55,50,837.39,1702.45,0.00
2024-12-10 17:18:42,105,1553,55,50,853.84,1703.00,0.00
2024-12-10 17:18:42,106,1553,55,51,845.78,1703.01,0.00
2024-12-10 17:18:42,105,1553,54,51,853.20,1703.04,0.00
2024-12-10 17:18:42,105,1554,54,51,869.76,1704.00,0.00
2024-12-10 17:18:42,106,1554,54,52,861.55,1704.01,0.00
2024-12-10 17:18:42,105,1554,54,51,869.11,1704.04,0.00
2024-12-10 17:18:42,105,1555,54,51,869.46,1705.00,0.00
2024-12-10 17:18:42,106,1555,55,51,861.25,1705.01,0.00
2024-12-10 17:18:42,105,1555,54,51,868.91,1705.04,0.00
2024-12-10 17:18:42,105,1556,54,51,869.25,1706.00,0.00
2024-12-10 17:18:42,106,1556,54,52,861.05,1706.01,0.00
2024-12-10 17:18:42,105,1556,53,52,868.60,1706.04,0.00
2024-12-10 17:18:42,105,1557,53,52,868.94,1707.00,0.00
2024-12-10 17:18:42,106,1557,53,53,860.75,1707.01,0.00
2024-12-10 17:18:42,105,1557,53,52,868.30,1707.04,0.00
2024-12-10 17:18:42,105,1558,53,52,868.43,1708.00,0.00
2024-12-10 17:18:42,106,1558,53,53,860.24,1708.01,0.00
2024-12-10 17:18:42,105,1558,53,52,867.78,1708.04,0.00
2024-12-10 17:18:42,105,1559,53,52,867.47,1709.00,0.00
2024-12-10 17:18:42,106,1559,54,52,859.29,1709.01,0.00
2024-12-10 17:18:42,105,1559,53,52,865.90,1709.09,0.00
2024-12-10 17:18:42,105,1560,53,52,867.05,1710.00,0.00
2024-12-10 17:18:42,106,1560,53,53,858.87,1710.01,0.00
2024-12-10 17:18:42,106,1561,53,53,858.57,1711.00,0.00
2024-12-10 17:18:42,107,1561,53,54,850.54,1711.01,0.00
2024-12-10 17:18:42,106,1561,52,54,857.92,1711.04,0.00
2024-12-10 17:18:42,106,1562,52,54,858.10,1712.00,0.00
2024-12-10 17:18:42,107,1562,53,54,850.08,1712.01,0.00
2024-12-10 17:18:42,106,1562,52,54,857.46,1712.04,0.00
2024-12-10 17:18:42,106,1563,52,54,857.63,1713.00,0.00
2024-12-10 17:18:42,107,1563,52,55,849.62,1713.01,0.00
2024-12-10 17:18:42,106,1563,52,54,856.99,1713.04,0.00
2024-12-10 17:18:42,106,1564,52,54,857.16,1714.00,0.00
2024-12-10 17:18:42,107,1564,53,54,849.15,1714.01,0.00
2024-12-10 17:18:42,106,1564,53,53,856.68,1714.03,0.00
2024-12-10 17:18:42,105,1564,52,53,864.67,1714.03,0.00
2024-12-10 17:18:42,104,1564,51,53,872.82,1714.03,0.00
2024-12-10 17:18:42,104,1565,51,53,873.17,1715.00,0.00
2024-12-10 17:18:42,105,1565,52,53,864.85,1715.01,0.00
2024-12-10 17:18:42,105,1566,52,53,864.70,1716.00,0.00
2024-12-10 17:18:42,106,1566,53,53,856.54,1716.01,0.00
2024-12-10 17:18:42,105,1566,52,53,864.21,1716.03,0.00
2024-12-10 17:18:42,105,1567,52,53,864.39,1717.00,0.00
2024-12-10 17:18:42,106,1567,52,54,856.23,1717.01,0.00
2024-12-10 17:18:42,105,1567,52,53,863.90,1717.03,0.00
2024-12-10 17:18:42,105,1568,52,53,864.07,1718.00,0.00
2024-12-10 17:18:42,106,1568,52,54,855.92,1718.01,0.00
2024-12-10 17:18:42,105,1568,52,53,863.58,1718.03,0.00
2024-12-10 17:18:42,105,1569,52,53,863.76,1719.00,0.00
2024-12-10 17:18:42,106,1569,53,53,855.61,1719.01,0.00
2024-12-10 17:18:43,105,1569,53,52,863.27,1719.03,0.00
2024-12-10 17:18:43,105,1570,53,52,863.44,1720.00,0.00
2024-12-10 17:18:43,106,1570,53,53,855.29,1720.01,0.00
2024-12-10 17:18:43,107,1569,54,53,847.14,1720.04,0.00
2024-12-10 17:18:43,106,1569,53,53,870.56,1720.04,0.00
2024-12-10 17:18:43,106,1570,53,53,870.73,1721.00,0.00
2024-12-10 17:18:43,107,1570,53,54,862.59,1721.01,0.00
2024-12-10 17:18:43,107,1571,53,54,878.22,1722.00,0.00
2024-12-10 17:18:43,108,1571,53,55,870.09,1722.01,0.00
2024-12-10 17:18:43,107,1571,53,54,877.75,1722.03,0.00
2024-12-10 17:18:43,107,1572,53,54,877.60,1723.00,0.00
2024-12-10 17:18:43,108,1572,53,55,869.48,1723.01,0.00
2024-12-10 17:18:43,107,1572,53,54,877.13,1723.03,0.00
2024-12-10 17:18:43,106,1572,52,54,885.24,1723.03,0.00
2024-12-10 17:18:43,106,1573,52,54,885.26,1724.00,0.00
2024-12-10 17:18:43,107,1573,52,55,876.98,1724.01,0.00
2024-12-10 17:18:43,106,1573,51,55,884.78,1724.03,0.00
2024-12-10 17:18:43,106,1574,51,55,884.79,1725.00,0.00
2024-12-10 17:18:43,107,1574,51,56,876.53,1725.01,0.00
2024-12-10 17:18:43,106,1574,50,56,884.32,1725.03,0.00
2024-12-10 17:18:43,106,1575,50,56,884.33,1726.00,0.00
2024-12-10 17:18:43,107,1575,50,57,876.07,1726.01,0.00
2024-12-10 17:18:43,106,1575,49,57,883.85,1726.03,0.00
2024-12-10 17:18:43,106,1576,49,57,883.86,1727.00,0.00
2024-12-10 17:18:43,107,1576,50,57,875.60,1727.01,0.00
2024-12-10 17:18:43,106,1576,50,56,883.39,1727.03,0.00
2024-12-10 17:18:43,106,1577,50,56,883.40,1728.00,0.00
2024-12-10 17:18:43,107,1577,50,57,875.14,1728.01,0.00
2024-12-10 17:18:43,106,1577,50,56,882.92,1728.03,0.00
2024-12-10 17:18:43,106,1578,50,56,882.93,1729.00,0.00
2024-12-10 17:18:43,107,1578,50,57,874.68,1729.01,0.00
2024-12-10 17:18:43,106,1578,49,57,882.45,1729.03,0.00
2024-12-10 17:18:43,106,1579,49,57,882.46,1730.00,0.00
2024-12-10 17:18:43,107,1579,49,58,874.22,1730.01,0.00
2024-12-10 17:18:43,106,1579,48,58,881.98,1730.03,0.00
2024-12-10 17:18:43,107,1578,49,58,869.10,1730.32,0.00
2024-12-10 17:18:43,108,1577,49,59,867.44,1730.62,0.00
2024-12-10 17:18:43,108,1578,49,59,883.29,1731.00,0.00
2024-12-10 17:18:43,109,1578,50,59,875.19,1731.01,0.00
2024-12-10 17:18:43,108,1578,49,59,882.82,1731.03,0.00
2024-12-10 17:18:43,108,1579,49,59,914.59,1732.00,0.00
2024-12-10 17:18:43,109,1579,50,59,906.20,1732.01,0.00
2024-12-10 17:18:43,108,1579,50,58,903.12,1732.35,0.00
2024-12-10 17:18:43,108,1580,50,58,908.38,1733.00,0.00
2024-12-10 17:18:43,109,1580,51,58,900.05,1733.01,0.00
2024-12-10 17:18:43,108,1580,50,58,908.22,1733.01,0.00
2024-12-10 17:18:43,107,1580,49,58,916.39,1733.02,0.00
2024-12-10 17:18:43,106,1580,49,57,924.87,1733.02,0.00
2024-12-10 17:18:43,106,1581,49,57,924.74,1734.00,0.00
2024-12-10 17:18:43,107,1581,49,58,916.10,1734.01,0.00
2024-12-10 17:18:43,107,1582,49,58,915.66,1735.00,0.00
2024-12-10 17:18:43,108,1582,50,58,907.18,1735.01,0.00
2024-12-10 17:18:43,107,1582,49,58,915.18,1735.03,0.00
2024-12-10 17:18:43,107,1583,49,58,915.05,1736.00,0.00
2024-12-10 17:18:43,108,1583,49,59,906.58,1736.01,0.00
2024-12-10 17:18:43,107,1583,49,58,914.58,1736.03,0.00
2024-12-10 17:18:43,107,1584,49,58,914.44,1737.00,0.00
2024-12-10 17:18:43,108,1584,49,59,905.97,1737.01,0.00
2024-12-10 17:18:43,107,1584,48,59,913.97,1737.03,0.00
2024-12-10 17:18:43,108,1583,48,60,895.73,1737.62,0.00
2024-12-10 17:18:43,108,1584,48,60,911.48,1738.00,0.00
2024-12-10 17:18:43,109,1584,49,60,903.12,1738.01,0.00
2024-12-10 17:18:43,108,1584,48,60,911.01,1738.03,0.00
2024-12-10 17:18:43,108,1585,48,60,926.82,1739.00,0.00
2024-12-10 17:18:43,109,1585,49,60,918.32,1739.01,0.00
2024-12-10 17:18:43,108,1585,48,60,926.35,1739.03,0.00
2024-12-10 17:18:43,108,1586,48,60,926.07,1740.00,0.00
2024-12-10 17:18:43,109,1586,48,61,917.57,1740.01,0.00
2024-12-10 17:18:43,108,1586,47,61,925.60,1740.03,0.00
2024-12-10 17:18:43,108,1587,47,61,925.31,1741.00,0.00
2024-12-10 17:18:43,109,1587,47,62,916.82,1741.01,0.00
2024-12-10 17:18:43,108,1587,47,61,924.84,1741.03,0.00
2024-12-10 17:18:43,109,1586,47,62,914.77,1741.14,0.00
2024-12-10 17:18:43,109,1587,47,62,930.45,1742.00,0.00
2024-12-10 17:18:43,110,1587,47,63,921.99,1742.01,0.00
2024-12-10 17:18:43,109,1587,47,62,929.98,1742.03,0.00
2024-12-10 17:18:43,109,1588,47,62,945.54,1743.00,0.00
2024-12-10 17:18:43,110,1588,48,62,936.94,1743.01,0.00
2024-12-10 17:18:43,109,1588,47,62,945.07,1743.03,0.00
2024-12-10 17:18:43,108,1588,47,61,953.66,1743.03,0.00
2024-12-10 17:18:43,108,1589,47,61,953.39,1744.00,0.00
2024-12-10 17:18:43,109,1589,48,61,944.64,1744.01,0.00
2024-12-10 17:18:43,110,1588,48,62,935.75,1744.05,0.00
2024-12-10 17:18:43,110,1589,48,62,941.94,1745.00,0.00
2024-12-10 17:18:43,111,1589,49,62,933.46,1745.01,0.00
2024-12-10 17:18:43,110,1589,48,62,941.33,1745.04,0.00
2024-12-10 17:18:43,110,1590,48,62,956.77,1746.00,0.00
2024-12-10 17:18:43,111,1590,49,62,948.15,1746.01,0.00
2024-12-10 17:18:43,110,1590,49,61,956.15,1746.04,0.00
2024-12-10 17:18:43,111,1589,50,61,936.09,1746.72,0.00
2024-12-10 17:18:43,111,1590,50,61,951.13,1747.00,0.00
2024-12-10 17:18:43,112,1590,50,62,942.63,1747.01,0.00
2024-12-10 17:18:43,111,1590,50,61,950.52,1747.04,0.00
2024-12-10 17:18:43,110,1590,50,60,958.94,1747.04,0.00
2024-12-10 17:18:43,110,1591,50,60,974.33,1748.00,0.00
2024-12-10 17:18:43,111,1591,50,61,965.56,1748.01,0.00
2024-12-10 17:18:44,111,1592,50,61,964.41,1749.00,0.00
2024-12-10 17:18:44,112,1592,50,62,955.80,1749.01,0.00
2024-12-10 17:18:44,111,1592,50,61,963.79,1749.04,0.00
2024-12-10 17:18:44,111,1593,50,61,963.13,1750.00,0.00
2024-12-10 17:18:44,112,1593,51,61,954.53,1750.01,0.00
2024-12-10 17:18:44,111,1593,50,61,962.52,1750.04,0.00
2024-12-10 17:18:44,111,1594,50,61,961.91,1751.00,0.00
2024-12-10 17:18:44,112,1594,51,61,953.32,1751.01,0.00
2024-12-10 17:18:44,112,1595,51,61,952.10,1752.00,0.00
2024-12-10 17:18:44,113,1595,52,61,943.68,1752.01,0.00
2024-12-10 17:18:44,112,1595,51,61,951.34,1752.05,0.00
2024-12-10 17:18:44,112,1596,51,61,949.49,1753.00,0.00
2024-12-10 17:18:44,113,1596,51,62,941.09,1753.01,0.00
2024-12-10 17:18:44,112,1596,51,61,948.74,1753.05,0.00
2024-12-10 17:18:44,112,1597,51,61,944.21,1754.00,0.00
2024-12-10 17:18:44,113,1597,52,61,935.86,1754.01,0.00
2024-12-10 17:18:44,112,1597,52,60,943.45,1754.05,0.00
2024-12-10 17:18:44,111,1597,52,59,951.73,1754.05,0.00
2024-12-10 17:18:44,111,1598,52,59,944.63,1755.00,0.00
2024-12-10 17:18:44,112,1598,52,60,936.20,1755.01,0.00
2024-12-10 17:18:44,111,1598,51,60,943.87,1755.05,0.00
2024-12-10 17:18:44,110,1598,51,59,935.70,1755.90,0.00
2024-12-10 17:18:44,110,1599,51,59,950.00,1756.00,0.00
2024-12-10 17:18:44,111,1599,52,59,941.44,1756.01,0.00
2024-12-10 17:18:44,111,1600,52,59,940.39,1757.00,0.00
2024-12-10 17:18:44,112,1600,53,59,931.99,1757.01,0.00
2024-12-10 17:18:44,113,1599,54,59,923.30,1757.05,0.00
2024-12-10 17:18:44,112,1599,53,59,933.74,1757.05,0.00
2024-12-10 17:18:44,112,1600,53,59,933.31,1758.00,0.00
2024-12-10 17:18:44,113,1600,53,60,925.05,1758.01,0.00
2024-12-10 17:18:44,112,1600,52,60,932.55,1758.05,0.00
2024-12-10 17:18:44,112,1601,52,60,947.66,1759.00,0.00
2024-12-10 17:18:44,113,1601,52,61,939.27,1759.01,0.00
2024-12-10 17:18:44,114,1600,52,62,925.55,1759.33,0.00
2024-12-10 17:18:44,114,1601,52,62,934.03,1760.00,0.00
2024-12-10 17:18:44,115,1601,53,62,925.91,1760.01,0.00
2024-12-10 17:18:44,114,1601,53,61,932.81,1760.05,0.00
2024-12-10 17:18:44,115,1600,54,61,910.99,1760.87,0.00
2024-12-10 17:18:44,115,1601,54,61,941.42,1761.00,0.00
2024-12-10 17:18:44,116,1601,54,62,933.31,1761.01,0.00
2024-12-10 17:18:44,115,1601,53,62,940.01,1761.05,0.00
2024-12-10 17:18:44,115,1602,53,62,954.46,1762.00,0.00
2024-12-10 17:18:44,116,1602,54,62,946.23,1762.01,0.00
2024-12-10 17:18:44,115,1602,54,61,952.81,1762.05,0.00
2024-12-10 17:18:44,115,1603,54,61,951.95,1763.00,0.00
2024-12-10 17:18:44,116,1603,55,61,943.74,1763.01,0.00
2024-12-10 17:18:44,115,1603,55,60,950.13,1763.05,0.00
2024-12-10 17:18:44,115,1604,55,60,949.26,1764.00,0.00
2024-12-10 17:18:44,116,1604,56,60,941.08,1764.01,0.00
2024-12-10 17:18:44,115,1604,55,60,947.34,1764.05,0.00
2024-12-10 17:18:44,115,1605,55,60,946.47,1765.00,0.00
2024-12-10 17:18:44,116,1605,56,60,938.31,1765.01,0.00
2024-12-10 17:18:44,115,1605,55,60,944.49,1765.05,0.00
2024-12-10 17:18:44,115,1606,55,60,943.61,1766.00,0.00
2024-12-10 17:18:44,116,1606,56,60,935.48,1766.01,0.00
2024-12-10 17:18:44,116,1607,56,60,929.18,1767.00,0.00
2024-12-10 17:18:44,117,1607,56,61,921.24,1767.01,0.00
2024-12-10 17:18:44,116,1607,55,61,926.31,1767.03,0.00
2024-12-10 17:18:44,115,1607,54,61,933.92,1767.04,0.00
2024-12-10 17:18:44,115,1608,54,61,932.89,1768.00,0.00
2024-12-10 17:18:44,116,1608,54,62,924.85,1768.01,0.00
2024-12-10 17:18:44,115,1608,54,61,932.14,1768.04,0.00
2024-12-10 17:18:44,115,1609,54,61,931.11,1769.00,0.00
2024-12-10 17:18:44,116,1609,55,61,923.08,1769.01,0.00
2024-12-10 17:18:44,115,1609,55,60,930.36,1769.04,0.00
2024-12-10 17:18:44,115,1610,55,60,929.33,1770.00,0.00
2024-12-10 17:18:44,116,1610,55,61,921.32,1770.01,0.00
2024-12-10 17:18:44,115,1610,55,60,928.58,1770.04,0.00
2024-12-10 17:18:44,115,1611,55,60,927.54,1771.00,0.00
2024-12-10 17:18:44,116,1611,55,61,919.55,1771.01,0.00
2024-12-10 17:18:44,115,1611,55,60,926.79,1771.04,0.00
2024-12-10 17:18:44,116,1610,56,60,912.32,1771.43,0.00
2024-12-10 17:18:44,116,1611,56,60,926.63,1772.00,0.00
2024-12-10 17:18:44,117,1611,57,60,918.71,1772.01,0.00
2024-12-10 17:18:44,116,1611,57,59,925.89,1772.04,0.00
2024-12-10 17:18:44,116,1612,57,59,940.00,1773.00,0.00
2024-12-10 17:18:44,117,1612,57,60,931.96,1773.01,0.00
2024-12-10 17:18:44,116,1612,57,59,939.25,1773.04,0.00
2024-12-10 17:18:44,116,1613,57,59,938.08,1774.00,0.00
2024-12-10 17:18:44,117,1613,58,59,930.06,1774.01,0.00
2024-12-10 17:18:44,116,1613,57,59,937.33,1774.04,0.00
2024-12-10 17:18:44,116,1614,57,59,936.16,1775.00,0.00
2024-12-10 17:18:44,117,1614,57,60,928.16,1775.01,0.00
2024-12-10 17:18:44,116,1614,56,60,935.41,1775.04,0.00
2024-12-10 17:18:44,116,1615,56,60,934.24,1776.00,0.00
2024-12-10 17:18:44,117,1615,57,60,926.25,1776.01,0.00
2024-12-10 17:18:44,116,1615,57,59,933.49,1776.04,0.00
2024-12-10 17:18:44,116,1616,57,59,932.31,1777.00,0.00
2024-12-10 17:18:44,117,1616,58,59,924.34,1777.01,0.00
2024-12-10 17:18:44,116,1616,57,59,931.56,1777.04,0.00
2024-12-10 17:18:44,116,1617,57,59,930.38,1778.00,0.00
2024-12-10 17:18:44,117,1617,57,60,922.43,1778.01,0.00
2024-12-10 17:18:44,116,1617,57,59,929.63,1778.04,0.00
2024-12-10 17:18:45,116,1618,57,59,928.45,1779.00,0.00
2024-12-10 17:18:45,117,1618,58,59,920.52,1779.01,0.00
2024-12-10 17:18:45,116,1618,57,59,927.70,1779.04,0.00
2024-12-10 17:18:45,116,1619,57,59,926.52,1780.00,0.00
2024-12-10 17:18:45,117,1619,57,60,918.60,1780.01,0.00
2024-12-10 17:18:45,116,1619,56,60,925.77,1780.04,0.00
2024-12-10 17:18:45,116,1620,56,60,924.58,1781.00,0.00
2024-12-10 17:18:45,117,1620,56,61,916.68,1781.01,0.00
2024-12-10 17:18:45,116,1620,55,61,923.83,1781.04,0.00
2024-12-10 17:18:45,117,1619,55,62,905.20,1781.68,0.00
2024-12-10 17:18:45,117,1620,55,62,917.96,1782.00,0.00
2024-12-10 17:18:45,118,1620,56,62,910.18,1782.01,0.00
2024-12-10 17:18:45,117,1620,56,61,917.21,1782.04,0.00
2024-12-10 17:18:45,117,1621,56,61,931.12,1783.00,0.00
2024-12-10 17:18:45,118,1621,57,61,923.23,1783.01,0.00
2024-12-10 17:18:45,117,1621,57,60,930.37,1783.04,0.00
2024-12-10 17:18:45,117,1622,57,60,929.05,1784.00,0.00
2024-12-10 17:18:45,118,1622,57,61,921.18,1784.01,0.00
2024-12-10 17:18:45,117,1622,57,60,928.30,1784.04,0.00
2024-12-10 17:18:45,117,1623,57,60,926.98,1785.00,0.00
2024-12-10 17:18:45,118,1623,57,61,919.12,1785.01,0.00
2024-12-10 17:18:45,117,1623,56,61,926.23,1785.04,0.00
2024-12-10 17:18:45,117,1624,56,61,924.90,1786.00,0.00
2024-12-10 17:18:45,118,1624,56,62,917.06,1786.01,0.00
2024-12-10 17:18:45,117,1624,56,61,924.15,1786.04,0.00
2024-12-10 17:18:45,117,1625,56,61,922.82,1787.00,0.00
2024-12-10 17:18:45,118,1625,57,61,915.00,1787.01,0.00
2024-12-10 17:18:45,117,1625,56,61,922.07,1787.04,0.00
2024-12-10 17:18:45,118,1624,56,62,906.66,1787.49,0.00
2024-12-10 17:18:45,119,1623,57,62,904.81,1787.62,0.00
2024-12-10 17:18:45,119,1624,57,62,914.13,1788.00,0.00
2024-12-10 17:18:45,120,1624,58,62,906.52,1788.01,0.00
2024-12-10 17:18:45,119,1624,58,61,913.39,1788.04,0.00
2024-12-10 17:18:45,119,1625,58,61,941.86,1789.00,0.00
2024-12-10 17:18:45,120,1625,58,62,934.01,1789.01,0.00
2024-12-10 17:18:45,119,1625,58,61,941.12,1789.04,0.00
2024-12-10 17:18:45,119,1626,58,61,939.52,1790.00,0.00
2024-12-10 17:18:45,120,1626,59,61,931.69,1790.01,0.00
2024-12-10 17:18:45,119,1626,59,60,938.78,1790.04,0.00
2024-12-10 17:18:45,119,1627,59,60,937.19,1791.00,0.00
2024-12-10 17:18:45,120,1627,59,61,929.38,1791.01,0.00
2024-12-10 17:18:45,120,1628,59,61,927.06,1792.00,0.00
2024-12-10 17:18:45,121,1628,59,62,919.40,1792.01,0.00
2024-12-10 17:18:45,120,1628,58,62,926.18,1792.05,0.00
2024-12-10 17:18:45,121,1627,59,62,905.80,1792.79,0.00
2024-12-10 17:18:45,121,1628,59,62,920.21,1793.00,0.00
2024-12-10 17:18:45,122,1628,60,62,912.67,1793.01,0.00
2024-12-10 17:18:45,121,1628,59,62,919.34,1793.05,0.00
2024-12-10 17:18:45,121,1629,59,62,932.43,1794.00,0.00
2024-12-10 17:18:45,122,1629,59,63,924.79,1794.01,0.00
2024-12-10 17:18:45,121,1629,58,63,932.14,1794.02,0.00
2024-12-10 17:18:45,120,1629,58,62,939.32,1794.04,0.00
2024-12-10 17:18:45,119,1629,58,61,947.07,1794.04,0.00
2024-12-10 17:18:45,120,1628,59,61,935.47,1794.27,0.00
2024-12-10 17:18:45,120,1629,59,61,948.81,1795.00,0.00
2024-12-10 17:18:45,121,1629,59,62,940.97,1795.01,0.00
2024-12-10 17:18:45,120,1629,59,61,948.07,1795.04,0.00
2024-12-10 17:18:45,121,1628,60,61,939.79,1795.08,0.00
2024-12-10 17:18:45,121,1629,60,61,961.37,1796.00,0.00
2024-12-10 17:18:45,122,1629,61,61,953.49,1796.01,0.00
2024-12-10 17:18:45,121,1629,61,60,960.64,1796.04,0.00
2024-12-10 17:18:45,122,1628,61,61,947.64,1796.29,0.00
2024-12-10 17:18:45,122,1629,61,61,975.36,1797.00,0.00
2024-12-10 17:18:45,123,1629,62,61,967.43,1797.01,0.00
2024-12-10 17:18:45,122,1629,61,61,974.63,1797.04,0.00
2024-12-10 17:18:45,123,1628,61,62,965.12,1797.15,0.00
2024-12-10 17:18:45,122,1628,61,61,985.15,1797.16,0.00
2024-12-10 17:18:45,122,1629,61,61,1000.10,1798.00,0.00
2024-12-10 17:18:45,123,1629,61,62,991.97,1798.01,0.00
2024-12-10 17:18:45,124,1628,62,62,983.97,1798.02,0.00
2024-12-10 17:18:45,123,1628,61,62,1002.66,1798.05,0.00
2024-12-10 17:18:45,123,1629,61,62,1015.34,1799.00,0.00
2024-12-10 17:18:45,124,1629,62,62,1007.15,1799.01,0.00
2024-12-10 17:18:45,124,1630,62,62,1018.89,1800.00,0.00
2024-12-10 17:18:45,125,1630,62,63,1010.74,1800.01,0.00
2024-12-10 17:18:45,124,1630,61,63,1018.04,1800.05,0.00
2024-12-10 17:18:45,124,1631,61,63,1015.97,1801.00,0.00
2024-12-10 17:18:45,125,1631,62,63,1007.84,1801.01,0.00
2024-12-10 17:18:45,124,1631,61,63,1015.12,1801.05,0.00
2024-12-10 17:18:45,125,1630,62,63,1001.90,1801.35,0.00
2024-12-10 17:18:45,125,1631,62,63,1014.45,1802.00,0.00
2024-12-10 17:18:45,126,1631,63,63,1006.40,1802.01,0.00
2024-12-10 17:18:45,125,1631,63,62,1013.62,1802.05,0.00
2024-12-10 17:18:45,124,1631,62,62,1021.64,1802.05,0.00
2024-12-10 17:18:45,125,1630,62,63,999.60,1802.86,0.00
2024-12-10 17:18:45,125,1631,62,63,1027.57,1803.00,0.00
2024-12-10 17:18:45,126,1631,63,63,1019.41,1803.01,0.00
2024-12-10 17:18:45,125,1631,63,62,1026.73,1803.05,0.00
2024-12-10 17:18:45,126,1630,64,62,1016.59,1803.18,0.00
2024-12-10 17:18:45,127,1629,65,62,1008.90,1803.24,0.00
2024-12-10 17:18:45,127,1630,65,62,1034.96,1804.00,0.00
2024-12-10 17:18:45,128,1630,65,63,1026.87,1804.01,0.00
2024-12-10 17:18:45,127,1630,65,62,1034.13,1804.05,0.00
2024-12-10 17:18:45,127,1631,65,62,1060.12,1805.00,0.00
2024-12-10 17:18:45,128,1631,65,63,1051.84,1805.01,0.00
2024-12-10 17:18:45,127,1631,64,63,1059.29,1805.05,0.00
2024-12-10 17:18:45,127,1632,64,63,1056.87,1806.00,0.00
2024-12-10 17:18:45,128,1632,65,63,1048.61,1806.01,0.00
2024-12-10 17:18:45,127,1632,65,62,1056.04,1806.05,0.00
2024-12-10 17:18:45,128,1631,65,63,1042.80,1806.34,0.00
2024-12-10 17:18:45,128,1632,65,63,1054.69,1807.00,0.00
2024-12-10 17:18:45,129,1632,66,63,1046.52,1807.01,0.00
2024-12-10 17:18:45,128,1632,66,62,1053.87,1807.05,0.00
2024-12-10 17:18:46,128,1633,66,62,1065.45,1808.00,0.00
2024-12-10 17:18:46,129,1633,66,63,1057.19,1808.01,0.00
2024-12-10 17:18:46,129,1634,66,63,1053.85,1809.00,0.00
2024-12-10 17:18:46,130,1634,66,64,1045.74,1809.01,0.00
2024-12-10 17:18:46,129,1634,65,64,1052.90,1809.05,0.00
2024-12-10 17:18:46,129,1635,65,64,1050.36,1810.00,0.00
2024-12-10 17:18:46,130,1635,65,65,1042.28,1810.01,0.00
2024-12-10 17:18:46,129,1635,65,64,1049.41,1810.05,0.00
2024-12-10 17:18:46,129,1636,65,64,1046.87,1811.00,0.00
2024-12-10 17:18:46,130,1636,66,64,1038.82,1811.01,0.00
2024-12-10 17:18:46,131,1635,66,65,1026.95,1811.24,0.00
2024-12-10 17:18:46,131,1636,66,65,1038.37,1812.00,0.00
2024-12-10 17:18:46,132,1636,66,66,1030.51,1812.01,0.00
2024-12-10 17:18:46,131,1636,65,66,1037.43,1812.05,0.00
2024-12-10 17:18:46,131,1637,65,66,1048.50,1813.00,0.00
2024-12-10 17:18:46,132,1637,65,67,1040.55,1813.01,0.00
2024-12-10 17:18:46,133,1636,66,67,1028.98,1813.23,0.00
2024-12-10 17:18:46,134,1635,66,68,1017.08,1813.49,0.00
2024-12-10 17:18:46,134,1636,66,68,1028.84,1814.00,0.00
2024-12-10 17:18:46,135,1636,66,69,1021.21,1814.01,0.00
2024-12-10 17:18:46,134,1636,65,69,1027.78,1814.06,0.00
2024-12-10 17:18:46,134,1637,65,69,1051.89,1815.00,0.00
2024-12-10 17:18:46,135,1637,66,69,1044.10,1815.01,0.00
2024-12-10 17:18:46,134,1637,65,69,1050.83,1815.06,0.00
2024-12-10 17:18:46,134,1638,65,69,1047.86,1816.00,0.00
2024-12-10 17:18:46,135,1638,66,69,1040.10,1816.01,0.00
2024-12-10 17:18:46,134,1638,65,69,1046.80,1816.06,0.00
2024-12-10 17:18:46,134,1639,65,69,1043.83,1817.00,0.00
2024-12-10 17:18:46,135,1639,65,70,1036.09,1817.01,0.00
2024-12-10 17:18:46,134,1639,65,69,1042.77,1817.06,0.00
2024-12-10 17:18:46,134,1640,65,69,1039.79,1818.00,0.00
2024-12-10 17:18:46,135,1640,66,69,1032.09,1818.01,0.00
2024-12-10 17:18:46,134,1640,66,68,1038.73,1818.06,0.00
2024-12-10 17:18:46,134,1641,66,68,1035.74,1819.00,0.00
2024-12-10 17:18:46,135,1641,66,69,1028.07,1819.01,0.00
2024-12-10 17:18:46,136,1640,67,69,1019.86,1819.06,0.00
2024-12-10 17:18:46,137,1639,68,69,999.04,1819.98,0.00
2024-12-10 17:18:46,137,1640,68,69,1012.35,1820.00,0.00
2024-12-10 17:18:46,138,1640,68,70,1005.01,1820.01,0.00
2024-12-10 17:18:46,137,1640,67,70,1011.06,1820.07,0.00
2024-12-10 17:18:46,137,1641,67,70,1034.10,1821.00,0.00
2024-12-10 17:18:46,138,1641,68,70,1026.61,1821.01,0.00
2024-12-10 17:18:46,137,1641,68,69,1032.81,1821.07,0.00
2024-12-10 17:18:46,138,1640,68,70,1020.54,1821.33,0.00
2024-12-10 17:18:46,138,1641,68,70,1031.17,1822.00,0.00
2024-12-10 17:18:46,139,1641,69,70,1023.75,1822.01,0.00
2024-12-10 17:18:46,140,1640,70,70,1015.43,1822.08,0.00
2024-12-10 17:18:46,141,1639,71,70,1017.93,1822.09,0.00
2024-12-10 17:18:46,141,1640,71,70,1040.23,1823.00,0.00
2024-12-10 17:18:46,142,1640,72,70,1032.90,1823.01,0.00
2024-12-10 17:18:46,142,1641,72,70,1053.84,1824.00,0.00
2024-12-10 17:18:46,143,1641,72,71,1046.47,1824.01,0.00
2024-12-10 17:18:46,142,1641,72,70,1052.35,1824.08,0.00
2024-12-10 17:18:46,142,1642,72,70,1049.02,1825.00,0.00
2024-12-10 17:18:46,143,1642,73,70,1041.68,1825.01,0.00
2024-12-10 17:18:46,143,1643,73,70,1036.89,1826.00,0.00
2024-12-10 17:18:46,144,1643,73,71,1029.69,1826.01,0.00
2024-12-10 17:18:46,143,1643,73,70,1035.28,1826.09,0.00
2024-12-10 17:18:46,143,1644,73,70,1031.96,1827.00,0.00
2024-12-10 17:18:46,144,1644,73,71,1024.80,1827.01,0.00
2024-12-10 17:18:46,143,1644,72,71,1030.35,1827.09,0.00
2024-12-10 17:18:46,143,1645,72,71,1027.03,1828.00,0.00
2024-12-10 17:18:46,144,1645,72,72,1019.90,1828.01,0.00
2024-12-10 17:18:46,143,1645,72,71,1025.42,1828.09,0.00
2024-12-10 17:18:46,143,1646,72,71,1021.80,1829.00,0.00
2024-12-10 17:18:46,144,1646,72,72,1014.70,1829.01,0.00
2024-12-10 17:18:46,143,1646,72,71,1020.19,1829.09,0.00
2024-12-10 17:18:46,143,1647,72,71,1016.34,1830.00,0.00
2024-12-10 17:18:46,144,1647,73,71,1009.28,1830.01,0.00
2024-12-10 17:18:46,143,1647,72,71,1015.96,1830.02,0.00
2024-12-10 17:18:46,142,1647,72,70,1021.87,1830.08,0.00
2024-12-10 17:18:46,141,1647,71,70,1028.99,1830.09,0.00
2024-12-10 17:18:46,140,1647,71,69,1036.21,1830.09,0.00
2024-12-10 17:18:46,140,1648,71,69,1032.83,1831.00,0.00
2024-12-10 17:18:46,141,1648,71,70,1025.50,1831.01,0.00
2024-12-10 17:18:46,140,1648,70,70,1031.31,1831.09,0.00
2024-12-10 17:18:46,141,1647,71,70,1018.37,1831.41,0.00
2024-12-10 17:18:46,141,1648,71,70,1025.93,1832.00,0.00
2024-12-10 17:18:46,142,1648,71,71,1018.71,1832.01,0.00
2024-12-10 17:18:46,142,1649,71,71,1026.84,1833.00,0.00
2024-12-10 17:18:46,143,1649,72,71,1019.66,1833.01,0.00
2024-12-10 17:18:46,142,1649,71,71,1025.22,1833.09,0.00
2024-12-10 17:18:46,142,1650,71,71,1021.90,1834.00,0.00
2024-12-10 17:18:46,143,1650,72,71,1014.75,1834.01,0.00
2024-12-10 17:18:46,143,1651,72,71,1009.67,1835.00,0.00
2024-12-10 17:18:47,144,1651,72,72,1002.66,1835.01,0.00
2024-12-10 17:18:47,145,1650,73,72,991.92,1835.22,0.00
2024-12-10 17:18:47,145,1651,73,72,1001.44,1836.00,0.00
2024-12-10 17:18:47,146,1651,73,73,994.58,1836.01,0.00
2024-12-10 17:18:47,145,1651,73,72,999.60,1836.10,0.00
2024-12-10 17:18:47,145,1652,73,72,1008.33,1837.00,0.00
2024-12-10 17:18:47,146,1652,73,73,1001.43,1837.01,0.00
2024-12-10 17:18:47,145,1652,73,72,1006.49,1837.10,0.00
2024-12-10 17:18:47,144,1652,73,71,1013.35,1837.10,0.00
2024-12-10 17:18:47,144,1653,73,71,1009.38,1838.00,0.00
2024-12-10 17:18:47,145,1653,73,72,1002.42,1838.01,0.00
2024-12-10 17:18:47,144,1653,72,72,1007.52,1838.10,0.00
2024-12-10 17:18:47,144,1654,72,72,1003.45,1839.00,0.00
2024-12-10 17:18:47,145,1654,73,72,996.52,1839.01,0.00
2024-12-10 17:18:47,144,1654,72,72,1001.09,1839.10,0.00
2024-12-10 17:18:47,145,1653,72,73,981.55,1839.77,0.00
2024-12-10 17:18:47,145,1654,72,73,993.42,1840.00,0.00
2024-12-10 17:18:47,146,1654,73,73,986.61,1840.01,0.00
2024-12-10 17:18:47,146,1655,73,73,990.48,1841.00,0.00
2024-12-10 17:18:47,147,1655,74,73,983.75,1841.01,0.00
2024-12-10 17:18:47,146,1655,74,72,983.50,1841.11,0.00
2024-12-10 17:18:47,145,1655,74,71,990.16,1841.11,0.00
2024-12-10 17:18:47,145,1656,74,71,986.15,1842.00,0.00
2024-12-10 17:18:47,146,1656,74,72,979.39,1842.01,0.00
2024-12-10 17:18:47,145,1656,73,72,983.97,1842.08,0.00
2024-12-10 17:18:47,144,1656,73,71,989.70,1842.10,0.00
2024-12-10 17:18:47,143,1656,72,71,995.84,1842.13,0.00
2024-12-10 17:18:47,143,1657,72,71,992.86,1843.00,0.00
2024-12-10 17:18:47,144,1657,72,72,985.96,1843.01,0.00
2024-12-10 17:18:47,143,1657,71,72,988.62,1843.11,0.00
2024-12-10 17:18:47,143,1658,71,72,984.81,1844.00,0.00
2024-12-10 17:18:47,144,1658,71,73,977.97,1844.01,0.00
2024-12-10 17:18:47,143,1658,70,73,978.72,1844.11,0.00
2024-12-10 17:18:47,143,1659,70,73,974.31,1845.00,0.00
2024-12-10 17:18:47,144,1659,70,74,967.54,1845.01,0.00
2024-12-10 17:18:47,143,1659,69,74,972.18,1845.09,0.00
2024-12-10 17:18:47,142,1659,68,74,978.77,1845.10,0.00
2024-12-10 17:18:47,142,1660,68,74,973.03,1846.00,0.00
2024-12-10 17:18:47,143,1660,68,75,966.23,1846.01,0.00
2024-12-10 17:18:47,142,1660,67,75,970.94,1846.10,0.00
2024-12-10 17:18:47,141,1660,66,75,974.17,1846.21,0.00
2024-12-10 17:18:47,141,1661,66,75,972.81,1847.00,0.00
2024-12-10 17:18:47,142,1661,66,76,965.96,1847.01,0.00
2024-12-10 17:18:47,141,1661,66,75,970.60,1847.10,0.00
2024-12-10 17:18:47,142,1660,67,75,959.92,1847.30,0.00
2024-12-10 17:18:47,143,1659,67,76,955.10,1847.74,0.00
2024-12-10 17:18:47,143,1660,67,76,966.57,1848.00,0.00
2024-12-10 17:18:47,144,1660,67,77,959.85,1848.01,0.00
2024-12-10 17:18:47,144,1661,67,77,978.47,1849.00,0.00
2024-12-10 17:18:47,145,1661,67,78,971.72,1849.01,0.00
2024-12-10 17:18:47,144,1661,67,77,974.97,1849.10,0.00
2024-12-10 17:18:47,144,1662,67,77,970.58,1850.00,0.00
2024-12-10 17:18:47,145,1662,68,77,963.89,1850.01,0.00
2024-12-10 17:18:47,145,1663,68,77,955.28,1851.00,0.00
2024-12-10 17:18:47,146,1663,68,78,948.74,1851.01,0.00
2024-12-10 17:18:47,145,1663,67,78,950.90,1851.11,0.00
2024-12-10 17:18:47,144,1663,66,78,957.25,1851.11,0.00
2024-12-10 17:18:47,144,1664,66,78,952.28,1852.00,0.00
2024-12-10 17:18:47,145,1664,66,79,945.71,1852.01,0.00
2024-12-10 17:18:47,145,1665,66,79,935.72,1853.00,0.00
2024-12-10 17:18:47,146,1665,67,79,929.31,1853.01,0.00
2024-12-10 17:18:47,145,1665,67,78,930.54,1853.11,0.00
2024-12-10 17:18:47,144,1665,66,78,924.89,1853.71,0.00
2024-12-10 17:18:47,144,1666,66,78,931.81,1854.00,0.00
2024-12-10 17:18:47,145,1666,66,79,925.38,1854.01,0.00
2024-12-10 17:18:47,144,1666,66,78,929.89,1854.04,0.00
2024-12-10 17:18:47,143,1666,66,77,933.21,1854.09,0.00
2024-12-10 17:18:47,142,1666,65,77,939.53,1854.10,0.00
2024-12-10 17:18:47,142,1667,65,77,935.35,1855.00,0.00
2024-12-10 17:18:47,143,1667,66,77,928.81,1855.01,0.00
2024-12-10 17:18:47,142,1667,66,76,932.21,1855.10,0.00
2024-12-10 17:18:47,142,1668,66,76,927.84,1856.00,0.00
2024-12-10 17:18:47,143,1668,67,76,921.35,1856.01,0.00
2024-12-10 17:18:47,142,1668,66,76,924.42,1856.10,0.00
2024-12-10 17:18:47,143,1667,66,77,912.82,1856.39,0.00
2024-12-10 17:18:47,143,1668,66,77,921.89,1857.00,0.00
2024-12-10 17:18:47,144,1668,67,77,915.48,1857.01,0.00
2024-12-10 17:18:47,143,1668,67,76,921.63,1857.01,0.00
2024-12-10 17:18:47,142,1668,67,75,926.86,1857.03,0.00
2024-12-10 17:18:47,141,1668,66,75,931.57,1857.09,0.00
2024-12-10 17:18:47,140,1668,65,75,938.09,1857.09,0.00
2024-12-10 17:18:47,140,1669,65,75,946.65,1858.00,0.00
2024-12-10 17:18:47,141,1669,66,75,939.93,1858.01,0.00
2024-12-10 17:18:47,140,1669,66,74,944.31,1858.09,0.00
2024-12-10 17:18:47,139,1669,65,74,938.52,1858.70,0.00
2024-12-10 17:18:47,139,1670,65,74,946.52,1859.00,0.00
2024-12-10 17:18:47,140,1670,66,74,939.76,1859.01,0.00
2024-12-10 17:18:47,139,1670,65,74,946.25,1859.01,0.00
2024-12-10 17:18:47,138,1670,65,73,950.98,1859.08,0.00
2024-12-10 17:18:47,137,1670,65,72,957.79,1859.08,0.00
2024-12-10 17:18:47,137,1671,65,72,954.74,1860.00,0.00
2024-12-10 17:18:47,138,1671,66,72,947.82,1860.01,0.00
2024-12-10 17:18:47,137,1671,65,72,952.48,1860.08,0.00
2024-12-10 17:18:47,137,1672,65,72,949.43,1861.00,0.00
2024-12-10 17:18:47,138,1672,65,73,942.55,1861.01,0.00
2024-12-10 17:18:47,137,1672,65,72,947.20,1861.08,0.00
2024-12-10 17:18:48,137,1673,65,72,944.14,1862.00,0.00
2024-12-10 17:18:48,138,1673,65,73,937.30,1862.01,0.00
2024-12-10 17:18:48,137,1673,64,73,942.03,1862.08,0.00
2024-12-10 17:18:48,137,1674,64,73,938.97,1863.00,0.00
2024-12-10 17:18:48,138,1674,64,74,932.16,1863.01,0.00
2024-12-10 17:18:48,137,1674,63,74,936.95,1863.08,0.00
2024-12-10 17:18:48,137,1675,63,74,933.89,1864.00,0.00
2024-12-10 17:18:48,138,1675,64,74,927.12,1864.01,0.00
2024-12-10 17:18:48,137,1675,63,74,931.89,1864.08,0.00
2024-12-10 17:18:48,138,1674,64,74,916.50,1864.57,0.00
2024-12-10 17:18:48,138,1675,64,74,925.48,1865.00,0.00
2024-12-10 17:18:48,139,1675,65,74,918.82,1865.01,0.00
2024-12-10 17:18:48,138,1675,65,73,924.26,1865.03,0.00
2024-12-10 17:18:48,137,1675,64,73,930.07,1865.07,0.00
2024-12-10 17:18:48,137,1676,64,73,940.49,1866.00,0.00
2024-12-10 17:18:48,138,1676,65,73,933.68,1866.01,0.00
2024-12-10 17:18:48,137,1676,64,73,939.15,1866.07,0.00
2024-12-10 17:18:48,137,1677,64,73,935.95,1867.00,0.00
2024-12-10 17:18:48,138,1677,64,74,929.17,1867.01,0.00
2024-12-10 17:18:48,137,1677,64,73,934.61,1867.07,0.00
2024-12-10 17:18:48,137,1678,64,73,931.41,1868.00,0.00
2024-12-10 17:18:48,138,1678,65,73,924.66,1868.01,0.00
2024-12-10 17:18:48,137,1678,65,72,930.07,1868.07,0.00
2024-12-10 17:18:48,137,1679,65,72,926.86,1869.00,0.00
2024-12-10 17:18:48,138,1679,65,73,920.14,1869.01,0.00
2024-12-10 17:18:48,137,1679,64,73,925.52,1869.07,0.00
2024-12-10 17:18:48,137,1680,64,73,922.31,1870.00,0.00
2024-12-10 17:18:48,138,1680,65,73,915.62,1870.01,0.00
2024-12-10 17:18:48,138,1681,65,73,911.10,1871.00,0.00
2024-12-10 17:18:48,139,1681,65,74,904.54,1871.01,0.00
2024-12-10 17:18:48,138,1681,65,73,909.63,1871.08,0.00
2024-12-10 17:18:48,137,1681,64,73,916.13,1871.08,0.00
2024-12-10 17:18:48,137,1682,64,73,913.04,1872.00,0.00
2024-12-10 17:18:48,138,1682,65,73,906.43,1872.01,0.00
2024-12-10 17:18:48,138,1683,65,73,900.84,1873.00,0.00
2024-12-10 17:18:48,139,1683,65,74,894.36,1873.01,0.00
2024-12-10 17:18:48,138,1683,65,73,899.25,1873.09,0.00
2024-12-10 17:18:48,138,1684,65,73,894.01,1874.00,0.00
2024-12-10 17:18:48,139,1684,66,73,887.58,1874.01,0.00
2024-12-10 17:18:48,138,1684,65,73,892.41,1874.09,0.00
2024-12-10 17:18:48,138,1685,65,73,886.05,1875.00,0.00
2024-12-10 17:18:48,139,1685,66,73,879.68,1875.01,0.00
2024-12-10 17:18:48,140,1684,66,74,873.26,1875.03,0.00
2024-12-10 17:18:48,139,1684,66,73,888.89,1875.09,0.00
2024-12-10 17:18:48,140,1683,66,74,876.57,1875.43,0.00
2024-12-10 17:18:48,139,1683,66,73,883.29,1875.72,0.00
2024-12-10 17:18:48,139,1684,66,73,891.74,1876.00,0.00
2024-12-10 17:18:48,140,1684,67,73,885.37,1876.01,0.00
2024-12-10 17:18:48,139,1684,66,73,890.16,1876.09,0.00
2024-12-10 17:18:48,139,1685,66,73,913.96,1877.00,0.00
2024-12-10 17:18:48,140,1685,66,74,907.43,1877.01,0.00
2024-12-10 17:18:48,139,1685,65,74,912.37,1877.09,0.00
2024-12-10 17:18:48,139,1686,65,74,909.18,1878.00,0.00
2024-12-10 17:18:48,140,1686,66,74,902.68,1878.01,0.00
2024-12-10 17:18:48,141,1685,66,75,896.28,1878.02,0.00
2024-12-10 17:18:48,140,1685,66,74,911.84,1878.09,0.00
2024-12-10 17:18:48,139,1685,65,74,916.92,1878.13,0.00
2024-12-10 17:18:48,140,1684,66,74,897.13,1878.86,0.00
2024-12-10 17:18:48,140,1685,66,74,910.28,1879.00,0.00
2024-12-10 17:18:48,141,1685,67,74,903.82,1879.01,0.00
2024-12-10 17:18:48,140,1685,66,74,908.55,1879.09,0.00
2024-12-10 17:18:48,140,1686,66,74,931.59,1880.00,0.00
2024-12-10 17:18:48,141,1686,66,75,924.99,1880.01,0.00
2024-12-10 17:18:48,140,1686,66,74,929.68,1880.09,0.00
2024-12-10 17:18:48,140,1687,66,74,925.50,1881.00,0.00
2024-12-10 17:18:48,141,1687,66,75,918.94,1881.01,0.00
2024-12-10 17:18:48,142,1686,66,76,911.69,1881.06,0.00
2024-12-10 17:18:48,141,1686,66,75,929.47,1881.09,0.00
2024-12-10 17:18:48,140,1686,66,74,935.97,1881.09,0.00
2024-12-10 17:18:48,140,1687,66,74,932.18,1882.00,0.00
2024-12-10 17:18:48,141,1687,66,75,925.57,1882.01,0.00
2024-12-10 17:18:48,140,1687,65,75,930.04,1882.09,0.00
2024-12-10 17:18:48,140,1688,65,75,939.86,1883.00,0.00
2024-12-10 17:18:48,141,1688,65,76,933.20,1883.01,0.00
2024-12-10 17:18:48,141,1689,65,76,927.51,1884.00,0.00
2024-12-10 17:18:48,142,1689,65,77,920.98,1884.01,0.00
2024-12-10 17:18:48,141,1689,65,76,925.24,1884.09,0.00
2024-12-10 17:18:48,141,1690,65,76,921.72,1885.00,0.00
2024-12-10 17:18:48,142,1690,66,76,915.23,1885.01,0.00
2024-12-10 17:18:48,141,1690,66,75,920.72,1885.06,0.00
2024-12-10 17:18:48,140,1690,66,74,926.77,1885.08,0.00
2024-12-10 17:18:48,140,1691,66,74,922.41,1886.00,0.00
2024-12-10 17:18:48,141,1691,67,74,915.86,1886.01,0.00
2024-12-10 17:18:48,140,1691,67,73,920.96,1886.08,0.00
2024-12-10 17:18:48,140,1692,67,73,915.31,1887.00,0.00
2024-12-10 17:18:48,141,1692,68,73,908.82,1887.01,0.00
2024-12-10 17:18:48,140,1692,67,73,913.74,1887.08,0.00
2024-12-10 17:18:48,139,1692,67,72,920.18,1887.08,0.00
2024-12-10 17:18:48,138,1692,66,72,926.71,1887.08,0.00
2024-12-10 17:18:48,138,1693,66,72,919.09,1888.00,0.00
2024-12-10 17:18:48,139,1693,67,72,912.48,1888.01,0.00
2024-12-10 17:18:48,138,1693,66,72,917.37,1888.08,0.00
2024-12-10 17:18:49,138,1694,66,72,907.05,1889.00,0.00
2024-12-10 17:18:49,139,1694,67,72,900.53,1889.01,0.00
2024-12-10 17:18:49,138,1694,67,71,905.13,1889.08,0.00
2024-12-10 17:18:49,138,1695,67,71,892.66,1890.00,0.00
2024-12-10 17:18:49,139,1695,67,72,886.24,1890.01,0.00
2024-12-10 17:18:49,138,1695,67,71,871.29,1890.80,0.00
2024-12-10 17:18:49,138,1696,67,71,877.65,1891.00,0.00
2024-12-10 17:18:49,139,1696,67,72,871.34,1891.01,0.00
2024-12-10 17:18:49,139,1697,67,72,856.67,1892.00,0.00
2024-12-10 17:18:49,140,1697,68,72,850.55,1892.01,0.00
2024-12-10 17:18:49,139,1697,68,71,853.62,1892.09,0.00
2024-12-10 17:18:49,138,1697,67,71,859.67,1892.09,0.00
2024-12-10 17:18:49,138,1698,67,71,845.48,1893.00,0.00
2024-12-10 17:18:49,139,1698,67,72,839.40,1893.01,0.00
2024-12-10 17:18:49,138,1698,66,72,842.08,1893.09,0.00
2024-12-10 17:18:49,138,1699,66,72,825.72,1894.00,0.00
2024-12-10 17:18:49,139,1699,66,73,819.78,1894.01,0.00
2024-12-10 17:18:49,138,1699,66,72,821.98,1894.09,0.00
2024-12-10 17:18:49,137,1699,65,72,827.84,1894.10,0.00
2024-12-10 17:18:49,137,1700,65,72,804.86,1895.00,0.00
2024-12-10 17:18:49,138,1700,66,72,799.03,1895.01,0.00
2024-12-10 17:18:49,137,1700,66,71,800.71,1895.10,0.00
2024-12-10 17:18:49,136,1700,65,71,806.46,1895.10,0.00
2024-12-10 17:18:49,136,1701,65,71,774.83,1896.00,0.00
2024-12-10 17:18:49,137,1701,66,71,769.17,1896.01,0.00
2024-12-10 17:18:49,136,1701,66,70,773.34,1896.01,0.00
2024-12-10 17:18:49,135,1701,66,69,778.51,1896.03,0.00
2024-12-10 17:18:49,134,1701,65,69,783.21,1896.08,0.00
2024-12-10 17:18:49,133,1701,65,68,788.96,1896.08,0.00
2024-12-10 17:18:49,132,1701,64,68,794.30,1896.11,0.00
2024-12-10 17:18:49,131,1701,64,67,791.08,1896.57,0.00
2024-12-10 17:18:49,130,1701,63,67,786.63,1896.75,0.00
2024-12-10 17:18:49,130,1702,63,67,770.38,1897.00,0.00
2024-12-10 17:18:49,131,1702,63,68,764.50,1897.01,0.00
2024-12-10 17:18:49,130,1702,62,68,768.80,1897.09,0.00
2024-12-10 17:18:49,129,1702,62,67,774.62,1897.09,0.00
2024-12-10 17:18:49,130,1701,62,68,759.87,1897.57,0.00
2024-12-10 17:18:49,129,1701,62,67,772.62,1897.71,0.00
2024-12-10 17:18:49,128,1701,62,66,776.02,1897.75,0.00
2024-12-10 17:18:49,127,1701,62,65,774.86,1897.87,0.00
2024-12-10 17:18:49,126,1701,62,64,778.65,1897.89,0.00
2024-12-10 17:18:49,125,1701,62,63,782.48,1897.90,0.00
2024-12-10 17:18:49,125,1702,62,63,779.54,1898.00,0.00
2024-12-10 17:18:49,126,1702,62,64,773.35,1898.01,0.00
2024-12-10 17:18:49,125,1702,62,63,777.72,1898.09,0.00
2024-12-10 17:18:49,124,1702,62,62,769.61,1898.71,0.00
2024-12-10 17:18:49,123,1702,62,61,774.95,1898.72,0.00
2024-12-10 17:18:49,123,1703,62,61,776.91,1899.00,0.00
2024-12-10 17:18:49,124,1703,63,61,770.65,1899.01,0.00
2024-12-10 17:18:49,123,1703,62,61,774.90,1899.09,0.00
2024-12-10 17:18:49,122,1703,62,60,764.98,1899.82,0.00
2024-12-10 17:18:49,121,1703,62,59,769.96,1899.84,0.00
2024-12-10 17:18:49,122,1702,62,60,761.33,1899.88,0.00
2024-12-10 17:18:49,121,1702,62,59,765.51,1899.93,0.00
2024-12-10 17:18:49,120,1702,62,58,766.00,1899.95,0.00
2024-12-10 17:18:49,119,1702,62,57,768.86,1899.96,0.00
2024-12-10 17:18:49,119,1703,62,57,777.74,1900.00,0.00
2024-12-10 17:18:49,120,1703,62,58,771.25,1900.01,0.00
2024-12-10 17:18:49,119,1703,62,57,775.94,1900.09,0.00
2024-12-10 17:18:49,118,1703,61,57,756.03,1900.91,0.00
2024-12-10 17:18:49,117,1703,61,56,757.48,1900.93,0.00
2024-12-10 17:18:49,117,1704,61,56,779.35,1901.00,0.00
2024-12-10 17:18:49,118,1704,62,56,772.74,1901.01,0.00
2024-12-10 17:18:49,117,1704,61,56,777.59,1901.09,0.00
2024-12-10 17:18:49,116,1704,60,56,784.13,1901.10,0.00
2024-12-10 17:18:49,115,1704,59,56,766.78,1901.93,0.00
2024-12-10 17:18:49,114,1704,58,56,773.40,1901.94,0.00
2024-12-10 17:18:49,114,1705,58,56,785.33,1902.00,0.00
2024-12-10 17:18:49,115,1705,59,56,778.51,1902.01,0.00
2024-12-10 17:18:49,114,1705,58,56,783.86,1902.08,0.00
2024-12-10 17:18:49,113,1705,57,56,790.46,1902.09,0.00
2024-12-10 17:18:49,112,1705,57,55,797.35,1902.09,0.00
2024-12-10 17:18:49,111,1705,57,54,791.09,1902.66,0.00
2024-12-10 17:18:49,110,1705,56,54,791.60,1902.85,0.00
2024-12-10 17:18:49,109,1705,55,54,796.75,1902.94,0.00
2024-12-10 17:18:49,109,1706,55,54,812.31,1903.00,0.00
2024-12-10 17:18:49,110,1706,56,54,804.93,1903.01,0.00
2024-12-10 17:18:49,109,1706,55,54,811.97,1903.02,0.00
2024-12-10 17:18:49,108,1706,55,53,819.13,1903.03,0.00
2024-12-10 17:18:49,107,1706,54,53,825.74,1903.08,0.00
2024-12-10 17:18:49,106,1706,53,53,833.35,1903.08,0.00
2024-12-10 17:18:49,105,1706,52,53,841.11,1903.08,0.00
2024-12-10 17:18:49,106,1705,53,53,815.83,1903.85,0.00
2024-12-10 17:18:49,106,1706,53,53,835.33,1904.00,0.00
2024-12-10 17:18:49,107,1706,53,54,827.53,1904.01,0.00
2024-12-10 17:18:49,106,1706,53,53,833.93,1904.08,0.00
2024-12-10 17:18:49,106,1707,53,53,848.08,1905.00,0.00
2024-12-10 17:18:49,107,1707,53,54,840.16,1905.01,0.00
2024-12-10 17:18:49,106,1707,53,53,846.67,1905.08,0.00
2024-12-10 17:18:49,105,1707,53,52,843.26,1905.54,0.00
2024-12-10 17:18:49,105,1708,53,52,851.45,1906.00,0.00
2024-12-10 17:18:49,106,1708,54,52,843.42,1906.01,0.00
2024-12-10 17:18:49,105,1708,53,52,850.03,1906.08,0.00
2024-12-10 17:18:49,104,1708,53,51,858.02,1906.08,0.00
2024-12-10 17:18:49,104,1709,53,51,857.22,1907.00,0.00
2024-12-10 17:18:49,105,1709,54,51,849.06,1907.01,0.00
2024-12-10 17:18:49,105,1710,54,51,845.87,1908.00,0.00
2024-12-10 17:18:49,106,1710,55,51,837.89,1908.01,0.00
2024-12-10 17:18:49,105,1710,55,50,844.27,1908.09,0.00
2024-12-10 17:18:49,105,1711,55,50,841.77,1909.00,0.00
2024-12-10 17:18:49,106,1711,55,51,833.83,1909.01,0.00
2024-12-10 17:18:49,105,1711,55,50,840.17,1909.09,0.00
2024-12-10 17:18:49,105,1712,55,50,837.12,1910.00,0.00
2024-12-10 17:18:49,106,1712,56,50,829.23,1910.01,0.00
2024-12-10 17:18:49,105,1712,56,49,835.46,1910.09,0.00
2024-12-10 17:18:49,104,1712,56,48,827.64,1910.87,0.00
2024-12-10 17:18:49,104,1713,56,48,843.56,1911.00,0.00
2024-12-10 17:18:49,105,1713,56,49,835.52,1911.01,0.00
2024-12-10 17:18:50,104,1713,55,49,840.79,1911.09,0.00
2024-12-10 17:18:50,103,1713,55,48,848.77,1911.09,0.00
2024-12-10 17:18:50,103,1714,55,48,850.18,1912.00,0.00
2024-12-10 17:18:50,104,1714,56,48,842.00,1912.01,0.00
2024-12-10 17:18:50,103,1714,56,47,846.47,1912.09,0.00
2024-12-10 17:18:50,103,1715,56,47,848.00,1913.00,0.00
2024-12-10 17:18:50,104,1715,57,47,839.84,1913.01,0.00
2024-12-10 17:18:50,103,1715,57,46,844.58,1913.09,0.00
2024-12-10 17:18:50,102,1715,57,45,852.49,1913.10,0.00
2024-12-10 17:18:50,102,1716,57,45,854.41,1914.00,0.00
2024-12-10 17:18:50,103,1716,57,46,846.11,1914.01,0.00
2024-12-10 17:18:50,102,1716,57,45,851.34,1914.10,0.00
2024-12-10 17:18:50,102,1717,57,45,853.26,1915.00,0.00
2024-12-10 17:18:50,103,1717,58,45,844.97,1915.01,0.00
2024-12-10 17:18:50,103,1718,58,45,844.59,1916.00,0.00
2024-12-10 17:18:50,104,1718,59,45,836.47,1916.01,0.00
2024-12-10 17:18:50,103,1718,58,45,842.29,1916.11,0.00
2024-12-10 17:18:50,103,1719,58,45,844.19,1917.00,0.00
2024-12-10 17:18:50,104,1719,58,46,836.07,1917.01,0.00
2024-12-10 17:18:50,104,1720,58,46,835.95,1918.00,0.00
2024-12-10 17:18:50,105,1720,59,46,827.99,1918.01,0.00
2024-12-10 17:18:50,104,1720,59,45,834.26,1918.07,0.00
2024-12-10 17:18:50,103,1720,58,45,841.44,1918.11,0.00
2024-12-10 17:18:50,103,1721,58,45,843.34,1919.00,0.00
2024-12-10 17:18:50,104,1721,58,46,835.23,1919.01,0.00
2024-12-10 17:18:50,103,1721,57,46,841.69,1919.09,0.00
2024-12-10 17:18:50,102,1721,57,45,849.57,1919.10,0.00
2024-12-10 17:18:50,101,1721,56,45,857.79,1919.10,0.00
2024-12-10 17:18:50,101,1722,56,45,859.92,1920.00,0.00
2024-12-10 17:18:50,102,1722,56,46,851.49,1920.01,0.00
2024-12-10 17:18:50,101,1722,56,45,858.05,1920.10,0.00
2024-12-10 17:18:50,101,1723,56,45,860.18,1921.00,0.00
2024-12-10 17:18:50,102,1723,57,45,851.75,1921.01,0.00
2024-12-10 17:18:50,101,1723,56,45,859.43,1921.04,0.00
2024-12-10 17:18:50,100,1723,55,45,866.89,1921.09,0.00
2024-12-10 17:18:50,99,1723,55,44,875.45,1921.09,0.00
2024-12-10 17:18:50,100,1722,56,44,858.33,1921.55,0.00
2024-12-10 17:18:50,100,1723,56,44,879.57,1922.00,0.00
2024-12-10 17:18:50,101,1723,57,44,870.86,1922.01,0.00
2024-12-10 17:18:50,100,1723,57,43,879.19,1922.02,0.00
2024-12-10 17:18:50,99,1723,56,43,886.74,1922.08,0.00
2024-12-10 17:18:50,98,1723,55,43,895.59,1922.08,0.00
2024-12-10 17:18:50,98,1724,55,43,916.13,1923.00,0.00
2024-12-10 17:18:50,99,1724,55,44,906.88,1923.01,0.00
2024-12-10 17:18:50,98,1724,54,44,914.59,1923.08,0.00
2024-12-10 17:18:50,98,1725,54,44,914.30,1924.00,0.00
2024-12-10 17:18:50,99,1725,54,45,905.06,1924.01,0.00
2024-12-10 17:18:50,98,1725,54,44,912.75,1924.08,0.00
2024-12-10 17:18:50,98,1726,54,44,912.46,1925.00,0.00
2024-12-10 17:18:50,99,1726,55,44,903.24,1925.01,0.00
2024-12-10 17:18:50,98,1726,54,44,910.91,1925.08,0.00
2024-12-10 17:18:50,98,1727,54,44,911.93,1926.00,0.00
2024-12-10 17:18:50,99,1727,55,44,902.72,1926.01,0.00
2024-12-10 17:18:50,98,1727,55,43,910.38,1926.08,0.00
2024-12-10 17:18:50,99,1726,56,43,897.31,1926.30,0.00
2024-12-10 17:18:50,99,1727,56,43,917.87,1927.00,0.00
2024-12-10 17:18:50,100,1727,56,44,908.69,1927.01,0.00
2024-12-10 17:18:50,99,1727,56,43,917.43,1927.03,0.00
2024-12-10 17:18:50,98,1727,56,42,925.83,1927.07,0.00
2024-12-10 17:18:50,97,1727,55,42,933.54,1927.17,0.00
2024-12-10 17:18:50,97,1728,55,42,955.16,1928.00,0.00
2024-12-10 17:18:50,98,1728,56,42,945.41,1928.01,0.00
2024-12-10 17:18:50,97,1728,56,41,953.69,1928.07,0.00
2024-12-10 17:18:50,97,1729,56,41,953.41,1929.00,0.00
2024-12-10 17:18:50,98,1729,56,42,943.68,1929.01,0.00
2024-12-10 17:18:50,97,1729,56,41,951.87,1929.07,0.00
2024-12-10 17:18:50,97,1730,56,41,951.66,1930.00,0.00
2024-12-10 17:18:50,98,1730,56,42,941.95,1930.01,0.00
2024-12-10 17:18:50,97,1730,55,42,950.12,1930.07,0.00
2024-12-10 17:18:50,97,1731,55,42,949.87,1931.00,0.00
2024-12-10 17:18:50,98,1731,55,43,940.18,1931.01,0.00
2024-12-10 17:18:50,97,1731,55,42,948.33,1931.07,0.00
2024-12-10 17:18:50,96,1731,54,42,958.01,1931.07,0.00
2024-12-10 17:18:50,96,1732,54,42,955.87,1932.00,0.00
2024-12-10 17:18:50,97,1732,54,43,946.02,1932.01,0.00
2024-12-10 17:18:50,96,1732,54,42,954.29,1932.07,0.00
2024-12-10 17:18:50,95,1732,54,41,963.22,1932.11,0.00
2024-12-10 17:18:50,94,1732,54,40,972.81,1932.12,0.00
2024-12-10 17:18:50,95,1731,54,41,952.53,1932.60,0.00
2024-12-10 17:18:50,94,1731,54,40,971.20,1932.63,0.00
2024-12-10 17:18:50,94,1732,54,40,981.02,1933.00,0.00
2024-12-10 17:18:50,95,1732,54,41,970.69,1933.01,0.00
2024-12-10 17:18:50,94,1732,53,41,979.38,1933.07,0.00
2024-12-10 17:18:50,93,1732,53,40,981.86,1933.40,0.00
2024-12-10 17:18:50,93,1733,53,40,1006.32,1934.00,0.00
2024-12-10 17:18:50,94,1733,54,40,995.61,1934.01,0.00
2024-12-10 17:18:50,93,1733,53,40,1004.64,1934.08,0.00
2024-12-10 17:18:50,92,1733,53,39,1013.85,1934.13,0.00
2024-12-10 17:18:50,92,1734,53,39,1010.13,1935.00,0.00
2024-12-10 17:18:50,93,1734,54,39,999.27,1935.01,0.00
2024-12-10 17:18:50,92,1734,54,38,1008.46,1935.08,0.00
2024-12-10 17:18:50,92,1735,54,38,1001.11,1936.00,0.00
2024-12-10 17:18:50,93,1735,55,38,990.34,1936.01,0.00
2024-12-10 17:18:50,93,1736,55,38,979.41,1937.00,0.00
2024-12-10 17:18:50,94,1736,56,38,968.99,1937.01,0.00
2024-12-10 17:18:50,93,1736,56,37,977.88,1937.08,0.00
2024-12-10 17:18:50,92,1736,55,37,985.92,1937.19,0.00
2024-12-10 17:18:50,93,1735,55,38,966.98,1937.57,0.00
2024-12-10 17:18:50,92,1735,54,38,977.88,1937.74,0.00
2024-12-10 17:18:50,92,1736,54,38,988.90,1938.00,0.00
2024-12-10 17:18:50,93,1736,55,38,978.26,1938.01,0.00
2024-12-10 17:18:50,93,1737,55,38,989.02,1939.00,0.00
2024-12-10 17:18:50,94,1737,55,39,978.50,1939.01,0.00
2024-12-10 17:18:50,95,1736,55,40,968.20,1939.03,0.00
2024-12-10 17:18:50,94,1736,54,40,992.02,1939.09,0.00
2024-12-10 17:18:50,93,1736,54,39,1001.76,1939.11,0.00
2024-12-10 17:18:50,92,1736,54,38,1010.05,1939.17,0.00
2024-12-10 17:18:50,91,1736,54,37,1003.37,1939.75,0.00
2024-12-10 17:18:51,91,1737,54,37,1016.86,1940.00,0.00
2024-12-10 17:18:51,92,1737,54,38,1005.81,1940.01,0.00
2024-12-10 17:18:51,91,1737,53,38,1015.34,1940.08,0.00
2024-12-10 17:18:51,90,1737,53,37,1023.64,1940.13,0.00
2024-12-10 17:18:51,90,1738,53,37,1039.44,1941.00,0.00
2024-12-10 17:18:51,91,1738,53,38,1028.02,1941.01,0.00
2024-12-10 17:18:51,90,1738,52,38,1037.93,1941.08,0.00
2024-12-10 17:18:51,89,1738,51,38,1033.16,1941.60,0.00
2024-12-10 17:18:51,88,1738,50,38,1042.17,1941.63,0.00
2024-12-10 17:18:51,87,1738,50,37,1051.37,1941.71,0.00
2024-12-10 17:18:51,87,1739,50,37,1066.42,1942.00,0.00
2024-12-10 17:18:51,88,1739,50,38,1054.30,1942.01,0.00
2024-12-10 17:18:51,87,1739,50,37,1064.76,1942.08,0.00
2024-12-10 17:18:51,87,1740,50,37,1058.45,1943.00,0.00
2024-12-10 17:18:51,88,1740,51,37,1046.42,1943.01,0.00
2024-12-10 17:18:51,87,1740,51,36,1056.53,1943.07,0.00
2024-12-10 17:18:51,88,1739,51,37,1024.83,1943.56,0.00
2024-12-10 17:18:51,88,1740,51,37,1036.46,1944.00,0.00
2024-12-10 17:18:51,89,1740,51,38,1024.81,1944.01,0.00
2024-12-10 17:18:51,89,1741,51,38,1016.60,1945.00,0.00
2024-12-10 17:18:51,90,1741,52,38,1005.30,1945.01,0.00
2024-12-10 17:18:51,89,1741,51,38,1012.58,1945.17,0.00
2024-12-10 17:18:51,88,1741,51,37,992.60,1945.63,0.00
2024-12-10 17:18:51,88,1742,51,37,989.86,1946.00,0.00
2024-12-10 17:18:51,89,1742,52,37,978.74,1946.01,0.00
2024-12-10 17:18:51,88,1742,52,36,987.88,1946.09,0.00
2024-12-10 17:18:51,87,1742,51,36,997.68,1946.17,0.00
2024-12-10 17:18:51,86,1742,50,36,1008.22,1946.22,0.00
2024-12-10 17:18:51,85,1742,49,36,1016.48,1946.39,0.00
2024-12-10 17:18:51,84,1742,49,35,1025.91,1946.42,0.00
2024-12-10 17:18:51,83,1742,49,34,1035.63,1946.45,0.00
2024-12-10 17:18:51,84,1741,50,34,1016.78,1946.64,0.00
2024-12-10 17:18:51,83,1741,50,33,1023.77,1946.80,0.00
2024-12-10 17:18:51,83,1742,50,33,1027.32,1947.00,0.00
2024-12-10 17:18:51,84,1742,50,34,1015.09,1947.01,0.00
2024-12-10 17:18:51,83,1742,49,34,1025.95,1947.04,0.00
2024-12-10 17:18:51,82,1742,48,34,1037.03,1947.07,0.00
2024-12-10 17:18:51,81,1742,48,33,1026.22,1947.78,0.00
2024-12-10 17:18:51,80,1742,48,32,1034.77,1947.79,0.00
2024-12-10 17:18:51,80,1743,48,32,1071.23,1948.00,0.00
2024-12-10 17:18:51,81,1743,49,32,1058.01,1948.01,0.00
2024-12-10 17:18:51,81,1744,49,32,1039.43,1949.00,0.00
2024-12-10 17:18:51,82,1744,50,32,1026.76,1949.01,0.00
2024-12-10 17:18:51,81,1744,50,31,1035.18,1949.07,0.00
2024-12-10 17:18:51,80,1744,50,30,1016.08,1949.83,0.00
2024-12-10 17:18:51,80,1745,50,30,1026.81,1950.00,0.00
2024-12-10 17:18:51,81,1745,50,31,1014.13,1950.01,0.00
2024-12-10 17:18:51,80,1745,50,30,1023.49,1950.03,0.00
2024-12-10 17:18:51,79,1745,49,30,1026.23,1950.42,0.00
2024-12-10 17:18:51,79,1746,49,30,1008.98,1951.00,0.00
2024-12-10 17:18:51,80,1746,49,31,996.36,1951.01,0.00
2024-12-10 17:18:51,79,1746,49,30,1001.60,1951.25,0.00
2024-12-10 17:18:51,78,1746,49,29,994.46,1951.73,0.00
2024-12-10 17:18:51,78,1747,49,29,991.28,1952.00,0.00
2024-12-10 17:18:51,79,1747,49,30,978.74,1952.01,0.00
2024-12-10 17:18:51,78,1747,49,29,990.05,1952.06,0.00
2024-12-10 17:18:51,77,1747,48,29,991.85,1952.42,0.00
2024-12-10 17:18:51,76,1747,48,28,985.87,1952.84,0.00
2024-12-10 17:18:51,75,1747,47,28,993.45,1952.87,0.00
2024-12-10 17:18:51,75,1748,47,28,1007.34,1953.00,0.00
2024-12-10 17:18:51,76,1748,47,29,994.09,1953.01,0.00
2024-12-10 17:18:51,75,1748,46,29,1006.06,1953.07,0.00
2024-12-10 17:18:51,75,1749,46,29,989.28,1954.00,0.00
2024-12-10 17:18:51,76,1749,47,29,976.26,1954.01,0.00
2024-12-10 17:18:51,75,1749,46,29,987.00,1954.07,0.00
2024-12-10 17:18:51,74,1749,45,29,962.18,1954.93,0.00
2024-12-10 17:18:51,74,1750,45,29,986.10,1955.00,0.00
2024-12-10 17:18:51,75,1750,46,29,972.95,1955.01,0.00
2024-12-10 17:18:51,75,1751,46,29,951.08,1956.00,0.00
2024-12-10 17:18:51,76,1751,47,29,938.56,1956.01,0.00
2024-12-10 17:18:51,75,1751,46,29,948.69,1956.07,0.00
2024-12-10 17:18:51,74,1751,46,28,961.25,1956.07,0.00
2024-12-10 17:18:51,73,1751,46,27,961.29,1956.59,0.00
2024-12-10 17:18:51,72,1751,46,26,974.14,1956.60,0.00
2024-12-10 17:18:51,71,1751,46,25,983.64,1956.65,0.00
2024-12-10 17:18:51,71,1752,46,25,990.85,1957.00,0.00
2024-12-10 17:18:51,72,1752,46,26,977.08,1957.01,0.00
2024-12-10 17:18:51,72,1753,46,26,962.27,1958.00,0.00
2024-12-10 17:18:51,73,1753,46,27,949.09,1958.01,0.00
2024-12-10 17:18:51,72,1753,45,27,958.88,1958.07,0.00
2024-12-10 17:18:51,71,1753,44,27,972.08,1958.07,0.00
2024-12-10 17:18:51,70,1753,44,26,975.73,1958.51,0.00
2024-12-10 17:18:51,70,1754,44,26,971.16,1959.00,0.00
2024-12-10 17:18:51,71,1754,44,27,957.48,1959.01,0.00
2024-12-10 17:18:51,70,1754,44,26,946.60,1959.73,0.00
2024-12-10 17:18:51,70,1755,44,26,950.52,1960.00,0.00
2024-12-10 17:18:51,71,1755,44,27,937.13,1960.01,0.00
2024-12-10 17:18:51,70,1755,44,26,949.29,1960.06,0.00
2024-12-10 17:18:51,69,1755,44,25,931.21,1960.75,0.00
2024-12-10 17:18:51,69,1756,44,25,939.44,1961.00,0.00
2024-12-10 17:18:51,70,1756,45,25,926.02,1961.01,0.00
2024-12-10 17:18:51,69,1756,44,25,926.51,1961.51,0.00
2024-12-10 17:18:51,69,1757,44,25,911.75,1962.00,0.00
2024-12-10 17:18:51,70,1757,44,26,898.72,1962.01,0.00
2024-12-10 17:18:51,69,1757,44,25,889.73,1962.61,0.00
2024-12-10 17:18:51,68,1757,44,24,899.61,1962.72,0.00
2024-12-10 17:18:51,67,1757,43,24,897.26,1962.91,0.00
2024-12-10 17:18:51,67,1758,43,24,913.27,1963.00,0.00
2024-12-10 17:18:51,68,1758,43,25,899.84,1963.02,0.00
2024-12-10 17:18:51,69,1757,43,26,876.19,1963.44,0.00
2024-12-10 17:18:51,68,1757,42,26,899.05,1963.60,0.00
2024-12-10 17:18:51,68,1758,42,26,899.23,1964.00,0.00
2024-12-10 17:18:51,69,1758,42,27,886.19,1964.02,0.00
2024-12-10 17:18:51,68,1758,41,27,898.37,1964.04,0.00
2024-12-10 17:18:51,67,1758,40,27,911.49,1964.05,0.00
2024-12-10 17:18:51,66,1758,39,27,925.00,1964.05,0.00
2024-12-10 17:18:51,65,1758,39,26,918.03,1964.85,0.00
2024-12-10 17:18:51,65,1759,39,26,960.71,1965.00,0.00
2024-12-10 17:18:51,66,1759,39,27,946.15,1965.02,0.00
2024-12-10 17:18:51,65,1759,38,27,957.79,1965.06,0.00
2024-12-10 17:18:51,64,1759,37,27,972.41,1965.06,0.00
2024-12-10 17:18:51,64,1760,37,27,966.45,1966.00,0.00
2024-12-10 17:18:51,65,1760,37,28,951.59,1966.02,0.00
2024-12-10 17:18:51,64,1760,36,28,962.70,1966.08,0.00
2024-12-10 17:18:51,63,1760,36,27,952.86,1966.87,0.00
2024-12-10 17:18:51,63,1761,36,27,975.51,1967.00,0.00
2024-12-10 17:18:51,64,1761,36,28,960.27,1967.02,0.00
2024-12-10 17:18:51,63,1761,35,28,973.14,1967.05,0.00
2024-12-10 17:18:51,62,1761,35,27,988.70,1967.05,0.00
2024-12-10 17:18:51,61,1761,35,26,977.36,1967.87,0.00
2024-12-10 17:18:51,61,1762,35,26,1005.69,1968.00,0.00
2024-12-10 17:18:51,62,1762,35,27,989.46,1968.02,0.00
2024-12-10 17:18:51,61,1762,34,27,1004.16,1968.08,0.00
2024-12-10 17:18:52,60,1762,33,27,1017.17,1968.25,0.00
2024-12-10 17:18:52,60,1763,33,27,1022.62,1969.00,0.00
2024-12-10 17:18:52,61,1763,33,28,1005.86,1969.02,0.00
2024-12-10 17:18:52,62,1762,33,29,975.75,1969.63,0.00
2024-12-10 17:18:52,62,1763,33,29,996.19,1970.00,0.00
2024-12-10 17:18:52,63,1763,34,29,980.37,1970.02,0.00
2024-12-10 17:18:52,64,1762,34,30,964.76,1970.06,0.00
2024-12-10 17:18:52,63,1762,34,29,988.32,1970.76,0.00
2024-12-10 17:18:52,62,1762,33,29,1002.05,1970.77,0.00
2024-12-10 17:18:52,62,1763,33,29,1054.28,1971.00,0.00
2024-12-10 17:18:52,63,1763,34,29,1037.55,1971.02,0.00
2024-12-10 17:18:52,62,1763,34,28,1039.87,1971.50,0.00
2024-12-10 17:18:52,62,1764,34,28,1081.35,1972.00,0.00
2024-12-10 17:18:52,63,1764,35,28,1064.18,1972.02,0.00
2024-12-10 17:18:52,63,1765,35,28,1059.01,1973.00,0.00
2024-12-10 17:18:52,64,1765,36,28,1042.47,1973.02,0.00
2024-12-10 17:18:52,63,1765,35,28,1038.09,1973.73,0.00
2024-12-10 17:18:52,63,1766,35,28,1059.45,1974.00,0.00
2024-12-10 17:18:52,64,1766,36,28,1042.90,1974.02,0.00
2024-12-10 17:18:52,64,1767,36,28,1047.36,1975.00,0.00
2024-12-10 17:18:52,65,1767,37,28,1031.25,1975.02,0.00
2024-12-10 17:18:52,64,1767,36,28,1046.46,1975.05,0.00
2024-12-10 17:18:52,63,1767,36,27,1062.76,1975.05,0.00
2024-12-10 17:18:52,62,1767,36,26,1079.20,1975.08,0.00
2024-12-10 17:18:52,62,1768,36,26,1089.68,1976.00,0.00
2024-12-10 17:18:52,63,1768,36,27,1072.39,1976.02,0.00
2024-12-10 17:18:52,63,1769,36,27,1081.47,1977.00,0.00
2024-12-10 17:18:52,64,1769,37,27,1064.58,1977.02,0.00
2024-12-10 17:18:52,64,1770,37,27,1067.81,1978.00,0.00
2024-12-10 17:18:52,65,1770,38,27,1051.38,1978.02,0.00
2024-12-10 17:18:52,66,1769,38,28,1024.01,1978.55,0.00
2024-12-10 17:18:52,65,1769,38,27,1042.63,1978.69,0.00
2024-12-10 17:18:52,65,1770,38,27,1061.67,1979.00,0.00
2024-12-10 17:18:52,66,1770,39,27,1045.58,1979.02,0.00
2024-12-10 17:18:52,65,1770,38,27,1060.48,1979.06,0.00
2024-12-10 17:18:52,65,1771,38,27,1091.33,1980.00,0.00
2024-12-10 17:18:52,66,1771,39,27,1074.80,1980.02,0.00
2024-12-10 17:18:52,65,1771,39,26,1065.45,1980.74,0.00
2024-12-10 17:18:52,66,1770,39,27,1047.58,1980.85,0.00
2024-12-10 17:18:52,66,1771,39,27,1077.26,1981.00,0.00
2024-12-10 17:18:52,67,1771,39,28,1061.18,1981.02,0.00
2024-12-10 17:18:52,66,1771,39,27,1076.08,1981.06,0.00
2024-12-10 17:18:52,66,1772,39,27,1109.51,1982.00,0.00
2024-12-10 17:18:52,67,1772,40,27,1092.95,1982.02,0.00
2024-12-10 17:18:52,66,1772,39,27,1103.67,1982.30,0.00
2024-12-10 17:18:52,65,1772,39,26,1101.33,1982.65,0.00
2024-12-10 17:18:52,65,1773,39,26,1124.72,1983.00,0.00
2024-12-10 17:18:52,66,1773,39,27,1107.68,1983.02,0.00
2024-12-10 17:18:52,65,1773,38,27,1117.04,1983.37,0.00
2024-12-10 17:18:52,65,1774,38,27,1130.49,1984.00,0.00
2024-12-10 17:18:52,66,1774,38,28,1113.36,1984.02,0.00
2024-12-10 17:18:52,65,1774,37,28,1128.29,1984.09,0.00
2024-12-10 17:18:52,64,1774,36,28,1145.90,1984.09,0.00
2024-12-10 17:18:52,64,1775,36,28,1155.28,1985.00,0.00
2024-12-10 17:18:52,65,1775,36,29,1137.51,1985.02,0.00
2024-12-10 17:18:52,64,1775,35,29,1153.76,1985.08,0.00
2024-12-10 17:18:52,64,1776,35,29,1160.62,1986.00,0.00
2024-12-10 17:18:52,65,1776,35,30,1142.77,1986.02,0.00
2024-12-10 17:18:52,66,1775,35,31,1123.38,1986.15,0.00
2024-12-10 17:18:52,65,1775,34,31,1158.61,1986.35,0.00
2024-12-10 17:18:52,65,1776,34,31,1173.95,1987.00,0.00
2024-12-10 17:18:52,66,1776,35,31,1156.16,1987.02,0.00
2024-12-10 17:18:52,66,1777,35,31,1194.18,1988.00,0.00
2024-12-10 17:18:52,67,1777,36,31,1176.36,1988.02,0.00
2024-12-10 17:18:52,67,1778,36,31,1184.31,1989.00,0.00
2024-12-10 17:18:52,68,1778,36,32,1166.90,1989.02,0.00
2024-12-10 17:18:52,68,1779,36,32,1174.81,1990.00,0.00
2024-12-10 17:18:52,69,1779,37,32,1157.79,1990.02,0.00
2024-12-10 17:18:52,69,1780,37,32,1165.07,1991.00,0.00
2024-12-10 17:18:52,70,1780,38,32,1148.43,1991.01,0.00
2024-12-10 17:18:52,70,1781,38,32,1155.49,1992.00,0.00
2024-12-10 17:18:52,71,1781,39,32,1139.21,1992.01,0.00
2024-12-10 17:18:52,71,1782,39,32,1146.41,1993.00,0.00
2024-12-10 17:18:52,72,1782,39,33,1130.48,1993.01,0.00
2024-12-10 17:18:52,71,1782,39,32,1133.44,1993.49,0.00
2024-12-10 17:18:52,72,1781,40,32,1117.16,1993.54,0.00
2024-12-10 17:18:52,72,1782,40,32,1144.14,1994.00,0.00
2024-12-10 17:18:52,73,1782,40,33,1128.46,1994.01,0.00
2024-12-10 17:18:52,73,1783,40,33,1159.34,1995.00,0.00
2024-12-10 17:18:52,74,1783,41,33,1143.68,1995.01,0.00
2024-12-10 17:18:52,74,1784,41,33,1146.30,1996.00,0.00
2024-12-10 17:18:52,75,1784,42,33,1131.01,1996.01,0.00
2024-12-10 17:18:52,74,1784,41,33,1140.26,1996.31,0.00
2024-12-10 17:18:52,74,1785,41,33,1151.44,1997.00,0.00
2024-12-10 17:18:52,75,1785,42,33,1136.08,1997.01,0.00
2024-12-10 17:18:53,75,1786,42,33,1141.30,1998.00,0.00
2024-12-10 17:18:53,76,1786,43,33,1126.29,1998.01,0.00
2024-12-10 17:18:53,75,1786,43,32,1139.99,1998.07,0.00
2024-12-10 17:18:53,75,1787,43,32,1143.71,1999.00,0.00
2024-12-10 17:18:53,76,1787,44,32,1128.66,1999.01,0.00
2024-12-10 17:18:53,75,1787,44,31,1142.65,1999.05,0.00
2024-12-10 17:18:53,74,1787,43,31,1157.83,1999.05,0.00
2024-12-10 17:18:53,73,1787,42,31,1164.15,1999.34,0.00
2024-12-10 17:18:53,73,1788,42,31,1176.82,2000.00,0.00
2024-12-10 17:18:53,74,1788,43,31,1160.92,2000.01,0.00
2024-12-10 17:18:53,74,1789,43,31,1162.78,2001.00,0.00
2024-12-10 17:18:53,75,1789,44,31,1147.28,2001.01,0.00
2024-12-10 17:18:53,75,1790,44,31,1149.83,2002.00,0.00
2024-12-10 17:18:53,76,1790,44,32,1134.70,2002.01,0.00
2024-12-10 17:18:53,75,1790,43,32,1141.52,2002.32,0.00
2024-12-10 17:18:53,75,1791,43,32,1153.96,2003.00,0.00
2024-12-10 17:18:53,76,1791,43,33,1138.78,2003.01,0.00
2024-12-10 17:18:53,75,1791,42,33,1153.17,2003.04,0.00
2024-12-10 17:18:53,74,1791,42,32,1163.37,2003.28,0.00
2024-12-10 17:18:53,74,1792,42,32,1174.79,2004.00,0.00
2024-12-10 17:18:53,75,1792,43,32,1159.13,2004.01,0.00
2024-12-10 17:18:53,75,1793,43,32,1164.83,2005.00,0.00
2024-12-10 17:18:53,76,1793,43,33,1149.50,2005.01,0.00
2024-12-10 17:18:53,75,1793,43,32,1163.49,2005.07,0.00
2024-12-10 17:18:53,75,1794,43,32,1170.11,2006.00,0.00
2024-12-10 17:18:53,76,1794,44,32,1154.71,2006.01,0.00
2024-12-10 17:18:53,77,1793,44,33,1137.15,2006.17,0.00
2024-12-10 17:18:53,77,1794,44,33,1168.05,2007.00,0.00
2024-12-10 17:18:53,78,1794,44,34,1153.08,2007.01,0.00
2024-12-10 17:18:53,77,1794,44,33,1162.88,2007.26,0.00
2024-12-10 17:18:53,77,1795,44,33,1199.47,2008.00,0.00
2024-12-10 17:18:53,78,1795,45,33,1184.10,2008.01,0.00
2024-12-10 17:18:53,77,1795,44,33,1197.94,2008.08,0.00
2024-12-10 17:18:53,78,1794,44,34,1176.50,2008.41,0.00
2024-12-10 17:18:53,78,1795,44,34,1199.75,2009.00,0.00
2024-12-10 17:18:53,79,1795,45,34,1184.56,2009.01,0.00
2024-12-10 17:18:53,78,1795,45,33,1198.23,2009.08,0.00
2024-12-10 17:18:53,78,1796,45,33,1230.61,2010.00,0.00
2024-12-10 17:18:53,79,1796,46,33,1215.03,2010.01,0.00
2024-12-10 17:18:53,79,1797,46,33,1220.09,2011.00,0.00
2024-12-10 17:18:53,80,1797,46,34,1204.84,2011.01,0.00
2024-12-10 17:18:53,79,1797,46,33,1218.59,2011.08,0.00
2024-12-10 17:18:53,78,1797,46,32,1231.05,2011.23,0.00
2024-12-10 17:18:53,78,1798,46,32,1240.71,2012.00,0.00
2024-12-10 17:18:53,79,1798,46,33,1225.01,2012.01,0.00
2024-12-10 17:18:53,78,1798,45,33,1239.19,2012.08,0.00
2024-12-10 17:18:53,78,1799,45,33,1245.01,2013.00,0.00
2024-12-10 17:18:53,79,1799,45,34,1229.25,2013.01,0.00
2024-12-10 17:18:53,78,1799,44,34,1243.49,2013.08,0.00
2024-12-10 17:18:53,78,1800,44,34,1249.10,2014.00,0.00
2024-12-10 17:18:53,79,1800,45,34,1233.29,2014.01,0.00
2024-12-10 17:18:53,79,1801,45,34,1236.00,2015.00,0.00
2024-12-10 17:18:53,80,1801,45,35,1220.55,2015.01,0.00
2024-12-10 17:18:53,79,1801,45,34,1225.43,2015.34,0.00
2024-12-10 17:18:53,79,1802,45,34,1238.10,2016.00,0.00
2024-12-10 17:18:53,80,1802,45,35,1222.62,2016.01,0.00
2024-12-10 17:18:53,79,1802,45,34,1229.33,2016.23,0.00
2024-12-10 17:18:53,79,1803,45,34,1239.17,2017.00,0.00
2024-12-10 17:18:53,80,1803,46,34,1223.68,2017.01,0.00
2024-12-10 17:18:53,81,1802,46,35,1207.83,2017.07,0.00
2024-12-10 17:18:53,80,1802,45,35,1226.21,2017.20,0.00
2024-12-10 17:18:53,79,1802,45,34,1240.14,2017.22,0.00
2024-12-10 17:18:53,79,1803,45,34,1250.21,2018.00,0.00
2024-12-10 17:18:53,80,1803,46,34,1234.58,2018.01,0.00
2024-12-10 17:18:53,79,1803,45,34,1245.09,2018.19,0.00
2024-12-10 17:18:54,79,1804,45,34,1279.37,2019.00,0.00
2024-12-10 17:18:54,80,1804,46,34,1263.38,2019.01,0.00
2024-12-10 17:18:54,80,1805,46,34,1266.95,2020.00,0.00
2024-12-10 17:18:54,81,1805,46,35,1251.31,2020.01,0.00
2024-12-10 17:18:54,81,1806,46,35,1253.79,2021.00,0.00
2024-12-10 17:18:54,82,1806,46,36,1238.50,2021.01,0.00
2024-12-10 17:18:54,81,1806,45,36,1252.08,2021.09,0.00
2024-12-10 17:18:54,81,1807,45,36,1255.03,2022.00,0.00
2024-12-10 17:18:54,82,1807,46,36,1239.73,2022.01,0.00
2024-12-10 17:18:54,81,1807,45,36,1253.32,2022.09,0.00
2024-12-10 17:18:54,81,1808,45,36,1255.78,2023.00,0.00
2024-12-10 17:18:54,82,1808,45,37,1240.47,2023.01,0.00
2024-12-10 17:18:54,82,1809,45,37,1240.05,2024.00,0.00
2024-12-10 17:18:54,83,1809,45,38,1225.11,2024.01,0.00
2024-12-10 17:18:54,82,1809,44,38,1224.90,2024.51,0.00
2024-12-10 17:18:54,82,1810,44,38,1238.78,2025.00,0.00
2024-12-10 17:18:54,83,1810,44,39,1223.86,2025.01,0.00
2024-12-10 17:18:54,82,1810,43,39,1237.09,2025.09,0.00
2024-12-10 17:18:54,82,1811,43,39,1237.44,2026.00,0.00
2024-12-10 17:18:54,83,1811,44,39,1222.54,2026.01,0.00
2024-12-10 17:18:54,82,1811,43,39,1235.75,2026.09,0.00
2024-12-10 17:18:54,81,1811,43,38,1245.17,2026.36,0.00
2024-12-10 17:18:54,81,1812,43,38,1247.21,2027.00,0.00
2024-12-10 17:18:54,82,1812,43,39,1232.01,2027.01,0.00
2024-12-10 17:18:54,81,1812,43,38,1235.01,2027.46,0.00
2024-12-10 17:18:54,81,1813,43,38,1236.74,2028.00,0.00
2024-12-10 17:18:54,82,1813,44,38,1221.66,2028.01,0.00
2024-12-10 17:18:54,81,1813,43,38,1216.53,2028.49,0.00
2024-12-10 17:18:54,81,1814,43,38,1225.41,2029.00,0.00
2024-12-10 17:18:54,82,1814,43,39,1210.46,2029.01,0.00
2024-12-10 17:18:54,81,1814,42,39,1211.89,2029.47,0.00
2024-12-10 17:18:54,81,1815,42,39,1219.35,2030.00,0.00
2024-12-10 17:18:54,82,1815,42,40,1204.48,2030.01,0.00
2024-12-10 17:18:54,82,1816,42,40,1201.23,2031.00,0.00
2024-12-10 17:18:54,83,1816,43,40,1186.76,2031.01,0.00
2024-12-10 17:18:54,83,1817,43,40,1180.61,2032.00,0.00
2024-12-10 17:18:54,84,1817,44,40,1166.55,2032.01,0.00
2024-12-10 17:18:54,83,1817,43,40,1180.06,2032.04,0.00
2024-12-10 17:18:54,82,1817,43,39,1178.30,2032.51,0.00
2024-12-10 17:18:54,82,1818,43,39,1187.27,2033.00,0.00
2024-12-10 17:18:54,83,1818,44,39,1172.96,2033.01,0.00
2024-12-10 17:18:54,82,1818,43,39,1167.37,2033.54,0.00
2024-12-10 17:18:54,83,1817,44,39,1150.36,2033.62,0.00
2024-12-10 17:18:54,83,1818,44,39,1174.46,2034.00,0.00
2024-12-10 17:18:54,84,1818,44,40,1160.47,2034.01,0.00
2024-12-10 17:18:54,83,1818,43,40,1173.01,2034.07,0.00
2024-12-10 17:18:54,83,1819,43,40,1194.53,2035.00,0.00
2024-12-10 17:18:54,84,1819,44,40,1180.31,2035.01,0.00
2024-12-10 17:18:54,85,1818,44,41,1161.33,2035.24,0.00
2024-12-10 17:18:54,85,1819,44,41,1174.61,2036.00,0.00
2024-12-10 17:18:54,86,1819,45,41,1160.95,2036.01,0.00
2024-12-10 17:18:54,85,1819,44,41,1173.19,2036.07,0.00
2024-12-10 17:18:54,84,1819,44,40,1175.28,2036.41,0.00
2024-12-10 17:18:54,83,1819,43,40,1187.03,2036.48,0.00
2024-12-10 17:18:54,83,1820,43,40,1223.56,2037.00,0.00
2024-12-10 17:18:54,84,1820,44,40,1209.00,2037.01,0.00
2024-12-10 17:18:54,84,1821,44,40,1204.64,2038.00,0.00
2024-12-10 17:18:54,85,1821,45,40,1190.47,2038.01,0.00
2024-12-10 17:18:54,84,1821,44,40,1203.21,2038.07,0.00
2024-12-10 17:18:54,83,1821,43,40,1214.02,2038.18,0.00
2024-12-10 17:18:54,82,1821,42,40,1226.70,2038.20,0.00
2024-12-10 17:18:54,82,1822,42,40,1231.59,2039.00,0.00
2024-12-10 17:18:54,83,1822,42,41,1216.75,2039.01,0.00
2024-12-10 17:18:54,82,1822,41,41,1231.47,2039.01,0.00
2024-12-10 17:18:54,82,1823,41,41,1231.87,2040.00,0.00
2024-12-10 17:18:54,83,1823,42,41,1217.03,2040.01,0.00
2024-12-10 17:18:54,82,1823,41,41,1226.33,2040.21,0.00
2024-12-10 17:18:54,82,1824,41,41,1231.55,2041.00,0.00
2024-12-10 17:18:54,83,1824,41,42,1216.71,2041.01,0.00
2024-12-10 17:18:54,83,1825,41,42,1215.13,2042.00,0.00
2024-12-10 17:18:54,84,1825,41,43,1200.66,2042.01,0.00
2024-12-10 17:18:54,83,1825,40,43,1200.61,2042.43,0.00
2024-12-10 17:18:54,83,1826,40,43,1210.95,2043.00,0.00
2024-12-10 17:18:54,84,1826,41,43,1196.53,2043.01,0.00
2024-12-10 17:18:54,83,1826,40,43,1204.01,2043.21,0.00
2024-12-10 17:18:54,82,1826,40,42,1217.84,2043.21,0.00
2024-12-10 17:18:54,82,1827,40,42,1223.56,2044.00,0.00
2024-12-10 17:18:54,83,1827,41,42,1208.82,2044.01,0.00
2024-12-10 17:18:54,83,1828,41,42,1209.77,2045.00,0.00
2024-12-10 17:18:54,84,1828,41,43,1195.37,2045.01,0.00
2024-12-10 17:18:54,83,1828,41,42,1200.10,2045.43,0.00
2024-12-10 17:18:54,83,1829,41,42,1211.97,2046.00,0.00
2024-12-10 17:18:54,84,1829,42,42,1197.54,2046.01,0.00
2024-12-10 17:18:54,84,1830,42,42,1199.51,2047.00,0.00
2024-12-10 17:18:54,85,1830,42,43,1185.40,2047.01,0.00
2024-12-10 17:18:54,84,1830,41,43,1198.08,2047.07,0.00
2024-12-10 17:18:54,85,1829,41,44,1165.32,2047.87,0.00
2024-12-10 17:18:54,85,1830,41,44,1189.54,2048.00,0.00
2024-12-10 17:18:54,86,1830,41,45,1175.71,2048.01,0.00
2024-12-10 17:18:55,86,1831,41,45,1200.12,2049.00,0.00
2024-12-10 17:18:55,87,1831,41,46,1186.33,2049.01,0.00
2024-12-10 17:18:55,87,1832,41,46,1186.42,2050.00,0.00
2024-12-10 17:18:55,88,1832,42,46,1172.94,2050.01,0.00
2024-12-10 17:18:55,87,1832,41,46,1178.50,2050.39,0.00
2024-12-10 17:18:55,87,1833,41,46,1187.44,2051.00,0.00
2024-12-10 17:18:55,88,1833,42,46,1173.95,2051.01,0.00
2024-12-10 17:18:55,88,1834,42,46,1174.62,2052.00,0.00
2024-12-10 17:18:55,89,1834,42,47,1161.42,2052.01,0.00
2024-12-10 17:18:55,88,1834,42,46,1172.68,2052.10,0.00
2024-12-10 17:18:55,88,1835,42,46,1174.96,2053.00,0.00
2024-12-10 17:18:55,89,1835,43,46,1161.76,2053.01,0.00
2024-12-10 17:18:55,88,1835,43,45,1173.27,2053.09,0.00
2024-12-10 17:18:55,87,1835,42,45,1178.99,2053.46,0.00
2024-12-10 17:18:55,88,1834,42,46,1159.76,2053.67,0.00
2024-12-10 17:18:55,88,1835,42,46,1182.69,2054.00,0.00
2024-12-10 17:18:55,89,1835,43,46,1169.40,2054.01,0.00
2024-12-10 17:18:55,90,1834,43,47,1154.60,2054.12,0.00
2024-12-10 17:18:55,90,1835,43,47,1193.81,2055.00,0.00
2024-12-10 17:18:55,91,1835,44,47,1180.69,2055.01,0.00
2024-12-10 17:18:55,91,1836,44,47,1201.42,2056.00,0.00
2024-12-10 17:18:55,92,1836,44,48,1188.36,2056.01,0.00
2024-12-10 17:18:55,91,1836,44,47,1192.05,2056.46,0.00
2024-12-10 17:18:55,91,1837,44,47,1202.28,2057.00,0.00
2024-12-10 17:18:55,92,1837,44,48,1189.21,2057.01,0.00
2024-12-10 17:18:55,93,1836,44,49,1158.15,2057.82,0.00
2024-12-10 17:18:55,93,1837,44,49,1179.79,2058.00,0.00
2024-12-10 17:18:55,94,1837,45,49,1167.24,2058.01,0.00
2024-12-10 17:18:55,94,1838,45,49,1187.35,2059.00,0.00
2024-12-10 17:18:55,95,1838,45,50,1174.86,2059.01,0.00
2024-12-10 17:18:55,94,1838,45,49,1185.82,2059.06,0.00
2024-12-10 17:18:55,94,1839,45,49,1184.64,2060.00,0.00
2024-12-10 17:18:55,95,1839,45,50,1172.17,2060.01,0.00
2024-12-10 17:18:55,95,1840,45,50,1168.76,2061.00,0.00
2024-12-10 17:18:55,96,1840,46,50,1156.58,2061.01,0.00
2024-12-10 17:18:55,95,1840,45,50,1161.48,2061.31,0.00
2024-12-10 17:18:55,95,1841,45,50,1166.31,2062.00,0.00
2024-12-10 17:18:55,96,1841,45,51,1154.17,2062.01,0.00
2024-12-10 17:18:55,95,1841,44,51,1166.08,2062.01,0.00
2024-12-10 17:18:55,94,1841,44,50,1168.37,2062.47,0.00
2024-12-10 17:18:55,94,1842,44,50,1177.02,2063.00,0.00
2024-12-10 17:18:55,95,1842,45,50,1164.63,2063.01,0.00
2024-12-10 17:18:55,94,1842,44,50,1176.59,2063.02,0.00
2024-12-10 17:18:55,93,1842,44,49,1188.54,2063.05,0.00
2024-12-10 17:18:55,93,1843,44,49,1188.14,2064.00,0.00
2024-12-10 17:18:55,94,1843,44,50,1175.50,2064.01,0.00
2024-12-10 17:18:55,93,1843,44,49,1176.93,2064.48,0.00
2024-12-10 17:18:55,93,1844,44,49,1187.58,2065.00,0.00
2024-12-10 17:18:55,94,1844,44,50,1174.95,2065.01,0.00
2024-12-10 17:18:55,94,1845,44,50,1174.61,2066.00,0.00
2024-12-10 17:18:55,95,1845,44,51,1162.25,2066.01,0.00
2024-12-10 17:18:55,95,1846,44,51,1160.39,2067.00,0.00
2024-12-10 17:18:55,96,1846,45,51,1148.30,2067.01,0.00
2024-12-10 17:18:55,96,1847,45,51,1146.28,2068.00,0.00
2024-12-10 17:18:55,97,1847,45,52,1134.46,2068.01,0.00
2024-12-10 17:18:55,98,1846,46,52,1110.31,2068.61,0.00
2024-12-10 17:18:55,98,1847,46,52,1128.48,2069.00,0.00
2024-12-10 17:18:55,99,1847,46,53,1117.08,2069.01,0.00
2024-12-10 17:18:55,98,1847,46,52,1127.85,2069.03,0.00
2024-12-10 17:18:55,97,1847,46,51,1138.85,2069.05,0.00
2024-12-10 17:18:56,97,1848,46,51,1158.81,2070.00,0.00
2024-12-10 17:18:56,98,1848,47,51,1146.99,2070.01,0.00
2024-12-10 17:18:56,98,1849,47,51,1143.51,2071.00,0.00
2024-12-10 17:18:56,99,1849,47,52,1131.96,2071.01,0.00
2024-12-10 17:18:56,98,1849,46,52,1126.45,2071.62,0.00
2024-12-10 17:18:56,98,1850,46,52,1138.52,2072.00,0.00
2024-12-10 17:18:56,99,1850,46,53,1127.02,2072.01,0.00
2024-12-10 17:18:56,98,1850,45,53,1137.27,2072.06,0.00
2024-12-10 17:18:56,98,1851,45,53,1133.45,2073.00,0.00
2024-12-10 17:18:56,99,1851,45,54,1122.01,2073.01,0.00
2024-12-10 17:18:56,98,1851,44,54,1132.21,2073.06,0.00
2024-12-10 17:18:56,97,1851,43,54,1139.23,2073.22,0.00
2024-12-10 17:18:56,97,1852,43,54,1138.62,2074.00,0.00
2024-12-10 17:18:56,98,1852,44,54,1127.00,2074.01,0.00
2024-12-10 17:18:56,97,1852,43,54,1127.51,2074.51,0.00
2024-12-10 17:18:56,97,1853,43,54,1133.67,2075.00,0.00
2024-12-10 17:18:56,98,1853,43,55,1122.10,2075.01,0.00
2024-12-10 17:18:56,98,1854,43,55,1116.37,2076.00,0.00
2024-12-10 17:18:56,99,1854,43,56,1105.09,2076.01,0.00
2024-12-10 17:18:56,99,1855,43,56,1097.38,2077.00,0.00
2024-12-10 17:18:56,100,1855,43,57,1086.41,2077.01,0.00
2024-12-10 17:18:56,99,1855,42,57,1095.18,2077.06,0.00
2024-12-10 17:18:56,99,1856,42,57,1090.23,2078.00,0.00
2024-12-10 17:18:56,100,1856,42,58,1079.33,2078.01,0.00
2024-12-10 17:18:56,101,1855,43,58,1068.44,2078.04,0.00
2024-12-10 17:18:56,100,1855,42,58,1092.07,2078.07,0.00
2024-12-10 17:18:56,100,1856,42,58,1087.23,2079.00,0.00
2024-12-10 17:18:56,101,1856,43,58,1076.47,2079.01,0.00
2024-12-10 17:18:56,100,1856,42,58,1085.24,2079.06,0.00
2024-12-10 17:18:56,99,1856,42,57,1079.25,2079.61,0.00
2024-12-10 17:18:56,99,1857,42,57,1112.07,2080.00,0.00
2024-12-10 17:18:56,100,1857,43,57,1100.95,2080.01,0.00
2024-12-10 17:18:56,99,1857,42,57,1110.41,2080.06,0.00
2024-12-10 17:18:56,98,1857,42,56,1121.53,2080.06,0.00
2024-12-10 17:18:56,97,1857,42,55,1120.11,2080.54,0.00
2024-12-10 17:18:56,97,1858,42,55,1129.93,2081.00,0.00
2024-12-10 17:18:56,98,1858,43,55,1118.40,2081.01,0.00
2024-12-10 17:18:56,97,1858,43,54,1128.66,2081.06,0.00
2024-12-10 17:18:56,97,1859,43,54,1125.52,2082.00,0.00
2024-12-10 17:18:56,98,1859,44,54,1114.03,2082.01,0.00
2024-12-10 17:18:56,97,1859,43,54,1124.25,2082.06,0.00
2024-12-10 17:18:56,98,1858,44,54,1103.66,2082.49,0.00
2024-12-10 17:18:56,98,1859,44,54,1129.16,2083.00,0.00
2024-12-10 17:18:56,99,1859,45,54,1117.76,2083.01,0.00
2024-12-10 17:18:56,98,1859,45,53,1127.91,2083.06,0.00
2024-12-10 17:18:56,97,1859,45,52,1136.16,2083.22,0.00
2024-12-10 17:18:56,97,1860,45,52,1153.24,2084.00,0.00
2024-12-10 17:18:56,98,1860,45,53,1141.48,2084.01,0.00
2024-12-10 17:18:56,97,1860,45,52,1151.98,2084.06,0.00
2024-12-10 17:18:56,96,1860,44,52,1143.97,2084.59,0.00
2024-12-10 17:18:56,96,1861,44,52,1154.56,2085.00,0.00
2024-12-10 17:18:56,97,1861,45,52,1142.66,2085.01,0.00
2024-12-10 17:18:56,96,1861,45,51,1153.28,2085.06,0.00
2024-12-10 17:18:56,96,1862,45,51,1146.19,2086.00,0.00
2024-12-10 17:18:56,97,1862,46,51,1134.37,2086.01,0.00
2024-12-10 17:18:56,96,1862,46,50,1125.29,2086.64,0.00
2024-12-10 17:18:56,96,1863,46,50,1137.48,2087.00,0.00
2024-12-10 17:18:56,97,1863,46,51,1125.75,2087.01,0.00
2024-12-10 17:18:56,96,1863,45,51,1129.02,2087.41,0.00
2024-12-10 17:18:56,95,1863,44,51,1134.83,2087.51,0.00
2024-12-10 17:18:56,95,1864,44,51,1142.64,2088.00,0.00
2024-12-10 17:18:56,96,1864,45,51,1130.74,2088.01,0.00
2024-12-10 17:18:56,95,1864,44,51,1131.69,2088.43,0.00
2024-12-10 17:18:57,95,1865,44,51,1136.77,2089.00,0.00
2024-12-10 17:18:57,96,1865,44,52,1124.93,2089.01,0.00
2024-12-10 17:18:57,95,1865,44,51,1134.62,2089.06,0.00
2024-12-10 17:18:57,94,1865,43,51,1137.01,2089.49,0.00
2024-12-10 17:18:57,94,1866,43,51,1143.88,2090.00,0.00
2024-12-10 17:18:57,95,1866,43,52,1131.84,2090.01,0.00
2024-12-10 17:18:57,95,1867,43,52,1125.67,2091.00,0.00
2024-12-10 17:18:57,96,1867,43,53,1113.95,2091.01,0.00
2024-12-10 17:18:57,95,1867,43,52,1121.93,2091.05,0.00
2024-12-10 17:18:57,94,1867,42,52,1133.64,2091.05,0.00
2024-12-10 17:18:57,94,1868,42,52,1130.66,2092.00,0.00
2024-12-10 17:18:57,95,1868,42,53,1118.76,2092.01,0.00
2024-12-10 17:18:57,94,1868,41,53,1129.57,2092.05,0.00
2024-12-10 17:18:57,93,1868,41,52,1127.94,2092.66,0.00
2024-12-10 17:18:57,93,1869,41,52,1142.28,2093.00,0.00
2024-12-10 17:18:57,94,1869,42,52,1130.13,2093.01,0.00
2024-12-10 17:18:57,93,1869,42,51,1141.61,2093.03,0.00
2024-12-10 17:18:57,92,1869,42,50,1153.58,2093.04,0.00
2024-12-10 17:18:57,91,1869,41,50,1166.02,2093.04,0.00
2024-12-10 17:18:57,91,1870,41,50,1166.61,2094.00,0.00
2024-12-10 17:18:57,92,1870,42,50,1153.93,2094.01,0.00
2024-12-10 17:18:57,92,1871,42,50,1151.80,2095.00,0.00
2024-12-10 17:18:57,93,1871,43,50,1139.41,2095.01,0.00
2024-12-10 17:18:57,93,1872,43,50,1133.69,2096.00,0.00
2024-12-10 17:18:57,94,1872,43,51,1121.63,2096.01,0.00
2024-12-10 17:18:57,93,1872,43,50,1127.65,2096.17,0.00
2024-12-10 17:18:57,93,1873,43,50,1125.30,2097.00,0.00
2024-12-10 17:18:57,94,1873,44,50,1113.33,2097.01,0.00
2024-12-10 17:18:57,93,1873,44,49,1106.32,2097.62,0.00
2024-12-10 17:18:57,93,1874,44,49,1118.99,2098.00,0.00
2024-12-10 17:18:57,94,1874,45,49,1107.09,2098.01,0.00
2024-12-10 17:18:57,94,1875,45,49,1103.39,2099.00,0.00
2024-12-10 17:18:57,95,1875,45,50,1091.78,2099.01,0.00
2024-12-10 17:18:57,95,1876,45,50,1086.96,2100.00,0.00
2024-12-10 17:18:57,96,1876,46,50,1075.64,2100.01,0.00
2024-12-10 17:18:57,95,1876,45,50,1086.09,2100.04,0.00
2024-12-10 17:18:57,94,1876,44,50,1083.63,2100.59,0.00
2024-12-10 17:18:57,94,1877,44,50,1093.78,2101.00,0.00
2024-12-10 17:18:57,95,1877,44,51,1082.26,2101.01,0.00
2024-12-10 17:18:57,96,1876,44,52,1049.49,2101.85,0.00
2024-12-10 17:18:57,96,1877,44,52,1071.52,2102.00,0.00
2024-12-10 17:18:57,97,1877,45,52,1060.47,2102.01,0.00
2024-12-10 17:18:57,97,1878,45,52,1078.74,2103.00,0.00
2024-12-10 17:18:57,98,1878,45,53,1067.73,2103.01,0.00
2024-12-10 17:18:57,98,1879,45,53,1063.47,2104.00,0.00
2024-12-10 17:18:57,99,1879,45,54,1052.73,2104.01,0.00
2024-12-10 17:18:57,98,1879,44,54,1062.42,2104.05,0.00
2024-12-10 17:18:57,97,1879,43,54,1068.11,2104.29,0.00
2024-12-10 17:18:57,97,1880,43,54,1068.74,2105.00,0.00
2024-12-10 17:18:57,98,1880,44,54,1057.84,2105.01,0.00
2024-12-10 17:18:57,97,1880,44,53,1067.68,2105.05,0.00
2024-12-10 17:18:57,96,1880,44,52,1061.56,2105.63,0.00
2024-12-10 17:18:57,95,1880,44,51,1071.70,2105.66,0.00
2024-12-10 17:18:57,95,1881,44,51,1086.16,2106.00,0.00
2024-12-10 17:18:57,96,1881,45,51,1074.85,2106.01,0.00
2024-12-10 17:18:57,95,1881,44,51,1085.07,2106.05,0.00
2024-12-10 17:18:57,94,1881,44,50,1096.39,2106.05,0.00
2024-12-10 17:18:57,93,1881,44,49,1096.66,2106.44,0.00
2024-12-10 17:18:57,93,1882,44,49,1104.24,2107.00,0.00
2024-12-10 17:18:57,94,1882,44,50,1092.49,2107.01,0.00
2024-12-10 17:18:57,93,1882,44,49,1103.12,2107.05,0.00
2024-12-10 17:18:57,94,1881,44,50,1080.62,2107.52,0.00
2024-12-10 17:18:57,95,1880,45,50,1071.91,2107.80,0.00
2024-12-10 17:18:57,95,1881,45,50,1092.97,2108.00,0.00
2024-12-10 17:18:57,96,1881,45,51,1081.58,2108.01,0.00
2024-12-10 17:18:57,95,1881,44,51,1091.88,2108.05,0.00
2024-12-10 17:18:57,95,1882,44,51,1132.56,2109.00,0.00
2024-12-10 17:18:57,96,1882,44,52,1120.76,2109.01,0.00
2024-12-10 17:18:57,96,1883,44,52,1115.76,2110.00,0.00
2024-12-10 17:18:57,97,1883,45,52,1104.26,2110.01,0.00
2024-12-10 17:18:57,96,1883,44,52,1114.68,2110.05,0.00
2024-12-10 17:18:57,96,1884,44,52,1110.61,2111.00,0.00
2024-12-10 17:18:57,97,1884,44,53,1099.17,2111.01,0.00
2024-12-10 17:18:57,96,1884,44,52,1109.53,2111.05,0.00
2024-12-10 17:18:57,97,1883,45,52,1087.88,2111.51,0.00
2024-12-10 17:18:57,96,1883,44,52,1101.23,2111.68,0.00
2024-12-10 17:18:57,96,1884,44,52,1115.80,2112.00,0.00
2024-12-10 17:18:57,97,1884,45,52,1104.29,2112.01,0.00
2024-12-10 17:18:57,96,1884,44,52,1107.04,2112.39,0.00
2024-12-10 17:18:57,95,1884,43,52,1109.54,2112.63,0.00
2024-12-10 17:18:57,95,1885,43,52,1146.34,2113.00,0.00
2024-12-10 17:18:57,96,1885,44,52,1134.40,2113.01,0.00
2024-12-10 17:18:57,95,1885,44,51,1145.24,2113.05,0.00
2024-12-10 17:18:57,95,1886,44,51,1146.46,2114.00,0.00
2024-12-10 17:18:57,96,1886,44,52,1134.51,2114.01,0.00
2024-12-10 17:18:57,97,1885,45,52,1122.82,2114.03,0.00
2024-12-10 17:18:57,96,1885,44,52,1154.80,2114.06,0.00
2024-12-10 17:18:57,96,1886,44,52,1154.86,2115.00,0.00
2024-12-10 17:18:57,97,1886,44,53,1142.96,2115.01,0.00
2024-12-10 17:18:57,97,1887,44,53,1161.68,2116.00,0.00
2024-12-10 17:18:57,98,1887,45,53,1149.83,2116.01,0.00
2024-12-10 17:18:57,97,1887,45,52,1160.61,2116.05,0.00
2024-12-10 17:18:57,98,1886,46,52,1144.70,2116.27,0.00
2024-12-10 17:18:57,98,1887,46,52,1160.71,2117.00,0.00
2024-12-10 17:18:57,99,1887,46,53,1148.98,2117.01,0.00
2024-12-10 17:18:57,98,1887,45,53,1159.65,2117.05,0.00
2024-12-10 17:18:57,97,1887,45,52,1164.20,2117.39,0.00
2024-12-10 17:18:58,97,1888,45,52,1188.58,2118.00,0.00
2024-12-10 17:18:58,98,1888,46,52,1176.45,2118.01,0.00
2024-12-10 17:18:58,97,1888,45,52,1187.51,2118.05,0.00
2024-12-10 17:18:58,96,1888,44,52,1185.32,2118.62,0.00
2024-12-10 17:18:58,96,1889,44,52,1194.66,2119.00,0.00
2024-12-10 17:18:58,97,1889,44,53,1182.34,2119.01,0.00
2024-12-10 17:18:58,96,1889,43,53,1193.58,2119.05,0.00
2024-12-10 17:18:58,96,1890,43,53,1191.07,2120.00,0.00
2024-12-10 17:18:58,97,1890,43,54,1178.79,2120.01,0.00
2024-12-10 17:18:58,96,1890,43,53,1189.99,2120.05,0.00
2024-12-10 17:18:58,95,1890,42,53,1187.93,2120.61,0.00
2024-12-10 17:18:58,95,1891,42,53,1201.13,2121.00,0.00
2024-12-10 17:18:58,96,1891,42,54,1188.61,2121.01,0.00
2024-12-10 17:18:58,96,1892,42,54,1189.01,2122.00,0.00
2024-12-10 17:18:58,97,1892,43,54,1176.75,2122.01,0.00
2024-12-10 17:18:58,96,1892,42,54,1187.92,2122.05,0.00
2024-12-10 17:18:58,97,1891,43,54,1163.05,2122.61,0.00
2024-12-10 17:18:58,97,1892,43,54,1183.08,2123.00,0.00
2024-12-10 17:18:58,98,1892,44,54,1171.01,2123.01,0.00
2024-12-10 17:18:58,97,1892,44,53,1182.01,2123.05,0.00
2024-12-10 17:18:58,96,1892,44,52,1192.68,2123.10,0.00
2024-12-10 17:18:58,96,1893,44,52,1216.38,2124.00,0.00
2024-12-10 17:18:58,97,1893,44,53,1203.84,2124.01,0.00
2024-12-10 17:18:58,96,1893,44,52,1215.30,2124.05,0.00
2024-12-10 17:18:58,96,1894,44,52,1215.97,2125.00,0.00
2024-12-10 17:18:58,97,1894,45,52,1203.43,2125.01,0.00
2024-12-10 17:18:58,96,1894,45,51,1214.88,2125.05,0.00
2024-12-10 17:18:58,96,1895,45,51,1216.08,2126.00,0.00
2024-12-10 17:18:58,97,1895,46,51,1203.54,2126.01,0.00
2024-12-10 17:18:58,98,1894,46,52,1172.23,2126.90,0.00
2024-12-10 17:18:58,98,1895,46,52,1193.82,2127.00,0.00
2024-12-10 17:18:58,99,1895,46,53,1181.76,2127.01,0.00
2024-12-10 17:18:58,98,1895,46,52,1192.53,2127.06,0.00
2024-12-10 17:18:58,98,1896,46,52,1215.77,2128.00,0.00
2024-12-10 17:18:58,99,1896,47,52,1203.49,2128.01,0.00
2024-12-10 17:18:58,98,1896,46,52,1214.49,2128.06,0.00
2024-12-10 17:18:58,98,1897,46,52,1215.43,2129.00,0.00
2024-12-10 17:18:58,99,1897,46,53,1203.15,2129.01,0.00
2024-12-10 17:18:58,100,1896,47,53,1177.28,2129.63,0.00
2024-12-10 17:18:58,100,1897,47,53,1195.67,2130.00,0.00
2024-12-10 17:18:58,101,1897,48,53,1183.83,2130.01,0.00
2024-12-10 17:18:58,100,1897,48,52,1194.41,2130.06,0.00
2024-12-10 17:18:58,99,1897,47,52,1203.52,2130.19,0.00
2024-12-10 17:18:58,99,1898,47,52,1224.87,2131.00,0.00
2024-12-10 17:18:58,100,1898,48,52,1212.63,2131.01,0.00
2024-12-10 17:18:58,100,1899,48,52,1206.88,2132.00,0.00
2024-12-10 17:18:58,101,1899,49,52,1194.93,2132.01,0.00
2024-12-10 17:18:58,100,1899,48,52,1195.08,2132.53,0.00
2024-12-10 17:18:58,100,1900,48,52,1202.81,2133.00,0.00
2024-12-10 17:18:58,101,1900,48,53,1190.90,2133.01,0.00
2024-12-10 17:18:58,100,1900,48,52,1201.97,2133.04,0.00
2024-12-10 17:18:58,99,1900,47,52,1213.68,2133.05,0.00
2024-12-10 17:18:58,99,1901,47,52,1210.96,2134.00,0.00
2024-12-10 17:18:58,100,1901,48,52,1198.85,2134.01,0.00
2024-12-10 17:18:58,99,1901,47,52,1194.15,2134.68,0.00
2024-12-10 17:18:58,99,1902,47,52,1207.01,2135.00,0.00
2024-12-10 17:18:58,100,1902,48,52,1194.94,2135.01,0.00
2024-12-10 17:18:58,100,1903,48,52,1190.06,2136.00,0.00
2024-12-10 17:18:58,101,1903,48,53,1178.28,2136.01,0.00
2024-12-10 17:18:58,100,1903,47,53,1188.59,2136.07,0.00
2024-12-10 17:18:58,101,1902,48,53,1161.04,2136.65,0.00
2024-12-10 17:18:58,101,1903,48,53,1177.00,2137.00,0.00
2024-12-10 17:18:58,102,1903,49,53,1165.46,2137.01,0.00
2024-12-10 17:18:58,101,1903,48,53,1175.54,2137.07,0.00
2024-12-10 17:18:58,101,1904,48,53,1188.07,2138.00,0.00
2024-12-10 17:18:58,102,1904,48,54,1176.42,2138.01,0.00
2024-12-10 17:18:58,101,1904,47,54,1184.75,2138.16,0.00
2024-12-10 17:18:58,101,1905,47,54,1174.90,2139.00,0.00
2024-12-10 17:18:58,102,1905,48,54,1163.38,2139.01,0.00
2024-12-10 17:18:58,101,1905,48,53,1166.93,2139.31,0.00
2024-12-10 17:18:58,100,1905,47,53,1172.10,2139.53,0.00
2024-12-10 17:18:58,99,1905,47,52,1182.01,2139.57,0.00
2024-12-10 17:18:58,99,1906,47,52,1186.22,2140.00,0.00
2024-12-10 17:18:58,100,1906,47,53,1174.36,2140.01,0.00
2024-12-10 17:18:58,99,1906,46,53,1184.73,2140.07,0.00
2024-12-10 17:18:58,99,1907,46,53,1177.28,2141.00,0.00
2024-12-10 17:18:58,100,1907,46,54,1165.51,2141.01,0.00
2024-12-10 17:18:58,100,1908,46,54,1155.53,2142.00,0.00
2024-12-10 17:18:58,101,1908,47,54,1144.09,2142.01,0.00
2024-12-10 17:18:58,100,1908,47,53,1139.23,2142.61,0.00
2024-12-10 17:18:58,99,1908,46,53,1147.88,2142.65,0.00
2024-12-10 17:18:58,99,1909,46,53,1157.84,2143.00,0.00
2024-12-10 17:18:58,100,1909,46,54,1146.26,2143.01,0.00
2024-12-10 17:18:58,99,1909,45,54,1138.91,2143.67,0.00
2024-12-10 17:18:58,99,1910,45,54,1153.24,2144.00,0.00
2024-12-10 17:18:58,100,1910,45,55,1141.71,2144.01,0.00
2024-12-10 17:18:58,100,1911,45,55,1137.16,2145.00,0.00
2024-12-10 17:18:58,101,1911,45,56,1125.90,2145.01,0.00
2024-12-10 17:18:58,102,1910,46,56,1112.58,2145.14,0.00
2024-12-10 17:18:58,101,1910,46,55,1128.49,2145.65,0.00
2024-12-10 17:18:58,101,1911,46,55,1141.96,2146.00,0.00
2024-12-10 17:18:58,102,1911,47,55,1130.77,2146.01,0.00
2024-12-10 17:18:58,101,1911,46,55,1140.07,2146.09,0.00
2024-12-10 17:18:58,100,1911,46,54,1138.21,2146.61,0.00
2024-12-10 17:18:59,100,1912,46,54,1172.40,2147.00,0.00
2024-12-10 17:18:59,101,1912,47,54,1160.79,2147.01,0.00
2024-12-10 17:18:59,100,1912,47,53,1171.12,2147.06,0.00
2024-12-10 17:18:59,99,1912,47,52,1182.31,2147.08,0.00
2024-12-10 17:18:59,98,1912,47,51,1194.16,2147.08,0.00
2024-12-10 17:18:59,98,1913,47,51,1194.32,2148.00,0.00
2024-12-10 17:18:59,99,1913,47,52,1182.26,2148.01,0.00
2024-12-10 17:18:59,99,1914,47,52,1180.29,2149.00,0.00
2024-12-10 17:18:59,100,1914,48,52,1168.48,2149.01,0.00
2024-12-10 17:18:59,99,1914,48,51,1178.36,2149.09,0.00
2024-12-10 17:18:59,99,1915,48,51,1177.91,2150.00,0.00
2024-12-10 17:18:59,100,1915,49,51,1166.13,2150.01,0.00
2024-12-10 17:18:59,100,1916,49,51,1163.85,2151.00,0.00
2024-12-10 17:18:59,101,1916,50,51,1152.32,2151.01,0.00
2024-12-10 17:18:59,101,1917,50,51,1149.53,2152.00,0.00
2024-12-10 17:18:59,102,1917,51,51,1138.26,2152.01,0.00
2024-12-10 17:18:59,101,1917,51,50,1147.64,2152.09,0.00
2024-12-10 17:18:59,101,1918,51,50,1145.37,2153.00,0.00
2024-12-10 17:18:59,102,1918,52,50,1134.14,2153.01,0.00
2024-12-10 17:18:59,101,1918,51,50,1144.52,2153.04,0.00
2024-12-10 17:18:59,101,1919,51,50,1139.73,2154.00,0.00
2024-12-10 17:18:59,102,1919,51,51,1128.56,2154.01,0.00
2024-12-10 17:18:59,101,1919,51,50,1139.10,2154.03,0.00
2024-12-10 17:18:59,101,1920,51,50,1131.71,2155.00,0.00
2024-12-10 17:18:59,102,1920,52,50,1120.62,2155.01,0.00
2024-12-10 17:18:59,101,1920,51,50,1130.24,2155.07,0.00
2024-12-10 17:18:59,100,1920,51,49,1131.37,2155.51,0.00
2024-12-10 17:18:59,99,1920,51,48,1138.91,2155.58,0.00
2024-12-10 17:18:59,98,1920,51,47,1148.06,2155.65,0.00
2024-12-10 17:18:59,98,1921,51,47,1159.36,2156.00,0.00
2024-12-10 17:18:59,99,1921,51,48,1147.65,2156.01,0.00
2024-12-10 17:18:59,98,1921,51,47,1158.05,2156.07,0.00
2024-12-10 17:18:59,98,1922,51,47,1155.31,2157.00,0.00
2024-12-10 17:18:59,99,1922,51,48,1143.64,2157.01,0.00
2024-12-10 17:18:59,98,1922,51,47,1154.22,2157.05,0.00
2024-12-10 17:18:59,97,1922,51,46,1165.68,2157.06,0.00
2024-12-10 17:18:59,96,1922,51,45,1177.60,2157.06,0.00
2024-12-10 17:18:59,96,1923,51,45,1173.45,2158.00,0.00
2024-12-10 17:18:59,97,1923,52,45,1161.35,2158.01,0.00
2024-12-10 17:18:59,96,1923,51,45,1172.13,2158.06,0.00
2024-12-10 17:18:59,96,1924,51,45,1166.84,2159.00,0.00
2024-12-10 17:18:59,97,1924,52,45,1154.81,2159.01,0.00
2024-12-10 17:18:59,97,1925,52,45,1147.40,2160.00,0.00
2024-12-10 17:18:59,98,1925,53,45,1135.69,2160.01,0.00
2024-12-10 17:18:59,99,1924,54,45,1120.12,2160.22,0.00
2024-12-10 17:18:59,98,1924,53,45,1134.01,2160.65,0.00
2024-12-10 17:18:59,98,1925,53,45,1145.05,2161.00,0.00
2024-12-10 17:18:59,99,1925,53,46,1133.49,2161.01,0.00
2024-12-10 17:18:59,99,1926,53,46,1147.94,2162.00,0.00
2024-12-10 17:18:59,100,1926,53,47,1136.46,2162.01,0.00
2024-12-10 17:18:59,99,1926,53,46,1134.91,2162.56,0.00
2024-12-10 17:18:59,99,1927,53,46,1142.29,2163.00,0.00
2024-12-10 17:18:59,100,1927,54,46,1130.87,2163.01,0.00
2024-12-10 17:18:59,99,1927,53,46,1140.79,2163.07,0.00
2024-12-10 17:18:59,98,1927,52,46,1137.11,2163.73,0.00
2024-12-10 17:18:59,98,1928,52,46,1151.82,2164.00,0.00
2024-12-10 17:18:59,99,1928,53,46,1140.18,2164.01,0.00
2024-12-10 17:18:59,98,1928,53,45,1148.76,2164.10,0.00
2024-12-10 17:18:59,99,1927,54,45,1120.67,2164.78,0.00
2024-12-10 17:18:59,99,1928,54,45,1142.29,2165.00,0.00
2024-12-10 17:18:59,100,1928,54,46,1130.86,2165.01,0.00
2024-12-10 17:18:59,99,1928,54,45,1140.78,2165.07,0.00
2024-12-10 17:18:59,98,1928,53,45,1136.88,2165.71,0.00
2024-12-10 17:18:59,98,1929,53,45,1174.06,2166.00,0.00
2024-12-10 17:18:59,99,1929,53,46,1162.21,2166.01,0.00
2024-12-10 17:18:59,99,1930,53,46,1161.39,2167.00,0.00
2024-12-10 17:18:59,100,1930,53,47,1149.78,2167.01,0.00
2024-12-10 17:18:59,99,1930,52,47,1159.67,2167.08,0.00
2024-12-10 17:18:59,99,1931,52,47,1160.02,2168.00,0.00
2024-12-10 17:18:59,100,1931,52,48,1148.42,2168.01,0.00
2024-12-10 17:18:59,99,1931,52,47,1159.37,2168.03,0.00
2024-12-10 17:18:59,98,1931,51,47,1170.12,2168.07,0.00
2024-12-10 17:18:59,98,1932,51,47,1169.97,2169.00,0.00
2024-12-10 17:18:59,99,1932,51,48,1158.15,2169.01,0.00
2024-12-10 17:18:59,98,1932,51,47,1168.45,2169.07,0.00
2024-12-10 17:18:59,98,1933,51,47,1166.21,2170.00,0.00
2024-12-10 17:18:59,99,1933,51,48,1154.43,2170.01,0.00
2024-12-10 17:18:59,98,1933,50,48,1164.68,2170.07,0.00
2024-12-10 17:18:59,98,1934,50,48,1159.75,2171.00,0.00
2024-12-10 17:18:59,99,1934,51,48,1148.03,2171.01,0.00
2024-12-10 17:18:59,98,1934,50,48,1156.60,2171.15,0.00
2024-12-10 17:18:59,98,1935,50,48,1151.45,2172.00,0.00
2024-12-10 17:18:59,99,1935,50,49,1139.82,2172.01,0.00
2024-12-10 17:18:59,98,1935,50,48,1149.93,2172.07,0.00
2024-12-10 17:18:59,97,1935,49,48,1149.35,2172.46,0.00
2024-12-10 17:18:59,97,1936,49,48,1150.67,2173.00,0.00
2024-12-10 17:18:59,98,1936,50,48,1138.93,2173.01,0.00
2024-12-10 17:18:59,99,1935,50,49,1095.68,2173.78,0.00
2024-12-10 17:18:59,99,1936,50,49,1117.38,2174.00,0.00
2024-12-10 17:18:59,100,1936,50,50,1106.21,2174.01,0.00
2024-12-10 17:18:59,99,1936,49,50,1115.87,2174.07,0.00
2024-12-10 17:18:59,98,1936,48,50,1108.74,2174.52,0.00
2024-12-10 17:18:59,98,1937,48,50,1136.52,2175.00,0.00
2024-12-10 17:18:59,99,1937,48,51,1125.04,2175.01,0.00
2024-12-10 17:18:59,98,1937,47,51,1130.72,2175.26,0.00
2024-12-10 17:18:59,97,1937,46,51,1139.23,2175.39,0.00
2024-12-10 17:19:00,96,1937,45,51,1146.73,2175.53,0.00
2024-12-10 17:19:00,96,1938,45,51,1155.16,2176.00,0.00
2024-12-10 17:19:00,97,1938,45,52,1143.25,2176.01,0.00
2024-12-10 17:19:00,96,1938,45,51,1153.60,2176.07,0.00
2024-12-10 17:19:00,95,1938,44,51,1157.23,2176.46,0.00
2024-12-10 17:19:00,95,1939,44,51,1163.73,2177.00,0.00
2024-12-10 17:19:00,96,1939,44,52,1151.61,2177.01,0.00
2024-12-10 17:19:00,95,1939,44,51,1162.15,2177.07,0.00
2024-12-10 17:19:00,95,1940,44,51,1159.54,2178.00,0.00
2024-12-10 17:19:00,96,1940,45,51,1147.46,2178.01,0.00
2024-12-10 17:19:00,95,1940,44,51,1159.09,2178.02,0.00
2024-12-10 17:19:00,94,1940,44,50,1170.28,2178.06,0.00
2024-12-10 17:19:00,93,1940,43,50,1165.90,2178.65,0.00
2024-12-10 17:19:00,93,1941,43,50,1179.68,2179.00,0.00
2024-12-10 17:19:00,94,1941,44,50,1167.13,2179.01,0.00
2024-12-10 17:19:00,93,1941,43,50,1178.07,2179.08,0.00
2024-12-10 17:19:00,93,1942,43,50,1177.44,2180.00,0.00
2024-12-10 17:19:00,94,1942,43,51,1164.92,2180.01,0.00
2024-12-10 17:19:00,94,1943,43,51,1162.30,2181.00,0.00
2024-12-10 17:19:00,95,1943,44,51,1150.07,2181.01,0.00
2024-12-10 17:19:00,94,1943,43,51,1160.71,2181.07,0.00
2024-12-10 17:19:00,95,1942,44,51,1143.71,2181.32,0.00
2024-12-10 17:19:00,94,1942,44,50,1166.24,2181.57,0.00
2024-12-10 17:19:00,94,1943,44,50,1176.95,2182.00,0.00
2024-12-10 17:19:00,95,1943,45,50,1164.56,2182.01,0.00
2024-12-10 17:19:00,95,1944,45,50,1185.37,2183.00,0.00
2024-12-10 17:19:00,96,1944,45,51,1173.02,2183.01,0.00
2024-12-10 17:19:00,95,1944,44,51,1183.79,2183.07,0.00
2024-12-10 17:19:00,96,1943,45,51,1163.16,2183.48,0.00
2024-12-10 17:19:00,96,1944,45,51,1181.37,2184.00,0.00
2024-12-10 17:19:00,97,1944,45,52,1169.19,2184.01,0.00
2024-12-10 17:19:00,96,1944,45,51,1179.80,2184.07,0.00
2024-12-10 17:19:00,95,1944,44,51,1180.31,2184.60,0.00
2024-12-10 17:19:00,96,1943,45,51,1167.79,2184.63,0.00
2024-12-10 17:19:00,96,1944,45,51,1220.00,2185.00,0.00
2024-12-10 17:19:00,97,1944,45,52,1207.42,2185.01,0.00
2024-12-10 17:19:00,96,1944,44,52,1218.43,2185.07,0.00
2024-12-10 17:19:00,96,1945,44,52,1239.70,2186.00,0.00
2024-12-10 17:19:00,97,1945,45,52,1226.92,2186.01,0.00
2024-12-10 17:19:00,97,1946,45,52,1223.70,2187.00,0.00
2024-12-10 17:19:00,98,1946,46,52,1211.21,2187.01,0.00
2024-12-10 17:19:00,97,1946,46,51,1222.15,2187.07,0.00
2024-12-10 17:19:00,97,1947,46,51,1220.07,2188.00,0.00
2024-12-10 17:19:00,98,1947,46,52,1207.62,2188.01,0.00
2024-12-10 17:19:00,99,1946,46,53,1183.47,2188.59,0.00
2024-12-10 17:19:00,99,1947,46,53,1200.28,2189.00,0.00
2024-12-10 17:19:00,100,1947,46,54,1188.28,2189.01,0.00
2024-12-10 17:19:00,100,1948,46,54,1204.45,2190.00,0.00
2024-12-10 17:19:00,101,1948,47,54,1192.53,2190.01,0.00
2024-12-10 17:19:00,100,1948,47,53,1202.72,2190.08,0.00
2024-12-10 17:19:00,100,1949,47,53,1198.12,2191.00,0.00
2024-12-10 17:19:00,101,1949,48,53,1186.26,2191.01,0.00
2024-12-10 17:19:00,100,1949,48,52,1196.40,2191.08,0.00
2024-12-10 17:19:00,100,1950,48,52,1191.53,2192.00,0.00
2024-12-10 17:19:00,101,1950,49,52,1179.73,2192.01,0.00
2024-12-10 17:19:00,100,1950,49,51,1189.80,2192.08,0.00
2024-12-10 17:19:00,100,1951,49,51,1184.96,2193.00,0.00
2024-12-10 17:19:00,101,1951,50,51,1173.23,2193.01,0.00
2024-12-10 17:19:00,102,1950,50,52,1141.49,2193.81,0.00
2024-12-10 17:19:00,102,1951,50,52,1158.52,2194.00,0.00
2024-12-10 17:19:00,103,1951,50,53,1147.27,2194.01,0.00
2024-12-10 17:19:00,102,1951,49,53,1156.82,2194.08,0.00
2024-12-10 17:19:00,101,1951,48,53,1146.96,2194.89,0.00
2024-12-10 17:19:00,101,1952,48,53,1186.49,2195.00,0.00
2024-12-10 17:19:00,102,1952,49,53,1174.86,2195.01,0.00
2024-12-10 17:19:00,101,1952,48,53,1182.66,2195.08,0.00
2024-12-10 17:19:00,100,1952,48,52,1192.94,2195.12,0.00
2024-12-10 17:19:00,100,1953,48,52,1190.37,2196.00,0.00
2024-12-10 17:19:00,101,1953,48,53,1178.58,2196.01,0.00
2024-12-10 17:19:00,100,1953,48,52,1183.70,2196.08,0.00
2024-12-10 17:19:00,100,1954,48,52,1178.07,2197.00,0.00
2024-12-10 17:19:00,101,1954,48,53,1166.41,2197.01,0.00
2024-12-10 17:19:00,100,1954,48,52,1173.94,2197.03,0.00
2024-12-10 17:19:00,99,1954,47,52,1184.70,2197.07,0.00
2024-12-10 17:19:00,99,1955,47,52,1177.40,2198.00,0.00
2024-12-10 17:19:00,100,1955,48,52,1165.62,2198.01,0.00
2024-12-10 17:19:00,100,1956,48,52,1155.87,2199.00,0.00
2024-12-10 17:19:00,101,1956,48,53,1144.42,2199.01,0.00
2024-12-10 17:19:00,100,1956,48,52,1148.09,2199.31,0.00
2024-12-10 17:19:00,99,1956,47,52,1152.81,2199.47,0.00
2024-12-10 17:19:00,98,1956,46,52,1161.61,2199.60,0.00
2024-12-10 17:19:00,98,1957,46,52,1172.18,2200.00,0.00
2024-12-10 17:19:00,99,1957,47,52,1160.34,2200.01,0.00
2024-12-10 17:19:00,98,1957,46,52,1163.32,2200.35,0.00
2024-12-10 17:19:00,98,1958,46,52,1168.32,2201.00,0.00
2024-12-10 17:19:00,99,1958,47,52,1156.52,2201.01,0.00
2024-12-10 17:19:00,98,1958,47,51,1166.54,2201.08,0.00
2024-12-10 17:19:00,97,1958,47,50,1157.73,2201.87,0.00
2024-12-10 17:19:01,97,1959,47,50,1177.60,2202.00,0.00
2024-12-10 17:19:01,98,1959,48,50,1165.58,2202.01,0.00
2024-12-10 17:19:01,97,1959,47,50,1175.80,2202.08,0.00
2024-12-10 17:19:01,97,1960,47,50,1175.02,2203.00,0.00
2024-12-10 17:19:01,98,1960,47,51,1163.03,2203.01,0.00
2024-12-10 17:19:01,98,1961,47,51,1159.74,2204.00,0.00
2024-12-10 17:19:01,99,1961,48,51,1148.02,2204.01,0.00
2024-12-10 17:19:01,98,1961,48,50,1157.95,2204.08,0.00
2024-12-10 17:19:01,97,1961,48,49,1155.89,2204.62,0.00
2024-12-10 17:19:01,98,1960,49,49,1144.10,2204.63,0.00
2024-12-10 17:19:01,98,1961,49,49,1164.89,2205.00,0.00
2024-12-10 17:19:01,99,1961,49,50,1153.12,2205.01,0.00
2024-12-10 17:19:01,98,1961,48,50,1163.10,2205.08,0.00
2024-12-10 17:19:01,98,1962,48,50,1185.27,2206.00,0.00
2024-12-10 17:19:01,99,1962,48,51,1173.30,2206.01,0.00
2024-12-10 17:19:01,98,1962,47,51,1183.48,2206.08,0.00
2024-12-10 17:19:01,98,1963,47,51,1182.45,2207.00,0.00
2024-12-10 17:19:01,99,1963,48,51,1170.51,2207.01,0.00
2024-12-10 17:19:01,98,1963,48,50,1181.78,2207.03,0.00
2024-12-10 17:19:01,97,1963,48,49,1192.22,2207.08,0.00
2024-12-10 17:19:01,97,1964,48,49,1190.97,2208.00,0.00
2024-12-10 17:19:01,98,1964,48,50,1178.81,2208.01,0.00
2024-12-10 17:19:01,97,1964,47,50,1183.31,2208.34,0.00
2024-12-10 17:19:01,97,1965,47,50,1188.92,2209.00,0.00
2024-12-10 17:19:01,98,1965,47,51,1176.79,2209.01,0.00
2024-12-10 17:19:01,98,1966,47,51,1174.21,2210.00,0.00
2024-12-10 17:19:01,99,1966,48,51,1162.35,2210.01,0.00
2024-12-10 17:19:01,98,1966,48,50,1159.67,2210.60,0.00
2024-12-10 17:19:01,98,1967,48,50,1171.16,2211.00,0.00
2024-12-10 17:19:01,99,1967,48,51,1159.33,2211.01,0.00
2024-12-10 17:19:01,98,1967,48,50,1170.49,2211.03,0.00
2024-12-10 17:19:01,97,1967,47,50,1181.20,2211.08,0.00
2024-12-10 17:19:01,97,1968,47,50,1180.47,2212.00,0.00
2024-12-10 17:19:01,98,1968,48,50,1168.43,2212.01,0.00
2024-12-10 17:19:01,98,1969,48,50,1164.48,2213.00,0.00
2024-12-10 17:19:01,99,1969,49,50,1152.72,2213.01,0.00
2024-12-10 17:19:01,98,1969,48,50,1162.69,2213.08,0.00
2024-12-10 17:19:01,98,1970,48,50,1159.21,2214.00,0.00
2024-12-10 17:19:01,99,1970,48,51,1147.50,2214.01,0.00
2024-12-10 17:19:01,98,1970,48,50,1158.99,2214.01,0.00
2024-12-10 17:19:01,97,1970,47,50,1150.21,2214.67,0.00
2024-12-10 17:19:01,97,1971,47,50,1165.23,2215.00,0.00
2024-12-10 17:19:01,98,1971,48,50,1153.34,2215.01,0.00
2024-12-10 17:19:01,97,1971,48,49,1163.64,2215.07,0.00
2024-12-10 17:19:01,97,1972,48,49,1160.92,2216.00,0.00
2024-12-10 17:19:01,98,1972,49,49,1149.08,2216.01,0.00
2024-12-10 17:19:01,97,1972,49,48,1160.70,2216.01,0.00
2024-12-10 17:19:01,96,1972,48,48,1169.96,2216.06,0.00
2024-12-10 17:19:01,96,1973,48,48,1167.07,2217.00,0.00
2024-12-10 17:19:01,97,1973,48,49,1155.04,2217.01,0.00
2024-12-10 17:19:01,97,1974,48,49,1149.43,2218.00,0.00
2024-12-10 17:19:01,98,1974,48,50,1137.70,2218.01,0.00
2024-12-10 17:19:01,97,1974,47,50,1148.07,2218.06,0.00
2024-12-10 17:19:01,98,1973,47,51,1123.32,2218.59,0.00
2024-12-10 17:19:01,98,1974,47,51,1151.91,2219.00,0.00
2024-12-10 17:19:01,99,1974,48,51,1140.27,2219.01,0.00
2024-12-10 17:19:01,98,1974,48,50,1150.56,2219.06,0.00
2024-12-10 17:19:01,99,1973,49,50,1111.18,2219.76,0.00
2024-12-10 17:19:01,99,1974,49,50,1152.63,2220.00,0.00
2024-12-10 17:19:01,100,1974,50,50,1141.10,2220.01,0.00
2024-12-10 17:19:01,99,1974,50,49,1151.82,2220.04,0.00
2024-12-10 17:19:01,98,1974,50,48,1163.13,2220.05,0.00
2024-12-10 17:19:01,97,1974,49,48,1165.87,2220.27,0.00
2024-12-10 17:19:01,96,1974,48,48,1171.22,2220.53,0.00
2024-12-10 17:19:01,96,1975,48,48,1193.94,2221.00,0.00
2024-12-10 17:19:01,97,1975,48,49,1181.63,2221.01,0.00
2024-12-10 17:19:01,96,1975,48,48,1172.19,2221.59,0.00
2024-12-10 17:19:01,96,1976,48,48,1179.30,2222.00,0.00
2024-12-10 17:19:01,97,1976,49,48,1167.14,2222.01,0.00
2024-12-10 17:19:01,96,1976,49,47,1178.84,2222.02,0.00
2024-12-10 17:19:01,95,1976,48,47,1190.55,2222.04,0.00
2024-12-10 17:19:01,96,1975,49,47,1164.82,2222.45,0.00
2024-12-10 17:19:01,96,1976,49,47,1166.67,2223.00,0.00
2024-12-10 17:19:01,97,1976,49,48,1154.64,2223.01,0.00
2024-12-10 17:19:01,96,1976,48,48,1165.75,2223.04,0.00
2024-12-10 17:19:01,95,1976,47,48,1166.70,2223.35,0.00
2024-12-10 17:19:01,95,1977,47,48,1184.03,2224.00,0.00
2024-12-10 17:19:01,96,1977,47,49,1171.69,2224.01,0.00
2024-12-10 17:19:01,95,1977,47,48,1171.41,2224.50,0.00
2024-12-10 17:19:01,94,1977,46,48,1177.83,2224.56,0.00
2024-12-10 17:19:01,93,1977,46,47,1176.26,2224.93,0.00
2024-12-10 17:19:01,93,1978,46,47,1198.57,2225.00,0.00
2024-12-10 17:19:01,94,1978,46,48,1185.82,2225.01,0.00
2024-12-10 17:19:01,93,1978,45,48,1197.62,2225.04,0.00
2024-12-10 17:19:01,92,1978,44,48,1197.41,2225.51,0.00
2024-12-10 17:19:01,92,1979,44,48,1208.24,2226.00,0.00
2024-12-10 17:19:01,93,1979,45,48,1195.25,2226.01,0.00
2024-12-10 17:19:01,92,1979,45,47,1207.28,2226.04,0.00
2024-12-10 17:19:01,92,1980,45,47,1205.64,2227.00,0.00
2024-12-10 17:19:01,93,1980,45,48,1192.68,2227.01,0.00
2024-12-10 17:19:01,92,1980,45,47,1204.69,2227.04,0.00
2024-12-10 17:19:01,92,1981,45,47,1197.56,2228.00,0.00
2024-12-10 17:19:01,93,1981,46,47,1184.69,2228.01,0.00
2024-12-10 17:19:01,92,1981,45,47,1183.48,2228.33,0.00
2024-12-10 17:19:01,91,1981,45,46,1188.23,2228.36,0.00
2024-12-10 17:19:01,91,1982,45,46,1194.08,2229.00,0.00
2024-12-10 17:19:01,92,1982,45,47,1181.10,2229.01,0.00
2024-12-10 17:19:01,91,1982,45,46,1193.59,2229.02,0.00
2024-12-10 17:19:01,90,1982,45,45,1206.36,2229.03,0.00
2024-12-10 17:19:01,89,1982,45,44,1211.47,2229.35,0.00
2024-12-10 17:19:01,89,1983,45,44,1218.25,2230.00,0.00
2024-12-10 17:19:01,90,1983,45,45,1204.71,2230.01,0.00
2024-12-10 17:19:01,89,1983,44,45,1217.51,2230.03,0.00
2024-12-10 17:19:01,88,1983,44,44,1229.99,2230.09,0.00
2024-12-10 17:19:01,87,1983,43,44,1229.53,2230.58,0.00
2024-12-10 17:19:02,87,1984,43,44,1246.03,2231.00,0.00
2024-12-10 17:19:02,88,1984,44,44,1231.87,2231.01,0.00
2024-12-10 17:19:02,87,1984,43,44,1245.27,2231.03,0.00
2024-12-10 17:19:02,87,1985,43,44,1246.61,2232.00,0.00
2024-12-10 17:19:02,88,1985,43,45,1232.44,2232.01,0.00
2024-12-10 17:19:02,88,1986,43,45,1233.27,2233.00,0.00
2024-12-10 17:19:02,89,1986,44,45,1219.41,2233.01,0.00
2024-12-10 17:19:02,89,1987,44,45,1220.37,2234.00,0.00
2024-12-10 17:19:02,90,1987,44,46,1206.81,2234.01,0.00
2024-12-10 17:19:02,89,1987,44,45,1206.78,2234.46,0.00
2024-12-10 17:19:02,89,1988,44,45,1218.98,2235.00,0.00
2024-12-10 17:19:02,90,1988,45,45,1205.43,2235.01,0.00
2024-12-10 17:19:02,89,1988,44,45,1217.66,2235.05,0.00
2024-12-10 17:19:02,89,1989,44,45,1209.72,2236.00,0.00
2024-12-10 17:19:02,90,1989,45,45,1196.28,2236.01,0.00
2024-12-10 17:19:02,89,1989,45,44,1208.42,2236.05,0.00
2024-12-10 17:19:02,88,1989,45,43,1211.75,2236.35,0.00
2024-12-10 17:19:02,88,1990,45,43,1213.47,2237.00,0.00
2024-12-10 17:19:02,89,1990,45,44,1199.83,2237.01,0.00
2024-12-10 17:19:02,88,1990,44,44,1205.19,2237.19,0.00
2024-12-10 17:19:02,87,1990,44,43,1213.19,2237.35,0.00
2024-12-10 17:19:02,87,1991,44,43,1222.17,2238.00,0.00
2024-12-10 17:19:02,88,1991,44,44,1208.29,2238.01,0.00
2024-12-10 17:19:02,87,1991,44,43,1221.11,2238.05,0.00
2024-12-10 17:19:02,87,1992,44,43,1223.24,2239.00,0.00
2024-12-10 17:19:02,88,1992,44,44,1209.34,2239.01,0.00
2024-12-10 17:19:02,88,1993,44,44,1209.68,2240.00,0.00
2024-12-10 17:19:02,89,1993,45,44,1196.09,2240.01,0.00
2024-12-10 17:19:02,88,1993,44,44,1207.11,2240.11,0.00
2024-12-10 17:19:02,89,1992,45,44,1191.40,2240.21,0.00
2024-12-10 17:19:02,90,1991,45,45,1196.37,2240.30,0.00
2024-12-10 17:19:02,90,1992,45,45,1218.86,2241.00,0.00
2024-12-10 17:19:02,91,1992,46,45,1205.47,2241.01,0.00
2024-12-10 17:19:02,90,1992,46,44,1217.88,2241.04,0.00
2024-12-10 17:19:02,90,1993,46,44,1266.69,2242.00,0.00
2024-12-10 17:19:02,91,1993,46,45,1252.77,2242.01,0.00
2024-12-10 17:19:02,90,1993,45,45,1265.70,2242.04,0.00
2024-12-10 17:19:02,89,1993,45,44,1277.70,2242.14,0.00
2024-12-10 17:19:02,88,1993,44,44,1287.35,2242.31,0.00
2024-12-10 17:19:02,89,1992,44,45,1267.17,2242.54,0.00
2024-12-10 17:19:02,89,1993,44,45,1289.68,2243.00,0.00
2024-12-10 17:19:02,90,1993,44,46,1275.35,2243.01,0.00
2024-12-10 17:19:02,90,1994,44,46,1299.12,2244.00,0.00
2024-12-10 17:19:02,91,1994,45,46,1284.85,2244.01,0.00
2024-12-10 17:19:02,90,1994,45,45,1298.07,2244.04,0.00
2024-12-10 17:19:02,89,1994,45,44,1298.62,2244.53,0.00
2024-12-10 17:19:02,89,1995,45,44,1313.06,2245.00,0.00
2024-12-10 17:19:02,90,1995,46,44,1298.47,2245.01,0.00
2024-12-10 17:19:02,89,1995,46,43,1311.75,2245.05,0.00
2024-12-10 17:19:02,88,1995,46,42,1318.75,2245.39,0.00
2024-12-10 17:19:02,88,1996,46,42,1330.48,2246.00,0.00
2024-12-10 17:19:02,89,1996,46,43,1315.53,2246.01,0.00
2024-12-10 17:19:02,88,1996,45,43,1328.93,2246.05,0.00
2024-12-10 17:19:02,88,1997,45,43,1333.07,2247.00,0.00
2024-12-10 17:19:02,89,1997,45,44,1318.10,2247.01,0.00
2024-12-10 17:19:02,89,1998,45,44,1320.53,2248.00,0.00
2024-12-10 17:19:02,90,1998,45,45,1305.86,2248.01,0.00
2024-12-10 17:19:02,89,1998,45,44,1318.82,2248.05,0.00
2024-12-10 17:19:02,90,1997,45,45,1297.76,2248.36,0.00
2024-12-10 17:19:02,90,1998,45,45,1321.52,2249.00,0.00
2024-12-10 17:19:02,91,1998,46,45,1307.00,2249.01,0.00
2024-12-10 17:19:02,91,1999,46,45,1333.25,2250.00,0.00
2024-12-10 17:19:02,92,1999,47,45,1318.76,2250.01,0.00
2024-12-10 17:19:02,92,2000,47,45,1319.24,2251.00,0.00
2024-12-10 17:19:02,93,2000,47,46,1305.05,2251.01,0.00
2024-12-10 17:19:02,92,2000,46,46,1316.96,2251.04,0.00
2024-12-10 17:19:02,92,2001,46,46,1318.20,2252.00,0.00
2024-12-10 17:19:02,93,2001,47,46,1304.02,2252.01,0.00
2024-12-10 17:19:02,92,2001,46,46,1316.20,2252.03,0.00
2024-12-10 17:19:02,92,2002,46,46,1316.09,2253.00,0.00
2024-12-10 17:19:02,93,2002,46,47,1301.94,2253.01,0.00
2024-12-10 17:19:02,92,2002,45,47,1314.01,2253.08,0.00
2024-12-10 17:19:02,92,2003,45,47,1315.34,2254.00,0.00
2024-12-10 17:19:02,93,2003,46,47,1301.20,2254.01,0.00
2024-12-10 17:19:02,92,2003,46,46,1314.61,2254.03,0.00
2024-12-10 17:19:02,92,2004,46,46,1314.37,2255.00,0.00
2024-12-10 17:19:02,93,2004,46,47,1300.24,2255.01,0.00
2024-12-10 17:19:02,92,2004,45,47,1313.64,2255.03,0.00
2024-12-10 17:19:02,92,2005,45,47,1312.25,2256.00,0.00
2024-12-10 17:19:02,93,2005,46,47,1298.14,2256.01,0.00
2024-12-10 17:19:02,94,2004,47,47,1283.85,2256.05,0.00
2024-12-10 17:19:02,94,2005,47,47,1305.01,2257.00,0.00
2024-12-10 17:19:02,95,2005,48,47,1291.27,2257.01,0.00
2024-12-10 17:19:02,96,2004,48,48,1277.13,2257.06,0.00
2024-12-10 17:19:02,96,2005,48,48,1319.54,2258.00,0.00
2024-12-10 17:19:02,97,2005,48,49,1305.94,2258.01,0.00
2024-12-10 17:19:02,97,2006,48,49,1322.76,2259.00,0.00
2024-12-10 17:19:02,98,2006,49,49,1309.26,2259.01,0.00
2024-12-10 17:19:02,97,2006,49,48,1313.01,2259.40,0.00
2024-12-10 17:19:02,96,2006,48,48,1325.05,2259.44,0.00
2024-12-10 17:19:02,95,2006,48,47,1332.65,2259.58,0.00
2024-12-10 17:19:02,95,2007,48,47,1345.76,2260.00,0.00
2024-12-10 17:19:02,96,2007,48,48,1331.74,2260.01,0.00
2024-12-10 17:19:02,95,2007,47,48,1345.52,2260.01,0.00
2024-12-10 17:19:02,95,2008,47,48,1344.16,2261.00,0.00
2024-12-10 17:19:02,96,2008,48,48,1330.16,2261.01,0.00
2024-12-10 17:19:02,95,2008,48,47,1343.00,2261.05,0.00
2024-12-10 17:19:03,95,2009,48,47,1342.72,2262.00,0.00
2024-12-10 17:19:03,96,2009,48,48,1328.73,2262.01,0.00
2024-12-10 17:19:03,95,2009,48,47,1341.56,2262.05,0.00
2024-12-10 17:19:03,95,2010,48,47,1341.00,2263.00,0.00
2024-12-10 17:19:03,96,2010,49,47,1327.04,2263.01,0.00
2024-12-10 17:19:03,96,2011,49,47,1324.84,2264.00,0.00
2024-12-10 17:19:03,97,2011,49,48,1311.18,2264.01,0.00
2024-12-10 17:19:03,96,2011,49,47,1310.84,2264.53,0.00
2024-12-10 17:19:03,96,2012,49,47,1323.36,2265.00,0.00
2024-12-10 17:19:03,97,2012,49,48,1309.71,2265.01,0.00
2024-12-10 17:19:03,96,2012,49,47,1322.20,2265.05,0.00
2024-12-10 17:19:03,96,2013,49,47,1321.36,2266.00,0.00
2024-12-10 17:19:03,97,2013,49,48,1307.74,2266.01,0.00
2024-12-10 17:19:03,96,2013,49,47,1320.21,2266.05,0.00
2024-12-10 17:19:03,96,2014,49,47,1315.39,2267.00,0.00
2024-12-10 17:19:03,97,2014,49,48,1301.83,2267.01,0.00
2024-12-10 17:19:03,96,2014,49,47,1314.24,2267.05,0.00
2024-12-10 17:19:03,95,2014,48,47,1314.76,2267.28,0.00
2024-12-10 17:19:03,95,2015,48,47,1320.93,2268.00,0.00
2024-12-10 17:19:03,96,2015,49,47,1307.17,2268.01,0.00
2024-12-10 17:19:03,95,2015,49,46,1307.15,2268.22,0.00
2024-12-10 17:19:03,95,2016,49,46,1311.47,2269.00,0.00
2024-12-10 17:19:03,96,2016,50,46,1297.81,2269.01,0.00
2024-12-10 17:19:03,95,2016,49,46,1303.78,2269.18,0.00
2024-12-10 17:19:03,95,2017,49,46,1306.77,2270.00,0.00
2024-12-10 17:19:03,96,2017,49,47,1293.16,2270.01,0.00
2024-12-10 17:19:03,95,2017,48,47,1302.25,2270.15,0.00
2024-12-10 17:19:03,95,2018,48,47,1301.08,2271.00,0.00
2024-12-10 17:19:03,96,2018,49,47,1287.53,2271.01,0.00
2024-12-10 17:19:03,95,2018,48,47,1286.75,2271.30,0.00
2024-12-10 17:19:03,95,2019,48,47,1293.14,2272.00,0.00
2024-12-10 17:19:03,96,2019,49,47,1279.67,2272.01,0.00
2024-12-10 17:19:03,95,2019,48,47,1281.38,2272.18,0.00
2024-12-10 17:19:03,94,2019,48,46,1288.59,2272.45,0.00
2024-12-10 17:19:03,94,2020,48,46,1300.61,2273.00,0.00
2024-12-10 17:19:03,95,2020,48,47,1286.92,2273.01,0.00
2024-12-10 17:19:03,94,2020,47,47,1298.96,2273.07,0.00
2024-12-10 17:19:03,93,2020,47,46,1312.70,2273.08,0.00
2024-12-10 17:19:03,94,2019,47,47,1296.33,2273.20,0.00
2024-12-10 17:19:03,94,2020,47,47,1318.58,2274.00,0.00
2024-12-10 17:19:03,95,2020,48,47,1304.70,2274.01,0.00
2024-12-10 17:19:03,95,2021,48,47,1325.01,2275.00,0.00
2024-12-10 17:19:03,96,2021,48,48,1311.21,2275.01,0.00
2024-12-10 17:19:03,95,2021,48,47,1323.37,2275.07,0.00
2024-12-10 17:19:03,94,2021,47,47,1327.30,2275.36,0.00
2024-12-10 17:19:03,94,2022,47,47,1337.18,2276.00,0.00
2024-12-10 17:19:03,95,2022,47,48,1323.10,2276.01,0.00
2024-12-10 17:19:03,95,2023,47,48,1324.91,2277.00,0.00
2024-12-10 17:19:03,96,2023,47,49,1311.11,2277.01,0.00
2024-12-10 17:19:03,96,2024,47,49,1309.33,2278.00,0.00
2024-12-10 17:19:03,97,2024,48,49,1295.83,2278.01,0.00
2024-12-10 17:19:03,96,2024,47,49,1307.70,2278.07,0.00
2024-12-10 17:19:03,96,2025,47,49,1302.22,2279.00,0.00
2024-12-10 17:19:03,97,2025,48,49,1288.79,2279.01,0.00
2024-12-10 17:19:03,98,2024,49,49,1274.96,2279.06,0.00
2024-12-10 17:19:03,97,2024,49,48,1287.25,2279.42,0.00
2024-12-10 17:19:03,97,2025,49,48,1296.53,2280.00,0.00
2024-12-10 17:19:03,98,2025,50,48,1283.30,2280.01,0.00
2024-12-10 17:19:03,99,2024,50,49,1269.44,2280.07,0.00
2024-12-10 17:19:03,99,2025,50,49,1297.87,2281.00,0.00
2024-12-10 17:19:03,100,2025,51,49,1284.90,2281.01,0.00
2024-12-10 17:19:03,99,2025,50,49,1297.64,2281.01,0.00
2024-12-10 17:19:03,98,2025,49,49,1305.97,2281.06,0.00
2024-12-10 17:19:03,97,2025,48,49,1314.94,2281.17,0.00
2024-12-10 17:19:03,96,2025,48,48,1315.03,2281.43,0.00
2024-12-10 17:19:03,96,2026,48,48,1348.77,2282.00,0.00
2024-12-10 17:19:03,97,2026,49,48,1334.87,2282.01,0.00
2024-12-10 17:19:03,97,2027,49,48,1326.25,2283.00,0.00
2024-12-10 17:19:03,98,2027,50,48,1312.71,2283.01,0.00
2024-12-10 17:19:03,97,2027,50,47,1323.00,2283.05,0.00
2024-12-10 17:19:03,96,2027,50,46,1336.55,2283.05,0.00
2024-12-10 17:19:03,96,2028,50,46,1329.44,2284.00,0.00
2024-12-10 17:19:03,97,2028,51,46,1315.74,2284.01,0.00
2024-12-10 17:19:03,96,2028,51,45,1328.29,2284.05,0.00
2024-12-10 17:19:03,95,2028,51,44,1340.57,2284.12,0.00
2024-12-10 17:19:03,94,2028,51,43,1342.87,2284.43,0.00
2024-12-10 17:19:03,94,2029,51,43,1351.49,2285.00,0.00
2024-12-10 17:19:03,95,2029,52,43,1337.27,2285.01,0.00
2024-12-10 17:19:03,95,2030,52,43,1335.59,2286.00,0.00
2024-12-10 17:19:03,96,2030,52,44,1321.68,2286.01,0.00
2024-12-10 17:19:03,97,2029,53,44,1307.83,2286.04,0.00
2024-12-10 17:19:03,98,2028,54,44,1291.61,2286.48,0.00
2024-12-10 17:19:03,98,2029,54,44,1309.78,2287.00,0.00
2024-12-10 17:19:03,99,2029,54,45,1296.55,2287.01,0.00
2024-12-10 17:19:03,100,2028,55,45,1277.28,2287.31,0.00
2024-12-10 17:19:03,101,2027,56,45,1261.57,2287.92,0.00
2024-12-10 17:19:03,101,2028,56,45,1329.14,2288.00,0.00
2024-12-10 17:19:03,102,2028,56,46,1316.11,2288.01,0.00
2024-12-10 17:19:03,102,2029,56,46,1354.51,2289.00,0.00
2024-12-10 17:19:03,103,2029,56,47,1341.36,2289.01,0.00
2024-12-10 17:19:03,102,2029,56,46,1353.42,2289.05,0.00
2024-12-10 17:19:03,101,2029,56,45,1348.95,2289.65,0.00
2024-12-10 17:19:03,101,2030,56,45,1363.99,2290.00,0.00
2024-12-10 17:19:03,102,2030,57,45,1350.61,2290.01,0.00
2024-12-10 17:19:03,101,2030,56,45,1362.89,2290.05,0.00
2024-12-10 17:19:03,101,2031,56,45,1361.57,2291.00,0.00
2024-12-10 17:19:03,102,2031,57,45,1348.22,2291.01,0.00
2024-12-10 17:19:03,101,2031,57,44,1348.67,2291.50,0.00
2024-12-10 17:19:04,101,2032,57,44,1358.39,2292.00,0.00
2024-12-10 17:19:04,102,2032,58,44,1345.07,2292.01,0.00
2024-12-10 17:19:04,101,2032,57,44,1357.28,2292.05,0.00
2024-12-10 17:19:04,101,2033,57,44,1353.36,2293.00,0.00
2024-12-10 17:19:04,102,2033,58,44,1340.09,2293.01,0.00
2024-12-10 17:19:04,101,2033,58,43,1352.26,2293.05,0.00
2024-12-10 17:19:04,101,2034,58,43,1342.51,2294.00,0.00
2024-12-10 17:19:04,102,2034,58,44,1329.35,2294.01,0.00
2024-12-10 17:19:04,101,2034,57,44,1333.58,2294.24,0.00
2024-12-10 17:19:04,100,2034,57,43,1328.49,2294.66,0.00
2024-12-10 17:19:04,100,2035,57,43,1343.92,2295.00,0.00
2024-12-10 17:19:04,101,2035,58,43,1330.62,2295.01,0.00
2024-12-10 17:19:04,102,2034,58,44,1308.50,2295.43,0.00
2024-12-10 17:19:04,102,2035,58,44,1330.39,2296.00,0.00
2024-12-10 17:19:04,103,2035,58,45,1317.47,2296.01,0.00
2024-12-10 17:19:04,102,2035,57,45,1305.68,2296.56,0.00
2024-12-10 17:19:04,102,2036,57,45,1340.63,2297.00,0.00
2024-12-10 17:19:04,103,2036,57,46,1327.61,2297.01,0.00
2024-12-10 17:19:04,102,2036,57,45,1339.53,2297.05,0.00
2024-12-10 17:19:04,101,2036,56,45,1340.98,2297.42,0.00
2024-12-10 17:19:04,100,2036,56,44,1351.89,2297.43,0.00
2024-12-10 17:19:04,100,2037,56,44,1361.57,2298.00,0.00
2024-12-10 17:19:04,101,2037,56,45,1348.09,2298.01,0.00
2024-12-10 17:19:04,102,2036,56,46,1332.44,2298.14,0.00
2024-12-10 17:19:04,103,2035,57,46,1334.30,2298.36,0.00
2024-12-10 17:19:04,103,2036,57,46,1354.34,2299.00,0.00
2024-12-10 17:19:04,104,2036,57,47,1341.31,2299.01,0.00
2024-12-10 17:19:04,104,2037,57,47,1384.22,2300.00,0.00
2024-12-10 17:19:04,105,2037,58,47,1371.04,2300.01,0.00
2024-12-10 17:19:04,104,2037,57,47,1382.93,2300.06,0.00
2024-12-10 17:19:04,104,2038,57,47,1382.63,2301.00,0.00
2024-12-10 17:19:04,105,2038,57,48,1369.47,2301.01,0.00
2024-12-10 17:19:04,105,2039,57,48,1364.81,2302.00,0.00
2024-12-10 17:19:04,106,2039,58,48,1351.93,2302.01,0.00
2024-12-10 17:19:04,105,2039,57,48,1349.63,2302.39,0.00
2024-12-10 17:19:04,105,2040,57,48,1356.89,2303.00,0.00
2024-12-10 17:19:04,106,2040,57,49,1344.09,2303.01,0.00
2024-12-10 17:19:04,105,2040,57,48,1355.61,2303.06,0.00
2024-12-10 17:19:04,105,2041,57,48,1355.29,2304.00,0.00
2024-12-10 17:19:04,106,2041,57,49,1342.50,2304.01,0.00
2024-12-10 17:19:04,105,2041,56,49,1354.00,2304.06,0.00
2024-12-10 17:19:04,105,2042,56,49,1353.35,2305.00,0.00
2024-12-10 17:19:04,106,2042,57,49,1340.58,2305.01,0.00
2024-12-10 17:19:04,105,2042,57,48,1351.85,2305.07,0.00
2024-12-10 17:19:04,105,2043,57,48,1349.72,2306.00,0.00
2024-12-10 17:19:04,106,2043,57,49,1336.99,2306.01,0.00
2024-12-10 17:19:04,106,2044,57,49,1330.75,2307.00,0.00
2024-12-10 17:19:04,107,2044,57,50,1318.32,2307.01,0.00
2024-12-10 17:19:04,107,2045,57,50,1308.98,2308.00,0.00
2024-12-10 17:19:04,108,2045,57,51,1296.86,2308.01,0.00
2024-12-10 17:19:04,107,2045,57,50,1292.59,2308.60,0.00
2024-12-10 17:19:04,106,2045,56,50,1294.42,2308.77,0.00
2024-12-10 17:19:04,106,2046,56,50,1311.17,2309.00,0.00
2024-12-10 17:19:04,107,2046,57,50,1298.91,2309.01,0.00
2024-12-10 17:19:04,106,2046,57,49,1309.68,2309.07,0.00
2024-12-10 17:19:04,106,2047,57,49,1304.28,2310.00,0.00
2024-12-10 17:19:04,107,2047,57,50,1292.09,2310.01,0.00
2024-12-10 17:19:04,106,2047,57,49,1296.77,2310.33,0.00
2024-12-10 17:19:04,106,2048,57,49,1301.87,2311.00,0.00
2024-12-10 17:19:04,107,2048,57,50,1289.71,2311.01,0.00
2024-12-10 17:19:04,106,2048,57,49,1296.31,2311.08,0.00
2024-12-10 17:19:04,106,2049,57,49,1295.58,2312.00,0.00
2024-12-10 17:19:04,107,2049,57,50,1283.48,2312.01,0.00
2024-12-10 17:19:04,106,2049,56,50,1292.23,2312.06,0.00
2024-12-10 17:19:04,106,2050,56,50,1291.40,2313.00,0.00
2024-12-10 17:19:04,107,2050,57,50,1279.33,2313.01,0.00
2024-12-10 17:19:04,106,2050,56,50,1289.91,2313.07,0.00
2024-12-10 17:19:04,106,2051,56,50,1290.08,2314.00,0.00
2024-12-10 17:19:04,107,2051,56,51,1278.02,2314.01,0.00
2024-12-10 17:19:04,106,2051,56,50,1288.59,2314.07,0.00
2024-12-10 17:19:04,107,2050,57,50,1272.68,2314.25,0.00
2024-12-10 17:19:04,107,2051,57,50,1280.49,2315.00,0.00
2024-12-10 17:19:04,108,2051,58,50,1268.63,2315.01,0.00
2024-12-10 17:19:04,107,2051,57,50,1279.01,2315.07,0.00
2024-12-10 17:19:04,107,2052,57,50,1298.61,2316.00,0.00
2024-12-10 17:19:04,108,2052,58,50,1286.58,2316.01,0.00
2024-12-10 17:19:04,107,2052,57,50,1297.13,2316.07,0.00
2024-12-10 17:19:04,106,2052,57,49,1304.37,2316.28,0.00
2024-12-10 17:19:04,105,2052,57,48,1308.12,2316.54,0.00
2024-12-10 17:19:04,105,2053,57,48,1319.95,2317.00,0.00
2024-12-10 17:19:04,106,2053,58,48,1307.49,2317.01,0.00
2024-12-10 17:19:04,105,2053,58,47,1318.44,2317.07,0.00
2024-12-10 17:19:04,105,2054,58,47,1319.41,2318.00,0.00
2024-12-10 17:19:04,106,2054,58,48,1306.97,2318.01,0.00
2024-12-10 17:19:04,105,2054,58,47,1317.90,2318.07,0.00
2024-12-10 17:19:04,105,2055,58,47,1318.81,2319.00,0.00
2024-12-10 17:19:04,106,2055,59,47,1306.36,2319.01,0.00
2024-12-10 17:19:04,105,2055,58,47,1317.29,2319.07,0.00
2024-12-10 17:19:04,105,2056,58,47,1316.37,2320.00,0.00
2024-12-10 17:19:04,106,2056,58,48,1303.95,2320.01,0.00
2024-12-10 17:19:05,105,2056,57,48,1314.86,2320.07,0.00
2024-12-10 17:19:05,104,2056,56,48,1321.71,2320.20,0.00
2024-12-10 17:19:05,104,2057,56,48,1326.01,2321.00,0.00
2024-12-10 17:19:05,105,2057,57,48,1313.38,2321.01,0.00
2024-12-10 17:19:05,104,2057,57,47,1324.48,2321.07,0.00
2024-12-10 17:19:05,104,2058,57,47,1325.69,2322.00,0.00
2024-12-10 17:19:05,105,2058,58,47,1313.07,2322.01,0.00
2024-12-10 17:19:05,105,2059,58,47,1312.75,2323.00,0.00
2024-12-10 17:19:05,106,2059,59,47,1300.36,2323.01,0.00
2024-12-10 17:19:05,106,2060,59,47,1299.77,2324.00,0.00
2024-12-10 17:19:05,107,2060,60,47,1287.62,2324.01,0.00
2024-12-10 17:19:05,107,2061,60,47,1286.72,2325.00,0.00
2024-12-10 17:19:05,108,2061,61,47,1274.80,2325.01,0.00
2024-12-10 17:19:05,109,2060,61,48,1249.89,2325.61,0.00
2024-12-10 17:19:05,109,2061,61,48,1270.17,2326.00,0.00
2024-12-10 17:19:05,110,2061,62,48,1258.62,2326.01,0.00
2024-12-10 17:19:05,109,2061,61,48,1268.50,2326.07,0.00
2024-12-10 17:19:05,109,2062,61,48,1289.60,2327.00,0.00
2024-12-10 17:19:05,110,2062,62,48,1277.87,2327.01,0.00
2024-12-10 17:19:05,109,2062,62,47,1287.92,2327.07,0.00
2024-12-10 17:19:05,109,2063,62,47,1287.44,2328.00,0.00
2024-12-10 17:19:05,110,2063,62,48,1275.73,2328.01,0.00
2024-12-10 17:19:05,109,2063,61,48,1285.76,2328.07,0.00
2024-12-10 17:19:05,109,2064,61,48,1284.44,2329.00,0.00
2024-12-10 17:19:05,110,2064,61,49,1272.77,2329.01,0.00
2024-12-10 17:19:05,110,2065,61,49,1268.03,2330.00,0.00
2024-12-10 17:19:05,111,2065,62,49,1256.61,2330.01,0.00
2024-12-10 17:19:05,110,2065,62,48,1266.37,2330.07,0.00
2024-12-10 17:19:05,110,2066,62,48,1261.02,2331.00,0.00
2024-12-10 17:19:05,111,2066,62,49,1249.66,2331.01,0.00
2024-12-10 17:19:05,110,2066,61,49,1259.36,2331.07,0.00
2024-12-10 17:19:05,111,2065,62,49,1246.97,2331.14,0.00
2024-12-10 17:19:05,111,2066,62,49,1243.24,2332.00,0.00
2024-12-10 17:19:05,112,2066,62,50,1232.14,2332.01,0.00
2024-12-10 17:19:05,111,2066,62,49,1241.59,2332.07,0.00
2024-12-10 17:19:05,110,2066,62,48,1237.63,2332.56,0.00
2024-12-10 17:19:05,110,2067,62,48,1264.76,2333.00,0.00
2024-12-10 17:19:05,111,2067,62,49,1253.37,2333.01,0.00
2024-12-10 17:19:05,110,2067,61,49,1263.10,2333.07,0.00
2024-12-10 17:19:05,110,2068,61,49,1252.43,2334.00,0.00
2024-12-10 17:19:05,111,2068,61,50,1241.15,2334.01,0.00
2024-12-10 17:19:05,110,2068,60,50,1229.80,2334.66,0.00
2024-12-10 17:19:05,110,2069,60,50,1243.24,2335.00,0.00
2024-12-10 17:19:05,111,2069,60,51,1232.04,2335.01,0.00
2024-12-10 17:19:05,110,2069,59,51,1241.57,2335.07,0.00
2024-12-10 17:19:05,109,2069,59,50,1246.47,2335.30,0.00
2024-12-10 17:19:05,108,2069,59,49,1247.00,2335.64,0.00
2024-12-10 17:19:05,108,2069,59,49,1260.48,2336.00,0.00
2024-12-10 17:19:05,109,2069,60,49,1248.92,2336.01,0.00
2024-12-10 17:19:05,108,2069,59,49,1258.78,2336.07,0.00
2024-12-10 17:19:05,108,2070,59,49,1257.45,2337.00,0.00
2024-12-10 17:19:05,109,2070,60,49,1245.91,2337.01,0.00
2024-12-10 17:19:05,108,2070,60,48,1255.75,2337.07,0.00
2024-12-10 17:19:05,108,2071,60,48,1253.44,2338.00,0.00
2024-12-10 17:19:05,109,2071,60,49,1241.94,2338.01,0.00
2024-12-10 17:19:05,110,2070,61,49,1219.25,2338.41,0.00
2024-12-10 17:19:05,110,2071,61,49,1244.77,2339.00,0.00
2024-12-10 17:19:05,111,2071,62,49,1233.56,2339.01,0.00
2024-12-10 17:19:05,111,2072,62,49,1247.00,2340.00,0.00
2024-12-10 17:19:05,112,2072,63,49,1235.86,2340.01,0.00
2024-12-10 17:19:05,111,2072,62,49,1245.13,2340.08,0.00
2024-12-10 17:19:05,110,2072,62,48,1256.24,2340.08,0.00
2024-12-10 17:19:05,110,2073,62,48,1249.89,2341.00,0.00
2024-12-10 17:19:05,111,2073,63,48,1238.63,2341.01,0.00
2024-12-10 17:19:05,110,2073,62,48,1247.14,2341.13,0.00
2024-12-10 17:19:05,109,2073,61,48,1255.97,2341.21,0.00
2024-12-10 17:19:05,109,2074,61,48,1255.25,2342.00,0.00
2024-12-10 17:19:05,110,2074,61,49,1243.84,2342.01,0.00
2024-12-10 17:19:05,109,2074,61,48,1253.14,2342.09,0.00
2024-12-10 17:19:05,108,2074,61,47,1261.14,2342.24,0.00
2024-12-10 17:19:05,108,2075,61,47,1261.07,2343.00,0.00
2024-12-10 17:19:05,109,2075,62,47,1249.50,2343.01,0.00
2024-12-10 17:19:05,108,2075,61,47,1250.81,2343.35,0.00
2024-12-10 17:19:05,108,2076,61,47,1254.43,2344.00,0.00
2024-12-10 17:19:05,109,2076,62,47,1242.92,2344.01,0.00
2024-12-10 17:19:05,109,2077,62,47,1235.70,2345.00,0.00
2024-12-10 17:19:05,110,2077,62,48,1224.47,2345.01,0.00
2024-12-10 17:19:05,109,2077,62,47,1232.77,2345.12,0.00
2024-12-10 17:19:05,109,2078,62,47,1229.14,2346.00,0.00
2024-12-10 17:19:05,110,2078,63,47,1217.97,2346.01,0.00
2024-12-10 17:19:05,110,2079,63,47,1211.86,2347.00,0.00
2024-12-10 17:19:05,111,2079,64,47,1200.94,2347.01,0.00
2024-12-10 17:19:05,111,2080,64,47,1194.17,2348.00,0.00
2024-12-10 17:19:05,112,2080,64,48,1183.51,2348.01,0.00
2024-12-10 17:19:05,111,2080,64,47,1191.88,2348.10,0.00
2024-12-10 17:19:05,110,2080,64,46,1192.58,2348.41,0.00
2024-12-10 17:19:05,110,2081,64,46,1197.90,2349.00,0.00
2024-12-10 17:19:05,111,2081,65,46,1187.11,2349.01,0.00
2024-12-10 17:19:05,110,2081,64,46,1195.59,2349.10,0.00
2024-12-10 17:19:05,109,2081,63,46,1193.64,2349.47,0.00
2024-12-10 17:19:06,109,2082,63,46,1202.33,2350.00,0.00
2024-12-10 17:19:06,110,2082,63,47,1191.40,2350.01,0.00
2024-12-10 17:19:06,110,2083,63,47,1184.57,2351.00,0.00
2024-12-10 17:19:06,111,2083,64,47,1173.90,2351.01,0.00
2024-12-10 17:19:06,110,2083,63,47,1179.26,2351.24,0.00
2024-12-10 17:19:06,109,2083,62,47,1185.27,2351.30,0.00
2024-12-10 17:19:06,109,2084,62,47,1187.28,2352.00,0.00
2024-12-10 17:19:06,110,2084,63,47,1176.48,2352.01,0.00
2024-12-10 17:19:06,109,2084,62,47,1184.93,2352.10,0.00
2024-12-10 17:19:06,108,2084,61,47,1191.24,2352.23,0.00
2024-12-10 17:19:06,108,2085,61,47,1191.12,2353.00,0.00
2024-12-10 17:19:06,109,2085,62,47,1180.19,2353.01,0.00
2024-12-10 17:19:06,108,2085,62,46,1188.75,2353.10,0.00
2024-12-10 17:19:06,107,2085,61,46,1191.86,2353.39,0.00
2024-12-10 17:19:06,107,2086,61,46,1195.47,2354.00,0.00
2024-12-10 17:19:06,108,2086,62,46,1184.40,2354.01,0.00
2024-12-10 17:19:06,107,2086,61,46,1192.54,2354.10,0.00
2024-12-10 17:19:06,106,2086,61,45,1194.87,2354.47,0.00
2024-12-10 17:19:06,106,2087,61,45,1199.48,2355.00,0.00
2024-12-10 17:19:06,107,2087,62,45,1188.27,2355.01,0.00
2024-12-10 17:19:06,106,2087,62,44,1194.92,2355.10,0.00
2024-12-10 17:19:06,106,2088,62,44,1188.31,2356.00,0.00
2024-12-10 17:19:06,107,2088,62,45,1177.20,2356.01,0.00
2024-12-10 17:19:06,106,2088,62,44,1188.08,2356.01,0.00
2024-12-10 17:19:06,105,2088,61,44,1193.13,2356.10,0.00
2024-12-10 17:19:06,104,2088,60,44,1204.38,2356.10,0.00
2024-12-10 17:19:06,103,2088,59,44,1189.48,2356.76,0.00
2024-12-10 17:19:06,103,2089,59,44,1205.62,2357.00,0.00
2024-12-10 17:19:06,104,2089,60,44,1194.02,2357.01,0.00
2024-12-10 17:19:06,103,2089,60,43,1197.05,2357.10,0.00
2024-12-10 17:19:06,102,2089,59,43,1207.34,2357.15,0.00
2024-12-10 17:19:06,102,2090,59,43,1207.69,2358.00,0.00
2024-12-10 17:19:06,103,2090,60,43,1195.97,2358.01,0.00
2024-12-10 17:19:06,102,2090,60,42,1202.56,2358.07,0.00
2024-12-10 17:19:06,101,2090,60,41,1213.78,2358.09,0.00
2024-12-10 17:19:06,101,2091,60,41,1212.70,2359.00,0.00
2024-12-10 17:19:06,102,2091,60,42,1200.81,2359.01,0.00
2024-12-10 17:19:06,102,2092,60,42,1187.96,2360.00,0.00
2024-12-10 17:19:06,103,2092,61,42,1176.42,2360.01,0.00
2024-12-10 17:19:06,103,2093,61,42,1162.87,2361.00,0.00
2024-12-10 17:19:06,104,2093,61,43,1151.69,2361.01,0.00
2024-12-10 17:19:06,103,2093,60,43,1160.83,2361.09,0.00
2024-12-10 17:19:06,102,2093,59,43,1141.28,2361.98,0.00
2024-12-10 17:19:06,102,2094,59,43,1163.99,2362.00,0.00
2024-12-10 17:19:06,103,2094,60,43,1152.68,2362.01,0.00
2024-12-10 17:19:06,102,2094,60,42,1161.92,2362.09,0.00
2024-12-10 17:19:06,101,2094,60,41,1162.67,2362.49,0.00
2024-12-10 17:19:06,101,2095,60,41,1169.93,2363.00,0.00
2024-12-10 17:19:06,102,2095,61,41,1158.46,2363.01,0.00
2024-12-10 17:19:06,101,2095,60,41,1167.85,2363.09,0.00
2024-12-10 17:19:06,101,2096,60,41,1163.58,2364.00,0.00
2024-12-10 17:19:06,102,2096,60,42,1152.17,2364.01,0.00
2024-12-10 17:19:06,101,2096,60,41,1161.35,2364.09,0.00
2024-12-10 17:19:06,101,2097,60,41,1159.94,2365.00,0.00
2024-12-10 17:19:06,102,2097,60,42,1148.57,2365.01,0.00
2024-12-10 17:19:06,102,2098,60,42,1141.82,2366.00,0.00
2024-12-10 17:19:06,103,2098,61,42,1130.73,2366.01,0.00
2024-12-10 17:19:06,102,2098,60,42,1138.50,2366.01,0.00
2024-12-10 17:19:06,103,2097,61,42,1112.71,2366.51,0.00
2024-12-10 17:19:06,102,2097,60,42,1139.56,2366.56,0.00
2024-12-10 17:19:06,102,2098,60,42,1150.21,2367.00,0.00
2024-12-10 17:19:06,103,2098,61,42,1139.04,2367.01,0.00
2024-12-10 17:19:06,102,2098,60,42,1146.67,2367.04,0.00
2024-12-10 17:19:06,102,2099,60,42,1165.48,2368.00,0.00
2024-12-10 17:19:06,103,2099,60,43,1154.16,2368.01,0.00
2024-12-10 17:19:06,102,2099,59,43,1160.23,2368.20,0.00
2024-12-10 17:19:06,102,2100,59,43,1159.94,2369.00,0.00
2024-12-10 17:19:06,103,2100,60,43,1148.68,2369.01,0.00
2024-12-10 17:19:06,102,2100,59,43,1158.32,2369.07,0.00
2024-12-10 17:19:06,103,2099,59,44,1145.70,2369.15,0.00
2024-12-10 17:19:06,103,2100,59,44,1164.20,2370.00,0.00
2024-12-10 17:19:06,104,2100,60,44,1153.01,2370.01,0.00
2024-12-10 17:19:06,103,2100,60,43,1160.70,2370.07,0.00
2024-12-10 17:19:06,103,2101,60,43,1179.68,2371.00,0.00
2024-12-10 17:19:06,104,2101,60,44,1168.34,2371.01,0.00
2024-12-10 17:19:06,103,2101,59,44,1178.05,2371.02,0.00
2024-12-10 17:19:06,103,2102,59,44,1170.09,2372.00,0.00
2024-12-10 17:19:06,104,2102,60,44,1158.84,2372.01,0.00
2024-12-10 17:19:06,103,2102,59,44,1169.39,2372.03,0.00
2024-12-10 17:19:06,103,2103,59,44,1163.61,2373.00,0.00
2024-12-10 17:19:06,104,2103,59,45,1152.42,2373.01,0.00
2024-12-10 17:19:06,103,2103,58,45,1163.15,2373.02,0.00
2024-12-10 17:19:06,102,2103,58,44,1173.10,2373.04,0.00
2024-12-10 17:19:06,101,2103,57,44,1166.73,2373.63,0.00
2024-12-10 17:19:06,101,2104,57,44,1178.87,2374.00,0.00
2024-12-10 17:19:06,102,2104,58,44,1167.31,2374.01,0.00
2024-12-10 17:19:06,101,2104,57,44,1176.42,2374.04,0.00
2024-12-10 17:19:06,101,2105,57,44,1171.69,2375.00,0.00
2024-12-10 17:19:06,102,2105,57,45,1160.20,2375.01,0.00
2024-12-10 17:19:06,101,2105,56,45,1170.95,2375.02,0.00
2024-12-10 17:19:06,100,2105,56,44,1182.19,2375.03,0.00
2024-12-10 17:19:06,100,2106,56,44,1177.01,2376.00,0.00
2024-12-10 17:19:06,101,2106,56,45,1165.36,2376.01,0.00
2024-12-10 17:19:07,101,2107,56,45,1159.12,2377.00,0.00
2024-12-10 17:19:07,102,2107,56,46,1147.76,2377.01,0.00
2024-12-10 17:19:07,101,2107,56,45,1158.42,2377.03,0.00
2024-12-10 17:19:07,101,2108,56,45,1152.20,2378.00,0.00
2024-12-10 17:19:07,102,2108,56,46,1140.90,2378.01,0.00
2024-12-10 17:19:07,101,2108,55,46,1151.49,2378.03,0.00
2024-12-10 17:19:07,102,2107,56,46,1136.04,2378.19,0.00
2024-12-10 17:19:07,102,2108,56,46,1151.30,2379.00,0.00
2024-12-10 17:19:07,103,2108,57,46,1140.13,2379.01,0.00
2024-12-10 17:19:07,102,2108,56,46,1151.07,2379.01,0.00
2024-12-10 17:19:07,101,2108,55,46,1141.01,2379.66,0.00
2024-12-10 17:19:07,101,2109,55,46,1172.70,2380.00,0.00
2024-12-10 17:19:07,102,2109,55,47,1161.20,2380.01,0.00
2024-12-10 17:19:07,101,2109,54,47,1170.34,2380.11,0.00
2024-12-10 17:19:07,100,2109,54,46,1171.48,2380.45,0.00
2024-12-10 17:19:07,99,2109,54,45,1181.41,2380.53,0.00
2024-12-10 17:19:07,99,2110,54,45,1179.20,2381.00,0.00
2024-12-10 17:19:07,100,2110,55,45,1167.41,2381.01,0.00
2024-12-10 17:19:07,99,2110,54,45,1178.25,2381.04,0.00
2024-12-10 17:19:07,98,2110,53,45,1189.98,2381.05,0.00
2024-12-10 17:19:07,97,2110,52,45,1175.73,2381.76,0.00
2024-12-10 17:19:07,97,2111,52,45,1183.25,2382.00,0.00
2024-12-10 17:19:07,98,2111,53,45,1171.18,2382.01,0.00
2024-12-10 17:19:07,97,2111,52,45,1182.28,2382.04,0.00
2024-12-10 17:19:07,96,2111,51,45,1191.56,2382.09,0.00
2024-12-10 17:19:07,95,2111,50,45,1198.06,2382.33,0.00
2024-12-10 17:19:07,95,2112,50,45,1188.64,2383.00,0.00
2024-12-10 17:19:07,96,2112,50,46,1176.26,2383.01,0.00
2024-12-10 17:19:07,95,2112,50,45,1164.93,2383.79,0.00
2024-12-10 17:19:07,94,2112,49,45,1174.12,2383.80,0.00
2024-12-10 17:19:07,94,2113,49,45,1191.43,2384.00,0.00
2024-12-10 17:19:07,95,2113,49,46,1178.89,2384.01,0.00
2024-12-10 17:19:07,94,2113,48,46,1190.43,2384.04,0.00
2024-12-10 17:19:07,93,2113,47,46,1191.39,2384.54,0.00
2024-12-10 17:19:07,92,2113,46,46,1196.89,2384.79,0.00
2024-12-10 17:19:07,92,2114,46,46,1212.73,2385.00,0.00
2024-12-10 17:19:07,93,2114,46,47,1199.69,2385.01,0.00
2024-12-10 17:19:07,93,2115,46,47,1190.78,2386.00,0.00
2024-12-10 17:19:07,94,2115,47,47,1178.11,2386.01,0.00
2024-12-10 17:19:07,93,2115,47,46,1189.76,2386.04,0.00
2024-12-10 17:19:07,92,2115,46,46,1202.44,2386.04,0.00
2024-12-10 17:19:07,91,2115,46,45,1186.27,2386.91,0.00
2024-12-10 17:19:07,91,2116,46,45,1210.47,2387.00,0.00
2024-12-10 17:19:07,92,2116,47,45,1197.31,2387.01,0.00
2024-12-10 17:19:07,91,2116,47,44,1209.70,2387.03,0.00
2024-12-10 17:19:07,91,2117,47,44,1209.87,2388.00,0.00
2024-12-10 17:19:07,92,2117,48,44,1196.72,2388.01,0.00
2024-12-10 17:19:07,91,2117,48,43,1208.84,2388.04,0.00
2024-12-10 17:19:07,90,2117,47,43,1208.88,2388.56,0.00
2024-12-10 17:19:07,90,2118,47,43,1218.36,2389.00,0.00
2024-12-10 17:19:07,91,2118,47,44,1204.98,2389.01,0.00
2024-12-10 17:19:07,92,2117,47,45,1169.32,2389.84,0.00
2024-12-10 17:19:07,92,2118,47,45,1186.89,2390.00,0.00
2024-12-10 17:19:07,93,2118,47,46,1174.13,2390.01,0.00
2024-12-10 17:19:07,93,2119,47,46,1176.84,2391.00,0.00
2024-12-10 17:19:07,94,2119,47,47,1164.32,2391.01,0.00
2024-12-10 17:19:07,93,2119,46,47,1135.69,2391.82,0.00
2024-12-10 17:19:07,93,2120,46,47,1141.22,2392.00,0.00
2024-12-10 17:19:07,94,2120,46,48,1129.08,2392.01,0.00
2024-12-10 17:19:07,93,2120,46,47,1141.02,2392.01,0.00
2024-12-10 17:19:07,92,2120,45,47,1152.66,2392.03,0.00
2024-12-10 17:19:07,91,2120,45,46,1157.85,2392.29,0.00
2024-12-10 17:19:07,92,2119,46,46,1125.42,2392.80,0.00
2024-12-10 17:19:07,91,2119,45,46,1126.98,2392.89,0.00
2024-12-10 17:19:07,91,2120,45,46,1143.96,2393.00,0.00
2024-12-10 17:19:07,92,2120,46,46,1131.53,2393.01,0.00
2024-12-10 17:19:07,91,2120,45,46,1143.19,2393.03,0.00
2024-12-10 17:19:07,90,2120,45,45,1155.03,2393.04,0.00
2024-12-10 17:19:07,89,2120,44,45,1152.97,2393.61,0.00
2024-12-10 17:19:07,89,2121,44,45,1159.92,2394.00,0.00
2024-12-10 17:19:07,90,2121,44,46,1147.03,2394.01,0.00
2024-12-10 17:19:07,90,2122,44,46,1105.57,2395.00,0.00
2024-12-10 17:19:07,91,2122,44,47,1093.42,2395.01,0.00
2024-12-10 17:19:07,90,2122,43,47,1086.54,2395.66,0.00
2024-12-10 17:19:07,89,2122,43,46,1085.87,2395.76,0.00
2024-12-10 17:19:07,88,2122,43,45,1084.20,2395.88,0.00
2024-12-10 17:19:07,88,2123,43,45,1096.97,2396.00,0.00
2024-12-10 17:19:07,89,2123,43,46,1084.65,2396.01,0.00
2024-12-10 17:19:07,88,2123,43,45,1095.90,2396.05,0.00
2024-12-10 17:19:07,87,2123,43,44,1082.96,2396.77,0.00
2024-12-10 17:19:07,86,2123,43,43,1092.19,2396.79,0.00
2024-12-10 17:19:07,85,2123,42,43,1084.04,2396.97,0.00
2024-12-10 17:19:07,85,2124,42,43,1111.42,2397.00,0.00
2024-12-10 17:19:07,86,2124,43,43,1098.50,2397.01,0.00
2024-12-10 17:19:07,85,2124,43,42,1110.31,2397.05,0.00
2024-12-10 17:19:07,85,2125,43,42,1092.70,2398.00,0.00
2024-12-10 17:19:07,86,2125,43,43,1080.00,2398.01,0.00
2024-12-10 17:19:07,85,2125,43,42,1091.59,2398.05,0.00
2024-12-10 17:19:07,85,2126,43,42,1067.52,2399.00,0.00
2024-12-10 17:19:07,86,2126,44,42,1055.11,2399.01,0.00
2024-12-10 17:19:07,85,2126,44,41,1066.41,2399.05,0.00
2024-12-10 17:19:07,84,2126,44,40,1038.34,2399.83,0.00
2024-12-10 17:19:07,84,2127,44,40,1055.06,2400.00,0.00
2024-12-10 17:19:07,85,2127,44,41,1042.64,2400.01,0.00
2024-12-10 17:19:07,84,2127,43,41,1053.93,2400.05,0.00
2024-12-10 17:19:07,84,2128,43,41,1032.55,2401.00,0.00
2024-12-10 17:19:07,85,2128,44,41,1020.40,2401.01,0.00
2024-12-10 17:19:07,84,2128,44,40,1016.43,2401.63,0.00
2024-12-10 17:19:07,83,2128,43,40,1024.79,2401.69,0.00
2024-12-10 17:19:07,82,2128,43,39,1024.49,2401.78,0.00
2024-12-10 17:19:07,82,2129,43,39,1038.76,2402.00,0.00
2024-12-10 17:19:07,83,2129,44,39,1026.24,2402.01,0.00
2024-12-10 17:19:07,82,2129,43,39,1037.61,2402.05,0.00
2024-12-10 17:19:07,83,2128,43,40,1010.70,2402.64,0.00
2024-12-10 17:19:07,82,2128,42,40,1033.08,2402.71,0.00
2024-12-10 17:19:07,81,2128,42,39,1040.88,2402.74,0.00
2024-12-10 17:19:07,81,2129,42,39,1053.45,2403.00,0.00
2024-12-10 17:19:07,82,2129,42,40,1040.60,2403.01,0.00
2024-12-10 17:19:07,83,2128,42,41,1027.78,2403.05,0.00
2024-12-10 17:19:07,82,2128,42,40,1062.32,2403.06,0.00
2024-12-10 17:19:07,82,2129,42,40,1086.66,2404.00,0.00
2024-12-10 17:19:07,83,2129,43,40,1073.56,2404.01,0.00
2024-12-10 17:19:07,82,2129,43,39,1085.51,2404.05,0.00
2024-12-10 17:19:07,81,2129,42,39,1080.55,2404.75,0.00
2024-12-10 17:19:07,80,2129,42,38,1088.78,2404.79,0.00
2024-12-10 17:19:07,79,2129,42,37,1101.62,2404.84,0.00
2024-12-10 17:19:07,79,2130,42,37,1158.69,2405.00,0.00
2024-12-10 17:19:07,80,2130,42,38,1144.20,2405.01,0.00
2024-12-10 17:19:07,79,2130,41,38,1157.50,2405.05,0.00
2024-12-10 17:19:08,79,2131,41,38,1163.23,2406.00,0.00
2024-12-10 17:19:08,80,2131,42,38,1148.69,2406.01,0.00
2024-12-10 17:19:08,79,2131,42,37,1162.04,2406.05,0.00
2024-12-10 17:19:08,79,2132,42,37,1167.52,2407.00,0.00
2024-12-10 17:19:08,80,2132,42,38,1152.92,2407.01,0.00
2024-12-10 17:19:08,79,2132,42,37,1166.33,2407.05,0.00
2024-12-10 17:19:08,79,2133,42,37,1171.44,2408.00,0.00
2024-12-10 17:19:08,80,2133,43,37,1156.80,2408.01,0.00
2024-12-10 17:19:08,79,2133,43,36,1170.25,2408.05,0.00
2024-12-10 17:19:08,78,2133,42,36,1167.20,2408.74,0.00
2024-12-10 17:19:08,78,2134,42,36,1192.13,2409.00,0.00
2024-12-10 17:19:08,79,2134,43,36,1177.04,2409.01,0.00
2024-12-10 17:19:08,78,2134,42,36,1190.92,2409.05,0.00
2024-12-10 17:19:08,78,2135,42,36,1199.42,2410.00,0.00
2024-12-10 17:19:08,79,2135,43,36,1184.24,2410.01,0.00
2024-12-10 17:19:08,78,2135,43,35,1198.21,2410.05,0.00
2024-12-10 17:19:08,78,2136,43,35,1206.72,2411.00,0.00
2024-12-10 17:19:08,79,2136,43,36,1191.44,2411.01,0.00
2024-12-10 17:19:08,78,2136,42,36,1204.09,2411.12,0.00
2024-12-10 17:19:08,78,2137,42,36,1214.15,2412.00,0.00
2024-12-10 17:19:08,79,2137,43,36,1198.78,2412.01,0.00
2024-12-10 17:19:08,78,2137,43,35,1212.94,2412.05,0.00
2024-12-10 17:19:08,78,2138,43,35,1221.45,2413.00,0.00
2024-12-10 17:19:08,79,2138,43,36,1205.99,2413.01,0.00
2024-12-10 17:19:08,78,2138,42,36,1220.24,2413.05,0.00
2024-12-10 17:19:08,78,2139,42,36,1228.77,2414.00,0.00
2024-12-10 17:19:08,79,2139,42,37,1213.22,2414.01,0.00
2024-12-10 17:19:08,78,2139,42,36,1227.56,2414.05,0.00
2024-12-10 17:19:08,77,2139,41,36,1243.19,2414.05,0.00
2024-12-10 17:19:08,77,2140,41,36,1252.14,2415.00,0.00
2024-12-10 17:19:08,78,2140,42,36,1236.09,2415.01,0.00
2024-12-10 17:19:08,78,2141,42,36,1243.73,2416.00,0.00
2024-12-10 17:19:08,79,2141,43,36,1227.98,2416.01,0.00
2024-12-10 17:19:08,78,2141,42,36,1242.51,2416.05,0.00
2024-12-10 17:19:08,78,2142,42,36,1250.91,2417.00,0.00
2024-12-10 17:19:08,79,2142,42,37,1235.07,2417.01,0.00
2024-12-10 17:19:08,78,2142,41,37,1238.35,2417.51,0.00
2024-12-10 17:19:08,78,2143,41,37,1257.94,2418.00,0.00
2024-12-10 17:19:08,79,2143,41,38,1242.02,2418.01,0.00
2024-12-10 17:19:08,79,2144,41,38,1248.55,2419.00,0.00
2024-12-10 17:19:08,80,2144,42,38,1232.94,2419.01,0.00
2024-12-10 17:19:08,79,2144,41,38,1247.35,2419.05,0.00
2024-12-10 17:19:08,79,2145,41,38,1254.26,2420.00,0.00
2024-12-10 17:19:08,80,2145,42,38,1238.58,2420.01,0.00
2024-12-10 17:19:08,79,2145,42,37,1253.06,2420.05,0.00
2024-12-10 17:19:08,79,2146,42,37,1259.11,2421.00,0.00
2024-12-10 17:19:08,80,2146,43,37,1243.38,2421.01,0.00
2024-12-10 17:19:08,80,2147,43,37,1247.12,2422.00,0.00
2024-12-10 17:19:08,81,2147,43,38,1231.72,2422.01,0.00
2024-12-10 17:19:08,80,2147,42,38,1245.93,2422.05,0.00
2024-12-10 17:19:08,80,2148,42,38,1249.55,2423.00,0.00
2024-12-10 17:19:08,81,2148,43,38,1234.13,2423.01,0.00
2024-12-10 17:19:08,80,2148,42,38,1248.37,2423.05,0.00
2024-12-10 17:19:08,80,2149,42,38,1251.16,2424.00,0.00
2024-12-10 17:19:08,81,2149,42,39,1235.71,2424.01,0.00
2024-12-10 17:19:08,80,2149,41,39,1249.97,2424.05,0.00
2024-12-10 17:19:08,80,2150,41,39,1252.03,2425.00,0.00
2024-12-10 17:19:08,81,2150,41,40,1236.57,2425.01,0.00
2024-12-10 17:19:08,80,2150,40,40,1250.84,2425.05,0.00
2024-12-10 17:19:08,80,2151,40,40,1252.49,2426.00,0.00
2024-12-10 17:19:08,81,2151,41,40,1237.03,2426.01,0.00
2024-12-10 17:19:08,80,2151,40,40,1251.30,2426.05,0.00
2024-12-10 17:19:08,79,2151,40,39,1266.67,2426.06,0.00
2024-12-10 17:19:08,79,2152,40,39,1268.64,2427.00,0.00
2024-12-10 17:19:08,80,2152,40,40,1252.79,2427.01,0.00
2024-12-10 17:19:08,79,2152,39,40,1267.44,2427.05,0.00
2024-12-10 17:19:08,78,2152,39,39,1265.60,2427.68,0.00
2024-12-10 17:19:08,78,2153,39,39,1289.21,2428.00,0.00
2024-12-10 17:19:08,79,2153,39,40,1272.89,2428.01,0.00
2024-12-10 17:19:08,79,2154,39,40,1277.90,2429.00,0.00
2024-12-10 17:19:08,80,2154,39,41,1261.92,2429.01,0.00
2024-12-10 17:19:08,79,2154,39,40,1276.69,2429.05,0.00
2024-12-10 17:19:08,79,2155,39,40,1282.52,2430.00,0.00
2024-12-10 17:19:08,80,2155,40,40,1266.49,2430.01,0.00
2024-12-10 17:19:08,79,2155,39,40,1281.31,2430.05,0.00
2024-12-10 17:19:08,78,2155,39,39,1288.29,2430.33,0.00
2024-12-10 17:19:08,78,2156,39,39,1303.72,2431.00,0.00
2024-12-10 17:19:08,79,2156,39,40,1287.22,2431.01,0.00
2024-12-10 17:19:08,78,2156,39,39,1302.49,2431.05,0.00
2024-12-10 17:19:08,78,2157,39,39,1311.12,2432.00,0.00
2024-12-10 17:19:08,79,2157,40,39,1294.52,2432.01,0.00
2024-12-10 17:19:08,78,2157,40,38,1309.89,2432.05,0.00
2024-12-10 17:19:08,78,2158,40,38,1318.52,2433.00,0.00
2024-12-10 17:19:08,79,2158,40,39,1301.83,2433.01,0.00
2024-12-10 17:19:08,79,2159,40,39,1309.14,2434.00,0.00
2024-12-10 17:19:08,80,2159,41,39,1292.78,2434.01,0.00
2024-12-10 17:19:08,79,2159,41,38,1307.93,2434.05,0.00
2024-12-10 17:19:08,79,2160,41,38,1316.15,2435.00,0.00
2024-12-10 17:19:08,80,2160,42,38,1299.70,2435.01,0.00
2024-12-10 17:19:08,79,2160,42,37,1314.94,2435.05,0.00
2024-12-10 17:19:08,79,2161,42,37,1323.17,2436.00,0.00
2024-12-10 17:19:08,80,2161,43,37,1306.63,2436.01,0.00
2024-12-10 17:19:08,79,2161,42,37,1321.95,2436.05,0.00
2024-12-10 17:19:08,79,2162,42,37,1330.19,2437.00,0.00
2024-12-10 17:19:08,80,2162,42,38,1313.56,2437.01,0.00
2024-12-10 17:19:08,80,2163,42,38,1320.50,2438.00,0.00
2024-12-10 17:19:08,81,2163,42,39,1304.20,2438.01,0.00
2024-12-10 17:19:08,80,2163,42,38,1319.30,2438.05,0.00
2024-12-10 17:19:09,80,2164,42,38,1327.14,2439.00,0.00
2024-12-10 17:19:09,81,2164,42,39,1310.76,2439.01,0.00
2024-12-10 17:19:09,80,2164,41,39,1326.00,2439.05,0.00
2024-12-10 17:19:09,80,2165,41,39,1333.85,2440.00,0.00
2024-12-10 17:19:09,81,2165,42,39,1317.38,2440.01,0.00
2024-12-10 17:19:09,80,2165,41,39,1332.64,2440.05,0.00
2024-12-10 17:19:09,81,2164,42,39,1311.09,2440.28,0.00
2024-12-10 17:19:09,81,2165,42,39,1345.34,2441.00,0.00
2024-12-10 17:19:09,82,2165,42,40,1328.94,2441.01,0.00
2024-12-10 17:19:09,81,2165,41,40,1344.15,2441.05,0.00
2024-12-10 17:19:09,82,2164,41,41,1318.64,2441.45,0.00
2024-12-10 17:19:09,82,2165,41,41,1378.02,2442.00,0.00
2024-12-10 17:19:09,83,2165,42,41,1361.42,2442.01,0.00
2024-12-10 17:19:09,82,2165,42,40,1376.90,2442.05,0.00
2024-12-10 17:19:09,82,2166,42,40,1413.79,2443.00,0.00
2024-12-10 17:19:09,83,2166,42,41,1396.76,2443.01,0.00
2024-12-10 17:19:09,83,2167,42,41,1402.63,2444.00,0.00
2024-12-10 17:19:09,84,2167,42,42,1385.93,2444.01,0.00
2024-12-10 17:19:09,83,2167,41,42,1401.47,2444.05,0.00
2024-12-10 17:19:09,83,2168,41,42,1408.21,2445.00,0.00
2024-12-10 17:19:09,84,2168,42,42,1391.45,2445.01,0.00
2024-12-10 17:19:09,83,2168,42,41,1407.05,2445.05,0.00
2024-12-10 17:19:09,83,2169,42,41,1413.80,2446.00,0.00
2024-12-10 17:19:09,84,2169,43,41,1396.97,2446.01,0.00
2024-12-10 17:19:09,85,2168,43,42,1379.68,2446.07,0.00
2024-12-10 17:19:09,85,2169,43,42,1414.49,2447.00,0.00
2024-12-10 17:19:09,86,2169,44,42,1398.05,2447.01,0.00
2024-12-10 17:19:09,86,2170,44,42,1431.35,2448.00,0.00
2024-12-10 17:19:09,87,2170,45,42,1414.90,2448.01,0.00
2024-12-10 17:19:09,86,2170,45,41,1429.95,2448.06,0.00
2024-12-10 17:19:09,86,2171,45,41,1435.92,2449.00,0.00
2024-12-10 17:19:09,87,2171,45,42,1419.42,2449.01,0.00
2024-12-10 17:19:09,86,2171,44,42,1434.52,2449.06,0.00
2024-12-10 17:19:09,86,2172,44,42,1440.50,2450.00,0.00
2024-12-10 17:19:09,87,2172,45,42,1423.94,2450.01,0.00
2024-12-10 17:19:09,86,2172,45,41,1439.10,2450.06,0.00
2024-12-10 17:19:09,86,2173,45,41,1445.08,2451.00,0.00
2024-12-10 17:19:09,87,2173,45,42,1428.47,2451.01,0.00
2024-12-10 17:19:09,86,2173,44,42,1443.67,2451.06,0.00
2024-12-10 17:19:09,85,2173,44,41,1459.72,2451.09,0.00
2024-12-10 17:19:09,85,2174,44,41,1466.92,2452.00,0.00
2024-12-10 17:19:09,86,2174,44,42,1449.87,2452.01,0.00
2024-12-10 17:19:09,85,2174,43,42,1465.50,2452.06,0.00
2024-12-10 17:19:09,85,2175,43,42,1471.85,2453.00,0.00
2024-12-10 17:19:09,86,2175,44,42,1454.74,2453.01,0.00
2024-12-10 17:19:09,85,2175,43,42,1470.60,2453.06,0.00
2024-12-10 17:19:09,85,2176,43,42,1475.72,2454.00,0.00
2024-12-10 17:19:09,86,2176,43,43,1458.56,2454.01,0.00
2024-12-10 17:19:09,86,2177,43,43,1460.74,2455.00,0.00
2024-12-10 17:19:09,87,2177,44,43,1443.95,2455.01,0.00
2024-12-10 17:19:09,86,2177,43,43,1459.33,2455.06,0.00
2024-12-10 17:19:09,86,2178,43,43,1460.55,2456.00,0.00
2024-12-10 17:19:09,87,2178,44,43,1443.76,2456.01,0.00
2024-12-10 17:19:09,86,2178,43,43,1459.00,2456.06,0.00
2024-12-10 17:19:09,85,2178,42,43,1469.84,2456.22,0.00
2024-12-10 17:19:09,85,2179,42,43,1480.20,2457.00,0.00
2024-12-10 17:19:09,86,2179,42,44,1462.99,2457.01,0.00
2024-12-10 17:19:09,86,2180,42,44,1467.88,2458.00,0.00
2024-12-10 17:19:09,87,2180,42,45,1451.00,2458.01,0.00
2024-12-10 17:19:09,87,2181,42,45,1455.55,2459.00,0.00
2024-12-10 17:19:09,88,2181,43,45,1439.01,2459.01,0.00
2024-12-10 17:19:09,88,2182,43,45,1443.23,2460.00,0.00
2024-12-10 17:19:09,89,2182,43,46,1427.01,2460.01,0.00
2024-12-10 17:19:09,89,2183,43,46,1430.91,2461.00,0.00
2024-12-10 17:19:09,90,2183,43,47,1415.01,2461.01,0.00
2024-12-10 17:19:09,90,2184,43,47,1417.97,2462.00,0.00
2024-12-10 17:19:09,91,2184,44,47,1402.39,2462.01,0.00
2024-12-10 17:19:09,91,2185,44,47,1400.10,2463.00,0.00
2024-12-10 17:19:09,92,2185,44,48,1384.89,2463.01,0.00
2024-12-10 17:19:09,91,2185,43,48,1394.41,2463.06,0.00
2024-12-10 17:19:09,91,2186,43,48,1393.49,2464.00,0.00
2024-12-10 17:19:09,92,2186,43,49,1378.34,2464.01,0.00
2024-12-10 17:19:09,91,2186,43,48,1385.59,2464.06,0.00
2024-12-10 17:19:09,91,2187,43,48,1382.73,2465.00,0.00
2024-12-10 17:19:09,92,2187,43,49,1367.70,2465.01,0.00
2024-12-10 17:19:09,91,2187,42,49,1373.59,2465.04,0.00
2024-12-10 17:19:09,90,2187,42,48,1364.01,2465.80,0.00
2024-12-10 17:19:09,90,2188,42,48,1386.65,2466.00,0.00
2024-12-10 17:19:09,91,2188,43,48,1371.41,2466.01,0.00
2024-12-10 17:19:09,91,2189,43,48,1374.68,2467.00,0.00
2024-12-10 17:19:09,92,2189,44,48,1359.74,2467.01,0.00
2024-12-10 17:19:09,92,2190,44,48,1362.70,2468.00,0.00
2024-12-10 17:19:09,93,2190,45,48,1348.05,2468.01,0.00
2024-12-10 17:19:09,92,2190,45,47,1361.64,2468.04,0.00
2024-12-10 17:19:09,92,2191,45,47,1365.40,2469.00,0.00
2024-12-10 17:19:09,93,2191,46,47,1350.72,2469.01,0.00
2024-12-10 17:19:09,92,2191,45,47,1365.13,2469.01,0.00
2024-12-10 17:19:09,92,2192,45,47,1368.10,2470.00,0.00
2024-12-10 17:19:09,93,2192,46,47,1353.39,2470.01,0.00
2024-12-10 17:19:09,93,2193,46,47,1356.07,2471.00,0.00
2024-12-10 17:19:09,94,2193,47,47,1341.64,2471.01,0.00
2024-12-10 17:19:09,93,2193,47,46,1355.02,2471.04,0.00
2024-12-10 17:19:09,93,2194,47,46,1358.48,2472.00,0.00
2024-12-10 17:19:09,94,2194,47,47,1344.02,2472.01,0.00
2024-12-10 17:19:09,93,2194,46,47,1357.42,2472.04,0.00
2024-12-10 17:19:10,93,2195,46,47,1360.89,2473.00,0.00
2024-12-10 17:19:10,94,2195,47,47,1346.41,2473.01,0.00
2024-12-10 17:19:10,93,2195,47,46,1358.75,2473.10,0.00
2024-12-10 17:19:10,93,2196,47,46,1363.54,2474.00,0.00
2024-12-10 17:19:10,94,2196,47,47,1349.04,2474.01,0.00
2024-12-10 17:19:10,94,2197,47,47,1351.42,2475.00,0.00
2024-12-10 17:19:10,95,2197,48,47,1337.20,2475.01,0.00
2024-12-10 17:19:10,95,2198,48,47,1339.30,2476.00,0.00
2024-12-10 17:19:10,96,2198,49,47,1325.35,2476.01,0.00
2024-12-10 17:19:10,96,2199,49,47,1327.18,2477.00,0.00
2024-12-10 17:19:10,97,2199,50,47,1313.49,2477.01,0.00
2024-12-10 17:19:10,97,2200,50,47,1315.05,2478.00,0.00
2024-12-10 17:19:10,98,2200,50,48,1301.63,2478.01,0.00
2024-12-10 17:19:10,97,2200,50,47,1314.54,2478.02,0.00
2024-12-10 17:19:10,96,2200,49,47,1327.72,2478.03,0.00
2024-12-10 17:19:10,97,2199,50,47,1311.74,2478.14,0.00
2024-12-10 17:19:10,97,2200,50,47,1325.80,2479.00,0.00
2024-12-10 17:19:10,98,2200,50,48,1312.27,2479.01,0.00
2024-12-10 17:19:10,97,2200,49,48,1325.04,2479.03,0.00
2024-12-10 17:19:10,97,2201,49,48,1352.67,2480.00,0.00
2024-12-10 17:19:10,98,2201,49,49,1338.87,2480.01,0.00
2024-12-10 17:19:10,98,2202,49,49,1340.16,2481.00,0.00
2024-12-10 17:19:10,99,2202,49,50,1326.63,2481.01,0.00
2024-12-10 17:19:10,98,2202,48,50,1339.41,2481.03,0.00
2024-12-10 17:19:10,98,2203,48,50,1340.70,2482.00,0.00
2024-12-10 17:19:10,99,2203,48,51,1327.16,2482.01,0.00
2024-12-10 17:19:10,99,2204,48,51,1326.36,2483.00,0.00
2024-12-10 17:19:10,100,2204,49,51,1313.10,2483.01,0.00
2024-12-10 17:19:10,99,2204,49,50,1325.62,2483.03,0.00
2024-12-10 17:19:10,99,2205,49,50,1323.96,2484.00,0.00
2024-12-10 17:19:10,100,2205,50,50,1310.72,2484.01,0.00
2024-12-10 17:19:10,99,2205,49,50,1317.74,2484.22,0.00
2024-12-10 17:19:10,100,2204,50,50,1304.56,2484.24,0.00
2024-12-10 17:19:10,100,2205,50,50,1329.15,2485.00,0.00
2024-12-10 17:19:10,101,2205,50,51,1315.99,2485.01,0.00
2024-12-10 17:19:10,101,2206,50,51,1341.13,2486.00,0.00
2024-12-10 17:19:10,102,2206,50,52,1327.98,2486.01,0.00
2024-12-10 17:19:10,102,2207,50,52,1327.92,2487.00,0.00
2024-12-10 17:19:10,103,2207,50,53,1315.03,2487.01,0.00
2024-12-10 17:19:10,102,2207,49,53,1327.19,2487.03,0.00
2024-12-10 17:19:10,102,2208,49,53,1327.73,2488.00,0.00
2024-12-10 17:19:10,103,2208,50,53,1314.84,2488.01,0.00
2024-12-10 17:19:10,102,2208,50,52,1326.84,2488.04,0.00
2024-12-10 17:19:10,102,2209,50,52,1326.71,2489.00,0.00
2024-12-10 17:19:10,103,2209,50,53,1313.83,2489.01,0.00
2024-12-10 17:19:10,102,2209,49,53,1322.01,2489.12,0.00
2024-12-10 17:19:10,102,2210,49,53,1324.96,2490.00,0.00
2024-12-10 17:19:10,103,2210,50,53,1312.10,2490.01,0.00
2024-12-10 17:19:10,102,2210,50,52,1324.23,2490.03,0.00
2024-12-10 17:19:10,102,2211,50,52,1325.00,2491.00,0.00
2024-12-10 17:19:10,103,2211,51,52,1312.14,2491.01,0.00
2024-12-10 17:19:10,103,2212,51,52,1312.18,2492.00,0.00
2024-12-10 17:19:10,104,2212,52,52,1299.56,2492.01,0.00
2024-12-10 17:19:10,104,2213,52,52,1299.37,2493.00,0.00
2024-12-10 17:19:10,105,2213,52,53,1286.99,2493.01,0.00
2024-12-10 17:19:10,106,2212,52,54,1274.62,2493.04,0.00
2024-12-10 17:19:10,106,2213,52,54,1286.89,2494.00,0.00
2024-12-10 17:19:10,107,2213,52,55,1274.86,2494.01,0.00
2024-12-10 17:19:10,106,2213,52,54,1286.20,2494.03,0.00
2024-12-10 17:19:10,106,2214,52,54,1309.53,2495.00,0.00
2024-12-10 17:19:10,107,2214,53,54,1297.29,2495.01,0.00
2024-12-10 17:19:10,106,2214,53,53,1308.84,2495.03,0.00
2024-12-10 17:19:10,106,2215,53,53,1308.64,2496.00,0.00
2024-12-10 17:19:10,107,2215,53,54,1296.41,2496.01,0.00
2024-12-10 17:19:10,106,2215,53,53,1307.95,2496.03,0.00
2024-12-10 17:19:10,106,2216,53,53,1307.76,2497.00,0.00
2024-12-10 17:19:10,107,2216,53,54,1295.53,2497.01,0.00
2024-12-10 17:19:10,107,2217,53,54,1294.65,2498.00,0.00
2024-12-10 17:19:10,108,2217,53,55,1282.66,2498.01,0.00
2024-12-10 17:19:10,107,2217,53,54,1293.73,2498.04,0.00
2024-12-10 17:19:10,107,2218,53,54,1293.36,2499.00,0.00
2024-12-10 17:19:10,108,2218,54,54,1281.38,2499.01,0.00
2024-12-10 17:19:10,107,2218,53,54,1292.44,2499.04,0.00
2024-12-10 17:19:10,108,2217,53,55,1278.17,2499.15,0.00
2024-12-10 17:19:10,108,2218,53,55,1300.36,2500.00,0.00
2024-12-10 17:19:10,109,2218,54,55,1288.43,2500.01,0.00
2024-12-10 17:19:10,108,2218,54,54,1299.45,2500.04,0.00
2024-12-10 17:19:10,108,2219,54,54,1321.85,2501.00,0.00
2024-12-10 17:19:10,109,2219,54,55,1309.72,2501.01,0.00
2024-12-10 17:19:10,108,2219,53,55,1320.94,2501.04,0.00
2024-12-10 17:19:10,108,2220,53,55,1320.22,2502.00,0.00
2024-12-10 17:19:10,109,2220,53,56,1308.11,2502.01,0.00
2024-12-10 17:19:10,109,2221,53,56,1306.49,2503.00,0.00
2024-12-10 17:19:10,110,2221,53,57,1294.61,2503.01,0.00
2024-12-10 17:19:10,109,2221,52,57,1306.26,2503.01,0.00
2024-12-10 17:19:10,108,2221,52,56,1317.68,2503.03,0.00
2024-12-10 17:19:10,107,2221,52,55,1329.76,2503.03,0.00
2024-12-10 17:19:11,107,2222,52,55,1328.56,2504.00,0.00
2024-12-10 17:19:11,108,2222,53,55,1316.26,2504.01,0.00
2024-12-10 17:19:11,107,2222,52,55,1327.88,2504.03,0.00
2024-12-10 17:19:11,106,2222,52,54,1338.28,2504.09,0.00
2024-12-10 17:19:11,106,2223,52,54,1339.62,2505.00,0.00
2024-12-10 17:19:11,107,2223,53,54,1327.10,2505.01,0.00
2024-12-10 17:19:11,106,2223,53,53,1338.93,2505.03,0.00
2024-12-10 17:19:11,106,2224,53,53,1338.22,2506.00,0.00
2024-12-10 17:19:11,107,2224,53,54,1325.71,2506.01,0.00
2024-12-10 17:19:11,106,2224,52,54,1337.53,2506.03,0.00
2024-12-10 17:19:11,106,2225,52,54,1336.32,2507.00,0.00
2024-12-10 17:19:11,107,2225,53,54,1323.83,2507.01,0.00
2024-12-10 17:19:11,106,2225,53,53,1335.63,2507.03,0.00
2024-12-10 17:19:11,106,2226,53,53,1333.21,2508.00,0.00
2024-12-10 17:19:11,107,2226,53,54,1320.75,2508.01,0.00
2024-12-10 17:19:11,106,2226,52,54,1332.51,2508.03,0.00
2024-12-10 17:19:11,106,2227,52,54,1328.58,2509.00,0.00
2024-12-10 17:19:11,107,2227,53,54,1316.17,2509.01,0.00
2024-12-10 17:19:11,106,2227,53,53,1319.23,2509.35,0.00
2024-12-10 17:19:11,106,2228,53,53,1327.00,2510.00,0.00
2024-12-10 17:19:11,107,2228,53,54,1314.60,2510.01,0.00
2024-12-10 17:19:11,107,2229,53,54,1313.72,2511.00,0.00
2024-12-10 17:19:11,108,2229,53,55,1301.55,2511.01,0.00
2024-12-10 17:19:11,109,2228,53,56,1279.81,2511.42,0.00
2024-12-10 17:19:11,109,2229,53,56,1302.91,2512.00,0.00
2024-12-10 17:19:11,110,2229,53,57,1291.06,2512.01,0.00
2024-12-10 17:19:11,109,2229,52,57,1301.78,2512.05,0.00
2024-12-10 17:19:11,109,2230,52,57,1324.06,2513.00,0.00
2024-12-10 17:19:11,110,2230,52,58,1312.03,2513.01,0.00
2024-12-10 17:19:11,110,2231,52,58,1309.48,2514.00,0.00
2024-12-10 17:19:11,111,2231,52,59,1297.68,2514.01,0.00
2024-12-10 17:19:11,110,2231,52,58,1308.36,2514.05,0.00
2024-12-10 17:19:11,110,2232,52,58,1305.71,2515.00,0.00
2024-12-10 17:19:11,111,2232,52,59,1293.94,2515.01,0.00
2024-12-10 17:19:11,110,2232,51,59,1304.59,2515.05,0.00
2024-12-10 17:19:11,111,2231,51,60,1288.33,2515.24,0.00
2024-12-10 17:19:11,111,2232,51,60,1305.70,2516.00,0.00
2024-12-10 17:19:11,112,2232,52,60,1294.04,2516.01,0.00
2024-12-10 17:19:11,111,2232,51,60,1304.59,2516.05,0.00
2024-12-10 17:19:11,110,2232,50,60,1304.09,2516.40,0.00
2024-12-10 17:19:11,110,2233,50,60,1333.53,2517.00,0.00
2024-12-10 17:19:11,111,2233,50,61,1321.52,2517.01,0.00
2024-12-10 17:19:11,110,2233,50,60,1332.41,2517.05,0.00
2024-12-10 17:19:11,110,2234,50,60,1330.25,2518.00,0.00
2024-12-10 17:19:11,111,2234,51,60,1318.26,2518.01,0.00
2024-12-10 17:19:11,110,2234,51,59,1329.13,2518.05,0.00
2024-12-10 17:19:11,110,2235,51,59,1324.81,2519.00,0.00
2024-12-10 17:19:11,111,2235,52,59,1312.88,2519.01,0.00
2024-12-10 17:19:11,110,2235,51,59,1323.69,2519.05,0.00
2024-12-10 17:19:11,110,2236,51,59,1319.06,2520.00,0.00
2024-12-10 17:19:11,111,2236,51,60,1307.17,2520.01,0.00
2024-12-10 17:19:11,110,2236,50,60,1317.94,2520.05,0.00
2024-12-10 17:19:11,111,2235,50,61,1288.64,2520.77,0.00
2024-12-10 17:19:11,111,2236,50,61,1307.20,2521.00,0.00
2024-12-10 17:19:11,112,2236,51,61,1295.53,2521.01,0.00
2024-12-10 17:19:11,111,2236,50,61,1306.09,2521.05,0.00
2024-12-10 17:19:11,111,2237,50,61,1325.38,2522.00,0.00
2024-12-10 17:19:11,112,2237,51,61,1313.55,2522.01,0.00
2024-12-10 17:19:11,111,2237,51,60,1324.27,2522.05,0.00
2024-12-10 17:19:11,110,2237,51,59,1314.05,2522.89,0.00
2024-12-10 17:19:11,110,2238,51,59,1334.33,2523.00,0.00
2024-12-10 17:19:11,111,2238,51,60,1322.31,2523.01,0.00
2024-12-10 17:19:11,110,2238,50,60,1333.21,2523.05,0.00
2024-12-10 17:19:11,110,2239,50,60,1332.57,2524.00,0.00
2024-12-10 17:19:11,111,2239,51,60,1320.56,2524.01,0.00
2024-12-10 17:19:11,110,2239,51,59,1331.44,2524.05,0.00
2024-12-10 17:19:11,110,2240,51,59,1330.80,2525.00,0.00
2024-12-10 17:19:11,111,2240,51,60,1318.81,2525.01,0.00
2024-12-10 17:19:11,110,2240,51,59,1329.68,2525.05,0.00
2024-12-10 17:19:11,110,2241,51,59,1328.68,2526.00,0.00
2024-12-10 17:19:11,111,2241,52,59,1316.71,2526.01,0.00
2024-12-10 17:19:11,110,2241,51,59,1327.55,2526.05,0.00
2024-12-10 17:19:11,109,2241,51,58,1339.62,2526.05,0.00
2024-12-10 17:19:11,109,2242,51,58,1339.20,2527.00,0.00
2024-12-10 17:19:11,110,2242,52,58,1327.03,2527.01,0.00
2024-12-10 17:19:11,110,2243,52,58,1325.49,2528.00,0.00
2024-12-10 17:19:11,111,2243,52,59,1313.54,2528.01,0.00
2024-12-10 17:19:11,110,2243,52,58,1324.36,2528.05,0.00
2024-12-10 17:19:11,110,2244,52,58,1323.71,2529.00,0.00
2024-12-10 17:19:11,111,2244,53,58,1311.79,2529.01,0.00
2024-12-10 17:19:11,110,2244,53,57,1322.58,2529.05,0.00
2024-12-10 17:19:11,110,2245,53,57,1321.94,2530.00,0.00
2024-12-10 17:19:11,111,2245,54,57,1310.03,2530.01,0.00
2024-12-10 17:19:11,110,2245,53,57,1320.81,2530.05,0.00
2024-12-10 17:19:11,110,2246,53,57,1320.09,2531.00,0.00
2024-12-10 17:19:11,111,2246,53,58,1308.19,2531.01,0.00
2024-12-10 17:19:11,110,2246,53,57,1319.03,2531.05,0.00
2024-12-10 17:19:11,110,2247,53,57,1318.38,2532.00,0.00
2024-12-10 17:19:11,111,2247,53,58,1306.50,2532.01,0.00
2024-12-10 17:19:11,110,2247,52,58,1317.25,2532.05,0.00
2024-12-10 17:19:11,111,2246,53,58,1301.75,2532.21,0.00
2024-12-10 17:19:12,111,2247,53,58,1323.90,2533.00,0.00
2024-12-10 17:19:12,112,2247,53,59,1312.08,2533.01,0.00
2024-12-10 17:19:12,111,2247,53,58,1322.78,2533.05,0.00
2024-12-10 17:19:12,110,2247,52,58,1334.68,2533.05,0.00
2024-12-10 17:19:12,110,2248,52,58,1357.07,2534.00,0.00
2024-12-10 17:19:12,111,2248,52,59,1344.85,2534.01,0.00
2024-12-10 17:19:12,111,2249,52,59,1343.09,2535.00,0.00
2024-12-10 17:19:12,112,2249,52,60,1331.10,2535.01,0.00
2024-12-10 17:19:12,111,2249,51,60,1341.97,2535.05,0.00
2024-12-10 17:19:12,111,2250,51,60,1341.11,2536.00,0.00
2024-12-10 17:19:12,112,2250,52,60,1329.14,2536.01,0.00
2024-12-10 17:19:12,113,2249,52,61,1316.93,2536.04,0.00
2024-12-10 17:19:12,113,2250,52,61,1327.10,2537.00,0.00
2024-12-10 17:19:12,114,2250,52,62,1315.46,2537.01,0.00
2024-12-10 17:19:12,113,2250,52,61,1325.78,2537.05,0.00
2024-12-10 17:19:12,113,2251,52,61,1347.16,2538.00,0.00
2024-12-10 17:19:12,114,2251,52,62,1335.34,2538.01,0.00
2024-12-10 17:19:12,113,2251,52,61,1345.84,2538.05,0.00
2024-12-10 17:19:12,113,2252,52,61,1344.77,2539.00,0.00
2024-12-10 17:19:12,114,2252,52,62,1332.97,2539.01,0.00
2024-12-10 17:19:12,113,2252,52,61,1343.45,2539.05,0.00
2024-12-10 17:19:12,113,2253,52,61,1342.38,2540.00,0.00
2024-12-10 17:19:12,114,2253,52,62,1330.60,2540.01,0.00
2024-12-10 17:19:12,113,2253,51,62,1341.06,2540.05,0.00
2024-12-10 17:19:12,112,2253,50,62,1352.81,2540.05,0.00
2024-12-10 17:19:12,112,2254,50,62,1351.95,2541.00,0.00
2024-12-10 17:19:12,113,2254,51,62,1339.98,2541.01,0.00
2024-12-10 17:19:12,112,2254,51,61,1350.61,2541.05,0.00
2024-12-10 17:19:12,111,2254,51,60,1362.55,2541.05,0.00
2024-12-10 17:19:12,111,2255,51,60,1361.49,2542.00,0.00
2024-12-10 17:19:12,112,2255,52,60,1349.34,2542.01,0.00
2024-12-10 17:19:12,111,2255,51,60,1360.15,2542.05,0.00
2024-12-10 17:19:12,111,2256,51,60,1357.34,2543.00,0.00
2024-12-10 17:19:12,112,2256,52,60,1345.22,2543.01,0.00
2024-12-10 17:19:12,111,2256,51,60,1348.00,2543.25,0.00
2024-12-10 17:19:12,111,2257,51,60,1351.90,2544.00,0.00
2024-12-10 17:19:12,112,2257,52,60,1339.83,2544.01,0.00
2024-12-10 17:19:12,111,2257,52,59,1350.56,2544.05,0.00
2024-12-10 17:19:12,111,2258,52,59,1346.62,2545.00,0.00
2024-12-10 17:19:12,112,2258,53,59,1334.60,2545.01,0.00
2024-12-10 17:19:12,111,2258,52,59,1345.27,2545.05,0.00
2024-12-10 17:19:12,110,2258,51,59,1343.91,2545.38,0.00
2024-12-10 17:19:12,110,2259,51,59,1351.74,2546.00,0.00
2024-12-10 17:19:12,111,2259,51,60,1339.57,2546.01,0.00
2024-12-10 17:19:12,110,2259,50,60,1350.38,2546.05,0.00
2024-12-10 17:19:12,110,2260,50,60,1348.75,2547.00,0.00
2024-12-10 17:19:12,111,2260,50,61,1336.60,2547.01,0.00
2024-12-10 17:19:12,110,2260,49,61,1347.38,2547.05,0.00
2024-12-10 17:19:12,110,2261,49,61,1343.47,2548.00,0.00
2024-12-10 17:19:12,111,2261,50,61,1331.36,2548.01,0.00
2024-12-10 17:19:12,110,2261,50,60,1338.60,2548.19,0.00
2024-12-10 17:19:12,110,2262,50,60,1340.64,2549.00,0.00
2024-12-10 17:19:12,111,2262,50,61,1328.56,2549.01,0.00
2024-12-10 17:19:12,110,2262,50,60,1339.05,2549.06,0.00
2024-12-10 17:19:12,110,2263,50,60,1338.00,2550.00,0.00
2024-12-10 17:19:12,111,2263,50,61,1325.95,2550.01,0.00
2024-12-10 17:19:12,110,2263,49,61,1336.41,2550.06,0.00
2024-12-10 17:19:12,110,2264,49,61,1334.87,2551.00,0.00
2024-12-10 17:19:12,111,2264,50,61,1322.85,2551.01,0.00
2024-12-10 17:19:12,111,2265,50,61,1318.84,2552.00,0.00
2024-12-10 17:19:12,112,2265,50,62,1307.06,2552.01,0.00
2024-12-10 17:19:12,111,2265,50,61,1317.04,2552.07,0.00
2024-12-10 17:19:12,111,2266,50,61,1313.93,2553.00,0.00
2024-12-10 17:19:12,112,2266,50,62,1302.20,2553.01,0.00
2024-12-10 17:19:12,111,2266,49,62,1312.13,2553.07,0.00
2024-12-10 17:19:12,110,2266,49,61,1315.40,2553.34,0.00
2024-12-10 17:19:12,110,2267,49,61,1322.10,2554.00,0.00
2024-12-10 17:19:12,111,2267,50,61,1310.19,2554.01,0.00
2024-12-10 17:19:12,112,2266,50,62,1296.05,2554.08,0.00
2024-12-10 17:19:12,111,2266,50,61,1317.17,2554.08,0.00
2024-12-10 17:19:12,112,2265,51,61,1298.88,2554.35,0.00
2024-12-10 17:19:12,112,2266,51,61,1320.75,2555.00,0.00
2024-12-10 17:19:12,113,2266,52,61,1309.06,2555.01,0.00
2024-12-10 17:19:12,113,2267,52,61,1349.42,2556.00,0.00
2024-12-10 17:19:12,114,2267,52,62,1337.58,2556.01,0.00
2024-12-10 17:19:12,113,2267,51,62,1344.62,2556.07,0.00
2024-12-10 17:19:12,113,2268,51,62,1342.93,2557.00,0.00
2024-12-10 17:19:12,114,2268,52,62,1331.15,2557.01,0.00
2024-12-10 17:19:12,113,2268,52,61,1337.65,2557.07,0.00
2024-12-10 17:19:12,112,2268,52,60,1343.88,2557.28,0.00
2024-12-10 17:19:12,113,2267,53,60,1331.76,2557.30,0.00
2024-12-10 17:19:12,113,2268,53,60,1353.27,2558.00,0.00
2024-12-10 17:19:12,114,2268,54,60,1341.40,2558.01,0.00
2024-12-10 17:19:12,113,2268,54,59,1347.79,2558.07,0.00
2024-12-10 17:19:12,113,2269,54,59,1369.38,2559.00,0.00
2024-12-10 17:19:12,114,2269,54,60,1357.37,2559.01,0.00
2024-12-10 17:19:12,113,2269,53,60,1364.14,2559.07,0.00
2024-12-10 17:19:12,113,2270,53,60,1362.28,2560.00,0.00
2024-12-10 17:19:12,114,2270,53,61,1350.33,2560.01,0.00
2024-12-10 17:19:12,113,2270,52,61,1361.51,2560.03,0.00
2024-12-10 17:19:12,112,2270,52,60,1372.54,2560.06,0.00
2024-12-10 17:19:12,113,2269,52,61,1341.23,2560.75,0.00
2024-12-10 17:19:12,113,2270,52,61,1363.20,2561.00,0.00
2024-12-10 17:19:12,114,2270,53,61,1351.24,2561.01,0.00
2024-12-10 17:19:12,113,2270,53,60,1361.64,2561.06,0.00
2024-12-10 17:19:13,113,2271,53,60,1380.13,2562.00,0.00
2024-12-10 17:19:13,114,2271,54,60,1368.02,2562.01,0.00
2024-12-10 17:19:13,113,2271,53,60,1378.57,2562.06,0.00
2024-12-10 17:19:13,113,2272,53,60,1373.50,2563.00,0.00
2024-12-10 17:19:13,114,2272,53,61,1361.45,2563.01,0.00
2024-12-10 17:19:13,113,2272,53,60,1371.94,2563.06,0.00
2024-12-10 17:19:13,113,2273,53,60,1365.29,2564.00,0.00
2024-12-10 17:19:13,114,2273,54,60,1353.31,2564.01,0.00
2024-12-10 17:19:13,113,2273,53,60,1353.19,2564.22,0.00
2024-12-10 17:19:13,113,2274,53,60,1356.22,2565.00,0.00
2024-12-10 17:19:13,114,2274,53,61,1344.32,2565.01,0.00
2024-12-10 17:19:13,113,2274,53,60,1354.65,2565.06,0.00
2024-12-10 17:19:13,112,2274,52,60,1361.14,2565.21,0.00
2024-12-10 17:19:13,112,2275,52,60,1363.04,2566.00,0.00
2024-12-10 17:19:13,113,2275,53,60,1350.98,2566.01,0.00
2024-12-10 17:19:13,112,2275,52,60,1361.46,2566.06,0.00
2024-12-10 17:19:13,112,2276,52,60,1358.43,2567.00,0.00
2024-12-10 17:19:13,113,2276,52,61,1346.41,2567.01,0.00
2024-12-10 17:19:13,113,2277,52,61,1340.82,2568.00,0.00
2024-12-10 17:19:13,114,2277,52,62,1329.06,2568.01,0.00
2024-12-10 17:19:13,113,2277,51,62,1339.26,2568.06,0.00
2024-12-10 17:19:13,113,2278,51,62,1333.37,2569.00,0.00
2024-12-10 17:19:13,114,2278,52,62,1321.68,2569.01,0.00
2024-12-10 17:19:13,113,2278,51,62,1331.81,2569.06,0.00
2024-12-10 17:19:13,112,2278,50,62,1343.36,2569.06,0.00
2024-12-10 17:19:13,111,2278,50,61,1335.51,2569.68,0.00
2024-12-10 17:19:13,111,2279,50,61,1350.59,2570.00,0.00
2024-12-10 17:19:13,112,2279,51,61,1338.53,2570.01,0.00
2024-12-10 17:19:13,111,2279,51,60,1348.10,2570.09,0.00
2024-12-10 17:19:13,112,2278,52,60,1332.87,2570.23,0.00
2024-12-10 17:19:13,112,2279,52,60,1354.23,2571.00,0.00
2024-12-10 17:19:13,113,2279,53,60,1342.25,2571.01,0.00
2024-12-10 17:19:13,112,2279,52,60,1352.65,2571.06,0.00
2024-12-10 17:19:13,112,2280,52,60,1374.79,2572.00,0.00
2024-12-10 17:19:13,113,2280,52,61,1362.63,2572.01,0.00
2024-12-10 17:19:13,112,2280,52,60,1373.21,2572.06,0.00
2024-12-10 17:19:13,112,2281,52,60,1371.88,2573.00,0.00
2024-12-10 17:19:13,113,2281,53,60,1359.74,2573.01,0.00
2024-12-10 17:19:13,112,2281,52,60,1370.29,2573.06,0.00
2024-12-10 17:19:13,112,2282,52,60,1368.34,2574.00,0.00
2024-12-10 17:19:13,113,2282,53,60,1356.23,2574.01,0.00
2024-12-10 17:19:13,113,2283,53,60,1352.71,2575.00,0.00
2024-12-10 17:19:13,114,2283,53,61,1340.85,2575.01,0.00
2024-12-10 17:19:13,113,2283,52,61,1351.14,2575.06,0.00
2024-12-10 17:19:13,113,2284,52,61,1348.57,2576.00,0.00
2024-12-10 17:19:13,114,2284,53,61,1336.74,2576.01,0.00
2024-12-10 17:19:13,113,2284,52,61,1347.00,2576.06,0.00
2024-12-10 17:19:13,112,2284,52,60,1352.24,2576.29,0.00
2024-12-10 17:19:13,112,2285,52,60,1357.30,2577.00,0.00
2024-12-10 17:19:13,113,2285,53,60,1345.28,2577.01,0.00
2024-12-10 17:19:13,112,2285,52,60,1355.70,2577.06,0.00
2024-12-10 17:19:13,112,2286,52,60,1355.06,2578.00,0.00
2024-12-10 17:19:13,113,2286,53,60,1343.07,2578.01,0.00
2024-12-10 17:19:13,112,2286,52,60,1354.60,2578.02,0.00
2024-12-10 17:19:13,111,2286,52,59,1365.64,2578.05,0.00
2024-12-10 17:19:13,110,2286,51,59,1377.82,2578.05,0.00
2024-12-10 17:19:13,110,2287,51,59,1377.40,2579.00,0.00
2024-12-10 17:19:13,111,2287,51,60,1364.99,2579.01,0.00
2024-12-10 17:19:13,110,2287,51,59,1375.74,2579.05,0.00
2024-12-10 17:19:13,110,2288,51,59,1375.32,2580.00,0.00
2024-12-10 17:19:13,111,2288,52,59,1362.93,2580.01,0.00
2024-12-10 17:19:13,110,2288,52,58,1373.63,2580.05,0.00
2024-12-10 17:19:13,110,2289,52,58,1373.21,2581.00,0.00
2024-12-10 17:19:13,111,2289,53,58,1360.84,2581.01,0.00
2024-12-10 17:19:13,110,2289,53,57,1371.46,2581.05,0.00
2024-12-10 17:19:13,110,2290,53,57,1371.04,2582.00,0.00
2024-12-10 17:19:13,111,2290,54,57,1358.68,2582.01,0.00
2024-12-10 17:19:13,111,2291,54,57,1356.36,2583.00,0.00
2024-12-10 17:19:13,112,2291,54,58,1344.25,2583.01,0.00
2024-12-10 17:19:13,112,2292,54,58,1341.43,2584.00,0.00
2024-12-10 17:19:13,113,2292,55,58,1329.56,2584.01,0.00
2024-12-10 17:19:13,113,2293,55,58,1326.28,2585.00,0.00
2024-12-10 17:19:13,114,2293,55,59,1314.65,2585.01,0.00
2024-12-10 17:19:13,113,2293,55,58,1325.90,2585.02,0.00
2024-12-10 17:19:13,113,2294,55,58,1323.89,2586.00,0.00
2024-12-10 17:19:13,114,2294,55,59,1312.28,2586.01,0.00
2024-12-10 17:19:13,114,2295,55,59,1309.84,2587.00,0.00
2024-12-10 17:19:13,115,2295,56,59,1298.45,2587.01,0.00
2024-12-10 17:19:13,114,2295,56,58,1308.50,2587.05,0.00
2024-12-10 17:19:13,114,2296,56,58,1307.17,2588.00,0.00
2024-12-10 17:19:13,115,2296,56,59,1295.80,2588.01,0.00
2024-12-10 17:19:13,114,2296,55,59,1305.82,2588.05,0.00
2024-12-10 17:19:13,114,2297,55,59,1304.49,2589.00,0.00
2024-12-10 17:19:13,115,2297,55,60,1293.15,2589.01,0.00
2024-12-10 17:19:13,114,2297,55,59,1303.15,2589.05,0.00
2024-12-10 17:19:13,114,2298,55,59,1301.82,2590.00,0.00
2024-12-10 17:19:13,115,2298,55,60,1290.50,2590.01,0.00
2024-12-10 17:19:13,114,2298,54,60,1300.47,2590.05,0.00
2024-12-10 17:19:13,114,2299,54,60,1299.14,2591.00,0.00
2024-12-10 17:19:14,115,2299,54,61,1287.84,2591.01,0.00
2024-12-10 17:19:14,114,2299,53,61,1297.79,2591.05,0.00
2024-12-10 17:19:14,114,2300,53,61,1296.45,2592.00,0.00
2024-12-10 17:19:14,115,2300,53,62,1285.18,2592.01,0.00
2024-12-10 17:19:14,115,2301,53,62,1282.52,2593.00,0.00
2024-12-10 17:19:14,116,2301,53,63,1271.46,2593.01,0.00
2024-12-10 17:19:14,115,2301,53,62,1282.29,2593.01,0.00
2024-12-10 17:19:14,114,2301,53,61,1292.20,2593.05,0.00
2024-12-10 17:19:14,113,2301,53,60,1303.41,2593.05,0.00
2024-12-10 17:19:14,113,2302,53,60,1302.28,2594.00,0.00
2024-12-10 17:19:14,114,2302,53,61,1290.86,2594.01,0.00
2024-12-10 17:19:14,113,2302,53,60,1300.92,2594.05,0.00
2024-12-10 17:19:14,113,2303,53,60,1299.80,2595.00,0.00
2024-12-10 17:19:14,114,2303,53,61,1288.39,2595.01,0.00
2024-12-10 17:19:14,113,2303,52,61,1298.44,2595.05,0.00
2024-12-10 17:19:14,113,2304,52,61,1297.31,2596.00,0.00
2024-12-10 17:19:14,114,2304,52,62,1285.93,2596.01,0.00
2024-12-10 17:19:14,114,2305,52,62,1283.46,2597.00,0.00
2024-12-10 17:19:14,115,2305,52,63,1272.30,2597.01,0.00
2024-12-10 17:19:14,114,2305,52,62,1281.89,2597.06,0.00
2024-12-10 17:19:14,114,2306,52,62,1279.10,2598.00,0.00
2024-12-10 17:19:14,115,2306,53,62,1267.98,2598.01,0.00
2024-12-10 17:19:14,114,2306,53,61,1277.53,2598.06,0.00
2024-12-10 17:19:14,113,2306,53,60,1285.00,2598.16,0.00
2024-12-10 17:19:14,113,2307,53,60,1286.62,2599.00,0.00
2024-12-10 17:19:14,114,2307,53,61,1275.33,2599.01,0.00
2024-12-10 17:19:14,113,2307,52,61,1285.03,2599.06,0.00
2024-12-10 17:19:14,112,2307,52,60,1296.27,2599.06,0.00
2024-12-10 17:19:14,112,2308,52,60,1295.59,2600.00,0.00
2024-12-10 17:19:14,113,2308,53,60,1284.12,2600.01,0.00
2024-12-10 17:19:14,112,2308,52,60,1293.99,2600.06,0.00
2024-12-10 17:19:14,112,2309,52,60,1293.30,2601.00,0.00
2024-12-10 17:19:14,113,2309,52,61,1281.86,2601.01,0.00
2024-12-10 17:19:14,112,2309,52,60,1291.70,2601.06,0.00
2024-12-10 17:19:14,112,2310,52,60,1291.01,2602.00,0.00
2024-12-10 17:19:14,113,2310,53,60,1279.58,2602.01,0.00
2024-12-10 17:19:14,112,2310,53,59,1289.40,2602.06,0.00
2024-12-10 17:19:14,112,2311,53,59,1288.72,2603.00,0.00
2024-12-10 17:19:14,113,2311,54,59,1277.31,2603.01,0.00
2024-12-10 17:19:14,113,2312,54,59,1275.04,2604.00,0.00
2024-12-10 17:19:14,114,2312,55,59,1263.85,2604.01,0.00
2024-12-10 17:19:14,113,2312,54,59,1273.44,2604.06,0.00
2024-12-10 17:19:14,113,2313,54,59,1272.53,2605.00,0.00
2024-12-10 17:19:14,114,2313,55,59,1261.37,2605.01,0.00
2024-12-10 17:19:14,113,2313,54,59,1270.94,2605.06,0.00
2024-12-10 17:19:14,113,2314,54,59,1270.02,2606.00,0.00
2024-12-10 17:19:14,114,2314,55,59,1258.88,2606.01,0.00
2024-12-10 17:19:14,113,2314,55,58,1268.43,2606.06,0.00
2024-12-10 17:19:14,113,2315,55,58,1267.51,2607.00,0.00
2024-12-10 17:19:14,114,2315,56,58,1256.39,2607.01,0.00
2024-12-10 17:19:14,113,2315,55,58,1265.91,2607.06,0.00
2024-12-10 17:19:14,113,2316,55,58,1264.86,2608.00,0.00
2024-12-10 17:19:14,114,2316,55,59,1253.76,2608.01,0.00
2024-12-10 17:19:14,113,2316,55,58,1263.26,2608.06,0.00
2024-12-10 17:19:14,113,2317,55,58,1261.19,2609.00,0.00
2024-12-10 17:19:14,114,2317,55,59,1250.13,2609.01,0.00
2024-12-10 17:19:14,113,2317,54,59,1259.59,2609.06,0.00
2024-12-10 17:19:14,113,2318,54,59,1256.08,2610.00,0.00
2024-12-10 17:19:14,114,2318,54,60,1245.06,2610.01,0.00
2024-12-10 17:19:14,114,2319,54,60,1238.34,2611.00,0.00
2024-12-10 17:19:14,115,2319,55,60,1227.57,2611.01,0.00
2024-12-10 17:19:14,114,2319,55,59,1236.75,2611.06,0.00
2024-12-10 17:19:14,113,2319,54,59,1232.29,2611.51,0.00
2024-12-10 17:19:14,113,2320,54,59,1243.04,2612.00,0.00
2024-12-10 17:19:14,114,2320,54,60,1232.13,2612.01,0.00
2024-12-10 17:19:14,113,2320,54,59,1241.43,2612.06,0.00
2024-12-10 17:19:14,112,2320,54,58,1249.35,2612.14,0.00
2024-12-10 17:19:14,112,2321,54,58,1250.74,2613.00,0.00
2024-12-10 17:19:14,113,2321,55,58,1239.67,2613.01,0.00
2024-12-10 17:19:14,112,2321,55,57,1249.12,2613.06,0.00
2024-12-10 17:19:14,112,2322,55,57,1248.42,2614.00,0.00
2024-12-10 17:19:14,113,2322,56,57,1237.37,2614.01,0.00
2024-12-10 17:19:14,112,2322,56,56,1246.02,2614.06,0.00
2024-12-10 17:19:14,112,2323,56,56,1245.32,2615.00,0.00
2024-12-10 17:19:14,113,2323,56,57,1234.30,2615.01,0.00
2024-12-10 17:19:14,112,2323,55,57,1245.08,2615.01,0.00
2024-12-10 17:19:14,111,2323,55,56,1254.90,2615.05,0.00
2024-12-10 17:19:14,110,2323,55,55,1266.07,2615.05,0.00
2024-12-10 17:19:14,110,2324,55,55,1265.59,2616.00,0.00
2024-12-10 17:19:14,111,2324,56,55,1254.19,2616.01,0.00
2024-12-10 17:19:14,110,2324,55,55,1264.02,2616.05,0.00
2024-12-10 17:19:14,110,2325,55,55,1263.54,2617.00,0.00
2024-12-10 17:19:14,111,2325,56,55,1252.16,2617.01,0.00
2024-12-10 17:19:14,110,2325,56,54,1261.78,2617.05,0.00
2024-12-10 17:19:15,110,2326,56,54,1261.29,2618.00,0.00
2024-12-10 17:19:15,111,2326,57,54,1249.93,2618.01,0.00
2024-12-10 17:19:15,110,2326,56,54,1259.64,2618.05,0.00
2024-12-10 17:19:15,110,2327,56,54,1259.16,2619.00,0.00
2024-12-10 17:19:15,111,2327,57,54,1247.81,2619.01,0.00
2024-12-10 17:19:15,110,2327,56,54,1257.74,2619.05,0.00
2024-12-10 17:19:15,110,2328,56,54,1257.26,2620.00,0.00
2024-12-10 17:19:15,111,2328,56,55,1245.93,2620.01,0.00
2024-12-10 17:19:15,110,2328,56,54,1256.08,2620.05,0.00
2024-12-10 17:19:15,109,2328,56,53,1267.36,2620.05,0.00
2024-12-10 17:19:15,109,2329,56,53,1266.87,2621.00,0.00
2024-12-10 17:19:15,110,2329,56,54,1255.35,2621.01,0.00
2024-12-10 17:19:15,109,2329,55,54,1265.68,2621.05,0.00
2024-12-10 17:19:15,110,2328,55,55,1254.17,2621.06,0.00
2024-12-10 17:19:15,110,2329,55,55,1277.28,2622.00,0.00
2024-12-10 17:19:15,111,2329,55,56,1265.78,2622.01,0.00
2024-12-10 17:19:15,111,2330,55,56,1287.53,2623.00,0.00
2024-12-10 17:19:15,112,2330,56,56,1276.03,2623.01,0.00
2024-12-10 17:19:15,111,2330,56,55,1285.95,2623.05,0.00
2024-12-10 17:19:15,111,2331,56,55,1285.24,2624.00,0.00
2024-12-10 17:19:15,112,2331,57,55,1273.77,2624.01,0.00
2024-12-10 17:19:15,111,2331,56,55,1284.81,2624.01,0.00
2024-12-10 17:19:15,110,2331,55,55,1295.32,2624.05,0.00
2024-12-10 17:19:15,110,2332,55,55,1294.60,2625.00,0.00
2024-12-10 17:19:15,111,2332,56,55,1282.94,2625.01,0.00
2024-12-10 17:19:15,110,2332,56,54,1293.43,2625.05,0.00
2024-12-10 17:19:15,110,2333,56,54,1292.71,2626.00,0.00
2024-12-10 17:19:15,111,2333,56,55,1281.06,2626.01,0.00
2024-12-10 17:19:15,110,2333,55,55,1291.53,2626.05,0.00
2024-12-10 17:19:15,110,2334,55,55,1290.69,2627.00,0.00
2024-12-10 17:19:15,111,2334,56,55,1279.06,2627.01,0.00
2024-12-10 17:19:15,110,2334,55,55,1289.51,2627.05,0.00
2024-12-10 17:19:15,110,2335,55,55,1288.30,2628.00,0.00
2024-12-10 17:19:15,111,2335,56,55,1276.70,2628.01,0.00
2024-12-10 17:19:15,110,2335,56,54,1287.13,2628.05,0.00
2024-12-10 17:19:15,110,2336,56,54,1285.44,2629.00,0.00
2024-12-10 17:19:15,111,2336,57,54,1273.86,2629.01,0.00
2024-12-10 17:19:15,110,2336,56,54,1284.27,2629.05,0.00
2024-12-10 17:19:15,109,2336,56,53,1294.94,2629.06,0.00
2024-12-10 17:19:15,109,2337,56,53,1294.29,2630.00,0.00
2024-12-10 17:19:15,110,2337,57,53,1282.52,2630.01,0.00
2024-12-10 17:19:15,109,2337,56,53,1293.10,2630.05,0.00
2024-12-10 17:19:15,110,2336,57,53,1270.34,2630.46,0.00
2024-12-10 17:19:15,110,2337,57,53,1294.40,2631.00,0.00
2024-12-10 17:19:15,111,2337,58,53,1282.74,2631.01,0.00
2024-12-10 17:19:15,110,2337,58,52,1293.22,2631.05,0.00
2024-12-10 17:19:15,110,2338,58,52,1315.90,2632.00,0.00
2024-12-10 17:19:15,111,2338,58,53,1304.04,2632.01,0.00
2024-12-10 17:19:15,110,2338,57,53,1314.72,2632.05,0.00
2024-12-10 17:19:15,111,2337,58,53,1293.59,2632.40,0.00
2024-12-10 17:19:15,111,2338,58,53,1317.01,2633.00,0.00
2024-12-10 17:19:15,112,2338,59,53,1305.25,2633.01,0.00
2024-12-10 17:19:15,111,2338,59,52,1315.84,2633.05,0.00
2024-12-10 17:19:15,111,2339,59,52,1337.97,2634.00,0.00
2024-12-10 17:19:15,112,2339,59,53,1326.03,2634.01,0.00
2024-12-10 17:19:15,111,2339,59,52,1336.80,2634.05,0.00
2024-12-10 17:19:15,111,2340,59,52,1334.96,2635.00,0.00
2024-12-10 17:19:15,112,2340,60,52,1323.04,2635.01,0.00
2024-12-10 17:19:15,111,2340,60,51,1331.41,2635.07,0.00
2024-12-10 17:19:15,110,2340,60,50,1340.31,2635.17,0.00
2024-12-10 17:19:15,110,2341,60,50,1342.95,2636.00,0.00
2024-12-10 17:19:15,111,2341,60,51,1330.85,2636.01,0.00
2024-12-10 17:19:15,110,2341,59,51,1340.49,2636.05,0.00
2024-12-10 17:19:15,110,2342,59,51,1340.02,2637.00,0.00
2024-12-10 17:19:15,111,2342,59,52,1327.95,2637.01,0.00
2024-12-10 17:19:15,110,2342,59,51,1337.58,2637.05,0.00
2024-12-10 17:19:15,110,2343,59,51,1337.12,2638.00,0.00
2024-12-10 17:19:15,111,2343,60,51,1325.07,2638.01,0.00
2024-12-10 17:19:15,110,2343,60,50,1335.56,2638.05,0.00
2024-12-10 17:19:15,110,2344,60,50,1334.85,2639.00,0.00
2024-12-10 17:19:15,111,2344,61,50,1322.83,2639.01,0.00
2024-12-10 17:19:15,110,2344,61,49,1333.67,2639.05,0.00
2024-12-10 17:19:15,110,2345,61,49,1332.86,2640.00,0.00
2024-12-10 17:19:15,111,2345,61,50,1320.85,2640.01,0.00
2024-12-10 17:19:15,110,2345,61,49,1331.67,2640.05,0.00
2024-12-10 17:19:15,110,2346,61,49,1330.62,2641.00,0.00
2024-12-10 17:19:15,111,2346,62,49,1318.63,2641.01,0.00
2024-12-10 17:19:15,110,2346,61,49,1329.43,2641.05,0.00
2024-12-10 17:19:15,110,2347,61,49,1328.17,2642.00,0.00
2024-12-10 17:19:15,111,2347,61,50,1316.21,2642.01,0.00
2024-12-10 17:19:15,110,2347,60,50,1326.98,2642.05,0.00
2024-12-10 17:19:15,109,2347,60,49,1338.22,2642.07,0.00
2024-12-10 17:19:15,109,2348,60,49,1338.47,2643.00,0.00
2024-12-10 17:19:15,110,2348,60,50,1326.30,2643.01,0.00
2024-12-10 17:19:15,109,2348,59,50,1337.27,2643.05,0.00
2024-12-10 17:19:15,109,2349,59,50,1336.80,2644.00,0.00
2024-12-10 17:19:15,110,2349,60,50,1324.64,2644.01,0.00
2024-12-10 17:19:15,109,2349,59,50,1335.59,2644.05,0.00
2024-12-10 17:19:15,109,2350,59,50,1335.12,2645.00,0.00
2024-12-10 17:19:15,110,2350,59,51,1322.98,2645.01,0.00
2024-12-10 17:19:15,109,2350,58,51,1333.92,2645.05,0.00
2024-12-10 17:19:16,109,2351,58,51,1333.44,2646.00,0.00
2024-12-10 17:19:16,110,2351,58,52,1321.32,2646.01,0.00
2024-12-10 17:19:16,110,2352,58,52,1319.65,2647.00,0.00
2024-12-10 17:19:16,111,2352,59,52,1307.76,2647.01,0.00
2024-12-10 17:19:16,110,2352,59,51,1318.46,2647.05,0.00
2024-12-10 17:19:16,110,2353,59,51,1317.74,2648.00,0.00
2024-12-10 17:19:16,111,2353,60,51,1305.87,2648.01,0.00
2024-12-10 17:19:16,110,2353,59,51,1316.55,2648.05,0.00
2024-12-10 17:19:16,110,2354,59,51,1315.81,2649.00,0.00
2024-12-10 17:19:16,111,2354,60,51,1303.96,2649.01,0.00
2024-12-10 17:19:16,110,2354,60,50,1314.62,2649.05,0.00
2024-12-10 17:19:16,110,2355,60,50,1313.68,2650.00,0.00
2024-12-10 17:19:16,111,2355,61,50,1301.84,2650.01,0.00
2024-12-10 17:19:16,111,2356,61,50,1299.55,2651.00,0.00
2024-12-10 17:19:16,112,2356,61,51,1287.95,2651.01,0.00
2024-12-10 17:19:16,111,2356,60,51,1298.36,2651.05,0.00
2024-12-10 17:19:16,111,2357,60,51,1296.84,2652.00,0.00
2024-12-10 17:19:16,112,2357,61,51,1285.26,2652.01,0.00
2024-12-10 17:19:16,111,2357,61,50,1295.65,2652.05,0.00
2024-12-10 17:19:16,111,2358,61,50,1294.12,2653.00,0.00
2024-12-10 17:19:16,112,2358,62,50,1282.57,2653.01,0.00
2024-12-10 17:19:16,111,2358,62,49,1292.94,2653.05,0.00
2024-12-10 17:19:16,111,2359,62,49,1291.44,2654.00,0.00
2024-12-10 17:19:16,112,2359,62,50,1279.91,2654.01,0.00
2024-12-10 17:19:16,111,2359,62,49,1291.20,2654.01,0.00
2024-12-10 17:19:16,110,2359,62,48,1302.70,2654.01,0.00
2024-12-10 17:19:16,109,2359,61,48,1313.93,2654.03,0.00
2024-12-10 17:19:16,108,2359,61,47,1325.85,2654.03,0.00
2024-12-10 17:19:16,107,2359,60,47,1337.99,2654.03,0.00
2024-12-10 17:19:16,107,2360,60,47,1336.86,2655.00,0.00
2024-12-10 17:19:16,108,2360,61,47,1324.48,2655.01,0.00
2024-12-10 17:19:16,107,2360,60,47,1336.12,2655.03,0.00
2024-12-10 17:19:16,107,2361,60,47,1334.85,2656.00,0.00
2024-12-10 17:19:16,108,2361,60,48,1322.49,2656.01,0.00
2024-12-10 17:19:16,107,2361,60,47,1334.11,2656.03,0.00
2024-12-10 17:19:16,107,2362,60,47,1332.73,2657.00,0.00
2024-12-10 17:19:16,108,2362,61,47,1320.39,2657.01,0.00
2024-12-10 17:19:16,107,2362,60,47,1331.99,2657.03,0.00
2024-12-10 17:19:16,107,2363,60,47,1330.01,2658.00,0.00
2024-12-10 17:19:16,108,2363,60,48,1317.70,2658.01,0.00
2024-12-10 17:19:16,107,2363,59,48,1329.27,2658.03,0.00
2024-12-10 17:19:16,106,2363,58,48,1340.00,2658.07,0.00
2024-12-10 17:19:16,106,2364,58,48,1339.51,2659.00,0.00
2024-12-10 17:19:16,107,2364,58,49,1326.99,2659.01,0.00
2024-12-10 17:19:16,106,2364,58,48,1338.76,2659.03,0.00
2024-12-10 17:19:16,105,2364,57,48,1343.65,2659.30,0.00
2024-12-10 17:19:16,105,2365,57,48,1350.69,2660.00,0.00
2024-12-10 17:19:16,106,2365,57,49,1337.95,2660.01,0.00
2024-12-10 17:19:16,105,2365,57,48,1349.94,2660.03,0.00
2024-12-10 17:19:16,104,2365,57,47,1362.66,2660.03,0.00
2024-12-10 17:19:16,104,2366,57,47,1362.91,2661.00,0.00
2024-12-10 17:19:16,105,2366,57,48,1349.93,2661.01,0.00
2024-12-10 17:19:16,104,2366,56,48,1362.15,2661.03,0.00
2024-12-10 17:19:16,104,2367,56,48,1362.40,2662.00,0.00
2024-12-10 17:19:16,105,2367,57,48,1349.42,2662.01,0.00
2024-12-10 17:19:16,105,2368,57,48,1348.35,2663.00,0.00
2024-12-10 17:19:16,106,2368,57,49,1335.63,2663.01,0.00
2024-12-10 17:19:16,105,2368,57,48,1347.60,2663.03,0.00
2024-12-10 17:19:16,106,2367,58,48,1333.63,2663.09,0.00
2024-12-10 17:19:16,106,2368,58,48,1357.24,2664.00,0.00
2024-12-10 17:19:16,107,2368,59,48,1344.56,2664.01,0.00
2024-12-10 17:19:16,106,2368,58,48,1356.49,2664.03,0.00
2024-12-10 17:19:16,106,2369,58,48,1379.97,2665.00,0.00
2024-12-10 17:19:16,107,2369,58,49,1367.07,2665.01,0.00
2024-12-10 17:19:16,106,2369,58,48,1379.22,2665.03,0.00
2024-12-10 17:19:16,106,2370,58,48,1377.49,2666.00,0.00
2024-12-10 17:19:16,107,2370,59,48,1364.62,2666.01,0.00
2024-12-10 17:19:16,106,2370,58,48,1376.74,2666.03,0.00
2024-12-10 17:19:16,106,2371,58,48,1374.45,2667.00,0.00
2024-12-10 17:19:16,107,2371,58,49,1361.60,2667.01,0.00
2024-12-10 17:19:16,107,2372,58,49,1358.20,2668.00,0.00
2024-12-10 17:19:16,108,2372,59,49,1345.63,2668.01,0.00
2024-12-10 17:19:16,107,2372,59,48,1357.22,2668.04,0.00
2024-12-10 17:19:16,106,2372,59,47,1368.80,2668.08,0.00
2024-12-10 17:19:16,106,2373,59,47,1367.25,2669.00,0.00
2024-12-10 17:19:16,107,2373,60,47,1354.47,2669.01,0.00
2024-12-10 17:19:16,106,2373,59,47,1362.08,2669.18,0.00
2024-12-10 17:19:16,106,2374,59,47,1363.88,2670.00,0.00
2024-12-10 17:19:16,107,2374,59,48,1351.13,2670.01,0.00
2024-12-10 17:19:16,106,2374,58,48,1363.63,2670.01,0.00
2024-12-10 17:19:16,105,2374,57,48,1375.61,2670.04,0.00
2024-12-10 17:19:16,104,2374,56,48,1388.59,2670.04,0.00
2024-12-10 17:19:16,105,2373,57,48,1372.07,2670.18,0.00
2024-12-10 17:19:16,105,2374,57,48,1395.64,2671.00,0.00
2024-12-10 17:19:16,106,2374,57,49,1382.48,2671.01,0.00
2024-12-10 17:19:16,105,2374,57,48,1390.33,2671.21,0.00
2024-12-10 17:19:16,105,2375,57,48,1420.58,2672.00,0.00
2024-12-10 17:19:16,106,2375,57,49,1407.17,2672.01,0.00
2024-12-10 17:19:16,106,2376,57,49,1406.44,2673.00,0.00
2024-12-10 17:19:16,107,2376,58,49,1393.30,2673.01,0.00
2024-12-10 17:19:16,106,2376,57,49,1405.20,2673.05,0.00
2024-12-10 17:19:16,106,2377,57,49,1405.03,2674.00,0.00
2024-12-10 17:19:16,107,2377,58,49,1391.90,2674.01,0.00
2024-12-10 17:19:16,106,2377,57,49,1403.80,2674.05,0.00
2024-12-10 17:19:16,107,2376,58,49,1390.43,2674.08,0.00
2024-12-10 17:19:16,107,2377,58,49,1414.70,2675.00,0.00
2024-12-10 17:19:17,108,2377,58,50,1401.60,2675.01,0.00
2024-12-10 17:19:17,107,2377,58,49,1413.47,2675.05,0.00
2024-12-10 17:19:17,107,2378,58,49,1437.49,2676.00,0.00
2024-12-10 17:19:17,108,2378,58,50,1424.18,2676.01,0.00
2024-12-10 17:19:17,108,2379,58,50,1422.12,2677.00,0.00
2024-12-10 17:19:17,109,2379,59,50,1409.08,2677.01,0.00
2024-12-10 17:19:17,110,2378,59,51,1396.03,2677.04,0.00
2024-12-10 17:19:17,109,2378,58,51,1418.69,2677.06,0.00
2024-12-10 17:19:17,109,2379,58,51,1417.66,2678.00,0.00
2024-12-10 17:19:17,110,2379,59,51,1404.77,2678.01,0.00
2024-12-10 17:19:17,109,2379,58,51,1416.22,2678.06,0.00
2024-12-10 17:19:17,109,2380,58,51,1439.65,2679.00,0.00
2024-12-10 17:19:17,110,2380,58,52,1426.56,2679.01,0.00
2024-12-10 17:19:17,109,2380,58,51,1438.21,2679.06,0.00
2024-12-10 17:19:17,109,2381,58,51,1437.04,2680.00,0.00
2024-12-10 17:19:17,110,2381,58,52,1423.97,2680.01,0.00
2024-12-10 17:19:17,109,2381,57,52,1435.60,2680.06,0.00
2024-12-10 17:19:17,109,2382,57,52,1434.41,2681.00,0.00
2024-12-10 17:19:17,110,2382,57,53,1421.37,2681.01,0.00
2024-12-10 17:19:17,109,2382,56,53,1432.97,2681.06,0.00
2024-12-10 17:19:17,108,2382,55,53,1442.81,2681.18,0.00
2024-12-10 17:19:17,108,2383,55,53,1444.76,2682.00,0.00
2024-12-10 17:19:17,109,2383,55,54,1431.51,2682.01,0.00
2024-12-10 17:19:17,108,2383,54,54,1443.30,2682.06,0.00
2024-12-10 17:19:17,108,2384,54,54,1441.50,2683.00,0.00
2024-12-10 17:19:17,109,2384,55,54,1428.27,2683.01,0.00
2024-12-10 17:19:17,108,2384,55,53,1440.04,2683.06,0.00
2024-12-10 17:19:17,107,2384,54,53,1440.58,2683.50,0.00
2024-12-10 17:19:17,107,2385,54,53,1451.79,2684.00,0.00
2024-12-10 17:19:17,108,2385,55,53,1438.35,2684.01,0.00
2024-12-10 17:19:17,108,2386,55,53,1435.74,2685.00,0.00
2024-12-10 17:19:17,109,2386,55,54,1422.57,2685.01,0.00
2024-12-10 17:19:17,108,2386,55,53,1434.28,2685.06,0.00
2024-12-10 17:19:17,108,2387,55,53,1431.60,2686.00,0.00
2024-12-10 17:19:17,109,2387,56,53,1418.46,2686.01,0.00
2024-12-10 17:19:17,108,2387,55,53,1423.53,2686.20,0.00
2024-12-10 17:19:17,108,2388,55,53,1426.29,2687.00,0.00
2024-12-10 17:19:17,109,2388,55,54,1413.20,2687.01,0.00
2024-12-10 17:19:17,110,2387,55,55,1376.62,2687.87,0.00
2024-12-10 17:19:17,110,2388,55,55,1400.69,2688.00,0.00
2024-12-10 17:19:17,111,2388,55,56,1388.07,2688.01,0.00
2024-12-10 17:19:17,110,2388,55,55,1399.01,2688.06,0.00
2024-12-10 17:19:17,110,2389,55,55,1421.46,2689.00,0.00
2024-12-10 17:19:17,111,2389,55,56,1408.65,2689.01,0.00
2024-12-10 17:19:17,110,2389,55,55,1419.78,2689.06,0.00
2024-12-10 17:19:17,110,2390,55,55,1416.67,2690.00,0.00
2024-12-10 17:19:17,111,2390,55,56,1403.90,2690.01,0.00
2024-12-10 17:19:17,110,2390,55,55,1414.99,2690.06,0.00
2024-12-10 17:19:17,110,2391,55,55,1411.19,2691.00,0.00
2024-12-10 17:19:17,111,2391,55,56,1398.48,2691.01,0.00
2024-12-10 17:19:17,110,2391,55,55,1409.52,2691.06,0.00
2024-12-10 17:19:17,110,2392,55,55,1405.24,2692.00,0.00
2024-12-10 17:19:17,111,2392,56,55,1392.58,2692.01,0.00
2024-12-10 17:19:17,110,2392,56,54,1387.29,2692.64,0.00
2024-12-10 17:19:17,110,2393,56,54,1402.27,2693.00,0.00
2024-12-10 17:19:17,111,2393,57,54,1389.64,2693.01,0.00
2024-12-10 17:19:17,110,2393,57,53,1400.59,2693.06,0.00
2024-12-10 17:19:17,110,2394,57,53,1400.22,2694.00,0.00
2024-12-10 17:19:17,111,2394,58,53,1387.61,2694.01,0.00
2024-12-10 17:19:17,110,2394,58,52,1398.54,2694.06,0.00
2024-12-10 17:19:17,110,2395,58,52,1398.20,2695.00,0.00
2024-12-10 17:19:17,111,2395,59,52,1385.60,2695.01,0.00
2024-12-10 17:19:17,110,2395,59,51,1396.52,2695.06,0.00
2024-12-10 17:19:17,109,2395,59,50,1409.09,2695.06,0.00
2024-12-10 17:19:17,109,2396,59,50,1409.09,2696.00,0.00
2024-12-10 17:19:17,110,2396,60,50,1396.28,2696.01,0.00
2024-12-10 17:19:17,110,2397,60,50,1394.59,2697.00,0.00
2024-12-10 17:19:17,111,2397,61,50,1382.03,2697.01,0.00
2024-12-10 17:19:17,110,2397,61,49,1392.91,2697.06,0.00
2024-12-10 17:19:17,110,2398,61,49,1392.66,2698.00,0.00
2024-12-10 17:19:17,111,2398,61,50,1380.11,2698.01,0.00
2024-12-10 17:19:17,112,2397,62,50,1356.81,2698.44,0.00
2024-12-10 17:19:17,112,2398,62,50,1380.34,2699.00,0.00
2024-12-10 17:19:17,113,2398,62,51,1368.13,2699.01,0.00
2024-12-10 17:19:17,112,2398,62,50,1378.69,2699.06,0.00
2024-12-10 17:19:17,112,2399,62,50,1402.02,2700.00,0.00
2024-12-10 17:19:17,113,2399,62,51,1389.61,2700.01,0.00
2024-12-10 17:19:17,112,2399,61,51,1400.36,2700.06,0.00
2024-12-10 17:19:17,112,2400,61,51,1399.53,2701.00,0.00
2024-12-10 17:19:17,113,2400,61,52,1387.15,2701.01,0.00
2024-12-10 17:19:17,112,2400,61,51,1397.87,2701.06,0.00
2024-12-10 17:19:17,112,2401,61,51,1396.93,2702.00,0.00
2024-12-10 17:19:17,113,2401,61,52,1384.57,2702.01,0.00
2024-12-10 17:19:17,112,2401,60,52,1395.27,2702.06,0.00
2024-12-10 17:19:17,112,2402,60,52,1394.21,2703.00,0.00
2024-12-10 17:19:17,113,2402,61,52,1381.87,2703.01,0.00
2024-12-10 17:19:17,112,2402,60,52,1391.46,2703.06,0.00
2024-12-10 17:19:17,112,2403,60,52,1390.24,2704.00,0.00
2024-12-10 17:19:17,113,2403,60,53,1377.94,2704.01,0.00
2024-12-10 17:19:17,112,2403,59,53,1386.88,2704.06,0.00
2024-12-10 17:19:18,112,2404,59,53,1385.56,2705.00,0.00
2024-12-10 17:19:18,113,2404,60,53,1373.30,2705.01,0.00
2024-12-10 17:19:18,113,2405,60,53,1368.31,2706.00,0.00
2024-12-10 17:19:18,114,2405,60,54,1356.30,2706.01,0.00
2024-12-10 17:19:18,113,2405,59,54,1365.63,2706.04,0.00
2024-12-10 17:19:18,112,2405,58,54,1377.11,2706.05,0.00
2024-12-10 17:19:18,112,2406,58,54,1373.84,2707.00,0.00
2024-12-10 17:19:18,113,2406,59,54,1361.68,2707.01,0.00
2024-12-10 17:19:18,112,2406,58,54,1371.68,2707.05,0.00
2024-12-10 17:19:18,111,2406,57,54,1380.92,2707.13,0.00
2024-12-10 17:19:18,111,2407,57,54,1380.34,2708.00,0.00
2024-12-10 17:19:18,112,2407,58,54,1368.02,2708.01,0.00
2024-12-10 17:19:18,111,2407,58,53,1377.91,2708.05,0.00
2024-12-10 17:19:18,111,2408,58,53,1374.67,2709.00,0.00
2024-12-10 17:19:18,112,2408,58,54,1362.40,2709.01,0.00
2024-12-10 17:19:18,111,2408,58,53,1372.12,2709.05,0.00
2024-12-10 17:19:18,111,2409,58,53,1367.85,2710.00,0.00
2024-12-10 17:19:18,112,2409,58,54,1355.64,2710.01,0.00
2024-12-10 17:19:18,111,2409,58,53,1365.33,2710.05,0.00
2024-12-10 17:19:18,111,2410,58,53,1359.73,2711.00,0.00
2024-12-10 17:19:18,112,2410,58,54,1347.59,2711.01,0.00
2024-12-10 17:19:18,111,2410,57,54,1357.31,2711.05,0.00
2024-12-10 17:19:18,111,2411,57,54,1349.93,2712.00,0.00
2024-12-10 17:19:18,112,2411,57,55,1337.88,2712.01,0.00
2024-12-10 17:19:18,111,2411,57,54,1347.66,2712.05,0.00
2024-12-10 17:19:18,110,2411,56,54,1348.85,2712.35,0.00
2024-12-10 17:19:18,110,2412,56,54,1352.25,2713.00,0.00
2024-12-10 17:19:18,111,2412,57,54,1340.07,2713.01,0.00
2024-12-10 17:19:18,110,2412,56,54,1350.03,2713.05,0.00
2024-12-10 17:19:18,109,2412,56,53,1360.30,2713.11,0.00
2024-12-10 17:19:18,108,2412,56,52,1355.90,2713.66,0.00
2024-12-10 17:19:18,108,2413,56,52,1372.01,2714.00,0.00
2024-12-10 17:19:18,109,2413,56,53,1359.42,2714.01,0.00
2024-12-10 17:19:18,108,2413,55,53,1369.76,2714.06,0.00
2024-12-10 17:19:18,108,2414,55,53,1368.55,2715.00,0.00
2024-12-10 17:19:18,109,2414,56,53,1355.99,2715.01,0.00
2024-12-10 17:19:18,108,2414,56,52,1366.24,2715.06,0.00
2024-12-10 17:19:18,108,2415,56,52,1364.92,2716.00,0.00
2024-12-10 17:19:18,109,2415,57,52,1352.39,2716.01,0.00
2024-12-10 17:19:18,109,2416,57,52,1349.08,2717.00,0.00
2024-12-10 17:19:18,110,2416,58,52,1336.82,2717.01,0.00
2024-12-10 17:19:18,109,2416,57,52,1346.75,2717.06,0.00
2024-12-10 17:19:18,109,2417,57,52,1345.57,2718.00,0.00
2024-12-10 17:19:18,110,2417,57,53,1333.34,2718.01,0.00
2024-12-10 17:19:18,109,2417,56,53,1344.00,2718.03,0.00
2024-12-10 17:19:18,108,2417,55,53,1355.70,2718.05,0.00
2024-12-10 17:19:18,107,2417,54,53,1357.03,2718.46,0.00
2024-12-10 17:19:18,107,2418,54,53,1368.09,2719.00,0.00
2024-12-10 17:19:18,108,2418,55,53,1355.43,2719.01,0.00
2024-12-10 17:19:18,107,2418,54,53,1366.84,2719.05,0.00
2024-12-10 17:19:18,107,2419,54,53,1366.04,2720.00,0.00
2024-12-10 17:19:18,108,2419,55,53,1353.39,2720.01,0.00
2024-12-10 17:19:18,107,2419,55,52,1364.78,2720.05,0.00
2024-12-10 17:19:18,107,2420,55,52,1363.08,2721.00,0.00
2024-12-10 17:19:18,108,2420,56,52,1350.46,2721.01,0.00
2024-12-10 17:19:18,107,2420,55,52,1362.83,2721.01,0.00
2024-12-10 17:19:18,106,2420,55,51,1374.68,2721.04,0.00
2024-12-10 17:19:18,106,2421,55,51,1373.13,2722.00,0.00
2024-12-10 17:19:18,107,2421,55,52,1360.30,2722.01,0.00
2024-12-10 17:19:18,106,2421,55,51,1372.12,2722.04,0.00
2024-12-10 17:19:18,106,2422,55,51,1370.60,2723.00,0.00
2024-12-10 17:19:18,107,2422,55,52,1357.80,2723.01,0.00
2024-12-10 17:19:18,106,2422,54,52,1369.59,2723.04,0.00
2024-12-10 17:19:18,107,2421,54,53,1343.09,2723.52,0.00
2024-12-10 17:19:18,107,2422,54,53,1364.84,2724.00,0.00
2024-12-10 17:19:18,108,2422,55,53,1352.20,2724.01,0.00
2024-12-10 17:19:18,107,2422,54,53,1363.83,2724.04,0.00
2024-12-10 17:19:18,107,2423,54,53,1388.27,2725.00,0.00
2024-12-10 17:19:18,108,2423,54,54,1375.42,2725.01,0.00
2024-12-10 17:19:18,107,2423,53,54,1387.26,2725.04,0.00
2024-12-10 17:19:18,107,2424,53,54,1386.37,2726.00,0.00
2024-12-10 17:19:18,108,2424,53,55,1373.53,2726.01,0.00
2024-12-10 17:19:18,107,2424,53,54,1385.36,2726.04,0.00
2024-12-10 17:19:18,107,2425,53,54,1384.51,2727.00,0.00
2024-12-10 17:19:18,108,2425,53,55,1371.70,2727.01,0.00
2024-12-10 17:19:18,107,2425,52,55,1383.51,2727.04,0.00
2024-12-10 17:19:18,107,2426,52,55,1382.59,2728.00,0.00
2024-12-10 17:19:18,108,2426,53,55,1369.79,2728.01,0.00
2024-12-10 17:19:18,107,2426,52,55,1381.59,2728.04,0.00
2024-12-10 17:19:18,107,2427,52,55,1380.53,2729.00,0.00
2024-12-10 17:19:18,108,2427,53,55,1367.75,2729.01,0.00
2024-12-10 17:19:18,107,2427,52,55,1379.52,2729.04,0.00
2024-12-10 17:19:18,107,2428,52,55,1378.33,2730.00,0.00
2024-12-10 17:19:18,108,2428,53,55,1365.56,2730.01,0.00
2024-12-10 17:19:18,107,2428,52,55,1377.32,2730.04,0.00
2024-12-10 17:19:18,106,2428,51,55,1390.05,2730.04,0.00
2024-12-10 17:19:18,106,2429,51,55,1388.89,2731.00,0.00
2024-12-10 17:19:18,107,2429,52,55,1375.91,2731.01,0.00
2024-12-10 17:19:18,106,2429,51,55,1387.87,2731.04,0.00
2024-12-10 17:19:18,106,2430,51,55,1386.29,2732.00,0.00
2024-12-10 17:19:18,107,2430,52,55,1373.34,2732.01,0.00
2024-12-10 17:19:18,106,2430,52,54,1385.27,2732.04,0.00
2024-12-10 17:19:18,106,2431,52,54,1383.24,2733.00,0.00
2024-12-10 17:19:18,107,2431,53,54,1370.31,2733.01,0.00
2024-12-10 17:19:18,106,2431,52,54,1382.22,2733.04,0.00
2024-12-10 17:19:19,106,2432,52,54,1379.63,2734.00,0.00
2024-12-10 17:19:19,107,2432,53,54,1366.73,2734.01,0.00
2024-12-10 17:19:19,106,2432,53,53,1378.61,2734.04,0.00
2024-12-10 17:19:19,105,2432,52,53,1390.94,2734.07,0.00
2024-12-10 17:19:19,105,2433,52,53,1390.88,2735.00,0.00
2024-12-10 17:19:19,106,2433,53,53,1377.76,2735.01,0.00
2024-12-10 17:19:19,107,2432,54,53,1364.38,2735.05,0.00
2024-12-10 17:19:19,106,2432,53,53,1393.52,2735.05,0.00
2024-12-10 17:19:19,106,2433,53,53,1392.52,2736.00,0.00
2024-12-10 17:19:19,107,2433,53,54,1379.50,2736.01,0.00
2024-12-10 17:19:19,106,2433,53,53,1391.50,2736.04,0.00
2024-12-10 17:19:19,106,2434,53,53,1416.13,2737.00,0.00
2024-12-10 17:19:19,107,2434,54,53,1402.90,2737.01,0.00
2024-12-10 17:19:19,106,2434,54,52,1415.12,2737.04,0.00
2024-12-10 17:19:19,105,2434,54,51,1422.23,2737.23,0.00
2024-12-10 17:19:19,105,2435,54,51,1427.67,2738.00,0.00
2024-12-10 17:19:19,106,2435,54,52,1414.20,2738.01,0.00
2024-12-10 17:19:19,106,2436,54,52,1413.42,2739.00,0.00
2024-12-10 17:19:19,107,2436,54,53,1400.21,2739.01,0.00
2024-12-10 17:19:19,106,2436,53,53,1412.41,2739.04,0.00
2024-12-10 17:19:19,106,2437,53,53,1412.39,2740.00,0.00
2024-12-10 17:19:19,107,2437,54,53,1399.19,2740.01,0.00
2024-12-10 17:19:19,106,2437,54,52,1411.37,2740.04,0.00
2024-12-10 17:19:19,106,2438,54,52,1411.35,2741.00,0.00
2024-12-10 17:19:19,107,2438,55,52,1398.16,2741.01,0.00
2024-12-10 17:19:19,106,2438,54,52,1410.33,2741.04,0.00
2024-12-10 17:19:19,106,2439,54,52,1410.32,2742.00,0.00
2024-12-10 17:19:19,107,2439,54,53,1397.14,2742.01,0.00
2024-12-10 17:19:19,106,2439,54,52,1409.30,2742.04,0.00
2024-12-10 17:19:19,105,2439,53,52,1419.59,2742.14,0.00
2024-12-10 17:19:19,105,2440,53,52,1422.70,2743.00,0.00
2024-12-10 17:19:19,106,2440,53,53,1409.28,2743.01,0.00
2024-12-10 17:19:19,105,2440,53,52,1421.67,2743.04,0.00
2024-12-10 17:19:19,105,2441,53,52,1421.91,2744.00,0.00
2024-12-10 17:19:19,106,2441,53,53,1408.50,2744.01,0.00
2024-12-10 17:19:19,106,2442,53,53,1407.72,2745.00,0.00
2024-12-10 17:19:19,107,2442,53,54,1394.56,2745.01,0.00
2024-12-10 17:19:19,106,2442,53,53,1406.70,2745.04,0.00
2024-12-10 17:19:19,106,2443,53,53,1406.68,2746.00,0.00
2024-12-10 17:19:19,107,2443,54,53,1393.53,2746.01,0.00
2024-12-10 17:19:19,106,2443,54,52,1405.65,2746.04,0.00
2024-12-10 17:19:19,107,2442,54,53,1372.81,2746.78,0.00
2024-12-10 17:19:19,107,2443,54,53,1398.17,2747.00,0.00
2024-12-10 17:19:19,108,2443,55,53,1385.23,2747.01,0.00
2024-12-10 17:19:19,107,2443,54,53,1397.16,2747.04,0.00
2024-12-10 17:19:19,107,2444,54,53,1422.09,2748.00,0.00
2024-12-10 17:19:19,108,2444,54,54,1408.92,2748.01,0.00
2024-12-10 17:19:19,107,2444,53,54,1421.07,2748.04,0.00
2024-12-10 17:19:19,107,2445,53,54,1419.93,2749.00,0.00
2024-12-10 17:19:19,108,2445,54,54,1406.79,2749.01,0.00
2024-12-10 17:19:19,107,2445,53,54,1418.92,2749.04,0.00
2024-12-10 17:19:19,107,2446,53,54,1417.32,2750.00,0.00
2024-12-10 17:19:19,108,2446,54,54,1404.20,2750.01,0.00
2024-12-10 17:19:19,107,2446,53,54,1416.31,2750.04,0.00
2024-12-10 17:19:19,107,2447,53,54,1414.36,2751.00,0.00
2024-12-10 17:19:19,108,2447,53,55,1401.26,2751.01,0.00
2024-12-10 17:19:19,107,2447,53,54,1413.34,2751.04,0.00
2024-12-10 17:19:19,107,2448,53,54,1411.21,2752.00,0.00
2024-12-10 17:19:19,108,2448,53,55,1398.14,2752.01,0.00
2024-12-10 17:19:19,107,2448,52,55,1410.19,2752.04,0.00
2024-12-10 17:19:19,108,2447,53,55,1386.71,2752.36,0.00
2024-12-10 17:19:19,108,2448,53,55,1411.36,2753.00,0.00
2024-12-10 17:19:19,109,2448,54,55,1398.41,2753.01,0.00
2024-12-10 17:19:19,108,2448,53,55,1410.35,2753.04,0.00
2024-12-10 17:19:19,108,2449,53,55,1432.95,2754.00,0.00
2024-12-10 17:19:19,109,2449,53,56,1419.80,2754.01,0.00
2024-12-10 17:19:19,108,2449,53,55,1431.94,2754.04,0.00
2024-12-10 17:19:19,109,2448,54,55,1401.30,2754.61,0.00
2024-12-10 17:19:19,109,2449,54,55,1425.88,2755.00,0.00
2024-12-10 17:19:19,110,2449,54,56,1412.92,2755.01,0.00
2024-12-10 17:19:19,110,2450,54,56,1433.59,2756.00,0.00
2024-12-10 17:19:19,111,2450,55,56,1420.68,2756.01,0.00
2024-12-10 17:19:19,110,2450,54,56,1427.38,2756.19,0.00
2024-12-10 17:19:19,110,2451,54,56,1430.63,2757.00,0.00
2024-12-10 17:19:19,111,2451,54,57,1417.74,2757.01,0.00
2024-12-10 17:19:19,110,2451,53,57,1429.64,2757.04,0.00
2024-12-10 17:19:19,110,2452,53,57,1428.64,2758.00,0.00
2024-12-10 17:19:19,111,2452,53,58,1415.77,2758.01,0.00
2024-12-10 17:19:19,110,2452,53,57,1427.65,2758.04,0.00
2024-12-10 17:19:19,110,2453,53,57,1426.65,2759.00,0.00
2024-12-10 17:19:19,111,2453,54,57,1413.80,2759.01,0.00
2024-12-10 17:19:19,110,2453,54,56,1425.66,2759.04,0.00
2024-12-10 17:19:19,111,2452,55,56,1390.81,2759.87,0.00
2024-12-10 17:19:19,111,2453,55,56,1415.06,2760.00,0.00
2024-12-10 17:19:19,112,2453,55,57,1402.42,2760.01,0.00
2024-12-10 17:19:19,113,2452,56,57,1390.01,2760.03,0.00
2024-12-10 17:19:19,112,2452,56,56,1421.91,2760.05,0.00
2024-12-10 17:19:19,113,2451,56,57,1401.56,2760.35,0.00
2024-12-10 17:19:19,113,2452,56,57,1449.16,2761.00,0.00
2024-12-10 17:19:19,114,2452,57,57,1436.45,2761.01,0.00
2024-12-10 17:19:19,114,2453,57,57,1482.27,2762.00,0.00
2024-12-10 17:19:19,115,2453,57,58,1469.38,2762.01,0.00
2024-12-10 17:19:19,114,2453,56,58,1481.32,2762.04,0.00
2024-12-10 17:19:20,114,2454,56,58,1479.05,2763.00,0.00
2024-12-10 17:19:20,115,2454,57,58,1466.19,2763.01,0.00
2024-12-10 17:19:20,114,2454,57,57,1478.09,2763.04,0.00
2024-12-10 17:19:20,114,2455,57,57,1475.22,2764.00,0.00
2024-12-10 17:19:20,115,2455,58,57,1462.40,2764.01,0.00
2024-12-10 17:19:20,114,2455,57,57,1474.27,2764.04,0.00
2024-12-10 17:19:20,115,2454,58,57,1438.57,2764.84,0.00
2024-12-10 17:19:20,115,2455,58,57,1461.56,2765.00,0.00
2024-12-10 17:19:20,116,2455,58,58,1448.96,2765.01,0.00
2024-12-10 17:19:20,115,2455,58,57,1460.61,2765.04,0.00
2024-12-10 17:19:20,115,2456,58,57,1480.20,2766.00,0.00
2024-12-10 17:19:20,116,2456,59,57,1467.44,2766.01,0.00
2024-12-10 17:19:20,115,2456,58,57,1479.25,2766.04,0.00
2024-12-10 17:19:20,116,2455,58,58,1452.82,2766.55,0.00
2024-12-10 17:19:20,116,2456,58,58,1471.82,2767.00,0.00
2024-12-10 17:19:20,117,2456,59,58,1459.24,2767.01,0.00
2024-12-10 17:19:20,116,2456,59,57,1470.88,2767.03,0.00
2024-12-10 17:19:20,116,2457,59,57,1488.50,2768.00,0.00
2024-12-10 17:19:20,117,2457,60,57,1475.78,2768.01,0.00
2024-12-10 17:19:20,116,2457,59,57,1487.56,2768.03,0.00
2024-12-10 17:19:20,115,2457,58,57,1478.61,2768.67,0.00
2024-12-10 17:19:20,115,2458,58,57,1493.81,2769.00,0.00
2024-12-10 17:19:20,116,2458,59,57,1480.94,2769.01,0.00
2024-12-10 17:19:20,115,2458,58,57,1492.87,2769.04,0.00
2024-12-10 17:19:20,115,2459,58,57,1490.74,2770.00,0.00
2024-12-10 17:19:20,116,2459,58,58,1477.89,2770.01,0.00
2024-12-10 17:19:20,115,2459,58,57,1489.79,2770.04,0.00
2024-12-10 17:19:20,114,2459,57,57,1502.62,2770.04,0.00
2024-12-10 17:19:20,114,2460,57,57,1500.71,2771.00,0.00
2024-12-10 17:19:20,115,2460,57,58,1487.67,2771.01,0.00
2024-12-10 17:19:20,114,2460,57,57,1499.76,2771.04,0.00
2024-12-10 17:19:20,114,2461,57,57,1497.85,2772.00,0.00
2024-12-10 17:19:20,115,2461,57,58,1484.83,2772.01,0.00
2024-12-10 17:19:20,114,2461,57,57,1496.89,2772.04,0.00
2024-12-10 17:19:20,114,2462,57,57,1494.99,2773.00,0.00
2024-12-10 17:19:20,115,2462,58,57,1481.99,2773.01,0.00
2024-12-10 17:19:20,114,2462,57,57,1494.03,2773.04,0.00
2024-12-10 17:19:20,114,2463,57,57,1492.08,2774.00,0.00
2024-12-10 17:19:20,115,2463,58,57,1479.10,2774.01,0.00
2024-12-10 17:19:20,114,2463,57,57,1491.60,2774.02,0.00
2024-12-10 17:19:20,113,2463,56,57,1504.31,2774.03,0.00
2024-12-10 17:19:20,113,2464,56,57,1502.15,2775.00,0.00
2024-12-10 17:19:20,114,2464,56,58,1488.98,2775.01,0.00
2024-12-10 17:19:20,113,2464,56,57,1501.43,2775.03,0.00
2024-12-10 17:19:20,113,2465,56,57,1499.03,2776.00,0.00
2024-12-10 17:19:20,114,2465,57,57,1485.88,2776.01,0.00
2024-12-10 17:19:20,113,2465,57,56,1498.30,2776.03,0.00
2024-12-10 17:19:20,114,2464,57,57,1464.73,2776.76,0.00
2024-12-10 17:19:20,114,2465,57,57,1487.83,2777.00,0.00
2024-12-10 17:19:20,115,2465,58,57,1474.89,2777.01,0.00
2024-12-10 17:19:20,114,2465,57,57,1487.11,2777.03,0.00
2024-12-10 17:19:20,114,2466,57,57,1508.16,2778.00,0.00
2024-12-10 17:19:20,115,2466,58,57,1495.04,2778.01,0.00
2024-12-10 17:19:20,114,2466,57,57,1507.44,2778.03,0.00
2024-12-10 17:19:20,114,2467,57,57,1503.82,2779.00,0.00
2024-12-10 17:19:20,115,2467,57,58,1490.75,2779.01,0.00
2024-12-10 17:19:20,114,2467,57,57,1503.10,2779.03,0.00
2024-12-10 17:19:20,114,2468,57,57,1499.21,2780.00,0.00
2024-12-10 17:19:20,115,2468,58,57,1486.18,2780.01,0.00
2024-12-10 17:19:20,114,2468,58,56,1498.49,2780.03,0.00
2024-12-10 17:19:20,114,2469,58,56,1494.13,2781.00,0.00
2024-12-10 17:19:20,115,2469,59,56,1481.14,2781.01,0.00
2024-12-10 17:19:20,114,2469,59,55,1493.41,2781.03,0.00
2024-12-10 17:19:20,114,2470,59,55,1488.61,2782.00,0.00
2024-12-10 17:19:20,115,2470,60,55,1475.66,2782.01,0.00
2024-12-10 17:19:20,114,2470,60,54,1487.89,2782.03,0.00
2024-12-10 17:19:20,114,2471,60,54,1482.32,2783.00,0.00
2024-12-10 17:19:20,115,2471,61,54,1469.43,2783.01,0.00
2024-12-10 17:19:20,114,2471,60,54,1481.60,2783.03,0.00
2024-12-10 17:19:20,114,2472,60,54,1474.79,2784.00,0.00
2024-12-10 17:19:20,115,2472,61,54,1461.97,2784.01,0.00
2024-12-10 17:19:20,114,2472,60,54,1474.07,2784.03,0.00
2024-12-10 17:19:20,113,2472,59,54,1465.03,2784.67,0.00
2024-12-10 17:19:20,113,2473,59,54,1480.49,2785.00,0.00
2024-12-10 17:19:20,114,2473,60,54,1467.50,2785.01,0.00
2024-12-10 17:19:20,113,2473,60,53,1479.76,2785.03,0.00
2024-12-10 17:19:20,113,2474,60,53,1473.49,2786.00,0.00
2024-12-10 17:19:20,114,2474,60,54,1460.57,2786.01,0.00
2024-12-10 17:19:20,113,2474,59,54,1472.76,2786.03,0.00
2024-12-10 17:19:20,113,2475,59,54,1464.76,2787.00,0.00
2024-12-10 17:19:20,114,2475,59,55,1451.91,2787.01,0.00
2024-12-10 17:19:20,113,2475,59,54,1463.79,2787.04,0.00
2024-12-10 17:19:20,113,2476,59,54,1454.50,2788.00,0.00
2024-12-10 17:19:20,114,2476,59,55,1441.74,2788.01,0.00
2024-12-10 17:19:20,113,2476,59,54,1453.53,2788.04,0.00
2024-12-10 17:19:20,112,2476,59,53,1450.76,2788.55,0.00
2024-12-10 17:19:20,112,2477,59,53,1458.70,2789.00,0.00
2024-12-10 17:19:20,113,2477,60,53,1445.79,2789.01,0.00
2024-12-10 17:19:20,112,2477,60,52,1457.72,2789.04,0.00
2024-12-10 17:19:20,112,2478,60,52,1450.67,2790.00,0.00
2024-12-10 17:19:20,113,2478,61,52,1437.83,2790.01,0.00
2024-12-10 17:19:20,112,2478,61,51,1449.69,2790.04,0.00
2024-12-10 17:19:20,112,2479,61,51,1441.69,2791.00,0.00
2024-12-10 17:19:20,113,2479,62,51,1428.93,2791.01,0.00
2024-12-10 17:19:20,112,2479,62,50,1440.71,2791.04,0.00
2024-12-10 17:19:20,111,2479,62,49,1432.98,2791.59,0.00
2024-12-10 17:19:21,111,2480,62,49,1444.27,2792.00,0.00
2024-12-10 17:19:21,112,2480,62,50,1431.37,2792.01,0.00
2024-12-10 17:19:21,112,2481,62,50,1422.29,2793.00,0.00
2024-12-10 17:19:21,113,2481,63,50,1409.70,2793.01,0.00
2024-12-10 17:19:21,112,2481,62,50,1421.06,2793.05,0.00
2024-12-10 17:19:21,111,2481,61,50,1417.67,2793.52,0.00
2024-12-10 17:19:21,110,2481,60,50,1423.42,2793.69,0.00
2024-12-10 17:19:21,110,2482,60,50,1440.43,2794.00,0.00
2024-12-10 17:19:21,111,2482,60,51,1427.46,2794.01,0.00
2024-12-10 17:19:21,110,2482,59,51,1439.18,2794.05,0.00
2024-12-10 17:19:21,110,2483,59,51,1438.41,2795.00,0.00
2024-12-10 17:19:21,111,2483,59,52,1425.45,2795.01,0.00
2024-12-10 17:19:21,110,2483,58,52,1437.16,2795.05,0.00
2024-12-10 17:19:21,110,2484,58,52,1436.15,2796.00,0.00
2024-12-10 17:19:21,111,2484,58,53,1423.21,2796.01,0.00
2024-12-10 17:19:21,110,2484,57,53,1434.90,2796.05,0.00
2024-12-10 17:19:21,111,2483,57,54,1408.75,2796.54,0.00
2024-12-10 17:19:21,111,2484,57,54,1428.72,2797.00,0.00
2024-12-10 17:19:21,112,2484,57,55,1415.96,2797.01,0.00
2024-12-10 17:19:21,111,2484,56,55,1427.48,2797.05,0.00
2024-12-10 17:19:21,111,2485,56,55,1450.77,2798.00,0.00
2024-12-10 17:19:21,112,2485,57,55,1437.81,2798.01,0.00
2024-12-10 17:19:21,111,2485,57,54,1449.52,2798.05,0.00
2024-12-10 17:19:21,110,2485,56,54,1462.45,2798.05,0.00
2024-12-10 17:19:21,111,2484,56,55,1426.00,2798.86,0.00
2024-12-10 17:19:21,111,2485,56,55,1451.10,2799.00,0.00
2024-12-10 17:19:21,112,2485,56,56,1438.14,2799.01,0.00
2024-12-10 17:19:21,113,2484,56,57,1425.41,2799.03,0.00
2024-12-10 17:19:21,112,2484,56,56,1446.66,2799.05,0.00
2024-12-10 17:19:21,112,2485,56,56,1468.58,2800.00,0.00
2024-12-10 17:19:21,113,2485,57,56,1455.59,2800.01,0.00
2024-12-10 17:19:21,112,2485,57,55,1467.36,2800.05,0.00
2024-12-10 17:19:21,112,2486,57,55,1488.44,2801.00,0.00
2024-12-10 17:19:21,113,2486,57,56,1475.27,2801.01,0.00
2024-12-10 17:19:21,112,2486,57,55,1487.21,2801.05,0.00
2024-12-10 17:19:21,113,2485,58,55,1461.05,2801.53,0.00
2024-12-10 17:19:21,113,2486,58,55,1481.06,2802.00,0.00
2024-12-10 17:19:21,114,2486,58,56,1468.07,2802.01,0.00
2024-12-10 17:19:21,113,2486,58,55,1479.85,2802.04,0.00
2024-12-10 17:19:21,114,2485,58,56,1451.33,2802.62,0.00
2024-12-10 17:19:21,114,2486,58,56,1495.60,2803.00,0.00
2024-12-10 17:19:21,115,2486,59,56,1482.60,2803.01,0.00
2024-12-10 17:19:21,114,2486,58,56,1494.39,2803.04,0.00
2024-12-10 17:19:21,114,2487,58,56,1512.83,2804.00,0.00
2024-12-10 17:19:21,115,2487,59,56,1499.68,2804.01,0.00
2024-12-10 17:19:21,114,2487,59,55,1511.63,2804.04,0.00
2024-12-10 17:19:21,113,2487,58,55,1505.82,2804.65,0.00
2024-12-10 17:19:21,113,2488,58,55,1518.47,2805.00,0.00
2024-12-10 17:19:21,114,2488,59,55,1505.15,2805.01,0.00
2024-12-10 17:19:21,113,2488,58,55,1517.25,2805.04,0.00
2024-12-10 17:19:21,113,2489,58,55,1512.60,2806.00,0.00
2024-12-10 17:19:21,114,2489,59,55,1499.33,2806.01,0.00
2024-12-10 17:19:21,113,2489,59,54,1511.38,2806.04,0.00
2024-12-10 17:19:21,113,2490,59,54,1506.11,2807.00,0.00
2024-12-10 17:19:21,114,2490,59,55,1492.90,2807.01,0.00
2024-12-10 17:19:21,113,2490,58,55,1504.89,2807.04,0.00
2024-12-10 17:19:21,114,2489,59,55,1467.72,2807.77,0.00
2024-12-10 17:19:21,114,2490,59,55,1491.33,2808.00,0.00
2024-12-10 17:19:21,115,2490,60,55,1478.36,2808.01,0.00
2024-12-10 17:19:21,114,2490,59,55,1490.11,2808.04,0.00
2024-12-10 17:19:21,114,2491,59,55,1508.25,2809.00,0.00
2024-12-10 17:19:21,115,2491,59,56,1495.14,2809.01,0.00
2024-12-10 17:19:21,114,2491,59,55,1507.04,2809.04,0.00
2024-12-10 17:19:21,113,2491,59,54,1503.72,2809.60,0.00
2024-12-10 17:19:21,113,2492,59,54,1516.30,2810.00,0.00
2024-12-10 17:19:21,114,2492,59,55,1503.00,2810.01,0.00
2024-12-10 17:19:21,113,2492,59,54,1515.08,2810.04,0.00
2024-12-10 17:19:21,113,2493,59,54,1512.35,2811.00,0.00
2024-12-10 17:19:21,114,2493,60,54,1499.08,2811.01,0.00
2024-12-10 17:19:21,113,2493,60,53,1511.12,2811.04,0.00
2024-12-10 17:19:21,113,2494,60,53,1508.54,2812.00,0.00
2024-12-10 17:19:21,114,2494,60,54,1495.31,2812.01,0.00
2024-12-10 17:19:21,113,2494,60,53,1507.32,2812.04,0.00
2024-12-10 17:19:21,113,2495,60,53,1504.93,2813.00,0.00
2024-12-10 17:19:21,114,2495,61,53,1491.73,2813.01,0.00
2024-12-10 17:19:21,115,2494,61,54,1477.80,2813.06,0.00
2024-12-10 17:19:21,115,2495,61,54,1499.83,2814.00,0.00
2024-12-10 17:19:21,116,2495,61,55,1486.90,2814.01,0.00
2024-12-10 17:19:21,117,2494,62,55,1472.53,2814.09,0.00
2024-12-10 17:19:21,117,2495,62,55,1517.92,2815.00,0.00
2024-12-10 17:19:21,118,2495,63,55,1505.06,2815.01,0.00
2024-12-10 17:19:21,117,2495,62,55,1516.27,2815.06,0.00
2024-12-10 17:19:21,118,2494,62,56,1488.30,2815.60,0.00
2024-12-10 17:19:21,118,2495,62,56,1533.66,2816.00,0.00
2024-12-10 17:19:21,119,2495,63,56,1520.77,2816.01,0.00
2024-12-10 17:19:21,118,2495,63,55,1518.43,2816.54,0.00
2024-12-10 17:19:21,118,2496,63,55,1552.75,2817.00,0.00
2024-12-10 17:19:21,119,2496,63,56,1539.70,2817.01,0.00
2024-12-10 17:19:21,118,2496,62,56,1550.87,2817.07,0.00
2024-12-10 17:19:22,118,2497,62,56,1547.87,2818.00,0.00
2024-12-10 17:19:22,119,2497,62,57,1534.86,2818.01,0.00
2024-12-10 17:19:22,118,2497,62,56,1545.99,2818.07,0.00
2024-12-10 17:19:22,118,2498,62,56,1542.98,2819.00,0.00
2024-12-10 17:19:22,119,2498,63,56,1530.02,2819.01,0.00
2024-12-10 17:19:22,118,2498,62,56,1541.10,2819.07,0.00
2024-12-10 17:19:22,118,2499,62,56,1537.64,2820.00,0.00
2024-12-10 17:19:22,119,2499,63,56,1524.72,2820.01,0.00
2024-12-10 17:19:22,118,2499,62,56,1535.76,2820.07,0.00
2024-12-10 17:19:22,119,2498,62,57,1507.89,2820.56,0.00
2024-12-10 17:19:22,119,2499,62,57,1529.10,2821.00,0.00
2024-12-10 17:19:22,120,2499,63,57,1516.35,2821.01,0.00
2024-12-10 17:19:22,119,2499,62,57,1527.23,2821.07,0.00
2024-12-10 17:19:22,120,2498,63,57,1491.25,2821.84,0.00
2024-12-10 17:19:22,120,2499,63,57,1537.25,2822.00,0.00
2024-12-10 17:19:22,121,2499,63,58,1524.54,2822.01,0.00
2024-12-10 17:19:22,121,2500,63,58,1541.09,2823.00,0.00
2024-12-10 17:19:22,122,2500,64,58,1528.46,2823.01,0.00
2024-12-10 17:19:22,121,2500,64,57,1538.79,2823.08,0.00
2024-12-10 17:19:22,120,2500,63,57,1537.53,2823.50,0.00
2024-12-10 17:19:22,120,2501,63,57,1547.33,2824.00,0.00
2024-12-10 17:19:22,121,2501,64,57,1534.54,2824.01,0.00
2024-12-10 17:19:22,120,2501,63,57,1545.01,2824.08,0.00
2024-12-10 17:19:22,120,2502,63,57,1543.17,2825.00,0.00
2024-12-10 17:19:22,121,2502,63,58,1530.42,2825.01,0.00
2024-12-10 17:19:22,120,2502,63,57,1540.85,2825.08,0.00
2024-12-10 17:19:22,121,2501,64,57,1523.00,2825.28,0.00
2024-12-10 17:19:22,122,2500,65,57,1509.04,2825.58,0.00
2024-12-10 17:19:22,122,2501,65,57,1529.99,2826.00,0.00
2024-12-10 17:19:22,123,2501,65,58,1517.55,2826.01,0.00
2024-12-10 17:19:22,122,2501,65,57,1527.71,2826.08,0.00
2024-12-10 17:19:22,122,2502,65,57,1571.78,2827.00,0.00
2024-12-10 17:19:22,123,2502,66,57,1559.00,2827.01,0.00
2024-12-10 17:19:22,122,2502,66,56,1569.50,2827.08,0.00
2024-12-10 17:19:22,122,2503,66,56,1566.96,2828.00,0.00
2024-12-10 17:19:22,123,2503,67,56,1554.22,2828.01,0.00
2024-12-10 17:19:22,122,2503,66,56,1564.67,2828.08,0.00
2024-12-10 17:19:22,122,2504,66,56,1561.75,2829.00,0.00
2024-12-10 17:19:22,123,2504,67,56,1549.05,2829.01,0.00
2024-12-10 17:19:22,122,2504,66,56,1559.46,2829.08,0.00
2024-12-10 17:19:22,122,2505,66,56,1556.20,2830.00,0.00
2024-12-10 17:19:22,123,2505,67,56,1543.54,2830.01,0.00
2024-12-10 17:19:22,122,2505,66,56,1553.91,2830.08,0.00
2024-12-10 17:19:22,123,2504,66,57,1522.54,2830.71,0.00
2024-12-10 17:19:22,123,2505,66,57,1543.74,2831.00,0.00
2024-12-10 17:19:22,124,2505,66,58,1531.29,2831.01,0.00
2024-12-10 17:19:22,123,2505,65,58,1541.47,2831.08,0.00
2024-12-10 17:19:22,123,2506,65,58,1559.26,2832.00,0.00
2024-12-10 17:19:22,124,2506,65,59,1546.69,2832.01,0.00
2024-12-10 17:19:22,123,2506,64,59,1556.99,2832.08,0.00
2024-12-10 17:19:22,123,2507,64,59,1551.27,2833.00,0.00
2024-12-10 17:19:22,124,2507,65,59,1538.76,2833.01,0.00
2024-12-10 17:19:22,123,2507,64,59,1549.00,2833.08,0.00
2024-12-10 17:19:22,123,2508,64,59,1542.02,2834.00,0.00
2024-12-10 17:19:22,124,2508,64,60,1529.59,2834.01,0.00
2024-12-10 17:19:22,123,2508,63,60,1539.74,2834.08,0.00
2024-12-10 17:19:22,123,2509,63,60,1531.78,2835.00,0.00
2024-12-10 17:19:22,124,2509,64,60,1519.42,2835.01,0.00
2024-12-10 17:19:22,123,2509,64,59,1531.32,2835.02,0.00
2024-12-10 17:19:22,122,2509,63,59,1542.03,2835.07,0.00
2024-12-10 17:19:22,121,2509,62,59,1554.54,2835.07,0.00
2024-12-10 17:19:22,120,2509,61,59,1553.91,2835.48,0.00
2024-12-10 17:19:22,121,2508,62,59,1539.92,2835.53,0.00
2024-12-10 17:19:22,121,2509,62,59,1556.15,2836.00,0.00
2024-12-10 17:19:22,122,2509,62,60,1543.39,2836.01,0.00
2024-12-10 17:19:22,121,2509,62,59,1554.06,2836.07,0.00
2024-12-10 17:19:22,122,2508,62,60,1524.84,2836.62,0.00
2024-12-10 17:19:22,122,2509,62,60,1563.82,2837.00,0.00
2024-12-10 17:19:22,123,2509,62,61,1551.10,2837.01,0.00
2024-12-10 17:19:22,123,2510,62,61,1561.17,2838.00,0.00
2024-12-10 17:19:22,124,2510,63,61,1548.58,2838.01,0.00
2024-12-10 17:19:22,125,2509,64,61,1535.97,2838.03,0.00
2024-12-10 17:19:22,124,2509,64,60,1566.23,2838.08,0.00
2024-12-10 17:19:22,123,2509,63,60,1551.02,2838.88,0.00
2024-12-10 17:19:22,123,2510,63,60,1570.75,2839.00,0.00
2024-12-10 17:19:22,124,2510,63,61,1558.08,2839.01,0.00
2024-12-10 17:19:22,123,2510,63,60,1568.70,2839.07,0.00
2024-12-10 17:19:22,123,2511,63,60,1583.52,2840.00,0.00
2024-12-10 17:19:22,124,2511,64,60,1570.75,2840.01,0.00
2024-12-10 17:19:22,123,2511,63,60,1581.47,2840.07,0.00
2024-12-10 17:19:22,124,2510,63,61,1567.11,2840.15,0.00
2024-12-10 17:19:22,123,2510,62,61,1569.55,2840.50,0.00
2024-12-10 17:19:22,123,2511,62,61,1578.71,2841.00,0.00
2024-12-10 17:19:22,124,2511,63,61,1565.98,2841.01,0.00
2024-12-10 17:19:22,123,2511,62,61,1576.66,2841.07,0.00
2024-12-10 17:19:23,123,2512,62,61,1593.87,2842.00,0.00
2024-12-10 17:19:23,124,2512,63,61,1581.02,2842.01,0.00
2024-12-10 17:19:23,123,2512,63,60,1591.82,2842.07,0.00
2024-12-10 17:19:23,122,2512,63,59,1596.10,2842.31,0.00
2024-12-10 17:19:23,122,2513,63,59,1597.97,2843.00,0.00
2024-12-10 17:19:23,123,2513,64,59,1584.98,2843.01,0.00
2024-12-10 17:19:23,124,2512,65,59,1571.07,2843.06,0.00
2024-12-10 17:19:23,123,2512,65,58,1589.63,2843.08,0.00
2024-12-10 17:19:23,123,2513,65,58,1582.94,2844.00,0.00
2024-12-10 17:19:23,124,2513,66,58,1570.18,2844.01,0.00
2024-12-10 17:19:23,123,2513,66,57,1580.89,2844.07,0.00
2024-12-10 17:19:23,122,2513,66,56,1578.08,2844.46,0.00
2024-12-10 17:19:23,122,2514,66,56,1609.05,2845.00,0.00
2024-12-10 17:19:23,123,2514,66,57,1595.97,2845.01,0.00
2024-12-10 17:19:23,123,2515,66,57,1588.26,2846.00,0.00
2024-12-10 17:19:23,124,2515,67,57,1575.45,2846.01,0.00
2024-12-10 17:19:23,123,2515,67,56,1586.43,2846.07,0.00
2024-12-10 17:19:23,122,2515,67,55,1599.20,2846.07,0.00
2024-12-10 17:19:23,123,2514,67,56,1569.63,2846.56,0.00
2024-12-10 17:19:23,123,2515,67,56,1591.21,2847.00,0.00
2024-12-10 17:19:23,124,2515,68,56,1578.38,2847.01,0.00
2024-12-10 17:19:23,125,2514,68,57,1565.75,2847.02,0.00
2024-12-10 17:19:23,124,2514,67,57,1587.59,2847.07,0.00
2024-12-10 17:19:23,125,2513,67,58,1568.44,2847.31,0.00
2024-12-10 17:19:23,125,2514,67,58,1595.20,2848.00,0.00
2024-12-10 17:19:23,126,2514,68,58,1582.54,2848.01,0.00
2024-12-10 17:19:23,125,2514,68,57,1593.41,2848.06,0.00
2024-12-10 17:19:23,125,2515,68,57,1628.44,2849.00,0.00
2024-12-10 17:19:23,126,2515,68,58,1615.52,2849.01,0.00
2024-12-10 17:19:23,127,2514,69,58,1595.91,2849.25,0.00
2024-12-10 17:19:23,126,2514,68,58,1624.05,2849.35,0.00
2024-12-10 17:19:23,126,2515,68,58,1623.53,2850.00,0.00
2024-12-10 17:19:23,127,2515,68,59,1610.74,2850.01,0.00
2024-12-10 17:19:23,126,2515,67,59,1621.53,2850.07,0.00
2024-12-10 17:19:23,126,2516,67,59,1634.37,2851.00,0.00
2024-12-10 17:19:23,127,2516,67,60,1621.50,2851.01,0.00
2024-12-10 17:19:23,127,2517,67,60,1608.47,2852.00,0.00
2024-12-10 17:19:23,128,2517,67,61,1595.90,2852.01,0.00
2024-12-10 17:19:23,127,2517,67,60,1606.49,2852.07,0.00
2024-12-10 17:19:23,126,2517,66,60,1619.01,2852.07,0.00
2024-12-10 17:19:23,125,2517,65,60,1628.55,2852.18,0.00
2024-12-10 17:19:23,124,2517,65,59,1630.03,2852.44,0.00
2024-12-10 17:19:23,123,2517,64,59,1639.59,2852.47,0.00
2024-12-10 17:19:23,124,2516,65,59,1620.52,2852.69,0.00
2024-12-10 17:19:23,124,2517,65,59,1641.27,2853.00,0.00
2024-12-10 17:19:23,125,2517,66,59,1628.14,2853.01,0.00
2024-12-10 17:19:23,126,2516,66,60,1612.99,2853.10,0.00
2024-12-10 17:19:23,126,2517,66,60,1644.77,2854.00,0.00
2024-12-10 17:19:23,127,2517,67,60,1631.82,2854.01,0.00
2024-12-10 17:19:23,126,2517,67,59,1643.66,2854.04,0.00
2024-12-10 17:19:23,125,2517,66,59,1655.68,2854.07,0.00
2024-12-10 17:19:23,125,2518,66,59,1675.29,2855.00,0.00
2024-12-10 17:19:23,126,2518,67,59,1662.00,2855.01,0.00
2024-12-10 17:19:23,126,2519,67,59,1656.51,2856.00,0.00
2024-12-10 17:19:23,127,2519,67,60,1643.47,2856.01,0.00
2024-12-10 17:19:23,126,2519,66,60,1654.29,2856.08,0.00
2024-12-10 17:19:23,126,2520,66,60,1650.53,2857.00,0.00
2024-12-10 17:19:23,127,2520,66,61,1637.54,2857.01,0.00
2024-12-10 17:19:23,126,2520,66,60,1648.31,2857.08,0.00
2024-12-10 17:19:23,127,2519,67,60,1617.58,2857.66,0.00
2024-12-10 17:19:23,127,2520,67,60,1637.67,2858.00,0.00
2024-12-10 17:19:23,128,2520,67,61,1624.87,2858.01,0.00
2024-12-10 17:19:23,127,2520,67,60,1635.46,2858.08,0.00
2024-12-10 17:19:23,127,2521,67,60,1651.53,2859.00,0.00
2024-12-10 17:19:23,128,2521,67,61,1638.63,2859.01,0.00
2024-12-10 17:19:23,127,2521,66,61,1649.32,2859.08,0.00
2024-12-10 17:19:23,126,2521,65,61,1662.18,2859.08,0.00
2024-12-10 17:19:23,126,2522,65,61,1654.49,2860.00,0.00
2024-12-10 17:19:23,127,2522,66,61,1641.46,2860.01,0.00
2024-12-10 17:19:23,126,2522,65,61,1653.82,2860.02,0.00
2024-12-10 17:19:23,125,2522,65,60,1665.48,2860.07,0.00
2024-12-10 17:19:23,124,2522,64,60,1678.68,2860.07,0.00
2024-12-10 17:19:23,123,2522,64,59,1692.09,2860.07,0.00
2024-12-10 17:19:23,124,2521,64,60,1670.23,2860.38,0.00
2024-12-10 17:19:23,124,2522,64,60,1675.96,2861.00,0.00
2024-12-10 17:19:23,125,2522,64,61,1662.55,2861.01,0.00
2024-12-10 17:19:23,125,2523,64,61,1672.30,2862.00,0.00
2024-12-10 17:19:23,126,2523,64,62,1659.02,2862.01,0.00
2024-12-10 17:19:23,125,2523,64,61,1670.27,2862.07,0.00
2024-12-10 17:19:23,124,2523,63,61,1674.59,2862.37,0.00
2024-12-10 17:19:23,124,2524,63,61,1676.04,2863.00,0.00
2024-12-10 17:19:23,125,2524,63,62,1662.63,2863.01,0.00
2024-12-10 17:19:23,124,2524,62,62,1674.00,2863.07,0.00
2024-12-10 17:19:23,124,2525,62,62,1665.94,2864.00,0.00
2024-12-10 17:19:23,125,2525,62,63,1652.61,2864.01,0.00
2024-12-10 17:19:23,126,2524,63,63,1620.59,2864.64,0.00
2024-12-10 17:19:23,125,2524,63,62,1632.36,2864.81,0.00
2024-12-10 17:19:23,125,2525,63,62,1649.90,2865.00,0.00
2024-12-10 17:19:23,126,2525,64,62,1636.80,2865.01,0.00
2024-12-10 17:19:23,125,2525,64,61,1647.64,2865.08,0.00
2024-12-10 17:19:23,125,2526,64,61,1664.65,2866.00,0.00
2024-12-10 17:19:23,126,2526,64,62,1651.43,2866.01,0.00
2024-12-10 17:19:23,125,2526,64,61,1663.52,2866.04,0.00
2024-12-10 17:19:23,124,2526,63,61,1675.80,2866.07,0.00
2024-12-10 17:19:23,123,2526,63,60,1689.19,2866.07,0.00
2024-12-10 17:19:23,123,2527,63,60,1682.24,2867.00,0.00
2024-12-10 17:19:23,124,2527,64,60,1668.67,2867.01,0.00
2024-12-10 17:19:23,124,2528,64,60,1658.77,2868.00,0.00
2024-12-10 17:19:23,125,2528,65,60,1645.50,2868.01,0.00
2024-12-10 17:19:23,124,2528,64,60,1656.50,2868.08,0.00
2024-12-10 17:19:23,124,2529,64,60,1648.12,2869.00,0.00
2024-12-10 17:19:23,125,2529,64,61,1634.94,2869.01,0.00
2024-12-10 17:19:24,126,2528,65,61,1618.38,2869.15,0.00
2024-12-10 17:19:24,126,2529,65,61,1630.72,2870.00,0.00
2024-12-10 17:19:24,127,2529,65,62,1617.88,2870.01,0.00
2024-12-10 17:19:24,127,2530,65,62,1627.52,2871.00,0.00
2024-12-10 17:19:24,128,2530,66,62,1614.80,2871.01,0.00
2024-12-10 17:19:24,127,2530,65,62,1614.56,2871.37,0.00
2024-12-10 17:19:24,127,2531,65,62,1615.56,2872.00,0.00
2024-12-10 17:19:24,128,2531,66,62,1602.94,2872.01,0.00
2024-12-10 17:19:24,129,2530,66,63,1574.58,2872.56,0.00
2024-12-10 17:19:24,129,2531,66,63,1590.39,2873.00,0.00
2024-12-10 17:19:24,130,2531,67,63,1578.15,2873.01,0.00
2024-12-10 17:19:24,129,2531,66,63,1588.20,2873.08,0.00
2024-12-10 17:19:24,130,2530,66,64,1563.68,2873.49,0.00
2024-12-10 17:19:24,129,2530,65,64,1575.65,2873.85,0.00
2024-12-10 17:19:24,129,2531,65,64,1616.10,2874.00,0.00
2024-12-10 17:19:24,130,2531,66,64,1603.66,2874.01,0.00
2024-12-10 17:19:24,130,2532,66,64,1618.66,2875.00,0.00
2024-12-10 17:19:24,131,2532,66,65,1606.30,2875.01,0.00
2024-12-10 17:19:24,130,2532,66,64,1616.49,2875.08,0.00
2024-12-10 17:19:24,130,2533,66,64,1610.73,2876.00,0.00
2024-12-10 17:19:24,131,2533,66,65,1598.43,2876.01,0.00
2024-12-10 17:19:24,130,2533,66,64,1609.42,2876.05,0.00
2024-12-10 17:19:24,130,2534,66,64,1602.28,2877.00,0.00
2024-12-10 17:19:24,131,2534,66,65,1590.05,2877.01,0.00
2024-12-10 17:19:24,130,2534,65,65,1599.89,2877.09,0.00
2024-12-10 17:19:24,129,2534,65,64,1604.80,2877.32,0.00
2024-12-10 17:19:24,130,2533,66,64,1573.99,2877.90,0.00
2024-12-10 17:19:24,130,2534,66,64,1595.56,2878.00,0.00
2024-12-10 17:19:24,131,2534,66,65,1583.38,2878.01,0.00
2024-12-10 17:19:24,130,2534,65,65,1593.17,2878.09,0.00
2024-12-10 17:19:24,129,2534,64,65,1590.72,2878.47,0.00
2024-12-10 17:19:24,129,2535,64,65,1620.35,2879.00,0.00
2024-12-10 17:19:24,130,2535,65,65,1607.89,2879.01,0.00
2024-12-10 17:19:24,129,2535,65,64,1617.94,2879.09,0.00
2024-12-10 17:19:24,130,2534,66,64,1601.97,2879.22,0.00
2024-12-10 17:19:24,130,2535,66,64,1616.31,2880.00,0.00
2024-12-10 17:19:24,131,2535,66,65,1603.97,2880.01,0.00
2024-12-10 17:19:24,131,2536,66,65,1615.52,2881.00,0.00
2024-12-10 17:19:24,132,2536,67,65,1603.28,2881.01,0.00
2024-12-10 17:19:24,131,2536,66,65,1612.93,2881.09,0.00
2024-12-10 17:19:24,130,2536,65,65,1615.46,2881.39,0.00
2024-12-10 17:19:24,130,2537,65,65,1619.98,2882.00,0.00
2024-12-10 17:19:24,131,2537,65,66,1607.61,2882.01,0.00
2024-12-10 17:19:24,130,2537,65,65,1612.47,2882.27,0.00
2024-12-10 17:19:24,130,2538,65,65,1613.92,2883.00,0.00
2024-12-10 17:19:24,131,2538,65,66,1601.60,2883.01,0.00
2024-12-10 17:19:24,130,2538,64,66,1611.09,2883.10,0.00
2024-12-10 17:19:24,130,2539,64,66,1607.16,2884.00,0.00
2024-12-10 17:19:24,131,2539,65,66,1594.89,2884.01,0.00
2024-12-10 17:19:24,131,2540,65,66,1587.01,2885.00,0.00
2024-12-10 17:19:24,132,2540,65,67,1574.99,2885.01,0.00
2024-12-10 17:19:24,132,2541,65,67,1565.78,2886.00,0.00
2024-12-10 17:19:24,133,2541,66,67,1554.00,2886.01,0.00
2024-12-10 17:19:24,132,2541,66,66,1562.98,2886.10,0.00
2024-12-10 17:19:24,132,2542,66,66,1555.00,2887.00,0.00
2024-12-10 17:19:24,133,2542,67,66,1543.31,2887.01,0.00
2024-12-10 17:19:24,132,2542,67,65,1552.20,2887.10,0.00
2024-12-10 17:19:24,132,2543,67,65,1541.55,2888.00,0.00
2024-12-10 17:19:24,133,2543,67,66,1529.96,2888.01,0.00
2024-12-10 17:19:24,132,2543,67,65,1538.75,2888.10,0.00
2024-12-10 17:19:24,133,2542,68,65,1506.18,2888.56,0.00
2024-12-10 17:19:24,133,2543,68,65,1523.05,2889.00,0.00
2024-12-10 17:19:24,134,2543,68,66,1511.68,2889.01,0.00
2024-12-10 17:19:24,133,2543,67,66,1520.26,2889.10,0.00
2024-12-10 17:19:24,132,2543,66,66,1521.32,2889.37,0.00
2024-12-10 17:19:24,132,2544,66,66,1539.28,2890.00,0.00
2024-12-10 17:19:24,133,2544,67,66,1527.71,2890.01,0.00
2024-12-10 17:19:24,132,2544,66,66,1536.48,2890.10,0.00
2024-12-10 17:19:24,131,2544,66,65,1547.52,2890.12,0.00
2024-12-10 17:19:24,131,2545,66,65,1533.03,2891.00,0.00
2024-12-10 17:19:24,132,2545,66,66,1521.42,2891.01,0.00
2024-12-10 17:19:24,131,2545,66,65,1522.29,2891.34,0.00
2024-12-10 17:19:24,130,2545,65,65,1528.43,2891.39,0.00
2024-12-10 17:19:24,130,2546,65,65,1526.76,2892.00,0.00
2024-12-10 17:19:24,131,2546,66,65,1515.10,2892.01,0.00
2024-12-10 17:19:24,130,2546,66,64,1523.69,2892.11,0.00
2024-12-10 17:19:24,129,2546,66,63,1506.99,2892.82,0.00
2024-12-10 17:19:24,129,2547,66,63,1524.41,2893.00,0.00
2024-12-10 17:19:24,130,2547,67,63,1512.69,2893.01,0.00
2024-12-10 17:19:24,130,2548,67,63,1503.21,2894.00,0.00
2024-12-10 17:19:24,131,2548,68,63,1491.73,2894.01,0.00
2024-12-10 17:19:24,130,2548,68,62,1500.13,2894.11,0.00
2024-12-10 17:19:24,129,2548,67,62,1501.77,2894.40,0.00
2024-12-10 17:19:24,129,2549,67,62,1507.25,2895.00,0.00
2024-12-10 17:19:24,130,2549,67,63,1495.65,2895.01,0.00
2024-12-10 17:19:24,129,2549,67,62,1498.65,2895.30,0.00
2024-12-10 17:19:24,129,2550,67,62,1500.06,2896.00,0.00
2024-12-10 17:19:24,130,2550,67,63,1488.52,2896.01,0.00
2024-12-10 17:19:24,129,2550,67,62,1496.95,2896.11,0.00
2024-12-10 17:19:24,129,2551,67,62,1492.55,2897.00,0.00
2024-12-10 17:19:24,130,2551,68,62,1481.07,2897.01,0.00
2024-12-10 17:19:24,129,2551,68,61,1489.44,2897.11,0.00
2024-12-10 17:19:24,129,2552,68,61,1484.60,2898.00,0.00
2024-12-10 17:19:25,130,2552,68,62,1473.18,2898.01,0.00
2024-12-10 17:19:25,129,2552,67,62,1481.94,2898.09,0.00
2024-12-10 17:19:25,128,2552,66,62,1493.07,2898.10,0.00
2024-12-10 17:19:25,128,2553,66,62,1487.56,2899.00,0.00
2024-12-10 17:19:25,129,2553,67,62,1476.03,2899.01,0.00
2024-12-10 17:19:25,128,2553,67,61,1484.43,2899.11,0.00
2024-12-10 17:19:25,127,2553,67,60,1495.89,2899.11,0.00
2024-12-10 17:19:25,126,2553,66,60,1496.83,2899.41,0.00
2024-12-10 17:19:25,126,2554,66,60,1502.99,2900.00,0.00
2024-12-10 17:19:25,127,2554,66,61,1491.15,2900.01,0.00
2024-12-10 17:19:25,126,2554,65,61,1499.81,2900.11,0.00
2024-12-10 17:19:25,126,2555,65,61,1496.16,2901.00,0.00
2024-12-10 17:19:25,127,2555,65,62,1484.38,2901.01,0.00
2024-12-10 17:19:25,126,2555,64,62,1492.98,2901.11,0.00
2024-12-10 17:19:25,127,2554,64,63,1477.36,2901.26,0.00
2024-12-10 17:19:25,127,2555,64,63,1494.72,2902.00,0.00
2024-12-10 17:19:25,128,2555,64,64,1483.04,2902.01,0.00
2024-12-10 17:19:25,127,2555,63,64,1493.13,2902.06,0.00
2024-12-10 17:19:25,126,2555,63,63,1503.17,2902.11,0.00
2024-12-10 17:19:25,127,2554,64,63,1487.02,2902.28,0.00
2024-12-10 17:19:25,128,2553,64,64,1490.85,2902.35,0.00
2024-12-10 17:19:25,127,2553,63,64,1511.49,2902.54,0.00
2024-12-10 17:19:25,127,2554,63,64,1544.28,2903.00,0.00
2024-12-10 17:19:25,128,2554,64,64,1532.22,2903.01,0.00
2024-12-10 17:19:25,127,2554,63,64,1540.82,2903.13,0.00
2024-12-10 17:19:25,127,2555,63,64,1583.95,2904.00,0.00
2024-12-10 17:19:25,128,2555,63,65,1571.58,2904.01,0.00
2024-12-10 17:19:25,128,2556,63,65,1564.06,2905.00,0.00
2024-12-10 17:19:25,129,2556,63,66,1551.93,2905.01,0.00
2024-12-10 17:19:25,128,2556,62,66,1560.92,2905.11,0.00
2024-12-10 17:19:25,129,2555,62,67,1538.89,2905.36,0.00
2024-12-10 17:19:25,129,2556,62,67,1557.08,2906.00,0.00
2024-12-10 17:19:25,130,2556,62,68,1545.10,2906.01,0.00
2024-12-10 17:19:25,129,2556,61,68,1547.44,2906.26,0.00
2024-12-10 17:19:25,130,2555,62,68,1535.10,2906.29,0.00
2024-12-10 17:19:25,130,2556,62,68,1572.69,2907.00,0.00
2024-12-10 17:19:25,131,2556,62,69,1560.68,2907.01,0.00
2024-12-10 17:19:25,131,2557,62,69,1571.35,2908.00,0.00
2024-12-10 17:19:25,132,2557,63,69,1559.45,2908.01,0.00
2024-12-10 17:19:25,131,2557,62,69,1568.06,2908.12,0.00
2024-12-10 17:19:25,131,2558,62,69,1558.33,2909.00,0.00
2024-12-10 17:19:25,132,2558,62,70,1546.52,2909.01,0.00
2024-12-10 17:19:25,132,2559,62,70,1531.67,2910.00,0.00
2024-12-10 17:19:25,133,2559,63,70,1520.16,2910.01,0.00
2024-12-10 17:19:25,132,2559,63,69,1528.40,2910.11,0.00
2024-12-10 17:19:25,131,2559,63,68,1539.62,2910.13,0.00
2024-12-10 17:19:25,130,2559,62,68,1540.64,2910.40,0.00
2024-12-10 17:19:25,129,2559,62,67,1549.93,2910.40,0.00
2024-12-10 17:19:25,129,2560,62,67,1554.59,2911.00,0.00
2024-12-10 17:19:25,130,2560,63,67,1542.63,2911.01,0.00
2024-12-10 17:19:25,129,2560,62,67,1542.45,2911.38,0.00
2024-12-10 17:19:25,129,2561,62,67,1546.07,2912.00,0.00
2024-12-10 17:19:25,130,2561,62,68,1534.18,2912.01,0.00
2024-12-10 17:19:25,129,2561,62,67,1542.72,2912.12,0.00
2024-12-10 17:19:25,128,2561,62,66,1551.83,2912.22,0.00
2024-12-10 17:19:25,128,2562,62,66,1550.16,2913.00,0.00
2024-12-10 17:19:25,129,2562,62,67,1538.14,2913.01,0.00
2024-12-10 17:19:25,128,2562,61,67,1549.48,2913.02,0.00
2024-12-10 17:19:25,127,2562,60,67,1558.96,2913.11,0.00
2024-12-10 17:19:25,127,2563,60,67,1553.33,2914.00,0.00
2024-12-10 17:19:25,128,2563,61,67,1541.19,2914.01,0.00
2024-12-10 17:19:25,127,2563,61,66,1550.15,2914.11,0.00
2024-12-10 17:19:25,126,2563,60,66,1562.22,2914.11,0.00
2024-12-10 17:19:25,126,2564,60,66,1555.97,2915.00,0.00
2024-12-10 17:19:25,127,2564,60,67,1543.72,2915.01,0.00
2024-12-10 17:19:25,126,2564,59,67,1554.36,2915.06,0.00
2024-12-10 17:19:25,125,2564,58,67,1565.18,2915.10,0.00
2024-12-10 17:19:25,124,2564,58,66,1577.57,2915.11,0.00
2024-12-10 17:19:25,124,2565,58,66,1570.60,2916.00,0.00
2024-12-10 17:19:25,125,2565,58,67,1558.03,2916.01,0.00
2024-12-10 17:19:25,124,2565,57,67,1567.57,2916.11,0.00
2024-12-10 17:19:25,124,2566,57,67,1559.98,2917.00,0.00
2024-12-10 17:19:25,125,2566,57,68,1547.50,2917.01,0.00
2024-12-10 17:19:25,124,2566,57,67,1556.96,2917.11,0.00
2024-12-10 17:19:25,124,2567,57,67,1548.73,2918.00,0.00
2024-12-10 17:19:25,125,2567,58,67,1536.34,2918.01,0.00
2024-12-10 17:19:25,124,2567,57,67,1542.16,2918.20,0.00
2024-12-10 17:19:25,124,2568,57,67,1540.67,2919.00,0.00
2024-12-10 17:19:25,125,2568,57,68,1528.35,2919.01,0.00
2024-12-10 17:19:25,124,2568,56,68,1537.64,2919.11,0.00
2024-12-10 17:19:25,123,2568,55,68,1532.60,2919.72,0.00
2024-12-10 17:19:25,123,2569,55,68,1546.82,2920.00,0.00
2024-12-10 17:19:25,124,2569,55,69,1534.34,2920.01,0.00
2024-12-10 17:19:25,124,2570,55,69,1526.56,2921.00,0.00
2024-12-10 17:19:25,125,2570,55,70,1514.35,2921.01,0.00
2024-12-10 17:19:25,124,2570,54,70,1523.76,2921.10,0.00
2024-12-10 17:19:25,123,2570,53,70,1535.68,2921.11,0.00
2024-12-10 17:19:25,122,2570,52,70,1548.03,2921.11,0.00
2024-12-10 17:19:25,122,2571,52,70,1542.28,2922.00,0.00
2024-12-10 17:19:25,123,2571,52,71,1529.74,2922.01,0.00
2024-12-10 17:19:25,123,2572,52,71,1520.06,2923.00,0.00
2024-12-10 17:19:25,124,2572,52,72,1507.81,2923.01,0.00
2024-12-10 17:19:25,123,2572,52,71,1495.37,2923.82,0.00
2024-12-10 17:19:25,123,2573,52,71,1514.06,2924.00,0.00
2024-12-10 17:19:25,124,2573,52,72,1501.85,2924.01,0.00
2024-12-10 17:19:25,125,2572,53,72,1488.21,2924.08,0.00
2024-12-10 17:19:25,125,2573,53,72,1497.83,2925.00,0.00
2024-12-10 17:19:25,126,2573,53,73,1485.95,2925.01,0.00
2024-12-10 17:19:25,126,2574,53,73,1503.87,2926.00,0.00
2024-12-10 17:19:25,127,2574,53,74,1492.03,2926.01,0.00
2024-12-10 17:19:26,127,2575,53,74,1486.55,2927.00,0.00
2024-12-10 17:19:26,128,2575,54,74,1474.93,2927.01,0.00
2024-12-10 17:19:26,127,2575,53,74,1483.13,2927.12,0.00
2024-12-10 17:19:26,127,2576,53,74,1480.83,2928.00,0.00
2024-12-10 17:19:26,128,2576,54,74,1469.26,2928.01,0.00
2024-12-10 17:19:26,128,2577,54,74,1463.58,2929.00,0.00
2024-12-10 17:19:26,129,2577,54,75,1452.24,2929.01,0.00
2024-12-10 17:19:26,130,2576,54,76,1440.84,2929.03,0.00
2024-12-10 17:19:26,131,2575,55,76,1441.55,2929.34,0.00
2024-12-10 17:19:26,132,2574,56,76,1435.93,2929.74,0.00
2024-12-10 17:19:26,132,2575,56,76,1457.23,2930.00,0.00
2024-12-10 17:19:26,133,2575,56,77,1446.27,2930.01,0.00
2024-12-10 17:19:26,132,2575,55,77,1453.94,2930.11,0.00
2024-12-10 17:19:26,133,2574,56,77,1435.15,2930.40,0.00
2024-12-10 17:19:26,133,2575,56,77,1520.81,2931.00,0.00
2024-12-10 17:19:26,134,2575,56,78,1509.46,2931.01,0.00
2024-12-10 17:19:26,134,2576,56,78,1524.64,2932.00,0.00
2024-12-10 17:19:26,135,2576,56,79,1513.35,2932.01,0.00
2024-12-10 17:19:26,134,2576,56,78,1520.97,2932.13,0.00
2024-12-10 17:19:26,135,2575,56,79,1505.81,2932.27,0.00
2024-12-10 17:19:26,135,2576,56,79,1524.51,2933.00,0.00
2024-12-10 17:19:26,136,2576,56,80,1513.30,2933.01,0.00
2024-12-10 17:19:26,136,2577,56,80,1527.84,2934.00,0.00
2024-12-10 17:19:26,137,2577,57,80,1516.68,2934.01,0.00
2024-12-10 17:19:26,136,2577,57,79,1524.21,2934.13,0.00
2024-12-10 17:19:26,137,2576,57,80,1510.10,2934.24,0.00
2024-12-10 17:19:26,138,2575,58,80,1517.45,2934.25,0.00
2024-12-10 17:19:26,138,2576,58,80,1535.34,2935.00,0.00
2024-12-10 17:19:26,139,2576,59,80,1524.30,2935.01,0.00
2024-12-10 17:19:26,138,2576,58,80,1533.45,2935.07,0.00
2024-12-10 17:19:26,137,2576,57,80,1542.95,2935.12,0.00
2024-12-10 17:19:26,137,2577,57,80,1581.39,2936.00,0.00
2024-12-10 17:19:26,138,2577,58,80,1569.93,2936.01,0.00
2024-12-10 17:19:26,137,2577,58,79,1578.00,2936.12,0.00
2024-12-10 17:19:26,136,2577,58,78,1589.39,2936.12,0.00
2024-12-10 17:19:26,136,2578,58,78,1584.17,2937.00,0.00
2024-12-10 17:19:26,137,2578,58,79,1572.61,2937.01,0.00
2024-12-10 17:19:26,137,2579,58,79,1562.90,2938.00,0.00
2024-12-10 17:19:26,138,2579,59,79,1551.58,2938.01,0.00
2024-12-10 17:19:26,137,2579,58,79,1559.30,2938.12,0.00
2024-12-10 17:19:26,136,2579,58,78,1564.36,2938.29,0.00
2024-12-10 17:19:26,136,2580,58,78,1564.89,2939.00,0.00
2024-12-10 17:19:26,137,2580,59,78,1553.47,2939.01,0.00
2024-12-10 17:19:26,136,2580,59,77,1561.26,2939.13,0.00
2024-12-10 17:19:26,136,2581,59,77,1556.70,2940.00,0.00
2024-12-10 17:19:26,137,2581,60,77,1545.34,2940.01,0.00
2024-12-10 17:19:26,136,2581,59,77,1555.84,2940.03,0.00
2024-12-10 17:19:26,135,2581,58,77,1564.57,2940.12,0.00
2024-12-10 17:19:26,134,2581,58,76,1576.03,2940.12,0.00
2024-12-10 17:19:26,134,2582,58,76,1571.53,2941.00,0.00
2024-12-10 17:19:26,135,2582,59,76,1559.89,2941.01,0.00
2024-12-10 17:19:26,134,2582,58,76,1568.06,2941.12,0.00
2024-12-10 17:19:26,135,2581,58,77,1544.37,2941.51,0.00
2024-12-10 17:19:26,135,2582,58,77,1563.91,2942.00,0.00
2024-12-10 17:19:26,136,2582,59,77,1552.41,2942.01,0.00
2024-12-10 17:19:26,135,2582,58,77,1553.07,2942.33,0.00
2024-12-10 17:19:26,136,2581,59,77,1533.34,2942.63,0.00
2024-12-10 17:19:26,136,2582,59,77,1574.53,2943.00,0.00
2024-12-10 17:19:26,137,2582,59,78,1563.04,2943.01,0.00
2024-12-10 17:19:26,136,2582,58,78,1573.89,2943.02,0.00
2024-12-10 17:19:26,135,2582,57,78,1582.53,2943.12,0.00
2024-12-10 17:19:26,134,2582,56,78,1594.12,2943.12,0.00
2024-12-10 17:19:26,134,2583,56,78,1611.24,2944.00,0.00
2024-12-10 17:19:26,135,2583,56,79,1599.30,2944.01,0.00
2024-12-10 17:19:26,135,2584,56,79,1589.91,2945.00,0.00
2024-12-10 17:19:26,136,2584,56,80,1578.22,2945.01,0.00
2024-12-10 17:19:26,135,2584,56,79,1586.46,2945.12,0.00
2024-12-10 17:19:26,134,2584,55,79,1591.82,2945.30,0.00
2024-12-10 17:19:26,134,2585,55,79,1592.85,2946.00,0.00
2024-12-10 17:19:26,135,2585,55,80,1581.05,2946.01,0.00
2024-12-10 17:19:26,134,2585,54,80,1589.37,2946.12,0.00
2024-12-10 17:19:26,134,2586,54,80,1584.85,2947.00,0.00
2024-12-10 17:19:26,135,2586,55,80,1573.11,2947.01,0.00
2024-12-10 17:19:26,134,2586,55,79,1584.63,2947.01,0.00
2024-12-10 17:19:26,133,2586,55,78,1595.66,2947.03,0.00
2024-12-10 17:19:26,133,2587,55,78,1588.46,2948.00,0.00
2024-12-10 17:19:26,134,2587,56,78,1576.61,2948.01,0.00
2024-12-10 17:19:26,134,2588,56,78,1568.37,2949.00,0.00
2024-12-10 17:19:26,135,2588,57,78,1556.75,2949.01,0.00
2024-12-10 17:19:26,134,2588,56,78,1567.71,2949.02,0.00
2024-12-10 17:19:26,133,2588,56,77,1576.66,2949.11,0.00
2024-12-10 17:19:26,132,2588,56,76,1580.23,2949.34,0.00
2024-12-10 17:19:26,132,2589,56,76,1583.58,2950.00,0.00
2024-12-10 17:19:26,133,2589,56,77,1571.67,2950.01,0.00
2024-12-10 17:19:26,132,2589,56,76,1580.06,2950.12,0.00
2024-12-10 17:19:26,133,2588,57,76,1560.49,2950.35,0.00
2024-12-10 17:19:26,133,2589,57,76,1579.79,2951.00,0.00
2024-12-10 17:19:26,134,2589,57,77,1568.00,2951.01,0.00
2024-12-10 17:19:26,133,2589,57,76,1576.29,2951.12,0.00
2024-12-10 17:19:26,133,2590,57,76,1592.97,2952.00,0.00
2024-12-10 17:19:26,134,2590,58,76,1581.08,2952.01,0.00
2024-12-10 17:19:26,133,2590,58,75,1589.47,2952.12,0.00
2024-12-10 17:19:26,132,2590,58,74,1596.39,2952.24,0.00
2024-12-10 17:19:26,132,2591,58,74,1596.63,2953.00,0.00
2024-12-10 17:19:26,133,2591,58,75,1584.63,2953.01,0.00
2024-12-10 17:19:26,132,2591,58,74,1596.19,2953.02,0.00
2024-12-10 17:19:26,131,2591,58,73,1605.05,2953.12,0.00
2024-12-10 17:19:26,132,2590,58,74,1580.72,2953.55,0.00
2024-12-10 17:19:26,132,2591,58,74,1600.75,2954.00,0.00
2024-12-10 17:19:27,133,2591,58,75,1588.72,2954.01,0.00
2024-12-10 17:19:27,132,2591,57,75,1597.23,2954.12,0.00
2024-12-10 17:19:27,132,2592,57,75,1616.52,2955.00,0.00
2024-12-10 17:19:27,133,2592,57,76,1604.36,2955.01,0.00
2024-12-10 17:19:27,132,2592,56,76,1612.99,2955.12,0.00
2024-12-10 17:19:27,132,2593,56,76,1609.74,2956.00,0.00
2024-12-10 17:19:27,133,2593,57,76,1597.63,2956.01,0.00
2024-12-10 17:19:27,132,2593,57,75,1606.21,2956.12,0.00
2024-12-10 17:19:27,132,2594,57,75,1602.66,2957.00,0.00
2024-12-10 17:19:27,133,2594,58,75,1590.61,2957.01,0.00
2024-12-10 17:19:27,132,2594,58,74,1599.13,2957.12,0.00
2024-12-10 17:19:27,132,2595,58,74,1595.21,2958.00,0.00
2024-12-10 17:19:27,133,2595,58,75,1583.22,2958.01,0.00
2024-12-10 17:19:27,132,2595,58,74,1591.68,2958.12,0.00
2024-12-10 17:19:27,131,2595,57,74,1601.82,2958.18,0.00
2024-12-10 17:19:27,131,2596,57,74,1600.03,2959.00,0.00
2024-12-10 17:19:27,132,2596,57,75,1587.91,2959.01,0.00
2024-12-10 17:19:27,133,2595,58,75,1575.54,2959.04,0.00
2024-12-10 17:19:27,133,2596,58,75,1586.56,2960.00,0.00
2024-12-10 17:19:27,134,2596,59,75,1574.72,2960.01,0.00
2024-12-10 17:19:27,133,2596,59,74,1585.69,2960.03,0.00
2024-12-10 17:19:27,134,2595,60,74,1572.98,2960.08,0.00
2024-12-10 17:19:27,133,2595,59,74,1595.07,2960.12,0.00
2024-12-10 17:19:27,132,2595,59,73,1606.93,2960.12,0.00
2024-12-10 17:19:27,132,2596,59,73,1625.01,2961.00,0.00
2024-12-10 17:19:27,133,2596,59,74,1612.79,2961.01,0.00
2024-12-10 17:19:27,132,2596,59,73,1621.71,2961.11,0.00
2024-12-10 17:19:27,132,2597,59,73,1639.25,2962.00,0.00
2024-12-10 17:19:27,133,2597,60,73,1626.93,2962.01,0.00
2024-12-10 17:19:27,133,2598,60,73,1618.70,2963.00,0.00
2024-12-10 17:19:27,134,2598,61,73,1606.62,2963.01,0.00
2024-12-10 17:19:27,133,2598,61,72,1615.20,2963.12,0.00
2024-12-10 17:19:27,133,2599,61,72,1610.20,2964.00,0.00
2024-12-10 17:19:27,134,2599,61,73,1598.18,2964.01,0.00
2024-12-10 17:19:27,133,2599,61,72,1608.66,2964.05,0.00
2024-12-10 17:19:27,132,2599,61,71,1618.87,2964.11,0.00
2024-12-10 17:19:27,131,2599,60,71,1631.00,2964.12,0.00
2024-12-10 17:19:27,131,2600,60,71,1626.10,2965.00,0.00
2024-12-10 17:19:27,132,2600,60,72,1613.78,2965.01,0.00
2024-12-10 17:19:27,132,2601,60,72,1605.08,2966.00,0.00
2024-12-10 17:19:27,133,2601,61,72,1593.01,2966.01,0.00
2024-12-10 17:19:27,132,2601,61,71,1599.41,2966.16,0.00
2024-12-10 17:19:27,132,2602,61,71,1595.67,2967.00,0.00
2024-12-10 17:19:27,133,2602,62,71,1583.67,2967.01,0.00
2024-12-10 17:19:27,133,2603,62,71,1575.15,2968.00,0.00
2024-12-10 17:19:27,134,2603,62,72,1563.39,2968.01,0.00
2024-12-10 17:19:27,133,2603,61,72,1565.97,2968.26,0.00
2024-12-10 17:19:27,134,2602,61,73,1550.56,2968.40,0.00
2024-12-10 17:19:27,135,2601,62,73,1544.57,2968.41,0.00
2024-12-10 17:19:27,135,2602,62,73,1563.45,2969.00,0.00
2024-12-10 17:19:27,136,2602,62,74,1551.96,2969.01,0.00
2024-12-10 17:19:27,135,2602,62,73,1560.21,2969.11,0.00
2024-12-10 17:19:27,134,2602,61,73,1571.63,2969.11,0.00
2024-12-10 17:19:27,134,2603,61,73,1612.22,2970.00,0.00
2024-12-10 17:19:27,135,2603,61,74,1600.28,2970.01,0.00
2024-12-10 17:19:27,134,2603,61,73,1608.95,2970.11,0.00
2024-12-10 17:19:27,134,2604,61,73,1605.23,2971.00,0.00
2024-12-10 17:19:27,135,2604,61,74,1593.34,2971.01,0.00
2024-12-10 17:19:27,134,2604,60,74,1601.95,2971.11,0.00
2024-12-10 17:19:27,134,2605,60,74,1598.23,2972.00,0.00
2024-12-10 17:19:27,135,2605,61,74,1586.39,2972.01,0.00
2024-12-10 17:19:27,136,2604,61,75,1573.65,2972.06,0.00
2024-12-10 17:19:27,137,2603,62,75,1577.14,2972.07,0.00
2024-12-10 17:19:27,136,2603,61,75,1589.42,2972.13,0.00
2024-12-10 17:19:27,136,2604,61,75,1585.75,2973.00,0.00
2024-12-10 17:19:27,137,2604,62,75,1574.17,2973.01,0.00
2024-12-10 17:19:27,136,2604,61,75,1584.67,2973.04,0.00
2024-12-10 17:19:27,135,2604,60,75,1594.24,2973.10,0.00
2024-12-10 17:19:27,136,2603,60,76,1564.20,2973.74,0.00
2024-12-10 17:19:27,136,2604,60,76,1628.26,2974.00,0.00
2024-12-10 17:19:27,137,2604,60,77,1616.38,2974.01,0.00
2024-12-10 17:19:27,136,2604,59,77,1625.26,2974.10,0.00
2024-12-10 17:19:27,137,2603,59,78,1606.08,2974.37,0.00
2024-12-10 17:19:27,137,2604,59,78,1645.59,2975.00,0.00
2024-12-10 17:19:27,138,2604,59,79,1633.66,2975.01,0.00
2024-12-10 17:19:27,137,2604,59,78,1642.60,2975.10,0.00
2024-12-10 17:19:27,137,2605,59,78,1659.83,2976.00,0.00
2024-12-10 17:19:27,138,2605,59,79,1647.80,2976.01,0.00
2024-12-10 17:19:27,137,2605,59,78,1656.84,2976.10,0.00
2024-12-10 17:19:27,137,2606,59,78,1652.34,2977.00,0.00
2024-12-10 17:19:27,138,2606,60,78,1640.37,2977.01,0.00
2024-12-10 17:19:27,137,2606,59,78,1648.67,2977.10,0.00
2024-12-10 17:19:27,137,2607,59,78,1644.17,2978.00,0.00
2024-12-10 17:19:27,138,2607,59,79,1632.25,2978.01,0.00
2024-12-10 17:19:27,138,2608,59,79,1624.57,2979.00,0.00
2024-12-10 17:19:27,139,2608,60,79,1612.88,2979.01,0.00
2024-12-10 17:19:27,138,2608,59,79,1621.39,2979.11,0.00
2024-12-10 17:19:27,137,2608,58,79,1633.01,2979.11,0.00
2024-12-10 17:19:27,138,2607,58,80,1617.94,2979.23,0.00
2024-12-10 17:19:27,138,2608,58,80,1634.83,2980.00,0.00
2024-12-10 17:19:27,139,2608,59,80,1623.07,2980.01,0.00
2024-12-10 17:19:28,138,2608,59,79,1631.65,2980.11,0.00
2024-12-10 17:19:28,138,2609,59,79,1648.78,2981.00,0.00
2024-12-10 17:19:28,139,2609,60,79,1636.91,2981.01,0.00
2024-12-10 17:19:28,138,2609,59,79,1645.59,2981.11,0.00
2024-12-10 17:19:28,138,2610,59,79,1641.12,2982.00,0.00
2024-12-10 17:19:28,139,2610,60,79,1629.31,2982.01,0.00
2024-12-10 17:19:28,138,2610,60,78,1637.93,2982.11,0.00
2024-12-10 17:19:28,138,2611,60,78,1633.45,2983.00,0.00
2024-12-10 17:19:28,139,2611,60,79,1621.70,2983.01,0.00
2024-12-10 17:19:28,138,2611,60,78,1630.26,2983.11,0.00
2024-12-10 17:19:28,138,2612,60,78,1625.63,2984.00,0.00
2024-12-10 17:19:28,139,2612,61,78,1613.93,2984.01,0.00
2024-12-10 17:19:28,140,2611,61,79,1599.47,2984.12,0.00
2024-12-10 17:19:28,140,2612,61,79,1615.69,2985.00,0.00
2024-12-10 17:19:28,141,2612,61,80,1604.23,2985.01,0.00
2024-12-10 17:19:28,142,2611,62,80,1591.07,2985.08,0.00
2024-12-10 17:19:28,141,2611,62,79,1610.93,2985.12,0.00
2024-12-10 17:19:28,141,2612,62,79,1627.05,2986.00,0.00
2024-12-10 17:19:28,142,2612,62,80,1615.59,2986.01,0.00
2024-12-10 17:19:28,142,2613,62,80,1627.14,2987.00,0.00
2024-12-10 17:19:28,143,2613,63,80,1615.76,2987.01,0.00
2024-12-10 17:19:28,142,2613,62,80,1622.60,2987.11,0.00
2024-12-10 17:19:28,142,2614,62,80,1617.29,2988.00,0.00
2024-12-10 17:19:28,143,2614,62,81,1605.98,2988.01,0.00
2024-12-10 17:19:28,142,2614,61,81,1615.63,2988.06,0.00
2024-12-10 17:19:28,141,2614,61,80,1624.03,2988.11,0.00
2024-12-10 17:19:28,141,2615,61,80,1618.75,2989.00,0.00
2024-12-10 17:19:28,142,2615,61,81,1607.35,2989.01,0.00
2024-12-10 17:19:28,141,2615,61,80,1614.21,2989.11,0.00
2024-12-10 17:19:28,142,2614,62,80,1595.96,2989.35,0.00
2024-12-10 17:19:28,142,2615,62,80,1612.38,2990.00,0.00
2024-12-10 17:19:28,143,2615,63,80,1601.11,2990.01,0.00
2024-12-10 17:19:28,142,2615,62,80,1607.88,2990.11,0.00
2024-12-10 17:19:28,142,2616,62,80,1623.55,2991.00,0.00
2024-12-10 17:19:28,143,2616,62,81,1612.20,2991.01,0.00
2024-12-10 17:19:28,142,2616,62,80,1619.00,2991.11,0.00
2024-12-10 17:19:28,142,2617,62,80,1613.60,2992.00,0.00
2024-12-10 17:19:28,143,2617,63,80,1602.32,2992.01,0.00
2024-12-10 17:19:28,142,2617,62,80,1608.98,2992.11,0.00
2024-12-10 17:19:28,142,2618,62,80,1603.29,2993.00,0.00
2024-12-10 17:19:28,143,2618,63,80,1592.08,2993.01,0.00
2024-12-10 17:19:28,142,2618,62,80,1598.46,2993.11,0.00
2024-12-10 17:19:28,142,2619,62,80,1592.50,2994.00,0.00
2024-12-10 17:19:28,143,2619,62,81,1581.36,2994.01,0.00
2024-12-10 17:19:28,144,2618,63,81,1569.15,2994.06,0.00
2024-12-10 17:19:28,143,2618,62,81,1594.94,2994.11,0.00
2024-12-10 17:19:28,143,2619,62,81,1588.82,2995.00,0.00
2024-12-10 17:19:28,144,2619,63,81,1577.79,2995.01,0.00
2024-12-10 17:19:28,145,2618,64,81,1565.49,2995.07,0.00
2024-12-10 17:19:28,144,2618,64,80,1584.97,2995.11,0.00
2024-12-10 17:19:28,145,2617,64,81,1565.17,2995.42,0.00
2024-12-10 17:19:28,145,2618,64,81,1601.61,2996.00,0.00
2024-12-10 17:19:28,146,2618,65,81,1590.64,2996.01,0.00
2024-12-10 17:19:28,145,2618,64,81,1597.18,2996.10,0.00
2024-12-10 17:19:28,145,2619,64,81,1630.67,2997.00,0.00
2024-12-10 17:19:28,146,2619,64,82,1619.50,2997.01,0.00
2024-12-10 17:19:28,145,2619,63,82,1627.63,2997.10,0.00
2024-12-10 17:19:28,145,2620,63,82,1619.41,2998.00,0.00
2024-12-10 17:19:28,146,2620,64,82,1608.32,2998.01,0.00
2024-12-10 17:19:28,145,2620,64,81,1616.37,2998.10,0.00
2024-12-10 17:19:28,146,2619,65,81,1605.30,2998.12,0.00
2024-12-10 17:19:28,146,2620,65,81,1610.77,2999.00,0.00
2024-12-10 17:19:28,147,2620,66,81,1599.81,2999.01,0.00
2024-12-10 17:19:28,147,2621,66,81,1607.90,3000.00,0.00
2024-12-10 17:19:28,148,2621,66,82,1597.03,3000.01,0.00
2024-12-10 17:19:28,147,2621,66,81,1604.69,3000.11,0.00
2024-12-10 17:19:28,146,2621,66,80,1611.32,3000.25,0.00
2024-12-10 17:19:28,146,2622,66,80,1606.70,3001.00,0.00
2024-12-10 17:19:28,147,2622,67,80,1595.77,3001.01,0.00
2024-12-10 17:19:28,146,2622,67,79,1605.89,3001.03,0.00
2024-12-10 17:19:28,145,2622,67,78,1614.53,3001.10,0.00
2024-12-10 17:19:28,144,2622,67,77,1625.53,3001.10,0.00
2024-12-10 17:19:28,144,2623,67,77,1616.30,3002.00,0.00
2024-12-10 17:19:28,145,2623,68,77,1605.15,3002.01,0.00
2024-12-10 17:19:28,144,2623,68,76,1612.91,3002.10,0.00
2024-12-10 17:19:28,144,2624,68,76,1602.95,3003.00,0.00
2024-12-10 17:19:28,145,2624,69,76,1591.90,3003.01,0.00
2024-12-10 17:19:28,145,2625,69,76,1577.49,3004.00,0.00
2024-12-10 17:19:28,146,2625,69,77,1566.69,3004.01,0.00
2024-12-10 17:19:28,145,2625,69,76,1572.94,3004.12,0.00
2024-12-10 17:19:28,144,2625,68,76,1565.00,3004.72,0.00
2024-12-10 17:19:28,143,2625,68,75,1571.81,3004.83,0.00
2024-12-10 17:19:28,143,2626,68,75,1587.72,3005.00,0.00
2024-12-10 17:19:28,144,2626,68,76,1576.70,3005.01,0.00
2024-12-10 17:19:28,143,2626,68,75,1582.83,3005.12,0.00
2024-12-10 17:19:28,144,2625,69,75,1568.70,3005.24,0.00
2024-12-10 17:19:28,144,2626,69,75,1584.02,3006.00,0.00
2024-12-10 17:19:28,145,2626,69,76,1573.10,3006.01,0.00
2024-12-10 17:19:28,144,2626,68,76,1578.80,3006.13,0.00
2024-12-10 17:19:28,144,2627,68,76,1593.83,3007.00,0.00
2024-12-10 17:19:28,145,2627,68,77,1582.84,3007.01,0.00
2024-12-10 17:19:29,146,2626,69,77,1571.38,3007.04,0.00
2024-12-10 17:19:29,145,2626,68,77,1587.87,3007.07,0.00
2024-12-10 17:19:29,144,2626,68,76,1596.84,3007.13,0.00
2024-12-10 17:19:29,144,2627,68,76,1590.52,3008.00,0.00
2024-12-10 17:19:29,145,2627,68,77,1579.55,3008.01,0.00
2024-12-10 17:19:29,144,2627,67,77,1586.83,3008.13,0.00
2024-12-10 17:19:29,145,2626,67,78,1573.98,3008.20,0.00
2024-12-10 17:19:29,144,2626,67,77,1586.55,3008.24,0.00
2024-12-10 17:19:29,144,2627,67,77,1605.75,3009.00,0.00
2024-12-10 17:19:29,145,2627,68,77,1594.67,3009.01,0.00
2024-12-10 17:19:29,146,2626,69,77,1582.13,3009.08,0.00
2024-12-10 17:19:29,145,2626,69,76,1607.61,3009.13,0.00
2024-12-10 17:19:29,145,2627,69,76,1623.15,3010.00,0.00
2024-12-10 17:19:29,146,2627,70,76,1612.04,3010.01,0.00
2024-12-10 17:19:29,145,2627,69,76,1619.49,3010.12,0.00
2024-12-10 17:19:29,145,2628,69,76,1634.83,3011.00,0.00
2024-12-10 17:19:29,146,2628,69,77,1623.63,3011.01,0.00
2024-12-10 17:19:29,145,2628,68,77,1631.16,3011.12,0.00
2024-12-10 17:19:29,145,2629,68,77,1625.76,3012.00,0.00
2024-12-10 17:19:29,146,2629,68,78,1614.62,3012.01,0.00
2024-12-10 17:19:29,145,2629,68,77,1622.09,3012.12,0.00
2024-12-10 17:19:29,145,2630,68,77,1616.68,3013.00,0.00
2024-12-10 17:19:29,146,2630,69,77,1605.61,3013.01,0.00
2024-12-10 17:19:29,145,2630,69,76,1613.01,3013.12,0.00
2024-12-10 17:19:29,145,2631,69,76,1607.03,3014.00,0.00
2024-12-10 17:19:29,146,2631,70,76,1596.02,3014.01,0.00
2024-12-10 17:19:29,145,2631,69,76,1603.21,3014.12,0.00
2024-12-10 17:19:29,144,2631,69,75,1614.18,3014.13,0.00
2024-12-10 17:19:29,144,2632,69,75,1607.53,3015.00,0.00
2024-12-10 17:19:29,145,2632,70,75,1596.45,3015.01,0.00
2024-12-10 17:19:29,145,2632,70,75,1585.10,3016.00,0.00
2024-12-10 17:19:29,146,2632,71,75,1574.24,3016.01,0.00
2024-12-10 17:19:29,145,2632,71,74,1581.42,3016.12,0.00
2024-12-10 17:19:29,145,2633,71,74,1572.37,3017.00,0.00
2024-12-10 17:19:29,146,2633,71,75,1561.60,3017.01,0.00
2024-12-10 17:19:29,146,2634,71,75,1547.66,3018.00,0.00
2024-12-10 17:19:29,147,2634,72,75,1537.13,3018.01,0.00
2024-12-10 17:19:29,146,2634,71,75,1544.00,3018.12,0.00
2024-12-10 17:19:29,146,2635,71,75,1532.44,3019.00,0.00
2024-12-10 17:19:29,147,2635,72,75,1522.01,3019.01,0.00
2024-12-10 17:19:29,146,2635,72,74,1516.19,3019.44,0.00
2024-12-10 17:19:29,145,2635,72,73,1524.96,3019.44,0.00
2024-12-10 17:19:29,145,2636,72,73,1529.11,3020.00,0.00
2024-12-10 17:19:29,146,2636,73,73,1518.64,3020.01,0.00
2024-12-10 17:19:29,145,2636,72,73,1528.76,3020.01,0.00
2024-12-10 17:19:29,144,2636,71,73,1529.88,3020.30,0.00
2024-12-10 17:19:29,144,2637,71,73,1528.00,3021.00,0.00
2024-12-10 17:19:29,145,2637,71,74,1517.46,3021.01,0.00
2024-12-10 17:19:29,146,2636,71,75,1505.65,3021.07,0.00
2024-12-10 17:19:29,145,2636,71,74,1516.08,3021.14,0.00
2024-12-10 17:19:29,144,2636,71,73,1516.66,3021.40,0.00
2024-12-10 17:19:29,144,2637,71,73,1518.96,3022.00,0.00
2024-12-10 17:19:29,145,2637,72,73,1508.49,3022.01,0.00
2024-12-10 17:19:29,144,2637,72,72,1515.05,3022.13,0.00
2024-12-10 17:19:29,144,2638,72,72,1528.30,3023.00,0.00
2024-12-10 17:19:29,145,2638,72,73,1517.76,3023.01,0.00
2024-12-10 17:19:29,144,2638,72,72,1524.38,3023.13,0.00
2024-12-10 17:19:29,143,2638,71,72,1531.24,3023.24,0.00
2024-12-10 17:19:29,143,2639,71,72,1526.16,3024.00,0.00
2024-12-10 17:19:29,144,2639,71,73,1515.57,3024.01,0.00
2024-12-10 17:19:29,143,2639,71,72,1522.21,3024.13,0.00
2024-12-10 17:19:29,142,2639,70,72,1532.72,3024.13,0.00
2024-12-10 17:19:29,141,2639,70,71,1536.15,3024.33,0.00
2024-12-10 17:19:29,141,2640,70,71,1534.05,3025.00,0.00
2024-12-10 17:19:29,142,2640,70,72,1523.25,3025.01,0.00
2024-12-10 17:19:29,141,2640,70,71,1525.56,3025.28,0.00
2024-12-10 17:19:29,141,2641,70,71,1521.34,3026.00,0.00
2024-12-10 17:19:29,142,2641,70,72,1510.62,3026.01,0.00
2024-12-10 17:19:29,141,2641,70,71,1517.32,3026.14,0.00
2024-12-10 17:19:29,141,2642,70,71,1506.91,3027.00,0.00
2024-12-10 17:19:29,142,2642,71,71,1496.29,3027.01,0.00
2024-12-10 17:19:29,141,2642,70,71,1502.89,3027.14,0.00
2024-12-10 17:19:29,141,2643,70,71,1490.85,3028.00,0.00
2024-12-10 17:19:29,142,2643,70,72,1480.35,3028.01,0.00
2024-12-10 17:19:29,141,2643,69,72,1486.84,3028.14,0.00
2024-12-10 17:19:29,140,2643,69,71,1486.63,3028.49,0.00
2024-12-10 17:19:29,139,2643,69,70,1496.18,3028.49,0.00
2024-12-10 17:19:29,139,2644,69,70,1498.23,3029.00,0.00
2024-12-10 17:19:29,140,2644,69,71,1487.53,3029.01,0.00
2024-12-10 17:19:29,139,2644,69,70,1498.01,3029.01,0.00
2024-12-10 17:19:29,138,2644,69,69,1504.98,3029.13,0.00
2024-12-10 17:19:29,137,2644,69,68,1515.74,3029.13,0.00
2024-12-10 17:19:29,136,2644,68,68,1526.66,3029.13,0.00
2024-12-10 17:19:29,135,2644,67,68,1537.75,3029.13,0.00
2024-12-10 17:19:29,135,2645,67,68,1527.51,3030.00,0.00
2024-12-10 17:19:29,136,2645,68,68,1516.28,3030.01,0.00
2024-12-10 17:19:29,137,2644,68,69,1504.99,3030.03,0.00
2024-12-10 17:19:29,136,2644,68,68,1519.65,3030.07,0.00
2024-12-10 17:19:29,137,2643,69,68,1507.03,3030.13,0.00
2024-12-10 17:19:29,136,2643,69,67,1522.36,3030.14,0.00
2024-12-10 17:19:29,137,2642,69,68,1510.14,3030.19,0.00
2024-12-10 17:19:29,137,2643,69,68,1519.49,3031.00,0.00
2024-12-10 17:19:29,138,2643,70,68,1508.48,3031.01,0.00
2024-12-10 17:19:29,137,2643,70,67,1515.58,3031.13,0.00
2024-12-10 17:19:29,136,2643,69,67,1510.53,3031.52,0.00
2024-12-10 17:19:29,135,2643,69,66,1514.51,3031.62,0.00
2024-12-10 17:19:29,135,2644,69,66,1588.67,3032.00,0.00
2024-12-10 17:19:29,136,2644,69,67,1576.99,3032.01,0.00
2024-12-10 17:19:29,135,2644,69,66,1584.43,3032.13,0.00
2024-12-10 17:19:29,134,2644,69,65,1596.03,3032.13,0.00
2024-12-10 17:19:29,134,2645,69,65,1581.88,3033.00,0.00
2024-12-10 17:19:29,135,2645,69,66,1570.16,3033.01,0.00
2024-12-10 17:19:29,134,2645,69,65,1577.26,3033.13,0.00
2024-12-10 17:19:30,133,2645,69,64,1577.70,3033.45,0.00
2024-12-10 17:19:30,133,2646,69,64,1572.85,3034.00,0.00
2024-12-10 17:19:30,134,2646,69,65,1561.12,3034.01,0.00
2024-12-10 17:19:30,133,2646,68,65,1567.77,3034.14,0.00
2024-12-10 17:19:30,134,2645,69,65,1548.75,3034.37,0.00
2024-12-10 17:19:30,133,2645,68,65,1552.12,3034.78,0.00
2024-12-10 17:19:30,133,2646,68,65,1566.74,3035.00,0.00
2024-12-10 17:19:30,134,2646,69,65,1555.05,3035.01,0.00
2024-12-10 17:19:30,133,2646,68,65,1561.49,3035.14,0.00
2024-12-10 17:19:30,132,2646,68,64,1555.63,3035.53,0.00
2024-12-10 17:19:30,132,2647,68,64,1582.69,3036.00,0.00
2024-12-10 17:19:30,133,2647,69,64,1570.79,3036.01,0.00
2024-12-10 17:19:30,132,2647,68,64,1577.15,3036.14,0.00
2024-12-10 17:19:30,131,2647,68,63,1579.08,3036.41,0.00
2024-12-10 17:19:30,131,2648,68,63,1578.73,3037.00,0.00
2024-12-10 17:19:30,132,2648,69,63,1566.77,3037.01,0.00
2024-12-10 17:19:30,131,2648,69,62,1572.55,3037.15,0.00
2024-12-10 17:19:30,130,2648,69,61,1563.98,3037.72,0.00
2024-12-10 17:19:30,130,2649,69,61,1576.95,3038.00,0.00
2024-12-10 17:19:30,131,2649,70,61,1564.91,3038.01,0.00
2024-12-10 17:19:30,130,2649,70,60,1571.19,3038.11,0.00
2024-12-10 17:19:30,129,2649,70,59,1580.03,3038.19,0.00
2024-12-10 17:19:30,129,2650,70,59,1577.01,3039.00,0.00
2024-12-10 17:19:30,130,2650,71,59,1564.88,3039.01,0.00
2024-12-10 17:19:30,129,2650,70,59,1572.83,3039.14,0.00
2024-12-10 17:19:30,129,2651,70,59,1566.81,3040.00,0.00
2024-12-10 17:19:30,130,2651,71,59,1554.76,3040.01,0.00
2024-12-10 17:19:30,129,2651,70,59,1562.64,3040.14,0.00
2024-12-10 17:19:30,128,2651,70,58,1573.82,3040.17,0.00
2024-12-10 17:19:30,128,2652,70,58,1567.43,3041.00,0.00
2024-12-10 17:19:30,129,2652,71,58,1555.28,3041.01,0.00
2024-12-10 17:19:30,128,2652,70,58,1563.22,3041.14,0.00
2024-12-10 17:19:30,127,2652,69,58,1556.41,3041.72,0.00
2024-12-10 17:19:30,127,2653,69,58,1566.87,3042.00,0.00
2024-12-10 17:19:30,128,2653,70,58,1554.63,3042.01,0.00
2024-12-10 17:19:30,127,2653,69,58,1562.63,3042.14,0.00
2024-12-10 17:19:30,126,2653,68,58,1574.79,3042.14,0.00
2024-12-10 17:19:30,126,2654,68,58,1563.97,3043.00,0.00
2024-12-10 17:19:30,127,2654,69,58,1551.66,3043.01,0.00
2024-12-10 17:19:30,126,2654,69,57,1559.28,3043.14,0.00
2024-12-10 17:19:30,127,2653,69,58,1537.57,3043.41,0.00
2024-12-10 17:19:30,127,2654,69,58,1548.17,3044.00,0.00
2024-12-10 17:19:30,128,2654,69,59,1536.07,3044.01,0.00
2024-12-10 17:19:30,127,2654,68,59,1536.18,3044.30,0.00
2024-12-10 17:19:30,127,2655,68,59,1545.33,3045.00,0.00
2024-12-10 17:19:30,128,2655,68,60,1533.26,3045.01,0.00
2024-12-10 17:19:30,127,2655,67,60,1508.60,3045.76,0.00
2024-12-10 17:19:30,127,2656,67,60,1514.18,3046.00,0.00
2024-12-10 17:19:30,128,2656,68,60,1502.35,3046.01,0.00
2024-12-10 17:19:30,128,2657,68,60,1469.93,3047.00,0.00
2024-12-10 17:19:30,129,2657,69,60,1458.54,3047.01,0.00
2024-12-10 17:19:30,128,2657,68,60,1463.40,3047.14,0.00
2024-12-10 17:19:30,127,2657,68,59,1455.46,3047.66,0.00
2024-12-10 17:19:30,127,2658,68,59,1446.49,3048.00,0.00
2024-12-10 17:19:30,128,2658,69,59,1435.19,3048.01,0.00
2024-12-10 17:19:30,127,2658,68,59,1439.79,3048.14,0.00
2024-12-10 17:19:30,126,2658,67,59,1427.57,3048.69,0.00
2024-12-10 17:19:30,125,2658,66,59,1434.87,3048.76,0.00
2024-12-10 17:19:30,124,2658,66,58,1445.44,3048.77,0.00
2024-12-10 17:19:30,124,2659,66,58,1448.56,3049.00,0.00
2024-12-10 17:19:30,125,2659,67,58,1436.97,3049.01,0.00
2024-12-10 17:19:30,124,2659,66,58,1441.67,3049.15,0.00
2024-12-10 17:19:30,123,2659,65,58,1417.13,3049.79,0.00
2024-12-10 17:19:30,122,2659,65,57,1423.21,3049.80,0.00
2024-12-10 17:19:30,122,2660,65,57,1440.75,3050.00,0.00
2024-12-10 17:19:30,123,2660,66,57,1429.04,3050.01,0.00
2024-12-10 17:19:30,122,2660,66,56,1436.56,3050.07,0.00
2024-12-10 17:19:30,121,2660,66,55,1445.95,3050.14,0.00
2024-12-10 17:19:30,120,2660,65,55,1457.74,3050.14,0.00
2024-12-10 17:19:30,119,2660,64,55,1458.37,3050.36,0.00
2024-12-10 17:19:30,118,2660,64,54,1443.79,3050.78,0.00
2024-12-10 17:19:30,118,2661,64,54,1461.20,3051.00,0.00
2024-12-10 17:19:30,119,2661,64,55,1448.92,3051.01,0.00
2024-12-10 17:19:30,120,2660,65,55,1434.04,3051.06,0.00
2024-12-10 17:19:30,120,2661,65,55,1430.87,3052.00,0.00
2024-12-10 17:19:30,121,2661,65,56,1419.05,3052.01,0.00
2024-12-10 17:19:30,120,2661,64,56,1424.98,3052.14,0.00
2024-12-10 17:19:30,119,2661,64,55,1415.00,3052.66,0.00
2024-12-10 17:19:30,119,2662,64,55,1447.23,3053.00,0.00
2024-12-10 17:19:30,120,2662,65,55,1435.17,3053.01,0.00
2024-12-10 17:19:30,119,2662,65,54,1446.92,3053.01,0.00
2024-12-10 17:19:30,118,2662,65,53,1455.76,3053.09,0.00
2024-12-10 17:19:30,117,2662,65,52,1466.92,3053.13,0.00
2024-12-10 17:19:30,116,2662,65,51,1479.30,3053.13,0.00
2024-12-10 17:19:30,115,2662,65,50,1465.83,3053.69,0.00
2024-12-10 17:19:30,115,2663,65,50,1478.52,3054.00,0.00
2024-12-10 17:19:30,116,2663,65,51,1465.78,3054.01,0.00
2024-12-10 17:19:30,115,2663,65,50,1460.44,3054.50,0.00
2024-12-10 17:19:30,114,2663,65,49,1469.53,3054.52,0.00
2024-12-10 17:19:30,114,2664,65,49,1470.75,3055.00,0.00
2024-12-10 17:19:30,115,2664,66,49,1457.96,3055.01,0.00
2024-12-10 17:19:30,116,2663,67,49,1433.95,3055.39,0.00
2024-12-10 17:19:30,115,2663,66,49,1455.50,3055.65,0.00
2024-12-10 17:19:30,115,2664,66,49,1460.64,3056.00,0.00
2024-12-10 17:19:30,116,2664,66,50,1448.05,3056.01,0.00
2024-12-10 17:19:30,115,2664,65,50,1456.50,3056.13,0.00
2024-12-10 17:19:30,115,2665,65,50,1468.20,3057.00,0.00
2024-12-10 17:19:30,116,2665,66,50,1455.55,3057.01,0.00
2024-12-10 17:19:30,115,2665,65,50,1463.85,3057.13,0.00
2024-12-10 17:19:30,114,2665,65,49,1451.36,3057.67,0.00
2024-12-10 17:19:30,114,2666,65,49,1459.90,3058.00,0.00
2024-12-10 17:19:30,115,2666,66,49,1447.21,3058.01,0.00
2024-12-10 17:19:30,114,2666,66,48,1455.08,3058.13,0.00
2024-12-10 17:19:30,115,2665,66,49,1440.53,3058.20,0.00
2024-12-10 17:19:30,116,2664,67,49,1428.60,3058.39,0.00
2024-12-10 17:19:30,115,2664,66,49,1453.29,3058.64,0.00
2024-12-10 17:19:30,115,2665,66,49,1459.39,3059.00,0.00
2024-12-10 17:19:30,116,2665,67,49,1446.81,3059.01,0.00
2024-12-10 17:19:30,115,2665,67,48,1453.57,3059.13,0.00
2024-12-10 17:19:30,114,2665,66,48,1466.05,3059.13,0.00
2024-12-10 17:19:30,113,2665,65,48,1478.00,3059.16,0.00
2024-12-10 17:19:30,114,2664,66,48,1435.80,3059.86,0.00
2024-12-10 17:19:30,115,2663,66,49,1422.91,3059.94,0.00
2024-12-10 17:19:31,115,2664,66,49,1501.66,3060.00,0.00
2024-12-10 17:19:31,116,2664,67,49,1488.72,3060.01,0.00
2024-12-10 17:19:31,115,2664,67,48,1501.23,3060.01,0.00
2024-12-10 17:19:31,114,2664,66,48,1507.44,3060.12,0.00
2024-12-10 17:19:31,113,2664,65,48,1520.51,3060.12,0.00
2024-12-10 17:19:31,112,2664,65,47,1512.05,3060.71,0.00
2024-12-10 17:19:31,112,2665,65,47,1578.15,3061.00,0.00
2024-12-10 17:19:31,113,2665,66,47,1564.19,3061.01,0.00
2024-12-10 17:19:31,112,2665,65,47,1575.49,3061.04,0.00
2024-12-10 17:19:31,111,2665,65,46,1585.88,3061.12,0.00
2024-12-10 17:19:31,111,2666,65,46,1576.69,3062.00,0.00
2024-12-10 17:19:31,112,2666,66,46,1562.62,3062.01,0.00
2024-12-10 17:19:31,111,2666,66,45,1570.78,3062.16,0.00
2024-12-10 17:19:31,111,2667,66,45,1561.32,3063.00,0.00
2024-12-10 17:19:31,112,2667,66,46,1547.38,3063.01,0.00
2024-12-10 17:19:31,112,2668,66,46,1529.49,3064.00,0.00
2024-12-10 17:19:31,113,2668,67,46,1515.96,3064.01,0.00
2024-12-10 17:19:31,112,2668,67,45,1524.67,3064.13,0.00
2024-12-10 17:19:31,112,2669,67,45,1510.82,3065.00,0.00
2024-12-10 17:19:31,113,2669,67,46,1497.45,3065.01,0.00
2024-12-10 17:19:31,114,2668,68,46,1482.31,3065.06,0.00
2024-12-10 17:19:31,113,2668,68,45,1516.08,3065.13,0.00
2024-12-10 17:19:31,113,2669,68,45,1502.64,3066.00,0.00
2024-12-10 17:19:31,114,2669,69,45,1489.46,3066.01,0.00
2024-12-10 17:19:31,113,2669,68,45,1487.60,3066.40,0.00
2024-12-10 17:19:31,114,2668,68,46,1463.28,3066.69,0.00
2024-12-10 17:19:31,114,2669,68,46,1521.18,3067.00,0.00
2024-12-10 17:19:31,115,2669,69,46,1507.95,3067.01,0.00
2024-12-10 17:19:31,114,2669,68,46,1518.52,3067.06,0.00
2024-12-10 17:19:31,113,2669,67,46,1530.08,3067.12,0.00
2024-12-10 17:19:31,114,2668,68,46,1479.94,3067.90,0.00
2024-12-10 17:19:31,114,2669,68,46,1529.63,3068.00,0.00
2024-12-10 17:19:31,115,2669,69,46,1516.33,3068.01,0.00
2024-12-10 17:19:31,114,2669,68,46,1526.89,3068.06,0.00
2024-12-10 17:19:31,113,2669,68,45,1538.80,3068.11,0.00
2024-12-10 17:19:31,112,2669,67,45,1552.27,3068.11,0.00
2024-12-10 17:19:31,112,2670,67,45,1561.03,3069.00,0.00
2024-12-10 17:19:31,113,2670,67,46,1547.21,3069.01,0.00
2024-12-10 17:19:31,113,2671,67,46,1522.36,3070.00,0.00
2024-12-10 17:19:31,114,2671,68,46,1509.01,3070.01,0.00
2024-12-10 17:19:31,113,2671,68,45,1500.37,3070.59,0.00
2024-12-10 17:19:31,113,2672,68,45,1496.23,3071.00,0.00
2024-12-10 17:19:31,114,2672,68,46,1483.11,3071.01,0.00
2024-12-10 17:19:31,113,2672,67,46,1493.53,3071.04,0.00
2024-12-10 17:19:31,112,2672,67,45,1498.82,3071.26,0.00
2024-12-10 17:19:31,111,2672,66,45,1489.87,3071.70,0.00
2024-12-10 17:19:31,110,2672,65,45,1501.23,3071.74,0.00
2024-12-10 17:19:31,110,2673,65,45,1512.33,3072.00,0.00
2024-12-10 17:19:31,111,2673,66,45,1498.71,3072.01,0.00
2024-12-10 17:19:31,110,2673,66,44,1512.05,3072.01,0.00
2024-12-10 17:19:31,109,2673,65,44,1523.15,3072.09,0.00
2024-12-10 17:19:31,108,2673,65,43,1536.97,3072.09,0.00
2024-12-10 17:19:31,109,2672,65,44,1522.30,3072.13,0.00
2024-12-10 17:19:31,109,2673,65,44,1531.30,3073.00,0.00
2024-12-10 17:19:31,110,2673,65,45,1517.38,3073.01,0.00
2024-12-10 17:19:31,109,2673,64,45,1528.28,3073.09,0.00
2024-12-10 17:19:31,108,2673,64,44,1525.90,3073.49,0.00
2024-12-10 17:19:31,107,2673,63,44,1520.86,3073.74,0.00
2024-12-10 17:19:31,107,2674,63,44,1565.40,3074.00,0.00
2024-12-10 17:19:31,108,2674,63,45,1550.91,3074.01,0.00
2024-12-10 17:19:31,107,2674,63,44,1562.00,3074.09,0.00
2024-12-10 17:19:31,108,2673,63,45,1535.09,3074.44,0.00
2024-12-10 17:19:31,108,2674,63,45,1549.03,3075.00,0.00
2024-12-10 17:19:31,109,2674,64,45,1534.82,3075.01,0.00
2024-12-10 17:19:31,108,2674,64,44,1545.03,3075.10,0.00
2024-12-10 17:19:31,107,2674,63,44,1535.41,3075.61,0.00
2024-12-10 17:19:31,107,2675,63,44,1566.34,3076.00,0.00
2024-12-10 17:19:31,108,2675,63,45,1551.84,3076.01,0.00
2024-12-10 17:19:31,107,2675,63,44,1561.98,3076.10,0.00
2024-12-10 17:19:31,108,2674,63,45,1538.72,3076.32,0.00
2024-12-10 17:19:31,107,2674,62,45,1561.90,3076.58,0.00
2024-12-10 17:19:31,107,2675,62,45,1561.73,3077.00,0.00
2024-12-10 17:19:31,108,2675,62,46,1547.27,3077.01,0.00
2024-12-10 17:19:31,107,2675,61,46,1552.69,3077.17,0.00
2024-12-10 17:19:31,106,2675,61,45,1556.48,3077.48,0.00
2024-12-10 17:19:31,106,2676,61,45,1583.33,3078.00,0.00
2024-12-10 17:19:31,107,2676,61,46,1568.53,3078.01,0.00
2024-12-10 17:19:31,106,2676,61,45,1578.60,3078.10,0.00
2024-12-10 17:19:31,105,2676,61,44,1560.45,3078.86,0.00
2024-12-10 17:19:31,105,2677,61,44,1585.49,3079.00,0.00
2024-12-10 17:19:31,106,2677,61,45,1570.53,3079.01,0.00
2024-12-10 17:19:31,105,2677,61,44,1580.84,3079.11,0.00
2024-12-10 17:19:31,104,2677,61,43,1577.57,3079.64,0.00
2024-12-10 17:19:31,104,2678,61,43,1591.32,3080.00,0.00
2024-12-10 17:19:31,105,2678,61,44,1576.16,3080.01,0.00
2024-12-10 17:19:31,104,2678,60,44,1587.37,3080.11,0.00
2024-12-10 17:19:31,103,2678,59,44,1577.69,3080.73,0.00
2024-12-10 17:19:31,103,2679,59,44,1595.30,3081.00,0.00
2024-12-10 17:19:31,104,2679,59,45,1579.96,3081.01,0.00
2024-12-10 17:19:31,103,2679,58,45,1591.78,3081.11,0.00
2024-12-10 17:19:31,104,2678,59,45,1568.52,3081.39,0.00
2024-12-10 17:19:31,104,2679,59,45,1567.32,3082.00,0.00
2024-12-10 17:19:31,105,2679,59,46,1552.39,3082.01,0.00
2024-12-10 17:19:31,104,2679,58,46,1563.53,3082.11,0.00
2024-12-10 17:19:31,103,2679,57,46,1542.24,3082.75,0.00
2024-12-10 17:19:31,103,2680,57,46,1592.25,3083.00,0.00
2024-12-10 17:19:31,104,2680,57,47,1576.94,3083.01,0.00
2024-12-10 17:19:31,104,2681,57,47,1555.02,3084.00,0.00
2024-12-10 17:19:31,105,2681,57,48,1540.21,3084.01,0.00
2024-12-10 17:19:31,104,2681,56,48,1550.43,3084.12,0.00
2024-12-10 17:19:31,103,2681,55,48,1541.73,3084.64,0.00
2024-12-10 17:19:31,103,2682,55,48,1545.37,3085.00,0.00
2024-12-10 17:19:31,104,2682,55,49,1530.51,3085.01,0.00
2024-12-10 17:19:31,103,2682,54,49,1522.90,3085.60,0.00
2024-12-10 17:19:31,102,2682,53,49,1535.75,3085.66,0.00
2024-12-10 17:19:31,102,2683,53,49,1542.07,3086.00,0.00
2024-12-10 17:19:31,103,2683,54,49,1527.10,3086.01,0.00
2024-12-10 17:19:31,102,2683,54,48,1537.64,3086.12,0.00
2024-12-10 17:19:31,103,2682,54,49,1510.57,3086.47,0.00
2024-12-10 17:19:31,102,2682,53,49,1535.51,3086.66,0.00
2024-12-10 17:19:31,101,2682,52,49,1543.06,3086.73,0.00
2024-12-10 17:19:31,101,2683,52,49,1565.59,3087.00,0.00
2024-12-10 17:19:31,102,2683,53,49,1550.24,3087.01,0.00
2024-12-10 17:19:31,101,2683,52,49,1560.05,3087.12,0.00
2024-12-10 17:19:31,100,2683,52,48,1568.45,3087.33,0.00
2024-12-10 17:19:31,101,2682,52,49,1548.99,3087.45,0.00
2024-12-10 17:19:32,101,2683,52,49,1606.20,3088.00,0.00
2024-12-10 17:19:32,102,2683,52,50,1590.45,3088.01,0.00
2024-12-10 17:19:32,101,2683,52,49,1598.58,3088.12,0.00
2024-12-10 17:19:32,101,2684,52,49,1626.18,3089.00,0.00
2024-12-10 17:19:32,102,2684,52,50,1610.24,3089.01,0.00
2024-12-10 17:19:32,101,2684,52,49,1624.63,3089.05,0.00
2024-12-10 17:19:32,100,2684,51,49,1633.92,3089.11,0.00
2024-12-10 17:19:32,100,2685,51,49,1629.28,3090.00,0.00
2024-12-10 17:19:32,101,2685,51,50,1613.15,3090.01,0.00
2024-12-10 17:19:32,100,2685,50,50,1619.53,3090.11,0.00
2024-12-10 17:19:32,99,2685,50,49,1611.00,3090.67,0.00
2024-12-10 17:19:32,99,2686,50,49,1632.19,3091.00,0.00
2024-12-10 17:19:32,100,2686,51,49,1615.87,3091.01,0.00
2024-12-10 17:19:32,99,2686,51,48,1624.48,3091.10,0.00
2024-12-10 17:19:32,99,2687,51,48,1621.58,3092.00,0.00
2024-12-10 17:19:32,100,2687,51,49,1605.36,3092.01,0.00
2024-12-10 17:19:32,99,2687,50,49,1615.32,3092.10,0.00
2024-12-10 17:19:32,99,2688,50,49,1610.94,3093.00,0.00
2024-12-10 17:19:32,100,2688,51,49,1594.83,3093.01,0.00
2024-12-10 17:19:32,99,2688,50,49,1604.53,3093.10,0.00
2024-12-10 17:19:32,100,2687,50,50,1554.72,3093.91,0.00
2024-12-10 17:19:32,100,2688,50,50,1585.12,3094.00,0.00
2024-12-10 17:19:32,101,2688,51,50,1569.43,3094.01,0.00
2024-12-10 17:19:32,100,2688,51,49,1584.81,3094.01,0.00
2024-12-10 17:19:32,99,2688,51,48,1595.06,3094.09,0.00
2024-12-10 17:19:32,98,2688,50,48,1611.02,3094.09,0.00
2024-12-10 17:19:32,97,2688,49,48,1620.33,3094.32,0.00
2024-12-10 17:19:32,96,2688,48,48,1635.52,3094.32,0.00
2024-12-10 17:19:32,95,2688,47,48,1648.49,3094.43,0.00
2024-12-10 17:19:32,95,2689,47,48,1693.35,3095.00,0.00
2024-12-10 17:19:32,96,2689,48,48,1675.71,3095.01,0.00
2024-12-10 17:19:32,95,2689,47,48,1691.73,3095.05,0.00
2024-12-10 17:19:32,94,2689,46,48,1705.32,3095.09,0.00
2024-12-10 17:19:32,93,2689,45,48,1723.32,3095.09,0.00
2024-12-10 17:19:32,93,2690,45,48,1724.85,3096.00,0.00
2024-12-10 17:19:32,94,2690,46,48,1706.50,3096.01,0.00
2024-12-10 17:19:32,93,2690,45,48,1718.74,3096.09,0.00
2024-12-10 17:19:32,92,2690,44,48,1719.54,3096.53,0.00
2024-12-10 17:19:32,92,2691,44,48,1737.78,3097.00,0.00
2024-12-10 17:19:32,93,2691,45,48,1719.09,3097.01,0.00
2024-12-10 17:19:32,92,2691,45,47,1734.56,3097.08,0.00
2024-12-10 17:19:32,92,2692,45,47,1736.54,3098.00,0.00
2024-12-10 17:19:32,93,2692,45,48,1717.87,3098.01,0.00
2024-12-10 17:19:32,92,2692,44,48,1735.55,3098.03,0.00
2024-12-10 17:19:32,91,2692,43,48,1753.27,3098.07,0.00
2024-12-10 17:19:32,91,2693,43,48,1752.57,3099.00,0.00
2024-12-10 17:19:32,92,2693,43,49,1733.52,3099.01,0.00
2024-12-10 17:19:32,91,2693,42,49,1750.55,3099.07,0.00
2024-12-10 17:19:32,92,2692,42,50,1703.54,3099.73,0.00
2024-12-10 17:19:32,92,2693,42,50,1735.18,3100.00,0.00
2024-12-10 17:19:32,93,2693,42,51,1716.53,3100.01,0.00
2024-12-10 17:19:32,93,2694,42,51,1740.44,3101.00,0.00
2024-12-10 17:19:32,94,2694,42,52,1721.92,3101.01,0.00
2024-12-10 17:19:32,95,2693,42,53,1702.19,3101.08,0.00
2024-12-10 17:19:32,94,2693,41,53,1727.89,3101.09,0.00
2024-12-10 17:19:32,94,2694,41,53,1717.21,3102.00,0.00
2024-12-10 17:19:32,95,2694,42,53,1699.13,3102.01,0.00
2024-12-10 17:19:32,94,2694,41,53,1714.93,3102.07,0.00
2024-12-10 17:19:32,94,2695,41,53,1734.33,3103.00,0.00
2024-12-10 17:19:32,95,2695,41,54,1716.08,3103.01,0.00
2024-12-10 17:19:32,94,2695,40,54,1732.06,3103.07,0.00
2024-12-10 17:19:32,93,2695,40,53,1739.66,3103.40,0.00
2024-12-10 17:19:32,94,2694,40,54,1719.74,3103.46,0.00
2024-12-10 17:19:32,94,2695,40,54,1736.97,3104.00,0.00
2024-12-10 17:19:32,95,2695,40,55,1718.68,3104.01,0.00
2024-12-10 17:19:32,94,2695,40,54,1734.69,3104.07,0.00
2024-12-10 17:19:32,93,2695,39,54,1737.89,3104.52,0.00
2024-12-10 17:19:32,92,2695,38,54,1751.51,3104.61,0.00
2024-12-10 17:19:32,92,2696,38,54,1801.15,3105.00,0.00
2024-12-10 17:19:32,93,2696,38,55,1781.79,3105.01,0.00
2024-12-10 17:19:32,92,2696,38,54,1800.15,3105.03,0.00
2024-12-10 17:19:32,91,2696,38,53,1818.59,3105.07,0.00
2024-12-10 17:19:32,90,2696,37,53,1838.45,3105.07,0.00
2024-12-10 17:19:32,91,2695,37,54,1816.89,3105.13,0.00
2024-12-10 17:19:32,92,2694,37,55,1814.87,3105.55,0.00
2024-12-10 17:19:32,92,2695,37,55,1837.56,3106.00,0.00
2024-12-10 17:19:32,93,2695,38,55,1817.80,3106.01,0.00
2024-12-10 17:19:32,93,2696,38,55,1879.36,3107.00,0.00
2024-12-10 17:19:32,94,2696,38,56,1859.36,3107.01,0.00
2024-12-10 17:19:32,93,2696,38,55,1877.38,3107.06,0.00
2024-12-10 17:19:32,92,2696,37,55,1897.45,3107.07,0.00
2024-12-10 17:19:32,92,2697,37,55,1893.26,3108.00,0.00
2024-12-10 17:19:32,93,2697,37,56,1872.90,3108.01,0.00
2024-12-10 17:19:32,93,2698,37,56,1865.20,3109.00,0.00
2024-12-10 17:19:32,94,2698,37,57,1845.35,3109.01,0.00
2024-12-10 17:19:32,94,2699,37,57,1836.20,3110.00,0.00
2024-12-10 17:19:32,95,2699,37,58,1816.87,3110.01,0.00
2024-12-10 17:19:32,95,2700,37,58,1804.25,3111.00,0.00
2024-12-10 17:19:32,96,2700,38,58,1785.46,3111.01,0.00
2024-12-10 17:19:32,95,2700,38,57,1772.10,3111.63,0.00
2024-12-10 17:19:32,94,2700,37,57,1784.98,3111.68,0.00
2024-12-10 17:19:32,94,2701,37,57,1808.43,3112.00,0.00
2024-12-10 17:19:32,95,2701,37,58,1789.39,3112.01,0.00
2024-12-10 17:19:32,94,2701,37,57,1806.15,3112.07,0.00
2024-12-10 17:19:32,93,2701,36,57,1817.90,3112.22,0.00
2024-12-10 17:19:32,92,2701,36,56,1836.82,3112.24,0.00
2024-12-10 17:19:32,91,2701,36,55,1846.92,3112.48,0.00
2024-12-10 17:19:32,90,2701,36,54,1864.33,3112.59,0.00
2024-12-10 17:19:32,90,2702,36,54,1883.62,3113.00,0.00
2024-12-10 17:19:32,91,2702,37,54,1862.92,3113.01,0.00
2024-12-10 17:19:32,91,2703,37,54,1862.62,3114.00,0.00
2024-12-10 17:19:32,92,2703,37,55,1842.37,3114.01,0.00
2024-12-10 17:19:32,91,2703,36,55,1847.59,3114.43,0.00
2024-12-10 17:19:32,91,2704,36,55,1862.86,3115.00,0.00
2024-12-10 17:19:32,92,2704,36,56,1842.62,3115.01,0.00
2024-12-10 17:19:32,91,2704,36,55,1855.33,3115.24,0.00
2024-12-10 17:19:32,91,2705,36,55,1864.03,3116.00,0.00
2024-12-10 17:19:32,92,2705,37,55,1843.77,3116.01,0.00
2024-12-10 17:19:32,91,2705,37,54,1854.14,3116.31,0.00
2024-12-10 17:19:32,91,2706,37,54,1865.75,3117.00,0.00
2024-12-10 17:19:32,92,2706,37,55,1845.47,3117.01,0.00
2024-12-10 17:19:32,91,2706,36,55,1859.40,3117.21,0.00
2024-12-10 17:19:32,91,2707,36,55,1866.68,3118.00,0.00
2024-12-10 17:19:33,92,2707,37,55,1846.39,3118.01,0.00
2024-12-10 17:19:33,91,2707,36,55,1863.98,3118.09,0.00
2024-12-10 17:19:33,92,2706,36,56,1826.02,3118.64,0.00
2024-12-10 17:19:33,92,2707,36,56,1855.49,3119.00,0.00
2024-12-10 17:19:33,93,2707,37,56,1835.54,3119.01,0.00
2024-12-10 17:19:33,94,2706,38,56,1784.66,3119.88,0.00
2024-12-10 17:19:33,94,2707,38,56,1850.81,3120.00,0.00
2024-12-10 17:19:33,95,2707,39,56,1831.33,3120.01,0.00
2024-12-10 17:19:33,94,2707,38,56,1848.20,3120.09,0.00
2024-12-10 17:19:33,94,2708,38,56,1879.97,3121.00,0.00
2024-12-10 17:19:33,95,2708,38,57,1860.18,3121.01,0.00
2024-12-10 17:19:33,94,2708,38,56,1877.35,3121.09,0.00
2024-12-10 17:19:33,94,2709,38,56,1875.19,3122.00,0.00
2024-12-10 17:19:33,95,2709,38,57,1855.46,3122.01,0.00
2024-12-10 17:19:33,94,2709,38,56,1848.93,3122.63,0.00
2024-12-10 17:19:33,94,2710,38,56,1870.84,3123.00,0.00
2024-12-10 17:19:33,95,2710,38,57,1851.14,3123.01,0.00
2024-12-10 17:19:33,95,2711,38,57,1850.60,3124.00,0.00
2024-12-10 17:19:33,96,2711,39,57,1831.33,3124.01,0.00
2024-12-10 17:19:33,95,2711,39,56,1847.43,3124.08,0.00
2024-12-10 17:19:33,96,2710,40,56,1824.30,3124.22,0.00
2024-12-10 17:19:33,95,2710,40,55,1860.28,3124.40,0.00
2024-12-10 17:19:33,95,2711,40,55,1874.83,3125.00,0.00
2024-12-10 17:19:33,96,2711,40,56,1855.30,3125.01,0.00
2024-12-10 17:19:33,95,2711,40,55,1870.12,3125.12,0.00
2024-12-10 17:19:33,95,2712,40,55,1906.45,3126.00,0.00
2024-12-10 17:19:33,96,2712,40,56,1886.59,3126.01,0.00
2024-12-10 17:19:33,97,2711,40,57,1860.81,3126.18,0.00
2024-12-10 17:19:33,97,2712,40,57,1889.44,3127.00,0.00
2024-12-10 17:19:33,98,2712,41,57,1870.16,3127.01,0.00
2024-12-10 17:19:33,98,2713,41,57,1893.58,3128.00,0.00
2024-12-10 17:19:33,99,2713,41,58,1874.45,3128.01,0.00
2024-12-10 17:19:33,98,2713,41,57,1891.88,3128.01,0.00
2024-12-10 17:19:33,97,2713,41,56,1897.20,3128.44,0.00
2024-12-10 17:19:33,97,2714,41,56,1906.45,3129.00,0.00
2024-12-10 17:19:33,98,2714,41,57,1886.99,3129.01,0.00
2024-12-10 17:19:33,97,2714,41,56,1904.22,3129.07,0.00
2024-12-10 17:19:33,97,2715,41,56,1900.45,3130.00,0.00
2024-12-10 17:19:33,98,2715,42,56,1881.06,3130.01,0.00
2024-12-10 17:19:33,97,2715,42,55,1899.81,3130.02,0.00
2024-12-10 17:19:33,97,2716,42,55,1895.31,3131.00,0.00
2024-12-10 17:19:33,98,2716,42,56,1875.97,3131.01,0.00
2024-12-10 17:19:33,98,2717,42,56,1871.90,3132.00,0.00
2024-12-10 17:19:33,99,2717,42,57,1852.99,3132.01,0.00
2024-12-10 17:19:33,99,2718,42,57,1848.42,3133.00,0.00
2024-12-10 17:19:33,100,2718,42,58,1829.94,3133.01,0.00
2024-12-10 17:19:33,100,2719,42,58,1824.60,3134.00,0.00
2024-12-10 17:19:33,101,2719,42,59,1806.53,3134.01,0.00
2024-12-10 17:19:33,100,2719,41,59,1822.12,3134.08,0.00
2024-12-10 17:19:33,100,2720,41,59,1818.08,3135.00,0.00
2024-12-10 17:19:33,101,2720,41,60,1800.08,3135.01,0.00
2024-12-10 17:19:33,100,2720,40,60,1815.61,3135.08,0.00
2024-12-10 17:19:33,99,2720,40,59,1832.73,3135.11,0.00
2024-12-10 17:19:33,99,2721,40,59,1829.30,3136.00,0.00
2024-12-10 17:19:33,100,2721,40,60,1811.00,3136.01,0.00
2024-12-10 17:19:33,99,2721,39,60,1827.09,3136.08,0.00
2024-12-10 17:19:33,100,2720,40,60,1807.89,3136.13,0.00
2024-12-10 17:19:33,101,2719,40,61,1782.81,3136.42,0.00
2024-12-10 17:19:33,101,2720,40,61,1803.93,3137.00,0.00
2024-12-10 17:19:33,102,2720,40,62,1786.24,3137.01,0.00
2024-12-10 17:19:33,101,2720,39,62,1798.41,3137.18,0.00
2024-12-10 17:19:33,100,2720,39,61,1808.33,3137.36,0.00
2024-12-10 17:19:33,101,2719,40,61,1776.70,3137.74,0.00
2024-12-10 17:19:33,102,2718,40,62,1754.42,3137.96,0.00
2024-12-10 17:19:33,102,2719,40,62,1846.11,3138.00,0.00
2024-12-10 17:19:33,103,2719,40,63,1828.19,3138.01,0.00
2024-12-10 17:19:33,102,2719,39,63,1842.99,3138.10,0.00
2024-12-10 17:19:33,102,2720,39,63,1899.85,3139.00,0.00
2024-12-10 17:19:33,103,2720,40,63,1881.41,3139.01,0.00
2024-12-10 17:19:33,104,2719,40,64,1862.12,3139.07,0.00
2024-12-10 17:19:33,105,2718,40,65,1839.54,3139.56,0.00
2024-12-10 17:19:33,105,2719,40,65,1860.47,3140.00,0.00
2024-12-10 17:19:33,106,2719,41,65,1842.92,3140.01,0.00
2024-12-10 17:19:33,105,2719,40,65,1858.11,3140.08,0.00
2024-12-10 17:19:33,105,2720,40,65,1910.01,3141.00,0.00
2024-12-10 17:19:33,106,2720,40,66,1892.00,3141.01,0.00
2024-12-10 17:19:33,106,2721,40,66,1881.74,3142.00,0.00
2024-12-10 17:19:33,107,2721,41,66,1864.15,3142.01,0.00
2024-12-10 17:19:33,107,2722,41,66,1852.77,3143.00,0.00
2024-12-10 17:19:33,108,2722,42,66,1835.62,3143.01,0.00
2024-12-10 17:19:33,108,2723,42,66,1821.13,3144.00,0.00
2024-12-10 17:19:33,109,2723,43,66,1804.42,3144.01,0.00
2024-12-10 17:19:33,109,2724,43,66,1788.76,3145.00,0.00
2024-12-10 17:19:33,110,2724,43,67,1772.50,3145.01,0.00
2024-12-10 17:19:33,110,2725,43,67,1757.72,3146.00,0.00
2024-12-10 17:19:33,111,2725,44,67,1741.89,3146.01,0.00
2024-12-10 17:19:33,111,2726,44,67,1728.07,3147.00,0.00
2024-12-10 17:19:33,112,2726,44,68,1712.64,3147.01,0.00
2024-12-10 17:19:33,112,2727,44,68,1697.23,3148.00,0.00
2024-12-10 17:19:33,113,2727,45,68,1682.21,3148.01,0.00
2024-12-10 17:19:33,114,2726,45,69,1647.73,3148.54,0.00
2024-12-10 17:19:33,113,2726,45,68,1668.89,3148.60,0.00
2024-12-10 17:19:33,113,2727,45,68,1679.29,3149.00,0.00
2024-12-10 17:19:33,114,2727,45,69,1664.56,3149.01,0.00
2024-12-10 17:19:33,113,2727,45,68,1639.92,3149.91,0.00
2024-12-10 17:19:33,113,2728,45,68,1692.95,3150.00,0.00
2024-12-10 17:19:34,114,2728,46,68,1678.10,3150.01,0.00
2024-12-10 17:19:34,113,2728,46,67,1676.89,3150.49,0.00
2024-12-10 17:19:34,112,2728,46,66,1679.97,3150.76,0.00
2024-12-10 17:19:34,112,2729,46,66,1699.64,3151.00,0.00
2024-12-10 17:19:34,113,2729,46,67,1684.60,3151.01,0.00
2024-12-10 17:19:34,112,2729,45,67,1696.87,3151.09,0.00
2024-12-10 17:19:34,112,2730,45,67,1692.81,3152.00,0.00
2024-12-10 17:19:34,113,2730,46,67,1677.83,3152.01,0.00
2024-12-10 17:19:34,112,2730,46,66,1690.27,3152.09,0.00
2024-12-10 17:19:34,112,2731,46,66,1684.80,3153.00,0.00
2024-12-10 17:19:34,113,2731,46,67,1669.89,3153.01,0.00
2024-12-10 17:19:34,114,2730,46,68,1645.65,3153.33,0.00
2024-12-10 17:19:34,113,2730,45,68,1666.43,3153.58,0.00
2024-12-10 17:19:34,113,2731,45,68,1677.77,3154.00,0.00
2024-12-10 17:19:34,114,2731,46,68,1663.06,3154.01,0.00
2024-12-10 17:19:34,113,2731,45,68,1660.69,3154.51,0.00
2024-12-10 17:19:34,112,2731,44,68,1668.40,3154.63,0.00
2024-12-10 17:19:34,112,2732,44,68,1711.68,3155.00,0.00
2024-12-10 17:19:34,113,2732,44,69,1696.54,3155.01,0.00
2024-12-10 17:19:34,112,2732,43,69,1708.96,3155.09,0.00
2024-12-10 17:19:34,111,2732,42,69,1707.10,3155.55,0.00
2024-12-10 17:19:34,111,2733,42,69,1719.73,3156.00,0.00
2024-12-10 17:19:34,112,2733,43,69,1704.38,3156.01,0.00
2024-12-10 17:19:34,111,2733,43,68,1716.80,3156.09,0.00
2024-12-10 17:19:34,111,2734,43,68,1714.03,3157.00,0.00
2024-12-10 17:19:34,112,2734,44,68,1698.72,3157.01,0.00
2024-12-10 17:19:34,112,2735,44,68,1692.25,3158.00,0.00
2024-12-10 17:19:34,113,2735,45,68,1677.27,3158.01,0.00
2024-12-10 17:19:34,112,2735,44,68,1691.68,3158.02,0.00
2024-12-10 17:19:34,113,2734,44,69,1670.43,3158.23,0.00
2024-12-10 17:19:34,113,2735,44,69,1685.14,3159.00,0.00
2024-12-10 17:19:34,114,2735,44,70,1670.36,3159.01,0.00
2024-12-10 17:19:34,113,2735,43,70,1681.45,3159.10,0.00
2024-12-10 17:19:34,114,2734,44,70,1655.73,3159.47,0.00
2024-12-10 17:19:34,113,2734,43,70,1679.09,3159.58,0.00
2024-12-10 17:19:34,112,2734,43,69,1693.16,3159.59,0.00
2024-12-10 17:19:34,112,2735,43,69,1734.68,3160.00,0.00
2024-12-10 17:19:34,113,2735,43,70,1719.33,3160.01,0.00
2024-12-10 17:19:34,114,2734,43,71,1674.18,3160.83,0.00
2024-12-10 17:19:34,114,2735,43,71,1728.67,3161.00,0.00
2024-12-10 17:19:34,115,2735,43,72,1713.64,3161.01,0.00
2024-12-10 17:19:34,116,2734,43,73,1698.59,3161.03,0.00
2024-12-10 17:19:34,116,2735,43,73,1734.71,3162.00,0.00
2024-12-10 17:19:34,117,2735,44,73,1719.89,3162.01,0.00
2024-12-10 17:19:34,117,2736,44,73,1738.95,3163.00,0.00
2024-12-10 17:19:34,118,2736,45,73,1724.21,3163.01,0.00
2024-12-10 17:19:34,118,2737,45,73,1715.11,3164.00,0.00
2024-12-10 17:19:34,119,2737,46,73,1700.69,3164.01,0.00
2024-12-10 17:19:34,118,2737,46,72,1695.61,3164.52,0.00
2024-12-10 17:19:34,117,2737,46,71,1706.23,3164.58,0.00
2024-12-10 17:19:34,117,2738,46,71,1718.66,3165.00,0.00
2024-12-10 17:19:34,118,2738,46,72,1704.10,3165.01,0.00
2024-12-10 17:19:34,117,2738,46,71,1718.39,3165.01,0.00
2024-12-10 17:19:34,116,2738,45,71,1731.09,3165.07,0.00
2024-12-10 17:19:34,115,2738,45,70,1745.59,3165.08,0.00
2024-12-10 17:19:34,114,2738,44,70,1760.63,3165.08,0.00
2024-12-10 17:19:34,114,2739,44,70,1752.49,3166.00,0.00
2024-12-10 17:19:34,115,2739,44,71,1737.25,3166.01,0.00
2024-12-10 17:19:34,114,2739,43,71,1750.02,3166.08,0.00
2024-12-10 17:19:34,114,2740,43,71,1742.08,3167.00,0.00
2024-12-10 17:19:34,115,2740,43,72,1726.93,3167.01,0.00
2024-12-10 17:19:34,114,2740,42,72,1739.61,3167.08,0.00
2024-12-10 17:19:34,113,2740,42,71,1739.88,3167.46,0.00
2024-12-10 17:19:34,113,2741,42,71,1746.02,3168.00,0.00
2024-12-10 17:19:34,114,2741,42,72,1730.71,3168.01,0.00
2024-12-10 17:19:34,114,2742,42,72,1718.59,3169.00,0.00
2024-12-10 17:19:34,115,2742,42,73,1703.64,3169.01,0.00
2024-12-10 17:19:34,114,2742,42,72,1716.12,3169.08,0.00
2024-12-10 17:19:34,113,2742,42,71,1720.15,3169.37,0.00
2024-12-10 17:19:34,113,2743,42,71,1719.44,3170.00,0.00
2024-12-10 17:19:34,114,2743,42,72,1704.35,3170.01,0.00
2024-12-10 17:19:35,113,2743,41,72,1716.94,3170.08,0.00
2024-12-10 17:19:35,112,2743,40,72,1718.31,3170.47,0.00
2024-12-10 17:19:35,112,2744,40,72,1720.37,3171.00,0.00
2024-12-10 17:19:35,113,2744,40,73,1705.15,3171.01,0.00
2024-12-10 17:19:35,112,2744,40,72,1717.85,3171.08,0.00
2024-12-10 17:19:35,112,2745,40,72,1704.14,3172.00,0.00
2024-12-10 17:19:35,113,2745,40,73,1689.06,3172.01,0.00
2024-12-10 17:19:35,112,2745,39,73,1684.59,3172.63,0.00
2024-12-10 17:19:35,112,2746,39,73,1686.10,3173.00,0.00
2024-12-10 17:19:35,113,2746,39,74,1671.18,3173.01,0.00
2024-12-10 17:19:35,112,2746,39,73,1683.30,3173.09,0.00
2024-12-10 17:19:35,112,2747,39,73,1665.50,3174.00,0.00
2024-12-10 17:19:35,113,2747,39,74,1650.76,3174.01,0.00
2024-12-10 17:19:35,112,2747,39,73,1662.70,3174.09,0.00
2024-12-10 17:19:35,111,2747,39,72,1650.69,3174.76,0.00
2024-12-10 17:19:35,111,2748,39,72,1659.53,3175.00,0.00
2024-12-10 17:19:35,112,2748,40,72,1644.72,3175.01,0.00
2024-12-10 17:19:35,111,2748,40,71,1648.33,3175.32,0.00
2024-12-10 17:19:35,111,2749,40,71,1638.81,3176.00,0.00
2024-12-10 17:19:35,112,2749,41,71,1624.17,3176.01,0.00
2024-12-10 17:19:35,111,2749,41,70,1635.97,3176.09,0.00
2024-12-10 17:19:35,110,2749,41,69,1650.56,3176.09,0.00
2024-12-10 17:19:35,111,2748,41,70,1604.18,3176.85,0.00
2024-12-10 17:19:35,111,2749,41,70,1630.70,3177.00,0.00
2024-12-10 17:19:35,112,2749,41,71,1616.14,3177.01,0.00
2024-12-10 17:19:35,112,2750,41,71,1618.83,3178.00,0.00
2024-12-10 17:19:35,113,2750,42,71,1604.50,3178.01,0.00
2024-12-10 17:19:35,112,2750,42,70,1615.74,3178.10,0.00
2024-12-10 17:19:35,113,2749,43,70,1593.89,3178.35,0.00
2024-12-10 17:19:35,112,2749,42,70,1598.61,3178.75,0.00
2024-12-10 17:19:35,112,2750,42,70,1600.58,3179.00,0.00
2024-12-10 17:19:35,113,2750,43,70,1586.42,3179.01,0.00
2024-12-10 17:19:35,112,2750,43,69,1597.50,3179.10,0.00
2024-12-10 17:19:35,111,2750,43,68,1610.63,3179.14,0.00
2024-12-10 17:19:35,111,2751,43,68,1616.11,3180.00,0.00
2024-12-10 17:19:35,112,2751,43,69,1601.68,3180.01,0.00
2024-12-10 17:19:35,111,2751,43,68,1612.99,3180.10,0.00
2024-12-10 17:19:35,110,2751,43,67,1618.95,3180.35,0.00
2024-12-10 17:19:35,109,2751,43,66,1612.46,3180.77,0.00
2024-12-10 17:19:35,109,2752,43,66,1617.28,3181.00,0.00
2024-12-10 17:19:35,110,2752,43,67,1602.58,3181.01,0.00
2024-12-10 17:19:35,109,2752,42,67,1616.71,3181.02,0.00
2024-12-10 17:19:35,108,2752,41,67,1629.05,3181.09,0.00
2024-12-10 17:19:35,109,2751,41,68,1612.95,3181.15,0.00
2024-12-10 17:19:35,108,2751,40,68,1618.26,3181.82,0.00
2024-12-10 17:19:35,107,2751,39,68,1632.71,3181.82,0.00
2024-12-10 17:19:35,107,2752,39,68,1648.90,3182.00,0.00
2024-12-10 17:19:35,108,2752,40,68,1633.63,3182.01,0.00
2024-12-10 17:19:35,109,2751,40,69,1576.10,3182.84,0.00
2024-12-10 17:19:35,109,2752,40,69,1637.15,3183.00,0.00
2024-12-10 17:19:35,110,2752,41,69,1622.27,3183.01,0.00
2024-12-10 17:19:35,109,2752,40,69,1612.65,3183.67,0.00
2024-12-10 17:19:35,108,2752,40,68,1624.29,3183.70,0.00
2024-12-10 17:19:35,107,2752,40,67,1631.53,3183.76,0.00
2024-12-10 17:19:35,107,2753,40,67,1669.26,3184.00,0.00
2024-12-10 17:19:35,108,2753,40,68,1653.81,3184.01,0.00
2024-12-10 17:19:35,109,2752,41,68,1595.66,3184.86,0.00
2024-12-10 17:19:35,109,2753,41,68,1620.21,3185.00,0.00
2024-12-10 17:19:35,110,2753,42,68,1605.48,3185.01,0.00
2024-12-10 17:19:35,110,2754,42,68,1604.81,3186.00,0.00
2024-12-10 17:19:35,111,2754,42,69,1590.35,3186.01,0.00
2024-12-10 17:19:35,110,2754,41,69,1603.66,3186.04,0.00
2024-12-10 17:19:35,109,2754,40,69,1593.99,3186.70,0.00
2024-12-10 17:19:35,108,2754,40,68,1598.82,3186.79,0.00
2024-12-10 17:19:35,108,2755,40,68,1607.12,3187.00,0.00
2024-12-10 17:19:35,109,2755,40,69,1592.38,3187.01,0.00
2024-12-10 17:19:35,108,2755,40,68,1606.25,3187.03,0.00
2024-12-10 17:19:35,107,2755,40,67,1618.90,3187.09,0.00
2024-12-10 17:19:35,106,2755,39,67,1624.86,3187.33,0.00
2024-12-10 17:19:35,105,2755,39,66,1623.79,3187.76,0.00
2024-12-10 17:19:35,105,2756,39,66,1625.84,3188.00,0.00
2024-12-10 17:19:35,106,2756,40,66,1610.50,3188.01,0.00
2024-12-10 17:19:35,106,2757,40,66,1584.90,3189.00,0.00
2024-12-10 17:19:35,107,2757,40,67,1570.08,3189.01,0.00
2024-12-10 17:19:36,107,2758,40,67,1542.59,3190.00,0.00
2024-12-10 17:19:36,108,2758,41,67,1528.30,3190.01,0.00
2024-12-10 17:19:36,107,2758,41,66,1515.41,3190.75,0.00
2024-12-10 17:19:36,106,2758,41,65,1524.69,3190.78,0.00
2024-12-10 17:19:36,106,2759,41,65,1531.21,3191.00,0.00
2024-12-10 17:19:36,107,2759,42,65,1516.90,3191.01,0.00
2024-12-10 17:19:36,106,2759,41,65,1527.34,3191.12,0.00
2024-12-10 17:19:36,105,2759,41,64,1500.74,3191.91,0.00
2024-12-10 17:19:36,105,2760,41,64,1527.00,3192.00,0.00
2024-12-10 17:19:36,106,2760,42,64,1512.60,3192.01,0.00
2024-12-10 17:19:36,105,2760,42,63,1523.10,3192.12,0.00
2024-12-10 17:19:36,105,2761,42,63,1507.82,3193.00,0.00
2024-12-10 17:19:36,106,2761,43,63,1493.60,3193.01,0.00
2024-12-10 17:19:36,105,2761,43,62,1505.41,3193.08,0.00
2024-12-10 17:19:36,104,2761,42,62,1518.38,3193.12,0.00
2024-12-10 17:19:36,103,2761,41,62,1501.00,3193.80,0.00
2024-12-10 17:19:36,103,2762,41,62,1517.56,3194.00,0.00
2024-12-10 17:19:36,104,2762,41,63,1502.97,3194.01,0.00
2024-12-10 17:19:36,103,2762,40,63,1513.88,3194.12,0.00
2024-12-10 17:19:36,103,2763,40,63,1500.56,3195.00,0.00
2024-12-10 17:19:36,104,2763,41,63,1486.13,3195.01,0.00
2024-12-10 17:19:36,103,2763,40,63,1496.88,3195.12,0.00
2024-12-10 17:19:36,102,2763,40,62,1486.81,3195.76,0.00
2024-12-10 17:19:36,102,2764,40,62,1498.60,3196.00,0.00
2024-12-10 17:19:36,103,2764,40,63,1484.05,3196.01,0.00
2024-12-10 17:19:36,102,2764,39,63,1494.89,3196.12,0.00
2024-12-10 17:19:36,101,2764,39,62,1500.63,3196.33,0.00
2024-12-10 17:19:36,100,2764,39,61,1494.61,3196.79,0.00
2024-12-10 17:19:36,100,2765,39,61,1511.51,3197.00,0.00
2024-12-10 17:19:36,101,2765,39,62,1496.55,3197.01,0.00
2024-12-10 17:19:36,100,2765,38,62,1507.75,3197.12,0.00
2024-12-10 17:19:36,99,2765,38,61,1497.61,3197.73,0.00
2024-12-10 17:19:36,98,2765,38,60,1511.17,3197.76,0.00
2024-12-10 17:19:36,98,2766,38,60,1525.83,3198.00,0.00
2024-12-10 17:19:36,99,2766,39,60,1510.41,3198.01,0.00
2024-12-10 17:19:36,98,2766,39,59,1522.13,3198.12,0.00
2024-12-10 17:19:36,97,2766,38,59,1533.30,3198.26,0.00
2024-12-10 17:19:36,96,2766,38,58,1523.28,3198.80,0.00
2024-12-10 17:19:36,96,2767,38,58,1545.76,3199.00,0.00
2024-12-10 17:19:36,97,2767,38,59,1529.83,3199.01,0.00
2024-12-10 17:19:36,96,2767,38,58,1541.81,3199.13,0.00
2024-12-10 17:19:36,95,2767,38,57,1557.70,3199.13,0.00
2024-12-10 17:19:36,96,2766,39,57,1528.72,3199.54,0.00
2024-12-10 17:19:36,96,2767,39,57,1553.70,3200.00,0.00
2024-12-10 17:19:36,97,2767,40,57,1537.68,3200.01,0.00
2024-12-10 17:19:36,96,2767,40,56,1549.74,3200.13,0.00
2024-12-10 17:19:36,95,2767,39,56,1537.20,3200.83,0.00
2024-12-10 17:19:36,95,2768,39,56,1594.81,3201.00,0.00
2024-12-10 17:19:36,96,2768,40,56,1578.20,3201.01,0.00
2024-12-10 17:19:36,95,2768,40,55,1590.81,3201.13,0.00
2024-12-10 17:19:36,95,2769,40,55,1585.09,3202.00,0.00
2024-12-10 17:19:36,96,2769,40,56,1568.58,3202.01,0.00
2024-12-10 17:19:36,95,2769,39,56,1581.08,3202.13,0.00
2024-12-10 17:19:36,95,2770,39,56,1574.62,3203.00,0.00
2024-12-10 17:19:36,96,2770,40,56,1558.21,3203.01,0.00
2024-12-10 17:19:36,95,2770,40,55,1573.22,3203.05,0.00
2024-12-10 17:19:36,95,2771,40,55,1564.54,3204.00,0.00
2024-12-10 17:19:36,96,2771,40,56,1548.25,3204.01,0.00
2024-12-10 17:19:36,95,2771,40,55,1560.87,3204.12,0.00
2024-12-10 17:19:36,95,2772,40,55,1554.90,3205.00,0.00
2024-12-10 17:19:36,96,2772,41,55,1538.70,3205.01,0.00
2024-12-10 17:19:36,95,2772,40,55,1553.23,3205.05,0.00
2024-12-10 17:19:36,94,2772,40,54,1567.39,3205.12,0.00
2024-12-10 17:19:36,93,2772,39,54,1569.10,3205.56,0.00
2024-12-10 17:19:36,92,2772,39,53,1584.09,3205.61,0.00
2024-12-10 17:19:36,91,2772,38,53,1591.67,3205.81,0.00
2024-12-10 17:19:36,91,2773,38,53,1617.27,3206.00,0.00
2024-12-10 17:19:36,92,2773,38,54,1599.69,3206.01,0.00
2024-12-10 17:19:36,92,2774,38,54,1596.52,3207.00,0.00
2024-12-10 17:19:36,93,2774,38,55,1579.36,3207.01,0.00
2024-12-10 17:19:36,92,2774,38,54,1592.39,3207.13,0.00
2024-12-10 17:19:36,93,2773,39,54,1564.42,3207.45,0.00
2024-12-10 17:19:36,93,2774,39,54,1596.82,3208.00,0.00
2024-12-10 17:19:36,94,2774,39,55,1579.84,3208.01,0.00
2024-12-10 17:19:36,94,2775,39,55,1608.08,3209.00,0.00
2024-12-10 17:19:36,95,2775,39,56,1591.15,3209.01,0.00
2024-12-10 17:19:36,94,2775,39,55,1603.70,3209.14,0.00
2024-12-10 17:19:36,94,2776,39,55,1601.31,3210.00,0.00
2024-12-10 17:19:36,95,2776,40,55,1584.46,3210.01,0.00
2024-12-10 17:19:36,94,2776,40,54,1597.14,3210.14,0.00
2024-12-10 17:19:36,93,2776,39,54,1612.48,3210.18,0.00
2024-12-10 17:19:36,92,2776,38,54,1629.41,3210.20,0.00
2024-12-10 17:19:36,92,2777,38,54,1629.38,3211.00,0.00
2024-12-10 17:19:36,93,2777,39,54,1611.86,3211.01,0.00
2024-12-10 17:19:36,92,2777,38,54,1600.74,3211.79,0.00
2024-12-10 17:19:36,92,2778,38,54,1625.35,3212.00,0.00
2024-12-10 17:19:36,93,2778,39,54,1607.87,3212.01,0.00
2024-12-10 17:19:36,94,2777,40,54,1589.08,3212.09,0.00
2024-12-10 17:19:36,93,2777,39,54,1613.26,3212.57,0.00
2024-12-10 17:19:36,93,2778,39,54,1629.45,3213.00,0.00
2024-12-10 17:19:36,94,2778,40,54,1612.11,3213.01,0.00
2024-12-10 17:19:36,93,2778,40,53,1617.27,3213.32,0.00
2024-12-10 17:19:36,93,2779,40,53,1657.67,3214.00,0.00
2024-12-10 17:19:36,94,2779,41,53,1640.03,3214.01,0.00
2024-12-10 17:19:36,93,2779,40,53,1628.03,3214.77,0.00
2024-12-10 17:19:36,93,2780,40,53,1652.36,3215.00,0.00
2024-12-10 17:19:36,94,2780,41,53,1634.78,3215.01,0.00
2024-12-10 17:19:36,95,2779,42,53,1602.82,3215.50,0.00
2024-12-10 17:19:36,94,2779,41,53,1637.29,3215.61,0.00
2024-12-10 17:19:36,94,2780,41,53,1653.25,3216.00,0.00
2024-12-10 17:19:36,95,2780,41,54,1635.84,3216.01,0.00
2024-12-10 17:19:37,95,2781,41,54,1665.75,3217.00,0.00
2024-12-10 17:19:37,96,2781,42,54,1648.40,3217.01,0.00
2024-12-10 17:19:37,95,2781,42,53,1639.51,3217.67,0.00
2024-12-10 17:19:37,95,2782,42,53,1662.08,3218.00,0.00
2024-12-10 17:19:37,96,2782,42,54,1644.76,3218.01,0.00
2024-12-10 17:19:37,95,2782,42,53,1659.06,3218.10,0.00
2024-12-10 17:19:37,94,2782,42,52,1675.35,3218.13,0.00
2024-12-10 17:19:37,94,2783,42,52,1681.17,3219.00,0.00
2024-12-10 17:19:37,95,2783,42,53,1663.47,3219.01,0.00
2024-12-10 17:19:37,94,2783,42,52,1677.44,3219.12,0.00
2024-12-10 17:19:37,94,2784,42,52,1681.21,3220.00,0.00
2024-12-10 17:19:37,95,2784,43,52,1663.51,3220.01,0.00
2024-12-10 17:19:37,95,2785,43,52,1660.89,3221.00,0.00
2024-12-10 17:19:37,96,2785,44,52,1643.59,3221.01,0.00
2024-12-10 17:19:37,96,2786,44,52,1638.13,3222.00,0.00
2024-12-10 17:19:37,97,2786,45,52,1621.24,3222.01,0.00
2024-12-10 17:19:37,96,2786,45,51,1633.82,3222.12,0.00
2024-12-10 17:19:37,95,2786,44,51,1650.45,3222.13,0.00
2024-12-10 17:19:37,95,2787,44,51,1648.29,3223.00,0.00
2024-12-10 17:19:37,96,2787,44,52,1631.12,3223.01,0.00
2024-12-10 17:19:37,95,2787,44,51,1643.90,3223.12,0.00
2024-12-10 17:19:37,95,2788,44,51,1640.61,3224.00,0.00
2024-12-10 17:19:37,96,2788,45,51,1623.52,3224.01,0.00
2024-12-10 17:19:37,96,2789,45,51,1612.83,3225.00,0.00
2024-12-10 17:19:37,97,2789,45,52,1596.20,3225.01,0.00
2024-12-10 17:19:37,98,2788,46,52,1579.26,3225.05,0.00
2024-12-10 17:19:37,97,2788,46,51,1621.81,3225.19,0.00
2024-12-10 17:19:37,98,2787,46,52,1593.73,3225.53,0.00
2024-12-10 17:19:37,98,2788,46,52,1613.25,3226.00,0.00
2024-12-10 17:19:37,99,2788,47,52,1596.96,3226.01,0.00
2024-12-10 17:19:37,98,2788,47,51,1606.86,3226.11,0.00
2024-12-10 17:19:37,98,2789,47,51,1659.77,3227.00,0.00
2024-12-10 17:19:37,99,2789,48,51,1643.00,3227.01,0.00
2024-12-10 17:19:37,98,2789,48,50,1630.03,3227.70,0.00
2024-12-10 17:19:37,97,2789,47,50,1640.95,3227.71,0.00
2024-12-10 17:19:37,97,2790,47,50,1656.27,3228.00,0.00
2024-12-10 17:19:37,98,2790,48,50,1639.37,3228.01,0.00
2024-12-10 17:19:37,98,2791,48,50,1623.04,3229.00,0.00
2024-12-10 17:19:37,99,2791,49,50,1606.65,3229.01,0.00
2024-12-10 17:19:37,98,2791,49,49,1619.12,3229.10,0.00
2024-12-10 17:19:37,97,2791,49,48,1635.48,3229.10,0.00
2024-12-10 17:19:37,96,2791,49,47,1649.08,3229.20,0.00
2024-12-10 17:19:37,97,2790,50,47,1626.82,3229.30,0.00
2024-12-10 17:19:37,97,2791,50,47,1650.99,3230.00,0.00
2024-12-10 17:19:37,98,2791,51,47,1634.14,3230.01,0.00
2024-12-10 17:19:37,97,2791,50,47,1647.69,3230.10,0.00
2024-12-10 17:19:37,96,2791,49,47,1658.49,3230.25,0.00
2024-12-10 17:19:37,97,2790,49,48,1640.41,3230.30,0.00
2024-12-10 17:19:37,96,2790,49,47,1679.81,3230.45,0.00
2024-12-10 17:19:37,95,2790,48,47,1676.09,3230.79,0.00
2024-12-10 17:19:37,95,2791,48,47,1729.56,3231.00,0.00
2024-12-10 17:19:37,96,2791,49,47,1711.54,3231.01,0.00
2024-12-10 17:19:37,95,2791,49,46,1726.19,3231.11,0.00
2024-12-10 17:19:37,95,2792,49,46,1745.83,3232.00,0.00
2024-12-10 17:19:37,96,2792,49,47,1727.64,3232.01,0.00
2024-12-10 17:19:37,95,2792,49,46,1742.46,3232.11,0.00
2024-12-10 17:19:37,94,2792,48,46,1734.24,3232.72,0.00
2024-12-10 17:19:37,94,2793,48,46,1741.04,3233.00,0.00
2024-12-10 17:19:37,95,2793,49,46,1722.71,3233.01,0.00
2024-12-10 17:19:37,94,2793,49,45,1737.63,3233.11,0.00
2024-12-10 17:19:37,93,2793,48,45,1730.82,3233.72,0.00
2024-12-10 17:19:37,93,2794,48,45,1739.55,3234.00,0.00
2024-12-10 17:19:37,94,2794,48,46,1721.04,3234.01,0.00
2024-12-10 17:19:37,93,2794,47,46,1708.08,3234.83,0.00
2024-12-10 17:19:37,93,2795,47,46,1724.89,3235.00,0.00
2024-12-10 17:19:37,94,2795,48,46,1706.54,3235.01,0.00
2024-12-10 17:19:37,95,2794,49,46,1687.90,3235.05,0.00
2024-12-10 17:19:37,94,2794,49,45,1706.58,3235.12,0.00
2024-12-10 17:19:37,94,2795,49,45,1695.68,3236.00,0.00
2024-12-10 17:19:37,95,2795,50,45,1677.83,3236.01,0.00
2024-12-10 17:19:37,94,2795,49,45,1694.31,3236.04,0.00
2024-12-10 17:19:37,93,2795,49,44,1710.46,3236.10,0.00
2024-12-10 17:19:37,92,2795,48,44,1728.70,3236.10,0.00
2024-12-10 17:19:37,91,2795,48,43,1747.34,3236.10,0.00
2024-12-10 17:19:37,92,2794,49,43,1715.55,3236.51,0.00
2024-12-10 17:19:37,91,2794,48,43,1733.90,3236.82,0.00
2024-12-10 17:19:37,91,2795,48,43,1789.84,3237.00,0.00
2024-12-10 17:19:37,92,2795,48,44,1770.39,3237.01,0.00
2024-12-10 17:19:38,91,2795,48,43,1786.68,3237.10,0.00
2024-12-10 17:19:38,91,2796,48,43,1814.57,3238.00,0.00
2024-12-10 17:19:38,92,2796,48,44,1794.85,3238.01,0.00
2024-12-10 17:19:38,91,2796,48,43,1788.03,3238.73,0.00
2024-12-10 17:19:38,90,2796,48,42,1803.05,3238.80,0.00
2024-12-10 17:19:38,90,2797,48,42,1826.50,3239.00,0.00
2024-12-10 17:19:38,91,2797,48,43,1806.43,3239.01,0.00
2024-12-10 17:19:38,90,2797,47,43,1825.79,3239.02,0.00
2024-12-10 17:19:38,89,2797,46,43,1843.78,3239.09,0.00
2024-12-10 17:19:38,88,2797,46,42,1864.37,3239.09,0.00
2024-12-10 17:19:38,88,2798,46,42,1865.05,3240.00,0.00
2024-12-10 17:19:38,89,2798,47,42,1844.10,3240.01,0.00
2024-12-10 17:19:38,88,2798,46,42,1862.14,3240.09,0.00
2024-12-10 17:19:38,89,2797,46,43,1832.61,3240.35,0.00
2024-12-10 17:19:38,90,2796,46,44,1806.28,3240.67,0.00
2024-12-10 17:19:38,90,2797,46,44,1842.74,3241.00,0.00
2024-12-10 17:19:38,91,2797,46,45,1822.49,3241.01,0.00
2024-12-10 17:19:38,90,2797,46,44,1839.89,3241.09,0.00
2024-12-10 17:19:38,89,2797,46,43,1855.67,3241.19,0.00
2024-12-10 17:19:38,88,2797,45,43,1849.69,3241.80,0.00
2024-12-10 17:19:38,88,2798,45,43,1952.44,3242.00,0.00
2024-12-10 17:19:38,89,2798,45,44,1930.51,3242.01,0.00
2024-12-10 17:19:38,88,2798,44,44,1949.53,3242.09,0.00
2024-12-10 17:19:38,88,2799,44,44,1947.17,3243.00,0.00
2024-12-10 17:19:38,89,2799,45,44,1925.30,3243.01,0.00
2024-12-10 17:19:38,89,2800,45,44,1917.33,3244.00,0.00
2024-12-10 17:19:38,90,2800,46,44,1896.02,3244.01,0.00
2024-12-10 17:19:38,91,2799,46,45,1870.19,3244.18,0.00
2024-12-10 17:19:38,90,2799,46,44,1915.16,3244.40,0.00
2024-12-10 17:19:38,90,2800,46,44,1918.23,3245.00,0.00
2024-12-10 17:19:38,91,2800,47,44,1897.16,3245.01,0.00
2024-12-10 17:19:38,91,2801,47,44,1919.33,3246.00,0.00
2024-12-10 17:19:38,92,2801,47,45,1898.47,3246.01,0.00
2024-12-10 17:19:38,92,2802,47,45,1880.37,3247.00,0.00
2024-12-10 17:19:38,93,2802,48,45,1860.15,3247.01,0.00
2024-12-10 17:19:38,92,2802,48,44,1875.55,3247.12,0.00
2024-12-10 17:19:38,91,2802,47,44,1880.49,3247.57,0.00
2024-12-10 17:19:38,91,2803,47,44,1888.06,3248.00,0.00
2024-12-10 17:19:38,92,2803,47,45,1867.54,3248.01,0.00
2024-12-10 17:19:38,91,2803,47,44,1882.63,3248.13,0.00
2024-12-10 17:19:38,92,2802,48,44,1861.47,3248.17,0.00
2024-12-10 17:19:38,92,2803,48,44,1864.66,3249.00,0.00
2024-12-10 17:19:38,93,2803,49,44,1844.61,3249.01,0.00
2024-12-10 17:19:38,93,2804,49,44,1863.25,3250.00,0.00
2024-12-10 17:19:38,94,2804,49,45,1843.42,3250.01,0.00
2024-12-10 17:19:38,94,2805,49,45,1823.30,3251.00,0.00
2024-12-10 17:19:38,95,2805,50,45,1804.10,3251.01,0.00
2024-12-10 17:19:38,95,2806,50,45,1780.72,3252.00,0.00
2024-12-10 17:19:38,96,2806,51,45,1762.17,3252.01,0.00
2024-12-10 17:19:38,95,2806,50,45,1774.45,3252.14,0.00
2024-12-10 17:19:38,94,2806,50,44,1764.09,3252.76,0.00
2024-12-10 17:19:38,94,2807,50,44,1774.79,3253.00,0.00
2024-12-10 17:19:38,95,2807,50,45,1756.11,3253.01,0.00
2024-12-10 17:19:38,94,2807,50,44,1773.08,3253.05,0.00
2024-12-10 17:19:38,93,2807,49,44,1772.19,3253.57,0.00
2024-12-10 17:19:38,93,2808,49,44,1771.27,3254.00,0.00
2024-12-10 17:19:38,94,2808,50,44,1752.43,3254.01,0.00
2024-12-10 17:19:38,95,2807,50,45,1710.22,3254.64,0.00
2024-12-10 17:19:38,94,2807,49,45,1727.23,3254.78,0.00
2024-12-10 17:19:38,93,2807,49,44,1741.55,3254.80,0.00
2024-12-10 17:19:38,93,2808,49,44,1758.18,3255.00,0.00
2024-12-10 17:19:38,94,2808,49,45,1739.47,3255.01,0.00
2024-12-10 17:19:38,93,2808,48,45,1729.03,3255.69,0.00
2024-12-10 17:19:38,93,2809,48,45,1775.74,3256.00,0.00
2024-12-10 17:19:38,94,2809,49,45,1756.85,3256.01,0.00
2024-12-10 17:19:38,93,2809,48,45,1772.64,3256.08,0.00
2024-12-10 17:19:38,92,2809,47,45,1766.97,3256.65,0.00
2024-12-10 17:19:38,91,2809,46,45,1780.03,3256.78,0.00
2024-12-10 17:19:38,91,2810,46,45,1799.54,3257.00,0.00
2024-12-10 17:19:38,92,2810,47,45,1779.98,3257.01,0.00
2024-12-10 17:19:38,91,2810,47,44,1780.85,3257.41,0.00
2024-12-10 17:19:38,90,2810,47,43,1783.00,3257.79,0.00
2024-12-10 17:19:38,90,2811,47,43,1802.82,3258.00,0.00
2024-12-10 17:19:38,91,2811,48,43,1783.01,3258.01,0.00
2024-12-10 17:19:38,90,2811,48,42,1801.74,3258.03,0.00
2024-12-10 17:19:38,89,2811,47,42,1818.74,3258.12,0.00
2024-12-10 17:19:38,88,2811,47,41,1839.04,3258.13,0.00
2024-12-10 17:19:38,87,2811,47,40,1831.63,3258.79,0.00
2024-12-10 17:19:38,87,2812,47,40,1853.37,3259.00,0.00
2024-12-10 17:19:38,88,2812,47,41,1832.30,3259.01,0.00
2024-12-10 17:19:38,87,2812,47,40,1851.51,3259.06,0.00
2024-12-10 17:19:38,86,2812,46,40,1870.81,3259.12,0.00
2024-12-10 17:19:38,86,2813,46,40,1864.46,3260.00,0.00
2024-12-10 17:19:38,87,2813,46,41,1843.03,3260.01,0.00
2024-12-10 17:19:38,86,2813,46,40,1860.73,3260.12,0.00
2024-12-10 17:19:38,86,2814,46,40,1850.59,3261.00,0.00
2024-12-10 17:19:38,87,2814,47,40,1829.32,3261.01,0.00
2024-12-10 17:19:38,86,2814,47,39,1850.21,3261.01,0.00
2024-12-10 17:19:38,85,2814,47,38,1868.58,3261.11,0.00
2024-12-10 17:19:38,84,2814,46,38,1855.02,3261.88,0.00
2024-12-10 17:19:38,84,2815,46,38,1887.29,3262.00,0.00
2024-12-10 17:19:38,85,2815,46,39,1865.09,3262.01,0.00
2024-12-10 17:19:38,84,2815,45,39,1868.24,3262.43,0.00
2024-12-10 17:19:38,84,2816,45,39,1874.60,3263.00,0.00
2024-12-10 17:19:38,85,2816,45,40,1852.55,3263.01,0.00
2024-12-10 17:19:38,84,2816,45,39,1863.53,3263.32,0.00
2024-12-10 17:19:38,84,2817,45,39,1858.19,3264.00,0.00
2024-12-10 17:19:38,85,2817,46,39,1836.32,3264.01,0.00
2024-12-10 17:19:38,86,2816,46,40,1792.01,3264.62,0.00
2024-12-10 17:19:38,86,2817,46,40,1805.01,3265.00,0.00
2024-12-10 17:19:38,87,2817,47,40,1784.26,3265.01,0.00
2024-12-10 17:19:38,88,2816,48,40,1751.60,3265.35,0.00
2024-12-10 17:19:38,88,2817,48,40,1796.30,3266.00,0.00
2024-12-10 17:19:38,89,2817,48,41,1776.11,3266.01,0.00
2024-12-10 17:19:38,88,2817,48,40,1778.75,3266.35,0.00
2024-12-10 17:19:38,87,2817,47,40,1769.41,3266.89,0.00
2024-12-10 17:19:38,87,2818,47,40,1831.66,3267.00,0.00
2024-12-10 17:19:38,88,2818,48,40,1810.85,3267.01,0.00
2024-12-10 17:19:38,87,2818,47,40,1798.04,3267.79,0.00
2024-12-10 17:19:39,86,2818,47,39,1804.76,3267.90,0.00
2024-12-10 17:19:39,86,2819,47,39,1839.43,3268.00,0.00
2024-12-10 17:19:39,87,2819,48,39,1818.29,3268.01,0.00
2024-12-10 17:19:39,86,2819,48,38,1835.91,3268.11,0.00
2024-12-10 17:19:39,85,2819,47,38,1854.68,3268.15,0.00
2024-12-10 17:19:39,86,2818,48,38,1825.14,3268.33,0.00
2024-12-10 17:19:39,85,2818,48,37,1851.45,3268.80,0.00
2024-12-10 17:19:39,85,2819,48,37,1880.30,3269.00,0.00
2024-12-10 17:19:39,86,2819,48,38,1858.43,3269.01,0.00
2024-12-10 17:19:39,85,2819,48,37,1867.98,3269.27,0.00
2024-12-10 17:19:39,85,2820,48,37,1912.63,3270.00,0.00
2024-12-10 17:19:39,86,2820,49,37,1890.39,3270.01,0.00
2024-12-10 17:19:39,85,2820,49,36,1909.22,3270.11,0.00
2024-12-10 17:19:39,84,2820,49,35,1930.58,3270.11,0.00
2024-12-10 17:19:39,84,2821,49,35,1930.84,3271.00,0.00
2024-12-10 17:19:39,85,2821,49,36,1908.13,3271.01,0.00
2024-12-10 17:19:39,84,2821,48,36,1911.54,3271.44,0.00
2024-12-10 17:19:39,84,2822,48,36,1927.94,3272.00,0.00
2024-12-10 17:19:39,85,2822,48,37,1905.26,3272.01,0.00
2024-12-10 17:19:39,86,2821,49,37,1868.92,3272.38,0.00
2024-12-10 17:19:39,87,2820,49,38,1853.00,3272.79,0.00
2024-12-10 17:19:39,87,2821,49,38,1887.04,3273.00,0.00
2024-12-10 17:19:39,88,2821,50,38,1865.60,3273.01,0.00
2024-12-10 17:19:39,87,2821,49,38,1859.10,3273.72,0.00
2024-12-10 17:19:39,87,2822,49,38,1957.13,3274.00,0.00
2024-12-10 17:19:39,88,2822,49,39,1934.89,3274.01,0.00
2024-12-10 17:19:39,88,2823,49,39,1930.33,3275.00,0.00
2024-12-10 17:19:39,89,2823,49,40,1908.64,3275.01,0.00
2024-12-10 17:19:39,88,2823,49,39,1918.73,3275.31,0.00
2024-12-10 17:19:39,88,2824,49,39,1926.16,3276.00,0.00
2024-12-10 17:19:39,89,2824,50,39,1904.51,3276.01,0.00
2024-12-10 17:19:39,88,2824,49,39,1921.01,3276.10,0.00
2024-12-10 17:19:39,88,2825,49,39,1920.73,3277.00,0.00
2024-12-10 17:19:39,89,2825,49,40,1899.15,3277.01,0.00
2024-12-10 17:19:39,88,2825,48,40,1888.10,3277.84,0.00
2024-12-10 17:19:39,88,2826,48,40,1920.27,3278.00,0.00
2024-12-10 17:19:39,89,2826,48,41,1898.70,3278.01,0.00
2024-12-10 17:19:39,89,2827,48,41,1898.73,3279.00,0.00
2024-12-10 17:19:39,90,2827,48,42,1877.64,3279.01,0.00
2024-12-10 17:19:39,90,2828,48,42,1876.91,3280.00,0.00
2024-12-10 17:19:39,91,2828,49,42,1856.28,3280.01,0.00
2024-12-10 17:19:39,90,2828,48,42,1875.97,3280.02,0.00
2024-12-10 17:19:39,90,2829,48,42,1878.73,3281.00,0.00
2024-12-10 17:19:39,91,2829,49,42,1858.09,3281.01,0.00
2024-12-10 17:19:39,90,2829,49,41,1878.01,3281.02,0.00
2024-12-10 17:19:39,89,2829,49,40,1896.56,3281.09,0.00
2024-12-10 17:19:39,88,2829,49,39,1917.74,3281.09,0.00
2024-12-10 17:19:39,88,2830,49,39,1922.91,3282.00,0.00
2024-12-10 17:19:39,89,2830,50,39,1901.31,3282.01,0.00
2024-12-10 17:19:39,88,2830,49,39,1919.96,3282.09,0.00
2024-12-10 17:19:39,88,2831,49,39,1924.03,3283.00,0.00
2024-12-10 17:19:39,89,2831,50,39,1902.41,3283.01,0.00
2024-12-10 17:19:39,88,2831,49,39,1920.55,3283.09,0.00
2024-12-10 17:19:39,88,2832,49,39,1923.64,3284.00,0.00
2024-12-10 17:19:39,89,2832,49,40,1902.03,3284.01,0.00
2024-12-10 17:19:39,88,2832,49,39,1919.92,3284.09,0.00
2024-12-10 17:19:39,88,2833,49,39,1922.73,3285.00,0.00
2024-12-10 17:19:39,89,2833,49,40,1901.13,3285.01,0.00
2024-12-10 17:19:39,88,2833,48,40,1918.96,3285.09,0.00
2024-12-10 17:19:39,87,2833,48,39,1939.24,3285.14,0.00
2024-12-10 17:19:39,87,2834,48,39,1946.93,3286.00,0.00
2024-12-10 17:19:39,88,2834,48,40,1924.80,3286.01,0.00
2024-12-10 17:19:39,88,2835,48,40,1927.74,3287.00,0.00
2024-12-10 17:19:39,89,2835,48,41,1906.08,3287.01,0.00
2024-12-10 17:19:39,88,2835,48,40,1924.17,3287.09,0.00
2024-12-10 17:19:39,88,2836,48,40,1930.42,3288.00,0.00
2024-12-10 17:19:39,89,2836,48,41,1908.73,3288.01,0.00
2024-12-10 17:19:39,88,2836,47,41,1925.04,3288.15,0.00
2024-12-10 17:19:39,88,2837,47,41,1934.92,3289.00,0.00
2024-12-10 17:19:39,89,2837,48,41,1913.18,3289.01,0.00
2024-12-10 17:19:39,90,2836,48,42,1867.63,3289.74,0.00
2024-12-10 17:19:39,90,2837,48,42,1903.31,3290.00,0.00
2024-12-10 17:19:39,91,2837,48,43,1882.40,3290.01,0.00
2024-12-10 17:19:39,90,2837,47,43,1901.90,3290.04,0.00
2024-12-10 17:19:39,89,2837,46,43,1921.81,3290.08,0.00
2024-12-10 17:19:39,89,2838,46,43,1964.43,3291.00,0.00
2024-12-10 17:19:39,90,2838,46,44,1942.60,3291.01,0.00
2024-12-10 17:19:39,90,2839,46,44,1943.87,3292.00,0.00
2024-12-10 17:19:39,91,2839,47,44,1922.51,3292.01,0.00
2024-12-10 17:19:39,90,2839,46,44,1940.97,3292.09,0.00
2024-12-10 17:19:39,89,2839,45,44,1956.39,3292.18,0.00
2024-12-10 17:19:39,89,2840,45,44,1966.92,3293.00,0.00
2024-12-10 17:19:39,90,2840,46,44,1945.06,3293.01,0.00
2024-12-10 17:19:39,90,2841,46,44,1949.68,3294.00,0.00
2024-12-10 17:19:39,91,2841,46,45,1928.26,3294.01,0.00
2024-12-10 17:19:39,92,2840,47,45,1898.79,3294.29,0.00
2024-12-10 17:19:39,92,2841,47,45,1934.74,3295.00,0.00
2024-12-10 17:19:39,93,2841,47,46,1913.93,3295.01,0.00
2024-12-10 17:19:39,93,2842,47,46,1952.61,3296.00,0.00
2024-12-10 17:19:39,94,2842,47,47,1931.83,3296.01,0.00
2024-12-10 17:19:39,94,2843,47,47,1934.76,3297.00,0.00
2024-12-10 17:19:39,95,2843,48,47,1914.40,3297.01,0.00
2024-12-10 17:19:39,95,2844,48,47,1916.70,3298.00,0.00
2024-12-10 17:19:39,96,2844,48,48,1896.74,3298.01,0.00
2024-12-10 17:19:39,97,2843,49,48,1877.18,3298.03,0.00
2024-12-10 17:19:39,96,2843,48,48,1915.15,3298.09,0.00
2024-12-10 17:19:40,96,2844,48,48,1920.11,3299.00,0.00
2024-12-10 17:19:40,97,2844,48,49,1900.32,3299.01,0.00
2024-12-10 17:19:40,96,2844,48,48,1919.44,3299.02,0.00
2024-12-10 17:19:40,97,2843,49,48,1885.18,3299.46,0.00
2024-12-10 17:19:40,97,2844,49,48,1952.95,3300.00,0.00
2024-12-10 17:19:40,98,2844,49,49,1933.03,3300.01,0.00
2024-12-10 17:19:40,98,2845,49,49,1967.52,3301.00,0.00
2024-12-10 17:19:40,99,2845,50,49,1947.65,3301.01,0.00
2024-12-10 17:19:40,98,2845,49,49,1964.00,3301.08,0.00
2024-12-10 17:19:40,98,2846,49,49,1967.86,3302.00,0.00
2024-12-10 17:19:40,99,2846,49,50,1947.98,3302.01,0.00
2024-12-10 17:19:40,99,2847,49,50,1947.88,3303.00,0.00
2024-12-10 17:19:40,100,2847,50,50,1928.40,3303.01,0.00
2024-12-10 17:19:40,100,2848,50,50,1926.72,3304.00,0.00
2024-12-10 17:19:40,101,2848,50,51,1907.64,3304.01,0.00
2024-12-10 17:19:40,101,2849,50,51,1904.50,3305.00,0.00
2024-12-10 17:19:40,102,2849,51,51,1885.83,3305.01,0.00
2024-12-10 17:19:40,101,2849,50,51,1901.03,3305.08,0.00
2024-12-10 17:19:40,101,2850,50,51,1900.76,3306.00,0.00
2024-12-10 17:19:40,102,2850,51,51,1882.13,3306.01,0.00
2024-12-10 17:19:40,101,2850,51,50,1886.26,3306.31,0.00
2024-12-10 17:19:40,101,2851,51,50,1896.56,3307.00,0.00
2024-12-10 17:19:40,102,2851,51,51,1877.97,3307.01,0.00
2024-12-10 17:19:40,101,2851,51,50,1893.30,3307.08,0.00
2024-12-10 17:19:40,101,2852,51,50,1894.52,3308.00,0.00
2024-12-10 17:19:40,102,2852,52,50,1875.95,3308.01,0.00
2024-12-10 17:19:40,101,2852,52,49,1891.43,3308.08,0.00
2024-12-10 17:19:40,100,2852,51,49,1909.40,3308.10,0.00
2024-12-10 17:19:40,100,2853,51,49,1913.26,3309.00,0.00
2024-12-10 17:19:40,101,2853,51,50,1894.31,3309.01,0.00
2024-12-10 17:19:40,100,2853,51,49,1910.18,3309.08,0.00
2024-12-10 17:19:40,100,2854,51,49,1913.38,3310.00,0.00
2024-12-10 17:19:40,101,2854,51,50,1894.43,3310.01,0.00
2024-12-10 17:19:40,101,2855,51,50,1894.65,3311.00,0.00
2024-12-10 17:19:40,102,2855,52,50,1876.08,3311.01,0.00
2024-12-10 17:19:40,102,2856,52,50,1875.89,3312.00,0.00
2024-12-10 17:19:40,103,2856,53,50,1857.68,3312.01,0.00
2024-12-10 17:19:40,103,2857,53,50,1857.10,3313.00,0.00
2024-12-10 17:19:40,104,2857,53,51,1839.25,3313.01,0.00
2024-12-10 17:19:40,103,2857,53,50,1856.41,3313.03,0.00
2024-12-10 17:19:40,103,2858,53,50,1856.62,3314.00,0.00
2024-12-10 17:19:40,104,2858,53,51,1838.77,3314.01,0.00
2024-12-10 17:19:40,105,2857,54,51,1819.39,3314.09,0.00
2024-12-10 17:19:40,106,2856,55,51,1808.02,3314.28,0.00
2024-12-10 17:19:40,106,2857,55,51,1838.35,3315.00,0.00
2024-12-10 17:19:40,107,2857,56,51,1821.16,3315.01,0.00
2024-12-10 17:19:40,106,2857,55,51,1835.87,3315.08,0.00
2024-12-10 17:19:40,106,2858,55,51,1897.12,3316.00,0.00
2024-12-10 17:19:40,107,2858,55,52,1879.39,3316.01,0.00
2024-12-10 17:19:40,108,2857,55,53,1861.69,3316.04,0.00
2024-12-10 17:19:40,109,2856,55,54,1852.71,3316.51,0.00
2024-12-10 17:19:40,109,2857,55,54,1881.08,3317.00,0.00
2024-12-10 17:19:40,110,2857,55,55,1863.98,3317.01,0.00
2024-12-10 17:19:40,110,2858,55,55,1918.52,3318.00,0.00
2024-12-10 17:19:40,111,2858,55,56,1901.24,3318.01,0.00
2024-12-10 17:19:40,110,2858,55,55,1916.27,3318.07,0.00
2024-12-10 17:19:40,110,2859,55,55,1912.92,3319.00,0.00
2024-12-10 17:19:40,111,2859,55,56,1895.69,3319.01,0.00
2024-12-10 17:19:40,110,2859,55,55,1910.54,3319.07,0.00
2024-12-10 17:19:40,111,2858,55,56,1879.06,3319.42,0.00
2024-12-10 17:19:40,111,2859,55,56,1906.11,3320.00,0.00
2024-12-10 17:19:40,112,2859,55,57,1889.09,3320.01,0.00
2024-12-10 17:19:40,111,2859,54,57,1894.98,3320.27,0.00
2024-12-10 17:19:40,111,2860,54,57,1931.08,3321.00,0.00
2024-12-10 17:19:40,112,2860,54,58,1913.84,3321.01,0.00
2024-12-10 17:19:40,112,2861,54,58,1909.56,3322.00,0.00
2024-12-10 17:19:40,113,2861,55,58,1892.66,3322.01,0.00
2024-12-10 17:19:40,112,2861,54,58,1907.22,3322.07,0.00
2024-12-10 17:19:40,112,2862,54,58,1903.75,3323.00,0.00
2024-12-10 17:19:40,113,2862,54,59,1886.90,3323.01,0.00
2024-12-10 17:19:40,112,2862,54,58,1901.41,3323.07,0.00
2024-12-10 17:19:40,111,2862,54,57,1913.09,3323.18,0.00
2024-12-10 17:19:40,111,2863,54,57,1913.99,3324.00,0.00
2024-12-10 17:19:40,112,2863,55,57,1896.90,3324.01,0.00
2024-12-10 17:19:40,113,2862,55,58,1878.66,3324.07,0.00
2024-12-10 17:19:40,112,2862,55,57,1909.18,3324.13,0.00
2024-12-10 17:19:40,112,2863,55,57,1907.20,3325.00,0.00
2024-12-10 17:19:40,113,2863,56,57,1890.32,3325.01,0.00
2024-12-10 17:19:40,112,2863,55,57,1904.86,3325.07,0.00
2024-12-10 17:19:40,112,2864,55,57,1930.11,3326.00,0.00
2024-12-10 17:19:40,113,2864,56,57,1913.03,3326.01,0.00
2024-12-10 17:19:40,112,2864,55,57,1927.48,3326.08,0.00
2024-12-10 17:19:40,111,2864,55,56,1934.67,3326.35,0.00
2024-12-10 17:19:40,111,2865,55,56,1943.53,3327.00,0.00
2024-12-10 17:19:40,112,2865,55,57,1926.17,3327.01,0.00
2024-12-10 17:19:41,112,2866,55,57,1923.49,3328.00,0.00
2024-12-10 17:19:41,113,2866,56,57,1906.46,3328.01,0.00
2024-12-10 17:19:41,114,2865,57,57,1881.93,3328.26,0.00
2024-12-10 17:19:41,114,2866,57,57,1903.16,3329.00,0.00
2024-12-10 17:19:41,115,2866,57,58,1886.61,3329.01,0.00
2024-12-10 17:19:41,114,2866,56,58,1900.28,3329.09,0.00
2024-12-10 17:19:41,115,2865,57,58,1862.63,3329.75,0.00
2024-12-10 17:19:41,115,2866,57,58,1918.74,3330.00,0.00
2024-12-10 17:19:41,116,2866,58,58,1902.20,3330.01,0.00
2024-12-10 17:19:41,117,2865,59,58,1876.35,3330.32,0.00
2024-12-10 17:19:41,117,2866,59,58,1929.49,3331.00,0.00
2024-12-10 17:19:41,118,2866,60,58,1913.14,3331.01,0.00
2024-12-10 17:19:41,117,2866,59,58,1926.68,3331.09,0.00
2024-12-10 17:19:41,118,2865,59,59,1891.14,3331.69,0.00
2024-12-10 17:19:41,118,2866,59,59,1945.34,3332.00,0.00
2024-12-10 17:19:41,119,2866,60,59,1929.00,3332.01,0.00
2024-12-10 17:19:41,118,2866,60,58,1942.56,3332.09,0.00
2024-12-10 17:19:41,118,2867,60,58,1969.09,3333.00,0.00
2024-12-10 17:19:41,119,2867,61,58,1952.54,3333.01,0.00
2024-12-10 17:19:41,118,2867,60,58,1966.30,3333.09,0.00
2024-12-10 17:19:41,118,2868,60,58,1964.59,3334.00,0.00
2024-12-10 17:19:41,119,2868,61,58,1948.08,3334.01,0.00
2024-12-10 17:19:41,120,2867,61,59,1926.89,3334.18,0.00
2024-12-10 17:19:41,120,2868,61,59,1951.88,3335.00,0.00
2024-12-10 17:19:41,121,2868,62,59,1935.75,3335.01,0.00
2024-12-10 17:19:41,120,2868,61,59,1949.14,3335.08,0.00
2024-12-10 17:19:41,119,2868,60,59,1965.24,3335.08,0.00
2024-12-10 17:19:41,119,2869,60,59,1991.30,3336.00,0.00
2024-12-10 17:19:41,120,2869,61,59,1974.71,3336.01,0.00
2024-12-10 17:19:41,119,2869,60,59,1989.91,3336.04,0.00
2024-12-10 17:19:41,118,2869,59,59,2005.38,3336.08,0.00
2024-12-10 17:19:41,118,2870,59,59,2003.41,3337.00,0.00
2024-12-10 17:19:41,119,2870,60,59,1986.57,3337.01,0.00
2024-12-10 17:19:41,119,2871,60,59,1982.12,3338.00,0.00
2024-12-10 17:19:41,120,2871,61,59,1965.60,3338.01,0.00
2024-12-10 17:19:41,120,2872,61,59,1960.90,3339.00,0.00
2024-12-10 17:19:41,121,2872,62,59,1944.70,3339.01,0.00
2024-12-10 17:19:41,121,2873,62,59,1939.76,3340.00,0.00
2024-12-10 17:19:41,122,2873,62,60,1923.86,3340.01,0.00
2024-12-10 17:19:41,121,2873,61,60,1938.67,3340.03,0.00
2024-12-10 17:19:41,120,2873,61,59,1953.45,3340.07,0.00
2024-12-10 17:19:41,121,2872,62,59,1910.16,3340.91,0.00
2024-12-10 17:19:41,121,2873,62,59,1937.30,3341.00,0.00
2024-12-10 17:19:41,122,2873,62,60,1921.42,3341.01,0.00
2024-12-10 17:19:41,122,2874,62,60,1943.63,3342.00,0.00
2024-12-10 17:19:41,123,2874,62,61,1927.82,3342.01,0.00
2024-12-10 17:19:41,123,2875,62,61,1921.33,3343.00,0.00
2024-12-10 17:19:41,124,2875,62,62,1905.84,3343.01,0.00
2024-12-10 17:19:41,123,2875,61,62,1918.92,3343.07,0.00
2024-12-10 17:19:41,123,2876,61,62,1913.62,3344.00,0.00
2024-12-10 17:19:41,124,2876,61,63,1898.18,3344.01,0.00
2024-12-10 17:19:41,123,2876,60,63,1911.20,3344.07,0.00
2024-12-10 17:19:41,122,2876,60,62,1926.59,3344.07,0.00
2024-12-10 17:19:41,121,2876,60,61,1938.27,3344.16,0.00
2024-12-10 17:19:41,121,2877,60,61,1938.24,3345.00,0.00
2024-12-10 17:19:41,122,2877,60,62,1922.35,3345.01,0.00
2024-12-10 17:19:41,121,2877,59,62,1935.78,3345.07,0.00
2024-12-10 17:19:41,121,2878,59,62,1933.01,3346.00,0.00
2024-12-10 17:19:41,122,2878,59,63,1917.17,3346.01,0.00
2024-12-10 17:19:41,122,2879,59,63,1911.98,3347.00,0.00
2024-12-10 17:19:41,123,2879,60,63,1896.43,3347.01,0.00
2024-12-10 17:19:41,123,2880,60,63,1890.83,3348.00,0.00
2024-12-10 17:19:41,124,2880,61,63,1875.58,3348.01,0.00
2024-12-10 17:19:41,123,2880,61,62,1890.02,3348.02,0.00
2024-12-10 17:19:41,122,2880,61,61,1903.62,3348.07,0.00
2024-12-10 17:19:41,122,2881,61,61,1900.00,3349.00,0.00
2024-12-10 17:19:41,123,2881,61,62,1884.55,3349.01,0.00
2024-12-10 17:19:41,124,2880,62,62,1855.19,3349.45,0.00
2024-12-10 17:19:41,125,2879,63,62,1852.71,3349.53,0.00
2024-12-10 17:19:41,126,2878,63,63,1843.36,3349.71,0.00
2024-12-10 17:19:41,127,2877,64,63,1831.61,3349.87,0.00
2024-12-10 17:19:41,127,2878,64,63,1857.58,3350.00,0.00
2024-12-10 17:19:41,128,2878,65,63,1843.06,3350.01,0.00
2024-12-10 17:19:41,129,2877,65,64,1801.72,3350.76,0.00
2024-12-10 17:19:41,129,2878,65,64,1929.19,3351.00,0.00
2024-12-10 17:19:41,130,2878,66,64,1914.35,3351.01,0.00
2024-12-10 17:19:41,131,2877,66,65,1873.38,3351.70,0.00
2024-12-10 17:19:41,131,2878,66,65,1921.74,3352.00,0.00
2024-12-10 17:19:41,132,2878,67,65,1907.18,3352.01,0.00
2024-12-10 17:19:41,132,2879,67,65,1920.33,3353.00,0.00
2024-12-10 17:19:41,133,2879,68,65,1905.89,3353.01,0.00
2024-12-10 17:19:41,132,2879,68,64,1917.82,3353.08,0.00
2024-12-10 17:19:41,133,2878,69,64,1878.83,3353.65,0.00
2024-12-10 17:19:41,133,2879,69,64,1893.50,3354.00,0.00
2024-12-10 17:19:41,134,2879,70,64,1879.37,3354.01,0.00
2024-12-10 17:19:41,133,2879,70,63,1892.26,3354.04,0.00
2024-12-10 17:19:41,132,2879,69,63,1905.34,3354.07,0.00
2024-12-10 17:19:41,131,2879,68,63,1899.91,3354.51,0.00
2024-12-10 17:19:42,131,2880,68,63,1933.39,3355.00,0.00
2024-12-10 17:19:42,132,2880,68,64,1918.75,3355.01,0.00
2024-12-10 17:19:42,131,2880,68,63,1930.87,3355.08,0.00
2024-12-10 17:19:42,130,2880,67,63,1944.44,3355.09,0.00
2024-12-10 17:19:42,130,2881,67,63,1935.51,3356.00,0.00
2024-12-10 17:19:42,131,2881,68,63,1920.73,3356.01,0.00
2024-12-10 17:19:42,130,2881,67,63,1932.97,3356.08,0.00
2024-12-10 17:19:42,130,2882,67,63,1922.95,3357.00,0.00
2024-12-10 17:19:42,131,2882,67,64,1908.27,3357.01,0.00
2024-12-10 17:19:42,132,2881,67,65,1892.61,3357.05,0.00
2024-12-10 17:19:42,131,2881,67,64,1907.85,3357.47,0.00
2024-12-10 17:19:42,131,2882,67,64,1911.87,3358.00,0.00
2024-12-10 17:19:42,132,2882,68,64,1897.38,3358.01,0.00
2024-12-10 17:19:42,131,2882,68,63,1895.30,3358.48,0.00
2024-12-10 17:19:42,132,2881,68,64,1873.80,3358.67,0.00
2024-12-10 17:19:42,132,2882,68,64,1921.42,3359.00,0.00
2024-12-10 17:19:42,133,2882,69,64,1906.97,3359.01,0.00
2024-12-10 17:19:42,133,2883,69,64,1921.87,3360.00,0.00
2024-12-10 17:19:42,134,2883,70,64,1907.53,3360.01,0.00
2024-12-10 17:19:42,134,2884,70,64,1895.56,3361.00,0.00
2024-12-10 17:19:42,135,2884,70,65,1881.51,3361.01,0.00
2024-12-10 17:19:42,134,2884,69,65,1892.81,3361.08,0.00
2024-12-10 17:19:42,134,2885,69,65,1882.56,3362.00,0.00
2024-12-10 17:19:42,135,2885,70,65,1868.61,3362.01,0.00
2024-12-10 17:19:42,134,2885,70,64,1879.37,3362.08,0.00
2024-12-10 17:19:42,135,2884,70,65,1854.35,3362.41,0.00
2024-12-10 17:19:42,135,2885,70,65,1868.50,3363.00,0.00
2024-12-10 17:19:42,136,2885,70,66,1854.76,3363.01,0.00
2024-12-10 17:19:42,135,2885,70,65,1864.91,3363.07,0.00
2024-12-10 17:19:42,134,2885,70,64,1862.11,3363.47,0.00
2024-12-10 17:19:42,134,2886,70,64,1888.91,3364.00,0.00
2024-12-10 17:19:42,135,2886,71,64,1874.92,3364.01,0.00
2024-12-10 17:19:42,134,2886,71,63,1883.99,3364.08,0.00
2024-12-10 17:19:42,134,2887,71,63,1869.96,3365.00,0.00
2024-12-10 17:19:42,135,2887,72,63,1856.11,3365.01,0.00
2024-12-10 17:19:42,135,2888,72,63,1834.36,3366.00,0.00
2024-12-10 17:19:42,136,2888,73,63,1820.87,3366.01,0.00
2024-12-10 17:19:42,135,2888,72,63,1824.80,3366.10,0.00
2024-12-10 17:19:42,136,2887,73,63,1810.65,3366.13,0.00
2024-12-10 17:19:42,135,2887,72,63,1821.30,3366.65,0.00
2024-12-10 17:19:42,135,2888,72,63,1834.34,3367.00,0.00
2024-12-10 17:19:42,136,2888,73,63,1820.85,3367.01,0.00
2024-12-10 17:19:42,135,2888,72,63,1831.53,3367.06,0.00
2024-12-10 17:19:42,134,2888,71,63,1842.40,3367.08,0.00
2024-12-10 17:19:42,135,2887,71,64,1810.57,3367.51,0.00
2024-12-10 17:19:42,135,2888,71,64,1854.21,3368.00,0.00
2024-12-10 17:19:42,136,2888,72,64,1840.58,3368.01,0.00
2024-12-10 17:19:42,135,2888,71,64,1848.36,3368.08,0.00
2024-12-10 17:19:42,134,2888,71,63,1847.28,3368.46,0.00
2024-12-10 17:19:42,133,2888,71,62,1858.76,3368.48,0.00
2024-12-10 17:19:42,133,2889,71,62,1890.65,3369.00,0.00
2024-12-10 17:19:42,134,2889,71,63,1876.54,3369.01,0.00
2024-12-10 17:19:42,133,2889,71,62,1884.45,3369.08,0.00
2024-12-10 17:19:42,134,2888,71,63,1865.38,3369.25,0.00
2024-12-10 17:19:42,134,2889,71,63,1885.19,3370.00,0.00
2024-12-10 17:19:42,135,2889,72,63,1871.22,3370.01,0.00
2024-12-10 17:19:42,136,2888,73,63,1824.48,3370.90,0.00
2024-12-10 17:19:42,136,2889,73,63,1873.16,3371.00,0.00
2024-12-10 17:19:42,137,2889,74,63,1859.48,3371.01,0.00
2024-12-10 17:19:42,137,2890,74,63,1870.66,3372.00,0.00
2024-12-10 17:19:42,138,2890,75,63,1857.10,3372.01,0.00
2024-12-10 17:19:42,137,2890,74,63,1867.81,3372.07,0.00
2024-12-10 17:19:42,138,2889,75,63,1854.03,3372.09,0.00
2024-12-10 17:19:42,137,2889,75,62,1880.62,3372.10,0.00
2024-12-10 17:19:42,136,2889,74,62,1894.20,3372.10,0.00
2024-12-10 17:19:42,135,2889,74,61,1907.99,3372.10,0.00
2024-12-10 17:19:42,135,2890,74,61,1899.49,3373.00,0.00
2024-12-10 17:19:42,136,2890,75,61,1885.53,3373.01,0.00
2024-12-10 17:19:42,135,2890,74,61,1895.50,3373.09,0.00
2024-12-10 17:19:42,136,2889,74,62,1866.07,3373.53,0.00
2024-12-10 17:19:42,136,2890,74,62,1909.75,3374.00,0.00
2024-12-10 17:19:42,137,2890,74,63,1895.81,3374.01,0.00
2024-12-10 17:19:42,136,2890,73,63,1908.72,3374.02,0.00
2024-12-10 17:19:42,135,2890,73,62,1920.40,3374.08,0.00
2024-12-10 17:19:42,135,2891,73,62,1933.35,3375.00,0.00
2024-12-10 17:19:42,136,2891,73,63,1919.14,3375.01,0.00
2024-12-10 17:19:42,135,2891,73,62,1930.65,3375.08,0.00
2024-12-10 17:19:42,136,2890,74,62,1912.00,3375.23,0.00
2024-12-10 17:19:42,136,2891,74,62,1922.15,3376.00,0.00
2024-12-10 17:19:42,137,2891,75,62,1908.12,3376.01,0.00
2024-12-10 17:19:42,136,2891,74,62,1919.46,3376.08,0.00
2024-12-10 17:19:42,137,2890,74,63,1902.99,3376.17,0.00
2024-12-10 17:19:42,138,2889,75,63,1907.83,3376.27,0.00
2024-12-10 17:19:42,139,2888,75,64,1912.58,3376.29,0.00
2024-12-10 17:19:42,139,2889,75,64,1943.79,3377.00,0.00
2024-12-10 17:19:42,140,2889,76,64,1929.90,3377.01,0.00
2024-12-10 17:19:42,139,2889,76,63,1941.16,3377.08,0.00
2024-12-10 17:19:42,139,2890,76,63,1991.53,3378.00,0.00
2024-12-10 17:19:42,140,2890,76,64,1977.30,3378.01,0.00
2024-12-10 17:19:42,139,2890,76,63,1988.90,3378.08,0.00
2024-12-10 17:19:42,138,2890,75,63,1994.85,3378.28,0.00
2024-12-10 17:19:42,138,2891,75,63,1977.06,3379.00,0.00
2024-12-10 17:19:42,139,2891,76,63,1962.83,3379.01,0.00
2024-12-10 17:19:42,138,2891,76,62,1974.40,3379.08,0.00
2024-12-10 17:19:42,137,2891,75,62,1963.93,3379.63,0.00
2024-12-10 17:19:42,136,2891,74,62,1969.34,3379.74,0.00
2024-12-10 17:19:42,136,2892,74,62,1979.81,3380.00,0.00
2024-12-10 17:19:42,137,2892,75,62,1965.36,3380.01,0.00
2024-12-10 17:19:42,136,2892,74,62,1977.11,3380.08,0.00
2024-12-10 17:19:42,135,2892,73,62,1969.76,3380.54,0.00
2024-12-10 17:19:43,135,2893,73,62,1969.37,3381.00,0.00
2024-12-10 17:19:43,136,2893,74,62,1954.89,3381.01,0.00
2024-12-10 17:19:43,135,2893,73,62,1966.66,3381.08,0.00
2024-12-10 17:19:43,135,2894,73,62,1945.38,3382.00,0.00
2024-12-10 17:19:43,136,2894,74,62,1931.08,3382.01,0.00
2024-12-10 17:19:43,135,2894,73,62,1942.67,3382.08,0.00
2024-12-10 17:19:43,134,2894,73,61,1929.91,3382.72,0.00
2024-12-10 17:19:43,134,2895,73,61,1936.86,3383.00,0.00
2024-12-10 17:19:43,135,2895,74,61,1922.52,3383.01,0.00
2024-12-10 17:19:43,134,2895,73,61,1934.12,3383.08,0.00
2024-12-10 17:19:43,133,2895,73,60,1939.04,3383.35,0.00
2024-12-10 17:19:43,134,2894,73,61,1921.58,3383.46,0.00
2024-12-10 17:19:43,134,2895,73,61,1928.87,3384.00,0.00
2024-12-10 17:19:43,135,2895,74,61,1914.58,3384.01,0.00
2024-12-10 17:19:43,134,2895,74,60,1926.07,3384.08,0.00
2024-12-10 17:19:43,135,2894,74,61,1897.48,3384.47,0.00
2024-12-10 17:19:43,134,2894,73,61,1914.06,3384.73,0.00
2024-12-10 17:19:43,133,2894,72,61,1924.64,3384.74,0.00
2024-12-10 17:19:43,133,2895,72,61,1961.63,3385.00,0.00
2024-12-10 17:19:43,134,2895,73,61,1946.99,3385.01,0.00
2024-12-10 17:19:43,133,2895,73,60,1958.59,3385.08,0.00
2024-12-10 17:19:43,132,2895,72,60,1960.57,3385.46,0.00
2024-12-10 17:19:43,131,2895,72,59,1961.13,3385.87,0.00
2024-12-10 17:19:43,131,2896,72,59,2008.54,3386.00,0.00
2024-12-10 17:19:43,132,2896,72,60,1993.32,3386.01,0.00
2024-12-10 17:19:43,131,2896,72,59,2005.09,3386.08,0.00
2024-12-10 17:19:43,130,2896,72,58,2011.41,3386.32,0.00
2024-12-10 17:19:43,130,2897,72,58,2014.76,3387.00,0.00
2024-12-10 17:19:43,131,2897,72,59,1999.38,3387.01,0.00
2024-12-10 17:19:43,131,2898,72,59,1990.33,3388.00,0.00
2024-12-10 17:19:43,132,2898,73,59,1975.26,3388.01,0.00
2024-12-10 17:19:43,132,2899,73,59,1965.20,3389.00,0.00
2024-12-10 17:19:43,133,2899,74,59,1950.42,3389.01,0.00
2024-12-10 17:19:43,132,2899,73,59,1963.61,3389.01,0.00
2024-12-10 17:19:43,131,2899,72,59,1975.74,3389.09,0.00
2024-12-10 17:19:43,130,2899,72,58,1990.68,3389.09,0.00
2024-12-10 17:19:43,131,2898,72,59,1972.40,3389.20,0.00
2024-12-10 17:19:43,131,2899,72,59,1981.80,3390.00,0.00
2024-12-10 17:19:43,132,2899,72,60,1966.78,3390.01,0.00
2024-12-10 17:19:43,131,2899,72,59,1978.74,3390.09,0.00
2024-12-10 17:19:43,131,2900,72,59,1991.48,3391.00,0.00
2024-12-10 17:19:43,132,2900,73,59,1976.39,3391.01,0.00
2024-12-10 17:19:43,131,2900,73,58,1988.42,3391.09,0.00
2024-12-10 17:19:43,131,2901,73,58,1973.75,3392.00,0.00
2024-12-10 17:19:43,132,2901,74,58,1958.80,3392.01,0.00
2024-12-10 17:19:43,131,2901,73,58,1970.68,3392.09,0.00
2024-12-10 17:19:43,132,2900,73,59,1923.61,3392.82,0.00
2024-12-10 17:19:43,132,2901,73,59,1944.34,3393.00,0.00
2024-12-10 17:19:43,133,2901,73,60,1929.72,3393.01,0.00
2024-12-10 17:19:43,132,2901,72,60,1932.93,3393.16,0.00
2024-12-10 17:19:43,132,2902,72,60,1950.23,3394.00,0.00
2024-12-10 17:19:43,133,2902,73,60,1935.56,3394.01,0.00
2024-12-10 17:19:43,132,2902,73,59,1946.81,3394.10,0.00
2024-12-10 17:19:43,131,2902,72,59,1958.11,3394.18,0.00
2024-12-10 17:19:43,132,2901,73,59,1936.66,3394.39,0.00
2024-12-10 17:19:43,132,2902,73,59,1939.54,3395.00,0.00
2024-12-10 17:19:43,133,2902,74,59,1924.96,3395.01,0.00
2024-12-10 17:19:43,132,2902,74,58,1935.85,3395.11,0.00
2024-12-10 17:19:43,133,2901,75,58,1919.53,3395.17,0.00
2024-12-10 17:19:43,134,2900,76,58,1914.86,3395.44,0.00
2024-12-10 17:19:43,134,2901,76,58,1955.29,3396.00,0.00
2024-12-10 17:19:43,135,2901,77,58,1940.81,3396.01,0.00
2024-12-10 17:19:43,134,2901,77,57,1951.59,3396.10,0.00
2024-12-10 17:19:43,134,2902,77,57,1989.75,3397.00,0.00
2024-12-10 17:19:43,135,2902,77,58,1975.01,3397.01,0.00
2024-12-10 17:19:43,134,2902,76,58,1985.94,3397.10,0.00
2024-12-10 17:19:43,135,2901,77,58,1955.90,3397.51,0.00
2024-12-10 17:19:43,136,2900,78,58,1952.53,3397.54,0.00
2024-12-10 17:19:43,136,2901,78,58,1965.77,3398.00,0.00
2024-12-10 17:19:43,137,2901,79,58,1951.42,3398.01,0.00
2024-12-10 17:19:43,136,2901,78,58,1961.53,3398.11,0.00
2024-12-10 17:19:43,136,2902,78,58,1996.04,3399.00,0.00
2024-12-10 17:19:43,137,2902,79,58,1981.47,3399.01,0.00
2024-12-10 17:19:43,136,2902,79,57,1954.82,3399.89,0.00
2024-12-10 17:19:43,136,2903,79,57,1976.16,3400.00,0.00
2024-12-10 17:19:43,137,2903,79,58,1961.74,3400.01,0.00
2024-12-10 17:19:43,136,2903,79,57,1970.21,3400.12,0.00
2024-12-10 17:19:43,136,2904,79,57,1953.89,3401.00,0.00
2024-12-10 17:19:43,137,2904,79,58,1939.63,3401.01,0.00
2024-12-10 17:19:43,136,2904,78,58,1922.70,3401.68,0.00
2024-12-10 17:19:43,136,2905,78,58,1930.29,3402.00,0.00
2024-12-10 17:19:43,137,2905,78,59,1916.20,3402.01,0.00
2024-12-10 17:19:43,137,2906,78,59,1891.72,3403.00,0.00
2024-12-10 17:19:43,138,2906,79,59,1878.01,3403.01,0.00
2024-12-10 17:19:43,138,2907,79,59,1850.06,3404.00,0.00
2024-12-10 17:19:43,139,2907,79,60,1836.75,3404.01,0.00
2024-12-10 17:19:43,138,2907,79,59,1814.05,3404.70,0.00
2024-12-10 17:19:43,139,2906,80,59,1794.54,3404.79,0.00
2024-12-10 17:19:43,140,2905,80,60,1792.44,3404.93,0.00
2024-12-10 17:19:43,140,2906,80,60,1816.34,3405.00,0.00
2024-12-10 17:19:43,141,2906,81,60,1803.46,3405.01,0.00
2024-12-10 17:19:43,140,2906,80,60,1777.69,3405.76,0.00
2024-12-10 17:19:43,140,2907,80,60,1836.28,3406.00,0.00
2024-12-10 17:19:43,141,2907,81,60,1823.25,3406.01,0.00
2024-12-10 17:19:43,140,2907,81,59,1826.51,3406.12,0.00
2024-12-10 17:19:43,139,2907,81,58,1824.28,3406.55,0.00
2024-12-10 17:19:43,138,2907,80,58,1833.99,3406.59,0.00
2024-12-10 17:19:43,138,2908,80,58,1837.82,3407.00,0.00
2024-12-10 17:19:43,139,2908,81,58,1824.60,3407.01,0.00
2024-12-10 17:19:44,138,2908,81,57,1832.16,3407.13,0.00
2024-12-10 17:19:44,137,2908,81,56,1845.32,3407.13,0.00
2024-12-10 17:19:44,137,2909,81,56,1830.31,3408.00,0.00
2024-12-10 17:19:44,138,2909,81,57,1817.05,3408.01,0.00
2024-12-10 17:19:44,137,2909,81,56,1826.81,3408.08,0.00
2024-12-10 17:19:44,137,2910,81,56,1808.47,3409.00,0.00
2024-12-10 17:19:44,138,2910,81,57,1795.36,3409.01,0.00
2024-12-10 17:19:44,137,2910,80,57,1775.46,3409.74,0.00
2024-12-10 17:19:44,137,2911,80,57,1787.22,3410.00,0.00
2024-12-10 17:19:44,138,2911,80,58,1774.26,3410.01,0.00
2024-12-10 17:19:44,138,2912,80,58,1754.24,3411.00,0.00
2024-12-10 17:19:44,139,2912,81,58,1741.61,3411.01,0.00
2024-12-10 17:19:44,138,2912,80,58,1747.76,3411.12,0.00
2024-12-10 17:19:44,138,2913,80,58,1731.89,3412.00,0.00
2024-12-10 17:19:44,139,2913,80,59,1719.43,3412.01,0.00
2024-12-10 17:19:44,138,2913,79,59,1725.17,3412.12,0.00
2024-12-10 17:19:44,137,2913,78,59,1736.40,3412.15,0.00
2024-12-10 17:19:44,136,2913,78,58,1741.14,3412.36,0.00
2024-12-10 17:19:44,135,2913,78,57,1748.13,3412.53,0.00
2024-12-10 17:19:44,134,2913,77,57,1739.71,3412.94,0.00
2024-12-10 17:19:44,134,2914,77,57,1763.19,3413.00,0.00
2024-12-10 17:19:44,135,2914,77,58,1750.13,3413.01,0.00
2024-12-10 17:19:44,135,2915,77,58,1732.84,3414.00,0.00
2024-12-10 17:19:44,136,2915,77,59,1720.10,3414.01,0.00
2024-12-10 17:19:44,135,2915,76,59,1732.34,3414.02,0.00
2024-12-10 17:19:44,134,2915,76,58,1744.76,3414.02,0.00
2024-12-10 17:19:44,133,2915,76,57,1756.76,3414.05,0.00
2024-12-10 17:19:44,132,2915,76,56,1766.10,3414.11,0.00
2024-12-10 17:19:44,131,2915,75,56,1779.32,3414.11,0.00
2024-12-10 17:19:44,130,2915,74,56,1792.75,3414.11,0.00
2024-12-10 17:19:44,130,2916,74,56,1781.33,3415.00,0.00
2024-12-10 17:19:44,131,2916,74,57,1767.73,3415.01,0.00
2024-12-10 17:19:44,132,2915,74,58,1746.70,3415.19,0.00
2024-12-10 17:19:44,131,2915,73,58,1762.93,3415.68,0.00
2024-12-10 17:19:44,130,2915,72,58,1769.65,3415.80,0.00
2024-12-10 17:19:44,130,2916,72,58,1787.42,3416.00,0.00
2024-12-10 17:19:44,131,2916,72,59,1773.77,3416.01,0.00
2024-12-10 17:19:44,132,2915,73,59,1759.56,3416.05,0.00
2024-12-10 17:19:44,131,2915,73,58,1790.84,3416.12,0.00
2024-12-10 17:19:44,131,2916,73,58,1810.52,3417.00,0.00
2024-12-10 17:19:44,132,2916,73,59,1796.80,3417.01,0.00
2024-12-10 17:19:44,132,2917,73,59,1808.52,3418.00,0.00
2024-12-10 17:19:44,133,2917,74,59,1794.92,3418.01,0.00
2024-12-10 17:19:44,133,2918,74,59,1778.23,3419.00,0.00
2024-12-10 17:19:44,134,2918,75,59,1764.96,3419.01,0.00
2024-12-10 17:19:44,133,2918,74,59,1776.95,3419.04,0.00
2024-12-10 17:19:44,132,2918,74,58,1786.67,3419.07,0.00
2024-12-10 17:19:44,132,2918,74,58,1774.65,3420.00,0.00
2024-12-10 17:19:44,133,2918,75,58,1761.31,3420.01,0.00
2024-12-10 17:19:44,132,2918,75,57,1769.67,3420.11,0.00
2024-12-10 17:19:44,132,2919,75,57,1757.26,3421.00,0.00
2024-12-10 17:19:44,133,2919,76,57,1744.05,3421.01,0.00
2024-12-10 17:19:44,134,2918,77,57,1727.05,3421.09,0.00
2024-12-10 17:19:44,133,2918,77,56,1757.28,3421.11,0.00
2024-12-10 17:19:44,133,2919,77,56,1742.75,3422.00,0.00
2024-12-10 17:19:44,134,2919,77,57,1729.75,3422.01,0.00
2024-12-10 17:19:44,133,2919,77,56,1739.67,3422.05,0.00
2024-12-10 17:19:44,132,2919,76,56,1750.80,3422.10,0.00
2024-12-10 17:19:44,131,2919,76,55,1732.83,3422.81,0.00
2024-12-10 17:19:44,131,2920,76,55,1773.56,3423.00,0.00
2024-12-10 17:19:44,132,2920,76,56,1760.13,3423.01,0.00
2024-12-10 17:19:44,132,2921,76,56,1740.09,3424.00,0.00
2024-12-10 17:19:44,133,2921,76,57,1727.01,3424.01,0.00
2024-12-10 17:19:44,132,2921,75,57,1739.83,3424.01,0.00
2024-12-10 17:19:44,131,2921,74,57,1749.20,3424.10,0.00
2024-12-10 17:19:44,132,2920,74,58,1735.95,3424.11,0.00
2024-12-10 17:19:44,131,2920,73,58,1772.62,3424.18,0.00
2024-12-10 17:19:44,130,2920,72,58,1754.42,3424.82,0.00
2024-12-10 17:19:44,130,2921,72,58,1771.92,3425.00,0.00
2024-12-10 17:19:44,131,2921,72,59,1758.39,3425.01,0.00
2024-12-10 17:19:44,132,2920,73,59,1722.18,3425.52,0.00
2024-12-10 17:19:44,132,2921,73,59,1769.99,3426.00,0.00
2024-12-10 17:19:44,133,2921,74,59,1756.69,3426.01,0.00
2024-12-10 17:19:44,132,2921,73,59,1764.63,3426.11,0.00
2024-12-10 17:19:44,131,2921,73,58,1773.35,3426.24,0.00
2024-12-10 17:19:44,130,2921,72,58,1783.79,3426.29,0.00
2024-12-10 17:19:44,130,2922,72,58,1795.87,3427.00,0.00
2024-12-10 17:19:44,131,2922,73,58,1782.16,3427.01,0.00
2024-12-10 17:19:44,130,2922,73,57,1778.86,3427.39,0.00
2024-12-10 17:19:44,131,2921,73,58,1762.44,3427.49,0.00
2024-12-10 17:19:44,131,2922,73,58,1770.46,3428.00,0.00
2024-12-10 17:19:44,132,2922,73,59,1757.04,3428.01,0.00
2024-12-10 17:19:44,131,2922,72,59,1768.55,3428.05,0.00
2024-12-10 17:19:44,132,2921,72,60,1755.16,3428.06,0.00
2024-12-10 17:19:44,131,2921,71,60,1779.32,3428.13,0.00
2024-12-10 17:19:44,130,2921,71,59,1758.56,3428.81,0.00
2024-12-10 17:19:44,130,2922,71,59,1802.58,3429.00,0.00
2024-12-10 17:19:44,131,2922,72,59,1788.82,3429.01,0.00
2024-12-10 17:19:44,130,2922,71,59,1800.50,3429.06,0.00
2024-12-10 17:19:44,129,2922,70,59,1812.09,3429.12,0.00
2024-12-10 17:19:44,128,2922,69,59,1797.68,3429.70,0.00
2024-12-10 17:19:44,128,2923,69,59,1837.85,3430.00,0.00
2024-12-10 17:19:44,129,2923,70,59,1823.60,3430.01,0.00
2024-12-10 17:19:44,128,2923,69,59,1833.62,3430.13,0.00
2024-12-10 17:19:44,128,2924,69,59,1818.59,3431.00,0.00
2024-12-10 17:19:44,129,2924,69,60,1804.49,3431.01,0.00
2024-12-10 17:19:44,128,2924,68,60,1796.98,3431.45,0.00
2024-12-10 17:19:44,128,2925,68,60,1794.15,3432.00,0.00
2024-12-10 17:19:44,129,2925,69,60,1780.24,3432.01,0.00
2024-12-10 17:19:44,130,2924,69,61,1765.76,3432.05,0.00
2024-12-10 17:19:44,129,2924,68,61,1766.20,3432.66,0.00
2024-12-10 17:19:45,129,2925,68,61,1774.04,3433.00,0.00
2024-12-10 17:19:45,130,2925,69,61,1760.40,3433.01,0.00
2024-12-10 17:19:45,131,2924,69,62,1743.34,3433.13,0.00
2024-12-10 17:19:45,130,2924,68,62,1769.18,3433.14,0.00
2024-12-10 17:19:45,131,2923,69,62,1754.37,3433.19,0.00
2024-12-10 17:19:45,130,2923,69,61,1755.39,3433.56,0.00
2024-12-10 17:19:45,131,2922,70,61,1735.46,3433.71,0.00
2024-12-10 17:19:45,131,2923,70,61,1779.43,3434.00,0.00
2024-12-10 17:19:45,132,2923,70,62,1765.95,3434.01,0.00
2024-12-10 17:19:45,131,2923,70,61,1778.91,3434.02,0.00
2024-12-10 17:19:45,130,2923,70,60,1788.43,3434.13,0.00
2024-12-10 17:19:45,130,2923,70,60,1846.45,3435.00,0.00
2024-12-10 17:19:45,131,2923,71,60,1832.36,3435.01,0.00
2024-12-10 17:19:45,130,2923,70,60,1842.03,3435.13,0.00
2024-12-10 17:19:45,129,2923,69,60,1852.45,3435.22,0.00
2024-12-10 17:19:45,128,2923,69,59,1823.98,3435.91,0.00
2024-12-10 17:19:45,128,2924,69,59,1847.68,3436.00,0.00
2024-12-10 17:19:45,129,2924,70,59,1833.36,3436.01,0.00
2024-12-10 17:19:45,128,2924,69,59,1829.77,3436.41,0.00
2024-12-10 17:19:45,127,2924,69,58,1834.36,3436.62,0.00
2024-12-10 17:19:45,127,2925,69,58,1846.28,3437.00,0.00
2024-12-10 17:19:45,128,2925,69,59,1831.86,3437.01,0.00
2024-12-10 17:19:45,127,2925,68,59,1841.41,3437.13,0.00
2024-12-10 17:19:45,126,2925,68,58,1855.16,3437.15,0.00
2024-12-10 17:19:45,125,2925,68,57,1868.75,3437.18,0.00
2024-12-10 17:19:45,125,2926,68,57,1863.70,3438.00,0.00
2024-12-10 17:19:45,126,2926,68,58,1848.91,3438.01,0.00
2024-12-10 17:19:45,125,2926,67,58,1858.44,3438.14,0.00
2024-12-10 17:19:45,125,2927,67,58,1845.35,3439.00,0.00
2024-12-10 17:19:45,126,2927,67,59,1830.71,3439.01,0.00
2024-12-10 17:19:45,125,2927,67,58,1818.72,3439.70,0.00
2024-12-10 17:19:45,125,2928,67,58,1818.37,3440.00,0.00
2024-12-10 17:19:45,126,2928,67,59,1803.94,3440.01,0.00
2024-12-10 17:19:45,125,2928,66,59,1812.50,3440.14,0.00
2024-12-10 17:19:45,125,2929,66,59,1783.90,3441.00,0.00
2024-12-10 17:19:45,126,2929,66,60,1769.74,3441.01,0.00
2024-12-10 17:19:45,126,2930,66,60,1728.77,3442.00,0.00
2024-12-10 17:19:45,127,2930,66,61,1715.16,3442.01,0.00
2024-12-10 17:19:45,126,2930,66,60,1685.01,3442.80,0.00
2024-12-10 17:19:45,125,2930,66,59,1677.96,3442.94,0.00
2024-12-10 17:19:45,125,2931,66,59,1703.62,3443.00,0.00
2024-12-10 17:19:45,126,2931,66,60,1690.10,3443.01,0.00
2024-12-10 17:19:45,125,2931,66,59,1697.15,3443.14,0.00
2024-12-10 17:19:45,124,2931,66,58,1683.29,3443.75,0.00
2024-12-10 17:19:45,123,2931,66,57,1684.42,3443.89,0.00
2024-12-10 17:19:45,123,2932,66,57,1702.31,3444.00,0.00
2024-12-10 17:19:45,124,2932,67,57,1688.58,3444.01,0.00
2024-12-10 17:19:45,123,2932,67,56,1695.64,3444.15,0.00
2024-12-10 17:19:45,122,2932,66,56,1673.17,3444.89,0.00
2024-12-10 17:19:45,122,2933,66,56,1697.55,3445.00,0.00
2024-12-10 17:19:45,123,2933,67,56,1683.75,3445.01,0.00
2024-12-10 17:19:45,122,2933,66,56,1663.32,3445.78,0.00
2024-12-10 17:19:45,122,2934,66,56,1680.59,3446.00,0.00
2024-12-10 17:19:45,123,2934,66,57,1666.93,3446.01,0.00
2024-12-10 17:19:45,122,2934,66,56,1673.23,3446.15,0.00
2024-12-10 17:19:45,121,2934,66,55,1685.60,3446.19,0.00
2024-12-10 17:19:45,121,2935,66,55,1677.56,3447.00,0.00
2024-12-10 17:19:45,122,2935,66,56,1663.81,3447.01,0.00
2024-12-10 17:19:45,123,2934,67,56,1647.52,3447.11,0.00
2024-12-10 17:19:45,122,2934,67,55,1667.13,3447.13,0.00
2024-12-10 17:19:45,122,2935,67,55,1655.21,3448.00,0.00
2024-12-10 17:19:45,123,2935,68,55,1641.76,3448.01,0.00
2024-12-10 17:19:45,122,2935,67,55,1649.70,3448.14,0.00
2024-12-10 17:19:45,121,2935,66,55,1657.83,3448.29,0.00
2024-12-10 17:19:45,120,2935,66,54,1655.76,3448.68,0.00
2024-12-10 17:19:45,119,2935,65,54,1659.20,3448.81,0.00
2024-12-10 17:19:45,119,2936,65,54,1710.65,3449.00,0.00
2024-12-10 17:19:45,120,2936,66,54,1696.40,3449.01,0.00
2024-12-10 17:19:45,119,2936,65,54,1706.36,3449.13,0.00
2024-12-10 17:19:45,118,2936,65,53,1719.34,3449.14,0.00
2024-12-10 17:19:45,117,2936,64,53,1733.45,3449.15,0.00
2024-12-10 17:19:45,118,2935,64,54,1694.64,3449.87,0.00
2024-12-10 17:19:45,118,2936,64,54,1728.06,3450.00,0.00
2024-12-10 17:19:45,119,2936,64,55,1713.54,3450.01,0.00
2024-12-10 17:19:45,118,2936,63,55,1722.20,3450.14,0.00
2024-12-10 17:19:45,118,2937,63,55,1751.14,3451.00,0.00
2024-12-10 17:19:45,119,2937,64,55,1736.43,3451.01,0.00
2024-12-10 17:19:45,118,2937,64,54,1748.54,3451.08,0.00
2024-12-10 17:19:45,117,2937,64,53,1759.87,3451.15,0.00
2024-12-10 17:19:45,117,2938,64,53,1759.18,3452.00,0.00
2024-12-10 17:19:45,118,2938,65,53,1744.27,3452.01,0.00
2024-12-10 17:19:45,117,2938,64,53,1753.25,3452.15,0.00
2024-12-10 17:19:45,117,2939,64,53,1750.82,3453.00,0.00
2024-12-10 17:19:45,118,2939,65,53,1735.98,3453.01,0.00
2024-12-10 17:19:45,117,2939,65,52,1748.48,3453.07,0.00
2024-12-10 17:19:45,118,2938,65,53,1730.70,3453.14,0.00
2024-12-10 17:19:45,117,2938,64,53,1761.43,3453.15,0.00
2024-12-10 17:19:45,116,2938,63,53,1776.32,3453.15,0.00
2024-12-10 17:19:45,115,2938,63,52,1790.70,3453.17,0.00
2024-12-10 17:19:45,115,2939,63,52,1789.44,3454.00,0.00
2024-12-10 17:19:45,116,2939,64,52,1774.01,3454.01,0.00
2024-12-10 17:19:45,115,2939,63,52,1782.75,3454.14,0.00
2024-12-10 17:19:45,115,2940,63,52,1810.06,3455.00,0.00
2024-12-10 17:19:45,116,2940,63,53,1794.46,3455.01,0.00
2024-12-10 17:19:45,116,2941,63,53,1781.68,3456.00,0.00
2024-12-10 17:19:45,117,2941,63,54,1766.46,3456.01,0.00
2024-12-10 17:19:45,116,2941,62,54,1781.16,3456.01,0.00
2024-12-10 17:19:45,115,2941,62,53,1772.31,3456.44,0.00
2024-12-10 17:19:45,115,2942,62,53,1781.52,3457.00,0.00
2024-12-10 17:19:45,116,2942,62,54,1766.16,3457.01,0.00
2024-12-10 17:19:45,115,2942,61,54,1777.85,3457.10,0.00
2024-12-10 17:19:45,114,2942,61,53,1792.26,3457.12,0.00
2024-12-10 17:19:45,114,2943,61,53,1788.58,3458.00,0.00
2024-12-10 17:19:45,115,2943,61,54,1773.03,3458.01,0.00
2024-12-10 17:19:45,114,2943,61,53,1785.89,3458.08,0.00
2024-12-10 17:19:45,113,2943,60,53,1798.41,3458.12,0.00
2024-12-10 17:19:45,113,2944,60,53,1792.53,3459.00,0.00
2024-12-10 17:19:45,114,2944,61,53,1776.80,3459.01,0.00
2024-12-10 17:19:45,113,2944,61,52,1787.26,3459.10,0.00
2024-12-10 17:19:45,112,2944,60,52,1798.10,3459.21,0.00
2024-12-10 17:19:46,112,2945,60,52,1793.96,3460.00,0.00
2024-12-10 17:19:46,113,2945,61,52,1778.08,3460.01,0.00
2024-12-10 17:19:46,113,2946,61,52,1763.35,3461.00,0.00
2024-12-10 17:19:46,114,2946,62,52,1747.88,3461.01,0.00
2024-12-10 17:19:46,114,2947,62,52,1730.19,3462.00,0.00
2024-12-10 17:19:46,115,2947,63,52,1715.14,3462.01,0.00
2024-12-10 17:19:46,116,2946,63,53,1697.12,3462.11,0.00
2024-12-10 17:19:46,115,2946,62,53,1713.99,3462.11,0.00
2024-12-10 17:19:46,114,2946,61,53,1706.27,3462.58,0.00
2024-12-10 17:19:46,113,2946,60,53,1719.93,3462.59,0.00
2024-12-10 17:19:46,113,2947,60,53,1732.51,3463.00,0.00
2024-12-10 17:19:46,114,2947,60,54,1717.31,3463.01,0.00
2024-12-10 17:19:46,113,2947,60,53,1728.21,3463.11,0.00
2024-12-10 17:19:46,112,2947,59,53,1721.69,3463.67,0.00
2024-12-10 17:19:46,112,2948,59,53,1772.36,3464.00,0.00
2024-12-10 17:19:46,113,2948,60,53,1756.68,3464.01,0.00
2024-12-10 17:19:46,112,2948,59,53,1767.53,3464.11,0.00
2024-12-10 17:19:46,111,2948,58,53,1777.68,3464.26,0.00
2024-12-10 17:19:46,111,2949,58,53,1783.05,3465.00,0.00
2024-12-10 17:19:46,112,2949,59,53,1767.13,3465.01,0.00
2024-12-10 17:19:46,112,2950,59,53,1760.67,3466.00,0.00
2024-12-10 17:19:46,113,2950,60,53,1745.09,3466.01,0.00
2024-12-10 17:19:46,112,2950,59,53,1756.48,3466.11,0.00
2024-12-10 17:19:46,111,2950,58,53,1771.99,3466.11,0.00
2024-12-10 17:19:46,112,2949,58,54,1739.80,3466.50,0.00
2024-12-10 17:19:46,112,2950,58,54,1769.93,3467.00,0.00
2024-12-10 17:19:46,113,2950,59,54,1754.27,3467.01,0.00
2024-12-10 17:19:46,112,2950,59,53,1768.09,3467.05,0.00
2024-12-10 17:19:46,111,2950,59,52,1782.18,3467.10,0.00
2024-12-10 17:19:46,110,2950,58,52,1797.29,3467.13,0.00
2024-12-10 17:19:46,110,2951,58,52,1826.86,3468.00,0.00
2024-12-10 17:19:46,111,2951,59,52,1810.40,3468.01,0.00
2024-12-10 17:19:46,110,2951,58,52,1823.44,3468.10,0.00
2024-12-10 17:19:46,109,2951,57,52,1832.88,3468.27,0.00
2024-12-10 17:19:46,109,2952,57,52,1837.16,3469.00,0.00
2024-12-10 17:19:46,110,2952,58,52,1820.46,3469.01,0.00
2024-12-10 17:19:46,109,2952,58,51,1833.71,3469.10,0.00
2024-12-10 17:19:46,108,2952,58,50,1850.36,3469.10,0.00
2024-12-10 17:19:46,107,2952,58,49,1860.27,3469.28,0.00
2024-12-10 17:19:46,107,2953,58,49,1868.19,3470.00,0.00
2024-12-10 17:19:46,108,2953,59,49,1850.89,3470.01,0.00
2024-12-10 17:19:46,108,2954,59,49,1848.90,3471.00,0.00
2024-12-10 17:19:46,109,2954,59,50,1831.94,3471.01,0.00
2024-12-10 17:19:46,108,2954,58,50,1845.62,3471.07,0.00
2024-12-10 17:19:46,108,2955,58,50,1845.85,3472.00,0.00
2024-12-10 17:19:46,109,2955,58,51,1828.91,3472.01,0.00
2024-12-10 17:19:46,108,2955,57,51,1842.11,3472.09,0.00
2024-12-10 17:19:46,109,2954,57,52,1812.65,3472.47,0.00
2024-12-10 17:19:46,109,2955,57,52,1843.95,3473.00,0.00
2024-12-10 17:19:46,110,2955,58,52,1827.19,3473.01,0.00
2024-12-10 17:19:46,110,2956,58,52,1855.85,3474.00,0.00
2024-12-10 17:19:46,111,2956,59,52,1839.14,3474.01,0.00
2024-12-10 17:19:46,110,2956,59,51,1850.60,3474.16,0.00
2024-12-10 17:19:46,110,2957,59,51,1852.57,3475.00,0.00
2024-12-10 17:19:46,111,2957,59,52,1835.88,3475.01,0.00
2024-12-10 17:19:46,110,2957,58,52,1851.63,3475.03,0.00
2024-12-10 17:19:46,109,2957,58,51,1866.42,3475.08,0.00
2024-12-10 17:19:46,108,2957,57,51,1883.38,3475.08,0.00
2024-12-10 17:19:46,108,2958,57,51,1882.70,3476.00,0.00
2024-12-10 17:19:46,109,2958,57,52,1865.43,3476.01,0.00
2024-12-10 17:19:46,108,2958,56,52,1879.82,3476.08,0.00
2024-12-10 17:19:46,107,2958,56,51,1897.07,3476.08,0.00
2024-12-10 17:19:46,106,2958,55,51,1914.64,3476.09,0.00
2024-12-10 17:19:46,105,2958,55,50,1932.54,3476.09,0.00
2024-12-10 17:19:46,105,2959,55,50,1932.22,3477.00,0.00
2024-12-10 17:19:46,106,2959,55,51,1913.99,3477.01,0.00
2024-12-10 17:19:46,105,2959,54,51,1927.85,3477.09,0.00
2024-12-10 17:19:46,104,2959,53,51,1943.46,3477.16,0.00
2024-12-10 17:19:46,103,2959,52,51,1952.35,3477.45,0.00
2024-12-10 17:19:46,103,2960,52,51,1967.28,3478.00,0.00
2024-12-10 17:19:46,104,2960,52,52,1948.37,3478.01,0.00
2024-12-10 17:19:46,104,2961,52,52,1945.08,3479.00,0.00
2024-12-10 17:19:46,105,2961,53,52,1926.55,3479.01,0.00
2024-12-10 17:19:46,106,2960,53,53,1894.06,3479.35,0.00
2024-12-10 17:19:46,106,2961,53,53,1926.03,3480.00,0.00
2024-12-10 17:19:46,107,2961,54,53,1908.03,3480.01,0.00
2024-12-10 17:19:46,106,2961,53,53,1919.61,3480.09,0.00
2024-12-10 17:19:46,106,2962,53,53,1953.69,3481.00,0.00
2024-12-10 17:19:46,107,2962,54,53,1935.43,3481.01,0.00
2024-12-10 17:19:46,107,2963,54,53,1931.25,3482.00,0.00
2024-12-10 17:19:46,108,2963,54,54,1913.37,3482.01,0.00
2024-12-10 17:19:46,108,2964,54,54,1910.09,3483.00,0.00
2024-12-10 17:19:46,109,2964,54,55,1892.57,3483.01,0.00
2024-12-10 17:19:46,108,2964,54,54,1907.07,3483.08,0.00
2024-12-10 17:19:46,108,2965,54,54,1905.72,3484.00,0.00
2024-12-10 17:19:46,109,2965,54,55,1888.24,3484.01,0.00
2024-12-10 17:19:46,108,2965,53,55,1901.93,3484.08,0.00
2024-12-10 17:19:46,107,2965,52,55,1910.48,3484.26,0.00
2024-12-10 17:19:46,108,2964,52,56,1874.99,3484.80,0.00
2024-12-10 17:19:46,108,2965,52,56,1906.47,3485.00,0.00
2024-12-10 17:19:46,109,2965,53,56,1888.98,3485.01,0.00
2024-12-10 17:19:46,108,2965,53,55,1905.51,3485.03,0.00
2024-12-10 17:19:46,107,2965,52,55,1921.39,3485.08,0.00
2024-12-10 17:19:46,107,2966,52,55,1953.69,3486.00,0.00
2024-12-10 17:19:46,108,2966,53,55,1935.60,3486.01,0.00
2024-12-10 17:19:46,107,2966,53,54,1950.92,3486.08,0.00
2024-12-10 17:19:46,107,2967,53,54,1948.76,3487.00,0.00
2024-12-10 17:19:46,108,2967,54,54,1930.72,3487.01,0.00
2024-12-10 17:19:46,107,2967,54,53,1945.79,3487.08,0.00
2024-12-10 17:19:46,107,2968,54,53,1941.35,3488.00,0.00
2024-12-10 17:19:46,108,2968,54,54,1923.38,3488.01,0.00
2024-12-10 17:19:46,107,2968,53,54,1938.38,3488.08,0.00
2024-12-10 17:19:47,107,2969,53,54,1932.39,3489.00,0.00
2024-12-10 17:19:47,108,2969,53,55,1914.50,3489.01,0.00
2024-12-10 17:19:47,107,2969,52,55,1917.49,3489.37,0.00
2024-12-10 17:19:47,107,2970,52,55,1928.70,3490.00,0.00
2024-12-10 17:19:47,108,2970,52,56,1910.84,3490.01,0.00
2024-12-10 17:19:47,109,2969,52,57,1892.18,3490.05,0.00
2024-12-10 17:19:47,108,2969,52,56,1930.09,3490.08,0.00
2024-12-10 17:19:47,108,2970,52,56,1928.75,3491.00,0.00
2024-12-10 17:19:47,109,2970,52,57,1911.05,3491.01,0.00
2024-12-10 17:19:47,109,2971,52,57,1937.98,3492.00,0.00
2024-12-10 17:19:47,110,2971,53,57,1920.36,3492.01,0.00
2024-12-10 17:19:47,109,2971,52,57,1935.22,3492.07,0.00
2024-12-10 17:19:47,109,2972,52,57,1932.33,3493.00,0.00
2024-12-10 17:19:47,110,2972,52,58,1914.76,3493.01,0.00
2024-12-10 17:19:47,110,2973,52,58,1908.38,3494.00,0.00
2024-12-10 17:19:47,111,2973,53,58,1891.19,3494.01,0.00
2024-12-10 17:19:47,110,2973,52,58,1905.87,3494.07,0.00
2024-12-10 17:19:47,109,2973,51,58,1923.32,3494.07,0.00
2024-12-10 17:19:47,109,2974,51,58,1918.57,3495.00,0.00
2024-12-10 17:19:47,110,2974,51,59,1901.13,3495.01,0.00
2024-12-10 17:19:47,111,2973,52,59,1861.43,3495.50,0.00
2024-12-10 17:19:47,111,2974,52,59,1891.32,3496.00,0.00
2024-12-10 17:19:47,112,2974,52,60,1874.43,3496.01,0.00
2024-12-10 17:19:47,111,2974,52,59,1886.14,3496.14,0.00
2024-12-10 17:19:47,110,2974,52,58,1900.88,3496.16,0.00
2024-12-10 17:19:47,109,2974,52,57,1917.16,3496.17,0.00
2024-12-10 17:19:47,109,2975,52,57,1952.96,3497.00,0.00
2024-12-10 17:19:47,110,2975,53,57,1935.21,3497.01,0.00
2024-12-10 17:19:47,109,2975,52,57,1949.95,3497.08,0.00
2024-12-10 17:19:47,108,2975,51,57,1967.68,3497.08,0.00
2024-12-10 17:19:47,108,2976,51,57,1968.42,3498.00,0.00
2024-12-10 17:19:47,109,2976,52,57,1950.36,3498.01,0.00
2024-12-10 17:19:47,108,2976,51,57,1965.30,3498.08,0.00
2024-12-10 17:19:47,108,2977,51,57,1965.80,3499.00,0.00
2024-12-10 17:19:47,109,2977,51,58,1947.76,3499.01,0.00
2024-12-10 17:19:47,108,2977,50,58,1962.70,3499.08,0.00
2024-12-10 17:19:47,109,2976,50,59,1925.92,3499.62,0.00
2024-12-10 17:19:47,109,2977,50,59,1956.42,3500.00,0.00
2024-12-10 17:19:47,110,2977,51,59,1938.63,3500.01,0.00
2024-12-10 17:19:47,109,2977,50,59,1951.33,3500.12,0.00
2024-12-10 17:19:47,109,2978,50,59,1984.32,3501.00,0.00
2024-12-10 17:19:47,110,2978,51,59,1966.28,3501.01,0.00
2024-12-10 17:19:47,110,2979,51,59,1962.29,3502.00,0.00
2024-12-10 17:19:47,111,2979,51,60,1944.61,3502.01,0.00
2024-12-10 17:19:47,110,2979,51,59,1958.98,3502.09,0.00
2024-12-10 17:19:47,110,2980,51,59,1956.02,3503.00,0.00
2024-12-10 17:19:47,111,2980,51,60,1938.40,3503.01,0.00
2024-12-10 17:19:47,110,2980,50,60,1955.63,3503.02,0.00
2024-12-10 17:19:47,109,2980,49,60,1969.13,3503.10,0.00
2024-12-10 17:19:47,109,2981,49,60,1967.74,3504.00,0.00
2024-12-10 17:19:47,110,2981,50,60,1949.85,3504.01,0.00
2024-12-10 17:19:47,109,2981,49,60,1965.12,3504.06,0.00
2024-12-10 17:19:47,108,2981,49,59,1982.67,3504.07,0.00
2024-12-10 17:19:47,107,2981,49,58,1995.91,3504.18,0.00
2024-12-10 17:19:47,108,2980,50,58,1963.17,3504.60,0.00
2024-12-10 17:19:47,108,2981,50,58,1994.00,3505.00,0.00
2024-12-10 17:19:47,109,2981,51,58,1975.71,3505.01,0.00
2024-12-10 17:19:47,108,2981,50,58,1990.94,3505.07,0.00
2024-12-10 17:19:47,108,2982,50,58,2022.02,3506.00,0.00
2024-12-10 17:19:47,109,2982,51,58,2003.47,3506.01,0.00
2024-12-10 17:19:47,108,2982,50,58,2015.89,3506.13,0.00
2024-12-10 17:19:47,108,2983,50,58,2017.71,3507.00,0.00
2024-12-10 17:19:47,109,2983,50,59,1999.20,3507.01,0.00
2024-12-10 17:19:47,109,2984,50,59,1996.52,3508.00,0.00
2024-12-10 17:19:47,110,2984,51,59,1978.37,3508.01,0.00
2024-12-10 17:19:47,111,2983,52,59,1939.11,3508.64,0.00
2024-12-10 17:19:47,111,2984,52,59,1969.13,3509.00,0.00
2024-12-10 17:19:47,112,2984,52,60,1951.54,3509.01,0.00
2024-12-10 17:19:47,112,2985,52,60,1979.99,3510.00,0.00
2024-12-10 17:19:47,113,2985,52,61,1962.47,3510.01,0.00
2024-12-10 17:19:47,113,2986,52,61,1957.99,3511.00,0.00
2024-12-10 17:19:47,114,2986,53,61,1940.82,3511.01,0.00
2024-12-10 17:19:47,115,2985,53,62,1922.73,3511.06,0.00
2024-12-10 17:19:47,114,2985,52,62,1958.34,3511.16,0.00
2024-12-10 17:19:47,114,2986,52,62,1960.09,3512.00,0.00
2024-12-10 17:19:47,115,2986,52,63,1943.04,3512.01,0.00
2024-12-10 17:19:47,115,2987,52,63,1969.87,3513.00,0.00
2024-12-10 17:19:47,116,2987,52,64,1952.89,3513.01,0.00
2024-12-10 17:19:47,116,2988,52,64,1948.90,3514.00,0.00
2024-12-10 17:19:47,117,2988,52,65,1932.24,3514.01,0.00
2024-12-10 17:19:47,118,2987,52,66,1905.22,3514.33,0.00
2024-12-10 17:19:47,118,2988,52,66,1917.31,3515.00,0.00
2024-12-10 17:19:47,119,2988,52,67,1901.19,3515.01,0.00
2024-12-10 17:19:47,118,2988,52,66,1914.65,3515.08,0.00
2024-12-10 17:19:47,117,2988,52,65,1930.72,3515.08,0.00
2024-12-10 17:19:47,117,2989,52,65,1958.74,3516.00,0.00
2024-12-10 17:19:47,118,2989,52,66,1942.14,3516.01,0.00
2024-12-10 17:19:47,117,2989,52,65,1958.44,3516.01,0.00
2024-12-10 17:19:47,116,2989,52,64,1972.93,3516.07,0.00
2024-12-10 17:19:47,117,2988,53,64,1936.46,3516.65,0.00
2024-12-10 17:19:47,117,2989,53,64,1963.95,3517.00,0.00
2024-12-10 17:19:47,118,2989,54,64,1947.31,3517.01,0.00
2024-12-10 17:19:47,118,2990,54,64,1971.82,3518.00,0.00
2024-12-10 17:19:47,119,2990,55,64,1955.25,3518.01,0.00
2024-12-10 17:19:47,119,2991,55,64,1949.31,3519.00,0.00
2024-12-10 17:19:47,120,2991,56,64,1933.06,3519.01,0.00
2024-12-10 17:19:47,119,2991,55,64,1946.67,3519.08,0.00
2024-12-10 17:19:48,119,2992,55,64,1942.66,3520.00,0.00
2024-12-10 17:19:48,120,2992,55,65,1926.47,3520.01,0.00
2024-12-10 17:19:48,120,2993,55,65,1919.50,3521.00,0.00
2024-12-10 17:19:48,121,2993,56,65,1903.64,3521.01,0.00
2024-12-10 17:19:48,121,2994,56,65,1896.07,3522.00,0.00
2024-12-10 17:19:48,122,2994,56,66,1880.53,3522.01,0.00
2024-12-10 17:19:48,121,2994,56,65,1893.48,3522.07,0.00
2024-12-10 17:19:48,121,2995,56,65,1887.84,3523.00,0.00
2024-12-10 17:19:48,122,2995,57,65,1872.37,3523.01,0.00
2024-12-10 17:19:48,122,2996,57,65,1863.83,3524.00,0.00
2024-12-10 17:19:48,123,2996,57,66,1848.68,3524.01,0.00
2024-12-10 17:19:48,122,2996,57,65,1863.26,3524.02,0.00
2024-12-10 17:19:48,123,2995,58,65,1847.26,3524.06,0.00
2024-12-10 17:19:48,122,2995,58,64,1887.55,3524.07,0.00
2024-12-10 17:19:48,121,2995,58,63,1902.86,3524.07,0.00
2024-12-10 17:19:48,122,2994,59,63,1875.79,3524.42,0.00
2024-12-10 17:19:48,122,2995,59,63,1892.57,3525.00,0.00
2024-12-10 17:19:48,123,2995,59,64,1877.19,3525.01,0.00
2024-12-10 17:19:48,122,2995,59,63,1868.36,3525.65,0.00
2024-12-10 17:19:48,122,2996,59,63,1942.90,3526.00,0.00
2024-12-10 17:19:48,123,2996,60,63,1927.11,3526.01,0.00
2024-12-10 17:19:48,123,2997,60,63,1921.35,3527.00,0.00
2024-12-10 17:19:48,124,2997,60,64,1905.85,3527.01,0.00
2024-12-10 17:19:48,124,2998,60,64,1899.85,3528.00,0.00
2024-12-10 17:19:48,125,2998,60,65,1884.65,3528.01,0.00
2024-12-10 17:19:48,124,2998,60,64,1897.60,3528.06,0.00
2024-12-10 17:19:48,123,2998,60,63,1912.74,3528.07,0.00
2024-12-10 17:19:48,124,2997,60,64,1876.50,3528.68,0.00
2024-12-10 17:19:48,124,2998,60,64,1902.95,3529.00,0.00
2024-12-10 17:19:48,125,2998,61,64,1887.73,3529.01,0.00
2024-12-10 17:19:48,126,2997,62,64,1872.74,3529.02,0.00
2024-12-10 17:19:48,126,2998,62,64,1907.32,3530.00,0.00
2024-12-10 17:19:48,127,2998,62,65,1892.30,3530.01,0.00
2024-12-10 17:19:48,127,2999,62,65,1913.41,3531.00,0.00
2024-12-10 17:19:48,128,2999,62,66,1898.46,3531.01,0.00
2024-12-10 17:19:48,128,3000,62,66,1891.55,3532.00,0.00
2024-12-10 17:19:48,129,3000,63,66,1876.89,3532.01,0.00
2024-12-10 17:19:48,128,3000,63,65,1889.38,3532.06,0.00
2024-12-10 17:19:48,128,3001,63,65,1883.99,3533.00,0.00
2024-12-10 17:19:48,129,3001,63,66,1869.39,3533.01,0.00
2024-12-10 17:19:48,128,3001,62,66,1881.69,3533.06,0.00
2024-12-10 17:19:48,127,3001,62,65,1896.23,3533.06,0.00
2024-12-10 17:19:48,126,3001,61,65,1910.72,3533.07,0.00
2024-12-10 17:19:48,127,3000,62,65,1880.99,3533.48,0.00
2024-12-10 17:19:48,127,3001,62,65,1905.59,3534.00,0.00
2024-12-10 17:19:48,128,3001,63,65,1890.70,3534.01,0.00
2024-12-10 17:19:48,129,3000,64,65,1853.51,3534.64,0.00
2024-12-10 17:19:48,129,3001,64,65,1905.58,3535.00,0.00
2024-12-10 17:19:48,130,3001,65,65,1890.93,3535.01,0.00
2024-12-10 17:19:48,129,3001,64,65,1902.63,3535.07,0.00
2024-12-10 17:19:48,129,3002,64,65,1925.06,3536.00,0.00
2024-12-10 17:19:48,130,3002,65,65,1910.26,3536.01,0.00
2024-12-10 17:19:48,129,3002,64,65,1921.90,3536.07,0.00
2024-12-10 17:19:48,129,3003,64,65,1916.93,3537.00,0.00
2024-12-10 17:19:48,130,3003,64,66,1902.19,3537.01,0.00
2024-12-10 17:19:48,129,3003,64,65,1913.59,3537.07,0.00
2024-12-10 17:19:48,129,3004,64,65,1908.62,3538.00,0.00
2024-12-10 17:19:48,130,3004,65,65,1893.94,3538.01,0.00
2024-12-10 17:19:48,129,3004,65,64,1905.12,3538.07,0.00
2024-12-10 17:19:48,130,3003,65,65,1868.14,3538.72,0.00
2024-12-10 17:19:48,130,3004,65,65,1893.15,3539.00,0.00
2024-12-10 17:19:48,131,3004,65,66,1878.70,3539.01,0.00
2024-12-10 17:19:48,130,3004,65,65,1889.51,3539.07,0.00
2024-12-10 17:19:48,130,3005,65,65,1911.53,3540.00,0.00
2024-12-10 17:19:48,131,3005,66,65,1896.94,3540.01,0.00
2024-12-10 17:19:48,130,3005,66,64,1907.71,3540.07,0.00
2024-12-10 17:19:48,130,3006,66,64,1902.51,3541.00,0.00
2024-12-10 17:19:48,131,3006,67,64,1887.98,3541.01,0.00
2024-12-10 17:19:48,130,3006,67,63,1898.56,3541.07,0.00
2024-12-10 17:19:48,130,3007,67,63,1893.35,3542.00,0.00
2024-12-10 17:19:48,131,3007,67,64,1878.90,3542.01,0.00
2024-12-10 17:19:48,130,3007,67,63,1889.41,3542.07,0.00
2024-12-10 17:19:48,130,3008,67,63,1884.19,3543.00,0.00
2024-12-10 17:19:48,131,3008,68,63,1869.81,3543.01,0.00
2024-12-10 17:19:48,130,3008,68,62,1880.18,3543.07,0.00
2024-12-10 17:19:48,130,3009,68,62,1874.96,3544.00,0.00
2024-12-10 17:19:48,131,3009,69,62,1860.65,3544.01,0.00
2024-12-10 17:19:48,130,3009,68,62,1870.62,3544.07,0.00
2024-12-10 17:19:48,130,3010,68,62,1865.40,3545.00,0.00
2024-12-10 17:19:48,131,3010,68,63,1851.16,3545.01,0.00
2024-12-10 17:19:48,130,3010,67,63,1860.68,3545.07,0.00
2024-12-10 17:19:48,130,3011,67,63,1854.93,3546.00,0.00
2024-12-10 17:19:48,131,3011,67,64,1840.77,3546.01,0.00
2024-12-10 17:19:48,130,3011,67,63,1849.72,3546.07,0.00
2024-12-10 17:19:48,130,3012,67,63,1843.94,3547.00,0.00
2024-12-10 17:19:48,131,3012,67,64,1829.87,3547.01,0.00
2024-12-10 17:19:48,130,3012,66,64,1840.18,3547.02,0.00
2024-12-10 17:19:48,129,3012,66,63,1852.54,3547.06,0.00
2024-12-10 17:19:48,129,3013,66,63,1847.25,3548.00,0.00
2024-12-10 17:19:48,130,3013,66,64,1833.04,3548.01,0.00
2024-12-10 17:19:48,129,3013,65,64,1845.91,3548.01,0.00
2024-12-10 17:19:48,128,3013,64,64,1858.14,3548.06,0.00
2024-12-10 17:19:49,128,3014,64,64,1853.10,3549.00,0.00
2024-12-10 17:19:49,129,3014,65,64,1838.73,3549.01,0.00
2024-12-10 17:19:49,128,3014,64,64,1851.45,3549.05,0.00
2024-12-10 17:19:49,127,3014,63,64,1865.47,3549.06,0.00
2024-12-10 17:19:49,126,3014,63,63,1880.00,3549.06,0.00
2024-12-10 17:19:49,127,3013,63,64,1859.07,3549.24,0.00
2024-12-10 17:19:49,127,3014,63,64,1885.69,3550.00,0.00
2024-12-10 17:19:49,128,3014,63,65,1870.96,3550.01,0.00
2024-12-10 17:19:49,127,3014,63,64,1883.76,3550.06,0.00
2024-12-10 17:19:49,127,3015,63,64,1906.63,3551.00,0.00
2024-12-10 17:19:49,128,3015,63,65,1891.74,3551.01,0.00
2024-12-10 17:19:49,127,3015,62,65,1904.70,3551.06,0.00
2024-12-10 17:19:49,127,3016,62,65,1899.62,3552.00,0.00
2024-12-10 17:19:49,128,3016,63,65,1884.78,3552.01,0.00
2024-12-10 17:19:49,129,3015,64,65,1869.62,3552.04,0.00
2024-12-10 17:19:49,130,3014,64,66,1862.08,3552.07,0.00
2024-12-10 17:19:49,129,3014,63,66,1886.44,3552.07,0.00
2024-12-10 17:19:49,129,3015,63,66,1881.16,3553.00,0.00
2024-12-10 17:19:49,130,3015,64,66,1866.69,3553.01,0.00
2024-12-10 17:19:49,129,3015,63,66,1879.25,3553.05,0.00
2024-12-10 17:19:49,128,3015,63,65,1893.66,3553.06,0.00
2024-12-10 17:19:49,128,3016,63,65,1942.97,3554.00,0.00
2024-12-10 17:19:49,129,3016,64,65,1927.91,3554.01,0.00
2024-12-10 17:19:49,128,3016,63,65,1941.05,3554.06,0.00
2024-12-10 17:19:49,128,3017,63,65,1935.42,3555.00,0.00
2024-12-10 17:19:49,129,3017,64,65,1920.42,3555.01,0.00
2024-12-10 17:19:49,128,3017,64,64,1933.50,3555.06,0.00
2024-12-10 17:19:49,128,3018,64,64,1928.19,3556.00,0.00
2024-12-10 17:19:49,129,3018,65,64,1913.24,3556.01,0.00
2024-12-10 17:19:49,128,3018,65,63,1926.27,3556.06,0.00
2024-12-10 17:19:49,128,3019,65,63,1920.95,3557.00,0.00
2024-12-10 17:19:49,129,3019,65,64,1906.06,3557.01,0.00
2024-12-10 17:19:49,128,3019,65,63,1919.03,3557.06,0.00
2024-12-10 17:19:49,129,3018,65,64,1880.99,3557.73,0.00
2024-12-10 17:19:49,129,3019,65,64,1906.87,3558.00,0.00
2024-12-10 17:19:49,130,3019,66,64,1892.20,3558.01,0.00
2024-12-10 17:19:49,129,3019,66,63,1904.96,3558.05,0.00
2024-12-10 17:19:49,129,3020,66,63,1926.99,3559.00,0.00
2024-12-10 17:19:49,130,3020,67,63,1912.17,3559.01,0.00
2024-12-10 17:19:49,129,3020,66,63,1925.08,3559.05,0.00
2024-12-10 17:19:49,129,3021,66,63,1919.34,3560.00,0.00
2024-12-10 17:19:49,130,3021,66,64,1904.58,3560.01,0.00
2024-12-10 17:19:49,129,3021,65,64,1917.43,3560.05,0.00
2024-12-10 17:19:49,130,3020,66,64,1902.13,3560.09,0.00
2024-12-10 17:19:49,131,3019,67,64,1882.97,3560.70,0.00
2024-12-10 17:19:49,131,3020,67,64,1907.97,3561.00,0.00
2024-12-10 17:19:49,132,3020,68,64,1893.51,3561.01,0.00
2024-12-10 17:19:49,131,3020,67,64,1906.08,3561.05,0.00
2024-12-10 17:19:49,132,3019,68,64,1874.55,3561.55,0.00
2024-12-10 17:19:49,132,3020,68,64,1952.06,3562.00,0.00
2024-12-10 17:19:49,133,3020,68,65,1937.38,3562.01,0.00
2024-12-10 17:19:49,132,3020,67,65,1951.52,3562.02,0.00
2024-12-10 17:19:49,131,3020,66,65,1965.08,3562.05,0.00
2024-12-10 17:19:49,131,3021,66,65,1985.29,3563.00,0.00
2024-12-10 17:19:49,132,3021,66,66,1970.25,3563.01,0.00
2024-12-10 17:19:49,131,3021,66,65,1983.41,3563.05,0.00
2024-12-10 17:19:49,131,3022,66,65,1975.60,3564.00,0.00
2024-12-10 17:19:49,132,3022,66,66,1960.64,3564.01,0.00
2024-12-10 17:19:49,132,3023,66,66,1949.56,3565.00,0.00
2024-12-10 17:19:49,133,3023,66,67,1934.90,3565.01,0.00
2024-12-10 17:19:49,132,3023,65,67,1947.43,3565.06,0.00
2024-12-10 17:19:49,133,3022,65,68,1898.78,3565.93,0.00
2024-12-10 17:19:49,133,3023,65,68,1924.86,3566.00,0.00
2024-12-10 17:19:49,134,3023,66,68,1910.50,3566.01,0.00
2024-12-10 17:19:49,133,3023,65,68,1922.74,3566.06,0.00
2024-12-10 17:19:49,133,3024,65,68,1938.35,3567.00,0.00
2024-12-10 17:19:49,134,3024,66,68,1923.89,3567.01,0.00
2024-12-10 17:19:49,133,3024,65,68,1935.97,3567.07,0.00
2024-12-10 17:19:49,134,3023,66,68,1908.32,3567.46,0.00
2024-12-10 17:19:49,133,3023,65,68,1931.20,3567.58,0.00
2024-12-10 17:19:49,133,3024,65,68,1943.34,3568.00,0.00
2024-12-10 17:19:49,134,3024,66,68,1928.84,3568.01,0.00
2024-12-10 17:19:49,133,3024,65,68,1940.96,3568.07,0.00
2024-12-10 17:19:49,133,3025,65,68,1961.86,3569.00,0.00
2024-12-10 17:19:49,134,3025,65,69,1947.22,3569.01,0.00
2024-12-10 17:19:49,134,3026,65,69,1938.98,3570.00,0.00
2024-12-10 17:19:49,135,3026,66,69,1924.61,3570.01,0.00
2024-12-10 17:19:49,134,3026,65,69,1936.35,3570.08,0.00
2024-12-10 17:19:49,135,3025,66,69,1897.19,3570.79,0.00
2024-12-10 17:19:49,135,3026,66,69,1924.64,3571.00,0.00
2024-12-10 17:19:49,136,3026,67,69,1910.48,3571.01,0.00
2024-12-10 17:19:49,135,3026,67,68,1922.03,3571.07,0.00
2024-12-10 17:19:49,135,3027,67,68,1942.37,3572.00,0.00
2024-12-10 17:19:49,136,3027,68,68,1928.09,3572.01,0.00
2024-12-10 17:19:49,135,3027,67,68,1941.32,3572.03,0.00
2024-12-10 17:19:49,134,3027,67,67,1954.24,3572.07,0.00
2024-12-10 17:19:49,133,3027,67,66,1968.66,3572.07,0.00
2024-12-10 17:19:49,133,3028,67,66,1962.73,3573.00,0.00
2024-12-10 17:19:49,134,3028,67,67,1948.08,3573.01,0.00
2024-12-10 17:19:49,134,3029,67,67,1939.83,3574.00,0.00
2024-12-10 17:19:49,135,3029,67,68,1925.46,3574.01,0.00
2024-12-10 17:19:49,134,3029,66,68,1937.20,3574.08,0.00
2024-12-10 17:19:49,134,3030,66,68,1931.07,3575.00,0.00
2024-12-10 17:19:49,135,3030,66,69,1916.76,3575.01,0.00
2024-12-10 17:19:49,134,3030,66,68,1928.43,3575.08,0.00
2024-12-10 17:19:49,134,3031,66,68,1922.14,3576.00,0.00
2024-12-10 17:19:49,135,3031,67,68,1907.90,3576.01,0.00
2024-12-10 17:19:49,134,3031,67,67,1919.50,3576.08,0.00
2024-12-10 17:19:50,134,3032,67,67,1912.98,3577.00,0.00
2024-12-10 17:19:50,135,3032,67,68,1898.81,3577.01,0.00
2024-12-10 17:19:50,134,3032,67,67,1910.34,3577.08,0.00
2024-12-10 17:19:50,135,3031,68,67,1895.93,3577.10,0.00
2024-12-10 17:19:50,135,3032,68,67,1900.87,3578.00,0.00
2024-12-10 17:19:50,136,3032,69,67,1886.90,3578.01,0.00
2024-12-10 17:19:50,135,3032,69,66,1898.25,3578.07,0.00
2024-12-10 17:19:50,135,3033,69,66,1916.94,3579.00,0.00
2024-12-10 17:19:50,136,3033,69,67,1902.85,3579.01,0.00
2024-12-10 17:19:50,135,3033,69,66,1916.16,3579.02,0.00
2024-12-10 17:19:50,134,3033,69,65,1928.35,3579.08,0.00
2024-12-10 17:19:50,134,3034,69,65,1921.16,3580.00,0.00
2024-12-10 17:19:50,135,3034,70,65,1906.93,3580.01,0.00
2024-12-10 17:19:50,134,3034,69,65,1918.53,3580.08,0.00
2024-12-10 17:19:50,134,3035,69,65,1911.36,3581.00,0.00
2024-12-10 17:19:50,135,3035,69,66,1897.20,3581.01,0.00
2024-12-10 17:19:50,134,3035,68,66,1908.73,3581.08,0.00
2024-12-10 17:19:50,134,3036,68,66,1900.46,3582.00,0.00
2024-12-10 17:19:50,135,3036,68,67,1886.39,3582.01,0.00
2024-12-10 17:19:50,136,3035,69,67,1855.55,3582.50,0.00
2024-12-10 17:19:50,136,3036,69,67,1868.10,3583.00,0.00
2024-12-10 17:19:50,137,3036,69,68,1854.46,3583.01,0.00
2024-12-10 17:19:50,136,3036,69,67,1865.24,3583.08,0.00
2024-12-10 17:19:50,136,3037,69,67,1882.53,3584.00,0.00
2024-12-10 17:19:50,137,3037,70,67,1868.79,3584.01,0.00
2024-12-10 17:19:50,136,3037,70,66,1879.67,3584.08,0.00
2024-12-10 17:19:50,135,3037,70,65,1893.33,3584.08,0.00
2024-12-10 17:19:50,135,3038,70,65,1885.19,3585.00,0.00
2024-12-10 17:19:50,136,3038,71,65,1871.33,3585.01,0.00
2024-12-10 17:19:50,135,3038,70,65,1882.31,3585.08,0.00
2024-12-10 17:19:50,135,3039,70,65,1873.75,3586.00,0.00
2024-12-10 17:19:50,136,3039,71,65,1859.97,3586.01,0.00
2024-12-10 17:19:50,135,3039,70,65,1870.86,3586.08,0.00
2024-12-10 17:19:50,134,3039,69,65,1870.49,3586.47,0.00
2024-12-10 17:19:50,134,3040,69,65,1878.63,3587.00,0.00
2024-12-10 17:19:50,135,3040,70,65,1864.71,3587.01,0.00
2024-12-10 17:19:50,134,3040,69,65,1875.72,3587.08,0.00
2024-12-10 17:19:50,134,3041,69,65,1870.05,3588.00,0.00
2024-12-10 17:19:50,135,3041,69,66,1856.19,3588.01,0.00
2024-12-10 17:19:50,134,3041,69,65,1867.14,3588.08,0.00
2024-12-10 17:19:50,135,3040,69,66,1844.85,3588.33,0.00
2024-12-10 17:19:50,135,3041,69,66,1854.44,3589.00,0.00
2024-12-10 17:19:50,136,3041,69,67,1840.81,3589.01,0.00
2024-12-10 17:19:50,135,3041,69,66,1851.55,3589.08,0.00
2024-12-10 17:19:50,135,3042,69,66,1870.44,3590.00,0.00
2024-12-10 17:19:50,136,3042,69,67,1856.69,3590.01,0.00
2024-12-10 17:19:50,135,3042,69,66,1867.55,3590.08,0.00
2024-12-10 17:19:50,135,3043,69,66,1860.28,3591.00,0.00
2024-12-10 17:19:50,136,3043,69,67,1846.61,3591.01,0.00
2024-12-10 17:19:50,135,3043,69,66,1857.39,3591.08,0.00
2024-12-10 17:19:50,135,3044,69,66,1851.15,3592.00,0.00
2024-12-10 17:19:50,136,3044,70,66,1837.54,3592.01,0.00
2024-12-10 17:19:50,135,3044,69,66,1848.25,3592.08,0.00
2024-12-10 17:19:50,135,3045,69,66,1841.23,3593.00,0.00
2024-12-10 17:19:50,136,3045,70,66,1827.69,3593.01,0.00
2024-12-10 17:19:50,135,3045,70,65,1838.33,3593.08,0.00
2024-12-10 17:19:50,135,3046,70,65,1830.52,3594.00,0.00
2024-12-10 17:19:50,136,3046,70,66,1817.06,3594.01,0.00
2024-12-10 17:19:50,135,3046,69,66,1827.62,3594.08,0.00
2024-12-10 17:19:50,135,3047,69,66,1819.11,3595.00,0.00
2024-12-10 17:19:50,136,3047,69,67,1805.73,3595.01,0.00
2024-12-10 17:19:50,135,3047,69,66,1816.21,3595.08,0.00
2024-12-10 17:19:50,135,3048,69,66,1806.32,3596.00,0.00
2024-12-10 17:19:50,136,3048,70,66,1793.03,3596.01,0.00
2024-12-10 17:19:50,135,3048,70,65,1803.15,3596.09,0.00
2024-12-10 17:19:50,135,3049,70,65,1793.37,3597.00,0.00
2024-12-10 17:19:50,136,3049,70,66,1780.18,3597.01,0.00
2024-12-10 17:19:50,135,3049,69,66,1790.20,3597.09,0.00
2024-12-10 17:19:50,135,3050,69,66,1781.30,3598.00,0.00
2024-12-10 17:19:50,136,3050,70,66,1768.20,3598.01,0.00
2024-12-10 17:19:50,137,3049,70,67,1733.18,3598.59,0.00
2024-12-10 17:19:50,137,3050,70,67,1756.87,3599.00,0.00
2024-12-10 17:19:50,138,3050,71,67,1744.14,3599.01,0.00
2024-12-10 17:19:50,137,3050,71,66,1753.48,3599.10,0.00
2024-12-10 17:19:50,136,3050,71,65,1766.11,3599.10,0.00
2024-12-10 17:19:50,137,3049,72,65,1739.61,3599.49,0.00
2024-12-10 17:19:50,137,3050,72,65,1787.28,3600.00,0.00
2024-12-10 17:19:50,138,3050,73,65,1774.33,3600.01,0.00
2024-12-10 17:19:50,137,3050,72,65,1783.90,3600.10,0.00
2024-12-10 17:19:50,136,3050,72,64,1789.56,3600.30,0.00
2024-12-10 17:19:50,136,3051,72,64,1815.71,3601.00,0.00
2024-12-10 17:19:50,137,3051,73,64,1802.45,3601.01,0.00
2024-12-10 17:19:50,136,3051,72,64,1812.29,3601.10,0.00
2024-12-10 17:19:50,136,3052,72,64,1803.15,3602.00,0.00
2024-12-10 17:19:50,137,3052,72,65,1789.99,3602.01,0.00
2024-12-10 17:19:50,136,3052,72,64,1799.74,3602.10,0.00
2024-12-10 17:19:50,137,3051,73,64,1780.96,3602.26,0.00
2024-12-10 17:19:50,137,3052,73,64,1798.39,3603.00,0.00
2024-12-10 17:19:50,138,3052,73,65,1785.36,3603.01,0.00
2024-12-10 17:19:50,137,3052,73,64,1795.00,3603.10,0.00
2024-12-10 17:19:50,137,3053,73,64,1812.43,3604.00,0.00
2024-12-10 17:19:50,138,3053,73,65,1799.29,3604.01,0.00
2024-12-10 17:19:51,137,3053,73,64,1810.86,3604.04,0.00
2024-12-10 17:19:51,136,3053,72,64,1822.34,3604.09,0.00
2024-12-10 17:19:51,135,3053,71,64,1835.57,3604.09,0.00
2024-12-10 17:19:51,134,3053,71,63,1832.34,3604.49,0.00
2024-12-10 17:19:51,134,3054,71,63,1841.04,3605.00,0.00
2024-12-10 17:19:51,135,3054,72,63,1827.40,3605.01,0.00
2024-12-10 17:19:51,134,3054,71,63,1837.84,3605.09,0.00
2024-12-10 17:19:51,134,3055,71,63,1830.76,3606.00,0.00
2024-12-10 17:19:51,135,3055,72,63,1817.20,3606.01,0.00
2024-12-10 17:19:51,134,3055,71,63,1827.56,3606.09,0.00
2024-12-10 17:19:51,135,3054,71,64,1801.47,3606.43,0.00
2024-12-10 17:19:51,135,3055,71,64,1823.42,3607.00,0.00
2024-12-10 17:19:51,136,3055,72,64,1810.01,3607.01,0.00
2024-12-10 17:19:51,135,3055,72,63,1820.24,3607.09,0.00
2024-12-10 17:19:51,135,3056,72,63,1838.38,3608.00,0.00
2024-12-10 17:19:51,136,3056,72,64,1824.86,3608.01,0.00
2024-12-10 17:19:51,135,3056,71,64,1836.52,3608.05,0.00
2024-12-10 17:19:51,134,3056,70,64,1848.89,3608.08,0.00
2024-12-10 17:19:51,133,3056,69,64,1862.52,3608.08,0.00
2024-12-10 17:19:51,133,3057,69,64,1853.06,3609.00,0.00
2024-12-10 17:19:51,134,3057,70,64,1839.23,3609.01,0.00
2024-12-10 17:19:51,133,3057,70,63,1850.10,3609.08,0.00
2024-12-10 17:19:51,133,3058,70,63,1840.21,3610.00,0.00
2024-12-10 17:19:51,134,3058,70,64,1826.48,3610.01,0.00
2024-12-10 17:19:51,133,3058,69,64,1833.53,3610.17,0.00
2024-12-10 17:19:51,133,3059,69,64,1826.88,3611.00,0.00
2024-12-10 17:19:51,134,3059,69,65,1813.24,3611.01,0.00
2024-12-10 17:19:51,133,3059,69,64,1826.60,3611.01,0.00
2024-12-10 17:19:51,132,3059,69,63,1837.19,3611.09,0.00
2024-12-10 17:19:51,133,3058,70,63,1807.59,3611.50,0.00
2024-12-10 17:19:51,133,3059,70,63,1827.45,3612.00,0.00
2024-12-10 17:19:51,134,3059,70,64,1813.81,3612.01,0.00
2024-12-10 17:19:51,133,3059,70,63,1824.17,3612.09,0.00
2024-12-10 17:19:51,132,3059,69,63,1830.23,3612.25,0.00
2024-12-10 17:19:51,131,3059,68,63,1824.27,3612.73,0.00
2024-12-10 17:19:51,131,3060,68,63,1869.99,3613.00,0.00
2024-12-10 17:19:51,132,3060,69,63,1855.83,3613.01,0.00
2024-12-10 17:19:51,131,3060,69,62,1866.62,3613.09,0.00
2024-12-10 17:19:51,131,3061,69,62,1859.30,3614.00,0.00
2024-12-10 17:19:51,132,3061,69,63,1845.21,3614.01,0.00
2024-12-10 17:19:51,131,3061,69,62,1856.02,3614.09,0.00
2024-12-10 17:19:51,130,3061,69,61,1870.01,3614.09,0.00
2024-12-10 17:19:51,130,3062,69,61,1861.66,3615.00,0.00
2024-12-10 17:19:51,131,3062,69,62,1847.45,3615.01,0.00
2024-12-10 17:19:51,130,3062,69,61,1853.19,3615.19,0.00
2024-12-10 17:19:51,129,3062,68,61,1864.50,3615.26,0.00
2024-12-10 17:19:51,129,3063,68,61,1865.25,3616.00,0.00
2024-12-10 17:19:51,130,3063,69,61,1850.90,3616.01,0.00
2024-12-10 17:19:51,129,3063,69,60,1863.30,3616.05,0.00
2024-12-10 17:19:51,128,3063,69,59,1876.18,3616.09,0.00
2024-12-10 17:19:51,127,3063,68,59,1890.67,3616.09,0.00
2024-12-10 17:19:51,127,3064,68,59,1886.05,3617.00,0.00
2024-12-10 17:19:51,128,3064,68,60,1871.31,3617.01,0.00
2024-12-10 17:19:51,127,3064,67,60,1882.66,3617.09,0.00
2024-12-10 17:19:51,127,3065,67,60,1877.28,3618.00,0.00
2024-12-10 17:19:51,128,3065,68,60,1862.61,3618.01,0.00
2024-12-10 17:19:51,129,3064,69,60,1843.44,3618.16,0.00
2024-12-10 17:19:51,128,3064,69,59,1882.96,3618.16,0.00
2024-12-10 17:19:51,128,3065,69,59,1881.17,3619.00,0.00
2024-12-10 17:19:51,129,3065,69,60,1866.59,3619.01,0.00
2024-12-10 17:19:51,129,3066,69,60,1887.29,3620.00,0.00
2024-12-10 17:19:51,130,3066,69,61,1872.78,3620.01,0.00
2024-12-10 17:19:51,129,3066,69,60,1883.68,3620.10,0.00
2024-12-10 17:19:51,129,3067,69,60,1879.07,3621.00,0.00
2024-12-10 17:19:51,130,3067,69,61,1864.61,3621.01,0.00
2024-12-10 17:19:51,129,3067,68,61,1875.45,3621.10,0.00
2024-12-10 17:19:51,129,3068,68,61,1870.21,3622.00,0.00
2024-12-10 17:19:51,130,3068,68,62,1855.82,3622.01,0.00
2024-12-10 17:19:51,129,3068,68,61,1866.59,3622.10,0.00
2024-12-10 17:19:51,129,3069,68,61,1859.62,3623.00,0.00
2024-12-10 17:19:51,130,3069,68,62,1845.31,3623.01,0.00
2024-12-10 17:19:51,129,3069,67,62,1856.00,3623.10,0.00
2024-12-10 17:19:51,129,3070,67,62,1848.81,3624.00,0.00
2024-12-10 17:19:51,130,3070,68,62,1834.59,3624.01,0.00
2024-12-10 17:19:51,129,3070,67,62,1847.69,3624.03,0.00
2024-12-10 17:19:51,128,3070,66,62,1859.60,3624.09,0.00
2024-12-10 17:19:51,128,3071,66,62,1851.56,3625.00,0.00
2024-12-10 17:19:51,129,3071,67,62,1837.21,3625.01,0.00
2024-12-10 17:19:51,129,3072,67,62,1824.39,3626.00,0.00
2024-12-10 17:19:51,130,3072,67,63,1810.36,3626.01,0.00
2024-12-10 17:19:51,129,3072,66,63,1820.77,3626.10,0.00
2024-12-10 17:19:51,129,3073,66,63,1811.24,3627.00,0.00
2024-12-10 17:19:51,130,3073,67,63,1797.30,3627.01,0.00
2024-12-10 17:19:51,129,3073,67,62,1806.41,3627.10,0.00
2024-12-10 17:19:51,130,3072,67,63,1779.79,3627.39,0.00
2024-12-10 17:19:51,130,3073,67,63,1803.20,3628.00,0.00
2024-12-10 17:19:51,131,3073,68,63,1789.44,3628.01,0.00
2024-12-10 17:19:51,130,3073,67,63,1801.54,3628.05,0.00
2024-12-10 17:19:51,130,3074,67,63,1819.18,3629.00,0.00
2024-12-10 17:19:51,131,3074,68,63,1805.29,3629.01,0.00
2024-12-10 17:19:51,130,3074,67,63,1815.86,3629.09,0.00
2024-12-10 17:19:51,130,3075,67,63,1807.04,3630.00,0.00
2024-12-10 17:19:51,131,3075,68,63,1793.25,3630.01,0.00
2024-12-10 17:19:51,130,3075,68,62,1803.72,3630.09,0.00
2024-12-10 17:19:51,130,3076,68,62,1794.08,3631.00,0.00
2024-12-10 17:19:51,131,3076,68,63,1780.38,3631.01,0.00
2024-12-10 17:19:51,130,3076,68,62,1790.75,3631.09,0.00
2024-12-10 17:19:51,129,3076,68,61,1804.19,3631.09,0.00
2024-12-10 17:19:52,129,3077,68,61,1794.21,3632.00,0.00
2024-12-10 17:19:52,130,3077,68,62,1780.41,3632.01,0.00
2024-12-10 17:19:52,130,3078,68,62,1767.46,3633.00,0.00
2024-12-10 17:19:52,131,3078,69,62,1753.97,3633.01,0.00
2024-12-10 17:19:52,130,3078,68,62,1764.14,3633.09,0.00
2024-12-10 17:19:52,130,3079,68,62,1754.62,3634.00,0.00
2024-12-10 17:19:52,131,3079,68,63,1741.23,3634.01,0.00
2024-12-10 17:19:52,130,3079,67,63,1752.95,3634.05,0.00
2024-12-10 17:19:52,129,3079,66,63,1764.87,3634.09,0.00
2024-12-10 17:19:52,128,3079,65,63,1778.38,3634.09,0.00
2024-12-10 17:19:52,127,3079,64,63,1781.01,3634.32,0.00
2024-12-10 17:19:52,127,3080,64,63,1782.62,3635.00,0.00
2024-12-10 17:19:52,128,3080,65,63,1768.69,3635.01,0.00
2024-12-10 17:19:52,127,3080,64,63,1779.50,3635.09,0.00
2024-12-10 17:19:52,126,3080,64,62,1784.83,3635.28,0.00
2024-12-10 17:19:52,126,3081,64,62,1784.06,3636.00,0.00
2024-12-10 17:19:52,127,3081,65,62,1770.01,3636.01,0.00
2024-12-10 17:19:52,127,3082,65,62,1757.63,3637.00,0.00
2024-12-10 17:19:52,128,3082,66,62,1743.90,3637.01,0.00
2024-12-10 17:19:52,127,3082,66,61,1754.14,3637.09,0.00
2024-12-10 17:19:52,126,3082,65,61,1755.46,3637.41,0.00
2024-12-10 17:19:52,126,3083,65,61,1759.99,3638.00,0.00
2024-12-10 17:19:52,127,3083,66,61,1746.13,3638.01,0.00
2024-12-10 17:19:52,126,3083,66,60,1758.27,3638.05,0.00
2024-12-10 17:19:52,125,3083,65,60,1770.23,3638.08,0.00
2024-12-10 17:19:52,124,3083,65,59,1784.22,3638.08,0.00
2024-12-10 17:19:52,123,3083,65,58,1788.90,3638.33,0.00
2024-12-10 17:19:52,123,3084,65,58,1791.78,3639.00,0.00
2024-12-10 17:19:52,124,3084,66,58,1777.33,3639.01,0.00
2024-12-10 17:19:52,123,3084,66,57,1787.94,3639.08,0.00
2024-12-10 17:19:52,122,3084,65,57,1776.31,3639.76,0.00
2024-12-10 17:19:52,122,3085,65,57,1797.69,3640.00,0.00
2024-12-10 17:19:52,123,3085,66,57,1783.08,3640.01,0.00
2024-12-10 17:19:52,122,3085,65,57,1794.09,3640.08,0.00
2024-12-10 17:19:52,122,3086,65,57,1790.77,3641.00,0.00
2024-12-10 17:19:52,123,3086,65,58,1776.21,3641.01,0.00
2024-12-10 17:19:52,122,3086,64,58,1786.79,3641.08,0.00
2024-12-10 17:19:52,122,3087,64,58,1783.48,3642.00,0.00
2024-12-10 17:19:52,123,3087,64,59,1768.99,3642.01,0.00
2024-12-10 17:19:52,123,3088,64,59,1758.91,3643.00,0.00
2024-12-10 17:19:52,124,3088,65,59,1744.73,3643.01,0.00
2024-12-10 17:19:52,124,3089,65,59,1735.73,3644.00,0.00
2024-12-10 17:19:52,125,3089,66,59,1721.85,3644.01,0.00
2024-12-10 17:19:52,124,3089,65,59,1731.95,3644.10,0.00
2024-12-10 17:19:52,123,3089,64,59,1734.88,3644.35,0.00
2024-12-10 17:19:52,123,3090,64,59,1741.22,3645.00,0.00
2024-12-10 17:19:52,124,3090,64,60,1727.18,3645.01,0.00
2024-12-10 17:19:52,123,3090,64,59,1734.31,3645.10,0.00
2024-12-10 17:19:52,123,3091,64,59,1730.99,3646.00,0.00
2024-12-10 17:19:52,124,3091,65,59,1717.03,3646.01,0.00
2024-12-10 17:19:52,123,3091,65,58,1722.92,3646.10,0.00
2024-12-10 17:19:52,123,3092,65,58,1720.11,3647.00,0.00
2024-12-10 17:19:52,124,3092,66,58,1706.23,3647.01,0.00
2024-12-10 17:19:52,123,3092,65,58,1716.70,3647.07,0.00
2024-12-10 17:19:52,122,3092,65,57,1729.59,3647.09,0.00
2024-12-10 17:19:52,121,3092,64,57,1740.37,3647.17,0.00
2024-12-10 17:19:52,122,3091,65,57,1713.35,3647.53,0.00
2024-12-10 17:19:52,122,3092,65,57,1741.80,3648.00,0.00
2024-12-10 17:19:52,123,3092,66,57,1727.64,3648.01,0.00
2024-12-10 17:19:52,122,3092,66,56,1738.53,3648.09,0.00
2024-12-10 17:19:52,121,3092,66,55,1752.45,3648.10,0.00
2024-12-10 17:19:52,121,3093,66,55,1779.91,3649.00,0.00
2024-12-10 17:19:52,122,3093,67,55,1765.32,3649.01,0.00
2024-12-10 17:19:52,121,3093,66,55,1778.71,3649.03,0.00
2024-12-10 17:19:52,120,3093,65,55,1791.42,3649.08,0.00
2024-12-10 17:19:52,120,3094,65,55,1788.85,3650.00,0.00
2024-12-10 17:19:52,121,3094,66,55,1774.06,3650.01,0.00
2024-12-10 17:19:52,122,3093,66,56,1759.52,3650.03,0.00
2024-12-10 17:19:52,122,3094,66,56,1783.10,3651.00,0.00
2024-12-10 17:19:52,123,3094,67,56,1768.61,3651.01,0.00
2024-12-10 17:19:52,122,3094,67,55,1780.14,3651.08,0.00
2024-12-10 17:19:52,122,3095,67,55,1806.94,3652.00,0.00
2024-12-10 17:19:52,123,3095,68,55,1792.25,3652.01,0.00
2024-12-10 17:19:52,122,3095,67,55,1806.35,3652.02,0.00
2024-12-10 17:19:52,121,3095,66,55,1818.88,3652.07,0.00
2024-12-10 17:19:52,120,3095,66,54,1833.44,3652.08,0.00
2024-12-10 17:19:52,120,3096,66,54,1830.86,3653.00,0.00
2024-12-10 17:19:52,121,3096,66,55,1815.73,3653.01,0.00
2024-12-10 17:19:52,120,3096,65,55,1827.85,3653.08,0.00
2024-12-10 17:19:52,120,3097,65,55,1824.10,3654.00,0.00
2024-12-10 17:19:52,121,3097,65,56,1809.03,3654.01,0.00
2024-12-10 17:19:52,120,3097,64,56,1821.09,3654.08,0.00
2024-12-10 17:19:52,120,3098,64,56,1817.79,3655.00,0.00
2024-12-10 17:19:52,121,3098,64,57,1802.77,3655.01,0.00
2024-12-10 17:19:52,121,3099,64,57,1795.61,3656.00,0.00
2024-12-10 17:19:52,122,3099,65,57,1780.89,3656.01,0.00
2024-12-10 17:19:52,121,3099,64,57,1791.82,3656.08,0.00
2024-12-10 17:19:52,121,3100,64,57,1786.38,3657.00,0.00
2024-12-10 17:19:52,122,3100,64,58,1771.74,3657.01,0.00
2024-12-10 17:19:52,121,3100,64,57,1782.82,3657.08,0.00
2024-12-10 17:19:52,120,3100,64,56,1793.79,3657.15,0.00
2024-12-10 17:19:52,119,3100,63,56,1807.39,3657.16,0.00
2024-12-10 17:19:52,119,3101,63,56,1806.30,3658.00,0.00
2024-12-10 17:19:52,120,3101,63,57,1791.25,3658.01,0.00
2024-12-10 17:19:52,119,3101,62,57,1803.20,3658.08,0.00
2024-12-10 17:19:52,120,3100,63,57,1787.54,3658.12,0.00
2024-12-10 17:19:52,119,3100,63,56,1804.14,3658.29,0.00
2024-12-10 17:19:52,119,3101,63,56,1809.50,3659.00,0.00
2024-12-10 17:19:52,120,3101,64,56,1794.42,3659.01,0.00
2024-12-10 17:19:52,119,3101,63,56,1806.48,3659.08,0.00
2024-12-10 17:19:53,119,3102,63,56,1834.93,3660.00,0.00
2024-12-10 17:19:53,120,3102,63,57,1819.64,3660.01,0.00
2024-12-10 17:19:53,119,3102,63,56,1834.33,3660.02,0.00
2024-12-10 17:19:53,120,3101,63,57,1817.53,3660.08,0.00
2024-12-10 17:19:53,119,3101,63,56,1856.14,3660.08,0.00
2024-12-10 17:19:53,119,3102,63,56,1853.55,3661.00,0.00
2024-12-10 17:19:53,120,3102,63,57,1838.10,3661.01,0.00
2024-12-10 17:19:53,119,3102,62,57,1850.51,3661.08,0.00
2024-12-10 17:19:53,118,3102,61,57,1865.88,3661.09,0.00
2024-12-10 17:19:53,118,3103,61,57,1894.91,3662.00,0.00
2024-12-10 17:19:53,119,3103,62,57,1878.98,3662.01,0.00
2024-12-10 17:19:53,118,3103,62,56,1891.84,3662.09,0.00
2024-12-10 17:19:53,118,3104,62,56,1889.84,3663.00,0.00
2024-12-10 17:19:53,119,3104,62,57,1873.95,3663.01,0.00
2024-12-10 17:19:53,118,3104,62,56,1886.77,3663.09,0.00
2024-12-10 17:19:53,118,3105,62,56,1882.57,3664.00,0.00
2024-12-10 17:19:53,119,3105,63,56,1866.75,3664.01,0.00
2024-12-10 17:19:53,119,3106,63,56,1860.03,3665.00,0.00
2024-12-10 17:19:53,120,3106,64,56,1844.53,3665.01,0.00
2024-12-10 17:19:53,119,3106,64,55,1856.99,3665.08,0.00
2024-12-10 17:19:53,119,3107,64,55,1853.99,3666.00,0.00
2024-12-10 17:19:53,120,3107,65,55,1838.54,3666.01,0.00
2024-12-10 17:19:53,120,3108,65,55,1833.17,3667.00,0.00
2024-12-10 17:19:53,121,3108,66,55,1818.02,3667.01,0.00
2024-12-10 17:19:53,120,3108,65,55,1832.26,3667.03,0.00
2024-12-10 17:19:53,119,3108,64,55,1845.53,3667.08,0.00
2024-12-10 17:19:53,118,3108,63,55,1860.86,3667.08,0.00
2024-12-10 17:19:53,118,3109,63,55,1858.53,3668.00,0.00
2024-12-10 17:19:53,119,3109,63,56,1842.91,3668.01,0.00
2024-12-10 17:19:53,118,3109,62,56,1855.77,3668.08,0.00
2024-12-10 17:19:53,118,3110,62,56,1853.30,3669.00,0.00
2024-12-10 17:19:53,119,3110,63,56,1837.72,3669.01,0.00
2024-12-10 17:19:53,118,3110,63,55,1850.53,3669.08,0.00
2024-12-10 17:19:53,119,3109,64,55,1805.34,3669.91,0.00
2024-12-10 17:19:53,119,3110,64,55,1835.96,3670.00,0.00
2024-12-10 17:19:53,120,3110,65,55,1820.66,3670.01,0.00
2024-12-10 17:19:53,119,3110,64,55,1833.22,3670.08,0.00
2024-12-10 17:19:53,120,3109,64,56,1802.15,3670.53,0.00
2024-12-10 17:19:53,120,3110,64,56,1861.84,3671.00,0.00
2024-12-10 17:19:53,121,3110,65,56,1846.46,3671.01,0.00
2024-12-10 17:19:53,121,3111,65,56,1870.55,3672.00,0.00
2024-12-10 17:19:53,122,3111,65,57,1855.22,3672.01,0.00
2024-12-10 17:19:53,121,3111,64,57,1867.85,3672.07,0.00
2024-12-10 17:19:53,121,3112,64,57,1863.71,3673.00,0.00
2024-12-10 17:19:53,122,3112,65,57,1848.44,3673.01,0.00
2024-12-10 17:19:53,121,3112,65,56,1861.01,3673.07,0.00
2024-12-10 17:19:53,120,3112,65,55,1876.06,3673.08,0.00
2024-12-10 17:19:53,120,3113,65,55,1873.01,3674.00,0.00
2024-12-10 17:19:53,121,3113,66,55,1857.53,3674.01,0.00
2024-12-10 17:19:53,120,3113,66,54,1870.29,3674.08,0.00
2024-12-10 17:19:53,120,3114,66,54,1865.81,3675.00,0.00
2024-12-10 17:19:53,121,3114,66,55,1850.39,3675.01,0.00
2024-12-10 17:19:53,122,3113,67,55,1810.46,3675.58,0.00
2024-12-10 17:19:53,122,3114,67,55,1839.11,3676.00,0.00
2024-12-10 17:19:53,123,3114,68,55,1824.16,3676.01,0.00
2024-12-10 17:19:53,122,3114,67,55,1836.43,3676.07,0.00
2024-12-10 17:19:53,122,3115,67,55,1858.24,3677.00,0.00
2024-12-10 17:19:53,123,3115,67,56,1843.13,3677.01,0.00
2024-12-10 17:19:53,122,3115,66,56,1857.64,3677.02,0.00
2024-12-10 17:19:53,121,3115,66,55,1870.89,3677.07,0.00
2024-12-10 17:19:53,120,3115,65,55,1886.17,3677.07,0.00
2024-12-10 17:19:53,120,3116,65,55,1880.03,3678.00,0.00
2024-12-10 17:19:53,121,3116,66,55,1864.49,3678.01,0.00
2024-12-10 17:19:53,120,3116,65,55,1877.60,3678.07,0.00
2024-12-10 17:19:53,120,3117,65,55,1872.71,3679.00,0.00
2024-12-10 17:19:53,121,3117,66,55,1857.23,3679.01,0.00
2024-12-10 17:19:53,120,3117,66,54,1870.28,3679.07,0.00
2024-12-10 17:19:53,121,3116,66,55,1844.38,3679.33,0.00
2024-12-10 17:19:53,121,3117,66,55,1879.39,3680.00,0.00
2024-12-10 17:19:53,122,3117,66,56,1863.98,3680.01,0.00
2024-12-10 17:19:53,121,3117,65,56,1876.98,3680.07,0.00
2024-12-10 17:19:53,121,3118,65,56,1902.59,3681.00,0.00
2024-12-10 17:19:53,122,3118,66,56,1887.00,3681.01,0.00
2024-12-10 17:19:53,121,3118,66,55,1899.82,3681.07,0.00
2024-12-10 17:19:53,120,3118,66,54,1910.93,3681.18,0.00
2024-12-10 17:19:53,120,3119,66,54,1911.07,3682.00,0.00
2024-12-10 17:19:53,121,3119,66,55,1895.27,3682.01,0.00
2024-12-10 17:19:53,121,3120,66,55,1886.03,3683.00,0.00
2024-12-10 17:19:53,122,3120,67,55,1870.57,3683.01,0.00
2024-12-10 17:19:53,121,3120,67,54,1882.38,3683.07,0.00
2024-12-10 17:19:53,121,3121,67,54,1874.68,3684.00,0.00
2024-12-10 17:19:53,122,3121,68,54,1859.32,3684.01,0.00
2024-12-10 17:19:53,121,3121,67,54,1870.72,3684.07,0.00
2024-12-10 17:19:53,121,3122,67,54,1861.01,3685.00,0.00
2024-12-10 17:19:53,122,3122,68,54,1845.75,3685.01,0.00
2024-12-10 17:19:53,121,3122,67,54,1856.77,3685.07,0.00
2024-12-10 17:19:53,120,3122,67,53,1869.78,3685.12,0.00
2024-12-10 17:19:53,120,3123,67,53,1863.85,3686.00,0.00
2024-12-10 17:19:53,121,3123,67,54,1848.45,3686.01,0.00
2024-12-10 17:19:53,122,3122,68,54,1829.54,3686.07,0.00
2024-12-10 17:19:53,121,3122,67,54,1852.59,3686.07,0.00
2024-12-10 17:19:54,120,3122,66,54,1866.07,3686.13,0.00
2024-12-10 17:19:54,119,3122,66,53,1880.99,3686.13,0.00
2024-12-10 17:19:54,119,3123,66,53,1876.38,3687.00,0.00
2024-12-10 17:19:54,120,3123,66,54,1860.74,3687.01,0.00
2024-12-10 17:19:54,119,3123,65,54,1871.76,3687.07,0.00
2024-12-10 17:19:54,119,3124,65,54,1895.33,3688.00,0.00
2024-12-10 17:19:54,120,3124,65,55,1879.54,3688.01,0.00
2024-12-10 17:19:54,119,3124,65,54,1894.72,3688.02,0.00
2024-12-10 17:19:54,118,3124,65,53,1906.59,3688.06,0.00
2024-12-10 17:19:54,117,3124,65,52,1922.57,3688.06,0.00
2024-12-10 17:19:54,116,3124,64,52,1933.93,3688.15,0.00
2024-12-10 17:19:54,116,3124,64,52,1931.56,3689.00,0.00
2024-12-10 17:19:54,117,3124,64,53,1915.05,3689.01,0.00
2024-12-10 17:19:54,116,3124,64,52,1927.09,3689.06,0.00
2024-12-10 17:19:54,116,3125,64,52,1921.50,3690.00,0.00
2024-12-10 17:19:54,117,3125,65,52,1905.07,3690.01,0.00
2024-12-10 17:19:54,116,3125,65,51,1917.00,3690.06,0.00
2024-12-10 17:19:54,115,3125,64,51,1922.61,3690.30,0.00
2024-12-10 17:19:54,115,3126,64,51,1929.16,3691.00,0.00
2024-12-10 17:19:54,116,3126,65,51,1912.53,3691.01,0.00
2024-12-10 17:19:54,115,3126,64,51,1923.63,3691.07,0.00
2024-12-10 17:19:54,115,3127,64,51,1921.45,3692.00,0.00
2024-12-10 17:19:54,116,3127,64,52,1904.88,3692.01,0.00
2024-12-10 17:19:54,115,3127,63,52,1918.20,3692.04,0.00
2024-12-10 17:19:54,114,3127,62,52,1934.07,3692.05,0.00
2024-12-10 17:19:54,114,3128,62,52,1930.52,3693.00,0.00
2024-12-10 17:19:54,115,3128,63,52,1913.73,3693.01,0.00
2024-12-10 17:19:54,115,3129,63,52,1907.51,3694.00,0.00
2024-12-10 17:19:54,116,3129,64,52,1891.06,3694.01,0.00
2024-12-10 17:19:54,116,3130,64,52,1883.73,3695.00,0.00
2024-12-10 17:19:54,117,3130,64,53,1867.63,3695.01,0.00
2024-12-10 17:19:54,117,3131,64,53,1858.34,3696.00,0.00
2024-12-10 17:19:54,118,3131,64,54,1842.59,3696.01,0.00
2024-12-10 17:19:54,119,3130,64,55,1804.38,3696.51,0.00
2024-12-10 17:19:54,119,3131,64,55,1831.30,3697.00,0.00
2024-12-10 17:19:54,120,3131,65,55,1816.03,3697.01,0.00
2024-12-10 17:19:54,119,3131,65,54,1829.45,3697.05,0.00
2024-12-10 17:19:54,118,3131,64,54,1826.84,3697.43,0.00
2024-12-10 17:19:54,118,3132,64,54,1866.65,3698.00,0.00
2024-12-10 17:19:54,119,3132,64,55,1850.96,3698.01,0.00
2024-12-10 17:19:54,118,3132,63,55,1865.60,3698.03,0.00
2024-12-10 17:19:54,117,3132,62,55,1880.92,3698.04,0.00
2024-12-10 17:19:54,116,3132,62,54,1896.81,3698.04,0.00
2024-12-10 17:19:54,116,3133,62,54,1887.54,3699.00,0.00
2024-12-10 17:19:54,117,3133,62,55,1871.41,3699.01,0.00
2024-12-10 17:19:54,116,3133,62,54,1886.59,3699.03,0.00
2024-12-10 17:19:54,115,3133,61,54,1902.36,3699.04,0.00
2024-12-10 17:19:54,114,3133,60,54,1918.72,3699.04,0.00
2024-12-10 17:19:54,114,3134,60,54,1909.31,3700.00,0.00
2024-12-10 17:19:54,115,3134,61,54,1892.70,3700.01,0.00
2024-12-10 17:19:54,114,3134,60,54,1908.02,3700.04,0.00
2024-12-10 17:19:54,114,3135,60,54,1898.56,3701.00,0.00
2024-12-10 17:19:54,115,3135,61,54,1882.05,3701.01,0.00
2024-12-10 17:19:54,115,3136,61,54,1871.65,3702.00,0.00
2024-12-10 17:19:54,116,3136,61,55,1855.52,3702.01,0.00
2024-12-10 17:19:54,115,3136,61,54,1870.38,3702.04,0.00
2024-12-10 17:19:54,114,3136,60,54,1886.46,3702.04,0.00
2024-12-10 17:19:54,115,3135,61,54,1843.64,3702.70,0.00
2024-12-10 17:19:54,115,3136,61,54,1871.66,3703.00,0.00
2024-12-10 17:19:54,116,3136,61,55,1855.52,3703.01,0.00
2024-12-10 17:19:54,115,3136,61,54,1870.38,3703.04,0.00
2024-12-10 17:19:54,114,3136,61,53,1883.16,3703.06,0.00
2024-12-10 17:19:54,113,3136,61,52,1870.53,3703.77,0.00
2024-12-10 17:19:54,113,3137,61,52,1927.75,3704.00,0.00
2024-12-10 17:19:54,114,3137,62,52,1910.84,3704.01,0.00
2024-12-10 17:19:54,113,3137,62,51,1926.45,3704.04,0.00
2024-12-10 17:19:54,114,3136,63,51,1901.78,3704.26,0.00
2024-12-10 17:19:54,114,3137,63,51,1931.83,3705.00,0.00
2024-12-10 17:19:54,115,3137,63,52,1915.03,3705.01,0.00
2024-12-10 17:19:54,114,3137,62,52,1930.55,3705.04,0.00
2024-12-10 17:19:54,114,3138,62,52,1960.31,3706.00,0.00
2024-12-10 17:19:54,115,3138,63,52,1943.27,3706.01,0.00
2024-12-10 17:19:54,114,3138,62,52,1959.02,3706.04,0.00
2024-12-10 17:19:54,114,3139,62,52,1956.29,3707.00,0.00
2024-12-10 17:19:54,115,3139,62,53,1939.28,3707.01,0.00
2024-12-10 17:19:54,114,3139,61,53,1955.00,3707.04,0.00
2024-12-10 17:19:54,115,3138,62,53,1904.46,3707.96,0.00
2024-12-10 17:19:54,115,3139,62,53,1936.42,3708.00,0.00
2024-12-10 17:19:54,116,3139,62,54,1919.73,3708.01,0.00
2024-12-10 17:19:54,115,3139,62,53,1935.14,3708.04,0.00
2024-12-10 17:19:54,115,3140,62,53,1963.99,3709.00,0.00
2024-12-10 17:19:54,116,3140,62,54,1947.06,3709.01,0.00
2024-12-10 17:19:54,115,3140,61,54,1962.71,3709.04,0.00
2024-12-10 17:19:54,114,3140,61,53,1977.37,3709.10,0.00
2024-12-10 17:19:54,114,3141,61,53,1976.91,3710.00,0.00
2024-12-10 17:19:54,115,3141,61,54,1959.72,3710.01,0.00
2024-12-10 17:19:54,114,3141,61,53,1975.62,3710.04,0.00
2024-12-10 17:19:54,114,3142,61,53,1972.89,3711.00,0.00
2024-12-10 17:19:54,115,3142,61,54,1955.73,3711.01,0.00
2024-12-10 17:19:54,114,3142,61,53,1971.60,3711.04,0.00
2024-12-10 17:19:54,114,3143,61,53,1968.86,3712.00,0.00
2024-12-10 17:19:54,115,3143,62,53,1951.74,3712.01,0.00
2024-12-10 17:19:54,114,3143,62,52,1967.57,3712.04,0.00
2024-12-10 17:19:54,114,3144,62,52,1964.78,3713.00,0.00
2024-12-10 17:19:54,115,3144,63,52,1947.70,3713.01,0.00
2024-12-10 17:19:54,114,3144,62,52,1963.49,3713.04,0.00
2024-12-10 17:19:54,115,3143,63,52,1928.17,3713.51,0.00
2024-12-10 17:19:54,115,3144,63,52,1958.25,3714.00,0.00
2024-12-10 17:19:54,116,3144,64,52,1941.37,3714.01,0.00
2024-12-10 17:19:54,115,3144,64,51,1956.97,3714.04,0.00
2024-12-10 17:19:54,115,3145,64,51,1985.09,3715.00,0.00
2024-12-10 17:19:54,116,3145,64,52,1967.97,3715.01,0.00
2024-12-10 17:19:54,115,3145,64,51,1983.80,3715.04,0.00
2024-12-10 17:19:55,115,3146,64,51,1980.77,3716.00,0.00
2024-12-10 17:19:55,116,3146,65,51,1963.70,3716.01,0.00
2024-12-10 17:19:55,115,3146,64,51,1979.49,3716.04,0.00
2024-12-10 17:19:55,115,3147,64,51,1976.46,3717.00,0.00
2024-12-10 17:19:55,116,3147,64,52,1959.42,3717.01,0.00
2024-12-10 17:19:55,116,3148,64,52,1954.91,3718.00,0.00
2024-12-10 17:19:55,117,3148,65,52,1938.20,3718.01,0.00
2024-12-10 17:19:55,116,3148,65,51,1954.27,3718.02,0.00
2024-12-10 17:19:55,115,3148,64,51,1970.62,3718.03,0.00
2024-12-10 17:19:55,115,3149,64,51,1966.36,3719.00,0.00
2024-12-10 17:19:55,116,3149,65,51,1949.41,3719.01,0.00
2024-12-10 17:19:55,115,3149,65,50,1965.40,3719.03,0.00
2024-12-10 17:19:55,115,3150,65,50,1961.14,3720.00,0.00
2024-12-10 17:19:55,116,3150,65,51,1944.24,3720.01,0.00
2024-12-10 17:19:55,115,3150,65,50,1960.18,3720.03,0.00
2024-12-10 17:19:55,115,3151,65,50,1956.36,3721.00,0.00
2024-12-10 17:19:55,116,3151,65,51,1939.49,3721.01,0.00
2024-12-10 17:19:55,115,3151,65,50,1955.39,3721.03,0.00
2024-12-10 17:19:55,115,3152,65,50,1951.47,3722.00,0.00
2024-12-10 17:19:55,116,3152,66,50,1934.64,3722.01,0.00
2024-12-10 17:19:55,115,3152,66,49,1950.50,3722.03,0.00
2024-12-10 17:19:55,115,3153,66,49,1946.17,3723.00,0.00
2024-12-10 17:19:55,116,3153,67,49,1929.39,3723.01,0.00
2024-12-10 17:19:55,115,3153,67,48,1945.21,3723.03,0.00
2024-12-10 17:19:55,115,3154,67,48,1940.26,3724.00,0.00
2024-12-10 17:19:55,116,3154,68,48,1923.53,3724.01,0.00
2024-12-10 17:19:55,115,3154,67,48,1939.30,3724.03,0.00
2024-12-10 17:19:55,115,3155,67,48,1933.91,3725.00,0.00
2024-12-10 17:19:55,116,3155,68,48,1917.24,3725.01,0.00
2024-12-10 17:19:55,115,3155,67,48,1932.94,3725.03,0.00
2024-12-10 17:19:55,115,3156,67,48,1927.74,3726.00,0.00
2024-12-10 17:19:55,116,3156,67,49,1911.12,3726.01,0.00
2024-12-10 17:19:55,115,3156,67,48,1926.77,3726.03,0.00
2024-12-10 17:19:55,114,3156,66,48,1933.40,3726.26,0.00
2024-12-10 17:19:55,114,3157,66,48,1939.09,3727.00,0.00
2024-12-10 17:19:55,115,3157,66,49,1922.23,3727.01,0.00
2024-12-10 17:19:55,114,3157,65,49,1938.12,3727.03,0.00
2024-12-10 17:19:55,113,3157,65,48,1954.94,3727.03,0.00
2024-12-10 17:19:55,113,3158,65,48,1952.16,3728.00,0.00
2024-12-10 17:19:55,114,3158,66,48,1935.03,3728.01,0.00
2024-12-10 17:19:55,114,3159,66,48,1931.30,3729.00,0.00
2024-12-10 17:19:55,115,3159,66,49,1914.51,3729.01,0.00
2024-12-10 17:19:55,116,3158,67,49,1872.86,3729.71,0.00
2024-12-10 17:19:55,116,3159,67,49,1903.98,3730.00,0.00
2024-12-10 17:19:55,117,3159,67,50,1887.70,3730.01,0.00
2024-12-10 17:19:55,116,3159,66,50,1902.39,3730.04,0.00
2024-12-10 17:19:55,116,3160,66,50,1931.51,3731.00,0.00
2024-12-10 17:19:55,117,3160,67,50,1915.00,3731.01,0.00
2024-12-10 17:19:55,116,3160,67,49,1929.91,3731.04,0.00
2024-12-10 17:19:55,115,3160,67,48,1939.83,3731.23,0.00
2024-12-10 17:19:55,115,3161,67,48,1943.71,3732.00,0.00
2024-12-10 17:19:55,116,3161,67,49,1926.95,3732.01,0.00
2024-12-10 17:19:55,115,3161,67,48,1942.10,3732.04,0.00
2024-12-10 17:19:55,115,3162,67,48,1939.19,3733.00,0.00
2024-12-10 17:19:55,116,3162,67,49,1922.48,3733.01,0.00
2024-12-10 17:19:55,115,3162,66,49,1937.59,3733.04,0.00
2024-12-10 17:19:55,115,3163,66,49,1934.44,3734.00,0.00
2024-12-10 17:19:55,116,3163,66,50,1917.76,3734.01,0.00
2024-12-10 17:19:55,115,3163,66,49,1932.83,3734.04,0.00
2024-12-10 17:19:55,115,3164,66,49,1930.09,3735.00,0.00
2024-12-10 17:19:55,116,3164,67,49,1913.45,3735.01,0.00
2024-12-10 17:19:55,115,3164,66,49,1928.48,3735.04,0.00
2024-12-10 17:19:55,115,3165,66,49,1925.19,3736.00,0.00
2024-12-10 17:19:55,116,3165,66,50,1908.59,3736.01,0.00
2024-12-10 17:19:55,115,3165,65,50,1923.58,3736.04,0.00
2024-12-10 17:19:55,116,3164,66,50,1896.11,3736.35,0.00
2024-12-10 17:19:55,116,3165,66,50,1923.58,3737.00,0.00
2024-12-10 17:19:55,117,3165,67,50,1907.14,3737.01,0.00
2024-12-10 17:19:55,116,3165,66,50,1921.98,3737.04,0.00
2024-12-10 17:19:55,116,3166,66,50,1944.68,3738.00,0.00
2024-12-10 17:19:55,117,3166,67,50,1928.06,3738.01,0.00
2024-12-10 17:19:55,116,3166,66,50,1943.08,3738.04,0.00
2024-12-10 17:19:55,117,3165,67,50,1899.46,3738.72,0.00
2024-12-10 17:19:55,117,3166,67,50,1927.00,3739.00,0.00
2024-12-10 17:19:55,118,3166,67,51,1910.67,3739.01,0.00
2024-12-10 17:19:55,118,3167,67,51,1934.19,3740.00,0.00
2024-12-10 17:19:55,119,3167,68,51,1917.93,3740.01,0.00
2024-12-10 17:19:55,118,3167,67,51,1932.61,3740.04,0.00
2024-12-10 17:19:55,118,3168,67,51,1925.79,3741.00,0.00
2024-12-10 17:19:55,119,3168,67,52,1909.61,3741.01,0.00
2024-12-10 17:19:55,118,3168,67,51,1924.22,3741.04,0.00
2024-12-10 17:19:55,118,3169,67,51,1915.07,3742.00,0.00
2024-12-10 17:19:55,119,3169,68,51,1898.98,3742.01,0.00
2024-12-10 17:19:55,118,3169,68,50,1913.50,3742.04,0.00
2024-12-10 17:19:55,119,3168,68,51,1875.33,3742.57,0.00
2024-12-10 17:19:55,120,3167,68,52,1875.79,3742.59,0.00
2024-12-10 17:19:55,121,3166,69,52,1871.76,3742.65,0.00
2024-12-10 17:19:55,121,3167,69,52,1897.14,3743.00,0.00
2024-12-10 17:19:55,122,3167,69,53,1881.59,3743.01,0.00
2024-12-10 17:19:55,121,3167,68,53,1895.60,3743.04,0.00
2024-12-10 17:19:55,121,3168,68,53,1976.02,3744.00,0.00
2024-12-10 17:19:55,122,3168,69,53,1959.83,3744.01,0.00
2024-12-10 17:19:55,121,3168,68,53,1974.49,3744.04,0.00
2024-12-10 17:19:55,120,3168,67,53,1970.28,3744.49,0.00
2024-12-10 17:19:56,120,3169,67,53,1978.08,3745.00,0.00
2024-12-10 17:19:56,121,3169,68,53,1961.73,3745.01,0.00
2024-12-10 17:19:56,120,3169,68,52,1976.53,3745.04,0.00
2024-12-10 17:19:56,120,3170,68,52,1964.11,3746.00,0.00
2024-12-10 17:19:56,121,3170,69,52,1947.87,3746.01,0.00
2024-12-10 17:19:56,121,3171,69,52,1930.28,3747.00,0.00
2024-12-10 17:19:56,122,3171,70,52,1914.46,3747.01,0.00
2024-12-10 17:19:56,121,3171,69,52,1928.43,3747.05,0.00
2024-12-10 17:19:56,120,3171,68,52,1944.19,3747.05,0.00
2024-12-10 17:19:56,119,3171,68,51,1956.16,3747.16,0.00
2024-12-10 17:19:56,119,3172,68,51,1939.27,3748.00,0.00
2024-12-10 17:19:56,120,3172,69,51,1923.11,3748.01,0.00
2024-12-10 17:19:56,119,3172,68,51,1937.59,3748.05,0.00
2024-12-10 17:19:56,119,3173,68,51,1917.76,3749.00,0.00
2024-12-10 17:19:56,120,3173,68,52,1901.78,3749.01,0.00
2024-12-10 17:19:56,119,3173,67,52,1915.88,3749.05,0.00
2024-12-10 17:19:56,119,3174,67,52,1893.49,3750.00,0.00
2024-12-10 17:19:56,120,3174,67,53,1877.71,3750.01,0.00
2024-12-10 17:19:56,121,3173,68,53,1862.19,3750.03,0.00
2024-12-10 17:19:56,120,3173,67,53,1907.11,3750.06,0.00
2024-12-10 17:19:56,119,3173,67,52,1922.82,3750.06,0.00
2024-12-10 17:19:56,118,3173,66,52,1905.74,3750.65,0.00
2024-12-10 17:19:56,118,3174,66,52,1916.52,3751.00,0.00
2024-12-10 17:19:56,119,3174,67,52,1900.41,3751.01,0.00
2024-12-10 17:19:56,118,3174,66,52,1914.63,3751.05,0.00
2024-12-10 17:19:56,117,3174,65,52,1903.61,3751.62,0.00
2024-12-10 17:19:56,117,3175,65,52,1946.84,3752.00,0.00
2024-12-10 17:19:56,118,3175,65,53,1930.34,3752.01,0.00
2024-12-10 17:19:56,117,3175,65,52,1914.76,3752.65,0.00
2024-12-10 17:19:56,117,3176,65,52,1932.21,3753.00,0.00
2024-12-10 17:19:56,118,3176,66,52,1915.84,3753.01,0.00
2024-12-10 17:19:56,118,3177,66,52,1905.43,3754.00,0.00
2024-12-10 17:19:56,119,3177,66,53,1889.41,3754.01,0.00
2024-12-10 17:19:56,118,3177,66,52,1903.56,3754.05,0.00
2024-12-10 17:19:56,118,3178,66,52,1892.78,3755.00,0.00
2024-12-10 17:19:56,119,3178,67,52,1876.88,3755.01,0.00
2024-12-10 17:19:56,118,3178,67,51,1890.48,3755.05,0.00
2024-12-10 17:19:56,117,3178,66,51,1889.71,3755.44,0.00
2024-12-10 17:19:56,117,3179,66,51,1893.50,3756.00,0.00
2024-12-10 17:19:56,118,3179,66,52,1877.46,3756.01,0.00
2024-12-10 17:19:56,117,3179,65,52,1891.43,3756.05,0.00
2024-12-10 17:19:56,117,3180,65,52,1875.15,3757.00,0.00
2024-12-10 17:19:56,118,3180,65,53,1859.26,3757.01,0.00
2024-12-10 17:19:56,117,3180,65,52,1873.25,3757.05,0.00
2024-12-10 17:19:56,116,3180,64,52,1878.48,3757.34,0.00
2024-12-10 17:19:56,116,3181,64,52,1872.14,3758.00,0.00
2024-12-10 17:19:56,117,3181,64,53,1856.14,3758.01,0.00
2024-12-10 17:19:56,116,3181,64,52,1870.22,3758.05,0.00
2024-12-10 17:19:56,116,3182,64,52,1849.75,3759.00,0.00
2024-12-10 17:19:56,117,3182,65,52,1833.94,3759.01,0.00
2024-12-10 17:19:56,116,3182,64,52,1847.50,3759.06,0.00
2024-12-10 17:19:56,115,3182,63,52,1841.18,3759.59,0.00
2024-12-10 17:19:56,115,3183,63,52,1839.69,3760.00,0.00
2024-12-10 17:19:56,116,3183,64,52,1823.83,3760.01,0.00
2024-12-10 17:19:56,115,3183,64,51,1837.42,3760.06,0.00
2024-12-10 17:19:56,115,3184,64,51,1814.52,3761.00,0.00
2024-12-10 17:19:56,116,3184,65,51,1798.88,3761.01,0.00
2024-12-10 17:19:56,115,3184,65,50,1811.68,3761.06,0.00
2024-12-10 17:19:56,114,3184,64,50,1790.34,3761.91,0.00
2024-12-10 17:19:56,113,3184,63,50,1798.51,3761.92,0.00
2024-12-10 17:19:56,113,3185,63,50,1822.91,3762.00,0.00
2024-12-10 17:19:56,114,3185,63,51,1806.92,3762.01,0.00
2024-12-10 17:19:56,113,3185,62,51,1819.41,3762.06,0.00
2024-12-10 17:19:56,112,3185,61,51,1802.49,3762.88,0.00
2024-12-10 17:19:56,112,3186,61,51,1823.78,3763.00,0.00
2024-12-10 17:19:56,113,3186,61,52,1807.64,3763.01,0.00
2024-12-10 17:19:56,112,3186,61,51,1819.68,3763.06,0.00
2024-12-10 17:19:56,111,3186,61,50,1797.65,3763.93,0.00
2024-12-10 17:19:56,112,3185,62,50,1780.94,3763.96,0.00
2024-12-10 17:19:56,112,3186,62,50,1813.34,3764.00,0.00
2024-12-10 17:19:56,113,3186,62,51,1797.29,3764.01,0.00
2024-12-10 17:19:56,113,3187,62,51,1820.84,3765.00,0.00
2024-12-10 17:19:56,114,3187,62,52,1804.87,3765.01,0.00
2024-12-10 17:19:56,113,3187,61,52,1819.18,3765.02,0.00
2024-12-10 17:19:56,112,3187,60,52,1833.42,3765.06,0.00
2024-12-10 17:19:56,112,3188,60,52,1825.09,3766.00,0.00
2024-12-10 17:19:56,113,3188,60,53,1808.94,3766.01,0.00
2024-12-10 17:19:56,112,3188,59,53,1822.76,3766.06,0.00
2024-12-10 17:19:56,112,3189,59,53,1811.70,3767.00,0.00
2024-12-10 17:19:56,113,3189,59,54,1795.67,3767.01,0.00
2024-12-10 17:19:56,112,3189,58,54,1809.36,3767.06,0.00
2024-12-10 17:19:56,112,3190,58,54,1795.66,3768.00,0.00
2024-12-10 17:19:56,113,3190,59,54,1779.77,3768.01,0.00
2024-12-10 17:19:56,112,3190,59,53,1793.32,3768.06,0.00
2024-12-10 17:19:56,111,3190,59,52,1789.21,3768.49,0.00
2024-12-10 17:19:56,111,3191,59,52,1792.78,3769.00,0.00
2024-12-10 17:19:56,112,3191,59,53,1776.77,3769.01,0.00
2024-12-10 17:19:56,111,3191,58,53,1791.09,3769.05,0.00
2024-12-10 17:19:56,110,3191,57,53,1806.69,3769.05,0.00
2024-12-10 17:19:56,109,3191,56,53,1783.61,3769.91,0.00
2024-12-10 17:19:56,109,3192,56,53,1813.46,3770.00,0.00
2024-12-10 17:19:56,110,3192,57,53,1796.98,3770.01,0.00
2024-12-10 17:19:56,109,3192,56,53,1811.02,3770.06,0.00
2024-12-10 17:19:57,109,3193,56,53,1805.50,3771.00,0.00
2024-12-10 17:19:57,110,3193,57,53,1789.08,3771.01,0.00
2024-12-10 17:19:57,109,3193,56,53,1802.75,3771.07,0.00
2024-12-10 17:19:57,109,3194,56,53,1796.58,3772.00,0.00
2024-12-10 17:19:57,110,3194,57,53,1780.25,3772.01,0.00
2024-12-10 17:19:57,109,3194,57,52,1793.83,3772.07,0.00
2024-12-10 17:19:57,109,3195,57,52,1786.69,3773.00,0.00
2024-12-10 17:19:57,110,3195,58,52,1770.44,3773.01,0.00
2024-12-10 17:19:57,109,3195,57,52,1783.94,3773.07,0.00
2024-12-10 17:19:57,109,3196,57,52,1774.86,3774.00,0.00
2024-12-10 17:19:57,110,3196,58,52,1758.72,3774.01,0.00
2024-12-10 17:19:57,109,3196,57,52,1772.10,3774.07,0.00
2024-12-10 17:19:57,110,3195,57,53,1749.49,3774.26,0.00
2024-12-10 17:19:57,111,3194,58,53,1758.30,3774.40,0.00
2024-12-10 17:19:57,111,3195,58,53,1788.40,3775.00,0.00
2024-12-10 17:19:57,112,3195,59,53,1772.44,3775.01,0.00
2024-12-10 17:19:57,111,3195,58,53,1787.39,3775.03,0.00
2024-12-10 17:19:57,110,3195,58,52,1801.80,3775.06,0.00
2024-12-10 17:19:57,109,3195,57,52,1817.99,3775.06,0.00
2024-12-10 17:19:57,109,3196,57,52,1873.62,3776.00,0.00
2024-12-10 17:19:57,110,3196,58,52,1856.58,3776.01,0.00
2024-12-10 17:19:57,109,3196,57,52,1870.91,3776.06,0.00
2024-12-10 17:19:57,109,3197,57,52,1853.18,3777.00,0.00
2024-12-10 17:19:57,110,3197,58,52,1836.34,3777.01,0.00
2024-12-10 17:19:57,109,3197,58,51,1850.29,3777.06,0.00
2024-12-10 17:19:57,108,3197,58,50,1861.60,3777.17,0.00
2024-12-10 17:19:57,107,3197,58,49,1865.29,3777.44,0.00
2024-12-10 17:19:57,108,3196,58,50,1826.51,3777.85,0.00
2024-12-10 17:19:57,108,3197,58,50,1853.03,3778.00,0.00
2024-12-10 17:19:57,109,3197,59,50,1836.03,3778.01,0.00
2024-12-10 17:19:57,108,3197,58,50,1850.83,3778.05,0.00
2024-12-10 17:19:57,107,3197,57,50,1867.42,3778.06,0.00
2024-12-10 17:19:57,107,3198,57,50,1880.27,3779.00,0.00
2024-12-10 17:19:57,108,3198,58,50,1862.86,3779.01,0.00
2024-12-10 17:19:57,107,3198,57,50,1878.16,3779.06,0.00
2024-12-10 17:19:57,106,3198,57,49,1881.67,3779.33,0.00
2024-12-10 17:19:57,105,3198,56,49,1887.03,3779.56,0.00
2024-12-10 17:19:57,105,3199,56,49,1885.15,3780.00,0.00
2024-12-10 17:19:57,106,3199,57,49,1867.36,3780.01,0.00
2024-12-10 17:19:57,105,3199,57,48,1883.00,3780.06,0.00
2024-12-10 17:19:57,104,3199,56,48,1882.60,3780.35,0.00
2024-12-10 17:19:57,104,3200,56,48,1869.01,3781.00,0.00
2024-12-10 17:19:57,105,3200,56,49,1851.21,3781.01,0.00
2024-12-10 17:19:57,104,3200,55,49,1866.85,3781.06,0.00
2024-12-10 17:19:57,104,3201,55,49,1830.32,3782.00,0.00
2024-12-10 17:19:57,105,3201,56,49,1812.88,3782.01,0.00
2024-12-10 17:19:57,104,3201,56,48,1828.15,3782.06,0.00
2024-12-10 17:19:57,103,3201,55,48,1809.96,3782.77,0.00
2024-12-10 17:19:57,102,3201,55,47,1817.23,3782.82,0.00
2024-12-10 17:19:57,101,3201,54,47,1826.36,3782.87,0.00
2024-12-10 17:19:57,101,3202,54,47,1848.78,3783.00,0.00
2024-12-10 17:19:57,102,3202,54,48,1830.65,3783.01,0.00
2024-12-10 17:19:57,101,3202,53,48,1846.54,3783.06,0.00
2024-12-10 17:19:57,102,3201,53,49,1813.75,3783.32,0.00
2024-12-10 17:19:57,101,3201,53,48,1864.87,3783.33,0.00
2024-12-10 17:19:57,101,3202,53,48,1860.08,3784.00,0.00
2024-12-10 17:19:57,102,3202,54,48,1841.84,3784.01,0.00
2024-12-10 17:19:57,101,3202,53,48,1857.84,3784.06,0.00
2024-12-10 17:19:57,100,3202,53,47,1844.86,3784.68,0.00
2024-12-10 17:19:57,100,3203,53,47,1890.18,3785.00,0.00
2024-12-10 17:19:57,101,3203,53,48,1871.46,3785.01,0.00
2024-12-10 17:19:57,100,3203,52,48,1887.92,3785.06,0.00
2024-12-10 17:19:57,99,3203,52,47,1872.21,3785.75,0.00
2024-12-10 17:19:57,99,3204,52,47,1880.71,3786.00,0.00
2024-12-10 17:19:57,100,3204,52,48,1861.90,3786.01,0.00
2024-12-10 17:19:57,99,3204,52,47,1878.33,3786.06,0.00
2024-12-10 17:19:57,99,3205,52,47,1847.63,3787.00,0.00
2024-12-10 17:19:57,100,3205,52,48,1829.15,3787.01,0.00
2024-12-10 17:19:57,99,3205,52,47,1845.14,3787.06,0.00
2024-12-10 17:19:57,98,3205,51,47,1860.69,3787.10,0.00
2024-12-10 17:19:57,98,3206,51,47,1829.83,3788.00,0.00
2024-12-10 17:19:57,99,3206,51,48,1811.34,3788.01,0.00
2024-12-10 17:19:57,98,3206,51,47,1827.10,3788.06,0.00
2024-12-10 17:19:57,97,3206,50,47,1840.04,3788.20,0.00
2024-12-10 17:19:57,96,3206,49,47,1810.46,3788.90,0.00
2024-12-10 17:19:57,96,3207,49,47,1831.29,3789.00,0.00
2024-12-10 17:19:57,97,3207,50,47,1812.41,3789.01,0.00
2024-12-10 17:19:57,96,3207,50,46,1796.90,3789.74,0.00
2024-12-10 17:19:57,95,3207,49,46,1807.88,3789.86,0.00
2024-12-10 17:19:57,95,3208,49,46,1821.71,3790.00,0.00
2024-12-10 17:19:57,96,3208,50,46,1802.73,3790.01,0.00
2024-12-10 17:19:57,95,3208,49,46,1818.57,3790.06,0.00
2024-12-10 17:19:57,95,3209,49,46,1788.91,3791.00,0.00
2024-12-10 17:19:57,96,3209,50,46,1770.27,3791.01,0.00
2024-12-10 17:19:57,95,3209,49,46,1785.52,3791.06,0.00
2024-12-10 17:19:57,94,3209,48,46,1760.06,3791.87,0.00
2024-12-10 17:19:57,95,3208,49,46,1720.12,3791.95,0.00
2024-12-10 17:19:57,95,3209,49,46,1757.44,3792.00,0.00
2024-12-10 17:19:57,96,3209,49,47,1739.13,3792.01,0.00
2024-12-10 17:19:57,95,3209,49,46,1753.86,3792.06,0.00
2024-12-10 17:19:57,94,3209,48,46,1726.07,3792.86,0.00
2024-12-10 17:19:57,93,3209,48,45,1740.95,3792.87,0.00
2024-12-10 17:19:57,93,3210,48,45,1809.42,3793.00,0.00
2024-12-10 17:19:57,94,3210,48,46,1790.17,3793.01,0.00
2024-12-10 17:19:57,94,3211,48,46,1765.87,3794.00,0.00
2024-12-10 17:19:57,95,3211,48,47,1747.28,3794.01,0.00
2024-12-10 17:19:57,95,3212,48,47,1719.70,3795.00,0.00
2024-12-10 17:19:57,96,3212,49,47,1701.78,3795.01,0.00
2024-12-10 17:19:57,95,3212,49,46,1715.74,3795.06,0.00
2024-12-10 17:19:57,94,3212,48,46,1727.67,3795.18,0.00
2024-12-10 17:19:57,94,3213,48,46,1704.55,3796.00,0.00
2024-12-10 17:19:57,95,3213,48,47,1686.61,3796.01,0.00
2024-12-10 17:19:57,94,3213,47,47,1701.27,3796.03,0.00
2024-12-10 17:19:57,93,3213,47,46,1718.34,3796.05,0.00
2024-12-10 17:19:57,92,3213,47,45,1736.61,3796.05,0.00
2024-12-10 17:19:57,91,3213,46,45,1718.33,3796.75,0.00
2024-12-10 17:19:58,90,3213,45,45,1723.71,3796.87,0.00
2024-12-10 17:19:58,90,3214,45,45,1745.10,3797.00,0.00
2024-12-10 17:19:58,91,3214,46,45,1725.92,3797.01,0.00
2024-12-10 17:19:58,91,3215,46,45,1691.43,3798.00,0.00
2024-12-10 17:19:58,92,3215,47,45,1673.04,3798.01,0.00
2024-12-10 17:19:58,91,3215,47,44,1670.03,3798.49,0.00
2024-12-10 17:19:58,90,3215,46,44,1678.93,3798.66,0.00
2024-12-10 17:19:58,90,3216,46,44,1676.99,3799.00,0.00
2024-12-10 17:19:58,91,3216,46,45,1658.56,3799.01,0.00
2024-12-10 17:19:58,90,3216,45,45,1636.27,3799.79,0.00
2024-12-10 17:19:58,90,3217,45,45,1642.70,3800.00,0.00
2024-12-10 17:19:58,91,3217,46,45,1624.65,3800.01,0.00
2024-12-10 17:19:58,90,3217,46,44,1641.59,3800.01,0.00
2024-12-10 17:19:58,89,3217,45,44,1657.48,3800.07,0.00
2024-12-10 17:19:58,88,3217,44,44,1645.34,3800.69,0.00
2024-12-10 17:19:58,87,3217,43,44,1638.34,3800.90,0.00
2024-12-10 17:19:58,87,3218,43,44,1668.75,3801.00,0.00
2024-12-10 17:19:58,88,3218,43,45,1649.78,3801.01,0.00
2024-12-10 17:19:58,87,3218,42,45,1666.14,3801.07,0.00
2024-12-10 17:19:58,86,3218,42,44,1635.64,3801.91,0.00
2024-12-10 17:19:58,86,3219,42,44,1676.39,3802.00,0.00
2024-12-10 17:19:58,87,3219,43,44,1657.12,3802.01,0.00
2024-12-10 17:19:58,86,3219,43,43,1675.07,3802.04,0.00
2024-12-10 17:19:58,85,3219,43,42,1693.44,3802.06,0.00
2024-12-10 17:19:58,84,3219,42,42,1695.37,3802.54,0.00
2024-12-10 17:19:58,83,3219,41,42,1682.92,3802.88,0.00
2024-12-10 17:19:58,83,3220,41,42,1724.26,3803.00,0.00
2024-12-10 17:19:58,84,3220,41,43,1703.74,3803.01,0.00
2024-12-10 17:19:58,83,3220,41,42,1721.52,3803.07,0.00
2024-12-10 17:19:58,82,3220,41,41,1720.75,3803.60,0.00
2024-12-10 17:19:58,81,3220,40,41,1725.62,3803.86,0.00
2024-12-10 17:19:58,81,3221,40,41,1767.53,3804.00,0.00
2024-12-10 17:19:58,82,3221,40,42,1745.97,3804.01,0.00
2024-12-10 17:19:58,81,3221,39,42,1767.06,3804.01,0.00
2024-12-10 17:19:58,80,3221,38,42,1786.78,3804.06,0.00
2024-12-10 17:19:58,80,3222,38,42,1794.85,3805.00,0.00
2024-12-10 17:19:58,81,3222,38,43,1772.70,3805.01,0.00
2024-12-10 17:19:58,80,3222,38,42,1792.49,3805.06,0.00
2024-12-10 17:19:58,80,3223,38,42,1800.51,3806.00,0.00
2024-12-10 17:19:58,81,3223,39,42,1778.29,3806.01,0.00
2024-12-10 17:19:58,80,3223,39,41,1769.18,3806.81,0.00
2024-12-10 17:19:58,80,3224,39,41,1809.78,3807.00,0.00
2024-12-10 17:19:58,81,3224,39,42,1787.44,3807.01,0.00
2024-12-10 17:19:58,80,3224,38,42,1807.89,3807.05,0.00
2024-12-10 17:19:58,79,3224,38,41,1830.29,3807.05,0.00
2024-12-10 17:19:58,79,3225,38,41,1841.82,3808.00,0.00
2024-12-10 17:19:58,80,3225,39,41,1818.80,3808.01,0.00
2024-12-10 17:19:58,80,3226,39,41,1828.25,3809.00,0.00
2024-12-10 17:19:58,81,3226,40,41,1805.68,3809.01,0.00
2024-12-10 17:19:58,81,3227,40,41,1814.63,3810.00,0.00
2024-12-10 17:19:58,82,3227,41,41,1792.50,3810.01,0.00
2024-12-10 17:19:58,82,3228,41,41,1801.18,3811.00,0.00
2024-12-10 17:19:58,83,3228,41,42,1779.48,3811.01,0.00
2024-12-10 17:19:58,83,3229,41,42,1787.76,3812.00,0.00
2024-12-10 17:19:58,84,3229,42,42,1766.48,3812.01,0.00
2024-12-10 17:19:58,84,3230,42,42,1774.08,3813.00,0.00
2024-12-10 17:19:58,85,3230,42,43,1753.21,3813.01,0.00
2024-12-10 17:19:58,84,3230,41,43,1773.63,3813.01,0.00
2024-12-10 17:19:58,83,3230,40,43,1792.72,3813.06,0.00
2024-12-10 17:19:58,83,3231,40,43,1802.80,3814.00,0.00
2024-12-10 17:19:58,84,3231,41,43,1781.33,3814.01,0.00
2024-12-10 17:19:58,84,3232,41,43,1788.97,3815.00,0.00
2024-12-10 17:19:58,85,3232,42,43,1767.93,3815.01,0.00
2024-12-10 17:19:58,84,3232,42,42,1786.72,3815.06,0.00
2024-12-10 17:19:58,84,3233,42,42,1795.83,3816.00,0.00
2024-12-10 17:19:58,85,3233,43,42,1774.71,3816.01,0.00
2024-12-10 17:19:58,84,3233,42,42,1793.58,3816.06,0.00
2024-12-10 17:19:58,85,3232,43,42,1770.68,3816.13,0.00
2024-12-10 17:19:58,85,3233,43,42,1822.71,3817.00,0.00
2024-12-10 17:19:58,86,3233,44,42,1801.52,3817.01,0.00
2024-12-10 17:19:58,87,3232,44,43,1779.50,3817.07,0.00
2024-12-10 17:19:58,87,3233,44,43,1845.51,3818.00,0.00
2024-12-10 17:19:58,88,3233,45,43,1824.54,3818.01,0.00
2024-12-10 17:19:58,88,3234,45,43,1872.74,3819.00,0.00
2024-12-10 17:19:58,89,3234,46,43,1851.70,3819.01,0.00
2024-12-10 17:19:58,88,3234,45,43,1870.59,3819.06,0.00
2024-12-10 17:19:58,88,3235,45,43,1877.07,3820.00,0.00
2024-12-10 17:19:58,89,3235,45,44,1855.98,3820.01,0.00
2024-12-10 17:19:58,88,3235,45,43,1874.91,3820.06,0.00
2024-12-10 17:19:58,88,3236,45,43,1881.27,3821.00,0.00
2024-12-10 17:19:58,89,3236,45,44,1860.13,3821.01,0.00
2024-12-10 17:19:58,90,3235,46,44,1822.58,3821.48,0.00
2024-12-10 17:19:58,90,3236,46,44,1868.12,3822.00,0.00
2024-12-10 17:19:58,91,3236,46,45,1847.59,3822.01,0.00
2024-12-10 17:19:58,90,3236,45,45,1866.01,3822.06,0.00
2024-12-10 17:19:58,91,3235,46,45,1829.62,3822.49,0.00
2024-12-10 17:19:58,91,3236,46,45,1914.80,3823.00,0.00
2024-12-10 17:19:58,92,3236,46,46,1893.99,3823.01,0.00
2024-12-10 17:19:58,91,3236,45,46,1912.71,3823.06,0.00
2024-12-10 17:19:58,91,3237,45,46,1958.97,3824.00,0.00
2024-12-10 17:19:58,92,3237,45,47,1937.67,3824.01,0.00
2024-12-10 17:19:58,91,3237,44,47,1940.72,3824.48,0.00
2024-12-10 17:19:58,91,3238,44,47,1962.56,3825.00,0.00
2024-12-10 17:19:58,92,3238,44,48,1941.23,3825.01,0.00
2024-12-10 17:19:58,91,3238,43,48,1960.06,3825.07,0.00
2024-12-10 17:19:58,92,3237,44,48,1906.79,3825.90,0.00
2024-12-10 17:19:58,92,3238,44,48,1947.64,3826.00,0.00
2024-12-10 17:19:58,93,3238,44,49,1926.70,3826.01,0.00
2024-12-10 17:19:58,92,3238,44,48,1945.17,3826.07,0.00
2024-12-10 17:19:58,92,3239,44,48,1991.72,3827.00,0.00
2024-12-10 17:19:58,93,3239,45,48,1970.30,3827.01,0.00
2024-12-10 17:19:58,92,3239,45,47,1989.24,3827.07,0.00
2024-12-10 17:19:58,92,3240,45,47,1993.89,3828.00,0.00
2024-12-10 17:19:58,93,3240,46,47,1972.45,3828.01,0.00
2024-12-10 17:19:58,92,3240,45,47,1991.41,3828.07,0.00
2024-12-10 17:19:59,92,3241,45,47,1995.10,3829.00,0.00
2024-12-10 17:19:59,93,3241,45,48,1973.65,3829.01,0.00
2024-12-10 17:19:59,92,3241,45,47,1994.69,3829.01,0.00
2024-12-10 17:19:59,91,3241,45,46,2014.52,3829.06,0.00
2024-12-10 17:19:59,90,3241,44,46,2036.48,3829.06,0.00
2024-12-10 17:19:59,89,3241,44,45,2057.81,3829.08,0.00
2024-12-10 17:19:59,89,3242,44,45,2064.11,3830.00,0.00
2024-12-10 17:19:59,90,3242,44,46,2041.18,3830.01,0.00
2024-12-10 17:19:59,89,3242,44,45,2061.98,3830.06,0.00
2024-12-10 17:19:59,88,3242,43,45,2069.49,3830.42,0.00
2024-12-10 17:19:59,88,3243,43,45,2091.26,3831.00,0.00
2024-12-10 17:19:59,89,3243,44,45,2067.76,3831.01,0.00
2024-12-10 17:19:59,88,3243,43,45,2089.10,3831.06,0.00
2024-12-10 17:19:59,89,3242,43,46,2052.25,3831.43,0.00
2024-12-10 17:19:59,89,3243,43,46,2097.47,3832.00,0.00
2024-12-10 17:19:59,90,3243,44,46,2074.16,3832.01,0.00
2024-12-10 17:19:59,89,3243,44,45,2082.57,3832.39,0.00
2024-12-10 17:19:59,89,3244,44,45,2145.90,3833.00,0.00
2024-12-10 17:19:59,90,3244,44,46,2122.06,3833.01,0.00
2024-12-10 17:19:59,89,3244,44,45,2143.77,3833.06,0.00
2024-12-10 17:19:59,89,3245,44,45,2151.20,3834.00,0.00
2024-12-10 17:19:59,90,3245,44,46,2127.30,3834.01,0.00
2024-12-10 17:19:59,89,3245,44,45,2149.06,3834.06,0.00
2024-12-10 17:19:59,89,3246,44,45,2156.50,3835.00,0.00
2024-12-10 17:19:59,90,3246,44,46,2132.54,3835.01,0.00
2024-12-10 17:19:59,89,3246,43,46,2154.36,3835.06,0.00
2024-12-10 17:19:59,89,3247,43,46,2161.80,3836.00,0.00
2024-12-10 17:19:59,90,3247,43,47,2137.78,3836.01,0.00
2024-12-10 17:19:59,89,3247,43,46,2159.67,3836.06,0.00
2024-12-10 17:19:59,89,3248,43,46,2165.89,3837.00,0.00
2024-12-10 17:19:59,90,3248,44,46,2141.82,3837.01,0.00
2024-12-10 17:19:59,89,3248,43,46,2163.75,3837.06,0.00
2024-12-10 17:19:59,89,3249,43,46,2167.87,3838.00,0.00
2024-12-10 17:19:59,90,3249,43,47,2143.78,3838.01,0.00
2024-12-10 17:19:59,89,3249,42,47,2167.01,3838.02,0.00
2024-12-10 17:19:59,88,3249,41,47,2190.34,3838.05,0.00
2024-12-10 17:19:59,87,3249,40,47,2215.08,3838.05,0.00
2024-12-10 17:19:59,87,3250,40,47,2217.06,3839.00,0.00
2024-12-10 17:19:59,88,3250,41,47,2191.87,3839.01,0.00
2024-12-10 17:19:59,87,3250,41,46,2215.31,3839.05,0.00
2024-12-10 17:19:59,88,3249,41,47,2182.31,3839.27,0.00
2024-12-10 17:19:59,89,3248,41,48,2184.98,3839.36,0.00
2024-12-10 17:19:59,89,3249,41,48,2208.96,3840.00,0.00
2024-12-10 17:19:59,90,3249,42,48,2184.42,3840.01,0.00
2024-12-10 17:19:59,89,3249,41,48,2206.46,3840.05,0.00
2024-12-10 17:19:59,88,3249,41,47,2209.00,3840.35,0.00
2024-12-10 17:19:59,87,3249,41,46,2232.33,3840.38,0.00
2024-12-10 17:19:59,87,3250,41,46,2341.40,3841.00,0.00
2024-12-10 17:19:59,88,3250,42,46,2314.79,3841.01,0.00
2024-12-10 17:19:59,87,3250,42,45,2341.33,3841.01,0.00
2024-12-10 17:19:59,86,3250,42,44,2367.24,3841.04,0.00
2024-12-10 17:19:59,86,3251,42,44,2371.17,3842.00,0.00
2024-12-10 17:19:59,87,3251,43,44,2343.92,3842.01,0.00
2024-12-10 17:19:59,86,3251,42,44,2369.85,3842.04,0.00
2024-12-10 17:19:59,85,3251,42,43,2397.28,3842.04,0.00
2024-12-10 17:19:59,84,3251,41,43,2425.36,3842.04,0.00
2024-12-10 17:19:59,84,3252,41,43,2427.56,3843.00,0.00
2024-12-10 17:19:59,85,3252,42,43,2399.00,3843.01,0.00
2024-12-10 17:19:59,84,3252,42,42,2426.21,3843.04,0.00
2024-12-10 17:19:59,84,3253,42,42,2427.17,3844.00,0.00
2024-12-10 17:19:59,85,3253,42,43,2398.62,3844.01,0.00
2024-12-10 17:19:59,84,3253,41,43,2425.82,3844.04,0.00
2024-12-10 17:19:59,84,3254,41,43,2427.85,3845.00,0.00
2024-12-10 17:19:59,85,3254,42,43,2399.28,3845.01,0.00
2024-12-10 17:19:59,84,3254,41,43,2426.49,3845.04,0.00
2024-12-10 17:19:59,83,3254,41,42,2445.49,3845.17,0.00
2024-12-10 17:19:59,83,3255,41,42,2460.44,3846.00,0.00
2024-12-10 17:19:59,84,3255,41,43,2431.15,3846.01,0.00
2024-12-10 17:19:59,84,3256,41,43,2439.57,3847.00,0.00
2024-12-10 17:19:59,85,3256,41,44,2410.87,3847.01,0.00
2024-12-10 17:19:59,85,3257,41,44,2418.74,3848.00,0.00
2024-12-10 17:19:59,86,3257,42,44,2390.61,3848.01,0.00
2024-12-10 17:19:59,85,3257,41,44,2417.40,3848.04,0.00
2024-12-10 17:19:59,86,3256,42,44,2382.62,3848.23,0.00
2024-12-10 17:19:59,86,3257,42,44,2401.97,3849.00,0.00
2024-12-10 17:19:59,87,3257,42,45,2374.37,3849.01,0.00
2024-12-10 17:19:59,86,3257,42,44,2400.65,3849.04,0.00
2024-12-10 17:19:59,86,3258,42,44,2453.64,3850.00,0.00
2024-12-10 17:19:59,87,3258,42,45,2425.43,3850.01,0.00
2024-12-10 17:19:59,86,3258,42,44,2445.77,3850.07,0.00
2024-12-10 17:19:59,86,3259,42,44,2455.35,3851.00,0.00
2024-12-10 17:19:59,87,3259,43,44,2427.12,3851.01,0.00
2024-12-10 17:19:59,86,3259,43,43,2449.54,3851.07,0.00
2024-12-10 17:19:59,86,3260,43,43,2459.12,3852.00,0.00
2024-12-10 17:19:59,87,3260,43,44,2430.85,3852.01,0.00
2024-12-10 17:19:59,86,3260,43,43,2457.79,3852.04,0.00
2024-12-10 17:19:59,86,3261,43,43,2466.03,3853.00,0.00
2024-12-10 17:19:59,87,3261,44,43,2437.68,3853.01,0.00
2024-12-10 17:19:59,86,3261,43,43,2464.70,3853.04,0.00
2024-12-10 17:19:59,86,3262,43,43,2463.25,3854.00,0.00
2024-12-10 17:19:59,87,3262,43,44,2434.94,3854.01,0.00
2024-12-10 17:19:59,86,3262,42,44,2448.54,3854.20,0.00
2024-12-10 17:19:59,86,3263,42,44,2462.47,3855.00,0.00
2024-12-10 17:19:59,87,3263,42,45,2434.16,3855.01,0.00
2024-12-10 17:19:59,86,3263,41,45,2461.14,3855.04,0.00
2024-12-10 17:19:59,86,3264,41,45,2468.78,3856.00,0.00
2024-12-10 17:19:59,87,3264,41,46,2440.40,3856.01,0.00
2024-12-10 17:19:59,86,3264,41,45,2462.53,3856.06,0.00
2024-12-10 17:19:59,86,3265,41,45,2470.00,3857.00,0.00
2024-12-10 17:19:59,87,3265,41,46,2441.60,3857.01,0.00
2024-12-10 17:19:59,88,3264,41,47,2410.83,3857.11,0.00
2024-12-10 17:19:59,88,3265,41,47,2406.44,3858.00,0.00
2024-12-10 17:19:59,89,3265,41,48,2379.40,3858.01,0.00
2024-12-10 17:19:59,89,3266,41,48,2366.81,3859.00,0.00
2024-12-10 17:19:59,90,3266,42,48,2340.51,3859.01,0.00
2024-12-10 17:19:59,89,3266,41,48,2355.97,3859.09,0.00
2024-12-10 17:19:59,88,3266,41,47,2338.76,3859.75,0.00
2024-12-10 17:20:00,88,3267,41,47,2356.46,3860.00,0.00
2024-12-10 17:20:00,89,3267,41,48,2329.99,3860.01,0.00
2024-12-10 17:20:00,88,3267,41,47,2316.46,3860.75,0.00
2024-12-10 17:20:00,88,3268,41,47,2350.89,3861.00,0.00
2024-12-10 17:20:00,89,3268,42,47,2324.48,3861.01,0.00
2024-12-10 17:20:00,89,3269,42,47,2321.28,3862.00,0.00
2024-12-10 17:20:00,90,3269,43,47,2295.49,3862.01,0.00
2024-12-10 17:20:00,90,3270,43,47,2294.14,3863.00,0.00
2024-12-10 17:20:00,91,3270,44,47,2268.93,3863.01,0.00
2024-12-10 17:20:00,90,3270,44,46,2291.15,3863.09,0.00
2024-12-10 17:20:00,89,3270,43,46,2304.44,3863.32,0.00
2024-12-10 17:20:00,89,3271,43,46,2311.19,3864.00,0.00
2024-12-10 17:20:00,90,3271,44,46,2285.51,3864.01,0.00
2024-12-10 17:20:00,90,3272,44,46,2276.74,3865.00,0.00
2024-12-10 17:20:00,91,3272,45,46,2251.72,3865.01,0.00
2024-12-10 17:20:00,90,3272,45,45,2245.70,3865.61,0.00
2024-12-10 17:20:00,90,3273,45,45,2270.39,3866.00,0.00
2024-12-10 17:20:00,91,3273,45,46,2245.44,3866.01,0.00
2024-12-10 17:20:00,92,3272,46,46,2212.29,3866.26,0.00
2024-12-10 17:20:00,92,3273,46,46,2247.64,3867.00,0.00
2024-12-10 17:20:00,93,3273,46,47,2223.47,3867.01,0.00
2024-12-10 17:20:00,93,3274,46,47,2263.60,3868.00,0.00
2024-12-10 17:20:00,94,3274,46,48,2239.52,3868.01,0.00
2024-12-10 17:20:00,95,3273,46,49,2191.64,3868.63,0.00
2024-12-10 17:20:00,95,3274,46,49,2228.47,3869.00,0.00
2024-12-10 17:20:00,96,3274,47,49,2205.26,3869.01,0.00
2024-12-10 17:20:00,96,3275,47,49,2240.27,3870.00,0.00
2024-12-10 17:20:00,97,3275,47,50,2217.18,3870.01,0.00
2024-12-10 17:20:00,96,3275,46,50,2237.92,3870.06,0.00
2024-12-10 17:20:00,95,3275,46,49,2250.90,3870.11,0.00
2024-12-10 17:20:00,95,3276,46,49,2247.09,3871.00,0.00
2024-12-10 17:20:00,96,3276,46,50,2223.68,3871.01,0.00
2024-12-10 17:20:00,96,3277,46,50,2204.05,3872.00,0.00
2024-12-10 17:20:00,97,3277,46,51,2181.33,3872.01,0.00
2024-12-10 17:20:00,96,3277,46,50,2165.23,3872.57,0.00
2024-12-10 17:20:00,96,3278,46,50,2178.14,3873.00,0.00
2024-12-10 17:20:00,97,3278,47,50,2155.68,3873.01,0.00
2024-12-10 17:20:00,96,3278,47,49,2171.78,3873.05,0.00
2024-12-10 17:20:00,95,3278,46,49,2158.50,3873.67,0.00
2024-12-10 17:20:00,95,3279,46,49,2186.91,3874.00,0.00
2024-12-10 17:20:00,96,3279,46,50,2164.13,3874.01,0.00
2024-12-10 17:20:00,95,3279,45,50,2184.88,3874.05,0.00
2024-12-10 17:20:00,95,3280,45,50,2182.93,3875.00,0.00
2024-12-10 17:20:00,96,3280,45,51,2160.19,3875.01,0.00
2024-12-10 17:20:00,96,3281,45,51,2157.35,3876.00,0.00
2024-12-10 17:20:00,97,3281,45,52,2135.11,3876.01,0.00
2024-12-10 17:20:00,97,3282,45,52,2130.26,3877.00,0.00
2024-12-10 17:20:00,98,3282,45,53,2108.52,3877.01,0.00
2024-12-10 17:20:00,97,3282,45,52,2129.06,3877.03,0.00
2024-12-10 17:20:00,97,3283,45,52,2122.57,3878.00,0.00
2024-12-10 17:20:00,98,3283,46,52,2100.91,3878.01,0.00
2024-12-10 17:20:00,98,3284,46,52,2089.65,3879.00,0.00
2024-12-10 17:20:00,99,3284,47,52,2068.55,3879.01,0.00
2024-12-10 17:20:00,99,3285,47,52,2054.02,3880.00,0.00
2024-12-10 17:20:00,100,3285,48,52,2033.48,3880.01,0.00
2024-12-10 17:20:00,99,3285,47,52,2032.57,3880.28,0.00
2024-12-10 17:20:00,99,3286,47,52,2039.07,3881.00,0.00
2024-12-10 17:20:00,100,3286,48,52,2018.68,3881.01,0.00
2024-12-10 17:20:00,99,3286,47,52,2008.36,3881.58,0.00
2024-12-10 17:20:00,99,3287,47,52,2030.83,3882.00,0.00
2024-12-10 17:20:00,100,3287,48,52,2010.52,3882.01,0.00
2024-12-10 17:20:00,99,3287,47,52,2029.27,3882.04,0.00
2024-12-10 17:20:00,98,3287,47,51,2024.91,3882.52,0.00
2024-12-10 17:20:00,98,3288,47,51,2046.23,3883.00,0.00
2024-12-10 17:20:00,99,3288,48,51,2025.56,3883.01,0.00
2024-12-10 17:20:00,98,3288,48,50,2035.49,3883.05,0.00
2024-12-10 17:20:00,97,3288,48,49,2051.92,3883.16,0.00
2024-12-10 17:20:00,96,3288,48,48,2068.53,3883.24,0.00
2024-12-10 17:20:00,96,3289,48,48,2079.50,3884.00,0.00
2024-12-10 17:20:00,97,3289,49,48,2058.06,3884.01,0.00
2024-12-10 17:20:00,96,3289,49,47,2060.95,3884.04,0.00
2024-12-10 17:20:00,97,3288,49,48,2036.11,3884.16,0.00
2024-12-10 17:20:00,97,3289,49,48,2075.11,3885.00,0.00
2024-12-10 17:20:00,98,3289,50,48,2053.93,3885.01,0.00
2024-12-10 17:20:00,98,3290,50,48,2092.81,3886.00,0.00
2024-12-10 17:20:00,99,3290,51,48,2071.68,3886.01,0.00
2024-12-10 17:20:00,98,3290,51,47,2091.49,3886.04,0.00
2024-12-10 17:20:00,98,3291,51,47,2091.34,3887.00,0.00
2024-12-10 17:20:00,99,3291,51,48,2070.22,3887.01,0.00
2024-12-10 17:20:00,98,3291,51,47,2089.78,3887.04,0.00
2024-12-10 17:20:00,98,3292,51,47,2088.33,3888.00,0.00
2024-12-10 17:20:00,99,3292,52,47,2067.24,3888.01,0.00
2024-12-10 17:20:01,99,3293,52,47,2064.98,3889.00,0.00
2024-12-10 17:20:01,100,3293,52,48,2044.33,3889.01,0.00
2024-12-10 17:20:01,100,3294,52,48,2041.92,3890.00,0.00
2024-12-10 17:20:01,101,3294,53,48,2021.71,3890.01,0.00
2024-12-10 17:20:01,101,3295,53,48,2018.93,3891.00,0.00
2024-12-10 17:20:01,102,3295,54,48,1999.14,3891.01,0.00
2024-12-10 17:20:01,102,3296,54,48,1995.73,3892.00,0.00
2024-12-10 17:20:01,103,3296,55,48,1976.35,3892.01,0.00
2024-12-10 17:20:01,103,3297,55,48,1972.17,3893.00,0.00
2024-12-10 17:20:01,104,3297,55,49,1953.20,3893.01,0.00
2024-12-10 17:20:01,103,3297,55,48,1955.08,3893.43,0.00
2024-12-10 17:20:01,103,3298,55,48,1969.71,3894.00,0.00
2024-12-10 17:20:01,104,3298,55,49,1950.77,3894.01,0.00
2024-12-10 17:20:01,104,3299,55,49,1949.24,3895.00,0.00
2024-12-10 17:20:01,105,3299,55,50,1930.67,3895.01,0.00
2024-12-10 17:20:01,104,3299,54,50,1947.75,3895.04,0.00
2024-12-10 17:20:01,104,3300,54,50,1947.53,3896.00,0.00
2024-12-10 17:20:01,105,3300,55,50,1928.98,3896.01,0.00
2024-12-10 17:20:01,104,3300,55,49,1946.04,3896.04,0.00
2024-12-10 17:20:01,104,3301,55,49,1938.48,3897.00,0.00
2024-12-10 17:20:01,105,3301,55,50,1920.02,3897.01,0.00
2024-12-10 17:20:01,104,3301,54,50,1936.99,3897.04,0.00
2024-12-10 17:20:01,103,3301,54,49,1931.71,3897.59,0.00
2024-12-10 17:20:01,103,3302,54,49,1953.97,3898.00,0.00
2024-12-10 17:20:01,104,3302,54,50,1935.19,3898.01,0.00
2024-12-10 17:20:01,103,3302,53,50,1952.47,3898.04,0.00
2024-12-10 17:20:01,103,3303,53,50,1950.68,3899.00,0.00
2024-12-10 17:20:01,104,3303,54,50,1931.92,3899.01,0.00
2024-12-10 17:20:01,103,3303,54,49,1949.17,3899.04,0.00
2024-12-10 17:20:01,103,3304,54,49,1946.17,3900.00,0.00
2024-12-10 17:20:01,104,3304,54,50,1927.46,3900.01,0.00
2024-12-10 17:20:01,103,3304,53,50,1944.66,3900.04,0.00
2024-12-10 17:20:01,103,3305,53,50,1939.12,3901.00,0.00
2024-12-10 17:20:01,104,3305,53,51,1920.48,3901.01,0.00
2024-12-10 17:20:01,103,3305,53,50,1937.61,3901.04,0.00
2024-12-10 17:20:01,103,3306,53,50,1931.71,3902.00,0.00
2024-12-10 17:20:01,104,3306,53,51,1913.14,3902.01,0.00
2024-12-10 17:20:01,103,3306,52,51,1910.32,3902.41,0.00
2024-12-10 17:20:01,103,3307,52,51,1922.98,3903.00,0.00
2024-12-10 17:20:01,104,3307,53,51,1904.49,3903.01,0.00
2024-12-10 17:20:01,103,3307,53,50,1906.70,3903.25,0.00
2024-12-10 17:20:01,103,3308,53,50,1912.08,3904.00,0.00
2024-12-10 17:20:01,104,3308,54,50,1893.69,3904.01,0.00
2024-12-10 17:20:01,103,3308,54,49,1910.20,3904.05,0.00
2024-12-10 17:20:01,102,3308,53,49,1922.82,3904.18,0.00
2024-12-10 17:20:01,101,3308,53,48,1934.37,3904.35,0.00
2024-12-10 17:20:01,101,3309,53,48,1945.39,3905.00,0.00
2024-12-10 17:20:01,102,3309,54,48,1926.32,3905.01,0.00
2024-12-10 17:20:01,101,3309,54,47,1943.47,3905.05,0.00
2024-12-10 17:20:01,100,3309,54,46,1949.54,3905.38,0.00
2024-12-10 17:20:01,100,3310,54,46,1964.82,3906.00,0.00
2024-12-10 17:20:01,101,3310,55,46,1945.36,3906.01,0.00
2024-12-10 17:20:01,100,3310,54,46,1962.87,3906.05,0.00
2024-12-10 17:20:01,100,3311,54,46,1965.32,3907.00,0.00
2024-12-10 17:20:01,101,3311,54,47,1945.86,3907.01,0.00
2024-12-10 17:20:01,100,3311,54,46,1963.38,3907.05,0.00
2024-12-10 17:20:01,100,3312,54,46,1965.82,3908.00,0.00
2024-12-10 17:20:01,101,3312,55,46,1946.36,3908.01,0.00
2024-12-10 17:20:01,100,3312,54,46,1963.88,3908.05,0.00
2024-12-10 17:20:01,100,3313,54,46,1966.33,3909.00,0.00
2024-12-10 17:20:01,101,3313,55,46,1946.86,3909.01,0.00
2024-12-10 17:20:01,101,3314,55,46,1946.81,3910.00,0.00
2024-12-10 17:20:01,102,3314,55,47,1927.72,3910.01,0.00
2024-12-10 17:20:01,101,3314,54,47,1944.72,3910.05,0.00
2024-12-10 17:20:01,101,3315,54,47,1945.96,3911.00,0.00
2024-12-10 17:20:01,102,3315,55,47,1926.88,3911.01,0.00
2024-12-10 17:20:01,101,3315,54,47,1940.92,3911.03,0.00
2024-12-10 17:20:01,100,3315,54,46,1959.13,3911.04,0.00
2024-12-10 17:20:01,99,3315,53,46,1969.84,3911.15,0.00
2024-12-10 17:20:01,99,3316,53,46,1975.27,3912.00,0.00
2024-12-10 17:20:01,100,3316,53,47,1955.52,3912.01,0.00
2024-12-10 17:20:01,99,3316,52,47,1972.92,3912.04,0.00
2024-12-10 17:20:01,99,3317,52,47,1973.47,3913.00,0.00
2024-12-10 17:20:01,100,3317,52,48,1953.74,3913.01,0.00
2024-12-10 17:20:01,100,3318,52,48,1950.42,3914.00,0.00
2024-12-10 17:20:01,101,3318,52,49,1931.10,3914.01,0.00
2024-12-10 17:20:01,100,3318,51,49,1946.67,3914.04,0.00
2024-12-10 17:20:01,99,3318,50,49,1957.72,3914.25,0.00
2024-12-10 17:20:01,99,3319,50,49,1964.85,3915.00,0.00
2024-12-10 17:20:01,100,3319,51,49,1945.20,3915.01,0.00
2024-12-10 17:20:01,99,3319,50,49,1950.27,3915.25,0.00
2024-12-10 17:20:01,99,3320,50,49,1959.11,3916.00,0.00
2024-12-10 17:20:01,100,3320,51,49,1939.52,3916.01,0.00
2024-12-10 17:20:01,99,3320,50,49,1958.32,3916.02,0.00
2024-12-10 17:20:01,98,3320,49,49,1975.64,3916.03,0.00
2024-12-10 17:20:01,97,3320,48,49,1995.61,3916.03,0.00
2024-12-10 17:20:01,97,3321,48,49,1995.90,3917.00,0.00
2024-12-10 17:20:01,98,3321,48,50,1975.54,3917.01,0.00
2024-12-10 17:20:01,97,3321,48,49,1995.50,3917.01,0.00
2024-12-10 17:20:01,96,3321,47,49,2014.21,3917.02,0.00
2024-12-10 17:20:01,97,3320,48,49,1988.70,3917.16,0.00
2024-12-10 17:20:02,97,3321,48,49,2026.90,3918.00,0.00
2024-12-10 17:20:02,98,3321,48,50,2006.22,3918.01,0.00
2024-12-10 17:20:02,97,3321,47,50,2024.66,3918.03,0.00
2024-12-10 17:20:02,96,3321,47,49,2045.69,3918.03,0.00
2024-12-10 17:20:02,96,3322,47,49,2080.80,3919.00,0.00
2024-12-10 17:20:02,97,3322,48,49,2059.35,3919.01,0.00
2024-12-10 17:20:02,97,3323,48,49,2046.72,3920.00,0.00
2024-12-10 17:20:02,98,3323,49,49,2025.84,3920.01,0.00
2024-12-10 17:20:02,97,3323,49,48,2024.37,3920.43,0.00
2024-12-10 17:20:02,97,3324,49,48,2040.20,3921.00,0.00
2024-12-10 17:20:02,98,3324,49,49,2019.38,3921.01,0.00
2024-12-10 17:20:02,97,3324,49,48,2034.89,3921.03,0.00
2024-12-10 17:20:02,96,3324,48,48,2055.68,3921.03,0.00
2024-12-10 17:20:02,96,3325,48,48,2053.04,3922.00,0.00
2024-12-10 17:20:02,97,3325,49,48,2031.87,3922.01,0.00
2024-12-10 17:20:02,96,3325,49,47,2049.15,3922.03,0.00
2024-12-10 17:20:02,95,3325,49,46,2047.77,3922.44,0.00
2024-12-10 17:20:02,95,3326,49,46,2067.59,3923.00,0.00
2024-12-10 17:20:02,96,3326,49,47,2046.05,3923.01,0.00
2024-12-10 17:20:02,95,3326,48,47,2065.50,3923.01,0.00
2024-12-10 17:20:02,94,3326,48,46,2086.64,3923.02,0.00
2024-12-10 17:20:02,93,3326,48,45,2106.48,3923.09,0.00
2024-12-10 17:20:02,92,3326,48,44,2119.42,3923.25,0.00
2024-12-10 17:20:02,92,3327,48,44,2133.13,3924.00,0.00
2024-12-10 17:20:02,93,3327,48,45,2110.19,3924.01,0.00
2024-12-10 17:20:02,93,3328,48,45,2114.04,3925.00,0.00
2024-12-10 17:20:02,94,3328,49,45,2091.55,3925.01,0.00
2024-12-10 17:20:02,93,3328,49,44,2113.62,3925.01,0.00
2024-12-10 17:20:02,92,3328,49,43,2136.17,3925.01,0.00
2024-12-10 17:20:02,91,3328,48,43,2159.21,3925.01,0.00
2024-12-10 17:20:02,91,3329,48,43,2162.87,3926.00,0.00
2024-12-10 17:20:02,92,3329,48,44,2139.36,3926.01,0.00
2024-12-10 17:20:02,91,3329,48,43,2162.44,3926.01,0.00
2024-12-10 17:20:02,91,3330,48,43,2164.90,3927.00,0.00
2024-12-10 17:20:02,92,3330,49,43,2141.37,3927.01,0.00
2024-12-10 17:20:02,91,3330,48,43,2164.47,3927.01,0.00
2024-12-10 17:20:02,91,3331,48,43,2166.01,3928.00,0.00
2024-12-10 17:20:02,92,3331,49,43,2142.47,3928.01,0.00
2024-12-10 17:20:02,92,3332,49,43,2142.99,3929.00,0.00
2024-12-10 17:20:02,93,3332,49,44,2119.95,3929.01,0.00
2024-12-10 17:20:02,92,3332,49,43,2142.15,3929.02,0.00
2024-12-10 17:20:02,92,3333,49,43,2142.02,3930.00,0.00
2024-12-10 17:20:02,93,3333,49,44,2118.99,3930.01,0.00
2024-12-10 17:20:02,93,3334,49,44,2116.35,3931.00,0.00
2024-12-10 17:20:02,94,3334,49,45,2093.83,3931.01,0.00
2024-12-10 17:20:02,93,3334,48,45,2115.51,3931.02,0.00
2024-12-10 17:20:02,93,3335,48,45,2112.13,3932.00,0.00
2024-12-10 17:20:02,94,3335,49,45,2089.66,3932.01,0.00
2024-12-10 17:20:02,93,3335,48,45,2111.29,3932.02,0.00
2024-12-10 17:20:02,93,3336,48,45,2106.21,3933.00,0.00
2024-12-10 17:20:02,94,3336,48,46,2083.81,3933.01,0.00
2024-12-10 17:20:02,93,3336,48,45,2105.38,3933.02,0.00
2024-12-10 17:20:02,92,3336,48,44,2095.35,3933.58,0.00
2024-12-10 17:20:02,92,3337,48,44,2121.77,3934.00,0.00
2024-12-10 17:20:02,93,3337,49,44,2098.95,3934.01,0.00
2024-12-10 17:20:02,92,3337,49,43,2102.47,3934.29,0.00
2024-12-10 17:20:02,92,3338,49,43,2114.93,3935.00,0.00
2024-12-10 17:20:02,93,3338,49,44,2092.19,3935.01,0.00
2024-12-10 17:20:02,92,3338,49,43,2105.42,3935.17,0.00
2024-12-10 17:20:02,92,3339,49,43,2112.79,3936.00,0.00
2024-12-10 17:20:02,93,3339,49,44,2090.07,3936.01,0.00
2024-12-10 17:20:02,93,3340,49,44,2089.51,3937.00,0.00
2024-12-10 17:20:02,94,3340,49,45,2067.28,3937.01,0.00
2024-12-10 17:20:02,93,3340,48,45,2088.68,3937.02,0.00
2024-12-10 17:20:02,93,3341,48,45,2087.28,3938.00,0.00
2024-12-10 17:20:02,94,3341,49,45,2065.08,3938.01,0.00
2024-12-10 17:20:02,93,3341,48,45,2060.89,3938.51,0.00
2024-12-10 17:20:02,93,3342,48,45,2084.14,3939.00,0.00
2024-12-10 17:20:02,94,3342,48,46,2061.97,3939.01,0.00
2024-12-10 17:20:02,94,3343,48,46,2061.98,3940.00,0.00
2024-12-10 17:20:02,95,3343,49,46,2040.28,3940.01,0.00
2024-12-10 17:20:02,95,3344,49,46,2040.00,3941.00,0.00
2024-12-10 17:20:02,96,3344,49,47,2018.75,3941.01,0.00
2024-12-10 17:20:02,96,3345,49,47,2017.53,3942.00,0.00
2024-12-10 17:20:02,97,3345,50,47,1996.73,3942.01,0.00
2024-12-10 17:20:02,96,3345,49,47,2016.72,3942.02,0.00
2024-12-10 17:20:02,96,3346,49,47,2014.35,3943.00,0.00
2024-12-10 17:20:02,97,3346,50,47,1993.58,3943.01,0.00
2024-12-10 17:20:02,98,3345,50,48,1969.23,3943.13,0.00
2024-12-10 17:20:02,97,3345,50,47,2024.42,3943.13,0.00
2024-12-10 17:20:02,97,3346,50,47,2025.07,3944.00,0.00
2024-12-10 17:20:02,98,3346,51,47,2004.40,3944.01,0.00
2024-12-10 17:20:02,97,3346,51,46,2024.26,3944.02,0.00
2024-12-10 17:20:02,96,3346,50,46,2031.97,3944.31,0.00
2024-12-10 17:20:02,96,3347,50,46,2085.40,3945.00,0.00
2024-12-10 17:20:02,97,3347,50,47,2063.90,3945.01,0.00
2024-12-10 17:20:02,96,3347,49,47,2076.37,3945.21,0.00
2024-12-10 17:20:02,96,3348,49,47,2083.68,3946.00,0.00
2024-12-10 17:20:02,97,3348,50,47,2062.20,3946.01,0.00
2024-12-10 17:20:02,97,3349,50,47,2060.02,3947.00,0.00
2024-12-10 17:20:02,98,3349,50,48,2039.00,3947.01,0.00
2024-12-10 17:20:02,97,3349,50,47,2059.40,3947.02,0.00
2024-12-10 17:20:02,97,3350,50,47,2055.95,3948.00,0.00
2024-12-10 17:20:02,98,3350,51,47,2034.97,3948.01,0.00
2024-12-10 17:20:02,97,3350,50,47,2055.14,3948.02,0.00
2024-12-10 17:20:02,96,3350,49,47,2076.14,3948.02,0.00
2024-12-10 17:20:02,95,3350,49,46,2096.56,3948.03,0.00
2024-12-10 17:20:02,95,3351,49,46,2091.99,3949.00,0.00
2024-12-10 17:20:02,96,3351,49,47,2070.20,3949.01,0.00
2024-12-10 17:20:02,95,3351,49,46,2091.17,3949.02,0.00
2024-12-10 17:20:03,95,3352,49,46,2084.76,3950.00,0.00
2024-12-10 17:20:03,96,3352,49,47,2063.04,3950.01,0.00
2024-12-10 17:20:03,95,3352,49,46,2076.32,3950.22,0.00
2024-12-10 17:20:03,95,3353,49,46,2080.65,3951.00,0.00
2024-12-10 17:20:03,96,3353,50,46,2058.98,3951.01,0.00
2024-12-10 17:20:03,95,3353,49,46,2079.82,3951.02,0.00
2024-12-10 17:20:03,94,3353,48,46,2092.61,3951.23,0.00
2024-12-10 17:20:03,94,3354,48,46,2097.87,3952.00,0.00
2024-12-10 17:20:03,95,3354,49,46,2075.78,3952.01,0.00
2024-12-10 17:20:03,94,3354,49,45,2097.03,3952.02,0.00
2024-12-10 17:20:03,94,3355,49,45,2088.57,3953.00,0.00
2024-12-10 17:20:03,95,3355,49,46,2066.58,3953.01,0.00
2024-12-10 17:20:03,94,3355,48,46,2087.73,3953.02,0.00
2024-12-10 17:20:03,93,3355,47,46,2095.88,3953.23,0.00
2024-12-10 17:20:03,92,3355,46,46,2107.40,3953.33,0.00
2024-12-10 17:20:03,92,3356,46,46,2121.26,3954.00,0.00
2024-12-10 17:20:03,93,3356,46,47,2098.45,3954.01,0.00
2024-12-10 17:20:03,92,3356,45,47,2109.09,3954.23,0.00
2024-12-10 17:20:03,92,3357,45,47,2118.79,3955.00,0.00
2024-12-10 17:20:03,93,3357,46,47,2096.01,3955.01,0.00
2024-12-10 17:20:03,93,3358,46,47,2096.79,3956.00,0.00
2024-12-10 17:20:03,94,3358,47,47,2074.49,3956.01,0.00
2024-12-10 17:20:03,93,3358,47,46,2095.11,3956.03,0.00
2024-12-10 17:20:03,93,3359,47,46,2096.66,3957.00,0.00
2024-12-10 17:20:03,94,3359,48,46,2074.36,3957.01,0.00
2024-12-10 17:20:03,94,3360,48,46,2074.44,3958.00,0.00
2024-12-10 17:20:03,95,3360,48,47,2052.60,3958.01,0.00
2024-12-10 17:20:03,95,3361,48,47,2050.00,3959.00,0.00
2024-12-10 17:20:03,96,3361,49,47,2028.64,3959.01,0.00
2024-12-10 17:20:03,95,3361,48,47,2048.76,3959.03,0.00
2024-12-10 17:20:03,94,3361,47,47,2069.04,3959.05,0.00
2024-12-10 17:20:03,94,3362,47,47,2067.08,3960.00,0.00
2024-12-10 17:20:03,95,3362,47,48,2045.32,3960.01,0.00
2024-12-10 17:20:03,94,3362,47,47,2065.83,3960.03,0.00
2024-12-10 17:20:03,93,3362,47,46,2084.60,3960.12,0.00
2024-12-10 17:20:03,93,3363,47,46,2081.94,3961.00,0.00
2024-12-10 17:20:03,94,3363,48,46,2059.79,3961.01,0.00
2024-12-10 17:20:03,93,3363,47,46,2080.68,3961.03,0.00
2024-12-10 17:20:03,92,3363,46,46,2090.15,3961.23,0.00
2024-12-10 17:20:03,92,3364,46,46,2094.80,3962.00,0.00
2024-12-10 17:20:03,93,3364,46,47,2072.28,3962.01,0.00
2024-12-10 17:20:03,92,3364,45,47,2076.90,3962.30,0.00
2024-12-10 17:20:03,93,3363,46,47,2053.72,3962.34,0.00
2024-12-10 17:20:03,93,3364,46,47,2093.55,3963.00,0.00
2024-12-10 17:20:03,94,3364,47,47,2071.28,3963.01,0.00
2024-12-10 17:20:03,93,3364,46,47,2092.64,3963.03,0.00
2024-12-10 17:20:03,92,3364,45,47,2100.61,3963.33,0.00
2024-12-10 17:20:03,92,3365,45,47,2160.52,3964.00,0.00
2024-12-10 17:20:03,93,3365,45,48,2137.29,3964.01,0.00
2024-12-10 17:20:03,92,3365,44,48,2159.25,3964.03,0.00
2024-12-10 17:20:03,91,3365,43,48,2180.67,3964.09,0.00
2024-12-10 17:20:03,90,3365,43,47,2193.92,3964.26,0.00
2024-12-10 17:20:03,90,3366,43,47,2208.96,3965.00,0.00
2024-12-10 17:20:03,91,3366,43,48,2184.69,3965.01,0.00
2024-12-10 17:20:03,90,3366,42,48,2207.66,3965.03,0.00
2024-12-10 17:20:03,90,3367,42,48,2213.93,3966.00,0.00
2024-12-10 17:20:03,91,3367,43,48,2189.60,3966.01,0.00
2024-12-10 17:20:03,90,3367,43,47,2212.62,3966.03,0.00
2024-12-10 17:20:03,90,3368,43,47,2218.66,3967.00,0.00
2024-12-10 17:20:03,91,3368,43,48,2194.28,3967.01,0.00
2024-12-10 17:20:03,91,3369,43,48,2198.61,3968.00,0.00
2024-12-10 17:20:03,92,3369,44,48,2174.72,3968.01,0.00
2024-12-10 17:20:03,91,3369,44,47,2197.32,3968.03,0.00
2024-12-10 17:20:03,91,3370,44,47,2200.65,3969.00,0.00
2024-12-10 17:20:03,92,3370,45,47,2176.73,3969.01,0.00
2024-12-10 17:20:03,91,3370,44,47,2199.35,3969.03,0.00
2024-12-10 17:20:03,91,3371,44,47,2201.24,3970.00,0.00
2024-12-10 17:20:03,92,3371,45,47,2177.31,3970.01,0.00
2024-12-10 17:20:03,91,3371,45,46,2199.16,3970.06,0.00
2024-12-10 17:20:03,90,3371,44,46,2217.43,3970.12,0.00
2024-12-10 17:20:03,90,3372,44,46,2225.04,3971.00,0.00
2024-12-10 17:20:03,91,3372,44,47,2200.59,3971.01,0.00
2024-12-10 17:20:03,90,3372,44,46,2223.73,3971.03,0.00
2024-12-10 17:20:03,90,3373,44,46,2226.28,3972.00,0.00
2024-12-10 17:20:03,91,3373,45,46,2201.82,3972.01,0.00
2024-12-10 17:20:03,91,3374,45,46,2200.74,3973.00,0.00
2024-12-10 17:20:03,92,3374,46,46,2176.82,3973.01,0.00
2024-12-10 17:20:03,91,3374,46,45,2194.39,3973.15,0.00
2024-12-10 17:20:03,91,3375,46,45,2198.72,3974.00,0.00
2024-12-10 17:20:03,92,3375,46,46,2174.82,3974.01,0.00
2024-12-10 17:20:03,91,3375,46,45,2197.42,3974.03,0.00
2024-12-10 17:20:03,91,3376,46,45,2193.75,3975.00,0.00
2024-12-10 17:20:03,92,3376,47,45,2169.91,3975.01,0.00
2024-12-10 17:20:03,92,3377,47,45,2161.22,3976.00,0.00
2024-12-10 17:20:03,93,3377,48,45,2137.98,3976.01,0.00
2024-12-10 17:20:03,93,3378,48,45,2125.14,3977.00,0.00
2024-12-10 17:20:03,94,3378,49,45,2102.53,3977.01,0.00
2024-12-10 17:20:03,93,3378,49,44,2123.86,3977.03,0.00
2024-12-10 17:20:03,92,3378,49,43,2109.02,3977.65,0.00
2024-12-10 17:20:03,92,3379,49,43,2133.31,3978.00,0.00
2024-12-10 17:20:03,93,3379,49,44,2110.37,3978.01,0.00
2024-12-10 17:20:03,92,3379,49,43,2116.72,3978.17,0.00
2024-12-10 17:20:03,92,3380,49,43,2117.81,3979.00,0.00
2024-12-10 17:20:03,93,3380,49,44,2095.04,3979.01,0.00
2024-12-10 17:20:03,93,3381,49,44,2084.17,3980.00,0.00
2024-12-10 17:20:03,94,3381,49,45,2062.00,3980.01,0.00
2024-12-10 17:20:03,93,3381,48,45,2082.90,3980.03,0.00
2024-12-10 17:20:03,93,3382,48,45,2068.33,3981.00,0.00
2024-12-10 17:20:03,94,3382,48,46,2046.33,3981.01,0.00
2024-12-10 17:20:03,93,3382,48,45,2062.39,3981.15,0.00
2024-12-10 17:20:04,93,3383,48,45,2050.63,3982.00,0.00
2024-12-10 17:20:04,94,3383,49,45,2028.81,3982.01,0.00
2024-12-10 17:20:04,94,3384,49,45,2004.83,3983.00,0.00
2024-12-10 17:20:04,95,3384,50,45,1983.72,3983.01,0.00
2024-12-10 17:20:04,94,3384,49,45,2003.57,3983.03,0.00
2024-12-10 17:20:04,93,3384,48,45,1986.34,3983.67,0.00
2024-12-10 17:20:04,93,3385,48,45,1994.02,3984.00,0.00
2024-12-10 17:20:04,94,3385,49,45,1972.81,3984.01,0.00
2024-12-10 17:20:04,93,3385,48,45,1992.75,3984.03,0.00
2024-12-10 17:20:04,92,3385,48,44,2013.97,3984.03,0.00
2024-12-10 17:20:04,91,3385,47,44,2012.26,3984.46,0.00
2024-12-10 17:20:04,91,3386,47,44,2005.22,3985.00,0.00
2024-12-10 17:20:04,92,3386,47,45,1983.43,3985.01,0.00
2024-12-10 17:20:04,91,3386,46,45,2003.92,3985.03,0.00
2024-12-10 17:20:04,90,3386,46,44,2022.24,3985.10,0.00
2024-12-10 17:20:04,89,3386,46,43,2003.55,3985.70,0.00
2024-12-10 17:20:04,89,3387,46,43,2018.63,3986.00,0.00
2024-12-10 17:20:04,90,3387,47,43,1996.20,3986.01,0.00
2024-12-10 17:20:04,89,3387,46,43,1980.00,3986.69,0.00
2024-12-10 17:20:04,88,3387,45,43,1985.85,3986.75,0.00
2024-12-10 17:20:04,88,3388,45,43,2016.51,3987.00,0.00
2024-12-10 17:20:04,89,3388,45,44,1993.85,3987.01,0.00
2024-12-10 17:20:04,88,3388,45,43,2015.16,3987.03,0.00
2024-12-10 17:20:04,87,3388,44,43,2020.34,3987.38,0.00
2024-12-10 17:20:04,87,3389,44,43,2027.32,3988.00,0.00
2024-12-10 17:20:04,88,3389,44,44,2004.28,3988.01,0.00
2024-12-10 17:20:04,88,3390,44,44,1995.75,3989.00,0.00
2024-12-10 17:20:04,89,3390,44,45,1973.33,3989.01,0.00
2024-12-10 17:20:04,88,3390,44,44,1994.40,3989.03,0.00
2024-12-10 17:20:04,87,3390,43,44,1976.06,3989.77,0.00
2024-12-10 17:20:04,87,3391,43,44,2012.94,3990.00,0.00
2024-12-10 17:20:04,88,3391,43,45,1990.07,3990.01,0.00
2024-12-10 17:20:04,87,3391,43,44,1985.31,3990.70,0.00
2024-12-10 17:20:04,87,3392,43,44,2019.50,3991.00,0.00
2024-12-10 17:20:04,88,3392,43,45,1996.55,3991.01,0.00
2024-12-10 17:20:04,88,3393,43,45,2002.95,3992.00,0.00
2024-12-10 17:20:04,89,3393,43,46,1980.44,3992.01,0.00
2024-12-10 17:20:04,88,3393,42,46,2001.60,3992.03,0.00
2024-12-10 17:20:04,87,3393,41,46,2015.01,3992.26,0.00
2024-12-10 17:20:04,87,3394,41,46,2031.99,3993.00,0.00
2024-12-10 17:20:04,88,3394,41,47,2008.90,3993.01,0.00
2024-12-10 17:20:04,87,3394,41,46,2030.62,3993.03,0.00
2024-12-10 17:20:04,87,3395,41,46,2038.47,3994.00,0.00
2024-12-10 17:20:04,88,3395,41,47,2015.30,3994.01,0.00
2024-12-10 17:20:04,88,3396,41,47,2021.14,3995.00,0.00
2024-12-10 17:20:04,89,3396,42,47,1998.43,3995.01,0.00
2024-12-10 17:20:04,89,3397,42,47,2002.84,3996.00,0.00
2024-12-10 17:20:04,90,3397,43,47,1980.59,3996.01,0.00
2024-12-10 17:20:04,89,3397,42,47,2001.50,3996.03,0.00
2024-12-10 17:20:04,89,3398,42,47,2004.98,3997.00,0.00
2024-12-10 17:20:04,90,3398,42,48,1982.71,3997.01,0.00
2024-12-10 17:20:04,90,3399,42,48,1983.54,3998.00,0.00
2024-12-10 17:20:04,91,3399,43,48,1961.75,3998.01,0.00
2024-12-10 17:20:04,90,3399,43,47,1982.22,3998.03,0.00
2024-12-10 17:20:04,90,3400,43,47,1982.96,3999.00,0.00
2024-12-10 17:20:04,91,3400,44,47,1961.17,3999.01,0.00
2024-12-10 17:20:04,91,3400,44,47,1959.82,4000.00,0.00
2024-12-10 17:20:04,92,3400,45,47,1938.51,4000.01,0.00
2024-12-10 17:20:04,91,3400,45,46,1944.98,4000.31,0.00
2024-12-10 17:20:04,91,3401,45,46,1959.78,4001.00,0.00
2024-12-10 17:20:04,92,3401,45,47,1938.48,4001.01,0.00
2024-12-10 17:20:04,92,3402,45,47,1941.42,4002.00,0.00
2024-12-10 17:20:04,93,3402,45,48,1920.55,4002.01,0.00
2024-12-10 17:20:04,93,3403,45,48,1923.46,4003.00,0.00
2024-12-10 17:20:04,94,3403,45,49,1903.00,4003.01,0.00
2024-12-10 17:20:04,93,3403,45,48,1903.46,4003.50,0.00
2024-12-10 17:20:04,93,3404,45,48,1926.38,4004.00,0.00
2024-12-10 17:20:04,94,3404,46,48,1905.89,4004.01,0.00
2024-12-10 17:20:04,93,3404,45,48,1925.10,4004.03,0.00
2024-12-10 17:20:04,93,3405,45,48,1929.45,4005.00,0.00
2024-12-10 17:20:04,94,3405,45,49,1908.92,4005.01,0.00
2024-12-10 17:20:04,93,3405,44,49,1928.16,4005.03,0.00
2024-12-10 17:20:04,92,3405,43,49,1927.66,4005.55,0.00
2024-12-10 17:20:04,92,3406,43,49,1953.60,4006.00,0.00
2024-12-10 17:20:04,93,3406,44,49,1932.60,4006.01,0.00
2024-12-10 17:20:04,92,3406,43,49,1952.30,4006.03,0.00
2024-12-10 17:20:04,92,3407,43,49,1957.27,4007.00,0.00
2024-12-10 17:20:04,93,3407,43,50,1936.23,4007.01,0.00
2024-12-10 17:20:04,92,3407,43,49,1955.97,4007.03,0.00
2024-12-10 17:20:04,92,3408,43,49,1960.48,4008.00,0.00
2024-12-10 17:20:04,93,3408,44,49,1939.40,4008.01,0.00
2024-12-10 17:20:04,92,3408,43,49,1959.18,4008.03,0.00
2024-12-10 17:20:04,92,3409,43,49,1963.29,4009.00,0.00
2024-12-10 17:20:04,93,3409,44,49,1942.18,4009.01,0.00
2024-12-10 17:20:04,92,3409,43,49,1961.99,4009.03,0.00
2024-12-10 17:20:04,92,3410,43,49,1966.28,4010.00,0.00
2024-12-10 17:20:04,93,3410,44,49,1945.14,4010.01,0.00
2024-12-10 17:20:04,92,3410,44,48,1964.98,4010.03,0.00
2024-12-10 17:20:04,92,3411,44,48,1968.50,4011.00,0.00
2024-12-10 17:20:04,93,3411,44,49,1947.33,4011.01,0.00
2024-12-10 17:20:04,92,3411,43,49,1967.19,4011.03,0.00
2024-12-10 17:20:05,92,3412,43,49,1968.42,4012.00,0.00
2024-12-10 17:20:05,93,3412,44,49,1947.25,4012.01,0.00
2024-12-10 17:20:05,92,3412,44,48,1967.11,4012.03,0.00
2024-12-10 17:20:05,92,3413,44,48,1966.79,4013.00,0.00
2024-12-10 17:20:05,93,3413,45,48,1945.64,4013.01,0.00
2024-12-10 17:20:05,92,3413,45,47,1965.48,4013.03,0.00
2024-12-10 17:20:05,92,3414,45,47,1963.46,4014.00,0.00
2024-12-10 17:20:05,93,3414,46,47,1942.35,4014.01,0.00
2024-12-10 17:20:05,92,3414,46,46,1962.15,4014.03,0.00
2024-12-10 17:20:05,92,3415,46,46,1959.47,4015.00,0.00
2024-12-10 17:20:05,93,3415,46,47,1938.40,4015.01,0.00
2024-12-10 17:20:05,92,3415,45,47,1958.16,4015.03,0.00
2024-12-10 17:20:05,92,3416,45,47,1954.11,4016.00,0.00
2024-12-10 17:20:05,93,3416,46,47,1933.10,4016.01,0.00
2024-12-10 17:20:05,92,3416,45,47,1952.80,4016.03,0.00
2024-12-10 17:20:05,92,3417,45,47,1947.82,4017.00,0.00
2024-12-10 17:20:05,93,3417,46,47,1926.87,4017.01,0.00
2024-12-10 17:20:05,92,3417,45,47,1947.38,4017.01,0.00
2024-12-10 17:20:05,91,3417,45,46,1967.90,4017.02,0.00
2024-12-10 17:20:05,90,3417,44,46,1989.32,4017.02,0.00
2024-12-10 17:20:05,89,3417,43,46,2007.04,4017.11,0.00
2024-12-10 17:20:05,88,3417,43,45,2021.67,4017.30,0.00
2024-12-10 17:20:05,88,3418,43,45,2032.00,4018.00,0.00
2024-12-10 17:20:05,89,3418,44,45,2009.17,4018.01,0.00
2024-12-10 17:20:05,88,3418,44,44,2031.09,4018.02,0.00
2024-12-10 17:20:05,87,3418,44,43,2048.62,4018.16,0.00
2024-12-10 17:20:05,86,3418,43,43,2061.24,4018.44,0.00
2024-12-10 17:20:05,86,3419,43,43,2079.34,4019.00,0.00
2024-12-10 17:20:05,87,3419,43,44,2055.44,4019.01,0.00
2024-12-10 17:20:05,86,3419,42,44,2078.41,4019.02,0.00
2024-12-10 17:20:05,85,3419,41,44,2074.51,4019.62,0.00
2024-12-10 17:20:05,85,3420,41,44,2106.98,4020.00,0.00
2024-12-10 17:20:05,86,3420,42,44,2082.48,4020.01,0.00
2024-12-10 17:20:05,86,3421,42,44,2090.01,4021.00,0.00
2024-12-10 17:20:05,87,3421,42,45,2065.99,4021.01,0.00
2024-12-10 17:20:05,86,3421,42,44,2089.08,4021.02,0.00
2024-12-10 17:20:05,86,3422,42,44,2097.08,4022.00,0.00
2024-12-10 17:20:05,87,3422,43,44,2072.98,4022.01,0.00
2024-12-10 17:20:05,86,3422,42,44,2096.15,4022.02,0.00
2024-12-10 17:20:05,86,3423,42,44,2104.15,4023.00,0.00
2024-12-10 17:20:05,87,3423,43,44,2079.97,4023.01,0.00
2024-12-10 17:20:05,86,3423,43,43,2103.22,4023.02,0.00
2024-12-10 17:20:05,86,3424,43,43,2111.22,4024.00,0.00
2024-12-10 17:20:05,87,3424,43,44,2086.96,4024.01,0.00
2024-12-10 17:20:05,86,3424,43,43,2110.29,4024.02,0.00
2024-12-10 17:20:05,86,3425,43,43,2118.30,4025.00,0.00
2024-12-10 17:20:05,87,3425,43,44,2093.95,4025.01,0.00
2024-12-10 17:20:05,86,3425,42,44,2117.37,4025.02,0.00
2024-12-10 17:20:05,86,3426,42,44,2125.38,4026.00,0.00
2024-12-10 17:20:05,87,3426,43,44,2100.95,4026.01,0.00
2024-12-10 17:20:05,86,3426,43,43,2124.45,4026.02,0.00
2024-12-10 17:20:05,87,3425,43,44,2094.95,4026.17,0.00
2024-12-10 17:20:05,87,3426,43,44,2146.37,4027.00,0.00
2024-12-10 17:20:05,88,3426,44,44,2121.98,4027.01,0.00
2024-12-10 17:20:05,88,3427,44,44,2174.23,4028.00,0.00
2024-12-10 17:20:05,89,3427,44,45,2149.80,4028.01,0.00
2024-12-10 17:20:05,89,3428,44,45,2154.83,4029.00,0.00
2024-12-10 17:20:05,90,3428,45,45,2130.89,4029.01,0.00
2024-12-10 17:20:05,89,3428,45,44,2153.93,4029.02,0.00
2024-12-10 17:20:05,89,3429,45,44,2158.47,4030.00,0.00
2024-12-10 17:20:05,90,3429,46,44,2134.49,4030.01,0.00
2024-12-10 17:20:05,90,3430,46,44,2137.09,4031.00,0.00
2024-12-10 17:20:05,91,3430,46,45,2113.61,4031.01,0.00
2024-12-10 17:20:05,90,3430,46,44,2136.20,4031.02,0.00
2024-12-10 17:20:05,90,3431,46,44,2137.71,4032.00,0.00
2024-12-10 17:20:05,91,3431,47,44,2114.22,4032.01,0.00
2024-12-10 17:20:05,90,3431,46,44,2136.81,4032.02,0.00
2024-12-10 17:20:05,90,3432,46,44,2136.29,4033.00,0.00
2024-12-10 17:20:05,91,3432,47,44,2112.82,4033.01,0.00
2024-12-10 17:20:05,90,3432,47,43,2135.40,4033.02,0.00
2024-12-10 17:20:05,91,3431,48,43,2079.82,4033.68,0.00
2024-12-10 17:20:05,91,3432,48,43,2123.77,4034.00,0.00
2024-12-10 17:20:05,92,3432,48,44,2100.68,4034.01,0.00
2024-12-10 17:20:05,91,3432,47,44,2095.88,4034.56,0.00
2024-12-10 17:20:05,91,3433,47,44,2163.76,4035.00,0.00
2024-12-10 17:20:05,92,3433,47,45,2140.24,4035.01,0.00
2024-12-10 17:20:05,91,3433,47,44,2162.87,4035.02,0.00
2024-12-10 17:20:05,91,3434,47,44,2165.03,4036.00,0.00
2024-12-10 17:20:05,92,3434,47,45,2141.50,4036.01,0.00
2024-12-10 17:20:05,92,3435,47,45,2142.22,4037.00,0.00
2024-12-10 17:20:05,93,3435,47,46,2119.18,4037.01,0.00
2024-12-10 17:20:05,92,3435,47,45,2141.34,4037.02,0.00
2024-12-10 17:20:05,92,3436,47,45,2140.89,4038.00,0.00
2024-12-10 17:20:05,93,3436,47,46,2117.87,4038.01,0.00
2024-12-10 17:20:05,92,3436,46,46,2140.02,4038.02,0.00
2024-12-10 17:20:05,92,3437,46,46,2137.67,4039.00,0.00
2024-12-10 17:20:05,93,3437,46,47,2114.69,4039.01,0.00
2024-12-10 17:20:05,92,3437,46,46,2136.80,4039.02,0.00
2024-12-10 17:20:05,91,3437,45,46,2149.65,4039.29,0.00
2024-12-10 17:20:05,91,3438,45,46,2157.53,4040.00,0.00
2024-12-10 17:20:05,92,3438,45,47,2134.08,4040.01,0.00
2024-12-10 17:20:05,91,3438,44,47,2156.65,4040.02,0.00
2024-12-10 17:20:05,91,3439,44,47,2153.37,4041.00,0.00
2024-12-10 17:20:05,92,3439,44,48,2129.97,4041.01,0.00
2024-12-10 17:20:05,91,3439,44,47,2152.49,4041.02,0.00
2024-12-10 17:20:05,91,3440,44,47,2147.49,4042.00,0.00
2024-12-10 17:20:05,92,3440,44,48,2124.15,4042.01,0.00
2024-12-10 17:20:05,91,3440,43,48,2146.60,4042.02,0.00
2024-12-10 17:20:05,91,3441,43,48,2140.02,4043.00,0.00
2024-12-10 17:20:05,92,3441,44,48,2116.76,4043.01,0.00
2024-12-10 17:20:05,91,3441,44,47,2139.58,4043.01,0.00
2024-12-10 17:20:05,90,3441,44,46,2162.46,4043.02,0.00
2024-12-10 17:20:05,89,3441,43,46,2157.49,4043.55,0.00
2024-12-10 17:20:06,89,3442,43,46,2185.10,4044.00,0.00
2024-12-10 17:20:06,90,3442,44,46,2160.82,4044.01,0.00
2024-12-10 17:20:06,89,3442,43,46,2184.20,4044.02,0.00
2024-12-10 17:20:06,88,3442,42,46,2184.80,4044.50,0.00
2024-12-10 17:20:06,88,3443,42,46,2210.92,4045.00,0.00
2024-12-10 17:20:06,89,3443,42,47,2186.08,4045.01,0.00
2024-12-10 17:20:06,89,3444,42,47,2189.13,4046.00,0.00
2024-12-10 17:20:06,90,3444,42,48,2164.81,4046.01,0.00
2024-12-10 17:20:06,89,3444,41,48,2188.23,4046.02,0.00
2024-12-10 17:20:06,89,3445,41,48,2190.89,4047.00,0.00
2024-12-10 17:20:06,90,3445,42,48,2166.55,4047.01,0.00
2024-12-10 17:20:06,89,3445,42,47,2178.52,4047.26,0.00
2024-12-10 17:20:06,89,3446,42,47,2193.55,4048.00,0.00
2024-12-10 17:20:06,90,3446,43,47,2169.18,4048.01,0.00
2024-12-10 17:20:06,89,3446,42,47,2192.65,4048.02,0.00
2024-12-10 17:20:06,89,3447,42,47,2198.11,4049.00,0.00
2024-12-10 17:20:06,90,3447,43,47,2173.68,4049.01,0.00
2024-12-10 17:20:06,89,3447,43,46,2197.20,4049.02,0.00
2024-12-10 17:20:06,89,3448,43,46,2202.17,4050.00,0.00
2024-12-10 17:20:06,90,3448,43,47,2177.70,4050.01,0.00
2024-12-10 17:20:06,90,3449,43,47,2180.49,4051.00,0.00
2024-12-10 17:20:06,91,3449,43,48,2156.53,4051.01,0.00
2024-12-10 17:20:06,90,3449,42,48,2179.60,4051.02,0.00
2024-12-10 17:20:06,90,3450,42,48,2183.66,4052.00,0.00
2024-12-10 17:20:06,91,3450,43,48,2159.67,4052.01,0.00
2024-12-10 17:20:06,91,3451,43,48,2162.89,4053.00,0.00
2024-12-10 17:20:06,92,3451,44,48,2139.38,4053.01,0.00
2024-12-10 17:20:06,91,3451,44,47,2162.01,4053.02,0.00
2024-12-10 17:20:06,91,3452,44,47,2165.05,4054.00,0.00
2024-12-10 17:20:06,92,3452,44,48,2141.51,4054.01,0.00
2024-12-10 17:20:06,91,3452,44,47,2164.16,4054.02,0.00
2024-12-10 17:20:06,91,3453,44,47,2167.08,4055.00,0.00
2024-12-10 17:20:06,92,3453,45,47,2143.52,4055.01,0.00
2024-12-10 17:20:06,91,3453,44,47,2166.19,4055.02,0.00
2024-12-10 17:20:06,91,3454,44,47,2169.26,4056.00,0.00
2024-12-10 17:20:06,92,3454,45,47,2145.68,4056.01,0.00
2024-12-10 17:20:06,91,3454,44,47,2168.37,4056.02,0.00
2024-12-10 17:20:06,91,3455,44,47,2171.73,4057.00,0.00
2024-12-10 17:20:06,92,3455,45,47,2148.12,4057.01,0.00
2024-12-10 17:20:06,92,3456,45,47,2151.21,4058.00,0.00
2024-12-10 17:20:06,93,3456,45,48,2128.08,4058.01,0.00
2024-12-10 17:20:06,93,3457,45,48,2130.69,4059.00,0.00
2024-12-10 17:20:06,94,3457,45,49,2108.03,4059.01,0.00
2024-12-10 17:20:06,93,3457,44,49,2129.83,4059.02,0.00
2024-12-10 17:20:06,93,3458,44,49,2132.54,4060.00,0.00
2024-12-10 17:20:06,94,3458,45,49,2109.85,4060.01,0.00
2024-12-10 17:20:06,93,3458,45,48,2131.67,4060.02,0.00
2024-12-10 17:20:06,93,3459,45,48,2134.17,4061.00,0.00
2024-12-10 17:20:06,94,3459,45,49,2111.46,4061.01,0.00
2024-12-10 17:20:06,94,3460,45,49,2111.76,4062.00,0.00
2024-12-10 17:20:06,95,3460,45,50,2089.54,4062.01,0.00
2024-12-10 17:20:06,94,3460,44,50,2110.91,4062.02,0.00
2024-12-10 17:20:06,93,3460,44,49,2115.86,4062.36,0.00
2024-12-10 17:20:06,93,3461,44,49,2133.79,4063.00,0.00
2024-12-10 17:20:06,94,3461,44,50,2111.09,4063.01,0.00
2024-12-10 17:20:06,93,3461,44,49,2123.73,4063.16,0.00
2024-12-10 17:20:06,93,3462,44,49,2133.30,4064.00,0.00
2024-12-10 17:20:06,94,3462,45,49,2110.60,4064.01,0.00
2024-12-10 17:20:06,93,3462,45,48,2132.43,4064.02,0.00
2024-12-10 17:20:06,93,3463,45,48,2135.67,4065.00,0.00
2024-12-10 17:20:06,94,3463,46,48,2112.95,4065.01,0.00
2024-12-10 17:20:06,93,3463,46,47,2134.80,4065.02,0.00
2024-12-10 17:20:06,93,3464,46,47,2137.27,4066.00,0.00
2024-12-10 17:20:06,94,3464,47,47,2114.54,4066.01,0.00
2024-12-10 17:20:06,93,3464,46,47,2136.40,4066.02,0.00
2024-12-10 17:20:06,93,3465,46,47,2138.02,4067.00,0.00
2024-12-10 17:20:06,94,3465,47,47,2115.28,4067.01,0.00
2024-12-10 17:20:06,93,3465,47,46,2137.15,4067.02,0.00
2024-12-10 17:20:06,93,3466,47,46,2137.92,4068.00,0.00
2024-12-10 17:20:06,94,3466,47,47,2115.18,4068.01,0.00
2024-12-10 17:20:06,93,3466,47,46,2125.06,4068.26,0.00
2024-12-10 17:20:06,93,3467,47,46,2139.10,4069.00,0.00
2024-12-10 17:20:06,94,3467,48,46,2116.34,4069.01,0.00
2024-12-10 17:20:06,94,3468,48,46,2119.78,4070.00,0.00
2024-12-10 17:20:06,95,3468,48,47,2097.46,4070.01,0.00
2024-12-10 17:20:06,94,3468,47,47,2118.92,4070.02,0.00
2024-12-10 17:20:06,94,3469,47,47,2121.54,4071.00,0.00
2024-12-10 17:20:06,95,3469,47,48,2099.20,4071.01,0.00
2024-12-10 17:20:06,94,3469,47,47,2120.68,4071.02,0.00
2024-12-10 17:20:06,94,3470,47,47,2122.31,4072.00,0.00
2024-12-10 17:20:06,95,3470,47,48,2099.97,4072.01,0.00
2024-12-10 17:20:06,94,3470,46,48,2121.45,4072.02,0.00
2024-12-10 17:20:06,94,3471,46,48,2122.74,4073.00,0.00
2024-12-10 17:20:06,95,3471,47,48,2100.40,4073.01,0.00
2024-12-10 17:20:06,95,3472,47,48,2100.91,4074.00,0.00
2024-12-10 17:20:06,96,3472,47,49,2079.03,4074.01,0.00
2024-12-10 17:20:06,95,3472,47,48,2100.06,4074.02,0.00
2024-12-10 17:20:06,94,3472,47,47,2116.70,4074.16,0.00
2024-12-10 17:20:06,94,3473,47,47,2123.93,4075.00,0.00
2024-12-10 17:20:06,95,3473,47,48,2101.57,4075.01,0.00
2024-12-10 17:20:06,94,3473,46,48,2123.07,4075.02,0.00
2024-12-10 17:20:06,94,3474,46,48,2124.69,4076.00,0.00
2024-12-10 17:20:06,95,3474,47,48,2102.33,4076.01,0.00
2024-12-10 17:20:06,94,3474,46,48,2123.83,4076.02,0.00
2024-12-10 17:20:07,94,3475,46,48,2125.82,4077.00,0.00
2024-12-10 17:20:07,95,3475,47,48,2103.44,4077.01,0.00
2024-12-10 17:20:07,94,3475,46,48,2124.96,4077.02,0.00
2024-12-10 17:20:07,95,3474,46,49,2100.36,4077.10,0.00
2024-12-10 17:20:07,95,3475,46,49,2144.08,4078.00,0.00
2024-12-10 17:20:07,96,3475,46,50,2121.74,4078.01,0.00
2024-12-10 17:20:07,95,3475,45,50,2132.01,4078.30,0.00
2024-12-10 17:20:07,95,3476,45,50,2189.58,4079.00,0.00
2024-12-10 17:20:07,96,3476,45,51,2166.77,4079.01,0.00
2024-12-10 17:20:07,97,3475,46,51,2144.43,4079.03,0.00
2024-12-10 17:20:07,96,3475,46,50,2188.45,4079.03,0.00
2024-12-10 17:20:07,96,3476,46,50,2191.95,4080.00,0.00
2024-12-10 17:20:07,97,3476,47,50,2169.36,4080.01,0.00
2024-12-10 17:20:07,96,3476,47,49,2191.11,4080.02,0.00
2024-12-10 17:20:07,96,3477,47,49,2236.44,4081.00,0.00
2024-12-10 17:20:07,97,3477,47,50,2213.39,4081.01,0.00
2024-12-10 17:20:07,97,3478,47,50,2214.51,4082.00,0.00
2024-12-10 17:20:07,98,3478,47,51,2191.91,4082.01,0.00
2024-12-10 17:20:07,97,3478,46,51,2213.67,4082.02,0.00
2024-12-10 17:20:07,97,3479,46,51,2215.49,4083.00,0.00
2024-12-10 17:20:07,98,3479,46,52,2192.88,4083.01,0.00
2024-12-10 17:20:07,97,3479,45,52,2214.83,4083.02,0.00
2024-12-10 17:20:07,97,3480,45,52,2217.09,4084.00,0.00
2024-12-10 17:20:07,98,3480,45,53,2194.47,4084.01,0.00
2024-12-10 17:20:07,97,3480,44,53,2216.26,4084.02,0.00
2024-12-10 17:20:07,97,3481,44,53,2218.48,4085.00,0.00
2024-12-10 17:20:07,98,3481,45,53,2195.84,4085.01,0.00
2024-12-10 17:20:07,98,3482,45,53,2196.07,4086.00,0.00
2024-12-10 17:20:07,99,3482,45,54,2173.89,4086.01,0.00
2024-12-10 17:20:07,99,3483,45,54,2172.10,4087.00,0.00
2024-12-10 17:20:07,100,3483,46,54,2150.38,4087.01,0.00
2024-12-10 17:20:07,99,3483,46,53,2170.88,4087.03,0.00
2024-12-10 17:20:07,99,3484,46,53,2168.54,4088.00,0.00
2024-12-10 17:20:07,100,3484,47,53,2146.85,4088.01,0.00
2024-12-10 17:20:07,99,3484,47,52,2167.32,4088.03,0.00
2024-12-10 17:20:07,99,3485,47,52,2162.49,4089.00,0.00
2024-12-10 17:20:07,100,3485,48,52,2140.87,4089.01,0.00
2024-12-10 17:20:07,99,3485,48,51,2161.27,4089.03,0.00
2024-12-10 17:20:07,98,3485,47,51,2179.58,4089.08,0.00
2024-12-10 17:20:07,97,3485,47,50,2192.96,4089.18,0.00
2024-12-10 17:20:07,97,3486,47,50,2199.44,4090.00,0.00
2024-12-10 17:20:07,98,3486,47,51,2177.00,4090.01,0.00
2024-12-10 17:20:07,97,3486,47,50,2198.19,4090.03,0.00
2024-12-10 17:20:07,97,3487,47,50,2194.51,4091.00,0.00
2024-12-10 17:20:07,98,3487,48,50,2172.12,4091.01,0.00
2024-12-10 17:20:07,97,3487,47,50,2186.34,4091.14,0.00
2024-12-10 17:20:07,97,3488,47,50,2189.33,4092.00,0.00
2024-12-10 17:20:07,98,3488,47,51,2166.99,4092.01,0.00
2024-12-10 17:20:07,97,3488,47,50,2188.08,4092.03,0.00
2024-12-10 17:20:07,97,3489,47,50,2183.54,4093.00,0.00
2024-12-10 17:20:07,98,3489,48,50,2161.26,4093.01,0.00
2024-12-10 17:20:07,97,3489,48,49,2182.29,4093.03,0.00
2024-12-10 17:20:07,96,3489,48,48,2185.16,4093.39,0.00
2024-12-10 17:20:07,96,3490,48,48,2202.22,4094.00,0.00
2024-12-10 17:20:07,97,3490,49,48,2179.51,4094.01,0.00
2024-12-10 17:20:07,96,3490,49,47,2200.96,4094.03,0.00
2024-12-10 17:20:07,95,3490,49,46,2208.94,4094.27,0.00
2024-12-10 17:20:07,95,3491,49,46,2221.96,4095.00,0.00
2024-12-10 17:20:07,96,3491,49,47,2198.82,4095.01,0.00
2024-12-10 17:20:07,95,3491,49,46,2219.70,4095.06,0.00
2024-12-10 17:20:07,94,3491,49,45,2233.65,4095.20,0.00
2024-12-10 17:20:07,94,3492,49,45,2244.34,4096.00,0.00
2024-12-10 17:20:07,95,3492,50,45,2220.71,4096.01,0.00
2024-12-10 17:20:07,94,3492,49,45,2243.05,4096.03,0.00
2024-12-10 17:20:07,94,3493,49,45,2243.29,4097.00,0.00
2024-12-10 17:20:07,95,3493,49,46,2219.68,4097.01,0.00
2024-12-10 17:20:07,96,3492,50,46,2164.52,4097.69,0.00
2024-12-10 17:20:07,96,3493,50,46,2206.62,4098.00,0.00
2024-12-10 17:20:07,97,3493,50,47,2183.87,4098.01,0.00
2024-12-10 17:20:07,96,3493,50,46,2189.16,4098.34,0.00
2024-12-10 17:20:07,96,3494,50,46,2248.10,4099.00,0.00
2024-12-10 17:20:07,97,3494,51,46,2224.93,4099.01,0.00
2024-12-10 17:20:07,96,3494,50,46,2246.84,4099.03,0.00
2024-12-10 17:20:07,96,3495,50,46,2250.36,4100.00,0.00
2024-12-10 17:20:07,97,3495,51,46,2227.16,4100.01,0.00
2024-12-10 17:20:07,97,3496,51,46,2227.99,4101.00,0.00
2024-12-10 17:20:07,98,3496,51,47,2205.25,4101.01,0.00
2024-12-10 17:20:07,97,3496,51,46,2226.73,4101.03,0.00
2024-12-10 17:20:07,97,3497,51,46,2228.43,4102.00,0.00
2024-12-10 17:20:07,98,3497,52,46,2205.70,4102.01,0.00
2024-12-10 17:20:07,98,3498,52,46,2207.10,4103.00,0.00
2024-12-10 17:20:07,99,3498,53,46,2184.80,4103.01,0.00
2024-12-10 17:20:07,99,3499,53,46,2184.99,4104.00,0.00
2024-12-10 17:20:07,100,3499,54,46,2163.14,4104.01,0.00
2024-12-10 17:20:07,100,3500,54,46,2162.98,4105.00,0.00
2024-12-10 17:20:07,101,3500,55,46,2141.56,4105.01,0.00
2024-12-10 17:20:07,100,3500,55,45,2161.76,4105.03,0.00
2024-12-10 17:20:07,100,3501,55,45,2162.43,4106.00,0.00
2024-12-10 17:20:07,101,3501,55,46,2141.02,4106.01,0.00
2024-12-10 17:20:07,100,3501,54,46,2161.21,4106.03,0.00
2024-12-10 17:20:07,100,3502,54,46,2160.28,4107.00,0.00
2024-12-10 17:20:07,101,3502,54,47,2138.89,4107.01,0.00
2024-12-10 17:20:07,100,3502,54,46,2159.06,4107.03,0.00
2024-12-10 17:20:08,100,3503,54,46,2155.25,4108.00,0.00
2024-12-10 17:20:08,101,3503,55,46,2133.91,4108.01,0.00
2024-12-10 17:20:08,100,3503,54,46,2154.03,4108.03,0.00
2024-12-10 17:20:08,99,3503,53,46,2173.55,4108.05,0.00
2024-12-10 17:20:08,99,3504,53,46,2169.36,4109.00,0.00
2024-12-10 17:20:08,100,3504,53,47,2147.67,4109.01,0.00
2024-12-10 17:20:08,99,3504,52,47,2164.42,4109.12,0.00
2024-12-10 17:20:08,98,3504,51,47,2182.25,4109.15,0.00
2024-12-10 17:20:08,98,3505,51,47,2181.95,4110.00,0.00
2024-12-10 17:20:08,99,3505,52,47,2159.91,4110.01,0.00
2024-12-10 17:20:08,98,3505,51,47,2180.70,4110.03,0.00
2024-12-10 17:20:08,98,3506,51,47,2170.91,4111.00,0.00
2024-12-10 17:20:08,99,3506,51,48,2148.98,4111.01,0.00
2024-12-10 17:20:08,99,3507,51,48,2135.84,4112.00,0.00
2024-12-10 17:20:08,100,3507,52,48,2114.48,4112.01,0.00
2024-12-10 17:20:08,99,3507,51,48,2134.61,4112.03,0.00
2024-12-10 17:20:08,98,3507,51,47,2148.80,4112.20,0.00
2024-12-10 17:20:08,99,3506,51,48,2118.89,4112.31,0.00
2024-12-10 17:20:08,99,3507,51,48,2153.56,4113.00,0.00
2024-12-10 17:20:08,100,3507,51,49,2132.02,4113.01,0.00
2024-12-10 17:20:08,99,3507,50,49,2140.86,4113.26,0.00
2024-12-10 17:20:08,99,3508,50,49,2184.40,4114.00,0.00
2024-12-10 17:20:08,100,3508,51,49,2162.56,4114.01,0.00
2024-12-10 17:20:08,99,3508,50,49,2171.04,4114.26,0.00
2024-12-10 17:20:08,99,3509,50,49,2175.51,4115.00,0.00
2024-12-10 17:20:08,100,3509,51,49,2153.75,4115.01,0.00
2024-12-10 17:20:08,99,3509,51,48,2174.27,4115.03,0.00
2024-12-10 17:20:08,98,3509,51,47,2173.08,4115.43,0.00
2024-12-10 17:20:08,98,3510,51,47,2188.25,4116.00,0.00
2024-12-10 17:20:08,99,3510,51,48,2166.15,4116.01,0.00
2024-12-10 17:20:08,98,3510,50,48,2187.01,4116.03,0.00
2024-12-10 17:20:08,97,3510,50,47,2205.76,4116.11,0.00
2024-12-10 17:20:08,96,3510,49,47,2227.42,4116.12,0.00
2024-12-10 17:20:08,95,3510,49,46,2229.88,4116.54,0.00
2024-12-10 17:20:08,95,3511,49,46,2254.51,4117.00,0.00
2024-12-10 17:20:08,96,3511,49,47,2231.03,4117.01,0.00
2024-12-10 17:20:08,95,3511,48,47,2253.23,4117.03,0.00
2024-12-10 17:20:08,95,3512,48,47,2256.10,4118.00,0.00
2024-12-10 17:20:08,96,3512,48,48,2232.60,4118.01,0.00
2024-12-10 17:20:08,95,3512,47,48,2254.81,4118.03,0.00
2024-12-10 17:20:08,95,3513,47,48,2256.64,4119.00,0.00
2024-12-10 17:20:08,96,3513,47,49,2233.13,4119.01,0.00
2024-12-10 17:20:08,95,3513,47,48,2255.35,4119.03,0.00
2024-12-10 17:20:08,94,3513,46,48,2272.61,4119.12,0.00
2024-12-10 17:20:08,94,3514,46,48,2280.60,4120.00,0.00
2024-12-10 17:20:08,95,3514,47,48,2256.59,4120.01,0.00
2024-12-10 17:20:08,94,3514,46,48,2279.29,4120.03,0.00
2024-12-10 17:20:08,94,3515,46,48,2283.78,4121.00,0.00
2024-12-10 17:20:08,95,3515,46,49,2259.74,4121.01,0.00
2024-12-10 17:20:08,95,3516,46,49,2262.89,4122.00,0.00
2024-12-10 17:20:08,96,3516,46,50,2239.32,4122.01,0.00
2024-12-10 17:20:08,95,3516,45,50,2261.60,4122.03,0.00
2024-12-10 17:20:08,95,3517,45,50,2265.61,4123.00,0.00
2024-12-10 17:20:08,96,3517,45,51,2242.01,4123.01,0.00
2024-12-10 17:20:08,96,3518,45,51,2244.70,4124.00,0.00
2024-12-10 17:20:08,97,3518,46,51,2221.56,4124.01,0.00
2024-12-10 17:20:08,96,3518,46,50,2243.43,4124.03,0.00
2024-12-10 17:20:08,96,3519,46,50,2246.97,4125.00,0.00
2024-12-10 17:20:08,97,3519,46,51,2223.80,4125.01,0.00
2024-12-10 17:20:08,96,3519,46,50,2245.69,4125.03,0.00
2024-12-10 17:20:08,96,3520,46,50,2248.41,4126.00,0.00
2024-12-10 17:20:08,97,3520,47,50,2225.23,4126.01,0.00
2024-12-10 17:20:08,96,3520,46,50,2247.13,4126.03,0.00
2024-12-10 17:20:08,95,3520,46,49,2268.27,4126.04,0.00
2024-12-10 17:20:08,95,3521,46,49,2272.68,4127.00,0.00
2024-12-10 17:20:08,96,3521,46,50,2249.01,4127.01,0.00
2024-12-10 17:20:08,95,3521,45,50,2270.92,4127.05,0.00
2024-12-10 17:20:08,95,3522,45,50,2275.61,4128.00,0.00
2024-12-10 17:20:08,96,3522,46,50,2251.91,4128.01,0.00
2024-12-10 17:20:08,96,3523,46,50,2254.60,4129.00,0.00
2024-12-10 17:20:08,97,3523,47,50,2231.36,4129.01,0.00
2024-12-10 17:20:08,97,3524,47,50,2233.60,4130.00,0.00
2024-12-10 17:20:08,98,3524,47,51,2210.81,4130.01,0.00
2024-12-10 17:20:08,97,3524,46,51,2232.34,4130.03,0.00
2024-12-10 17:20:08,97,3525,46,51,2235.42,4131.00,0.00
2024-12-10 17:20:08,98,3525,46,52,2212.61,4131.01,0.00
2024-12-10 17:20:08,98,3526,46,52,2214.41,4132.00,0.00
2024-12-10 17:20:08,99,3526,46,53,2192.04,4132.01,0.00
2024-12-10 17:20:08,98,3526,45,53,2213.16,4132.03,0.00
2024-12-10 17:20:08,98,3527,45,53,2215.28,4133.00,0.00
2024-12-10 17:20:08,99,3527,45,54,2192.91,4133.01,0.00
2024-12-10 17:20:08,99,3528,45,54,2193.01,4134.00,0.00
2024-12-10 17:20:08,100,3528,45,55,2171.08,4134.01,0.00
2024-12-10 17:20:08,100,3529,45,55,2170.36,4135.00,0.00
2024-12-10 17:20:08,101,3529,46,55,2148.87,4135.01,0.00
2024-12-10 17:20:08,101,3530,46,55,2147.33,4136.00,0.00
2024-12-10 17:20:08,102,3530,46,56,2126.28,4136.01,0.00
2024-12-10 17:20:08,101,3530,46,55,2146.11,4136.03,0.00
2024-12-10 17:20:08,101,3531,46,55,2145.17,4137.00,0.00
2024-12-10 17:20:08,102,3531,47,55,2124.14,4137.01,0.00
2024-12-10 17:20:08,102,3532,47,55,2121.95,4138.00,0.00
2024-12-10 17:20:08,103,3532,47,56,2101.35,4138.01,0.00
2024-12-10 17:20:08,102,3532,47,55,2120.74,4138.03,0.00
2024-12-10 17:20:08,102,3533,47,55,2118.62,4139.00,0.00
2024-12-10 17:20:08,103,3533,47,56,2098.05,4139.01,0.00
2024-12-10 17:20:08,102,3533,47,55,2117.41,4139.03,0.00
2024-12-10 17:20:09,102,3534,47,55,2113.40,4140.00,0.00
2024-12-10 17:20:09,103,3534,47,56,2092.88,4140.01,0.00
2024-12-10 17:20:09,102,3534,47,55,2112.19,4140.03,0.00
2024-12-10 17:20:09,101,3534,46,55,2109.81,4140.47,0.00
2024-12-10 17:20:09,101,3535,46,55,2129.05,4141.00,0.00
2024-12-10 17:20:09,102,3535,47,55,2108.18,4141.01,0.00
2024-12-10 17:20:09,101,3535,47,54,2127.83,4141.03,0.00
2024-12-10 17:20:09,101,3536,47,54,2125.27,4142.00,0.00
2024-12-10 17:20:09,102,3536,47,55,2104.44,4142.01,0.00
2024-12-10 17:20:09,101,3536,47,54,2124.05,4142.03,0.00
2024-12-10 17:20:09,100,3536,47,53,2138.16,4142.19,0.00
2024-12-10 17:20:09,100,3537,47,53,2146.52,4143.00,0.00
2024-12-10 17:20:09,101,3537,48,53,2125.27,4143.01,0.00
2024-12-10 17:20:09,101,3538,48,53,2125.07,4144.00,0.00
2024-12-10 17:20:09,102,3538,48,54,2104.24,4144.01,0.00
2024-12-10 17:20:09,101,3538,48,53,2118.79,4144.16,0.00
2024-12-10 17:20:09,101,3539,48,53,2125.44,4145.00,0.00
2024-12-10 17:20:09,102,3539,48,54,2104.60,4145.01,0.00
2024-12-10 17:20:09,101,3539,48,53,2124.22,4145.03,0.00
2024-12-10 17:20:09,101,3540,48,53,2125.54,4146.00,0.00
2024-12-10 17:20:09,102,3540,49,53,2104.70,4146.01,0.00
2024-12-10 17:20:09,102,3541,49,53,2104.80,4147.00,0.00
2024-12-10 17:20:09,103,3541,50,53,2084.37,4147.01,0.00
2024-12-10 17:20:09,102,3541,49,53,2103.19,4147.04,0.00
2024-12-10 17:20:09,102,3542,49,53,2104.50,4148.00,0.00
2024-12-10 17:20:09,103,3542,50,53,2084.07,4148.01,0.00
2024-12-10 17:20:09,102,3542,49,53,2102.88,4148.04,0.00
2024-12-10 17:20:09,102,3543,49,53,2104.07,4149.00,0.00
2024-12-10 17:20:09,103,3543,49,54,2083.65,4149.01,0.00
2024-12-10 17:20:09,102,3543,48,54,2102.46,4149.04,0.00
2024-12-10 17:20:09,102,3544,48,54,2103.74,4150.00,0.00
2024-12-10 17:20:09,103,3544,49,54,2083.31,4150.01,0.00
2024-12-10 17:20:09,102,3544,49,53,2102.12,4150.04,0.00
2024-12-10 17:20:09,102,3545,49,53,2103.43,4151.00,0.00
2024-12-10 17:20:09,103,3545,50,53,2083.01,4151.01,0.00
2024-12-10 17:20:09,102,3545,50,52,2101.81,4151.04,0.00
2024-12-10 17:20:09,102,3546,50,52,2103.12,4152.00,0.00
2024-12-10 17:20:09,103,3546,51,52,2082.70,4152.01,0.00
2024-12-10 17:20:09,102,3546,50,52,2101.50,4152.04,0.00
2024-12-10 17:20:09,102,3547,50,52,2102.81,4153.00,0.00
2024-12-10 17:20:09,103,3547,51,52,2082.40,4153.01,0.00
2024-12-10 17:20:09,102,3547,50,52,2101.20,4153.04,0.00
2024-12-10 17:20:09,102,3548,50,52,2102.51,4154.00,0.00
2024-12-10 17:20:09,103,3548,50,53,2082.09,4154.01,0.00
2024-12-10 17:20:09,102,3548,50,52,2100.89,4154.04,0.00
2024-12-10 17:20:09,103,3547,51,52,2077.67,4154.13,0.00
2024-12-10 17:20:09,103,3548,51,52,2117.69,4155.00,0.00
2024-12-10 17:20:09,104,3548,51,53,2097.33,4155.01,0.00
2024-12-10 17:20:09,103,3548,50,53,2116.09,4155.04,0.00
2024-12-10 17:20:09,103,3549,50,53,2157.34,4156.00,0.00
2024-12-10 17:20:09,104,3549,50,54,2136.59,4156.01,0.00
2024-12-10 17:20:09,103,3549,49,54,2155.73,4156.04,0.00
2024-12-10 17:20:09,103,3550,49,54,2156.65,4157.00,0.00
2024-12-10 17:20:09,104,3550,49,55,2135.91,4157.01,0.00
2024-12-10 17:20:09,103,3550,48,55,2155.04,4157.04,0.00
2024-12-10 17:20:09,103,3551,48,55,2155.48,4158.00,0.00
2024-12-10 17:20:09,104,3551,48,56,2134.75,4158.01,0.00
2024-12-10 17:20:09,104,3552,48,56,2133.22,4159.00,0.00
2024-12-10 17:20:09,105,3552,48,57,2112.91,4159.01,0.00
2024-12-10 17:20:09,104,3552,48,56,2131.63,4159.04,0.00
2024-12-10 17:20:09,104,3553,48,56,2131.18,4160.00,0.00
2024-12-10 17:20:09,105,3553,48,57,2110.89,4160.01,0.00
2024-12-10 17:20:09,104,3553,47,57,2129.59,4160.04,0.00
2024-12-10 17:20:09,104,3554,47,57,2129.01,4161.00,0.00
2024-12-10 17:20:09,105,3554,47,58,2108.73,4161.01,0.00
2024-12-10 17:20:09,105,3555,47,58,2106.17,4162.00,0.00
2024-12-10 17:20:09,106,3555,47,59,2086.30,4162.01,0.00
2024-12-10 17:20:09,106,3556,47,59,2082.25,4163.00,0.00
2024-12-10 17:20:09,107,3556,48,59,2062.79,4163.01,0.00
2024-12-10 17:20:09,106,3556,48,58,2080.69,4163.04,0.00
2024-12-10 17:20:09,106,3557,48,58,2076.93,4164.00,0.00
2024-12-10 17:20:09,107,3557,49,58,2057.52,4164.01,0.00
2024-12-10 17:20:09,106,3557,48,58,2075.37,4164.04,0.00
2024-12-10 17:20:09,105,3557,48,57,2078.90,4164.36,0.00
2024-12-10 17:20:09,105,3558,48,57,2092.42,4165.00,0.00
2024-12-10 17:20:09,106,3558,49,57,2072.68,4165.01,0.00
2024-12-10 17:20:09,106,3559,49,57,2071.21,4166.00,0.00
2024-12-10 17:20:09,107,3559,50,57,2051.85,4166.01,0.00
2024-12-10 17:20:09,106,3559,49,57,2069.26,4166.05,0.00
2024-12-10 17:20:09,106,3560,49,57,2069.35,4167.00,0.00
2024-12-10 17:20:09,107,3560,49,58,2050.01,4167.01,0.00
2024-12-10 17:20:09,106,3560,48,58,2067.40,4167.05,0.00
2024-12-10 17:20:10,106,3561,48,58,2067.48,4168.00,0.00
2024-12-10 17:20:10,107,3561,49,58,2048.16,4168.01,0.00
2024-12-10 17:20:10,107,3562,49,58,2046.32,4169.00,0.00
2024-12-10 17:20:10,108,3562,50,58,2027.37,4169.01,0.00
2024-12-10 17:20:10,107,3562,49,58,2043.99,4169.06,0.00
2024-12-10 17:20:10,107,3563,49,58,2044.08,4170.00,0.00
2024-12-10 17:20:10,108,3563,50,58,2025.15,4170.01,0.00
2024-12-10 17:20:10,107,3563,50,57,2041.76,4170.06,0.00
2024-12-10 17:20:10,107,3564,50,57,2041.84,4171.00,0.00
2024-12-10 17:20:10,108,3564,51,57,2022.93,4171.01,0.00
2024-12-10 17:20:10,107,3564,51,56,2039.52,4171.06,0.00
2024-12-10 17:20:10,107,3565,51,56,2039.60,4172.00,0.00
2024-12-10 17:20:10,108,3565,52,56,2020.71,4172.01,0.00
2024-12-10 17:20:10,107,3565,52,55,2037.28,4172.06,0.00
2024-12-10 17:20:10,107,3566,52,55,2037.36,4173.00,0.00
2024-12-10 17:20:10,108,3566,52,56,2018.49,4173.01,0.00
2024-12-10 17:20:10,107,3566,51,56,2035.03,4173.06,0.00
2024-12-10 17:20:10,107,3567,51,56,2035.12,4174.00,0.00
2024-12-10 17:20:10,108,3567,52,56,2016.27,4174.01,0.00
2024-12-10 17:20:10,107,3567,52,55,2032.79,4174.06,0.00
2024-12-10 17:20:10,107,3568,52,55,2032.87,4175.00,0.00
2024-12-10 17:20:10,108,3568,53,55,2014.05,4175.01,0.00
2024-12-10 17:20:10,108,3569,53,55,2011.83,4176.00,0.00
2024-12-10 17:20:10,109,3569,53,56,1993.37,4176.01,0.00
2024-12-10 17:20:10,108,3569,52,56,2009.52,4176.06,0.00
2024-12-10 17:20:10,108,3570,52,56,2009.21,4177.00,0.00
2024-12-10 17:20:10,109,3570,53,56,1990.78,4177.01,0.00
2024-12-10 17:20:10,108,3570,53,55,2008.44,4177.02,0.00
2024-12-10 17:20:10,107,3570,52,55,2025.66,4177.05,0.00
2024-12-10 17:20:10,106,3570,52,54,2044.38,4177.05,0.00
2024-12-10 17:20:10,106,3571,52,54,2044.46,4178.00,0.00
2024-12-10 17:20:10,107,3571,53,54,2025.35,4178.01,0.00
2024-12-10 17:20:10,106,3571,53,53,2042.50,4178.05,0.00
2024-12-10 17:20:10,106,3572,53,53,2042.58,4179.00,0.00
2024-12-10 17:20:10,107,3572,53,54,2023.49,4179.01,0.00
2024-12-10 17:20:10,106,3572,52,54,2042.19,4179.01,0.00
2024-12-10 17:20:10,105,3572,52,53,2060.06,4179.04,0.00
2024-12-10 17:20:10,104,3572,51,53,2079.47,4179.04,0.00
2024-12-10 17:20:10,104,3573,51,53,2079.92,4180.00,0.00
2024-12-10 17:20:10,105,3573,51,54,2060.11,4180.01,0.00
2024-12-10 17:20:10,104,3573,50,54,2078.32,4180.04,0.00
2024-12-10 17:20:10,104,3574,50,54,2078.32,4181.00,0.00
2024-12-10 17:20:10,105,3574,51,54,2058.52,4181.01,0.00
2024-12-10 17:20:10,104,3574,51,53,2076.72,4181.04,0.00
2024-12-10 17:20:10,104,3575,51,53,2075.42,4182.00,0.00
2024-12-10 17:20:10,105,3575,51,54,2055.65,4182.01,0.00
2024-12-10 17:20:10,104,3575,51,53,2073.82,4182.04,0.00
2024-12-10 17:20:10,103,3575,50,53,2090.04,4182.09,0.00
2024-12-10 17:20:10,103,3576,50,53,2091.91,4183.00,0.00
2024-12-10 17:20:10,104,3576,50,54,2071.79,4183.01,0.00
2024-12-10 17:20:10,103,3576,50,53,2090.29,4183.04,0.00
2024-12-10 17:20:10,103,3577,50,53,2090.14,4184.00,0.00
2024-12-10 17:20:10,104,3577,51,53,2070.04,4184.01,0.00
2024-12-10 17:20:10,103,3577,51,52,2088.53,4184.04,0.00
2024-12-10 17:20:10,103,3578,51,52,2088.51,4185.00,0.00
2024-12-10 17:20:10,104,3578,51,53,2068.43,4185.01,0.00
2024-12-10 17:20:10,103,3578,50,53,2086.90,4185.04,0.00
2024-12-10 17:20:10,103,3579,50,53,2087.15,4186.00,0.00
2024-12-10 17:20:10,104,3579,50,54,2067.08,4186.01,0.00
2024-12-10 17:20:10,103,3579,50,53,2085.53,4186.04,0.00
2024-12-10 17:20:10,103,3580,50,53,2085.97,4187.00,0.00
2024-12-10 17:20:10,104,3580,51,53,2065.91,4187.01,0.00
2024-12-10 17:20:10,104,3581,51,53,2064.84,4188.00,0.00
2024-12-10 17:20:10,105,3581,52,53,2045.18,4188.01,0.00
2024-12-10 17:20:10,104,3581,51,53,2063.24,4188.04,0.00
2024-12-10 17:20:10,104,3582,51,53,2063.57,4189.00,0.00
2024-12-10 17:20:10,105,3582,51,54,2043.91,4189.01,0.00
2024-12-10 17:20:10,105,3583,51,54,2042.81,4190.00,0.00
2024-12-10 17:20:10,106,3583,51,55,2023.54,4190.01,0.00
2024-12-10 17:20:10,105,3583,51,54,2041.22,4190.04,0.00
2024-12-10 17:20:10,105,3584,51,54,2041.30,4191.00,0.00
2024-12-10 17:20:10,106,3584,51,55,2022.04,4191.01,0.00
2024-12-10 17:20:10,105,3584,50,55,2039.71,4191.04,0.00
2024-12-10 17:20:10,106,3583,51,55,2017.31,4191.13,0.00
2024-12-10 17:20:10,106,3584,51,55,2056.53,4192.00,0.00
2024-12-10 17:20:10,107,3584,51,56,2037.31,4192.01,0.00
2024-12-10 17:20:10,106,3584,51,55,2054.96,4192.04,0.00
2024-12-10 17:20:10,105,3584,50,55,2069.67,4192.15,0.00
2024-12-10 17:20:10,105,3585,50,55,2114.47,4193.00,0.00
2024-12-10 17:20:10,106,3585,51,55,2094.52,4193.01,0.00
2024-12-10 17:20:10,105,3585,50,55,2112.88,4193.04,0.00
2024-12-10 17:20:10,105,3586,50,55,2112.98,4194.00,0.00
2024-12-10 17:20:10,106,3586,51,55,2093.04,4194.01,0.00
2024-12-10 17:20:10,105,3586,50,55,2111.39,4194.04,0.00
2024-12-10 17:20:10,105,3587,50,55,2111.37,4195.00,0.00
2024-12-10 17:20:10,106,3587,50,56,2091.45,4195.01,0.00
2024-12-10 17:20:10,105,3587,50,55,2109.78,4195.04,0.00
2024-12-10 17:20:10,105,3588,50,55,2108.62,4196.00,0.00
2024-12-10 17:20:10,106,3588,51,55,2088.73,4196.01,0.00
2024-12-10 17:20:10,105,3588,50,55,2107.03,4196.04,0.00
2024-12-10 17:20:10,105,3589,50,55,2105.37,4197.00,0.00
2024-12-10 17:20:10,106,3589,50,56,2085.51,4197.01,0.00
2024-12-10 17:20:10,105,3589,50,55,2104.18,4197.03,0.00
2024-12-10 17:20:10,104,3589,50,54,2124.01,4197.03,0.00
2024-12-10 17:20:10,103,3589,49,54,2144.22,4197.03,0.00
2024-12-10 17:20:11,103,3590,49,54,2142.70,4198.00,0.00
2024-12-10 17:20:11,104,3590,49,55,2122.10,4198.01,0.00
2024-12-10 17:20:11,104,3591,49,55,2119.08,4199.00,0.00
2024-12-10 17:20:11,105,3591,50,55,2098.90,4199.01,0.00
2024-12-10 17:20:11,104,3591,49,55,2117.88,4199.03,0.00
2024-12-10 17:20:11,105,3590,50,55,2080.58,4199.39,0.00
2024-12-10 17:20:11,105,3591,50,55,2120.04,4200.00,0.00
2024-12-10 17:20:11,106,3591,51,55,2100.04,4200.01,0.00
2024-12-10 17:20:11,105,3591,51,54,2109.09,4200.27,0.00
2024-12-10 17:20:11,105,3592,51,54,2158.74,4201.00,0.00
2024-12-10 17:20:11,106,3592,51,55,2138.38,4201.01,0.00
2024-12-10 17:20:11,105,3592,51,54,2157.16,4201.04,0.00
2024-12-10 17:20:11,105,3593,51,54,2156.92,4202.00,0.00
2024-12-10 17:20:11,106,3593,52,54,2136.58,4202.01,0.00
2024-12-10 17:20:11,105,3593,51,54,2155.27,4202.04,0.00
2024-12-10 17:20:11,105,3594,51,54,2154.15,4203.00,0.00
2024-12-10 17:20:11,106,3594,51,55,2133.83,4203.01,0.00
2024-12-10 17:20:11,105,3594,50,55,2152.22,4203.04,0.00
2024-12-10 17:20:11,105,3595,50,55,2147.55,4204.00,0.00
2024-12-10 17:20:11,106,3595,50,56,2127.29,4204.01,0.00
2024-12-10 17:20:11,105,3595,49,56,2145.20,4204.04,0.00
2024-12-10 17:20:11,105,3596,49,56,2137.66,4205.00,0.00
2024-12-10 17:20:11,106,3596,50,56,2117.49,4205.01,0.00
2024-12-10 17:20:11,106,3597,50,56,2105.22,4206.00,0.00
2024-12-10 17:20:11,107,3597,51,56,2085.54,4206.01,0.00
2024-12-10 17:20:11,106,3597,51,55,2104.62,4206.01,0.00
2024-12-10 17:20:11,105,3597,51,54,2123.47,4206.03,0.00
2024-12-10 17:20:11,105,3598,51,54,2109.20,4207.00,0.00
2024-12-10 17:20:11,106,3598,51,55,2089.30,4207.01,0.00
2024-12-10 17:20:11,105,3598,51,54,2108.01,4207.03,0.00
2024-12-10 17:20:11,104,3598,50,54,2126.38,4207.07,0.00
2024-12-10 17:20:11,104,3599,50,54,2111.80,4208.00,0.00
2024-12-10 17:20:11,105,3599,50,55,2091.69,4208.01,0.00
2024-12-10 17:20:11,104,3599,49,55,2110.60,4208.03,0.00
2024-12-10 17:20:11,104,3600,49,55,2090.10,4209.00,0.00
2024-12-10 17:20:11,105,3600,50,55,2070.20,4209.01,0.00
2024-12-10 17:20:11,104,3600,50,54,2088.90,4209.03,0.00
2024-12-10 17:20:11,103,3600,50,53,2097.15,4209.19,0.00
2024-12-10 17:20:11,103,3601,50,53,2082.61,4210.00,0.00
2024-12-10 17:20:11,104,3601,50,54,2062.59,4210.01,0.00
2024-12-10 17:20:11,103,3601,49,54,2081.40,4210.03,0.00
2024-12-10 17:20:11,102,3601,48,54,2089.75,4210.27,0.00
2024-12-10 17:20:11,102,3602,48,54,2080.74,4211.00,0.00
2024-12-10 17:20:11,103,3602,49,54,2060.53,4211.01,0.00
2024-12-10 17:20:11,102,3602,49,53,2079.51,4211.03,0.00
2024-12-10 17:20:11,101,3602,49,52,2099.93,4211.03,0.00
2024-12-10 17:20:11,101,3603,49,52,2075.78,4212.00,0.00
2024-12-10 17:20:11,102,3603,49,53,2055.43,4212.01,0.00
2024-12-10 17:20:11,102,3604,49,53,2023.83,4213.00,0.00
2024-12-10 17:20:11,103,3604,49,54,2004.18,4213.01,0.00
2024-12-10 17:20:11,102,3604,49,53,2022.61,4213.03,0.00
2024-12-10 17:20:11,101,3604,49,52,2007.63,4213.76,0.00
2024-12-10 17:20:11,100,3604,48,52,2015.08,4213.83,0.00
2024-12-10 17:20:11,100,3605,48,52,2031.74,4214.00,0.00
2024-12-10 17:20:11,101,3605,48,53,2011.63,4214.01,0.00
2024-12-10 17:20:11,100,3605,47,53,2030.49,4214.03,0.00
2024-12-10 17:20:11,100,3606,47,53,2007.48,4215.00,0.00
2024-12-10 17:20:11,101,3606,48,53,1987.60,4215.01,0.00
2024-12-10 17:20:11,100,3606,47,53,2006.22,4215.03,0.00
2024-12-10 17:20:11,99,3606,47,52,2019.43,4215.15,0.00
2024-12-10 17:20:11,98,3606,46,52,2004.05,4215.86,0.00
2024-12-10 17:20:11,98,3607,46,52,2026.88,4216.00,0.00
2024-12-10 17:20:11,99,3607,46,53,2006.40,4216.01,0.00
2024-12-10 17:20:11,98,3607,46,52,2025.60,4216.03,0.00
2024-12-10 17:20:11,97,3607,45,52,2010.79,4216.79,0.00
2024-12-10 17:20:11,96,3607,44,52,2023.73,4216.87,0.00
2024-12-10 17:20:11,95,3607,44,51,2043.87,4216.88,0.00
2024-12-10 17:20:11,95,3608,44,51,2079.58,4217.00,0.00
2024-12-10 17:20:11,96,3608,44,52,2057.91,4217.01,0.00
2024-12-10 17:20:11,95,3608,44,51,2078.26,4217.03,0.00
2024-12-10 17:20:11,94,3608,44,50,2096.08,4217.09,0.00
2024-12-10 17:20:11,94,3609,44,50,2097.70,4218.00,0.00
2024-12-10 17:20:11,95,3609,45,50,2075.62,4218.01,0.00
2024-12-10 17:20:11,94,3609,45,49,2096.37,4218.03,0.00
2024-12-10 17:20:11,94,3610,45,49,2095.28,4219.00,0.00
2024-12-10 17:20:11,95,3610,46,49,2073.22,4219.01,0.00
2024-12-10 17:20:11,94,3610,46,48,2093.94,4219.03,0.00
2024-12-10 17:20:11,94,3611,46,48,2091.99,4220.00,0.00
2024-12-10 17:20:11,95,3611,47,48,2069.97,4220.01,0.00
2024-12-10 17:20:11,94,3611,46,48,2090.66,4220.03,0.00
2024-12-10 17:20:11,94,3612,46,48,2089.48,4221.00,0.00
2024-12-10 17:20:11,95,3612,47,48,2067.48,4221.01,0.00
2024-12-10 17:20:11,94,3612,47,47,2088.14,4221.03,0.00
2024-12-10 17:20:11,94,3613,47,47,2086.87,4222.00,0.00
2024-12-10 17:20:11,95,3613,47,48,2064.90,4222.01,0.00
2024-12-10 17:20:11,94,3613,47,47,2085.53,4222.03,0.00
2024-12-10 17:20:11,93,3613,46,47,2069.50,4222.84,0.00
2024-12-10 17:20:11,93,3614,46,47,2107.73,4223.00,0.00
2024-12-10 17:20:11,94,3614,46,48,2085.31,4223.01,0.00
2024-12-10 17:20:11,94,3615,46,48,2082.72,4224.00,0.00
2024-12-10 17:20:11,95,3615,46,49,2060.80,4224.01,0.00
2024-12-10 17:20:11,94,3615,45,49,2081.38,4224.03,0.00
2024-12-10 17:20:11,94,3616,45,49,2077.87,4225.00,0.00
2024-12-10 17:20:11,95,3616,46,49,2056.00,4225.01,0.00
2024-12-10 17:20:11,94,3616,46,48,2069.83,4225.14,0.00
2024-12-10 17:20:11,93,3616,45,48,2074.41,4225.56,0.00
2024-12-10 17:20:11,93,3617,45,48,2099.73,4226.00,0.00
2024-12-10 17:20:11,94,3617,45,49,2077.39,4226.01,0.00
2024-12-10 17:20:11,93,3617,44,49,2098.38,4226.03,0.00
2024-12-10 17:20:11,93,3618,44,49,2100.88,4227.00,0.00
2024-12-10 17:20:11,94,3618,44,50,2078.53,4227.01,0.00
2024-12-10 17:20:11,94,3619,44,50,2077.95,4228.00,0.00
2024-12-10 17:20:11,95,3619,45,50,2056.08,4228.01,0.00
2024-12-10 17:20:11,94,3619,44,50,2076.61,4228.03,0.00
2024-12-10 17:20:12,94,3620,44,50,2076.06,4229.00,0.00
2024-12-10 17:20:12,95,3620,45,50,2054.21,4229.01,0.00
2024-12-10 17:20:12,94,3620,44,50,2074.72,4229.03,0.00
2024-12-10 17:20:12,94,3621,44,50,2073.27,4230.00,0.00
2024-12-10 17:20:12,95,3621,45,50,2051.44,4230.01,0.00
2024-12-10 17:20:12,95,3622,45,50,2046.91,4231.00,0.00
2024-12-10 17:20:12,96,3622,45,51,2025.59,4231.01,0.00
2024-12-10 17:20:12,95,3622,45,50,2045.58,4231.03,0.00
2024-12-10 17:20:12,94,3622,44,50,2063.94,4231.11,0.00
2024-12-10 17:20:12,94,3623,44,50,2063.87,4232.00,0.00
2024-12-10 17:20:12,95,3623,45,50,2042.15,4232.01,0.00
2024-12-10 17:20:12,94,3623,45,49,2062.53,4232.03,0.00
2024-12-10 17:20:12,94,3624,45,49,2059.43,4233.00,0.00
2024-12-10 17:20:12,95,3624,45,50,2037.75,4233.01,0.00
2024-12-10 17:20:12,94,3624,45,49,2058.08,4233.03,0.00
2024-12-10 17:20:12,94,3625,45,49,2055.06,4234.00,0.00
2024-12-10 17:20:12,95,3625,45,50,2033.42,4234.01,0.00
2024-12-10 17:20:12,94,3625,45,49,2053.02,4234.03,0.00
2024-12-10 17:20:12,93,3625,44,49,2040.72,4234.76,0.00
2024-12-10 17:20:12,93,3626,44,49,2076.44,4235.00,0.00
2024-12-10 17:20:12,94,3626,45,49,2054.35,4235.01,0.00
2024-12-10 17:20:12,93,3626,44,49,2074.17,4235.03,0.00
2024-12-10 17:20:12,93,3627,44,49,2074.32,4236.00,0.00
2024-12-10 17:20:12,94,3627,45,49,2052.25,4236.01,0.00
2024-12-10 17:20:12,93,3627,45,48,2071.91,4236.04,0.00
2024-12-10 17:20:12,92,3627,44,48,2069.09,4236.51,0.00
2024-12-10 17:20:12,92,3628,44,48,2094.77,4237.00,0.00
2024-12-10 17:20:12,93,3628,44,49,2072.25,4237.01,0.00
2024-12-10 17:20:12,94,3627,45,49,2043.93,4237.16,0.00
2024-12-10 17:20:12,94,3628,45,49,2090.56,4238.00,0.00
2024-12-10 17:20:12,95,3628,45,50,2068.56,4238.01,0.00
2024-12-10 17:20:12,94,3628,44,50,2086.52,4238.06,0.00
2024-12-10 17:20:12,94,3629,44,50,2134.90,4239.00,0.00
2024-12-10 17:20:12,95,3629,45,50,2112.42,4239.01,0.00
2024-12-10 17:20:12,95,3630,45,50,2109.25,4240.00,0.00
2024-12-10 17:20:12,96,3630,46,50,2087.28,4240.01,0.00
2024-12-10 17:20:12,95,3630,45,50,2108.82,4240.01,0.00
2024-12-10 17:20:12,94,3630,45,49,2129.92,4240.03,0.00
2024-12-10 17:20:12,95,3629,46,49,2092.93,4240.39,0.00
2024-12-10 17:20:12,95,3630,46,49,2134.38,4241.00,0.00
2024-12-10 17:20:12,96,3630,46,50,2112.15,4241.01,0.00
2024-12-10 17:20:12,96,3631,46,50,2148.68,4242.00,0.00
2024-12-10 17:20:12,97,3631,47,50,2126.53,4242.01,0.00
2024-12-10 17:20:12,96,3631,47,49,2147.36,4242.03,0.00
2024-12-10 17:20:12,95,3631,47,48,2145.19,4242.44,0.00
2024-12-10 17:20:12,95,3632,47,48,2162.97,4243.00,0.00
2024-12-10 17:20:12,96,3632,47,49,2140.44,4243.01,0.00
2024-12-10 17:20:12,96,3633,47,49,2134.50,4244.00,0.00
2024-12-10 17:20:12,97,3633,47,50,2112.50,4244.01,0.00
2024-12-10 17:20:12,96,3633,47,49,2133.18,4244.03,0.00
2024-12-10 17:20:12,96,3634,47,49,2129.03,4245.00,0.00
2024-12-10 17:20:12,97,3634,48,49,2107.08,4245.01,0.00
2024-12-10 17:20:12,96,3634,48,48,2127.72,4245.03,0.00
2024-12-10 17:20:12,95,3634,47,48,2130.61,4245.40,0.00
2024-12-10 17:20:12,95,3635,47,48,2146.34,4246.00,0.00
2024-12-10 17:20:12,96,3635,48,48,2123.99,4246.01,0.00
2024-12-10 17:20:12,95,3635,47,48,2145.01,4246.03,0.00
2024-12-10 17:20:12,94,3635,46,48,2157.65,4246.27,0.00
2024-12-10 17:20:12,94,3636,46,48,2165.76,4247.00,0.00
2024-12-10 17:20:12,95,3636,46,49,2142.97,4247.01,0.00
2024-12-10 17:20:12,94,3636,45,49,2164.42,4247.03,0.00
2024-12-10 17:20:12,94,3637,45,49,2159.49,4248.00,0.00
2024-12-10 17:20:12,95,3637,45,50,2136.76,4248.01,0.00
2024-12-10 17:20:12,94,3637,44,50,2158.14,4248.03,0.00
2024-12-10 17:20:12,94,3638,44,50,2149.89,4249.00,0.00
2024-12-10 17:20:12,95,3638,45,50,2127.26,4249.01,0.00
2024-12-10 17:20:12,94,3638,45,49,2148.54,4249.03,0.00
2024-12-10 17:20:12,93,3638,45,48,2149.31,4249.46,0.00
2024-12-10 17:20:12,93,3639,45,48,2164.23,4250.00,0.00
2024-12-10 17:20:12,94,3639,45,49,2141.21,4250.01,0.00
2024-12-10 17:20:12,93,3639,44,49,2129.08,4250.65,0.00
2024-12-10 17:20:12,93,3640,44,49,2160.00,4251.00,0.00
2024-12-10 17:20:12,94,3640,44,50,2137.02,4251.01,0.00
2024-12-10 17:20:12,93,3640,43,50,2158.19,4251.04,0.00
2024-12-10 17:20:12,92,3640,43,49,2163.77,4251.37,0.00
2024-12-10 17:20:12,92,3641,43,49,2183.62,4252.00,0.00
2024-12-10 17:20:12,93,3641,43,50,2160.14,4252.01,0.00
2024-12-10 17:20:12,92,3641,42,50,2181.79,4252.04,0.00
2024-12-10 17:20:12,92,3642,42,50,2186.00,4253.00,0.00
2024-12-10 17:20:12,93,3642,43,50,2162.49,4253.01,0.00
2024-12-10 17:20:12,92,3642,42,50,2184.17,4253.04,0.00
2024-12-10 17:20:12,92,3643,42,50,2188.45,4254.00,0.00
2024-12-10 17:20:12,93,3643,43,50,2164.92,4254.01,0.00
2024-12-10 17:20:12,92,3643,43,49,2186.62,4254.04,0.00
2024-12-10 17:20:12,91,3643,42,49,2210.18,4254.04,0.00
2024-12-10 17:20:12,91,3644,42,49,2214.63,4255.00,0.00
2024-12-10 17:20:12,92,3644,42,50,2190.56,4255.01,0.00
2024-12-10 17:20:12,91,3644,42,49,2212.77,4255.04,0.00
2024-12-10 17:20:12,91,3645,42,49,2216.92,4256.00,0.00
2024-12-10 17:20:12,92,3645,42,50,2192.82,4256.01,0.00
2024-12-10 17:20:12,91,3645,42,49,2215.07,4256.04,0.00
2024-12-10 17:20:12,90,3645,42,48,2227.04,4256.30,0.00
2024-12-10 17:20:12,90,3646,42,48,2245.01,4257.00,0.00
2024-12-10 17:20:12,91,3646,42,49,2220.34,4257.01,0.00
2024-12-10 17:20:12,90,3646,42,48,2243.13,4257.04,0.00
2024-12-10 17:20:12,90,3647,42,48,2250.27,4258.00,0.00
2024-12-10 17:20:12,91,3647,43,48,2225.54,4258.01,0.00
2024-12-10 17:20:12,90,3647,43,47,2248.39,4258.04,0.00
2024-12-10 17:20:12,90,3648,43,47,2255.53,4259.00,0.00
2024-12-10 17:20:12,91,3648,44,47,2230.74,4259.01,0.00
2024-12-10 17:20:12,90,3648,44,46,2253.65,4259.04,0.00
2024-12-10 17:20:13,90,3649,44,46,2260.79,4260.00,0.00
2024-12-10 17:20:13,91,3649,45,46,2235.95,4260.01,0.00
2024-12-10 17:20:13,90,3649,45,45,2258.91,4260.04,0.00
2024-12-10 17:20:13,91,3648,45,46,2203.20,4260.76,0.00
2024-12-10 17:20:13,91,3649,45,46,2249.77,4261.00,0.00
2024-12-10 17:20:13,92,3649,46,46,2225.31,4261.01,0.00
2024-12-10 17:20:13,91,3649,46,45,2247.91,4261.04,0.00
2024-12-10 17:20:13,91,3650,46,45,2297.93,4262.00,0.00
2024-12-10 17:20:13,92,3650,47,45,2272.95,4262.01,0.00
2024-12-10 17:20:13,91,3650,47,44,2296.07,4262.04,0.00
2024-12-10 17:20:13,90,3650,47,43,2313.63,4262.18,0.00
2024-12-10 17:20:13,90,3651,47,43,2326.05,4263.00,0.00
2024-12-10 17:20:13,91,3651,47,44,2300.49,4263.01,0.00
2024-12-10 17:20:13,90,3651,46,44,2324.17,4263.04,0.00
2024-12-10 17:20:13,91,3650,46,45,2297.69,4263.09,0.00
2024-12-10 17:20:13,91,3651,46,45,2349.99,4264.00,0.00
2024-12-10 17:20:13,92,3651,47,45,2324.45,4264.01,0.00
2024-12-10 17:20:13,91,3651,46,45,2348.14,4264.04,0.00
2024-12-10 17:20:13,91,3652,46,45,2401.04,4265.00,0.00
2024-12-10 17:20:13,92,3652,47,45,2374.95,4265.01,0.00
2024-12-10 17:20:13,91,3652,46,45,2399.18,4265.04,0.00
2024-12-10 17:20:13,91,3653,46,45,2405.29,4266.00,0.00
2024-12-10 17:20:13,92,3653,47,45,2379.15,4266.01,0.00
2024-12-10 17:20:13,91,3653,46,45,2391.66,4266.33,0.00
2024-12-10 17:20:13,91,3654,46,45,2409.45,4267.00,0.00
2024-12-10 17:20:13,92,3654,47,45,2383.26,4267.01,0.00
2024-12-10 17:20:13,91,3654,47,44,2407.13,4267.06,0.00
2024-12-10 17:20:13,91,3655,47,44,2412.66,4268.00,0.00
2024-12-10 17:20:13,92,3655,48,44,2386.44,4268.01,0.00
2024-12-10 17:20:13,92,3656,48,44,2389.04,4269.00,0.00
2024-12-10 17:20:13,93,3656,49,44,2363.35,4269.01,0.00
2024-12-10 17:20:13,92,3656,48,44,2385.90,4269.05,0.00
2024-12-10 17:20:13,92,3657,48,44,2389.28,4270.00,0.00
2024-12-10 17:20:13,93,3657,49,44,2363.59,4270.01,0.00
2024-12-10 17:20:13,92,3657,48,44,2384.83,4270.05,0.00
2024-12-10 17:20:13,92,3658,48,44,2386.45,4271.00,0.00
2024-12-10 17:20:13,93,3658,48,45,2360.79,4271.01,0.00
2024-12-10 17:20:13,92,3658,47,45,2380.99,4271.05,0.00
2024-12-10 17:20:13,92,3659,47,45,2381.05,4272.00,0.00
2024-12-10 17:20:13,93,3659,48,45,2355.44,4272.01,0.00
2024-12-10 17:20:13,92,3659,47,45,2374.72,4272.05,0.00
2024-12-10 17:20:13,91,3659,47,44,2385.87,4272.31,0.00
2024-12-10 17:20:13,92,3658,48,44,2352.13,4272.51,0.00
2024-12-10 17:20:13,92,3659,48,44,2393.49,4273.00,0.00
2024-12-10 17:20:13,93,3659,49,44,2367.75,4273.01,0.00
2024-12-10 17:20:13,92,3659,49,43,2386.30,4273.05,0.00
2024-12-10 17:20:13,92,3660,49,43,2433.25,4274.00,0.00
2024-12-10 17:20:13,93,3660,50,43,2407.09,4274.01,0.00
2024-12-10 17:20:13,93,3661,50,43,2399.85,4275.00,0.00
2024-12-10 17:20:13,94,3661,50,44,2374.32,4275.01,0.00
2024-12-10 17:20:13,93,3661,49,44,2390.63,4275.06,0.00
2024-12-10 17:20:13,93,3662,49,44,2391.29,4276.00,0.00
2024-12-10 17:20:13,94,3662,50,44,2365.85,4276.01,0.00
2024-12-10 17:20:13,93,3662,50,43,2379.17,4276.09,0.00
2024-12-10 17:20:13,93,3663,50,43,2380.59,4277.00,0.00
2024-12-10 17:20:13,94,3663,51,43,2355.27,4277.01,0.00
2024-12-10 17:20:13,93,3663,50,43,2373.58,4277.04,0.00
2024-12-10 17:20:13,92,3663,49,43,2398.45,4277.05,0.00
2024-12-10 17:20:13,92,3664,49,43,2398.23,4278.00,0.00
2024-12-10 17:20:13,93,3664,49,44,2372.44,4278.01,0.00
2024-12-10 17:20:13,92,3664,49,43,2392.71,4278.13,0.00
2024-12-10 17:20:13,92,3665,49,43,2395.39,4279.00,0.00
2024-12-10 17:20:13,93,3665,50,43,2369.63,4279.01,0.00
2024-12-10 17:20:13,92,3665,50,42,2393.08,4279.05,0.00
2024-12-10 17:20:13,91,3665,50,41,2381.67,4279.82,0.00
2024-12-10 17:20:13,91,3666,50,41,2421.33,4280.00,0.00
2024-12-10 17:20:13,92,3666,50,42,2395.01,4280.01,0.00
2024-12-10 17:20:13,91,3666,49,42,2414.07,4280.15,0.00
2024-12-10 17:20:13,91,3667,49,42,2425.43,4281.00,0.00
2024-12-10 17:20:13,92,3667,50,42,2399.07,4281.01,0.00
2024-12-10 17:20:13,92,3668,50,42,2403.82,4282.00,0.00
2024-12-10 17:20:13,93,3668,51,42,2377.97,4282.01,0.00
2024-12-10 17:20:13,92,3668,51,41,2401.51,4282.05,0.00
2024-12-10 17:20:13,92,3669,51,41,2408.10,4283.00,0.00
2024-12-10 17:20:13,93,3669,52,41,2382.21,4283.01,0.00
2024-12-10 17:20:13,93,3670,52,41,2386.45,4284.00,0.00
2024-12-10 17:20:13,94,3670,53,41,2361.06,4284.01,0.00
2024-12-10 17:20:13,94,3671,53,41,2364.81,4285.00,0.00
2024-12-10 17:20:13,95,3671,53,42,2339.91,4285.01,0.00
2024-12-10 17:20:13,95,3672,53,42,2343.17,4286.00,0.00
2024-12-10 17:20:13,96,3672,54,42,2318.76,4286.01,0.00
2024-12-10 17:20:13,96,3673,54,42,2321.30,4287.00,0.00
2024-12-10 17:20:13,97,3673,55,42,2297.37,4287.01,0.00
2024-12-10 17:20:13,96,3673,54,42,2319.08,4287.05,0.00
2024-12-10 17:20:13,96,3674,54,42,2323.16,4288.00,0.00
2024-12-10 17:20:13,97,3674,54,43,2299.21,4288.01,0.00
2024-12-10 17:20:13,96,3674,53,43,2320.94,4288.05,0.00
2024-12-10 17:20:13,96,3675,53,43,2325.07,4289.00,0.00
2024-12-10 17:20:13,97,3675,53,44,2301.10,4289.01,0.00
2024-12-10 17:20:13,96,3675,53,43,2322.85,4289.05,0.00
2024-12-10 17:20:13,97,3674,54,43,2298.46,4289.08,0.00
2024-12-10 17:20:13,97,3675,54,43,2346.51,4290.00,0.00
2024-12-10 17:20:13,98,3675,55,43,2322.57,4290.01,0.00
2024-12-10 17:20:13,98,3676,55,43,2368.21,4291.00,0.00
2024-12-10 17:20:13,99,3676,55,44,2344.29,4291.01,0.00
2024-12-10 17:20:13,98,3676,54,44,2367.77,4291.01,0.00
2024-12-10 17:20:13,97,3676,54,43,2390.42,4291.04,0.00
2024-12-10 17:20:14,97,3677,54,43,2394.07,4292.00,0.00
2024-12-10 17:20:14,98,3677,55,43,2369.64,4292.01,0.00
2024-12-10 17:20:14,98,3678,55,43,2371.50,4293.00,0.00
2024-12-10 17:20:14,99,3678,56,43,2347.55,4293.01,0.00
2024-12-10 17:20:14,98,3678,55,43,2369.33,4293.05,0.00
2024-12-10 17:20:14,98,3679,55,43,2372.88,4294.00,0.00
2024-12-10 17:20:14,99,3679,56,43,2348.91,4294.01,0.00
2024-12-10 17:20:14,99,3680,56,43,2350.14,4295.00,0.00
2024-12-10 17:20:14,100,3680,57,43,2326.64,4295.01,0.00
2024-12-10 17:20:14,100,3681,57,43,2327.23,4296.00,0.00
2024-12-10 17:20:14,101,3681,57,44,2304.19,4296.01,0.00
2024-12-10 17:20:14,101,3682,57,44,2304.73,4297.00,0.00
2024-12-10 17:20:14,102,3682,57,45,2282.13,4297.01,0.00
2024-12-10 17:20:14,101,3682,57,44,2302.80,4297.05,0.00
2024-12-10 17:20:14,101,3683,57,44,2305.02,4298.00,0.00
2024-12-10 17:20:14,102,3683,58,44,2282.42,4298.01,0.00
2024-12-10 17:20:14,101,3683,58,43,2302.91,4298.05,0.00
2024-12-10 17:20:14,102,3682,59,43,2247.82,4298.83,0.00
2024-12-10 17:20:14,102,3683,59,43,2289.70,4299.00,0.00
2024-12-10 17:20:14,103,3683,60,43,2267.47,4299.01,0.00
2024-12-10 17:20:14,102,3683,60,42,2289.27,4299.01,0.00
2024-12-10 17:20:14,101,3683,59,42,2310.25,4299.04,0.00
2024-12-10 17:20:14,101,3684,59,42,2354.62,4300.00,0.00
2024-12-10 17:20:14,102,3684,60,42,2331.53,4300.01,0.00
2024-12-10 17:20:14,102,3685,60,42,2331.33,4301.00,0.00
2024-12-10 17:20:14,103,3685,60,43,2308.69,4301.01,0.00
2024-12-10 17:20:14,102,3685,60,42,2330.02,4301.04,0.00
2024-12-10 17:20:14,101,3685,60,41,2352.71,4301.04,0.00
2024-12-10 17:20:14,101,3686,60,41,2354.52,4302.00,0.00
2024-12-10 17:20:14,102,3686,61,41,2331.44,4302.01,0.00
2024-12-10 17:20:14,102,3687,61,41,2331.56,4303.00,0.00
2024-12-10 17:20:14,103,3687,61,42,2308.92,4303.01,0.00
2024-12-10 17:20:14,103,3688,61,42,2308.62,4304.00,0.00
2024-12-10 17:20:14,104,3688,62,42,2286.42,4304.01,0.00
2024-12-10 17:20:14,104,3689,62,42,2285.71,4305.00,0.00
2024-12-10 17:20:14,105,3689,63,42,2263.94,4305.01,0.00
2024-12-10 17:20:14,106,3688,63,43,2220.81,4305.54,0.00
2024-12-10 17:20:14,106,3689,63,43,2260.17,4306.00,0.00
2024-12-10 17:20:14,107,3689,63,44,2239.04,4306.01,0.00
2024-12-10 17:20:14,108,3688,63,45,2185.55,4306.80,0.00
2024-12-10 17:20:14,108,3689,63,45,2264.29,4307.00,0.00
2024-12-10 17:20:14,109,3689,63,46,2243.52,4307.01,0.00
2024-12-10 17:20:14,108,3689,63,45,2262.71,4307.04,0.00
2024-12-10 17:20:14,108,3690,63,45,2301.51,4308.00,0.00
2024-12-10 17:20:14,109,3690,64,45,2280.40,4308.01,0.00
2024-12-10 17:20:14,108,3690,64,44,2299.93,4308.04,0.00
2024-12-10 17:20:14,108,3691,64,44,2298.86,4309.00,0.00
2024-12-10 17:20:14,109,3691,65,44,2277.77,4309.01,0.00
2024-12-10 17:20:14,108,3691,64,44,2297.27,4309.04,0.00
2024-12-10 17:20:14,108,3692,64,44,2296.20,4310.00,0.00
2024-12-10 17:20:14,109,3692,65,44,2275.13,4310.01,0.00
2024-12-10 17:20:14,110,3691,66,44,2243.14,4310.29,0.00
2024-12-10 17:20:14,110,3692,66,44,2271.06,4311.00,0.00
2024-12-10 17:20:14,111,3692,66,45,2250.60,4311.01,0.00
2024-12-10 17:20:14,111,3693,66,45,2286.09,4312.00,0.00
2024-12-10 17:20:14,112,3693,66,46,2265.68,4312.01,0.00
2024-12-10 17:20:14,111,3693,66,45,2284.54,4312.04,0.00
2024-12-10 17:20:14,111,3694,66,45,2282.34,4313.00,0.00
2024-12-10 17:20:14,112,3694,67,45,2261.96,4313.01,0.00
2024-12-10 17:20:14,111,3694,67,44,2280.80,4313.04,0.00
2024-12-10 17:20:14,111,3695,67,44,2278.60,4314.00,0.00
2024-12-10 17:20:14,112,3695,67,45,2258.25,4314.01,0.00
2024-12-10 17:20:14,111,3695,67,44,2277.05,4314.04,0.00
2024-12-10 17:20:14,111,3696,67,44,2274.85,4315.00,0.00
2024-12-10 17:20:14,112,3696,68,44,2254.54,4315.01,0.00
2024-12-10 17:20:14,111,3696,67,44,2273.30,4315.04,0.00
2024-12-10 17:20:14,111,3697,67,44,2271.10,4316.00,0.00
2024-12-10 17:20:14,112,3697,68,44,2250.82,4316.01,0.00
2024-12-10 17:20:14,111,3697,68,43,2269.55,4316.04,0.00
2024-12-10 17:20:14,111,3698,68,43,2267.28,4317.00,0.00
2024-12-10 17:20:14,112,3698,69,43,2247.04,4317.01,0.00
2024-12-10 17:20:14,111,3698,69,42,2265.74,4317.04,0.00
2024-12-10 17:20:14,111,3699,69,42,2263.25,4318.00,0.00
2024-12-10 17:20:14,112,3699,70,42,2243.04,4318.01,0.00
2024-12-10 17:20:14,112,3700,70,42,2238.82,4319.00,0.00
2024-12-10 17:20:14,113,3700,70,43,2219.01,4319.01,0.00
2024-12-10 17:20:14,112,3700,69,43,2237.29,4319.04,0.00
2024-12-10 17:20:15,112,3701,69,43,2233.96,4320.00,0.00
2024-12-10 17:20:15,113,3701,69,44,2214.19,4320.01,0.00
2024-12-10 17:20:15,112,3701,68,44,2232.43,4320.04,0.00
2024-12-10 17:20:15,111,3701,68,43,2251.13,4320.06,0.00
2024-12-10 17:20:15,111,3702,68,43,2249.07,4321.00,0.00
2024-12-10 17:20:15,112,3702,69,43,2228.99,4321.01,0.00
2024-12-10 17:20:15,111,3702,68,43,2247.34,4321.04,0.00
2024-12-10 17:20:15,111,3703,68,43,2243.88,4322.00,0.00
2024-12-10 17:20:15,112,3703,68,44,2223.84,4322.01,0.00
2024-12-10 17:20:15,111,3703,68,43,2240.58,4322.04,0.00
2024-12-10 17:20:15,111,3704,68,43,2236.89,4323.00,0.00
2024-12-10 17:20:15,112,3704,68,44,2216.92,4323.01,0.00
2024-12-10 17:20:15,111,3704,67,44,2232.99,4323.01,0.00
2024-12-10 17:20:15,110,3704,67,43,2252.12,4323.03,0.00
2024-12-10 17:20:15,110,3705,67,43,2248.13,4324.00,0.00
2024-12-10 17:20:15,111,3705,67,44,2227.88,4324.01,0.00
2024-12-10 17:20:15,110,3705,67,43,2238.32,4324.22,0.00
2024-12-10 17:20:15,110,3706,67,43,2244.25,4325.00,0.00
2024-12-10 17:20:15,111,3706,68,43,2224.03,4325.01,0.00
2024-12-10 17:20:15,110,3706,67,43,2243.08,4325.03,0.00
2024-12-10 17:20:15,110,3707,67,43,2240.08,4326.00,0.00
2024-12-10 17:20:15,111,3707,68,43,2219.90,4326.01,0.00
2024-12-10 17:20:15,110,3707,68,42,2238.90,4326.03,0.00
2024-12-10 17:20:15,111,3706,68,43,2207.87,4326.30,0.00
2024-12-10 17:20:15,111,3707,68,43,2243.24,4327.00,0.00
2024-12-10 17:20:15,112,3707,68,44,2223.21,4327.01,0.00
2024-12-10 17:20:15,111,3707,68,43,2242.08,4327.03,0.00
2024-12-10 17:20:15,111,3708,68,43,2277.76,4328.00,0.00
2024-12-10 17:20:15,112,3708,69,43,2257.42,4328.01,0.00
2024-12-10 17:20:15,111,3708,68,43,2276.60,4328.03,0.00
2024-12-10 17:20:15,111,3709,68,43,2274.00,4329.00,0.00
2024-12-10 17:20:15,112,3709,69,43,2253.69,4329.01,0.00
2024-12-10 17:20:15,111,3709,68,43,2272.83,4329.03,0.00
2024-12-10 17:20:15,111,3710,68,43,2270.23,4330.00,0.00
2024-12-10 17:20:15,112,3710,68,44,2249.96,4330.01,0.00
2024-12-10 17:20:15,112,3711,68,44,2246.23,4331.00,0.00
2024-12-10 17:20:15,113,3711,69,44,2226.35,4331.01,0.00
2024-12-10 17:20:15,112,3711,69,43,2244.69,4331.04,0.00
2024-12-10 17:20:15,112,3712,69,43,2242.11,4332.00,0.00
2024-12-10 17:20:15,113,3712,70,43,2222.26,4332.01,0.00
2024-12-10 17:20:15,112,3712,69,43,2240.57,4332.04,0.00
2024-12-10 17:20:15,112,3713,69,43,2237.98,4333.00,0.00
2024-12-10 17:20:15,113,3713,70,43,2218.18,4333.01,0.00
2024-12-10 17:20:15,112,3713,70,42,2236.44,4333.04,0.00
2024-12-10 17:20:15,112,3714,70,42,2233.53,4334.00,0.00
2024-12-10 17:20:15,113,3714,70,43,2213.76,4334.01,0.00
2024-12-10 17:20:15,112,3714,70,42,2231.99,4334.04,0.00
2024-12-10 17:20:15,112,3715,70,42,2228.65,4335.00,0.00
2024-12-10 17:20:15,113,3715,70,43,2208.93,4335.01,0.00
2024-12-10 17:20:15,112,3715,69,43,2227.11,4335.04,0.00
2024-12-10 17:20:15,112,3716,69,43,2224.52,4336.00,0.00
2024-12-10 17:20:15,113,3716,69,44,2204.83,4336.01,0.00
2024-12-10 17:20:15,112,3716,68,44,2222.98,4336.04,0.00
2024-12-10 17:20:15,112,3717,68,44,2220.38,4337.00,0.00
2024-12-10 17:20:15,113,3717,68,45,2200.73,4337.01,0.00
2024-12-10 17:20:15,112,3717,68,44,2218.84,4337.04,0.00
2024-12-10 17:20:15,111,3717,67,44,2238.44,4337.04,0.00
2024-12-10 17:20:15,111,3718,67,44,2236.21,4338.00,0.00
2024-12-10 17:20:15,112,3718,67,45,2216.25,4338.01,0.00
2024-12-10 17:20:15,112,3719,67,45,2212.50,4339.00,0.00
2024-12-10 17:20:15,113,3719,68,45,2192.92,4339.01,0.00
2024-12-10 17:20:15,112,3719,67,45,2210.57,4339.04,0.00
2024-12-10 17:20:15,112,3720,67,45,2208.36,4340.00,0.00
2024-12-10 17:20:15,113,3720,67,46,2188.81,4340.01,0.00
2024-12-10 17:20:15,112,3720,66,46,2207.97,4340.01,0.00
2024-12-10 17:20:15,111,3720,65,46,2226.31,4340.04,0.00
2024-12-10 17:20:15,110,3720,64,46,2246.16,4340.04,0.00
2024-12-10 17:20:15,110,3721,64,46,2244.29,4341.00,0.00
2024-12-10 17:20:15,111,3721,64,47,2224.07,4341.01,0.00
2024-12-10 17:20:15,110,3721,64,46,2242.73,4341.04,0.00
2024-12-10 17:20:15,110,3722,64,46,2240.86,4342.00,0.00
2024-12-10 17:20:15,111,3722,65,46,2220.67,4342.01,0.00
2024-12-10 17:20:15,110,3722,64,46,2239.30,4342.04,0.00
2024-12-10 17:20:15,110,3723,64,46,2237.43,4343.00,0.00
2024-12-10 17:20:15,111,3723,65,46,2217.27,4343.01,0.00
2024-12-10 17:20:15,110,3723,65,45,2235.86,4343.04,0.00
2024-12-10 17:20:15,111,3722,66,45,2201.71,4343.38,0.00
2024-12-10 17:20:15,111,3723,66,45,2238.92,4344.00,0.00
2024-12-10 17:20:15,112,3723,66,46,2218.92,4344.01,0.00
2024-12-10 17:20:15,112,3724,66,46,2253.96,4345.00,0.00
2024-12-10 17:20:15,113,3724,67,46,2234.02,4345.01,0.00
2024-12-10 17:20:15,112,3724,66,46,2252.42,4345.04,0.00
2024-12-10 17:20:15,112,3725,66,46,2249.83,4346.00,0.00
2024-12-10 17:20:15,113,3725,66,47,2229.92,4346.01,0.00
2024-12-10 17:20:15,112,3725,65,47,2248.29,4346.04,0.00
2024-12-10 17:20:15,113,3724,65,48,2223.79,4346.16,0.00
2024-12-10 17:20:15,113,3725,65,48,2240.13,4347.00,0.00
2024-12-10 17:20:15,114,3725,66,48,2220.48,4347.01,0.00
2024-12-10 17:20:15,113,3725,66,47,2238.61,4347.04,0.00
2024-12-10 17:20:15,113,3726,66,47,2272.19,4348.00,0.00
2024-12-10 17:20:15,114,3726,66,48,2252.26,4348.01,0.00
2024-12-10 17:20:15,113,3726,66,47,2270.66,4348.04,0.00
2024-12-10 17:20:15,113,3727,66,47,2265.88,4349.00,0.00
2024-12-10 17:20:16,114,3727,66,48,2246.01,4349.01,0.00
2024-12-10 17:20:16,113,3727,65,48,2264.35,4349.04,0.00
2024-12-10 17:20:16,113,3728,65,48,2261.16,4350.00,0.00
2024-12-10 17:20:16,114,3728,65,49,2241.33,4350.01,0.00
2024-12-10 17:20:16,113,3728,65,48,2259.64,4350.04,0.00
2024-12-10 17:20:16,112,3728,65,47,2274.61,4350.15,0.00
2024-12-10 17:20:16,112,3729,65,47,2276.53,4351.00,0.00
2024-12-10 17:20:16,113,3729,65,48,2256.39,4351.01,0.00
2024-12-10 17:20:16,112,3729,65,47,2274.99,4351.04,0.00
2024-12-10 17:20:16,112,3730,65,47,2271.86,4352.00,0.00
2024-12-10 17:20:16,113,3730,66,47,2251.75,4352.01,0.00
2024-12-10 17:20:16,112,3730,66,46,2270.32,4352.04,0.00
2024-12-10 17:20:16,113,3729,67,46,2239.11,4352.31,0.00
2024-12-10 17:20:16,113,3730,67,46,2267.70,4353.00,0.00
2024-12-10 17:20:16,114,3730,67,47,2247.81,4353.01,0.00
2024-12-10 17:20:16,113,3730,66,47,2266.17,4353.04,0.00
2024-12-10 17:20:16,113,3731,66,47,2301.06,4354.00,0.00
2024-12-10 17:20:16,114,3731,67,47,2280.87,4354.01,0.00
2024-12-10 17:20:16,114,3732,67,47,2275.69,4355.00,0.00
2024-12-10 17:20:16,115,3732,67,48,2255.90,4355.01,0.00
2024-12-10 17:20:16,116,3731,68,48,2236.46,4355.03,0.00
2024-12-10 17:20:16,115,3731,68,47,2279.03,4355.05,0.00
2024-12-10 17:20:16,115,3732,68,47,2275.80,4356.00,0.00
2024-12-10 17:20:16,116,3732,69,47,2256.18,4356.01,0.00
2024-12-10 17:20:16,115,3732,69,46,2273.93,4356.04,0.00
2024-12-10 17:20:16,115,3733,69,46,2308.53,4357.00,0.00
2024-12-10 17:20:16,116,3733,70,46,2288.63,4357.01,0.00
2024-12-10 17:20:16,115,3733,70,45,2306.65,4357.04,0.00
2024-12-10 17:20:16,116,3732,71,45,2275.93,4357.31,0.00
2024-12-10 17:20:16,116,3733,71,45,2302.23,4358.00,0.00
2024-12-10 17:20:16,117,3733,72,45,2282.55,4358.01,0.00
2024-12-10 17:20:16,116,3733,71,45,2300.37,4358.04,0.00
2024-12-10 17:20:16,116,3734,71,45,2333.27,4359.00,0.00
2024-12-10 17:20:16,117,3734,72,45,2313.32,4359.01,0.00
2024-12-10 17:20:16,117,3735,72,45,2306.32,4360.00,0.00
2024-12-10 17:20:16,118,3735,73,45,2286.78,4360.01,0.00
2024-12-10 17:20:16,117,3735,72,45,2304.12,4360.05,0.00
2024-12-10 17:20:16,116,3735,72,44,2323.60,4360.05,0.00
2024-12-10 17:20:16,116,3736,72,44,2318.30,4361.00,0.00
2024-12-10 17:20:16,117,3736,73,44,2298.48,4361.01,0.00
2024-12-10 17:20:16,116,3736,72,44,2316.07,4361.05,0.00
2024-12-10 17:20:16,116,3737,72,44,2310.87,4362.00,0.00
2024-12-10 17:20:16,117,3737,72,45,2291.12,4362.01,0.00
2024-12-10 17:20:16,116,3737,71,45,2308.64,4362.05,0.00
2024-12-10 17:20:16,115,3737,70,45,2313.89,4362.39,0.00
2024-12-10 17:20:16,115,3738,70,45,2325.69,4363.00,0.00
2024-12-10 17:20:16,116,3738,71,45,2305.64,4363.01,0.00
2024-12-10 17:20:16,117,3737,72,45,2267.05,4363.46,0.00
2024-12-10 17:20:16,118,3736,72,46,2259.42,4363.69,0.00
2024-12-10 17:20:16,118,3737,72,46,2294.82,4364.00,0.00
2024-12-10 17:20:16,119,3737,72,47,2275.53,4364.01,0.00
2024-12-10 17:20:16,118,3737,71,47,2292.62,4364.05,0.00
2024-12-10 17:20:16,118,3738,71,47,2362.57,4365.00,0.00
2024-12-10 17:20:16,119,3738,71,48,2342.71,4365.01,0.00
2024-12-10 17:20:16,118,3738,70,48,2360.37,4365.05,0.00
2024-12-10 17:20:16,118,3739,70,48,2356.15,4366.00,0.00
2024-12-10 17:20:16,119,3739,70,49,2336.35,4366.01,0.00
2024-12-10 17:20:16,118,3739,69,49,2353.95,4366.05,0.00
2024-12-10 17:20:16,119,3738,70,49,2308.94,4366.64,0.00
2024-12-10 17:20:16,119,3739,70,49,2343.37,4367.00,0.00
2024-12-10 17:20:16,120,3739,70,50,2323.84,4367.01,0.00
2024-12-10 17:20:16,119,3739,69,50,2341.19,4367.05,0.00
2024-12-10 17:20:16,119,3740,69,50,2372.25,4368.00,0.00
2024-12-10 17:20:16,120,3740,69,51,2352.48,4368.01,0.00
2024-12-10 17:20:16,119,3740,68,51,2370.07,4368.05,0.00
2024-12-10 17:20:16,118,3740,67,51,2387.63,4368.09,0.00
2024-12-10 17:20:16,118,3741,67,51,2383.68,4369.00,0.00
2024-12-10 17:20:16,119,3741,67,52,2363.65,4369.01,0.00
2024-12-10 17:20:16,118,3741,66,52,2381.48,4369.05,0.00
2024-12-10 17:20:16,117,3741,66,51,2396.28,4369.14,0.00
2024-12-10 17:20:16,117,3742,66,51,2396.42,4370.00,0.00
2024-12-10 17:20:16,118,3742,66,52,2376.12,4370.01,0.00
2024-12-10 17:20:16,117,3742,65,52,2394.21,4370.05,0.00
2024-12-10 17:20:16,118,3741,65,53,2351.50,4370.59,0.00
2024-12-10 17:20:16,118,3742,65,53,2385.92,4371.00,0.00
2024-12-10 17:20:16,119,3742,65,54,2365.87,4371.01,0.00
2024-12-10 17:20:16,120,3741,66,54,2346.15,4371.03,0.00
2024-12-10 17:20:16,119,3741,66,53,2369.57,4371.06,0.00
2024-12-10 17:20:16,119,3742,66,53,2402.42,4372.00,0.00
2024-12-10 17:20:16,120,3742,67,53,2382.40,4372.01,0.00
2024-12-10 17:20:16,119,3742,66,53,2401.69,4372.02,0.00
2024-12-10 17:20:16,118,3742,65,53,2420.58,4372.04,0.00
2024-12-10 17:20:16,117,3742,64,53,2440.89,4372.04,0.00
2024-12-10 17:20:16,117,3743,64,53,2474.32,4373.00,0.00
2024-12-10 17:20:16,118,3743,65,53,2453.35,4373.01,0.00
2024-12-10 17:20:16,118,3744,65,53,2447.15,4374.00,0.00
2024-12-10 17:20:16,119,3744,65,54,2426.58,4374.01,0.00
2024-12-10 17:20:16,118,3744,64,54,2445.32,4374.04,0.00
2024-12-10 17:20:16,118,3745,64,54,2441.03,4375.00,0.00
2024-12-10 17:20:16,119,3745,64,55,2420.51,4375.01,0.00
2024-12-10 17:20:16,118,3745,64,54,2439.19,4375.04,0.00
2024-12-10 17:20:16,118,3746,64,54,2434.91,4376.00,0.00
2024-12-10 17:20:16,119,3746,65,54,2414.45,4376.01,0.00
2024-12-10 17:20:16,118,3746,64,54,2433.07,4376.04,0.00
2024-12-10 17:20:16,118,3747,64,54,2428.33,4377.00,0.00
2024-12-10 17:20:16,119,3747,65,54,2407.92,4377.01,0.00
2024-12-10 17:20:16,118,3747,64,54,2426.49,4377.04,0.00
2024-12-10 17:20:16,119,3746,64,55,2369.60,4377.87,0.00
2024-12-10 17:20:17,119,3747,64,55,2405.41,4378.00,0.00
2024-12-10 17:20:17,120,3747,65,55,2385.37,4378.01,0.00
2024-12-10 17:20:17,119,3747,65,54,2403.60,4378.04,0.00
2024-12-10 17:20:17,119,3748,65,54,2432.06,4379.00,0.00
2024-12-10 17:20:17,120,3748,65,55,2411.79,4379.01,0.00
2024-12-10 17:20:17,119,3748,65,54,2416.60,4379.23,0.00
2024-12-10 17:20:17,119,3749,65,54,2420.04,4380.00,0.00
2024-12-10 17:20:17,120,3749,65,55,2399.87,4380.01,0.00
2024-12-10 17:20:17,119,3749,64,55,2411.62,4380.17,0.00
2024-12-10 17:20:17,119,3750,64,55,2412.49,4381.00,0.00
2024-12-10 17:20:17,120,3750,65,55,2392.38,4381.01,0.00
2024-12-10 17:20:17,121,3749,66,55,2369.38,4381.10,0.00
2024-12-10 17:20:17,121,3750,66,55,2400.67,4382.00,0.00
2024-12-10 17:20:17,122,3750,66,56,2380.99,4382.01,0.00
2024-12-10 17:20:17,121,3750,65,56,2398.16,4382.06,0.00
2024-12-10 17:20:17,122,3749,66,56,2360.03,4382.48,0.00
2024-12-10 17:20:17,122,3750,66,56,2415.24,4383.00,0.00
2024-12-10 17:20:17,123,3750,66,57,2395.61,4383.01,0.00
2024-12-10 17:20:17,122,3750,65,57,2412.76,4383.06,0.00
2024-12-10 17:20:17,121,3750,65,56,2429.74,4383.09,0.00
2024-12-10 17:20:17,121,3751,65,56,2460.82,4384.00,0.00
2024-12-10 17:20:17,122,3751,65,57,2440.65,4384.01,0.00
2024-12-10 17:20:17,121,3751,64,57,2458.31,4384.06,0.00
2024-12-10 17:20:17,121,3752,64,57,2450.10,4385.00,0.00
2024-12-10 17:20:17,122,3752,64,58,2430.02,4385.01,0.00
2024-12-10 17:20:17,121,3752,63,58,2443.51,4385.12,0.00
2024-12-10 17:20:17,121,3753,63,58,2438.41,4386.00,0.00
2024-12-10 17:20:17,122,3753,64,58,2418.42,4386.01,0.00
2024-12-10 17:20:17,123,3752,65,58,2374.71,4386.58,0.00
2024-12-10 17:20:17,123,3753,65,58,2402.07,4387.00,0.00
2024-12-10 17:20:17,124,3753,65,59,2382.70,4387.01,0.00
2024-12-10 17:20:17,123,3753,64,59,2398.90,4387.07,0.00
2024-12-10 17:20:17,124,3752,65,59,2343.72,4387.79,0.00
2024-12-10 17:20:17,124,3752,65,59,2412.55,4388.00,0.00
2024-12-10 17:20:17,125,3752,66,59,2393.25,4388.01,0.00
2024-12-10 17:20:17,125,3753,66,59,2414.87,4389.00,0.00
2024-12-10 17:20:17,126,3753,66,60,2395.70,4389.01,0.00
2024-12-10 17:20:17,125,3753,66,59,2411.75,4389.07,0.00
2024-12-10 17:20:17,124,3753,65,59,2430.84,4389.07,0.00
2024-12-10 17:20:17,124,3754,65,59,2421.02,4390.00,0.00
2024-12-10 17:20:17,125,3754,66,59,2401.65,4390.01,0.00
2024-12-10 17:20:17,124,3754,65,59,2417.87,4390.07,0.00
2024-12-10 17:20:17,123,3754,64,59,2411.94,4390.63,0.00
2024-12-10 17:20:17,123,3755,64,59,2431.88,4391.00,0.00
2024-12-10 17:20:17,124,3755,65,59,2412.27,4391.01,0.00
2024-12-10 17:20:17,123,3755,65,58,2428.70,4391.07,0.00
2024-12-10 17:20:17,123,3756,65,58,2423.06,4392.00,0.00
2024-12-10 17:20:17,124,3756,65,59,2403.52,4392.01,0.00
2024-12-10 17:20:17,123,3756,64,59,2419.88,4392.07,0.00
2024-12-10 17:20:17,123,3757,64,59,2414.15,4393.00,0.00
2024-12-10 17:20:17,124,3757,64,60,2394.68,4393.01,0.00
2024-12-10 17:20:17,125,3756,64,61,2367.14,4393.22,0.00
2024-12-10 17:20:17,125,3757,64,61,2395.90,4394.00,0.00
2024-12-10 17:20:17,126,3757,64,62,2376.89,4394.01,0.00
2024-12-10 17:20:17,126,3758,64,62,2402.36,4395.00,0.00
2024-12-10 17:20:17,127,3758,64,63,2383.45,4395.01,0.00
2024-12-10 17:20:17,126,3758,63,63,2399.26,4395.07,0.00
2024-12-10 17:20:17,126,3759,63,63,2392.67,4396.00,0.00
2024-12-10 17:20:17,127,3759,64,63,2373.83,4396.01,0.00
2024-12-10 17:20:17,126,3759,64,62,2389.57,4396.07,0.00
2024-12-10 17:20:17,127,3758,64,63,2342.22,4396.72,0.00
2024-12-10 17:20:17,127,3759,64,63,2374.32,4397.00,0.00
2024-12-10 17:20:17,128,3759,65,63,2355.77,4397.01,0.00
2024-12-10 17:20:17,127,3759,65,62,2371.23,4397.07,0.00
2024-12-10 17:20:17,127,3760,65,62,2399.12,4398.00,0.00
2024-12-10 17:20:17,128,3760,66,62,2380.37,4398.01,0.00
2024-12-10 17:20:17,127,3760,65,62,2396.03,4398.07,0.00
2024-12-10 17:20:17,126,3760,64,62,2414.70,4398.07,0.00
2024-12-10 17:20:17,126,3761,64,62,2407.85,4399.00,0.00
2024-12-10 17:20:17,127,3761,64,63,2388.89,4399.01,0.00
2024-12-10 17:20:17,126,3761,63,63,2404.74,4399.07,0.00
2024-12-10 17:20:17,125,3761,63,62,2404.51,4399.47,0.00
2024-12-10 17:20:17,125,3762,63,62,2416.87,4400.00,0.00
2024-12-10 17:20:17,126,3762,64,62,2397.69,4400.01,0.00
2024-12-10 17:20:17,126,3763,64,62,2388.46,4401.00,0.00
2024-12-10 17:20:17,127,3763,64,63,2369.65,4401.01,0.00
2024-12-10 17:20:17,128,3762,64,64,2327.60,4401.54,0.00
2024-12-10 17:20:17,128,3763,64,64,2357.07,4402.00,0.00
2024-12-10 17:20:17,129,3763,65,64,2338.79,4402.01,0.00
2024-12-10 17:20:17,128,3763,64,64,2354.00,4402.07,0.00
2024-12-10 17:20:17,127,3763,63,64,2367.29,4402.17,0.00
2024-12-10 17:20:17,127,3764,63,64,2399.36,4403.00,0.00
2024-12-10 17:20:17,128,3764,64,64,2380.61,4403.01,0.00
2024-12-10 17:20:17,127,3764,64,63,2396.26,4403.07,0.00
2024-12-10 17:20:17,127,3765,64,63,2388.77,4404.00,0.00
2024-12-10 17:20:17,128,3765,65,63,2370.11,4404.01,0.00
2024-12-10 17:20:17,127,3765,64,63,2385.68,4404.07,0.00
2024-12-10 17:20:17,127,3766,64,63,2378.09,4405.00,0.00
2024-12-10 17:20:17,128,3766,64,64,2359.51,4405.01,0.00
2024-12-10 17:20:17,127,3766,63,64,2374.99,4405.07,0.00
2024-12-10 17:20:17,126,3766,63,63,2393.49,4405.07,0.00
2024-12-10 17:20:17,127,3765,64,63,2348.17,4405.64,0.00
2024-12-10 17:20:17,127,3766,64,63,2379.32,4406.00,0.00
2024-12-10 17:20:17,128,3766,65,63,2360.74,4406.01,0.00
2024-12-10 17:20:17,127,3766,65,62,2376.23,4406.07,0.00
2024-12-10 17:20:17,126,3766,65,61,2387.31,4406.21,0.00
2024-12-10 17:20:18,126,3767,65,61,2420.93,4407.00,0.00
2024-12-10 17:20:18,127,3767,65,62,2401.87,4407.01,0.00
2024-12-10 17:20:18,126,3767,65,61,2417.39,4407.08,0.00
2024-12-10 17:20:18,126,3768,65,61,2409.22,4408.00,0.00
2024-12-10 17:20:18,127,3768,65,62,2390.25,4408.01,0.00
2024-12-10 17:20:18,126,3768,64,62,2405.15,4408.08,0.00
2024-12-10 17:20:18,126,3769,64,62,2396.96,4409.00,0.00
2024-12-10 17:20:18,127,3769,64,63,2378.09,4409.01,0.00
2024-12-10 17:20:18,126,3769,63,63,2392.28,4409.08,0.00
2024-12-10 17:20:18,127,3768,64,63,2352.10,4409.58,0.00
2024-12-10 17:20:18,127,3769,64,63,2383.30,4410.00,0.00
2024-12-10 17:20:18,128,3769,65,63,2364.68,4410.01,0.00
2024-12-10 17:20:18,127,3769,65,62,2382.61,4410.02,0.00
2024-12-10 17:20:18,126,3769,64,62,2396.56,4410.08,0.00
2024-12-10 17:20:18,126,3770,64,62,2423.27,4411.00,0.00
2024-12-10 17:20:18,127,3770,64,63,2404.19,4411.01,0.00
2024-12-10 17:20:18,126,3770,64,62,2417.34,4411.08,0.00
2024-12-10 17:20:18,126,3771,64,62,2408.09,4412.00,0.00
2024-12-10 17:20:18,127,3771,65,62,2389.13,4412.01,0.00
2024-12-10 17:20:18,126,3771,65,61,2401.50,4412.08,0.00
2024-12-10 17:20:18,126,3772,65,61,2390.30,4413.00,0.00
2024-12-10 17:20:18,127,3772,66,61,2371.48,4413.01,0.00
2024-12-10 17:20:18,128,3771,66,62,2311.56,4413.80,0.00
2024-12-10 17:20:18,128,3772,66,62,2340.64,4414.00,0.00
2024-12-10 17:20:18,129,3772,66,63,2322.49,4414.01,0.00
2024-12-10 17:20:18,128,3772,65,63,2338.76,4414.04,0.00
2024-12-10 17:20:18,127,3772,65,62,2355.45,4414.07,0.00
2024-12-10 17:20:18,128,3771,66,62,2319.24,4414.49,0.00
2024-12-10 17:20:18,128,3772,66,62,2376.72,4415.00,0.00
2024-12-10 17:20:18,129,3772,66,63,2358.30,4415.01,0.00
2024-12-10 17:20:18,128,3772,65,63,2373.65,4415.07,0.00
2024-12-10 17:20:18,129,3771,66,63,2347.75,4415.26,0.00
2024-12-10 17:20:18,129,3772,66,63,2403.77,4416.00,0.00
2024-12-10 17:20:18,130,3772,66,64,2385.28,4416.01,0.00
2024-12-10 17:20:18,129,3772,65,64,2400.72,4416.07,0.00
2024-12-10 17:20:18,129,3773,65,64,2423.20,4417.00,0.00
2024-12-10 17:20:18,130,3773,66,64,2404.56,4417.01,0.00
2024-12-10 17:20:18,129,3773,65,64,2420.15,4417.07,0.00
2024-12-10 17:20:18,130,3772,65,65,2374.42,4417.69,0.00
2024-12-10 17:20:18,130,3773,65,65,2401.07,4418.00,0.00
2024-12-10 17:20:18,131,3773,65,66,2382.74,4418.01,0.00
2024-12-10 17:20:18,130,3773,64,66,2398.04,4418.07,0.00
2024-12-10 17:20:18,130,3774,64,66,2420.79,4419.00,0.00
2024-12-10 17:20:18,131,3774,65,66,2402.31,4419.01,0.00
2024-12-10 17:20:18,130,3774,65,65,2417.75,4419.07,0.00
2024-12-10 17:20:18,130,3775,65,65,2406.11,4420.00,0.00
2024-12-10 17:20:18,131,3775,66,65,2387.75,4420.01,0.00
2024-12-10 17:20:18,130,3775,66,64,2403.08,4420.07,0.00
2024-12-10 17:20:18,129,3775,65,64,2394.30,4420.68,0.00
2024-12-10 17:20:18,129,3776,65,64,2413.03,4421.00,0.00
2024-12-10 17:20:18,130,3776,66,64,2394.47,4421.01,0.00
2024-12-10 17:20:18,129,3776,65,64,2409.97,4421.07,0.00
2024-12-10 17:20:18,129,3777,65,64,2400.74,4422.00,0.00
2024-12-10 17:20:18,130,3777,66,64,2382.27,4422.01,0.00
2024-12-10 17:20:18,129,3777,66,63,2397.68,4422.07,0.00
2024-12-10 17:20:18,130,3776,66,64,2363.35,4422.45,0.00
2024-12-10 17:20:18,130,3777,66,64,2388.63,4423.00,0.00
2024-12-10 17:20:18,131,3777,66,65,2370.39,4423.01,0.00
2024-12-10 17:20:18,131,3778,66,65,2390.60,4424.00,0.00
2024-12-10 17:20:18,132,3778,66,66,2372.49,4424.01,0.00
2024-12-10 17:20:18,131,3778,66,65,2387.58,4424.07,0.00
2024-12-10 17:20:18,131,3779,66,65,2376.14,4425.00,0.00
2024-12-10 17:20:18,132,3779,67,65,2358.14,4425.01,0.00
2024-12-10 17:20:18,131,3779,66,65,2373.12,4425.07,0.00
2024-12-10 17:20:18,130,3779,65,65,2354.25,4425.85,0.00
2024-12-10 17:20:18,131,3778,65,66,2332.30,4425.95,0.00
2024-12-10 17:20:18,131,3779,65,66,2365.80,4426.00,0.00
2024-12-10 17:20:18,132,3779,66,66,2347.88,4426.01,0.00
2024-12-10 17:20:18,131,3779,65,66,2365.13,4426.02,0.00
2024-12-10 17:20:18,130,3779,64,66,2380.96,4426.06,0.00
2024-12-10 17:20:18,129,3779,64,65,2399.07,4426.06,0.00
2024-12-10 17:20:18,129,3780,64,65,2422.30,4427.00,0.00
2024-12-10 17:20:18,130,3780,65,65,2403.67,4427.01,0.00
2024-12-10 17:20:18,129,3780,65,64,2419.57,4427.06,0.00
2024-12-10 17:20:18,128,3780,64,64,2420.50,4427.46,0.00
2024-12-10 17:20:18,128,3781,64,64,2427.54,4428.00,0.00
2024-12-10 17:20:18,129,3781,64,65,2408.72,4428.01,0.00
2024-12-10 17:20:18,129,3782,64,65,2395.38,4429.00,0.00
2024-12-10 17:20:18,130,3782,65,65,2376.95,4429.01,0.00
2024-12-10 17:20:18,129,3782,65,64,2366.12,4429.66,0.00
2024-12-10 17:20:18,129,3783,65,64,2385.63,4430.00,0.00
2024-12-10 17:20:18,130,3783,65,65,2367.27,4430.01,0.00
2024-12-10 17:20:18,130,3784,65,65,2357.20,4431.00,0.00
2024-12-10 17:20:18,131,3784,66,65,2339.21,4431.01,0.00
2024-12-10 17:20:18,130,3784,65,65,2353.48,4431.08,0.00
2024-12-10 17:20:18,129,3784,65,64,2370.93,4431.10,0.00
2024-12-10 17:20:18,129,3785,65,64,2365.56,4432.00,0.00
2024-12-10 17:20:18,130,3785,66,64,2347.36,4432.01,0.00
2024-12-10 17:20:18,129,3785,65,64,2361.81,4432.09,0.00
2024-12-10 17:20:18,130,3784,65,65,2338.46,4432.20,0.00
2024-12-10 17:20:18,130,3785,65,65,2366.57,4433.00,0.00
2024-12-10 17:20:18,131,3785,65,66,2348.50,4433.01,0.00
2024-12-10 17:20:18,130,3785,64,66,2362.84,4433.08,0.00
2024-12-10 17:20:18,131,3784,64,67,2318.45,4433.66,0.00
2024-12-10 17:20:18,131,3785,64,67,2383.36,4434.00,0.00
2024-12-10 17:20:18,132,3785,64,68,2365.31,4434.01,0.00
2024-12-10 17:20:19,133,3784,65,68,2331.51,4434.33,0.00
2024-12-10 17:20:19,134,3783,66,68,2328.77,4434.54,0.00
2024-12-10 17:20:19,134,3784,66,68,2391.34,4435.00,0.00
2024-12-10 17:20:19,135,3784,67,68,2373.62,4435.01,0.00
2024-12-10 17:20:19,134,3784,67,67,2387.72,4435.08,0.00
2024-12-10 17:20:19,133,3784,66,67,2403.24,4435.13,0.00
2024-12-10 17:20:19,132,3784,65,67,2421.07,4435.14,0.00
2024-12-10 17:20:19,133,3783,66,67,2399.55,4435.23,0.00
2024-12-10 17:20:19,133,3784,66,67,2492.76,4436.00,0.00
2024-12-10 17:20:19,134,3784,66,68,2474.16,4436.01,0.00
2024-12-10 17:20:19,133,3784,66,67,2489.12,4436.08,0.00
2024-12-10 17:20:19,133,3785,66,67,2515.58,4437.00,0.00
2024-12-10 17:20:19,134,3785,67,67,2496.81,4437.01,0.00
2024-12-10 17:20:19,133,3785,67,66,2511.94,4437.08,0.00
2024-12-10 17:20:19,133,3786,67,66,2504.94,4438.00,0.00
2024-12-10 17:20:19,134,3786,67,67,2486.25,4438.01,0.00
2024-12-10 17:20:19,134,3787,67,67,2475.56,4439.00,0.00
2024-12-10 17:20:19,135,3787,68,67,2457.22,4439.01,0.00
2024-12-10 17:20:19,134,3787,67,67,2471.61,4439.09,0.00
2024-12-10 17:20:19,134,3788,67,67,2464.36,4440.00,0.00
2024-12-10 17:20:19,135,3788,67,68,2446.11,4440.01,0.00
2024-12-10 17:20:19,134,3788,67,67,2460.41,4440.09,0.00
2024-12-10 17:20:19,134,3789,67,67,2452.97,4441.00,0.00
2024-12-10 17:20:19,135,3789,67,68,2434.80,4441.01,0.00
2024-12-10 17:20:19,134,3789,67,67,2449.02,4441.09,0.00
2024-12-10 17:20:19,134,3790,67,67,2441.40,4442.00,0.00
2024-12-10 17:20:19,135,3790,67,68,2423.31,4442.01,0.00
2024-12-10 17:20:19,135,3791,67,68,2411.24,4443.00,0.00
2024-12-10 17:20:19,136,3791,68,68,2393.51,4443.01,0.00
2024-12-10 17:20:19,135,3791,67,68,2410.26,4443.02,0.00
2024-12-10 17:20:19,134,3791,66,68,2425.28,4443.08,0.00
2024-12-10 17:20:19,134,3792,66,68,2415.83,4444.00,0.00
2024-12-10 17:20:19,135,3792,67,68,2397.93,4444.01,0.00
2024-12-10 17:20:19,134,3792,67,67,2412.20,4444.08,0.00
2024-12-10 17:20:19,135,3791,67,68,2358.18,4444.84,0.00
2024-12-10 17:20:19,135,3792,67,68,2389.61,4445.00,0.00
2024-12-10 17:20:19,136,3792,67,69,2372.04,4445.01,0.00
2024-12-10 17:20:19,136,3793,67,69,2388.39,4446.00,0.00
2024-12-10 17:20:19,137,3793,68,69,2370.95,4446.01,0.00
2024-12-10 17:20:19,136,3793,67,69,2387.73,4446.02,0.00
2024-12-10 17:20:19,136,3794,67,69,2369.25,4447.00,0.00
2024-12-10 17:20:19,137,3794,68,69,2351.96,4447.01,0.00
2024-12-10 17:20:19,136,3794,67,69,2365.36,4447.09,0.00
2024-12-10 17:20:19,135,3794,67,68,2360.82,4447.50,0.00
2024-12-10 17:20:19,135,3795,67,68,2369.61,4448.00,0.00
2024-12-10 17:20:19,136,3795,68,68,2352.19,4448.01,0.00
2024-12-10 17:20:19,135,3795,68,67,2365.69,4448.09,0.00
2024-12-10 17:20:19,135,3796,68,67,2352.62,4449.00,0.00
2024-12-10 17:20:19,136,3796,68,68,2335.32,4449.01,0.00
2024-12-10 17:20:19,135,3796,68,67,2348.69,4449.09,0.00
2024-12-10 17:20:19,135,3797,68,67,2334.78,4450.00,0.00
2024-12-10 17:20:19,136,3797,68,68,2317.61,4450.01,0.00
2024-12-10 17:20:19,135,3797,68,67,2330.85,4450.09,0.00
2024-12-10 17:20:19,134,3797,67,67,2344.59,4450.14,0.00
2024-12-10 17:20:19,134,3798,67,67,2334.04,4451.00,0.00
2024-12-10 17:20:19,135,3798,68,67,2316.75,4451.01,0.00
2024-12-10 17:20:19,134,3798,68,66,2330.08,4451.09,0.00
2024-12-10 17:20:19,133,3798,68,65,2320.42,4451.56,0.00
2024-12-10 17:20:19,133,3799,68,65,2334.81,4452.00,0.00
2024-12-10 17:20:19,134,3799,69,65,2317.39,4452.01,0.00
2024-12-10 17:20:19,133,3799,68,65,2330.82,4452.09,0.00
2024-12-10 17:20:19,132,3799,67,65,2348.14,4452.09,0.00
2024-12-10 17:20:19,131,3799,67,64,2356.77,4452.29,0.00
2024-12-10 17:20:19,131,3800,67,64,2356.61,4453.00,0.00
2024-12-10 17:20:19,132,3800,67,65,2338.76,4453.01,0.00
2024-12-10 17:20:19,131,3800,67,64,2336.91,4453.44,0.00
2024-12-10 17:20:19,131,3801,67,64,2346.48,4454.00,0.00
2024-12-10 17:20:19,132,3801,68,64,2328.71,4454.01,0.00
2024-12-10 17:20:19,132,3802,68,64,2318.77,4455.00,0.00
2024-12-10 17:20:19,133,3802,69,64,2301.33,4455.01,0.00
2024-12-10 17:20:19,132,3802,69,63,2314.07,4455.11,0.00
2024-12-10 17:20:19,132,3803,69,63,2308.48,4456.00,0.00
2024-12-10 17:20:19,133,3803,69,64,2291.13,4456.01,0.00
2024-12-10 17:20:19,132,3803,68,64,2303.79,4456.11,0.00
2024-12-10 17:20:19,132,3804,68,64,2298.20,4457.00,0.00
2024-12-10 17:20:19,133,3804,68,65,2280.92,4457.01,0.00
2024-12-10 17:20:19,132,3804,67,65,2297.19,4457.02,0.00
2024-12-10 17:20:19,131,3804,66,65,2311.01,4457.10,0.00
2024-12-10 17:20:19,131,3805,66,65,2305.37,4458.00,0.00
2024-12-10 17:20:19,132,3805,67,65,2287.91,4458.01,0.00
2024-12-10 17:20:19,131,3805,66,65,2300.98,4458.10,0.00
2024-12-10 17:20:19,131,3806,66,65,2295.34,4459.00,0.00
2024-12-10 17:20:19,132,3806,66,66,2277.95,4459.01,0.00
2024-12-10 17:20:19,131,3806,65,66,2290.94,4459.10,0.00
2024-12-10 17:20:19,131,3807,65,66,2285.30,4460.00,0.00
2024-12-10 17:20:19,132,3807,66,66,2267.98,4460.01,0.00
2024-12-10 17:20:19,131,3807,65,66,2280.90,4460.10,0.00
2024-12-10 17:20:19,131,3808,65,66,2275.25,4461.00,0.00
2024-12-10 17:20:19,132,3808,65,67,2258.02,4461.01,0.00
2024-12-10 17:20:19,131,3808,64,67,2270.85,4461.10,0.00
2024-12-10 17:20:19,131,3809,64,67,2265.20,4462.00,0.00
2024-12-10 17:20:20,132,3809,64,68,2248.04,4462.01,0.00
2024-12-10 17:20:20,131,3809,64,67,2260.80,4462.10,0.00
2024-12-10 17:20:20,131,3810,64,67,2255.15,4463.00,0.00
2024-12-10 17:20:20,132,3810,64,68,2238.07,4463.01,0.00
2024-12-10 17:20:20,131,3810,64,67,2254.13,4463.02,0.00
2024-12-10 17:20:20,131,3811,64,67,2245.09,4464.00,0.00
2024-12-10 17:20:20,132,3811,65,67,2228.08,4464.01,0.00
2024-12-10 17:20:20,131,3811,65,66,2240.02,4464.12,0.00
2024-12-10 17:20:20,131,3812,65,66,2235.03,4465.00,0.00
2024-12-10 17:20:20,132,3812,65,67,2218.10,4465.01,0.00
2024-12-10 17:20:20,132,3813,65,67,2208.11,4466.00,0.00
2024-12-10 17:20:20,133,3813,66,67,2191.50,4466.01,0.00
2024-12-10 17:20:20,132,3813,65,67,2206.42,4466.04,0.00
2024-12-10 17:20:20,131,3813,65,66,2219.54,4466.12,0.00
2024-12-10 17:20:20,131,3814,65,66,2214.55,4467.00,0.00
2024-12-10 17:20:20,132,3814,66,66,2197.77,4467.01,0.00
2024-12-10 17:20:20,132,3815,66,66,2187.77,4468.00,0.00
2024-12-10 17:20:20,133,3815,66,67,2171.32,4468.01,0.00
2024-12-10 17:20:20,133,3816,66,67,2161.05,4469.00,0.00
2024-12-10 17:20:20,134,3816,66,68,2144.93,4469.01,0.00
2024-12-10 17:20:20,133,3816,66,67,2155.05,4469.14,0.00
2024-12-10 17:20:20,133,3817,66,67,2150.45,4470.00,0.00
2024-12-10 17:20:20,134,3817,66,68,2134.40,4470.01,0.00
2024-12-10 17:20:20,133,3817,65,68,2149.10,4470.03,0.00
2024-12-10 17:20:20,132,3817,65,67,2160.68,4470.13,0.00
2024-12-10 17:20:20,131,3817,65,66,2176.83,4470.13,0.00
2024-12-10 17:20:20,131,3818,65,66,2172.50,4471.00,0.00
2024-12-10 17:20:20,132,3818,65,67,2156.04,4471.01,0.00
2024-12-10 17:20:20,131,3818,64,67,2172.16,4471.01,0.00
2024-12-10 17:20:20,130,3818,64,66,2183.41,4471.12,0.00
2024-12-10 17:20:20,130,3819,64,66,2179.04,4472.00,0.00
2024-12-10 17:20:20,131,3819,64,67,2162.41,4472.01,0.00
2024-12-10 17:20:20,130,3819,63,67,2173.57,4472.12,0.00
2024-12-10 17:20:20,130,3820,63,67,2169.21,4473.00,0.00
2024-12-10 17:20:20,131,3820,64,67,2152.65,4473.01,0.00
2024-12-10 17:20:20,130,3820,63,67,2163.74,4473.12,0.00
2024-12-10 17:20:20,130,3821,63,67,2159.37,4474.00,0.00
2024-12-10 17:20:20,131,3821,64,67,2142.88,4474.01,0.00
2024-12-10 17:20:20,130,3821,64,66,2153.89,4474.12,0.00
2024-12-10 17:20:20,130,3822,64,66,2149.52,4475.00,0.00
2024-12-10 17:20:20,131,3822,64,67,2133.11,4475.01,0.00
2024-12-10 17:20:20,131,3823,64,67,2123.34,4476.00,0.00
2024-12-10 17:20:20,132,3823,65,67,2107.25,4476.01,0.00
2024-12-10 17:20:20,131,3823,64,67,2117.91,4476.12,0.00
2024-12-10 17:20:20,131,3824,64,67,2113.22,4477.00,0.00
2024-12-10 17:20:20,132,3824,65,67,2097.21,4477.01,0.00
2024-12-10 17:20:20,131,3824,65,66,2109.48,4477.08,0.00
2024-12-10 17:20:20,130,3824,64,66,2124.00,4477.12,0.00
2024-12-10 17:20:20,129,3824,64,65,2140.11,4477.12,0.00
2024-12-10 17:20:20,129,3825,64,65,2135.23,4478.00,0.00
2024-12-10 17:20:20,130,3825,64,66,2118.81,4478.01,0.00
2024-12-10 17:20:20,129,3825,63,66,2130.06,4478.12,0.00
2024-12-10 17:20:20,128,3825,63,65,2146.47,4478.12,0.00
2024-12-10 17:20:20,128,3826,63,65,2142.37,4479.00,0.00
2024-12-10 17:20:20,129,3826,64,65,2125.76,4479.01,0.00
2024-12-10 17:20:20,129,3827,64,65,2116.51,4480.00,0.00
2024-12-10 17:20:20,130,3827,65,65,2100.23,4480.01,0.00
2024-12-10 17:20:20,129,3827,65,64,2111.33,4480.12,0.00
2024-12-10 17:20:20,129,3828,65,64,2106.91,4481.00,0.00
2024-12-10 17:20:20,130,3828,65,65,2090.70,4481.01,0.00
2024-12-10 17:20:20,129,3828,65,64,2106.56,4481.01,0.00
2024-12-10 17:20:20,128,3828,64,64,2118.15,4481.11,0.00
2024-12-10 17:20:20,127,3828,63,64,2134.47,4481.11,0.00
2024-12-10 17:20:20,127,3829,63,64,2130.33,4482.00,0.00
2024-12-10 17:20:20,128,3829,64,64,2113.69,4482.01,0.00
2024-12-10 17:20:20,127,3829,64,63,2129.63,4482.02,0.00
2024-12-10 17:20:20,126,3829,64,62,2142.29,4482.10,0.00
2024-12-10 17:20:20,125,3829,63,62,2159.07,4482.10,0.00
2024-12-10 17:20:20,125,3830,63,62,2155.22,4483.00,0.00
2024-12-10 17:20:20,126,3830,63,63,2138.11,4483.01,0.00
2024-12-10 17:20:20,126,3831,63,63,2129.69,4484.00,0.00
2024-12-10 17:20:20,127,3831,64,63,2112.92,4484.01,0.00
2024-12-10 17:20:20,126,3831,64,62,2124.74,4484.11,0.00
2024-12-10 17:20:20,125,3831,63,62,2139.36,4484.16,0.00
2024-12-10 17:20:20,125,3832,63,62,2138.01,4485.00,0.00
2024-12-10 17:20:20,126,3832,64,62,2121.05,4485.01,0.00
2024-12-10 17:20:20,125,3832,64,61,2133.02,4485.11,0.00
2024-12-10 17:20:20,125,3833,64,61,2129.48,4486.00,0.00
2024-12-10 17:20:20,126,3833,64,62,2112.58,4486.01,0.00
2024-12-10 17:20:20,125,3833,63,62,2128.41,4486.02,0.00
2024-12-10 17:20:20,124,3833,62,62,2141.26,4486.11,0.00
2024-12-10 17:20:20,124,3834,62,62,2137.60,4487.00,0.00
2024-12-10 17:20:20,125,3834,63,62,2120.50,4487.01,0.00
2024-12-10 17:20:20,124,3834,63,61,2132.57,4487.11,0.00
2024-12-10 17:20:20,124,3835,63,61,2128.46,4488.00,0.00
2024-12-10 17:20:20,125,3835,64,61,2111.43,4488.01,0.00
2024-12-10 17:20:20,126,3834,64,62,2091.49,4488.10,0.00
2024-12-10 17:20:20,125,3834,63,62,2139.47,4488.12,0.00
2024-12-10 17:20:20,125,3835,63,62,2134.93,4489.00,0.00
2024-12-10 17:20:20,126,3835,64,62,2117.99,4489.01,0.00
2024-12-10 17:20:20,125,3835,64,61,2129.94,4489.11,0.00
2024-12-10 17:20:20,125,3836,64,61,2160.69,4490.00,0.00
2024-12-10 17:20:20,126,3836,64,62,2143.54,4490.01,0.00
2024-12-10 17:20:20,125,3836,63,62,2151.17,4490.21,0.00
2024-12-10 17:20:21,125,3837,63,62,2150.80,4491.00,0.00
2024-12-10 17:20:21,126,3837,63,63,2133.73,4491.01,0.00
2024-12-10 17:20:21,126,3838,63,63,2124.35,4492.00,0.00
2024-12-10 17:20:21,127,3838,63,64,2107.62,4492.01,0.00
2024-12-10 17:20:21,127,3839,63,64,2098.02,4493.00,0.00
2024-12-10 17:20:21,128,3839,63,65,2081.63,4493.01,0.00
2024-12-10 17:20:21,127,3839,62,65,2097.67,4493.01,0.00
2024-12-10 17:20:21,126,3839,62,64,2109.36,4493.11,0.00
2024-12-10 17:20:21,126,3840,62,64,2103.66,4494.00,0.00
2024-12-10 17:20:21,127,3840,62,65,2087.10,4494.01,0.00
2024-12-10 17:20:21,126,3840,62,64,2095.24,4494.17,0.00
2024-12-10 17:20:21,126,3841,62,64,2090.73,4495.00,0.00
2024-12-10 17:20:21,127,3841,63,64,2074.27,4495.01,0.00
2024-12-10 17:20:21,126,3841,63,63,2085.77,4495.11,0.00
2024-12-10 17:20:21,125,3841,63,62,2093.91,4495.23,0.00
2024-12-10 17:20:21,125,3842,63,62,2093.28,4496.00,0.00
2024-12-10 17:20:21,126,3842,64,62,2076.66,4496.01,0.00
2024-12-10 17:20:21,125,3842,63,62,2088.27,4496.11,0.00
2024-12-10 17:20:21,124,3842,63,61,2104.75,4496.11,0.00
2024-12-10 17:20:21,124,3843,63,61,2096.79,4497.00,0.00
2024-12-10 17:20:21,125,3843,63,62,2080.02,4497.01,0.00
2024-12-10 17:20:21,125,3844,63,62,2066.63,4498.00,0.00
2024-12-10 17:20:21,126,3844,63,63,2050.23,4498.01,0.00
2024-12-10 17:20:21,125,3844,62,63,2061.26,4498.12,0.00
2024-12-10 17:20:21,124,3844,62,62,2076.95,4498.14,0.00
2024-12-10 17:20:21,123,3844,62,61,2078.49,4498.44,0.00
2024-12-10 17:20:21,123,3845,62,61,2090.20,4499.00,0.00
2024-12-10 17:20:21,124,3845,63,61,2073.34,4499.01,0.00
2024-12-10 17:20:21,123,3845,63,60,2084.74,4499.12,0.00
2024-12-10 17:20:21,122,3845,63,59,2095.31,4499.22,0.00
2024-12-10 17:20:21,122,3846,63,59,2097.59,4500.00,0.00
2024-12-10 17:20:21,123,3846,64,59,2080.53,4500.01,0.00
2024-12-10 17:20:21,122,3846,63,59,2092.08,4500.12,0.00
2024-12-10 17:20:21,122,3847,63,59,2089.94,4501.00,0.00
2024-12-10 17:20:21,123,3847,63,60,2072.94,4501.01,0.00
2024-12-10 17:20:21,122,3847,62,60,2088.47,4501.03,0.00
2024-12-10 17:20:21,122,3848,62,60,2082.28,4502.00,0.00
2024-12-10 17:20:21,123,3848,62,61,2065.35,4502.01,0.00
2024-12-10 17:20:21,122,3848,61,61,2077.14,4502.12,0.00
2024-12-10 17:20:21,122,3849,61,61,2074.62,4503.00,0.00
2024-12-10 17:20:21,123,3849,62,61,2057.76,4503.01,0.00
2024-12-10 17:20:21,122,3849,61,61,2072.13,4503.06,0.00
2024-12-10 17:20:21,122,3850,61,61,2067.04,4504.00,0.00
2024-12-10 17:20:21,123,3850,61,62,2050.23,4504.01,0.00
2024-12-10 17:20:21,122,3850,60,62,2062.26,4504.11,0.00
2024-12-10 17:20:21,122,3851,60,62,2059.37,4505.00,0.00
2024-12-10 17:20:21,123,3851,61,62,2042.63,4505.01,0.00
2024-12-10 17:20:21,122,3851,61,61,2056.44,4505.07,0.00
2024-12-10 17:20:21,121,3851,60,61,2071.58,4505.10,0.00
2024-12-10 17:20:21,121,3852,60,61,2068.66,4506.00,0.00
2024-12-10 17:20:21,122,3852,61,61,2051.71,4506.01,0.00
2024-12-10 17:20:21,121,3852,60,61,2064.22,4506.10,0.00
2024-12-10 17:20:21,122,3851,61,61,2017.61,4506.78,0.00
2024-12-10 17:20:21,122,3852,61,61,2054.38,4507.00,0.00
2024-12-10 17:20:21,123,3852,61,62,2037.68,4507.01,0.00
2024-12-10 17:20:21,122,3852,61,61,2049.97,4507.10,0.00
2024-12-10 17:20:21,122,3853,61,61,2083.66,4508.00,0.00
2024-12-10 17:20:21,123,3853,62,61,2066.72,4508.01,0.00
2024-12-10 17:20:21,122,3853,62,60,2079.24,4508.10,0.00
2024-12-10 17:20:21,122,3854,62,60,2075.99,4509.00,0.00
2024-12-10 17:20:21,123,3854,63,60,2059.11,4509.01,0.00
2024-12-10 17:20:21,122,3854,63,59,2071.57,4509.10,0.00
2024-12-10 17:20:21,122,3855,63,59,2068.31,4510.00,0.00
2024-12-10 17:20:21,123,3855,64,59,2051.50,4510.01,0.00
2024-12-10 17:20:21,122,3855,63,59,2063.90,4510.10,0.00
2024-12-10 17:20:21,122,3856,63,59,2060.64,4511.00,0.00
2024-12-10 17:20:21,123,3856,64,59,2043.89,4511.01,0.00
2024-12-10 17:20:21,123,3857,64,59,2036.27,4512.00,0.00
2024-12-10 17:20:21,124,3857,64,60,2019.85,4512.01,0.00
2024-12-10 17:20:21,123,3857,63,60,2031.88,4512.10,0.00
2024-12-10 17:20:21,123,3858,63,60,2028.28,4513.00,0.00
2024-12-10 17:20:21,124,3858,63,61,2011.92,4513.01,0.00
2024-12-10 17:20:21,123,3858,62,61,2024.63,4513.08,0.00
2024-12-10 17:20:21,122,3858,61,61,2040.48,4513.09,0.00
2024-12-10 17:20:21,121,3858,61,60,2056.97,4513.09,0.00
2024-12-10 17:20:21,121,3859,61,60,2053.68,4514.00,0.00
2024-12-10 17:20:21,122,3859,61,61,2036.85,4514.01,0.00
2024-12-10 17:20:21,121,3859,60,61,2051.82,4514.04,0.00
2024-12-10 17:20:21,120,3859,59,61,2066.67,4514.08,0.00
2024-12-10 17:20:21,121,3858,59,62,2018.35,4514.79,0.00
2024-12-10 17:20:21,121,3859,59,62,2055.48,4515.00,0.00
2024-12-10 17:20:21,122,3859,59,63,2038.63,4515.01,0.00
2024-12-10 17:20:21,121,3859,59,62,2055.10,4515.01,0.00
2024-12-10 17:20:21,120,3859,59,61,2068.86,4515.08,0.00
2024-12-10 17:20:21,119,3859,58,61,2085.86,4515.08,0.00
2024-12-10 17:20:21,119,3860,58,61,2119.89,4516.00,0.00
2024-12-10 17:20:21,120,3860,58,62,2102.23,4516.01,0.00
2024-12-10 17:20:21,119,3860,58,61,2116.49,4516.08,0.00
2024-12-10 17:20:21,119,3861,58,61,2113.15,4517.00,0.00
2024-12-10 17:20:21,120,3861,59,61,2095.54,4517.01,0.00
2024-12-10 17:20:21,119,3861,58,61,2110.50,4517.06,0.00
2024-12-10 17:20:21,118,3861,57,61,2127.63,4517.07,0.00
2024-12-10 17:20:21,117,3861,57,60,2145.42,4517.07,0.00
2024-12-10 17:20:21,117,3862,57,60,2142.41,4518.00,0.00
2024-12-10 17:20:21,118,3862,58,60,2124.25,4518.01,0.00
2024-12-10 17:20:21,118,3863,58,60,2118.21,4519.00,0.00
2024-12-10 17:20:21,119,3863,58,61,2100.41,4519.01,0.00
2024-12-10 17:20:21,118,3863,57,61,2114.78,4519.08,0.00
2024-12-10 17:20:22,118,3864,57,61,2111.54,4520.00,0.00
2024-12-10 17:20:22,119,3864,58,61,2093.80,4520.01,0.00
2024-12-10 17:20:22,118,3864,57,61,2108.11,4520.08,0.00
2024-12-10 17:20:22,117,3864,57,60,2125.32,4520.09,0.00
2024-12-10 17:20:22,117,3865,57,60,2122.76,4521.00,0.00
2024-12-10 17:20:22,118,3865,57,61,2104.77,4521.01,0.00
2024-12-10 17:20:22,117,3865,56,61,2119.30,4521.08,0.00
2024-12-10 17:20:22,118,3864,57,61,2089.12,4521.36,0.00
2024-12-10 17:20:22,118,3865,57,61,2125.52,4522.00,0.00
2024-12-10 17:20:22,119,3865,57,62,2107.66,4522.01,0.00
2024-12-10 17:20:22,118,3865,57,61,2123.99,4522.03,0.00
2024-12-10 17:20:22,117,3865,56,61,2140.22,4522.07,0.00
2024-12-10 17:20:22,117,3866,56,61,2174.20,4523.00,0.00
2024-12-10 17:20:22,118,3866,56,62,2155.77,4523.01,0.00
2024-12-10 17:20:22,117,3866,56,61,2170.82,4523.07,0.00
2024-12-10 17:20:22,117,3867,56,61,2165.69,4524.00,0.00
2024-12-10 17:20:22,118,3867,56,62,2147.34,4524.01,0.00
2024-12-10 17:20:22,117,3867,56,61,2161.02,4524.07,0.00
2024-12-10 17:20:22,117,3868,56,61,2155.45,4525.00,0.00
2024-12-10 17:20:22,118,3868,57,61,2137.19,4525.01,0.00
2024-12-10 17:20:22,117,3868,56,61,2150.05,4525.05,0.00
2024-12-10 17:20:22,116,3868,56,60,2168.19,4525.05,0.00
2024-12-10 17:20:22,115,3868,55,60,2186.65,4525.05,0.00
2024-12-10 17:20:22,114,3868,55,59,2205.44,4525.05,0.00
2024-12-10 17:20:22,114,3869,55,59,2199.78,4526.00,0.00
2024-12-10 17:20:22,115,3869,56,59,2180.65,4526.01,0.00
2024-12-10 17:20:22,116,3868,57,59,2134.52,4526.61,0.00
2024-12-10 17:20:22,116,3869,57,59,2168.85,4527.00,0.00
2024-12-10 17:20:22,117,3869,58,59,2150.31,4527.01,0.00
2024-12-10 17:20:22,116,3869,58,58,2167.03,4527.04,0.00
2024-12-10 17:20:22,115,3869,57,58,2185.09,4527.05,0.00
2024-12-10 17:20:22,115,3870,57,58,2217.15,4528.00,0.00
2024-12-10 17:20:22,116,3870,58,58,2198.03,4528.01,0.00
2024-12-10 17:20:22,115,3870,58,57,2214.79,4528.05,0.00
2024-12-10 17:20:22,115,3871,58,57,2206.76,4529.00,0.00
2024-12-10 17:20:22,116,3871,58,58,2187.74,4529.01,0.00
2024-12-10 17:20:22,115,3871,57,58,2204.40,4529.05,0.00
2024-12-10 17:20:22,115,3872,57,58,2195.71,4530.00,0.00
2024-12-10 17:20:22,116,3872,57,59,2176.79,4530.01,0.00
2024-12-10 17:20:22,115,3872,57,58,2193.36,4530.05,0.00
2024-12-10 17:20:22,114,3872,57,57,2185.75,4530.65,0.00
2024-12-10 17:20:22,114,3873,57,57,2206.93,4531.00,0.00
2024-12-10 17:20:22,115,3873,58,57,2187.74,4531.01,0.00
2024-12-10 17:20:22,114,3873,57,57,2204.55,4531.05,0.00
2024-12-10 17:20:22,114,3874,57,57,2198.13,4532.00,0.00
2024-12-10 17:20:22,115,3874,58,57,2179.02,4532.01,0.00
2024-12-10 17:20:22,114,3874,58,56,2197.73,4532.01,0.00
2024-12-10 17:20:22,113,3874,57,56,2215.18,4532.04,0.00
2024-12-10 17:20:22,112,3874,57,55,2234.56,4532.04,0.00
2024-12-10 17:20:22,113,3873,57,56,2191.27,4532.58,0.00
2024-12-10 17:20:22,113,3874,57,56,2225.56,4533.00,0.00
2024-12-10 17:20:22,114,3874,58,56,2206.04,4533.01,0.00
2024-12-10 17:20:22,113,3874,58,55,2223.56,4533.04,0.00
2024-12-10 17:20:22,114,3873,59,55,2177.22,4533.66,0.00
2024-12-10 17:20:22,114,3874,59,55,2249.31,4534.00,0.00
2024-12-10 17:20:22,115,3874,60,55,2229.75,4534.01,0.00
2024-12-10 17:20:22,114,3874,59,55,2248.52,4534.02,0.00
2024-12-10 17:20:22,113,3874,59,54,2267.22,4534.04,0.00
2024-12-10 17:20:22,112,3874,58,54,2287.06,4534.04,0.00
2024-12-10 17:20:22,111,3874,57,54,2307.25,4534.04,0.00
2024-12-10 17:20:22,110,3874,57,53,2292.60,4534.66,0.00
2024-12-10 17:20:22,110,3875,57,53,2360.07,4535.00,0.00
2024-12-10 17:20:22,111,3875,58,53,2338.80,4535.01,0.00
2024-12-10 17:20:22,110,3875,58,52,2359.65,4535.01,0.00
2024-12-10 17:20:22,109,3875,57,52,2380.06,4535.03,0.00
2024-12-10 17:20:22,108,3875,56,52,2401.68,4535.03,0.00
2024-12-10 17:20:22,108,3876,56,52,2397.74,4536.00,0.00
2024-12-10 17:20:22,109,3876,56,53,2375.74,4536.01,0.00
2024-12-10 17:20:22,108,3876,56,52,2396.49,4536.03,0.00
2024-12-10 17:20:22,108,3877,56,52,2392.78,4537.00,0.00
2024-12-10 17:20:22,109,3877,57,52,2370.83,4537.01,0.00
2024-12-10 17:20:22,108,3877,56,52,2391.52,4537.03,0.00
2024-12-10 17:20:22,109,3876,57,52,2327.05,4537.94,0.00
2024-12-10 17:20:22,109,3877,57,52,2367.91,4538.00,0.00
2024-12-10 17:20:22,110,3877,58,52,2346.38,4538.01,0.00
2024-12-10 17:20:22,109,3877,58,51,2366.67,4538.03,0.00
2024-12-10 17:20:22,109,3878,58,51,2403.27,4539.00,0.00
2024-12-10 17:20:22,110,3878,58,52,2381.42,4539.01,0.00
2024-12-10 17:20:22,109,3878,57,52,2402.03,4539.03,0.00
2024-12-10 17:20:22,109,3879,57,52,2396.76,4540.00,0.00
2024-12-10 17:20:22,110,3879,58,52,2374.97,4540.01,0.00
2024-12-10 17:20:22,109,3879,58,51,2395.51,4540.03,0.00
2024-12-10 17:20:22,109,3880,58,51,2389.64,4541.00,0.00
2024-12-10 17:20:22,110,3880,58,52,2367.92,4541.01,0.00
2024-12-10 17:20:22,109,3880,58,51,2388.40,4541.03,0.00
2024-12-10 17:20:22,109,3881,58,51,2381.70,4542.00,0.00
2024-12-10 17:20:22,110,3881,59,51,2360.05,4542.01,0.00
2024-12-10 17:20:22,109,3881,59,50,2380.46,4542.03,0.00
2024-12-10 17:20:22,109,3882,59,50,2372.85,4543.00,0.00
2024-12-10 17:20:22,110,3882,59,51,2351.28,4543.01,0.00
2024-12-10 17:20:22,109,3882,58,51,2371.60,4543.03,0.00
2024-12-10 17:20:22,108,3882,58,50,2392.47,4543.05,0.00
2024-12-10 17:20:22,107,3882,57,50,2387.17,4543.55,0.00
2024-12-10 17:20:22,107,3883,57,50,2409.60,4544.00,0.00
2024-12-10 17:20:22,108,3883,57,51,2387.29,4544.01,0.00
2024-12-10 17:20:22,107,3883,56,51,2408.76,4544.02,0.00
2024-12-10 17:20:22,106,3883,55,51,2431.05,4544.02,0.00
2024-12-10 17:20:22,105,3883,55,50,2453.77,4544.02,0.00
2024-12-10 17:20:22,105,3884,55,50,2448.58,4545.00,0.00
2024-12-10 17:20:22,106,3884,55,51,2425.48,4545.01,0.00
2024-12-10 17:20:22,106,3885,55,51,2418.56,4546.00,0.00
2024-12-10 17:20:22,107,3885,55,52,2395.96,4546.01,0.00
2024-12-10 17:20:23,106,3885,54,52,2417.71,4546.02,0.00
2024-12-10 17:20:23,106,3886,54,52,2410.23,4547.00,0.00
2024-12-10 17:20:23,107,3886,54,53,2387.70,4547.01,0.00
2024-12-10 17:20:23,106,3886,53,53,2409.37,4547.02,0.00
2024-12-10 17:20:23,105,3886,53,52,2411.30,4547.43,0.00
2024-12-10 17:20:23,105,3887,53,52,2426.61,4548.00,0.00
2024-12-10 17:20:23,106,3887,53,53,2403.72,4548.01,0.00
2024-12-10 17:20:23,106,3888,53,53,2399.35,4549.00,0.00
2024-12-10 17:20:23,107,3888,53,54,2376.93,4549.01,0.00
2024-12-10 17:20:23,106,3888,53,53,2398.08,4549.03,0.00
2024-12-10 17:20:23,106,3889,53,53,2394.07,4550.00,0.00
2024-12-10 17:20:23,107,3889,54,53,2371.70,4550.01,0.00
2024-12-10 17:20:23,106,3889,54,52,2392.79,4550.03,0.00
2024-12-10 17:20:23,105,3889,53,52,2393.42,4550.45,0.00
2024-12-10 17:20:23,105,3890,53,52,2412.03,4551.00,0.00
2024-12-10 17:20:23,106,3890,53,53,2389.27,4551.01,0.00
2024-12-10 17:20:23,105,3890,52,53,2410.74,4551.03,0.00
2024-12-10 17:20:23,105,3891,52,53,2409.60,4552.00,0.00
2024-12-10 17:20:23,106,3891,52,54,2386.87,4552.01,0.00
2024-12-10 17:20:23,105,3891,51,54,2408.31,4552.03,0.00
2024-12-10 17:20:23,105,3892,51,54,2406.15,4553.00,0.00
2024-12-10 17:20:23,106,3892,51,55,2383.45,4553.01,0.00
2024-12-10 17:20:23,105,3892,51,54,2404.86,4553.03,0.00
2024-12-10 17:20:23,105,3893,51,54,2401.46,4554.00,0.00
2024-12-10 17:20:23,106,3893,52,54,2378.80,4554.01,0.00
2024-12-10 17:20:23,105,3893,51,54,2400.17,4554.03,0.00
2024-12-10 17:20:23,105,3894,51,54,2395.52,4555.00,0.00
2024-12-10 17:20:23,106,3894,52,54,2372.92,4555.01,0.00
2024-12-10 17:20:23,105,3894,51,54,2394.23,4555.03,0.00
2024-12-10 17:20:23,105,3895,51,54,2387.58,4556.00,0.00
2024-12-10 17:20:23,106,3895,51,55,2365.06,4556.01,0.00
2024-12-10 17:20:23,105,3895,51,54,2386.29,4556.03,0.00
2024-12-10 17:20:23,105,3896,51,54,2377.46,4557.00,0.00
2024-12-10 17:20:23,106,3896,51,55,2355.03,4557.01,0.00
2024-12-10 17:20:23,105,3896,51,54,2376.17,4557.03,0.00
2024-12-10 17:20:23,105,3897,51,54,2365.16,4558.00,0.00
2024-12-10 17:20:23,106,3897,51,55,2342.85,4558.01,0.00
2024-12-10 17:20:23,105,3897,50,55,2363.87,4558.03,0.00
2024-12-10 17:20:23,106,3896,50,56,2337.27,4558.14,0.00
2024-12-10 17:20:23,105,3896,50,55,2361.53,4558.74,0.00
2024-12-10 17:20:23,105,3897,50,55,2393.44,4559.00,0.00
2024-12-10 17:20:23,106,3897,50,56,2370.86,4559.01,0.00
2024-12-10 17:20:23,105,3897,50,55,2392.15,4559.03,0.00
2024-12-10 17:20:23,105,3898,50,55,2428.35,4560.00,0.00
2024-12-10 17:20:23,106,3898,51,55,2405.44,4560.01,0.00
2024-12-10 17:20:23,105,3898,50,55,2427.06,4560.03,0.00
2024-12-10 17:20:23,106,3897,50,56,2394.73,4560.26,0.00
2024-12-10 17:20:23,106,3898,50,56,2428.77,4561.00,0.00
2024-12-10 17:20:23,107,3898,51,56,2406.07,4561.01,0.00
2024-12-10 17:20:23,106,3898,51,55,2427.49,4561.03,0.00
2024-12-10 17:20:23,105,3898,50,55,2435.20,4561.28,0.00
2024-12-10 17:20:23,105,3899,50,55,2489.46,4562.00,0.00
2024-12-10 17:20:23,106,3899,51,55,2465.98,4562.01,0.00
2024-12-10 17:20:23,105,3899,51,54,2488.17,4562.03,0.00
2024-12-10 17:20:23,105,3900,51,54,2486.95,4563.00,0.00
2024-12-10 17:20:23,106,3900,52,54,2463.49,4563.01,0.00
2024-12-10 17:20:23,105,3900,52,53,2485.65,4563.03,0.00
2024-12-10 17:20:23,106,3899,52,54,2459.20,4563.11,0.00
2024-12-10 17:20:23,106,3900,52,54,2499.43,4564.00,0.00
2024-12-10 17:20:23,107,3900,52,55,2476.07,4564.01,0.00
2024-12-10 17:20:23,106,3900,51,55,2498.14,4564.03,0.00
2024-12-10 17:20:23,106,3901,51,55,2535.35,4565.00,0.00
2024-12-10 17:20:23,107,3901,52,55,2511.66,4565.01,0.00
2024-12-10 17:20:23,106,3901,52,54,2534.07,4565.03,0.00
2024-12-10 17:20:23,106,3902,52,54,2526.33,4566.00,0.00
2024-12-10 17:20:23,107,3902,52,55,2502.71,4566.01,0.00
2024-12-10 17:20:23,106,3902,51,55,2525.04,4566.03,0.00
2024-12-10 17:20:23,106,3903,51,55,2515.49,4567.00,0.00
2024-12-10 17:20:23,107,3903,51,56,2491.98,4567.01,0.00
2024-12-10 17:20:23,106,3903,50,56,2514.20,4567.03,0.00
2024-12-10 17:20:23,107,3902,51,56,2453.29,4567.77,0.00
2024-12-10 17:20:23,107,3903,51,56,2489.18,4568.00,0.00
2024-12-10 17:20:23,108,3903,52,56,2466.13,4568.01,0.00
2024-12-10 17:20:23,107,3903,52,55,2487.91,4568.03,0.00
2024-12-10 17:20:23,107,3904,52,55,2517.01,4569.00,0.00
2024-12-10 17:20:23,108,3904,53,55,2493.71,4569.01,0.00
2024-12-10 17:20:23,108,3905,53,55,2477.36,4570.00,0.00
2024-12-10 17:20:23,109,3905,54,55,2454.63,4570.01,0.00
2024-12-10 17:20:23,108,3905,54,54,2475.68,4570.04,0.00
2024-12-10 17:20:23,108,3906,54,54,2459.01,4571.00,0.00
2024-12-10 17:20:23,109,3906,54,55,2436.45,4571.01,0.00
2024-12-10 17:20:23,108,3906,53,55,2436.56,4571.37,0.00
2024-12-10 17:20:23,107,3906,52,55,2433.07,4571.88,0.00
2024-12-10 17:20:23,107,3907,52,55,2470.35,4572.00,0.00
2024-12-10 17:20:24,108,3907,53,55,2447.48,4572.01,0.00
2024-12-10 17:20:24,107,3907,53,54,2462.80,4572.05,0.00
2024-12-10 17:20:24,108,3906,54,54,2429.88,4572.29,0.00
2024-12-10 17:20:24,108,3907,54,54,2471.57,4573.00,0.00
2024-12-10 17:20:24,109,3907,54,55,2448.90,4573.01,0.00
2024-12-10 17:20:24,108,3907,53,55,2463.60,4573.05,0.00
2024-12-10 17:20:24,108,3908,53,55,2503.99,4574.00,0.00
2024-12-10 17:20:24,109,3908,53,56,2481.02,4574.01,0.00
2024-12-10 17:20:24,108,3908,53,55,2500.02,4574.04,0.00
2024-12-10 17:20:24,107,3908,52,55,2522.96,4574.04,0.00
2024-12-10 17:20:24,107,3909,52,55,2519.99,4575.00,0.00
2024-12-10 17:20:24,108,3909,53,55,2496.65,4575.01,0.00
2024-12-10 17:20:24,109,3908,53,56,2472.50,4575.06,0.00
2024-12-10 17:20:24,109,3909,53,56,2510.05,4576.00,0.00
2024-12-10 17:20:24,110,3909,53,57,2487.23,4576.01,0.00
2024-12-10 17:20:24,109,3909,52,57,2507.97,4576.05,0.00
2024-12-10 17:20:24,110,3908,52,58,2450.69,4576.77,0.00
2024-12-10 17:20:24,110,3909,52,58,2529.99,4577.00,0.00
2024-12-10 17:20:24,111,3909,52,59,2507.20,4577.01,0.00
2024-12-10 17:20:24,110,3909,51,59,2527.93,4577.05,0.00
2024-12-10 17:20:24,110,3910,51,59,2561.94,4578.00,0.00
2024-12-10 17:20:24,111,3910,51,60,2538.86,4578.01,0.00
2024-12-10 17:20:24,110,3910,51,59,2559.88,4578.05,0.00
2024-12-10 17:20:24,110,3911,51,59,2550.64,4579.00,0.00
2024-12-10 17:20:24,111,3911,51,60,2527.66,4579.01,0.00
2024-12-10 17:20:24,111,3912,51,60,2513.80,4580.00,0.00
2024-12-10 17:20:24,112,3912,52,60,2491.36,4580.01,0.00
2024-12-10 17:20:24,111,3912,51,60,2509.48,4580.05,0.00
2024-12-10 17:20:24,111,3913,51,60,2494.04,4581.00,0.00
2024-12-10 17:20:24,112,3913,51,61,2471.77,4581.01,0.00
2024-12-10 17:20:24,111,3913,51,60,2488.52,4581.05,0.00
2024-12-10 17:20:24,111,3914,51,60,2468.59,4582.00,0.00
2024-12-10 17:20:24,112,3914,52,60,2446.55,4582.01,0.00
2024-12-10 17:20:24,111,3914,51,60,2461.96,4582.05,0.00
2024-12-10 17:20:24,110,3914,51,59,2476.96,4582.18,0.00
2024-12-10 17:20:24,110,3915,51,59,2467.61,4583.00,0.00
2024-12-10 17:20:24,111,3915,52,59,2445.38,4583.01,0.00
2024-12-10 17:20:24,111,3916,52,59,2410.94,4584.00,0.00
2024-12-10 17:20:24,112,3916,52,60,2389.42,4584.01,0.00
2024-12-10 17:20:24,111,3916,51,60,2395.10,4584.11,0.00
2024-12-10 17:20:24,111,3917,51,60,2362.83,4585.00,0.00
2024-12-10 17:20:24,112,3917,51,61,2341.74,4585.01,0.00
2024-12-10 17:20:24,111,3917,50,61,2347.42,4585.07,0.00
2024-12-10 17:20:24,111,3918,50,61,2301.61,4586.00,0.00
2024-12-10 17:20:24,112,3918,51,61,2281.06,4586.01,0.00
2024-12-10 17:20:24,111,3918,51,60,2299.74,4586.03,0.00
2024-12-10 17:20:24,110,3918,51,59,2312.77,4586.06,0.00
2024-12-10 17:20:24,111,3917,51,60,2269.38,4586.58,0.00
2024-12-10 17:20:24,111,3918,51,60,2238.84,4587.00,0.00
2024-12-10 17:20:24,112,3918,51,61,2218.85,4587.01,0.00
2024-12-10 17:20:24,111,3918,50,61,2229.12,4587.06,0.00
2024-12-10 17:20:24,112,3917,50,62,2169.45,4587.79,0.00
2024-12-10 17:20:24,111,3917,49,62,2189.52,4587.84,0.00
2024-12-10 17:20:24,110,3917,49,61,2193.40,4587.86,0.00
2024-12-10 17:20:24,110,3918,49,61,2226.98,4588.00,0.00
2024-12-10 17:20:24,111,3918,49,62,2206.92,4588.01,0.00
2024-12-10 17:20:24,110,3918,49,61,2226.57,4588.01,0.00
2024-12-10 17:20:24,109,3918,49,60,2240.31,4588.04,0.00
2024-12-10 17:20:24,108,3918,49,59,2223.01,4588.69,0.00
2024-12-10 17:20:24,107,3918,49,58,2230.95,4588.84,0.00
2024-12-10 17:20:24,107,3919,49,58,2261.72,4589.00,0.00
2024-12-10 17:20:24,108,3919,50,58,2240.77,4589.01,0.00
2024-12-10 17:20:24,107,3919,50,57,2205.93,4589.92,0.00
2024-12-10 17:20:24,107,3920,50,57,2217.33,4590.00,0.00
2024-12-10 17:20:24,108,3920,50,58,2196.80,4590.01,0.00
2024-12-10 17:20:24,107,3920,50,57,2159.25,4590.89,0.00
2024-12-10 17:20:24,108,3919,50,58,2124.34,4590.94,0.00
2024-12-10 17:20:24,108,3920,50,58,2182.65,4591.00,0.00
2024-12-10 17:20:24,109,3920,51,58,2162.62,4591.01,0.00
2024-12-10 17:20:24,108,3920,51,57,2180.11,4591.06,0.00
2024-12-10 17:20:24,107,3920,50,57,2163.76,4591.82,0.00
2024-12-10 17:20:24,107,3921,50,57,2197.71,4592.00,0.00
2024-12-10 17:20:24,108,3921,50,58,2177.36,4592.01,0.00
2024-12-10 17:20:24,107,3921,50,57,2195.15,4592.06,0.00
2024-12-10 17:20:24,106,3921,50,56,2170.20,4592.86,0.00
2024-12-10 17:20:24,105,3921,49,56,2188.49,4592.89,0.00
2024-12-10 17:20:24,104,3921,48,56,2206.32,4592.89,0.00
2024-12-10 17:20:24,103,3921,47,56,2211.55,4592.92,0.00
2024-12-10 17:20:24,103,3922,47,56,2246.07,4593.00,0.00
2024-12-10 17:20:24,104,3922,48,56,2224.48,4593.01,0.00
2024-12-10 17:20:24,104,3923,48,56,2205.66,4594.00,0.00
2024-12-10 17:20:24,105,3923,48,57,2184.66,4594.01,0.00
2024-12-10 17:20:24,104,3923,48,56,2203.03,4594.06,0.00
2024-12-10 17:20:24,105,3922,48,57,2166.79,4594.37,0.00
2024-12-10 17:20:24,105,3923,48,57,2195.82,4595.00,0.00
2024-12-10 17:20:24,106,3923,48,58,2175.10,4595.01,0.00
2024-12-10 17:20:24,105,3923,47,58,2193.21,4595.06,0.00
2024-12-10 17:20:24,104,3923,47,57,2206.77,4595.17,0.00
2024-12-10 17:20:24,105,3922,48,57,2182.71,4595.26,0.00
2024-12-10 17:20:24,104,3922,48,56,2206.34,4595.88,0.00
2024-12-10 17:20:24,103,3922,48,55,2223.79,4595.88,0.00
2024-12-10 17:20:24,103,3923,48,55,2305.27,4596.00,0.00
2024-12-10 17:20:24,104,3923,49,55,2283.10,4596.01,0.00
2024-12-10 17:20:24,105,3922,50,55,2231.69,4596.63,0.00
2024-12-10 17:20:24,105,3923,50,55,2318.89,4597.00,0.00
2024-12-10 17:20:24,106,3923,51,55,2297.01,4597.01,0.00
2024-12-10 17:20:24,105,3923,51,54,2316.27,4597.06,0.00
2024-12-10 17:20:24,105,3924,51,54,2357.38,4598.00,0.00
2024-12-10 17:20:24,106,3924,51,55,2335.15,4598.01,0.00
2024-12-10 17:20:24,106,3925,51,55,2329.02,4599.00,0.00
2024-12-10 17:20:24,107,3925,52,55,2307.25,4599.01,0.00
2024-12-10 17:20:24,106,3925,51,55,2326.00,4599.07,0.00
2024-12-10 17:20:24,106,3926,51,55,2321.43,4600.00,0.00
2024-12-10 17:20:24,107,3926,51,56,2299.74,4600.01,0.00
2024-12-10 17:20:25,106,3926,50,56,2300.12,4600.43,0.00
2024-12-10 17:20:25,106,3927,50,56,2314.75,4601.00,0.00
2024-12-10 17:20:25,107,3927,51,56,2293.12,4601.01,0.00
2024-12-10 17:20:25,107,3928,51,56,2286.22,4602.00,0.00
2024-12-10 17:20:25,108,3928,52,56,2265.05,4602.01,0.00
2024-12-10 17:20:25,108,3929,52,56,2255.46,4603.00,0.00
2024-12-10 17:20:25,109,3929,53,56,2234.77,4603.01,0.00
2024-12-10 17:20:25,108,3929,52,56,2252.49,4603.07,0.00
2024-12-10 17:20:25,107,3929,52,55,2240.63,4603.65,0.00
2024-12-10 17:20:25,107,3930,52,55,2264.60,4604.00,0.00
2024-12-10 17:20:25,108,3930,53,55,2243.63,4604.01,0.00
2024-12-10 17:20:25,107,3930,53,54,2261.60,4604.07,0.00
2024-12-10 17:20:25,107,3931,53,54,2257.03,4605.00,0.00
2024-12-10 17:20:25,108,3931,53,55,2236.13,4605.01,0.00
2024-12-10 17:20:25,107,3931,52,55,2254.03,4605.07,0.00
2024-12-10 17:20:25,108,3930,52,56,2201.49,4605.77,0.00
2024-12-10 17:20:25,108,3931,52,56,2239.61,4606.00,0.00
2024-12-10 17:20:25,109,3931,52,57,2219.06,4606.01,0.00
2024-12-10 17:20:25,108,3931,51,57,2238.34,4606.03,0.00
2024-12-10 17:20:25,107,3931,50,57,2257.54,4606.06,0.00
2024-12-10 17:20:25,106,3931,49,57,2278.40,4606.06,0.00
2024-12-10 17:20:25,106,3932,49,57,2315.48,4607.00,0.00
2024-12-10 17:20:25,107,3932,50,57,2293.84,4607.01,0.00
2024-12-10 17:20:25,106,3932,50,56,2312.89,4607.06,0.00
2024-12-10 17:20:25,105,3932,49,56,2296.28,4607.74,0.00
2024-12-10 17:20:25,105,3933,49,56,2328.53,4608.00,0.00
2024-12-10 17:20:25,106,3933,49,57,2306.56,4608.01,0.00
2024-12-10 17:20:25,105,3933,48,57,2325.91,4608.06,0.00
2024-12-10 17:20:25,105,3934,48,57,2326.69,4609.00,0.00
2024-12-10 17:20:25,106,3934,48,58,2304.74,4609.01,0.00
2024-12-10 17:20:25,105,3934,47,58,2324.07,4609.06,0.00
2024-12-10 17:20:25,105,3935,47,58,2324.41,4610.00,0.00
2024-12-10 17:20:25,106,3935,48,58,2302.48,4610.01,0.00
2024-12-10 17:20:25,105,3935,47,58,2321.79,4610.06,0.00
2024-12-10 17:20:25,104,3935,47,57,2341.24,4610.10,0.00
2024-12-10 17:20:25,104,3936,47,57,2344.40,4611.00,0.00
2024-12-10 17:20:25,105,3936,47,58,2322.07,4611.01,0.00
2024-12-10 17:20:25,105,3937,47,58,2320.81,4612.00,0.00
2024-12-10 17:20:25,106,3937,47,59,2298.92,4612.01,0.00
2024-12-10 17:20:25,106,3938,47,59,2297.24,4613.00,0.00
2024-12-10 17:20:25,107,3938,48,59,2275.77,4613.01,0.00
2024-12-10 17:20:25,106,3938,48,58,2294.64,4613.06,0.00
2024-12-10 17:20:25,106,3939,48,58,2295.13,4614.00,0.00
2024-12-10 17:20:25,107,3939,48,59,2273.68,4614.01,0.00
2024-12-10 17:20:25,106,3939,48,58,2293.40,4614.04,0.00
2024-12-10 17:20:25,105,3939,48,57,2314.36,4614.05,0.00
2024-12-10 17:20:25,104,3939,48,56,2336.17,4614.05,0.00
2024-12-10 17:20:25,104,3940,48,56,2337.11,4615.00,0.00
2024-12-10 17:20:25,105,3940,48,57,2314.85,4615.01,0.00
2024-12-10 17:20:25,104,3940,48,56,2334.90,4615.05,0.00
2024-12-10 17:20:25,104,3941,48,56,2335.84,4616.00,0.00
2024-12-10 17:20:25,105,3941,48,57,2313.60,4616.01,0.00
2024-12-10 17:20:25,105,3942,48,57,2312.34,4617.00,0.00
2024-12-10 17:20:25,106,3942,49,57,2290.52,4617.01,0.00
2024-12-10 17:20:25,105,3942,48,57,2310.15,4617.05,0.00
2024-12-10 17:20:25,105,3943,48,57,2310.64,4618.00,0.00
2024-12-10 17:20:25,106,3943,48,58,2288.84,4618.01,0.00
2024-12-10 17:20:25,105,3943,47,58,2308.45,4618.05,0.00
2024-12-10 17:20:25,105,3944,47,58,2308.94,4619.00,0.00
2024-12-10 17:20:25,106,3944,47,59,2287.16,4619.01,0.00
2024-12-10 17:20:25,106,3945,47,59,2285.47,4620.00,0.00
2024-12-10 17:20:25,107,3945,47,60,2264.11,4620.01,0.00
2024-12-10 17:20:25,106,3945,46,60,2282.87,4620.06,0.00
2024-12-10 17:20:25,106,3946,46,60,2283.35,4621.00,0.00
2024-12-10 17:20:25,107,3946,46,61,2262.01,4621.01,0.00
2024-12-10 17:20:25,106,3946,45,61,2282.92,4621.01,0.00
2024-12-10 17:20:25,105,3946,45,60,2302.47,4621.05,0.00
2024-12-10 17:20:25,104,3946,44,60,2324.17,4621.05,0.00
2024-12-10 17:20:25,104,3947,44,60,2325.10,4622.00,0.00
2024-12-10 17:20:25,105,3947,45,60,2302.96,4622.01,0.00
2024-12-10 17:20:25,104,3947,45,59,2322.89,4622.05,0.00
2024-12-10 17:20:25,104,3948,45,59,2323.83,4623.00,0.00
2024-12-10 17:20:25,105,3948,46,59,2301.69,4623.01,0.00
2024-12-10 17:20:25,104,3948,46,58,2321.62,4623.05,0.00
2024-12-10 17:20:25,104,3949,46,58,2322.55,4624.00,0.00
2024-12-10 17:20:25,105,3949,47,58,2300.43,4624.01,0.00
2024-12-10 17:20:25,104,3949,47,57,2320.34,4624.05,0.00
2024-12-10 17:20:25,104,3950,47,57,2321.27,4625.00,0.00
2024-12-10 17:20:25,105,3950,48,57,2299.17,4625.01,0.00
2024-12-10 17:20:25,104,3950,47,57,2319.06,4625.05,0.00
2024-12-10 17:20:25,104,3951,47,57,2320.00,4626.00,0.00
2024-12-10 17:20:25,105,3951,48,57,2297.90,4626.01,0.00
2024-12-10 17:20:25,104,3951,47,57,2319.11,4626.02,0.00
2024-12-10 17:20:25,103,3951,46,57,2340.29,4626.04,0.00
2024-12-10 17:20:25,102,3951,45,57,2362.78,4626.04,0.00
2024-12-10 17:20:25,102,3952,45,57,2361.39,4627.00,0.00
2024-12-10 17:20:25,103,3952,46,57,2338.47,4627.01,0.00
2024-12-10 17:20:25,103,3953,46,57,2333.31,4628.00,0.00
2024-12-10 17:20:25,104,3953,47,57,2310.88,4628.01,0.00
2024-12-10 17:20:25,103,3953,46,57,2331.08,4628.05,0.00
2024-12-10 17:20:25,103,3954,46,57,2326.26,4629.00,0.00
2024-12-10 17:20:25,104,3954,47,57,2303.89,4629.01,0.00
2024-12-10 17:20:25,103,3954,47,56,2324.03,4629.05,0.00
2024-12-10 17:20:25,102,3954,47,55,2312.89,4629.59,0.00
2024-12-10 17:20:25,102,3955,47,55,2339.54,4630.00,0.00
2024-12-10 17:20:25,103,3955,47,56,2316.82,4630.01,0.00
2024-12-10 17:20:26,102,3955,47,55,2337.29,4630.05,0.00
2024-12-10 17:20:26,101,3955,47,54,2332.12,4630.47,0.00
2024-12-10 17:20:26,101,3956,47,54,2352.74,4631.00,0.00
2024-12-10 17:20:26,102,3956,47,55,2329.68,4631.01,0.00
2024-12-10 17:20:26,102,3957,47,55,2323.68,4632.00,0.00
2024-12-10 17:20:26,103,3957,47,56,2301.12,4632.01,0.00
2024-12-10 17:20:26,102,3957,46,56,2320.97,4632.06,0.00
2024-12-10 17:20:26,102,3958,46,56,2317.97,4633.00,0.00
2024-12-10 17:20:26,103,3958,46,57,2295.46,4633.01,0.00
2024-12-10 17:20:26,102,3958,46,56,2317.06,4633.02,0.00
2024-12-10 17:20:26,101,3958,45,56,2338.18,4633.05,0.00
2024-12-10 17:20:26,100,3958,44,56,2361.10,4633.05,0.00
2024-12-10 17:20:26,100,3959,44,56,2359.04,4634.00,0.00
2024-12-10 17:20:26,101,3959,44,57,2335.68,4634.01,0.00
2024-12-10 17:20:26,100,3959,43,57,2356.74,4634.05,0.00
2024-12-10 17:20:26,100,3960,43,57,2355.28,4635.00,0.00
2024-12-10 17:20:26,101,3960,43,58,2331.96,4635.01,0.00
2024-12-10 17:20:26,100,3960,42,58,2352.97,4635.05,0.00
2024-12-10 17:20:26,99,3960,42,57,2362.95,4635.29,0.00
2024-12-10 17:20:26,99,3961,42,57,2375.71,4636.00,0.00
2024-12-10 17:20:26,100,3961,42,58,2351.96,4636.01,0.00
2024-12-10 17:20:26,99,3961,42,57,2373.39,4636.05,0.00
2024-12-10 17:20:26,99,3962,42,57,2375.60,4637.00,0.00
2024-12-10 17:20:26,100,3962,43,57,2351.84,4637.01,0.00
2024-12-10 17:20:26,99,3962,42,57,2373.74,4637.04,0.00
2024-12-10 17:20:26,98,3962,41,57,2397.49,4637.04,0.00
2024-12-10 17:20:26,97,3962,40,57,2421.73,4637.04,0.00
2024-12-10 17:20:26,97,3963,40,57,2424.43,4638.00,0.00
2024-12-10 17:20:26,98,3963,40,58,2399.69,4638.01,0.00
2024-12-10 17:20:26,98,3964,40,58,2401.40,4639.00,0.00
2024-12-10 17:20:26,99,3964,40,59,2377.14,4639.01,0.00
2024-12-10 17:20:26,98,3964,40,58,2399.52,4639.04,0.00
2024-12-10 17:20:26,98,3965,40,58,2402.86,4640.00,0.00
2024-12-10 17:20:26,99,3965,40,59,2378.59,4640.01,0.00
2024-12-10 17:20:26,98,3965,39,59,2400.98,4640.04,0.00
2024-12-10 17:20:26,97,3965,38,59,2415.67,4640.26,0.00
2024-12-10 17:20:26,97,3966,38,59,2429.54,4641.00,0.00
2024-12-10 17:20:26,98,3966,39,59,2404.75,4641.01,0.00
2024-12-10 17:20:26,97,3966,39,58,2427.64,4641.04,0.00
2024-12-10 17:20:26,97,3967,39,58,2431.20,4642.00,0.00
2024-12-10 17:20:26,98,3967,39,59,2406.39,4642.01,0.00
2024-12-10 17:20:26,97,3967,38,59,2429.30,4642.04,0.00
2024-12-10 17:20:26,96,3967,37,59,2444.53,4642.23,0.00
2024-12-10 17:20:26,96,3968,37,59,2457.59,4643.00,0.00
2024-12-10 17:20:26,97,3968,37,60,2432.25,4643.01,0.00
2024-12-10 17:20:26,96,3968,37,59,2455.67,4643.04,0.00
2024-12-10 17:20:26,96,3969,37,59,2460.05,4644.00,0.00
2024-12-10 17:20:26,97,3969,37,60,2434.69,4644.01,0.00
2024-12-10 17:20:26,97,3970,37,60,2437.10,4645.00,0.00
2024-12-10 17:20:26,98,3970,38,60,2412.24,4645.01,0.00
2024-12-10 17:20:26,97,3970,38,59,2434.73,4645.05,0.00
2024-12-10 17:20:26,97,3971,38,59,2437.73,4646.00,0.00
2024-12-10 17:20:26,98,3971,38,60,2412.85,4646.01,0.00
2024-12-10 17:20:26,97,3971,38,59,2435.35,4646.05,0.00
2024-12-10 17:20:26,97,3972,38,59,2436.95,4647.00,0.00
2024-12-10 17:20:26,98,3972,39,59,2412.09,4647.01,0.00
2024-12-10 17:20:26,97,3972,39,58,2434.57,4647.05,0.00
2024-12-10 17:20:26,96,3972,39,57,2454.41,4647.15,0.00
2024-12-10 17:20:26,97,3971,39,58,2414.36,4647.48,0.00
2024-12-10 17:20:26,97,3972,39,58,2462.18,4648.00,0.00
2024-12-10 17:20:26,98,3972,39,59,2437.06,4648.01,0.00
2024-12-10 17:20:26,97,3972,39,58,2459.81,4648.05,0.00
2024-12-10 17:20:26,98,3971,40,58,2410.70,4648.59,0.00
2024-12-10 17:20:26,98,3972,40,58,2505.42,4649.00,0.00
2024-12-10 17:20:26,99,3972,40,59,2480.12,4649.01,0.00
2024-12-10 17:20:26,100,3971,41,59,2454.85,4649.04,0.00
2024-12-10 17:20:26,99,3971,41,58,2503.15,4649.06,0.00
2024-12-10 17:20:26,99,3972,41,58,2553.92,4650.00,0.00
2024-12-10 17:20:26,100,3972,41,59,2528.38,4650.01,0.00
2024-12-10 17:20:26,99,3972,40,59,2551.59,4650.05,0.00
2024-12-10 17:20:26,98,3972,39,59,2567.51,4650.23,0.00
2024-12-10 17:20:26,98,3973,39,59,2626.86,4651.00,0.00
2024-12-10 17:20:26,99,3973,39,60,2600.33,4651.01,0.00
2024-12-10 17:20:26,98,3973,39,59,2624.51,4651.05,0.00
2024-12-10 17:20:26,98,3974,39,59,2628.38,4652.00,0.00
2024-12-10 17:20:26,99,3974,40,59,2601.83,4652.01,0.00
2024-12-10 17:20:26,98,3974,40,58,2626.03,4652.05,0.00
2024-12-10 17:20:26,98,3975,40,58,2629.89,4653.00,0.00
2024-12-10 17:20:26,99,3975,40,59,2603.33,4653.01,0.00
2024-12-10 17:20:26,98,3975,40,58,2627.54,4653.05,0.00
2024-12-10 17:20:26,98,3976,40,58,2631.41,4654.00,0.00
2024-12-10 17:20:26,99,3976,40,59,2604.83,4654.01,0.00
2024-12-10 17:20:26,99,3977,40,59,2606.33,4655.00,0.00
2024-12-10 17:20:26,100,3977,41,59,2580.27,4655.01,0.00
2024-12-10 17:20:26,101,3976,41,60,2543.25,4655.28,0.00
2024-12-10 17:20:26,101,3977,41,60,2586.61,4656.00,0.00
2024-12-10 17:20:26,102,3977,42,60,2561.25,4656.01,0.00
2024-12-10 17:20:26,101,3977,42,59,2583.41,4656.07,0.00
2024-12-10 17:20:26,101,3978,42,59,2632.82,4657.00,0.00
2024-12-10 17:20:26,102,3978,43,59,2607.01,4657.01,0.00
2024-12-10 17:20:26,102,3979,43,59,2607.11,4658.00,0.00
2024-12-10 17:20:26,103,3979,43,60,2581.80,4658.01,0.00
2024-12-10 17:20:26,102,3979,43,59,2603.93,4658.07,0.00
2024-12-10 17:20:26,102,3980,43,59,2606.75,4659.00,0.00
2024-12-10 17:20:26,103,3980,44,59,2581.45,4659.01,0.00
2024-12-10 17:20:26,102,3980,44,58,2603.58,4659.07,0.00
2024-12-10 17:20:26,102,3981,44,58,2606.40,4660.00,0.00
2024-12-10 17:20:26,103,3981,45,58,2581.10,4660.01,0.00
2024-12-10 17:20:27,103,3982,45,58,2580.74,4661.00,0.00
2024-12-10 17:20:27,104,3982,45,59,2555.93,4661.01,0.00
2024-12-10 17:20:27,103,3982,44,59,2577.60,4661.07,0.00
2024-12-10 17:20:27,103,3983,44,59,2579.94,4662.00,0.00
2024-12-10 17:20:27,104,3983,45,59,2555.13,4662.01,0.00
2024-12-10 17:20:27,104,3984,45,59,2554.30,4663.00,0.00
2024-12-10 17:20:27,105,3984,46,59,2529.97,4663.01,0.00
2024-12-10 17:20:27,105,3985,46,59,2528.57,4664.00,0.00
2024-12-10 17:20:27,106,3985,47,59,2504.72,4664.01,0.00
2024-12-10 17:20:27,105,3985,47,58,2525.48,4664.07,0.00
2024-12-10 17:20:27,105,3986,47,58,2525.68,4665.00,0.00
2024-12-10 17:20:27,106,3986,47,59,2501.86,4665.01,0.00
2024-12-10 17:20:27,105,3986,46,59,2522.59,4665.07,0.00
2024-12-10 17:20:27,106,3985,47,59,2484.79,4665.39,0.00
2024-12-10 17:20:27,106,3986,47,59,2525.02,4666.00,0.00
2024-12-10 17:20:27,107,3986,47,60,2501.42,4666.01,0.00
2024-12-10 17:20:27,106,3986,47,59,2521.95,4666.07,0.00
2024-12-10 17:20:27,106,3987,47,59,2564.18,4667.00,0.00
2024-12-10 17:20:27,107,3987,48,59,2540.21,4667.01,0.00
2024-12-10 17:20:27,106,3987,48,58,2561.11,4667.07,0.00
2024-12-10 17:20:27,106,3988,48,58,2558.44,4668.00,0.00
2024-12-10 17:20:27,107,3988,48,59,2534.53,4668.01,0.00
2024-12-10 17:20:27,106,3988,47,59,2554.93,4668.08,0.00
2024-12-10 17:20:27,106,3989,47,59,2551.40,4669.00,0.00
2024-12-10 17:20:27,107,3989,47,60,2527.56,4669.01,0.00
2024-12-10 17:20:27,106,3989,46,60,2547.89,4669.08,0.00
2024-12-10 17:20:27,106,3990,46,60,2543.29,4670.00,0.00
2024-12-10 17:20:27,107,3990,46,61,2519.52,4670.01,0.00
2024-12-10 17:20:27,106,3990,45,61,2539.78,4670.08,0.00
2024-12-10 17:20:27,106,3991,45,61,2533.98,4671.00,0.00
2024-12-10 17:20:27,107,3991,45,62,2510.29,4671.01,0.00
2024-12-10 17:20:27,107,3992,45,62,2500.05,4672.00,0.00
2024-12-10 17:20:27,108,3992,46,62,2476.90,4672.01,0.00
2024-12-10 17:20:27,108,3993,46,62,2465.18,4673.00,0.00
2024-12-10 17:20:27,109,3993,46,63,2442.56,4673.01,0.00
2024-12-10 17:20:27,109,3994,46,63,2428.92,4674.00,0.00
2024-12-10 17:20:27,110,3994,47,63,2406.84,4674.01,0.00
2024-12-10 17:20:27,110,3995,47,63,2389.61,4675.00,0.00
2024-12-10 17:20:27,111,3995,47,64,2368.08,4675.01,0.00
2024-12-10 17:20:27,110,3995,47,63,2389.19,4675.01,0.00
2024-12-10 17:20:27,109,3995,47,62,2408.11,4675.06,0.00
2024-12-10 17:20:27,108,3995,47,61,2406.12,4675.46,0.00
2024-12-10 17:20:27,107,3995,47,60,2418.68,4675.54,0.00
2024-12-10 17:20:27,107,3996,47,60,2440.42,4676.00,0.00
2024-12-10 17:20:27,108,3996,48,60,2417.83,4676.01,0.00
2024-12-10 17:20:27,107,3996,47,60,2438.25,4676.05,0.00
2024-12-10 17:20:27,106,3996,47,59,2460.37,4676.06,0.00
2024-12-10 17:20:27,105,3996,47,58,2483.36,4676.06,0.00
2024-12-10 17:20:27,104,3996,47,57,2496.90,4676.22,0.00
2024-12-10 17:20:27,105,3995,47,58,2456.29,4676.56,0.00
2024-12-10 17:20:27,105,3996,47,58,2496.97,4677.00,0.00
2024-12-10 17:20:27,106,3996,47,59,2473.42,4677.01,0.00
2024-12-10 17:20:27,105,3996,46,59,2474.97,4677.45,0.00
2024-12-10 17:20:27,105,3997,46,59,2535.35,4678.00,0.00
2024-12-10 17:20:27,106,3997,46,60,2511.43,4678.01,0.00
2024-12-10 17:20:27,107,3996,47,60,2487.53,4678.04,0.00
2024-12-10 17:20:27,107,3997,47,60,2517.75,4679.00,0.00
2024-12-10 17:20:27,108,3997,47,61,2494.44,4679.01,0.00
2024-12-10 17:20:27,108,3998,47,61,2528.64,4680.00,0.00
2024-12-10 17:20:27,109,3998,47,62,2505.44,4680.01,0.00
2024-12-10 17:20:27,108,3998,46,62,2511.98,4680.35,0.00
2024-12-10 17:20:27,108,3999,46,62,2518.52,4681.00,0.00
2024-12-10 17:20:27,109,3999,47,62,2495.41,4681.01,0.00
2024-12-10 17:20:27,109,4000,47,62,2483.41,4682.00,0.00
2024-12-10 17:20:27,110,4000,48,62,2460.83,4682.01,0.00
2024-12-10 17:20:27,110,4001,48,62,2446.32,4683.00,0.00
2024-12-10 17:20:27,111,4001,49,62,2424.28,4683.01,0.00
2024-12-10 17:20:27,111,4002,49,62,2405.13,4684.00,0.00
2024-12-10 17:20:27,112,4002,50,62,2383.66,4684.01,0.00
2024-12-10 17:20:27,112,4003,50,62,2359.00,4685.00,0.00
2024-12-10 17:20:27,113,4003,50,63,2338.13,4685.01,0.00
2024-12-10 17:20:27,112,4003,49,63,2310.13,4685.78,0.00
2024-12-10 17:20:27,112,4004,49,63,2332.68,4686.00,0.00
2024-12-10 17:20:27,113,4004,50,63,2312.03,4686.01,0.00
2024-12-10 17:20:27,112,4004,50,62,2331.44,4686.03,0.00
2024-12-10 17:20:27,113,4003,50,63,2310.80,4686.04,0.00
2024-12-10 17:20:27,112,4003,50,62,2367.42,4686.06,0.00
2024-12-10 17:20:27,111,4003,49,62,2378.45,4686.28,0.00
2024-12-10 17:20:27,110,4003,48,62,2374.51,4686.70,0.00
2024-12-10 17:20:27,110,4004,48,62,2392.72,4687.00,0.00
2024-12-10 17:20:27,111,4004,49,62,2371.16,4687.01,0.00
2024-12-10 17:20:27,110,4004,48,62,2390.79,4687.04,0.00
2024-12-10 17:20:27,109,4004,48,61,2411.87,4687.05,0.00
2024-12-10 17:20:27,108,4004,48,60,2433.76,4687.05,0.00
2024-12-10 17:20:27,107,4004,48,59,2417.96,4687.77,0.00
2024-12-10 17:20:27,107,4005,48,59,2487.62,4688.00,0.00
2024-12-10 17:20:27,108,4005,48,60,2464.59,4688.01,0.00
2024-12-10 17:20:28,108,4006,48,60,2452.45,4689.00,0.00
2024-12-10 17:20:28,109,4006,49,60,2429.95,4689.01,0.00
2024-12-10 17:20:28,108,4006,48,60,2449.33,4689.06,0.00
2024-12-10 17:20:28,108,4007,48,60,2437.04,4690.00,0.00
2024-12-10 17:20:28,109,4007,48,61,2414.68,4690.01,0.00
2024-12-10 17:20:28,108,4007,48,60,2434.20,4690.06,0.00
2024-12-10 17:20:28,108,4008,48,60,2419.48,4691.00,0.00
2024-12-10 17:20:28,109,4008,48,61,2397.28,4691.01,0.00
2024-12-10 17:20:28,108,4008,47,61,2416.90,4691.06,0.00
2024-12-10 17:20:28,107,4008,47,60,2403.38,4691.77,0.00
2024-12-10 17:20:28,106,4008,47,59,2416.78,4691.81,0.00
2024-12-10 17:20:28,106,4009,47,59,2452.34,4692.00,0.00
2024-12-10 17:20:28,107,4009,47,60,2429.42,4692.01,0.00
2024-12-10 17:20:28,106,4009,47,59,2449.72,4692.06,0.00
2024-12-10 17:20:28,106,4010,47,59,2450.21,4693.00,0.00
2024-12-10 17:20:28,107,4010,47,60,2427.31,4693.01,0.00
2024-12-10 17:20:28,106,4010,46,60,2447.58,4693.06,0.00
2024-12-10 17:20:28,106,4011,46,60,2447.81,4694.00,0.00
2024-12-10 17:20:28,107,4011,46,61,2424.93,4694.01,0.00
2024-12-10 17:20:28,106,4011,46,60,2445.18,4694.06,0.00
2024-12-10 17:20:28,105,4011,46,59,2468.02,4694.06,0.00
2024-12-10 17:20:28,105,4012,46,59,2468.96,4695.00,0.00
2024-12-10 17:20:28,106,4012,46,60,2445.67,4695.01,0.00
2024-12-10 17:20:28,105,4012,46,59,2466.31,4695.06,0.00
2024-12-10 17:20:28,104,4012,45,59,2489.84,4695.06,0.00
2024-12-10 17:20:28,104,4013,45,59,2491.25,4696.00,0.00
2024-12-10 17:20:28,105,4013,45,60,2467.52,4696.01,0.00
2024-12-10 17:20:28,104,4013,44,60,2488.57,4696.06,0.00
2024-12-10 17:20:28,103,4013,43,60,2512.27,4696.06,0.00
2024-12-10 17:20:28,103,4014,43,60,2514.07,4697.00,0.00
2024-12-10 17:20:28,104,4014,43,61,2489.89,4697.01,0.00
2024-12-10 17:20:28,104,4015,43,61,2485.84,4698.00,0.00
2024-12-10 17:20:28,105,4015,44,61,2462.17,4698.01,0.00
2024-12-10 17:20:28,105,4016,44,61,2454.48,4699.00,0.00
2024-12-10 17:20:28,106,4016,44,62,2431.32,4699.01,0.00
2024-12-10 17:20:28,105,4016,43,62,2447.43,4699.07,0.00
2024-12-10 17:20:28,105,4017,43,62,2445.78,4700.00,0.00
2024-12-10 17:20:28,106,4017,43,63,2422.71,4700.01,0.00
2024-12-10 17:20:28,105,4017,43,62,2439.22,4700.07,0.00
2024-12-10 17:20:28,105,4018,43,62,2438.33,4701.00,0.00
2024-12-10 17:20:28,106,4018,44,62,2415.32,4701.01,0.00
2024-12-10 17:20:28,105,4018,43,62,2432.61,4701.07,0.00
2024-12-10 17:20:28,106,4017,43,63,2401.26,4701.26,0.00
2024-12-10 17:20:28,106,4018,43,63,2443.75,4702.00,0.00
2024-12-10 17:20:28,107,4018,44,63,2420.91,4702.01,0.00
2024-12-10 17:20:28,106,4018,43,63,2439.21,4702.07,0.00
2024-12-10 17:20:28,106,4019,43,63,2483.55,4703.00,0.00
2024-12-10 17:20:28,107,4019,43,64,2460.34,4703.01,0.00
2024-12-10 17:20:28,106,4019,42,64,2479.44,4703.07,0.00
2024-12-10 17:20:28,106,4020,42,64,2479.14,4704.00,0.00
2024-12-10 17:20:28,107,4020,42,65,2455.97,4704.01,0.00
2024-12-10 17:20:28,107,4021,42,65,2451.29,4705.00,0.00
2024-12-10 17:20:28,108,4021,42,66,2428.59,4705.01,0.00
2024-12-10 17:20:28,107,4021,42,65,2448.65,4705.04,0.00
2024-12-10 17:20:28,106,4021,42,64,2469.99,4705.07,0.00
2024-12-10 17:20:28,105,4021,42,63,2493.06,4705.07,0.00
2024-12-10 17:20:28,106,4020,43,63,2449.97,4705.50,0.00
2024-12-10 17:20:28,106,4021,43,63,2492.20,4706.00,0.00
2024-12-10 17:20:28,107,4021,43,64,2468.91,4706.01,0.00
2024-12-10 17:20:28,106,4021,43,63,2488.15,4706.07,0.00
2024-12-10 17:20:28,106,4022,43,63,2530.26,4707.00,0.00
2024-12-10 17:20:28,107,4022,44,63,2506.62,4707.01,0.00
2024-12-10 17:20:28,107,4023,44,63,2499.32,4708.00,0.00
2024-12-10 17:20:28,108,4023,45,63,2476.18,4708.01,0.00
2024-12-10 17:20:28,107,4023,45,62,2494.49,4708.09,0.00
2024-12-10 17:20:28,107,4024,45,62,2492.30,4709.00,0.00
2024-12-10 17:20:28,108,4024,45,63,2469.22,4709.01,0.00
2024-12-10 17:20:28,107,4024,45,62,2488.19,4709.08,0.00
2024-12-10 17:20:28,107,4025,45,62,2483.87,4710.00,0.00
2024-12-10 17:20:28,108,4025,45,63,2460.87,4710.01,0.00
2024-12-10 17:20:28,107,4025,44,63,2479.83,4710.08,0.00
2024-12-10 17:20:28,107,4026,44,63,2473.96,4711.00,0.00
2024-12-10 17:20:28,108,4026,45,63,2451.05,4711.01,0.00
2024-12-10 17:20:28,107,4026,45,62,2448.68,4711.47,0.00
2024-12-10 17:20:28,108,4025,45,63,2422.56,4711.56,0.00
2024-12-10 17:20:28,108,4026,45,63,2464.64,4712.00,0.00
2024-12-10 17:20:28,109,4026,46,63,2442.03,4712.01,0.00
2024-12-10 17:20:28,108,4026,46,62,2460.23,4712.07,0.00
2024-12-10 17:20:28,108,4027,46,62,2502.57,4713.00,0.00
2024-12-10 17:20:28,109,4027,47,62,2479.61,4713.01,0.00
2024-12-10 17:20:28,109,4028,47,62,2473.37,4714.00,0.00
2024-12-10 17:20:28,110,4028,48,62,2450.88,4714.01,0.00
2024-12-10 17:20:28,109,4028,47,62,2471.61,4714.02,0.00
2024-12-10 17:20:28,108,4028,47,61,2491.81,4714.07,0.00
2024-12-10 17:20:28,108,4029,47,61,2488.86,4715.00,0.00
2024-12-10 17:20:28,109,4029,48,61,2466.02,4715.01,0.00
2024-12-10 17:20:28,108,4029,48,60,2485.51,4715.07,0.00
2024-12-10 17:20:28,108,4030,48,60,2481.84,4716.00,0.00
2024-12-10 17:20:28,109,4030,49,60,2459.07,4716.01,0.00
2024-12-10 17:20:28,108,4030,49,59,2477.43,4716.07,0.00
2024-12-10 17:20:28,108,4031,49,59,2471.88,4717.00,0.00
2024-12-10 17:20:28,109,4031,49,60,2449.20,4717.01,0.00
2024-12-10 17:20:28,108,4031,48,60,2466.41,4717.07,0.00
2024-12-10 17:20:28,107,4031,48,59,2475.04,4717.26,0.00
2024-12-10 17:20:28,107,4032,48,59,2482.05,4718.00,0.00
2024-12-10 17:20:28,108,4032,49,59,2459.07,4718.01,0.00
2024-12-10 17:20:28,107,4032,49,58,2475.07,4718.07,0.00
2024-12-10 17:20:29,107,4033,49,58,2473.04,4719.00,0.00
2024-12-10 17:20:29,108,4033,50,58,2450.14,4719.01,0.00
2024-12-10 17:20:29,107,4033,50,57,2464.43,4719.07,0.00
2024-12-10 17:20:29,108,4032,51,57,2441.61,4719.08,0.00
2024-12-10 17:20:29,108,4033,51,57,2482.45,4720.00,0.00
2024-12-10 17:20:29,109,4033,52,57,2459.68,4720.01,0.00
2024-12-10 17:20:29,110,4032,52,58,2410.32,4720.46,0.00
2024-12-10 17:20:29,110,4033,52,58,2491.11,4721.00,0.00
2024-12-10 17:20:29,111,4033,53,58,2468.67,4721.01,0.00
2024-12-10 17:20:29,110,4033,52,58,2483.97,4721.05,0.00
2024-12-10 17:20:29,110,4034,52,58,2518.99,4722.00,0.00
2024-12-10 17:20:29,111,4034,52,59,2496.29,4722.01,0.00
2024-12-10 17:20:29,110,4034,51,59,2512.99,4722.06,0.00
2024-12-10 17:20:29,110,4035,51,59,2501.09,4723.00,0.00
2024-12-10 17:20:29,111,4035,51,60,2478.55,4723.01,0.00
2024-12-10 17:20:29,110,4035,50,60,2456.51,4723.55,0.00
2024-12-10 17:20:29,110,4036,50,60,2472.85,4724.00,0.00
2024-12-10 17:20:29,111,4036,50,61,2450.58,4724.01,0.00
2024-12-10 17:20:29,110,4036,50,60,2471.92,4724.03,0.00
2024-12-10 17:20:29,109,4036,50,59,2482.97,4724.24,0.00
2024-12-10 17:20:29,108,4036,49,59,2496.88,4724.29,0.00
2024-12-10 17:20:29,107,4036,48,59,2508.72,4724.47,0.00
2024-12-10 17:20:29,107,4037,48,59,2522.33,4725.00,0.00
2024-12-10 17:20:29,108,4037,49,59,2498.98,4725.01,0.00
2024-12-10 17:20:29,107,4037,48,59,2518.89,4725.07,0.00
2024-12-10 17:20:29,107,4038,48,59,2513.00,4726.00,0.00
2024-12-10 17:20:29,108,4038,48,60,2489.73,4726.01,0.00
2024-12-10 17:20:29,107,4038,47,60,2509.92,4726.07,0.00
2024-12-10 17:20:29,108,4037,48,60,2484.50,4726.13,0.00
2024-12-10 17:20:29,107,4037,48,59,2517.95,4726.68,0.00
2024-12-10 17:20:29,107,4038,48,59,2547.37,4727.00,0.00
2024-12-10 17:20:29,108,4038,49,59,2523.78,4727.01,0.00
2024-12-10 17:20:29,107,4038,48,59,2544.30,4727.07,0.00
2024-12-10 17:20:29,108,4037,48,60,2518.13,4727.14,0.00
2024-12-10 17:20:29,108,4038,48,60,2605.31,4728.00,0.00
2024-12-10 17:20:29,109,4038,48,61,2581.40,4728.01,0.00
2024-12-10 17:20:29,108,4038,47,61,2602.27,4728.07,0.00
2024-12-10 17:20:29,108,4039,47,61,2643.71,4729.00,0.00
2024-12-10 17:20:29,109,4039,47,62,2619.46,4729.01,0.00
2024-12-10 17:20:29,108,4039,46,62,2640.67,4729.07,0.00
2024-12-10 17:20:29,107,4039,46,61,2659.62,4729.14,0.00
2024-12-10 17:20:29,107,4040,46,61,2659.29,4730.00,0.00
2024-12-10 17:20:29,108,4040,46,62,2634.66,4730.01,0.00
2024-12-10 17:20:29,108,4041,46,62,2625.70,4731.00,0.00
2024-12-10 17:20:29,109,4041,47,62,2601.61,4731.01,0.00
2024-12-10 17:20:29,108,4041,47,61,2620.83,4731.07,0.00
2024-12-10 17:20:29,108,4042,47,61,2612.87,4732.00,0.00
2024-12-10 17:20:29,109,4042,47,62,2588.90,4732.01,0.00
2024-12-10 17:20:29,108,4042,47,61,2606.14,4732.07,0.00
2024-12-10 17:20:29,107,4042,47,60,2596.75,4732.66,0.00
2024-12-10 17:20:29,107,4043,47,60,2625.34,4733.00,0.00
2024-12-10 17:20:29,108,4043,48,60,2601.03,4733.01,0.00
2024-12-10 17:20:29,108,4044,48,60,2593.85,4734.00,0.00
2024-12-10 17:20:29,109,4044,48,61,2570.06,4734.01,0.00
2024-12-10 17:20:29,109,4045,48,61,2561.65,4735.00,0.00
2024-12-10 17:20:29,110,4045,49,61,2538.36,4735.01,0.00
2024-12-10 17:20:29,111,4044,49,62,2496.71,4735.30,0.00
2024-12-10 17:20:29,111,4045,49,62,2538.56,4736.00,0.00
2024-12-10 17:20:29,112,4045,49,63,2515.90,4736.01,0.00
2024-12-10 17:20:29,111,4045,48,63,2532.12,4736.05,0.00
2024-12-10 17:20:29,110,4045,48,62,2553.44,4736.08,0.00
2024-12-10 17:20:29,111,4044,49,62,2516.86,4736.39,0.00
2024-12-10 17:20:29,111,4045,49,62,2599.22,4737.00,0.00
2024-12-10 17:20:29,112,4045,50,62,2576.01,4737.01,0.00
2024-12-10 17:20:29,111,4045,49,62,2595.41,4737.08,0.00
2024-12-10 17:20:29,111,4046,49,62,2637.76,4738.00,0.00
2024-12-10 17:20:29,112,4046,50,62,2614.20,4738.01,0.00
2024-12-10 17:20:29,111,4046,50,61,2633.95,4738.08,0.00
2024-12-10 17:20:29,112,4045,51,61,2608.32,4738.14,0.00
2024-12-10 17:20:29,112,4046,51,61,2648.61,4739.00,0.00
2024-12-10 17:20:29,113,4046,52,61,2625.17,4739.01,0.00
2024-12-10 17:20:29,113,4047,52,61,2662.63,4740.00,0.00
2024-12-10 17:20:29,114,4047,53,61,2639.28,4740.01,0.00
2024-12-10 17:20:29,113,4047,53,60,2658.89,4740.08,0.00
2024-12-10 17:20:29,113,4048,53,60,2657.74,4741.00,0.00
2024-12-10 17:20:29,114,4048,54,60,2634.43,4741.01,0.00
2024-12-10 17:20:29,113,4048,53,60,2654.00,4741.08,0.00
2024-12-10 17:20:29,113,4049,53,60,2652.85,4742.00,0.00
2024-12-10 17:20:29,114,4049,53,61,2629.58,4742.01,0.00
2024-12-10 17:20:29,114,4050,53,61,2624.72,4743.00,0.00
2024-12-10 17:20:29,115,4050,54,61,2601.90,4743.01,0.00
2024-12-10 17:20:29,114,4050,54,60,2621.01,4743.08,0.00
2024-12-10 17:20:29,114,4051,54,60,2618.94,4744.00,0.00
2024-12-10 17:20:29,115,4051,54,61,2596.16,4744.01,0.00
2024-12-10 17:20:29,114,4051,54,60,2615.22,4744.08,0.00
2024-12-10 17:20:29,115,4050,54,61,2557.08,4744.83,0.00
2024-12-10 17:20:29,115,4051,54,61,2596.85,4745.00,0.00
2024-12-10 17:20:29,116,4051,54,62,2574.46,4745.01,0.00
2024-12-10 17:20:29,115,4051,53,62,2593.16,4745.08,0.00
2024-12-10 17:20:29,116,4050,53,63,2562.26,4745.28,0.00
2024-12-10 17:20:29,116,4051,53,63,2639.31,4746.00,0.00
2024-12-10 17:20:29,117,4051,54,63,2616.76,4746.01,0.00
2024-12-10 17:20:29,117,4052,54,63,2649.00,4747.00,0.00
2024-12-10 17:20:29,118,4052,54,64,2626.55,4747.01,0.00
2024-12-10 17:20:29,117,4052,53,64,2647.78,4747.03,0.00
2024-12-10 17:20:29,116,4052,53,63,2667.77,4747.08,0.00
2024-12-10 17:20:30,116,4053,53,63,2661.97,4748.00,0.00
2024-12-10 17:20:30,117,4053,54,63,2639.21,4748.01,0.00
2024-12-10 17:20:30,116,4053,54,62,2660.74,4748.03,0.00
2024-12-10 17:20:30,115,4053,54,61,2681.43,4748.07,0.00
2024-12-10 17:20:30,114,4053,53,61,2704.54,4748.07,0.00
2024-12-10 17:20:30,114,4054,53,61,2698.49,4749.00,0.00
2024-12-10 17:20:30,115,4054,54,61,2675.03,4749.01,0.00
2024-12-10 17:20:30,114,4054,54,60,2698.07,4749.01,0.00
2024-12-10 17:20:30,113,4054,54,59,2719.04,4749.06,0.00
2024-12-10 17:20:30,113,4055,54,59,2712.72,4750.00,0.00
2024-12-10 17:20:30,114,4055,55,59,2688.92,4750.01,0.00
2024-12-10 17:20:30,113,4055,55,58,2709.81,4750.06,0.00
2024-12-10 17:20:30,112,4055,54,58,2726.67,4750.13,0.00
2024-12-10 17:20:30,112,4056,54,58,2727.27,4751.00,0.00
2024-12-10 17:20:30,113,4056,55,58,2703.13,4751.01,0.00
2024-12-10 17:20:30,112,4056,55,57,2724.33,4751.06,0.00
2024-12-10 17:20:30,112,4057,55,57,2716.75,4752.00,0.00
2024-12-10 17:20:30,113,4057,56,57,2692.71,4752.01,0.00
2024-12-10 17:20:30,113,4058,56,57,2681.35,4753.00,0.00
2024-12-10 17:20:30,114,4058,57,57,2657.83,4753.01,0.00
2024-12-10 17:20:30,113,4058,57,56,2678.02,4753.07,0.00
2024-12-10 17:20:30,113,4059,57,56,2667.96,4754.00,0.00
2024-12-10 17:20:30,114,4059,58,56,2644.56,4754.01,0.00
2024-12-10 17:20:30,113,4059,58,55,2664.63,4754.07,0.00
2024-12-10 17:20:30,113,4060,58,55,2652.61,4755.00,0.00
2024-12-10 17:20:30,114,4060,58,56,2629.34,4755.01,0.00
2024-12-10 17:20:30,115,4059,59,56,2604.84,4755.06,0.00
2024-12-10 17:20:30,114,4059,59,55,2610.42,4755.37,0.00
2024-12-10 17:20:30,114,4060,59,55,2622.21,4756.00,0.00
2024-12-10 17:20:30,115,4060,59,56,2599.41,4756.01,0.00
2024-12-10 17:20:30,114,4060,58,56,2618.91,4756.07,0.00
2024-12-10 17:20:30,113,4060,57,56,2637.55,4756.09,0.00
2024-12-10 17:20:30,113,4061,57,56,2667.61,4757.00,0.00
2024-12-10 17:20:30,114,4061,58,56,2644.21,4757.01,0.00
2024-12-10 17:20:30,113,4061,57,56,2664.28,4757.07,0.00
2024-12-10 17:20:30,113,4062,57,56,2645.13,4758.00,0.00
2024-12-10 17:20:30,114,4062,57,57,2621.92,4758.01,0.00
2024-12-10 17:20:30,113,4062,57,56,2641.79,4758.07,0.00
2024-12-10 17:20:30,114,4061,58,56,2616.54,4758.13,0.00
2024-12-10 17:20:30,113,4061,57,56,2660.03,4758.23,0.00
2024-12-10 17:20:30,112,4061,56,56,2681.94,4758.24,0.00
2024-12-10 17:20:30,112,4062,56,56,2679.74,4759.00,0.00
2024-12-10 17:20:30,113,4062,56,57,2656.03,4759.01,0.00
2024-12-10 17:20:30,112,4062,56,56,2665.98,4759.13,0.00
2024-12-10 17:20:30,112,4063,56,56,2699.02,4760.00,0.00
2024-12-10 17:20:30,113,4063,56,57,2675.13,4760.01,0.00
2024-12-10 17:20:30,112,4063,56,56,2654.13,4760.86,0.00
2024-12-10 17:20:30,112,4064,56,56,2689.96,4761.00,0.00
2024-12-10 17:20:30,113,4064,57,56,2666.15,4761.01,0.00
2024-12-10 17:20:30,112,4064,57,55,2686.59,4761.07,0.00
2024-12-10 17:20:30,112,4065,57,55,2685.42,4762.00,0.00
2024-12-10 17:20:30,113,4065,57,56,2661.66,4762.01,0.00
2024-12-10 17:20:30,113,4066,57,56,2657.16,4763.00,0.00
2024-12-10 17:20:30,114,4066,58,56,2633.85,4763.01,0.00
2024-12-10 17:20:30,113,4066,57,56,2653.41,4763.07,0.00
2024-12-10 17:20:30,113,4067,57,56,2651.82,4764.00,0.00
2024-12-10 17:20:30,114,4067,58,56,2628.56,4764.01,0.00
2024-12-10 17:20:30,115,4066,59,56,2575.87,4764.64,0.00
2024-12-10 17:20:30,115,4067,59,56,2615.12,4765.00,0.00
2024-12-10 17:20:30,116,4067,59,57,2592.58,4765.01,0.00
2024-12-10 17:20:30,116,4068,59,57,2626.74,4766.00,0.00
2024-12-10 17:20:30,117,4068,60,57,2604.29,4766.01,0.00
2024-12-10 17:20:30,116,4068,60,56,2621.25,4766.09,0.00
2024-12-10 17:20:30,116,4069,60,56,2619.16,4767.00,0.00
2024-12-10 17:20:30,117,4069,60,57,2596.77,4767.01,0.00
2024-12-10 17:20:30,118,4068,60,58,2570.11,4767.09,0.00
2024-12-10 17:20:30,118,4069,60,58,2589.97,4768.00,0.00
2024-12-10 17:20:30,119,4069,60,59,2568.21,4768.01,0.00
2024-12-10 17:20:30,118,4069,59,59,2588.31,4768.01,0.00
2024-12-10 17:20:30,118,4070,59,59,2622.39,4769.00,0.00
2024-12-10 17:20:30,119,4070,59,60,2600.36,4769.01,0.00
2024-12-10 17:20:30,119,4071,59,60,2593.69,4770.00,0.00
2024-12-10 17:20:30,120,4071,60,60,2572.07,4770.01,0.00
2024-12-10 17:20:30,119,4071,60,59,2589.72,4770.08,0.00
2024-12-10 17:20:30,120,4070,60,60,2555.87,4770.36,0.00
2024-12-10 17:20:30,120,4071,60,60,2590.90,4771.00,0.00
2024-12-10 17:20:30,121,4071,60,61,2569.49,4771.01,0.00
2024-12-10 17:20:30,120,4071,60,60,2586.97,4771.08,0.00
2024-12-10 17:20:30,121,4070,60,61,2558.12,4771.26,0.00
2024-12-10 17:20:30,121,4071,60,61,2631.95,4772.00,0.00
2024-12-10 17:20:30,122,4071,60,62,2610.37,4772.01,0.00
2024-12-10 17:20:30,122,4072,60,62,2641.82,4773.00,0.00
2024-12-10 17:20:30,123,4072,60,63,2620.35,4773.01,0.00
2024-12-10 17:20:30,123,4073,60,63,2612.36,4774.00,0.00
2024-12-10 17:20:30,124,4073,61,63,2591.29,4774.01,0.00
2024-12-10 17:20:30,123,4073,60,63,2608.52,4774.08,0.00
2024-12-10 17:20:30,123,4074,60,63,2603.98,4775.00,0.00
2024-12-10 17:20:30,124,4074,61,63,2582.98,4775.01,0.00
2024-12-10 17:20:30,124,4075,61,63,2574.66,4776.00,0.00
2024-12-10 17:20:30,125,4075,62,63,2554.06,4776.01,0.00
2024-12-10 17:20:30,124,4075,62,62,2573.51,4776.02,0.00
2024-12-10 17:20:30,123,4075,61,62,2591.36,4776.08,0.00
2024-12-10 17:20:30,122,4075,61,61,2612.21,4776.08,0.00
2024-12-10 17:20:31,122,4076,61,61,2607.70,4777.00,0.00
2024-12-10 17:20:31,123,4076,62,61,2586.50,4777.01,0.00
2024-12-10 17:20:31,122,4076,62,60,2603.83,4777.08,0.00
2024-12-10 17:20:31,122,4077,62,60,2599.09,4778.00,0.00
2024-12-10 17:20:31,123,4077,63,60,2577.96,4778.01,0.00
2024-12-10 17:20:31,124,4076,63,61,2555.27,4778.06,0.00
2024-12-10 17:20:31,123,4076,63,60,2596.66,4778.09,0.00
2024-12-10 17:20:31,123,4077,63,60,2591.75,4779.00,0.00
2024-12-10 17:20:31,124,4077,64,60,2570.85,4779.01,0.00
2024-12-10 17:20:31,123,4077,64,59,2587.91,4779.08,0.00
2024-12-10 17:20:31,123,4078,64,59,2621.49,4780.00,0.00
2024-12-10 17:20:31,124,4078,64,60,2600.35,4780.01,0.00
2024-12-10 17:20:31,123,4078,64,59,2617.65,4780.08,0.00
2024-12-10 17:20:31,123,4079,64,59,2612.39,4781.00,0.00
2024-12-10 17:20:31,124,4079,64,60,2591.32,4781.01,0.00
2024-12-10 17:20:31,124,4080,64,60,2582.47,4782.00,0.00
2024-12-10 17:20:31,125,4080,64,61,2561.81,4782.01,0.00
2024-12-10 17:20:31,124,4080,63,61,2578.66,4782.08,0.00
2024-12-10 17:20:31,124,4081,63,61,2573.47,4783.00,0.00
2024-12-10 17:20:31,125,4081,63,62,2552.88,4783.01,0.00
2024-12-10 17:20:31,124,4081,63,61,2565.07,4783.18,0.00
2024-12-10 17:20:31,125,4080,64,61,2541.71,4783.25,0.00
2024-12-10 17:20:31,126,4079,65,61,2536.64,4783.56,0.00
2024-12-10 17:20:31,126,4080,65,61,2571.53,4784.00,0.00
2024-12-10 17:20:31,127,4080,65,62,2551.28,4784.01,0.00
2024-12-10 17:20:31,126,4080,64,62,2567.77,4784.08,0.00
2024-12-10 17:20:31,126,4081,64,62,2637.81,4785.00,0.00
2024-12-10 17:20:31,127,4081,64,63,2617.04,4785.01,0.00
2024-12-10 17:20:31,126,4081,64,62,2634.05,4785.08,0.00
2024-12-10 17:20:31,125,4081,64,61,2654.43,4785.09,0.00
2024-12-10 17:20:31,125,4082,64,61,2649.07,4786.00,0.00
2024-12-10 17:20:31,126,4082,65,61,2628.04,4786.01,0.00
2024-12-10 17:20:31,125,4082,64,61,2645.28,4786.08,0.00
2024-12-10 17:20:31,125,4083,64,61,2639.44,4787.00,0.00
2024-12-10 17:20:31,126,4083,65,61,2618.50,4787.01,0.00
2024-12-10 17:20:31,125,4083,64,61,2635.65,4787.08,0.00
2024-12-10 17:20:31,125,4084,64,61,2629.78,4788.00,0.00
2024-12-10 17:20:31,126,4084,64,62,2608.91,4788.01,0.00
2024-12-10 17:20:31,125,4084,64,61,2625.99,4788.08,0.00
2024-12-10 17:20:31,125,4085,64,61,2620.47,4789.00,0.00
2024-12-10 17:20:31,126,4085,65,61,2599.67,4789.01,0.00
2024-12-10 17:20:31,125,4085,64,61,2616.68,4789.08,0.00
2024-12-10 17:20:31,125,4086,64,61,2611.40,4790.00,0.00
2024-12-10 17:20:31,126,4086,64,62,2590.67,4790.01,0.00
2024-12-10 17:20:31,125,4086,64,61,2607.60,4790.08,0.00
2024-12-10 17:20:31,124,4086,63,61,2625.30,4790.14,0.00
2024-12-10 17:20:31,124,4087,63,61,2623.10,4791.00,0.00
2024-12-10 17:20:31,125,4087,64,61,2602.11,4791.01,0.00
2024-12-10 17:20:31,124,4087,64,60,2619.55,4791.08,0.00
2024-12-10 17:20:31,124,4088,64,60,2614.65,4792.00,0.00
2024-12-10 17:20:31,125,4088,64,61,2593.74,4792.01,0.00
2024-12-10 17:20:31,125,4089,64,61,2585.05,4793.00,0.00
2024-12-10 17:20:31,126,4089,64,62,2564.53,4793.01,0.00
2024-12-10 17:20:31,125,4089,64,61,2581.25,4793.08,0.00
2024-12-10 17:20:31,125,4090,64,61,2575.61,4794.00,0.00
2024-12-10 17:20:31,126,4090,64,62,2555.17,4794.01,0.00
2024-12-10 17:20:31,127,4089,65,62,2500.42,4794.75,0.00
2024-12-10 17:20:31,127,4090,65,62,2535.38,4795.00,0.00
2024-12-10 17:20:31,128,4090,66,62,2515.57,4795.01,0.00
2024-12-10 17:20:31,127,4090,66,61,2530.88,4795.09,0.00
2024-12-10 17:20:31,127,4090,66,61,2562.03,4796.00,0.00
2024-12-10 17:20:31,128,4090,67,61,2542.01,4796.01,0.00
2024-12-10 17:20:31,128,4091,67,61,2529.96,4797.00,0.00
2024-12-10 17:20:31,129,4091,67,62,2510.35,4797.01,0.00
2024-12-10 17:20:31,129,4092,67,62,2497.25,4798.00,0.00
2024-12-10 17:20:31,130,4092,67,63,2478.04,4798.01,0.00
2024-12-10 17:20:31,129,4092,66,63,2493.19,4798.09,0.00
2024-12-10 17:20:31,130,4091,67,63,2443.85,4798.69,0.00
2024-12-10 17:20:31,130,4092,67,63,2476.36,4799.00,0.00
2024-12-10 17:20:31,131,4092,68,63,2457.45,4799.01,0.00
2024-12-10 17:20:31,130,4092,68,62,2472.33,4799.08,0.00
2024-12-10 17:20:31,131,4091,69,62,2451.99,4799.13,0.00
2024-12-10 17:20:31,131,4092,69,62,2490.61,4800.00,0.00
2024-12-10 17:20:31,132,4092,70,62,2471.74,4800.01,0.00
2024-12-10 17:20:31,131,4092,70,61,2486.62,4800.08,0.00
2024-12-10 17:20:31,131,4093,70,61,2510.16,4801.00,0.00
2024-12-10 17:20:31,132,4093,70,62,2491.14,4801.01,0.00
2024-12-10 17:20:31,132,4094,70,62,2473.67,4802.00,0.00
2024-12-10 17:20:31,133,4094,71,62,2455.07,4802.01,0.00
2024-12-10 17:20:31,132,4094,70,62,2469.70,4802.08,0.00
2024-12-10 17:20:31,133,4093,71,62,2429.61,4802.54,0.00
2024-12-10 17:20:31,133,4094,71,62,2455.54,4803.00,0.00
2024-12-10 17:20:31,134,4094,71,63,2437.21,4803.01,0.00
2024-12-10 17:20:31,133,4094,71,62,2451.60,4803.08,0.00
2024-12-10 17:20:31,133,4095,71,62,2473.20,4804.00,0.00
2024-12-10 17:20:31,134,4095,72,62,2454.74,4804.01,0.00
2024-12-10 17:20:31,133,4095,72,61,2469.26,4804.08,0.00
2024-12-10 17:20:32,133,4096,72,61,2455.28,4805.00,0.00
2024-12-10 17:20:32,134,4096,73,61,2436.96,4805.01,0.00
2024-12-10 17:20:32,133,4096,72,61,2453.48,4805.04,0.00
2024-12-10 17:20:32,132,4096,71,61,2434.61,4805.80,0.00
2024-12-10 17:20:32,132,4097,71,61,2460.21,4806.00,0.00
2024-12-10 17:20:32,133,4097,71,62,2441.71,4806.01,0.00
2024-12-10 17:20:32,132,4097,71,61,2455.88,4806.09,0.00
2024-12-10 17:20:32,131,4097,71,60,2473.43,4806.12,0.00
2024-12-10 17:20:32,131,4098,71,60,2466.35,4807.00,0.00
2024-12-10 17:20:32,132,4098,71,61,2447.66,4807.01,0.00
2024-12-10 17:20:32,131,4098,70,61,2461.98,4807.09,0.00
2024-12-10 17:20:32,131,4099,70,61,2452.82,4808.00,0.00
2024-12-10 17:20:32,132,4099,71,61,2434.24,4808.01,0.00
2024-12-10 17:20:32,131,4099,70,61,2448.46,4808.09,0.00
2024-12-10 17:20:32,130,4099,70,60,2466.87,4808.09,0.00
2024-12-10 17:20:32,130,4100,70,60,2457.39,4809.00,0.00
2024-12-10 17:20:32,131,4100,70,61,2438.63,4809.01,0.00
2024-12-10 17:20:32,131,4101,70,61,2424.56,4810.00,0.00
2024-12-10 17:20:32,132,4101,71,61,2406.19,4810.01,0.00
2024-12-10 17:20:32,131,4101,70,61,2418.98,4810.12,0.00
2024-12-10 17:20:32,132,4100,70,62,2382.91,4810.51,0.00
2024-12-10 17:20:32,133,4099,71,62,2379.16,4810.63,0.00
2024-12-10 17:20:32,133,4099,71,62,2410.01,4811.00,0.00
2024-12-10 17:20:32,134,4099,71,63,2392.03,4811.01,0.00
2024-12-10 17:20:32,133,4099,70,63,2405.71,4811.09,0.00
2024-12-10 17:20:32,132,4099,70,62,2423.57,4811.09,0.00
2024-12-10 17:20:32,133,4098,70,63,2398.85,4811.24,0.00
2024-12-10 17:20:32,133,4099,70,63,2485.34,4812.00,0.00
2024-12-10 17:20:32,134,4099,70,64,2466.79,4812.01,0.00
2024-12-10 17:20:32,133,4099,69,64,2481.36,4812.09,0.00
2024-12-10 17:20:32,133,4100,69,64,2508.03,4813.00,0.00
2024-12-10 17:20:32,134,4100,69,65,2489.31,4813.01,0.00
2024-12-10 17:20:32,133,4100,68,65,2503.98,4813.09,0.00
2024-12-10 17:20:32,133,4101,68,65,2494.78,4814.00,0.00
2024-12-10 17:20:32,134,4101,68,66,2476.16,4814.01,0.00
2024-12-10 17:20:32,133,4101,67,66,2453.78,4814.87,0.00
2024-12-10 17:20:32,133,4102,67,66,2483.59,4815.00,0.00
2024-12-10 17:20:32,134,4102,67,67,2465.05,4815.01,0.00
2024-12-10 17:20:32,133,4102,66,67,2479.28,4815.09,0.00
2024-12-10 17:20:32,133,4103,66,67,2472.13,4816.00,0.00
2024-12-10 17:20:32,134,4103,66,68,2453.69,4816.01,0.00
2024-12-10 17:20:32,133,4103,65,68,2467.82,4816.09,0.00
2024-12-10 17:20:32,133,4104,65,68,2460.70,4817.00,0.00
2024-12-10 17:20:32,134,4104,65,69,2442.33,4817.01,0.00
2024-12-10 17:20:32,133,4104,65,68,2455.37,4817.09,0.00
2024-12-10 17:20:32,133,4105,65,68,2447.60,4818.00,0.00
2024-12-10 17:20:32,134,4105,66,68,2429.33,4818.01,0.00
2024-12-10 17:20:32,133,4105,65,68,2441.75,4818.09,0.00
2024-12-10 17:20:32,134,4104,65,69,2389.74,4818.79,0.00
2024-12-10 17:20:32,134,4105,65,69,2424.09,4819.00,0.00
2024-12-10 17:20:32,135,4105,65,70,2406.13,4819.01,0.00
2024-12-10 17:20:32,134,4105,65,69,2423.73,4819.01,0.00
2024-12-10 17:20:32,133,4105,64,69,2436.43,4819.08,0.00
2024-12-10 17:20:32,132,4105,63,69,2454.53,4819.08,0.00
2024-12-10 17:20:32,132,4106,63,69,2482.29,4820.00,0.00
2024-12-10 17:20:32,133,4106,64,69,2463.62,4820.01,0.00
2024-12-10 17:20:32,132,4106,63,69,2477.00,4820.08,0.00
2024-12-10 17:20:32,131,4106,63,68,2495.54,4820.08,0.00
2024-12-10 17:20:32,130,4106,63,67,2506.90,4820.20,0.00
2024-12-10 17:20:32,130,4107,63,67,2505.89,4821.00,0.00
2024-12-10 17:20:32,131,4107,64,67,2486.77,4821.01,0.00
2024-12-10 17:20:32,130,4107,63,67,2504.00,4821.02,0.00
2024-12-10 17:20:32,129,4107,62,67,2520.44,4821.08,0.00
2024-12-10 17:20:32,130,4106,62,68,2494.77,4821.22,0.00
2024-12-10 17:20:32,131,4105,63,68,2484.95,4821.33,0.00
2024-12-10 17:20:32,131,4106,63,68,2516.68,4822.00,0.00
2024-12-10 17:20:32,132,4106,63,69,2497.62,4822.01,0.00
2024-12-10 17:20:32,131,4106,63,68,2512.91,4822.08,0.00
2024-12-10 17:20:32,132,4105,64,68,2463.80,4822.72,0.00
2024-12-10 17:20:32,132,4106,64,68,2570.36,4823.00,0.00
2024-12-10 17:20:32,133,4106,65,68,2551.03,4823.01,0.00
2024-12-10 17:20:32,132,4106,65,67,2566.21,4823.08,0.00
2024-12-10 17:20:32,132,4107,65,67,2595.23,4824.00,0.00
2024-12-10 17:20:32,133,4107,66,67,2575.71,4824.01,0.00
2024-12-10 17:20:32,134,4106,66,68,2553.56,4824.08,0.00
2024-12-10 17:20:32,133,4106,66,67,2584.63,4824.08,0.00
2024-12-10 17:20:32,133,4107,66,67,2577.16,4825.00,0.00
2024-12-10 17:20:32,134,4107,66,68,2557.93,4825.01,0.00
2024-12-10 17:20:32,133,4107,65,68,2573.51,4825.08,0.00
2024-12-10 17:20:32,134,4106,65,69,2523.25,4825.74,0.00
2024-12-10 17:20:32,134,4107,65,69,2592.26,4826.00,0.00
2024-12-10 17:20:32,135,4107,65,70,2573.06,4826.01,0.00
2024-12-10 17:20:32,134,4107,65,69,2591.90,4826.01,0.00
2024-12-10 17:20:32,133,4107,65,68,2608.15,4826.07,0.00
2024-12-10 17:20:32,132,4107,64,68,2627.55,4826.07,0.00
2024-12-10 17:20:32,132,4108,64,68,2656.22,4827.00,0.00
2024-12-10 17:20:32,133,4108,64,69,2636.25,4827.01,0.00
2024-12-10 17:20:32,133,4109,64,69,2625.18,4828.00,0.00
2024-12-10 17:20:32,134,4109,64,70,2605.59,4828.01,0.00
2024-12-10 17:20:32,133,4109,64,69,2621.22,4828.08,0.00
2024-12-10 17:20:32,133,4110,64,69,2613.74,4829.00,0.00
2024-12-10 17:20:32,134,4110,64,70,2594.24,4829.01,0.00
2024-12-10 17:20:32,135,4109,64,71,2572.89,4829.07,0.00
2024-12-10 17:20:32,134,4109,64,70,2592.11,4829.09,0.00
2024-12-10 17:20:32,134,4110,64,70,2584.68,4830.00,0.00
2024-12-10 17:20:32,135,4110,64,71,2565.54,4830.01,0.00
2024-12-10 17:20:32,134,4110,64,70,2580.75,4830.08,0.00
2024-12-10 17:20:32,134,4111,64,70,2609.01,4831.00,0.00
2024-12-10 17:20:32,135,4111,65,70,2589.68,4831.01,0.00
2024-12-10 17:20:32,136,4110,65,71,2569.59,4831.04,0.00
2024-12-10 17:20:33,135,4110,65,70,2614.33,4831.04,0.00
2024-12-10 17:20:33,134,4110,64,70,2631.70,4831.08,0.00
2024-12-10 17:20:33,134,4111,64,70,2623.64,4832.00,0.00
2024-12-10 17:20:33,135,4111,64,71,2604.20,4832.01,0.00
2024-12-10 17:20:33,134,4111,64,70,2620.06,4832.08,0.00
2024-12-10 17:20:33,134,4112,64,70,2647.51,4833.00,0.00
2024-12-10 17:20:33,135,4112,65,70,2627.90,4833.01,0.00
2024-12-10 17:20:33,134,4112,64,70,2643.94,4833.08,0.00
2024-12-10 17:20:33,135,4111,65,70,2597.36,4833.65,0.00
2024-12-10 17:20:33,135,4112,65,70,2628.44,4834.00,0.00
2024-12-10 17:20:33,136,4112,66,70,2609.11,4834.01,0.00
2024-12-10 17:20:33,137,4111,67,70,2576.74,4834.30,0.00
2024-12-10 17:20:33,137,4112,67,70,2640.09,4835.00,0.00
2024-12-10 17:20:33,138,4112,68,70,2620.96,4835.01,0.00
2024-12-10 17:20:33,137,4112,67,70,2636.59,4835.07,0.00
2024-12-10 17:20:33,136,4112,67,69,2655.62,4835.07,0.00
2024-12-10 17:20:33,136,4113,67,69,2682.29,4836.00,0.00
2024-12-10 17:20:33,137,4113,67,70,2662.71,4836.01,0.00
2024-12-10 17:20:33,136,4113,67,69,2678.76,4836.07,0.00
2024-12-10 17:20:33,136,4114,67,69,2668.90,4837.00,0.00
2024-12-10 17:20:33,137,4114,68,69,2649.42,4837.01,0.00
2024-12-10 17:20:33,136,4114,67,69,2665.03,4837.08,0.00
2024-12-10 17:20:33,136,4115,67,69,2654.30,4838.00,0.00
2024-12-10 17:20:33,137,4115,67,70,2634.93,4838.01,0.00
2024-12-10 17:20:33,136,4115,66,70,2650.42,4838.08,0.00
2024-12-10 17:20:33,135,4115,65,70,2669.70,4838.08,0.00
2024-12-10 17:20:33,136,4114,65,71,2619.12,4838.67,0.00
2024-12-10 17:20:33,136,4115,65,71,2650.23,4839.00,0.00
2024-12-10 17:20:33,137,4115,65,72,2630.88,4839.01,0.00
2024-12-10 17:20:33,136,4115,64,72,2646.35,4839.08,0.00
2024-12-10 17:20:33,137,4114,65,72,2605.78,4839.48,0.00
2024-12-10 17:20:33,138,4113,66,72,2597.33,4839.65,0.00
2024-12-10 17:20:33,138,4114,66,72,2662.21,4840.00,0.00
2024-12-10 17:20:33,139,4114,67,72,2643.06,4840.01,0.00
2024-12-10 17:20:33,138,4114,66,72,2658.39,4840.08,0.00
2024-12-10 17:20:33,138,4115,66,72,2714.65,4841.00,0.00
2024-12-10 17:20:33,139,4115,66,73,2695.12,4841.01,0.00
2024-12-10 17:20:33,138,4115,65,73,2710.82,4841.08,0.00
2024-12-10 17:20:33,138,4116,65,73,2696.97,4842.00,0.00
2024-12-10 17:20:33,139,4116,66,73,2677.57,4842.01,0.00
2024-12-10 17:20:33,140,4115,66,74,2658.44,4842.02,0.00
2024-12-10 17:20:33,139,4115,66,73,2704.08,4842.09,0.00
2024-12-10 17:20:33,139,4116,66,73,2690.66,4843.00,0.00
2024-12-10 17:20:33,140,4116,67,73,2671.44,4843.01,0.00
2024-12-10 17:20:33,139,4116,66,73,2686.87,4843.08,0.00
2024-12-10 17:20:33,139,4117,66,73,2708.38,4844.00,0.00
2024-12-10 17:20:33,140,4117,67,73,2689.04,4844.01,0.00
2024-12-10 17:20:33,139,4117,66,73,2705.62,4844.06,0.00
2024-12-10 17:20:33,138,4117,66,72,2724.18,4844.07,0.00
2024-12-10 17:20:33,137,4117,66,71,2743.72,4844.07,0.00
2024-12-10 17:20:33,137,4118,66,71,2730.51,4845.00,0.00
2024-12-10 17:20:33,138,4118,67,71,2710.72,4845.01,0.00
2024-12-10 17:20:33,137,4118,67,70,2727.01,4845.07,0.00
2024-12-10 17:20:33,137,4119,67,70,2713.57,4846.00,0.00
2024-12-10 17:20:33,138,4119,67,71,2693.91,4846.01,0.00
2024-12-10 17:20:33,137,4119,66,71,2710.07,4846.07,0.00
2024-12-10 17:20:33,137,4120,66,71,2695.50,4847.00,0.00
2024-12-10 17:20:33,138,4120,66,72,2675.97,4847.01,0.00
2024-12-10 17:20:33,138,4121,66,72,2655.57,4848.00,0.00
2024-12-10 17:20:33,139,4121,66,73,2636.47,4848.01,0.00
2024-12-10 17:20:33,138,4121,65,73,2651.75,4848.08,0.00
2024-12-10 17:20:33,139,4120,65,74,2621.57,4848.30,0.00
2024-12-10 17:20:33,138,4120,64,74,2660.08,4848.34,0.00
2024-12-10 17:20:33,138,4121,64,74,2660.81,4849.00,0.00
2024-12-10 17:20:33,139,4121,64,75,2641.67,4849.01,0.00
2024-12-10 17:20:33,138,4121,63,75,2657.09,4849.08,0.00
2024-12-10 17:20:33,138,4122,63,75,2674.40,4850.00,0.00
2024-12-10 17:20:33,139,4122,64,75,2655.16,4850.01,0.00
2024-12-10 17:20:33,138,4122,63,75,2670.57,4850.08,0.00
2024-12-10 17:20:33,137,4122,62,75,2685.26,4850.17,0.00
2024-12-10 17:20:33,136,4122,61,75,2695.54,4850.30,0.00
2024-12-10 17:20:33,136,4123,61,75,2693.94,4851.00,0.00
2024-12-10 17:20:33,137,4123,61,76,2674.27,4851.01,0.00
2024-12-10 17:20:33,136,4123,60,76,2690.05,4851.08,0.00
2024-12-10 17:20:33,135,4123,59,76,2699.49,4851.29,0.00
2024-12-10 17:20:33,135,4124,59,76,2697.45,4852.00,0.00
2024-12-10 17:20:33,136,4124,59,77,2677.61,4852.01,0.00
2024-12-10 17:20:33,136,4125,59,77,2661.71,4853.00,0.00
2024-12-10 17:20:33,137,4125,59,78,2642.28,4853.01,0.00
2024-12-10 17:20:33,136,4125,58,78,2657.47,4853.09,0.00
2024-12-10 17:20:33,136,4126,58,78,2645.48,4854.00,0.00
2024-12-10 17:20:33,137,4126,58,79,2626.17,4854.01,0.00
2024-12-10 17:20:33,136,4126,57,79,2641.23,4854.09,0.00
2024-12-10 17:20:33,137,4125,58,79,2583.94,4854.79,0.00
2024-12-10 17:20:33,137,4126,58,79,2617.00,4855.00,0.00
2024-12-10 17:20:33,138,4126,59,79,2598.03,4855.01,0.00
2024-12-10 17:20:33,137,4126,59,78,2612.78,4855.09,0.00
2024-12-10 17:20:33,137,4127,59,78,2632.13,4856.00,0.00
2024-12-10 17:20:33,138,4127,59,79,2613.05,4856.01,0.00
2024-12-10 17:20:33,137,4127,59,78,2627.56,4856.10,0.00
2024-12-10 17:20:33,136,4127,59,77,2639.33,4856.22,0.00
2024-12-10 17:20:33,136,4128,59,77,2629.44,4857.00,0.00
2024-12-10 17:20:33,137,4128,60,77,2610.24,4857.01,0.00
2024-12-10 17:20:33,136,4128,59,77,2624.84,4857.10,0.00
2024-12-10 17:20:34,137,4127,60,77,2576.73,4857.55,0.00
2024-12-10 17:20:34,137,4128,60,77,2602.71,4858.00,0.00
2024-12-10 17:20:34,138,4128,60,78,2583.85,4858.01,0.00
2024-12-10 17:20:34,137,4128,60,77,2598.14,4858.10,0.00
2024-12-10 17:20:34,136,4128,60,76,2608.09,4858.22,0.00
2024-12-10 17:20:34,135,4128,59,76,2626.85,4858.23,0.00
2024-12-10 17:20:34,135,4129,59,76,2651.83,4859.00,0.00
2024-12-10 17:20:34,136,4129,59,77,2632.33,4859.01,0.00
2024-12-10 17:20:34,135,4129,59,76,2646.84,4859.10,0.00
2024-12-10 17:20:34,134,4129,59,75,2658.34,4859.21,0.00
2024-12-10 17:20:34,134,4130,59,75,2643.71,4860.00,0.00
2024-12-10 17:20:34,135,4130,60,75,2624.12,4860.01,0.00
2024-12-10 17:20:34,134,4130,60,74,2638.67,4860.10,0.00
2024-12-10 17:20:34,133,4130,60,73,2636.73,4860.41,0.00
2024-12-10 17:20:34,133,4131,60,73,2636.36,4861.00,0.00
2024-12-10 17:20:34,134,4131,60,74,2616.69,4861.01,0.00
2024-12-10 17:20:34,133,4131,60,73,2619.54,4861.27,0.00
2024-12-10 17:20:34,132,4131,60,72,2620.43,4861.54,0.00
2024-12-10 17:20:34,131,4131,60,71,2640.27,4861.54,0.00
2024-12-10 17:20:34,131,4132,60,71,2652.21,4862.00,0.00
2024-12-10 17:20:34,132,4132,61,71,2632.11,4862.01,0.00
2024-12-10 17:20:34,131,4132,61,70,2645.84,4862.11,0.00
2024-12-10 17:20:34,131,4133,61,70,2631.36,4863.00,0.00
2024-12-10 17:20:34,132,4133,62,70,2611.42,4863.01,0.00
2024-12-10 17:20:34,131,4133,62,69,2629.22,4863.04,0.00
2024-12-10 17:20:34,130,4133,61,69,2646.10,4863.10,0.00
2024-12-10 17:20:34,129,4133,61,68,2663.58,4863.15,0.00
2024-12-10 17:20:34,129,4134,61,68,2653.59,4864.00,0.00
2024-12-10 17:20:34,130,4134,62,68,2633.18,4864.01,0.00
2024-12-10 17:20:34,129,4134,61,68,2648.73,4864.10,0.00
2024-12-10 17:20:34,128,4134,61,67,2653.85,4864.34,0.00
2024-12-10 17:20:34,129,4133,62,67,2617.88,4864.63,0.00
2024-12-10 17:20:34,129,4134,62,67,2651.74,4865.00,0.00
2024-12-10 17:20:34,130,4134,62,68,2631.34,4865.01,0.00
2024-12-10 17:20:34,129,4134,62,67,2646.50,4865.11,0.00
2024-12-10 17:20:34,128,4134,61,67,2663.67,4865.16,0.00
2024-12-10 17:20:34,127,4134,60,67,2661.84,4865.56,0.00
2024-12-10 17:20:34,127,4135,60,67,2717.13,4866.00,0.00
2024-12-10 17:20:34,128,4135,60,68,2695.90,4866.01,0.00
2024-12-10 17:20:34,129,4134,60,69,2670.52,4866.12,0.00
2024-12-10 17:20:34,128,4134,59,69,2716.48,4866.12,0.00
2024-12-10 17:20:34,128,4135,59,69,2706.64,4867.00,0.00
2024-12-10 17:20:34,129,4135,59,70,2685.66,4867.01,0.00
2024-12-10 17:20:34,128,4135,58,70,2705.51,4867.02,0.00
2024-12-10 17:20:34,127,4135,58,69,2722.25,4867.11,0.00
2024-12-10 17:20:34,126,4135,57,69,2740.57,4867.15,0.00
2024-12-10 17:20:34,126,4136,57,69,2772.36,4868.00,0.00
2024-12-10 17:20:34,127,4136,58,69,2750.53,4868.01,0.00
2024-12-10 17:20:34,126,4136,58,68,2763.85,4868.16,0.00
2024-12-10 17:20:34,125,4136,58,67,2784.90,4868.16,0.00
2024-12-10 17:20:34,126,4135,59,67,2745.85,4868.50,0.00
2024-12-10 17:20:34,126,4136,59,67,2778.29,4869.00,0.00
2024-12-10 17:20:34,127,4136,60,67,2756.41,4869.01,0.00
2024-12-10 17:20:34,126,4136,60,66,2772.93,4869.11,0.00
2024-12-10 17:20:34,127,4135,60,67,2736.56,4869.39,0.00
2024-12-10 17:20:34,127,4136,60,67,2806.40,4870.00,0.00
2024-12-10 17:20:34,128,4136,61,67,2784.47,4870.01,0.00
2024-12-10 17:20:34,127,4136,60,67,2804.50,4870.04,0.00
2024-12-10 17:20:34,126,4136,59,67,2823.31,4870.10,0.00
2024-12-10 17:20:34,125,4136,59,66,2845.50,4870.10,0.00
2024-12-10 17:20:34,125,4137,59,66,2878.21,4871.00,0.00
2024-12-10 17:20:34,126,4137,59,67,2855.36,4871.01,0.00
2024-12-10 17:20:34,127,4136,59,68,2828.32,4871.12,0.00
2024-12-10 17:20:34,127,4137,59,68,2828.73,4872.00,0.00
2024-12-10 17:20:34,128,4137,59,69,2806.63,4872.01,0.00
2024-12-10 17:20:34,127,4137,59,68,2810.08,4872.32,0.00
2024-12-10 17:20:34,127,4138,59,68,2851.44,4873.00,0.00
2024-12-10 17:20:34,128,4138,60,68,2829.16,4873.01,0.00
2024-12-10 17:20:34,129,4137,60,69,2777.00,4873.57,0.00
2024-12-10 17:20:34,129,4138,60,69,2799.28,4874.00,0.00
2024-12-10 17:20:34,130,4138,61,69,2777.74,4874.01,0.00
2024-12-10 17:20:34,130,4139,61,69,2798.40,4875.00,0.00
2024-12-10 17:20:34,131,4139,62,69,2777.03,4875.01,0.00
2024-12-10 17:20:34,131,4140,62,69,2759.24,4876.00,0.00
2024-12-10 17:20:34,132,4140,63,69,2738.34,4876.01,0.00
2024-12-10 17:20:34,132,4141,63,69,2718.70,4877.00,0.00
2024-12-10 17:20:34,133,4141,63,70,2698.26,4877.01,0.00
2024-12-10 17:20:34,132,4141,63,69,2707.14,4877.24,0.00
2024-12-10 17:20:34,132,4142,63,69,2699.53,4878.00,0.00
2024-12-10 17:20:34,133,4142,64,69,2679.23,4878.01,0.00
2024-12-10 17:20:34,132,4142,63,69,2698.79,4878.02,0.00
2024-12-10 17:20:34,131,4142,63,68,2714.97,4878.10,0.00
2024-12-10 17:20:34,130,4142,62,68,2708.20,4878.55,0.00
2024-12-10 17:20:34,130,4143,62,68,2724.31,4879.00,0.00
2024-12-10 17:20:34,131,4143,62,69,2703.51,4879.01,0.00
2024-12-10 17:20:34,132,4142,63,69,2671.53,4879.24,0.00
2024-12-10 17:20:34,132,4143,63,69,2696.88,4880.00,0.00
2024-12-10 17:20:34,133,4143,64,69,2676.60,4880.01,0.00
2024-12-10 17:20:34,132,4143,64,68,2692.11,4880.10,0.00
2024-12-10 17:20:34,131,4143,64,67,2691.97,4880.44,0.00
2024-12-10 17:20:34,131,4144,64,67,2736.85,4881.00,0.00
2024-12-10 17:20:34,132,4144,65,67,2716.11,4881.01,0.00
2024-12-10 17:20:34,132,4145,65,67,2699.58,4882.00,0.00
2024-12-10 17:20:34,133,4145,65,68,2679.29,4882.01,0.00
2024-12-10 17:20:34,132,4145,65,67,2694.99,4882.10,0.00
2024-12-10 17:20:34,132,4146,65,67,2681.05,4883.00,0.00
2024-12-10 17:20:34,133,4146,65,68,2660.89,4883.01,0.00
2024-12-10 17:20:34,132,4146,64,68,2651.90,4883.52,0.00
2024-12-10 17:20:35,132,4147,64,68,2665.58,4884.00,0.00
2024-12-10 17:20:35,133,4147,64,69,2645.54,4884.01,0.00
2024-12-10 17:20:35,132,4147,64,68,2655.71,4884.11,0.00
2024-12-10 17:20:35,131,4147,64,67,2673.25,4884.15,0.00
2024-12-10 17:20:35,132,4146,65,67,2639.78,4884.44,0.00
2024-12-10 17:20:35,132,4147,65,67,2670.57,4885.00,0.00
2024-12-10 17:20:35,133,4147,66,67,2650.49,4885.01,0.00
2024-12-10 17:20:35,132,4147,65,67,2661.74,4885.10,0.00
2024-12-10 17:20:35,132,4148,65,67,2690.00,4886.00,0.00
2024-12-10 17:20:35,133,4148,66,67,2669.78,4886.01,0.00
2024-12-10 17:20:35,132,4148,65,67,2684.41,4886.10,0.00
2024-12-10 17:20:35,132,4149,65,67,2674.33,4887.00,0.00
2024-12-10 17:20:35,133,4149,65,68,2654.22,4887.01,0.00
2024-12-10 17:20:35,134,4148,65,69,2629.64,4887.09,0.00
2024-12-10 17:20:35,133,4148,64,69,2655.67,4887.11,0.00
2024-12-10 17:20:35,133,4149,64,69,2644.79,4888.00,0.00
2024-12-10 17:20:35,134,4149,65,69,2625.05,4888.01,0.00
2024-12-10 17:20:35,133,4149,65,68,2637.70,4888.10,0.00
2024-12-10 17:20:35,133,4150,65,68,2662.30,4889.00,0.00
2024-12-10 17:20:35,134,4150,65,69,2642.43,4889.01,0.00
2024-12-10 17:20:35,133,4150,64,69,2654.32,4889.10,0.00
2024-12-10 17:20:35,133,4151,64,69,2641.15,4890.00,0.00
2024-12-10 17:20:35,134,4151,64,70,2621.44,4890.01,0.00
2024-12-10 17:20:35,133,4151,63,70,2636.08,4890.04,0.00
2024-12-10 17:20:35,132,4151,63,69,2653.11,4890.09,0.00
2024-12-10 17:20:35,132,4152,63,69,2638.29,4891.00,0.00
2024-12-10 17:20:35,133,4152,64,69,2618.46,4891.01,0.00
2024-12-10 17:20:35,132,4152,63,69,2633.88,4891.09,0.00
2024-12-10 17:20:35,131,4152,62,69,2647.14,4891.23,0.00
2024-12-10 17:20:35,131,4153,62,69,2637.60,4892.00,0.00
2024-12-10 17:20:35,132,4153,62,70,2617.62,4892.01,0.00
2024-12-10 17:20:35,133,4152,62,71,2595.38,4892.08,0.00
2024-12-10 17:20:35,132,4152,61,71,2614.77,4892.44,0.00
2024-12-10 17:20:35,131,4152,61,70,2632.95,4892.46,0.00
2024-12-10 17:20:35,131,4153,61,70,2640.14,4893.00,0.00
2024-12-10 17:20:35,132,4153,62,70,2620.14,4893.01,0.00
2024-12-10 17:20:35,131,4153,61,70,2632.61,4893.15,0.00
2024-12-10 17:20:35,130,4153,61,69,2637.15,4893.46,0.00
2024-12-10 17:20:35,130,4154,61,69,2686.05,4894.00,0.00
2024-12-10 17:20:35,131,4154,62,69,2665.55,4894.01,0.00
2024-12-10 17:20:35,132,4153,62,70,2641.62,4894.08,0.00
2024-12-10 17:20:35,131,4153,62,69,2663.66,4894.08,0.00
2024-12-10 17:20:35,130,4153,62,68,2683.03,4894.10,0.00
2024-12-10 17:20:35,130,4154,62,68,2676.15,4895.00,0.00
2024-12-10 17:20:35,131,4154,63,68,2655.72,4895.01,0.00
2024-12-10 17:20:35,130,4154,62,68,2670.09,4895.10,0.00
2024-12-10 17:20:35,130,4155,62,68,2699.71,4896.00,0.00
2024-12-10 17:20:35,131,4155,62,69,2679.10,4896.01,0.00
2024-12-10 17:20:35,130,4155,61,69,2693.47,4896.10,0.00
2024-12-10 17:20:35,130,4156,61,69,2684.15,4897.00,0.00
2024-12-10 17:20:35,131,4156,61,70,2663.66,4897.01,0.00
2024-12-10 17:20:35,131,4157,61,70,2646.30,4898.00,0.00
2024-12-10 17:20:35,132,4157,62,70,2626.25,4898.01,0.00
2024-12-10 17:20:35,133,4156,63,70,2602.58,4898.07,0.00
2024-12-10 17:20:35,132,4156,63,69,2646.77,4898.21,0.00
2024-12-10 17:20:35,132,4157,63,69,2642.76,4899.00,0.00
2024-12-10 17:20:35,133,4157,64,69,2622.88,4899.01,0.00
2024-12-10 17:20:35,133,4158,64,69,2642.56,4900.00,0.00
2024-12-10 17:20:35,134,4158,65,69,2622.84,4900.01,0.00
2024-12-10 17:20:35,135,4157,65,70,2597.52,4900.10,0.00
2024-12-10 17:20:35,134,4157,64,70,2644.59,4900.12,0.00
2024-12-10 17:20:35,133,4157,64,69,2647.30,4900.41,0.00
2024-12-10 17:20:35,133,4158,64,69,2653.51,4901.00,0.00
2024-12-10 17:20:35,134,4158,64,70,2633.70,4901.01,0.00
2024-12-10 17:20:35,133,4158,63,70,2652.89,4901.02,0.00
2024-12-10 17:20:35,133,4159,63,70,2674.71,4902.00,0.00
2024-12-10 17:20:35,134,4159,63,71,2654.75,4902.01,0.00
2024-12-10 17:20:35,133,4159,62,71,2672.87,4902.04,0.00
2024-12-10 17:20:35,132,4159,61,71,2689.82,4902.10,0.00
2024-12-10 17:20:35,132,4160,61,71,2677.41,4903.00,0.00
2024-12-10 17:20:35,133,4160,62,71,2657.28,4903.01,0.00
2024-12-10 17:20:35,132,4160,62,70,2672.63,4903.10,0.00
2024-12-10 17:20:35,133,4159,62,71,2639.43,4903.36,0.00
2024-12-10 17:20:35,133,4160,62,71,2664.40,4904.00,0.00
2024-12-10 17:20:35,134,4160,63,71,2644.52,4904.01,0.00
2024-12-10 17:20:35,134,4161,63,71,2662.44,4905.00,0.00
2024-12-10 17:20:35,135,4161,63,72,2642.72,4905.01,0.00
2024-12-10 17:20:35,134,4161,62,72,2640.60,4905.42,0.00
2024-12-10 17:20:35,134,4162,62,72,2647.43,4906.00,0.00
2024-12-10 17:20:35,135,4162,62,73,2627.82,4906.01,0.00
2024-12-10 17:20:35,135,4163,62,73,2614.00,4907.00,0.00
2024-12-10 17:20:35,136,4163,63,73,2594.78,4907.01,0.00
2024-12-10 17:20:35,135,4163,63,72,2608.60,4907.11,0.00
2024-12-10 17:20:35,134,4163,62,72,2627.82,4907.11,0.00
2024-12-10 17:20:35,134,4164,62,72,2620.34,4908.00,0.00
2024-12-10 17:20:35,135,4164,63,72,2600.93,4908.01,0.00
2024-12-10 17:20:35,136,4163,64,72,2572.84,4908.21,0.00
2024-12-10 17:20:35,135,4163,64,71,2619.82,4908.27,0.00
2024-12-10 17:20:35,135,4164,64,71,2620.91,4909.00,0.00
2024-12-10 17:20:35,136,4164,65,71,2601.64,4909.01,0.00
2024-12-10 17:20:35,135,4164,65,70,2615.50,4909.11,0.00
2024-12-10 17:20:36,135,4165,65,70,2644.05,4910.00,0.00
2024-12-10 17:20:36,136,4165,66,70,2624.61,4910.01,0.00
2024-12-10 17:20:36,135,4165,65,70,2638.64,4910.11,0.00
2024-12-10 17:20:36,134,4165,65,69,2657.23,4910.13,0.00
2024-12-10 17:20:36,134,4166,65,69,2649.49,4911.00,0.00
2024-12-10 17:20:36,135,4166,65,70,2629.86,4911.01,0.00
2024-12-10 17:20:36,134,4166,65,69,2648.39,4911.02,0.00
2024-12-10 17:20:36,133,4166,65,68,2663.19,4911.12,0.00
2024-12-10 17:20:36,133,4167,65,68,2653.77,4912.00,0.00
2024-12-10 17:20:36,134,4167,65,69,2633.96,4912.01,0.00
2024-12-10 17:20:36,133,4167,64,69,2628.18,4912.48,0.00
2024-12-10 17:20:36,133,4168,64,69,2638.30,4913.00,0.00
2024-12-10 17:20:36,134,4168,65,69,2618.62,4913.01,0.00
2024-12-10 17:20:36,134,4169,65,69,2603.29,4914.00,0.00
2024-12-10 17:20:36,135,4169,66,69,2584.01,4914.01,0.00
2024-12-10 17:20:36,134,4169,66,68,2596.68,4914.12,0.00
2024-12-10 17:20:36,134,4170,66,68,2586.63,4915.00,0.00
2024-12-10 17:20:36,135,4170,67,68,2567.47,4915.01,0.00
2024-12-10 17:20:36,134,4170,67,67,2578.92,4915.12,0.00
2024-12-10 17:20:36,135,4169,68,67,2523.66,4915.80,0.00
2024-12-10 17:20:36,135,4170,68,67,2564.19,4916.00,0.00
2024-12-10 17:20:36,136,4170,69,67,2545.34,4916.01,0.00
2024-12-10 17:20:36,137,4169,70,67,2511.75,4916.28,0.00
2024-12-10 17:20:36,137,4170,70,67,2544.04,4917.00,0.00
2024-12-10 17:20:36,138,4170,71,67,2525.61,4917.01,0.00
2024-12-10 17:20:36,137,4170,70,67,2525.52,4917.27,0.00
2024-12-10 17:20:36,137,4171,70,67,2555.31,4918.00,0.00
2024-12-10 17:20:36,138,4171,71,67,2536.80,4918.01,0.00
2024-12-10 17:20:36,137,4171,70,67,2549.12,4918.07,0.00
2024-12-10 17:20:36,136,4171,69,67,2564.66,4918.11,0.00
2024-12-10 17:20:36,135,4171,69,66,2583.29,4918.11,0.00
2024-12-10 17:20:36,136,4170,70,66,2557.81,4918.26,0.00
2024-12-10 17:20:36,135,4170,70,65,2571.41,4918.36,0.00
2024-12-10 17:20:36,135,4171,70,65,2572.46,4919.00,0.00
2024-12-10 17:20:36,136,4171,71,65,2553.55,4919.01,0.00
2024-12-10 17:20:36,135,4171,71,64,2562.66,4919.11,0.00
2024-12-10 17:20:36,135,4172,71,64,2588.03,4920.00,0.00
2024-12-10 17:20:36,136,4172,72,64,2569.00,4920.01,0.00
2024-12-10 17:20:36,136,4173,72,64,2547.78,4921.00,0.00
2024-12-10 17:20:36,137,4173,72,65,2529.18,4921.01,0.00
2024-12-10 17:20:36,136,4173,72,64,2546.70,4921.02,0.00
2024-12-10 17:20:36,135,4173,72,63,2555.10,4921.12,0.00
2024-12-10 17:20:36,134,4173,71,63,2573.80,4921.12,0.00
2024-12-10 17:20:36,134,4174,71,63,2563.76,4922.00,0.00
2024-12-10 17:20:36,135,4174,72,63,2544.77,4922.01,0.00
2024-12-10 17:20:36,134,4174,71,63,2557.92,4922.03,0.00
2024-12-10 17:20:36,133,4174,71,62,2571.48,4922.11,0.00
2024-12-10 17:20:36,133,4175,71,62,2562.18,4923.00,0.00
2024-12-10 17:20:36,134,4175,71,63,2543.06,4923.01,0.00
2024-12-10 17:20:36,133,4175,70,63,2554.68,4923.11,0.00
2024-12-10 17:20:36,133,4176,70,63,2546.56,4924.00,0.00
2024-12-10 17:20:36,134,4176,70,64,2527.55,4924.01,0.00
2024-12-10 17:20:36,133,4176,69,64,2540.76,4924.08,0.00
2024-12-10 17:20:36,132,4176,68,64,2558.16,4924.11,0.00
2024-12-10 17:20:36,131,4176,67,64,2572.36,4924.21,0.00
2024-12-10 17:20:36,132,4175,67,65,2531.79,4924.66,0.00
2024-12-10 17:20:36,132,4176,67,65,2565.87,4925.00,0.00
2024-12-10 17:20:36,133,4176,68,65,2546.58,4925.01,0.00
2024-12-10 17:20:36,132,4176,67,65,2560.50,4925.05,0.00
2024-12-10 17:20:36,133,4175,67,66,2539.41,4925.11,0.00
2024-12-10 17:20:36,132,4175,67,65,2579.18,4925.11,0.00
2024-12-10 17:20:36,132,4176,67,65,2597.81,4926.00,0.00
2024-12-10 17:20:36,133,4176,68,65,2578.28,4926.01,0.00
2024-12-10 17:20:36,132,4176,67,65,2556.58,4926.60,0.00
2024-12-10 17:20:36,132,4177,67,65,2609.90,4927.00,0.00
2024-12-10 17:20:36,133,4177,68,65,2590.27,4927.01,0.00
2024-12-10 17:20:36,133,4178,68,65,2569.50,4928.00,0.00
2024-12-10 17:20:36,134,4178,69,65,2550.33,4928.01,0.00
2024-12-10 17:20:36,133,4178,69,64,2566.18,4928.04,0.00
2024-12-10 17:20:36,132,4178,69,63,2581.92,4928.11,0.00
2024-12-10 17:20:36,131,4178,69,62,2571.48,4928.66,0.00
2024-12-10 17:20:36,131,4179,69,62,2592.45,4929.00,0.00
2024-12-10 17:20:36,132,4179,70,62,2572.81,4929.01,0.00
2024-12-10 17:20:36,131,4179,70,61,2591.70,4929.02,0.00
2024-12-10 17:20:36,130,4179,70,60,2607.13,4929.10,0.00
2024-12-10 17:20:36,129,4179,70,59,2626.96,4929.10,0.00
2024-12-10 17:20:36,129,4180,70,59,2621.33,4930.00,0.00
2024-12-10 17:20:36,130,4180,70,60,2601.17,4930.01,0.00
2024-12-10 17:20:36,129,4180,70,59,2616.41,4930.10,0.00
2024-12-10 17:20:36,129,4181,70,59,2610.78,4931.00,0.00
2024-12-10 17:20:36,130,4181,71,59,2590.69,4931.01,0.00
2024-12-10 17:20:36,129,4181,70,59,2605.85,4931.10,0.00
2024-12-10 17:20:36,129,4182,70,59,2600.22,4932.00,0.00
2024-12-10 17:20:36,130,4182,71,59,2580.22,4932.01,0.00
2024-12-10 17:20:36,129,4182,71,58,2594.91,4932.11,0.00
2024-12-10 17:20:36,129,4183,71,58,2589.66,4933.00,0.00
2024-12-10 17:20:36,130,4183,72,58,2569.74,4933.01,0.00
2024-12-10 17:20:36,130,4184,72,58,2559.25,4934.00,0.00
2024-12-10 17:20:36,131,4184,72,59,2539.71,4934.01,0.00
2024-12-10 17:20:36,131,4185,72,59,2528.93,4935.00,0.00
2024-12-10 17:20:36,132,4185,72,60,2509.77,4935.01,0.00
2024-12-10 17:20:36,132,4186,72,60,2498.69,4936.00,0.00
2024-12-10 17:20:36,133,4186,72,61,2479.90,4936.01,0.00
2024-12-10 17:20:37,133,4187,72,61,2468.52,4937.00,0.00
2024-12-10 17:20:37,134,4187,72,62,2450.10,4937.01,0.00
2024-12-10 17:20:37,133,4187,71,62,2463.00,4937.11,0.00
2024-12-10 17:20:37,133,4188,71,62,2456.77,4938.00,0.00
2024-12-10 17:20:37,134,4188,71,63,2438.44,4938.01,0.00
2024-12-10 17:20:37,135,4187,72,63,2417.11,4938.09,0.00
2024-12-10 17:20:37,134,4187,72,62,2437.75,4938.12,0.00
2024-12-10 17:20:37,134,4188,72,62,2431.56,4939.00,0.00
2024-12-10 17:20:37,135,4188,73,62,2413.55,4939.01,0.00
2024-12-10 17:20:37,134,4188,72,62,2429.36,4939.05,0.00
2024-12-10 17:20:37,133,4188,71,62,2444.32,4939.11,0.00
2024-12-10 17:20:37,133,4189,71,62,2474.85,4940.00,0.00
2024-12-10 17:20:37,134,4189,72,62,2456.38,4940.01,0.00
2024-12-10 17:20:37,135,4188,73,62,2437.82,4940.03,0.00
2024-12-10 17:20:37,134,4188,72,62,2466.75,4940.11,0.00
2024-12-10 17:20:37,134,4189,72,62,2459.71,4941.00,0.00
2024-12-10 17:20:37,135,4189,72,63,2441.49,4941.01,0.00
2024-12-10 17:20:37,134,4189,72,62,2454.59,4941.10,0.00
2024-12-10 17:20:37,135,4188,73,62,2433.49,4941.18,0.00
2024-12-10 17:20:37,135,4189,73,62,2498.23,4942.00,0.00
2024-12-10 17:20:37,136,4189,73,63,2479.86,4942.01,0.00
2024-12-10 17:20:37,135,4189,73,62,2497.87,4942.01,0.00
2024-12-10 17:20:37,134,4189,72,62,2511.76,4942.10,0.00
2024-12-10 17:20:37,133,4189,72,61,2530.27,4942.10,0.00
2024-12-10 17:20:37,133,4190,72,61,2558.20,4943.00,0.00
2024-12-10 17:20:37,134,4190,72,62,2539.11,4943.01,0.00
2024-12-10 17:20:37,134,4191,72,62,2523.56,4944.00,0.00
2024-12-10 17:20:37,135,4191,73,62,2504.87,4944.01,0.00
2024-12-10 17:20:37,134,4191,72,62,2518.81,4944.10,0.00
2024-12-10 17:20:37,133,4191,71,62,2529.05,4944.25,0.00
2024-12-10 17:20:37,133,4192,71,62,2526.61,4945.00,0.00
2024-12-10 17:20:37,134,4192,71,63,2507.75,4945.01,0.00
2024-12-10 17:20:37,133,4192,70,63,2521.82,4945.10,0.00
2024-12-10 17:20:37,132,4192,70,62,2528.04,4945.27,0.00
2024-12-10 17:20:37,132,4193,70,62,2529.98,4946.00,0.00
2024-12-10 17:20:37,133,4193,70,63,2510.95,4946.01,0.00
2024-12-10 17:20:37,132,4193,70,62,2525.15,4946.10,0.00
2024-12-10 17:20:37,133,4192,70,63,2472.60,4946.80,0.00
2024-12-10 17:20:37,133,4193,70,63,2508.12,4947.00,0.00
2024-12-10 17:20:37,134,4193,71,63,2489.40,4947.01,0.00
2024-12-10 17:20:37,133,4193,71,62,2503.32,4947.10,0.00
2024-12-10 17:20:37,133,4194,71,62,2533.55,4948.00,0.00
2024-12-10 17:20:37,134,4194,71,63,2514.64,4948.01,0.00
2024-12-10 17:20:37,133,4194,71,62,2528.75,4948.10,0.00
2024-12-10 17:20:37,133,4195,71,62,2521.78,4949.00,0.00
2024-12-10 17:20:37,134,4195,72,62,2502.96,4949.01,0.00
2024-12-10 17:20:37,133,4195,72,61,2516.98,4949.10,0.00
2024-12-10 17:20:37,133,4196,72,61,2510.01,4950.00,0.00
2024-12-10 17:20:37,134,4196,73,61,2491.28,4950.01,0.00
2024-12-10 17:20:37,134,4197,73,61,2479.45,4951.00,0.00
2024-12-10 17:20:37,135,4197,74,61,2461.08,4951.01,0.00
2024-12-10 17:20:37,134,4197,74,60,2474.32,4951.10,0.00
2024-12-10 17:20:37,135,4196,74,61,2435.88,4951.50,0.00
2024-12-10 17:20:37,135,4197,74,61,2468.15,4952.00,0.00
2024-12-10 17:20:37,136,4197,75,61,2450.00,4952.01,0.00
2024-12-10 17:20:37,135,4197,75,60,2463.06,4952.10,0.00
2024-12-10 17:20:37,135,4198,75,60,2489.21,4953.00,0.00
2024-12-10 17:20:37,136,4198,75,61,2470.90,4953.01,0.00
2024-12-10 17:20:37,135,4198,75,60,2484.11,4953.10,0.00
2024-12-10 17:20:37,134,4198,75,59,2491.00,4953.28,0.00
2024-12-10 17:20:37,134,4199,75,59,2492.92,4954.00,0.00
2024-12-10 17:20:37,135,4199,76,59,2474.45,4954.01,0.00
2024-12-10 17:20:37,134,4199,76,58,2487.79,4954.10,0.00
2024-12-10 17:20:37,133,4199,75,58,2506.12,4954.11,0.00
2024-12-10 17:20:37,133,4200,75,58,2499.50,4955.00,0.00
2024-12-10 17:20:37,134,4200,76,58,2480.85,4955.01,0.00
2024-12-10 17:20:37,133,4200,75,58,2494.33,4955.11,0.00
2024-12-10 17:20:37,133,4201,75,58,2487.71,4956.00,0.00
2024-12-10 17:20:37,134,4201,76,58,2469.15,4956.01,0.00
2024-12-10 17:20:37,133,4201,76,57,2482.53,4956.11,0.00
2024-12-10 17:20:37,133,4202,76,57,2475.91,4957.00,0.00
2024-12-10 17:20:37,134,4202,77,57,2457.44,4957.01,0.00
2024-12-10 17:20:37,133,4202,77,56,2473.69,4957.05,0.00
2024-12-10 17:20:37,132,4202,76,56,2489.45,4957.10,0.00
2024-12-10 17:20:37,132,4203,76,56,2482.78,4958.00,0.00
2024-12-10 17:20:37,133,4203,77,56,2464.11,4958.01,0.00
2024-12-10 17:20:37,132,4203,77,55,2477.93,4958.10,0.00
2024-12-10 17:20:37,132,4204,77,55,2471.26,4959.00,0.00
2024-12-10 17:20:37,133,4204,77,56,2452.68,4959.01,0.00
2024-12-10 17:20:37,132,4204,77,55,2466.41,4959.10,0.00
2024-12-10 17:20:37,132,4205,77,55,2459.73,4960.00,0.00
2024-12-10 17:20:37,133,4205,77,56,2441.24,4960.01,0.00
2024-12-10 17:20:37,132,4205,76,56,2454.88,4960.10,0.00
2024-12-10 17:20:37,132,4206,76,56,2448.20,4961.00,0.00
2024-12-10 17:20:37,133,4206,77,56,2429.79,4961.01,0.00
2024-12-10 17:20:37,132,4206,77,55,2443.35,4961.10,0.00
2024-12-10 17:20:37,132,4207,77,55,2436.67,4962.00,0.00
2024-12-10 17:20:37,133,4207,77,56,2418.34,4962.01,0.00
2024-12-10 17:20:37,132,4207,76,56,2431.81,4962.10,0.00
2024-12-10 17:20:37,132,4208,76,56,2425.13,4963.00,0.00
2024-12-10 17:20:38,133,4208,76,57,2406.89,4963.01,0.00
2024-12-10 17:20:38,132,4208,75,57,2420.27,4963.10,0.00
2024-12-10 17:20:38,132,4209,75,57,2413.58,4964.00,0.00
2024-12-10 17:20:38,133,4209,76,57,2395.43,4964.01,0.00
2024-12-10 17:20:38,132,4209,76,56,2410.22,4964.07,0.00
2024-12-10 17:20:38,131,4209,75,56,2427.11,4964.09,0.00
2024-12-10 17:20:38,131,4210,75,56,2420.37,4965.00,0.00
2024-12-10 17:20:38,132,4210,75,57,2402.03,4965.01,0.00
2024-12-10 17:20:38,131,4210,75,56,2415.85,4965.09,0.00
2024-12-10 17:20:38,131,4211,75,56,2409.10,4966.00,0.00
2024-12-10 17:20:38,132,4211,76,56,2390.85,4966.01,0.00
2024-12-10 17:20:38,131,4211,76,55,2404.58,4966.09,0.00
2024-12-10 17:20:38,130,4211,76,54,2422.70,4966.09,0.00
2024-12-10 17:20:38,130,4212,76,54,2416.28,4967.00,0.00
2024-12-10 17:20:38,131,4212,77,54,2397.83,4967.01,0.00
2024-12-10 17:20:38,131,4213,77,54,2386.94,4968.00,0.00
2024-12-10 17:20:38,132,4213,78,54,2368.86,4968.01,0.00
2024-12-10 17:20:38,131,4213,77,54,2382.42,4968.09,0.00
2024-12-10 17:20:38,130,4213,76,54,2400.36,4968.09,0.00
2024-12-10 17:20:38,130,4214,76,54,2393.93,4969.00,0.00
2024-12-10 17:20:38,131,4214,76,55,2375.66,4969.01,0.00
2024-12-10 17:20:38,130,4214,76,54,2392.03,4969.04,0.00
2024-12-10 17:20:38,129,4214,75,54,2407.90,4969.09,0.00
2024-12-10 17:20:38,128,4214,75,53,2426.32,4969.09,0.00
2024-12-10 17:20:38,128,4215,75,53,2420.18,4970.00,0.00
2024-12-10 17:20:38,129,4215,76,53,2401.42,4970.01,0.00
2024-12-10 17:20:38,128,4215,75,53,2415.94,4970.09,0.00
2024-12-10 17:20:38,129,4214,75,54,2384.92,4970.35,0.00
2024-12-10 17:20:38,130,4213,76,54,2384.24,4970.55,0.00
2024-12-10 17:20:38,130,4214,76,54,2420.14,4971.00,0.00
2024-12-10 17:20:38,131,4214,76,55,2401.66,4971.01,0.00
2024-12-10 17:20:38,130,4214,76,54,2415.96,4971.08,0.00
2024-12-10 17:20:38,129,4214,76,53,2434.30,4971.09,0.00
2024-12-10 17:20:38,129,4215,76,53,2504.91,4972.00,0.00
2024-12-10 17:20:38,130,4215,76,54,2485.64,4972.01,0.00
2024-12-10 17:20:38,129,4215,76,53,2500.70,4972.09,0.00
2024-12-10 17:20:38,129,4216,76,53,2494.23,4973.00,0.00
2024-12-10 17:20:38,130,4216,76,54,2475.05,4973.01,0.00
2024-12-10 17:20:38,129,4216,76,53,2491.17,4973.06,0.00
2024-12-10 17:20:38,128,4216,75,53,2509.47,4973.08,0.00
2024-12-10 17:20:38,128,4217,75,53,2502.96,4974.00,0.00
2024-12-10 17:20:38,129,4217,75,54,2483.55,4974.01,0.00
2024-12-10 17:20:38,128,4217,74,54,2499.10,4974.08,0.00
2024-12-10 17:20:38,128,4218,74,54,2492.58,4975.00,0.00
2024-12-10 17:20:38,129,4218,75,54,2473.26,4975.01,0.00
2024-12-10 17:20:38,128,4218,74,54,2488.72,4975.08,0.00
2024-12-10 17:20:38,128,4219,74,54,2482.19,4976.00,0.00
2024-12-10 17:20:38,129,4219,74,55,2462.95,4976.01,0.00
2024-12-10 17:20:38,128,4219,73,55,2478.33,4976.08,0.00
2024-12-10 17:20:38,129,4218,73,56,2451.42,4976.25,0.00
2024-12-10 17:20:38,129,4219,73,56,2484.28,4977.00,0.00
2024-12-10 17:20:38,130,4219,74,56,2465.17,4977.01,0.00
2024-12-10 17:20:38,129,4219,74,55,2480.45,4977.08,0.00
2024-12-10 17:20:38,129,4220,74,55,2512.18,4978.00,0.00
2024-12-10 17:20:38,130,4220,74,56,2492.85,4978.01,0.00
2024-12-10 17:20:38,129,4220,73,56,2508.34,4978.08,0.00
2024-12-10 17:20:38,130,4219,74,56,2458.64,4978.71,0.00
2024-12-10 17:20:38,130,4220,74,56,2495.27,4979.00,0.00
2024-12-10 17:20:38,131,4220,74,57,2476.22,4979.01,0.00
2024-12-10 17:20:38,130,4220,73,57,2493.74,4979.03,0.00
2024-12-10 17:20:38,129,4220,73,56,2510.77,4979.07,0.00
2024-12-10 17:20:38,128,4220,72,56,2530.18,4979.07,0.00
2024-12-10 17:20:38,128,4221,72,56,2562.18,4980.00,0.00
2024-12-10 17:20:38,129,4221,72,57,2542.32,4980.01,0.00
2024-12-10 17:20:38,128,4221,71,57,2558.70,4980.07,0.00
2024-12-10 17:20:38,128,4222,71,57,2551.80,4981.00,0.00
2024-12-10 17:20:38,129,4222,71,58,2532.02,4981.01,0.00
2024-12-10 17:20:38,128,4222,70,58,2548.32,4981.07,0.00
2024-12-10 17:20:38,128,4223,70,58,2541.41,4982.00,0.00
2024-12-10 17:20:38,129,4223,70,59,2521.71,4982.01,0.00
2024-12-10 17:20:38,128,4223,70,58,2537.93,4982.07,0.00
2024-12-10 17:20:38,128,4224,70,58,2531.02,4983.00,0.00
2024-12-10 17:20:38,129,4224,71,58,2511.40,4983.01,0.00
2024-12-10 17:20:38,130,4223,71,59,2490.56,4983.05,0.00
2024-12-10 17:20:38,129,4223,71,58,2525.33,4983.08,0.00
2024-12-10 17:20:38,129,4224,71,58,2518.47,4984.00,0.00
2024-12-10 17:20:38,130,4224,71,59,2499.10,4984.01,0.00
2024-12-10 17:20:38,129,4224,71,58,2516.17,4984.05,0.00
2024-12-10 17:20:38,128,4224,71,57,2534.67,4984.06,0.00
2024-12-10 17:20:38,128,4225,71,57,2560.41,4985.00,0.00
2024-12-10 17:20:38,129,4225,71,58,2540.57,4985.01,0.00
2024-12-10 17:20:38,128,4225,70,58,2557.32,4985.06,0.00
2024-12-10 17:20:38,129,4224,70,59,2532.88,4985.17,0.00
2024-12-10 17:20:38,130,4223,71,59,2496.31,4985.95,0.00
2024-12-10 17:20:38,130,4224,71,59,2534.33,4986.00,0.00
2024-12-10 17:20:38,131,4224,72,59,2514.98,4986.01,0.00
2024-12-10 17:20:38,130,4224,71,59,2531.28,4986.06,0.00
2024-12-10 17:20:38,129,4224,70,59,2531.90,4986.17,0.00
2024-12-10 17:20:38,128,4224,69,59,2543.72,4986.33,0.00
2024-12-10 17:20:38,128,4225,69,59,2627.52,4987.00,0.00
2024-12-10 17:20:38,129,4225,70,59,2607.16,4987.01,0.00
2024-12-10 17:20:38,128,4225,70,58,2624.43,4987.06,0.00
2024-12-10 17:20:38,128,4226,70,58,2617.14,4988.00,0.00
2024-12-10 17:20:38,129,4226,70,59,2596.85,4988.01,0.00
2024-12-10 17:20:38,128,4226,69,59,2613.66,4988.07,0.00
2024-12-10 17:20:38,128,4227,69,59,2606.73,4989.00,0.00
2024-12-10 17:20:38,129,4227,70,59,2586.52,4989.01,0.00
2024-12-10 17:20:38,128,4227,70,58,2603.24,4989.07,0.00
2024-12-10 17:20:39,128,4228,70,58,2596.27,4990.00,0.00
2024-12-10 17:20:39,129,4228,71,58,2576.14,4990.01,0.00
2024-12-10 17:20:39,128,4228,71,57,2592.78,4990.07,0.00
2024-12-10 17:20:39,128,4229,71,57,2585.65,4991.00,0.00
2024-12-10 17:20:39,129,4229,72,57,2565.60,4991.01,0.00
2024-12-10 17:20:39,128,4229,71,57,2582.16,4991.07,0.00
2024-12-10 17:20:39,128,4230,71,57,2574.96,4992.00,0.00
2024-12-10 17:20:39,129,4230,71,58,2555.00,4992.01,0.00
2024-12-10 17:20:39,128,4230,71,57,2571.47,4992.07,0.00
2024-12-10 17:20:39,127,4230,70,57,2591.54,4992.07,0.00
2024-12-10 17:20:39,128,4229,70,58,2548.81,4992.54,0.00
2024-12-10 17:20:39,129,4228,71,58,2530.10,4992.92,0.00
2024-12-10 17:20:39,129,4229,71,58,2568.10,4993.00,0.00
2024-12-10 17:20:39,130,4229,72,58,2548.35,4993.01,0.00
2024-12-10 17:20:39,131,4228,72,59,2511.83,4993.37,0.00
2024-12-10 17:20:39,131,4229,72,59,2620.90,4994.00,0.00
2024-12-10 17:20:39,132,4229,72,60,2601.04,4994.01,0.00
2024-12-10 17:20:39,131,4229,71,60,2620.14,4994.02,0.00
2024-12-10 17:20:39,130,4229,70,60,2637.62,4994.06,0.00
2024-12-10 17:20:39,130,4230,70,60,2668.10,4995.00,0.00
2024-12-10 17:20:39,131,4230,71,60,2647.73,4995.01,0.00
2024-12-10 17:20:39,131,4231,71,60,2636.82,4996.00,0.00
2024-12-10 17:20:39,132,4231,71,61,2616.84,4996.01,0.00
2024-12-10 17:20:39,132,4232,71,61,2605.63,4997.00,0.00
2024-12-10 17:20:39,133,4232,72,61,2586.04,4997.01,0.00
2024-12-10 17:20:39,132,4232,72,60,2601.50,4997.08,0.00
2024-12-10 17:20:39,132,4233,72,60,2594.04,4998.00,0.00
2024-12-10 17:20:39,133,4233,73,60,2574.53,4998.01,0.00
2024-12-10 17:20:39,132,4233,72,60,2589.91,4998.08,0.00
2024-12-10 17:20:39,132,4234,72,60,2582.44,4999.00,0.00
2024-12-10 17:20:39,133,4234,73,60,2563.02,4999.01,0.00
2024-12-10 17:20:39,132,4234,72,60,2578.30,4999.08,0.00
2024-12-10 17:20:39,132,4235,72,60,2570.83,5000.00,0.00
2024-12-10 17:20:39,133,4235,72,61,2551.50,5000.01,0.00
2024-12-10 17:20:39,132,4235,72,60,2570.08,5000.02,0.00
2024-12-10 17:20:39,131,4235,71,60,2586.29,5000.08,0.00
2024-12-10 17:20:39,130,4235,71,59,2605.80,5000.08,0.00
2024-12-10 17:20:39,131,4234,72,59,2579.05,5000.23,0.00
2024-12-10 17:20:39,132,4233,73,59,2567.69,5000.71,0.00
2024-12-10 17:20:39,132,4234,73,59,2602.41,5001.00,0.00
2024-12-10 17:20:39,133,4234,73,60,2582.85,5001.01,0.00
2024-12-10 17:20:39,132,4234,73,59,2598.66,5001.08,0.00
2024-12-10 17:20:39,132,4235,73,59,2666.59,5002.00,0.00
2024-12-10 17:20:39,133,4235,73,60,2646.55,5002.01,0.00
2024-12-10 17:20:39,132,4235,73,59,2662.84,5002.08,0.00
2024-12-10 17:20:39,132,4236,73,59,2655.00,5003.00,0.00
2024-12-10 17:20:39,133,4236,73,60,2635.04,5003.01,0.00
2024-12-10 17:20:39,132,4236,72,60,2651.24,5003.08,0.00
2024-12-10 17:20:39,131,4236,72,59,2671.10,5003.08,0.00
2024-12-10 17:20:39,131,4237,72,59,2663.58,5004.00,0.00
2024-12-10 17:20:39,132,4237,73,59,2643.40,5004.01,0.00
2024-12-10 17:20:39,131,4237,72,59,2659.79,5004.08,0.00
2024-12-10 17:20:39,131,4238,72,59,2652.27,5005.00,0.00
2024-12-10 17:20:39,132,4238,73,59,2632.17,5005.01,0.00
2024-12-10 17:20:39,131,4238,73,58,2648.48,5005.08,0.00
2024-12-10 17:20:39,131,4239,73,58,2640.95,5006.00,0.00
2024-12-10 17:20:39,132,4239,73,59,2620.94,5006.01,0.00
2024-12-10 17:20:39,131,4239,73,58,2637.16,5006.08,0.00
2024-12-10 17:20:39,131,4240,73,58,2629.63,5007.00,0.00
2024-12-10 17:20:39,132,4240,73,59,2609.71,5007.01,0.00
2024-12-10 17:20:39,131,4240,72,59,2625.84,5007.08,0.00
2024-12-10 17:20:39,132,4239,73,59,2602.15,5007.17,0.00
2024-12-10 17:20:39,132,4240,73,59,2601.12,5008.00,0.00
2024-12-10 17:20:39,133,4240,74,59,2581.57,5008.01,0.00
2024-12-10 17:20:39,134,4239,75,59,2562.30,5008.02,0.00
2024-12-10 17:20:39,133,4239,74,59,2606.43,5008.02,0.00
2024-12-10 17:20:39,132,4239,73,59,2623.16,5008.08,0.00
2024-12-10 17:20:39,131,4239,72,59,2642.80,5008.08,0.00
2024-12-10 17:20:39,131,4240,72,59,2673.50,5009.00,0.00
2024-12-10 17:20:39,132,4240,72,60,2653.25,5009.01,0.00
2024-12-10 17:20:39,131,4240,71,60,2670.09,5009.07,0.00
2024-12-10 17:20:39,131,4241,71,60,2688.43,5010.00,0.00
2024-12-10 17:20:39,132,4241,71,61,2668.06,5010.01,0.00
2024-12-10 17:20:39,131,4241,70,61,2685.01,5010.07,0.00
2024-12-10 17:20:39,130,4241,69,61,2640.72,5010.92,0.00
2024-12-10 17:20:39,130,4242,69,61,2675.10,5011.00,0.00
2024-12-10 17:20:39,131,4242,69,62,2654.68,5011.01,0.00
2024-12-10 17:20:39,130,4242,69,61,2671.66,5011.07,0.00
2024-12-10 17:20:39,130,4243,69,61,2664.07,5012.00,0.00
2024-12-10 17:20:39,131,4243,69,62,2643.73,5012.01,0.00
2024-12-10 17:20:39,130,4243,69,61,2660.63,5012.07,0.00
2024-12-10 17:20:39,130,4244,69,61,2653.03,5013.00,0.00
2024-12-10 17:20:39,131,4244,69,62,2632.78,5013.01,0.00
2024-12-10 17:20:39,130,4244,68,62,2649.59,5013.07,0.00
2024-12-10 17:20:39,130,4245,68,62,2641.94,5014.00,0.00
2024-12-10 17:20:39,131,4245,69,62,2621.77,5014.01,0.00
2024-12-10 17:20:39,130,4245,68,62,2638.50,5014.07,0.00
2024-12-10 17:20:39,130,4246,68,62,2630.41,5015.00,0.00
2024-12-10 17:20:39,131,4246,69,62,2610.33,5015.01,0.00
2024-12-10 17:20:39,130,4246,68,62,2626.97,5015.07,0.00
2024-12-10 17:20:40,130,4247,68,62,2618.66,5016.00,0.00
2024-12-10 17:20:40,131,4247,68,63,2598.67,5016.01,0.00
2024-12-10 17:20:40,130,4247,67,63,2615.21,5016.07,0.00
2024-12-10 17:20:40,130,4248,67,63,2607.31,5017.00,0.00
2024-12-10 17:20:40,131,4248,68,63,2587.41,5017.01,0.00
2024-12-10 17:20:40,132,4247,68,64,2566.30,5017.05,0.00
2024-12-10 17:20:40,131,4247,67,64,2619.24,5017.08,0.00
2024-12-10 17:20:40,131,4248,67,64,2611.85,5018.00,0.00
2024-12-10 17:20:40,132,4248,67,65,2592.06,5018.01,0.00
2024-12-10 17:20:40,131,4248,66,65,2610.71,5018.02,0.00
2024-12-10 17:20:40,130,4248,65,65,2628.12,5018.07,0.00
2024-12-10 17:20:40,130,4249,65,65,2658.38,5019.00,0.00
2024-12-10 17:20:40,131,4249,66,65,2638.09,5019.01,0.00
2024-12-10 17:20:40,130,4249,65,65,2654.68,5019.08,0.00
2024-12-10 17:20:40,129,4249,64,65,2672.57,5019.12,0.00
2024-12-10 17:20:40,129,4249,64,65,2667.99,5020.00,0.00
2024-12-10 17:20:40,130,4249,64,66,2647.47,5020.01,0.00
2024-12-10 17:20:40,129,4249,63,66,2664.14,5020.08,0.00
2024-12-10 17:20:40,129,4250,63,66,2657.24,5021.00,0.00
2024-12-10 17:20:40,130,4250,63,67,2636.80,5021.01,0.00
2024-12-10 17:20:40,129,4250,63,66,2653.39,5021.08,0.00
2024-12-10 17:20:40,129,4251,63,66,2646.48,5022.00,0.00
2024-12-10 17:20:40,130,4251,64,66,2626.12,5022.01,0.00
2024-12-10 17:20:40,129,4251,63,66,2641.39,5022.08,0.00
2024-12-10 17:20:40,130,4250,63,67,2612.60,5022.26,0.00
2024-12-10 17:20:40,130,4251,63,67,2625.80,5023.00,0.00
2024-12-10 17:20:40,131,4251,64,67,2605.76,5023.01,0.00
2024-12-10 17:20:40,131,4252,64,67,2631.16,5024.00,0.00
2024-12-10 17:20:40,132,4252,64,68,2611.22,5024.01,0.00
2024-12-10 17:20:40,131,4252,64,67,2624.60,5024.08,0.00
2024-12-10 17:20:40,131,4253,64,67,2617.41,5025.00,0.00
2024-12-10 17:20:40,132,4253,64,68,2597.58,5025.01,0.00
2024-12-10 17:20:40,131,4253,64,67,2610.27,5025.09,0.00
2024-12-10 17:20:40,131,4254,64,67,2603.46,5026.00,0.00
2024-12-10 17:20:40,132,4254,65,67,2583.73,5026.01,0.00
2024-12-10 17:20:40,133,4253,65,68,2558.25,5026.09,0.00
2024-12-10 17:20:40,132,4253,64,68,2606.96,5026.10,0.00
2024-12-10 17:20:40,132,4254,64,68,2600.19,5027.00,0.00
2024-12-10 17:20:40,133,4254,65,68,2580.64,5027.01,0.00
2024-12-10 17:20:40,132,4254,64,68,2592.76,5027.09,0.00
2024-12-10 17:20:40,132,4255,64,68,2623.71,5028.00,0.00
2024-12-10 17:20:40,133,4255,65,68,2603.98,5028.01,0.00
2024-12-10 17:20:40,132,4255,64,68,2616.22,5028.09,0.00
2024-12-10 17:20:40,132,4256,64,68,2609.08,5029.00,0.00
2024-12-10 17:20:40,133,4256,65,68,2589.46,5029.01,0.00
2024-12-10 17:20:40,132,4256,64,68,2601.51,5029.09,0.00
2024-12-10 17:20:40,132,4257,64,68,2594.36,5030.00,0.00
2024-12-10 17:20:40,133,4257,65,68,2574.85,5030.01,0.00
2024-12-10 17:20:40,132,4257,64,68,2593.12,5030.02,0.00
2024-12-10 17:20:40,131,4257,64,67,2609.12,5030.08,0.00
2024-12-10 17:20:40,131,4258,64,67,2601.91,5031.00,0.00
2024-12-10 17:20:40,132,4258,65,67,2582.20,5031.01,0.00
2024-12-10 17:20:40,131,4258,64,67,2597.73,5031.08,0.00
2024-12-10 17:20:40,131,4259,64,67,2590.50,5032.00,0.00
2024-12-10 17:20:40,132,4259,65,67,2570.88,5032.01,0.00
2024-12-10 17:20:40,131,4259,64,67,2586.32,5032.08,0.00
2024-12-10 17:20:40,132,4258,65,67,2526.21,5032.91,0.00
2024-12-10 17:20:40,132,4259,65,67,2563.66,5033.00,0.00
2024-12-10 17:20:40,133,4259,66,67,2544.39,5033.01,0.00
2024-12-10 17:20:40,132,4259,65,67,2559.51,5033.08,0.00
2024-12-10 17:20:40,132,4260,65,67,2590.10,5034.00,0.00
2024-12-10 17:20:40,133,4260,65,68,2570.63,5034.01,0.00
2024-12-10 17:20:40,132,4260,65,67,2585.95,5034.08,0.00
2024-12-10 17:20:40,133,4259,65,68,2534.57,5034.74,0.00
2024-12-10 17:20:40,133,4260,65,68,2570.38,5035.00,0.00
2024-12-10 17:20:40,134,4260,66,68,2551.20,5035.01,0.00
2024-12-10 17:20:40,133,4260,66,67,2566.26,5035.08,0.00
2024-12-10 17:20:40,133,4261,66,67,2596.26,5036.00,0.00
2024-12-10 17:20:40,134,4261,66,68,2576.89,5036.01,0.00
2024-12-10 17:20:40,133,4261,66,67,2592.14,5036.08,0.00
2024-12-10 17:20:40,134,4260,67,67,2564.55,5036.26,0.00
2024-12-10 17:20:40,134,4261,67,67,2595.82,5037.00,0.00
2024-12-10 17:20:40,135,4261,68,67,2576.59,5037.01,0.00
2024-12-10 17:20:40,134,4261,68,66,2591.72,5037.08,0.00
2024-12-10 17:20:40,135,4260,68,67,2532.97,5037.89,0.00
2024-12-10 17:20:40,135,4261,68,67,2606.21,5038.00,0.00
2024-12-10 17:20:40,136,4261,69,67,2587.05,5038.01,0.00
2024-12-10 17:20:40,135,4261,69,66,2602.14,5038.08,0.00
2024-12-10 17:20:40,134,4261,68,66,2621.18,5038.08,0.00
2024-12-10 17:20:40,135,4260,68,67,2600.28,5038.13,0.00
2024-12-10 17:20:40,135,4261,68,67,2636.96,5039.00,0.00
2024-12-10 17:20:40,136,4261,69,67,2617.57,5039.01,0.00
2024-12-10 17:20:40,135,4261,68,67,2632.89,5039.08,0.00
2024-12-10 17:20:40,135,4262,68,67,2661.75,5040.00,0.00
2024-12-10 17:20:40,136,4262,68,68,2642.18,5040.01,0.00
2024-12-10 17:20:40,135,4262,67,68,2657.68,5040.08,0.00
2024-12-10 17:20:41,134,4262,66,68,2677.14,5040.08,0.00
2024-12-10 17:20:41,134,4263,66,68,2668.98,5041.00,0.00
2024-12-10 17:20:41,135,4263,67,68,2649.21,5041.01,0.00
2024-12-10 17:20:41,134,4263,66,68,2668.23,5041.02,0.00
2024-12-10 17:20:41,133,4263,66,67,2684.91,5041.08,0.00
2024-12-10 17:20:41,134,4262,66,68,2659.25,5041.20,0.00
2024-12-10 17:20:41,134,4263,66,68,2658.60,5042.00,0.00
2024-12-10 17:20:41,135,4263,67,68,2638.91,5042.01,0.00
2024-12-10 17:20:41,134,4263,67,67,2654.50,5042.08,0.00
2024-12-10 17:20:41,135,4262,68,67,2605.18,5042.69,0.00
2024-12-10 17:20:41,135,4263,68,67,2676.78,5043.00,0.00
2024-12-10 17:20:41,136,4263,68,68,2657.10,5043.01,0.00
2024-12-10 17:20:41,135,4263,68,67,2672.71,5043.08,0.00
2024-12-10 17:20:41,136,4262,68,68,2644.56,5043.27,0.00
2024-12-10 17:20:41,136,4263,68,68,2710.66,5044.00,0.00
2024-12-10 17:20:41,137,4263,68,69,2690.88,5044.01,0.00
2024-12-10 17:20:41,137,4264,68,69,2714.98,5045.00,0.00
2024-12-10 17:20:41,138,4264,68,70,2695.31,5045.01,0.00
2024-12-10 17:20:41,137,4264,68,69,2710.60,5045.09,0.00
2024-12-10 17:20:41,137,4265,68,69,2701.89,5046.00,0.00
2024-12-10 17:20:41,138,4265,69,69,2682.31,5046.01,0.00
2024-12-10 17:20:41,137,4265,69,68,2697.51,5046.09,0.00
2024-12-10 17:20:41,136,4265,69,67,2716.97,5046.09,0.00
2024-12-10 17:20:41,136,4266,69,67,2708.57,5047.00,0.00
2024-12-10 17:20:41,137,4266,70,67,2688.80,5047.01,0.00
2024-12-10 17:20:41,136,4266,69,67,2704.27,5047.09,0.00
2024-12-10 17:20:41,136,4267,69,67,2695.85,5048.00,0.00
2024-12-10 17:20:41,137,4267,70,67,2676.18,5048.01,0.00
2024-12-10 17:20:41,136,4267,70,66,2691.44,5048.09,0.00
2024-12-10 17:20:41,136,4268,70,66,2683.02,5049.00,0.00
2024-12-10 17:20:41,137,4268,70,67,2663.44,5049.01,0.00
2024-12-10 17:20:41,136,4268,69,67,2678.60,5049.09,0.00
2024-12-10 17:20:41,136,4269,69,67,2670.19,5050.00,0.00
2024-12-10 17:20:41,137,4269,70,67,2650.70,5050.01,0.00
2024-12-10 17:20:41,136,4269,69,67,2665.77,5050.09,0.00
2024-12-10 17:20:41,136,4270,69,67,2657.34,5051.00,0.00
2024-12-10 17:20:41,137,4270,69,68,2637.95,5051.01,0.00
2024-12-10 17:20:41,136,4270,68,68,2655.87,5051.03,0.00
2024-12-10 17:20:41,135,4270,67,68,2672.57,5051.08,0.00
2024-12-10 17:20:41,134,4270,67,67,2692.14,5051.08,0.00
2024-12-10 17:20:41,134,4271,67,67,2683.97,5052.00,0.00
2024-12-10 17:20:41,135,4271,68,67,2664.09,5052.01,0.00
2024-12-10 17:20:41,134,4271,67,67,2679.86,5052.08,0.00
2024-12-10 17:20:41,134,4272,67,67,2671.68,5053.00,0.00
2024-12-10 17:20:41,135,4272,68,67,2651.89,5053.01,0.00
2024-12-10 17:20:41,134,4272,68,66,2667.56,5053.08,0.00
2024-12-10 17:20:41,134,4273,68,66,2659.38,5054.00,0.00
2024-12-10 17:20:41,135,4273,68,67,2639.68,5054.01,0.00
2024-12-10 17:20:41,135,4274,68,67,2627.48,5055.00,0.00
2024-12-10 17:20:41,136,4274,69,67,2608.16,5055.01,0.00
2024-12-10 17:20:41,135,4274,68,67,2623.02,5055.09,0.00
2024-12-10 17:20:41,135,4275,68,67,2614.89,5056.00,0.00
2024-12-10 17:20:41,136,4275,68,68,2595.66,5056.01,0.00
2024-12-10 17:20:41,137,4274,68,69,2574.88,5056.06,0.00
2024-12-10 17:20:41,136,4274,67,69,2623.21,5056.10,0.00
2024-12-10 17:20:41,136,4275,67,69,2615.14,5057.00,0.00
2024-12-10 17:20:41,137,4275,67,70,2596.05,5057.01,0.00
2024-12-10 17:20:41,136,4275,66,70,2610.72,5057.09,0.00
2024-12-10 17:20:41,137,4274,67,70,2566.35,5057.61,0.00
2024-12-10 17:20:41,137,4275,67,70,2636.07,5058.00,0.00
2024-12-10 17:20:41,138,4275,68,70,2616.96,5058.01,0.00
2024-12-10 17:20:41,137,4275,67,70,2631.68,5058.09,0.00
2024-12-10 17:20:42,137,4276,67,70,2659.85,5059.00,0.00
2024-12-10 17:20:42,138,4276,67,71,2640.58,5059.01,0.00
2024-12-10 17:20:42,137,4276,67,70,2655.46,5059.09,0.00
2024-12-10 17:20:42,137,4277,67,70,2646.71,5060.00,0.00
2024-12-10 17:20:42,138,4277,68,70,2627.53,5060.01,0.00
2024-12-10 17:20:42,137,4277,68,69,2642.32,5060.09,0.00
2024-12-10 17:20:42,137,4278,68,69,2633.57,5061.00,0.00
2024-12-10 17:20:42,138,4278,68,70,2614.48,5061.01,0.00
2024-12-10 17:20:42,137,4278,67,70,2629.17,5061.09,0.00
2024-12-10 17:20:42,137,4279,67,70,2620.41,5062.00,0.00
2024-12-10 17:20:42,138,4279,67,71,2601.43,5062.01,0.00
2024-12-10 17:20:42,137,4279,67,70,2616.02,5062.09,0.00
2024-12-10 17:20:42,137,4280,67,70,2607.26,5063.00,0.00
2024-12-10 17:20:42,138,4280,67,71,2588.37,5063.01,0.00
2024-12-10 17:20:42,137,4280,67,70,2602.86,5063.09,0.00
2024-12-10 17:20:42,138,4279,67,71,2557.39,5063.63,0.00
2024-12-10 17:20:42,138,4280,67,71,2590.35,5064.00,0.00
2024-12-10 17:20:42,139,4280,67,72,2571.71,5064.01,0.00
2024-12-10 17:20:42,140,4279,67,73,2551.17,5064.06,0.00
2024-12-10 17:20:42,139,4279,66,73,2569.92,5064.09,0.00
2024-12-10 17:20:42,139,4280,66,73,2597.35,5065.00,0.00
2024-12-10 17:20:42,140,4280,67,73,2578.80,5065.01,0.00
2024-12-10 17:20:42,140,4281,67,73,2601.29,5066.00,0.00
2024-12-10 17:20:42,141,4281,68,73,2582.84,5066.01,0.00
2024-12-10 17:20:42,142,4280,68,74,2564.30,5066.03,0.00
2024-12-10 17:20:42,141,4280,67,74,2595.82,5066.10,0.00
2024-12-10 17:20:42,141,4281,67,74,2586.59,5067.00,0.00
2024-12-10 17:20:42,142,4281,67,75,2568.37,5067.01,0.00
2024-12-10 17:20:42,141,4281,66,75,2581.96,5067.09,0.00
2024-12-10 17:20:42,141,4282,66,75,2608.31,5068.00,0.00
2024-12-10 17:20:42,142,4282,67,75,2589.94,5068.01,0.00
2024-12-10 17:20:42,141,4282,66,75,2603.68,5068.09,0.00
2024-12-10 17:20:42,141,4283,66,75,2594.08,5069.00,0.00
2024-12-10 17:20:42,142,4283,67,75,2575.81,5069.01,0.00
2024-12-10 17:20:42,141,4283,67,74,2589.45,5069.09,0.00
2024-12-10 17:20:42,141,4284,67,74,2579.85,5070.00,0.00
2024-12-10 17:20:42,142,4284,67,75,2561.68,5070.01,0.00
2024-12-10 17:20:42,141,4284,66,75,2575.22,5070.09,0.00
2024-12-10 17:20:42,140,4284,65,75,2592.89,5070.10,0.00
2024-12-10 17:20:42,140,4285,65,75,2583.94,5071.00,0.00
2024-12-10 17:20:42,141,4285,65,76,2565.61,5071.01,0.00
2024-12-10 17:20:42,140,4285,65,75,2578.91,5071.10,0.00
2024-12-10 17:20:42,140,4286,65,75,2569.96,5072.00,0.00
2024-12-10 17:20:42,141,4286,65,76,2551.73,5072.01,0.00
2024-12-10 17:20:42,142,4285,66,76,2533.41,5072.03,0.00
2024-12-10 17:20:42,141,4285,66,75,2548.89,5072.11,0.00
2024-12-10 17:20:42,141,4286,66,75,2539.71,5073.00,0.00
2024-12-10 17:20:42,142,4286,66,76,2521.82,5073.01,0.00
2024-12-10 17:20:42,141,4286,66,75,2534.71,5073.10,0.00
2024-12-10 17:20:42,141,4287,66,75,2560.70,5074.00,0.00
2024-12-10 17:20:42,142,4287,67,75,2542.67,5074.01,0.00
2024-12-10 17:20:42,141,4287,67,74,2555.70,5074.10,0.00
2024-12-10 17:20:42,141,4288,67,74,2545.41,5075.00,0.00
2024-12-10 17:20:42,142,4288,67,75,2527.48,5075.01,0.00
2024-12-10 17:20:42,141,4288,66,75,2540.41,5075.10,0.00
2024-12-10 17:20:42,141,4289,66,75,2529.24,5076.00,0.00
2024-12-10 17:20:42,142,4289,67,75,2511.43,5076.01,0.00
2024-12-10 17:20:42,141,4289,67,74,2528.17,5076.02,0.00
2024-12-10 17:20:42,140,4289,67,73,2542.27,5076.09,0.00
2024-12-10 17:20:42,139,4289,67,72,2560.19,5076.09,0.00
2024-12-10 17:20:42,140,4288,67,73,2539.00,5076.16,0.00
2024-12-10 17:20:42,141,4287,68,73,2550.17,5076.19,0.00
2024-12-10 17:20:42,140,4287,68,72,2598.66,5076.21,0.00
2024-12-10 17:20:42,141,4286,68,73,2568.27,5076.46,0.00
2024-12-10 17:20:42,141,4287,68,73,2598.54,5077.00,0.00
2024-12-10 17:20:42,142,4287,68,74,2580.24,5077.01,0.00
2024-12-10 17:20:42,141,4287,67,74,2593.89,5077.09,0.00
2024-12-10 17:20:42,142,4286,67,75,2565.29,5077.31,0.00
2024-12-10 17:20:42,142,4287,67,75,2700.90,5078.00,0.00
2024-12-10 17:20:42,143,4287,67,76,2682.01,5078.01,0.00
2024-12-10 17:20:42,142,4287,66,76,2697.71,5078.06,0.00
2024-12-10 17:20:42,141,4287,66,75,2715.41,5078.09,0.00
2024-12-10 17:20:42,141,4288,66,75,2741.48,5079.00,0.00
2024-12-10 17:20:42,142,4288,67,75,2722.18,5079.01,0.00
2024-12-10 17:20:42,141,4288,67,74,2736.84,5079.09,0.00
2024-12-10 17:20:42,141,4289,67,74,2726.99,5080.00,0.00
2024-12-10 17:20:42,142,4289,67,75,2707.78,5080.01,0.00
2024-12-10 17:20:42,141,4289,67,74,2722.34,5080.09,0.00
2024-12-10 17:20:42,141,4290,67,74,2711.68,5081.00,0.00
2024-12-10 17:20:42,142,4290,68,74,2692.59,5081.01,0.00
2024-12-10 17:20:42,141,4290,68,73,2706.20,5081.09,0.00
2024-12-10 17:20:42,141,4291,68,73,2694.64,5082.00,0.00
2024-12-10 17:20:42,142,4291,68,74,2675.66,5082.01,0.00
2024-12-10 17:20:42,141,4291,68,73,2688.00,5082.09,0.00
2024-12-10 17:20:42,140,4291,68,72,2700.01,5082.21,0.00
2024-12-10 17:20:42,141,4290,69,72,2667.98,5082.48,0.00
2024-12-10 17:20:42,141,4291,69,72,2697.56,5083.00,0.00
2024-12-10 17:20:42,142,4291,70,72,2678.56,5083.01,0.00
2024-12-10 17:20:42,141,4291,69,72,2689.55,5083.09,0.00
2024-12-10 17:20:43,141,4292,69,72,2716.01,5084.00,0.00
2024-12-10 17:20:43,142,4292,70,72,2696.88,5084.01,0.00
2024-12-10 17:20:43,141,4292,69,72,2712.92,5084.03,0.00
2024-12-10 17:20:43,140,4292,69,71,2728.69,5084.09,0.00
2024-12-10 17:20:43,141,4291,70,71,2696.06,5084.37,0.00
2024-12-10 17:20:43,141,4292,70,71,2702.98,5085.00,0.00
2024-12-10 17:20:43,142,4292,70,72,2683.95,5085.01,0.00
2024-12-10 17:20:43,141,4292,70,71,2701.91,5085.02,0.00
2024-12-10 17:20:43,140,4292,69,71,2718.33,5085.07,0.00
2024-12-10 17:20:43,139,4292,69,70,2737.16,5085.08,0.00
2024-12-10 17:20:43,138,4292,68,70,2756.26,5085.09,0.00
2024-12-10 17:20:43,138,4293,68,70,2784.03,5086.00,0.00
2024-12-10 17:20:43,139,4293,69,70,2764.00,5086.01,0.00
2024-12-10 17:20:43,138,4293,68,70,2779.65,5086.09,0.00
2024-12-10 17:20:43,138,4294,68,70,2770.57,5087.00,0.00
2024-12-10 17:20:43,139,4294,69,70,2750.64,5087.01,0.00
2024-12-10 17:20:43,138,4294,68,70,2766.19,5087.09,0.00
2024-12-10 17:20:43,139,4293,68,71,2717.96,5087.66,0.00
2024-12-10 17:20:43,139,4294,68,71,2750.45,5088.00,0.00
2024-12-10 17:20:43,140,4294,68,72,2730.80,5088.01,0.00
2024-12-10 17:20:43,140,4295,68,72,2753.51,5089.00,0.00
2024-12-10 17:20:43,141,4295,69,72,2733.98,5089.01,0.00
2024-12-10 17:20:43,140,4295,68,72,2749.19,5089.09,0.00
2024-12-10 17:20:43,140,4296,68,72,2739.51,5090.00,0.00
2024-12-10 17:20:43,141,4296,68,73,2720.08,5090.01,0.00
2024-12-10 17:20:43,140,4296,67,73,2735.19,5090.09,0.00
2024-12-10 17:20:43,141,4295,67,74,2710.75,5090.20,0.00
2024-12-10 17:20:43,141,4296,67,74,2737.95,5091.00,0.00
2024-12-10 17:20:43,142,4296,67,75,2718.67,5091.01,0.00
2024-12-10 17:20:43,141,4296,66,75,2733.65,5091.09,0.00
2024-12-10 17:20:43,142,4295,66,76,2703.69,5091.31,0.00
2024-12-10 17:20:43,142,4296,66,76,2766.89,5092.00,0.00
2024-12-10 17:20:43,143,4296,66,77,2747.54,5092.01,0.00
2024-12-10 17:20:43,142,4296,66,76,2762.63,5092.08,0.00
2024-12-10 17:20:43,141,4296,66,75,2781.86,5092.09,0.00
2024-12-10 17:20:43,140,4296,65,75,2801.36,5092.09,0.00
2024-12-10 17:20:43,140,4297,65,75,2828.07,5093.00,0.00
2024-12-10 17:20:43,141,4297,65,76,2808.01,5093.01,0.00
2024-12-10 17:20:43,140,4297,65,75,2826.26,5093.04,0.00
2024-12-10 17:20:43,139,4297,64,75,2844.06,5093.08,0.00
2024-12-10 17:20:43,138,4297,64,74,2864.30,5093.08,0.00
2024-12-10 17:20:43,138,4298,64,74,2854.52,5094.00,0.00
2024-12-10 17:20:43,139,4298,65,74,2833.99,5094.01,0.00
2024-12-10 17:20:43,140,4297,66,74,2777.68,5094.71,0.00
2024-12-10 17:20:43,140,4298,66,74,2810.31,5095.00,0.00
2024-12-10 17:20:43,141,4298,67,74,2790.38,5095.01,0.00
2024-12-10 17:20:43,140,4298,66,74,2806.34,5095.08,0.00
2024-12-10 17:20:43,140,4299,66,74,2830.66,5096.00,0.00
2024-12-10 17:20:43,141,4299,67,74,2810.58,5096.01,0.00
2024-12-10 17:20:43,140,4299,67,73,2826.69,5096.08,0.00
2024-12-10 17:20:43,139,4299,67,72,2839.89,5096.19,0.00
2024-12-10 17:20:43,139,4300,67,72,2835.98,5097.00,0.00
2024-12-10 17:20:43,140,4300,67,73,2815.73,5097.01,0.00
2024-12-10 17:20:43,139,4300,66,73,2831.98,5097.08,0.00
2024-12-10 17:20:43,139,4301,66,73,2822.24,5098.00,0.00
2024-12-10 17:20:43,140,4301,67,73,2802.08,5098.01,0.00
2024-12-10 17:20:43,139,4301,66,73,2818.24,5098.08,0.00
2024-12-10 17:20:43,140,4300,67,73,2785.42,5098.34,0.00
2024-12-10 17:20:43,141,4299,67,74,2767.02,5098.82,0.00
2024-12-10 17:20:43,141,4300,67,74,2801.18,5099.00,0.00
2024-12-10 17:20:43,142,4300,68,74,2781.45,5099.01,0.00
2024-12-10 17:20:43,141,4300,67,74,2797.23,5099.08,0.00
2024-12-10 17:20:43,142,4299,68,74,2756.78,5099.47,0.00
2024-12-10 17:20:43,142,4300,68,74,2858.09,5100.00,0.00
2024-12-10 17:20:43,143,4300,68,75,2838.10,5100.01,0.00
2024-12-10 17:20:43,142,4300,68,74,2855.23,5100.06,0.00
2024-12-10 17:20:43,141,4300,68,73,2874.41,5100.07,0.00
2024-12-10 17:20:43,141,4301,68,73,2897.29,5101.00,0.00
2024-12-10 17:20:43,142,4301,68,74,2876.89,5101.01,0.00
2024-12-10 17:20:43,141,4301,68,73,2893.35,5101.08,0.00
2024-12-10 17:20:43,142,4300,69,73,2841.08,5101.64,0.00
2024-12-10 17:20:43,142,4301,69,73,2861.14,5102.00,0.00
2024-12-10 17:20:43,143,4301,69,74,2841.13,5102.01,0.00
2024-12-10 17:20:43,143,4302,69,74,2857.10,5103.00,0.00
2024-12-10 17:20:43,144,4302,70,74,2837.26,5103.01,0.00
2024-12-10 17:20:43,143,4302,70,73,2852.86,5103.08,0.00
2024-12-10 17:20:43,143,4303,70,73,2836.06,5104.00,0.00
2024-12-10 17:20:43,144,4303,70,74,2816.37,5104.01,0.00
2024-12-10 17:20:43,145,4302,71,74,2788.56,5104.16,0.00
2024-12-10 17:20:43,144,4302,71,73,2825.63,5104.20,0.00
2024-12-10 17:20:43,144,4303,71,73,2820.80,5105.00,0.00
2024-12-10 17:20:43,145,4303,72,73,2801.35,5105.01,0.00
2024-12-10 17:20:43,144,4303,71,73,2816.23,5105.09,0.00
2024-12-10 17:20:43,143,4303,71,72,2833.63,5105.13,0.00
2024-12-10 17:20:43,142,4303,71,71,2849.21,5105.16,0.00
2024-12-10 17:20:43,142,4304,71,71,2878.84,5106.00,0.00
2024-12-10 17:20:43,143,4304,71,72,2858.71,5106.01,0.00
2024-12-10 17:20:43,142,4304,71,71,2874.21,5106.09,0.00
2024-12-10 17:20:43,141,4304,70,71,2893.99,5106.10,0.00
2024-12-10 17:20:43,141,4305,70,71,2884.74,5107.00,0.00
2024-12-10 17:20:43,142,4305,71,71,2864.43,5107.01,0.00
2024-12-10 17:20:43,141,4305,71,70,2880.07,5107.09,0.00
2024-12-10 17:20:43,141,4306,71,70,2870.45,5108.00,0.00
2024-12-10 17:20:43,142,4306,71,71,2850.24,5108.01,0.00
2024-12-10 17:20:43,141,4306,70,71,2870.09,5108.01,0.00
2024-12-10 17:20:43,140,4306,69,71,2886.25,5108.09,0.00
2024-12-10 17:20:44,140,4307,69,71,2876.56,5109.00,0.00
2024-12-10 17:20:44,141,4307,70,71,2856.16,5109.01,0.00
2024-12-10 17:20:44,142,4306,71,71,2801.09,5109.71,0.00
2024-12-10 17:20:44,143,4305,71,72,2790.82,5109.75,0.00
2024-12-10 17:20:44,143,4306,71,72,2823.19,5110.00,0.00
2024-12-10 17:20:44,144,4306,72,72,2803.59,5110.01,0.00
2024-12-10 17:20:44,145,4305,72,73,2756.97,5110.56,0.00
2024-12-10 17:20:44,145,4306,72,73,2843.31,5111.00,0.00
2024-12-10 17:20:44,146,4306,73,73,2823.84,5111.01,0.00
2024-12-10 17:20:44,145,4306,73,72,2838.77,5111.09,0.00
2024-12-10 17:20:44,146,4305,73,73,2790.50,5111.67,0.00
2024-12-10 17:20:44,146,4306,73,73,2855.55,5112.00,0.00
2024-12-10 17:20:44,147,4306,73,74,2836.13,5112.01,0.00
2024-12-10 17:20:44,147,4307,73,74,2853.87,5113.00,0.00
2024-12-10 17:20:44,148,4307,73,75,2834.59,5113.01,0.00
2024-12-10 17:20:44,147,4307,73,74,2849.04,5113.10,0.00
2024-12-10 17:20:44,148,4306,73,75,2793.95,5113.75,0.00
2024-12-10 17:20:44,148,4307,73,75,2824.58,5114.00,0.00
2024-12-10 17:20:44,149,4307,74,75,2805.62,5114.01,0.00
2024-12-10 17:20:44,149,4308,74,75,2822.47,5115.00,0.00
2024-12-10 17:20:44,150,4308,74,76,2803.65,5115.01,0.00
2024-12-10 17:20:44,149,4308,73,76,2817.36,5115.10,0.00
2024-12-10 17:20:44,150,4307,74,76,2777.23,5115.53,0.00
2024-12-10 17:20:44,151,4306,74,77,2762.07,5115.80,0.00
2024-12-10 17:20:44,151,4307,74,77,2792.75,5116.00,0.00
2024-12-10 17:20:44,152,4307,75,77,2774.37,5116.01,0.00
2024-12-10 17:20:44,152,4308,75,77,2825.08,5117.00,0.00
2024-12-10 17:20:44,153,4308,76,77,2806.61,5117.01,0.00
2024-12-10 17:20:44,152,4308,76,76,2819.73,5117.11,0.00
2024-12-10 17:20:44,152,4309,76,76,2808.12,5118.00,0.00
2024-12-10 17:20:44,153,4309,77,76,2789.76,5118.01,0.00
2024-12-10 17:20:44,152,4309,76,76,2800.42,5118.13,0.00
2024-12-10 17:20:44,152,4310,76,76,2789.81,5119.00,0.00
2024-12-10 17:20:44,153,4310,76,77,2771.57,5119.01,0.00
2024-12-10 17:20:44,154,4309,76,78,2753.25,5119.03,0.00
2024-12-10 17:20:44,153,4309,75,78,2784.67,5119.11,0.00
2024-12-10 17:20:44,153,4310,75,78,2773.12,5120.00,0.00
2024-12-10 17:20:44,154,4310,75,79,2755.11,5120.01,0.00
2024-12-10 17:20:44,153,4310,75,78,2767.81,5120.10,0.00
2024-12-10 17:20:44,152,4310,74,78,2778.52,5120.25,0.00
2024-12-10 17:20:44,152,4311,74,78,2807.97,5121.00,0.00
2024-12-10 17:20:44,153,4311,75,78,2789.61,5121.01,0.00
2024-12-10 17:20:44,152,4311,74,78,2791.16,5121.09,0.00
2024-12-10 17:20:44,152,4312,74,78,2778.86,5122.00,0.00
2024-12-10 17:20:44,153,4312,75,78,2760.70,5122.01,0.00
2024-12-10 17:20:44,152,4312,74,78,2770.65,5122.15,0.00
2024-12-10 17:20:44,153,4311,74,79,2734.90,5122.50,0.00
2024-12-10 17:20:44,154,4310,75,79,2724.59,5122.71,0.00
2024-12-10 17:20:44,154,4311,75,79,2753.11,5123.00,0.00
2024-12-10 17:20:44,155,4311,76,79,2735.35,5123.01,0.00
2024-12-10 17:20:44,154,4311,75,79,2747.50,5123.11,0.00
2024-12-10 17:20:44,154,4312,75,79,2802.23,5124.00,0.00
2024-12-10 17:20:44,155,4312,76,79,2784.15,5124.01,0.00
2024-12-10 17:20:44,154,4312,76,78,2796.61,5124.11,0.00
2024-12-10 17:20:44,154,4313,76,78,2784.81,5125.00,0.00
2024-12-10 17:20:44,155,4313,76,79,2766.84,5125.01,0.00
2024-12-10 17:20:44,155,4314,76,79,2749.52,5126.00,0.00
2024-12-10 17:20:44,156,4314,77,79,2731.89,5126.01,0.00
2024-12-10 17:20:44,155,4314,77,78,2748.54,5126.02,0.00
2024-12-10 17:20:44,154,4314,77,77,2761.09,5126.12,0.00
2024-12-10 17:20:44,155,4313,77,78,2693.13,5126.87,0.00
2024-12-10 17:20:44,155,4314,77,78,2724.35,5127.00,0.00
2024-12-10 17:20:44,156,4314,77,79,2706.88,5127.01,0.00
2024-12-10 17:20:44,157,4313,78,79,2687.05,5127.07,0.00
2024-12-10 17:20:44,156,4313,78,78,2688.56,5127.53,0.00
2024-12-10 17:20:44,157,4312,78,79,2655.33,5127.86,0.00
2024-12-10 17:20:44,157,4313,78,79,2713.59,5128.00,0.00
2024-12-10 17:20:44,158,4313,79,79,2696.42,5128.01,0.00
2024-12-10 17:20:44,159,4312,80,79,2659.88,5128.40,0.00
2024-12-10 17:20:44,159,4313,80,79,2747.08,5129.00,0.00
2024-12-10 17:20:44,160,4313,81,79,2729.91,5129.01,0.00
2024-12-10 17:20:44,159,4313,80,79,2740.99,5129.12,0.00
2024-12-10 17:20:44,160,4312,80,80,2715.55,5129.29,0.00
2024-12-10 17:20:44,160,4313,80,80,2769.24,5130.00,0.00
2024-12-10 17:20:44,161,4313,81,80,2752.04,5130.01,0.00
2024-12-10 17:20:44,162,4312,82,80,2733.16,5130.06,0.00
2024-12-10 17:20:44,161,4312,81,80,2763.24,5130.12,0.00
2024-12-10 17:20:44,161,4313,81,80,2782.53,5131.00,0.00
2024-12-10 17:20:44,162,4313,82,80,2765.35,5131.01,0.00
2024-12-10 17:20:44,161,4313,81,80,2776.52,5131.12,0.00
2024-12-10 17:20:44,162,4312,81,81,2737.36,5131.56,0.00
2024-12-10 17:20:44,162,4313,81,81,2793.14,5132.00,0.00
2024-12-10 17:20:44,163,4313,81,82,2776.00,5132.01,0.00
2024-12-10 17:20:44,162,4313,81,81,2788.74,5132.09,0.00
2024-12-10 17:20:44,161,4313,80,81,2804.48,5132.11,0.00
2024-12-10 17:20:44,160,4313,79,81,2821.68,5132.11,0.00
2024-12-10 17:20:44,160,4314,79,81,2840.46,5133.00,0.00
2024-12-10 17:20:44,161,4314,79,82,2822.82,5133.01,0.00
2024-12-10 17:20:44,160,4314,78,82,2834.73,5133.11,0.00
2024-12-10 17:20:45,160,4315,78,82,2820.08,5134.00,0.00
2024-12-10 17:20:45,161,4315,79,82,2802.56,5134.01,0.00
2024-12-10 17:20:45,160,4315,78,82,2816.90,5134.06,0.00
2024-12-10 17:20:45,159,4315,78,81,2832.05,5134.11,0.00
2024-12-10 17:20:45,158,4315,78,80,2849.65,5134.11,0.00
2024-12-10 17:20:45,158,4316,78,80,2834.32,5135.00,0.00
2024-12-10 17:20:45,159,4316,79,80,2816.49,5135.01,0.00
2024-12-10 17:20:45,158,4316,78,80,2828.84,5135.11,0.00
2024-12-10 17:20:45,158,4317,78,80,2812.59,5136.00,0.00
2024-12-10 17:20:45,159,4317,79,80,2794.90,5136.01,0.00
2024-12-10 17:20:45,158,4317,79,79,2807.11,5136.11,0.00
2024-12-10 17:20:45,157,4317,78,79,2824.66,5136.11,0.00
2024-12-10 17:20:45,157,4318,78,79,2809.65,5137.00,0.00
2024-12-10 17:20:45,158,4318,78,80,2791.87,5137.01,0.00
2024-12-10 17:20:45,157,4318,78,79,2805.10,5137.09,0.00
2024-12-10 17:20:45,156,4318,77,79,2822.10,5137.10,0.00
2024-12-10 17:20:45,155,4318,77,78,2839.98,5137.10,0.00
2024-12-10 17:20:45,155,4319,77,78,2827.56,5138.00,0.00
2024-12-10 17:20:45,156,4319,77,79,2809.44,5138.01,0.00
2024-12-10 17:20:45,155,4319,76,79,2826.58,5138.02,0.00
2024-12-10 17:20:45,154,4319,76,78,2840.63,5138.10,0.00
2024-12-10 17:20:45,154,4320,76,78,2828.13,5139.00,0.00
2024-12-10 17:20:45,155,4320,76,79,2809.88,5139.01,0.00
2024-12-10 17:20:45,154,4320,75,79,2823.16,5139.10,0.00
2024-12-10 17:20:45,153,4320,75,78,2828.90,5139.35,0.00
2024-12-10 17:20:45,154,4319,76,78,2805.57,5139.46,0.00
2024-12-10 17:20:45,154,4320,76,78,2830.00,5140.00,0.00
2024-12-10 17:20:45,155,4320,77,78,2811.74,5140.01,0.00
2024-12-10 17:20:45,154,4320,77,77,2825.03,5140.10,0.00
2024-12-10 17:20:45,154,4321,77,77,2845.91,5141.00,0.00
2024-12-10 17:20:45,155,4321,78,77,2827.55,5141.01,0.00
2024-12-10 17:20:45,154,4321,77,77,2844.91,5141.02,0.00
2024-12-10 17:20:45,153,4321,76,77,2859.51,5141.09,0.00
2024-12-10 17:20:45,152,4321,76,76,2877.98,5141.09,0.00
2024-12-10 17:20:45,153,4320,76,77,2837.49,5141.53,0.00
2024-12-10 17:20:45,153,4321,76,77,2863.39,5142.00,0.00
2024-12-10 17:20:45,154,4321,77,77,2844.79,5142.01,0.00
2024-12-10 17:20:45,153,4321,76,77,2860.72,5142.05,0.00
2024-12-10 17:20:45,152,4321,75,77,2877.53,5142.09,0.00
2024-12-10 17:20:45,152,4322,75,77,2898.69,5143.00,0.00
2024-12-10 17:20:45,153,4322,75,78,2879.74,5143.01,0.00
2024-12-10 17:20:45,152,4322,75,77,2897.68,5143.02,0.00
2024-12-10 17:20:45,151,4322,75,76,2913.16,5143.09,0.00
2024-12-10 17:20:45,150,4322,75,75,2932.24,5143.09,0.00
2024-12-10 17:20:45,150,4323,75,75,2920.08,5144.00,0.00
2024-12-10 17:20:45,151,4323,76,75,2900.74,5144.01,0.00
2024-12-10 17:20:45,150,4323,76,74,2915.66,5144.09,0.00
2024-12-10 17:20:45,151,4322,76,75,2858.23,5144.85,0.00
2024-12-10 17:20:45,151,4323,76,75,2890.06,5145.00,0.00
2024-12-10 17:20:45,152,4323,76,76,2871.04,5145.01,0.00
2024-12-10 17:20:45,153,4322,77,76,2850.95,5145.05,0.00
2024-12-10 17:20:45,152,4322,77,75,2889.70,5145.09,0.00
2024-12-10 17:20:45,152,4323,77,75,2911.21,5146.00,0.00
2024-12-10 17:20:45,153,4323,78,75,2892.18,5146.01,0.00
2024-12-10 17:20:45,152,4323,77,75,2906.85,5146.09,0.00
2024-12-10 17:20:45,152,4324,77,75,2928.03,5147.00,0.00
2024-12-10 17:20:45,153,4324,78,75,2908.89,5147.01,0.00
2024-12-10 17:20:45,152,4324,77,75,2923.67,5147.09,0.00
2024-12-10 17:20:45,152,4325,77,75,2910.99,5148.00,0.00
2024-12-10 17:20:45,153,4325,78,75,2891.96,5148.01,0.00
2024-12-10 17:20:45,152,4325,77,75,2906.63,5148.09,0.00
2024-12-10 17:20:45,153,4324,78,75,2872.58,5148.39,0.00
2024-12-10 17:20:45,153,4325,78,75,2868.85,5149.00,0.00
2024-12-10 17:20:45,154,4325,78,76,2850.22,5149.01,0.00
2024-12-10 17:20:45,155,4324,79,76,2808.77,5149.46,0.00
2024-12-10 17:20:45,155,4325,79,76,2855.12,5150.00,0.00
2024-12-10 17:20:45,156,4325,80,76,2836.82,5150.01,0.00
2024-12-10 17:20:45,155,4325,79,76,2850.51,5150.09,0.00
2024-12-10 17:20:45,154,4325,79,75,2825.60,5150.84,0.00
2024-12-10 17:20:45,154,4326,79,75,2884.59,5151.00,0.00
2024-12-10 17:20:45,155,4326,80,75,2865.98,5151.01,0.00
2024-12-10 17:20:45,156,4325,80,76,2802.56,5151.62,0.00
2024-12-10 17:20:45,156,4326,80,76,2829.61,5152.00,0.00
2024-12-10 17:20:45,157,4326,80,77,2811.59,5152.01,0.00
2024-12-10 17:20:45,156,4326,79,77,2824.70,5152.10,0.00
2024-12-10 17:20:45,157,4325,79,78,2800.17,5152.24,0.00
2024-12-10 17:20:45,156,4325,78,78,2821.20,5152.37,0.00
2024-12-10 17:20:45,156,4326,78,78,2854.53,5153.00,0.00
2024-12-10 17:20:45,157,4326,79,78,2836.35,5153.01,0.00
2024-12-10 17:20:45,156,4326,78,78,2849.62,5153.10,0.00
2024-12-10 17:20:45,157,4325,79,78,2816.13,5153.41,0.00
2024-12-10 17:20:45,158,4324,80,78,2806.09,5153.67,0.00
2024-12-10 17:20:45,158,4325,80,78,2866.05,5154.00,0.00
2024-12-10 17:20:45,159,4325,81,78,2848.02,5154.01,0.00
2024-12-10 17:20:45,158,4325,81,77,2861.20,5154.10,0.00
2024-12-10 17:20:45,158,4326,81,77,2912.94,5155.00,0.00
2024-12-10 17:20:45,159,4326,81,78,2894.62,5155.01,0.00
2024-12-10 17:20:45,158,4326,80,78,2908.08,5155.10,0.00
2024-12-10 17:20:45,158,4327,80,78,2894.40,5156.00,0.00
2024-12-10 17:20:45,159,4327,80,79,2876.20,5156.01,0.00
2024-12-10 17:20:45,158,4327,80,78,2889.55,5156.10,0.00
2024-12-10 17:20:45,157,4327,80,77,2907.62,5156.10,0.00
2024-12-10 17:20:45,158,4326,80,78,2888.57,5156.12,0.00
2024-12-10 17:20:45,158,4327,80,78,2907.85,5157.00,0.00
2024-12-10 17:20:45,159,4327,81,78,2889.56,5157.01,0.00
2024-12-10 17:20:45,158,4327,81,77,2902.99,5157.10,0.00
2024-12-10 17:20:45,157,4327,80,77,2921.16,5157.10,0.00
2024-12-10 17:20:46,157,4328,80,77,2940.68,5158.00,0.00
2024-12-10 17:20:46,158,4328,80,78,2922.07,5158.01,0.00
2024-12-10 17:20:46,158,4329,80,78,2904.00,5159.00,0.00
2024-12-10 17:20:46,159,4329,81,78,2885.73,5159.01,0.00
2024-12-10 17:20:46,158,4329,81,77,2898.82,5159.10,0.00
2024-12-10 17:20:46,158,4330,81,77,2885.41,5160.00,0.00
2024-12-10 17:20:46,159,4330,82,77,2867.26,5160.01,0.00
2024-12-10 17:20:46,160,4329,83,77,2848.06,5160.04,0.00
2024-12-10 17:20:46,159,4329,82,77,2866.98,5160.11,0.00
2024-12-10 17:20:46,159,4330,82,77,2853.37,5161.00,0.00
2024-12-10 17:20:46,160,4330,83,77,2835.53,5161.01,0.00
2024-12-10 17:20:46,159,4330,83,76,2848.22,5161.10,0.00
2024-12-10 17:20:46,159,4331,83,76,2865.84,5162.00,0.00
2024-12-10 17:20:46,160,4331,84,76,2847.93,5162.01,0.00
2024-12-10 17:20:46,159,4331,84,75,2860.54,5162.10,0.00
2024-12-10 17:20:46,159,4332,84,75,2844.46,5163.00,0.00
2024-12-10 17:20:46,160,4332,84,76,2826.68,5163.01,0.00
2024-12-10 17:20:46,159,4332,84,75,2840.21,5163.06,0.00
2024-12-10 17:20:46,158,4332,84,74,2855.59,5163.10,0.00
2024-12-10 17:20:46,157,4332,84,73,2868.28,5163.19,0.00
2024-12-10 17:20:46,157,4333,84,73,2858.40,5164.00,0.00
2024-12-10 17:20:46,158,4333,85,73,2840.31,5164.01,0.00
2024-12-10 17:20:46,157,4333,85,72,2850.81,5164.10,0.00
2024-12-10 17:20:46,158,4332,85,73,2827.12,5164.22,0.00
2024-12-10 17:20:46,158,4333,85,73,2839.62,5165.00,0.00
2024-12-10 17:20:46,159,4333,86,73,2821.76,5165.01,0.00
2024-12-10 17:20:46,158,4333,86,72,2838.91,5165.02,0.00
2024-12-10 17:20:46,157,4333,85,72,2852.43,5165.10,0.00
2024-12-10 17:20:46,157,4334,85,72,2869.91,5166.00,0.00
2024-12-10 17:20:46,158,4334,86,72,2851.75,5166.01,0.00
2024-12-10 17:20:46,157,4334,86,71,2864.37,5166.11,0.00
2024-12-10 17:20:46,156,4334,86,70,2879.63,5166.15,0.00
2024-12-10 17:20:46,156,4334,86,70,2867.45,5167.00,0.00
2024-12-10 17:20:46,157,4334,86,71,2849.19,5167.01,0.00
2024-12-10 17:20:46,156,4334,86,70,2861.87,5167.11,0.00
2024-12-10 17:20:46,157,4333,86,71,2817.87,5167.62,0.00
2024-12-10 17:20:46,157,4334,86,71,2843.20,5168.00,0.00
2024-12-10 17:20:46,158,4334,86,72,2825.21,5168.01,0.00
2024-12-10 17:20:46,158,4335,86,72,2837.15,5169.00,0.00
2024-12-10 17:20:46,159,4335,87,72,2819.30,5169.01,0.00
2024-12-10 17:20:46,160,4334,88,72,2761.26,5169.79,0.00
2024-12-10 17:20:46,160,4335,88,72,2788.67,5170.00,0.00
2024-12-10 17:20:46,161,4335,89,72,2771.35,5170.01,0.00
2024-12-10 17:20:46,162,4334,89,73,2746.31,5170.17,0.00
2024-12-10 17:20:46,163,4333,90,73,2747.87,5170.18,0.00
2024-12-10 17:20:46,163,4334,90,73,2769.13,5171.00,0.00
2024-12-10 17:20:46,164,4334,90,74,2752.24,5171.01,0.00
2024-12-10 17:20:46,163,4334,90,73,2763.15,5171.12,0.00
2024-12-10 17:20:46,163,4335,90,73,2811.58,5172.00,0.00
2024-12-10 17:20:46,164,4335,91,73,2794.44,5172.01,0.00
2024-12-10 17:20:46,163,4335,91,72,2811.26,5172.01,0.00
2024-12-10 17:20:46,162,4335,91,71,2822.92,5172.11,0.00
2024-12-10 17:20:46,161,4335,90,71,2840.13,5172.11,0.00
2024-12-10 17:20:46,161,4336,90,71,2825.73,5173.00,0.00
2024-12-10 17:20:46,162,4336,90,72,2808.29,5173.01,0.00
2024-12-10 17:20:46,163,4335,90,73,2765.22,5173.52,0.00
2024-12-10 17:20:46,163,4336,90,73,2788.54,5174.00,0.00
2024-12-10 17:20:46,164,4336,91,73,2771.53,5174.01,0.00
2024-12-10 17:20:46,163,4336,90,73,2782.87,5174.11,0.00
2024-12-10 17:20:46,163,4337,90,73,2800.06,5175.00,0.00
2024-12-10 17:20:46,164,4337,91,73,2782.98,5175.01,0.00
2024-12-10 17:20:46,164,4338,91,73,2762.84,5176.00,0.00
2024-12-10 17:20:46,165,4338,91,74,2746.09,5176.01,0.00
2024-12-10 17:20:46,164,4338,90,74,2757.20,5176.11,0.00
2024-12-10 17:20:46,163,4338,90,73,2773.80,5176.11,0.00
2024-12-10 17:20:46,162,4338,89,73,2790.60,5176.11,0.00
2024-12-10 17:20:46,162,4339,89,73,2775.49,5177.00,0.00
2024-12-10 17:20:46,163,4339,89,74,2758.46,5177.01,0.00
2024-12-10 17:20:46,163,4340,89,74,2735.87,5178.00,0.00
2024-12-10 17:20:46,164,4340,90,74,2719.19,5178.01,0.00
2024-12-10 17:20:46,164,4341,90,74,2694.70,5179.00,0.00
2024-12-10 17:20:46,165,4341,91,74,2678.37,5179.01,0.00
2024-12-10 17:20:46,164,4341,90,74,2688.13,5179.13,0.00
2024-12-10 17:20:46,163,4341,89,74,2668.15,5179.79,0.00
2024-12-10 17:20:46,163,4342,89,74,2689.30,5180.00,0.00
2024-12-10 17:20:46,164,4342,90,74,2672.91,5180.01,0.00
2024-12-10 17:20:46,163,4342,90,73,2682.68,5180.13,0.00
2024-12-10 17:20:46,163,4343,90,73,2669.18,5181.00,0.00
2024-12-10 17:20:46,164,4343,90,74,2652.90,5181.01,0.00
2024-12-10 17:20:46,163,4343,89,74,2662.56,5181.13,0.00
2024-12-10 17:20:47,163,4344,89,74,2648.10,5182.00,0.00
2024-12-10 17:20:47,164,4344,90,74,2631.96,5182.01,0.00
2024-12-10 17:20:47,163,4344,89,74,2645.89,5182.04,0.00
2024-12-10 17:20:47,164,4343,89,75,2587.41,5182.84,0.00
2024-12-10 17:20:47,164,4344,89,75,2617.26,5183.00,0.00
2024-12-10 17:20:47,165,4344,89,76,2601.40,5183.01,0.00
2024-12-10 17:20:47,164,4344,88,76,2609.29,5183.13,0.00
2024-12-10 17:20:47,164,4345,88,76,2626.34,5184.00,0.00
2024-12-10 17:20:47,165,4345,89,76,2610.42,5184.01,0.00
2024-12-10 17:20:47,164,4345,88,76,2618.39,5184.13,0.00
2024-12-10 17:20:47,163,4345,87,76,2621.70,5184.34,0.00
2024-12-10 17:20:47,163,4346,87,76,2619.14,5185.00,0.00
2024-12-10 17:20:47,164,4346,87,77,2603.17,5185.01,0.00
2024-12-10 17:20:47,163,4346,87,76,2610.87,5185.14,0.00
2024-12-10 17:20:47,163,4347,87,76,2596.12,5186.00,0.00
2024-12-10 17:20:47,164,4347,88,76,2580.29,5186.01,0.00
2024-12-10 17:20:47,163,4347,87,76,2587.70,5186.14,0.00
2024-12-10 17:20:47,163,4348,87,76,2571.82,5187.00,0.00
2024-12-10 17:20:47,164,4348,87,77,2556.14,5187.01,0.00
2024-12-10 17:20:47,163,4348,87,76,2568.65,5187.06,0.00
2024-12-10 17:20:47,162,4348,86,76,2579.11,5187.13,0.00
2024-12-10 17:20:47,161,4348,85,76,2589.61,5187.22,0.00
2024-12-10 17:20:47,161,4349,85,76,2579.24,5188.00,0.00
2024-12-10 17:20:47,162,4349,85,77,2563.32,5188.01,0.00
2024-12-10 17:20:47,161,4349,85,76,2570.78,5188.14,0.00
2024-12-10 17:20:47,161,4350,85,76,2556.92,5189.00,0.00
2024-12-10 17:20:47,162,4350,85,77,2541.14,5189.01,0.00
2024-12-10 17:20:47,161,4350,84,77,2548.71,5189.14,0.00
2024-12-10 17:20:47,160,4350,84,76,2551.14,5189.38,0.00
2024-12-10 17:20:47,160,4351,84,76,2551.53,5190.00,0.00
2024-12-10 17:20:47,161,4351,84,77,2535.68,5190.01,0.00
2024-12-10 17:20:47,160,4351,84,76,2543.63,5190.14,0.00
2024-12-10 17:20:47,160,4352,84,76,2531.75,5191.00,0.00
2024-12-10 17:20:47,161,4352,84,77,2516.02,5191.01,0.00
2024-12-10 17:20:47,160,4352,83,77,2529.81,5191.04,0.00
2024-12-10 17:20:47,159,4352,83,76,2539.38,5191.15,0.00
2024-12-10 17:20:47,159,4353,83,76,2527.80,5192.00,0.00
2024-12-10 17:20:47,160,4353,83,77,2512.00,5192.01,0.00
2024-12-10 17:20:47,160,4354,83,77,2492.45,5193.00,0.00
2024-12-10 17:20:47,161,4354,84,77,2476.97,5193.01,0.00
2024-12-10 17:20:47,161,4355,84,77,2456.99,5194.00,0.00
2024-12-10 17:20:47,162,4355,85,77,2441.83,5194.01,0.00
2024-12-10 17:20:47,161,4355,84,77,2448.98,5194.16,0.00
2024-12-10 17:20:47,161,4356,84,77,2436.31,5195.00,0.00
2024-12-10 17:20:47,162,4356,84,78,2421.27,5195.01,0.00
2024-12-10 17:20:47,161,4356,83,78,2427.92,5195.16,0.00
2024-12-10 17:20:47,160,4356,82,78,2442.00,5195.18,0.00
2024-12-10 17:20:47,161,4355,83,78,2416.22,5195.39,0.00
2024-12-10 17:20:47,161,4356,83,78,2441.43,5196.00,0.00
2024-12-10 17:20:47,162,4356,83,79,2426.36,5196.01,0.00
2024-12-10 17:20:47,161,4356,82,79,2432.87,5196.16,0.00
2024-12-10 17:20:47,161,4357,82,79,2451.67,5197.00,0.00
2024-12-10 17:20:47,162,4357,82,80,2436.53,5197.01,0.00
2024-12-10 17:20:47,161,4357,82,79,2442.83,5197.16,0.00
2024-12-10 17:20:47,161,4358,82,79,2428.92,5198.00,0.00
2024-12-10 17:20:47,162,4358,83,79,2413.93,5198.01,0.00
2024-12-10 17:20:47,161,4358,82,79,2427.00,5198.04,0.00
2024-12-10 17:20:47,160,4358,82,78,2434.96,5198.16,0.00
2024-12-10 17:20:47,160,4359,82,78,2420.56,5199.00,0.00
2024-12-10 17:20:47,161,4359,82,79,2405.53,5199.01,0.00
2024-12-10 17:20:47,160,4359,81,79,2418.62,5199.04,0.00
2024-12-10 17:20:47,159,4359,81,78,2429.98,5199.10,0.00
2024-12-10 17:20:47,158,4359,80,78,2442.74,5199.15,0.00
2024-12-10 17:20:47,157,4359,79,78,2457.97,5199.15,0.00
2024-12-10 17:20:47,158,4358,79,79,2437.29,5199.25,0.00
2024-12-10 17:20:47,158,4359,79,79,2443.19,5200.00,0.00
2024-12-10 17:20:47,159,4359,80,79,2427.83,5200.01,0.00
2024-12-10 17:20:47,158,4359,80,78,2435.67,5200.15,0.00
2024-12-10 17:20:47,157,4359,79,78,2447.90,5200.20,0.00
2024-12-10 17:20:47,157,4360,79,78,2468.64,5201.00,0.00
2024-12-10 17:20:47,158,4360,79,79,2453.02,5201.01,0.00
2024-12-10 17:20:47,159,4359,79,80,2435.32,5201.06,0.00
2024-12-10 17:20:47,158,4359,79,79,2469.53,5201.15,0.00
2024-12-10 17:20:47,157,4359,78,79,2484.92,5201.15,0.00
2024-12-10 17:20:47,157,4360,78,79,2469.59,5202.00,0.00
2024-12-10 17:20:47,158,4360,78,80,2453.96,5202.01,0.00
2024-12-10 17:20:47,157,4360,78,79,2461.40,5202.15,0.00
2024-12-10 17:20:47,156,4360,77,79,2476.93,5202.15,0.00
2024-12-10 17:20:47,155,4360,76,79,2474.89,5202.43,0.00
2024-12-10 17:20:47,155,4361,76,79,2512.53,5203.00,0.00
2024-12-10 17:20:47,156,4361,77,79,2496.43,5203.01,0.00
2024-12-10 17:20:47,157,4360,77,80,2450.07,5203.54,0.00
2024-12-10 17:20:47,157,4361,77,80,2477.84,5204.00,0.00
2024-12-10 17:20:47,158,4361,77,81,2462.16,5204.01,0.00
2024-12-10 17:20:47,157,4361,77,80,2476.19,5204.03,0.00
2024-12-10 17:20:47,156,4361,77,79,2484.69,5204.14,0.00
2024-12-10 17:20:47,155,4361,76,79,2500.39,5204.14,0.00
2024-12-10 17:20:47,155,4362,76,79,2520.37,5205.00,0.00
2024-12-10 17:20:47,156,4362,76,80,2504.21,5205.01,0.00
2024-12-10 17:20:47,155,4362,75,80,2511.43,5205.14,0.00
2024-12-10 17:20:47,155,4363,75,80,2496.89,5206.00,0.00
2024-12-10 17:20:47,156,4363,75,81,2480.88,5206.01,0.00
2024-12-10 17:20:47,155,4363,75,80,2488.14,5206.14,0.00
2024-12-10 17:20:48,156,4362,76,80,2465.54,5206.28,0.00
2024-12-10 17:20:48,156,4363,76,80,2478.10,5207.00,0.00
2024-12-10 17:20:48,157,4363,77,80,2462.32,5207.01,0.00
2024-12-10 17:20:48,157,4364,77,80,2466.70,5208.00,0.00
2024-12-10 17:20:48,158,4364,77,81,2451.09,5208.01,0.00
2024-12-10 17:20:48,157,4364,77,80,2459.44,5208.14,0.00
2024-12-10 17:20:48,157,4365,77,80,2437.94,5209.00,0.00
2024-12-10 17:20:48,158,4365,77,81,2422.51,5209.01,0.00
2024-12-10 17:20:48,157,4365,77,80,2433.32,5209.09,0.00
2024-12-10 17:20:48,156,4365,76,80,2448.58,5209.09,0.00
2024-12-10 17:20:48,155,4365,75,80,2462.04,5209.13,0.00
2024-12-10 17:20:48,154,4365,75,79,2477.68,5209.13,0.00
2024-12-10 17:20:48,154,4366,75,79,2455.55,5210.00,0.00
2024-12-10 17:20:48,155,4366,76,79,2439.71,5210.01,0.00
2024-12-10 17:20:48,154,4366,76,78,2452.86,5210.05,0.00
2024-12-10 17:20:48,153,4366,75,78,2464.82,5210.12,0.00
2024-12-10 17:20:48,152,4366,74,78,2469.27,5210.24,0.00
2024-12-10 17:20:48,151,4366,74,77,2475.09,5210.42,0.00
2024-12-10 17:20:48,151,4367,74,77,2478.08,5211.00,0.00
2024-12-10 17:20:48,152,4367,75,77,2461.78,5211.01,0.00
2024-12-10 17:20:48,151,4367,74,77,2471.22,5211.13,0.00
2024-12-10 17:20:48,151,4368,74,77,2453.46,5212.00,0.00
2024-12-10 17:20:48,152,4368,74,78,2437.32,5212.01,0.00
2024-12-10 17:20:48,151,4368,74,77,2446.02,5212.14,0.00
2024-12-10 17:20:48,152,4367,75,77,2429.25,5212.17,0.00
2024-12-10 17:20:48,151,4367,74,77,2469.92,5212.23,0.00
2024-12-10 17:20:48,150,4367,73,77,2478.23,5212.38,0.00
2024-12-10 17:20:48,150,4368,73,77,2478.75,5213.00,0.00
2024-12-10 17:20:48,151,4368,73,78,2462.34,5213.01,0.00
2024-12-10 17:20:48,150,4368,73,77,2473.17,5213.09,0.00
2024-12-10 17:20:48,149,4368,73,76,2486.98,5213.13,0.00
2024-12-10 17:20:48,148,4368,73,75,2503.43,5213.14,0.00
2024-12-10 17:20:48,149,4367,74,75,2484.19,5213.20,0.00
2024-12-10 17:20:48,149,4368,74,75,2523.38,5214.00,0.00
2024-12-10 17:20:48,150,4368,74,76,2506.56,5214.01,0.00
2024-12-10 17:20:48,149,4368,73,76,2519.45,5214.07,0.00
2024-12-10 17:20:48,149,4369,73,76,2537.72,5215.00,0.00
2024-12-10 17:20:48,150,4369,73,77,2520.80,5215.01,0.00
2024-12-10 17:20:48,149,4369,72,77,2534.93,5215.05,0.00
2024-12-10 17:20:48,148,4369,71,77,2549.25,5215.10,0.00
2024-12-10 17:20:48,147,4369,71,76,2565.19,5215.12,0.00
2024-12-10 17:20:48,146,4369,70,76,2582.40,5215.12,0.00
2024-12-10 17:20:48,146,4370,70,76,2568.61,5216.00,0.00
2024-12-10 17:20:48,147,4370,70,77,2551.13,5216.01,0.00
2024-12-10 17:20:48,146,4370,69,77,2562.22,5216.12,0.00
2024-12-10 17:20:48,147,4369,69,78,2496.15,5216.99,0.00
2024-12-10 17:20:48,147,4370,69,78,2531.65,5217.00,0.00
2024-12-10 17:20:48,148,4370,69,79,2514.54,5217.01,0.00
2024-12-10 17:20:48,147,4370,69,78,2510.86,5217.40,0.00
2024-12-10 17:20:48,147,4371,69,78,2549.34,5218.00,0.00
2024-12-10 17:20:48,148,4371,69,79,2532.11,5218.01,0.00
2024-12-10 17:20:48,147,4371,68,79,2542.64,5218.13,0.00
2024-12-10 17:20:48,146,4371,68,78,2556.84,5218.16,0.00
2024-12-10 17:20:48,147,4370,69,78,2529.19,5218.37,0.00
2024-12-10 17:20:48,147,4371,69,78,2555.55,5219.00,0.00
2024-12-10 17:20:48,148,4371,70,78,2538.28,5219.01,0.00
2024-12-10 17:20:48,147,4371,69,78,2555.20,5219.01,0.00
2024-12-10 17:20:48,146,4371,69,77,2566.30,5219.12,0.00
2024-12-10 17:20:48,146,4372,69,77,2591.63,5220.00,0.00
2024-12-10 17:20:48,147,4372,70,77,2574.00,5220.01,0.00
2024-12-10 17:20:48,146,4372,70,76,2584.88,5220.13,0.00
2024-12-10 17:20:48,146,4373,70,76,2575.32,5221.00,0.00
2024-12-10 17:20:48,147,4373,71,76,2557.80,5221.01,0.00
2024-12-10 17:20:48,148,4372,71,77,2534.91,5221.13,0.00
2024-12-10 17:20:48,147,4372,70,77,2575.25,5221.14,0.00
2024-12-10 17:20:48,147,4373,70,77,2566.10,5222.00,0.00
2024-12-10 17:20:48,148,4373,70,78,2548.77,5222.01,0.00
2024-12-10 17:20:48,147,4373,70,77,2562.22,5222.08,0.00
2024-12-10 17:20:48,147,4374,70,77,2584.97,5223.00,0.00
2024-12-10 17:20:48,148,4374,70,78,2567.50,5223.01,0.00
2024-12-10 17:20:48,147,4374,69,78,2578.62,5223.12,0.00
2024-12-10 17:20:48,148,4373,70,78,2558.03,5223.20,0.00
2024-12-10 17:20:48,148,4374,70,78,2584.58,5224.00,0.00
2024-12-10 17:20:48,149,4374,71,78,2567.24,5224.01,0.00
2024-12-10 17:20:48,148,4374,70,78,2578.28,5224.12,0.00
2024-12-10 17:20:48,149,4373,71,78,2559.93,5224.15,0.00
2024-12-10 17:20:48,149,4374,71,78,2619.73,5225.00,0.00
2024-12-10 17:20:48,150,4374,71,79,2602.27,5225.01,0.00
2024-12-10 17:20:48,150,4375,71,79,2619.21,5226.00,0.00
2024-12-10 17:20:48,151,4375,71,80,2601.86,5226.01,0.00
2024-12-10 17:20:48,150,4375,70,80,2612.63,5226.13,0.00
2024-12-10 17:20:48,149,4375,70,79,2629.82,5226.13,0.00
2024-12-10 17:20:48,149,4376,70,79,2617.49,5227.00,0.00
2024-12-10 17:20:48,150,4376,71,79,2600.04,5227.01,0.00
2024-12-10 17:20:48,149,4376,71,78,2616.44,5227.02,0.00
2024-12-10 17:20:48,148,4376,71,77,2630.26,5227.09,0.00
2024-12-10 17:20:48,147,4376,71,76,2645.69,5227.13,0.00
2024-12-10 17:20:48,147,4377,71,76,2633.16,5228.00,0.00
2024-12-10 17:20:48,148,4377,71,77,2615.37,5228.01,0.00
2024-12-10 17:20:48,147,4377,71,76,2629.29,5228.08,0.00
2024-12-10 17:20:48,146,4377,70,76,2644.47,5228.12,0.00
2024-12-10 17:20:48,145,4377,69,76,2662.35,5228.12,0.00
2024-12-10 17:20:48,146,4376,70,76,2597.98,5228.95,0.00
2024-12-10 17:20:48,146,4377,70,76,2633.14,5229.00,0.00
2024-12-10 17:20:48,147,4377,71,76,2615.22,5229.01,0.00
2024-12-10 17:20:48,146,4377,71,75,2632.06,5229.02,0.00
2024-12-10 17:20:48,147,4376,71,76,2614.16,5229.03,0.00
2024-12-10 17:20:48,146,4376,71,75,2652.54,5229.13,0.00
2024-12-10 17:20:48,145,4376,70,75,2631.42,5229.79,0.00
2024-12-10 17:20:48,145,4377,70,75,2692.91,5230.00,0.00
2024-12-10 17:20:48,146,4377,71,75,2674.46,5230.01,0.00
2024-12-10 17:20:48,145,4377,71,74,2692.55,5230.01,0.00
2024-12-10 17:20:48,144,4377,70,74,2705.13,5230.12,0.00
2024-12-10 17:20:48,143,4377,69,74,2723.69,5230.12,0.00
2024-12-10 17:20:49,143,4378,69,74,2746.19,5231.00,0.00
2024-12-10 17:20:49,144,4378,70,74,2727.12,5231.01,0.00
2024-12-10 17:20:49,143,4378,69,74,2740.04,5231.12,0.00
2024-12-10 17:20:49,143,4379,69,74,2723.33,5232.00,0.00
2024-12-10 17:20:49,144,4379,70,74,2704.41,5232.01,0.00
2024-12-10 17:20:49,143,4379,70,73,2717.17,5232.12,0.00
2024-12-10 17:20:49,142,4379,69,73,2715.17,5232.44,0.00
2024-12-10 17:20:49,142,4380,69,73,2718.91,5233.00,0.00
2024-12-10 17:20:49,143,4380,69,74,2699.89,5233.01,0.00
2024-12-10 17:20:49,142,4380,69,73,2712.70,5233.12,0.00
2024-12-10 17:20:49,143,4379,70,73,2687.30,5233.25,0.00
2024-12-10 17:20:49,142,4379,69,73,2720.30,5233.52,0.00
2024-12-10 17:20:49,142,4380,69,73,2732.45,5234.00,0.00
2024-12-10 17:20:49,143,4380,70,73,2713.34,5234.01,0.00
2024-12-10 17:20:49,144,4379,70,74,2689.82,5234.11,0.00
2024-12-10 17:20:49,144,4380,70,74,2718.18,5235.00,0.00
2024-12-10 17:20:49,145,4380,70,75,2699.44,5235.01,0.00
2024-12-10 17:20:49,144,4380,69,75,2712.06,5235.12,0.00
2024-12-10 17:20:49,144,4381,69,75,2737.91,5236.00,0.00
2024-12-10 17:20:49,145,4381,70,75,2719.03,5236.01,0.00
2024-12-10 17:20:49,144,4381,69,75,2731.78,5236.12,0.00
2024-12-10 17:20:49,143,4381,69,74,2748.77,5236.15,0.00
2024-12-10 17:20:49,142,4381,68,74,2767.38,5236.16,0.00
2024-12-10 17:20:49,142,4382,68,74,2760.84,5237.00,0.00
2024-12-10 17:20:49,143,4382,69,74,2741.53,5237.01,0.00
2024-12-10 17:20:49,142,4382,69,73,2754.62,5237.12,0.00
2024-12-10 17:20:49,142,4383,69,73,2745.19,5238.00,0.00
2024-12-10 17:20:49,143,4383,69,74,2725.99,5238.01,0.00
2024-12-10 17:20:49,144,4382,70,74,2703.81,5238.08,0.00
2024-12-10 17:20:49,143,4382,70,73,2729.34,5238.13,0.00
2024-12-10 17:20:49,143,4383,70,73,2717.15,5239.00,0.00
2024-12-10 17:20:49,144,4383,70,74,2698.28,5239.01,0.00
2024-12-10 17:20:49,143,4383,70,73,2706.64,5239.12,0.00
2024-12-10 17:20:49,142,4383,69,73,2717.81,5239.23,0.00
2024-12-10 17:20:49,142,4384,69,73,2749.95,5240.00,0.00
2024-12-10 17:20:49,143,4384,69,74,2730.72,5240.01,0.00
2024-12-10 17:20:49,142,4384,68,74,2748.43,5240.03,0.00
2024-12-10 17:20:49,141,4384,67,74,2763.14,5240.11,0.00
2024-12-10 17:20:49,141,4385,67,74,2752.93,5241.00,0.00
2024-12-10 17:20:49,142,4385,67,75,2733.55,5241.01,0.00
2024-12-10 17:20:49,141,4385,67,74,2750.35,5241.05,0.00
2024-12-10 17:20:49,140,4385,66,74,2766.13,5241.11,0.00
2024-12-10 17:20:49,140,4386,66,74,2735.49,5242.00,0.00
2024-12-10 17:20:49,141,4386,67,74,2716.09,5242.01,0.00
2024-12-10 17:20:49,140,4386,66,74,2729.93,5242.11,0.00
2024-12-10 17:20:49,139,4386,65,74,2692.37,5242.93,0.00
2024-12-10 17:20:49,139,4387,65,74,2726.38,5243.00,0.00
2024-12-10 17:20:49,140,4387,65,75,2706.90,5243.01,0.00
2024-12-10 17:20:49,139,4387,64,75,2721.67,5243.09,0.00
2024-12-10 17:20:49,139,4388,64,75,2712.34,5244.00,0.00
2024-12-10 17:20:49,140,4388,65,75,2692.96,5244.01,0.00
2024-12-10 17:20:49,139,4388,65,74,2707.10,5244.10,0.00
2024-12-10 17:20:49,139,4389,65,74,2696.11,5245.00,0.00
2024-12-10 17:20:49,140,4389,65,75,2676.85,5245.01,0.00
2024-12-10 17:20:49,140,4390,65,75,2658.49,5246.00,0.00
2024-12-10 17:20:49,141,4390,66,75,2639.64,5246.01,0.00
2024-12-10 17:20:49,140,4390,65,75,2652.55,5246.11,0.00
2024-12-10 17:20:49,141,4389,66,75,2630.78,5246.19,0.00
2024-12-10 17:20:49,140,4389,66,74,2670.80,5246.41,0.00
2024-12-10 17:20:49,140,4390,66,74,2676.34,5247.00,0.00
2024-12-10 17:20:49,141,4390,66,75,2657.36,5247.01,0.00
2024-12-10 17:20:49,141,4391,66,75,2676.70,5248.00,0.00
2024-12-10 17:20:49,142,4391,66,76,2657.85,5248.01,0.00
2024-12-10 17:20:49,141,4391,65,76,2670.42,5248.12,0.00
2024-12-10 17:20:49,140,4391,64,76,2671.37,5248.40,0.00
2024-12-10 17:20:49,140,4392,64,76,2677.77,5249.00,0.00
2024-12-10 17:20:49,141,4392,64,77,2658.78,5249.01,0.00
2024-12-10 17:20:49,140,4392,63,77,2671.08,5249.13,0.00
2024-12-10 17:20:49,140,4393,63,77,2663.28,5250.00,0.00
2024-12-10 17:20:49,141,4393,64,77,2644.39,5250.01,0.00
2024-12-10 17:20:49,140,4393,63,77,2656.59,5250.13,0.00
2024-12-10 17:20:49,140,4394,63,77,2648.78,5251.00,0.00
2024-12-10 17:20:49,141,4394,63,78,2630.00,5251.01,0.00
2024-12-10 17:20:49,142,4393,64,78,2611.48,5251.02,0.00
2024-12-10 17:20:49,143,4392,64,79,2624.45,5251.07,0.00
2024-12-10 17:20:49,142,4392,63,79,2657.77,5251.14,0.00
2024-12-10 17:20:49,141,4392,63,78,2676.25,5251.14,0.00
2024-12-10 17:20:49,141,4393,63,78,2668.86,5252.00,0.00
2024-12-10 17:20:49,142,4393,64,78,2650.07,5252.01,0.00
2024-12-10 17:20:49,141,4393,64,77,2662.23,5252.13,0.00
2024-12-10 17:20:49,141,4394,64,77,2728.61,5253.00,0.00
2024-12-10 17:20:49,142,4394,64,78,2709.39,5253.01,0.00
2024-12-10 17:20:49,141,4394,64,77,2726.39,5253.04,0.00
2024-12-10 17:20:49,140,4394,63,77,2741.04,5253.13,0.00
2024-12-10 17:20:49,141,4393,63,78,2682.73,5253.89,0.00
2024-12-10 17:20:49,141,4394,63,78,2718.99,5254.00,0.00
2024-12-10 17:20:49,142,4394,63,79,2699.84,5254.01,0.00
2024-12-10 17:20:49,141,4394,62,79,2712.35,5254.13,0.00
2024-12-10 17:20:49,141,4395,62,79,2741.07,5255.00,0.00
2024-12-10 17:20:49,142,4395,62,80,2721.77,5255.01,0.00
2024-12-10 17:20:49,141,4395,62,79,2723.21,5255.13,0.00
2024-12-10 17:20:50,141,4396,62,79,2714.40,5256.00,0.00
2024-12-10 17:20:50,142,4396,62,80,2695.28,5256.01,0.00
2024-12-10 17:20:50,141,4396,61,80,2697.34,5256.10,0.00
2024-12-10 17:20:50,140,4396,61,79,2715.12,5256.12,0.00
2024-12-10 17:20:50,139,4396,61,78,2734.28,5256.12,0.00
2024-12-10 17:20:50,139,4397,61,78,2725.18,5257.00,0.00
2024-12-10 17:20:50,140,4397,62,78,2705.72,5257.01,0.00
2024-12-10 17:20:50,139,4397,61,78,2718.82,5257.12,0.00
2024-12-10 17:20:50,139,4398,61,78,2708.92,5258.00,0.00
2024-12-10 17:20:50,140,4398,62,78,2689.57,5258.01,0.00
2024-12-10 17:20:50,139,4398,62,77,2702.55,5258.12,0.00
2024-12-10 17:20:50,139,4399,62,77,2692.20,5259.00,0.00
2024-12-10 17:20:50,140,4399,63,77,2672.97,5259.01,0.00
2024-12-10 17:20:50,139,4399,62,77,2685.83,5259.12,0.00
2024-12-10 17:20:50,139,4400,62,77,2675.45,5260.00,0.00
2024-12-10 17:20:50,140,4400,63,77,2656.34,5260.01,0.00
2024-12-10 17:20:50,139,4400,62,77,2669.08,5260.12,0.00
2024-12-10 17:20:50,139,4401,62,77,2659.33,5261.00,0.00
2024-12-10 17:20:50,140,4401,62,78,2640.34,5261.01,0.00
2024-12-10 17:20:50,139,4401,61,78,2652.58,5261.13,0.00
2024-12-10 17:20:50,138,4401,61,77,2670.57,5261.15,0.00
2024-12-10 17:20:50,138,4402,61,77,2662.60,5262.00,0.00
2024-12-10 17:20:50,139,4402,61,78,2643.45,5262.01,0.00
2024-12-10 17:20:50,138,4402,60,78,2655.80,5262.13,0.00
2024-12-10 17:20:50,139,4401,61,78,2631.40,5262.25,0.00
2024-12-10 17:20:50,139,4402,61,78,2661.34,5263.00,0.00
2024-12-10 17:20:50,140,4402,61,79,2642.33,5263.01,0.00
2024-12-10 17:20:50,139,4402,61,78,2654.59,5263.13,0.00
2024-12-10 17:20:50,139,4403,61,78,2683.17,5264.00,0.00
2024-12-10 17:20:50,140,4403,61,79,2664.00,5264.01,0.00
2024-12-10 17:20:50,139,4403,60,79,2676.41,5264.13,0.00
2024-12-10 17:20:50,139,4404,60,79,2666.66,5265.00,0.00
2024-12-10 17:20:50,140,4404,60,80,2647.61,5265.01,0.00
2024-12-10 17:20:50,139,4404,59,80,2659.90,5265.13,0.00
2024-12-10 17:20:50,139,4405,59,80,2646.80,5266.00,0.00
2024-12-10 17:20:50,140,4405,59,81,2627.89,5266.01,0.00
2024-12-10 17:20:50,139,4405,58,81,2640.03,5266.13,0.00
2024-12-10 17:20:50,138,4405,58,80,2658.45,5266.14,0.00
2024-12-10 17:20:50,139,4404,58,81,2619.39,5266.45,0.00
2024-12-10 17:20:50,140,4403,58,82,2609.77,5266.66,0.00
2024-12-10 17:20:50,140,4404,58,82,2643.96,5267.00,0.00
2024-12-10 17:20:50,141,4404,59,82,2625.21,5267.01,0.00
2024-12-10 17:20:50,140,4404,59,81,2640.23,5267.07,0.00
2024-12-10 17:20:50,139,4404,59,80,2656.22,5267.12,0.00
2024-12-10 17:20:50,138,4404,58,80,2673.81,5267.15,0.00
2024-12-10 17:20:50,137,4404,57,80,2679.27,5267.35,0.00
2024-12-10 17:20:50,138,4403,58,80,2631.90,5267.81,0.00
2024-12-10 17:20:50,138,4404,58,80,2743.77,5268.00,0.00
2024-12-10 17:20:50,139,4404,58,81,2724.03,5268.01,0.00
2024-12-10 17:20:50,138,4404,58,80,2737.33,5268.12,0.00
2024-12-10 17:20:50,137,4404,58,79,2752.73,5268.21,0.00
2024-12-10 17:20:50,137,4405,58,79,2781.37,5269.00,0.00
2024-12-10 17:20:50,138,4405,59,79,2761.22,5269.01,0.00
2024-12-10 17:20:50,137,4405,59,78,2776.80,5269.09,0.00
2024-12-10 17:20:50,136,4405,58,78,2795.29,5269.12,0.00
2024-12-10 17:20:50,136,4406,58,78,2780.09,5270.00,0.00
2024-12-10 17:20:50,137,4406,59,78,2759.80,5270.01,0.00
2024-12-10 17:20:50,136,4406,59,77,2778.56,5270.03,0.00
2024-12-10 17:20:50,135,4406,59,76,2798.75,5270.03,0.00
2024-12-10 17:20:50,134,4406,58,76,2815.35,5270.10,0.00
2024-12-10 17:20:50,133,4406,58,75,2836.12,5270.11,0.00
2024-12-10 17:20:50,132,4406,58,74,2831.24,5270.55,0.00
2024-12-10 17:20:50,132,4407,58,74,2845.88,5271.00,0.00
2024-12-10 17:20:50,133,4407,59,74,2824.48,5271.01,0.00
2024-12-10 17:20:50,132,4407,59,73,2840.34,5271.11,0.00
2024-12-10 17:20:50,132,4408,59,73,2830.13,5272.00,0.00
2024-12-10 17:20:50,133,4408,60,73,2808.85,5272.01,0.00
2024-12-10 17:20:50,134,4407,60,74,2784.39,5272.09,0.00
2024-12-10 17:20:50,133,4407,59,74,2830.71,5272.11,0.00
2024-12-10 17:20:50,133,4408,59,74,2820.63,5273.00,0.00
2024-12-10 17:20:50,134,4408,60,74,2799.58,5273.01,0.00
2024-12-10 17:20:50,133,4408,60,73,2815.14,5273.11,0.00
2024-12-10 17:20:50,132,4408,60,72,2829.04,5273.21,0.00
2024-12-10 17:20:50,131,4408,60,71,2842.19,5273.35,0.00
2024-12-10 17:20:50,132,4407,61,71,2798.92,5273.78,0.00
2024-12-10 17:20:50,132,4408,61,71,2875.82,5274.00,0.00
2024-12-10 17:20:50,133,4408,61,72,2854.20,5274.01,0.00
2024-12-10 17:20:50,132,4408,60,72,2868.68,5274.11,0.00
2024-12-10 17:20:50,132,4409,60,72,2902.34,5275.00,0.00
2024-12-10 17:20:50,133,4409,60,73,2880.52,5275.01,0.00
2024-12-10 17:20:50,132,4409,59,73,2895.32,5275.11,0.00
2024-12-10 17:20:50,132,4410,59,73,2888.27,5276.00,0.00
2024-12-10 17:20:50,133,4410,59,74,2866.55,5276.01,0.00
2024-12-10 17:20:50,132,4410,59,73,2881.16,5276.11,0.00
2024-12-10 17:20:50,132,4411,59,73,2872.64,5277.00,0.00
2024-12-10 17:20:50,133,4411,59,74,2851.04,5277.01,0.00
2024-12-10 17:20:50,133,4412,59,74,2832.15,5278.00,0.00
2024-12-10 17:20:50,134,4412,60,74,2811.01,5278.01,0.00
2024-12-10 17:20:50,133,4412,59,74,2817.44,5278.23,0.00
2024-12-10 17:20:50,133,4413,59,74,2812.02,5279.00,0.00
2024-12-10 17:20:50,134,4413,60,74,2791.04,5279.01,0.00
2024-12-10 17:20:50,133,4413,59,74,2802.83,5279.11,0.00
2024-12-10 17:20:50,134,4412,60,74,2744.19,5279.75,0.00
2024-12-10 17:20:50,134,4413,60,74,2781.06,5280.00,0.00
2024-12-10 17:20:50,135,4413,60,75,2760.46,5280.01,0.00
2024-12-10 17:20:50,135,4414,60,75,2777.01,5281.00,0.00
2024-12-10 17:20:50,136,4414,61,75,2756.59,5281.01,0.00
2024-12-10 17:20:51,135,4414,60,75,2741.95,5281.50,0.00
2024-12-10 17:20:51,135,4415,60,75,2754.84,5282.00,0.00
2024-12-10 17:20:51,136,4415,60,76,2734.59,5282.01,0.00
2024-12-10 17:20:51,135,4415,60,75,2746.40,5282.06,0.00
2024-12-10 17:20:51,134,4415,59,75,2764.95,5282.09,0.00
2024-12-10 17:20:51,133,4415,58,75,2784.94,5282.10,0.00
2024-12-10 17:20:51,132,4415,58,74,2805.64,5282.10,0.00
2024-12-10 17:20:51,132,4416,58,74,2798.06,5283.00,0.00
2024-12-10 17:20:51,133,4416,59,74,2777.02,5283.01,0.00
2024-12-10 17:20:51,132,4416,59,73,2792.90,5283.10,0.00
2024-12-10 17:20:51,133,4415,60,73,2766.35,5283.22,0.00
2024-12-10 17:20:51,133,4416,60,73,2797.23,5284.00,0.00
2024-12-10 17:20:51,134,4416,61,73,2776.35,5284.01,0.00
2024-12-10 17:20:51,133,4416,60,73,2792.11,5284.10,0.00
2024-12-10 17:20:51,133,4417,60,73,2823.58,5285.00,0.00
2024-12-10 17:20:51,134,4417,61,73,2802.50,5285.01,0.00
2024-12-10 17:20:51,133,4417,61,72,2818.45,5285.10,0.00
2024-12-10 17:20:51,133,4418,61,72,2810.47,5286.00,0.00
2024-12-10 17:20:51,134,4418,61,73,2789.49,5286.01,0.00
2024-12-10 17:20:51,133,4418,60,73,2805.34,5286.10,0.00
2024-12-10 17:20:51,134,4417,61,73,2749.97,5286.77,0.00
2024-12-10 17:20:51,134,4418,61,73,2786.47,5287.00,0.00
2024-12-10 17:20:51,135,4418,61,74,2765.83,5287.01,0.00
2024-12-10 17:20:51,134,4418,61,73,2781.27,5287.10,0.00
2024-12-10 17:20:51,134,4419,61,73,2812.93,5288.00,0.00
2024-12-10 17:20:51,135,4419,62,73,2792.09,5288.01,0.00
2024-12-10 17:20:51,134,4419,62,72,2807.38,5288.10,0.00
2024-12-10 17:20:51,135,4418,63,72,2762.05,5288.58,0.00
2024-12-10 17:20:51,135,4419,63,72,2796.47,5289.00,0.00
2024-12-10 17:20:51,136,4419,64,72,2775.91,5289.01,0.00
2024-12-10 17:20:51,135,4419,64,71,2790.75,5289.10,0.00
2024-12-10 17:20:51,135,4420,64,71,2819.81,5290.00,0.00
2024-12-10 17:20:51,136,4420,65,71,2799.07,5290.01,0.00
2024-12-10 17:20:51,136,4421,65,71,2781.11,5291.00,0.00
2024-12-10 17:20:51,137,4421,66,71,2760.81,5291.01,0.00
2024-12-10 17:20:51,136,4421,66,70,2774.90,5291.10,0.00
2024-12-10 17:20:51,135,4421,66,69,2784.98,5291.28,0.00
2024-12-10 17:20:51,136,4420,67,69,2744.45,5291.68,0.00
2024-12-10 17:20:51,136,4421,67,69,2779.74,5292.00,0.00
2024-12-10 17:20:51,137,4421,68,69,2759.45,5292.01,0.00
2024-12-10 17:20:51,136,4421,68,68,2773.01,5292.10,0.00
2024-12-10 17:20:51,136,4422,68,68,2803.46,5293.00,0.00
2024-12-10 17:20:51,137,4422,69,68,2783.00,5293.01,0.00
2024-12-10 17:20:51,136,4422,68,68,2796.08,5293.10,0.00
2024-12-10 17:20:51,136,4423,68,68,2787.62,5294.00,0.00
2024-12-10 17:20:51,137,4423,68,69,2767.28,5294.01,0.00
2024-12-10 17:20:51,136,4423,67,69,2779.92,5294.10,0.00
2024-12-10 17:20:51,136,4424,67,69,2771.46,5295.00,0.00
2024-12-10 17:20:51,137,4424,68,69,2751.23,5295.01,0.00
2024-12-10 17:20:51,136,4424,68,68,2763.54,5295.10,0.00
2024-12-10 17:20:51,136,4425,68,68,2755.07,5296.00,0.00
2024-12-10 17:20:51,137,4425,68,69,2734.96,5296.01,0.00
2024-12-10 17:20:51,136,4425,67,69,2752.33,5296.04,0.00
2024-12-10 17:20:51,135,4425,67,68,2769.60,5296.09,0.00
2024-12-10 17:20:51,135,4426,67,68,2761.06,5297.00,0.00
2024-12-10 17:20:51,136,4426,67,69,2740.76,5297.01,0.00
2024-12-10 17:20:51,135,4426,67,68,2756.39,5297.09,0.00
2024-12-10 17:20:51,136,4425,68,68,2717.89,5297.45,0.00
2024-12-10 17:20:51,136,4426,68,68,2751.02,5298.00,0.00
2024-12-10 17:20:51,137,4426,68,69,2730.94,5298.01,0.00
2024-12-10 17:20:51,137,4427,68,69,2756.21,5299.00,0.00
2024-12-10 17:20:51,138,4427,68,70,2736.23,5299.01,0.00
2024-12-10 17:20:51,137,4427,68,69,2751.59,5299.09,0.00
2024-12-10 17:20:51,137,4428,68,69,2742.41,5300.00,0.00
2024-12-10 17:20:51,138,4428,68,70,2722.54,5300.01,0.00
2024-12-10 17:20:51,137,4428,67,70,2737.42,5300.10,0.00
2024-12-10 17:20:51,138,4427,67,71,2690.19,5300.62,0.00
2024-12-10 17:20:51,139,4426,68,71,2684.22,5300.67,0.00
2024-12-10 17:20:51,139,4427,68,71,2718.43,5301.00,0.00
2024-12-10 17:20:51,140,4427,68,72,2699.01,5301.01,0.00
2024-12-10 17:20:51,139,4427,68,71,2717.29,5301.02,0.00
2024-12-10 17:20:51,138,4427,68,70,2733.16,5301.09,0.00
2024-12-10 17:20:51,137,4427,68,69,2752.73,5301.09,0.00
2024-12-10 17:20:51,138,4426,68,70,2696.21,5301.80,0.00
2024-12-10 17:20:51,138,4427,68,70,2808.95,5302.00,0.00
2024-12-10 17:20:51,139,4427,68,71,2788.74,5302.01,0.00
2024-12-10 17:20:51,138,4427,68,70,2804.37,5302.09,0.00
2024-12-10 17:20:51,139,4426,69,70,2767.48,5302.42,0.00
2024-12-10 17:20:51,139,4427,69,70,2831.62,5303.00,0.00
2024-12-10 17:20:51,140,4427,69,71,2811.39,5303.01,0.00
2024-12-10 17:20:51,139,4427,68,71,2827.07,5303.09,0.00
2024-12-10 17:20:51,138,4427,68,70,2847.17,5303.09,0.00
2024-12-10 17:20:51,139,4426,68,71,2805.44,5303.50,0.00
2024-12-10 17:20:51,139,4427,68,71,2875.27,5304.00,0.00
2024-12-10 17:20:51,140,4427,68,72,2854.73,5304.01,0.00
2024-12-10 17:20:51,141,4426,68,73,2804.22,5304.60,0.00
2024-12-10 17:20:51,141,4427,68,73,2873.77,5305.00,0.00
2024-12-10 17:20:51,142,4427,69,73,2853.53,5305.01,0.00
2024-12-10 17:20:51,141,4427,69,72,2868.91,5305.09,0.00
2024-12-10 17:20:51,141,4428,69,72,2896.19,5306.00,0.00
2024-12-10 17:20:51,142,4428,69,73,2875.79,5306.01,0.00
2024-12-10 17:20:51,142,4429,69,73,2858.73,5307.00,0.00
2024-12-10 17:20:51,143,4429,69,74,2838.74,5307.01,0.00
2024-12-10 17:20:51,144,4428,70,74,2815.73,5307.08,0.00
2024-12-10 17:20:51,143,4428,69,74,2858.71,5307.10,0.00
2024-12-10 17:20:52,143,4429,69,74,2844.08,5308.00,0.00
2024-12-10 17:20:52,144,4429,70,74,2824.33,5308.01,0.00
2024-12-10 17:20:52,143,4429,70,73,2839.29,5308.09,0.00
2024-12-10 17:20:52,142,4429,69,73,2841.74,5308.35,0.00
2024-12-10 17:20:52,142,4430,69,73,2882.57,5309.00,0.00
2024-12-10 17:20:52,143,4430,70,73,2862.42,5309.01,0.00
2024-12-10 17:20:52,142,4430,70,72,2877.75,5309.09,0.00
2024-12-10 17:20:52,142,4431,70,72,2867.41,5310.00,0.00
2024-12-10 17:20:52,143,4431,71,72,2847.36,5310.01,0.00
2024-12-10 17:20:52,142,4431,70,72,2862.58,5310.09,0.00
2024-12-10 17:20:52,143,4430,70,73,2807.58,5310.77,0.00
2024-12-10 17:20:52,143,4431,70,73,2841.21,5311.00,0.00
2024-12-10 17:20:52,144,4431,71,73,2821.48,5311.01,0.00
2024-12-10 17:20:52,143,4431,70,73,2836.41,5311.09,0.00
2024-12-10 17:20:52,144,4430,70,74,2813.40,5311.17,0.00
2024-12-10 17:20:52,145,4429,71,74,2825.14,5311.23,0.00
2024-12-10 17:20:52,145,4430,71,74,2889.37,5312.00,0.00
2024-12-10 17:20:52,146,4430,72,74,2869.58,5312.01,0.00
2024-12-10 17:20:52,145,4430,72,73,2884.05,5312.09,0.00
2024-12-10 17:20:52,144,4430,71,73,2903.70,5312.09,0.00
2024-12-10 17:20:52,144,4431,71,73,2966.57,5313.00,0.00
2024-12-10 17:20:52,145,4431,72,73,2946.11,5313.01,0.00
2024-12-10 17:20:52,144,4431,72,72,2963.11,5313.04,0.00
2024-12-10 17:20:52,143,4431,72,71,2980.88,5313.08,0.00
2024-12-10 17:20:52,143,4432,72,71,2969.89,5314.00,0.00
2024-12-10 17:20:52,144,4432,73,71,2949.27,5314.01,0.00
2024-12-10 17:20:52,144,4433,73,71,2930.87,5315.00,0.00
2024-12-10 17:20:52,145,4433,74,71,2910.65,5315.01,0.00
2024-12-10 17:20:52,144,4433,73,71,2930.28,5315.01,0.00
2024-12-10 17:20:52,145,4432,73,72,2907.88,5315.07,0.00
2024-12-10 17:20:52,144,4432,73,71,2929.19,5315.09,0.00
2024-12-10 17:20:52,144,4433,73,71,2918.25,5316.00,0.00
2024-12-10 17:20:52,145,4433,74,71,2898.12,5316.01,0.00
2024-12-10 17:20:52,144,4433,73,71,2914.22,5316.08,0.00
2024-12-10 17:20:52,143,4433,73,70,2934.22,5316.08,0.00
2024-12-10 17:20:52,142,4433,73,69,2954.51,5316.08,0.00
2024-12-10 17:20:52,142,4434,73,69,2980.88,5317.00,0.00
2024-12-10 17:20:52,143,4434,73,70,2960.03,5317.01,0.00
2024-12-10 17:20:52,142,4434,73,69,2976.79,5317.08,0.00
2024-12-10 17:20:52,142,4435,73,69,2965.71,5318.00,0.00
2024-12-10 17:20:52,143,4435,74,69,2944.97,5318.01,0.00
2024-12-10 17:20:52,142,4435,74,68,2961.62,5318.08,0.00
2024-12-10 17:20:52,142,4436,74,68,2950.53,5319.00,0.00
2024-12-10 17:20:52,143,4436,75,68,2929.90,5319.01,0.00
2024-12-10 17:20:52,142,4436,74,68,2946.07,5319.08,0.00
2024-12-10 17:20:52,142,4437,74,68,2935.35,5320.00,0.00
2024-12-10 17:20:52,143,4437,74,69,2914.83,5320.01,0.00
2024-12-10 17:20:52,142,4437,73,69,2930.89,5320.08,0.00
2024-12-10 17:20:52,142,4438,73,69,2920.17,5321.00,0.00
2024-12-10 17:20:52,143,4438,74,69,2899.75,5321.01,0.00
2024-12-10 17:20:52,142,4438,73,69,2919.05,5321.02,0.00
2024-12-10 17:20:52,141,4438,72,69,2936.38,5321.08,0.00
2024-12-10 17:20:52,142,4437,73,69,2888.91,5321.60,0.00
2024-12-10 17:20:52,142,4438,73,69,2912.47,5322.00,0.00
2024-12-10 17:20:52,143,4438,73,70,2892.10,5322.01,0.00
2024-12-10 17:20:52,142,4438,73,69,2908.00,5322.08,0.00
2024-12-10 17:20:52,143,4437,73,70,2875.07,5322.34,0.00
2024-12-10 17:20:52,143,4438,73,70,2930.24,5323.00,0.00
2024-12-10 17:20:52,144,4438,73,71,2909.89,5323.01,0.00
2024-12-10 17:20:52,143,4438,72,71,2929.13,5323.02,0.00
2024-12-10 17:20:52,142,4438,71,71,2946.41,5323.08,0.00
2024-12-10 17:20:52,142,4439,71,71,2971.26,5324.00,0.00
2024-12-10 17:20:52,143,4439,72,71,2950.48,5324.01,0.00
2024-12-10 17:20:52,142,4439,71,71,2967.17,5324.08,0.00
2024-12-10 17:20:52,143,4438,71,72,2900.25,5324.87,0.00
2024-12-10 17:20:52,143,4439,71,72,2935.75,5325.00,0.00
2024-12-10 17:20:52,144,4439,72,72,2915.36,5325.01,0.00
2024-12-10 17:20:52,143,4439,72,71,2931.31,5325.08,0.00
2024-12-10 17:20:52,143,4440,72,71,2951.88,5326.00,0.00
2024-12-10 17:20:52,144,4440,73,71,2931.38,5326.01,0.00
2024-12-10 17:20:52,143,4440,73,70,2947.18,5326.08,0.00
2024-12-10 17:20:52,143,4441,73,70,2928.22,5327.00,0.00
2024-12-10 17:20:52,144,4441,73,71,2907.89,5327.01,0.00
2024-12-10 17:20:52,143,4441,73,70,2924.42,5327.07,0.00
2024-12-10 17:20:52,144,4440,73,71,2887.92,5327.39,0.00
2024-12-10 17:20:52,145,4439,73,72,2858.80,5327.84,0.00
2024-12-10 17:20:52,145,4440,73,72,2893.11,5328.00,0.00
2024-12-10 17:20:52,146,4440,74,72,2873.30,5328.01,0.00
2024-12-10 17:20:52,145,4440,74,71,2889.10,5328.08,0.00
2024-12-10 17:20:52,144,4440,73,71,2908.80,5328.08,0.00
2024-12-10 17:20:52,143,4440,73,70,2889.45,5328.79,0.00
2024-12-10 17:20:52,143,4441,73,70,2989.52,5329.00,0.00
2024-12-10 17:20:52,144,4441,73,71,2968.76,5329.01,0.00
2024-12-10 17:20:52,143,4441,72,71,2985.45,5329.08,0.00
2024-12-10 17:20:52,142,4441,72,70,3006.10,5329.08,0.00
2024-12-10 17:20:52,143,4440,72,71,2960.65,5329.55,0.00
2024-12-10 17:20:52,143,4441,72,71,2990.36,5330.00,0.00
2024-12-10 17:20:53,144,4441,72,72,2969.59,5330.01,0.00
2024-12-10 17:20:53,143,4441,71,72,2986.29,5330.08,0.00
2024-12-10 17:20:53,143,4442,71,72,3011.94,5331.00,0.00
2024-12-10 17:20:53,144,4442,71,73,2991.02,5331.01,0.00
2024-12-10 17:20:53,143,4442,70,73,3007.87,5331.08,0.00
2024-12-10 17:20:53,143,4443,70,73,2996.47,5332.00,0.00
2024-12-10 17:20:53,144,4443,71,73,2975.66,5332.01,0.00
2024-12-10 17:20:53,143,4443,70,73,2992.40,5332.08,0.00
2024-12-10 17:20:53,143,4444,70,73,2980.99,5333.00,0.00
2024-12-10 17:20:53,144,4444,71,73,2960.29,5333.01,0.00
2024-12-10 17:20:53,143,4444,70,73,2979.51,5333.03,0.00
2024-12-10 17:20:53,142,4444,70,72,2997.89,5333.07,0.00
2024-12-10 17:20:53,142,4445,70,72,2986.40,5334.00,0.00
2024-12-10 17:20:53,143,4445,71,72,2965.52,5334.01,0.00
2024-12-10 17:20:53,142,4445,70,72,2982.67,5334.07,0.00
2024-12-10 17:20:53,141,4445,70,71,3003.45,5334.07,0.00
2024-12-10 17:20:53,141,4446,70,71,2992.24,5335.00,0.00
2024-12-10 17:20:53,142,4446,71,71,2971.17,5335.01,0.00
2024-12-10 17:20:53,141,4446,71,70,2988.48,5335.07,0.00
2024-12-10 17:20:53,141,4447,71,70,2976.24,5336.00,0.00
2024-12-10 17:20:53,142,4447,71,71,2955.29,5336.01,0.00
2024-12-10 17:20:53,141,4447,70,71,2972.49,5336.07,0.00
2024-12-10 17:20:53,141,4448,70,71,2959.26,5337.00,0.00
2024-12-10 17:20:53,142,4448,70,72,2938.42,5337.01,0.00
2024-12-10 17:20:53,142,4449,70,72,2920.93,5338.00,0.00
2024-12-10 17:20:53,143,4449,70,73,2900.50,5338.01,0.00
2024-12-10 17:20:53,142,4449,70,72,2916.82,5338.08,0.00
2024-12-10 17:20:53,143,4448,71,72,2849.72,5338.92,0.00
2024-12-10 17:20:53,143,4449,71,72,2886.75,5339.00,0.00
2024-12-10 17:20:53,144,4449,72,72,2866.71,5339.01,0.00
2024-12-10 17:20:53,144,4449,72,72,2885.31,5340.00,0.00
2024-12-10 17:20:53,145,4449,73,72,2865.42,5340.01,0.00
2024-12-10 17:20:53,144,4449,73,71,2880.90,5340.08,0.00
2024-12-10 17:20:53,144,4450,73,71,2865.28,5341.00,0.00
2024-12-10 17:20:53,145,4450,74,71,2845.52,5341.01,0.00
2024-12-10 17:20:53,144,4450,74,70,2860.87,5341.08,0.00
2024-12-10 17:20:53,145,4449,75,70,2823.55,5341.43,0.00
2024-12-10 17:20:53,145,4450,75,70,2832.16,5342.00,0.00
2024-12-10 17:20:53,146,4450,75,71,2812.76,5342.01,0.00
2024-12-10 17:20:53,145,4450,74,71,2827.77,5342.08,0.00
2024-12-10 17:20:53,145,4451,74,71,2847.73,5343.00,0.00
2024-12-10 17:20:53,146,4451,75,71,2828.23,5343.01,0.00
2024-12-10 17:20:53,146,4452,75,71,2806.69,5344.00,0.00
2024-12-10 17:20:53,147,4452,76,71,2787.59,5344.01,0.00
2024-12-10 17:20:53,146,4452,75,71,2801.96,5344.09,0.00
2024-12-10 17:20:53,145,4452,74,71,2790.35,5344.67,0.00
2024-12-10 17:20:53,145,4453,74,71,2807.95,5345.00,0.00
2024-12-10 17:20:53,146,4453,75,71,2788.71,5345.01,0.00
2024-12-10 17:20:53,145,4453,75,70,2803.19,5345.09,0.00
2024-12-10 17:20:53,145,4454,75,70,2790.88,5346.00,0.00
2024-12-10 17:20:53,146,4454,75,71,2771.76,5346.01,0.00
2024-12-10 17:20:53,145,4454,75,70,2789.41,5346.03,0.00
2024-12-10 17:20:53,144,4454,74,70,2805.46,5346.08,0.00
2024-12-10 17:20:53,145,4453,74,71,2746.31,5346.84,0.00
2024-12-10 17:20:53,145,4454,74,71,2780.54,5347.00,0.00
2024-12-10 17:20:53,146,4454,75,71,2761.49,5347.01,0.00
2024-12-10 17:20:53,145,4454,75,70,2775.78,5347.09,0.00
2024-12-10 17:20:53,146,4453,76,70,2733.83,5347.53,0.00
2024-12-10 17:20:53,146,4454,76,70,2798.57,5348.00,0.00
2024-12-10 17:20:53,147,4454,76,71,2779.53,5348.01,0.00
2024-12-10 17:20:53,146,4454,76,70,2793.84,5348.09,0.00
2024-12-10 17:20:53,147,4453,77,70,2746.66,5348.63,0.00
2024-12-10 17:20:53,147,4454,77,70,2811.90,5349.00,0.00
2024-12-10 17:20:53,148,4454,77,71,2792.91,5349.01,0.00
2024-12-10 17:20:53,149,4453,78,71,2773.44,5349.03,0.00
2024-12-10 17:20:53,148,4453,78,70,2816.07,5349.10,0.00
2024-12-10 17:20:53,148,4454,78,70,2836.00,5350.00,0.00
2024-12-10 17:20:53,149,4454,79,70,2816.97,5350.01,0.00
2024-12-10 17:20:53,148,4454,78,70,2831.33,5350.09,0.00
2024-12-10 17:20:53,148,4455,78,70,2849.52,5351.00,0.00
2024-12-10 17:20:53,149,4455,78,71,2830.40,5351.01,0.00
2024-12-10 17:20:53,148,4455,77,71,2849.16,5351.01,0.00
2024-12-10 17:20:53,147,4455,77,70,2868.18,5351.01,0.00
2024-12-10 17:20:53,148,4454,77,71,2839.82,5351.19,0.00
2024-12-10 17:20:53,148,4455,77,71,2842.56,5352.00,0.00
2024-12-10 17:20:53,149,4455,77,72,2823.48,5352.01,0.00
2024-12-10 17:20:53,148,4455,76,72,2837.54,5352.10,0.00
2024-12-10 17:20:53,149,4454,76,73,2787.12,5352.70,0.00
2024-12-10 17:20:53,148,4454,76,72,2807.19,5352.80,0.00
2024-12-10 17:20:53,148,4455,76,72,2868.85,5353.00,0.00
2024-12-10 17:20:53,149,4455,77,72,2849.60,5353.01,0.00
2024-12-10 17:20:53,148,4455,77,71,2863.83,5353.10,0.00
2024-12-10 17:20:53,147,4455,77,70,2882.95,5353.10,0.00
2024-12-10 17:20:53,148,4454,78,70,2844.04,5353.47,0.00
2024-12-10 17:20:53,148,4455,78,70,2888.44,5354.00,0.00
2024-12-10 17:20:53,149,4455,79,70,2869.06,5354.01,0.00
2024-12-10 17:20:53,148,4455,79,69,2883.42,5354.10,0.00
2024-12-10 17:20:53,148,4456,79,69,2901.01,5355.00,0.00
2024-12-10 17:20:53,149,4456,79,70,2881.54,5355.01,0.00
2024-12-10 17:20:53,148,4456,79,69,2895.98,5355.10,0.00
2024-12-10 17:20:53,147,4456,78,69,2882.73,5355.55,0.00
2024-12-10 17:20:53,147,4457,78,69,2893.05,5356.00,0.00
2024-12-10 17:20:54,148,4457,79,69,2873.51,5356.01,0.00
2024-12-10 17:20:54,149,4456,79,70,2804.81,5356.87,0.00
2024-12-10 17:20:54,149,4457,79,70,2838.37,5357.00,0.00
2024-12-10 17:20:54,150,4457,79,71,2819.45,5357.01,0.00
2024-12-10 17:20:54,149,4457,78,71,2833.02,5357.10,0.00
2024-12-10 17:20:54,149,4458,78,71,2846.90,5358.00,0.00
2024-12-10 17:20:54,150,4458,79,71,2827.92,5358.01,0.00
2024-12-10 17:20:54,149,4458,78,71,2841.54,5358.10,0.00
2024-12-10 17:20:54,150,4457,78,72,2822.24,5358.12,0.00
2024-12-10 17:20:54,151,4456,79,72,2834.09,5358.21,0.00
2024-12-10 17:20:54,151,4457,79,72,2839.77,5359.00,0.00
2024-12-10 17:20:54,152,4457,80,72,2821.08,5359.01,0.00
2024-12-10 17:20:54,151,4457,79,72,2802.33,5359.54,0.00
2024-12-10 17:20:54,150,4457,78,72,2809.47,5359.59,0.00
2024-12-10 17:20:54,150,4458,78,72,2888.96,5360.00,0.00
2024-12-10 17:20:54,151,4458,79,72,2869.83,5360.01,0.00
2024-12-10 17:20:54,152,4457,79,73,2823.27,5360.54,0.00
2024-12-10 17:20:54,152,4458,79,73,2842.13,5361.00,0.00
2024-12-10 17:20:54,153,4458,79,74,2823.55,5361.01,0.00
2024-12-10 17:20:54,152,4458,79,73,2836.17,5361.11,0.00
2024-12-10 17:20:54,151,4458,79,72,2812.77,5361.76,0.00
2024-12-10 17:20:54,151,4459,79,72,2867.87,5362.00,0.00
2024-12-10 17:20:54,152,4459,79,73,2849.00,5362.01,0.00
2024-12-10 17:20:54,153,4458,80,73,2825.86,5362.10,0.00
2024-12-10 17:20:54,153,4459,80,73,2827.34,5363.00,0.00
2024-12-10 17:20:54,154,4459,80,74,2808.99,5363.01,0.00
2024-12-10 17:20:54,155,4458,81,74,2765.07,5363.50,0.00
2024-12-10 17:20:54,154,4458,81,73,2793.92,5363.59,0.00
2024-12-10 17:20:54,154,4459,81,73,2834.56,5364.00,0.00
2024-12-10 17:20:54,155,4459,81,74,2816.27,5364.01,0.00
2024-12-10 17:20:54,155,4460,81,74,2822.32,5365.00,0.00
2024-12-10 17:20:54,156,4460,81,75,2804.23,5365.01,0.00
2024-12-10 17:20:54,155,4460,81,74,2815.11,5365.14,0.00
2024-12-10 17:20:54,154,4460,81,73,2832.68,5365.15,0.00
2024-12-10 17:20:54,153,4460,81,72,2811.28,5365.73,0.00
2024-12-10 17:20:54,153,4461,81,72,2832.20,5366.00,0.00
2024-12-10 17:20:54,154,4461,81,73,2813.81,5366.01,0.00
2024-12-10 17:20:54,153,4461,81,72,2830.81,5366.03,0.00
2024-12-10 17:20:54,154,4460,81,73,2808.97,5366.10,0.00
2024-12-10 17:20:54,153,4460,81,72,2848.04,5366.14,0.00
2024-12-10 17:20:54,152,4460,81,71,2866.43,5366.14,0.00
2024-12-10 17:20:54,151,4460,80,71,2860.29,5366.57,0.00
2024-12-10 17:20:54,151,4461,80,71,2872.24,5367.00,0.00
2024-12-10 17:20:54,152,4461,81,71,2853.34,5367.01,0.00
2024-12-10 17:20:54,151,4461,80,71,2869.06,5367.06,0.00
2024-12-10 17:20:54,150,4461,79,71,2884.29,5367.13,0.00
2024-12-10 17:20:54,149,4461,78,71,2903.29,5367.13,0.00
2024-12-10 17:20:54,149,4462,78,71,2924.98,5368.00,0.00
2024-12-10 17:20:54,150,4462,79,71,2905.48,5368.01,0.00
2024-12-10 17:20:54,149,4462,78,71,2897.70,5368.34,0.00
2024-12-10 17:20:54,149,4463,78,71,2887.26,5369.00,0.00
2024-12-10 17:20:54,150,4463,78,72,2868.01,5369.01,0.00
2024-12-10 17:20:54,149,4463,77,72,2880.11,5369.13,0.00
2024-12-10 17:20:54,148,4463,76,72,2895.95,5369.17,0.00
2024-12-10 17:20:54,149,4462,76,73,2861.45,5369.46,0.00
2024-12-10 17:20:54,148,4462,76,72,2863.34,5369.55,0.00
2024-12-10 17:20:54,148,4463,76,72,2875.57,5370.00,0.00
2024-12-10 17:20:54,149,4463,76,73,2856.28,5370.01,0.00
2024-12-10 17:20:54,148,4463,75,73,2868.38,5370.14,0.00
2024-12-10 17:20:54,147,4463,74,73,2869.66,5370.32,0.00
2024-12-10 17:20:54,146,4463,73,73,2879.49,5370.47,0.00
2024-12-10 17:20:54,146,4464,73,73,2917.41,5371.00,0.00
2024-12-10 17:20:54,147,4464,74,73,2897.57,5371.01,0.00
2024-12-10 17:20:54,146,4464,73,73,2910.12,5371.14,0.00
2024-12-10 17:20:54,145,4464,72,73,2910.69,5371.48,0.00
2024-12-10 17:20:54,145,4465,72,73,2920.33,5372.00,0.00
2024-12-10 17:20:54,146,4465,72,74,2900.33,5372.01,0.00
2024-12-10 17:20:54,145,4465,71,74,2912.99,5372.14,0.00
2024-12-10 17:20:54,144,4465,71,73,2932.84,5372.14,0.00
2024-12-10 17:20:54,144,4466,71,73,2924.37,5373.00,0.00
2024-12-10 17:20:54,145,4466,72,73,2904.20,5373.01,0.00
2024-12-10 17:20:54,144,4466,72,72,2921.03,5373.06,0.00
2024-12-10 17:20:54,143,4466,71,72,2937.37,5373.13,0.00
2024-12-10 17:20:54,143,4467,71,72,2928.83,5374.00,0.00
2024-12-10 17:20:54,144,4467,71,73,2908.49,5374.01,0.00
2024-12-10 17:20:54,143,4467,71,72,2921.75,5374.13,0.00
2024-12-10 17:20:54,143,4468,71,72,2913.22,5375.00,0.00
2024-12-10 17:20:54,144,4468,71,73,2892.99,5375.01,0.00
2024-12-10 17:20:54,143,4468,71,72,2906.13,5375.13,0.00
2024-12-10 17:20:54,143,4469,71,72,2897.59,5376.00,0.00
2024-12-10 17:20:54,144,4469,71,73,2877.47,5376.01,0.00
2024-12-10 17:20:54,143,4469,71,72,2888.61,5376.10,0.00
2024-12-10 17:20:54,142,4469,71,71,2907.08,5376.13,0.00
2024-12-10 17:20:54,142,4470,71,71,2898.47,5377.00,0.00
2024-12-10 17:20:54,143,4470,72,71,2878.20,5377.01,0.00
2024-12-10 17:20:54,142,4470,72,70,2891.71,5377.13,0.00
2024-12-10 17:20:54,143,4469,72,71,2854.28,5377.46,0.00
2024-12-10 17:20:54,143,4470,72,71,2885.88,5378.00,0.00
2024-12-10 17:20:54,144,4470,73,71,2865.84,5378.01,0.00
2024-12-10 17:20:54,143,4470,72,71,2879.17,5378.13,0.00
2024-12-10 17:20:54,143,4471,72,71,2907.44,5379.00,0.00
2024-12-10 17:20:54,144,4471,73,71,2887.25,5379.01,0.00
2024-12-10 17:20:54,143,4471,72,71,2900.72,5379.13,0.00
2024-12-10 17:20:54,143,4472,72,71,2891.18,5380.00,0.00
2024-12-10 17:20:54,144,4472,72,72,2871.10,5380.01,0.00
2024-12-10 17:20:54,143,4472,72,71,2884.09,5380.13,0.00
2024-12-10 17:20:54,143,4473,72,71,2874.65,5381.00,0.00
2024-12-10 17:20:54,144,4473,72,72,2854.69,5381.01,0.00
2024-12-10 17:20:54,143,4473,71,72,2867.55,5381.13,0.00
2024-12-10 17:20:55,143,4474,71,72,2858.03,5382.00,0.00
2024-12-10 17:20:55,144,4474,71,73,2838.18,5382.01,0.00
2024-12-10 17:20:55,143,4474,71,72,2850.93,5382.13,0.00
2024-12-10 17:20:55,143,4475,71,72,2842.09,5383.00,0.00
2024-12-10 17:20:55,144,4475,72,72,2822.35,5383.01,0.00
2024-12-10 17:20:55,143,4475,72,71,2840.97,5383.02,0.00
2024-12-10 17:20:55,142,4475,71,71,2854.95,5383.13,0.00
2024-12-10 17:20:55,142,4476,71,71,2846.33,5384.00,0.00
2024-12-10 17:20:55,143,4476,72,71,2826.43,5384.01,0.00
2024-12-10 17:20:55,142,4476,71,71,2839.18,5384.13,0.00
2024-12-10 17:20:55,143,4475,71,72,2796.42,5384.56,0.00
2024-12-10 17:20:55,143,4476,71,72,2828.01,5385.00,0.00
2024-12-10 17:20:55,144,4476,71,73,2808.37,5385.01,0.00
2024-12-10 17:20:55,143,4476,70,73,2820.91,5385.13,0.00
2024-12-10 17:20:55,143,4477,70,73,2843.00,5386.00,0.00
2024-12-10 17:20:55,144,4477,71,73,2823.25,5386.01,0.00
2024-12-10 17:20:55,143,4477,71,72,2835.89,5386.13,0.00
2024-12-10 17:20:55,143,4478,71,72,2812.12,5387.00,0.00
2024-12-10 17:20:55,144,4478,71,73,2792.60,5387.01,0.00
2024-12-10 17:20:55,143,4478,71,72,2804.64,5387.14,0.00
2024-12-10 17:20:55,142,4478,71,71,2792.57,5387.47,0.00
2024-12-10 17:20:55,142,4479,71,71,2802.06,5388.00,0.00
2024-12-10 17:20:55,143,4479,71,72,2782.46,5388.01,0.00
2024-12-10 17:20:55,142,4479,71,71,2799.41,5388.05,0.00
2024-12-10 17:20:55,141,4479,70,71,2814.34,5388.14,0.00
2024-12-10 17:20:55,140,4479,69,71,2834.05,5388.14,0.00
2024-12-10 17:20:55,139,4479,68,71,2835.90,5388.30,0.00
2024-12-10 17:20:55,139,4480,68,71,2837.51,5389.00,0.00
2024-12-10 17:20:55,140,4480,68,72,2817.24,5389.01,0.00
2024-12-10 17:20:55,139,4480,67,72,2830.20,5389.14,0.00
2024-12-10 17:20:55,140,4479,68,72,2769.17,5389.91,0.00
2024-12-10 17:20:55,140,4480,68,72,2807.37,5390.00,0.00
2024-12-10 17:20:55,141,4480,69,72,2787.46,5390.01,0.00
2024-12-10 17:20:55,140,4480,68,72,2800.10,5390.14,0.00
2024-12-10 17:20:55,141,4479,68,73,2757.07,5390.58,0.00
2024-12-10 17:20:55,141,4480,68,73,2827.36,5391.00,0.00
2024-12-10 17:20:55,142,4480,68,74,2807.45,5391.01,0.00
2024-12-10 17:20:55,143,4479,68,75,2782.20,5391.13,0.00
2024-12-10 17:20:55,142,4479,67,75,2819.27,5391.14,0.00
2024-12-10 17:20:55,141,4479,66,75,2838.88,5391.14,0.00
2024-12-10 17:20:55,142,4478,66,76,2818.89,5391.16,0.00
2024-12-10 17:20:55,142,4479,66,76,2886.19,5392.00,0.00
2024-12-10 17:20:55,143,4479,66,77,2866.01,5392.01,0.00
2024-12-10 17:20:55,144,4478,67,77,2843.87,5392.06,0.00
2024-12-10 17:20:55,144,4479,67,77,2939.14,5393.00,0.00
2024-12-10 17:20:55,145,4479,67,78,2918.87,5393.01,0.00
2024-12-10 17:20:55,146,4478,68,78,2859.31,5393.76,0.00
2024-12-10 17:20:55,146,4479,68,78,2930.08,5394.00,0.00
2024-12-10 17:20:55,147,4479,69,78,2910.14,5394.01,0.00
2024-12-10 17:20:55,147,4480,69,78,2928.40,5395.00,0.00
2024-12-10 17:20:55,148,4480,69,79,2908.62,5395.01,0.00
2024-12-10 17:20:55,147,4480,68,79,2920.01,5395.14,0.00
2024-12-10 17:20:55,147,4481,68,79,2903.20,5396.00,0.00
2024-12-10 17:20:55,148,4481,68,80,2883.58,5396.01,0.00
2024-12-10 17:20:55,147,4481,68,79,2893.71,5396.14,0.00
2024-12-10 17:20:55,146,4481,67,79,2903.52,5396.25,0.00
2024-12-10 17:20:55,146,4482,67,79,2889.76,5397.00,0.00
2024-12-10 17:20:55,147,4482,68,79,2870.10,5397.01,0.00
2024-12-10 17:20:55,148,4481,69,79,2849.62,5397.04,0.00
2024-12-10 17:20:55,147,4481,68,79,2899.86,5397.04,0.00
2024-12-10 17:20:55,146,4481,67,79,2913.68,5397.12,0.00
2024-12-10 17:20:55,145,4481,66,79,2932.67,5397.14,0.00
2024-12-10 17:20:55,144,4481,65,79,2945.02,5397.26,0.00
2024-12-10 17:20:55,143,4481,64,79,2955.01,5397.43,0.00
2024-12-10 17:20:55,143,4482,64,79,2962.22,5398.00,0.00
2024-12-10 17:20:55,144,4482,65,79,2941.65,5398.01,0.00
2024-12-10 17:20:55,143,4482,65,78,2955.11,5398.13,0.00
2024-12-10 17:20:55,143,4483,65,78,2982.54,5399.00,0.00
2024-12-10 17:20:55,144,4483,65,79,2961.82,5399.01,0.00
2024-12-10 17:20:55,143,4483,65,78,2975.42,5399.13,0.00
2024-12-10 17:20:55,143,4484,65,78,2962.85,5400.00,0.00
2024-12-10 17:20:55,144,4484,65,79,2942.27,5400.01,0.00
2024-12-10 17:20:55,143,4484,65,78,2957.98,5400.09,0.00
2024-12-10 17:20:55,142,4484,65,77,2976.55,5400.13,0.00
2024-12-10 17:20:55,141,4484,65,76,2997.28,5400.13,0.00
2024-12-10 17:20:55,140,4484,64,76,3018.30,5400.13,0.00
2024-12-10 17:20:55,139,4484,63,76,3018.71,5400.39,0.00
2024-12-10 17:20:55,139,4485,63,76,3024.65,5401.00,0.00
2024-12-10 17:20:55,140,4485,64,76,3003.05,5401.01,0.00
2024-12-10 17:20:55,139,4485,64,75,3017.72,5401.13,0.00
2024-12-10 17:20:55,138,4485,64,74,3039.20,5401.13,0.00
2024-12-10 17:20:55,138,4486,64,74,3029.65,5402.00,0.00
2024-12-10 17:20:55,139,4486,65,74,3007.86,5402.01,0.00
2024-12-10 17:20:55,138,4486,65,73,3027.71,5402.04,0.00
2024-12-10 17:20:55,137,4486,65,72,3044.73,5402.12,0.00
2024-12-10 17:20:55,136,4486,64,72,3066.72,5402.13,0.00
2024-12-10 17:20:55,137,4485,65,72,3021.80,5402.56,0.00
2024-12-10 17:20:55,137,4486,65,72,3051.76,5403.00,0.00
2024-12-10 17:20:55,138,4486,66,72,3029.65,5403.01,0.00
2024-12-10 17:20:55,139,4485,67,72,3005.16,5403.07,0.00
2024-12-10 17:20:55,138,4485,67,71,3037.54,5403.13,0.00
2024-12-10 17:20:55,137,4485,67,70,3059.32,5403.13,0.00
2024-12-10 17:20:55,138,4484,67,71,3021.20,5403.44,0.00
2024-12-10 17:20:55,139,4483,67,72,3017.76,5403.50,0.00
2024-12-10 17:20:55,139,4484,67,72,3083.25,5404.00,0.00
2024-12-10 17:20:55,140,4484,67,73,3061.22,5404.01,0.00
2024-12-10 17:20:55,139,4484,67,72,3076.31,5404.13,0.00
2024-12-10 17:20:55,139,4485,67,72,3177.22,5405.00,0.00
2024-12-10 17:20:55,140,4485,67,73,3154.53,5405.01,0.00
2024-12-10 17:20:55,139,4485,67,72,3143.87,5405.56,0.00
2024-12-10 17:20:55,139,4486,67,72,3156.41,5406.00,0.00
2024-12-10 17:20:55,140,4486,68,72,3133.86,5406.01,0.00
2024-12-10 17:20:56,140,4487,68,72,3114.83,5407.00,0.00
2024-12-10 17:20:56,141,4487,68,73,3092.74,5407.01,0.00
2024-12-10 17:20:56,142,4486,69,73,3059.86,5407.20,0.00
2024-12-10 17:20:56,142,4487,69,73,3081.53,5408.00,0.00
2024-12-10 17:20:56,143,4487,69,74,3059.98,5408.01,0.00
2024-12-10 17:20:56,144,4486,69,75,3016.72,5408.34,0.00
2024-12-10 17:20:56,144,4487,69,75,3075.69,5409.00,0.00
2024-12-10 17:20:56,145,4487,70,75,3054.48,5409.01,0.00
2024-12-10 17:20:56,144,4487,70,74,3062.30,5409.13,0.00
2024-12-10 17:20:56,144,4488,70,74,3081.15,5410.00,0.00
2024-12-10 17:20:56,145,4488,70,75,3059.90,5410.01,0.00
2024-12-10 17:20:56,144,4488,69,75,3079.78,5410.02,0.00
2024-12-10 17:20:56,143,4488,69,74,3087.40,5410.23,0.00
2024-12-10 17:20:56,143,4489,69,74,3082.12,5411.00,0.00
2024-12-10 17:20:56,144,4489,69,75,3060.71,5411.01,0.00
2024-12-10 17:20:56,143,4489,69,74,3075.36,5411.13,0.00
2024-12-10 17:20:56,142,4489,68,74,3096.64,5411.13,0.00
2024-12-10 17:20:56,143,4488,69,74,3042.73,5411.74,0.00
2024-12-10 17:20:56,143,4489,69,74,3075.70,5412.00,0.00
2024-12-10 17:20:56,144,4489,70,74,3054.34,5412.01,0.00
2024-12-10 17:20:56,144,4490,70,74,3076.33,5413.00,0.00
2024-12-10 17:20:56,145,4490,70,75,3055.11,5413.01,0.00
2024-12-10 17:20:56,145,4491,70,75,3037.03,5414.00,0.00
2024-12-10 17:20:56,146,4491,71,75,3016.22,5414.01,0.00
2024-12-10 17:20:56,145,4491,70,75,3030.36,5414.12,0.00
2024-12-10 17:20:56,145,4492,70,75,3012.89,5415.00,0.00
2024-12-10 17:20:56,146,4492,70,76,2992.25,5415.01,0.00
2024-12-10 17:20:56,145,4492,70,75,3012.14,5415.01,0.00
2024-12-10 17:20:56,144,4492,70,74,3027.09,5415.12,0.00
2024-12-10 17:20:56,144,4493,70,74,3003.97,5416.00,0.00
2024-12-10 17:20:56,145,4493,70,75,2983.25,5416.01,0.00
2024-12-10 17:20:56,146,4492,70,76,2944.67,5416.36,0.00
2024-12-10 17:20:56,145,4492,70,75,2976.63,5416.44,0.00
2024-12-10 17:20:56,145,4493,70,75,2984.12,5417.00,0.00
2024-12-10 17:20:56,146,4493,70,76,2963.68,5417.01,0.00
2024-12-10 17:20:56,146,4494,70,76,2982.96,5418.00,0.00
2024-12-10 17:20:56,147,4494,70,77,2962.67,5418.01,0.00
2024-12-10 17:20:56,148,4493,71,77,2933.93,5418.18,0.00
2024-12-10 17:20:56,147,4493,70,77,2980.96,5418.24,0.00
2024-12-10 17:20:56,147,4494,70,77,2976.84,5419.00,0.00
2024-12-10 17:20:56,148,4494,71,77,2956.72,5419.01,0.00
2024-12-10 17:20:56,148,4495,71,77,2976.31,5420.00,0.00
2024-12-10 17:20:56,149,4495,72,77,2956.33,5420.01,0.00
2024-12-10 17:20:56,149,4496,72,77,2939.21,5421.00,0.00
2024-12-10 17:20:56,150,4496,73,77,2919.62,5421.01,0.00
2024-12-10 17:20:56,149,4496,72,77,2932.35,5421.13,0.00
2024-12-10 17:20:56,149,4497,72,77,2921.90,5422.00,0.00
2024-12-10 17:20:56,150,4497,73,77,2902.42,5422.01,0.00
2024-12-10 17:20:56,149,4497,73,76,2920.45,5422.03,0.00
2024-12-10 17:20:56,148,4497,73,75,2934.37,5422.13,0.00
2024-12-10 17:20:56,147,4497,73,74,2953.96,5422.13,0.00
2024-12-10 17:20:56,147,4498,73,74,2944.12,5423.00,0.00
2024-12-10 17:20:56,148,4498,73,75,2924.23,5423.01,0.00
2024-12-10 17:20:56,147,4498,73,74,2937.17,5423.13,0.00
2024-12-10 17:20:56,148,4497,74,74,2903.47,5423.40,0.00
2024-12-10 17:20:56,148,4498,74,74,2931.73,5424.00,0.00
2024-12-10 17:20:56,149,4498,75,74,2912.05,5424.01,0.00
2024-12-10 17:20:56,148,4498,74,74,2924.82,5424.13,0.00
2024-12-10 17:20:56,147,4498,73,74,2943.94,5424.14,0.00
2024-12-10 17:20:56,147,4499,73,74,2971.73,5425.00,0.00
2024-12-10 17:20:56,148,4499,74,74,2951.65,5425.01,0.00
2024-12-10 17:20:56,147,4499,73,74,2964.41,5425.14,0.00
2024-12-10 17:20:56,148,4498,73,75,2924.64,5425.47,0.00
2024-12-10 17:20:56,148,4499,73,75,2957.14,5426.00,0.00
2024-12-10 17:20:56,149,4499,73,76,2937.30,5426.01,0.00
2024-12-10 17:20:56,150,4498,74,76,2909.45,5426.17,0.00
2024-12-10 17:20:56,151,4497,75,76,2918.59,5426.25,0.00
2024-12-10 17:20:56,151,4498,75,76,2976.78,5427.00,0.00
2024-12-10 17:20:56,152,4498,76,76,2957.20,5427.01,0.00
2024-12-10 17:20:56,151,4498,76,75,2973.93,5427.05,0.00
2024-12-10 17:20:56,150,4498,76,74,2989.45,5427.13,0.00
2024-12-10 17:20:56,151,4497,76,75,2941.94,5427.52,0.00
2024-12-10 17:20:56,151,4498,76,75,3039.18,5428.00,0.00
2024-12-10 17:20:56,152,4498,77,75,3019.19,5428.01,0.00
2024-12-10 17:20:56,151,4498,76,75,3032.41,5428.13,0.00
2024-12-10 17:20:56,152,4497,77,75,2970.01,5428.78,0.00
2024-12-10 17:20:56,152,4498,77,75,3036.11,5429.00,0.00
2024-12-10 17:20:56,153,4498,77,76,3016.26,5429.01,0.00
2024-12-10 17:20:56,152,4498,76,76,3032.56,5429.07,0.00
2024-12-10 17:20:56,151,4498,76,75,3049.43,5429.12,0.00
2024-12-10 17:20:56,151,4499,76,75,3063.33,5430.00,0.00
2024-12-10 17:20:56,152,4499,76,76,3043.17,5430.01,0.00
2024-12-10 17:20:56,151,4499,76,75,3056.90,5430.12,0.00
2024-12-10 17:20:56,151,4500,76,75,3034.31,5431.00,0.00
2024-12-10 17:20:56,152,4500,77,75,3014.34,5431.01,0.00
2024-12-10 17:20:56,153,4499,77,76,2930.99,5431.99,0.00
2024-12-10 17:20:56,153,4500,77,76,2966.51,5432.00,0.00
2024-12-10 17:20:56,154,4500,78,76,2947.25,5432.01,0.00
2024-12-10 17:20:56,153,4500,78,75,2960.12,5432.12,0.00
2024-12-10 17:20:56,152,4500,77,75,2979.24,5432.12,0.00
2024-12-10 17:20:56,153,4499,78,75,2954.47,5432.23,0.00
2024-12-10 17:20:56,153,4500,78,75,2981.70,5433.00,0.00
2024-12-10 17:20:56,154,4500,79,75,2962.34,5433.01,0.00
2024-12-10 17:20:57,154,4501,79,75,2970.42,5434.00,0.00
2024-12-10 17:20:57,155,4501,80,75,2951.25,5434.01,0.00
2024-12-10 17:20:57,156,4500,81,75,2928.53,5434.09,0.00
2024-12-10 17:20:57,155,4500,80,75,2969.88,5434.12,0.00
2024-12-10 17:20:57,155,4501,80,75,2947.24,5435.00,0.00
2024-12-10 17:20:57,156,4501,81,75,2928.35,5435.01,0.00
2024-12-10 17:20:57,155,4501,80,75,2940.98,5435.12,0.00
2024-12-10 17:20:57,154,4501,80,74,2955.87,5435.14,0.00
2024-12-10 17:20:57,153,4501,80,73,2962.25,5435.37,0.00
2024-12-10 17:20:57,152,4501,79,73,2962.41,5435.69,0.00
2024-12-10 17:20:57,152,4502,79,73,3017.38,5436.00,0.00
2024-12-10 17:20:57,153,4502,80,73,2997.66,5436.01,0.00
2024-12-10 17:20:57,154,4501,80,74,2978.19,5436.02,0.00
2024-12-10 17:20:57,154,4502,80,74,2991.10,5437.00,0.00
2024-12-10 17:20:57,155,4502,81,74,2971.80,5437.01,0.00
2024-12-10 17:20:57,156,4501,81,75,2942.72,5437.21,0.00
2024-12-10 17:20:57,156,4502,81,75,2971.07,5438.00,0.00
2024-12-10 17:20:57,157,4502,81,76,2952.15,5438.01,0.00
2024-12-10 17:20:57,157,4503,81,76,2967.34,5439.00,0.00
2024-12-10 17:20:57,158,4503,81,77,2948.56,5439.01,0.00
2024-12-10 17:20:57,159,4502,81,78,2923.57,5439.14,0.00
2024-12-10 17:20:57,159,4503,81,78,2918.44,5440.00,0.00
2024-12-10 17:20:57,160,4503,81,79,2900.20,5440.01,0.00
2024-12-10 17:20:57,159,4503,80,79,2911.99,5440.12,0.00
2024-12-10 17:20:57,158,4503,80,78,2927.50,5440.15,0.00
2024-12-10 17:20:57,158,4504,80,78,2948.85,5441.00,0.00
2024-12-10 17:20:57,159,4504,81,78,2930.30,5441.01,0.00
2024-12-10 17:20:57,158,4504,80,78,2942.02,5441.13,0.00
2024-12-10 17:20:57,159,4503,81,78,2918.75,5441.23,0.00
2024-12-10 17:20:57,159,4504,81,78,2923.60,5442.00,0.00
2024-12-10 17:20:57,160,4504,81,79,2905.32,5442.01,0.00
2024-12-10 17:20:57,160,4505,81,79,2918.09,5443.00,0.00
2024-12-10 17:20:57,161,4505,82,79,2899.96,5443.01,0.00
2024-12-10 17:20:57,160,4505,81,79,2911.34,5443.13,0.00
2024-12-10 17:20:57,159,4505,80,79,2922.63,5443.21,0.00
2024-12-10 17:20:57,160,4504,80,80,2903.01,5443.25,0.00
2024-12-10 17:20:57,159,4504,79,80,2907.45,5443.62,0.00
2024-12-10 17:20:57,159,4505,79,80,2921.45,5444.00,0.00
2024-12-10 17:20:57,160,4505,80,80,2903.19,5444.01,0.00
2024-12-10 17:20:57,161,4504,81,80,2885.16,5444.02,0.00
2024-12-10 17:20:57,160,4504,80,80,2899.16,5444.13,0.00
2024-12-10 17:20:57,160,4505,80,80,2920.40,5445.00,0.00
2024-12-10 17:20:57,161,4505,81,80,2902.26,5445.01,0.00
2024-12-10 17:20:57,161,4506,81,80,2916.32,5446.00,0.00
2024-12-10 17:20:57,162,4506,81,81,2898.32,5446.01,0.00
2024-12-10 17:20:57,161,4506,81,80,2909.27,5446.13,0.00
2024-12-10 17:20:57,161,4507,81,80,2896.22,5447.00,0.00
2024-12-10 17:20:57,162,4507,81,81,2878.34,5447.01,0.00
2024-12-10 17:20:57,161,4507,80,81,2888.65,5447.14,0.00
2024-12-10 17:20:57,161,4508,80,81,2875.84,5448.00,0.00
2024-12-10 17:20:57,162,4508,80,82,2858.08,5448.01,0.00
2024-12-10 17:20:57,162,4509,80,82,2836.89,5449.00,0.00
2024-12-10 17:20:57,163,4509,80,83,2819.49,5449.01,0.00
2024-12-10 17:20:57,162,4509,80,82,2828.74,5449.15,0.00
2024-12-10 17:20:57,161,4509,79,82,2845.97,5449.15,0.00
2024-12-10 17:20:57,161,4510,79,82,2832.28,5450.00,0.00
2024-12-10 17:20:57,162,4510,80,82,2814.79,5450.01,0.00
2024-12-10 17:20:57,161,4510,79,82,2824.21,5450.15,0.00
2024-12-10 17:20:57,161,4511,79,82,2809.77,5451.00,0.00
2024-12-10 17:20:57,162,4511,80,82,2792.43,5451.01,0.00
2024-12-10 17:20:57,161,4511,79,82,2807.41,5451.04,0.00
2024-12-10 17:20:57,160,4511,79,81,2819.21,5451.14,0.00
2024-12-10 17:20:57,159,4511,79,80,2836.60,5451.15,0.00
2024-12-10 17:20:57,159,4512,79,80,2821.41,5452.00,0.00
2024-12-10 17:20:57,160,4512,80,80,2803.78,5452.01,0.00
2024-12-10 17:20:57,159,4512,79,80,2816.64,5452.09,0.00
2024-12-10 17:20:57,158,4512,79,79,2831.39,5452.14,0.00
2024-12-10 17:20:57,158,4513,79,79,2815.51,5453.00,0.00
2024-12-10 17:20:57,159,4513,79,80,2797.80,5453.01,0.00
2024-12-10 17:20:57,158,4513,79,79,2812.08,5453.06,0.00
2024-12-10 17:20:57,157,4513,78,79,2825.52,5453.14,0.00
2024-12-10 17:20:57,158,4512,79,79,2802.13,5453.25,0.00
2024-12-10 17:20:57,158,4513,79,79,2801.47,5454.00,0.00
2024-12-10 17:20:57,159,4513,79,80,2783.85,5454.01,0.00
2024-12-10 17:20:57,158,4513,78,80,2794.13,5454.14,0.00
2024-12-10 17:20:57,158,4514,78,80,2812.41,5455.00,0.00
2024-12-10 17:20:57,159,4514,79,80,2794.72,5455.01,0.00
2024-12-10 17:20:57,158,4514,79,79,2804.88,5455.14,0.00
2024-12-10 17:20:57,158,4515,79,79,2788.53,5456.00,0.00
2024-12-10 17:20:57,159,4515,80,79,2770.99,5456.01,0.00
2024-12-10 17:20:57,158,4515,79,79,2780.99,5456.14,0.00
2024-12-10 17:20:57,158,4516,79,79,2764.44,5457.00,0.00
2024-12-10 17:20:57,159,4516,79,80,2747.06,5457.01,0.00
2024-12-10 17:20:57,158,4516,79,79,2728.27,5457.65,0.00
2024-12-10 17:20:58,158,4517,79,79,2739.81,5458.00,0.00
2024-12-10 17:20:58,159,4517,80,79,2722.58,5458.01,0.00
2024-12-10 17:20:58,158,4517,79,79,2737.75,5458.04,0.00
2024-12-10 17:20:58,157,4517,79,78,2754.84,5458.04,0.00
2024-12-10 17:20:58,156,4517,78,78,2766.95,5458.14,0.00
2024-12-10 17:20:58,155,4517,78,77,2784.45,5458.14,0.00
2024-12-10 17:20:58,154,4517,77,77,2802.18,5458.14,0.00
2024-12-10 17:20:58,154,4518,77,77,2782.80,5459.00,0.00
2024-12-10 17:20:58,155,4518,77,78,2764.84,5459.01,0.00
2024-12-10 17:20:58,154,4518,76,78,2775.34,5459.14,0.00
2024-12-10 17:20:58,154,4519,76,78,2754.76,5460.00,0.00
2024-12-10 17:20:58,155,4519,77,78,2736.99,5460.01,0.00
2024-12-10 17:20:58,154,4519,76,78,2747.22,5460.14,0.00
2024-12-10 17:20:58,154,4520,76,78,2726.12,5461.00,0.00
2024-12-10 17:20:58,155,4520,76,79,2708.53,5461.01,0.00
2024-12-10 17:20:58,154,4520,76,78,2718.46,5461.14,0.00
2024-12-10 17:20:58,154,4521,76,78,2696.85,5462.00,0.00
2024-12-10 17:20:58,155,4521,77,78,2679.45,5462.01,0.00
2024-12-10 17:20:58,154,4521,77,77,2695.44,5462.03,0.00
2024-12-10 17:20:58,153,4521,77,76,2704.88,5462.13,0.00
2024-12-10 17:20:58,152,4521,76,76,2722.31,5462.13,0.00
2024-12-10 17:20:58,151,4521,75,76,2725.12,5462.40,0.00
2024-12-10 17:20:58,151,4522,75,76,2719.86,5463.00,0.00
2024-12-10 17:20:58,152,4522,76,76,2701.97,5463.01,0.00
2024-12-10 17:20:58,151,4522,76,75,2716.92,5463.05,0.00
2024-12-10 17:20:58,150,4522,76,74,2730.06,5463.13,0.00
2024-12-10 17:20:58,149,4522,75,74,2748.01,5463.13,0.00
2024-12-10 17:20:58,150,4521,75,75,2720.62,5463.31,0.00
2024-12-10 17:20:58,150,4522,75,75,2725.33,5464.00,0.00
2024-12-10 17:20:58,151,4522,75,76,2707.28,5464.01,0.00
2024-12-10 17:20:58,150,4522,75,75,2717.66,5464.13,0.00
2024-12-10 17:20:58,150,4523,75,75,2695.40,5465.00,0.00
2024-12-10 17:20:58,151,4523,75,76,2677.55,5465.01,0.00
2024-12-10 17:20:58,150,4523,75,75,2687.56,5465.13,0.00
2024-12-10 17:20:58,149,4523,75,74,2639.08,5465.87,0.00
2024-12-10 17:20:58,149,4524,75,74,2564.64,5466.00,0.00
2024-12-10 17:20:58,150,4524,76,74,2547.54,5466.01,0.00
2024-12-10 17:20:58,149,4524,75,74,2475.45,5466.90,0.00
2024-12-10 17:20:58,148,4524,75,73,2476.04,5466.92,0.00
2024-12-10 17:20:58,147,4524,74,73,2484.64,5466.93,0.00
2024-12-10 17:20:58,146,4524,74,72,2489.27,5466.94,0.00
2024-12-10 17:20:58,145,4524,73,72,2496.08,5466.96,0.00
2024-12-10 17:20:58,144,4524,73,71,2499.53,5466.97,0.00
2024-12-10 17:20:58,144,4525,73,71,2514.42,5467.00,0.00
2024-12-10 17:20:58,145,4525,73,72,2497.08,5467.01,0.00
2024-12-10 17:20:58,144,4525,72,72,2505.72,5467.14,0.00
2024-12-10 17:20:58,143,4525,71,72,2418.72,5467.97,0.00
2024-12-10 17:20:58,143,4526,71,72,2455.08,5468.00,0.00
2024-12-10 17:20:58,144,4526,71,73,2438.03,5468.01,0.00
2024-12-10 17:20:58,143,4526,70,73,2446.07,5468.14,0.00
2024-12-10 17:20:58,144,4525,71,73,2421.51,5468.29,0.00
2024-12-10 17:20:58,145,4524,72,73,2399.57,5468.43,0.00
2024-12-10 17:20:58,144,4524,71,73,2408.75,5468.73,0.00
2024-12-10 17:20:58,143,4524,70,73,2396.88,5468.92,0.00
2024-12-10 17:20:58,143,4525,70,73,2430.61,5469.00,0.00
2024-12-10 17:20:58,144,4525,71,73,2413.73,5469.01,0.00
2024-12-10 17:20:58,145,4524,72,73,2391.84,5469.12,0.00
2024-12-10 17:20:58,144,4524,72,72,2429.71,5469.15,0.00
2024-12-10 17:20:58,143,4524,72,71,2446.32,5469.15,0.00
2024-12-10 17:20:58,142,4524,71,71,2437.42,5469.59,0.00
2024-12-10 17:20:58,141,4524,70,71,2431.91,5469.86,0.00
2024-12-10 17:20:58,141,4525,70,71,2538.62,5470.00,0.00
2024-12-10 17:20:58,142,4525,71,71,2520.75,5470.01,0.00
2024-12-10 17:20:58,141,4525,71,70,2529.17,5470.14,0.00
2024-12-10 17:20:58,142,4524,71,71,2494.48,5470.47,0.00
2024-12-10 17:20:58,141,4524,71,70,2526.84,5470.61,0.00
2024-12-10 17:20:58,141,4525,71,70,2566.70,5471.00,0.00
2024-12-10 17:20:58,142,4525,71,71,2548.63,5471.01,0.00
2024-12-10 17:20:58,141,4525,70,71,2557.14,5471.14,0.00
2024-12-10 17:20:58,140,4525,69,71,2519.07,5471.74,0.00
2024-12-10 17:20:58,140,4526,69,71,2579.75,5472.00,0.00
2024-12-10 17:20:58,141,4526,69,72,2561.45,5472.01,0.00
2024-12-10 17:20:58,142,4525,70,72,2540.35,5472.08,0.00
2024-12-10 17:20:58,141,4525,70,71,2577.09,5472.15,0.00
2024-12-10 17:20:58,141,4526,70,71,2558.95,5473.00,0.00
2024-12-10 17:20:58,142,4526,71,71,2540.92,5473.01,0.00
2024-12-10 17:20:58,141,4526,70,71,2549.13,5473.14,0.00
2024-12-10 17:20:58,140,4526,70,70,2531.88,5473.66,0.00
2024-12-10 17:20:58,141,4525,71,70,2509.17,5473.75,0.00
2024-12-10 17:20:58,141,4526,71,70,2583.40,5474.00,0.00
2024-12-10 17:20:58,142,4526,72,70,2565.20,5474.01,0.00
2024-12-10 17:20:58,141,4526,72,69,2573.30,5474.14,0.00
2024-12-10 17:20:58,140,4526,72,68,2565.68,5474.61,0.00
2024-12-10 17:20:58,140,4527,72,68,2614.37,5475.00,0.00
2024-12-10 17:20:58,141,4527,73,68,2595.83,5475.01,0.00
2024-12-10 17:20:58,140,4527,73,67,2604.02,5475.14,0.00
2024-12-10 17:20:58,139,4527,72,67,2595.35,5475.62,0.00
2024-12-10 17:20:58,139,4528,72,67,2603.28,5476.00,0.00
2024-12-10 17:20:58,140,4528,73,67,2584.68,5476.01,0.00
2024-12-10 17:20:58,139,4528,72,67,2562.57,5476.67,0.00
2024-12-10 17:20:58,139,4529,72,67,2578.49,5477.00,0.00
2024-12-10 17:20:58,140,4529,73,67,2560.07,5477.01,0.00
2024-12-10 17:20:58,139,4529,72,67,2575.35,5477.06,0.00
2024-12-10 17:20:58,138,4529,72,66,2589.99,5477.12,0.00
2024-12-10 17:20:58,137,4529,71,66,2607.31,5477.14,0.00
2024-12-10 17:20:58,137,4530,71,66,2592.13,5478.00,0.00
2024-12-10 17:20:58,138,4530,72,66,2573.35,5478.01,0.00
2024-12-10 17:20:58,137,4530,71,66,2584.20,5478.15,0.00
2024-12-10 17:20:58,137,4531,71,66,2565.12,5479.00,0.00
2024-12-10 17:20:58,138,4531,71,67,2546.53,5479.01,0.00
2024-12-10 17:20:58,137,4531,70,67,2557.18,5479.15,0.00
2024-12-10 17:20:58,136,4531,69,67,2543.13,5479.61,0.00
2024-12-10 17:20:58,135,4531,68,67,2555.14,5479.72,0.00
2024-12-10 17:20:58,135,4532,68,67,2579.22,5480.00,0.00
2024-12-10 17:20:58,136,4532,69,67,2560.25,5480.01,0.00
2024-12-10 17:20:58,135,4532,69,66,2571.16,5480.15,0.00
2024-12-10 17:20:58,135,4533,69,66,2560.11,5481.00,0.00
2024-12-10 17:20:58,136,4533,70,66,2541.28,5481.01,0.00
2024-12-10 17:20:58,135,4533,70,65,2552.04,5481.15,0.00
2024-12-10 17:20:58,136,4532,71,65,2517.18,5481.45,0.00
2024-12-10 17:20:59,136,4533,71,65,2540.36,5482.00,0.00
2024-12-10 17:20:59,137,4533,72,65,2521.81,5482.01,0.00
2024-12-10 17:20:59,136,4533,72,64,2532.35,5482.15,0.00
2024-12-10 17:20:59,135,4533,72,63,2520.30,5482.67,0.00
2024-12-10 17:20:59,134,4533,71,63,2533.50,5482.73,0.00
2024-12-10 17:20:59,134,4534,71,63,2599.54,5483.00,0.00
2024-12-10 17:20:59,135,4534,72,63,2580.28,5483.01,0.00
2024-12-10 17:20:59,134,4534,71,63,2591.41,5483.15,0.00
2024-12-10 17:20:59,134,4535,71,63,2584.15,5484.00,0.00
2024-12-10 17:20:59,135,4535,72,63,2565.01,5484.01,0.00
2024-12-10 17:20:59,134,4535,72,62,2580.03,5484.08,0.00
2024-12-10 17:20:59,133,4535,71,62,2595.33,5484.14,0.00
2024-12-10 17:20:59,132,4535,71,61,2614.58,5484.14,0.00
2024-12-10 17:20:59,132,4536,71,61,2606.31,5485.00,0.00
2024-12-10 17:20:59,133,4536,71,62,2586.71,5485.01,0.00
2024-12-10 17:20:59,134,4535,71,63,2564.20,5485.08,0.00
2024-12-10 17:20:59,133,4535,71,62,2583.93,5485.15,0.00
2024-12-10 17:20:59,134,4534,71,63,2542.14,5485.57,0.00
2024-12-10 17:20:59,135,4533,71,64,2533.50,5485.74,0.00
2024-12-10 17:20:59,135,4534,71,64,2573.55,5486.00,0.00
2024-12-10 17:20:59,136,4534,72,64,2554.63,5486.01,0.00
2024-12-10 17:20:59,137,4533,72,65,2495.36,5486.70,0.00
2024-12-10 17:20:59,137,4534,72,65,2658.91,5487.00,0.00
2024-12-10 17:20:59,138,4534,72,66,2639.64,5487.01,0.00
2024-12-10 17:20:59,137,4534,72,65,2649.93,5487.15,0.00
2024-12-10 17:20:59,137,4535,72,65,2674.19,5488.00,0.00
2024-12-10 17:20:59,138,4535,72,66,2654.81,5488.01,0.00
2024-12-10 17:20:59,139,4534,72,67,2635.32,5488.03,0.00
2024-12-10 17:20:59,138,4534,72,66,2684.03,5488.15,0.00
2024-12-10 17:20:59,137,4534,71,66,2691.10,5488.37,0.00
2024-12-10 17:20:59,137,4535,71,66,2684.97,5489.00,0.00
2024-12-10 17:20:59,138,4535,72,66,2665.51,5489.01,0.00
2024-12-10 17:20:59,137,4535,71,66,2678.60,5489.09,0.00
2024-12-10 17:20:59,136,4535,71,65,2695.89,5489.13,0.00
2024-12-10 17:20:59,135,4535,71,64,2715.06,5489.13,0.00
2024-12-10 17:20:59,134,4535,70,64,2734.91,5489.13,0.00
2024-12-10 17:20:59,135,4534,71,64,2699.20,5489.42,0.00
2024-12-10 17:20:59,134,4534,70,64,2754.36,5489.43,0.00
2024-12-10 17:20:59,134,4535,70,64,2784.47,5490.00,0.00
2024-12-10 17:20:59,135,4535,70,65,2763.85,5490.01,0.00
2024-12-10 17:20:59,134,4535,69,65,2774.94,5490.13,0.00
2024-12-10 17:20:59,133,4535,69,64,2795.39,5490.14,0.00
2024-12-10 17:20:59,132,4535,68,64,2812.02,5490.21,0.00
2024-12-10 17:20:59,131,4535,68,63,2805.47,5490.63,0.00
2024-12-10 17:20:59,131,4536,68,63,2864.13,5491.00,0.00
2024-12-10 17:20:59,132,4536,69,63,2842.43,5491.01,0.00
2024-12-10 17:20:59,131,4536,68,63,2859.60,5491.04,0.00
2024-12-10 17:20:59,130,4536,68,62,2881.17,5491.04,0.00
2024-12-10 17:20:59,129,4536,68,61,2898.44,5491.12,0.00
2024-12-10 17:20:59,128,4536,68,60,2920.66,5491.13,0.00
2024-12-10 17:20:59,127,4536,68,59,2943.22,5491.13,0.00
2024-12-10 17:20:59,127,4537,68,59,2932.75,5492.00,0.00
2024-12-10 17:20:59,128,4537,68,60,2909.84,5492.01,0.00
2024-12-10 17:20:59,127,4537,67,60,2928.99,5492.02,0.00
2024-12-10 17:20:59,126,4537,67,59,2946.62,5492.12,0.00
2024-12-10 17:20:59,125,4537,66,59,2969.75,5492.12,0.00
2024-12-10 17:20:59,125,4538,66,59,2961.07,5493.00,0.00
2024-12-10 17:20:59,126,4538,67,59,2937.57,5493.01,0.00
2024-12-10 17:20:59,125,4538,67,58,2952.41,5493.12,0.00
2024-12-10 17:20:59,125,4539,67,58,2941.34,5494.00,0.00
2024-12-10 17:20:59,126,4539,68,58,2917.99,5494.01,0.00
2024-12-10 17:20:59,125,4539,67,58,2938.67,5494.02,0.00
2024-12-10 17:20:59,124,4539,66,58,2957.10,5494.11,0.00
2024-12-10 17:20:59,125,4538,67,58,2918.12,5494.41,0.00
2024-12-10 17:20:59,124,4538,66,58,2969.01,5494.56,0.00
2024-12-10 17:20:59,124,4539,66,58,2981.73,5495.00,0.00
2024-12-10 17:20:59,125,4539,66,59,2957.87,5495.01,0.00
2024-12-10 17:20:59,124,4539,66,58,2974.25,5495.11,0.00
2024-12-10 17:20:59,125,4538,66,59,2936.53,5495.36,0.00
2024-12-10 17:20:59,125,4539,66,59,3010.61,5496.00,0.00
2024-12-10 17:20:59,126,4539,66,60,2986.71,5496.01,0.00
2024-12-10 17:20:59,127,4538,66,61,2963.19,5496.02,0.00
2024-12-10 17:20:59,126,4538,66,60,3002.20,5496.12,0.00
2024-12-10 17:20:59,125,4538,65,60,3025.69,5496.13,0.00
2024-12-10 17:20:59,124,4538,65,59,3018.05,5496.55,0.00
2024-12-10 17:20:59,124,4539,65,59,3081.85,5497.00,0.00
2024-12-10 17:20:59,125,4539,66,59,3057.19,5497.01,0.00
2024-12-10 17:20:59,124,4539,65,59,3074.58,5497.11,0.00
2024-12-10 17:20:59,124,4540,65,59,3113.82,5498.00,0.00
2024-12-10 17:20:59,125,4540,65,60,3088.91,5498.01,0.00
2024-12-10 17:20:59,126,4539,66,60,3040.30,5498.44,0.00
2024-12-10 17:20:59,126,4540,66,60,3079.82,5499.00,0.00
2024-12-10 17:20:59,127,4540,66,61,3055.57,5499.01,0.00
2024-12-10 17:20:59,127,4541,66,61,3084.52,5500.00,0.00
2024-12-10 17:20:59,128,4541,67,61,3060.43,5500.01,0.00
2024-12-10 17:20:59,127,4541,67,60,3075.92,5500.12,0.00
2024-12-10 17:20:59,127,4542,67,60,3068.73,5501.00,0.00
2024-12-10 17:20:59,128,4542,68,60,3044.75,5501.01,0.00
2024-12-10 17:20:59,129,4541,69,60,3021.15,5501.02,0.00
2024-12-10 17:20:59,128,4541,68,60,3037.45,5501.13,0.00
2024-12-10 17:20:59,127,4541,67,60,3059.98,5501.13,0.00
2024-12-10 17:20:59,128,4540,67,61,3016.07,5501.50,0.00
2024-12-10 17:20:59,128,4541,67,61,3060.01,5502.00,0.00
2024-12-10 17:20:59,129,4541,68,61,3036.29,5502.01,0.00
2024-12-10 17:20:59,128,4541,67,61,3049.54,5502.12,0.00
2024-12-10 17:20:59,127,4541,66,61,3061.88,5502.29,0.00
2024-12-10 17:20:59,127,4542,66,61,3146.20,5503.00,0.00
2024-12-10 17:20:59,128,4542,67,61,3121.62,5503.01,0.00
2024-12-10 17:20:59,127,4542,67,60,3134.55,5503.12,0.00
2024-12-10 17:20:59,128,4541,68,60,3099.78,5503.32,0.00
2024-12-10 17:20:59,129,4540,69,60,3050.49,5503.81,0.00
2024-12-10 17:20:59,129,4541,69,60,3101.15,5504.00,0.00
2024-12-10 17:20:59,130,4541,69,61,3077.29,5504.01,0.00
2024-12-10 17:20:59,129,4541,68,61,3098.52,5504.02,0.00
2024-12-10 17:20:59,128,4541,68,60,3116.75,5504.12,0.00
2024-12-10 17:20:59,128,4542,68,60,3190.02,5505.00,0.00
2024-12-10 17:20:59,129,4542,69,60,3165.29,5505.01,0.00
2024-12-10 17:20:59,129,4543,69,60,3142.87,5506.00,0.00
2024-12-10 17:20:59,130,4543,70,60,3118.70,5506.01,0.00
2024-12-10 17:20:59,129,4543,69,60,3136.10,5506.12,0.00
2024-12-10 17:20:59,129,4544,69,60,3117.93,5507.00,0.00
2024-12-10 17:20:59,130,4544,70,60,3093.95,5507.01,0.00
2024-12-10 17:21:00,129,4544,70,59,3111.15,5507.12,0.00
2024-12-10 17:21:00,128,4544,69,59,3135.03,5507.13,0.00
2024-12-10 17:21:00,128,4545,69,59,3117.74,5508.00,0.00
2024-12-10 17:21:00,129,4545,70,59,3093.57,5508.01,0.00
2024-12-10 17:21:00,128,4545,70,58,3110.90,5508.13,0.00
2024-12-10 17:21:00,127,4545,70,57,3134.96,5508.13,0.00
2024-12-10 17:21:00,127,4546,70,57,3118.42,5509.00,0.00
2024-12-10 17:21:00,128,4546,71,57,3094.06,5509.01,0.00
2024-12-10 17:21:00,127,4546,71,56,3057.34,5509.93,0.00
2024-12-10 17:21:00,127,4547,71,56,3096.89,5510.00,0.00
2024-12-10 17:21:00,128,4547,72,56,3072.69,5510.01,0.00
2024-12-10 17:21:00,128,4548,72,56,3057.48,5511.00,0.00
2024-12-10 17:21:00,129,4548,72,57,3033.78,5511.01,0.00
2024-12-10 17:21:00,128,4548,72,56,3050.22,5511.13,0.00
2024-12-10 17:21:00,127,4548,71,56,3073.80,5511.13,0.00
2024-12-10 17:21:00,128,4547,71,57,3022.00,5511.59,0.00
2024-12-10 17:21:00,128,4548,71,57,3056.61,5512.00,0.00
2024-12-10 17:21:00,129,4548,72,57,3032.92,5512.01,0.00
2024-12-10 17:21:00,128,4548,71,57,3049.34,5512.13,0.00
2024-12-10 17:21:00,127,4548,71,56,3059.60,5512.37,0.00
2024-12-10 17:21:00,127,4549,71,56,3107.42,5513.00,0.00
2024-12-10 17:21:00,128,4549,71,57,3083.14,5513.01,0.00
2024-12-10 17:21:00,127,4549,71,56,3100.09,5513.13,0.00
2024-12-10 17:21:00,126,4549,70,56,3108.79,5513.42,0.00
2024-12-10 17:21:00,126,4550,70,56,3119.53,5514.00,0.00
2024-12-10 17:21:00,127,4550,71,56,3094.97,5514.01,0.00
2024-12-10 17:21:00,126,4550,70,56,3112.09,5514.14,0.00
2024-12-10 17:21:00,126,4551,70,56,3108.67,5515.00,0.00
2024-12-10 17:21:00,127,4551,71,56,3084.19,5515.01,0.00
2024-12-10 17:21:00,126,4551,71,55,3101.14,5515.14,0.00
2024-12-10 17:21:00,125,4551,70,55,3123.19,5515.18,0.00
2024-12-10 17:21:00,125,4552,70,55,3122.81,5516.00,0.00
2024-12-10 17:21:00,126,4552,70,56,3098.02,5516.01,0.00
2024-12-10 17:21:00,125,4552,70,55,3115.20,5516.14,0.00
2024-12-10 17:21:00,124,4552,70,54,3139.88,5516.14,0.00
2024-12-10 17:21:00,124,4553,70,54,3137.03,5517.00,0.00
2024-12-10 17:21:00,125,4553,71,54,3111.94,5517.01,0.00
2024-12-10 17:21:00,125,4554,71,54,3101.00,5518.00,0.00
2024-12-10 17:21:00,126,4554,71,55,3076.39,5518.01,0.00
2024-12-10 17:21:00,125,4554,71,54,3099.24,5518.03,0.00
2024-12-10 17:21:00,124,4554,70,54,3118.00,5518.14,0.00
2024-12-10 17:21:00,124,4555,70,54,3114.07,5519.00,0.00
2024-12-10 17:21:00,125,4555,70,55,3089.15,5519.01,0.00
2024-12-10 17:21:00,125,4556,70,55,3077.40,5520.00,0.00
2024-12-10 17:21:00,126,4556,70,56,3052.98,5520.01,0.00
2024-12-10 17:21:00,126,4557,70,56,3040.26,5521.00,0.00
2024-12-10 17:21:00,127,4557,70,57,3016.32,5521.01,0.00
2024-12-10 17:21:00,126,4557,69,57,3032.86,5521.14,0.00
2024-12-10 17:21:00,125,4557,69,56,3024.35,5521.67,0.00
2024-12-10 17:21:00,125,4558,69,56,3050.68,5522.00,0.00
2024-12-10 17:21:00,126,4558,70,56,3026.47,5522.01,0.00
2024-12-10 17:21:00,126,4559,70,56,3008.94,5523.00,0.00
2024-12-10 17:21:00,127,4559,70,57,2985.25,5523.01,0.00
2024-12-10 17:21:00,128,4558,71,57,2957.21,5523.11,0.00
2024-12-10 17:21:00,128,4559,71,57,2955.93,5524.00,0.00
2024-12-10 17:21:00,129,4559,71,58,2933.01,5524.01,0.00
2024-12-10 17:21:00,128,4559,70,58,2907.42,5524.83,0.00
2024-12-10 17:21:00,128,4560,70,58,2984.39,5525.00,0.00
2024-12-10 17:21:00,129,4560,70,59,2961.26,5525.01,0.00
2024-12-10 17:21:00,128,4560,69,59,2976.67,5525.14,0.00
2024-12-10 17:21:00,127,4560,69,58,2999.68,5525.14,0.00
2024-12-10 17:21:00,127,4561,69,58,2996.25,5526.00,0.00
2024-12-10 17:21:00,128,4561,69,59,2972.84,5526.01,0.00
2024-12-10 17:21:00,127,4561,68,59,2994.09,5526.04,0.00
2024-12-10 17:21:00,126,4561,67,59,3011.75,5526.14,0.00
2024-12-10 17:21:00,126,4562,67,59,3008.73,5527.00,0.00
2024-12-10 17:21:00,127,4562,67,60,2985.04,5527.01,0.00
2024-12-10 17:21:00,126,4562,67,59,3004.80,5527.07,0.00
2024-12-10 17:21:00,127,4561,68,59,2937.59,5527.88,0.00
2024-12-10 17:21:00,127,4562,68,59,2980.79,5528.00,0.00
2024-12-10 17:21:00,128,4562,68,60,2957.51,5528.01,0.00
2024-12-10 17:21:00,129,4561,69,60,2933.73,5528.04,0.00
2024-12-10 17:21:00,128,4561,69,59,2971.36,5528.09,0.00
2024-12-10 17:21:00,127,4561,68,59,2991.74,5528.14,0.00
2024-12-10 17:21:00,127,4562,68,59,3031.84,5529.00,0.00
2024-12-10 17:21:00,128,4562,69,59,3008.15,5529.01,0.00
2024-12-10 17:21:00,128,4563,69,59,3040.23,5530.00,0.00
2024-12-10 17:21:00,129,4563,70,59,3016.66,5530.01,0.00
2024-12-10 17:21:00,128,4563,70,58,3032.94,5530.13,0.00
2024-12-10 17:21:00,128,4564,70,58,3028.68,5531.00,0.00
2024-12-10 17:21:00,129,4564,71,58,3005.20,5531.01,0.00
2024-12-10 17:21:00,128,4564,71,57,3021.39,5531.13,0.00
2024-12-10 17:21:00,129,4563,71,58,2968.18,5531.69,0.00
2024-12-10 17:21:00,129,4564,71,58,3008.15,5532.00,0.00
2024-12-10 17:21:00,130,4564,72,58,2985.01,5532.01,0.00
2024-12-10 17:21:00,129,4564,71,58,3000.91,5532.13,0.00
2024-12-10 17:21:00,128,4564,70,58,3023.92,5532.13,0.00
2024-12-10 17:21:00,128,4565,70,58,3062.78,5533.00,0.00
2024-12-10 17:21:00,129,4565,70,59,3039.04,5533.01,0.00
2024-12-10 17:21:00,130,4564,70,60,2997.88,5533.35,0.00
2024-12-10 17:21:00,130,4565,70,60,3031.86,5534.00,0.00
2024-12-10 17:21:00,131,4565,70,61,3008.71,5534.01,0.00
2024-12-10 17:21:00,130,4565,70,60,3031.01,5534.02,0.00
2024-12-10 17:21:00,129,4565,69,60,3048.12,5534.12,0.00
2024-12-10 17:21:01,129,4566,69,60,3085.95,5535.00,0.00
2024-12-10 17:21:01,130,4566,69,61,3062.21,5535.01,0.00
2024-12-10 17:21:01,130,4567,69,61,3050.41,5536.00,0.00
2024-12-10 17:21:01,131,4567,69,62,3027.13,5536.01,0.00
2024-12-10 17:21:01,130,4567,68,62,3043.23,5536.13,0.00
2024-12-10 17:21:01,129,4567,68,61,3066.39,5536.13,0.00
2024-12-10 17:21:01,129,4568,68,61,3055.23,5537.00,0.00
2024-12-10 17:21:01,130,4568,69,61,3031.72,5537.01,0.00
2024-12-10 17:21:01,129,4568,68,61,3053.09,5537.04,0.00
2024-12-10 17:21:01,128,4568,67,61,3071.79,5537.13,0.00
2024-12-10 17:21:01,127,4568,67,60,3095.55,5537.13,0.00
2024-12-10 17:21:01,126,4568,67,59,3085.59,5537.48,0.00
2024-12-10 17:21:01,126,4569,67,59,3101.36,5538.00,0.00
2024-12-10 17:21:01,127,4569,67,60,3076.94,5538.01,0.00
2024-12-10 17:21:01,128,4568,68,60,3027.97,5538.48,0.00
2024-12-10 17:21:01,128,4569,68,60,3065.05,5539.00,0.00
2024-12-10 17:21:01,129,4569,68,61,3041.29,5539.01,0.00
2024-12-10 17:21:01,128,4569,67,61,3063.76,5539.02,0.00
2024-12-10 17:21:01,127,4569,67,60,3081.82,5539.13,0.00
2024-12-10 17:21:01,127,4570,67,60,3121.01,5540.00,0.00
2024-12-10 17:21:01,128,4570,68,60,3096.63,5540.01,0.00
2024-12-10 17:21:01,127,4570,68,59,3114.09,5540.13,0.00
2024-12-10 17:21:01,128,4569,69,59,3060.98,5540.66,0.00
2024-12-10 17:21:01,128,4570,69,59,3101.36,5541.00,0.00
2024-12-10 17:21:01,129,4570,70,59,3077.32,5541.01,0.00
2024-12-10 17:21:01,128,4570,69,59,3094.49,5541.13,0.00
2024-12-10 17:21:01,129,4569,70,59,3048.31,5541.54,0.00
2024-12-10 17:21:01,129,4570,70,59,3127.40,5542.00,0.00
2024-12-10 17:21:01,130,4570,71,59,3103.35,5542.01,0.00
2024-12-10 17:21:01,130,4571,71,59,3130.05,5543.00,0.00
2024-12-10 17:21:01,131,4571,72,59,3106.16,5543.01,0.00
2024-12-10 17:21:01,130,4571,72,58,3128.36,5543.03,0.00
2024-12-10 17:21:01,130,4572,72,58,3109.50,5544.00,0.00
2024-12-10 17:21:01,131,4572,72,59,3085.77,5544.01,0.00
2024-12-10 17:21:01,130,4572,71,59,3102.73,5544.12,0.00
2024-12-10 17:21:01,130,4573,71,59,3078.89,5545.00,0.00
2024-12-10 17:21:01,131,4573,72,59,3055.38,5545.01,0.00
2024-12-10 17:21:01,132,4572,72,60,2961.10,5545.89,0.00
2024-12-10 17:21:01,132,4573,72,60,2998.40,5546.00,0.00
2024-12-10 17:21:01,133,4573,72,61,2975.85,5546.01,0.00
2024-12-10 17:21:01,132,4573,71,61,2990.56,5546.14,0.00
2024-12-10 17:21:01,131,4573,70,61,2975.43,5546.68,0.00
2024-12-10 17:21:01,131,4574,70,61,3002.19,5547.00,0.00
2024-12-10 17:21:01,132,4574,71,61,2979.45,5547.01,0.00
2024-12-10 17:21:01,133,4573,71,62,2952.08,5547.11,0.00
2024-12-10 17:21:01,134,4572,72,62,2926.89,5547.55,0.00
2024-12-10 17:21:01,133,4572,72,61,2923.02,5547.80,0.00
2024-12-10 17:21:01,133,4573,72,61,2934.03,5548.00,0.00
2024-12-10 17:21:01,134,4573,72,62,2912.13,5548.01,0.00
2024-12-10 17:21:01,133,4573,72,61,2867.82,5548.84,0.00
2024-12-10 17:21:01,133,4574,72,61,2979.72,5549.00,0.00
2024-12-10 17:21:01,134,4574,73,61,2957.48,5549.01,0.00
2024-12-10 17:21:01,133,4574,73,60,2973.09,5549.12,0.00
2024-12-10 17:21:01,134,4573,73,61,2929.91,5549.52,0.00
2024-12-10 17:21:01,134,4574,73,61,2942.17,5550.00,0.00
2024-12-10 17:21:01,135,4574,73,62,2920.38,5550.01,0.00
2024-12-10 17:21:01,135,4575,73,62,2919.55,5551.00,0.00
2024-12-10 17:21:01,136,4575,73,63,2898.08,5551.01,0.00
2024-12-10 17:21:01,135,4575,72,63,2890.81,5551.51,0.00
2024-12-10 17:21:01,134,4575,71,63,2899.61,5551.68,0.00
2024-12-10 17:21:01,134,4576,71,63,2915.09,5552.00,0.00
2024-12-10 17:21:01,135,4576,71,64,2893.50,5552.01,0.00
2024-12-10 17:21:01,136,4575,72,64,2828.85,5552.74,0.00
2024-12-10 17:21:01,136,4576,72,64,2862.85,5553.00,0.00
2024-12-10 17:21:01,137,4576,72,65,2841.95,5553.01,0.00
2024-12-10 17:21:01,136,4576,72,64,2861.23,5553.03,0.00
2024-12-10 17:21:01,135,4576,72,63,2877.11,5553.12,0.00
2024-12-10 17:21:01,134,4576,72,62,2864.74,5553.69,0.00
2024-12-10 17:21:01,134,4577,72,62,2927.75,5554.00,0.00
2024-12-10 17:21:01,135,4577,72,63,2906.06,5554.01,0.00
2024-12-10 17:21:01,135,4578,72,63,2875.79,5555.00,0.00
2024-12-10 17:21:01,136,4578,73,63,2854.65,5555.01,0.00
2024-12-10 17:21:01,135,4578,72,63,2869.25,5555.12,0.00
2024-12-10 17:21:01,135,4579,72,63,2826.86,5556.00,0.00
2024-12-10 17:21:01,136,4579,73,63,2806.08,5556.01,0.00
2024-12-10 17:21:01,136,4580,73,63,2734.69,5557.00,0.00
2024-12-10 17:21:01,137,4580,73,64,2714.73,5557.01,0.00
2024-12-10 17:21:01,136,4580,72,64,2702.94,5557.56,0.00
2024-12-10 17:21:01,135,4580,72,63,2708.95,5557.62,0.00
2024-12-10 17:21:01,135,4581,72,63,2689.40,5558.00,0.00
2024-12-10 17:21:01,136,4581,72,64,2669.62,5558.01,0.00
2024-12-10 17:21:01,135,4581,72,63,2651.00,5558.60,0.00
2024-12-10 17:21:01,134,4581,72,62,2655.37,5558.69,0.00
2024-12-10 17:21:01,133,4581,72,61,2673.98,5558.71,0.00
2024-12-10 17:21:01,133,4582,72,61,2681.72,5559.00,0.00
2024-12-10 17:21:01,134,4582,72,62,2661.71,5559.01,0.00
2024-12-10 17:21:01,135,4581,72,63,2641.58,5559.03,0.00
2024-12-10 17:21:01,134,4581,72,62,2667.97,5559.13,0.00
2024-12-10 17:21:01,135,4580,72,63,2610.40,5559.76,0.00
2024-12-10 17:21:01,134,4580,71,63,2628.92,5559.96,0.00
2024-12-10 17:21:01,134,4581,71,63,2667.96,5560.00,0.00
2024-12-10 17:21:01,135,4581,71,64,2648.20,5560.01,0.00
2024-12-10 17:21:01,135,4582,71,64,2712.47,5561.00,0.00
2024-12-10 17:21:01,136,4582,71,65,2692.52,5561.01,0.00
2024-12-10 17:21:02,136,4583,71,65,2675.51,5562.00,0.00
2024-12-10 17:21:02,137,4583,72,65,2655.98,5562.01,0.00
2024-12-10 17:21:02,138,4582,72,66,2608.39,5562.52,0.00
2024-12-10 17:21:02,138,4583,72,66,2644.14,5563.00,0.00
2024-12-10 17:21:02,139,4583,73,66,2625.12,5563.01,0.00
2024-12-10 17:21:02,138,4583,72,66,2637.73,5563.12,0.00
2024-12-10 17:21:02,137,4583,72,65,2656.57,5563.12,0.00
2024-12-10 17:21:02,138,4582,73,65,2623.92,5563.36,0.00
2024-12-10 17:21:02,138,4583,73,65,2688.87,5564.00,0.00
2024-12-10 17:21:02,139,4583,73,66,2669.53,5564.01,0.00
2024-12-10 17:21:02,138,4583,73,65,2682.46,5564.12,0.00
2024-12-10 17:21:02,139,4582,73,66,2628.29,5564.66,0.00
2024-12-10 17:21:02,139,4583,73,66,2702.87,5565.00,0.00
2024-12-10 17:21:02,140,4583,73,67,2683.57,5565.01,0.00
2024-12-10 17:21:02,139,4583,73,66,2696.50,5565.12,0.00
2024-12-10 17:21:02,138,4583,72,66,2698.92,5565.36,0.00
2024-12-10 17:21:02,138,4584,72,66,2740.20,5566.00,0.00
2024-12-10 17:21:02,139,4584,73,66,2720.49,5566.01,0.00
2024-12-10 17:21:02,138,4584,72,66,2733.78,5566.12,0.00
2024-12-10 17:21:02,138,4585,72,66,2718.01,5567.00,0.00
2024-12-10 17:21:02,139,4585,72,67,2698.45,5567.01,0.00
2024-12-10 17:21:02,138,4585,72,66,2711.94,5567.12,0.00
2024-12-10 17:21:02,137,4585,71,66,2707.17,5567.50,0.00
2024-12-10 17:21:02,137,4586,71,66,2713.05,5568.00,0.00
2024-12-10 17:21:02,138,4586,71,67,2693.39,5568.01,0.00
2024-12-10 17:21:02,137,4586,70,67,2711.43,5568.03,0.00
2024-12-10 17:21:02,136,4586,70,66,2726.48,5568.11,0.00
2024-12-10 17:21:02,135,4586,69,66,2746.26,5568.11,0.00
2024-12-10 17:21:02,134,4586,69,65,2731.27,5568.56,0.00
2024-12-10 17:21:02,134,4587,69,65,2743.72,5569.00,0.00
2024-12-10 17:21:02,135,4587,69,66,2723.40,5569.01,0.00
2024-12-10 17:21:02,134,4587,69,65,2742.48,5569.02,0.00
2024-12-10 17:21:02,133,4587,68,65,2757.68,5569.11,0.00
2024-12-10 17:21:02,132,4587,67,65,2778.15,5569.11,0.00
2024-12-10 17:21:02,131,4587,67,64,2781.28,5569.37,0.00
2024-12-10 17:21:02,131,4588,67,64,2773.45,5570.00,0.00
2024-12-10 17:21:02,132,4588,68,64,2752.44,5570.01,0.00
2024-12-10 17:21:02,131,4588,68,63,2771.77,5570.03,0.00
2024-12-10 17:21:02,130,4588,67,63,2788.40,5570.11,0.00
2024-12-10 17:21:02,129,4588,67,62,2809.58,5570.11,0.00
2024-12-10 17:21:02,128,4588,66,62,2811.30,5570.45,0.00
2024-12-10 17:21:02,129,4587,66,63,2759.51,5570.81,0.00
2024-12-10 17:21:02,129,4588,66,63,2800.70,5571.00,0.00
2024-12-10 17:21:02,130,4588,66,64,2779.16,5571.01,0.00
2024-12-10 17:21:02,129,4588,66,63,2794.69,5571.11,0.00
2024-12-10 17:21:02,130,4587,67,63,2726.97,5571.74,0.00
2024-12-10 17:21:02,130,4588,67,63,2823.35,5572.00,0.00
2024-12-10 17:21:02,131,4588,67,64,2801.79,5572.01,0.00
2024-12-10 17:21:02,130,4588,67,63,2817.38,5572.11,0.00
2024-12-10 17:21:02,130,4589,67,63,2841.33,5573.00,0.00
2024-12-10 17:21:02,131,4589,67,64,2819.64,5573.01,0.00
2024-12-10 17:21:02,130,4589,67,63,2837.07,5573.08,0.00
2024-12-10 17:21:02,129,4589,67,62,2858.88,5573.08,0.00
2024-12-10 17:21:02,128,4589,66,62,2879.13,5573.10,0.00
2024-12-10 17:21:02,127,4589,65,62,2901.36,5573.10,0.00
2024-12-10 17:21:02,126,4589,65,61,2890.81,5573.60,0.00
2024-12-10 17:21:02,126,4590,65,61,2908.75,5574.00,0.00
2024-12-10 17:21:02,127,4590,66,61,2885.85,5574.01,0.00
2024-12-10 17:21:02,128,4589,66,62,2863.30,5574.02,0.00
2024-12-10 17:21:02,127,4589,65,62,2911.94,5574.11,0.00
2024-12-10 17:21:02,127,4590,65,62,2897.19,5575.00,0.00
2024-12-10 17:21:02,128,4590,66,62,2874.56,5575.01,0.00
2024-12-10 17:21:02,127,4590,65,62,2891.28,5575.10,0.00
2024-12-10 17:21:02,126,4590,65,61,2889.66,5575.46,0.00
2024-12-10 17:21:02,127,4589,66,61,2844.93,5575.74,0.00
2024-12-10 17:21:02,127,4590,66,61,2929.45,5576.00,0.00
2024-12-10 17:21:02,128,4590,67,61,2906.56,5576.01,0.00
2024-12-10 17:21:02,127,4590,66,61,2923.55,5576.10,0.00
2024-12-10 17:21:02,126,4590,65,61,2943.50,5576.14,0.00
2024-12-10 17:21:02,125,4590,64,61,2966.34,5576.14,0.00
2024-12-10 17:21:02,124,4590,63,61,2970.66,5576.46,0.00
2024-12-10 17:21:02,123,4590,62,61,2986.73,5576.56,0.00
2024-12-10 17:21:02,123,4591,62,61,3051.81,5577.00,0.00
2024-12-10 17:21:02,124,4591,63,61,3027.20,5577.01,0.00
2024-12-10 17:21:02,123,4591,62,61,3045.78,5577.11,0.00
2024-12-10 17:21:02,123,4592,62,61,3038.56,5578.00,0.00
2024-12-10 17:21:02,124,4592,62,62,3014.06,5578.01,0.00
2024-12-10 17:21:02,123,4592,61,62,3032.54,5578.11,0.00
2024-12-10 17:21:02,123,4593,61,62,3022.75,5579.00,0.00
2024-12-10 17:21:02,124,4593,62,62,2998.37,5579.01,0.00
2024-12-10 17:21:02,123,4593,62,61,3016.70,5579.11,0.00
2024-12-10 17:21:02,124,4592,63,61,2980.72,5579.33,0.00
2024-12-10 17:21:02,124,4593,63,61,3014.84,5580.00,0.00
2024-12-10 17:21:02,125,4593,64,61,2990.72,5580.01,0.00
2024-12-10 17:21:02,124,4593,64,60,3013.11,5580.03,0.00
2024-12-10 17:21:02,123,4593,63,60,3033.35,5580.10,0.00
2024-12-10 17:21:02,123,4594,63,60,3061.45,5581.00,0.00
2024-12-10 17:21:02,124,4594,63,61,3036.77,5581.01,0.00
2024-12-10 17:21:02,123,4594,62,61,3055.84,5581.10,0.00
2024-12-10 17:21:02,122,4594,62,60,3041.06,5581.61,0.00
2024-12-10 17:21:02,122,4595,62,60,3064.91,5582.00,0.00
2024-12-10 17:21:02,123,4595,62,61,3039.99,5582.01,0.00
2024-12-10 17:21:02,123,4596,62,61,3026.74,5583.00,0.00
2024-12-10 17:21:02,124,4596,62,62,3002.33,5583.01,0.00
2024-12-10 17:21:02,123,4596,61,62,3021.09,5583.10,0.00
2024-12-10 17:21:02,123,4597,61,62,3010.17,5584.00,0.00
2024-12-10 17:21:02,124,4597,62,62,2985.89,5584.01,0.00
2024-12-10 17:21:02,123,4597,61,62,3004.69,5584.10,0.00
2024-12-10 17:21:02,123,4598,61,62,2992.43,5585.00,0.00
2024-12-10 17:21:02,124,4598,62,62,2968.30,5585.01,0.00
2024-12-10 17:21:02,123,4598,62,61,2989.28,5585.06,0.00
2024-12-10 17:21:02,122,4598,61,61,3012.87,5585.07,0.00
2024-12-10 17:21:02,121,4598,61,60,3036.39,5585.08,0.00
2024-12-10 17:21:02,120,4598,61,59,3060.76,5585.09,0.00
2024-12-10 17:21:02,119,4598,60,59,3068.57,5585.33,0.00
2024-12-10 17:21:02,120,4597,61,59,3012.17,5585.87,0.00
2024-12-10 17:21:02,120,4598,61,59,3056.88,5586.00,0.00
2024-12-10 17:21:02,121,4598,61,60,3031.61,5586.01,0.00
2024-12-10 17:21:02,120,4598,60,60,3052.77,5586.08,0.00
2024-12-10 17:21:02,119,4598,59,60,3077.49,5586.08,0.00
2024-12-10 17:21:02,118,4598,59,59,3101.53,5586.12,0.00
2024-12-10 17:21:02,119,4597,60,59,3049.68,5586.56,0.00
2024-12-10 17:21:02,119,4598,60,59,3136.65,5587.00,0.00
2024-12-10 17:21:02,120,4598,61,59,3110.51,5587.01,0.00
2024-12-10 17:21:03,119,4598,61,58,3131.52,5587.09,0.00
2024-12-10 17:21:03,118,4598,60,58,3130.87,5587.56,0.00
2024-12-10 17:21:03,118,4599,60,58,3200.94,5588.00,0.00
2024-12-10 17:21:03,119,4599,60,59,3174.04,5588.01,0.00
2024-12-10 17:21:03,118,4599,60,58,3195.77,5588.09,0.00
2024-12-10 17:21:03,118,4600,60,58,3191.84,5589.00,0.00
2024-12-10 17:21:03,119,4600,60,59,3165.02,5589.01,0.00
2024-12-10 17:21:03,118,4600,60,58,3189.96,5589.03,0.00
2024-12-10 17:21:03,119,4599,60,59,3162.22,5589.07,0.00
2024-12-10 17:21:03,118,4599,59,59,3206.56,5589.09,0.00
2024-12-10 17:21:03,118,4600,59,59,3202.91,5590.00,0.00
2024-12-10 17:21:03,119,4600,59,60,3176.00,5590.01,0.00
2024-12-10 17:21:03,119,4601,59,60,3215.09,5591.00,0.00
2024-12-10 17:21:03,120,4601,60,60,3188.30,5591.01,0.00
2024-12-10 17:21:03,119,4601,59,60,3210.09,5591.08,0.00
2024-12-10 17:21:03,119,4602,59,60,3202.07,5592.00,0.00
2024-12-10 17:21:03,120,4602,60,60,3175.39,5592.01,0.00
2024-12-10 17:21:03,119,4602,60,59,3197.25,5592.08,0.00
2024-12-10 17:21:03,120,4601,61,59,3153.70,5592.33,0.00
2024-12-10 17:21:03,121,4600,62,59,3140.29,5592.65,0.00
2024-12-10 17:21:03,121,4601,62,59,3179.84,5593.00,0.00
2024-12-10 17:21:03,122,4601,63,59,3153.77,5593.01,0.00
2024-12-10 17:21:03,121,4601,62,59,3175.25,5593.08,0.00
2024-12-10 17:21:03,120,4601,62,58,3189.74,5593.25,0.00
2024-12-10 17:21:03,121,4600,62,59,3162.46,5593.28,0.00
2024-12-10 17:21:03,121,4601,62,59,3288.60,5594.00,0.00
2024-12-10 17:21:03,122,4601,62,60,3261.65,5594.01,0.00
2024-12-10 17:21:03,123,4600,63,60,3234.68,5594.03,0.00
2024-12-10 17:21:03,122,4600,62,60,3273.15,5594.09,0.00
2024-12-10 17:21:03,123,4599,63,60,3227.10,5594.46,0.00
2024-12-10 17:21:03,123,4600,63,60,3304.18,5595.00,0.00
2024-12-10 17:21:03,124,4600,64,60,3277.54,5595.01,0.00
2024-12-10 17:21:03,123,4600,63,60,3302.38,5595.03,0.00
2024-12-10 17:21:03,122,4600,63,59,3326.26,5595.08,0.00
2024-12-10 17:21:03,122,4601,63,59,3409.49,5596.00,0.00
2024-12-10 17:21:03,123,4601,63,60,3381.77,5596.01,0.00
2024-12-10 17:21:03,122,4601,63,59,3404.49,5596.09,0.00
2024-12-10 17:21:03,123,4600,64,59,3347.03,5596.64,0.00
2024-12-10 17:21:03,123,4601,64,59,3381.48,5597.00,0.00
2024-12-10 17:21:03,124,4601,65,59,3354.21,5597.01,0.00
2024-12-10 17:21:03,124,4602,65,59,3386.03,5598.00,0.00
2024-12-10 17:21:03,125,4602,65,60,3358.94,5598.01,0.00
2024-12-10 17:21:03,124,4602,65,59,3381.11,5598.09,0.00
2024-12-10 17:21:03,123,4602,64,59,3408.14,5598.09,0.00
2024-12-10 17:21:03,123,4603,64,59,3402.47,5599.00,0.00
2024-12-10 17:21:03,124,4603,64,60,3375.03,5599.01,0.00
2024-12-10 17:21:03,123,4603,64,59,3397.50,5599.09,0.00
2024-12-10 17:21:03,123,4604,64,59,3390.48,5600.00,0.00
2024-12-10 17:21:03,124,4604,65,59,3363.14,5600.01,0.00
2024-12-10 17:21:03,123,4604,64,59,3385.51,5600.09,0.00
2024-12-10 17:21:03,123,4605,64,59,3374.23,5601.00,0.00
2024-12-10 17:21:03,124,4605,64,60,3347.02,5601.01,0.00
2024-12-10 17:21:03,125,4604,65,60,3308.23,5601.24,0.00
2024-12-10 17:21:03,124,4604,64,60,3313.71,5601.72,0.00
2024-12-10 17:21:03,124,4605,64,60,3343.32,5602.00,0.00
2024-12-10 17:21:03,125,4605,65,60,3316.57,5602.01,0.00
2024-12-10 17:21:03,124,4605,64,60,3341.55,5602.03,0.00
2024-12-10 17:21:03,123,4605,63,60,3364.66,5602.10,0.00
2024-12-10 17:21:03,122,4605,63,59,3391.32,5602.12,0.00
2024-12-10 17:21:03,122,4606,63,59,3422.76,5603.00,0.00
2024-12-10 17:21:03,123,4606,63,60,3394.93,5603.01,0.00
2024-12-10 17:21:03,122,4606,62,60,3417.29,5603.10,0.00
2024-12-10 17:21:03,122,4607,62,60,3401.88,5604.00,0.00
2024-12-10 17:21:03,123,4607,62,61,3374.23,5604.01,0.00
2024-12-10 17:21:03,122,4607,62,60,3368.16,5604.48,0.00
2024-12-10 17:21:03,123,4606,63,60,3340.78,5604.50,0.00
2024-12-10 17:21:03,124,4605,63,61,3311.43,5604.91,0.00
2024-12-10 17:21:03,124,4606,63,61,3355.82,5605.00,0.00
2024-12-10 17:21:03,125,4606,63,62,3328.97,5605.01,0.00
2024-12-10 17:21:03,125,4607,63,62,3403.40,5606.00,0.00
2024-12-10 17:21:03,126,4607,63,63,3376.39,5606.01,0.00
2024-12-10 17:21:03,126,4608,63,63,3359.49,5607.00,0.00
2024-12-10 17:21:03,127,4608,64,63,3333.04,5607.01,0.00
2024-12-10 17:21:03,127,4609,64,63,3314.20,5608.00,0.00
2024-12-10 17:21:03,128,4609,64,64,3288.31,5608.01,0.00
2024-12-10 17:21:03,127,4609,63,64,3308.51,5608.10,0.00
2024-12-10 17:21:03,127,4610,63,64,3292.06,5609.00,0.00
2024-12-10 17:21:03,128,4610,63,65,3266.34,5609.01,0.00
2024-12-10 17:21:03,129,4609,63,66,3236.28,5609.11,0.00
2024-12-10 17:21:03,128,4609,62,66,3290.93,5609.11,0.00
2024-12-10 17:21:03,127,4609,62,65,3293.39,5609.44,0.00
2024-12-10 17:21:03,127,4610,62,65,3298.33,5610.00,0.00
2024-12-10 17:21:03,128,4610,63,65,3272.56,5610.01,0.00
2024-12-10 17:21:03,127,4610,62,65,3292.64,5610.10,0.00
2024-12-10 17:21:03,128,4609,63,65,3259.07,5610.26,0.00
2024-12-10 17:21:03,127,4609,63,64,3302.67,5610.43,0.00
2024-12-10 17:21:03,127,4610,63,64,3355.60,5611.00,0.00
2024-12-10 17:21:03,128,4610,64,64,3329.38,5611.01,0.00
2024-12-10 17:21:03,127,4610,64,63,3349.90,5611.10,0.00
2024-12-10 17:21:03,128,4609,65,63,3319.38,5611.20,0.00
2024-12-10 17:21:03,128,4610,65,63,3389.00,5612.00,0.00
2024-12-10 17:21:03,129,4610,65,64,3362.73,5612.01,0.00
2024-12-10 17:21:03,129,4611,65,64,3384.65,5613.00,0.00
2024-12-10 17:21:03,130,4611,66,64,3358.62,5613.01,0.00
2024-12-10 17:21:03,129,4611,66,63,3361.08,5613.39,0.00
2024-12-10 17:21:03,129,4612,66,63,3363.58,5614.00,0.00
2024-12-10 17:21:03,130,4612,66,64,3337.70,5614.01,0.00
2024-12-10 17:21:03,131,4611,66,65,3311.80,5614.03,0.00
2024-12-10 17:21:03,130,4611,65,65,3332.09,5614.27,0.00
2024-12-10 17:21:03,130,4612,65,65,3324.36,5615.00,0.00
2024-12-10 17:21:03,131,4612,65,66,3298.99,5615.01,0.00
2024-12-10 17:21:04,132,4611,66,66,3270.62,5615.08,0.00
2024-12-10 17:21:04,131,4611,65,66,3321.75,5615.11,0.00
2024-12-10 17:21:04,132,4610,66,66,3295.32,5615.14,0.00
2024-12-10 17:21:04,131,4610,66,65,3312.65,5615.76,0.00
2024-12-10 17:21:04,131,4611,66,65,3385.30,5616.00,0.00
2024-12-10 17:21:04,132,4611,67,65,3359.65,5616.01,0.00
2024-12-10 17:21:04,133,4610,67,66,3307.87,5616.47,0.00
2024-12-10 17:21:04,133,4611,67,66,3411.43,5617.00,0.00
2024-12-10 17:21:04,134,4611,67,67,3385.97,5617.01,0.00
2024-12-10 17:21:04,135,4610,68,67,3341.00,5617.34,0.00
2024-12-10 17:21:04,134,4610,67,67,3367.07,5617.64,0.00
2024-12-10 17:21:04,134,4611,67,67,3431.08,5618.00,0.00
2024-12-10 17:21:04,135,4611,68,67,3405.67,5618.01,0.00
2024-12-10 17:21:04,134,4611,68,66,3425.68,5618.10,0.00
2024-12-10 17:21:04,134,4612,68,66,3457.49,5619.00,0.00
2024-12-10 17:21:04,135,4612,69,66,3431.88,5619.01,0.00
2024-12-10 17:21:04,136,4611,70,66,3368.30,5619.67,0.00
2024-12-10 17:21:04,136,4612,70,66,3402.97,5620.00,0.00
2024-12-10 17:21:04,137,4612,70,67,3378.13,5620.01,0.00
2024-12-10 17:21:04,137,4613,70,67,3402.74,5621.00,0.00
2024-12-10 17:21:04,138,4613,71,67,3378.09,5621.01,0.00
2024-12-10 17:21:04,137,4613,70,67,3390.02,5621.22,0.00
2024-12-10 17:21:04,137,4614,70,67,3385.19,5622.00,0.00
2024-12-10 17:21:04,138,4614,70,68,3360.66,5622.01,0.00
2024-12-10 17:21:04,137,4614,69,68,3379.90,5622.10,0.00
2024-12-10 17:21:04,137,4615,69,68,3366.15,5623.00,0.00
2024-12-10 17:21:04,138,4615,69,69,3341.76,5623.01,0.00
2024-12-10 17:21:04,139,4614,69,70,3317.32,5623.03,0.00
2024-12-10 17:21:04,138,4614,69,69,3344.21,5623.03,0.00
2024-12-10 17:21:04,138,4615,69,69,3325.10,5624.00,0.00
2024-12-10 17:21:04,139,4615,69,70,3301.18,5624.01,0.00
2024-12-10 17:21:04,140,4614,70,70,3272.43,5624.11,0.00
2024-12-10 17:21:04,140,4615,70,70,3334.17,5625.00,0.00
2024-12-10 17:21:04,141,4615,70,71,3310.52,5625.01,0.00
2024-12-10 17:21:04,141,4616,70,71,3324.06,5626.00,0.00
2024-12-10 17:21:04,142,4616,71,71,3300.65,5626.01,0.00
2024-12-10 17:21:04,141,4616,70,71,3309.97,5626.23,0.00
2024-12-10 17:21:04,141,4617,70,71,3293.57,5627.00,0.00
2024-12-10 17:21:04,142,4617,71,71,3270.38,5627.01,0.00
2024-12-10 17:21:04,143,4616,72,71,3246.73,5627.04,0.00
2024-12-10 17:21:04,142,4616,71,71,3274.20,5627.21,0.00
2024-12-10 17:21:04,141,4616,70,71,3266.49,5627.67,0.00
2024-12-10 17:21:04,141,4617,70,71,3280.86,5628.00,0.00
2024-12-10 17:21:04,142,4617,71,71,3257.75,5628.01,0.00
2024-12-10 17:21:04,142,4618,71,71,3270.17,5629.00,0.00
2024-12-10 17:21:04,143,4618,71,72,3247.30,5629.01,0.00
2024-12-10 17:21:04,142,4618,70,72,3263.72,5629.12,0.00
2024-12-10 17:21:04,141,4618,70,71,3243.15,5629.75,0.00
2024-12-10 17:21:04,141,4619,70,71,3268.92,5630.00,0.00
2024-12-10 17:21:04,142,4619,70,72,3245.90,5630.01,0.00
2024-12-10 17:21:04,141,4619,69,72,3262.20,5630.12,0.00
2024-12-10 17:21:04,140,4619,69,71,3277.99,5630.21,0.00
2024-12-10 17:21:04,141,4618,69,72,3245.62,5630.39,0.00
2024-12-10 17:21:04,141,4619,69,72,3284.72,5631.00,0.00
2024-12-10 17:21:04,142,4619,70,72,3261.59,5631.01,0.00
2024-12-10 17:21:04,141,4619,70,71,3277.60,5631.13,0.00
2024-12-10 17:21:04,141,4620,70,71,3305.69,5632.00,0.00
2024-12-10 17:21:04,142,4620,70,72,3282.41,5632.01,0.00
2024-12-10 17:21:04,141,4620,69,72,3298.57,5632.13,0.00
2024-12-10 17:21:04,140,4620,69,71,3305.40,5632.38,0.00
2024-12-10 17:21:04,140,4621,69,71,3310.57,5633.00,0.00
2024-12-10 17:21:04,141,4621,69,72,3287.09,5633.01,0.00
2024-12-10 17:21:04,140,4621,68,72,3308.97,5633.03,0.00
2024-12-10 17:21:04,140,4622,68,72,3294.65,5634.00,0.00
2024-12-10 17:21:04,141,4622,69,72,3271.28,5634.01,0.00
2024-12-10 17:21:04,140,4622,69,71,3287.47,5634.13,0.00
2024-12-10 17:21:04,140,4623,69,71,3278.85,5635.00,0.00
2024-12-10 17:21:04,141,4623,69,72,3255.60,5635.01,0.00
2024-12-10 17:21:04,142,4622,70,72,3231.10,5635.05,0.00
2024-12-10 17:21:04,141,4622,70,71,3276.86,5635.14,0.00
2024-12-10 17:21:04,141,4623,70,71,3268.98,5636.00,0.00
2024-12-10 17:21:04,142,4623,70,72,3245.96,5636.01,0.00
2024-12-10 17:21:04,141,4623,70,71,3261.85,5636.13,0.00
2024-12-10 17:21:04,141,4624,70,71,3292.82,5637.00,0.00
2024-12-10 17:21:04,142,4624,71,71,3269.63,5637.01,0.00
2024-12-10 17:21:04,142,4625,71,71,3250.94,5638.00,0.00
2024-12-10 17:21:04,143,4625,72,71,3228.21,5638.01,0.00
2024-12-10 17:21:04,142,4625,72,70,3249.37,5638.03,0.00
2024-12-10 17:21:04,142,4626,72,70,3230.18,5639.00,0.00
2024-12-10 17:21:04,143,4626,73,70,3207.59,5639.01,0.00
2024-12-10 17:21:04,144,4625,73,71,3179.51,5639.13,0.00
2024-12-10 17:21:04,143,4625,73,70,3232.12,5639.13,0.00
2024-12-10 17:21:04,142,4625,73,69,3245.98,5639.26,0.00
2024-12-10 17:21:04,143,4624,73,70,3222.11,5639.29,0.00
2024-12-10 17:21:04,143,4625,73,70,3251.75,5640.00,0.00
2024-12-10 17:21:04,144,4625,74,70,3229.17,5640.01,0.00
2024-12-10 17:21:04,143,4625,73,70,3244.73,5640.13,0.00
2024-12-10 17:21:04,143,4626,73,70,3314.10,5641.00,0.00
2024-12-10 17:21:04,144,4626,73,71,3291.08,5641.01,0.00
2024-12-10 17:21:04,143,4626,72,71,3312.15,5641.04,0.00
2024-12-10 17:21:05,143,4627,72,71,3297.67,5642.00,0.00
2024-12-10 17:21:05,144,4627,73,71,3274.76,5642.01,0.00
2024-12-10 17:21:05,143,4627,72,71,3291.03,5642.12,0.00
2024-12-10 17:21:05,144,4626,72,72,3253.76,5642.39,0.00
2024-12-10 17:21:05,144,4627,72,72,3283.58,5643.00,0.00
2024-12-10 17:21:05,145,4627,72,73,3260.93,5643.01,0.00
2024-12-10 17:21:05,144,4627,71,73,3276.98,5643.12,0.00
2024-12-10 17:21:05,144,4628,71,73,3305.35,5644.00,0.00
2024-12-10 17:21:05,145,4628,71,74,3282.56,5644.01,0.00
2024-12-10 17:21:05,145,4629,71,74,3243.88,5645.00,0.00
2024-12-10 17:21:05,146,4629,71,75,3221.66,5645.01,0.00
2024-12-10 17:21:05,145,4629,71,74,3226.97,5645.03,0.00
2024-12-10 17:21:05,144,4629,70,74,3239.95,5645.18,0.00
2024-12-10 17:21:05,144,4630,70,74,3213.57,5646.00,0.00
2024-12-10 17:21:05,145,4630,70,75,3191.40,5646.01,0.00
2024-12-10 17:21:05,144,4630,69,75,3141.39,5646.97,0.00
2024-12-10 17:21:05,144,4631,69,75,3139.67,5647.00,0.00
2024-12-10 17:21:05,145,4631,69,76,3118.02,5647.01,0.00
2024-12-10 17:21:05,144,4631,69,75,3132.68,5647.13,0.00
2024-12-10 17:21:05,143,4631,69,74,3088.54,5647.98,0.00
2024-12-10 17:21:05,143,4632,69,74,3126.87,5648.00,0.00
2024-12-10 17:21:05,144,4632,70,74,3105.15,5648.01,0.00
2024-12-10 17:21:05,143,4632,70,73,3119.82,5648.13,0.00
2024-12-10 17:21:05,144,4631,71,73,3055.40,5648.90,0.00
2024-12-10 17:21:05,144,4632,71,73,3093.93,5649.00,0.00
2024-12-10 17:21:05,145,4632,71,74,3072.59,5649.01,0.00
2024-12-10 17:21:05,144,4632,70,74,3086.94,5649.13,0.00
2024-12-10 17:21:05,144,4633,70,74,3116.45,5650.00,0.00
2024-12-10 17:21:05,145,4633,71,74,3094.96,5650.01,0.00
2024-12-10 17:21:05,146,4632,71,75,3071.84,5650.06,0.00
2024-12-10 17:21:05,147,4631,71,76,3028.93,5650.60,0.00
2024-12-10 17:21:05,148,4630,71,77,3007.92,5650.91,0.00
2024-12-10 17:21:05,148,4631,71,77,3045.42,5651.00,0.00
2024-12-10 17:21:05,149,4631,71,78,3024.98,5651.01,0.00
2024-12-10 17:21:05,148,4631,71,77,3037.85,5651.14,0.00
2024-12-10 17:21:05,147,4631,70,77,3040.02,5651.20,0.00
2024-12-10 17:21:05,147,4632,70,77,3148.90,5652.00,0.00
2024-12-10 17:21:05,148,4632,71,77,3127.62,5652.01,0.00
2024-12-10 17:21:05,147,4632,71,76,3141.28,5652.14,0.00
2024-12-10 17:21:05,147,4633,71,76,3131.38,5653.00,0.00
2024-12-10 17:21:05,148,4633,71,77,3110.23,5653.01,0.00
2024-12-10 17:21:05,147,4633,71,76,3123.76,5653.14,0.00
2024-12-10 17:21:05,147,4634,71,76,3113.18,5654.00,0.00
2024-12-10 17:21:05,148,4634,72,76,3092.14,5654.01,0.00
2024-12-10 17:21:05,148,4635,72,76,3073.23,5655.00,0.00
2024-12-10 17:21:05,149,4635,73,76,3052.61,5655.01,0.00
2024-12-10 17:21:05,149,4636,73,76,3028.84,5656.00,0.00
2024-12-10 17:21:05,150,4636,74,76,3008.65,5656.01,0.00
2024-12-10 17:21:05,149,4636,73,76,3021.31,5656.13,0.00
2024-12-10 17:21:05,149,4636,73,76,2994.87,5657.00,0.00
2024-12-10 17:21:05,150,4636,74,76,2974.91,5657.01,0.00
2024-12-10 17:21:05,150,4637,74,76,2929.51,5658.00,0.00
2024-12-10 17:21:05,151,4637,75,76,2910.11,5658.01,0.00
2024-12-10 17:21:05,150,4637,74,76,2909.42,5658.35,0.00
2024-12-10 17:21:05,149,4637,73,76,2888.33,5658.84,0.00
2024-12-10 17:21:05,149,4638,73,76,2904.14,5659.00,0.00
2024-12-10 17:21:05,150,4638,74,76,2884.78,5659.01,0.00
2024-12-10 17:21:05,151,4637,74,77,2815.36,5659.86,0.00
2024-12-10 17:21:05,150,4637,74,76,2820.99,5659.95,0.00
2024-12-10 17:21:05,150,4638,74,76,2855.75,5660.00,0.00
2024-12-10 17:21:05,151,4638,74,77,2836.84,5660.01,0.00
2024-12-10 17:21:05,150,4638,74,76,2847.51,5660.15,0.00
2024-12-10 17:21:05,150,4639,74,76,2870.29,5661.00,0.00
2024-12-10 17:21:05,151,4639,75,76,2851.28,5661.01,0.00
2024-12-10 17:21:05,151,4640,75,76,2826.60,5662.00,0.00
2024-12-10 17:21:05,152,4640,76,76,2808.01,5662.01,0.00
2024-12-10 17:21:05,151,4640,75,76,2824.74,5662.03,0.00
2024-12-10 17:21:05,150,4640,74,76,2837.21,5662.14,0.00
2024-12-10 17:21:05,149,4640,74,75,2855.87,5662.14,0.00
2024-12-10 17:21:05,149,4641,74,75,2836.70,5663.00,0.00
2024-12-10 17:21:05,150,4641,74,76,2817.79,5663.01,0.00
2024-12-10 17:21:05,149,4641,73,76,2828.78,5663.14,0.00
2024-12-10 17:21:05,148,4641,73,75,2837.23,5663.30,0.00
2024-12-10 17:21:05,148,4642,73,75,2827.52,5664.00,0.00
2024-12-10 17:21:05,149,4642,73,76,2808.55,5664.01,0.00
2024-12-10 17:21:05,148,4642,73,75,2817.98,5664.14,0.00
2024-12-10 17:21:05,147,4642,73,74,2820.68,5664.43,0.00
2024-12-10 17:21:05,147,4643,73,74,2820.93,5665.00,0.00
2024-12-10 17:21:05,148,4643,74,74,2801.87,5665.01,0.00
2024-12-10 17:21:05,147,4643,74,73,2808.45,5665.15,0.00
2024-12-10 17:21:05,148,4642,75,73,2779.55,5665.34,0.00
2024-12-10 17:21:05,148,4643,75,73,2797.75,5666.00,0.00
2024-12-10 17:21:05,149,4643,76,73,2778.97,5666.01,0.00
2024-12-10 17:21:05,150,4642,76,74,2748.70,5666.11,0.00
2024-12-10 17:21:05,151,4641,76,75,2742.20,5666.39,0.00
2024-12-10 17:21:05,150,4641,76,74,2784.65,5666.43,0.00
2024-12-10 17:21:05,149,4641,75,74,2795.54,5666.57,0.00
2024-12-10 17:21:05,149,4642,75,74,2847.57,5667.00,0.00
2024-12-10 17:21:05,150,4642,75,75,2828.58,5667.01,0.00
2024-12-10 17:21:05,149,4642,74,75,2838.41,5667.08,0.00
2024-12-10 17:21:05,150,4641,75,75,2784.21,5667.72,0.00
2024-12-10 17:21:06,150,4642,75,75,2894.77,5668.00,0.00
2024-12-10 17:21:06,151,4642,76,75,2875.60,5668.01,0.00
2024-12-10 17:21:06,150,4642,76,74,2886.14,5668.15,0.00
2024-12-10 17:21:06,150,4643,76,74,2914.18,5669.00,0.00
2024-12-10 17:21:06,151,4643,76,75,2894.88,5669.01,0.00
2024-12-10 17:21:06,151,4644,76,75,2876.61,5670.00,0.00
2024-12-10 17:21:06,152,4644,77,75,2857.69,5670.01,0.00
2024-12-10 17:21:06,151,4644,76,75,2868.04,5670.15,0.00
2024-12-10 17:21:06,150,4644,76,74,2886.78,5670.15,0.00
2024-12-10 17:21:06,150,4645,76,74,2877.02,5671.00,0.00
2024-12-10 17:21:06,151,4645,77,74,2857.97,5671.01,0.00
2024-12-10 17:21:06,150,4645,77,73,2868.38,5671.15,0.00
2024-12-10 17:21:06,151,4644,78,73,2831.81,5671.48,0.00
2024-12-10 17:21:06,152,4643,78,74,2828.17,5671.62,0.00
2024-12-10 17:21:06,152,4644,78,74,2861.31,5672.00,0.00
2024-12-10 17:21:06,153,4644,78,75,2842.61,5672.01,0.00
2024-12-10 17:21:06,152,4644,78,74,2852.41,5672.16,0.00
2024-12-10 17:21:06,152,4645,78,74,2917.05,5673.00,0.00
2024-12-10 17:21:06,153,4645,78,75,2897.98,5673.01,0.00
2024-12-10 17:21:06,154,4644,79,75,2872.95,5673.13,0.00
2024-12-10 17:21:06,153,4644,79,74,2914.73,5673.16,0.00
2024-12-10 17:21:06,153,4645,79,74,2904.80,5674.00,0.00
2024-12-10 17:21:06,154,4645,80,74,2885.94,5674.01,0.00
2024-12-10 17:21:06,153,4645,79,74,2904.43,5674.01,0.00
2024-12-10 17:21:06,152,4645,78,74,2915.01,5674.15,0.00
2024-12-10 17:21:06,151,4645,78,73,2933.94,5674.15,0.00
2024-12-10 17:21:06,152,4644,79,73,2891.62,5674.57,0.00
2024-12-10 17:21:06,152,4645,79,73,2961.01,5675.00,0.00
2024-12-10 17:21:06,153,4645,80,73,2941.66,5675.01,0.00
2024-12-10 17:21:06,152,4645,80,72,2955.45,5675.10,0.00
2024-12-10 17:21:06,151,4645,79,72,2972.04,5675.15,0.00
2024-12-10 17:21:06,151,4646,79,72,2998.83,5676.00,0.00
2024-12-10 17:21:06,152,4646,79,73,2979.10,5676.01,0.00
2024-12-10 17:21:06,151,4646,78,73,2990.62,5676.15,0.00
2024-12-10 17:21:06,151,4647,78,73,2979.41,5677.00,0.00
2024-12-10 17:21:06,152,4647,79,73,2959.81,5677.01,0.00
2024-12-10 17:21:06,151,4647,78,73,2971.20,5677.15,0.00
2024-12-10 17:21:06,152,4646,79,73,2908.03,5677.92,0.00
2024-12-10 17:21:06,152,4647,79,73,2943.97,5678.00,0.00
2024-12-10 17:21:06,153,4647,79,74,2924.73,5678.01,0.00
2024-12-10 17:21:06,152,4647,78,74,2928.77,5678.26,0.00
2024-12-10 17:21:06,153,4646,79,74,2900.77,5678.43,0.00
2024-12-10 17:21:06,153,4646,79,74,2966.86,5679.00,0.00
2024-12-10 17:21:06,154,4646,80,74,2947.59,5679.01,0.00
2024-12-10 17:21:06,155,4645,81,74,2928.21,5679.03,0.00
2024-12-10 17:21:06,154,4645,80,74,2958.35,5679.16,0.00
2024-12-10 17:21:06,153,4645,79,74,2977.31,5679.16,0.00
2024-12-10 17:21:06,154,4644,79,75,2929.41,5679.68,0.00
2024-12-10 17:21:06,154,4645,79,75,2998.64,5680.00,0.00
2024-12-10 17:21:06,155,4645,79,76,2979.30,5680.01,0.00
2024-12-10 17:21:06,154,4645,78,76,2990.22,5680.15,0.00
2024-12-10 17:21:06,154,4646,78,76,3053.03,5681.00,0.00
2024-12-10 17:21:06,155,4646,79,76,3033.33,5681.01,0.00
2024-12-10 17:21:06,154,4646,79,75,3044.40,5681.15,0.00
2024-12-10 17:21:06,155,4645,79,76,2979.74,5681.96,0.00
2024-12-10 17:21:06,155,4646,79,76,3015.34,5682.00,0.00
2024-12-10 17:21:06,156,4646,80,76,2996.01,5682.01,0.00
2024-12-10 17:21:06,155,4646,80,75,3006.56,5682.15,0.00
2024-12-10 17:21:06,155,4647,80,75,3031.97,5683.00,0.00
2024-12-10 17:21:06,156,4647,81,75,3012.53,5683.01,0.00
2024-12-10 17:21:06,155,4647,80,75,3024.18,5683.14,0.00
2024-12-10 17:21:06,155,4648,80,75,3012.20,5684.00,0.00
2024-12-10 17:21:06,156,4648,80,76,2992.89,5684.01,0.00
2024-12-10 17:21:06,155,4648,79,76,3004.18,5684.14,0.00
2024-12-10 17:21:06,155,4649,79,76,2992.56,5685.00,0.00
2024-12-10 17:21:06,156,4649,79,77,2973.37,5685.01,0.00
2024-12-10 17:21:06,155,4649,78,77,2984.54,5685.14,0.00
2024-12-10 17:21:06,155,4650,78,77,2972.91,5686.00,0.00
2024-12-10 17:21:06,156,4650,79,77,2953.85,5686.01,0.00
2024-12-10 17:21:06,155,4650,78,77,2967.80,5686.09,0.00
2024-12-10 17:21:06,154,4650,78,76,2984.14,5686.14,0.00
2024-12-10 17:21:06,154,4651,78,76,2972.43,5687.00,0.00
2024-12-10 17:21:06,155,4651,78,77,2953.25,5687.01,0.00
2024-12-10 17:21:06,154,4651,77,77,2964.72,5687.14,0.00
2024-12-10 17:21:06,154,4652,77,77,2953.00,5688.00,0.00
2024-12-10 17:21:06,155,4652,78,77,2933.95,5688.01,0.00
2024-12-10 17:21:06,154,4652,78,76,2945.29,5688.14,0.00
2024-12-10 17:21:06,154,4653,78,76,2933.42,5689.00,0.00
2024-12-10 17:21:06,155,4653,79,76,2914.49,5689.01,0.00
2024-12-10 17:21:06,154,4653,79,75,2925.71,5689.14,0.00
2024-12-10 17:21:06,155,4652,80,75,2870.79,5689.77,0.00
2024-12-10 17:21:06,155,4653,80,75,2903.29,5690.00,0.00
2024-12-10 17:21:06,156,4653,80,76,2884.68,5690.01,0.00
2024-12-10 17:21:06,157,4652,81,76,2863.43,5690.07,0.00
2024-12-10 17:21:06,158,4651,82,76,2879.88,5690.09,0.00
2024-12-10 17:21:06,157,4651,82,75,2912.39,5690.15,0.00
2024-12-10 17:21:06,157,4652,82,75,2934.57,5691.00,0.00
2024-12-10 17:21:06,158,4652,82,76,2915.99,5691.01,0.00
2024-12-10 17:21:06,157,4652,81,76,2926.65,5691.14,0.00
2024-12-10 17:21:06,157,4653,81,76,2980.69,5692.00,0.00
2024-12-10 17:21:06,158,4653,81,77,2961.83,5692.01,0.00
2024-12-10 17:21:06,157,4653,81,76,2974.93,5692.10,0.00
2024-12-10 17:21:06,156,4653,80,76,2991.83,5692.14,0.00
2024-12-10 17:21:06,155,4653,79,76,3010.76,5692.14,0.00
2024-12-10 17:21:06,154,4653,78,76,3029.94,5692.14,0.00
2024-12-10 17:21:07,154,4654,78,76,3007.38,5693.00,0.00
2024-12-10 17:21:07,155,4654,78,77,2987.98,5693.01,0.00
2024-12-10 17:21:07,154,4654,78,76,3005.18,5693.04,0.00
2024-12-10 17:21:07,154,4655,78,76,2972.49,5694.00,0.00
2024-12-10 17:21:07,155,4655,79,76,2953.32,5694.01,0.00
2024-12-10 17:21:07,154,4655,79,75,2963.37,5694.13,0.00
2024-12-10 17:21:07,153,4655,79,74,2962.12,5694.29,0.00
2024-12-10 17:21:07,154,4654,80,74,2937.73,5694.39,0.00
2024-12-10 17:21:07,154,4655,80,74,2944.47,5695.00,0.00
2024-12-10 17:21:07,155,4655,80,75,2925.47,5695.01,0.00
2024-12-10 17:21:07,154,4655,79,75,2936.21,5695.14,0.00
2024-12-10 17:21:07,153,4655,78,75,2943.97,5695.25,0.00
2024-12-10 17:21:07,153,4656,78,75,2970.70,5696.00,0.00
2024-12-10 17:21:07,154,4656,79,75,2951.41,5696.01,0.00
2024-12-10 17:21:07,153,4656,79,74,2962.74,5696.10,0.00
2024-12-10 17:21:07,152,4656,79,73,2980.00,5696.13,0.00
2024-12-10 17:21:07,151,4656,78,73,2999.36,5696.13,0.00
2024-12-10 17:21:07,150,4656,78,72,3012.48,5696.22,0.00
2024-12-10 17:21:07,149,4656,78,71,3013.41,5696.52,0.00
2024-12-10 17:21:07,149,4657,78,71,3021.60,5697.00,0.00
2024-12-10 17:21:07,150,4657,78,72,3001.46,5697.01,0.00
2024-12-10 17:21:07,149,4657,77,72,3009.11,5697.13,0.00
2024-12-10 17:21:07,149,4658,77,72,2981.89,5698.00,0.00
2024-12-10 17:21:07,150,4658,77,73,2962.01,5698.01,0.00
2024-12-10 17:21:07,149,4658,77,72,2966.01,5698.13,0.00
2024-12-10 17:21:07,150,4657,77,73,2941.68,5698.23,0.00
2024-12-10 17:21:07,150,4658,77,73,2938.39,5699.00,0.00
2024-12-10 17:21:07,151,4658,78,73,2918.93,5699.01,0.00
2024-12-10 17:21:07,150,4658,78,72,2850.62,5699.83,0.00
2024-12-10 17:21:07,150,4659,78,72,2905.77,5700.00,0.00
2024-12-10 17:21:07,151,4659,78,73,2886.53,5700.01,0.00
2024-12-10 17:21:07,150,4659,78,72,2892.73,5700.07,0.00
2024-12-10 17:21:07,149,4659,77,72,2908.35,5700.13,0.00
2024-12-10 17:21:07,148,4659,77,71,2895.05,5700.53,0.00
2024-12-10 17:21:07,148,4660,77,71,2879.96,5701.00,0.00
2024-12-10 17:21:07,149,4660,77,72,2860.63,5701.01,0.00
2024-12-10 17:21:07,148,4660,76,72,2876.51,5701.06,0.00
2024-12-10 17:21:07,147,4660,75,72,2892.23,5701.12,0.00
2024-12-10 17:21:07,146,4660,74,72,2839.63,5701.92,0.00
2024-12-10 17:21:07,146,4661,74,72,2874.07,5702.00,0.00
2024-12-10 17:21:07,147,4661,75,72,2854.51,5702.01,0.00
2024-12-10 17:21:07,146,4661,74,72,2863.22,5702.12,0.00
2024-12-10 17:21:07,147,4660,75,72,2842.97,5702.15,0.00
2024-12-10 17:21:07,146,4660,74,72,2879.88,5702.41,0.00
2024-12-10 17:21:07,146,4661,74,72,2871.04,5703.00,0.00
2024-12-10 17:21:07,147,4661,75,72,2851.51,5703.01,0.00
2024-12-10 17:21:07,146,4661,75,71,2856.28,5703.12,0.00
2024-12-10 17:21:07,145,4661,74,71,2861.79,5703.33,0.00
2024-12-10 17:21:07,146,4660,75,71,2835.98,5703.45,0.00
2024-12-10 17:21:07,146,4661,75,71,2885.25,5704.00,0.00
2024-12-10 17:21:07,147,4661,75,72,2865.62,5704.01,0.00
2024-12-10 17:21:07,146,4661,75,71,2870.03,5704.12,0.00
2024-12-10 17:21:07,146,4662,75,71,2883.39,5705.00,0.00
2024-12-10 17:21:07,147,4662,76,71,2863.77,5705.01,0.00
2024-12-10 17:21:07,146,4662,75,71,2872.71,5705.06,0.00
2024-12-10 17:21:07,145,4662,75,70,2888.22,5705.12,0.00
2024-12-10 17:21:07,144,4662,74,70,2865.86,5705.72,0.00
2024-12-10 17:21:07,144,4663,74,70,2882.89,5706.00,0.00
2024-12-10 17:21:07,145,4663,74,71,2863.01,5706.01,0.00
2024-12-10 17:21:07,146,4662,75,71,2781.25,5706.87,0.00
2024-12-10 17:21:07,146,4663,75,71,2822.95,5707.00,0.00
2024-12-10 17:21:07,147,4663,75,72,2803.75,5707.01,0.00
2024-12-10 17:21:07,146,4663,74,72,2815.57,5707.13,0.00
2024-12-10 17:21:07,145,4663,73,72,2812.61,5707.52,0.00
2024-12-10 17:21:07,144,4663,72,72,2831.31,5707.53,0.00
2024-12-10 17:21:07,143,4663,71,72,2832.23,5707.75,0.00
2024-12-10 17:21:07,143,4664,71,72,2894.72,5708.00,0.00
2024-12-10 17:21:07,144,4664,72,72,2874.62,5708.01,0.00
2024-12-10 17:21:07,143,4664,72,71,2887.18,5708.13,0.00
2024-12-10 17:21:07,144,4663,72,72,2861.59,5708.24,0.00
2024-12-10 17:21:07,144,4664,72,72,2882.46,5709.00,0.00
2024-12-10 17:21:07,145,4664,72,73,2862.58,5709.01,0.00
2024-12-10 17:21:07,144,4664,71,73,2880.49,5709.04,0.00
2024-12-10 17:21:07,143,4664,71,72,2895.07,5709.13,0.00
2024-12-10 17:21:07,143,4665,71,72,2912.13,5710.00,0.00
2024-12-10 17:21:07,144,4665,71,73,2891.91,5710.01,0.00
2024-12-10 17:21:07,143,4665,70,73,2909.35,5710.05,0.00
2024-12-10 17:21:07,142,4665,69,73,2925.45,5710.12,0.00
2024-12-10 17:21:07,141,4665,68,73,2918.00,5710.56,0.00
2024-12-10 17:21:07,141,4666,68,73,2920.30,5711.00,0.00
2024-12-10 17:21:07,142,4666,69,73,2899.73,5711.01,0.00
2024-12-10 17:21:07,141,4666,68,73,2913.05,5711.13,0.00
2024-12-10 17:21:07,140,4666,67,73,2900.07,5711.67,0.00
2024-12-10 17:21:07,140,4667,67,73,2910.39,5712.00,0.00
2024-12-10 17:21:07,141,4667,67,74,2889.75,5712.01,0.00
2024-12-10 17:21:07,140,4667,67,73,2903.09,5712.13,0.00
2024-12-10 17:21:07,139,4667,67,72,2885.64,5712.71,0.00
2024-12-10 17:21:07,139,4668,67,72,2902.82,5713.00,0.00
2024-12-10 17:21:07,140,4668,67,73,2882.09,5713.01,0.00
2024-12-10 17:21:07,140,4669,67,73,2854.00,5714.00,0.00
2024-12-10 17:21:07,141,4669,67,74,2833.76,5714.01,0.00
2024-12-10 17:21:07,140,4669,67,73,2845.52,5714.14,0.00
2024-12-10 17:21:07,139,4669,66,73,2841.30,5714.46,0.00
2024-12-10 17:21:07,139,4670,66,73,2846.32,5715.00,0.00
2024-12-10 17:21:07,140,4670,67,73,2825.99,5715.01,0.00
2024-12-10 17:21:07,139,4670,67,72,2845.09,5715.02,0.00
2024-12-10 17:21:07,138,4670,67,71,2864.88,5715.03,0.00
2024-12-10 17:21:07,137,4670,67,70,2879.40,5715.12,0.00
2024-12-10 17:21:07,136,4670,66,70,2900.15,5715.13,0.00
2024-12-10 17:21:07,137,4669,66,71,2836.21,5715.78,0.00
2024-12-10 17:21:07,137,4670,66,71,2879.82,5716.00,0.00
2024-12-10 17:21:07,138,4670,66,72,2858.95,5716.01,0.00
2024-12-10 17:21:07,137,4670,65,72,2876.45,5716.06,0.00
2024-12-10 17:21:07,136,4670,64,72,2893.54,5716.12,0.00
2024-12-10 17:21:07,135,4670,64,71,2914.55,5716.12,0.00
2024-12-10 17:21:07,134,4670,64,70,2902.58,5716.68,0.00
2024-12-10 17:21:07,134,4671,64,70,2967.26,5717.00,0.00
2024-12-10 17:21:08,135,4671,64,71,2945.28,5717.01,0.00
2024-12-10 17:21:08,134,4671,64,70,2964.54,5717.05,0.00
2024-12-10 17:21:08,133,4671,64,69,2982.56,5717.11,0.00
2024-12-10 17:21:08,132,4671,63,69,3004.72,5717.11,0.00
2024-12-10 17:21:08,132,4672,63,69,2971.33,5718.00,0.00
2024-12-10 17:21:08,133,4672,64,69,2948.99,5718.01,0.00
2024-12-10 17:21:08,132,4672,63,69,2964.87,5718.11,0.00
2024-12-10 17:21:08,132,4673,63,69,2922.39,5719.00,0.00
2024-12-10 17:21:08,133,4673,63,70,2900.42,5719.01,0.00
2024-12-10 17:21:08,132,4673,62,70,2915.50,5719.12,0.00
2024-12-10 17:21:08,131,4673,61,70,2883.40,5719.86,0.00
2024-12-10 17:21:08,132,4672,62,70,2860.70,5719.89,0.00
2024-12-10 17:21:08,132,4673,62,70,2889.07,5720.00,0.00
2024-12-10 17:21:08,133,4673,62,71,2867.35,5720.01,0.00
2024-12-10 17:21:08,132,4673,62,70,2882.18,5720.12,0.00
2024-12-10 17:21:08,132,4674,62,70,2889.47,5721.00,0.00
2024-12-10 17:21:08,133,4674,63,70,2867.74,5721.01,0.00
2024-12-10 17:21:08,132,4674,62,70,2882.57,5721.12,0.00
2024-12-10 17:21:08,131,4674,61,70,2838.86,5721.87,0.00
2024-12-10 17:21:08,131,4675,61,70,2865.92,5722.00,0.00
2024-12-10 17:21:08,132,4675,61,71,2844.21,5722.01,0.00
2024-12-10 17:21:08,131,4675,61,70,2857.97,5722.12,0.00
2024-12-10 17:21:08,130,4675,60,70,2838.35,5722.72,0.00
2024-12-10 17:21:08,130,4676,60,70,2856.71,5723.00,0.00
2024-12-10 17:21:08,131,4676,61,70,2834.90,5723.01,0.00
2024-12-10 17:21:08,130,4676,60,70,2856.27,5723.01,0.00
2024-12-10 17:21:08,129,4676,60,69,2868.44,5723.12,0.00
2024-12-10 17:21:08,128,4676,60,68,2833.64,5723.94,0.00
2024-12-10 17:21:08,128,4677,60,68,2874.83,5724.00,0.00
2024-12-10 17:21:08,129,4677,60,69,2852.55,5724.01,0.00
2024-12-10 17:21:08,128,4677,60,68,2873.50,5724.02,0.00
2024-12-10 17:21:08,127,4677,59,68,2885.95,5724.13,0.00
2024-12-10 17:21:08,127,4678,59,68,2869.43,5725.00,0.00
2024-12-10 17:21:08,128,4678,60,68,2847.01,5725.01,0.00
2024-12-10 17:21:08,127,4678,60,67,2859.27,5725.13,0.00
2024-12-10 17:21:08,127,4679,60,67,2841.97,5726.00,0.00
2024-12-10 17:21:08,128,4679,61,67,2819.77,5726.01,0.00
2024-12-10 17:21:08,127,4679,60,67,2833.87,5726.10,0.00
2024-12-10 17:21:08,126,4679,59,67,2854.42,5726.12,0.00
2024-12-10 17:21:08,126,4680,59,67,2834.49,5727.00,0.00
2024-12-10 17:21:08,127,4680,59,68,2812.18,5727.01,0.00
2024-12-10 17:21:08,128,4679,60,68,2788.10,5727.05,0.00
2024-12-10 17:21:08,127,4679,59,68,2826.01,5727.13,0.00
2024-12-10 17:21:08,126,4679,59,67,2823.08,5727.52,0.00
2024-12-10 17:21:08,126,4680,59,67,2822.83,5728.00,0.00
2024-12-10 17:21:08,127,4680,60,67,2800.61,5728.01,0.00
2024-12-10 17:21:08,126,4680,59,67,2809.31,5728.12,0.00
2024-12-10 17:21:08,126,4681,59,67,2825.63,5729.00,0.00
2024-12-10 17:21:08,127,4681,60,67,2803.38,5729.01,0.00
2024-12-10 17:21:08,126,4681,59,67,2814.01,5729.06,0.00
2024-12-10 17:21:08,125,4681,59,66,2833.34,5729.11,0.00
2024-12-10 17:21:08,124,4681,59,65,2819.04,5729.65,0.00
2024-12-10 17:21:08,124,4682,59,65,2818.54,5730.00,0.00
2024-12-10 17:21:08,125,4682,59,66,2796.00,5730.01,0.00
2024-12-10 17:21:08,124,4682,59,65,2817.20,5730.02,0.00
2024-12-10 17:21:08,123,4682,59,64,2839.18,5730.03,0.00
2024-12-10 17:21:08,122,4682,59,63,2858.26,5730.10,0.00
2024-12-10 17:21:08,121,4682,59,62,2881.40,5730.10,0.00
2024-12-10 17:21:08,120,4682,58,62,2877.28,5730.55,0.00
2024-12-10 17:21:08,119,4682,58,61,2900.17,5730.57,0.00
2024-12-10 17:21:08,118,4682,57,61,2911.29,5730.75,0.00
2024-12-10 17:21:08,118,4683,57,61,2932.39,5731.00,0.00
2024-12-10 17:21:08,119,4683,57,62,2907.75,5731.01,0.00
2024-12-10 17:21:08,118,4683,56,62,2926.61,5731.10,0.00
2024-12-10 17:21:08,118,4684,56,62,2909.57,5732.00,0.00
2024-12-10 17:21:08,119,4684,56,63,2885.12,5732.01,0.00
2024-12-10 17:21:08,119,4685,56,63,2864.90,5733.00,0.00
2024-12-10 17:21:08,120,4685,56,64,2841.03,5733.01,0.00
2024-12-10 17:21:08,119,4685,56,63,2858.69,5733.11,0.00
2024-12-10 17:21:08,119,4686,56,63,2843.45,5734.00,0.00
2024-12-10 17:21:08,120,4686,57,63,2819.75,5734.01,0.00
2024-12-10 17:21:08,120,4687,57,63,2795.75,5735.00,0.00
2024-12-10 17:21:08,121,4687,57,64,2772.65,5735.01,0.00
2024-12-10 17:21:08,120,4687,56,64,2789.11,5735.12,0.00
2024-12-10 17:21:08,119,4687,55,64,2802.27,5735.28,0.00
2024-12-10 17:21:08,119,4688,55,64,2792.36,5736.00,0.00
2024-12-10 17:21:08,120,4688,55,65,2769.09,5736.01,0.00
2024-12-10 17:21:08,119,4688,55,64,2785.65,5736.12,0.00
2024-12-10 17:21:08,118,4688,54,64,2774.87,5736.58,0.00
2024-12-10 17:21:08,118,4689,54,64,2787.57,5737.00,0.00
2024-12-10 17:21:08,119,4689,54,65,2764.15,5737.01,0.00
2024-12-10 17:21:08,118,4689,53,65,2780.81,5737.12,0.00
2024-12-10 17:21:08,117,4689,52,65,2781.09,5737.40,0.00
2024-12-10 17:21:08,117,4690,52,65,2787.52,5738.00,0.00
2024-12-10 17:21:08,118,4690,53,65,2763.89,5738.01,0.00
2024-12-10 17:21:08,118,4691,53,65,2747.50,5739.00,0.00
2024-12-10 17:21:08,119,4691,53,66,2724.41,5739.01,0.00
2024-12-10 17:21:08,118,4691,52,66,2740.74,5739.12,0.00
2024-12-10 17:21:08,117,4691,52,65,2763.67,5739.12,0.00
2024-12-10 17:21:08,116,4691,52,64,2787.00,5739.12,0.00
2024-12-10 17:21:08,116,4692,52,64,2776.62,5740.00,0.00
2024-12-10 17:21:08,117,4692,52,65,2752.89,5740.01,0.00
2024-12-10 17:21:08,117,4693,52,65,2732.48,5741.00,0.00
2024-12-10 17:21:08,118,4693,53,65,2709.32,5741.01,0.00
2024-12-10 17:21:08,117,4693,53,64,2716.84,5741.21,0.00
2024-12-10 17:21:08,118,4692,54,64,2676.18,5741.52,0.00
2024-12-10 17:21:08,117,4692,54,63,2708.22,5741.68,0.00
2024-12-10 17:21:08,117,4693,54,63,2736.46,5742.00,0.00
2024-12-10 17:21:08,118,4693,55,63,2713.27,5742.01,0.00
2024-12-10 17:21:08,117,4693,55,62,2734.51,5742.03,0.00
2024-12-10 17:21:08,116,4693,55,61,2752.18,5742.13,0.00
2024-12-10 17:21:08,115,4693,55,60,2750.60,5742.53,0.00
2024-12-10 17:21:08,114,4693,54,60,2756.65,5742.84,0.00
2024-12-10 17:21:08,114,4694,54,60,2848.40,5743.00,0.00
2024-12-10 17:21:08,115,4694,54,61,2823.63,5743.01,0.00
2024-12-10 17:21:08,114,4694,54,60,2836.85,5743.20,0.00
2024-12-10 17:21:09,114,4695,54,60,2838.78,5744.00,0.00
2024-12-10 17:21:09,115,4695,55,60,2814.10,5744.01,0.00
2024-12-10 17:21:09,114,4695,55,59,2831.27,5744.13,0.00
2024-12-10 17:21:09,114,4696,55,59,2828.67,5745.00,0.00
2024-12-10 17:21:09,115,4696,56,59,2804.07,5745.01,0.00
2024-12-10 17:21:09,115,4697,56,59,2795.13,5746.00,0.00
2024-12-10 17:21:09,116,4697,57,59,2771.03,5746.01,0.00
2024-12-10 17:21:09,115,4697,57,58,2787.68,5746.13,0.00
2024-12-10 17:21:09,115,4698,57,58,2785.45,5747.00,0.00
2024-12-10 17:21:09,116,4698,57,59,2761.44,5747.01,0.00
2024-12-10 17:21:09,115,4698,57,58,2777.80,5747.13,0.00
2024-12-10 17:21:09,115,4699,57,58,2775.43,5748.00,0.00
2024-12-10 17:21:09,116,4699,57,59,2751.50,5748.01,0.00
2024-12-10 17:21:09,115,4699,57,58,2768.63,5748.10,0.00
2024-12-10 17:21:09,114,4699,56,58,2791.42,5748.12,0.00
2024-12-10 17:21:09,113,4699,55,58,2815.61,5748.12,0.00
2024-12-10 17:21:09,113,4700,55,58,2813.63,5749.00,0.00
2024-12-10 17:21:09,114,4700,55,59,2788.95,5749.01,0.00
2024-12-10 17:21:09,114,4701,55,59,2771.52,5750.00,0.00
2024-12-10 17:21:09,115,4701,56,59,2747.42,5750.01,0.00
2024-12-10 17:21:09,114,4701,55,59,2770.51,5750.02,0.00
2024-12-10 17:21:09,113,4701,55,58,2793.01,5750.04,0.00
2024-12-10 17:21:09,114,4700,56,58,2765.27,5750.09,0.00
2024-12-10 17:21:09,113,4700,55,58,2827.42,5750.12,0.00
2024-12-10 17:21:09,112,4700,55,57,2852.15,5750.12,0.00
2024-12-10 17:21:09,111,4700,55,56,2877.33,5750.12,0.00
2024-12-10 17:21:09,111,4701,55,56,2868.50,5751.00,0.00
2024-12-10 17:21:09,112,4701,56,56,2842.89,5751.01,0.00
2024-12-10 17:21:09,112,4702,56,56,2877.08,5752.00,0.00
2024-12-10 17:21:09,113,4702,57,56,2851.62,5752.01,0.00
2024-12-10 17:21:09,114,4701,57,57,2774.32,5752.76,0.00
2024-12-10 17:21:09,114,4702,57,57,2832.31,5753.00,0.00
2024-12-10 17:21:09,115,4702,58,57,2807.69,5753.01,0.00
2024-12-10 17:21:09,116,4701,59,57,2761.50,5753.26,0.00
2024-12-10 17:21:09,116,4702,59,57,2853.48,5754.00,0.00
2024-12-10 17:21:09,117,4702,59,58,2829.09,5754.01,0.00
2024-12-10 17:21:09,116,4702,58,58,2844.80,5754.10,0.00
2024-12-10 17:21:09,115,4702,58,57,2863.43,5754.20,0.00
2024-12-10 17:21:09,116,4701,59,57,2837.75,5754.23,0.00
2024-12-10 17:21:09,117,4700,60,57,2821.72,5754.72,0.00
2024-12-10 17:21:09,118,4699,61,57,2807.13,5754.81,0.00
2024-12-10 17:21:09,118,4700,61,57,2902.89,5755.00,0.00
2024-12-10 17:21:09,119,4700,61,58,2878.49,5755.01,0.00
2024-12-10 17:21:09,119,4701,61,58,2998.57,5756.00,0.00
2024-12-10 17:21:09,120,4701,62,58,2973.58,5756.01,0.00
2024-12-10 17:21:09,119,4701,62,57,2958.71,5756.40,0.00
2024-12-10 17:21:09,119,4702,62,57,2969.74,5757.00,0.00
2024-12-10 17:21:09,120,4702,63,57,2944.99,5757.01,0.00
2024-12-10 17:21:09,121,4701,64,57,2908.66,5757.22,0.00
2024-12-10 17:21:09,120,4701,64,56,2961.92,5757.37,0.00
2024-12-10 17:21:09,119,4701,63,56,2961.91,5757.68,0.00
2024-12-10 17:21:09,119,4702,63,56,2992.17,5758.00,0.00
2024-12-10 17:21:09,120,4702,63,57,2967.24,5758.01,0.00
2024-12-10 17:21:09,119,4702,62,57,2986.28,5758.10,0.00
2024-12-10 17:21:09,119,4703,62,57,3023.02,5759.00,0.00
2024-12-10 17:21:09,120,4703,63,57,2997.82,5759.01,0.00
2024-12-10 17:21:09,119,4703,62,57,3017.24,5759.10,0.00
2024-12-10 17:21:09,118,4703,62,56,3042.32,5759.10,0.00
2024-12-10 17:21:09,118,4704,62,56,3019.82,5760.00,0.00
2024-12-10 17:21:09,119,4704,63,56,2994.44,5760.01,0.00
2024-12-10 17:21:09,118,4704,63,55,3014.00,5760.10,0.00
2024-12-10 17:21:09,117,4704,62,55,3012.08,5760.34,0.00
2024-12-10 17:21:09,116,4704,62,54,3027.41,5760.49,0.00
2024-12-10 17:21:09,116,4705,62,54,3038.29,5761.00,0.00
2024-12-10 17:21:09,117,4705,62,55,3012.33,5761.01,0.00
2024-12-10 17:21:09,116,4705,61,55,3031.91,5761.10,0.00
2024-12-10 17:21:09,115,4705,60,55,3047.63,5761.28,0.00
2024-12-10 17:21:09,114,4705,59,55,3068.61,5761.32,0.00
2024-12-10 17:21:09,114,4706,59,55,3063.13,5762.00,0.00
2024-12-10 17:21:09,115,4706,60,55,3036.49,5762.01,0.00
2024-12-10 17:21:09,114,4706,59,55,3056.53,5762.11,0.00
2024-12-10 17:21:09,113,4706,58,55,3026.70,5762.55,0.00
2024-12-10 17:21:09,113,4707,58,55,3051.31,5763.00,0.00
2024-12-10 17:21:09,114,4707,59,55,3024.55,5763.01,0.00
2024-12-10 17:21:09,115,4706,60,55,2993.52,5763.10,0.00
2024-12-10 17:21:09,114,4706,60,54,3048.61,5763.11,0.00
2024-12-10 17:21:09,115,4705,60,55,3008.94,5763.35,0.00
2024-12-10 17:21:09,114,4705,60,54,3060.37,5763.40,0.00
2024-12-10 17:21:09,113,4705,59,54,3079.33,5763.43,0.00
2024-12-10 17:21:09,113,4706,59,54,3085.64,5764.00,0.00
2024-12-10 17:21:09,114,4706,59,55,3058.57,5764.01,0.00
2024-12-10 17:21:09,113,4706,59,54,3079.55,5764.11,0.00
2024-12-10 17:21:09,112,4706,59,53,3084.70,5764.40,0.00
2024-12-10 17:21:09,112,4707,59,53,3200.50,5765.00,0.00
2024-12-10 17:21:09,113,4707,60,53,3172.17,5765.01,0.00
2024-12-10 17:21:09,112,4707,60,52,3198.96,5765.03,0.00
2024-12-10 17:21:09,113,4706,60,53,3111.78,5765.81,0.00
2024-12-10 17:21:09,114,4705,60,54,3091.01,5765.83,0.00
2024-12-10 17:21:09,114,4706,60,54,3137.71,5766.00,0.00
2024-12-10 17:21:09,115,4706,60,55,3110.43,5766.01,0.00
2024-12-10 17:21:09,114,4706,59,55,3135.69,5766.04,0.00
2024-12-10 17:21:09,113,4706,58,55,3159.89,5766.10,0.00
2024-12-10 17:21:09,112,4706,58,54,3187.59,5766.10,0.00
2024-12-10 17:21:09,111,4706,58,53,3210.17,5766.16,0.00
2024-12-10 17:21:09,110,4706,57,53,3236.86,5766.19,0.00
2024-12-10 17:21:09,110,4707,57,53,3327.34,5767.00,0.00
2024-12-10 17:21:09,111,4707,58,53,3297.37,5767.01,0.00
2024-12-10 17:21:09,110,4707,58,52,3323.69,5767.06,0.00
2024-12-10 17:21:09,109,4707,58,51,3352.08,5767.09,0.00
2024-12-10 17:21:09,108,4707,58,50,3364.69,5767.35,0.00
2024-12-10 17:21:09,107,4707,57,50,3383.98,5767.36,0.00
2024-12-10 17:21:09,107,4708,57,50,3393.10,5768.00,0.00
2024-12-10 17:21:09,108,4708,58,50,3361.68,5768.01,0.00
2024-12-10 17:21:09,108,4709,58,50,3344.87,5769.00,0.00
2024-12-10 17:21:09,109,4709,58,51,3314.18,5769.01,0.00
2024-12-10 17:21:09,109,4710,58,51,3295.94,5770.00,0.00
2024-12-10 17:21:09,110,4710,59,51,3265.97,5770.01,0.00
2024-12-10 17:21:09,109,4710,59,50,3268.33,5770.40,0.00
2024-12-10 17:21:09,109,4711,59,50,3275.30,5771.00,0.00
2024-12-10 17:21:09,110,4711,60,50,3245.53,5771.01,0.00
2024-12-10 17:21:09,109,4711,59,50,3266.73,5771.12,0.00
2024-12-10 17:21:09,108,4711,58,50,3296.44,5771.12,0.00
2024-12-10 17:21:09,107,4711,58,49,3326.71,5771.12,0.00
2024-12-10 17:21:10,107,4712,58,49,3317.88,5772.00,0.00
2024-12-10 17:21:10,108,4712,58,50,3287.16,5772.01,0.00
2024-12-10 17:21:10,107,4712,57,50,3312.74,5772.08,0.00
2024-12-10 17:21:10,107,4713,57,50,3304.10,5773.00,0.00
2024-12-10 17:21:10,108,4713,58,50,3273.50,5773.01,0.00
2024-12-10 17:21:10,107,4713,57,50,3297.67,5773.11,0.00
2024-12-10 17:21:10,108,4712,57,51,3245.67,5773.48,0.00
2024-12-10 17:21:10,108,4713,57,51,3293.38,5774.00,0.00
2024-12-10 17:21:10,109,4713,57,52,3263.16,5774.01,0.00
2024-12-10 17:21:10,108,4713,56,52,3287.01,5774.11,0.00
2024-12-10 17:21:10,108,4714,56,52,3331.38,5775.00,0.00
2024-12-10 17:21:10,109,4714,57,52,3300.81,5775.01,0.00
2024-12-10 17:21:10,109,4715,57,52,3278.33,5776.00,0.00
2024-12-10 17:21:10,110,4715,57,53,3248.53,5776.01,0.00
2024-12-10 17:21:10,109,4715,57,52,3272.02,5776.11,0.00
2024-12-10 17:21:10,108,4715,57,51,3287.88,5776.36,0.00
2024-12-10 17:21:10,108,4716,57,51,3278.20,5777.00,0.00
2024-12-10 17:21:10,109,4716,58,51,3248.13,5777.01,0.00
2024-12-10 17:21:10,108,4716,57,51,3215.23,5777.68,0.00
2024-12-10 17:21:10,108,4717,57,51,3247.72,5778.00,0.00
2024-12-10 17:21:10,109,4717,57,52,3217.93,5778.01,0.00
2024-12-10 17:21:10,108,4717,57,51,3240.81,5778.12,0.00
2024-12-10 17:21:10,109,4716,57,52,3143.60,5778.86,0.00
2024-12-10 17:21:10,109,4717,57,52,3195.15,5779.00,0.00
2024-12-10 17:21:10,110,4717,58,52,3166.10,5779.01,0.00
2024-12-10 17:21:10,109,4717,57,52,3194.62,5779.01,0.00
2024-12-10 17:21:10,108,4717,57,51,3220.48,5779.07,0.00
2024-12-10 17:21:10,107,4717,56,51,3247.90,5779.10,0.00
2024-12-10 17:21:10,106,4717,56,50,3245.48,5779.47,0.00
2024-12-10 17:21:10,106,4718,56,50,3302.80,5780.00,0.00
2024-12-10 17:21:10,107,4718,56,51,3271.93,5780.01,0.00
2024-12-10 17:21:10,106,4718,55,51,3229.95,5780.73,0.00
2024-12-10 17:21:10,106,4719,55,51,3263.72,5781.00,0.00
2024-12-10 17:21:10,107,4719,55,52,3233.21,5781.01,0.00
2024-12-10 17:21:10,106,4719,54,52,3258.31,5781.09,0.00
2024-12-10 17:21:10,105,4719,53,52,3284.02,5781.17,0.00
2024-12-10 17:21:10,104,4719,53,51,3300.10,5781.35,0.00
2024-12-10 17:21:10,104,4720,53,51,3303.48,5782.00,0.00
2024-12-10 17:21:10,105,4720,54,51,3272.02,5782.01,0.00
2024-12-10 17:21:10,104,4720,53,51,3297.96,5782.10,0.00
2024-12-10 17:21:10,104,4721,53,51,3272.29,5783.00,0.00
2024-12-10 17:21:10,105,4721,53,52,3241.12,5783.01,0.00
2024-12-10 17:21:10,104,4721,52,52,3266.77,5783.10,0.00
2024-12-10 17:21:10,104,4722,52,52,3217.75,5784.00,0.00
2024-12-10 17:21:10,105,4722,52,53,3187.10,5784.01,0.00
2024-12-10 17:21:10,104,4722,51,53,3181.11,5784.60,0.00
2024-12-10 17:21:10,104,4723,51,53,3150.66,5785.00,0.00
2024-12-10 17:21:10,105,4723,51,54,3120.65,5785.01,0.00
2024-12-10 17:21:10,104,4723,51,53,3145.13,5785.10,0.00
2024-12-10 17:21:10,103,4723,50,53,3129.42,5785.73,0.00
2024-12-10 17:21:10,103,4724,50,53,3100.91,5786.00,0.00
2024-12-10 17:21:10,104,4724,51,53,3071.10,5786.01,0.00
2024-12-10 17:21:10,103,4724,51,52,2995.91,5786.88,0.00
2024-12-10 17:21:10,103,4725,51,52,3017.86,5787.00,0.00
2024-12-10 17:21:10,104,4725,51,53,2988.84,5787.01,0.00
2024-12-10 17:21:10,103,4725,51,52,2993.24,5787.30,0.00
2024-12-10 17:21:10,102,4725,51,51,2990.17,5787.76,0.00
2024-12-10 17:21:10,101,4725,50,51,3012.52,5787.81,0.00
2024-12-10 17:21:10,100,4725,50,50,3028.13,5787.91,0.00
2024-12-10 17:21:10,100,4726,50,50,3066.80,5788.00,0.00
2024-12-10 17:21:10,101,4726,51,50,3036.43,5788.01,0.00
2024-12-10 17:21:10,100,4726,50,50,3059.36,5788.10,0.00
2024-12-10 17:21:10,99,4726,49,50,3074.59,5788.31,0.00
2024-12-10 17:21:10,99,4727,49,50,3052.63,5789.00,0.00
2024-12-10 17:21:10,100,4727,50,50,3022.10,5789.01,0.00
2024-12-10 17:21:10,99,4727,50,49,3050.28,5789.04,0.00
2024-12-10 17:21:10,98,4727,50,48,3069.52,5789.20,0.00
2024-12-10 17:21:10,99,4726,50,49,3038.52,5789.22,0.00
2024-12-10 17:21:10,98,4726,49,49,3034.91,5789.91,0.00
2024-12-10 17:21:10,98,4727,49,49,3076.92,5790.00,0.00
2024-12-10 17:21:10,99,4727,50,49,3045.84,5790.01,0.00
2024-12-10 17:21:10,98,4727,50,48,3005.20,5790.85,0.00
2024-12-10 17:21:10,98,4728,50,48,3080.51,5791.00,0.00
2024-12-10 17:21:10,99,4728,51,48,3049.40,5791.01,0.00
2024-12-10 17:21:10,98,4728,51,47,3073.85,5791.09,0.00
2024-12-10 17:21:10,97,4728,51,46,2995.61,5791.93,0.00
2024-12-10 17:21:10,97,4729,51,46,3047.42,5792.00,0.00
2024-12-10 17:21:10,98,4729,51,47,3016.32,5792.01,0.00
2024-12-10 17:21:10,97,4729,50,47,3015.26,5792.33,0.00
2024-12-10 17:21:10,96,4729,49,47,3013.71,5792.71,0.00
2024-12-10 17:21:10,95,4729,49,46,3018.54,5792.87,0.00
2024-12-10 17:21:10,95,4730,49,46,3052.71,5793.00,0.00
2024-12-10 17:21:10,96,4730,50,46,3020.91,5793.01,0.00
2024-12-10 17:21:10,96,4731,50,46,2945.55,5794.00,0.00
2024-12-10 17:21:10,97,4731,50,47,2915.19,5794.01,0.00
2024-12-10 17:21:10,96,4731,49,47,2936.79,5794.09,0.00
2024-12-10 17:21:10,97,4730,50,47,2893.95,5794.32,0.00
2024-12-10 17:21:10,96,4730,50,46,2957.14,5794.33,0.00
2024-12-10 17:21:10,96,4731,50,46,2877.98,5795.00,0.00
2024-12-10 17:21:10,97,4731,51,46,2848.31,5795.01,0.00
2024-12-10 17:21:10,96,4731,51,45,2868.30,5795.10,0.00
2024-12-10 17:21:10,95,4731,51,44,2764.34,5795.87,0.00
2024-12-10 17:21:10,94,4731,50,44,2785.35,5795.89,0.00
2024-12-10 17:21:10,94,4732,50,44,2886.72,5796.00,0.00
2024-12-10 17:21:10,95,4732,51,44,2856.34,5796.01,0.00
2024-12-10 17:21:10,95,4733,51,44,2755.54,5797.00,0.00
2024-12-10 17:21:10,96,4733,52,44,2726.84,5797.01,0.00
2024-12-10 17:21:10,95,4733,52,43,2754.70,5797.01,0.00
2024-12-10 17:21:10,94,4733,52,42,2778.49,5797.10,0.00
2024-12-10 17:21:10,93,4733,51,42,2792.04,5797.29,0.00
2024-12-10 17:21:10,92,4733,50,42,2759.13,5797.70,0.00
2024-12-10 17:21:10,91,4733,50,41,2774.08,5797.81,0.00
2024-12-10 17:21:10,91,4734,50,41,2781.74,5798.00,0.00
2024-12-10 17:21:10,92,4734,50,42,2751.51,5798.01,0.00
2024-12-10 17:21:10,91,4734,49,42,2780.47,5798.02,0.00
2024-12-10 17:21:10,92,4733,49,43,2749.62,5798.05,0.00
2024-12-10 17:21:10,91,4733,49,42,2796.56,5798.10,0.00
2024-12-10 17:21:10,90,4733,49,41,2826.99,5798.10,0.00
2024-12-10 17:21:10,89,4733,48,41,2831.19,5798.35,0.00
2024-12-10 17:21:10,89,4734,48,41,2763.88,5799.00,0.00
2024-12-10 17:21:10,90,4734,49,41,2733.17,5799.01,0.00
2024-12-10 17:21:10,89,4734,48,41,2750.67,5799.09,0.00
2024-12-10 17:21:10,88,4734,47,41,2750.26,5799.35,0.00
2024-12-10 17:21:11,88,4735,47,41,2737.68,5800.00,0.00
2024-12-10 17:21:11,89,4735,47,42,2706.92,5800.01,0.00
2024-12-10 17:21:11,88,4735,47,41,2702.15,5800.27,0.00
2024-12-10 17:21:11,87,4735,46,41,2724.17,5800.36,0.00
2024-12-10 17:21:11,86,4735,46,40,2681.76,5800.78,0.00
2024-12-10 17:21:11,86,4736,46,40,2667.12,5801.00,0.00
2024-12-10 17:21:11,87,4736,46,41,2636.46,5801.01,0.00
2024-12-10 17:21:11,86,4736,45,41,2652.87,5801.06,0.00
2024-12-10 17:21:11,85,4736,45,40,2682.05,5801.08,0.00
2024-12-10 17:21:11,84,4736,45,39,2684.52,5801.39,0.00
2024-12-10 17:21:11,83,4736,45,38,2633.18,5801.81,0.00
2024-12-10 17:21:11,82,4736,44,38,2661.22,5801.83,0.00
2024-12-10 17:21:11,81,4736,43,38,2667.81,5801.91,0.00
2024-12-10 17:21:11,81,4737,43,38,2723.66,5802.00,0.00
2024-12-10 17:21:11,82,4737,44,38,2690.45,5802.01,0.00
2024-12-10 17:21:11,81,4737,43,38,2722.95,5802.01,0.00
2024-12-10 17:21:11,80,4737,42,38,2752.67,5802.08,0.00
2024-12-10 17:21:11,79,4737,42,37,2755.67,5802.39,0.00
2024-12-10 17:21:11,78,4737,41,37,2787.51,5802.45,0.00
2024-12-10 17:21:11,77,4737,40,37,2805.29,5802.58,0.00
2024-12-10 17:21:11,77,4738,40,37,2805.44,5803.00,0.00
2024-12-10 17:21:11,78,4738,40,38,2769.48,5803.01,0.00
2024-12-10 17:21:11,77,4738,40,37,2781.40,5803.29,0.00
2024-12-10 17:21:11,76,4738,39,37,2784.47,5803.66,0.00
2024-12-10 17:21:11,75,4738,39,36,2808.53,5803.71,0.00
2024-12-10 17:21:11,75,4739,39,36,2840.42,5804.00,0.00
2024-12-10 17:21:11,76,4739,39,37,2803.04,5804.01,0.00
2024-12-10 17:21:11,75,4739,39,36,2800.36,5804.52,0.00
2024-12-10 17:21:11,74,4739,39,35,2825.00,5804.66,0.00
2024-12-10 17:21:11,73,4739,38,35,2847.53,5804.75,0.00
2024-12-10 17:21:11,72,4739,38,34,2882.24,5804.76,0.00
2024-12-10 17:21:11,72,4740,38,34,2942.46,5805.00,0.00
2024-12-10 17:21:11,73,4740,38,35,2902.16,5805.01,0.00
2024-12-10 17:21:11,72,4740,37,35,2937.67,5805.08,0.00
2024-12-10 17:21:11,71,4740,37,34,2924.51,5805.75,0.00
2024-12-10 17:21:11,71,4741,37,34,2985.87,5806.00,0.00
2024-12-10 17:21:11,72,4741,38,34,2944.40,5806.01,0.00
2024-12-10 17:21:11,72,4742,38,34,2945.61,5807.00,0.00
2024-12-10 17:21:11,73,4742,38,35,2905.26,5807.01,0.00
2024-12-10 17:21:11,72,4742,37,35,2930.07,5807.24,0.00
2024-12-10 17:21:11,72,4743,37,35,2947.15,5808.00,0.00
2024-12-10 17:21:11,73,4743,38,35,2906.78,5808.01,0.00
2024-12-10 17:21:11,73,4744,38,35,2902.53,5809.00,0.00
2024-12-10 17:21:11,74,4744,39,35,2863.30,5809.01,0.00
2024-12-10 17:21:11,73,4744,38,35,2865.35,5809.52,0.00
2024-12-10 17:21:11,72,4744,37,35,2874.21,5809.83,0.00
2024-12-10 17:21:11,72,4745,37,35,2945.37,5810.00,0.00
2024-12-10 17:21:11,73,4745,37,36,2905.02,5810.01,0.00
2024-12-10 17:21:11,73,4746,37,36,2920.20,5811.00,0.00
2024-12-10 17:21:11,74,4746,38,36,2880.74,5811.01,0.00
2024-12-10 17:21:11,73,4746,37,36,2914.68,5811.10,0.00
2024-12-10 17:21:11,72,4746,37,35,2922.60,5811.58,0.00
2024-12-10 17:21:11,72,4747,37,35,2979.41,5812.00,0.00
2024-12-10 17:21:11,73,4747,37,36,2938.60,5812.01,0.00
2024-12-10 17:21:11,72,4747,37,35,2973.81,5812.10,0.00
2024-12-10 17:21:11,71,4747,36,35,2982.38,5812.61,0.00
2024-12-10 17:21:11,71,4748,36,35,3041.64,5813.00,0.00
2024-12-10 17:21:11,72,4748,37,35,2999.39,5813.01,0.00
2024-12-10 17:21:11,71,4748,37,34,3035.95,5813.10,0.00
2024-12-10 17:21:11,71,4749,37,34,3059.24,5814.00,0.00
2024-12-10 17:21:11,72,4749,38,34,3016.75,5814.01,0.00
2024-12-10 17:21:11,72,4750,38,34,3032.17,5815.00,0.00
2024-12-10 17:21:11,73,4750,38,35,2990.64,5815.01,0.00
2024-12-10 17:21:11,72,4750,37,35,3026.56,5815.10,0.00
2024-12-10 17:21:11,72,4751,37,35,3049.59,5816.00,0.00
2024-12-10 17:21:11,73,4751,37,36,3007.82,5816.01,0.00
2024-12-10 17:21:11,72,4751,37,35,3043.98,5816.10,0.00
2024-12-10 17:21:11,72,4752,37,35,3070.38,5817.00,0.00
2024-12-10 17:21:11,73,4752,37,36,3028.32,5817.01,0.00
2024-12-10 17:21:11,72,4752,37,35,3064.77,5817.10,0.00
2024-12-10 17:21:11,72,4753,37,35,3091.15,5818.00,0.00
2024-12-10 17:21:11,73,4753,38,35,3048.81,5818.01,0.00
2024-12-10 17:21:11,72,4753,37,35,3064.77,5818.40,0.00
2024-12-10 17:21:11,72,4754,37,35,3103.64,5819.00,0.00
2024-12-10 17:21:11,73,4754,38,35,3061.13,5819.01,0.00
2024-12-10 17:21:11,72,4754,37,35,3098.03,5819.10,0.00
2024-12-10 17:21:11,72,4755,37,35,3108.55,5820.00,0.00
2024-12-10 17:21:11,73,4755,37,36,3065.97,5820.01,0.00
2024-12-10 17:21:11,73,4756,37,36,3057.22,5821.00,0.00
2024-12-10 17:21:11,74,4756,37,37,3015.91,5821.01,0.00
2024-12-10 17:21:11,73,4756,36,37,3051.68,5821.10,0.00
2024-12-10 17:21:11,72,4756,35,37,3013.30,5821.81,0.00
2024-12-10 17:21:11,72,4757,35,37,3083.01,5822.00,0.00
2024-12-10 17:21:11,73,4757,36,37,3040.78,5822.01,0.00
2024-12-10 17:21:11,74,4756,37,37,2959.15,5822.73,0.00
2024-12-10 17:21:11,74,4757,37,37,3016.44,5823.00,0.00
2024-12-10 17:21:11,75,4757,38,37,2976.22,5823.01,0.00
2024-12-10 17:21:11,74,4757,37,37,2950.55,5823.73,0.00
2024-12-10 17:21:11,74,4758,37,37,3090.22,5824.00,0.00
2024-12-10 17:21:11,75,4758,37,38,3049.01,5824.01,0.00
2024-12-10 17:21:11,76,4757,37,39,2986.35,5824.32,0.00
2024-12-10 17:21:11,76,4758,37,39,3073.53,5825.00,0.00
2024-12-10 17:21:11,77,4758,38,39,3033.61,5825.01,0.00
2024-12-10 17:21:11,76,4758,38,38,3060.86,5825.11,0.00
2024-12-10 17:21:11,77,4757,39,38,3016.58,5825.21,0.00
2024-12-10 17:21:11,77,4758,39,38,3173.50,5826.00,0.00
2024-12-10 17:21:11,78,4758,40,38,3132.81,5826.01,0.00
2024-12-10 17:21:11,78,4759,40,38,3192.25,5827.00,0.00
2024-12-10 17:21:11,79,4759,40,39,3151.84,5827.01,0.00
2024-12-10 17:21:11,79,4760,40,39,3116.82,5828.00,0.00
2024-12-10 17:21:11,80,4760,40,40,3077.86,5828.01,0.00
2024-12-10 17:21:11,80,4761,40,40,3019.48,5829.00,0.00
2024-12-10 17:21:11,81,4761,40,41,2982.20,5829.01,0.00
2024-12-10 17:21:11,80,4761,40,40,3000.43,5829.08,0.00
2024-12-10 17:21:11,79,4761,39,40,2975.34,5829.72,0.00
2024-12-10 17:21:11,79,4762,39,40,2982.11,5830.00,0.00
2024-12-10 17:21:11,80,4762,39,41,2944.83,5830.01,0.00
2024-12-10 17:21:11,79,4762,38,41,2974.97,5830.04,0.00
2024-12-10 17:21:11,78,4762,38,40,2906.95,5830.86,0.00
2024-12-10 17:21:11,78,4763,38,40,2961.24,5831.00,0.00
2024-12-10 17:21:11,79,4763,38,41,2923.76,5831.01,0.00
2024-12-10 17:21:11,78,4763,38,40,2954.32,5831.08,0.00
2024-12-10 17:21:12,78,4764,38,40,2891.12,5832.00,0.00
2024-12-10 17:21:12,79,4764,39,40,2854.52,5832.01,0.00
2024-12-10 17:21:12,78,4764,38,40,2821.56,5832.69,0.00
2024-12-10 17:21:12,78,4765,38,40,2794.75,5833.00,0.00
2024-12-10 17:21:12,79,4765,38,41,2759.37,5833.01,0.00
2024-12-10 17:21:12,78,4765,38,40,2786.41,5833.08,0.00
2024-12-10 17:21:12,78,4766,38,40,2674.52,5834.00,0.00
2024-12-10 17:21:12,79,4766,39,40,2640.66,5834.01,0.00
2024-12-10 17:21:12,78,4766,39,39,2673.19,5834.01,0.00
2024-12-10 17:21:12,77,4766,38,39,2704.14,5834.07,0.00
2024-12-10 17:21:12,76,4766,37,39,2701.05,5834.58,0.00
2024-12-10 17:21:12,77,4765,37,40,2650.06,5834.68,0.00
2024-12-10 17:21:12,76,4765,36,40,2643.63,5834.91,0.00
2024-12-10 17:21:12,76,4766,36,40,2685.47,5835.00,0.00
2024-12-10 17:21:12,77,4766,37,40,2650.60,5835.01,0.00
2024-12-10 17:21:12,76,4766,37,39,2575.15,5835.72,0.00
2024-12-10 17:21:12,75,4766,37,38,2542.55,5835.89,0.00
2024-12-10 17:21:12,75,4767,37,38,2660.49,5836.00,0.00
2024-12-10 17:21:12,76,4767,38,38,2625.49,5836.01,0.00
2024-12-10 17:21:12,75,4767,37,38,2559.99,5836.72,0.00
2024-12-10 17:21:12,74,4767,36,38,2562.87,5836.88,0.00
2024-12-10 17:21:12,74,4767,36,38,2600.27,5837.00,0.00
2024-12-10 17:21:12,75,4767,36,39,2565.60,5837.01,0.00
2024-12-10 17:21:12,74,4767,36,38,2596.34,5837.07,0.00
2024-12-10 17:21:12,74,4768,36,38,2499.66,5838.00,0.00
2024-12-10 17:21:12,75,4768,36,39,2466.33,5838.01,0.00
2024-12-10 17:21:12,74,4768,36,38,2452.55,5838.55,0.00
2024-12-10 17:21:12,73,4768,36,37,2465.99,5838.64,0.00
2024-12-10 17:21:12,72,4768,36,36,2488.16,5838.65,0.00
2024-12-10 17:21:12,72,4769,36,36,2473.15,5839.00,0.00
2024-12-10 17:21:12,73,4769,37,36,2439.27,5839.01,0.00
2024-12-10 17:21:12,72,4769,37,35,2469.11,5839.07,0.00
2024-12-10 17:21:12,71,4769,36,35,2499.96,5839.08,0.00
2024-12-10 17:21:12,70,4769,35,35,2459.21,5839.73,0.00
2024-12-10 17:21:12,70,4770,35,35,2487.06,5840.00,0.00
2024-12-10 17:21:12,71,4770,35,36,2452.03,5840.01,0.00
2024-12-10 17:21:12,70,4770,35,35,2482.90,5840.07,0.00
2024-12-10 17:21:12,69,4770,35,34,2487.48,5840.61,0.00
2024-12-10 17:21:12,68,4770,35,33,2500.26,5840.68,0.00
2024-12-10 17:21:12,68,4771,35,33,2529.09,5841.00,0.00
2024-12-10 17:21:12,69,4771,36,33,2492.43,5841.02,0.00
2024-12-10 17:21:12,68,4771,35,33,2491.13,5841.63,0.00
2024-12-10 17:21:12,67,4771,35,32,2520.86,5841.64,0.00
2024-12-10 17:21:12,67,4772,35,32,2550.91,5842.00,0.00
2024-12-10 17:21:12,68,4772,35,33,2513.40,5842.02,0.00
2024-12-10 17:21:12,67,4772,35,32,2464.67,5842.90,0.00
2024-12-10 17:21:12,67,4773,35,32,2545.86,5843.00,0.00
2024-12-10 17:21:12,68,4773,35,33,2508.42,5843.02,0.00
2024-12-10 17:21:12,67,4773,35,32,2541.51,5843.08,0.00
2024-12-10 17:21:12,66,4773,34,32,2532.49,5843.77,0.00
2024-12-10 17:21:12,65,4773,33,32,2556.01,5843.85,0.00
2024-12-10 17:21:12,64,4773,33,31,2590.96,5843.86,0.00
2024-12-10 17:21:12,64,4774,33,31,2674.17,5844.00,0.00
2024-12-10 17:21:12,65,4774,33,32,2633.03,5844.02,0.00
2024-12-10 17:21:12,64,4774,32,32,2669.62,5844.08,0.00
2024-12-10 17:21:12,64,4775,32,32,2707.00,5845.00,0.00
2024-12-10 17:21:12,65,4775,32,33,2665.36,5845.02,0.00
2024-12-10 17:21:12,64,4775,31,33,2702.45,5845.08,0.00
2024-12-10 17:21:12,64,4776,31,33,2740.35,5846.00,0.00
2024-12-10 17:21:12,65,4776,32,33,2698.19,5846.02,0.00
2024-12-10 17:21:12,64,4776,31,33,2735.80,5846.08,0.00
2024-12-10 17:21:12,64,4777,31,33,2773.71,5847.00,0.00
2024-12-10 17:21:12,65,4777,32,33,2731.04,5847.02,0.00
2024-12-10 17:21:12,66,4776,32,34,2681.71,5847.18,0.00
2024-12-10 17:21:12,66,4777,32,34,2804.42,5848.00,0.00
2024-12-10 17:21:12,67,4777,32,35,2762.56,5848.02,0.00
2024-12-10 17:21:12,67,4778,32,35,2880.01,5849.00,0.00
2024-12-10 17:21:12,68,4778,33,35,2837.66,5849.02,0.00
2024-12-10 17:21:12,67,4778,33,34,2875.66,5849.08,0.00
2024-12-10 17:21:12,67,4779,33,34,2909.32,5850.00,0.00
2024-12-10 17:21:12,68,4779,34,34,2866.54,5850.02,0.00
2024-12-10 17:21:12,67,4779,33,34,2904.96,5850.08,0.00
2024-12-10 17:21:12,67,4780,33,34,2938.63,5851.00,0.00
2024-12-10 17:21:12,68,4780,34,34,2895.42,5851.02,0.00
2024-12-10 17:21:12,68,4781,34,34,2924.31,5852.00,0.00
2024-12-10 17:21:12,69,4781,35,34,2881.93,5852.02,0.00
2024-12-10 17:21:12,68,4781,35,33,2919.17,5852.09,0.00
2024-12-10 17:21:12,68,4782,35,33,2952.36,5853.00,0.00
2024-12-10 17:21:12,69,4782,36,33,2909.57,5853.02,0.00
2024-12-10 17:21:12,68,4782,36,32,2950.64,5853.03,0.00
2024-12-10 17:21:12,67,4782,35,32,2991.20,5853.08,0.00
2024-12-10 17:21:12,67,4783,35,32,3024.89,5854.00,0.00
2024-12-10 17:21:12,68,4783,36,32,2980.41,5854.02,0.00
2024-12-10 17:21:12,67,4783,36,31,3022.28,5854.05,0.00
2024-12-10 17:21:12,66,4783,35,31,3065.44,5854.08,0.00
2024-12-10 17:21:12,65,4783,34,31,3111.70,5854.08,0.00
2024-12-10 17:21:12,65,4784,34,31,3148.23,5855.00,0.00
2024-12-10 17:21:12,66,4784,35,31,3100.53,5855.02,0.00
2024-12-10 17:21:12,65,4784,34,31,3126.84,5855.37,0.00
2024-12-10 17:21:12,65,4785,34,31,3179.91,5856.00,0.00
2024-12-10 17:21:12,66,4785,34,32,3131.73,5856.02,0.00
2024-12-10 17:21:12,65,4785,33,32,3175.43,5856.08,0.00
2024-12-10 17:21:12,65,4786,33,32,3210.97,5857.00,0.00
2024-12-10 17:21:12,66,4786,33,33,3162.32,5857.02,0.00
2024-12-10 17:21:12,66,4787,33,33,3192.05,5858.00,0.00
2024-12-10 17:21:12,67,4787,33,34,3144.41,5858.02,0.00
2024-12-10 17:21:12,66,4787,33,33,3187.64,5858.08,0.00
2024-12-10 17:21:12,66,4788,33,33,3219.78,5859.00,0.00
2024-12-10 17:21:12,67,4788,34,33,3171.73,5859.02,0.00
2024-12-10 17:21:12,66,4788,33,33,3215.37,5859.08,0.00
2024-12-10 17:21:12,66,4789,33,33,3246.85,5860.00,0.00
2024-12-10 17:21:12,67,4789,34,33,3198.39,5860.02,0.00
2024-12-10 17:21:12,67,4790,34,33,3222.03,5861.00,0.00
2024-12-10 17:21:12,68,4790,35,33,3174.65,5861.02,0.00
2024-12-10 17:21:12,67,4790,35,32,3217.69,5861.08,0.00
2024-12-10 17:21:12,68,4789,35,33,3114.90,5861.93,0.00
2024-12-10 17:21:12,68,4790,35,33,3200.76,5862.00,0.00
2024-12-10 17:21:12,69,4790,35,34,3154.38,5862.02,0.00
2024-12-10 17:21:12,69,4791,35,34,3254.18,5863.00,0.00
2024-12-10 17:21:12,70,4791,35,35,3207.70,5863.01,0.00
2024-12-10 17:21:12,69,4791,34,35,3252.49,5863.03,0.00
2024-12-10 17:21:12,68,4791,33,35,3297.76,5863.06,0.00
2024-12-10 17:21:12,67,4791,33,34,3346.10,5863.06,0.00
2024-12-10 17:21:12,67,4792,33,34,3341.33,5864.00,0.00
2024-12-10 17:21:12,68,4792,33,35,3292.19,5864.02,0.00
2024-12-10 17:21:13,68,4793,33,35,3261.65,5865.00,0.00
2024-12-10 17:21:13,69,4793,33,36,3214.38,5865.02,0.00
2024-12-10 17:21:13,68,4793,33,35,3258.23,5865.06,0.00
2024-12-10 17:21:13,67,4793,33,34,3187.05,5865.96,0.00
2024-12-10 17:21:13,67,4794,33,34,3272.00,5866.00,0.00
2024-12-10 17:21:13,68,4794,34,34,3223.88,5866.02,0.00
2024-12-10 17:21:13,67,4794,34,33,3268.52,5866.06,0.00
2024-12-10 17:21:13,68,4793,35,33,3210.13,5866.27,0.00
2024-12-10 17:21:13,67,4793,35,32,3315.64,5866.28,0.00
2024-12-10 17:21:13,66,4793,35,31,3335.76,5866.56,0.00
2024-12-10 17:21:13,66,4794,35,31,3380.90,5867.00,0.00
2024-12-10 17:21:13,67,4794,35,32,3330.44,5867.02,0.00
2024-12-10 17:21:13,66,4794,35,31,3357.49,5867.41,0.00
2024-12-10 17:21:13,66,4795,35,31,3481.74,5868.00,0.00
2024-12-10 17:21:13,67,4795,36,31,3429.77,5868.02,0.00
2024-12-10 17:21:13,66,4795,36,30,3424.59,5868.85,0.00
2024-12-10 17:21:13,66,4796,36,30,3504.76,5869.00,0.00
2024-12-10 17:21:13,67,4796,37,30,3452.45,5869.02,0.00
2024-12-10 17:21:13,67,4797,37,30,3482.82,5870.00,0.00
2024-12-10 17:21:13,68,4797,37,31,3431.60,5870.02,0.00
2024-12-10 17:21:13,68,4798,37,31,3460.68,5871.00,0.00
2024-12-10 17:21:13,69,4798,37,32,3410.52,5871.02,0.00
2024-12-10 17:21:13,68,4798,36,32,3457.25,5871.06,0.00
2024-12-10 17:21:13,68,4799,36,32,3488.90,5872.00,0.00
2024-12-10 17:21:13,69,4799,37,32,3438.34,5872.02,0.00
2024-12-10 17:21:13,69,4800,37,32,3465.87,5873.00,0.00
2024-12-10 17:21:13,70,4800,37,33,3416.36,5873.01,0.00
2024-12-10 17:21:13,69,4800,36,33,3462.49,5873.06,0.00
2024-12-10 17:21:13,68,4800,35,33,3505.33,5873.19,0.00
2024-12-10 17:21:13,69,4799,35,34,3431.76,5873.61,0.00
2024-12-10 17:21:13,69,4800,35,34,3512.60,5874.00,0.00
2024-12-10 17:21:13,70,4800,35,35,3462.42,5874.01,0.00
2024-12-10 17:21:13,70,4801,35,35,3566.46,5875.00,0.00
2024-12-10 17:21:13,71,4801,36,35,3516.23,5875.01,0.00
2024-12-10 17:21:13,70,4801,35,35,3563.13,5875.06,0.00
2024-12-10 17:21:13,70,4802,35,35,3584.87,5876.00,0.00
2024-12-10 17:21:13,71,4802,35,36,3534.38,5876.01,0.00
2024-12-10 17:21:13,71,4803,35,36,3555.82,5877.00,0.00
2024-12-10 17:21:13,72,4803,36,36,3506.44,5877.01,0.00
2024-12-10 17:21:13,71,4803,35,36,3551.87,5877.06,0.00
2024-12-10 17:21:13,70,4803,35,35,3597.29,5877.14,0.00
2024-12-10 17:21:13,70,4804,35,35,3631.46,5878.00,0.00
2024-12-10 17:21:13,71,4804,35,36,3580.32,5878.01,0.00
2024-12-10 17:21:13,70,4804,34,36,3624.36,5878.13,0.00
2024-12-10 17:21:13,70,4805,34,36,3657.70,5879.00,0.00
2024-12-10 17:21:13,71,4805,35,36,3606.19,5879.01,0.00
2024-12-10 17:21:13,71,4806,35,36,3631.64,5880.00,0.00
2024-12-10 17:21:13,72,4806,35,37,3581.21,5880.01,0.00
2024-12-10 17:21:13,72,4807,35,37,3600.72,5881.00,0.00
2024-12-10 17:21:13,73,4807,36,37,3551.39,5881.01,0.00
2024-12-10 17:21:13,72,4807,36,36,3583.06,5881.31,0.00
2024-12-10 17:21:13,72,4808,36,36,3610.76,5882.00,0.00
2024-12-10 17:21:13,73,4808,36,37,3561.30,5882.01,0.00
2024-12-10 17:21:13,73,4809,36,37,3560.85,5883.00,0.00
2024-12-10 17:21:13,74,4809,36,38,3512.73,5883.01,0.00
2024-12-10 17:21:13,73,4809,35,38,3513.46,5883.58,0.00
2024-12-10 17:21:13,73,4810,35,38,3569.42,5884.00,0.00
2024-12-10 17:21:13,74,4810,35,39,3521.19,5884.01,0.00
2024-12-10 17:21:13,74,4811,35,39,3543.26,5885.00,0.00
2024-12-10 17:21:13,75,4811,35,40,3496.01,5885.01,0.00
2024-12-10 17:21:13,75,4812,35,40,3517.01,5886.00,0.00
2024-12-10 17:21:13,76,4812,36,40,3470.73,5886.01,0.00
2024-12-10 17:21:13,76,4813,36,40,3490.69,5887.00,0.00
2024-12-10 17:21:13,77,4813,36,41,3445.36,5887.01,0.00
2024-12-10 17:21:13,77,4814,36,41,3464.29,5888.00,0.00
2024-12-10 17:21:13,78,4814,36,42,3419.88,5888.01,0.00
2024-12-10 17:21:13,77,4814,35,42,3461.25,5888.05,0.00
2024-12-10 17:21:13,76,4814,34,42,3504.70,5888.08,0.00
2024-12-10 17:21:13,75,4814,34,41,3550.99,5888.08,0.00
2024-12-10 17:21:13,75,4815,34,41,3573.52,5889.00,0.00
2024-12-10 17:21:13,76,4815,35,41,3526.50,5889.01,0.00
2024-12-10 17:21:13,75,4815,35,40,3570.39,5889.05,0.00
2024-12-10 17:21:13,75,4816,35,40,3586.63,5890.00,0.00
2024-12-10 17:21:13,76,4816,36,40,3539.43,5890.01,0.00
2024-12-10 17:21:13,75,4816,35,40,3583.50,5890.05,0.00
2024-12-10 17:21:13,75,4817,35,40,3586.58,5891.00,0.00
2024-12-10 17:21:13,76,4817,35,41,3539.39,5891.01,0.00
2024-12-10 17:21:13,76,4818,35,41,3526.89,5892.00,0.00
2024-12-10 17:21:13,77,4818,36,41,3481.08,5892.01,0.00
2024-12-10 17:21:13,77,4819,36,41,3454.89,5893.00,0.00
2024-12-10 17:21:13,78,4819,36,42,3410.60,5893.01,0.00
2024-12-10 17:21:13,77,4819,36,41,3396.65,5893.77,0.00
2024-12-10 17:21:13,77,4820,36,41,3444.55,5894.00,0.00
2024-12-10 17:21:13,78,4820,37,41,3400.39,5894.01,0.00
2024-12-10 17:21:13,77,4820,36,41,3398.74,5894.73,0.00
2024-12-10 17:21:13,77,4821,36,41,3428.75,5895.00,0.00
2024-12-10 17:21:13,78,4821,36,42,3384.80,5895.01,0.00
2024-12-10 17:21:13,78,4822,36,42,3357.71,5896.00,0.00
2024-12-10 17:21:13,79,4822,37,42,3315.20,5896.01,0.00
2024-12-10 17:21:13,78,4822,36,42,3284.30,5896.77,0.00
2024-12-10 17:21:13,78,4823,36,42,3346.49,5897.00,0.00
2024-12-10 17:21:13,79,4823,36,43,3304.13,5897.01,0.00
2024-12-10 17:21:13,78,4823,35,43,3346.24,5897.01,0.00
2024-12-10 17:21:13,77,4823,34,43,3330.38,5897.74,0.00
2024-12-10 17:21:13,77,4824,34,43,3391.88,5898.00,0.00
2024-12-10 17:21:13,78,4824,34,44,3348.39,5898.01,0.00
2024-12-10 17:21:13,78,4825,34,44,3345.34,5899.00,0.00
2024-12-10 17:21:13,79,4825,34,45,3303.00,5899.01,0.00
2024-12-10 17:21:14,79,4826,34,45,3285.66,5900.00,0.00
2024-12-10 17:21:14,80,4826,35,45,3244.59,5900.01,0.00
2024-12-10 17:21:14,79,4826,35,44,3229.28,5900.70,0.00
2024-12-10 17:21:14,79,4827,35,44,3268.25,5901.00,0.00
2024-12-10 17:21:14,80,4827,36,44,3227.40,5901.01,0.00
2024-12-10 17:21:14,79,4827,36,43,3186.66,5901.70,0.00
2024-12-10 17:21:14,79,4828,36,43,3240.71,5902.00,0.00
2024-12-10 17:21:14,80,4828,36,44,3200.20,5902.01,0.00
2024-12-10 17:21:14,79,4828,35,44,3214.67,5902.44,0.00
2024-12-10 17:21:14,79,4829,35,44,3248.26,5903.00,0.00
2024-12-10 17:21:14,80,4829,35,45,3207.65,5903.01,0.00
2024-12-10 17:21:14,79,4829,35,44,3244.54,5903.06,0.00
2024-12-10 17:21:14,80,4828,35,45,3184.89,5903.41,0.00
2024-12-10 17:21:14,80,4829,35,45,3249.72,5904.00,0.00
2024-12-10 17:21:14,81,4829,36,45,3209.60,5904.01,0.00
2024-12-10 17:21:14,81,4830,36,45,3273.95,5905.00,0.00
2024-12-10 17:21:14,82,4830,36,46,3234.02,5905.01,0.00
2024-12-10 17:21:14,81,4830,36,45,3270.32,5905.06,0.00
2024-12-10 17:21:14,80,4830,35,45,3302.41,5905.20,0.00
2024-12-10 17:21:14,79,4830,35,44,3306.65,5905.68,0.00
2024-12-10 17:21:14,79,4831,35,44,3347.42,5906.00,0.00
2024-12-10 17:21:14,80,4831,35,45,3305.58,5906.01,0.00
2024-12-10 17:21:14,80,4832,35,45,3285.61,5907.00,0.00
2024-12-10 17:21:14,81,4832,36,45,3245.05,5907.01,0.00
2024-12-10 17:21:14,80,4832,36,44,3199.72,5907.75,0.00
2024-12-10 17:21:14,80,4833,36,44,3239.56,5908.00,0.00
2024-12-10 17:21:14,81,4833,36,45,3199.57,5908.01,0.00
2024-12-10 17:21:14,82,4832,37,45,3132.61,5908.51,0.00
2024-12-10 17:21:14,81,4832,36,45,3148.31,5908.77,0.00
2024-12-10 17:21:14,81,4833,36,45,3207.60,5909.00,0.00
2024-12-10 17:21:14,82,4833,37,45,3168.49,5909.01,0.00
2024-12-10 17:21:14,82,4834,37,45,3203.09,5910.00,0.00
2024-12-10 17:21:14,83,4834,38,45,3164.50,5910.01,0.00
2024-12-10 17:21:14,82,4834,37,45,3127.39,5910.66,0.00
2024-12-10 17:21:14,82,4835,37,45,3158.68,5911.00,0.00
2024-12-10 17:21:14,83,4835,38,45,3120.62,5911.01,0.00
2024-12-10 17:21:14,84,4834,39,45,3063.57,5911.37,0.00
2024-12-10 17:21:14,83,4834,39,44,3087.46,5911.49,0.00
2024-12-10 17:21:14,83,4835,39,44,3094.86,5912.00,0.00
2024-12-10 17:21:14,84,4835,40,44,3058.02,5912.01,0.00
2024-12-10 17:21:14,83,4835,39,44,2994.09,5912.95,0.00
2024-12-10 17:21:14,83,4836,39,44,3133.75,5913.00,0.00
2024-12-10 17:21:14,84,4836,39,45,3096.44,5913.01,0.00
2024-12-10 17:21:14,83,4836,38,45,3130.20,5913.06,0.00
2024-12-10 17:21:14,82,4836,37,45,3100.69,5913.78,0.00
2024-12-10 17:21:14,82,4837,37,45,3135.23,5914.00,0.00
2024-12-10 17:21:14,83,4837,37,46,3097.45,5914.01,0.00
2024-12-10 17:21:14,83,4838,37,46,3051.98,5915.00,0.00
2024-12-10 17:21:14,84,4838,37,47,3015.64,5915.01,0.00
2024-12-10 17:21:14,83,4838,36,47,2961.46,5915.81,0.00
2024-12-10 17:21:14,83,4839,36,47,3021.51,5916.00,0.00
2024-12-10 17:21:14,84,4839,37,47,2985.54,5916.01,0.00
2024-12-10 17:21:14,83,4839,37,46,2938.69,5916.78,0.00
2024-12-10 17:21:14,83,4840,37,46,2997.34,5917.00,0.00
2024-12-10 17:21:14,84,4840,37,47,2961.65,5917.01,0.00
2024-12-10 17:21:14,83,4840,37,46,2993.78,5917.06,0.00
2024-12-10 17:21:14,82,4840,37,45,2976.77,5917.49,0.00
2024-12-10 17:21:14,82,4841,37,45,3007.16,5918.00,0.00
2024-12-10 17:21:14,83,4841,37,46,2970.93,5918.01,0.00
2024-12-10 17:21:14,82,4841,36,46,3003.56,5918.06,0.00
2024-12-10 17:21:14,81,4841,36,45,2965.86,5918.64,0.00
2024-12-10 17:21:14,81,4842,36,45,3015.36,5919.00,0.00
2024-12-10 17:21:14,82,4842,37,45,2978.59,5919.01,0.00
2024-12-10 17:21:14,81,4842,36,45,2952.04,5919.42,0.00
2024-12-10 17:21:14,81,4843,36,45,2982.93,5920.00,0.00
2024-12-10 17:21:14,82,4843,37,45,2946.56,5920.01,0.00
2024-12-10 17:21:14,81,4843,37,44,2979.29,5920.06,0.00
2024-12-10 17:21:14,80,4843,37,43,2995.51,5920.31,0.00
2024-12-10 17:21:14,80,4844,37,43,3016.86,5921.00,0.00
2024-12-10 17:21:14,81,4844,38,43,2979.62,5921.01,0.00
2024-12-10 17:21:14,81,4845,38,43,2980.42,5922.00,0.00
2024-12-10 17:21:14,82,4845,39,43,2944.07,5922.01,0.00
2024-12-10 17:21:14,81,4845,39,42,2977.50,5922.05,0.00
2024-12-10 17:21:14,80,4845,38,42,3013.98,5922.05,0.00
2024-12-10 17:21:14,79,4845,37,42,3051.38,5922.05,0.00
2024-12-10 17:21:14,80,4844,37,43,2978.66,5922.66,0.00
2024-12-10 17:21:14,80,4845,37,43,3040.79,5923.00,0.00
2024-12-10 17:21:14,81,4845,37,44,3003.25,5923.01,0.00
2024-12-10 17:21:14,80,4845,36,44,3037.84,5923.05,0.00
2024-12-10 17:21:14,80,4846,36,44,3120.54,5924.00,0.00
2024-12-10 17:21:14,81,4846,37,44,3082.01,5924.01,0.00
2024-12-10 17:21:14,80,4846,36,44,3119.80,5924.01,0.00
2024-12-10 17:21:14,79,4846,36,43,3157.05,5924.04,0.00
2024-12-10 17:21:14,78,4846,36,42,3154.37,5924.76,0.00
2024-12-10 17:21:14,78,4847,36,42,3216.11,5925.00,0.00
2024-12-10 17:21:14,79,4847,37,42,3175.40,5925.01,0.00
2024-12-10 17:21:14,79,4848,37,42,3192.44,5926.00,0.00
2024-12-10 17:21:14,80,4848,38,42,3152.53,5926.01,0.00
2024-12-10 17:21:14,80,4849,38,42,3168.62,5927.00,0.00
2024-12-10 17:21:14,81,4849,39,42,3129.50,5927.01,0.00
2024-12-10 17:21:14,81,4850,39,42,3141.50,5928.00,0.00
2024-12-10 17:21:14,82,4850,40,42,3103.19,5928.01,0.00
2024-12-10 17:21:14,81,4850,40,41,3139.31,5928.04,0.00
2024-12-10 17:21:14,81,4851,40,41,3142.29,5929.00,0.00
2024-12-10 17:21:14,82,4851,41,41,3103.96,5929.01,0.00
2024-12-10 17:21:14,81,4851,41,40,3139.75,5929.05,0.00
2024-12-10 17:21:14,81,4852,41,40,3130.68,5930.00,0.00
2024-12-10 17:21:14,82,4852,42,40,3092.50,5930.01,0.00
2024-12-10 17:21:14,81,4852,42,39,3129.03,5930.04,0.00
2024-12-10 17:21:14,80,4852,42,38,3091.87,5930.84,0.00
2024-12-10 17:21:14,80,4853,42,38,3156.51,5931.00,0.00
2024-12-10 17:21:14,81,4853,42,39,3117.54,5931.01,0.00
2024-12-10 17:21:14,81,4854,42,39,3118.63,5932.00,0.00
2024-12-10 17:21:14,82,4854,42,40,3080.59,5932.01,0.00
2024-12-10 17:21:15,82,4855,42,40,3065.03,5933.00,0.00
2024-12-10 17:21:15,83,4855,43,40,3028.10,5933.01,0.00
2024-12-10 17:21:15,82,4855,42,40,3023.64,5933.56,0.00
2024-12-10 17:21:15,82,4856,42,40,3045.31,5934.00,0.00
2024-12-10 17:21:15,83,4856,42,41,3008.61,5934.01,0.00
2024-12-10 17:21:15,82,4856,42,40,2971.09,5934.87,0.00
2024-12-10 17:21:15,82,4857,42,40,3035.62,5935.00,0.00
2024-12-10 17:21:15,83,4857,42,41,2999.05,5935.01,0.00
2024-12-10 17:21:15,82,4857,41,41,3033.46,5935.04,0.00
2024-12-10 17:21:15,82,4858,41,41,3049.16,5936.00,0.00
2024-12-10 17:21:15,83,4858,42,41,3012.43,5936.01,0.00
2024-12-10 17:21:15,82,4858,41,41,3047.00,5936.04,0.00
2024-12-10 17:21:15,82,4859,41,41,3058.81,5937.00,0.00
2024-12-10 17:21:15,83,4859,42,41,3021.96,5937.01,0.00
2024-12-10 17:21:15,82,4859,42,40,3047.18,5937.16,0.00
2024-12-10 17:21:15,82,4860,42,40,3070.13,5938.00,0.00
2024-12-10 17:21:15,83,4860,42,41,3033.14,5938.01,0.00
2024-12-10 17:21:15,82,4860,42,40,3067.96,5938.04,0.00
2024-12-10 17:21:15,81,4860,42,39,3092.12,5938.26,0.00
2024-12-10 17:21:15,81,4861,42,39,3121.93,5939.00,0.00
2024-12-10 17:21:15,82,4861,43,39,3083.86,5939.01,0.00
2024-12-10 17:21:15,81,4861,42,39,3119.74,5939.04,0.00
2024-12-10 17:21:15,81,4862,42,39,3134.63,5940.00,0.00
2024-12-10 17:21:15,82,4862,43,39,3096.41,5940.01,0.00
2024-12-10 17:21:15,81,4862,43,38,3132.44,5940.04,0.00
2024-12-10 17:21:15,81,4863,43,38,3140.44,5941.00,0.00
2024-12-10 17:21:15,82,4863,43,39,3102.14,5941.01,0.00
2024-12-10 17:21:15,81,4863,42,39,3138.25,5941.04,0.00
2024-12-10 17:21:15,81,4864,42,39,3132.79,5942.00,0.00
2024-12-10 17:21:15,82,4864,42,40,3094.59,5942.01,0.00
2024-12-10 17:21:15,81,4864,42,39,3130.60,5942.04,0.00
2024-12-10 17:21:15,80,4864,41,39,3092.26,5942.81,0.00
2024-12-10 17:21:15,80,4865,41,39,3152.42,5943.00,0.00
2024-12-10 17:21:15,81,4865,42,39,3113.50,5943.01,0.00
2024-12-10 17:21:15,82,4864,43,39,3075.53,5943.04,0.00
2024-12-10 17:21:15,81,4864,43,38,3181.75,5943.05,0.00
2024-12-10 17:21:15,81,4865,43,38,3195.65,5944.00,0.00
2024-12-10 17:21:15,82,4865,43,39,3156.68,5944.01,0.00
2024-12-10 17:21:15,81,4865,43,38,3193.47,5944.04,0.00
2024-12-10 17:21:15,81,4866,43,38,3282.76,5945.00,0.00
2024-12-10 17:21:15,82,4866,43,39,3242.72,5945.01,0.00
2024-12-10 17:21:15,81,4866,43,38,3280.45,5945.04,0.00
2024-12-10 17:21:15,81,4867,43,38,3297.13,5946.00,0.00
2024-12-10 17:21:15,82,4867,43,39,3256.93,5946.01,0.00
2024-12-10 17:21:15,82,4868,43,39,3270.11,5947.00,0.00
2024-12-10 17:21:15,83,4868,43,40,3230.71,5947.01,0.00
2024-12-10 17:21:15,82,4868,42,40,3264.53,5947.05,0.00
2024-12-10 17:21:15,82,4869,42,40,3278.33,5948.00,0.00
2024-12-10 17:21:15,83,4869,42,41,3238.83,5948.01,0.00
2024-12-10 17:21:15,82,4869,41,41,3260.73,5948.13,0.00
2024-12-10 17:21:15,82,4870,41,41,3282.19,5949.00,0.00
2024-12-10 17:21:15,83,4870,42,41,3242.64,5949.01,0.00
2024-12-10 17:21:15,82,4870,42,40,3276.02,5949.02,0.00
2024-12-10 17:21:15,81,4870,41,40,3315.00,5949.04,0.00
2024-12-10 17:21:15,82,4869,41,41,3237.83,5949.68,0.00
2024-12-10 17:21:15,82,4870,41,41,3310.14,5950.00,0.00
2024-12-10 17:21:15,83,4870,42,41,3270.26,5950.01,0.00
2024-12-10 17:21:15,82,4870,41,41,3307.98,5950.04,0.00
2024-12-10 17:21:15,81,4870,40,41,3348.18,5950.04,0.00
2024-12-10 17:21:15,81,4871,40,41,3438.36,5951.00,0.00
2024-12-10 17:21:15,82,4871,40,42,3396.43,5951.01,0.00
2024-12-10 17:21:15,82,4872,40,42,3410.79,5952.00,0.00
2024-12-10 17:21:15,83,4872,40,43,3369.70,5952.01,0.00
2024-12-10 17:21:15,83,4873,40,43,3382.66,5953.00,0.00
2024-12-10 17:21:15,84,4873,41,43,3342.39,5953.01,0.00
2024-12-10 17:21:15,84,4874,41,43,3346.10,5954.00,0.00
2024-12-10 17:21:15,85,4874,42,43,3306.73,5954.01,0.00
2024-12-10 17:21:15,84,4874,41,43,3343.99,5954.04,0.00
2024-12-10 17:21:15,84,4875,41,43,3343.51,5955.00,0.00
2024-12-10 17:21:15,85,4875,42,43,3304.17,5955.01,0.00
2024-12-10 17:21:15,85,4876,42,43,3296.58,5956.00,0.00
2024-12-10 17:21:15,86,4876,43,43,3258.25,5956.01,0.00
2024-12-10 17:21:15,85,4876,43,42,3293.79,5956.05,0.00
2024-12-10 17:21:15,84,4876,42,42,3276.15,5956.76,0.00
2024-12-10 17:21:15,84,4877,42,42,3333.09,5957.00,0.00
2024-12-10 17:21:15,85,4877,42,43,3293.88,5957.01,0.00
2024-12-10 17:21:15,84,4877,42,42,3330.27,5957.05,0.00
2024-12-10 17:21:15,84,4878,42,42,3343.97,5958.00,0.00
2024-12-10 17:21:15,85,4878,43,42,3304.63,5958.01,0.00
2024-12-10 17:21:15,85,4879,43,42,3305.39,5959.00,0.00
2024-12-10 17:21:15,86,4879,44,42,3266.96,5959.01,0.00
2024-12-10 17:21:15,85,4879,43,42,3303.63,5959.04,0.00
2024-12-10 17:21:15,85,4880,43,42,3287.22,5960.00,0.00
2024-12-10 17:21:15,86,4880,44,42,3249.00,5960.01,0.00
2024-12-10 17:21:15,87,4879,45,42,3100.63,5960.85,0.00
2024-12-10 17:21:15,87,4880,45,42,3168.60,5961.00,0.00
2024-12-10 17:21:15,88,4880,45,43,3132.59,5961.01,0.00
2024-12-10 17:21:15,87,4880,44,43,3166.56,5961.04,0.00
2024-12-10 17:21:15,86,4880,44,42,3169.69,5961.38,0.00
2024-12-10 17:21:15,85,4880,44,41,3170.27,5961.71,0.00
2024-12-10 17:21:15,84,4880,43,41,3195.97,5961.73,0.00
2024-12-10 17:21:15,84,4881,43,41,3308.12,5962.00,0.00
2024-12-10 17:21:15,85,4881,43,42,3269.20,5962.01,0.00
2024-12-10 17:21:15,85,4882,43,42,3257.51,5963.00,0.00
2024-12-10 17:21:15,86,4882,44,42,3219.64,5963.01,0.00
2024-12-10 17:21:15,85,4882,43,42,3253.22,5963.06,0.00
2024-12-10 17:21:15,84,4882,42,42,3234.48,5963.75,0.00
2024-12-10 17:21:15,84,4883,42,42,3290.79,5964.00,0.00
2024-12-10 17:21:15,85,4883,43,42,3252.07,5964.01,0.00
2024-12-10 17:21:15,84,4883,43,41,3288.67,5964.04,0.00
2024-12-10 17:21:15,84,4884,43,41,3301.99,5965.00,0.00
2024-12-10 17:21:15,85,4884,43,42,3263.15,5965.01,0.00
2024-12-10 17:21:16,85,4885,43,42,3265.52,5966.00,0.00
2024-12-10 17:21:16,86,4885,43,43,3227.55,5966.01,0.00
2024-12-10 17:21:16,85,4885,42,43,3263.43,5966.04,0.00
2024-12-10 17:21:16,85,4886,42,43,3252.22,5967.00,0.00
2024-12-10 17:21:16,86,4886,43,43,3214.40,5967.01,0.00
2024-12-10 17:21:16,85,4886,43,42,3250.12,5967.04,0.00
2024-12-10 17:21:16,85,4887,43,42,3225.07,5968.00,0.00
2024-12-10 17:21:16,86,4887,44,42,3187.56,5968.01,0.00
2024-12-10 17:21:16,85,4887,43,42,3222.97,5968.04,0.00
2024-12-10 17:21:16,84,4887,43,41,3196.65,5968.74,0.00
2024-12-10 17:21:16,84,4888,43,41,3227.33,5969.00,0.00
2024-12-10 17:21:16,85,4888,43,42,3189.36,5969.01,0.00
2024-12-10 17:21:16,84,4888,42,42,3225.21,5969.04,0.00
2024-12-10 17:21:16,83,4888,41,42,3202.80,5969.90,0.00
2024-12-10 17:21:16,83,4889,41,42,3269.05,5970.00,0.00
2024-12-10 17:21:16,84,4889,41,43,3230.14,5970.01,0.00
2024-12-10 17:21:16,83,4889,41,42,3266.90,5970.04,0.00
2024-12-10 17:21:16,83,4890,41,42,3281.83,5971.00,0.00
2024-12-10 17:21:16,84,4890,41,43,3242.76,5971.01,0.00
2024-12-10 17:21:16,83,4890,41,42,3279.68,5971.04,0.00
2024-12-10 17:21:16,83,4891,41,42,3294.61,5972.00,0.00
2024-12-10 17:21:16,84,4891,41,43,3255.39,5972.01,0.00
2024-12-10 17:21:16,84,4892,41,43,3263.75,5973.00,0.00
2024-12-10 17:21:16,85,4892,42,43,3225.36,5973.01,0.00
2024-12-10 17:21:16,84,4892,41,43,3262.34,5973.02,0.00
2024-12-10 17:21:16,84,4893,41,43,3262.09,5974.00,0.00
2024-12-10 17:21:16,85,4893,42,43,3223.71,5974.01,0.00
2024-12-10 17:21:16,85,4894,42,43,3211.30,5975.00,0.00
2024-12-10 17:21:16,86,4894,42,44,3173.96,5975.01,0.00
2024-12-10 17:21:16,85,4894,41,44,3147.66,5975.69,0.00
2024-12-10 17:21:16,85,4895,41,44,3199.94,5976.00,0.00
2024-12-10 17:21:16,86,4895,41,45,3162.74,5976.01,0.00
2024-12-10 17:21:16,85,4895,41,44,3198.56,5976.02,0.00
2024-12-10 17:21:16,84,4895,41,43,3216.12,5976.23,0.00
2024-12-10 17:21:16,84,4896,41,43,3239.04,5977.00,0.00
2024-12-10 17:21:16,85,4896,41,44,3200.94,5977.01,0.00
2024-12-10 17:21:16,85,4897,41,44,3206.77,5978.00,0.00
2024-12-10 17:21:16,86,4897,42,44,3169.48,5978.01,0.00
2024-12-10 17:21:16,85,4897,42,43,3205.37,5978.02,0.00
2024-12-10 17:21:16,85,4898,42,43,3207.89,5979.00,0.00
2024-12-10 17:21:16,86,4898,42,44,3170.59,5979.01,0.00
2024-12-10 17:21:16,85,4898,41,44,3206.49,5979.02,0.00
2024-12-10 17:21:16,85,4899,41,44,3207.35,5980.00,0.00
2024-12-10 17:21:16,86,4899,41,45,3170.05,5980.01,0.00
2024-12-10 17:21:16,86,4900,41,45,3165.85,5981.00,0.00
2024-12-10 17:21:16,87,4900,41,46,3129.46,5981.01,0.00
2024-12-10 17:21:16,86,4900,41,45,3120.11,5981.48,0.00
2024-12-10 17:21:16,86,4901,41,45,3151.56,5982.00,0.00
2024-12-10 17:21:16,87,4901,41,46,3115.34,5982.01,0.00
2024-12-10 17:21:16,86,4901,41,45,3149.49,5982.02,0.00
2024-12-10 17:21:16,85,4901,40,45,3142.99,5982.44,0.00
2024-12-10 17:21:16,85,4902,40,45,3161.27,5983.00,0.00
2024-12-10 17:21:16,86,4902,41,45,3124.51,5983.01,0.00
2024-12-10 17:21:16,85,4902,41,44,3158.96,5983.02,0.00
2024-12-10 17:21:16,84,4902,41,43,3187.18,5983.11,0.00
2024-12-10 17:21:16,84,4903,41,43,3163.22,5984.00,0.00
2024-12-10 17:21:16,85,4903,41,44,3126.01,5984.01,0.00
2024-12-10 17:21:16,84,4903,41,43,3160.91,5984.02,0.00
2024-12-10 17:21:16,83,4903,40,43,3106.71,5984.70,0.00
2024-12-10 17:21:16,83,4904,40,43,3145.07,5985.00,0.00
2024-12-10 17:21:16,84,4904,41,43,3107.63,5985.01,0.00
2024-12-10 17:21:16,83,4904,41,42,3142.76,5985.04,0.00
2024-12-10 17:21:16,83,4905,41,42,3094.61,5986.00,0.00
2024-12-10 17:21:16,84,4905,41,43,3057.77,5986.01,0.00
2024-12-10 17:21:16,83,4905,40,43,3092.95,5986.02,0.00
2024-12-10 17:21:16,82,4905,40,42,3126.81,5986.04,0.00
2024-12-10 17:21:16,82,4906,40,42,3064.47,5987.00,0.00
2024-12-10 17:21:16,83,4906,41,42,3027.55,5987.01,0.00
2024-12-10 17:21:16,82,4906,41,41,3056.28,5987.10,0.00
2024-12-10 17:21:16,82,4907,41,41,2992.24,5988.00,0.00
2024-12-10 17:21:16,83,4907,41,42,2956.18,5988.01,0.00
2024-12-10 17:21:16,82,4907,41,41,2975.02,5988.23,0.00
2024-12-10 17:21:16,81,4907,40,41,2933.26,5988.70,0.00
2024-12-10 17:21:16,81,4908,40,41,2956.58,5989.00,0.00
2024-12-10 17:21:16,82,4908,40,42,2920.53,5989.01,0.00
2024-12-10 17:21:16,82,4909,40,42,2858.33,5990.00,0.00
2024-12-10 17:21:16,83,4909,41,42,2823.89,5990.01,0.00
2024-12-10 17:21:16,82,4909,40,42,2856.88,5990.02,0.00
2024-12-10 17:21:16,81,4909,39,42,2863.51,5990.33,0.00
2024-12-10 17:21:16,80,4909,39,41,2884.21,5990.49,0.00
2024-12-10 17:21:16,79,4909,39,40,2913.17,5990.56,0.00
2024-12-10 17:21:16,79,4910,39,40,2912.18,5991.00,0.00
2024-12-10 17:21:16,80,4910,40,40,2875.78,5991.01,0.00
2024-12-10 17:21:16,80,4911,40,40,2814.35,5992.00,0.00
2024-12-10 17:21:16,81,4911,41,40,2779.61,5992.01,0.00
2024-12-10 17:21:16,80,4911,40,40,2812.86,5992.03,0.00
2024-12-10 17:21:16,79,4911,39,40,2828.84,5992.28,0.00
2024-12-10 17:21:16,78,4911,39,39,2822.50,5992.73,0.00
2024-12-10 17:21:16,78,4912,39,39,2843.37,5993.00,0.00
2024-12-10 17:21:16,79,4912,39,40,2807.38,5993.01,0.00
2024-12-10 17:21:16,78,4912,39,39,2783.64,5993.74,0.00
2024-12-10 17:21:16,77,4912,39,38,2792.26,5993.83,0.00
2024-12-10 17:21:16,77,4913,39,38,2851.29,5994.00,0.00
2024-12-10 17:21:16,78,4913,40,38,2814.74,5994.01,0.00
2024-12-10 17:21:16,77,4913,39,38,2837.03,5994.17,0.00
2024-12-10 17:21:16,76,4913,39,37,2823.32,5994.80,0.00
2024-12-10 17:21:16,76,4914,39,37,2879.77,5995.00,0.00
2024-12-10 17:21:16,77,4914,39,38,2842.37,5995.01,0.00
2024-12-10 17:21:16,77,4915,39,38,2844.81,5996.00,0.00
2024-12-10 17:21:16,78,4915,39,39,2808.34,5996.01,0.00
2024-12-10 17:21:16,77,4915,39,38,2824.42,5996.34,0.00
2024-12-10 17:21:16,76,4915,39,37,2831.48,5996.82,0.00
2024-12-10 17:21:16,76,4916,39,37,2897.88,5997.00,0.00
2024-12-10 17:21:16,77,4916,40,37,2860.24,5997.01,0.00
2024-12-10 17:21:16,76,4916,40,36,2895.52,5997.04,0.00
2024-12-10 17:21:16,75,4916,39,36,2916.43,5997.33,0.00
2024-12-10 17:21:17,75,4917,39,36,2953.74,5998.00,0.00
2024-12-10 17:21:17,76,4917,39,37,2914.88,5998.01,0.00
2024-12-10 17:21:17,76,4918,39,37,2930.80,5999.00,0.00
2024-12-10 17:21:17,77,4918,40,37,2892.74,5999.01,0.00
2024-12-10 17:21:17,76,4918,40,36,2928.44,5999.04,0.00
2024-12-10 17:21:17,76,4919,40,36,2942.61,6000.00,0.00
2024-12-10 17:21:17,77,4919,41,36,2904.40,6000.01,0.00
2024-12-10 17:21:17,76,4919,40,36,2940.76,6000.04,0.00
2024-12-10 17:21:17,76,4920,40,36,2954.24,6001.00,0.00
2024-12-10 17:21:17,77,4920,40,37,2915.87,6001.01,0.00
2024-12-10 17:21:17,76,4920,40,36,2938.32,6001.24,0.00
2024-12-10 17:21:17,76,4921,40,36,2964.39,6002.00,0.00
2024-12-10 17:21:17,77,4921,41,36,2925.89,6002.01,0.00
2024-12-10 17:21:17,76,4921,41,35,2960.54,6002.07,0.00
2024-12-10 17:21:17,75,4921,41,34,2971.24,6002.37,0.00
2024-12-10 17:21:17,75,4922,41,34,3014.09,6003.00,0.00
2024-12-10 17:21:17,76,4922,41,35,2974.43,6003.01,0.00
2024-12-10 17:21:17,75,4922,41,34,3012.74,6003.03,0.00
2024-12-10 17:21:17,74,4922,41,33,3052.65,6003.03,0.00
2024-12-10 17:21:17,74,4923,41,33,3073.80,6004.00,0.00
2024-12-10 17:21:17,75,4923,42,33,3032.82,6004.01,0.00
2024-12-10 17:21:17,74,4923,41,33,3072.18,6004.03,0.00
2024-12-10 17:21:17,74,4924,41,33,3093.81,6005.00,0.00
2024-12-10 17:21:17,75,4924,42,33,3052.56,6005.01,0.00
2024-12-10 17:21:17,74,4924,41,33,3084.04,6005.18,0.00
2024-12-10 17:21:17,74,4925,41,33,3116.19,6006.00,0.00
2024-12-10 17:21:17,75,4925,41,34,3074.64,6006.01,0.00
2024-12-10 17:21:17,75,4926,41,34,3095.98,6007.00,0.00
2024-12-10 17:21:17,76,4926,42,34,3055.24,6007.01,0.00
2024-12-10 17:21:17,75,4926,41,34,3094.38,6007.03,0.00
2024-12-10 17:21:17,75,4927,41,34,3116.52,6008.00,0.00
2024-12-10 17:21:17,76,4927,42,34,3075.51,6008.01,0.00
2024-12-10 17:21:17,76,4928,42,34,3092.98,6009.00,0.00
2024-12-10 17:21:17,77,4928,42,35,3052.81,6009.01,0.00
2024-12-10 17:21:17,76,4928,41,35,3091.40,6009.03,0.00
2024-12-10 17:21:17,76,4929,41,35,3101.27,6010.00,0.00
2024-12-10 17:21:17,77,4929,41,36,3060.99,6010.01,0.00
2024-12-10 17:21:17,76,4929,40,36,3099.69,6010.03,0.00
2024-12-10 17:21:17,76,4930,40,36,3096.31,6011.00,0.00
2024-12-10 17:21:17,77,4930,40,37,3056.10,6011.01,0.00
2024-12-10 17:21:17,76,4930,39,37,3094.73,6011.03,0.00
2024-12-10 17:21:17,76,4931,39,37,3073.36,6012.00,0.00
2024-12-10 17:21:17,77,4931,40,37,3033.45,6012.01,0.00
2024-12-10 17:21:17,76,4931,39,37,3072.12,6012.03,0.00
2024-12-10 17:21:17,75,4931,38,37,3045.62,6012.88,0.00
2024-12-10 17:21:17,75,4932,38,37,3099.24,6013.00,0.00
2024-12-10 17:21:17,76,4932,39,37,3058.46,6013.01,0.00
2024-12-10 17:21:17,75,4932,39,36,3097.64,6013.03,0.00
2024-12-10 17:21:17,76,4931,40,36,3002.54,6013.88,0.00
2024-12-10 17:21:17,76,4932,40,36,3054.46,6014.00,0.00
2024-12-10 17:21:17,77,4932,40,37,3014.80,6014.01,0.00
2024-12-10 17:21:17,76,4932,40,36,3052.88,6014.03,0.00
2024-12-10 17:21:17,75,4932,39,36,3026.23,6014.87,0.00
2024-12-10 17:21:17,75,4933,39,36,3178.72,6015.00,0.00
2024-12-10 17:21:17,76,4933,39,37,3136.89,6015.01,0.00
2024-12-10 17:21:17,76,4934,39,37,3154.27,6016.00,0.00
2024-12-10 17:21:17,77,4934,40,37,3113.31,6016.01,0.00
2024-12-10 17:21:17,76,4934,39,37,3152.69,6016.03,0.00
2024-12-10 17:21:17,76,4935,39,37,3170.99,6017.00,0.00
2024-12-10 17:21:17,77,4935,40,37,3129.81,6017.01,0.00
2024-12-10 17:21:17,77,4936,40,37,3143.12,6018.00,0.00
2024-12-10 17:21:17,78,4936,40,38,3102.82,6018.01,0.00
2024-12-10 17:21:17,77,4936,40,37,3141.56,6018.03,0.00
2024-12-10 17:21:17,77,4937,40,37,3151.46,6019.00,0.00
2024-12-10 17:21:17,78,4937,40,38,3111.06,6019.01,0.00
2024-12-10 17:21:17,77,4937,39,38,3149.90,6019.03,0.00
2024-12-10 17:21:17,78,4936,40,38,3051.09,6019.77,0.00
2024-12-10 17:21:17,78,4937,40,38,3129.25,6020.00,0.00
2024-12-10 17:21:17,79,4937,40,39,3089.64,6020.01,0.00
2024-12-10 17:21:17,78,4937,39,39,3127.71,6020.03,0.00
2024-12-10 17:21:17,77,4937,39,38,3151.18,6020.20,0.00
2024-12-10 17:21:17,76,4937,39,37,3188.33,6020.21,0.00
2024-12-10 17:21:17,75,4937,38,37,3212.66,6020.48,0.00
2024-12-10 17:21:17,75,4938,38,37,3342.30,6021.00,0.00
2024-12-10 17:21:17,76,4938,39,37,3298.32,6021.01,0.00
2024-12-10 17:21:17,76,4939,39,37,3315.98,6022.00,0.00
2024-12-10 17:21:17,77,4939,40,37,3272.91,6022.01,0.00
2024-12-10 17:21:17,77,4940,40,37,3288.92,6023.00,0.00
2024-12-10 17:21:17,78,4940,41,37,3246.75,6023.01,0.00
2024-12-10 17:21:17,79,4939,42,37,3185.90,6023.37,0.00
2024-12-10 17:21:17,79,4940,42,37,3272.32,6024.00,0.00
2024-12-10 17:21:17,80,4940,43,37,3231.41,6024.01,0.00
2024-12-10 17:21:17,79,4940,42,37,3270.80,6024.03,0.00
2024-12-10 17:21:17,78,4940,41,37,3311.63,6024.04,0.00
2024-12-10 17:21:17,78,4941,41,37,3397.71,6025.00,0.00
2024-12-10 17:21:17,79,4941,42,37,3354.70,6025.01,0.00
2024-12-10 17:21:17,78,4941,41,37,3396.17,6025.03,0.00
2024-12-10 17:21:17,78,4942,41,37,3397.24,6026.00,0.00
2024-12-10 17:21:17,79,4942,41,38,3354.24,6026.01,0.00
2024-12-10 17:21:17,79,4943,41,38,3346.87,6027.00,0.00
2024-12-10 17:21:17,80,4943,41,39,3305.04,6027.01,0.00
2024-12-10 17:21:17,81,4942,42,39,3176.80,6027.95,0.00
2024-12-10 17:21:17,81,4943,42,39,3247.71,6028.00,0.00
2024-12-10 17:21:17,82,4943,43,39,3208.11,6028.01,0.00
2024-12-10 17:21:17,81,4943,43,38,3157.69,6028.82,0.00
2024-12-10 17:21:18,81,4944,43,38,3291.77,6029.00,0.00
2024-12-10 17:21:18,82,4944,43,39,3251.63,6029.01,0.00
2024-12-10 17:21:18,82,4945,43,39,3239.45,6030.00,0.00
2024-12-10 17:21:18,83,4945,44,39,3200.42,6030.01,0.00
2024-12-10 17:21:18,82,4945,43,39,3237.98,6030.02,0.00
2024-12-10 17:21:18,81,4945,42,39,3228.94,6030.56,0.00
2024-12-10 17:21:18,81,4946,42,39,3263.89,6031.00,0.00
2024-12-10 17:21:18,82,4946,43,39,3224.09,6031.01,0.00
2024-12-10 17:21:18,81,4946,43,38,3242.07,6031.28,0.00
2024-12-10 17:21:18,81,4947,43,38,3246.59,6032.00,0.00
2024-12-10 17:21:18,82,4947,43,39,3207.00,6032.01,0.00
2024-12-10 17:21:18,81,4947,42,39,3235.87,6032.19,0.00
2024-12-10 17:21:18,81,4948,42,39,3215.97,6033.00,0.00
2024-12-10 17:21:18,82,4948,42,40,3176.75,6033.01,0.00
2024-12-10 17:21:18,81,4948,41,40,3212.38,6033.06,0.00
2024-12-10 17:21:18,80,4948,41,39,3249.08,6033.11,0.00
2024-12-10 17:21:18,79,4948,40,39,3181.68,6033.87,0.00
2024-12-10 17:21:18,79,4949,40,39,3250.53,6034.00,0.00
2024-12-10 17:21:18,80,4949,40,40,3209.90,6034.01,0.00
2024-12-10 17:21:18,79,4949,40,39,3249.01,6034.03,0.00
2024-12-10 17:21:18,78,4949,40,38,3233.75,6034.69,0.00
2024-12-10 17:21:18,77,4949,39,38,3271.40,6034.75,0.00
2024-12-10 17:21:18,77,4950,39,38,3335.10,6035.00,0.00
2024-12-10 17:21:18,78,4950,40,38,3292.34,6035.01,0.00
2024-12-10 17:21:18,77,4950,40,37,3333.53,6035.03,0.00
2024-12-10 17:21:18,77,4951,40,37,3353.68,6036.00,0.00
2024-12-10 17:21:18,78,4951,40,38,3310.69,6036.01,0.00
2024-12-10 17:21:18,77,4951,39,38,3352.11,6036.03,0.00
2024-12-10 17:21:18,77,4952,39,38,3372.27,6037.00,0.00
2024-12-10 17:21:18,78,4952,39,39,3329.04,6037.01,0.00
2024-12-10 17:21:18,78,4953,39,39,3347.39,6038.00,0.00
2024-12-10 17:21:18,79,4953,39,40,3305.02,6038.01,0.00
2024-12-10 17:21:18,78,4953,39,39,3346.91,6038.01,0.00
2024-12-10 17:21:18,78,4954,39,39,3365.27,6039.00,0.00
2024-12-10 17:21:18,79,4954,39,40,3322.68,6039.01,0.00
2024-12-10 17:21:18,79,4955,39,40,3339.59,6040.00,0.00
2024-12-10 17:21:18,80,4955,40,40,3297.85,6040.01,0.00
2024-12-10 17:21:18,80,4956,40,40,3301.72,6041.00,0.00
2024-12-10 17:21:18,81,4956,41,40,3260.96,6041.01,0.00
2024-12-10 17:21:18,80,4956,41,39,3300.96,6041.01,0.00
2024-12-10 17:21:18,80,4957,41,39,3289.41,6042.00,0.00
2024-12-10 17:21:18,81,4957,41,40,3248.80,6042.01,0.00
2024-12-10 17:21:18,80,4957,41,39,3288.66,6042.01,0.00
2024-12-10 17:21:18,81,4956,42,39,3154.49,6042.88,0.00
2024-12-10 17:21:18,81,4957,42,39,3229.21,6043.00,0.00
2024-12-10 17:21:18,82,4957,43,39,3189.83,6043.01,0.00
2024-12-10 17:21:18,81,4957,42,39,3228.47,6043.01,0.00
2024-12-10 17:21:18,80,4957,42,38,3167.80,6043.83,0.00
2024-12-10 17:21:18,80,4958,42,38,3308.46,6044.00,0.00
2024-12-10 17:21:18,81,4958,43,38,3267.61,6044.01,0.00
2024-12-10 17:21:18,80,4958,42,38,3241.42,6044.81,0.00
2024-12-10 17:21:18,80,4959,42,38,3305.81,6045.00,0.00
2024-12-10 17:21:18,81,4959,43,38,3265.00,6045.01,0.00
2024-12-10 17:21:18,80,4959,43,37,3295.08,6045.19,0.00
2024-12-10 17:21:18,80,4960,43,37,3299.95,6046.00,0.00
2024-12-10 17:21:18,81,4960,43,38,3259.21,6046.01,0.00
2024-12-10 17:21:18,80,4960,43,37,3299.19,6046.01,0.00
2024-12-10 17:21:18,79,4960,43,36,3277.30,6046.77,0.00
2024-12-10 17:21:18,79,4961,43,36,3339.31,6047.00,0.00
2024-12-10 17:21:18,80,4961,43,37,3297.57,6047.01,0.00
2024-12-10 17:21:18,81,4960,44,37,3188.09,6047.95,0.00
2024-12-10 17:21:18,81,4961,44,37,3262.81,6048.00,0.00
2024-12-10 17:21:18,82,4961,44,38,3223.02,6048.01,0.00
2024-12-10 17:21:18,82,4962,44,38,3290.22,6049.00,0.00
2024-12-10 17:21:18,83,4962,44,39,3250.58,6049.01,0.00
2024-12-10 17:21:18,82,4962,43,39,3289.14,6049.02,0.00
2024-12-10 17:21:18,82,4963,43,39,3277.72,6050.00,0.00
2024-12-10 17:21:18,83,4963,44,39,3238.23,6050.01,0.00
2024-12-10 17:21:18,82,4963,43,39,3276.98,6050.01,0.00
2024-12-10 17:21:18,82,4964,43,39,3263.90,6051.00,0.00
2024-12-10 17:21:18,83,4964,43,40,3224.57,6051.01,0.00
2024-12-10 17:21:18,82,4964,42,40,3260.56,6051.02,0.00
2024-12-10 17:21:18,83,4963,43,40,3214.73,6051.16,0.00
2024-12-10 17:21:18,82,4963,42,40,3276.64,6051.65,0.00
2024-12-10 17:21:18,82,4964,42,40,3316.67,6052.00,0.00
2024-12-10 17:21:18,83,4964,43,40,3276.71,6052.01,0.00
2024-12-10 17:21:18,82,4964,43,39,3267.46,6052.73,0.00
2024-12-10 17:21:18,82,4965,43,39,3399.08,6053.00,0.00
2024-12-10 17:21:18,83,4965,44,39,3358.13,6053.01,0.00
2024-12-10 17:21:18,83,4966,44,39,3370.46,6054.00,0.00
2024-12-10 17:21:18,84,4966,45,39,3330.34,6054.01,0.00
2024-12-10 17:21:18,83,4966,44,39,3369.73,6054.01,0.00
2024-12-10 17:21:18,84,4965,44,40,3284.15,6054.79,0.00
2024-12-10 17:21:18,84,4966,44,40,3354.27,6055.00,0.00
2024-12-10 17:21:18,85,4966,45,40,3314.81,6055.01,0.00
2024-12-10 17:21:19,85,4967,45,40,3398.00,6056.00,0.00
2024-12-10 17:21:19,86,4967,45,41,3358.49,6056.01,0.00
2024-12-10 17:21:19,86,4968,45,41,3369.61,6057.00,0.00
2024-12-10 17:21:19,87,4968,45,42,3330.88,6057.01,0.00
2024-12-10 17:21:19,86,4968,45,41,3368.91,6057.01,0.00
2024-12-10 17:21:19,85,4968,44,41,3407.84,6057.01,0.00
2024-12-10 17:21:19,85,4969,44,41,3419.81,6058.00,0.00
2024-12-10 17:21:19,86,4969,45,41,3380.04,6058.01,0.00
2024-12-10 17:21:19,86,4970,45,41,3391.17,6059.00,0.00
2024-12-10 17:21:19,87,4970,46,41,3352.19,6059.01,0.00
2024-12-10 17:21:19,87,4971,46,41,3360.24,6060.00,0.00
2024-12-10 17:21:19,88,4971,47,41,3322.06,6060.01,0.00
2024-12-10 17:21:19,87,4971,46,41,3359.55,6060.01,0.00
2024-12-10 17:21:19,87,4972,46,41,3364.38,6061.00,0.00
2024-12-10 17:21:19,88,4972,46,42,3326.14,6061.01,0.00
2024-12-10 17:21:19,87,4972,46,41,3363.68,6061.01,0.00
2024-12-10 17:21:19,87,4973,46,41,3357.85,6062.00,0.00
2024-12-10 17:21:19,88,4973,46,42,3319.70,6062.01,0.00
2024-12-10 17:21:19,87,4973,46,41,3357.16,6062.01,0.00
2024-12-10 17:21:19,87,4974,46,41,3338.21,6063.00,0.00
2024-12-10 17:21:19,88,4974,46,42,3300.28,6063.01,0.00
2024-12-10 17:21:19,88,4975,46,42,3267.19,6064.00,0.00
2024-12-10 17:21:19,89,4975,47,42,3230.48,6064.01,0.00
2024-12-10 17:21:19,88,4975,46,42,3266.50,6064.01,0.00
2024-12-10 17:21:19,88,4976,46,42,3221.58,6065.00,0.00
2024-12-10 17:21:19,89,4976,47,42,3185.38,6065.01,0.00
2024-12-10 17:21:19,88,4976,47,41,3220.89,6065.01,0.00
2024-12-10 17:21:19,87,4976,47,40,3225.60,6065.49,0.00
2024-12-10 17:21:19,86,4976,47,39,3225.23,6065.83,0.00
2024-12-10 17:21:19,85,4976,46,39,3240.35,6065.89,0.00
2024-12-10 17:21:19,85,4977,46,39,3305.39,6066.00,0.00
2024-12-10 17:21:19,86,4977,47,39,3266.95,6066.01,0.00
2024-12-10 17:21:19,85,4977,46,39,3235.13,6066.82,0.00
2024-12-10 17:21:19,85,4978,46,39,3295.95,6067.00,0.00
2024-12-10 17:21:19,86,4978,46,40,3257.62,6067.01,0.00
2024-12-10 17:21:19,85,4978,45,40,3295.23,6067.01,0.00
2024-12-10 17:21:19,85,4979,45,40,3301.51,6068.00,0.00
2024-12-10 17:21:19,86,4979,46,40,3263.12,6068.01,0.00
2024-12-10 17:21:19,85,4979,45,40,3300.80,6068.01,0.00
2024-12-10 17:21:19,85,4980,45,40,3298.17,6069.00,0.00
2024-12-10 17:21:19,86,4980,45,41,3259.81,6069.01,0.00
2024-12-10 17:21:19,86,4981,45,41,3245.61,6070.00,0.00
2024-12-10 17:21:19,87,4981,46,41,3208.31,6070.01,0.00
2024-12-10 17:21:19,86,4981,45,41,3244.87,6070.02,0.00
2024-12-10 17:21:19,85,4981,44,41,3211.56,6070.89,0.00
2024-12-10 17:21:19,85,4982,44,41,3276.65,6071.00,0.00
2024-12-10 17:21:19,86,4982,44,42,3238.55,6071.01,0.00
2024-12-10 17:21:19,85,4982,44,41,3271.10,6071.09,0.00
2024-12-10 17:21:19,85,4983,44,41,3288.05,6072.00,0.00
2024-12-10 17:21:19,86,4983,45,41,3249.82,6072.01,0.00
2024-12-10 17:21:19,86,4984,45,41,3260.95,6073.00,0.00
2024-12-10 17:21:19,87,4984,46,41,3223.46,6073.01,0.00
2024-12-10 17:21:19,86,4984,45,41,3255.61,6073.09,0.00
2024-12-10 17:21:19,86,4985,45,41,3271.67,6074.00,0.00
2024-12-10 17:21:19,87,4985,46,41,3234.07,6074.01,0.00
2024-12-10 17:21:19,86,4985,45,41,3270.27,6074.02,0.00
2024-12-10 17:21:19,86,4986,45,41,3282.10,6075.00,0.00
2024-12-10 17:21:19,87,4986,46,41,3244.38,6075.01,0.00
2024-12-10 17:21:19,86,4986,46,40,3280.70,6075.02,0.00
2024-12-10 17:21:19,86,4987,46,40,3292.18,6076.00,0.00
2024-12-10 17:21:19,87,4987,47,40,3254.34,6076.01,0.00
2024-12-10 17:21:19,86,4987,47,39,3290.77,6076.02,0.00
2024-12-10 17:21:19,87,4986,48,39,3228.61,6076.45,0.00
2024-12-10 17:21:19,87,4987,48,39,3294.71,6077.00,0.00
2024-12-10 17:21:19,88,4987,49,39,3257.27,6077.01,0.00
2024-12-10 17:21:19,88,4988,49,39,3316.95,6078.00,0.00
2024-12-10 17:21:19,89,4988,50,39,3279.69,6078.01,0.00
2024-12-10 17:21:19,89,4989,50,39,3257.14,6079.00,0.00
2024-12-10 17:21:19,90,4989,51,39,3220.95,6079.01,0.00
2024-12-10 17:21:19,89,4989,51,38,3202.38,6079.80,0.00
2024-12-10 17:21:19,89,4989,51,38,3257.09,6080.00,0.00
2024-12-10 17:21:19,90,4989,52,38,3220.90,6080.01,0.00
2024-12-10 17:21:19,89,4989,52,37,3255.74,6080.02,0.00
2024-12-10 17:21:19,89,4990,52,37,3260.95,6081.00,0.00
2024-12-10 17:21:19,90,4990,53,37,3224.72,6081.01,0.00
2024-12-10 17:21:19,89,4990,53,36,3259.91,6081.02,0.00
2024-12-10 17:21:19,89,4991,53,36,3257.74,6082.00,0.00
2024-12-10 17:21:19,90,4991,53,37,3221.54,6082.01,0.00
2024-12-10 17:21:19,89,4991,52,37,3256.95,6082.02,0.00
2024-12-10 17:21:19,89,4992,52,37,3242.38,6083.00,0.00
2024-12-10 17:21:19,90,4992,52,38,3206.35,6083.01,0.00
2024-12-10 17:21:19,91,4991,53,38,3169.61,6083.06,0.00
2024-12-10 17:21:19,92,4990,54,38,3175.16,6083.35,0.00
2024-12-10 17:21:19,91,4990,53,38,3193.08,6083.88,0.00
2024-12-10 17:21:19,91,4991,53,38,3250.45,6084.00,0.00
2024-12-10 17:21:19,92,4991,53,39,3215.12,6084.01,0.00
2024-12-10 17:21:19,92,4992,53,39,3331.54,6085.00,0.00
2024-12-10 17:21:19,93,4992,53,40,3295.72,6085.01,0.00
2024-12-10 17:21:19,92,4992,53,39,3330.35,6085.02,0.00
2024-12-10 17:21:19,91,4992,53,38,3365.77,6085.03,0.00
2024-12-10 17:21:19,90,4992,52,38,3390.92,6085.18,0.00
2024-12-10 17:21:19,90,4993,52,38,3390.38,6086.00,0.00
2024-12-10 17:21:19,91,4993,52,39,3353.13,6086.01,0.00
2024-12-10 17:21:19,91,4994,52,39,3340.74,6087.00,0.00
2024-12-10 17:21:19,92,4994,53,39,3304.42,6087.01,0.00
2024-12-10 17:21:19,91,4994,52,39,3337.28,6087.07,0.00
2024-12-10 17:21:19,91,4995,52,39,3325.09,6088.00,0.00
2024-12-10 17:21:20,92,4995,53,39,3288.95,6088.01,0.00
2024-12-10 17:21:20,92,4996,53,39,3269.87,6089.00,0.00
2024-12-10 17:21:20,93,4996,53,40,3234.71,6089.01,0.00
2024-12-10 17:21:20,92,4996,53,39,3267.90,6089.03,0.00
2024-12-10 17:21:20,91,4996,52,39,3302.71,6089.04,0.00
2024-12-10 17:21:20,91,4997,52,39,3281.85,6090.00,0.00
2024-12-10 17:21:20,92,4997,53,39,3246.18,6090.01,0.00
2024-12-10 17:21:20,91,4997,52,39,3280.16,6090.03,0.00
2024-12-10 17:21:20,90,4997,51,39,3254.04,6090.89,0.00
2024-12-10 17:21:20,89,4997,51,38,3281.51,6090.91,0.00
2024-12-10 17:21:20,89,4998,51,38,3339.67,6091.00,0.00
2024-12-10 17:21:20,90,4998,51,39,3302.56,6091.01,0.00
2024-12-10 17:21:20,90,4999,51,39,3292.46,6092.00,0.00
2024-12-10 17:21:20,91,4999,51,40,3256.27,6092.01,0.00
2024-12-10 17:21:20,91,5000,51,40,3238.05,6093.00,0.00
2024-12-10 17:21:20,92,5000,51,41,3202.85,6093.01,0.00
2024-12-10 17:21:20,91,5000,51,40,3236.06,6093.03,0.00
2024-12-10 17:21:20,91,5001,51,40,3214.70,6094.00,0.00
2024-12-10 17:21:20,92,5001,51,41,3179.76,6094.01,0.00
2024-12-10 17:21:20,92,5002,51,41,3149.44,6095.00,0.00
2024-12-10 17:21:20,93,5002,52,41,3115.58,6095.01,0.00
2024-12-10 17:21:20,92,5002,52,40,3147.86,6095.03,0.00
2024-12-10 17:21:20,91,5002,52,39,3149.44,6095.54,0.00
2024-12-10 17:21:20,90,5002,51,39,3145.87,6095.92,0.00
2024-12-10 17:21:20,90,5003,51,39,3191.06,6096.00,0.00
2024-12-10 17:21:20,91,5003,51,40,3155.99,6096.01,0.00
2024-12-10 17:21:20,90,5003,51,39,3189.05,6096.03,0.00
2024-12-10 17:21:20,89,5003,50,39,3159.70,6096.92,0.00
2024-12-10 17:21:20,89,5004,50,39,3223.47,6097.00,0.00
2024-12-10 17:21:20,90,5004,50,40,3187.66,6097.01,0.00
2024-12-10 17:21:20,89,5004,49,40,3221.43,6097.03,0.00
2024-12-10 17:21:20,88,5004,49,39,3255.43,6097.07,0.00
2024-12-10 17:21:20,88,5005,49,39,3267.02,6098.00,0.00
2024-12-10 17:21:20,89,5005,49,40,3230.32,6098.01,0.00
2024-12-10 17:21:20,88,5005,49,39,3265.50,6098.03,0.00
2024-12-10 17:21:20,88,5006,49,39,3271.78,6099.00,0.00
2024-12-10 17:21:20,89,5006,50,39,3235.02,6099.01,0.00
2024-12-10 17:21:20,90,5005,51,39,3160.69,6099.67,0.00
2024-12-10 17:21:20,90,5006,51,39,3221.65,6100.00,0.00
2024-12-10 17:21:20,91,5006,51,40,3186.25,6100.01,0.00
2024-12-10 17:21:20,90,5006,50,40,3219.43,6100.04,0.00
2024-12-10 17:21:20,90,5007,50,40,3284.90,6101.00,0.00
2024-12-10 17:21:20,91,5007,51,40,3248.80,6101.01,0.00
2024-12-10 17:21:20,91,5008,51,40,3240.10,6102.00,0.00
2024-12-10 17:21:20,92,5008,51,41,3204.88,6102.01,0.00
2024-12-10 17:21:20,91,5008,51,40,3177.87,6102.82,0.00
2024-12-10 17:21:20,92,5007,52,40,3138.75,6102.91,0.00
2024-12-10 17:21:20,92,5008,52,40,3204.51,6103.00,0.00
2024-12-10 17:21:20,93,5008,53,40,3170.05,6103.01,0.00
2024-12-10 17:21:20,93,5009,53,40,3240.88,6104.00,0.00
2024-12-10 17:21:20,94,5009,53,41,3206.40,6104.01,0.00
2024-12-10 17:21:20,94,5010,53,41,3205.18,6105.00,0.00
2024-12-10 17:21:20,95,5010,54,41,3171.45,6105.01,0.00
2024-12-10 17:21:20,95,5011,54,41,3161.35,6106.00,0.00
2024-12-10 17:21:20,96,5011,54,42,3128.42,6106.01,0.00
2024-12-10 17:21:20,95,5011,54,41,3158.15,6106.05,0.00
2024-12-10 17:21:20,95,5012,54,41,3144.09,6107.00,0.00
2024-12-10 17:21:20,96,5012,54,42,3111.34,6107.01,0.00
2024-12-10 17:21:20,95,5012,53,42,3140.89,6107.05,0.00
2024-12-10 17:21:20,94,5012,52,42,3174.10,6107.05,0.00
2024-12-10 17:21:20,93,5012,51,42,3154.95,6107.56,0.00
2024-12-10 17:21:20,93,5013,51,42,3190.75,6108.00,0.00
2024-12-10 17:21:20,94,5013,51,43,3156.80,6108.01,0.00
2024-12-10 17:21:20,93,5013,50,43,3185.10,6108.10,0.00
2024-12-10 17:21:20,93,5014,50,43,3175.67,6109.00,0.00
2024-12-10 17:21:20,94,5014,50,44,3141.89,6109.01,0.00
2024-12-10 17:21:20,93,5014,50,43,3172.40,6109.05,0.00
2024-12-10 17:21:20,92,5014,50,42,3179.85,6109.38,0.00
2024-12-10 17:21:20,92,5015,50,42,3200.38,6110.00,0.00
2024-12-10 17:21:20,93,5015,50,43,3165.96,6110.01,0.00
2024-12-10 17:21:20,92,5015,50,42,3197.07,6110.05,0.00
2024-12-10 17:21:20,91,5015,50,41,3202.70,6110.52,0.00
2024-12-10 17:21:20,91,5016,50,41,3231.33,6111.00,0.00
2024-12-10 17:21:20,92,5016,50,42,3196.21,6111.01,0.00
2024-12-10 17:21:20,92,5017,50,42,3181.45,6112.00,0.00
2024-12-10 17:21:20,93,5017,50,43,3147.24,6112.01,0.00
2024-12-10 17:21:20,92,5017,49,43,3178.14,6112.05,0.00
2024-12-10 17:21:20,91,5017,48,43,3212.57,6112.06,0.00
2024-12-10 17:21:20,91,5018,48,43,3187.78,6113.00,0.00
2024-12-10 17:21:20,92,5018,49,43,3153.13,6113.01,0.00
2024-12-10 17:21:20,91,5018,49,42,3185.10,6113.04,0.00
2024-12-10 17:21:20,90,5018,49,41,3220.30,6113.04,0.00
2024-12-10 17:21:20,91,5017,49,42,3118.96,6113.91,0.00
2024-12-10 17:21:20,91,5018,49,42,3187.18,6114.00,0.00
2024-12-10 17:21:20,92,5018,49,43,3152.54,6114.01,0.00
2024-12-10 17:21:20,92,5019,49,43,3142.92,6115.00,0.00
2024-12-10 17:21:20,93,5019,49,44,3109.13,6115.01,0.00
2024-12-10 17:21:20,92,5019,48,44,3082.75,6115.86,0.00
2024-12-10 17:21:20,91,5019,48,43,3096.69,6115.88,0.00
2024-12-10 17:21:20,90,5019,47,43,3110.72,6115.89,0.00
2024-12-10 17:21:20,90,5020,47,43,3149.87,6116.00,0.00
2024-12-10 17:21:20,91,5020,48,43,3115.26,6116.01,0.00
2024-12-10 17:21:20,90,5020,48,42,3068.68,6116.98,0.00
2024-12-10 17:21:20,90,5021,48,42,3135.30,6117.00,0.00
2024-12-10 17:21:20,91,5021,48,43,3100.85,6117.01,0.00
2024-12-10 17:21:20,90,5021,47,43,3132.59,6117.04,0.00
2024-12-10 17:21:20,90,5022,47,43,3141.22,6118.00,0.00
2024-12-10 17:21:20,91,5022,47,44,3106.70,6118.01,0.00
2024-12-10 17:21:20,91,5023,47,44,3109.85,6119.00,0.00
2024-12-10 17:21:20,92,5023,48,44,3076.05,6119.01,0.00
2024-12-10 17:21:20,91,5023,47,44,3107.91,6119.03,0.00
2024-12-10 17:21:20,90,5023,47,43,3141.09,6119.04,0.00
2024-12-10 17:21:20,89,5023,46,43,3175.69,6119.05,0.00
2024-12-10 17:21:21,89,5024,46,43,3176.73,6120.00,0.00
2024-12-10 17:21:21,90,5024,47,43,3141.43,6120.01,0.00
2024-12-10 17:21:21,90,5025,47,43,3133.00,6121.00,0.00
2024-12-10 17:21:21,91,5025,48,43,3098.57,6121.01,0.00
2024-12-10 17:21:21,91,5026,48,43,3081.64,6122.00,0.00
2024-12-10 17:21:21,92,5026,49,43,3048.14,6122.01,0.00
2024-12-10 17:21:21,91,5026,48,43,3078.96,6122.04,0.00
2024-12-10 17:21:21,90,5026,48,42,3043.50,6122.87,0.00
2024-12-10 17:21:21,90,5027,48,42,3090.41,6123.00,0.00
2024-12-10 17:21:21,91,5027,49,42,3056.45,6123.01,0.00
2024-12-10 17:21:21,91,5028,49,42,3042.94,6124.00,0.00
2024-12-10 17:21:21,92,5028,50,42,3009.86,6124.01,0.00
2024-12-10 17:21:21,91,5028,49,42,3039.29,6124.07,0.00
2024-12-10 17:21:21,90,5028,49,41,3010.15,6124.87,0.00
2024-12-10 17:21:21,90,5029,49,41,3061.32,6125.00,0.00
2024-12-10 17:21:21,91,5029,50,41,3027.68,6125.01,0.00
2024-12-10 17:21:21,91,5030,50,41,3016.46,6126.00,0.00
2024-12-10 17:21:21,92,5030,50,42,2983.67,6126.01,0.00
2024-12-10 17:21:21,91,5030,50,41,3012.44,6126.07,0.00
2024-12-10 17:21:21,91,5031,50,41,2994.01,6127.00,0.00
2024-12-10 17:21:21,92,5031,51,41,2961.47,6127.01,0.00
2024-12-10 17:21:21,91,5031,50,41,2991.60,6127.04,0.00
2024-12-10 17:21:21,90,5031,49,41,3023.49,6127.06,0.00
2024-12-10 17:21:21,89,5031,48,41,2993.59,6127.89,0.00
2024-12-10 17:21:21,89,5032,48,41,3040.39,6128.00,0.00
2024-12-10 17:21:21,90,5032,48,42,3006.61,6128.01,0.00
2024-12-10 17:21:21,90,5033,48,42,2993.73,6129.00,0.00
2024-12-10 17:21:21,91,5033,49,42,2960.84,6129.01,0.00
2024-12-10 17:21:21,90,5033,49,41,2925.78,6129.89,0.00
2024-12-10 17:21:21,90,5034,49,41,2987.17,6130.00,0.00
2024-12-10 17:21:21,91,5034,49,42,2954.34,6130.01,0.00
2024-12-10 17:21:21,90,5034,48,42,2983.78,6130.06,0.00
2024-12-10 17:21:21,91,5033,49,42,2938.89,6130.28,0.00
2024-12-10 17:21:21,92,5032,49,43,2958.41,6130.33,0.00
2024-12-10 17:21:21,92,5033,49,43,3025.54,6131.00,0.00
2024-12-10 17:21:21,93,5033,50,43,2993.01,6131.01,0.00
2024-12-10 17:21:21,92,5033,50,42,3022.13,6131.07,0.00
2024-12-10 17:21:21,91,5033,49,42,3035.42,6131.33,0.00
2024-12-10 17:21:21,91,5034,49,42,3191.36,6132.00,0.00
2024-12-10 17:21:21,92,5034,49,43,3156.67,6132.01,0.00
2024-12-10 17:21:21,93,5033,49,44,3088.62,6132.59,0.00
2024-12-10 17:21:21,93,5034,49,44,3145.02,6133.00,0.00
2024-12-10 17:21:21,94,5034,50,44,3111.56,6133.01,0.00
2024-12-10 17:21:21,94,5035,50,44,3159.49,6134.00,0.00
2024-12-10 17:21:21,95,5035,51,44,3126.23,6134.01,0.00
2024-12-10 17:21:21,94,5035,51,43,3153.72,6134.06,0.00
2024-12-10 17:21:21,93,5035,50,43,3111.29,6134.85,0.00
2024-12-10 17:21:21,93,5036,50,43,3162.72,6135.00,0.00
2024-12-10 17:21:21,94,5036,50,44,3129.08,6135.01,0.00
2024-12-10 17:21:21,93,5036,49,44,3140.99,6135.06,0.00
2024-12-10 17:21:21,93,5037,49,44,3119.98,6136.00,0.00
2024-12-10 17:21:21,94,5037,49,45,3086.79,6136.01,0.00
2024-12-10 17:21:21,93,5037,49,44,3116.58,6136.01,0.00
2024-12-10 17:21:21,92,5037,49,43,3128.46,6136.02,0.00
2024-12-10 17:21:21,91,5037,49,42,3160.82,6136.04,0.00
2024-12-10 17:21:21,90,5037,48,42,3146.46,6136.49,0.00
2024-12-10 17:21:21,90,5038,48,42,3116.41,6137.00,0.00
2024-12-10 17:21:21,91,5038,49,42,3082.16,6137.01,0.00
2024-12-10 17:21:21,90,5038,49,41,3099.89,6137.04,0.00
2024-12-10 17:21:21,90,5039,49,41,2912.85,6138.00,0.00
2024-12-10 17:21:21,91,5039,49,42,2880.84,6138.01,0.00
2024-12-10 17:21:21,90,5039,48,42,2900.41,6138.01,0.00
2024-12-10 17:21:21,89,5039,48,41,2928.49,6138.08,0.00
2024-12-10 17:21:21,88,5039,47,41,2928.53,6138.16,0.00
2024-12-10 17:21:21,87,5039,46,41,2907.86,6138.49,0.00
2024-12-10 17:21:21,86,5039,46,40,2921.95,6138.50,0.00
2024-12-10 17:21:21,85,5039,46,39,2921.56,6138.61,0.00
2024-12-10 17:21:21,84,5039,45,39,2901.43,6138.81,0.00
2024-12-10 17:21:21,84,5040,45,39,2865.61,6139.00,0.00
2024-12-10 17:21:21,85,5040,45,40,2831.90,6139.01,0.00
2024-12-10 17:21:21,84,5040,45,39,2862.69,6139.05,0.00
2024-12-10 17:21:21,83,5040,44,39,2868.11,6139.35,0.00
2024-12-10 17:21:21,82,5040,44,38,2874.41,6139.57,0.00
2024-12-10 17:21:21,81,5040,44,37,2879.06,6139.68,0.00
2024-12-10 17:21:21,80,5040,43,37,2897.64,6139.70,0.00
2024-12-10 17:21:21,79,5040,42,37,2892.57,6139.82,0.00
2024-12-10 17:21:21,78,5040,41,37,2881.21,6139.95,0.00
2024-12-10 17:21:21,78,5041,41,37,2956.81,6140.00,0.00
2024-12-10 17:21:21,79,5041,41,38,2919.39,6140.01,0.00
2024-12-10 17:21:21,78,5041,40,38,2953.67,6140.05,0.00
2024-12-10 17:21:21,77,5041,39,38,2927.24,6140.81,0.00
2024-12-10 17:21:21,76,5041,38,38,2941.45,6140.87,0.00
2024-12-10 17:21:21,76,5042,38,38,3013.84,6141.00,0.00
2024-12-10 17:21:21,77,5042,39,38,2974.70,6141.01,0.00
2024-12-10 17:21:21,76,5042,38,38,3010.59,6141.05,0.00
2024-12-10 17:21:21,76,5043,38,38,3009.68,6142.00,0.00
2024-12-10 17:21:21,77,5043,38,39,2970.59,6142.01,0.00
2024-12-10 17:21:21,76,5043,37,39,3008.07,6142.03,0.00
2024-12-10 17:21:21,76,5044,37,39,2971.58,6143.00,0.00
2024-12-10 17:21:21,77,5044,37,40,2932.99,6143.01,0.00
2024-12-10 17:21:21,76,5044,36,40,2968.36,6143.05,0.00
2024-12-10 17:21:21,75,5044,35,40,2969.35,6143.29,0.00
2024-12-10 17:21:21,74,5044,34,40,3001.95,6143.41,0.00
2024-12-10 17:21:21,74,5045,34,40,3005.93,6144.00,0.00
2024-12-10 17:21:21,75,5045,34,41,2965.85,6144.01,0.00
2024-12-10 17:21:21,74,5045,33,41,3002.61,6144.05,0.00
2024-12-10 17:21:21,73,5045,33,40,2983.85,6144.49,0.00
2024-12-10 17:21:21,72,5045,33,39,2987.18,6144.78,0.00
2024-12-10 17:21:21,72,5046,33,39,3047.64,6145.00,0.00
2024-12-10 17:21:21,73,5046,34,39,3005.89,6145.01,0.00
2024-12-10 17:21:21,72,5046,33,39,3044.93,6145.06,0.00
2024-12-10 17:21:21,71,5046,32,39,3053.98,6145.21,0.00
2024-12-10 17:21:21,71,5047,32,39,3072.51,6146.00,0.00
2024-12-10 17:21:21,72,5047,33,39,3029.83,6146.01,0.00
2024-12-10 17:21:21,71,5047,33,38,3066.30,6146.08,0.00
2024-12-10 17:21:21,70,5047,33,37,3080.64,6146.13,0.00
2024-12-10 17:21:21,70,5048,33,37,3080.46,6147.00,0.00
2024-12-10 17:21:21,71,5048,33,38,3037.08,6147.01,0.00
2024-12-10 17:21:21,70,5048,32,38,3077.83,6147.04,0.00
2024-12-10 17:21:21,69,5048,32,37,3121.55,6147.04,0.00
2024-12-10 17:21:21,68,5048,31,37,3166.55,6147.04,0.00
2024-12-10 17:21:21,67,5048,31,36,3125.23,6147.79,0.00
2024-12-10 17:21:21,67,5049,31,36,3204.32,6148.00,0.00
2024-12-10 17:21:21,68,5049,31,37,3157.19,6148.02,0.00
2024-12-10 17:21:21,67,5049,30,37,3174.77,6148.30,0.00
2024-12-10 17:21:21,66,5049,30,36,3202.94,6148.38,0.00
2024-12-10 17:21:21,66,5050,30,36,3258.35,6149.00,0.00
2024-12-10 17:21:21,67,5050,30,37,3209.72,6149.02,0.00
2024-12-10 17:21:21,66,5050,30,36,3246.24,6149.09,0.00
2024-12-10 17:21:22,66,5051,30,36,3282.03,6150.00,0.00
2024-12-10 17:21:22,67,5051,30,37,3233.05,6150.02,0.00
2024-12-10 17:21:22,67,5052,30,37,3257.71,6151.00,0.00
2024-12-10 17:21:22,68,5052,31,37,3209.80,6151.02,0.00
2024-12-10 17:21:22,68,5053,31,37,3225.21,6152.00,0.00
2024-12-10 17:21:22,69,5053,31,38,3178.47,6152.02,0.00
2024-12-10 17:21:22,68,5053,30,38,3222.50,6152.04,0.00
2024-12-10 17:21:22,68,5054,30,38,3237.20,6153.00,0.00
2024-12-10 17:21:22,69,5054,31,38,3190.29,6153.02,0.00
2024-12-10 17:21:22,68,5054,30,38,3234.49,6153.04,0.00
2024-12-10 17:21:22,67,5054,29,38,3248.90,6153.36,0.00
2024-12-10 17:21:22,67,5055,29,38,3294.99,6154.00,0.00
2024-12-10 17:21:22,68,5055,29,39,3246.53,6154.02,0.00
2024-12-10 17:21:22,67,5055,29,38,3293.18,6154.03,0.00
2024-12-10 17:21:22,66,5055,28,38,3342.15,6154.03,0.00
2024-12-10 17:21:22,66,5056,28,38,3354.83,6155.00,0.00
2024-12-10 17:21:22,67,5056,28,39,3304.76,6155.02,0.00
2024-12-10 17:21:22,66,5056,27,39,3314.00,6155.38,0.00
2024-12-10 17:21:22,66,5057,27,39,3363.73,6156.00,0.00
2024-12-10 17:21:22,67,5057,27,40,3313.53,6156.02,0.00
2024-12-10 17:21:22,67,5058,27,40,3339.77,6157.00,0.00
2024-12-10 17:21:22,68,5058,27,41,3290.66,6157.02,0.00
2024-12-10 17:21:22,67,5058,27,40,3337.94,6157.03,0.00
2024-12-10 17:21:22,66,5058,27,39,3385.03,6157.08,0.00
2024-12-10 17:21:22,66,5059,27,39,3415.81,6158.00,0.00
2024-12-10 17:21:22,67,5059,28,39,3364.83,6158.02,0.00
2024-12-10 17:21:22,66,5059,27,39,3413.95,6158.03,0.00
2024-12-10 17:21:22,66,5060,27,39,3428.62,6159.00,0.00
2024-12-10 17:21:22,67,5060,27,40,3377.45,6159.02,0.00
2024-12-10 17:21:22,67,5061,27,40,3391.85,6160.00,0.00
2024-12-10 17:21:22,68,5061,27,41,3341.97,6160.02,0.00
2024-12-10 17:21:22,67,5061,27,40,3357.55,6160.25,0.00
2024-12-10 17:21:22,67,5062,27,40,3399.85,6161.00,0.00
2024-12-10 17:21:22,68,5062,27,41,3349.85,6161.02,0.00
2024-12-10 17:21:22,67,5062,26,41,3370.36,6161.21,0.00
2024-12-10 17:21:22,67,5063,26,41,3410.83,6162.00,0.00
2024-12-10 17:21:22,68,5063,26,42,3360.67,6162.02,0.00
2024-12-10 17:21:22,67,5063,26,41,3408.99,6162.03,0.00
2024-12-10 17:21:22,66,5063,25,41,3440.23,6162.17,0.00
2024-12-10 17:21:22,66,5064,25,41,3475.89,6163.00,0.00
2024-12-10 17:21:22,67,5064,26,41,3424.01,6163.02,0.00
2024-12-10 17:21:22,67,5065,26,41,3444.95,6164.00,0.00
2024-12-10 17:21:22,68,5065,26,42,3394.29,6164.02,0.00
2024-12-10 17:21:22,68,5066,26,42,3411.29,6165.00,0.00
2024-12-10 17:21:22,69,5066,27,42,3361.85,6165.02,0.00
2024-12-10 17:21:22,69,5066,27,42,3377.72,6166.00,0.00
2024-12-10 17:21:22,70,5066,27,43,3329.47,6166.01,0.00
2024-12-10 17:21:22,70,5067,27,43,3341.86,6167.00,0.00
2024-12-10 17:21:22,71,5067,28,43,3294.79,6167.01,0.00
2024-12-10 17:21:22,70,5067,28,42,3337.58,6167.07,0.00
2024-12-10 17:21:22,69,5067,28,41,3350.44,6167.55,0.00
2024-12-10 17:21:22,69,5068,28,41,3397.14,6168.00,0.00
2024-12-10 17:21:22,70,5068,28,42,3348.60,6168.01,0.00
2024-12-10 17:21:22,69,5068,27,42,3394.46,6168.04,0.00
2024-12-10 17:21:22,69,5069,27,42,3397.03,6169.00,0.00
2024-12-10 17:21:22,70,5069,27,43,3348.50,6169.01,0.00
2024-12-10 17:21:22,69,5069,27,42,3394.62,6169.04,0.00
2024-12-10 17:21:22,68,5069,26,42,3380.56,6169.66,0.00
2024-12-10 17:21:22,68,5070,26,42,3450.71,6170.00,0.00
2024-12-10 17:21:22,69,5070,26,43,3400.70,6170.02,0.00
2024-12-10 17:21:22,69,5071,26,43,3423.31,6171.00,0.00
2024-12-10 17:21:22,70,5071,26,44,3374.40,6171.01,0.00
2024-12-10 17:21:22,69,5071,25,44,3398.14,6171.25,0.00
2024-12-10 17:21:22,69,5072,25,44,3441.41,6172.00,0.00
2024-12-10 17:21:22,70,5072,25,45,3392.24,6172.01,0.00
2024-12-10 17:21:22,70,5073,25,45,3419.35,6173.00,0.00
2024-12-10 17:21:22,71,5073,26,45,3371.19,6173.01,0.00
2024-12-10 17:21:22,70,5073,25,45,3416.71,6173.04,0.00
2024-12-10 17:21:22,70,5074,25,45,3440.98,6174.00,0.00
2024-12-10 17:21:22,71,5074,26,45,3392.51,6174.01,0.00
2024-12-10 17:21:22,70,5074,25,45,3435.57,6174.06,0.00
2024-12-10 17:21:22,70,5075,25,45,3455.25,6175.00,0.00
2024-12-10 17:21:22,71,5075,25,46,3406.58,6175.01,0.00
2024-12-10 17:21:22,70,5075,24,46,3444.95,6175.04,0.00
2024-12-10 17:21:22,70,5076,24,46,3456.37,6176.00,0.00
2024-12-10 17:21:22,71,5076,24,47,3407.69,6176.01,0.00
2024-12-10 17:21:22,70,5076,23,47,3455.57,6176.01,0.00
2024-12-10 17:21:22,69,5076,22,47,3494.50,6176.02,0.00
2024-12-10 17:21:22,68,5076,21,47,3544.98,6176.02,0.00
2024-12-10 17:21:22,69,5075,21,48,3490.03,6176.10,0.00
2024-12-10 17:21:22,69,5076,21,48,3574.39,6177.00,0.00
2024-12-10 17:21:22,70,5076,21,49,3523.32,6177.01,0.00
2024-12-10 17:21:22,69,5076,20,49,3573.49,6177.02,0.00
2024-12-10 17:21:22,68,5076,19,49,3592.93,6177.43,0.00
2024-12-10 17:21:22,68,5077,19,49,3737.24,6178.00,0.00
2024-12-10 17:21:22,69,5077,19,50,3683.08,6178.02,0.00
2024-12-10 17:21:22,68,5077,19,49,3736.43,6178.02,0.00
2024-12-10 17:21:22,68,5078,19,49,3758.65,6179.00,0.00
2024-12-10 17:21:22,69,5078,20,49,3704.18,6179.02,0.00
2024-12-10 17:21:22,69,5079,20,49,3723.42,6180.00,0.00
2024-12-10 17:21:22,70,5079,21,49,3670.22,6180.01,0.00
2024-12-10 17:21:22,69,5079,21,48,3722.27,6180.03,0.00
2024-12-10 17:21:22,69,5080,21,48,3736.04,6181.00,0.00
2024-12-10 17:21:22,70,5080,21,49,3682.67,6181.01,0.00
2024-12-10 17:21:22,70,5081,21,49,3682.67,6182.00,0.00
2024-12-10 17:21:22,71,5081,22,49,3630.80,6182.01,0.00
2024-12-10 17:21:22,71,5082,22,49,3623.82,6183.00,0.00
2024-12-10 17:21:22,72,5082,22,50,3573.49,6183.01,0.00
2024-12-10 17:21:22,71,5082,22,49,3615.96,6183.14,0.00
2024-12-10 17:21:22,70,5082,22,48,3634.40,6183.44,0.00
2024-12-10 17:21:22,70,5083,22,48,3674.88,6184.00,0.00
2024-12-10 17:21:22,71,5083,23,48,3623.12,6184.01,0.00
2024-12-10 17:21:23,70,5083,23,47,3674.49,6184.01,0.00
2024-12-10 17:21:23,70,5084,23,47,3676.36,6185.00,0.00
2024-12-10 17:21:23,71,5084,23,48,3624.58,6185.01,0.00
2024-12-10 17:21:23,71,5085,23,48,3626.00,6186.00,0.00
2024-12-10 17:21:23,72,5085,24,48,3575.64,6186.01,0.00
2024-12-10 17:21:23,72,5086,24,48,3572.68,6187.00,0.00
2024-12-10 17:21:23,73,5086,24,49,3523.74,6187.01,0.00
2024-12-10 17:21:23,73,5087,24,49,3514.42,6188.00,0.00
2024-12-10 17:21:23,74,5087,25,49,3466.92,6188.01,0.00
2024-12-10 17:21:23,73,5087,25,48,3435.20,6188.77,0.00
2024-12-10 17:21:23,74,5086,25,49,3387.13,6188.81,0.00
2024-12-10 17:21:23,74,5087,25,49,3495.75,6189.00,0.00
2024-12-10 17:21:23,75,5087,25,50,3449.14,6189.01,0.00
2024-12-10 17:21:23,74,5087,24,50,3472.82,6189.19,0.00
2024-12-10 17:21:23,74,5088,24,50,3583.95,6190.00,0.00
2024-12-10 17:21:23,75,5088,24,51,3536.17,6190.01,0.00
2024-12-10 17:21:23,74,5088,24,50,3567.99,6190.08,0.00
2024-12-10 17:21:23,74,5089,24,50,3576.62,6191.00,0.00
2024-12-10 17:21:23,75,5089,25,50,3528.93,6191.01,0.00
2024-12-10 17:21:23,74,5089,25,49,3572.88,6191.04,0.00
2024-12-10 17:21:23,73,5089,24,49,3621.04,6191.04,0.00
2024-12-10 17:21:23,72,5089,23,49,3669.74,6191.04,0.00
2024-12-10 17:21:23,71,5089,22,49,3707.73,6191.25,0.00
2024-12-10 17:21:23,71,5090,22,49,3723.15,6192.00,0.00
2024-12-10 17:21:23,72,5090,23,49,3671.44,6192.01,0.00
2024-12-10 17:21:23,72,5091,23,49,3660.70,6193.00,0.00
2024-12-10 17:21:23,73,5091,23,50,3610.56,6193.01,0.00
2024-12-10 17:21:23,73,5092,23,50,3575.80,6194.00,0.00
2024-12-10 17:21:23,74,5092,23,51,3527.48,6194.01,0.00
2024-12-10 17:21:23,73,5092,23,50,3555.24,6194.08,0.00
2024-12-10 17:21:23,73,5093,23,50,3514.99,6195.00,0.00
2024-12-10 17:21:23,74,5093,24,50,3467.49,6195.01,0.00
2024-12-10 17:21:23,73,5093,24,49,3506.51,6195.07,0.00
2024-12-10 17:21:23,72,5093,24,48,3441.52,6195.92,0.00
2024-12-10 17:21:23,72,5094,24,48,3515.65,6196.00,0.00
2024-12-10 17:21:23,73,5094,25,48,3467.49,6196.01,0.00
2024-12-10 17:21:23,72,5094,25,47,3513.94,6196.03,0.00
2024-12-10 17:21:23,71,5094,24,47,3534.09,6196.41,0.00
2024-12-10 17:21:23,70,5094,23,47,3564.06,6196.69,0.00
2024-12-10 17:21:23,70,5095,23,47,3596.81,6197.00,0.00
2024-12-10 17:21:23,71,5095,24,47,3546.15,6197.01,0.00
2024-12-10 17:21:23,71,5096,24,47,3517.72,6198.00,0.00
2024-12-10 17:21:23,72,5096,24,48,3468.86,6198.01,0.00
2024-12-10 17:21:23,71,5096,24,47,3510.86,6198.06,0.00
2024-12-10 17:21:23,71,5097,24,47,3484.04,6199.00,0.00
2024-12-10 17:21:23,72,5097,24,48,3435.65,6199.01,0.00
2024-12-10 17:21:23,71,5097,24,47,3481.99,6199.04,0.00
2024-12-10 17:21:23,70,5097,24,46,3527.97,6199.04,0.00
2024-12-10 17:21:23,71,5096,25,46,3427.92,6199.68,0.00
2024-12-10 17:21:23,70,5096,25,45,3483.05,6199.71,0.00
2024-12-10 17:21:23,70,5097,25,45,3547.02,6200.00,0.00
2024-12-10 17:21:23,71,5097,25,46,3497.06,6200.01,0.00
2024-12-10 17:21:23,71,5098,25,46,3583.62,6201.00,0.00
2024-12-10 17:21:23,72,5098,25,47,3533.85,6201.01,0.00
2024-12-10 17:21:23,71,5098,24,47,3581.05,6201.04,0.00
2024-12-10 17:21:23,70,5098,23,47,3625.59,6201.04,0.00
2024-12-10 17:21:23,70,5099,23,47,3622.67,6202.00,0.00
2024-12-10 17:21:23,71,5099,23,48,3571.65,6202.01,0.00
2024-12-10 17:21:23,71,5100,23,48,3558.94,6203.00,0.00
2024-12-10 17:21:23,72,5100,24,48,3509.51,6203.01,0.00
2024-12-10 17:21:23,71,5100,23,48,3508.16,6203.47,0.00
2024-12-10 17:21:23,71,5101,23,48,3541.28,6204.00,0.00
2024-12-10 17:21:23,72,5101,23,49,3492.09,6204.01,0.00
2024-12-10 17:21:23,72,5102,23,49,3483.06,6205.00,0.00
2024-12-10 17:21:23,73,5102,23,50,3435.34,6205.01,0.00
2024-12-10 17:21:23,72,5102,23,49,3455.24,6205.22,0.00
2024-12-10 17:21:23,71,5102,22,49,3473.19,6205.63,0.00
2024-12-10 17:21:23,71,5103,22,49,3526.75,6206.00,0.00
2024-12-10 17:21:23,72,5103,22,50,3477.77,6206.01,0.00
2024-12-10 17:21:23,71,5103,22,49,3525.01,6206.03,0.00
2024-12-10 17:21:23,71,5104,22,49,3528.89,6207.00,0.00
2024-12-10 17:21:23,72,5104,23,49,3479.88,6207.01,0.00
2024-12-10 17:21:23,71,5104,22,49,3525.25,6207.06,0.00
2024-12-10 17:21:23,71,5105,22,49,3530.87,6208.00,0.00
2024-12-10 17:21:23,72,5105,22,50,3481.83,6208.01,0.00
2024-12-10 17:21:23,72,5106,22,50,3461.39,6209.00,0.00
2024-12-10 17:21:23,73,5106,23,50,3413.97,6209.01,0.00
2024-12-10 17:21:23,72,5106,22,50,3449.04,6209.08,0.00
2024-12-10 17:21:23,71,5106,22,49,3495.48,6209.08,0.00
2024-12-10 17:21:23,70,5106,22,48,3532.24,6209.20,0.00
2024-12-10 17:21:23,69,5106,21,48,3555.61,6209.64,0.00
2024-12-10 17:21:23,68,5106,21,47,3573.42,6209.85,0.00
2024-12-10 17:21:23,68,5107,21,47,3655.74,6210.00,0.00
2024-12-10 17:21:23,69,5107,21,48,3602.75,6210.02,0.00
2024-12-10 17:21:23,68,5107,21,47,3650.52,6210.09,0.00
2024-12-10 17:21:23,68,5108,21,47,3663.78,6211.00,0.00
2024-12-10 17:21:23,69,5108,21,48,3610.68,6211.02,0.00
2024-12-10 17:21:23,70,5107,21,49,3553.80,6211.13,0.00
2024-12-10 17:21:23,70,5108,21,49,3622.84,6212.00,0.00
2024-12-10 17:21:23,71,5108,22,49,3571.82,6212.01,0.00
2024-12-10 17:21:23,71,5109,22,49,3644.20,6213.00,0.00
2024-12-10 17:21:23,72,5109,22,50,3593.59,6213.01,0.00
2024-12-10 17:21:23,71,5109,22,49,3601.84,6213.42,0.00
2024-12-10 17:21:23,71,5110,22,49,3647.82,6214.00,0.00
2024-12-10 17:21:23,72,5110,23,49,3597.15,6214.01,0.00
2024-12-10 17:21:23,72,5111,23,49,3609.06,6215.00,0.00
2024-12-10 17:21:23,73,5111,24,49,3559.62,6215.01,0.00
2024-12-10 17:21:23,73,5112,24,49,3567.35,6216.00,0.00
2024-12-10 17:21:23,74,5112,25,49,3519.15,6216.01,0.00
2024-12-10 17:21:23,74,5113,25,49,3513.23,6217.00,0.00
2024-12-10 17:21:23,75,5113,26,49,3466.39,6217.01,0.00
2024-12-10 17:21:23,74,5113,26,48,3508.53,6217.07,0.00
2024-12-10 17:21:23,74,5114,26,48,3495.43,6218.00,0.00
2024-12-10 17:21:23,75,5114,27,48,3448.82,6218.01,0.00
2024-12-10 17:21:23,74,5114,27,47,3404.07,6218.82,0.00
2024-12-10 17:21:24,74,5115,27,47,3475.58,6219.00,0.00
2024-12-10 17:21:24,75,5115,28,47,3429.24,6219.01,0.00
2024-12-10 17:21:24,74,5115,28,46,3446.75,6219.39,0.00
2024-12-10 17:21:24,74,5116,28,46,3487.96,6220.00,0.00
2024-12-10 17:21:24,75,5116,29,46,3441.46,6220.01,0.00
2024-12-10 17:21:24,74,5116,29,45,3448.51,6220.57,0.00
2024-12-10 17:21:24,74,5117,29,45,3499.96,6221.00,0.00
2024-12-10 17:21:24,75,5117,30,45,3453.30,6221.01,0.00
2024-12-10 17:21:24,75,5118,30,45,3469.22,6222.00,0.00
2024-12-10 17:21:24,76,5118,31,45,3423.57,6222.01,0.00
2024-12-10 17:21:24,77,5117,32,45,3379.11,6222.04,0.00
2024-12-10 17:21:24,76,5117,31,45,3465.44,6222.04,0.00
2024-12-10 17:21:24,76,5118,31,45,3483.28,6223.00,0.00
2024-12-10 17:21:24,77,5118,32,45,3438.05,6223.01,0.00
2024-12-10 17:21:24,77,5119,32,45,3524.62,6224.00,0.00
2024-12-10 17:21:24,78,5119,32,46,3479.43,6224.01,0.00
2024-12-10 17:21:24,78,5120,32,46,3468.21,6225.00,0.00
2024-12-10 17:21:24,79,5120,33,46,3424.31,6225.01,0.00
2024-12-10 17:21:24,78,5120,32,46,3370.74,6225.87,0.00
2024-12-10 17:21:24,78,5121,32,46,3442.68,6226.00,0.00
2024-12-10 17:21:24,79,5121,32,47,3399.11,6226.01,0.00
2024-12-10 17:21:24,78,5121,32,46,3441.10,6226.03,0.00
2024-12-10 17:21:24,78,5122,32,46,3430.18,6227.00,0.00
2024-12-10 17:21:24,79,5122,32,47,3386.76,6227.01,0.00
2024-12-10 17:21:24,78,5122,32,46,3369.67,6227.80,0.00
2024-12-10 17:21:24,78,5123,32,46,3425.11,6228.00,0.00
2024-12-10 17:21:24,79,5123,32,47,3381.75,6228.01,0.00
2024-12-10 17:21:24,79,5124,32,47,3379.98,6229.00,0.00
2024-12-10 17:21:24,80,5124,32,48,3337.73,6229.01,0.00
2024-12-10 17:21:24,80,5125,32,48,3329.55,6230.00,0.00
2024-12-10 17:21:24,81,5125,33,48,3288.44,6230.01,0.00
2024-12-10 17:21:24,80,5125,33,47,3328.00,6230.03,0.00
2024-12-10 17:21:24,79,5125,32,47,3305.63,6230.85,0.00
2024-12-10 17:21:24,79,5126,32,47,3375.17,6231.00,0.00
2024-12-10 17:21:24,80,5126,33,47,3332.98,6231.01,0.00
2024-12-10 17:21:24,80,5127,33,47,3348.32,6232.00,0.00
2024-12-10 17:21:24,81,5127,34,47,3306.99,6232.01,0.00
2024-12-10 17:21:24,81,5128,34,47,3322.91,6233.00,0.00
2024-12-10 17:21:24,82,5128,35,47,3282.38,6233.01,0.00
2024-12-10 17:21:24,81,5128,34,47,3319.14,6233.06,0.00
2024-12-10 17:21:24,81,5129,34,47,3337.67,6234.00,0.00
2024-12-10 17:21:24,82,5129,35,47,3296.97,6234.01,0.00
2024-12-10 17:21:24,82,5130,35,47,3306.97,6235.00,0.00
2024-12-10 17:21:24,83,5130,35,48,3267.12,6235.01,0.00
2024-12-10 17:21:24,83,5131,35,48,3270.89,6236.00,0.00
2024-12-10 17:21:24,84,5131,35,49,3231.95,6236.01,0.00
2024-12-10 17:21:24,83,5131,35,48,3268.49,6236.05,0.00
2024-12-10 17:21:24,83,5132,35,48,3270.78,6237.00,0.00
2024-12-10 17:21:24,84,5132,35,49,3231.84,6237.01,0.00
2024-12-10 17:21:24,83,5132,35,48,3267.82,6237.05,0.00
2024-12-10 17:21:24,83,5133,35,48,3268.16,6238.00,0.00
2024-12-10 17:21:24,84,5133,36,48,3229.26,6238.01,0.00
2024-12-10 17:21:24,83,5133,36,47,3266.71,6238.02,0.00
2024-12-10 17:21:24,83,5134,36,47,3266.28,6239.00,0.00
2024-12-10 17:21:24,84,5134,37,47,3227.39,6239.01,0.00
2024-12-10 17:21:24,85,5133,37,48,3170.41,6239.34,0.00
2024-12-10 17:21:24,84,5133,36,48,3230.09,6239.82,0.00
2024-12-10 17:21:24,84,5134,36,48,3293.39,6240.00,0.00
2024-12-10 17:21:24,85,5134,36,49,3254.64,6240.01,0.00
2024-12-10 17:21:24,85,5135,36,49,3340.33,6241.00,0.00
2024-12-10 17:21:24,86,5135,37,49,3301.49,6241.01,0.00
2024-12-10 17:21:24,86,5136,37,49,3312.67,6242.00,0.00
2024-12-10 17:21:24,87,5136,38,49,3274.60,6242.01,0.00
2024-12-10 17:21:24,86,5136,37,49,3310.67,6242.04,0.00
2024-12-10 17:21:24,86,5137,37,49,3321.49,6243.00,0.00
2024-12-10 17:21:24,87,5137,38,49,3283.31,6243.01,0.00
2024-12-10 17:21:24,87,5138,38,49,3292.55,6244.00,0.00
2024-12-10 17:21:24,88,5138,39,49,3255.13,6244.01,0.00
2024-12-10 17:21:24,88,5139,39,49,3264.78,6245.00,0.00
2024-12-10 17:21:24,89,5139,39,50,3228.09,6245.01,0.00
2024-12-10 17:21:24,88,5139,38,50,3261.18,6245.07,0.00
2024-12-10 17:21:24,88,5140,38,50,3274.47,6246.00,0.00
2024-12-10 17:21:24,89,5140,39,50,3237.68,6246.01,0.00
2024-12-10 17:21:24,88,5140,39,49,3272.53,6246.03,0.00
2024-12-10 17:21:24,87,5140,39,48,3305.61,6246.10,0.00
2024-12-10 17:21:24,87,5141,39,48,3321.92,6247.00,0.00
2024-12-10 17:21:24,88,5141,40,48,3284.17,6247.01,0.00
2024-12-10 17:21:24,88,5142,40,48,3293.92,6248.00,0.00
2024-12-10 17:21:24,89,5142,41,48,3256.91,6248.01,0.00
2024-12-10 17:21:24,89,5143,41,48,3265.86,6249.00,0.00
2024-12-10 17:21:24,90,5143,41,49,3229.57,6249.01,0.00
2024-12-10 17:21:24,89,5143,41,48,3263.76,6249.03,0.00
2024-12-10 17:21:24,89,5144,41,48,3274.11,6250.00,0.00
2024-12-10 17:21:24,90,5144,41,49,3237.73,6250.01,0.00
2024-12-10 17:21:24,89,5144,41,48,3272.01,6250.03,0.00
2024-12-10 17:21:25,89,5145,41,48,3282.36,6251.00,0.00
2024-12-10 17:21:25,90,5145,42,48,3245.89,6251.01,0.00
2024-12-10 17:21:25,90,5146,42,48,3254.05,6252.00,0.00
2024-12-10 17:21:25,91,5146,43,48,3218.29,6252.01,0.00
2024-12-10 17:21:25,90,5146,43,47,3251.97,6252.03,0.00
2024-12-10 17:21:25,89,5146,43,46,3288.47,6252.03,0.00
2024-12-10 17:21:25,89,5147,43,46,3294.61,6253.00,0.00
2024-12-10 17:21:25,90,5147,44,46,3258.00,6253.01,0.00
2024-12-10 17:21:25,90,5148,44,46,3248.49,6254.00,0.00
2024-12-10 17:21:25,91,5148,44,47,3212.79,6254.01,0.00
2024-12-10 17:21:25,91,5149,44,47,3179.16,6255.00,0.00
2024-12-10 17:21:25,92,5149,44,48,3144.60,6255.01,0.00
2024-12-10 17:21:25,91,5149,44,47,3177.11,6255.03,0.00
2024-12-10 17:21:25,90,5149,44,46,3134.02,6255.79,0.00
2024-12-10 17:21:25,90,5150,44,46,3172.28,6256.00,0.00
2024-12-10 17:21:25,91,5150,45,46,3137.42,6256.01,0.00
2024-12-10 17:21:25,90,5150,45,45,3170.21,6256.03,0.00
2024-12-10 17:21:25,89,5150,44,45,3199.54,6256.12,0.00
2024-12-10 17:21:25,89,5151,44,45,3162.79,6257.00,0.00
2024-12-10 17:21:25,90,5151,45,45,3127.64,6257.01,0.00
2024-12-10 17:21:25,89,5151,45,44,3113.49,6257.76,0.00
2024-12-10 17:21:25,88,5151,45,43,3147.64,6257.77,0.00
2024-12-10 17:21:25,88,5152,45,43,3204.73,6258.00,0.00
2024-12-10 17:21:25,89,5152,45,44,3168.72,6258.01,0.00
2024-12-10 17:21:25,88,5152,44,44,3202.60,6258.03,0.00
2024-12-10 17:21:25,88,5153,44,44,3213.78,6259.00,0.00
2024-12-10 17:21:25,89,5153,44,45,3177.67,6259.01,0.00
2024-12-10 17:21:25,88,5153,44,44,3211.65,6259.03,0.00
2024-12-10 17:21:25,87,5153,44,43,3243.86,6259.10,0.00
2024-12-10 17:21:25,87,5154,44,43,3260.19,6260.00,0.00
2024-12-10 17:21:25,88,5154,45,43,3223.15,6260.01,0.00
2024-12-10 17:21:25,87,5154,45,42,3258.04,6260.04,0.00
2024-12-10 17:21:25,87,5155,45,42,3270.07,6261.00,0.00
2024-12-10 17:21:25,88,5155,45,43,3232.91,6261.01,0.00
2024-12-10 17:21:25,87,5155,45,42,3267.92,6261.04,0.00
2024-12-10 17:21:25,87,5156,45,42,3279.91,6262.00,0.00
2024-12-10 17:21:25,88,5156,46,42,3242.64,6262.01,0.00
2024-12-10 17:21:25,87,5156,46,41,3277.76,6262.04,0.00
2024-12-10 17:21:25,86,5156,46,40,3315.79,6262.04,0.00
2024-12-10 17:21:25,85,5156,45,40,3354.48,6262.04,0.00
2024-12-10 17:21:25,85,5157,45,40,3363.50,6263.00,0.00
2024-12-10 17:21:25,86,5157,46,40,3324.39,6263.01,0.00
2024-12-10 17:21:25,86,5158,46,40,3327.06,6264.00,0.00
2024-12-10 17:21:25,87,5158,46,41,3288.82,6264.01,0.00
2024-12-10 17:21:25,87,5159,46,41,3286.75,6265.00,0.00
2024-12-10 17:21:25,88,5159,47,41,3249.40,6265.01,0.00
2024-12-10 17:21:25,87,5159,47,40,3285.18,6265.04,0.00
2024-12-10 17:21:25,86,5159,47,39,3292.90,6265.42,0.00
2024-12-10 17:21:25,86,5160,47,39,3329.75,6266.00,0.00
2024-12-10 17:21:25,87,5160,48,39,3291.48,6266.01,0.00
2024-12-10 17:21:25,86,5160,48,38,3315.56,6266.23,0.00
2024-12-10 17:21:25,86,5161,48,38,3340.82,6267.00,0.00
2024-12-10 17:21:25,87,5161,49,38,3302.42,6267.01,0.00
2024-12-10 17:21:25,87,5162,49,38,3313.04,6268.00,0.00
2024-12-10 17:21:25,88,5162,49,39,3275.39,6268.01,0.00
2024-12-10 17:21:25,88,5163,49,39,3284.77,6269.00,0.00
2024-12-10 17:21:25,89,5163,50,39,3247.86,6269.01,0.00
2024-12-10 17:21:25,88,5163,50,38,3282.79,6269.02,0.00
2024-12-10 17:21:25,88,5164,50,38,3291.01,6270.00,0.00
2024-12-10 17:21:25,89,5164,50,39,3254.03,6270.01,0.00
2024-12-10 17:21:25,88,5164,50,38,3289.64,6270.02,0.00
2024-12-10 17:21:25,88,5165,50,38,3293.90,6271.00,0.00
2024-12-10 17:21:25,89,5165,51,38,3256.89,6271.01,0.00
2024-12-10 17:21:25,88,5165,51,37,3288.44,6271.07,0.00
2024-12-10 17:21:25,88,5166,51,37,3290.22,6272.00,0.00
2024-12-10 17:21:25,89,5166,51,38,3253.26,6272.01,0.00
2024-12-10 17:21:25,90,5165,51,39,3206.77,6272.16,0.00
2024-12-10 17:21:25,89,5165,51,38,3298.36,6272.20,0.00
2024-12-10 17:21:25,89,5166,51,38,3305.90,6273.00,0.00
2024-12-10 17:21:25,90,5166,51,39,3269.16,6273.01,0.00
2024-12-10 17:21:25,89,5166,50,39,3303.71,6273.02,0.00
2024-12-10 17:21:25,88,5166,50,38,3341.14,6273.02,0.00
2024-12-10 17:21:25,88,5167,50,38,3403.86,6274.00,0.00
2024-12-10 17:21:25,89,5167,51,38,3365.62,6274.01,0.00
2024-12-10 17:21:25,88,5167,51,37,3395.95,6274.09,0.00
2024-12-10 17:21:25,88,5168,51,37,3390.91,6275.00,0.00
2024-12-10 17:21:25,89,5168,52,37,3352.81,6275.01,0.00
2024-12-10 17:21:25,89,5169,52,37,3335.25,6276.00,0.00
2024-12-10 17:21:25,90,5169,53,37,3298.19,6276.01,0.00
2024-12-10 17:21:25,90,5170,53,37,3280.09,6277.00,0.00
2024-12-10 17:21:25,91,5170,53,38,3244.04,6277.01,0.00
2024-12-10 17:21:25,90,5170,52,38,3276.44,6277.04,0.00
2024-12-10 17:21:25,89,5170,51,38,3311.71,6277.06,0.00
2024-12-10 17:21:25,89,5171,51,38,3304.75,6278.00,0.00
2024-12-10 17:21:25,90,5171,52,38,3268.03,6278.01,0.00
2024-12-10 17:21:25,90,5172,52,38,3253.71,6279.00,0.00
2024-12-10 17:21:25,91,5172,53,38,3217.95,6279.01,0.00
2024-12-10 17:21:25,90,5172,53,37,3247.70,6279.06,0.00
2024-12-10 17:21:25,89,5172,52,37,3277.29,6279.11,0.00
2024-12-10 17:21:25,90,5171,52,38,3179.71,6279.87,0.00
2024-12-10 17:21:25,90,5172,52,38,3235.05,6280.00,0.00
2024-12-10 17:21:25,91,5172,52,39,3199.50,6280.01,0.00
2024-12-10 17:21:25,90,5172,52,38,3222.48,6280.09,0.00
2024-12-10 17:21:25,90,5173,52,38,3241.74,6281.00,0.00
2024-12-10 17:21:25,91,5173,52,39,3206.12,6281.01,0.00
2024-12-10 17:21:25,90,5173,52,38,3233.95,6281.04,0.00
2024-12-10 17:21:25,89,5173,51,38,3248.24,6281.26,0.00
2024-12-10 17:21:25,89,5174,51,38,3184.82,6282.00,0.00
2024-12-10 17:21:25,90,5174,52,38,3149.43,6282.01,0.00
2024-12-10 17:21:25,89,5174,51,38,3171.39,6282.10,0.00
2024-12-10 17:21:25,88,5174,51,37,3192.21,6282.25,0.00
2024-12-10 17:21:25,87,5174,50,37,3217.68,6282.31,0.00
2024-12-10 17:21:25,86,5174,49,37,3171.00,6282.81,0.00
2024-12-10 17:21:26,86,5175,49,37,3185.88,6283.00,0.00
2024-12-10 17:21:26,87,5175,49,38,3149.26,6283.01,0.00
2024-12-10 17:21:26,86,5175,48,38,3179.58,6283.05,0.00
2024-12-10 17:21:26,85,5175,48,37,3106.86,6283.81,0.00
2024-12-10 17:21:26,85,5176,48,37,3137.60,6284.00,0.00
2024-12-10 17:21:26,86,5176,49,37,3101.12,6284.01,0.00
2024-12-10 17:21:26,86,5177,49,37,3034.64,6285.00,0.00
2024-12-10 17:21:26,87,5177,50,37,2999.76,6285.01,0.00
2024-12-10 17:21:26,86,5177,50,36,3028.22,6285.06,0.00
2024-12-10 17:21:26,85,5177,50,35,3056.92,6285.14,0.00
2024-12-10 17:21:26,85,5178,50,35,3001.29,6286.00,0.00
2024-12-10 17:21:26,86,5178,51,35,2966.39,6286.01,0.00
2024-12-10 17:21:26,85,5178,50,35,2914.55,6286.79,0.00
2024-12-10 17:21:26,85,5179,50,35,2957.29,6287.00,0.00
2024-12-10 17:21:26,86,5179,51,35,2922.90,6287.01,0.00
2024-12-10 17:21:26,86,5180,51,35,2890.44,6288.00,0.00
2024-12-10 17:21:26,87,5180,52,35,2857.21,6288.01,0.00
2024-12-10 17:21:26,87,5181,52,35,2819.33,6289.00,0.00
2024-12-10 17:21:26,88,5181,52,36,2787.29,6289.01,0.00
2024-12-10 17:21:26,87,5181,52,35,2815.38,6289.01,0.00
2024-12-10 17:21:26,88,5180,52,36,2676.42,6289.84,0.00
2024-12-10 17:21:26,88,5181,52,36,2756.93,6290.00,0.00
2024-12-10 17:21:26,89,5181,52,37,2725.95,6290.01,0.00
2024-12-10 17:21:26,88,5181,52,36,2742.46,6290.14,0.00
2024-12-10 17:21:26,87,5181,52,35,2773.04,6290.14,0.00
2024-12-10 17:21:26,86,5181,52,34,2701.61,6290.78,0.00
2024-12-10 17:21:26,86,5182,52,34,2809.44,6291.00,0.00
2024-12-10 17:21:26,87,5182,53,34,2777.15,6291.01,0.00
2024-12-10 17:21:26,86,5182,52,34,2798.60,6291.05,0.00
2024-12-10 17:21:26,85,5182,52,33,2824.97,6291.14,0.00
2024-12-10 17:21:26,84,5182,51,33,2851.37,6291.21,0.00
2024-12-10 17:21:26,83,5182,50,33,2855.10,6291.35,0.00
2024-12-10 17:21:26,83,5183,50,33,2816.37,6292.00,0.00
2024-12-10 17:21:26,84,5183,51,33,2782.85,6292.01,0.00
2024-12-10 17:21:26,83,5183,51,32,2814.80,6292.02,0.00
2024-12-10 17:21:26,82,5183,50,32,2845.52,6292.05,0.00
2024-12-10 17:21:26,81,5183,50,31,2860.42,6292.28,0.00
2024-12-10 17:21:26,80,5183,49,31,2863.83,6292.41,0.00
2024-12-10 17:21:26,79,5183,49,30,2834.20,6292.75,0.00
2024-12-10 17:21:26,79,5184,49,30,2874.11,6293.00,0.00
2024-12-10 17:21:26,80,5184,50,30,2838.19,6293.01,0.00
2024-12-10 17:21:26,79,5184,49,30,2862.81,6293.13,0.00
2024-12-10 17:21:26,78,5184,48,30,2881.68,6293.28,0.00
2024-12-10 17:21:26,77,5184,47,30,2917.00,6293.29,0.00
2024-12-10 17:21:26,77,5185,47,30,2888.47,6294.00,0.00
2024-12-10 17:21:26,78,5185,48,30,2851.44,6294.01,0.00
2024-12-10 17:21:26,77,5185,47,30,2812.82,6294.55,0.00
2024-12-10 17:21:26,77,5186,47,30,2835.11,6295.00,0.00
2024-12-10 17:21:26,78,5186,48,30,2798.76,6295.01,0.00
2024-12-10 17:21:26,77,5186,47,30,2831.18,6295.04,0.00
2024-12-10 17:21:26,76,5186,46,30,2842.97,6295.32,0.00
2024-12-10 17:21:26,75,5186,45,30,2864.66,6295.43,0.00
2024-12-10 17:21:26,74,5186,44,30,2898.85,6295.46,0.00
2024-12-10 17:21:26,73,5186,44,29,2934.05,6295.49,0.00
2024-12-10 17:21:26,72,5186,44,28,2972.44,6295.50,0.00
2024-12-10 17:21:26,72,5187,44,28,2996.96,6296.00,0.00
2024-12-10 17:21:26,73,5187,45,28,2955.90,6296.01,0.00
2024-12-10 17:21:26,72,5187,45,27,2992.04,6296.04,0.00
2024-12-10 17:21:26,71,5187,45,26,3009.63,6296.32,0.00
2024-12-10 17:21:26,71,5188,45,26,3016.94,6297.00,0.00
2024-12-10 17:21:26,72,5188,45,27,2975.04,6297.01,0.00
2024-12-10 17:21:26,71,5188,45,26,2994.43,6297.24,0.00
2024-12-10 17:21:26,71,5189,45,26,2995.98,6298.00,0.00
2024-12-10 17:21:26,72,5189,46,26,2954.37,6298.01,0.00
2024-12-10 17:21:26,71,5189,45,26,2962.40,6298.38,0.00
2024-12-10 17:21:26,70,5189,44,26,2985.55,6298.59,0.00
2024-12-10 17:21:26,70,5190,44,26,3020.58,6299.00,0.00
2024-12-10 17:21:26,71,5190,44,27,2978.04,6299.01,0.00
2024-12-10 17:21:26,70,5190,44,26,3019.68,6299.01,0.00
2024-12-10 17:21:26,69,5190,43,26,3055.99,6299.03,0.00
2024-12-10 17:21:26,68,5190,43,25,3087.86,6299.19,0.00
2024-12-10 17:21:26,68,5191,43,25,3091.24,6300.00,0.00
2024-12-10 17:21:26,69,5191,43,26,3046.44,6300.02,0.00
2024-12-10 17:21:26,68,5191,42,26,3087.41,6300.02,0.00
2024-12-10 17:21:26,67,5191,42,25,3132.56,6300.02,0.00
2024-12-10 17:21:26,66,5191,42,24,3175.79,6300.06,0.00
2024-12-10 17:21:26,66,5192,42,24,3151.36,6301.00,0.00
2024-12-10 17:21:26,67,5192,43,24,3104.33,6301.02,0.00
2024-12-10 17:21:26,66,5192,43,23,3151.25,6301.02,0.00
2024-12-10 17:21:26,65,5192,42,23,3152.37,6301.54,0.00
2024-12-10 17:21:26,65,5193,42,23,3154.92,6302.00,0.00
2024-12-10 17:21:26,66,5193,43,23,3107.11,6302.02,0.00
2024-12-10 17:21:26,66,5194,43,23,3049.82,6303.00,0.00
2024-12-10 17:21:26,67,5194,43,24,3004.30,6303.02,0.00
2024-12-10 17:21:26,66,5194,42,24,3048.86,6303.02,0.00
2024-12-10 17:21:26,65,5194,41,24,3000.23,6303.71,0.00
2024-12-10 17:21:26,65,5195,41,24,3039.50,6304.00,0.00
2024-12-10 17:21:26,66,5195,41,25,2993.44,6304.02,0.00
2024-12-10 17:21:26,65,5195,40,25,3031.27,6304.11,0.00
2024-12-10 17:21:26,64,5195,40,24,3044.32,6304.52,0.00
2024-12-10 17:21:26,63,5195,39,24,3088.41,6304.54,0.00
2024-12-10 17:21:26,62,5195,39,23,3092.46,6304.76,0.00
2024-12-10 17:21:26,61,5195,39,22,3135.11,6304.77,0.00
2024-12-10 17:21:26,61,5196,39,22,3224.20,6305.00,0.00
2024-12-10 17:21:26,62,5196,39,23,3172.20,6305.02,0.00
2024-12-10 17:21:26,63,5195,40,23,3106.03,6305.29,0.00
2024-12-10 17:21:26,62,5195,39,23,3162.36,6305.71,0.00
2024-12-10 17:21:26,62,5196,39,23,3246.01,6306.00,0.00
2024-12-10 17:21:26,63,5196,40,23,3194.48,6306.02,0.00
2024-12-10 17:21:26,62,5196,40,22,3223.79,6306.27,0.00
2024-12-10 17:21:26,62,5197,40,22,3359.89,6307.00,0.00
2024-12-10 17:21:26,63,5197,41,22,3306.56,6307.02,0.00
2024-12-10 17:21:26,62,5197,40,22,3358.87,6307.02,0.00
2024-12-10 17:21:26,62,5198,40,22,3367.31,6308.00,0.00
2024-12-10 17:21:26,63,5198,40,23,3313.86,6308.02,0.00
2024-12-10 17:21:26,64,5197,40,24,3195.48,6308.64,0.00
2024-12-10 17:21:26,64,5198,40,24,3354.49,6309.00,0.00
2024-12-10 17:21:26,65,5198,40,25,3302.88,6309.02,0.00
2024-12-10 17:21:26,64,5198,39,25,3351.83,6309.03,0.00
2024-12-10 17:21:26,63,5198,38,25,3403.95,6309.03,0.00
2024-12-10 17:21:26,62,5198,37,25,3417.90,6309.48,0.00
2024-12-10 17:21:26,62,5199,37,25,3559.78,6310.00,0.00
2024-12-10 17:21:26,63,5199,38,25,3503.27,6310.02,0.00
2024-12-10 17:21:26,63,5200,38,25,3496.18,6311.00,0.00
2024-12-10 17:21:26,64,5200,39,25,3441.55,6311.02,0.00
2024-12-10 17:21:26,64,5201,39,25,3427.21,6312.00,0.00
2024-12-10 17:21:26,65,5201,40,25,3374.48,6312.02,0.00
2024-12-10 17:21:26,64,5201,39,25,3376.72,6312.48,0.00
2024-12-10 17:21:26,64,5202,39,25,3411.62,6313.00,0.00
2024-12-10 17:21:26,65,5202,40,25,3359.13,6313.02,0.00
2024-12-10 17:21:26,64,5202,40,24,3404.61,6313.08,0.00
2024-12-10 17:21:26,64,5203,40,24,3390.23,6314.00,0.00
2024-12-10 17:21:27,65,5203,41,24,3338.08,6314.02,0.00
2024-12-10 17:21:27,64,5203,40,24,3389.25,6314.02,0.00
2024-12-10 17:21:27,63,5203,40,23,3391.79,6314.48,0.00
2024-12-10 17:21:27,63,5204,40,23,3418.76,6315.00,0.00
2024-12-10 17:21:27,64,5204,40,24,3365.34,6315.02,0.00
2024-12-10 17:21:27,65,5203,40,25,3244.24,6315.68,0.00
2024-12-10 17:21:27,65,5204,40,25,3311.21,6316.00,0.00
2024-12-10 17:21:27,66,5204,41,25,3261.04,6316.02,0.00
2024-12-10 17:21:27,65,5204,41,24,3302.79,6316.12,0.00
2024-12-10 17:21:27,65,5205,41,24,3386.45,6317.00,0.00
2024-12-10 17:21:27,66,5205,42,24,3335.14,6317.02,0.00
2024-12-10 17:21:27,66,5206,42,24,3310.82,6318.00,0.00
2024-12-10 17:21:27,67,5206,43,24,3261.40,6318.02,0.00
2024-12-10 17:21:27,66,5206,43,23,3285.90,6318.35,0.00
2024-12-10 17:21:27,65,5206,43,22,3330.24,6318.43,0.00
2024-12-10 17:21:27,64,5206,43,21,3376.48,6318.44,0.00
2024-12-10 17:21:27,63,5206,42,21,3420.82,6318.44,0.00
2024-12-10 17:21:27,63,5207,42,21,3454.28,6319.00,0.00
2024-12-10 17:21:27,64,5207,43,21,3400.31,6319.02,0.00
2024-12-10 17:21:27,63,5207,42,21,3453.28,6319.02,0.00
2024-12-10 17:21:27,63,5208,42,21,3454.72,6320.00,0.00
2024-12-10 17:21:27,64,5208,43,21,3400.74,6320.02,0.00
2024-12-10 17:21:27,63,5208,43,20,3376.89,6320.81,0.00
2024-12-10 17:21:27,63,5209,43,20,3453.60,6321.00,0.00
2024-12-10 17:21:27,64,5209,44,20,3399.64,6321.02,0.00
2024-12-10 17:21:27,64,5210,44,20,3404.13,6322.00,0.00
2024-12-10 17:21:27,65,5210,44,21,3351.76,6322.02,0.00
2024-12-10 17:21:27,64,5210,43,21,3403.14,6322.02,0.00
2024-12-10 17:21:27,64,5211,43,21,3402.58,6323.00,0.00
2024-12-10 17:21:27,65,5211,44,21,3350.23,6323.02,0.00
2024-12-10 17:21:27,64,5211,43,21,3402.18,6323.02,0.00
2024-12-10 17:21:27,64,5212,43,21,3401.45,6324.00,0.00
2024-12-10 17:21:27,65,5212,43,22,3349.12,6324.02,0.00
2024-12-10 17:21:27,64,5212,42,22,3393.13,6324.05,0.00
2024-12-10 17:21:27,64,5213,42,22,3399.26,6325.00,0.00
2024-12-10 17:21:27,65,5213,42,23,3346.96,6325.02,0.00
2024-12-10 17:21:27,64,5213,42,22,3398.34,6325.02,0.00
2024-12-10 17:21:27,63,5213,41,22,3429.61,6325.35,0.00
2024-12-10 17:21:27,62,5213,40,22,3432.24,6325.81,0.00
2024-12-10 17:21:27,62,5214,40,22,3517.70,6326.00,0.00
2024-12-10 17:21:27,63,5214,41,22,3461.87,6326.02,0.00
2024-12-10 17:21:27,62,5214,40,22,3449.58,6326.71,0.00
2024-12-10 17:21:27,62,5215,40,22,3526.23,6327.00,0.00
2024-12-10 17:21:27,63,5215,41,22,3470.26,6327.02,0.00
2024-12-10 17:21:27,63,5216,41,22,3483.91,6328.00,0.00
2024-12-10 17:21:27,64,5216,42,22,3429.48,6328.02,0.00
2024-12-10 17:21:27,64,5217,42,22,3430.56,6329.00,0.00
2024-12-10 17:21:27,65,5217,43,22,3377.78,6329.02,0.00
2024-12-10 17:21:27,64,5217,43,21,3424.10,6329.11,0.00
2024-12-10 17:21:27,64,5218,43,21,3417.46,6330.00,0.00
2024-12-10 17:21:27,65,5218,44,21,3364.88,6330.02,0.00
2024-12-10 17:21:27,64,5218,43,21,3408.15,6330.16,0.00
2024-12-10 17:21:27,63,5218,43,20,3425.79,6330.49,0.00
2024-12-10 17:21:27,63,5219,43,20,3481.20,6331.00,0.00
2024-12-10 17:21:27,64,5219,43,21,3426.80,6331.02,0.00
2024-12-10 17:21:27,64,5220,43,21,3446.42,6332.00,0.00
2024-12-10 17:21:27,65,5220,43,22,3393.40,6332.02,0.00
2024-12-10 17:21:27,64,5220,42,22,3445.44,6332.02,0.00
2024-12-10 17:21:27,63,5220,41,22,3496.93,6332.03,0.00
2024-12-10 17:21:27,62,5220,41,21,3536.00,6332.27,0.00
2024-12-10 17:21:27,62,5221,41,21,3586.78,6333.00,0.00
2024-12-10 17:21:27,63,5221,41,22,3529.85,6333.02,0.00
2024-12-10 17:21:27,63,5222,41,22,3563.30,6334.00,0.00
2024-12-10 17:21:27,64,5222,42,22,3507.62,6334.02,0.00
2024-12-10 17:21:27,64,5223,42,22,3537.44,6335.00,0.00
2024-12-10 17:21:27,65,5223,42,23,3483.02,6335.02,0.00
2024-12-10 17:21:27,65,5224,42,23,3506.95,6336.00,0.00
2024-12-10 17:21:27,66,5224,42,24,3453.82,6336.02,0.00
2024-12-10 17:21:27,66,5225,42,24,3473.79,6337.00,0.00
2024-12-10 17:21:27,67,5225,43,24,3421.94,6337.02,0.00
2024-12-10 17:21:27,68,5224,43,25,3353.97,6337.32,0.00
2024-12-10 17:21:27,67,5224,42,25,3431.82,6337.57,0.00
2024-12-10 17:21:27,67,5225,42,25,3488.57,6338.00,0.00
2024-12-10 17:21:27,68,5225,43,25,3437.27,6338.02,0.00
2024-12-10 17:21:27,67,5225,42,25,3487.62,6338.02,0.00
2024-12-10 17:21:27,66,5225,42,24,3500.52,6338.49,0.00
2024-12-10 17:21:27,66,5226,42,24,3642.60,6339.00,0.00
2024-12-10 17:21:27,67,5226,42,25,3588.23,6339.02,0.00
2024-12-10 17:21:27,66,5226,41,25,3612.25,6339.41,0.00
2024-12-10 17:21:27,66,5227,41,25,3647.30,6340.00,0.00
2024-12-10 17:21:27,67,5227,41,26,3592.87,6340.02,0.00
2024-12-10 17:21:27,66,5227,41,25,3629.62,6340.24,0.00
2024-12-10 17:21:27,66,5228,41,25,3648.99,6341.00,0.00
2024-12-10 17:21:27,67,5228,41,26,3594.53,6341.02,0.00
2024-12-10 17:21:27,67,5229,41,26,3594.48,6342.00,0.00
2024-12-10 17:21:27,68,5229,41,27,3541.62,6342.02,0.00
2024-12-10 17:21:27,67,5229,40,27,3593.54,6342.02,0.00
2024-12-10 17:21:27,67,5230,40,27,3589.94,6343.00,0.00
2024-12-10 17:21:27,68,5230,41,27,3537.14,6343.02,0.00
2024-12-10 17:21:27,67,5230,40,27,3519.56,6343.76,0.00
2024-12-10 17:21:27,67,5231,40,27,3591.34,6344.00,0.00
2024-12-10 17:21:27,68,5231,40,28,3538.53,6344.02,0.00
2024-12-10 17:21:27,68,5232,40,28,3546.97,6345.00,0.00
2024-12-10 17:21:27,69,5232,40,29,3495.57,6345.02,0.00
2024-12-10 17:21:27,69,5233,40,29,3502.70,6346.00,0.00
2024-12-10 17:21:27,70,5233,40,30,3452.66,6346.01,0.00
2024-12-10 17:21:27,70,5234,40,30,3457.56,6347.00,0.00
2024-12-10 17:21:27,71,5234,41,30,3408.86,6347.01,0.00
2024-12-10 17:21:28,70,5234,40,30,3455.75,6347.03,0.00
2024-12-10 17:21:28,70,5235,40,30,3460.45,6348.00,0.00
2024-12-10 17:21:28,71,5235,41,30,3411.71,6348.01,0.00
2024-12-10 17:21:28,70,5235,40,30,3457.56,6348.06,0.00
2024-12-10 17:21:28,71,5234,41,30,3391.07,6348.37,0.00
2024-12-10 17:21:28,70,5234,40,30,3469.85,6348.43,0.00
2024-12-10 17:21:28,71,5233,41,30,3389.28,6348.77,0.00
2024-12-10 17:21:28,71,5234,41,30,3472.67,6349.00,0.00
2024-12-10 17:21:28,72,5234,41,31,3424.44,6349.01,0.00
2024-12-10 17:21:28,73,5233,42,31,3357.62,6349.36,0.00
2024-12-10 17:21:28,72,5233,41,31,3372.07,6349.69,0.00
2024-12-10 17:21:28,72,5234,41,31,3611.03,6350.00,0.00
2024-12-10 17:21:28,73,5234,42,31,3561.56,6350.01,0.00
2024-12-10 17:21:28,72,5234,42,30,3609.27,6350.03,0.00
2024-12-10 17:21:28,72,5235,42,30,3709.64,6351.00,0.00
2024-12-10 17:21:28,73,5235,42,31,3658.82,6351.01,0.00
2024-12-10 17:21:28,73,5236,42,31,3667.97,6352.00,0.00
2024-12-10 17:21:28,74,5236,43,31,3618.40,6352.01,0.00
2024-12-10 17:21:28,73,5236,42,31,3666.23,6352.03,0.00
2024-12-10 17:21:28,73,5237,42,31,3674.91,6353.00,0.00
2024-12-10 17:21:28,74,5237,43,31,3625.24,6353.01,0.00
2024-12-10 17:21:28,74,5238,43,31,3630.30,6354.00,0.00
2024-12-10 17:21:28,75,5238,43,32,3581.89,6354.01,0.00
2024-12-10 17:21:28,75,5239,43,32,3584.62,6355.00,0.00
2024-12-10 17:21:28,76,5239,44,32,3537.45,6355.01,0.00
2024-12-10 17:21:28,77,5238,44,33,3440.66,6355.61,0.00
2024-12-10 17:21:28,77,5239,44,33,3515.52,6356.00,0.00
2024-12-10 17:21:28,78,5239,45,33,3470.45,6356.01,0.00
2024-12-10 17:21:28,77,5239,45,32,3490.35,6356.33,0.00
2024-12-10 17:21:28,76,5239,45,31,3508.76,6356.57,0.00
2024-12-10 17:21:28,75,5239,44,31,3550.20,6356.65,0.00
2024-12-10 17:21:28,76,5238,45,31,3503.49,6356.67,0.00
2024-12-10 17:21:28,76,5239,45,31,3666.88,6357.00,0.00
2024-12-10 17:21:28,77,5239,45,32,3619.26,6357.01,0.00
2024-12-10 17:21:28,76,5239,44,32,3632.40,6357.40,0.00
2024-12-10 17:21:28,76,5240,44,32,3761.68,6358.00,0.00
2024-12-10 17:21:28,77,5240,45,32,3712.83,6358.01,0.00
2024-12-10 17:21:28,76,5240,45,31,3757.11,6358.03,0.00
2024-12-10 17:21:28,76,5241,45,31,3772.80,6359.00,0.00
2024-12-10 17:21:28,77,5241,45,32,3723.81,6359.01,0.00
2024-12-10 17:21:28,76,5241,44,32,3771.29,6359.01,0.00
2024-12-10 17:21:28,75,5241,44,31,3820.73,6359.01,0.00
2024-12-10 17:21:28,75,5242,44,31,3835.53,6360.00,0.00
2024-12-10 17:21:28,76,5242,44,32,3785.06,6360.01,0.00
2024-12-10 17:21:28,75,5242,43,32,3834.68,6360.01,0.00
2024-12-10 17:21:28,76,5241,44,32,3762.47,6360.34,0.00
2024-12-10 17:21:28,76,5242,44,32,3859.67,6361.00,0.00
2024-12-10 17:21:28,77,5242,44,33,3809.55,6361.01,0.00
2024-12-10 17:21:28,76,5242,44,32,3858.83,6361.01,0.00
2024-12-10 17:21:28,76,5243,44,32,3947.09,6362.00,0.00
2024-12-10 17:21:28,77,5243,44,33,3895.83,6362.01,0.00
2024-12-10 17:21:28,76,5243,43,33,3946.25,6362.01,0.00
2024-12-10 17:21:28,76,5244,43,33,3949.04,6363.00,0.00
2024-12-10 17:21:28,77,5244,44,33,3897.76,6363.01,0.00
2024-12-10 17:21:28,76,5244,43,33,3948.21,6363.01,0.00
2024-12-10 17:21:28,76,5245,43,33,3948.18,6364.00,0.00
2024-12-10 17:21:28,77,5245,44,33,3896.91,6364.01,0.00
2024-12-10 17:21:28,77,5246,44,33,3893.27,6365.00,0.00
2024-12-10 17:21:28,78,5246,44,34,3843.36,6365.01,0.00
2024-12-10 17:21:28,77,5246,43,34,3892.45,6365.01,0.00
2024-12-10 17:21:28,77,5247,43,34,3886.60,6366.00,0.00
2024-12-10 17:21:28,78,5247,43,35,3836.77,6366.01,0.00
2024-12-10 17:21:28,78,5248,43,35,3824.63,6367.00,0.00
2024-12-10 17:21:28,79,5248,44,35,3776.22,6367.01,0.00
2024-12-10 17:21:28,78,5248,44,34,3806.17,6367.24,0.00
2024-12-10 17:21:28,78,5249,44,34,3807.02,6368.00,0.00
2024-12-10 17:21:28,79,5249,44,35,3758.83,6368.01,0.00
2024-12-10 17:21:28,79,5250,44,35,3739.67,6369.00,0.00
2024-12-10 17:21:28,80,5250,44,36,3692.92,6369.01,0.00
2024-12-10 17:21:28,79,5250,43,36,3737.00,6369.05,0.00
2024-12-10 17:21:28,79,5251,43,36,3714.37,6370.00,0.00
2024-12-10 17:21:28,80,5251,43,37,3667.94,6370.01,0.00
2024-12-10 17:21:28,79,5251,43,36,3713.67,6370.01,0.00
2024-12-10 17:21:28,78,5251,42,36,3739.40,6370.28,0.00
2024-12-10 17:21:28,77,5251,41,36,3787.40,6370.29,0.00
2024-12-10 17:21:28,77,5252,41,36,3781.01,6371.00,0.00
2024-12-10 17:21:28,78,5252,41,37,3732.53,6371.01,0.00
2024-12-10 17:21:28,77,5252,40,37,3780.38,6371.01,0.00
2024-12-10 17:21:28,77,5253,40,37,3748.22,6372.00,0.00
2024-12-10 17:21:28,78,5253,41,37,3700.16,6372.01,0.00
2024-12-10 17:21:28,79,5252,42,37,3603.96,6372.58,0.00
2024-12-10 17:21:28,79,5253,42,37,3639.61,6373.00,0.00
2024-12-10 17:21:28,80,5253,43,37,3594.11,6373.01,0.00
2024-12-10 17:21:28,79,5253,42,37,3558.18,6373.63,0.00
2024-12-10 17:21:28,79,5254,42,37,3684.38,6374.00,0.00
2024-12-10 17:21:28,80,5254,42,38,3638.33,6374.01,0.00
2024-12-10 17:21:28,79,5254,41,38,3670.60,6374.20,0.00
2024-12-10 17:21:28,79,5255,41,38,3658.46,6375.00,0.00
2024-12-10 17:21:28,80,5255,41,39,3612.73,6375.01,0.00
2024-12-10 17:21:28,79,5255,41,38,3604.15,6375.57,0.00
2024-12-10 17:21:28,78,5255,40,38,3629.92,6375.73,0.00
2024-12-10 17:21:28,78,5256,40,38,3689.95,6376.00,0.00
2024-12-10 17:21:28,79,5256,41,38,3643.24,6376.01,0.00
2024-12-10 17:21:28,80,5255,42,38,3574.68,6376.35,0.00
2024-12-10 17:21:28,79,5255,42,37,3644.59,6376.44,0.00
2024-12-10 17:21:28,79,5256,42,37,3666.84,6377.00,0.00
2024-12-10 17:21:28,80,5256,43,37,3621.01,6377.01,0.00
2024-12-10 17:21:28,80,5257,43,37,3674.59,6378.00,0.00
2024-12-10 17:21:28,81,5257,44,37,3629.22,6378.01,0.00
2024-12-10 17:21:28,80,5257,43,37,3608.38,6378.56,0.00
2024-12-10 17:21:28,80,5258,43,37,3649.06,6379.00,0.00
2024-12-10 17:21:28,81,5258,44,37,3604.01,6379.01,0.00
2024-12-10 17:21:28,81,5259,44,37,3598.54,6380.00,0.00
2024-12-10 17:21:28,82,5259,45,37,3554.65,6380.01,0.00
2024-12-10 17:21:29,82,5260,45,37,3551.56,6381.00,0.00
2024-12-10 17:21:29,83,5260,45,38,3508.77,6381.01,0.00
2024-12-10 17:21:29,83,5261,45,38,3500.15,6382.00,0.00
2024-12-10 17:21:29,84,5261,45,39,3458.48,6382.01,0.00
2024-12-10 17:21:29,84,5261,45,39,3441.22,6383.00,0.00
2024-12-10 17:21:29,85,5261,45,40,3400.74,6383.01,0.00
2024-12-10 17:21:29,85,5262,45,40,3375.03,6384.00,0.00
2024-12-10 17:21:29,86,5262,45,41,3335.79,6384.01,0.00
2024-12-10 17:21:29,86,5263,45,41,3306.46,6385.00,0.00
2024-12-10 17:21:29,87,5263,46,41,3268.45,6385.01,0.00
2024-12-10 17:21:29,86,5263,46,40,3294.71,6385.17,0.00
2024-12-10 17:21:29,85,5263,45,40,3288.95,6385.61,0.00
2024-12-10 17:21:29,85,5264,45,40,3315.92,6386.00,0.00
2024-12-10 17:21:29,86,5264,45,41,3277.36,6386.01,0.00
2024-12-10 17:21:29,85,5264,44,41,3315.17,6386.01,0.00
2024-12-10 17:21:29,84,5264,43,41,3327.85,6386.41,0.00
2024-12-10 17:21:29,84,5265,43,41,3330.10,6387.00,0.00
2024-12-10 17:21:29,85,5265,43,42,3290.92,6387.01,0.00
2024-12-10 17:21:29,84,5265,42,42,3315.88,6387.23,0.00
2024-12-10 17:21:29,85,5264,43,42,3273.14,6387.31,0.00
2024-12-10 17:21:29,85,5265,43,42,3309.10,6388.00,0.00
2024-12-10 17:21:29,86,5265,43,43,3270.62,6388.01,0.00
2024-12-10 17:21:29,85,5265,42,43,3258.24,6388.55,0.00
2024-12-10 17:21:29,84,5265,42,42,3288.97,6388.62,0.00
2024-12-10 17:21:29,84,5266,42,42,3404.16,6389.00,0.00
2024-12-10 17:21:29,85,5266,43,42,3364.11,6389.01,0.00
2024-12-10 17:21:29,84,5266,43,41,3368.79,6389.46,0.00
2024-12-10 17:21:29,84,5267,43,41,3395.34,6390.00,0.00
2024-12-10 17:21:29,85,5267,44,41,3355.39,6390.01,0.00
2024-12-10 17:21:29,84,5267,44,40,3393.82,6390.02,0.00
2024-12-10 17:21:29,84,5268,44,40,3392.63,6391.00,0.00
2024-12-10 17:21:29,85,5268,44,41,3352.72,6391.01,0.00
2024-12-10 17:21:29,84,5268,43,41,3391.19,6391.02,0.00
2024-12-10 17:21:29,84,5269,43,41,3390.29,6392.00,0.00
2024-12-10 17:21:29,85,5269,44,41,3350.40,6392.01,0.00
2024-12-10 17:21:29,84,5269,43,41,3388.77,6392.02,0.00
2024-12-10 17:21:29,83,5269,43,40,3420.74,6392.16,0.00
2024-12-10 17:21:29,83,5270,43,40,3428.08,6393.00,0.00
2024-12-10 17:21:29,84,5270,43,41,3387.27,6393.01,0.00
2024-12-10 17:21:29,83,5270,42,41,3426.55,6393.02,0.00
2024-12-10 17:21:29,83,5271,42,41,3424.82,6394.00,0.00
2024-12-10 17:21:29,84,5271,43,41,3384.05,6394.01,0.00
2024-12-10 17:21:29,83,5271,42,41,3423.28,6394.02,0.00
2024-12-10 17:21:29,82,5271,42,40,3419.27,6394.59,0.00
2024-12-10 17:21:29,82,5272,42,40,3465.39,6395.00,0.00
2024-12-10 17:21:29,83,5272,43,40,3423.64,6395.01,0.00
2024-12-10 17:21:29,84,5271,43,41,3327.14,6395.71,0.00
2024-12-10 17:21:29,84,5272,43,41,3398.90,6396.00,0.00
2024-12-10 17:21:29,85,5272,44,41,3358.91,6396.01,0.00
2024-12-10 17:21:29,84,5272,43,41,3396.62,6396.04,0.00
2024-12-10 17:21:29,84,5273,43,41,3470.44,6397.00,0.00
2024-12-10 17:21:29,85,5273,44,41,3429.61,6397.01,0.00
2024-12-10 17:21:29,84,5273,43,41,3465.04,6397.10,0.00
2024-12-10 17:21:29,84,5274,43,41,3470.54,6398.00,0.00
2024-12-10 17:21:29,85,5274,44,41,3429.71,6398.01,0.00
2024-12-10 17:21:29,85,5275,44,41,3430.94,6399.00,0.00
2024-12-10 17:21:29,86,5275,45,41,3391.05,6399.01,0.00
2024-12-10 17:21:29,85,5275,45,40,3428.69,6399.04,0.00
2024-12-10 17:21:29,84,5275,44,40,3468.63,6399.05,0.00
2024-12-10 17:21:29,84,5276,44,40,3471.70,6400.00,0.00
2024-12-10 17:21:29,85,5276,44,41,3430.85,6400.01,0.00
2024-12-10 17:21:29,84,5276,43,41,3464.43,6400.10,0.00
2024-12-10 17:21:29,83,5276,42,41,3501.24,6400.17,0.00
2024-12-10 17:21:29,82,5276,41,41,3521.83,6400.46,0.00
2024-12-10 17:21:29,82,5277,41,41,3558.89,6401.00,0.00
2024-12-10 17:21:29,83,5277,42,41,3516.01,6401.01,0.00
2024-12-10 17:21:29,82,5277,42,40,3555.34,6401.06,0.00
2024-12-10 17:21:29,82,5278,42,40,3562.58,6402.00,0.00
2024-12-10 17:21:29,83,5278,43,40,3519.66,6402.01,0.00
2024-12-10 17:21:29,82,5278,42,40,3559.47,6402.05,0.00
2024-12-10 17:21:29,81,5278,41,40,3571.12,6402.46,0.00
2024-12-10 17:21:29,81,5279,41,40,3608.60,6403.00,0.00
2024-12-10 17:21:29,82,5279,41,41,3564.59,6403.01,0.00
2024-12-10 17:21:29,82,5280,41,41,3564.81,6404.00,0.00
2024-12-10 17:21:29,83,5280,41,42,3521.86,6404.01,0.00
2024-12-10 17:21:29,83,5281,41,42,3518.47,6405.00,0.00
2024-12-10 17:21:29,84,5281,42,42,3476.58,6405.01,0.00
2024-12-10 17:21:29,84,5282,42,42,3470.79,6406.00,0.00
2024-12-10 17:21:29,85,5282,42,43,3429.96,6406.01,0.00
2024-12-10 17:21:29,84,5282,42,42,3420.06,6406.48,0.00
2024-12-10 17:21:29,84,5283,42,42,3462.46,6407.00,0.00
2024-12-10 17:21:29,85,5283,42,43,3421.72,6407.01,0.00
2024-12-10 17:21:29,84,5283,42,42,3448.83,6407.19,0.00
2024-12-10 17:21:29,83,5283,42,41,3478.17,6407.37,0.00
2024-12-10 17:21:29,83,5284,42,41,3511.17,6408.00,0.00
2024-12-10 17:21:29,84,5284,43,41,3469.37,6408.01,0.00
2024-12-10 17:21:29,83,5284,43,40,3498.99,6408.18,0.00
2024-12-10 17:21:29,83,5285,43,40,3517.61,6409.00,0.00
2024-12-10 17:21:29,84,5285,43,41,3475.73,6409.01,0.00
2024-12-10 17:21:29,83,5285,42,41,3512.34,6409.08,0.00
2024-12-10 17:21:29,83,5286,42,41,3522.51,6410.00,0.00
2024-12-10 17:21:29,84,5286,42,42,3480.57,6410.01,0.00
2024-12-10 17:21:29,84,5287,42,42,3483.85,6411.00,0.00
2024-12-10 17:21:29,85,5287,43,42,3442.86,6411.01,0.00
2024-12-10 17:21:29,84,5287,42,42,3456.81,6411.36,0.00
2024-12-10 17:21:29,84,5288,42,42,3486.58,6412.00,0.00
2024-12-10 17:21:29,85,5288,43,42,3445.56,6412.01,0.00
2024-12-10 17:21:29,85,5289,43,42,3443.64,6413.00,0.00
2024-12-10 17:21:29,86,5289,44,42,3403.60,6413.01,0.00
2024-12-10 17:21:29,85,5289,43,42,3437.50,6413.07,0.00
2024-12-10 17:21:30,85,5290,43,42,3436.81,6414.00,0.00
2024-12-10 17:21:30,86,5290,43,43,3396.85,6414.01,0.00
2024-12-10 17:21:30,85,5290,42,43,3433.80,6414.05,0.00
2024-12-10 17:21:30,84,5290,41,43,3470.88,6414.07,0.00
2024-12-10 17:21:30,83,5290,41,42,3505.63,6414.12,0.00
2024-12-10 17:21:30,83,5291,41,42,3512.31,6415.00,0.00
2024-12-10 17:21:30,84,5291,41,43,3470.50,6415.01,0.00
2024-12-10 17:21:30,83,5291,40,43,3510.77,6415.02,0.00
2024-12-10 17:21:30,82,5291,40,42,3552.02,6415.04,0.00
2024-12-10 17:21:30,81,5291,39,42,3580.94,6415.20,0.00
2024-12-10 17:21:30,81,5292,39,42,3594.70,6416.00,0.00
2024-12-10 17:21:30,82,5292,40,42,3550.86,6416.01,0.00
2024-12-10 17:21:30,81,5292,39,42,3568.02,6416.33,0.00
2024-12-10 17:21:30,81,5293,39,42,3592.67,6417.00,0.00
2024-12-10 17:21:30,82,5293,39,43,3548.85,6417.01,0.00
2024-12-10 17:21:30,82,5294,39,43,3547.27,6418.00,0.00
2024-12-10 17:21:30,83,5294,39,44,3504.53,6418.01,0.00
2024-12-10 17:21:30,82,5294,39,43,3534.98,6418.16,0.00
2024-12-10 17:21:30,81,5294,38,43,3566.31,6418.33,0.00
2024-12-10 17:21:30,81,5295,38,43,3592.58,6419.00,0.00
2024-12-10 17:21:30,82,5295,38,44,3548.77,6419.01,0.00
2024-12-10 17:21:30,82,5296,38,44,3550.29,6420.00,0.00
2024-12-10 17:21:30,83,5296,39,44,3507.52,6420.01,0.00
2024-12-10 17:21:30,82,5296,39,43,3548.00,6420.04,0.00
2024-12-10 17:21:30,81,5296,39,42,3557.76,6420.51,0.00
2024-12-10 17:21:30,81,5297,39,42,3602.12,6421.00,0.00
2024-12-10 17:21:30,82,5297,39,43,3558.19,6421.01,0.00
2024-12-10 17:21:30,82,5298,39,43,3567.60,6422.00,0.00
2024-12-10 17:21:30,83,5298,39,44,3524.62,6422.01,0.00
2024-12-10 17:21:30,83,5299,39,44,3533.09,6423.00,0.00
2024-12-10 17:21:30,84,5299,40,44,3491.03,6423.01,0.00
2024-12-10 17:21:30,83,5299,39,44,3529.82,6423.06,0.00
2024-12-10 17:21:30,82,5299,39,43,3562.78,6423.21,0.00
2024-12-10 17:21:30,82,5300,39,43,3584.45,6424.00,0.00
2024-12-10 17:21:30,83,5300,39,44,3541.26,6424.01,0.00
2024-12-10 17:21:30,83,5301,39,44,3548.60,6425.00,0.00
2024-12-10 17:21:30,84,5301,39,45,3506.36,6425.01,0.00
2024-12-10 17:21:30,83,5301,39,44,3529.58,6425.28,0.00
2024-12-10 17:21:30,83,5302,39,44,3556.18,6426.00,0.00
2024-12-10 17:21:30,84,5302,39,45,3513.84,6426.01,0.00
2024-12-10 17:21:30,84,5303,39,45,3522.55,6427.00,0.00
2024-12-10 17:21:30,85,5303,39,46,3481.11,6427.01,0.00
2024-12-10 17:21:30,84,5303,39,45,3517.64,6427.08,0.00
2024-12-10 17:21:30,84,5304,39,45,3530.64,6428.00,0.00
2024-12-10 17:21:30,85,5304,40,45,3489.10,6428.01,0.00
2024-12-10 17:21:30,85,5305,40,45,3496.55,6429.00,0.00
2024-12-10 17:21:30,86,5305,41,45,3455.89,6429.01,0.00
2024-12-10 17:21:30,85,5305,40,45,3456.16,6429.57,0.00
2024-12-10 17:21:30,85,5306,40,45,3503.19,6430.00,0.00
2024-12-10 17:21:30,86,5306,41,45,3462.46,6430.01,0.00
2024-12-10 17:21:30,86,5307,41,45,3471.14,6431.00,0.00
2024-12-10 17:21:30,87,5307,41,46,3431.24,6431.01,0.00
2024-12-10 17:21:30,86,5307,41,45,3467.41,6431.06,0.00
2024-12-10 17:21:30,85,5307,40,45,3489.88,6431.29,0.00
2024-12-10 17:21:30,85,5308,40,45,3518.93,6432.00,0.00
2024-12-10 17:21:30,86,5308,40,46,3478.01,6432.01,0.00
2024-12-10 17:21:30,86,5309,40,46,3484.31,6433.00,0.00
2024-12-10 17:21:30,87,5309,40,47,3444.26,6433.01,0.00
2024-12-10 17:21:30,88,5308,40,48,3362.13,6433.66,0.00
2024-12-10 17:21:30,88,5309,40,48,3430.70,6434.00,0.00
2024-12-10 17:21:30,89,5309,40,49,3392.16,6434.01,0.00
2024-12-10 17:21:30,89,5310,40,49,3461.66,6435.00,0.00
2024-12-10 17:21:30,90,5310,41,49,3423.20,6435.01,0.00
2024-12-10 17:21:30,91,5309,42,49,3359.85,6435.40,0.00
2024-12-10 17:21:30,91,5310,42,49,3422.81,6436.00,0.00
2024-12-10 17:21:30,92,5310,43,49,3385.60,6436.01,0.00
2024-12-10 17:21:30,92,5311,43,49,3452.79,6437.00,0.00
2024-12-10 17:21:30,93,5311,44,49,3415.67,6437.01,0.00
2024-12-10 17:21:30,92,5311,43,49,3452.09,6437.01,0.00
2024-12-10 17:21:30,91,5311,42,49,3487.21,6437.04,0.00
2024-12-10 17:21:30,90,5311,41,49,3519.35,6437.15,0.00
2024-12-10 17:21:30,90,5312,41,49,3525.95,6438.00,0.00
2024-12-10 17:21:30,91,5312,42,49,3487.20,6438.01,0.00
2024-12-10 17:21:30,91,5313,42,49,3483.74,6439.00,0.00
2024-12-10 17:21:30,92,5313,42,50,3445.87,6439.01,0.00
2024-12-10 17:21:30,91,5313,42,49,3480.91,6439.04,0.00
2024-12-10 17:21:30,90,5313,42,48,3519.15,6439.04,0.00
2024-12-10 17:21:30,90,5314,42,48,3520.48,6440.00,0.00
2024-12-10 17:21:30,91,5314,43,48,3481.79,6440.01,0.00
2024-12-10 17:21:30,90,5314,43,47,3506.29,6440.18,0.00
2024-12-10 17:21:30,89,5314,43,46,3544.47,6440.19,0.00
2024-12-10 17:21:30,88,5314,42,46,3577.06,6440.25,0.00
2024-12-10 17:21:30,88,5315,42,46,3598.91,6441.00,0.00
2024-12-10 17:21:30,89,5315,42,47,3558.48,6441.01,0.00
2024-12-10 17:21:30,88,5315,42,46,3595.99,6441.05,0.00
2024-12-10 17:21:30,88,5316,42,46,3602.23,6442.00,0.00
2024-12-10 17:21:30,89,5316,42,47,3561.76,6442.01,0.00
2024-12-10 17:21:30,89,5317,42,47,3560.91,6443.00,0.00
2024-12-10 17:21:30,90,5317,43,47,3521.35,6443.01,0.00
2024-12-10 17:21:30,89,5317,42,47,3558.02,6443.05,0.00
2024-12-10 17:21:30,88,5317,42,46,3581.84,6443.21,0.00
2024-12-10 17:21:30,89,5316,42,47,3532.96,6443.36,0.00
2024-12-10 17:21:30,90,5315,43,47,3503.03,6443.83,0.00
2024-12-10 17:21:30,90,5316,43,47,3572.80,6444.00,0.00
2024-12-10 17:21:30,91,5316,43,48,3533.54,6444.01,0.00
2024-12-10 17:21:30,90,5316,43,47,3561.55,6444.13,0.00
2024-12-10 17:21:30,91,5315,44,47,3497.35,6444.53,0.00
2024-12-10 17:21:30,91,5316,44,47,3699.04,6445.00,0.00
2024-12-10 17:21:30,92,5316,44,48,3658.83,6445.01,0.00
2024-12-10 17:21:31,93,5315,44,49,3573.95,6445.69,0.00
2024-12-10 17:21:31,93,5316,44,49,3713.74,6446.00,0.00
2024-12-10 17:21:31,94,5316,45,49,3674.23,6446.01,0.00
2024-12-10 17:21:31,94,5317,45,49,3736.11,6447.00,0.00
2024-12-10 17:21:31,95,5317,45,50,3696.79,6447.01,0.00
2024-12-10 17:21:31,94,5317,45,49,3732.21,6447.06,0.00
2024-12-10 17:21:31,94,5318,45,49,3728.50,6448.00,0.00
2024-12-10 17:21:31,95,5318,45,50,3689.25,6448.01,0.00
2024-12-10 17:21:31,94,5318,44,50,3725.07,6448.05,0.00
2024-12-10 17:21:31,93,5318,44,49,3762.76,6448.09,0.00
2024-12-10 17:21:31,93,5319,44,49,3759.86,6449.00,0.00
2024-12-10 17:21:31,94,5319,45,49,3719.86,6449.01,0.00
2024-12-10 17:21:31,93,5319,45,48,3759.17,6449.01,0.00
2024-12-10 17:21:31,92,5319,44,48,3798.93,6449.02,0.00
2024-12-10 17:21:31,91,5319,43,48,3839.26,6449.03,0.00
2024-12-10 17:21:31,91,5320,43,48,3832.52,6450.00,0.00
2024-12-10 17:21:31,92,5320,44,48,3790.86,6450.01,0.00
2024-12-10 17:21:31,91,5320,43,48,3830.40,6450.03,0.00
2024-12-10 17:21:31,91,5321,43,48,3821.10,6451.00,0.00
2024-12-10 17:21:31,92,5321,44,48,3779.57,6451.01,0.00
2024-12-10 17:21:31,92,5322,44,48,3764.35,6452.00,0.00
2024-12-10 17:21:31,93,5322,45,48,3723.87,6452.01,0.00
2024-12-10 17:21:31,93,5323,45,48,3706.33,6453.00,0.00
2024-12-10 17:21:31,94,5323,45,49,3666.90,6453.01,0.00
2024-12-10 17:21:31,94,5324,45,49,3648.15,6454.00,0.00
2024-12-10 17:21:31,95,5324,46,49,3609.75,6454.01,0.00
2024-12-10 17:21:31,94,5324,45,49,3602.00,6454.59,0.00
2024-12-10 17:21:31,94,5325,45,49,3630.38,6455.00,0.00
2024-12-10 17:21:31,95,5325,45,50,3592.16,6455.01,0.00
2024-12-10 17:21:31,94,5325,45,49,3628.32,6455.03,0.00
2024-12-10 17:21:31,94,5326,45,49,3617.32,6456.00,0.00
2024-12-10 17:21:31,95,5326,45,50,3579.24,6456.01,0.00
2024-12-10 17:21:31,95,5327,45,50,3564.41,6457.00,0.00
2024-12-10 17:21:31,96,5327,45,51,3527.28,6457.01,0.00
2024-12-10 17:21:31,95,5327,44,51,3515.83,6457.65,0.00
2024-12-10 17:21:31,95,5328,44,51,3550.00,6458.00,0.00
2024-12-10 17:21:31,96,5328,44,52,3513.02,6458.01,0.00
2024-12-10 17:21:31,95,5328,44,51,3497.69,6458.67,0.00
2024-12-10 17:21:31,95,5329,44,51,3538.55,6459.00,0.00
2024-12-10 17:21:31,96,5329,45,51,3501.69,6459.01,0.00
2024-12-10 17:21:31,96,5330,45,51,3491.93,6460.00,0.00
2024-12-10 17:21:31,97,5330,45,52,3455.93,6460.01,0.00
2024-12-10 17:21:31,96,5330,45,51,3489.91,6460.03,0.00
2024-12-10 17:21:31,96,5331,45,51,3479.55,6461.00,0.00
2024-12-10 17:21:31,97,5331,46,51,3443.68,6461.01,0.00
2024-12-10 17:21:31,96,5331,45,51,3452.91,6461.37,0.00
2024-12-10 17:21:31,96,5332,45,51,3469.53,6462.00,0.00
2024-12-10 17:21:31,97,5332,45,52,3433.77,6462.01,0.00
2024-12-10 17:21:31,97,5333,45,52,3422.68,6463.00,0.00
2024-12-10 17:21:31,98,5333,45,53,3387.75,6463.01,0.00
2024-12-10 17:21:31,97,5333,44,53,3420.68,6463.03,0.00
2024-12-10 17:21:31,97,5334,44,53,3410.29,6464.00,0.00
2024-12-10 17:21:31,98,5334,44,54,3375.49,6464.01,0.00
2024-12-10 17:21:31,97,5334,43,54,3393.46,6464.26,0.00
2024-12-10 17:21:31,96,5334,43,53,3420.19,6464.39,0.00
2024-12-10 17:21:31,95,5334,42,53,3435.03,6464.67,0.00
2024-12-10 17:21:31,95,5335,42,53,3480.23,6465.00,0.00
2024-12-10 17:21:31,96,5335,43,53,3443.98,6465.01,0.00
2024-12-10 17:21:31,96,5336,43,53,3443.12,6466.00,0.00
2024-12-10 17:21:31,97,5336,44,53,3407.62,6466.01,0.00
2024-12-10 17:21:31,97,5337,44,53,3403.57,6467.00,0.00
2024-12-10 17:21:31,98,5337,44,54,3368.84,6467.01,0.00
2024-12-10 17:21:31,98,5338,44,54,3362.15,6468.00,0.00
2024-12-10 17:21:31,99,5338,44,55,3328.18,6468.01,0.00
2024-12-10 17:21:31,99,5339,44,55,3318.94,6469.00,0.00
2024-12-10 17:21:31,100,5339,45,55,3285.75,6469.01,0.00
2024-12-10 17:21:31,99,5339,45,54,3316.98,6469.03,0.00
2024-12-10 17:21:31,99,5340,45,54,3306.24,6470.00,0.00
2024-12-10 17:21:31,100,5340,46,54,3273.17,6470.01,0.00
2024-12-10 17:21:31,100,5341,46,54,3258.56,6471.00,0.00
2024-12-10 17:21:31,101,5341,47,54,3226.30,6471.01,0.00
2024-12-10 17:21:31,100,5341,47,53,3256.62,6471.03,0.00
2024-12-10 17:21:31,100,5342,47,53,3241.52,6472.00,0.00
2024-12-10 17:21:31,101,5342,48,53,3209.43,6472.01,0.00
2024-12-10 17:21:31,100,5342,48,52,3240.23,6472.02,0.00
2024-12-10 17:21:31,100,5343,48,52,3223.28,6473.00,0.00
2024-12-10 17:21:31,101,5343,48,53,3191.37,6473.01,0.00
2024-12-10 17:21:31,100,5343,47,53,3221.34,6473.03,0.00
2024-12-10 17:21:31,100,5344,47,53,3205.87,6474.00,0.00
2024-12-10 17:21:31,101,5344,48,53,3174.13,6474.01,0.00
2024-12-10 17:21:31,101,5345,48,53,3159.54,6475.00,0.00
2024-12-10 17:21:31,102,5345,49,53,3128.57,6475.01,0.00
2024-12-10 17:21:31,101,5345,49,52,3157.62,6475.03,0.00
2024-12-10 17:21:31,101,5346,49,52,3148.18,6476.00,0.00
2024-12-10 17:21:31,102,5346,49,53,3117.31,6476.01,0.00
2024-12-10 17:21:31,101,5346,49,52,3147.54,6476.01,0.00
2024-12-10 17:21:31,100,5346,48,52,3177.72,6476.02,0.00
2024-12-10 17:21:31,100,5347,48,52,3171.63,6477.00,0.00
2024-12-10 17:21:31,101,5347,49,52,3140.22,6477.01,0.00
2024-12-10 17:21:31,100,5347,48,52,3170.33,6477.02,0.00
2024-12-10 17:21:32,100,5348,48,52,3164.34,6478.00,0.00
2024-12-10 17:21:32,101,5348,48,53,3133.01,6478.01,0.00
2024-12-10 17:21:32,100,5348,47,53,3163.05,6478.02,0.00
2024-12-10 17:21:32,100,5349,47,53,3156.80,6479.00,0.00
2024-12-10 17:21:32,101,5349,47,54,3125.54,6479.01,0.00
2024-12-10 17:21:32,100,5349,46,54,3155.50,6479.02,0.00
2024-12-10 17:21:32,100,5350,46,54,3148.92,6480.00,0.00
2024-12-10 17:21:32,101,5350,47,54,3117.74,6480.01,0.00
2024-12-10 17:21:32,101,5351,47,54,3108.80,6481.00,0.00
2024-12-10 17:21:32,102,5351,48,54,3078.32,6481.01,0.00
2024-12-10 17:21:32,102,5352,48,54,3058.56,6482.00,0.00
2024-12-10 17:21:32,103,5352,49,54,3028.86,6482.01,0.00
2024-12-10 17:21:32,102,5352,49,53,3056.66,6482.03,0.00
2024-12-10 17:21:32,101,5352,49,52,3086.50,6482.03,0.00
2024-12-10 17:21:32,100,5352,48,52,3051.97,6482.73,0.00
2024-12-10 17:21:32,100,5353,48,52,3082.58,6483.00,0.00
2024-12-10 17:21:32,101,5353,48,53,3052.06,6483.01,0.00
2024-12-10 17:21:32,100,5353,47,53,3020.42,6483.70,0.00
2024-12-10 17:21:32,99,5353,47,52,3047.18,6483.75,0.00
2024-12-10 17:21:32,99,5354,47,52,3077.13,6484.00,0.00
2024-12-10 17:21:32,100,5354,48,52,3046.36,6484.01,0.00
2024-12-10 17:21:32,99,5354,48,51,3075.17,6484.03,0.00
2024-12-10 17:21:32,98,5354,47,51,3064.15,6484.60,0.00
2024-12-10 17:21:32,97,5354,47,50,3086.92,6484.74,0.00
2024-12-10 17:21:32,97,5355,47,50,3117.31,6485.00,0.00
2024-12-10 17:21:32,98,5355,48,50,3085.51,6485.01,0.00
2024-12-10 17:21:32,97,5355,47,50,3115.31,6485.03,0.00
2024-12-10 17:21:32,97,5356,47,50,3096.75,6486.00,0.00
2024-12-10 17:21:32,98,5356,47,51,3065.15,6486.01,0.00
2024-12-10 17:21:32,97,5356,47,50,3094.75,6486.03,0.00
2024-12-10 17:21:32,96,5356,46,50,3073.89,6486.75,0.00
2024-12-10 17:21:32,96,5357,46,50,3108.22,6487.00,0.00
2024-12-10 17:21:32,97,5357,46,51,3076.17,6487.01,0.00
2024-12-10 17:21:32,96,5357,46,50,3106.19,6487.03,0.00
2024-12-10 17:21:32,95,5357,45,50,3120.53,6487.31,0.00
2024-12-10 17:21:32,95,5358,45,50,3125.71,6488.00,0.00
2024-12-10 17:21:32,96,5358,45,51,3093.15,6488.01,0.00
2024-12-10 17:21:32,95,5358,45,50,3122.99,6488.04,0.00
2024-12-10 17:21:32,95,5359,45,50,3114.56,6489.00,0.00
2024-12-10 17:21:32,96,5359,46,50,3082.12,6489.01,0.00
2024-12-10 17:21:32,95,5359,45,50,3111.84,6489.04,0.00
2024-12-10 17:21:32,95,5360,45,50,3103.92,6490.00,0.00
2024-12-10 17:21:32,96,5360,45,51,3071.59,6490.01,0.00
2024-12-10 17:21:32,95,5360,44,51,3101.20,6490.04,0.00
2024-12-10 17:21:32,95,5361,44,51,3092.79,6491.00,0.00
2024-12-10 17:21:32,96,5361,45,51,3060.58,6491.01,0.00
2024-12-10 17:21:32,95,5361,45,50,3090.07,6491.04,0.00
2024-12-10 17:21:32,95,5362,45,50,3081.48,6492.00,0.00
2024-12-10 17:21:32,96,5362,46,50,3049.38,6492.01,0.00
2024-12-10 17:21:32,96,5363,46,50,3037.34,6493.00,0.00
2024-12-10 17:21:32,97,5363,47,50,3006.03,6493.01,0.00
2024-12-10 17:21:32,96,5363,47,49,3034.65,6493.04,0.00
2024-12-10 17:21:32,96,5364,47,49,3023.56,6494.00,0.00
2024-12-10 17:21:32,97,5364,48,49,2992.39,6494.01,0.00
2024-12-10 17:21:32,96,5364,48,48,2975.78,6494.65,0.00
2024-12-10 17:21:32,96,5365,48,48,3010.61,6495.00,0.00
2024-12-10 17:21:32,97,5365,48,49,2979.58,6495.01,0.00
2024-12-10 17:21:32,96,5365,47,49,3009.94,6495.01,0.00
2024-12-10 17:21:32,95,5365,46,49,3039.58,6495.03,0.00
2024-12-10 17:21:32,94,5365,46,48,3071.22,6495.03,0.00
2024-12-10 17:21:32,94,5366,46,48,3065.52,6496.00,0.00
2024-12-10 17:21:32,95,5366,47,48,3033.25,6496.01,0.00
2024-12-10 17:21:32,94,5366,46,48,3063.45,6496.03,0.00
2024-12-10 17:21:32,94,5367,46,48,3056.88,6497.00,0.00
2024-12-10 17:21:32,95,5367,46,49,3024.71,6497.01,0.00
2024-12-10 17:21:32,94,5367,45,49,3054.82,6497.03,0.00
2024-12-10 17:21:32,93,5367,44,49,3035.58,6497.76,0.00
2024-12-10 17:21:32,93,5368,44,49,3084.17,6498.00,0.00
2024-12-10 17:21:32,94,5368,44,50,3051.36,6498.01,0.00
2024-12-10 17:21:32,93,5368,43,50,3082.08,6498.03,0.00
2024-12-10 17:21:32,93,5369,43,50,3081.87,6499.00,0.00
2024-12-10 17:21:32,94,5369,43,51,3049.09,6499.01,0.00
2024-12-10 17:21:32,93,5369,42,51,3080.06,6499.03,0.00
2024-12-10 17:21:32,94,5368,43,51,3016.62,6499.51,0.00
2024-12-10 17:21:32,93,5368,42,51,3079.84,6499.75,0.00
2024-12-10 17:21:32,93,5369,42,51,3131.27,6500.00,0.00
2024-12-10 17:21:32,94,5369,43,51,3097.96,6500.01,0.00
2024-12-10 17:21:32,93,5369,43,50,3129.18,6500.03,0.00
2024-12-10 17:21:32,93,5370,43,50,3201.55,6501.00,0.00
2024-12-10 17:21:32,94,5370,44,50,3167.49,6501.01,0.00
2024-12-10 17:21:32,93,5370,43,50,3199.46,6501.03,0.00
2024-12-10 17:21:32,93,5371,43,50,3201.10,6502.00,0.00
2024-12-10 17:21:32,94,5371,43,51,3167.04,6502.01,0.00
2024-12-10 17:21:32,94,5372,43,51,3165.86,6503.00,0.00
2024-12-10 17:21:32,95,5372,43,52,3132.53,6503.01,0.00
2024-12-10 17:21:32,94,5372,43,51,3163.79,6503.03,0.00
2024-12-10 17:21:32,94,5373,43,51,3163.45,6504.00,0.00
2024-12-10 17:21:32,95,5373,44,51,3130.15,6504.01,0.00
2024-12-10 17:21:32,95,5374,44,51,3127.28,6505.00,0.00
2024-12-10 17:21:32,96,5374,44,52,3094.70,6505.01,0.00
2024-12-10 17:21:32,95,5374,43,52,3124.55,6505.04,0.00
2024-12-10 17:21:32,95,5375,43,52,3123.04,6506.00,0.00
2024-12-10 17:21:32,96,5375,43,53,3090.51,6506.01,0.00
2024-12-10 17:21:32,95,5375,43,52,3120.31,6506.04,0.00
2024-12-10 17:21:32,95,5376,43,52,3118.73,6507.00,0.00
2024-12-10 17:21:32,96,5376,44,52,3086.25,6507.01,0.00
2024-12-10 17:21:32,95,5376,44,51,3115.22,6507.05,0.00
2024-12-10 17:21:32,94,5376,44,50,3131.78,6507.28,0.00
2024-12-10 17:21:33,93,5376,44,49,3135.21,6507.70,0.00
2024-12-10 17:21:33,93,5377,44,49,3185.84,6508.00,0.00
2024-12-10 17:21:33,94,5377,44,50,3151.95,6508.01,0.00
2024-12-10 17:21:33,93,5377,43,50,3183.05,6508.04,0.00
2024-12-10 17:21:33,93,5378,43,50,3189.30,6509.00,0.00
2024-12-10 17:21:33,94,5378,44,50,3155.37,6509.01,0.00
2024-12-10 17:21:33,94,5379,44,50,3156.73,6510.00,0.00
2024-12-10 17:21:33,95,5379,45,50,3123.50,6510.01,0.00
2024-12-10 17:21:33,94,5379,45,49,3153.97,6510.04,0.00
2024-12-10 17:21:33,94,5380,45,49,3154.80,6511.00,0.00
2024-12-10 17:21:33,95,5380,45,50,3121.60,6511.01,0.00
2024-12-10 17:21:33,94,5380,44,50,3152.04,6511.04,0.00
2024-12-10 17:21:33,94,5381,44,50,3150.04,6512.00,0.00
2024-12-10 17:21:33,95,5381,44,51,3116.89,6512.01,0.00
2024-12-10 17:21:33,94,5381,43,51,3147.28,6512.04,0.00
2024-12-10 17:21:33,93,5381,43,50,3160.00,6512.34,0.00
2024-12-10 17:21:33,93,5382,43,50,3185.18,6513.00,0.00
2024-12-10 17:21:33,94,5382,44,50,3151.30,6513.01,0.00
2024-12-10 17:21:33,93,5382,43,50,3182.39,6513.04,0.00
2024-12-10 17:21:33,93,5383,43,50,3187.67,6514.00,0.00
2024-12-10 17:21:33,94,5383,44,50,3153.76,6514.01,0.00
2024-12-10 17:21:33,93,5383,44,49,3184.88,6514.04,0.00
2024-12-10 17:21:33,93,5384,44,49,3189.74,6515.00,0.00
2024-12-10 17:21:33,94,5384,44,50,3155.81,6515.01,0.00
2024-12-10 17:21:33,93,5384,44,49,3186.95,6515.04,0.00
2024-12-10 17:21:33,93,5385,44,49,3191.82,6516.00,0.00
2024-12-10 17:21:33,94,5385,45,49,3157.86,6516.01,0.00
2024-12-10 17:21:33,94,5386,45,49,3157.30,6517.00,0.00
2024-12-10 17:21:33,95,5386,45,50,3124.06,6517.01,0.00
2024-12-10 17:21:33,94,5386,45,49,3154.53,6517.04,0.00
2024-12-10 17:21:33,93,5386,45,48,3185.96,6517.08,0.00
2024-12-10 17:21:33,93,5387,45,48,3187.10,6518.00,0.00
2024-12-10 17:21:33,94,5387,45,49,3153.19,6518.01,0.00
2024-12-10 17:21:33,93,5387,45,48,3184.30,6518.04,0.00
2024-12-10 17:21:33,93,5388,45,48,3179.85,6519.00,0.00
2024-12-10 17:21:33,94,5388,45,49,3146.03,6519.01,0.00
2024-12-10 17:21:33,93,5388,45,48,3177.06,6519.04,0.00
2024-12-10 17:21:33,92,5388,45,47,3178.75,6519.40,0.00
2024-12-10 17:21:33,92,5389,45,47,3205.57,6520.00,0.00
2024-12-10 17:21:33,93,5389,45,48,3171.11,6520.01,0.00
2024-12-10 17:21:33,94,5388,45,49,3088.53,6520.71,0.00
2024-12-10 17:21:33,94,5389,45,49,3152.09,6521.00,0.00
2024-12-10 17:21:33,95,5389,46,49,3118.91,6521.01,0.00
2024-12-10 17:21:33,94,5389,46,48,3149.32,6521.04,0.00
2024-12-10 17:21:33,94,5390,46,48,3213.06,6522.00,0.00
2024-12-10 17:21:33,95,5390,46,49,3179.24,6522.01,0.00
2024-12-10 17:21:33,95,5391,46,49,3168.67,6523.00,0.00
2024-12-10 17:21:33,96,5391,46,50,3135.66,6523.01,0.00
2024-12-10 17:21:33,95,5391,45,50,3165.93,6523.04,0.00
2024-12-10 17:21:33,95,5392,45,50,3156.23,6524.00,0.00
2024-12-10 17:21:33,96,5392,45,51,3123.35,6524.01,0.00
2024-12-10 17:21:33,95,5392,45,50,3153.49,6524.04,0.00
2024-12-10 17:21:33,95,5393,45,50,3144.20,6525.00,0.00
2024-12-10 17:21:33,96,5393,46,50,3111.45,6525.01,0.00
2024-12-10 17:21:33,95,5393,46,49,3141.46,6525.04,0.00
2024-12-10 17:21:33,94,5393,45,49,3167.54,6525.15,0.00
2024-12-10 17:21:33,94,5394,45,49,3166.57,6526.00,0.00
2024-12-10 17:21:33,95,5394,46,49,3133.24,6526.01,0.00
2024-12-10 17:21:33,94,5394,46,48,3163.80,6526.04,0.00
2024-12-10 17:21:33,93,5394,46,47,3187.36,6526.17,0.00
2024-12-10 17:21:33,92,5394,45,47,3176.51,6526.73,0.00
2024-12-10 17:21:33,92,5395,45,47,3226.65,6527.00,0.00
2024-12-10 17:21:33,93,5395,46,47,3191.95,6527.01,0.00
2024-12-10 17:21:33,92,5395,46,46,3223.82,6527.04,0.00
2024-12-10 17:21:33,92,5396,46,46,3225.93,6528.00,0.00
2024-12-10 17:21:33,93,5396,47,46,3191.25,6528.01,0.00
2024-12-10 17:21:33,92,5396,46,46,3223.10,6528.04,0.00
2024-12-10 17:21:33,91,5396,46,45,3256.23,6528.08,0.00
2024-12-10 17:21:33,90,5396,45,45,3289.45,6528.12,0.00
2024-12-10 17:21:33,90,5397,45,45,3299.42,6529.00,0.00
2024-12-10 17:21:33,91,5397,46,45,3263.16,6529.01,0.00
2024-12-10 17:21:33,91,5398,46,45,3265.54,6530.00,0.00
2024-12-10 17:21:33,92,5398,47,45,3230.04,6530.01,0.00
2024-12-10 17:21:33,91,5398,46,45,3262.67,6530.04,0.00
2024-12-10 17:21:33,90,5398,46,44,3291.62,6530.16,0.00
2024-12-10 17:21:33,90,5399,46,44,3304.40,6531.00,0.00
2024-12-10 17:21:33,91,5399,46,45,3268.09,6531.01,0.00
2024-12-10 17:21:33,90,5399,46,44,3301.50,6531.04,0.00
2024-12-10 17:21:33,90,5400,46,44,3307.56,6532.00,0.00
2024-12-10 17:21:33,91,5400,46,45,3271.21,6532.01,0.00
2024-12-10 17:21:33,90,5400,45,45,3288.90,6532.29,0.00
2024-12-10 17:21:33,90,5401,45,45,3311.04,6533.00,0.00
2024-12-10 17:21:33,91,5401,45,46,3274.66,6533.01,0.00
2024-12-10 17:21:33,90,5401,45,45,3308.14,6533.04,0.00
2024-12-10 17:21:33,91,5400,46,45,3213.48,6533.87,0.00
2024-12-10 17:21:33,91,5401,46,45,3285.40,6534.00,0.00
2024-12-10 17:21:33,92,5401,47,45,3249.69,6534.01,0.00
2024-12-10 17:21:33,92,5402,47,45,3319.87,6535.00,0.00
2024-12-10 17:21:33,93,5402,47,46,3284.17,6535.01,0.00
2024-12-10 17:21:33,92,5402,46,46,3319.16,6535.01,0.00
2024-12-10 17:21:33,91,5402,45,46,3353.48,6535.03,0.00
2024-12-10 17:21:33,90,5402,44,46,3390.42,6535.03,0.00
2024-12-10 17:21:33,89,5402,43,46,3412.06,6535.20,0.00
2024-12-10 17:21:33,88,5402,42,46,3444.24,6535.30,0.00
2024-12-10 17:21:33,87,5402,42,45,3463.65,6535.61,0.00
2024-12-10 17:21:33,87,5403,42,45,3513.56,6536.00,0.00
2024-12-10 17:21:33,88,5403,43,45,3473.63,6536.01,0.00
2024-12-10 17:21:33,87,5403,43,44,3499.93,6536.18,0.00
2024-12-10 17:21:33,87,5404,43,44,3522.24,6537.00,0.00
2024-12-10 17:21:33,88,5404,44,44,3482.21,6537.01,0.00
2024-12-10 17:21:33,87,5404,43,44,3519.98,6537.04,0.00
2024-12-10 17:21:33,87,5405,43,44,3532.45,6538.00,0.00
2024-12-10 17:21:34,88,5405,44,44,3492.31,6538.01,0.00
2024-12-10 17:21:34,88,5406,44,44,3502.06,6539.00,0.00
2024-12-10 17:21:34,89,5406,44,45,3462.71,6539.01,0.00
2024-12-10 17:21:34,88,5406,44,44,3499.84,6539.03,0.00
2024-12-10 17:21:34,88,5407,44,44,3510.95,6540.00,0.00
2024-12-10 17:21:34,89,5407,44,45,3471.50,6540.01,0.00
2024-12-10 17:21:34,88,5407,43,45,3508.37,6540.05,0.00
2024-12-10 17:21:34,87,5407,43,44,3548.20,6540.05,0.00
2024-12-10 17:21:34,86,5407,42,44,3576.38,6540.24,0.00
2024-12-10 17:21:34,85,5407,42,43,3617.82,6540.25,0.00
2024-12-10 17:21:34,85,5408,42,43,3645.59,6541.00,0.00
2024-12-10 17:21:34,86,5408,42,44,3603.20,6541.01,0.00
2024-12-10 17:21:34,85,5408,42,43,3643.28,6541.04,0.00
2024-12-10 17:21:34,85,5409,42,43,3657.31,6542.00,0.00
2024-12-10 17:21:34,86,5409,42,44,3614.78,6542.01,0.00
2024-12-10 17:21:34,86,5410,42,44,3625.95,6543.00,0.00
2024-12-10 17:21:34,87,5410,42,45,3584.27,6543.01,0.00
2024-12-10 17:21:34,86,5410,41,45,3625.19,6543.01,0.00
2024-12-10 17:21:34,86,5411,41,45,3635.27,6544.00,0.00
2024-12-10 17:21:34,87,5411,41,46,3593.49,6544.01,0.00
2024-12-10 17:21:34,86,5411,41,45,3634.51,6544.01,0.00
2024-12-10 17:21:34,85,5411,40,45,3676.50,6544.01,0.00
2024-12-10 17:21:34,85,5412,40,45,3686.09,6545.00,0.00
2024-12-10 17:21:34,86,5412,40,46,3643.23,6545.01,0.00
2024-12-10 17:21:34,87,5411,40,47,3541.76,6545.87,0.00
2024-12-10 17:21:34,87,5412,40,47,3617.12,6546.00,0.00
2024-12-10 17:21:34,88,5412,40,48,3576.02,6546.01,0.00
2024-12-10 17:21:34,87,5412,39,48,3615.63,6546.02,0.00
2024-12-10 17:21:34,86,5412,39,47,3653.31,6546.08,0.00
2024-12-10 17:21:34,86,5413,39,47,3739.93,6547.00,0.00
2024-12-10 17:21:34,87,5413,39,48,3696.95,6547.01,0.00
2024-12-10 17:21:34,86,5413,39,47,3738.42,6547.02,0.00
2024-12-10 17:21:34,85,5413,39,46,3778.25,6547.07,0.00
2024-12-10 17:21:34,85,5414,39,46,3793.07,6548.00,0.00
2024-12-10 17:21:34,86,5414,40,46,3748.96,6548.01,0.00
2024-12-10 17:21:34,85,5414,40,45,3791.53,6548.02,0.00
2024-12-10 17:21:34,84,5414,40,44,3834.08,6548.06,0.00
2024-12-10 17:21:34,84,5415,40,44,3848.35,6549.00,0.00
2024-12-10 17:21:34,85,5415,41,44,3803.07,6549.01,0.00
2024-12-10 17:21:34,84,5415,40,44,3846.79,6549.02,0.00
2024-12-10 17:21:34,84,5416,40,44,3857.93,6550.00,0.00
2024-12-10 17:21:34,85,5416,41,44,3812.55,6550.01,0.00
2024-12-10 17:21:34,84,5416,40,44,3856.38,6550.02,0.00
2024-12-10 17:21:34,84,5417,40,44,3867.62,6551.00,0.00
2024-12-10 17:21:34,85,5417,40,45,3822.11,6551.01,0.00
2024-12-10 17:21:34,85,5418,40,45,3832.31,6552.00,0.00
2024-12-10 17:21:34,86,5418,41,45,3787.75,6552.01,0.00
2024-12-10 17:21:34,85,5418,40,45,3830.77,6552.02,0.00
2024-12-10 17:21:34,85,5419,40,45,3843.58,6553.00,0.00
2024-12-10 17:21:34,86,5419,41,45,3798.89,6553.01,0.00
2024-12-10 17:21:34,85,5419,40,45,3832.52,6553.18,0.00
2024-12-10 17:21:34,85,5420,40,45,3856.20,6554.00,0.00
2024-12-10 17:21:34,86,5420,41,45,3811.36,6554.01,0.00
2024-12-10 17:21:34,86,5421,41,45,3823.38,6555.00,0.00
2024-12-10 17:21:34,87,5421,42,45,3779.43,6555.01,0.00
2024-12-10 17:21:34,87,5422,42,45,3790.56,6556.00,0.00
2024-12-10 17:21:34,88,5422,43,45,3747.48,6556.01,0.00
2024-12-10 17:21:34,88,5423,43,45,3757.74,6557.00,0.00
2024-12-10 17:21:34,89,5423,44,45,3715.52,6557.01,0.00
2024-12-10 17:21:34,90,5422,44,46,3653.00,6557.36,0.00
2024-12-10 17:21:34,90,5423,44,46,3725.61,6558.00,0.00
2024-12-10 17:21:34,91,5423,45,46,3684.67,6558.01,0.00
2024-12-10 17:21:34,91,5424,45,46,3762.60,6559.00,0.00
2024-12-10 17:21:34,92,5424,46,46,3721.71,6559.01,0.00
2024-12-10 17:21:34,92,5425,46,46,3725.32,6560.00,0.00
2024-12-10 17:21:34,93,5425,46,47,3685.26,6560.01,0.00
2024-12-10 17:21:34,93,5426,46,47,3686.89,6561.00,0.00
2024-12-10 17:21:34,94,5426,46,48,3647.66,6561.01,0.00
2024-12-10 17:21:34,94,5427,46,48,3648.09,6562.00,0.00
2024-12-10 17:21:34,95,5427,47,48,3609.69,6562.01,0.00
2024-12-10 17:21:34,94,5427,46,48,3635.82,6562.14,0.00
2024-12-10 17:21:34,95,5426,47,48,3552.67,6562.82,0.00
2024-12-10 17:21:34,95,5427,47,48,3621.23,6563.00,0.00
2024-12-10 17:21:34,96,5427,48,48,3583.51,6563.01,0.00
2024-12-10 17:21:34,97,5426,48,49,3482.80,6563.98,0.00
2024-12-10 17:21:34,97,5427,48,49,3617.47,6564.00,0.00
2024-12-10 17:21:34,98,5427,49,49,3580.56,6564.01,0.00
2024-12-10 17:21:34,97,5427,49,48,3616.12,6564.02,0.00
2024-12-10 17:21:34,97,5428,49,48,3685.45,6565.00,0.00
2024-12-10 17:21:34,98,5428,49,49,3647.84,6565.01,0.00
2024-12-10 17:21:34,98,5429,49,49,3647.87,6566.00,0.00
2024-12-10 17:21:34,99,5429,49,50,3611.02,6566.01,0.00
2024-12-10 17:21:34,98,5429,48,50,3646.84,6566.02,0.00
2024-12-10 17:21:34,98,5430,48,50,3647.46,6567.00,0.00
2024-12-10 17:21:34,99,5430,48,51,3610.62,6567.01,0.00
2024-12-10 17:21:34,98,5430,48,50,3646.13,6567.02,0.00
2024-12-10 17:21:34,97,5430,48,49,3673.08,6567.17,0.00
2024-12-10 17:21:34,97,5431,48,49,3686.49,6568.00,0.00
2024-12-10 17:21:34,98,5431,48,50,3648.87,6568.01,0.00
2024-12-10 17:21:34,97,5431,48,49,3685.14,6568.02,0.00
2024-12-10 17:21:34,97,5432,48,49,3689.08,6569.00,0.00
2024-12-10 17:21:34,98,5432,49,49,3651.44,6569.01,0.00
2024-12-10 17:21:34,97,5432,48,49,3687.73,6569.02,0.00
2024-12-10 17:21:35,97,5433,48,49,3691.67,6570.00,0.00
2024-12-10 17:21:35,98,5433,49,49,3654.00,6570.01,0.00
2024-12-10 17:21:35,97,5433,48,49,3690.73,6570.02,0.00
2024-12-10 17:21:35,97,5434,48,49,3694.68,6571.00,0.00
2024-12-10 17:21:35,98,5434,48,50,3656.97,6571.01,0.00
2024-12-10 17:21:35,98,5435,48,50,3659.54,6572.00,0.00
2024-12-10 17:21:35,99,5435,48,51,3622.58,6572.01,0.00
2024-12-10 17:21:35,99,5436,48,51,3624.46,6573.00,0.00
2024-12-10 17:21:35,100,5436,48,52,3588.21,6573.01,0.00
2024-12-10 17:21:35,100,5437,48,52,3589.42,6574.00,0.00
2024-12-10 17:21:35,101,5437,48,53,3553.88,6574.01,0.00
2024-12-10 17:21:35,101,5438,48,53,3554.42,6575.00,0.00
2024-12-10 17:21:35,102,5438,48,54,3519.57,6575.01,0.00
2024-12-10 17:21:35,102,5439,48,54,3519.46,6576.00,0.00
2024-12-10 17:21:35,103,5439,49,54,3485.29,6576.01,0.00
2024-12-10 17:21:35,102,5439,49,53,3518.17,6576.02,0.00
2024-12-10 17:21:35,102,5440,49,53,3518.71,6577.00,0.00
2024-12-10 17:21:35,103,5440,50,53,3484.54,6577.01,0.00
2024-12-10 17:21:35,102,5440,49,53,3517.42,6577.02,0.00
2024-12-10 17:21:35,102,5441,49,53,3517.95,6578.00,0.00
2024-12-10 17:21:35,103,5441,50,53,3483.79,6578.01,0.00
2024-12-10 17:21:35,102,5441,50,52,3516.66,6578.02,0.00
2024-12-10 17:21:35,102,5442,50,52,3517.20,6579.00,0.00
2024-12-10 17:21:35,103,5442,51,52,3483.05,6579.01,0.00
2024-12-10 17:21:35,103,5443,51,52,3482.30,6580.00,0.00
2024-12-10 17:21:35,104,5443,52,52,3448.82,6580.01,0.00
2024-12-10 17:21:35,103,5443,51,52,3481.02,6580.02,0.00
2024-12-10 17:21:35,103,5444,51,52,3480.00,6581.00,0.00
2024-12-10 17:21:35,104,5444,52,52,3446.53,6581.01,0.00
2024-12-10 17:21:35,103,5444,51,52,3478.72,6581.02,0.00
2024-12-10 17:21:35,103,5445,51,52,3476.45,6582.00,0.00
2024-12-10 17:21:35,104,5445,51,53,3443.02,6582.01,0.00
2024-12-10 17:21:35,103,5445,50,53,3462.92,6582.18,0.00
2024-12-10 17:21:35,103,5446,50,53,3473.01,6583.00,0.00
2024-12-10 17:21:35,104,5446,51,53,3439.62,6583.01,0.00
2024-12-10 17:21:35,103,5446,51,52,3471.73,6583.02,0.00
2024-12-10 17:21:35,103,5447,51,52,3471.62,6584.00,0.00
2024-12-10 17:21:35,104,5447,52,52,3438.24,6584.01,0.00
2024-12-10 17:21:35,105,5446,52,53,3389.23,6584.28,0.00
2024-12-10 17:21:35,105,5447,52,53,3448.66,6585.00,0.00
2024-12-10 17:21:35,106,5447,52,54,3416.12,6585.01,0.00
2024-12-10 17:21:35,105,5447,51,54,3447.40,6585.02,0.00
2024-12-10 17:21:35,105,5448,51,54,3508.77,6586.00,0.00
2024-12-10 17:21:35,106,5448,52,54,3475.67,6586.01,0.00
2024-12-10 17:21:35,105,5448,52,53,3507.51,6586.02,0.00
2024-12-10 17:21:35,105,5449,52,53,3506.16,6587.00,0.00
2024-12-10 17:21:35,106,5449,52,54,3473.09,6587.01,0.00
2024-12-10 17:21:35,105,5449,52,53,3504.91,6587.02,0.00
2024-12-10 17:21:35,105,5450,52,53,3503.56,6588.00,0.00
2024-12-10 17:21:35,106,5450,52,54,3470.51,6588.01,0.00
2024-12-10 17:21:35,105,5450,52,53,3502.31,6588.02,0.00
2024-12-10 17:21:35,106,5449,52,54,3450.69,6588.32,0.00
2024-12-10 17:21:35,106,5450,52,54,3509.57,6589.00,0.00
2024-12-10 17:21:35,107,5450,53,54,3476.77,6589.01,0.00
2024-12-10 17:21:35,106,5450,52,54,3508.33,6589.02,0.00
2024-12-10 17:21:35,106,5451,52,54,3568.55,6590.00,0.00
2024-12-10 17:21:35,107,5451,53,54,3535.19,6590.01,0.00
2024-12-10 17:21:35,107,5452,53,54,3532.03,6591.00,0.00
2024-12-10 17:21:35,108,5452,53,55,3499.33,6591.01,0.00
2024-12-10 17:21:35,107,5452,52,55,3530.80,6591.02,0.00
2024-12-10 17:21:35,107,5453,52,55,3528.26,6592.00,0.00
2024-12-10 17:21:35,108,5453,53,55,3495.59,6592.01,0.00
2024-12-10 17:21:35,107,5453,52,55,3527.03,6592.02,0.00
2024-12-10 17:21:35,107,5454,52,55,3524.48,6593.00,0.00
2024-12-10 17:21:35,108,5454,53,55,3491.85,6593.01,0.00
2024-12-10 17:21:35,108,5455,53,55,3488.10,6594.00,0.00
2024-12-10 17:21:35,109,5455,53,56,3456.10,6594.01,0.00
2024-12-10 17:21:35,108,5455,52,56,3486.27,6594.03,0.00
2024-12-10 17:21:35,108,5456,52,56,3483.75,6595.00,0.00
2024-12-10 17:21:35,109,5456,53,56,3451.79,6595.01,0.00
2024-12-10 17:21:35,108,5456,53,55,3481.92,6595.03,0.00
2024-12-10 17:21:35,108,5457,53,55,3479.39,6596.00,0.00
2024-12-10 17:21:35,109,5457,54,55,3447.47,6596.01,0.00
2024-12-10 17:21:35,108,5457,53,55,3477.56,6596.03,0.00
2024-12-10 17:21:35,109,5456,53,56,3400.55,6596.73,0.00
2024-12-10 17:21:35,109,5457,53,56,3460.09,6597.00,0.00
2024-12-10 17:21:35,110,5457,53,57,3428.64,6597.01,0.00
2024-12-10 17:21:35,109,5457,53,56,3458.28,6597.03,0.00
2024-12-10 17:21:35,109,5458,53,56,3515.70,6598.00,0.00
2024-12-10 17:21:35,110,5458,53,57,3483.74,6598.01,0.00
2024-12-10 17:21:35,109,5458,53,56,3513.89,6598.03,0.00
2024-12-10 17:21:35,109,5459,53,56,3510.79,6599.00,0.00
2024-12-10 17:21:35,110,5459,54,56,3478.87,6599.01,0.00
2024-12-10 17:21:35,109,5459,54,55,3510.18,6599.01,0.00
2024-12-10 17:21:35,108,5459,54,54,3541.46,6599.02,0.00
2024-12-10 17:21:35,108,5460,54,54,3538.33,6600.00,0.00
2024-12-10 17:21:35,109,5460,54,55,3505.87,6600.01,0.00
2024-12-10 17:21:35,109,5461,54,55,3501.56,6601.00,0.00
2024-12-10 17:21:35,110,5461,55,55,3469.72,6601.01,0.00
2024-12-10 17:21:36,110,5462,55,55,3464.85,6602.00,0.00
2024-12-10 17:21:36,111,5462,55,56,3433.63,6602.01,0.00
2024-12-10 17:21:36,111,5463,55,56,3428.20,6603.00,0.00
2024-12-10 17:21:36,112,5463,55,57,3397.59,6603.01,0.00
2024-12-10 17:21:36,111,5463,55,56,3426.43,6603.03,0.00
2024-12-10 17:21:36,111,5464,55,56,3422.18,6604.00,0.00
2024-12-10 17:21:36,112,5464,55,57,3391.62,6604.01,0.00
2024-12-10 17:21:36,111,5464,54,57,3420.40,6604.03,0.00
2024-12-10 17:21:36,111,5465,54,57,3416.15,6605.00,0.00
2024-12-10 17:21:36,112,5465,54,58,3385.65,6605.01,0.00
2024-12-10 17:21:36,111,5465,54,57,3414.37,6605.03,0.00
2024-12-10 17:21:36,111,5466,54,57,3410.12,6606.00,0.00
2024-12-10 17:21:36,112,5466,54,58,3379.67,6606.01,0.00
2024-12-10 17:21:36,111,5466,54,57,3408.34,6606.03,0.00
2024-12-10 17:21:36,112,5465,54,58,3316.46,6606.98,0.00
2024-12-10 17:21:36,112,5466,54,58,3375.47,6607.00,0.00
2024-12-10 17:21:36,113,5466,54,59,3345.60,6607.01,0.00
2024-12-10 17:21:36,112,5466,53,59,3373.70,6607.03,0.00
2024-12-10 17:21:36,112,5467,53,59,3427.90,6608.00,0.00
2024-12-10 17:21:36,113,5467,53,60,3397.56,6608.01,0.00
2024-12-10 17:21:36,112,5467,53,59,3426.13,6608.03,0.00
2024-12-10 17:21:36,112,5468,53,59,3421.34,6609.00,0.00
2024-12-10 17:21:36,113,5468,53,60,3391.06,6609.01,0.00
2024-12-10 17:21:36,112,5468,52,60,3419.57,6609.03,0.00
2024-12-10 17:21:36,112,5469,52,60,3414.77,6610.00,0.00
2024-12-10 17:21:36,113,5469,52,61,3384.55,6610.01,0.00
2024-12-10 17:21:36,112,5469,51,61,3413.01,6610.03,0.00
2024-12-10 17:21:36,112,5470,51,61,3408.20,6611.00,0.00
2024-12-10 17:21:36,113,5470,52,61,3378.04,6611.01,0.00
2024-12-10 17:21:36,112,5470,52,60,3406.44,6611.03,0.00
2024-12-10 17:21:36,113,5469,52,61,3320.53,6611.89,0.00
2024-12-10 17:21:36,113,5470,52,61,3378.55,6612.00,0.00
2024-12-10 17:21:36,114,5470,52,62,3348.92,6612.01,0.00
2024-12-10 17:21:36,113,5470,52,61,3376.80,6612.03,0.00
2024-12-10 17:21:36,114,5469,52,62,3288.46,6612.94,0.00
2024-12-10 17:21:36,114,5470,52,62,3403.37,6613.00,0.00
2024-12-10 17:21:36,115,5470,53,62,3373.78,6613.01,0.00
2024-12-10 17:21:36,115,5471,53,62,3423.75,6614.00,0.00
2024-12-10 17:21:36,116,5471,53,63,3394.24,6614.01,0.00
2024-12-10 17:21:36,115,5471,52,63,3421.46,6614.04,0.00
2024-12-10 17:21:36,115,5472,52,63,3415.10,6615.00,0.00
2024-12-10 17:21:36,116,5472,53,63,3385.66,6615.01,0.00
2024-12-10 17:21:36,115,5472,53,62,3412.81,6615.04,0.00
2024-12-10 17:21:36,115,5473,53,62,3405.47,6616.00,0.00
2024-12-10 17:21:36,116,5473,53,63,3376.12,6616.01,0.00
2024-12-10 17:21:36,115,5473,52,63,3403.18,6616.04,0.00
2024-12-10 17:21:36,115,5474,52,63,3394.93,6617.00,0.00
2024-12-10 17:21:36,116,5474,53,63,3365.66,6617.01,0.00
2024-12-10 17:21:36,115,5474,53,62,3392.64,6617.04,0.00
2024-12-10 17:21:36,115,5475,53,62,3381.53,6618.00,0.00
2024-12-10 17:21:36,116,5475,54,62,3352.38,6618.01,0.00
2024-12-10 17:21:36,115,5475,54,61,3379.24,6618.04,0.00
2024-12-10 17:21:36,114,5475,54,60,3398.77,6618.16,0.00
2024-12-10 17:21:36,114,5476,54,60,3396.81,6619.00,0.00
2024-12-10 17:21:36,115,5476,55,60,3367.28,6619.01,0.00
2024-12-10 17:21:36,114,5476,55,59,3394.50,6619.04,0.00
2024-12-10 17:21:36,114,5477,55,59,3382.61,6620.00,0.00
2024-12-10 17:21:36,115,5477,55,60,3353.19,6620.01,0.00
2024-12-10 17:21:36,114,5477,54,60,3382.02,6620.01,0.00
2024-12-10 17:21:36,113,5477,54,59,3410.21,6620.03,0.00
2024-12-10 17:21:36,113,5478,54,59,3396.66,6621.00,0.00
2024-12-10 17:21:36,114,5478,54,60,3366.87,6621.01,0.00
2024-12-10 17:21:36,114,5479,54,60,3350.76,6622.00,0.00
2024-12-10 17:21:36,115,5479,55,60,3321.62,6622.01,0.00
2024-12-10 17:21:36,114,5479,55,59,3347.87,6622.04,0.00
2024-12-10 17:21:36,114,5480,55,59,3333.30,6623.00,0.00
2024-12-10 17:21:36,115,5480,56,59,3304.32,6623.01,0.00
2024-12-10 17:21:36,114,5480,56,58,3330.41,6623.04,0.00
2024-12-10 17:21:36,113,5480,55,58,3306.54,6623.79,0.00
2024-12-10 17:21:36,113,5481,55,58,3351.27,6624.00,0.00
2024-12-10 17:21:36,114,5481,55,59,3321.88,6624.01,0.00
2024-12-10 17:21:36,113,5481,55,58,3348.36,6624.04,0.00
2024-12-10 17:21:36,114,5480,56,58,3310.86,6624.18,0.00
2024-12-10 17:21:36,114,5481,56,58,3364.22,6625.00,0.00
2024-12-10 17:21:36,115,5481,57,58,3334.97,6625.01,0.00
2024-12-10 17:21:36,114,5481,56,58,3361.33,6625.04,0.00
2024-12-10 17:21:36,114,5482,56,58,3414.71,6626.00,0.00
2024-12-10 17:21:36,115,5482,56,59,3385.02,6626.01,0.00
2024-12-10 17:21:36,114,5482,55,59,3411.82,6626.04,0.00
2024-12-10 17:21:36,114,5483,55,59,3406.87,6627.00,0.00
2024-12-10 17:21:36,115,5483,55,60,3377.25,6627.01,0.00
2024-12-10 17:21:36,114,5483,54,60,3403.98,6627.04,0.00
2024-12-10 17:21:36,114,5484,54,60,3398.95,6628.00,0.00
2024-12-10 17:21:36,115,5484,55,60,3369.39,6628.01,0.00
2024-12-10 17:21:36,114,5484,54,60,3396.06,6628.04,0.00
2024-12-10 17:21:36,114,5485,54,60,3391.26,6629.00,0.00
2024-12-10 17:21:36,115,5485,54,61,3361.77,6629.01,0.00
2024-12-10 17:21:36,114,5485,53,61,3388.37,6629.04,0.00
2024-12-10 17:21:36,115,5484,54,61,3305.09,6629.88,0.00
2024-12-10 17:21:36,115,5485,54,61,3362.28,6630.00,0.00
2024-12-10 17:21:36,116,5485,54,62,3333.30,6630.01,0.00
2024-12-10 17:21:36,115,5485,53,62,3359.41,6630.04,0.00
2024-12-10 17:21:36,115,5486,53,62,3411.80,6631.00,0.00
2024-12-10 17:21:36,116,5486,53,63,3382.39,6631.01,0.00
2024-12-10 17:21:36,115,5486,53,62,3408.93,6631.04,0.00
2024-12-10 17:21:37,115,5487,53,62,3403.67,6632.00,0.00
2024-12-10 17:21:37,116,5487,53,63,3374.32,6632.01,0.00
2024-12-10 17:21:37,116,5487,53,63,3366.25,6633.00,0.00
2024-12-10 17:21:37,117,5487,53,64,3337.48,6633.01,0.00
2024-12-10 17:21:37,116,5487,53,63,3364.55,6633.03,0.00
2024-12-10 17:21:37,115,5487,53,62,3392.65,6633.04,0.00
2024-12-10 17:21:37,115,5488,53,62,3386.81,6634.00,0.00
2024-12-10 17:21:37,116,5488,53,63,3357.61,6634.01,0.00
2024-12-10 17:21:37,115,5488,52,63,3383.94,6634.04,0.00
2024-12-10 17:21:37,115,5489,52,63,3378.66,6635.00,0.00
2024-12-10 17:21:37,116,5489,52,64,3349.54,6635.01,0.00
2024-12-10 17:21:37,115,5489,52,63,3375.79,6635.04,0.00
2024-12-10 17:21:37,115,5490,52,63,3370.52,6636.00,0.00
2024-12-10 17:21:37,116,5490,52,64,3341.46,6636.01,0.00
2024-12-10 17:21:37,115,5490,51,64,3367.64,6636.04,0.00
2024-12-10 17:21:37,115,5491,51,64,3362.37,6637.00,0.00
2024-12-10 17:21:37,116,5491,52,64,3333.38,6637.01,0.00
2024-12-10 17:21:37,115,5491,51,64,3359.49,6637.04,0.00
2024-12-10 17:21:37,115,5492,51,64,3354.22,6638.00,0.00
2024-12-10 17:21:37,116,5492,51,65,3325.30,6638.01,0.00
2024-12-10 17:21:37,115,5492,50,65,3351.34,6638.04,0.00
2024-12-10 17:21:37,115,5493,50,65,3346.06,6639.00,0.00
2024-12-10 17:21:37,116,5493,50,66,3317.22,6639.01,0.00
2024-12-10 17:21:37,117,5492,50,67,3286.61,6639.06,0.00
2024-12-10 17:21:37,117,5493,50,67,3289.36,6640.00,0.00
2024-12-10 17:21:37,118,5493,50,68,3261.49,6640.01,0.00
2024-12-10 17:21:37,117,5493,50,67,3285.97,6640.05,0.00
2024-12-10 17:21:37,117,5494,50,67,3336.97,6641.00,0.00
2024-12-10 17:21:37,118,5494,50,68,3308.69,6641.01,0.00
2024-12-10 17:21:37,117,5494,50,67,3333.58,6641.05,0.00
2024-12-10 17:21:37,117,5495,50,67,3327.82,6642.00,0.00
2024-12-10 17:21:37,118,5495,51,67,3299.62,6642.01,0.00
2024-12-10 17:21:37,117,5495,51,66,3324.43,6642.05,0.00
2024-12-10 17:21:37,117,5496,51,66,3318.67,6643.00,0.00
2024-12-10 17:21:37,118,5496,51,67,3290.54,6643.01,0.00
2024-12-10 17:21:37,117,5496,51,66,3315.28,6643.05,0.00
2024-12-10 17:21:37,117,5497,51,66,3309.51,6644.00,0.00
2024-12-10 17:21:37,118,5497,52,66,3281.47,6644.01,0.00
2024-12-10 17:21:37,117,5497,52,65,3306.12,6644.05,0.00
2024-12-10 17:21:37,117,5498,52,65,3300.36,6645.00,0.00
2024-12-10 17:21:37,118,5498,53,65,3272.39,6645.01,0.00
2024-12-10 17:21:37,117,5498,52,65,3298.09,6645.03,0.00
2024-12-10 17:21:37,116,5498,52,64,3325.39,6645.04,0.00
2024-12-10 17:21:37,116,5499,52,64,3319.57,6646.00,0.00
2024-12-10 17:21:37,117,5499,52,65,3291.20,6646.01,0.00
2024-12-10 17:21:37,116,5499,52,64,3316.15,6646.05,0.00
2024-12-10 17:21:37,116,5500,52,64,3310.90,6647.00,0.00
2024-12-10 17:21:37,117,5500,53,64,3282.60,6647.01,0.00
2024-12-10 17:21:37,116,5500,53,63,3307.48,6647.05,0.00
2024-12-10 17:21:37,116,5501,53,63,3302.23,6648.00,0.00
2024-12-10 17:21:37,117,5501,54,63,3274.01,6648.01,0.00
2024-12-10 17:21:37,116,5501,53,63,3298.81,6648.05,0.00
2024-12-10 17:21:37,116,5502,53,63,3293.56,6649.00,0.00
2024-12-10 17:21:37,117,5502,54,63,3265.41,6649.01,0.00
2024-12-10 17:21:37,116,5502,53,63,3290.13,6649.05,0.00
2024-12-10 17:21:37,116,5503,53,63,3284.88,6650.00,0.00
2024-12-10 17:21:37,117,5503,53,64,3256.80,6650.01,0.00
2024-12-10 17:21:37,116,5503,52,64,3281.46,6650.05,0.00
2024-12-10 17:21:37,117,5502,52,65,3230.17,6650.42,0.00
2024-12-10 17:21:37,117,5503,52,65,3283.44,6651.00,0.00
2024-12-10 17:21:37,118,5503,52,66,3255.62,6651.01,0.00
2024-12-10 17:21:37,119,5502,52,67,3227.70,6651.03,0.00
2024-12-10 17:21:37,118,5502,52,66,3290.02,6651.06,0.00
2024-12-10 17:21:37,118,5503,52,66,3340.66,6652.00,0.00
2024-12-10 17:21:37,119,5503,53,66,3312.59,6652.01,0.00
2024-12-10 17:21:37,118,5503,52,66,3337.30,6652.05,0.00
2024-12-10 17:21:37,118,5504,52,66,3387.40,6653.00,0.00
2024-12-10 17:21:37,119,5504,52,67,3358.93,6653.01,0.00
2024-12-10 17:21:37,118,5504,51,67,3384.03,6653.05,0.00
2024-12-10 17:21:37,118,5505,51,67,3377.76,6654.00,0.00
2024-12-10 17:21:37,119,5505,51,68,3349.37,6654.01,0.00
2024-12-10 17:21:37,118,5505,50,68,3374.39,6654.05,0.00
2024-12-10 17:21:37,118,5506,50,68,3368.11,6655.00,0.00
2024-12-10 17:21:37,119,5506,51,68,3339.81,6655.01,0.00
2024-12-10 17:21:37,118,5506,50,68,3364.75,6655.05,0.00
2024-12-10 17:21:37,118,5507,50,68,3358.47,6656.00,0.00
2024-12-10 17:21:37,119,5507,50,69,3330.24,6656.01,0.00
2024-12-10 17:21:37,118,5507,49,69,3355.10,6656.05,0.00
2024-12-10 17:21:37,118,5508,49,69,3348.82,6657.00,0.00
2024-12-10 17:21:37,119,5508,50,69,3320.68,6657.01,0.00
2024-12-10 17:21:37,118,5508,49,69,3348.25,6657.01,0.00
2024-12-10 17:21:37,117,5508,48,69,3374.04,6657.04,0.00
2024-12-10 17:21:37,116,5508,48,68,3402.56,6657.04,0.00
2024-12-10 17:21:37,116,5509,48,68,3396.73,6658.00,0.00
2024-12-10 17:21:37,117,5509,48,69,3367.70,6658.01,0.00
2024-12-10 17:21:37,116,5509,47,69,3393.88,6658.04,0.00
2024-12-10 17:21:37,116,5510,47,69,3388.06,6659.00,0.00
2024-12-10 17:21:37,117,5510,47,70,3359.10,6659.01,0.00
2024-12-10 17:21:37,116,5510,46,70,3385.21,6659.04,0.00
2024-12-10 17:21:37,117,5509,46,71,3321.71,6659.58,0.00
2024-12-10 17:21:38,117,5510,46,71,3376.11,6660.00,0.00
2024-12-10 17:21:38,118,5510,47,71,3347.50,6660.01,0.00
2024-12-10 17:21:38,117,5510,47,70,3373.29,6660.04,0.00
2024-12-10 17:21:38,117,5511,47,70,3423.87,6661.00,0.00
2024-12-10 17:21:38,118,5511,47,71,3394.86,6661.01,0.00
2024-12-10 17:21:38,118,5512,47,71,3385.77,6662.00,0.00
2024-12-10 17:21:38,119,5512,48,71,3357.32,6662.01,0.00
2024-12-10 17:21:38,118,5512,48,70,3383.53,6662.03,0.00
2024-12-10 17:21:38,117,5512,47,70,3411.31,6662.04,0.00
2024-12-10 17:21:38,116,5512,46,70,3440.14,6662.04,0.00
2024-12-10 17:21:38,116,5513,46,70,3434.32,6663.00,0.00
2024-12-10 17:21:38,117,5513,47,70,3404.97,6663.01,0.00
2024-12-10 17:21:38,116,5513,47,69,3432.04,6663.04,0.00
2024-12-10 17:21:38,115,5513,46,69,3461.31,6663.04,0.00
2024-12-10 17:21:38,114,5513,46,68,3491.08,6663.04,0.00
2024-12-10 17:21:38,114,5514,46,68,3485.75,6664.00,0.00
2024-12-10 17:21:38,115,5514,46,69,3455.44,6664.01,0.00
2024-12-10 17:21:38,114,5514,45,69,3483.43,6664.04,0.00
2024-12-10 17:21:38,114,5515,45,69,3478.09,6665.00,0.00
2024-12-10 17:21:38,115,5515,46,69,3447.84,6665.01,0.00
2024-12-10 17:21:38,114,5515,46,68,3475.76,6665.04,0.00
2024-12-10 17:21:38,114,5516,46,68,3470.42,6666.00,0.00
2024-12-10 17:21:38,115,5516,47,68,3440.24,6666.01,0.00
2024-12-10 17:21:38,114,5516,47,67,3468.10,6666.04,0.00
2024-12-10 17:21:38,114,5517,47,67,3462.75,6667.00,0.00
2024-12-10 17:21:38,115,5517,48,67,3432.64,6667.01,0.00
2024-12-10 17:21:38,114,5517,48,66,3460.43,6667.04,0.00
2024-12-10 17:21:38,114,5518,48,66,3455.08,6668.00,0.00
2024-12-10 17:21:38,115,5518,49,66,3425.04,6668.01,0.00
2024-12-10 17:21:38,115,5519,49,66,3417.43,6669.00,0.00
2024-12-10 17:21:38,116,5519,49,67,3387.97,6669.01,0.00
2024-12-10 17:21:38,115,5519,48,67,3414.55,6669.04,0.00
2024-12-10 17:21:38,115,5520,48,67,3409.14,6670.00,0.00
2024-12-10 17:21:38,116,5520,48,68,3379.75,6670.01,0.00
2024-12-10 17:21:38,115,5520,47,68,3406.26,6670.04,0.00
2024-12-10 17:21:38,115,5521,47,68,3400.41,6671.00,0.00
2024-12-10 17:21:38,116,5521,48,68,3371.10,6671.01,0.00
2024-12-10 17:21:38,115,5521,48,67,3397.53,6671.04,0.00
2024-12-10 17:21:38,115,5522,48,67,3390.96,6672.00,0.00
2024-12-10 17:21:38,116,5522,49,67,3361.72,6672.01,0.00
2024-12-10 17:21:38,115,5522,49,66,3388.07,6672.04,0.00
2024-12-10 17:21:38,115,5523,49,66,3380.49,6673.00,0.00
2024-12-10 17:21:38,116,5523,49,67,3351.35,6673.01,0.00
2024-12-10 17:21:38,115,5523,49,66,3377.61,6673.04,0.00
2024-12-10 17:21:38,115,5524,49,66,3369.13,6674.00,0.00
2024-12-10 17:21:38,116,5524,50,66,3340.09,6674.01,0.00
2024-12-10 17:21:38,115,5524,50,65,3366.24,6674.04,0.00
2024-12-10 17:21:38,115,5525,50,65,3357.08,6675.00,0.00
2024-12-10 17:21:38,116,5525,51,65,3328.14,6675.01,0.00
2024-12-10 17:21:38,115,5525,51,64,3354.19,6675.04,0.00
2024-12-10 17:21:38,115,5526,51,64,3344.54,6676.00,0.00
2024-12-10 17:21:38,116,5526,51,65,3315.71,6676.01,0.00
2024-12-10 17:21:38,115,5526,50,65,3341.65,6676.04,0.00
2024-12-10 17:21:38,115,5527,50,65,3331.42,6677.00,0.00
2024-12-10 17:21:38,116,5527,51,65,3302.70,6677.01,0.00
2024-12-10 17:21:38,115,5527,50,65,3328.53,6677.04,0.00
2024-12-10 17:21:38,115,5528,50,65,3317.73,6678.00,0.00
2024-12-10 17:21:38,116,5528,50,66,3289.13,6678.01,0.00
2024-12-10 17:21:38,115,5528,49,66,3314.84,6678.04,0.00
2024-12-10 17:21:38,115,5529,49,66,3303.82,6679.00,0.00
2024-12-10 17:21:38,116,5529,49,67,3275.34,6679.01,0.00
2024-12-10 17:21:38,115,5529,48,67,3300.93,6679.04,0.00
2024-12-10 17:21:38,115,5530,48,67,3289.92,6680.00,0.00
2024-12-10 17:21:38,116,5530,48,68,3261.55,6680.01,0.00
2024-12-10 17:21:38,115,5530,47,68,3287.02,6680.04,0.00
2024-12-10 17:21:38,115,5531,47,68,3276.42,6681.00,0.00
2024-12-10 17:21:38,116,5531,47,69,3248.18,6681.01,0.00
2024-12-10 17:21:38,115,5531,46,69,3273.53,6681.04,0.00
2024-12-10 17:21:38,116,5530,47,69,3208.05,6681.62,0.00
2024-12-10 17:21:38,115,5530,46,69,3253.27,6681.69,0.00
2024-12-10 17:21:38,115,5531,46,69,3290.71,6682.00,0.00
2024-12-10 17:21:38,116,5531,47,69,3262.34,6682.01,0.00
2024-12-10 17:21:38,115,5531,47,68,3287.82,6682.04,0.00
2024-12-10 17:21:38,115,5532,47,68,3338.60,6683.00,0.00
2024-12-10 17:21:38,116,5532,47,69,3309.82,6683.01,0.00
2024-12-10 17:21:38,117,5531,48,69,3281.53,6683.03,0.00
2024-12-10 17:21:38,116,5531,47,69,3325.39,6683.05,0.00
2024-12-10 17:21:38,116,5532,47,69,3317.08,6684.00,0.00
2024-12-10 17:21:38,117,5532,47,70,3288.72,6684.01,0.00
2024-12-10 17:21:38,116,5532,46,70,3314.21,6684.04,0.00
2024-12-10 17:21:38,115,5532,46,69,3342.45,6684.04,0.00
2024-12-10 17:21:38,115,5533,46,69,3390.37,6685.00,0.00
2024-12-10 17:21:38,116,5533,47,69,3361.15,6685.01,0.00
2024-12-10 17:21:38,115,5533,47,68,3387.48,6685.04,0.00
2024-12-10 17:21:38,116,5532,47,69,3321.57,6685.61,0.00
2024-12-10 17:21:38,116,5533,47,69,3386.11,6686.00,0.00
2024-12-10 17:21:38,117,5533,48,69,3357.17,6686.01,0.00
2024-12-10 17:21:38,116,5533,47,69,3383.24,6686.04,0.00
2024-12-10 17:21:38,116,5534,47,69,3419.37,6687.00,0.00
2024-12-10 17:21:38,117,5534,47,70,3390.14,6687.01,0.00
2024-12-10 17:21:38,116,5534,47,69,3416.50,6687.04,0.00
2024-12-10 17:21:38,116,5535,47,69,3394.54,6688.00,0.00
2024-12-10 17:21:38,117,5535,47,70,3365.53,6688.01,0.00
2024-12-10 17:21:38,116,5535,46,70,3393.39,6688.02,0.00
2024-12-10 17:21:38,115,5535,46,69,3420.59,6688.04,0.00
2024-12-10 17:21:39,115,5536,46,69,3399.44,6689.00,0.00
2024-12-10 17:21:39,116,5536,46,70,3370.14,6689.01,0.00
2024-12-10 17:21:39,115,5536,45,70,3396.55,6689.04,0.00
2024-12-10 17:21:39,115,5537,45,70,3374.20,6690.00,0.00
2024-12-10 17:21:39,116,5537,46,70,3345.11,6690.01,0.00
2024-12-10 17:21:39,115,5537,45,70,3371.31,6690.04,0.00
2024-12-10 17:21:39,114,5537,45,69,3364.95,6690.55,0.00
2024-12-10 17:21:39,114,5538,45,69,3389.68,6691.00,0.00
2024-12-10 17:21:39,115,5538,46,69,3360.21,6691.01,0.00
2024-12-10 17:21:39,114,5538,46,68,3386.76,6691.04,0.00
2024-12-10 17:21:39,114,5539,46,68,3375.53,6692.00,0.00
2024-12-10 17:21:39,115,5539,47,68,3346.18,6692.01,0.00
2024-12-10 17:21:39,114,5539,46,68,3372.61,6692.04,0.00
2024-12-10 17:21:39,114,5540,46,68,3358.93,6693.00,0.00
2024-12-10 17:21:39,115,5540,47,68,3329.72,6693.01,0.00
2024-12-10 17:21:39,114,5540,46,68,3356.01,6693.04,0.00
2024-12-10 17:21:39,114,5541,46,68,3340.20,6694.00,0.00
2024-12-10 17:21:39,115,5541,46,69,3311.15,6694.01,0.00
2024-12-10 17:21:39,114,5541,46,68,3337.28,6694.04,0.00
2024-12-10 17:21:39,113,5541,46,67,3302.64,6694.93,0.00
2024-12-10 17:21:39,114,5540,46,68,3273.09,6694.95,0.00
2024-12-10 17:21:39,114,5541,46,68,3331.86,6695.00,0.00
2024-12-10 17:21:39,115,5541,47,68,3302.89,6695.01,0.00
2024-12-10 17:21:39,114,5541,46,68,3328.94,6695.04,0.00
2024-12-10 17:21:39,114,5542,46,68,3382.88,6696.00,0.00
2024-12-10 17:21:39,115,5542,47,68,3353.46,6696.01,0.00
2024-12-10 17:21:39,114,5542,47,67,3381.12,6696.03,0.00
2024-12-10 17:21:39,113,5542,46,67,3409.87,6696.04,0.00
2024-12-10 17:21:39,112,5542,46,66,3439.71,6696.04,0.00
2024-12-10 17:21:39,112,5543,46,66,3435.43,6697.00,0.00
2024-12-10 17:21:39,113,5543,46,67,3405.02,6697.01,0.00
2024-12-10 17:21:39,112,5543,46,66,3433.05,6697.04,0.00
2024-12-10 17:21:39,112,5544,46,66,3428.76,6698.00,0.00
2024-12-10 17:21:39,113,5544,47,66,3398.42,6698.01,0.00
2024-12-10 17:21:39,112,5544,47,65,3426.39,6698.04,0.00
2024-12-10 17:21:39,112,5545,47,65,3422.10,6699.00,0.00
2024-12-10 17:21:39,113,5545,48,65,3391.81,6699.01,0.00
2024-12-10 17:21:39,113,5546,48,65,3385.21,6700.00,0.00
2024-12-10 17:21:39,114,5546,48,66,3355.51,6700.01,0.00
2024-12-10 17:21:39,113,5546,48,65,3382.26,6700.04,0.00
2024-12-10 17:21:39,113,5547,48,65,3378.00,6701.00,0.00
2024-12-10 17:21:39,114,5547,48,66,3348.37,6701.01,0.00
2024-12-10 17:21:39,114,5548,48,66,3341.23,6702.00,0.00
2024-12-10 17:21:39,115,5548,48,67,3312.17,6702.01,0.00
2024-12-10 17:21:39,114,5548,48,66,3338.30,6702.04,0.00
2024-12-10 17:21:39,114,5549,48,66,3333.49,6703.00,0.00
2024-12-10 17:21:39,115,5549,48,67,3304.51,6703.01,0.00
2024-12-10 17:21:39,116,5548,49,67,3249.52,6703.42,0.00
2024-12-10 17:21:39,116,5549,49,67,3280.99,6704.00,0.00
2024-12-10 17:21:39,117,5549,49,68,3252.95,6704.01,0.00
2024-12-10 17:21:39,116,5549,49,67,3277.54,6704.05,0.00
2024-12-10 17:21:39,116,5550,49,67,3329.39,6705.00,0.00
2024-12-10 17:21:39,117,5550,49,68,3300.94,6705.01,0.00
2024-12-10 17:21:39,116,5550,49,67,3325.94,6705.05,0.00
2024-12-10 17:21:39,116,5551,49,67,3319.53,6706.00,0.00
2024-12-10 17:21:39,117,5551,50,67,3291.16,6706.01,0.00
2024-12-10 17:21:39,116,5551,50,66,3316.65,6706.04,0.00
2024-12-10 17:21:39,115,5551,50,65,3344.33,6706.05,0.00
2024-12-10 17:21:39,115,5551,50,65,3337.83,6707.00,0.00
2024-12-10 17:21:39,116,5551,50,66,3309.05,6707.01,0.00
2024-12-10 17:21:39,115,5551,50,65,3334.34,6707.05,0.00
2024-12-10 17:21:39,115,5552,50,65,3327.24,6708.00,0.00
2024-12-10 17:21:39,116,5552,50,66,3298.56,6708.01,0.00
2024-12-10 17:21:39,115,5552,50,65,3323.75,6708.05,0.00
2024-12-10 17:21:39,115,5553,50,65,3316.04,6709.00,0.00
2024-12-10 17:21:39,116,5553,51,65,3287.46,6709.01,0.00
2024-12-10 17:21:39,115,5553,51,64,3312.56,6709.05,0.00
2024-12-10 17:21:39,115,5554,51,64,3304.21,6710.00,0.00
2024-12-10 17:21:39,116,5554,52,64,3275.72,6710.01,0.00
2024-12-10 17:21:39,115,5554,52,63,3300.72,6710.05,0.00
2024-12-10 17:21:39,115,5555,52,63,3291.68,6711.00,0.00
2024-12-10 17:21:39,116,5555,52,64,3263.30,6711.01,0.00
2024-12-10 17:21:39,115,5555,51,64,3289.36,6711.04,0.00
2024-12-10 17:21:39,114,5555,50,64,3317.04,6711.04,0.00
2024-12-10 17:21:39,113,5555,50,63,3345.80,6711.04,0.00
2024-12-10 17:21:39,112,5555,50,62,3375.44,6711.04,0.00
2024-12-10 17:21:39,112,5556,50,62,3366.65,6712.00,0.00
2024-12-10 17:21:39,113,5556,51,62,3336.86,6712.01,0.00
2024-12-10 17:21:39,112,5556,51,61,3364.27,6712.04,0.00
2024-12-10 17:21:39,111,5556,51,60,3393.97,6712.04,0.00
2024-12-10 17:21:39,111,5557,51,60,3384.64,6713.00,0.00
2024-12-10 17:21:39,112,5557,51,61,3354.42,6713.01,0.00
2024-12-10 17:21:39,111,5557,50,61,3382.23,6713.04,0.00
2024-12-10 17:21:39,110,5557,49,61,3378.00,6713.52,0.00
2024-12-10 17:21:39,110,5558,49,61,3407.05,6714.00,0.00
2024-12-10 17:21:39,111,5558,50,61,3376.35,6714.01,0.00
2024-12-10 17:21:39,111,5559,50,61,3370.81,6715.00,0.00
2024-12-10 17:21:39,112,5559,50,62,3340.71,6715.01,0.00
2024-12-10 17:21:39,112,5560,50,62,3334.61,6716.00,0.00
2024-12-10 17:21:39,113,5560,50,63,3305.10,6716.01,0.00
2024-12-10 17:21:39,112,5560,50,62,3331.03,6716.05,0.00
2024-12-10 17:21:40,112,5561,50,62,3327.91,6717.00,0.00
2024-12-10 17:21:40,113,5561,50,63,3298.46,6717.01,0.00
2024-12-10 17:21:40,112,5561,49,63,3324.33,6717.05,0.00
2024-12-10 17:21:40,112,5562,49,63,3321.21,6718.00,0.00
2024-12-10 17:21:40,113,5562,49,64,3291.82,6718.01,0.00
2024-12-10 17:21:40,112,5562,48,64,3317.63,6718.05,0.00
2024-12-10 17:21:40,113,5561,48,65,3236.28,6718.85,0.00
2024-12-10 17:21:40,113,5562,48,65,3295.28,6719.00,0.00
2024-12-10 17:21:40,114,5562,48,66,3266.38,6719.01,0.00
2024-12-10 17:21:40,113,5562,47,66,3291.73,6719.05,0.00
2024-12-10 17:21:40,113,5563,47,66,3347.51,6720.00,0.00
2024-12-10 17:21:40,114,5563,47,67,3318.15,6720.01,0.00
2024-12-10 17:21:40,113,5563,47,66,3343.96,6720.05,0.00
2024-12-10 17:21:40,113,5564,47,66,3340.28,6721.00,0.00
2024-12-10 17:21:40,114,5564,48,66,3310.98,6721.01,0.00
2024-12-10 17:21:40,115,5563,48,67,3281.61,6721.04,0.00
2024-12-10 17:21:40,114,5563,48,66,3355.80,6721.06,0.00
2024-12-10 17:21:40,114,5564,48,66,3352.15,6722.00,0.00
2024-12-10 17:21:40,115,5564,48,67,3323.00,6722.01,0.00
2024-12-10 17:21:40,114,5564,47,67,3348.64,6722.05,0.00
2024-12-10 17:21:40,114,5565,47,67,3403.37,6723.00,0.00
2024-12-10 17:21:40,115,5565,47,68,3373.77,6723.01,0.00
2024-12-10 17:21:40,114,5565,46,68,3399.85,6723.05,0.00
2024-12-10 17:21:40,114,5566,46,68,3395.62,6724.00,0.00
2024-12-10 17:21:40,115,5566,47,68,3366.09,6724.01,0.00
2024-12-10 17:21:40,114,5566,47,67,3392.10,6724.05,0.00
2024-12-10 17:21:40,113,5566,46,67,3421.52,6724.05,0.00
2024-12-10 17:21:40,113,5567,46,67,3417.85,6725.00,0.00
2024-12-10 17:21:40,114,5567,46,68,3387.87,6725.01,0.00
2024-12-10 17:21:40,113,5567,45,68,3414.30,6725.05,0.00
2024-12-10 17:21:40,114,5566,45,69,3375.51,6725.20,0.00
2024-12-10 17:21:40,114,5567,45,69,3393.68,6726.00,0.00
2024-12-10 17:21:40,115,5567,45,70,3364.17,6726.01,0.00
2024-12-10 17:21:40,114,5567,45,69,3390.16,6726.05,0.00
2024-12-10 17:21:40,114,5568,45,69,3444.93,6727.00,0.00
2024-12-10 17:21:40,115,5568,46,69,3414.97,6727.01,0.00
2024-12-10 17:21:40,114,5568,46,68,3441.41,6727.05,0.00
2024-12-10 17:21:40,114,5569,46,68,3437.18,6728.00,0.00
2024-12-10 17:21:40,115,5569,47,68,3407.29,6728.01,0.00
2024-12-10 17:21:40,114,5569,46,68,3433.66,6728.05,0.00
2024-12-10 17:21:40,114,5570,46,68,3429.43,6729.00,0.00
2024-12-10 17:21:40,115,5570,47,68,3399.61,6729.01,0.00
2024-12-10 17:21:40,114,5570,46,68,3426.49,6729.04,0.00
2024-12-10 17:21:40,113,5570,46,67,3456.22,6729.04,0.00
2024-12-10 17:21:40,112,5570,45,67,3486.48,6729.04,0.00
2024-12-10 17:21:40,112,5571,45,67,3482.77,6730.00,0.00
2024-12-10 17:21:40,113,5571,46,67,3451.95,6730.01,0.00
2024-12-10 17:21:40,112,5571,46,66,3479.79,6730.04,0.00
2024-12-10 17:21:40,112,5572,46,66,3476.08,6731.00,0.00
2024-12-10 17:21:40,113,5572,47,66,3445.32,6731.01,0.00
2024-12-10 17:21:40,112,5572,47,65,3473.09,6731.04,0.00
2024-12-10 17:21:40,113,5571,47,66,3423.35,6731.35,0.00
2024-12-10 17:21:40,113,5572,47,66,3479.79,6732.00,0.00
2024-12-10 17:21:40,114,5572,48,66,3449.26,6732.01,0.00
2024-12-10 17:21:40,113,5572,48,65,3476.83,6732.04,0.00
2024-12-10 17:21:40,113,5573,48,65,3532.14,6733.00,0.00
2024-12-10 17:21:40,114,5573,48,66,3501.16,6733.01,0.00
2024-12-10 17:21:40,113,5573,48,65,3529.18,6733.04,0.00
2024-12-10 17:21:40,113,5574,48,65,3524.92,6734.00,0.00
2024-12-10 17:21:40,114,5574,49,65,3494.00,6734.01,0.00
2024-12-10 17:21:40,113,5574,49,64,3521.96,6734.04,0.00
2024-12-10 17:21:40,113,5575,49,64,3517.69,6735.00,0.00
2024-12-10 17:21:40,114,5575,50,64,3486.84,6735.01,0.00
2024-12-10 17:21:40,113,5575,50,63,3514.73,6735.04,0.00
2024-12-10 17:21:40,113,5576,50,63,3510.47,6736.00,0.00
2024-12-10 17:21:40,114,5576,50,64,3479.67,6736.01,0.00
2024-12-10 17:21:40,113,5576,50,63,3507.50,6736.04,0.00
2024-12-10 17:21:40,113,5577,50,63,3503.24,6737.00,0.00
2024-12-10 17:21:40,114,5577,51,63,3472.51,6737.01,0.00
2024-12-10 17:21:40,113,5577,50,63,3500.27,6737.04,0.00
2024-12-10 17:21:40,114,5576,50,64,3461.31,6737.18,0.00
2024-12-10 17:21:40,114,5577,50,64,3516.17,6738.00,0.00
2024-12-10 17:21:40,115,5577,50,65,3485.59,6738.01,0.00
2024-12-10 17:21:40,114,5577,50,64,3513.23,6738.04,0.00
2024-12-10 17:21:40,114,5578,50,64,3567.53,6739.00,0.00
2024-12-10 17:21:40,115,5578,50,65,3536.51,6739.01,0.00
2024-12-10 17:21:40,116,5577,50,66,3504.87,6739.04,0.00
2024-12-10 17:21:40,115,5577,50,65,3585.75,6739.05,0.00
2024-12-10 17:21:40,115,5578,50,65,3580.99,6740.00,0.00
2024-12-10 17:21:40,116,5578,50,66,3550.12,6740.01,0.00
2024-12-10 17:21:40,115,5578,50,65,3577.50,6740.05,0.00
2024-12-10 17:21:40,115,5579,50,65,3631.35,6741.00,0.00
2024-12-10 17:21:40,116,5579,51,65,3600.04,6741.01,0.00
2024-12-10 17:21:40,115,5579,51,64,3627.86,6741.05,0.00
2024-12-10 17:21:40,115,5580,51,64,3623.09,6742.00,0.00
2024-12-10 17:21:40,116,5580,52,64,3591.86,6742.01,0.00
2024-12-10 17:21:40,115,5580,51,64,3619.60,6742.05,0.00
2024-12-10 17:21:40,115,5581,51,64,3614.83,6743.00,0.00
2024-12-10 17:21:40,116,5581,51,65,3583.67,6743.01,0.00
2024-12-10 17:21:40,116,5582,51,65,3575.48,6744.00,0.00
2024-12-10 17:21:40,117,5582,52,65,3544.92,6744.01,0.00
2024-12-10 17:21:40,116,5582,51,65,3572.02,6744.05,0.00
2024-12-10 17:21:40,116,5583,51,65,3566.71,6745.00,0.00
2024-12-10 17:21:40,117,5583,51,66,3536.22,6745.01,0.00
2024-12-10 17:21:40,116,5583,50,66,3563.24,6745.05,0.00
2024-12-10 17:21:40,116,5584,50,66,3557.93,6746.00,0.00
2024-12-10 17:21:41,117,5584,50,67,3527.52,6746.01,0.00
2024-12-10 17:21:41,116,5584,50,66,3554.47,6746.05,0.00
2024-12-10 17:21:41,117,5583,50,67,3470.83,6746.86,0.00
2024-12-10 17:21:41,117,5584,50,67,3527.47,6747.00,0.00
2024-12-10 17:21:41,118,5584,50,68,3497.57,6747.01,0.00
2024-12-10 17:21:41,118,5585,50,68,3545.56,6748.00,0.00
2024-12-10 17:21:41,119,5585,50,69,3515.76,6748.01,0.00
2024-12-10 17:21:41,118,5585,49,69,3542.15,6748.05,0.00
2024-12-10 17:21:41,118,5586,49,69,3535.79,6749.00,0.00
2024-12-10 17:21:41,119,5586,49,70,3506.08,6749.01,0.00
2024-12-10 17:21:41,118,5586,48,70,3532.38,6749.05,0.00
2024-12-10 17:21:41,118,5587,48,70,3525.57,6750.00,0.00
2024-12-10 17:21:41,119,5587,48,71,3495.95,6750.01,0.00
2024-12-10 17:21:41,118,5587,48,70,3522.17,6750.05,0.00
2024-12-10 17:21:41,117,5587,48,69,3551.69,6750.05,0.00
2024-12-10 17:21:41,117,5588,48,69,3544.44,6751.00,0.00
2024-12-10 17:21:41,118,5588,49,69,3514.40,6751.01,0.00
2024-12-10 17:21:41,117,5588,49,68,3541.00,6751.05,0.00
2024-12-10 17:21:41,118,5587,49,69,3458.67,6751.81,0.00
2024-12-10 17:21:41,118,5588,49,69,3505.76,6752.00,0.00
2024-12-10 17:21:41,119,5588,49,70,3476.30,6752.01,0.00
2024-12-10 17:21:41,118,5588,48,70,3501.78,6752.06,0.00
2024-12-10 17:21:41,119,5587,49,70,3430.23,6752.66,0.00
2024-12-10 17:21:41,119,5588,49,70,3539.46,6753.00,0.00
2024-12-10 17:21:41,120,5588,50,70,3509.97,6753.01,0.00
2024-12-10 17:21:41,119,5588,50,69,3535.52,6753.06,0.00
2024-12-10 17:21:41,119,5589,50,69,3581.97,6754.00,0.00
2024-12-10 17:21:41,120,5589,50,70,3552.12,6754.01,0.00
2024-12-10 17:21:41,119,5589,50,69,3578.02,6754.06,0.00
2024-12-10 17:21:41,119,5590,50,69,3566.50,6755.00,0.00
2024-12-10 17:21:41,120,5590,50,70,3536.78,6755.01,0.00
2024-12-10 17:21:41,119,5590,49,70,3562.55,6755.06,0.00
2024-12-10 17:21:41,118,5590,49,69,3570.01,6755.35,0.00
2024-12-10 17:21:41,118,5591,49,69,3582.78,6756.00,0.00
2024-12-10 17:21:41,119,5591,49,70,3552.67,6756.01,0.00
2024-12-10 17:21:41,118,5591,49,69,3578.80,6756.06,0.00
2024-12-10 17:21:41,118,5592,49,69,3571.86,6757.00,0.00
2024-12-10 17:21:41,119,5592,49,70,3541.84,6757.01,0.00
2024-12-10 17:21:41,118,5592,48,70,3567.88,6757.06,0.00
2024-12-10 17:21:41,118,5593,48,70,3560.81,6758.00,0.00
2024-12-10 17:21:41,119,5593,48,71,3530.89,6758.01,0.00
2024-12-10 17:21:41,118,5593,48,70,3556.83,6758.06,0.00
2024-12-10 17:21:41,119,5592,49,70,3523.54,6758.13,0.00
2024-12-10 17:21:41,119,5593,49,70,3573.08,6759.00,0.00
2024-12-10 17:21:41,120,5593,49,71,3543.30,6759.01,0.00
2024-12-10 17:21:41,119,5593,49,70,3570.82,6759.03,0.00
2024-12-10 17:21:41,118,5593,49,69,3599.38,6759.05,0.00
2024-12-10 17:21:41,117,5593,49,68,3629.56,6759.05,0.00
2024-12-10 17:21:41,117,5594,49,68,3681.31,6760.00,0.00
2024-12-10 17:21:41,118,5594,50,68,3650.12,6760.01,0.00
2024-12-10 17:21:41,117,5594,49,68,3677.87,6760.05,0.00
2024-12-10 17:21:41,117,5595,49,68,3671.43,6761.00,0.00
2024-12-10 17:21:41,118,5595,49,69,3640.31,6761.01,0.00
2024-12-10 17:21:41,117,5595,49,68,3667.98,6761.05,0.00
2024-12-10 17:21:41,118,5594,49,69,3610.08,6761.47,0.00
2024-12-10 17:21:41,118,5595,49,69,3661.36,6762.00,0.00
2024-12-10 17:21:41,119,5595,49,70,3630.59,6762.01,0.00
2024-12-10 17:21:41,119,5596,49,70,3674.64,6763.00,0.00
2024-12-10 17:21:41,120,5596,50,70,3644.02,6763.01,0.00
2024-12-10 17:21:41,120,5597,50,70,3630.20,6764.00,0.00
2024-12-10 17:21:41,121,5597,50,71,3600.20,6764.01,0.00
2024-12-10 17:21:41,120,5597,50,70,3626.29,6764.06,0.00
2024-12-10 17:21:41,120,5598,50,70,3615.08,6765.00,0.00
2024-12-10 17:21:41,121,5598,50,71,3585.20,6765.01,0.00
2024-12-10 17:21:41,121,5599,50,71,3569.31,6766.00,0.00
2024-12-10 17:21:41,122,5599,51,71,3540.05,6766.01,0.00
2024-12-10 17:21:41,121,5599,50,71,3564.87,6766.07,0.00
2024-12-10 17:21:41,121,5600,50,71,3551.87,6767.00,0.00
2024-12-10 17:21:41,122,5600,51,71,3522.76,6767.01,0.00
2024-12-10 17:21:41,121,5600,50,71,3547.43,6767.07,0.00
2024-12-10 17:21:41,121,5601,50,71,3532.41,6768.00,0.00
2024-12-10 17:21:41,122,5601,51,71,3503.45,6768.01,0.00
2024-12-10 17:21:41,121,5601,50,71,3527.97,6768.07,0.00
2024-12-10 17:21:41,121,5602,50,71,3508.39,6769.00,0.00
2024-12-10 17:21:41,122,5602,51,71,3479.64,6769.01,0.00
2024-12-10 17:21:41,121,5602,51,70,3503.95,6769.07,0.00
2024-12-10 17:21:41,121,5603,51,70,3481.84,6770.00,0.00
2024-12-10 17:21:41,122,5603,52,70,3453.30,6770.01,0.00
2024-12-10 17:21:41,121,5603,52,69,3477.40,6770.07,0.00
2024-12-10 17:21:41,120,5603,52,68,3474.39,6770.39,0.00
2024-12-10 17:21:41,120,5604,52,68,3483.19,6771.00,0.00
2024-12-10 17:21:41,121,5604,53,68,3454.41,6771.01,0.00
2024-12-10 17:21:41,120,5604,52,68,3478.71,6771.07,0.00
2024-12-10 17:21:41,121,5603,52,69,3422.64,6771.49,0.00
2024-12-10 17:21:41,121,5604,52,69,3467.59,6772.00,0.00
2024-12-10 17:21:41,122,5604,52,70,3439.17,6772.01,0.00
2024-12-10 17:21:41,121,5604,51,70,3463.15,6772.07,0.00
2024-12-10 17:21:41,121,5605,51,70,3508.16,6773.00,0.00
2024-12-10 17:21:41,122,5605,52,70,3479.41,6773.01,0.00
2024-12-10 17:21:41,121,5605,52,69,3503.72,6773.07,0.00
2024-12-10 17:21:41,121,5606,52,69,3492.92,6774.00,0.00
2024-12-10 17:21:41,122,5606,53,69,3464.29,6774.01,0.00
2024-12-10 17:21:41,121,5606,52,69,3488.47,6774.07,0.00
2024-12-10 17:21:42,121,5607,52,69,3477.70,6775.00,0.00
2024-12-10 17:21:42,122,5607,52,70,3449.20,6775.01,0.00
2024-12-10 17:21:42,121,5607,51,70,3473.25,6775.07,0.00
2024-12-10 17:21:42,121,5608,51,70,3461.96,6776.00,0.00
2024-12-10 17:21:42,122,5608,52,70,3433.59,6776.01,0.00
2024-12-10 17:21:42,121,5608,52,69,3457.51,6776.07,0.00
2024-12-10 17:21:42,120,5608,51,69,3448.39,6776.58,0.00
2024-12-10 17:21:42,120,5609,51,69,3474.89,6777.00,0.00
2024-12-10 17:21:42,121,5609,52,69,3446.17,6777.01,0.00
2024-12-10 17:21:42,120,5609,51,69,3470.40,6777.07,0.00
2024-12-10 17:21:42,121,5608,51,70,3388.40,6777.83,0.00
2024-12-10 17:21:42,121,5609,51,70,3443.45,6778.00,0.00
2024-12-10 17:21:42,122,5609,51,71,3415.22,6778.01,0.00
2024-12-10 17:21:42,121,5609,51,70,3439.00,6778.07,0.00
2024-12-10 17:21:42,121,5610,51,70,3484.09,6779.00,0.00
2024-12-10 17:21:42,122,5610,51,71,3455.53,6779.01,0.00
2024-12-10 17:21:42,121,5610,51,70,3479.63,6779.07,0.00
2024-12-10 17:21:42,121,5611,51,70,3466.94,6780.00,0.00
2024-12-10 17:21:42,122,5611,52,70,3438.52,6780.01,0.00
2024-12-10 17:21:42,121,5611,52,69,3462.49,6780.07,0.00
2024-12-10 17:21:42,121,5612,52,69,3447.85,6781.00,0.00
2024-12-10 17:21:42,122,5612,52,70,3419.59,6781.01,0.00
2024-12-10 17:21:42,121,5612,52,69,3443.39,6781.07,0.00
2024-12-10 17:21:42,120,5612,51,69,3471.52,6781.07,0.00
2024-12-10 17:21:42,119,5612,51,68,3454.32,6781.69,0.00
2024-12-10 17:21:42,119,5613,51,68,3490.48,6782.00,0.00
2024-12-10 17:21:42,120,5613,51,69,3461.39,6782.01,0.00
2024-12-10 17:21:42,119,5613,50,69,3485.95,6782.07,0.00
2024-12-10 17:21:42,119,5614,50,69,3480.16,6783.00,0.00
2024-12-10 17:21:42,120,5614,51,69,3451.16,6783.01,0.00
2024-12-10 17:21:42,119,5614,50,69,3479.59,6783.01,0.00
2024-12-10 17:21:42,118,5614,50,68,3505.09,6783.06,0.00
2024-12-10 17:21:42,117,5614,49,68,3534.46,6783.06,0.00
2024-12-10 17:21:42,117,5615,49,68,3529.16,6784.00,0.00
2024-12-10 17:21:42,118,5615,49,69,3499.25,6784.01,0.00
2024-12-10 17:21:42,117,5615,49,68,3525.13,6784.06,0.00
2024-12-10 17:21:42,117,5616,49,68,3519.82,6785.00,0.00
2024-12-10 17:21:42,118,5616,49,69,3489.99,6785.01,0.00
2024-12-10 17:21:42,117,5616,48,69,3515.79,6785.06,0.00
2024-12-10 17:21:42,117,5617,48,69,3510.48,6786.00,0.00
2024-12-10 17:21:42,118,5617,49,69,3480.73,6786.01,0.00
2024-12-10 17:21:42,117,5617,48,69,3506.45,6786.06,0.00
2024-12-10 17:21:42,117,5618,48,69,3501.14,6787.00,0.00
2024-12-10 17:21:42,118,5618,49,69,3471.47,6787.01,0.00
2024-12-10 17:21:42,118,5619,49,69,3462.20,6788.00,0.00
2024-12-10 17:21:42,119,5619,49,70,3433.10,6788.01,0.00
2024-12-10 17:21:42,119,5620,49,70,3423.34,6789.00,0.00
2024-12-10 17:21:42,120,5620,50,70,3394.81,6789.01,0.00
2024-12-10 17:21:42,119,5620,50,69,3418.80,6789.07,0.00
2024-12-10 17:21:42,119,5621,50,69,3413.00,6790.00,0.00
2024-12-10 17:21:42,120,5621,51,69,3384.56,6790.01,0.00
2024-12-10 17:21:42,119,5621,50,69,3408.46,6790.07,0.00
2024-12-10 17:21:42,119,5622,50,69,3402.66,6791.00,0.00
2024-12-10 17:21:42,120,5622,51,69,3374.31,6791.01,0.00
2024-12-10 17:21:42,119,5622,50,69,3398.12,6791.07,0.00
2024-12-10 17:21:42,119,5623,50,69,3392.32,6792.00,0.00
2024-12-10 17:21:42,120,5623,50,70,3364.05,6792.01,0.00
2024-12-10 17:21:42,119,5623,49,70,3387.78,6792.07,0.00
2024-12-10 17:21:42,119,5624,49,70,3381.97,6793.00,0.00
2024-12-10 17:21:42,120,5624,50,70,3353.79,6793.01,0.00
2024-12-10 17:21:42,119,5624,49,70,3377.43,6793.07,0.00
2024-12-10 17:21:42,119,5625,49,70,3371.32,6794.00,0.00
2024-12-10 17:21:42,120,5625,49,71,3343.22,6794.01,0.00
2024-12-10 17:21:42,119,5625,49,70,3367.34,6794.06,0.00
2024-12-10 17:21:42,118,5625,49,69,3395.30,6794.06,0.00
2024-12-10 17:21:42,117,5625,49,68,3423.74,6794.06,0.00
2024-12-10 17:21:42,117,5626,49,68,3416.85,6795.00,0.00
2024-12-10 17:21:42,118,5626,49,69,3387.89,6795.01,0.00
2024-12-10 17:21:42,117,5626,48,69,3412.80,6795.06,0.00
2024-12-10 17:21:42,117,5627,48,69,3405.01,6796.00,0.00
2024-12-10 17:21:42,118,5627,48,70,3376.15,6796.01,0.00
2024-12-10 17:21:42,117,5627,47,70,3400.96,6796.06,0.00
2024-12-10 17:21:42,117,5628,47,70,3392.67,6797.00,0.00
2024-12-10 17:21:42,118,5628,48,70,3363.92,6797.01,0.00
2024-12-10 17:21:42,117,5628,48,69,3388.62,6797.06,0.00
2024-12-10 17:21:42,117,5629,48,69,3380.19,6798.00,0.00
2024-12-10 17:21:42,118,5629,49,69,3351.54,6798.01,0.00
2024-12-10 17:21:42,117,5629,48,69,3376.14,6798.06,0.00
2024-12-10 17:21:42,117,5630,48,69,3368.08,6799.00,0.00
2024-12-10 17:21:42,118,5630,48,70,3339.54,6799.01,0.00
2024-12-10 17:21:42,117,5630,47,70,3364.03,6799.06,0.00
2024-12-10 17:21:42,117,5631,47,70,3356.65,6800.00,0.00
2024-12-10 17:21:42,118,5631,48,70,3328.21,6800.01,0.00
2024-12-10 17:21:42,117,5631,48,69,3352.60,6800.06,0.00
2024-12-10 17:21:42,117,5632,48,69,3346.27,6801.00,0.00
2024-12-10 17:21:42,118,5632,48,70,3317.91,6801.01,0.00
2024-12-10 17:21:42,119,5631,48,71,3279.76,6801.18,0.00
2024-12-10 17:21:42,119,5632,48,71,3331.10,6802.00,0.00
2024-12-10 17:21:42,120,5632,49,71,3303.34,6802.01,0.00
2024-12-10 17:21:42,119,5632,49,70,3326.54,6802.07,0.00
2024-12-10 17:21:42,119,5633,49,70,3377.89,6803.00,0.00
2024-12-10 17:21:42,120,5633,49,71,3349.74,6803.01,0.00
2024-12-10 17:21:42,119,5633,49,70,3373.34,6803.07,0.00
2024-12-10 17:21:43,118,5633,48,70,3401.35,6803.07,0.00
2024-12-10 17:21:43,118,5634,48,70,3396.06,6804.00,0.00
2024-12-10 17:21:43,119,5634,49,70,3367.52,6804.01,0.00
2024-12-10 17:21:43,118,5634,49,69,3391.47,6804.07,0.00
2024-12-10 17:21:43,118,5635,49,69,3386.18,6805.00,0.00
2024-12-10 17:21:43,119,5635,50,69,3357.73,6805.01,0.00
2024-12-10 17:21:43,118,5635,50,68,3381.58,6805.07,0.00
2024-12-10 17:21:43,118,5636,50,68,3376.30,6806.00,0.00
2024-12-10 17:21:43,119,5636,50,69,3347.92,6806.01,0.00
2024-12-10 17:21:43,118,5636,49,69,3371.70,6806.07,0.00
2024-12-10 17:21:43,118,5637,49,69,3366.37,6807.00,0.00
2024-12-10 17:21:43,119,5637,50,69,3338.08,6807.01,0.00
2024-12-10 17:21:43,119,5638,50,69,3327.50,6808.00,0.00
2024-12-10 17:21:43,120,5638,50,70,3299.77,6808.01,0.00
2024-12-10 17:21:43,119,5638,50,69,3322.94,6808.07,0.00
2024-12-10 17:21:43,119,5639,50,69,3315.60,6809.00,0.00
2024-12-10 17:21:43,120,5639,50,70,3287.97,6809.01,0.00
2024-12-10 17:21:43,119,5639,49,70,3311.04,6809.07,0.00
2024-12-10 17:21:43,119,5640,49,70,3303.04,6810.00,0.00
2024-12-10 17:21:43,120,5640,50,70,3275.52,6810.01,0.00
2024-12-10 17:21:43,119,5640,49,70,3298.48,6810.07,0.00
2024-12-10 17:21:43,119,5641,49,70,3290.33,6811.00,0.00
2024-12-10 17:21:43,120,5641,50,70,3262.91,6811.01,0.00
2024-12-10 17:21:43,119,5641,50,69,3285.77,6811.07,0.00
2024-12-10 17:21:43,120,5640,51,69,3198.93,6811.93,0.00
2024-12-10 17:21:43,120,5641,51,69,3255.77,6812.00,0.00
2024-12-10 17:21:43,121,5641,51,70,3228.86,6812.01,0.00
2024-12-10 17:21:43,120,5641,50,70,3251.24,6812.07,0.00
2024-12-10 17:21:43,120,5642,50,70,3298.98,6813.00,0.00
2024-12-10 17:21:43,121,5642,50,71,3271.71,6813.01,0.00
2024-12-10 17:21:43,121,5643,50,71,3258.09,6814.00,0.00
2024-12-10 17:21:43,122,5643,51,71,3231.38,6814.01,0.00
2024-12-10 17:21:43,121,5643,50,71,3253.04,6814.07,0.00
2024-12-10 17:21:43,121,5644,50,71,3243.64,6815.00,0.00
2024-12-10 17:21:43,122,5644,50,72,3217.05,6815.01,0.00
2024-12-10 17:21:43,121,5644,50,71,3238.59,6815.07,0.00
2024-12-10 17:21:43,120,5644,50,70,3244.98,6815.38,0.00
2024-12-10 17:21:43,120,5645,50,70,3259.58,6816.00,0.00
2024-12-10 17:21:43,121,5645,50,71,3232.64,6816.01,0.00
2024-12-10 17:21:43,120,5645,50,70,3254.49,6816.08,0.00
2024-12-10 17:21:43,120,5646,50,70,3247.83,6817.00,0.00
2024-12-10 17:21:43,121,5646,51,70,3220.99,6817.01,0.00
2024-12-10 17:21:43,120,5646,51,69,3242.73,6817.08,0.00
2024-12-10 17:21:43,119,5646,51,68,3264.55,6817.15,0.00
2024-12-10 17:21:43,119,5647,51,68,3262.68,6818.00,0.00
2024-12-10 17:21:43,120,5647,52,68,3235.49,6818.01,0.00
2024-12-10 17:21:43,119,5647,52,67,3258.67,6818.06,0.00
2024-12-10 17:21:43,119,5648,52,67,3249.64,6819.00,0.00
2024-12-10 17:21:43,120,5648,53,67,3222.56,6819.01,0.00
2024-12-10 17:21:43,119,5648,53,66,3243.94,6819.08,0.00
2024-12-10 17:21:43,119,5649,53,66,3235.86,6820.00,0.00
2024-12-10 17:21:43,120,5649,53,67,3208.90,6820.01,0.00
2024-12-10 17:21:43,119,5649,53,66,3230.15,6820.08,0.00
2024-12-10 17:21:43,119,5650,53,66,3221.29,6821.00,0.00
2024-12-10 17:21:43,120,5650,53,67,3194.45,6821.01,0.00
2024-12-10 17:21:43,119,5650,53,66,3220.72,6821.01,0.00
2024-12-10 17:21:43,118,5650,52,66,3242.83,6821.08,0.00
2024-12-10 17:21:43,117,5650,52,65,3269.97,6821.08,0.00
2024-12-10 17:21:43,117,5651,52,65,3260.83,6822.00,0.00
2024-12-10 17:21:43,118,5651,52,66,3233.19,6822.01,0.00
2024-12-10 17:21:43,117,5651,52,65,3255.60,6822.08,0.00
2024-12-10 17:21:43,117,5652,52,65,3245.82,6823.00,0.00
2024-12-10 17:21:43,118,5652,52,66,3218.31,6823.01,0.00
2024-12-10 17:21:43,117,5652,52,65,3240.59,6823.08,0.00
2024-12-10 17:21:43,117,5653,52,65,3230.33,6824.00,0.00
2024-12-10 17:21:43,118,5653,52,66,3202.96,6824.01,0.00
2024-12-10 17:21:43,117,5653,51,66,3225.10,6824.08,0.00
2024-12-10 17:21:43,118,5652,52,66,3140.81,6824.84,0.00
2024-12-10 17:21:43,118,5653,52,66,3198.21,6825.00,0.00
2024-12-10 17:21:43,119,5653,52,67,3171.34,6825.01,0.00
2024-12-10 17:21:43,118,5653,52,66,3197.06,6825.02,0.00
2024-12-10 17:21:43,117,5653,52,65,3220.32,6825.07,0.00
2024-12-10 17:21:43,117,5654,52,65,3266.29,6826.00,0.00
2024-12-10 17:21:43,118,5654,53,65,3238.61,6826.01,0.00
2024-12-10 17:21:43,117,5654,53,64,3261.65,6826.07,0.00
2024-12-10 17:21:43,116,5654,53,63,3234.24,6826.78,0.00
2024-12-10 17:21:43,116,5655,53,63,3271.29,6827.00,0.00
2024-12-10 17:21:43,117,5655,54,63,3243.33,6827.01,0.00
2024-12-10 17:21:43,116,5655,53,63,3266.60,6827.07,0.00
2024-12-10 17:21:43,116,5656,53,63,3246.58,6828.00,0.00
2024-12-10 17:21:43,117,5656,54,63,3218.83,6828.01,0.00
2024-12-10 17:21:43,116,5656,53,63,3241.89,6828.07,0.00
2024-12-10 17:21:43,116,5657,53,63,3215.45,6829.00,0.00
2024-12-10 17:21:43,117,5657,54,63,3187.97,6829.01,0.00
2024-12-10 17:21:43,116,5657,53,63,3210.76,6829.07,0.00
2024-12-10 17:21:43,116,5658,53,63,3180.97,6830.00,0.00
2024-12-10 17:21:43,117,5658,53,64,3153.78,6830.01,0.00
2024-12-10 17:21:43,116,5658,52,64,3176.28,6830.07,0.00
2024-12-10 17:21:43,115,5658,51,64,3144.54,6830.77,0.00
2024-12-10 17:21:43,115,5659,51,64,3175.45,6831.00,0.00
2024-12-10 17:21:43,116,5659,52,64,3148.07,6831.01,0.00
2024-12-10 17:21:43,115,5659,51,64,3173.66,6831.03,0.00
2024-12-10 17:21:43,114,5659,50,64,3198.52,6831.06,0.00
2024-12-10 17:21:44,114,5660,50,64,3181.27,6832.00,0.00
2024-12-10 17:21:44,115,5660,50,65,3153.61,6832.01,0.00
2024-12-10 17:21:44,116,5659,50,66,3074.28,6832.79,0.00
2024-12-10 17:21:44,117,5658,50,67,3059.70,6832.82,0.00
2024-12-10 17:21:44,116,5658,49,67,3088.46,6832.94,0.00
2024-12-10 17:21:44,116,5659,49,67,3143.30,6833.00,0.00
2024-12-10 17:21:44,117,5659,49,68,3116.43,6833.01,0.00
2024-12-10 17:21:44,116,5659,49,67,3138.60,6833.07,0.00
2024-12-10 17:21:44,116,5660,49,67,3252.16,6834.00,0.00
2024-12-10 17:21:44,117,5660,49,68,3224.36,6834.01,0.00
2024-12-10 17:21:44,116,5660,48,68,3247.46,6834.07,0.00
2024-12-10 17:21:44,116,5661,48,68,3243.21,6835.00,0.00
2024-12-10 17:21:44,117,5661,49,68,3215.49,6835.01,0.00
2024-12-10 17:21:44,116,5661,48,68,3238.51,6835.07,0.00
2024-12-10 17:21:44,116,5662,48,68,3234.25,6836.00,0.00
2024-12-10 17:21:44,117,5662,48,69,3206.61,6836.01,0.00
2024-12-10 17:21:44,116,5662,48,68,3229.55,6836.07,0.00
2024-12-10 17:21:44,116,5663,48,68,3223.89,6837.00,0.00
2024-12-10 17:21:44,117,5663,49,68,3196.33,6837.01,0.00
2024-12-10 17:21:44,116,5663,49,67,3222.71,6837.02,0.00
2024-12-10 17:21:44,115,5663,48,67,3247.18,6837.06,0.00
2024-12-10 17:21:44,114,5663,48,66,3275.06,6837.06,0.00
2024-12-10 17:21:44,114,5664,48,66,3267.81,6838.00,0.00
2024-12-10 17:21:44,115,5664,49,66,3239.39,6838.01,0.00
2024-12-10 17:21:44,114,5664,49,65,3263.62,6838.06,0.00
2024-12-10 17:21:44,114,5665,49,65,3256.07,6839.00,0.00
2024-12-10 17:21:44,115,5665,50,65,3227.76,6839.01,0.00
2024-12-10 17:21:44,114,5665,50,64,3255.47,6839.01,0.00
2024-12-10 17:21:44,113,5665,50,63,3280.66,6839.05,0.00
2024-12-10 17:21:44,112,5665,50,62,3309.34,6839.05,0.00
2024-12-10 17:21:44,112,5666,50,62,3302.38,6840.00,0.00
2024-12-10 17:21:44,113,5666,51,62,3273.16,6840.01,0.00
2024-12-10 17:21:44,112,5666,51,61,3298.73,6840.05,0.00
2024-12-10 17:21:44,113,5665,52,61,3218.67,6840.78,0.00
2024-12-10 17:21:44,113,5666,52,61,3277.35,6841.00,0.00
2024-12-10 17:21:44,114,5666,53,61,3248.60,6841.01,0.00
2024-12-10 17:21:44,113,5666,52,61,3273.73,6841.05,0.00
2024-12-10 17:21:44,113,5667,52,61,3326.78,6842.00,0.00
2024-12-10 17:21:44,114,5667,53,61,3297.60,6842.01,0.00
2024-12-10 17:21:44,113,5667,52,61,3323.16,6842.05,0.00
2024-12-10 17:21:44,113,5668,52,61,3314.87,6843.00,0.00
2024-12-10 17:21:44,114,5668,52,62,3285.79,6843.01,0.00
2024-12-10 17:21:44,113,5668,52,61,3311.25,6843.05,0.00
2024-12-10 17:21:44,113,5669,52,61,3302.07,6844.00,0.00
2024-12-10 17:21:44,114,5669,53,61,3273.10,6844.01,0.00
2024-12-10 17:21:44,115,5668,53,62,3242.27,6844.06,0.00
2024-12-10 17:21:44,114,5668,52,62,3325.35,6844.06,0.00
2024-12-10 17:21:44,115,5667,52,63,3286.33,6844.23,0.00
2024-12-10 17:21:44,115,5668,52,63,3336.94,6845.00,0.00
2024-12-10 17:21:44,116,5668,53,63,3308.17,6845.01,0.00
2024-12-10 17:21:44,115,5668,53,62,3333.38,6845.05,0.00
2024-12-10 17:21:44,116,5667,53,63,3268.80,6845.60,0.00
2024-12-10 17:21:44,116,5668,53,63,3436.85,6846.00,0.00
2024-12-10 17:21:44,117,5668,54,63,3407.48,6846.01,0.00
2024-12-10 17:21:44,116,5668,54,62,3433.33,6846.05,0.00
2024-12-10 17:21:44,116,5669,54,62,3479.64,6847.00,0.00
2024-12-10 17:21:44,117,5669,55,62,3449.90,6847.01,0.00
2024-12-10 17:21:44,116,5669,55,61,3476.11,6847.05,0.00
2024-12-10 17:21:44,116,5670,55,61,3462.53,6848.00,0.00
2024-12-10 17:21:44,117,5670,55,62,3432.93,6848.01,0.00
2024-12-10 17:21:44,116,5670,55,61,3459.00,6848.05,0.00
2024-12-10 17:21:44,116,5671,55,61,3444.13,6849.00,0.00
2024-12-10 17:21:44,117,5671,55,62,3414.70,6849.01,0.00
2024-12-10 17:21:44,116,5671,55,61,3432.33,6849.18,0.00
2024-12-10 17:21:44,116,5672,55,61,3423.95,6850.00,0.00
2024-12-10 17:21:44,117,5672,56,61,3394.68,6850.01,0.00
2024-12-10 17:21:44,116,5672,56,60,3420.42,6850.05,0.00
2024-12-10 17:21:44,117,5671,56,61,3332.93,6850.78,0.00
2024-12-10 17:21:44,117,5672,56,61,3426.53,6851.00,0.00
2024-12-10 17:21:44,118,5672,57,61,3397.49,6851.01,0.00
2024-12-10 17:21:44,117,5672,56,61,3423.03,6851.05,0.00
2024-12-10 17:21:44,116,5672,56,60,3451.95,6851.05,0.00
2024-12-10 17:21:44,115,5672,56,59,3451.67,6851.44,0.00
2024-12-10 17:21:44,115,5673,56,59,3510.19,6852.00,0.00
2024-12-10 17:21:44,116,5673,57,59,3479.93,6852.01,0.00
2024-12-10 17:21:44,115,5673,57,58,3508.41,6852.03,0.00
2024-12-10 17:21:44,114,5673,57,57,3537.39,6852.04,0.00
2024-12-10 17:21:44,113,5673,56,57,3568.09,6852.04,0.00
2024-12-10 17:21:44,112,5673,56,56,3582.16,6852.30,0.00
2024-12-10 17:21:44,112,5674,56,56,3571.01,6853.00,0.00
2024-12-10 17:21:44,113,5674,56,57,3539.41,6853.01,0.00
2024-12-10 17:21:44,112,5674,55,57,3567.97,6853.04,0.00
2024-12-10 17:21:44,112,5675,55,57,3538.94,6854.00,0.00
2024-12-10 17:21:44,113,5675,55,58,3507.63,6854.01,0.00
2024-12-10 17:21:44,112,5675,55,57,3535.90,6854.04,0.00
2024-12-10 17:21:44,111,5675,55,56,3523.52,6854.69,0.00
2024-12-10 17:21:44,111,5676,55,56,3546.83,6855.00,0.00
2024-12-10 17:21:44,112,5676,55,57,3515.16,6855.01,0.00
2024-12-10 17:21:44,111,5676,55,56,3543.76,6855.05,0.00
2024-12-10 17:21:44,111,5677,55,56,3522.02,6856.00,0.00
2024-12-10 17:21:44,112,5677,55,57,3490.57,6856.01,0.00
2024-12-10 17:21:44,111,5677,55,56,3518.94,6856.05,0.00
2024-12-10 17:21:44,111,5678,55,56,3495.02,6857.00,0.00
2024-12-10 17:21:44,112,5678,56,56,3463.81,6857.01,0.00
2024-12-10 17:21:44,111,5678,56,55,3491.94,6857.05,0.00
2024-12-10 17:21:44,111,5679,56,55,3467.03,6858.00,0.00
2024-12-10 17:21:44,112,5679,57,55,3436.07,6858.01,0.00
2024-12-10 17:21:44,111,5679,56,55,3466.41,6858.01,0.00
2024-12-10 17:21:44,110,5679,56,54,3495.44,6858.04,0.00
2024-12-10 17:21:44,109,5679,55,54,3468.98,6858.82,0.00
2024-12-10 17:21:44,109,5680,55,54,3501.97,6859.00,0.00
2024-12-10 17:21:44,110,5680,55,55,3470.13,6859.01,0.00
2024-12-10 17:21:44,109,5680,55,54,3498.84,6859.05,0.00
2024-12-10 17:21:45,109,5681,55,54,3479.57,6860.00,0.00
2024-12-10 17:21:45,110,5681,56,54,3447.94,6860.01,0.00
2024-12-10 17:21:45,110,5682,56,54,3426.13,6861.00,0.00
2024-12-10 17:21:45,111,5682,57,54,3395.26,6861.01,0.00
2024-12-10 17:21:45,110,5682,57,53,3422.41,6861.06,0.00
2024-12-10 17:21:45,110,5683,57,53,3405.23,6862.00,0.00
2024-12-10 17:21:45,111,5683,58,53,3374.55,6862.01,0.00
2024-12-10 17:21:45,112,5682,58,54,3343.20,6862.04,0.00
2024-12-10 17:21:45,111,5682,58,53,3381.99,6862.06,0.00
2024-12-10 17:21:45,111,5683,58,53,3365.90,6863.00,0.00
2024-12-10 17:21:45,112,5683,58,54,3335.85,6863.01,0.00
2024-12-10 17:21:45,111,5683,57,54,3362.21,6863.05,0.00
2024-12-10 17:21:45,112,5682,57,55,3315.68,6863.31,0.00
2024-12-10 17:21:45,113,5681,58,55,3314.87,6863.51,0.00
2024-12-10 17:21:45,113,5682,58,55,3423.98,6864.00,0.00
2024-12-10 17:21:45,114,5682,58,56,3393.94,6864.01,0.00
2024-12-10 17:21:45,113,5682,58,55,3420.35,6864.05,0.00
2024-12-10 17:21:45,114,5681,59,55,3386.74,6864.12,0.00
2024-12-10 17:21:45,113,5681,58,55,3417.22,6864.82,0.00
2024-12-10 17:21:45,113,5682,58,55,3586.76,6865.00,0.00
2024-12-10 17:21:45,114,5682,59,55,3555.30,6865.01,0.00
2024-12-10 17:21:45,113,5682,59,54,3583.13,6865.05,0.00
2024-12-10 17:21:45,112,5682,58,54,3563.25,6865.80,0.00
2024-12-10 17:21:45,112,5683,58,54,3669.60,6866.00,0.00
2024-12-10 17:21:45,113,5683,59,54,3637.12,6866.01,0.00
2024-12-10 17:21:45,112,5683,58,54,3665.94,6866.05,0.00
2024-12-10 17:21:45,113,5682,59,54,3630.47,6866.12,0.00
2024-12-10 17:21:45,113,5683,59,54,3682.74,6867.00,0.00
2024-12-10 17:21:45,114,5683,60,54,3650.44,6867.01,0.00
2024-12-10 17:21:45,113,5683,59,54,3679.12,6867.05,0.00
2024-12-10 17:21:45,114,5682,60,54,3601.95,6867.73,0.00
2024-12-10 17:21:45,113,5682,60,53,3647.48,6867.73,0.00
2024-12-10 17:21:45,113,5683,60,53,3746.42,6868.00,0.00
2024-12-10 17:21:45,114,5683,61,53,3713.56,6868.01,0.00
2024-12-10 17:21:45,113,5683,60,53,3742.80,6868.05,0.00
2024-12-10 17:21:45,113,5684,60,53,3794.84,6869.00,0.00
2024-12-10 17:21:45,114,5684,60,54,3761.55,6869.01,0.00
2024-12-10 17:21:45,113,5684,59,54,3791.21,6869.05,0.00
2024-12-10 17:21:45,112,5684,58,54,3810.88,6869.26,0.00
2024-12-10 17:21:45,112,5685,58,54,3816.59,6870.00,0.00
2024-12-10 17:21:45,113,5685,59,54,3782.81,6870.01,0.00
2024-12-10 17:21:45,112,5685,58,54,3812.93,6870.05,0.00
2024-12-10 17:21:45,112,5686,58,54,3804.58,6871.00,0.00
2024-12-10 17:21:45,113,5686,59,54,3770.91,6871.01,0.00
2024-12-10 17:21:45,112,5686,59,53,3803.36,6871.02,0.00
2024-12-10 17:21:45,113,5685,59,54,3718.97,6871.78,0.00
2024-12-10 17:21:45,113,5686,59,54,3770.85,6872.00,0.00
2024-12-10 17:21:45,114,5686,59,55,3737.77,6872.01,0.00
2024-12-10 17:21:45,115,5685,59,56,3704.67,6872.04,0.00
2024-12-10 17:21:45,114,5685,59,55,3739.61,6872.07,0.00
2024-12-10 17:21:45,114,5686,59,55,3791.15,6873.00,0.00
2024-12-10 17:21:45,115,5686,60,55,3758.18,6873.01,0.00
2024-12-10 17:21:45,114,5686,59,55,3786.96,6873.06,0.00
2024-12-10 17:21:45,115,5685,59,56,3749.85,6873.14,0.00
2024-12-10 17:21:45,115,5686,59,56,3859.57,6874.00,0.00
2024-12-10 17:21:45,116,5686,60,56,3826.30,6874.01,0.00
2024-12-10 17:21:45,115,5686,59,56,3855.42,6874.06,0.00
2024-12-10 17:21:45,116,5685,60,56,3763.58,6874.88,0.00
2024-12-10 17:21:45,116,5686,60,56,3880.86,6875.00,0.00
2024-12-10 17:21:45,117,5686,60,57,3847.69,6875.01,0.00
2024-12-10 17:21:45,116,5686,60,56,3876.74,6875.06,0.00
2024-12-10 17:21:45,115,5686,60,55,3859.20,6875.75,0.00
2024-12-10 17:21:45,115,5687,60,55,3957.10,6876.00,0.00
2024-12-10 17:21:45,116,5687,61,55,3922.98,6876.01,0.00
2024-12-10 17:21:45,115,5687,60,55,3952.94,6876.06,0.00
2024-12-10 17:21:45,115,5688,60,55,3942.51,6877.00,0.00
2024-12-10 17:21:45,116,5688,60,56,3908.52,6877.01,0.00
2024-12-10 17:21:45,115,5688,59,56,3940.73,6877.03,0.00
2024-12-10 17:21:45,114,5688,58,56,3972.90,6877.05,0.00
2024-12-10 17:21:45,113,5688,58,55,4007.45,6877.05,0.00
2024-12-10 17:21:45,113,5689,58,55,3995.75,6878.00,0.00
2024-12-10 17:21:45,114,5689,58,56,3960.70,6878.01,0.00
2024-12-10 17:21:45,113,5689,58,55,3992.13,6878.05,0.00
2024-12-10 17:21:45,114,5688,58,56,3918.72,6878.63,0.00
2024-12-10 17:21:45,114,5689,58,56,3964.31,6879.00,0.00
2024-12-10 17:21:45,115,5689,58,57,3929.84,6879.01,0.00
2024-12-10 17:21:45,115,5690,58,57,3970.58,6880.00,0.00
2024-12-10 17:21:45,116,5690,58,58,3936.35,6880.01,0.00
2024-12-10 17:21:45,115,5690,57,58,3967.02,6880.05,0.00
2024-12-10 17:21:45,115,5691,57,58,3950.01,6881.00,0.00
2024-12-10 17:21:45,116,5691,57,59,3915.95,6881.01,0.00
2024-12-10 17:21:45,116,5692,57,59,3895.00,6882.00,0.00
2024-12-10 17:21:45,117,5692,57,60,3861.71,6882.01,0.00
2024-12-10 17:21:45,116,5692,57,59,3890.89,6882.06,0.00
2024-12-10 17:21:45,116,5693,57,59,3874.07,6883.00,0.00
2024-12-10 17:21:45,117,5693,57,60,3840.95,6883.01,0.00
2024-12-10 17:21:45,116,5693,56,60,3869.95,6883.06,0.00
2024-12-10 17:21:45,117,5692,57,60,3794.77,6883.69,0.00
2024-12-10 17:21:45,117,5693,57,60,3836.78,6884.00,0.00
2024-12-10 17:21:45,118,5693,58,60,3804.26,6884.01,0.00
2024-12-10 17:21:45,117,5693,58,59,3832.70,6884.06,0.00
2024-12-10 17:21:45,117,5694,58,59,3876.33,6885.00,0.00
2024-12-10 17:21:45,118,5694,59,59,3843.48,6885.01,0.00
2024-12-10 17:21:45,117,5694,59,58,3872.24,6885.06,0.00
2024-12-10 17:21:45,116,5694,58,58,3856.18,6885.76,0.00
2024-12-10 17:21:45,116,5695,58,58,3895.02,6886.00,0.00
2024-12-10 17:21:45,117,5695,58,59,3861.73,6886.01,0.00
2024-12-10 17:21:45,118,5694,59,59,3828.42,6886.03,0.00
2024-12-10 17:21:45,117,5694,58,59,3865.89,6886.07,0.00
2024-12-10 17:21:45,118,5693,58,60,3817.42,6886.31,0.00
2024-12-10 17:21:45,117,5693,57,60,3833.91,6886.89,0.00
2024-12-10 17:21:45,117,5694,57,60,3885.21,6887.00,0.00
2024-12-10 17:21:45,118,5694,57,61,3852.29,6887.01,0.00
2024-12-10 17:21:45,117,5694,56,61,3881.13,6887.06,0.00
2024-12-10 17:21:46,117,5695,56,61,3992.51,6888.00,0.00
2024-12-10 17:21:46,118,5695,57,61,3958.68,6888.01,0.00
2024-12-10 17:21:46,117,5695,57,60,3988.42,6888.06,0.00
2024-12-10 17:21:46,117,5696,57,60,3982.21,6889.00,0.00
2024-12-10 17:21:46,118,5696,58,60,3948.46,6889.01,0.00
2024-12-10 17:21:46,117,5696,57,60,3978.12,6889.06,0.00
2024-12-10 17:21:46,118,5695,58,60,3881.84,6889.98,0.00
2024-12-10 17:21:46,118,5696,58,60,3940.25,6890.00,0.00
2024-12-10 17:21:46,119,5696,58,61,3907.14,6890.01,0.00
2024-12-10 17:21:46,119,5697,58,61,3955.06,6891.00,0.00
2024-12-10 17:21:46,120,5697,59,61,3922.11,6891.01,0.00
2024-12-10 17:21:46,121,5696,59,62,3888.56,6891.04,0.00
2024-12-10 17:21:46,120,5696,58,62,3944.54,6891.08,0.00
2024-12-10 17:21:46,120,5697,58,62,3938.76,6892.00,0.00
2024-12-10 17:21:46,121,5697,59,62,3906.20,6892.01,0.00
2024-12-10 17:21:46,121,5698,59,62,3952.34,6893.00,0.00
2024-12-10 17:21:46,122,5698,60,62,3919.95,6893.01,0.00
2024-12-10 17:21:46,122,5699,60,62,3908.65,6894.00,0.00
2024-12-10 17:21:46,123,5699,60,63,3876.87,6894.01,0.00
2024-12-10 17:21:46,122,5699,60,62,3904.17,6894.07,0.00
2024-12-10 17:21:46,122,5700,60,62,3896.78,6895.00,0.00
2024-12-10 17:21:46,123,5700,61,62,3865.10,6895.01,0.00
2024-12-10 17:21:46,122,5700,61,61,3892.30,6895.07,0.00
2024-12-10 17:21:46,123,5699,62,61,3854.50,6895.17,0.00
2024-12-10 17:21:46,123,5700,62,61,3902.11,6896.00,0.00
2024-12-10 17:21:46,124,5700,63,61,3870.64,6896.01,0.00
2024-12-10 17:21:46,123,5700,63,60,3897.66,6896.07,0.00
2024-12-10 17:21:46,124,5699,63,61,3829.18,6896.62,0.00
2024-12-10 17:21:46,125,5698,63,62,3797.77,6896.90,0.00
2024-12-10 17:21:46,125,5699,63,62,3904.90,6897.00,0.00
2024-12-10 17:21:46,126,5699,63,63,3873.91,6897.01,0.00
2024-12-10 17:21:46,125,5699,62,63,3900.52,6897.06,0.00
2024-12-10 17:21:46,125,5700,62,63,3998.35,6898.00,0.00
2024-12-10 17:21:46,126,5700,63,63,3966.62,6898.01,0.00
2024-12-10 17:21:46,125,5700,62,63,3993.97,6898.06,0.00
2024-12-10 17:21:46,125,5701,62,63,3979.77,6899.00,0.00
2024-12-10 17:21:46,126,5701,63,63,3948.19,6899.01,0.00
2024-12-10 17:21:46,125,5701,63,62,3975.40,6899.06,0.00
2024-12-10 17:21:46,125,5702,63,62,3958.70,6900.00,0.00
2024-12-10 17:21:46,126,5702,64,62,3927.28,6900.01,0.00
2024-12-10 17:21:46,125,5702,63,62,3954.32,6900.06,0.00
2024-12-10 17:21:46,125,5703,63,62,3937.75,6901.00,0.00
2024-12-10 17:21:46,126,5703,64,62,3906.50,6901.01,0.00
2024-12-10 17:21:46,125,5703,64,61,3937.20,6901.01,0.00
2024-12-10 17:21:46,126,5702,65,61,3905.95,6901.02,0.00
2024-12-10 17:21:46,125,5702,65,60,3941.65,6901.06,0.00
2024-12-10 17:21:46,125,5703,65,60,3925.32,6902.00,0.00
2024-12-10 17:21:46,126,5703,66,60,3894.16,6902.01,0.00
2024-12-10 17:21:46,126,5704,66,60,3928.68,6903.00,0.00
2024-12-10 17:21:46,127,5704,67,60,3897.74,6903.01,0.00
2024-12-10 17:21:46,126,5704,67,59,3924.33,6903.06,0.00
2024-12-10 17:21:46,126,5705,67,59,3907.86,6904.00,0.00
2024-12-10 17:21:46,127,5705,68,59,3877.09,6904.01,0.00
2024-12-10 17:21:46,126,5705,67,59,3903.51,6904.06,0.00
2024-12-10 17:21:46,125,5705,66,59,3897.33,6904.61,0.00
2024-12-10 17:21:46,125,5706,66,59,3922.13,6905.00,0.00
2024-12-10 17:21:46,126,5706,67,59,3891.00,6905.01,0.00
2024-12-10 17:21:46,126,5707,67,59,3873.68,6906.00,0.00
2024-12-10 17:21:46,127,5707,68,59,3843.18,6906.01,0.00
2024-12-10 17:21:46,126,5707,68,58,3869.33,6906.06,0.00
2024-12-10 17:21:46,127,5706,69,58,3807.48,6906.54,0.00
2024-12-10 17:21:46,128,5705,70,58,3779.39,6906.59,0.00
2024-12-10 17:21:46,128,5706,70,58,3822.16,6907.00,0.00
2024-12-10 17:21:46,129,5706,70,59,3792.53,6907.01,0.00
2024-12-10 17:21:46,128,5706,69,59,3817.88,6907.06,0.00
2024-12-10 17:21:46,129,5705,70,59,3767.48,6907.38,0.00
2024-12-10 17:21:46,130,5704,70,60,3721.65,6907.79,0.00
2024-12-10 17:21:46,130,5705,70,60,3871.68,6908.00,0.00
2024-12-10 17:21:46,131,5705,71,60,3842.12,6908.01,0.00
2024-12-10 17:21:46,131,5706,71,60,3926.88,6909.00,0.00
2024-12-10 17:21:46,132,5706,72,60,3897.13,6909.01,0.00
2024-12-10 17:21:46,133,5705,72,61,3831.66,6909.55,0.00
2024-12-10 17:21:46,132,5705,72,60,3872.43,6909.66,0.00
2024-12-10 17:21:46,132,5706,72,60,3901.51,6910.00,0.00
2024-12-10 17:21:46,133,5706,72,61,3872.18,6910.01,0.00
2024-12-10 17:21:46,132,5706,71,61,3896.32,6910.08,0.00
2024-12-10 17:21:46,133,5705,72,61,3827.28,6910.66,0.00
2024-12-10 17:21:46,133,5706,72,61,3924.21,6911.00,0.00
2024-12-10 17:21:46,134,5706,72,62,3894.93,6911.01,0.00
2024-12-10 17:21:46,133,5706,71,62,3919.06,6911.08,0.00
2024-12-10 17:21:46,134,5705,72,62,3866.69,6911.43,0.00
2024-12-10 17:21:46,134,5706,72,62,3957.74,6912.00,0.00
2024-12-10 17:21:46,135,5706,72,63,3928.42,6912.01,0.00
2024-12-10 17:21:46,134,5706,72,62,3952.11,6912.08,0.00
2024-12-10 17:21:46,135,5705,73,62,3912.61,6912.25,0.00
2024-12-10 17:21:46,135,5706,73,62,4001.24,6913.00,0.00
2024-12-10 17:21:46,136,5706,74,62,3971.81,6913.01,0.00
2024-12-10 17:21:46,135,5706,73,62,3989.38,6913.18,0.00
2024-12-10 17:21:46,135,5707,73,62,4032.55,6914.00,0.00
2024-12-10 17:21:46,136,5707,73,63,4002.90,6914.01,0.00
2024-12-10 17:21:46,135,5707,72,63,4026.45,6914.09,0.00
2024-12-10 17:21:46,136,5706,73,63,3963.84,6914.54,0.00
2024-12-10 17:21:46,136,5707,73,63,4004.89,6915.00,0.00
2024-12-10 17:21:46,137,5707,74,63,3975.65,6915.01,0.00
2024-12-10 17:21:46,136,5707,74,62,3998.83,6915.09,0.00
2024-12-10 17:21:47,136,5708,74,62,4034.39,6916.00,0.00
2024-12-10 17:21:47,137,5708,75,62,4004.94,6916.01,0.00
2024-12-10 17:21:47,137,5709,75,62,3983.42,6917.00,0.00
2024-12-10 17:21:47,138,5709,75,63,3954.56,6917.01,0.00
2024-12-10 17:21:47,137,5709,74,63,3976.91,6917.10,0.00
2024-12-10 17:21:47,136,5709,74,62,3980.39,6917.40,0.00
2024-12-10 17:21:47,137,5708,74,63,3933.32,6917.67,0.00
2024-12-10 17:21:47,137,5709,74,63,3965.92,6918.00,0.00
2024-12-10 17:21:47,138,5709,75,63,3937.18,6918.01,0.00
2024-12-10 17:21:47,137,5709,74,63,3959.40,6918.10,0.00
2024-12-10 17:21:47,137,5710,74,63,3995.12,6919.00,0.00
2024-12-10 17:21:47,138,5710,75,63,3966.17,6919.01,0.00
2024-12-10 17:21:47,137,5710,74,63,3988.59,6919.10,0.00
2024-12-10 17:21:47,137,5711,74,63,3972.00,6920.00,0.00
2024-12-10 17:21:47,138,5711,74,64,3943.22,6920.01,0.00
2024-12-10 17:21:47,137,5711,74,63,3965.48,6920.10,0.00
2024-12-10 17:21:47,136,5711,74,62,3974.86,6920.30,0.00
2024-12-10 17:21:47,136,5712,74,62,3977.90,6921.00,0.00
2024-12-10 17:21:47,137,5712,75,62,3948.86,6921.01,0.00
2024-12-10 17:21:47,136,5712,75,61,3971.32,6921.10,0.00
2024-12-10 17:21:47,136,5713,75,61,3960.15,6922.00,0.00
2024-12-10 17:21:47,137,5713,76,61,3931.24,6922.01,0.00
2024-12-10 17:21:47,138,5712,76,62,3901.76,6922.04,0.00
2024-12-10 17:21:47,137,5712,76,61,3954.02,6922.10,0.00
2024-12-10 17:21:47,138,5711,77,61,3900.41,6922.48,0.00
2024-12-10 17:21:47,139,5710,78,61,3894.29,6922.53,0.00
2024-12-10 17:21:47,139,5711,78,61,3934.38,6923.00,0.00
2024-12-10 17:21:47,140,5711,78,62,3906.27,6923.01,0.00
2024-12-10 17:21:47,139,5711,78,61,3927.94,6923.09,0.00
2024-12-10 17:21:47,139,5712,78,61,4063.33,6924.00,0.00
2024-12-10 17:21:47,140,5712,78,62,4034.31,6924.01,0.00
2024-12-10 17:21:47,139,5712,78,61,4056.90,6924.09,0.00
2024-12-10 17:21:47,140,5711,78,62,3981.97,6924.74,0.00
2024-12-10 17:21:47,140,5712,78,62,4024.73,6925.00,0.00
2024-12-10 17:21:47,141,5712,78,63,3996.19,6925.01,0.00
2024-12-10 17:21:47,141,5713,78,63,4024.02,6926.00,0.00
2024-12-10 17:21:47,142,5713,79,63,3995.68,6926.01,0.00
2024-12-10 17:21:47,141,5713,78,63,4017.68,6926.09,0.00
2024-12-10 17:21:47,141,5714,78,63,4002.38,6927.00,0.00
2024-12-10 17:21:47,142,5714,78,64,3974.20,6927.01,0.00
2024-12-10 17:21:47,142,5715,78,64,3953.09,6928.00,0.00
2024-12-10 17:21:47,143,5715,79,64,3925.45,6928.01,0.00
2024-12-10 17:21:47,142,5715,78,64,3946.79,6928.09,0.00
2024-12-10 17:21:47,141,5715,77,64,3974.45,6928.09,0.00
2024-12-10 17:21:47,141,5716,77,64,3959.88,6929.00,0.00
2024-12-10 17:21:47,142,5716,78,64,3931.99,6929.01,0.00
2024-12-10 17:21:47,143,5715,79,64,3904.02,6929.03,0.00
2024-12-10 17:21:47,144,5714,79,65,3877.45,6929.29,0.00
2024-12-10 17:21:47,144,5715,79,65,3883.98,6930.00,0.00
2024-12-10 17:21:47,145,5715,79,66,3857.20,6930.01,0.00
2024-12-10 17:21:47,144,5715,79,65,3877.76,6930.09,0.00
2024-12-10 17:21:47,144,5716,79,65,3958.57,6931.00,0.00
2024-12-10 17:21:47,145,5716,79,66,3931.27,6931.01,0.00
2024-12-10 17:21:47,144,5716,78,66,3952.35,6931.09,0.00
2024-12-10 17:21:47,144,5717,78,66,3937.15,6932.00,0.00
2024-12-10 17:21:47,145,5717,78,67,3910.00,6932.01,0.00
2024-12-10 17:21:47,144,5717,78,66,3932.85,6932.06,0.00
2024-12-10 17:21:47,143,5717,77,66,3959.87,6932.06,0.00
2024-12-10 17:21:47,142,5717,77,65,3986.29,6932.08,0.00
2024-12-10 17:21:47,141,5717,77,64,4014.07,6932.08,0.00
2024-12-10 17:21:47,141,5718,77,64,3999.23,6933.00,0.00
2024-12-10 17:21:47,142,5718,77,65,3971.07,6933.01,0.00
2024-12-10 17:21:47,141,5718,77,64,3993.37,6933.09,0.00
2024-12-10 17:21:47,141,5719,77,64,3979.16,6934.00,0.00
2024-12-10 17:21:47,142,5719,77,65,3951.14,6934.01,0.00
2024-12-10 17:21:47,141,5719,77,64,3973.30,6934.09,0.00
2024-12-10 17:21:47,142,5718,78,64,3896.91,6934.80,0.00
2024-12-10 17:21:47,142,5719,78,64,3942.02,6935.00,0.00
2024-12-10 17:21:47,143,5719,78,65,3914.46,6935.01,0.00
2024-12-10 17:21:47,142,5719,77,65,3936.20,6935.08,0.00
2024-12-10 17:21:47,141,5719,77,64,3957.23,6935.19,0.00
2024-12-10 17:21:47,142,5718,77,65,3926.93,6935.23,0.00
2024-12-10 17:21:47,143,5717,78,65,3904.46,6935.53,0.00
2024-12-10 17:21:47,143,5718,78,65,3990.73,6936.00,0.00
2024-12-10 17:21:47,144,5718,78,66,3963.02,6936.01,0.00
2024-12-10 17:21:47,143,5718,78,65,3984.95,6936.08,0.00
2024-12-10 17:21:47,143,5719,78,65,4067.26,6937.00,0.00
2024-12-10 17:21:47,144,5719,79,65,4039.02,6937.01,0.00
2024-12-10 17:21:47,143,5719,78,65,4061.48,6937.08,0.00
2024-12-10 17:21:47,144,5718,78,66,4010.75,6937.42,0.00
2024-12-10 17:21:47,144,5719,78,66,4045.87,6938.00,0.00
2024-12-10 17:21:47,145,5719,78,67,4017.96,6938.01,0.00
2024-12-10 17:21:47,144,5719,77,67,4040.12,6938.08,0.00
2024-12-10 17:21:47,145,5718,78,67,3989.89,6938.42,0.00
2024-12-10 17:21:47,146,5717,79,67,3976.45,6938.61,0.00
2024-12-10 17:21:47,146,5718,79,67,4050.90,6939.00,0.00
2024-12-10 17:21:47,147,5718,79,68,4023.35,6939.01,0.00
2024-12-10 17:21:47,146,5718,78,68,4045.24,6939.08,0.00
2024-12-10 17:21:47,147,5717,78,69,3996.12,6939.41,0.00
2024-12-10 17:21:47,147,5718,78,69,4097.10,6940.00,0.00
2024-12-10 17:21:47,148,5718,78,70,4069.42,6940.01,0.00
2024-12-10 17:21:47,147,5718,77,70,4091.47,6940.08,0.00
2024-12-10 17:21:47,146,5718,76,70,4119.02,6940.08,0.00
2024-12-10 17:21:48,146,5719,76,70,4150.96,6941.00,0.00
2024-12-10 17:21:48,147,5719,77,70,4122.72,6941.01,0.00
2024-12-10 17:21:48,148,5718,77,71,4038.54,6941.84,0.00
2024-12-10 17:21:48,148,5719,77,71,4081.38,6942.00,0.00
2024-12-10 17:21:48,149,5719,78,71,4053.99,6942.01,0.00
2024-12-10 17:21:48,149,5720,78,71,4077.80,6943.00,0.00
2024-12-10 17:21:48,150,5720,78,72,4050.61,6943.01,0.00
2024-12-10 17:21:48,151,5719,78,73,4005.03,6943.29,0.00
2024-12-10 17:21:48,152,5718,78,74,3984.12,6943.32,0.00
2024-12-10 17:21:48,152,5719,78,74,4014.75,6944.00,0.00
2024-12-10 17:21:48,153,5719,78,75,3988.51,6944.01,0.00
2024-12-10 17:21:48,152,5719,77,75,4008.84,6944.09,0.00
2024-12-10 17:21:48,151,5719,77,74,4034.93,6944.09,0.00
2024-12-10 17:21:48,152,5718,78,74,3987.62,6944.30,0.00
2024-12-10 17:21:48,152,5719,78,74,4072.51,6945.00,0.00
2024-12-10 17:21:48,153,5719,79,74,4045.89,6945.01,0.00
2024-12-10 17:21:48,152,5719,78,74,4069.33,6945.05,0.00
2024-12-10 17:21:48,151,5719,77,74,4093.07,6945.09,0.00
2024-12-10 17:21:48,150,5719,77,73,4119.90,6945.09,0.00
2024-12-10 17:21:48,150,5720,77,73,4135.59,6946.00,0.00
2024-12-10 17:21:48,151,5720,78,73,4108.20,6946.01,0.00
2024-12-10 17:21:48,152,5719,78,74,4079.36,6946.05,0.00
2024-12-10 17:21:48,152,5720,78,74,4076.94,6947.00,0.00
2024-12-10 17:21:48,153,5720,78,75,4050.29,6947.01,0.00
2024-12-10 17:21:48,153,5721,78,75,4056.40,6948.00,0.00
2024-12-10 17:21:48,154,5721,78,76,4030.06,6948.01,0.00
2024-12-10 17:21:48,153,5721,78,75,4050.54,6948.09,0.00
2024-12-10 17:21:48,152,5721,77,75,4063.61,6948.24,0.00
2024-12-10 17:21:48,153,5720,78,75,4008.66,6948.66,0.00
2024-12-10 17:21:48,153,5721,78,75,4038.18,6949.00,0.00
2024-12-10 17:21:48,154,5721,79,75,4011.96,6949.01,0.00
2024-12-10 17:21:48,154,5722,79,75,4025.71,6950.00,0.00
2024-12-10 17:21:48,155,5722,79,76,3999.73,6950.01,0.00
2024-12-10 17:21:48,154,5722,78,76,4019.88,6950.08,0.00
2024-12-10 17:21:48,154,5723,78,76,3994.45,6951.00,0.00
2024-12-10 17:21:48,155,5723,78,77,3968.68,6951.01,0.00
2024-12-10 17:21:48,155,5724,78,77,3938.58,6952.00,0.00
2024-12-10 17:21:48,156,5724,78,78,3913.34,6952.01,0.00
2024-12-10 17:21:48,155,5724,77,78,3932.34,6952.09,0.00
2024-12-10 17:21:48,155,5725,77,78,3909.40,6953.00,0.00
2024-12-10 17:21:48,156,5725,78,78,3884.34,6953.01,0.00
2024-12-10 17:21:48,155,5725,78,77,3903.16,6953.09,0.00
2024-12-10 17:21:48,156,5724,79,77,3875.03,6953.15,0.00
2024-12-10 17:21:48,157,5723,79,78,3839.91,6953.61,0.00
2024-12-10 17:21:48,156,5723,79,77,3858.88,6953.92,0.00
2024-12-10 17:21:48,156,5724,79,77,3897.74,6954.00,0.00
2024-12-10 17:21:48,157,5724,80,77,3872.91,6954.01,0.00
2024-12-10 17:21:48,158,5723,81,77,3783.90,6954.92,0.00
2024-12-10 17:21:48,158,5724,81,77,3914.25,6955.00,0.00
2024-12-10 17:21:48,159,5724,82,77,3889.64,6955.01,0.00
2024-12-10 17:21:48,160,5723,83,77,3800.03,6955.94,0.00
2024-12-10 17:21:48,160,5724,83,77,3885.29,6956.00,0.00
2024-12-10 17:21:48,161,5724,84,77,3861.16,6956.01,0.00
2024-12-10 17:21:48,160,5724,84,76,3878.81,6956.09,0.00
2024-12-10 17:21:48,160,5725,84,76,3901.20,6957.00,0.00
2024-12-10 17:21:48,161,5725,84,77,3876.97,6957.01,0.00
2024-12-10 17:21:48,162,5724,84,78,3849.19,6957.07,0.00
2024-12-10 17:21:48,163,5723,84,79,3823.12,6957.39,0.00
2024-12-10 17:21:48,163,5724,84,79,3848.81,6958.00,0.00
2024-12-10 17:21:48,164,5724,84,80,3825.34,6958.01,0.00
2024-12-10 17:21:48,163,5724,83,80,3842.02,6958.10,0.00
2024-12-10 17:21:48,163,5725,83,80,3906.44,6959.00,0.00
2024-12-10 17:21:48,164,5725,83,81,3882.62,6959.01,0.00
2024-12-10 17:21:48,165,5724,84,81,3805.89,6959.76,0.00
2024-12-10 17:21:48,165,5725,84,81,3841.53,6960.00,0.00
2024-12-10 17:21:48,166,5725,84,82,3818.39,6960.01,0.00
2024-12-10 17:21:48,165,5725,83,82,3834.82,6960.10,0.00
2024-12-10 17:21:48,165,5726,83,82,3854.62,6961.00,0.00
2024-12-10 17:21:48,166,5726,83,83,3831.40,6961.01,0.00
2024-12-10 17:21:48,165,5726,82,83,3847.91,6961.10,0.00
2024-12-10 17:21:48,164,5726,81,83,3851.24,6961.37,0.00
2024-12-10 17:21:48,165,5725,82,83,3801.98,6961.73,0.00
2024-12-10 17:21:48,165,5726,82,83,3836.81,6962.00,0.00
2024-12-10 17:21:48,166,5726,83,83,3813.70,6962.01,0.00
2024-12-10 17:21:48,165,5726,82,83,3830.10,6962.10,0.00
2024-12-10 17:21:48,165,5727,82,83,3849.04,6963.00,0.00
2024-12-10 17:21:48,166,5727,83,83,3825.85,6963.01,0.00
2024-12-10 17:21:48,165,5727,82,83,3846.52,6963.04,0.00
2024-12-10 17:21:48,164,5727,82,82,3869.13,6963.04,0.00
2024-12-10 17:21:48,163,5727,82,81,3889.05,6963.09,0.00
2024-12-10 17:21:48,162,5727,82,80,3912.62,6963.09,0.00
2024-12-10 17:21:48,161,5727,81,80,3936.49,6963.09,0.00
2024-12-10 17:21:48,162,5726,82,80,3887.58,6963.43,0.00
2024-12-10 17:21:48,162,5727,82,80,3914.53,6964.00,0.00
2024-12-10 17:21:48,163,5727,82,81,3890.51,6964.01,0.00
2024-12-10 17:21:48,162,5727,82,80,3908.12,6964.09,0.00
2024-12-10 17:21:48,162,5728,82,80,3928.43,6965.00,0.00
2024-12-10 17:21:48,163,5728,83,80,3904.33,6965.01,0.00
2024-12-10 17:21:48,162,5728,82,80,3922.02,6965.09,0.00
2024-12-10 17:21:48,162,5729,82,80,3898.91,6966.00,0.00
2024-12-10 17:21:48,163,5729,83,80,3874.99,6966.01,0.00
2024-12-10 17:21:48,164,5728,83,81,3850.94,6966.02,0.00
2024-12-10 17:21:48,163,5728,83,80,3889.10,6966.03,0.00
2024-12-10 17:21:48,164,5727,83,81,3855.67,6966.18,0.00
2024-12-10 17:21:49,164,5728,83,81,3875.40,6967.00,0.00
2024-12-10 17:21:49,165,5728,84,81,3851.91,6967.01,0.00
2024-12-10 17:21:49,164,5728,83,81,3872.02,6967.05,0.00
2024-12-10 17:21:49,163,5728,82,81,3892.38,6967.09,0.00
2024-12-10 17:21:49,162,5728,82,80,3908.55,6967.17,0.00
2024-12-10 17:21:49,162,5729,82,80,3979.08,6968.00,0.00
2024-12-10 17:21:49,163,5729,83,80,3954.67,6968.01,0.00
2024-12-10 17:21:49,162,5729,82,80,3972.67,6968.09,0.00
2024-12-10 17:21:49,162,5730,82,80,3952.14,6969.00,0.00
2024-12-10 17:21:49,163,5730,82,81,3927.89,6969.01,0.00
2024-12-10 17:21:49,162,5730,82,80,3945.73,6969.09,0.00
2024-12-10 17:21:49,162,5731,82,80,3924.92,6970.00,0.00
2024-12-10 17:21:49,163,5731,83,80,3900.84,6970.01,0.00
2024-12-10 17:21:49,162,5731,82,80,3885.71,6970.54,0.00
2024-12-10 17:21:49,163,5730,83,80,3852.98,6970.68,0.00
2024-12-10 17:21:49,163,5731,83,80,3887.46,6971.00,0.00
2024-12-10 17:21:49,164,5731,84,80,3863.75,6971.01,0.00
2024-12-10 17:21:49,163,5731,83,80,3883.63,6971.06,0.00
2024-12-10 17:21:49,162,5731,83,79,3904.61,6971.09,0.00
2024-12-10 17:21:49,163,5730,84,79,3823.46,6971.90,0.00
2024-12-10 17:21:49,163,5731,84,79,3906.95,6972.00,0.00
2024-12-10 17:21:49,164,5731,85,79,3883.13,6972.01,0.00
2024-12-10 17:21:49,163,5731,85,78,3900.58,6972.09,0.00
2024-12-10 17:21:49,162,5731,85,77,3902.30,6972.40,0.00
2024-12-10 17:21:49,162,5732,85,77,3947.06,6973.00,0.00
2024-12-10 17:21:49,163,5732,85,78,3922.84,6973.01,0.00
2024-12-10 17:21:49,162,5732,84,78,3940.22,6973.10,0.00
2024-12-10 17:21:49,161,5732,84,77,3964.26,6973.10,0.00
2024-12-10 17:21:49,161,5733,84,77,3945.29,6974.00,0.00
2024-12-10 17:21:49,162,5733,84,78,3920.93,6974.01,0.00
2024-12-10 17:21:49,161,5733,83,78,3938.41,6974.10,0.00
2024-12-10 17:21:49,161,5734,83,78,3919.43,6975.00,0.00
2024-12-10 17:21:49,162,5734,83,79,3895.24,6975.01,0.00
2024-12-10 17:21:49,162,5735,83,79,3869.52,6976.00,0.00
2024-12-10 17:21:49,163,5735,84,79,3845.79,6976.01,0.00
2024-12-10 17:21:49,163,5736,84,79,3819.80,6977.00,0.00
2024-12-10 17:21:49,164,5736,85,79,3796.51,6977.01,0.00
2024-12-10 17:21:49,165,5735,85,80,3743.62,6977.45,0.00
2024-12-10 17:21:49,166,5734,86,80,3739.61,6977.55,0.00
2024-12-10 17:21:49,166,5735,86,80,3770.11,6978.00,0.00
2024-12-10 17:21:49,167,5735,87,80,3747.54,6978.01,0.00
2024-12-10 17:21:49,166,5735,87,79,3762.59,6978.11,0.00
2024-12-10 17:21:49,166,5736,87,79,3825.71,6979.00,0.00
2024-12-10 17:21:49,167,5736,88,79,3802.80,6979.01,0.00
2024-12-10 17:21:49,166,5736,88,78,3818.19,6979.11,0.00
2024-12-10 17:21:49,166,5737,88,78,3796.48,6980.00,0.00
2024-12-10 17:21:49,167,5737,89,78,3773.75,6980.01,0.00
2024-12-10 17:21:49,166,5737,89,77,3788.96,6980.11,0.00
2024-12-10 17:21:49,166,5738,89,77,3766.48,6981.00,0.00
2024-12-10 17:21:49,167,5738,90,77,3743.93,6981.01,0.00
2024-12-10 17:21:49,168,5737,90,78,3674.14,6981.70,0.00
2024-12-10 17:21:49,168,5738,90,78,3705.79,6982.00,0.00
2024-12-10 17:21:49,169,5738,91,78,3683.87,6982.01,0.00
2024-12-10 17:21:49,170,5737,91,79,3602.24,6982.88,0.00
2024-12-10 17:21:49,170,5738,91,79,3688.25,6983.00,0.00
2024-12-10 17:21:49,171,5738,92,79,3666.68,6983.01,0.00
2024-12-10 17:21:49,170,5738,92,78,3680.09,6983.12,0.00
2024-12-10 17:21:49,169,5738,91,78,3701.45,6983.12,0.00
2024-12-10 17:21:49,170,5737,92,78,3633.55,6983.79,0.00
2024-12-10 17:21:49,170,5738,92,78,3702.68,6984.00,0.00
2024-12-10 17:21:49,171,5738,92,79,3681.03,6984.01,0.00
2024-12-10 17:21:49,170,5738,91,79,3694.52,6984.12,0.00
2024-12-10 17:21:49,170,5739,91,79,3706.45,6985.00,0.00
2024-12-10 17:21:49,171,5739,92,79,3684.78,6985.01,0.00
2024-12-10 17:21:49,170,5739,91,79,3698.28,6985.12,0.00
2024-12-10 17:21:49,171,5738,91,80,3652.65,6985.47,0.00
2024-12-10 17:21:49,171,5739,91,80,3671.46,6986.00,0.00
2024-12-10 17:21:49,172,5739,92,80,3650.12,6986.01,0.00
2024-12-10 17:21:49,171,5739,92,79,3669.02,6986.04,0.00
2024-12-10 17:21:49,170,5739,92,78,3684.89,6986.11,0.00
2024-12-10 17:21:49,169,5739,91,78,3706.28,6986.11,0.00
2024-12-10 17:21:49,169,5740,91,78,3718.02,6987.00,0.00
2024-12-10 17:21:49,170,5740,91,79,3696.15,6987.01,0.00
2024-12-10 17:21:49,169,5740,91,78,3709.80,6987.12,0.00
2024-12-10 17:21:49,170,5739,92,78,3658.93,6987.55,0.00
2024-12-10 17:21:49,170,5740,92,78,3666.24,6988.00,0.00
2024-12-10 17:21:49,171,5740,92,79,3644.80,6988.01,0.00
2024-12-10 17:21:49,170,5740,91,79,3658.06,6988.12,0.00
2024-12-10 17:21:49,171,5739,91,80,3622.81,6988.33,0.00
2024-12-10 17:21:49,171,5740,91,80,3663.42,6989.00,0.00
2024-12-10 17:21:49,172,5740,92,80,3642.12,6989.01,0.00
2024-12-10 17:21:49,171,5740,91,80,3655.29,6989.12,0.00
2024-12-10 17:21:49,170,5740,91,79,3627.48,6989.81,0.00
2024-12-10 17:21:49,170,5741,91,79,3695.02,6990.00,0.00
2024-12-10 17:21:49,171,5741,91,80,3673.41,6990.01,0.00
2024-12-10 17:21:49,170,5741,91,79,3686.43,6990.12,0.00
2024-12-10 17:21:49,171,5740,92,79,3647.36,6990.39,0.00
2024-12-10 17:21:49,171,5741,92,79,3672.44,6991.00,0.00
2024-12-10 17:21:49,172,5741,92,80,3651.09,6991.01,0.00
2024-12-10 17:21:50,171,5741,91,80,3663.90,6991.12,0.00
2024-12-10 17:21:50,170,5741,91,79,3685.04,6991.12,0.00
2024-12-10 17:21:50,170,5742,91,79,3706.00,6992.00,0.00
2024-12-10 17:21:50,171,5742,92,79,3684.33,6992.01,0.00
2024-12-10 17:21:50,170,5742,91,79,3697.41,6992.12,0.00
2024-12-10 17:21:50,170,5743,91,79,3677.28,6993.00,0.00
2024-12-10 17:21:50,171,5743,92,79,3655.77,6993.01,0.00
2024-12-10 17:21:50,172,5742,92,80,3602.54,6993.48,0.00
2024-12-10 17:21:50,172,5743,92,80,3619.06,6994.00,0.00
2024-12-10 17:21:50,173,5743,93,80,3598.14,6994.01,0.00
2024-12-10 17:21:50,172,5743,93,79,3610.16,6994.13,0.00
2024-12-10 17:21:50,172,5744,93,79,3630.44,6995.00,0.00
2024-12-10 17:21:50,173,5744,93,80,3609.45,6995.01,0.00
2024-12-10 17:21:50,172,5744,93,79,3628.42,6995.03,0.00
2024-12-10 17:21:50,171,5744,92,79,3642.72,6995.12,0.00
2024-12-10 17:21:50,172,5743,92,80,3589.17,6995.60,0.00
2024-12-10 17:21:50,172,5744,92,80,3616.82,6996.00,0.00
2024-12-10 17:21:50,173,5744,92,81,3595.92,6996.01,0.00
2024-12-10 17:21:50,172,5744,91,81,3608.32,6996.12,0.00
2024-12-10 17:21:50,171,5744,91,80,3629.02,6996.12,0.00
2024-12-10 17:21:50,170,5744,91,79,3649.95,6996.12,0.00
2024-12-10 17:21:50,170,5745,91,79,3669.28,6997.00,0.00
2024-12-10 17:21:50,171,5745,91,80,3647.82,6997.01,0.00
2024-12-10 17:21:50,170,5745,91,79,3660.67,6997.12,0.00
2024-12-10 17:21:50,170,5746,91,79,3636.75,6998.00,0.00
2024-12-10 17:21:50,171,5746,92,79,3615.49,6998.01,0.00
2024-12-10 17:21:50,170,5746,91,79,3628.15,6998.12,0.00
2024-12-10 17:21:50,170,5747,91,79,3601.26,6999.00,0.00
2024-12-10 17:21:50,171,5747,92,79,3580.20,6999.01,0.00
2024-12-10 17:21:50,170,5747,91,79,3592.65,6999.12,0.00
2024-12-10 17:21:50,170,5748,91,79,3563.57,7000.00,0.00
2024-12-10 17:21:50,171,5748,92,79,3542.73,7000.01,0.00
2024-12-10 17:21:50,170,5748,91,79,3554.96,7000.12,0.00
2024-12-10 17:21:50,170,5749,91,79,3523.77,7001.00,0.00
2024-12-10 17:21:50,171,5749,91,80,3503.16,7001.01,0.00
2024-12-10 17:21:50,170,5749,91,79,3523.35,7001.01,0.00
2024-12-10 17:21:50,169,5749,90,79,3535.54,7001.12,0.00
2024-12-10 17:21:50,170,5748,90,80,3486.87,7001.54,0.00
2024-12-10 17:21:50,170,5749,90,80,3507.60,7002.00,0.00
2024-12-10 17:21:50,171,5749,90,81,3487.09,7002.01,0.00
2024-12-10 17:21:50,170,5749,89,81,3498.99,7002.12,0.00
2024-12-10 17:21:50,171,5748,89,82,3469.95,7002.26,0.00
2024-12-10 17:21:50,171,5748,89,82,3502.39,7003.00,0.00
2024-12-10 17:21:50,172,5748,89,83,3482.03,7003.01,0.00
2024-12-10 17:21:50,171,5748,88,83,3493.83,7003.12,0.00
2024-12-10 17:21:50,171,5749,88,83,3508.23,7004.00,0.00
2024-12-10 17:21:50,172,5749,89,83,3487.83,7004.01,0.00
2024-12-10 17:21:50,171,5749,88,83,3499.66,7004.12,0.00
2024-12-10 17:21:50,171,5750,88,83,3473.66,7005.00,0.00
2024-12-10 17:21:50,172,5750,89,83,3453.46,7005.01,0.00
2024-12-10 17:21:50,172,5751,89,83,3417.79,7006.00,0.00
2024-12-10 17:21:50,173,5751,89,84,3398.03,7006.01,0.00
2024-12-10 17:21:50,174,5750,90,84,3374.90,7006.07,0.00
2024-12-10 17:21:50,173,5750,89,84,3429.66,7006.13,0.00
2024-12-10 17:21:50,172,5750,88,84,3449.20,7006.13,0.00
2024-12-10 17:21:50,171,5750,87,84,3468.96,7006.13,0.00
2024-12-10 17:21:50,170,5750,87,83,3432.76,7006.80,0.00
2024-12-10 17:21:50,170,5751,87,83,3460.05,7007.00,0.00
2024-12-10 17:21:50,171,5751,87,84,3439.82,7007.01,0.00
2024-12-10 17:21:50,170,5751,87,83,3458.00,7007.03,0.00
2024-12-10 17:21:50,169,5751,87,82,3471.45,7007.12,0.00
2024-12-10 17:21:50,168,5751,86,82,3491.69,7007.13,0.00
2024-12-10 17:21:50,167,5751,86,81,3512.18,7007.13,0.00
2024-12-10 17:21:50,168,5750,87,81,3475.90,7007.36,0.00
2024-12-10 17:21:50,168,5751,87,81,3513.50,7008.00,0.00
2024-12-10 17:21:50,169,5751,87,82,3492.71,7008.01,0.00
2024-12-10 17:21:50,168,5751,86,82,3504.79,7008.13,0.00
2024-12-10 17:21:50,168,5752,86,82,3519.76,7009.00,0.00
2024-12-10 17:21:50,169,5752,87,82,3498.93,7009.01,0.00
2024-12-10 17:21:50,168,5752,86,82,3516.44,7009.05,0.00
2024-12-10 17:21:50,167,5752,85,82,3532.06,7009.12,0.00
2024-12-10 17:21:50,166,5752,84,82,3519.93,7009.53,0.00
2024-12-10 17:21:50,165,5752,83,82,3525.24,7009.69,0.00
2024-12-10 17:21:50,165,5753,83,82,3546.30,7010.00,0.00
2024-12-10 17:21:50,166,5753,83,83,3524.94,7010.01,0.00
2024-12-10 17:21:50,165,5753,83,82,3537.85,7010.12,0.00
2024-12-10 17:21:50,164,5753,82,82,3558.99,7010.12,0.00
2024-12-10 17:21:50,163,5753,82,81,3545.60,7010.55,0.00
2024-12-10 17:21:50,163,5754,82,81,3555.60,7011.00,0.00
2024-12-10 17:21:50,164,5754,83,81,3533.92,7011.01,0.00
2024-12-10 17:21:50,163,5754,83,80,3547.03,7011.12,0.00
2024-12-10 17:21:50,162,5754,82,80,3568.50,7011.12,0.00
2024-12-10 17:21:50,163,5753,82,81,3544.03,7011.17,0.00
2024-12-10 17:21:50,164,5752,83,81,3488.36,7011.63,0.00
2024-12-10 17:21:50,164,5753,83,81,3522.37,7012.00,0.00
2024-12-10 17:21:50,165,5753,84,81,3501.02,7012.01,0.00
2024-12-10 17:21:50,166,5752,84,82,3415.18,7012.82,0.00
2024-12-10 17:21:50,166,5753,84,82,3537.54,7013.00,0.00
2024-12-10 17:21:50,167,5753,85,82,3516.36,7013.01,0.00
2024-12-10 17:21:50,166,5753,84,82,3528.29,7013.13,0.00
2024-12-10 17:21:50,165,5753,84,81,3527.06,7013.35,0.00
2024-12-10 17:21:51,165,5754,84,81,3562.61,7014.00,0.00
2024-12-10 17:21:51,166,5754,85,81,3541.15,7014.01,0.00
2024-12-10 17:21:51,165,5754,84,81,3558.81,7014.06,0.00
2024-12-10 17:21:51,164,5754,84,80,3574.97,7014.13,0.00
2024-12-10 17:21:51,164,5755,84,80,3547.42,7015.00,0.00
2024-12-10 17:21:51,165,5755,85,80,3525.92,7015.01,0.00
2024-12-10 17:21:51,164,5755,84,80,3538.05,7015.13,0.00
2024-12-10 17:21:51,163,5755,84,79,3558.41,7015.14,0.00
2024-12-10 17:21:51,162,5755,83,79,3566.45,7015.32,0.00
2024-12-10 17:21:51,163,5754,83,80,3528.06,7015.55,0.00
2024-12-10 17:21:51,163,5755,83,80,3559.13,7016.00,0.00
2024-12-10 17:21:51,164,5755,83,81,3537.42,7016.01,0.00
2024-12-10 17:21:51,165,5754,83,82,3444.34,7016.99,0.00
2024-12-10 17:21:51,165,5755,83,82,3528.98,7017.00,0.00
2024-12-10 17:21:51,166,5755,84,82,3507.72,7017.01,0.00
2024-12-10 17:21:51,165,5755,84,81,3523.05,7017.09,0.00
2024-12-10 17:21:51,164,5755,84,80,3540.70,7017.13,0.00
2024-12-10 17:21:51,164,5756,84,80,3564.04,7018.00,0.00
2024-12-10 17:21:51,165,5756,84,81,3542.44,7018.01,0.00
2024-12-10 17:21:51,164,5756,83,81,3554.67,7018.13,0.00
2024-12-10 17:21:51,165,5755,84,81,3523.79,7018.28,0.00
2024-12-10 17:21:51,166,5754,84,82,3491.87,7018.97,0.00
2024-12-10 17:21:51,166,5755,84,82,3532.49,7019.00,0.00
2024-12-10 17:21:51,167,5755,84,83,3511.33,7019.01,0.00
2024-12-10 17:21:51,166,5755,83,83,3523.23,7019.13,0.00
2024-12-10 17:21:51,166,5756,83,83,3587.35,7020.00,0.00
2024-12-10 17:21:51,167,5756,84,83,3565.86,7020.01,0.00
2024-12-10 17:21:51,166,5756,84,82,3578.08,7020.13,0.00
2024-12-10 17:21:51,167,5755,85,82,3553.30,7020.19,0.00
2024-12-10 17:21:51,167,5756,85,82,3548.43,7021.00,0.00
2024-12-10 17:21:51,168,5756,85,83,3527.31,7021.01,0.00
2024-12-10 17:21:51,168,5757,85,83,3532.52,7022.00,0.00
2024-12-10 17:21:51,169,5757,85,84,3511.62,7022.01,0.00
2024-12-10 17:21:51,168,5757,84,84,3531.69,7022.01,0.00
2024-12-10 17:21:51,167,5757,84,83,3549.48,7022.05,0.00
2024-12-10 17:21:51,166,5757,83,83,3565.39,7022.13,0.00
2024-12-10 17:21:51,165,5757,83,82,3586.58,7022.13,0.00
2024-12-10 17:21:51,164,5757,82,82,3608.02,7022.13,0.00
2024-12-10 17:21:51,165,5756,83,82,3545.81,7022.66,0.00
2024-12-10 17:21:51,165,5757,83,82,3574.97,7023.00,0.00
2024-12-10 17:21:51,166,5757,84,82,3553.44,7023.01,0.00
2024-12-10 17:21:51,165,5757,84,81,3566.07,7023.13,0.00
2024-12-10 17:21:51,165,5758,84,81,3572.44,7024.00,0.00
2024-12-10 17:21:51,166,5758,85,81,3550.92,7024.01,0.00
2024-12-10 17:21:51,165,5758,85,80,3563.54,7024.13,0.00
2024-12-10 17:21:51,164,5758,85,79,3584.84,7024.13,0.00
2024-12-10 17:21:51,163,5758,85,78,3563.58,7024.63,0.00
2024-12-10 17:21:51,163,5759,85,78,3567.43,7025.00,0.00
2024-12-10 17:21:51,164,5759,85,79,3545.67,7025.01,0.00
2024-12-10 17:21:51,165,5758,85,80,3462.92,7025.71,0.00
2024-12-10 17:21:51,165,5759,85,80,3489.03,7026.00,0.00
2024-12-10 17:21:51,166,5759,86,80,3468.01,7026.01,0.00
2024-12-10 17:21:51,166,5760,86,80,3458.84,7027.00,0.00
2024-12-10 17:21:51,167,5760,86,81,3438.13,7027.01,0.00
2024-12-10 17:21:51,166,5760,86,80,3449.15,7027.14,0.00
2024-12-10 17:21:51,166,5761,86,80,3407.68,7028.00,0.00
2024-12-10 17:21:51,167,5761,86,81,3387.28,7028.01,0.00
2024-12-10 17:21:51,166,5761,85,81,3397.99,7028.14,0.00
2024-12-10 17:21:51,165,5761,85,80,3411.41,7028.19,0.00
2024-12-10 17:21:51,164,5761,84,80,3405.90,7028.51,0.00
2024-12-10 17:21:51,165,5760,85,80,3379.63,7028.58,0.00
2024-12-10 17:21:51,165,5761,85,80,3403.26,7029.00,0.00
2024-12-10 17:21:51,166,5761,86,80,3382.76,7029.01,0.00
2024-12-10 17:21:51,165,5761,86,79,3401.56,7029.02,0.00
2024-12-10 17:21:51,164,5761,85,79,3413.77,7029.14,0.00
2024-12-10 17:21:51,163,5761,85,78,3434.28,7029.14,0.00
2024-12-10 17:21:51,163,5762,85,78,3445.31,7030.00,0.00
2024-12-10 17:21:51,164,5762,85,79,3424.30,7030.01,0.00
2024-12-10 17:21:51,163,5762,85,78,3435.43,7030.14,0.00
2024-12-10 17:21:51,164,5761,85,79,3404.78,7030.29,0.00
2024-12-10 17:21:52,163,5761,84,79,3430.64,7030.37,0.00
2024-12-10 17:21:52,163,5762,84,79,3417.01,7031.00,0.00
2024-12-10 17:21:52,164,5762,85,79,3396.18,7031.01,0.00
2024-12-10 17:21:52,163,5762,85,78,3407.13,7031.14,0.00
2024-12-10 17:21:52,163,5763,85,78,3417.75,7032.00,0.00
2024-12-10 17:21:52,164,5763,85,79,3396.91,7032.01,0.00
2024-12-10 17:21:52,163,5763,85,78,3407.86,7032.14,0.00
2024-12-10 17:21:52,164,5762,86,78,3366.87,7032.39,0.00
2024-12-10 17:21:52,163,5762,86,77,3410.70,7032.40,0.00
2024-12-10 17:21:52,163,5763,86,77,3402.13,7033.00,0.00
2024-12-10 17:21:52,164,5763,87,77,3381.39,7033.01,0.00
2024-12-10 17:21:52,163,5763,87,76,3392.24,7033.14,0.00
2024-12-10 17:21:52,162,5763,87,75,3408.17,7033.20,0.00
2024-12-10 17:21:52,163,5762,87,76,3385.10,7033.25,0.00
2024-12-10 17:21:52,163,5763,87,76,3443.22,7034.00,0.00
2024-12-10 17:21:52,164,5763,88,76,3422.23,7034.01,0.00
2024-12-10 17:21:52,165,5762,88,77,3399.36,7034.05,0.00
2024-12-10 17:21:52,164,5762,87,77,3427.40,7034.10,0.00
2024-12-10 17:21:52,165,5761,88,77,3405.78,7034.13,0.00
2024-12-10 17:21:52,164,5761,88,76,3443.29,7034.15,0.00
2024-12-10 17:21:52,165,5760,88,77,3415.19,7034.26,0.00
2024-12-10 17:21:52,164,5760,87,77,3413.73,7034.55,0.00
2024-12-10 17:21:52,165,5759,88,77,3391.77,7034.58,0.00
2024-12-10 17:21:52,166,5758,89,77,3363.12,7034.91,0.00
2024-12-10 17:21:52,166,5759,89,77,3445.58,7035.00,0.00
2024-12-10 17:21:52,167,5759,90,77,3424.94,7035.01,0.00
2024-12-10 17:21:52,166,5759,89,77,3443.89,7035.02,0.00
2024-12-10 17:21:52,165,5759,88,77,3461.78,7035.06,0.00
2024-12-10 17:21:52,164,5759,87,77,3477.35,7035.13,0.00
2024-12-10 17:21:52,163,5759,87,76,3490.04,7035.23,0.00
2024-12-10 17:21:52,162,5759,86,76,3465.52,7035.82,0.00
2024-12-10 17:21:52,162,5760,86,76,3711.17,7036.00,0.00
2024-12-10 17:21:52,163,5760,86,77,3688.40,7036.01,0.00
2024-12-10 17:21:52,162,5760,86,76,3701.66,7036.14,0.00
2024-12-10 17:21:52,162,5761,86,76,3679.23,7037.00,0.00
2024-12-10 17:21:52,163,5761,86,77,3656.66,7037.01,0.00
2024-12-10 17:21:52,162,5761,86,76,3675.77,7037.05,0.00
2024-12-10 17:21:52,161,5761,86,75,3692.52,7037.13,0.00
2024-12-10 17:21:52,160,5761,86,74,3674.34,7037.70,0.00
2024-12-10 17:21:52,160,5762,86,74,3691.34,7038.00,0.00
2024-12-10 17:21:52,161,5762,86,75,3668.41,7038.01,0.00
2024-12-10 17:21:52,160,5762,85,75,3686.96,7038.06,0.00
2024-12-10 17:21:52,161,5761,85,76,3661.89,7038.11,0.00
2024-12-10 17:21:52,160,5761,84,76,3724.82,7038.13,0.00
2024-12-10 17:21:52,159,5761,83,76,3747.81,7038.13,0.00
2024-12-10 17:21:52,158,5761,82,76,3748.88,7038.44,0.00
2024-12-10 17:21:52,158,5762,82,76,3744.79,7039.00,0.00
2024-12-10 17:21:52,159,5762,83,76,3721.24,7039.01,0.00
2024-12-10 17:21:52,158,5762,83,75,3741.24,7039.05,0.00
2024-12-10 17:21:52,157,5762,83,74,3759.73,7039.12,0.00
2024-12-10 17:21:52,156,5762,83,73,3783.38,7039.12,0.00
2024-12-10 17:21:52,156,5763,83,73,3798.27,7040.00,0.00
2024-12-10 17:21:52,157,5763,83,74,3774.08,7040.01,0.00
2024-12-10 17:21:52,158,5762,83,75,3714.38,7040.50,0.00
2024-12-10 17:21:52,158,5763,83,75,3731.86,7041.00,0.00
2024-12-10 17:21:52,159,5763,84,75,3708.39,7041.01,0.00
2024-12-10 17:21:52,158,5763,83,75,3723.49,7041.12,0.00
2024-12-10 17:21:52,157,5763,83,74,3746.75,7041.12,0.00
2024-12-10 17:21:52,158,5762,84,74,3711.67,7041.28,0.00
2024-12-10 17:21:52,157,5762,83,74,3726.48,7041.81,0.00
2024-12-10 17:21:52,157,5763,83,74,3795.06,7042.00,0.00
2024-12-10 17:21:52,158,5763,84,74,3771.04,7042.01,0.00
2024-12-10 17:21:52,157,5763,83,74,3786.17,7042.12,0.00
2024-12-10 17:21:52,158,5762,83,75,3722.15,7042.67,0.00
2024-12-10 17:21:52,158,5763,83,75,3786.78,7043.00,0.00
2024-12-10 17:21:52,159,5763,83,76,3762.97,7043.01,0.00
2024-12-10 17:21:52,160,5762,84,76,3734.62,7043.09,0.00
2024-12-10 17:21:52,159,5762,84,75,3768.01,7043.13,0.00
2024-12-10 17:21:52,158,5762,84,74,3791.41,7043.13,0.00
2024-12-10 17:21:52,159,5761,85,74,3696.71,7043.91,0.00
2024-12-10 17:21:52,159,5762,85,74,3780.02,7044.00,0.00
2024-12-10 17:21:52,160,5762,85,75,3756.40,7044.01,0.00
2024-12-10 17:21:52,159,5762,85,74,3777.37,7044.04,0.00
2024-12-10 17:21:52,158,5762,84,74,3793.96,7044.12,0.00
2024-12-10 17:21:52,157,5762,83,74,3814.25,7044.15,0.00
2024-12-10 17:21:52,158,5761,83,75,3774.32,7044.39,0.00
2024-12-10 17:21:52,158,5762,83,75,3860.85,7045.00,0.00
2024-12-10 17:21:52,159,5762,84,75,3836.57,7045.01,0.00
2024-12-10 17:21:52,159,5763,84,75,3836.77,7046.00,0.00
2024-12-10 17:21:52,160,5763,84,76,3812.79,7046.01,0.00
2024-12-10 17:21:52,159,5763,84,75,3835.89,7046.01,0.00
2024-12-10 17:21:53,159,5764,84,75,3792.55,7047.00,0.00
2024-12-10 17:21:53,160,5764,84,76,3768.84,7047.01,0.00
2024-12-10 17:21:53,161,5763,85,76,3745.00,7047.03,0.00
2024-12-10 17:21:53,160,5763,85,75,3797.54,7047.13,0.00
2024-12-10 17:21:53,159,5763,85,74,3784.71,7047.62,0.00
2024-12-10 17:21:53,160,5762,85,75,3753.63,7047.74,0.00
2024-12-10 17:21:53,160,5763,85,75,3793.70,7048.00,0.00
2024-12-10 17:21:53,161,5763,86,75,3770.13,7048.01,0.00
2024-12-10 17:21:53,160,5763,85,75,3789.75,7048.06,0.00
2024-12-10 17:21:53,159,5763,84,75,3805.79,7048.13,0.00
2024-12-10 17:21:53,160,5762,85,75,3721.31,7048.82,0.00
2024-12-10 17:21:53,160,5763,85,75,3850.35,7049.00,0.00
2024-12-10 17:21:53,161,5763,86,75,3826.44,7049.01,0.00
2024-12-10 17:21:53,160,5763,85,75,3842.62,7049.08,0.00
2024-12-10 17:21:53,161,5762,85,76,3808.35,7049.23,0.00
2024-12-10 17:21:53,160,5762,85,75,3823.63,7049.73,0.00
2024-12-10 17:21:53,160,5763,85,75,3879.21,7050.00,0.00
2024-12-10 17:21:53,161,5763,85,76,3855.12,7050.01,0.00
2024-12-10 17:21:53,162,5762,85,77,3825.27,7050.11,0.00
2024-12-10 17:21:53,161,5762,85,76,3854.30,7050.12,0.00
2024-12-10 17:21:53,161,5763,85,76,3854.69,7051.00,0.00
2024-12-10 17:21:53,162,5763,86,76,3830.90,7051.01,0.00
2024-12-10 17:21:53,161,5763,86,75,3846.43,7051.12,0.00
2024-12-10 17:21:53,161,5764,86,75,3846.40,7052.00,0.00
2024-12-10 17:21:53,162,5764,86,76,3822.65,7052.01,0.00
2024-12-10 17:21:53,161,5764,86,75,3838.13,7052.12,0.00
2024-12-10 17:21:53,162,5763,86,76,3726.14,7052.96,0.00
2024-12-10 17:21:53,162,5764,86,76,3768.41,7053.00,0.00
2024-12-10 17:21:53,163,5764,87,76,3745.29,7053.01,0.00
2024-12-10 17:21:53,162,5764,87,75,3767.11,7053.02,0.00
2024-12-10 17:21:53,161,5764,86,75,3783.54,7053.11,0.00
2024-12-10 17:21:53,160,5764,85,75,3806.75,7053.11,0.00
2024-12-10 17:21:53,159,5764,85,74,3830.25,7053.11,0.00
2024-12-10 17:21:53,158,5764,85,73,3853.01,7053.13,0.00
2024-12-10 17:21:53,157,5764,85,72,3876.45,7053.14,0.00
2024-12-10 17:21:53,156,5764,84,72,3838.87,7053.77,0.00
2024-12-10 17:21:53,156,5765,84,72,3902.44,7054.00,0.00
2024-12-10 17:21:53,157,5765,85,72,3877.59,7054.01,0.00
2024-12-10 17:21:53,156,5765,84,72,3895.71,7054.10,0.00
2024-12-10 17:21:53,155,5765,83,72,3919.48,7054.11,0.00
2024-12-10 17:21:53,154,5765,83,71,3924.01,7054.36,0.00
2024-12-10 17:21:53,153,5765,83,70,3923.88,7054.65,0.00
2024-12-10 17:21:53,153,5766,83,70,3930.23,7055.00,0.00
2024-12-10 17:21:53,154,5766,83,71,3904.71,7055.01,0.00
2024-12-10 17:21:53,153,5766,82,71,3922.44,7055.11,0.00
2024-12-10 17:21:53,154,5765,82,72,3894.24,7055.16,0.00
2024-12-10 17:21:53,154,5766,82,72,3864.81,7056.00,0.00
2024-12-10 17:21:53,155,5766,82,73,3839.87,7056.01,0.00
2024-12-10 17:21:53,154,5766,81,73,3857.07,7056.11,0.00
2024-12-10 17:21:53,153,5766,81,72,3806.88,7056.92,0.00
2024-12-10 17:21:53,153,5767,81,72,3892.00,7057.00,0.00
2024-12-10 17:21:53,154,5767,82,72,3866.72,7057.01,0.00
2024-12-10 17:21:53,153,5767,81,72,3889.70,7057.03,0.00
2024-12-10 17:21:53,152,5767,81,71,3909.76,7057.11,0.00
2024-12-10 17:21:53,153,5766,81,72,3840.46,7057.67,0.00
2024-12-10 17:21:53,154,5765,81,73,3806.47,7057.84,0.00
2024-12-10 17:21:53,154,5766,81,73,3846.50,7058.00,0.00
2024-12-10 17:21:53,155,5766,82,73,3821.68,7058.01,0.00
2024-12-10 17:21:53,154,5766,82,72,3838.73,7058.12,0.00
2024-12-10 17:21:53,155,5765,82,73,3792.26,7058.39,0.00
2024-12-10 17:21:53,154,5765,81,73,3810.59,7058.71,0.00
2024-12-10 17:21:53,154,5766,81,73,3924.38,7059.00,0.00
2024-12-10 17:21:53,155,5766,81,74,3899.06,7059.01,0.00
2024-12-10 17:21:53,154,5766,81,73,3918.91,7059.08,0.00
2024-12-10 17:21:53,155,5765,82,73,3833.43,7059.79,0.00
2024-12-10 17:21:53,155,5766,82,73,3915.64,7060.00,0.00
2024-12-10 17:21:53,156,5766,83,73,3890.54,7060.01,0.00
2024-12-10 17:21:53,155,5766,82,73,3896.34,7060.24,0.00
2024-12-10 17:21:53,155,5767,82,73,3922.96,7061.00,0.00
2024-12-10 17:21:53,156,5767,83,73,3897.82,7061.01,0.00
2024-12-10 17:21:53,156,5768,83,73,3861.84,7062.00,0.00
2024-12-10 17:21:53,157,5768,84,73,3837.24,7062.01,0.00
2024-12-10 17:21:53,156,5768,84,72,3848.13,7062.20,0.00
2024-12-10 17:21:53,157,5767,84,73,3793.90,7062.57,0.00
2024-12-10 17:21:53,158,5766,84,74,3787.34,7062.61,0.00
2024-12-10 17:21:53,158,5767,84,74,3805.76,7063.00,0.00
2024-12-10 17:21:53,159,5767,85,74,3781.83,7063.01,0.00
2024-12-10 17:21:53,158,5767,84,74,3803.54,7063.03,0.00
2024-12-10 17:21:53,157,5767,83,74,3821.52,7063.12,0.00
2024-12-10 17:21:53,156,5767,82,74,3845.56,7063.12,0.00
2024-12-10 17:21:53,155,5767,81,74,3814.47,7063.70,0.00
2024-12-10 17:21:53,155,5768,81,74,3923.69,7064.00,0.00
2024-12-10 17:21:53,156,5768,81,75,3898.54,7064.01,0.00
2024-12-10 17:21:53,155,5768,81,74,3914.94,7064.12,0.00
2024-12-10 17:21:53,154,5768,81,73,3938.66,7064.13,0.00
2024-12-10 17:21:53,153,5768,80,73,3958.85,7064.21,0.00
2024-12-10 17:21:53,152,5768,80,72,3968.40,7064.39,0.00
2024-12-10 17:21:53,153,5767,80,73,3930.35,7064.57,0.00
2024-12-10 17:21:53,152,5767,79,73,3955.18,7064.74,0.00
2024-12-10 17:21:53,152,5768,79,73,3981.99,7065.00,0.00
2024-12-10 17:21:53,153,5768,79,74,3955.96,7065.01,0.00
2024-12-10 17:21:53,154,5767,79,75,3926.63,7065.07,0.00
2024-12-10 17:21:53,153,5767,78,75,3966.87,7065.12,0.00
2024-12-10 17:21:53,152,5767,77,75,3984.97,7065.22,0.00
2024-12-10 17:21:53,152,5768,77,75,4014.17,7066.00,0.00
2024-12-10 17:21:53,153,5768,77,76,3987.93,7066.01,0.00
2024-12-10 17:21:53,152,5768,76,76,4013.71,7066.01,0.00
2024-12-10 17:21:53,151,5768,75,76,4038.89,7066.02,0.00
2024-12-10 17:21:53,151,5769,75,76,4050.35,7067.00,0.00
2024-12-10 17:21:53,152,5769,75,77,4023.70,7067.01,0.00
2024-12-10 17:21:53,151,5769,74,77,4039.06,7067.11,0.00
2024-12-10 17:21:54,151,5770,74,77,4012.22,7068.00,0.00
2024-12-10 17:21:54,152,5770,75,77,3985.83,7068.01,0.00
2024-12-10 17:21:54,151,5770,74,77,4000.04,7068.11,0.00
2024-12-10 17:21:54,151,5771,74,77,3972.18,7069.00,0.00
2024-12-10 17:21:54,152,5771,75,77,3946.04,7069.01,0.00
2024-12-10 17:21:54,151,5771,75,76,3959.94,7069.11,0.00
2024-12-10 17:21:54,151,5772,75,76,3927.13,7070.00,0.00
2024-12-10 17:21:54,152,5772,75,77,3901.29,7070.01,0.00
2024-12-10 17:21:54,151,5772,74,77,3914.80,7070.11,0.00
2024-12-10 17:21:54,150,5772,74,76,3906.20,7070.53,0.00
2024-12-10 17:21:54,150,5773,74,76,3905.73,7071.00,0.00
2024-12-10 17:21:54,151,5773,74,77,3879.86,7071.01,0.00
2024-12-10 17:21:54,150,5773,73,77,3893.39,7071.11,0.00
2024-12-10 17:21:54,149,5773,72,77,3879.37,7071.58,0.00
2024-12-10 17:21:54,149,5774,72,77,3892.86,7072.00,0.00
2024-12-10 17:21:54,150,5774,73,77,3866.91,7072.01,0.00
2024-12-10 17:21:54,149,5774,72,77,3880.45,7072.11,0.00
2024-12-10 17:21:54,148,5774,71,77,3870.73,7072.55,0.00
2024-12-10 17:21:54,149,5773,72,77,3825.46,7072.79,0.00
2024-12-10 17:21:54,149,5774,72,77,3867.34,7073.00,0.00
2024-12-10 17:21:54,150,5774,73,77,3841.56,7073.01,0.00
2024-12-10 17:21:54,151,5773,73,78,3766.19,7073.60,0.00
2024-12-10 17:21:54,152,5772,73,79,3724.93,7073.97,0.00
2024-12-10 17:21:54,152,5773,73,79,3817.57,7074.00,0.00
2024-12-10 17:21:54,153,5773,73,80,3792.62,7074.01,0.00
2024-12-10 17:21:54,152,5773,73,79,3805.35,7074.11,0.00
2024-12-10 17:21:54,152,5774,73,79,3871.12,7075.00,0.00
2024-12-10 17:21:54,153,5774,74,79,3845.82,7075.01,0.00
2024-12-10 17:21:54,154,5773,74,80,3819.94,7075.03,0.00
2024-12-10 17:21:54,153,5773,73,80,3877.18,7075.10,0.00
2024-12-10 17:21:54,152,5773,73,79,3900.39,7075.11,0.00
2024-12-10 17:21:54,153,5772,74,79,3872.12,7075.16,0.00
2024-12-10 17:21:54,154,5771,75,79,3853.41,7075.57,0.00
2024-12-10 17:21:54,154,5772,75,79,3880.05,7076.00,0.00
2024-12-10 17:21:54,155,5772,75,80,3855.02,7076.01,0.00
2024-12-10 17:21:54,154,5772,74,80,3870.95,7076.10,0.00
2024-12-10 17:21:54,153,5772,73,80,3883.56,7076.22,0.00
2024-12-10 17:21:54,152,5772,73,79,3874.82,7076.61,0.00
2024-12-10 17:21:54,152,5773,73,79,4027.70,7077.00,0.00
2024-12-10 17:21:54,153,5773,73,80,4001.38,7077.01,0.00
2024-12-10 17:21:54,152,5773,73,79,4018.24,7077.11,0.00
2024-12-10 17:21:54,151,5773,72,79,4044.39,7077.11,0.00
2024-12-10 17:21:54,152,5772,73,79,3985.74,7077.47,0.00
2024-12-10 17:21:54,153,5771,74,79,3946.85,7077.71,0.00
2024-12-10 17:21:54,154,5770,75,79,3915.13,7077.92,0.00
2024-12-10 17:21:54,154,5771,75,79,3958.42,7078.00,0.00
2024-12-10 17:21:54,155,5771,76,79,3932.88,7078.01,0.00
2024-12-10 17:21:54,155,5772,76,79,4025.68,7079.00,0.00
2024-12-10 17:21:54,156,5772,77,79,3999.88,7079.01,0.00
2024-12-10 17:21:54,155,5772,76,79,4015.93,7079.10,0.00
2024-12-10 17:21:54,156,5771,76,80,3988.84,7079.14,0.00
2024-12-10 17:21:54,156,5772,76,80,3995.75,7080.00,0.00
2024-12-10 17:21:54,157,5772,77,80,3970.30,7080.01,0.00
2024-12-10 17:21:54,156,5772,76,80,3988.19,7080.10,0.00
2024-12-10 17:21:54,155,5772,76,79,3996.60,7080.25,0.00
2024-12-10 17:21:54,156,5771,77,79,3964.65,7080.35,0.00
2024-12-10 17:21:54,155,5771,77,78,4012.80,7080.43,0.00
2024-12-10 17:21:54,155,5772,77,78,4048.67,7081.00,0.00
2024-12-10 17:21:54,156,5772,78,78,4022.71,7081.01,0.00
2024-12-10 17:21:54,157,5771,78,79,3994.86,7081.05,0.00
2024-12-10 17:21:54,156,5771,77,79,4035.48,7081.10,0.00
2024-12-10 17:21:54,155,5771,77,78,4006.94,7081.63,0.00
2024-12-10 17:21:54,155,5772,77,78,4066.98,7082.00,0.00
2024-12-10 17:21:54,156,5772,78,78,4040.91,7082.01,0.00
2024-12-10 17:21:54,155,5772,77,78,4060.17,7082.10,0.00
2024-12-10 17:21:54,154,5772,76,78,4048.09,7082.54,0.00
2024-12-10 17:21:54,154,5773,76,78,4099.11,7083.00,0.00
2024-12-10 17:21:54,155,5773,76,79,4072.67,7083.01,0.00
2024-12-10 17:21:54,154,5773,75,79,4082.28,7083.22,0.00
2024-12-10 17:21:54,155,5772,76,79,4023.59,7083.65,0.00
2024-12-10 17:21:54,154,5772,76,78,4052.48,7083.67,0.00
2024-12-10 17:21:54,155,5771,77,78,4011.18,7083.89,0.00
2024-12-10 17:21:54,155,5772,77,78,4052.88,7084.00,0.00
2024-12-10 17:21:54,156,5772,77,79,4026.90,7084.01,0.00
2024-12-10 17:21:54,155,5772,77,78,4041.88,7084.16,0.00
2024-12-10 17:21:54,156,5771,78,78,3979.18,7084.65,0.00
2024-12-10 17:21:54,157,5770,78,79,3962.47,7084.74,0.00
2024-12-10 17:21:54,157,5771,78,79,4089.19,7085.00,0.00
2024-12-10 17:21:54,158,5771,78,80,4063.31,7085.01,0.00
2024-12-10 17:21:54,157,5771,78,79,4081.58,7085.11,0.00
2024-12-10 17:21:54,158,5770,79,79,4055.30,7085.13,0.00
2024-12-10 17:21:54,158,5771,79,79,4143.61,7086.00,0.00
2024-12-10 17:21:54,159,5771,79,80,4117.55,7086.01,0.00
2024-12-10 17:21:55,159,5772,79,80,4131.56,7087.00,0.00
2024-12-10 17:21:55,160,5772,80,80,4105.74,7087.01,0.00
2024-12-10 17:21:55,161,5771,81,80,4079.80,7087.03,0.00
2024-12-10 17:21:55,160,5771,80,80,4121.13,7087.13,0.00
2024-12-10 17:21:55,161,5770,81,80,4039.00,7087.86,0.00
2024-12-10 17:21:55,161,5771,81,80,4078.31,7088.00,0.00
2024-12-10 17:21:55,162,5771,81,81,4053.14,7088.01,0.00
2024-12-10 17:21:55,161,5771,81,80,4070.01,7088.12,0.00
2024-12-10 17:21:55,160,5771,81,79,4091.07,7088.18,0.00
2024-12-10 17:21:55,159,5771,80,79,4114.41,7088.21,0.00
2024-12-10 17:21:55,160,5770,80,80,4072.32,7088.39,0.00
2024-12-10 17:21:55,160,5771,80,80,4193.51,7089.00,0.00
2024-12-10 17:21:55,161,5771,80,81,4167.46,7089.01,0.00
2024-12-10 17:21:55,160,5771,79,81,4185.16,7089.12,0.00
2024-12-10 17:21:55,160,5772,79,81,4202.84,7090.00,0.00
2024-12-10 17:21:55,161,5772,79,82,4176.73,7090.01,0.00
2024-12-10 17:21:55,160,5772,78,82,4194.04,7090.13,0.00
2024-12-10 17:21:55,160,5773,78,82,4167.18,7091.00,0.00
2024-12-10 17:21:55,161,5773,78,83,4141.29,7091.01,0.00
2024-12-10 17:21:55,160,5773,77,83,4138.32,7091.34,0.00
2024-12-10 17:21:55,160,5774,77,83,4134.55,7092.00,0.00
2024-12-10 17:21:55,161,5774,78,83,4108.87,7092.01,0.00
2024-12-10 17:21:55,160,5774,77,83,4125.75,7092.13,0.00
2024-12-10 17:21:55,159,5774,76,83,4141.04,7092.27,0.00
2024-12-10 17:21:55,160,5773,76,84,4089.75,7092.64,0.00
2024-12-10 17:21:55,160,5774,76,84,4120.11,7093.00,0.00
2024-12-10 17:21:55,161,5774,77,84,4094.52,7093.01,0.00
2024-12-10 17:21:55,160,5774,77,83,4111.31,7093.13,0.00
2024-12-10 17:21:55,161,5773,78,83,4075.23,7093.29,0.00
2024-12-10 17:21:55,161,5774,78,83,4149.22,7094.00,0.00
2024-12-10 17:21:55,162,5774,79,83,4123.60,7094.01,0.00
2024-12-10 17:21:55,161,5774,78,83,4140.47,7094.12,0.00
2024-12-10 17:21:55,161,5775,78,83,4161.30,7095.00,0.00
2024-12-10 17:21:55,162,5775,79,83,4135.61,7095.01,0.00
2024-12-10 17:21:55,161,5775,79,82,4156.49,7095.07,0.00
2024-12-10 17:21:55,160,5775,79,81,4177.87,7095.13,0.00
2024-12-10 17:21:55,160,5776,79,81,4155.76,7096.00,0.00
2024-12-10 17:21:55,161,5776,80,81,4129.95,7096.01,0.00
2024-12-10 17:21:55,160,5776,80,80,4146.42,7096.13,0.00
2024-12-10 17:21:55,159,5776,79,80,4172.41,7096.13,0.00
2024-12-10 17:21:55,159,5777,79,80,4152.94,7097.00,0.00
2024-12-10 17:21:55,160,5777,79,81,4126.99,7097.01,0.00
2024-12-10 17:21:55,160,5778,79,81,4098.67,7098.00,0.00
2024-12-10 17:21:55,161,5778,80,81,4073.21,7098.01,0.00
2024-12-10 17:21:55,161,5779,80,81,4044.62,7099.00,0.00
2024-12-10 17:21:55,162,5779,80,82,4019.65,7099.01,0.00
2024-12-10 17:21:55,163,5778,81,82,3929.71,7099.93,0.00
2024-12-10 17:21:55,163,5779,81,82,3976.40,7100.00,0.00
2024-12-10 17:21:55,164,5779,82,82,3952.16,7100.01,0.00
2024-12-10 17:21:55,163,5779,81,82,3966.70,7100.12,0.00
2024-12-10 17:21:55,164,5778,82,82,3926.55,7100.36,0.00
2024-12-10 17:21:55,164,5779,82,82,3978.31,7101.00,0.00
2024-12-10 17:21:55,165,5779,82,83,3954.20,7101.01,0.00
2024-12-10 17:21:55,164,5779,82,82,3969.36,7101.12,0.00
2024-12-10 17:21:55,165,5778,83,82,3929.49,7101.35,0.00
2024-12-10 17:21:55,166,5777,84,82,3902.42,7101.41,0.00
2024-12-10 17:21:55,167,5776,85,82,3881.28,7101.76,0.00
2024-12-10 17:21:55,167,5777,85,82,3965.26,7102.00,0.00
2024-12-10 17:21:55,168,5777,85,83,3941.66,7102.01,0.00
2024-12-10 17:21:55,167,5777,84,83,3959.82,7102.08,0.00
2024-12-10 17:21:55,166,5777,84,82,3980.70,7102.11,0.00
2024-12-10 17:21:55,166,5778,84,82,4083.90,7103.00,0.00
2024-12-10 17:21:55,167,5778,84,83,4059.44,7103.01,0.00
2024-12-10 17:21:55,168,5777,85,83,4030.24,7103.09,0.00
2024-12-10 17:21:55,167,5777,85,82,4063.34,7103.12,0.00
2024-12-10 17:21:55,167,5778,85,82,4038.94,7104.00,0.00
2024-12-10 17:21:55,168,5778,85,83,4014.89,7104.01,0.00
2024-12-10 17:21:55,168,5779,85,83,4023.06,7105.00,0.00
2024-12-10 17:21:55,169,5779,86,83,3999.26,7105.01,0.00
2024-12-10 17:21:55,170,5778,86,84,3971.58,7105.08,0.00
2024-12-10 17:21:55,169,5778,85,84,4018.32,7105.12,0.00
2024-12-10 17:21:55,169,5779,85,84,3987.82,7106.00,0.00
2024-12-10 17:21:55,170,5779,85,85,3964.36,7106.01,0.00
2024-12-10 17:21:55,169,5779,85,84,3979.89,7106.11,0.00
2024-12-10 17:21:55,168,5779,84,84,4003.15,7106.11,0.00
2024-12-10 17:21:55,168,5780,84,84,4014.80,7107.00,0.00
2024-12-10 17:21:55,169,5780,85,84,3991.05,7107.01,0.00
2024-12-10 17:21:55,168,5780,84,84,4011.44,7107.05,0.00
2024-12-10 17:21:55,167,5780,83,84,4031.11,7107.11,0.00
2024-12-10 17:21:55,167,5781,83,84,4002.57,7108.00,0.00
2024-12-10 17:21:55,168,5781,83,85,3978.75,7108.01,0.00
2024-12-10 17:21:55,167,5781,83,84,3994.97,7108.11,0.00
2024-12-10 17:21:55,168,5780,83,85,3958.88,7108.27,0.00
2024-12-10 17:21:55,169,5779,83,86,3967.19,7108.37,0.00
2024-12-10 17:21:55,169,5780,83,86,3986.63,7109.00,0.00
2024-12-10 17:21:55,170,5780,83,87,3963.18,7109.01,0.00
2024-12-10 17:21:55,170,5781,83,87,4013.82,7110.00,0.00
2024-12-10 17:21:55,171,5781,83,88,3990.35,7110.01,0.00
2024-12-10 17:21:55,172,5780,84,88,3964.28,7110.06,0.00
2024-12-10 17:21:55,173,5779,84,89,3905.79,7110.86,0.00
2024-12-10 17:21:56,173,5780,84,89,3941.91,7111.00,0.00
2024-12-10 17:21:56,174,5780,85,89,3919.26,7111.01,0.00
2024-12-10 17:21:56,173,5780,85,88,3935.63,7111.09,0.00
2024-12-10 17:21:56,172,5780,84,88,3957.28,7111.10,0.00
2024-12-10 17:21:56,171,5780,84,87,3980.00,7111.11,0.00
2024-12-10 17:21:56,170,5780,83,87,4003.00,7111.11,0.00
2024-12-10 17:21:56,169,5780,83,86,4018.24,7111.21,0.00
2024-12-10 17:21:56,169,5781,83,86,4084.31,7112.00,0.00
2024-12-10 17:21:56,170,5781,84,86,4060.29,7112.01,0.00
2024-12-10 17:21:56,169,5781,83,86,4076.79,7112.11,0.00
2024-12-10 17:21:56,168,5781,83,85,4086.02,7112.31,0.00
2024-12-10 17:21:56,168,5782,83,85,4077.95,7113.00,0.00
2024-12-10 17:21:56,169,5782,83,86,4053.82,7113.01,0.00
2024-12-10 17:21:56,168,5782,82,86,4069.96,7113.11,0.00
2024-12-10 17:21:56,168,5783,82,86,4044.98,7114.00,0.00
2024-12-10 17:21:56,169,5783,82,87,4021.05,7114.01,0.00
2024-12-10 17:21:56,170,5782,82,88,3968.25,7114.43,0.00
2024-12-10 17:21:56,170,5783,82,88,3989.35,7115.00,0.00
2024-12-10 17:21:56,171,5783,83,88,3966.02,7115.01,0.00
2024-12-10 17:21:56,172,5782,84,88,3939.68,7115.06,0.00
2024-12-10 17:21:56,171,5782,84,87,3991.46,7115.12,0.00
2024-12-10 17:21:56,172,5781,85,87,3913.10,7115.86,0.00
2024-12-10 17:21:56,172,5782,85,87,3990.54,7116.00,0.00
2024-12-10 17:21:56,173,5782,85,88,3967.47,7116.01,0.00
2024-12-10 17:21:56,172,5782,85,87,3982.32,7116.12,0.00
2024-12-10 17:21:56,173,5781,85,88,3946.99,7116.28,0.00
2024-12-10 17:21:56,173,5782,85,88,4047.21,7117.00,0.00
2024-12-10 17:21:56,174,5782,85,89,4023.95,7117.01,0.00
2024-12-10 17:21:56,173,5782,84,89,4039.63,7117.11,0.00
2024-12-10 17:21:56,172,5782,83,89,4062.45,7117.12,0.00
2024-12-10 17:21:56,172,5783,83,89,4078.01,7118.00,0.00
2024-12-10 17:21:56,173,5783,83,90,4054.43,7118.01,0.00
2024-12-10 17:21:56,174,5782,84,90,4025.86,7118.09,0.00
2024-12-10 17:21:56,173,5782,84,89,4080.83,7118.12,0.00
2024-12-10 17:21:56,172,5782,84,88,4092.28,7118.29,0.00
2024-12-10 17:21:56,172,5783,84,88,4080.44,7119.00,0.00
2024-12-10 17:21:56,173,5783,85,88,4056.85,7119.01,0.00
2024-12-10 17:21:56,172,5783,85,87,4071.81,7119.12,0.00
2024-12-10 17:21:56,172,5784,85,87,4089.85,7120.00,0.00
2024-12-10 17:21:56,173,5784,85,88,4066.21,7120.01,0.00
2024-12-10 17:21:56,172,5784,84,88,4081.53,7120.12,0.00
2024-12-10 17:21:56,171,5784,83,88,4104.98,7120.12,0.00
2024-12-10 17:21:56,172,5783,83,89,4079.47,7120.16,0.00
2024-12-10 17:21:56,171,5783,83,88,4125.87,7120.31,0.00
2024-12-10 17:21:56,171,5784,83,88,4115.49,7121.00,0.00
2024-12-10 17:21:56,172,5784,83,89,4091.56,7121.01,0.00
2024-12-10 17:21:56,173,5783,83,90,4060.97,7121.12,0.00
2024-12-10 17:21:56,173,5784,83,90,4089.73,7122.00,0.00
2024-12-10 17:21:56,174,5784,83,91,4066.23,7122.01,0.00
2024-12-10 17:21:56,174,5785,83,91,4069.23,7123.00,0.00
2024-12-10 17:21:56,175,5785,83,92,4045.98,7123.01,0.00
2024-12-10 17:21:56,176,5784,84,92,3996.65,7123.37,0.00
2024-12-10 17:21:56,175,5784,83,92,4009.05,7123.81,0.00
2024-12-10 17:21:56,175,5785,83,92,4036.09,7124.00,0.00
2024-12-10 17:21:56,176,5785,84,92,4013.15,7124.01,0.00
2024-12-10 17:21:56,175,5785,83,92,4027.60,7124.12,0.00
2024-12-10 17:21:56,175,5786,83,92,4040.99,7125.00,0.00
2024-12-10 17:21:56,176,5786,84,92,4018.03,7125.01,0.00
2024-12-10 17:21:56,177,5785,85,92,3968.68,7125.37,0.00
2024-12-10 17:21:56,178,5784,86,92,3944.85,7125.55,0.00
2024-12-10 17:21:56,178,5785,86,92,3968.51,7126.00,0.00
2024-12-10 17:21:56,179,5785,86,93,3946.34,7126.01,0.00
2024-12-10 17:21:56,178,5785,85,93,3947.90,7126.27,0.00
2024-12-10 17:21:56,178,5786,85,93,4012.41,7127.00,0.00
2024-12-10 17:21:56,179,5786,86,93,3990.00,7127.01,0.00
2024-12-10 17:21:56,180,5785,87,93,3965.47,7127.05,0.00
2024-12-10 17:21:56,179,5785,87,92,4006.12,7127.13,0.00
2024-12-10 17:21:56,179,5786,87,92,3980.54,7128.00,0.00
2024-12-10 17:21:56,180,5786,87,93,3958.42,7128.01,0.00
2024-12-10 17:21:56,179,5786,87,92,3971.84,7128.12,0.00
2024-12-10 17:21:56,180,5785,87,93,3901.39,7128.76,0.00
2024-12-10 17:21:56,180,5786,87,93,3973.67,7129.00,0.00
2024-12-10 17:21:56,181,5786,88,93,3951.72,7129.01,0.00
2024-12-10 17:21:56,181,5787,88,93,3954.41,7130.00,0.00
2024-12-10 17:21:56,182,5787,88,94,3932.69,7130.01,0.00
2024-12-10 17:21:56,181,5787,88,93,3945.42,7130.13,0.00
2024-12-10 17:21:56,181,5788,88,93,3914.76,7131.00,0.00
2024-12-10 17:21:56,182,5788,89,93,3893.25,7131.01,0.00
2024-12-10 17:21:56,181,5788,89,92,3866.86,7131.61,0.00
2024-12-10 17:21:56,182,5787,89,93,3827.10,7131.84,0.00
2024-12-10 17:21:56,182,5788,89,93,3861.74,7132.00,0.00
2024-12-10 17:21:56,183,5788,90,93,3840.64,7132.01,0.00
2024-12-10 17:21:56,182,5788,89,93,3857.46,7132.06,0.00
2024-12-10 17:21:56,183,5787,90,93,3832.51,7132.13,0.00
2024-12-10 17:21:56,182,5787,90,92,3867.21,7132.13,0.00
2024-12-10 17:21:56,182,5788,90,92,3877.26,7133.00,0.00
2024-12-10 17:21:56,183,5788,90,93,3856.07,7133.01,0.00
2024-12-10 17:21:56,182,5788,90,92,3868.31,7133.13,0.00
2024-12-10 17:21:56,183,5787,91,92,3819.43,7133.50,0.00
2024-12-10 17:21:56,183,5788,91,92,3879.09,7134.00,0.00
2024-12-10 17:21:56,184,5788,92,92,3858.00,7134.01,0.00
2024-12-10 17:21:56,183,5788,91,92,3877.14,7134.03,0.00
2024-12-10 17:21:56,182,5788,90,92,3891.06,7134.13,0.00
2024-12-10 17:21:56,181,5788,89,92,3911.77,7134.13,0.00
2024-12-10 17:21:56,180,5788,88,92,3933.10,7134.13,0.00
2024-12-10 17:21:57,179,5788,87,92,3949.18,7134.21,0.00
2024-12-10 17:21:57,180,5787,88,92,3909.90,7134.41,0.00
2024-12-10 17:21:57,180,5788,88,92,3968.33,7135.00,0.00
2024-12-10 17:21:57,181,5788,89,92,3946.40,7135.01,0.00
2024-12-10 17:21:57,180,5788,89,91,3959.05,7135.13,0.00
2024-12-10 17:21:57,181,5787,90,91,3934.42,7135.18,0.00
2024-12-10 17:21:57,181,5788,90,91,3959.48,7136.00,0.00
2024-12-10 17:21:57,182,5788,90,92,3937.73,7136.01,0.00
2024-12-10 17:21:57,183,5787,90,93,3896.05,7136.30,0.00
2024-12-10 17:21:57,184,5786,91,93,3895.86,7136.52,0.00
2024-12-10 17:21:57,184,5787,91,93,3967.41,7137.00,0.00
2024-12-10 17:21:57,185,5787,91,94,3945.97,7137.01,0.00
2024-12-10 17:21:57,184,5787,91,93,3958.17,7137.13,0.00
2024-12-10 17:21:57,184,5788,91,93,4003.06,7138.00,0.00
2024-12-10 17:21:57,185,5788,91,94,3981.43,7138.01,0.00
2024-12-10 17:21:57,186,5787,92,94,3956.59,7138.06,0.00
2024-12-10 17:21:57,185,5787,92,93,3985.74,7138.14,0.00
2024-12-10 17:21:57,184,5787,92,92,4007.01,7138.14,0.00
2024-12-10 17:21:57,185,5786,92,93,3961.65,7138.43,0.00
2024-12-10 17:21:57,186,5785,93,93,3963.39,7138.45,0.00
2024-12-10 17:21:57,186,5786,93,93,3985.83,7139.00,0.00
2024-12-10 17:21:57,187,5786,94,93,3964.51,7139.01,0.00
2024-12-10 17:21:57,187,5787,94,93,4036.83,7140.00,0.00
2024-12-10 17:21:57,188,5787,95,93,4015.36,7140.01,0.00
2024-12-10 17:21:57,189,5786,96,93,3992.98,7140.03,0.00
2024-12-10 17:21:57,188,5786,96,92,4027.80,7140.31,0.00
2024-12-10 17:21:57,188,5787,96,92,4010.46,7141.00,0.00
2024-12-10 17:21:57,189,5787,97,92,3989.24,7141.01,0.00
2024-12-10 17:21:57,189,5788,97,92,3983.27,7142.00,0.00
2024-12-10 17:21:57,190,5788,97,93,3962.31,7142.01,0.00
2024-12-10 17:21:57,189,5788,96,93,3977.65,7142.08,0.00
2024-12-10 17:21:57,188,5788,96,92,3994.28,7142.14,0.00
2024-12-10 17:21:57,187,5788,95,92,4008.15,7142.24,0.00
2024-12-10 17:21:57,187,5789,95,92,3980.60,7143.00,0.00
2024-12-10 17:21:57,188,5789,96,92,3959.43,7143.01,0.00
2024-12-10 17:21:57,187,5789,95,92,3970.36,7143.15,0.00
2024-12-10 17:21:57,188,5788,96,92,3943.93,7143.23,0.00
2024-12-10 17:21:57,189,5787,96,93,3896.66,7143.69,0.00
2024-12-10 17:21:57,190,5786,96,94,3868.75,7143.95,0.00
2024-12-10 17:21:57,190,5787,96,94,3913.76,7144.00,0.00
2024-12-10 17:21:57,191,5787,97,94,3893.27,7144.01,0.00
2024-12-10 17:21:57,190,5787,97,93,3903.68,7144.14,0.00
2024-12-10 17:21:57,189,5787,97,92,3890.75,7144.52,0.00
2024-12-10 17:21:57,189,5788,97,92,3997.63,7145.00,0.00
2024-12-10 17:21:57,190,5788,98,92,3976.59,7145.01,0.00
2024-12-10 17:21:57,189,5788,97,92,3987.77,7145.14,0.00
2024-12-10 17:21:57,189,5789,97,92,3944.58,7146.00,0.00
2024-12-10 17:21:57,190,5789,98,92,3923.82,7146.01,0.00
2024-12-10 17:21:57,189,5789,98,91,3934.58,7146.14,0.00
2024-12-10 17:21:57,190,5788,98,92,3908.32,7146.22,0.00
2024-12-10 17:21:57,189,5788,98,91,3933.21,7146.26,0.00
2024-12-10 17:21:57,190,5787,98,92,3908.75,7146.32,0.00
2024-12-10 17:21:57,191,5786,99,92,3863.59,7146.67,0.00
2024-12-10 17:21:57,191,5787,99,92,3878.73,7147.00,0.00
2024-12-10 17:21:57,192,5787,99,93,3858.53,7147.01,0.00
2024-12-10 17:21:57,191,5787,99,92,3878.36,7147.01,0.00
2024-12-10 17:21:57,190,5787,98,92,3889.06,7147.14,0.00
2024-12-10 17:21:57,190,5788,98,92,3959.99,7148.00,0.00
2024-12-10 17:21:57,191,5788,98,93,3939.26,7148.01,0.00
2024-12-10 17:21:57,191,5789,98,93,3887.33,7149.00,0.00
2024-12-10 17:21:57,192,5789,99,93,3867.08,7149.01,0.00
2024-12-10 17:21:57,193,5788,99,94,3845.94,7149.03,0.00
2024-12-10 17:21:57,192,5788,98,94,3818.21,7149.89,0.00
2024-12-10 17:21:57,192,5789,98,94,3840.58,7150.00,0.00
2024-12-10 17:21:57,193,5789,99,94,3820.68,7150.01,0.00
2024-12-10 17:21:57,192,5789,99,93,3830.16,7150.15,0.00
2024-12-10 17:21:57,191,5789,98,93,3836.14,7150.30,0.00
2024-12-10 17:21:57,190,5789,98,92,3799.70,7150.95,0.00
2024-12-10 17:21:57,190,5790,98,92,3871.25,7151.00,0.00
2024-12-10 17:21:57,191,5790,98,93,3850.98,7151.01,0.00
2024-12-10 17:21:57,190,5790,97,93,3860.68,7151.15,0.00
2024-12-10 17:21:57,189,5790,96,93,3874.41,7151.22,0.00
2024-12-10 17:21:57,188,5790,95,93,3894.43,7151.23,0.00
2024-12-10 17:21:57,189,5789,95,94,3868.54,7151.31,0.00
2024-12-10 17:21:57,189,5790,95,94,3877.42,7152.00,0.00
2024-12-10 17:21:57,190,5790,96,94,3857.01,7152.01,0.00
2024-12-10 17:21:57,191,5789,96,95,3802.69,7152.44,0.00
2024-12-10 17:21:57,192,5788,96,96,3767.96,7152.91,0.00
2024-12-10 17:21:57,192,5789,96,96,3839.52,7153.00,0.00
2024-12-10 17:21:57,193,5789,97,96,3819.63,7153.01,0.00
2024-12-10 17:21:57,192,5789,96,96,3828.78,7153.15,0.00
2024-12-10 17:21:57,191,5789,96,95,3847.39,7153.17,0.00
2024-12-10 17:21:57,190,5789,95,95,3864.66,7153.20,0.00
2024-12-10 17:21:57,190,5790,95,95,3912.83,7154.00,0.00
2024-12-10 17:21:57,191,5790,95,96,3892.34,7154.01,0.00
2024-12-10 17:21:57,190,5790,94,96,3901.98,7154.15,0.00
2024-12-10 17:21:57,191,5789,94,97,3879.90,7154.18,0.00
2024-12-10 17:21:57,190,5789,94,96,3899.89,7154.23,0.00
2024-12-10 17:21:57,190,5790,94,96,3875.80,7155.00,0.00
2024-12-10 17:21:57,191,5790,94,97,3855.50,7155.01,0.00
2024-12-10 17:21:57,192,5789,95,97,3827.28,7155.13,0.00
2024-12-10 17:21:57,191,5789,95,96,3859.32,7155.16,0.00
2024-12-10 17:21:57,190,5789,95,95,3879.25,7155.16,0.00
2024-12-10 17:21:58,189,5789,95,94,3895.27,7155.22,0.00
2024-12-10 17:21:58,189,5790,95,94,3904.88,7156.00,0.00
2024-12-10 17:21:58,190,5790,95,95,3884.33,7156.01,0.00
2024-12-10 17:21:58,191,5789,95,96,3860.28,7156.07,0.00
2024-12-10 17:21:58,191,5790,95,96,3873.11,7157.00,0.00
2024-12-10 17:21:58,192,5790,95,97,3852.94,7157.01,0.00
2024-12-10 17:21:58,191,5790,94,97,3866.63,7157.09,0.00
2024-12-10 17:21:58,190,5790,94,96,3882.11,7157.15,0.00
2024-12-10 17:21:58,191,5789,95,96,3849.42,7157.32,0.00
2024-12-10 17:21:58,192,5788,96,96,3838.53,7157.58,0.00
2024-12-10 17:21:58,192,5789,96,96,3895.14,7158.00,0.00
2024-12-10 17:21:58,193,5789,96,97,3874.95,7158.01,0.00
2024-12-10 17:21:58,192,5789,96,96,3890.16,7158.07,0.00
2024-12-10 17:21:58,193,5788,96,97,3816.42,7158.76,0.00
2024-12-10 17:21:58,194,5787,96,98,3795.59,7158.95,0.00
2024-12-10 17:21:58,194,5788,96,98,3904.49,7159.00,0.00
2024-12-10 17:21:58,195,5788,96,99,3884.47,7159.01,0.00
2024-12-10 17:21:58,196,5787,96,100,3863.20,7159.04,0.00
2024-12-10 17:21:58,195,5787,96,99,3888.61,7159.11,0.00
2024-12-10 17:21:58,196,5786,96,100,3868.77,7159.12,0.00
2024-12-10 17:21:58,195,5786,96,99,3886.16,7159.16,0.00
2024-12-10 17:21:58,196,5785,97,99,3825.62,7159.67,0.00
2024-12-10 17:21:58,197,5784,97,100,3794.86,7159.93,0.00
2024-12-10 17:21:58,197,5785,97,100,3900.50,7160.00,0.00
2024-12-10 17:21:58,198,5785,97,101,3880.80,7160.01,0.00
2024-12-10 17:21:58,197,5785,97,100,3885.69,7160.19,0.00
2024-12-10 17:21:58,196,5785,96,100,3881.61,7160.48,0.00
2024-12-10 17:21:58,195,5785,96,99,3897.06,7160.51,0.00
2024-12-10 17:21:58,196,5784,96,100,3842.49,7160.92,0.00
2024-12-10 17:21:58,196,5785,96,100,4021.05,7161.00,0.00
2024-12-10 17:21:58,197,5785,97,100,4000.64,7161.01,0.00
2024-12-10 17:21:58,196,5785,96,100,4008.97,7161.15,0.00
2024-12-10 17:21:58,195,5785,96,99,3974.49,7161.82,0.00
2024-12-10 17:21:58,195,5786,96,99,4034.24,7162.00,0.00
2024-12-10 17:21:58,196,5786,97,99,4013.66,7162.01,0.00
2024-12-10 17:21:58,195,5786,97,98,4028.56,7162.08,0.00
2024-12-10 17:21:58,194,5786,97,97,4042.96,7162.15,0.00
2024-12-10 17:21:58,194,5787,97,97,4014.00,7163.00,0.00
2024-12-10 17:21:58,195,5787,98,97,3993.42,7163.01,0.00
2024-12-10 17:21:58,196,5786,98,98,3956.00,7163.24,0.00
2024-12-10 17:21:58,197,5785,98,99,3896.33,7164.00,0.00
2024-12-10 17:21:58,197,5786,98,99,3932.70,7164.00,0.00
2024-12-10 17:21:58,198,5786,99,99,3912.84,7164.01,0.00
2024-12-10 17:21:58,197,5786,99,98,3920.78,7164.15,0.00
2024-12-10 17:21:58,198,5785,100,98,3845.67,7164.84,0.00
2024-12-10 17:21:58,198,5786,100,98,3946.07,7165.00,0.00
2024-12-10 17:21:58,199,5786,100,99,3926.24,7165.01,0.00
2024-12-10 17:21:58,198,5786,100,98,3934.12,7165.15,0.00
2024-12-10 17:21:58,197,5786,100,97,3953.72,7165.15,0.00
2024-12-10 17:21:58,197,5787,100,97,3953.94,7166.00,0.00
2024-12-10 17:21:58,198,5787,100,98,3933.97,7166.01,0.00
2024-12-10 17:21:58,198,5788,100,98,3885.05,7167.00,0.00
2024-12-10 17:21:58,199,5788,100,99,3865.53,7167.01,0.00
2024-12-10 17:21:58,198,5788,99,99,3867.21,7167.22,0.00
2024-12-10 17:21:58,197,5788,98,99,3886.35,7167.22,0.00
2024-12-10 17:21:58,196,5788,97,99,3892.84,7167.39,0.00
2024-12-10 17:21:58,196,5789,97,99,3879.12,7168.00,0.00
2024-12-10 17:21:58,197,5789,98,99,3859.43,7168.01,0.00
2024-12-10 17:21:58,197,5790,98,99,3812.20,7169.00,0.00
2024-12-10 17:21:58,198,5790,99,99,3792.94,7169.01,0.00
2024-12-10 17:21:58,197,5790,98,99,3808.55,7169.05,0.00
2024-12-10 17:21:58,196,5790,97,99,3785.23,7169.58,0.00
2024-12-10 17:21:58,196,5791,97,99,3791.13,7170.00,0.00
2024-12-10 17:21:58,197,5791,97,100,3771.88,7170.01,0.00
2024-12-10 17:21:58,196,5791,97,99,3782.71,7170.12,0.00
2024-12-10 17:21:58,195,5791,97,98,3797.09,7170.15,0.00
2024-12-10 17:21:58,195,5792,97,98,3769.56,7171.00,0.00
2024-12-10 17:21:58,196,5792,97,99,3750.33,7171.01,0.00
2024-12-10 17:21:58,196,5793,97,99,3709.01,7172.00,0.00
2024-12-10 17:21:58,197,5793,97,100,3690.18,7172.01,0.00
2024-12-10 17:21:58,198,5792,97,101,3664.92,7172.09,0.00
2024-12-10 17:21:58,197,5792,96,101,3709.97,7172.16,0.00
2024-12-10 17:21:58,196,5792,95,101,3723.27,7172.24,0.00
2024-12-10 17:21:59,196,5793,95,101,3702.90,7173.00,0.00
2024-12-10 17:21:59,197,5793,95,102,3684.10,7173.01,0.00
2024-12-10 17:21:59,196,5793,94,102,3687.42,7173.14,0.00
2024-12-10 17:21:59,195,5793,94,101,3705.23,7173.15,0.00
2024-12-10 17:21:59,194,5793,94,100,3723.96,7173.15,0.00
2024-12-10 17:21:59,195,5792,95,100,3699.37,7173.24,0.00
2024-12-10 17:21:59,195,5793,95,100,3746.54,7174.00,0.00
2024-12-10 17:21:59,196,5793,95,101,3727.43,7174.01,0.00
2024-12-10 17:21:59,196,5794,95,101,3717.06,7175.00,0.00
2024-12-10 17:21:59,197,5794,96,101,3698.20,7175.01,0.00
2024-12-10 17:21:59,196,5794,96,100,3716.33,7175.01,0.00
2024-12-10 17:21:59,195,5794,96,99,3724.05,7175.12,0.00
2024-12-10 17:21:59,194,5794,96,98,3740.66,7175.15,0.00
2024-12-10 17:21:59,193,5794,95,98,3759.67,7175.15,0.00
2024-12-10 17:21:59,192,5794,94,98,3774.28,7175.21,0.00
2024-12-10 17:21:59,192,5795,94,98,3748.58,7176.00,0.00
2024-12-10 17:21:59,193,5795,94,99,3729.15,7176.01,0.00
2024-12-10 17:21:59,192,5795,93,99,3729.95,7176.21,0.00
2024-12-10 17:21:59,192,5796,93,99,3704.48,7177.00,0.00
2024-12-10 17:21:59,193,5796,93,100,3685.28,7177.01,0.00
2024-12-10 17:21:59,194,5795,94,100,3664.45,7177.04,0.00
2024-12-10 17:21:59,193,5795,93,100,3697.37,7177.11,0.00
2024-12-10 17:21:59,192,5795,92,100,3714.76,7177.13,0.00
2024-12-10 17:21:59,191,5795,91,100,3730.80,7177.17,0.00
2024-12-10 17:21:59,191,5796,91,100,3702.75,7178.00,0.00
2024-12-10 17:21:59,192,5796,92,100,3683.47,7178.01,0.00
2024-12-10 17:21:59,191,5796,91,100,3687.13,7178.16,0.00
2024-12-10 17:21:59,190,5796,91,99,3699.30,7178.25,0.00
2024-12-10 17:21:59,191,5795,91,100,3633.14,7178.88,0.00
2024-12-10 17:21:59,191,5796,91,100,3702.73,7179.00,0.00
2024-12-10 17:21:59,192,5796,91,101,3683.44,7179.01,0.00
2024-12-10 17:21:59,191,5796,91,100,3686.62,7179.16,0.00
2024-12-10 17:21:59,191,5797,91,100,3694.45,7180.00,0.00
2024-12-10 17:21:59,192,5797,91,101,3675.21,7180.01,0.00
2024-12-10 17:21:59,191,5797,90,101,3687.22,7180.05,0.00
2024-12-10 17:21:59,190,5797,90,100,3702.49,7180.10,0.00
2024-12-10 17:21:59,189,5797,89,100,3717.55,7180.16,0.00
2024-12-10 17:21:59,189,5798,89,100,3687.96,7181.00,0.00
2024-12-10 17:21:59,190,5798,89,101,3668.55,7181.01,0.00
2024-12-10 17:21:59,189,5798,89,100,3676.63,7181.16,0.00
2024-12-10 17:21:59,190,5797,90,100,3642.45,7181.36,0.00
2024-12-10 17:21:59,191,5796,91,100,3594.44,7181.86,0.00
2024-12-10 17:21:59,191,5797,91,100,3631.72,7182.00,0.00
2024-12-10 17:21:59,192,5797,92,100,3612.81,7182.01,0.00
2024-12-10 17:21:59,191,5797,91,100,3585.31,7182.62,0.00
2024-12-10 17:21:59,191,5798,91,100,3667.93,7183.00,0.00
2024-12-10 17:21:59,192,5798,92,100,3648.83,7183.01,0.00
2024-12-10 17:21:59,191,5798,92,99,3659.33,7183.12,0.00
2024-12-10 17:21:59,192,5797,92,100,3583.87,7183.86,0.00
2024-12-10 17:21:59,192,5798,92,100,3626.97,7184.00,0.00
2024-12-10 17:21:59,193,5798,93,100,3608.18,7184.01,0.00
2024-12-10 17:21:59,192,5798,92,100,3619.16,7184.11,0.00
2024-12-10 17:21:59,191,5798,92,99,3634.37,7184.16,0.00
2024-12-10 17:21:59,190,5798,91,99,3653.12,7184.16,0.00
2024-12-10 17:21:59,189,5798,91,98,3672.07,7184.16,0.00
2024-12-10 17:21:59,188,5798,90,98,3691.14,7184.17,0.00
2024-12-10 17:21:59,188,5799,90,98,3706.02,7185.00,0.00
2024-12-10 17:21:59,189,5799,90,99,3686.42,7185.01,0.00
2024-12-10 17:21:59,188,5799,90,98,3702.60,7185.05,0.00
2024-12-10 17:21:59,187,5799,90,97,3714.38,7185.16,0.00
2024-12-10 17:21:59,187,5800,90,97,3688.06,7186.00,0.00
2024-12-10 17:21:59,188,5800,90,98,3668.44,7186.01,0.00
2024-12-10 17:21:59,187,5800,90,97,3675.33,7186.18,0.00
2024-12-10 17:21:59,188,5799,91,97,3594.50,7186.94,0.00
2024-12-10 17:21:59,188,5800,91,97,3631.11,7187.00,0.00
2024-12-10 17:21:59,189,5800,91,98,3611.90,7187.01,0.00
2024-12-10 17:21:59,188,5800,90,98,3630.73,7187.01,0.00
2024-12-10 17:21:59,187,5800,89,98,3642.12,7187.11,0.00
2024-12-10 17:21:59,186,5800,88,98,3657.84,7187.15,0.00
2024-12-10 17:21:59,185,5800,87,98,3677.22,7187.15,0.00
2024-12-10 17:21:59,184,5800,86,98,3693.86,7187.20,0.00
2024-12-10 17:21:59,185,5799,86,99,3616.64,7187.96,0.00
2024-12-10 17:21:59,185,5800,86,99,3693.74,7188.00,0.00
2024-12-10 17:21:59,186,5800,86,100,3673.88,7188.01,0.00
2024-12-10 17:21:59,185,5800,86,99,3690.59,7188.05,0.00
2024-12-10 17:21:59,186,5799,86,100,3665.37,7188.13,0.00
2024-12-10 17:21:59,185,5799,86,99,3696.09,7188.15,0.00
2024-12-10 17:21:59,185,5800,86,99,3708.82,7189.00,0.00
2024-12-10 17:21:59,186,5800,87,99,3688.88,7189.01,0.00
2024-12-10 17:21:59,187,5799,88,99,3662.66,7189.11,0.00
2024-12-10 17:21:59,186,5799,88,98,3668.29,7189.53,0.00
2024-12-10 17:21:59,187,5798,88,99,3647.52,7189.55,0.00
2024-12-10 17:21:59,187,5799,88,99,3707.20,7190.00,0.00
2024-12-10 17:21:59,188,5799,89,99,3687.48,7190.01,0.00
2024-12-10 17:21:59,187,5799,88,99,3698.33,7190.13,0.00
2024-12-10 17:21:59,187,5800,88,99,3742.64,7191.00,0.00
2024-12-10 17:21:59,188,5800,88,100,3722.73,7191.01,0.00
2024-12-10 17:21:59,189,5799,89,100,3657.78,7191.64,0.00
2024-12-10 17:21:59,189,5800,89,100,3676.53,7192.00,0.00
2024-12-10 17:21:59,190,5800,90,100,3657.18,7192.01,0.00
2024-12-10 17:21:59,189,5800,89,100,3666.32,7192.14,0.00
2024-12-10 17:21:59,188,5800,89,99,3685.44,7192.14,0.00
2024-12-10 17:21:59,188,5801,89,99,3691.21,7193.00,0.00
2024-12-10 17:21:59,189,5801,89,100,3671.68,7193.01,0.00
2024-12-10 17:21:59,188,5801,88,100,3680.91,7193.14,0.00
2024-12-10 17:21:59,187,5801,88,99,3699.21,7193.16,0.00
2024-12-10 17:22:00,187,5802,88,99,3669.83,7194.00,0.00
2024-12-10 17:22:00,188,5802,88,100,3650.31,7194.01,0.00
2024-12-10 17:22:00,187,5802,87,100,3664.57,7194.08,0.00
2024-12-10 17:22:00,186,5802,86,100,3678.45,7194.15,0.00
2024-12-10 17:22:00,185,5802,86,99,3644.97,7194.76,0.00
2024-12-10 17:22:00,185,5803,86,99,3666.56,7195.00,0.00
2024-12-10 17:22:00,186,5803,86,100,3646.85,7195.01,0.00
2024-12-10 17:22:00,185,5803,85,100,3655.91,7195.15,0.00
2024-12-10 17:22:00,184,5803,84,100,3673.16,7195.18,0.00
2024-12-10 17:22:00,184,5804,84,100,3651.43,7196.00,0.00
2024-12-10 17:22:00,185,5804,84,101,3631.69,7196.01,0.00
2024-12-10 17:22:00,185,5805,84,101,3597.02,7197.00,0.00
2024-12-10 17:22:00,186,5805,85,101,3577.69,7197.01,0.00
2024-12-10 17:22:00,186,5806,85,101,3542.21,7198.00,0.00
2024-12-10 17:22:00,187,5806,86,101,3523.27,7198.01,0.00
2024-12-10 17:22:00,186,5806,85,101,3530.59,7198.15,0.00
2024-12-10 17:22:00,186,5807,85,101,3506.30,7199.00,0.00
2024-12-10 17:22:00,187,5807,86,101,3487.55,7199.01,0.00
2024-12-10 17:22:00,188,5806,86,102,3461.00,7199.13,0.00
2024-12-10 17:22:00,187,5806,86,101,3483.14,7199.14,0.00
2024-12-10 17:22:00,186,5806,85,101,3501.64,7199.14,0.00
2024-12-10 17:22:00,185,5806,85,100,3520.18,7199.14,0.00
2024-12-10 17:22:00,185,5807,85,100,3495.11,7200.00,0.00
2024-12-10 17:22:00,186,5807,86,100,3476.32,7200.01,0.00
2024-12-10 17:22:00,185,5807,85,100,3484.16,7200.14,0.00
2024-12-10 17:22:00,185,5808,85,100,3496.71,7201.00,0.00
2024-12-10 17:22:00,186,5808,85,101,3477.91,7201.01,0.00
2024-12-10 17:22:00,185,5808,85,100,3492.06,7201.07,0.00
2024-12-10 17:22:00,184,5808,85,99,3503.98,7201.14,0.00
2024-12-10 17:22:00,184,5809,85,99,3476.77,7202.00,0.00
2024-12-10 17:22:00,185,5809,86,99,3457.97,7202.01,0.00
2024-12-10 17:22:00,186,5808,87,99,3432.45,7202.11,0.00
2024-12-10 17:22:00,185,5808,87,98,3475.91,7202.15,0.00
2024-12-10 17:22:00,185,5809,87,98,3451.47,7203.00,0.00
2024-12-10 17:22:00,186,5809,88,98,3432.91,7203.01,0.00
2024-12-10 17:22:00,185,5809,88,97,3439.03,7203.14,0.00
2024-12-10 17:22:00,185,5810,88,97,3453.85,7204.00,0.00
2024-12-10 17:22:00,186,5810,88,98,3435.28,7204.01,0.00
2024-12-10 17:22:00,185,5810,88,97,3441.11,7204.14,0.00
2024-12-10 17:22:00,184,5810,88,96,3433.31,7204.51,0.00
2024-12-10 17:22:00,184,5811,88,96,3435.98,7205.00,0.00
2024-12-10 17:22:00,185,5811,89,96,3417.41,7205.01,0.00
2024-12-10 17:22:00,184,5811,89,95,3433.64,7205.03,0.00
2024-12-10 17:22:00,183,5811,88,95,3440.48,7205.14,0.00
2024-12-10 17:22:00,182,5811,88,94,3458.99,7205.14,0.00
2024-12-10 17:22:00,182,5812,88,94,3433.91,7206.00,0.00
2024-12-10 17:22:00,183,5812,89,94,3415.14,7206.01,0.00
2024-12-10 17:22:00,182,5812,89,93,3419.99,7206.14,0.00
2024-12-10 17:22:00,181,5812,89,92,3430.13,7206.26,0.00
2024-12-10 17:22:00,181,5813,89,92,3413.87,7207.00,0.00
2024-12-10 17:22:00,182,5813,89,93,3395.11,7207.01,0.00
2024-12-10 17:22:00,181,5813,88,93,3398.61,7207.14,0.00
2024-12-10 17:22:00,180,5813,88,92,3387.19,7207.56,0.00
2024-12-10 17:22:00,180,5814,88,92,3392.51,7208.00,0.00
2024-12-10 17:22:00,181,5814,88,93,3373.77,7208.01,0.00
2024-12-10 17:22:00,180,5814,87,93,3388.92,7208.05,0.00
2024-12-10 17:22:00,179,5814,87,92,3395.63,7208.13,0.00
2024-12-10 17:22:00,178,5814,87,91,3414.30,7208.14,0.00
2024-12-10 17:22:00,178,5815,87,91,3389.82,7209.00,0.00
2024-12-10 17:22:00,179,5815,87,92,3370.89,7209.01,0.00
2024-12-10 17:22:00,180,5814,87,93,3348.18,7209.07,0.00
2024-12-10 17:22:00,181,5813,88,93,3309.83,7209.67,0.00
2024-12-10 17:22:00,181,5814,88,93,3341.66,7210.00,0.00
2024-12-10 17:22:00,182,5814,89,93,3323.30,7210.01,0.00
2024-12-10 17:22:00,181,5814,89,92,3340.08,7210.02,0.00
2024-12-10 17:22:00,182,5813,90,92,3317.39,7210.09,0.00
2024-12-10 17:22:00,181,5813,90,91,3346.41,7210.14,0.00
2024-12-10 17:22:00,180,5813,90,90,3364.37,7210.15,0.00
2024-12-10 17:22:00,180,5814,90,90,3418.87,7211.00,0.00
2024-12-10 17:22:00,181,5814,90,91,3399.98,7211.01,0.00
2024-12-10 17:22:00,180,5814,89,91,3405.41,7211.14,0.00
2024-12-10 17:22:00,180,5815,89,91,3419.59,7212.00,0.00
2024-12-10 17:22:00,181,5815,89,92,3400.70,7212.01,0.00
2024-12-10 17:22:00,182,5814,89,93,3366.32,7212.21,0.00
2024-12-10 17:22:00,182,5815,89,93,3382.19,7213.00,0.00
2024-12-10 17:22:00,183,5815,90,93,3363.71,7213.01,0.00
2024-12-10 17:22:00,182,5815,89,93,3374.15,7213.10,0.00
2024-12-10 17:22:00,181,5815,89,92,3389.61,7213.14,0.00
2024-12-10 17:22:00,181,5816,89,92,3403.40,7214.00,0.00
2024-12-10 17:22:00,182,5816,90,92,3384.70,7214.01,0.00
2024-12-10 17:22:00,183,5815,90,93,3365.03,7214.03,0.00
2024-12-10 17:22:00,184,5814,91,93,3353.84,7214.14,0.00
2024-12-10 17:22:00,183,5814,91,92,3393.46,7214.15,0.00
2024-12-10 17:22:00,182,5814,91,91,3411.71,7214.15,0.00
2024-12-10 17:22:00,182,5815,91,91,3387.02,7215.00,0.00
2024-12-10 17:22:01,183,5815,92,91,3368.51,7215.01,0.00
2024-12-10 17:22:01,182,5815,91,91,3379.13,7215.11,0.00
2024-12-10 17:22:01,181,5815,90,91,3395.82,7215.13,0.00
2024-12-10 17:22:01,180,5815,89,91,3414.28,7215.13,0.00
2024-12-10 17:22:01,179,5815,88,91,3432.95,7215.13,0.00
2024-12-10 17:22:01,179,5816,88,91,3488.49,7216.00,0.00
2024-12-10 17:22:01,180,5816,88,92,3469.11,7216.01,0.00
2024-12-10 17:22:01,179,5816,88,91,3478.87,7216.13,0.00
2024-12-10 17:22:01,178,5816,88,90,3498.01,7216.14,0.00
2024-12-10 17:22:01,177,5816,88,89,3495.36,7216.45,0.00
2024-12-10 17:22:01,178,5815,88,90,3455.16,7216.73,0.00
2024-12-10 17:22:01,178,5816,88,90,3485.31,7217.00,0.00
2024-12-10 17:22:01,179,5816,89,90,3465.84,7217.01,0.00
2024-12-10 17:22:01,180,5815,90,90,3444.99,7217.04,0.00
2024-12-10 17:22:01,181,5814,91,90,3455.88,7217.07,0.00
2024-12-10 17:22:01,180,5814,91,89,3491.74,7217.15,0.00
2024-12-10 17:22:01,179,5814,91,88,3486.77,7217.48,0.00
2024-12-10 17:22:01,179,5815,91,88,3527.84,7218.00,0.00
2024-12-10 17:22:01,180,5815,91,89,3508.24,7218.01,0.00
2024-12-10 17:22:01,179,5815,91,88,3517.19,7218.13,0.00
2024-12-10 17:22:01,179,5816,91,88,3573.83,7219.00,0.00
2024-12-10 17:22:01,180,5816,92,88,3553.98,7219.01,0.00
2024-12-10 17:22:01,179,5816,91,88,3561.62,7219.14,0.00
2024-12-10 17:22:01,179,5817,91,88,3536.96,7220.00,0.00
2024-12-10 17:22:01,180,5817,91,89,3517.31,7220.01,0.00
2024-12-10 17:22:01,181,5816,91,90,3496.68,7220.03,0.00
2024-12-10 17:22:01,180,5816,91,89,3506.90,7220.15,0.00
2024-12-10 17:22:01,179,5816,91,88,3476.44,7220.83,0.00
2024-12-10 17:22:01,179,5817,91,88,3502.22,7221.00,0.00
2024-12-10 17:22:01,180,5817,91,89,3482.76,7221.01,0.00
2024-12-10 17:22:01,179,5817,91,88,3499.82,7221.03,0.00
2024-12-10 17:22:01,178,5817,91,87,3508.86,7221.14,0.00
2024-12-10 17:22:01,177,5817,91,86,3528.27,7221.14,0.00
2024-12-10 17:22:01,178,5816,91,87,3477.33,7221.58,0.00
2024-12-10 17:22:01,178,5817,91,87,3546.04,7222.00,0.00
2024-12-10 17:22:01,179,5817,91,88,3526.23,7222.01,0.00
2024-12-10 17:22:01,178,5817,91,87,3533.16,7222.14,0.00
2024-12-10 17:22:01,179,5816,91,88,3492.50,7222.44,0.00
2024-12-10 17:22:01,179,5817,91,88,3556.03,7223.00,0.00
2024-12-10 17:22:01,180,5817,91,89,3536.27,7223.01,0.00
2024-12-10 17:22:01,179,5817,91,88,3543.45,7223.13,0.00
2024-12-10 17:22:01,179,5818,91,88,3556.82,7224.00,0.00
2024-12-10 17:22:01,180,5818,92,88,3537.06,7224.01,0.00
2024-12-10 17:22:01,179,5818,91,88,3544.11,7224.13,0.00
2024-12-10 17:22:01,178,5818,91,87,3561.70,7224.15,0.00
2024-12-10 17:22:01,178,5819,91,87,3532.87,7225.00,0.00
2024-12-10 17:22:01,179,5819,91,88,3513.13,7225.01,0.00
2024-12-10 17:22:01,178,5819,91,87,3528.43,7225.06,0.00
2024-12-10 17:22:01,179,5818,91,88,3502.08,7225.12,0.00
2024-12-10 17:22:01,178,5818,90,88,3537.60,7225.14,0.00
2024-12-10 17:22:01,177,5818,89,88,3557.18,7225.14,0.00
2024-12-10 17:22:01,176,5818,88,88,3576.98,7225.14,0.00
2024-12-10 17:22:01,177,5817,89,88,3512.18,7225.74,0.00
2024-12-10 17:22:01,177,5818,89,88,3540.75,7226.00,0.00
2024-12-10 17:22:01,178,5818,90,88,3520.86,7226.01,0.00
2024-12-10 17:22:01,178,5819,90,88,3556.61,7227.00,0.00
2024-12-10 17:22:01,179,5819,90,89,3536.74,7227.01,0.00
2024-12-10 17:22:01,178,5819,89,89,3545.57,7227.10,0.00
2024-12-10 17:22:01,179,5818,90,89,3524.16,7227.13,0.00
2024-12-10 17:22:01,178,5818,89,89,3549.65,7227.13,0.00
2024-12-10 17:22:01,177,5818,88,89,3569.29,7227.13,0.00
2024-12-10 17:22:01,177,5819,88,89,3534.35,7228.00,0.00
2024-12-10 17:22:01,178,5819,89,89,3514.49,7228.01,0.00
2024-12-10 17:22:01,177,5819,89,88,3524.30,7228.09,0.00
2024-12-10 17:22:01,176,5819,88,88,3543.91,7228.09,0.00
2024-12-10 17:22:01,175,5819,87,88,3561.70,7228.10,0.00
2024-12-10 17:22:01,174,5819,87,87,3581.05,7228.11,0.00
2024-12-10 17:22:01,173,5819,87,86,3601.33,7228.11,0.00
2024-12-10 17:22:01,174,5818,87,87,3576.07,7228.18,0.00
2024-12-10 17:22:01,173,5818,86,87,3630.56,7228.25,0.00
2024-12-10 17:22:01,172,5818,86,86,3645.84,7228.31,0.00
2024-12-10 17:22:01,171,5818,85,86,3626.99,7228.77,0.00
2024-12-10 17:22:01,171,5819,85,86,3689.82,7229.00,0.00
2024-12-10 17:22:01,172,5819,86,86,3668.36,7229.01,0.00
2024-12-10 17:22:01,171,5819,85,86,3677.97,7229.11,0.00
2024-12-10 17:22:01,171,5820,85,86,3692.55,7230.00,0.00
2024-12-10 17:22:01,172,5820,86,86,3671.08,7230.01,0.00
2024-12-10 17:22:01,171,5820,86,85,3684.93,7230.08,0.00
2024-12-10 17:22:01,170,5820,86,84,3703.01,7230.11,0.00
2024-12-10 17:22:01,169,5820,85,84,3672.14,7230.81,0.00
2024-12-10 17:22:01,169,5821,85,84,3699.67,7231.00,0.00
2024-12-10 17:22:01,170,5821,85,85,3677.91,7231.01,0.00
2024-12-10 17:22:01,171,5820,86,85,3655.98,7231.02,0.00
2024-12-10 17:22:01,170,5820,85,85,3703.99,7231.11,0.00
2024-12-10 17:22:01,169,5820,85,84,3725.48,7231.11,0.00
2024-12-10 17:22:01,169,5821,85,84,3701.70,7232.00,0.00
2024-12-10 17:22:01,170,5821,85,85,3679.93,7232.01,0.00
2024-12-10 17:22:01,169,5821,84,85,3699.15,7232.04,0.00
2024-12-10 17:22:01,168,5821,83,85,3714.90,7232.10,0.00
2024-12-10 17:22:01,168,5822,83,85,3733.36,7233.00,0.00
2024-12-10 17:22:01,169,5822,84,85,3711.27,7233.01,0.00
2024-12-10 17:22:01,168,5822,83,85,3727.65,7233.08,0.00
2024-12-10 17:22:01,167,5822,83,84,3746.73,7233.10,0.00
2024-12-10 17:22:01,166,5822,82,84,3768.86,7233.10,0.00
2024-12-10 17:22:01,166,5823,82,84,3744.52,7234.00,0.00
2024-12-10 17:22:01,167,5823,83,84,3722.09,7234.01,0.00
2024-12-10 17:22:01,166,5823,82,84,3740.67,7234.05,0.00
2024-12-10 17:22:01,165,5823,81,84,3758.76,7234.10,0.00
2024-12-10 17:22:01,164,5823,80,84,3781.24,7234.10,0.00
2024-12-10 17:22:02,164,5824,80,84,3756.49,7235.00,0.00
2024-12-10 17:22:02,165,5824,81,84,3733.72,7235.01,0.00
2024-12-10 17:22:02,164,5824,80,84,3752.36,7235.06,0.00
2024-12-10 17:22:02,163,5824,79,84,3771.64,7235.09,0.00
2024-12-10 17:22:02,164,5823,80,84,3738.96,7235.24,0.00
2024-12-10 17:22:02,164,5824,80,84,3742.82,7236.00,0.00
2024-12-10 17:22:02,165,5824,81,84,3720.14,7236.01,0.00
2024-12-10 17:22:02,164,5824,81,83,3734.71,7236.10,0.00
2024-12-10 17:22:02,163,5824,81,82,3722.80,7236.54,0.00
2024-12-10 17:22:02,163,5825,81,82,3776.86,7237.00,0.00
2024-12-10 17:22:02,164,5825,82,82,3753.83,7237.01,0.00
2024-12-10 17:22:02,163,5825,82,81,3768.48,7237.10,0.00
2024-12-10 17:22:02,162,5825,81,81,3778.19,7237.27,0.00
2024-12-10 17:22:02,163,5824,82,81,3740.43,7237.49,0.00
2024-12-10 17:22:02,163,5825,82,81,3768.79,7238.00,0.00
2024-12-10 17:22:02,164,5825,82,82,3745.81,7238.01,0.00
2024-12-10 17:22:02,163,5825,82,81,3760.18,7238.10,0.00
2024-12-10 17:22:02,162,5825,81,81,3782.94,7238.10,0.00
2024-12-10 17:22:02,161,5825,81,80,3791.04,7238.31,0.00
2024-12-10 17:22:02,161,5826,81,80,3830.14,7239.00,0.00
2024-12-10 17:22:02,162,5826,81,81,3806.50,7239.01,0.00
2024-12-10 17:22:02,161,5826,80,81,3820.64,7239.11,0.00
2024-12-10 17:22:02,162,5825,81,81,3751.28,7239.75,0.00
2024-12-10 17:22:02,162,5826,81,81,3787.91,7240.00,0.00
2024-12-10 17:22:02,163,5826,81,82,3764.68,7240.01,0.00
2024-12-10 17:22:02,162,5826,80,82,3787.47,7240.01,0.00
2024-12-10 17:22:02,161,5826,79,82,3801.16,7240.10,0.00
2024-12-10 17:22:02,161,5827,79,82,3824.46,7241.00,0.00
2024-12-10 17:22:02,162,5827,79,83,3800.85,7241.01,0.00
2024-12-10 17:22:02,161,5827,78,83,3813.42,7241.11,0.00
2024-12-10 17:22:02,161,5828,78,83,3791.19,7242.00,0.00
2024-12-10 17:22:02,162,5828,79,83,3767.79,7242.01,0.00
2024-12-10 17:22:02,163,5827,79,84,3740.70,7242.07,0.00
2024-12-10 17:22:02,164,5826,80,84,3724.12,7242.09,0.00
2024-12-10 17:22:02,163,5826,80,83,3766.62,7242.12,0.00
2024-12-10 17:22:02,162,5826,80,82,3779.82,7242.25,0.00
2024-12-10 17:22:02,162,5827,80,82,3767.47,7243.00,0.00
2024-12-10 17:22:02,163,5827,81,82,3744.35,7243.01,0.00
2024-12-10 17:22:02,162,5827,80,82,3752.90,7243.11,0.00
2024-12-10 17:22:02,162,5828,80,82,3813.77,7244.00,0.00
2024-12-10 17:22:02,163,5828,81,82,3790.37,7244.01,0.00
2024-12-10 17:22:02,164,5827,82,82,3764.20,7244.06,0.00
2024-12-10 17:22:02,163,5827,81,82,3798.22,7244.11,0.00
2024-12-10 17:22:02,163,5828,81,82,3768.59,7245.00,0.00
2024-12-10 17:22:02,164,5828,81,83,3745.61,7245.01,0.00
2024-12-10 17:22:02,163,5828,80,83,3749.75,7245.10,0.00
2024-12-10 17:22:02,164,5827,80,84,3712.34,7245.32,0.00
2024-12-10 17:22:02,164,5828,80,84,3774.53,7246.00,0.00
2024-12-10 17:22:02,165,5828,81,84,3751.66,7246.01,0.00
2024-12-10 17:22:02,164,5828,80,84,3753.52,7246.10,0.00
2024-12-10 17:22:02,163,5828,80,83,3776.15,7246.10,0.00
2024-12-10 17:22:02,162,5828,79,83,3799.01,7246.11,0.00
2024-12-10 17:22:02,161,5828,78,83,3769.26,7246.83,0.00
2024-12-10 17:22:02,161,5829,78,83,3840.85,7247.00,0.00
2024-12-10 17:22:02,162,5829,79,83,3817.14,7247.01,0.00
2024-12-10 17:22:02,163,5828,79,84,3782.39,7247.09,0.00
2024-12-10 17:22:02,162,5828,79,83,3826.89,7247.11,0.00
2024-12-10 17:22:02,162,5829,79,83,3799.68,7248.00,0.00
2024-12-10 17:22:02,163,5829,80,83,3776.37,7248.01,0.00
2024-12-10 17:22:02,164,5828,80,84,3742.15,7248.08,0.00
2024-12-10 17:22:02,163,5828,80,83,3766.59,7248.11,0.00
2024-12-10 17:22:02,162,5828,79,83,3788.54,7248.12,0.00
2024-12-10 17:22:02,162,5829,79,83,3797.40,7249.00,0.00
2024-12-10 17:22:02,163,5829,79,84,3774.10,7249.01,0.00
2024-12-10 17:22:02,162,5829,79,83,3770.55,7249.11,0.00
2024-12-10 17:22:02,161,5829,78,83,3729.16,7249.94,0.00
2024-12-10 17:22:02,161,5830,78,83,3803.97,7250.00,0.00
2024-12-10 17:22:02,162,5830,79,83,3780.49,7250.01,0.00
2024-12-10 17:22:02,161,5830,79,82,3793.76,7250.06,0.00
2024-12-10 17:22:02,160,5830,78,82,3804.85,7250.07,0.00
2024-12-10 17:22:02,161,5829,78,83,3721.19,7250.91,0.00
2024-12-10 17:22:02,161,5830,78,83,3751.92,7251.00,0.00
2024-12-10 17:22:02,162,5830,79,83,3728.76,7251.01,0.00
2024-12-10 17:22:02,161,5830,79,82,3671.31,7251.97,0.00
2024-12-10 17:22:02,161,5831,79,82,3759.16,7252.00,0.00
2024-12-10 17:22:02,162,5831,79,83,3735.96,7252.01,0.00
2024-12-10 17:22:02,161,5831,78,83,3752.90,7252.09,0.00
2024-12-10 17:22:02,160,5831,77,83,3775.00,7252.10,0.00
2024-12-10 17:22:02,159,5831,77,82,3798.29,7252.10,0.00
2024-12-10 17:22:02,159,5832,77,82,3779.15,7253.00,0.00
2024-12-10 17:22:02,160,5832,77,83,3755.53,7253.01,0.00
2024-12-10 17:22:02,161,5831,77,84,3731.30,7253.03,0.00
2024-12-10 17:22:02,161,5832,77,84,3721.00,7254.00,0.00
2024-12-10 17:22:02,162,5832,78,84,3698.03,7254.01,0.00
2024-12-10 17:22:02,161,5832,77,84,3716.14,7254.07,0.00
2024-12-10 17:22:02,160,5832,77,83,3736.66,7254.10,0.00
2024-12-10 17:22:02,160,5833,77,83,3762.11,7255.00,0.00
2024-12-10 17:22:02,161,5833,77,84,3738.74,7255.01,0.00
2024-12-10 17:22:02,160,5833,77,83,3754.60,7255.10,0.00
2024-12-10 17:22:02,159,5833,76,83,3777.76,7255.10,0.00
2024-12-10 17:22:02,160,5832,76,84,3701.39,7255.82,0.00
2024-12-10 17:22:02,160,5833,76,84,3742.82,7256.00,0.00
2024-12-10 17:22:02,161,5833,77,84,3719.57,7256.01,0.00
2024-12-10 17:22:02,162,5832,77,85,3631.85,7256.86,0.00
2024-12-10 17:22:03,162,5833,77,85,3713.95,7257.00,0.00
2024-12-10 17:22:03,163,5833,78,85,3691.16,7257.01,0.00
2024-12-10 17:22:03,162,5833,77,85,3713.25,7257.01,0.00
2024-12-10 17:22:03,161,5833,77,84,3729.60,7257.10,0.00
2024-12-10 17:22:03,160,5833,76,84,3752.69,7257.10,0.00
2024-12-10 17:22:03,160,5834,76,84,3774.14,7258.00,0.00
2024-12-10 17:22:03,161,5834,76,85,3750.70,7258.01,0.00
2024-12-10 17:22:03,160,5834,75,85,3767.84,7258.09,0.00
2024-12-10 17:22:03,159,5834,75,84,3790.63,7258.09,0.00
2024-12-10 17:22:03,158,5834,75,83,3814.16,7258.10,0.00
2024-12-10 17:22:03,157,5834,74,83,3837.06,7258.12,0.00
2024-12-10 17:22:03,158,5833,75,83,3764.18,7258.72,0.00
2024-12-10 17:22:03,158,5834,75,83,3803.73,7259.00,0.00
2024-12-10 17:22:03,159,5834,75,84,3779.81,7259.01,0.00
2024-12-10 17:22:03,158,5834,75,83,3796.89,7259.10,0.00
2024-12-10 17:22:03,157,5834,75,82,3820.61,7259.10,0.00
2024-12-10 17:22:03,156,5834,75,81,3844.64,7259.10,0.00
2024-12-10 17:22:03,156,5835,75,81,3864.13,7260.00,0.00
2024-12-10 17:22:03,157,5835,76,81,3839.52,7260.01,0.00
2024-12-10 17:22:03,158,5834,76,82,3768.07,7260.61,0.00
2024-12-10 17:22:03,158,5835,76,82,3800.75,7261.00,0.00
2024-12-10 17:22:03,159,5835,77,82,3776.84,7261.01,0.00
2024-12-10 17:22:03,158,5835,77,81,3760.09,7261.50,0.00
2024-12-10 17:22:03,159,5834,78,81,3712.77,7261.78,0.00
2024-12-10 17:22:03,159,5835,78,81,3798.82,7262.00,0.00
2024-12-10 17:22:03,160,5835,79,81,3775.08,7262.01,0.00
2024-12-10 17:22:03,159,5835,78,81,3790.65,7262.11,0.00
2024-12-10 17:22:03,160,5834,78,82,3757.00,7262.26,0.00
2024-12-10 17:22:03,161,5833,78,83,3732.38,7262.73,0.00
2024-12-10 17:22:03,162,5832,79,83,3721.46,7262.75,0.00
2024-12-10 17:22:03,162,5833,79,83,3805.06,7263.00,0.00
2024-12-10 17:22:03,163,5833,80,83,3781.72,7263.01,0.00
2024-12-10 17:22:03,162,5833,79,83,3795.47,7263.11,0.00
2024-12-10 17:22:03,161,5833,78,83,3818.59,7263.11,0.00
2024-12-10 17:22:03,160,5833,78,82,3842.01,7263.11,0.00
2024-12-10 17:22:03,161,5832,79,82,3771.25,7263.70,0.00
2024-12-10 17:22:03,161,5833,79,82,3944.30,7264.00,0.00
2024-12-10 17:22:03,162,5833,80,82,3919.95,7264.01,0.00
2024-12-10 17:22:03,163,5832,80,83,3892.80,7264.06,0.00
2024-12-10 17:22:03,162,5832,79,83,3942.59,7264.08,0.00
2024-12-10 17:22:03,161,5832,78,83,3964.83,7264.11,0.00
2024-12-10 17:22:03,162,5831,79,83,3885.63,7264.81,0.00
2024-12-10 17:22:03,162,5832,79,83,3969.66,7265.00,0.00
2024-12-10 17:22:03,163,5832,80,83,3945.31,7265.01,0.00
2024-12-10 17:22:03,162,5832,80,82,3961.29,7265.11,0.00
2024-12-10 17:22:03,163,5831,80,83,3888.57,7265.71,0.00
2024-12-10 17:22:03,163,5832,80,83,4010.20,7266.00,0.00
2024-12-10 17:22:03,164,5832,81,83,3985.75,7266.01,0.00
2024-12-10 17:22:03,163,5832,81,82,3987.68,7266.28,0.00
2024-12-10 17:22:03,163,5833,81,82,4019.58,7267.00,0.00
2024-12-10 17:22:03,164,5833,82,82,3995.07,7267.01,0.00
2024-12-10 17:22:03,163,5833,82,81,4011.61,7267.11,0.00
2024-12-10 17:22:03,163,5834,82,81,3985.80,7268.00,0.00
2024-12-10 17:22:03,164,5834,83,81,3961.49,7268.01,0.00
2024-12-10 17:22:03,163,5834,82,81,3975.93,7268.11,0.00
2024-12-10 17:22:03,162,5834,82,80,3988.13,7268.27,0.00
2024-12-10 17:22:03,162,5835,82,80,3974.82,7269.00,0.00
2024-12-10 17:22:03,163,5835,82,81,3950.44,7269.01,0.00
2024-12-10 17:22:03,164,5834,83,81,3881.86,7269.58,0.00
2024-12-10 17:22:03,164,5835,83,81,3911.19,7270.00,0.00
2024-12-10 17:22:03,165,5835,84,81,3887.49,7270.01,0.00
2024-12-10 17:22:03,166,5834,85,81,3856.82,7270.11,0.00
2024-12-10 17:22:03,165,5834,85,80,3905.33,7270.12,0.00
2024-12-10 17:22:03,164,5834,85,79,3917.62,7270.27,0.00
2024-12-10 17:22:03,164,5835,85,79,3949.58,7271.00,0.00
2024-12-10 17:22:03,165,5835,86,79,3925.65,7271.01,0.00
2024-12-10 17:22:03,164,5835,86,78,3941.22,7271.12,0.00
2024-12-10 17:22:03,164,5836,86,78,3963.94,7272.00,0.00
2024-12-10 17:22:03,165,5836,86,79,3939.92,7272.01,0.00
2024-12-10 17:22:03,164,5836,86,78,3962.18,7272.02,0.00
2024-12-10 17:22:03,163,5836,86,77,3979.84,7272.11,0.00
2024-12-10 17:22:03,162,5836,86,76,4003.96,7272.11,0.00
2024-12-10 17:22:03,163,5835,87,76,3934.97,7272.68,0.00
2024-12-10 17:22:03,163,5836,87,76,3970.94,7273.00,0.00
2024-12-10 17:22:03,164,5836,87,77,3946.72,7273.01,0.00
2024-12-10 17:22:03,163,5836,87,76,3962.96,7273.11,0.00
2024-12-10 17:22:03,162,5836,86,76,3986.97,7273.11,0.00
2024-12-10 17:22:03,161,5836,86,75,3981.76,7273.45,0.00
2024-12-10 17:22:03,161,5837,86,75,4032.21,7274.00,0.00
2024-12-10 17:22:03,162,5837,87,75,4007.32,7274.01,0.00
2024-12-10 17:22:03,161,5837,87,74,4024.13,7274.11,0.00
2024-12-10 17:22:03,162,5836,87,75,3990.22,7274.25,0.00
2024-12-10 17:22:03,161,5836,86,75,4028.06,7274.57,0.00
2024-12-10 17:22:03,161,5837,86,75,4041.69,7275.00,0.00
2024-12-10 17:22:03,162,5837,87,75,4016.74,7275.01,0.00
2024-12-10 17:22:03,161,5837,86,75,4033.61,7275.11,0.00
2024-12-10 17:22:03,161,5838,86,75,4055.60,7276.00,0.00
2024-12-10 17:22:03,162,5838,87,75,4030.57,7276.01,0.00
2024-12-10 17:22:03,161,5838,87,74,4049.61,7276.09,0.00
2024-12-10 17:22:03,160,5838,87,73,4073.12,7276.11,0.00
2024-12-10 17:22:03,160,5839,87,73,4048.78,7277.00,0.00
2024-12-10 17:22:03,161,5839,88,73,4023.63,7277.01,0.00
2024-12-10 17:22:03,162,5838,89,73,3995.68,7277.06,0.00
2024-12-10 17:22:03,161,5838,89,72,4029.11,7277.11,0.00
2024-12-10 17:22:03,160,5838,88,72,4053.84,7277.11,0.00
2024-12-10 17:22:03,160,5839,88,72,4025.80,7278.00,0.00
2024-12-10 17:22:03,161,5839,88,73,4000.79,7278.01,0.00
2024-12-10 17:22:03,160,5839,88,72,4019.93,7278.08,0.00
2024-12-10 17:22:03,159,5839,88,71,4042.94,7278.11,0.00
2024-12-10 17:22:03,158,5839,88,70,4059.21,7278.23,0.00
2024-12-10 17:22:03,158,5840,88,70,4087.02,7279.00,0.00
2024-12-10 17:22:03,159,5840,89,70,4061.31,7279.01,0.00
2024-12-10 17:22:03,160,5839,90,70,4007.53,7279.40,0.00
2024-12-10 17:22:03,161,5838,90,71,3973.89,7279.84,0.00
2024-12-10 17:22:04,161,5839,90,71,4013.31,7280.00,0.00
2024-12-10 17:22:04,162,5839,90,72,3988.54,7280.01,0.00
2024-12-10 17:22:04,161,5839,90,71,4005.23,7280.11,0.00
2024-12-10 17:22:04,161,5840,90,71,4069.16,7281.00,0.00
2024-12-10 17:22:04,162,5840,91,71,4044.04,7281.01,0.00
2024-12-10 17:22:04,161,5840,91,70,4061.07,7281.11,0.00
2024-12-10 17:22:04,160,5840,90,70,4086.00,7281.11,0.00
2024-12-10 17:22:04,161,5839,90,71,4031.42,7281.51,0.00
2024-12-10 17:22:04,162,5838,90,72,4013.98,7281.67,0.00
2024-12-10 17:22:04,162,5839,90,72,4049.77,7282.00,0.00
2024-12-10 17:22:04,163,5839,90,73,4024.92,7282.01,0.00
2024-12-10 17:22:04,162,5839,89,73,4041.28,7282.12,0.00
2024-12-10 17:22:04,163,5838,90,73,3996.70,7282.38,0.00
2024-12-10 17:22:04,164,5837,91,73,3977.69,7282.45,0.00
2024-12-10 17:22:04,164,5838,91,73,4106.81,7283.00,0.00
2024-12-10 17:22:04,165,5838,92,73,4081.92,7283.01,0.00
2024-12-10 17:22:04,164,5838,91,73,4098.43,7283.12,0.00
2024-12-10 17:22:04,163,5838,91,72,4107.30,7283.33,0.00
2024-12-10 17:22:04,164,5837,92,72,4069.47,7283.52,0.00
2024-12-10 17:22:04,163,5837,91,72,4095.81,7283.60,0.00
2024-12-10 17:22:04,163,5838,91,72,4195.21,7284.00,0.00
2024-12-10 17:22:04,164,5838,91,73,4169.63,7284.01,0.00
2024-12-10 17:22:04,163,5838,90,73,4186.77,7284.12,0.00
2024-12-10 17:22:04,164,5837,90,74,4132.96,7284.52,0.00
2024-12-10 17:22:04,164,5838,90,74,4188.90,7285.00,0.00
2024-12-10 17:22:04,165,5838,91,74,4163.51,7285.01,0.00
2024-12-10 17:22:04,164,5838,91,73,4184.66,7285.06,0.00
2024-12-10 17:22:04,163,5838,91,72,4206.33,7285.11,0.00
2024-12-10 17:22:04,164,5837,91,73,4152.40,7285.51,0.00
2024-12-10 17:22:04,164,5838,91,73,4223.32,7286.00,0.00
2024-12-10 17:22:04,165,5838,91,74,4197.72,7286.01,0.00
2024-12-10 17:22:04,164,5838,91,73,4215.37,7286.11,0.00
2024-12-10 17:22:04,163,5838,90,73,4240.79,7286.11,0.00
2024-12-10 17:22:04,163,5839,90,73,4263.75,7287.00,0.00
2024-12-10 17:22:04,164,5839,90,74,4237.75,7287.01,0.00
2024-12-10 17:22:04,164,5840,90,74,4209.23,7288.00,0.00
2024-12-10 17:22:04,165,5840,90,75,4183.72,7288.01,0.00
2024-12-10 17:22:04,164,5840,90,74,4201.28,7288.11,0.00
2024-12-10 17:22:04,164,5841,90,74,4179.08,7289.00,0.00
2024-12-10 17:22:04,165,5841,91,74,4153.75,7289.01,0.00
2024-12-10 17:22:04,164,5841,90,74,4171.13,7289.11,0.00
2024-12-10 17:22:04,163,5841,89,74,4196.27,7289.11,0.00
2024-12-10 17:22:04,163,5842,89,74,4172.75,7290.00,0.00
2024-12-10 17:22:04,164,5842,89,75,4147.30,7290.01,0.00
2024-12-10 17:22:04,163,5842,88,75,4164.30,7290.12,0.00
2024-12-10 17:22:04,163,5843,88,75,4139.57,7291.00,0.00
2024-12-10 17:22:04,164,5843,88,76,4114.32,7291.01,0.00
2024-12-10 17:22:04,163,5843,88,75,4131.12,7291.12,0.00
2024-12-10 17:22:04,164,5842,89,75,4044.96,7291.92,0.00
2024-12-10 17:22:04,164,5843,89,75,4084.99,7292.00,0.00
2024-12-10 17:22:04,165,5843,90,75,4060.23,7292.01,0.00
2024-12-10 17:22:04,164,5843,89,75,4077.60,7292.10,0.00
2024-12-10 17:22:04,163,5843,88,75,4101.28,7292.12,0.00
2024-12-10 17:22:04,163,5844,88,75,4119.36,7293.00,0.00
2024-12-10 17:22:04,164,5844,89,75,4094.24,7293.01,0.00
2024-12-10 17:22:04,164,5845,89,75,4058.58,7294.00,0.00
2024-12-10 17:22:04,165,5845,90,75,4033.98,7294.01,0.00
2024-12-10 17:22:04,164,5845,90,74,4050.18,7294.12,0.00
2024-12-10 17:22:04,164,5846,90,74,4020.07,7295.00,0.00
2024-12-10 17:22:04,165,5846,91,74,3995.70,7295.01,0.00
2024-12-10 17:22:04,164,5846,91,73,4011.62,7295.12,0.00
2024-12-10 17:22:04,164,5847,91,73,3979.49,7296.00,0.00
2024-12-10 17:22:04,165,5847,92,73,3955.38,7296.01,0.00
2024-12-10 17:22:04,164,5847,92,72,3970.08,7296.12,0.00
2024-12-10 17:22:04,164,5848,92,72,3938.36,7297.00,0.00
2024-12-10 17:22:04,165,5848,93,72,3914.49,7297.01,0.00
2024-12-10 17:22:04,164,5848,92,72,3927.37,7297.12,0.00
2024-12-10 17:22:04,164,5849,92,72,3896.04,7298.00,0.00
2024-12-10 17:22:04,165,5849,93,72,3872.43,7298.01,0.00
2024-12-10 17:22:04,164,5849,92,72,3884.06,7298.12,0.00
2024-12-10 17:22:04,165,5848,92,73,3854.77,7298.21,0.00
2024-12-10 17:22:04,166,5847,93,73,3838.58,7298.57,0.00
2024-12-10 17:22:04,166,5848,93,73,3866.63,7299.00,0.00
2024-12-10 17:22:04,167,5848,93,74,3843.47,7299.01,0.00
2024-12-10 17:22:04,166,5848,92,74,3856.70,7299.11,0.00
2024-12-10 17:22:04,165,5848,91,74,3830.69,7299.73,0.00
2024-12-10 17:22:04,165,5849,91,74,3942.07,7300.00,0.00
2024-12-10 17:22:04,166,5849,91,75,3918.32,7300.01,0.00
2024-12-10 17:22:04,165,5849,90,75,3933.58,7300.12,0.00
2024-12-10 17:22:04,164,5849,90,74,3941.72,7300.30,0.00
2024-12-10 17:22:04,164,5850,90,74,3933.44,7301.00,0.00
2024-12-10 17:22:04,165,5850,91,74,3909.61,7301.01,0.00
2024-12-10 17:22:04,164,5850,91,73,3925.03,7301.12,0.00
2024-12-10 17:22:04,165,5849,91,74,3859.33,7301.67,0.00
2024-12-10 17:22:04,165,5850,91,74,3907.47,7302.00,0.00
2024-12-10 17:22:04,166,5850,91,75,3883.93,7302.01,0.00
2024-12-10 17:22:04,165,5850,90,75,3897.42,7302.12,0.00
2024-12-10 17:22:04,166,5849,90,76,3847.23,7302.49,0.00
2024-12-10 17:22:04,166,5850,90,76,3918.76,7303.00,0.00
2024-12-10 17:22:04,167,5850,91,76,3895.29,7303.01,0.00
2024-12-10 17:22:04,166,5850,90,76,3905.75,7303.11,0.00
2024-12-10 17:22:04,166,5851,90,76,3925.99,7304.00,0.00
2024-12-10 17:22:04,167,5851,90,77,3902.48,7304.01,0.00
2024-12-10 17:22:04,166,5851,90,76,3912.24,7304.11,0.00
2024-12-10 17:22:05,166,5852,90,76,3888.55,7305.00,0.00
2024-12-10 17:22:05,167,5852,90,77,3865.27,7305.01,0.00
2024-12-10 17:22:05,166,5852,89,77,3877.39,7305.11,0.00
2024-12-10 17:22:05,167,5851,90,77,3809.82,7305.73,0.00
2024-12-10 17:22:05,167,5852,90,77,3843.86,7306.00,0.00
2024-12-10 17:22:05,168,5852,91,77,3820.98,7306.01,0.00
2024-12-10 17:22:05,167,5852,90,77,3834.68,7306.11,0.00
2024-12-10 17:22:05,167,5853,90,77,3854.84,7307.00,0.00
2024-12-10 17:22:05,168,5853,90,78,3831.90,7307.01,0.00
2024-12-10 17:22:05,167,5853,90,77,3847.73,7307.10,0.00
2024-12-10 17:22:05,166,5853,90,76,3869.59,7307.11,0.00
2024-12-10 17:22:05,166,5854,90,76,3843.90,7308.00,0.00
2024-12-10 17:22:05,167,5854,90,77,3820.88,7308.01,0.00
2024-12-10 17:22:05,166,5854,90,76,3836.00,7308.11,0.00
2024-12-10 17:22:05,167,5853,90,77,3801.68,7308.28,0.00
2024-12-10 17:22:05,168,5852,91,77,3794.76,7308.36,0.00
2024-12-10 17:22:05,168,5853,91,77,3815.08,7309.00,0.00
2024-12-10 17:22:05,169,5853,91,78,3792.50,7309.01,0.00
2024-12-10 17:22:05,168,5853,90,78,3812.91,7309.03,0.00
2024-12-10 17:22:05,167,5853,90,77,3830.07,7309.10,0.00
2024-12-10 17:22:05,166,5853,89,77,3852.71,7309.10,0.00
2024-12-10 17:22:05,167,5852,89,78,3806.55,7309.43,0.00
2024-12-10 17:22:05,168,5851,89,79,3795.05,7309.45,0.00
2024-12-10 17:22:05,168,5852,89,79,3907.06,7310.00,0.00
2024-12-10 17:22:05,169,5852,90,79,3883.94,7310.01,0.00
2024-12-10 17:22:05,168,5852,89,79,3899.69,7310.10,0.00
2024-12-10 17:22:05,168,5853,89,79,3948.49,7311.00,0.00
2024-12-10 17:22:05,169,5853,89,80,3925.13,7311.01,0.00
2024-12-10 17:22:05,168,5853,88,80,3887.19,7311.76,0.00
2024-12-10 17:22:05,168,5854,88,80,3904.48,7312.00,0.00
2024-12-10 17:22:05,169,5854,88,81,3881.37,7312.01,0.00
2024-12-10 17:22:05,168,5854,88,80,3896.67,7312.11,0.00
2024-12-10 17:22:05,167,5854,88,79,3919.57,7312.11,0.00
2024-12-10 17:22:05,167,5855,88,79,3887.12,7313.00,0.00
2024-12-10 17:22:05,168,5855,89,79,3863.98,7313.01,0.00
2024-12-10 17:22:05,167,5855,89,78,3835.33,7313.66,0.00
2024-12-10 17:22:05,167,5856,89,78,3852.51,7314.00,0.00
2024-12-10 17:22:05,168,5856,90,78,3829.58,7314.01,0.00
2024-12-10 17:22:05,167,5856,89,78,3844.04,7314.11,0.00
2024-12-10 17:22:05,166,5856,88,78,3866.75,7314.11,0.00
2024-12-10 17:22:05,167,5855,88,79,3836.17,7314.23,0.00
2024-12-10 17:22:05,167,5856,88,79,3816.60,7315.00,0.00
2024-12-10 17:22:05,168,5856,88,80,3793.88,7315.01,0.00
2024-12-10 17:22:05,167,5856,87,80,3807.07,7315.11,0.00
2024-12-10 17:22:05,168,5855,88,80,3745.40,7315.64,0.00
2024-12-10 17:22:05,168,5856,88,80,3800.60,7316.00,0.00
2024-12-10 17:22:05,169,5856,89,80,3778.11,7316.01,0.00
2024-12-10 17:22:05,169,5857,89,80,3779.94,7317.00,0.00
2024-12-10 17:22:05,170,5857,89,81,3757.70,7317.01,0.00
2024-12-10 17:22:05,169,5857,89,80,3778.64,7317.02,0.00
2024-12-10 17:22:05,168,5857,88,80,3800.70,7317.02,0.00
2024-12-10 17:22:05,167,5857,87,80,3815.16,7317.11,0.00
2024-12-10 17:22:05,166,5857,86,80,3837.26,7317.11,0.00
2024-12-10 17:22:05,165,5857,86,79,3796.12,7317.94,0.00
2024-12-10 17:22:05,165,5858,86,79,3836.09,7318.00,0.00
2024-12-10 17:22:05,166,5858,87,79,3812.98,7318.01,0.00
2024-12-10 17:22:05,165,5858,87,78,3826.50,7318.12,0.00
2024-12-10 17:22:05,166,5857,87,79,3798.60,7318.19,0.00
2024-12-10 17:22:05,167,5856,88,79,3770.96,7318.30,0.00
2024-12-10 17:22:05,167,5857,88,79,3783.03,7319.00,0.00
2024-12-10 17:22:05,168,5857,89,79,3760.51,7319.01,0.00
2024-12-10 17:22:05,169,5856,89,80,3738.26,7319.02,0.00
2024-12-10 17:22:05,168,5856,88,80,3789.08,7319.12,0.00
2024-12-10 17:22:05,169,5855,89,80,3719.41,7319.77,0.00
2024-12-10 17:22:05,169,5856,89,80,3843.13,7320.00,0.00
2024-12-10 17:22:05,170,5856,89,81,3820.52,7320.01,0.00
2024-12-10 17:22:05,169,5856,89,80,3832.62,7320.11,0.00
2024-12-10 17:22:05,168,5856,89,79,3855.00,7320.11,0.00
2024-12-10 17:22:05,169,5855,90,79,3793.79,7320.64,0.00
2024-12-10 17:22:05,169,5856,90,79,3913.10,7321.00,0.00
2024-12-10 17:22:05,170,5856,90,80,3890.08,7321.01,0.00
2024-12-10 17:22:05,169,5856,89,80,3907.33,7321.07,0.00
2024-12-10 17:22:05,168,5856,89,79,3924.27,7321.11,0.00
2024-12-10 17:22:05,167,5856,89,78,3947.33,7321.11,0.00
2024-12-10 17:22:05,168,5855,89,79,3897.84,7321.46,0.00
2024-12-10 17:22:05,169,5854,90,79,3880.07,7321.65,0.00
2024-12-10 17:22:05,169,5855,90,79,3955.89,7322.00,0.00
2024-12-10 17:22:05,170,5855,91,79,3932.62,7322.01,0.00
2024-12-10 17:22:05,169,5855,91,78,3951.73,7322.05,0.00
2024-12-10 17:22:05,168,5855,91,77,3969.67,7322.10,0.00
2024-12-10 17:22:05,167,5855,91,76,3993.00,7322.10,0.00
2024-12-10 17:22:05,167,5856,91,76,4055.31,7323.00,0.00
2024-12-10 17:22:05,168,5856,91,77,4031.17,7323.01,0.00
2024-12-10 17:22:05,168,5857,91,77,3996.86,7324.00,0.00
2024-12-10 17:22:05,169,5857,91,78,3973.21,7324.01,0.00
2024-12-10 17:22:05,169,5858,91,78,3937.97,7325.00,0.00
2024-12-10 17:22:05,170,5858,91,79,3914.81,7325.01,0.00
2024-12-10 17:22:05,169,5858,91,78,3935.79,7325.02,0.00
2024-12-10 17:22:05,168,5858,90,78,3955.74,7325.07,0.00
2024-12-10 17:22:05,167,5858,90,77,3976.81,7325.10,0.00
2024-12-10 17:22:05,166,5858,90,76,4000.33,7325.10,0.00
2024-12-10 17:22:05,165,5858,89,76,4024.13,7325.10,0.00
2024-12-10 17:22:05,165,5859,89,76,3996.77,7326.00,0.00
2024-12-10 17:22:05,166,5859,89,77,3972.70,7326.01,0.00
2024-12-10 17:22:05,166,5860,89,77,3939.10,7327.00,0.00
2024-12-10 17:22:05,167,5860,90,77,3915.52,7327.01,0.00
2024-12-10 17:22:05,166,5860,90,76,3931.63,7327.10,0.00
2024-12-10 17:22:05,165,5860,90,75,3943.06,7327.27,0.00
2024-12-10 17:22:06,165,5861,90,75,3931.59,7328.00,0.00
2024-12-10 17:22:06,166,5861,91,75,3907.90,7328.01,0.00
2024-12-10 17:22:06,165,5861,90,75,3929.38,7328.03,0.00
2024-12-10 17:22:06,164,5861,89,75,3948.00,7328.10,0.00
2024-12-10 17:22:06,163,5861,89,74,3971.77,7328.10,0.00
2024-12-10 17:22:06,163,5862,89,74,3948.73,7329.00,0.00
2024-12-10 17:22:06,164,5862,89,75,3924.66,7329.01,0.00
2024-12-10 17:22:06,165,5861,89,76,3857.13,7329.62,0.00
2024-12-10 17:22:06,165,5862,89,76,3890.51,7330.00,0.00
2024-12-10 17:22:06,166,5862,89,77,3867.08,7330.01,0.00
2024-12-10 17:22:06,166,5863,89,77,3878.98,7331.00,0.00
2024-12-10 17:22:06,167,5863,89,78,3855.76,7331.01,0.00
2024-12-10 17:22:06,168,5862,89,79,3826.72,7331.10,0.00
2024-12-10 17:22:06,167,5862,89,78,3858.68,7331.11,0.00
2024-12-10 17:22:06,168,5861,90,78,3833.53,7331.15,0.00
2024-12-10 17:22:06,169,5860,90,79,3774.07,7331.89,0.00
2024-12-10 17:22:06,169,5861,90,79,3822.36,7332.00,0.00
2024-12-10 17:22:06,170,5861,91,79,3799.87,7332.01,0.00
2024-12-10 17:22:06,171,5860,92,79,3740.43,7332.50,0.00
2024-12-10 17:22:06,171,5861,92,79,3890.71,7333.00,0.00
2024-12-10 17:22:06,172,5861,93,79,3868.09,7333.01,0.00
2024-12-10 17:22:06,171,5861,92,79,3880.96,7333.11,0.00
2024-12-10 17:22:06,170,5861,92,78,3858.27,7333.71,0.00
2024-12-10 17:22:06,170,5862,92,78,3918.42,7334.00,0.00
2024-12-10 17:22:06,171,5862,92,79,3895.50,7334.01,0.00
2024-12-10 17:22:06,172,5861,93,79,3844.02,7334.40,0.00
2024-12-10 17:22:06,172,5862,93,79,3849.60,7335.00,0.00
2024-12-10 17:22:06,173,5862,93,80,3827.35,7335.01,0.00
2024-12-10 17:22:06,172,5862,93,79,3847.48,7335.03,0.00
2024-12-10 17:22:06,172,5863,93,79,3854.99,7336.00,0.00
2024-12-10 17:22:06,173,5863,93,80,3832.71,7336.01,0.00
2024-12-10 17:22:06,173,5864,93,80,3792.98,7337.00,0.00
2024-12-10 17:22:06,174,5864,94,80,3771.18,7337.01,0.00
2024-12-10 17:22:06,173,5864,93,80,3790.02,7337.04,0.00
2024-12-10 17:22:06,174,5863,94,80,3733.82,7337.48,0.00
2024-12-10 17:22:06,174,5864,94,80,3753.57,7338.00,0.00
2024-12-10 17:22:06,175,5864,95,80,3732.12,7338.01,0.00
2024-12-10 17:22:06,174,5864,95,79,3737.95,7338.13,0.00
2024-12-10 17:22:06,174,5865,95,79,3749.01,7339.00,0.00
2024-12-10 17:22:06,175,5865,95,80,3727.59,7339.01,0.00
2024-12-10 17:22:06,174,5865,94,80,3745.23,7339.05,0.00
2024-12-10 17:22:06,173,5865,94,79,3755.88,7339.13,0.00
2024-12-10 17:22:06,172,5865,94,78,3734.44,7339.67,0.00
2024-12-10 17:22:06,172,5866,94,78,3748.00,7340.00,0.00
2024-12-10 17:22:06,173,5866,95,78,3726.33,7340.01,0.00
2024-12-10 17:22:06,172,5866,94,78,3743.38,7340.06,0.00
2024-12-10 17:22:06,172,5867,94,78,3709.42,7341.00,0.00
2024-12-10 17:22:06,173,5867,94,79,3687.98,7341.01,0.00
2024-12-10 17:22:06,172,5867,94,78,3698.80,7341.13,0.00
2024-12-10 17:22:06,173,5866,95,78,3667.68,7341.28,0.00
2024-12-10 17:22:06,173,5867,95,78,3687.34,7342.00,0.00
2024-12-10 17:22:06,174,5867,95,79,3666.15,7342.01,0.00
2024-12-10 17:22:06,173,5867,94,79,3677.63,7342.13,0.00
2024-12-10 17:22:06,172,5867,94,78,3698.97,7342.13,0.00
2024-12-10 17:22:06,172,5868,94,78,3715.18,7343.00,0.00
2024-12-10 17:22:06,173,5868,95,78,3693.71,7343.01,0.00
2024-12-10 17:22:06,172,5868,94,78,3705.41,7343.13,0.00
2024-12-10 17:22:06,173,5867,94,79,3671.29,7343.32,0.00
2024-12-10 17:22:06,174,5866,95,79,3683.53,7343.33,0.00
2024-12-10 17:22:06,174,5867,95,79,3702.30,7344.00,0.00
2024-12-10 17:22:06,175,5867,96,79,3681.15,7344.01,0.00
2024-12-10 17:22:06,176,5866,97,79,3659.40,7344.03,0.00
2024-12-10 17:22:06,175,5866,96,79,3713.01,7344.14,0.00
2024-12-10 17:22:06,175,5867,96,79,3767.96,7345.00,0.00
2024-12-10 17:22:06,176,5867,97,79,3746.55,7345.01,0.00
2024-12-10 17:22:06,175,5867,97,78,3765.45,7345.03,0.00
2024-12-10 17:22:06,176,5866,98,78,3738.92,7345.10,0.00
2024-12-10 17:22:06,175,5866,98,77,3762.82,7345.14,0.00
2024-12-10 17:22:06,175,5867,98,77,3774.17,7346.00,0.00
2024-12-10 17:22:06,176,5867,98,78,3752.73,7346.01,0.00
2024-12-10 17:22:06,177,5866,99,78,3727.18,7346.07,0.00
2024-12-10 17:22:06,176,5866,98,78,3771.13,7346.14,0.00
2024-12-10 17:22:06,176,5867,98,78,3780.95,7347.00,0.00
2024-12-10 17:22:06,177,5867,99,78,3759.59,7347.01,0.00
2024-12-10 17:22:06,176,5867,98,78,3771.13,7347.13,0.00
2024-12-10 17:22:06,176,5868,98,78,3779.43,7348.00,0.00
2024-12-10 17:22:06,177,5868,99,78,3758.08,7348.01,0.00
2024-12-10 17:22:06,176,5868,98,78,3769.87,7348.13,0.00
2024-12-10 17:22:06,176,5869,98,78,3735.26,7349.00,0.00
2024-12-10 17:22:06,177,5869,98,79,3714.15,7349.01,0.00
2024-12-10 17:22:06,176,5869,98,78,3725.70,7349.13,0.00
2024-12-10 17:22:06,176,5870,98,78,3693.03,7350.00,0.00
2024-12-10 17:22:06,177,5870,98,79,3672.16,7350.01,0.00
2024-12-10 17:22:06,176,5870,98,78,3682.06,7350.14,0.00
2024-12-10 17:22:06,176,5871,98,78,3649.18,7351.00,0.00
2024-12-10 17:22:06,177,5871,99,78,3628.57,7351.01,0.00
2024-12-10 17:22:06,176,5871,98,78,3636.89,7351.14,0.00
2024-12-10 17:22:06,175,5871,97,78,3634.90,7351.43,0.00
2024-12-10 17:22:07,175,5872,97,78,3623.56,7352.00,0.00
2024-12-10 17:22:07,176,5872,97,79,3602.97,7352.01,0.00
2024-12-10 17:22:07,175,5872,97,78,3611.62,7352.14,0.00
2024-12-10 17:22:07,174,5872,97,77,3575.03,7352.82,0.00
2024-12-10 17:22:07,173,5872,96,77,3588.47,7352.86,0.00
2024-12-10 17:22:07,173,5873,96,77,3619.70,7353.00,0.00
2024-12-10 17:22:07,174,5873,97,77,3598.89,7353.01,0.00
2024-12-10 17:22:07,173,5873,96,77,3618.85,7353.01,0.00
2024-12-10 17:22:07,172,5873,96,76,3637.68,7353.04,0.00
2024-12-10 17:22:07,173,5872,96,77,3614.25,7353.07,0.00
2024-12-10 17:22:07,172,5872,96,76,3668.21,7353.13,0.00
2024-12-10 17:22:07,172,5873,96,76,3638.76,7354.00,0.00
2024-12-10 17:22:07,173,5873,97,76,3617.73,7354.01,0.00
2024-12-10 17:22:07,172,5873,96,76,3627.52,7354.13,0.00
2024-12-10 17:22:07,173,5872,97,76,3598.50,7354.25,0.00
2024-12-10 17:22:07,172,5872,96,76,3617.13,7354.48,0.00
2024-12-10 17:22:07,172,5873,96,76,3658.31,7355.00,0.00
2024-12-10 17:22:07,173,5873,97,76,3637.16,7355.01,0.00
2024-12-10 17:22:07,172,5873,96,76,3651.50,7355.07,0.00
2024-12-10 17:22:07,171,5873,96,75,3668.15,7355.13,0.00
2024-12-10 17:22:07,170,5873,96,74,3689.29,7355.13,0.00
2024-12-10 17:22:07,171,5872,97,74,3634.66,7355.57,0.00
2024-12-10 17:22:07,170,5872,97,73,3671.57,7355.64,0.00
2024-12-10 17:22:07,170,5873,97,73,3727.74,7356.00,0.00
2024-12-10 17:22:07,171,5873,97,74,3705.94,7356.01,0.00
2024-12-10 17:22:07,170,5873,97,73,3718.23,7356.11,0.00
2024-12-10 17:22:07,169,5873,96,73,3738.49,7356.12,0.00
2024-12-10 17:22:07,168,5873,96,72,3760.31,7356.13,0.00
2024-12-10 17:22:07,169,5872,97,72,3712.21,7356.49,0.00
2024-12-10 17:22:07,168,5872,97,71,3745.85,7356.66,0.00
2024-12-10 17:22:07,168,5873,97,71,3804.47,7357.00,0.00
2024-12-10 17:22:07,169,5873,97,72,3781.95,7357.01,0.00
2024-12-10 17:22:07,170,5872,98,72,3750.85,7357.11,0.00
2024-12-10 17:22:07,169,5872,97,72,3787.86,7357.13,0.00
2024-12-10 17:22:07,169,5873,97,72,3803.82,7358.00,0.00
2024-12-10 17:22:07,170,5873,98,72,3781.44,7358.01,0.00
2024-12-10 17:22:07,169,5873,98,71,3792.46,7358.12,0.00
2024-12-10 17:22:07,169,5873,98,71,3808.26,7359.00,0.00
2024-12-10 17:22:07,170,5873,98,72,3785.86,7359.01,0.00
2024-12-10 17:22:07,169,5873,98,71,3795.51,7359.13,0.00
2024-12-10 17:22:07,169,5874,98,71,3768.16,7360.00,0.00
2024-12-10 17:22:07,170,5874,98,72,3745.99,7360.01,0.00
2024-12-10 17:22:07,169,5874,97,72,3754.17,7360.13,0.00
2024-12-10 17:22:07,168,5874,97,71,3776.08,7360.13,0.00
2024-12-10 17:22:07,169,5873,98,71,3745.49,7360.25,0.00
2024-12-10 17:22:07,168,5873,98,70,3768.44,7360.76,0.00
2024-12-10 17:22:07,168,5874,98,70,3793.60,7361.00,0.00
2024-12-10 17:22:07,169,5874,98,71,3771.15,7361.01,0.00
2024-12-10 17:22:07,168,5874,97,71,3782.11,7361.09,0.00
2024-12-10 17:22:07,167,5874,96,71,3801.69,7361.13,0.00
2024-12-10 17:22:07,166,5874,95,71,3824.15,7361.13,0.00
2024-12-10 17:22:07,166,5875,95,71,3847.39,7362.00,0.00
2024-12-10 17:22:07,167,5875,96,71,3824.35,7362.01,0.00
2024-12-10 17:22:07,166,5875,96,70,3837.07,7362.07,0.00
2024-12-10 17:22:07,165,5875,95,70,3855.89,7362.12,0.00
2024-12-10 17:22:07,164,5875,95,69,3878.95,7362.12,0.00
2024-12-10 17:22:07,163,5875,94,69,3901.85,7362.13,0.00
2024-12-10 17:22:07,163,5876,94,69,3877.08,7363.00,0.00
2024-12-10 17:22:07,164,5876,94,70,3853.44,7363.01,0.00
2024-12-10 17:22:07,165,5875,95,70,3765.04,7363.84,0.00
2024-12-10 17:22:07,165,5876,95,70,3798.07,7364.00,0.00
2024-12-10 17:22:07,166,5876,96,70,3775.19,7364.01,0.00
2024-12-10 17:22:07,165,5876,96,69,3787.60,7364.10,0.00
2024-12-10 17:22:07,166,5875,96,70,3763.47,7364.13,0.00
2024-12-10 17:22:07,165,5875,95,70,3803.70,7364.14,0.00
2024-12-10 17:22:07,164,5875,94,70,3826.00,7364.15,0.00
2024-12-10 17:22:07,165,5874,95,70,3784.13,7364.41,0.00
2024-12-10 17:22:07,164,5874,94,70,3771.68,7364.85,0.00
2024-12-10 17:22:07,164,5875,94,70,3847.96,7365.00,0.00
2024-12-10 17:22:07,165,5875,94,71,3824.64,7365.01,0.00
2024-12-10 17:22:07,166,5874,95,71,3801.16,7365.02,0.00
2024-12-10 17:22:07,165,5874,94,71,3830.51,7365.06,0.00
2024-12-10 17:22:07,164,5874,93,71,3847.18,7365.14,0.00
2024-12-10 17:22:07,163,5874,93,70,3870.33,7365.14,0.00
2024-12-10 17:22:07,164,5873,94,70,3786.10,7365.93,0.00
2024-12-10 17:22:07,164,5874,94,70,3918.73,7366.00,0.00
2024-12-10 17:22:07,165,5874,94,71,3894.98,7366.01,0.00
2024-12-10 17:22:07,164,5874,93,71,3908.91,7366.13,0.00
2024-12-10 17:22:07,164,5875,93,71,3975.87,7367.00,0.00
2024-12-10 17:22:07,165,5875,94,71,3951.77,7367.01,0.00
2024-12-10 17:22:07,164,5875,93,71,3964.92,7367.13,0.00
2024-12-10 17:22:07,164,5876,93,71,3941.07,7368.00,0.00
2024-12-10 17:22:07,165,5876,94,71,3917.19,7368.01,0.00
2024-12-10 17:22:07,166,5875,95,71,3890.05,7368.07,0.00
2024-12-10 17:22:07,165,5875,94,71,3911.65,7368.14,0.00
2024-12-10 17:22:07,165,5876,94,71,3885.87,7369.00,0.00
2024-12-10 17:22:07,166,5876,95,71,3862.46,7369.01,0.00
2024-12-10 17:22:07,165,5876,95,70,3872.41,7369.13,0.00
2024-12-10 17:22:07,164,5876,95,69,3889.10,7369.20,0.00
2024-12-10 17:22:07,164,5876,95,69,3914.70,7370.00,0.00
2024-12-10 17:22:07,165,5876,95,70,3890.97,7370.01,0.00
2024-12-10 17:22:07,164,5876,94,70,3912.91,7370.02,0.00
2024-12-10 17:22:07,163,5876,93,70,3923.29,7370.13,0.00
2024-12-10 17:22:07,162,5876,92,70,3947.06,7370.13,0.00
2024-12-10 17:22:07,162,5877,92,70,3922.23,7371.00,0.00
2024-12-10 17:22:07,163,5877,93,70,3898.17,7371.01,0.00
2024-12-10 17:22:07,164,5876,94,70,3873.95,7371.02,0.00
2024-12-10 17:22:07,163,5876,94,69,3898.36,7371.03,0.00
2024-12-10 17:22:07,163,5877,94,69,3859.81,7372.00,0.00
2024-12-10 17:22:07,164,5877,94,70,3836.28,7372.01,0.00
2024-12-10 17:22:07,163,5877,94,69,3842.57,7372.13,0.00
2024-12-10 17:22:07,162,5877,93,69,3865.83,7372.13,0.00
2024-12-10 17:22:07,163,5876,93,70,3840.31,7372.17,0.00
2024-12-10 17:22:07,164,5875,94,70,3820.97,7372.35,0.00
2024-12-10 17:22:07,164,5876,94,70,3890.51,7373.00,0.00
2024-12-10 17:22:07,165,5876,95,70,3866.94,7373.01,0.00
2024-12-10 17:22:07,164,5876,95,69,3873.05,7373.13,0.00
2024-12-10 17:22:07,165,5875,95,70,3820.30,7373.52,0.00
2024-12-10 17:22:07,165,5876,95,70,3939.10,7374.00,0.00
2024-12-10 17:22:07,166,5876,95,71,3915.37,7374.01,0.00
2024-12-10 17:22:07,165,5876,94,71,3867.51,7374.80,0.00
2024-12-10 17:22:08,165,5876,94,71,3940.95,7375.00,0.00
2024-12-10 17:22:08,166,5876,95,71,3917.21,7375.01,0.00
2024-12-10 17:22:08,165,5876,94,71,3932.91,7375.08,0.00
2024-12-10 17:22:08,164,5876,94,70,3949.75,7375.11,0.00
2024-12-10 17:22:08,163,5876,93,70,3972.63,7375.12,0.00
2024-12-10 17:22:08,164,5875,93,71,3944.82,7375.18,0.00
2024-12-10 17:22:08,163,5875,92,71,3974.47,7375.45,0.00
2024-12-10 17:22:08,163,5876,92,71,3974.04,7376.00,0.00
2024-12-10 17:22:08,164,5876,92,72,3949.81,7376.01,0.00
2024-12-10 17:22:08,163,5876,91,72,3965.04,7376.12,0.00
2024-12-10 17:22:08,164,5875,91,73,3922.50,7376.38,0.00
2024-12-10 17:22:08,164,5876,91,73,3991.52,7377.00,0.00
2024-12-10 17:22:08,165,5876,91,74,3967.33,7377.01,0.00
2024-12-10 17:22:08,164,5876,90,74,3990.18,7377.02,0.00
2024-12-10 17:22:08,165,5875,91,74,3940.18,7377.38,0.00
2024-12-10 17:22:08,165,5876,91,74,4011.39,7378.00,0.00
2024-12-10 17:22:08,166,5876,92,74,3987.22,7378.01,0.00
2024-12-10 17:22:08,166,5877,92,74,3997.88,7379.00,0.00
2024-12-10 17:22:08,167,5877,92,75,3973.94,7379.01,0.00
2024-12-10 17:22:08,166,5877,92,74,3996.55,7379.02,0.00
2024-12-10 17:22:08,165,5877,91,74,4012.78,7379.12,0.00
2024-12-10 17:22:08,164,5877,90,74,4036.79,7379.12,0.00
2024-12-10 17:22:08,165,5876,91,74,3974.13,7379.62,0.00
2024-12-10 17:22:08,166,5875,91,75,3952.57,7379.84,0.00
2024-12-10 17:22:08,166,5876,91,75,3996.56,7380.00,0.00
2024-12-10 17:22:08,167,5876,91,76,3972.63,7380.01,0.00
2024-12-10 17:22:08,166,5876,91,75,3987.24,7380.13,0.00
2024-12-10 17:22:08,166,5877,91,75,4050.07,7381.00,0.00
2024-12-10 17:22:08,167,5877,91,76,4025.82,7381.01,0.00
2024-12-10 17:22:08,166,5877,90,76,4048.30,7381.02,0.00
2024-12-10 17:22:08,165,5877,89,76,4064.76,7381.12,0.00
2024-12-10 17:22:08,164,5877,88,76,4064.32,7381.46,0.00
2024-12-10 17:22:08,164,5878,88,76,4066.08,7382.00,0.00
2024-12-10 17:22:08,165,5878,88,77,4041.44,7382.01,0.00
2024-12-10 17:22:08,164,5878,87,77,4064.74,7382.02,0.00
2024-12-10 17:22:08,163,5878,87,76,4079.98,7382.13,0.00
2024-12-10 17:22:08,163,5879,87,76,4057.66,7383.00,0.00
2024-12-10 17:22:08,164,5879,87,77,4032.91,7383.01,0.00
2024-12-10 17:22:08,163,5879,86,77,4055.86,7383.02,0.00
2024-12-10 17:22:08,164,5878,86,78,4023.93,7383.11,0.00
2024-12-10 17:22:08,163,5878,85,78,4070.13,7383.13,0.00
2024-12-10 17:22:08,162,5878,84,78,4094.80,7383.13,0.00
2024-12-10 17:22:08,162,5879,84,78,4073.51,7384.00,0.00
2024-12-10 17:22:08,163,5879,85,78,4048.52,7384.01,0.00
2024-12-10 17:22:08,162,5879,85,77,4061.84,7384.12,0.00
2024-12-10 17:22:08,162,5880,85,77,4086.38,7385.00,0.00
2024-12-10 17:22:08,163,5880,85,78,4061.31,7385.01,0.00
2024-12-10 17:22:08,162,5880,84,78,4084.12,7385.03,0.00
2024-12-10 17:22:08,161,5880,83,78,4098.74,7385.12,0.00
2024-12-10 17:22:08,160,5880,83,77,4123.89,7385.13,0.00
2024-12-10 17:22:08,160,5881,83,77,4103.76,7386.00,0.00
2024-12-10 17:22:08,161,5881,83,78,4078.27,7386.01,0.00
2024-12-10 17:22:08,160,5881,82,78,4094.18,7386.08,0.00
2024-12-10 17:22:08,159,5881,82,77,4116.70,7386.12,0.00
2024-12-10 17:22:08,160,5880,83,77,4048.74,7386.71,0.00
2024-12-10 17:22:08,160,5881,83,77,4084.99,7387.00,0.00
2024-12-10 17:22:08,161,5881,83,78,4059.62,7387.01,0.00
2024-12-10 17:22:08,160,5881,83,77,4076.11,7387.12,0.00
2024-12-10 17:22:08,160,5882,83,77,4102.26,7388.00,0.00
2024-12-10 17:22:08,161,5882,83,78,4076.78,7388.01,0.00
2024-12-10 17:22:08,160,5882,83,77,4092.49,7388.12,0.00
2024-12-10 17:22:08,160,5883,83,77,4072.66,7389.00,0.00
2024-12-10 17:22:08,161,5883,84,77,4047.37,7389.01,0.00
2024-12-10 17:22:08,160,5883,83,77,4062.20,7389.12,0.00
2024-12-10 17:22:08,161,5882,83,78,4031.02,7389.21,0.00
2024-12-10 17:22:08,161,5883,83,78,4057.76,7390.00,0.00
2024-12-10 17:22:08,162,5883,83,79,4032.71,7390.01,0.00
2024-12-10 17:22:08,161,5883,83,78,4046.95,7390.12,0.00
2024-12-10 17:22:08,161,5884,83,78,4072.64,7391.00,0.00
2024-12-10 17:22:08,162,5884,83,79,4047.50,7391.01,0.00
2024-12-10 17:22:08,161,5884,83,78,4062.41,7391.11,0.00
2024-12-10 17:22:08,160,5884,83,77,4086.88,7391.11,0.00
2024-12-10 17:22:08,160,5885,83,77,4066.20,7392.00,0.00
2024-12-10 17:22:08,161,5885,83,78,4040.95,7392.01,0.00
2024-12-10 17:22:08,160,5885,82,78,4055.17,7392.11,0.00
2024-12-10 17:22:08,161,5884,82,79,3975.37,7392.86,0.00
2024-12-10 17:22:08,161,5885,82,79,4018.16,7393.00,0.00
2024-12-10 17:22:08,162,5885,82,80,3993.36,7393.01,0.00
2024-12-10 17:22:08,163,5884,82,81,3963.45,7393.09,0.00
2024-12-10 17:22:08,162,5884,81,81,3991.83,7393.12,0.00
2024-12-10 17:22:08,163,5883,82,81,3908.27,7393.90,0.00
2024-12-10 17:22:08,163,5884,82,81,3999.72,7394.00,0.00
2024-12-10 17:22:08,164,5884,82,82,3975.33,7394.01,0.00
2024-12-10 17:22:08,165,5883,83,82,3946.79,7394.08,0.00
2024-12-10 17:22:08,164,5883,82,82,3987.40,7394.12,0.00
2024-12-10 17:22:08,165,5882,83,82,3948.49,7394.33,0.00
2024-12-10 17:22:08,165,5883,83,82,4047.71,7395.00,0.00
2024-12-10 17:22:08,166,5883,83,83,4023.33,7395.01,0.00
2024-12-10 17:22:08,165,5883,82,83,4036.92,7395.11,0.00
2024-12-10 17:22:08,165,5884,82,83,4101.19,7396.00,0.00
2024-12-10 17:22:08,166,5884,82,84,4076.48,7396.01,0.00
2024-12-10 17:22:08,166,5885,82,84,4039.83,7397.00,0.00
2024-12-10 17:22:08,167,5885,83,84,4015.64,7397.01,0.00
2024-12-10 17:22:08,166,5885,82,84,4028.84,7397.11,0.00
2024-12-10 17:22:08,166,5886,82,84,4001.67,7398.00,0.00
2024-12-10 17:22:08,167,5886,83,84,3977.71,7398.01,0.00
2024-12-10 17:22:08,168,5885,84,84,3953.59,7398.02,0.00
2024-12-10 17:22:08,167,5885,84,83,3986.58,7398.05,0.00
2024-12-10 17:22:08,166,5885,83,83,4002.72,7398.11,0.00
2024-12-10 17:22:08,165,5885,83,82,4026.53,7398.12,0.00
2024-12-10 17:22:09,165,5886,83,82,3998.75,7399.00,0.00
2024-12-10 17:22:09,166,5886,83,83,3974.66,7399.01,0.00
2024-12-10 17:22:09,165,5886,83,82,3987.62,7399.12,0.00
2024-12-10 17:22:09,165,5887,83,82,4004.53,7400.00,0.00
2024-12-10 17:22:09,166,5887,83,83,3980.40,7400.01,0.00
2024-12-10 17:22:09,165,5887,83,82,3993.14,7400.12,0.00
2024-12-10 17:22:09,165,5888,83,82,3964.69,7401.00,0.00
2024-12-10 17:22:09,166,5888,83,83,3940.81,7401.01,0.00
2024-12-10 17:22:09,165,5888,83,82,3956.71,7401.09,0.00
2024-12-10 17:22:09,166,5887,84,82,3893.40,7401.64,0.00
2024-12-10 17:22:09,166,5888,84,82,3919.75,7402.00,0.00
2024-12-10 17:22:09,167,5888,85,82,3896.28,7402.01,0.00
2024-12-10 17:22:09,166,5888,85,81,3911.34,7402.11,0.00
2024-12-10 17:22:09,165,5888,85,80,3888.32,7402.74,0.00
2024-12-10 17:22:09,165,5889,85,80,3954.47,7403.00,0.00
2024-12-10 17:22:09,166,5889,86,80,3930.65,7403.01,0.00
2024-12-10 17:22:09,165,5889,85,80,3946.00,7403.12,0.00
2024-12-10 17:22:09,165,5890,85,80,3920.41,7404.00,0.00
2024-12-10 17:22:09,166,5890,85,81,3896.80,7404.01,0.00
2024-12-10 17:22:09,167,5889,85,82,3870.38,7404.06,0.00
2024-12-10 17:22:09,166,5889,85,81,3906.22,7404.12,0.00
2024-12-10 17:22:09,165,5889,85,80,3881.72,7404.75,0.00
2024-12-10 17:22:09,166,5888,86,80,3857.01,7404.77,0.00
2024-12-10 17:22:09,166,5889,86,80,3896.21,7405.00,0.00
2024-12-10 17:22:09,167,5889,87,80,3872.88,7405.01,0.00
2024-12-10 17:22:09,166,5889,87,79,3887.79,7405.11,0.00
2024-12-10 17:22:09,165,5889,86,79,3910.91,7405.12,0.00
2024-12-10 17:22:09,165,5890,86,79,3977.11,7406.00,0.00
2024-12-10 17:22:09,166,5890,87,79,3953.15,7406.01,0.00
2024-12-10 17:22:09,166,5891,87,79,3920.35,7407.00,0.00
2024-12-10 17:22:09,167,5891,88,79,3896.88,7407.01,0.00
2024-12-10 17:22:09,168,5890,89,79,3866.74,7407.10,0.00
2024-12-10 17:22:09,167,5890,89,78,3925.40,7407.13,0.00
2024-12-10 17:22:09,167,5891,89,78,3901.97,7408.00,0.00
2024-12-10 17:22:09,168,5891,90,78,3878.75,7408.01,0.00
2024-12-10 17:22:09,167,5891,89,78,3899.39,7408.03,0.00
2024-12-10 17:22:09,166,5891,88,78,3912.80,7408.13,0.00
2024-12-10 17:22:09,165,5891,87,78,3917.50,7408.36,0.00
2024-12-10 17:22:09,166,5890,88,78,3855.73,7408.89,0.00
2024-12-10 17:22:09,166,5891,88,78,3942.42,7409.00,0.00
2024-12-10 17:22:09,167,5891,89,78,3918.81,7409.01,0.00
2024-12-10 17:22:09,166,5891,89,77,3930.19,7409.13,0.00
2024-12-10 17:22:09,165,5891,89,76,3953.56,7409.13,0.00
2024-12-10 17:22:09,166,5890,89,77,3924.39,7409.21,0.00
2024-12-10 17:22:09,167,5889,90,77,3896.49,7409.37,0.00
2024-12-10 17:22:09,168,5888,90,78,3878.05,7409.72,0.00
2024-12-10 17:22:09,168,5889,90,78,3947.33,7410.00,0.00
2024-12-10 17:22:09,169,5889,91,78,3923.98,7410.01,0.00
2024-12-10 17:22:09,168,5889,90,78,3934.95,7410.13,0.00
2024-12-10 17:22:09,168,5890,90,78,4046.75,7411.00,0.00
2024-12-10 17:22:09,169,5890,90,79,4022.80,7411.01,0.00
2024-12-10 17:22:09,168,5890,90,78,4034.07,7411.13,0.00
2024-12-10 17:22:09,169,5889,90,79,4001.01,7411.26,0.00
2024-12-10 17:22:09,169,5890,90,79,4026.14,7412.00,0.00
2024-12-10 17:22:09,170,5890,91,79,4002.46,7412.01,0.00
2024-12-10 17:22:09,169,5890,91,78,4012.91,7412.12,0.00
2024-12-10 17:22:09,169,5891,91,78,4035.20,7413.00,0.00
2024-12-10 17:22:09,170,5891,92,78,4011.46,7413.01,0.00
2024-12-10 17:22:09,169,5891,91,78,4021.10,7413.12,0.00
2024-12-10 17:22:09,168,5891,90,78,4028.60,7413.34,0.00
2024-12-10 17:22:09,168,5892,90,78,4024.11,7414.00,0.00
2024-12-10 17:22:09,169,5892,90,79,4000.30,7414.01,0.00
2024-12-10 17:22:09,168,5892,89,79,4009.16,7414.13,0.00
2024-12-10 17:22:09,168,5893,89,79,3988.80,7415.00,0.00
2024-12-10 17:22:09,169,5893,90,79,3965.20,7415.01,0.00
2024-12-10 17:22:09,168,5893,90,78,3973.03,7415.13,0.00
2024-12-10 17:22:09,168,5894,90,78,3952.76,7416.00,0.00
2024-12-10 17:22:09,169,5894,90,79,3929.37,7416.01,0.00
2024-12-10 17:22:09,168,5894,89,79,3936.06,7416.13,0.00
2024-12-10 17:22:09,168,5895,89,79,3915.39,7417.00,0.00
2024-12-10 17:22:09,169,5895,90,79,3892.22,7417.01,0.00
2024-12-10 17:22:09,170,5894,91,79,3868.02,7417.04,0.00
2024-12-10 17:22:09,169,5894,91,78,3907.49,7417.12,0.00
2024-12-10 17:22:09,168,5894,91,77,3930.31,7417.13,0.00
2024-12-10 17:22:09,168,5895,91,77,3909.30,7418.00,0.00
2024-12-10 17:22:09,169,5895,91,78,3886.17,7418.01,0.00
2024-12-10 17:22:09,168,5895,90,78,3898.96,7418.12,0.00
2024-12-10 17:22:09,167,5895,89,78,3921.87,7418.12,0.00
2024-12-10 17:22:09,168,5894,89,79,3843.68,7418.88,0.00
2024-12-10 17:22:09,168,5895,89,79,3928.58,7419.00,0.00
2024-12-10 17:22:09,169,5895,90,79,3905.33,7419.01,0.00
2024-12-10 17:22:09,168,5895,90,78,3928.14,7419.01,0.00
2024-12-10 17:22:09,167,5895,89,78,3940.75,7419.11,0.00
2024-12-10 17:22:09,166,5895,89,77,3964.04,7419.11,0.00
2024-12-10 17:22:09,166,5896,89,77,3988.21,7420.00,0.00
2024-12-10 17:22:09,167,5896,89,78,3964.32,7420.01,0.00
2024-12-10 17:22:09,168,5895,89,79,3936.34,7420.08,0.00
2024-12-10 17:22:09,167,5895,89,78,3990.42,7420.13,0.00
2024-12-10 17:22:09,166,5895,88,78,4014.01,7420.13,0.00
2024-12-10 17:22:09,166,5896,88,78,3994.35,7421.00,0.00
2024-12-10 17:22:09,167,5896,88,79,3970.44,7421.01,0.00
2024-12-10 17:22:09,166,5896,88,78,3980.46,7421.12,0.00
2024-12-10 17:22:09,165,5896,88,77,4004.13,7421.12,0.00
2024-12-10 17:22:09,166,5895,88,78,3972.42,7421.24,0.00
2024-12-10 17:22:09,167,5894,89,78,3963.42,7421.55,0.00
2024-12-10 17:22:09,167,5895,89,78,4038.42,7422.00,0.00
2024-12-10 17:22:10,168,5895,89,79,4014.38,7422.01,0.00
2024-12-10 17:22:10,167,5895,88,79,4025.02,7422.12,0.00
2024-12-10 17:22:10,168,5894,89,79,3946.88,7422.86,0.00
2024-12-10 17:22:10,168,5895,89,79,4072.99,7423.00,0.00
2024-12-10 17:22:10,169,5895,89,80,4048.89,7423.01,0.00
2024-12-10 17:22:10,168,5895,89,79,4060.84,7423.12,0.00
2024-12-10 17:22:10,169,5894,89,80,4035.05,7423.15,0.00
2024-12-10 17:22:10,169,5895,89,80,4061.10,7424.00,0.00
2024-12-10 17:22:10,170,5895,89,81,4037.21,7424.01,0.00
2024-12-10 17:22:10,169,5895,89,80,4050.51,7424.12,0.00
2024-12-10 17:22:10,170,5894,89,81,3996.68,7424.54,0.00
2024-12-10 17:22:10,170,5895,89,81,4065.43,7425.00,0.00
2024-12-10 17:22:10,171,5895,89,82,4041.66,7425.01,0.00
2024-12-10 17:22:10,172,5894,90,82,4017.73,7425.02,0.00
2024-12-10 17:22:10,171,5894,90,81,4055.75,7425.12,0.00
2024-12-10 17:22:10,172,5893,90,82,3986.99,7425.72,0.00
2024-12-10 17:22:10,172,5894,90,82,4054.24,7426.00,0.00
2024-12-10 17:22:10,173,5894,91,82,4030.80,7426.01,0.00
2024-12-10 17:22:10,172,5894,91,81,4042.78,7426.12,0.00
2024-12-10 17:22:10,172,5895,91,81,4100.51,7427.00,0.00
2024-12-10 17:22:10,173,5895,92,81,4076.81,7427.01,0.00
2024-12-10 17:22:10,174,5894,92,82,4051.26,7427.05,0.00
2024-12-10 17:22:10,173,5894,91,82,4074.08,7427.12,0.00
2024-12-10 17:22:10,173,5895,91,82,4045.25,7428.00,0.00
2024-12-10 17:22:10,174,5895,91,83,4022.00,7428.01,0.00
2024-12-10 17:22:10,175,5894,91,84,3977.59,7428.23,0.00
2024-12-10 17:22:10,175,5895,91,84,4034.93,7429.00,0.00
2024-12-10 17:22:10,176,5895,92,84,4012.01,7429.01,0.00
2024-12-10 17:22:10,175,5895,92,83,4024.62,7429.07,0.00
2024-12-10 17:22:10,174,5895,92,82,4042.26,7429.12,0.00
2024-12-10 17:22:10,173,5895,92,81,4065.20,7429.12,0.00
2024-12-10 17:22:10,173,5896,92,81,4076.94,7430.00,0.00
2024-12-10 17:22:10,174,5896,92,82,4053.51,7430.01,0.00
2024-12-10 17:22:10,173,5896,91,82,4064.00,7430.08,0.00
2024-12-10 17:22:10,172,5896,91,81,4085.06,7430.11,0.00
2024-12-10 17:22:10,171,5896,90,81,4086.49,7430.40,0.00
2024-12-10 17:22:10,171,5897,90,81,4077.49,7431.00,0.00
2024-12-10 17:22:10,172,5897,90,82,4053.78,7431.01,0.00
2024-12-10 17:22:10,173,5896,91,82,4030.35,7431.02,0.00
2024-12-10 17:22:10,172,5896,91,81,4057.76,7431.12,0.00
2024-12-10 17:22:10,171,5896,90,81,4081.06,7431.12,0.00
2024-12-10 17:22:10,171,5897,90,81,4051.67,7432.00,0.00
2024-12-10 17:22:10,172,5897,91,81,4028.12,7432.01,0.00
2024-12-10 17:22:10,171,5897,90,81,4045.21,7432.06,0.00
2024-12-10 17:22:10,170,5897,89,81,4064.65,7432.11,0.00
2024-12-10 17:22:10,169,5897,88,81,4088.27,7432.11,0.00
2024-12-10 17:22:10,170,5896,89,81,4020.51,7432.67,0.00
2024-12-10 17:22:10,169,5896,89,80,4039.98,7432.88,0.00
2024-12-10 17:22:10,170,5895,90,80,4016.22,7432.88,0.00
2024-12-10 17:22:10,170,5896,90,80,4099.40,7433.00,0.00
2024-12-10 17:22:10,171,5896,90,81,4075.42,7433.01,0.00
2024-12-10 17:22:10,170,5896,89,81,4086.67,7433.11,0.00
2024-12-10 17:22:10,170,5897,89,81,4147.10,7434.00,0.00
2024-12-10 17:22:10,171,5897,89,82,4122.85,7434.01,0.00
2024-12-10 17:22:10,170,5897,89,81,4118.09,7434.11,0.00
2024-12-10 17:22:10,170,5898,89,81,4090.45,7435.00,0.00
2024-12-10 17:22:10,171,5898,90,81,4066.53,7435.01,0.00
2024-12-10 17:22:10,170,5898,89,81,4088.29,7435.03,0.00
2024-12-10 17:22:10,169,5898,88,81,4105.92,7435.05,0.00
2024-12-10 17:22:10,168,5898,88,80,4125.36,7435.10,0.00
2024-12-10 17:22:10,169,5897,89,80,4095.25,7435.18,0.00
2024-12-10 17:22:10,169,5898,89,80,4111.71,7436.00,0.00
2024-12-10 17:22:10,170,5898,90,80,4087.52,7436.01,0.00
2024-12-10 17:22:10,170,5899,90,80,4092.54,7437.00,0.00
2024-12-10 17:22:10,171,5899,90,81,4068.61,7437.01,0.00
2024-12-10 17:22:10,170,5899,89,81,4083.56,7437.10,0.00
2024-12-10 17:22:10,169,5899,89,80,4065.79,7437.59,0.00
2024-12-10 17:22:10,169,5900,89,80,4077.18,7438.00,0.00
2024-12-10 17:22:10,170,5900,90,80,4053.19,7438.01,0.00
2024-12-10 17:22:10,171,5899,91,80,4001.63,7438.37,0.00
2024-12-10 17:22:10,171,5900,91,80,4023.98,7439.00,0.00
2024-12-10 17:22:10,172,5900,92,80,4000.58,7439.01,0.00
2024-12-10 17:22:10,172,5901,92,80,4005.23,7440.00,0.00
2024-12-10 17:22:10,173,5901,93,80,3982.08,7440.01,0.00
2024-12-10 17:22:10,172,5901,92,80,3994.69,7440.11,0.00
2024-12-10 17:22:10,173,5900,92,81,3906.15,7440.67,0.00
2024-12-10 17:22:10,174,5899,92,82,3874.39,7440.90,0.00
2024-12-10 17:22:10,174,5900,92,82,3914.68,7441.00,0.00
2024-12-10 17:22:10,175,5900,92,83,3892.31,7441.01,0.00
2024-12-10 17:22:10,174,5900,92,82,3903.70,7441.11,0.00
2024-12-10 17:22:10,173,5900,92,81,3889.83,7441.56,0.00
2024-12-10 17:22:10,173,5901,92,81,3980.46,7442.00,0.00
2024-12-10 17:22:10,174,5901,93,81,3957.58,7442.01,0.00
2024-12-10 17:22:10,173,5901,93,80,3968.79,7442.11,0.00
2024-12-10 17:22:10,173,5902,93,80,3937.88,7443.00,0.00
2024-12-10 17:22:10,174,5902,94,80,3915.25,7443.01,0.00
2024-12-10 17:22:10,173,5902,93,80,3935.32,7443.04,0.00
2024-12-10 17:22:10,172,5902,92,80,3948.42,7443.10,0.00
2024-12-10 17:22:10,171,5902,91,80,3970.64,7443.11,0.00
2024-12-10 17:22:10,171,5903,91,80,3939.43,7444.00,0.00
2024-12-10 17:22:10,172,5903,91,81,3916.53,7444.01,0.00
2024-12-10 17:22:10,171,5903,90,81,3930.75,7444.08,0.00
2024-12-10 17:22:10,170,5903,89,81,3951.26,7444.11,0.00
2024-12-10 17:22:10,169,5903,88,81,3932.01,7444.60,0.00
2024-12-10 17:22:10,169,5904,88,81,3943.81,7445.00,0.00
2024-12-10 17:22:10,170,5904,89,81,3920.62,7445.01,0.00
2024-12-10 17:22:10,171,5903,89,82,3891.63,7445.10,0.00
2024-12-10 17:22:10,170,5903,88,82,3941.26,7445.12,0.00
2024-12-10 17:22:10,169,5903,88,81,3932.46,7445.52,0.00
2024-12-10 17:22:11,170,5902,88,82,3903.25,7445.58,0.00
2024-12-10 17:22:11,170,5903,88,82,3932.02,7446.00,0.00
2024-12-10 17:22:11,171,5903,88,83,3909.03,7446.01,0.00
2024-12-10 17:22:11,172,5902,89,83,3883.29,7446.06,0.00
2024-12-10 17:22:11,171,5902,89,82,3917.37,7446.12,0.00
2024-12-10 17:22:11,172,5901,89,83,3834.89,7446.85,0.00
2024-12-10 17:22:11,172,5902,89,83,3960.55,7447.00,0.00
2024-12-10 17:22:11,173,5902,89,84,3937.66,7447.01,0.00
2024-12-10 17:22:11,172,5902,88,84,3951.95,7447.12,0.00
2024-12-10 17:22:11,171,5902,88,83,3929.85,7447.64,0.00
2024-12-10 17:22:11,171,5903,88,83,4032.98,7448.00,0.00
2024-12-10 17:22:11,172,5903,89,83,4009.53,7448.01,0.00
2024-12-10 17:22:11,171,5903,88,83,4024.33,7448.12,0.00
2024-12-10 17:22:11,172,5902,88,84,3990.99,7448.26,0.00
2024-12-10 17:22:11,171,5902,87,84,4044.40,7448.28,0.00
2024-12-10 17:22:11,171,5903,87,84,4031.26,7449.00,0.00
2024-12-10 17:22:11,172,5903,87,85,4007.82,7449.01,0.00
2024-12-10 17:22:11,171,5903,87,84,4005.00,7449.12,0.00
2024-12-10 17:22:11,170,5903,86,84,3998.82,7449.50,0.00
2024-12-10 17:22:11,170,5904,86,84,4048.64,7450.00,0.00
2024-12-10 17:22:11,171,5904,87,84,4024.96,7450.01,0.00
2024-12-10 17:22:11,170,5904,87,83,4022.81,7450.12,0.00
2024-12-10 17:22:11,170,5905,87,83,4000.75,7451.00,0.00
2024-12-10 17:22:11,171,5905,88,83,3977.35,7451.01,0.00
2024-12-10 17:22:11,170,5905,88,82,3990.46,7451.05,0.00
2024-12-10 17:22:11,169,5905,87,82,4008.81,7451.11,0.00
2024-12-10 17:22:11,169,5906,87,82,3986.90,7452.00,0.00
2024-12-10 17:22:11,170,5906,87,83,3963.44,7452.01,0.00
2024-12-10 17:22:11,169,5906,87,82,3978.57,7452.11,0.00
2024-12-10 17:22:11,169,5907,87,82,3956.81,7453.00,0.00
2024-12-10 17:22:11,170,5907,88,82,3933.54,7453.01,0.00
2024-12-10 17:22:11,169,5907,87,82,3948.49,7453.11,0.00
2024-12-10 17:22:11,168,5907,87,81,3971.54,7453.11,0.00
2024-12-10 17:22:11,168,5908,87,81,3948.61,7454.00,0.00
2024-12-10 17:22:11,169,5908,88,81,3925.25,7454.01,0.00
2024-12-10 17:22:11,168,5908,87,81,3940.23,7454.11,0.00
2024-12-10 17:22:11,169,5907,87,82,3888.09,7454.47,0.00
2024-12-10 17:22:11,169,5908,87,82,3904.66,7455.00,0.00
2024-12-10 17:22:11,170,5908,88,82,3881.70,7455.01,0.00
2024-12-10 17:22:11,169,5908,87,82,3900.27,7455.06,0.00
2024-12-10 17:22:11,168,5908,86,82,3919.52,7455.11,0.00
2024-12-10 17:22:11,167,5908,85,82,3942.55,7455.11,0.00
2024-12-10 17:22:11,166,5908,85,81,3953.80,7455.24,0.00
2024-12-10 17:22:11,167,5907,85,82,3912.15,7455.48,0.00
2024-12-10 17:22:11,167,5908,85,82,3966.19,7456.00,0.00
2024-12-10 17:22:11,168,5908,85,83,3942.58,7456.01,0.00
2024-12-10 17:22:11,167,5908,85,82,3958.20,7456.11,0.00
2024-12-10 17:22:11,168,5907,85,83,3930.20,7456.18,0.00
2024-12-10 17:22:11,169,5906,86,83,3928.58,7456.22,0.00
2024-12-10 17:22:11,169,5907,86,83,3995.34,7457.00,0.00
2024-12-10 17:22:11,170,5907,86,84,3971.84,7457.01,0.00
2024-12-10 17:22:11,169,5907,85,84,3993.59,7457.02,0.00
2024-12-10 17:22:11,168,5907,85,83,4010.74,7457.11,0.00
2024-12-10 17:22:11,169,5906,85,84,3953.60,7457.50,0.00
2024-12-10 17:22:11,169,5907,85,84,4071.47,7458.00,0.00
2024-12-10 17:22:11,170,5907,86,84,4047.52,7458.01,0.00
2024-12-10 17:22:11,169,5907,85,84,4063.14,7458.11,0.00
2024-12-10 17:22:11,169,5908,85,84,4077.52,7459.00,0.00
2024-12-10 17:22:11,170,5908,86,84,4053.53,7459.01,0.00
2024-12-10 17:22:11,169,5908,86,83,4069.18,7459.11,0.00
2024-12-10 17:22:11,168,5908,86,82,4058.95,7459.45,0.00
2024-12-10 17:22:11,169,5907,87,82,4022.66,7459.63,0.00
2024-12-10 17:22:11,170,5906,88,82,4004.32,7459.72,0.00
2024-12-10 17:22:11,170,5907,88,82,4034.34,7460.00,0.00
2024-12-10 17:22:11,171,5907,89,82,4010.75,7460.01,0.00
2024-12-10 17:22:11,170,5907,88,82,4031.72,7460.04,0.00
2024-12-10 17:22:11,169,5907,88,81,4049.87,7460.11,0.00
2024-12-10 17:22:11,168,5907,87,81,4073.53,7460.11,0.00
2024-12-10 17:22:11,168,5908,87,81,4134.54,7461.00,0.00
2024-12-10 17:22:11,169,5908,88,81,4110.08,7461.01,0.00
2024-12-10 17:22:11,168,5908,88,80,4126.59,7461.11,0.00
2024-12-10 17:22:11,168,5909,88,80,4097.15,7462.00,0.00
2024-12-10 17:22:11,169,5909,88,81,4072.90,7462.01,0.00
2024-12-10 17:22:11,168,5909,87,81,4089.20,7462.11,0.00
2024-12-10 17:22:11,167,5909,86,81,4108.16,7462.18,0.00
2024-12-10 17:22:11,167,5910,86,81,4083.82,7463.00,0.00
2024-12-10 17:22:11,168,5910,86,82,4059.51,7463.01,0.00
2024-12-10 17:22:11,167,5910,85,82,4077.88,7463.08,0.00
2024-12-10 17:22:11,166,5910,85,81,4100.65,7463.10,0.00
2024-12-10 17:22:11,165,5910,85,80,4112.34,7463.28,0.00
2024-12-10 17:22:11,165,5911,85,80,4094.08,7464.00,0.00
2024-12-10 17:22:11,166,5911,85,81,4069.41,7464.01,0.00
2024-12-10 17:22:11,167,5910,86,81,4043.27,7464.04,0.00
2024-12-10 17:22:11,166,5910,85,81,4098.21,7464.04,0.00
2024-12-10 17:22:11,165,5910,84,81,4117.65,7464.11,0.00
2024-12-10 17:22:11,164,5910,84,80,4142.30,7464.11,0.00
2024-12-10 17:22:11,164,5911,84,80,4109.81,7465.00,0.00
2024-12-10 17:22:11,165,5911,84,81,4084.91,7465.01,0.00
2024-12-10 17:22:11,166,5910,84,82,4055.39,7465.08,0.00
2024-12-10 17:22:11,165,5910,83,82,4095.53,7465.09,0.00
2024-12-10 17:22:11,164,5910,82,82,4120.04,7465.09,0.00
2024-12-10 17:22:11,163,5910,82,81,4143.96,7465.10,0.00
2024-12-10 17:22:11,162,5910,81,81,4169.08,7465.11,0.00
2024-12-10 17:22:11,163,5909,82,81,4070.12,7465.92,0.00
2024-12-10 17:22:11,163,5910,82,81,4161.57,7466.00,0.00
2024-12-10 17:22:11,164,5910,83,81,4136.20,7466.01,0.00
2024-12-10 17:22:11,163,5910,82,81,4132.87,7466.35,0.00
2024-12-10 17:22:11,164,5909,82,82,4075.96,7466.72,0.00
2024-12-10 17:22:11,164,5910,82,82,4201.07,7467.00,0.00
2024-12-10 17:22:11,165,5910,82,83,4175.61,7467.01,0.00
2024-12-10 17:22:11,166,5909,83,83,4094.80,7467.69,0.00
2024-12-10 17:22:11,166,5910,83,83,4171.67,7468.00,0.00
2024-12-10 17:22:11,167,5910,83,84,4146.69,7468.01,0.00
2024-12-10 17:22:11,168,5909,83,85,4116.27,7468.10,0.00
2024-12-10 17:22:11,167,5909,82,85,4144.52,7468.11,0.00
2024-12-10 17:22:11,168,5908,83,85,4060.62,7468.79,0.00
2024-12-10 17:22:12,168,5909,83,85,4142.70,7469.00,0.00
2024-12-10 17:22:12,169,5909,83,86,4118.19,7469.01,0.00
2024-12-10 17:22:12,168,5909,82,86,4128.23,7469.11,0.00
2024-12-10 17:22:12,169,5908,83,86,4043.54,7469.80,0.00
2024-12-10 17:22:12,169,5909,83,86,4169.43,7470.00,0.00
2024-12-10 17:22:12,170,5909,84,86,4144.90,7470.01,0.00
2024-12-10 17:22:12,170,5910,84,86,4091.65,7471.00,0.00
2024-12-10 17:22:12,171,5910,85,86,4067.72,7471.01,0.00
2024-12-10 17:22:12,170,5910,85,85,4081.51,7471.02,0.00
2024-12-10 17:22:12,169,5910,84,85,4099.52,7471.10,0.00
2024-12-10 17:22:12,168,5910,83,85,4060.74,7471.61,0.00
2024-12-10 17:22:12,167,5910,83,84,3990.78,7471.86,0.00
2024-12-10 17:22:12,168,5909,83,85,3966.59,7471.87,0.00
2024-12-10 17:22:12,168,5910,83,85,3967.66,7472.00,0.00
2024-12-10 17:22:12,169,5910,84,85,3944.19,7472.01,0.00
2024-12-10 17:22:12,168,5910,84,84,3959.72,7472.11,0.00
2024-12-10 17:22:12,167,5910,83,84,3982.98,7472.11,0.00
2024-12-10 17:22:12,166,5910,83,83,3971.17,7472.52,0.00
2024-12-10 17:22:12,165,5910,83,82,3988.93,7472.57,0.00
2024-12-10 17:22:12,164,5910,82,82,3991.90,7472.66,0.00
2024-12-10 17:22:12,163,5910,82,81,3994.87,7472.75,0.00
2024-12-10 17:22:12,162,5910,81,81,3960.88,7472.88,0.00
2024-12-10 17:22:12,162,5911,81,81,3992.07,7473.00,0.00
2024-12-10 17:22:12,163,5911,81,82,3967.58,7473.01,0.00
2024-12-10 17:22:12,164,5910,81,83,3937.96,7473.09,0.00
2024-12-10 17:22:12,163,5910,81,82,3912.94,7473.74,0.00
2024-12-10 17:22:12,162,5910,81,81,3933.85,7473.77,0.00
2024-12-10 17:22:12,161,5910,81,80,3913.80,7473.83,0.00
2024-12-10 17:22:12,161,5911,81,80,3840.11,7474.00,0.00
2024-12-10 17:22:12,162,5911,82,80,3816.41,7474.01,0.00
2024-12-10 17:22:12,163,5910,82,81,3793.00,7474.02,0.00
2024-12-10 17:22:12,162,5910,82,80,3827.55,7474.12,0.00
2024-12-10 17:22:12,163,5909,83,80,3772.54,7474.56,0.00
2024-12-10 17:22:12,162,5909,82,80,3786.20,7474.81,0.00
2024-12-10 17:22:12,161,5909,81,80,3761.45,7474.86,0.00
2024-12-10 17:22:12,160,5909,81,79,3778.02,7474.93,0.00
2024-12-10 17:22:12,159,5909,81,78,3799.86,7474.94,0.00
2024-12-10 17:22:12,158,5909,80,78,3811.52,7474.98,0.00
2024-12-10 17:22:12,158,5910,80,78,3893.67,7475.00,0.00
2024-12-10 17:22:12,159,5910,81,78,3869.18,7475.01,0.00
2024-12-10 17:22:12,158,5910,80,78,3884.74,7475.12,0.00
2024-12-10 17:22:12,157,5910,79,78,3845.56,7475.84,0.00
2024-12-10 17:22:12,157,5911,79,78,3962.43,7476.00,0.00
2024-12-10 17:22:12,158,5911,79,79,3937.35,7476.01,0.00
2024-12-10 17:22:12,157,5911,79,78,3959.59,7476.04,0.00
2024-12-10 17:22:12,156,5911,79,77,3978.79,7476.12,0.00
2024-12-10 17:22:12,155,5911,79,76,4003.98,7476.12,0.00
2024-12-10 17:22:12,156,5910,80,76,3949.70,7476.51,0.00
2024-12-10 17:22:12,155,5910,80,75,3936.31,7476.96,0.00
2024-12-10 17:22:12,155,5911,80,75,3981.21,7477.00,0.00
2024-12-10 17:22:12,156,5911,81,75,3955.69,7477.01,0.00
2024-12-10 17:22:12,155,5911,81,74,3972.59,7477.12,0.00
2024-12-10 17:22:12,154,5911,81,73,3988.88,7477.24,0.00
2024-12-10 17:22:12,153,5911,81,72,3949.72,7477.81,0.00
2024-12-10 17:22:12,153,5912,81,72,4033.45,7478.00,0.00
2024-12-10 17:22:12,154,5912,82,72,4007.26,7478.01,0.00
2024-12-10 17:22:12,153,5912,81,72,4024.23,7478.12,0.00
2024-12-10 17:22:12,154,5911,81,73,3986.47,7478.29,0.00
2024-12-10 17:22:12,154,5912,81,73,3997.51,7479.00,0.00
2024-12-10 17:22:12,155,5912,82,73,3971.72,7479.01,0.00
2024-12-10 17:22:12,154,5912,82,72,3988.35,7479.12,0.00
2024-12-10 17:22:12,153,5912,81,72,4013.93,7479.12,0.00
2024-12-10 17:22:12,153,5913,81,72,4020.40,7480.00,0.00
2024-12-10 17:22:12,154,5913,81,73,3994.29,7480.01,0.00
2024-12-10 17:22:12,153,5913,81,72,4010.69,7480.13,0.00
2024-12-10 17:22:12,154,5912,81,73,3972.53,7480.31,0.00
2024-12-10 17:22:12,153,5912,81,72,3996.70,7480.46,0.00
2024-12-10 17:22:12,152,5912,81,71,4019.95,7480.50,0.00
2024-12-10 17:22:12,152,5913,81,71,4017.85,7481.00,0.00
2024-12-10 17:22:12,153,5913,82,71,3991.59,7481.01,0.00
2024-12-10 17:22:12,152,5913,82,70,4008.07,7481.13,0.00
2024-12-10 17:22:12,151,5913,81,70,4018.61,7481.30,0.00
2024-12-10 17:22:12,151,5914,81,70,4040.15,7482.00,0.00
2024-12-10 17:22:12,152,5914,82,70,4013.57,7482.01,0.00
2024-12-10 17:22:12,153,5913,82,71,3985.88,7482.04,0.00
2024-12-10 17:22:12,152,5913,81,71,4014.01,7482.13,0.00
2024-12-10 17:22:12,151,5913,81,70,4039.60,7482.13,0.00
2024-12-10 17:22:12,150,5913,80,70,4038.94,7482.47,0.00
2024-12-10 17:22:12,151,5912,81,70,3998.88,7482.66,0.00
2024-12-10 17:22:12,151,5913,81,70,4038.92,7483.00,0.00
2024-12-10 17:22:12,152,5913,81,71,4012.35,7483.01,0.00
2024-12-10 17:22:12,151,5913,81,70,4029.57,7483.13,0.00
2024-12-10 17:22:12,151,5914,81,70,4109.42,7484.00,0.00
2024-12-10 17:22:12,152,5914,81,71,4082.38,7484.01,0.00
2024-12-10 17:22:12,153,5913,81,72,4050.36,7484.09,0.00
2024-12-10 17:22:12,152,5913,80,72,4078.50,7484.13,0.00
2024-12-10 17:22:12,152,5914,80,72,4058.98,7485.00,0.00
2024-12-10 17:22:12,153,5914,80,73,4032.45,7485.01,0.00
2024-12-10 17:22:12,152,5914,80,72,4049.68,7485.13,0.00
2024-12-10 17:22:12,153,5913,81,72,3969.45,7485.80,0.00
2024-12-10 17:22:12,153,5914,81,72,4068.71,7486.00,0.00
2024-12-10 17:22:12,154,5914,82,72,4042.29,7486.01,0.00
2024-12-10 17:22:12,153,5914,82,71,4059.47,7486.12,0.00
2024-12-10 17:22:12,152,5914,81,71,4085.68,7486.13,0.00
2024-12-10 17:22:12,152,5915,81,71,4096.59,7487.00,0.00
2024-12-10 17:22:12,153,5915,82,71,4069.81,7487.01,0.00
2024-12-10 17:22:12,154,5914,83,71,4042.42,7487.03,0.00
2024-12-10 17:22:12,155,5913,83,72,4044.40,7487.12,0.00
2024-12-10 17:22:12,154,5913,83,71,4092.07,7487.14,0.00
2024-12-10 17:22:12,153,5913,82,71,4086.71,7487.55,0.00
2024-12-10 17:22:12,153,5914,82,71,4081.17,7488.00,0.00
2024-12-10 17:22:12,154,5914,82,72,4054.67,7488.01,0.00
2024-12-10 17:22:12,153,5914,82,71,4071.39,7488.12,0.00
2024-12-10 17:22:12,152,5914,81,71,4036.21,7488.80,0.00
2024-12-10 17:22:12,152,5915,81,71,4168.90,7489.00,0.00
2024-12-10 17:22:12,153,5915,82,71,4141.65,7489.01,0.00
2024-12-10 17:22:12,152,5915,81,71,4166.46,7489.03,0.00
2024-12-10 17:22:12,153,5914,82,71,4135.76,7489.08,0.00
2024-12-10 17:22:12,152,5914,81,71,4185.17,7489.13,0.00
2024-12-10 17:22:12,151,5914,81,70,4212.40,7489.13,0.00
2024-12-10 17:22:12,150,5914,81,69,4196.57,7489.68,0.00
2024-12-10 17:22:12,150,5915,81,69,4219.03,7490.00,0.00
2024-12-10 17:22:12,151,5915,81,70,4191.09,7490.01,0.00
2024-12-10 17:22:12,150,5915,81,69,4209.37,7490.11,0.00
2024-12-10 17:22:12,149,5915,81,68,4237.11,7490.11,0.00
2024-12-10 17:22:12,150,5914,82,68,4189.46,7490.39,0.00
2024-12-10 17:22:12,151,5913,83,68,4174.57,7490.58,0.00
2024-12-10 17:22:12,151,5914,83,68,4257.22,7491.00,0.00
2024-12-10 17:22:12,152,5914,83,69,4229.21,7491.01,0.00
2024-12-10 17:22:12,151,5914,83,68,4247.10,7491.11,0.00
2024-12-10 17:22:13,152,5913,83,69,4180.37,7491.62,0.00
2024-12-10 17:22:13,153,5912,84,69,4162.94,7491.76,0.00
2024-12-10 17:22:13,154,5911,85,69,4137.07,7491.88,0.00
2024-12-10 17:22:13,154,5912,85,69,4273.56,7492.00,0.00
2024-12-10 17:22:13,155,5912,85,70,4245.99,7492.01,0.00
2024-12-10 17:22:13,155,5913,85,70,4339.98,7493.00,0.00
2024-12-10 17:22:13,156,5913,86,70,4312.16,7493.01,0.00
2024-12-10 17:22:13,155,5913,86,69,4330.20,7493.11,0.00
2024-12-10 17:22:13,154,5913,85,69,4357.83,7493.11,0.00
2024-12-10 17:22:13,155,5912,85,70,4309.97,7493.39,0.00
2024-12-10 17:22:13,155,5913,85,70,4313.29,7494.00,0.00
2024-12-10 17:22:13,156,5913,86,70,4285.64,7494.01,0.00
2024-12-10 17:22:13,157,5912,86,71,4234.96,7494.32,0.00
2024-12-10 17:22:13,158,5911,86,72,4226.77,7494.56,0.00
2024-12-10 17:22:13,158,5912,86,72,4263.19,7495.00,0.00
2024-12-10 17:22:13,159,5912,87,72,4236.38,7495.01,0.00
2024-12-10 17:22:13,160,5911,87,73,4205.27,7495.07,0.00
2024-12-10 17:22:13,159,5911,87,72,4241.18,7495.12,0.00
2024-12-10 17:22:13,158,5911,87,71,4216.71,7495.70,0.00
2024-12-10 17:22:13,158,5912,87,71,4311.65,7496.00,0.00
2024-12-10 17:22:13,159,5912,88,71,4284.54,7496.01,0.00
2024-12-10 17:22:13,158,5912,88,70,4302.00,7496.11,0.00
2024-12-10 17:22:13,159,5911,88,71,4255.69,7496.38,0.00
2024-12-10 17:22:13,160,5910,89,71,4213.69,7496.78,0.00
2024-12-10 17:22:13,159,5910,88,71,4231.90,7496.94,0.00
2024-12-10 17:22:13,159,5911,88,71,4315.07,7497.00,0.00
2024-12-10 17:22:13,160,5911,88,72,4288.11,7497.01,0.00
2024-12-10 17:22:13,159,5911,88,71,4312.13,7497.04,0.00
2024-12-10 17:22:13,159,5912,88,71,4365.69,7498.00,0.00
2024-12-10 17:22:13,160,5912,89,71,4338.40,7498.01,0.00
2024-12-10 17:22:13,159,5912,88,71,4357.26,7498.11,0.00
2024-12-10 17:22:13,160,5911,89,71,4269.28,7498.86,0.00
2024-12-10 17:22:13,160,5912,89,71,4294.65,7499.00,0.00
2024-12-10 17:22:13,161,5912,90,71,4267.97,7499.01,0.00
2024-12-10 17:22:13,161,5913,90,71,4257.42,7500.00,0.00
2024-12-10 17:22:13,162,5913,91,71,4231.14,7500.01,0.00
2024-12-10 17:22:13,161,5913,91,70,4248.63,7500.12,0.00
2024-12-10 17:22:13,161,5914,91,70,4189.57,7501.00,0.00
2024-12-10 17:22:13,162,5914,92,70,4163.70,7501.01,0.00
2024-12-10 17:22:13,161,5914,92,69,4152.24,7501.42,0.00
2024-12-10 17:22:13,161,5915,92,69,4104.63,7502.00,0.00
2024-12-10 17:22:13,162,5915,93,69,4079.29,7502.01,0.00
2024-12-10 17:22:13,161,5915,92,69,4095.84,7502.12,0.00
2024-12-10 17:22:13,160,5915,92,68,4077.92,7502.45,0.00
2024-12-10 17:22:13,159,5915,91,68,4079.67,7502.57,0.00
2024-12-10 17:22:13,158,5915,91,67,4071.13,7502.80,0.00
2024-12-10 17:22:13,158,5916,91,67,4077.74,7503.00,0.00
2024-12-10 17:22:13,159,5916,92,67,4052.09,7503.01,0.00
2024-12-10 17:22:13,158,5916,91,67,4068.77,7503.12,0.00
2024-12-10 17:22:13,159,5915,92,67,3982.72,7503.84,0.00
2024-12-10 17:22:13,159,5916,92,67,4022.62,7504.00,0.00
2024-12-10 17:22:13,160,5916,92,68,3997.48,7504.01,0.00
2024-12-10 17:22:13,161,5915,92,69,3967.56,7504.09,0.00
2024-12-10 17:22:13,160,5915,92,68,4011.15,7504.13,0.00
2024-12-10 17:22:13,161,5914,93,68,3944.98,7504.69,0.00
2024-12-10 17:22:13,161,5915,93,68,3989.35,7505.00,0.00
2024-12-10 17:22:13,162,5915,94,68,3964.72,7505.01,0.00
2024-12-10 17:22:13,163,5914,94,69,3932.17,7505.13,0.00
2024-12-10 17:22:13,162,5914,93,69,3967.11,7505.13,0.00
2024-12-10 17:22:13,163,5913,94,69,3842.17,7505.98,0.00
2024-12-10 17:22:13,163,5914,94,69,3980.14,7506.00,0.00
2024-12-10 17:22:13,164,5914,95,69,3955.87,7506.01,0.00
2024-12-10 17:22:13,163,5914,94,69,3970.99,7506.12,0.00
2024-12-10 17:22:13,162,5914,94,68,3925.14,7506.81,0.00
2024-12-10 17:22:13,161,5914,93,68,3940.56,7506.85,0.00
2024-12-10 17:22:13,160,5914,92,68,3961.69,7506.86,0.00
2024-12-10 17:22:13,160,5915,92,68,4077.06,7507.00,0.00
2024-12-10 17:22:13,161,5915,92,69,4051.74,7507.01,0.00
2024-12-10 17:22:13,160,5915,91,69,4067.74,7507.13,0.00
2024-12-10 17:22:13,160,5916,91,69,4014.60,7508.00,0.00
2024-12-10 17:22:13,161,5916,92,69,3989.66,7508.01,0.00
2024-12-10 17:22:13,160,5916,91,69,4004.81,7508.13,0.00
2024-12-10 17:22:13,159,5916,90,69,4029.52,7508.13,0.00
2024-12-10 17:22:13,158,5916,89,69,3951.48,7508.88,0.00
2024-12-10 17:22:13,158,5917,89,69,3985.60,7509.00,0.00
2024-12-10 17:22:13,159,5917,90,69,3960.54,7509.01,0.00
2024-12-10 17:22:13,158,5917,90,68,3982.29,7509.04,0.00
2024-12-10 17:22:13,157,5917,89,68,4001.01,7509.13,0.00
2024-12-10 17:22:13,156,5917,88,68,4026.18,7509.13,0.00
2024-12-10 17:22:13,155,5917,88,67,4051.67,7509.13,0.00
2024-12-10 17:22:13,154,5917,88,66,4028.25,7509.70,0.00
2024-12-10 17:22:13,153,5917,87,66,4032.24,7509.79,0.00
2024-12-10 17:22:13,153,5918,87,66,4041.02,7510.00,0.00
2024-12-10 17:22:13,154,5918,87,67,4014.78,7510.01,0.00
2024-12-10 17:22:13,153,5918,86,67,4031.26,7510.13,0.00
2024-12-10 17:22:13,154,5917,86,68,4001.19,7510.20,0.00
2024-12-10 17:22:13,153,5917,86,67,4006.43,7510.82,0.00
2024-12-10 17:22:13,153,5918,86,67,4038.12,7511.00,0.00
2024-12-10 17:22:13,154,5918,87,67,4011.90,7511.01,0.00
2024-12-10 17:22:13,153,5918,87,66,4028.37,7511.13,0.00
2024-12-10 17:22:13,152,5918,87,65,4054.38,7511.13,0.00
2024-12-10 17:22:13,151,5918,87,64,4029.78,7511.73,0.00
2024-12-10 17:22:13,151,5919,87,64,4092.75,7512.00,0.00
2024-12-10 17:22:13,152,5919,87,65,4065.82,7512.01,0.00
2024-12-10 17:22:13,151,5919,86,65,4082.86,7512.13,0.00
2024-12-10 17:22:13,150,5919,85,65,4056.11,7512.73,0.00
2024-12-10 17:22:13,150,5920,85,65,4078.59,7513.00,0.00
2024-12-10 17:22:13,151,5920,86,65,4051.58,7513.01,0.00
2024-12-10 17:22:13,150,5920,85,65,4068.64,7513.13,0.00
2024-12-10 17:22:13,149,5920,84,65,4053.46,7513.68,0.00
2024-12-10 17:22:13,149,5921,84,65,4069.97,7514.00,0.00
2024-12-10 17:22:13,150,5921,85,65,4042.84,7514.01,0.00
2024-12-10 17:22:13,149,5921,85,64,4059.95,7514.13,0.00
2024-12-10 17:22:13,150,5920,86,64,4022.90,7514.28,0.00
2024-12-10 17:22:13,149,5920,86,63,4053.96,7514.75,0.00
2024-12-10 17:22:13,149,5921,86,63,4077.91,7515.00,0.00
2024-12-10 17:22:14,150,5921,87,63,4050.73,7515.01,0.00
2024-12-10 17:22:14,149,5921,86,63,4067.89,7515.13,0.00
2024-12-10 17:22:14,149,5922,86,63,4092.85,7516.00,0.00
2024-12-10 17:22:14,150,5922,87,63,4065.57,7516.01,0.00
2024-12-10 17:22:14,149,5922,87,62,4082.82,7516.13,0.00
2024-12-10 17:22:14,150,5921,87,63,4049.12,7516.23,0.00
2024-12-10 17:22:14,149,5921,87,62,4073.29,7516.30,0.00
2024-12-10 17:22:14,150,5920,87,63,4044.64,7516.33,0.00
2024-12-10 17:22:14,150,5921,87,63,4067.22,7517.00,0.00
2024-12-10 17:22:14,151,5921,88,63,4040.28,7517.01,0.00
2024-12-10 17:22:14,152,5920,89,63,4010.26,7517.07,0.00
2024-12-10 17:22:14,151,5920,88,63,4044.50,7517.14,0.00
2024-12-10 17:22:14,152,5919,88,64,4000.17,7517.39,0.00
2024-12-10 17:22:14,153,5918,89,64,3960.55,7517.72,0.00
2024-12-10 17:22:14,152,5918,89,63,3996.16,7517.74,0.00
2024-12-10 17:22:14,152,5919,89,63,4112.98,7518.00,0.00
2024-12-10 17:22:14,153,5919,90,63,4086.09,7518.01,0.00
2024-12-10 17:22:14,152,5919,90,62,4102.65,7518.14,0.00
2024-12-10 17:22:14,152,5920,90,62,4224.02,7519.00,0.00
2024-12-10 17:22:14,153,5920,90,63,4196.41,7519.01,0.00
2024-12-10 17:22:14,152,5920,89,63,4213.20,7519.15,0.00
2024-12-10 17:22:14,152,5921,89,63,4186.27,7520.00,0.00
2024-12-10 17:22:14,153,5921,90,63,4158.90,7520.01,0.00
2024-12-10 17:22:14,152,5921,90,62,4175.45,7520.15,0.00
2024-12-10 17:22:14,151,5921,89,62,4137.11,7520.86,0.00
2024-12-10 17:22:14,151,5922,89,62,4176.58,7521.00,0.00
2024-12-10 17:22:14,152,5922,90,62,4149.10,7521.01,0.00
2024-12-10 17:22:14,151,5922,90,61,4170.15,7521.09,0.00
2024-12-10 17:22:14,150,5922,89,61,4192.96,7521.15,0.00
2024-12-10 17:22:14,151,5921,89,62,4152.79,7521.33,0.00
2024-12-10 17:22:14,151,5922,89,62,4162.50,7522.00,0.00
2024-12-10 17:22:14,152,5922,89,63,4135.12,7522.01,0.00
2024-12-10 17:22:14,151,5922,88,63,4153.59,7522.12,0.00
2024-12-10 17:22:14,152,5921,88,64,4098.69,7522.50,0.00
2024-12-10 17:22:14,153,5920,88,65,4090.65,7522.61,0.00
2024-12-10 17:22:14,152,5920,87,65,4123.40,7522.75,0.00
2024-12-10 17:22:14,152,5921,87,65,4203.78,7523.00,0.00
2024-12-10 17:22:14,153,5921,88,65,4176.31,7523.01,0.00
2024-12-10 17:22:14,152,5921,87,65,4187.20,7523.03,0.00
2024-12-10 17:22:14,151,5921,87,64,4206.52,7523.14,0.00
2024-12-10 17:22:14,151,5922,87,64,4287.55,7524.00,0.00
2024-12-10 17:22:14,152,5922,88,64,4259.34,7524.01,0.00
2024-12-10 17:22:14,151,5922,87,64,4276.35,7524.01,0.00
2024-12-10 17:22:14,150,5922,86,64,4299.38,7524.07,0.00
2024-12-10 17:22:14,149,5922,86,63,4323.72,7524.13,0.00
2024-12-10 17:22:14,149,5923,86,63,4304.64,7525.00,0.00
2024-12-10 17:22:14,150,5923,86,64,4275.95,7525.01,0.00
2024-12-10 17:22:14,149,5923,85,64,4304.14,7525.01,0.00
2024-12-10 17:22:14,148,5923,84,64,4323.63,7525.13,0.00
2024-12-10 17:22:14,147,5923,83,64,4315.48,7525.61,0.00
2024-12-10 17:22:14,147,5924,83,64,4337.80,7526.00,0.00
2024-12-10 17:22:14,148,5924,83,65,4308.49,7526.01,0.00
2024-12-10 17:22:14,149,5923,83,66,4276.07,7526.07,0.00
2024-12-10 17:22:14,148,5923,82,66,4309.59,7526.14,0.00
2024-12-10 17:22:14,149,5922,82,67,4263.56,7526.38,0.00
2024-12-10 17:22:14,149,5923,82,67,4302.45,7527.00,0.00
2024-12-10 17:22:14,150,5923,82,68,4273.76,7527.01,0.00
2024-12-10 17:22:14,151,5922,82,69,4243.97,7527.04,0.00
2024-12-10 17:22:14,150,5922,81,69,4279.86,7527.14,0.00
2024-12-10 17:22:14,150,5923,81,69,4366.17,7528.00,0.00
2024-12-10 17:22:14,151,5923,81,70,4337.26,7528.01,0.00
2024-12-10 17:22:14,152,5922,82,70,4252.63,7528.77,0.00
2024-12-10 17:22:14,152,5923,82,70,4345.45,7529.00,0.00
2024-12-10 17:22:14,153,5923,82,71,4317.05,7529.01,0.00
2024-12-10 17:22:14,154,5922,83,71,4277.86,7529.17,0.00
2024-12-10 17:22:14,154,5923,83,71,4360.98,7530.00,0.00
2024-12-10 17:22:14,155,5923,83,72,4332.84,7530.01,0.00
2024-12-10 17:22:14,154,5923,83,71,4349.81,7530.15,0.00
2024-12-10 17:22:14,153,5923,82,71,4343.67,7530.61,0.00
2024-12-10 17:22:14,153,5924,82,71,4412.88,7531.00,0.00
2024-12-10 17:22:14,154,5924,83,71,4384.23,7531.01,0.00
2024-12-10 17:22:14,154,5925,83,71,4358.89,7532.00,0.00
2024-12-10 17:22:14,155,5925,83,72,4330.77,7532.01,0.00
2024-12-10 17:22:14,154,5925,82,72,4353.54,7532.07,0.00
2024-12-10 17:22:14,155,5924,82,73,4322.56,7532.12,0.00
2024-12-10 17:22:14,154,5924,81,73,4375.60,7532.16,0.00
2024-12-10 17:22:14,153,5924,80,73,4403.71,7532.16,0.00
2024-12-10 17:22:14,152,5924,79,73,4432.19,7532.16,0.00
2024-12-10 17:22:14,151,5924,79,72,4410.79,7532.51,0.00
2024-12-10 17:22:14,152,5923,79,73,4368.50,7532.70,0.00
2024-12-10 17:22:14,152,5924,79,73,4425.03,7533.00,0.00
2024-12-10 17:22:14,153,5924,79,74,4396.11,7533.01,0.00
2024-12-10 17:22:14,153,5925,79,74,4469.57,7534.00,0.00
2024-12-10 17:22:14,154,5925,80,74,4440.54,7534.01,0.00
2024-12-10 17:22:14,153,5925,80,73,4458.33,7534.15,0.00
2024-12-10 17:22:14,153,5926,80,73,4444.06,7535.00,0.00
2024-12-10 17:22:14,154,5926,80,74,4415.20,7535.01,0.00
2024-12-10 17:22:14,153,5926,79,74,4432.32,7535.16,0.00
2024-12-10 17:22:14,154,5925,80,74,4400.62,7535.21,0.00
2024-12-10 17:22:14,154,5926,80,74,4396.70,7536.00,0.00
2024-12-10 17:22:14,155,5926,81,74,4368.34,7536.01,0.00
2024-12-10 17:22:14,156,5925,81,75,4337.94,7536.05,0.00
2024-12-10 17:22:14,156,5926,81,75,4388.26,7537.00,0.00
2024-12-10 17:22:14,157,5926,82,75,4360.31,7537.01,0.00
2024-12-10 17:22:14,157,5927,82,75,4382.01,7538.00,0.00
2024-12-10 17:22:14,158,5927,83,75,4354.28,7538.01,0.00
2024-12-10 17:22:14,158,5928,83,75,4327.58,7539.00,0.00
2024-12-10 17:22:14,159,5928,84,75,4300.37,7539.01,0.00
2024-12-10 17:22:14,158,5928,83,75,4315.74,7539.16,0.00
2024-12-10 17:22:14,158,5929,83,75,4300.00,7540.00,0.00
2024-12-10 17:22:14,159,5929,83,76,4272.95,7540.01,0.00
2024-12-10 17:22:14,158,5929,82,76,4288.15,7540.16,0.00
2024-12-10 17:22:15,157,5929,82,75,4314.98,7540.16,0.00
2024-12-10 17:22:15,156,5929,82,74,4342.16,7540.16,0.00
2024-12-10 17:22:15,156,5930,82,74,4326.97,7541.00,0.00
2024-12-10 17:22:15,157,5930,82,75,4299.41,7541.01,0.00
2024-12-10 17:22:15,157,5931,82,75,4272.18,7542.00,0.00
2024-12-10 17:22:15,158,5931,82,76,4245.14,7542.01,0.00
2024-12-10 17:22:15,158,5932,82,76,4217.67,7543.00,0.00
2024-12-10 17:22:15,159,5932,83,76,4191.15,7543.01,0.00
2024-12-10 17:22:15,160,5931,83,77,4164.95,7543.02,0.00
2024-12-10 17:22:15,159,5931,82,77,4176.81,7543.55,0.00
2024-12-10 17:22:15,159,5932,82,77,4190.44,7544.00,0.00
2024-12-10 17:22:15,160,5932,83,77,4164.25,7544.01,0.00
2024-12-10 17:22:15,159,5932,83,76,4177.71,7544.17,0.00
2024-12-10 17:22:15,160,5931,84,76,4145.96,7544.26,0.00
2024-12-10 17:22:15,161,5930,85,76,4143.35,7544.51,0.00
2024-12-10 17:22:15,161,5931,85,76,4225.25,7545.00,0.00
2024-12-10 17:22:15,162,5931,85,77,4199.17,7545.01,0.00
2024-12-10 17:22:15,161,5931,84,77,4223.86,7545.02,0.00
2024-12-10 17:22:15,160,5931,83,77,4239.02,7545.16,0.00
2024-12-10 17:22:15,159,5931,83,76,4265.20,7545.16,0.00
2024-12-10 17:22:15,160,5930,84,76,4199.78,7545.69,0.00
2024-12-10 17:22:15,160,5931,84,76,4332.09,7546.00,0.00
2024-12-10 17:22:15,161,5931,84,77,4305.18,7546.01,0.00
2024-12-10 17:22:15,160,5931,84,76,4323.19,7546.12,0.00
2024-12-10 17:22:15,159,5931,83,76,4346.61,7546.16,0.00
2024-12-10 17:22:15,158,5931,83,75,4373.64,7546.17,0.00
2024-12-10 17:22:15,159,5930,83,76,4329.58,7546.40,0.00
2024-12-10 17:22:15,159,5931,83,76,4402.17,7547.00,0.00
2024-12-10 17:22:15,160,5931,83,77,4374.66,7547.01,0.00
2024-12-10 17:22:15,161,5930,83,78,4340.97,7547.11,0.00
2024-12-10 17:22:15,162,5929,83,79,4327.75,7547.28,0.00
2024-12-10 17:22:15,162,5930,83,79,4404.38,7548.00,0.00
2024-12-10 17:22:15,163,5930,84,79,4377.35,7548.01,0.00
2024-12-10 17:22:15,162,5930,83,79,4401.60,7548.04,0.00
2024-12-10 17:22:15,161,5930,82,79,4419.63,7548.16,0.00
2024-12-10 17:22:15,162,5929,82,80,4383.99,7548.28,0.00
2024-12-10 17:22:15,163,5928,83,80,4360.21,7548.73,0.00
2024-12-10 17:22:15,163,5929,83,80,4491.03,7549.00,0.00
2024-12-10 17:22:15,164,5929,84,80,4463.65,7549.01,0.00
2024-12-10 17:22:15,163,5929,84,79,4470.28,7549.15,0.00
2024-12-10 17:22:15,164,5928,85,79,4430.64,7549.33,0.00
2024-12-10 17:22:15,165,5927,86,79,4431.25,7549.40,0.00
2024-12-10 17:22:15,165,5928,86,79,4553.50,7550.00,0.00
2024-12-10 17:22:15,166,5928,86,80,4526.07,7550.01,0.00
2024-12-10 17:22:15,166,5929,86,80,4584.00,7551.00,0.00
2024-12-10 17:22:15,167,5929,86,81,4556.55,7551.01,0.00
2024-12-10 17:22:15,166,5929,85,81,4572.26,7551.16,0.00
2024-12-10 17:22:15,166,5930,85,81,4548.40,7552.00,0.00
2024-12-10 17:22:15,167,5930,85,82,4521.17,7552.01,0.00
2024-12-10 17:22:15,166,5930,85,81,4536.66,7552.16,0.00
2024-12-10 17:22:15,167,5929,86,81,4506.36,7552.20,0.00
2024-12-10 17:22:15,166,5929,85,81,4563.28,7552.36,0.00
2024-12-10 17:22:15,167,5928,85,82,4532.81,7552.41,0.00
2024-12-10 17:22:15,167,5929,85,82,4558.17,7553.00,0.00
2024-12-10 17:22:15,168,5929,86,82,4531.03,7553.01,0.00
2024-12-10 17:22:15,167,5929,85,82,4546.49,7553.16,0.00
2024-12-10 17:22:15,168,5928,86,82,4495.52,7553.43,0.00
2024-12-10 17:22:15,168,5929,86,82,4613.42,7554.00,0.00
2024-12-10 17:22:15,169,5929,87,82,4586.12,7554.01,0.00
2024-12-10 17:22:15,168,5929,86,82,4609.84,7554.05,0.00
2024-12-10 17:22:15,167,5929,85,82,4629.36,7554.15,0.00
2024-12-10 17:22:15,166,5929,85,81,4633.67,7554.40,0.00
2024-12-10 17:22:15,166,5930,85,81,4679.48,7555.00,0.00
2024-12-10 17:22:15,167,5930,86,81,4651.46,7555.01,0.00
2024-12-10 17:22:15,168,5929,86,82,4602.26,7555.27,0.00
2024-12-10 17:22:15,168,5930,86,82,4629.17,7556.00,0.00
2024-12-10 17:22:15,169,5930,87,82,4601.78,7556.01,0.00
2024-12-10 17:22:15,170,5929,87,83,4565.00,7556.15,0.00
2024-12-10 17:22:15,169,5929,86,83,4607.68,7556.16,0.00
2024-12-10 17:22:15,169,5930,86,83,4631.20,7557.00,0.00
2024-12-10 17:22:15,170,5930,87,83,4603.96,7557.01,0.00
2024-12-10 17:22:15,171,5929,87,84,4508.74,7557.90,0.00
2024-12-10 17:22:15,171,5930,87,84,4593.25,7558.00,0.00
2024-12-10 17:22:15,172,5930,88,84,4566.55,7558.01,0.00
2024-12-10 17:22:15,172,5931,88,84,4577.58,7559.00,0.00
2024-12-10 17:22:15,173,5931,88,85,4551.13,7559.01,0.00
2024-12-10 17:22:15,172,5931,87,85,4564.54,7559.16,0.00
2024-12-10 17:22:15,173,5930,88,85,4534.24,7559.22,0.00
2024-12-10 17:22:15,174,5929,88,86,4542.10,7559.31,0.00
2024-12-10 17:22:15,174,5930,88,86,4537.84,7560.00,0.00
2024-12-10 17:22:15,175,5930,89,86,4511.91,7560.01,0.00
2024-12-10 17:22:15,174,5930,88,86,4519.77,7560.23,0.00
2024-12-10 17:22:15,174,5931,88,86,4590.79,7561.00,0.00
2024-12-10 17:22:15,175,5931,88,87,4564.56,7561.01,0.00
2024-12-10 17:22:15,175,5932,88,87,4530.26,7562.00,0.00
2024-12-10 17:22:15,176,5932,88,88,4504.52,7562.01,0.00
2024-12-10 17:22:15,175,5932,88,87,4517.55,7562.16,0.00
2024-12-10 17:22:15,176,5931,88,88,4470.94,7562.45,0.00
2024-12-10 17:22:15,176,5932,88,88,4494.53,7563.00,0.00
2024-12-10 17:22:15,177,5932,88,89,4469.14,7563.01,0.00
2024-12-10 17:22:15,178,5931,88,90,4439.81,7563.07,0.00
2024-12-10 17:22:15,177,5931,88,89,4485.97,7563.16,0.00
2024-12-10 17:22:15,177,5932,88,89,4505.59,7564.00,0.00
2024-12-10 17:22:15,178,5932,88,90,4480.28,7564.01,0.00
2024-12-10 17:22:15,177,5932,88,89,4492.01,7564.16,0.00
2024-12-10 17:22:16,176,5932,87,89,4517.10,7564.16,0.00
2024-12-10 17:22:16,177,5931,87,90,4457.60,7564.62,0.00
2024-12-10 17:22:16,177,5932,87,90,4526.83,7565.00,0.00
2024-12-10 17:22:16,178,5932,88,90,4501.40,7565.01,0.00
2024-12-10 17:22:16,177,5932,88,89,4513.10,7565.16,0.00
2024-12-10 17:22:16,177,5933,88,89,4530.97,7566.00,0.00
2024-12-10 17:22:16,178,5933,89,89,4505.52,7566.01,0.00
2024-12-10 17:22:16,178,5934,89,89,4466.30,7567.00,0.00
2024-12-10 17:22:16,179,5934,89,90,4441.35,7567.01,0.00
2024-12-10 17:22:16,178,5934,88,90,4457.55,7567.11,0.00
2024-12-10 17:22:16,179,5933,88,91,4415.94,7567.34,0.00
2024-12-10 17:22:16,178,5933,88,90,4420.61,7567.67,0.00
2024-12-10 17:22:16,178,5934,88,90,4438.41,7568.00,0.00
2024-12-10 17:22:16,179,5934,88,91,4413.61,7568.01,0.00
2024-12-10 17:22:16,180,5933,89,91,4381.57,7568.12,0.00
2024-12-10 17:22:16,180,5934,89,91,4420.28,7569.00,0.00
2024-12-10 17:22:16,181,5934,89,92,4395.86,7569.01,0.00
2024-12-10 17:22:16,180,5934,89,91,4406.91,7569.18,0.00
2024-12-10 17:22:16,179,5934,88,91,4431.11,7569.18,0.00
2024-12-10 17:22:16,179,5935,88,91,4454.02,7570.00,0.00
2024-12-10 17:22:16,180,5935,89,91,4429.28,7570.01,0.00
2024-12-10 17:22:16,180,5936,89,91,4396.63,7571.00,0.00
2024-12-10 17:22:16,181,5936,90,91,4372.34,7571.01,0.00
2024-12-10 17:22:16,182,5935,90,92,4340.87,7571.12,0.00
2024-12-10 17:22:16,183,5934,90,93,4276.45,7571.68,0.00
2024-12-10 17:22:16,183,5935,90,93,4307.75,7572.00,0.00
2024-12-10 17:22:16,184,5935,90,94,4284.34,7572.01,0.00
2024-12-10 17:22:16,184,5936,90,94,4333.06,7573.00,0.00
2024-12-10 17:22:16,185,5936,91,94,4309.64,7573.01,0.00
2024-12-10 17:22:16,184,5936,91,93,4319.56,7573.18,0.00
2024-12-10 17:22:16,183,5936,91,92,4342.75,7573.18,0.00
2024-12-10 17:22:16,183,5937,91,92,4322.54,7574.00,0.00
2024-12-10 17:22:16,184,5937,91,93,4299.05,7574.01,0.00
2024-12-10 17:22:16,183,5937,90,93,4308.97,7574.18,0.00
2024-12-10 17:22:16,183,5938,90,93,4288.76,7575.00,0.00
2024-12-10 17:22:16,184,5938,91,93,4265.45,7575.01,0.00
2024-12-10 17:22:16,183,5938,90,93,4274.36,7575.19,0.00
2024-12-10 17:22:16,183,5939,90,93,4254.97,7576.00,0.00
2024-12-10 17:22:16,184,5939,91,93,4231.84,7576.01,0.00
2024-12-10 17:22:16,183,5939,91,92,4250.02,7576.07,0.00
2024-12-10 17:22:16,184,5938,91,93,4219.97,7576.17,0.00
2024-12-10 17:22:16,183,5938,91,92,4247.60,7576.19,0.00
2024-12-10 17:22:16,182,5938,90,92,4270.52,7576.19,0.00
2024-12-10 17:22:16,183,5937,90,93,4220.41,7576.56,0.00
2024-12-10 17:22:16,183,5938,90,93,4248.90,7577.00,0.00
2024-12-10 17:22:16,184,5938,90,94,4225.81,7577.01,0.00
2024-12-10 17:22:16,183,5938,89,94,4234.91,7577.19,0.00
2024-12-10 17:22:16,183,5939,89,94,4297.91,7578.00,0.00
2024-12-10 17:22:16,184,5939,89,95,4274.55,7578.01,0.00
2024-12-10 17:22:16,183,5939,89,94,4294.61,7578.04,0.00
2024-12-10 17:22:16,182,5939,89,93,4307.04,7578.19,0.00
2024-12-10 17:22:16,182,5940,89,93,4287.53,7579.00,0.00
2024-12-10 17:22:16,183,5940,89,94,4264.10,7579.01,0.00
2024-12-10 17:22:16,183,5941,89,94,4230.70,7580.00,0.00
2024-12-10 17:22:16,184,5941,89,95,4207.71,7580.01,0.00
2024-12-10 17:22:16,185,5940,90,95,4184.15,7580.03,0.00
2024-12-10 17:22:16,185,5941,90,95,4173.22,7581.00,0.00
2024-12-10 17:22:16,186,5941,91,95,4150.79,7581.01,0.00
2024-12-10 17:22:16,187,5940,92,95,4125.77,7581.05,0.00
2024-12-10 17:22:16,188,5939,93,95,4106.27,7581.43,0.00
2024-12-10 17:22:16,188,5940,93,95,4169.98,7582.00,0.00
2024-12-10 17:22:16,189,5940,94,95,4147.92,7582.01,0.00
2024-12-10 17:22:16,188,5940,93,95,4169.17,7582.01,0.00
2024-12-10 17:22:16,187,5940,92,95,4185.02,7582.09,0.00
2024-12-10 17:22:16,186,5940,92,94,4205.89,7582.11,0.00
2024-12-10 17:22:16,185,5940,92,93,4223.38,7582.17,0.00
2024-12-10 17:22:16,185,5941,92,93,4284.10,7583.00,0.00
2024-12-10 17:22:16,186,5941,93,93,4261.07,7583.01,0.00
2024-12-10 17:22:16,187,5940,94,93,4231.39,7583.11,0.00
2024-12-10 17:22:16,186,5940,94,92,4258.61,7583.18,0.00
2024-12-10 17:22:16,187,5939,94,93,4186.28,7583.85,0.00
2024-12-10 17:22:16,187,5940,94,93,4222.92,7584.00,0.00
2024-12-10 17:22:16,188,5940,94,94,4200.46,7584.01,0.00
2024-12-10 17:22:16,188,5941,94,94,4246.15,7585.00,0.00
2024-12-10 17:22:16,189,5941,95,94,4223.68,7585.01,0.00
2024-12-10 17:22:16,188,5941,94,94,4236.05,7585.12,0.00
2024-12-10 17:22:16,187,5941,94,93,4254.68,7585.17,0.00
2024-12-10 17:22:16,187,5942,94,93,4232.84,7586.00,0.00
2024-12-10 17:22:16,188,5942,95,93,4210.32,7586.01,0.00
2024-12-10 17:22:16,188,5943,95,93,4174.56,7587.00,0.00
2024-12-10 17:22:16,189,5943,96,93,4152.47,7587.01,0.00
2024-12-10 17:22:16,188,5943,95,93,4172.15,7587.03,0.00
2024-12-10 17:22:16,189,5942,95,94,4145.50,7587.08,0.00
2024-12-10 17:22:16,188,5942,94,94,4183.34,7587.18,0.00
2024-12-10 17:22:16,189,5941,95,94,4160.41,7587.20,0.00
2024-12-10 17:22:16,189,5942,95,94,4156.85,7588.00,0.00
2024-12-10 17:22:16,190,5942,96,94,4134.97,7588.01,0.00
2024-12-10 17:22:17,190,5943,96,94,4178.30,7589.00,0.00
2024-12-10 17:22:17,191,5943,96,95,4156.43,7589.01,0.00
2024-12-10 17:22:17,192,5942,96,96,4133.60,7589.03,0.00
2024-12-10 17:22:17,191,5942,96,95,4172.31,7589.06,0.00
2024-12-10 17:22:17,190,5942,96,94,4182.47,7589.22,0.00
2024-12-10 17:22:17,190,5943,96,94,4163.34,7590.00,0.00
2024-12-10 17:22:17,191,5943,97,94,4141.54,7590.01,0.00
2024-12-10 17:22:17,190,5943,96,94,4149.85,7590.18,0.00
2024-12-10 17:22:17,191,5942,96,95,4093.33,7590.65,0.00
2024-12-10 17:22:17,191,5943,96,95,4162.36,7591.00,0.00
2024-12-10 17:22:17,192,5943,96,96,4140.68,7591.01,0.00
2024-12-10 17:22:17,193,5942,96,97,4116.49,7591.05,0.00
2024-12-10 17:22:17,192,5942,95,97,4145.08,7591.09,0.00
2024-12-10 17:22:17,191,5942,95,96,4156.49,7591.20,0.00
2024-12-10 17:22:17,191,5943,95,96,4175.63,7592.00,0.00
2024-12-10 17:22:17,192,5943,96,96,4153.88,7592.01,0.00
2024-12-10 17:22:17,192,5944,96,96,4157.98,7593.00,0.00
2024-12-10 17:22:17,193,5944,96,97,4136.44,7593.01,0.00
2024-12-10 17:22:17,192,5944,96,96,4145.02,7593.17,0.00
2024-12-10 17:22:17,192,5945,96,96,4121.71,7594.00,0.00
2024-12-10 17:22:17,193,5945,97,96,4100.35,7594.01,0.00
2024-12-10 17:22:17,194,5944,98,96,4057.13,7594.11,0.00
2024-12-10 17:22:17,193,5944,98,95,4090.39,7594.18,0.00
2024-12-10 17:22:17,192,5944,98,94,4111.21,7594.18,0.00
2024-12-10 17:22:17,192,5945,98,94,4089.12,7595.00,0.00
2024-12-10 17:22:17,193,5945,99,94,4067.93,7595.01,0.00
2024-12-10 17:22:17,192,5945,98,94,4074.75,7595.09,0.00
2024-12-10 17:22:17,193,5944,98,95,4048.16,7595.18,0.00
2024-12-10 17:22:17,193,5945,98,95,4075.37,7596.00,0.00
2024-12-10 17:22:17,194,5945,99,95,4054.37,7596.01,0.00
2024-12-10 17:22:17,193,5945,99,94,4071.07,7596.06,0.00
2024-12-10 17:22:17,193,5946,99,94,4075.15,7597.00,0.00
2024-12-10 17:22:17,194,5946,99,95,4054.15,7597.01,0.00
2024-12-10 17:22:17,194,5947,99,95,4009.18,7598.00,0.00
2024-12-10 17:22:17,195,5947,99,96,3988.62,7598.01,0.00
2024-12-10 17:22:17,196,5946,99,97,3964.42,7598.07,0.00
2024-12-10 17:22:17,195,5946,98,97,4010.91,7598.14,0.00
2024-12-10 17:22:17,194,5946,97,97,4029.64,7598.17,0.00
2024-12-10 17:22:17,193,5946,96,97,4050.12,7598.17,0.00
2024-12-10 17:22:17,192,5946,95,97,4037.72,7598.53,0.00
2024-12-10 17:22:17,192,5947,95,97,4042.01,7599.00,0.00
2024-12-10 17:22:17,193,5947,96,97,4021.07,7599.01,0.00
2024-12-10 17:22:17,192,5947,95,97,4029.83,7599.16,0.00
2024-12-10 17:22:17,193,5946,96,97,3966.65,7599.73,0.00
2024-12-10 17:22:17,193,5947,96,97,4038.14,7600.00,0.00
2024-12-10 17:22:17,194,5947,97,97,4017.33,7600.01,0.00
2024-12-10 17:22:17,195,5946,98,97,3993.24,7600.06,0.00
2024-12-10 17:22:17,194,5946,97,97,4031.91,7600.17,0.00
2024-12-10 17:22:17,194,5947,97,97,4047.24,7601.00,0.00
2024-12-10 17:22:17,195,5947,98,97,4026.48,7601.01,0.00
2024-12-10 17:22:17,194,5947,97,97,4035.18,7601.16,0.00
2024-12-10 17:22:17,194,5948,97,97,4050.12,7602.00,0.00
2024-12-10 17:22:17,195,5948,98,97,4029.35,7602.01,0.00
2024-12-10 17:22:17,194,5948,97,97,4038.06,7602.16,0.00
2024-12-10 17:22:17,195,5947,98,97,4002.19,7602.37,0.00
2024-12-10 17:22:17,196,5946,99,97,3975.65,7602.59,0.00
2024-12-10 17:22:17,196,5947,99,97,4002.34,7603.00,0.00
2024-12-10 17:22:17,197,5947,100,97,3982.02,7603.01,0.00
2024-12-10 17:22:17,198,5946,101,97,3953.91,7603.12,0.00
2024-12-10 17:22:17,197,5946,100,97,3990.99,7603.16,0.00
2024-12-10 17:22:17,198,5945,101,97,3953.22,7603.40,0.00
2024-12-10 17:22:17,199,5944,102,97,3945.67,7603.61,0.00
2024-12-10 17:22:17,199,5945,102,97,4048.33,7604.00,0.00
2024-12-10 17:22:17,200,5945,103,97,4028.09,7604.01,0.00
2024-12-10 17:22:17,199,5945,102,97,4039.61,7604.12,0.00
2024-12-10 17:22:17,198,5945,102,96,4056.57,7604.16,0.00
2024-12-10 17:22:17,197,5945,101,96,4076.40,7604.16,0.00
2024-12-10 17:22:17,197,5946,101,96,4167.23,7605.00,0.00
2024-12-10 17:22:17,198,5946,102,96,4146.18,7605.01,0.00
2024-12-10 17:22:17,199,5945,103,96,4117.38,7605.12,0.00
2024-12-10 17:22:17,198,5945,102,96,4134.75,7605.17,0.00
2024-12-10 17:22:17,199,5944,103,96,4074.80,7605.69,0.00
2024-12-10 17:22:17,199,5945,103,96,4103.55,7606.00,0.00
2024-12-10 17:22:17,200,5945,103,97,4083.03,7606.01,0.00
2024-12-10 17:22:17,199,5945,102,97,4091.02,7606.17,0.00
2024-12-10 17:22:17,200,5944,102,98,4059.94,7606.32,0.00
2024-12-10 17:22:17,200,5945,102,98,4152.79,7607.00,0.00
2024-12-10 17:22:17,201,5945,102,99,4132.13,7607.01,0.00
2024-12-10 17:22:17,200,5945,102,98,4140.33,7607.17,0.00
2024-12-10 17:22:17,200,5946,102,98,4153.34,7608.00,0.00
2024-12-10 17:22:17,201,5946,102,99,4132.67,7608.01,0.00
2024-12-10 17:22:17,200,5946,101,99,4140.87,7608.17,0.00
2024-12-10 17:22:17,200,5947,101,99,4115.84,7609.00,0.00
2024-12-10 17:22:17,201,5947,102,99,4095.36,7609.01,0.00
2024-12-10 17:22:17,200,5947,101,99,4103.36,7609.17,0.00
2024-12-10 17:22:17,200,5948,101,99,4078.33,7610.00,0.00
2024-12-10 17:22:17,201,5948,102,99,4058.04,7610.01,0.00
2024-12-10 17:22:17,200,5948,101,99,4075.68,7610.04,0.00
2024-12-10 17:22:17,199,5948,101,98,4086.28,7610.16,0.00
2024-12-10 17:22:17,198,5948,101,97,4106.54,7610.16,0.00
2024-12-10 17:22:18,198,5949,101,97,4081.13,7611.00,0.00
2024-12-10 17:22:18,199,5949,102,97,4060.63,7611.01,0.00
2024-12-10 17:22:18,198,5949,101,97,4068.91,7611.16,0.00
2024-12-10 17:22:18,197,5949,101,96,4064.86,7611.37,0.00
2024-12-10 17:22:18,198,5948,102,96,4025.61,7611.63,0.00
2024-12-10 17:22:18,199,5947,103,96,4007.69,7611.66,0.00
2024-12-10 17:22:18,199,5948,103,96,4035.89,7612.00,0.00
2024-12-10 17:22:18,200,5948,103,97,4015.71,7612.01,0.00
2024-12-10 17:22:18,199,5948,103,96,4023.72,7612.16,0.00
2024-12-10 17:22:18,200,5947,104,96,3982.36,7612.45,0.00
2024-12-10 17:22:18,201,5946,104,97,3961.95,7612.74,0.00
2024-12-10 17:22:18,201,5947,104,97,4067.08,7613.00,0.00
2024-12-10 17:22:18,202,5947,104,98,4046.95,7613.01,0.00
2024-12-10 17:22:18,203,5946,105,98,4020.68,7613.10,0.00
2024-12-10 17:22:18,202,5946,104,98,4048.91,7613.16,0.00
2024-12-10 17:22:18,202,5947,104,98,4084.06,7614.00,0.00
2024-12-10 17:22:18,203,5947,104,99,4063.94,7614.01,0.00
2024-12-10 17:22:18,202,5947,103,99,4072.07,7614.16,0.00
2024-12-10 17:22:18,201,5947,102,99,4039.13,7614.72,0.00
2024-12-10 17:22:18,201,5948,102,99,4093.53,7615.00,0.00
2024-12-10 17:22:18,202,5948,103,99,4073.27,7615.01,0.00
2024-12-10 17:22:18,203,5947,104,99,4042.39,7615.16,0.00
2024-12-10 17:22:18,202,5947,103,99,4080.89,7615.17,0.00
2024-12-10 17:22:18,202,5948,103,99,4055.55,7616.00,0.00
2024-12-10 17:22:18,203,5948,104,99,4035.57,7616.01,0.00
2024-12-10 17:22:18,204,5947,105,99,4014.67,7616.03,0.00
2024-12-10 17:22:18,203,5947,104,99,4033.40,7616.17,0.00
2024-12-10 17:22:18,202,5947,104,98,4052.99,7616.17,0.00
2024-12-10 17:22:18,203,5946,105,98,4010.96,7616.47,0.00
2024-12-10 17:22:18,203,5947,105,98,4033.43,7617.00,0.00
2024-12-10 17:22:18,204,5947,106,98,4013.66,7617.01,0.00
2024-12-10 17:22:18,203,5947,105,98,4032.31,7617.02,0.00
2024-12-10 17:22:18,202,5947,105,97,4044.03,7617.12,0.00
2024-12-10 17:22:18,201,5947,104,97,4060.76,7617.16,0.00
2024-12-10 17:22:18,200,5947,103,97,4080.68,7617.16,0.00
2024-12-10 17:22:18,199,5947,103,96,4100.81,7617.16,0.00
2024-12-10 17:22:18,198,5947,102,96,4121.13,7617.16,0.00
2024-12-10 17:22:18,197,5947,102,95,4087.35,7617.75,0.00
2024-12-10 17:22:18,197,5948,102,95,4184.23,7618.00,0.00
2024-12-10 17:22:18,198,5948,103,95,4163.10,7618.01,0.00
2024-12-10 17:22:18,197,5948,102,95,4171.94,7618.16,0.00
2024-12-10 17:22:18,197,5949,102,95,4147.27,7619.00,0.00
2024-12-10 17:22:18,198,5949,103,95,4126.32,7619.01,0.00
2024-12-10 17:22:18,197,5949,103,94,4134.97,7619.16,0.00
2024-12-10 17:22:18,197,5950,103,94,4110.29,7620.00,0.00
2024-12-10 17:22:18,198,5950,103,95,4089.53,7620.01,0.00
2024-12-10 17:22:18,199,5949,104,95,4058.18,7620.16,0.00
2024-12-10 17:22:18,198,5949,103,95,4112.55,7620.17,0.00
2024-12-10 17:22:18,198,5950,103,95,4087.99,7621.00,0.00
2024-12-10 17:22:18,199,5950,103,96,4067.45,7621.01,0.00
2024-12-10 17:22:18,198,5950,102,96,4079.84,7621.11,0.00
2024-12-10 17:22:18,197,5950,101,96,4096.70,7621.16,0.00
2024-12-10 17:22:18,198,5949,101,97,4063.35,7621.33,0.00
2024-12-10 17:22:18,198,5950,101,97,4119.20,7622.00,0.00
2024-12-10 17:22:18,199,5950,101,98,4098.50,7622.01,0.00
2024-12-10 17:22:18,198,5950,100,98,4112.31,7622.09,0.00
2024-12-10 17:22:18,197,5950,100,97,4127.81,7622.16,0.00
2024-12-10 17:22:18,196,5950,100,96,4148.48,7622.16,0.00
2024-12-10 17:22:18,195,5950,100,95,4169.36,7622.16,0.00
2024-12-10 17:22:18,196,5949,101,95,4130.65,7622.40,0.00
2024-12-10 17:22:18,197,5948,102,95,4135.62,7622.42,0.00
2024-12-10 17:22:18,197,5949,102,95,4195.60,7623.00,0.00
2024-12-10 17:22:18,198,5949,103,95,4174.41,7623.01,0.00
2024-12-10 17:22:18,197,5949,102,95,4183.68,7623.16,0.00
2024-12-10 17:22:18,198,5948,103,95,4127.69,7623.63,0.00
2024-12-10 17:22:18,199,5947,103,96,4122.66,7623.64,0.00
2024-12-10 17:22:18,199,5948,103,96,4196.52,7624.00,0.00
2024-12-10 17:22:18,200,5948,103,97,4175.53,7624.01,0.00
2024-12-10 17:22:18,199,5948,102,97,4184.71,7624.16,0.00
2024-12-10 17:22:18,198,5948,101,97,4147.21,7624.77,0.00
2024-12-10 17:22:18,198,5949,101,97,4245.60,7625.00,0.00
2024-12-10 17:22:18,199,5949,101,98,4224.26,7625.01,0.00
2024-12-10 17:22:18,200,5948,101,99,4202.38,7625.03,0.00
2024-12-10 17:22:18,201,5947,102,99,4156.95,7625.40,0.00
2024-12-10 17:22:18,201,5948,102,99,4176.70,7626.00,0.00
2024-12-10 17:22:18,202,5948,102,100,4156.03,7626.01,0.00
2024-12-10 17:22:18,201,5948,102,99,4175.20,7626.02,0.00
2024-12-10 17:22:18,202,5947,103,99,4154.15,7626.04,0.00
2024-12-10 17:22:18,201,5947,103,98,4177.54,7626.16,0.00
2024-12-10 17:22:18,201,5948,103,98,4226.84,7627.00,0.00
2024-12-10 17:22:18,202,5948,103,99,4205.92,7627.01,0.00
2024-12-10 17:22:18,203,5947,103,100,4178.86,7627.10,0.00
2024-12-10 17:22:18,202,5947,103,99,4201.85,7627.17,0.00
2024-12-10 17:22:18,201,5947,103,98,4222.37,7627.17,0.00
2024-12-10 17:22:18,201,5948,103,98,4215.64,7628.00,0.00
2024-12-10 17:22:18,202,5948,103,99,4194.77,7628.01,0.00
2024-12-10 17:22:18,201,5948,103,98,4203.20,7628.16,0.00
2024-12-10 17:22:18,200,5948,102,98,4223.83,7628.17,0.00
2024-12-10 17:22:18,201,5947,102,99,4180.14,7628.47,0.00
2024-12-10 17:22:18,200,5947,101,99,4158.67,7628.89,0.00
2024-12-10 17:22:18,200,5948,101,99,4226.66,7629.00,0.00
2024-12-10 17:22:18,201,5948,102,99,4205.63,7629.01,0.00
2024-12-10 17:22:18,200,5948,102,98,4214.15,7629.17,0.00
2024-12-10 17:22:18,199,5948,101,98,4234.95,7629.17,0.00
2024-12-10 17:22:18,199,5949,101,98,4246.55,7630.00,0.00
2024-12-10 17:22:18,200,5949,101,99,4225.32,7630.01,0.00
2024-12-10 17:22:18,199,5949,101,98,4233.98,7630.17,0.00
2024-12-10 17:22:18,199,5950,101,98,4207.16,7631.00,0.00
2024-12-10 17:22:18,200,5950,101,99,4186.12,7631.01,0.00
2024-12-10 17:22:18,201,5949,102,99,4135.44,7631.41,0.00
2024-12-10 17:22:19,201,5950,102,99,4153.46,7632.00,0.00
2024-12-10 17:22:19,202,5950,103,99,4132.90,7632.01,0.00
2024-12-10 17:22:19,201,5950,102,99,4144.40,7632.12,0.00
2024-12-10 17:22:19,200,5950,102,98,4161.33,7632.17,0.00
2024-12-10 17:22:19,199,5950,102,97,4181.86,7632.17,0.00
2024-12-10 17:22:19,199,5951,102,97,4193.46,7633.00,0.00
2024-12-10 17:22:19,200,5951,103,97,4172.50,7633.01,0.00
2024-12-10 17:22:19,199,5951,103,96,4180.88,7633.17,0.00
2024-12-10 17:22:19,199,5952,103,96,4153.98,7634.00,0.00
2024-12-10 17:22:19,200,5952,104,96,4133.21,7634.01,0.00
2024-12-10 17:22:19,201,5951,105,96,4108.12,7634.08,0.00
2024-12-10 17:22:19,200,5951,104,96,4153.31,7634.17,0.00
2024-12-10 17:22:19,200,5952,104,96,4126.54,7635.00,0.00
2024-12-10 17:22:19,201,5952,105,96,4106.01,7635.01,0.00
2024-12-10 17:22:19,200,5952,104,96,4122.36,7635.06,0.00
2024-12-10 17:22:19,199,5952,103,96,4136.57,7635.07,0.00
2024-12-10 17:22:19,198,5952,103,95,4146.57,7635.16,0.00
2024-12-10 17:22:19,197,5952,102,95,4167.23,7635.16,0.00
2024-12-10 17:22:19,198,5951,103,95,4107.93,7635.64,0.00
2024-12-10 17:22:19,198,5952,103,95,4173.38,7636.00,0.00
2024-12-10 17:22:19,199,5952,104,95,4152.41,7636.01,0.00
2024-12-10 17:22:19,200,5951,104,96,4093.94,7636.44,0.00
2024-12-10 17:22:19,200,5952,104,96,4155.85,7637.00,0.00
2024-12-10 17:22:19,201,5952,104,97,4135.18,7637.01,0.00
2024-12-10 17:22:19,202,5951,105,97,4113.95,7637.03,0.00
2024-12-10 17:22:19,201,5951,104,97,4120.98,7637.16,0.00
2024-12-10 17:22:19,201,5952,104,97,4111.96,7638.00,0.00
2024-12-10 17:22:19,202,5952,105,97,4091.61,7638.01,0.00
2024-12-10 17:22:19,201,5952,104,97,4085.11,7638.16,0.00
2024-12-10 17:22:19,202,5951,105,97,4020.46,7638.69,0.00
2024-12-10 17:22:19,201,5951,104,97,4024.59,7638.84,0.00
2024-12-10 17:22:19,201,5952,104,97,4086.55,7639.00,0.00
2024-12-10 17:22:19,202,5952,105,97,4066.32,7639.01,0.00
2024-12-10 17:22:19,201,5952,105,96,4062.90,7639.14,0.00
2024-12-10 17:22:19,200,5952,104,96,4082.07,7639.16,0.00
2024-12-10 17:22:19,200,5953,104,96,4088.38,7640.00,0.00
2024-12-10 17:22:19,201,5953,104,97,4068.04,7640.01,0.00
2024-12-10 17:22:19,200,5953,104,96,4062.61,7640.16,0.00
2024-12-10 17:22:19,199,5953,103,96,4069.61,7640.27,0.00
2024-12-10 17:22:19,200,5952,103,97,3997.84,7640.84,0.00
2024-12-10 17:22:19,200,5953,103,97,4030.32,7641.00,0.00
2024-12-10 17:22:19,201,5953,104,97,4010.27,7641.01,0.00
2024-12-10 17:22:19,200,5953,103,97,4027.84,7641.02,0.00
2024-12-10 17:22:19,199,5953,103,96,4037.31,7641.15,0.00
2024-12-10 17:22:19,200,5952,104,96,4015.98,7641.18,0.00
2024-12-10 17:22:19,199,5952,103,96,3996.76,7641.54,0.00
2024-12-10 17:22:19,199,5953,103,96,4035.71,7642.00,0.00
2024-12-10 17:22:19,200,5953,103,97,4015.53,7642.01,0.00
2024-12-10 17:22:19,201,5952,104,97,3987.42,7642.12,0.00
2024-12-10 17:22:19,200,5952,104,96,4012.34,7642.16,0.00
2024-12-10 17:22:19,200,5953,104,96,4015.73,7643.00,0.00
2024-12-10 17:22:19,201,5953,104,97,3995.75,7643.01,0.00
2024-12-10 17:22:19,200,5953,103,97,4015.35,7643.01,0.00
2024-12-10 17:22:19,199,5953,102,97,4023.85,7643.15,0.00
2024-12-10 17:22:20,198,5953,102,96,4043.78,7643.15,0.00
2024-12-10 17:22:20,198,5954,102,96,4032.92,7644.00,0.00
2024-12-10 17:22:20,199,5954,103,96,4012.65,7644.01,0.00
2024-12-10 17:22:20,198,5954,102,96,4020.60,7644.15,0.00
2024-12-10 17:22:20,198,5955,102,96,3968.09,7645.00,0.00
2024-12-10 17:22:20,199,5955,102,97,3948.15,7645.01,0.00
2024-12-10 17:22:20,198,5955,101,97,3958.77,7645.11,0.00
2024-12-10 17:22:20,197,5955,101,96,3975.77,7645.15,0.00
2024-12-10 17:22:20,196,5955,100,96,3995.67,7645.15,0.00
2024-12-10 17:22:20,195,5955,99,96,3995.20,7645.36,0.00
2024-12-10 17:22:20,196,5954,100,96,3970.16,7645.43,0.00
2024-12-10 17:22:20,195,5954,99,96,3963.36,7645.94,0.00
2024-12-10 17:22:20,195,5955,99,96,3998.31,7646.00,0.00
2024-12-10 17:22:20,196,5955,100,96,3977.91,7646.01,0.00
2024-12-10 17:22:20,195,5955,100,95,3985.99,7646.15,0.00
2024-12-10 17:22:20,194,5955,100,94,4006.15,7646.15,0.00
2024-12-10 17:22:20,194,5956,100,94,4003.73,7647.00,0.00
2024-12-10 17:22:20,195,5956,101,94,3983.20,7647.01,0.00
2024-12-10 17:22:20,194,5956,101,93,4001.02,7647.02,0.00
2024-12-10 17:22:20,193,5956,101,92,4011.90,7647.15,0.00
2024-12-10 17:22:20,192,5956,101,91,4032.40,7647.15,0.00
2024-12-10 17:22:20,192,5957,101,91,3992.29,7648.00,0.00
2024-12-10 17:22:20,193,5957,102,91,3971.61,7648.01,0.00
2024-12-10 17:22:20,192,5957,102,90,3982.30,7648.12,0.00
2024-12-10 17:22:20,191,5957,101,90,4000.36,7648.15,0.00
2024-12-10 17:22:20,190,5957,101,89,4021.01,7648.15,0.00
2024-12-10 17:22:20,189,5957,100,89,4041.89,7648.15,0.00
2024-12-10 17:22:20,188,5957,99,89,4052.24,7648.25,0.00
2024-12-10 17:22:20,189,5956,99,90,3973.35,7649.00,0.00
2024-12-10 17:22:20,189,5957,99,90,4013.83,7649.00,0.00
2024-12-10 17:22:20,190,5957,100,90,3992.70,7649.01,0.00
2024-12-10 17:22:20,189,5957,99,90,4006.45,7649.08,0.00
2024-12-10 17:22:20,188,5957,98,90,4022.10,7649.15,0.00
2024-12-10 17:22:20,187,5957,97,90,4043.19,7649.15,0.00
2024-12-10 17:22:20,187,5958,97,90,4058.71,7650.00,0.00
2024-12-10 17:22:20,188,5958,97,91,4037.12,7650.01,0.00
2024-12-10 17:22:20,189,5957,97,92,4006.02,7650.13,0.00
2024-12-10 17:22:20,188,5957,97,91,4059.50,7650.15,0.00
2024-12-10 17:22:20,188,5958,97,91,4031.51,7651.00,0.00
2024-12-10 17:22:20,189,5958,97,92,4010.18,7651.01,0.00
2024-12-10 17:22:20,190,5957,98,92,3970.22,7651.25,0.00
2024-12-10 17:22:20,191,5956,98,93,3983.49,7651.27,0.00
2024-12-10 17:22:20,191,5957,98,93,4027.10,7652.00,0.00
2024-12-10 17:22:20,192,5957,98,94,4006.13,7652.01,0.00
2024-12-10 17:22:20,191,5957,97,94,4020.06,7652.08,0.00
2024-12-10 17:22:20,192,5956,97,95,3937.82,7652.88,0.00
2024-12-10 17:22:20,192,5957,97,95,4077.94,7653.00,0.00
2024-12-10 17:22:20,193,5957,98,95,4056.81,7653.01,0.00
2024-12-10 17:22:20,192,5957,98,94,4076.93,7653.01,0.00
2024-12-10 17:22:20,191,5957,97,94,4086.73,7653.16,0.00
2024-12-10 17:22:20,191,5958,97,94,4081.69,7654.00,0.00
2024-12-10 17:22:20,192,5958,97,95,4060.43,7654.01,0.00
2024-12-10 17:22:20,193,5957,98,95,4033.65,7654.09,0.00
2024-12-10 17:22:20,192,5957,97,95,4071.85,7654.16,0.00
2024-12-10 17:22:20,191,5957,96,95,4072.09,7654.44,0.00
2024-12-10 17:22:20,192,5956,96,96,4043.75,7654.54,0.00
2024-12-10 17:22:20,192,5957,96,96,4064.88,7655.00,0.00
2024-12-10 17:22:20,193,5957,97,96,4043.81,7655.01,0.00
2024-12-10 17:22:20,192,5957,96,96,4060.51,7655.06,0.00
2024-12-10 17:22:20,191,5957,96,95,4073.81,7655.16,0.00
2024-12-10 17:22:20,192,5956,96,96,4045.04,7655.27,0.00
2024-12-10 17:22:20,192,5957,96,96,4120.55,7656.00,0.00
2024-12-10 17:22:20,193,5957,97,96,4099.20,7656.01,0.00
2024-12-10 17:22:20,192,5957,96,96,4108.46,7656.16,0.00
2024-12-10 17:22:20,191,5957,96,95,4129.57,7656.16,0.00
2024-12-10 17:22:20,190,5957,96,94,4094.34,7656.83,0.00
2024-12-10 17:22:20,190,5958,96,94,4162.00,7657.00,0.00
2024-12-10 17:22:20,191,5958,96,95,4140.21,7657.01,0.00
2024-12-10 17:22:20,190,5958,95,95,4149.31,7657.16,0.00
2024-12-10 17:22:20,189,5958,95,94,4170.86,7657.16,0.00
2024-12-10 17:22:20,190,5957,95,95,4141.66,7657.26,0.00
2024-12-10 17:22:20,189,5957,95,94,4170.61,7657.60,0.00
2024-12-10 17:22:20,189,5958,95,94,4177.48,7658.00,0.00
2024-12-10 17:22:20,190,5958,95,95,4155.49,7658.01,0.00
2024-12-10 17:22:20,189,5958,94,95,4164.81,7658.16,0.00
2024-12-10 17:22:20,190,5957,95,95,4113.92,7658.55,0.00
2024-12-10 17:22:20,191,5956,95,96,4077.78,7658.96,0.00
2024-12-10 17:22:20,191,5957,95,96,4156.40,7659.00,0.00
2024-12-10 17:22:20,192,5957,96,96,4134.76,7659.01,0.00
2024-12-10 17:22:20,191,5957,95,96,4151.62,7659.06,0.00
2024-12-10 17:22:20,190,5957,95,95,4166.26,7659.15,0.00
2024-12-10 17:22:20,189,5957,95,94,4187.90,7659.15,0.00
2024-12-10 17:22:20,189,5958,95,94,4240.27,7660.00,0.00
2024-12-10 17:22:20,190,5958,95,95,4217.96,7660.01,0.00
2024-12-10 17:22:20,189,5958,94,95,4228.46,7660.15,0.00
2024-12-10 17:22:20,189,5959,94,95,4201.52,7661.00,0.00
2024-12-10 17:22:20,190,5959,94,96,4179.41,7661.01,0.00
2024-12-10 17:22:20,189,5959,94,95,4188.28,7661.15,0.00
2024-12-10 17:22:20,188,5959,94,94,4210.03,7661.16,0.00
2024-12-10 17:22:20,188,5960,94,94,4185.60,7662.00,0.00
2024-12-10 17:22:20,189,5960,94,95,4163.45,7662.01,0.00
2024-12-10 17:22:21,190,5959,95,95,4078.53,7662.80,0.00
2024-12-10 17:22:21,190,5960,95,95,4112.99,7663.00,0.00
2024-12-10 17:22:21,191,5960,95,96,4091.46,7663.01,0.00
2024-12-10 17:22:21,192,5959,95,97,4064.45,7663.08,0.00
2024-12-10 17:22:21,191,5959,95,96,4081.96,7663.16,0.00
2024-12-10 17:22:21,190,5959,95,95,4103.04,7663.16,0.00
2024-12-10 17:22:21,190,5960,95,95,4117.25,7664.00,0.00
2024-12-10 17:22:21,191,5960,95,96,4095.70,7664.01,0.00
2024-12-10 17:22:21,190,5960,95,95,4103.35,7664.16,0.00
2024-12-10 17:22:21,191,5959,95,96,4057.19,7664.49,0.00
2024-12-10 17:22:21,192,5958,95,97,4042.81,7664.69,0.00
2024-12-10 17:22:21,192,5959,95,97,4114.96,7665.00,0.00
2024-12-10 17:22:21,193,5959,95,98,4093.64,7665.01,0.00
2024-12-10 17:22:21,194,5958,95,99,3993.65,7665.97,0.00
2024-12-10 17:22:21,194,5959,95,99,4109.32,7666.00,0.00
2024-12-10 17:22:21,195,5959,95,100,4088.25,7666.01,0.00
2024-12-10 17:22:21,194,5959,94,100,4094.32,7666.17,0.00
2024-12-10 17:22:21,194,5960,94,100,4103.05,7667.00,0.00
2024-12-10 17:22:21,195,5960,95,100,4082.01,7667.01,0.00
2024-12-10 17:22:21,194,5960,95,99,4088.10,7667.17,0.00
2024-12-10 17:22:21,193,5960,95,98,4108.88,7667.17,0.00
2024-12-10 17:22:21,193,5961,95,98,4077.66,7668.00,0.00
2024-12-10 17:22:21,194,5961,96,98,4056.64,7668.01,0.00
2024-12-10 17:22:21,195,5960,97,98,3981.20,7668.64,0.00
2024-12-10 17:22:21,195,5961,97,98,4005.37,7669.00,0.00
2024-12-10 17:22:21,196,5961,98,98,3984.94,7669.01,0.00
2024-12-10 17:22:21,196,5962,98,98,3962.30,7670.00,0.00
2024-12-10 17:22:21,197,5962,99,98,3942.18,7670.01,0.00
2024-12-10 17:22:21,196,5962,99,97,3958.48,7670.02,0.00
2024-12-10 17:22:21,195,5962,98,97,3965.58,7670.17,0.00
2024-12-10 17:22:21,194,5962,97,97,3911.62,7670.77,0.00
2024-12-10 17:22:21,194,5963,97,97,3930.99,7671.00,0.00
2024-12-10 17:22:21,195,5963,97,98,3910.83,7671.01,0.00
2024-12-10 17:22:21,194,5963,96,98,3927.31,7671.03,0.00
2024-12-10 17:22:21,193,5963,95,98,3942.12,7671.09,0.00
2024-12-10 17:22:21,194,5962,96,98,3921.80,7671.10,0.00
2024-12-10 17:22:21,193,5962,96,97,3947.83,7671.17,0.00
2024-12-10 17:22:21,192,5962,96,96,3967.99,7671.17,0.00
2024-12-10 17:22:21,191,5962,96,95,3961.82,7671.47,0.00
2024-12-10 17:22:21,191,5963,96,95,3956.59,7672.00,0.00
2024-12-10 17:22:21,192,5963,97,95,3935.98,7672.01,0.00
2024-12-10 17:22:21,191,5963,97,94,3941.39,7672.17,0.00
2024-12-10 17:22:21,192,5962,98,94,3885.99,7672.59,0.00
2024-12-10 17:22:21,192,5963,98,94,3955.57,7673.00,0.00
2024-12-10 17:22:21,193,5963,98,95,3935.07,7673.01,0.00
2024-12-10 17:22:21,192,5963,97,95,3940.08,7673.17,0.00
2024-12-10 17:22:21,192,5964,97,95,3948.18,7674.00,0.00
2024-12-10 17:22:21,193,5964,97,96,3927.72,7674.01,0.00
2024-12-10 17:22:21,192,5964,97,95,3932.57,7674.17,0.00
2024-12-10 17:22:21,191,5964,96,95,3952.71,7674.17,0.00
2024-12-10 17:22:21,191,5965,96,95,3922.60,7675.00,0.00
2024-12-10 17:22:21,192,5965,96,96,3902.17,7675.01,0.00
2024-12-10 17:22:21,191,5965,95,96,3906.87,7675.17,0.00
2024-12-10 17:22:21,191,5966,95,96,3875.35,7676.00,0.00
2024-12-10 17:22:21,192,5966,96,96,3855.17,7676.01,0.00
2024-12-10 17:22:21,191,5966,96,95,3859.71,7676.17,0.00
2024-12-10 17:22:21,190,5966,96,94,3879.62,7676.17,0.00
2024-12-10 17:22:21,189,5966,95,94,3896.44,7676.22,0.00
2024-12-10 17:22:21,190,5965,96,94,3829.86,7676.72,0.00
2024-12-10 17:22:21,190,5966,96,94,3861.20,7677.00,0.00
2024-12-10 17:22:21,191,5966,97,94,3840.98,7677.01,0.00
2024-12-10 17:22:21,190,5966,96,94,3858.95,7677.02,0.00
2024-12-10 17:22:21,191,5965,96,95,3826.70,7677.18,0.00
2024-12-10 17:22:21,191,5966,96,95,3874.26,7678.00,0.00
2024-12-10 17:22:21,192,5966,97,95,3854.08,7678.01,0.00
2024-12-10 17:22:21,192,5967,97,95,3846.00,7679.00,0.00
2024-12-10 17:22:21,193,5967,97,96,3826.07,7679.01,0.00
2024-12-10 17:22:21,194,5966,98,96,3800.76,7679.08,0.00
2024-12-10 17:22:21,193,5966,98,95,3851.15,7679.18,0.00
2024-12-10 17:22:21,192,5966,97,95,3858.14,7679.33,0.00
2024-12-10 17:22:21,192,5967,97,95,3835.28,7680.00,0.00
2024-12-10 17:22:21,193,5967,98,95,3815.41,7680.01,0.00
2024-12-10 17:22:21,192,5967,98,94,3834.88,7680.01,0.00
2024-12-10 17:22:21,193,5966,99,94,3803.53,7680.16,0.00
2024-12-10 17:22:21,192,5966,99,93,3848.96,7680.17,0.00
2024-12-10 17:22:21,193,5965,100,93,3811.48,7680.38,0.00
2024-12-10 17:22:21,194,5964,101,93,3794.63,7680.46,0.00
2024-12-10 17:22:21,193,5964,101,92,3835.14,7680.51,0.00
2024-12-10 17:22:21,193,5965,101,92,3866.85,7681.00,0.00
2024-12-10 17:22:21,194,5965,102,92,3846.92,7681.01,0.00
2024-12-10 17:22:21,193,5965,101,92,3852.83,7681.17,0.00
2024-12-10 17:22:21,192,5965,100,92,3834.84,7681.59,0.00
2024-12-10 17:22:21,192,5966,100,92,3955.88,7682.00,0.00
2024-12-10 17:22:21,193,5966,101,92,3935.38,7682.01,0.00
2024-12-10 17:22:21,194,5965,102,92,3912.33,7682.05,0.00
2024-12-10 17:22:22,193,5965,101,92,3958.59,7682.18,0.00
2024-12-10 17:22:22,194,5964,101,93,3908.35,7682.55,0.00
2024-12-10 17:22:22,195,5963,101,94,3901.18,7682.76,0.00
2024-12-10 17:22:22,195,5964,101,94,3925.34,7683.00,0.00
2024-12-10 17:22:22,196,5964,102,94,3905.31,7683.01,0.00
2024-12-10 17:22:22,195,5964,102,93,3924.16,7683.02,0.00
2024-12-10 17:22:22,194,5964,101,93,3930.86,7683.17,0.00
2024-12-10 17:22:22,193,5964,101,92,3950.83,7683.17,0.00
2024-12-10 17:22:22,192,5964,101,91,3917.63,7683.75,0.00
2024-12-10 17:22:22,192,5965,101,91,4051.22,7684.00,0.00
2024-12-10 17:22:22,193,5965,102,91,4030.23,7684.01,0.00
2024-12-10 17:22:22,192,5965,102,90,4036.53,7684.17,0.00
2024-12-10 17:22:22,192,5966,102,90,4001.63,7685.00,0.00
2024-12-10 17:22:22,193,5966,103,90,3980.90,7685.01,0.00
2024-12-10 17:22:22,192,5966,102,90,3986.79,7685.17,0.00
2024-12-10 17:22:22,191,5966,101,90,4007.61,7685.17,0.00
2024-12-10 17:22:22,191,5967,101,90,3977.79,7686.00,0.00
2024-12-10 17:22:22,192,5967,102,90,3957.07,7686.01,0.00
2024-12-10 17:22:22,191,5967,102,89,3977.39,7686.01,0.00
2024-12-10 17:22:22,190,5967,102,88,3935.86,7686.71,0.00
2024-12-10 17:22:22,190,5968,102,88,3954.30,7687.00,0.00
2024-12-10 17:22:22,191,5968,102,89,3933.60,7687.01,0.00
2024-12-10 17:22:22,190,5968,102,88,3953.89,7687.01,0.00
2024-12-10 17:22:22,189,5968,101,88,3960.47,7687.16,0.00
2024-12-10 17:22:22,188,5968,101,87,3981.13,7687.17,0.00
2024-12-10 17:22:22,188,5969,101,87,3948.15,7688.00,0.00
2024-12-10 17:22:22,189,5969,102,87,3927.26,7688.01,0.00
2024-12-10 17:22:22,190,5968,103,87,3905.38,7688.03,0.00
2024-12-10 17:22:22,189,5968,102,87,3937.72,7688.17,0.00
2024-12-10 17:22:22,188,5968,102,86,3897.90,7688.81,0.00
2024-12-10 17:22:22,188,5969,102,86,3924.24,7689.00,0.00
2024-12-10 17:22:22,189,5969,102,87,3903.48,7689.01,0.00
2024-12-10 17:22:22,188,5969,102,86,3909.84,7689.17,0.00
2024-12-10 17:22:22,187,5969,102,85,3913.90,7689.36,0.00
2024-12-10 17:22:22,187,5970,102,85,3944.30,7690.00,0.00
2024-12-10 17:22:22,188,5970,103,85,3923.32,7690.01,0.00
2024-12-10 17:22:22,187,5970,102,85,3936.34,7690.08,0.00
2024-12-10 17:22:22,186,5970,102,84,3950.93,7690.16,0.00
2024-12-10 17:22:22,185,5970,101,84,3963.98,7690.27,0.00
2024-12-10 17:22:22,185,5971,101,84,3948.27,7691.00,0.00
2024-12-10 17:22:22,186,5971,102,84,3927.04,7691.01,0.00
2024-12-10 17:22:22,185,5971,102,83,3944.88,7691.04,0.00
2024-12-10 17:22:22,184,5971,102,82,3957.17,7691.16,0.00
2024-12-10 17:22:22,183,5971,102,81,3978.38,7691.16,0.00
2024-12-10 17:22:22,184,5970,103,81,3925.11,7691.55,0.00
2024-12-10 17:22:22,184,5971,103,81,3961.17,7692.00,0.00
2024-12-10 17:22:22,185,5971,104,81,3939.75,7692.01,0.00
2024-12-10 17:22:22,184,5971,103,81,3949.11,7692.16,0.00
2024-12-10 17:22:22,185,5970,103,82,3922.37,7692.24,0.00
2024-12-10 17:22:22,185,5971,103,82,3977.14,7693.00,0.00
2024-12-10 17:22:22,186,5971,104,82,3955.76,7693.01,0.00
2024-12-10 17:22:22,185,5971,104,81,3965.15,7693.16,0.00
2024-12-10 17:22:22,186,5970,104,82,3903.48,7693.66,0.00
2024-12-10 17:22:22,186,5971,104,82,3976.19,7694.00,0.00
2024-12-10 17:22:22,187,5971,104,83,3954.93,7694.01,0.00
2024-12-10 17:22:22,186,5971,104,82,3975.36,7694.01,0.00
2024-12-10 17:22:22,185,5971,103,82,3985.61,7694.15,0.00
2024-12-10 17:22:22,186,5970,104,82,3957.17,7694.25,0.00
2024-12-10 17:22:22,186,5971,104,82,4014.95,7695.00,0.00
2024-12-10 17:22:22,187,5971,105,82,3993.48,7695.01,0.00
2024-12-10 17:22:22,186,5971,104,82,4002.60,7695.16,0.00
2024-12-10 17:22:22,185,5971,104,81,4023.81,7695.16,0.00
2024-12-10 17:22:22,184,5971,104,80,4025.41,7695.40,0.00
2024-12-10 17:22:22,185,5970,105,80,3958.72,7695.98,0.00
2024-12-10 17:22:22,185,5971,105,80,4041.11,7696.00,0.00
2024-12-10 17:22:22,186,5971,105,81,4019.38,7696.01,0.00
2024-12-10 17:22:22,185,5971,104,81,4029.03,7696.16,0.00
2024-12-10 17:22:22,186,5970,104,82,3985.39,7696.40,0.00
2024-12-10 17:22:22,186,5971,104,82,4031.39,7697.00,0.00
2024-12-10 17:22:22,187,5971,105,82,4009.83,7697.01,0.00
2024-12-10 17:22:22,186,5971,105,81,4019.45,7697.16,0.00
2024-12-10 17:22:22,186,5972,105,81,4025.79,7698.00,0.00
2024-12-10 17:22:22,187,5972,106,81,4004.26,7698.01,0.00
2024-12-10 17:22:22,186,5972,106,80,4003.26,7698.16,0.00
2024-12-10 17:22:22,185,5972,106,79,4024.48,7698.16,0.00
2024-12-10 17:22:22,184,5972,106,78,4023.75,7698.28,0.00
2024-12-10 17:22:22,185,5971,107,78,3971.59,7698.66,0.00
2024-12-10 17:22:22,185,5972,107,78,4001.65,7699.00,0.00
2024-12-10 17:22:22,186,5972,108,78,3980.14,7699.01,0.00
2024-12-10 17:22:22,187,5971,108,79,3948.16,7699.03,0.00
2024-12-10 17:22:22,186,5971,107,79,3965.72,7699.16,0.00
2024-12-10 17:22:22,185,5971,106,79,3986.74,7699.16,0.00
2024-12-10 17:22:22,184,5971,105,79,3993.68,7699.17,0.00
2024-12-10 17:22:22,185,5970,105,80,3907.95,7699.99,0.00
2024-12-10 17:22:22,185,5971,105,80,3990.79,7700.00,0.00
2024-12-10 17:22:22,186,5971,105,81,3969.33,7700.01,0.00
2024-12-10 17:22:22,185,5971,104,81,3966.84,7700.16,0.00
2024-12-10 17:22:22,185,5972,104,81,4023.90,7701.00,0.00
2024-12-10 17:22:22,186,5972,105,81,4002.26,7701.01,0.00
2024-12-10 17:22:22,185,5972,105,80,4018.59,7701.02,0.00
2024-12-10 17:22:22,185,5973,105,80,3979.28,7702.00,0.00
2024-12-10 17:22:22,186,5973,105,81,3957.89,7702.01,0.00
2024-12-10 17:22:22,185,5973,104,81,3966.84,7702.15,0.00
2024-12-10 17:22:22,184,5973,103,81,3987.98,7702.15,0.00
2024-12-10 17:22:22,183,5973,102,81,3988.02,7702.43,0.00
2024-12-10 17:22:22,183,5974,102,81,3982.73,7703.00,0.00
2024-12-10 17:22:22,184,5974,103,81,3961.09,7703.01,0.00
2024-12-10 17:22:22,183,5974,102,81,3978.96,7703.05,0.00
2024-12-10 17:22:23,182,5974,101,81,3997.87,7703.08,0.00
2024-12-10 17:22:23,181,5974,100,81,4013.10,7703.14,0.00
2024-12-10 17:22:23,180,5974,99,81,4034.97,7703.15,0.00
2024-12-10 17:22:23,179,5974,98,81,4057.08,7703.15,0.00
2024-12-10 17:22:23,179,5975,98,81,4033.09,7704.00,0.00
2024-12-10 17:22:23,180,5975,99,81,4010.68,7704.01,0.00
2024-12-10 17:22:23,179,5975,98,81,4021.95,7704.15,0.00
2024-12-10 17:22:23,180,5974,98,82,3998.34,7704.17,0.00
2024-12-10 17:22:23,180,5975,98,82,4016.81,7705.00,0.00
2024-12-10 17:22:23,181,5975,98,83,3994.62,7705.01,0.00
2024-12-10 17:22:23,182,5974,99,83,3954.12,7705.26,0.00
2024-12-10 17:22:23,182,5975,99,83,4014.89,7706.00,0.00
2024-12-10 17:22:23,183,5975,99,84,3992.95,7706.01,0.00
2024-12-10 17:22:23,182,5975,99,83,4011.94,7706.04,0.00
2024-12-10 17:22:23,181,5975,99,82,4024.36,7706.16,0.00
2024-12-10 17:22:23,181,5976,99,82,4040.19,7707.00,0.00
2024-12-10 17:22:23,182,5976,100,82,4018.00,7707.01,0.00
2024-12-10 17:22:23,181,5976,100,81,4026.41,7707.16,0.00
2024-12-10 17:22:23,181,5977,100,81,3998.39,7708.00,0.00
2024-12-10 17:22:23,182,5977,101,81,3976.43,7708.01,0.00
2024-12-10 17:22:23,182,5978,101,81,3935.61,7709.00,0.00
2024-12-10 17:22:23,183,5978,102,81,3914.10,7709.01,0.00
2024-12-10 17:22:23,182,5978,101,81,3923.39,7709.16,0.00
2024-12-10 17:22:23,181,5978,100,81,3925.78,7709.40,0.00
2024-12-10 17:22:23,181,5979,100,81,3914.85,7710.00,0.00
2024-12-10 17:22:23,182,5979,101,81,3893.34,7710.01,0.00
2024-12-10 17:22:23,181,5979,100,81,3902.55,7710.16,0.00
2024-12-10 17:22:23,181,5980,100,81,3872.22,7711.00,0.00
2024-12-10 17:22:23,182,5980,101,81,3850.94,7711.01,0.00
2024-12-10 17:22:23,183,5979,102,81,3819.41,7711.15,0.00
2024-12-10 17:22:23,182,5979,101,81,3858.63,7711.17,0.00
2024-12-10 17:22:23,181,5979,100,81,3879.52,7711.17,0.00
2024-12-10 17:22:23,180,5979,99,81,3900.65,7711.17,0.00
2024-12-10 17:22:23,181,5978,99,82,3871.02,7711.28,0.00
2024-12-10 17:22:23,181,5979,99,82,3856.62,7712.00,0.00
2024-12-10 17:22:23,182,5979,99,83,3835.43,7712.01,0.00
2024-12-10 17:22:23,181,5979,99,82,3852.80,7712.05,0.00
2024-12-10 17:22:23,180,5979,98,82,3865.68,7712.16,0.00
2024-12-10 17:22:23,180,5980,98,82,3922.33,7713.00,0.00
2024-12-10 17:22:23,181,5980,98,83,3900.66,7713.01,0.00
2024-12-10 17:22:23,180,5980,98,82,3921.48,7713.01,0.00
2024-12-10 17:22:23,179,5980,97,82,3932.24,7713.15,0.00
2024-12-10 17:22:23,180,5979,97,83,3901.42,7713.28,0.00
2024-12-10 17:22:23,180,5980,97,83,3901.70,7714.00,0.00
2024-12-10 17:22:23,181,5980,98,83,3880.15,7714.01,0.00
2024-12-10 17:22:23,180,5980,97,83,3893.04,7714.12,0.00
2024-12-10 17:22:23,179,5980,97,82,3912.23,7714.15,0.00
2024-12-10 17:22:23,179,5981,97,82,3926.06,7715.00,0.00
2024-12-10 17:22:23,180,5981,97,83,3904.25,7715.01,0.00
2024-12-10 17:22:23,179,5981,97,82,3924.35,7715.02,0.00
2024-12-10 17:22:23,180,5980,97,83,3900.84,7715.06,0.00
2024-12-10 17:22:23,179,5980,96,83,3957.59,7715.15,0.00
2024-12-10 17:22:23,179,5981,96,83,3929.30,7716.00,0.00
2024-12-10 17:22:23,180,5981,96,84,3907.47,7716.01,0.00
2024-12-10 17:22:23,179,5981,95,84,3918.15,7716.15,0.00
2024-12-10 17:22:23,178,5981,94,84,3939.73,7716.15,0.00
2024-12-10 17:22:23,177,5981,94,83,3934.61,7716.50,0.00
2024-12-10 17:22:23,176,5981,94,82,3954.06,7716.51,0.00
2024-12-10 17:22:23,177,5980,94,83,3896.53,7716.94,0.00
2024-12-10 17:22:23,177,5981,94,83,3982.03,7717.00,0.00
2024-12-10 17:22:23,178,5981,95,83,3959.66,7717.01,0.00
2024-12-10 17:22:23,177,5981,94,83,3970.76,7717.15,0.00
2024-12-10 17:22:23,177,5982,94,83,3990.18,7718.00,0.00
2024-12-10 17:22:23,178,5982,95,83,3967.77,7718.01,0.00
2024-12-10 17:22:23,179,5981,96,83,3945.60,7718.02,0.00
2024-12-10 17:22:23,179,5982,96,83,3946.77,7719.00,0.00
2024-12-10 17:22:23,180,5982,96,84,3924.85,7719.01,0.00
2024-12-10 17:22:23,179,5982,95,84,3935.20,7719.15,0.00
2024-12-10 17:22:23,178,5982,95,83,3942.42,7719.34,0.00
2024-12-10 17:22:23,177,5982,94,83,3935.46,7719.70,0.00
2024-12-10 17:22:23,177,5983,94,83,3998.16,7720.00,0.00
2024-12-10 17:22:23,178,5983,95,83,3975.70,7720.01,0.00
2024-12-10 17:22:23,177,5983,95,82,3986.45,7720.15,0.00
2024-12-10 17:22:23,178,5982,96,82,3955.40,7720.28,0.00
2024-12-10 17:22:23,178,5983,96,82,3975.55,7721.00,0.00
2024-12-10 17:22:23,179,5983,97,82,3953.34,7721.01,0.00
2024-12-10 17:22:23,178,5983,97,81,3963.90,7721.15,0.00
2024-12-10 17:22:23,178,5984,97,81,3977.77,7722.00,0.00
2024-12-10 17:22:23,179,5984,97,82,3955.54,7722.01,0.00
2024-12-10 17:22:23,178,5984,97,81,3974.75,7722.04,0.00
2024-12-10 17:22:23,177,5984,96,81,3995.90,7722.05,0.00
2024-12-10 17:22:23,176,5984,95,81,4009.67,7722.15,0.00
2024-12-10 17:22:23,175,5984,94,81,4032.14,7722.15,0.00
2024-12-10 17:22:23,175,5985,94,81,4002.24,7723.00,0.00
2024-12-10 17:22:23,176,5985,94,82,3979.50,7723.01,0.00
2024-12-10 17:22:23,175,5985,93,82,3993.79,7723.10,0.00
2024-12-10 17:22:23,174,5985,92,82,4012.78,7723.14,0.00
2024-12-10 17:22:23,173,5985,92,81,4035.08,7723.15,0.00
2024-12-10 17:22:23,173,5986,92,81,4009.11,7724.00,0.00
2024-12-10 17:22:23,174,5986,93,81,3986.07,7724.01,0.00
2024-12-10 17:22:23,175,5985,94,81,3891.66,7724.89,0.00
2024-12-10 17:22:23,175,5986,94,81,3932.81,7725.00,0.00
2024-12-10 17:22:23,176,5986,95,81,3910.47,7725.01,0.00
2024-12-10 17:22:23,175,5986,95,80,3929.30,7725.05,0.00
2024-12-10 17:22:23,174,5986,95,79,3943.94,7725.14,0.00
2024-12-10 17:22:23,173,5986,94,79,3965.84,7725.15,0.00
2024-12-10 17:22:23,174,5985,94,80,3928.88,7725.35,0.00
2024-12-10 17:22:24,174,5986,94,80,3993.65,7726.00,0.00
2024-12-10 17:22:24,175,5986,95,80,3970.83,7726.01,0.00
2024-12-10 17:22:24,174,5986,95,79,3982.17,7726.15,0.00
2024-12-10 17:22:24,173,5986,94,79,4004.74,7726.15,0.00
2024-12-10 17:22:24,174,5985,95,79,3961.79,7726.41,0.00
2024-12-10 17:22:24,174,5986,95,79,4009.98,7727.00,0.00
2024-12-10 17:22:24,175,5986,96,79,3987.07,7727.01,0.00
2024-12-10 17:22:24,174,5986,96,78,3998.07,7727.16,0.00
2024-12-10 17:22:24,175,5985,96,79,3961.57,7727.34,0.00
2024-12-10 17:22:24,176,5984,96,80,3942.01,7727.69,0.00
2024-12-10 17:22:24,176,5985,96,80,4025.12,7728.00,0.00
2024-12-10 17:22:24,177,5985,97,80,4002.38,7728.01,0.00
2024-12-10 17:22:24,176,5985,96,80,4020.76,7728.06,0.00
2024-12-10 17:22:24,175,5985,96,79,4036.27,7728.15,0.00
2024-12-10 17:22:24,174,5985,96,78,4059.02,7728.15,0.00
2024-12-10 17:22:24,173,5985,95,78,4050.27,7728.53,0.00
2024-12-10 17:22:24,173,5986,95,78,4145.68,7729.00,0.00
2024-12-10 17:22:24,174,5986,96,78,4121.86,7729.01,0.00
2024-12-10 17:22:24,173,5986,95,78,4133.40,7729.15,0.00
2024-12-10 17:22:24,172,5986,95,77,4138.94,7729.37,0.00
2024-12-10 17:22:24,173,5985,95,78,4080.92,7729.82,0.00
2024-12-10 17:22:24,173,5986,95,78,4120.40,7730.00,0.00
2024-12-10 17:22:24,174,5986,96,78,4096.72,7730.01,0.00
2024-12-10 17:22:24,173,5986,96,77,4107.68,7730.15,0.00
2024-12-10 17:22:24,173,5987,96,77,4130.78,7731.00,0.00
2024-12-10 17:22:24,174,5987,97,77,4107.04,7731.01,0.00
2024-12-10 17:22:24,173,5987,97,76,4119.12,7731.15,0.00
2024-12-10 17:22:24,172,5987,96,76,4142.62,7731.15,0.00
2024-12-10 17:22:24,171,5987,95,76,4160.95,7731.23,0.00
2024-12-10 17:22:24,171,5988,95,76,4141.64,7732.00,0.00
2024-12-10 17:22:24,172,5988,95,77,4117.56,7732.01,0.00
2024-12-10 17:22:24,173,5987,95,78,4093.76,7732.02,0.00
2024-12-10 17:22:24,174,5986,95,79,4065.85,7732.16,0.00
2024-12-10 17:22:24,175,5985,96,79,4042.20,7732.28,0.00
2024-12-10 17:22:24,176,5984,97,79,4046.22,7732.38,0.00
2024-12-10 17:22:24,177,5983,97,80,4015.20,7732.88,0.00
2024-12-10 17:22:24,177,5984,97,80,4051.84,7733.00,0.00
2024-12-10 17:22:24,178,5984,97,81,4029.08,7733.01,0.00
2024-12-10 17:22:24,179,5983,97,82,3965.04,7733.54,0.00
2024-12-10 17:22:24,180,5982,97,83,3963.79,7733.62,0.00
2024-12-10 17:22:24,180,5983,97,83,4192.14,7734.00,0.00
2024-12-10 17:22:24,181,5983,97,84,4168.97,7734.01,0.00
2024-12-10 17:22:24,182,5982,97,85,4143.11,7734.06,0.00
2024-12-10 17:22:24,181,5982,96,85,4179.01,7734.16,0.00
2024-12-10 17:22:24,180,5982,95,85,4201.79,7734.16,0.00
2024-12-10 17:22:24,181,5981,95,86,4143.72,7734.60,0.00
2024-12-10 17:22:24,182,5980,96,86,4101.59,7734.86,0.00
2024-12-10 17:22:24,182,5981,96,86,4221.79,7735.00,0.00
2024-12-10 17:22:24,183,5981,97,86,4198.72,7735.01,0.00
2024-12-10 17:22:24,182,5981,96,86,4197.65,7735.08,0.00
2024-12-10 17:22:24,181,5981,96,85,4215.74,7735.12,0.00
2024-12-10 17:22:24,180,5981,95,85,4237.02,7735.14,0.00
2024-12-10 17:22:24,179,5981,94,85,4260.26,7735.14,0.00
2024-12-10 17:22:24,179,5982,94,85,4346.82,7736.00,0.00
2024-12-10 17:22:24,180,5982,94,86,4322.67,7736.01,0.00
2024-12-10 17:22:24,179,5982,94,85,4337.77,7736.05,0.00
2024-12-10 17:22:24,180,5981,94,86,4260.11,7736.75,0.00
2024-12-10 17:22:24,180,5982,94,86,4273.60,7737.00,0.00
2024-12-10 17:22:24,181,5982,95,86,4249.98,7737.01,0.00
2024-12-10 17:22:24,180,5982,95,85,4263.34,7737.13,0.00
2024-12-10 17:22:24,179,5982,95,84,4213.67,7737.97,0.00
2024-12-10 17:22:24,179,5983,95,84,4297.98,7738.00,0.00
2024-12-10 17:22:24,180,5983,95,85,4274.10,7738.01,0.00
2024-12-10 17:22:24,180,5984,95,85,4234.78,7739.00,0.00
2024-12-10 17:22:24,181,5984,96,85,4211.39,7739.01,0.00
2024-12-10 17:22:24,180,5984,96,84,4213.08,7739.28,0.00
2024-12-10 17:22:24,181,5983,97,84,4167.65,7739.55,0.00
2024-12-10 17:22:24,181,5984,97,84,4191.92,7740.00,0.00
2024-12-10 17:22:24,182,5984,98,84,4168.89,7740.01,0.00
2024-12-10 17:22:24,181,5984,98,83,4180.86,7740.14,0.00
2024-12-10 17:22:24,180,5984,98,82,4203.66,7740.15,0.00
2024-12-10 17:22:24,181,5983,98,83,4152.71,7740.48,0.00
2024-12-10 17:22:24,181,5984,98,83,4219.66,7741.00,0.00
2024-12-10 17:22:24,182,5984,98,84,4196.47,7741.01,0.00
2024-12-10 17:22:24,181,5984,97,84,4208.60,7741.14,0.00
2024-12-10 17:22:24,180,5984,96,84,4231.55,7741.15,0.00
2024-12-10 17:22:24,179,5984,96,83,4235.33,7741.28,0.00
2024-12-10 17:22:24,179,5985,96,83,4260.67,7742.00,0.00
2024-12-10 17:22:24,180,5985,96,84,4237.00,7742.01,0.00
2024-12-10 17:22:24,180,5986,96,84,4197.15,7743.00,0.00
2024-12-10 17:22:24,181,5986,97,84,4173.96,7743.01,0.00
2024-12-10 17:22:24,181,5987,97,84,4133.39,7744.00,0.00
2024-12-10 17:22:24,182,5987,97,85,4110.68,7744.01,0.00
2024-12-10 17:22:24,181,5987,97,84,4119.05,7744.19,0.00
2024-12-10 17:22:24,181,5988,97,84,4093.74,7745.00,0.00
2024-12-10 17:22:24,182,5988,98,84,4071.25,7745.01,0.00
2024-12-10 17:22:24,181,5988,97,84,4088.12,7745.06,0.00
2024-12-10 17:22:24,180,5988,97,83,4110.40,7745.06,0.00
2024-12-10 17:22:24,179,5988,97,82,4126.91,7745.14,0.00
2024-12-10 17:22:24,178,5988,96,82,4149.66,7745.14,0.00
2024-12-10 17:22:24,179,5987,97,82,4124.75,7745.17,0.00
2024-12-10 17:22:24,178,5987,97,81,4123.23,7745.52,0.00
2024-12-10 17:22:24,178,5988,97,81,4105.71,7746.00,0.00
2024-12-10 17:22:24,179,5988,97,82,4082.78,7746.01,0.00
2024-12-10 17:22:24,178,5988,96,82,4083.77,7746.24,0.00
2024-12-10 17:22:24,177,5988,96,81,4069.95,7746.62,0.00
2024-12-10 17:22:24,177,5989,96,81,4124.80,7747.00,0.00
2024-12-10 17:22:24,178,5989,96,82,4101.62,7747.01,0.00
2024-12-10 17:22:24,177,5989,95,82,4113.47,7747.15,0.00
2024-12-10 17:22:24,176,5989,95,81,4123.58,7747.32,0.00
2024-12-10 17:22:25,176,5990,95,81,4111.59,7748.00,0.00
2024-12-10 17:22:25,177,5990,96,81,4088.37,7748.01,0.00
2024-12-10 17:22:25,176,5990,95,81,4100.64,7748.14,0.00
2024-12-10 17:22:25,175,5990,94,81,4123.63,7748.14,0.00
2024-12-10 17:22:25,174,5990,94,80,4146.88,7748.14,0.00
2024-12-10 17:22:25,174,5991,94,80,4121.99,7749.00,0.00
2024-12-10 17:22:25,175,5991,95,80,4098.43,7749.01,0.00
2024-12-10 17:22:25,176,5990,96,80,4058.49,7749.23,0.00
2024-12-10 17:22:25,177,5989,97,80,4038.20,7749.30,0.00
2024-12-10 17:22:25,178,5988,97,81,4035.18,7749.51,0.00
2024-12-10 17:22:25,178,5989,97,81,4061.66,7750.00,0.00
2024-12-10 17:22:25,179,5989,97,82,4038.97,7750.01,0.00
2024-12-10 17:22:25,178,5989,97,81,4059.49,7750.03,0.00
2024-12-10 17:22:25,178,5990,97,81,4154.67,7751.00,0.00
2024-12-10 17:22:25,179,5990,97,82,4131.46,7751.01,0.00
2024-12-10 17:22:25,180,5989,97,83,4108.51,7751.02,0.00
2024-12-10 17:22:25,179,5989,97,82,4136.68,7751.05,0.00
2024-12-10 17:22:25,178,5989,97,81,4151.68,7751.15,0.00
2024-12-10 17:22:25,177,5989,96,81,4174.86,7751.15,0.00
2024-12-10 17:22:25,178,5988,96,82,4101.20,7751.81,0.00
2024-12-10 17:22:25,178,5989,96,82,4134.93,7752.00,0.00
2024-12-10 17:22:25,179,5989,96,83,4111.83,7752.01,0.00
2024-12-10 17:22:25,179,5990,96,83,4162.81,7753.00,0.00
2024-12-10 17:22:25,180,5990,97,83,4139.68,7753.01,0.00
2024-12-10 17:22:25,179,5990,96,83,4152.90,7753.09,0.00
2024-12-10 17:22:25,178,5990,95,83,4174.33,7753.11,0.00
2024-12-10 17:22:25,177,5990,94,83,4195.30,7753.14,0.00
2024-12-10 17:22:25,176,5990,93,83,4199.42,7753.39,0.00
2024-12-10 17:22:25,176,5991,93,83,4195.00,7754.00,0.00
2024-12-10 17:22:25,177,5991,93,84,4171.30,7754.01,0.00
2024-12-10 17:22:25,178,5990,94,84,4128.35,7754.27,0.00
2024-12-10 17:22:25,178,5991,94,84,4141.64,7755.00,0.00
2024-12-10 17:22:25,179,5991,94,85,4118.50,7755.01,0.00
2024-12-10 17:22:25,178,5991,94,84,4138.61,7755.04,0.00
2024-12-10 17:22:25,177,5991,93,84,4153.27,7755.15,0.00
2024-12-10 17:22:25,176,5991,93,83,4176.43,7755.15,0.00
2024-12-10 17:22:25,177,5990,93,84,4147.59,7755.23,0.00
2024-12-10 17:22:25,176,5990,92,84,4192.48,7755.39,0.00
2024-12-10 17:22:25,176,5991,92,84,4230.11,7756.00,0.00
2024-12-10 17:22:25,177,5991,93,84,4206.21,7756.01,0.00
2024-12-10 17:22:25,176,5991,92,84,4218.71,7756.15,0.00
2024-12-10 17:22:25,176,5992,92,84,4235.97,7757.00,0.00
2024-12-10 17:22:25,177,5992,93,84,4212.04,7757.01,0.00
2024-12-10 17:22:25,176,5992,93,83,4224.57,7757.15,0.00
2024-12-10 17:22:25,177,5991,93,84,4200.26,7757.16,0.00
2024-12-10 17:22:25,177,5992,93,84,4176.71,7758.00,0.00
2024-12-10 17:22:25,178,5992,94,84,4153.25,7758.01,0.00
2024-12-10 17:22:25,177,5992,94,83,4166.25,7758.14,0.00
2024-12-10 17:22:25,178,5991,94,84,4105.37,7758.56,0.00
2024-12-10 17:22:25,179,5990,94,85,4069.45,7758.82,0.00
2024-12-10 17:22:25,179,5991,94,85,4151.53,7759.00,0.00
2024-12-10 17:22:25,180,5991,94,86,4128.46,7759.01,0.00
2024-12-10 17:22:25,180,5992,94,86,4169.55,7760.00,0.00
2024-12-10 17:22:25,181,5992,95,86,4146.51,7760.01,0.00
2024-12-10 17:22:25,180,5992,95,85,4093.92,7760.78,0.00
2024-12-10 17:22:25,180,5993,95,85,4119.98,7761.00,0.00
2024-12-10 17:22:25,181,5993,96,85,4097.22,7761.01,0.00
2024-12-10 17:22:25,180,5993,96,84,4078.22,7761.40,0.00
2024-12-10 17:22:25,180,5994,96,84,4068.16,7762.00,0.00
2024-12-10 17:22:25,181,5994,96,85,4045.68,7762.01,0.00
2024-12-10 17:22:25,181,5995,96,85,3988.18,7763.00,0.00
2024-12-10 17:22:25,182,5995,97,85,3966.27,7763.01,0.00
2024-12-10 17:22:25,181,5995,97,84,3986.90,7763.02,0.00
2024-12-10 17:22:25,182,5994,98,84,3955.57,7763.15,0.00
2024-12-10 17:22:25,181,5994,98,83,3980.98,7763.16,0.00
2024-12-10 17:22:25,180,5994,98,82,4002.67,7763.16,0.00
2024-12-10 17:22:25,179,5994,97,82,4017.48,7763.19,0.00
2024-12-10 17:22:25,180,5993,98,82,3947.60,7763.76,0.00
2024-12-10 17:22:25,181,5992,99,82,3944.38,7763.88,0.00
2024-12-10 17:22:25,181,5993,99,82,3981.11,7764.00,0.00
2024-12-10 17:22:25,182,5993,100,82,3959.24,7764.01,0.00
2024-12-10 17:22:25,181,5993,100,81,3966.34,7764.15,0.00
2024-12-10 17:22:25,180,5993,100,80,3987.95,7764.15,0.00
2024-12-10 17:22:25,180,5994,100,80,4049.06,7765.00,0.00
2024-12-10 17:22:25,181,5994,100,81,4026.69,7765.01,0.00
2024-12-10 17:22:25,180,5994,99,81,4037.60,7765.15,0.00
2024-12-10 17:22:25,179,5994,99,80,4059.73,7765.15,0.00
2024-12-10 17:22:25,178,5994,99,79,4082.10,7765.15,0.00
2024-12-10 17:22:25,177,5994,99,78,4089.66,7765.28,0.00
2024-12-10 17:22:25,176,5994,98,78,4111.93,7765.30,0.00
2024-12-10 17:22:25,175,5994,97,78,4078.81,7765.85,0.00
2024-12-10 17:22:25,175,5994,97,78,4088.73,7766.00,0.00
2024-12-10 17:22:25,176,5994,98,78,4065.50,7766.01,0.00
2024-12-10 17:22:25,175,5994,98,77,4074.44,7766.15,0.00
2024-12-10 17:22:25,174,5994,97,77,4004.44,7766.99,0.00
2024-12-10 17:22:25,174,5995,97,77,4048.19,7767.00,0.00
2024-12-10 17:22:25,175,5995,97,78,4025.06,7767.01,0.00
2024-12-10 17:22:25,175,5996,97,78,3951.99,7768.00,0.00
2024-12-10 17:22:25,176,5996,97,79,3929.53,7768.01,0.00
2024-12-10 17:22:25,177,5995,98,79,3897.41,7768.13,0.00
2024-12-10 17:22:25,178,5994,99,79,3870.41,7768.19,0.00
2024-12-10 17:22:25,177,5994,98,79,3854.08,7768.70,0.00
2024-12-10 17:22:25,177,5995,98,79,3865.55,7769.00,0.00
2024-12-10 17:22:25,178,5995,99,79,3843.83,7769.01,0.00
2024-12-10 17:22:25,177,5995,99,78,3845.56,7769.14,0.00
2024-12-10 17:22:25,176,5995,98,78,3862.24,7769.15,0.00
2024-12-10 17:22:25,175,5995,97,78,3882.72,7769.17,0.00
2024-12-10 17:22:26,174,5995,96,78,3874.24,7769.55,0.00
2024-12-10 17:22:26,174,5996,96,78,3956.41,7770.00,0.00
2024-12-10 17:22:26,175,5996,96,79,3933.80,7770.01,0.00
2024-12-10 17:22:26,174,5996,95,79,3951.26,7770.06,0.00
2024-12-10 17:22:26,173,5996,94,79,3965.12,7770.15,0.00
2024-12-10 17:22:26,172,5996,93,79,3912.40,7770.95,0.00
2024-12-10 17:22:26,172,5997,93,79,3951.21,7771.00,0.00
2024-12-10 17:22:26,173,5997,93,80,3928.37,7771.01,0.00
2024-12-10 17:22:26,172,5997,92,80,3937.66,7771.01,0.00
2024-12-10 17:22:26,171,5997,91,80,3959.78,7771.02,0.00
2024-12-10 17:22:26,170,5997,90,80,3973.26,7771.13,0.00
2024-12-10 17:22:26,170,5998,90,80,3945.07,7772.00,0.00
2024-12-10 17:22:26,171,5998,90,81,3922.00,7772.01,0.00
2024-12-10 17:22:26,170,5998,89,81,3934.16,7772.14,0.00
2024-12-10 17:22:26,169,5998,89,80,3918.29,7772.60,0.00
2024-12-10 17:22:26,169,5999,89,80,3928.74,7773.00,0.00
2024-12-10 17:22:26,170,5999,89,81,3905.63,7773.01,0.00
2024-12-10 17:22:26,169,5999,88,81,3922.46,7773.08,0.00
2024-12-10 17:22:26,168,5999,88,80,3941.21,7773.14,0.00
2024-12-10 17:22:26,169,5998,88,81,3857.23,7773.90,0.00
2024-12-10 17:22:26,169,5999,88,81,3899.92,7774.00,0.00
2024-12-10 17:22:26,170,5999,88,82,3876.98,7774.01,0.00
2024-12-10 17:22:26,169,5999,88,81,3889.39,7774.14,0.00
2024-12-10 17:22:26,169,6000,88,81,3909.09,7775.00,0.00
2024-12-10 17:22:26,170,6000,89,81,3886.09,7775.01,0.00
2024-12-10 17:22:26,169,6000,89,80,3898.55,7775.14,0.00
2024-12-10 17:22:26,170,5999,89,81,3850.55,7775.47,0.00
2024-12-10 17:22:26,170,6000,89,81,3876.17,7776.00,0.00
2024-12-10 17:22:26,171,6000,90,81,3853.50,7776.01,0.00
2024-12-10 17:22:26,170,6000,90,80,3869.79,7776.08,0.00
2024-12-10 17:22:26,171,5999,91,80,3843.99,7776.13,0.00
2024-12-10 17:22:26,170,5999,90,80,3869.36,7776.14,0.00
2024-12-10 17:22:26,170,6000,90,80,3888.18,7777.00,0.00
2024-12-10 17:22:26,171,6000,90,81,3865.44,7777.01,0.00
2024-12-10 17:22:26,170,6000,90,80,3885.90,7777.03,0.00
2024-12-10 17:22:26,169,6000,89,80,3901.11,7777.12,0.00
2024-12-10 17:22:26,168,6000,89,79,3923.87,7777.13,0.00
2024-12-10 17:22:26,168,6001,89,79,3942.16,7778.00,0.00
2024-12-10 17:22:26,169,6001,89,80,3918.83,7778.01,0.00
2024-12-10 17:22:26,168,6001,88,80,3932.48,7778.13,0.00
2024-12-10 17:22:26,169,6000,89,80,3909.21,7778.14,0.00
2024-12-10 17:22:26,169,6001,89,80,3924.96,7779.00,0.00
2024-12-10 17:22:26,170,6001,89,81,3901.87,7779.01,0.00
2024-12-10 17:22:26,169,6001,89,80,3924.05,7779.01,0.00
2024-12-10 17:22:26,168,6001,88,80,3931.21,7779.13,0.00
2024-12-10 17:22:26,168,6002,88,80,3948.96,7780.00,0.00
2024-12-10 17:22:26,169,6002,88,81,3925.60,7780.01,0.00
2024-12-10 17:22:26,168,6002,88,80,3947.58,7780.02,0.00
2024-12-10 17:22:26,167,6002,87,80,3969.36,7780.04,0.00
2024-12-10 17:22:26,166,6002,86,80,3973.99,7780.11,0.00
2024-12-10 17:22:26,165,6002,85,80,3997.73,7780.12,0.00
2024-12-10 17:22:26,164,6002,84,80,4021.63,7780.12,0.00
2024-12-10 17:22:26,163,6002,83,80,4045.83,7780.12,0.00
2024-12-10 17:22:26,162,6002,82,80,4022.31,7780.72,0.00
2024-12-10 17:22:26,162,6003,82,80,4043.52,7781.00,0.00
2024-12-10 17:22:26,163,6003,83,80,4018.71,7781.01,0.00
2024-12-10 17:22:26,164,6002,83,81,3913.24,7781.82,0.00
2024-12-10 17:22:26,164,6003,83,81,3951.88,7782.00,0.00
2024-12-10 17:22:26,165,6003,84,81,3927.93,7782.01,0.00
2024-12-10 17:22:26,164,6003,83,81,3945.26,7782.09,0.00
2024-12-10 17:22:26,163,6003,83,80,3962.52,7782.10,0.00
2024-12-10 17:22:26,162,6003,82,80,3985.54,7782.12,0.00
2024-12-10 17:22:26,161,6003,82,79,4009.82,7782.12,0.00
2024-12-10 17:22:26,161,6004,82,79,4031.11,7783.00,0.00
2024-12-10 17:22:26,162,6004,82,80,4006.23,7783.01,0.00
2024-12-10 17:22:26,163,6003,82,81,3977.84,7783.07,0.00
2024-12-10 17:22:26,163,6004,82,81,3979.44,7784.00,0.00
2024-12-10 17:22:26,164,6004,82,82,3955.17,7784.01,0.00
2024-12-10 17:22:26,163,6004,81,82,3969.57,7784.12,0.00
2024-12-10 17:22:26,163,6005,81,82,3989.30,7785.00,0.00
2024-12-10 17:22:26,164,6005,81,83,3964.97,7785.01,0.00
2024-12-10 17:22:26,163,6005,80,83,3886.71,7785.95,0.00
2024-12-10 17:22:26,163,6006,80,83,3930.69,7786.00,0.00
2024-12-10 17:22:26,164,6006,81,83,3906.73,7786.01,0.00
2024-12-10 17:22:26,165,6005,82,83,3858.57,7786.33,0.00
2024-12-10 17:22:26,166,6004,82,84,3791.01,7786.97,0.00
2024-12-10 17:22:26,166,6005,82,84,3837.48,7787.00,0.00
2024-12-10 17:22:26,167,6005,82,85,3814.51,7787.01,0.00
2024-12-10 17:22:26,166,6005,82,84,3828.43,7787.11,0.00
2024-12-10 17:22:26,167,6004,82,85,3786.25,7787.37,0.00
2024-12-10 17:22:26,167,6005,82,85,3901.81,7788.00,0.00
2024-12-10 17:22:26,168,6005,82,86,3878.59,7788.01,0.00
2024-12-10 17:22:26,167,6005,81,86,3892.48,7788.11,0.00
2024-12-10 17:22:26,167,6006,81,86,3910.60,7789.00,0.00
2024-12-10 17:22:26,168,6006,81,87,3887.33,7789.01,0.00
2024-12-10 17:22:26,167,6006,81,86,3901.19,7789.11,0.00
2024-12-10 17:22:26,166,6006,81,85,3892.12,7789.52,0.00
2024-12-10 17:22:26,166,6007,81,85,3897.55,7790.00,0.00
2024-12-10 17:22:26,167,6007,81,86,3874.21,7790.01,0.00
2024-12-10 17:22:26,166,6007,80,86,3888.05,7790.11,0.00
2024-12-10 17:22:26,165,6007,79,86,3907.75,7790.16,0.00
2024-12-10 17:22:26,165,6008,79,86,3883.96,7791.00,0.00
2024-12-10 17:22:26,166,6008,80,86,3860.56,7791.01,0.00
2024-12-10 17:22:26,167,6007,81,86,3831.41,7791.10,0.00
2024-12-10 17:22:26,167,6008,81,86,3829.83,7792.00,0.00
2024-12-10 17:22:26,168,6008,81,87,3807.04,7792.01,0.00
2024-12-10 17:22:26,167,6008,80,87,3816.84,7792.13,0.00
2024-12-10 17:22:27,166,6008,79,87,3783.02,7792.77,0.00
2024-12-10 17:22:27,166,6009,79,87,3857.61,7793.00,0.00
2024-12-10 17:22:27,167,6009,79,88,3834.51,7793.01,0.00
2024-12-10 17:22:27,166,6009,79,87,3846.24,7793.08,0.00
2024-12-10 17:22:27,165,6009,78,87,3865.35,7793.12,0.00
2024-12-10 17:22:27,165,6010,78,87,3834.30,7794.00,0.00
2024-12-10 17:22:27,166,6010,78,88,3811.20,7794.01,0.00
2024-12-10 17:22:27,165,6010,77,88,3832.89,7794.02,0.00
2024-12-10 17:22:27,164,6010,77,87,3842.32,7794.12,0.00
2024-12-10 17:22:27,163,6010,76,87,3865.42,7794.12,0.00
2024-12-10 17:22:27,164,6009,76,88,3819.10,7794.42,0.00
2024-12-10 17:22:27,165,6008,77,88,3807.87,7794.59,0.00
2024-12-10 17:22:27,165,6009,77,88,3842.74,7795.00,0.00
2024-12-10 17:22:27,166,6009,78,88,3819.59,7795.01,0.00
2024-12-10 17:22:27,165,6009,77,88,3831.03,7795.12,0.00
2024-12-10 17:22:27,165,6010,77,88,3895.56,7796.00,0.00
2024-12-10 17:22:27,166,6010,77,89,3872.10,7796.01,0.00
2024-12-10 17:22:27,165,6010,77,88,3886.17,7796.12,0.00
2024-12-10 17:22:27,164,6010,77,87,3909.40,7796.12,0.00
2024-12-10 17:22:27,164,6011,77,87,3879.11,7797.00,0.00
2024-12-10 17:22:27,165,6011,78,87,3855.60,7797.01,0.00
2024-12-10 17:22:27,165,6012,78,87,3814.86,7798.00,0.00
2024-12-10 17:22:27,166,6012,78,88,3791.88,7798.01,0.00
2024-12-10 17:22:27,165,6012,77,88,3804.80,7798.12,0.00
2024-12-10 17:22:27,164,6012,76,88,3827.53,7798.12,0.00
2024-12-10 17:22:27,164,6013,76,88,3794.96,7799.00,0.00
2024-12-10 17:22:27,165,6013,76,89,3771.96,7799.01,0.00
2024-12-10 17:22:27,164,6013,75,89,3784.63,7799.12,0.00
2024-12-10 17:22:27,163,6013,74,89,3807.37,7799.12,0.00
2024-12-10 17:22:27,162,6013,74,88,3830.39,7799.12,0.00
2024-12-10 17:22:27,161,6013,74,87,3853.69,7799.12,0.00
2024-12-10 17:22:27,160,6013,73,87,3845.73,7799.47,0.00
2024-12-10 17:22:27,160,6014,73,87,3844.58,7800.00,0.00
2024-12-10 17:22:27,161,6014,73,88,3820.70,7800.01,0.00
2024-12-10 17:22:27,160,6014,73,87,3830.82,7800.12,0.00
2024-12-10 17:22:27,159,6014,72,87,3820.77,7800.51,0.00
2024-12-10 17:22:27,159,6015,72,87,3824.96,7801.00,0.00
2024-12-10 17:22:27,160,6015,73,87,3801.05,7801.01,0.00
2024-12-10 17:22:27,161,6014,73,88,3773.04,7801.06,0.00
2024-12-10 17:22:27,160,6014,72,88,3818.04,7801.13,0.00
2024-12-10 17:22:27,161,6013,73,88,3788.52,7801.21,0.00
2024-12-10 17:22:27,161,6014,73,88,3772.25,7802.00,0.00
2024-12-10 17:22:27,162,6014,74,88,3748.96,7802.01,0.00
2024-12-10 17:22:27,161,6014,73,88,3771.15,7802.02,0.00
2024-12-10 17:22:27,162,6013,74,88,3739.42,7802.09,0.00
2024-12-10 17:22:27,161,6013,74,87,3784.95,7802.12,0.00
2024-12-10 17:22:27,160,6013,74,86,3783.55,7802.41,0.00
2024-12-10 17:22:27,159,6013,73,86,3779.74,7802.67,0.00
2024-12-10 17:22:27,159,6014,73,86,3894.33,7803.00,0.00
2024-12-10 17:22:27,160,6014,73,87,3869.99,7803.01,0.00
2024-12-10 17:22:27,159,6014,72,87,3884.33,7803.11,0.00
2024-12-10 17:22:27,158,6014,72,86,3885.47,7803.40,0.00
2024-12-10 17:22:27,158,6015,72,86,3909.81,7804.00,0.00
2024-12-10 17:22:27,159,6015,72,87,3885.22,7804.01,0.00
2024-12-10 17:22:27,158,6015,72,86,3908.33,7804.02,0.00
2024-12-10 17:22:27,157,6015,71,86,3925.81,7804.11,0.00
2024-12-10 17:22:27,156,6015,70,86,3904.62,7804.65,0.00
2024-12-10 17:22:27,155,6015,70,85,3896.23,7804.85,0.00
2024-12-10 17:22:27,155,6016,70,85,3933.02,7805.00,0.00
2024-12-10 17:22:27,156,6016,71,85,3907.81,7805.01,0.00
2024-12-10 17:22:27,155,6016,70,85,3931.51,7805.02,0.00
2024-12-10 17:22:27,156,6015,70,86,3904.82,7805.05,0.00
2024-12-10 17:22:27,157,6014,71,86,3907.31,7805.09,0.00
2024-12-10 17:22:27,156,6014,71,85,3943.88,7805.12,0.00
2024-12-10 17:22:27,155,6014,70,85,3968.82,7805.12,0.00
2024-12-10 17:22:27,156,6013,70,86,3936.89,7805.21,0.00
2024-12-10 17:22:27,155,6013,70,85,3954.69,7805.49,0.00
2024-12-10 17:22:27,155,6014,70,85,3965.14,7806.00,0.00
2024-12-10 17:22:27,156,6014,71,85,3939.72,7806.01,0.00
2024-12-10 17:22:27,155,6014,71,84,3957.13,7806.10,0.00
2024-12-10 17:22:27,156,6013,72,84,3931.26,7806.12,0.00
2024-12-10 17:22:27,156,6014,72,84,4100.63,7807.00,0.00
2024-12-10 17:22:27,157,6014,72,85,4074.51,7807.01,0.00
2024-12-10 17:22:27,156,6014,71,85,4092.42,7807.10,0.00
2024-12-10 17:22:27,156,6015,71,85,4120.65,7808.00,0.00
2024-12-10 17:22:27,157,6015,72,85,4094.40,7808.01,0.00
2024-12-10 17:22:27,156,6015,71,85,4084.71,7808.37,0.00
2024-12-10 17:22:27,155,6015,71,84,4096.99,7808.56,0.00
2024-12-10 17:22:27,155,6016,71,84,4112.19,7809.00,0.00
2024-12-10 17:22:27,156,6016,72,84,4085.83,7809.01,0.00
2024-12-10 17:22:27,155,6016,71,84,4109.06,7809.03,0.00
2024-12-10 17:22:27,154,6016,71,83,4122.09,7809.16,0.00
2024-12-10 17:22:27,154,6017,71,83,4105.74,7810.00,0.00
2024-12-10 17:22:27,155,6017,72,83,4079.25,7810.01,0.00
2024-12-10 17:22:27,154,6017,71,83,4097.73,7810.09,0.00
2024-12-10 17:22:27,153,6017,70,83,4122.99,7810.10,0.00
2024-12-10 17:22:27,153,6018,70,83,4101.92,7811.00,0.00
2024-12-10 17:22:27,154,6018,71,83,4075.29,7811.01,0.00
2024-12-10 17:22:27,153,6018,71,82,4100.52,7811.02,0.00
2024-12-10 17:22:27,152,6018,70,82,4120.24,7811.11,0.00
2024-12-10 17:22:27,153,6017,71,82,4033.77,7811.86,0.00
2024-12-10 17:22:27,153,6018,71,82,4081.38,7812.00,0.00
2024-12-10 17:22:27,154,6018,71,83,4054.88,7812.01,0.00
2024-12-10 17:22:27,155,6017,72,83,4025.22,7812.06,0.00
2024-12-10 17:22:27,154,6017,72,82,4051.09,7812.12,0.00
2024-12-10 17:22:27,154,6018,72,82,4081.41,7813.00,0.00
2024-12-10 17:22:27,155,6018,73,82,4055.08,7813.01,0.00
2024-12-10 17:22:27,154,6018,73,81,4072.18,7813.11,0.00
2024-12-10 17:22:27,153,6018,73,80,4098.28,7813.11,0.00
2024-12-10 17:22:27,153,6019,73,80,4126.42,7814.00,0.00
2024-12-10 17:22:27,154,6019,73,81,4099.62,7814.01,0.00
2024-12-10 17:22:27,153,6019,72,81,4116.92,7814.11,0.00
2024-12-10 17:22:27,154,6018,72,82,4084.62,7814.20,0.00
2024-12-10 17:22:28,154,6019,72,82,4114.56,7815.00,0.00
2024-12-10 17:22:28,155,6019,73,82,4088.01,7815.01,0.00
2024-12-10 17:22:28,154,6019,73,81,4113.55,7815.01,0.00
2024-12-10 17:22:28,154,6020,73,81,4134.47,7816.00,0.00
2024-12-10 17:22:28,155,6020,74,81,4107.79,7816.01,0.00
2024-12-10 17:22:28,154,6020,73,81,4127.12,7816.08,0.00
2024-12-10 17:22:28,153,6020,73,80,4150.90,7816.11,0.00
2024-12-10 17:22:28,154,6019,74,80,4101.95,7816.39,0.00
2024-12-10 17:22:28,155,6018,74,81,4101.58,7816.50,0.00
2024-12-10 17:22:28,156,6017,75,81,4055.59,7816.94,0.00
2024-12-10 17:22:28,156,6018,75,81,4104.06,7817.00,0.00
2024-12-10 17:22:28,157,6018,75,82,4077.92,7817.01,0.00
2024-12-10 17:22:28,157,6019,75,82,4192.93,7818.00,0.00
2024-12-10 17:22:28,158,6019,75,83,4166.39,7818.01,0.00
2024-12-10 17:22:28,157,6019,74,83,4182.81,7818.12,0.00
2024-12-10 17:22:28,156,6019,73,83,4209.12,7818.12,0.00
2024-12-10 17:22:28,155,6019,72,83,4232.13,7818.16,0.00
2024-12-10 17:22:28,155,6019,72,83,4212.61,7819.00,0.00
2024-12-10 17:22:28,156,6019,73,83,4185.61,7819.01,0.00
2024-12-10 17:22:28,155,6019,73,82,4202.28,7819.12,0.00
2024-12-10 17:22:28,156,6018,73,83,4129.22,7819.68,0.00
2024-12-10 17:22:28,156,6019,73,83,4163.66,7820.00,0.00
2024-12-10 17:22:28,157,6019,74,83,4137.14,7820.01,0.00
2024-12-10 17:22:28,156,6019,73,83,4153.17,7820.12,0.00
2024-12-10 17:22:28,156,6020,73,83,4166.66,7821.00,0.00
2024-12-10 17:22:28,157,6020,74,83,4140.12,7821.01,0.00
2024-12-10 17:22:28,156,6020,73,83,4161.17,7821.06,0.00
2024-12-10 17:22:28,156,6020,73,83,4117.69,7822.00,0.00
2024-12-10 17:22:28,157,6020,74,83,4091.46,7822.01,0.00
2024-12-10 17:22:28,156,6020,74,82,4106.69,7822.12,0.00
2024-12-10 17:22:28,156,6021,74,82,4066.69,7823.00,0.00
2024-12-10 17:22:28,157,6021,75,82,4040.78,7823.01,0.00
2024-12-10 17:22:28,156,6021,75,81,4054.86,7823.12,0.00
2024-12-10 17:22:28,155,6021,74,81,4029.68,7823.61,0.00
2024-12-10 17:22:28,155,6022,74,81,4042.66,7824.00,0.00
2024-12-10 17:22:28,156,6022,74,82,4016.74,7824.01,0.00
2024-12-10 17:22:28,155,6022,73,82,4034.74,7824.08,0.00
2024-12-10 17:22:28,154,6022,72,82,4049.23,7824.12,0.00
2024-12-10 17:22:28,155,6021,73,82,4014.72,7824.23,0.00
2024-12-10 17:22:28,155,6022,73,82,4041.74,7825.00,0.00
2024-12-10 17:22:28,156,6022,73,83,4015.83,7825.01,0.00
2024-12-10 17:22:28,155,6022,73,82,4039.73,7825.03,0.00
2024-12-10 17:22:28,154,6022,73,81,4047.41,7825.11,0.00
2024-12-10 17:22:28,155,6021,74,81,3982.22,7825.60,0.00
2024-12-10 17:22:28,155,6022,74,81,4064.88,7826.00,0.00
2024-12-10 17:22:28,156,6022,74,82,4038.82,7826.01,0.00
2024-12-10 17:22:28,155,6022,73,82,4043.48,7826.11,0.00
2024-12-10 17:22:28,154,6022,72,82,4069.23,7826.11,0.00
2024-12-10 17:22:28,154,6023,72,82,4082.04,7827.00,0.00
2024-12-10 17:22:28,155,6023,73,82,4055.70,7827.01,0.00
2024-12-10 17:22:28,154,6023,72,82,4066.23,7827.10,0.00
2024-12-10 17:22:28,153,6023,71,82,4090.48,7827.10,0.00
2024-12-10 17:22:28,152,6023,70,82,4116.88,7827.10,0.00
2024-12-10 17:22:28,151,6023,70,81,4143.63,7827.10,0.00
2024-12-10 17:22:28,150,6023,70,80,4144.08,7827.28,0.00
2024-12-10 17:22:28,151,6022,70,81,4081.90,7827.64,0.00
2024-12-10 17:22:28,150,6022,70,80,4101.26,7827.88,0.00
2024-12-10 17:22:28,150,6023,70,80,4140.77,7828.00,0.00
2024-12-10 17:22:28,151,6023,71,80,4113.35,7828.01,0.00
2024-12-10 17:22:28,150,6023,70,80,4119.25,7828.13,0.00
2024-12-10 17:22:28,150,6024,70,80,4142.15,7829.00,0.00
2024-12-10 17:22:28,151,6024,70,81,4114.71,7829.01,0.00
2024-12-10 17:22:28,150,6024,69,81,4134.01,7829.03,0.00
2024-12-10 17:22:28,149,6024,68,81,4155.75,7829.10,0.00
2024-12-10 17:22:28,148,6024,68,80,4183.30,7829.10,0.00
2024-12-10 17:22:28,148,6025,68,80,4151.20,7830.00,0.00
2024-12-10 17:22:28,149,6025,69,80,4123.34,7830.01,0.00
2024-12-10 17:22:28,148,6025,68,80,4143.05,7830.10,0.00
2024-12-10 17:22:28,147,6025,68,79,4168.47,7830.14,0.00
2024-12-10 17:22:28,147,6026,68,79,4138.41,7831.00,0.00
2024-12-10 17:22:28,148,6026,68,80,4110.45,7831.01,0.00
2024-12-10 17:22:28,147,6026,68,79,4114.96,7831.30,0.00
2024-12-10 17:22:28,147,6027,68,79,4092.56,7832.00,0.00
2024-12-10 17:22:28,148,6027,69,79,4064.90,7832.01,0.00
2024-12-10 17:22:28,147,6027,68,79,4085.46,7832.09,0.00
2024-12-10 17:22:28,146,6027,68,78,4111.84,7832.10,0.00
2024-12-10 17:22:28,145,6027,68,77,4139.66,7832.10,0.00
2024-12-10 17:22:28,144,6027,67,77,4167.86,7832.10,0.00
2024-12-10 17:22:28,143,6027,67,76,4196.46,7832.11,0.00
2024-12-10 17:22:28,142,6027,67,75,4171.31,7832.61,0.00
2024-12-10 17:22:28,142,6028,67,75,4183.66,7833.00,0.00
2024-12-10 17:22:28,143,6028,67,76,4154.40,7833.01,0.00
2024-12-10 17:22:28,142,6028,66,76,4132.45,7833.54,0.00
2024-12-10 17:22:28,142,6029,66,76,4130.24,7834.00,0.00
2024-12-10 17:22:28,143,6029,67,76,4101.36,7834.01,0.00
2024-12-10 17:22:28,144,6028,67,77,4017.09,7834.59,0.00
2024-12-10 17:22:28,143,6028,66,77,4018.73,7834.94,0.00
2024-12-10 17:22:28,143,6029,66,77,4068.64,7835.00,0.00
2024-12-10 17:22:28,144,6029,67,77,4040.39,7835.01,0.00
2024-12-10 17:22:28,145,6028,68,77,3990.98,7835.30,0.00
2024-12-10 17:22:28,144,6028,67,77,3995.87,7835.74,0.00
2024-12-10 17:22:28,145,6027,67,78,3948.86,7835.95,0.00
2024-12-10 17:22:28,145,6028,67,78,4056.45,7836.00,0.00
2024-12-10 17:22:28,146,6028,68,78,4028.67,7836.01,0.00
2024-12-10 17:22:28,145,6028,68,77,4047.85,7836.11,0.00
2024-12-10 17:22:28,144,6028,68,76,4041.30,7836.49,0.00
2024-12-10 17:22:28,145,6027,69,76,4009.13,7836.56,0.00
2024-12-10 17:22:29,145,6028,69,76,4142.65,7837.00,0.00
2024-12-10 17:22:29,146,6028,70,76,4114.27,7837.01,0.00
2024-12-10 17:22:29,146,6029,70,76,4113.31,7838.00,0.00
2024-12-10 17:22:29,147,6029,70,77,4085.33,7838.01,0.00
2024-12-10 17:22:29,148,6028,70,78,4057.73,7838.02,0.00
2024-12-10 17:22:29,147,6028,70,77,4122.71,7838.12,0.00
2024-12-10 17:22:29,147,6029,70,77,4073.88,7839.00,0.00
2024-12-10 17:22:29,148,6029,71,77,4046.36,7839.01,0.00
2024-12-10 17:22:29,147,6029,70,77,4069.22,7839.05,0.00
2024-12-10 17:22:29,146,6029,69,77,4092.28,7839.11,0.00
2024-12-10 17:22:29,145,6029,68,77,4119.97,7839.11,0.00
2024-12-10 17:22:29,146,6028,68,78,4088.53,7839.17,0.00
2024-12-10 17:22:29,146,6029,68,78,4118.52,7840.00,0.00
2024-12-10 17:22:29,147,6029,68,79,4090.51,7840.01,0.00
2024-12-10 17:22:29,146,6029,67,79,4113.02,7840.05,0.00
2024-12-10 17:22:29,145,6029,66,79,4136.55,7840.10,0.00
2024-12-10 17:22:29,144,6029,66,78,4164.73,7840.10,0.00
2024-12-10 17:22:29,144,6030,66,78,4164.79,7841.00,0.00
2024-12-10 17:22:29,145,6030,67,78,4136.07,7841.01,0.00
2024-12-10 17:22:29,144,6030,67,77,4152.60,7841.10,0.00
2024-12-10 17:22:29,143,6030,67,76,4136.24,7841.50,0.00
2024-12-10 17:22:29,143,6031,67,76,4118.72,7842.00,0.00
2024-12-10 17:22:29,144,6031,67,77,4090.12,7842.01,0.00
2024-12-10 17:22:29,143,6031,67,76,4103.61,7842.11,0.00
2024-12-10 17:22:29,144,6030,68,76,4031.88,7842.54,0.00
2024-12-10 17:22:29,144,6031,68,76,4036.50,7843.00,0.00
2024-12-10 17:22:29,145,6031,69,76,4008.67,7843.01,0.00
2024-12-10 17:22:29,144,6031,69,75,4010.45,7843.19,0.00
2024-12-10 17:22:29,143,6031,69,74,4037.68,7843.20,0.00
2024-12-10 17:22:29,144,6030,69,75,3948.37,7843.72,0.00
2024-12-10 17:22:29,144,6031,69,75,4005.13,7844.00,0.00
2024-12-10 17:22:29,145,6031,70,75,3977.50,7844.01,0.00
2024-12-10 17:22:29,144,6031,70,74,3982.77,7844.10,0.00
2024-12-10 17:22:29,143,6031,70,73,4006.04,7844.15,0.00
2024-12-10 17:22:29,142,6031,69,73,3919.92,7844.92,0.00
2024-12-10 17:22:29,142,6032,69,73,3989.20,7845.00,0.00
2024-12-10 17:22:29,143,6032,70,73,3961.31,7845.01,0.00
2024-12-10 17:22:29,142,6032,70,72,3972.57,7845.01,0.00
2024-12-10 17:22:29,141,6032,69,72,3991.59,7845.10,0.00
2024-12-10 17:22:29,140,6032,69,71,3960.55,7845.58,0.00
2024-12-10 17:22:29,139,6032,68,71,3945.67,7845.78,0.00
2024-12-10 17:22:29,139,6033,68,71,3917.51,7846.00,0.00
2024-12-10 17:22:29,140,6033,68,72,3889.53,7846.01,0.00
2024-12-10 17:22:29,139,6033,68,71,3869.21,7846.43,0.00
2024-12-10 17:22:29,138,6033,67,71,3874.63,7846.64,0.00
2024-12-10 17:22:29,138,6034,67,71,3789.75,7847.00,0.00
2024-12-10 17:22:29,139,6034,67,72,3762.48,7847.01,0.00
2024-12-10 17:22:29,138,6034,67,71,3779.01,7847.11,0.00
2024-12-10 17:22:29,137,6034,67,70,3803.65,7847.15,0.00
2024-12-10 17:22:29,138,6033,68,70,3769.29,7847.25,0.00
2024-12-10 17:22:29,137,6033,67,70,3816.73,7847.42,0.00
2024-12-10 17:22:29,136,6033,66,70,3760.68,7847.90,0.00
2024-12-10 17:22:29,135,6033,65,70,3740.12,7847.97,0.00
2024-12-10 17:22:29,135,6034,65,70,3767.43,7848.00,0.00
2024-12-10 17:22:29,136,6034,65,71,3739.72,7848.01,0.00
2024-12-10 17:22:29,137,6033,66,71,3697.32,7848.18,0.00
2024-12-10 17:22:29,136,6033,65,71,3720.52,7848.28,0.00
2024-12-10 17:22:29,135,6033,65,70,3695.01,7848.72,0.00
2024-12-10 17:22:29,134,6033,64,70,3698.37,7848.76,0.00
2024-12-10 17:22:29,133,6033,63,70,3695.21,7848.94,0.00
2024-12-10 17:22:29,132,6033,63,69,3715.89,7848.95,0.00
2024-12-10 17:22:29,131,6033,62,69,3729.08,7848.97,0.00
2024-12-10 17:22:29,131,6034,62,69,3833.56,7849.00,0.00
2024-12-10 17:22:29,132,6034,62,70,3804.52,7849.01,0.00
2024-12-10 17:22:29,131,6034,61,70,3821.05,7849.12,0.00
2024-12-10 17:22:29,130,6034,60,70,3777.15,7849.76,0.00
2024-12-10 17:22:29,130,6035,60,70,3851.93,7850.00,0.00
2024-12-10 17:22:29,131,6035,60,71,3822.53,7850.01,0.00
2024-12-10 17:22:29,130,6035,60,70,3839.38,7850.12,0.00
2024-12-10 17:22:29,131,6034,60,71,3776.20,7850.54,0.00
2024-12-10 17:22:29,130,6034,59,71,3764.24,7850.95,0.00
2024-12-10 17:22:29,130,6035,59,71,3821.04,7851.00,0.00
2024-12-10 17:22:29,131,6035,60,71,3791.88,7851.01,0.00
2024-12-10 17:22:29,130,6035,60,70,3811.56,7851.08,0.00
2024-12-10 17:22:29,129,6035,60,69,3838.08,7851.12,0.00
2024-12-10 17:22:29,128,6035,60,68,3867.45,7851.12,0.00
2024-12-10 17:22:29,127,6035,60,67,3891.20,7851.20,0.00
2024-12-10 17:22:29,126,6035,59,67,3871.63,7851.72,0.00
2024-12-10 17:22:29,126,6036,59,67,3949.72,7852.00,0.00
2024-12-10 17:22:29,127,6036,59,68,3918.62,7852.01,0.00
2024-12-10 17:22:29,126,6036,58,68,3946.78,7852.03,0.00
2024-12-10 17:22:29,127,6035,58,69,3910.17,7852.12,0.00
2024-12-10 17:22:29,128,6034,59,69,3865.14,7852.56,0.00
2024-12-10 17:22:29,127,6034,59,68,3901.49,7852.76,0.00
2024-12-10 17:22:29,127,6035,59,68,3923.86,7853.00,0.00
2024-12-10 17:22:29,128,6035,60,68,3893.21,7853.01,0.00
2024-12-10 17:22:29,127,6035,59,68,3915.26,7853.11,0.00
2024-12-10 17:22:29,128,6034,59,69,3849.94,7853.54,0.00
2024-12-10 17:22:29,128,6035,59,69,3992.80,7854.00,0.00
2024-12-10 17:22:29,129,6035,59,70,3961.85,7854.01,0.00
2024-12-10 17:22:29,128,6035,58,70,3984.26,7854.11,0.00
2024-12-10 17:22:29,127,6035,57,70,3963.26,7854.63,0.00
2024-12-10 17:22:29,126,6035,56,70,3976.66,7854.75,0.00
2024-12-10 17:22:29,125,6035,55,70,3990.31,7854.86,0.00
2024-12-10 17:22:29,125,6036,55,70,4103.09,7855.00,0.00
2024-12-10 17:22:29,126,6036,56,70,4070.53,7855.01,0.00
2024-12-10 17:22:29,125,6036,55,70,4094.76,7855.11,0.00
2024-12-10 17:22:29,124,6036,55,69,4102.28,7855.42,0.00
2024-12-10 17:22:29,124,6037,55,69,4102.90,7856.00,0.00
2024-12-10 17:22:29,125,6037,56,69,4070.08,7856.01,0.00
2024-12-10 17:22:29,125,6038,56,69,4022.70,7857.00,0.00
2024-12-10 17:22:29,126,6038,57,69,3990.77,7857.01,0.00
2024-12-10 17:22:29,126,6039,57,69,3933.23,7858.00,0.00
2024-12-10 17:22:29,127,6039,57,70,3902.26,7858.01,0.00
2024-12-10 17:22:29,126,6039,57,69,3926.40,7858.09,0.00
2024-12-10 17:22:29,125,6039,56,69,3955.31,7858.11,0.00
2024-12-10 17:22:29,126,6038,56,70,3901.97,7858.41,0.00
2024-12-10 17:22:29,125,6038,55,70,3960.44,7858.59,0.00
2024-12-10 17:22:29,125,6039,55,70,3963.44,7859.00,0.00
2024-12-10 17:22:29,126,6039,55,71,3931.98,7859.01,0.00
2024-12-10 17:22:29,125,6039,55,70,3953.43,7859.13,0.00
2024-12-10 17:22:29,124,6039,54,70,3952.31,7859.41,0.00
2024-12-10 17:22:29,124,6040,54,70,3993.39,7860.00,0.00
2024-12-10 17:22:29,125,6040,54,71,3961.44,7860.01,0.00
2024-12-10 17:22:29,124,6040,53,71,3983.30,7860.13,0.00
2024-12-10 17:22:29,123,6040,53,70,3991.34,7860.39,0.00
2024-12-10 17:22:29,122,6040,52,70,3981.41,7860.72,0.00
2024-12-10 17:22:30,121,6040,51,70,4007.24,7860.74,0.00
2024-12-10 17:22:30,121,6041,51,70,4042.19,7861.00,0.00
2024-12-10 17:22:30,122,6041,52,70,4009.05,7861.01,0.00
2024-12-10 17:22:30,121,6041,51,70,4031.33,7861.13,0.00
2024-12-10 17:22:30,121,6042,51,70,4001.18,7862.00,0.00
2024-12-10 17:22:30,122,6042,52,70,3968.38,7862.01,0.00
2024-12-10 17:22:30,121,6042,51,70,3940.34,7862.59,0.00
2024-12-10 17:22:30,121,6043,51,70,3958.78,7863.00,0.00
2024-12-10 17:22:30,122,6043,52,70,3926.33,7863.01,0.00
2024-12-10 17:22:30,121,6043,51,70,3874.22,7863.90,0.00
2024-12-10 17:22:30,121,6044,51,70,3929.44,7864.00,0.00
2024-12-10 17:22:30,122,6044,52,70,3897.23,7864.01,0.00
2024-12-10 17:22:30,123,6043,53,70,3800.64,7864.72,0.00
2024-12-10 17:22:30,123,6044,53,70,3859.23,7865.00,0.00
2024-12-10 17:22:30,124,6044,54,70,3828.10,7865.01,0.00
2024-12-10 17:22:30,123,6044,54,69,3849.05,7865.13,0.00
2024-12-10 17:22:30,122,6044,54,68,3875.36,7865.20,0.00
2024-12-10 17:22:30,122,6045,54,68,3926.09,7866.00,0.00
2024-12-10 17:22:30,123,6045,55,68,3894.17,7866.01,0.00
2024-12-10 17:22:30,122,6045,55,67,3882.52,7866.46,0.00
2024-12-10 17:22:30,122,6046,55,67,3899.06,7867.00,0.00
2024-12-10 17:22:30,123,6046,55,68,3867.36,7867.01,0.00
2024-12-10 17:22:30,122,6046,55,67,3888.15,7867.14,0.00
2024-12-10 17:22:30,121,6046,54,67,3893.56,7867.43,0.00
2024-12-10 17:22:30,121,6047,54,67,3906.89,7868.00,0.00
2024-12-10 17:22:30,122,6047,55,67,3874.87,7868.01,0.00
2024-12-10 17:22:30,121,6047,55,66,3904.94,7868.03,0.00
2024-12-10 17:22:30,120,6047,55,65,3928.35,7868.13,0.00
2024-12-10 17:22:30,119,6047,54,65,3960.70,7868.13,0.00
2024-12-10 17:22:30,118,6047,53,65,3993.60,7868.14,0.00
2024-12-10 17:22:30,117,6047,52,65,3970.43,7868.70,0.00
2024-12-10 17:22:30,117,6048,52,65,4009.71,7869.00,0.00
2024-12-10 17:22:30,118,6048,53,65,3975.73,7869.01,0.00
2024-12-10 17:22:30,118,6049,53,65,3946.44,7870.00,0.00
2024-12-10 17:22:30,119,6049,53,66,3913.28,7870.01,0.00
2024-12-10 17:22:30,118,6049,53,65,3935.82,7870.14,0.00
2024-12-10 17:22:30,117,6049,53,64,3957.12,7870.25,0.00
2024-12-10 17:22:30,116,6049,52,64,3963.39,7870.52,0.00
2024-12-10 17:22:30,116,6050,52,64,3986.33,7871.00,0.00
2024-12-10 17:22:30,117,6050,53,64,3952.25,7871.01,0.00
2024-12-10 17:22:30,116,6050,53,63,3975.07,7871.14,0.00
2024-12-10 17:22:30,115,6050,53,62,4007.09,7871.16,0.00
2024-12-10 17:22:30,115,6051,53,62,3999.70,7872.00,0.00
2024-12-10 17:22:30,116,6051,53,63,3965.22,7872.01,0.00
2024-12-10 17:22:30,115,6051,53,62,3988.45,7872.14,0.00
2024-12-10 17:22:30,116,6050,54,62,3893.45,7872.83,0.00
2024-12-10 17:22:30,116,6051,54,62,3956.60,7873.00,0.00
2024-12-10 17:22:30,117,6051,55,62,3922.78,7873.01,0.00
2024-12-10 17:22:30,116,6051,55,61,3953.34,7873.04,0.00
2024-12-10 17:22:30,115,6051,55,60,3981.41,7873.11,0.00
2024-12-10 17:22:30,114,6051,55,59,4014.96,7873.12,0.00
2024-12-10 17:22:30,113,6051,55,58,4043.32,7873.19,0.00
2024-12-10 17:22:30,113,6052,55,58,4107.17,7874.00,0.00
2024-12-10 17:22:30,114,6052,55,59,4071.14,7874.01,0.00
2024-12-10 17:22:30,114,6053,55,59,4046.89,7875.00,0.00
2024-12-10 17:22:30,115,6053,55,60,4011.70,7875.01,0.00
2024-12-10 17:22:30,114,6053,54,60,4036.41,7875.12,0.00
2024-12-10 17:22:30,113,6053,54,59,4071.44,7875.12,0.00
2024-12-10 17:22:30,114,6052,54,60,4010.10,7875.45,0.00
2024-12-10 17:22:30,114,6053,54,60,4066.92,7876.00,0.00
2024-12-10 17:22:30,115,6053,54,61,4031.56,7876.01,0.00
2024-12-10 17:22:30,114,6053,53,61,4056.43,7876.12,0.00
2024-12-10 17:22:30,113,6053,52,61,4091.63,7876.12,0.00
2024-12-10 17:22:30,113,6054,52,61,4144.97,7877.00,0.00
2024-12-10 17:22:30,114,6054,52,62,4108.61,7877.01,0.00
2024-12-10 17:22:30,113,6054,52,61,4134.15,7877.12,0.00
2024-12-10 17:22:30,114,6053,53,61,4074.28,7877.41,0.00
2024-12-10 17:22:30,113,6053,52,61,4143.75,7877.48,0.00
2024-12-10 17:22:30,112,6053,52,60,4143.70,7877.81,0.00
2024-12-10 17:22:30,112,6054,52,60,4199.43,7878.00,0.00
2024-12-10 17:22:30,113,6054,52,61,4162.27,7878.01,0.00
2024-12-10 17:22:30,112,6054,52,60,4188.81,7878.13,0.00
2024-12-10 17:22:30,112,6055,52,60,4247.93,7879.00,0.00
2024-12-10 17:22:30,113,6055,52,61,4210.34,7879.01,0.00
2024-12-10 17:22:30,112,6055,52,60,4237.34,7879.13,0.00
2024-12-10 17:22:30,113,6054,52,61,4162.06,7879.57,0.00
2024-12-10 17:22:30,112,6054,52,60,4208.95,7879.69,0.00
2024-12-10 17:22:30,113,6053,53,60,4161.35,7879.83,0.00
2024-12-10 17:22:30,113,6054,53,60,4228.45,7880.00,0.00
2024-12-10 17:22:30,114,6054,53,61,4191.36,7880.01,0.00
2024-12-10 17:22:30,113,6054,52,61,4208.45,7880.23,0.00
2024-12-10 17:22:30,113,6055,52,61,4350.04,7881.00,0.00
2024-12-10 17:22:30,114,6055,53,61,4311.89,7881.01,0.00
2024-12-10 17:22:30,113,6055,52,61,4339.75,7881.12,0.00
2024-12-10 17:22:30,114,6054,53,61,4282.26,7881.38,0.00
2024-12-10 17:22:30,114,6055,53,61,4294.98,7882.00,0.00
2024-12-10 17:22:30,115,6055,53,62,4257.63,7882.01,0.00
2024-12-10 17:22:30,115,6056,53,62,4301.94,7883.00,0.00
2024-12-10 17:22:30,116,6056,54,62,4264.86,7883.01,0.00
2024-12-10 17:22:30,115,6056,54,61,4292.45,7883.12,0.00
2024-12-10 17:22:30,114,6056,54,60,4327.22,7883.16,0.00
2024-12-10 17:22:30,113,6056,53,60,4339.58,7883.39,0.00
2024-12-10 17:22:30,114,6055,54,60,4296.70,7883.47,0.00
2024-12-10 17:22:30,114,6056,54,60,4353.12,7884.00,0.00
2024-12-10 17:22:30,115,6056,54,61,4315.26,7884.01,0.00
2024-12-10 17:22:30,114,6056,54,60,4343.47,7884.12,0.00
2024-12-10 17:22:30,114,6057,54,60,4398.73,7885.00,0.00
2024-12-10 17:22:30,115,6057,54,61,4360.48,7885.01,0.00
2024-12-10 17:22:30,114,6057,54,60,4389.08,7885.12,0.00
2024-12-10 17:22:30,113,6057,54,59,4407.92,7885.35,0.00
2024-12-10 17:22:30,113,6058,54,59,4408.87,7886.00,0.00
2024-12-10 17:22:30,114,6058,54,60,4370.20,7886.01,0.00
2024-12-10 17:22:30,113,6058,54,59,4398.51,7886.13,0.00
2024-12-10 17:22:30,112,6058,54,58,4380.27,7886.57,0.00
2024-12-10 17:22:30,112,6059,54,58,4416.20,7887.00,0.00
2024-12-10 17:22:30,113,6059,55,58,4377.11,7887.01,0.00
2024-12-10 17:22:31,112,6059,55,57,4411.98,7887.05,0.00
2024-12-10 17:22:31,111,6059,55,56,4445.44,7887.12,0.00
2024-12-10 17:22:31,110,6059,55,55,4479.69,7887.16,0.00
2024-12-10 17:22:31,110,6060,55,55,4470.41,7888.00,0.00
2024-12-10 17:22:31,111,6060,56,55,4430.13,7888.01,0.00
2024-12-10 17:22:31,110,6060,55,55,4444.64,7888.28,0.00
2024-12-10 17:22:31,109,6060,55,54,4470.01,7888.42,0.00
2024-12-10 17:22:31,109,6061,55,54,4493.47,7889.00,0.00
2024-12-10 17:22:31,110,6061,56,54,4452.62,7889.01,0.00
2024-12-10 17:22:31,110,6062,56,54,4424.92,7890.00,0.00
2024-12-10 17:22:31,111,6062,56,55,4385.06,7890.01,0.00
2024-12-10 17:22:31,112,6061,57,55,4285.84,7890.54,0.00
2024-12-10 17:22:31,112,6062,57,55,4337.15,7891.00,0.00
2024-12-10 17:22:31,113,6062,58,55,4298.77,7891.01,0.00
2024-12-10 17:22:31,112,6062,57,55,4327.90,7891.12,0.00
2024-12-10 17:22:31,112,6063,57,55,4368.12,7892.00,0.00
2024-12-10 17:22:31,113,6063,57,56,4329.46,7892.01,0.00
2024-12-10 17:22:31,112,6063,57,55,4357.62,7892.13,0.00
2024-12-10 17:22:31,112,6064,57,55,4329.84,7893.00,0.00
2024-12-10 17:22:31,113,6064,57,56,4291.53,7893.01,0.00
2024-12-10 17:22:31,112,6064,56,56,4325.88,7893.05,0.00
2024-12-10 17:22:31,111,6064,56,55,4322.88,7893.38,0.00
2024-12-10 17:22:31,112,6063,57,55,4280.08,7893.45,0.00
2024-12-10 17:22:31,112,6064,57,55,4328.65,7894.00,0.00
2024-12-10 17:22:31,113,6064,58,55,4290.34,7894.01,0.00
2024-12-10 17:22:31,113,6065,58,55,4316.97,7895.00,0.00
2024-12-10 17:22:31,114,6065,59,55,4279.10,7895.01,0.00
2024-12-10 17:22:31,113,6065,59,54,4290.16,7895.26,0.00
2024-12-10 17:22:31,112,6065,58,54,4270.06,7895.79,0.00
2024-12-10 17:22:31,112,6066,58,54,4324.52,7896.00,0.00
2024-12-10 17:22:31,113,6066,58,55,4286.25,7896.01,0.00
2024-12-10 17:22:31,112,6066,57,55,4310.78,7896.17,0.00
2024-12-10 17:22:31,112,6067,57,55,4298.76,7897.00,0.00
2024-12-10 17:22:31,113,6067,57,56,4260.72,7897.01,0.00
2024-12-10 17:22:31,112,6067,57,55,4274.50,7897.29,0.00
2024-12-10 17:22:31,112,6068,57,55,4263.48,7898.00,0.00
2024-12-10 17:22:31,113,6068,57,56,4225.75,7898.01,0.00
2024-12-10 17:22:31,112,6068,57,55,4253.63,7898.13,0.00
2024-12-10 17:22:31,111,6068,56,55,4224.63,7898.69,0.00
2024-12-10 17:22:31,111,6069,56,55,4266.76,7899.00,0.00
2024-12-10 17:22:31,112,6069,57,55,4228.67,7899.01,0.00
2024-12-10 17:22:31,111,6069,57,54,4257.06,7899.13,0.00
2024-12-10 17:22:31,110,6069,57,53,4288.58,7899.21,0.00
2024-12-10 17:22:31,110,6070,57,53,4280.83,7900.00,0.00
2024-12-10 17:22:31,111,6070,58,53,4242.27,7900.01,0.00
2024-12-10 17:22:31,110,6070,58,52,4269.84,7900.13,0.00
2024-12-10 17:22:31,109,6070,57,52,4267.26,7900.58,0.00
2024-12-10 17:22:31,110,6069,57,53,4212.74,7900.73,0.00
2024-12-10 17:22:31,110,6070,57,53,4278.19,7901.00,0.00
2024-12-10 17:22:31,111,6070,57,54,4239.65,7901.01,0.00
2024-12-10 17:22:31,110,6070,57,53,4277.48,7901.01,0.00
2024-12-10 17:22:31,109,6070,57,52,4304.45,7901.13,0.00
2024-12-10 17:22:31,109,6071,57,52,4363.78,7902.00,0.00
2024-12-10 17:22:31,110,6071,58,52,4324.11,7902.01,0.00
2024-12-10 17:22:31,110,6072,58,52,4294.80,7903.00,0.00
2024-12-10 17:22:31,111,6072,59,52,4256.11,7903.01,0.00
2024-12-10 17:22:31,110,6072,59,51,4281.19,7903.15,0.00
2024-12-10 17:22:31,110,6073,59,51,4264.88,7904.00,0.00
2024-12-10 17:22:31,111,6073,59,52,4226.46,7904.01,0.00
2024-12-10 17:22:31,110,6073,58,52,4259.12,7904.06,0.00
2024-12-10 17:22:31,110,6074,58,52,4231.07,7905.00,0.00
2024-12-10 17:22:31,111,6074,58,53,4192.95,7905.01,0.00
2024-12-10 17:22:31,110,6074,57,53,4230.35,7905.01,0.00
2024-12-10 17:22:31,109,6074,56,53,4268.43,7905.01,0.00
2024-12-10 17:22:31,108,6074,56,52,4306.49,7905.02,0.00
2024-12-10 17:22:31,109,6073,57,52,4264.09,7905.07,0.00
2024-12-10 17:22:31,108,6073,56,52,4342.52,7905.11,0.00
2024-12-10 17:22:31,107,6073,55,52,4382.36,7905.11,0.00
2024-12-10 17:22:31,106,6073,55,51,4422.96,7905.11,0.00
2024-12-10 17:22:31,105,6073,54,51,4402.81,7905.63,0.00
2024-12-10 17:22:31,105,6074,54,51,4446.27,7906.00,0.00
2024-12-10 17:22:31,106,6074,54,52,4404.32,7906.01,0.00
2024-12-10 17:22:31,105,6074,53,52,4445.80,7906.01,0.00
2024-12-10 17:22:31,104,6074,52,52,4480.98,7906.10,0.00
2024-12-10 17:22:31,103,6074,52,51,4508.36,7906.22,0.00
2024-12-10 17:22:31,103,6075,52,51,4591.41,7907.00,0.00
2024-12-10 17:22:31,104,6075,52,52,4547.27,7907.01,0.00
2024-12-10 17:22:31,104,6076,52,52,4528.73,7908.00,0.00
2024-12-10 17:22:31,105,6076,52,53,4485.60,7908.01,0.00
2024-12-10 17:22:31,104,6076,51,53,4521.16,7908.10,0.00
2024-12-10 17:22:31,103,6076,50,53,4556.69,7908.18,0.00
2024-12-10 17:22:31,102,6076,50,52,4591.56,7908.24,0.00
2024-12-10 17:22:31,102,6077,50,52,4603.40,7909.00,0.00
2024-12-10 17:22:31,103,6077,50,53,4558.71,7909.01,0.00
2024-12-10 17:22:31,103,6078,50,53,4543.28,7910.00,0.00
2024-12-10 17:22:31,104,6078,51,53,4499.60,7910.01,0.00
2024-12-10 17:22:31,104,6079,51,53,4472.14,7911.00,0.00
2024-12-10 17:22:31,105,6079,52,53,4429.55,7911.01,0.00
2024-12-10 17:22:31,104,6079,51,53,4464.57,7911.10,0.00
2024-12-10 17:22:31,105,6078,52,53,4401.22,7911.31,0.00
2024-12-10 17:22:31,104,6078,51,53,4438.32,7911.69,0.00
2024-12-10 17:22:31,104,6079,51,53,4490.31,7912.00,0.00
2024-12-10 17:22:31,105,6079,52,53,4447.54,7912.01,0.00
2024-12-10 17:22:31,106,6078,53,53,4354.62,7912.59,0.00
2024-12-10 17:22:31,106,6079,53,53,4463.51,7913.00,0.00
2024-12-10 17:22:31,107,6079,53,54,4421.80,7913.01,0.00
2024-12-10 17:22:31,108,6078,54,54,4374.29,7913.11,0.00
2024-12-10 17:22:31,107,6078,54,53,4393.33,7913.59,0.00
2024-12-10 17:22:31,107,6079,54,53,4507.99,7914.00,0.00
2024-12-10 17:22:31,108,6079,54,54,4466.25,7914.01,0.00
2024-12-10 17:22:31,108,6080,54,54,4526.98,7915.00,0.00
2024-12-10 17:22:31,109,6080,54,55,4485.44,7915.01,0.00
2024-12-10 17:22:32,110,6079,55,55,4400.05,7915.56,0.00
2024-12-10 17:22:32,110,6080,55,55,4429.59,7916.00,0.00
2024-12-10 17:22:32,111,6080,56,55,4389.68,7916.01,0.00
2024-12-10 17:22:32,110,6080,56,54,4426.72,7916.04,0.00
2024-12-10 17:22:32,109,6080,55,54,4462.27,7916.09,0.00
2024-12-10 17:22:32,108,6080,55,53,4502.86,7916.09,0.00
2024-12-10 17:22:32,108,6081,55,53,4558.19,7917.00,0.00
2024-12-10 17:22:32,109,6081,55,54,4516.37,7917.01,0.00
2024-12-10 17:22:32,110,6080,56,54,4468.15,7917.12,0.00
2024-12-10 17:22:32,110,6081,56,54,4508.18,7918.00,0.00
2024-12-10 17:22:32,111,6081,56,55,4467.57,7918.01,0.00
2024-12-10 17:22:32,110,6081,56,54,4501.02,7918.09,0.00
2024-12-10 17:22:32,109,6081,56,53,4531.16,7918.19,0.00
2024-12-10 17:22:32,108,6081,56,52,4535.25,7918.59,0.00
2024-12-10 17:22:32,109,6080,57,52,4492.20,7918.62,0.00
2024-12-10 17:22:32,109,6081,57,52,4614.34,7919.00,0.00
2024-12-10 17:22:32,110,6081,57,53,4572.40,7919.01,0.00
2024-12-10 17:22:32,110,6082,57,53,4612.19,7920.00,0.00
2024-12-10 17:22:32,111,6082,58,53,4570.64,7920.01,0.00
2024-12-10 17:22:32,110,6082,57,53,4598.65,7920.15,0.00
2024-12-10 17:22:32,109,6082,56,53,4590.38,7920.66,0.00
2024-12-10 17:22:32,109,6083,56,53,4629.97,7921.00,0.00
2024-12-10 17:22:32,110,6083,57,53,4587.88,7921.01,0.00
2024-12-10 17:22:32,109,6083,56,53,4602.31,7921.31,0.00
2024-12-10 17:22:32,109,6084,56,53,4614.46,7922.00,0.00
2024-12-10 17:22:32,110,6084,57,53,4572.51,7922.01,0.00
2024-12-10 17:22:32,110,6085,57,53,4557.94,7923.00,0.00
2024-12-10 17:22:32,111,6085,57,54,4516.88,7923.01,0.00
2024-12-10 17:22:32,110,6085,56,54,4557.79,7923.01,0.00
2024-12-10 17:22:32,111,6084,56,55,4515.31,7923.05,0.00
2024-12-10 17:22:32,111,6085,56,55,4513.88,7924.00,0.00
2024-12-10 17:22:32,112,6085,56,56,4473.58,7924.01,0.00
2024-12-10 17:22:32,111,6085,55,56,4506.84,7924.09,0.00
2024-12-10 17:22:32,110,6085,55,55,4544.98,7924.11,0.00
2024-12-10 17:22:32,110,6086,55,55,4606.24,7925.00,0.00
2024-12-10 17:22:32,111,6086,55,56,4564.74,7925.01,0.00
2024-12-10 17:22:32,110,6086,55,55,4593.64,7925.16,0.00
2024-12-10 17:22:32,110,6087,55,55,4579.64,7926.00,0.00
2024-12-10 17:22:32,111,6087,56,55,4538.38,7926.01,0.00
2024-12-10 17:22:32,110,6087,56,54,4572.47,7926.09,0.00
2024-12-10 17:22:32,111,6086,57,54,4460.84,7926.72,0.00
2024-12-10 17:22:32,111,6087,57,54,4520.14,7927.00,0.00
2024-12-10 17:22:32,112,6087,58,54,4479.78,7927.01,0.00
2024-12-10 17:22:32,111,6087,58,53,4511.10,7927.12,0.00
2024-12-10 17:22:32,111,6088,58,53,4548.36,7928.00,0.00
2024-12-10 17:22:32,112,6088,58,54,4507.75,7928.01,0.00
2024-12-10 17:22:32,111,6088,57,54,4531.40,7928.20,0.00
2024-12-10 17:22:32,111,6089,57,54,4501.10,7929.00,0.00
2024-12-10 17:22:32,112,6089,57,55,4460.91,7929.01,0.00
2024-12-10 17:22:32,113,6088,58,55,4379.76,7929.51,0.00
2024-12-10 17:22:32,112,6088,57,55,4440.65,7929.61,0.00
2024-12-10 17:22:32,111,6088,57,54,4467.98,7929.68,0.00
2024-12-10 17:22:32,112,6087,57,55,4405.36,7929.86,0.00
2024-12-10 17:22:32,112,6088,57,55,4473.46,7930.00,0.00
2024-12-10 17:22:32,113,6088,57,56,4433.88,7930.01,0.00
2024-12-10 17:22:32,112,6088,56,56,4463.97,7930.10,0.00
2024-12-10 17:22:32,112,6089,56,56,4589.45,7931.00,0.00
2024-12-10 17:22:32,113,6089,56,57,4548.83,7931.01,0.00
2024-12-10 17:22:32,113,6090,56,57,4519.70,7932.00,0.00
2024-12-10 17:22:32,114,6090,57,57,4480.05,7932.01,0.00
2024-12-10 17:22:32,115,6089,57,58,4364.18,7932.78,0.00
2024-12-10 17:22:32,115,6090,57,58,4456.39,7933.00,0.00
2024-12-10 17:22:32,116,6090,57,59,4417.98,7933.01,0.00
2024-12-10 17:22:32,115,6090,57,58,4442.75,7933.10,0.00
2024-12-10 17:22:32,115,6091,57,58,4479.20,7934.00,0.00
2024-12-10 17:22:32,116,6091,58,58,4440.58,7934.01,0.00
2024-12-10 17:22:32,115,6091,57,58,4476.45,7934.04,0.00
2024-12-10 17:22:32,115,6092,57,58,4427.59,7935.00,0.00
2024-12-10 17:22:32,116,6092,58,58,4389.42,7935.01,0.00
2024-12-10 17:22:32,115,6092,58,57,4417.89,7935.08,0.00
2024-12-10 17:22:32,115,6093,58,57,4380.30,7936.00,0.00
2024-12-10 17:22:32,116,6093,59,57,4342.54,7936.01,0.00
2024-12-10 17:22:32,117,6092,60,57,4295.17,7936.14,0.00
2024-12-10 17:22:32,117,6093,60,57,4268.23,7937.00,0.00
2024-12-10 17:22:32,118,6093,60,58,4232.06,7937.01,0.00
2024-12-10 17:22:32,117,6093,60,57,4255.90,7937.15,0.00
2024-12-10 17:22:32,117,6094,60,57,4264.49,7938.00,0.00
2024-12-10 17:22:32,118,6094,60,58,4228.35,7938.01,0.00
2024-12-10 17:22:32,117,6094,59,58,4228.61,7938.27,0.00
2024-12-10 17:22:32,116,6094,59,57,4254.41,7938.33,0.00
2024-12-10 17:22:32,115,6094,58,57,4271.99,7938.40,0.00
2024-12-10 17:22:32,116,6093,59,57,4203.83,7938.54,0.00
2024-12-10 17:22:32,115,6093,59,56,4252.78,7938.64,0.00
2024-12-10 17:22:32,114,6093,58,56,4279.69,7938.74,0.00
2024-12-10 17:22:32,114,6094,58,56,4327.96,7939.00,0.00
2024-12-10 17:22:32,115,6094,59,56,4290.32,7939.01,0.00
2024-12-10 17:22:32,116,6093,60,56,4241.08,7939.15,0.00
2024-12-10 17:22:32,115,6093,59,56,4300.67,7939.26,0.00
2024-12-10 17:22:32,115,6094,59,56,4324.44,7940.00,0.00
2024-12-10 17:22:32,116,6094,60,56,4287.16,7940.01,0.00
2024-12-10 17:22:32,115,6094,60,55,4310.94,7940.11,0.00
2024-12-10 17:22:32,114,6094,60,54,4310.27,7940.42,0.00
2024-12-10 17:22:32,113,6094,59,54,4340.62,7940.43,0.00
2024-12-10 17:22:32,113,6095,59,54,4409.16,7941.00,0.00
2024-12-10 17:22:32,114,6095,60,54,4370.48,7941.01,0.00
2024-12-10 17:22:32,113,6095,60,53,4381.25,7941.29,0.00
2024-12-10 17:22:32,114,6094,61,53,4340.73,7941.33,0.00
2024-12-10 17:22:32,114,6095,61,53,4337.20,7942.00,0.00
2024-12-10 17:22:32,115,6095,61,54,4299.48,7942.01,0.00
2024-12-10 17:22:33,114,6095,60,54,4334.42,7942.04,0.00
2024-12-10 17:22:33,113,6095,59,54,4370.22,7942.04,0.00
2024-12-10 17:22:33,112,6095,58,54,4405.71,7942.08,0.00
2024-12-10 17:22:33,111,6095,58,53,4388.52,7942.48,0.00
2024-12-10 17:22:33,111,6096,58,53,4462.57,7943.00,0.00
2024-12-10 17:22:33,112,6096,58,54,4422.73,7943.01,0.00
2024-12-10 17:22:33,111,6096,58,53,4438.27,7943.32,0.00
2024-12-10 17:22:33,110,6096,57,53,4455.72,7943.39,0.00
2024-12-10 17:22:33,109,6096,56,53,4477.97,7943.48,0.00
2024-12-10 17:22:33,109,6097,56,53,4490.42,7944.00,0.00
2024-12-10 17:22:33,110,6097,56,54,4449.59,7944.01,0.00
2024-12-10 17:22:33,109,6097,56,53,4432.89,7944.47,0.00
2024-12-10 17:22:33,109,6098,56,53,4444.87,7945.00,0.00
2024-12-10 17:22:33,110,6098,57,53,4404.47,7945.01,0.00
2024-12-10 17:22:33,110,6099,57,53,4367.70,7946.00,0.00
2024-12-10 17:22:33,111,6099,58,53,4328.35,7946.01,0.00
2024-12-10 17:22:33,110,6099,58,52,4361.23,7946.08,0.00
2024-12-10 17:22:33,110,6100,58,52,4334.72,7947.00,0.00
2024-12-10 17:22:33,111,6100,59,52,4295.67,7947.01,0.00
2024-12-10 17:22:33,110,6100,59,51,4256.36,7947.84,0.00
2024-12-10 17:22:33,110,6101,59,51,4315.75,7948.00,0.00
2024-12-10 17:22:33,111,6101,59,52,4276.87,7948.01,0.00
2024-12-10 17:22:33,110,6101,58,52,4314.31,7948.02,0.00
2024-12-10 17:22:33,110,6102,58,52,4285.17,7949.00,0.00
2024-12-10 17:22:33,111,6102,59,52,4246.56,7949.01,0.00
2024-12-10 17:22:33,110,6102,59,51,4277.98,7949.09,0.00
2024-12-10 17:22:33,109,6102,59,50,4317.09,7949.09,0.00
2024-12-10 17:22:33,108,6102,58,50,4282.04,7949.58,0.00
2024-12-10 17:22:33,108,6103,58,50,4321.49,7950.00,0.00
2024-12-10 17:22:33,109,6103,59,50,4281.84,7950.01,0.00
2024-12-10 17:22:33,108,6103,58,50,4319.28,7950.03,0.00
2024-12-10 17:22:33,107,6103,58,49,4334.38,7950.34,0.00
2024-12-10 17:22:33,106,6103,57,49,4352.72,7950.42,0.00
2024-12-10 17:22:33,107,6102,57,50,4309.83,7950.47,0.00
2024-12-10 17:22:33,107,6103,57,50,4370.39,7951.00,0.00
2024-12-10 17:22:33,108,6103,58,50,4329.92,7951.01,0.00
2024-12-10 17:22:33,107,6103,58,49,4336.70,7951.34,0.00
2024-12-10 17:22:33,107,6104,58,49,4418.58,7952.00,0.00
2024-12-10 17:22:33,108,6104,58,50,4377.67,7952.01,0.00
2024-12-10 17:22:33,107,6104,57,50,4417.84,7952.01,0.00
2024-12-10 17:22:33,106,6104,57,49,4453.56,7952.08,0.00
2024-12-10 17:22:33,107,6103,58,49,4349.96,7952.75,0.00
2024-12-10 17:22:33,107,6104,58,49,4418.90,7953.00,0.00
2024-12-10 17:22:33,108,6104,59,49,4377.98,7953.01,0.00
2024-12-10 17:22:33,107,6104,58,49,4412.99,7953.08,0.00
2024-12-10 17:22:33,106,6104,57,49,4436.89,7953.29,0.00
2024-12-10 17:22:33,106,6105,57,49,4523.87,7954.00,0.00
2024-12-10 17:22:33,107,6105,57,50,4481.59,7954.01,0.00
2024-12-10 17:22:33,106,6105,57,49,4517.16,7954.09,0.00
2024-12-10 17:22:33,107,6104,58,49,4464.55,7954.23,0.00
2024-12-10 17:22:33,108,6103,59,49,4463.86,7954.50,0.00
2024-12-10 17:22:33,108,6104,59,49,4529.91,7955.00,0.00
2024-12-10 17:22:33,109,6104,60,49,4488.35,7955.01,0.00
2024-12-10 17:22:33,109,6105,60,49,4622.76,7956.00,0.00
2024-12-10 17:22:33,110,6105,61,49,4580.73,7956.01,0.00
2024-12-10 17:22:33,109,6105,60,49,4616.22,7956.08,0.00
2024-12-10 17:22:33,109,6106,60,49,4608.62,7957.00,0.00
2024-12-10 17:22:33,110,6106,60,50,4566.73,7957.01,0.00
2024-12-10 17:22:33,109,6106,59,50,4602.09,7957.08,0.00
2024-12-10 17:22:33,109,6107,59,50,4593.17,7958.00,0.00
2024-12-10 17:22:33,110,6107,59,51,4551.41,7958.01,0.00
2024-12-10 17:22:33,109,6107,59,50,4586.63,7958.08,0.00
2024-12-10 17:22:33,109,6108,59,50,4576.72,7959.00,0.00
2024-12-10 17:22:33,110,6108,59,51,4535.11,7959.01,0.00
2024-12-10 17:22:33,109,6108,59,50,4570.18,7959.08,0.00
2024-12-10 17:22:33,109,6109,59,50,4560.31,7960.00,0.00
2024-12-10 17:22:33,110,6109,59,51,4518.85,7960.01,0.00
2024-12-10 17:22:33,109,6109,59,50,4553.77,7960.08,0.00
2024-12-10 17:22:33,109,6110,59,50,4543.37,7961.00,0.00
2024-12-10 17:22:33,110,6110,59,51,4502.07,7961.01,0.00
2024-12-10 17:22:33,109,6110,58,51,4491.06,7961.63,0.00
2024-12-10 17:22:33,109,6111,58,51,4530.49,7962.00,0.00
2024-12-10 17:22:33,110,6111,58,52,4489.30,7962.01,0.00
2024-12-10 17:22:33,109,6111,57,52,4523.95,7962.08,0.00
2024-12-10 17:22:33,109,6112,57,52,4517.40,7963.00,0.00
2024-12-10 17:22:33,110,6112,58,52,4476.33,7963.01,0.00
2024-12-10 17:22:33,111,6111,59,52,4431.72,7963.08,0.00
2024-12-10 17:22:33,111,6112,59,52,4439.78,7964.00,0.00
2024-12-10 17:22:33,112,6112,60,52,4400.14,7964.01,0.00
2024-12-10 17:22:33,111,6112,59,52,4432.64,7964.09,0.00
2024-12-10 17:22:33,110,6112,59,51,4456.86,7964.28,0.00
2024-12-10 17:22:33,110,6113,59,51,4538.55,7965.00,0.00
2024-12-10 17:22:33,111,6113,59,52,4497.66,7965.01,0.00
2024-12-10 17:22:33,111,6114,59,52,4484.94,7966.00,0.00
2024-12-10 17:22:33,112,6114,59,53,4444.89,7966.01,0.00
2024-12-10 17:22:33,111,6114,58,53,4477.79,7966.09,0.00
2024-12-10 17:22:33,111,6115,58,53,4472.16,7967.00,0.00
2024-12-10 17:22:33,112,6115,59,53,4432.23,7967.01,0.00
2024-12-10 17:22:33,111,6115,59,52,4465.01,7967.09,0.00
2024-12-10 17:22:33,111,6116,59,52,4460.09,7968.00,0.00
2024-12-10 17:22:33,112,6116,59,53,4420.27,7968.01,0.00
2024-12-10 17:22:33,111,6116,58,53,4452.94,7968.09,0.00
2024-12-10 17:22:33,111,6117,58,53,4448.15,7969.00,0.00
2024-12-10 17:22:33,112,6117,59,53,4408.44,7969.01,0.00
2024-12-10 17:22:33,111,6117,58,53,4440.30,7969.09,0.00
2024-12-10 17:22:33,111,6118,58,53,4436.90,7970.00,0.00
2024-12-10 17:22:33,112,6118,58,54,4397.29,7970.01,0.00
2024-12-10 17:22:34,111,6118,57,54,4421.93,7970.17,0.00
2024-12-10 17:22:34,111,6119,57,54,4425.89,7971.00,0.00
2024-12-10 17:22:34,112,6119,58,54,4386.37,7971.01,0.00
2024-12-10 17:22:34,112,6120,58,54,4374.06,7972.00,0.00
2024-12-10 17:22:34,113,6120,58,55,4335.36,7972.01,0.00
2024-12-10 17:22:34,112,6120,58,54,4364.29,7972.07,0.00
2024-12-10 17:22:34,111,6120,58,53,4402.17,7972.08,0.00
2024-12-10 17:22:34,110,6120,57,53,4441.46,7972.08,0.00
2024-12-10 17:22:34,110,6121,57,53,4433.32,7973.00,0.00
2024-12-10 17:22:34,111,6121,58,53,4393.38,7973.01,0.00
2024-12-10 17:22:34,110,6121,58,52,4403.60,7973.26,0.00
2024-12-10 17:22:34,110,6122,58,52,4407.38,7974.00,0.00
2024-12-10 17:22:34,111,6122,58,53,4367.67,7974.01,0.00
2024-12-10 17:22:34,110,6122,58,52,4402.08,7974.05,0.00
2024-12-10 17:22:34,110,6123,58,52,4387.07,7975.00,0.00
2024-12-10 17:22:34,111,6123,58,53,4347.55,7975.01,0.00
2024-12-10 17:22:34,110,6123,57,53,4385.69,7975.02,0.00
2024-12-10 17:22:34,110,6124,57,53,4368.50,7976.00,0.00
2024-12-10 17:22:34,111,6124,57,54,4329.15,7976.01,0.00
2024-12-10 17:22:34,110,6124,57,53,4362.01,7976.08,0.00
2024-12-10 17:22:34,110,6125,57,53,4349.74,7977.00,0.00
2024-12-10 17:22:34,111,6125,57,54,4310.55,7977.01,0.00
2024-12-10 17:22:34,110,6125,57,53,4309.90,7977.42,0.00
2024-12-10 17:22:34,109,6125,56,53,4316.13,7977.79,0.00
2024-12-10 17:22:34,109,6126,56,53,4372.67,7978.00,0.00
2024-12-10 17:22:34,110,6126,56,54,4332.91,7978.01,0.00
2024-12-10 17:22:34,110,6127,56,54,4321.54,7979.00,0.00
2024-12-10 17:22:34,111,6127,56,55,4282.61,7979.01,0.00
2024-12-10 17:22:34,110,6127,55,55,4319.37,7979.03,0.00
2024-12-10 17:22:34,109,6127,54,55,4356.82,7979.05,0.00
2024-12-10 17:22:34,108,6127,54,54,4392.28,7979.07,0.00
2024-12-10 17:22:34,107,6127,54,53,4432.58,7979.07,0.00
2024-12-10 17:22:34,106,6127,53,53,4473.64,7979.07,0.00
2024-12-10 17:22:34,106,6128,53,53,4470.29,7980.00,0.00
2024-12-10 17:22:34,107,6128,53,54,4428.52,7980.01,0.00
2024-12-10 17:22:34,106,6128,53,53,4461.19,7980.07,0.00
2024-12-10 17:22:34,106,6129,53,53,4457.86,7981.00,0.00
2024-12-10 17:22:34,107,6129,53,54,4416.20,7981.01,0.00
2024-12-10 17:22:34,108,6128,54,54,4332.15,7981.49,0.00
2024-12-10 17:22:34,108,6129,54,54,4397.63,7982.00,0.00
2024-12-10 17:22:34,109,6129,54,55,4357.28,7982.01,0.00
2024-12-10 17:22:34,109,6130,54,55,4414.00,7983.00,0.00
2024-12-10 17:22:34,110,6130,54,56,4373.87,7983.01,0.00
2024-12-10 17:22:34,110,6131,54,56,4355.13,7984.00,0.00
2024-12-10 17:22:34,111,6131,54,57,4315.90,7984.01,0.00
2024-12-10 17:22:34,111,6132,54,57,4294.90,7985.00,0.00
2024-12-10 17:22:34,112,6132,55,57,4256.55,7985.01,0.00
2024-12-10 17:22:34,111,6132,55,56,4290.87,7985.05,0.00
2024-12-10 17:22:34,111,6133,55,56,4279.32,7986.00,0.00
2024-12-10 17:22:34,112,6133,56,56,4241.11,7986.01,0.00
2024-12-10 17:22:34,111,6133,56,55,4245.59,7986.31,0.00
2024-12-10 17:22:34,111,6134,56,55,4262.59,7987.00,0.00
2024-12-10 17:22:34,112,6134,56,56,4224.53,7987.01,0.00
2024-12-10 17:22:34,112,6135,56,56,4214.37,7988.00,0.00
2024-12-10 17:22:34,113,6135,57,56,4177.07,7988.01,0.00
2024-12-10 17:22:34,113,6136,57,56,4167.13,7989.00,0.00
2024-12-10 17:22:34,114,6136,57,57,4130.58,7989.01,0.00
2024-12-10 17:22:34,113,6136,56,57,4162.91,7989.05,0.00
2024-12-10 17:22:34,113,6137,56,57,4158.24,7990.00,0.00
2024-12-10 17:22:34,114,6137,57,57,4121.76,7990.01,0.00
2024-12-10 17:22:34,113,6137,57,56,4154.01,7990.05,0.00
2024-12-10 17:22:34,112,6137,56,56,4190.39,7990.05,0.00
2024-12-10 17:22:34,112,6138,56,56,4185.57,7991.00,0.00
2024-12-10 17:22:34,113,6138,56,57,4148.53,7991.01,0.00
2024-12-10 17:22:34,113,6139,56,57,4138.58,7992.00,0.00
2024-12-10 17:22:34,114,6139,57,57,4102.28,7992.01,0.00
2024-12-10 17:22:34,113,6139,57,56,4134.35,7992.05,0.00
2024-12-10 17:22:34,113,6140,57,56,4127.29,7993.00,0.00
2024-12-10 17:22:34,114,6140,57,57,4091.08,7993.01,0.00
2024-12-10 17:22:34,113,6140,57,56,4123.06,7993.05,0.00
2024-12-10 17:22:34,112,6140,56,56,4159.16,7993.05,0.00
2024-12-10 17:22:34,112,6141,56,56,4152.48,7994.00,0.00
2024-12-10 17:22:34,113,6141,57,56,4115.73,7994.01,0.00
2024-12-10 17:22:34,112,6141,56,56,4146.10,7994.08,0.00
2024-12-10 17:22:34,113,6140,57,56,4104.13,7994.15,0.00
2024-12-10 17:22:34,113,6141,57,56,4172.60,7995.00,0.00
2024-12-10 17:22:34,114,6141,58,56,4136.00,7995.01,0.00
2024-12-10 17:22:34,113,6141,57,56,4168.37,7995.05,0.00
2024-12-10 17:22:34,113,6142,57,56,4228.84,7996.00,0.00
2024-12-10 17:22:34,114,6142,58,56,4191.74,7996.01,0.00
2024-12-10 17:22:34,114,6143,58,56,4176.09,7997.00,0.00
2024-12-10 17:22:34,115,6143,58,57,4139.77,7997.01,0.00
2024-12-10 17:22:34,114,6143,58,56,4168.64,7997.08,0.00
2024-12-10 17:22:34,114,6143,58,56,4159.63,7998.00,0.00
2024-12-10 17:22:34,115,6143,59,56,4123.46,7998.01,0.00
2024-12-10 17:22:34,114,6143,58,56,4120.85,7998.43,0.00
2024-12-10 17:22:34,114,6144,58,56,4145.80,7999.00,0.00
2024-12-10 17:22:34,115,6144,59,56,4109.74,7999.01,0.00
2024-12-10 17:22:35,115,6145,59,56,4092.72,8000.00,0.00
2024-12-10 17:22:35,116,6145,59,57,4057.44,8000.01,0.00
2024-12-10 17:22:35,115,6145,59,56,4088.57,8000.05,0.00
2024-12-10 17:22:35,114,6145,58,56,4113.34,8000.10,0.00
2024-12-10 17:22:35,114,6146,58,56,4105.44,8001.00,0.00
2024-12-10 17:22:35,115,6146,58,57,4069.74,8001.01,0.00
2024-12-10 17:22:35,114,6146,57,57,4096.17,8001.05,0.00
2024-12-10 17:22:35,114,6147,57,57,4079.24,8002.00,0.00
2024-12-10 17:22:35,115,6147,58,57,4043.77,8002.01,0.00
2024-12-10 17:22:35,115,6148,58,57,4017.97,8003.00,0.00
2024-12-10 17:22:35,116,6148,59,57,3983.33,8003.01,0.00
2024-12-10 17:22:35,116,6149,59,57,3953.61,8004.00,0.00
2024-12-10 17:22:35,117,6149,59,58,3919.82,8004.01,0.00
2024-12-10 17:22:35,118,6148,60,58,3868.76,8004.16,0.00
2024-12-10 17:22:35,118,6149,60,58,3911.06,8005.00,0.00
2024-12-10 17:22:35,119,6149,60,59,3878.20,8005.01,0.00
2024-12-10 17:22:35,118,6149,59,59,3906.33,8005.06,0.00
2024-12-10 17:22:35,117,6149,59,58,3938.02,8005.06,0.00
2024-12-10 17:22:35,116,6149,59,57,3962.12,8005.10,0.00
2024-12-10 17:22:35,115,6149,59,56,3996.14,8005.10,0.00
2024-12-10 17:22:35,114,6149,58,56,4020.26,8005.22,0.00
2024-12-10 17:22:35,114,6150,58,56,4090.96,8006.00,0.00
2024-12-10 17:22:35,115,6150,59,56,4055.38,8006.01,0.00
2024-12-10 17:22:35,115,6151,59,56,4031.31,8007.00,0.00
2024-12-10 17:22:35,116,6151,60,56,3996.55,8007.01,0.00
2024-12-10 17:22:35,115,6151,59,56,3981.90,8007.49,0.00
2024-12-10 17:22:35,115,6152,59,56,4004.14,8008.00,0.00
2024-12-10 17:22:35,116,6152,59,57,3969.63,8008.01,0.00
2024-12-10 17:22:35,115,6152,59,56,3988.99,8008.10,0.00
2024-12-10 17:22:35,114,6152,58,56,3955.02,8008.88,0.00
2024-12-10 17:22:35,114,6153,58,56,4015.55,8009.00,0.00
2024-12-10 17:22:35,115,6153,58,57,3980.63,8009.01,0.00
2024-12-10 17:22:35,114,6153,58,56,4011.15,8009.06,0.00
2024-12-10 17:22:35,114,6154,58,56,3990.56,8010.00,0.00
2024-12-10 17:22:35,115,6154,59,56,3955.86,8010.01,0.00
2024-12-10 17:22:35,115,6155,59,56,3923.19,8011.00,0.00
2024-12-10 17:22:35,116,6155,60,56,3889.37,8011.01,0.00
2024-12-10 17:22:35,115,6155,59,56,3912.05,8011.07,0.00
2024-12-10 17:22:35,116,6154,59,57,3823.35,8011.59,0.00
2024-12-10 17:22:35,116,6155,59,57,3880.08,8012.00,0.00
2024-12-10 17:22:35,117,6155,59,58,3846.92,8012.01,0.00
2024-12-10 17:22:35,116,6155,58,58,3876.48,8012.01,0.00
2024-12-10 17:22:35,115,6155,57,58,3900.65,8012.07,0.00
2024-12-10 17:22:35,116,6154,57,59,3804.93,8012.72,0.00
2024-12-10 17:22:35,116,6155,57,59,3928.63,8013.00,0.00
2024-12-10 17:22:35,117,6155,57,60,3895.05,8013.01,0.00
2024-12-10 17:22:35,116,6155,56,60,3922.95,8013.06,0.00
2024-12-10 17:22:35,115,6155,56,59,3938.57,8013.13,0.00
2024-12-10 17:22:35,115,6156,56,59,3994.97,8014.00,0.00
2024-12-10 17:22:35,116,6156,57,59,3960.53,8014.01,0.00
2024-12-10 17:22:35,115,6156,56,59,3966.15,8014.28,0.00
2024-12-10 17:22:35,115,6157,56,59,3963.65,8015.00,0.00
2024-12-10 17:22:35,116,6157,56,60,3929.48,8015.01,0.00
2024-12-10 17:22:35,115,6157,55,60,3881.37,8015.90,0.00
2024-12-10 17:22:35,115,6158,55,60,3942.80,8016.00,0.00
2024-12-10 17:22:35,116,6158,55,61,3908.81,8016.01,0.00
2024-12-10 17:22:35,115,6158,55,60,3923.79,8016.18,0.00
2024-12-10 17:22:35,115,6159,55,60,3923.70,8017.00,0.00
2024-12-10 17:22:35,116,6159,56,60,3889.88,8017.01,0.00
2024-12-10 17:22:35,115,6159,56,59,3923.01,8017.01,0.00
2024-12-10 17:22:35,114,6159,56,58,3947.90,8017.06,0.00
2024-12-10 17:22:35,113,6159,55,58,3982.12,8017.06,0.00
2024-12-10 17:22:35,112,6159,54,58,4000.06,8017.25,0.00
2024-12-10 17:22:35,112,6160,54,58,4011.97,8018.00,0.00
2024-12-10 17:22:35,113,6160,55,58,3976.47,8018.01,0.00
2024-12-10 17:22:35,112,6160,54,58,4007.79,8018.05,0.00
2024-12-10 17:22:35,111,6160,54,57,4043.18,8018.05,0.00
2024-12-10 17:22:35,110,6160,53,57,4079.20,8018.06,0.00
2024-12-10 17:22:35,110,6161,53,57,4076.78,8019.00,0.00
2024-12-10 17:22:35,111,6161,54,57,4040.06,8019.01,0.00
2024-12-10 17:22:35,111,6162,54,57,4033.33,8020.00,0.00
2024-12-10 17:22:35,112,6162,55,57,3997.32,8020.01,0.00
2024-12-10 17:22:35,111,6162,54,57,4029.01,8020.05,0.00
2024-12-10 17:22:35,111,6163,54,57,4025.89,8021.00,0.00
2024-12-10 17:22:35,112,6163,54,58,3989.94,8021.01,0.00
2024-12-10 17:22:35,111,6163,53,58,4021.57,8021.05,0.00
2024-12-10 17:22:35,111,6164,53,58,4018.44,8022.00,0.00
2024-12-10 17:22:35,112,6164,54,58,3982.56,8022.01,0.00
2024-12-10 17:22:35,111,6164,53,58,4014.12,8022.05,0.00
2024-12-10 17:22:35,111,6165,53,58,4010.99,8023.00,0.00
2024-12-10 17:22:35,112,6165,53,59,3975.18,8023.01,0.00
2024-12-10 17:22:35,112,6166,53,59,3966.95,8024.00,0.00
2024-12-10 17:22:35,113,6166,54,59,3931.84,8024.01,0.00
2024-12-10 17:22:35,112,6166,54,58,3962.66,8024.05,0.00
2024-12-10 17:22:35,112,6167,54,58,3956.06,8025.00,0.00
2024-12-10 17:22:35,113,6167,54,59,3921.05,8025.01,0.00
2024-12-10 17:22:35,112,6167,54,58,3951.77,8025.05,0.00
2024-12-10 17:22:35,112,6168,54,58,3945.47,8026.00,0.00
2024-12-10 17:22:35,113,6168,55,58,3910.55,8026.01,0.00
2024-12-10 17:22:35,112,6168,54,58,3941.18,8026.05,0.00
2024-12-10 17:22:35,112,6169,54,58,3935.37,8027.00,0.00
2024-12-10 17:22:35,113,6169,54,59,3900.54,8027.01,0.00
2024-12-10 17:22:35,112,6169,53,59,3931.08,8027.05,0.00
2024-12-10 17:22:36,112,6170,53,59,3926.18,8028.00,0.00
2024-12-10 17:22:36,113,6170,54,59,3891.44,8028.01,0.00
2024-12-10 17:22:36,112,6170,54,58,3921.89,8028.05,0.00
2024-12-10 17:22:36,112,6171,54,58,3916.94,8029.00,0.00
2024-12-10 17:22:36,113,6171,54,59,3882.28,8029.01,0.00
2024-12-10 17:22:36,112,6171,54,58,3912.65,8029.05,0.00
2024-12-10 17:22:36,113,6170,55,58,3838.70,8029.55,0.00
2024-12-10 17:22:36,113,6171,55,58,3907.97,8030.00,0.00
2024-12-10 17:22:36,114,6171,55,59,3873.69,8030.01,0.00
2024-12-10 17:22:36,113,6171,55,58,3903.71,8030.05,0.00
2024-12-10 17:22:36,113,6172,55,58,3969.41,8031.00,0.00
2024-12-10 17:22:36,114,6172,55,59,3934.59,8031.01,0.00
2024-12-10 17:22:36,113,6172,55,58,3965.15,8031.05,0.00
2024-12-10 17:22:36,113,6173,55,58,3959.37,8032.00,0.00
2024-12-10 17:22:36,114,6173,56,58,3924.63,8032.01,0.00
2024-12-10 17:22:36,113,6173,55,58,3955.11,8032.05,0.00
2024-12-10 17:22:36,112,6173,54,58,3963.77,8032.36,0.00
2024-12-10 17:22:36,112,6174,54,58,3984.29,8033.00,0.00
2024-12-10 17:22:36,113,6174,55,58,3949.03,8033.01,0.00
2024-12-10 17:22:36,113,6175,55,58,3939.14,8034.00,0.00
2024-12-10 17:22:36,114,6175,56,58,3904.59,8034.01,0.00
2024-12-10 17:22:36,113,6175,55,58,3934.17,8034.06,0.00
2024-12-10 17:22:36,113,6176,55,58,3919.67,8035.00,0.00
2024-12-10 17:22:36,114,6176,55,59,3885.29,8035.01,0.00
2024-12-10 17:22:36,113,6176,54,59,3914.70,8035.06,0.00
2024-12-10 17:22:36,113,6177,54,59,3884.67,8036.00,0.00
2024-12-10 17:22:36,114,6177,54,60,3850.60,8036.01,0.00
2024-12-10 17:22:36,113,6177,53,60,3883.96,8036.01,0.00
2024-12-10 17:22:36,112,6177,52,60,3914.34,8036.05,0.00
2024-12-10 17:22:36,111,6177,51,60,3948.89,8036.05,0.00
2024-12-10 17:22:36,110,6177,51,59,3962.01,8036.26,0.00
2024-12-10 17:22:36,110,6178,51,59,3944.20,8037.00,0.00
2024-12-10 17:22:36,111,6178,51,60,3908.66,8037.01,0.00
2024-12-10 17:22:36,110,6178,51,59,3939.82,8037.06,0.00
2024-12-10 17:22:36,110,6179,51,59,3891.27,8038.00,0.00
2024-12-10 17:22:36,111,6179,52,59,3856.21,8038.01,0.00
2024-12-10 17:22:36,110,6179,52,58,3886.89,8038.06,0.00
2024-12-10 17:22:36,109,6179,51,58,3817.32,8038.93,0.00
2024-12-10 17:22:36,110,6178,51,59,3770.14,8038.98,0.00
2024-12-10 17:22:36,110,6179,51,59,3841.80,8039.00,0.00
2024-12-10 17:22:36,111,6179,51,60,3807.19,8039.01,0.00
2024-12-10 17:22:36,110,6179,51,59,3807.10,8039.44,0.00
2024-12-10 17:22:36,110,6180,51,59,3883.20,8040.00,0.00
2024-12-10 17:22:36,111,6180,52,59,3848.21,8040.01,0.00
2024-12-10 17:22:36,110,6180,51,59,3878.82,8040.06,0.00
2024-12-10 17:22:36,110,6181,51,59,3838.67,8041.00,0.00
2024-12-10 17:22:36,111,6181,52,59,3804.08,8041.01,0.00
2024-12-10 17:22:36,110,6181,52,58,3837.21,8041.02,0.00
2024-12-10 17:22:36,109,6181,51,58,3869.47,8041.05,0.00
2024-12-10 17:22:36,108,6181,50,58,3904.55,8041.05,0.00
2024-12-10 17:22:36,108,6182,50,58,3842.81,8042.00,0.00
2024-12-10 17:22:36,109,6182,51,58,3807.55,8042.01,0.00
2024-12-10 17:22:36,108,6182,51,57,3839.09,8042.05,0.00
2024-12-10 17:22:36,107,6182,51,56,3849.27,8042.27,0.00
2024-12-10 17:22:36,106,6182,50,56,3877.89,8042.31,0.00
2024-12-10 17:22:36,106,6183,50,56,3859.53,8043.00,0.00
2024-12-10 17:22:36,107,6183,51,56,3823.46,8043.01,0.00
2024-12-10 17:22:36,106,6183,51,55,3855.74,8043.05,0.00
2024-12-10 17:22:36,105,6183,50,55,3813.91,8043.91,0.00
2024-12-10 17:22:36,105,6184,50,55,3868.65,8044.00,0.00
2024-12-10 17:22:36,106,6184,50,56,3832.16,8044.01,0.00
2024-12-10 17:22:36,105,6184,50,55,3864.83,8044.05,0.00
2024-12-10 17:22:36,105,6185,50,55,3846.03,8045.00,0.00
2024-12-10 17:22:36,106,6185,50,56,3809.74,8045.01,0.00
2024-12-10 17:22:36,105,6185,49,56,3841.88,8045.05,0.00
2024-12-10 17:22:36,105,6186,49,56,3817.97,8046.00,0.00
2024-12-10 17:22:36,106,6186,50,56,3781.95,8046.01,0.00
2024-12-10 17:22:36,105,6186,49,56,3812.82,8046.05,0.00
2024-12-10 17:22:36,105,6187,49,56,3784.08,8047.00,0.00
2024-12-10 17:22:36,106,6187,49,57,3748.38,8047.01,0.00
2024-12-10 17:22:36,105,6187,48,57,3776.84,8047.05,0.00
2024-12-10 17:22:36,106,6186,48,58,3686.80,8047.75,0.00
2024-12-10 17:22:36,107,6185,49,58,3675.93,8047.79,0.00
2024-12-10 17:22:36,107,6186,49,58,3720.85,8048.00,0.00
2024-12-10 17:22:36,108,6186,49,59,3686.40,8048.01,0.00
2024-12-10 17:22:36,107,6186,49,58,3711.87,8048.05,0.00
2024-12-10 17:22:36,106,6186,48,58,3675.11,8048.80,0.00
2024-12-10 17:22:36,106,6187,48,58,3863.76,8049.00,0.00
2024-12-10 17:22:36,107,6187,49,58,3827.65,8049.01,0.00
2024-12-10 17:22:36,106,6187,48,58,3851.56,8049.05,0.00
2024-12-10 17:22:36,106,6188,48,58,3816.48,8050.00,0.00
2024-12-10 17:22:36,107,6188,49,58,3780.81,8050.01,0.00
2024-12-10 17:22:36,106,6188,49,57,3814.96,8050.02,0.00
2024-12-10 17:22:36,105,6188,48,57,3851.22,8050.02,0.00
2024-12-10 17:22:36,104,6188,48,56,3882.55,8050.02,0.00
2024-12-10 17:22:36,103,6188,47,56,3919.46,8050.02,0.00
2024-12-10 17:22:36,102,6188,47,55,3957.10,8050.02,0.00
2024-12-10 17:22:36,103,6187,48,55,3832.08,8050.90,0.00
2024-12-10 17:22:36,103,6188,48,55,3955.46,8051.00,0.00
2024-12-10 17:22:36,104,6188,49,55,3917.43,8051.01,0.00
2024-12-10 17:22:36,103,6188,48,55,3953.90,8051.02,0.00
2024-12-10 17:22:37,103,6189,48,55,3964.60,8052.00,0.00
2024-12-10 17:22:37,104,6189,49,55,3926.48,8052.01,0.00
2024-12-10 17:22:37,103,6189,49,54,3963.04,8052.02,0.00
2024-12-10 17:22:37,102,6189,49,53,3945.69,8052.51,0.00
2024-12-10 17:22:37,102,6190,49,53,3926.78,8053.00,0.00
2024-12-10 17:22:37,103,6190,50,53,3888.66,8053.01,0.00
2024-12-10 17:22:37,102,6190,49,53,3925.20,8053.02,0.00
2024-12-10 17:22:37,103,6189,50,53,3879.28,8053.14,0.00
2024-12-10 17:22:37,103,6190,50,53,3856.42,8054.00,0.00
2024-12-10 17:22:37,104,6190,50,54,3819.34,8054.01,0.00
2024-12-10 17:22:37,103,6190,50,53,3854.86,8054.02,0.00
2024-12-10 17:22:37,102,6190,49,53,3891.86,8054.02,0.00
2024-12-10 17:22:37,101,6190,48,53,3875.74,8054.63,0.00
2024-12-10 17:22:37,100,6190,47,53,3883.03,8054.84,0.00
2024-12-10 17:22:37,99,6190,47,52,3908.63,8054.91,0.00
2024-12-10 17:22:37,99,6191,47,52,4044.57,8055.00,0.00
2024-12-10 17:22:37,100,6191,47,53,4004.13,8055.01,0.00
2024-12-10 17:22:37,99,6191,46,53,4042.95,8055.02,0.00
2024-12-10 17:22:37,98,6191,45,53,3999.25,8055.95,0.00
2024-12-10 17:22:37,98,6192,45,53,4077.38,8056.00,0.00
2024-12-10 17:22:37,99,6192,45,54,4036.20,8056.01,0.00
2024-12-10 17:22:37,98,6192,44,54,4075.74,8056.02,0.00
2024-12-10 17:22:37,98,6193,44,54,4074.88,8057.00,0.00
2024-12-10 17:22:37,99,6193,44,55,4033.72,8057.01,0.00
2024-12-10 17:22:37,98,6193,44,54,4073.24,8057.02,0.00
2024-12-10 17:22:37,99,6192,44,55,3967.50,8057.75,0.00
2024-12-10 17:22:37,99,6193,44,55,4048.29,8058.00,0.00
2024-12-10 17:22:37,100,6193,44,56,4007.80,8058.01,0.00
2024-12-10 17:22:37,99,6193,44,55,4021.54,8058.24,0.00
2024-12-10 17:22:37,99,6194,44,55,4123.75,8059.00,0.00
2024-12-10 17:22:37,100,6194,45,55,4082.52,8059.01,0.00
2024-12-10 17:22:37,99,6194,45,54,4122.13,8059.02,0.00
2024-12-10 17:22:37,99,6195,45,54,4125.08,8060.00,0.00
2024-12-10 17:22:37,100,6195,46,54,4083.83,8060.01,0.00
2024-12-10 17:22:37,99,6195,46,53,4123.45,8060.02,0.00
2024-12-10 17:22:37,99,6196,46,53,4123.03,8061.00,0.00
2024-12-10 17:22:37,100,6196,47,53,4081.80,8061.01,0.00
2024-12-10 17:22:37,99,6196,47,52,4121.41,8061.02,0.00
2024-12-10 17:22:37,99,6197,47,52,4116.94,8062.00,0.00
2024-12-10 17:22:37,100,6197,48,52,4075.77,8062.01,0.00
2024-12-10 17:22:37,99,6197,48,51,4115.31,8062.02,0.00
2024-12-10 17:22:37,99,6198,48,51,4106.70,8063.00,0.00
2024-12-10 17:22:37,100,6198,49,51,4065.63,8063.01,0.00
2024-12-10 17:22:37,99,6198,48,51,4105.88,8063.01,0.00
2024-12-10 17:22:37,98,6198,47,51,4146.96,8063.01,0.00
2024-12-10 17:22:37,97,6198,47,50,4141.15,8063.42,0.00
2024-12-10 17:22:37,98,6197,47,51,4085.82,8063.60,0.00
2024-12-10 17:22:37,98,6198,47,51,4167.59,8064.00,0.00
2024-12-10 17:22:37,99,6198,48,51,4125.50,8064.01,0.00
2024-12-10 17:22:37,99,6199,48,51,4209.10,8065.00,0.00
2024-12-10 17:22:37,100,6199,49,51,4167.01,8065.01,0.00
2024-12-10 17:22:37,99,6199,49,50,4207.48,8065.02,0.00
2024-12-10 17:22:37,99,6200,49,50,4210.44,8066.00,0.00
2024-12-10 17:22:37,100,6200,49,51,4168.34,8066.01,0.00
2024-12-10 17:22:37,100,6201,49,51,4162.01,8067.00,0.00
2024-12-10 17:22:37,101,6201,50,51,4120.80,8067.01,0.00
2024-12-10 17:22:37,100,6201,49,51,4160.40,8067.02,0.00
2024-12-10 17:22:37,100,6202,49,51,4146.65,8068.00,0.00
2024-12-10 17:22:37,101,6202,49,52,4105.60,8068.01,0.00
2024-12-10 17:22:37,102,6201,50,52,4065.34,8068.03,0.00
2024-12-10 17:22:37,101,6201,50,51,4115.99,8068.03,0.00
2024-12-10 17:22:37,100,6201,50,50,4152.76,8068.05,0.00
2024-12-10 17:22:37,100,6202,50,50,4132.85,8069.00,0.00
2024-12-10 17:22:37,101,6202,51,50,4091.93,8069.01,0.00
2024-12-10 17:22:37,100,6202,50,50,4131.24,8069.02,0.00
2024-12-10 17:22:37,99,6202,50,49,4113.59,8069.66,0.00
2024-12-10 17:22:37,99,6203,50,49,4249.18,8070.00,0.00
2024-12-10 17:22:37,100,6203,50,50,4206.68,8070.01,0.00
2024-12-10 17:22:37,99,6203,50,49,4247.55,8070.02,0.00
2024-12-10 17:22:37,99,6204,50,49,4250.52,8071.00,0.00
2024-12-10 17:22:37,100,6204,51,49,4208.01,8071.01,0.00
2024-12-10 17:22:37,100,6205,51,49,4209.34,8072.00,0.00
2024-12-10 17:22:37,101,6205,52,49,4167.66,8072.01,0.00
2024-12-10 17:22:37,101,6206,52,49,4168.18,8073.00,0.00
2024-12-10 17:22:37,102,6206,52,50,4127.32,8073.01,0.00
2024-12-10 17:22:37,101,6206,51,50,4166.59,8073.02,0.00
2024-12-10 17:22:37,101,6207,51,50,4167.90,8074.00,0.00
2024-12-10 17:22:37,102,6207,51,51,4127.04,8074.01,0.00
2024-12-10 17:22:37,101,6207,51,50,4166.31,8074.02,0.00
2024-12-10 17:22:37,101,6208,51,50,4167.62,8075.00,0.00
2024-12-10 17:22:37,102,6208,51,51,4126.76,8075.01,0.00
2024-12-10 17:22:37,101,6208,51,50,4166.03,8075.02,0.00
2024-12-10 17:22:37,101,6209,51,50,4167.33,8076.00,0.00
2024-12-10 17:22:37,102,6209,51,51,4126.47,8076.01,0.00
2024-12-10 17:22:37,101,6209,51,50,4165.74,8076.02,0.00
2024-12-10 17:22:37,102,6208,51,51,4079.95,8076.60,0.00
2024-12-10 17:22:37,102,6209,51,51,4202.51,8077.00,0.00
2024-12-10 17:22:37,103,6209,51,52,4161.71,8077.01,0.00
2024-12-10 17:22:37,102,6209,51,51,4200.93,8077.02,0.00
2024-12-10 17:22:37,103,6208,52,51,4144.49,8077.23,0.00
2024-12-10 17:22:37,104,6207,52,52,4148.98,8077.44,0.00
2024-12-10 17:22:37,104,6208,52,52,4302.40,8078.00,0.00
2024-12-10 17:22:37,105,6208,52,53,4261.43,8078.01,0.00
2024-12-10 17:22:37,104,6208,52,52,4300.86,8078.02,0.00
2024-12-10 17:22:37,105,6207,53,52,4207.08,8078.70,0.00
2024-12-10 17:22:37,105,6208,53,52,4432.77,8079.00,0.00
2024-12-10 17:22:37,106,6208,54,52,4390.95,8079.01,0.00
2024-12-10 17:22:37,105,6208,54,51,4431.24,8079.02,0.00
2024-12-10 17:22:37,105,6209,54,51,4481.18,8080.00,0.00
2024-12-10 17:22:37,106,6209,55,51,4438.90,8080.01,0.00
2024-12-10 17:22:38,106,6210,55,51,4367.23,8081.00,0.00
2024-12-10 17:22:38,107,6210,55,52,4326.41,8081.01,0.00
2024-12-10 17:22:38,106,6210,55,51,4365.71,8081.02,0.00
2024-12-10 17:22:38,107,6209,55,52,4177.27,8081.91,0.00
2024-12-10 17:22:38,107,6210,55,52,4237.16,8082.00,0.00
2024-12-10 17:22:38,108,6210,56,52,4197.92,8082.01,0.00
2024-12-10 17:22:38,107,6210,56,51,4234.90,8082.03,0.00
2024-12-10 17:22:38,106,6210,56,50,4177.85,8082.71,0.00
2024-12-10 17:22:38,105,6210,55,50,4158.16,8082.87,0.00
2024-12-10 17:22:38,105,6211,55,50,4240.13,8083.00,0.00
2024-12-10 17:22:38,106,6211,55,51,4200.13,8083.01,0.00
2024-12-10 17:22:38,105,6211,55,50,4194.90,8083.37,0.00
2024-12-10 17:22:38,104,6211,55,49,4137.06,8083.88,0.00
2024-12-10 17:22:38,104,6212,55,49,4177.50,8084.00,0.00
2024-12-10 17:22:38,105,6212,56,49,4137.72,8084.01,0.00
2024-12-10 17:22:38,104,6212,56,48,4175.18,8084.03,0.00
2024-12-10 17:22:38,103,6212,56,47,4179.34,8084.48,0.00
2024-12-10 17:22:38,102,6212,55,47,4183.07,8084.85,0.00
2024-12-10 17:22:38,102,6213,55,47,4220.11,8085.00,0.00
2024-12-10 17:22:38,103,6213,55,48,4179.14,8085.01,0.00
2024-12-10 17:22:38,102,6213,54,48,4217.74,8085.03,0.00
2024-12-10 17:22:38,101,6213,54,47,4164.93,8085.91,0.00
2024-12-10 17:22:38,101,6214,54,47,4234.12,8086.00,0.00
2024-12-10 17:22:38,102,6214,54,48,4192.61,8086.01,0.00
2024-12-10 17:22:38,101,6214,53,48,4231.73,8086.03,0.00
2024-12-10 17:22:38,102,6213,54,48,4138.66,8086.51,0.00
2024-12-10 17:22:38,102,6214,54,48,4213.96,8087.00,0.00
2024-12-10 17:22:38,103,6214,54,49,4173.05,8087.01,0.00
2024-12-10 17:22:38,102,6214,54,48,4211.59,8087.03,0.00
2024-12-10 17:22:38,103,6213,54,49,4165.21,8087.12,0.00
2024-12-10 17:22:38,102,6213,54,48,4237.42,8087.46,0.00
2024-12-10 17:22:38,102,6214,54,48,4352.79,8088.00,0.00
2024-12-10 17:22:38,103,6214,55,48,4310.53,8088.01,0.00
2024-12-10 17:22:38,102,6214,54,48,4350.42,8088.03,0.00
2024-12-10 17:22:38,103,6213,54,49,4288.81,8088.22,0.00
2024-12-10 17:22:38,103,6214,54,49,4434.85,8089.00,0.00
2024-12-10 17:22:38,104,6214,54,50,4392.21,8089.01,0.00
2024-12-10 17:22:38,103,6214,54,49,4432.50,8089.03,0.00
2024-12-10 17:22:38,102,6214,54,48,4465.16,8089.13,0.00
2024-12-10 17:22:38,101,6214,54,47,4496.58,8089.25,0.00
2024-12-10 17:22:38,101,6215,54,47,4589.08,8090.00,0.00
2024-12-10 17:22:38,102,6215,54,48,4544.09,8090.01,0.00
2024-12-10 17:22:38,101,6215,53,48,4586.69,8090.03,0.00
2024-12-10 17:22:38,101,6216,53,48,4570.72,8091.00,0.00
2024-12-10 17:22:38,102,6216,54,48,4525.91,8091.01,0.00
2024-12-10 17:22:38,101,6216,54,47,4568.33,8091.03,0.00
2024-12-10 17:22:38,100,6216,53,47,4609.89,8091.05,0.00
2024-12-10 17:22:38,100,6217,53,47,4592.42,8092.00,0.00
2024-12-10 17:22:38,101,6217,54,47,4546.95,8092.01,0.00
2024-12-10 17:22:38,100,6217,53,47,4590.01,8092.03,0.00
2024-12-10 17:22:38,100,6218,53,47,4567.29,8093.00,0.00
2024-12-10 17:22:38,101,6218,53,48,4522.07,8093.01,0.00
2024-12-10 17:22:38,100,6218,53,47,4564.87,8093.03,0.00
2024-12-10 17:22:38,99,6218,53,46,4507.38,8093.75,0.00
2024-12-10 17:22:38,99,6219,53,46,4563.87,8094.00,0.00
2024-12-10 17:22:38,100,6219,54,46,4518.23,8094.01,0.00
2024-12-10 17:22:38,100,6220,54,46,4483.60,8095.00,0.00
2024-12-10 17:22:38,101,6220,55,46,4439.21,8095.01,0.00
2024-12-10 17:22:38,101,6221,55,46,4403.33,8096.00,0.00
2024-12-10 17:22:38,102,6221,56,46,4360.16,8096.01,0.00
2024-12-10 17:22:38,101,6221,55,46,4400.14,8096.04,0.00
2024-12-10 17:22:38,100,6221,55,45,4406.03,8096.38,0.00
2024-12-10 17:22:38,100,6222,55,45,4434.73,8097.00,0.00
2024-12-10 17:22:38,101,6222,56,45,4390.82,8097.01,0.00
2024-12-10 17:22:38,100,6222,56,44,4431.50,8097.04,0.00
2024-12-10 17:22:38,99,6222,55,44,4449.77,8097.18,0.00
2024-12-10 17:22:38,100,6221,55,45,4392.37,8097.36,0.00
2024-12-10 17:22:38,101,6220,56,45,4384.24,8097.53,0.00
2024-12-10 17:22:38,101,6221,56,45,4457.46,8098.00,0.00
2024-12-10 17:22:38,102,6221,56,46,4413.76,8098.01,0.00
2024-12-10 17:22:38,101,6221,55,46,4454.27,8098.04,0.00
2024-12-10 17:22:38,102,6220,56,46,4397.65,8098.16,0.00
2024-12-10 17:22:38,102,6221,56,46,4633.45,8099.00,0.00
2024-12-10 17:22:38,103,6221,56,47,4588.47,8099.01,0.00
2024-12-10 17:22:38,103,6222,56,47,4641.49,8100.00,0.00
2024-12-10 17:22:38,104,6222,56,48,4596.86,8100.01,0.00
2024-12-10 17:22:38,103,6222,56,47,4608.80,8100.24,0.00
2024-12-10 17:22:38,104,6221,57,47,4560.60,8100.31,0.00
2024-12-10 17:22:38,104,6222,57,47,4573.29,8101.00,0.00
2024-12-10 17:22:38,105,6222,58,47,4529.74,8101.01,0.00
2024-12-10 17:22:38,104,6222,58,46,4568.75,8101.05,0.00
2024-12-10 17:22:38,105,6221,59,46,4515.40,8101.12,0.00
2024-12-10 17:22:38,104,6221,59,45,4521.16,8101.94,0.00
2024-12-10 17:22:38,104,6222,59,45,4672.32,8102.00,0.00
2024-12-10 17:22:38,105,6222,59,46,4627.82,8102.01,0.00
2024-12-10 17:22:38,104,6222,58,46,4668.16,8102.05,0.00
2024-12-10 17:22:38,104,6223,58,46,4726.74,8103.00,0.00
2024-12-10 17:22:38,105,6223,58,47,4681.73,8103.01,0.00
2024-12-10 17:22:38,104,6223,57,47,4722.87,8103.05,0.00
2024-12-10 17:22:38,104,6224,57,47,4698.63,8104.00,0.00
2024-12-10 17:22:38,105,6224,58,47,4653.89,8104.01,0.00
2024-12-10 17:22:38,104,6224,58,46,4694.76,8104.05,0.00
2024-12-10 17:22:38,103,6224,58,45,4734.77,8104.07,0.00
2024-12-10 17:22:38,103,6225,58,45,4714.84,8105.00,0.00
2024-12-10 17:22:38,104,6225,58,46,4669.50,8105.01,0.00
2024-12-10 17:22:38,104,6226,58,46,4642.69,8106.00,0.00
2024-12-10 17:22:38,105,6226,58,47,4598.48,8106.01,0.00
2024-12-10 17:22:38,104,6226,57,47,4638.81,8106.05,0.00
2024-12-10 17:22:38,103,6226,56,47,4618.88,8106.76,0.00
2024-12-10 17:22:39,103,6227,56,47,4673.62,8107.00,0.00
2024-12-10 17:22:39,104,6227,56,48,4628.68,8107.01,0.00
2024-12-10 17:22:39,103,6227,55,48,4669.71,8107.05,0.00
2024-12-10 17:22:39,104,6226,56,48,4565.01,8107.75,0.00
2024-12-10 17:22:39,104,6227,56,48,4643.29,8108.00,0.00
2024-12-10 17:22:39,105,6227,57,48,4599.07,8108.01,0.00
2024-12-10 17:22:39,106,6226,57,49,4552.64,8108.07,0.00
2024-12-10 17:22:39,106,6227,57,49,4627.87,8109.00,0.00
2024-12-10 17:22:39,107,6227,58,49,4584.62,8109.01,0.00
2024-12-10 17:22:39,107,6228,58,49,4634.52,8110.00,0.00
2024-12-10 17:22:39,108,6228,58,50,4591.61,8110.01,0.00
2024-12-10 17:22:39,109,6227,59,50,4533.68,8110.14,0.00
2024-12-10 17:22:39,109,6228,59,50,4577.13,8111.00,0.00
2024-12-10 17:22:39,110,6228,59,51,4535.52,8111.01,0.00
2024-12-10 17:22:39,109,6228,58,51,4569.64,8111.06,0.00
2024-12-10 17:22:39,108,6228,58,50,4516.57,8111.73,0.00
2024-12-10 17:22:39,108,6229,58,50,4615.11,8112.00,0.00
2024-12-10 17:22:39,109,6229,58,51,4572.77,8112.01,0.00
2024-12-10 17:22:39,108,6229,57,51,4613.61,8112.02,0.00
2024-12-10 17:22:39,107,6229,57,50,4642.46,8112.06,0.00
2024-12-10 17:22:39,106,6229,57,49,4685.49,8112.06,0.00
2024-12-10 17:22:39,105,6229,57,48,4692.66,8112.37,0.00
2024-12-10 17:22:39,105,6230,57,48,4645.29,8113.00,0.00
2024-12-10 17:22:39,106,6230,58,48,4601.47,8113.01,0.00
2024-12-10 17:22:39,105,6230,58,47,4574.03,8113.55,0.00
2024-12-10 17:22:39,105,6231,58,47,4527.92,8114.00,0.00
2024-12-10 17:22:39,106,6231,58,48,4485.21,8114.01,0.00
2024-12-10 17:22:39,105,6231,58,47,4508.10,8114.05,0.00
2024-12-10 17:22:39,104,6231,57,47,4485.45,8114.72,0.00
2024-12-10 17:22:39,104,6232,57,47,4470.79,8115.00,0.00
2024-12-10 17:22:39,105,6232,57,48,4428.21,8115.01,0.00
2024-12-10 17:22:39,104,6232,57,47,4464.22,8115.05,0.00
2024-12-10 17:22:39,104,6233,57,47,4376.57,8116.00,0.00
2024-12-10 17:22:39,105,6233,57,48,4334.88,8116.01,0.00
2024-12-10 17:22:39,104,6233,57,47,4369.95,8116.05,0.00
2024-12-10 17:22:39,104,6234,57,47,4298.43,8117.00,0.00
2024-12-10 17:22:39,105,6234,57,48,4257.49,8117.01,0.00
2024-12-10 17:22:39,104,6234,56,48,4291.74,8117.05,0.00
2024-12-10 17:22:39,103,6234,55,48,4321.65,8117.19,0.00
2024-12-10 17:22:39,104,6233,56,48,4269.60,8117.31,0.00
2024-12-10 17:22:39,104,6234,56,48,4232.31,8118.00,0.00
2024-12-10 17:22:39,105,6234,56,49,4192.00,8118.01,0.00
2024-12-10 17:22:39,104,6234,56,48,4142.90,8118.85,0.00
2024-12-10 17:22:39,103,6234,55,48,4174.89,8118.88,0.00
2024-12-10 17:22:39,102,6234,55,47,4178.36,8118.93,0.00
2024-12-10 17:22:39,101,6234,55,46,4214.26,8118.94,0.00
2024-12-10 17:22:39,101,6235,55,46,4347.03,8119.00,0.00
2024-12-10 17:22:39,102,6235,56,46,4304.42,8119.01,0.00
2024-12-10 17:22:39,101,6235,56,45,4274.95,8119.59,0.00
2024-12-10 17:22:39,101,6236,56,45,4278.84,8120.00,0.00
2024-12-10 17:22:39,102,6236,57,45,4236.90,8120.01,0.00
2024-12-10 17:22:39,101,6236,56,45,4268.61,8120.06,0.00
2024-12-10 17:22:39,100,6236,55,45,4270.20,8120.28,0.00
2024-12-10 17:22:39,99,6236,55,44,4251.68,8120.91,0.00
2024-12-10 17:22:39,99,6237,55,44,4310.22,8121.00,0.00
2024-12-10 17:22:39,100,6237,56,44,4267.11,8121.01,0.00
2024-12-10 17:22:39,99,6237,55,44,4284.62,8121.14,0.00
2024-12-10 17:22:39,98,6237,54,44,4236.26,8121.92,0.00
2024-12-10 17:22:39,98,6238,54,44,4305.57,8122.00,0.00
2024-12-10 17:22:39,99,6238,55,44,4262.08,8122.01,0.00
2024-12-10 17:22:39,98,6238,54,44,4293.97,8122.06,0.00
2024-12-10 17:22:39,97,6238,53,44,4331.85,8122.13,0.00
2024-12-10 17:22:39,96,6238,53,43,4295.17,8122.92,0.00
2024-12-10 17:22:39,96,6239,53,43,4373.09,8123.00,0.00
2024-12-10 17:22:39,97,6239,53,44,4328.00,8123.01,0.00
2024-12-10 17:22:39,96,6239,52,44,4264.11,8123.90,0.00
2024-12-10 17:22:39,96,6240,52,44,4340.36,8124.00,0.00
2024-12-10 17:22:39,97,6240,53,44,4295.62,8124.01,0.00
2024-12-10 17:22:39,96,6240,52,44,4331.59,8124.04,0.00
2024-12-10 17:22:39,96,6241,52,44,4290.32,8125.00,0.00
2024-12-10 17:22:39,97,6241,53,44,4246.09,8125.01,0.00
2024-12-10 17:22:39,97,6242,53,44,4194.90,8126.00,0.00
2024-12-10 17:22:39,98,6242,54,44,4152.10,8126.01,0.00
2024-12-10 17:22:39,97,6242,53,44,4189.07,8126.07,0.00
2024-12-10 17:22:39,98,6241,54,44,4144.67,8126.11,0.00
2024-12-10 17:22:39,97,6241,54,43,4264.27,8126.12,0.00
2024-12-10 17:22:39,96,6241,54,42,4201.32,8126.93,0.00
2024-12-10 17:22:39,96,6242,54,42,4280.11,8127.00,0.00
2024-12-10 17:22:39,97,6242,54,43,4235.99,8127.01,0.00
2024-12-10 17:22:39,96,6242,54,42,4274.22,8127.07,0.00
2024-12-10 17:22:39,96,6243,54,42,4358.16,8128.00,0.00
2024-12-10 17:22:39,97,6243,54,43,4313.23,8128.01,0.00
2024-12-10 17:22:39,97,6244,54,43,4302.11,8129.00,0.00
2024-12-10 17:22:39,98,6244,55,43,4258.21,8129.01,0.00
2024-12-10 17:22:39,97,6244,55,42,4296.27,8129.07,0.00
2024-12-10 17:22:39,97,6245,55,42,4284.47,8130.00,0.00
2024-12-10 17:22:39,98,6245,56,42,4240.75,8130.01,0.00
2024-12-10 17:22:39,97,6245,55,42,4246.97,8130.34,0.00
2024-12-10 17:22:39,97,6246,55,42,4267.38,8131.00,0.00
2024-12-10 17:22:39,98,6246,56,42,4223.83,8131.01,0.00
2024-12-10 17:22:39,97,6246,56,41,4260.36,8131.08,0.00
2024-12-10 17:22:39,96,6246,56,40,4238.33,8131.78,0.00
2024-12-10 17:22:39,96,6247,56,40,4282.60,8132.00,0.00
2024-12-10 17:22:39,97,6247,56,41,4238.45,8132.01,0.00
2024-12-10 17:22:39,97,6248,56,41,4207.98,8133.00,0.00
2024-12-10 17:22:39,98,6248,57,41,4165.04,8133.01,0.00
2024-12-10 17:22:39,97,6248,57,40,4105.92,8133.90,0.00
2024-12-10 17:22:39,97,6249,57,40,4181.48,8134.00,0.00
2024-12-10 17:22:39,98,6249,57,41,4138.81,8134.01,0.00
2024-12-10 17:22:40,98,6250,57,41,4135.27,8135.00,0.00
2024-12-10 17:22:40,99,6250,58,41,4093.50,8135.01,0.00
2024-12-10 17:22:40,99,6251,58,41,4084.45,8136.00,0.00
2024-12-10 17:22:40,100,6251,58,42,4043.61,8136.01,0.00
2024-12-10 17:22:40,100,6252,58,42,3970.26,8137.00,0.00
2024-12-10 17:22:40,101,6252,59,42,3930.95,8137.01,0.00
2024-12-10 17:22:40,100,6252,59,41,3856.65,8137.92,0.00
2024-12-10 17:22:40,100,6253,59,41,3931.59,8138.00,0.00
2024-12-10 17:22:40,101,6253,60,41,3892.66,8138.01,0.00
2024-12-10 17:22:40,101,6254,60,41,3867.11,8139.00,0.00
2024-12-10 17:22:40,102,6254,60,42,3829.19,8139.01,0.00
2024-12-10 17:22:40,101,6254,60,41,3799.38,8139.64,0.00
2024-12-10 17:22:40,102,6253,60,42,3747.88,8139.83,0.00
2024-12-10 17:22:40,102,6254,60,42,3828.63,8140.00,0.00
2024-12-10 17:22:40,103,6254,60,43,3791.46,8140.01,0.00
2024-12-10 17:22:40,102,6254,60,42,3776.73,8140.51,0.00
2024-12-10 17:22:40,102,6255,60,42,3896.78,8141.00,0.00
2024-12-10 17:22:40,103,6255,60,43,3858.95,8141.01,0.00
2024-12-10 17:22:40,103,6256,60,43,3846.57,8142.00,0.00
2024-12-10 17:22:40,104,6256,61,43,3809.58,8142.01,0.00
2024-12-10 17:22:40,103,6256,60,43,3839.04,8142.09,0.00
2024-12-10 17:22:40,102,6256,59,43,3841.07,8142.48,0.00
2024-12-10 17:22:40,103,6255,60,43,3770.83,8142.90,0.00
2024-12-10 17:22:40,103,6256,60,43,3792.97,8143.00,0.00
2024-12-10 17:22:40,104,6256,61,43,3756.49,8143.01,0.00
2024-12-10 17:22:40,103,6256,60,43,3784.94,8143.09,0.00
2024-12-10 17:22:40,104,6255,60,44,3725.89,8143.39,0.00
2024-12-10 17:22:40,105,6254,61,44,3708.19,8143.78,0.00
2024-12-10 17:22:40,104,6254,61,43,3715.84,8143.89,0.00
2024-12-10 17:22:40,104,6255,61,43,3807.46,8144.00,0.00
2024-12-10 17:22:40,105,6255,61,44,3771.20,8144.01,0.00
2024-12-10 17:22:40,104,6255,60,44,3806.31,8144.02,0.00
2024-12-10 17:22:40,103,6255,60,43,3837.76,8144.08,0.00
2024-12-10 17:22:40,103,6256,60,43,3995.83,8145.00,0.00
2024-12-10 17:22:40,104,6256,60,44,3957.41,8145.01,0.00
2024-12-10 17:22:40,103,6256,60,43,3989.52,8145.08,0.00
2024-12-10 17:22:40,104,6255,60,44,3882.61,8145.85,0.00
2024-12-10 17:22:40,104,6256,60,44,3958.73,8146.00,0.00
2024-12-10 17:22:40,105,6256,60,45,3921.03,8146.01,0.00
2024-12-10 17:22:40,104,6256,59,45,3952.48,8146.08,0.00
2024-12-10 17:22:40,103,6256,59,44,3946.19,8146.42,0.00
2024-12-10 17:22:40,103,6257,59,44,4056.57,8147.00,0.00
2024-12-10 17:22:40,104,6257,60,44,4017.57,8147.01,0.00
2024-12-10 17:22:40,103,6257,60,43,4053.42,8147.04,0.00
2024-12-10 17:22:40,102,6257,60,42,4089.97,8147.07,0.00
2024-12-10 17:22:40,101,6257,59,42,4129.66,8147.07,0.00
2024-12-10 17:22:40,100,6257,58,42,4145.48,8147.27,0.00
2024-12-10 17:22:40,100,6258,58,42,4164.21,8148.00,0.00
2024-12-10 17:22:40,101,6258,58,43,4122.98,8148.01,0.00
2024-12-10 17:22:40,100,6258,58,42,4158.53,8148.07,0.00
2024-12-10 17:22:40,101,6257,59,42,4060.24,8148.76,0.00
2024-12-10 17:22:40,101,6258,59,42,4138.35,8149.00,0.00
2024-12-10 17:22:40,102,6258,60,42,4097.77,8149.01,0.00
2024-12-10 17:22:40,101,6258,59,42,4132.72,8149.07,0.00
2024-12-10 17:22:40,102,6257,60,42,4043.80,8149.67,0.00
2024-12-10 17:22:40,102,6258,60,42,4200.67,8150.00,0.00
2024-12-10 17:22:40,103,6258,60,43,4159.88,8150.01,0.00
2024-12-10 17:22:40,102,6258,59,43,4195.09,8150.07,0.00
2024-12-10 17:22:40,102,6259,59,43,4276.67,8151.00,0.00
2024-12-10 17:22:40,103,6259,59,44,4235.15,8151.01,0.00
2024-12-10 17:22:40,103,6260,59,44,4229.94,8152.00,0.00
2024-12-10 17:22:40,104,6260,59,45,4189.26,8152.01,0.00
2024-12-10 17:22:40,104,6261,59,45,4180.99,8153.00,0.00
2024-12-10 17:22:40,105,6261,60,45,4141.17,8153.01,0.00
2024-12-10 17:22:40,104,6261,59,45,4174.74,8153.08,0.00
2024-12-10 17:22:40,104,6262,59,45,4168.33,8154.00,0.00
2024-12-10 17:22:40,105,6262,59,46,4128.63,8154.01,0.00
2024-12-10 17:22:40,104,6262,59,45,4161.30,8154.09,0.00
2024-12-10 17:22:40,103,6262,58,45,4181.91,8154.29,0.00
2024-12-10 17:22:40,103,6263,58,45,4196.25,8155.00,0.00
2024-12-10 17:22:40,104,6263,58,46,4155.90,8155.01,0.00
2024-12-10 17:22:40,104,6264,58,46,4144.91,8156.00,0.00
2024-12-10 17:22:40,105,6264,59,46,4105.43,8156.01,0.00
2024-12-10 17:22:40,104,6264,59,45,4137.87,8156.09,0.00
2024-12-10 17:22:40,104,6265,59,45,4133.00,8157.00,0.00
2024-12-10 17:22:40,105,6265,59,46,4093.63,8157.01,0.00
2024-12-10 17:22:40,104,6265,59,45,4125.96,8157.09,0.00
2024-12-10 17:22:40,104,6266,59,45,4120.60,8158.00,0.00
2024-12-10 17:22:40,105,6266,59,46,4081.36,8158.01,0.00
2024-12-10 17:22:40,104,6266,59,45,4113.57,8158.09,0.00
2024-12-10 17:22:40,103,6266,58,45,4125.67,8158.37,0.00
2024-12-10 17:22:40,104,6265,59,45,4072.54,8158.54,0.00
2024-12-10 17:22:40,104,6266,59,45,4142.00,8159.00,0.00
2024-12-10 17:22:40,105,6266,59,46,4102.55,8159.01,0.00
2024-12-10 17:22:40,104,6266,58,46,4134.96,8159.09,0.00
2024-12-10 17:22:40,104,6267,58,46,4192.38,8160.00,0.00
2024-12-10 17:22:40,105,6267,58,47,4152.45,8160.01,0.00
2024-12-10 17:22:40,104,6267,57,47,4185.34,8160.09,0.00
2024-12-10 17:22:40,103,6267,57,46,4194.14,8160.31,0.00
2024-12-10 17:22:40,103,6268,57,46,4195.50,8161.00,0.00
2024-12-10 17:22:40,104,6268,58,46,4155.16,8161.01,0.00
2024-12-10 17:22:40,103,6268,57,46,4188.39,8161.09,0.00
2024-12-10 17:22:40,103,6269,57,46,4167.82,8162.00,0.00
2024-12-10 17:22:40,104,6269,58,46,4127.75,8162.01,0.00
2024-12-10 17:22:40,103,6269,57,46,4160.71,8162.09,0.00
2024-12-10 17:22:40,102,6269,57,45,4164.22,8162.49,0.00
2024-12-10 17:22:40,102,6270,57,45,4189.36,8163.00,0.00
2024-12-10 17:22:40,103,6270,58,45,4148.68,8163.01,0.00
2024-12-10 17:22:40,102,6270,57,45,4186.16,8163.04,0.00
2024-12-10 17:22:40,101,6270,56,45,4223.58,8163.08,0.00
2024-12-10 17:22:40,100,6270,56,44,4265.00,8163.08,0.00
2024-12-10 17:22:40,99,6270,55,44,4297.98,8163.19,0.00
2024-12-10 17:22:41,99,6271,55,44,4302.30,8164.00,0.00
2024-12-10 17:22:41,100,6271,55,45,4259.27,8164.01,0.00
2024-12-10 17:22:41,99,6271,55,44,4246.17,8164.65,0.00
2024-12-10 17:22:41,99,6272,55,44,4300.06,8165.00,0.00
2024-12-10 17:22:41,100,6272,55,45,4257.06,8165.01,0.00
2024-12-10 17:22:41,101,6271,56,45,4211.69,8165.07,0.00
2024-12-10 17:22:41,100,6271,55,45,4323.23,8165.09,0.00
2024-12-10 17:22:41,99,6271,54,45,4364.23,8165.10,0.00
2024-12-10 17:22:41,98,6271,54,44,4378.40,8165.44,0.00
2024-12-10 17:22:41,98,6272,54,44,4416.33,8166.00,0.00
2024-12-10 17:22:41,99,6272,54,45,4371.72,8166.01,0.00
2024-12-10 17:22:41,98,6272,54,44,4409.69,8166.08,0.00
2024-12-10 17:22:41,97,6272,54,43,4448.36,8166.11,0.00
2024-12-10 17:22:41,98,6271,55,43,4337.43,8166.93,0.00
2024-12-10 17:22:41,98,6272,55,43,4503.33,8167.00,0.00
2024-12-10 17:22:41,99,6272,56,43,4457.84,8167.01,0.00
2024-12-10 17:22:41,99,6273,56,43,4540.64,8168.00,0.00
2024-12-10 17:22:41,100,6273,57,43,4495.23,8168.01,0.00
2024-12-10 17:22:41,99,6273,56,43,4539.81,8168.01,0.00
2024-12-10 17:22:41,98,6273,56,42,4580.33,8168.07,0.00
2024-12-10 17:22:41,97,6273,56,41,4619.71,8168.17,0.00
2024-12-10 17:22:41,98,6272,57,41,4546.65,8168.49,0.00
2024-12-10 17:22:41,99,6271,58,41,4511.92,8168.77,0.00
2024-12-10 17:22:41,99,6272,58,41,4591.35,8169.00,0.00
2024-12-10 17:22:41,100,6272,58,42,4545.44,8169.01,0.00
2024-12-10 17:22:41,99,6272,57,42,4591.33,8169.01,0.00
2024-12-10 17:22:41,98,6272,56,42,4633.21,8169.06,0.00
2024-12-10 17:22:41,98,6273,56,42,4802.88,8170.00,0.00
2024-12-10 17:22:41,99,6273,57,42,4754.37,8170.01,0.00
2024-12-10 17:22:41,98,6273,57,41,4797.91,8170.06,0.00
2024-12-10 17:22:41,99,6272,58,41,4726.85,8170.34,0.00
2024-12-10 17:22:41,100,6271,58,42,4719.50,8170.70,0.00
2024-12-10 17:22:41,100,6272,58,42,4797.58,8171.00,0.00
2024-12-10 17:22:41,101,6272,59,42,4750.08,8171.01,0.00
2024-12-10 17:22:41,100,6272,58,42,4747.86,8171.60,0.00
2024-12-10 17:22:41,100,6273,58,42,4950.89,8172.00,0.00
2024-12-10 17:22:41,101,6273,59,42,4901.87,8172.01,0.00
2024-12-10 17:22:41,102,6272,60,42,4784.17,8172.74,0.00
2024-12-10 17:22:41,102,6273,60,42,4852.81,8173.00,0.00
2024-12-10 17:22:41,103,6273,61,42,4805.69,8173.01,0.00
2024-12-10 17:22:41,102,6273,61,41,4842.86,8173.13,0.00
2024-12-10 17:22:41,103,6272,61,42,4776.01,8173.38,0.00
2024-12-10 17:22:41,104,6271,61,43,4728.34,8173.75,0.00
2024-12-10 17:22:41,104,6272,61,43,4869.72,8174.00,0.00
2024-12-10 17:22:41,105,6272,62,43,4823.35,8174.01,0.00
2024-12-10 17:22:41,104,6272,61,43,4854.49,8174.19,0.00
2024-12-10 17:22:41,104,6273,61,43,4995.29,8175.00,0.00
2024-12-10 17:22:41,105,6273,62,43,4947.72,8175.01,0.00
2024-12-10 17:22:41,105,6274,62,43,4909.64,8176.00,0.00
2024-12-10 17:22:41,106,6274,62,44,4863.32,8176.01,0.00
2024-12-10 17:22:41,105,6274,62,43,4843.06,8176.61,0.00
2024-12-10 17:22:41,106,6273,62,44,4790.49,8176.71,0.00
2024-12-10 17:22:41,106,6274,62,44,4828.39,8177.00,0.00
2024-12-10 17:22:41,107,6274,62,45,4783.27,8177.01,0.00
2024-12-10 17:22:41,106,6274,62,44,4823.02,8177.07,0.00
2024-12-10 17:22:41,105,6274,61,44,4868.17,8177.07,0.00
2024-12-10 17:22:41,104,6274,61,43,4828.61,8177.90,0.00
2024-12-10 17:22:41,104,6275,61,43,4978.09,8178.00,0.00
2024-12-10 17:22:41,105,6275,61,44,4930.68,8178.01,0.00
2024-12-10 17:22:41,104,6275,61,43,4972.62,8178.07,0.00
2024-12-10 17:22:41,104,6276,61,43,4966.97,8179.00,0.00
2024-12-10 17:22:41,105,6276,61,44,4919.66,8179.01,0.00
2024-12-10 17:22:41,105,6277,61,44,4906.97,8180.00,0.00
2024-12-10 17:22:41,106,6277,62,44,4860.68,8180.01,0.00
2024-12-10 17:22:41,105,6277,61,44,4901.55,8180.07,0.00
2024-12-10 17:22:41,106,6276,62,44,4849.91,8180.15,0.00
2024-12-10 17:22:41,105,6276,62,43,4953.68,8180.24,0.00
2024-12-10 17:22:41,106,6275,62,44,4823.35,8180.64,0.00
2024-12-10 17:22:41,106,6276,62,44,4876.92,8181.00,0.00
2024-12-10 17:22:41,107,6276,62,45,4831.34,8181.01,0.00
2024-12-10 17:22:41,106,6276,62,44,4871.55,8181.07,0.00
2024-12-10 17:22:41,105,6276,61,44,4872.11,8181.33,0.00
2024-12-10 17:22:41,106,6275,62,44,4820.77,8181.42,0.00
2024-12-10 17:22:41,107,6274,62,45,4805.59,8181.50,0.00
2024-12-10 17:22:41,107,6275,62,45,5014.12,8182.00,0.00
2024-12-10 17:22:41,108,6275,63,45,4967.70,8182.01,0.00
2024-12-10 17:22:41,107,6275,62,45,5008.79,8182.07,0.00
2024-12-10 17:22:41,106,6275,62,44,5015.75,8182.51,0.00
2024-12-10 17:22:41,106,6276,62,44,5207.59,8183.00,0.00
2024-12-10 17:22:41,107,6276,62,45,5158.92,8183.01,0.00
2024-12-10 17:22:41,107,6277,62,45,5154.70,8184.00,0.00
2024-12-10 17:22:41,108,6277,63,45,5106.97,8184.01,0.00
2024-12-10 17:22:41,109,6276,63,46,4985.94,8184.93,0.00
2024-12-10 17:22:41,109,6277,63,46,5058.10,8185.00,0.00
2024-12-10 17:22:41,110,6277,63,47,5012.12,8185.01,0.00
2024-12-10 17:22:41,110,6278,63,47,5076.62,8186.00,0.00
2024-12-10 17:22:41,111,6278,63,48,5030.89,8186.01,0.00
2024-12-10 17:22:41,112,6277,63,49,4962.84,8186.29,0.00
2024-12-10 17:22:41,113,6276,63,50,4920.41,8186.59,0.00
2024-12-10 17:22:41,114,6275,64,50,4856.00,8186.95,0.00
2024-12-10 17:22:41,114,6276,64,50,4926.43,8187.00,0.00
2024-12-10 17:22:41,115,6276,64,51,4883.59,8187.01,0.00
2024-12-10 17:22:41,114,6276,64,50,4921.42,8187.06,0.00
2024-12-10 17:22:41,114,6277,64,50,5103.01,8188.00,0.00
2024-12-10 17:22:41,115,6277,64,51,5058.64,8188.01,0.00
2024-12-10 17:22:41,116,6276,65,51,5011.51,8188.07,0.00
2024-12-10 17:22:41,115,6276,64,51,5085.72,8188.07,0.00
2024-12-10 17:22:41,114,6276,64,50,5122.23,8188.14,0.00
2024-12-10 17:22:41,114,6277,64,50,5087.75,8189.00,0.00
2024-12-10 17:22:41,115,6277,64,51,5043.51,8189.01,0.00
2024-12-10 17:22:41,114,6277,63,51,5073.06,8189.18,0.00
2024-12-10 17:22:41,113,6277,62,51,5073.50,8189.35,0.00
2024-12-10 17:22:41,113,6278,62,51,5165.32,8190.00,0.00
2024-12-10 17:22:41,114,6278,63,51,5120.01,8190.01,0.00
2024-12-10 17:22:41,113,6278,63,50,5160.27,8190.06,0.00
2024-12-10 17:22:41,112,6278,62,50,5190.65,8190.22,0.00
2024-12-10 17:22:41,112,6279,62,50,5200.72,8191.00,0.00
2024-12-10 17:22:41,113,6279,63,50,5154.70,8191.01,0.00
2024-12-10 17:22:42,113,6280,63,50,5146.56,8192.00,0.00
2024-12-10 17:22:42,114,6280,64,50,5101.41,8192.01,0.00
2024-12-10 17:22:42,113,6280,63,50,5141.50,8192.06,0.00
2024-12-10 17:22:42,113,6281,63,50,5137.23,8193.00,0.00
2024-12-10 17:22:42,114,6281,64,50,5092.17,8193.01,0.00
2024-12-10 17:22:42,113,6281,64,49,5132.18,8193.06,0.00
2024-12-10 17:22:42,113,6282,64,49,5125.42,8194.00,0.00
2024-12-10 17:22:42,114,6282,65,49,5080.46,8194.01,0.00
2024-12-10 17:22:42,114,6283,65,49,5064.06,8195.00,0.00
2024-12-10 17:22:42,115,6283,65,50,5020.02,8195.01,0.00
2024-12-10 17:22:42,115,6284,65,50,4999.79,8196.00,0.00
2024-12-10 17:22:42,116,6284,66,50,4956.69,8196.01,0.00
2024-12-10 17:22:42,115,6284,65,50,4994.12,8196.07,0.00
2024-12-10 17:22:42,115,6285,65,50,4975.89,8197.00,0.00
2024-12-10 17:22:42,116,6285,65,51,4932.99,8197.01,0.00
2024-12-10 17:22:42,115,6285,64,51,4972.33,8197.04,0.00
2024-12-10 17:22:42,114,6285,63,51,5013.81,8197.06,0.00
2024-12-10 17:22:42,113,6285,62,51,5057.99,8197.06,0.00
2024-12-10 17:22:42,114,6284,62,52,4949.78,8197.73,0.00
2024-12-10 17:22:42,114,6285,62,52,5010.62,8198.00,0.00
2024-12-10 17:22:42,115,6285,62,53,4967.05,8198.01,0.00
2024-12-10 17:22:42,116,6284,63,53,4915.78,8198.13,0.00
2024-12-10 17:22:42,117,6283,64,53,4862.73,8198.51,0.00
2024-12-10 17:22:42,117,6284,64,53,4967.05,8199.00,0.00
2024-12-10 17:22:42,118,6284,64,54,4924.96,8199.01,0.00
2024-12-10 17:22:42,117,6284,64,53,4962.17,8199.06,0.00
2024-12-10 17:22:42,117,6285,64,53,5068.94,8200.00,0.00
2024-12-10 17:22:42,118,6285,64,54,5025.98,8200.01,0.00
2024-12-10 17:22:42,117,6285,63,54,5064.06,8200.06,0.00
2024-12-10 17:22:42,118,6284,63,55,4942.79,8200.71,0.00
2024-12-10 17:22:42,118,6285,63,55,4994.02,8201.00,0.00
2024-12-10 17:22:42,119,6285,63,56,4952.06,8201.01,0.00
2024-12-10 17:22:42,118,6285,62,56,4989.18,8201.06,0.00
2024-12-10 17:22:42,117,6285,61,56,5031.12,8201.06,0.00
2024-12-10 17:22:42,116,6285,60,56,5021.59,8201.60,0.00
2024-12-10 17:22:42,117,6284,61,56,4964.55,8201.64,0.00
2024-12-10 17:22:42,117,6285,61,56,5082.41,8202.00,0.00
2024-12-10 17:22:42,118,6285,61,57,5039.33,8202.01,0.00
2024-12-10 17:22:42,117,6285,61,56,5077.52,8202.06,0.00
2024-12-10 17:22:42,118,6284,62,56,5004.07,8202.45,0.00
2024-12-10 17:22:42,117,6284,62,55,5010.66,8202.73,0.00
2024-12-10 17:22:42,117,6285,62,55,5104.66,8203.00,0.00
2024-12-10 17:22:42,118,6285,62,56,5061.40,8203.01,0.00
2024-12-10 17:22:42,117,6285,61,56,5045.85,8203.61,0.00
2024-12-10 17:22:42,117,6286,61,56,5106.61,8204.00,0.00
2024-12-10 17:22:42,118,6286,61,57,5063.34,8204.01,0.00
2024-12-10 17:22:42,117,6286,60,57,5101.73,8204.06,0.00
2024-12-10 17:22:42,116,6286,60,56,5087.87,8204.64,0.00
2024-12-10 17:22:42,115,6286,60,55,5116.42,8204.77,0.00
2024-12-10 17:22:42,115,6287,60,55,5168.00,8205.00,0.00
2024-12-10 17:22:42,116,6287,61,55,5123.45,8205.01,0.00
2024-12-10 17:22:42,116,6288,61,55,5105.32,8206.00,0.00
2024-12-10 17:22:42,117,6288,61,56,5061.69,8206.01,0.00
2024-12-10 17:22:42,117,6289,61,56,5040.40,8207.00,0.00
2024-12-10 17:22:42,118,6289,61,57,4997.68,8207.01,0.00
2024-12-10 17:22:42,117,6289,60,57,5026.45,8207.17,0.00
2024-12-10 17:22:42,117,6290,60,57,5017.22,8208.00,0.00
2024-12-10 17:22:42,118,6290,60,58,4974.70,8208.01,0.00
2024-12-10 17:22:42,118,6291,60,58,4950.50,8209.00,0.00
2024-12-10 17:22:42,119,6291,61,58,4908.90,8209.01,0.00
2024-12-10 17:22:42,118,6291,60,58,4903.46,8209.56,0.00
2024-12-10 17:22:42,119,6290,60,59,4845.16,8209.78,0.00
2024-12-10 17:22:42,119,6291,60,59,4924.03,8210.00,0.00
2024-12-10 17:22:42,120,6291,60,60,4883.00,8210.01,0.00
2024-12-10 17:22:42,119,6291,59,60,4923.34,8210.01,0.00
2024-12-10 17:22:42,120,6290,60,60,4865.96,8210.23,0.00
2024-12-10 17:22:42,120,6291,60,60,4973.93,8211.00,0.00
2024-12-10 17:22:42,121,6291,61,60,4932.82,8211.01,0.00
2024-12-10 17:22:42,121,6292,61,60,4974.58,8212.00,0.00
2024-12-10 17:22:42,122,6292,62,60,4933.81,8212.01,0.00
2024-12-10 17:22:42,123,6291,63,60,4878.17,8212.21,0.00
2024-12-10 17:22:42,123,6292,63,60,4917.82,8213.00,0.00
2024-12-10 17:22:42,124,6292,64,60,4878.16,8213.01,0.00
2024-12-10 17:22:42,124,6293,64,60,4921.27,8214.00,0.00
2024-12-10 17:22:42,125,6293,64,61,4881.90,8214.01,0.00
2024-12-10 17:22:42,126,6292,64,62,4836.66,8214.10,0.00
2024-12-10 17:22:42,126,6293,64,62,4848.71,8215.00,0.00
2024-12-10 17:22:42,127,6293,64,63,4810.53,8215.01,0.00
2024-12-10 17:22:42,128,6292,65,63,4756.98,8215.22,0.00
2024-12-10 17:22:42,128,6293,65,63,4863.59,8216.00,0.00
2024-12-10 17:22:42,129,6293,65,64,4825.89,8216.01,0.00
2024-12-10 17:22:42,128,6293,65,63,4858.48,8216.06,0.00
2024-12-10 17:22:42,128,6294,65,63,4905.31,8217.00,0.00
2024-12-10 17:22:42,129,6294,66,63,4867.28,8217.01,0.00
2024-12-10 17:22:42,128,6294,65,63,4903.60,8217.02,0.00
2024-12-10 17:22:42,127,6294,65,62,4939.00,8217.06,0.00
2024-12-10 17:22:42,127,6295,65,62,4921.29,8218.00,0.00
2024-12-10 17:22:42,128,6295,66,62,4882.84,8218.01,0.00
2024-12-10 17:22:42,128,6296,66,62,4858.93,8219.00,0.00
2024-12-10 17:22:42,129,6296,66,63,4821.27,8219.01,0.00
2024-12-10 17:22:42,130,6295,67,63,4737.51,8219.57,0.00
2024-12-10 17:22:42,130,6296,67,63,4783.09,8220.00,0.00
2024-12-10 17:22:42,131,6296,67,64,4746.58,8220.01,0.00
2024-12-10 17:22:42,132,6295,67,65,4671.58,8220.50,0.00
2024-12-10 17:22:43,132,6296,67,65,4760.81,8221.00,0.00
2024-12-10 17:22:43,133,6296,67,66,4725.01,8221.01,0.00
2024-12-10 17:22:43,132,6296,66,66,4755.23,8221.07,0.00
2024-12-10 17:22:43,132,6297,66,66,4782.94,8222.00,0.00
2024-12-10 17:22:43,133,6297,66,67,4746.98,8222.01,0.00
2024-12-10 17:22:43,132,6297,65,67,4777.37,8222.07,0.00
2024-12-10 17:22:43,132,6298,65,67,4736.84,8223.00,0.00
2024-12-10 17:22:43,133,6298,66,67,4701.23,8223.01,0.00
2024-12-10 17:22:43,132,6298,65,67,4658.34,8223.64,0.00
2024-12-10 17:22:43,132,6299,65,67,4686.18,8224.00,0.00
2024-12-10 17:22:43,133,6299,66,67,4650.94,8224.01,0.00
2024-12-10 17:22:43,132,6299,65,67,4680.60,8224.07,0.00
2024-12-10 17:22:43,133,6298,65,68,4642.32,8224.12,0.00
2024-12-10 17:22:43,132,6298,64,68,4672.89,8224.57,0.00
2024-12-10 17:22:43,132,6299,64,68,4694.98,8225.00,0.00
2024-12-10 17:22:43,133,6299,65,68,4659.68,8225.01,0.00
2024-12-10 17:22:43,133,6300,65,68,4683.19,8226.00,0.00
2024-12-10 17:22:43,134,6300,65,69,4648.24,8226.01,0.00
2024-12-10 17:22:43,133,6300,65,68,4682.57,8226.01,0.00
2024-12-10 17:22:43,132,6300,64,68,4713.08,8226.06,0.00
2024-12-10 17:22:43,131,6300,64,67,4698.38,8226.45,0.00
2024-12-10 17:22:43,131,6301,64,67,4711.30,8227.00,0.00
2024-12-10 17:22:43,132,6301,64,68,4675.61,8227.01,0.00
2024-12-10 17:22:43,131,6301,64,67,4705.68,8227.07,0.00
2024-12-10 17:22:43,131,6302,64,67,4683.76,8228.00,0.00
2024-12-10 17:22:43,132,6302,64,68,4648.28,8228.01,0.00
2024-12-10 17:22:43,132,6303,64,68,4618.78,8229.00,0.00
2024-12-10 17:22:43,133,6303,65,68,4584.05,8229.01,0.00
2024-12-10 17:22:43,132,6303,64,68,4613.20,8229.07,0.00
2024-12-10 17:22:43,133,6302,65,68,4570.51,8229.18,0.00
2024-12-10 17:22:43,132,6302,64,68,4612.13,8229.69,0.00
2024-12-10 17:22:43,132,6303,64,68,4642.83,8230.00,0.00
2024-12-10 17:22:43,133,6303,65,68,4607.92,8230.01,0.00
2024-12-10 17:22:43,133,6304,65,68,4640.11,8231.00,0.00
2024-12-10 17:22:43,134,6304,65,69,4605.48,8231.01,0.00
2024-12-10 17:22:43,134,6305,65,69,4575.35,8232.00,0.00
2024-12-10 17:22:43,135,6305,66,69,4541.46,8232.01,0.00
2024-12-10 17:22:43,134,6305,66,68,4546.27,8232.33,0.00
2024-12-10 17:22:43,134,6306,66,68,4545.00,8233.00,0.00
2024-12-10 17:22:43,135,6306,67,68,4511.33,8233.01,0.00
2024-12-10 17:22:43,134,6306,66,68,4537.30,8233.09,0.00
2024-12-10 17:22:43,134,6307,66,68,4515.43,8234.00,0.00
2024-12-10 17:22:43,135,6307,66,69,4481.98,8234.01,0.00
2024-12-10 17:22:43,136,6306,66,70,4430.34,8234.25,0.00
2024-12-10 17:22:43,136,6307,66,70,4448.20,8235.00,0.00
2024-12-10 17:22:43,137,6307,66,71,4415.73,8235.01,0.00
2024-12-10 17:22:43,137,6307,66,71,4443.42,8236.00,0.00
2024-12-10 17:22:43,138,6307,67,71,4411.23,8236.01,0.00
2024-12-10 17:22:43,138,6308,67,71,4377.43,8237.00,0.00
2024-12-10 17:22:43,139,6308,68,71,4345.94,8237.01,0.00
2024-12-10 17:22:43,139,6309,68,71,4311.70,8238.00,0.00
2024-12-10 17:22:43,140,6309,68,72,4280.90,8238.01,0.00
2024-12-10 17:22:43,139,6309,67,72,4304.62,8238.09,0.00
2024-12-10 17:22:43,139,6310,67,72,4276.49,8239.00,0.00
2024-12-10 17:22:43,140,6310,67,73,4245.95,8239.01,0.00
2024-12-10 17:22:43,141,6309,68,73,4204.20,8239.16,0.00
2024-12-10 17:22:43,140,6309,67,73,4286.44,8239.19,0.00
2024-12-10 17:22:43,139,6309,66,73,4264.38,8239.72,0.00
2024-12-10 17:22:43,139,6310,66,73,4298.93,8240.00,0.00
2024-12-10 17:22:43,140,6310,66,74,4268.22,8240.01,0.00
2024-12-10 17:22:43,140,6311,66,74,4301.74,8241.00,0.00
2024-12-10 17:22:43,141,6311,66,75,4271.23,8241.01,0.00
2024-12-10 17:22:43,140,6311,66,74,4292.96,8241.11,0.00
2024-12-10 17:22:43,139,6311,66,73,4293.13,8241.48,0.00
2024-12-10 17:22:43,139,6312,66,73,4309.36,8242.00,0.00
2024-12-10 17:22:43,140,6312,67,73,4278.58,8242.01,0.00
2024-12-10 17:22:43,141,6311,68,73,4247.07,8242.04,0.00
2024-12-10 17:22:43,141,6312,68,73,4261.46,8243.00,0.00
2024-12-10 17:22:43,142,6312,68,74,4231.45,8243.01,0.00
2024-12-10 17:22:43,141,6312,67,74,4252.15,8243.11,0.00
2024-12-10 17:22:43,140,6312,67,73,4281.94,8243.11,0.00
2024-12-10 17:22:43,139,6312,66,73,4312.15,8243.12,0.00
2024-12-10 17:22:43,139,6313,66,73,4356.65,8244.00,0.00
2024-12-10 17:22:43,140,6313,66,74,4325.53,8244.01,0.00
2024-12-10 17:22:43,141,6312,66,75,4288.45,8244.10,0.00
2024-12-10 17:22:43,140,6312,65,75,4333.34,8244.14,0.00
2024-12-10 17:22:43,141,6311,65,76,4246.68,8244.80,0.00
2024-12-10 17:22:43,141,6312,65,76,4339.35,8245.00,0.00
2024-12-10 17:22:43,142,6312,65,77,4308.79,8245.01,0.00
2024-12-10 17:22:43,141,6312,64,77,4334.11,8245.06,0.00
2024-12-10 17:22:43,141,6313,64,77,4428.69,8246.00,0.00
2024-12-10 17:22:43,142,6313,64,78,4397.50,8246.01,0.00
2024-12-10 17:22:43,142,6314,64,78,4368.75,8247.00,0.00
2024-12-10 17:22:43,143,6314,65,78,4338.20,8247.01,0.00
2024-12-10 17:22:44,143,6315,65,78,4307.93,8248.00,0.00
2024-12-10 17:22:44,144,6315,65,79,4278.01,8248.01,0.00
2024-12-10 17:22:44,143,6315,64,79,4303.34,8248.06,0.00
2024-12-10 17:22:44,142,6315,64,78,4328.45,8248.11,0.00
2024-12-10 17:22:44,142,6316,64,78,4305.88,8249.00,0.00
2024-12-10 17:22:44,143,6316,64,79,4275.77,8249.01,0.00
2024-12-10 17:22:44,142,6316,63,79,4302.40,8249.04,0.00
2024-12-10 17:22:44,141,6316,62,79,4326.53,8249.11,0.00
2024-12-10 17:22:44,141,6317,62,79,4303.89,8250.00,0.00
2024-12-10 17:22:44,142,6317,63,79,4273.58,8250.01,0.00
2024-12-10 17:22:44,141,6317,63,78,4294.58,8250.11,0.00
2024-12-10 17:22:44,140,6317,62,78,4323.63,8250.13,0.00
2024-12-10 17:22:44,140,6318,62,78,4303.44,8251.00,0.00
2024-12-10 17:22:44,141,6318,63,78,4272.91,8251.01,0.00
2024-12-10 17:22:44,141,6319,63,78,4240.98,8252.00,0.00
2024-12-10 17:22:44,142,6319,64,78,4211.11,8252.01,0.00
2024-12-10 17:22:44,141,6319,64,77,4231.09,8252.12,0.00
2024-12-10 17:22:44,141,6320,64,77,4209.00,8253.00,0.00
2024-12-10 17:22:44,142,6320,64,78,4179.36,8253.01,0.00
2024-12-10 17:22:44,141,6320,63,78,4164.08,8253.54,0.00
2024-12-10 17:22:44,141,6321,63,78,4177.96,8254.00,0.00
2024-12-10 17:22:44,142,6321,64,78,4148.54,8254.01,0.00
2024-12-10 17:22:44,142,6322,64,78,4117.70,8255.00,0.00
2024-12-10 17:22:44,143,6322,65,78,4088.90,8255.01,0.00
2024-12-10 17:22:44,142,6322,65,77,4107.29,8255.13,0.00
2024-12-10 17:22:44,141,6322,65,76,4135.66,8255.14,0.00
2024-12-10 17:22:44,140,6322,65,75,4118.77,8255.70,0.00
2024-12-10 17:22:44,140,6323,65,75,4147.34,8256.00,0.00
2024-12-10 17:22:44,141,6323,66,75,4117.93,8256.01,0.00
2024-12-10 17:22:44,140,6323,65,75,4136.79,8256.13,0.00
2024-12-10 17:22:44,140,6324,65,75,4117.58,8257.00,0.00
2024-12-10 17:22:44,141,6324,65,76,4088.38,8257.01,0.00
2024-12-10 17:22:44,141,6325,65,76,4058.31,8258.00,0.00
2024-12-10 17:22:44,142,6325,65,77,4029.73,8258.01,0.00
2024-12-10 17:22:44,141,6325,64,77,4055.39,8258.04,0.00
2024-12-10 17:22:44,140,6325,64,76,4076.73,8258.12,0.00
2024-12-10 17:22:44,140,6326,64,76,4055.85,8259.00,0.00
2024-12-10 17:22:44,141,6326,64,77,4027.09,8259.01,0.00
2024-12-10 17:22:44,140,6326,64,76,4045.26,8259.14,0.00
2024-12-10 17:22:44,140,6327,64,76,4024.66,8260.00,0.00
2024-12-10 17:22:44,141,6327,65,76,3996.11,8260.01,0.00
2024-12-10 17:22:44,141,6328,65,76,3963.62,8261.00,0.00
2024-12-10 17:22:44,142,6328,66,76,3935.71,8261.01,0.00
2024-12-10 17:22:44,141,6328,65,76,3952.55,8261.14,0.00
2024-12-10 17:22:44,141,6329,65,76,3929.59,8262.00,0.00
2024-12-10 17:22:44,142,6329,66,76,3901.91,8262.01,0.00
2024-12-10 17:22:44,141,6329,65,76,3918.51,8262.14,0.00
2024-12-10 17:22:44,141,6330,65,76,3895.01,8263.00,0.00
2024-12-10 17:22:44,142,6330,65,77,3867.58,8263.01,0.00
2024-12-10 17:22:44,141,6330,64,77,3883.95,8263.14,0.00
2024-12-10 17:22:44,141,6331,64,77,3858.24,8264.00,0.00
2024-12-10 17:22:44,142,6331,64,78,3831.07,8264.01,0.00
2024-12-10 17:22:44,141,6331,64,77,3795.16,8264.70,0.00
2024-12-10 17:22:44,141,6332,64,77,3822.21,8265.00,0.00
2024-12-10 17:22:44,142,6332,65,77,3795.29,8265.01,0.00
2024-12-10 17:22:44,141,6332,64,77,3821.63,8265.01,0.00
2024-12-10 17:22:44,140,6332,64,76,3838.35,8265.13,0.00
2024-12-10 17:22:44,139,6332,63,76,3865.37,8265.13,0.00
2024-12-10 17:22:44,139,6333,63,76,3845.86,8266.00,0.00
2024-12-10 17:22:44,140,6333,63,77,3818.39,8266.01,0.00
2024-12-10 17:22:44,139,6333,63,76,3835.21,8266.13,0.00
2024-12-10 17:22:44,138,6333,62,76,3862.41,8266.13,0.00
2024-12-10 17:22:44,138,6334,62,76,3843.31,8267.00,0.00
2024-12-10 17:22:44,139,6334,63,76,3815.66,8267.01,0.00
2024-12-10 17:22:44,138,6334,62,76,3832.58,8267.13,0.00
2024-12-10 17:22:44,138,6335,62,76,3806.24,8268.00,0.00
2024-12-10 17:22:44,139,6335,63,76,3778.86,8268.01,0.00
2024-12-10 17:22:44,138,6335,62,76,3798.49,8268.09,0.00
2024-12-10 17:22:44,137,6335,61,76,3823.21,8268.12,0.00
2024-12-10 17:22:44,136,6335,60,76,3850.72,8268.13,0.00
2024-12-10 17:22:44,135,6335,59,76,3878.63,8268.13,0.00
2024-12-10 17:22:44,134,6335,58,76,3906.88,8268.14,0.00
2024-12-10 17:22:44,133,6335,58,75,3906.87,8268.48,0.00
2024-12-10 17:22:44,132,6335,58,74,3925.91,8268.60,0.00
2024-12-10 17:22:44,133,6334,59,74,3875.14,8268.82,0.00
2024-12-10 17:22:44,133,6335,59,74,3932.24,8269.00,0.00
2024-12-10 17:22:44,134,6335,60,74,3902.90,8269.01,0.00
2024-12-10 17:22:44,133,6335,60,73,3921.72,8269.13,0.00
2024-12-10 17:22:44,134,6334,60,74,3850.70,8269.64,0.00
2024-12-10 17:22:44,134,6335,60,74,3946.38,8270.00,0.00
2024-12-10 17:22:44,135,6335,61,74,3917.14,8270.01,0.00
2024-12-10 17:22:44,135,6336,61,74,3930.12,8271.00,0.00
2024-12-10 17:22:44,136,6336,62,74,3901.22,8271.01,0.00
2024-12-10 17:22:44,137,6335,63,74,3836.63,8271.45,0.00
2024-12-10 17:22:44,138,6334,64,74,3818.68,8271.77,0.00
2024-12-10 17:22:44,138,6335,64,74,3842.51,8272.00,0.00
2024-12-10 17:22:44,139,6335,64,75,3814.87,8272.01,0.00
2024-12-10 17:22:44,138,6335,63,75,3832.37,8272.12,0.00
2024-12-10 17:22:44,137,6335,62,75,3859.74,8272.12,0.00
2024-12-10 17:22:44,136,6335,62,74,3817.08,8272.77,0.00
2024-12-10 17:22:44,135,6335,61,74,3808.40,8272.96,0.00
2024-12-10 17:22:44,135,6336,61,74,3988.59,8273.00,0.00
2024-12-10 17:22:44,136,6336,62,74,3959.26,8273.01,0.00
2024-12-10 17:22:44,135,6336,62,73,3978.21,8273.13,0.00
2024-12-10 17:22:45,135,6337,62,73,3962.18,8274.00,0.00
2024-12-10 17:22:45,136,6337,62,74,3933.05,8274.01,0.00
2024-12-10 17:22:45,135,6337,61,74,3951.80,8274.13,0.00
2024-12-10 17:22:45,135,6338,61,74,3934.41,8275.00,0.00
2024-12-10 17:22:45,136,6338,61,75,3905.48,8275.01,0.00
2024-12-10 17:22:45,136,6339,61,75,3877.60,8276.00,0.00
2024-12-10 17:22:45,137,6339,61,76,3849.30,8276.01,0.00
2024-12-10 17:22:45,136,6339,61,75,3866.69,8276.13,0.00
2024-12-10 17:22:45,136,6340,61,75,3847.43,8277.00,0.00
2024-12-10 17:22:45,137,6340,61,76,3819.35,8277.01,0.00
2024-12-10 17:22:45,138,6339,62,76,3786.30,8277.09,0.00
2024-12-10 17:22:45,137,6339,62,75,3863.80,8277.18,0.00
2024-12-10 17:22:45,137,6340,62,75,3846.69,8278.00,0.00
2024-12-10 17:22:45,138,6340,62,76,3818.81,8278.01,0.00
2024-12-10 17:22:45,137,6340,62,75,3818.91,8278.07,0.00
2024-12-10 17:22:45,136,6340,62,74,3840.93,8278.13,0.00
2024-12-10 17:22:45,136,6341,62,74,3878.98,8279.00,0.00
2024-12-10 17:22:45,137,6341,62,75,3850.67,8279.01,0.00
2024-12-10 17:22:45,137,6342,62,75,3813.59,8280.00,0.00
2024-12-10 17:22:45,138,6342,62,76,3785.96,8280.01,0.00
2024-12-10 17:22:45,137,6342,62,75,3806.38,8280.09,0.00
2024-12-10 17:22:45,136,6342,61,75,3829.51,8280.14,0.00
2024-12-10 17:22:45,135,6342,60,75,3794.67,8280.76,0.00
2024-12-10 17:22:45,136,6341,60,76,3758.33,8280.88,0.00
2024-12-10 17:22:45,136,6342,60,76,3816.90,8281.00,0.00
2024-12-10 17:22:45,137,6342,60,77,3789.04,8281.01,0.00
2024-12-10 17:22:45,136,6342,60,76,3813.26,8281.04,0.00
2024-12-10 17:22:45,135,6342,60,75,3832.95,8281.14,0.00
2024-12-10 17:22:45,136,6341,60,76,3801.72,8281.19,0.00
2024-12-10 17:22:45,135,6341,60,75,3848.29,8281.61,0.00
2024-12-10 17:22:45,135,6342,60,75,3931.65,8282.00,0.00
2024-12-10 17:22:45,136,6342,61,75,3902.74,8282.01,0.00
2024-12-10 17:22:45,136,6343,61,75,3932.62,8283.00,0.00
2024-12-10 17:22:45,137,6343,61,76,3903.91,8283.01,0.00
2024-12-10 17:22:45,136,6343,61,75,3919.39,8283.14,0.00
2024-12-10 17:22:45,136,6344,61,75,3898.83,8284.00,0.00
2024-12-10 17:22:45,137,6344,61,76,3870.37,8284.01,0.00
2024-12-10 17:22:45,136,6344,61,75,3886.63,8284.12,0.00
2024-12-10 17:22:45,135,6344,60,75,3913.58,8284.13,0.00
2024-12-10 17:22:45,134,6344,60,74,3942.17,8284.14,0.00
2024-12-10 17:22:45,134,6345,60,74,3920.23,8285.00,0.00
2024-12-10 17:22:45,135,6345,60,75,3891.19,8285.01,0.00
2024-12-10 17:22:45,134,6345,60,74,3899.41,8285.22,0.00
2024-12-10 17:22:45,133,6345,60,73,3924.65,8285.26,0.00
2024-12-10 17:22:45,132,6345,60,72,3911.58,8285.66,0.00
2024-12-10 17:22:45,132,6346,60,72,3942.40,8286.00,0.00
2024-12-10 17:22:45,133,6346,60,73,3912.75,8286.01,0.00
2024-12-10 17:22:45,132,6346,60,72,3932.72,8286.11,0.00
2024-12-10 17:22:45,131,6346,59,72,3961.48,8286.12,0.00
2024-12-10 17:22:45,130,6346,59,71,3991.32,8286.12,0.00
2024-12-10 17:22:45,129,6346,59,70,4021.62,8286.12,0.00
2024-12-10 17:22:45,129,6347,59,70,4001.90,8287.00,0.00
2024-12-10 17:22:45,130,6347,60,70,3971.11,8287.01,0.00
2024-12-10 17:22:45,129,6347,60,69,3991.02,8287.13,0.00
2024-12-10 17:22:45,128,6347,60,68,3971.54,8287.63,0.00
2024-12-10 17:22:45,128,6348,60,68,4004.35,8288.00,0.00
2024-12-10 17:22:45,129,6348,61,68,3973.30,8288.01,0.00
2024-12-10 17:22:45,128,6348,61,67,4003.70,8288.01,0.00
2024-12-10 17:22:45,127,6348,61,66,4024.83,8288.13,0.00
2024-12-10 17:22:45,126,6348,60,66,4053.49,8288.16,0.00
2024-12-10 17:22:45,126,6349,60,66,4025.42,8289.00,0.00
2024-12-10 17:22:45,127,6349,60,67,3993.72,8289.01,0.00
2024-12-10 17:22:45,126,6349,60,66,4014.94,8289.13,0.00
2024-12-10 17:22:45,125,6349,59,66,4008.83,8289.50,0.00
2024-12-10 17:22:45,125,6350,59,66,3999.17,8290.00,0.00
2024-12-10 17:22:45,126,6350,59,67,3967.43,8290.01,0.00
2024-12-10 17:22:45,125,6350,58,67,3988.60,8290.13,0.00
2024-12-10 17:22:45,125,6351,58,67,3937.53,8291.00,0.00
2024-12-10 17:22:45,126,6351,59,67,3906.28,8291.01,0.00
2024-12-10 17:22:45,125,6351,58,67,3926.96,8291.13,0.00
2024-12-10 17:22:45,124,6351,57,67,3912.05,8291.52,0.00
2024-12-10 17:22:45,123,6351,56,67,3919.46,8291.63,0.00
2024-12-10 17:22:45,123,6352,56,67,3952.13,8292.00,0.00
2024-12-10 17:22:45,124,6352,57,67,3920.25,8292.01,0.00
2024-12-10 17:22:45,123,6352,56,67,3941.38,8292.13,0.00
2024-12-10 17:22:45,122,6352,55,67,3930.29,8292.52,0.00
2024-12-10 17:22:45,123,6351,56,67,3887.31,8292.58,0.00
2024-12-10 17:22:45,122,6351,56,66,3928.70,8292.60,0.00
2024-12-10 17:22:45,123,6350,56,67,3894.75,8292.63,0.00
2024-12-10 17:22:45,123,6351,56,67,3952.08,8293.00,0.00
2024-12-10 17:22:45,124,6351,56,68,3920.20,8293.01,0.00
2024-12-10 17:22:45,124,6352,56,68,4018.66,8294.00,0.00
2024-12-10 17:22:45,125,6352,57,68,3986.51,8294.01,0.00
2024-12-10 17:22:45,124,6352,56,68,4007.84,8294.13,0.00
2024-12-10 17:22:45,123,6352,56,67,4006.66,8294.49,0.00
2024-12-10 17:22:45,123,6353,56,67,4021.40,8295.00,0.00
2024-12-10 17:22:45,124,6353,56,68,3988.97,8295.01,0.00
2024-12-10 17:22:45,123,6353,56,67,4003.43,8295.22,0.00
2024-12-10 17:22:45,122,6353,56,66,4005.95,8295.52,0.00
2024-12-10 17:22:45,122,6354,56,66,4030.67,8296.00,0.00
2024-12-10 17:22:45,123,6354,57,66,3997.90,8296.01,0.00
2024-12-10 17:22:45,122,6354,56,66,4019.64,8296.13,0.00
2024-12-10 17:22:45,121,6354,55,66,4045.90,8296.22,0.00
2024-12-10 17:22:45,122,6353,55,67,3970.55,8296.68,0.00
2024-12-10 17:22:45,122,6354,55,67,4035.27,8297.00,0.00
2024-12-10 17:22:45,123,6354,56,67,4002.46,8297.01,0.00
2024-12-10 17:22:45,122,6354,55,67,4026.36,8297.11,0.00
2024-12-10 17:22:45,121,6354,55,66,4057.58,8297.12,0.00
2024-12-10 17:22:45,120,6354,55,65,4090.71,8297.13,0.00
2024-12-10 17:22:45,120,6355,55,65,4141.28,8298.00,0.00
2024-12-10 17:22:45,121,6355,56,65,4107.06,8298.01,0.00
2024-12-10 17:22:45,120,6355,56,64,4139.90,8298.02,0.00
2024-12-10 17:22:45,119,6355,56,63,4167.55,8298.09,0.00
2024-12-10 17:22:45,118,6355,56,62,4200.77,8298.11,0.00
2024-12-10 17:22:45,117,6355,55,62,4235.96,8298.11,0.00
2024-12-10 17:22:45,117,6356,55,62,4211.41,8299.00,0.00
2024-12-10 17:22:45,118,6356,56,62,4175.72,8299.01,0.00
2024-12-10 17:22:45,117,6356,56,61,4201.79,8299.11,0.00
2024-12-10 17:22:46,117,6357,56,61,4176.42,8300.00,0.00
2024-12-10 17:22:46,118,6357,57,61,4141.03,8300.01,0.00
2024-12-10 17:22:46,117,6357,57,60,4166.62,8300.11,0.00
2024-12-10 17:22:46,116,6357,57,59,4192.13,8300.23,0.00
2024-12-10 17:22:46,115,6357,57,58,4208.24,8300.41,0.00
2024-12-10 17:22:46,115,6358,57,58,4214.44,8301.00,0.00
2024-12-10 17:22:46,116,6358,57,59,4178.11,8301.01,0.00
2024-12-10 17:22:46,115,6358,57,58,4204.34,8301.11,0.00
2024-12-10 17:22:46,115,6359,57,58,4184.31,8302.00,0.00
2024-12-10 17:22:46,116,6359,58,58,4148.24,8302.01,0.00
2024-12-10 17:22:46,115,6359,57,58,4177.12,8302.09,0.00
2024-12-10 17:22:46,114,6359,57,57,4211.00,8302.11,0.00
2024-12-10 17:22:46,113,6359,56,57,4247.53,8302.11,0.00
2024-12-10 17:22:46,112,6359,56,56,4258.52,8302.38,0.00
2024-12-10 17:22:46,111,6359,56,55,4294.15,8302.41,0.00
2024-12-10 17:22:46,110,6359,55,55,4312.10,8302.55,0.00
2024-12-10 17:22:46,110,6360,55,55,4342.97,8303.00,0.00
2024-12-10 17:22:46,111,6360,55,56,4303.84,8303.01,0.00
2024-12-10 17:22:46,110,6360,55,55,4333.55,8303.11,0.00
2024-12-10 17:22:46,109,6360,54,55,4367.29,8303.15,0.00
2024-12-10 17:22:46,109,6361,54,55,4348.03,8304.00,0.00
2024-12-10 17:22:46,110,6361,54,56,4308.50,8304.01,0.00
2024-12-10 17:22:46,111,6360,55,56,4231.20,8304.47,0.00
2024-12-10 17:22:46,111,6361,55,56,4245.35,8305.00,0.00
2024-12-10 17:22:46,112,6361,55,57,4207.45,8305.01,0.00
2024-12-10 17:22:46,111,6361,55,56,4197.07,8305.46,0.00
2024-12-10 17:22:46,110,6361,54,56,4220.66,8305.52,0.00
2024-12-10 17:22:46,110,6362,54,56,4328.84,8306.00,0.00
2024-12-10 17:22:46,111,6362,55,56,4289.84,8306.01,0.00
2024-12-10 17:22:46,111,6363,55,56,4269.11,8307.00,0.00
2024-12-10 17:22:46,112,6363,56,56,4230.99,8307.01,0.00
2024-12-10 17:22:46,111,6363,56,55,4259.41,8307.12,0.00
2024-12-10 17:22:46,112,6362,56,56,4190.08,8307.46,0.00
2024-12-10 17:22:46,112,6363,56,56,4247.31,8308.00,0.00
2024-12-10 17:22:46,113,6363,56,57,4209.73,8308.01,0.00
2024-12-10 17:22:46,112,6363,56,56,4244.27,8308.05,0.00
2024-12-10 17:22:46,111,6363,56,55,4276.55,8308.11,0.00
2024-12-10 17:22:46,111,6364,56,55,4322.98,8309.00,0.00
2024-12-10 17:22:46,112,6364,56,56,4284.38,8309.01,0.00
2024-12-10 17:22:46,112,6365,56,56,4239.82,8310.00,0.00
2024-12-10 17:22:46,113,6365,56,57,4202.30,8310.01,0.00
2024-12-10 17:22:46,112,6365,56,56,4230.95,8310.11,0.00
2024-12-10 17:22:46,113,6364,56,57,4116.36,8310.79,0.00
2024-12-10 17:22:46,113,6365,56,57,4166.12,8311.00,0.00
2024-12-10 17:22:46,114,6365,56,58,4129.57,8311.01,0.00
2024-12-10 17:22:46,113,6365,55,58,4157.32,8311.11,0.00
2024-12-10 17:22:46,113,6366,55,58,4176.24,8312.00,0.00
2024-12-10 17:22:46,114,6366,55,59,4139.60,8312.01,0.00
2024-12-10 17:22:46,113,6366,54,59,4167.44,8312.11,0.00
2024-12-10 17:22:46,112,6366,53,59,4203.91,8312.11,0.00
2024-12-10 17:22:46,111,6366,53,58,4181.57,8312.44,0.00
2024-12-10 17:22:46,111,6367,53,58,4179.72,8313.00,0.00
2024-12-10 17:22:46,112,6367,53,59,4142.40,8313.01,0.00
2024-12-10 17:22:46,111,6367,52,59,4170.76,8313.11,0.00
2024-12-10 17:22:46,110,6367,52,58,4206.33,8313.14,0.00
2024-12-10 17:22:46,109,6367,51,58,4204.34,8313.40,0.00
2024-12-10 17:22:46,108,6367,51,57,4235.78,8313.41,0.00
2024-12-10 17:22:46,108,6368,51,57,4225.02,8314.00,0.00
2024-12-10 17:22:46,109,6368,51,58,4186.26,8314.01,0.00
2024-12-10 17:22:46,108,6368,50,58,4223.48,8314.02,0.00
2024-12-10 17:22:46,107,6368,50,57,4255.21,8314.10,0.00
2024-12-10 17:22:46,106,6368,50,56,4255.47,8314.40,0.00
2024-12-10 17:22:46,106,6369,50,56,4237.43,8315.00,0.00
2024-12-10 17:22:46,107,6369,51,56,4197.83,8315.01,0.00
2024-12-10 17:22:46,106,6369,51,55,4228.83,8315.10,0.00
2024-12-10 17:22:46,105,6369,50,55,4268.31,8315.10,0.00
2024-12-10 17:22:46,105,6370,50,55,4193.09,8316.00,0.00
2024-12-10 17:22:46,106,6370,51,55,4153.53,8316.01,0.00
2024-12-10 17:22:46,105,6370,50,55,4141.31,8316.35,0.00
2024-12-10 17:22:46,105,6371,50,55,4079.64,8317.00,0.00
2024-12-10 17:22:46,106,6371,51,55,4041.16,8317.01,0.00
2024-12-10 17:22:46,105,6371,50,55,4073.62,8317.08,0.00
2024-12-10 17:22:46,104,6371,49,55,4110.40,8317.10,0.00
2024-12-10 17:22:46,103,6371,48,55,4044.51,8317.70,0.00
2024-12-10 17:22:46,103,6372,48,55,4040.23,8318.00,0.00
2024-12-10 17:22:46,104,6372,48,56,4001.39,8318.01,0.00
2024-12-10 17:22:46,103,6372,47,56,4032.19,8318.10,0.00
2024-12-10 17:22:46,102,6372,47,55,4056.01,8318.25,0.00
2024-12-10 17:22:46,101,6372,46,55,4095.22,8318.26,0.00
2024-12-10 17:22:46,100,6372,46,54,4130.68,8318.27,0.00
2024-12-10 17:22:46,99,6372,45,54,4161.15,8318.31,0.00
2024-12-10 17:22:46,98,6372,45,53,4161.50,8318.66,0.00
2024-12-10 17:22:46,97,6372,44,53,4187.68,8318.68,0.00
2024-12-10 17:22:46,96,6372,44,52,4223.81,8318.71,0.00
2024-12-10 17:22:46,95,6372,44,51,4252.53,8318.73,0.00
2024-12-10 17:22:46,94,6372,44,50,4290.68,8318.75,0.00
2024-12-10 17:22:46,94,6373,44,50,4333.30,8319.00,0.00
2024-12-10 17:22:46,95,6373,45,50,4287.69,8319.01,0.00
2024-12-10 17:22:46,94,6373,45,49,4324.48,8319.11,0.00
2024-12-10 17:22:46,93,6373,44,49,4370.08,8319.11,0.00
2024-12-10 17:22:46,92,6373,43,49,4339.68,8319.75,0.00
2024-12-10 17:22:46,92,6374,43,49,4397.36,8320.00,0.00
2024-12-10 17:22:46,93,6374,43,50,4350.08,8320.01,0.00
2024-12-10 17:22:46,93,6375,43,50,4317.35,8321.00,0.00
2024-12-10 17:22:46,94,6375,44,50,4271.42,8321.01,0.00
2024-12-10 17:22:46,93,6375,44,49,4308.43,8321.11,0.00
2024-12-10 17:22:46,93,6376,44,49,4283.80,8322.00,0.00
2024-12-10 17:22:46,94,6376,44,50,4238.23,8322.01,0.00
2024-12-10 17:22:46,93,6376,44,49,4274.88,8322.11,0.00
2024-12-10 17:22:46,92,6376,43,49,4255.87,8322.71,0.00
2024-12-10 17:22:46,91,6376,42,49,4283.11,8322.79,0.00
2024-12-10 17:22:46,91,6377,42,49,4356.68,8323.00,0.00
2024-12-10 17:22:46,92,6377,42,50,4309.32,8323.01,0.00
2024-12-10 17:22:46,91,6377,41,50,4347.56,8323.11,0.00
2024-12-10 17:22:46,90,6377,41,49,4329.99,8323.67,0.00
2024-12-10 17:22:46,90,6378,41,49,4395.00,8324.00,0.00
2024-12-10 17:22:46,91,6378,41,50,4346.70,8324.01,0.00
2024-12-10 17:22:46,90,6378,40,50,4393.15,8324.02,0.00
2024-12-10 17:22:46,91,6377,40,51,4344.88,8324.04,0.00
2024-12-10 17:22:46,90,6377,39,51,4459.78,8324.11,0.00
2024-12-10 17:22:46,89,6377,39,50,4508.95,8324.11,0.00
2024-12-10 17:22:46,88,6377,39,49,4549.52,8324.18,0.00
2024-12-10 17:22:46,88,6378,39,49,4567.02,8325.00,0.00
2024-12-10 17:22:46,89,6378,39,50,4515.70,8325.01,0.00
2024-12-10 17:22:46,88,6378,38,50,4558.54,8325.10,0.00
2024-12-10 17:22:46,87,6378,38,49,4600.47,8325.20,0.00
2024-12-10 17:22:47,87,6379,38,49,4718.73,8326.00,0.00
2024-12-10 17:22:47,88,6379,38,50,4665.11,8326.01,0.00
2024-12-10 17:22:47,87,6379,37,50,4707.56,8326.13,0.00
2024-12-10 17:22:47,87,6380,37,50,4724.93,8327.00,0.00
2024-12-10 17:22:47,88,6380,37,51,4671.23,8327.01,0.00
2024-12-10 17:22:47,87,6380,36,51,4714.66,8327.13,0.00
2024-12-10 17:22:47,87,6381,36,51,4731.23,8328.00,0.00
2024-12-10 17:22:47,88,6381,37,51,4677.47,8328.01,0.00
2024-12-10 17:22:47,87,6381,37,50,4721.70,8328.12,0.00
2024-12-10 17:22:47,86,6381,36,50,4776.33,8328.12,0.00
2024-12-10 17:22:47,85,6381,35,50,4826.57,8328.15,0.00
2024-12-10 17:22:47,85,6382,35,50,4849.24,8329.00,0.00
2024-12-10 17:22:47,86,6382,36,50,4792.85,8329.01,0.00
2024-12-10 17:22:47,85,6382,36,49,4845.34,8329.05,0.00
2024-12-10 17:22:47,85,6383,36,49,4857.58,8330.00,0.00
2024-12-10 17:22:47,86,6383,36,50,4801.10,8330.01,0.00
2024-12-10 17:22:47,86,6384,36,50,4809.95,8331.00,0.00
2024-12-10 17:22:47,87,6384,37,50,4754.67,8331.01,0.00
2024-12-10 17:22:47,87,6385,37,50,4764.19,8332.00,0.00
2024-12-10 17:22:47,88,6385,38,50,4710.05,8332.01,0.00
2024-12-10 17:22:47,88,6386,38,50,4718.30,8333.00,0.00
2024-12-10 17:22:47,89,6386,39,50,4665.29,8333.01,0.00
2024-12-10 17:22:47,88,6386,38,50,4709.81,8333.10,0.00
2024-12-10 17:22:47,88,6387,38,50,4719.46,8334.00,0.00
2024-12-10 17:22:47,89,6387,39,50,4666.43,8334.01,0.00
2024-12-10 17:22:47,88,6387,39,49,4714.74,8334.06,0.00
2024-12-10 17:22:47,88,6388,39,49,4710.98,8335.00,0.00
2024-12-10 17:22:47,89,6388,39,50,4658.05,8335.01,0.00
2024-12-10 17:22:47,88,6388,38,50,4687.69,8335.18,0.00
2024-12-10 17:22:47,88,6389,38,50,4689.39,8336.00,0.00
2024-12-10 17:22:47,89,6389,38,51,4636.70,8336.01,0.00
2024-12-10 17:22:47,89,6389,38,51,4609.77,8337.00,0.00
2024-12-10 17:22:47,90,6389,39,51,4558.55,8337.01,0.00
2024-12-10 17:22:47,89,6389,38,51,4546.10,8337.54,0.00
2024-12-10 17:22:47,88,6389,38,50,4580.10,8337.57,0.00
2024-12-10 17:22:47,88,6390,38,50,4637.63,8338.00,0.00
2024-12-10 17:22:47,89,6390,39,50,4585.52,8338.01,0.00
2024-12-10 17:22:47,88,6390,38,50,4594.45,8338.22,0.00
2024-12-10 17:22:47,88,6391,38,50,4592.66,8339.00,0.00
2024-12-10 17:22:47,89,6391,39,50,4541.06,8339.01,0.00
2024-12-10 17:22:47,88,6391,39,49,4588.88,8339.05,0.00
2024-12-10 17:22:47,87,6391,39,48,4631.67,8339.07,0.00
2024-12-10 17:22:47,86,6391,38,48,4684.55,8339.07,0.00
2024-12-10 17:22:47,85,6391,37,48,4670.92,8339.53,0.00
2024-12-10 17:22:47,85,6392,37,48,4729.27,8340.00,0.00
2024-12-10 17:22:47,86,6392,37,49,4674.28,8340.01,0.00
2024-12-10 17:22:47,86,6393,37,49,4685.71,8341.00,0.00
2024-12-10 17:22:47,87,6393,37,50,4631.85,8341.01,0.00
2024-12-10 17:22:47,87,6394,37,50,4639.68,8342.00,0.00
2024-12-10 17:22:47,88,6394,38,50,4586.96,8342.01,0.00
2024-12-10 17:22:47,87,6394,37,50,4638.72,8342.01,0.00
2024-12-10 17:22:47,87,6395,37,50,4639.27,8343.00,0.00
2024-12-10 17:22:47,88,6395,38,50,4586.55,8343.01,0.00
2024-12-10 17:22:47,88,6396,38,50,4579.65,8344.00,0.00
2024-12-10 17:22:47,89,6396,39,50,4528.20,8344.01,0.00
2024-12-10 17:22:47,89,6397,39,50,4516.26,8345.00,0.00
2024-12-10 17:22:47,90,6397,39,51,4466.08,8345.01,0.00
2024-12-10 17:22:47,89,6397,38,51,4471.51,8345.47,0.00
2024-12-10 17:22:47,89,6397,38,51,4517.05,8346.00,0.00
2024-12-10 17:22:47,90,6397,39,51,4466.86,8346.01,0.00
2024-12-10 17:22:47,91,6396,39,52,4359.65,8346.63,0.00
2024-12-10 17:22:47,91,6397,39,52,4451.21,8347.00,0.00
2024-12-10 17:22:47,92,6397,40,52,4402.83,8347.01,0.00
2024-12-10 17:22:47,92,6398,40,52,4490.42,8348.00,0.00
2024-12-10 17:22:47,93,6398,40,53,4442.14,8348.01,0.00
2024-12-10 17:22:47,92,6398,40,52,4485.00,8348.07,0.00
2024-12-10 17:22:47,92,6399,40,52,4478.18,8349.00,0.00
2024-12-10 17:22:47,93,6399,40,53,4430.03,8349.01,0.00
2024-12-10 17:22:47,92,6399,40,52,4472.76,8349.07,0.00
2024-12-10 17:22:47,91,6399,40,51,4487.97,8349.39,0.00
2024-12-10 17:22:47,91,6400,40,51,4526.18,8350.00,0.00
2024-12-10 17:22:47,92,6400,40,52,4476.98,8350.01,0.00
2024-12-10 17:22:47,93,6399,40,53,4364.63,8350.71,0.00
2024-12-10 17:22:47,93,6400,40,53,4452.31,8351.00,0.00
2024-12-10 17:22:47,94,6400,40,54,4404.95,8351.01,0.00
2024-12-10 17:22:47,93,6400,40,53,4428.80,8351.23,0.00
2024-12-10 17:22:47,93,6401,40,53,4531.86,8352.00,0.00
2024-12-10 17:22:47,94,6401,41,53,4483.65,8352.01,0.00
2024-12-10 17:22:47,93,6401,41,52,4433.65,8352.53,0.00
2024-12-10 17:22:47,93,6402,41,52,4483.41,8353.00,0.00
2024-12-10 17:22:47,94,6402,41,53,4435.71,8353.01,0.00
2024-12-10 17:22:47,93,6402,41,52,4434.06,8353.43,0.00
2024-12-10 17:22:47,93,6403,41,52,4458.91,8354.00,0.00
2024-12-10 17:22:47,94,6403,41,53,4411.48,8354.01,0.00
2024-12-10 17:22:47,95,6402,41,54,4343.99,8354.28,0.00
2024-12-10 17:22:47,94,6402,40,54,4439.67,8354.47,0.00
2024-12-10 17:22:47,95,6401,41,54,4376.79,8354.67,0.00
2024-12-10 17:22:47,95,6402,41,54,4461.90,8355.00,0.00
2024-12-10 17:22:47,96,6402,42,54,4415.42,8355.01,0.00
2024-12-10 17:22:47,95,6402,41,54,4457.19,8355.06,0.00
2024-12-10 17:22:47,95,6403,41,54,4629.20,8356.00,0.00
2024-12-10 17:22:47,96,6403,41,55,4580.98,8356.01,0.00
2024-12-10 17:22:48,96,6404,41,55,4569.06,8357.00,0.00
2024-12-10 17:22:48,97,6404,41,56,4521.96,8357.01,0.00
2024-12-10 17:22:48,97,6405,41,56,4506.88,8358.00,0.00
2024-12-10 17:22:48,98,6405,42,56,4460.89,8358.01,0.00
2024-12-10 17:22:48,98,6406,42,56,4442.42,8359.00,0.00
2024-12-10 17:22:48,99,6406,42,57,4397.54,8359.01,0.00
2024-12-10 17:22:48,98,6406,42,56,4398.29,8359.43,0.00
2024-12-10 17:22:48,98,6407,42,56,4422.34,8360.00,0.00
2024-12-10 17:22:48,99,6407,43,56,4377.67,8360.01,0.00
2024-12-10 17:22:48,99,6408,43,56,4359.06,8361.00,0.00
2024-12-10 17:22:48,100,6408,43,57,4315.47,8361.01,0.00
2024-12-10 17:22:48,100,6409,43,57,4296.53,8362.00,0.00
2024-12-10 17:22:48,101,6409,43,58,4253.99,8362.01,0.00
2024-12-10 17:22:48,100,6409,42,58,4291.52,8362.06,0.00
2024-12-10 17:22:48,101,6408,42,59,4183.01,8362.82,0.00
2024-12-10 17:22:48,101,6409,42,59,4273.17,8363.00,0.00
2024-12-10 17:22:48,102,6409,42,60,4231.28,8363.01,0.00
2024-12-10 17:22:48,101,6409,42,59,4268.22,8363.06,0.00
2024-12-10 17:22:48,100,6409,42,58,4225.49,8363.90,0.00
2024-12-10 17:22:48,100,6410,42,58,4379.14,8364.00,0.00
2024-12-10 17:22:48,101,6410,42,59,4335.79,8364.01,0.00
2024-12-10 17:22:48,101,6411,42,59,4322.51,8365.00,0.00
2024-12-10 17:22:48,102,6411,42,60,4280.13,8365.01,0.00
2024-12-10 17:22:48,102,6412,42,60,4265.42,8366.00,0.00
2024-12-10 17:22:48,103,6412,42,61,4224.01,8366.01,0.00
2024-12-10 17:22:48,103,6413,42,61,4207.32,8367.00,0.00
2024-12-10 17:22:48,104,6413,43,61,4166.86,8367.01,0.00
2024-12-10 17:22:48,103,6413,42,61,4200.83,8367.08,0.00
2024-12-10 17:22:48,103,6414,42,61,4189.23,8368.00,0.00
2024-12-10 17:22:48,104,6414,43,61,4148.95,8368.01,0.00
2024-12-10 17:22:48,103,6414,42,61,4182.74,8368.08,0.00
2024-12-10 17:22:48,103,6415,42,61,4170.07,8369.00,0.00
2024-12-10 17:22:48,104,6415,42,62,4129.97,8369.01,0.00
2024-12-10 17:22:48,103,6415,42,61,4164.27,8369.08,0.00
2024-12-10 17:22:48,102,6415,42,60,4135.62,8369.76,0.00
2024-12-10 17:22:48,102,6416,42,60,4193.54,8370.00,0.00
2024-12-10 17:22:48,103,6416,42,61,4152.83,8370.01,0.00
2024-12-10 17:22:48,102,6416,41,61,4186.99,8370.08,0.00
2024-12-10 17:22:48,102,6417,41,61,4189.12,8371.00,0.00
2024-12-10 17:22:48,103,6417,41,62,4148.44,8371.01,0.00
2024-12-10 17:22:48,102,6417,41,61,4185.84,8371.04,0.00
2024-12-10 17:22:48,101,6417,40,61,4223.97,8371.07,0.00
2024-12-10 17:22:48,100,6417,39,61,4265.38,8371.07,0.00
2024-12-10 17:22:48,99,6417,38,61,4307.61,8371.07,0.00
2024-12-10 17:22:48,99,6418,38,61,4311.91,8372.00,0.00
2024-12-10 17:22:48,100,6418,39,61,4268.79,8372.01,0.00
2024-12-10 17:22:48,99,6418,39,60,4306.00,8372.07,0.00
2024-12-10 17:22:48,99,6419,39,60,4310.78,8373.00,0.00
2024-12-10 17:22:48,100,6419,39,61,4267.68,8373.01,0.00
2024-12-10 17:22:48,99,6419,38,61,4304.87,8373.07,0.00
2024-12-10 17:22:48,99,6420,38,61,4309.91,8374.00,0.00
2024-12-10 17:22:48,100,6420,38,62,4266.81,8374.01,0.00
2024-12-10 17:22:48,99,6420,38,61,4303.99,8374.07,0.00
2024-12-10 17:22:48,99,6421,38,61,4308.99,8375.00,0.00
2024-12-10 17:22:48,100,6421,39,61,4265.90,8375.01,0.00
2024-12-10 17:22:48,101,6420,40,61,4152.74,8375.88,0.00
2024-12-10 17:22:48,101,6421,40,61,4278.03,8376.00,0.00
2024-12-10 17:22:48,102,6421,41,61,4236.09,8376.01,0.00
2024-12-10 17:22:48,101,6421,41,60,4272.23,8376.07,0.00
2024-12-10 17:22:48,101,6422,41,60,4354.81,8377.00,0.00
2024-12-10 17:22:48,102,6422,41,61,4312.11,8377.01,0.00
2024-12-10 17:22:48,101,6422,40,61,4353.15,8377.02,0.00
2024-12-10 17:22:48,100,6422,40,60,4392.50,8377.06,0.00
2024-12-10 17:22:48,99,6422,39,60,4436.02,8377.06,0.00
2024-12-10 17:22:48,100,6421,39,61,4359.10,8377.47,0.00
2024-12-10 17:22:48,101,6420,40,61,4330.26,8377.80,0.00
2024-12-10 17:22:48,101,6421,40,61,4403.09,8378.00,0.00
2024-12-10 17:22:48,102,6421,41,61,4359.92,8378.01,0.00
2024-12-10 17:22:48,101,6421,41,60,4400.58,8378.04,0.00
2024-12-10 17:22:48,100,6421,41,59,4442.91,8378.05,0.00
2024-12-10 17:22:48,100,6422,41,59,4602.04,8379.00,0.00
2024-12-10 17:22:48,101,6422,42,59,4556.47,8379.01,0.00
2024-12-10 17:22:48,101,6423,42,59,4540.19,8380.00,0.00
2024-12-10 17:22:48,102,6423,43,59,4495.68,8380.01,0.00
2024-12-10 17:22:48,101,6423,43,58,4536.88,8380.04,0.00
2024-12-10 17:22:48,100,6423,43,57,4580.57,8380.05,0.00
2024-12-10 17:22:48,99,6423,43,56,4626.00,8380.05,0.00
2024-12-10 17:22:48,100,6422,43,57,4570.53,8380.18,0.00
2024-12-10 17:22:48,100,6423,43,57,4629.78,8381.00,0.00
2024-12-10 17:22:48,101,6423,44,57,4583.94,8381.01,0.00
2024-12-10 17:22:48,100,6423,43,57,4628.11,8381.02,0.00
2024-12-10 17:22:48,99,6423,43,56,4672.32,8381.04,0.00
2024-12-10 17:22:48,98,6423,43,55,4719.14,8381.04,0.00
2024-12-10 17:22:48,98,6424,43,55,4783.60,8382.00,0.00
2024-12-10 17:22:48,99,6424,43,56,4735.28,8382.01,0.00
2024-12-10 17:22:48,98,6424,42,56,4780.18,8382.04,0.00
2024-12-10 17:22:48,98,6425,42,56,4753.13,8383.00,0.00
2024-12-10 17:22:48,99,6425,42,57,4705.12,8383.01,0.00
2024-12-10 17:22:48,98,6425,42,56,4749.71,8383.04,0.00
2024-12-10 17:22:48,98,6426,42,56,4717.90,8384.00,0.00
2024-12-10 17:22:48,99,6426,43,56,4670.25,8384.01,0.00
2024-12-10 17:22:48,98,6426,43,55,4714.49,8384.04,0.00
2024-12-10 17:22:48,97,6426,43,54,4680.94,8384.74,0.00
2024-12-10 17:22:48,96,6426,42,54,4710.02,8384.89,0.00
2024-12-10 17:22:48,96,6427,42,54,4787.86,8385.00,0.00
2024-12-10 17:22:48,97,6427,42,55,4738.50,8385.01,0.00
2024-12-10 17:22:48,96,6427,42,54,4784.37,8385.04,0.00
2024-12-10 17:22:48,96,6428,42,54,4773.13,8386.00,0.00
2024-12-10 17:22:48,97,6428,42,55,4723.92,8386.01,0.00
2024-12-10 17:22:48,96,6428,42,54,4770.84,8386.03,0.00
2024-12-10 17:22:49,95,6428,42,53,4775.63,8386.34,0.00
2024-12-10 17:22:49,95,6429,42,53,4808.76,8387.00,0.00
2024-12-10 17:22:49,96,6429,42,54,4758.67,8387.01,0.00
2024-12-10 17:22:49,95,6429,41,54,4806.12,8387.03,0.00
2024-12-10 17:22:49,95,6430,41,54,4813.75,8388.00,0.00
2024-12-10 17:22:49,96,6430,42,54,4763.61,8388.01,0.00
2024-12-10 17:22:49,95,6430,41,54,4811.11,8388.03,0.00
2024-12-10 17:22:49,95,6431,41,54,4818.74,8389.00,0.00
2024-12-10 17:22:49,96,6431,41,55,4768.55,8389.01,0.00
2024-12-10 17:22:49,97,6430,41,56,4713.35,8389.10,0.00
2024-12-10 17:22:49,97,6431,41,56,4796.93,8390.00,0.00
2024-12-10 17:22:49,98,6431,42,56,4747.98,8390.01,0.00
2024-12-10 17:22:49,98,6432,42,56,4836.74,8391.00,0.00
2024-12-10 17:22:49,99,6432,43,56,4787.88,8391.01,0.00
2024-12-10 17:22:49,99,6433,43,56,4790.15,8392.00,0.00
2024-12-10 17:22:49,100,6433,44,56,4742.25,8392.01,0.00
2024-12-10 17:22:49,99,6433,43,56,4788.46,8392.02,0.00
2024-12-10 17:22:49,98,6433,42,56,4836.46,8392.02,0.00
2024-12-10 17:22:49,97,6433,42,55,4885.46,8392.02,0.00
2024-12-10 17:22:49,97,6434,42,55,4890.36,8393.00,0.00
2024-12-10 17:22:49,98,6434,43,55,4840.46,8393.01,0.00
2024-12-10 17:22:49,98,6435,43,55,4783.88,8394.00,0.00
2024-12-10 17:22:49,99,6435,44,55,4735.56,8394.01,0.00
2024-12-10 17:22:49,98,6435,44,54,4705.24,8394.81,0.00
2024-12-10 17:22:49,98,6436,44,54,4774.80,8395.00,0.00
2024-12-10 17:22:49,99,6436,45,54,4726.57,8395.01,0.00
2024-12-10 17:22:49,99,6437,45,54,4728.83,8396.00,0.00
2024-12-10 17:22:49,100,6437,46,54,4681.54,8396.01,0.00
2024-12-10 17:22:49,101,6436,46,55,4629.39,8396.10,0.00
2024-12-10 17:22:49,101,6437,46,55,4708.90,8397.00,0.00
2024-12-10 17:22:49,102,6437,47,55,4662.73,8397.01,0.00
2024-12-10 17:22:49,102,6438,47,55,4743.81,8398.00,0.00
2024-12-10 17:22:49,103,6438,48,55,4697.76,8398.01,0.00
2024-12-10 17:22:49,103,6439,48,55,4693.40,8399.00,0.00
2024-12-10 17:22:49,104,6439,48,56,4648.27,8399.01,0.00
2024-12-10 17:22:49,103,6439,47,56,4691.77,8399.02,0.00
2024-12-10 17:22:49,103,6440,47,56,4687.79,8400.00,0.00
2024-12-10 17:22:49,104,6440,47,57,4642.71,8400.01,0.00
2024-12-10 17:22:49,104,6441,47,57,4607.82,8401.00,0.00
2024-12-10 17:22:49,105,6441,47,58,4563.93,8401.01,0.00
2024-12-10 17:22:49,105,6442,47,58,4497.77,8402.00,0.00
2024-12-10 17:22:49,106,6442,47,59,4455.34,8402.01,0.00
2024-12-10 17:22:49,105,6442,47,58,4406.74,8402.87,0.00
2024-12-10 17:22:49,105,6443,47,58,4449.04,8403.00,0.00
2024-12-10 17:22:49,106,6443,47,59,4407.06,8403.01,0.00
2024-12-10 17:22:49,105,6443,46,59,4346.20,8403.88,0.00
2024-12-10 17:22:49,105,6444,46,59,4415.94,8404.00,0.00
2024-12-10 17:22:49,106,6444,47,59,4374.28,8404.01,0.00
2024-12-10 17:22:49,105,6444,47,58,4413.55,8404.03,0.00
2024-12-10 17:22:49,104,6444,47,57,4396.90,8404.62,0.00
2024-12-10 17:22:49,104,6445,47,57,4445.69,8405.00,0.00
2024-12-10 17:22:49,105,6445,48,57,4403.35,8405.01,0.00
2024-12-10 17:22:49,105,6446,48,57,4400.67,8406.00,0.00
2024-12-10 17:22:49,106,6446,49,57,4359.16,8406.01,0.00
2024-12-10 17:22:49,105,6446,48,57,4397.49,8406.04,0.00
2024-12-10 17:22:49,105,6447,48,57,4397.19,8407.00,0.00
2024-12-10 17:22:49,106,6447,49,57,4355.71,8407.01,0.00
2024-12-10 17:22:49,106,6448,49,57,4352.26,8408.00,0.00
2024-12-10 17:22:49,107,6448,49,58,4311.59,8408.01,0.00
2024-12-10 17:22:49,106,6448,49,57,4349.10,8408.04,0.00
2024-12-10 17:22:49,106,6449,49,57,4348.02,8409.00,0.00
2024-12-10 17:22:49,107,6449,49,58,4307.38,8409.01,0.00
2024-12-10 17:22:49,107,6450,49,58,4279.04,8410.00,0.00
2024-12-10 17:22:49,108,6450,50,58,4239.42,8410.01,0.00
2024-12-10 17:22:49,107,6450,50,57,4275.14,8410.05,0.00
2024-12-10 17:22:49,107,6451,50,57,4245.41,8411.00,0.00
2024-12-10 17:22:49,108,6451,50,58,4206.10,8411.01,0.00
2024-12-10 17:22:49,107,6451,50,57,4241.51,8411.05,0.00
2024-12-10 17:22:49,106,6451,49,57,4275.18,8411.11,0.00
2024-12-10 17:22:49,105,6451,49,56,4229.89,8411.91,0.00
2024-12-10 17:22:49,105,6452,49,56,4302.87,8412.00,0.00
2024-12-10 17:22:49,106,6452,49,57,4262.28,8412.01,0.00
2024-12-10 17:22:49,107,6451,49,58,4209.12,8412.19,0.00
2024-12-10 17:22:49,107,6452,49,58,4287.42,8413.00,0.00
2024-12-10 17:22:49,108,6452,49,59,4247.72,8413.01,0.00
2024-12-10 17:22:49,107,6452,49,58,4282.73,8413.06,0.00
2024-12-10 17:22:49,107,6453,49,58,4342.49,8414.00,0.00
2024-12-10 17:22:49,108,6453,49,59,4302.28,8414.01,0.00
2024-12-10 17:22:49,107,6453,49,58,4337.80,8414.06,0.00
2024-12-10 17:22:49,107,6454,49,58,4296.88,8415.00,0.00
2024-12-10 17:22:49,108,6454,50,58,4257.09,8415.01,0.00
2024-12-10 17:22:49,107,6454,49,58,4292.18,8415.06,0.00
2024-12-10 17:22:49,107,6455,49,58,4220.61,8416.00,0.00
2024-12-10 17:22:49,108,6455,49,59,4181.53,8416.01,0.00
2024-12-10 17:22:49,107,6455,48,59,4215.91,8416.06,0.00
2024-12-10 17:22:49,106,6455,48,58,4171.33,8416.85,0.00
2024-12-10 17:22:50,106,6456,48,58,4212.22,8417.00,0.00
2024-12-10 17:22:50,107,6456,49,58,4172.85,8417.01,0.00
2024-12-10 17:22:50,106,6456,48,58,4207.48,8417.06,0.00
2024-12-10 17:22:50,105,6456,47,58,4205.11,8417.30,0.00
2024-12-10 17:22:50,104,6456,46,58,4195.32,8417.90,0.00
2024-12-10 17:22:50,104,6457,46,58,4267.45,8418.00,0.00
2024-12-10 17:22:50,105,6457,47,58,4226.81,8418.01,0.00
2024-12-10 17:22:50,104,6457,47,57,4262.61,8418.06,0.00
2024-12-10 17:22:50,104,6458,47,57,4259.35,8419.00,0.00
2024-12-10 17:22:50,105,6458,47,58,4218.78,8419.01,0.00
2024-12-10 17:22:50,106,6457,47,59,4171.07,8419.12,0.00
2024-12-10 17:22:50,106,6458,47,59,4212.31,8420.00,0.00
2024-12-10 17:22:50,107,6458,48,59,4172.94,8420.01,0.00
2024-12-10 17:22:50,106,6458,48,58,4207.57,8420.06,0.00
2024-12-10 17:22:50,105,6458,47,58,4167.06,8420.80,0.00
2024-12-10 17:22:50,105,6459,47,58,4310.78,8421.00,0.00
2024-12-10 17:22:50,106,6459,48,58,4270.11,8421.01,0.00
2024-12-10 17:22:50,105,6459,47,58,4305.99,8421.06,0.00
2024-12-10 17:22:50,105,6460,47,58,4298.70,8422.00,0.00
2024-12-10 17:22:50,106,6460,48,58,4258.15,8422.01,0.00
2024-12-10 17:22:50,105,6460,48,57,4293.91,8422.06,0.00
2024-12-10 17:22:50,105,6461,48,57,4287.23,8423.00,0.00
2024-12-10 17:22:50,106,6461,49,57,4246.79,8423.01,0.00
2024-12-10 17:22:50,105,6461,49,56,4282.44,8423.06,0.00
2024-12-10 17:22:50,105,6462,49,56,4276.23,8424.00,0.00
2024-12-10 17:22:50,106,6462,49,57,4235.88,8424.01,0.00
2024-12-10 17:22:50,105,6462,49,56,4275.42,8424.01,0.00
2024-12-10 17:22:50,105,6463,49,56,4265.42,8425.00,0.00
2024-12-10 17:22:50,106,6463,50,56,4225.18,8425.01,0.00
2024-12-10 17:22:50,106,6464,50,56,4214.97,8426.00,0.00
2024-12-10 17:22:50,107,6464,51,56,4175.58,8426.01,0.00
2024-12-10 17:22:50,106,6464,51,55,4192.36,8426.08,0.00
2024-12-10 17:22:50,106,6465,51,55,4191.29,8427.00,0.00
2024-12-10 17:22:50,107,6465,51,56,4152.12,8427.01,0.00
2024-12-10 17:22:50,107,6466,51,56,4123.79,8428.00,0.00
2024-12-10 17:22:50,108,6466,52,56,4085.61,8428.01,0.00
2024-12-10 17:22:50,107,6466,51,56,4117.98,8428.01,0.00
2024-12-10 17:22:50,106,6466,50,56,4151.29,8428.07,0.00
2024-12-10 17:22:50,106,6467,50,56,4152.55,8429.00,0.00
2024-12-10 17:22:50,107,6467,50,57,4113.74,8429.01,0.00
2024-12-10 17:22:50,106,6467,49,57,4147.01,8429.07,0.00
2024-12-10 17:22:50,106,6468,49,57,4148.27,8430.00,0.00
2024-12-10 17:22:50,107,6468,50,57,4109.50,8430.01,0.00
2024-12-10 17:22:50,106,6468,50,56,4142.73,8430.07,0.00
2024-12-10 17:22:50,105,6468,49,56,4143.83,8430.52,0.00
2024-12-10 17:22:50,105,6469,49,56,4089.40,8431.00,0.00
2024-12-10 17:22:50,106,6469,49,57,4050.82,8431.01,0.00
2024-12-10 17:22:50,105,6469,48,57,4083.22,8431.07,0.00
2024-12-10 17:22:50,104,6469,48,56,4044.04,8431.86,0.00
2024-12-10 17:22:50,103,6469,47,56,4048.43,8431.87,0.00
2024-12-10 17:22:50,103,6470,47,56,4119.76,8432.00,0.00
2024-12-10 17:22:50,104,6470,48,56,4080.15,8432.01,0.00
2024-12-10 17:22:50,103,6470,47,56,4111.08,8432.07,0.00
2024-12-10 17:22:50,104,6469,48,56,4006.20,8432.87,0.00
2024-12-10 17:22:50,104,6470,48,56,4030.33,8433.00,0.00
2024-12-10 17:22:50,105,6470,49,56,3991.95,8433.01,0.00
2024-12-10 17:22:50,104,6470,48,56,4018.68,8433.07,0.00
2024-12-10 17:22:50,103,6470,47,56,3968.28,8433.85,0.00
2024-12-10 17:22:50,103,6471,47,56,4061.43,8434.00,0.00
2024-12-10 17:22:50,104,6471,47,57,4022.38,8434.01,0.00
2024-12-10 17:22:50,103,6471,46,57,4046.05,8434.07,0.00
2024-12-10 17:22:50,103,6472,46,57,4049.78,8435.00,0.00
2024-12-10 17:22:50,104,6472,46,58,4010.84,8435.01,0.00
2024-12-10 17:22:50,103,6472,46,57,4030.50,8435.07,0.00
2024-12-10 17:22:50,103,6473,46,57,4034.23,8436.00,0.00
2024-12-10 17:22:50,104,6473,46,58,3995.44,8436.01,0.00
2024-12-10 17:22:50,103,6473,46,57,4013.13,8436.05,0.00
2024-12-10 17:22:50,102,6473,46,56,4050.83,8436.06,0.00
2024-12-10 17:22:50,102,6474,46,56,3995.63,8437.00,0.00
2024-12-10 17:22:50,103,6474,47,56,3956.84,8437.01,0.00
2024-12-10 17:22:50,102,6474,46,56,3990.68,8437.06,0.00
2024-12-10 17:22:50,101,6474,45,56,3953.07,8437.84,0.00
2024-12-10 17:22:50,101,6475,45,56,4023.38,8438.00,0.00
2024-12-10 17:22:50,102,6475,46,56,3983.93,8438.01,0.00
2024-12-10 17:22:50,101,6475,45,56,4018.39,8438.06,0.00
2024-12-10 17:22:50,101,6476,45,56,4023.02,8439.00,0.00
2024-12-10 17:22:50,102,6476,46,56,3983.58,8439.01,0.00
2024-12-10 17:22:50,101,6476,45,56,4018.03,8439.06,0.00
2024-12-10 17:22:50,101,6477,45,56,3973.92,8440.00,0.00
2024-12-10 17:22:50,102,6477,46,56,3934.96,8440.01,0.00
2024-12-10 17:22:50,101,6477,46,55,3968.92,8440.06,0.00
2024-12-10 17:22:50,100,6477,45,55,3923.95,8440.82,0.00
2024-12-10 17:22:50,100,6478,45,55,3993.31,8441.00,0.00
2024-12-10 17:22:50,101,6478,46,55,3953.77,8441.01,0.00
2024-12-10 17:22:50,100,6478,46,54,3988.26,8441.06,0.00
2024-12-10 17:22:50,100,6479,46,54,3993.78,8442.00,0.00
2024-12-10 17:22:50,101,6479,47,54,3954.24,8442.01,0.00
2024-12-10 17:22:50,100,6479,46,54,3988.74,8442.06,0.00
2024-12-10 17:22:50,100,6480,46,54,3994.26,8443.00,0.00
2024-12-10 17:22:50,101,6480,46,55,3954.71,8443.01,0.00
2024-12-10 17:22:50,100,6480,45,55,3989.21,8443.06,0.00
2024-12-10 17:22:51,100,6481,45,55,3994.73,8444.00,0.00
2024-12-10 17:22:51,101,6481,46,55,3955.18,8444.01,0.00
2024-12-10 17:22:51,101,6482,46,55,3955.65,8445.00,0.00
2024-12-10 17:22:51,102,6482,47,55,3916.86,8445.01,0.00
2024-12-10 17:22:51,101,6482,47,54,3935.69,8445.03,0.00
2024-12-10 17:22:51,100,6482,47,53,3972.52,8445.05,0.00
2024-12-10 17:22:51,100,6483,47,53,3966.41,8446.00,0.00
2024-12-10 17:22:51,101,6483,48,53,3927.14,8446.01,0.00
2024-12-10 17:22:51,100,6483,48,52,3940.19,8446.02,0.00
2024-12-10 17:22:51,99,6483,47,52,3977.44,8446.04,0.00
2024-12-10 17:22:51,98,6483,47,51,4012.85,8446.06,0.00
2024-12-10 17:22:51,97,6483,47,50,4043.59,8446.18,0.00
2024-12-10 17:22:51,97,6484,47,50,4061.47,8447.00,0.00
2024-12-10 17:22:51,98,6484,48,50,4020.02,8447.01,0.00
2024-12-10 17:22:51,97,6484,47,50,4058.00,8447.04,0.00
2024-12-10 17:22:51,97,6485,47,50,3993.94,8448.00,0.00
2024-12-10 17:22:51,98,6485,48,50,3953.19,8448.01,0.00
2024-12-10 17:22:51,97,6485,48,49,3990.47,8448.04,0.00
2024-12-10 17:22:51,96,6485,48,48,4008.14,8448.25,0.00
2024-12-10 17:22:51,95,6485,47,48,3976.05,8448.83,0.00
2024-12-10 17:22:51,95,6486,47,48,4031.19,8449.00,0.00
2024-12-10 17:22:51,96,6486,48,48,3989.20,8449.01,0.00
2024-12-10 17:22:51,96,6487,48,48,3929.96,8450.00,0.00
2024-12-10 17:22:51,97,6487,49,48,3889.45,8450.01,0.00
2024-12-10 17:22:51,96,6487,49,47,3928.21,8450.02,0.00
2024-12-10 17:22:51,95,6487,49,46,3967.78,8450.03,0.00
2024-12-10 17:22:51,94,6487,49,45,4009.10,8450.03,0.00
2024-12-10 17:22:51,93,6487,48,45,4028.07,8450.24,0.00
2024-12-10 17:22:51,94,6486,48,46,3936.33,8450.80,0.00
2024-12-10 17:22:51,94,6487,48,46,3958.35,8451.00,0.00
2024-12-10 17:22:51,95,6487,49,46,3916.68,8451.01,0.00
2024-12-10 17:22:51,94,6487,49,45,3955.66,8451.03,0.00
2024-12-10 17:22:51,93,6487,48,45,3876.87,8451.81,0.00
2024-12-10 17:22:51,93,6488,48,45,3973.16,8452.00,0.00
2024-12-10 17:22:51,94,6488,49,45,3930.89,8452.01,0.00
2024-12-10 17:22:51,93,6488,48,45,3970.44,8452.03,0.00
2024-12-10 17:22:51,94,6487,49,45,3861.78,8452.78,0.00
2024-12-10 17:22:51,93,6487,48,45,3872.93,8452.86,0.00
2024-12-10 17:22:51,92,6487,47,45,3904.18,8452.87,0.00
2024-12-10 17:22:51,92,6488,47,45,3959.19,8453.00,0.00
2024-12-10 17:22:51,93,6488,48,45,3916.62,8453.01,0.00
2024-12-10 17:22:51,92,6488,48,44,3956.44,8453.03,0.00
2024-12-10 17:22:51,91,6488,47,44,3881.98,8453.77,0.00
2024-12-10 17:22:51,91,6489,47,44,3979.43,8454.00,0.00
2024-12-10 17:22:51,92,6489,47,45,3936.17,8454.01,0.00
2024-12-10 17:22:51,91,6489,47,44,3958.19,8454.03,0.00
2024-12-10 17:22:51,90,6489,46,44,4001.23,8454.03,0.00
2024-12-10 17:22:51,89,6489,45,44,3956.36,8454.85,0.00
2024-12-10 17:22:51,88,6489,44,44,3903.06,8454.99,0.00
2024-12-10 17:22:51,88,6490,44,44,3998.18,8455.00,0.00
2024-12-10 17:22:51,89,6490,44,45,3953.26,8455.01,0.00
2024-12-10 17:22:51,88,6490,44,44,3983.64,8455.01,0.00
2024-12-10 17:22:51,87,6490,43,44,4027.49,8455.02,0.00
2024-12-10 17:22:51,87,6491,43,44,3917.33,8456.00,0.00
2024-12-10 17:22:51,88,6491,44,44,3872.82,8456.01,0.00
2024-12-10 17:22:51,87,6491,44,43,3915.39,8456.02,0.00
2024-12-10 17:22:51,86,6491,43,43,3919.63,8456.50,0.00
2024-12-10 17:22:51,85,6491,42,43,3882.81,8456.86,0.00
2024-12-10 17:22:51,84,6491,42,42,3822.46,8456.99,0.00
2024-12-10 17:22:51,84,6492,42,42,3922.13,8457.00,0.00
2024-12-10 17:22:51,85,6492,43,42,3875.99,8457.01,0.00
2024-12-10 17:22:51,84,6492,43,41,3920.12,8457.02,0.00
2024-12-10 17:22:51,83,6492,42,41,3812.39,8457.88,0.00
2024-12-10 17:22:51,83,6493,42,41,3848.88,8458.00,0.00
2024-12-10 17:22:51,84,6493,43,41,3803.06,8458.01,0.00
2024-12-10 17:22:51,85,6492,43,42,3748.38,8458.15,0.00
2024-12-10 17:22:51,84,6492,43,41,3807.92,8458.76,0.00
2024-12-10 17:22:51,83,6492,42,41,3740.77,8458.94,0.00
2024-12-10 17:22:51,83,6493,42,41,3837.64,8459.00,0.00
2024-12-10 17:22:51,84,6493,42,42,3791.95,8459.01,0.00
2024-12-10 17:22:51,83,6493,42,41,3752.09,8459.80,0.00
2024-12-10 17:22:51,83,6494,42,41,3905.65,8460.00,0.00
2024-12-10 17:22:51,84,6494,42,42,3859.15,8460.01,0.00
2024-12-10 17:22:51,83,6494,41,42,3902.60,8460.04,0.00
2024-12-10 17:22:51,82,6494,40,42,3868.66,8460.87,0.00
2024-12-10 17:22:51,82,6495,40,42,3960.61,8461.00,0.00
2024-12-10 17:22:51,83,6495,40,43,3912.89,8461.01,0.00
2024-12-10 17:22:51,82,6495,40,42,3957.52,8461.04,0.00
2024-12-10 17:22:52,82,6496,40,42,3977.53,8462.00,0.00
2024-12-10 17:22:52,83,6496,40,43,3929.61,8462.01,0.00
2024-12-10 17:22:52,82,6496,40,42,3974.44,8462.04,0.00
2024-12-10 17:22:52,81,6496,39,42,3961.77,8462.74,0.00
2024-12-10 17:22:52,81,6497,39,42,3977.53,8463.00,0.00
2024-12-10 17:22:52,82,6497,40,42,3929.03,8463.01,0.00
2024-12-10 17:22:52,81,6497,40,41,3974.41,8463.04,0.00
2024-12-10 17:22:52,80,6497,39,41,3925.09,8463.78,0.00
2024-12-10 17:22:52,80,6498,39,41,3928.62,8464.00,0.00
2024-12-10 17:22:52,81,6498,39,42,3880.12,8464.01,0.00
2024-12-10 17:22:52,80,6498,39,41,3925.46,8464.04,0.00
2024-12-10 17:22:52,79,6498,38,41,3820.75,8464.92,0.00
2024-12-10 17:22:52,79,6499,38,41,3826.71,8465.00,0.00
2024-12-10 17:22:52,80,6499,38,42,3778.87,8465.01,0.00
2024-12-10 17:22:52,79,6499,38,41,3735.15,8465.28,0.00
2024-12-10 17:22:52,78,6499,37,41,3720.51,8465.87,0.00
2024-12-10 17:22:52,78,6500,37,41,3669.17,8466.00,0.00
2024-12-10 17:22:52,79,6500,37,42,3622.73,8466.01,0.00
2024-12-10 17:22:52,78,6500,37,41,3664.28,8466.01,0.00
2024-12-10 17:22:52,77,6500,37,40,3709.67,8466.03,0.00
2024-12-10 17:22:52,76,6500,37,39,3675.59,8466.95,0.00
2024-12-10 17:22:52,75,6500,36,39,3712.73,8466.97,0.00
2024-12-10 17:22:52,75,6501,36,39,3716.25,8467.00,0.00
2024-12-10 17:22:52,76,6501,37,39,3667.35,8467.01,0.00
2024-12-10 17:22:52,75,6501,36,39,3714.00,8467.03,0.00
2024-12-10 17:22:52,74,6501,36,38,3625.40,8467.97,0.00
2024-12-10 17:22:52,74,6502,36,38,3686.19,8468.00,0.00
2024-12-10 17:22:52,75,6502,36,39,3637.04,8468.01,0.00
2024-12-10 17:22:52,74,6502,35,39,3683.90,8468.03,0.00
2024-12-10 17:22:52,73,6502,35,38,3597.95,8468.95,0.00
2024-12-10 17:22:52,72,6502,35,37,3634.26,8468.97,0.00
2024-12-10 17:22:52,72,6503,35,37,3749.55,8469.00,0.00
2024-12-10 17:22:52,73,6503,35,38,3698.18,8469.01,0.00
2024-12-10 17:22:52,72,6503,34,38,3733.10,8469.10,0.00
2024-12-10 17:22:52,72,6504,34,38,3768.08,8470.00,0.00
2024-12-10 17:22:52,73,6504,35,38,3716.46,8470.01,0.00
2024-12-10 17:22:52,73,6505,35,38,3742.26,8471.00,0.00
2024-12-10 17:22:52,74,6505,35,39,3691.69,8471.01,0.00
2024-12-10 17:22:52,73,6505,35,38,3738.79,8471.04,0.00
2024-12-10 17:22:52,72,6505,35,37,3746.92,8471.53,0.00
2024-12-10 17:22:52,72,6506,35,37,3824.91,8472.00,0.00
2024-12-10 17:22:52,73,6506,35,38,3772.51,8472.01,0.00
2024-12-10 17:22:52,73,6507,35,38,3805.46,8473.00,0.00
2024-12-10 17:22:52,74,6507,36,38,3754.03,8473.01,0.00
2024-12-10 17:22:52,73,6507,36,37,3801.99,8473.04,0.00
2024-12-10 17:22:52,73,6508,36,37,3837.25,8474.00,0.00
2024-12-10 17:22:52,74,6508,37,37,3785.39,8474.01,0.00
2024-12-10 17:22:52,73,6508,37,36,3833.78,8474.04,0.00
2024-12-10 17:22:52,73,6509,37,36,3821.50,8475.00,0.00
2024-12-10 17:22:52,74,6509,38,36,3769.86,8475.01,0.00
2024-12-10 17:22:52,73,6509,37,36,3818.03,8475.04,0.00
2024-12-10 17:22:52,72,6509,37,35,3822.83,8475.42,0.00
2024-12-10 17:22:52,71,6509,37,34,3855.16,8475.44,0.00
2024-12-10 17:22:52,71,6510,37,34,3927.17,8476.00,0.00
2024-12-10 17:22:52,72,6510,38,34,3872.63,8476.01,0.00
2024-12-10 17:22:52,72,6511,38,34,3907.23,8477.00,0.00
2024-12-10 17:22:52,73,6511,39,34,3853.70,8477.01,0.00
2024-12-10 17:22:52,72,6511,38,34,3906.05,8477.01,0.00
2024-12-10 17:22:52,71,6511,38,33,3958.69,8477.03,0.00
2024-12-10 17:22:52,71,6512,38,33,3996.16,8478.00,0.00
2024-12-10 17:22:52,72,6512,39,33,3940.66,8478.01,0.00
2024-12-10 17:22:52,71,6512,38,33,3993.78,8478.03,0.00
2024-12-10 17:22:52,71,6513,38,33,3962.97,8479.00,0.00
2024-12-10 17:22:52,72,6513,39,33,3907.93,8479.01,0.00
2024-12-10 17:22:52,71,6513,38,33,3960.59,8479.03,0.00
2024-12-10 17:22:52,70,6513,38,32,3852.80,8479.80,0.00
2024-12-10 17:22:52,70,6514,38,32,3957.16,8480.00,0.00
2024-12-10 17:22:52,71,6514,38,33,3901.42,8480.01,0.00
2024-12-10 17:22:52,70,6514,37,33,3954.75,8480.03,0.00
2024-12-10 17:22:52,69,6514,37,32,4010.83,8480.03,0.00
2024-12-10 17:22:52,68,6514,36,32,3994.85,8480.69,0.00
2024-12-10 17:22:52,68,6515,36,32,4093.63,8481.00,0.00
2024-12-10 17:22:52,69,6515,37,32,4034.30,8481.02,0.00
2024-12-10 17:22:52,68,6515,36,32,4091.15,8481.03,0.00
2024-12-10 17:22:52,68,6516,36,32,4130.99,8482.00,0.00
2024-12-10 17:22:52,69,6516,37,32,4071.12,8482.02,0.00
2024-12-10 17:22:52,68,6516,37,31,4128.51,8482.03,0.00
2024-12-10 17:22:52,68,6517,37,31,4168.71,8483.00,0.00
2024-12-10 17:22:52,69,6517,38,31,4108.29,8483.02,0.00
2024-12-10 17:22:52,68,6517,38,30,4166.22,8483.03,0.00
2024-12-10 17:22:52,68,6518,38,30,4176.40,8484.00,0.00
2024-12-10 17:22:53,69,6518,39,30,4115.87,8484.02,0.00
2024-12-10 17:22:53,68,6518,38,30,4173.92,8484.03,0.00
2024-12-10 17:22:53,68,6519,38,30,4175.02,8485.00,0.00
2024-12-10 17:22:53,69,6519,38,31,4114.52,8485.02,0.00
2024-12-10 17:22:53,68,6519,38,30,4172.54,8485.03,0.00
2024-12-10 17:22:53,67,6519,38,29,4208.23,8485.16,0.00
2024-12-10 17:22:53,66,6519,38,28,4183.93,8485.76,0.00
2024-12-10 17:22:53,66,6520,38,28,4292.15,8486.00,0.00
2024-12-10 17:22:53,67,6520,38,29,4228.08,8486.02,0.00
2024-12-10 17:22:53,67,6521,38,29,4245.00,8487.00,0.00
2024-12-10 17:22:53,68,6521,39,29,4182.58,8487.02,0.00
2024-12-10 17:22:53,67,6521,39,28,4242.48,8487.03,0.00
2024-12-10 17:22:53,67,6522,39,28,4227.13,8488.00,0.00
2024-12-10 17:22:53,68,6522,40,28,4164.97,8488.02,0.00
2024-12-10 17:22:53,67,6522,39,28,4224.61,8488.03,0.00
2024-12-10 17:22:53,67,6523,39,28,4196.16,8489.00,0.00
2024-12-10 17:22:53,68,6523,40,28,4134.46,8489.02,0.00
2024-12-10 17:22:53,67,6523,40,27,4193.64,8489.03,0.00
2024-12-10 17:22:53,66,6523,40,26,4164.30,8489.88,0.00
2024-12-10 17:22:53,67,6522,40,27,4102.15,8489.90,0.00
2024-12-10 17:22:53,67,6523,40,27,4245.46,8490.00,0.00
2024-12-10 17:22:53,68,6523,40,28,4183.03,8490.02,0.00
2024-12-10 17:22:53,68,6524,40,28,4263.52,8491.00,0.00
2024-12-10 17:22:53,69,6524,41,28,4201.73,8491.02,0.00
2024-12-10 17:22:53,68,6524,40,28,4261.04,8491.03,0.00
2024-12-10 17:22:53,67,6524,39,28,4213.57,8491.85,0.00
2024-12-10 17:22:53,67,6525,39,28,4294.11,8492.00,0.00
2024-12-10 17:22:53,68,6525,40,28,4230.96,8492.02,0.00
2024-12-10 17:22:53,67,6525,39,28,4291.58,8492.03,0.00
2024-12-10 17:22:53,67,6526,39,28,4305.17,8493.00,0.00
2024-12-10 17:22:53,68,6526,40,28,4241.86,8493.02,0.00
2024-12-10 17:22:53,67,6526,39,28,4302.64,8493.03,0.00
2024-12-10 17:22:53,66,6526,39,27,4267.22,8493.95,0.00
2024-12-10 17:22:53,66,6527,39,27,4392.09,8494.00,0.00
2024-12-10 17:22:53,67,6527,40,27,4326.53,8494.02,0.00
2024-12-10 17:22:53,66,6527,39,27,4389.52,8494.03,0.00
2024-12-10 17:22:53,66,6528,39,27,4370.88,8495.00,0.00
2024-12-10 17:22:53,67,6528,40,27,4305.65,8495.02,0.00
2024-12-10 17:22:53,66,6528,39,27,4368.32,8495.03,0.00
2024-12-10 17:22:53,65,6528,39,26,4324.50,8495.65,0.00
2024-12-10 17:22:53,65,6529,39,26,4398.31,8496.00,0.00
2024-12-10 17:22:53,66,6529,40,26,4331.67,8496.02,0.00
2024-12-10 17:22:53,65,6529,39,26,4395.71,8496.03,0.00
2024-12-10 17:22:53,65,6530,39,26,4375.69,8497.00,0.00
2024-12-10 17:22:53,66,6530,39,27,4309.39,8497.02,0.00
2024-12-10 17:22:53,65,6530,39,26,4333.66,8497.49,0.00
2024-12-10 17:22:53,65,6531,39,26,4391.04,8498.00,0.00
2024-12-10 17:22:53,66,6531,40,26,4324.51,8498.02,0.00
2024-12-10 17:22:53,65,6531,39,26,4388.43,8498.03,0.00
2024-12-10 17:22:53,64,6531,38,26,4352.22,8498.88,0.00
2024-12-10 17:22:53,64,6532,38,26,4474.50,8499.00,0.00
2024-12-10 17:22:53,65,6532,38,27,4405.66,8499.02,0.00
2024-12-10 17:22:53,65,6533,38,27,4433.13,8500.00,0.00
2024-12-10 17:22:53,66,6533,39,27,4365.96,8500.02,0.00
2024-12-10 17:22:53,65,6533,39,26,4430.52,8500.03,0.00
2024-12-10 17:22:53,64,6533,38,26,4475.48,8500.31,0.00
2024-12-10 17:22:53,64,6534,38,26,4441.46,8501.00,0.00
2024-12-10 17:22:53,65,6534,38,27,4373.13,8501.02,0.00
2024-12-10 17:22:53,64,6534,37,27,4368.52,8501.63,0.00
2024-12-10 17:22:53,64,6535,37,27,4398.60,8502.00,0.00
2024-12-10 17:22:53,65,6535,37,28,4330.93,8502.02,0.00
2024-12-10 17:22:53,64,6535,37,27,4395.95,8502.03,0.00
2024-12-10 17:22:53,63,6535,36,27,4304.84,8502.89,0.00
2024-12-10 17:22:53,63,6536,36,27,4419.63,8503.00,0.00
2024-12-10 17:22:53,64,6536,37,27,4350.58,8503.02,0.00
2024-12-10 17:22:53,63,6536,37,26,4416.94,8503.03,0.00
2024-12-10 17:22:53,63,6537,37,26,4394.28,8504.00,0.00
2024-12-10 17:22:53,64,6537,38,26,4325.61,8504.02,0.00
2024-12-10 17:22:53,63,6537,37,26,4304.90,8504.73,0.00
2024-12-10 17:22:53,63,6538,37,26,4382.47,8505.00,0.00
2024-12-10 17:22:53,64,6538,37,27,4313.99,8505.02,0.00
2024-12-10 17:22:53,63,6538,36,27,4379.78,8505.03,0.00
2024-12-10 17:22:53,63,6539,36,27,4353.84,8506.00,0.00
2024-12-10 17:22:53,64,6539,36,28,4285.81,8506.02,0.00
2024-12-10 17:22:53,63,6539,35,28,4272.18,8506.62,0.00
2024-12-10 17:22:53,63,6540,35,28,4345.68,8507.00,0.00
2024-12-10 17:22:53,64,6540,35,29,4277.78,8507.02,0.00
2024-12-10 17:22:53,63,6540,34,29,4342.99,8507.03,0.00
2024-12-10 17:22:53,62,6540,33,29,4322.76,8507.84,0.00
2024-12-10 17:22:53,62,6541,33,29,4446.40,8508.00,0.00
2024-12-10 17:22:53,63,6541,33,30,4375.82,8508.02,0.00
2024-12-10 17:22:53,62,6541,33,29,4443.66,8508.03,0.00
2024-12-10 17:22:53,62,6542,33,29,4492.94,8509.00,0.00
2024-12-10 17:22:53,63,6542,33,30,4421.63,8509.02,0.00
2024-12-10 17:22:53,63,6543,33,30,4466.44,8510.00,0.00
2024-12-10 17:22:53,64,6543,34,30,4396.65,8510.02,0.00
2024-12-10 17:22:53,63,6543,33,30,4463.74,8510.03,0.00
2024-12-10 17:22:53,63,6544,33,30,4494.12,8511.00,0.00
2024-12-10 17:22:53,64,6544,33,31,4423.90,8511.02,0.00
2024-12-10 17:22:53,65,6543,33,32,4353.23,8511.08,0.00
2024-12-10 17:22:53,65,6543,33,32,4445.68,8512.00,0.00
2024-12-10 17:22:53,66,6543,34,32,4378.32,8512.02,0.00
2024-12-10 17:22:53,65,6543,34,31,4443.07,8512.03,0.00
2024-12-10 17:22:53,64,6543,34,30,4445.65,8512.48,0.00
2024-12-10 17:22:53,64,6544,34,30,4653.53,8513.00,0.00
2024-12-10 17:22:53,65,6544,35,30,4581.93,8513.02,0.00
2024-12-10 17:22:53,64,6544,35,29,4646.47,8513.09,0.00
2024-12-10 17:22:53,64,6545,35,29,4657.05,8514.00,0.00
2024-12-10 17:22:53,65,6545,36,29,4585.40,8514.02,0.00
2024-12-10 17:22:53,64,6545,36,28,4653.08,8514.05,0.00
2024-12-10 17:22:54,63,6545,35,28,4696.53,8514.35,0.00
2024-12-10 17:22:54,63,6546,35,28,4726.19,8515.00,0.00
2024-12-10 17:22:54,64,6546,35,29,4652.34,8515.02,0.00
2024-12-10 17:22:54,63,6546,34,29,4722.15,8515.05,0.00
2024-12-10 17:22:54,63,6547,34,29,4669.32,8516.00,0.00
2024-12-10 17:22:54,64,6547,34,30,4596.36,8516.02,0.00
2024-12-10 17:22:54,63,6547,34,29,4627.27,8516.35,0.00
2024-12-10 17:22:54,62,6547,33,29,4648.84,8516.50,0.00
2024-12-10 17:22:54,61,6547,32,29,4695.66,8516.80,0.00
2024-12-10 17:22:54,61,6548,32,29,4797.58,8517.00,0.00
2024-12-10 17:22:54,62,6548,33,29,4720.20,8517.02,0.00
2024-12-10 17:22:54,62,6549,33,29,4738.61,8518.00,0.00
2024-12-10 17:22:54,63,6549,33,30,4663.40,8518.02,0.00
2024-12-10 17:22:54,63,6550,33,30,4661.09,8519.00,0.00
2024-12-10 17:22:54,64,6550,33,31,4588.26,8519.02,0.00
2024-12-10 17:22:54,63,6550,33,30,4657.05,8519.05,0.00
2024-12-10 17:22:54,62,6550,32,30,4662.93,8519.44,0.00
2024-12-10 17:22:54,61,6550,32,29,4698.15,8519.80,0.00
2024-12-10 17:22:54,61,6551,32,29,4821.23,8520.00,0.00
2024-12-10 17:22:54,62,6551,33,29,4743.47,8520.02,0.00
2024-12-10 17:22:54,61,6551,32,29,4817.06,8520.05,0.00
2024-12-10 17:22:54,61,6552,32,29,4876.28,8521.00,0.00
2024-12-10 17:22:54,62,6552,32,30,4797.63,8521.02,0.00
2024-12-10 17:22:54,62,6553,32,30,4851.80,8522.00,0.00
2024-12-10 17:22:54,63,6553,32,31,4774.78,8522.02,0.00
2024-12-10 17:22:54,63,6554,32,31,4793.17,8523.00,0.00
2024-12-10 17:22:54,64,6554,32,32,4718.28,8523.02,0.00
2024-12-10 17:22:54,63,6554,31,32,4789.13,8523.05,0.00
2024-12-10 17:22:54,63,6555,31,32,4812.55,8524.00,0.00
2024-12-10 17:22:54,64,6555,32,32,4737.36,8524.02,0.00
2024-12-10 17:22:54,63,6555,32,31,4808.51,8524.05,0.00
2024-12-10 17:22:54,63,6556,32,31,4830.60,8525.00,0.00
2024-12-10 17:22:54,64,6556,32,32,4755.12,8525.02,0.00
2024-12-10 17:22:54,63,6556,31,32,4826.56,8525.05,0.00
2024-12-10 17:22:54,62,6556,31,31,4777.47,8525.85,0.00
2024-12-10 17:22:54,62,6557,31,31,4902.74,8526.00,0.00
2024-12-10 17:22:54,63,6557,32,31,4824.92,8526.02,0.00
2024-12-10 17:22:54,62,6557,31,31,4898.63,8526.05,0.00
2024-12-10 17:22:54,62,6558,31,31,4911.56,8527.00,0.00
2024-12-10 17:22:54,63,6558,31,32,4833.60,8527.02,0.00
2024-12-10 17:22:54,62,6558,31,31,4907.46,8527.05,0.00
2024-12-10 17:22:54,61,6558,30,31,4857.00,8527.57,0.00
2024-12-10 17:22:54,61,6559,30,31,4925.59,8528.00,0.00
2024-12-10 17:22:54,62,6559,31,31,4846.14,8528.02,0.00
2024-12-10 17:22:54,61,6559,30,31,4881.52,8528.38,0.00
2024-12-10 17:22:54,61,6560,30,31,4921.61,8529.00,0.00
2024-12-10 17:22:54,62,6560,30,32,4842.23,8529.02,0.00
2024-12-10 17:22:54,61,6560,30,31,4917.43,8529.05,0.00
2024-12-10 17:22:54,60,6560,30,30,4939.67,8529.55,0.00
2024-12-10 17:22:54,60,6561,30,30,5043.82,8530.00,0.00
2024-12-10 17:22:54,61,6561,31,30,4961.13,8530.02,0.00
2024-12-10 17:22:54,61,6562,31,30,4950.37,8531.00,0.00
2024-12-10 17:22:54,62,6562,31,31,4870.53,8531.02,0.00
2024-12-10 17:22:54,62,6563,31,31,4852.64,8532.00,0.00
2024-12-10 17:22:54,63,6563,31,32,4775.62,8532.02,0.00
2024-12-10 17:22:54,63,6564,31,32,4745.64,8533.00,0.00
2024-12-10 17:22:54,64,6564,31,33,4671.49,8533.02,0.00
2024-12-10 17:22:54,63,6564,31,32,4741.14,8533.06,0.00
2024-12-10 17:22:54,62,6564,31,31,4680.37,8533.85,0.00
2024-12-10 17:22:54,62,6565,31,31,4805.75,8534.00,0.00
2024-12-10 17:22:54,63,6565,32,31,4729.47,8534.02,0.00
2024-12-10 17:22:54,62,6565,32,30,4801.64,8534.05,0.00
2024-12-10 17:22:54,61,6565,31,30,4771.69,8534.80,0.00
2024-12-10 17:22:54,61,6566,31,30,4894.99,8535.00,0.00
2024-12-10 17:22:54,62,6566,31,31,4816.04,8535.02,0.00
2024-12-10 17:22:54,61,6566,31,30,4780.85,8535.74,0.00
2024-12-10 17:22:54,61,6567,31,30,4898.62,8536.00,0.00
2024-12-10 17:22:54,62,6567,31,31,4819.61,8536.02,0.00
2024-12-10 17:22:54,62,6568,31,31,4814.37,8537.00,0.00
2024-12-10 17:22:54,63,6568,32,31,4737.96,8537.02,0.00
2024-12-10 17:22:54,62,6568,31,31,4811.25,8537.05,0.00
2024-12-10 17:22:54,61,6568,31,30,4861.70,8537.33,0.00
2024-12-10 17:22:54,61,6569,31,30,4920.68,8538.00,0.00
2024-12-10 17:22:54,62,6569,31,31,4841.31,8538.02,0.00
2024-12-10 17:22:55,62,6570,31,31,4837.83,8539.00,0.00
2024-12-10 17:22:55,63,6570,31,32,4761.03,8539.02,0.00
2024-12-10 17:22:55,63,6571,31,32,4748.46,8540.00,0.00
2024-12-10 17:22:55,64,6571,31,33,4674.27,8540.02,0.00
2024-12-10 17:22:55,63,6571,30,33,4744.74,8540.05,0.00
2024-12-10 17:22:55,62,6571,29,33,4734.22,8540.82,0.00
2024-12-10 17:22:55,62,6572,29,33,4816.24,8541.00,0.00
2024-12-10 17:22:55,63,6572,29,34,4739.79,8541.02,0.00
2024-12-10 17:22:55,62,6572,29,33,4786.27,8541.35,0.00
2024-12-10 17:22:55,61,6572,28,33,4807.18,8541.84,0.00
2024-12-10 17:22:55,61,6573,28,33,4933.35,8542.00,0.00
2024-12-10 17:22:55,62,6573,28,34,4853.78,8542.02,0.00
2024-12-10 17:22:55,62,6574,28,34,4908.09,8543.00,0.00
2024-12-10 17:22:55,63,6574,28,35,4830.18,8543.02,0.00
2024-12-10 17:22:55,62,6574,28,34,4903.97,8543.05,0.00
2024-12-10 17:22:55,62,6575,28,34,4949.85,8544.00,0.00
2024-12-10 17:22:55,63,6575,28,35,4871.29,8544.02,0.00
2024-12-10 17:22:55,63,6576,28,35,4909.75,8545.00,0.00
2024-12-10 17:22:55,64,6576,28,36,4833.04,8545.02,0.00
2024-12-10 17:22:55,63,6576,27,36,4905.69,8545.05,0.00
2024-12-10 17:22:55,63,6577,27,36,4930.18,8546.00,0.00
2024-12-10 17:22:55,64,6577,28,36,4853.15,8546.02,0.00
2024-12-10 17:22:55,64,6578,28,36,4841.37,8547.00,0.00
2024-12-10 17:22:55,65,6578,29,36,4766.89,8547.02,0.00
2024-12-10 17:22:55,64,6578,28,36,4837.37,8547.05,0.00
2024-12-10 17:22:55,63,6578,28,35,4868.92,8547.25,0.00
2024-12-10 17:22:55,63,6579,28,35,4905.72,8548.00,0.00
2024-12-10 17:22:55,64,6579,28,36,4829.07,8548.02,0.00
2024-12-10 17:22:55,64,6580,28,36,4848.89,8549.00,0.00
2024-12-10 17:22:55,65,6580,29,36,4774.29,8549.02,0.00
2024-12-10 17:22:55,64,6580,28,36,4844.90,8549.05,0.00
2024-12-10 17:22:55,64,6581,28,36,4857.56,8550.00,0.00
2024-12-10 17:22:55,65,6581,28,37,4782.82,8550.02,0.00
2024-12-10 17:22:55,64,6581,27,37,4777.26,8550.81,0.00
2024-12-10 17:22:55,64,6582,27,37,4873.35,8551.00,0.00
2024-12-10 17:22:55,65,6582,27,38,4798.37,8551.02,0.00
2024-12-10 17:22:55,65,6583,27,38,4811.11,8552.00,0.00
2024-12-10 17:22:55,66,6583,27,39,4738.21,8552.02,0.00
2024-12-10 17:22:55,65,6583,26,39,4807.17,8552.05,0.00
2024-12-10 17:22:55,65,6584,26,39,4822.96,8553.00,0.00
2024-12-10 17:22:55,66,6584,27,39,4749.88,8553.02,0.00
2024-12-10 17:22:55,67,6583,27,40,4584.80,8553.82,0.00
2024-12-10 17:22:55,67,6584,27,40,4768.66,8554.00,0.00
2024-12-10 17:22:55,68,6584,28,40,4698.53,8554.02,0.00
2024-12-10 17:22:55,68,6585,28,40,4771.84,8555.00,0.00
2024-12-10 17:22:55,69,6585,28,41,4702.68,8555.02,0.00
2024-12-10 17:22:55,68,6585,28,40,4768.07,8555.04,0.00
2024-12-10 17:22:55,67,6585,27,40,4788.06,8555.46,0.00
2024-12-10 17:22:55,66,6585,26,40,4833.25,8555.70,0.00
2024-12-10 17:22:55,66,6586,26,40,4873.73,8556.00,0.00
2024-12-10 17:22:55,67,6586,27,40,4800.99,8556.02,0.00
2024-12-10 17:22:55,67,6587,27,40,4708.75,8557.00,0.00
2024-12-10 17:22:55,68,6587,28,40,4639.50,8557.02,0.00
2024-12-10 17:22:55,67,6587,27,40,4704.93,8557.05,0.00
2024-12-10 17:22:55,66,6587,26,40,4698.86,8557.47,0.00
2024-12-10 17:22:55,66,6588,26,40,4663.14,8558.00,0.00
2024-12-10 17:22:55,67,6588,27,40,4593.54,8558.02,0.00
2024-12-10 17:22:55,66,6588,27,39,4661.85,8558.02,0.00
2024-12-10 17:22:55,65,6588,27,38,4636.58,8558.75,0.00
2024-12-10 17:22:55,64,6588,27,37,4663.16,8558.84,0.00
2024-12-10 17:22:55,64,6589,27,37,4770.32,8559.00,0.00
2024-12-10 17:22:55,65,6589,27,38,4696.93,8559.02,0.00
2024-12-10 17:22:55,64,6589,27,37,4707.86,8559.73,0.00
2024-12-10 17:22:55,64,6590,27,37,4806.81,8560.00,0.00
2024-12-10 17:22:55,65,6590,28,37,4732.86,8560.02,0.00
2024-12-10 17:22:55,65,6591,28,37,4766.50,8561.00,0.00
2024-12-10 17:22:55,66,6591,29,37,4694.28,8561.02,0.00
2024-12-10 17:22:55,66,6592,29,37,4721.37,8562.00,0.00
2024-12-10 17:22:55,67,6592,29,38,4650.90,8562.02,0.00
2024-12-10 17:22:55,66,6592,29,37,4718.78,8562.03,0.00
2024-12-10 17:22:55,66,6593,29,37,4736.23,8563.00,0.00
2024-12-10 17:22:55,67,6593,30,37,4665.54,8563.02,0.00
2024-12-10 17:22:55,67,6594,30,37,4670.75,8564.00,0.00
2024-12-10 17:22:55,68,6594,31,37,4602.06,8564.02,0.00
2024-12-10 17:22:55,67,6594,31,36,4603.29,8564.81,0.00
2024-12-10 17:22:55,67,6595,31,36,4714.66,8565.00,0.00
2024-12-10 17:22:55,68,6595,31,37,4645.33,8565.02,0.00
2024-12-10 17:22:55,68,6596,31,37,4659.10,8566.00,0.00
2024-12-10 17:22:55,69,6596,31,38,4591.58,8566.02,0.00
2024-12-10 17:22:55,68,6596,31,37,4656.59,8566.03,0.00
2024-12-10 17:22:55,67,6596,31,36,4624.32,8566.82,0.00
2024-12-10 17:22:55,67,6597,31,36,4737.00,8567.00,0.00
2024-12-10 17:22:55,68,6597,32,36,4667.34,8567.02,0.00
2024-12-10 17:22:55,67,6597,31,36,4734.45,8567.03,0.00
2024-12-10 17:22:55,66,6597,31,35,4740.03,8567.26,0.00
2024-12-10 17:22:55,65,6597,30,35,4733.25,8567.72,0.00
2024-12-10 17:22:55,65,6598,30,35,4805.44,8568.00,0.00
2024-12-10 17:22:55,66,6598,30,36,4732.63,8568.02,0.00
2024-12-10 17:22:55,66,6599,30,36,4754.12,8569.00,0.00
2024-12-10 17:22:55,67,6599,31,36,4683.16,8569.02,0.00
2024-12-10 17:22:55,67,6600,31,36,4698.60,8570.00,0.00
2024-12-10 17:22:55,68,6600,31,37,4629.50,8570.02,0.00
2024-12-10 17:22:55,67,6600,30,37,4696.04,8570.03,0.00
2024-12-10 17:22:55,66,6600,29,37,4682.68,8570.77,0.00
2024-12-10 17:22:56,66,6601,29,37,4793.26,8571.00,0.00
2024-12-10 17:22:56,67,6601,29,38,4721.72,8571.02,0.00
2024-12-10 17:22:56,67,6602,29,38,4765.77,8572.00,0.00
2024-12-10 17:22:56,68,6602,29,39,4695.69,8572.02,0.00
2024-12-10 17:22:56,67,6602,29,38,4763.22,8572.03,0.00
2024-12-10 17:22:56,67,6603,29,38,4808.56,8573.00,0.00
2024-12-10 17:22:56,68,6603,29,39,4737.84,8573.02,0.00
2024-12-10 17:22:56,68,6604,29,39,4757.60,8574.00,0.00
2024-12-10 17:22:56,69,6604,29,40,4688.65,8574.02,0.00
2024-12-10 17:22:56,68,6604,28,40,4755.09,8574.03,0.00
2024-12-10 17:22:56,67,6604,28,39,4788.68,8574.24,0.00
2024-12-10 17:22:56,67,6605,28,39,4851.91,8575.00,0.00
2024-12-10 17:22:56,68,6605,28,40,4780.56,8575.02,0.00
2024-12-10 17:22:56,68,6606,28,40,4822.74,8576.00,0.00
2024-12-10 17:22:56,69,6606,28,41,4752.84,8576.02,0.00
2024-12-10 17:22:56,69,6607,28,41,4735.12,8577.00,0.00
2024-12-10 17:22:56,70,6607,29,41,4667.47,8577.02,0.00
2024-12-10 17:22:56,69,6607,28,41,4732.64,8577.03,0.00
2024-12-10 17:22:56,68,6607,28,40,4737.99,8577.40,0.00
2024-12-10 17:22:56,68,6608,28,40,4771.98,8578.00,0.00
2024-12-10 17:22:56,69,6608,28,41,4702.82,8578.02,0.00
2024-12-10 17:22:56,68,6608,27,41,4769.46,8578.03,0.00
2024-12-10 17:22:56,67,6608,27,40,4712.00,8578.94,0.00
2024-12-10 17:22:56,67,6609,27,40,4834.97,8579.00,0.00
2024-12-10 17:22:56,68,6609,27,41,4763.87,8579.02,0.00
2024-12-10 17:22:56,68,6610,27,41,4806.06,8580.00,0.00
2024-12-10 17:22:56,69,6610,28,41,4736.41,8580.02,0.00
2024-12-10 17:22:56,69,6611,28,41,4776.75,8581.00,0.00
2024-12-10 17:22:56,70,6611,28,42,4708.51,8581.02,0.00
2024-12-10 17:22:56,70,6612,28,42,4747.07,8582.00,0.00
2024-12-10 17:22:56,71,6612,29,42,4680.21,8582.01,0.00
2024-12-10 17:22:56,71,6613,29,42,4717.02,8583.00,0.00
2024-12-10 17:22:56,72,6613,30,42,4651.51,8583.01,0.00
2024-12-10 17:22:56,71,6613,29,42,4714.61,8583.03,0.00
2024-12-10 17:22:56,71,6614,29,42,4653.28,8584.00,0.00
2024-12-10 17:22:56,72,6614,30,42,4588.65,8584.01,0.00
2024-12-10 17:22:56,71,6614,29,42,4599.89,8584.35,0.00
2024-12-10 17:22:56,70,6614,29,41,4636.52,8584.36,0.00
2024-12-10 17:22:56,70,6615,29,41,4666.11,8585.00,0.00
2024-12-10 17:22:56,71,6615,30,41,4600.39,8585.01,0.00
2024-12-10 17:22:56,71,6616,30,41,4588.71,8586.00,0.00
2024-12-10 17:22:56,72,6616,31,41,4524.98,8586.01,0.00
2024-12-10 17:22:56,71,6616,31,40,4508.38,8586.90,0.00
2024-12-10 17:22:56,71,6617,31,40,4620.94,8587.00,0.00
2024-12-10 17:22:56,72,6617,32,40,4556.76,8587.01,0.00
2024-12-10 17:22:56,71,6617,31,40,4618.52,8587.03,0.00
2024-12-10 17:22:56,71,6618,31,40,4651.38,8588.00,0.00
2024-12-10 17:22:56,72,6618,32,40,4586.78,8588.01,0.00
2024-12-10 17:22:56,71,6618,31,40,4648.97,8588.03,0.00
2024-12-10 17:22:56,71,6619,31,40,4674.23,8589.00,0.00
2024-12-10 17:22:56,72,6619,31,41,4609.31,8589.01,0.00
2024-12-10 17:22:56,72,6620,31,41,4582.82,8590.00,0.00
2024-12-10 17:22:56,73,6620,32,41,4520.05,8590.01,0.00
2024-12-10 17:22:56,72,6620,32,40,4553.01,8590.14,0.00
2024-12-10 17:22:56,72,6621,32,40,4521.67,8591.00,0.00
2024-12-10 17:22:56,73,6621,32,41,4459.72,8591.01,0.00
2024-12-10 17:22:56,72,6621,31,41,4519.28,8591.03,0.00
2024-12-10 17:22:56,71,6621,31,40,4536.86,8591.42,0.00
2024-12-10 17:22:56,70,6621,30,40,4545.91,8591.70,0.00
2024-12-10 17:22:56,70,6622,30,40,4633.14,8592.00,0.00
2024-12-10 17:22:56,71,6622,31,40,4567.88,8592.01,0.00
2024-12-10 17:22:56,70,6622,30,40,4630.69,8592.03,0.00
2024-12-10 17:22:56,70,6623,30,40,4644.05,8593.00,0.00
2024-12-10 17:22:56,71,6623,31,40,4578.64,8593.01,0.00
2024-12-10 17:22:56,70,6623,30,40,4641.60,8593.03,0.00
2024-12-10 17:22:56,70,6624,30,40,4652.08,8594.00,0.00
2024-12-10 17:22:56,71,6624,30,41,4586.56,8594.01,0.00
2024-12-10 17:22:56,70,6624,30,40,4599.52,8594.60,0.00
2024-12-10 17:22:56,70,6625,30,40,4676.62,8595.00,0.00
2024-12-10 17:22:56,71,6625,30,41,4610.75,8595.01,0.00
2024-12-10 17:22:56,70,6625,29,41,4674.17,8595.03,0.00
2024-12-10 17:22:56,70,6626,29,41,4691.00,8596.00,0.00
2024-12-10 17:22:56,71,6626,30,41,4624.93,8596.01,0.00
2024-12-10 17:22:56,71,6627,30,41,4638.94,8597.00,0.00
2024-12-10 17:22:56,72,6627,31,41,4574.51,8597.01,0.00
2024-12-10 17:22:56,71,6627,31,40,4636.52,8597.03,0.00
2024-12-10 17:22:56,71,6628,31,40,4648.85,8598.00,0.00
2024-12-10 17:22:56,72,6628,32,40,4584.28,8598.01,0.00
2024-12-10 17:22:56,72,6629,32,40,4509.00,8599.00,0.00
2024-12-10 17:22:56,73,6629,33,40,4447.23,8599.01,0.00
2024-12-10 17:22:56,72,6629,32,40,4433.93,8599.56,0.00
2024-12-10 17:22:56,72,6630,32,40,4464.45,8600.00,0.00
2024-12-10 17:22:56,73,6630,32,41,4403.30,8600.01,0.00
2024-12-10 17:22:56,72,6630,31,41,4462.06,8600.03,0.00
2024-12-10 17:22:56,71,6630,30,41,4448.66,8600.76,0.00
2024-12-10 17:22:56,71,6631,30,41,4502.08,8601.00,0.00
2024-12-10 17:22:56,72,6631,30,42,4439.55,8601.01,0.00
2024-12-10 17:22:56,71,6631,30,41,4499.66,8601.03,0.00
2024-12-10 17:22:56,70,6631,29,41,4443.34,8601.83,0.00
2024-12-10 17:22:56,70,6632,29,41,4519.94,8602.00,0.00
2024-12-10 17:22:56,71,6632,30,41,4456.27,8602.01,0.00
2024-12-10 17:22:56,71,6633,30,41,4387.84,8603.00,0.00
2024-12-10 17:22:56,72,6633,30,42,4326.90,8603.01,0.00
2024-12-10 17:22:56,71,6633,29,42,4385.42,8603.03,0.00
2024-12-10 17:22:57,70,6633,29,41,4402.33,8603.49,0.00
2024-12-10 17:22:57,69,6633,29,40,4414.29,8603.70,0.00
2024-12-10 17:22:57,69,6634,29,40,4454.74,8604.00,0.00
2024-12-10 17:22:57,70,6634,30,40,4391.10,8604.02,0.00
2024-12-10 17:22:57,69,6634,29,40,4365.64,8604.81,0.00
2024-12-10 17:22:57,68,6634,28,40,4384.96,8604.84,0.00
2024-12-10 17:22:57,68,6635,28,40,4474.49,8605.00,0.00
2024-12-10 17:22:57,69,6635,28,41,4409.64,8605.02,0.00
2024-12-10 17:22:57,69,6636,28,41,4386.38,8606.00,0.00
2024-12-10 17:22:57,70,6636,28,42,4323.72,8606.02,0.00
2024-12-10 17:22:57,69,6636,27,42,4362.69,8606.12,0.00
2024-12-10 17:22:57,68,6636,27,41,4273.06,8606.84,0.00
2024-12-10 17:22:57,68,6637,27,41,4360.87,8607.00,0.00
2024-12-10 17:22:57,69,6637,28,41,4297.67,8607.02,0.00
2024-12-10 17:22:57,68,6637,28,40,4334.14,8607.22,0.00
2024-12-10 17:22:57,67,6637,28,39,4342.20,8607.81,0.00
2024-12-10 17:22:57,67,6638,28,39,4427.72,8608.00,0.00
2024-12-10 17:22:57,68,6638,28,40,4362.61,8608.02,0.00
2024-12-10 17:22:57,67,6638,28,39,4425.15,8608.03,0.00
2024-12-10 17:22:57,67,6639,28,39,4436.57,8609.00,0.00
2024-12-10 17:22:57,68,6639,28,40,4371.32,8609.02,0.00
2024-12-10 17:22:57,67,6639,28,39,4434.00,8609.03,0.00
2024-12-10 17:22:57,67,6640,28,39,4374.84,8610.00,0.00
2024-12-10 17:22:57,68,6640,29,39,4310.50,8610.02,0.00
2024-12-10 17:22:57,67,6640,28,39,4372.27,8610.03,0.00
2024-12-10 17:22:57,67,6641,28,39,4244.86,8611.00,0.00
2024-12-10 17:22:57,68,6641,28,40,4182.44,8611.02,0.00
2024-12-10 17:22:57,67,6641,28,39,4243.58,8611.02,0.00
2024-12-10 17:22:57,66,6641,28,38,4306.57,8611.02,0.00
2024-12-10 17:22:57,65,6641,28,37,4371.50,8611.02,0.00
2024-12-10 17:22:57,64,6641,27,37,4290.96,8611.70,0.00
2024-12-10 17:22:57,63,6641,26,37,4311.87,8611.81,0.00
2024-12-10 17:22:57,62,6641,26,36,4305.32,8611.84,0.00
2024-12-10 17:22:57,62,6642,26,36,4430.47,8612.00,0.00
2024-12-10 17:22:57,63,6642,26,37,4360.14,8612.02,0.00
2024-12-10 17:22:57,62,6642,26,36,4349.01,8612.66,0.00
2024-12-10 17:22:57,61,6642,25,36,4357.32,8612.82,0.00
2024-12-10 17:22:57,61,6643,25,36,4483.14,8613.00,0.00
2024-12-10 17:22:57,62,6643,26,36,4410.84,8613.02,0.00
2024-12-10 17:22:57,61,6643,25,36,4481.73,8613.02,0.00
2024-12-10 17:22:57,60,6643,24,36,4446.78,8613.72,0.00
2024-12-10 17:22:57,60,6644,24,36,4566.18,8614.00,0.00
2024-12-10 17:22:57,61,6644,25,36,4491.33,8614.02,0.00
2024-12-10 17:22:57,60,6644,24,36,4510.39,8614.43,0.00
2024-12-10 17:22:57,60,6645,24,36,4605.57,8615.00,0.00
2024-12-10 17:22:57,61,6645,25,36,4530.07,8615.02,0.00
2024-12-10 17:22:57,62,6644,25,37,4376.90,8615.98,0.00
2024-12-10 17:22:57,62,6645,25,37,4515.89,8616.00,0.00
2024-12-10 17:22:57,63,6645,26,37,4444.21,8616.02,0.00
2024-12-10 17:22:57,63,6646,26,37,4633.48,8617.00,0.00
2024-12-10 17:22:57,64,6646,27,37,4561.08,8617.02,0.00
2024-12-10 17:22:57,64,6647,27,37,4611.43,8618.00,0.00
2024-12-10 17:22:57,65,6647,27,38,4540.48,8618.02,0.00
2024-12-10 17:22:57,64,6647,27,37,4610.08,8618.02,0.00
2024-12-10 17:22:57,64,6648,27,37,4660.45,8619.00,0.00
2024-12-10 17:22:57,65,6648,27,38,4588.75,8619.02,0.00
2024-12-10 17:22:57,64,6648,27,37,4659.10,8619.02,0.00
2024-12-10 17:22:57,64,6649,27,37,4684.58,8620.00,0.00
2024-12-10 17:22:57,65,6649,28,37,4612.51,8620.02,0.00
2024-12-10 17:22:57,65,6650,28,37,4660.79,8621.00,0.00
2024-12-10 17:22:57,66,6650,29,37,4590.17,8621.02,0.00
2024-12-10 17:22:57,65,6650,29,36,4659.47,8621.02,0.00
2024-12-10 17:22:57,65,6651,29,36,4707.76,8622.00,0.00
2024-12-10 17:22:57,66,6651,30,36,4636.43,8622.02,0.00
2024-12-10 17:22:57,65,6651,30,35,4706.43,8622.02,0.00
2024-12-10 17:22:57,65,6652,30,35,4754.74,8623.00,0.00
2024-12-10 17:22:57,66,6652,30,36,4682.69,8623.02,0.00
2024-12-10 17:22:57,66,6653,30,36,4728.97,8624.00,0.00
2024-12-10 17:22:57,67,6653,31,36,4658.39,8624.02,0.00
2024-12-10 17:22:57,66,6653,30,36,4727.66,8624.02,0.00
2024-12-10 17:22:57,66,6654,30,36,4754.31,8625.00,0.00
2024-12-10 17:22:57,67,6654,31,36,4683.35,8625.02,0.00
2024-12-10 17:22:57,66,6654,31,35,4724.32,8625.20,0.00
2024-12-10 17:22:57,66,6655,31,35,4786.27,8626.00,0.00
2024-12-10 17:22:57,67,6655,31,36,4714.83,8626.02,0.00
2024-12-10 17:22:57,66,6655,31,35,4781.04,8626.02,0.00
2024-12-10 17:22:57,66,6656,31,35,4827.34,8627.00,0.00
2024-12-10 17:22:57,67,6656,31,36,4755.29,8627.02,0.00
2024-12-10 17:22:57,67,6657,31,36,4799.52,8628.00,0.00
2024-12-10 17:22:57,68,6657,31,37,4728.93,8628.02,0.00
2024-12-10 17:22:57,68,6658,31,37,4770.65,8629.00,0.00
2024-12-10 17:22:57,69,6658,32,37,4701.51,8629.02,0.00
2024-12-10 17:22:57,69,6659,32,37,4717.41,8630.00,0.00
2024-12-10 17:22:57,70,6659,32,38,4650.02,8630.02,0.00
2024-12-10 17:22:57,70,6660,32,38,4654.32,8631.00,0.00
2024-12-10 17:22:57,71,6660,32,39,4588.76,8631.01,0.00
2024-12-10 17:22:57,70,6660,32,38,4653.09,8631.02,0.00
2024-12-10 17:22:57,69,6660,31,38,4649.05,8631.54,0.00
2024-12-10 17:22:57,69,6661,31,38,4734.50,8632.00,0.00
2024-12-10 17:22:57,70,6661,32,38,4666.86,8632.02,0.00
2024-12-10 17:22:57,71,6660,32,39,4534.25,8632.80,0.00
2024-12-10 17:22:57,71,6661,32,39,4656.02,8633.00,0.00
2024-12-10 17:22:57,72,6661,33,39,4591.36,8633.01,0.00
2024-12-10 17:22:57,71,6661,33,38,4654.81,8633.01,0.00
2024-12-10 17:22:57,71,6662,33,38,4812.03,8634.00,0.00
2024-12-10 17:22:57,72,6662,34,38,4745.20,8634.01,0.00
2024-12-10 17:22:57,72,6663,34,38,4778.29,8635.00,0.00
2024-12-10 17:22:57,73,6663,35,38,4712.83,8635.01,0.00
2024-12-10 17:22:57,72,6663,35,37,4777.09,8635.01,0.00
2024-12-10 17:22:58,72,6664,35,37,4797.06,8636.00,0.00
2024-12-10 17:22:58,73,6664,35,38,4731.35,8636.01,0.00
2024-12-10 17:22:58,72,6664,35,37,4795.86,8636.01,0.00
2024-12-10 17:22:58,72,6665,35,37,4811.43,8637.00,0.00
2024-12-10 17:22:58,73,6665,35,38,4745.52,8637.01,0.00
2024-12-10 17:22:58,72,6665,35,37,4797.11,8637.11,0.00
2024-12-10 17:22:58,71,6665,34,37,4837.92,8637.14,0.00
2024-12-10 17:22:58,71,6666,34,37,4854.66,8638.00,0.00
2024-12-10 17:22:58,72,6666,34,38,4787.23,8638.01,0.00
2024-12-10 17:22:58,71,6666,34,37,4853.44,8638.01,0.00
2024-12-10 17:22:58,71,6667,34,37,4853.98,8639.00,0.00
2024-12-10 17:22:58,72,6667,34,38,4786.57,8639.01,0.00
2024-12-10 17:22:58,71,6667,34,37,4852.77,8639.01,0.00
2024-12-10 17:22:58,70,6667,34,36,4898.56,8639.29,0.00
2024-12-10 17:22:58,70,6668,34,36,4885.87,8640.00,0.00
2024-12-10 17:22:58,71,6668,34,37,4817.06,8640.01,0.00
2024-12-10 17:22:58,71,6669,34,37,4770.60,8641.00,0.00
2024-12-10 17:22:58,72,6669,35,37,4704.34,8641.01,0.00
2024-12-10 17:22:58,71,6669,35,36,4769.38,8641.01,0.00
2024-12-10 17:22:58,70,6669,35,35,4740.63,8641.74,0.00
2024-12-10 17:22:58,69,6669,35,34,4776.69,8641.84,0.00
2024-12-10 17:22:58,69,6670,35,34,4888.29,8642.00,0.00
2024-12-10 17:22:58,70,6670,36,34,4818.46,8642.02,0.00
2024-12-10 17:22:58,69,6670,35,34,4881.74,8642.07,0.00
2024-12-10 17:22:58,69,6671,35,34,4917.64,8643.00,0.00
2024-12-10 17:22:58,70,6671,36,34,4847.39,8643.02,0.00
2024-12-10 17:22:58,70,6672,36,34,4878.21,8644.00,0.00
2024-12-10 17:22:58,71,6672,36,35,4809.50,8644.01,0.00
2024-12-10 17:22:58,70,6672,36,34,4876.98,8644.02,0.00
2024-12-10 17:22:58,70,6673,36,34,4908.87,8645.00,0.00
2024-12-10 17:22:58,71,6673,37,34,4839.73,8645.01,0.00
2024-12-10 17:22:58,70,6673,37,33,4907.63,8645.02,0.00
2024-12-10 17:22:58,70,6674,37,33,4918.13,8646.00,0.00
2024-12-10 17:22:58,71,6674,37,34,4848.86,8646.01,0.00
2024-12-10 17:22:58,70,6674,36,34,4897.13,8646.07,0.00
2024-12-10 17:22:58,70,6675,36,34,4876.78,8647.00,0.00
2024-12-10 17:22:58,71,6675,36,35,4808.10,8647.01,0.00
2024-12-10 17:22:58,70,6675,35,35,4875.55,8647.02,0.00
2024-12-10 17:22:58,70,6676,35,35,4831.93,8648.00,0.00
2024-12-10 17:22:58,71,6676,36,35,4763.87,8648.01,0.00
2024-12-10 17:22:58,72,6675,36,36,4670.16,8648.36,0.00
2024-12-10 17:22:58,71,6675,36,35,4727.73,8648.86,0.00
2024-12-10 17:22:58,70,6675,36,34,4750.32,8648.87,0.00
2024-12-10 17:22:58,70,6676,36,34,4862.86,8649.00,0.00
2024-12-10 17:22:58,71,6676,36,35,4794.37,8649.01,0.00
2024-12-10 17:22:58,70,6676,35,35,4861.63,8649.02,0.00
2024-12-10 17:22:58,69,6676,35,34,4893.22,8649.45,0.00
2024-12-10 17:22:58,69,6677,35,34,5096.72,8650.00,0.00
2024-12-10 17:22:58,70,6677,35,35,5023.91,8650.02,0.00
2024-12-10 17:22:58,70,6678,35,35,5062.80,8651.00,0.00
2024-12-10 17:22:58,71,6678,36,35,4991.49,8651.01,0.00
2024-12-10 17:22:58,71,6679,36,35,5002.13,8652.00,0.00
2024-12-10 17:22:58,72,6679,37,35,4932.65,8652.01,0.00
2024-12-10 17:22:58,72,6680,37,35,4896.93,8653.00,0.00
2024-12-10 17:22:58,73,6680,38,35,4829.85,8653.01,0.00
2024-12-10 17:22:58,72,6680,37,35,4823.22,8653.61,0.00
2024-12-10 17:22:58,72,6681,37,35,4864.65,8654.00,0.00
2024-12-10 17:22:58,73,6681,38,35,4798.01,8654.01,0.00
2024-12-10 17:22:58,72,6681,37,35,4768.03,8654.83,0.00
2024-12-10 17:22:58,72,6682,37,35,4873.96,8655.00,0.00
2024-12-10 17:22:58,73,6682,37,36,4807.19,8655.01,0.00
2024-12-10 17:22:58,72,6682,37,35,4872.75,8655.01,0.00
2024-12-10 17:22:58,71,6682,37,34,4913.36,8655.11,0.00
2024-12-10 17:22:58,71,6683,37,34,4959.02,8656.00,0.00
2024-12-10 17:22:58,72,6683,37,35,4890.15,8656.01,0.00
2024-12-10 17:22:58,72,6684,37,35,4925.58,8657.00,0.00
2024-12-10 17:22:58,73,6684,38,35,4858.11,8657.01,0.00
2024-12-10 17:22:58,72,6684,37,35,4924.38,8657.01,0.00
2024-12-10 17:22:58,72,6685,37,35,4959.82,8658.00,0.00
2024-12-10 17:22:58,73,6685,38,35,4891.88,8658.01,0.00
2024-12-10 17:22:58,73,6686,38,35,4925.65,8659.00,0.00
2024-12-10 17:22:58,74,6686,39,35,4859.09,8659.01,0.00
2024-12-10 17:22:58,74,6687,39,35,4891.25,8660.00,0.00
2024-12-10 17:22:58,75,6687,39,36,4826.03,8660.01,0.00
2024-12-10 17:22:58,74,6687,38,36,4890.08,8660.01,0.00
2024-12-10 17:22:58,73,6687,38,35,4934.53,8660.10,0.00
2024-12-10 17:22:58,73,6688,38,35,4975.44,8661.00,0.00
2024-12-10 17:22:58,74,6688,39,35,4908.20,8661.01,0.00
2024-12-10 17:22:58,74,6689,39,35,4940.37,8662.00,0.00
2024-12-10 17:22:58,75,6689,39,36,4874.50,8662.01,0.00
2024-12-10 17:22:58,75,6690,39,36,4905.09,8663.00,0.00
2024-12-10 17:22:58,76,6690,39,37,4840.55,8663.01,0.00
2024-12-10 17:22:58,76,6691,39,37,4869.61,8664.00,0.00
2024-12-10 17:22:58,77,6691,40,37,4806.37,8664.01,0.00
2024-12-10 17:22:58,76,6691,39,37,4868.47,8664.01,0.00
2024-12-10 17:22:59,76,6692,39,37,4896.85,8665.00,0.00
2024-12-10 17:22:59,77,6692,40,37,4833.26,8665.01,0.00
2024-12-10 17:22:59,76,6692,40,36,4895.71,8665.01,0.00
2024-12-10 17:22:59,76,6693,40,36,4923.33,8666.00,0.00
2024-12-10 17:22:59,77,6693,40,37,4859.40,8666.01,0.00
2024-12-10 17:22:59,76,6693,40,36,4922.19,8666.01,0.00
2024-12-10 17:22:59,75,6693,40,35,4986.52,8666.01,0.00
2024-12-10 17:22:59,75,6694,40,35,5017.14,8667.00,0.00
2024-12-10 17:22:59,76,6694,40,36,4951.13,8667.01,0.00
2024-12-10 17:22:59,76,6695,40,36,4980.21,8668.00,0.00
2024-12-10 17:22:59,77,6695,41,36,4915.53,8668.01,0.00
2024-12-10 17:22:59,77,6696,41,36,4943.12,8669.00,0.00
2024-12-10 17:22:59,78,6696,41,37,4879.75,8669.01,0.00
2024-12-10 17:22:59,77,6696,40,37,4941.99,8669.01,0.00
2024-12-10 17:22:59,77,6697,40,37,4927.84,8670.00,0.00
2024-12-10 17:22:59,78,6697,41,37,4864.66,8670.01,0.00
2024-12-10 17:22:59,78,6698,41,37,4833.62,8671.00,0.00
2024-12-10 17:22:59,79,6698,41,38,4772.43,8671.01,0.00
2024-12-10 17:22:59,78,6698,41,37,4832.51,8671.01,0.00
2024-12-10 17:22:59,77,6698,40,37,4782.33,8671.83,0.00
2024-12-10 17:22:59,77,6699,40,37,4880.46,8672.00,0.00
2024-12-10 17:22:59,78,6699,41,37,4817.89,8672.01,0.00
2024-12-10 17:22:59,78,6700,41,37,4813.97,8673.00,0.00
2024-12-10 17:22:59,79,6700,41,38,4753.03,8673.01,0.00
2024-12-10 17:22:59,78,6700,40,38,4747.78,8673.62,0.00
2024-12-10 17:22:59,78,6701,40,38,4825.94,8674.00,0.00
2024-12-10 17:22:59,79,6701,40,39,4764.85,8674.01,0.00
2024-12-10 17:22:59,78,6701,40,38,4824.83,8674.01,0.00
2024-12-10 17:22:59,77,6701,40,37,4839.79,8674.47,0.00
2024-12-10 17:22:59,77,6702,40,37,4906.67,8675.00,0.00
2024-12-10 17:22:59,78,6702,40,38,4843.76,8675.01,0.00
2024-12-10 17:22:59,78,6703,40,38,4867.98,8676.00,0.00
2024-12-10 17:22:59,79,6703,40,39,4806.36,8676.01,0.00
2024-12-10 17:22:59,78,6703,40,38,4866.87,8676.01,0.00
2024-12-10 17:22:59,78,6704,40,38,4890.55,8677.00,0.00
2024-12-10 17:22:59,79,6704,41,38,4828.64,8677.01,0.00
2024-12-10 17:22:59,78,6704,40,38,4889.43,8677.01,0.00
2024-12-10 17:22:59,78,6705,40,38,4912.47,8678.00,0.00
2024-12-10 17:22:59,79,6705,40,39,4850.29,8678.01,0.00
2024-12-10 17:22:59,79,6706,40,39,4871.32,8679.00,0.00
2024-12-10 17:22:59,80,6706,40,40,4810.42,8679.01,0.00
2024-12-10 17:22:59,80,6707,40,40,4829.94,8680.00,0.00
2024-12-10 17:22:59,81,6707,41,40,4770.31,8680.01,0.00
2024-12-10 17:22:59,80,6707,40,40,4828.86,8680.01,0.00
2024-12-10 17:22:59,79,6707,39,40,4863.62,8680.09,0.00
2024-12-10 17:22:59,79,6708,39,40,4890.88,8681.00,0.00
2024-12-10 17:22:59,80,6708,39,41,4829.75,8681.01,0.00
2024-12-10 17:22:59,80,6709,39,41,4848.99,8682.00,0.00
2024-12-10 17:22:59,81,6709,39,42,4789.13,8682.01,0.00
2024-12-10 17:22:59,81,6710,39,42,4807.18,8683.00,0.00
2024-12-10 17:22:59,82,6710,39,43,4748.55,8683.01,0.00
2024-12-10 17:22:59,81,6710,38,43,4806.11,8683.01,0.00
2024-12-10 17:22:59,81,6711,38,43,4824.44,8684.00,0.00
2024-12-10 17:22:59,82,6711,39,43,4765.61,8684.01,0.00
2024-12-10 17:22:59,81,6711,38,43,4823.37,8684.01,0.00
2024-12-10 17:22:59,81,6712,38,43,4841.78,8685.00,0.00
2024-12-10 17:22:59,82,6712,39,43,4782.73,8685.01,0.00
2024-12-10 17:22:59,81,6712,38,43,4840.71,8685.01,0.00
2024-12-10 17:22:59,80,6712,37,43,4874.61,8685.29,0.00
2024-12-10 17:22:59,80,6713,37,43,4921.79,8686.00,0.00
2024-12-10 17:22:59,81,6713,38,43,4861.03,8686.01,0.00
2024-12-10 17:22:59,81,6714,38,43,4858.81,8687.00,0.00
2024-12-10 17:22:59,82,6714,39,43,4799.55,8687.01,0.00
2024-12-10 17:22:59,82,6715,39,43,4786.71,8688.00,0.00
2024-12-10 17:22:59,83,6715,40,43,4729.04,8688.01,0.00
2024-12-10 17:22:59,82,6715,40,42,4743.67,8688.48,0.00
2024-12-10 17:22:59,82,6716,40,42,4804.47,8689.00,0.00
2024-12-10 17:22:59,83,6716,41,42,4746.58,8689.01,0.00
2024-12-10 17:22:59,82,6716,41,41,4803.41,8689.01,0.00
2024-12-10 17:22:59,82,6717,41,41,4824.10,8690.00,0.00
2024-12-10 17:22:59,83,6717,41,42,4765.98,8690.01,0.00
2024-12-10 17:22:59,83,6718,41,42,4785.37,8691.00,0.00
2024-12-10 17:22:59,84,6718,42,42,4728.40,8691.01,0.00
2024-12-10 17:22:59,83,6718,42,41,4779.01,8691.06,0.00
2024-12-10 17:22:59,83,6719,42,41,4784.75,8692.00,0.00
2024-12-10 17:22:59,84,6719,42,42,4727.78,8692.01,0.00
2024-12-10 17:22:59,84,6720,42,42,4723.94,8693.00,0.00
2024-12-10 17:22:59,85,6720,43,42,4668.37,8693.01,0.00
2024-12-10 17:22:59,84,6720,42,42,4722.91,8693.01,0.00
2024-12-10 17:22:59,83,6720,42,41,4705.93,8693.57,0.00
2024-12-10 17:22:59,83,6721,42,41,4773.32,8694.00,0.00
2024-12-10 17:22:59,84,6721,42,42,4716.49,8694.01,0.00
2024-12-10 17:22:59,84,6722,42,42,4734.63,8695.00,0.00
2024-12-10 17:22:59,85,6722,42,43,4678.93,8695.01,0.00
2024-12-10 17:22:59,84,6722,42,42,4733.60,8695.01,0.00
2024-12-10 17:23:00,84,6723,42,42,4751.74,8696.00,0.00
2024-12-10 17:23:00,85,6723,42,43,4695.84,8696.01,0.00
2024-12-10 17:23:00,85,6724,42,43,4712.75,8697.00,0.00
2024-12-10 17:23:00,86,6724,42,44,4657.95,8697.01,0.00
2024-12-10 17:23:00,86,6725,42,44,4673.66,8698.00,0.00
2024-12-10 17:23:00,87,6725,43,44,4619.94,8698.01,0.00
2024-12-10 17:23:00,87,6726,43,44,4634.46,8699.00,0.00
2024-12-10 17:23:00,88,6726,43,45,4581.80,8699.01,0.00
2024-12-10 17:23:00,88,6727,43,45,4595.18,8700.00,0.00
2024-12-10 17:23:00,89,6727,44,45,4543.55,8700.01,0.00
2024-12-10 17:23:00,89,6728,44,45,4555.80,8701.00,0.00
2024-12-10 17:23:00,90,6728,45,45,4505.18,8701.01,0.00
2024-12-10 17:23:00,90,6729,45,45,4516.34,8702.00,0.00
2024-12-10 17:23:00,91,6729,46,45,4466.71,8702.01,0.00
2024-12-10 17:23:00,90,6729,45,45,4514.41,8702.02,0.00
2024-12-10 17:23:00,90,6730,45,45,4526.52,8703.00,0.00
2024-12-10 17:23:00,91,6730,46,45,4476.78,8703.01,0.00
2024-12-10 17:23:00,91,6731,46,45,4486.86,8704.00,0.00
2024-12-10 17:23:00,92,6731,47,45,4438.09,8704.01,0.00
2024-12-10 17:23:00,91,6731,46,45,4484.95,8704.02,0.00
2024-12-10 17:23:00,91,6732,46,45,4495.99,8705.00,0.00
2024-12-10 17:23:00,92,6732,47,45,4447.12,8705.01,0.00
2024-12-10 17:23:00,91,6732,47,44,4494.08,8705.02,0.00
2024-12-10 17:23:00,91,6733,47,44,4486.32,8706.00,0.00
2024-12-10 17:23:00,92,6733,47,45,4437.56,8706.01,0.00
2024-12-10 17:23:00,91,6733,47,44,4484.41,8706.02,0.00
2024-12-10 17:23:00,90,6733,47,43,4474.11,8706.40,0.00
2024-12-10 17:23:00,90,6734,47,43,4519.04,8707.00,0.00
2024-12-10 17:23:00,91,6734,48,43,4469.38,8707.01,0.00
2024-12-10 17:23:00,90,6734,47,43,4517.11,8707.02,0.00
2024-12-10 17:23:00,90,6735,47,43,4526.04,8708.00,0.00
2024-12-10 17:23:00,91,6735,47,44,4476.30,8708.01,0.00
2024-12-10 17:23:00,90,6735,47,43,4524.11,8708.02,0.00
2024-12-10 17:23:00,90,6736,47,43,4532.71,8709.00,0.00
2024-12-10 17:23:00,91,6736,48,43,4482.90,8709.01,0.00
2024-12-10 17:23:00,91,6737,48,43,4473.84,8710.00,0.00
2024-12-10 17:23:00,92,6737,49,43,4425.21,8710.01,0.00
2024-12-10 17:23:00,91,6737,48,43,4471.93,8710.02,0.00
2024-12-10 17:23:00,91,6738,48,43,4460.46,8711.00,0.00
2024-12-10 17:23:00,92,6738,48,44,4411.97,8711.01,0.00
2024-12-10 17:23:00,91,6738,48,43,4458.54,8711.02,0.00
2024-12-10 17:23:00,90,6738,47,43,4478.58,8711.33,0.00
2024-12-10 17:23:00,90,6739,47,43,4499.62,8712.00,0.00
2024-12-10 17:23:00,91,6739,48,43,4450.17,8712.01,0.00
2024-12-10 17:23:00,90,6739,48,42,4497.68,8712.02,0.00
2024-12-10 17:23:00,90,6740,48,42,4473.51,8713.00,0.00
2024-12-10 17:23:00,91,6740,48,43,4424.35,8713.01,0.00
2024-12-10 17:23:00,90,6740,48,42,4389.46,8713.60,0.00
2024-12-10 17:23:00,90,6741,48,42,4451.74,8714.00,0.00
2024-12-10 17:23:00,91,6741,48,43,4402.82,8714.01,0.00
2024-12-10 17:23:00,90,6741,47,43,4448.84,8714.03,0.00
2024-12-10 17:23:00,91,6740,47,44,4394.21,8714.12,0.00
2024-12-10 17:23:00,91,6741,47,44,4486.16,8715.00,0.00
2024-12-10 17:23:00,92,6741,48,44,4437.40,8715.01,0.00
2024-12-10 17:23:00,91,6741,47,44,4484.25,8715.02,0.00
2024-12-10 17:23:00,90,6741,46,44,4533.11,8715.02,0.00
2024-12-10 17:23:00,89,6741,46,43,4583.06,8715.02,0.00
2024-12-10 17:23:00,88,6741,45,43,4575.56,8715.52,0.00
2024-12-10 17:23:00,88,6742,45,43,4732.40,8716.00,0.00
2024-12-10 17:23:00,89,6742,45,44,4679.23,8716.01,0.00
2024-12-10 17:23:00,88,6742,44,44,4730.43,8716.02,0.00
2024-12-10 17:23:00,88,6743,44,44,4739.81,8717.00,0.00
2024-12-10 17:23:00,89,6743,44,45,4686.56,8717.01,0.00
2024-12-10 17:23:00,88,6743,44,44,4723.98,8717.19,0.00
2024-12-10 17:23:00,88,6744,44,44,4744.15,8718.00,0.00
2024-12-10 17:23:00,89,6744,44,45,4690.84,8718.01,0.00
2024-12-10 17:23:00,88,6744,44,44,4741.18,8718.03,0.00
2024-12-10 17:23:00,88,6745,44,44,4747.17,8719.00,0.00
2024-12-10 17:23:00,89,6745,45,44,4693.83,8719.01,0.00
2024-12-10 17:23:00,88,6745,45,43,4744.20,8719.03,0.00
2024-12-10 17:23:00,88,6746,45,43,4749.94,8720.00,0.00
2024-12-10 17:23:00,89,6746,45,44,4696.57,8720.01,0.00
2024-12-10 17:23:00,89,6747,45,44,4700.99,8721.00,0.00
2024-12-10 17:23:00,90,6747,46,44,4648.75,8721.01,0.00
2024-12-10 17:23:00,90,6748,46,44,4654.40,8722.00,0.00
2024-12-10 17:23:00,91,6748,47,44,4603.26,8722.01,0.00
2024-12-10 17:23:00,91,6749,47,44,4609.31,8723.00,0.00
2024-12-10 17:23:00,92,6749,48,44,4559.21,8723.01,0.00
2024-12-10 17:23:00,92,6750,48,44,4564.98,8724.00,0.00
2024-12-10 17:23:00,93,6750,49,44,4515.90,8724.01,0.00
2024-12-10 17:23:00,92,6750,48,44,4561.20,8724.04,0.00
2024-12-10 17:23:00,92,6751,48,44,4570.05,8725.00,0.00
2024-12-10 17:23:00,93,6751,48,45,4520.91,8725.01,0.00
2024-12-10 17:23:00,92,6751,47,45,4566.27,8725.04,0.00
2024-12-10 17:23:00,92,6752,47,45,4575.49,8726.00,0.00
2024-12-10 17:23:00,93,6752,47,46,4526.29,8726.01,0.00
2024-12-10 17:23:00,92,6752,47,45,4571.71,8726.04,0.00
2024-12-10 17:23:00,92,6753,47,45,4581.56,8727.00,0.00
2024-12-10 17:23:01,93,6753,48,45,4532.29,8727.01,0.00
2024-12-10 17:23:01,92,6753,48,44,4577.78,8727.04,0.00
2024-12-10 17:23:01,92,6754,48,44,4587.72,8728.00,0.00
2024-12-10 17:23:01,93,6754,48,45,4538.39,8728.01,0.00
2024-12-10 17:23:01,93,6755,48,45,4543.79,8729.00,0.00
2024-12-10 17:23:01,94,6755,48,46,4495.45,8729.01,0.00
2024-12-10 17:23:01,93,6755,47,46,4540.05,8729.04,0.00
2024-12-10 17:23:01,93,6756,47,46,4547.58,8730.00,0.00
2024-12-10 17:23:01,94,6756,47,47,4499.20,8730.01,0.00
2024-12-10 17:23:01,93,6756,47,46,4490.36,8730.61,0.00
2024-12-10 17:23:01,93,6757,47,46,4550.76,8731.00,0.00
2024-12-10 17:23:01,94,6757,47,47,4502.35,8731.01,0.00
2024-12-10 17:23:01,93,6757,47,46,4547.01,8731.04,0.00
2024-12-10 17:23:01,93,6758,47,46,4553.06,8732.00,0.00
2024-12-10 17:23:01,94,6758,47,47,4504.63,8732.01,0.00
2024-12-10 17:23:01,93,6758,46,47,4551.19,8732.02,0.00
2024-12-10 17:23:01,92,6758,45,47,4598.77,8732.03,0.00
2024-12-10 17:23:01,91,6758,45,46,4648.35,8732.03,0.00
2024-12-10 17:23:01,91,6759,45,46,4654.79,8733.00,0.00
2024-12-10 17:23:01,92,6759,46,46,4604.20,8733.01,0.00
2024-12-10 17:23:01,91,6759,45,46,4651.92,8733.03,0.00
2024-12-10 17:23:01,91,6760,45,46,4658.03,8734.00,0.00
2024-12-10 17:23:01,92,6760,45,47,4607.40,8734.01,0.00
2024-12-10 17:23:01,91,6760,44,47,4655.16,8734.03,0.00
2024-12-10 17:23:01,91,6761,44,47,4661.29,8735.00,0.00
2024-12-10 17:23:01,92,6761,44,48,4610.63,8735.01,0.00
2024-12-10 17:23:01,91,6761,43,48,4658.42,8735.03,0.00
2024-12-10 17:23:01,91,6762,43,48,4666.18,8736.00,0.00
2024-12-10 17:23:01,92,6762,44,48,4615.46,8736.01,0.00
2024-12-10 17:23:01,92,6763,44,48,4621.68,8737.00,0.00
2024-12-10 17:23:01,93,6763,44,49,4571.99,8737.01,0.00
2024-12-10 17:23:01,93,6764,44,49,4578.49,8738.00,0.00
2024-12-10 17:23:01,94,6764,44,50,4529.78,8738.01,0.00
2024-12-10 17:23:01,94,6765,44,50,4496.52,8739.00,0.00
2024-12-10 17:23:01,95,6765,44,51,4449.19,8739.01,0.00
2024-12-10 17:23:01,94,6765,44,50,4493.74,8739.03,0.00
2024-12-10 17:23:01,93,6765,44,49,4490.82,8739.51,0.00
2024-12-10 17:23:01,93,6766,44,49,4541.84,8740.00,0.00
2024-12-10 17:23:01,94,6766,45,49,4493.52,8740.01,0.00
2024-12-10 17:23:01,93,6766,45,48,4539.03,8740.03,0.00
2024-12-10 17:23:01,93,6767,45,48,4548.22,8741.00,0.00
2024-12-10 17:23:01,94,6767,45,49,4499.84,8741.01,0.00
2024-12-10 17:23:01,94,6768,45,49,4506.02,8742.00,0.00
2024-12-10 17:23:01,95,6768,46,49,4458.59,8742.01,0.00
2024-12-10 17:23:01,94,6768,46,48,4413.15,8742.50,0.00
2024-12-10 17:23:01,94,6769,46,48,4461.84,8743.00,0.00
2024-12-10 17:23:01,95,6769,47,48,4414.88,8743.01,0.00
2024-12-10 17:23:01,94,6769,46,48,4459.06,8743.03,0.00
2024-12-10 17:23:01,94,6770,46,48,4465.96,8744.00,0.00
2024-12-10 17:23:01,95,6770,46,49,4418.95,8744.01,0.00
2024-12-10 17:23:01,95,6771,46,49,4420.33,8745.00,0.00
2024-12-10 17:23:01,96,6771,47,49,4374.29,8745.01,0.00
2024-12-10 17:23:01,95,6771,46,49,4417.58,8745.03,0.00
2024-12-10 17:23:01,95,6772,46,49,4419.62,8746.00,0.00
2024-12-10 17:23:01,96,6772,47,49,4373.58,8746.01,0.00
2024-12-10 17:23:01,95,6772,47,48,4416.87,8746.03,0.00
2024-12-10 17:23:01,94,6772,47,47,4462.91,8746.03,0.00
2024-12-10 17:23:01,93,6772,47,46,4470.71,8746.43,0.00
2024-12-10 17:23:01,93,6773,47,46,4513.56,8747.00,0.00
2024-12-10 17:23:01,94,6773,47,47,4465.54,8747.01,0.00
2024-12-10 17:23:01,94,6774,47,47,4466.48,8748.00,0.00
2024-12-10 17:23:01,95,6774,48,47,4419.47,8748.01,0.00
2024-12-10 17:23:01,94,6774,48,46,4465.55,8748.01,0.00
2024-12-10 17:23:01,93,6774,48,45,4511.70,8748.02,0.00
2024-12-10 17:23:01,92,6774,48,44,4546.24,8748.17,0.00
2024-12-10 17:23:01,92,6775,48,44,4567.17,8749.00,0.00
2024-12-10 17:23:01,93,6775,49,44,4518.06,8749.01,0.00
2024-12-10 17:23:01,93,6776,49,44,4523.73,8750.00,0.00
2024-12-10 17:23:01,94,6776,50,44,4475.61,8750.01,0.00
2024-12-10 17:23:01,93,6776,50,43,4521.86,8750.02,0.00
2024-12-10 17:23:01,93,6777,50,43,4528.15,8751.00,0.00
2024-12-10 17:23:01,94,6777,51,43,4479.98,8751.01,0.00
2024-12-10 17:23:01,93,6777,50,43,4526.27,8751.02,0.00
2024-12-10 17:23:01,93,6778,50,43,4533.12,8752.00,0.00
2024-12-10 17:23:01,94,6778,51,43,4484.89,8752.01,0.00
2024-12-10 17:23:01,93,6778,50,43,4531.24,8752.02,0.00
2024-12-10 17:23:01,93,6779,50,43,4538.37,8753.00,0.00
2024-12-10 17:23:01,94,6779,50,44,4490.09,8753.01,0.00
2024-12-10 17:23:01,93,6779,49,44,4536.50,8753.02,0.00
2024-12-10 17:23:01,93,6780,49,44,4543.91,8754.00,0.00
2024-12-10 17:23:01,94,6780,50,44,4495.57,8754.01,0.00
2024-12-10 17:23:01,93,6780,49,44,4542.04,8754.02,0.00
2024-12-10 17:23:01,93,6781,49,44,4549.98,8755.00,0.00
2024-12-10 17:23:01,94,6781,49,45,4501.58,8755.01,0.00
2024-12-10 17:23:01,94,6782,49,45,4508.12,8756.00,0.00
2024-12-10 17:23:01,95,6782,49,46,4460.67,8756.01,0.00
2024-12-10 17:23:01,94,6782,49,45,4506.26,8756.02,0.00
2024-12-10 17:23:01,94,6783,49,45,4514.23,8757.00,0.00
2024-12-10 17:23:01,95,6783,49,46,4466.71,8757.01,0.00
2024-12-10 17:23:02,95,6784,49,46,4472.75,8758.00,0.00
2024-12-10 17:23:02,96,6784,49,47,4426.16,8758.01,0.00
2024-12-10 17:23:02,95,6784,48,47,4470.91,8758.02,0.00
2024-12-10 17:23:02,95,6785,48,47,4477.87,8759.00,0.00
2024-12-10 17:23:02,96,6785,49,47,4431.23,8759.01,0.00
2024-12-10 17:23:02,95,6785,48,47,4476.03,8759.02,0.00
2024-12-10 17:23:02,95,6786,48,47,4482.99,8760.00,0.00
2024-12-10 17:23:02,96,6786,48,48,4436.29,8760.01,0.00
2024-12-10 17:23:02,95,6786,48,47,4481.15,8760.02,0.00
2024-12-10 17:23:02,96,6785,49,47,4418.07,8760.23,0.00
2024-12-10 17:23:02,96,6786,49,47,4512.55,8761.00,0.00
2024-12-10 17:23:02,97,6786,49,48,4466.02,8761.01,0.00
2024-12-10 17:23:02,96,6786,48,48,4510.73,8761.02,0.00
2024-12-10 17:23:02,97,6785,48,49,4446.19,8761.25,0.00
2024-12-10 17:23:02,97,6786,48,49,4629.13,8762.00,0.00
2024-12-10 17:23:02,98,6786,48,50,4581.89,8762.01,0.00
2024-12-10 17:23:02,97,6786,48,49,4627.33,8762.02,0.00
2024-12-10 17:23:02,97,6787,48,49,4722.71,8763.00,0.00
2024-12-10 17:23:02,98,6787,48,50,4674.52,8763.01,0.00
2024-12-10 17:23:02,97,6787,48,49,4720.91,8763.02,0.00
2024-12-10 17:23:02,97,6788,48,49,4725.96,8764.00,0.00
2024-12-10 17:23:02,98,6788,48,50,4677.73,8764.01,0.00
2024-12-10 17:23:02,97,6788,47,50,4724.16,8764.02,0.00
2024-12-10 17:23:02,97,6789,47,50,4729.21,8765.00,0.00
2024-12-10 17:23:02,98,6789,48,50,4680.95,8765.01,0.00
2024-12-10 17:23:02,97,6789,47,50,4727.41,8765.02,0.00
2024-12-10 17:23:02,97,6790,47,50,4732.46,8766.00,0.00
2024-12-10 17:23:02,98,6790,48,50,4684.17,8766.01,0.00
2024-12-10 17:23:02,98,6791,48,50,4687.39,8767.00,0.00
2024-12-10 17:23:02,99,6791,48,51,4640.04,8767.01,0.00
2024-12-10 17:23:02,98,6791,48,50,4685.60,8767.02,0.00
2024-12-10 17:23:02,98,6792,48,50,4689.34,8768.00,0.00
2024-12-10 17:23:02,99,6792,49,50,4641.97,8768.01,0.00
2024-12-10 17:23:02,98,6792,48,50,4687.55,8768.02,0.00
2024-12-10 17:23:02,98,6793,48,50,4690.24,8769.00,0.00
2024-12-10 17:23:02,99,6793,49,50,4642.86,8769.01,0.00
2024-12-10 17:23:02,98,6793,49,49,4688.45,8769.02,0.00
2024-12-10 17:23:02,98,6794,49,49,4690.93,8770.00,0.00
2024-12-10 17:23:02,99,6794,49,50,4643.54,8770.01,0.00
2024-12-10 17:23:02,98,6794,48,50,4689.14,8770.02,0.00
2024-12-10 17:23:02,98,6795,48,50,4691.02,8771.00,0.00
2024-12-10 17:23:02,99,6795,48,51,4643.63,8771.01,0.00
2024-12-10 17:23:02,98,6795,48,50,4689.23,8771.02,0.00
2024-12-10 17:23:02,98,6795,48,50,4690.18,8772.00,0.00
2024-12-10 17:23:02,99,6795,49,50,4642.80,8772.01,0.00
2024-12-10 17:23:02,99,6796,49,50,4640.97,8773.00,0.00
2024-12-10 17:23:02,100,6796,50,50,4594.56,8773.01,0.00
2024-12-10 17:23:02,99,6796,50,49,4639.20,8773.02,0.00
2024-12-10 17:23:02,100,6795,50,50,4542.13,8773.62,0.00
2024-12-10 17:23:02,100,6796,50,50,4624.42,8774.00,0.00
2024-12-10 17:23:02,101,6796,51,50,4578.64,8774.01,0.00
2024-12-10 17:23:02,100,6796,51,49,4622.67,8774.02,0.00
2024-12-10 17:23:02,100,6797,51,49,4708.75,8775.00,0.00
2024-12-10 17:23:02,101,6797,52,49,4662.13,8775.01,0.00
2024-12-10 17:23:02,102,6796,53,49,4616.42,8775.03,0.00
2024-12-10 17:23:02,101,6796,53,48,4713.40,8775.03,0.00
2024-12-10 17:23:02,101,6797,53,48,4710.33,8776.00,0.00
2024-12-10 17:23:02,102,6797,54,48,4664.15,8776.01,0.00
2024-12-10 17:23:02,102,6798,54,48,4742.65,8777.00,0.00
2024-12-10 17:23:02,103,6798,54,49,4696.60,8777.01,0.00
2024-12-10 17:23:02,102,6798,53,49,4740.94,8777.02,0.00
2024-12-10 17:23:02,102,6799,53,49,4732.12,8778.00,0.00
2024-12-10 17:23:02,103,6799,53,50,4686.18,8778.01,0.00
2024-12-10 17:23:02,102,6799,53,49,4730.41,8778.02,0.00
2024-12-10 17:23:02,102,6800,53,49,4719.12,8779.00,0.00
2024-12-10 17:23:02,103,6800,54,49,4673.30,8779.01,0.00
2024-12-10 17:23:02,102,6800,54,48,4717.41,8779.02,0.00
2024-12-10 17:23:02,102,6801,54,48,4703.85,8780.00,0.00
2024-12-10 17:23:02,103,6801,54,49,4658.18,8780.01,0.00
2024-12-10 17:23:02,102,6801,53,49,4702.14,8780.02,0.00
2024-12-10 17:23:02,102,6802,53,49,4687.19,8781.00,0.00
2024-12-10 17:23:02,103,6802,53,50,4641.69,8781.01,0.00
2024-12-10 17:23:02,102,6802,53,49,4685.48,8781.02,0.00
2024-12-10 17:23:02,102,6803,53,49,4669.57,8782.00,0.00
2024-12-10 17:23:02,103,6803,53,50,4624.23,8782.01,0.00
2024-12-10 17:23:02,103,6804,53,50,4606.41,8783.00,0.00
2024-12-10 17:23:02,104,6804,53,51,4562.12,8783.01,0.00
2024-12-10 17:23:02,103,6804,53,50,4603.87,8783.03,0.00
2024-12-10 17:23:02,103,6805,53,50,4582.11,8784.00,0.00
2024-12-10 17:23:02,104,6805,53,51,4538.05,8784.01,0.00
2024-12-10 17:23:02,103,6805,52,51,4579.57,8784.03,0.00
2024-12-10 17:23:02,103,6806,52,51,4552.31,8785.00,0.00
2024-12-10 17:23:02,104,6806,53,51,4508.54,8785.01,0.00
2024-12-10 17:23:02,104,6807,53,51,4473.08,8786.00,0.00
2024-12-10 17:23:02,105,6807,54,51,4430.48,8786.01,0.00
2024-12-10 17:23:02,104,6807,53,51,4469.73,8786.04,0.00
2024-12-10 17:23:02,103,6807,53,50,4451.28,8786.68,0.00
2024-12-10 17:23:02,103,6808,53,50,4482.19,8787.00,0.00
2024-12-10 17:23:02,104,6808,54,50,4439.09,8787.01,0.00
2024-12-10 17:23:03,103,6808,53,50,4478.80,8787.04,0.00
2024-12-10 17:23:03,102,6808,52,50,4432.07,8787.85,0.00
2024-12-10 17:23:03,102,6809,52,50,4505.43,8788.00,0.00
2024-12-10 17:23:03,103,6809,53,50,4461.69,8788.01,0.00
2024-12-10 17:23:03,102,6809,52,50,4502.01,8788.04,0.00
2024-12-10 17:23:03,101,6809,52,49,4526.87,8788.26,0.00
2024-12-10 17:23:03,101,6810,52,49,4541.33,8789.00,0.00
2024-12-10 17:23:03,102,6810,53,49,4496.81,8789.01,0.00
2024-12-10 17:23:03,101,6810,52,49,4537.88,8789.04,0.00
2024-12-10 17:23:03,101,6811,52,49,4532.35,8790.00,0.00
2024-12-10 17:23:03,102,6811,53,49,4487.92,8790.01,0.00
2024-12-10 17:23:03,102,6812,53,49,4480.51,8791.00,0.00
2024-12-10 17:23:03,103,6812,53,50,4437.01,8791.01,0.00
2024-12-10 17:23:03,102,6812,52,50,4477.09,8791.04,0.00
2024-12-10 17:23:03,102,6813,52,50,4472.00,8792.00,0.00
2024-12-10 17:23:03,103,6813,53,50,4428.58,8792.01,0.00
2024-12-10 17:23:03,103,6814,53,50,4418.08,8793.00,0.00
2024-12-10 17:23:03,104,6814,54,50,4375.60,8793.01,0.00
2024-12-10 17:23:03,103,6814,53,50,4413.84,8793.04,0.00
2024-12-10 17:23:03,103,6815,53,50,4402.79,8794.00,0.00
2024-12-10 17:23:03,104,6815,53,51,4360.45,8794.01,0.00
2024-12-10 17:23:03,104,6816,53,51,4340.50,8795.00,0.00
2024-12-10 17:23:03,105,6816,53,52,4299.16,8795.01,0.00
2024-12-10 17:23:03,104,6816,53,51,4282.23,8795.61,0.00
2024-12-10 17:23:03,104,6817,53,51,4319.21,8796.00,0.00
2024-12-10 17:23:03,105,6817,54,51,4278.07,8796.01,0.00
2024-12-10 17:23:03,104,6817,54,50,4315.64,8796.04,0.00
2024-12-10 17:23:03,104,6818,54,50,4302.06,8797.00,0.00
2024-12-10 17:23:03,105,6818,55,50,4261.08,8797.01,0.00
2024-12-10 17:23:03,104,6818,55,49,4298.69,8797.04,0.00
2024-12-10 17:23:03,104,6819,55,49,4284.92,8798.00,0.00
2024-12-10 17:23:03,105,6819,56,49,4244.11,8798.01,0.00
2024-12-10 17:23:03,104,6819,55,49,4281.56,8798.04,0.00
2024-12-10 17:23:03,103,6819,54,49,4277.62,8798.55,0.00
2024-12-10 17:23:03,103,6820,54,49,4309.28,8799.00,0.00
2024-12-10 17:23:03,104,6820,54,50,4267.85,8799.01,0.00
2024-12-10 17:23:03,103,6820,54,49,4305.88,8799.04,0.00
2024-12-10 17:23:03,102,6820,53,49,4311.65,8799.45,0.00
2024-12-10 17:23:03,101,6820,53,48,4323.76,8799.68,0.00
2024-12-10 17:23:03,101,6821,53,48,4380.81,8800.00,0.00
2024-12-10 17:23:03,102,6821,53,49,4337.86,8800.01,0.00
2024-12-10 17:23:03,101,6821,52,49,4377.34,8800.04,0.00
2024-12-10 17:23:03,101,6822,52,49,4378.53,8801.00,0.00
2024-12-10 17:23:03,102,6822,53,49,4335.60,8801.01,0.00
2024-12-10 17:23:03,101,6822,52,49,4375.06,8801.04,0.00
2024-12-10 17:23:03,101,6823,52,49,4376.58,8802.00,0.00
2024-12-10 17:23:03,102,6823,52,50,4333.67,8802.01,0.00
2024-12-10 17:23:03,101,6823,51,50,4373.11,8802.04,0.00
2024-12-10 17:23:03,102,6822,51,51,4273.51,8802.71,0.00
2024-12-10 17:23:03,102,6823,51,51,4357.72,8803.00,0.00
2024-12-10 17:23:03,103,6823,51,52,4315.41,8803.01,0.00
2024-12-10 17:23:03,104,6822,52,52,4272.24,8803.05,0.00
2024-12-10 17:23:03,103,6822,51,52,4347.91,8803.05,0.00
2024-12-10 17:23:03,103,6823,51,52,4432.98,8804.00,0.00
2024-12-10 17:23:03,104,6823,51,53,4390.36,8804.01,0.00
2024-12-10 17:23:03,103,6823,50,53,4429.59,8804.04,0.00
2024-12-10 17:23:03,103,6824,50,53,4511.95,8805.00,0.00
2024-12-10 17:23:03,104,6824,50,54,4468.56,8805.01,0.00
2024-12-10 17:23:03,103,6824,49,54,4508.55,8805.04,0.00
2024-12-10 17:23:03,104,6823,49,55,4461.81,8805.10,0.00
2024-12-10 17:23:03,104,6824,49,55,4540.05,8806.00,0.00
2024-12-10 17:23:03,105,6824,49,56,4496.81,8806.01,0.00
2024-12-10 17:23:03,104,6824,49,55,4536.68,8806.04,0.00
2024-12-10 17:23:03,104,6825,49,55,4612.79,8807.00,0.00
2024-12-10 17:23:03,105,6825,50,55,4568.86,8807.01,0.00
2024-12-10 17:23:03,104,6825,49,55,4609.42,8807.04,0.00
2024-12-10 17:23:03,104,6826,49,55,4597.51,8808.00,0.00
2024-12-10 17:23:03,105,6826,50,55,4553.72,8808.01,0.00
2024-12-10 17:23:03,104,6826,50,54,4594.14,8808.04,0.00
2024-12-10 17:23:03,104,6827,50,54,4577.62,8809.00,0.00
2024-12-10 17:23:03,105,6827,50,55,4534.02,8809.01,0.00
2024-12-10 17:23:03,104,6827,49,55,4574.25,8809.04,0.00
2024-12-10 17:23:03,104,6828,49,55,4553.10,8810.00,0.00
2024-12-10 17:23:03,105,6828,49,56,4509.74,8810.01,0.00
2024-12-10 17:23:03,105,6829,49,56,4478.21,8811.00,0.00
2024-12-10 17:23:03,106,6829,49,57,4435.97,8811.01,0.00
2024-12-10 17:23:03,105,6829,49,56,4473.33,8811.05,0.00
2024-12-10 17:23:03,105,6830,49,56,4437.23,8812.00,0.00
2024-12-10 17:23:03,106,6830,49,57,4395.37,8812.01,0.00
2024-12-10 17:23:03,105,6830,48,57,4432.74,8812.05,0.00
2024-12-10 17:23:03,104,6830,47,57,4423.31,8812.59,0.00
2024-12-10 17:23:03,104,6831,47,57,4450.19,8813.00,0.00
2024-12-10 17:23:03,105,6831,48,57,4407.81,8813.01,0.00
2024-12-10 17:23:03,104,6831,48,56,4445.98,8813.05,0.00
2024-12-10 17:23:03,104,6832,48,56,4413.13,8814.00,0.00
2024-12-10 17:23:03,105,6832,48,57,4371.10,8814.01,0.00
2024-12-10 17:23:03,104,6832,48,56,4408.92,8814.05,0.00
2024-12-10 17:23:03,105,6831,48,57,4250.61,8814.94,0.00
2024-12-10 17:23:04,105,6832,48,57,4333.42,8815.00,0.00
2024-12-10 17:23:04,106,6832,48,58,4292.54,8815.01,0.00
2024-12-10 17:23:04,107,6831,48,59,4250.24,8815.05,0.00
2024-12-10 17:23:04,106,6831,47,59,4297.84,8815.06,0.00
2024-12-10 17:23:04,105,6831,46,59,4332.55,8815.11,0.00
2024-12-10 17:23:04,106,6830,46,60,4230.54,8815.72,0.00
2024-12-10 17:23:04,105,6830,46,59,4262.91,8815.86,0.00
2024-12-10 17:23:04,105,6831,46,59,4412.25,8816.00,0.00
2024-12-10 17:23:04,106,6831,46,60,4370.62,8816.01,0.00
2024-12-10 17:23:04,105,6831,46,59,4405.69,8816.05,0.00
2024-12-10 17:23:04,106,6830,46,60,4294.16,8816.72,0.00
2024-12-10 17:23:04,106,6831,46,60,4524.01,8817.00,0.00
2024-12-10 17:23:04,107,6831,47,60,4481.73,8817.01,0.00
2024-12-10 17:23:04,106,6831,47,59,4514.60,8817.05,0.00
2024-12-10 17:23:04,107,6830,48,59,4437.08,8817.47,0.00
2024-12-10 17:23:04,107,6831,48,59,4577.48,8818.00,0.00
2024-12-10 17:23:04,108,6831,49,59,4535.09,8818.01,0.00
2024-12-10 17:23:04,107,6831,49,58,4564.99,8818.05,0.00
2024-12-10 17:23:04,108,6830,49,59,4477.04,8818.55,0.00
2024-12-10 17:23:04,109,6829,50,59,4450.66,8818.67,0.00
2024-12-10 17:23:04,109,6830,50,59,4538.49,8819.00,0.00
2024-12-10 17:23:04,110,6830,51,59,4497.23,8819.01,0.00
2024-12-10 17:23:04,109,6830,50,59,4522.54,8819.05,0.00
2024-12-10 17:23:04,109,6831,50,59,4575.53,8820.00,0.00
2024-12-10 17:23:04,110,6831,51,59,4533.94,8820.01,0.00
2024-12-10 17:23:04,109,6831,51,58,4574.63,8820.02,0.00
2024-12-10 17:23:04,108,6831,51,57,4614.55,8820.04,0.00
2024-12-10 17:23:04,108,6832,51,57,4449.60,8821.00,0.00
2024-12-10 17:23:04,109,6832,51,58,4408.78,8821.01,0.00
2024-12-10 17:23:04,108,6832,50,58,4446.35,8821.04,0.00
2024-12-10 17:23:04,109,6831,51,58,4178.57,8821.93,0.00
2024-12-10 17:23:04,109,6832,51,58,4219.79,8822.00,0.00
2024-12-10 17:23:04,110,6832,51,59,4181.43,8822.01,0.00
2024-12-10 17:23:04,109,6832,50,59,4151.38,8822.58,0.00
2024-12-10 17:23:04,108,6832,50,58,4128.46,8822.63,0.00
2024-12-10 17:23:04,108,6833,50,58,4080.10,8823.00,0.00
2024-12-10 17:23:04,109,6833,50,59,4042.67,8823.01,0.00
2024-12-10 17:23:04,108,6833,49,59,4076.85,8823.04,0.00
2024-12-10 17:23:04,107,6833,48,59,4040.54,8823.59,0.00
2024-12-10 17:23:04,106,6833,47,59,4044.82,8823.61,0.00
2024-12-10 17:23:04,105,6833,46,59,4052.17,8823.66,0.00
2024-12-10 17:23:04,106,6832,47,59,3886.33,8823.93,0.00
2024-12-10 17:23:04,106,6833,47,59,3915.02,8824.00,0.00
2024-12-10 17:23:04,107,6833,48,59,3878.43,8824.01,0.00
2024-12-10 17:23:04,106,6833,47,59,3911.71,8824.04,0.00
2024-12-10 17:23:04,105,6833,47,58,3938.22,8824.12,0.00
2024-12-10 17:23:04,104,6833,47,57,3920.75,8824.57,0.00
2024-12-10 17:23:04,103,6833,46,57,3952.89,8824.58,0.00
2024-12-10 17:23:04,102,6833,45,57,3986.86,8824.60,0.00
2024-12-10 17:23:04,101,6833,44,57,4010.16,8824.64,0.00
2024-12-10 17:23:04,100,6833,44,56,4039.42,8824.69,0.00
2024-12-10 17:23:04,99,6833,43,56,4065.63,8824.76,0.00
2024-12-10 17:23:04,98,6833,42,56,4098.75,8824.81,0.00
2024-12-10 17:23:04,97,6833,42,55,4126.21,8824.84,0.00
2024-12-10 17:23:04,97,6834,42,55,4173.36,8825.00,0.00
2024-12-10 17:23:04,98,6834,42,56,4130.78,8825.01,0.00
2024-12-10 17:23:04,97,6834,42,55,4169.75,8825.04,0.00
2024-12-10 17:23:04,96,6834,42,54,4106.23,8825.85,0.00
2024-12-10 17:23:04,95,6834,41,54,4123.20,8825.90,0.00
2024-12-10 17:23:04,94,6834,40,54,4149.20,8825.92,0.00
2024-12-10 17:23:04,94,6835,40,54,4193.95,8826.00,0.00
2024-12-10 17:23:04,95,6835,40,55,4149.80,8826.01,0.00
2024-12-10 17:23:04,94,6835,40,54,4190.21,8826.04,0.00
2024-12-10 17:23:04,93,6835,39,54,4094.59,8826.93,0.00
2024-12-10 17:23:04,93,6836,39,54,4162.59,8827.00,0.00
2024-12-10 17:23:04,94,6836,40,54,4118.31,8827.01,0.00
2024-12-10 17:23:04,93,6836,39,54,4158.82,8827.04,0.00
2024-12-10 17:23:04,92,6836,39,53,4164.92,8827.40,0.00
2024-12-10 17:23:04,91,6836,38,53,4189.32,8827.63,0.00
2024-12-10 17:23:04,90,6836,37,53,4178.68,8827.88,0.00
2024-12-10 17:23:04,89,6836,36,53,4210.50,8827.93,0.00
2024-12-10 17:23:04,89,6837,36,53,4300.05,8828.00,0.00
2024-12-10 17:23:04,90,6837,36,54,4252.27,8828.01,0.00
2024-12-10 17:23:04,89,6837,36,53,4296.10,8828.05,0.00
2024-12-10 17:23:04,89,6838,36,53,4265.23,8829.00,0.00
2024-12-10 17:23:04,90,6838,37,53,4217.84,8829.01,0.00
2024-12-10 17:23:04,89,6838,37,52,4261.28,8829.05,0.00
2024-12-10 17:23:04,89,6839,37,52,4223.81,8830.00,0.00
2024-12-10 17:23:04,90,6839,38,52,4176.88,8830.01,0.00
2024-12-10 17:23:04,89,6839,38,51,4219.12,8830.05,0.00
2024-12-10 17:23:04,89,6840,38,51,4181.03,8831.00,0.00
2024-12-10 17:23:04,90,6840,38,52,4134.58,8831.01,0.00
2024-12-10 17:23:04,89,6840,38,51,4174.79,8831.05,0.00
2024-12-10 17:23:04,90,6839,38,52,4098.48,8831.39,0.00
2024-12-10 17:23:04,90,6840,38,52,4156.53,8832.00,0.00
2024-12-10 17:23:04,91,6840,39,52,4110.85,8832.01,0.00
2024-12-10 17:23:04,90,6840,39,51,4149.05,8832.05,0.00
2024-12-10 17:23:04,90,6841,39,51,4209.92,8833.00,0.00
2024-12-10 17:23:04,91,6841,39,52,4163.66,8833.01,0.00
2024-12-10 17:23:04,90,6841,38,52,4201.08,8833.05,0.00
2024-12-10 17:23:04,90,6842,38,52,4167.24,8834.00,0.00
2024-12-10 17:23:04,91,6842,39,52,4121.44,8834.01,0.00
2024-12-10 17:23:04,90,6842,38,52,4083.09,8834.70,0.00
2024-12-10 17:23:04,89,6842,38,51,4124.36,8834.75,0.00
2024-12-10 17:23:04,89,6843,38,51,4182.69,8835.00,0.00
2024-12-10 17:23:04,90,6843,38,52,4136.21,8835.01,0.00
2024-12-10 17:23:04,89,6843,38,51,4171.35,8835.05,0.00
2024-12-10 17:23:04,88,6843,38,50,4151.24,8835.66,0.00
2024-12-10 17:23:04,88,6844,38,50,4201.56,8836.00,0.00
2024-12-10 17:23:04,89,6844,39,50,4154.36,8836.01,0.00
2024-12-10 17:23:04,88,6844,38,50,4174.90,8836.20,0.00
2024-12-10 17:23:04,88,6845,38,50,4177.70,8837.00,0.00
2024-12-10 17:23:04,89,6845,38,51,4130.76,8837.01,0.00
2024-12-10 17:23:04,88,6845,38,50,4164.54,8837.06,0.00
2024-12-10 17:23:04,87,6845,37,50,4158.46,8837.61,0.00
2024-12-10 17:23:04,87,6846,37,50,4202.50,8838.00,0.00
2024-12-10 17:23:04,88,6846,37,51,4154.74,8838.01,0.00
2024-12-10 17:23:04,87,6846,37,50,4189.34,8838.06,0.00
2024-12-10 17:23:04,87,6847,37,50,4179.60,8839.00,0.00
2024-12-10 17:23:04,88,6847,38,50,4132.11,8839.01,0.00
2024-12-10 17:23:04,87,6847,38,49,4166.71,8839.06,0.00
2024-12-10 17:23:04,86,6847,38,48,4137.32,8839.72,0.00
2024-12-10 17:23:04,86,6848,38,48,4206.36,8840.00,0.00
2024-12-10 17:23:04,87,6848,39,48,4158.01,8840.01,0.00
2024-12-10 17:23:04,86,6848,38,48,4195.73,8840.04,0.00
2024-12-10 17:23:04,85,6848,37,48,4243.01,8840.05,0.00
2024-12-10 17:23:04,84,6848,37,47,4270.17,8840.27,0.00
2024-12-10 17:23:04,83,6848,37,46,4279.83,8840.69,0.00
2024-12-10 17:23:05,83,6849,37,46,4348.82,8841.00,0.00
2024-12-10 17:23:05,84,6849,37,47,4297.05,8841.01,0.00
2024-12-10 17:23:05,83,6849,37,46,4344.48,8841.05,0.00
2024-12-10 17:23:05,83,6850,37,46,4349.05,8842.00,0.00
2024-12-10 17:23:05,84,6850,37,47,4297.28,8842.01,0.00
2024-12-10 17:23:05,84,6851,37,47,4292.12,8843.00,0.00
2024-12-10 17:23:05,85,6851,37,48,4241.62,8843.01,0.00
2024-12-10 17:23:05,84,6851,36,48,4287.49,8843.05,0.00
2024-12-10 17:23:05,84,6852,36,48,4282.08,8844.00,0.00
2024-12-10 17:23:05,85,6852,37,48,4231.70,8844.01,0.00
2024-12-10 17:23:05,84,6852,37,47,4277.89,8844.05,0.00
2024-12-10 17:23:05,83,6852,36,47,4252.77,8844.70,0.00
2024-12-10 17:23:05,83,6853,36,47,4326.07,8845.00,0.00
2024-12-10 17:23:05,84,6853,36,48,4274.57,8845.01,0.00
2024-12-10 17:23:05,83,6853,35,48,4321.83,8845.05,0.00
2024-12-10 17:23:05,83,6854,35,48,4317.15,8846.00,0.00
2024-12-10 17:23:05,84,6854,35,49,4265.76,8846.01,0.00
2024-12-10 17:23:05,83,6854,34,49,4312.90,8846.05,0.00
2024-12-10 17:23:05,83,6855,34,49,4307.72,8847.00,0.00
2024-12-10 17:23:05,84,6855,35,49,4256.44,8847.01,0.00
2024-12-10 17:23:05,83,6855,35,48,4303.47,8847.05,0.00
2024-12-10 17:23:05,83,6856,35,48,4297.17,8848.00,0.00
2024-12-10 17:23:05,84,6856,36,48,4246.01,8848.01,0.00
2024-12-10 17:23:05,83,6856,35,48,4292.92,8848.05,0.00
2024-12-10 17:23:05,83,6857,35,48,4283.85,8849.00,0.00
2024-12-10 17:23:05,84,6857,36,48,4232.85,8849.01,0.00
2024-12-10 17:23:05,83,6857,35,48,4279.60,8849.05,0.00
2024-12-10 17:23:05,83,6858,35,48,4267.54,8850.00,0.00
2024-12-10 17:23:05,84,6858,36,48,4216.74,8850.01,0.00
2024-12-10 17:23:05,83,6858,35,48,4263.29,8850.05,0.00
2024-12-10 17:23:05,82,6858,35,47,4243.51,8850.59,0.00
2024-12-10 17:23:05,82,6859,35,47,4301.87,8851.00,0.00
2024-12-10 17:23:05,83,6859,35,48,4250.04,8851.01,0.00
2024-12-10 17:23:05,83,6860,35,48,4245.26,8852.00,0.00
2024-12-10 17:23:05,84,6860,35,49,4194.72,8852.01,0.00
2024-12-10 17:23:05,84,6861,35,49,4189.56,8853.00,0.00
2024-12-10 17:23:05,85,6861,36,49,4140.27,8853.01,0.00
2024-12-10 17:23:05,84,6861,36,48,4185.36,8853.05,0.00
2024-12-10 17:23:05,84,6862,36,48,4180.31,8854.00,0.00
2024-12-10 17:23:05,85,6862,37,48,4131.13,8854.01,0.00
2024-12-10 17:23:05,84,6862,36,48,4176.10,8854.05,0.00
2024-12-10 17:23:05,85,6861,37,48,4094.04,8854.44,0.00
2024-12-10 17:23:05,85,6862,37,48,4218.91,8855.00,0.00
2024-12-10 17:23:05,86,6862,38,48,4169.85,8855.01,0.00
2024-12-10 17:23:05,87,6861,39,48,4095.52,8855.33,0.00
2024-12-10 17:23:05,87,6862,39,48,4281.38,8856.00,0.00
2024-12-10 17:23:05,88,6862,39,49,4232.73,8856.01,0.00
2024-12-10 17:23:05,88,6863,39,49,4316.55,8857.00,0.00
2024-12-10 17:23:05,89,6863,39,50,4268.05,8857.01,0.00
2024-12-10 17:23:05,88,6863,39,49,4312.54,8857.05,0.00
2024-12-10 17:23:05,88,6864,39,49,4298.72,8858.00,0.00
2024-12-10 17:23:05,89,6864,40,49,4250.42,8858.01,0.00
2024-12-10 17:23:05,88,6864,40,48,4294.71,8858.05,0.00
2024-12-10 17:23:05,87,6864,40,47,4261.76,8858.76,0.00
2024-12-10 17:23:05,87,6865,40,47,4338.30,8859.00,0.00
2024-12-10 17:23:05,88,6865,41,47,4289.00,8859.01,0.00
2024-12-10 17:23:05,87,6865,40,47,4334.24,8859.05,0.00
2024-12-10 17:23:05,87,6866,40,47,4333.45,8860.00,0.00
2024-12-10 17:23:05,88,6866,41,47,4284.21,8860.01,0.00
2024-12-10 17:23:05,87,6866,41,46,4329.39,8860.05,0.00
2024-12-10 17:23:05,86,6866,40,46,4378.70,8860.05,0.00
2024-12-10 17:23:05,86,6867,40,46,4374.69,8861.00,0.00
2024-12-10 17:23:05,87,6867,41,46,4324.41,8861.01,0.00
2024-12-10 17:23:05,86,6867,41,45,4370.58,8861.05,0.00
2024-12-10 17:23:05,85,6867,41,44,4420.95,8861.05,0.00
2024-12-10 17:23:05,84,6867,41,43,4430.20,8861.42,0.00
2024-12-10 17:23:05,83,6867,40,43,4479.03,8861.47,0.00
2024-12-10 17:23:05,83,6868,40,43,4522.04,8862.00,0.00
2024-12-10 17:23:05,84,6868,41,43,4468.20,8862.01,0.00
2024-12-10 17:23:05,83,6868,41,42,4517.78,8862.05,0.00
2024-12-10 17:23:05,82,6868,41,41,4511.63,8862.67,0.00
2024-12-10 17:23:05,82,6869,41,41,4580.39,8863.00,0.00
2024-12-10 17:23:05,83,6869,41,42,4525.20,8863.01,0.00
2024-12-10 17:23:05,82,6869,41,41,4563.59,8863.20,0.00
2024-12-10 17:23:05,81,6869,41,40,4614.65,8863.25,0.00
2024-12-10 17:23:05,82,6868,42,40,4490.67,8863.83,0.00
2024-12-10 17:23:05,82,6869,42,40,4596.28,8864.00,0.00
2024-12-10 17:23:05,83,6869,43,40,4540.90,8864.01,0.00
2024-12-10 17:23:05,83,6870,43,40,4643.91,8865.00,0.00
2024-12-10 17:23:05,84,6870,44,40,4588.63,8865.01,0.00
2024-12-10 17:23:05,83,6870,43,40,4623.16,8865.24,0.00
2024-12-10 17:23:05,82,6870,43,39,4665.64,8865.39,0.00
2024-12-10 17:23:05,82,6871,43,39,4701.40,8866.00,0.00
2024-12-10 17:23:05,83,6871,44,39,4644.76,8866.01,0.00
2024-12-10 17:23:05,82,6871,43,39,4696.01,8866.06,0.00
2024-12-10 17:23:05,82,6872,43,39,4699.11,8867.00,0.00
2024-12-10 17:23:05,83,6872,44,39,4642.50,8867.01,0.00
2024-12-10 17:23:06,83,6873,44,39,4637.33,8868.00,0.00
2024-12-10 17:23:06,84,6873,44,40,4582.13,8868.01,0.00
2024-12-10 17:23:06,83,6873,43,40,4632.00,8868.06,0.00
2024-12-10 17:23:06,82,6873,43,39,4656.70,8868.37,0.00
2024-12-10 17:23:06,81,6873,43,38,4694.80,8868.57,0.00
2024-12-10 17:23:06,80,6873,42,38,4748.93,8868.61,0.00
2024-12-10 17:23:06,80,6874,42,38,4823.04,8869.00,0.00
2024-12-10 17:23:06,81,6874,42,39,4763.49,8869.01,0.00
2024-12-10 17:23:06,80,6874,41,39,4817.51,8869.06,0.00
2024-12-10 17:23:06,80,6875,41,39,4841.37,8870.00,0.00
2024-12-10 17:23:06,81,6875,42,39,4781.60,8870.01,0.00
2024-12-10 17:23:06,80,6875,42,38,4835.84,8870.06,0.00
2024-12-10 17:23:06,80,6876,42,38,4855.06,8871.00,0.00
2024-12-10 17:23:06,81,6876,42,39,4795.12,8871.01,0.00
2024-12-10 17:23:06,80,6876,42,38,4849.53,8871.06,0.00
2024-12-10 17:23:06,80,6877,42,38,4863.55,8872.00,0.00
2024-12-10 17:23:06,81,6877,43,38,4803.51,8872.01,0.00
2024-12-10 17:23:06,81,6878,43,38,4807.25,8873.00,0.00
2024-12-10 17:23:06,82,6878,43,39,4748.63,8873.01,0.00
2024-12-10 17:23:06,81,6878,42,39,4803.97,8873.04,0.00
2024-12-10 17:23:06,80,6878,42,38,4861.81,8873.05,0.00
2024-12-10 17:23:06,80,6879,42,38,4864.51,8874.00,0.00
2024-12-10 17:23:06,81,6879,43,38,4804.46,8874.01,0.00
2024-12-10 17:23:06,80,6879,42,38,4860.09,8874.05,0.00
2024-12-10 17:23:06,79,6879,42,37,4862.85,8874.57,0.00
2024-12-10 17:23:06,79,6880,42,37,4926.49,8875.00,0.00
2024-12-10 17:23:06,80,6880,43,37,4864.91,8875.01,0.00
2024-12-10 17:23:06,79,6880,42,37,4925.37,8875.01,0.00
2024-12-10 17:23:06,78,6880,41,37,4985.11,8875.04,0.00
2024-12-10 17:23:06,78,6881,41,37,4993.67,8876.00,0.00
2024-12-10 17:23:06,79,6881,42,37,4930.46,8876.01,0.00
2024-12-10 17:23:06,78,6881,41,37,4989.14,8876.05,0.00
2024-12-10 17:23:06,78,6882,41,37,4993.98,8877.00,0.00
2024-12-10 17:23:06,79,6882,42,37,4930.77,8877.01,0.00
2024-12-10 17:23:06,78,6882,42,36,4989.44,8877.05,0.00
2024-12-10 17:23:06,77,6882,42,35,5030.89,8877.26,0.00
2024-12-10 17:23:06,78,6881,43,35,4935.76,8877.63,0.00
2024-12-10 17:23:06,78,6882,43,35,5006.30,8878.00,0.00
2024-12-10 17:23:06,79,6882,43,36,4942.93,8878.01,0.00
2024-12-10 17:23:06,78,6882,43,35,4991.91,8878.17,0.00
2024-12-10 17:23:06,78,6883,43,35,5111.46,8879.00,0.00
2024-12-10 17:23:06,79,6883,44,35,5046.76,8879.01,0.00
2024-12-10 17:23:06,78,6883,43,35,5106.93,8879.05,0.00
2024-12-10 17:23:06,78,6884,43,35,5098.08,8880.00,0.00
2024-12-10 17:23:06,79,6884,44,35,5033.55,8880.01,0.00
2024-12-10 17:23:06,78,6884,44,34,5093.55,8880.05,0.00
2024-12-10 17:23:06,77,6884,44,33,5157.60,8880.06,0.00
2024-12-10 17:23:06,78,6883,45,33,5086.93,8880.14,0.00
2024-12-10 17:23:06,77,6883,44,33,5145.67,8880.65,0.00
2024-12-10 17:23:06,77,6884,44,33,5225.04,8881.00,0.00
2024-12-10 17:23:06,78,6884,44,34,5158.05,8881.01,0.00
2024-12-10 17:23:06,78,6885,44,34,5278.34,8882.00,0.00
2024-12-10 17:23:06,79,6885,44,35,5211.53,8882.01,0.00
2024-12-10 17:23:06,78,6885,44,34,5271.88,8882.08,0.00
2024-12-10 17:23:06,78,6886,44,34,5283.94,8883.00,0.00
2024-12-10 17:23:06,79,6886,45,34,5217.05,8883.01,0.00
2024-12-10 17:23:06,78,6886,45,33,5268.21,8883.18,0.00
2024-12-10 17:23:06,77,6886,44,33,5295.15,8883.57,0.00
2024-12-10 17:23:06,77,6887,44,33,5367.96,8884.00,0.00
2024-12-10 17:23:06,78,6887,44,34,5299.14,8884.01,0.00
2024-12-10 17:23:06,78,6888,44,34,5314.44,8885.00,0.00
2024-12-10 17:23:06,79,6888,45,34,5247.17,8885.01,0.00
2024-12-10 17:23:06,79,6889,45,34,5257.95,8886.00,0.00
2024-12-10 17:23:06,80,6889,45,35,5192.22,8886.01,0.00
2024-12-10 17:23:06,79,6889,45,34,5251.87,8886.08,0.00
2024-12-10 17:23:06,79,6890,45,34,5265.49,8887.00,0.00
2024-12-10 17:23:06,80,6890,45,35,5199.67,8887.01,0.00
2024-12-10 17:23:06,80,6891,45,35,5202.46,8888.00,0.00
2024-12-10 17:23:06,81,6891,45,36,5138.23,8888.01,0.00
2024-12-10 17:23:06,80,6891,45,35,5188.15,8888.16,0.00
2024-12-10 17:23:06,80,6892,45,35,5200.98,8889.00,0.00
2024-12-10 17:23:06,81,6892,46,35,5136.77,8889.01,0.00
2024-12-10 17:23:06,80,6892,45,35,5195.44,8889.06,0.00
2024-12-10 17:23:06,80,6893,45,35,5194.95,8890.00,0.00
2024-12-10 17:23:06,81,6893,45,36,5130.81,8890.01,0.00
2024-12-10 17:23:06,80,6893,44,36,5189.69,8890.06,0.00
2024-12-10 17:23:06,79,6893,43,36,5212.35,8890.53,0.00
2024-12-10 17:23:06,79,6894,43,36,5277.70,8891.00,0.00
2024-12-10 17:23:06,80,6894,43,37,5211.73,8891.01,0.00
2024-12-10 17:23:06,79,6894,42,37,5262.61,8891.18,0.00
2024-12-10 17:23:06,79,6895,42,37,5294.14,8892.00,0.00
2024-12-10 17:23:06,80,6895,43,37,5227.96,8892.01,0.00
2024-12-10 17:23:06,80,6896,43,37,5242.49,8893.00,0.00
2024-12-10 17:23:06,81,6896,44,37,5177.77,8893.01,0.00
2024-12-10 17:23:06,81,6897,44,37,5190.94,8894.00,0.00
2024-12-10 17:23:06,82,6897,45,37,5127.64,8894.01,0.00
2024-12-10 17:23:06,82,6898,45,37,5137.87,8895.00,0.00
2024-12-10 17:23:06,83,6898,46,37,5075.97,8895.01,0.00
2024-12-10 17:23:06,83,6899,46,37,5083.80,8896.00,0.00
2024-12-10 17:23:06,84,6899,47,37,5023.28,8896.01,0.00
2024-12-10 17:23:06,85,6898,47,38,4912.82,8896.54,0.00
2024-12-10 17:23:06,85,6899,47,38,5007.68,8897.00,0.00
2024-12-10 17:23:06,86,6899,48,38,4949.45,8897.01,0.00
2024-12-10 17:23:06,87,6898,49,38,4841.62,8897.53,0.00
2024-12-10 17:23:06,87,6899,49,38,4996.32,8898.00,0.00
2024-12-10 17:23:06,88,6899,49,39,4939.55,8898.01,0.00
2024-12-10 17:23:06,88,6900,49,39,5035.27,8899.00,0.00
2024-12-10 17:23:06,89,6900,49,40,4978.70,8899.01,0.00
2024-12-10 17:23:07,89,6901,49,40,4969.71,8900.00,0.00
2024-12-10 17:23:07,90,6901,50,40,4914.49,8900.01,0.00
2024-12-10 17:23:07,89,6901,50,39,4897.55,8900.64,0.00
2024-12-10 17:23:07,89,6902,50,39,4958.07,8901.00,0.00
2024-12-10 17:23:07,90,6902,51,39,4902.98,8901.01,0.00
2024-12-10 17:23:07,89,6902,51,38,4950.91,8901.09,0.00
2024-12-10 17:23:07,88,6902,50,38,4970.82,8901.43,0.00
2024-12-10 17:23:07,88,6903,50,38,5004.46,8902.00,0.00
2024-12-10 17:23:07,89,6903,50,39,4948.23,8902.01,0.00
2024-12-10 17:23:07,88,6903,50,38,4998.44,8902.07,0.00
2024-12-10 17:23:07,88,6904,50,38,4993.63,8903.00,0.00
2024-12-10 17:23:07,89,6904,50,39,4937.53,8903.01,0.00
2024-12-10 17:23:07,88,6904,49,39,4987.58,8903.07,0.00
2024-12-10 17:23:07,87,6904,49,38,5042.53,8903.08,0.00
2024-12-10 17:23:07,87,6905,49,38,5039.19,8904.00,0.00
2024-12-10 17:23:07,88,6905,50,38,4981.93,8904.01,0.00
2024-12-10 17:23:07,88,6906,50,38,4969.44,8905.00,0.00
2024-12-10 17:23:07,89,6906,51,38,4913.60,8905.01,0.00
2024-12-10 17:23:07,88,6906,51,37,4963.38,8905.07,0.00
2024-12-10 17:23:07,88,6907,51,37,4954.49,8906.00,0.00
2024-12-10 17:23:07,89,6907,51,38,4898.82,8906.01,0.00
2024-12-10 17:23:07,89,6908,51,38,4880.28,8907.00,0.00
2024-12-10 17:23:07,90,6908,51,39,4826.05,8907.01,0.00
2024-12-10 17:23:07,91,6907,52,39,4740.22,8907.37,0.00
2024-12-10 17:23:07,91,6908,52,39,4802.78,8908.00,0.00
2024-12-10 17:23:07,92,6908,53,39,4750.57,8908.01,0.00
2024-12-10 17:23:07,91,6908,52,39,4763.50,8908.42,0.00
2024-12-10 17:23:07,91,6909,52,39,4877.43,8909.00,0.00
2024-12-10 17:23:07,92,6909,53,39,4824.42,8909.01,0.00
2024-12-10 17:23:07,91,6909,52,39,4810.07,8909.57,0.00
2024-12-10 17:23:07,91,6910,52,39,4854.24,8910.00,0.00
2024-12-10 17:23:07,92,6910,52,40,4801.48,8910.01,0.00
2024-12-10 17:23:07,91,6910,51,40,4768.83,8910.86,0.00
2024-12-10 17:23:07,91,6911,51,40,4854.14,8911.00,0.00
2024-12-10 17:23:07,92,6911,52,40,4801.38,8911.01,0.00
2024-12-10 17:23:07,92,6912,52,40,4805.40,8912.00,0.00
2024-12-10 17:23:07,93,6912,52,41,4753.73,8912.01,0.00
2024-12-10 17:23:07,93,6913,52,41,4755.61,8913.00,0.00
2024-12-10 17:23:07,94,6913,53,41,4705.02,8913.01,0.00
2024-12-10 17:23:07,94,6914,53,41,4703.03,8914.00,0.00
2024-12-10 17:23:07,95,6914,53,42,4653.53,8914.01,0.00
2024-12-10 17:23:07,94,6914,52,42,4673.42,8914.32,0.00
2024-12-10 17:23:07,94,6915,52,42,4696.32,8915.00,0.00
2024-12-10 17:23:07,95,6915,53,42,4646.89,8915.01,0.00
2024-12-10 17:23:07,94,6915,52,42,4695.97,8915.01,0.00
2024-12-10 17:23:07,93,6915,51,42,4729.49,8915.19,0.00
2024-12-10 17:23:07,94,6914,52,42,4648.97,8915.55,0.00
2024-12-10 17:23:07,94,6915,52,42,4752.74,8916.00,0.00
2024-12-10 17:23:07,95,6915,52,43,4702.71,8916.01,0.00
2024-12-10 17:23:07,95,6916,52,43,4767.62,8917.00,0.00
2024-12-10 17:23:07,96,6916,52,44,4717.96,8917.01,0.00
2024-12-10 17:23:07,95,6916,51,44,4732.71,8917.38,0.00
2024-12-10 17:23:07,94,6916,50,44,4741.04,8917.57,0.00
2024-12-10 17:23:07,94,6917,50,44,4795.59,8918.00,0.00
2024-12-10 17:23:07,95,6917,51,44,4745.11,8918.01,0.00
2024-12-10 17:23:07,94,6917,50,44,4793.70,8918.02,0.00
2024-12-10 17:23:07,94,6918,50,44,4784.96,8919.00,0.00
2024-12-10 17:23:07,95,6918,50,45,4734.60,8919.01,0.00
2024-12-10 17:23:07,96,6917,51,45,4684.35,8919.04,0.00
2024-12-10 17:23:07,96,6918,51,45,4732.89,8920.00,0.00
2024-12-10 17:23:07,97,6918,52,45,4684.10,8920.01,0.00
2024-12-10 17:23:07,97,6919,52,45,4762.70,8921.00,0.00
2024-12-10 17:23:07,98,6919,53,45,4714.10,8921.01,0.00
2024-12-10 17:23:07,97,6919,53,44,4759.03,8921.04,0.00
2024-12-10 17:23:07,97,6920,53,44,4749.48,8922.00,0.00
2024-12-10 17:23:07,98,6920,53,45,4701.02,8922.01,0.00
2024-12-10 17:23:07,97,6920,53,44,4745.82,8922.04,0.00
2024-12-10 17:23:07,96,6920,52,44,4754.53,8922.48,0.00
2024-12-10 17:23:07,96,6921,52,44,4799.64,8923.00,0.00
2024-12-10 17:23:07,97,6921,53,44,4750.16,8923.01,0.00
2024-12-10 17:23:07,96,6921,53,43,4795.94,8923.04,0.00
2024-12-10 17:23:07,96,6922,53,43,4802.85,8924.00,0.00
2024-12-10 17:23:07,97,6922,54,43,4753.34,8924.01,0.00
2024-12-10 17:23:07,96,6922,53,43,4799.15,8924.04,0.00
2024-12-10 17:23:07,95,6922,52,43,4828.38,8924.27,0.00
2024-12-10 17:23:07,95,6923,52,43,4857.77,8925.00,0.00
2024-12-10 17:23:07,96,6923,52,44,4807.17,8925.01,0.00
2024-12-10 17:23:07,95,6923,52,43,4854.03,8925.04,0.00
2024-12-10 17:23:07,95,6924,52,43,4862.56,8926.00,0.00
2024-12-10 17:23:07,96,6924,53,43,4811.91,8926.01,0.00
2024-12-10 17:23:07,95,6924,53,42,4859.06,8926.04,0.00
2024-12-10 17:23:07,95,6925,53,42,4865.39,8927.00,0.00
2024-12-10 17:23:07,96,6925,53,43,4814.71,8927.01,0.00
2024-12-10 17:23:08,95,6925,52,43,4861.65,8927.04,0.00
2024-12-10 17:23:08,95,6926,52,43,4865.07,8928.00,0.00
2024-12-10 17:23:08,96,6926,52,44,4814.39,8928.01,0.00
2024-12-10 17:23:08,95,6926,52,43,4861.32,8928.04,0.00
2024-12-10 17:23:08,95,6927,52,43,4861.90,8929.00,0.00
2024-12-10 17:23:08,96,6927,53,43,4811.25,8929.01,0.00
2024-12-10 17:23:08,95,6927,52,43,4858.15,8929.04,0.00
2024-12-10 17:23:08,95,6928,52,43,4855.38,8930.00,0.00
2024-12-10 17:23:08,96,6928,52,44,4804.81,8930.01,0.00
2024-12-10 17:23:08,95,6928,51,44,4851.64,8930.04,0.00
2024-12-10 17:23:08,95,6929,51,44,4845.73,8931.00,0.00
2024-12-10 17:23:08,96,6929,51,45,4795.25,8931.01,0.00
2024-12-10 17:23:08,95,6929,50,45,4845.23,8931.01,0.00
2024-12-10 17:23:08,94,6929,50,44,4893.94,8931.03,0.00
2024-12-10 17:23:08,93,6929,50,43,4945.60,8931.03,0.00
2024-12-10 17:23:08,93,6930,50,43,4934.67,8932.00,0.00
2024-12-10 17:23:08,94,6930,50,44,4882.17,8932.01,0.00
2024-12-10 17:23:08,93,6930,49,44,4931.80,8932.03,0.00
2024-12-10 17:23:08,93,6931,49,44,4914.78,8933.00,0.00
2024-12-10 17:23:08,94,6931,50,44,4862.50,8933.01,0.00
2024-12-10 17:23:08,94,6932,50,44,4836.87,8934.00,0.00
2024-12-10 17:23:08,95,6932,50,45,4785.95,8934.01,0.00
2024-12-10 17:23:08,94,6932,49,45,4798.78,8934.36,0.00
2024-12-10 17:23:08,94,6933,49,45,4805.27,8935.00,0.00
2024-12-10 17:23:08,95,6933,50,45,4754.69,8935.01,0.00
2024-12-10 17:23:08,94,6933,50,44,4759.72,8935.47,0.00
2024-12-10 17:23:08,94,6934,50,44,4798.78,8936.00,0.00
2024-12-10 17:23:08,95,6934,50,45,4748.27,8936.01,0.00
2024-12-10 17:23:08,94,6934,49,45,4795.01,8936.03,0.00
2024-12-10 17:23:08,94,6935,49,45,4797.49,8937.00,0.00
2024-12-10 17:23:08,95,6935,50,45,4746.99,8937.01,0.00
2024-12-10 17:23:08,94,6935,50,44,4792.89,8937.03,0.00
2024-12-10 17:23:08,94,6936,50,44,4797.77,8938.00,0.00
2024-12-10 17:23:08,95,6936,51,44,4747.27,8938.01,0.00
2024-12-10 17:23:08,95,6937,51,44,4747.97,8939.00,0.00
2024-12-10 17:23:08,96,6937,51,45,4698.52,8939.01,0.00
2024-12-10 17:23:08,96,6938,51,45,4698.38,8940.00,0.00
2024-12-10 17:23:08,97,6938,52,45,4649.94,8940.01,0.00
2024-12-10 17:23:08,96,6938,51,45,4691.44,8940.03,0.00
2024-12-10 17:23:08,96,6939,51,45,4697.43,8941.00,0.00
2024-12-10 17:23:08,97,6939,52,45,4649.00,8941.01,0.00
2024-12-10 17:23:08,96,6939,52,44,4690.58,8941.03,0.00
2024-12-10 17:23:08,95,6939,51,44,4685.68,8941.63,0.00
2024-12-10 17:23:08,95,6940,51,44,4746.89,8942.00,0.00
2024-12-10 17:23:08,96,6940,51,45,4697.44,8942.01,0.00
2024-12-10 17:23:08,96,6941,51,45,4698.34,8943.00,0.00
2024-12-10 17:23:08,97,6941,51,46,4649.91,8943.01,0.00
2024-12-10 17:23:08,96,6941,51,45,4692.90,8943.03,0.00
2024-12-10 17:23:08,96,6942,51,45,4698.71,8944.00,0.00
2024-12-10 17:23:08,97,6942,52,45,4650.26,8944.01,0.00
2024-12-10 17:23:08,96,6942,51,45,4694.18,8944.03,0.00
2024-12-10 17:23:08,96,6943,51,45,4701.22,8945.00,0.00
2024-12-10 17:23:08,97,6943,52,45,4652.75,8945.01,0.00
2024-12-10 17:23:08,96,6943,52,44,4697.45,8945.03,0.00
2024-12-10 17:23:08,96,6944,52,44,4704.06,8946.00,0.00
2024-12-10 17:23:08,97,6944,52,45,4655.57,8946.01,0.00
2024-12-10 17:23:08,96,6944,52,44,4700.56,8946.03,0.00
2024-12-10 17:23:08,96,6945,52,44,4706.10,8947.00,0.00
2024-12-10 17:23:08,97,6945,53,44,4657.59,8947.01,0.00
2024-12-10 17:23:08,96,6945,52,44,4702.12,8947.03,0.00
2024-12-10 17:23:08,96,6946,52,44,4706.67,8948.00,0.00
2024-12-10 17:23:08,97,6946,52,45,4658.15,8948.01,0.00
2024-12-10 17:23:08,96,6946,52,44,4702.55,8948.02,0.00
2024-12-10 17:23:08,95,6946,51,44,4751.11,8948.02,0.00
2024-12-10 17:23:08,95,6947,51,44,4754.63,8949.00,0.00
2024-12-10 17:23:08,96,6947,52,44,4705.10,8949.01,0.00
2024-12-10 17:23:08,96,6948,52,44,4705.92,8950.00,0.00
2024-12-10 17:23:08,97,6948,53,44,4657.40,8950.01,0.00
2024-12-10 17:23:08,96,6948,52,44,4645.25,8950.64,0.00
2024-12-10 17:23:08,96,6949,52,44,4706.15,8951.00,0.00
2024-12-10 17:23:08,97,6949,52,45,4657.63,8951.01,0.00
2024-12-10 17:23:08,97,6950,52,45,4658.03,8952.00,0.00
2024-12-10 17:23:08,98,6950,53,45,4610.50,8952.01,0.00
2024-12-10 17:23:08,97,6950,53,44,4654.35,8952.04,0.00
2024-12-10 17:23:08,97,6951,53,44,4657.99,8953.00,0.00
2024-12-10 17:23:08,98,6951,54,44,4610.46,8953.01,0.00
2024-12-10 17:23:08,98,6952,54,44,4610.98,8954.00,0.00
2024-12-10 17:23:08,99,6952,55,44,4564.40,8954.01,0.00
2024-12-10 17:23:08,99,6953,55,44,4564.38,8955.00,0.00
2024-12-10 17:23:08,100,6953,56,44,4518.73,8955.01,0.00
2024-12-10 17:23:08,101,6952,57,44,4432.62,8955.47,0.00
2024-12-10 17:23:08,101,6953,57,44,4520.79,8956.00,0.00
2024-12-10 17:23:08,102,6953,58,44,4476.47,8956.01,0.00
2024-12-10 17:23:08,101,6953,58,43,4517.26,8956.04,0.00
2024-12-10 17:23:09,101,6954,58,43,4606.79,8957.00,0.00
2024-12-10 17:23:09,102,6954,59,43,4561.63,8957.01,0.00
2024-12-10 17:23:09,101,6954,59,42,4604.12,8957.04,0.00
2024-12-10 17:23:09,100,6954,59,41,4631.36,8957.13,0.00
2024-12-10 17:23:09,100,6955,59,41,4641.73,8958.00,0.00
2024-12-10 17:23:09,101,6955,59,42,4595.77,8958.01,0.00
2024-12-10 17:23:09,100,6955,58,42,4638.16,8958.04,0.00
2024-12-10 17:23:09,100,6956,58,42,4640.66,8959.00,0.00
2024-12-10 17:23:09,101,6956,58,43,4594.71,8959.01,0.00
2024-12-10 17:23:09,100,6956,57,43,4619.17,8959.13,0.00
2024-12-10 17:23:09,101,6955,58,43,4563.70,8959.26,0.00
2024-12-10 17:23:09,101,6956,58,43,4669.01,8960.00,0.00
2024-12-10 17:23:09,102,6956,58,44,4623.23,8960.01,0.00
2024-12-10 17:23:09,101,6956,57,44,4665.47,8960.04,0.00
2024-12-10 17:23:09,101,6957,57,44,4744.74,8961.00,0.00
2024-12-10 17:23:09,102,6957,57,45,4698.22,8961.01,0.00
2024-12-10 17:23:09,103,6956,58,45,4650.87,8961.05,0.00
2024-12-10 17:23:09,103,6957,58,45,4678.92,8962.00,0.00
2024-12-10 17:23:09,104,6957,58,46,4633.93,8962.01,0.00
2024-12-10 17:23:09,103,6957,57,46,4675.98,8962.04,0.00
2024-12-10 17:23:09,103,6958,57,46,4734.56,8963.00,0.00
2024-12-10 17:23:09,104,6958,58,46,4689.04,8963.01,0.00
2024-12-10 17:23:09,103,6958,58,45,4731.10,8963.04,0.00
2024-12-10 17:23:09,102,6958,57,45,4776.60,8963.04,0.00
2024-12-10 17:23:09,101,6958,56,45,4816.79,8963.07,0.00
2024-12-10 17:23:09,100,6958,55,45,4858.08,8963.14,0.00
2024-12-10 17:23:09,100,6959,55,45,4830.27,8964.00,0.00
2024-12-10 17:23:09,101,6959,56,45,4782.45,8964.01,0.00
2024-12-10 17:23:09,100,6959,55,45,4826.70,8964.04,0.00
2024-12-10 17:23:09,99,6959,54,45,4855.53,8964.17,0.00
2024-12-10 17:23:09,99,6960,54,45,4855.08,8965.00,0.00
2024-12-10 17:23:09,100,6960,55,45,4806.52,8965.01,0.00
2024-12-10 17:23:09,99,6960,54,45,4851.47,8965.04,0.00
2024-12-10 17:23:09,99,6961,54,45,4833.95,8966.00,0.00
2024-12-10 17:23:09,100,6961,54,46,4785.61,8966.01,0.00
2024-12-10 17:23:09,99,6961,53,46,4830.34,8966.04,0.00
2024-12-10 17:23:09,98,6961,52,46,4785.88,8966.93,0.00
2024-12-10 17:23:09,98,6962,52,46,4871.04,8967.00,0.00
2024-12-10 17:23:09,99,6962,53,46,4821.83,8967.01,0.00
2024-12-10 17:23:09,99,6963,53,46,4822.35,8968.00,0.00
2024-12-10 17:23:09,100,6963,53,47,4774.12,8968.01,0.00
2024-12-10 17:23:09,100,6964,53,47,4773.09,8969.00,0.00
2024-12-10 17:23:09,101,6964,53,48,4725.83,8969.01,0.00
2024-12-10 17:23:09,100,6964,53,47,4769.52,8969.04,0.00
2024-12-10 17:23:09,100,6965,53,47,4770.23,8970.00,0.00
2024-12-10 17:23:09,101,6965,53,48,4723.00,8970.01,0.00
2024-12-10 17:23:09,101,6966,53,48,4718.95,8971.00,0.00
2024-12-10 17:23:09,102,6966,53,49,4672.68,8971.01,0.00
2024-12-10 17:23:09,101,6966,53,48,4706.91,8971.14,0.00
2024-12-10 17:23:09,101,6967,53,48,4713.14,8972.00,0.00
2024-12-10 17:23:09,102,6967,54,48,4666.93,8972.01,0.00
2024-12-10 17:23:09,101,6967,53,48,4709.60,8972.04,0.00
2024-12-10 17:23:09,101,6968,53,48,4705.53,8973.00,0.00
2024-12-10 17:23:09,102,6968,53,49,4659.39,8973.01,0.00
2024-12-10 17:23:09,101,6968,53,48,4701.98,8973.04,0.00
2024-12-10 17:23:09,101,6969,53,48,4695.29,8974.00,0.00
2024-12-10 17:23:09,102,6969,53,49,4649.26,8974.01,0.00
2024-12-10 17:23:09,102,6970,53,49,4637.53,8975.00,0.00
2024-12-10 17:23:09,103,6970,53,50,4592.50,8975.01,0.00
2024-12-10 17:23:09,102,6970,52,50,4634.02,8975.04,0.00
2024-12-10 17:23:09,102,6971,52,50,4622.15,8976.00,0.00
2024-12-10 17:23:09,103,6971,53,50,4577.28,8976.01,0.00
2024-12-10 17:23:09,103,6972,53,50,4556.34,8977.00,0.00
2024-12-10 17:23:09,104,6972,53,51,4512.52,8977.01,0.00
2024-12-10 17:23:09,103,6972,52,51,4554.99,8977.02,0.00
2024-12-10 17:23:09,102,6972,51,51,4597.89,8977.03,0.00
2024-12-10 17:23:09,102,6973,51,51,4572.67,8978.00,0.00
2024-12-10 17:23:09,103,6973,52,51,4528.28,8978.01,0.00
2024-12-10 17:23:09,102,6973,52,50,4570.04,8978.03,0.00
2024-12-10 17:23:09,102,6974,52,50,4539.58,8979.00,0.00
2024-12-10 17:23:09,103,6974,53,50,4495.51,8979.01,0.00
2024-12-10 17:23:09,102,6974,52,50,4536.96,8979.03,0.00
2024-12-10 17:23:09,102,6975,52,50,4502.29,8980.00,0.00
2024-12-10 17:23:09,103,6975,52,51,4458.58,8980.01,0.00
2024-12-10 17:23:09,102,6975,51,51,4443.77,8980.55,0.00
2024-12-10 17:23:09,102,6976,51,51,4469.82,8981.00,0.00
2024-12-10 17:23:09,103,6976,52,51,4426.43,8981.01,0.00
2024-12-10 17:23:09,102,6976,52,50,4467.19,8981.03,0.00
2024-12-10 17:23:09,101,6976,52,49,4504.55,8981.09,0.00
2024-12-10 17:23:09,100,6976,51,49,4489.98,8981.65,0.00
2024-12-10 17:23:09,100,6977,51,49,4536.62,8982.00,0.00
2024-12-10 17:23:09,101,6977,51,50,4491.70,8982.01,0.00
2024-12-10 17:23:09,100,6977,51,49,4533.94,8982.03,0.00
2024-12-10 17:23:09,100,6978,51,49,4496.76,8983.00,0.00
2024-12-10 17:23:09,101,6978,51,50,4452.24,8983.01,0.00
2024-12-10 17:23:09,100,6978,50,50,4494.08,8983.03,0.00
2024-12-10 17:23:09,99,6978,49,50,4486.19,8983.44,0.00
2024-12-10 17:23:09,99,6979,49,50,4506.15,8984.00,0.00
2024-12-10 17:23:09,100,6979,50,50,4461.09,8984.01,0.00
2024-12-10 17:23:09,99,6979,50,49,4503.44,8984.03,0.00
2024-12-10 17:23:09,98,6979,49,49,4511.43,8984.45,0.00
2024-12-10 17:23:09,98,6980,49,49,4528.88,8985.00,0.00
2024-12-10 17:23:09,99,6980,50,49,4483.13,8985.01,0.00
2024-12-10 17:23:10,99,6981,50,49,4458.54,8986.00,0.00
2024-12-10 17:23:10,100,6981,51,49,4413.95,8986.01,0.00
2024-12-10 17:23:10,100,6982,51,49,4385.89,8987.00,0.00
2024-12-10 17:23:10,101,6982,52,49,4342.46,8987.01,0.00
2024-12-10 17:23:10,100,6982,52,48,4383.20,8987.03,0.00
2024-12-10 17:23:10,100,6983,52,48,4358.16,8988.00,0.00
2024-12-10 17:23:10,101,6983,52,49,4315.01,8988.01,0.00
2024-12-10 17:23:10,100,6983,52,48,4269.96,8988.75,0.00
2024-12-10 17:23:10,100,6984,52,48,4336.81,8989.00,0.00
2024-12-10 17:23:10,101,6984,52,49,4293.87,8989.01,0.00
2024-12-10 17:23:10,100,6984,51,49,4334.12,8989.03,0.00
2024-12-10 17:23:10,99,6984,51,48,4334.86,8989.42,0.00
2024-12-10 17:23:10,99,6985,51,48,4372.15,8990.00,0.00
2024-12-10 17:23:10,100,6985,51,49,4328.43,8990.01,0.00
2024-12-10 17:23:10,99,6985,51,48,4369.44,8990.03,0.00
2024-12-10 17:23:10,99,6986,51,48,4371.28,8991.00,0.00
2024-12-10 17:23:10,100,6986,51,49,4327.57,8991.01,0.00
2024-12-10 17:23:10,99,6986,51,48,4364.08,8991.08,0.00
2024-12-10 17:23:10,99,6987,51,48,4369.65,8992.00,0.00
2024-12-10 17:23:10,100,6987,52,48,4325.95,8992.01,0.00
2024-12-10 17:23:10,99,6987,51,48,4366.94,8992.03,0.00
2024-12-10 17:23:10,99,6988,51,48,4367.11,8993.00,0.00
2024-12-10 17:23:10,100,6988,52,48,4323.44,8993.01,0.00
2024-12-10 17:23:10,99,6988,51,48,4364.40,8993.03,0.00
2024-12-10 17:23:10,99,6989,51,48,4363.88,8994.00,0.00
2024-12-10 17:23:10,100,6989,52,48,4320.24,8994.01,0.00
2024-12-10 17:23:10,99,6989,51,48,4361.16,8994.03,0.00
2024-12-10 17:23:10,99,6990,51,48,4359.97,8995.00,0.00
2024-12-10 17:23:10,100,6990,52,48,4316.37,8995.01,0.00
2024-12-10 17:23:10,99,6990,51,48,4357.25,8995.03,0.00
2024-12-10 17:23:10,99,6991,51,48,4356.03,8996.00,0.00
2024-12-10 17:23:10,100,6991,52,48,4312.47,8996.01,0.00
2024-12-10 17:23:10,99,6991,51,48,4353.32,8996.03,0.00
2024-12-10 17:23:10,98,6991,51,47,4366.31,8996.37,0.00
2024-12-10 17:23:10,98,6992,51,47,4398.02,8997.00,0.00
2024-12-10 17:23:10,99,6992,51,48,4353.60,8997.01,0.00
2024-12-10 17:23:10,98,6992,50,48,4395.28,8997.03,0.00
2024-12-10 17:23:10,98,6993,50,48,4396.32,8998.00,0.00
2024-12-10 17:23:10,99,6993,51,48,4351.92,8998.01,0.00
2024-12-10 17:23:10,98,6993,51,47,4393.58,8998.03,0.00
2024-12-10 17:23:10,98,6994,51,47,4394.18,8999.00,0.00
2024-12-10 17:23:10,99,6994,52,47,4349.79,8999.01,0.00
2024-12-10 17:23:10,98,6994,52,46,4391.43,8999.03,0.00
2024-12-10 17:23:10,98,6995,52,46,4392.20,9000.00,0.00
2024-12-10 17:23:10,99,6995,52,47,4347.83,9000.01,0.00
2024-12-10 17:23:10,98,6995,51,47,4389.45,9000.03,0.00
2024-12-10 17:23:10,98,6996,51,47,4390.31,9001.00,0.00
2024-12-10 17:23:10,99,6996,52,47,4345.97,9001.01,0.00
2024-12-10 17:23:10,99,6997,52,47,4343.41,9002.00,0.00
2024-12-10 17:23:10,100,6997,53,47,4299.98,9002.01,0.00
2024-12-10 17:23:10,99,6997,53,46,4339.78,9002.04,0.00
2024-12-10 17:23:10,99,6998,53,46,4339.36,9003.00,0.00
2024-12-10 17:23:10,100,6998,54,46,4295.97,9003.01,0.00
2024-12-10 17:23:10,99,6998,54,45,4335.74,9003.04,0.00
2024-12-10 17:23:10,99,6999,54,45,4334.94,9004.00,0.00
2024-12-10 17:23:10,100,6999,55,45,4291.59,9004.01,0.00
2024-12-10 17:23:10,99,6999,54,45,4331.32,9004.04,0.00
2024-12-10 17:23:10,98,6999,53,45,4327.63,9004.52,0.00
2024-12-10 17:23:10,98,7000,53,45,4375.30,9005.00,0.00
2024-12-10 17:23:10,99,7000,53,46,4331.11,9005.01,0.00
2024-12-10 17:23:10,98,7000,52,46,4371.64,9005.04,0.00
2024-12-10 17:23:10,98,7001,52,46,4372.67,9006.00,0.00
2024-12-10 17:23:10,99,7001,52,47,4328.50,9006.01,0.00
2024-12-10 17:23:10,98,7001,52,46,4369.01,9006.04,0.00
2024-12-10 17:23:10,97,7001,51,46,4370.15,9006.50,0.00
2024-12-10 17:23:10,97,7002,51,46,4414.71,9007.00,0.00
2024-12-10 17:23:10,98,7002,51,47,4369.66,9007.01,0.00
2024-12-10 17:23:10,97,7002,51,46,4411.01,9007.04,0.00
2024-12-10 17:23:10,97,7003,51,46,4413.21,9008.00,0.00
2024-12-10 17:23:10,98,7003,51,47,4368.18,9008.01,0.00
2024-12-10 17:23:10,97,7003,50,47,4409.51,9008.04,0.00
2024-12-10 17:23:10,97,7004,50,47,4410.27,9009.00,0.00
2024-12-10 17:23:10,98,7004,51,47,4365.26,9009.01,0.00
2024-12-10 17:23:10,97,7004,50,47,4406.56,9009.04,0.00
2024-12-10 17:23:10,97,7005,50,47,4406.18,9010.00,0.00
2024-12-10 17:23:10,98,7005,51,47,4361.22,9010.01,0.00
2024-12-10 17:23:10,97,7005,51,46,4402.47,9010.04,0.00
2024-12-10 17:23:10,96,7005,50,46,4405.05,9010.52,0.00
2024-12-10 17:23:10,96,7006,50,46,4446.88,9011.00,0.00
2024-12-10 17:23:10,97,7006,51,46,4401.04,9011.01,0.00
2024-12-10 17:23:10,96,7006,50,46,4443.14,9011.04,0.00
2024-12-10 17:23:10,96,7007,50,46,4442.82,9012.00,0.00
2024-12-10 17:23:10,97,7007,50,47,4397.02,9012.01,0.00
2024-12-10 17:23:10,96,7007,50,46,4439.08,9012.04,0.00
2024-12-10 17:23:10,96,7008,50,46,4438.39,9013.00,0.00
2024-12-10 17:23:10,97,7008,51,46,4392.63,9013.01,0.00
2024-12-10 17:23:10,96,7008,50,46,4434.65,9013.04,0.00
2024-12-10 17:23:10,96,7009,50,46,4433.33,9014.00,0.00
2024-12-10 17:23:10,97,7009,50,47,4387.62,9014.01,0.00
2024-12-10 17:23:11,96,7009,50,46,4429.58,9014.04,0.00
2024-12-10 17:23:11,95,7009,50,45,4430.26,9014.54,0.00
2024-12-10 17:23:11,95,7010,50,45,4481.48,9015.00,0.00
2024-12-10 17:23:11,96,7010,50,46,4434.80,9015.01,0.00
2024-12-10 17:23:11,95,7010,49,46,4477.70,9015.04,0.00
2024-12-10 17:23:11,95,7011,49,46,4483.99,9016.00,0.00
2024-12-10 17:23:11,96,7011,50,46,4437.28,9016.01,0.00
2024-12-10 17:23:11,95,7011,50,45,4480.21,9016.04,0.00
2024-12-10 17:23:11,95,7012,50,45,4485.49,9017.00,0.00
2024-12-10 17:23:11,96,7012,51,45,4438.76,9017.01,0.00
2024-12-10 17:23:11,95,7012,51,44,4481.70,9017.04,0.00
2024-12-10 17:23:11,95,7013,51,44,4486.00,9018.00,0.00
2024-12-10 17:23:11,96,7013,51,45,4439.27,9018.01,0.00
2024-12-10 17:23:11,95,7013,50,45,4482.21,9018.04,0.00
2024-12-10 17:23:11,95,7014,50,45,4486.55,9019.00,0.00
2024-12-10 17:23:11,96,7014,51,45,4439.81,9019.01,0.00
2024-12-10 17:23:11,95,7014,51,44,4485.60,9019.01,0.00
2024-12-10 17:23:11,94,7014,51,43,4530.45,9019.03,0.00
2024-12-10 17:23:11,93,7014,50,43,4578.19,9019.03,0.00
2024-12-10 17:23:11,93,7015,50,43,4583.75,9020.00,0.00
2024-12-10 17:23:11,94,7015,50,44,4534.99,9020.01,0.00
2024-12-10 17:23:11,93,7015,49,44,4580.85,9020.03,0.00
2024-12-10 17:23:11,93,7016,49,44,4586.21,9021.00,0.00
2024-12-10 17:23:11,94,7016,50,44,4537.42,9021.01,0.00
2024-12-10 17:23:11,93,7016,49,44,4583.31,9021.03,0.00
2024-12-10 17:23:11,93,7017,49,44,4588.53,9022.00,0.00
2024-12-10 17:23:11,94,7017,50,44,4539.71,9022.01,0.00
2024-12-10 17:23:11,93,7017,50,43,4585.62,9022.03,0.00
2024-12-10 17:23:11,93,7018,50,43,4588.75,9023.00,0.00
2024-12-10 17:23:11,94,7018,50,44,4539.94,9023.01,0.00
2024-12-10 17:23:11,93,7018,49,44,4585.85,9023.03,0.00
2024-12-10 17:23:11,93,7019,49,44,4585.31,9024.00,0.00
2024-12-10 17:23:11,94,7019,49,45,4536.53,9024.01,0.00
2024-12-10 17:23:11,93,7019,48,45,4582.40,9024.03,0.00
2024-12-10 17:23:11,92,7019,48,44,4575.85,9024.50,0.00
2024-12-10 17:23:11,92,7020,48,44,4629.20,9025.00,0.00
2024-12-10 17:23:11,93,7020,49,44,4579.42,9025.01,0.00
2024-12-10 17:23:11,92,7020,49,43,4626.26,9025.03,0.00
2024-12-10 17:23:11,92,7021,49,43,4634.71,9026.00,0.00
2024-12-10 17:23:11,93,7021,49,44,4584.88,9026.01,0.00
2024-12-10 17:23:11,93,7022,49,44,4590.41,9027.00,0.00
2024-12-10 17:23:11,94,7022,49,45,4541.58,9027.01,0.00
2024-12-10 17:23:11,93,7022,49,44,4587.51,9027.03,0.00
2024-12-10 17:23:11,93,7023,49,44,4594.66,9028.00,0.00
2024-12-10 17:23:11,94,7023,50,44,4545.78,9028.01,0.00
2024-12-10 17:23:11,93,7023,50,43,4591.75,9028.03,0.00
2024-12-10 17:23:11,93,7024,50,43,4596.80,9029.00,0.00
2024-12-10 17:23:11,94,7024,50,44,4547.90,9029.01,0.00
2024-12-10 17:23:11,93,7024,49,44,4580.25,9029.16,0.00
2024-12-10 17:23:11,93,7025,49,44,4598.55,9030.00,0.00
2024-12-10 17:23:11,94,7025,50,44,4549.63,9030.01,0.00
2024-12-10 17:23:11,94,7026,50,44,4552.09,9031.00,0.00
2024-12-10 17:23:11,95,7026,50,45,4504.17,9031.01,0.00
2024-12-10 17:23:11,94,7026,50,44,4549.21,9031.03,0.00
2024-12-10 17:23:11,94,7027,50,44,4552.50,9032.00,0.00
2024-12-10 17:23:11,95,7027,51,44,4504.58,9032.01,0.00
2024-12-10 17:23:11,95,7028,51,44,4504.26,9033.00,0.00
2024-12-10 17:23:11,96,7028,52,44,4457.34,9033.01,0.00
2024-12-10 17:23:11,95,7028,51,44,4501.41,9033.03,0.00
2024-12-10 17:23:11,95,7029,51,44,4502.88,9034.00,0.00
2024-12-10 17:23:11,96,7029,51,45,4455.98,9034.01,0.00
2024-12-10 17:23:11,95,7029,51,44,4500.03,9034.03,0.00
2024-12-10 17:23:11,95,7030,51,44,4501.52,9035.00,0.00
2024-12-10 17:23:11,96,7030,52,44,4454.63,9035.01,0.00
2024-12-10 17:23:11,96,7031,52,44,4453.32,9036.00,0.00
2024-12-10 17:23:11,97,7031,52,45,4407.41,9036.01,0.00
2024-12-10 17:23:11,96,7031,52,44,4450.50,9036.03,0.00
2024-12-10 17:23:11,95,7031,51,44,4496.61,9036.03,0.00
2024-12-10 17:23:11,94,7031,50,44,4501.51,9036.46,0.00
2024-12-10 17:23:11,94,7032,50,44,4549.01,9037.00,0.00
2024-12-10 17:23:11,95,7032,50,45,4501.13,9037.01,0.00
2024-12-10 17:23:11,94,7032,50,44,4529.00,9037.22,0.00
2024-12-10 17:23:11,94,7033,50,44,4555.43,9038.00,0.00
2024-12-10 17:23:11,95,7033,50,45,4507.48,9038.01,0.00
2024-12-10 17:23:11,94,7033,49,45,4552.55,9038.03,0.00
2024-12-10 17:23:11,94,7034,49,45,4561.71,9039.00,0.00
2024-12-10 17:23:11,95,7034,49,46,4513.69,9039.01,0.00
2024-12-10 17:23:11,94,7034,49,45,4558.83,9039.03,0.00
2024-12-10 17:23:11,94,7035,49,45,4567.98,9040.00,0.00
2024-12-10 17:23:11,95,7035,49,46,4519.90,9040.01,0.00
2024-12-10 17:23:11,94,7035,48,46,4565.10,9040.03,0.00
2024-12-10 17:23:11,94,7036,48,46,4574.26,9041.00,0.00
2024-12-10 17:23:11,95,7036,48,47,4526.11,9041.01,0.00
2024-12-10 17:23:11,94,7036,47,47,4571.38,9041.03,0.00
2024-12-10 17:23:11,94,7037,47,47,4580.54,9042.00,0.00
2024-12-10 17:23:11,95,7037,48,47,4532.32,9042.01,0.00
2024-12-10 17:23:11,94,7037,48,46,4577.65,9042.03,0.00
2024-12-10 17:23:11,94,7038,48,46,4586.81,9043.00,0.00
2024-12-10 17:23:11,95,7038,48,47,4538.53,9043.01,0.00
2024-12-10 17:23:11,94,7038,48,46,4583.93,9043.03,0.00
2024-12-10 17:23:11,94,7039,48,46,4593.09,9044.00,0.00
2024-12-10 17:23:11,95,7039,49,46,4544.75,9044.01,0.00
2024-12-10 17:23:12,94,7039,48,46,4590.21,9044.03,0.00
2024-12-10 17:23:12,94,7040,48,46,4599.38,9045.00,0.00
2024-12-10 17:23:12,95,7040,49,46,4550.96,9045.01,0.00
2024-12-10 17:23:12,95,7040,49,46,4557.18,9046.00,0.00
2024-12-10 17:23:12,96,7040,50,46,4509.71,9046.01,0.00
2024-12-10 17:23:12,95,7040,50,45,4554.32,9046.03,0.00
2024-12-10 17:23:12,94,7040,49,45,4598.29,9046.07,0.00
2024-12-10 17:23:12,94,7041,49,45,4611.31,9047.00,0.00
2024-12-10 17:23:12,95,7041,50,45,4562.77,9047.01,0.00
2024-12-10 17:23:12,95,7042,50,45,4568.99,9048.00,0.00
2024-12-10 17:23:12,96,7042,50,46,4521.39,9048.01,0.00
2024-12-10 17:23:12,95,7042,50,45,4566.13,9048.03,0.00
2024-12-10 17:23:12,95,7043,50,45,4574.26,9049.00,0.00
2024-12-10 17:23:12,96,7043,51,45,4526.61,9049.01,0.00
2024-12-10 17:23:12,95,7043,50,45,4571.40,9049.03,0.00
2024-12-10 17:23:12,95,7044,50,45,4579.53,9050.00,0.00
2024-12-10 17:23:12,96,7044,50,46,4531.82,9050.01,0.00
2024-12-10 17:23:12,95,7044,49,46,4576.67,9050.03,0.00
2024-12-10 17:23:12,95,7045,49,46,4584.79,9051.00,0.00
2024-12-10 17:23:12,96,7045,49,47,4537.04,9051.01,0.00
2024-12-10 17:23:12,95,7045,49,46,4581.94,9051.03,0.00
2024-12-10 17:23:12,95,7046,49,46,4590.06,9052.00,0.00
2024-12-10 17:23:12,96,7046,50,46,4542.25,9052.01,0.00
2024-12-10 17:23:12,96,7047,50,46,4546.99,9053.00,0.00
2024-12-10 17:23:12,97,7047,50,47,4500.11,9053.01,0.00
2024-12-10 17:23:12,96,7047,49,47,4544.16,9053.03,0.00
2024-12-10 17:23:12,95,7047,49,46,4582.49,9053.13,0.00
2024-12-10 17:23:12,95,7048,49,46,4598.01,9054.00,0.00
2024-12-10 17:23:12,96,7048,49,47,4550.11,9054.01,0.00
2024-12-10 17:23:12,95,7048,48,47,4595.15,9054.03,0.00
2024-12-10 17:23:12,95,7049,48,47,4602.34,9055.00,0.00
2024-12-10 17:23:12,96,7049,48,48,4554.40,9055.01,0.00
2024-12-10 17:23:12,95,7049,47,48,4600.44,9055.02,0.00
2024-12-10 17:23:12,94,7049,46,48,4648.41,9055.02,0.00
2024-12-10 17:23:12,94,7050,46,48,4654.94,9056.00,0.00
2024-12-10 17:23:12,95,7050,47,48,4605.94,9056.01,0.00
2024-12-10 17:23:12,96,7049,48,48,4557.96,9056.03,0.00
2024-12-10 17:23:12,96,7050,48,48,4649.03,9057.00,0.00
2024-12-10 17:23:12,97,7050,48,49,4601.10,9057.01,0.00
2024-12-10 17:23:12,96,7050,47,49,4647.16,9057.02,0.00
2024-12-10 17:23:12,95,7050,47,48,4667.40,9057.15,0.00
2024-12-10 17:23:12,95,7051,47,48,4774.93,9058.00,0.00
2024-12-10 17:23:12,96,7051,48,48,4725.19,9058.01,0.00
2024-12-10 17:23:12,95,7051,48,47,4773.03,9058.02,0.00
2024-12-10 17:23:12,94,7051,48,46,4815.40,9058.11,0.00
2024-12-10 17:23:12,94,7052,48,46,4824.36,9059.00,0.00
2024-12-10 17:23:12,95,7052,49,46,4773.58,9059.01,0.00
2024-12-10 17:23:12,95,7053,49,46,4773.38,9060.00,0.00
2024-12-10 17:23:12,96,7053,50,46,4723.66,9060.01,0.00
2024-12-10 17:23:12,95,7053,50,45,4771.48,9060.02,0.00
2024-12-10 17:23:12,95,7054,50,45,4773.91,9061.00,0.00
2024-12-10 17:23:12,96,7054,51,45,4724.18,9061.01,0.00
2024-12-10 17:23:12,95,7054,51,44,4772.01,9061.02,0.00
2024-12-10 17:23:12,94,7054,50,44,4822.43,9061.02,0.00
2024-12-10 17:23:12,94,7055,50,44,4826.54,9062.00,0.00
2024-12-10 17:23:12,95,7055,50,45,4775.73,9062.01,0.00
2024-12-10 17:23:12,95,7056,50,45,4778.01,9063.00,0.00
2024-12-10 17:23:12,96,7056,51,45,4728.24,9063.01,0.00
2024-12-10 17:23:12,96,7057,51,45,4728.12,9064.00,0.00
2024-12-10 17:23:12,97,7057,52,45,4679.38,9064.01,0.00
2024-12-10 17:23:12,96,7057,51,45,4726.24,9064.02,0.00
2024-12-10 17:23:12,96,7058,51,45,4725.53,9065.00,0.00
2024-12-10 17:23:12,97,7058,52,45,4676.81,9065.01,0.00
2024-12-10 17:23:12,96,7058,51,45,4723.65,9065.02,0.00
2024-12-10 17:23:12,96,7059,51,45,4721.76,9066.00,0.00
2024-12-10 17:23:12,97,7059,52,45,4673.08,9066.01,0.00
2024-12-10 17:23:12,97,7060,52,45,4670.05,9067.00,0.00
2024-12-10 17:23:12,98,7060,52,46,4622.40,9067.01,0.00
2024-12-10 17:23:12,97,7060,51,46,4668.19,9067.02,0.00
2024-12-10 17:23:12,96,7060,51,45,4702.33,9067.18,0.00
2024-12-10 17:23:12,96,7061,51,45,4720.59,9068.00,0.00
2024-12-10 17:23:12,97,7061,51,46,4671.93,9068.01,0.00
2024-12-10 17:23:12,96,7061,51,45,4718.71,9068.02,0.00
2024-12-10 17:23:12,97,7060,52,45,4590.58,9068.91,0.00
2024-12-10 17:23:12,97,7061,52,45,4684.16,9069.00,0.00
2024-12-10 17:23:12,98,7061,53,45,4636.37,9069.01,0.00
2024-12-10 17:23:12,97,7061,52,45,4675.72,9069.10,0.00
2024-12-10 17:23:12,97,7062,52,45,4780.07,9070.00,0.00
2024-12-10 17:23:12,98,7062,53,45,4731.29,9070.01,0.00
2024-12-10 17:23:12,97,7062,53,44,4778.20,9070.02,0.00
2024-12-10 17:23:12,97,7063,53,44,4780.44,9071.00,0.00
2024-12-10 17:23:12,98,7063,54,44,4731.66,9071.01,0.00
2024-12-10 17:23:12,98,7064,54,44,4730.48,9072.00,0.00
2024-12-10 17:23:12,99,7064,55,44,4682.70,9072.01,0.00
2024-12-10 17:23:12,98,7064,54,44,4728.64,9072.02,0.00
2024-12-10 17:23:12,98,7065,54,44,4726.57,9073.00,0.00
2024-12-10 17:23:12,99,7065,54,45,4678.82,9073.01,0.00
2024-12-10 17:23:12,98,7065,54,44,4724.72,9073.02,0.00
2024-12-10 17:23:12,97,7065,54,43,4699.80,9073.73,0.00
2024-12-10 17:23:12,97,7066,54,43,4769.25,9074.00,0.00
2024-12-10 17:23:12,98,7066,55,43,4720.59,9074.01,0.00
2024-12-10 17:23:13,98,7067,55,43,4718.94,9075.00,0.00
2024-12-10 17:23:13,99,7067,55,44,4671.27,9075.01,0.00
2024-12-10 17:23:13,98,7067,55,43,4717.09,9075.02,0.00
2024-12-10 17:23:13,97,7067,54,43,4763.88,9075.03,0.00
2024-12-10 17:23:13,97,7068,54,43,4766.36,9076.00,0.00
2024-12-10 17:23:13,98,7068,54,44,4717.73,9076.01,0.00
2024-12-10 17:23:13,97,7068,53,44,4764.50,9076.02,0.00
2024-12-10 17:23:13,96,7068,52,44,4813.67,9076.02,0.00
2024-12-10 17:23:13,96,7069,52,44,4816.25,9077.00,0.00
2024-12-10 17:23:13,97,7069,52,45,4766.60,9077.01,0.00
2024-12-10 17:23:13,98,7068,52,46,4640.99,9077.85,0.00
2024-12-10 17:23:13,98,7069,52,46,4732.84,9078.00,0.00
2024-12-10 17:23:13,99,7069,53,46,4685.03,9078.01,0.00
2024-12-10 17:23:13,99,7070,53,46,4775.89,9079.00,0.00
2024-12-10 17:23:13,100,7070,54,46,4728.13,9079.01,0.00
2024-12-10 17:23:13,101,7069,55,46,4601.75,9079.87,0.00
2024-12-10 17:23:13,101,7070,55,46,4689.97,9080.00,0.00
2024-12-10 17:23:13,102,7070,56,46,4643.99,9080.01,0.00
2024-12-10 17:23:13,101,7070,56,45,4688.18,9080.02,0.00
2024-12-10 17:23:13,101,7071,56,45,4775.43,9081.00,0.00
2024-12-10 17:23:13,102,7071,56,46,4728.61,9081.01,0.00
2024-12-10 17:23:13,103,7070,56,47,4612.23,9081.76,0.00
2024-12-10 17:23:13,103,7071,56,47,4689.17,9082.00,0.00
2024-12-10 17:23:13,104,7071,56,48,4644.08,9082.01,0.00
2024-12-10 17:23:13,103,7071,56,47,4687.41,9082.02,0.00
2024-12-10 17:23:13,103,7072,56,47,4770.45,9083.00,0.00
2024-12-10 17:23:13,104,7072,57,47,4724.58,9083.01,0.00
2024-12-10 17:23:13,103,7072,57,46,4768.70,9083.02,0.00
2024-12-10 17:23:13,103,7073,57,46,4762.62,9084.00,0.00
2024-12-10 17:23:13,104,7073,57,47,4716.83,9084.01,0.00
2024-12-10 17:23:13,105,7072,58,47,4598.10,9084.77,0.00
2024-12-10 17:23:13,106,7071,58,48,4570.17,9084.80,0.00
2024-12-10 17:23:13,106,7072,58,48,4652.63,9085.00,0.00
2024-12-10 17:23:13,107,7072,58,49,4609.15,9085.01,0.00
2024-12-10 17:23:13,106,7072,57,49,4650.92,9085.02,0.00
2024-12-10 17:23:13,106,7073,57,49,4811.14,9086.00,0.00
2024-12-10 17:23:13,107,7073,58,49,4766.18,9086.01,0.00
2024-12-10 17:23:13,106,7073,57,49,4809.43,9086.02,0.00
2024-12-10 17:23:13,106,7074,57,49,4797.00,9087.00,0.00
2024-12-10 17:23:13,107,7074,58,49,4752.17,9087.01,0.00
2024-12-10 17:23:13,106,7074,57,49,4795.29,9087.02,0.00
2024-12-10 17:23:13,106,7075,57,49,4781.87,9088.00,0.00
2024-12-10 17:23:13,107,7075,58,49,4737.18,9088.01,0.00
2024-12-10 17:23:13,106,7075,58,48,4734.90,9088.50,0.00
2024-12-10 17:23:13,106,7076,58,48,4766.77,9089.00,0.00
2024-12-10 17:23:13,107,7076,58,49,4722.22,9089.01,0.00
2024-12-10 17:23:13,106,7076,58,48,4765.06,9089.02,0.00
2024-12-10 17:23:13,106,7077,58,48,4750.78,9090.00,0.00
2024-12-10 17:23:13,107,7077,58,49,4706.38,9090.01,0.00
2024-12-10 17:23:13,106,7077,58,48,4749.07,9090.02,0.00
2024-12-10 17:23:13,106,7078,58,48,4732.71,9091.00,0.00
2024-12-10 17:23:13,107,7078,58,49,4688.48,9091.01,0.00
2024-12-10 17:23:13,106,7078,58,48,4731.00,9091.02,0.00
2024-12-10 17:23:13,105,7078,58,47,4722.71,9091.60,0.00
2024-12-10 17:23:13,105,7079,58,47,4765.00,9092.00,0.00
2024-12-10 17:23:13,106,7079,58,48,4720.05,9092.01,0.00
2024-12-10 17:23:13,105,7079,57,48,4763.27,9092.02,0.00
2024-12-10 17:23:13,105,7080,57,48,4751.85,9093.00,0.00
2024-12-10 17:23:13,106,7080,58,48,4707.02,9093.01,0.00
2024-12-10 17:23:13,105,7080,57,48,4750.12,9093.02,0.00
2024-12-10 17:23:13,105,7081,57,48,4737.43,9094.00,0.00
2024-12-10 17:23:13,106,7081,58,48,4692.74,9094.01,0.00
2024-12-10 17:23:13,105,7081,57,48,4735.70,9094.02,0.00
2024-12-10 17:23:13,105,7082,57,48,4721.16,9095.00,0.00
2024-12-10 17:23:13,106,7082,57,49,4676.62,9095.01,0.00
2024-12-10 17:23:13,105,7082,56,49,4719.43,9095.02,0.00
2024-12-10 17:23:13,105,7083,56,49,4701.88,9096.00,0.00
2024-12-10 17:23:13,106,7083,57,49,4657.52,9096.01,0.00
2024-12-10 17:23:13,105,7083,56,49,4700.15,9096.02,0.00
2024-12-10 17:23:13,105,7084,56,49,4681.05,9097.00,0.00
2024-12-10 17:23:13,106,7084,56,50,4636.89,9097.01,0.00
2024-12-10 17:23:13,105,7084,56,49,4679.32,9097.02,0.00
2024-12-10 17:23:13,105,7085,56,49,4659.82,9098.00,0.00
2024-12-10 17:23:13,106,7085,57,49,4615.86,9098.01,0.00
2024-12-10 17:23:13,105,7085,56,49,4658.10,9098.02,0.00
2024-12-10 17:23:13,105,7086,56,49,4628.64,9099.00,0.00
2024-12-10 17:23:13,106,7086,57,49,4584.97,9099.01,0.00
2024-12-10 17:23:13,105,7086,56,49,4626.91,9099.02,0.00
2024-12-10 17:23:13,105,7087,56,49,4601.90,9100.00,0.00
2024-12-10 17:23:13,106,7087,57,49,4558.49,9100.01,0.00
2024-12-10 17:23:13,105,7087,57,48,4600.17,9100.02,0.00
2024-12-10 17:23:13,105,7088,57,48,4570.97,9101.00,0.00
2024-12-10 17:23:13,106,7088,58,48,4527.85,9101.01,0.00
2024-12-10 17:23:13,105,7088,57,48,4569.25,9101.02,0.00
2024-12-10 17:23:13,105,7089,57,48,4532.99,9102.00,0.00
2024-12-10 17:23:13,106,7089,57,49,4490.23,9102.01,0.00
2024-12-10 17:23:13,105,7089,56,49,4531.26,9102.02,0.00
2024-12-10 17:23:13,104,7089,55,49,4536.02,9102.30,0.00
2024-12-10 17:23:13,103,7089,55,48,4532.64,9102.70,0.00
2024-12-10 17:23:13,103,7090,55,48,4586.49,9103.00,0.00
2024-12-10 17:23:13,104,7090,55,49,4542.39,9103.01,0.00
2024-12-10 17:23:13,103,7090,54,49,4584.73,9103.02,0.00
2024-12-10 17:23:13,102,7090,53,49,4575.73,9103.52,0.00
2024-12-10 17:23:14,102,7091,53,49,4613.81,9104.00,0.00
2024-12-10 17:23:14,103,7091,53,50,4569.02,9104.01,0.00
2024-12-10 17:23:14,102,7091,52,50,4612.03,9104.02,0.00
2024-12-10 17:23:14,102,7092,52,50,4607.02,9105.00,0.00
2024-12-10 17:23:14,103,7092,52,51,4562.30,9105.01,0.00
2024-12-10 17:23:14,102,7092,52,50,4605.24,9105.02,0.00
2024-12-10 17:23:14,103,7091,52,51,4506.38,9105.62,0.00
2024-12-10 17:23:14,103,7092,52,51,4588.25,9106.00,0.00
2024-12-10 17:23:14,104,7092,52,52,4544.13,9106.01,0.00
2024-12-10 17:23:14,103,7092,52,51,4586.49,9106.02,0.00
2024-12-10 17:23:14,103,7093,52,51,4670.07,9107.00,0.00
2024-12-10 17:23:14,104,7093,53,51,4625.17,9107.01,0.00
2024-12-10 17:23:14,103,7093,53,50,4668.31,9107.02,0.00
2024-12-10 17:23:14,103,7094,53,50,4663.14,9108.00,0.00
2024-12-10 17:23:14,104,7094,54,50,4618.30,9108.01,0.00
2024-12-10 17:23:14,103,7094,54,49,4661.37,9108.02,0.00
2024-12-10 17:23:14,102,7094,53,49,4629.78,9108.70,0.00
2024-12-10 17:23:14,102,7095,53,49,4691.65,9109.00,0.00
2024-12-10 17:23:14,103,7095,53,50,4646.10,9109.01,0.00
2024-12-10 17:23:14,102,7095,52,50,4689.87,9109.02,0.00
2024-12-10 17:23:14,101,7095,51,50,4727.42,9109.08,0.00
2024-12-10 17:23:14,100,7095,51,49,4753.40,9109.22,0.00
2024-12-10 17:23:14,100,7096,51,49,4772.92,9110.00,0.00
2024-12-10 17:23:14,101,7096,51,50,4725.66,9110.01,0.00
2024-12-10 17:23:14,100,7096,50,50,4771.10,9110.02,0.00
2024-12-10 17:23:14,100,7097,50,50,4772.82,9111.00,0.00
2024-12-10 17:23:14,101,7097,50,51,4725.56,9111.01,0.00
2024-12-10 17:23:14,100,7097,49,51,4771.00,9111.02,0.00
2024-12-10 17:23:14,100,7098,49,51,4773.11,9112.00,0.00
2024-12-10 17:23:14,101,7098,50,51,4725.86,9112.01,0.00
2024-12-10 17:23:14,100,7098,50,50,4771.30,9112.02,0.00
2024-12-10 17:23:14,100,7099,50,50,4773.64,9113.00,0.00
2024-12-10 17:23:14,101,7099,51,50,4726.38,9113.01,0.00
2024-12-10 17:23:14,100,7099,50,50,4771.82,9113.02,0.00
2024-12-10 17:23:14,100,7100,50,50,4774.16,9114.00,0.00
2024-12-10 17:23:14,101,7100,50,51,4726.89,9114.01,0.00
2024-12-10 17:23:14,100,7100,50,50,4772.34,9114.02,0.00
2024-12-10 17:23:14,100,7101,50,50,4773.76,9115.00,0.00
2024-12-10 17:23:14,101,7101,50,51,4726.50,9115.01,0.00
2024-12-10 17:23:14,100,7101,50,50,4771.94,9115.02,0.00
2024-12-10 17:23:14,99,7101,49,50,4774.25,9115.53,0.00
2024-12-10 17:23:14,99,7102,49,50,4822.77,9116.00,0.00
2024-12-10 17:23:14,100,7102,49,51,4774.54,9116.01,0.00
2024-12-10 17:23:14,100,7103,49,51,4775.97,9117.00,0.00
2024-12-10 17:23:14,101,7103,49,52,4728.69,9117.01,0.00
2024-12-10 17:23:14,100,7103,48,52,4774.15,9117.02,0.00
2024-12-10 17:23:14,100,7104,48,52,4776.50,9118.00,0.00
2024-12-10 17:23:14,101,7104,49,52,4729.21,9118.01,0.00
2024-12-10 17:23:14,100,7104,49,51,4774.68,9118.02,0.00
2024-12-10 17:23:14,100,7105,49,51,4776.22,9119.00,0.00
2024-12-10 17:23:14,101,7105,50,51,4728.93,9119.01,0.00
2024-12-10 17:23:14,100,7105,49,51,4774.40,9119.02,0.00
2024-12-10 17:23:14,100,7106,49,51,4772.80,9120.00,0.00
2024-12-10 17:23:14,101,7106,49,52,4725.55,9120.01,0.00
2024-12-10 17:23:14,100,7106,49,51,4770.98,9120.02,0.00
2024-12-10 17:23:14,100,7107,49,51,4769.46,9121.00,0.00
2024-12-10 17:23:14,101,7107,49,52,4722.24,9121.01,0.00
2024-12-10 17:23:14,100,7107,48,52,4767.64,9121.02,0.00
2024-12-10 17:23:14,100,7108,48,52,4765.24,9122.00,0.00
2024-12-10 17:23:14,101,7108,48,53,4718.06,9122.01,0.00
2024-12-10 17:23:14,100,7108,47,53,4763.42,9122.02,0.00
2024-12-10 17:23:14,100,7109,47,53,4759.43,9123.00,0.00
2024-12-10 17:23:14,101,7109,48,53,4712.31,9123.01,0.00
2024-12-10 17:23:14,100,7109,48,52,4757.61,9123.02,0.00
2024-12-10 17:23:14,100,7110,48,52,4754.59,9124.00,0.00
2024-12-10 17:23:14,101,7110,49,52,4707.51,9124.01,0.00
2024-12-10 17:23:14,100,7110,49,51,4752.77,9124.02,0.00
2024-12-10 17:23:14,100,7111,49,51,4750.93,9125.00,0.00
2024-12-10 17:23:14,101,7111,49,52,4703.89,9125.01,0.00
2024-12-10 17:23:14,100,7111,48,52,4749.10,9125.02,0.00
2024-12-10 17:23:14,100,7112,48,52,4746.82,9126.00,0.00
2024-12-10 17:23:14,101,7112,48,53,4699.83,9126.01,0.00
2024-12-10 17:23:14,100,7112,48,52,4745.00,9126.02,0.00
2024-12-10 17:23:14,101,7111,49,52,4659.04,9126.43,0.00
2024-12-10 17:23:14,101,7112,49,52,4743.07,9127.00,0.00
2024-12-10 17:23:14,102,7112,50,52,4696.57,9127.01,0.00
2024-12-10 17:23:14,101,7112,50,51,4741.27,9127.02,0.00
2024-12-10 17:23:14,100,7112,50,50,4780.70,9127.10,0.00
2024-12-10 17:23:14,100,7113,50,50,4867.99,9128.00,0.00
2024-12-10 17:23:14,101,7113,50,51,4819.79,9128.01,0.00
2024-12-10 17:23:14,100,7113,49,51,4866.16,9128.02,0.00
2024-12-10 17:23:14,100,7114,49,51,4849.89,9129.00,0.00
2024-12-10 17:23:14,101,7114,49,52,4801.87,9129.01,0.00
2024-12-10 17:23:14,100,7114,49,51,4848.07,9129.02,0.00
2024-12-10 17:23:14,99,7114,48,51,4870.35,9129.27,0.00
2024-12-10 17:23:14,99,7115,48,51,4880.51,9130.00,0.00
2024-12-10 17:23:14,100,7115,49,51,4831.70,9130.01,0.00
2024-12-10 17:23:14,99,7115,48,51,4878.66,9130.02,0.00
2024-12-10 17:23:14,99,7116,48,51,4867.09,9131.00,0.00
2024-12-10 17:23:14,100,7116,49,51,4818.42,9131.01,0.00
2024-12-10 17:23:14,100,7117,49,51,4810.00,9132.00,0.00
2024-12-10 17:23:14,101,7117,50,51,4762.37,9132.01,0.00
2024-12-10 17:23:14,101,7118,50,51,4758.04,9133.00,0.00
2024-12-10 17:23:14,102,7118,50,52,4711.39,9133.01,0.00
2024-12-10 17:23:15,101,7118,49,52,4756.23,9133.02,0.00
2024-12-10 17:23:15,101,7119,49,52,4756.30,9134.00,0.00
2024-12-10 17:23:15,102,7119,50,52,4709.67,9134.01,0.00
2024-12-10 17:23:15,101,7119,50,51,4754.50,9134.02,0.00
2024-12-10 17:23:15,101,7120,50,51,4755.85,9135.00,0.00
2024-12-10 17:23:15,102,7120,50,52,4709.23,9135.01,0.00
2024-12-10 17:23:15,101,7120,49,52,4754.04,9135.02,0.00
2024-12-10 17:23:15,101,7121,49,52,4755.45,9136.00,0.00
2024-12-10 17:23:15,102,7121,49,53,4708.83,9136.01,0.00
2024-12-10 17:23:15,101,7121,49,52,4753.65,9136.02,0.00
2024-12-10 17:23:15,101,7122,49,52,4755.07,9137.00,0.00
2024-12-10 17:23:15,102,7122,49,53,4708.45,9137.01,0.00
2024-12-10 17:23:15,101,7122,49,52,4753.26,9137.02,0.00
2024-12-10 17:23:15,101,7123,49,52,4754.53,9138.00,0.00
2024-12-10 17:23:15,102,7123,50,52,4707.91,9138.01,0.00
2024-12-10 17:23:15,103,7122,50,53,4646.26,9138.20,0.00
2024-12-10 17:23:15,103,7123,50,53,4731.57,9139.00,0.00
2024-12-10 17:23:15,104,7123,51,53,4686.08,9139.01,0.00
2024-12-10 17:23:15,103,7123,51,52,4729.80,9139.02,0.00
2024-12-10 17:23:15,103,7124,51,52,4817.33,9140.00,0.00
2024-12-10 17:23:15,104,7124,52,52,4771.00,9140.01,0.00
2024-12-10 17:23:15,104,7125,52,52,4766.90,9141.00,0.00
2024-12-10 17:23:15,105,7125,53,52,4721.50,9141.01,0.00
2024-12-10 17:23:15,104,7125,53,51,4765.14,9141.02,0.00
2024-12-10 17:23:15,104,7126,53,51,4758.01,9142.00,0.00
2024-12-10 17:23:15,105,7126,53,52,4712.70,9142.01,0.00
2024-12-10 17:23:15,104,7126,52,52,4756.26,9142.02,0.00
2024-12-10 17:23:15,104,7127,52,52,4753.93,9143.00,0.00
2024-12-10 17:23:15,105,7127,52,53,4708.66,9143.01,0.00
2024-12-10 17:23:15,104,7127,52,52,4752.18,9143.02,0.00
2024-12-10 17:23:15,104,7128,52,52,4750.94,9144.00,0.00
2024-12-10 17:23:15,105,7128,52,53,4705.69,9144.01,0.00
2024-12-10 17:23:15,104,7128,51,53,4749.57,9144.02,0.00
2024-12-10 17:23:15,105,7127,51,54,4685.22,9144.25,0.00
2024-12-10 17:23:15,105,7128,51,54,4737.08,9145.00,0.00
2024-12-10 17:23:15,106,7128,51,55,4692.39,9145.01,0.00
2024-12-10 17:23:15,105,7128,50,55,4735.34,9145.02,0.00
2024-12-10 17:23:15,105,7129,50,55,4819.51,9146.00,0.00
2024-12-10 17:23:15,106,7129,50,56,4774.04,9146.01,0.00
2024-12-10 17:23:15,105,7129,49,56,4817.77,9146.02,0.00
2024-12-10 17:23:15,105,7130,49,56,4815.68,9147.00,0.00
2024-12-10 17:23:15,106,7130,49,57,4770.25,9147.01,0.00
2024-12-10 17:23:15,105,7130,48,57,4813.94,9147.02,0.00
2024-12-10 17:23:15,104,7130,47,57,4811.30,9147.52,0.00
2024-12-10 17:23:15,103,7130,47,56,4855.25,9147.55,0.00
2024-12-10 17:23:15,103,7131,47,56,4903.55,9148.00,0.00
2024-12-10 17:23:15,104,7131,48,56,4856.40,9148.01,0.00
2024-12-10 17:23:15,105,7130,49,56,4791.03,9148.24,0.00
2024-12-10 17:23:15,105,7131,49,56,4867.33,9149.00,0.00
2024-12-10 17:23:15,106,7131,49,57,4821.41,9149.01,0.00
2024-12-10 17:23:15,105,7131,48,57,4865.59,9149.02,0.00
2024-12-10 17:23:15,105,7132,48,57,4941.50,9150.00,0.00
2024-12-10 17:23:15,106,7132,49,57,4894.88,9150.01,0.00
2024-12-10 17:23:15,105,7132,49,56,4939.75,9150.02,0.00
2024-12-10 17:23:15,106,7131,49,57,4863.90,9150.36,0.00
2024-12-10 17:23:15,107,7130,50,57,4845.19,9150.65,0.00
2024-12-10 17:23:15,107,7131,50,57,4925.96,9151.00,0.00
2024-12-10 17:23:15,108,7131,50,58,4880.35,9151.01,0.00
2024-12-10 17:23:15,107,7131,50,57,4924.25,9151.02,0.00
2024-12-10 17:23:15,107,7132,50,57,5089.84,9152.00,0.00
2024-12-10 17:23:15,108,7132,51,57,5042.72,9152.01,0.00
2024-12-10 17:23:15,107,7132,50,57,5088.13,9152.02,0.00
2024-12-10 17:23:15,107,7133,50,57,5083.40,9153.00,0.00
2024-12-10 17:23:15,108,7133,50,58,5036.34,9153.01,0.00
2024-12-10 17:23:15,107,7133,50,57,5081.69,9153.02,0.00
2024-12-10 17:23:15,107,7134,50,57,5077.44,9154.00,0.00
2024-12-10 17:23:15,108,7134,50,58,5030.43,9154.01,0.00
2024-12-10 17:23:15,107,7134,50,57,5075.73,9154.02,0.00
2024-12-10 17:23:15,108,7133,51,57,4966.67,9154.70,0.00
2024-12-10 17:23:15,108,7134,51,57,5047.45,9155.00,0.00
2024-12-10 17:23:15,109,7134,51,58,5001.15,9155.01,0.00
2024-12-10 17:23:15,109,7135,51,58,5077.11,9156.00,0.00
2024-12-10 17:23:15,110,7135,52,58,5030.96,9156.01,0.00
2024-12-10 17:23:15,109,7135,52,57,5076.27,9156.01,0.00
2024-12-10 17:23:15,108,7135,51,57,5122.43,9156.01,0.00
2024-12-10 17:23:15,107,7135,50,57,5169.45,9156.01,0.00
2024-12-10 17:23:15,107,7136,50,57,5163.12,9157.00,0.00
2024-12-10 17:23:15,108,7136,51,57,5115.32,9157.01,0.00
2024-12-10 17:23:15,107,7136,51,56,5162.31,9157.01,0.00
2024-12-10 17:23:15,106,7136,50,56,5183.14,9157.29,0.00
2024-12-10 17:23:15,106,7137,50,56,5203.47,9158.00,0.00
2024-12-10 17:23:15,107,7137,51,56,5154.84,9158.01,0.00
2024-12-10 17:23:15,107,7138,51,56,5144.71,9159.00,0.00
2024-12-10 17:23:15,108,7138,52,56,5097.08,9159.01,0.00
2024-12-10 17:23:15,108,7139,52,56,5084.20,9160.00,0.00
2024-12-10 17:23:15,109,7139,52,57,5037.56,9160.01,0.00
2024-12-10 17:23:15,108,7139,51,57,5082.52,9160.02,0.00
2024-12-10 17:23:15,108,7140,51,57,5069.32,9161.00,0.00
2024-12-10 17:23:15,109,7140,52,57,5022.81,9161.01,0.00
2024-12-10 17:23:15,109,7141,52,57,5006.38,9162.00,0.00
2024-12-10 17:23:15,110,7141,52,58,4960.87,9162.01,0.00
2024-12-10 17:23:15,110,7142,52,58,4945.96,9163.00,0.00
2024-12-10 17:23:15,111,7142,53,58,4901.40,9163.01,0.00
2024-12-10 17:23:16,111,7143,53,58,4887.36,9164.00,0.00
2024-12-10 17:23:16,112,7143,53,59,4843.73,9164.01,0.00
2024-12-10 17:23:16,111,7143,52,59,4883.68,9164.04,0.00
2024-12-10 17:23:16,110,7143,51,59,4897.02,9164.36,0.00
2024-12-10 17:23:16,110,7144,51,59,4917.67,9165.00,0.00
2024-12-10 17:23:16,111,7144,51,60,4873.37,9165.01,0.00
2024-12-10 17:23:16,110,7144,50,60,4912.60,9165.04,0.00
2024-12-10 17:23:16,111,7143,50,61,4867.52,9165.06,0.00
2024-12-10 17:23:16,111,7144,50,61,4929.88,9166.00,0.00
2024-12-10 17:23:16,112,7144,51,61,4885.86,9166.01,0.00
2024-12-10 17:23:16,113,7143,51,62,4831.71,9166.11,0.00
2024-12-10 17:23:16,113,7144,51,62,4920.73,9167.00,0.00
2024-12-10 17:23:16,114,7144,52,62,4877.57,9167.01,0.00
2024-12-10 17:23:16,114,7145,52,62,4933.53,9168.00,0.00
2024-12-10 17:23:16,115,7145,52,63,4890.63,9168.01,0.00
2024-12-10 17:23:16,114,7145,51,63,4930.10,9168.03,0.00
2024-12-10 17:23:16,115,7144,51,64,4885.64,9168.06,0.00
2024-12-10 17:23:16,114,7144,50,64,5007.32,9168.06,0.00
2024-12-10 17:23:16,115,7143,50,65,4952.65,9168.20,0.00
2024-12-10 17:23:16,116,7142,50,66,4907.07,9168.81,0.00
2024-12-10 17:23:16,116,7143,50,66,4982.50,9169.00,0.00
2024-12-10 17:23:16,117,7143,50,67,4939.91,9169.01,0.00
2024-12-10 17:23:16,118,7142,50,68,4898.05,9169.03,0.00
2024-12-10 17:23:16,119,7141,51,68,4807.94,9169.70,0.00
2024-12-10 17:23:16,119,7142,51,68,5099.43,9170.00,0.00
2024-12-10 17:23:16,120,7142,52,68,5056.93,9170.01,0.00
2024-12-10 17:23:16,121,7141,52,69,4940.50,9170.71,0.00
2024-12-10 17:23:16,121,7142,52,69,5144.21,9171.00,0.00
2024-12-10 17:23:16,122,7142,52,70,5102.04,9171.01,0.00
2024-12-10 17:23:16,122,7143,52,70,5131.98,9172.00,0.00
2024-12-10 17:23:16,123,7143,52,71,5090.26,9172.01,0.00
2024-12-10 17:23:16,122,7143,52,70,5092.92,9172.42,0.00
2024-12-10 17:23:16,122,7144,52,70,5090.52,9173.00,0.00
2024-12-10 17:23:16,123,7144,53,70,5049.14,9173.01,0.00
2024-12-10 17:23:16,122,7144,53,69,5083.80,9173.07,0.00
2024-12-10 17:23:16,122,7145,53,69,5047.24,9174.00,0.00
2024-12-10 17:23:16,123,7145,53,70,5006.21,9174.01,0.00
2024-12-10 17:23:16,122,7145,52,70,5040.51,9174.07,0.00
2024-12-10 17:23:16,122,7146,52,70,5004.36,9175.00,0.00
2024-12-10 17:23:16,123,7146,52,71,4963.67,9175.01,0.00
2024-12-10 17:23:16,123,7147,52,71,4926.18,9176.00,0.00
2024-12-10 17:23:16,124,7147,53,71,4886.45,9176.01,0.00
2024-12-10 17:23:16,123,7147,53,70,4919.50,9176.07,0.00
2024-12-10 17:23:16,122,7147,52,70,4889.99,9176.71,0.00
2024-12-10 17:23:16,122,7148,52,70,4936.69,9177.00,0.00
2024-12-10 17:23:16,123,7148,53,70,4896.56,9177.01,0.00
2024-12-10 17:23:16,122,7148,53,69,4935.19,9177.02,0.00
2024-12-10 17:23:16,121,7148,53,68,4970.71,9177.07,0.00
2024-12-10 17:23:16,120,7148,53,67,5011.36,9177.07,0.00
2024-12-10 17:23:16,119,7148,52,67,5036.09,9177.25,0.00
2024-12-10 17:23:16,118,7148,52,66,5030.77,9177.69,0.00
2024-12-10 17:23:16,118,7149,52,66,5077.99,9178.00,0.00
2024-12-10 17:23:16,119,7149,52,67,5035.32,9178.01,0.00
2024-12-10 17:23:16,118,7149,51,67,5071.81,9178.07,0.00
2024-12-10 17:23:16,118,7150,51,67,5055.30,9179.00,0.00
2024-12-10 17:23:16,119,7150,51,68,5012.82,9179.01,0.00
2024-12-10 17:23:16,118,7150,50,68,5049.12,9179.07,0.00
2024-12-10 17:23:16,117,7150,49,68,5091.49,9179.07,0.00
2024-12-10 17:23:16,116,7150,48,68,5082.59,9179.55,0.00
2024-12-10 17:23:16,116,7151,48,68,5117.41,9180.00,0.00
2024-12-10 17:23:16,117,7151,48,69,5073.68,9180.01,0.00
2024-12-10 17:23:16,117,7152,48,69,5054.73,9181.00,0.00
2024-12-10 17:23:16,118,7152,49,69,5011.89,9181.01,0.00
2024-12-10 17:23:16,117,7152,49,68,5048.49,9181.07,0.00
2024-12-10 17:23:16,116,7152,49,67,5091.22,9181.07,0.00
2024-12-10 17:23:16,117,7151,50,67,5040.66,9181.16,0.00
2024-12-10 17:23:16,117,7152,50,67,5103.62,9182.00,0.00
2024-12-10 17:23:16,118,7152,50,68,5060.37,9182.01,0.00
2024-12-10 17:23:16,117,7152,50,67,5097.38,9182.07,0.00
2024-12-10 17:23:16,118,7151,50,68,5038.65,9182.25,0.00
2024-12-10 17:23:16,118,7152,50,68,5183.06,9183.00,0.00
2024-12-10 17:23:16,119,7152,51,68,5139.50,9183.01,0.00
2024-12-10 17:23:16,118,7152,51,67,5170.02,9183.15,0.00
2024-12-10 17:23:16,118,7153,51,67,5226.97,9184.00,0.00
2024-12-10 17:23:16,119,7153,51,68,5183.04,9184.01,0.00
2024-12-10 17:23:16,118,7153,50,68,5225.42,9184.02,0.00
2024-12-10 17:23:16,117,7153,50,67,5264.62,9184.07,0.00
2024-12-10 17:23:16,116,7153,49,67,5309.21,9184.07,0.00
2024-12-10 17:23:16,116,7154,49,67,5280.02,9185.00,0.00
2024-12-10 17:23:16,117,7154,49,68,5234.89,9185.01,0.00
2024-12-10 17:23:16,116,7154,49,67,5272.94,9185.08,0.00
2024-12-10 17:23:16,116,7155,49,67,5242.50,9186.00,0.00
2024-12-10 17:23:16,117,7155,50,67,5197.69,9186.01,0.00
2024-12-10 17:23:16,116,7155,49,67,5236.18,9186.08,0.00
2024-12-10 17:23:16,116,7156,49,67,5205.99,9187.00,0.00
2024-12-10 17:23:16,117,7156,49,68,5161.49,9187.01,0.00
2024-12-10 17:23:16,118,7155,50,68,5115.44,9187.05,0.00
2024-12-10 17:23:16,117,7155,50,67,5104.16,9187.80,0.00
2024-12-10 17:23:16,117,7156,50,67,5156.79,9188.00,0.00
2024-12-10 17:23:16,118,7156,50,68,5113.09,9188.01,0.00
2024-12-10 17:23:16,119,7155,51,68,5069.36,9188.03,0.00
2024-12-10 17:23:16,118,7155,50,68,5124.04,9188.09,0.00
2024-12-10 17:23:16,118,7156,50,68,5177.59,9189.00,0.00
2024-12-10 17:23:16,119,7156,51,68,5134.08,9189.01,0.00
2024-12-10 17:23:16,118,7156,51,67,5170.63,9189.08,0.00
2024-12-10 17:23:16,118,7157,51,67,5221.16,9190.00,0.00
2024-12-10 17:23:16,119,7157,51,68,5177.28,9190.01,0.00
2024-12-10 17:23:17,119,7158,51,68,5140.51,9191.00,0.00
2024-12-10 17:23:17,120,7158,52,68,5097.68,9191.01,0.00
2024-12-10 17:23:17,119,7158,51,68,5086.08,9191.45,0.00
2024-12-10 17:23:17,119,7159,51,68,5096.87,9192.00,0.00
2024-12-10 17:23:17,120,7159,51,69,5054.40,9192.01,0.00
2024-12-10 17:23:17,119,7159,51,68,5089.00,9192.08,0.00
2024-12-10 17:23:17,118,7159,51,67,5123.24,9192.16,0.00
2024-12-10 17:23:17,119,7158,51,68,5043.26,9192.58,0.00
2024-12-10 17:23:17,119,7159,51,68,5089.77,9193.00,0.00
2024-12-10 17:23:17,120,7159,51,69,5047.36,9193.01,0.00
2024-12-10 17:23:17,119,7159,50,69,5081.39,9193.08,0.00
2024-12-10 17:23:17,119,7160,50,69,5126.98,9194.00,0.00
2024-12-10 17:23:17,120,7160,50,70,5084.26,9194.01,0.00
2024-12-10 17:23:17,119,7160,49,70,5118.29,9194.08,0.00
2024-12-10 17:23:17,119,7161,49,70,5080.81,9195.00,0.00
2024-12-10 17:23:17,120,7161,50,70,5038.47,9195.01,0.00
2024-12-10 17:23:17,119,7161,50,69,5072.05,9195.08,0.00
2024-12-10 17:23:17,119,7162,50,69,5027.45,9196.00,0.00
2024-12-10 17:23:17,120,7162,50,70,4985.56,9196.01,0.00
2024-12-10 17:23:17,119,7162,49,70,5019.31,9196.08,0.00
2024-12-10 17:23:17,120,7161,50,70,4954.46,9196.34,0.00
2024-12-10 17:23:17,119,7161,50,69,5010.72,9196.66,0.00
2024-12-10 17:23:17,119,7162,50,69,5026.74,9197.00,0.00
2024-12-10 17:23:17,120,7162,51,69,4984.85,9197.01,0.00
2024-12-10 17:23:17,119,7162,51,68,5018.07,9197.08,0.00
2024-12-10 17:23:17,119,7163,51,68,5053.98,9198.00,0.00
2024-12-10 17:23:17,120,7163,51,69,5011.87,9198.01,0.00
2024-12-10 17:23:17,121,7162,51,70,4897.02,9198.79,0.00
2024-12-10 17:23:17,120,7162,51,69,4985.79,9198.88,0.00
2024-12-10 17:23:17,120,7163,51,69,5033.03,9199.00,0.00
2024-12-10 17:23:17,121,7163,52,69,4991.43,9199.01,0.00
2024-12-10 17:23:17,120,7163,52,68,4938.43,9199.88,0.00
2024-12-10 17:23:17,120,7164,52,68,5074.79,9200.00,0.00
2024-12-10 17:23:17,121,7164,52,69,5032.85,9200.01,0.00
2024-12-10 17:23:17,121,7165,52,69,4995.51,9201.00,0.00
2024-12-10 17:23:17,122,7165,52,70,4954.56,9201.01,0.00
2024-12-10 17:23:17,121,7165,51,70,4986.57,9201.08,0.00
2024-12-10 17:23:17,120,7165,51,69,5024.87,9201.11,0.00
2024-12-10 17:23:17,121,7164,51,70,4957.55,9201.39,0.00
2024-12-10 17:23:17,121,7165,51,70,5009.77,9202.00,0.00
2024-12-10 17:23:17,122,7165,51,71,4968.71,9202.01,0.00
2024-12-10 17:23:17,123,7164,51,72,4926.83,9202.04,0.00
2024-12-10 17:23:17,122,7164,51,71,4986.86,9202.09,0.00
2024-12-10 17:23:17,123,7163,52,71,4866.56,9202.82,0.00
2024-12-10 17:23:17,123,7164,52,71,5009.44,9203.00,0.00
2024-12-10 17:23:17,124,7164,53,71,4969.05,9203.01,0.00
2024-12-10 17:23:17,123,7164,53,70,5002.31,9203.08,0.00
2024-12-10 17:23:17,123,7165,53,70,5123.33,9204.00,0.00
2024-12-10 17:23:17,124,7165,54,70,5082.01,9204.01,0.00
2024-12-10 17:23:17,124,7166,54,70,5045.93,9205.00,0.00
2024-12-10 17:23:17,125,7166,54,71,5005.57,9205.01,0.00
2024-12-10 17:23:17,124,7166,54,70,5038.56,9205.08,0.00
2024-12-10 17:23:17,125,7165,55,70,4914.00,9205.87,0.00
2024-12-10 17:23:17,125,7166,55,70,4973.95,9206.00,0.00
2024-12-10 17:23:17,126,7166,55,71,4934.47,9206.01,0.00
2024-12-10 17:23:17,125,7166,54,71,4963.45,9206.12,0.00
2024-12-10 17:23:17,125,7167,54,71,4992.50,9207.00,0.00
2024-12-10 17:23:17,126,7167,55,71,4952.88,9207.01,0.00
2024-12-10 17:23:17,125,7167,54,71,4985.18,9207.08,0.00
2024-12-10 17:23:17,124,7167,54,70,5023.59,9207.10,0.00
2024-12-10 17:23:17,125,7166,54,71,4969.63,9207.26,0.00
2024-12-10 17:23:17,125,7167,54,71,4936.06,9208.00,0.00
2024-12-10 17:23:17,126,7167,55,71,4896.88,9208.01,0.00
2024-12-10 17:23:17,125,7167,54,71,4927.55,9208.08,0.00
2024-12-10 17:23:17,124,7167,54,70,4963.12,9208.12,0.00
2024-12-10 17:23:17,123,7167,54,69,4944.12,9208.59,0.00
2024-12-10 17:23:17,123,7168,54,69,5025.51,9209.00,0.00
2024-12-10 17:23:17,124,7168,55,69,4984.98,9209.01,0.00
2024-12-10 17:23:17,123,7168,55,68,5012.54,9209.08,0.00
2024-12-10 17:23:17,122,7168,55,67,4956.49,9209.85,0.00
2024-12-10 17:23:17,122,7169,55,67,4999.48,9210.00,0.00
2024-12-10 17:23:17,123,7169,56,67,4958.84,9210.01,0.00
2024-12-10 17:23:17,122,7169,55,67,4893.26,9210.85,0.00
2024-12-10 17:23:17,122,7170,55,67,4948.53,9211.00,0.00
2024-12-10 17:23:17,123,7170,56,67,4908.30,9211.01,0.00
2024-12-10 17:23:17,122,7170,56,66,4930.35,9211.08,0.00
2024-12-10 17:23:17,122,7171,56,66,4891.38,9212.00,0.00
2024-12-10 17:23:17,123,7171,56,67,4851.62,9212.01,0.00
2024-12-10 17:23:17,122,7171,56,66,4847.49,9212.38,0.00
2024-12-10 17:23:17,122,7172,56,66,4816.14,9213.00,0.00
2024-12-10 17:23:17,123,7172,56,67,4776.98,9213.01,0.00
2024-12-10 17:23:17,122,7172,55,67,4806.83,9213.08,0.00
2024-12-10 17:23:17,121,7172,55,66,4839.68,9213.16,0.00
2024-12-10 17:23:17,122,7171,55,67,4798.50,9213.19,0.00
2024-12-10 17:23:17,123,7170,56,67,4806.00,9213.39,0.00
2024-12-10 17:23:17,123,7171,56,67,4791.32,9214.00,0.00
2024-12-10 17:23:17,124,7171,56,68,4752.68,9214.01,0.00
2024-12-10 17:23:17,123,7171,56,67,4783.15,9214.08,0.00
2024-12-10 17:23:17,122,7171,56,66,4773.77,9214.52,0.00
2024-12-10 17:23:17,122,7172,56,66,4878.30,9215.00,0.00
2024-12-10 17:23:17,123,7172,56,67,4838.64,9215.01,0.00
2024-12-10 17:23:17,122,7172,55,67,4731.08,9215.88,0.00
2024-12-10 17:23:17,122,7173,55,67,4764.76,9216.00,0.00
2024-12-10 17:23:17,123,7173,55,68,4726.02,9216.01,0.00
2024-12-10 17:23:17,122,7173,55,67,4750.73,9216.08,0.00
2024-12-10 17:23:17,121,7173,55,66,4777.07,9216.21,0.00
2024-12-10 17:23:17,122,7172,56,66,4723.61,9216.38,0.00
2024-12-10 17:23:17,122,7173,56,66,4706.14,9217.00,0.00
2024-12-10 17:23:17,123,7173,56,67,4667.88,9217.01,0.00
2024-12-10 17:23:18,123,7174,56,67,4650.96,9218.00,0.00
2024-12-10 17:23:18,124,7174,57,67,4613.45,9218.01,0.00
2024-12-10 17:23:18,123,7174,56,67,4640.08,9218.08,0.00
2024-12-10 17:23:18,123,7175,56,67,4555.19,9219.00,0.00
2024-12-10 17:23:18,124,7175,57,67,4518.46,9219.01,0.00
2024-12-10 17:23:18,123,7175,56,67,4545.23,9219.08,0.00
2024-12-10 17:23:18,122,7175,56,66,4581.45,9219.09,0.00
2024-12-10 17:23:18,122,7176,56,66,4494.57,9220.00,0.00
2024-12-10 17:23:18,123,7176,56,67,4458.03,9220.01,0.00
2024-12-10 17:23:18,122,7176,56,66,4484.94,9220.08,0.00
2024-12-10 17:23:18,122,7177,56,66,4401.14,9221.00,0.00
2024-12-10 17:23:18,123,7177,57,66,4365.35,9221.01,0.00
2024-12-10 17:23:18,122,7177,57,65,4351.82,9221.47,0.00
2024-12-10 17:23:18,122,7178,57,65,4305.86,9222.00,0.00
2024-12-10 17:23:18,123,7178,57,66,4270.85,9222.01,0.00
2024-12-10 17:23:18,122,7178,57,65,4298.33,9222.08,0.00
2024-12-10 17:23:18,123,7177,58,65,4243.96,9222.29,0.00
2024-12-10 17:23:18,122,7177,57,65,4249.35,9222.84,0.00
2024-12-10 17:23:18,121,7177,57,64,4280.08,9222.84,0.00
2024-12-10 17:23:18,121,7178,57,64,4312.03,9223.00,0.00
2024-12-10 17:23:18,122,7178,58,64,4276.69,9223.01,0.00
2024-12-10 17:23:18,121,7178,57,64,4308.10,9223.05,0.00
2024-12-10 17:23:18,120,7178,56,64,4340.94,9223.08,0.00
2024-12-10 17:23:18,119,7178,56,63,4348.03,9223.32,0.00
2024-12-10 17:23:18,120,7177,56,64,4257.83,9223.73,0.00
2024-12-10 17:23:18,119,7177,55,64,4266.28,9223.87,0.00
2024-12-10 17:23:18,119,7178,55,64,4397.81,9224.00,0.00
2024-12-10 17:23:18,120,7178,56,64,4361.16,9224.01,0.00
2024-12-10 17:23:18,119,7178,55,64,4390.86,9224.08,0.00
2024-12-10 17:23:18,118,7178,55,63,4373.54,9224.59,0.00
2024-12-10 17:23:18,117,7178,54,63,4345.95,9224.85,0.00
2024-12-10 17:23:18,117,7179,54,63,4474.93,9225.00,0.00
2024-12-10 17:23:18,118,7179,55,63,4437.00,9225.01,0.00
2024-12-10 17:23:18,117,7179,55,62,4448.62,9225.25,0.00
2024-12-10 17:23:18,118,7178,56,62,4362.49,9225.71,0.00
2024-12-10 17:23:18,118,7179,56,62,4411.98,9226.00,0.00
2024-12-10 17:23:18,119,7179,56,63,4374.90,9226.01,0.00
2024-12-10 17:23:18,118,7179,55,63,4408.09,9226.04,0.00
2024-12-10 17:23:18,117,7179,55,62,4442.62,9226.07,0.00
2024-12-10 17:23:18,116,7179,54,62,4475.90,9226.12,0.00
2024-12-10 17:23:18,117,7178,55,62,4410.45,9226.43,0.00
2024-12-10 17:23:18,118,7177,55,63,4408.48,9226.66,0.00
2024-12-10 17:23:18,118,7178,55,63,4539.14,9227.00,0.00
2024-12-10 17:23:18,119,7178,56,63,4501.00,9227.01,0.00
2024-12-10 17:23:18,118,7178,56,62,4481.61,9227.62,0.00
2024-12-10 17:23:18,119,7177,56,63,4429.09,9227.75,0.00
2024-12-10 17:23:18,119,7178,56,63,4626.03,9228.00,0.00
2024-12-10 17:23:18,120,7178,57,63,4587.48,9228.01,0.00
2024-12-10 17:23:18,119,7178,57,62,4617.94,9228.08,0.00
2024-12-10 17:23:18,119,7179,57,62,4646.44,9229.00,0.00
2024-12-10 17:23:18,120,7179,57,63,4607.72,9229.01,0.00
2024-12-10 17:23:18,121,7178,58,63,4567.36,9229.05,0.00
2024-12-10 17:23:18,120,7178,58,62,4632.49,9229.09,0.00
2024-12-10 17:23:18,119,7178,57,62,4669.87,9229.11,0.00
2024-12-10 17:23:18,118,7178,57,61,4613.11,9229.84,0.00
2024-12-10 17:23:18,118,7179,57,61,4666.80,9230.00,0.00
2024-12-10 17:23:18,119,7179,57,62,4627.58,9230.01,0.00
2024-12-10 17:23:18,120,7178,58,62,4505.25,9230.79,0.00
2024-12-10 17:23:18,120,7179,58,62,4666.39,9231.00,0.00
2024-12-10 17:23:18,121,7179,59,62,4627.82,9231.01,0.00
2024-12-10 17:23:18,120,7179,58,62,4657.97,9231.09,0.00
2024-12-10 17:23:18,120,7180,58,62,4662.98,9232.00,0.00
2024-12-10 17:23:18,121,7180,58,63,4624.44,9232.01,0.00
2024-12-10 17:23:18,121,7181,58,63,4536.06,9233.00,0.00
2024-12-10 17:23:18,122,7181,59,63,4498.88,9233.01,0.00
2024-12-10 17:23:18,121,7181,58,63,4524.10,9233.13,0.00
2024-12-10 17:23:18,122,7180,58,64,4479.58,9233.20,0.00
2024-12-10 17:23:18,121,7180,58,63,4437.07,9233.79,0.00
2024-12-10 17:23:18,121,7181,58,63,4453.04,9234.00,0.00
2024-12-10 17:23:18,122,7181,58,64,4416.54,9234.01,0.00
2024-12-10 17:23:18,123,7180,58,65,4367.92,9234.16,0.00
2024-12-10 17:23:18,122,7180,57,65,4360.86,9234.81,0.00
2024-12-10 17:23:18,123,7179,58,65,4316.24,9234.84,0.00
2024-12-10 17:23:18,123,7180,58,65,4440.45,9235.00,0.00
2024-12-10 17:23:18,124,7180,58,66,4404.64,9235.01,0.00
2024-12-10 17:23:18,123,7180,58,65,4432.23,9235.09,0.00
2024-12-10 17:23:18,122,7180,57,65,4416.50,9235.53,0.00
2024-12-10 17:23:18,122,7181,57,65,4534.86,9236.00,0.00
2024-12-10 17:23:18,123,7181,57,66,4497.99,9236.01,0.00
2024-12-10 17:23:18,122,7181,57,65,4527.24,9236.09,0.00
2024-12-10 17:23:18,121,7181,57,64,4534.33,9236.32,0.00
2024-12-10 17:23:18,120,7181,56,64,4532.72,9236.68,0.00
2024-12-10 17:23:18,119,7181,56,63,4555.34,9236.72,0.00
2024-12-10 17:23:18,120,7180,56,64,4515.85,9236.75,0.00
2024-12-10 17:23:18,120,7181,56,64,4592.29,9237.00,0.00
2024-12-10 17:23:18,121,7181,57,64,4554.34,9237.01,0.00
2024-12-10 17:23:18,120,7181,57,63,4583.86,9237.09,0.00
2024-12-10 17:23:18,119,7181,57,62,4554.81,9237.67,0.00
2024-12-10 17:23:18,118,7181,56,62,4528.23,9237.92,0.00
2024-12-10 17:23:18,118,7182,56,62,4657.79,9238.00,0.00
2024-12-10 17:23:18,119,7182,57,62,4618.65,9238.01,0.00
2024-12-10 17:23:18,118,7182,57,61,4649.22,9238.09,0.00
2024-12-10 17:23:18,117,7182,57,60,4645.40,9238.47,0.00
2024-12-10 17:23:18,118,7181,58,60,4580.13,9238.71,0.00
2024-12-10 17:23:18,118,7181,58,60,4595.35,9239.00,0.00
2024-12-10 17:23:18,119,7181,58,61,4556.74,9239.01,0.00
2024-12-10 17:23:18,120,7180,58,62,4517.23,9239.04,0.00
2024-12-10 17:23:18,121,7179,58,63,4480.80,9239.29,0.00
2024-12-10 17:23:18,121,7180,58,63,4562.91,9240.00,0.00
2024-12-10 17:23:18,122,7180,58,64,4525.51,9240.01,0.00
2024-12-10 17:23:18,121,7180,58,63,4550.29,9240.14,0.00
2024-12-10 17:23:18,120,7180,57,63,4578.64,9240.23,0.00
2024-12-10 17:23:18,119,7180,57,62,4559.17,9240.69,0.00
2024-12-10 17:23:18,118,7180,57,61,4538.38,9240.95,0.00
2024-12-10 17:23:18,118,7181,57,61,4768.65,9241.00,0.00
2024-12-10 17:23:18,119,7181,57,62,4728.58,9241.01,0.00
2024-12-10 17:23:18,119,7182,57,62,4680.30,9242.00,0.00
2024-12-10 17:23:18,120,7182,57,63,4641.29,9242.01,0.00
2024-12-10 17:23:18,119,7182,56,63,4655.54,9242.24,0.00
2024-12-10 17:23:18,118,7182,56,62,4676.70,9242.41,0.00
2024-12-10 17:23:18,117,7182,55,62,4682.53,9242.72,0.00
2024-12-10 17:23:18,117,7183,55,62,4705.12,9243.00,0.00
2024-12-10 17:23:18,118,7183,56,62,4665.24,9243.01,0.00
2024-12-10 17:23:18,117,7183,56,61,4694.89,9243.11,0.00
2024-12-10 17:23:19,116,7183,56,60,4727.11,9243.20,0.00
2024-12-10 17:23:19,115,7183,56,59,4734.29,9243.55,0.00
2024-12-10 17:23:19,115,7184,56,59,4728.95,9244.00,0.00
2024-12-10 17:23:19,116,7184,56,60,4688.18,9244.01,0.00
2024-12-10 17:23:19,115,7184,56,59,4717.75,9244.12,0.00
2024-12-10 17:23:19,114,7184,55,59,4748.60,9244.24,0.00
2024-12-10 17:23:19,113,7184,54,59,4713.23,9244.81,0.00
2024-12-10 17:23:19,113,7185,54,59,4749.48,9245.00,0.00
2024-12-10 17:23:19,114,7185,55,59,4707.82,9245.01,0.00
2024-12-10 17:23:19,113,7185,54,59,4660.33,9245.74,0.00
2024-12-10 17:23:19,113,7186,54,59,4687.90,9246.00,0.00
2024-12-10 17:23:19,114,7186,54,60,4646.78,9246.01,0.00
2024-12-10 17:23:19,113,7186,53,60,4674.49,9246.15,0.00
2024-12-10 17:23:19,112,7186,52,60,4703.95,9246.21,0.00
2024-12-10 17:23:19,111,7186,52,59,4713.36,9246.55,0.00
2024-12-10 17:23:19,111,7187,52,59,4717.04,9247.00,0.00
2024-12-10 17:23:19,112,7187,52,60,4674.92,9247.01,0.00
2024-12-10 17:23:19,112,7188,52,60,4634.27,9248.00,0.00
2024-12-10 17:23:19,113,7188,53,60,4593.26,9248.01,0.00
2024-12-10 17:23:19,114,7187,53,61,4545.70,9248.11,0.00
2024-12-10 17:23:19,113,7187,52,61,4613.78,9248.15,0.00
2024-12-10 17:23:19,114,7186,53,61,4563.47,9248.27,0.00
2024-12-10 17:23:19,114,7187,53,61,4565.21,9249.00,0.00
2024-12-10 17:23:19,115,7187,53,62,4525.51,9249.01,0.00
2024-12-10 17:23:19,114,7187,52,62,4482.91,9249.78,0.00
2024-12-10 17:23:19,113,7187,52,61,4517.97,9249.79,0.00
2024-12-10 17:23:19,113,7188,52,61,4722.90,9250.00,0.00
2024-12-10 17:23:19,114,7188,53,61,4681.47,9250.01,0.00
2024-12-10 17:23:19,113,7188,53,60,4718.21,9250.05,0.00
2024-12-10 17:23:19,112,7188,53,59,4745.41,9250.21,0.00
2024-12-10 17:23:19,111,7188,53,58,4708.55,9250.83,0.00
2024-12-10 17:23:19,111,7189,53,58,4769.76,9251.00,0.00
2024-12-10 17:23:19,112,7189,53,59,4727.18,9251.01,0.00
2024-12-10 17:23:19,111,7189,53,58,4768.77,9251.02,0.00
2024-12-10 17:23:19,112,7188,54,58,4722.08,9251.08,0.00
2024-12-10 17:23:19,111,7188,53,58,4782.64,9251.22,0.00
2024-12-10 17:23:19,110,7188,52,58,4807.29,9251.42,0.00
2024-12-10 17:23:19,111,7187,52,59,4731.67,9251.78,0.00
2024-12-10 17:23:19,111,7188,52,59,4839.59,9252.00,0.00
2024-12-10 17:23:19,112,7188,53,59,4796.38,9252.01,0.00
2024-12-10 17:23:19,111,7188,52,59,4827.15,9252.14,0.00
2024-12-10 17:23:19,111,7189,52,59,4959.76,9253.00,0.00
2024-12-10 17:23:19,112,7189,52,60,4915.48,9253.01,0.00
2024-12-10 17:23:19,113,7188,53,60,4871.98,9253.03,0.00
2024-12-10 17:23:19,112,7188,52,60,4972.49,9253.15,0.00
2024-12-10 17:23:19,111,7188,52,59,5002.24,9253.32,0.00
2024-12-10 17:23:19,110,7188,51,59,5029.70,9253.51,0.00
2024-12-10 17:23:19,110,7189,51,59,5033.40,9254.00,0.00
2024-12-10 17:23:19,111,7189,51,60,4988.05,9254.01,0.00
2024-12-10 17:23:19,110,7189,50,60,5028.37,9254.06,0.00
2024-12-10 17:23:19,110,7190,50,60,5077.29,9255.00,0.00
2024-12-10 17:23:19,111,7190,50,61,5031.55,9255.01,0.00
2024-12-10 17:23:19,112,7189,51,61,4975.13,9255.15,0.00
2024-12-10 17:23:19,112,7190,51,61,5031.21,9256.00,0.00
2024-12-10 17:23:19,113,7190,51,62,4986.68,9256.01,0.00
2024-12-10 17:23:19,114,7189,51,63,4914.64,9256.33,0.00
2024-12-10 17:23:19,113,7189,50,63,4975.60,9256.71,0.00
2024-12-10 17:23:19,113,7190,50,63,5105.77,9257.00,0.00
2024-12-10 17:23:19,114,7190,50,64,5060.98,9257.01,0.00
2024-12-10 17:23:19,113,7190,49,64,5092.74,9257.14,0.00
2024-12-10 17:23:19,114,7189,49,65,5027.01,9257.39,0.00
2024-12-10 17:23:19,114,7190,49,65,5178.50,9258.00,0.00
2024-12-10 17:23:19,115,7190,50,65,5133.47,9258.01,0.00
2024-12-10 17:23:19,114,7190,50,64,5139.07,9258.43,0.00
2024-12-10 17:23:19,114,7191,50,64,5236.15,9259.00,0.00
2024-12-10 17:23:19,115,7191,50,65,5190.62,9259.01,0.00
2024-12-10 17:23:19,114,7191,49,65,5233.56,9259.04,0.00
2024-12-10 17:23:19,113,7191,48,65,5265.28,9259.19,0.00
2024-12-10 17:23:19,114,7190,49,65,5198.79,9259.40,0.00
2024-12-10 17:23:19,114,7191,49,65,5235.85,9260.00,0.00
2024-12-10 17:23:19,115,7191,50,65,5190.32,9260.01,0.00
2024-12-10 17:23:19,114,7191,50,64,5223.74,9260.13,0.00
2024-12-10 17:23:19,114,7192,50,64,5279.82,9261.00,0.00
2024-12-10 17:23:19,115,7192,50,65,5233.91,9261.01,0.00
2024-12-10 17:23:19,114,7192,50,64,5192.69,9261.75,0.00
2024-12-10 17:23:19,114,7193,50,64,5233.73,9262.00,0.00
2024-12-10 17:23:19,115,7193,51,64,5188.22,9262.01,0.00
2024-12-10 17:23:19,116,7192,51,65,5133.37,9262.13,0.00
2024-12-10 17:23:19,116,7193,51,65,5140.39,9263.00,0.00
2024-12-10 17:23:19,117,7193,52,65,5096.45,9263.01,0.00
2024-12-10 17:23:19,118,7192,52,66,5029.11,9263.28,0.00
2024-12-10 17:23:19,117,7192,51,66,5125.02,9263.39,0.00
2024-12-10 17:23:19,116,7192,50,66,5108.89,9263.79,0.00
2024-12-10 17:23:19,116,7193,50,66,5247.82,9264.00,0.00
2024-12-10 17:23:19,117,7193,51,66,5202.96,9264.01,0.00
2024-12-10 17:23:19,116,7193,51,65,5233.52,9264.14,0.00
2024-12-10 17:23:19,116,7194,51,65,5296.40,9265.00,0.00
2024-12-10 17:23:19,117,7194,51,66,5251.13,9265.01,0.00
2024-12-10 17:23:19,117,7195,51,66,5212.00,9266.00,0.00
2024-12-10 17:23:19,118,7195,52,66,5167.83,9266.01,0.00
2024-12-10 17:23:19,117,7195,52,65,5182.74,9266.27,0.00
2024-12-10 17:23:19,117,7196,52,65,5166.62,9267.00,0.00
2024-12-10 17:23:19,118,7196,52,66,5122.84,9267.01,0.00
2024-12-10 17:23:19,117,7196,51,66,5153.17,9267.14,0.00
2024-12-10 17:23:19,117,7197,51,66,5122.54,9268.00,0.00
2024-12-10 17:23:19,118,7197,52,66,5079.13,9268.01,0.00
2024-12-10 17:23:19,117,7197,52,65,5089.20,9268.35,0.00
2024-12-10 17:23:19,117,7198,52,65,5079.61,9269.00,0.00
2024-12-10 17:23:19,118,7198,53,65,5036.56,9269.01,0.00
2024-12-10 17:23:19,117,7198,53,64,5073.31,9269.07,0.00
2024-12-10 17:23:19,116,7198,53,63,5109.90,9269.14,0.00
2024-12-10 17:23:19,115,7198,52,63,5103.84,9269.52,0.00
2024-12-10 17:23:19,115,7199,52,63,5124.89,9270.00,0.00
2024-12-10 17:23:19,116,7199,52,64,5080.71,9270.01,0.00
2024-12-10 17:23:19,115,7199,52,63,5117.68,9270.08,0.00
2024-12-10 17:23:19,114,7199,51,63,5156.92,9270.13,0.00
2024-12-10 17:23:19,113,7199,51,62,5201.73,9270.13,0.00
2024-12-10 17:23:20,113,7200,51,62,5182.31,9271.00,0.00
2024-12-10 17:23:20,114,7200,51,63,5136.85,9271.01,0.00
2024-12-10 17:23:20,113,7200,51,62,5170.08,9271.13,0.00
2024-12-10 17:23:20,112,7200,50,62,5193.45,9271.34,0.00
2024-12-10 17:23:20,112,7201,50,62,5200.02,9272.00,0.00
2024-12-10 17:23:20,113,7201,51,62,5154.01,9272.01,0.00
2024-12-10 17:23:20,112,7201,51,61,5187.33,9272.13,0.00
2024-12-10 17:23:20,111,7201,51,60,5220.89,9272.27,0.00
2024-12-10 17:23:20,111,7202,51,60,5221.86,9273.00,0.00
2024-12-10 17:23:20,112,7202,52,60,5175.23,9273.01,0.00
2024-12-10 17:23:20,111,7202,51,60,5207.85,9273.14,0.00
2024-12-10 17:23:20,110,7202,50,60,5250.60,9273.18,0.00
2024-12-10 17:23:20,109,7202,49,60,5277.02,9273.39,0.00
2024-12-10 17:23:20,110,7201,49,61,5202.81,9273.59,0.00
2024-12-10 17:23:20,110,7202,49,61,5267.40,9274.00,0.00
2024-12-10 17:23:20,111,7202,49,62,5219.94,9274.01,0.00
2024-12-10 17:23:20,110,7202,49,61,5252.00,9274.14,0.00
2024-12-10 17:23:20,109,7202,49,60,5291.12,9274.19,0.00
2024-12-10 17:23:20,108,7202,48,60,5329.28,9274.31,0.00
2024-12-10 17:23:20,109,7201,48,61,5243.71,9274.59,0.00
2024-12-10 17:23:20,108,7201,48,60,5299.63,9274.72,0.00
2024-12-10 17:23:20,108,7202,48,60,5443.86,9275.00,0.00
2024-12-10 17:23:20,109,7202,48,61,5393.92,9275.01,0.00
2024-12-10 17:23:20,108,7202,48,60,5440.13,9275.04,0.00
2024-12-10 17:23:20,107,7202,48,59,5481.49,9275.13,0.00
2024-12-10 17:23:20,106,7202,48,58,5519.09,9275.23,0.00
2024-12-10 17:23:20,107,7201,48,59,5425.76,9275.56,0.00
2024-12-10 17:23:20,107,7202,48,59,5580.89,9276.00,0.00
2024-12-10 17:23:20,108,7202,49,59,5529.21,9276.01,0.00
2024-12-10 17:23:20,107,7202,48,59,5568.83,9276.13,0.00
2024-12-10 17:23:20,108,7201,48,60,5470.24,9276.52,0.00
2024-12-10 17:23:20,109,7200,49,60,5475.04,9276.53,0.00
2024-12-10 17:23:20,109,7201,49,60,5625.27,9277.00,0.00
2024-12-10 17:23:20,110,7201,49,61,5574.13,9277.01,0.00
2024-12-10 17:23:20,109,7201,48,61,5613.43,9277.13,0.00
2024-12-10 17:23:20,108,7201,47,61,5629.34,9277.40,0.00
2024-12-10 17:23:20,108,7202,47,61,5795.73,9278.00,0.00
2024-12-10 17:23:20,109,7202,47,62,5742.56,9278.01,0.00
2024-12-10 17:23:20,108,7202,47,61,5784.48,9278.13,0.00
2024-12-10 17:23:20,107,7202,46,61,5829.77,9278.15,0.00
2024-12-10 17:23:20,106,7202,45,61,5883.33,9278.16,0.00
2024-12-10 17:23:20,106,7203,45,61,5850.74,9279.00,0.00
2024-12-10 17:23:20,107,7203,46,61,5796.06,9279.01,0.00
2024-12-10 17:23:20,107,7204,46,61,5736.54,9280.00,0.00
2024-12-10 17:23:20,108,7204,47,61,5683.42,9280.01,0.00
2024-12-10 17:23:20,108,7205,47,61,5621.15,9281.00,0.00
2024-12-10 17:23:20,109,7205,47,62,5569.58,9281.01,0.00
2024-12-10 17:23:20,110,7204,47,63,5514.75,9281.07,0.00
2024-12-10 17:23:20,111,7203,48,63,5495.66,9281.39,0.00
2024-12-10 17:23:20,110,7203,48,62,5582.27,9281.41,0.00
2024-12-10 17:23:20,111,7202,49,62,5504.78,9281.51,0.00
2024-12-10 17:23:20,111,7203,49,62,5527.51,9282.00,0.00
2024-12-10 17:23:20,112,7203,49,63,5478.16,9282.01,0.00
2024-12-10 17:23:20,111,7203,49,62,5498.40,9282.23,0.00
2024-12-10 17:23:20,112,7202,50,62,5377.90,9282.67,0.00
2024-12-10 17:23:20,112,7203,50,62,5692.14,9283.00,0.00
2024-12-10 17:23:20,113,7203,51,62,5641.77,9283.01,0.00
2024-12-10 17:23:20,112,7203,50,62,5676.24,9283.13,0.00
2024-12-10 17:23:20,111,7203,50,61,5715.29,9283.26,0.00
2024-12-10 17:23:20,110,7203,50,60,5722.48,9283.49,0.00
2024-12-10 17:23:20,109,7203,50,59,5764.79,9283.54,0.00
2024-12-10 17:23:20,109,7204,50,59,5883.90,9284.00,0.00
2024-12-10 17:23:20,110,7204,51,59,5830.41,9284.01,0.00
2024-12-10 17:23:20,110,7205,51,59,5785.98,9285.00,0.00
2024-12-10 17:23:20,111,7205,52,59,5733.86,9285.01,0.00
2024-12-10 17:23:20,111,7206,52,59,5686.79,9286.00,0.00
2024-12-10 17:23:20,112,7206,53,59,5636.02,9286.01,0.00
2024-12-10 17:23:20,111,7206,52,59,5671.22,9286.14,0.00
2024-12-10 17:23:20,111,7207,52,59,5638.12,9287.00,0.00
2024-12-10 17:23:20,112,7207,53,59,5587.78,9287.01,0.00
2024-12-10 17:23:20,112,7208,53,59,5536.06,9288.00,0.00
2024-12-10 17:23:20,113,7208,54,59,5487.07,9288.01,0.00
2024-12-10 17:23:20,112,7208,54,58,5514.20,9288.18,0.00
2024-12-10 17:23:20,111,7208,54,57,5541.37,9288.38,0.00
2024-12-10 17:23:20,110,7208,53,57,5590.85,9288.39,0.00
2024-12-10 17:23:20,110,7209,53,57,5593.09,9289.00,0.00
2024-12-10 17:23:20,111,7209,54,57,5542.70,9289.01,0.00
2024-12-10 17:23:20,110,7209,54,56,5543.52,9289.40,0.00
2024-12-10 17:23:20,111,7208,54,57,5441.80,9289.83,0.00
2024-12-10 17:23:20,111,7209,54,57,5546.24,9290.00,0.00
2024-12-10 17:23:20,112,7209,54,58,5496.72,9290.01,0.00
2024-12-10 17:23:20,111,7209,54,57,5484.98,9290.46,0.00
2024-12-10 17:23:20,111,7210,54,57,5589.13,9291.00,0.00
2024-12-10 17:23:20,112,7210,55,57,5539.23,9291.01,0.00
2024-12-10 17:23:20,112,7211,55,57,5499.90,9292.00,0.00
2024-12-10 17:23:20,113,7211,56,57,5451.23,9292.01,0.00
2024-12-10 17:23:20,114,7210,56,58,5401.79,9292.04,0.00
2024-12-10 17:23:20,113,7210,56,57,5488.67,9292.12,0.00
2024-12-10 17:23:20,113,7211,56,57,5465.73,9293.00,0.00
2024-12-10 17:23:20,114,7211,56,58,5417.79,9293.01,0.00
2024-12-10 17:23:20,113,7211,55,58,5433.59,9293.32,0.00
2024-12-10 17:23:20,112,7211,54,58,5414.35,9293.80,0.00
2024-12-10 17:23:20,112,7212,54,58,5560.92,9294.00,0.00
2024-12-10 17:23:20,113,7212,55,58,5511.71,9294.01,0.00
2024-12-10 17:23:20,114,7211,55,59,5394.59,9294.50,0.00
2024-12-10 17:23:20,114,7212,55,59,5456.31,9295.00,0.00
2024-12-10 17:23:20,115,7212,56,59,5408.86,9295.01,0.00
2024-12-10 17:23:20,114,7212,55,59,5439.80,9295.19,0.00
2024-12-10 17:23:20,115,7211,56,59,5377.09,9295.31,0.00
2024-12-10 17:23:20,114,7211,55,59,5465.48,9295.41,0.00
2024-12-10 17:23:20,114,7212,55,59,5560.85,9296.00,0.00
2024-12-10 17:23:20,115,7212,55,60,5512.50,9296.01,0.00
2024-12-10 17:23:20,116,7211,56,60,5449.82,9296.18,0.00
2024-12-10 17:23:20,116,7212,56,60,5562.79,9297.00,0.00
2024-12-10 17:23:20,117,7212,57,60,5515.24,9297.01,0.00
2024-12-10 17:23:20,116,7212,56,60,5535.50,9297.23,0.00
2024-12-10 17:23:20,115,7212,55,60,5568.17,9297.32,0.00
2024-12-10 17:23:21,115,7213,55,60,5647.87,9298.00,0.00
2024-12-10 17:23:21,116,7213,55,61,5599.18,9298.01,0.00
2024-12-10 17:23:21,115,7213,55,60,5602.09,9298.38,0.00
2024-12-10 17:23:21,115,7214,55,60,5614.76,9299.00,0.00
2024-12-10 17:23:21,116,7214,55,61,5566.36,9299.01,0.00
2024-12-10 17:23:21,115,7214,55,60,5607.30,9299.08,0.00
2024-12-10 17:23:21,116,7213,55,61,5530.63,9299.37,0.00
2024-12-10 17:23:21,116,7214,55,61,5613.38,9300.00,0.00
2024-12-10 17:23:21,117,7214,55,62,5565.41,9300.01,0.00
2024-12-10 17:23:21,117,7215,55,62,5612.53,9301.00,0.00
2024-12-10 17:23:21,118,7215,55,63,5564.97,9301.01,0.00
2024-12-10 17:23:21,117,7215,55,62,5599.08,9301.15,0.00
2024-12-10 17:23:21,116,7215,54,62,5644.21,9301.17,0.00
2024-12-10 17:23:21,116,7216,54,62,5624.52,9302.00,0.00
2024-12-10 17:23:21,117,7216,54,63,5576.45,9302.01,0.00
2024-12-10 17:23:21,116,7216,54,62,5602.94,9302.19,0.00
2024-12-10 17:23:21,117,7215,54,63,5530.28,9302.39,0.00
2024-12-10 17:23:21,116,7215,54,62,5612.01,9302.53,0.00
2024-12-10 17:23:21,116,7216,54,62,5640.74,9303.00,0.00
2024-12-10 17:23:21,117,7216,55,62,5592.52,9303.01,0.00
2024-12-10 17:23:21,117,7217,55,62,5634.41,9304.00,0.00
2024-12-10 17:23:21,118,7217,55,63,5586.66,9304.01,0.00
2024-12-10 17:23:21,117,7217,54,63,5618.82,9304.17,0.00
2024-12-10 17:23:21,117,7218,54,63,5595.17,9305.00,0.00
2024-12-10 17:23:21,118,7218,55,63,5547.75,9305.01,0.00
2024-12-10 17:23:21,119,7217,56,63,5426.06,9305.62,0.00
2024-12-10 17:23:21,119,7218,56,63,5483.51,9306.00,0.00
2024-12-10 17:23:21,120,7218,57,63,5437.82,9306.01,0.00
2024-12-10 17:23:21,121,7217,58,63,5345.29,9306.36,0.00
2024-12-10 17:23:21,121,7218,58,63,5442.64,9307.00,0.00
2024-12-10 17:23:21,122,7218,59,63,5398.02,9307.01,0.00
2024-12-10 17:23:21,121,7218,59,62,5428.86,9307.15,0.00
2024-12-10 17:23:21,120,7218,59,61,5472.88,9307.16,0.00
2024-12-10 17:23:21,119,7218,58,61,5518.70,9307.16,0.00
2024-12-10 17:23:21,119,7219,58,61,5545.60,9308.00,0.00
2024-12-10 17:23:21,120,7219,59,61,5499.39,9308.01,0.00
2024-12-10 17:23:21,119,7219,59,60,5522.86,9308.24,0.00
2024-12-10 17:23:21,118,7219,58,60,5568.15,9308.24,0.00
2024-12-10 17:23:21,117,7219,57,60,5600.52,9308.28,0.00
2024-12-10 17:23:21,116,7219,57,59,5600.00,9308.60,0.00
2024-12-10 17:23:21,116,7220,57,59,5626.33,9309.00,0.00
2024-12-10 17:23:21,117,7220,58,59,5578.24,9309.01,0.00
2024-12-10 17:23:21,118,7219,59,59,5512.80,9309.20,0.00
2024-12-10 17:23:21,118,7220,59,59,5543.38,9310.00,0.00
2024-12-10 17:23:21,119,7220,60,59,5496.79,9310.01,0.00
2024-12-10 17:23:21,118,7220,60,58,5424.98,9310.88,0.00
2024-12-10 17:23:21,118,7221,60,58,5559.06,9311.00,0.00
2024-12-10 17:23:21,119,7221,60,59,5512.35,9311.01,0.00
2024-12-10 17:23:21,118,7221,60,58,5530.80,9311.26,0.00
2024-12-10 17:23:21,117,7221,60,57,5576.12,9311.27,0.00
2024-12-10 17:23:21,117,7222,60,57,5555.70,9312.00,0.00
2024-12-10 17:23:21,118,7222,60,58,5508.61,9312.01,0.00
2024-12-10 17:23:21,117,7222,59,58,5539.80,9312.18,0.00
2024-12-10 17:23:21,116,7222,58,58,5578.73,9312.27,0.00
2024-12-10 17:23:21,115,7222,58,57,5594.34,9312.44,0.00
2024-12-10 17:23:21,115,7223,58,57,5610.70,9313.00,0.00
2024-12-10 17:23:21,116,7223,58,58,5562.33,9313.01,0.00
2024-12-10 17:23:21,115,7223,58,57,5583.94,9313.28,0.00
2024-12-10 17:23:21,116,7222,58,58,5523.82,9313.42,0.00
2024-12-10 17:23:21,116,7223,58,58,5579.07,9314.00,0.00
2024-12-10 17:23:21,117,7223,59,58,5531.39,9314.01,0.00
2024-12-10 17:23:21,116,7223,58,58,5489.20,9314.92,0.00
2024-12-10 17:23:21,116,7224,58,58,5642.63,9315.00,0.00
2024-12-10 17:23:21,117,7224,59,58,5594.40,9315.01,0.00
2024-12-10 17:23:21,117,7225,59,58,5578.38,9316.00,0.00
2024-12-10 17:23:21,118,7225,59,59,5531.11,9316.01,0.00
2024-12-10 17:23:21,119,7224,59,60,5420.77,9316.71,0.00
2024-12-10 17:23:21,119,7225,59,60,5504.82,9317.00,0.00
2024-12-10 17:23:21,120,7225,59,61,5458.95,9317.01,0.00
2024-12-10 17:23:21,121,7224,59,62,5367.08,9317.53,0.00
2024-12-10 17:23:21,121,7225,59,62,5502.73,9318.00,0.00
2024-12-10 17:23:21,122,7225,59,63,5457.63,9318.01,0.00
2024-12-10 17:23:21,122,7226,59,63,5510.85,9319.00,0.00
2024-12-10 17:23:21,123,7226,59,64,5466.05,9319.01,0.00
2024-12-10 17:23:21,123,7227,59,64,5438.48,9320.00,0.00
2024-12-10 17:23:21,124,7227,59,65,5394.63,9320.01,0.00
2024-12-10 17:23:21,123,7227,58,65,5423.72,9320.16,0.00
2024-12-10 17:23:21,123,7228,58,65,5408.49,9321.00,0.00
2024-12-10 17:23:21,124,7228,59,65,5364.88,9321.01,0.00
2024-12-10 17:23:21,123,7228,59,64,5393.18,9321.17,0.00
2024-12-10 17:23:21,122,7228,59,63,5432.68,9321.19,0.00
2024-12-10 17:23:21,123,7227,59,64,5340.88,9321.67,0.00
2024-12-10 17:23:21,123,7228,59,64,5393.50,9322.00,0.00
2024-12-10 17:23:21,124,7228,59,65,5350.01,9322.01,0.00
2024-12-10 17:23:21,125,7227,59,66,5296.05,9322.14,0.00
2024-12-10 17:23:21,125,7228,59,66,5393.15,9323.00,0.00
2024-12-10 17:23:21,126,7228,59,67,5350.35,9323.01,0.00
2024-12-10 17:23:21,125,7228,59,66,5379.03,9323.15,0.00
2024-12-10 17:23:22,125,7229,59,66,5432.09,9324.00,0.00
2024-12-10 17:23:22,126,7229,59,67,5388.98,9324.01,0.00
2024-12-10 17:23:22,127,7228,59,68,5283.02,9324.64,0.00
2024-12-10 17:23:22,127,7229,59,68,5321.42,9325.00,0.00
2024-12-10 17:23:22,128,7229,59,69,5279.85,9325.01,0.00
2024-12-10 17:23:22,127,7229,58,69,5311.11,9325.12,0.00
2024-12-10 17:23:22,127,7230,58,69,5355.76,9326.00,0.00
2024-12-10 17:23:22,128,7230,59,69,5313.92,9326.01,0.00
2024-12-10 17:23:22,127,7230,59,68,5346.24,9326.10,0.00
2024-12-10 17:23:22,127,7231,59,68,5311.86,9327.00,0.00
2024-12-10 17:23:22,128,7231,60,68,5270.36,9327.01,0.00
2024-12-10 17:23:22,129,7230,60,69,5183.69,9327.44,0.00
2024-12-10 17:23:22,128,7230,59,69,5247.38,9327.55,0.00
2024-12-10 17:23:22,128,7231,59,69,5263.90,9328.00,0.00
2024-12-10 17:23:22,129,7231,60,69,5223.09,9328.01,0.00
2024-12-10 17:23:22,129,7232,60,69,5254.39,9329.00,0.00
2024-12-10 17:23:22,130,7232,61,69,5213.97,9329.01,0.00
2024-12-10 17:23:22,130,7233,61,69,5177.34,9330.00,0.00
2024-12-10 17:23:22,131,7233,61,70,5137.82,9330.01,0.00
2024-12-10 17:23:22,131,7234,61,70,5103.07,9331.00,0.00
2024-12-10 17:23:22,132,7234,62,70,5064.42,9331.01,0.00
2024-12-10 17:23:22,132,7235,62,70,5029.43,9332.00,0.00
2024-12-10 17:23:22,133,7235,63,70,4991.61,9332.01,0.00
2024-12-10 17:23:22,132,7235,62,70,5023.87,9332.06,0.00
2024-12-10 17:23:22,131,7235,62,69,5042.98,9332.27,0.00
2024-12-10 17:23:22,131,7236,62,69,5034.49,9333.00,0.00
2024-12-10 17:23:22,132,7236,63,69,4996.35,9333.01,0.00
2024-12-10 17:23:22,131,7236,63,68,4949.24,9333.84,0.00
2024-12-10 17:23:22,131,7237,63,68,5005.67,9334.00,0.00
2024-12-10 17:23:22,132,7237,63,69,4967.74,9334.01,0.00
2024-12-10 17:23:22,131,7237,63,68,5000.69,9334.05,0.00
2024-12-10 17:23:22,130,7237,63,67,5030.58,9334.14,0.00
2024-12-10 17:23:22,130,7238,63,67,5014.54,9335.00,0.00
2024-12-10 17:23:22,131,7238,63,68,4976.26,9335.01,0.00
2024-12-10 17:23:22,131,7239,63,68,4948.00,9336.00,0.00
2024-12-10 17:23:22,132,7239,63,69,4910.52,9336.01,0.00
2024-12-10 17:23:22,133,7238,64,69,4864.50,9336.12,0.00
2024-12-10 17:23:22,132,7238,64,68,4924.70,9336.55,0.00
2024-12-10 17:23:22,132,7239,64,68,4954.03,9337.00,0.00
2024-12-10 17:23:22,133,7239,65,68,4916.78,9337.01,0.00
2024-12-10 17:23:22,133,7240,65,68,4963.01,9338.00,0.00
2024-12-10 17:23:22,134,7240,65,69,4925.98,9338.01,0.00
2024-12-10 17:23:22,134,7241,65,69,4902.22,9339.00,0.00
2024-12-10 17:23:22,135,7241,65,70,4865.91,9339.01,0.00
2024-12-10 17:23:22,134,7241,65,69,4900.83,9339.02,0.00
2024-12-10 17:23:22,133,7241,65,68,4932.78,9339.06,0.00
2024-12-10 17:23:22,132,7241,65,67,4961.13,9339.14,0.00
2024-12-10 17:23:22,132,7242,65,67,4950.50,9340.00,0.00
2024-12-10 17:23:22,133,7242,66,67,4913.27,9340.01,0.00
2024-12-10 17:23:22,133,7243,66,67,4887.68,9341.00,0.00
2024-12-10 17:23:22,134,7243,66,68,4851.21,9341.01,0.00
2024-12-10 17:23:22,134,7244,66,68,4821.43,9342.00,0.00
2024-12-10 17:23:22,135,7244,67,68,4785.72,9342.01,0.00
2024-12-10 17:23:22,135,7245,67,68,4751.67,9343.00,0.00
2024-12-10 17:23:22,136,7245,67,69,4716.73,9343.01,0.00
2024-12-10 17:23:22,136,7246,67,69,4676.94,9344.00,0.00
2024-12-10 17:23:22,137,7246,67,70,4642.80,9344.01,0.00
2024-12-10 17:23:22,137,7247,67,70,4599.42,9345.00,0.00
2024-12-10 17:23:22,138,7247,67,71,4566.09,9345.01,0.00
2024-12-10 17:23:22,138,7248,67,71,4521.18,9346.00,0.00
2024-12-10 17:23:22,139,7248,67,72,4488.66,9346.01,0.00
2024-12-10 17:23:22,139,7249,67,72,4443.81,9347.00,0.00
2024-12-10 17:23:22,140,7249,68,72,4412.07,9347.01,0.00
2024-12-10 17:23:22,141,7248,69,72,4372.19,9347.11,0.00
2024-12-10 17:23:22,140,7248,69,71,4433.28,9347.21,0.00
2024-12-10 17:23:22,139,7248,69,70,4396.54,9347.81,0.00
2024-12-10 17:23:22,139,7249,69,70,4445.79,9348.00,0.00
2024-12-10 17:23:22,140,7249,70,70,4414.04,9348.01,0.00
2024-12-10 17:23:22,139,7249,69,70,4443.11,9348.03,0.00
2024-12-10 17:23:22,138,7249,69,69,4460.77,9348.12,0.00
2024-12-10 17:23:22,137,7249,68,69,4481.78,9348.24,0.00
2024-12-10 17:23:22,137,7250,68,69,4545.56,9349.00,0.00
2024-12-10 17:23:22,138,7250,69,69,4512.63,9349.01,0.00
2024-12-10 17:23:22,137,7250,69,68,4535.60,9349.10,0.00
2024-12-10 17:23:22,136,7250,68,68,4567.02,9349.12,0.00
2024-12-10 17:23:22,137,7249,68,69,4522.78,9349.25,0.00
2024-12-10 17:23:22,137,7250,68,69,4575.11,9350.00,0.00
2024-12-10 17:23:22,138,7250,69,69,4541.96,9350.01,0.00
2024-12-10 17:23:22,138,7251,69,69,4579.65,9351.00,0.00
2024-12-10 17:23:22,139,7251,69,70,4546.70,9351.01,0.00
2024-12-10 17:23:22,138,7251,68,70,4577.62,9351.02,0.00
2024-12-10 17:23:22,137,7251,67,70,4602.19,9351.11,0.00
2024-12-10 17:23:22,137,7252,67,70,4579.54,9352.00,0.00
2024-12-10 17:23:22,138,7252,67,71,4546.36,9352.01,0.00
2024-12-10 17:23:23,137,7252,66,71,4569.34,9352.11,0.00
2024-12-10 17:23:23,136,7252,66,70,4578.08,9352.32,0.00
2024-12-10 17:23:23,136,7253,66,70,4578.66,9353.00,0.00
2024-12-10 17:23:23,137,7253,67,70,4545.24,9353.01,0.00
2024-12-10 17:23:23,136,7253,66,70,4577.97,9353.01,0.00
2024-12-10 17:23:23,135,7253,65,70,4596.06,9353.11,0.00
2024-12-10 17:23:23,136,7252,65,71,4516.01,9353.55,0.00
2024-12-10 17:23:23,136,7253,65,71,4575.75,9354.00,0.00
2024-12-10 17:23:23,137,7253,66,71,4542.35,9354.01,0.00
2024-12-10 17:23:23,136,7253,66,70,4559.00,9354.11,0.00
2024-12-10 17:23:23,135,7253,66,69,4580.79,9354.23,0.00
2024-12-10 17:23:23,135,7254,66,69,4638.10,9355.00,0.00
2024-12-10 17:23:23,136,7254,66,70,4603.99,9355.01,0.00
2024-12-10 17:23:23,135,7254,65,70,4635.33,9355.03,0.00
2024-12-10 17:23:23,134,7254,65,69,4654.30,9355.10,0.00
2024-12-10 17:23:23,133,7254,64,69,4688.59,9355.11,0.00
2024-12-10 17:23:23,132,7254,63,69,4687.98,9355.45,0.00
2024-12-10 17:23:23,132,7255,63,69,4705.07,9356.00,0.00
2024-12-10 17:23:23,133,7255,63,70,4669.70,9356.01,0.00
2024-12-10 17:23:23,132,7255,63,69,4692.35,9356.10,0.00
2024-12-10 17:23:23,131,7255,63,68,4727.45,9356.10,0.00
2024-12-10 17:23:23,131,7256,63,68,4709.41,9357.00,0.00
2024-12-10 17:23:23,132,7256,63,69,4673.73,9357.01,0.00
2024-12-10 17:23:23,131,7256,63,68,4705.84,9357.04,0.00
2024-12-10 17:23:23,130,7256,63,67,4736.31,9357.09,0.00
2024-12-10 17:23:23,130,7257,63,67,4715.45,9358.00,0.00
2024-12-10 17:23:23,131,7257,63,68,4679.46,9358.01,0.00
2024-12-10 17:23:23,130,7257,62,68,4706.85,9358.09,0.00
2024-12-10 17:23:23,129,7257,62,67,4700.05,9358.49,0.00
2024-12-10 17:23:23,129,7258,62,67,4721.97,9359.00,0.00
2024-12-10 17:23:23,130,7258,63,67,4685.65,9359.01,0.00
2024-12-10 17:23:23,129,7258,63,66,4713.30,9359.09,0.00
2024-12-10 17:23:23,128,7258,62,66,4749.39,9359.09,0.00
2024-12-10 17:23:23,129,7257,62,67,4629.60,9359.91,0.00
2024-12-10 17:23:23,129,7258,62,67,4700.79,9360.00,0.00
2024-12-10 17:23:23,130,7258,63,67,4664.63,9360.01,0.00
2024-12-10 17:23:23,129,7258,62,67,4692.12,9360.09,0.00
2024-12-10 17:23:23,129,7259,62,67,4742.13,9361.00,0.00
2024-12-10 17:23:23,130,7259,63,67,4705.66,9361.01,0.00
2024-12-10 17:23:23,129,7259,62,67,4709.79,9361.30,0.00
2024-12-10 17:23:23,130,7258,63,67,4659.92,9361.45,0.00
2024-12-10 17:23:23,130,7259,63,67,4718.16,9362.00,0.00
2024-12-10 17:23:23,131,7259,63,68,4682.15,9362.01,0.00
2024-12-10 17:23:23,130,7259,63,67,4716.01,9362.02,0.00
2024-12-10 17:23:23,129,7259,62,67,4745.34,9362.09,0.00
2024-12-10 17:23:23,130,7258,62,68,4702.36,9362.18,0.00
2024-12-10 17:23:23,130,7259,62,68,4805.39,9363.00,0.00
2024-12-10 17:23:23,131,7259,63,68,4768.71,9363.01,0.00
2024-12-10 17:23:23,130,7259,62,68,4803.23,9363.02,0.00
2024-12-10 17:23:23,130,7260,62,68,4848.38,9364.00,0.00
2024-12-10 17:23:23,131,7260,63,68,4811.37,9364.01,0.00
2024-12-10 17:23:23,130,7260,62,68,4840.49,9364.09,0.00
2024-12-10 17:23:23,129,7260,62,67,4820.80,9364.64,0.00
2024-12-10 17:23:23,129,7261,62,67,4857.08,9365.00,0.00
2024-12-10 17:23:23,130,7261,62,68,4819.72,9365.01,0.00
2024-12-10 17:23:23,130,7262,62,68,4793.25,9366.00,0.00
2024-12-10 17:23:23,131,7262,62,69,4756.66,9366.01,0.00
2024-12-10 17:23:23,130,7262,61,69,4784.64,9366.09,0.00
2024-12-10 17:23:23,130,7263,61,69,4765.69,9367.00,0.00
2024-12-10 17:23:23,131,7263,61,70,4729.31,9367.01,0.00
2024-12-10 17:23:23,130,7263,61,69,4757.08,9367.09,0.00
2024-12-10 17:23:23,130,7264,61,69,4737.58,9368.00,0.00
2024-12-10 17:23:23,131,7264,61,70,4701.42,9368.01,0.00
2024-12-10 17:23:23,130,7264,60,70,4728.97,9368.09,0.00
2024-12-10 17:23:23,129,7264,59,70,4764.02,9368.11,0.00
2024-12-10 17:23:23,129,7265,59,70,4745.95,9369.00,0.00
2024-12-10 17:23:23,130,7265,60,70,4709.44,9369.01,0.00
2024-12-10 17:23:23,129,7265,59,70,4737.27,9369.09,0.00
2024-12-10 17:23:23,129,7266,59,70,4717.15,9370.00,0.00
2024-12-10 17:23:23,130,7266,59,71,4680.86,9370.01,0.00
2024-12-10 17:23:23,129,7266,59,70,4669.96,9370.47,0.00
2024-12-10 17:23:23,129,7267,59,70,4691.18,9371.00,0.00
2024-12-10 17:23:23,130,7267,60,70,4655.10,9371.01,0.00
2024-12-10 17:23:23,129,7267,60,69,4682.50,9371.09,0.00
2024-12-10 17:23:23,130,7266,60,70,4638.56,9371.19,0.00
2024-12-10 17:23:23,130,7267,60,70,4696.00,9372.00,0.00
2024-12-10 17:23:23,131,7267,61,70,4660.15,9372.01,0.00
2024-12-10 17:23:23,130,7267,61,69,4640.19,9372.60,0.00
2024-12-10 17:23:23,130,7268,61,69,4744.32,9373.00,0.00
2024-12-10 17:23:23,131,7268,61,70,4708.10,9373.01,0.00
2024-12-10 17:23:23,130,7268,60,70,4738.57,9373.06,0.00
2024-12-10 17:23:23,129,7268,59,70,4772.41,9373.09,0.00
2024-12-10 17:23:23,129,7269,59,70,4756.91,9374.00,0.00
2024-12-10 17:23:23,130,7269,60,70,4720.32,9374.01,0.00
2024-12-10 17:23:23,129,7269,59,70,4738.81,9374.19,0.00
2024-12-10 17:23:23,129,7270,59,70,4734.92,9375.00,0.00
2024-12-10 17:23:23,130,7270,60,70,4698.50,9375.01,0.00
2024-12-10 17:23:23,129,7270,60,69,4724.06,9375.11,0.00
2024-12-10 17:23:23,129,7271,60,69,4711.73,9376.00,0.00
2024-12-10 17:23:23,130,7271,61,69,4675.48,9376.01,0.00
2024-12-10 17:23:23,129,7271,60,69,4700.60,9376.11,0.00
2024-12-10 17:23:23,130,7270,60,70,4631.76,9376.47,0.00
2024-12-10 17:23:23,130,7271,60,70,4694.02,9377.00,0.00
2024-12-10 17:23:23,131,7271,61,70,4658.18,9377.01,0.00
2024-12-10 17:23:23,130,7271,61,69,4682.81,9377.11,0.00
2024-12-10 17:23:24,130,7272,61,69,4737.84,9378.00,0.00
2024-12-10 17:23:24,131,7272,62,69,4701.67,9378.01,0.00
2024-12-10 17:23:24,130,7272,62,68,4726.32,9378.11,0.00
2024-12-10 17:23:24,129,7272,62,67,4760.98,9378.12,0.00
2024-12-10 17:23:24,129,7273,62,67,4743.32,9379.00,0.00
2024-12-10 17:23:24,130,7273,62,68,4706.83,9379.01,0.00
2024-12-10 17:23:24,129,7273,61,68,4731.60,9379.11,0.00
2024-12-10 17:23:24,129,7274,61,68,4708.19,9380.00,0.00
2024-12-10 17:23:24,130,7274,61,69,4671.97,9380.01,0.00
2024-12-10 17:23:24,129,7274,61,68,4700.01,9380.09,0.00
2024-12-10 17:23:24,128,7274,60,68,4734.84,9380.10,0.00
2024-12-10 17:23:24,128,7275,60,68,4706.20,9381.00,0.00
2024-12-10 17:23:24,129,7275,61,68,4669.72,9381.01,0.00
2024-12-10 17:23:24,128,7275,60,68,4704.73,9381.02,0.00
2024-12-10 17:23:24,127,7275,60,67,4737.36,9381.06,0.00
2024-12-10 17:23:24,126,7275,59,67,4769.94,9381.10,0.00
2024-12-10 17:23:24,125,7275,58,67,4807.35,9381.10,0.00
2024-12-10 17:23:24,125,7276,58,67,4775.24,9382.00,0.00
2024-12-10 17:23:24,126,7276,58,68,4737.34,9382.01,0.00
2024-12-10 17:23:24,125,7276,58,67,4765.48,9382.10,0.00
2024-12-10 17:23:24,125,7277,58,67,4732.42,9383.00,0.00
2024-12-10 17:23:24,126,7277,59,67,4694.86,9383.01,0.00
2024-12-10 17:23:24,127,7276,59,68,4634.20,9383.27,0.00
2024-12-10 17:23:24,126,7276,59,67,4675.04,9383.44,0.00
2024-12-10 17:23:24,125,7276,58,67,4696.33,9383.54,0.00
2024-12-10 17:23:24,125,7277,58,67,4713.54,9384.00,0.00
2024-12-10 17:23:24,126,7277,58,68,4676.13,9384.01,0.00
2024-12-10 17:23:24,127,7276,58,69,4547.78,9384.81,0.00
2024-12-10 17:23:24,127,7277,58,69,4693.51,9385.00,0.00
2024-12-10 17:23:24,128,7277,59,69,4656.84,9385.01,0.00
2024-12-10 17:23:24,127,7277,58,69,4684.07,9385.10,0.00
2024-12-10 17:23:24,127,7278,58,69,4734.72,9386.00,0.00
2024-12-10 17:23:24,128,7278,59,69,4697.73,9386.01,0.00
2024-12-10 17:23:24,127,7278,58,69,4725.38,9386.10,0.00
2024-12-10 17:23:24,126,7278,57,69,4700.24,9386.64,0.00
2024-12-10 17:23:24,126,7279,57,69,4740.18,9387.00,0.00
2024-12-10 17:23:24,127,7279,58,69,4702.86,9387.01,0.00
2024-12-10 17:23:24,126,7279,57,69,4731.04,9387.10,0.00
2024-12-10 17:23:24,126,7280,57,69,4714.42,9388.00,0.00
2024-12-10 17:23:24,127,7280,58,69,4677.30,9388.01,0.00
2024-12-10 17:23:24,126,7280,57,69,4705.52,9388.10,0.00
2024-12-10 17:23:24,126,7281,57,69,4684.77,9389.00,0.00
2024-12-10 17:23:24,127,7281,58,69,4647.88,9389.01,0.00
2024-12-10 17:23:24,128,7280,58,70,4611.57,9389.02,0.00
2024-12-10 17:23:24,127,7280,57,70,4710.76,9389.10,0.00
2024-12-10 17:23:24,127,7281,57,70,4689.39,9390.00,0.00
2024-12-10 17:23:24,128,7281,57,71,4652.75,9390.01,0.00
2024-12-10 17:23:24,127,7281,57,70,4680.39,9390.10,0.00
2024-12-10 17:23:24,127,7282,57,70,4733.59,9391.00,0.00
2024-12-10 17:23:24,128,7282,58,70,4696.61,9391.01,0.00
2024-12-10 17:23:24,127,7282,57,70,4724.61,9391.10,0.00
2024-12-10 17:23:24,128,7281,57,71,4670.34,9391.25,0.00
2024-12-10 17:23:24,128,7282,57,71,4733.28,9392.00,0.00
2024-12-10 17:23:24,129,7282,57,72,4696.59,9392.01,0.00
2024-12-10 17:23:24,128,7282,56,72,4724.25,9392.09,0.00
2024-12-10 17:23:24,127,7282,56,71,4760.71,9392.10,0.00
2024-12-10 17:23:24,127,7283,56,71,4811.11,9393.00,0.00
2024-12-10 17:23:24,128,7283,56,72,4773.52,9393.01,0.00
2024-12-10 17:23:24,127,7283,56,71,4802.27,9393.10,0.00
2024-12-10 17:23:24,126,7283,55,71,4822.22,9393.25,0.00
2024-12-10 17:23:24,126,7284,55,71,4818.92,9394.00,0.00
2024-12-10 17:23:24,127,7284,55,72,4780.98,9394.01,0.00
2024-12-10 17:23:24,126,7284,54,72,4809.93,9394.10,0.00
2024-12-10 17:23:24,125,7284,54,71,4847.65,9394.10,0.00
2024-12-10 17:23:24,125,7285,54,71,4829.94,9395.00,0.00
2024-12-10 17:23:24,126,7285,54,72,4791.61,9395.01,0.00
2024-12-10 17:23:24,125,7285,53,72,4820.65,9395.10,0.00
2024-12-10 17:23:24,125,7286,53,72,4806.01,9396.00,0.00
2024-12-10 17:23:24,126,7286,54,72,4767.87,9396.01,0.00
2024-12-10 17:23:24,125,7286,54,71,4803.76,9396.02,0.00
2024-12-10 17:23:24,124,7286,54,70,4835.25,9396.09,0.00
2024-12-10 17:23:24,123,7286,53,70,4873.79,9396.09,0.00
2024-12-10 17:23:24,123,7287,53,70,4862.58,9397.00,0.00
2024-12-10 17:23:24,124,7287,53,71,4823.37,9397.01,0.00
2024-12-10 17:23:24,123,7287,52,71,4853.70,9397.09,0.00
2024-12-10 17:23:24,123,7288,52,71,4841.76,9398.00,0.00
2024-12-10 17:23:24,124,7288,52,72,4802.72,9398.01,0.00
2024-12-10 17:23:24,123,7288,52,71,4832.99,9398.09,0.00
2024-12-10 17:23:24,123,7289,52,71,4818.42,9399.00,0.00
2024-12-10 17:23:24,124,7289,53,71,4779.56,9399.01,0.00
2024-12-10 17:23:24,123,7289,53,70,4809.84,9399.09,0.00
2024-12-10 17:23:24,123,7290,53,70,4792.37,9400.00,0.00
2024-12-10 17:23:24,124,7290,53,71,4753.72,9400.01,0.00
2024-12-10 17:23:24,123,7290,53,70,4782.48,9400.09,0.00
2024-12-10 17:23:24,122,7290,53,69,4756.48,9400.73,0.00
2024-12-10 17:23:24,122,7291,53,69,4805.92,9401.00,0.00
2024-12-10 17:23:24,123,7291,53,70,4766.85,9401.01,0.00
2024-12-10 17:23:24,123,7292,53,70,4739.33,9402.00,0.00
2024-12-10 17:23:24,124,7292,53,71,4701.11,9402.01,0.00
2024-12-10 17:23:24,123,7292,53,70,4731.15,9402.05,0.00
2024-12-10 17:23:24,122,7292,53,69,4763.45,9402.11,0.00
2024-12-10 17:23:24,122,7293,53,69,4747.56,9403.00,0.00
2024-12-10 17:23:24,123,7293,53,70,4708.96,9403.01,0.00
2024-12-10 17:23:24,122,7293,52,70,4737.82,9403.10,0.00
2024-12-10 17:23:24,122,7294,52,70,4720.72,9404.00,0.00
2024-12-10 17:23:24,123,7294,53,70,4682.34,9404.01,0.00
2024-12-10 17:23:24,124,7293,54,70,4558.25,9404.88,0.00
2024-12-10 17:23:25,124,7294,54,70,4629.63,9405.00,0.00
2024-12-10 17:23:25,125,7294,55,70,4592.60,9405.01,0.00
2024-12-10 17:23:25,124,7294,55,69,4624.11,9405.06,0.00
2024-12-10 17:23:25,123,7294,54,69,4658.66,9405.09,0.00
2024-12-10 17:23:25,122,7294,53,69,4696.07,9405.09,0.00
2024-12-10 17:23:25,122,7295,53,69,4755.98,9406.00,0.00
2024-12-10 17:23:25,123,7295,54,69,4717.31,9406.01,0.00
2024-12-10 17:23:25,123,7296,54,69,4691.45,9407.00,0.00
2024-12-10 17:23:25,124,7296,55,69,4653.61,9407.01,0.00
2024-12-10 17:23:25,123,7296,54,69,4678.06,9407.10,0.00
2024-12-10 17:23:25,122,7296,53,69,4674.71,9407.54,0.00
2024-12-10 17:23:25,122,7297,53,69,4703.89,9408.00,0.00
2024-12-10 17:23:25,123,7297,54,69,4665.64,9408.01,0.00
2024-12-10 17:23:25,122,7297,53,69,4691.38,9408.10,0.00
2024-12-10 17:23:25,121,7297,52,69,4695.66,9408.44,0.00
2024-12-10 17:23:25,121,7298,52,69,4712.63,9409.00,0.00
2024-12-10 17:23:25,122,7298,53,69,4674.00,9409.01,0.00
2024-12-10 17:23:25,121,7298,53,68,4709.53,9409.03,0.00
2024-12-10 17:23:25,120,7298,52,68,4740.25,9409.09,0.00
2024-12-10 17:23:25,121,7297,53,68,4658.43,9409.56,0.00
2024-12-10 17:23:25,121,7298,53,68,4721.41,9410.00,0.00
2024-12-10 17:23:25,122,7298,53,69,4682.71,9410.01,0.00
2024-12-10 17:23:25,121,7298,52,69,4711.72,9410.09,0.00
2024-12-10 17:23:25,121,7299,52,69,4769.87,9411.00,0.00
2024-12-10 17:23:25,122,7299,52,70,4730.77,9411.01,0.00
2024-12-10 17:23:25,123,7298,52,71,4641.17,9411.57,0.00
2024-12-10 17:23:25,123,7299,52,71,4698.10,9412.00,0.00
2024-12-10 17:23:25,124,7299,53,71,4660.22,9412.01,0.00
2024-12-10 17:23:25,123,7299,53,70,4689.72,9412.09,0.00
2024-12-10 17:23:25,122,7299,53,69,4654.89,9412.81,0.00
2024-12-10 17:23:25,122,7300,53,69,4778.99,9413.00,0.00
2024-12-10 17:23:25,123,7300,54,69,4740.14,9413.01,0.00
2024-12-10 17:23:25,122,7300,54,68,4770.54,9413.09,0.00
2024-12-10 17:23:25,121,7300,54,67,4809.18,9413.09,0.00
2024-12-10 17:23:25,121,7301,54,67,4788.86,9414.00,0.00
2024-12-10 17:23:25,122,7301,55,67,4749.61,9414.01,0.00
2024-12-10 17:23:25,121,7301,54,67,4780.33,9414.09,0.00
2024-12-10 17:23:25,121,7302,54,67,4755.02,9415.00,0.00
2024-12-10 17:23:25,122,7302,54,68,4716.04,9415.01,0.00
2024-12-10 17:23:25,121,7302,53,68,4746.49,9415.09,0.00
2024-12-10 17:23:25,120,7302,53,67,4707.58,9415.88,0.00
2024-12-10 17:23:25,120,7303,53,67,4771.96,9416.00,0.00
2024-12-10 17:23:25,121,7303,54,67,4732.52,9416.01,0.00
2024-12-10 17:23:25,121,7304,54,67,4715.09,9417.00,0.00
2024-12-10 17:23:25,122,7304,55,67,4676.44,9417.01,0.00
2024-12-10 17:23:25,121,7304,55,66,4705.78,9417.10,0.00
2024-12-10 17:23:25,120,7304,55,65,4744.21,9417.10,0.00
2024-12-10 17:23:25,121,7303,55,66,4676.27,9417.42,0.00
2024-12-10 17:23:25,121,7304,55,66,4744.12,9418.00,0.00
2024-12-10 17:23:25,122,7304,56,66,4705.24,9418.01,0.00
2024-12-10 17:23:25,123,7303,56,67,4666.98,9418.02,0.00
2024-12-10 17:23:25,122,7303,56,66,4718.39,9418.11,0.00
2024-12-10 17:23:25,123,7302,56,67,4607.66,9418.90,0.00
2024-12-10 17:23:25,123,7303,56,67,4764.64,9419.00,0.00
2024-12-10 17:23:25,124,7303,56,68,4726.22,9419.01,0.00
2024-12-10 17:23:25,123,7303,56,67,4755.49,9419.10,0.00
2024-12-10 17:23:25,123,7304,56,67,4897.82,9420.00,0.00
2024-12-10 17:23:25,124,7304,57,67,4858.32,9420.01,0.00
2024-12-10 17:23:25,123,7304,57,66,4888.66,9420.10,0.00
2024-12-10 17:23:25,123,7305,57,66,4877.38,9421.00,0.00
2024-12-10 17:23:25,124,7305,58,66,4838.05,9421.01,0.00
2024-12-10 17:23:25,123,7305,57,66,4868.22,9421.10,0.00
2024-12-10 17:23:25,124,7304,58,66,4818.33,9421.23,0.00
2024-12-10 17:23:25,124,7305,58,66,4877.42,9422.00,0.00
2024-12-10 17:23:25,125,7305,59,66,4838.40,9422.01,0.00
2024-12-10 17:23:25,124,7305,58,66,4875.90,9422.02,0.00
2024-12-10 17:23:25,123,7305,58,65,4907.91,9422.09,0.00
2024-12-10 17:23:25,123,7306,58,65,4962.31,9423.00,0.00
2024-12-10 17:23:25,124,7306,59,65,4922.30,9423.01,0.00
2024-12-10 17:23:25,123,7306,59,64,4953.92,9423.09,0.00
2024-12-10 17:23:25,124,7305,59,65,4899.55,9423.26,0.00
2024-12-10 17:23:25,124,7306,59,65,4955.41,9424.00,0.00
2024-12-10 17:23:25,125,7306,60,65,4915.77,9424.01,0.00
2024-12-10 17:23:25,124,7306,60,64,4947.08,9424.09,0.00
2024-12-10 17:23:25,124,7307,60,64,5001.42,9425.00,0.00
2024-12-10 17:23:25,125,7307,61,64,4961.41,9425.01,0.00
2024-12-10 17:23:25,124,7307,61,63,4993.09,9425.09,0.00
2024-12-10 17:23:25,124,7308,61,63,4968.63,9426.00,0.00
2024-12-10 17:23:25,125,7308,61,64,4928.88,9426.01,0.00
2024-12-10 17:23:25,124,7308,60,64,4960.30,9426.09,0.00
2024-12-10 17:23:25,125,7307,61,64,4895.04,9426.38,0.00
2024-12-10 17:23:25,125,7308,61,64,4943.72,9427.00,0.00
2024-12-10 17:23:25,126,7308,61,65,4904.48,9427.01,0.00
2024-12-10 17:23:25,125,7308,60,65,4935.69,9427.07,0.00
2024-12-10 17:23:25,124,7308,59,65,4973.97,9427.08,0.00
2024-12-10 17:23:25,125,7307,60,65,4912.36,9427.33,0.00
2024-12-10 17:23:25,125,7308,60,65,5033.66,9428.00,0.00
2024-12-10 17:23:25,126,7308,61,65,4993.71,9428.01,0.00
2024-12-10 17:23:25,125,7308,60,65,5020.64,9428.08,0.00
2024-12-10 17:23:25,125,7309,60,65,5063.96,9429.00,0.00
2024-12-10 17:23:25,126,7309,60,66,5023.77,9429.01,0.00
2024-12-10 17:23:25,125,7309,59,66,5047.94,9429.08,0.00
2024-12-10 17:23:25,125,7310,59,66,5014.97,9430.00,0.00
2024-12-10 17:23:25,126,7310,60,66,4975.17,9430.01,0.00
2024-12-10 17:23:25,125,7310,60,65,4996.35,9430.08,0.00
2024-12-10 17:23:25,124,7310,60,64,4996.68,9430.48,0.00
2024-12-10 17:23:25,124,7311,60,64,5006.97,9431.00,0.00
2024-12-10 17:23:25,125,7311,60,65,4966.92,9431.01,0.00
2024-12-10 17:23:26,124,7311,59,65,4988.36,9431.08,0.00
2024-12-10 17:23:26,124,7312,59,65,4958.94,9432.00,0.00
2024-12-10 17:23:26,125,7312,60,65,4919.27,9432.01,0.00
2024-12-10 17:23:26,124,7312,59,65,4941.89,9432.08,0.00
2024-12-10 17:23:26,124,7313,59,65,4909.26,9433.00,0.00
2024-12-10 17:23:26,125,7313,59,66,4869.98,9433.01,0.00
2024-12-10 17:23:26,124,7313,59,65,4816.46,9433.77,0.00
2024-12-10 17:23:26,124,7314,59,65,4870.67,9434.00,0.00
2024-12-10 17:23:26,125,7314,60,65,4831.71,9434.01,0.00
2024-12-10 17:23:26,124,7314,59,65,4862.11,9434.01,0.00
2024-12-10 17:23:26,123,7314,59,64,4894.75,9434.07,0.00
2024-12-10 17:23:26,124,7313,59,65,4819.21,9434.47,0.00
2024-12-10 17:23:26,124,7314,59,65,4878.50,9435.00,0.00
2024-12-10 17:23:26,125,7314,59,66,4839.47,9435.01,0.00
2024-12-10 17:23:26,124,7314,59,65,4871.66,9435.07,0.00
2024-12-10 17:23:26,124,7315,59,65,4927.55,9436.00,0.00
2024-12-10 17:23:26,125,7315,60,65,4888.13,9436.01,0.00
2024-12-10 17:23:26,124,7315,60,64,4926.79,9436.01,0.00
2024-12-10 17:23:26,123,7315,60,63,4960.73,9436.07,0.00
2024-12-10 17:23:26,122,7315,59,63,4938.43,9436.70,0.00
2024-12-10 17:23:26,121,7315,58,63,4972.92,9436.71,0.00
2024-12-10 17:23:26,121,7316,58,63,5023.84,9437.00,0.00
2024-12-10 17:23:26,122,7316,59,63,4982.66,9437.01,0.00
2024-12-10 17:23:26,121,7316,58,63,5016.84,9437.07,0.00
2024-12-10 17:23:26,121,7317,58,63,5005.82,9438.00,0.00
2024-12-10 17:23:26,122,7317,59,63,4964.79,9438.01,0.00
2024-12-10 17:23:26,121,7317,59,62,4998.82,9438.07,0.00
2024-12-10 17:23:26,122,7316,59,63,4882.32,9438.89,0.00
2024-12-10 17:23:26,122,7317,59,63,4957.85,9439.00,0.00
2024-12-10 17:23:26,123,7317,59,64,4917.55,9439.01,0.00
2024-12-10 17:23:26,122,7317,59,63,4950.91,9439.07,0.00
2024-12-10 17:23:26,122,7318,59,63,5016.58,9440.00,0.00
2024-12-10 17:23:26,123,7318,60,63,4975.80,9440.01,0.00
2024-12-10 17:23:26,122,7318,59,63,5009.64,9440.07,0.00
2024-12-10 17:23:26,122,7319,59,63,4997.64,9441.00,0.00
2024-12-10 17:23:26,123,7319,59,64,4957.01,9441.01,0.00
2024-12-10 17:23:26,122,7319,59,63,4990.69,9441.07,0.00
2024-12-10 17:23:26,122,7320,59,63,4976.79,9442.00,0.00
2024-12-10 17:23:26,123,7320,59,64,4936.33,9442.01,0.00
2024-12-10 17:23:26,122,7320,58,64,4969.84,9442.07,0.00
2024-12-10 17:23:26,122,7321,58,64,4955.76,9443.00,0.00
2024-12-10 17:23:26,123,7321,58,65,4915.47,9443.01,0.00
2024-12-10 17:23:26,122,7321,58,64,4951.37,9443.05,0.00
2024-12-10 17:23:26,122,7322,58,64,4933.83,9444.00,0.00
2024-12-10 17:23:26,123,7322,59,64,4893.72,9444.01,0.00
2024-12-10 17:23:26,122,7322,59,63,4926.89,9444.07,0.00
2024-12-10 17:23:26,122,7323,59,63,4911.84,9445.00,0.00
2024-12-10 17:23:26,123,7323,59,64,4871.91,9445.01,0.00
2024-12-10 17:23:26,122,7323,59,63,4904.90,9445.07,0.00
2024-12-10 17:23:26,122,7324,59,63,4888.97,9446.00,0.00
2024-12-10 17:23:26,123,7324,60,63,4849.22,9446.01,0.00
2024-12-10 17:23:26,122,7324,60,62,4882.18,9446.07,0.00
2024-12-10 17:23:26,122,7325,60,62,4864.29,9447.00,0.00
2024-12-10 17:23:26,123,7325,61,62,4824.74,9447.01,0.00
2024-12-10 17:23:26,122,7325,61,61,4863.52,9447.01,0.00
2024-12-10 17:23:26,121,7325,60,61,4898.00,9447.07,0.00
2024-12-10 17:23:26,120,7325,59,61,4938.03,9447.07,0.00
2024-12-10 17:23:26,120,7326,59,61,4918.77,9448.00,0.00
2024-12-10 17:23:26,121,7326,59,62,4878.12,9448.01,0.00
2024-12-10 17:23:26,122,7325,60,62,4790.28,9448.53,0.00
2024-12-10 17:23:26,122,7326,60,62,4873.86,9449.00,0.00
2024-12-10 17:23:26,123,7326,61,62,4834.24,9449.01,0.00
2024-12-10 17:23:26,122,7326,61,61,4873.09,9449.01,0.00
2024-12-10 17:23:26,121,7326,61,60,4907.91,9449.06,0.00
2024-12-10 17:23:26,121,7327,61,60,4962.73,9450.00,0.00
2024-12-10 17:23:26,122,7327,62,60,4922.05,9450.01,0.00
2024-12-10 17:23:26,121,7327,61,60,4957.28,9450.06,0.00
2024-12-10 17:23:26,121,7328,61,60,4929.09,9451.00,0.00
2024-12-10 17:23:26,122,7328,62,60,4888.69,9451.01,0.00
2024-12-10 17:23:26,121,7328,62,59,4923.64,9451.06,0.00
2024-12-10 17:23:26,121,7329,62,59,4893.45,9452.00,0.00
2024-12-10 17:23:26,122,7329,62,60,4853.34,9452.01,0.00
2024-12-10 17:23:26,121,7329,62,59,4888.00,9452.06,0.00
2024-12-10 17:23:26,122,7328,63,59,4769.97,9452.76,0.00
2024-12-10 17:23:26,122,7329,63,59,4855.03,9453.00,0.00
2024-12-10 17:23:26,123,7329,64,59,4815.55,9453.01,0.00
2024-12-10 17:23:26,122,7329,63,59,4849.62,9453.06,0.00
2024-12-10 17:23:26,121,7329,63,58,4889.24,9453.06,0.00
2024-12-10 17:23:26,121,7330,63,58,4925.64,9454.00,0.00
2024-12-10 17:23:26,122,7330,64,58,4885.26,9454.01,0.00
2024-12-10 17:23:26,123,7329,64,59,4841.71,9454.07,0.00
2024-12-10 17:23:26,123,7330,64,59,4820.15,9455.00,0.00
2024-12-10 17:23:26,124,7330,65,59,4781.28,9455.01,0.00
2024-12-10 17:23:26,123,7330,65,58,4814.03,9455.07,0.00
2024-12-10 17:23:26,123,7331,65,58,4843.07,9456.00,0.00
2024-12-10 17:23:26,124,7331,65,59,4804.01,9456.01,0.00
2024-12-10 17:23:26,123,7331,65,58,4783.24,9456.58,0.00
2024-12-10 17:23:26,123,7332,65,58,4788.63,9457.00,0.00
2024-12-10 17:23:26,124,7332,66,58,4750.01,9457.01,0.00
2024-12-10 17:23:26,123,7332,66,57,4781.73,9457.07,0.00
2024-12-10 17:23:26,122,7332,66,56,4817.83,9457.08,0.00
2024-12-10 17:23:26,121,7332,65,56,4801.63,9457.65,0.00
2024-12-10 17:23:26,120,7332,64,56,4807.74,9457.92,0.00
2024-12-10 17:23:26,120,7333,64,56,4873.63,9458.00,0.00
2024-12-10 17:23:26,121,7333,64,57,4833.36,9458.01,0.00
2024-12-10 17:23:27,120,7333,64,56,4866.57,9458.08,0.00
2024-12-10 17:23:27,120,7334,64,56,4843.42,9459.00,0.00
2024-12-10 17:23:27,121,7334,64,57,4803.39,9459.01,0.00
2024-12-10 17:23:27,122,7333,65,57,4754.75,9459.12,0.00
2024-12-10 17:23:27,123,7332,65,58,4716.18,9459.70,0.00
2024-12-10 17:23:27,123,7333,65,58,4790.14,9460.00,0.00
2024-12-10 17:23:27,124,7333,65,59,4751.51,9460.01,0.00
2024-12-10 17:23:27,124,7334,65,59,4862.87,9461.00,0.00
2024-12-10 17:23:27,125,7334,66,59,4823.97,9461.01,0.00
2024-12-10 17:23:27,124,7334,66,58,4860.59,9461.02,0.00
2024-12-10 17:23:27,123,7334,65,58,4894.75,9461.07,0.00
2024-12-10 17:23:27,122,7334,64,58,4934.09,9461.07,0.00
2024-12-10 17:23:27,122,7335,64,58,4897.99,9462.00,0.00
2024-12-10 17:23:27,123,7335,64,59,4858.16,9462.01,0.00
2024-12-10 17:23:27,122,7335,64,58,4897.21,9462.01,0.00
2024-12-10 17:23:27,122,7336,64,58,4855.88,9463.00,0.00
2024-12-10 17:23:27,123,7336,65,58,4816.40,9463.01,0.00
2024-12-10 17:23:27,122,7336,64,58,4844.82,9463.08,0.00
2024-12-10 17:23:27,122,7337,64,58,4813.79,9464.00,0.00
2024-12-10 17:23:27,123,7337,65,58,4774.66,9464.01,0.00
2024-12-10 17:23:27,123,7338,65,58,4728.30,9465.00,0.00
2024-12-10 17:23:27,124,7338,65,59,4690.17,9465.01,0.00
2024-12-10 17:23:27,123,7338,65,58,4715.34,9465.09,0.00
2024-12-10 17:23:27,123,7339,65,58,4676.36,9466.00,0.00
2024-12-10 17:23:27,124,7339,66,58,4638.64,9466.01,0.00
2024-12-10 17:23:27,123,7339,66,57,4665.32,9466.09,0.00
2024-12-10 17:23:27,122,7339,65,57,4607.36,9466.87,0.00
2024-12-10 17:23:27,122,7340,65,57,4657.76,9467.00,0.00
2024-12-10 17:23:27,123,7340,65,58,4619.89,9467.01,0.00
2024-12-10 17:23:27,122,7340,65,57,4648.43,9467.09,0.00
2024-12-10 17:23:27,122,7341,65,57,4600.97,9468.00,0.00
2024-12-10 17:23:27,123,7341,65,58,4563.56,9468.01,0.00
2024-12-10 17:23:27,122,7341,65,57,4592.47,9468.09,0.00
2024-12-10 17:23:27,123,7340,65,58,4545.90,9468.20,0.00
2024-12-10 17:23:27,123,7341,65,58,4574.74,9469.00,0.00
2024-12-10 17:23:27,124,7341,65,59,4537.84,9469.01,0.00
2024-12-10 17:23:27,125,7340,65,60,4499.27,9469.05,0.00
2024-12-10 17:23:27,124,7340,64,60,4558.30,9469.10,0.00
2024-12-10 17:23:27,123,7340,63,60,4560.15,9469.42,0.00
2024-12-10 17:23:27,123,7341,63,60,4628.59,9470.00,0.00
2024-12-10 17:23:27,124,7341,64,60,4591.26,9470.01,0.00
2024-12-10 17:23:27,123,7341,64,59,4620.16,9470.09,0.00
2024-12-10 17:23:27,124,7340,65,59,4505.48,9470.71,0.00
2024-12-10 17:23:27,124,7341,65,59,4641.87,9471.00,0.00
2024-12-10 17:23:27,125,7341,66,59,4604.73,9471.01,0.00
2024-12-10 17:23:27,124,7341,66,58,4641.41,9471.01,0.00
2024-12-10 17:23:27,123,7341,65,58,4671.48,9471.08,0.00
2024-12-10 17:23:27,123,7342,65,58,4702.55,9472.00,0.00
2024-12-10 17:23:27,124,7342,66,58,4664.63,9472.01,0.00
2024-12-10 17:23:27,123,7342,65,58,4694.89,9472.08,0.00
2024-12-10 17:23:27,123,7343,65,58,4648.01,9473.00,0.00
2024-12-10 17:23:27,124,7343,66,58,4610.53,9473.01,0.00
2024-12-10 17:23:27,123,7343,66,57,4639.84,9473.08,0.00
2024-12-10 17:23:27,122,7343,65,57,4643.75,9473.37,0.00
2024-12-10 17:23:27,121,7343,64,57,4666.17,9473.52,0.00
2024-12-10 17:23:27,121,7344,64,57,4682.85,9474.00,0.00
2024-12-10 17:23:27,122,7344,65,57,4644.46,9474.01,0.00
2024-12-10 17:23:27,121,7344,64,57,4674.11,9474.08,0.00
2024-12-10 17:23:27,120,7344,63,57,4683.44,9474.36,0.00
2024-12-10 17:23:27,121,7343,64,57,4626.67,9474.55,0.00
2024-12-10 17:23:27,120,7343,63,57,4691.25,9474.59,0.00
2024-12-10 17:23:27,121,7342,63,58,4624.77,9474.85,0.00
2024-12-10 17:23:27,121,7343,63,58,4692.19,9475.00,0.00
2024-12-10 17:23:27,122,7343,64,58,4653.73,9475.01,0.00
2024-12-10 17:23:27,121,7343,63,58,4683.41,9475.08,0.00
2024-12-10 17:23:27,122,7342,63,59,4555.20,9475.92,0.00
2024-12-10 17:23:27,122,7343,63,59,4776.97,9476.00,0.00
2024-12-10 17:23:27,123,7343,64,59,4738.13,9476.01,0.00
2024-12-10 17:23:27,122,7343,64,58,4776.19,9476.01,0.00
2024-12-10 17:23:27,121,7343,63,58,4807.85,9476.07,0.00
2024-12-10 17:23:27,121,7344,63,58,4852.37,9477.00,0.00
2024-12-10 17:23:27,122,7344,64,58,4812.59,9477.01,0.00
2024-12-10 17:23:27,121,7344,63,58,4844.76,9477.07,0.00
2024-12-10 17:23:27,122,7343,64,58,4713.31,9477.85,0.00
2024-12-10 17:23:27,122,7344,64,58,4782.08,9478.00,0.00
2024-12-10 17:23:27,123,7344,64,59,4743.20,9478.01,0.00
2024-12-10 17:23:27,124,7343,65,59,4602.99,9478.82,0.00
2024-12-10 17:23:27,124,7344,65,59,4727.48,9479.00,0.00
2024-12-10 17:23:27,125,7344,66,59,4689.66,9479.01,0.00
2024-12-10 17:23:27,124,7344,66,58,4719.67,9479.08,0.00
2024-12-10 17:23:27,125,7343,66,59,4546.64,9479.94,0.00
2024-12-10 17:23:27,125,7344,66,59,4692.73,9480.00,0.00
2024-12-10 17:23:27,126,7344,67,59,4655.49,9480.01,0.00
2024-12-10 17:23:27,125,7344,67,58,4685.19,9480.08,0.00
2024-12-10 17:23:27,124,7344,67,57,4687.46,9480.24,0.00
2024-12-10 17:23:27,125,7343,67,58,4631.77,9480.44,0.00
2024-12-10 17:23:27,125,7344,67,58,4738.79,9481.00,0.00
2024-12-10 17:23:27,126,7344,67,59,4701.18,9481.01,0.00
2024-12-10 17:23:27,125,7344,66,59,4723.76,9481.08,0.00
2024-12-10 17:23:27,124,7344,65,59,4719.79,9481.44,0.00
2024-12-10 17:23:27,125,7343,65,60,4607.97,9481.92,0.00
2024-12-10 17:23:27,125,7344,65,60,4752.82,9482.00,0.00
2024-12-10 17:23:27,126,7344,66,60,4715.10,9482.01,0.00
2024-12-10 17:23:27,125,7344,66,59,4745.27,9482.08,0.00
2024-12-10 17:23:27,124,7344,66,58,4772.67,9482.19,0.00
2024-12-10 17:23:27,123,7344,66,57,4734.41,9482.81,0.00
2024-12-10 17:23:27,123,7345,66,57,4861.60,9483.00,0.00
2024-12-10 17:23:27,124,7345,66,58,4822.39,9483.01,0.00
2024-12-10 17:23:27,123,7345,65,58,4853.92,9483.08,0.00
2024-12-10 17:23:27,122,7345,65,57,4892.94,9483.08,0.00
2024-12-10 17:23:27,121,7345,65,56,4891.67,9483.46,0.00
2024-12-10 17:23:27,121,7346,65,56,4904.39,9484.00,0.00
2024-12-10 17:23:27,122,7346,65,57,4864.19,9484.01,0.00
2024-12-10 17:23:27,121,7346,65,56,4896.59,9484.08,0.00
2024-12-10 17:23:28,120,7346,65,55,4936.60,9484.08,0.00
2024-12-10 17:23:28,120,7347,65,55,4910.81,9485.00,0.00
2024-12-10 17:23:28,121,7347,66,55,4870.23,9485.01,0.00
2024-12-10 17:23:28,120,7347,65,55,4902.94,9485.08,0.00
2024-12-10 17:23:28,119,7347,64,55,4889.19,9485.60,0.00
2024-12-10 17:23:28,120,7346,65,55,4831.89,9485.75,0.00
2024-12-10 17:23:28,121,7345,66,55,4783.11,9485.85,0.00
2024-12-10 17:23:28,121,7346,66,55,4854.87,9486.00,0.00
2024-12-10 17:23:28,122,7346,66,56,4815.07,9486.01,0.00
2024-12-10 17:23:28,121,7346,65,56,4847.06,9486.08,0.00
2024-12-10 17:23:28,121,7347,65,56,4983.08,9487.00,0.00
2024-12-10 17:23:28,122,7347,66,56,4942.23,9487.01,0.00
2024-12-10 17:23:28,121,7347,65,56,4975.27,9487.08,0.00
2024-12-10 17:23:28,120,7347,65,55,5006.20,9487.19,0.00
2024-12-10 17:23:28,120,7348,65,55,4995.43,9488.00,0.00
2024-12-10 17:23:28,121,7348,65,56,4954.14,9488.01,0.00
2024-12-10 17:23:28,120,7348,64,56,4987.55,9488.08,0.00
2024-12-10 17:23:28,121,7347,65,56,4883.26,9488.69,0.00
2024-12-10 17:23:28,121,7348,65,56,4929.73,9489.00,0.00
2024-12-10 17:23:28,122,7348,65,57,4889.33,9489.01,0.00
2024-12-10 17:23:28,121,7348,64,57,4921.92,9489.08,0.00
2024-12-10 17:23:28,120,7348,63,57,4945.52,9489.25,0.00
2024-12-10 17:23:28,120,7349,63,57,5012.58,9490.00,0.00
2024-12-10 17:23:28,121,7349,64,57,4971.15,9490.01,0.00
2024-12-10 17:23:28,120,7349,64,56,5003.91,9490.09,0.00
2024-12-10 17:23:28,120,7350,64,56,4972.70,9491.00,0.00
2024-12-10 17:23:28,121,7350,65,56,4931.60,9491.01,0.00
2024-12-10 17:23:28,120,7350,64,56,4964.02,9491.09,0.00
2024-12-10 17:23:28,121,7349,64,57,4901.56,9491.32,0.00
2024-12-10 17:23:28,121,7350,64,57,4946.81,9492.00,0.00
2024-12-10 17:23:28,122,7350,64,58,4906.27,9492.01,0.00
2024-12-10 17:23:28,121,7350,64,57,4938.21,9492.09,0.00
2024-12-10 17:23:28,122,7349,64,58,4825.03,9492.75,0.00
2024-12-10 17:23:28,122,7350,64,58,4971.87,9493.00,0.00
2024-12-10 17:23:28,123,7350,64,59,4931.45,9493.01,0.00
2024-12-10 17:23:28,122,7350,63,59,4953.43,9493.20,0.00
2024-12-10 17:23:28,123,7349,64,59,4877.43,9493.55,0.00
2024-12-10 17:23:28,124,7348,65,59,4850.66,9493.70,0.00
2024-12-10 17:23:28,124,7349,65,59,4989.04,9494.00,0.00
2024-12-10 17:23:28,125,7349,65,60,4949.13,9494.01,0.00
2024-12-10 17:23:28,124,7349,65,59,4980.64,9494.09,0.00
2024-12-10 17:23:28,123,7349,65,58,5007.16,9494.23,0.00
2024-12-10 17:23:28,123,7350,65,58,5136.59,9495.00,0.00
2024-12-10 17:23:28,124,7350,65,59,5095.16,9495.01,0.00
2024-12-10 17:23:28,123,7350,65,58,5128.12,9495.09,0.00
2024-12-10 17:23:28,123,7351,65,58,5088.55,9496.00,0.00
2024-12-10 17:23:28,124,7351,66,58,5047.51,9496.01,0.00
2024-12-10 17:23:28,123,7351,65,58,5080.08,9496.09,0.00
2024-12-10 17:23:28,122,7351,65,57,5121.07,9496.09,0.00
2024-12-10 17:23:28,121,7351,65,56,5117.64,9496.56,0.00
2024-12-10 17:23:28,121,7352,65,56,5123.28,9497.00,0.00
2024-12-10 17:23:28,122,7352,66,56,5081.29,9497.01,0.00
2024-12-10 17:23:28,123,7351,66,57,5018.40,9497.25,0.00
2024-12-10 17:23:28,123,7352,66,57,5048.02,9498.00,0.00
2024-12-10 17:23:28,124,7352,66,58,5007.31,9498.01,0.00
2024-12-10 17:23:28,124,7353,66,58,5025.97,9499.00,0.00
2024-12-10 17:23:28,125,7353,66,59,4985.76,9499.01,0.00
2024-12-10 17:23:28,124,7353,65,59,5017.57,9499.09,0.00
2024-12-10 17:23:28,124,7354,65,59,4965.08,9500.00,0.00
2024-12-10 17:23:28,125,7354,65,60,4925.36,9500.01,0.00
2024-12-10 17:23:28,124,7354,65,59,4956.67,9500.09,0.00
2024-12-10 17:23:28,123,7354,65,58,4943.95,9500.60,0.00
2024-12-10 17:23:28,123,7355,65,58,4940.82,9501.00,0.00
2024-12-10 17:23:28,124,7355,65,59,4900.97,9501.01,0.00
2024-12-10 17:23:28,123,7355,64,59,4934.90,9501.07,0.00
2024-12-10 17:23:28,122,7355,64,58,4973.01,9501.08,0.00
2024-12-10 17:23:28,121,7355,63,58,4939.39,9501.71,0.00
2024-12-10 17:23:28,120,7355,63,57,4937.66,9501.89,0.00
2024-12-10 17:23:28,120,7356,63,57,5004.40,9502.00,0.00
2024-12-10 17:23:28,121,7356,64,57,4963.05,9502.01,0.00
2024-12-10 17:23:28,122,7355,64,58,4913.49,9502.12,0.00
2024-12-10 17:23:28,122,7356,64,58,4949.54,9503.00,0.00
2024-12-10 17:23:28,123,7356,65,58,4909.30,9503.01,0.00
2024-12-10 17:23:28,122,7356,64,58,4941.25,9503.08,0.00
2024-12-10 17:23:28,122,7357,64,58,4975.38,9504.00,0.00
2024-12-10 17:23:28,123,7357,65,58,4934.93,9504.01,0.00
2024-12-10 17:23:28,122,7357,65,57,4966.77,9504.07,0.00
2024-12-10 17:23:28,121,7357,64,57,5007.03,9504.07,0.00
2024-12-10 17:23:28,122,7356,65,57,4905.06,9504.62,0.00
2024-12-10 17:23:28,122,7357,65,57,4981.77,9505.00,0.00
2024-12-10 17:23:28,123,7357,66,57,4941.27,9505.01,0.00
2024-12-10 17:23:28,122,7357,66,56,4976.34,9505.05,0.00
2024-12-10 17:23:28,122,7358,66,56,5014.77,9506.00,0.00
2024-12-10 17:23:28,123,7358,66,57,4974.00,9506.01,0.00
2024-12-10 17:23:28,122,7358,65,57,4993.19,9506.19,0.00
2024-12-10 17:23:28,121,7358,65,56,4995.48,9506.53,0.00
2024-12-10 17:23:28,122,7357,66,56,4939.98,9506.62,0.00
2024-12-10 17:23:28,122,7358,66,56,5020.52,9507.00,0.00
2024-12-10 17:23:28,123,7358,66,57,4979.70,9507.01,0.00
2024-12-10 17:23:28,122,7358,66,56,4933.27,9507.66,0.00
2024-12-10 17:23:28,122,7359,66,56,5048.20,9508.00,0.00
2024-12-10 17:23:28,123,7359,66,57,5007.16,9508.01,0.00
2024-12-10 17:23:29,123,7360,66,57,4947.69,9509.00,0.00
2024-12-10 17:23:29,124,7360,66,58,4907.79,9509.01,0.00
2024-12-10 17:23:29,123,7360,66,57,4926.52,9509.18,0.00
2024-12-10 17:23:29,122,7360,65,57,4891.12,9509.71,0.00
2024-12-10 17:23:29,123,7359,66,57,4826.91,9509.96,0.00
2024-12-10 17:23:29,123,7360,66,57,4902.66,9510.00,0.00
2024-12-10 17:23:29,124,7360,66,58,4863.12,9510.01,0.00
2024-12-10 17:23:29,123,7360,66,57,4895.72,9510.07,0.00
2024-12-10 17:23:29,122,7360,66,56,4886.96,9510.52,0.00
2024-12-10 17:23:29,122,7361,66,56,4964.67,9511.00,0.00
2024-12-10 17:23:29,123,7361,67,56,4924.30,9511.01,0.00
2024-12-10 17:23:29,124,7360,68,56,4882.30,9511.05,0.00
2024-12-10 17:23:29,123,7360,68,55,4983.03,9511.08,0.00
2024-12-10 17:23:29,124,7359,68,56,4865.71,9511.71,0.00
2024-12-10 17:23:29,124,7360,68,56,4904.76,9512.00,0.00
2024-12-10 17:23:29,125,7360,69,56,4865.52,9512.01,0.00
2024-12-10 17:23:29,124,7360,68,56,4897.89,9512.07,0.00
2024-12-10 17:23:29,123,7360,67,56,4930.66,9512.13,0.00
2024-12-10 17:23:29,124,7359,67,57,4824.08,9512.65,0.00
2024-12-10 17:23:29,125,7358,68,57,4807.18,9512.72,0.00
2024-12-10 17:23:29,126,7357,68,58,4743.06,9512.94,0.00
2024-12-10 17:23:29,126,7358,68,58,4957.71,9513.00,0.00
2024-12-10 17:23:29,127,7358,68,59,4918.67,9513.01,0.00
2024-12-10 17:23:29,126,7358,68,58,4939.81,9513.14,0.00
2024-12-10 17:23:29,125,7358,67,58,4885.03,9513.73,0.00
2024-12-10 17:23:29,125,7359,67,58,5133.45,9514.00,0.00
2024-12-10 17:23:29,126,7359,67,59,5092.71,9514.01,0.00
2024-12-10 17:23:29,125,7359,66,59,5126.62,9514.07,0.00
2024-12-10 17:23:29,124,7359,65,59,5161.79,9514.12,0.00
2024-12-10 17:23:29,123,7359,64,59,5143.36,9514.52,0.00
2024-12-10 17:23:29,123,7360,64,59,5126.58,9515.00,0.00
2024-12-10 17:23:29,124,7360,65,59,5085.23,9515.01,0.00
2024-12-10 17:23:29,123,7360,64,59,5109.45,9515.15,0.00
2024-12-10 17:23:29,122,7360,64,58,5098.75,9515.68,0.00
2024-12-10 17:23:29,122,7361,64,58,5102.70,9516.00,0.00
2024-12-10 17:23:29,123,7361,65,58,5061.21,9516.01,0.00
2024-12-10 17:23:29,122,7361,64,58,5095.70,9516.07,0.00
2024-12-10 17:23:29,123,7360,65,58,4988.79,9516.72,0.00
2024-12-10 17:23:29,123,7361,65,58,5033.95,9517.00,0.00
2024-12-10 17:23:29,124,7361,65,59,4993.36,9517.01,0.00
2024-12-10 17:23:29,123,7361,64,59,5031.64,9517.02,0.00
2024-12-10 17:23:29,122,7361,64,58,5068.22,9517.07,0.00
2024-12-10 17:23:29,121,7361,63,58,4991.98,9517.89,0.00
2024-12-10 17:23:29,121,7362,63,58,5124.41,9518.00,0.00
2024-12-10 17:23:29,122,7362,63,59,5082.40,9518.01,0.00
2024-12-10 17:23:29,121,7362,62,59,5118.14,9518.07,0.00
2024-12-10 17:23:29,120,7362,62,58,5159.99,9518.07,0.00
2024-12-10 17:23:29,121,7361,63,58,5079.71,9518.48,0.00
2024-12-10 17:23:29,120,7361,62,58,5109.38,9518.86,0.00
2024-12-10 17:23:29,120,7362,62,58,5159.85,9519.00,0.00
2024-12-10 17:23:29,121,7362,62,59,5117.20,9519.01,0.00
2024-12-10 17:23:29,120,7362,62,58,5153.52,9519.07,0.00
2024-12-10 17:23:29,119,7362,61,58,5133.65,9519.66,0.00
2024-12-10 17:23:29,118,7362,61,57,5129.12,9519.93,0.00
2024-12-10 17:23:29,118,7363,61,57,5281.86,9520.00,0.00
2024-12-10 17:23:29,119,7363,62,57,5237.47,9520.01,0.00
2024-12-10 17:23:29,118,7363,61,57,5275.43,9520.07,0.00
2024-12-10 17:23:29,119,7362,61,58,5194.42,9520.47,0.00
2024-12-10 17:23:29,119,7363,61,58,5199.48,9521.00,0.00
2024-12-10 17:23:29,120,7363,62,58,5156.15,9521.01,0.00
2024-12-10 17:23:29,119,7363,61,58,5198.68,9521.01,0.00
2024-12-10 17:23:29,119,7364,61,58,5234.61,9522.00,0.00
2024-12-10 17:23:29,120,7364,61,59,5190.99,9522.01,0.00
2024-12-10 17:23:29,120,7365,61,59,5142.05,9523.00,0.00
2024-12-10 17:23:29,121,7365,61,60,5099.56,9523.01,0.00
2024-12-10 17:23:29,122,7364,62,60,5057.76,9523.02,0.00
2024-12-10 17:23:29,123,7363,63,60,5034.30,9523.31,0.00
2024-12-10 17:23:29,122,7363,62,60,5057.69,9523.60,0.00
2024-12-10 17:23:29,123,7362,63,60,5008.01,9523.68,0.00
2024-12-10 17:23:29,122,7362,63,59,5058.52,9523.75,0.00
2024-12-10 17:23:29,122,7363,63,59,5105.57,9524.00,0.00
2024-12-10 17:23:29,123,7363,64,59,5064.06,9524.01,0.00
2024-12-10 17:23:29,123,7364,64,59,5248.37,9525.00,0.00
2024-12-10 17:23:29,124,7364,64,60,5206.04,9525.01,0.00
2024-12-10 17:23:29,123,7364,63,60,5246.54,9525.02,0.00
2024-12-10 17:23:29,122,7364,63,59,5233.55,9525.53,0.00
2024-12-10 17:23:29,122,7365,63,59,5241.31,9526.00,0.00
2024-12-10 17:23:29,123,7365,64,59,5198.70,9526.01,0.00
2024-12-10 17:23:29,124,7364,64,60,5084.03,9526.58,0.00
2024-12-10 17:23:29,123,7364,63,60,5127.56,9526.75,0.00
2024-12-10 17:23:29,123,7365,63,60,5169.11,9527.00,0.00
2024-12-10 17:23:29,124,7365,64,60,5127.43,9527.01,0.00
2024-12-10 17:23:29,123,7365,64,59,5161.50,9527.06,0.00
2024-12-10 17:23:29,122,7365,63,59,5193.06,9527.13,0.00
2024-12-10 17:23:29,121,7365,63,58,5183.18,9527.52,0.00
2024-12-10 17:23:29,121,7366,63,58,5279.55,9528.00,0.00
2024-12-10 17:23:29,122,7366,63,59,5236.27,9528.01,0.00
2024-12-10 17:23:29,123,7365,64,59,5105.34,9528.79,0.00
2024-12-10 17:23:29,123,7366,64,59,5161.43,9529.00,0.00
2024-12-10 17:23:29,124,7366,64,60,5119.80,9529.01,0.00
2024-12-10 17:23:29,123,7366,64,59,5153.37,9529.07,0.00
2024-12-10 17:23:29,122,7366,64,58,5186.83,9529.15,0.00
2024-12-10 17:23:29,122,7367,64,58,5237.96,9530.00,0.00
2024-12-10 17:23:29,123,7367,64,59,5195.38,9530.01,0.00
2024-12-10 17:23:29,122,7367,63,59,5230.24,9530.07,0.00
2024-12-10 17:23:29,122,7368,63,59,5195.17,9531.00,0.00
2024-12-10 17:23:29,123,7368,63,60,5152.93,9531.01,0.00
2024-12-10 17:23:29,123,7369,63,60,5112.76,9532.00,0.00
2024-12-10 17:23:29,124,7369,63,61,5071.53,9532.01,0.00
2024-12-10 17:23:29,125,7368,63,62,5030.96,9532.02,0.00
2024-12-10 17:23:29,124,7368,62,62,5059.69,9532.19,0.00
2024-12-10 17:23:29,125,7367,62,63,4986.09,9532.50,0.00
2024-12-10 17:23:29,126,7366,63,63,4978.14,9532.57,0.00
2024-12-10 17:23:29,126,7367,63,63,5042.61,9533.00,0.00
2024-12-10 17:23:29,127,7367,64,63,5002.90,9533.01,0.00
2024-12-10 17:23:29,126,7367,64,62,5036.58,9533.06,0.00
2024-12-10 17:23:29,125,7367,63,62,5050.75,9533.34,0.00
2024-12-10 17:23:29,125,7368,63,62,5282.95,9534.00,0.00
2024-12-10 17:23:29,126,7368,64,62,5241.02,9534.01,0.00
2024-12-10 17:23:30,125,7368,63,62,5279.92,9534.03,0.00
2024-12-10 17:23:30,124,7368,62,62,5319.43,9534.06,0.00
2024-12-10 17:23:30,123,7368,62,61,5361.91,9534.06,0.00
2024-12-10 17:23:30,124,7367,62,62,5250.15,9534.73,0.00
2024-12-10 17:23:30,124,7368,62,62,5313.82,9535.00,0.00
2024-12-10 17:23:30,125,7368,63,62,5271.31,9535.01,0.00
2024-12-10 17:23:30,124,7368,63,61,5308.47,9535.06,0.00
2024-12-10 17:23:30,125,7367,64,61,5191.88,9535.72,0.00
2024-12-10 17:23:30,125,7368,64,61,5369.44,9536.00,0.00
2024-12-10 17:23:30,126,7368,64,62,5326.82,9536.01,0.00
2024-12-10 17:23:30,125,7368,63,62,5364.12,9536.06,0.00
2024-12-10 17:23:30,126,7367,63,63,5286.10,9536.37,0.00
2024-12-10 17:23:30,127,7366,64,63,5259.50,9536.59,0.00
2024-12-10 17:23:30,127,7367,64,63,5408.74,9537.00,0.00
2024-12-10 17:23:30,128,7367,65,63,5366.48,9537.01,0.00
2024-12-10 17:23:30,127,7367,64,63,5403.50,9537.06,0.00
2024-12-10 17:23:30,126,7367,64,62,5443.81,9537.08,0.00
2024-12-10 17:23:30,126,7368,64,62,5553.62,9538.00,0.00
2024-12-10 17:23:30,127,7368,64,63,5509.89,9538.01,0.00
2024-12-10 17:23:30,127,7369,64,63,5452.95,9539.00,0.00
2024-12-10 17:23:30,128,7369,64,64,5410.35,9539.01,0.00
2024-12-10 17:23:30,127,7369,64,63,5446.96,9539.06,0.00
2024-12-10 17:23:30,128,7368,64,64,5396.22,9539.16,0.00
2024-12-10 17:23:30,127,7368,64,63,5436.14,9539.27,0.00
2024-12-10 17:23:30,127,7369,64,63,5402.65,9540.00,0.00
2024-12-10 17:23:30,128,7369,64,64,5360.44,9540.01,0.00
2024-12-10 17:23:30,127,7369,63,64,5396.67,9540.06,0.00
2024-12-10 17:23:30,126,7369,62,64,5423.73,9540.22,0.00
2024-12-10 17:23:30,127,7368,63,64,5375.71,9540.28,0.00
2024-12-10 17:23:30,127,7369,63,64,5443.98,9541.00,0.00
2024-12-10 17:23:30,128,7369,64,64,5401.45,9541.01,0.00
2024-12-10 17:23:30,129,7368,64,65,5328.41,9541.31,0.00
2024-12-10 17:23:30,128,7368,64,64,5362.70,9541.36,0.00
2024-12-10 17:23:30,129,7367,65,64,5243.21,9541.86,0.00
2024-12-10 17:23:30,129,7367,65,64,5375.57,9542.00,0.00
2024-12-10 17:23:30,130,7367,65,65,5334.22,9542.01,0.00
2024-12-10 17:23:30,131,7366,65,66,5293.50,9542.02,0.00
2024-12-10 17:23:30,130,7366,64,66,5286.11,9542.45,0.00
2024-12-10 17:23:30,130,7367,64,66,5414.67,9543.00,0.00
2024-12-10 17:23:30,131,7367,64,67,5373.34,9543.01,0.00
2024-12-10 17:23:30,130,7367,64,66,5408.83,9543.06,0.00
2024-12-10 17:23:30,129,7367,64,65,5348.66,9543.70,0.00
2024-12-10 17:23:30,129,7368,64,65,5455.27,9544.00,0.00
2024-12-10 17:23:30,130,7368,65,65,5413.30,9544.01,0.00
2024-12-10 17:23:30,129,7368,64,65,5446.77,9544.06,0.00
2024-12-10 17:23:30,128,7368,63,65,5474.53,9544.20,0.00
2024-12-10 17:23:30,127,7368,63,64,5443.20,9544.60,0.00
2024-12-10 17:23:30,127,7369,63,64,5456.51,9545.00,0.00
2024-12-10 17:23:30,128,7369,64,64,5413.88,9545.01,0.00
2024-12-10 17:23:30,127,7369,64,63,5447.02,9545.06,0.00
2024-12-10 17:23:30,126,7369,64,62,5476.31,9545.21,0.00
2024-12-10 17:23:30,126,7370,64,62,5411.54,9546.00,0.00
2024-12-10 17:23:30,127,7370,65,62,5368.93,9546.01,0.00
2024-12-10 17:23:30,126,7370,64,62,5401.54,9546.06,0.00
2024-12-10 17:23:30,127,7369,64,63,5217.78,9546.89,0.00
2024-12-10 17:23:30,127,7370,64,63,5291.30,9547.00,0.00
2024-12-10 17:23:30,128,7370,65,63,5249.96,9547.01,0.00
2024-12-10 17:23:30,129,7369,65,64,5146.89,9547.39,0.00
2024-12-10 17:23:30,130,7368,65,65,5156.67,9547.46,0.00
2024-12-10 17:23:30,131,7367,65,66,5112.98,9547.81,0.00
2024-12-10 17:23:30,131,7368,65,66,5229.18,9548.00,0.00
2024-12-10 17:23:30,132,7368,65,67,5189.57,9548.01,0.00
2024-12-10 17:23:30,131,7368,64,67,5222.63,9548.04,0.00
2024-12-10 17:23:30,130,7368,64,66,5260.60,9548.05,0.00
2024-12-10 17:23:30,129,7368,63,66,5289.67,9548.17,0.00
2024-12-10 17:23:30,128,7368,62,66,5234.73,9548.58,0.00
2024-12-10 17:23:30,128,7369,62,66,5454.00,9549.00,0.00
2024-12-10 17:23:30,129,7369,62,67,5411.72,9549.01,0.00
2024-12-10 17:23:30,130,7368,62,68,5242.66,9549.78,0.00
2024-12-10 17:23:30,130,7369,62,68,5271.78,9550.00,0.00
2024-12-10 17:23:30,131,7369,63,68,5231.53,9550.01,0.00
2024-12-10 17:23:30,130,7369,62,68,5263.93,9550.05,0.00
2024-12-10 17:23:30,131,7368,63,68,5201.37,9550.23,0.00
2024-12-10 17:23:30,131,7369,63,68,5206.24,9551.00,0.00
2024-12-10 17:23:30,132,7369,63,69,5166.80,9551.01,0.00
2024-12-10 17:23:30,131,7369,62,69,5198.47,9551.05,0.00
2024-12-10 17:23:30,130,7369,61,69,5219.09,9551.19,0.00
2024-12-10 17:23:30,131,7368,61,70,5157.55,9551.34,0.00
2024-12-10 17:23:30,130,7368,60,70,5124.92,9551.85,0.00
2024-12-10 17:23:30,130,7369,60,70,5237.44,9552.00,0.00
2024-12-10 17:23:30,131,7369,60,71,5197.46,9552.01,0.00
2024-12-10 17:23:30,130,7369,60,70,5229.84,9552.05,0.00
2024-12-10 17:23:30,129,7369,60,69,5209.60,9552.40,0.00
2024-12-10 17:23:30,129,7370,60,69,5236.07,9553.00,0.00
2024-12-10 17:23:30,130,7370,60,70,5195.79,9553.01,0.00
2024-12-10 17:23:30,129,7370,59,70,5228.99,9553.06,0.00
2024-12-10 17:23:30,128,7370,59,69,5202.61,9553.44,0.00
2024-12-10 17:23:30,128,7371,59,69,5163.27,9554.00,0.00
2024-12-10 17:23:30,129,7371,59,70,5123.24,9554.01,0.00
2024-12-10 17:23:30,128,7371,58,70,5156.46,9554.06,0.00
2024-12-10 17:23:30,127,7371,57,70,5186.92,9554.15,0.00
2024-12-10 17:23:30,126,7371,57,69,5075.96,9554.91,0.00
2024-12-10 17:23:30,127,7370,58,69,5027.22,9554.98,0.00
2024-12-10 17:23:30,127,7371,58,69,5109.76,9555.00,0.00
2024-12-10 17:23:30,128,7371,59,69,5069.84,9555.01,0.00
2024-12-10 17:23:30,127,7371,58,69,5102.59,9555.06,0.00
2024-12-10 17:23:30,128,7370,58,70,5010.23,9555.38,0.00
2024-12-10 17:23:30,127,7370,57,70,5052.54,9555.45,0.00
2024-12-10 17:23:30,126,7370,56,70,5053.33,9555.75,0.00
2024-12-10 17:23:30,126,7371,56,70,5144.37,9556.00,0.00
2024-12-10 17:23:30,127,7371,56,71,5103.87,9556.01,0.00
2024-12-10 17:23:30,126,7371,56,70,5137.61,9556.06,0.00
2024-12-10 17:23:30,127,7370,56,71,5027.91,9556.50,0.00
2024-12-10 17:23:30,128,7369,57,71,5035.48,9556.56,0.00
2024-12-10 17:23:30,128,7370,57,71,5126.04,9557.00,0.00
2024-12-10 17:23:30,129,7370,57,72,5086.30,9557.01,0.00
2024-12-10 17:23:30,128,7370,56,72,5120.04,9557.06,0.00
2024-12-10 17:23:30,127,7370,56,71,5122.23,9557.28,0.00
2024-12-10 17:23:30,126,7370,56,70,5107.88,9557.72,0.00
2024-12-10 17:23:30,125,7370,56,69,5123.15,9557.85,0.00
2024-12-10 17:23:30,125,7371,56,69,5301.61,9558.00,0.00
2024-12-10 17:23:30,126,7371,57,69,5259.54,9558.01,0.00
2024-12-10 17:23:30,125,7371,57,68,5295.52,9558.06,0.00
2024-12-10 17:23:30,124,7371,56,68,5332.97,9558.11,0.00
2024-12-10 17:23:30,125,7370,56,69,5220.38,9558.73,0.00
2024-12-10 17:23:31,125,7371,56,69,5245.43,9559.00,0.00
2024-12-10 17:23:31,126,7371,56,70,5203.80,9559.01,0.00
2024-12-10 17:23:31,125,7371,56,69,5243.15,9559.02,0.00
2024-12-10 17:23:31,124,7371,56,68,5281.59,9559.06,0.00
2024-12-10 17:23:31,124,7372,56,68,5275.67,9560.00,0.00
2024-12-10 17:23:31,125,7372,57,68,5233.46,9560.01,0.00
2024-12-10 17:23:31,124,7372,57,67,5269.52,9560.06,0.00
2024-12-10 17:23:31,123,7372,57,66,5199.18,9560.90,0.00
2024-12-10 17:23:31,122,7372,56,66,5224.51,9560.93,0.00
2024-12-10 17:23:31,122,7373,56,66,5283.96,9561.00,0.00
2024-12-10 17:23:31,123,7373,56,67,5241.00,9561.01,0.00
2024-12-10 17:23:31,122,7373,55,67,5277.71,9561.07,0.00
2024-12-10 17:23:31,123,7372,56,67,5122.34,9561.87,0.00
2024-12-10 17:23:31,123,7373,56,67,5189.17,9562.00,0.00
2024-12-10 17:23:31,124,7373,56,68,5147.32,9562.01,0.00
2024-12-10 17:23:31,123,7373,56,67,5174.20,9562.11,0.00
2024-12-10 17:23:31,122,7373,55,67,5207.64,9562.20,0.00
2024-12-10 17:23:31,121,7373,54,67,5230.63,9562.40,0.00
2024-12-10 17:23:31,121,7374,54,67,5293.89,9563.00,0.00
2024-12-10 17:23:31,122,7374,54,68,5250.50,9563.01,0.00
2024-12-10 17:23:31,122,7375,54,68,5195.24,9564.00,0.00
2024-12-10 17:23:31,123,7375,55,68,5153.00,9564.01,0.00
2024-12-10 17:23:31,124,7374,55,69,5025.35,9564.69,0.00
2024-12-10 17:23:31,124,7375,55,69,5072.70,9565.00,0.00
2024-12-10 17:23:31,125,7375,56,69,5032.12,9565.01,0.00
2024-12-10 17:23:31,124,7375,55,69,4995.50,9565.66,0.00
2024-12-10 17:23:31,124,7376,55,69,5094.33,9566.00,0.00
2024-12-10 17:23:31,125,7376,56,69,5053.57,9566.01,0.00
2024-12-10 17:23:31,126,7375,56,70,5012.71,9566.03,0.00
2024-12-10 17:23:31,125,7375,55,70,5087.35,9566.08,0.00
2024-12-10 17:23:31,124,7375,54,70,5119.27,9566.17,0.00
2024-12-10 17:23:31,123,7375,54,69,5154.11,9566.21,0.00
2024-12-10 17:23:31,123,7376,54,69,5116.45,9567.00,0.00
2024-12-10 17:23:31,124,7376,55,69,5075.19,9567.01,0.00
2024-12-10 17:23:31,123,7376,54,69,5112.36,9567.02,0.00
2024-12-10 17:23:31,123,7377,54,69,5126.42,9568.00,0.00
2024-12-10 17:23:31,124,7377,55,69,5085.08,9568.01,0.00
2024-12-10 17:23:31,123,7377,54,69,5087.70,9568.38,0.00
2024-12-10 17:23:31,123,7378,54,69,5069.13,9569.00,0.00
2024-12-10 17:23:31,124,7378,54,70,5028.25,9569.01,0.00
2024-12-10 17:23:31,125,7377,54,71,4918.91,9569.68,0.00
2024-12-10 17:23:31,124,7377,54,70,4948.15,9569.86,0.00
2024-12-10 17:23:31,124,7378,54,70,5006.27,9570.00,0.00
2024-12-10 17:23:31,125,7378,55,70,4966.22,9570.01,0.00
2024-12-10 17:23:31,124,7378,55,69,5003.20,9570.03,0.00
2024-12-10 17:23:31,125,7377,56,69,4952.55,9570.14,0.00
2024-12-10 17:23:31,125,7378,56,69,5064.91,9571.00,0.00
2024-12-10 17:23:31,126,7378,56,70,5024.71,9571.01,0.00
2024-12-10 17:23:31,127,7377,56,71,4973.41,9571.13,0.00
2024-12-10 17:23:31,126,7377,56,70,5004.31,9571.76,0.00
2024-12-10 17:23:31,125,7377,56,69,5025.78,9571.86,0.00
2024-12-10 17:23:31,125,7378,56,69,5165.04,9572.00,0.00
2024-12-10 17:23:31,126,7378,57,69,5124.05,9572.01,0.00
2024-12-10 17:23:31,126,7379,57,69,5151.41,9573.00,0.00
2024-12-10 17:23:31,127,7379,58,69,5110.84,9573.01,0.00
2024-12-10 17:23:31,126,7379,57,69,5149.78,9573.02,0.00
2024-12-10 17:23:31,125,7379,56,69,5183.51,9573.05,0.00
2024-12-10 17:23:31,124,7379,55,69,5220.29,9573.06,0.00
2024-12-10 17:23:31,123,7379,54,69,5261.99,9573.07,0.00
2024-12-10 17:23:31,124,7378,55,69,5183.49,9573.35,0.00
2024-12-10 17:23:31,123,7378,55,68,5280.05,9573.35,0.00
2024-12-10 17:23:31,123,7379,55,68,5279.38,9574.00,0.00
2024-12-10 17:23:31,124,7379,56,68,5236.80,9574.01,0.00
2024-12-10 17:23:31,123,7379,55,68,5276.28,9574.03,0.00
2024-12-10 17:23:31,122,7379,55,67,5317.96,9574.04,0.00
2024-12-10 17:23:31,121,7379,54,67,5359.13,9574.04,0.00
2024-12-10 17:23:31,122,7378,54,68,5287.52,9574.24,0.00
2024-12-10 17:23:31,122,7379,54,68,5425.27,9575.00,0.00
2024-12-10 17:23:31,123,7379,55,68,5381.16,9575.01,0.00
2024-12-10 17:23:31,122,7379,55,67,5398.59,9575.19,0.00
2024-12-10 17:23:31,121,7379,54,67,5423.10,9575.35,0.00
2024-12-10 17:23:31,121,7380,54,67,5500.18,9576.00,0.00
2024-12-10 17:23:31,122,7380,55,67,5455.09,9576.01,0.00
2024-12-10 17:23:31,123,7379,55,68,5409.97,9576.03,0.00
2024-12-10 17:23:31,123,7379,55,68,5383.65,9577.00,0.00
2024-12-10 17:23:31,124,7379,56,68,5340.23,9577.01,0.00
2024-12-10 17:23:31,123,7379,55,68,5379.91,9577.04,0.00
2024-12-10 17:23:31,122,7379,54,68,5419.70,9577.08,0.00
2024-12-10 17:23:31,123,7378,55,68,5323.91,9577.49,0.00
2024-12-10 17:23:31,123,7379,55,68,5462.36,9578.00,0.00
2024-12-10 17:23:31,124,7379,56,68,5418.31,9578.01,0.00
2024-12-10 17:23:31,124,7380,56,68,5446.58,9579.00,0.00
2024-12-10 17:23:31,125,7380,57,68,5403.01,9579.01,0.00
2024-12-10 17:23:31,124,7380,56,68,5442.94,9579.04,0.00
2024-12-10 17:23:31,123,7380,55,68,5450.18,9579.29,0.00
2024-12-10 17:23:31,123,7381,55,68,5438.42,9580.00,0.00
2024-12-10 17:23:31,124,7381,56,68,5394.57,9580.01,0.00
2024-12-10 17:23:31,123,7381,55,68,5433.98,9580.05,0.00
2024-12-10 17:23:31,123,7382,55,68,5382.74,9581.00,0.00
2024-12-10 17:23:31,124,7382,56,68,5339.33,9581.01,0.00
2024-12-10 17:23:31,123,7382,56,67,5368.38,9581.15,0.00
2024-12-10 17:23:31,122,7382,55,67,5374.20,9581.37,0.00
2024-12-10 17:23:31,123,7381,55,68,5289.45,9581.77,0.00
2024-12-10 17:23:31,123,7382,55,68,5397.59,9582.00,0.00
2024-12-10 17:23:31,124,7382,56,68,5354.06,9582.01,0.00
2024-12-10 17:23:31,123,7382,56,67,5313.91,9582.69,0.00
2024-12-10 17:23:31,123,7383,56,67,5415.78,9583.00,0.00
2024-12-10 17:23:31,124,7383,57,67,5372.10,9583.01,0.00
2024-12-10 17:23:31,125,7382,58,67,5308.52,9583.18,0.00
2024-12-10 17:23:31,126,7381,58,68,5209.01,9583.71,0.00
2024-12-10 17:23:31,126,7382,58,68,5254.53,9584.00,0.00
2024-12-10 17:23:31,127,7382,59,68,5213.15,9584.01,0.00
2024-12-10 17:23:31,126,7382,58,68,5241.39,9584.13,0.00
2024-12-10 17:23:31,125,7382,57,68,5262.33,9584.25,0.00
2024-12-10 17:23:31,125,7383,57,68,5387.24,9585.00,0.00
2024-12-10 17:23:31,126,7383,57,69,5344.48,9585.01,0.00
2024-12-10 17:23:31,125,7383,57,68,5372.23,9585.14,0.00
2024-12-10 17:23:32,124,7383,56,68,5367.94,9585.49,0.00
2024-12-10 17:23:32,124,7384,56,68,5372.81,9586.00,0.00
2024-12-10 17:23:32,125,7384,57,68,5329.83,9586.01,0.00
2024-12-10 17:23:32,124,7384,57,67,5337.31,9586.37,0.00
2024-12-10 17:23:32,123,7384,56,67,5335.35,9586.71,0.00
2024-12-10 17:23:32,123,7385,56,67,5380.09,9587.00,0.00
2024-12-10 17:23:32,124,7385,57,67,5336.70,9587.01,0.00
2024-12-10 17:23:32,123,7385,57,66,5374.21,9587.06,0.00
2024-12-10 17:23:32,122,7385,57,65,5415.93,9587.07,0.00
2024-12-10 17:23:32,121,7385,57,64,5457.79,9587.10,0.00
2024-12-10 17:23:32,121,7386,57,64,5443.30,9588.00,0.00
2024-12-10 17:23:32,122,7386,58,64,5398.69,9588.01,0.00
2024-12-10 17:23:32,121,7386,58,63,5440.62,9588.03,0.00
2024-12-10 17:23:32,120,7386,57,63,5482.78,9588.06,0.00
2024-12-10 17:23:32,120,7387,57,63,5462.92,9589.00,0.00
2024-12-10 17:23:32,121,7387,58,63,5417.77,9589.01,0.00
2024-12-10 17:23:32,121,7388,58,63,5385.33,9590.00,0.00
2024-12-10 17:23:32,122,7388,58,64,5341.19,9590.01,0.00
2024-12-10 17:23:32,122,7389,58,64,5300.96,9591.00,0.00
2024-12-10 17:23:32,123,7389,58,65,5257.86,9591.01,0.00
2024-12-10 17:23:32,123,7390,58,65,5212.02,9592.00,0.00
2024-12-10 17:23:32,124,7390,58,66,5169.99,9592.01,0.00
2024-12-10 17:23:32,123,7390,58,65,5206.59,9592.06,0.00
2024-12-10 17:23:32,124,7389,59,65,5159.85,9592.12,0.00
2024-12-10 17:23:32,124,7390,59,65,5135.41,9593.00,0.00
2024-12-10 17:23:32,125,7390,60,65,5094.33,9593.01,0.00
2024-12-10 17:23:32,124,7390,60,64,5097.24,9593.40,0.00
2024-12-10 17:23:32,124,7391,60,64,5172.65,9594.00,0.00
2024-12-10 17:23:32,125,7391,61,64,5131.27,9594.01,0.00
2024-12-10 17:23:32,124,7391,61,63,5166.71,9594.06,0.00
2024-12-10 17:23:32,123,7391,61,62,5165.58,9594.45,0.00
2024-12-10 17:23:32,123,7392,61,62,5175.35,9595.00,0.00
2024-12-10 17:23:32,124,7392,62,62,5133.62,9595.01,0.00
2024-12-10 17:23:32,123,7392,61,62,5169.54,9595.07,0.00
2024-12-10 17:23:32,122,7392,60,62,5210.01,9595.08,0.00
2024-12-10 17:23:32,121,7392,59,62,5167.92,9595.77,0.00
2024-12-10 17:23:32,121,7393,59,62,5225.21,9596.00,0.00
2024-12-10 17:23:32,122,7393,59,63,5182.38,9596.01,0.00
2024-12-10 17:23:32,122,7394,59,63,5152.51,9597.00,0.00
2024-12-10 17:23:32,123,7394,59,64,5110.62,9597.01,0.00
2024-12-10 17:23:32,122,7394,59,63,5146.25,9597.07,0.00
2024-12-10 17:23:32,123,7393,60,63,5033.43,9597.71,0.00
2024-12-10 17:23:32,123,7394,60,63,5102.29,9598.00,0.00
2024-12-10 17:23:32,124,7394,61,63,5061.14,9598.01,0.00
2024-12-10 17:23:32,125,7393,62,63,4996.16,9598.28,0.00
2024-12-10 17:23:32,126,7392,62,64,5009.07,9598.29,0.00
2024-12-10 17:23:32,126,7393,62,64,5132.82,9599.00,0.00
2024-12-10 17:23:32,127,7393,62,65,5092.41,9599.01,0.00
2024-12-10 17:23:32,128,7392,63,65,5024.19,9599.31,0.00
2024-12-10 17:23:32,127,7392,62,65,5072.50,9599.61,0.00
2024-12-10 17:23:32,127,7393,62,65,5259.63,9600.00,0.00
2024-12-10 17:23:32,128,7393,63,65,5218.54,9600.01,0.00
2024-12-10 17:23:32,127,7393,63,64,5250.87,9600.10,0.00
2024-12-10 17:23:32,127,7394,63,64,5303.16,9601.00,0.00
2024-12-10 17:23:32,128,7394,64,64,5261.73,9601.01,0.00
2024-12-10 17:23:32,129,7393,65,64,5159.47,9601.61,0.00
2024-12-10 17:23:32,130,7392,66,64,5137.67,9601.75,0.00
2024-12-10 17:23:32,130,7393,66,64,5202.90,9602.00,0.00
2024-12-10 17:23:32,131,7393,66,65,5163.18,9602.01,0.00
2024-12-10 17:23:32,130,7393,65,65,5197.02,9602.06,0.00
2024-12-10 17:23:32,129,7393,65,64,5149.38,9602.78,0.00
2024-12-10 17:23:32,129,7394,65,64,5340.95,9603.00,0.00
2024-12-10 17:23:32,130,7394,65,65,5299.87,9603.01,0.00
2024-12-10 17:23:32,131,7393,66,65,5254.31,9603.08,0.00
2024-12-10 17:23:32,131,7394,66,65,5213.39,9604.00,0.00
2024-12-10 17:23:32,132,7394,67,65,5173.90,9604.01,0.00
2024-12-10 17:23:32,132,7395,67,65,5186.99,9605.00,0.00
2024-12-10 17:23:32,133,7395,67,66,5147.99,9605.01,0.00
2024-12-10 17:23:32,134,7394,68,66,5107.43,9605.05,0.00
2024-12-10 17:23:32,133,7394,67,66,5164.24,9605.08,0.00
2024-12-10 17:23:32,132,7394,67,65,5203.35,9605.08,0.00
2024-12-10 17:23:32,132,7395,67,65,5148.88,9606.00,0.00
2024-12-10 17:23:32,133,7395,67,66,5110.16,9606.01,0.00
2024-12-10 17:23:32,132,7395,66,66,5107.10,9606.39,0.00
2024-12-10 17:23:32,131,7395,65,66,5119.62,9606.56,0.00
2024-12-10 17:23:32,130,7395,65,65,5142.81,9606.62,0.00
2024-12-10 17:23:32,130,7396,65,65,5245.09,9607.00,0.00
2024-12-10 17:23:32,131,7396,65,66,5205.06,9607.01,0.00
2024-12-10 17:23:32,130,7396,65,65,5230.63,9607.11,0.00
2024-12-10 17:23:32,129,7396,65,64,5237.65,9607.40,0.00
2024-12-10 17:23:32,129,7397,65,64,5239.58,9608.00,0.00
2024-12-10 17:23:32,130,7397,66,64,5199.27,9608.01,0.00
2024-12-10 17:23:32,129,7397,66,63,5228.55,9608.07,0.00
2024-12-10 17:23:32,130,7396,67,63,5171.37,9608.26,0.00
2024-12-10 17:23:32,130,7397,67,63,5153.20,9609.00,0.00
2024-12-10 17:23:32,131,7397,67,64,5113.86,9609.01,0.00
2024-12-10 17:23:32,132,7396,68,64,5042.23,9609.30,0.00
2024-12-10 17:23:32,131,7396,68,63,5130.96,9609.32,0.00
2024-12-10 17:23:32,132,7395,69,63,5079.27,9609.45,0.00
2024-12-10 17:23:32,132,7396,69,63,5187.86,9610.00,0.00
2024-12-10 17:23:32,133,7396,70,63,5148.85,9610.01,0.00
2024-12-10 17:23:32,134,7395,71,63,5107.58,9610.05,0.00
2024-12-10 17:23:32,133,7395,71,62,5185.40,9610.08,0.00
2024-12-10 17:23:32,132,7395,70,62,5219.85,9610.12,0.00
2024-12-10 17:23:32,131,7395,70,61,5249.50,9610.22,0.00
2024-12-10 17:23:32,131,7396,70,61,5369.65,9611.00,0.00
2024-12-10 17:23:32,132,7396,70,62,5328.97,9611.01,0.00
2024-12-10 17:23:32,131,7396,70,61,5355.87,9611.08,0.00
2024-12-10 17:23:32,132,7395,71,61,5256.71,9611.59,0.00
2024-12-10 17:23:33,132,7396,71,61,5367.76,9612.00,0.00
2024-12-10 17:23:33,133,7396,72,61,5327.40,9612.01,0.00
2024-12-10 17:23:33,132,7396,72,60,5316.21,9612.35,0.00
2024-12-10 17:23:33,131,7396,71,60,5311.79,9612.67,0.00
2024-12-10 17:23:33,131,7397,71,60,5421.65,9613.00,0.00
2024-12-10 17:23:33,132,7397,71,61,5380.58,9613.01,0.00
2024-12-10 17:23:33,133,7396,71,62,5293.07,9613.38,0.00
2024-12-10 17:23:33,133,7397,71,62,5352.94,9614.00,0.00
2024-12-10 17:23:33,134,7397,71,63,5313.00,9614.01,0.00
2024-12-10 17:23:33,133,7397,71,62,5340.59,9614.08,0.00
2024-12-10 17:23:33,133,7398,71,62,5379.19,9615.00,0.00
2024-12-10 17:23:33,134,7398,71,63,5339.04,9615.01,0.00
2024-12-10 17:23:33,135,7397,72,63,5285.23,9615.13,0.00
2024-12-10 17:23:33,134,7397,71,63,5370.96,9615.25,0.00
2024-12-10 17:23:33,135,7396,72,63,5300.88,9615.54,0.00
2024-12-10 17:23:33,135,7397,72,63,5353.40,9616.00,0.00
2024-12-10 17:23:33,136,7397,72,64,5314.04,9616.01,0.00
2024-12-10 17:23:33,135,7397,71,64,5328.19,9616.21,0.00
2024-12-10 17:23:33,134,7397,70,64,5355.67,9616.33,0.00
2024-12-10 17:23:33,134,7398,70,64,5499.66,9617.00,0.00
2024-12-10 17:23:33,135,7398,71,64,5458.93,9617.01,0.00
2024-12-10 17:23:33,134,7398,71,63,5487.45,9617.08,0.00
2024-12-10 17:23:33,135,7397,71,64,5413.83,9617.44,0.00
2024-12-10 17:23:33,135,7398,71,64,5461.79,9618.00,0.00
2024-12-10 17:23:33,136,7398,72,64,5421.63,9618.01,0.00
2024-12-10 17:23:33,135,7398,71,64,5398.61,9618.58,0.00
2024-12-10 17:23:33,136,7397,71,65,5337.95,9618.79,0.00
2024-12-10 17:23:33,137,7396,72,65,5314.03,9618.85,0.00
2024-12-10 17:23:33,137,7397,72,65,5448.21,9619.00,0.00
2024-12-10 17:23:33,138,7397,72,66,5408.73,9619.01,0.00
2024-12-10 17:23:33,139,7396,72,67,5368.44,9619.04,0.00
2024-12-10 17:23:33,138,7396,72,66,5449.77,9619.09,0.00
2024-12-10 17:23:33,138,7397,72,66,5556.62,9620.00,0.00
2024-12-10 17:23:33,139,7397,73,66,5516.65,9620.01,0.00
2024-12-10 17:23:33,138,7397,72,66,5527.93,9620.20,0.00
2024-12-10 17:23:33,138,7398,72,66,5575.62,9621.00,0.00
2024-12-10 17:23:33,139,7398,72,67,5535.51,9621.01,0.00
2024-12-10 17:23:33,138,7398,72,66,5571.81,9621.04,0.00
2024-12-10 17:23:33,138,7399,72,66,5531.01,9622.00,0.00
2024-12-10 17:23:33,139,7399,73,66,5491.22,9622.01,0.00
2024-12-10 17:23:33,138,7399,73,65,5517.76,9622.12,0.00
2024-12-10 17:23:33,137,7399,72,65,5524.13,9622.45,0.00
2024-12-10 17:23:33,137,7400,72,65,5519.16,9623.00,0.00
2024-12-10 17:23:33,138,7400,72,66,5479.17,9623.01,0.00
2024-12-10 17:23:33,137,7400,71,66,5513.99,9623.04,0.00
2024-12-10 17:23:33,136,7400,71,65,5551.01,9623.07,0.00
2024-12-10 17:23:33,135,7400,70,65,5590.05,9623.08,0.00
2024-12-10 17:23:33,134,7400,69,65,5631.05,9623.08,0.00
2024-12-10 17:23:33,134,7401,69,65,5585.03,9624.00,0.00
2024-12-10 17:23:33,135,7401,70,65,5543.66,9624.01,0.00
2024-12-10 17:23:33,134,7401,69,65,5576.82,9624.08,0.00
2024-12-10 17:23:33,133,7401,68,65,5602.02,9624.23,0.00
2024-12-10 17:23:33,133,7402,68,65,5568.06,9625.00,0.00
2024-12-10 17:23:33,134,7402,69,65,5526.50,9625.01,0.00
2024-12-10 17:23:33,134,7403,69,65,5475.80,9626.00,0.00
2024-12-10 17:23:33,135,7403,69,66,5435.24,9626.01,0.00
2024-12-10 17:23:33,134,7403,69,65,5471.51,9626.04,0.00
2024-12-10 17:23:33,133,7403,68,65,5508.32,9626.08,0.00
2024-12-10 17:23:33,132,7403,68,64,5549.32,9626.08,0.00
2024-12-10 17:23:33,132,7404,68,64,5513.53,9627.00,0.00
2024-12-10 17:23:33,133,7404,68,65,5472.07,9627.01,0.00
2024-12-10 17:23:33,134,7403,69,65,5412.28,9627.21,0.00
2024-12-10 17:23:33,134,7404,69,65,5449.45,9628.00,0.00
2024-12-10 17:23:33,135,7404,70,65,5409.08,9628.01,0.00
2024-12-10 17:23:33,134,7404,69,65,5443.75,9628.05,0.00
2024-12-10 17:23:33,133,7404,69,64,5481.80,9628.07,0.00
2024-12-10 17:23:33,133,7405,69,64,5513.11,9629.00,0.00
2024-12-10 17:23:33,134,7405,70,64,5471.97,9629.01,0.00
2024-12-10 17:23:33,133,7405,69,64,5454.90,9629.50,0.00
2024-12-10 17:23:33,133,7406,69,64,5466.62,9630.00,0.00
2024-12-10 17:23:33,134,7406,70,64,5425.82,9630.01,0.00
2024-12-10 17:23:33,133,7406,70,63,5457.15,9630.08,0.00
2024-12-10 17:23:33,134,7405,70,64,5387.95,9630.39,0.00
2024-12-10 17:23:33,134,7406,70,64,5390.40,9631.00,0.00
2024-12-10 17:23:33,135,7406,70,65,5350.47,9631.01,0.00
2024-12-10 17:23:33,134,7406,69,65,5333.02,9631.51,0.00
2024-12-10 17:23:33,134,7407,69,65,5421.47,9632.00,0.00
2024-12-10 17:23:33,135,7407,70,65,5381.31,9632.01,0.00
2024-12-10 17:23:33,134,7407,70,64,5412.25,9632.08,0.00
2024-12-10 17:23:33,133,7407,69,64,5392.07,9632.65,0.00
2024-12-10 17:23:33,133,7408,69,64,5425.53,9633.00,0.00
2024-12-10 17:23:33,134,7408,70,64,5385.04,9633.01,0.00
2024-12-10 17:23:33,133,7408,69,64,5413.64,9633.09,0.00
2024-12-10 17:23:33,134,7407,70,64,5369.66,9633.14,0.00
2024-12-10 17:23:33,135,7406,70,65,5323.33,9633.59,0.00
2024-12-10 17:23:33,135,7407,70,65,5373.69,9634.00,0.00
2024-12-10 17:23:33,136,7407,71,65,5334.18,9634.01,0.00
2024-12-10 17:23:33,135,7407,70,65,5367.80,9634.05,0.00
2024-12-10 17:23:33,134,7407,70,64,5400.10,9634.08,0.00
2024-12-10 17:23:33,133,7407,69,64,5403.03,9634.35,0.00
2024-12-10 17:23:33,133,7408,69,64,5542.04,9635.00,0.00
2024-12-10 17:23:33,134,7408,70,64,5500.69,9635.01,0.00
2024-12-10 17:23:33,133,7408,70,63,5540.84,9635.01,0.00
2024-12-10 17:23:33,134,7407,71,63,5495.16,9635.06,0.00
2024-12-10 17:23:33,134,7408,71,63,5464.78,9636.00,0.00
2024-12-10 17:23:33,135,7408,72,63,5424.30,9636.01,0.00
2024-12-10 17:23:33,134,7408,71,63,5447.56,9636.11,0.00
2024-12-10 17:23:33,134,7409,71,63,5455.02,9637.00,0.00
2024-12-10 17:23:33,135,7409,72,63,5414.61,9637.01,0.00
2024-12-10 17:23:33,134,7409,72,62,5436.15,9637.12,0.00
2024-12-10 17:23:34,133,7409,71,62,5439.39,9637.38,0.00
2024-12-10 17:23:34,134,7408,72,62,5356.33,9637.62,0.00
2024-12-10 17:23:34,134,7409,72,62,5396.83,9638.00,0.00
2024-12-10 17:23:34,135,7409,73,62,5356.85,9638.01,0.00
2024-12-10 17:23:34,135,7410,73,62,5319.20,9639.00,0.00
2024-12-10 17:23:34,136,7410,73,63,5280.09,9639.01,0.00
2024-12-10 17:23:34,135,7410,73,62,5301.90,9639.09,0.00
2024-12-10 17:23:34,136,7409,73,63,5131.81,9639.83,0.00
2024-12-10 17:23:34,136,7410,73,63,5187.80,9640.00,0.00
2024-12-10 17:23:34,137,7410,73,64,5149.94,9640.01,0.00
2024-12-10 17:23:34,136,7410,73,63,5169.83,9640.09,0.00
2024-12-10 17:23:34,135,7410,73,62,5207.33,9640.10,0.00
2024-12-10 17:23:34,135,7411,73,62,5176.59,9641.00,0.00
2024-12-10 17:23:34,136,7411,73,63,5138.53,9641.01,0.00
2024-12-10 17:23:34,135,7411,73,62,5083.51,9641.49,0.00
2024-12-10 17:23:34,135,7412,73,62,5054.12,9642.00,0.00
2024-12-10 17:23:34,136,7412,73,63,5016.96,9642.01,0.00
2024-12-10 17:23:34,135,7412,73,62,5028.14,9642.11,0.00
2024-12-10 17:23:34,134,7412,73,61,5064.62,9642.11,0.00
2024-12-10 17:23:34,133,7412,73,60,5093.98,9642.19,0.00
2024-12-10 17:23:34,132,7412,73,59,5066.88,9642.55,0.00
2024-12-10 17:23:34,132,7413,73,59,5055.63,9643.00,0.00
2024-12-10 17:23:34,133,7413,73,60,5017.62,9643.01,0.00
2024-12-10 17:23:34,132,7413,73,59,4985.51,9643.42,0.00
2024-12-10 17:23:34,131,7413,73,58,5005.84,9643.47,0.00
2024-12-10 17:23:34,132,7412,74,58,4953.84,9643.58,0.00
2024-12-10 17:23:34,131,7412,74,57,4998.38,9643.69,0.00
2024-12-10 17:23:34,131,7413,74,57,5014.90,9644.00,0.00
2024-12-10 17:23:34,132,7413,74,58,4976.91,9644.01,0.00
2024-12-10 17:23:34,131,7413,73,58,5005.60,9644.05,0.00
2024-12-10 17:23:34,130,7413,73,57,5018.30,9644.19,0.00
2024-12-10 17:23:34,131,7412,74,57,4966.55,9644.32,0.00
2024-12-10 17:23:34,130,7412,74,56,5029.61,9644.42,0.00
2024-12-10 17:23:34,130,7413,74,56,5086.32,9645.00,0.00
2024-12-10 17:23:34,131,7413,74,57,5047.50,9645.01,0.00
2024-12-10 17:23:34,130,7413,73,57,5067.38,9645.10,0.00
2024-12-10 17:23:34,129,7413,72,57,5032.68,9645.69,0.00
2024-12-10 17:23:34,128,7413,71,57,5042.98,9645.83,0.00
2024-12-10 17:23:34,128,7414,71,57,5171.86,9646.00,0.00
2024-12-10 17:23:34,129,7414,71,58,5131.77,9646.01,0.00
2024-12-10 17:23:34,129,7415,71,58,5072.95,9647.00,0.00
2024-12-10 17:23:34,130,7415,71,59,5033.93,9647.01,0.00
2024-12-10 17:23:34,129,7415,70,59,5054.46,9647.09,0.00
2024-12-10 17:23:34,128,7415,70,58,5027.85,9647.64,0.00
2024-12-10 17:23:34,128,7416,70,58,5054.83,9648.00,0.00
2024-12-10 17:23:34,129,7416,70,59,5015.65,9648.01,0.00
2024-12-10 17:23:34,130,7415,70,60,4910.74,9648.53,0.00
2024-12-10 17:23:34,130,7416,70,60,4961.92,9649.00,0.00
2024-12-10 17:23:34,131,7416,70,61,4924.04,9649.01,0.00
2024-12-10 17:23:34,130,7416,70,60,4954.54,9649.06,0.00
2024-12-10 17:23:34,129,7416,69,60,4957.83,9649.33,0.00
2024-12-10 17:23:34,130,7415,70,60,4835.39,9649.88,0.00
2024-12-10 17:23:34,130,7416,70,60,4975.17,9650.00,0.00
2024-12-10 17:23:34,131,7416,70,61,4937.19,9650.01,0.00
2024-12-10 17:23:34,130,7416,69,61,4943.55,9650.28,0.00
2024-12-10 17:23:34,130,7417,69,61,4977.20,9651.00,0.00
2024-12-10 17:23:34,131,7417,70,61,4939.21,9651.01,0.00
2024-12-10 17:23:34,130,7417,70,60,4973.67,9651.04,0.00
2024-12-10 17:23:34,129,7417,70,59,5007.01,9651.09,0.00
2024-12-10 17:23:34,128,7417,70,58,4951.01,9651.68,0.00
2024-12-10 17:23:34,128,7418,70,58,4981.61,9652.00,0.00
2024-12-10 17:23:34,129,7418,70,59,4943.00,9652.01,0.00
2024-12-10 17:23:34,128,7418,70,58,4973.36,9652.09,0.00
2024-12-10 17:23:34,127,7418,69,58,4989.57,9652.29,0.00
2024-12-10 17:23:34,126,7418,68,58,4984.48,9652.56,0.00
2024-12-10 17:23:34,126,7419,68,58,5003.84,9653.00,0.00
2024-12-10 17:23:34,127,7419,69,58,4964.44,9653.01,0.00
2024-12-10 17:23:34,126,7419,69,57,4995.45,9653.09,0.00
2024-12-10 17:23:34,127,7418,69,58,4941.24,9653.23,0.00
2024-12-10 17:23:34,127,7419,69,58,4971.54,9654.00,0.00
2024-12-10 17:23:34,128,7419,70,58,4932.70,9654.01,0.00
2024-12-10 17:23:34,127,7419,69,58,4935.13,9654.35,0.00
2024-12-10 17:23:34,128,7418,70,58,4856.38,9654.57,0.00
2024-12-10 17:23:34,128,7419,70,58,4980.82,9655.00,0.00
2024-12-10 17:23:34,129,7419,71,58,4942.21,9655.01,0.00
2024-12-10 17:23:34,128,7419,70,58,4971.80,9655.09,0.00
2024-12-10 17:23:34,127,7419,69,58,5009.93,9655.10,0.00
2024-12-10 17:23:34,126,7419,68,58,5032.16,9655.25,0.00
2024-12-10 17:23:34,127,7418,69,58,4984.95,9655.35,0.00
2024-12-10 17:23:34,126,7418,69,57,5064.73,9655.48,0.00
2024-12-10 17:23:34,126,7419,69,57,5147.90,9656.00,0.00
2024-12-10 17:23:34,127,7419,70,57,5107.37,9656.01,0.00
2024-12-10 17:23:34,126,7419,70,56,5138.74,9656.10,0.00
2024-12-10 17:23:34,125,7419,70,55,5139.33,9656.44,0.00
2024-12-10 17:23:34,125,7420,70,55,5209.34,9657.00,0.00
2024-12-10 17:23:34,126,7420,71,55,5168.00,9657.01,0.00
2024-12-10 17:23:34,127,7419,72,55,5020.86,9657.85,0.00
2024-12-10 17:23:34,127,7420,72,55,5106.04,9658.00,0.00
2024-12-10 17:23:34,128,7420,72,56,5066.15,9658.01,0.00
2024-12-10 17:23:34,127,7420,71,56,5096.19,9658.10,0.00
2024-12-10 17:23:34,126,7420,71,55,5134.07,9658.12,0.00
2024-12-10 17:23:34,125,7420,70,55,5162.55,9658.25,0.00
2024-12-10 17:23:34,124,7420,69,55,5147.22,9658.63,0.00
2024-12-10 17:23:34,124,7421,69,55,5246.55,9659.00,0.00
2024-12-10 17:23:34,125,7421,70,55,5204.58,9659.01,0.00
2024-12-10 17:23:34,124,7421,69,55,5169.79,9659.59,0.00
2024-12-10 17:23:34,124,7422,69,55,5186.69,9660.00,0.00
2024-12-10 17:23:34,125,7422,69,56,5145.19,9660.01,0.00
2024-12-10 17:23:34,124,7422,68,56,5176.60,9660.10,0.00
2024-12-10 17:23:34,123,7422,68,55,5176.00,9660.42,0.00
2024-12-10 17:23:34,123,7423,68,55,5173.19,9661.00,0.00
2024-12-10 17:23:34,124,7423,69,55,5131.47,9661.01,0.00
2024-12-10 17:23:34,123,7423,68,55,5134.67,9661.37,0.00
2024-12-10 17:23:34,123,7424,68,55,5125.34,9662.00,0.00
2024-12-10 17:23:34,124,7424,68,56,5084.00,9662.01,0.00
2024-12-10 17:23:34,123,7424,68,55,5115.16,9662.11,0.00
2024-12-10 17:23:34,122,7424,67,55,5154.33,9662.13,0.00
2024-12-10 17:23:34,123,7423,67,56,5099.90,9662.28,0.00
2024-12-10 17:23:35,123,7424,67,56,5139.29,9663.00,0.00
2024-12-10 17:23:35,124,7424,68,56,5097.84,9663.01,0.00
2024-12-10 17:23:35,124,7425,68,56,5119.26,9664.00,0.00
2024-12-10 17:23:35,125,7425,69,56,5078.31,9664.01,0.00
2024-12-10 17:23:35,124,7425,68,56,5113.04,9664.06,0.00
2024-12-10 17:23:35,123,7425,68,55,5150.70,9664.10,0.00
2024-12-10 17:23:35,122,7425,67,55,5098.39,9664.77,0.00
2024-12-10 17:23:35,122,7426,67,55,5149.33,9665.00,0.00
2024-12-10 17:23:35,123,7426,67,56,5107.47,9665.01,0.00
2024-12-10 17:23:35,123,7427,67,56,5051.25,9666.00,0.00
2024-12-10 17:23:35,124,7427,67,57,5010.51,9666.01,0.00
2024-12-10 17:23:35,123,7427,66,57,5042.50,9666.10,0.00
2024-12-10 17:23:35,122,7427,66,56,5083.04,9666.10,0.00
2024-12-10 17:23:35,121,7427,65,56,5089.75,9666.33,0.00
2024-12-10 17:23:35,120,7427,64,56,5116.31,9666.43,0.00
2024-12-10 17:23:35,120,7428,64,56,5122.08,9667.00,0.00
2024-12-10 17:23:35,121,7428,65,56,5079.75,9667.01,0.00
2024-12-10 17:23:35,122,7427,65,57,4972.31,9667.51,0.00
2024-12-10 17:23:35,121,7427,64,57,5019.06,9667.66,0.00
2024-12-10 17:23:35,121,7428,64,57,5059.27,9668.00,0.00
2024-12-10 17:23:35,122,7428,64,58,5017.80,9668.01,0.00
2024-12-10 17:23:35,121,7428,63,58,5049.71,9668.10,0.00
2024-12-10 17:23:35,120,7428,62,58,5086.47,9668.13,0.00
2024-12-10 17:23:35,119,7428,61,58,5063.39,9668.53,0.00
2024-12-10 17:23:35,119,7429,61,58,5166.62,9669.00,0.00
2024-12-10 17:23:35,120,7429,61,59,5123.56,9669.01,0.00
2024-12-10 17:23:35,119,7429,61,58,5156.90,9669.10,0.00
2024-12-10 17:23:35,118,7429,60,58,5173.00,9669.21,0.00
2024-12-10 17:23:35,118,7430,60,58,5144.16,9670.00,0.00
2024-12-10 17:23:35,119,7430,60,59,5100.94,9670.01,0.00
2024-12-10 17:23:35,118,7430,59,59,5109.64,9670.32,0.00
2024-12-10 17:23:35,117,7430,59,58,5086.38,9670.76,0.00
2024-12-10 17:23:35,117,7431,59,58,5137.86,9671.00,0.00
2024-12-10 17:23:35,118,7431,60,58,5094.32,9671.01,0.00
2024-12-10 17:23:35,118,7432,60,58,5034.22,9672.00,0.00
2024-12-10 17:23:35,119,7432,60,59,4991.91,9672.01,0.00
2024-12-10 17:23:35,120,7431,61,59,4948.71,9672.04,0.00
2024-12-10 17:23:35,119,7431,61,58,4985.72,9672.50,0.00
2024-12-10 17:23:35,120,7430,61,59,4940.17,9672.56,0.00
2024-12-10 17:23:35,119,7430,60,59,5000.13,9672.59,0.00
2024-12-10 17:23:35,119,7431,60,59,5015.59,9673.00,0.00
2024-12-10 17:23:35,120,7431,61,59,4973.79,9673.01,0.00
2024-12-10 17:23:35,119,7431,61,58,4963.56,9673.48,0.00
2024-12-10 17:23:35,120,7430,61,59,4882.84,9673.89,0.00
2024-12-10 17:23:35,120,7431,61,59,5149.27,9674.00,0.00
2024-12-10 17:23:35,121,7431,61,60,5106.71,9674.01,0.00
2024-12-10 17:23:35,120,7431,61,59,5135.67,9674.13,0.00
2024-12-10 17:23:35,120,7432,61,59,5132.04,9675.00,0.00
2024-12-10 17:23:35,121,7432,61,60,5089.63,9675.01,0.00
2024-12-10 17:23:35,122,7431,61,61,5006.88,9675.39,0.00
2024-12-10 17:23:35,121,7431,61,60,5047.70,9675.87,0.00
2024-12-10 17:23:35,121,7432,61,60,5077.31,9676.00,0.00
2024-12-10 17:23:35,122,7432,61,61,5035.70,9676.01,0.00
2024-12-10 17:23:35,121,7432,61,60,5076.51,9676.01,0.00
2024-12-10 17:23:35,120,7432,61,59,5012.52,9676.98,0.00
2024-12-10 17:23:35,120,7433,61,59,5171.39,9677.00,0.00
2024-12-10 17:23:35,121,7433,62,59,5128.65,9677.01,0.00
2024-12-10 17:23:35,120,7433,62,58,5133.17,9677.36,0.00
2024-12-10 17:23:35,119,7433,61,58,5156.47,9677.55,0.00
2024-12-10 17:23:35,119,7434,61,58,5193.37,9678.00,0.00
2024-12-10 17:23:35,120,7434,61,59,5150.09,9678.01,0.00
2024-12-10 17:23:35,119,7434,60,59,5177.57,9678.14,0.00
2024-12-10 17:23:35,119,7435,60,59,5172.93,9679.00,0.00
2024-12-10 17:23:35,120,7435,61,59,5129.82,9679.01,0.00
2024-12-10 17:23:35,120,7436,61,59,5107.17,9680.00,0.00
2024-12-10 17:23:35,121,7436,61,60,5064.96,9680.01,0.00
2024-12-10 17:23:35,121,7437,61,60,5039.16,9681.00,0.00
2024-12-10 17:23:35,122,7437,61,61,4997.85,9681.01,0.00
2024-12-10 17:23:35,121,7437,61,60,5029.58,9681.08,0.00
2024-12-10 17:23:35,120,7437,60,60,5062.42,9681.13,0.00
2024-12-10 17:23:35,119,7437,59,60,5100.62,9681.16,0.00
2024-12-10 17:23:35,119,7438,59,60,5097.61,9682.00,0.00
2024-12-10 17:23:35,120,7438,59,61,5055.13,9682.01,0.00
2024-12-10 17:23:35,120,7439,59,61,5035.33,9683.00,0.00
2024-12-10 17:23:35,121,7439,60,61,4993.72,9683.01,0.00
2024-12-10 17:23:35,122,7438,60,62,4943.14,9683.12,0.00
2024-12-10 17:23:35,121,7438,60,61,5040.39,9683.14,0.00
2024-12-10 17:23:35,121,7439,60,61,5034.66,9684.00,0.00
2024-12-10 17:23:35,122,7439,61,61,4993.39,9684.01,0.00
2024-12-10 17:23:35,123,7438,62,61,4896.76,9684.58,0.00
2024-12-10 17:23:35,123,7439,62,61,5045.30,9685.00,0.00
2024-12-10 17:23:35,124,7439,63,61,5004.61,9685.01,0.00
2024-12-10 17:23:35,123,7439,63,60,5032.95,9685.13,0.00
2024-12-10 17:23:36,124,7438,63,61,4989.43,9685.17,0.00
2024-12-10 17:23:36,123,7438,62,61,5067.08,9685.22,0.00
2024-12-10 17:23:36,123,7439,62,61,5146.70,9686.00,0.00
2024-12-10 17:23:36,124,7439,62,62,5105.19,9686.01,0.00
2024-12-10 17:23:36,123,7439,61,62,5134.36,9686.13,0.00
2024-12-10 17:23:36,124,7438,61,63,5091.39,9686.16,0.00
2024-12-10 17:23:36,124,7439,61,63,5161.64,9687.00,0.00
2024-12-10 17:23:36,125,7439,61,64,5120.35,9687.01,0.00
2024-12-10 17:23:36,124,7439,61,63,5132.26,9687.30,0.00
2024-12-10 17:23:36,125,7438,62,63,5043.03,9687.76,0.00
2024-12-10 17:23:36,125,7439,62,63,5189.21,9688.00,0.00
2024-12-10 17:23:36,126,7439,63,63,5148.02,9688.01,0.00
2024-12-10 17:23:36,126,7440,63,63,5192.83,9689.00,0.00
2024-12-10 17:23:36,127,7440,63,64,5151.94,9689.01,0.00
2024-12-10 17:23:36,126,7440,63,63,5180.68,9689.12,0.00
2024-12-10 17:23:36,126,7441,63,63,5154.77,9690.00,0.00
2024-12-10 17:23:36,127,7441,64,63,5114.18,9690.01,0.00
2024-12-10 17:23:36,126,7441,64,62,5142.71,9690.12,0.00
2024-12-10 17:23:36,126,7442,64,62,5112.94,9691.00,0.00
2024-12-10 17:23:36,127,7442,65,62,5072.68,9691.01,0.00
2024-12-10 17:23:36,126,7442,64,62,5096.58,9691.15,0.00
2024-12-10 17:23:36,126,7443,64,62,5069.25,9692.00,0.00
2024-12-10 17:23:36,127,7443,64,63,5029.33,9692.01,0.00
2024-12-10 17:23:36,126,7443,63,63,5058.02,9692.12,0.00
2024-12-10 17:23:36,126,7444,63,63,5021.00,9693.00,0.00
2024-12-10 17:23:36,127,7444,63,64,4981.46,9693.01,0.00
2024-12-10 17:23:36,128,7443,64,64,4933.48,9693.12,0.00
2024-12-10 17:23:36,128,7444,64,64,4898.96,9694.00,0.00
2024-12-10 17:23:36,129,7444,64,65,4860.98,9694.01,0.00
2024-12-10 17:23:36,128,7444,64,64,4895.23,9694.04,0.00
2024-12-10 17:23:36,128,7445,64,64,4919.11,9695.00,0.00
2024-12-10 17:23:36,129,7445,65,64,4880.98,9695.01,0.00
2024-12-10 17:23:36,128,7445,64,64,4898.55,9695.12,0.00
2024-12-10 17:23:36,127,7445,63,64,4900.16,9695.38,0.00
2024-12-10 17:23:36,127,7446,63,64,4904.38,9696.00,0.00
2024-12-10 17:23:36,128,7446,63,65,4866.07,9696.01,0.00
2024-12-10 17:23:36,127,7446,62,65,4866.92,9696.24,0.00
2024-12-10 17:23:36,127,7447,62,65,4854.73,9697.00,0.00
2024-12-10 17:23:36,128,7447,63,65,4816.80,9697.01,0.00
2024-12-10 17:23:36,127,7447,63,64,4847.86,9697.07,0.00
2024-12-10 17:23:36,127,7448,63,64,4805.16,9698.00,0.00
2024-12-10 17:23:36,128,7448,64,64,4767.62,9698.01,0.00
2024-12-10 17:23:36,127,7448,63,64,4802.11,9698.03,0.00
2024-12-10 17:23:36,126,7448,62,64,4824.68,9698.10,0.00
2024-12-10 17:23:36,125,7448,61,64,4861.73,9698.10,0.00
2024-12-10 17:23:36,124,7448,61,63,4900.16,9698.10,0.00
2024-12-10 17:23:37,124,7449,61,63,4867.91,9699.00,0.00
2024-12-10 17:23:37,125,7449,61,64,4828.97,9699.01,0.00
2024-12-10 17:23:37,124,7449,61,63,4867.44,9699.01,0.00
2024-12-10 17:23:37,123,7449,60,63,4905.45,9699.02,0.00
2024-12-10 17:23:37,122,7449,60,62,4937.75,9699.09,0.00
2024-12-10 17:23:37,121,7449,59,62,4970.80,9699.16,0.00
2024-12-10 17:23:37,122,7448,59,63,4898.58,9699.45,0.00
2024-12-10 17:23:37,121,7448,59,62,4936.38,9699.87,0.00
2024-12-10 17:23:37,120,7448,59,61,4968.69,9699.88,0.00
2024-12-10 17:23:37,120,7449,59,61,5038.31,9700.00,0.00
2024-12-10 17:23:37,121,7449,60,61,4996.67,9700.01,0.00
2024-12-10 17:23:37,120,7449,59,61,5029.45,9700.09,0.00
2024-12-10 17:23:37,119,7449,59,60,5061.28,9700.19,0.00
2024-12-10 17:23:37,119,7450,59,60,5140.38,9701.00,0.00
2024-12-10 17:23:37,120,7450,59,61,5097.55,9701.01,0.00
2024-12-10 17:23:37,119,7450,59,60,5137.07,9701.04,0.00
2024-12-10 17:23:37,118,7450,58,60,5171.16,9701.14,0.00
2024-12-10 17:23:37,117,7450,57,60,5203.37,9701.25,0.00
2024-12-10 17:23:37,117,7451,57,60,5213.24,9702.00,0.00
2024-12-10 17:23:37,118,7451,58,60,5169.06,9702.01,0.00
2024-12-10 17:23:37,118,7452,58,60,5155.09,9703.00,0.00
2024-12-10 17:23:37,119,7452,59,60,5111.77,9703.01,0.00
2024-12-10 17:23:37,118,7452,59,59,5147.12,9703.09,0.00
2024-12-10 17:23:37,117,7452,58,59,5178.84,9703.21,0.00
2024-12-10 17:23:37,117,7453,58,59,5184.56,9704.00,0.00
2024-12-10 17:23:37,118,7453,58,60,5140.62,9704.01,0.00
2024-12-10 17:23:37,117,7453,57,60,5174.72,9704.10,0.00
2024-12-10 17:23:37,116,7453,57,59,5212.55,9704.17,0.00
2024-12-10 17:23:37,116,7454,57,59,5212.53,9705.00,0.00
2024-12-10 17:23:37,117,7454,58,59,5167.98,9705.01,0.00
2024-12-10 17:23:37,117,7455,58,59,5143.52,9706.00,0.00
2024-12-10 17:23:37,118,7455,59,59,5099.93,9706.01,0.00
2024-12-10 17:23:37,117,7455,59,58,5132.33,9706.11,0.00
2024-12-10 17:23:37,116,7455,58,58,5127.93,9706.51,0.00
2024-12-10 17:23:37,116,7456,58,58,5156.68,9707.00,0.00
2024-12-10 17:23:37,117,7456,58,59,5112.61,9707.01,0.00
2024-12-10 17:23:37,118,7455,59,59,5067.10,9707.03,0.00
2024-12-10 17:23:37,117,7455,59,58,5175.29,9707.19,0.00
2024-12-10 17:23:37,116,7455,58,58,5191.30,9707.47,0.00
2024-12-10 17:23:37,116,7456,58,58,5213.74,9708.00,0.00
2024-12-10 17:23:37,117,7456,58,59,5169.18,9708.01,0.00
2024-12-10 17:23:37,116,7456,57,59,5202.57,9708.10,0.00
2024-12-10 17:23:37,115,7456,56,59,5246.47,9708.11,0.00
2024-12-10 17:23:37,115,7457,56,59,5319.14,9709.00,0.00
2024-12-10 17:23:37,116,7457,57,59,5273.29,9709.01,0.00
2024-12-10 17:23:37,116,7458,57,59,5248.99,9710.00,0.00
2024-12-10 17:23:37,117,7458,57,60,5204.13,9710.01,0.00
2024-12-10 17:23:37,118,7457,57,61,5149.68,9710.11,0.00
2024-12-10 17:23:37,117,7457,56,61,5268.39,9710.11,0.00
2024-12-10 17:23:37,117,7458,56,61,5257.21,9711.00,0.00
2024-12-10 17:23:37,118,7458,56,62,5212.66,9711.01,0.00
2024-12-10 17:23:37,118,7459,56,62,5270.96,9712.00,0.00
2024-12-10 17:23:37,119,7459,56,63,5226.67,9712.01,0.00
2024-12-10 17:23:37,120,7458,57,63,5146.02,9712.38,0.00
2024-12-10 17:23:37,120,7459,57,63,5205.30,9713.00,0.00
2024-12-10 17:23:37,121,7459,58,63,5162.28,9713.01,0.00
2024-12-10 17:23:37,120,7459,57,63,5199.48,9713.03,0.00
2024-12-10 17:23:37,119,7459,56,63,5234.65,9713.12,0.00
2024-12-10 17:23:37,119,7460,56,63,5297.57,9714.00,0.00
2024-12-10 17:23:37,120,7460,57,63,5253.42,9714.01,0.00
2024-12-10 17:23:37,119,7460,56,63,5277.69,9714.18,0.00
2024-12-10 17:23:37,118,7460,55,63,5321.05,9714.19,0.00
2024-12-10 17:23:37,119,7459,55,64,5225.14,9714.69,0.00
2024-12-10 17:23:37,119,7460,55,64,5327.55,9715.00,0.00
2024-12-10 17:23:37,120,7460,56,64,5283.15,9715.01,0.00
2024-12-10 17:23:37,119,7460,55,64,5314.91,9715.10,0.00
2024-12-10 17:23:37,118,7460,55,63,5348.37,9715.22,0.00
2024-12-10 17:23:37,118,7461,55,63,5418.17,9716.00,0.00
2024-12-10 17:23:37,119,7461,55,64,5372.64,9716.01,0.00
2024-12-10 17:23:37,118,7461,55,63,5405.35,9716.10,0.00
2024-12-10 17:23:37,119,7460,55,64,5337.14,9716.35,0.00
2024-12-10 17:23:37,119,7461,55,64,5387.01,9717.00,0.00
2024-12-10 17:23:37,120,7461,56,64,5342.12,9717.01,0.00
2024-12-10 17:23:37,119,7461,55,64,5348.46,9717.37,0.00
2024-12-10 17:23:37,119,7462,55,64,5433.23,9718.00,0.00
2024-12-10 17:23:37,120,7462,56,64,5387.95,9718.01,0.00
2024-12-10 17:23:37,121,7461,56,65,5251.86,9718.79,0.00
2024-12-10 17:23:37,121,7462,56,65,5323.49,9719.00,0.00
2024-12-10 17:23:37,122,7462,56,66,5279.85,9719.01,0.00
2024-12-10 17:23:37,121,7462,56,65,5310.08,9719.11,0.00
2024-12-10 17:23:37,121,7463,56,65,5366.17,9720.00,0.00
2024-12-10 17:23:37,122,7463,57,65,5322.18,9720.01,0.00
2024-12-10 17:23:37,122,7464,57,65,5286.76,9721.00,0.00
2024-12-10 17:23:37,123,7464,57,66,5243.78,9721.01,0.00
2024-12-10 17:23:38,123,7465,57,66,5209.00,9722.00,0.00
2024-12-10 17:23:38,124,7465,58,66,5166.99,9722.01,0.00
2024-12-10 17:23:38,124,7466,58,66,5129.88,9723.00,0.00
2024-12-10 17:23:38,125,7466,59,66,5088.84,9723.01,0.00
2024-12-10 17:23:38,125,7467,59,66,5048.40,9724.00,0.00
2024-12-10 17:23:38,126,7467,60,66,5008.33,9724.01,0.00
2024-12-10 17:23:38,125,7467,60,65,5038.97,9724.10,0.00
2024-12-10 17:23:38,126,7466,61,65,4992.81,9724.18,0.00
2024-12-10 17:23:38,127,7465,61,66,4981.99,9724.55,0.00
2024-12-10 17:23:38,128,7464,61,67,4955.17,9724.91,0.00
2024-12-10 17:23:38,128,7465,61,67,5067.51,9725.00,0.00
2024-12-10 17:23:38,129,7465,62,67,5028.22,9725.01,0.00
2024-12-10 17:23:38,128,7465,62,66,5000.70,9725.58,0.00
2024-12-10 17:23:38,128,7466,62,66,5234.48,9726.00,0.00
2024-12-10 17:23:38,129,7466,63,66,5193.90,9726.01,0.00
2024-12-10 17:23:38,128,7466,63,65,5234.42,9726.01,0.00
2024-12-10 17:23:38,128,7467,63,65,5169.89,9727.00,0.00
2024-12-10 17:23:38,129,7467,64,65,5129.81,9727.01,0.00
2024-12-10 17:23:38,128,7467,63,65,5161.21,9727.09,0.00
2024-12-10 17:23:38,129,7466,63,66,5076.14,9727.51,0.00
2024-12-10 17:23:38,128,7466,62,66,5129.56,9727.66,0.00
2024-12-10 17:23:38,128,7467,62,66,5141.81,9728.00,0.00
2024-12-10 17:23:38,129,7467,62,67,5101.95,9728.01,0.00
2024-12-10 17:23:38,129,7468,62,67,5109.79,9729.00,0.00
2024-12-10 17:23:38,130,7468,62,68,5070.48,9729.01,0.00
2024-12-10 17:23:38,129,7468,61,68,5103.89,9729.06,0.00
2024-12-10 17:23:38,128,7468,60,68,5140.74,9729.09,0.00
2024-12-10 17:23:38,127,7468,60,67,5090.10,9729.84,0.00
2024-12-10 17:23:38,127,7469,60,67,5131.06,9730.00,0.00
2024-12-10 17:23:38,128,7469,60,68,5090.97,9730.01,0.00
2024-12-10 17:23:38,127,7469,60,67,5128.00,9730.03,0.00
2024-12-10 17:23:38,126,7469,60,66,5163.05,9730.09,0.00
2024-12-10 17:23:38,125,7469,59,66,5164.91,9730.42,0.00
2024-12-10 17:23:38,124,7469,59,65,5135.55,9730.95,0.00
2024-12-10 17:23:38,124,7470,59,65,5209.36,9731.00,0.00
2024-12-10 17:23:38,125,7470,59,66,5167.69,9731.01,0.00
2024-12-10 17:23:38,124,7470,58,66,5198.65,9731.11,0.00
2024-12-10 17:23:38,124,7471,58,66,5172.53,9732.00,0.00
2024-12-10 17:23:38,125,7471,58,67,5131.15,9732.01,0.00
2024-12-10 17:23:38,125,7472,58,67,5091.77,9733.00,0.00
2024-12-10 17:23:38,126,7472,58,68,5051.36,9733.01,0.00
2024-12-10 17:23:38,125,7472,58,67,5090.22,9733.02,0.00
2024-12-10 17:23:38,124,7472,57,67,5128.14,9733.04,0.00
2024-12-10 17:23:38,123,7472,57,66,5165.89,9733.07,0.00
2024-12-10 17:23:38,123,7473,57,66,5133.96,9734.00,0.00
2024-12-10 17:23:38,124,7473,57,67,5092.56,9734.01,0.00
2024-12-10 17:23:38,123,7473,56,67,5132.40,9734.02,0.00
2024-12-10 17:23:38,123,7474,56,67,5096.47,9735.00,0.00
2024-12-10 17:23:38,124,7474,56,68,5055.37,9735.01,0.00
2024-12-10 17:23:38,123,7474,55,68,5083.64,9735.14,0.00
2024-12-10 17:23:38,124,7473,55,69,5008.96,9735.45,0.00
2024-12-10 17:23:38,124,7474,55,69,5071.19,9736.00,0.00
2024-12-10 17:23:38,125,7474,55,70,5030.62,9736.01,0.00
2024-12-10 17:23:38,124,7474,54,70,5064.94,9736.06,0.00
2024-12-10 17:23:38,124,7475,54,70,5102.84,9737.00,0.00
2024-12-10 17:23:38,125,7475,55,70,5062.02,9737.01,0.00
2024-12-10 17:23:38,126,7474,56,70,4990.96,9737.28,0.00
2024-12-10 17:23:38,125,7474,56,69,5011.37,9737.89,0.00
2024-12-10 17:23:38,125,7475,56,69,5072.45,9738.00,0.00
2024-12-10 17:23:38,126,7475,56,70,5032.19,9738.01,0.00
2024-12-10 17:23:38,126,7476,56,70,5060.78,9739.00,0.00
2024-12-10 17:23:38,127,7476,56,71,5020.93,9739.01,0.00
2024-12-10 17:23:38,126,7476,56,70,5053.08,9739.08,0.00
2024-12-10 17:23:38,127,7475,57,70,5004.87,9739.18,0.00
2024-12-10 17:23:38,126,7475,56,70,5065.03,9739.44,0.00
2024-12-10 17:23:38,126,7476,56,70,5067.90,9740.00,0.00
2024-12-10 17:23:38,127,7476,57,70,5028.00,9740.01,0.00
2024-12-10 17:23:38,126,7476,57,69,5060.20,9740.08,0.00
2024-12-10 17:23:38,125,7476,56,69,5022.72,9740.69,0.00
2024-12-10 17:23:38,125,7477,56,69,5126.00,9741.00,0.00
2024-12-10 17:23:38,126,7477,57,69,5085.31,9741.01,0.00
2024-12-10 17:23:38,125,7477,57,68,5118.23,9741.08,0.00
2024-12-10 17:23:38,125,7478,57,68,5063.63,9742.00,0.00
2024-12-10 17:23:38,126,7478,57,69,5023.44,9742.01,0.00
2024-12-10 17:23:38,126,7479,57,69,4959.02,9743.00,0.00
2024-12-10 17:23:38,127,7479,57,70,4919.98,9743.01,0.00
2024-12-10 17:23:38,126,7479,57,69,4950.55,9743.09,0.00
2024-12-10 17:23:38,125,7479,56,69,4971.26,9743.21,0.00
2024-12-10 17:23:38,124,7479,55,69,4987.53,9743.39,0.00
2024-12-10 17:23:38,124,7480,55,69,4978.51,9744.00,0.00
2024-12-10 17:23:38,125,7480,56,69,4938.68,9744.01,0.00
2024-12-10 17:23:38,124,7480,55,69,4976.16,9744.02,0.00
2024-12-10 17:23:38,123,7480,55,68,5010.31,9744.08,0.00
2024-12-10 17:23:39,123,7481,55,68,4965.68,9745.00,0.00
2024-12-10 17:23:39,124,7481,56,68,4925.64,9745.01,0.00
2024-12-10 17:23:39,123,7481,56,67,4957.79,9745.08,0.00
2024-12-10 17:23:39,123,7482,56,67,4913.36,9746.00,0.00
2024-12-10 17:23:39,124,7482,56,68,4873.74,9746.01,0.00
2024-12-10 17:23:39,125,7481,56,69,4823.86,9746.14,0.00
2024-12-10 17:23:39,124,7481,55,69,4805.62,9746.95,0.00
2024-12-10 17:23:39,124,7482,55,69,4879.55,9747.00,0.00
2024-12-10 17:23:39,125,7482,56,69,4840.51,9747.01,0.00
2024-12-10 17:23:39,124,7482,56,68,4870.93,9747.09,0.00
2024-12-10 17:23:39,124,7483,56,68,4915.57,9748.00,0.00
2024-12-10 17:23:39,125,7483,56,69,4876.24,9748.01,0.00
2024-12-10 17:23:39,124,7483,56,68,4906.95,9748.09,0.00
2024-12-10 17:23:39,123,7483,56,67,4914.28,9748.36,0.00
2024-12-10 17:23:39,123,7484,56,67,4914.49,9749.00,0.00
2024-12-10 17:23:39,124,7484,56,68,4874.86,9749.01,0.00
2024-12-10 17:23:39,123,7484,55,68,4908.96,9749.06,0.00
2024-12-10 17:23:39,122,7484,55,67,4946.02,9749.08,0.00
2024-12-10 17:23:39,121,7484,54,67,4986.09,9749.08,0.00
2024-12-10 17:23:39,121,7485,54,67,4956.36,9750.00,0.00
2024-12-10 17:23:39,122,7485,54,68,4915.73,9750.01,0.00
2024-12-10 17:23:39,122,7486,54,68,4879.05,9751.00,0.00
2024-12-10 17:23:39,123,7486,54,69,4839.38,9751.01,0.00
2024-12-10 17:23:39,122,7486,53,69,4863.14,9751.09,0.00
2024-12-10 17:23:39,122,7487,53,69,4840.21,9752.00,0.00
2024-12-10 17:23:39,123,7487,53,70,4800.86,9752.01,0.00
2024-12-10 17:23:39,122,7487,53,69,4823.71,9752.09,0.00
2024-12-10 17:23:39,122,7488,53,69,4796.27,9753.00,0.00
2024-12-10 17:23:39,123,7488,53,70,4757.28,9753.01,0.00
2024-12-10 17:23:39,122,7488,53,69,4778.50,9753.10,0.00
2024-12-10 17:23:39,122,7489,53,69,4744.58,9754.00,0.00
2024-12-10 17:23:39,123,7489,54,69,4706.00,9754.01,0.00
2024-12-10 17:23:39,122,7489,53,69,4726.08,9754.10,0.00
2024-12-10 17:23:39,121,7489,52,69,4693.17,9754.74,0.00
2024-12-10 17:23:39,120,7489,52,68,4714.47,9754.83,0.00
2024-12-10 17:23:39,119,7489,52,67,4728.66,9754.94,0.00
2024-12-10 17:23:39,119,7490,52,67,4804.94,9755.00,0.00
2024-12-10 17:23:39,120,7490,53,67,4764.90,9755.01,0.00
2024-12-10 17:23:39,121,7489,54,67,4722.31,9755.06,0.00
2024-12-10 17:23:39,120,7489,53,67,4816.69,9755.11,0.00
2024-12-10 17:23:39,121,7488,54,67,4775.27,9755.14,0.00
2024-12-10 17:23:39,121,7489,54,67,4829.56,9756.00,0.00
2024-12-10 17:23:39,122,7489,55,67,4789.98,9756.01,0.00
2024-12-10 17:23:39,121,7489,55,66,4822.27,9756.08,0.00
2024-12-10 17:23:39,120,7489,54,66,4860.83,9756.09,0.00
2024-12-10 17:23:39,120,7490,54,66,4992.52,9757.00,0.00
2024-12-10 17:23:39,121,7490,54,67,4951.26,9757.01,0.00
2024-12-10 17:23:39,122,7489,54,68,4836.15,9757.72,0.00
2024-12-10 17:23:39,122,7490,54,68,4948.71,9758.00,0.00
2024-12-10 17:23:39,123,7490,54,69,4908.47,9758.01,0.00
2024-12-10 17:23:39,122,7490,54,68,4939.95,9758.09,0.00
2024-12-10 17:23:39,122,7491,54,68,4978.65,9759.00,0.00
2024-12-10 17:23:39,123,7491,54,69,4938.17,9759.01,0.00
2024-12-10 17:23:39,123,7492,54,69,4888.84,9760.00,0.00
2024-12-10 17:23:39,124,7492,54,70,4849.41,9760.01,0.00
2024-12-10 17:23:39,124,7493,54,70,4800.44,9761.00,0.00
2024-12-10 17:23:39,125,7493,54,71,4762.04,9761.01,0.00
2024-12-10 17:23:39,124,7493,53,71,4790.26,9761.10,0.00
2024-12-10 17:23:39,123,7493,53,70,4790.55,9761.50,0.00
2024-12-10 17:23:39,123,7494,53,70,4791.68,9762.00,0.00
2024-12-10 17:23:39,124,7494,53,71,4753.04,9762.01,0.00
2024-12-10 17:23:39,123,7494,53,70,4781.41,9762.11,0.00
2024-12-10 17:23:39,122,7494,52,70,4765.65,9762.62,0.00
2024-12-10 17:23:39,122,7495,52,70,4785.07,9763.00,0.00
2024-12-10 17:23:39,123,7495,52,71,4746.17,9763.01,0.00
2024-12-10 17:23:39,122,7495,51,71,4774.72,9763.11,0.00
2024-12-10 17:23:39,122,7496,51,71,4739.38,9764.00,0.00
2024-12-10 17:23:39,123,7496,51,72,4700.85,9764.01,0.00
2024-12-10 17:23:39,124,7495,51,73,4657.45,9764.08,0.00
2024-12-10 17:23:39,125,7494,52,73,4671.00,9764.21,0.00
2024-12-10 17:23:39,124,7494,51,73,4770.95,9764.30,0.00
2024-12-10 17:23:39,124,7495,51,73,4745.21,9765.00,0.00
2024-12-10 17:23:39,125,7495,51,74,4707.25,9765.01,0.00
2024-12-10 17:23:39,124,7495,51,73,4734.24,9765.11,0.00
2024-12-10 17:23:39,125,7494,51,74,4617.29,9765.71,0.00
2024-12-10 17:23:39,125,7495,51,74,4862.98,9766.00,0.00
2024-12-10 17:23:39,126,7495,51,75,4824.38,9766.01,0.00
2024-12-10 17:23:39,125,7495,51,74,4852.09,9766.11,0.00
2024-12-10 17:23:39,124,7495,51,73,4815.28,9766.68,0.00
2024-12-10 17:23:39,124,7496,51,73,4900.30,9767.00,0.00
2024-12-10 17:23:39,125,7496,52,73,4861.09,9767.01,0.00
2024-12-10 17:23:39,124,7496,51,73,4889.32,9767.11,0.00
2024-12-10 17:23:39,123,7496,51,72,4928.27,9767.11,0.00
2024-12-10 17:23:39,122,7496,51,71,4878.25,9767.70,0.00
2024-12-10 17:23:39,122,7497,51,71,4896.87,9768.00,0.00
2024-12-10 17:23:39,123,7497,52,71,4857.06,9768.01,0.00
2024-12-10 17:23:39,122,7497,52,70,4885.71,9768.12,0.00
2024-12-10 17:23:40,122,7498,52,70,4809.62,9769.00,0.00
2024-12-10 17:23:40,123,7498,52,71,4770.52,9769.01,0.00
2024-12-10 17:23:40,122,7498,52,70,4798.46,9769.12,0.00
2024-12-10 17:23:40,121,7498,52,69,4768.74,9769.65,0.00
2024-12-10 17:23:40,120,7498,52,68,4729.81,9769.88,0.00
2024-12-10 17:23:40,120,7499,52,68,4795.15,9770.00,0.00
2024-12-10 17:23:40,121,7499,52,69,4755.52,9770.01,0.00
2024-12-10 17:23:40,120,7499,52,68,4783.80,9770.12,0.00
2024-12-10 17:23:40,119,7499,51,68,4767.03,9770.61,0.00
2024-12-10 17:23:40,118,7499,50,68,4783.11,9770.68,0.00
2024-12-10 17:23:40,118,7500,50,68,4796.97,9771.00,0.00
2024-12-10 17:23:40,119,7500,51,68,4756.66,9771.01,0.00
2024-12-10 17:23:40,119,7501,51,68,4676.20,9772.00,0.00
2024-12-10 17:23:40,120,7501,52,68,4637.23,9772.01,0.00
2024-12-10 17:23:40,119,7501,52,67,4671.29,9772.05,0.00
2024-12-10 17:23:40,118,7501,52,66,4704.28,9772.11,0.00
2024-12-10 17:23:40,117,7501,51,66,4743.66,9772.11,0.00
2024-12-10 17:23:40,116,7501,51,65,4728.96,9772.64,0.00
2024-12-10 17:23:40,115,7501,51,64,4758.55,9772.64,0.00
2024-12-10 17:23:40,115,7502,51,64,4760.75,9773.00,0.00
2024-12-10 17:23:40,116,7502,51,65,4719.71,9773.01,0.00
2024-12-10 17:23:40,115,7502,50,65,4748.91,9773.12,0.00
2024-12-10 17:23:40,116,7501,50,66,4706.29,9773.16,0.00
2024-12-10 17:23:40,116,7502,50,66,4741.31,9774.00,0.00
2024-12-10 17:23:40,117,7502,50,67,4700.79,9774.01,0.00
2024-12-10 17:23:40,116,7502,50,66,4729.57,9774.12,0.00
2024-12-10 17:23:40,115,7502,49,66,4732.95,9774.48,0.00
2024-12-10 17:23:40,115,7503,49,66,4806.68,9775.00,0.00
2024-12-10 17:23:40,116,7503,50,66,4765.25,9775.01,0.00
2024-12-10 17:23:40,115,7503,50,65,4803.29,9775.04,0.00
2024-12-10 17:23:40,114,7503,50,64,4836.90,9775.11,0.00
2024-12-10 17:23:40,113,7503,49,64,4823.70,9775.66,0.00
2024-12-10 17:23:40,113,7504,49,64,4836.01,9776.00,0.00
2024-12-10 17:23:40,114,7504,50,64,4793.59,9776.01,0.00
2024-12-10 17:23:40,113,7504,50,63,4728.33,9776.90,0.00
2024-12-10 17:23:40,113,7505,50,63,4805.41,9777.00,0.00
2024-12-10 17:23:40,114,7505,51,63,4763.26,9777.01,0.00
2024-12-10 17:23:40,113,7505,50,63,4734.67,9777.67,0.00
2024-12-10 17:23:40,113,7506,50,63,4781.75,9778.00,0.00
2024-12-10 17:23:40,114,7506,50,64,4739.80,9778.01,0.00
2024-12-10 17:23:40,113,7506,50,63,4768.83,9778.13,0.00
2024-12-10 17:23:40,113,7507,50,63,4765.45,9779.00,0.00
2024-12-10 17:23:40,114,7507,50,64,4723.65,9779.01,0.00
2024-12-10 17:23:40,114,7508,50,64,4706.50,9780.00,0.00
2024-12-10 17:23:40,115,7508,50,65,4665.58,9780.01,0.00
2024-12-10 17:23:40,116,7507,51,65,4546.51,9780.78,0.00
2024-12-10 17:23:40,116,7508,51,65,4657.37,9781.00,0.00
2024-12-10 17:23:40,117,7508,51,66,4617.56,9781.01,0.00
2024-12-10 17:23:40,116,7508,51,65,4643.69,9781.13,0.00
2024-12-10 17:23:40,116,7509,51,65,4703.41,9782.00,0.00
2024-12-10 17:23:40,117,7509,51,66,4663.21,9782.01,0.00
2024-12-10 17:23:40,116,7509,51,65,4686.56,9782.13,0.00
2024-12-10 17:23:40,116,7510,51,65,4657.41,9783.00,0.00
2024-12-10 17:23:40,117,7510,52,65,4617.60,9783.01,0.00
2024-12-10 17:23:40,116,7510,51,65,4652.74,9783.02,0.00
2024-12-10 17:23:40,115,7510,50,65,4682.19,9783.12,0.00
2024-12-10 17:23:40,114,7510,49,65,4663.37,9783.64,0.00
2024-12-10 17:23:40,114,7511,49,65,4697.99,9784.00,0.00
2024-12-10 17:23:40,115,7511,49,66,4657.13,9784.01,0.00
2024-12-10 17:23:40,116,7510,49,67,4616.15,9784.03,0.00
2024-12-10 17:23:40,115,7510,48,67,4708.24,9784.13,0.00
2024-12-10 17:23:40,114,7510,47,67,4748.68,9784.13,0.00
2024-12-10 17:23:40,114,7511,47,67,4727.66,9785.00,0.00
2024-12-10 17:23:40,115,7511,48,67,4686.55,9785.01,0.00
2024-12-10 17:23:40,114,7511,48,66,4641.78,9785.75,0.00
2024-12-10 17:23:40,114,7512,48,66,4778.49,9786.00,0.00
2024-12-10 17:23:40,115,7512,48,67,4736.94,9786.01,0.00
2024-12-10 17:23:40,114,7512,48,66,4762.65,9786.12,0.00
2024-12-10 17:23:40,115,7511,48,67,4676.14,9786.51,0.00
2024-12-10 17:23:40,116,7510,48,68,4672.23,9786.65,0.00
2024-12-10 17:23:40,116,7511,48,68,4730.97,9787.00,0.00
2024-12-10 17:23:40,117,7511,49,68,4690.54,9787.01,0.00
2024-12-10 17:23:40,116,7511,48,68,4717.24,9787.09,0.00
2024-12-10 17:23:40,115,7511,48,67,4754.88,9787.11,0.00
2024-12-10 17:23:40,116,7510,49,67,4713.89,9787.13,0.00
2024-12-10 17:23:40,117,7509,50,67,4723.25,9787.38,0.00
2024-12-10 17:23:40,118,7508,50,68,4687.18,9787.81,0.00
2024-12-10 17:23:40,118,7509,50,68,4902.42,9788.00,0.00
2024-12-10 17:23:40,119,7509,50,69,4861.23,9788.01,0.00
2024-12-10 17:23:40,120,7508,51,69,4810.36,9788.11,0.00
2024-12-10 17:23:40,119,7508,50,69,4859.86,9788.13,0.00
2024-12-10 17:23:40,118,7508,49,69,4887.40,9788.23,0.00
2024-12-10 17:23:40,119,7507,50,69,4791.36,9788.51,0.00
2024-12-10 17:23:40,118,7507,50,68,4860.09,9788.60,0.00
2024-12-10 17:23:40,119,7506,51,68,4810.84,9788.65,0.00
2024-12-10 17:23:40,119,7507,51,68,5084.83,9789.00,0.00
2024-12-10 17:23:40,120,7507,51,69,5042.46,9789.01,0.00
2024-12-10 17:23:40,119,7507,51,68,5073.38,9789.12,0.00
2024-12-10 17:23:40,118,7507,51,67,5113.92,9789.14,0.00
2024-12-10 17:23:40,117,7507,50,67,5149.34,9789.21,0.00
2024-12-10 17:23:40,117,7508,50,67,5329.58,9790.00,0.00
2024-12-10 17:23:40,118,7508,51,67,5284.41,9790.01,0.00
2024-12-10 17:23:40,117,7508,50,67,5318.12,9790.12,0.00
2024-12-10 17:23:40,117,7509,50,67,5269.19,9791.00,0.00
2024-12-10 17:23:40,118,7509,51,67,5224.54,9791.01,0.00
2024-12-10 17:23:40,117,7509,50,67,5257.54,9791.12,0.00
2024-12-10 17:23:40,117,7510,50,67,5220.59,9792.00,0.00
2024-12-10 17:23:40,118,7510,51,67,5176.35,9792.01,0.00
2024-12-10 17:23:40,117,7510,50,67,5201.81,9792.20,0.00
2024-12-10 17:23:40,116,7510,49,67,5245.41,9792.21,0.00
2024-12-10 17:23:40,115,7510,48,67,5258.40,9792.37,0.00
2024-12-10 17:23:41,115,7511,48,67,5259.26,9793.00,0.00
2024-12-10 17:23:41,116,7511,49,67,5213.92,9793.01,0.00
2024-12-10 17:23:41,115,7511,49,66,5258.93,9793.01,0.00
2024-12-10 17:23:41,114,7511,49,65,5293.96,9793.11,0.00
2024-12-10 17:23:41,114,7512,49,65,5257.46,9794.00,0.00
2024-12-10 17:23:41,115,7512,50,65,5211.75,9794.01,0.00
2024-12-10 17:23:41,114,7512,50,64,5246.35,9794.11,0.00
2024-12-10 17:23:41,113,7512,50,63,5282.13,9794.20,0.00
2024-12-10 17:23:41,112,7512,49,63,5268.07,9794.71,0.00
2024-12-10 17:23:41,112,7513,49,63,5309.72,9795.00,0.00
2024-12-10 17:23:41,113,7513,49,64,5262.73,9795.01,0.00
2024-12-10 17:23:41,112,7513,48,64,5298.41,9795.12,0.00
2024-12-10 17:23:41,111,7513,47,64,5272.31,9795.79,0.00
2024-12-10 17:23:41,112,7512,47,65,5209.73,9795.93,0.00
2024-12-10 17:23:41,112,7513,47,65,5285.28,9796.00,0.00
2024-12-10 17:23:41,113,7513,47,66,5238.51,9796.01,0.00
2024-12-10 17:23:41,112,7513,47,65,5273.97,9796.12,0.00
2024-12-10 17:23:41,111,7513,47,64,5314.18,9796.19,0.00
2024-12-10 17:23:41,111,7514,47,64,5389.06,9797.00,0.00
2024-12-10 17:23:41,112,7514,47,65,5340.95,9797.01,0.00
2024-12-10 17:23:41,112,7515,47,65,5310.76,9798.00,0.00
2024-12-10 17:23:41,113,7515,47,66,5263.76,9798.01,0.00
2024-12-10 17:23:41,112,7515,46,66,5298.57,9798.13,0.00
2024-12-10 17:23:41,111,7515,46,65,5339.45,9798.19,0.00
2024-12-10 17:23:41,110,7515,46,64,5387.31,9798.19,0.00
2024-12-10 17:23:41,110,7516,46,64,5376.97,9799.00,0.00
2024-12-10 17:23:41,111,7516,47,64,5328.53,9799.01,0.00
2024-12-10 17:23:41,110,7516,47,63,5372.54,9799.05,0.00
2024-12-10 17:23:41,109,7516,47,62,5413.77,9799.12,0.00
2024-12-10 17:23:41,108,7516,47,61,5462.99,9799.12,0.00
2024-12-10 17:23:41,108,7517,47,61,5444.85,9800.00,0.00
2024-12-10 17:23:41,109,7517,48,61,5394.90,9800.01,0.00
2024-12-10 17:23:41,108,7517,47,61,5426.38,9800.19,0.00
2024-12-10 17:23:41,108,7518,47,61,5415.65,9801.00,0.00
2024-12-10 17:23:41,109,7518,47,62,5365.96,9801.01,0.00
2024-12-10 17:23:41,108,7518,47,61,5403.91,9801.12,0.00
2024-12-10 17:23:41,107,7518,47,60,5423.22,9801.41,0.00
2024-12-10 17:23:41,108,7517,47,61,5359.50,9801.52,0.00
2024-12-10 17:23:41,108,7518,47,61,5442.17,9802.00,0.00
2024-12-10 17:23:41,109,7518,47,62,5392.24,9802.01,0.00
2024-12-10 17:23:41,108,7518,47,61,5430.60,9802.12,0.00
2024-12-10 17:23:41,107,7518,47,60,5476.60,9802.17,0.00
2024-12-10 17:23:41,106,7518,46,60,5473.45,9802.58,0.00
2024-12-10 17:23:41,106,7519,46,60,5608.84,9803.00,0.00
2024-12-10 17:23:41,107,7519,47,60,5556.42,9803.01,0.00
2024-12-10 17:23:41,108,7518,48,60,5504.97,9803.03,0.00
2024-12-10 17:23:41,108,7519,48,60,5495.98,9804.00,0.00
2024-12-10 17:23:41,109,7519,48,61,5445.56,9804.01,0.00
2024-12-10 17:23:41,110,7518,49,61,5290.93,9804.94,0.00
2024-12-10 17:23:41,110,7519,49,61,5467.47,9805.00,0.00
2024-12-10 17:23:41,111,7519,49,62,5418.21,9805.01,0.00
2024-12-10 17:23:41,112,7518,50,62,5368.10,9805.05,0.00
2024-12-10 17:23:41,113,7517,51,62,5359.45,9805.34,0.00
2024-12-10 17:23:41,113,7518,51,62,5528.98,9806.00,0.00
2024-12-10 17:23:41,114,7518,51,63,5480.48,9806.01,0.00
2024-12-10 17:23:41,113,7518,50,63,5517.76,9806.12,0.00
2024-12-10 17:23:41,113,7519,50,63,5671.44,9807.00,0.00
2024-12-10 17:23:41,114,7519,51,63,5621.69,9807.01,0.00
2024-12-10 17:23:41,113,7519,50,63,5660.21,9807.12,0.00
2024-12-10 17:23:41,112,7519,50,62,5703.24,9807.19,0.00
2024-12-10 17:23:41,112,7520,50,62,5690.58,9808.00,0.00
2024-12-10 17:23:41,113,7520,51,62,5640.22,9808.01,0.00
2024-12-10 17:23:41,113,7521,51,62,5612.37,9809.00,0.00
2024-12-10 17:23:41,114,7521,51,63,5563.13,9809.01,0.00
2024-12-10 17:23:41,115,7520,51,64,5509.67,9809.08,0.00
2024-12-10 17:23:41,114,7520,50,64,5566.01,9809.58,0.00
2024-12-10 17:23:41,114,7521,50,64,5598.76,9810.00,0.00
2024-12-10 17:23:41,115,7521,50,65,5550.07,9810.01,0.00
2024-12-10 17:23:41,114,7521,50,64,5587.63,9810.11,0.00
2024-12-10 17:23:41,115,7520,51,64,5511.83,9810.41,0.00
2024-12-10 17:23:41,115,7521,51,64,5684.71,9811.00,0.00
2024-12-10 17:23:41,116,7521,52,64,5635.70,9811.01,0.00
2024-12-10 17:23:41,115,7521,51,64,5667.63,9811.18,0.00
2024-12-10 17:23:41,115,7522,51,64,5745.39,9812.00,0.00
2024-12-10 17:23:41,116,7522,52,64,5695.86,9812.01,0.00
2024-12-10 17:23:41,115,7522,51,64,5734.35,9812.11,0.00
2024-12-10 17:23:41,115,7523,51,64,5717.06,9813.00,0.00
2024-12-10 17:23:41,116,7523,51,65,5667.77,9813.01,0.00
2024-12-10 17:23:41,117,7522,52,65,5601.78,9813.21,0.00
2024-12-10 17:23:41,117,7523,52,65,5612.48,9814.00,0.00
2024-12-10 17:23:41,118,7523,52,66,5564.92,9814.01,0.00
2024-12-10 17:23:41,117,7523,52,65,5597.78,9814.15,0.00
2024-12-10 17:23:41,116,7523,52,64,5640.98,9814.20,0.00
2024-12-10 17:23:41,117,7522,53,64,5581.89,9814.31,0.00
2024-12-10 17:23:41,117,7523,53,64,5688.15,9815.00,0.00
2024-12-10 17:23:41,118,7523,54,64,5639.95,9815.01,0.00
2024-12-10 17:23:41,117,7523,53,64,5671.96,9815.17,0.00
2024-12-10 17:23:41,117,7524,53,64,5740.02,9816.00,0.00
2024-12-10 17:23:41,118,7524,54,64,5691.38,9816.01,0.00
2024-12-10 17:23:41,117,7524,53,64,5735.85,9816.04,0.00
2024-12-10 17:23:41,116,7524,53,63,5777.72,9816.11,0.00
2024-12-10 17:23:41,117,7523,54,63,5648.00,9816.75,0.00
2024-12-10 17:23:41,117,7524,54,63,5724.58,9817.00,0.00
2024-12-10 17:23:41,118,7524,54,64,5676.07,9817.01,0.00
2024-12-10 17:23:41,117,7524,53,64,5714.00,9817.11,0.00
2024-12-10 17:23:41,117,7525,53,64,5775.22,9818.00,0.00
2024-12-10 17:23:41,118,7525,53,65,5726.28,9818.01,0.00
2024-12-10 17:23:41,117,7525,52,65,5766.04,9818.09,0.00
2024-12-10 17:23:41,116,7525,51,65,5814.57,9818.10,0.00
2024-12-10 17:23:41,115,7525,51,64,5864.28,9818.10,0.00
2024-12-10 17:23:42,116,7524,52,64,5787.39,9818.31,0.00
2024-12-10 17:23:42,116,7525,52,64,5795.01,9819.00,0.00
2024-12-10 17:23:42,117,7525,53,64,5745.48,9819.01,0.00
2024-12-10 17:23:42,116,7525,53,63,5771.27,9819.19,0.00
2024-12-10 17:23:42,116,7526,53,63,5839.70,9820.00,0.00
2024-12-10 17:23:42,117,7526,54,63,5789.79,9820.01,0.00
2024-12-10 17:23:42,116,7526,53,63,5830.34,9820.10,0.00
2024-12-10 17:23:42,117,7525,54,63,5710.27,9820.64,0.00
2024-12-10 17:23:42,117,7526,54,63,5808.45,9821.00,0.00
2024-12-10 17:23:42,118,7526,54,64,5759.22,9821.01,0.00
2024-12-10 17:23:42,117,7526,54,63,5793.47,9821.14,0.00
2024-12-10 17:23:42,116,7526,54,62,5791.03,9821.50,0.00
2024-12-10 17:23:42,116,7527,54,62,5903.24,9822.00,0.00
2024-12-10 17:23:42,117,7527,55,62,5852.79,9822.01,0.00
2024-12-10 17:23:42,118,7526,55,63,5704.18,9822.85,0.00
2024-12-10 17:23:42,118,7527,55,63,5777.39,9823.00,0.00
2024-12-10 17:23:42,119,7527,55,64,5728.84,9823.01,0.00
2024-12-10 17:23:42,118,7527,54,64,5752.48,9823.24,0.00
2024-12-10 17:23:42,118,7528,54,64,5829.87,9824.00,0.00
2024-12-10 17:23:42,119,7528,55,64,5780.88,9824.01,0.00
2024-12-10 17:23:42,118,7528,54,64,5819.93,9824.10,0.00
2024-12-10 17:23:42,117,7528,54,63,5865.73,9824.14,0.00
2024-12-10 17:23:42,117,7529,54,63,5849.95,9825.00,0.00
2024-12-10 17:23:42,118,7529,54,64,5800.38,9825.01,0.00
2024-12-10 17:23:42,118,7530,54,64,5770.33,9826.00,0.00
2024-12-10 17:23:42,119,7530,54,65,5721.84,9826.01,0.00
2024-12-10 17:23:42,119,7531,54,65,5692.53,9827.00,0.00
2024-12-10 17:23:42,120,7531,55,65,5645.09,9827.01,0.00
2024-12-10 17:23:42,119,7531,55,64,5685.13,9827.08,0.00
2024-12-10 17:23:42,118,7531,54,64,5720.45,9827.20,0.00
2024-12-10 17:23:42,118,7532,54,64,5711.10,9828.00,0.00
2024-12-10 17:23:42,119,7532,55,64,5663.11,9828.01,0.00
2024-12-10 17:23:42,118,7532,55,63,5701.16,9828.10,0.00
2024-12-10 17:23:42,117,7532,54,63,5747.03,9828.13,0.00
2024-12-10 17:23:42,117,7533,54,63,5729.64,9829.00,0.00
2024-12-10 17:23:42,118,7533,54,64,5681.08,9829.01,0.00
2024-12-10 17:23:42,117,7533,54,63,5675.68,9829.40,0.00
2024-12-10 17:23:42,116,7533,54,62,5722.43,9829.41,0.00
2024-12-10 17:23:42,117,7532,55,62,5650.71,9829.59,0.00
2024-12-10 17:23:42,117,7533,55,62,5723.30,9830.00,0.00
2024-12-10 17:23:42,118,7533,55,63,5674.80,9830.01,0.00
2024-12-10 17:23:42,118,7534,55,63,5723.10,9831.00,0.00
2024-12-10 17:23:42,119,7534,56,63,5675.00,9831.01,0.00
2024-12-10 17:23:42,118,7534,56,62,5713.15,9831.10,0.00
2024-12-10 17:23:42,118,7535,56,62,5691.92,9832.00,0.00
2024-12-10 17:23:42,119,7535,57,62,5644.09,9832.01,0.00
2024-12-10 17:23:42,119,7536,57,62,5617.11,9833.00,0.00
2024-12-10 17:23:42,120,7536,58,62,5570.30,9833.01,0.00
2024-12-10 17:23:42,119,7536,58,61,5604.68,9833.14,0.00
2024-12-10 17:23:42,118,7536,57,61,5634.18,9833.29,0.00
2024-12-10 17:23:42,117,7536,56,61,5672.98,9833.35,0.00
2024-12-10 17:23:42,118,7535,57,61,5586.59,9833.70,0.00
2024-12-10 17:23:42,118,7536,57,61,5661.93,9834.00,0.00
2024-12-10 17:23:42,119,7536,58,61,5614.35,9834.01,0.00
2024-12-10 17:23:42,119,7537,58,61,5674.98,9835.00,0.00
2024-12-10 17:23:42,120,7537,58,62,5627.69,9835.01,0.00
2024-12-10 17:23:42,120,7538,58,62,5602.52,9836.00,0.00
2024-12-10 17:23:42,121,7538,58,63,5556.22,9836.01,0.00
2024-12-10 17:23:42,120,7538,58,62,5589.53,9836.13,0.00
2024-12-10 17:23:42,121,7537,58,63,5526.63,9836.27,0.00
2024-12-10 17:23:42,121,7538,58,63,5585.45,9837.00,0.00
2024-12-10 17:23:42,122,7538,58,64,5539.67,9837.01,0.00
2024-12-10 17:23:42,123,7537,58,65,5419.12,9837.68,0.00
2024-12-10 17:23:42,123,7538,58,65,5570.53,9838.00,0.00
2024-12-10 17:23:42,124,7538,59,65,5525.60,9838.01,0.00
2024-12-10 17:23:42,124,7539,59,65,5577.57,9839.00,0.00
2024-12-10 17:23:42,125,7539,60,65,5532.95,9839.01,0.00
2024-12-10 17:23:42,124,7539,60,64,5563.58,9839.15,0.00
2024-12-10 17:23:42,123,7539,59,64,5566.30,9839.48,0.00
2024-12-10 17:23:42,123,7540,59,64,5593.06,9840.00,0.00
2024-12-10 17:23:42,124,7540,59,65,5547.96,9840.01,0.00
2024-12-10 17:23:42,124,7541,59,65,5520.90,9841.00,0.00
2024-12-10 17:23:42,125,7541,59,66,5476.73,9841.01,0.00
2024-12-10 17:23:42,124,7541,59,65,5500.81,9841.21,0.00
2024-12-10 17:23:42,124,7542,59,65,5493.00,9842.00,0.00
2024-12-10 17:23:42,125,7542,60,65,5449.06,9842.01,0.00
2024-12-10 17:23:42,125,7543,60,65,5417.38,9843.00,0.00
2024-12-10 17:23:42,126,7543,60,66,5374.39,9843.01,0.00
2024-12-10 17:23:42,125,7543,60,65,5406.41,9843.11,0.00
2024-12-10 17:23:42,124,7543,60,64,5448.38,9843.13,0.00
2024-12-10 17:23:42,124,7544,60,64,5431.26,9844.00,0.00
2024-12-10 17:23:42,125,7544,60,65,5387.81,9844.01,0.00
2024-12-10 17:23:43,125,7545,60,65,5363.48,9845.00,0.00
2024-12-10 17:23:43,126,7545,61,65,5320.92,9845.01,0.00
2024-12-10 17:23:43,127,7544,61,66,5275.16,9845.06,0.00
2024-12-10 17:23:43,126,7544,60,66,5338.15,9845.12,0.00
2024-12-10 17:23:43,125,7544,60,65,5352.80,9845.38,0.00
2024-12-10 17:23:43,125,7544,60,65,5366.44,9846.00,0.00
2024-12-10 17:23:43,126,7544,60,66,5323.85,9846.01,0.00
2024-12-10 17:23:43,125,7544,60,65,5317.61,9846.41,0.00
2024-12-10 17:23:43,125,7545,60,65,5417.28,9847.00,0.00
2024-12-10 17:23:43,126,7545,61,65,5374.28,9847.01,0.00
2024-12-10 17:23:43,127,7544,61,66,5325.01,9847.10,0.00
2024-12-10 17:23:43,126,7544,61,65,5406.82,9847.16,0.00
2024-12-10 17:23:43,125,7544,61,64,5424.67,9847.38,0.00
2024-12-10 17:23:43,125,7545,61,64,5442.19,9848.00,0.00
2024-12-10 17:23:43,126,7545,61,65,5399.00,9848.01,0.00
2024-12-10 17:23:43,127,7544,62,65,5352.62,9848.06,0.00
2024-12-10 17:23:43,127,7545,62,65,5413.78,9849.00,0.00
2024-12-10 17:23:43,128,7545,62,66,5371.49,9849.01,0.00
2024-12-10 17:23:43,128,7546,62,66,5422.65,9850.00,0.00
2024-12-10 17:23:43,129,7546,63,66,5380.62,9850.01,0.00
2024-12-10 17:23:43,128,7546,63,65,5399.55,9850.22,0.00
2024-12-10 17:23:43,128,7547,63,65,5398.17,9851.00,0.00
2024-12-10 17:23:43,129,7547,63,66,5356.33,9851.01,0.00
2024-12-10 17:23:43,128,7547,63,65,5385.01,9851.14,0.00
2024-12-10 17:23:43,127,7547,63,64,5425.56,9851.16,0.00
2024-12-10 17:23:43,127,7548,63,64,5418.87,9852.00,0.00
2024-12-10 17:23:43,128,7548,63,65,5376.53,9852.01,0.00
2024-12-10 17:23:43,127,7548,63,64,5403.74,9852.16,0.00
2024-12-10 17:23:43,127,7549,63,64,5396.92,9853.00,0.00
2024-12-10 17:23:43,128,7549,64,64,5354.75,9853.01,0.00
2024-12-10 17:23:43,129,7548,64,65,5261.94,9853.54,0.00
2024-12-10 17:23:43,129,7549,64,65,5324.62,9854.00,0.00
2024-12-10 17:23:43,130,7549,65,65,5283.67,9854.01,0.00
2024-12-10 17:23:43,131,7548,66,65,5235.84,9854.10,0.00
2024-12-10 17:23:43,131,7549,66,65,5322.20,9855.00,0.00
2024-12-10 17:23:43,132,7549,66,66,5281.88,9855.01,0.00
2024-12-10 17:23:43,131,7549,65,66,5320.70,9855.02,0.00
2024-12-10 17:23:43,130,7549,64,66,5359.36,9855.03,0.00
2024-12-10 17:23:43,129,7549,63,66,5392.54,9855.11,0.00
2024-12-10 17:23:43,130,7548,63,67,5311.37,9855.50,0.00
2024-12-10 17:23:43,130,7549,63,67,5425.02,9856.00,0.00
2024-12-10 17:23:43,131,7549,63,68,5383.61,9856.01,0.00
2024-12-10 17:23:43,130,7549,63,67,5411.22,9856.15,0.00
2024-12-10 17:23:43,129,7549,63,66,5452.58,9856.15,0.00
2024-12-10 17:23:43,130,7548,64,66,5351.80,9856.66,0.00
2024-12-10 17:23:43,130,7549,64,66,5495.38,9857.00,0.00
2024-12-10 17:23:43,131,7549,64,67,5453.43,9857.01,0.00
2024-12-10 17:23:43,130,7549,63,67,5478.66,9857.15,0.00
2024-12-10 17:23:43,130,7550,63,67,5538.96,9858.00,0.00
2024-12-10 17:23:43,131,7550,63,68,5496.68,9858.01,0.00
2024-12-10 17:23:43,130,7550,63,67,5499.04,9858.35,0.00
2024-12-10 17:23:43,130,7551,63,67,5507.93,9859.00,0.00
2024-12-10 17:23:43,131,7551,63,68,5465.89,9859.01,0.00
2024-12-10 17:23:43,130,7551,63,67,5493.14,9859.15,0.00
2024-12-10 17:23:43,131,7550,63,68,5437.69,9859.29,0.00
2024-12-10 17:23:43,131,7551,63,68,5493.93,9860.00,0.00
2024-12-10 17:23:43,132,7551,63,69,5452.31,9860.01,0.00
2024-12-10 17:23:43,131,7551,63,68,5482.14,9860.12,0.00
2024-12-10 17:23:43,131,7552,63,68,5546.43,9861.00,0.00
2024-12-10 17:23:43,132,7552,63,69,5504.42,9861.01,0.00
2024-12-10 17:23:43,132,7553,63,69,5481.22,9862.00,0.00
2024-12-10 17:23:43,133,7553,64,69,5440.01,9862.01,0.00
2024-12-10 17:23:43,132,7553,63,69,5466.01,9862.16,0.00
2024-12-10 17:23:43,132,7554,63,69,5457.45,9863.00,0.00
2024-12-10 17:23:43,133,7554,63,70,5416.42,9863.01,0.00
2024-12-10 17:23:43,134,7553,63,71,5315.34,9863.61,0.00
2024-12-10 17:23:43,134,7554,63,71,5380.44,9864.00,0.00
2024-12-10 17:23:43,135,7554,63,72,5340.58,9864.01,0.00
2024-12-10 17:23:43,134,7554,63,71,5378.23,9864.02,0.00
2024-12-10 17:23:43,133,7554,63,70,5417.19,9864.03,0.00
2024-12-10 17:23:43,132,7554,63,69,5450.05,9864.11,0.00
2024-12-10 17:23:43,132,7555,63,69,5504.87,9865.00,0.00
2024-12-10 17:23:43,133,7555,64,69,5463.48,9865.01,0.00
2024-12-10 17:23:43,134,7554,65,69,5402.16,9865.23,0.00
2024-12-10 17:23:43,133,7554,64,69,5500.45,9865.26,0.00
2024-12-10 17:23:43,133,7555,64,69,5489.35,9866.00,0.00
2024-12-10 17:23:43,134,7555,65,69,5448.39,9866.01,0.00
2024-12-10 17:23:43,135,7554,65,70,5390.22,9866.20,0.00
2024-12-10 17:23:43,134,7554,64,70,5487.19,9866.21,0.00
2024-12-10 17:23:43,133,7554,63,70,5495.97,9866.34,0.00
2024-12-10 17:23:43,133,7555,63,70,5554.27,9867.00,0.00
2024-12-10 17:23:43,134,7555,63,71,5512.82,9867.01,0.00
2024-12-10 17:23:43,133,7555,62,71,5509.54,9867.17,0.00
2024-12-10 17:23:43,132,7555,62,70,5448.06,9867.77,0.00
2024-12-10 17:23:44,132,7556,62,70,5574.59,9868.00,0.00
2024-12-10 17:23:44,133,7556,62,71,5532.68,9868.01,0.00
2024-12-10 17:23:44,132,7556,61,71,5542.25,9868.05,0.00
2024-12-10 17:23:44,132,7557,61,71,5442.20,9869.00,0.00
2024-12-10 17:23:44,133,7557,61,72,5401.28,9869.01,0.00
2024-12-10 17:23:44,132,7557,61,71,5431.77,9869.11,0.00
2024-12-10 17:23:44,131,7557,61,70,5467.50,9869.16,0.00
2024-12-10 17:23:44,130,7557,60,70,5419.32,9869.62,0.00
2024-12-10 17:23:44,129,7557,59,70,5399.86,9869.80,0.00
2024-12-10 17:23:44,129,7558,59,70,5410.88,9870.00,0.00
2024-12-10 17:23:44,130,7558,60,70,5369.26,9870.01,0.00
2024-12-10 17:23:44,129,7558,59,70,5349.93,9870.19,0.00
2024-12-10 17:23:44,128,7558,58,70,5372.68,9870.34,0.00
2024-12-10 17:23:44,127,7558,58,69,5340.67,9870.80,0.00
2024-12-10 17:23:44,127,7559,58,69,5398.36,9871.00,0.00
2024-12-10 17:23:44,128,7559,59,69,5356.19,9871.01,0.00
2024-12-10 17:23:44,127,7559,59,68,5312.84,9871.35,0.00
2024-12-10 17:23:44,128,7558,59,69,5217.99,9871.90,0.00
2024-12-10 17:23:44,128,7559,59,69,5292.77,9872.00,0.00
2024-12-10 17:23:44,129,7559,59,70,5251.74,9872.01,0.00
2024-12-10 17:23:44,128,7559,59,69,5267.37,9872.25,0.00
2024-12-10 17:23:44,127,7559,59,68,5291.06,9872.28,0.00
2024-12-10 17:23:44,127,7560,59,68,5375.88,9873.00,0.00
2024-12-10 17:23:44,128,7560,59,69,5333.88,9873.01,0.00
2024-12-10 17:23:44,129,7559,60,69,5290.25,9873.05,0.00
2024-12-10 17:23:44,128,7559,60,68,5388.69,9873.12,0.00
2024-12-10 17:23:44,127,7559,60,67,5426.46,9873.14,0.00
2024-12-10 17:23:44,126,7559,59,67,5462.84,9873.21,0.00
2024-12-10 17:23:44,126,7560,59,67,5458.56,9874.00,0.00
2024-12-10 17:23:44,127,7560,59,68,5415.58,9874.01,0.00
2024-12-10 17:23:44,126,7560,59,67,5446.64,9874.11,0.00
2024-12-10 17:23:44,125,7560,59,66,5488.67,9874.12,0.00
2024-12-10 17:23:44,125,7561,59,66,5518.65,9875.00,0.00
2024-12-10 17:23:44,126,7561,59,67,5474.85,9875.01,0.00
2024-12-10 17:23:44,125,7561,58,67,5448.88,9875.58,0.00
2024-12-10 17:23:44,124,7561,58,66,5423.98,9875.83,0.00
2024-12-10 17:23:44,124,7562,58,66,5484.25,9876.00,0.00
2024-12-10 17:23:44,125,7562,59,66,5440.38,9876.01,0.00
2024-12-10 17:23:44,125,7563,59,66,5370.95,9877.00,0.00
2024-12-10 17:23:44,126,7563,60,66,5328.32,9877.01,0.00
2024-12-10 17:23:44,125,7563,60,65,5361.12,9877.06,0.00
2024-12-10 17:23:44,124,7563,60,64,5298.30,9877.82,0.00
2024-12-10 17:23:44,124,7564,60,64,5335.64,9878.00,0.00
2024-12-10 17:23:44,125,7564,60,65,5292.95,9878.01,0.00
2024-12-10 17:23:44,124,7564,60,64,5325.32,9878.10,0.00
2024-12-10 17:23:44,125,7563,61,64,5274.04,9878.21,0.00
2024-12-10 17:23:44,124,7563,61,63,5354.86,9878.31,0.00
2024-12-10 17:23:44,123,7563,61,62,5276.58,9878.82,0.00
2024-12-10 17:23:44,123,7564,61,62,5321.53,9879.00,0.00
2024-12-10 17:23:44,124,7564,61,63,5278.62,9879.01,0.00
2024-12-10 17:23:44,123,7564,61,62,5195.20,9879.80,0.00
2024-12-10 17:23:44,123,7565,61,62,5291.86,9880.00,0.00
2024-12-10 17:23:44,124,7565,61,63,5249.19,9880.01,0.00
2024-12-10 17:23:44,123,7565,61,62,5184.03,9880.92,0.00
2024-12-10 17:23:44,123,7566,61,62,5256.40,9881.00,0.00
2024-12-10 17:23:44,124,7566,61,63,5214.01,9881.01,0.00
2024-12-10 17:23:44,123,7566,60,63,5240.17,9881.17,0.00
2024-12-10 17:23:44,123,7567,60,63,5231.13,9882.00,0.00
2024-12-10 17:23:44,124,7567,61,63,5188.95,9882.01,0.00
2024-12-10 17:23:44,124,7568,61,63,5160.08,9883.00,0.00
2024-12-10 17:23:44,125,7568,62,63,5118.80,9883.01,0.00
2024-12-10 17:23:44,124,7568,61,63,5149.75,9883.10,0.00
2024-12-10 17:23:44,123,7568,60,63,5161.01,9883.41,0.00
2024-12-10 17:23:44,123,7569,60,63,5169.55,9884.00,0.00
2024-12-10 17:23:44,124,7569,60,64,5127.86,9884.01,0.00
2024-12-10 17:23:44,123,7569,60,63,5159.13,9884.11,0.00
2024-12-10 17:23:44,123,7570,60,63,5104.01,9885.00,0.00
2024-12-10 17:23:44,124,7570,60,64,5062.85,9885.01,0.00
2024-12-10 17:23:44,123,7570,59,64,4968.79,9885.83,0.00
2024-12-10 17:23:44,123,7571,59,64,5028.69,9886.00,0.00
2024-12-10 17:23:44,124,7571,60,64,4988.13,9886.01,0.00
2024-12-10 17:23:44,123,7571,60,63,5017.47,9886.11,0.00
2024-12-10 17:23:44,123,7572,60,63,4910.63,9887.00,0.00
2024-12-10 17:23:44,124,7572,61,63,4871.03,9887.01,0.00
2024-12-10 17:23:44,123,7572,60,63,4906.63,9887.04,0.00
2024-12-10 17:23:44,122,7572,59,63,4939.57,9887.11,0.00
2024-12-10 17:23:44,121,7572,58,63,4891.97,9887.81,0.00
2024-12-10 17:23:44,120,7572,58,62,4895.44,9887.83,0.00
2024-12-10 17:23:44,119,7572,58,61,4912.96,9887.84,0.00
2024-12-10 17:23:44,119,7573,58,61,4906.49,9888.00,0.00
2024-12-10 17:23:44,120,7573,58,62,4865.60,9888.01,0.00
2024-12-10 17:23:44,119,7573,57,62,4901.52,9888.05,0.00
2024-12-10 17:23:44,118,7573,56,62,4941.39,9888.06,0.00
2024-12-10 17:23:44,117,7573,55,62,4977.72,9888.11,0.00
2024-12-10 17:23:44,116,7573,54,62,5005.35,9888.26,0.00
2024-12-10 17:23:44,115,7573,54,61,4965.90,9888.85,0.00
2024-12-10 17:23:44,114,7573,54,60,4963.20,9888.86,0.00
2024-12-10 17:23:45,114,7574,54,60,5032.05,9889.00,0.00
2024-12-10 17:23:45,115,7574,55,60,4988.30,9889.01,0.00
2024-12-10 17:23:45,116,7573,55,61,4796.41,9889.91,0.00
2024-12-10 17:23:45,116,7574,55,61,4880.91,9890.00,0.00
2024-12-10 17:23:45,117,7574,55,62,4839.19,9890.01,0.00
2024-12-10 17:23:45,116,7574,54,62,4875.74,9890.06,0.00
2024-12-10 17:23:45,115,7574,54,61,4870.36,9890.51,0.00
2024-12-10 17:23:45,114,7574,54,60,4823.73,9890.86,0.00
2024-12-10 17:23:45,114,7575,54,60,4983.49,9891.00,0.00
2024-12-10 17:23:45,115,7575,54,61,4940.15,9891.01,0.00
2024-12-10 17:23:45,115,7576,54,61,4867.15,9892.00,0.00
2024-12-10 17:23:45,116,7576,55,61,4825.19,9892.01,0.00
2024-12-10 17:23:45,115,7576,55,60,4840.45,9892.20,0.00
2024-12-10 17:23:45,114,7576,54,60,4820.36,9892.82,0.00
2024-12-10 17:23:45,114,7577,54,60,4833.56,9893.00,0.00
2024-12-10 17:23:45,115,7577,55,60,4791.53,9893.01,0.00
2024-12-10 17:23:45,114,7577,55,59,4746.47,9893.86,0.00
2024-12-10 17:23:45,114,7578,55,59,4819.50,9894.00,0.00
2024-12-10 17:23:45,115,7578,56,59,4777.59,9894.01,0.00
2024-12-10 17:23:45,115,7579,56,59,4765.60,9895.00,0.00
2024-12-10 17:23:45,116,7579,57,59,4724.52,9895.01,0.00
2024-12-10 17:23:45,115,7579,56,59,4757.02,9895.09,0.00
2024-12-10 17:23:45,114,7579,56,58,4796.16,9895.11,0.00
2024-12-10 17:23:45,115,7578,56,59,4713.65,9895.53,0.00
2024-12-10 17:23:45,115,7579,56,59,4800.17,9896.00,0.00
2024-12-10 17:23:45,116,7579,56,60,4758.79,9896.01,0.00
2024-12-10 17:23:45,116,7580,56,60,4816.17,9897.00,0.00
2024-12-10 17:23:45,117,7580,56,61,4775.00,9897.01,0.00
2024-12-10 17:23:45,118,7579,57,61,4657.92,9897.79,0.00
2024-12-10 17:23:45,118,7580,57,61,4690.79,9898.00,0.00
2024-12-10 17:23:45,119,7580,58,61,4651.37,9898.01,0.00
2024-12-10 17:23:45,118,7580,57,61,4610.25,9898.80,0.00
2024-12-10 17:23:45,118,7581,57,61,4721.08,9899.00,0.00
2024-12-10 17:23:45,119,7581,58,61,4681.41,9899.01,0.00
2024-12-10 17:23:45,118,7581,57,61,4708.23,9899.12,0.00
2024-12-10 17:23:45,117,7581,57,60,4639.06,9899.85,0.00
2024-12-10 17:23:45,117,7582,57,60,4672.73,9900.00,0.00
2024-12-10 17:23:45,118,7582,57,61,4633.13,9900.01,0.00
2024-12-10 17:23:45,117,7582,56,61,4642.01,9900.12,0.00
2024-12-10 17:23:45,118,7581,57,61,4517.98,9900.86,0.00
2024-12-10 17:23:45,117,7581,56,61,4529.83,9900.87,0.00
2024-12-10 17:23:45,117,7582,56,61,4601.87,9901.00,0.00
2024-12-10 17:23:45,118,7582,57,61,4562.88,9901.01,0.00
2024-12-10 17:23:45,117,7582,57,60,4595.97,9901.06,0.00
2024-12-10 17:23:45,116,7582,56,60,4628.54,9901.09,0.00
2024-12-10 17:23:45,115,7582,56,59,4666.21,9901.10,0.00
2024-12-10 17:23:45,114,7582,55,59,4653.89,9901.54,0.00
2024-12-10 17:23:45,114,7583,55,59,4724.03,9902.00,0.00
2024-12-10 17:23:45,115,7583,55,60,4682.95,9902.01,0.00
2024-12-10 17:23:45,114,7583,55,59,4713.64,9902.11,0.00
2024-12-10 17:23:45,113,7583,55,58,4684.24,9902.76,0.00
2024-12-10 17:23:45,113,7584,55,58,4660.13,9903.00,0.00
2024-12-10 17:23:45,114,7584,55,59,4619.25,9903.01,0.00
2024-12-10 17:23:45,113,7584,54,59,4659.25,9903.01,0.00
2024-12-10 17:23:45,112,7584,53,59,4691.16,9903.10,0.00
2024-12-10 17:23:45,111,7584,52,59,4708.25,9903.35,0.00
2024-12-10 17:23:45,112,7583,52,60,4625.80,9903.77,0.00
2024-12-10 17:23:45,111,7583,52,59,4638.96,9903.87,0.00
2024-12-10 17:23:45,110,7583,51,59,4665.65,9903.88,0.00
2024-12-10 17:23:45,110,7584,51,59,4737.55,9904.00,0.00
2024-12-10 17:23:45,111,7584,51,60,4694.87,9904.01,0.00
2024-12-10 17:23:45,110,7584,51,59,4728.58,9904.09,0.00
2024-12-10 17:23:45,109,7584,51,58,4771.05,9904.09,0.00
2024-12-10 17:23:45,108,7584,50,58,4814.31,9904.09,0.00
2024-12-10 17:23:45,109,7583,51,58,4751.09,9904.30,0.00
2024-12-10 17:23:45,109,7584,51,58,4852.62,9905.00,0.00
2024-12-10 17:23:45,110,7584,51,59,4808.51,9905.01,0.00
2024-12-10 17:23:45,109,7584,50,59,4851.72,9905.01,0.00
2024-12-10 17:23:45,108,7584,49,59,4888.42,9905.08,0.00
2024-12-10 17:23:45,107,7584,49,58,4818.96,9905.89,0.00
2024-12-10 17:23:45,107,7585,49,58,4993.10,9906.00,0.00
2024-12-10 17:23:45,108,7585,50,58,4946.87,9906.01,0.00
2024-12-10 17:23:45,109,7584,50,59,4899.67,9906.05,0.00
2024-12-10 17:23:45,108,7584,49,59,4972.95,9906.23,0.00
2024-12-10 17:23:45,107,7584,49,58,4998.26,9906.41,0.00
2024-12-10 17:23:45,107,7585,49,58,5032.46,9907.00,0.00
2024-12-10 17:23:45,108,7585,50,58,4985.86,9907.01,0.00
2024-12-10 17:23:45,109,7584,50,59,4871.30,9907.73,0.00
2024-12-10 17:23:45,109,7585,50,59,4993.18,9908.00,0.00
2024-12-10 17:23:45,110,7585,50,60,4947.79,9908.01,0.00
2024-12-10 17:23:45,111,7584,50,61,4850.71,9908.56,0.00
2024-12-10 17:23:45,110,7584,49,61,4865.91,9908.87,0.00
2024-12-10 17:23:45,110,7585,49,61,5033.57,9909.00,0.00
2024-12-10 17:23:45,111,7585,50,61,4988.22,9909.01,0.00
2024-12-10 17:23:45,111,7586,50,61,5069.08,9910.00,0.00
2024-12-10 17:23:45,112,7586,50,62,5023.82,9910.01,0.00
2024-12-10 17:23:45,111,7586,50,61,5058.41,9910.11,0.00
2024-12-10 17:23:45,111,7587,50,61,5059.77,9911.00,0.00
2024-12-10 17:23:45,112,7587,50,62,5014.59,9911.01,0.00
2024-12-10 17:23:45,111,7587,49,62,5049.09,9911.11,0.00
2024-12-10 17:23:45,110,7587,48,62,5085.07,9911.21,0.00
2024-12-10 17:23:45,110,7588,48,62,5097.25,9912.00,0.00
2024-12-10 17:23:45,111,7588,49,62,5051.33,9912.01,0.00
2024-12-10 17:23:45,110,7588,48,62,5086.48,9912.11,0.00
2024-12-10 17:23:45,111,7587,49,62,5004.13,9912.50,0.00
2024-12-10 17:23:45,112,7586,50,62,4988.86,9912.59,0.00
2024-12-10 17:23:45,112,7587,50,62,5080.35,9913.00,0.00
2024-12-10 17:23:45,113,7587,50,63,5035.40,9913.01,0.00
2024-12-10 17:23:45,112,7587,50,62,5069.77,9913.11,0.00
2024-12-10 17:23:45,111,7587,49,62,5114.55,9913.11,0.00
2024-12-10 17:23:45,110,7587,48,62,5158.51,9913.13,0.00
2024-12-10 17:23:45,109,7587,47,62,5141.23,9913.52,0.00
2024-12-10 17:23:46,109,7588,47,62,5367.16,9914.00,0.00
2024-12-10 17:23:46,110,7588,48,62,5318.36,9914.01,0.00
2024-12-10 17:23:46,109,7588,48,61,5363.53,9914.04,0.00
2024-12-10 17:23:46,108,7588,48,60,5405.88,9914.10,0.00
2024-12-10 17:23:46,107,7588,47,60,5455.47,9914.10,0.00
2024-12-10 17:23:46,107,7589,47,60,5444.96,9915.00,0.00
2024-12-10 17:23:46,108,7589,47,61,5394.54,9915.01,0.00
2024-12-10 17:23:46,108,7590,47,61,5330.63,9916.00,0.00
2024-12-10 17:23:46,109,7590,47,62,5281.73,9916.01,0.00
2024-12-10 17:23:46,108,7590,46,62,5320.57,9916.10,0.00
2024-12-10 17:23:46,107,7590,45,62,5369.37,9916.10,0.00
2024-12-10 17:23:46,106,7590,45,61,5297.99,9916.82,0.00
2024-12-10 17:23:46,106,7591,45,61,5373.93,9917.00,0.00
2024-12-10 17:23:46,107,7591,45,62,5323.71,9917.01,0.00
2024-12-10 17:23:46,106,7591,45,61,5363.68,9917.10,0.00
2024-12-10 17:23:46,106,7592,45,61,5282.87,9918.00,0.00
2024-12-10 17:23:46,107,7592,46,61,5233.50,9918.01,0.00
2024-12-10 17:23:46,106,7592,46,60,5272.66,9918.10,0.00
2024-12-10 17:23:46,105,7592,45,60,5290.04,9918.41,0.00
2024-12-10 17:23:46,105,7593,45,60,5283.23,9919.00,0.00
2024-12-10 17:23:46,106,7593,45,61,5233.38,9919.01,0.00
2024-12-10 17:23:46,105,7593,44,61,5178.61,9919.93,0.00
2024-12-10 17:23:46,105,7594,44,61,5266.53,9920.00,0.00
2024-12-10 17:23:46,106,7594,44,62,5216.85,9920.01,0.00
2024-12-10 17:23:46,105,7594,43,62,5256.17,9920.10,0.00
2024-12-10 17:23:46,106,7593,44,62,5156.23,9920.63,0.00
2024-12-10 17:23:46,106,7594,44,62,5182.22,9921.00,0.00
2024-12-10 17:23:46,107,7594,45,62,5133.79,9921.01,0.00
2024-12-10 17:23:46,106,7594,45,61,5171.96,9921.10,0.00
2024-12-10 17:23:46,107,7593,46,61,5058.09,9921.79,0.00
2024-12-10 17:23:46,106,7593,46,60,5085.00,9921.79,0.00
2024-12-10 17:23:46,106,7594,46,60,5217.02,9922.00,0.00
2024-12-10 17:23:46,107,7594,47,60,5168.27,9922.01,0.00
2024-12-10 17:23:46,106,7594,47,59,5207.70,9922.10,0.00
2024-12-10 17:23:46,105,7594,46,59,5176.80,9922.80,0.00
2024-12-10 17:23:46,105,7595,46,59,5346.13,9923.00,0.00
2024-12-10 17:23:46,106,7595,46,60,5295.70,9923.01,0.00
2024-12-10 17:23:46,105,7595,46,59,5334.00,9923.11,0.00
2024-12-10 17:23:46,105,7596,46,59,5341.11,9924.00,0.00
2024-12-10 17:23:46,106,7596,47,59,5290.72,9924.01,0.00
2024-12-10 17:23:46,105,7596,46,59,5327.64,9924.11,0.00
2024-12-10 17:23:46,105,7597,46,59,5334.75,9925.00,0.00
2024-12-10 17:23:46,106,7597,47,59,5284.42,9925.01,0.00
2024-12-10 17:23:46,105,7597,47,58,5319.94,9925.11,0.00
2024-12-10 17:23:46,105,7598,47,58,5327.05,9926.00,0.00
2024-12-10 17:23:46,106,7598,48,58,5276.80,9926.01,0.00
2024-12-10 17:23:46,105,7598,48,57,5310.94,9926.11,0.00
2024-12-10 17:23:46,105,7599,48,57,5316.60,9927.00,0.00
2024-12-10 17:23:46,106,7599,49,57,5266.44,9927.01,0.00
2024-12-10 17:23:46,106,7600,49,57,5253.94,9928.00,0.00
2024-12-10 17:23:46,107,7600,49,58,5204.83,9928.01,0.00
2024-12-10 17:23:46,106,7600,48,58,5236.16,9928.11,0.00
2024-12-10 17:23:46,106,7601,48,58,5238.72,9929.00,0.00
2024-12-10 17:23:46,107,7601,48,59,5189.76,9929.01,0.00
2024-12-10 17:23:46,106,7601,48,58,5220.49,9929.11,0.00
2024-12-10 17:23:46,105,7601,47,58,5269.26,9929.11,0.00
2024-12-10 17:23:46,105,7602,47,58,5235.42,9930.00,0.00
2024-12-10 17:23:46,106,7602,48,58,5186.03,9930.01,0.00
2024-12-10 17:23:46,105,7602,48,57,5217.05,9930.11,0.00
2024-12-10 17:23:46,106,7601,48,58,5098.32,9930.77,0.00
2024-12-10 17:23:46,106,7602,48,58,5113.65,9931.00,0.00
2024-12-10 17:23:46,107,7602,49,58,5065.86,9931.01,0.00
2024-12-10 17:23:46,106,7602,49,57,5100.68,9931.07,0.00
2024-12-10 17:23:46,105,7602,48,57,5033.15,9931.79,0.00
2024-12-10 17:23:46,104,7602,48,56,5074.88,9931.81,0.00
2024-12-10 17:23:46,104,7603,48,56,5246.93,9932.00,0.00
2024-12-10 17:23:46,105,7603,49,56,5196.96,9932.01,0.00
2024-12-10 17:23:46,104,7603,48,56,5236.46,9932.11,0.00
2024-12-10 17:23:46,104,7604,48,56,5200.65,9933.00,0.00
2024-12-10 17:23:46,105,7604,48,57,5151.12,9933.01,0.00
2024-12-10 17:23:46,104,7604,47,57,5190.18,9933.11,0.00
2024-12-10 17:23:46,104,7605,47,57,5109.73,9934.00,0.00
2024-12-10 17:23:46,105,7605,48,57,5061.07,9934.01,0.00
2024-12-10 17:23:46,104,7605,47,57,5099.25,9934.11,0.00
2024-12-10 17:23:46,103,7605,47,56,5036.40,9934.81,0.00
2024-12-10 17:23:46,102,7605,47,55,5078.83,9934.81,0.00
2024-12-10 17:23:46,102,7606,47,55,5157.89,9935.00,0.00
2024-12-10 17:23:46,103,7606,48,55,5107.81,9935.01,0.00
2024-12-10 17:23:46,102,7606,48,54,5147.21,9935.11,0.00
2024-12-10 17:23:46,102,7607,48,54,5144.36,9936.00,0.00
2024-12-10 17:23:46,103,7607,49,54,5094.42,9936.01,0.00
2024-12-10 17:23:46,102,7607,48,54,5140.48,9936.04,0.00
2024-12-10 17:23:46,101,7607,48,53,5184.50,9936.10,0.00
2024-12-10 17:23:46,100,7607,48,52,5206.98,9936.29,0.00
2024-12-10 17:23:46,100,7608,48,52,5204.56,9937.00,0.00
2024-12-10 17:23:46,101,7608,49,52,5153.03,9937.01,0.00
2024-12-10 17:23:46,100,7608,48,52,5197.63,9937.07,0.00
2024-12-10 17:23:46,99,7608,48,51,5247.12,9937.09,0.00
2024-12-10 17:23:46,100,7607,48,52,5135.33,9937.66,0.00
2024-12-10 17:23:46,101,7606,49,52,5113.05,9937.70,0.00
2024-12-10 17:23:46,101,7607,49,52,5185.06,9938.00,0.00
2024-12-10 17:23:46,102,7607,49,53,5134.23,9938.01,0.00
2024-12-10 17:23:46,102,7608,49,53,5298.19,9939.00,0.00
2024-12-10 17:23:46,103,7608,50,53,5246.75,9939.01,0.00
2024-12-10 17:23:46,102,7608,49,53,5288.48,9939.10,0.00
2024-12-10 17:23:46,101,7608,49,52,5337.38,9939.11,0.00
2024-12-10 17:23:46,100,7608,48,52,5315.18,9939.79,0.00
2024-12-10 17:23:47,100,7609,48,52,5393.88,9940.00,0.00
2024-12-10 17:23:47,101,7609,49,52,5340.48,9940.01,0.00
2024-12-10 17:23:47,100,7609,49,51,5383.98,9940.10,0.00
2024-12-10 17:23:47,99,7609,48,51,5418.86,9940.27,0.00
2024-12-10 17:23:47,99,7610,48,51,5421.61,9941.00,0.00
2024-12-10 17:23:47,100,7610,48,52,5367.40,9941.01,0.00
2024-12-10 17:23:47,100,7611,48,52,5340.26,9942.00,0.00
2024-12-10 17:23:47,101,7611,49,52,5287.39,9942.01,0.00
2024-12-10 17:23:47,100,7611,48,52,5330.35,9942.10,0.00
2024-12-10 17:23:47,99,7611,48,51,5288.68,9942.79,0.00
2024-12-10 17:23:47,99,7612,48,51,5368.21,9943.00,0.00
2024-12-10 17:23:47,100,7612,49,51,5314.53,9943.01,0.00
2024-12-10 17:23:47,101,7611,50,51,5255.04,9943.10,0.00
2024-12-10 17:23:47,100,7611,50,50,5343.40,9943.11,0.00
2024-12-10 17:23:47,101,7610,51,50,5268.87,9943.35,0.00
2024-12-10 17:23:47,101,7611,51,50,5370.74,9944.00,0.00
2024-12-10 17:23:47,102,7611,51,51,5318.09,9944.01,0.00
2024-12-10 17:23:47,101,7611,51,50,5360.93,9944.10,0.00
2024-12-10 17:23:47,101,7612,51,50,5567.23,9945.00,0.00
2024-12-10 17:23:47,102,7612,51,51,5512.65,9945.01,0.00
2024-12-10 17:23:47,102,7613,51,51,5495.66,9946.00,0.00
2024-12-10 17:23:47,103,7613,52,51,5442.30,9946.01,0.00
2024-12-10 17:23:47,102,7613,52,50,5485.93,9946.10,0.00
2024-12-10 17:23:47,102,7614,52,50,5472.90,9947.00,0.00
2024-12-10 17:23:47,103,7614,53,50,5419.77,9947.01,0.00
2024-12-10 17:23:47,102,7614,52,50,5463.18,9947.10,0.00
2024-12-10 17:23:47,101,7614,52,49,5516.28,9947.10,0.00
2024-12-10 17:23:47,101,7615,52,49,5498.37,9948.00,0.00
2024-12-10 17:23:47,102,7615,52,50,5444.46,9948.01,0.00
2024-12-10 17:23:47,101,7615,52,49,5497.38,9948.01,0.00
2024-12-10 17:23:47,100,7615,52,48,5543.43,9948.09,0.00
2024-12-10 17:23:47,99,7615,51,48,5598.42,9948.09,0.00
2024-12-10 17:23:47,100,7614,52,48,5526.55,9948.27,0.00
2024-12-10 17:23:47,99,7614,51,48,5519.99,9948.78,0.00
2024-12-10 17:23:47,99,7615,51,48,5598.57,9949.00,0.00
2024-12-10 17:23:47,100,7615,52,48,5542.58,9949.01,0.00
2024-12-10 17:23:47,99,7615,52,47,5589.55,9949.09,0.00
2024-12-10 17:23:47,99,7616,52,47,5700.65,9950.00,0.00
2024-12-10 17:23:47,100,7616,52,48,5643.64,9950.01,0.00
2024-12-10 17:23:47,100,7617,52,48,5645.20,9951.00,0.00
2024-12-10 17:23:47,101,7617,52,49,5589.31,9951.01,0.00
2024-12-10 17:23:47,101,7618,52,49,5522.27,9952.00,0.00
2024-12-10 17:23:47,102,7618,53,49,5468.13,9952.01,0.00
2024-12-10 17:23:47,101,7618,53,48,5513.43,9952.09,0.00
2024-12-10 17:23:47,101,7619,53,48,5449.63,9953.00,0.00
2024-12-10 17:23:47,102,7619,53,49,5396.20,9953.01,0.00
2024-12-10 17:23:47,101,7619,52,49,5444.71,9953.05,0.00
2024-12-10 17:23:47,100,7619,52,48,5495.19,9953.08,0.00
2024-12-10 17:23:47,99,7619,51,48,5473.37,9953.78,0.00
2024-12-10 17:23:47,98,7619,50,48,5512.09,9953.79,0.00
2024-12-10 17:23:47,98,7620,50,48,5592.52,9954.00,0.00
2024-12-10 17:23:47,99,7620,50,49,5536.03,9954.01,0.00
2024-12-10 17:23:47,98,7620,49,49,5584.42,9954.08,0.00
2024-12-10 17:23:47,98,7621,49,49,5595.11,9955.00,0.00
2024-12-10 17:23:47,99,7621,50,49,5538.60,9955.01,0.00
2024-12-10 17:23:47,98,7621,50,48,5586.00,9955.09,0.00
2024-12-10 17:23:47,98,7622,50,48,5597.71,9956.00,0.00
2024-12-10 17:23:47,99,7622,50,49,5541.16,9956.01,0.00
2024-12-10 17:23:47,98,7622,49,49,5592.64,9956.05,0.00
2024-12-10 17:23:47,97,7622,49,48,5646.20,9956.08,0.00
2024-12-10 17:23:47,97,7623,49,48,5658.04,9957.00,0.00
2024-12-10 17:23:47,98,7623,50,48,5600.30,9957.01,0.00
2024-12-10 17:23:47,98,7624,50,48,5603.91,9958.00,0.00
2024-12-10 17:23:47,99,7624,50,49,5547.31,9958.01,0.00
2024-12-10 17:23:47,98,7624,50,48,5595.81,9958.08,0.00
2024-12-10 17:23:47,98,7625,50,48,5503.34,9959.00,0.00
2024-12-10 17:23:47,99,7625,51,48,5447.75,9959.01,0.00
2024-12-10 17:23:47,98,7625,50,48,5498.68,9959.04,0.00
2024-12-10 17:23:47,99,7624,50,49,5407.04,9959.42,0.00
2024-12-10 17:23:47,98,7624,49,49,5428.57,9959.81,0.00
2024-12-10 17:23:47,97,7624,48,49,5449.50,9959.81,0.00
2024-12-10 17:23:47,97,7625,48,49,5533.86,9960.00,0.00
2024-12-10 17:23:47,98,7625,49,49,5477.39,9960.01,0.00
2024-12-10 17:23:47,98,7626,49,49,5581.42,9961.00,0.00
2024-12-10 17:23:47,99,7626,49,50,5525.04,9961.01,0.00
2024-12-10 17:23:47,98,7626,49,49,5573.40,9961.07,0.00
2024-12-10 17:23:47,98,7627,49,49,5583.08,9962.00,0.00
2024-12-10 17:23:47,99,7627,50,49,5526.69,9962.01,0.00
2024-12-10 17:23:47,99,7628,50,49,5478.97,9963.00,0.00
2024-12-10 17:23:47,100,7628,50,50,5424.18,9963.01,0.00
2024-12-10 17:23:47,99,7628,50,49,5471.40,9963.07,0.00
2024-12-10 17:23:47,98,7628,50,48,5526.21,9963.07,0.00
2024-12-10 17:23:47,97,7628,49,48,5473.73,9963.81,0.00
2024-12-10 17:23:47,97,7629,49,48,5558.13,9964.00,0.00
2024-12-10 17:23:47,98,7629,50,48,5501.41,9964.01,0.00
2024-12-10 17:23:47,97,7629,50,47,5550.74,9964.07,0.00
2024-12-10 17:23:47,97,7630,50,47,5561.55,9965.00,0.00
2024-12-10 17:23:47,98,7630,50,48,5504.80,9965.01,0.00
2024-12-10 17:23:47,97,7630,49,48,5554.38,9965.07,0.00
2024-12-10 17:23:47,97,7631,49,48,5565.19,9966.00,0.00
2024-12-10 17:23:47,98,7631,49,49,5508.40,9966.01,0.00
2024-12-10 17:23:47,97,7631,49,48,5562.11,9966.03,0.00
2024-12-10 17:23:47,96,7631,49,47,5615.91,9966.06,0.00
2024-12-10 17:23:48,96,7632,49,47,5626.84,9967.00,0.00
2024-12-10 17:23:48,97,7632,49,48,5568.83,9967.01,0.00
2024-12-10 17:23:48,98,7631,49,49,5502.88,9967.12,0.00
2024-12-10 17:23:48,98,7632,49,49,5577.65,9968.00,0.00
2024-12-10 17:23:48,99,7632,50,49,5521.31,9968.01,0.00
2024-12-10 17:23:48,98,7632,50,48,5571.57,9968.06,0.00
2024-12-10 17:23:48,98,7633,50,48,5681.97,9969.00,0.00
2024-12-10 17:23:48,99,7633,50,49,5624.58,9969.01,0.00
2024-12-10 17:23:48,100,7632,51,49,5562.37,9969.09,0.00
2024-12-10 17:23:48,100,7633,51,49,5591.82,9970.00,0.00
2024-12-10 17:23:48,101,7633,51,50,5536.46,9970.01,0.00
2024-12-10 17:23:48,102,7632,52,50,5469.52,9970.16,0.00
2024-12-10 17:23:48,102,7633,52,50,5629.36,9971.00,0.00
2024-12-10 17:23:48,103,7633,52,51,5574.71,9971.01,0.00
2024-12-10 17:23:48,103,7634,52,51,5670.15,9972.00,0.00
2024-12-10 17:23:48,104,7634,53,51,5615.62,9972.01,0.00
2024-12-10 17:23:48,103,7634,53,50,5621.81,9972.24,0.00
2024-12-10 17:23:48,103,7635,53,50,5642.75,9973.00,0.00
2024-12-10 17:23:48,104,7635,54,50,5588.49,9973.01,0.00
2024-12-10 17:23:48,105,7634,55,50,5535.27,9973.03,0.00
2024-12-10 17:23:48,106,7633,56,50,5545.49,9973.33,0.00
2024-12-10 17:23:48,106,7634,56,50,5606.17,9974.00,0.00
2024-12-10 17:23:48,107,7634,56,51,5553.77,9974.01,0.00
2024-12-10 17:23:48,107,7635,56,51,5731.27,9975.00,0.00
2024-12-10 17:23:48,108,7635,56,52,5678.21,9975.01,0.00
2024-12-10 17:23:48,108,7636,56,52,5667.28,9976.00,0.00
2024-12-10 17:23:48,109,7636,57,52,5615.28,9976.01,0.00
2024-12-10 17:23:48,109,7637,57,52,5602.95,9977.00,0.00
2024-12-10 17:23:48,110,7637,57,53,5552.01,9977.01,0.00
2024-12-10 17:23:48,109,7637,56,53,5595.66,9977.07,0.00
2024-12-10 17:23:48,109,7638,56,53,5588.83,9978.00,0.00
2024-12-10 17:23:48,110,7638,56,54,5538.03,9978.01,0.00
2024-12-10 17:23:48,111,7637,56,55,5429.98,9978.54,0.00
2024-12-10 17:23:48,111,7638,56,55,5514.85,9979.00,0.00
2024-12-10 17:23:48,112,7638,57,55,5465.61,9979.01,0.00
2024-12-10 17:23:48,111,7638,57,54,5506.79,9979.08,0.00
2024-12-10 17:23:48,111,7639,57,54,5587.63,9980.00,0.00
2024-12-10 17:23:48,112,7639,57,55,5537.74,9980.01,0.00
2024-12-10 17:23:48,111,7639,57,54,5579.58,9980.08,0.00
2024-12-10 17:23:48,111,7640,57,54,5570.43,9981.00,0.00
2024-12-10 17:23:48,112,7640,58,54,5520.70,9981.01,0.00
2024-12-10 17:23:48,111,7640,58,53,5562.38,9981.08,0.00
2024-12-10 17:23:48,111,7641,58,53,5552.69,9982.00,0.00
2024-12-10 17:23:48,112,7641,58,54,5503.11,9982.01,0.00
2024-12-10 17:23:48,111,7641,57,54,5544.63,9982.08,0.00
2024-12-10 17:23:48,111,7642,57,54,5534.74,9983.00,0.00
2024-12-10 17:23:48,112,7642,58,54,5485.32,9983.01,0.00
2024-12-10 17:23:48,111,7642,58,53,5506.58,9983.23,0.00
2024-12-10 17:23:48,112,7641,59,53,5411.30,9983.71,0.00
2024-12-10 17:23:48,112,7642,59,53,5494.45,9984.00,0.00
2024-12-10 17:23:48,113,7642,60,53,5445.83,9984.01,0.00
2024-12-10 17:23:48,113,7643,60,53,5524.13,9985.00,0.00
2024-12-10 17:23:48,114,7643,61,53,5475.68,9985.01,0.00
2024-12-10 17:23:48,114,7644,61,53,5464.84,9986.00,0.00
2024-12-10 17:23:48,115,7644,61,54,5417.32,9986.01,0.00
2024-12-10 17:23:48,114,7644,60,54,5455.24,9986.10,0.00
2024-12-10 17:23:48,114,7645,60,54,5453.12,9987.00,0.00
2024-12-10 17:23:48,115,7645,61,54,5405.70,9987.01,0.00
2024-12-10 17:23:48,115,7646,61,54,5394.08,9988.00,0.00
2024-12-10 17:23:48,116,7646,62,54,5347.58,9988.01,0.00
2024-12-10 17:23:48,115,7646,62,53,5384.57,9988.10,0.00
2024-12-10 17:23:48,115,7647,62,53,5381.44,9989.00,0.00
2024-12-10 17:23:48,116,7647,63,53,5335.05,9989.01,0.00
2024-12-10 17:23:48,115,7647,62,53,5371.92,9989.10,0.00
2024-12-10 17:23:48,114,7647,62,52,5418.17,9989.10,0.00
2024-12-10 17:23:48,114,7648,62,52,5415.49,9990.00,0.00
2024-12-10 17:23:48,115,7648,63,52,5368.40,9990.01,0.00
2024-12-10 17:23:48,116,7647,63,53,5322.12,9990.03,0.00
2024-12-10 17:23:48,116,7648,63,53,5322.22,9991.00,0.00
2024-12-10 17:23:48,117,7648,63,54,5276.74,9991.01,0.00
2024-12-10 17:23:48,116,7648,63,53,5312.79,9991.10,0.00
2024-12-10 17:23:48,115,7648,62,53,5350.56,9991.14,0.00
2024-12-10 17:23:48,116,7647,62,54,5299.28,9991.21,0.00
2024-12-10 17:23:48,116,7648,62,54,5465.15,9992.00,0.00
2024-12-10 17:23:48,117,7648,63,54,5418.44,9992.01,0.00
2024-12-10 17:23:48,118,7647,64,54,5331.41,9992.40,0.00
2024-12-10 17:23:48,118,7648,64,54,5492.75,9993.00,0.00
2024-12-10 17:23:48,119,7648,64,55,5446.59,9993.01,0.00
2024-12-10 17:23:48,118,7648,63,55,5483.46,9993.09,0.00
2024-12-10 17:23:48,117,7648,62,55,5521.51,9993.15,0.00
2024-12-10 17:23:48,117,7649,62,55,5607.45,9994.00,0.00
2024-12-10 17:23:48,118,7649,62,56,5559.92,9994.01,0.00
2024-12-10 17:23:48,117,7649,61,56,5598.08,9994.09,0.00
2024-12-10 17:23:49,118,7648,62,56,5505.92,9994.56,0.00
2024-12-10 17:23:49,118,7649,62,56,5581.66,9995.00,0.00
2024-12-10 17:23:49,119,7649,62,57,5534.75,9995.01,0.00
2024-12-10 17:23:49,118,7649,61,57,5578.28,9995.03,0.00
2024-12-10 17:23:49,117,7649,60,57,5620.00,9995.09,0.00
2024-12-10 17:23:49,116,7649,60,56,5667.58,9995.09,0.00
2024-12-10 17:23:49,116,7650,60,56,5749.12,9996.00,0.00
2024-12-10 17:23:49,117,7650,61,56,5699.98,9996.01,0.00
2024-12-10 17:23:49,117,7651,61,56,5686.88,9997.00,0.00
2024-12-10 17:23:49,118,7651,62,56,5638.69,9997.01,0.00
2024-12-10 17:23:49,117,7651,61,56,5682.62,9997.04,0.00
2024-12-10 17:23:49,116,7651,60,56,5727.32,9997.08,0.00
2024-12-10 17:23:49,116,7652,60,56,5721.83,9998.00,0.00
2024-12-10 17:23:49,117,7652,60,57,5672.92,9998.01,0.00
2024-12-10 17:23:49,117,7653,60,57,5659.82,9999.00,0.00
2024-12-10 17:23:49,118,7653,61,57,5611.85,9999.01,0.00
2024-12-10 17:23:49,118,7654,61,57,5598.01,10000.00,0.00
2024-12-10 17:23:49,119,7654,62,57,5550.97,10000.01,0.00
2024-12-10 17:23:49,118,7654,62,56,5591.26,10000.07,0.00
2024-12-10 17:23:49,117,7654,62,55,5638.19,10000.07,0.00
2024-12-10 17:23:49,116,7654,61,55,5685.94,10000.07,0.00
2024-12-10 17:23:49,117,7653,61,56,5634.78,10000.11,0.00
2024-12-10 17:23:49,118,7652,61,57,5592.97,10000.14,0.00
2024-12-10 17:23:49,119,7651,61,58,5548.71,10000.65,0.00
2024-12-10 17:23:49,119,7652,61,58,5624.63,10001.00,0.00
2024-12-10 17:23:49,120,7652,62,58,5577.76,10001.01,0.00
2024-12-10 17:23:49,120,7653,62,58,5812.54,10002.00,0.00
2024-12-10 17:23:49,121,7653,62,59,5764.50,10002.01,0.00
2024-12-10 17:23:49,120,7653,62,58,5811.17,10002.02,0.00
2024-12-10 17:23:49,119,7653,62,57,5854.98,10002.06,0.00
2024-12-10 17:23:49,119,7654,62,57,5845.45,10003.00,0.00
2024-12-10 17:23:49,120,7654,63,57,5796.74,10003.01,0.00
2024-12-10 17:23:49,121,7653,64,57,5687.10,10003.64,0.00
2024-12-10 17:23:49,121,7654,64,57,5760.98,10004.00,0.00
2024-12-10 17:23:49,122,7654,65,57,5713.76,10004.01,0.00
2024-12-10 17:23:49,123,7653,66,57,5621.92,10004.48,0.00
2024-12-10 17:23:49,123,7654,66,57,5771.99,10005.00,0.00
2024-12-10 17:23:49,124,7654,67,57,5725.44,10005.01,0.00
2024-12-10 17:23:49,123,7654,67,56,5765.51,10005.07,0.00
2024-12-10 17:23:49,123,7655,67,56,5835.20,10006.00,0.00
2024-12-10 17:23:49,124,7655,67,57,5788.14,10006.01,0.00
2024-12-10 17:23:49,124,7656,67,57,5770.16,10007.00,0.00
2024-12-10 17:23:49,125,7656,68,57,5724.00,10007.01,0.00
2024-12-10 17:23:49,124,7656,67,57,5762.94,10007.07,0.00
2024-12-10 17:23:49,124,7657,67,57,5751.37,10008.00,0.00
2024-12-10 17:23:49,125,7657,67,58,5705.36,10008.01,0.00
2024-12-10 17:23:49,124,7657,66,58,5748.96,10008.02,0.00
2024-12-10 17:23:49,123,7657,66,57,5788.87,10008.07,0.00
2024-12-10 17:23:49,124,7656,66,58,5739.76,10008.11,0.00
2024-12-10 17:23:49,125,7655,67,58,5758.72,10008.25,0.00
2024-12-10 17:23:49,126,7654,68,58,5714.65,10008.37,0.00
2024-12-10 17:23:49,126,7655,68,58,5781.04,10009.00,0.00
2024-12-10 17:23:49,127,7655,69,58,5735.52,10009.01,0.00
2024-12-10 17:23:49,126,7655,68,58,5768.86,10009.08,0.00
2024-12-10 17:23:49,126,7656,68,58,5995.01,10010.00,0.00
2024-12-10 17:23:49,127,7656,69,58,5947.81,10010.01,0.00
2024-12-10 17:23:49,126,7656,69,57,5979.33,10010.08,0.00
2024-12-10 17:23:49,127,7655,70,57,5899.25,10010.42,0.00
2024-12-10 17:23:49,127,7656,70,57,5962.75,10011.00,0.00
2024-12-10 17:23:49,128,7656,70,58,5916.17,10011.01,0.00
2024-12-10 17:23:49,129,7655,70,59,5762.78,10011.88,0.00
2024-12-10 17:23:49,129,7656,70,59,5913.46,10012.00,0.00
2024-12-10 17:23:49,130,7656,70,60,5867.97,10012.01,0.00
2024-12-10 17:23:49,129,7656,69,60,5890.85,10012.08,0.00
2024-12-10 17:23:49,129,7657,69,60,5947.31,10013.00,0.00
2024-12-10 17:23:49,130,7657,70,60,5901.57,10013.01,0.00
2024-12-10 17:23:49,129,7657,69,60,5940.28,10013.03,0.00
2024-12-10 17:23:49,129,7658,69,60,5914.55,10014.00,0.00
2024-12-10 17:23:49,130,7658,69,61,5869.06,10014.01,0.00
2024-12-10 17:23:49,129,7658,68,61,5906.83,10014.08,0.00
2024-12-10 17:23:49,129,7659,68,61,5882.89,10015.00,0.00
2024-12-10 17:23:49,130,7659,69,61,5837.63,10015.01,0.00
2024-12-10 17:23:49,129,7659,69,60,5875.17,10015.08,0.00
2024-12-10 17:23:49,128,7659,68,60,5919.03,10015.08,0.00
2024-12-10 17:23:49,128,7660,68,60,5886.02,10016.00,0.00
2024-12-10 17:23:49,129,7660,68,61,5840.40,10016.01,0.00
2024-12-10 17:23:49,130,7659,68,62,5794.70,10016.03,0.00
2024-12-10 17:23:49,129,7659,67,62,5884.06,10016.14,0.00
2024-12-10 17:23:49,130,7658,67,63,5767.83,10016.68,0.00
2024-12-10 17:23:49,131,7657,68,63,5732.31,10016.82,0.00
2024-12-10 17:23:49,131,7658,68,63,5802.07,10017.00,0.00
2024-12-10 17:23:49,132,7658,68,64,5758.11,10017.01,0.00
2024-12-10 17:23:49,131,7658,68,63,5770.94,10017.26,0.00
2024-12-10 17:23:49,131,7659,68,63,6003.15,10018.00,0.00
2024-12-10 17:23:49,132,7659,68,64,5957.67,10018.01,0.00
2024-12-10 17:23:49,132,7660,68,64,5934.04,10019.00,0.00
2024-12-10 17:23:49,133,7660,69,64,5889.42,10019.01,0.00
2024-12-10 17:23:49,132,7660,69,63,5926.49,10019.08,0.00
2024-12-10 17:23:50,132,7661,69,63,5907.00,10020.00,0.00
2024-12-10 17:23:50,133,7661,69,64,5862.59,10020.01,0.00
2024-12-10 17:23:50,132,7661,69,63,5899.45,10020.08,0.00
2024-12-10 17:23:50,131,7661,68,63,5943.72,10020.08,0.00
2024-12-10 17:23:50,132,7660,68,64,5864.64,10020.43,0.00
2024-12-10 17:23:50,132,7661,68,64,5893.22,10021.00,0.00
2024-12-10 17:23:50,133,7661,68,65,5848.91,10021.01,0.00
2024-12-10 17:23:50,132,7661,67,65,5885.67,10021.08,0.00
2024-12-10 17:23:50,132,7662,67,65,5936.61,10022.00,0.00
2024-12-10 17:23:50,133,7662,68,65,5891.97,10022.01,0.00
2024-12-10 17:23:50,132,7662,67,65,5929.06,10022.08,0.00
2024-12-10 17:23:50,133,7661,67,66,5854.43,10022.39,0.00
2024-12-10 17:23:50,133,7662,67,66,5898.82,10023.00,0.00
2024-12-10 17:23:50,134,7662,68,66,5854.80,10023.01,0.00
2024-12-10 17:23:50,134,7663,68,66,5888.96,10024.00,0.00
2024-12-10 17:23:50,135,7663,69,66,5845.34,10024.01,0.00
2024-12-10 17:23:50,134,7663,68,66,5881.52,10024.07,0.00
2024-12-10 17:23:50,134,7664,68,66,5843.63,10025.00,0.00
2024-12-10 17:23:50,135,7664,68,67,5800.35,10025.01,0.00
2024-12-10 17:23:50,134,7664,67,67,5836.19,10025.07,0.00
2024-12-10 17:23:50,133,7664,67,66,5792.00,10025.81,0.00
2024-12-10 17:23:50,133,7665,67,66,5848.70,10026.00,0.00
2024-12-10 17:23:50,134,7665,68,66,5805.05,10026.01,0.00
2024-12-10 17:23:50,135,7664,68,67,5733.92,10026.30,0.00
2024-12-10 17:23:50,136,7663,69,67,5716.12,10026.38,0.00
2024-12-10 17:23:50,136,7664,69,67,5768.94,10027.00,0.00
2024-12-10 17:23:50,137,7664,69,68,5726.83,10027.01,0.00
2024-12-10 17:23:50,136,7664,68,68,5761.61,10027.07,0.00
2024-12-10 17:23:50,136,7665,68,68,5887.79,10028.00,0.00
2024-12-10 17:23:50,137,7665,68,69,5844.82,10028.01,0.00
2024-12-10 17:23:50,136,7665,68,68,5880.46,10028.07,0.00
2024-12-10 17:23:50,136,7666,68,68,5859.54,10029.00,0.00
2024-12-10 17:23:50,137,7666,68,69,5816.77,10029.01,0.00
2024-12-10 17:23:50,136,7666,68,68,5852.20,10029.07,0.00
2024-12-10 17:23:50,137,7665,69,68,5738.49,10029.78,0.00
2024-12-10 17:23:50,137,7666,69,68,5804.58,10030.00,0.00
2024-12-10 17:23:50,138,7666,69,69,5762.52,10030.01,0.00
2024-12-10 17:23:50,137,7666,69,68,5798.75,10030.06,0.00
2024-12-10 17:23:50,138,7665,69,69,5732.82,10030.31,0.00
2024-12-10 17:23:50,138,7666,69,69,5857.12,10031.00,0.00
2024-12-10 17:23:50,139,7666,69,70,5814.99,10031.01,0.00
2024-12-10 17:23:50,138,7666,68,70,5849.90,10031.07,0.00
2024-12-10 17:23:50,138,7667,68,70,5902.33,10032.00,0.00
2024-12-10 17:23:50,139,7667,68,71,5859.87,10032.01,0.00
2024-12-10 17:23:50,139,7668,68,71,5833.03,10033.00,0.00
2024-12-10 17:23:50,140,7668,68,72,5791.36,10033.01,0.00
2024-12-10 17:23:50,139,7668,68,71,5825.13,10033.08,0.00
2024-12-10 17:23:50,139,7669,68,71,5805.46,10034.00,0.00
2024-12-10 17:23:50,140,7669,69,71,5763.99,10034.01,0.00
2024-12-10 17:23:50,139,7669,68,71,5797.56,10034.08,0.00
2024-12-10 17:23:50,139,7670,68,71,5777.88,10035.00,0.00
2024-12-10 17:23:50,140,7670,68,72,5736.61,10035.01,0.00
2024-12-10 17:23:50,140,7671,68,72,5709.22,10036.00,0.00
2024-12-10 17:23:50,141,7671,69,72,5668.73,10036.01,0.00
2024-12-10 17:23:50,141,7672,69,72,5640.82,10037.00,0.00
2024-12-10 17:23:50,142,7672,70,72,5601.10,10037.01,0.00
2024-12-10 17:23:50,141,7672,69,72,5633.03,10037.08,0.00
2024-12-10 17:23:50,140,7672,69,71,5672.55,10037.08,0.00
2024-12-10 17:23:50,139,7672,68,71,5712.64,10037.08,0.00
2024-12-10 17:23:50,140,7671,69,71,5626.12,10037.55,0.00
2024-12-10 17:23:50,141,7670,69,72,5601.99,10037.72,0.00
2024-12-10 17:23:50,141,7671,69,72,5649.93,10038.00,0.00
2024-12-10 17:23:50,142,7671,69,73,5610.14,10038.01,0.00
2024-12-10 17:23:50,141,7671,69,72,5642.14,10038.08,0.00
2024-12-10 17:23:50,141,7672,69,72,5763.70,10039.00,0.00
2024-12-10 17:23:50,142,7672,69,73,5723.11,10039.01,0.00
2024-12-10 17:23:50,141,7672,68,73,5755.91,10039.08,0.00
2024-12-10 17:23:50,141,7673,68,73,5735.08,10040.00,0.00
2024-12-10 17:23:50,142,7673,69,73,5694.69,10040.01,0.00
2024-12-10 17:23:50,141,7673,68,73,5727.28,10040.08,0.00
2024-12-10 17:23:50,141,7674,68,73,5706.45,10041.00,0.00
2024-12-10 17:23:50,142,7674,68,74,5666.27,10041.01,0.00
2024-12-10 17:23:50,141,7674,68,73,5698.65,10041.08,0.00
2024-12-10 17:23:50,141,7675,68,73,5677.82,10042.00,0.00
2024-12-10 17:23:50,142,7675,68,74,5637.84,10042.01,0.00
2024-12-10 17:23:50,142,7676,68,74,5609.40,10043.00,0.00
2024-12-10 17:23:50,143,7676,68,75,5570.17,10043.01,0.00
2024-12-10 17:23:50,142,7676,67,75,5601.65,10043.08,0.00
2024-12-10 17:23:50,141,7676,66,75,5640.67,10043.08,0.00
2024-12-10 17:23:51,141,7677,66,75,5618.21,10044.00,0.00
2024-12-10 17:23:51,142,7677,66,76,5578.65,10044.01,0.00
2024-12-10 17:23:51,142,7678,66,76,5546.04,10045.00,0.00
2024-12-10 17:23:51,143,7678,67,76,5507.26,10045.01,0.00
2024-12-10 17:23:51,142,7678,67,75,5538.30,10045.08,0.00
2024-12-10 17:23:51,142,7679,67,75,5510.69,10046.00,0.00
2024-12-10 17:23:51,143,7679,67,76,5472.15,10046.01,0.00
2024-12-10 17:23:51,143,7680,67,76,5435.52,10047.00,0.00
2024-12-10 17:23:51,144,7680,68,76,5397.78,10047.01,0.00
2024-12-10 17:23:51,143,7680,67,76,5427.83,10047.08,0.00
2024-12-10 17:23:51,143,7681,67,76,5397.46,10048.00,0.00
2024-12-10 17:23:51,144,7681,68,76,5359.97,10048.01,0.00
2024-12-10 17:23:51,143,7681,68,75,5389.76,10048.08,0.00
2024-12-10 17:23:51,142,7681,67,75,5427.01,10048.08,0.00
2024-12-10 17:23:51,142,7682,67,75,5396.90,10049.00,0.00
2024-12-10 17:23:51,143,7682,68,75,5359.16,10049.01,0.00
2024-12-10 17:23:51,142,7682,67,75,5389.15,10049.08,0.00
2024-12-10 17:23:51,143,7681,67,76,5347.95,10049.13,0.00
2024-12-10 17:23:51,144,7680,67,77,5301.95,10049.45,0.00
2024-12-10 17:23:51,144,7681,67,77,5356.78,10050.00,0.00
2024-12-10 17:23:51,145,7681,68,77,5319.83,10050.01,0.00
2024-12-10 17:23:51,144,7681,68,76,5349.13,10050.08,0.00
2024-12-10 17:23:51,144,7682,68,76,5458.63,10051.00,0.00
2024-12-10 17:23:51,145,7682,68,77,5420.98,10051.01,0.00
2024-12-10 17:23:51,144,7682,68,76,5450.98,10051.08,0.00
2024-12-10 17:23:51,143,7682,68,75,5477.68,10051.18,0.00
2024-12-10 17:23:51,144,7681,68,76,5389.61,10051.69,0.00
2024-12-10 17:23:51,144,7682,68,76,5452.68,10052.00,0.00
2024-12-10 17:23:51,145,7682,68,77,5415.08,10052.01,0.00
2024-12-10 17:23:51,145,7683,68,77,5454.44,10053.00,0.00
2024-12-10 17:23:51,146,7683,68,78,5417.08,10053.01,0.00
2024-12-10 17:23:51,147,7682,69,78,5378.87,10053.03,0.00
2024-12-10 17:23:51,146,7682,69,77,5466.69,10053.09,0.00
2024-12-10 17:23:51,146,7683,69,77,5444.48,10054.00,0.00
2024-12-10 17:23:51,147,7683,70,77,5407.44,10054.01,0.00
2024-12-10 17:23:51,146,7683,70,76,5436.25,10054.08,0.00
2024-12-10 17:23:51,145,7683,69,76,5439.01,10054.43,0.00
2024-12-10 17:23:51,145,7684,69,76,5520.54,10055.00,0.00
2024-12-10 17:23:51,146,7684,70,76,5482.73,10055.01,0.00
2024-12-10 17:23:51,146,7685,70,76,5452.28,10056.00,0.00
2024-12-10 17:23:51,147,7685,71,76,5415.19,10056.01,0.00
2024-12-10 17:23:51,147,7686,71,76,5384.25,10057.00,0.00
2024-12-10 17:23:51,148,7686,72,76,5347.87,10057.01,0.00
2024-12-10 17:23:51,148,7687,72,76,5316.46,10058.00,0.00
2024-12-10 17:23:51,149,7687,73,76,5280.78,10058.01,0.00
2024-12-10 17:23:51,150,7686,74,76,5242.24,10058.05,0.00
2024-12-10 17:23:51,149,7686,74,75,5309.86,10058.11,0.00
2024-12-10 17:23:51,149,7687,74,75,5288.06,10059.00,0.00
2024-12-10 17:23:51,150,7687,74,76,5252.81,10059.01,0.00
2024-12-10 17:23:51,149,7687,73,76,5277.98,10059.10,0.00
2024-12-10 17:23:51,148,7687,73,75,5312.96,10059.10,0.00
2024-12-10 17:23:51,148,7688,73,75,5358.99,10060.00,0.00
2024-12-10 17:23:51,149,7688,73,76,5323.02,10060.01,0.00
2024-12-10 17:23:51,148,7688,72,76,5348.84,10060.10,0.00
2024-12-10 17:23:51,148,7689,72,76,5326.89,10061.00,0.00
2024-12-10 17:23:51,149,7689,72,77,5291.14,10061.01,0.00
2024-12-10 17:23:51,148,7689,72,76,5316.74,10061.10,0.00
2024-12-10 17:23:51,148,7690,72,76,5294.78,10062.00,0.00
2024-12-10 17:23:51,149,7690,72,77,5259.25,10062.01,0.00
2024-12-10 17:23:51,149,7691,72,77,5227.35,10063.00,0.00
2024-12-10 17:23:51,150,7691,73,77,5192.50,10063.01,0.00
2024-12-10 17:23:51,149,7691,73,76,5216.60,10063.11,0.00
2024-12-10 17:23:51,150,7690,74,76,5102.36,10063.91,0.00
2024-12-10 17:23:51,150,7691,74,76,5168.20,10064.00,0.00
2024-12-10 17:23:51,151,7691,75,76,5133.97,10064.01,0.00
2024-12-10 17:23:51,150,7691,74,76,5157.51,10064.11,0.00
2024-12-10 17:23:51,150,7692,74,76,5202.26,10065.00,0.00
2024-12-10 17:23:51,151,7692,74,77,5167.81,10065.01,0.00
2024-12-10 17:23:51,151,7693,74,77,5134.99,10066.00,0.00
2024-12-10 17:23:51,152,7693,75,77,5101.21,10066.01,0.00
2024-12-10 17:23:51,152,7694,75,77,5067.94,10067.00,0.00
2024-12-10 17:23:51,153,7694,75,78,5034.81,10067.01,0.00
2024-12-10 17:23:51,152,7694,75,77,5056.72,10067.11,0.00
2024-12-10 17:23:51,152,7695,75,77,5034.00,10068.00,0.00
2024-12-10 17:23:52,153,7695,76,77,5001.09,10068.01,0.00
2024-12-10 17:23:52,152,7695,75,77,5022.12,10068.12,0.00
2024-12-10 17:23:52,152,7696,75,77,5000.05,10069.00,0.00
2024-12-10 17:23:52,153,7696,75,78,4967.37,10069.01,0.00
2024-12-10 17:23:52,152,7696,75,77,4988.17,10069.12,0.00
2024-12-10 17:23:52,151,7696,74,77,5020.54,10069.12,0.00
2024-12-10 17:23:52,151,7697,74,77,4998.99,10070.00,0.00
2024-12-10 17:23:52,152,7697,75,77,4966.10,10070.01,0.00
2024-12-10 17:23:52,151,7697,74,77,4996.33,10070.03,0.00
2024-12-10 17:23:52,150,7697,74,76,5020.27,10070.11,0.00
2024-12-10 17:23:52,150,7698,74,76,4998.18,10071.00,0.00
2024-12-10 17:23:52,151,7698,74,77,4965.08,10071.01,0.00
2024-12-10 17:23:52,150,7698,74,76,4986.15,10071.12,0.00
2024-12-10 17:23:52,150,7699,74,76,4964.38,10072.00,0.00
2024-12-10 17:23:52,151,7699,74,77,4931.50,10072.01,0.00
2024-12-10 17:23:52,150,7699,73,77,4952.34,10072.12,0.00
2024-12-10 17:23:52,150,7700,73,77,4930.43,10073.00,0.00
2024-12-10 17:23:52,151,7700,73,78,4897.78,10073.01,0.00
2024-12-10 17:23:52,150,7700,72,78,4927.75,10073.03,0.00
2024-12-10 17:23:52,149,7700,71,78,4951.40,10073.11,0.00
2024-12-10 17:23:52,148,7700,70,78,4984.17,10073.12,0.00
2024-12-10 17:23:52,147,7700,69,78,5017.39,10073.12,0.00
2024-12-10 17:23:52,147,7701,69,78,4996.78,10074.00,0.00
2024-12-10 17:23:52,148,7701,70,78,4963.01,10074.01,0.00
2024-12-10 17:23:52,149,7700,70,79,4927.69,10074.04,0.00
2024-12-10 17:23:52,148,7700,70,78,4962.38,10074.12,0.00
2024-12-10 17:23:52,148,7701,70,78,4941.47,10075.00,0.00
2024-12-10 17:23:52,149,7701,71,78,4908.31,10075.01,0.00
2024-12-10 17:23:52,150,7700,72,78,4869.56,10075.08,0.00
2024-12-10 17:23:52,151,7699,73,78,4854.00,10075.09,0.00
2024-12-10 17:23:52,150,7699,73,77,4925.34,10075.13,0.00
2024-12-10 17:23:52,151,7698,74,77,4860.10,10075.46,0.00
2024-12-10 17:23:52,152,7697,74,78,4836.93,10075.80,0.00
2024-12-10 17:23:52,152,7698,74,78,4964.62,10076.00,0.00
2024-12-10 17:23:52,153,7698,75,78,4932.17,10076.01,0.00
2024-12-10 17:23:52,152,7698,74,78,4953.40,10076.11,0.00
2024-12-10 17:23:52,152,7699,74,78,5193.65,10077.00,0.00
2024-12-10 17:23:52,153,7699,75,78,5159.71,10077.01,0.00
2024-12-10 17:23:52,152,7699,75,77,5182.43,10077.11,0.00
2024-12-10 17:23:52,152,7700,75,77,5157.13,10078.00,0.00
2024-12-10 17:23:52,153,7700,76,77,5123.43,10078.01,0.00
2024-12-10 17:23:52,152,7700,75,77,5151.85,10078.05,0.00
2024-12-10 17:23:52,151,7700,75,76,5179.99,10078.11,0.00
2024-12-10 17:23:52,150,7700,75,75,5213.85,10078.11,0.00
2024-12-10 17:23:52,150,7701,75,75,5188.90,10079.00,0.00
2024-12-10 17:23:52,151,7701,76,75,5154.53,10079.01,0.00
2024-12-10 17:23:52,150,7701,75,75,5178.19,10079.11,0.00
2024-12-10 17:23:52,151,7700,75,76,5057.17,10079.96,0.00
2024-12-10 17:23:52,151,7701,75,76,5121.96,10080.00,0.00
2024-12-10 17:23:52,152,7701,76,76,5088.26,10080.01,0.00
2024-12-10 17:23:52,151,7701,76,75,5111.32,10080.11,0.00
2024-12-10 17:23:52,151,7702,76,75,5154.15,10081.00,0.00
2024-12-10 17:23:52,152,7702,77,75,5120.25,10081.01,0.00
2024-12-10 17:23:52,151,7702,76,75,5143.52,10081.11,0.00
2024-12-10 17:23:52,151,7703,76,75,5120.61,10082.00,0.00
2024-12-10 17:23:52,152,7703,76,76,5086.93,10082.01,0.00
2024-12-10 17:23:52,151,7703,76,75,5109.97,10082.11,0.00
2024-12-10 17:23:52,151,7704,76,75,5087.07,10083.00,0.00
2024-12-10 17:23:52,152,7704,77,75,5053.60,10083.01,0.00
2024-12-10 17:23:52,151,7704,76,75,5076.43,10083.11,0.00
2024-12-10 17:23:52,150,7704,75,75,5109.60,10083.11,0.00
2024-12-10 17:23:52,150,7705,75,75,5087.20,10084.00,0.00
2024-12-10 17:23:52,151,7705,76,75,5053.51,10084.01,0.00
2024-12-10 17:23:52,150,7705,75,75,5076.49,10084.11,0.00
2024-12-10 17:23:52,150,7706,75,75,5054.09,10085.00,0.00
2024-12-10 17:23:52,151,7706,75,76,5020.62,10085.01,0.00
2024-12-10 17:23:52,150,7706,74,76,5043.38,10085.11,0.00
2024-12-10 17:23:52,150,7707,74,76,5020.97,10086.00,0.00
2024-12-10 17:23:52,151,7707,75,76,4987.72,10086.01,0.00
2024-12-10 17:23:52,150,7707,75,75,5010.25,10086.11,0.00
2024-12-10 17:23:52,151,7706,76,75,4919.82,10086.69,0.00
2024-12-10 17:23:52,151,7707,76,75,4979.53,10087.00,0.00
2024-12-10 17:23:52,152,7707,76,76,4946.77,10087.01,0.00
2024-12-10 17:23:52,153,7706,76,77,4907.87,10087.08,0.00
2024-12-10 17:23:52,154,7705,77,77,4914.66,10087.10,0.00
2024-12-10 17:23:52,155,7704,78,77,4897.98,10087.38,0.00
2024-12-10 17:23:52,155,7705,78,77,5012.92,10088.00,0.00
2024-12-10 17:23:52,156,7705,78,78,4980.78,10088.01,0.00
2024-12-10 17:23:52,155,7705,77,78,5001.90,10088.11,0.00
2024-12-10 17:23:52,155,7706,77,78,5172.89,10089.00,0.00
2024-12-10 17:23:52,156,7706,78,78,5139.73,10089.01,0.00
2024-12-10 17:23:52,155,7706,77,78,5161.87,10089.11,0.00
2024-12-10 17:23:52,155,7707,77,78,5137.59,10090.00,0.00
2024-12-10 17:23:53,156,7707,77,79,5104.66,10090.01,0.00
2024-12-10 17:23:53,155,7707,77,78,5136.94,10090.01,0.00
2024-12-10 17:23:53,154,7707,76,78,5159.86,10090.10,0.00
2024-12-10 17:23:53,153,7707,76,77,5192.93,10090.10,0.00
2024-12-10 17:23:53,153,7708,76,77,5168.99,10091.00,0.00
2024-12-10 17:23:53,154,7708,77,77,5135.43,10091.01,0.00
2024-12-10 17:23:53,153,7708,77,76,5158.48,10091.10,0.00
2024-12-10 17:23:53,153,7709,77,76,5134.54,10092.00,0.00
2024-12-10 17:23:53,154,7709,77,77,5101.20,10092.01,0.00
2024-12-10 17:23:53,155,7708,77,78,5058.57,10092.12,0.00
2024-12-10 17:23:53,154,7708,76,78,5118.29,10092.12,0.00
2024-12-10 17:23:53,155,7707,76,79,5065.12,10092.33,0.00
2024-12-10 17:23:53,155,7708,76,79,5065.54,10093.00,0.00
2024-12-10 17:23:53,156,7708,77,79,5033.07,10093.01,0.00
2024-12-10 17:23:53,155,7708,77,78,5053.87,10093.12,0.00
2024-12-10 17:23:53,156,7707,78,78,4987.91,10093.46,0.00
2024-12-10 17:23:53,157,7706,79,78,4949.39,10093.94,0.00
2024-12-10 17:23:53,157,7707,79,78,5139.74,10094.00,0.00
2024-12-10 17:23:53,158,7707,80,78,5107.21,10094.01,0.00
2024-12-10 17:23:53,157,7707,79,78,5135.25,10094.04,0.00
2024-12-10 17:23:53,156,7707,79,77,5161.09,10094.11,0.00
2024-12-10 17:23:53,156,7708,79,77,5265.73,10095.00,0.00
2024-12-10 17:23:53,157,7708,80,77,5232.19,10095.01,0.00
2024-12-10 17:23:53,156,7708,80,76,5254.78,10095.11,0.00
2024-12-10 17:23:53,157,7707,80,77,5195.64,10095.38,0.00
2024-12-10 17:23:53,157,7708,80,77,5243.64,10096.00,0.00
2024-12-10 17:23:53,158,7708,81,77,5210.46,10096.01,0.00
2024-12-10 17:23:53,157,7708,80,77,5232.76,10096.11,0.00
2024-12-10 17:23:53,158,7707,80,78,5191.98,10096.20,0.00
2024-12-10 17:23:53,158,7708,80,78,5297.24,10097.00,0.00
2024-12-10 17:23:53,159,7708,81,78,5263.93,10097.01,0.00
2024-12-10 17:23:53,158,7708,80,78,5286.43,10097.11,0.00
2024-12-10 17:23:53,158,7709,80,78,5324.61,10098.00,0.00
2024-12-10 17:23:53,159,7709,81,78,5291.12,10098.01,0.00
2024-12-10 17:23:53,158,7709,81,77,5313.79,10098.11,0.00
2024-12-10 17:23:53,159,7708,81,78,5214.59,10098.77,0.00
2024-12-10 17:23:53,160,7707,82,78,5192.11,10098.79,0.00
2024-12-10 17:23:53,160,7708,82,78,5248.48,10099.00,0.00
2024-12-10 17:23:53,161,7708,83,78,5215.88,10099.01,0.00
2024-12-10 17:23:53,160,7708,82,78,5237.79,10099.11,0.00
2024-12-10 17:23:53,160,7709,82,78,5337.37,10100.00,0.00
2024-12-10 17:23:53,161,7709,83,78,5304.22,10100.01,0.00
2024-12-10 17:23:53,160,7709,83,77,5334.86,10100.03,0.00
2024-12-10 17:23:53,159,7709,82,77,5360.19,10100.10,0.00
2024-12-10 17:23:53,158,7709,82,76,5392.83,10100.11,0.00
2024-12-10 17:23:53,159,7708,83,76,5284.31,10100.86,0.00
2024-12-10 17:23:53,159,7709,83,76,5337.80,10101.00,0.00
2024-12-10 17:23:53,160,7709,84,76,5304.44,10101.01,0.00
2024-12-10 17:23:53,159,7709,83,76,5326.41,10101.11,0.00
2024-12-10 17:23:53,159,7710,83,76,5364.38,10102.00,0.00
2024-12-10 17:23:53,160,7710,83,77,5330.85,10102.01,0.00
2024-12-10 17:23:53,159,7710,83,76,5352.98,10102.11,0.00
2024-12-10 17:23:53,159,7711,83,76,5327.42,10103.00,0.00
2024-12-10 17:23:53,160,7711,83,77,5294.13,10103.01,0.00
2024-12-10 17:23:53,159,7711,82,77,5319.83,10103.08,0.00
2024-12-10 17:23:53,158,7711,81,77,5349.67,10103.11,0.00
2024-12-10 17:23:53,157,7711,80,77,5383.10,10103.11,0.00
2024-12-10 17:23:53,157,7712,80,77,5357.85,10104.00,0.00
2024-12-10 17:23:53,158,7712,80,78,5323.94,10104.01,0.00
2024-12-10 17:23:53,157,7712,79,78,5346.95,10104.11,0.00
2024-12-10 17:23:53,158,7711,80,78,5231.03,10104.94,0.00
2024-12-10 17:23:53,158,7712,80,78,5293.13,10105.00,0.00
2024-12-10 17:23:53,159,7712,81,78,5259.84,10105.01,0.00
2024-12-10 17:23:53,160,7711,82,78,5226.96,10105.02,0.00
2024-12-10 17:23:53,159,7711,81,78,5305.01,10105.12,0.00
2024-12-10 17:23:53,159,7712,81,78,5343.62,10106.00,0.00
2024-12-10 17:23:53,160,7712,81,79,5310.22,10106.01,0.00
2024-12-10 17:23:53,159,7712,81,78,5332.23,10106.11,0.00
2024-12-10 17:23:53,159,7713,81,78,5370.21,10107.00,0.00
2024-12-10 17:23:53,160,7713,81,79,5336.65,10107.01,0.00
2024-12-10 17:23:53,161,7712,81,80,5302.88,10107.02,0.00
2024-12-10 17:23:53,160,7712,80,80,5359.44,10107.12,0.00
2024-12-10 17:23:53,161,7711,80,81,5251.79,10107.87,0.00
2024-12-10 17:23:53,161,7712,80,81,5309.68,10108.00,0.00
2024-12-10 17:23:53,162,7712,81,81,5276.90,10108.01,0.00
2024-12-10 17:23:53,161,7712,81,80,5307.18,10108.02,0.00
2024-12-10 17:23:53,160,7712,81,79,5339.72,10108.03,0.00
2024-12-10 17:23:53,159,7712,81,78,5365.07,10108.10,0.00
2024-12-10 17:23:53,158,7712,80,78,5397.75,10108.11,0.00
2024-12-10 17:23:53,159,7711,80,79,5357.46,10108.18,0.00
2024-12-10 17:23:53,159,7712,80,79,5523.86,10109.00,0.00
2024-12-10 17:23:53,160,7712,80,80,5489.34,10109.01,0.00
2024-12-10 17:23:53,159,7712,79,80,5513.11,10109.11,0.00
2024-12-10 17:23:53,159,7713,79,80,5550.48,10110.00,0.00
2024-12-10 17:23:53,160,7713,79,81,5515.79,10110.01,0.00
2024-12-10 17:23:53,159,7713,78,81,5539.72,10110.11,0.00
2024-12-10 17:23:53,158,7713,77,81,5574.14,10110.11,0.00
2024-12-10 17:23:53,158,7714,77,81,5548.40,10111.00,0.00
2024-12-10 17:23:53,159,7714,78,81,5513.51,10111.01,0.00
2024-12-10 17:23:53,158,7714,78,80,5539.49,10111.09,0.00
2024-12-10 17:23:53,157,7714,78,79,5572.85,10111.10,0.00
2024-12-10 17:23:54,157,7715,78,79,5546.94,10112.00,0.00
2024-12-10 17:23:54,158,7715,79,79,5511.83,10112.01,0.00
2024-12-10 17:23:54,159,7714,79,80,5473.38,10112.06,0.00
2024-12-10 17:23:54,158,7714,79,79,5553.49,10112.11,0.00
2024-12-10 17:23:54,158,7715,79,79,5528.38,10113.00,0.00
2024-12-10 17:23:54,159,7715,80,79,5493.61,10113.01,0.00
2024-12-10 17:23:54,158,7715,79,79,5517.56,10113.11,0.00
2024-12-10 17:23:54,158,7716,79,79,5555.81,10114.00,0.00
2024-12-10 17:23:54,159,7716,79,80,5520.87,10114.01,0.00
2024-12-10 17:23:54,159,7717,79,80,5484.52,10115.00,0.00
2024-12-10 17:23:54,160,7717,79,81,5450.24,10115.01,0.00
2024-12-10 17:23:54,159,7717,78,81,5473.13,10115.11,0.00
2024-12-10 17:23:54,160,7716,78,82,5409.27,10115.42,0.00
2024-12-10 17:23:54,160,7717,78,82,5454.57,10116.00,0.00
2024-12-10 17:23:54,161,7717,78,83,5420.69,10116.01,0.00
2024-12-10 17:23:54,160,7717,77,83,5448.29,10116.06,0.00
2024-12-10 17:23:54,159,7717,77,82,5480.65,10116.08,0.00
2024-12-10 17:23:54,158,7717,77,81,5512.15,10116.10,0.00
2024-12-10 17:23:54,157,7717,77,80,5545.98,10116.11,0.00
2024-12-10 17:23:54,158,7716,78,80,5485.32,10116.37,0.00
2024-12-10 17:23:54,159,7715,78,81,5466.86,10116.65,0.00
2024-12-10 17:23:54,159,7716,78,81,5581.68,10117.00,0.00
2024-12-10 17:23:54,160,7716,78,82,5546.80,10117.01,0.00
2024-12-10 17:23:54,159,7716,78,81,5570.29,10117.11,0.00
2024-12-10 17:23:54,159,7717,78,81,5671.96,10118.00,0.00
2024-12-10 17:23:54,160,7717,79,81,5636.51,10118.01,0.00
2024-12-10 17:23:54,159,7717,79,80,5660.57,10118.11,0.00
2024-12-10 17:23:54,159,7718,79,80,5634.97,10119.00,0.00
2024-12-10 17:23:54,160,7718,79,81,5599.75,10119.01,0.00
2024-12-10 17:23:54,159,7718,78,81,5623.58,10119.11,0.00
2024-12-10 17:23:54,160,7717,79,81,5579.59,10119.21,0.00
2024-12-10 17:23:54,161,7716,80,81,5491.27,10119.91,0.00
2024-12-10 17:23:54,161,7717,80,81,5551.69,10120.00,0.00
2024-12-10 17:23:54,162,7717,80,82,5517.42,10120.01,0.00
2024-12-10 17:23:54,163,7716,80,83,5480.49,10120.05,0.00
2024-12-10 17:23:54,162,7716,80,82,5532.45,10120.06,0.00
2024-12-10 17:23:54,161,7716,80,81,5561.19,10120.11,0.00
2024-12-10 17:23:54,160,7716,80,80,5595.31,10120.11,0.00
2024-12-10 17:23:54,161,7715,80,81,5501.09,10120.71,0.00
2024-12-10 17:23:54,161,7716,80,81,5677.97,10121.00,0.00
2024-12-10 17:23:54,162,7716,81,81,5642.92,10121.01,0.00
2024-12-10 17:23:54,161,7716,81,80,5667.35,10121.11,0.00
2024-12-10 17:23:54,162,7715,81,81,5606.19,10121.38,0.00
2024-12-10 17:23:54,162,7716,81,81,5772.81,10122.00,0.00
2024-12-10 17:23:54,163,7716,82,81,5737.40,10122.01,0.00
2024-12-10 17:23:54,162,7716,81,81,5762.25,10122.10,0.00
2024-12-10 17:23:54,162,7717,81,81,5797.13,10123.00,0.00
2024-12-10 17:23:54,163,7717,81,82,5761.57,10123.01,0.00
2024-12-10 17:23:54,162,7717,80,82,5785.95,10123.11,0.00
2024-12-10 17:23:54,162,7718,80,82,5758.96,10124.00,0.00
2024-12-10 17:23:54,163,7718,81,82,5723.62,10124.01,0.00
2024-12-10 17:23:54,162,7718,80,82,5747.77,10124.11,0.00
2024-12-10 17:23:54,163,7717,81,82,5672.88,10124.52,0.00
2024-12-10 17:23:54,163,7718,81,82,5701.83,10125.00,0.00
2024-12-10 17:23:54,164,7718,81,83,5667.06,10125.01,0.00
2024-12-10 17:23:54,163,7718,81,82,5690.71,10125.11,0.00
2024-12-10 17:23:54,163,7719,81,82,5725.38,10126.00,0.00
2024-12-10 17:23:54,164,7719,82,82,5690.47,10126.01,0.00
2024-12-10 17:23:54,165,7718,83,82,5655.37,10126.02,0.00
2024-12-10 17:23:54,164,7718,82,82,5691.15,10126.12,0.00
2024-12-10 17:23:54,163,7718,82,81,5725.44,10126.12,0.00
2024-12-10 17:23:54,162,7718,81,81,5760.16,10126.12,0.00
2024-12-10 17:23:54,162,7719,81,81,5733.78,10127.00,0.00
2024-12-10 17:23:54,163,7719,81,82,5698.61,10127.01,0.00
2024-12-10 17:23:54,162,7719,81,81,5722.59,10127.11,0.00
2024-12-10 17:23:54,162,7720,81,81,5758.11,10128.00,0.00
2024-12-10 17:23:54,163,7720,82,81,5722.78,10128.01,0.00
2024-12-10 17:23:54,164,7719,82,82,5680.52,10128.09,0.00
2024-12-10 17:23:54,163,7719,82,81,5744.59,10128.12,0.00
2024-12-10 17:23:54,163,7720,82,81,5717.75,10129.00,0.00
2024-12-10 17:23:54,164,7720,82,82,5682.89,10129.01,0.00
2024-12-10 17:23:54,163,7720,82,81,5706.63,10129.11,0.00
2024-12-10 17:23:54,164,7719,83,81,5634.89,10129.49,0.00
2024-12-10 17:23:54,164,7720,83,81,5725.45,10130.00,0.00
2024-12-10 17:23:54,165,7720,84,81,5690.75,10130.01,0.00
2024-12-10 17:23:54,164,7720,84,80,5713.78,10130.12,0.00
2024-12-10 17:23:54,163,7720,84,79,5748.21,10130.12,0.00
2024-12-10 17:23:54,163,7721,84,79,5783.52,10131.00,0.00
2024-12-10 17:23:54,164,7721,85,79,5748.25,10131.01,0.00
2024-12-10 17:23:54,163,7721,85,78,5771.78,10131.12,0.00
2024-12-10 17:23:54,164,7720,85,79,5679.98,10131.69,0.00
2024-12-10 17:23:54,164,7721,85,79,5730.29,10132.00,0.00
2024-12-10 17:23:54,165,7721,86,79,5695.56,10132.01,0.00
2024-12-10 17:23:54,164,7721,86,78,5718.61,10132.12,0.00
2024-12-10 17:23:54,164,7722,86,78,5753.10,10133.00,0.00
2024-12-10 17:23:54,165,7722,87,78,5718.23,10133.01,0.00
2024-12-10 17:23:54,164,7722,87,77,5741.42,10133.12,0.00
2024-12-10 17:23:55,164,7723,87,77,5714.12,10134.00,0.00
2024-12-10 17:23:55,165,7723,87,78,5679.49,10134.01,0.00
2024-12-10 17:23:55,164,7723,86,78,5702.44,10134.12,0.00
2024-12-10 17:23:55,164,7724,86,78,5675.13,10135.00,0.00
2024-12-10 17:23:55,165,7724,87,78,5640.73,10135.01,0.00
2024-12-10 17:23:55,164,7724,87,77,5663.45,10135.12,0.00
2024-12-10 17:23:55,165,7723,88,77,5578.33,10135.63,0.00
2024-12-10 17:23:55,165,7724,88,77,5625.93,10136.00,0.00
2024-12-10 17:23:55,166,7724,88,78,5592.04,10136.01,0.00
2024-12-10 17:23:55,165,7724,87,78,5614.32,10136.12,0.00
2024-12-10 17:23:55,165,7725,87,78,5647.99,10137.00,0.00
2024-12-10 17:23:55,166,7725,88,78,5613.97,10137.01,0.00
2024-12-10 17:23:55,167,7724,89,78,5576.13,10137.06,0.00
2024-12-10 17:23:55,166,7724,88,78,5638.43,10137.07,0.00
2024-12-10 17:23:55,165,7724,87,78,5671.38,10137.07,0.00
2024-12-10 17:23:55,164,7724,86,78,5701.65,10137.11,0.00
2024-12-10 17:23:55,163,7724,85,78,5736.01,10137.11,0.00
2024-12-10 17:23:55,162,7724,85,77,5770.79,10137.11,0.00
2024-12-10 17:23:55,162,7725,85,77,5743.77,10138.00,0.00
2024-12-10 17:23:55,163,7725,85,78,5708.53,10138.01,0.00
2024-12-10 17:23:55,162,7725,85,77,5733.19,10138.10,0.00
2024-12-10 17:23:55,162,7726,85,77,5768.12,10139.00,0.00
2024-12-10 17:23:55,163,7726,85,78,5732.73,10139.01,0.00
2024-12-10 17:23:55,162,7726,85,77,5757.54,10139.10,0.00
2024-12-10 17:23:55,163,7725,85,78,5636.83,10139.96,0.00
2024-12-10 17:23:55,163,7726,85,78,5697.83,10140.00,0.00
2024-12-10 17:23:55,164,7726,86,78,5663.09,10140.01,0.00
2024-12-10 17:23:55,165,7725,86,79,5625.10,10140.05,0.00
2024-12-10 17:23:55,164,7725,85,79,5669.95,10140.11,0.00
2024-12-10 17:23:55,164,7726,85,79,5703.84,10141.00,0.00
2024-12-10 17:23:55,165,7726,86,79,5669.27,10141.01,0.00
2024-12-10 17:23:55,166,7725,87,79,5627.23,10141.10,0.00
2024-12-10 17:23:55,165,7725,87,78,5714.20,10141.11,0.00
2024-12-10 17:23:55,166,7724,87,79,5596.53,10141.95,0.00
2024-12-10 17:23:55,166,7725,87,79,5716.32,10142.00,0.00
2024-12-10 17:23:55,167,7725,88,79,5682.09,10142.01,0.00
2024-12-10 17:23:55,166,7725,88,78,5706.00,10142.10,0.00
2024-12-10 17:23:55,167,7724,89,78,5645.78,10142.37,0.00
2024-12-10 17:23:55,167,7725,89,78,5771.94,10143.00,0.00
2024-12-10 17:23:55,168,7725,90,78,5737.58,10143.01,0.00
2024-12-10 17:23:55,167,7725,90,77,5761.67,10143.10,0.00
2024-12-10 17:23:55,166,7725,89,77,5780.73,10143.25,0.00
2024-12-10 17:23:55,166,7726,89,77,5827.65,10144.00,0.00
2024-12-10 17:23:55,167,7726,89,78,5792.75,10144.01,0.00
2024-12-10 17:23:55,166,7726,89,77,5817.32,10144.10,0.00
2024-12-10 17:23:55,167,7725,89,78,5706.33,10144.87,0.00
2024-12-10 17:23:55,167,7726,89,78,5762.34,10145.00,0.00
2024-12-10 17:23:55,168,7726,89,79,5728.04,10145.01,0.00
2024-12-10 17:23:55,167,7726,88,79,5752.07,10145.10,0.00
2024-12-10 17:23:55,167,7727,88,79,5782.96,10146.00,0.00
2024-12-10 17:23:55,168,7727,88,80,5748.53,10146.01,0.00
2024-12-10 17:23:55,167,7727,88,79,5772.69,10146.10,0.00
2024-12-10 17:23:55,168,7726,88,80,5669.19,10146.80,0.00
2024-12-10 17:23:55,168,7727,88,80,5721.92,10147.00,0.00
2024-12-10 17:23:55,169,7727,88,81,5688.06,10147.01,0.00
2024-12-10 17:23:55,168,7727,87,81,5711.71,10147.10,0.00
2024-12-10 17:23:55,168,7727,87,81,5741.82,10148.00,0.00
2024-12-10 17:23:55,169,7727,88,81,5707.84,10148.01,0.00
2024-12-10 17:23:55,170,7726,89,81,5666.55,10148.09,0.00
2024-12-10 17:23:55,171,7725,90,81,5593.21,10148.54,0.00
2024-12-10 17:23:55,171,7726,90,81,5635.11,10149.00,0.00
2024-12-10 17:23:55,172,7726,91,81,5602.35,10149.01,0.00
2024-12-10 17:23:55,171,7726,90,81,5624.48,10149.11,0.00
2024-12-10 17:23:55,171,7727,90,81,5712.24,10150.00,0.00
2024-12-10 17:23:55,172,7727,90,82,5679.03,10150.01,0.00
2024-12-10 17:23:55,172,7728,90,82,5637.68,10151.00,0.00
2024-12-10 17:23:55,173,7728,90,83,5605.09,10151.01,0.00
2024-12-10 17:23:55,172,7728,90,82,5625.35,10151.12,0.00
2024-12-10 17:23:55,172,7729,90,82,5595.74,10152.00,0.00
2024-12-10 17:23:55,173,7729,90,83,5563.39,10152.01,0.00
2024-12-10 17:23:55,174,7728,91,83,5520.98,10152.12,0.00
2024-12-10 17:23:55,173,7728,91,82,5595.74,10152.13,0.00
2024-12-10 17:23:55,173,7729,91,82,5566.88,10153.00,0.00
2024-12-10 17:23:55,174,7729,91,83,5534.88,10153.01,0.00
2024-12-10 17:23:55,173,7729,91,82,5554.03,10153.13,0.00
2024-12-10 17:23:55,174,7728,91,83,5505.80,10153.30,0.00
2024-12-10 17:23:55,174,7729,91,83,5557.60,10154.00,0.00
2024-12-10 17:23:55,175,7729,92,83,5525.84,10154.01,0.00
2024-12-10 17:23:55,176,7728,93,83,5489.28,10154.07,0.00
2024-12-10 17:23:55,175,7728,92,83,5546.22,10154.14,0.00
2024-12-10 17:23:55,176,7727,93,83,5472.16,10154.57,0.00
2024-12-10 17:23:55,176,7728,93,83,5570.58,10155.00,0.00
2024-12-10 17:23:55,177,7728,93,84,5539.10,10155.01,0.00
2024-12-10 17:23:55,176,7728,92,84,5557.37,10155.13,0.00
2024-12-10 17:23:55,177,7727,93,84,5452.32,10155.87,0.00
2024-12-10 17:23:56,177,7728,93,84,5618.83,10156.00,0.00
2024-12-10 17:23:56,178,7728,93,85,5587.26,10156.01,0.00
2024-12-10 17:23:56,177,7728,92,85,5605.70,10156.13,0.00
2024-12-10 17:23:56,178,7727,92,86,5548.02,10156.40,0.00
2024-12-10 17:23:56,179,7726,92,87,5534.71,10156.59,0.00
2024-12-10 17:23:56,180,7725,93,87,5504.14,10156.84,0.00
2024-12-10 17:23:56,180,7726,93,87,5609.81,10157.00,0.00
2024-12-10 17:23:56,181,7726,93,88,5578.81,10157.01,0.00
2024-12-10 17:23:56,182,7725,93,89,5545.94,10157.04,0.00
2024-12-10 17:23:56,181,7725,92,89,5611.99,10157.13,0.00
2024-12-10 17:23:56,181,7726,92,89,5716.09,10158.00,0.00
2024-12-10 17:23:56,182,7726,92,90,5684.68,10158.01,0.00
2024-12-10 17:23:56,181,7726,91,90,5703.25,10158.13,0.00
2024-12-10 17:23:56,180,7726,90,90,5734.37,10158.13,0.00
2024-12-10 17:23:56,181,7725,90,91,5672.47,10158.44,0.00
2024-12-10 17:23:56,180,7725,90,90,5691.99,10158.78,0.00
2024-12-10 17:23:56,181,7724,90,91,5656.09,10158.83,0.00
2024-12-10 17:23:56,181,7724,90,91,5752.22,10159.00,0.00
2024-12-10 17:23:56,182,7724,90,92,5720.62,10159.01,0.00
2024-12-10 17:23:56,181,7724,90,91,5739.38,10159.13,0.00
2024-12-10 17:23:56,181,7725,90,91,5819.58,10160.00,0.00
2024-12-10 17:23:56,182,7725,90,92,5787.61,10160.01,0.00
2024-12-10 17:23:56,183,7724,91,92,5748.80,10160.09,0.00
2024-12-10 17:23:56,182,7724,91,91,5782.89,10160.12,0.00
2024-12-10 17:23:56,181,7724,91,90,5813.72,10160.13,0.00
2024-12-10 17:23:56,182,7723,91,91,5685.14,10160.80,0.00
2024-12-10 17:23:56,182,7724,91,91,5731.10,10161.00,0.00
2024-12-10 17:23:56,183,7724,91,92,5699.78,10161.01,0.00
2024-12-10 17:23:56,184,7723,92,92,5660.57,10161.10,0.00
2024-12-10 17:23:56,183,7723,92,91,5710.96,10161.13,0.00
2024-12-10 17:23:56,182,7723,91,91,5677.61,10161.68,0.00
2024-12-10 17:23:56,183,7722,92,91,5638.32,10161.77,0.00
2024-12-10 17:23:56,183,7723,92,91,5752.61,10162.00,0.00
2024-12-10 17:23:56,184,7723,93,91,5721.34,10162.01,0.00
2024-12-10 17:23:56,183,7723,93,90,5740.46,10162.12,0.00
2024-12-10 17:23:56,182,7723,93,89,5683.81,10162.75,0.00
2024-12-10 17:23:56,182,7724,93,89,5730.97,10163.00,0.00
2024-12-10 17:23:56,183,7724,93,90,5699.65,10163.01,0.00
2024-12-10 17:23:56,182,7724,92,90,5718.75,10163.12,0.00
2024-12-10 17:23:56,181,7724,91,90,5675.69,10163.75,0.00
2024-12-10 17:23:56,180,7724,90,90,5668.32,10163.93,0.00
2024-12-10 17:23:56,179,7724,89,90,5669.69,10163.99,0.00
2024-12-10 17:23:56,179,7725,89,90,5725.91,10164.00,0.00
2024-12-10 17:23:56,180,7725,90,90,5694.10,10164.01,0.00
2024-12-10 17:23:56,179,7725,89,90,5713.48,10164.12,0.00
2024-12-10 17:23:56,179,7726,89,90,5681.61,10165.00,0.00
2024-12-10 17:23:56,180,7726,89,91,5650.04,10165.01,0.00
2024-12-10 17:23:56,179,7726,89,90,5669.18,10165.12,0.00
2024-12-10 17:23:56,179,7727,89,90,5637.30,10166.00,0.00
2024-12-10 17:23:56,180,7727,90,90,5605.98,10166.01,0.00
2024-12-10 17:23:56,179,7727,89,90,5624.87,10166.12,0.00
2024-12-10 17:23:56,180,7726,89,91,5509.35,10166.97,0.00
2024-12-10 17:23:56,180,7727,89,91,5565.30,10167.00,0.00
2024-12-10 17:23:56,181,7727,89,92,5534.55,10167.01,0.00
2024-12-10 17:23:56,180,7727,89,91,5552.93,10167.12,0.00
2024-12-10 17:23:56,181,7726,89,92,5478.03,10167.57,0.00
2024-12-10 17:23:56,181,7727,89,92,5573.30,10168.00,0.00
2024-12-10 17:23:56,182,7727,89,93,5542.67,10168.01,0.00
2024-12-10 17:23:56,181,7727,88,93,5561.00,10168.12,0.00
2024-12-10 17:23:56,181,7728,88,93,5553.42,10169.00,0.00
2024-12-10 17:23:56,182,7728,88,94,5522.91,10169.01,0.00
2024-12-10 17:23:56,181,7728,88,93,5541.12,10169.12,0.00
2024-12-10 17:23:56,180,7728,88,92,5485.43,10169.82,0.00
2024-12-10 17:23:56,180,7729,88,92,5524.00,10170.00,0.00
2024-12-10 17:23:56,181,7729,89,92,5493.48,10170.01,0.00
2024-12-10 17:23:56,180,7729,88,92,5511.63,10170.12,0.00
2024-12-10 17:23:56,180,7730,88,92,5479.34,10171.00,0.00
2024-12-10 17:23:56,181,7730,88,93,5449.07,10171.01,0.00
2024-12-10 17:23:56,180,7730,88,92,5466.97,10171.12,0.00
2024-12-10 17:23:56,180,7731,88,92,5434.67,10172.00,0.00
2024-12-10 17:23:56,181,7731,88,93,5404.64,10172.01,0.00
2024-12-10 17:23:56,180,7731,88,92,5422.29,10172.12,0.00
2024-12-10 17:23:56,181,7730,89,92,5336.90,10172.68,0.00
2024-12-10 17:23:56,181,7731,89,92,5377.64,10173.00,0.00
2024-12-10 17:23:56,182,7731,90,92,5348.09,10173.01,0.00
2024-12-10 17:23:56,181,7731,90,91,5365.33,10173.12,0.00
2024-12-10 17:23:56,181,7732,90,91,5388.84,10174.00,0.00
2024-12-10 17:23:56,182,7732,91,91,5359.23,10174.01,0.00
2024-12-10 17:23:56,181,7732,91,90,5387.16,10174.02,0.00
2024-12-10 17:23:56,180,7732,90,90,5406.40,10174.12,0.00
2024-12-10 17:23:56,179,7732,90,89,5436.04,10174.12,0.00
2024-12-10 17:23:56,179,7732,90,89,5380.51,10175.00,0.00
2024-12-10 17:23:56,180,7732,91,89,5350.61,10175.01,0.00
2024-12-10 17:23:56,179,7732,90,89,5378.81,10175.02,0.00
2024-12-10 17:23:56,178,7732,89,89,5398.78,10175.11,0.00
2024-12-10 17:23:56,177,7732,88,89,5428.14,10175.12,0.00
2024-12-10 17:23:56,176,7732,87,89,5458.40,10175.12,0.00
2024-12-10 17:23:56,177,7731,88,89,5420.10,10175.20,0.00
2024-12-10 17:23:56,177,7732,88,89,5422.25,10176.00,0.00
2024-12-10 17:23:56,178,7732,88,90,5391.79,10176.01,0.00
2024-12-10 17:23:57,177,7732,87,90,5409.66,10176.12,0.00
2024-12-10 17:23:57,176,7732,87,89,5364.21,10176.88,0.00
2024-12-10 17:23:57,176,7733,87,89,5467.24,10177.00,0.00
2024-12-10 17:23:57,177,7733,88,89,5436.35,10177.01,0.00
2024-12-10 17:23:57,176,7733,87,89,5454.58,10177.13,0.00
2024-12-10 17:23:57,176,7734,87,89,5423.83,10178.00,0.00
2024-12-10 17:23:57,177,7734,88,89,5393.19,10178.01,0.00
2024-12-10 17:23:57,176,7734,87,89,5411.16,10178.13,0.00
2024-12-10 17:23:57,176,7735,87,89,5380.41,10179.00,0.00
2024-12-10 17:23:57,177,7735,88,89,5350.01,10179.01,0.00
2024-12-10 17:23:57,176,7735,87,89,5367.74,10179.13,0.00
2024-12-10 17:23:57,177,7734,88,89,5272.13,10179.78,0.00
2024-12-10 17:23:57,177,7735,88,89,5321.78,10180.00,0.00
2024-12-10 17:23:57,178,7735,89,89,5291.88,10180.01,0.00
2024-12-10 17:23:57,177,7735,88,89,5308.61,10180.13,0.00
2024-12-10 17:23:57,178,7734,88,90,5252.54,10180.40,0.00
2024-12-10 17:23:57,179,7733,89,90,5218.34,10180.85,0.00
2024-12-10 17:23:57,179,7734,89,90,5328.24,10181.00,0.00
2024-12-10 17:23:57,180,7734,90,90,5298.64,10181.01,0.00
2024-12-10 17:23:57,179,7734,89,90,5315.22,10181.13,0.00
2024-12-10 17:23:57,179,7735,89,90,5397.59,10182.00,0.00
2024-12-10 17:23:57,180,7735,89,91,5367.61,10182.01,0.00
2024-12-10 17:23:57,179,7735,89,90,5384.56,10182.13,0.00
2024-12-10 17:23:57,179,7736,89,90,5353.18,10183.00,0.00
2024-12-10 17:23:57,180,7736,90,90,5323.44,10183.01,0.00
2024-12-10 17:23:57,179,7736,89,90,5340.15,10183.13,0.00
2024-12-10 17:23:57,180,7735,89,91,5288.47,10183.36,0.00
2024-12-10 17:23:57,181,7734,89,92,5268.98,10183.69,0.00
2024-12-10 17:23:57,181,7735,89,92,5313.68,10184.00,0.00
2024-12-10 17:23:57,182,7735,90,92,5284.49,10184.01,0.00
2024-12-10 17:23:57,181,7735,89,92,5300.79,10184.13,0.00
2024-12-10 17:23:57,181,7736,89,92,5352.53,10185.00,0.00
2024-12-10 17:23:57,182,7736,90,92,5323.12,10185.01,0.00
2024-12-10 17:23:57,181,7736,90,91,5339.64,10185.13,0.00
2024-12-10 17:23:57,180,7736,90,90,5287.96,10185.66,0.00
2024-12-10 17:23:57,181,7735,91,90,5241.98,10185.83,0.00
2024-12-10 17:23:57,181,7736,91,90,5264.59,10186.00,0.00
2024-12-10 17:23:57,182,7736,91,91,5235.67,10186.01,0.00
2024-12-10 17:23:57,181,7736,91,90,5255.62,10186.09,0.00
2024-12-10 17:23:57,180,7736,90,90,5280.87,10186.12,0.00
2024-12-10 17:23:57,179,7736,90,89,5196.50,10186.98,0.00
2024-12-10 17:23:57,179,7737,90,89,5308.62,10187.00,0.00
2024-12-10 17:23:57,180,7737,91,89,5279.12,10187.01,0.00
2024-12-10 17:23:57,179,7737,91,88,5295.58,10187.13,0.00
2024-12-10 17:23:57,178,7737,90,88,5324.19,10187.13,0.00
2024-12-10 17:23:57,177,7737,89,88,5353.69,10187.14,0.00
2024-12-10 17:23:57,178,7736,90,88,5252.40,10187.85,0.00
2024-12-10 17:23:57,178,7737,90,88,5305.04,10188.00,0.00
2024-12-10 17:23:57,179,7737,91,88,5275.40,10188.01,0.00
2024-12-10 17:23:57,178,7737,91,87,5291.36,10188.13,0.00
2024-12-10 17:23:57,177,7737,90,87,5258.05,10188.51,0.00
2024-12-10 17:23:57,177,7738,90,87,5320.66,10189.00,0.00
2024-12-10 17:23:57,178,7738,90,88,5290.77,10189.01,0.00
2024-12-10 17:23:57,177,7738,89,88,5306.90,10189.14,0.00
2024-12-10 17:23:57,177,7739,89,88,5269.51,10190.00,0.00
2024-12-10 17:23:57,178,7739,90,88,5239.91,10190.01,0.00
2024-12-10 17:23:57,179,7738,91,88,5199.86,10190.12,0.00
2024-12-10 17:23:57,178,7738,91,87,5247.40,10190.14,0.00
2024-12-10 17:23:57,179,7737,92,87,5158.55,10190.74,0.00
2024-12-10 17:23:57,179,7738,92,87,5196.47,10191.00,0.00
2024-12-10 17:23:57,180,7738,92,88,5167.60,10191.01,0.00
2024-12-10 17:23:57,179,7738,91,88,5182.86,10191.13,0.00
2024-12-10 17:23:57,179,7739,91,88,5253.01,10192.00,0.00
2024-12-10 17:23:57,180,7739,92,88,5223.82,10192.01,0.00
2024-12-10 17:23:57,179,7739,92,87,5249.04,10192.04,0.00
2024-12-10 17:23:57,178,7739,92,86,5276.81,10192.05,0.00
2024-12-10 17:23:57,177,7739,92,85,5297.45,10192.14,0.00
2024-12-10 17:23:57,178,7738,92,86,5208.94,10192.72,0.00
2024-12-10 17:23:57,177,7738,92,85,5234.80,10192.83,0.00
2024-12-10 17:23:57,177,7739,92,85,5275.26,10193.00,0.00
2024-12-10 17:23:57,178,7739,92,86,5245.62,10193.01,0.00
2024-12-10 17:23:57,177,7739,91,86,5261.49,10193.14,0.00
2024-12-10 17:23:57,176,7739,90,86,5290.23,10193.14,0.00
2024-12-10 17:23:57,177,7738,91,86,5216.71,10193.58,0.00
2024-12-10 17:23:57,177,7739,91,86,5313.90,10194.00,0.00
2024-12-10 17:23:57,178,7739,92,86,5284.05,10194.01,0.00
2024-12-10 17:23:57,179,7738,92,87,5249.42,10194.07,0.00
2024-12-10 17:23:57,178,7738,91,87,5289.25,10194.15,0.00
2024-12-10 17:23:57,178,7739,91,87,5311.75,10195.00,0.00
2024-12-10 17:23:57,179,7739,92,87,5282.07,10195.01,0.00
2024-12-10 17:23:57,178,7739,92,86,5305.47,10195.06,0.00
2024-12-10 17:23:57,177,7739,91,86,5327.41,10195.14,0.00
2024-12-10 17:23:57,176,7739,91,85,5357.10,10195.14,0.00
2024-12-10 17:23:57,176,7740,91,85,5378.72,10196.00,0.00
2024-12-10 17:23:57,177,7740,92,85,5348.33,10196.01,0.00
2024-12-10 17:23:57,177,7741,92,85,5297.83,10197.00,0.00
2024-12-10 17:23:57,178,7741,92,86,5268.06,10197.01,0.00
2024-12-10 17:23:57,179,7740,92,87,5235.79,10197.04,0.00
2024-12-10 17:23:58,179,7741,92,87,5222.36,10198.00,0.00
2024-12-10 17:23:58,180,7741,92,88,5193.35,10198.01,0.00
2024-12-10 17:23:58,181,7740,92,89,5156.24,10198.10,0.00
2024-12-10 17:23:58,180,7740,91,89,5220.04,10198.16,0.00
2024-12-10 17:23:58,181,7739,91,90,5135.63,10198.71,0.00
2024-12-10 17:23:58,181,7740,91,90,5233.10,10199.00,0.00
2024-12-10 17:23:58,182,7740,91,91,5204.34,10199.01,0.00
2024-12-10 17:23:58,181,7740,90,91,5216.82,10199.16,0.00
2024-12-10 17:23:58,182,7739,91,91,5151.27,10199.53,0.00
2024-12-10 17:23:58,182,7740,91,91,5269.46,10200.00,0.00
2024-12-10 17:23:58,183,7740,91,92,5240.67,10200.01,0.00
2024-12-10 17:23:58,182,7740,91,91,5258.30,10200.11,0.00
2024-12-10 17:23:58,181,7740,90,91,5282.29,10200.15,0.00
2024-12-10 17:23:58,180,7740,89,91,5311.07,10200.16,0.00
2024-12-10 17:23:58,180,7741,89,91,5334.41,10201.00,0.00
2024-12-10 17:23:58,181,7741,90,91,5304.93,10201.01,0.00
2024-12-10 17:23:58,180,7741,89,91,5318.60,10201.16,0.00
2024-12-10 17:23:58,181,7740,90,91,5253.25,10201.52,0.00
2024-12-10 17:23:58,182,7739,90,92,5248.52,10201.60,0.00
2024-12-10 17:23:58,181,7739,90,91,5288.39,10201.72,0.00
2024-12-10 17:23:58,181,7740,90,91,5315.66,10202.00,0.00
2024-12-10 17:23:58,182,7740,90,92,5286.45,10202.01,0.00
2024-12-10 17:23:58,181,7740,90,91,5299.94,10202.15,0.00
2024-12-10 17:23:58,181,7741,90,91,5379.94,10203.00,0.00
2024-12-10 17:23:58,182,7741,90,92,5350.38,10203.01,0.00
2024-12-10 17:23:58,181,7741,90,91,5364.22,10203.15,0.00
2024-12-10 17:23:58,182,7740,90,92,5329.15,10203.22,0.00
2024-12-10 17:23:58,182,7741,90,92,5312.15,10204.00,0.00
2024-12-10 17:23:58,183,7741,91,92,5283.13,10204.01,0.00
2024-12-10 17:23:58,182,7741,91,91,5298.75,10204.13,0.00
2024-12-10 17:23:58,181,7741,91,90,5325.77,10204.15,0.00
2024-12-10 17:23:58,180,7741,90,90,5354.79,10204.15,0.00
2024-12-10 17:23:58,180,7742,90,90,5373.44,10205.00,0.00
2024-12-10 17:23:58,181,7742,90,91,5343.75,10205.01,0.00
2024-12-10 17:23:58,180,7742,90,90,5372.87,10205.01,0.00
2024-12-10 17:23:58,179,7742,89,90,5388.12,10205.15,0.00
2024-12-10 17:23:58,178,7742,88,90,5417.82,10205.15,0.00
2024-12-10 17:23:58,179,7741,89,90,5331.90,10205.70,0.00
2024-12-10 17:23:58,179,7742,89,90,5369.18,10206.00,0.00
2024-12-10 17:23:58,180,7742,89,91,5339.35,10206.01,0.00
2024-12-10 17:23:58,179,7742,89,90,5354.41,10206.15,0.00
2024-12-10 17:23:58,180,7741,90,90,5278.33,10206.61,0.00
2024-12-10 17:23:58,180,7742,90,90,5367.49,10207.00,0.00
2024-12-10 17:23:58,181,7742,91,90,5337.83,10207.01,0.00
2024-12-10 17:23:58,180,7742,90,90,5355.62,10207.12,0.00
2024-12-10 17:23:58,179,7742,90,89,5381.56,10207.15,0.00
2024-12-10 17:23:58,179,7743,90,89,5391.20,10208.00,0.00
2024-12-10 17:23:58,180,7743,90,90,5361.24,10208.01,0.00
2024-12-10 17:23:58,179,7743,90,89,5386.65,10208.04,0.00
2024-12-10 17:23:58,178,7743,89,89,5406.06,10208.15,0.00
2024-12-10 17:23:58,178,7744,89,89,5325.96,10209.00,0.00
2024-12-10 17:23:58,179,7744,90,89,5296.21,10209.01,0.00
2024-12-10 17:23:58,178,7744,89,89,5192.93,10209.86,0.00
2024-12-10 17:23:58,178,7745,89,89,5228.71,10210.00,0.00
2024-12-10 17:23:58,179,7745,90,89,5199.50,10210.01,0.00
2024-12-10 17:23:58,178,7745,90,88,5212.71,10210.16,0.00
2024-12-10 17:23:58,177,7745,90,87,5168.45,10210.79,0.00
2024-12-10 17:23:58,177,7746,90,87,5186.65,10211.00,0.00
2024-12-10 17:23:58,178,7746,91,87,5157.51,10211.01,0.00
2024-12-10 17:23:58,178,7747,91,87,5092.39,10212.00,0.00
2024-12-10 17:23:58,179,7747,92,87,5063.94,10212.01,0.00
2024-12-10 17:23:58,178,7747,91,87,5075.81,10212.16,0.00
2024-12-10 17:23:58,177,7747,91,86,5103.91,10212.16,0.00
2024-12-10 17:23:58,176,7747,90,86,5067.94,10212.77,0.00
2024-12-10 17:23:58,175,7747,89,86,5093.69,10212.79,0.00
2024-12-10 17:23:58,175,7748,89,86,5126.33,10213.00,0.00
2024-12-10 17:23:58,176,7748,89,87,5097.21,10213.01,0.00
2024-12-10 17:23:58,177,7747,90,87,5068.41,10213.02,0.00
2024-12-10 17:23:58,176,7747,89,87,5130.93,10213.17,0.00
2024-12-10 17:23:58,176,7748,89,87,5099.96,10214.00,0.00
2024-12-10 17:23:58,177,7748,90,87,5071.14,10214.01,0.00
2024-12-10 17:23:58,176,7748,90,86,5083.19,10214.17,0.00
2024-12-10 17:23:58,175,7748,90,85,5111.17,10214.17,0.00
2024-12-10 17:23:58,174,7748,90,84,5065.64,10214.85,0.00
2024-12-10 17:23:58,174,7749,90,84,5167.91,10215.00,0.00
2024-12-10 17:23:58,175,7749,90,85,5138.38,10215.01,0.00
2024-12-10 17:23:58,174,7749,89,85,5160.90,10215.07,0.00
2024-12-10 17:23:58,173,7749,89,84,5180.73,10215.16,0.00
2024-12-10 17:23:58,173,7750,89,84,5152.12,10216.00,0.00
2024-12-10 17:23:58,174,7750,90,84,5122.51,10216.01,0.00
2024-12-10 17:23:58,173,7750,89,84,5146.24,10216.06,0.00
2024-12-10 17:23:58,172,7750,89,83,5173.20,10216.08,0.00
2024-12-10 17:23:58,171,7750,89,82,5195.71,10216.15,0.00
2024-12-10 17:23:58,170,7750,88,82,5225.67,10216.15,0.00
2024-12-10 17:23:58,169,7750,88,81,5255.99,10216.15,0.00
2024-12-10 17:23:58,169,7751,88,81,5226.94,10217.00,0.00
2024-12-10 17:23:58,170,7751,89,81,5196.19,10217.01,0.00
2024-12-10 17:23:58,169,7751,89,80,5211.28,10217.15,0.00
2024-12-10 17:23:59,169,7752,89,80,5177.96,10218.00,0.00
2024-12-10 17:23:59,170,7752,90,80,5147.50,10218.01,0.00
2024-12-10 17:23:59,171,7751,90,81,5112.04,10218.07,0.00
2024-12-10 17:23:59,170,7751,89,81,5171.60,10218.16,0.00
2024-12-10 17:23:59,171,7750,90,81,5129.42,10218.29,0.00
2024-12-10 17:23:59,171,7751,90,81,5148.52,10219.00,0.00
2024-12-10 17:23:59,172,7751,90,82,5118.59,10219.01,0.00
2024-12-10 17:23:59,173,7750,90,83,5084.88,10219.06,0.00
2024-12-10 17:23:59,172,7750,90,82,5119.83,10219.14,0.00
2024-12-10 17:23:59,173,7749,90,83,5089.06,10219.16,0.00
2024-12-10 17:23:59,172,7749,89,83,5148.36,10219.16,0.00
2024-12-10 17:23:59,171,7749,88,83,5177.87,10219.16,0.00
2024-12-10 17:23:59,170,7749,88,82,5168.11,10219.50,0.00
2024-12-10 17:23:59,170,7750,88,82,5275.89,10220.00,0.00
2024-12-10 17:23:59,171,7750,88,83,5245.04,10220.01,0.00
2024-12-10 17:23:59,170,7750,87,83,5274.10,10220.02,0.00
2024-12-10 17:23:59,169,7750,87,82,5297.48,10220.09,0.00
2024-12-10 17:23:59,168,7750,87,81,5322.95,10220.14,0.00
2024-12-10 17:23:59,167,7750,87,80,5354.22,10220.14,0.00
2024-12-10 17:23:59,166,7750,87,79,5385.85,10220.14,0.00
2024-12-10 17:23:59,167,7749,87,80,5348.10,10220.21,0.00
2024-12-10 17:23:59,166,7749,87,79,5387.05,10220.67,0.00
2024-12-10 17:23:59,166,7750,87,79,5535.40,10221.00,0.00
2024-12-10 17:23:59,167,7750,87,80,5502.25,10221.01,0.00
2024-12-10 17:23:59,166,7750,86,80,5529.27,10221.06,0.00
2024-12-10 17:23:59,165,7750,85,80,5554.15,10221.14,0.00
2024-12-10 17:23:59,164,7750,85,79,5587.39,10221.14,0.00
2024-12-10 17:23:59,165,7749,86,79,5498.61,10221.69,0.00
2024-12-10 17:23:59,166,7748,86,80,5480.31,10221.75,0.00
2024-12-10 17:23:59,166,7749,86,80,5591.48,10222.00,0.00
2024-12-10 17:23:59,167,7749,86,81,5558.00,10222.01,0.00
2024-12-10 17:23:59,166,7749,85,81,5577.39,10222.14,0.00
2024-12-10 17:23:59,166,7750,85,81,5652.33,10223.00,0.00
2024-12-10 17:23:59,167,7750,86,81,5618.48,10223.01,0.00
2024-12-10 17:23:59,166,7750,86,80,5638.23,10223.14,0.00
2024-12-10 17:23:59,167,7749,86,81,5587.37,10223.32,0.00
2024-12-10 17:23:59,166,7749,86,80,5601.38,10223.54,0.00
2024-12-10 17:23:59,166,7750,86,80,5612.65,10224.00,0.00
2024-12-10 17:23:59,167,7750,86,81,5579.04,10224.01,0.00
2024-12-10 17:23:59,166,7750,85,81,5597.94,10224.14,0.00
2024-12-10 17:23:59,166,7751,85,81,5628.87,10225.00,0.00
2024-12-10 17:23:59,167,7751,86,81,5595.16,10225.01,0.00
2024-12-10 17:23:59,166,7751,86,80,5614.15,10225.14,0.00
2024-12-10 17:23:59,167,7750,87,80,5577.48,10225.19,0.00
2024-12-10 17:23:59,167,7751,87,80,5600.68,10226.00,0.00
2024-12-10 17:23:59,168,7751,88,80,5567.34,10226.01,0.00
2024-12-10 17:23:59,167,7751,87,80,5586.05,10226.14,0.00
2024-12-10 17:23:59,166,7751,86,80,5619.08,10226.14,0.00
2024-12-10 17:23:59,166,7752,86,80,5651.28,10227.00,0.00
2024-12-10 17:23:59,167,7752,86,81,5617.44,10227.01,0.00
2024-12-10 17:23:59,168,7751,86,82,5519.12,10227.65,0.00
2024-12-10 17:23:59,168,7752,86,82,5563.23,10228.00,0.00
2024-12-10 17:23:59,169,7752,86,83,5530.31,10228.01,0.00
2024-12-10 17:23:59,170,7751,87,83,5494.78,10228.05,0.00
2024-12-10 17:23:59,169,7751,87,82,5575.77,10228.15,0.00
2024-12-10 17:23:59,169,7752,87,82,5607.75,10229.00,0.00
2024-12-10 17:23:59,170,7752,88,82,5574.77,10229.01,0.00
2024-12-10 17:23:59,169,7752,88,81,5592.69,10229.15,0.00
2024-12-10 17:23:59,169,7753,88,81,5624.42,10230.00,0.00
2024-12-10 17:23:59,170,7753,88,82,5591.34,10230.01,0.00
2024-12-10 17:23:59,170,7754,88,82,5547.11,10231.00,0.00
2024-12-10 17:23:59,171,7754,88,83,5514.67,10231.01,0.00
2024-12-10 17:23:59,172,7753,88,84,5476.10,10231.08,0.00
2024-12-10 17:23:59,171,7753,87,84,5538.05,10231.11,0.00
2024-12-10 17:23:59,170,7753,86,84,5565.24,10231.15,0.00
2024-12-10 17:23:59,170,7754,86,84,5534.39,10232.00,0.00
2024-12-10 17:23:59,171,7754,87,84,5502.03,10232.01,0.00
2024-12-10 17:23:59,170,7754,86,84,5518.82,10232.15,0.00
2024-12-10 17:23:59,170,7755,86,84,5544.16,10233.00,0.00
2024-12-10 17:23:59,171,7755,86,85,5511.74,10233.01,0.00
2024-12-10 17:23:59,170,7755,85,85,5528.59,10233.15,0.00
2024-12-10 17:23:59,169,7755,84,85,5559.25,10233.17,0.00
2024-12-10 17:23:59,170,7754,85,85,5518.74,10233.26,0.00
2024-12-10 17:23:59,169,7754,84,85,5598.83,10233.28,0.00
2024-12-10 17:23:59,169,7755,84,85,5576.09,10234.00,0.00
2024-12-10 17:23:59,170,7755,84,86,5543.29,10234.01,0.00
2024-12-10 17:23:59,171,7754,84,87,5448.09,10234.53,0.00
2024-12-10 17:23:59,172,7753,84,88,5429.71,10234.69,0.00
2024-12-10 17:23:59,172,7754,84,88,5537.66,10235.00,0.00
2024-12-10 17:23:59,173,7754,84,89,5505.65,10235.01,0.00
2024-12-10 17:23:59,172,7754,83,89,5529.37,10235.08,0.00
2024-12-10 17:23:59,171,7754,82,89,5553.36,10235.16,0.00
2024-12-10 17:23:59,172,7753,83,89,5519.89,10235.18,0.00
2024-12-10 17:23:59,173,7752,84,89,5531.80,10235.31,0.00
2024-12-10 17:23:59,173,7753,84,89,5642.32,10236.00,0.00
2024-12-10 17:23:59,174,7753,84,90,5609.89,10236.01,0.00
2024-12-10 17:23:59,173,7753,84,89,5604.69,10236.36,0.00
2024-12-10 17:23:59,173,7754,84,89,5708.04,10237.00,0.00
2024-12-10 17:23:59,174,7754,84,90,5675.23,10237.01,0.00
2024-12-10 17:23:59,173,7754,83,90,5692.13,10237.16,0.00
2024-12-10 17:23:59,173,7755,83,90,5652.23,10238.00,0.00
2024-12-10 17:23:59,174,7755,83,91,5619.75,10238.01,0.00
2024-12-10 17:23:59,175,7754,83,92,5585.31,10238.04,0.00
2024-12-10 17:23:59,174,7754,83,91,5653.36,10238.16,0.00
2024-12-10 17:24:00,174,7755,83,91,5605.00,10239.00,0.00
2024-12-10 17:24:00,175,7755,83,92,5572.97,10239.01,0.00
2024-12-10 17:24:00,176,7754,83,93,5536.10,10239.07,0.00
2024-12-10 17:24:00,175,7754,83,92,5582.41,10239.15,0.00
2024-12-10 17:24:00,174,7754,83,91,5554.57,10239.54,0.00
2024-12-10 17:24:00,174,7755,83,91,5620.69,10240.00,0.00
2024-12-10 17:24:00,175,7755,83,92,5588.58,10240.01,0.00
2024-12-10 17:24:00,174,7755,82,92,5618.93,10240.02,0.00
2024-12-10 17:24:00,173,7755,82,91,5637.28,10240.15,0.00
2024-12-10 17:24:00,172,7755,82,90,5647.82,10240.34,0.00
2024-12-10 17:24:00,172,7756,82,90,5692.95,10241.00,0.00
2024-12-10 17:24:00,173,7756,83,90,5660.04,10241.01,0.00
2024-12-10 17:24:00,174,7755,84,90,5615.80,10241.13,0.00
2024-12-10 17:24:00,173,7755,84,89,5655.98,10241.17,0.00
2024-12-10 17:24:00,173,7756,84,89,5619.99,10242.00,0.00
2024-12-10 17:24:00,174,7756,84,90,5587.69,10242.01,0.00
2024-12-10 17:24:00,173,7756,83,90,5603.49,10242.16,0.00
2024-12-10 17:24:00,172,7756,82,90,5635.48,10242.16,0.00
2024-12-10 17:24:00,172,7757,82,90,5656.30,10243.00,0.00
2024-12-10 17:24:00,173,7757,82,91,5623.60,10243.01,0.00
2024-12-10 17:24:00,172,7757,81,91,5639.70,10243.16,0.00
2024-12-10 17:24:00,172,7758,81,91,5599.35,10244.00,0.00
2024-12-10 17:24:00,173,7758,81,92,5566.98,10244.01,0.00
2024-12-10 17:24:00,173,7759,81,92,5508.90,10245.00,0.00
2024-12-10 17:24:00,174,7759,81,93,5477.24,10245.01,0.00
2024-12-10 17:24:00,173,7759,81,92,5490.46,10245.17,0.00
2024-12-10 17:24:00,174,7758,82,92,5429.54,10245.47,0.00
2024-12-10 17:24:00,173,7758,81,92,5480.43,10245.59,0.00
2024-12-10 17:24:00,174,7757,82,92,5434.31,10245.74,0.00
2024-12-10 17:24:00,174,7758,82,92,5474.91,10246.00,0.00
2024-12-10 17:24:00,175,7758,82,93,5443.63,10246.01,0.00
2024-12-10 17:24:00,174,7758,81,93,5463.18,10246.12,0.00
2024-12-10 17:24:00,175,7757,81,94,5429.64,10246.15,0.00
2024-12-10 17:24:00,175,7758,81,94,5515.28,10247.00,0.00
2024-12-10 17:24:00,176,7758,82,94,5483.95,10247.01,0.00
2024-12-10 17:24:00,175,7758,82,93,5497.12,10247.17,0.00
2024-12-10 17:24:00,176,7757,82,94,5385.00,10247.89,0.00
2024-12-10 17:24:00,176,7758,82,94,5496.90,10248.00,0.00
2024-12-10 17:24:00,177,7758,83,94,5465.84,10248.01,0.00
2024-12-10 17:24:00,176,7758,83,93,5488.79,10248.08,0.00
2024-12-10 17:24:00,175,7758,82,93,5510.03,10248.17,0.00
2024-12-10 17:24:00,174,7758,81,93,5541.11,10248.17,0.00
2024-12-10 17:24:00,175,7757,81,94,5480.24,10248.46,0.00
2024-12-10 17:24:00,176,7756,82,94,5475.93,10248.55,0.00
2024-12-10 17:24:00,176,7757,82,94,5593.06,10249.00,0.00
2024-12-10 17:24:00,177,7757,83,94,5561.46,10249.01,0.00
2024-12-10 17:24:00,176,7757,82,94,5575.45,10249.17,0.00
2024-12-10 17:24:00,176,7758,82,94,5654.74,10250.00,0.00
2024-12-10 17:24:00,177,7758,82,95,5622.79,10250.01,0.00
2024-12-10 17:24:00,176,7758,82,94,5637.13,10250.17,0.00
2024-12-10 17:24:00,177,7757,82,95,5590.83,10250.32,0.00
2024-12-10 17:24:00,177,7758,82,95,5614.87,10251.00,0.00
2024-12-10 17:24:00,178,7758,83,95,5583.32,10251.01,0.00
2024-12-10 17:24:00,177,7758,83,94,5531.83,10251.75,0.00
2024-12-10 17:24:00,177,7759,83,94,5619.09,10252.00,0.00
2024-12-10 17:24:00,178,7759,84,94,5587.52,10252.01,0.00
2024-12-10 17:24:00,177,7759,84,93,5602.08,10252.16,0.00
2024-12-10 17:24:00,176,7759,83,93,5633.32,10252.17,0.00
2024-12-10 17:24:00,177,7758,84,93,5544.37,10252.72,0.00
2024-12-10 17:24:00,177,7759,84,93,5611.93,10253.00,0.00
2024-12-10 17:24:00,178,7759,84,94,5580.40,10253.01,0.00
2024-12-10 17:24:00,177,7759,84,93,5595.19,10253.16,0.00
2024-12-10 17:24:00,177,7760,84,93,5617.72,10254.00,0.00
2024-12-10 17:24:00,178,7760,85,93,5586.16,10254.01,0.00
2024-12-10 17:24:00,177,7760,85,92,5609.65,10254.08,0.00
2024-12-10 17:24:00,176,7760,84,92,5631.93,10254.17,0.00
2024-12-10 17:24:00,175,7760,83,92,5662.94,10254.17,0.00
2024-12-10 17:24:00,175,7761,83,92,5629.53,10255.00,0.00
2024-12-10 17:24:00,176,7761,83,93,5597.54,10255.01,0.00
2024-12-10 17:24:00,177,7760,84,93,5563.04,10255.04,0.00
2024-12-10 17:24:00,176,7760,84,92,5599.65,10255.18,0.00
2024-12-10 17:24:00,175,7760,83,92,5631.06,10255.18,0.00
2024-12-10 17:24:00,175,7761,83,92,5597.52,10256.00,0.00
2024-12-10 17:24:00,176,7761,83,93,5565.72,10256.01,0.00
2024-12-10 17:24:00,175,7761,83,92,5590.53,10256.07,0.00
2024-12-10 17:24:00,174,7761,82,92,5620.30,10256.09,0.00
2024-12-10 17:24:00,173,7761,82,91,5641.85,10256.16,0.00
2024-12-10 17:24:00,172,7761,82,90,5674.06,10256.16,0.00
2024-12-10 17:24:00,171,7761,82,89,5706.64,10256.16,0.00
2024-12-10 17:24:00,171,7762,82,89,5729.75,10257.00,0.00
2024-12-10 17:24:00,172,7762,82,90,5696.43,10257.01,0.00
2024-12-10 17:24:00,171,7762,82,89,5728.55,10257.01,0.00
2024-12-10 17:24:00,171,7763,82,89,5669.06,10258.00,0.00
2024-12-10 17:24:00,172,7763,82,90,5636.10,10258.01,0.00
2024-12-10 17:24:00,171,7763,81,90,5662.49,10258.06,0.00
2024-12-10 17:24:00,170,7763,80,90,5684.39,10258.12,0.00
2024-12-10 17:24:00,169,7763,80,89,5713.19,10258.16,0.00
2024-12-10 17:24:00,169,7764,80,89,5670.42,10259.00,0.00
2024-12-10 17:24:00,170,7764,81,89,5637.06,10259.01,0.00
2024-12-10 17:24:00,170,7765,81,89,5569.34,10260.00,0.00
2024-12-10 17:24:00,171,7765,81,90,5536.77,10260.01,0.00
2024-12-10 17:24:01,170,7765,80,90,5549.98,10260.11,0.00
2024-12-10 17:24:01,169,7765,79,90,5577.37,10260.16,0.00
2024-12-10 17:24:01,169,7766,79,90,5530.47,10261.00,0.00
2024-12-10 17:24:01,170,7766,80,90,5497.94,10261.01,0.00
2024-12-10 17:24:01,169,7766,79,90,5526.84,10261.04,0.00
2024-12-10 17:24:01,168,7766,78,90,5537.48,10261.16,0.00
2024-12-10 17:24:01,169,7765,78,91,5441.08,10261.68,0.00
2024-12-10 17:24:01,169,7766,78,91,5478.49,10262.00,0.00
2024-12-10 17:24:01,170,7766,79,91,5446.26,10262.01,0.00
2024-12-10 17:24:01,169,7766,78,91,5452.94,10262.16,0.00
2024-12-10 17:24:01,168,7766,78,90,5434.55,10262.61,0.00
2024-12-10 17:24:01,168,7767,78,90,5501.89,10263.00,0.00
2024-12-10 17:24:01,169,7767,79,90,5469.33,10263.01,0.00
2024-12-10 17:24:01,168,7767,79,89,5493.70,10263.08,0.00
2024-12-10 17:24:01,167,7767,78,89,5437.32,10263.81,0.00
2024-12-10 17:24:01,167,7768,78,89,5478.28,10264.00,0.00
2024-12-10 17:24:01,168,7768,79,89,5445.67,10264.01,0.00
2024-12-10 17:24:01,169,7767,80,89,5411.63,10264.04,0.00
2024-12-10 17:24:01,170,7766,81,89,5399.74,10264.06,0.00
2024-12-10 17:24:01,169,7766,80,89,5434.17,10264.17,0.00
2024-12-10 17:24:01,170,7765,81,89,5389.55,10264.31,0.00
2024-12-10 17:24:01,169,7765,81,88,5448.42,10264.49,0.00
2024-12-10 17:24:01,169,7766,81,88,5451.04,10265.00,0.00
2024-12-10 17:24:01,170,7766,81,89,5418.98,10265.01,0.00
2024-12-10 17:24:01,169,7766,81,88,5434.72,10265.16,0.00
2024-12-10 17:24:01,169,7767,81,88,5581.66,10266.00,0.00
2024-12-10 17:24:01,170,7767,82,88,5548.82,10266.01,0.00
2024-12-10 17:24:01,169,7767,82,87,5566.54,10266.15,0.00
2024-12-10 17:24:01,168,7767,81,87,5598.45,10266.15,0.00
2024-12-10 17:24:01,167,7767,81,86,5631.36,10266.16,0.00
2024-12-10 17:24:01,167,7768,81,86,5595.15,10267.00,0.00
2024-12-10 17:24:01,168,7768,82,86,5561.84,10267.01,0.00
2024-12-10 17:24:01,168,7769,82,86,5510.06,10268.00,0.00
2024-12-10 17:24:01,169,7769,83,86,5477.46,10268.01,0.00
2024-12-10 17:24:01,168,7769,83,85,5490.97,10268.16,0.00
2024-12-10 17:24:01,168,7770,83,85,5455.28,10269.00,0.00
2024-12-10 17:24:01,169,7770,83,86,5423.00,10269.01,0.00
2024-12-10 17:24:01,170,7769,84,86,5388.10,10269.05,0.00
2024-12-10 17:24:01,169,7769,84,85,5438.73,10269.11,0.00
2024-12-10 17:24:01,169,7770,84,85,5397.17,10270.00,0.00
2024-12-10 17:24:01,170,7770,85,85,5365.42,10270.01,0.00
2024-12-10 17:24:01,170,7771,85,85,5373.51,10271.00,0.00
2024-12-10 17:24:01,171,7771,85,86,5342.09,10271.01,0.00
2024-12-10 17:24:01,170,7771,84,86,5286.41,10271.82,0.00
2024-12-10 17:24:01,169,7771,83,86,5313.51,10271.86,0.00
2024-12-10 17:24:01,169,7772,83,86,5359.83,10272.00,0.00
2024-12-10 17:24:01,170,7772,84,86,5328.30,10272.01,0.00
2024-12-10 17:24:01,169,7772,83,86,5350.76,10272.09,0.00
2024-12-10 17:24:01,168,7772,83,85,5375.30,10272.15,0.00
2024-12-10 17:24:01,167,7772,82,85,5406.87,10272.16,0.00
2024-12-10 17:24:01,168,7771,82,86,5351.15,10272.39,0.00
2024-12-10 17:24:01,168,7772,82,86,5390.91,10273.00,0.00
2024-12-10 17:24:01,169,7772,82,87,5359.01,10273.01,0.00
2024-12-10 17:24:01,168,7772,81,87,5375.08,10273.15,0.00
2024-12-10 17:24:01,168,7773,81,87,5407.88,10274.00,0.00
2024-12-10 17:24:01,169,7773,81,88,5375.88,10274.01,0.00
2024-12-10 17:24:01,170,7772,81,89,5343.66,10274.02,0.00
2024-12-10 17:24:01,169,7772,80,89,5406.96,10274.16,0.00
2024-12-10 17:24:01,169,7773,80,89,5378.76,10275.00,0.00
2024-12-10 17:24:01,170,7773,81,89,5347.12,10275.01,0.00
2024-12-10 17:24:01,169,7773,80,89,5363.03,10275.15,0.00
2024-12-10 17:24:01,168,7773,79,89,5394.34,10275.15,0.00
2024-12-10 17:24:01,168,7774,79,89,5427.76,10276.00,0.00
2024-12-10 17:24:01,169,7774,80,89,5395.64,10276.01,0.00
2024-12-10 17:24:01,168,7774,80,88,5411.93,10276.15,0.00
2024-12-10 17:24:01,167,7774,79,88,5443.33,10276.16,0.00
2024-12-10 17:24:01,168,7773,80,88,5376.51,10276.51,0.00
2024-12-10 17:24:01,169,7772,81,88,5344.20,10276.84,0.00
2024-12-10 17:24:01,169,7773,81,88,5400.90,10277.00,0.00
2024-12-10 17:24:01,170,7773,81,89,5369.13,10277.01,0.00
2024-12-10 17:24:01,169,7773,80,89,5385.16,10277.15,0.00
2024-12-10 17:24:01,170,7772,80,90,5319.66,10277.49,0.00
2024-12-10 17:24:01,170,7773,80,90,5482.79,10278.00,0.00
2024-12-10 17:24:01,171,7773,81,90,5450.72,10278.01,0.00
2024-12-10 17:24:01,170,7773,81,89,5418.42,10278.62,0.00
2024-12-10 17:24:01,170,7774,81,89,5500.94,10279.00,0.00
2024-12-10 17:24:01,171,7774,81,90,5468.77,10279.01,0.00
2024-12-10 17:24:01,172,7773,81,91,5434.60,10279.04,0.00
2024-12-10 17:24:01,171,7773,81,90,5472.43,10279.11,0.00
2024-12-10 17:24:01,170,7773,80,90,5499.80,10279.15,0.00
2024-12-10 17:24:01,170,7774,80,90,5472.44,10280.00,0.00
2024-12-10 17:24:01,171,7774,81,90,5440.44,10280.01,0.00
2024-12-10 17:24:01,172,7773,82,90,5403.47,10280.07,0.00
2024-12-10 17:24:01,171,7773,81,90,5483.20,10280.16,0.00
2024-12-10 17:24:01,170,7773,81,89,5514.85,10280.16,0.00
2024-12-10 17:24:01,169,7773,80,89,5546.87,10280.16,0.00
2024-12-10 17:24:01,169,7774,80,89,5581.18,10281.00,0.00
2024-12-10 17:24:01,170,7774,81,89,5548.35,10281.01,0.00
2024-12-10 17:24:01,169,7774,80,89,5565.44,10281.15,0.00
2024-12-10 17:24:01,169,7775,80,89,5599.21,10282.00,0.00
2024-12-10 17:24:01,170,7775,81,89,5566.27,10282.01,0.00
2024-12-10 17:24:02,170,7776,81,89,5523.81,10283.00,0.00
2024-12-10 17:24:02,171,7776,81,90,5491.51,10283.01,0.00
2024-12-10 17:24:02,172,7775,82,90,5444.70,10283.16,0.00
2024-12-10 17:24:02,172,7776,82,90,5428.15,10284.00,0.00
2024-12-10 17:24:02,173,7776,83,90,5396.77,10284.01,0.00
2024-12-10 17:24:02,172,7776,83,89,5399.54,10284.27,0.00
2024-12-10 17:24:02,173,7775,84,89,5351.73,10284.44,0.00
2024-12-10 17:24:02,173,7776,84,89,5416.92,10285.00,0.00
2024-12-10 17:24:02,174,7776,85,89,5385.78,10285.01,0.00
2024-12-10 17:24:02,173,7776,85,88,5403.90,10285.13,0.00
2024-12-10 17:24:02,172,7776,84,88,5431.74,10285.16,0.00
2024-12-10 17:24:02,171,7776,83,88,5462.91,10285.16,0.00
2024-12-10 17:24:02,171,7777,83,88,5497.05,10286.00,0.00
2024-12-10 17:24:02,172,7777,84,88,5465.09,10286.01,0.00
2024-12-10 17:24:02,172,7778,84,88,5423.15,10287.00,0.00
2024-12-10 17:24:02,173,7778,85,88,5391.81,10287.01,0.00
2024-12-10 17:24:02,173,7779,85,88,5349.51,10288.00,0.00
2024-12-10 17:24:02,174,7779,86,88,5318.77,10288.01,0.00
2024-12-10 17:24:02,175,7778,87,88,5249.10,10288.40,0.00
2024-12-10 17:24:02,175,7779,87,88,5271.25,10289.00,0.00
2024-12-10 17:24:02,176,7779,88,88,5241.30,10289.01,0.00
2024-12-10 17:24:02,176,7780,88,88,5256.43,10290.00,0.00
2024-12-10 17:24:02,177,7780,88,89,5226.73,10290.01,0.00
2024-12-10 17:24:02,176,7780,88,88,5251.78,10290.05,0.00
2024-12-10 17:24:02,175,7780,88,87,5275.34,10290.10,0.00
2024-12-10 17:24:02,174,7780,87,87,5299.18,10290.16,0.00
2024-12-10 17:24:02,173,7780,86,87,5329.21,10290.16,0.00
2024-12-10 17:24:02,173,7781,86,87,5302.89,10291.00,0.00
2024-12-10 17:24:02,174,7781,86,88,5272.41,10291.01,0.00
2024-12-10 17:24:02,173,7781,86,87,5286.31,10291.16,0.00
2024-12-10 17:24:02,174,7780,86,88,5245.88,10291.27,0.00
2024-12-10 17:24:02,174,7781,86,88,5281.42,10292.00,0.00
2024-12-10 17:24:02,175,7781,86,89,5251.24,10292.01,0.00
2024-12-10 17:24:02,174,7781,86,88,5270.82,10292.10,0.00
2024-12-10 17:24:02,173,7781,85,88,5295.36,10292.16,0.00
2024-12-10 17:24:02,172,7781,85,87,5325.55,10292.16,0.00
2024-12-10 17:24:02,171,7781,85,86,5356.48,10292.16,0.00
2024-12-10 17:24:02,171,7782,85,86,5389.03,10293.00,0.00
2024-12-10 17:24:02,172,7782,86,86,5357.70,10293.01,0.00
2024-12-10 17:24:02,173,7781,87,86,5285.81,10293.42,0.00
2024-12-10 17:24:02,174,7780,87,87,5250.67,10293.84,0.00
2024-12-10 17:24:02,174,7781,87,87,5304.65,10294.00,0.00
2024-12-10 17:24:02,175,7781,88,87,5274.33,10294.01,0.00
2024-12-10 17:24:02,174,7781,88,86,5288.15,10294.16,0.00
2024-12-10 17:24:02,174,7782,88,86,5375.99,10295.00,0.00
2024-12-10 17:24:02,175,7782,88,87,5345.27,10295.01,0.00
2024-12-10 17:24:02,174,7782,87,87,5359.49,10295.16,0.00
2024-12-10 17:24:02,174,7783,87,87,5328.20,10296.00,0.00
2024-12-10 17:24:02,175,7783,87,88,5297.75,10296.01,0.00
2024-12-10 17:24:02,174,7783,86,88,5311.69,10296.16,0.00
2024-12-10 17:24:02,175,7782,86,89,5228.02,10296.63,0.00
2024-12-10 17:24:02,175,7783,86,89,5275.97,10297.00,0.00
2024-12-10 17:24:02,176,7783,87,89,5245.99,10297.01,0.00
2024-12-10 17:24:02,175,7783,87,88,5259.55,10297.16,0.00
2024-12-10 17:24:02,174,7783,87,87,5264.08,10297.41,0.00
2024-12-10 17:24:02,174,7784,87,87,5320.77,10298.00,0.00
2024-12-10 17:24:02,175,7784,88,87,5290.36,10298.01,0.00
2024-12-10 17:24:02,174,7784,88,86,5304.26,10298.16,0.00
2024-12-10 17:24:02,173,7784,88,85,5334.33,10298.16,0.00
2024-12-10 17:24:02,173,7785,88,85,5306.63,10299.00,0.00
2024-12-10 17:24:02,174,7785,88,86,5276.13,10299.01,0.00
2024-12-10 17:24:02,173,7785,88,85,5290.02,10299.16,0.00
2024-12-10 17:24:02,173,7786,88,85,5262.35,10300.00,0.00
2024-12-10 17:24:02,174,7786,89,85,5232.11,10300.01,0.00
2024-12-10 17:24:02,173,7786,89,84,5245.74,10300.16,0.00
2024-12-10 17:24:02,172,7786,89,83,5269.18,10300.23,0.00
2024-12-10 17:24:02,172,7787,89,83,5248.41,10301.00,0.00
2024-12-10 17:24:02,173,7787,90,83,5218.07,10301.01,0.00
2024-12-10 17:24:02,172,7787,89,83,5231.70,10301.16,0.00
2024-12-10 17:24:02,171,7787,89,82,5261.10,10301.17,0.00
2024-12-10 17:24:02,171,7788,89,82,5234.69,10302.00,0.00
2024-12-10 17:24:02,172,7788,90,82,5204.25,10302.01,0.00
2024-12-10 17:24:02,171,7788,90,81,5217.28,10302.17,0.00
2024-12-10 17:24:02,170,7788,89,81,5232.65,10302.32,0.00
2024-12-10 17:24:02,171,7787,90,81,5139.27,10302.92,0.00
2024-12-10 17:24:02,171,7788,90,81,5197.79,10303.00,0.00
2024-12-10 17:24:02,172,7788,90,82,5167.57,10303.01,0.00
2024-12-10 17:24:02,171,7788,90,81,5191.79,10303.06,0.00
2024-12-10 17:24:02,172,7787,90,82,5155.63,10303.13,0.00
2024-12-10 17:24:02,171,7787,90,81,5221.95,10303.17,0.00
2024-12-10 17:24:02,172,7786,90,82,5129.68,10303.77,0.00
2024-12-10 17:24:02,172,7787,90,82,5241.90,10304.00,0.00
2024-12-10 17:24:02,173,7787,91,82,5211.60,10304.01,0.00
2024-12-10 17:24:02,174,7786,91,83,5176.93,10304.06,0.00
2024-12-10 17:24:02,173,7786,90,83,5208.69,10304.17,0.00
2024-12-10 17:24:03,173,7787,90,83,5301.00,10305.00,0.00
2024-12-10 17:24:03,174,7787,90,84,5270.53,10305.01,0.00
2024-12-10 17:24:03,173,7787,89,84,5289.72,10305.11,0.00
2024-12-10 17:24:03,172,7787,89,83,5314.51,10305.16,0.00
2024-12-10 17:24:03,171,7787,88,83,5344.99,10305.16,0.00
2024-12-10 17:24:03,171,7788,88,83,5378.08,10306.00,0.00
2024-12-10 17:24:03,172,7788,89,83,5346.81,10306.01,0.00
2024-12-10 17:24:03,171,7788,89,82,5367.87,10306.10,0.00
2024-12-10 17:24:03,170,7788,88,82,5392.81,10306.16,0.00
2024-12-10 17:24:03,171,7787,89,82,5340.22,10306.37,0.00
2024-12-10 17:24:03,171,7788,89,82,5392.42,10307.00,0.00
2024-12-10 17:24:03,172,7788,89,83,5361.07,10307.01,0.00
2024-12-10 17:24:03,171,7788,88,83,5376.21,10307.16,0.00
2024-12-10 17:24:03,172,7787,89,83,5340.16,10307.21,0.00
2024-12-10 17:24:03,172,7788,89,83,5430.44,10308.00,0.00
2024-12-10 17:24:03,173,7788,90,83,5399.05,10308.01,0.00
2024-12-10 17:24:03,173,7789,90,83,5412.94,10309.00,0.00
2024-12-10 17:24:03,174,7789,90,84,5381.83,10309.01,0.00
2024-12-10 17:24:03,173,7789,89,84,5396.91,10309.16,0.00
2024-12-10 17:24:03,173,7790,89,84,5366.05,10310.00,0.00
2024-12-10 17:24:03,174,7790,90,84,5335.21,10310.01,0.00
2024-12-10 17:24:03,173,7790,89,84,5350.02,10310.16,0.00
2024-12-10 17:24:03,173,7791,89,84,5318.54,10311.00,0.00
2024-12-10 17:24:03,174,7791,90,84,5287.97,10311.01,0.00
2024-12-10 17:24:03,173,7791,89,84,5302.51,10311.16,0.00
2024-12-10 17:24:03,174,7790,90,84,5221.00,10311.66,0.00
2024-12-10 17:24:03,174,7791,90,84,5263.88,10312.00,0.00
2024-12-10 17:24:03,175,7791,91,84,5233.80,10312.01,0.00
2024-12-10 17:24:03,174,7791,90,84,5247.93,10312.16,0.00
2024-12-10 17:24:03,175,7790,91,84,5176.76,10312.57,0.00
2024-12-10 17:24:03,176,7789,92,84,5176.06,10312.58,0.00
2024-12-10 17:24:03,176,7790,92,84,5273.31,10313.00,0.00
2024-12-10 17:24:03,177,7790,93,84,5243.52,10313.01,0.00
2024-12-10 17:24:03,176,7790,92,84,5272.73,10313.01,0.00
2024-12-10 17:24:03,175,7790,92,83,5287.59,10313.15,0.00
2024-12-10 17:24:03,174,7790,91,83,5317.38,10313.15,0.00
2024-12-10 17:24:03,175,7789,92,83,5231.26,10313.70,0.00
2024-12-10 17:24:03,175,7790,92,83,5391.18,10314.00,0.00
2024-12-10 17:24:03,176,7790,93,83,5360.55,10314.01,0.00
2024-12-10 17:24:03,175,7790,92,83,5375.91,10314.15,0.00
2024-12-10 17:24:03,175,7791,92,83,5398.23,10315.00,0.00
2024-12-10 17:24:03,176,7791,93,83,5367.56,10315.01,0.00
2024-12-10 17:24:03,175,7791,93,82,5382.96,10315.15,0.00
2024-12-10 17:24:03,175,7792,93,82,5345.58,10316.00,0.00
2024-12-10 17:24:03,176,7792,93,83,5315.21,10316.01,0.00
2024-12-10 17:24:03,176,7793,93,83,5262.35,10317.00,0.00
2024-12-10 17:24:03,177,7793,94,83,5232.61,10317.01,0.00
2024-12-10 17:24:03,176,7793,93,83,5246.57,10317.15,0.00
2024-12-10 17:24:03,176,7794,93,83,5209.74,10318.00,0.00
2024-12-10 17:24:03,177,7794,94,83,5180.30,10318.01,0.00
2024-12-10 17:24:03,176,7794,94,82,5203.31,10318.06,0.00
2024-12-10 17:24:03,175,7794,93,82,5223.64,10318.15,0.00
2024-12-10 17:24:03,174,7794,92,82,5252.48,10318.16,0.00
2024-12-10 17:24:03,174,7795,92,82,5216.93,10319.00,0.00
2024-12-10 17:24:03,175,7795,92,83,5187.12,10319.01,0.00
2024-12-10 17:24:03,174,7795,92,82,5211.61,10319.05,0.00
2024-12-10 17:24:03,173,7795,92,81,5231.03,10319.15,0.00
2024-12-10 17:24:03,174,7794,92,82,5154.18,10319.59,0.00
2024-12-10 17:24:03,174,7795,92,82,5195.67,10320.00,0.00
2024-12-10 17:24:03,175,7795,93,82,5165.98,10320.01,0.00
2024-12-10 17:24:03,174,7795,93,81,5179.12,10320.16,0.00
2024-12-10 17:24:03,173,7795,93,80,5185.72,10320.38,0.00
2024-12-10 17:24:03,172,7795,92,80,5177.62,10320.73,0.00
2024-12-10 17:24:03,172,7796,92,80,5270.24,10321.00,0.00
2024-12-10 17:24:03,173,7796,93,80,5239.78,10321.01,0.00
2024-12-10 17:24:03,172,7796,92,80,5259.47,10321.10,0.00
2024-12-10 17:24:03,171,7796,91,80,5288.42,10321.12,0.00
2024-12-10 17:24:03,170,7796,91,79,5315.30,10321.15,0.00
2024-12-10 17:24:03,169,7796,91,78,5346.14,10321.15,0.00
2024-12-10 17:24:03,169,7797,91,78,5320.34,10322.00,0.00
2024-12-10 17:24:03,170,7797,91,79,5289.04,10322.01,0.00
2024-12-10 17:24:03,169,7797,91,78,5304.52,10322.15,0.00
2024-12-10 17:24:03,169,7798,91,78,5278.71,10323.00,0.00
2024-12-10 17:24:03,170,7798,91,79,5247.66,10323.01,0.00
2024-12-10 17:24:03,169,7798,91,78,5272.01,10323.07,0.00
2024-12-10 17:24:03,168,7798,90,78,5294.21,10323.15,0.00
2024-12-10 17:24:03,168,7799,90,78,5268.24,10324.00,0.00
2024-12-10 17:24:03,169,7799,90,79,5237.07,10324.01,0.00
2024-12-10 17:24:03,169,7800,90,79,5196.03,10325.00,0.00
2024-12-10 17:24:03,170,7800,90,80,5165.47,10325.01,0.00
2024-12-10 17:24:03,169,7800,89,80,5190.55,10325.05,0.00
2024-12-10 17:24:03,168,7800,88,80,5211.04,10325.15,0.00
2024-12-10 17:24:03,167,7800,87,80,5241.63,10325.15,0.00
2024-12-10 17:24:03,167,7801,87,80,5216.10,10326.00,0.00
2024-12-10 17:24:03,168,7801,87,81,5185.05,10326.01,0.00
2024-12-10 17:24:04,168,7802,87,81,5144.37,10327.00,0.00
2024-12-10 17:24:04,169,7802,87,82,5113.93,10327.01,0.00
2024-12-10 17:24:04,168,7802,86,82,5133.95,10327.10,0.00
2024-12-10 17:24:04,167,7802,86,81,5159.16,10327.15,0.00
2024-12-10 17:24:04,167,7803,86,81,5133.62,10328.00,0.00
2024-12-10 17:24:04,168,7803,87,81,5103.07,10328.01,0.00
2024-12-10 17:24:04,167,7803,87,80,5118.22,10328.15,0.00
2024-12-10 17:24:04,166,7803,86,80,5148.43,10328.15,0.00
2024-12-10 17:24:04,166,7804,86,80,5123.36,10329.00,0.00
2024-12-10 17:24:04,167,7804,87,80,5092.68,10329.01,0.00
2024-12-10 17:24:04,166,7804,86,80,5107.86,10329.15,0.00
2024-12-10 17:24:04,166,7805,86,80,5081.68,10330.00,0.00
2024-12-10 17:24:04,167,7805,87,80,5051.25,10330.01,0.00
2024-12-10 17:24:04,166,7805,87,79,5066.17,10330.15,0.00
2024-12-10 17:24:04,165,7805,87,78,5091.74,10330.18,0.00
2024-12-10 17:24:04,165,7806,87,78,5070.26,10331.00,0.00
2024-12-10 17:24:04,166,7806,87,79,5039.71,10331.01,0.00
2024-12-10 17:24:04,167,7805,87,80,5009.53,10331.02,0.00
2024-12-10 17:24:04,166,7805,86,80,5070.85,10331.05,0.00
2024-12-10 17:24:04,165,7805,86,79,5090.35,10331.15,0.00
2024-12-10 17:24:04,164,7805,86,78,5120.76,10331.15,0.00
2024-12-10 17:24:04,164,7806,86,78,5096.63,10332.00,0.00
2024-12-10 17:24:04,165,7806,86,79,5065.74,10332.01,0.00
2024-12-10 17:24:04,164,7806,85,79,5081.56,10332.15,0.00
2024-12-10 17:24:04,164,7807,85,79,5119.80,10333.00,0.00
2024-12-10 17:24:04,165,7807,86,79,5088.77,10333.01,0.00
2024-12-10 17:24:04,164,7807,86,78,5114.15,10333.05,0.00
2024-12-10 17:24:04,163,7807,86,77,5136.05,10333.14,0.00
2024-12-10 17:24:04,164,7806,87,77,5060.13,10333.58,0.00
2024-12-10 17:24:04,164,7807,87,77,5112.10,10334.00,0.00
2024-12-10 17:24:04,165,7807,88,77,5081.12,10334.01,0.00
2024-12-10 17:24:04,164,7807,88,76,5097.04,10334.15,0.00
2024-12-10 17:24:04,164,7808,88,76,5135.29,10335.00,0.00
2024-12-10 17:24:04,165,7808,88,77,5104.16,10335.01,0.00
2024-12-10 17:24:04,164,7808,87,77,5129.63,10335.05,0.00
2024-12-10 17:24:04,163,7808,86,77,5151.00,10335.15,0.00
2024-12-10 17:24:04,162,7808,85,77,5182.16,10335.15,0.00
2024-12-10 17:24:04,163,7807,86,77,5111.16,10335.54,0.00
2024-12-10 17:24:04,163,7808,86,77,5161.16,10336.00,0.00
2024-12-10 17:24:04,164,7808,86,78,5129.69,10336.01,0.00
2024-12-10 17:24:04,163,7808,86,77,5146.00,10336.15,0.00
2024-12-10 17:24:04,163,7809,86,77,5183.05,10337.00,0.00
2024-12-10 17:24:04,164,7809,87,77,5151.45,10337.01,0.00
2024-12-10 17:24:04,163,7809,87,76,5167.89,10337.15,0.00
2024-12-10 17:24:04,164,7808,87,77,5077.34,10337.73,0.00
2024-12-10 17:24:04,164,7809,87,77,5130.89,10338.00,0.00
2024-12-10 17:24:04,165,7809,88,77,5099.79,10338.01,0.00
2024-12-10 17:24:04,164,7809,87,77,5129.63,10338.01,0.00
2024-12-10 17:24:04,165,7808,88,77,5095.42,10338.05,0.00
2024-12-10 17:24:04,164,7808,88,76,5173.81,10338.15,0.00
2024-12-10 17:24:04,163,7808,88,75,5204.92,10338.15,0.00
2024-12-10 17:24:04,163,7809,88,75,5240.82,10339.00,0.00
2024-12-10 17:24:04,164,7809,88,76,5208.87,10339.01,0.00
2024-12-10 17:24:04,163,7809,88,75,5226.29,10339.14,0.00
2024-12-10 17:24:04,162,7809,88,74,5257.91,10339.14,0.00
2024-12-10 17:24:04,163,7808,89,74,5224.39,10339.17,0.00
2024-12-10 17:24:04,164,7807,89,75,5222.88,10339.47,0.00
2024-12-10 17:24:04,164,7808,89,75,5330.74,10340.00,0.00
2024-12-10 17:24:04,165,7808,89,76,5298.43,10340.01,0.00
2024-12-10 17:24:04,164,7808,89,75,5316.29,10340.14,0.00
2024-12-10 17:24:04,163,7808,89,74,5344.09,10340.18,0.00
2024-12-10 17:24:04,163,7809,89,74,5447.64,10341.00,0.00
2024-12-10 17:24:04,164,7809,89,75,5414.42,10341.01,0.00
2024-12-10 17:24:04,163,7809,88,75,5433.10,10341.14,0.00
2024-12-10 17:24:04,162,7809,87,75,5406.27,10341.71,0.00
2024-12-10 17:24:04,162,7810,87,75,5440.35,10342.00,0.00
2024-12-10 17:24:04,163,7810,88,75,5406.97,10342.01,0.00
2024-12-10 17:24:04,164,7809,89,75,5372.12,10342.04,0.00
2024-12-10 17:24:04,163,7809,88,75,5446.03,10342.08,0.00
2024-12-10 17:24:04,163,7810,88,75,5414.79,10343.00,0.00
2024-12-10 17:24:04,164,7810,89,75,5381.78,10343.01,0.00
2024-12-10 17:24:04,163,7810,89,74,5400.26,10343.14,0.00
2024-12-10 17:24:04,163,7811,89,74,5438.80,10344.00,0.00
2024-12-10 17:24:04,164,7811,89,75,5405.63,10344.01,0.00
2024-12-10 17:24:04,163,7811,89,74,5424.26,10344.14,0.00
2024-12-10 17:24:04,163,7812,89,74,5399.34,10345.00,0.00
2024-12-10 17:24:04,164,7812,90,74,5366.42,10345.01,0.00
2024-12-10 17:24:04,165,7811,90,75,5333.27,10345.02,0.00
2024-12-10 17:24:04,164,7811,90,74,5410.61,10345.07,0.00
2024-12-10 17:24:04,163,7811,90,73,5436.21,10345.14,0.00
2024-12-10 17:24:04,162,7811,89,73,5469.13,10345.14,0.00
2024-12-10 17:24:04,161,7811,88,73,5502.46,10345.14,0.00
2024-12-10 17:24:04,162,7810,88,74,5436.02,10345.47,0.00
2024-12-10 17:24:04,162,7811,88,74,5452.35,10346.00,0.00
2024-12-10 17:24:04,163,7811,89,74,5418.90,10346.01,0.00
2024-12-10 17:24:04,164,7810,89,75,5383.98,10346.04,0.00
2024-12-10 17:24:04,164,7811,89,75,5475.18,10347.00,0.00
2024-12-10 17:24:04,165,7811,90,75,5442.00,10347.01,0.00
2024-12-10 17:24:04,164,7811,90,74,5462.62,10347.12,0.00
2024-12-10 17:24:04,163,7811,89,74,5494.87,10347.13,0.00
2024-12-10 17:24:04,162,7811,89,73,5528.15,10347.13,0.00
2024-12-10 17:24:04,162,7812,89,73,5564.20,10348.00,0.00
2024-12-10 17:24:04,163,7812,89,74,5530.06,10348.01,0.00
2024-12-10 17:24:04,162,7812,88,74,5550.85,10348.13,0.00
2024-12-10 17:24:04,161,7812,88,73,5584.68,10348.13,0.00
2024-12-10 17:24:04,162,7811,89,73,5501.83,10348.61,0.00
2024-12-10 17:24:05,162,7811,89,73,5550.47,10349.00,0.00
2024-12-10 17:24:05,163,7811,90,73,5516.42,10349.01,0.00
2024-12-10 17:24:05,162,7811,89,73,5537.12,10349.13,0.00
2024-12-10 17:24:05,162,7812,89,73,5570.65,10350.00,0.00
2024-12-10 17:24:05,163,7812,89,74,5536.47,10350.01,0.00
2024-12-10 17:24:05,162,7812,89,73,5565.56,10350.05,0.00
2024-12-10 17:24:05,161,7812,89,72,5591.80,10350.12,0.00
2024-12-10 17:24:05,162,7811,90,72,5528.61,10350.41,0.00
2024-12-10 17:24:05,163,7810,91,72,5481.43,10350.58,0.00
2024-12-10 17:24:05,163,7811,91,72,5525.63,10351.00,0.00
2024-12-10 17:24:05,164,7811,92,72,5491.94,10351.01,0.00
2024-12-10 17:24:05,163,7811,91,72,5512.36,10351.13,0.00
2024-12-10 17:24:05,163,7812,91,72,5606.26,10352.00,0.00
2024-12-10 17:24:05,164,7812,92,72,5572.08,10352.01,0.00
2024-12-10 17:24:05,163,7812,91,72,5592.99,10352.13,0.00
2024-12-10 17:24:05,164,7811,92,72,5512.23,10352.57,0.00
2024-12-10 17:24:05,164,7812,92,72,5526.19,10353.00,0.00
2024-12-10 17:24:05,165,7812,92,73,5492.70,10353.01,0.00
2024-12-10 17:24:05,164,7812,92,72,5512.99,10353.13,0.00
2024-12-10 17:24:05,164,7813,92,72,5541.62,10354.00,0.00
2024-12-10 17:24:05,165,7813,93,72,5508.03,10354.01,0.00
2024-12-10 17:24:05,164,7813,92,72,5528.42,10354.13,0.00
2024-12-10 17:24:05,164,7814,92,72,5493.46,10355.00,0.00
2024-12-10 17:24:05,165,7814,93,72,5460.17,10355.01,0.00
2024-12-10 17:24:05,164,7814,93,71,5480.26,10355.13,0.00
2024-12-10 17:24:05,163,7814,92,71,5431.12,10355.85,0.00
2024-12-10 17:24:05,163,7815,92,71,5479.54,10356.00,0.00
2024-12-10 17:24:05,164,7815,92,72,5446.13,10356.01,0.00
2024-12-10 17:24:05,163,7815,92,71,5465.61,10356.13,0.00
2024-12-10 17:24:05,162,7815,91,71,5492.95,10356.19,0.00
2024-12-10 17:24:05,162,7816,91,71,5472.96,10357.00,0.00
2024-12-10 17:24:05,163,7816,92,71,5439.38,10357.01,0.00
2024-12-10 17:24:05,162,7816,92,70,5458.95,10357.14,0.00
2024-12-10 17:24:05,162,7817,92,70,5433.85,10358.00,0.00
2024-12-10 17:24:05,163,7817,92,71,5400.51,10358.01,0.00
2024-12-10 17:24:05,162,7817,92,70,5419.83,10358.14,0.00
2024-12-10 17:24:05,162,7818,92,70,5394.72,10359.00,0.00
2024-12-10 17:24:05,163,7818,92,71,5361.63,10359.01,0.00
2024-12-10 17:24:05,162,7818,91,71,5380.71,10359.14,0.00
2024-12-10 17:24:05,163,7817,91,72,5331.21,10359.31,0.00
2024-12-10 17:24:05,163,7818,91,72,5351.98,10360.00,0.00
2024-12-10 17:24:05,164,7818,91,73,5319.34,10360.01,0.00
2024-12-10 17:24:05,163,7818,91,72,5338.04,10360.13,0.00
2024-12-10 17:24:05,164,7817,92,72,5289.73,10360.30,0.00
2024-12-10 17:24:05,164,7818,92,72,5343.86,10361.00,0.00
2024-12-10 17:24:05,165,7818,92,73,5311.47,10361.01,0.00
2024-12-10 17:24:05,164,7818,91,73,5333.16,10361.10,0.00
2024-12-10 17:24:05,163,7818,91,72,5362.08,10361.13,0.00
2024-12-10 17:24:05,163,7819,91,72,5400.05,10362.00,0.00
2024-12-10 17:24:05,164,7819,91,73,5367.12,10362.01,0.00
2024-12-10 17:24:05,165,7818,92,73,5240.21,10362.93,0.00
2024-12-10 17:24:05,165,7819,92,73,5301.82,10363.00,0.00
2024-12-10 17:24:05,166,7819,92,74,5269.89,10363.01,0.00
2024-12-10 17:24:05,165,7819,91,74,5287.43,10363.14,0.00
2024-12-10 17:24:05,166,7818,91,75,5241.08,10363.28,0.00
2024-12-10 17:24:05,166,7819,91,75,5292.71,10364.00,0.00
2024-12-10 17:24:05,167,7819,92,75,5261.02,10364.01,0.00
2024-12-10 17:24:05,166,7819,91,75,5289.60,10364.03,0.00
2024-12-10 17:24:05,165,7819,90,75,5310.39,10364.13,0.00
2024-12-10 17:24:05,164,7819,89,75,5342.14,10364.13,0.00
2024-12-10 17:24:05,163,7819,88,75,5374.28,10364.13,0.00
2024-12-10 17:24:05,163,7820,88,75,5410.60,10365.00,0.00
2024-12-10 17:24:05,164,7820,88,76,5377.61,10365.01,0.00
2024-12-10 17:24:05,163,7820,88,75,5396.66,10365.13,0.00
2024-12-10 17:24:05,163,7821,88,75,5370.34,10366.00,0.00
2024-12-10 17:24:05,164,7821,88,76,5337.60,10366.01,0.00
2024-12-10 17:24:05,163,7821,87,76,5356.40,10366.13,0.00
2024-12-10 17:24:05,163,7822,87,76,5330.79,10367.00,0.00
2024-12-10 17:24:05,164,7822,87,77,5298.28,10367.01,0.00
2024-12-10 17:24:05,165,7821,87,78,5258.04,10367.10,0.00
2024-12-10 17:24:05,164,7821,86,78,5341.95,10367.14,0.00
2024-12-10 17:24:05,164,7822,86,78,5316.50,10368.00,0.00
2024-12-10 17:24:05,165,7822,86,79,5284.28,10368.01,0.00
2024-12-10 17:24:05,164,7822,85,79,5302.64,10368.13,0.00
2024-12-10 17:24:05,164,7823,85,79,5339.77,10369.00,0.00
2024-12-10 17:24:05,165,7823,85,80,5307.41,10369.01,0.00
2024-12-10 17:24:05,164,7823,85,79,5325.91,10369.13,0.00
2024-12-10 17:24:05,163,7823,84,79,5357.95,10369.13,0.00
2024-12-10 17:24:05,163,7824,84,79,5332.33,10370.00,0.00
2024-12-10 17:24:06,164,7824,85,79,5299.82,10370.01,0.00
2024-12-10 17:24:06,164,7825,85,79,5260.49,10371.00,0.00
2024-12-10 17:24:06,165,7825,86,79,5228.61,10371.01,0.00
2024-12-10 17:24:06,165,7826,86,79,5188.06,10372.00,0.00
2024-12-10 17:24:06,166,7826,86,80,5156.81,10372.01,0.00
2024-12-10 17:24:06,165,7826,85,80,5182.43,10372.05,0.00
2024-12-10 17:24:06,166,7825,86,80,5146.85,10372.11,0.00
2024-12-10 17:24:06,165,7825,85,80,5193.77,10372.15,0.00
2024-12-10 17:24:06,164,7825,85,79,5224.81,10372.15,0.00
2024-12-10 17:24:06,164,7826,85,79,5199.57,10373.00,0.00
2024-12-10 17:24:06,165,7826,86,79,5168.06,10373.01,0.00
2024-12-10 17:24:06,164,7826,86,78,5185.08,10373.14,0.00
2024-12-10 17:24:06,164,7827,86,78,5222.85,10374.00,0.00
2024-12-10 17:24:06,165,7827,86,79,5191.19,10374.01,0.00
2024-12-10 17:24:06,164,7827,86,78,5208.35,10374.14,0.00
2024-12-10 17:24:06,164,7828,86,78,5182.87,10375.00,0.00
2024-12-10 17:24:06,165,7828,86,79,5151.45,10375.01,0.00
2024-12-10 17:24:06,166,7827,87,79,5119.18,10375.03,0.00
2024-12-10 17:24:06,166,7828,87,79,5140.92,10376.00,0.00
2024-12-10 17:24:06,167,7828,87,80,5110.13,10376.01,0.00
2024-12-10 17:24:06,166,7828,86,80,5129.71,10376.11,0.00
2024-12-10 17:24:06,165,7828,85,80,5156.41,10376.15,0.00
2024-12-10 17:24:06,164,7828,84,80,5187.21,10376.15,0.00
2024-12-10 17:24:06,165,7827,85,80,5078.15,10376.91,0.00
2024-12-10 17:24:06,165,7828,85,80,5202.13,10377.00,0.00
2024-12-10 17:24:06,166,7828,85,81,5170.79,10377.01,0.00
2024-12-10 17:24:06,167,7827,85,82,5133.02,10377.08,0.00
2024-12-10 17:24:06,166,7827,85,81,5213.36,10377.16,0.00
2024-12-10 17:24:06,166,7828,85,81,5251.31,10378.00,0.00
2024-12-10 17:24:06,167,7828,85,82,5219.87,10378.01,0.00
2024-12-10 17:24:06,166,7828,84,82,5235.12,10378.16,0.00
2024-12-10 17:24:06,166,7829,84,82,5273.08,10379.00,0.00
2024-12-10 17:24:06,167,7829,85,82,5241.50,10379.01,0.00
2024-12-10 17:24:06,166,7829,85,81,5256.88,10379.16,0.00
2024-12-10 17:24:06,166,7830,85,81,5232.31,10380.00,0.00
2024-12-10 17:24:06,167,7830,86,81,5200.98,10380.01,0.00
2024-12-10 17:24:06,166,7830,85,81,5215.50,10380.16,0.00
2024-12-10 17:24:06,165,7830,84,81,5246.48,10380.16,0.00
2024-12-10 17:24:06,165,7831,84,81,5223.01,10381.00,0.00
2024-12-10 17:24:06,166,7831,84,82,5191.54,10381.01,0.00
2024-12-10 17:24:06,165,7831,83,82,5206.09,10381.16,0.00
2024-12-10 17:24:06,165,7832,83,82,5182.61,10382.00,0.00
2024-12-10 17:24:06,166,7832,84,82,5151.39,10382.01,0.00
2024-12-10 17:24:06,166,7833,84,82,5111.23,10383.00,0.00
2024-12-10 17:24:06,167,7833,85,82,5080.63,10383.01,0.00
2024-12-10 17:24:06,166,7833,84,82,5106.25,10383.05,0.00
2024-12-10 17:24:06,165,7833,84,81,5124.66,10383.16,0.00
2024-12-10 17:24:06,164,7833,83,81,5155.27,10383.17,0.00
2024-12-10 17:24:06,164,7834,83,81,5132.27,10384.00,0.00
2024-12-10 17:24:06,165,7834,83,82,5101.17,10384.01,0.00
2024-12-10 17:24:06,164,7834,82,82,5115.24,10384.17,0.00
2024-12-10 17:24:06,163,7834,81,82,5145.99,10384.17,0.00
2024-12-10 17:24:06,163,7835,81,82,5123.48,10385.00,0.00
2024-12-10 17:24:06,164,7835,81,83,5092.24,10385.01,0.00
2024-12-10 17:24:06,163,7835,80,83,5106.34,10385.17,0.00
2024-12-10 17:24:06,164,7834,80,84,5051.82,10385.40,0.00
2024-12-10 17:24:06,164,7835,80,84,5098.91,10386.00,0.00
2024-12-10 17:24:06,165,7835,81,84,5068.01,10386.01,0.00
2024-12-10 17:24:06,164,7835,81,83,5086.24,10386.13,0.00
2024-12-10 17:24:06,163,7835,80,83,5113.63,10386.16,0.00
2024-12-10 17:24:06,163,7836,80,83,5152.96,10387.00,0.00
2024-12-10 17:24:06,164,7836,80,84,5121.54,10387.01,0.00
2024-12-10 17:24:06,163,7836,79,84,5136.46,10387.16,0.00
2024-12-10 17:24:06,163,7837,79,84,5111.02,10388.00,0.00
2024-12-10 17:24:06,164,7837,80,84,5079.85,10388.01,0.00
2024-12-10 17:24:06,163,7837,80,83,5104.66,10388.06,0.00
2024-12-10 17:24:06,162,7837,79,83,5125.95,10388.15,0.00
2024-12-10 17:24:06,162,7838,79,83,5099.44,10389.00,0.00
2024-12-10 17:24:06,163,7838,80,83,5068.16,10389.01,0.00
2024-12-10 17:24:06,164,7837,81,83,5034.10,10389.05,0.00
2024-12-10 17:24:06,163,7837,80,83,5084.79,10389.16,0.00
2024-12-10 17:24:06,163,7838,80,83,5057.40,10390.00,0.00
2024-12-10 17:24:06,164,7838,81,83,5026.57,10390.01,0.00
2024-12-10 17:24:06,163,7838,81,82,5041.53,10390.15,0.00
2024-12-10 17:24:06,163,7839,81,82,5076.30,10391.00,0.00
2024-12-10 17:24:06,164,7839,82,82,5045.35,10391.01,0.00
2024-12-10 17:24:06,163,7839,82,81,5071.23,10391.05,0.00
2024-12-10 17:24:06,164,7838,82,82,5039.04,10391.07,0.00
2024-12-10 17:24:06,165,7837,82,83,5022.99,10391.08,0.00
2024-12-10 17:24:06,164,7837,82,82,5106.87,10391.16,0.00
2024-12-10 17:24:07,164,7838,82,82,5077.28,10392.00,0.00
2024-12-10 17:24:07,165,7838,82,83,5046.51,10392.01,0.00
2024-12-10 17:24:07,164,7838,82,82,5061.50,10392.15,0.00
2024-12-10 17:24:07,163,7838,82,81,5056.88,10392.47,0.00
2024-12-10 17:24:07,163,7839,82,81,5193.04,10393.00,0.00
2024-12-10 17:24:07,164,7839,83,81,5161.38,10393.01,0.00
2024-12-10 17:24:07,163,7839,82,81,5177.17,10393.15,0.00
2024-12-10 17:24:07,162,7839,81,81,5208.48,10393.15,0.00
2024-12-10 17:24:07,161,7839,81,80,5240.19,10393.16,0.00
2024-12-10 17:24:07,161,7840,81,80,5217.39,10394.00,0.00
2024-12-10 17:24:07,162,7840,82,80,5185.18,10394.01,0.00
2024-12-10 17:24:07,161,7840,81,80,5201.31,10394.16,0.00
2024-12-10 17:24:07,161,7841,81,80,5178.50,10395.00,0.00
2024-12-10 17:24:07,162,7841,82,80,5146.54,10395.01,0.00
2024-12-10 17:24:07,161,7841,82,79,5162.42,10395.16,0.00
2024-12-10 17:24:07,161,7842,82,79,5139.62,10396.00,0.00
2024-12-10 17:24:07,162,7842,83,79,5107.89,10396.01,0.00
2024-12-10 17:24:07,161,7842,82,79,5132.17,10396.07,0.00
2024-12-10 17:24:07,160,7842,82,78,5162.95,10396.08,0.00
2024-12-10 17:24:07,159,7842,82,77,5188.25,10396.14,0.00
2024-12-10 17:24:07,158,7842,82,76,5220.43,10396.15,0.00
2024-12-10 17:24:07,158,7843,82,76,5197.84,10397.00,0.00
2024-12-10 17:24:07,159,7843,82,77,5165.15,10397.01,0.00
2024-12-10 17:24:07,160,7842,83,77,5125.11,10397.09,0.00
2024-12-10 17:24:07,159,7842,82,77,5205.75,10397.15,0.00
2024-12-10 17:24:07,159,7843,82,77,5183.30,10398.00,0.00
2024-12-10 17:24:07,160,7843,83,77,5150.91,10398.01,0.00
2024-12-10 17:24:07,161,7842,83,78,5105.41,10398.15,0.00
2024-12-10 17:24:07,160,7842,82,78,5198.42,10398.15,0.00
2024-12-10 17:24:07,161,7841,83,78,5117.19,10398.63,0.00
2024-12-10 17:24:07,161,7842,83,78,5231.15,10399.00,0.00
2024-12-10 17:24:07,162,7842,83,79,5198.85,10399.01,0.00
2024-12-10 17:24:07,161,7842,83,78,5216.36,10399.14,0.00
2024-12-10 17:24:07,161,7843,83,78,5321.44,10400.00,0.00
2024-12-10 17:24:07,162,7843,83,79,5288.59,10400.01,0.00
2024-12-10 17:24:07,161,7843,82,79,5306.65,10400.14,0.00
2024-12-10 17:24:07,161,7844,82,79,5282.54,10401.00,0.00
2024-12-10 17:24:07,162,7844,82,80,5249.93,10401.01,0.00
2024-12-10 17:24:07,161,7844,81,80,5267.75,10401.14,0.00
2024-12-10 17:24:07,162,7843,81,81,5152.79,10401.95,0.00
2024-12-10 17:24:07,162,7844,81,81,5215.12,10402.00,0.00
2024-12-10 17:24:07,163,7844,82,81,5183.13,10402.01,0.00
2024-12-10 17:24:07,162,7844,81,81,5199.78,10402.15,0.00
2024-12-10 17:24:07,162,7845,81,81,5240.03,10403.00,0.00
2024-12-10 17:24:07,163,7845,81,82,5207.88,10403.01,0.00
2024-12-10 17:24:07,162,7845,80,82,5235.55,10403.04,0.00
2024-12-10 17:24:07,161,7845,79,82,5261.64,10403.10,0.00
2024-12-10 17:24:07,162,7844,80,82,5225.96,10403.14,0.00
2024-12-10 17:24:07,161,7844,80,81,5291.38,10403.14,0.00
2024-12-10 17:24:07,161,7845,80,81,5267.26,10404.00,0.00
2024-12-10 17:24:07,162,7845,80,82,5234.75,10404.01,0.00
2024-12-10 17:24:07,161,7845,80,81,5264.04,10404.03,0.00
2024-12-10 17:24:07,160,7845,79,81,5284.65,10404.14,0.00
2024-12-10 17:24:07,159,7845,79,80,5317.23,10404.14,0.00
2024-12-10 17:24:07,159,7846,79,80,5359.55,10405.00,0.00
2024-12-10 17:24:07,160,7846,80,80,5326.06,10405.01,0.00
2024-12-10 17:24:07,159,7846,80,79,5344.57,10405.14,0.00
2024-12-10 17:24:07,159,7847,80,79,5321.45,10406.00,0.00
2024-12-10 17:24:07,160,7847,80,80,5288.19,10406.01,0.00
2024-12-10 17:24:07,159,7847,79,80,5306.47,10406.14,0.00
2024-12-10 17:24:07,160,7846,79,81,5233.73,10406.54,0.00
2024-12-10 17:24:07,160,7847,79,81,5286.75,10407.00,0.00
2024-12-10 17:24:07,161,7847,80,81,5253.92,10407.01,0.00
2024-12-10 17:24:07,160,7847,79,81,5282.87,10407.04,0.00
2024-12-10 17:24:07,159,7847,79,80,5305.02,10407.14,0.00
2024-12-10 17:24:07,158,7847,78,80,5337.93,10407.14,0.00
2024-12-10 17:24:07,158,7848,78,80,5380.54,10408.00,0.00
2024-12-10 17:24:07,159,7848,78,81,5346.70,10408.01,0.00
2024-12-10 17:24:07,160,7847,78,82,5310.69,10408.04,0.00
2024-12-10 17:24:07,159,7847,77,82,5344.80,10408.14,0.00
2024-12-10 17:24:07,160,7846,77,83,5308.14,10408.19,0.00
2024-12-10 17:24:07,160,7847,77,83,5303.38,10409.00,0.00
2024-12-10 17:24:07,161,7847,78,83,5270.44,10409.01,0.00
2024-12-10 17:24:07,160,7847,78,82,5289.14,10409.14,0.00
2024-12-10 17:24:07,161,7846,79,82,5228.54,10409.42,0.00
2024-12-10 17:24:07,161,7847,79,82,5404.79,10410.00,0.00
2024-12-10 17:24:07,162,7847,80,82,5371.43,10410.01,0.00
2024-12-10 17:24:07,161,7847,79,82,5390.63,10410.14,0.00
2024-12-10 17:24:07,161,7848,79,82,5430.53,10411.00,0.00
2024-12-10 17:24:07,162,7848,80,82,5397.01,10411.01,0.00
2024-12-10 17:24:07,161,7848,80,81,5422.16,10411.08,0.00
2024-12-10 17:24:07,160,7848,79,81,5450.22,10411.13,0.00
2024-12-10 17:24:07,159,7848,78,81,5483.84,10411.13,0.00
2024-12-10 17:24:07,159,7849,78,81,5459.42,10412.00,0.00
2024-12-10 17:24:07,160,7849,78,82,5425.30,10412.01,0.00
2024-12-10 17:24:07,159,7849,77,82,5452.26,10412.07,0.00
2024-12-10 17:24:07,158,7849,76,82,5480.20,10412.13,0.00
2024-12-10 17:24:07,157,7849,75,82,5513.78,10412.13,0.00
2024-12-10 17:24:07,157,7850,75,82,5490.37,10413.00,0.00
2024-12-10 17:24:07,158,7850,75,83,5455.62,10413.01,0.00
2024-12-10 17:24:07,159,7849,75,84,5410.23,10413.13,0.00
2024-12-10 17:24:07,158,7849,74,84,5482.05,10413.14,0.00
2024-12-10 17:24:07,157,7849,73,84,5516.31,10413.14,0.00
2024-12-10 17:24:08,157,7850,73,84,5493.55,10414.00,0.00
2024-12-10 17:24:08,158,7850,73,85,5458.78,10414.01,0.00
2024-12-10 17:24:08,157,7850,72,85,5479.69,10414.13,0.00
2024-12-10 17:24:08,157,7851,72,85,5522.23,10415.00,0.00
2024-12-10 17:24:08,158,7851,73,85,5487.27,10415.01,0.00
2024-12-10 17:24:08,157,7851,72,85,5508.36,10415.13,0.00
2024-12-10 17:24:08,157,7852,72,85,5483.07,10416.00,0.00
2024-12-10 17:24:08,158,7852,72,86,5448.37,10416.01,0.00
2024-12-10 17:24:08,159,7851,73,86,5412.14,10416.04,0.00
2024-12-10 17:24:08,160,7850,74,86,5418.06,10416.10,0.00
2024-12-10 17:24:08,159,7850,74,85,5481.00,10416.14,0.00
2024-12-10 17:24:08,159,7851,74,85,5454.79,10417.00,0.00
2024-12-10 17:24:08,160,7851,75,85,5420.70,10417.01,0.00
2024-12-10 17:24:08,159,7851,74,85,5441.11,10417.13,0.00
2024-12-10 17:24:08,159,7852,74,85,5543.61,10418.00,0.00
2024-12-10 17:24:08,160,7852,74,86,5508.96,10418.01,0.00
2024-12-10 17:24:08,159,7852,73,86,5529.92,10418.13,0.00
2024-12-10 17:24:08,159,7853,73,86,5500.52,10419.00,0.00
2024-12-10 17:24:08,160,7853,73,87,5466.14,10419.01,0.00
2024-12-10 17:24:08,159,7853,72,87,5493.35,10419.07,0.00
2024-12-10 17:24:08,158,7853,72,86,5521.56,10419.13,0.00
2024-12-10 17:24:08,157,7853,72,85,5556.06,10419.13,0.00
2024-12-10 17:24:08,157,7854,72,85,5526.18,10420.00,0.00
2024-12-10 17:24:08,158,7854,73,85,5491.21,10420.01,0.00
2024-12-10 17:24:08,157,7854,72,85,5512.98,10420.13,0.00
2024-12-10 17:24:08,157,7855,72,85,5482.39,10421.00,0.00
2024-12-10 17:24:08,158,7855,72,86,5447.69,10421.01,0.00
2024-12-10 17:24:08,157,7855,71,86,5469.19,10421.13,0.00
2024-12-10 17:24:08,157,7856,71,86,5437.89,10422.00,0.00
2024-12-10 17:24:08,158,7856,72,86,5403.48,10422.01,0.00
2024-12-10 17:24:08,157,7856,72,85,5424.69,10422.13,0.00
2024-12-10 17:24:08,156,7856,72,84,5404.29,10422.62,0.00
2024-12-10 17:24:08,156,7857,72,84,5431.98,10423.00,0.00
2024-12-10 17:24:08,157,7857,72,85,5397.39,10423.01,0.00
2024-12-10 17:24:08,156,7857,72,84,5418.69,10423.13,0.00
2024-12-10 17:24:08,156,7858,72,84,5395.08,10424.00,0.00
2024-12-10 17:24:08,157,7858,72,85,5360.72,10424.01,0.00
2024-12-10 17:24:08,156,7858,72,84,5381.79,10424.13,0.00
2024-12-10 17:24:08,156,7859,72,84,5358.18,10425.00,0.00
2024-12-10 17:24:08,157,7859,73,84,5324.05,10425.01,0.00
2024-12-10 17:24:08,156,7859,73,83,5344.88,10425.13,0.00
2024-12-10 17:24:08,156,7860,73,83,5321.27,10426.00,0.00
2024-12-10 17:24:08,157,7860,74,83,5287.37,10426.01,0.00
2024-12-10 17:24:08,156,7860,74,82,5307.96,10426.13,0.00
2024-12-10 17:24:08,156,7861,74,82,5284.35,10427.00,0.00
2024-12-10 17:24:08,157,7861,74,83,5250.69,10427.01,0.00
2024-12-10 17:24:08,156,7861,74,82,5271.04,10427.13,0.00
2024-12-10 17:24:08,157,7860,75,82,5181.85,10427.67,0.00
2024-12-10 17:24:08,157,7861,75,82,5239.24,10428.00,0.00
2024-12-10 17:24:08,158,7861,76,82,5206.08,10428.01,0.00
2024-12-10 17:24:08,157,7861,75,82,5226.01,10428.13,0.00
2024-12-10 17:24:08,157,7862,75,82,5268.21,10429.00,0.00
2024-12-10 17:24:08,158,7862,76,82,5234.87,10429.01,0.00
2024-12-10 17:24:08,157,7862,75,82,5254.98,10429.13,0.00
2024-12-10 17:24:08,157,7863,75,82,5229.93,10430.00,0.00
2024-12-10 17:24:08,158,7863,75,83,5196.83,10430.01,0.00
2024-12-10 17:24:08,157,7863,74,83,5216.71,10430.13,0.00
2024-12-10 17:24:08,157,7864,74,83,5190.81,10431.00,0.00
2024-12-10 17:24:08,158,7864,74,84,5157.95,10431.01,0.00
2024-12-10 17:24:08,157,7864,74,83,5190.14,10431.01,0.00
2024-12-10 17:24:08,156,7864,74,82,5210.77,10431.12,0.00
2024-12-10 17:24:08,156,7865,74,82,5184.07,10432.00,0.00
2024-12-10 17:24:08,157,7865,74,83,5151.05,10432.01,0.00
2024-12-10 17:24:08,156,7865,74,82,5171.42,10432.12,0.00
2024-12-10 17:24:09,156,7866,74,82,5144.29,10433.00,0.00
2024-12-10 17:24:09,157,7866,74,83,5111.53,10433.01,0.00
2024-12-10 17:24:09,156,7866,73,83,5131.64,10433.12,0.00
2024-12-10 17:24:09,155,7866,72,83,5164.08,10433.12,0.00
2024-12-10 17:24:09,155,7867,72,83,5137.26,10434.00,0.00
2024-12-10 17:24:09,156,7867,73,83,5104.33,10434.01,0.00
2024-12-10 17:24:09,155,7867,72,83,5124.53,10434.12,0.00
2024-12-10 17:24:09,155,7868,72,83,5097.66,10435.00,0.00
2024-12-10 17:24:09,156,7868,73,83,5064.99,10435.01,0.00
2024-12-10 17:24:09,155,7868,73,82,5089.62,10435.08,0.00
2024-12-10 17:24:09,154,7868,73,81,5117.95,10435.12,0.00
2024-12-10 17:24:09,153,7868,72,81,5150.71,10435.12,0.00
2024-12-10 17:24:09,153,7869,72,81,5124.10,10436.00,0.00
2024-12-10 17:24:09,154,7869,73,81,5090.83,10436.01,0.00
2024-12-10 17:24:09,153,7869,73,80,5111.88,10436.12,0.00
2024-12-10 17:24:09,154,7868,74,80,5039.46,10436.51,0.00
2024-12-10 17:24:09,155,7867,74,81,5017.50,10436.77,0.00
2024-12-10 17:24:09,155,7868,74,81,5080.32,10437.00,0.00
2024-12-10 17:24:09,156,7868,74,82,5047.75,10437.01,0.00
2024-12-10 17:24:09,155,7868,74,81,5069.59,10437.10,0.00
2024-12-10 17:24:09,154,7868,73,81,5101.16,10437.11,0.00
2024-12-10 17:24:09,153,7868,73,80,5133.82,10437.11,0.00
2024-12-10 17:24:09,153,7869,73,80,5242.64,10438.00,0.00
2024-12-10 17:24:09,154,7869,73,81,5208.59,10438.01,0.00
2024-12-10 17:24:09,153,7869,72,81,5231.09,10438.11,0.00
2024-12-10 17:24:09,152,7869,71,81,5264.82,10438.11,0.00
2024-12-10 17:24:09,152,7870,71,81,5237.52,10439.00,0.00
2024-12-10 17:24:09,153,7870,72,81,5203.29,10439.01,0.00
2024-12-10 17:24:09,152,7870,71,81,5230.68,10439.07,0.00
2024-12-10 17:24:09,151,7870,71,80,5260.51,10439.11,0.00
2024-12-10 17:24:09,150,7870,71,79,5294.88,10439.11,0.00
2024-12-10 17:24:09,151,7869,71,80,5250.84,10439.21,0.00
2024-12-10 17:24:09,150,7869,70,80,5316.69,10439.49,0.00
2024-12-10 17:24:09,150,7870,70,80,5332.69,10440.00,0.00
2024-12-10 17:24:09,151,7870,71,80,5297.37,10440.01,0.00
2024-12-10 17:24:09,150,7870,71,79,5321.60,10440.11,0.00
2024-12-10 17:24:09,150,7871,71,79,5366.59,10441.00,0.00
2024-12-10 17:24:09,151,7871,72,79,5331.05,10441.01,0.00
2024-12-10 17:24:09,150,7871,72,78,5355.51,10441.11,0.00
2024-12-10 17:24:09,150,7872,72,78,5329.82,10442.00,0.00
2024-12-10 17:24:09,151,7872,72,79,5294.52,10442.01,0.00
2024-12-10 17:24:09,150,7872,71,79,5318.73,10442.11,0.00
2024-12-10 17:24:09,150,7873,71,79,5291.25,10443.00,0.00
2024-12-10 17:24:09,151,7873,71,80,5256.21,10443.01,0.00
2024-12-10 17:24:09,152,7872,72,80,5215.47,10443.08,0.00
2024-12-10 17:24:09,151,7872,71,80,5263.18,10443.12,0.00
2024-12-10 17:24:09,151,7873,71,80,5235.26,10444.00,0.00
2024-12-10 17:24:09,152,7873,72,80,5200.82,10444.01,0.00
2024-12-10 17:24:09,151,7873,72,79,5223.56,10444.11,0.00
2024-12-10 17:24:09,151,7874,72,79,5262.85,10445.00,0.00
2024-12-10 17:24:09,152,7874,73,79,5228.23,10445.01,0.00
2024-12-10 17:24:09,151,7874,73,78,5262.16,10445.01,0.00
2024-12-10 17:24:09,150,7874,72,78,5286.15,10445.11,0.00
2024-12-10 17:24:09,149,7874,72,77,5320.93,10445.11,0.00
2024-12-10 17:24:09,148,7874,72,76,5356.18,10445.11,0.00
2024-12-10 17:24:09,148,7875,72,76,5326.70,10446.00,0.00
2024-12-10 17:24:09,149,7875,73,76,5290.95,10446.01,0.00
2024-12-10 17:24:09,148,7875,72,76,5315.46,10446.11,0.00
2024-12-10 17:24:09,147,7875,72,75,5350.91,10446.11,0.00
2024-12-10 17:24:09,146,7875,72,74,5348.66,10446.47,0.00
2024-12-10 17:24:09,147,7874,72,75,5311.57,10446.48,0.00
2024-12-10 17:24:10,147,7875,72,75,5368.79,10447.00,0.00
2024-12-10 17:24:10,148,7875,73,75,5332.52,10447.01,0.00
2024-12-10 17:24:10,147,7875,72,75,5357.47,10447.11,0.00
2024-12-10 17:24:10,147,7876,72,75,5406.98,10448.00,0.00
2024-12-10 17:24:10,148,7876,72,76,5370.44,10448.01,0.00
2024-12-10 17:24:10,147,7876,72,75,5395.65,10448.11,0.00
2024-12-10 17:24:10,147,7877,72,75,5374.08,10449.00,0.00
2024-12-10 17:24:10,148,7877,73,75,5337.77,10449.01,0.00
2024-12-10 17:24:10,147,7877,72,75,5362.06,10449.12,0.00
2024-12-10 17:24:10,148,7876,72,76,5325.12,10449.13,0.00
2024-12-10 17:24:10,148,7877,72,76,5375.00,10450.00,0.00
2024-12-10 17:24:10,149,7877,73,76,5338.93,10450.01,0.00
2024-12-10 17:24:10,148,7877,72,76,5367.97,10450.07,0.00
2024-12-10 17:24:10,147,7877,72,75,5399.54,10450.11,0.00
2024-12-10 17:24:10,147,7878,72,75,5448.25,10451.00,0.00
2024-12-10 17:24:10,148,7878,72,76,5411.44,10451.01,0.00
2024-12-10 17:24:10,147,7878,71,76,5435.52,10451.12,0.00
2024-12-10 17:24:10,148,7877,71,77,5319.65,10451.87,0.00
2024-12-10 17:24:10,148,7878,71,77,5386.86,10452.00,0.00
2024-12-10 17:24:10,149,7878,71,78,5350.70,10452.01,0.00
2024-12-10 17:24:10,148,7878,70,78,5374.21,10452.12,0.00
2024-12-10 17:24:10,148,7879,70,78,5422.25,10453.00,0.00
2024-12-10 17:24:10,149,7879,70,79,5385.86,10453.01,0.00
2024-12-10 17:24:10,148,7879,70,78,5408.90,10453.13,0.00
2024-12-10 17:24:10,148,7880,70,78,5388.48,10454.00,0.00
2024-12-10 17:24:10,149,7880,71,78,5352.31,10454.01,0.00
2024-12-10 17:24:10,148,7880,70,78,5375.12,10454.13,0.00
2024-12-10 17:24:10,148,7881,70,78,5355.09,10455.00,0.00
2024-12-10 17:24:10,149,7881,70,79,5319.15,10455.01,0.00
2024-12-10 17:24:10,148,7881,69,79,5341.73,10455.13,0.00
2024-12-10 17:24:10,148,7882,69,79,5321.69,10456.00,0.00
2024-12-10 17:24:10,149,7882,69,80,5285.97,10456.01,0.00
2024-12-10 17:24:10,148,7882,69,79,5308.32,10456.13,0.00
2024-12-10 17:24:10,148,7883,69,79,5287.47,10457.00,0.00
2024-12-10 17:24:10,149,7883,69,80,5251.99,10457.01,0.00
2024-12-10 17:24:10,150,7882,69,81,5213.50,10457.05,0.00
2024-12-10 17:24:10,149,7882,68,81,5285.03,10457.13,0.00
2024-12-10 17:24:10,150,7881,69,81,5169.29,10457.92,0.00
2024-12-10 17:24:10,150,7882,69,81,5236.20,10458.00,0.00
2024-12-10 17:24:10,151,7882,70,81,5201.52,10458.01,0.00
2024-12-10 17:24:10,150,7882,70,80,5223.01,10458.13,0.00
2024-12-10 17:24:10,150,7883,70,80,5335.11,10459.00,0.00
2024-12-10 17:24:10,151,7883,71,80,5299.78,10459.01,0.00
2024-12-10 17:24:10,150,7883,71,79,5321.93,10459.13,0.00
2024-12-10 17:24:10,149,7883,71,78,5356.94,10459.13,0.00
2024-12-10 17:24:10,149,7884,71,78,5327.71,10460.00,0.00
2024-12-10 17:24:10,150,7884,71,79,5292.19,10460.01,0.00
2024-12-10 17:24:10,151,7883,72,79,5246.11,10460.13,0.00
2024-12-10 17:24:10,150,7883,72,78,5316.86,10460.13,0.00
2024-12-10 17:24:10,149,7883,71,78,5351.85,10460.13,0.00
2024-12-10 17:24:10,149,7884,71,78,5322.02,10461.00,0.00
2024-12-10 17:24:10,150,7884,72,78,5286.54,10461.01,0.00
2024-12-10 17:24:10,149,7884,72,77,5308.74,10461.13,0.00
2024-12-10 17:24:10,149,7885,72,77,5348.29,10462.00,0.00
2024-12-10 17:24:10,150,7885,73,77,5312.63,10462.01,0.00
2024-12-10 17:24:10,149,7885,73,76,5335.01,10462.13,0.00
2024-12-10 17:24:10,148,7885,72,76,5370.35,10462.13,0.00
2024-12-10 17:24:10,148,7886,72,76,5340.53,10463.00,0.00
2024-12-10 17:24:10,149,7886,73,76,5304.69,10463.01,0.00
2024-12-10 17:24:10,148,7886,73,75,5327.16,10463.13,0.00
2024-12-10 17:24:10,149,7885,73,76,5250.78,10463.53,0.00
2024-12-10 17:24:10,149,7886,73,76,5299.90,10464.00,0.00
2024-12-10 17:24:10,150,7886,74,76,5264.56,10464.01,0.00
2024-12-10 17:24:10,149,7886,73,76,5285.91,10464.13,0.00
2024-12-10 17:24:10,149,7887,73,76,5325.42,10465.00,0.00
2024-12-10 17:24:10,150,7887,73,77,5289.91,10465.01,0.00
2024-12-10 17:24:10,149,7887,73,76,5311.43,10465.13,0.00
2024-12-10 17:24:10,149,7888,73,76,5280.60,10466.00,0.00
2024-12-10 17:24:10,150,7888,73,77,5245.39,10466.01,0.00
2024-12-10 17:24:10,151,7887,73,78,5209.96,10466.03,0.00
2024-12-10 17:24:10,150,7887,73,77,5266.38,10466.14,0.00
2024-12-10 17:24:10,151,7886,73,78,5219.04,10466.27,0.00
2024-12-10 17:24:10,151,7887,73,78,5258.70,10467.00,0.00
2024-12-10 17:24:10,152,7887,74,78,5224.11,10467.01,0.00
2024-12-10 17:24:10,151,7887,74,77,5244.90,10467.13,0.00
2024-12-10 17:24:10,150,7887,74,76,5279.16,10467.13,0.00
2024-12-10 17:24:11,150,7888,74,76,5384.63,10468.00,0.00
2024-12-10 17:24:11,151,7888,75,76,5348.97,10468.01,0.00
2024-12-10 17:24:11,150,7888,75,75,5370.73,10468.13,0.00
2024-12-10 17:24:11,149,7888,75,74,5328.77,10468.81,0.00
2024-12-10 17:24:11,149,7889,75,74,5371.06,10469.00,0.00
2024-12-10 17:24:11,150,7889,76,74,5335.25,10469.01,0.00
2024-12-10 17:24:11,149,7889,76,73,5357.06,10469.13,0.00
2024-12-10 17:24:11,150,7888,76,74,5278.20,10469.56,0.00
2024-12-10 17:24:11,149,7888,75,74,5309.33,10469.90,0.00
2024-12-10 17:24:11,149,7889,75,74,5369.14,10470.00,0.00
2024-12-10 17:24:11,150,7889,76,74,5333.35,10470.01,0.00
2024-12-10 17:24:11,149,7889,75,74,5355.14,10470.13,0.00
2024-12-10 17:24:11,150,7888,76,74,5246.47,10470.85,0.00
2024-12-10 17:24:11,150,7889,76,74,5382.02,10471.00,0.00
2024-12-10 17:24:11,151,7889,77,74,5346.38,10471.01,0.00
2024-12-10 17:24:11,150,7889,76,74,5368.12,10471.13,0.00
2024-12-10 17:24:11,151,7888,76,75,5266.26,10471.78,0.00
2024-12-10 17:24:11,151,7889,76,75,5398.90,10472.00,0.00
2024-12-10 17:24:11,152,7889,77,75,5363.39,10472.01,0.00
2024-12-10 17:24:11,151,7889,77,74,5394.07,10472.05,0.00
2024-12-10 17:24:11,150,7889,77,73,5420.99,10472.13,0.00
2024-12-10 17:24:11,149,7889,76,73,5457.26,10472.13,0.00
2024-12-10 17:24:11,149,7890,76,73,5506.94,10473.00,0.00
2024-12-10 17:24:11,150,7890,77,73,5470.23,10473.01,0.00
2024-12-10 17:24:11,149,7890,76,73,5493.63,10473.13,0.00
2024-12-10 17:24:11,150,7889,77,73,5388.17,10473.80,0.00
2024-12-10 17:24:11,150,7890,77,73,5451.89,10474.00,0.00
2024-12-10 17:24:11,151,7890,77,74,5415.79,10474.01,0.00
2024-12-10 17:24:11,152,7889,78,74,5380.16,10474.02,0.00
2024-12-10 17:24:11,151,7889,78,73,5471.33,10474.13,0.00
2024-12-10 17:24:11,151,7890,78,73,5519.67,10475.00,0.00
2024-12-10 17:24:11,152,7890,78,74,5483.36,10475.01,0.00
2024-12-10 17:24:11,153,7889,79,74,5446.16,10475.03,0.00
2024-12-10 17:24:11,152,7889,79,73,5516.49,10475.13,0.00
2024-12-10 17:24:11,151,7889,78,73,5552.33,10475.13,0.00
2024-12-10 17:24:11,152,7888,79,73,5462.76,10475.65,0.00
2024-12-10 17:24:11,152,7889,79,73,5580.20,10476.00,0.00
2024-12-10 17:24:11,153,7889,79,74,5543.73,10476.01,0.00
2024-12-10 17:24:11,152,7889,79,73,5567.86,10476.12,0.00
2024-12-10 17:24:11,151,7889,79,72,5604.04,10476.12,0.00
2024-12-10 17:24:11,151,7890,79,72,5715.66,10477.00,0.00
2024-12-10 17:24:11,152,7890,79,73,5678.05,10477.01,0.00
2024-12-10 17:24:11,151,7890,79,72,5712.90,10477.03,0.00
2024-12-10 17:24:11,150,7890,79,71,5740.55,10477.12,0.00
2024-12-10 17:24:11,149,7890,79,70,5778.37,10477.12,0.00
2024-12-10 17:24:11,149,7891,79,70,5750.31,10478.00,0.00
2024-12-10 17:24:11,150,7891,79,71,5711.97,10478.01,0.00
2024-12-10 17:24:11,150,7892,79,71,5669.13,10479.00,0.00
2024-12-10 17:24:11,151,7892,79,72,5631.59,10479.01,0.00
2024-12-10 17:24:11,152,7891,79,73,5590.43,10479.06,0.00
2024-12-10 17:24:11,151,7891,78,73,5644.14,10479.13,0.00
2024-12-10 17:24:11,152,7890,78,74,5519.00,10479.86,0.00
2024-12-10 17:24:11,152,7891,78,74,5581.87,10480.00,0.00
2024-12-10 17:24:11,153,7891,78,75,5545.39,10480.01,0.00
2024-12-10 17:24:11,152,7891,77,75,5537.92,10480.30,0.00
2024-12-10 17:24:11,153,7890,78,75,5496.25,10480.37,0.00
2024-12-10 17:24:11,154,7889,78,76,5436.24,10480.71,0.00
2024-12-10 17:24:11,154,7890,78,76,5630.45,10481.00,0.00
2024-12-10 17:24:11,155,7890,79,76,5594.12,10481.01,0.00
2024-12-10 17:24:11,154,7890,79,75,5618.25,10481.12,0.00
2024-12-10 17:24:11,155,7889,80,75,5494.17,10481.89,0.00
2024-12-10 17:24:12,155,7890,80,75,5691.73,10482.00,0.00
2024-12-10 17:24:12,156,7890,81,75,5655.24,10482.01,0.00
2024-12-10 17:24:12,156,7891,81,75,5676.74,10483.00,0.00
2024-12-10 17:24:12,157,7891,82,75,5640.58,10483.01,0.00
2024-12-10 17:24:12,156,7891,81,75,5654.68,10483.12,0.00
2024-12-10 17:24:12,156,7892,81,75,5628.98,10484.00,0.00
2024-12-10 17:24:12,157,7892,81,76,5593.13,10484.01,0.00
2024-12-10 17:24:12,156,7892,80,76,5614.44,10484.12,0.00
2024-12-10 17:24:12,155,7892,80,75,5649.99,10484.12,0.00
2024-12-10 17:24:12,155,7893,80,75,5621.53,10485.00,0.00
2024-12-10 17:24:12,156,7893,80,76,5585.49,10485.01,0.00
2024-12-10 17:24:12,155,7893,80,75,5609.40,10485.12,0.00
2024-12-10 17:24:12,154,7893,80,74,5645.15,10485.12,0.00
2024-12-10 17:24:12,154,7894,80,74,5612.89,10486.00,0.00
2024-12-10 17:24:12,155,7894,81,74,5576.68,10486.01,0.00
2024-12-10 17:24:12,154,7894,80,74,5599.70,10486.12,0.00
2024-12-10 17:24:12,154,7895,80,74,5563.93,10487.00,0.00
2024-12-10 17:24:12,155,7895,81,74,5528.04,10487.01,0.00
2024-12-10 17:24:12,156,7894,81,75,5401.20,10487.78,0.00
2024-12-10 17:24:12,156,7895,81,75,5459.21,10488.00,0.00
2024-12-10 17:24:12,157,7895,82,75,5424.44,10488.01,0.00
2024-12-10 17:24:12,156,7895,81,75,5447.16,10488.12,0.00
2024-12-10 17:24:12,155,7895,81,74,5463.05,10488.27,0.00
2024-12-10 17:24:12,155,7896,81,74,5513.28,10489.00,0.00
2024-12-10 17:24:12,156,7896,81,75,5477.94,10489.01,0.00
2024-12-10 17:24:12,155,7896,81,74,5488.23,10489.23,0.00
2024-12-10 17:24:12,155,7897,81,74,5465.75,10490.00,0.00
2024-12-10 17:24:12,156,7897,81,75,5430.72,10490.01,0.00
2024-12-10 17:24:12,155,7897,80,75,5452.27,10490.13,0.00
2024-12-10 17:24:12,154,7897,80,74,5458.86,10490.35,0.00
2024-12-10 17:24:12,154,7898,80,74,5457.70,10491.00,0.00
2024-12-10 17:24:12,155,7898,81,74,5422.49,10491.01,0.00
2024-12-10 17:24:12,154,7898,81,73,5454.99,10491.03,0.00
2024-12-10 17:24:12,153,7898,80,73,5479.71,10491.12,0.00
2024-12-10 17:24:12,152,7898,80,72,5515.07,10491.13,0.00
2024-12-10 17:24:12,151,7898,80,71,5550.90,10491.13,0.00
2024-12-10 17:24:12,150,7898,79,71,5571.23,10491.27,0.00
2024-12-10 17:24:12,151,7897,79,72,5498.94,10491.60,0.00
2024-12-10 17:24:12,152,7896,80,72,5471.88,10491.79,0.00
2024-12-10 17:24:12,152,7897,80,72,5532.81,10492.00,0.00
2024-12-10 17:24:12,153,7897,81,72,5496.65,10492.01,0.00
2024-12-10 17:24:12,152,7897,81,71,5519.74,10492.13,0.00
2024-12-10 17:24:12,151,7897,81,70,5523.59,10492.40,0.00
2024-12-10 17:24:12,151,7898,81,70,5669.24,10493.00,0.00
2024-12-10 17:24:12,152,7898,81,71,5631.94,10493.01,0.00
2024-12-10 17:24:12,151,7898,80,71,5656.09,10493.13,0.00
2024-12-10 17:24:12,152,7897,80,72,5556.30,10493.74,0.00
2024-12-10 17:24:12,152,7898,80,72,5615.22,10494.00,0.00
2024-12-10 17:24:12,153,7898,80,73,5578.52,10494.01,0.00
2024-12-10 17:24:12,152,7898,79,73,5601.54,10494.13,0.00
2024-12-10 17:24:12,152,7899,79,73,5648.00,10495.00,0.00
2024-12-10 17:24:12,153,7899,79,74,5611.09,10495.01,0.00
2024-12-10 17:24:12,153,7900,79,74,5574.97,10496.00,0.00
2024-12-10 17:24:12,154,7900,80,74,5538.77,10496.01,0.00
2024-12-10 17:24:12,153,7900,79,74,5560.11,10496.13,0.00
2024-12-10 17:24:12,153,7901,79,74,5537.94,10497.00,0.00
2024-12-10 17:24:12,154,7901,79,75,5501.98,10497.01,0.00
2024-12-10 17:24:12,153,7901,78,75,5534.53,10497.03,0.00
2024-12-10 17:24:12,152,7901,78,74,5559.09,10497.13,0.00
2024-12-10 17:24:12,151,7901,77,74,5595.21,10497.13,0.00
2024-12-10 17:24:12,151,7902,77,74,5572.81,10498.00,0.00
2024-12-10 17:24:12,152,7902,77,75,5536.15,10498.01,0.00
2024-12-10 17:24:12,151,7902,77,74,5568.66,10498.04,0.00
2024-12-10 17:24:12,150,7902,76,74,5598.39,10498.09,0.00
2024-12-10 17:24:12,149,7902,75,74,5632.45,10498.11,0.00
2024-12-10 17:24:12,148,7902,75,73,5669.80,10498.12,0.00
2024-12-10 17:24:12,147,7902,74,73,5707.65,10498.12,0.00
2024-12-10 17:24:12,147,7903,74,73,5685.94,10499.00,0.00
2024-12-10 17:24:13,148,7903,74,74,5647.52,10499.01,0.00
2024-12-10 17:24:13,147,7903,74,73,5671.77,10499.12,0.00
2024-12-10 17:24:13,147,7904,74,73,5649.26,10500.00,0.00
2024-12-10 17:24:13,148,7904,75,73,5611.09,10500.01,0.00
2024-12-10 17:24:13,147,7904,75,72,5634.93,10500.12,0.00
2024-12-10 17:24:13,147,7905,75,72,5611.80,10501.00,0.00
2024-12-10 17:24:13,148,7905,76,72,5573.89,10501.01,0.00
2024-12-10 17:24:13,147,7905,75,72,5598.08,10501.11,0.00
2024-12-10 17:24:13,146,7905,75,71,5635.70,10501.11,0.00
2024-12-10 17:24:13,145,7905,75,70,5670.00,10501.15,0.00
2024-12-10 17:24:13,145,7906,75,70,5653.83,10502.00,0.00
2024-12-10 17:24:13,146,7906,75,71,5615.11,10502.01,0.00
2024-12-10 17:24:13,146,7907,75,71,5580.85,10503.00,0.00
2024-12-10 17:24:13,147,7907,75,72,5542.89,10503.01,0.00
2024-12-10 17:24:13,146,7907,74,72,5576.56,10503.04,0.00
2024-12-10 17:24:13,145,7907,74,71,5605.32,10503.10,0.00
2024-12-10 17:24:13,144,7907,73,71,5643.52,10503.10,0.00
2024-12-10 17:24:13,143,7907,72,71,5680.64,10503.13,0.00
2024-12-10 17:24:13,144,7906,72,72,5590.99,10503.62,0.00
2024-12-10 17:24:13,144,7907,72,72,5640.90,10504.00,0.00
2024-12-10 17:24:13,145,7907,72,73,5602.00,10504.01,0.00
2024-12-10 17:24:13,144,7907,72,72,5627.46,10504.10,0.00
2024-12-10 17:24:13,144,7908,72,72,5679.07,10505.00,0.00
2024-12-10 17:24:13,145,7908,72,73,5639.90,10505.01,0.00
2024-12-10 17:24:13,144,7908,71,73,5665.56,10505.10,0.00
2024-12-10 17:24:13,145,7907,72,73,5618.53,10505.19,0.00
2024-12-10 17:24:13,145,7908,72,73,5630.76,10506.00,0.00
2024-12-10 17:24:13,146,7908,72,74,5592.20,10506.01,0.00
2024-12-10 17:24:13,146,7909,72,74,5628.91,10507.00,0.00
2024-12-10 17:24:13,147,7909,72,75,5590.62,10507.01,0.00
2024-12-10 17:24:13,148,7908,73,75,5547.18,10507.07,0.00
2024-12-10 17:24:13,148,7909,73,75,5566.46,10508.00,0.00
2024-12-10 17:24:13,149,7909,73,76,5529.10,10508.01,0.00
2024-12-10 17:24:13,148,7909,72,76,5561.51,10508.05,0.00
2024-12-10 17:24:13,147,7909,72,75,5589.79,10508.11,0.00
2024-12-10 17:24:13,147,7910,72,75,5639.60,10509.00,0.00
2024-12-10 17:24:13,148,7910,73,75,5601.50,10509.01,0.00
2024-12-10 17:24:13,149,7909,74,75,5563.91,10509.02,0.00
2024-12-10 17:24:13,148,7909,73,75,5621.40,10509.05,0.00
2024-12-10 17:24:13,147,7909,72,75,5651.13,10509.11,0.00
2024-12-10 17:24:13,147,7910,72,75,5629.46,10510.00,0.00
2024-12-10 17:24:13,148,7910,72,76,5591.43,10510.01,0.00
2024-12-10 17:24:13,147,7910,71,76,5617.06,10510.10,0.00
2024-12-10 17:24:13,147,7911,71,76,5666.17,10511.00,0.00
2024-12-10 17:24:13,148,7911,72,76,5627.89,10511.01,0.00
2024-12-10 17:24:13,147,7911,71,76,5660.14,10511.06,0.00
2024-12-10 17:24:13,146,7911,70,76,5694.60,10511.10,0.00
2024-12-10 17:24:13,146,7912,70,76,5672.06,10512.00,0.00
2024-12-10 17:24:13,147,7912,71,76,5633.47,10512.01,0.00
2024-12-10 17:24:13,146,7912,71,75,5662.02,10512.10,0.00
2024-12-10 17:24:13,147,7911,71,76,5580.72,10512.52,0.00
2024-12-10 17:24:13,147,7912,71,76,5636.15,10513.00,0.00
2024-12-10 17:24:13,148,7912,71,77,5598.07,10513.01,0.00
2024-12-10 17:24:13,147,7912,71,76,5631.88,10513.04,0.00
2024-12-10 17:24:13,146,7912,71,75,5664.71,10513.09,0.00
2024-12-10 17:24:13,145,7912,71,74,5703.06,10513.09,0.00
2024-12-10 17:24:13,145,7913,71,74,5752.87,10514.00,0.00
2024-12-10 17:24:13,146,7913,71,75,5713.46,10514.01,0.00
2024-12-10 17:24:13,145,7913,71,74,5743.48,10514.09,0.00
2024-12-10 17:24:13,145,7914,71,74,5720.78,10515.00,0.00
2024-12-10 17:24:13,146,7914,71,75,5681.60,10515.01,0.00
2024-12-10 17:24:13,145,7914,70,75,5711.39,10515.09,0.00
2024-12-10 17:24:13,145,7915,70,75,5688.69,10516.00,0.00
2024-12-10 17:24:13,146,7915,70,76,5649.72,10516.01,0.00
2024-12-10 17:24:13,145,7915,69,76,5678.58,10516.10,0.00
2024-12-10 17:24:13,145,7916,69,76,5656.59,10517.00,0.00
2024-12-10 17:24:13,146,7916,69,77,5617.85,10517.01,0.00
2024-12-10 17:24:13,145,7916,68,77,5646.48,10517.10,0.00
2024-12-10 17:24:13,145,7917,68,77,5624.49,10518.00,0.00
2024-12-10 17:24:13,146,7917,69,77,5585.96,10518.01,0.00
2024-12-10 17:24:13,145,7917,69,76,5614.37,10518.10,0.00
2024-12-10 17:24:13,146,7916,70,76,5551.47,10518.34,0.00
2024-12-10 17:24:13,147,7915,71,76,5485.35,10518.80,0.00
2024-12-10 17:24:13,147,7916,71,76,5553.50,10519.00,0.00
2024-12-10 17:24:13,148,7916,71,77,5515.97,10519.01,0.00
2024-12-10 17:24:13,149,7915,71,78,5471.22,10519.09,0.00
2024-12-10 17:24:13,148,7915,71,77,5533.79,10519.10,0.00
2024-12-10 17:24:13,149,7914,71,78,5455.82,10519.50,0.00
2024-12-10 17:24:13,149,7915,71,78,5633.39,10520.00,0.00
2024-12-10 17:24:13,150,7915,71,79,5595.84,10520.01,0.00
2024-12-10 17:24:13,149,7915,70,79,5623.55,10520.09,0.00
2024-12-10 17:24:13,149,7916,70,79,5740.55,10521.00,0.00
2024-12-10 17:24:14,150,7916,71,79,5702.28,10521.01,0.00
2024-12-10 17:24:14,149,7916,71,78,5730.71,10521.09,0.00
2024-12-10 17:24:14,149,7917,71,78,5706.49,10522.00,0.00
2024-12-10 17:24:14,150,7917,71,79,5668.45,10522.01,0.00
2024-12-10 17:24:14,149,7917,70,79,5696.65,10522.09,0.00
2024-12-10 17:24:14,149,7918,70,79,5672.43,10523.00,0.00
2024-12-10 17:24:14,150,7918,70,80,5634.61,10523.01,0.00
2024-12-10 17:24:14,149,7918,70,79,5662.58,10523.09,0.00
2024-12-10 17:24:14,149,7919,70,79,5638.36,10524.00,0.00
2024-12-10 17:24:14,150,7919,70,80,5600.77,10524.01,0.00
2024-12-10 17:24:14,151,7918,70,81,5563.68,10524.02,0.00
2024-12-10 17:24:14,150,7918,70,80,5601.51,10524.10,0.00
2024-12-10 17:24:14,150,7919,70,80,5577.45,10525.00,0.00
2024-12-10 17:24:14,151,7919,70,81,5540.51,10525.01,0.00
2024-12-10 17:24:14,150,7919,69,81,5567.67,10525.09,0.00
2024-12-10 17:24:14,150,7920,69,81,5613.06,10526.00,0.00
2024-12-10 17:24:14,151,7920,70,81,5575.89,10526.01,0.00
2024-12-10 17:24:14,150,7920,70,80,5605.54,10526.07,0.00
2024-12-10 17:24:14,149,7920,69,80,5641.06,10526.09,0.00
2024-12-10 17:24:14,149,7921,69,80,5616.12,10527.00,0.00
2024-12-10 17:24:14,150,7921,70,80,5578.68,10527.01,0.00
2024-12-10 17:24:14,149,7921,69,80,5609.08,10527.07,0.00
2024-12-10 17:24:14,148,7921,68,80,5644.86,10527.08,0.00
2024-12-10 17:24:14,149,7920,68,81,5587.93,10527.28,0.00
2024-12-10 17:24:14,149,7921,68,81,5615.24,10528.00,0.00
2024-12-10 17:24:14,150,7921,68,82,5577.80,10528.01,0.00
2024-12-10 17:24:14,149,7921,67,82,5606.80,10528.08,0.00
2024-12-10 17:24:14,150,7920,67,83,5526.04,10528.51,0.00
2024-12-10 17:24:14,150,7921,67,83,5651.33,10529.00,0.00
2024-12-10 17:24:14,151,7921,68,83,5613.91,10529.01,0.00
2024-12-10 17:24:14,150,7921,67,83,5642.95,10529.08,0.00
2024-12-10 17:24:14,150,7922,67,83,5686.97,10530.00,0.00
2024-12-10 17:24:14,151,7922,68,83,5649.31,10530.01,0.00
2024-12-10 17:24:14,150,7922,68,82,5678.58,10530.08,0.00
2024-12-10 17:24:14,150,7923,68,82,5652.41,10531.00,0.00
2024-12-10 17:24:14,151,7923,68,83,5614.97,10531.01,0.00
2024-12-10 17:24:14,150,7923,68,82,5644.02,10531.08,0.00
2024-12-10 17:24:14,151,7922,68,83,5589.24,10531.26,0.00
2024-12-10 17:24:14,151,7923,68,83,5636.43,10532.00,0.00
2024-12-10 17:24:14,152,7923,69,83,5599.35,10532.01,0.00
2024-12-10 17:24:14,151,7923,69,82,5628.10,10532.08,0.00
2024-12-10 17:24:14,152,7922,69,83,5559.97,10532.39,0.00
2024-12-10 17:24:14,153,7921,69,84,5526.41,10532.45,0.00
2024-12-10 17:24:14,153,7922,69,84,5646.58,10533.00,0.00
2024-12-10 17:24:14,154,7922,69,85,5609.92,10533.01,0.00
2024-12-10 17:24:14,153,7922,69,84,5638.35,10533.08,0.00
2024-12-10 17:24:14,153,7923,69,84,5748.33,10534.00,0.00
2024-12-10 17:24:14,154,7923,69,85,5711.00,10534.01,0.00
2024-12-10 17:24:14,153,7923,68,85,5740.10,10534.08,0.00
2024-12-10 17:24:14,153,7924,68,85,5711.71,10535.00,0.00
2024-12-10 17:24:14,154,7924,69,85,5674.62,10535.01,0.00
2024-12-10 17:24:14,153,7924,68,85,5703.48,10535.08,0.00
2024-12-10 17:24:14,154,7923,69,85,5624.37,10535.48,0.00
2024-12-10 17:24:14,154,7924,69,85,5676.74,10536.00,0.00
2024-12-10 17:24:14,155,7924,70,85,5640.12,10536.01,0.00
2024-12-10 17:24:14,154,7924,69,85,5671.29,10536.05,0.00
2024-12-10 17:24:14,153,7924,68,85,5705.61,10536.07,0.00
2024-12-10 17:24:14,152,7924,68,84,5741.76,10536.08,0.00
2024-12-10 17:24:14,153,7923,68,85,5610.31,10536.97,0.00
2024-12-10 17:24:14,153,7924,68,85,5747.38,10537.00,0.00
2024-12-10 17:24:14,154,7924,69,85,5710.06,10537.01,0.00
2024-12-10 17:24:14,153,7924,69,84,5739.15,10537.08,0.00
2024-12-10 17:24:14,154,7923,69,85,5661.83,10537.45,0.00
2024-12-10 17:24:14,154,7924,69,85,5742.28,10538.00,0.00
2024-12-10 17:24:14,155,7924,70,85,5705.23,10538.01,0.00
2024-12-10 17:24:14,154,7924,70,84,5734.10,10538.08,0.00
2024-12-10 17:24:14,154,7925,70,84,5771.83,10539.00,0.00
2024-12-10 17:24:14,155,7925,71,84,5734.59,10539.01,0.00
2024-12-10 17:24:14,154,7925,70,84,5763.65,10539.08,0.00
2024-12-10 17:24:14,153,7925,70,83,5800.63,10539.08,0.00
2024-12-10 17:24:14,154,7924,70,84,5739.86,10539.29,0.00
2024-12-10 17:24:14,154,7925,70,84,5753.54,10540.00,0.00
2024-12-10 17:24:14,155,7925,70,85,5716.42,10540.01,0.00
2024-12-10 17:24:14,154,7925,69,85,5745.35,10540.08,0.00
2024-12-10 17:24:14,153,7925,68,85,5761.85,10540.24,0.00
2024-12-10 17:24:14,154,7924,69,85,5712.16,10540.36,0.00
2024-12-10 17:24:14,154,7925,69,85,5779.38,10541.00,0.00
2024-12-10 17:24:14,155,7925,69,86,5742.10,10541.01,0.00
2024-12-10 17:24:14,154,7925,68,86,5771.20,10541.08,0.00
2024-12-10 17:24:14,154,7926,68,86,5796.75,10542.00,0.00
2024-12-10 17:24:14,155,7926,69,86,5759.35,10542.01,0.00
2024-12-10 17:24:14,154,7926,69,85,5788.57,10542.08,0.00
2024-12-10 17:24:15,154,7927,69,85,5743.31,10543.00,0.00
2024-12-10 17:24:15,155,7927,69,86,5706.25,10543.01,0.00
2024-12-10 17:24:15,154,7927,69,85,5735.12,10543.08,0.00
2024-12-10 17:24:15,153,7927,68,85,5771.91,10543.08,0.00
2024-12-10 17:24:15,152,7927,67,85,5722.30,10543.75,0.00
2024-12-10 17:24:15,152,7928,67,85,5765.52,10544.00,0.00
2024-12-10 17:24:15,153,7928,67,86,5727.84,10544.01,0.00
2024-12-10 17:24:15,152,7928,66,86,5757.23,10544.08,0.00
2024-12-10 17:24:15,152,7929,66,86,5727.52,10545.00,0.00
2024-12-10 17:24:15,153,7929,66,87,5690.08,10545.01,0.00
2024-12-10 17:24:15,152,7929,65,87,5719.22,10545.08,0.00
2024-12-10 17:24:15,153,7928,66,87,5668.08,10545.22,0.00
2024-12-10 17:24:15,153,7929,66,87,5667.45,10546.00,0.00
2024-12-10 17:24:15,154,7929,67,87,5630.65,10546.01,0.00
2024-12-10 17:24:15,153,7929,66,87,5661.96,10546.05,0.00
2024-12-10 17:24:15,152,7929,65,87,5658.59,10546.34,0.00
2024-12-10 17:24:15,152,7930,65,87,5722.66,10547.00,0.00
2024-12-10 17:24:15,153,7930,65,88,5685.26,10547.01,0.00
2024-12-10 17:24:15,152,7930,64,88,5714.36,10547.08,0.00
2024-12-10 17:24:15,152,7931,64,88,5677.50,10548.00,0.00
2024-12-10 17:24:15,153,7931,65,88,5640.40,10548.01,0.00
2024-12-10 17:24:15,152,7931,65,87,5669.20,10548.08,0.00
2024-12-10 17:24:15,152,7932,65,87,5628.25,10549.00,0.00
2024-12-10 17:24:15,153,7932,65,88,5591.46,10549.01,0.00
2024-12-10 17:24:15,152,7932,64,88,5623.40,10549.05,0.00
2024-12-10 17:24:15,151,7932,64,87,5656.47,10549.08,0.00
2024-12-10 17:24:15,151,7933,64,87,5614.06,10550.00,0.00
2024-12-10 17:24:15,152,7933,64,88,5577.13,10550.01,0.00
2024-12-10 17:24:15,151,7933,64,87,5539.88,10550.58,0.00
2024-12-10 17:24:15,152,7932,65,87,5472.23,10550.84,0.00
2024-12-10 17:24:15,152,7933,65,87,5536.93,10551.00,0.00
2024-12-10 17:24:15,153,7933,66,87,5500.74,10551.01,0.00
2024-12-10 17:24:15,154,7932,66,88,5462.97,10551.04,0.00
2024-12-10 17:24:15,154,7933,66,88,5552.74,10552.00,0.00
2024-12-10 17:24:15,155,7933,66,89,5516.92,10552.01,0.00
2024-12-10 17:24:15,156,7932,67,89,5441.76,10552.40,0.00
2024-12-10 17:24:15,156,7933,67,89,5544.06,10553.00,0.00
2024-12-10 17:24:15,157,7933,68,89,5508.75,10553.01,0.00
2024-12-10 17:24:15,158,7932,69,89,5468.56,10553.07,0.00
2024-12-10 17:24:15,157,7932,69,88,5550.47,10553.11,0.00
2024-12-10 17:24:15,156,7932,68,88,5522.17,10553.62,0.00
2024-12-10 17:24:15,156,7933,68,88,5617.85,10554.00,0.00
2024-12-10 17:24:15,157,7933,69,88,5582.07,10554.01,0.00
2024-12-10 17:24:15,156,7933,68,88,5607.07,10554.10,0.00
2024-12-10 17:24:15,157,7932,68,89,5570.01,10554.13,0.00
2024-12-10 17:24:15,158,7931,68,90,5555.61,10554.55,0.00
2024-12-10 17:24:15,159,7930,69,90,5544.62,10554.65,0.00
2024-12-10 17:24:15,159,7931,69,90,5665.06,10555.00,0.00
2024-12-10 17:24:15,160,7931,69,91,5629.65,10555.01,0.00
2024-12-10 17:24:15,161,7930,69,92,5587.51,10555.09,0.00
2024-12-10 17:24:15,160,7930,69,91,5637.61,10555.11,0.00
2024-12-10 17:24:15,160,7931,69,91,5807.66,10556.00,0.00
2024-12-10 17:24:15,161,7931,69,92,5771.58,10556.01,0.00
2024-12-10 17:24:15,160,7931,69,91,5797.15,10556.10,0.00
2024-12-10 17:24:15,160,7932,69,91,5834.60,10557.00,0.00
2024-12-10 17:24:15,161,7932,69,92,5798.36,10557.01,0.00
2024-12-10 17:24:15,160,7932,69,91,5823.43,10557.11,0.00
2024-12-10 17:24:15,161,7931,70,91,5719.35,10557.76,0.00
2024-12-10 17:24:15,161,7932,70,91,5773.33,10558.00,0.00
2024-12-10 17:24:15,162,7932,71,91,5737.70,10558.01,0.00
2024-12-10 17:24:15,161,7932,70,91,5762.24,10558.11,0.00
2024-12-10 17:24:15,161,7933,70,91,5799.46,10559.00,0.00
2024-12-10 17:24:15,162,7933,71,91,5763.66,10559.01,0.00
2024-12-10 17:24:15,161,7933,70,91,5788.36,10559.11,0.00
2024-12-10 17:24:15,161,7934,70,91,5760.00,10560.00,0.00
2024-12-10 17:24:15,162,7934,71,91,5724.44,10560.01,0.00
2024-12-10 17:24:15,161,7934,71,90,5748.90,10560.11,0.00
2024-12-10 17:24:15,162,7933,72,90,5697.15,10560.27,0.00
2024-12-10 17:24:15,162,7934,72,90,5739.33,10561.00,0.00
2024-12-10 17:24:15,163,7934,73,90,5704.12,10561.01,0.00
2024-12-10 17:24:15,162,7934,72,90,5728.29,10561.10,0.00
2024-12-10 17:24:15,163,7933,72,91,5652.45,10561.50,0.00
2024-12-10 17:24:15,163,7934,72,91,5764.92,10562.00,0.00
2024-12-10 17:24:15,164,7934,73,91,5729.77,10562.01,0.00
2024-12-10 17:24:15,163,7934,72,91,5753.95,10562.10,0.00
2024-12-10 17:24:15,163,7935,72,91,5789.44,10563.00,0.00
2024-12-10 17:24:15,164,7935,72,92,5754.14,10563.01,0.00
2024-12-10 17:24:15,163,7935,72,91,5777.83,10563.11,0.00
2024-12-10 17:24:16,163,7936,72,91,5747.16,10564.00,0.00
2024-12-10 17:24:16,164,7936,72,92,5712.12,10564.01,0.00
2024-12-10 17:24:16,163,7936,71,92,5735.54,10564.11,0.00
2024-12-10 17:24:16,163,7937,71,92,5703.71,10565.00,0.00
2024-12-10 17:24:16,164,7937,72,92,5668.93,10565.01,0.00
2024-12-10 17:24:16,164,7938,72,92,5621.39,10566.00,0.00
2024-12-10 17:24:16,165,7938,72,93,5587.32,10566.01,0.00
2024-12-10 17:24:16,164,7938,72,92,5620.10,10566.01,0.00
2024-12-10 17:24:16,163,7938,72,91,5642.96,10566.12,0.00
2024-12-10 17:24:16,162,7938,72,90,5677.14,10566.12,0.00
2024-12-10 17:24:16,162,7939,72,90,5639.31,10567.00,0.00
2024-12-10 17:24:16,163,7939,73,90,5604.71,10567.01,0.00
2024-12-10 17:24:16,164,7938,73,91,5553.20,10567.18,0.00
2024-12-10 17:24:16,165,7937,73,92,5468.11,10567.73,0.00
2024-12-10 17:24:16,165,7938,73,92,5522.79,10568.00,0.00
2024-12-10 17:24:16,166,7938,73,93,5489.52,10568.01,0.00
2024-12-10 17:24:16,165,7938,72,93,5510.03,10568.12,0.00
2024-12-10 17:24:16,166,7937,72,94,5466.04,10568.24,0.00
2024-12-10 17:24:16,167,7936,73,94,5469.43,10568.43,0.00
2024-12-10 17:24:16,168,7935,74,94,5462.90,10568.58,0.00
2024-12-10 17:24:16,168,7936,74,94,5639.58,10569.00,0.00
2024-12-10 17:24:16,169,7936,75,94,5606.21,10569.01,0.00
2024-12-10 17:24:16,168,7936,74,94,5627.05,10569.12,0.00
2024-12-10 17:24:16,167,7936,74,93,5660.11,10569.12,0.00
2024-12-10 17:24:16,167,7937,74,93,5809.15,10570.00,0.00
2024-12-10 17:24:16,168,7937,75,93,5774.57,10570.01,0.00
2024-12-10 17:24:16,169,7936,75,94,5739.78,10570.02,0.00
2024-12-10 17:24:16,168,7936,75,93,5825.57,10570.09,0.00
2024-12-10 17:24:16,167,7936,74,93,5856.04,10570.13,0.00
2024-12-10 17:24:16,166,7936,74,92,5837.62,10570.57,0.00
2024-12-10 17:24:16,166,7937,74,92,5850.20,10571.00,0.00
2024-12-10 17:24:16,167,7937,74,93,5815.17,10571.01,0.00
2024-12-10 17:24:16,166,7937,73,93,5844.49,10571.05,0.00
2024-12-10 17:24:16,165,7937,72,93,5872.90,10571.12,0.00
2024-12-10 17:24:16,165,7938,72,93,5888.50,10572.00,0.00
2024-12-10 17:24:16,166,7938,73,93,5853.02,10572.01,0.00
2024-12-10 17:24:16,167,7937,74,93,5814.83,10572.05,0.00
2024-12-10 17:24:16,166,7937,73,93,5874.10,10572.13,0.00
2024-12-10 17:24:16,166,7938,73,93,5823.26,10573.00,0.00
2024-12-10 17:24:16,167,7938,74,93,5788.39,10573.01,0.00
2024-12-10 17:24:16,166,7938,74,92,5816.29,10573.07,0.00
2024-12-10 17:24:16,165,7938,73,92,5845.16,10573.12,0.00
2024-12-10 17:24:16,165,7939,73,92,5851.24,10574.00,0.00
2024-12-10 17:24:16,166,7939,74,92,5815.99,10574.01,0.00
2024-12-10 17:24:16,165,7939,74,91,5838.40,10574.12,0.00
2024-12-10 17:24:16,164,7939,73,91,5873.36,10574.12,0.00
2024-12-10 17:24:16,163,7939,72,91,5787.45,10574.96,0.00
2024-12-10 17:24:16,163,7940,72,91,5847.83,10575.00,0.00
2024-12-10 17:24:16,164,7940,73,91,5812.17,10575.01,0.00
2024-12-10 17:24:16,163,7940,72,91,5834.27,10575.13,0.00
2024-12-10 17:24:16,162,7940,72,90,5832.46,10575.35,0.00
2024-12-10 17:24:16,162,7941,72,90,5823.06,10576.00,0.00
2024-12-10 17:24:16,163,7941,73,90,5787.34,10576.01,0.00
2024-12-10 17:24:16,162,7941,73,89,5809.42,10576.13,0.00
2024-12-10 17:24:16,163,7940,74,89,5753.70,10576.33,0.00
2024-12-10 17:24:16,163,7941,74,89,5789.94,10577.00,0.00
2024-12-10 17:24:16,164,7941,75,89,5754.64,10577.01,0.00
2024-12-10 17:24:16,165,7940,75,90,5719.76,10577.02,0.00
2024-12-10 17:24:16,166,7939,75,91,5703.86,10577.17,0.00
2024-12-10 17:24:16,167,7938,76,91,5712.81,10577.35,0.00
2024-12-10 17:24:16,168,7937,77,91,5656.99,10577.94,0.00
2024-12-10 17:24:16,168,7938,77,91,5781.08,10578.00,0.00
2024-12-10 17:24:16,169,7938,77,92,5746.88,10578.01,0.00
2024-12-10 17:24:16,170,7937,77,93,5692.62,10578.21,0.00
2024-12-10 17:24:16,170,7938,77,93,5970.97,10579.00,0.00
2024-12-10 17:24:16,171,7938,77,94,5936.05,10579.01,0.00
2024-12-10 17:24:16,170,7938,77,93,5968.49,10579.02,0.00
2024-12-10 17:24:16,169,7938,77,92,5991.97,10579.13,0.00
2024-12-10 17:24:16,170,7937,77,93,5944.93,10579.25,0.00
2024-12-10 17:24:16,170,7938,77,93,6039.00,10580.00,0.00
2024-12-10 17:24:16,171,7938,77,94,6003.69,10580.01,0.00
2024-12-10 17:24:16,170,7938,77,93,6024.15,10580.14,0.00
2024-12-10 17:24:16,169,7938,76,93,6059.17,10580.14,0.00
2024-12-10 17:24:16,168,7938,76,92,6094.60,10580.14,0.00
2024-12-10 17:24:16,169,7937,76,93,5967.03,10580.98,0.00
2024-12-10 17:24:16,169,7938,76,93,6091.01,10581.00,0.00
2024-12-10 17:24:16,170,7938,77,93,6055.18,10581.01,0.00
2024-12-10 17:24:16,169,7938,77,92,6080.42,10581.10,0.00
2024-12-10 17:24:16,168,7938,76,92,6112.23,10581.14,0.00
2024-12-10 17:24:16,167,7938,75,92,6148.20,10581.14,0.00
2024-12-10 17:24:16,167,7939,75,92,6180.38,10582.00,0.00
2024-12-10 17:24:16,168,7939,76,92,6143.60,10582.01,0.00
2024-12-10 17:24:16,169,7938,77,92,6044.27,10582.62,0.00
2024-12-10 17:24:16,169,7939,77,92,6089.45,10583.00,0.00
2024-12-10 17:24:16,170,7939,77,93,6053.63,10583.01,0.00
2024-12-10 17:24:16,169,7939,76,93,6074.50,10583.14,0.00
2024-12-10 17:24:16,169,7940,76,93,6106.76,10584.00,0.00
2024-12-10 17:24:16,170,7940,76,94,6070.84,10584.01,0.00
2024-12-10 17:24:16,169,7940,76,93,6091.81,10584.14,0.00
2024-12-10 17:24:16,170,7939,77,93,6001.36,10584.62,0.00
2024-12-10 17:24:16,171,7938,78,93,5967.66,10584.84,0.00
2024-12-10 17:24:16,171,7939,78,93,6021.66,10585.00,0.00
2024-12-10 17:24:17,172,7939,79,93,5986.65,10585.01,0.00
2024-12-10 17:24:17,172,7940,79,93,6060.90,10586.00,0.00
2024-12-10 17:24:17,173,7940,79,94,6025.86,10586.01,0.00
2024-12-10 17:24:17,172,7940,78,94,6045.59,10586.15,0.00
2024-12-10 17:24:17,171,7940,77,94,6057.44,10586.36,0.00
2024-12-10 17:24:17,171,7941,77,94,6046.96,10587.00,0.00
2024-12-10 17:24:17,172,7941,77,95,6011.80,10587.01,0.00
2024-12-10 17:24:17,171,7941,77,94,6038.33,10587.08,0.00
2024-12-10 17:24:17,170,7941,76,94,6067.04,10587.14,0.00
2024-12-10 17:24:17,169,7941,76,93,6102.31,10587.14,0.00
2024-12-10 17:24:17,169,7942,76,93,6068.57,10588.00,0.00
2024-12-10 17:24:17,170,7942,76,94,6032.88,10588.01,0.00
2024-12-10 17:24:17,169,7942,75,94,6053.62,10588.14,0.00
2024-12-10 17:24:17,168,7942,74,94,6013.37,10588.81,0.00
2024-12-10 17:24:17,168,7943,74,94,6056.40,10589.00,0.00
2024-12-10 17:24:17,169,7943,75,94,6020.56,10589.01,0.00
2024-12-10 17:24:17,168,7943,75,93,6041.35,10589.14,0.00
2024-12-10 17:24:17,168,7944,75,93,6009.58,10590.00,0.00
2024-12-10 17:24:17,169,7944,75,94,5974.02,10590.01,0.00
2024-12-10 17:24:17,170,7943,75,95,5927.72,10590.12,0.00
2024-12-10 17:24:17,169,7943,75,94,5992.27,10590.15,0.00
2024-12-10 17:24:17,169,7944,75,94,5958.21,10591.00,0.00
2024-12-10 17:24:17,170,7944,76,94,5923.16,10591.01,0.00
2024-12-10 17:24:17,169,7944,75,94,5948.85,10591.09,0.00
2024-12-10 17:24:17,168,7944,74,94,5978.62,10591.14,0.00
2024-12-10 17:24:17,167,7944,74,93,6013.79,10591.14,0.00
2024-12-10 17:24:17,168,7943,74,94,5908.12,10591.70,0.00
2024-12-10 17:24:17,168,7944,74,94,6022.49,10592.00,0.00
2024-12-10 17:24:17,169,7944,74,95,5986.85,10592.01,0.00
2024-12-10 17:24:17,170,7943,75,95,5942.96,10592.10,0.00
2024-12-10 17:24:17,169,7943,74,95,5987.56,10592.15,0.00
2024-12-10 17:24:17,168,7943,74,94,5981.30,10592.45,0.00
2024-12-10 17:24:17,168,7944,74,94,6044.22,10593.00,0.00
2024-12-10 17:24:17,169,7944,75,94,6008.45,10593.01,0.00
2024-12-10 17:24:17,168,7944,75,93,6029.17,10593.14,0.00
2024-12-10 17:24:17,168,7945,75,93,6057.65,10594.00,0.00
2024-12-10 17:24:17,169,7945,75,94,6021.81,10594.01,0.00
2024-12-10 17:24:17,170,7944,76,94,5978.95,10594.09,0.00
2024-12-10 17:24:17,169,7944,76,93,6040.70,10594.15,0.00
2024-12-10 17:24:17,169,7945,76,93,6006.10,10595.00,0.00
2024-12-10 17:24:17,170,7945,77,93,5970.77,10595.01,0.00
2024-12-10 17:24:17,169,7945,77,92,5990.51,10595.15,0.00
2024-12-10 17:24:17,168,7945,77,91,5983.87,10595.48,0.00
2024-12-10 17:24:17,168,7946,77,91,6051.64,10596.00,0.00
2024-12-10 17:24:17,169,7946,77,92,6015.84,10596.01,0.00
2024-12-10 17:24:17,168,7946,76,92,6035.96,10596.15,0.00
2024-12-10 17:24:17,168,7947,76,92,5998.32,10597.00,0.00
2024-12-10 17:24:17,169,7947,77,92,5962.83,10597.01,0.00
2024-12-10 17:24:17,168,7947,77,91,5982.63,10597.15,0.00
2024-12-10 17:24:17,168,7948,77,91,5937.33,10598.00,0.00
2024-12-10 17:24:17,169,7948,78,91,5902.20,10598.01,0.00
2024-12-10 17:24:17,168,7948,78,90,5921.64,10598.15,0.00
2024-12-10 17:24:17,168,7949,78,90,5867.29,10599.00,0.00
2024-12-10 17:24:17,169,7949,78,91,5832.57,10599.01,0.00
2024-12-10 17:24:17,168,7949,78,90,5775.34,10599.68,0.00
2024-12-10 17:24:17,168,7950,78,90,5804.62,10600.00,0.00
2024-12-10 17:24:17,169,7950,79,90,5770.28,10600.01,0.00
2024-12-10 17:24:17,168,7950,78,90,5788.30,10600.15,0.00
2024-12-10 17:24:17,167,7950,78,89,5760.20,10600.62,0.00
2024-12-10 17:24:17,167,7951,78,89,5783.35,10601.00,0.00
2024-12-10 17:24:17,168,7951,78,90,5748.92,10601.01,0.00
2024-12-10 17:24:17,167,7951,77,90,5766.92,10601.16,0.00
2024-12-10 17:24:17,166,7951,77,89,5750.52,10601.52,0.00
2024-12-10 17:24:17,167,7950,77,90,5700.30,10601.68,0.00
2024-12-10 17:24:17,167,7951,77,90,5751.36,10602.00,0.00
2024-12-10 17:24:17,168,7951,77,91,5717.12,10602.01,0.00
2024-12-10 17:24:17,167,7951,76,91,5746.64,10602.05,0.00
2024-12-10 17:24:17,166,7951,76,90,5735.53,10602.48,0.00
2024-12-10 17:24:17,166,7952,76,90,5808.07,10603.00,0.00
2024-12-10 17:24:17,167,7952,77,90,5773.30,10603.01,0.00
2024-12-10 17:24:17,168,7951,78,90,5693.48,10603.45,0.00
2024-12-10 17:24:17,168,7952,78,90,5738.05,10604.00,0.00
2024-12-10 17:24:17,169,7952,78,91,5704.10,10604.01,0.00
2024-12-10 17:24:17,169,7953,78,91,5724.68,10605.00,0.00
2024-12-10 17:24:17,170,7953,78,92,5691.01,10605.01,0.00
2024-12-10 17:24:17,169,7953,77,92,5720.93,10605.04,0.00
2024-12-10 17:24:17,168,7953,77,91,5741.79,10605.15,0.00
2024-12-10 17:24:17,167,7953,76,91,5775.54,10605.16,0.00
2024-12-10 17:24:18,167,7954,76,91,5749.96,10606.00,0.00
2024-12-10 17:24:18,168,7954,77,91,5715.74,10606.01,0.00
2024-12-10 17:24:18,167,7954,77,90,5730.09,10606.19,0.00
2024-12-10 17:24:18,168,7953,77,91,5637.51,10606.76,0.00
2024-12-10 17:24:18,168,7954,77,91,5692.65,10607.00,0.00
2024-12-10 17:24:18,169,7954,78,91,5658.96,10607.01,0.00
2024-12-10 17:24:18,168,7954,77,91,5690.13,10607.02,0.00
2024-12-10 17:24:18,167,7954,77,90,5709.67,10607.16,0.00
2024-12-10 17:24:18,166,7954,76,90,5743.43,10607.16,0.00
2024-12-10 17:24:18,166,7955,76,90,5781.88,10608.00,0.00
2024-12-10 17:24:18,167,7955,77,90,5747.25,10608.01,0.00
2024-12-10 17:24:18,166,7955,77,89,5765.78,10608.16,0.00
2024-12-10 17:24:18,167,7954,77,90,5706.40,10608.40,0.00
2024-12-10 17:24:18,167,7955,77,90,5708.83,10609.00,0.00
2024-12-10 17:24:18,168,7955,78,90,5674.84,10609.01,0.00
2024-12-10 17:24:18,167,7955,77,90,5692.39,10609.16,0.00
2024-12-10 17:24:18,166,7955,76,90,5726.04,10609.16,0.00
2024-12-10 17:24:18,166,7956,76,90,5764.70,10610.00,0.00
2024-12-10 17:24:18,167,7956,77,90,5730.18,10610.01,0.00
2024-12-10 17:24:18,167,7957,77,90,5688.61,10611.00,0.00
2024-12-10 17:24:18,168,7957,77,91,5654.75,10611.01,0.00
2024-12-10 17:24:18,167,7957,76,91,5672.17,10611.16,0.00
2024-12-10 17:24:18,167,7958,76,91,5646.49,10612.00,0.00
2024-12-10 17:24:18,168,7958,77,91,5612.88,10612.01,0.00
2024-12-10 17:24:18,167,7958,77,90,5630.05,10612.16,0.00
2024-12-10 17:24:18,167,7959,77,90,5604.45,10613.00,0.00
2024-12-10 17:24:18,168,7959,77,91,5571.09,10613.01,0.00
2024-12-10 17:24:18,167,7959,77,90,5588.00,10613.16,0.00
2024-12-10 17:24:18,167,7960,77,90,5562.39,10614.00,0.00
2024-12-10 17:24:18,168,7960,78,90,5529.28,10614.01,0.00
2024-12-10 17:24:18,167,7960,78,89,5545.94,10614.16,0.00
2024-12-10 17:24:18,167,7961,78,89,5520.33,10615.00,0.00
2024-12-10 17:24:18,168,7961,79,89,5487.47,10615.01,0.00
2024-12-10 17:24:18,169,7960,80,89,5448.75,10615.08,0.00
2024-12-10 17:24:18,168,7960,80,88,5523.56,10615.16,0.00
2024-12-10 17:24:18,169,7959,81,88,5481.46,10615.26,0.00
2024-12-10 17:24:18,169,7960,81,88,5520.09,10616.00,0.00
2024-12-10 17:24:18,170,7960,82,88,5487.62,10616.01,0.00
2024-12-10 17:24:18,171,7959,83,88,5361.92,10616.89,0.00
2024-12-10 17:24:18,171,7960,83,88,5544.78,10617.00,0.00
2024-12-10 17:24:18,172,7960,84,88,5512.54,10617.01,0.00
2024-12-10 17:24:18,173,7959,85,88,5475.18,10617.07,0.00
2024-12-10 17:24:18,172,7959,85,87,5510.15,10617.16,0.00
2024-12-10 17:24:18,172,7960,85,87,5540.94,10618.00,0.00
2024-12-10 17:24:18,173,7960,86,87,5508.91,10618.01,0.00
2024-12-10 17:24:18,172,7960,86,86,5528.03,10618.12,0.00
2024-12-10 17:24:18,171,7960,85,86,5556.65,10618.15,0.00
2024-12-10 17:24:18,172,7959,85,87,5451.77,10618.82,0.00
2024-12-10 17:24:18,172,7960,85,87,5566.77,10619.00,0.00
2024-12-10 17:24:18,173,7960,86,87,5534.59,10619.01,0.00
2024-12-10 17:24:18,172,7960,86,86,5550.79,10619.15,0.00
2024-12-10 17:24:18,171,7960,86,85,5582.63,10619.15,0.00
2024-12-10 17:24:18,170,7960,86,84,5614.84,10619.15,0.00
2024-12-10 17:24:18,170,7961,86,84,5645.48,10620.00,0.00
2024-12-10 17:24:18,171,7961,86,85,5612.47,10620.01,0.00
2024-12-10 17:24:18,170,7961,86,84,5629.31,10620.15,0.00
2024-12-10 17:24:18,170,7962,86,84,5600.60,10621.00,0.00
2024-12-10 17:24:18,171,7962,86,85,5567.84,10621.01,0.00
2024-12-10 17:24:18,172,7961,86,86,5469.63,10621.64,0.00
2024-12-10 17:24:18,172,7962,86,86,5516.59,10622.00,0.00
2024-12-10 17:24:18,173,7962,86,87,5484.71,10622.01,0.00
2024-12-10 17:24:18,172,7962,86,86,5499.99,10622.16,0.00
2024-12-10 17:24:18,172,7963,86,86,5532.62,10623.00,0.00
2024-12-10 17:24:18,173,7963,86,87,5500.64,10623.01,0.00
2024-12-10 17:24:18,172,7963,86,86,5516.01,10623.16,0.00
2024-12-10 17:24:18,173,7962,86,87,5424.17,10623.73,0.00
2024-12-10 17:24:18,173,7963,86,87,5474.99,10624.00,0.00
2024-12-10 17:24:18,174,7963,87,87,5443.53,10624.01,0.00
2024-12-10 17:24:18,173,7963,87,86,5458.47,10624.16,0.00
2024-12-10 17:24:18,172,7963,87,85,5489.59,10624.16,0.00
2024-12-10 17:24:18,172,7964,87,85,5520.03,10625.00,0.00
2024-12-10 17:24:18,173,7964,87,86,5488.13,10625.01,0.00
2024-12-10 17:24:18,174,7963,88,86,5431.01,10625.26,0.00
2024-12-10 17:24:18,174,7964,88,86,5446.00,10626.00,0.00
2024-12-10 17:24:18,175,7964,88,87,5414.88,10626.01,0.00
2024-12-10 17:24:18,174,7964,87,87,5429.57,10626.16,0.00
2024-12-10 17:24:18,175,7963,88,87,5370.78,10626.42,0.00
2024-12-10 17:24:18,175,7964,88,87,5467.92,10627.00,0.00
2024-12-10 17:24:18,176,7964,89,87,5436.85,10627.01,0.00
2024-12-10 17:24:18,175,7964,88,87,5451.58,10627.15,0.00
2024-12-10 17:24:18,174,7964,88,86,5482.30,10627.16,0.00
2024-12-10 17:24:18,175,7963,88,87,5397.72,10627.67,0.00
2024-12-10 17:24:18,176,7962,88,88,5361.44,10627.92,0.00
2024-12-10 17:24:19,176,7963,88,88,5479.27,10628.00,0.00
2024-12-10 17:24:19,177,7963,88,89,5448.31,10628.01,0.00
2024-12-10 17:24:19,176,7963,88,88,5471.45,10628.07,0.00
2024-12-10 17:24:19,175,7963,88,87,5493.64,10628.15,0.00
2024-12-10 17:24:19,175,7964,88,87,5582.10,10629.00,0.00
2024-12-10 17:24:19,176,7964,89,87,5550.38,10629.01,0.00
2024-12-10 17:24:19,175,7964,88,87,5565.76,10629.15,0.00
2024-12-10 17:24:19,175,7965,88,87,5532.96,10630.00,0.00
2024-12-10 17:24:19,176,7965,89,87,5501.53,10630.01,0.00
2024-12-10 17:24:19,175,7965,88,87,5516.62,10630.15,0.00
2024-12-10 17:24:19,175,7966,88,87,5480.07,10631.00,0.00
2024-12-10 17:24:19,176,7966,89,87,5448.94,10631.01,0.00
2024-12-10 17:24:19,175,7966,89,86,5475.83,10631.04,0.00
2024-12-10 17:24:19,174,7966,89,85,5495.13,10631.15,0.00
2024-12-10 17:24:19,173,7966,89,84,5526.28,10631.15,0.00
2024-12-10 17:24:19,173,7967,89,84,5488.35,10632.00,0.00
2024-12-10 17:24:19,174,7967,90,84,5456.81,10632.01,0.00
2024-12-10 17:24:19,173,7967,89,84,5472.43,10632.15,0.00
2024-12-10 17:24:19,172,7967,89,83,5492.21,10632.26,0.00
2024-12-10 17:24:19,171,7967,89,82,5510.67,10632.35,0.00
2024-12-10 17:24:19,171,7968,89,82,5501.43,10633.00,0.00
2024-12-10 17:24:19,172,7968,89,83,5469.44,10633.01,0.00
2024-12-10 17:24:19,172,7969,89,83,5423.00,10634.00,0.00
2024-12-10 17:24:19,173,7969,89,84,5391.65,10634.01,0.00
2024-12-10 17:24:19,172,7969,89,83,5405.75,10634.16,0.00
2024-12-10 17:24:19,172,7970,89,83,5375.47,10635.00,0.00
2024-12-10 17:24:19,173,7970,89,84,5344.40,10635.01,0.00
2024-12-10 17:24:19,172,7970,88,84,5358.22,10635.16,0.00
2024-12-10 17:24:19,171,7970,87,84,5388.93,10635.16,0.00
2024-12-10 17:24:19,171,7971,87,84,5358.42,10636.00,0.00
2024-12-10 17:24:19,172,7971,88,84,5327.26,10636.01,0.00
2024-12-10 17:24:19,171,7971,87,84,5341.05,10636.16,0.00
2024-12-10 17:24:19,172,7970,88,84,5307.53,10636.20,0.00
2024-12-10 17:24:19,172,7971,88,84,5299.33,10637.00,0.00
2024-12-10 17:24:19,173,7971,88,85,5268.70,10637.01,0.00
2024-12-10 17:24:19,172,7971,87,85,5281.46,10637.17,0.00
2024-12-10 17:24:19,171,7971,87,84,5311.72,10637.17,0.00
2024-12-10 17:24:19,172,7970,87,85,5216.46,10637.73,0.00
2024-12-10 17:24:19,172,7971,87,85,5349.68,10638.00,0.00
2024-12-10 17:24:19,173,7971,87,86,5318.76,10638.01,0.00
2024-12-10 17:24:19,172,7971,86,86,5331.80,10638.17,0.00
2024-12-10 17:24:19,171,7971,85,86,5341.53,10638.32,0.00
2024-12-10 17:24:19,171,7972,85,86,5381.35,10639.00,0.00
2024-12-10 17:24:19,172,7972,85,87,5350.06,10639.01,0.00
2024-12-10 17:24:19,171,7972,85,86,5362.75,10639.18,0.00
2024-12-10 17:24:19,172,7971,85,87,5274.58,10639.70,0.00
2024-12-10 17:24:19,172,7972,85,87,5316.92,10640.00,0.00
2024-12-10 17:24:19,173,7972,86,87,5286.19,10640.01,0.00
2024-12-10 17:24:19,172,7972,85,87,5298.42,10640.17,0.00
2024-12-10 17:24:19,172,7973,85,87,5326.45,10641.00,0.00
2024-12-10 17:24:19,173,7973,86,87,5295.66,10641.01,0.00
2024-12-10 17:24:19,174,7972,86,88,5260.34,10641.06,0.00
2024-12-10 17:24:19,173,7972,86,87,5292.03,10641.18,0.00
2024-12-10 17:24:19,173,7973,86,87,5261.73,10642.00,0.00
2024-12-10 17:24:19,174,7973,87,87,5231.49,10642.01,0.00
2024-12-10 17:24:19,175,7972,88,87,5157.31,10642.43,0.00
2024-12-10 17:24:19,175,7973,88,87,5253.65,10643.00,0.00
2024-12-10 17:24:19,176,7973,89,87,5223.80,10643.01,0.00
2024-12-10 17:24:19,175,7973,89,86,5234.85,10643.18,0.00
2024-12-10 17:24:19,175,7974,89,86,5263.67,10644.00,0.00
2024-12-10 17:24:19,176,7974,89,87,5233.77,10644.01,0.00
2024-12-10 17:24:19,176,7975,89,87,5181.14,10645.00,0.00
2024-12-10 17:24:19,177,7975,89,88,5151.87,10645.01,0.00
2024-12-10 17:24:19,178,7974,89,89,5121.14,10645.03,0.00
2024-12-10 17:24:19,177,7974,88,89,5191.05,10645.05,0.00
2024-12-10 17:24:19,176,7974,87,89,5208.61,10645.14,0.00
2024-12-10 17:24:19,175,7974,86,89,5233.52,10645.18,0.00
2024-12-10 17:24:19,174,7974,85,89,5195.40,10645.76,0.00
2024-12-10 17:24:19,174,7975,85,89,5230.23,10646.00,0.00
2024-12-10 17:24:19,175,7975,86,89,5200.34,10646.01,0.00
2024-12-10 17:24:19,174,7975,85,89,5211.93,10646.17,0.00
2024-12-10 17:24:19,175,7974,85,90,5153.01,10646.46,0.00
2024-12-10 17:24:19,175,7975,85,90,5247.84,10647.00,0.00
2024-12-10 17:24:19,176,7975,85,91,5218.02,10647.01,0.00
2024-12-10 17:24:19,176,7976,85,91,5221.96,10648.00,0.00
2024-12-10 17:24:19,177,7976,86,91,5192.46,10648.01,0.00
2024-12-10 17:24:19,178,7975,87,91,5150.16,10648.14,0.00
2024-12-10 17:24:19,177,7975,86,91,5194.32,10648.17,0.00
2024-12-10 17:24:19,177,7976,86,91,5154.55,10649.00,0.00
2024-12-10 17:24:19,178,7976,86,92,5125.60,10649.01,0.00
2024-12-10 17:24:19,179,7975,87,92,5042.38,10649.53,0.00
2024-12-10 17:24:20,179,7976,87,92,5113.98,10650.00,0.00
2024-12-10 17:24:20,180,7976,88,92,5085.57,10650.01,0.00
2024-12-10 17:24:20,179,7976,88,91,5099.74,10650.13,0.00
2024-12-10 17:24:20,178,7976,88,90,5124.81,10650.16,0.00
2024-12-10 17:24:20,177,7976,87,90,5153.16,10650.16,0.00
2024-12-10 17:24:20,176,7976,86,90,5131.42,10650.62,0.00
2024-12-10 17:24:20,176,7977,86,90,5202.53,10651.00,0.00
2024-12-10 17:24:20,177,7977,87,90,5173.14,10651.01,0.00
2024-12-10 17:24:20,176,7977,87,89,5200.72,10651.02,0.00
2024-12-10 17:24:20,175,7977,86,89,5214.66,10651.16,0.00
2024-12-10 17:24:20,174,7977,86,88,5244.02,10651.16,0.00
2024-12-10 17:24:20,174,7978,86,88,5199.49,10652.00,0.00
2024-12-10 17:24:20,175,7978,87,88,5169.78,10652.01,0.00
2024-12-10 17:24:20,174,7978,86,88,5190.95,10652.08,0.00
2024-12-10 17:24:20,173,7978,86,87,5212.36,10652.16,0.00
2024-12-10 17:24:20,172,7978,85,87,5242.04,10652.16,0.00
2024-12-10 17:24:20,173,7977,86,87,5188.39,10652.39,0.00
2024-12-10 17:24:20,172,7977,86,86,5175.14,10652.88,0.00
2024-12-10 17:24:20,172,7978,86,86,5224.18,10653.00,0.00
2024-12-10 17:24:20,173,7978,86,87,5193.98,10653.01,0.00
2024-12-10 17:24:20,172,7978,85,87,5221.71,10653.02,0.00
2024-12-10 17:24:20,171,7978,84,87,5237.95,10653.15,0.00
2024-12-10 17:24:20,170,7978,83,87,5268.14,10653.15,0.00
2024-12-10 17:24:20,170,7979,83,87,5299.96,10654.00,0.00
2024-12-10 17:24:20,171,7979,83,88,5268.96,10654.01,0.00
2024-12-10 17:24:20,170,7979,83,87,5296.83,10654.03,0.00
2024-12-10 17:24:20,169,7979,83,86,5320.63,10654.09,0.00
2024-12-10 17:24:20,168,7979,83,85,5351.03,10654.10,0.00
2024-12-10 17:24:20,167,7979,82,85,5378.63,10654.14,0.00
2024-12-10 17:24:20,166,7979,82,84,5410.39,10654.14,0.00
2024-12-10 17:24:20,165,7979,82,83,5442.53,10654.14,0.00
2024-12-10 17:24:20,164,7979,81,83,5475.07,10654.14,0.00
2024-12-10 17:24:20,165,7978,82,83,5430.93,10654.25,0.00
2024-12-10 17:24:20,165,7979,82,83,5461.96,10655.00,0.00
2024-12-10 17:24:20,166,7979,82,84,5429.06,10655.01,0.00
2024-12-10 17:24:20,165,7979,81,84,5459.38,10655.02,0.00
2024-12-10 17:24:20,166,7978,82,84,5420.10,10655.10,0.00
2024-12-10 17:24:20,165,7978,82,83,5497.53,10655.14,0.00
2024-12-10 17:24:20,164,7978,82,82,5530.40,10655.14,0.00
2024-12-10 17:24:20,165,7977,83,82,5429.06,10655.78,0.00
2024-12-10 17:24:20,165,7978,83,82,5550.53,10656.00,0.00
2024-12-10 17:24:20,166,7978,83,83,5517.09,10656.01,0.00
2024-12-10 17:24:20,167,7977,84,83,5426.63,10656.54,0.00
2024-12-10 17:24:20,167,7978,84,83,5579.62,10657.00,0.00
2024-12-10 17:24:20,168,7978,85,83,5546.41,10657.01,0.00
2024-12-10 17:24:20,167,7978,85,82,5568.81,10657.10,0.00
2024-12-10 17:24:20,167,7979,85,82,5600.03,10658.00,0.00
2024-12-10 17:24:20,168,7979,85,83,5566.70,10658.01,0.00
2024-12-10 17:24:20,168,7980,85,83,5523.81,10659.00,0.00
2024-12-10 17:24:20,169,7980,86,83,5491.13,10659.01,0.00
2024-12-10 17:24:20,169,7981,86,83,5448.19,10660.00,0.00
2024-12-10 17:24:20,170,7981,86,84,5416.14,10660.01,0.00
2024-12-10 17:24:20,169,7981,86,83,5443.79,10660.04,0.00
2024-12-10 17:24:20,168,7981,85,83,5466.07,10660.13,0.00
2024-12-10 17:24:20,167,7981,84,83,5498.17,10660.13,0.00
2024-12-10 17:24:20,167,7982,84,83,5469.67,10661.00,0.00
2024-12-10 17:24:20,168,7982,85,83,5437.11,10661.01,0.00
2024-12-10 17:24:20,167,7982,85,82,5460.76,10661.08,0.00
2024-12-10 17:24:20,166,7982,84,82,5488.54,10661.13,0.00
2024-12-10 17:24:20,165,7982,84,81,5521.16,10661.13,0.00
2024-12-10 17:24:20,166,7981,85,81,5476.36,10661.25,0.00
2024-12-10 17:24:20,167,7980,85,82,5405.47,10661.72,0.00
2024-12-10 17:24:20,167,7981,85,82,5443.37,10662.00,0.00
2024-12-10 17:24:20,168,7981,86,82,5410.97,10662.01,0.00
2024-12-10 17:24:20,169,7980,87,82,5377.06,10662.04,0.00
2024-12-10 17:24:20,168,7980,86,82,5411.02,10662.13,0.00
2024-12-10 17:24:20,168,7981,86,82,5509.22,10663.00,0.00
2024-12-10 17:24:20,169,7981,86,83,5476.62,10663.01,0.00
2024-12-10 17:24:20,168,7981,86,82,5495.94,10663.13,0.00
2024-12-10 17:24:20,168,7982,86,82,5530.05,10664.00,0.00
2024-12-10 17:24:20,169,7982,87,82,5497.33,10664.01,0.00
2024-12-10 17:24:20,170,7981,88,82,5451.24,10664.15,0.00
2024-12-10 17:24:20,170,7982,88,82,5483.70,10665.00,0.00
2024-12-10 17:24:20,171,7982,88,83,5451.63,10665.01,0.00
2024-12-10 17:24:20,170,7982,87,83,5470.57,10665.12,0.00
2024-12-10 17:24:20,171,7981,87,84,5415.55,10665.35,0.00
2024-12-10 17:24:20,171,7982,87,84,5519.50,10666.00,0.00
2024-12-10 17:24:20,172,7982,87,85,5487.41,10666.01,0.00
2024-12-10 17:24:20,173,7981,87,86,5452.62,10666.05,0.00
2024-12-10 17:24:20,173,7982,87,86,5519.71,10667.00,0.00
2024-12-10 17:24:20,174,7982,87,87,5487.99,10667.01,0.00
2024-12-10 17:24:20,173,7982,87,86,5505.59,10667.13,0.00
2024-12-10 17:24:20,172,7982,87,85,5536.97,10667.13,0.00
2024-12-10 17:24:20,173,7981,88,85,5498.19,10667.21,0.00
2024-12-10 17:24:20,173,7982,88,85,5540.58,10668.00,0.00
2024-12-10 17:24:20,174,7982,88,86,5508.74,10668.01,0.00
2024-12-10 17:24:20,173,7982,88,85,5535.67,10668.05,0.00
2024-12-10 17:24:20,174,7981,88,86,5502.01,10668.08,0.00
2024-12-10 17:24:20,173,7981,88,85,5582.57,10668.14,0.00
2024-12-10 17:24:20,173,7982,88,85,5614.49,10669.00,0.00
2024-12-10 17:24:20,174,7982,88,86,5582.22,10669.01,0.00
2024-12-10 17:24:20,174,7983,88,86,5599.30,10670.00,0.00
2024-12-10 17:24:20,175,7983,89,86,5567.30,10670.01,0.00
2024-12-10 17:24:20,174,7983,89,85,5598.07,10670.01,0.00
2024-12-10 17:24:20,173,7983,88,85,5616.92,10670.13,0.00
2024-12-10 17:24:20,172,7983,88,84,5648.96,10670.13,0.00
2024-12-10 17:24:21,172,7984,88,84,5619.03,10671.00,0.00
2024-12-10 17:24:21,173,7984,88,85,5586.55,10671.01,0.00
2024-12-10 17:24:21,172,7984,88,84,5604.82,10671.13,0.00
2024-12-10 17:24:21,173,7983,89,84,5559.49,10671.27,0.00
2024-12-10 17:24:21,173,7984,89,84,5596.94,10672.00,0.00
2024-12-10 17:24:21,174,7984,90,84,5564.78,10672.01,0.00
2024-12-10 17:24:21,173,7984,89,84,5582.81,10672.13,0.00
2024-12-10 17:24:21,172,7984,88,84,5614.65,10672.13,0.00
2024-12-10 17:24:21,172,7985,88,84,5646.40,10673.00,0.00
2024-12-10 17:24:21,173,7985,88,85,5613.77,10673.01,0.00
2024-12-10 17:24:21,172,7985,87,85,5632.19,10673.13,0.00
2024-12-10 17:24:21,172,7986,87,85,5601.42,10674.00,0.00
2024-12-10 17:24:21,173,7986,88,85,5569.04,10674.01,0.00
2024-12-10 17:24:21,172,7986,87,85,5587.20,10674.13,0.00
2024-12-10 17:24:21,172,7987,87,85,5556.18,10675.00,0.00
2024-12-10 17:24:21,173,7987,88,85,5524.06,10675.01,0.00
2024-12-10 17:24:21,172,7987,87,85,5541.96,10675.13,0.00
2024-12-10 17:24:21,172,7988,87,85,5510.71,10676.00,0.00
2024-12-10 17:24:21,173,7988,87,86,5478.86,10676.01,0.00
2024-12-10 17:24:21,172,7988,87,85,5501.13,10676.09,0.00
2024-12-10 17:24:21,171,7988,86,85,5528.32,10676.13,0.00
2024-12-10 17:24:21,171,7989,86,85,5497.54,10677.00,0.00
2024-12-10 17:24:21,172,7989,87,85,5465.58,10677.01,0.00
2024-12-10 17:24:21,171,7989,86,85,5496.91,10677.01,0.00
2024-12-10 17:24:21,170,7989,86,84,5525.50,10677.04,0.00
2024-12-10 17:24:21,169,7989,85,84,5548.13,10677.12,0.00
2024-12-10 17:24:21,168,7989,85,83,5580.52,10677.13,0.00
2024-12-10 17:24:21,167,7989,85,82,5613.29,10677.13,0.00
2024-12-10 17:24:21,168,7988,86,82,5517.20,10677.71,0.00
2024-12-10 17:24:21,168,7989,86,82,5570.19,10678.00,0.00
2024-12-10 17:24:21,169,7989,87,82,5537.24,10678.01,0.00
2024-12-10 17:24:21,168,7989,87,81,5566.40,10678.04,0.00
2024-12-10 17:24:21,167,7989,87,80,5588.91,10678.13,0.00
2024-12-10 17:24:21,166,7989,87,79,5621.93,10678.13,0.00
2024-12-10 17:24:21,166,7990,87,79,5657.44,10679.00,0.00
2024-12-10 17:24:21,167,7990,88,79,5623.57,10679.01,0.00
2024-12-10 17:24:21,166,7990,87,79,5653.60,10679.04,0.00
2024-12-10 17:24:21,165,7990,87,78,5676.91,10679.13,0.00
2024-12-10 17:24:21,165,7991,87,78,5648.85,10680.00,0.00
2024-12-10 17:24:21,166,7991,88,78,5614.82,10680.01,0.00
2024-12-10 17:24:21,165,7991,88,77,5634.68,10680.13,0.00
2024-12-10 17:24:21,164,7991,88,76,5668.39,10680.13,0.00
2024-12-10 17:24:21,164,7992,88,76,5641.21,10681.00,0.00
2024-12-10 17:24:21,165,7992,88,77,5607.02,10681.01,0.00
2024-12-10 17:24:21,164,7992,87,77,5626.94,10681.13,0.00
2024-12-10 17:24:21,164,7993,87,77,5600.05,10682.00,0.00
2024-12-10 17:24:21,165,7993,88,77,5566.11,10682.01,0.00
2024-12-10 17:24:21,164,7993,87,77,5592.92,10682.07,0.00
2024-12-10 17:24:21,163,7993,86,77,5620.05,10682.13,0.00
2024-12-10 17:24:21,162,7993,85,77,5654.09,10682.13,0.00
2024-12-10 17:24:21,163,7992,85,78,5556.06,10682.74,0.00
2024-12-10 17:24:21,163,7993,85,78,5612.65,10683.00,0.00
2024-12-10 17:24:21,164,7993,86,78,5578.43,10683.01,0.00
2024-12-10 17:24:21,164,7994,86,78,5603.05,10684.00,0.00
2024-12-10 17:24:21,165,7994,86,79,5569.09,10684.01,0.00
2024-12-10 17:24:21,164,7994,86,78,5593.32,10684.09,0.00
2024-12-10 17:24:21,163,7994,86,77,5623.07,10684.13,0.00
2024-12-10 17:24:21,162,7994,85,77,5657.13,10684.13,0.00
2024-12-10 17:24:21,161,7994,84,77,5691.60,10684.13,0.00
2024-12-10 17:24:21,160,7994,84,76,5707.06,10684.32,0.00
2024-12-10 17:24:21,160,7995,84,76,5701.47,10685.00,0.00
2024-12-10 17:24:21,161,7995,85,76,5666.06,10685.01,0.00
2024-12-10 17:24:21,160,7995,84,76,5677.37,10685.23,0.00
2024-12-10 17:24:21,160,7996,84,76,5662.46,10686.00,0.00
2024-12-10 17:24:21,161,7996,85,76,5627.29,10686.01,0.00
2024-12-10 17:24:21,160,7996,85,75,5647.83,10686.14,0.00
2024-12-10 17:24:21,161,7995,85,76,5590.23,10686.36,0.00
2024-12-10 17:24:21,161,7996,85,76,5635.12,10687.00,0.00
2024-12-10 17:24:21,162,7996,85,77,5600.33,10687.01,0.00
2024-12-10 17:24:21,162,7997,85,77,5626.59,10688.00,0.00
2024-12-10 17:24:21,163,7997,85,78,5592.07,10688.01,0.00
2024-12-10 17:24:21,162,7997,85,77,5611.48,10688.14,0.00
2024-12-10 17:24:21,163,7996,85,78,5541.73,10688.48,0.00
2024-12-10 17:24:21,163,7997,85,78,5591.28,10689.00,0.00
2024-12-10 17:24:21,164,7997,85,79,5557.19,10689.01,0.00
2024-12-10 17:24:21,163,7997,84,79,5576.26,10689.14,0.00
2024-12-10 17:24:21,163,7998,84,79,5616.07,10690.00,0.00
2024-12-10 17:24:21,164,7998,85,79,5581.82,10690.01,0.00
2024-12-10 17:24:21,163,7998,85,78,5612.80,10690.03,0.00
2024-12-10 17:24:21,164,7997,85,79,5567.55,10690.15,0.00
2024-12-10 17:24:21,163,7997,85,78,5627.29,10690.15,0.00
2024-12-10 17:24:21,163,7998,85,78,5602.16,10691.00,0.00
2024-12-10 17:24:21,164,7998,85,79,5568.00,10691.01,0.00
2024-12-10 17:24:21,163,7998,84,79,5594.98,10691.07,0.00
2024-12-10 17:24:21,162,7998,83,79,5621.64,10691.14,0.00
2024-12-10 17:24:21,161,7998,83,78,5655.89,10691.14,0.00
2024-12-10 17:24:21,160,7998,83,77,5683.27,10691.21,0.00
2024-12-10 17:24:21,160,7999,83,77,5732.51,10692.00,0.00
2024-12-10 17:24:21,161,7999,83,78,5696.90,10692.01,0.00
2024-12-10 17:24:21,160,7999,83,77,5717.88,10692.14,0.00
2024-12-10 17:24:21,159,7999,82,77,5753.17,10692.14,0.00
2024-12-10 17:24:22,159,8000,82,77,5728.75,10693.00,0.00
2024-12-10 17:24:22,160,8000,83,77,5692.95,10693.01,0.00
2024-12-10 17:24:22,161,7999,84,77,5653.62,10693.06,0.00
2024-12-10 17:24:22,160,7999,83,77,5708.39,10693.14,0.00
2024-12-10 17:24:22,160,8000,83,77,5684.12,10694.00,0.00
2024-12-10 17:24:22,161,8000,84,77,5648.82,10694.01,0.00
2024-12-10 17:24:22,160,8000,84,76,5669.49,10694.14,0.00
2024-12-10 17:24:22,161,7999,85,76,5617.04,10694.31,0.00
2024-12-10 17:24:22,160,7999,84,76,5678.32,10694.47,0.00
2024-12-10 17:24:22,160,8000,84,76,5756.22,10695.00,0.00
2024-12-10 17:24:22,161,8000,85,76,5720.46,10695.01,0.00
2024-12-10 17:24:22,160,8000,84,76,5740.92,10695.14,0.00
2024-12-10 17:24:22,161,7999,85,76,5684.04,10695.35,0.00
2024-12-10 17:24:22,162,7998,86,76,5659.04,10695.71,0.00
2024-12-10 17:24:22,162,7999,86,76,5782.08,10696.00,0.00
2024-12-10 17:24:22,163,7999,86,77,5746.61,10696.01,0.00
2024-12-10 17:24:22,162,7999,86,76,5766.97,10696.14,0.00
2024-12-10 17:24:22,162,8000,86,76,5873.74,10697.00,0.00
2024-12-10 17:24:22,163,8000,86,77,5837.71,10697.01,0.00
2024-12-10 17:24:22,163,8001,86,77,5797.56,10698.00,0.00
2024-12-10 17:24:22,164,8001,87,77,5762.21,10698.01,0.00
2024-12-10 17:24:22,163,8001,86,77,5782.53,10698.14,0.00
2024-12-10 17:24:22,163,8002,86,77,5756.75,10699.00,0.00
2024-12-10 17:24:22,164,8002,87,77,5721.65,10699.01,0.00
2024-12-10 17:24:22,163,8002,87,76,5741.72,10699.14,0.00
2024-12-10 17:24:22,164,8001,87,77,5688.48,10699.32,0.00
2024-12-10 17:24:22,165,8000,87,78,5635.60,10699.97,0.00
2024-12-10 17:24:22,165,8001,87,78,5699.18,10700.00,0.00
2024-12-10 17:24:22,166,8001,88,78,5664.85,10700.01,0.00
2024-12-10 17:24:22,165,8001,87,78,5684.33,10700.14,0.00
2024-12-10 17:24:22,165,8002,87,78,5787.26,10701.00,0.00
2024-12-10 17:24:22,166,8002,88,78,5752.40,10701.01,0.00
2024-12-10 17:24:22,165,8002,88,77,5780.16,10701.07,0.00
2024-12-10 17:24:22,164,8002,88,76,5807.61,10701.13,0.00
2024-12-10 17:24:22,164,8003,88,76,5780.68,10702.00,0.00
2024-12-10 17:24:22,165,8003,88,77,5745.64,10702.01,0.00
2024-12-10 17:24:22,164,8003,88,76,5766.38,10702.13,0.00
2024-12-10 17:24:22,164,8004,88,76,5739.41,10703.00,0.00
2024-12-10 17:24:22,165,8004,89,76,5704.63,10703.01,0.00
2024-12-10 17:24:22,166,8003,89,77,5608.07,10703.59,0.00
2024-12-10 17:24:22,166,8004,89,77,5659.33,10704.00,0.00
2024-12-10 17:24:22,167,8004,89,78,5625.44,10704.01,0.00
2024-12-10 17:24:22,166,8004,89,77,5644.56,10704.14,0.00
2024-12-10 17:24:22,166,8005,89,77,5680.03,10705.00,0.00
2024-12-10 17:24:22,167,8005,89,78,5646.02,10705.01,0.00
2024-12-10 17:24:22,166,8005,89,77,5665.26,10705.14,0.00
2024-12-10 17:24:22,166,8006,89,77,5636.15,10706.00,0.00
2024-12-10 17:24:22,167,8006,90,77,5602.40,10706.01,0.00
2024-12-10 17:24:22,166,8006,89,77,5627.16,10706.08,0.00
2024-12-10 17:24:22,165,8006,88,77,5655.45,10706.13,0.00
2024-12-10 17:24:22,164,8006,88,76,5689.28,10706.13,0.00
2024-12-10 17:24:22,164,8007,88,76,5660.60,10707.00,0.00
2024-12-10 17:24:22,165,8007,89,76,5626.30,10707.01,0.00
2024-12-10 17:24:22,164,8007,88,76,5646.30,10707.13,0.00
2024-12-10 17:24:22,165,8006,88,77,5550.36,10707.72,0.00
2024-12-10 17:24:22,165,8007,88,77,5607.71,10708.00,0.00
2024-12-10 17:24:22,166,8007,88,78,5573.92,10708.01,0.00
2024-12-10 17:24:22,165,8007,87,78,5593.48,10708.13,0.00
2024-12-10 17:24:22,165,8008,87,78,5630.94,10709.00,0.00
2024-12-10 17:24:22,166,8008,87,79,5597.02,10709.01,0.00
2024-12-10 17:24:22,165,8008,86,79,5616.72,10709.13,0.00
2024-12-10 17:24:22,166,8007,86,80,5533.37,10709.61,0.00
2024-12-10 17:24:22,166,8008,86,80,5585.93,10710.00,0.00
2024-12-10 17:24:22,167,8008,87,80,5552.48,10710.01,0.00
2024-12-10 17:24:22,166,8008,86,80,5571.79,10710.13,0.00
2024-12-10 17:24:22,166,8009,86,80,5608.39,10711.00,0.00
2024-12-10 17:24:22,167,8009,87,80,5574.81,10711.01,0.00
2024-12-10 17:24:22,166,8009,87,79,5594.25,10711.13,0.00
2024-12-10 17:24:22,166,8010,87,79,5566.33,10712.00,0.00
2024-12-10 17:24:22,167,8010,87,80,5532.99,10712.01,0.00
2024-12-10 17:24:22,166,8010,86,80,5552.18,10712.13,0.00
2024-12-10 17:24:22,167,8009,86,81,5451.21,10712.78,0.00
2024-12-10 17:24:22,167,8010,86,81,5507.85,10713.00,0.00
2024-12-10 17:24:22,168,8010,87,81,5475.07,10713.01,0.00
2024-12-10 17:24:22,167,8010,87,80,5493.79,10713.13,0.00
2024-12-10 17:24:22,167,8011,87,80,5529.54,10714.00,0.00
2024-12-10 17:24:22,168,8011,87,81,5496.62,10714.01,0.00
2024-12-10 17:24:22,167,8011,86,81,5515.47,10714.13,0.00
2024-12-10 17:24:22,167,8012,86,81,5487.06,10715.00,0.00
2024-12-10 17:24:22,168,8012,87,81,5454.40,10715.01,0.00
2024-12-10 17:24:22,167,8012,86,81,5485.14,10715.02,0.00
2024-12-10 17:24:22,166,8012,85,81,5505.96,10715.13,0.00
2024-12-10 17:24:22,165,8012,84,81,5538.04,10715.13,0.00
2024-12-10 17:24:23,165,8013,84,81,5510.58,10716.00,0.00
2024-12-10 17:24:23,166,8013,84,82,5477.38,10716.01,0.00
2024-12-10 17:24:23,165,8013,83,82,5496.34,10716.13,0.00
2024-12-10 17:24:23,166,8012,84,82,5433.60,10716.42,0.00
2024-12-10 17:24:23,166,8013,84,82,5479.19,10717.00,0.00
2024-12-10 17:24:23,167,8013,85,82,5446.38,10717.01,0.00
2024-12-10 17:24:23,166,8013,84,82,5465.03,10717.13,0.00
2024-12-10 17:24:23,166,8014,84,82,5501.65,10718.00,0.00
2024-12-10 17:24:23,167,8014,85,82,5468.70,10718.01,0.00
2024-12-10 17:24:23,168,8013,85,83,5435.52,10718.02,0.00
2024-12-10 17:24:23,167,8013,84,83,5492.50,10718.12,0.00
2024-12-10 17:24:23,166,8013,83,83,5523.01,10718.14,0.00
2024-12-10 17:24:23,165,8013,83,82,5555.83,10718.14,0.00
2024-12-10 17:24:23,165,8014,83,82,5529.01,10719.00,0.00
2024-12-10 17:24:23,166,8014,84,82,5495.71,10719.01,0.00
2024-12-10 17:24:23,165,8014,83,82,5514.78,10719.13,0.00
2024-12-10 17:24:23,166,8013,84,82,5440.99,10719.52,0.00
2024-12-10 17:24:23,166,8014,84,82,5525.28,10720.00,0.00
2024-12-10 17:24:23,167,8014,85,82,5492.19,10720.01,0.00
2024-12-10 17:24:23,166,8014,85,81,5511.12,10720.13,0.00
2024-12-10 17:24:23,165,8014,84,81,5539.79,10720.18,0.00
2024-12-10 17:24:23,165,8015,84,81,5581.83,10721.00,0.00
2024-12-10 17:24:23,166,8015,84,82,5548.20,10721.01,0.00
2024-12-10 17:24:23,165,8015,84,81,5567.58,10721.13,0.00
2024-12-10 17:24:23,164,8015,84,80,5600.88,10721.13,0.00
2024-12-10 17:24:23,164,8016,84,80,5573.89,10722.00,0.00
2024-12-10 17:24:23,165,8016,85,80,5540.11,10722.01,0.00
2024-12-10 17:24:23,165,8017,85,80,5499.03,10723.00,0.00
2024-12-10 17:24:23,166,8017,85,81,5465.91,10723.01,0.00
2024-12-10 17:24:23,165,8017,85,80,5483.49,10723.15,0.00
2024-12-10 17:24:23,165,8018,85,80,5454.22,10724.00,0.00
2024-12-10 17:24:23,166,8018,85,81,5421.36,10724.01,0.00
2024-12-10 17:24:23,165,8018,85,80,5450.24,10724.04,0.00
2024-12-10 17:24:23,164,8018,84,80,5472.39,10724.14,0.00
2024-12-10 17:24:23,163,8018,84,79,5497.76,10724.21,0.00
2024-12-10 17:24:23,163,8019,84,79,5464.98,10725.00,0.00
2024-12-10 17:24:23,164,8019,85,79,5431.66,10725.01,0.00
2024-12-10 17:24:23,163,8019,85,78,5449.91,10725.14,0.00
2024-12-10 17:24:23,162,8019,84,78,5453.84,10725.40,0.00
2024-12-10 17:24:23,162,8020,84,78,5455.16,10726.00,0.00
2024-12-10 17:24:23,163,8020,84,79,5421.69,10726.01,0.00
2024-12-10 17:24:23,162,8020,83,79,5449.88,10726.05,0.00
2024-12-10 17:24:23,161,8020,83,78,5473.78,10726.14,0.00
2024-12-10 17:24:23,160,8020,82,78,5507.32,10726.14,0.00
2024-12-10 17:24:23,160,8021,82,78,5481.63,10727.00,0.00
2024-12-10 17:24:23,161,8021,83,78,5447.58,10727.01,0.00
2024-12-10 17:24:23,162,8020,84,78,5413.29,10727.02,0.00
2024-12-10 17:24:23,161,8020,83,78,5444.28,10727.09,0.00
2024-12-10 17:24:23,160,8020,82,78,5472.97,10727.14,0.00
2024-12-10 17:24:23,159,8020,82,77,5506.72,10727.14,0.00
2024-12-10 17:24:23,160,8019,83,77,5430.85,10727.54,0.00
2024-12-10 17:24:23,160,8020,83,77,5484.30,10728.00,0.00
2024-12-10 17:24:23,161,8020,83,78,5450.24,10728.01,0.00
2024-12-10 17:24:23,161,8021,83,78,5541.95,10729.00,0.00
2024-12-10 17:24:23,162,8021,84,78,5507.74,10729.01,0.00
2024-12-10 17:24:23,161,8021,83,78,5526.68,10729.14,0.00
2024-12-10 17:24:23,161,8022,83,78,5496.05,10730.00,0.00
2024-12-10 17:24:23,162,8022,83,79,5462.12,10730.01,0.00
2024-12-10 17:24:23,161,8022,82,79,5480.77,10730.14,0.00
2024-12-10 17:24:23,161,8023,82,79,5446.67,10731.00,0.00
2024-12-10 17:24:23,162,8023,83,79,5413.05,10731.01,0.00
2024-12-10 17:24:23,161,8023,82,79,5431.40,10731.14,0.00
2024-12-10 17:24:23,161,8024,82,79,5394.39,10732.00,0.00
2024-12-10 17:24:23,162,8024,83,79,5361.09,10732.01,0.00
2024-12-10 17:24:23,161,8024,82,79,5379.11,10732.14,0.00
2024-12-10 17:24:23,162,8023,82,80,5307.60,10732.46,0.00
2024-12-10 17:24:23,162,8024,82,80,5351.68,10733.00,0.00
2024-12-10 17:24:23,163,8024,83,80,5318.85,10733.01,0.00
2024-12-10 17:24:23,162,8024,83,79,5336.49,10733.14,0.00
2024-12-10 17:24:23,163,8023,84,79,5280.60,10733.34,0.00
2024-12-10 17:24:23,163,8024,84,79,5382.15,10734.00,0.00
2024-12-10 17:24:23,164,8024,84,80,5349.33,10734.01,0.00
2024-12-10 17:24:23,164,8025,84,80,5362.73,10735.00,0.00
2024-12-10 17:24:23,165,8025,85,80,5330.23,10735.01,0.00
2024-12-10 17:24:23,166,8024,86,80,5287.16,10735.12,0.00
2024-12-10 17:24:23,165,8024,86,79,5341.99,10735.15,0.00
2024-12-10 17:24:23,165,8025,86,79,5308.40,10736.00,0.00
2024-12-10 17:24:23,166,8025,86,80,5276.42,10736.01,0.00
2024-12-10 17:24:23,165,8025,85,80,5303.86,10736.04,0.00
2024-12-10 17:24:23,164,8025,84,80,5325.76,10736.13,0.00
2024-12-10 17:24:23,165,8024,84,81,5249.99,10736.52,0.00
2024-12-10 17:24:24,165,8025,84,81,5363.25,10737.00,0.00
2024-12-10 17:24:24,166,8025,85,81,5330.94,10737.01,0.00
2024-12-10 17:24:24,165,8025,85,80,5348.98,10737.13,0.00
2024-12-10 17:24:24,166,8024,86,80,5242.74,10737.79,0.00
2024-12-10 17:24:24,166,8025,86,80,5365.82,10738.00,0.00
2024-12-10 17:24:24,167,8025,86,81,5333.69,10738.01,0.00
2024-12-10 17:24:24,166,8025,86,80,5351.64,10738.13,0.00
2024-12-10 17:24:24,165,8025,85,80,5350.39,10738.44,0.00
2024-12-10 17:24:24,166,8024,86,80,5309.79,10738.52,0.00
2024-12-10 17:24:24,166,8025,86,80,5423.99,10739.00,0.00
2024-12-10 17:24:24,167,8025,87,80,5391.51,10739.01,0.00
2024-12-10 17:24:24,166,8025,87,79,5409.80,10739.13,0.00
2024-12-10 17:24:24,165,8025,87,78,5441.94,10739.13,0.00
2024-12-10 17:24:24,165,8026,87,78,5479.12,10740.00,0.00
2024-12-10 17:24:24,166,8026,88,78,5446.11,10740.01,0.00
2024-12-10 17:24:24,165,8026,87,78,5464.84,10740.13,0.00
2024-12-10 17:24:24,166,8025,88,78,5361.12,10740.80,0.00
2024-12-10 17:24:24,167,8024,88,79,5338.07,10740.86,0.00
2024-12-10 17:24:24,167,8025,88,79,5397.37,10741.00,0.00
2024-12-10 17:24:24,168,8025,88,80,5365.24,10741.01,0.00
2024-12-10 17:24:24,167,8025,87,80,5383.26,10741.13,0.00
2024-12-10 17:24:24,166,8025,87,79,5415.05,10741.13,0.00
2024-12-10 17:24:24,166,8026,87,79,5515.56,10742.00,0.00
2024-12-10 17:24:24,167,8026,88,79,5482.53,10742.01,0.00
2024-12-10 17:24:24,166,8026,87,79,5501.37,10742.13,0.00
2024-12-10 17:24:24,165,8026,86,79,5534.06,10742.13,0.00
2024-12-10 17:24:24,165,8027,86,79,5504.97,10743.00,0.00
2024-12-10 17:24:24,166,8027,86,80,5471.81,10743.01,0.00
2024-12-10 17:24:24,165,8027,85,80,5490.69,10743.13,0.00
2024-12-10 17:24:24,166,8026,86,80,5432.24,10743.37,0.00
2024-12-10 17:24:24,166,8027,86,80,5475.54,10744.00,0.00
2024-12-10 17:24:24,167,8027,87,80,5442.75,10744.01,0.00
2024-12-10 17:24:24,166,8027,87,79,5461.34,10744.13,0.00
2024-12-10 17:24:24,165,8027,86,79,5475.83,10744.30,0.00
2024-12-10 17:24:24,165,8028,86,79,5525.13,10745.00,0.00
2024-12-10 17:24:24,166,8028,87,79,5491.85,10745.01,0.00
2024-12-10 17:24:24,165,8028,87,78,5524.48,10745.01,0.00
2024-12-10 17:24:24,166,8027,88,78,5485.39,10745.07,0.00
2024-12-10 17:24:24,165,8027,88,77,5575.32,10745.13,0.00
2024-12-10 17:24:24,165,8028,88,77,5538.99,10746.00,0.00
2024-12-10 17:24:24,166,8028,89,77,5505.62,10746.01,0.00
2024-12-10 17:24:24,167,8027,89,78,5459.18,10746.14,0.00
2024-12-10 17:24:24,166,8027,89,77,5555.52,10746.14,0.00
2024-12-10 17:24:24,165,8027,88,77,5550.12,10746.47,0.00
2024-12-10 17:24:24,165,8028,88,77,5615.86,10747.00,0.00
2024-12-10 17:24:24,166,8028,88,78,5582.03,10747.01,0.00
2024-12-10 17:24:24,165,8028,88,77,5600.93,10747.14,0.00
2024-12-10 17:24:24,165,8029,88,77,5626.34,10748.00,0.00
2024-12-10 17:24:24,166,8029,88,78,5592.45,10748.01,0.00
2024-12-10 17:24:24,165,8029,87,78,5611.41,10748.14,0.00
2024-12-10 17:24:24,164,8029,86,78,5644.97,10748.14,0.00
2024-12-10 17:24:24,163,8029,85,78,5678.49,10748.15,0.00
2024-12-10 17:24:24,162,8029,85,77,5657.91,10748.60,0.00
2024-12-10 17:24:24,162,8029,85,77,5680.06,10749.00,0.00
2024-12-10 17:24:24,163,8029,86,77,5645.21,10749.01,0.00
2024-12-10 17:24:24,163,8030,86,77,5600.75,10750.00,0.00
2024-12-10 17:24:24,164,8030,86,78,5566.60,10750.01,0.00
2024-12-10 17:24:24,163,8030,85,78,5584.97,10750.15,0.00
2024-12-10 17:24:24,164,8029,86,78,5531.00,10750.32,0.00
2024-12-10 17:24:24,164,8030,86,78,5526.21,10751.00,0.00
2024-12-10 17:24:24,165,8030,86,79,5492.72,10751.01,0.00
2024-12-10 17:24:24,164,8030,85,79,5510.53,10751.15,0.00
2024-12-10 17:24:24,164,8031,85,79,5546.08,10752.00,0.00
2024-12-10 17:24:24,165,8031,85,80,5512.46,10752.01,0.00
2024-12-10 17:24:24,164,8031,84,80,5540.19,10752.05,0.00
2024-12-10 17:24:24,163,8031,83,80,5564.32,10752.14,0.00
2024-12-10 17:24:24,163,8032,83,80,5534.52,10753.00,0.00
2024-12-10 17:24:24,164,8032,83,81,5500.77,10753.01,0.00
2024-12-10 17:24:24,163,8032,83,80,5518.73,10753.15,0.00
2024-12-10 17:24:24,164,8031,84,80,5422.18,10753.71,0.00
2024-12-10 17:24:24,165,8030,85,80,5409.66,10753.77,0.00
2024-12-10 17:24:24,165,8031,85,80,5466.54,10754.00,0.00
2024-12-10 17:24:24,166,8031,85,81,5433.61,10754.01,0.00
2024-12-10 17:24:24,165,8031,84,81,5461.98,10754.04,0.00
2024-12-10 17:24:24,164,8031,84,80,5484.18,10754.14,0.00
2024-12-10 17:24:24,163,8031,83,80,5517.16,10754.14,0.00
2024-12-10 17:24:24,163,8032,83,80,5612.68,10755.00,0.00
2024-12-10 17:24:24,164,8032,83,81,5578.46,10755.01,0.00
2024-12-10 17:24:24,163,8032,83,80,5610.05,10755.02,0.00
2024-12-10 17:24:24,162,8032,83,79,5632.10,10755.14,0.00
2024-12-10 17:24:24,162,8033,83,79,5586.09,10756.00,0.00
2024-12-10 17:24:24,163,8033,84,79,5551.82,10756.01,0.00
2024-12-10 17:24:24,162,8033,83,79,5578.80,10756.07,0.00
2024-12-10 17:24:24,161,8033,82,79,5602.02,10756.14,0.00
2024-12-10 17:24:24,162,8032,83,79,5546.90,10756.35,0.00
2024-12-10 17:24:24,162,8033,83,79,5566.32,10757.00,0.00
2024-12-10 17:24:24,163,8033,83,80,5532.17,10757.01,0.00
2024-12-10 17:24:24,162,8033,82,80,5548.82,10757.14,0.00
2024-12-10 17:24:24,161,8033,81,80,5508.59,10757.79,0.00
2024-12-10 17:24:24,161,8034,81,80,5620.35,10758.00,0.00
2024-12-10 17:24:24,162,8034,81,81,5585.66,10758.01,0.00
2024-12-10 17:24:24,163,8033,81,82,5550.73,10758.02,0.00
2024-12-10 17:24:24,162,8033,81,81,5629.98,10758.15,0.00
2024-12-10 17:24:25,162,8034,81,81,5601.00,10759.00,0.00
2024-12-10 17:24:25,163,8034,81,82,5566.64,10759.01,0.00
2024-12-10 17:24:25,162,8034,80,82,5585.11,10759.14,0.00
2024-12-10 17:24:25,162,8035,80,82,5621.72,10760.00,0.00
2024-12-10 17:24:25,163,8035,81,82,5587.23,10760.01,0.00
2024-12-10 17:24:25,162,8035,81,81,5606.49,10760.14,0.00
2024-12-10 17:24:25,163,8034,82,81,5570.11,10760.17,0.00
2024-12-10 17:24:25,163,8035,82,81,5569.32,10761.00,0.00
2024-12-10 17:24:25,164,8035,83,81,5535.36,10761.01,0.00
2024-12-10 17:24:25,163,8035,83,80,5559.45,10761.09,0.00
2024-12-10 17:24:25,162,8035,82,80,5588.47,10761.14,0.00
2024-12-10 17:24:25,161,8035,81,80,5622.51,10761.14,0.00
2024-12-10 17:24:25,161,8036,81,80,5659.29,10762.00,0.00
2024-12-10 17:24:25,162,8036,82,80,5624.36,10762.01,0.00
2024-12-10 17:24:25,163,8035,83,80,5582.61,10762.09,0.00
2024-12-10 17:24:25,163,8036,83,80,5563.59,10763.00,0.00
2024-12-10 17:24:25,164,8036,84,80,5529.67,10763.01,0.00
2024-12-10 17:24:25,163,8036,84,79,5547.80,10763.15,0.00
2024-12-10 17:24:25,162,8036,83,79,5553.13,10763.39,0.00
2024-12-10 17:24:25,163,8035,84,79,5462.94,10763.90,0.00
2024-12-10 17:24:25,163,8036,84,79,5591.14,10764.00,0.00
2024-12-10 17:24:25,164,8036,84,80,5557.05,10764.01,0.00
2024-12-10 17:24:25,163,8036,83,80,5587.85,10764.03,0.00
2024-12-10 17:24:25,162,8036,82,80,5609.76,10764.14,0.00
2024-12-10 17:24:25,161,8036,81,80,5643.94,10764.14,0.00
2024-12-10 17:24:25,161,8037,81,80,5681.27,10765.00,0.00
2024-12-10 17:24:25,162,8037,82,80,5646.20,10765.01,0.00
2024-12-10 17:24:25,161,8037,82,79,5675.94,10765.05,0.00
2024-12-10 17:24:25,162,8036,82,80,5636.27,10765.10,0.00
2024-12-10 17:24:25,161,8036,82,79,5678.65,10765.14,0.00
2024-12-10 17:24:25,160,8036,82,78,5713.47,10765.14,0.00
2024-12-10 17:24:25,161,8035,83,78,5619.70,10765.70,0.00
2024-12-10 17:24:25,161,8036,83,78,5669.98,10766.00,0.00
2024-12-10 17:24:25,162,8036,84,78,5634.98,10766.01,0.00
2024-12-10 17:24:25,161,8036,84,77,5655.40,10766.14,0.00
2024-12-10 17:24:25,161,8037,84,77,5754.95,10767.00,0.00
2024-12-10 17:24:25,162,8037,84,78,5719.43,10767.01,0.00
2024-12-10 17:24:25,161,8037,83,78,5751.62,10767.03,0.00
2024-12-10 17:24:25,160,8037,83,77,5775.02,10767.14,0.00
2024-12-10 17:24:25,160,8038,83,77,5738.01,10768.00,0.00
2024-12-10 17:24:25,161,8038,84,77,5702.37,10768.01,0.00
2024-12-10 17:24:25,160,8038,84,76,5736.00,10768.02,0.00
2024-12-10 17:24:25,159,8038,84,75,5758.05,10768.14,0.00
2024-12-10 17:24:25,158,8038,84,74,5793.81,10768.14,0.00
2024-12-10 17:24:25,159,8037,85,74,5705.84,10768.62,0.00
2024-12-10 17:24:25,160,8036,85,75,5645.08,10768.82,0.00
2024-12-10 17:24:25,160,8037,85,75,5705.82,10769.00,0.00
2024-12-10 17:24:25,161,8037,86,75,5670.38,10769.01,0.00
2024-12-10 17:24:25,160,8037,86,74,5690.45,10769.14,0.00
2024-12-10 17:24:25,160,8038,86,74,5782.58,10770.00,0.00
2024-12-10 17:24:25,161,8038,86,75,5746.67,10770.01,0.00
2024-12-10 17:24:25,161,8039,86,75,5688.46,10771.00,0.00
2024-12-10 17:24:25,162,8039,86,76,5653.34,10771.01,0.00
2024-12-10 17:24:25,161,8039,86,75,5685.13,10771.03,0.00
2024-12-10 17:24:25,160,8039,85,75,5708.58,10771.14,0.00
2024-12-10 17:24:25,160,8040,85,75,5663.71,10772.00,0.00
2024-12-10 17:24:25,161,8040,85,76,5628.53,10772.01,0.00
2024-12-10 17:24:25,161,8041,85,76,5569.45,10773.00,0.00
2024-12-10 17:24:25,162,8041,86,76,5535.07,10773.01,0.00
2024-12-10 17:24:25,161,8041,86,75,5559.14,10773.10,0.00
2024-12-10 17:24:25,160,8041,86,74,5589.19,10773.14,0.00
2024-12-10 17:24:25,161,8040,87,74,5452.13,10773.91,0.00
2024-12-10 17:24:25,161,8041,87,74,5515.79,10774.00,0.00
2024-12-10 17:24:25,162,8041,88,74,5481.74,10774.01,0.00
2024-12-10 17:24:25,161,8041,87,74,5501.12,10774.14,0.00
2024-12-10 17:24:25,162,8040,88,74,5423.46,10774.51,0.00
2024-12-10 17:24:25,162,8041,88,74,5501.01,10775.00,0.00
2024-12-10 17:24:25,163,8041,88,75,5467.26,10775.01,0.00
2024-12-10 17:24:25,162,8041,87,75,5486.43,10775.14,0.00
2024-12-10 17:24:25,161,8041,87,74,5482.39,10775.43,0.00
2024-12-10 17:24:25,162,8040,87,75,5416.40,10775.69,0.00
2024-12-10 17:24:25,162,8041,87,75,5535.32,10776.00,0.00
2024-12-10 17:24:25,163,8041,87,76,5501.36,10776.01,0.00
2024-12-10 17:24:25,162,8041,87,75,5520.74,10776.14,0.00
2024-12-10 17:24:25,163,8040,88,75,5464.43,10776.36,0.00
2024-12-10 17:24:25,164,8039,88,76,5424.06,10776.75,0.00
2024-12-10 17:24:25,164,8040,88,76,5544.99,10777.00,0.00
2024-12-10 17:24:25,165,8040,88,77,5511.39,10777.01,0.00
2024-12-10 17:24:25,164,8040,88,76,5537.79,10777.07,0.00
2024-12-10 17:24:25,163,8040,87,76,5564.52,10777.13,0.00
2024-12-10 17:24:25,162,8040,86,76,5598.20,10777.13,0.00
2024-12-10 17:24:25,161,8040,86,75,5566.91,10777.66,0.00
2024-12-10 17:24:25,161,8041,86,75,5726.27,10778.00,0.00
2024-12-10 17:24:25,162,8041,86,76,5690.92,10778.01,0.00
2024-12-10 17:24:25,161,8041,85,76,5645.81,10778.70,0.00
2024-12-10 17:24:25,161,8042,85,76,5672.70,10779.00,0.00
2024-12-10 17:24:25,162,8042,85,77,5637.68,10779.01,0.00
2024-12-10 17:24:25,161,8042,84,77,5658.02,10779.14,0.00
2024-12-10 17:24:25,161,8043,84,77,5613.75,10780.00,0.00
2024-12-10 17:24:25,162,8043,85,77,5579.10,10780.01,0.00
2024-12-10 17:24:25,163,8042,85,78,5483.48,10780.59,0.00
2024-12-10 17:24:25,164,8041,86,78,5478.12,10780.80,0.00
2024-12-10 17:24:26,164,8042,86,78,5519.92,10781.00,0.00
2024-12-10 17:24:26,165,8042,87,78,5486.46,10781.01,0.00
2024-12-10 17:24:26,164,8042,87,77,5504.85,10781.14,0.00
2024-12-10 17:24:26,164,8043,87,77,5582.39,10782.00,0.00
2024-12-10 17:24:26,165,8043,87,78,5548.56,10782.01,0.00
2024-12-10 17:24:26,164,8043,86,78,5573.87,10782.08,0.00
2024-12-10 17:24:26,163,8043,86,77,5600.82,10782.14,0.00
2024-12-10 17:24:26,163,8044,86,77,5541.34,10783.00,0.00
2024-12-10 17:24:26,164,8044,87,77,5507.55,10783.01,0.00
2024-12-10 17:24:26,163,8044,86,77,5526.18,10783.14,0.00
2024-12-10 17:24:26,164,8043,86,78,5456.57,10783.46,0.00
2024-12-10 17:24:26,163,8043,86,77,5482.25,10783.93,0.00
2024-12-10 17:24:26,163,8044,86,77,5541.19,10784.00,0.00
2024-12-10 17:24:26,164,8044,87,77,5507.40,10784.01,0.00
2024-12-10 17:24:26,163,8044,87,76,5526.02,10784.14,0.00
2024-12-10 17:24:26,162,8044,86,76,5547.46,10784.23,0.00
2024-12-10 17:24:26,163,8043,86,77,5459.71,10784.63,0.00
2024-12-10 17:24:26,163,8044,86,77,5572.12,10785.00,0.00
2024-12-10 17:24:26,164,8044,87,77,5538.14,10785.01,0.00
2024-12-10 17:24:26,165,8043,87,78,5494.81,10785.11,0.00
2024-12-10 17:24:26,164,8043,86,78,5557.93,10785.15,0.00
2024-12-10 17:24:26,165,8042,87,78,5489.03,10785.48,0.00
2024-12-10 17:24:26,166,8041,87,79,5491.71,10785.51,0.00
2024-12-10 17:24:26,165,8041,87,78,5544.21,10785.61,0.00
2024-12-10 17:24:26,165,8042,87,78,5627.61,10786.00,0.00
2024-12-10 17:24:26,166,8042,87,79,5593.71,10786.01,0.00
2024-12-10 17:24:26,165,8042,86,79,5623.70,10786.04,0.00
2024-12-10 17:24:26,164,8042,86,78,5646.85,10786.13,0.00
2024-12-10 17:24:26,164,8043,86,78,5813.71,10787.00,0.00
2024-12-10 17:24:26,165,8043,87,78,5778.48,10787.01,0.00
2024-12-10 17:24:26,164,8043,87,77,5799.29,10787.13,0.00
2024-12-10 17:24:26,164,8044,87,77,5770.21,10788.00,0.00
2024-12-10 17:24:26,165,8044,88,77,5735.24,10788.01,0.00
2024-12-10 17:24:26,164,8044,88,76,5764.31,10788.05,0.00
2024-12-10 17:24:26,163,8044,88,75,5791.10,10788.13,0.00
2024-12-10 17:24:26,162,8044,88,74,5826.18,10788.13,0.00
2024-12-10 17:24:26,162,8045,88,74,5799.37,10789.00,0.00
2024-12-10 17:24:26,163,8045,88,75,5763.79,10789.01,0.00
2024-12-10 17:24:26,162,8045,88,74,5785.43,10789.13,0.00
2024-12-10 17:24:26,163,8044,88,75,5705.72,10789.55,0.00
2024-12-10 17:24:26,163,8045,88,75,5755.72,10790.00,0.00
2024-12-10 17:24:26,164,8045,88,76,5720.62,10790.01,0.00
2024-12-10 17:24:26,163,8045,88,75,5752.42,10790.03,0.00
2024-12-10 17:24:26,162,8045,87,75,5777.31,10790.12,0.00
2024-12-10 17:24:26,161,8045,87,74,5812.52,10790.12,0.00
2024-12-10 17:24:26,162,8044,87,75,5766.66,10790.23,0.00
2024-12-10 17:24:26,163,8043,87,76,5679.29,10790.80,0.00
2024-12-10 17:24:26,163,8044,87,76,5803.92,10791.00,0.00
2024-12-10 17:24:26,164,8044,88,76,5768.53,10791.01,0.00
2024-12-10 17:24:26,163,8044,88,75,5790.72,10791.12,0.00
2024-12-10 17:24:26,164,8043,89,75,5700.34,10791.65,0.00
2024-12-10 17:24:26,164,8044,89,75,5882.90,10792.00,0.00
2024-12-10 17:24:26,165,8044,89,76,5847.25,10792.01,0.00
2024-12-10 17:24:26,164,8044,89,75,5869.79,10792.12,0.00
2024-12-10 17:24:26,165,8043,89,76,5822.45,10792.24,0.00
2024-12-10 17:24:26,165,8044,89,76,5926.94,10793.00,0.00
2024-12-10 17:24:26,166,8044,90,76,5891.23,10793.01,0.00
2024-12-10 17:24:26,165,8044,90,75,5924.98,10793.02,0.00
2024-12-10 17:24:26,164,8044,89,75,5949.96,10793.12,0.00
2024-12-10 17:24:26,165,8043,90,75,5864.36,10793.59,0.00
2024-12-10 17:24:26,165,8044,90,75,5970.01,10794.00,0.00
2024-12-10 17:24:26,166,8044,90,76,5934.05,10794.01,0.00
2024-12-10 17:24:26,165,8044,89,76,5957.63,10794.12,0.00
2024-12-10 17:24:26,164,8044,88,76,5993.29,10794.12,0.00
2024-12-10 17:24:26,165,8043,89,76,5898.43,10794.67,0.00
2024-12-10 17:24:26,165,8044,89,76,6014.51,10795.00,0.00
2024-12-10 17:24:26,166,8044,89,77,5978.27,10795.01,0.00
2024-12-10 17:24:26,165,8044,89,76,6010.59,10795.04,0.00
2024-12-10 17:24:26,164,8044,89,75,6046.32,10795.04,0.00
2024-12-10 17:24:26,163,8044,89,74,6082.09,10795.05,0.00
2024-12-10 17:24:26,162,8044,88,74,6113.01,10795.10,0.00
2024-12-10 17:24:26,163,8043,89,74,6024.16,10795.58,0.00
2024-12-10 17:24:26,164,8042,90,74,5996.11,10795.76,0.00
2024-12-10 17:24:26,164,8043,90,74,6116.12,10796.00,0.00
2024-12-10 17:24:26,165,8043,90,75,6079.06,10796.01,0.00
2024-12-10 17:24:26,164,8043,90,74,6104.97,10796.10,0.00
2024-12-10 17:24:26,164,8044,90,74,6204.56,10797.00,0.00
2024-12-10 17:24:26,165,8044,90,75,6166.95,10797.01,0.00
2024-12-10 17:24:26,164,8044,90,74,6193.40,10797.10,0.00
2024-12-10 17:24:26,163,8044,89,74,6204.61,10797.35,0.00
2024-12-10 17:24:26,164,8043,89,75,6150.11,10797.49,0.00
2024-12-10 17:24:26,164,8043,89,75,6195.28,10798.00,0.00
2024-12-10 17:24:26,165,8043,90,75,6157.74,10798.01,0.00
2024-12-10 17:24:26,164,8043,89,75,6184.13,10798.10,0.00
2024-12-10 17:24:26,165,8042,89,76,6070.27,10798.80,0.00
2024-12-10 17:24:26,165,8043,89,76,6190.87,10799.00,0.00
2024-12-10 17:24:26,166,8043,89,77,6153.58,10799.01,0.00
2024-12-10 17:24:26,165,8043,89,76,6187.61,10799.03,0.00
2024-12-10 17:24:26,164,8043,88,76,6218.12,10799.09,0.00
2024-12-10 17:24:26,163,8043,87,76,6255.61,10799.09,0.00
2024-12-10 17:24:26,162,8043,87,75,6293.56,10799.09,0.00
2024-12-10 17:24:26,161,8043,87,74,6331.98,10799.09,0.00
2024-12-10 17:24:26,161,8044,87,74,6364.46,10800.00,0.00
2024-12-10 17:24:26,162,8044,88,74,6325.17,10800.01,0.00
2024-12-10 17:24:26,161,8044,87,74,6354.44,10800.09,0.00
2024-12-10 17:24:26,161,8045,87,74,6318.78,10801.00,0.00
2024-12-10 17:24:26,162,8045,88,74,6279.78,10801.01,0.00
2024-12-10 17:24:26,161,8045,87,74,6308.76,10801.09,0.00
2024-12-10 17:24:26,162,8044,88,74,6214.77,10801.59,0.00
2024-12-10 17:24:26,161,8044,87,74,6256.30,10801.60,0.00
2024-12-10 17:24:26,162,8043,87,75,6194.61,10801.80,0.00
2024-12-10 17:24:27,162,8044,87,75,6250.81,10802.00,0.00
2024-12-10 17:24:27,163,8044,88,75,6212.46,10802.01,0.00
2024-12-10 17:24:27,164,8043,89,75,6102.59,10802.66,0.00
2024-12-10 17:24:27,164,8044,89,75,6267.75,10803.00,0.00
2024-12-10 17:24:27,165,8044,90,75,6229.76,10803.01,0.00
2024-12-10 17:24:27,166,8043,91,75,6192.23,10803.02,0.00
2024-12-10 17:24:27,165,8043,90,75,6275.61,10803.04,0.00
2024-12-10 17:24:27,164,8043,90,74,6307.32,10803.10,0.00
2024-12-10 17:24:27,164,8044,90,74,6335.19,10804.00,0.00
2024-12-10 17:24:27,165,8044,91,74,6296.80,10804.01,0.00
2024-12-10 17:24:27,164,8044,91,73,6325.36,10804.09,0.00
2024-12-10 17:24:27,164,8045,91,73,6352.96,10805.00,0.00
2024-12-10 17:24:27,165,8045,92,73,6314.46,10805.01,0.00
2024-12-10 17:24:27,164,8045,92,72,6343.12,10805.09,0.00
2024-12-10 17:24:27,165,8044,92,73,6235.16,10805.71,0.00
2024-12-10 17:24:27,165,8045,92,73,6284.26,10806.00,0.00
2024-12-10 17:24:27,166,8045,92,74,6246.40,10806.01,0.00
2024-12-10 17:24:27,165,8045,91,74,6274.48,10806.09,0.00
2024-12-10 17:24:27,165,8046,91,74,6302.26,10807.00,0.00
2024-12-10 17:24:27,166,8046,91,75,6264.29,10807.01,0.00
2024-12-10 17:24:27,165,8046,90,75,6295.74,10807.06,0.00
2024-12-10 17:24:27,164,8046,90,74,6330.19,10807.09,0.00
2024-12-10 17:24:27,165,8045,90,75,6225.71,10807.70,0.00
2024-12-10 17:24:27,165,8046,90,75,6255.88,10808.00,0.00
2024-12-10 17:24:27,166,8046,90,76,6218.19,10808.01,0.00
2024-12-10 17:24:27,165,8046,90,75,6246.10,10808.09,0.00
2024-12-10 17:24:27,165,8047,90,75,6273.75,10809.00,0.00
2024-12-10 17:24:27,166,8047,91,75,6235.95,10809.01,0.00
2024-12-10 17:24:27,165,8047,91,74,6264.18,10809.09,0.00
2024-12-10 17:24:27,164,8047,91,73,6301.72,10809.09,0.00
2024-12-10 17:24:27,163,8047,90,73,6312.66,10809.34,0.00
2024-12-10 17:24:27,164,8046,90,74,6226.49,10809.79,0.00
2024-12-10 17:24:27,164,8047,90,74,6277.03,10810.00,0.00
2024-12-10 17:24:27,165,8047,90,75,6238.98,10810.01,0.00
2024-12-10 17:24:27,164,8047,89,75,6267.18,10810.09,0.00
2024-12-10 17:24:27,164,8048,89,75,6294.39,10811.00,0.00
2024-12-10 17:24:27,165,8048,90,75,6256.24,10811.01,0.00
2024-12-10 17:24:27,166,8047,91,75,6156.02,10811.59,0.00
2024-12-10 17:24:27,166,8048,91,75,6218.91,10812.00,0.00
2024-12-10 17:24:27,167,8048,91,76,6181.67,10812.01,0.00
2024-12-10 17:24:27,166,8048,91,75,6208.53,10812.10,0.00
2024-12-10 17:24:27,167,8047,91,76,6150.04,10812.31,0.00
2024-12-10 17:24:27,167,8048,91,76,6244.15,10813.00,0.00
2024-12-10 17:24:27,168,8048,91,77,6206.98,10813.01,0.00
2024-12-10 17:24:27,169,8047,91,78,6163.88,10813.08,0.00
2024-12-10 17:24:27,168,8047,90,78,6233.42,10813.10,0.00
2024-12-10 17:24:27,168,8048,90,78,6256.58,10814.00,0.00
2024-12-10 17:24:27,169,8048,91,78,6219.56,10814.01,0.00
2024-12-10 17:24:27,168,8048,91,77,6246.33,10814.10,0.00
2024-12-10 17:24:27,168,8049,91,77,6266.62,10815.00,0.00
2024-12-10 17:24:27,169,8049,92,77,6229.54,10815.01,0.00
2024-12-10 17:24:27,168,8049,91,77,6256.37,10815.10,0.00
2024-12-10 17:24:27,167,8049,91,76,6195.47,10815.84,0.00
2024-12-10 17:24:27,167,8050,91,76,6243.53,10816.00,0.00
2024-12-10 17:24:27,168,8050,92,76,6206.37,10816.01,0.00
2024-12-10 17:24:27,167,8050,92,75,6233.21,10816.10,0.00
2024-12-10 17:24:27,168,8049,92,76,6140.18,10816.63,0.00
2024-12-10 17:24:27,168,8050,92,76,6149.73,10817.00,0.00
2024-12-10 17:24:27,169,8050,92,77,6113.34,10817.01,0.00
2024-12-10 17:24:27,168,8050,91,77,6138.83,10817.10,0.00
2024-12-10 17:24:27,169,8049,91,78,6099.31,10817.14,0.00
2024-12-10 17:24:27,169,8050,91,78,6169.80,10818.00,0.00
2024-12-10 17:24:27,170,8050,91,79,6133.51,10818.01,0.00
2024-12-10 17:24:27,171,8049,92,79,6090.40,10818.08,0.00
2024-12-10 17:24:27,170,8049,91,79,6173.33,10818.11,0.00
2024-12-10 17:24:27,169,8049,91,78,6209.22,10818.11,0.00
2024-12-10 17:24:27,170,8048,92,78,6138.20,10818.43,0.00
2024-12-10 17:24:27,169,8048,92,77,6167.00,10818.73,0.00
2024-12-10 17:24:27,170,8047,93,77,6121.25,10818.82,0.00
2024-12-10 17:24:27,170,8048,93,77,6241.04,10819.00,0.00
2024-12-10 17:24:27,171,8048,94,77,6204.55,10819.01,0.00
2024-12-10 17:24:27,170,8048,93,77,6229.74,10819.10,0.00
2024-12-10 17:24:27,171,8047,94,77,6149.31,10819.51,0.00
2024-12-10 17:24:27,171,8048,94,77,6352.61,10820.00,0.00
2024-12-10 17:24:27,172,8048,95,77,6315.68,10820.01,0.00
2024-12-10 17:24:27,173,8047,95,78,6279.17,10820.02,0.00
2024-12-10 17:24:27,172,8047,94,78,6314.47,10820.11,0.00
2024-12-10 17:24:28,172,8048,94,78,6336.10,10821.00,0.00
2024-12-10 17:24:28,173,8048,94,79,6299.47,10821.01,0.00
2024-12-10 17:24:28,174,8047,95,79,6259.55,10821.05,0.00
2024-12-10 17:24:28,173,8047,95,78,6257.56,10821.58,0.00
2024-12-10 17:24:28,173,8048,95,78,6337.96,10822.00,0.00
2024-12-10 17:24:28,174,8048,96,78,6301.53,10822.01,0.00
2024-12-10 17:24:28,173,8048,95,78,6325.65,10822.11,0.00
2024-12-10 17:24:28,174,8047,95,79,6274.41,10822.26,0.00
2024-12-10 17:24:28,174,8048,95,79,6367.07,10823.00,0.00
2024-12-10 17:24:28,175,8048,96,79,6330.69,10823.01,0.00
2024-12-10 17:24:28,174,8048,95,79,6347.22,10823.18,0.00
2024-12-10 17:24:28,174,8049,95,79,6381.01,10824.00,0.00
2024-12-10 17:24:28,175,8049,95,80,6344.54,10824.01,0.00
2024-12-10 17:24:28,175,8050,95,80,6293.10,10825.00,0.00
2024-12-10 17:24:28,176,8050,96,80,6257.35,10825.01,0.00
2024-12-10 17:24:28,175,8050,95,80,6280.17,10825.12,0.00
2024-12-10 17:24:28,176,8049,96,80,6187.14,10825.53,0.00
2024-12-10 17:24:28,176,8050,96,80,6227.49,10826.00,0.00
2024-12-10 17:24:28,177,8050,96,81,6192.30,10826.01,0.00
2024-12-10 17:24:28,176,8050,96,80,6214.62,10826.12,0.00
2024-12-10 17:24:28,175,8050,96,79,6228.38,10826.29,0.00
2024-12-10 17:24:28,175,8051,96,79,6275.26,10827.00,0.00
2024-12-10 17:24:28,176,8051,96,80,6239.60,10827.01,0.00
2024-12-10 17:24:28,175,8051,96,79,6269.71,10827.05,0.00
2024-12-10 17:24:28,174,8051,95,79,6298.31,10827.12,0.00
2024-12-10 17:24:28,174,8052,95,79,6262.63,10828.00,0.00
2024-12-10 17:24:28,175,8052,96,79,6226.85,10828.01,0.00
2024-12-10 17:24:28,174,8052,96,78,6249.00,10828.13,0.00
2024-12-10 17:24:28,174,8053,96,78,6215.08,10829.00,0.00
2024-12-10 17:24:28,175,8053,97,78,6179.56,10829.01,0.00
2024-12-10 17:24:28,174,8053,97,77,6203.56,10829.11,0.00
2024-12-10 17:24:28,174,8054,97,77,6168.41,10830.00,0.00
2024-12-10 17:24:28,175,8054,98,77,6133.16,10830.01,0.00
2024-12-10 17:24:28,175,8055,98,77,6087.55,10831.00,0.00
2024-12-10 17:24:28,176,8055,99,77,6052.97,10831.01,0.00
2024-12-10 17:24:28,175,8055,98,77,6073.99,10831.13,0.00
2024-12-10 17:24:28,175,8056,98,77,6041.59,10832.00,0.00
2024-12-10 17:24:28,176,8056,98,78,6007.26,10832.01,0.00
2024-12-10 17:24:28,175,8056,97,78,6036.50,10832.05,0.00
2024-12-10 17:24:28,174,8056,96,78,6063.14,10832.12,0.00
2024-12-10 17:24:28,174,8057,96,78,6029.40,10833.00,0.00
2024-12-10 17:24:28,175,8057,97,78,5994.94,10833.01,0.00
2024-12-10 17:24:28,174,8057,96,78,6015.76,10833.13,0.00
2024-12-10 17:24:28,174,8058,96,78,5981.13,10834.00,0.00
2024-12-10 17:24:28,175,8058,97,78,5946.95,10834.01,0.00
2024-12-10 17:24:28,174,8058,97,77,5967.48,10834.13,0.00
2024-12-10 17:24:28,174,8059,97,77,5931.51,10835.00,0.00
2024-12-10 17:24:28,175,8059,97,78,5897.61,10835.01,0.00
2024-12-10 17:24:28,176,8058,98,78,5770.96,10835.83,0.00
2024-12-10 17:24:28,176,8059,98,78,5826.52,10836.00,0.00
2024-12-10 17:24:28,177,8059,99,78,5793.60,10836.01,0.00
2024-12-10 17:24:28,176,8059,99,77,5812.41,10836.13,0.00
2024-12-10 17:24:28,175,8059,99,76,5845.01,10836.13,0.00
2024-12-10 17:24:28,176,8058,100,76,5726.68,10836.87,0.00
2024-12-10 17:24:28,176,8059,100,76,5842.08,10837.00,0.00
2024-12-10 17:24:28,177,8059,100,77,5809.08,10837.01,0.00
2024-12-10 17:24:28,176,8059,99,77,5834.11,10837.07,0.00
2024-12-10 17:24:28,175,8059,98,77,5861.28,10837.13,0.00
2024-12-10 17:24:28,174,8059,97,77,5894.34,10837.13,0.00
2024-12-10 17:24:28,174,8060,97,77,5900.79,10838.00,0.00
2024-12-10 17:24:28,175,8060,98,77,5867.07,10838.01,0.00
2024-12-10 17:24:29,176,8059,99,77,5820.85,10838.14,0.00
2024-12-10 17:24:29,175,8059,98,77,5868.98,10838.14,0.00
2024-12-10 17:24:29,175,8060,98,77,5803.24,10839.00,0.00
2024-12-10 17:24:29,176,8060,99,77,5770.27,10839.01,0.00
2024-12-10 17:24:29,175,8060,98,77,5787.58,10839.13,0.00
2024-12-10 17:24:29,174,8060,97,77,5710.13,10839.84,0.00
2024-12-10 17:24:29,175,8059,97,78,5672.59,10839.89,0.00
2024-12-10 17:24:29,175,8060,97,78,5787.02,10840.00,0.00
2024-12-10 17:24:29,176,8060,97,79,5754.14,10840.01,0.00
2024-12-10 17:24:29,175,8060,97,78,5783.55,10840.02,0.00
2024-12-10 17:24:29,174,8060,96,78,5810.58,10840.07,0.00
2024-12-10 17:24:29,173,8060,96,77,5780.57,10840.62,0.00
2024-12-10 17:24:29,173,8061,96,77,5841.47,10841.00,0.00
2024-12-10 17:24:29,174,8061,96,78,5807.90,10841.01,0.00
2024-12-10 17:24:29,175,8060,96,79,5774.71,10841.02,0.00
2024-12-10 17:24:29,175,8061,96,79,5701.04,10842.00,0.00
2024-12-10 17:24:29,176,8061,96,80,5668.65,10842.01,0.00
2024-12-10 17:24:29,176,8062,96,80,5626.02,10843.00,0.00
2024-12-10 17:24:29,177,8062,96,81,5594.23,10843.01,0.00
2024-12-10 17:24:29,176,8062,95,81,5611.29,10843.14,0.00
2024-12-10 17:24:29,175,8062,94,81,5567.16,10843.76,0.00
2024-12-10 17:24:29,174,8062,93,81,5539.62,10843.95,0.00
2024-12-10 17:24:29,174,8063,93,81,5596.38,10844.00,0.00
2024-12-10 17:24:29,175,8063,94,81,5564.40,10844.01,0.00
2024-12-10 17:24:29,174,8063,93,81,5581.48,10844.14,0.00
2024-12-10 17:24:29,175,8062,94,81,5516.83,10844.45,0.00
2024-12-10 17:24:29,174,8062,93,81,5530.41,10844.94,0.00
2024-12-10 17:24:29,174,8063,93,81,5585.94,10845.00,0.00
2024-12-10 17:24:29,175,8063,94,81,5554.02,10845.01,0.00
2024-12-10 17:24:29,174,8063,93,81,5571.03,10845.14,0.00
2024-12-10 17:24:29,173,8063,92,81,5594.27,10845.21,0.00
2024-12-10 17:24:29,173,8063,92,81,5630.81,10846.00,0.00
2024-12-10 17:24:29,174,8063,93,81,5598.45,10846.01,0.00
2024-12-10 17:24:29,173,8063,93,80,5615.19,10846.14,0.00
2024-12-10 17:24:29,173,8064,93,80,5581.68,10847.00,0.00
2024-12-10 17:24:29,174,8064,94,80,5549.60,10847.01,0.00
2024-12-10 17:24:29,173,8064,94,79,5566.06,10847.14,0.00
2024-12-10 17:24:29,172,8064,94,78,5539.11,10847.67,0.00
2024-12-10 17:24:29,173,8063,94,79,5502.11,10847.73,0.00
2024-12-10 17:24:29,173,8064,94,79,5556.53,10848.00,0.00
2024-12-10 17:24:29,174,8064,95,79,5524.59,10848.01,0.00
2024-12-10 17:24:29,173,8064,94,79,5543.49,10848.12,0.00
2024-12-10 17:24:29,173,8065,94,79,5573.48,10849.00,0.00
2024-12-10 17:24:29,174,8065,95,79,5541.45,10849.01,0.00
2024-12-10 17:24:29,174,8066,95,79,5495.60,10850.00,0.00
2024-12-10 17:24:29,175,8066,95,80,5464.20,10850.01,0.00
2024-12-10 17:24:29,174,8066,94,80,5491.25,10850.04,0.00
2024-12-10 17:24:29,173,8066,93,80,5511.11,10850.14,0.00
2024-12-10 17:24:29,173,8067,93,80,5479.88,10851.00,0.00
2024-12-10 17:24:29,174,8067,94,80,5448.39,10851.01,0.00
2024-12-10 17:24:29,173,8067,93,80,5466.29,10851.13,0.00
2024-12-10 17:24:29,173,8068,93,80,5431.86,10852.00,0.00
2024-12-10 17:24:29,174,8068,94,80,5400.64,10852.01,0.00
2024-12-10 17:24:29,173,8068,94,79,5416.23,10852.14,0.00
2024-12-10 17:24:29,173,8069,94,79,5381.74,10853.00,0.00
2024-12-10 17:24:29,174,8069,95,79,5350.81,10853.01,0.00
2024-12-10 17:24:29,175,8068,95,80,5319.00,10853.03,0.00
2024-12-10 17:24:29,174,8068,95,79,5392.04,10853.15,0.00
2024-12-10 17:24:29,173,8068,94,79,5422.58,10853.15,0.00
2024-12-10 17:24:29,173,8069,94,79,5387.12,10854.00,0.00
2024-12-10 17:24:29,174,8069,95,79,5356.16,10854.01,0.00
2024-12-10 17:24:29,173,8069,95,78,5370.87,10854.15,0.00
2024-12-10 17:24:29,173,8070,95,78,5392.93,10855.00,0.00
2024-12-10 17:24:29,174,8070,95,79,5361.94,10855.01,0.00
2024-12-10 17:24:29,174,8071,95,79,5300.17,10856.00,0.00
2024-12-10 17:24:29,175,8071,96,79,5269.88,10856.01,0.00
2024-12-10 17:24:29,174,8071,95,79,5283.38,10856.16,0.00
2024-12-10 17:24:29,173,8071,95,78,5234.63,10856.75,0.00
2024-12-10 17:24:29,173,8072,95,78,5263.70,10857.00,0.00
2024-12-10 17:24:29,174,8072,95,79,5233.45,10857.01,0.00
2024-12-10 17:24:29,173,8072,95,78,5246.81,10857.16,0.00
2024-12-10 17:24:29,173,8073,95,78,5202.53,10858.00,0.00
2024-12-10 17:24:29,174,8073,96,78,5172.63,10858.01,0.00
2024-12-10 17:24:30,173,8073,95,78,5201.28,10858.01,0.00
2024-12-10 17:24:30,172,8073,95,77,5215.79,10858.15,0.00
2024-12-10 17:24:30,173,8072,95,78,5175.61,10858.25,0.00
2024-12-10 17:24:30,172,8072,94,78,5231.72,10858.49,0.00
2024-12-10 17:24:30,172,8073,94,78,5228.08,10859.00,0.00
2024-12-10 17:24:30,173,8073,94,79,5197.86,10859.01,0.00
2024-12-10 17:24:30,173,8074,94,79,5200.78,10860.00,0.00
2024-12-10 17:24:30,174,8074,95,79,5170.89,10860.01,0.00
2024-12-10 17:24:30,173,8074,94,79,5198.28,10860.02,0.00
2024-12-10 17:24:30,172,8074,93,79,5213.39,10860.16,0.00
2024-12-10 17:24:30,171,8074,92,79,5243.24,10860.16,0.00
2024-12-10 17:24:30,172,8073,93,79,5191.97,10860.36,0.00
2024-12-10 17:24:30,171,8073,92,79,5216.26,10860.84,0.00
2024-12-10 17:24:30,171,8074,92,79,5262.76,10861.00,0.00
2024-12-10 17:24:30,172,8074,92,80,5232.16,10861.01,0.00
2024-12-10 17:24:30,172,8075,92,80,5249.82,10862.00,0.00
2024-12-10 17:24:30,173,8075,92,81,5219.47,10862.01,0.00
2024-12-10 17:24:30,172,8075,91,81,5232.19,10862.16,0.00
2024-12-10 17:24:30,173,8074,91,82,5185.83,10862.24,0.00
2024-12-10 17:24:30,173,8075,91,82,5223.56,10863.00,0.00
2024-12-10 17:24:30,174,8075,91,83,5193.54,10863.01,0.00
2024-12-10 17:24:30,173,8075,90,83,5206.04,10863.16,0.00
2024-12-10 17:24:30,172,8075,89,83,5235.67,10863.16,0.00
2024-12-10 17:24:30,173,8074,90,83,5202.90,10863.20,0.00
2024-12-10 17:24:30,173,8075,90,83,5281.99,10864.00,0.00
2024-12-10 17:24:30,174,8075,90,84,5251.64,10864.01,0.00
2024-12-10 17:24:30,173,8075,90,83,5264.46,10864.16,0.00
2024-12-10 17:24:30,173,8076,90,83,5259.10,10865.00,0.00
2024-12-10 17:24:30,174,8076,91,83,5228.87,10865.01,0.00
2024-12-10 17:24:30,173,8076,90,83,5257.22,10865.02,0.00
2024-12-10 17:24:30,172,8076,90,82,5280.23,10865.08,0.00
2024-12-10 17:24:30,171,8076,89,82,5302.87,10865.15,0.00
2024-12-10 17:24:30,170,8076,89,81,5333.42,10865.15,0.00
2024-12-10 17:24:30,169,8076,88,81,5364.34,10865.15,0.00
2024-12-10 17:24:30,168,8076,88,80,5391.28,10865.18,0.00
2024-12-10 17:24:30,168,8077,88,80,5345.99,10866.00,0.00
2024-12-10 17:24:30,169,8077,88,81,5314.36,10866.01,0.00
2024-12-10 17:24:30,168,8077,87,81,5267.42,10866.65,0.00
2024-12-10 17:24:30,168,8078,87,81,5294.21,10867.00,0.00
2024-12-10 17:24:30,169,8078,88,81,5262.88,10867.01,0.00
2024-12-10 17:24:30,168,8078,88,80,5276.80,10867.16,0.00
2024-12-10 17:24:30,168,8079,88,80,5240.30,10868.00,0.00
2024-12-10 17:24:30,169,8079,89,80,5209.29,10868.01,0.00
2024-12-10 17:24:30,168,8079,88,80,5233.21,10868.07,0.00
2024-12-10 17:24:30,167,8079,88,79,5260.00,10868.10,0.00
2024-12-10 17:24:30,166,8079,87,79,5285.81,10868.15,0.00
2024-12-10 17:24:30,165,8079,86,79,5317.19,10868.15,0.00
2024-12-10 17:24:30,164,8079,86,78,5322.11,10868.33,0.00
2024-12-10 17:24:30,165,8078,87,78,5285.91,10868.38,0.00
2024-12-10 17:24:30,165,8079,87,78,5330.04,10869.00,0.00
2024-12-10 17:24:30,166,8079,88,78,5297.93,10869.01,0.00
2024-12-10 17:24:30,165,8079,88,77,5303.10,10869.21,0.00
2024-12-10 17:24:30,165,8080,88,77,5343.33,10870.00,0.00
2024-12-10 17:24:30,166,8080,89,77,5311.14,10870.01,0.00
2024-12-10 17:24:30,165,8080,88,77,5281.23,10870.54,0.00
2024-12-10 17:24:30,165,8081,88,77,5295.13,10871.00,0.00
2024-12-10 17:24:30,166,8081,88,78,5263.23,10871.01,0.00
2024-12-10 17:24:30,166,8082,88,78,5213.85,10872.00,0.00
2024-12-10 17:24:30,167,8082,89,78,5182.63,10872.01,0.00
2024-12-10 17:24:30,166,8082,89,77,5195.57,10872.17,0.00
2024-12-10 17:24:30,166,8083,89,77,5154.67,10873.00,0.00
2024-12-10 17:24:30,167,8083,90,77,5123.80,10873.01,0.00
2024-12-10 17:24:30,166,8083,89,77,5135.73,10873.17,0.00
2024-12-10 17:24:30,166,8084,89,77,5085.89,10874.00,0.00
2024-12-10 17:24:30,167,8084,89,78,5055.44,10874.01,0.00
2024-12-10 17:24:30,168,8083,90,78,5024.70,10874.02,0.00
2024-12-10 17:24:30,167,8083,89,78,5063.92,10874.05,0.00
2024-12-10 17:24:30,166,8083,88,78,5080.71,10874.17,0.00
2024-12-10 17:24:30,165,8083,87,78,5110.84,10874.18,0.00
2024-12-10 17:24:30,166,8082,88,78,4995.38,10874.90,0.00
2024-12-10 17:24:30,165,8082,88,77,5017.06,10874.92,0.00
2024-12-10 17:24:30,165,8083,88,77,5074.47,10875.00,0.00
2024-12-10 17:24:30,166,8083,89,77,5043.90,10875.01,0.00
2024-12-10 17:24:30,165,8083,89,76,5052.55,10875.17,0.00
2024-12-10 17:24:30,165,8084,89,76,5143.11,10876.00,0.00
2024-12-10 17:24:30,166,8084,89,77,5112.13,10876.01,0.00
2024-12-10 17:24:30,165,8084,88,77,5132.60,10876.10,0.00
2024-12-10 17:24:30,164,8084,88,76,5146.56,10876.17,0.00
2024-12-10 17:24:30,163,8084,87,76,5120.17,10876.59,0.00
2024-12-10 17:24:30,164,8083,87,77,5078.39,10876.70,0.00
2024-12-10 17:24:30,165,8082,88,77,5048.98,10876.92,0.00
2024-12-10 17:24:30,165,8083,88,77,5113.00,10877.00,0.00
2024-12-10 17:24:30,166,8083,89,77,5082.20,10877.01,0.00
2024-12-10 17:24:30,165,8083,88,77,5092.58,10877.13,0.00
2024-12-10 17:24:30,164,8083,88,76,5105.37,10877.17,0.00
2024-12-10 17:24:30,163,8083,87,76,5133.03,10877.18,0.00
2024-12-10 17:24:30,163,8084,87,76,5240.74,10878.00,0.00
2024-12-10 17:24:30,164,8084,87,77,5208.78,10878.01,0.00
2024-12-10 17:24:30,163,8084,87,76,5200.13,10878.17,0.00
2024-12-10 17:24:30,162,8084,86,76,5216.36,10878.22,0.00
2024-12-10 17:24:30,161,8084,85,76,5244.61,10878.24,0.00
2024-12-10 17:24:30,162,8083,85,77,5157.37,10878.76,0.00
2024-12-10 17:24:31,162,8084,85,77,5218.69,10879.00,0.00
2024-12-10 17:24:31,163,8084,86,77,5186.67,10879.01,0.00
2024-12-10 17:24:31,162,8084,85,77,5187.85,10879.13,0.00
2024-12-10 17:24:31,161,8084,84,77,5203.64,10879.19,0.00
2024-12-10 17:24:31,162,8083,84,78,5111.96,10879.75,0.00
2024-12-10 17:24:31,162,8084,84,78,5217.98,10880.00,0.00
2024-12-10 17:24:31,163,8084,85,78,5185.97,10880.01,0.00
2024-12-10 17:24:31,162,8084,84,78,5209.94,10880.07,0.00
2024-12-10 17:24:31,161,8084,84,77,5237.58,10880.11,0.00
2024-12-10 17:24:31,160,8084,83,77,5264.89,10880.16,0.00
2024-12-10 17:24:31,160,8085,83,77,5304.69,10881.00,0.00
2024-12-10 17:24:31,161,8085,83,78,5271.74,10881.01,0.00
2024-12-10 17:24:31,161,8086,83,78,5214.00,10882.00,0.00
2024-12-10 17:24:31,162,8086,83,79,5181.81,10882.01,0.00
2024-12-10 17:24:31,161,8086,82,79,5193.40,10882.14,0.00
2024-12-10 17:24:31,160,8086,82,78,5223.14,10882.16,0.00
2024-12-10 17:24:31,160,8087,82,78,5174.08,10883.00,0.00
2024-12-10 17:24:31,161,8087,83,78,5141.95,10883.01,0.00
2024-12-10 17:24:31,160,8087,83,77,5168.21,10883.06,0.00
2024-12-10 17:24:31,161,8086,84,77,5101.03,10883.39,0.00
2024-12-10 17:24:31,160,8086,83,77,5113.52,10883.79,0.00
2024-12-10 17:24:31,161,8085,84,77,5069.02,10883.91,0.00
2024-12-10 17:24:31,161,8086,84,77,5132.60,10884.00,0.00
2024-12-10 17:24:31,162,8086,84,78,5100.91,10884.01,0.00
2024-12-10 17:24:31,161,8086,84,77,5117.94,10884.08,0.00
2024-12-10 17:24:31,160,8086,83,77,5141.79,10884.15,0.00
2024-12-10 17:24:31,159,8086,83,76,5173.44,10884.15,0.00
2024-12-10 17:24:31,160,8085,84,76,5103.77,10884.51,0.00
2024-12-10 17:24:31,160,8086,84,76,5268.14,10885.00,0.00
2024-12-10 17:24:31,161,8086,85,76,5235.42,10885.01,0.00
2024-12-10 17:24:31,160,8086,84,76,5249.64,10885.06,0.00
2024-12-10 17:24:31,159,8086,84,75,5281.98,10885.06,0.00
2024-12-10 17:24:31,158,8086,84,74,5305.79,10885.14,0.00
2024-12-10 17:24:31,157,8086,83,74,5338.89,10885.14,0.00
2024-12-10 17:24:31,156,8086,83,73,5372.42,10885.14,0.00
2024-12-10 17:24:31,155,8086,83,72,5359.29,10885.52,0.00
2024-12-10 17:24:31,155,8087,83,72,5375.23,10886.00,0.00
2024-12-10 17:24:31,156,8087,84,72,5340.77,10886.01,0.00
2024-12-10 17:24:31,155,8087,84,71,5340.92,10886.14,0.00
2024-12-10 17:24:31,154,8087,83,71,5356.35,10886.26,0.00
2024-12-10 17:24:31,153,8087,82,71,5319.06,10886.63,0.00
2024-12-10 17:24:31,153,8088,82,71,5260.61,10887.00,0.00
2024-12-10 17:24:31,154,8088,82,72,5226.45,10887.01,0.00
2024-12-10 17:24:31,155,8087,82,73,5192.73,10887.02,0.00
2024-12-10 17:24:31,154,8087,81,73,5184.85,10887.59,0.00
2024-12-10 17:24:31,153,8087,81,72,5142.70,10887.86,0.00
2024-12-10 17:24:31,153,8088,81,72,5096.92,10888.00,0.00
2024-12-10 17:24:31,154,8088,82,72,5063.83,10888.01,0.00
2024-12-10 17:24:31,153,8088,81,72,5051.78,10888.14,0.00
2024-12-10 17:24:31,152,8088,80,72,5019.19,10888.45,0.00
2024-12-10 17:24:31,153,8087,80,73,4948.40,10888.74,0.00
2024-12-10 17:24:31,152,8087,79,73,4968.18,10888.84,0.00
2024-12-10 17:24:31,151,8087,78,73,4952.89,10888.91,0.00
2024-12-10 17:24:31,150,8087,77,73,4971.00,10888.93,0.00
2024-12-10 17:24:31,150,8088,77,73,5006.99,10889.00,0.00
2024-12-10 17:24:31,151,8088,78,73,4973.83,10889.01,0.00
2024-12-10 17:24:31,150,8088,78,72,4991.54,10889.01,0.00
2024-12-10 17:24:31,151,8087,78,73,4954.89,10889.05,0.00
2024-12-10 17:24:31,150,8087,78,72,5046.76,10889.15,0.00
2024-12-10 17:24:31,149,8087,77,72,5063.00,10889.30,0.00
2024-12-10 17:24:31,148,8087,77,71,5088.02,10889.37,0.00
2024-12-10 17:24:31,147,8087,77,70,4972.57,10889.92,0.00
2024-12-10 17:24:31,146,8087,76,70,4976.96,10889.97,0.00
2024-12-10 17:24:31,146,8088,76,70,5045.37,10890.00,0.00
2024-12-10 17:24:31,147,8088,76,71,5011.05,10890.01,0.00
2024-12-10 17:24:31,146,8088,75,71,5041.65,10890.03,0.00
2024-12-10 17:24:31,145,8088,75,70,5070.43,10890.06,0.00
2024-12-10 17:24:31,144,8088,75,69,5096.59,10890.14,0.00
2024-12-10 17:24:31,143,8088,74,69,5057.28,10890.63,0.00
2024-12-10 17:24:31,144,8087,75,69,5012.39,10890.73,0.00
2024-12-10 17:24:31,143,8087,75,68,4994.07,10890.87,0.00
2024-12-10 17:24:31,142,8087,75,67,4995.47,10890.96,0.00
2024-12-10 17:24:31,142,8088,75,67,5074.60,10891.00,0.00
2024-12-10 17:24:31,143,8088,75,68,5039.11,10891.01,0.00
2024-12-10 17:24:31,142,8088,75,67,5066.95,10891.07,0.00
2024-12-10 17:24:31,141,8088,74,67,5094.72,10891.13,0.00
2024-12-10 17:24:31,140,8088,73,67,5130.33,10891.14,0.00
2024-12-10 17:24:31,139,8088,73,66,5035.32,10891.86,0.00
2024-12-10 17:24:31,138,8088,72,66,5022.43,10891.96,0.00
2024-12-10 17:24:31,138,8089,72,66,5140.95,10892.00,0.00
2024-12-10 17:24:31,139,8089,73,66,5103.96,10892.01,0.00
2024-12-10 17:24:31,138,8089,73,65,5124.87,10892.14,0.00
2024-12-10 17:24:31,137,8089,72,65,5154.45,10892.18,0.00
2024-12-10 17:24:31,136,8089,72,64,5187.07,10892.19,0.00
2024-12-10 17:24:31,135,8089,71,64,5206.90,10892.26,0.00
2024-12-10 17:24:31,134,8089,70,64,5103.06,10892.97,0.00
2024-12-10 17:24:31,134,8090,70,64,5181.12,10893.00,0.00
2024-12-10 17:24:31,135,8090,70,65,5142.74,10893.01,0.00
2024-12-10 17:24:31,134,8090,69,65,5162.68,10893.15,0.00
2024-12-10 17:24:31,133,8090,68,65,5200.68,10893.15,0.00
2024-12-10 17:24:31,132,8090,67,65,5227.44,10893.23,0.00
2024-12-10 17:24:31,131,8090,67,64,5182.25,10893.78,0.00
2024-12-10 17:24:31,130,8090,66,64,5197.29,10893.86,0.00
2024-12-10 17:24:31,130,8091,66,64,5266.12,10894.00,0.00
2024-12-10 17:24:31,131,8091,67,64,5225.92,10894.01,0.00
2024-12-10 17:24:31,130,8091,66,64,5257.79,10894.07,0.00
2024-12-10 17:24:31,129,8091,66,63,5286.82,10894.15,0.00
2024-12-10 17:24:31,128,8091,65,63,5278.45,10894.49,0.00
2024-12-10 17:24:31,129,8090,65,64,5216.52,10894.70,0.00
2024-12-10 17:24:31,129,8091,65,64,5285.98,10895.00,0.00
2024-12-10 17:24:31,130,8091,66,64,5245.31,10895.01,0.00
2024-12-10 17:24:31,129,8091,66,63,5267.25,10895.15,0.00
2024-12-10 17:24:31,128,8091,65,63,5307.55,10895.15,0.00
2024-12-10 17:24:31,127,8091,64,63,5302.17,10895.45,0.00
2024-12-10 17:24:31,127,8092,64,63,5396.38,10896.00,0.00
2024-12-10 17:24:31,128,8092,65,63,5354.23,10896.01,0.00
2024-12-10 17:24:31,127,8092,65,62,5377.31,10896.15,0.00
2024-12-10 17:24:31,126,8092,64,62,5412.67,10896.20,0.00
2024-12-10 17:24:31,127,8091,64,63,5350.37,10896.39,0.00
2024-12-10 17:24:31,128,8090,64,64,5303.59,10896.80,0.00
2024-12-10 17:24:31,128,8091,64,64,5393.83,10897.00,0.00
2024-12-10 17:24:31,129,8091,64,65,5352.02,10897.01,0.00
2024-12-10 17:24:31,128,8091,63,65,5374.75,10897.15,0.00
2024-12-10 17:24:31,127,8091,62,65,5324.27,10897.76,0.00
2024-12-10 17:24:32,127,8092,62,65,5549.98,10898.00,0.00
2024-12-10 17:24:32,128,8092,62,66,5506.62,10898.01,0.00
2024-12-10 17:24:32,127,8092,62,65,5519.87,10898.20,0.00
2024-12-10 17:24:32,126,8092,61,65,5503.95,10898.56,0.00
2024-12-10 17:24:32,126,8093,61,65,5523.44,10899.00,0.00
2024-12-10 17:24:32,127,8093,61,66,5479.94,10899.01,0.00
2024-12-10 17:24:32,126,8093,61,65,5410.07,10899.88,0.00
2024-12-10 17:24:32,126,8094,61,65,5474.17,10900.00,0.00
2024-12-10 17:24:32,127,8094,62,65,5431.07,10900.01,0.00
2024-12-10 17:24:32,127,8095,62,65,5372.25,10901.00,0.00
2024-12-10 17:24:32,128,8095,62,66,5330.28,10901.01,0.00
2024-12-10 17:24:32,127,8095,61,66,5363.88,10901.08,0.00
2024-12-10 17:24:32,126,8095,60,66,5393.07,10901.15,0.00
2024-12-10 17:24:32,125,8095,59,66,5435.34,10901.15,0.00
2024-12-10 17:24:32,124,8095,59,65,5478.30,10901.15,0.00
2024-12-10 17:24:32,124,8096,59,65,5430.18,10902.00,0.00
2024-12-10 17:24:32,125,8096,60,65,5386.73,10902.01,0.00
2024-12-10 17:24:32,126,8095,60,66,5328.96,10902.13,0.00
2024-12-10 17:24:32,125,8095,59,66,5416.96,10902.16,0.00
2024-12-10 17:24:32,125,8096,59,66,5355.24,10903.00,0.00
2024-12-10 17:24:32,126,8096,60,66,5312.74,10903.01,0.00
2024-12-10 17:24:32,125,8096,59,66,5335.33,10903.15,0.00
2024-12-10 17:24:32,124,8096,59,65,5219.88,10903.94,0.00
2024-12-10 17:24:32,124,8097,59,65,5389.63,10904.00,0.00
2024-12-10 17:24:32,125,8097,59,66,5346.52,10904.01,0.00
2024-12-10 17:24:32,124,8097,58,66,5231.18,10904.75,0.00
2024-12-10 17:24:32,124,8098,58,66,5288.64,10905.00,0.00
2024-12-10 17:24:32,125,8098,59,66,5246.33,10905.01,0.00
2024-12-10 17:24:32,124,8098,58,66,5266.40,10905.18,0.00
2024-12-10 17:24:32,125,8097,59,66,5116.30,10905.70,0.00
2024-12-10 17:24:32,125,8098,59,66,5170.72,10906.00,0.00
2024-12-10 17:24:32,126,8098,60,66,5129.68,10906.01,0.00
2024-12-10 17:24:32,125,8098,60,65,5154.18,10906.15,0.00
2024-12-10 17:24:32,124,8098,59,65,5147.35,10906.51,0.00
2024-12-10 17:24:32,123,8098,59,64,5173.78,10906.58,0.00
2024-12-10 17:24:32,122,8098,58,64,5203.17,10906.66,0.00
2024-12-10 17:24:32,121,8098,57,64,5230.72,10906.69,0.00
2024-12-10 17:24:32,121,8099,57,64,5364.11,10907.00,0.00
2024-12-10 17:24:32,122,8099,57,65,5320.14,10907.01,0.00
2024-12-10 17:24:32,121,8099,56,65,5323.55,10907.29,0.00
2024-12-10 17:24:32,121,8100,56,65,5297.51,10908.00,0.00
2024-12-10 17:24:32,122,8100,56,66,5254.09,10908.01,0.00
2024-12-10 17:24:32,121,8100,56,65,5279.53,10908.17,0.00
2024-12-10 17:24:32,120,8100,56,64,5316.17,10908.23,0.00
2024-12-10 17:24:32,120,8101,56,64,5264.29,10909.00,0.00
2024-12-10 17:24:32,121,8101,56,65,5220.78,10909.01,0.00
2024-12-10 17:24:32,120,8101,56,64,5248.89,10909.13,0.00
2024-12-10 17:24:32,119,8101,56,63,5289.35,10909.16,0.00
2024-12-10 17:24:32,118,8101,56,62,5298.59,10909.44,0.00
2024-12-10 17:24:32,117,8101,55,62,5298.66,10909.63,0.00
2024-12-10 17:24:32,117,8102,55,62,5327.49,10910.00,0.00
2024-12-10 17:24:32,118,8102,55,63,5282.34,10910.01,0.00
2024-12-10 17:24:32,117,8102,55,62,5310.70,10910.11,0.00
2024-12-10 17:24:32,116,8102,55,61,5350.86,10910.16,0.00
2024-12-10 17:24:32,115,8102,54,61,5354.82,10910.50,0.00
2024-12-10 17:24:32,115,8103,54,61,5368.15,10911.00,0.00
2024-12-10 17:24:32,116,8103,55,61,5321.87,10911.01,0.00
2024-12-10 17:24:32,115,8103,55,60,5357.73,10911.10,0.00
2024-12-10 17:24:32,114,8103,54,60,5398.06,10911.15,0.00
2024-12-10 17:24:32,114,8104,54,60,5369.84,10912.00,0.00
2024-12-10 17:24:32,115,8104,54,61,5323.14,10912.01,0.00
2024-12-10 17:24:32,115,8105,54,61,5277.27,10913.00,0.00
2024-12-10 17:24:32,116,8105,54,62,5231.78,10913.01,0.00
2024-12-10 17:24:32,115,8105,53,62,5274.43,10913.03,0.00
2024-12-10 17:24:32,114,8105,53,61,5306.38,10913.15,0.00
2024-12-10 17:24:32,113,8105,53,60,5352.37,10913.15,0.00
2024-12-10 17:24:32,113,8106,53,60,5311.73,10914.00,0.00
2024-12-10 17:24:32,114,8106,54,60,5265.13,10914.01,0.00
2024-12-10 17:24:32,114,8107,54,60,5195.40,10915.00,0.00
2024-12-10 17:24:32,115,8107,54,61,5150.23,10915.01,0.00
2024-12-10 17:24:32,114,8107,53,61,5179.17,10915.15,0.00
2024-12-10 17:24:32,113,8107,52,61,5136.39,10915.58,0.00
2024-12-10 17:24:32,113,8108,52,61,5167.42,10916.00,0.00
2024-12-10 17:24:32,114,8108,53,61,5122.09,10916.01,0.00
2024-12-10 17:24:32,113,8108,52,61,5151.04,10916.15,0.00
2024-12-10 17:24:32,112,8108,52,60,5133.18,10916.54,0.00
2024-12-10 17:24:32,112,8109,52,60,5154.03,10917.00,0.00
2024-12-10 17:24:32,113,8109,52,61,5108.42,10917.01,0.00
2024-12-10 17:24:32,112,8109,52,60,5149.17,10917.04,0.00
2024-12-10 17:24:32,111,8109,52,59,5183.78,10917.14,0.00
2024-12-10 17:24:32,110,8109,52,58,5229.92,10917.15,0.00
2024-12-10 17:24:32,109,8109,52,57,5234.31,10917.48,0.00
2024-12-10 17:24:32,108,8109,52,56,5269.44,10917.60,0.00
2024-12-10 17:24:32,108,8110,52,56,5290.93,10918.00,0.00
2024-12-10 17:24:32,109,8110,52,57,5242.39,10918.01,0.00
2024-12-10 17:24:32,108,8110,51,57,5287.90,10918.03,0.00
2024-12-10 17:24:32,107,8110,51,56,5333.25,10918.06,0.00
2024-12-10 17:24:32,106,8110,51,55,5377.40,10918.10,0.00
2024-12-10 17:24:32,105,8110,51,54,5425.51,10918.12,0.00
2024-12-10 17:24:32,104,8110,50,54,5476.63,10918.13,0.00
2024-12-10 17:24:32,103,8110,49,54,5528.74,10918.13,0.00
2024-12-10 17:24:32,103,8111,49,54,5489.07,10919.00,0.00
2024-12-10 17:24:32,104,8111,49,55,5436.29,10919.01,0.00
2024-12-10 17:24:32,103,8111,49,54,5399.11,10919.63,0.00
2024-12-10 17:24:32,103,8112,49,54,5458.37,10920.00,0.00
2024-12-10 17:24:32,104,8112,49,55,5405.89,10920.01,0.00
2024-12-10 17:24:32,103,8112,49,54,5444.63,10920.13,0.00
2024-12-10 17:24:32,103,8113,49,54,5422.28,10921.00,0.00
2024-12-10 17:24:32,104,8113,49,55,5370.14,10921.01,0.00
2024-12-10 17:24:32,103,8113,49,54,5420.16,10921.02,0.00
2024-12-10 17:24:32,102,8113,48,54,5410.67,10921.52,0.00
2024-12-10 17:24:32,101,8113,48,53,5450.96,10921.57,0.00
2024-12-10 17:24:32,100,8113,47,53,5502.17,10921.58,0.00
2024-12-10 17:24:33,100,8114,47,53,5545.93,10922.00,0.00
2024-12-10 17:24:33,101,8114,47,54,5491.02,10922.01,0.00
2024-12-10 17:24:33,100,8114,46,54,5541.57,10922.04,0.00
2024-12-10 17:24:33,100,8115,46,54,5513.64,10923.00,0.00
2024-12-10 17:24:33,101,8115,46,55,5459.05,10923.01,0.00
2024-12-10 17:24:33,100,8115,46,54,5495.49,10923.17,0.00
2024-12-10 17:24:33,99,8115,45,54,5499.26,10923.58,0.00
2024-12-10 17:24:33,99,8116,45,54,5557.79,10924.00,0.00
2024-12-10 17:24:33,100,8116,45,55,5502.21,10924.01,0.00
2024-12-10 17:24:33,99,8116,45,54,5542.40,10924.14,0.00
2024-12-10 17:24:33,99,8117,45,54,5554.05,10925.00,0.00
2024-12-10 17:24:33,100,8117,45,55,5498.51,10925.01,0.00
2024-12-10 17:24:33,99,8117,44,55,5548.55,10925.05,0.00
2024-12-10 17:24:33,98,8117,43,55,5595.17,10925.13,0.00
2024-12-10 17:24:33,97,8117,42,55,5651.73,10925.13,0.00
2024-12-10 17:24:33,97,8118,42,55,5665.33,10926.00,0.00
2024-12-10 17:24:33,98,8118,43,55,5607.52,10926.01,0.00
2024-12-10 17:24:33,98,8119,43,55,5607.34,10927.00,0.00
2024-12-10 17:24:33,99,8119,44,55,5550.70,10927.01,0.00
2024-12-10 17:24:33,98,8119,43,55,5544.55,10927.55,0.00
2024-12-10 17:24:33,98,8120,43,55,5607.33,10928.00,0.00
2024-12-10 17:24:33,99,8120,43,56,5550.69,10928.01,0.00
2024-12-10 17:24:33,98,8120,42,56,5592.89,10928.13,0.00
2024-12-10 17:24:33,98,8121,42,56,5607.37,10929.00,0.00
2024-12-10 17:24:33,99,8121,43,56,5550.73,10929.01,0.00
2024-12-10 17:24:33,98,8121,43,55,5603.85,10929.04,0.00
2024-12-10 17:24:33,97,8121,42,55,5635.63,10929.28,0.00
2024-12-10 17:24:33,97,8122,42,55,5661.42,10930.00,0.00
2024-12-10 17:24:33,98,8122,43,55,5603.65,10930.01,0.00
2024-12-10 17:24:33,97,8122,42,55,5647.95,10930.12,0.00
2024-12-10 17:24:33,96,8122,41,55,5704.20,10930.15,0.00
2024-12-10 17:24:33,96,8122,41,55,5711.75,10931.00,0.00
2024-12-10 17:24:33,97,8122,42,55,5652.86,10931.01,0.00
2024-12-10 17:24:33,96,8122,41,55,5698.13,10931.13,0.00
2024-12-10 17:24:33,97,8121,42,55,5579.87,10931.69,0.00
2024-12-10 17:24:33,97,8122,42,55,5676.03,10932.00,0.00
2024-12-10 17:24:33,98,8122,43,55,5618.11,10932.01,0.00
2024-12-10 17:24:33,97,8122,43,54,5662.55,10932.12,0.00
2024-12-10 17:24:33,97,8123,43,54,5772.39,10933.00,0.00
2024-12-10 17:24:33,98,8123,44,54,5713.49,10933.01,0.00
2024-12-10 17:24:33,98,8124,44,54,5695.30,10934.00,0.00
2024-12-10 17:24:33,99,8124,44,55,5637.77,10934.01,0.00
2024-12-10 17:24:33,100,8123,44,56,5553.02,10934.29,0.00
2024-12-10 17:24:33,101,8122,45,56,5521.13,10934.89,0.00
2024-12-10 17:24:33,101,8123,45,56,5623.54,10935.00,0.00
2024-12-10 17:24:33,102,8123,45,57,5568.41,10935.01,0.00
2024-12-10 17:24:33,101,8123,45,56,5610.59,10935.12,0.00
2024-12-10 17:24:33,101,8124,45,56,5793.59,10936.00,0.00
2024-12-10 17:24:33,102,8124,46,56,5736.79,10936.01,0.00
2024-12-10 17:24:33,103,8123,46,57,5680.04,10936.04,0.00
2024-12-10 17:24:33,102,8123,45,57,5774.36,10936.13,0.00
2024-12-10 17:24:33,102,8124,45,57,5732.48,10937.00,0.00
2024-12-10 17:24:33,103,8124,45,58,5676.83,10937.01,0.00
2024-12-10 17:24:33,103,8125,45,58,5716.83,10938.00,0.00
2024-12-10 17:24:33,104,8125,45,59,5661.87,10938.01,0.00
2024-12-10 17:24:33,103,8125,45,58,5713.66,10938.03,0.00
2024-12-10 17:24:33,102,8125,44,58,5758.99,10938.12,0.00
2024-12-10 17:24:33,101,8125,44,57,5727.15,10938.82,0.00
2024-12-10 17:24:33,100,8125,43,57,5724.61,10938.96,0.00
2024-12-10 17:24:33,100,8126,43,57,5829.66,10939.00,0.00
2024-12-10 17:24:33,101,8126,43,58,5771.94,10939.01,0.00
2024-12-10 17:24:33,100,8126,42,58,5818.76,10939.10,0.00
2024-12-10 17:24:33,99,8126,42,57,5875.33,10939.11,0.00
2024-12-10 17:24:33,99,8127,42,57,5847.73,10940.00,0.00
2024-12-10 17:24:33,100,8127,43,57,5789.26,10940.01,0.00
2024-12-10 17:24:33,99,8127,43,56,5835.62,10940.11,0.00
2024-12-10 17:24:33,98,8127,42,56,5890.23,10940.15,0.00
2024-12-10 17:24:33,98,8128,42,56,5841.45,10941.00,0.00
2024-12-10 17:24:33,99,8128,43,56,5782.44,10941.01,0.00
2024-12-10 17:24:33,98,8128,43,55,5829.21,10941.11,0.00
2024-12-10 17:24:33,97,8128,43,54,5888.18,10941.11,0.00
2024-12-10 17:24:33,96,8128,43,53,5905.79,10941.39,0.00
2024-12-10 17:24:33,95,8128,43,52,5900.30,10941.84,0.00
2024-12-10 17:24:33,95,8129,43,52,5998.34,10942.00,0.00
2024-12-10 17:24:33,96,8129,43,53,5935.86,10942.01,0.00
2024-12-10 17:24:33,96,8130,43,53,5942.10,10943.00,0.00
2024-12-10 17:24:33,97,8130,43,54,5880.84,10943.01,0.00
2024-12-10 17:24:33,96,8130,43,53,5929.60,10943.11,0.00
2024-12-10 17:24:33,96,8131,43,53,5947.20,10944.00,0.00
2024-12-10 17:24:33,97,8131,43,54,5885.89,10944.01,0.00
2024-12-10 17:24:33,96,8131,42,54,5934.70,10944.11,0.00
2024-12-10 17:24:33,95,8131,42,53,5922.69,10944.78,0.00
2024-12-10 17:24:33,95,8132,42,53,6013.90,10945.00,0.00
2024-12-10 17:24:33,96,8132,43,53,5951.25,10945.01,0.00
2024-12-10 17:24:33,96,8133,43,53,5950.28,10946.00,0.00
2024-12-10 17:24:33,97,8133,44,53,5888.93,10946.01,0.00
2024-12-10 17:24:33,96,8133,44,52,5884.33,10946.44,0.00
2024-12-10 17:24:33,96,8134,44,52,5937.19,10947.00,0.00
2024-12-10 17:24:33,97,8134,44,53,5875.98,10947.01,0.00
2024-12-10 17:24:33,96,8134,44,52,5929.23,10947.07,0.00
2024-12-10 17:24:33,95,8134,43,52,5936.60,10947.57,0.00
2024-12-10 17:24:33,96,8133,43,53,5844.18,10947.86,0.00
2024-12-10 17:24:34,96,8134,43,53,5957.21,10948.00,0.00
2024-12-10 17:24:34,97,8134,43,54,5895.79,10948.01,0.00
2024-12-10 17:24:34,97,8135,43,54,6013.72,10949.00,0.00
2024-12-10 17:24:34,98,8135,43,55,5952.36,10949.01,0.00
2024-12-10 17:24:34,98,8136,43,55,5956.26,10950.00,0.00
2024-12-10 17:24:34,99,8136,44,55,5896.09,10950.01,0.00
2024-12-10 17:24:34,100,8135,44,56,5827.31,10950.12,0.00
2024-12-10 17:24:34,99,8135,44,55,5962.50,10950.12,0.00
2024-12-10 17:24:34,99,8136,44,55,5977.38,10951.00,0.00
2024-12-10 17:24:34,100,8136,44,56,5917.61,10951.01,0.00
2024-12-10 17:24:34,99,8136,43,56,5965.25,10951.11,0.00
2024-12-10 17:24:34,99,8137,43,56,6089.66,10952.00,0.00
2024-12-10 17:24:34,100,8137,44,56,6028.76,10952.01,0.00
2024-12-10 17:24:34,99,8137,43,56,6077.53,10952.11,0.00
2024-12-10 17:24:34,99,8138,43,56,6091.32,10953.00,0.00
2024-12-10 17:24:34,100,8138,44,56,6030.41,10953.01,0.00
2024-12-10 17:24:34,100,8139,44,56,6032.05,10954.00,0.00
2024-12-10 17:24:34,101,8139,45,56,5972.33,10954.01,0.00
2024-12-10 17:24:34,100,8139,44,56,6018.49,10954.12,0.00
2024-12-10 17:24:34,100,8140,44,56,6032.14,10955.00,0.00
2024-12-10 17:24:34,101,8140,44,57,5972.42,10955.01,0.00
2024-12-10 17:24:34,100,8140,44,56,6017.41,10955.12,0.00
2024-12-10 17:24:34,100,8141,44,56,6031.06,10956.00,0.00
2024-12-10 17:24:34,101,8141,45,56,5971.35,10956.01,0.00
2024-12-10 17:24:34,102,8140,45,57,5904.23,10956.11,0.00
2024-12-10 17:24:34,101,8140,44,57,6042.86,10956.13,0.00
2024-12-10 17:24:34,101,8141,44,57,6056.38,10957.00,0.00
2024-12-10 17:24:34,102,8141,44,58,5997.00,10957.01,0.00
2024-12-10 17:24:34,103,8140,45,58,5909.12,10957.27,0.00
2024-12-10 17:24:34,103,8141,45,58,6120.24,10958.00,0.00
2024-12-10 17:24:34,104,8141,46,58,6061.39,10958.01,0.00
2024-12-10 17:24:34,104,8142,46,58,6160.49,10959.00,0.00
2024-12-10 17:24:34,105,8142,46,59,6101.82,10959.01,0.00
2024-12-10 17:24:34,105,8143,46,59,6094.32,10960.00,0.00
2024-12-10 17:24:34,106,8143,46,60,6036.82,10960.01,0.00
2024-12-10 17:24:34,105,8143,46,59,6090.15,10960.04,0.00
2024-12-10 17:24:34,104,8143,45,59,6135.04,10960.12,0.00
2024-12-10 17:24:34,105,8142,45,60,6033.95,10960.52,0.00
2024-12-10 17:24:34,106,8141,45,61,5983.52,10960.92,0.00
2024-12-10 17:24:34,106,8142,45,61,6084.94,10961.00,0.00
2024-12-10 17:24:34,107,8142,46,61,6028.07,10961.01,0.00
2024-12-10 17:24:34,106,8142,46,60,6067.54,10961.12,0.00
2024-12-10 17:24:34,106,8143,46,60,6282.11,10962.00,0.00
2024-12-10 17:24:34,107,8143,47,60,6223.40,10962.01,0.00
2024-12-10 17:24:34,107,8144,47,60,6212.13,10963.00,0.00
2024-12-10 17:24:34,108,8144,48,60,6154.61,10963.01,0.00
2024-12-10 17:24:34,107,8144,48,59,6188.95,10963.12,0.00
2024-12-10 17:24:34,106,8144,47,59,6246.30,10963.12,0.00
2024-12-10 17:24:34,106,8145,47,59,6254.07,10964.00,0.00
2024-12-10 17:24:34,107,8145,47,60,6195.62,10964.01,0.00
2024-12-10 17:24:34,106,8145,47,59,6224.45,10964.12,0.00
2024-12-10 17:24:34,106,8146,47,59,6232.22,10965.00,0.00
2024-12-10 17:24:34,107,8146,48,59,6173.97,10965.01,0.00
2024-12-10 17:24:34,106,8146,48,58,6205.31,10965.09,0.00
2024-12-10 17:24:34,106,8147,48,58,6209.97,10966.00,0.00
2024-12-10 17:24:34,107,8147,48,59,6151.94,10966.01,0.00
2024-12-10 17:24:34,107,8148,48,59,6146.35,10967.00,0.00
2024-12-10 17:24:34,108,8148,49,59,6089.44,10967.01,0.00
2024-12-10 17:24:34,108,8149,49,59,6082.88,10968.00,0.00
2024-12-10 17:24:34,109,8149,50,59,6027.08,10968.01,0.00
2024-12-10 17:24:34,108,8149,50,58,6078.83,10968.04,0.00
2024-12-10 17:24:34,107,8149,49,58,6127.47,10968.10,0.00
2024-12-10 17:24:34,107,8150,49,58,6132.09,10969.00,0.00
2024-12-10 17:24:34,108,8150,50,58,6075.32,10969.01,0.00
2024-12-10 17:24:34,109,8149,50,59,5926.42,10969.88,0.00
2024-12-10 17:24:34,109,8150,50,59,6025.16,10970.00,0.00
2024-12-10 17:24:34,110,8150,51,59,5970.38,10970.01,0.00
2024-12-10 17:24:34,111,8149,52,59,5892.93,10970.24,0.00
2024-12-10 17:24:34,112,8148,52,60,5874.77,10970.62,0.00
2024-12-10 17:24:34,112,8149,52,60,6049.57,10971.00,0.00
2024-12-10 17:24:34,113,8149,52,61,5996.03,10971.01,0.00
2024-12-10 17:24:34,112,8149,52,60,6038.82,10971.10,0.00
2024-12-10 17:24:34,112,8150,52,60,6233.79,10972.00,0.00
2024-12-10 17:24:34,113,8150,53,60,6178.63,10972.01,0.00
2024-12-10 17:24:34,113,8151,53,60,6166.68,10973.00,0.00
2024-12-10 17:24:34,114,8151,54,60,6112.58,10973.01,0.00
2024-12-10 17:24:34,114,8152,54,60,6099.53,10974.00,0.00
2024-12-10 17:24:34,115,8152,55,60,6046.49,10974.01,0.00
2024-12-10 17:24:34,114,8152,54,60,6098.57,10974.01,0.00
2024-12-10 17:24:34,113,8152,53,60,6143.82,10974.08,0.00
2024-12-10 17:24:34,112,8152,52,60,6197.70,10974.08,0.00
2024-12-10 17:24:34,111,8152,51,60,6252.55,10974.08,0.00
2024-12-10 17:24:35,111,8153,51,60,6248.92,10975.00,0.00
2024-12-10 17:24:35,112,8153,52,60,6193.13,10975.01,0.00
2024-12-10 17:24:35,113,8152,53,60,6053.22,10975.81,0.00
2024-12-10 17:24:35,113,8153,53,60,6130.18,10976.00,0.00
2024-12-10 17:24:35,114,8153,54,60,6076.41,10976.01,0.00
2024-12-10 17:24:35,114,8154,54,60,6151.17,10977.00,0.00
2024-12-10 17:24:35,115,8154,55,60,6097.68,10977.01,0.00
2024-12-10 17:24:35,114,8154,54,60,6142.53,10977.08,0.00
2024-12-10 17:24:35,114,8155,54,60,6106.58,10978.00,0.00
2024-12-10 17:24:35,115,8155,55,60,6053.48,10978.01,0.00
2024-12-10 17:24:35,114,8155,55,59,6097.94,10978.08,0.00
2024-12-10 17:24:35,113,8155,55,58,6143.99,10978.15,0.00
2024-12-10 17:24:35,113,8156,55,58,6108.71,10979.00,0.00
2024-12-10 17:24:35,114,8156,56,58,6055.12,10979.01,0.00
2024-12-10 17:24:35,113,8156,56,57,6099.98,10979.08,0.00
2024-12-10 17:24:35,113,8157,56,57,6029.22,10980.00,0.00
2024-12-10 17:24:35,114,8157,57,57,5976.33,10980.01,0.00
2024-12-10 17:24:35,115,8156,58,57,5914.85,10980.11,0.00
2024-12-10 17:24:35,114,8156,57,57,6042.14,10980.14,0.00
2024-12-10 17:24:35,113,8156,56,57,6004.59,10980.75,0.00
2024-12-10 17:24:35,113,8157,56,57,6033.12,10981.00,0.00
2024-12-10 17:24:35,114,8157,57,57,5980.20,10981.01,0.00
2024-12-10 17:24:35,113,8157,56,57,5865.76,10981.95,0.00
2024-12-10 17:24:35,113,8158,56,57,6047.13,10982.00,0.00
2024-12-10 17:24:35,114,8158,57,57,5994.09,10982.01,0.00
2024-12-10 17:24:35,114,8159,57,57,5922.07,10983.00,0.00
2024-12-10 17:24:35,115,8159,57,58,5870.57,10983.01,0.00
2024-12-10 17:24:35,114,8159,57,57,5919.18,10983.03,0.00
2024-12-10 17:24:35,113,8159,56,57,5934.16,10983.12,0.00
2024-12-10 17:24:35,112,8159,55,57,5898.49,10983.81,0.00
2024-12-10 17:24:35,112,8160,55,57,5958.28,10984.00,0.00
2024-12-10 17:24:35,113,8160,55,58,5905.55,10984.01,0.00
2024-12-10 17:24:35,112,8160,54,58,5955.34,10984.03,0.00
2024-12-10 17:24:35,111,8160,53,58,6003.08,10984.07,0.00
2024-12-10 17:24:35,112,8159,53,59,5890.84,10984.63,0.00
2024-12-10 17:24:35,112,8160,53,59,5953.52,10985.00,0.00
2024-12-10 17:24:35,113,8160,53,60,5900.84,10985.01,0.00
2024-12-10 17:24:35,114,8159,54,60,5785.02,10985.50,0.00
2024-12-10 17:24:35,114,8160,54,60,5930.89,10986.00,0.00
2024-12-10 17:24:35,115,8160,54,61,5879.32,10986.01,0.00
2024-12-10 17:24:35,114,8160,53,61,5861.26,10986.39,0.00
2024-12-10 17:24:35,115,8159,54,61,5755.85,10986.90,0.00
2024-12-10 17:24:35,115,8160,54,61,5978.11,10987.00,0.00
2024-12-10 17:24:35,116,8160,55,61,5926.57,10987.01,0.00
2024-12-10 17:24:35,116,8161,55,61,5907.24,10988.00,0.00
2024-12-10 17:24:35,117,8161,55,62,5856.75,10988.01,0.00
2024-12-10 17:24:35,116,8161,54,62,5723.70,10988.89,0.00
2024-12-10 17:24:35,116,8162,54,62,5769.73,10989.00,0.00
2024-12-10 17:24:35,117,8162,54,63,5720.41,10989.01,0.00
2024-12-10 17:24:35,118,8161,54,64,5629.59,10989.40,0.00
2024-12-10 17:24:35,117,8161,54,63,5661.11,10989.67,0.00
2024-12-10 17:24:35,116,8161,53,63,5679.24,10989.87,0.00
2024-12-10 17:24:35,116,8162,53,63,5713.35,10990.00,0.00
2024-12-10 17:24:35,117,8162,53,64,5664.51,10990.01,0.00
2024-12-10 17:24:35,116,8162,53,63,5707.68,10990.05,0.00
2024-12-10 17:24:35,115,8162,53,62,5752.84,10990.07,0.00
2024-12-10 17:24:35,114,8162,52,62,5802.34,10990.07,0.00
2024-12-10 17:24:35,113,8162,51,62,5814.34,10990.39,0.00
2024-12-10 17:24:35,113,8163,51,62,5886.41,10991.00,0.00
2024-12-10 17:24:35,114,8163,51,63,5834.78,10991.01,0.00
2024-12-10 17:24:35,113,8163,51,62,5877.02,10991.07,0.00
2024-12-10 17:24:35,112,8163,50,62,5769.75,10991.96,0.00
2024-12-10 17:24:35,112,8164,50,62,5863.02,10992.00,0.00
2024-12-10 17:24:35,113,8164,50,63,5811.14,10992.01,0.00
2024-12-10 17:24:35,114,8163,50,64,5681.38,10992.69,0.00
2024-12-10 17:24:35,113,8163,49,64,5737.92,10992.88,0.00
2024-12-10 17:24:35,113,8164,49,64,5791.17,10993.00,0.00
2024-12-10 17:24:35,114,8164,50,64,5740.38,10993.01,0.00
2024-12-10 17:24:35,113,8164,49,64,5686.63,10993.88,0.00
2024-12-10 17:24:35,113,8165,49,64,5867.69,10994.00,0.00
2024-12-10 17:24:35,114,8165,50,64,5816.22,10994.01,0.00
2024-12-10 17:24:35,114,8166,50,64,5793.30,10995.00,0.00
2024-12-10 17:24:35,115,8166,51,64,5742.92,10995.01,0.00
2024-12-10 17:24:35,114,8166,50,64,5785.61,10995.07,0.00
2024-12-10 17:24:35,114,8167,50,64,5767.85,10996.00,0.00
2024-12-10 17:24:35,115,8167,51,64,5717.70,10996.01,0.00
2024-12-10 17:24:35,114,8167,51,63,5764.96,10996.03,0.00
2024-12-10 17:24:35,113,8167,50,63,5811.14,10996.06,0.00
2024-12-10 17:24:35,112,8167,50,62,5862.04,10996.06,0.00
2024-12-10 17:24:35,112,8168,50,62,5842.43,10997.00,0.00
2024-12-10 17:24:35,113,8168,51,62,5790.73,10997.01,0.00
2024-12-10 17:24:35,112,8168,51,61,5835.58,10997.06,0.00
2024-12-10 17:24:35,111,8168,51,60,5862.54,10997.21,0.00
2024-12-10 17:24:35,111,8169,51,60,5874.92,10998.00,0.00
2024-12-10 17:24:35,112,8169,52,60,5822.47,10998.01,0.00
2024-12-10 17:24:35,111,8169,52,59,5868.01,10998.06,0.00
2024-12-10 17:24:35,111,8170,52,59,5864.56,10999.00,0.00
2024-12-10 17:24:35,112,8170,53,59,5812.19,10999.01,0.00
2024-12-10 17:24:35,111,8170,53,58,5857.65,10999.06,0.00
2024-12-10 17:24:35,112,8169,53,59,5780.82,10999.30,0.00
2024-12-10 17:24:35,112,8170,53,59,5870.67,11000.00,0.00
2024-12-10 17:24:35,113,8170,53,60,5818.72,11000.01,0.00
2024-12-10 17:24:36,112,8170,52,60,5863.82,11000.06,0.00
2024-12-10 17:24:36,111,8170,52,59,5913.96,11000.08,0.00
2024-12-10 17:24:36,111,8171,52,59,6011.60,11001.00,0.00
2024-12-10 17:24:36,112,8171,52,60,5957.92,11001.01,0.00
2024-12-10 17:24:36,113,8170,53,60,5902.28,11001.05,0.00
2024-12-10 17:24:36,112,8170,53,59,6001.17,11001.07,0.00
2024-12-10 17:24:36,112,8171,53,59,5997.75,11002.00,0.00
2024-12-10 17:24:36,113,8171,53,60,5944.68,11002.01,0.00
2024-12-10 17:24:36,112,8171,52,60,5995.79,11002.02,0.00
2024-12-10 17:24:36,112,8172,52,60,6084.75,11003.00,0.00
2024-12-10 17:24:36,113,8172,52,61,6030.90,11003.01,0.00
2024-12-10 17:24:36,112,8172,51,61,6077.91,11003.06,0.00
2024-12-10 17:24:36,113,8171,51,62,5993.03,11003.36,0.00
2024-12-10 17:24:36,113,8172,51,62,6082.09,11004.00,0.00
2024-12-10 17:24:36,114,8172,52,62,6028.74,11004.01,0.00
2024-12-10 17:24:36,113,8172,52,61,6075.30,11004.06,0.00
2024-12-10 17:24:36,113,8173,52,61,6167.37,11005.00,0.00
2024-12-10 17:24:36,114,8173,52,62,6113.27,11005.01,0.00
2024-12-10 17:24:36,113,8173,51,62,6160.58,11005.06,0.00
2024-12-10 17:24:36,113,8174,51,62,6155.27,11006.00,0.00
2024-12-10 17:24:36,114,8174,52,62,6101.27,11006.01,0.00
2024-12-10 17:24:36,113,8174,51,62,6148.48,11006.06,0.00
2024-12-10 17:24:36,113,8175,51,62,6143.17,11007.00,0.00
2024-12-10 17:24:36,114,8175,51,63,6089.28,11007.01,0.00
2024-12-10 17:24:36,113,8175,51,62,6136.38,11007.06,0.00
2024-12-10 17:24:36,113,8176,51,62,6128.92,11008.00,0.00
2024-12-10 17:24:36,114,8176,52,62,6075.16,11008.01,0.00
2024-12-10 17:24:36,113,8176,52,61,6122.13,11008.06,0.00
2024-12-10 17:24:36,113,8177,52,61,6113.50,11009.00,0.00
2024-12-10 17:24:36,114,8177,52,62,6059.87,11009.01,0.00
2024-12-10 17:24:36,113,8177,52,61,6106.71,11009.06,0.00
2024-12-10 17:24:36,113,8178,52,61,6096.68,11010.00,0.00
2024-12-10 17:24:36,114,8178,53,61,6043.20,11010.01,0.00
2024-12-10 17:24:36,113,8178,53,60,6089.88,11010.06,0.00
2024-12-10 17:24:36,114,8177,54,60,6023.92,11010.19,0.00
2024-12-10 17:24:36,115,8176,55,60,5938.21,11010.60,0.00
2024-12-10 17:24:36,115,8177,55,60,6020.80,11011.00,0.00
2024-12-10 17:24:36,116,8177,56,60,5968.89,11011.01,0.00
2024-12-10 17:24:36,115,8177,55,60,6014.12,11011.06,0.00
2024-12-10 17:24:36,115,8178,55,60,6187.23,11012.00,0.00
2024-12-10 17:24:36,116,8178,56,60,6133.90,11012.01,0.00
2024-12-10 17:24:36,115,8178,56,59,6180.56,11012.06,0.00
2024-12-10 17:24:36,116,8177,56,60,6103.60,11012.29,0.00
2024-12-10 17:24:36,116,8178,56,60,6173.89,11013.00,0.00
2024-12-10 17:24:36,117,8178,56,61,6121.12,11013.01,0.00
2024-12-10 17:24:36,117,8179,56,61,6184.63,11014.00,0.00
2024-12-10 17:24:36,118,8179,56,62,6132.22,11014.01,0.00
2024-12-10 17:24:36,117,8179,55,62,6178.07,11014.06,0.00
2024-12-10 17:24:36,117,8180,55,62,6141.39,11015.00,0.00
2024-12-10 17:24:36,118,8180,55,63,6089.34,11015.01,0.00
2024-12-10 17:24:36,117,8180,55,62,6134.82,11015.06,0.00
2024-12-10 17:24:36,117,8181,55,62,6074.08,11016.00,0.00
2024-12-10 17:24:36,118,8181,56,62,6022.60,11016.01,0.00
2024-12-10 17:24:36,117,8181,55,62,6067.51,11016.06,0.00
2024-12-10 17:24:36,118,8180,55,63,5946.03,11016.70,0.00
2024-12-10 17:24:36,117,8180,55,62,6026.59,11016.70,0.00
2024-12-10 17:24:36,117,8181,55,62,6061.73,11017.00,0.00
2024-12-10 17:24:36,118,8181,56,62,6010.35,11017.01,0.00
2024-12-10 17:24:36,117,8181,56,61,6055.16,11017.06,0.00
2024-12-10 17:24:36,117,8182,56,61,6084.38,11018.00,0.00
2024-12-10 17:24:36,118,8182,57,61,6032.82,11018.01,0.00
2024-12-10 17:24:36,117,8182,57,60,6077.81,11018.06,0.00
2024-12-10 17:24:36,118,8181,57,61,5995.58,11018.36,0.00
2024-12-10 17:24:36,118,8182,57,61,6006.68,11019.00,0.00
2024-12-10 17:24:36,119,8182,57,62,5956.20,11019.01,0.00
2024-12-10 17:24:36,118,8182,57,61,6000.16,11019.06,0.00
2024-12-10 17:24:36,119,8181,58,61,5899.91,11019.53,0.00
2024-12-10 17:24:36,118,8181,57,61,5901.42,11019.91,0.00
2024-12-10 17:24:36,118,8182,57,61,6070.93,11020.00,0.00
2024-12-10 17:24:36,119,8182,58,61,6019.92,11020.01,0.00
2024-12-10 17:24:36,118,8182,58,60,6064.42,11020.06,0.00
2024-12-10 17:24:36,119,8181,59,60,5949.81,11020.66,0.00
2024-12-10 17:24:36,120,8180,59,61,5884.73,11020.84,0.00
2024-12-10 17:24:36,120,8181,59,61,6054.18,11021.00,0.00
2024-12-10 17:24:36,121,8181,60,61,6004.15,11021.01,0.00
2024-12-10 17:24:36,120,8181,60,60,6047.77,11021.06,0.00
2024-12-10 17:24:36,120,8182,60,60,6170.69,11022.00,0.00
2024-12-10 17:24:36,121,8182,61,60,6119.69,11022.01,0.00
2024-12-10 17:24:36,120,8182,61,59,6164.28,11022.06,0.00
2024-12-10 17:24:36,119,8182,60,59,6133.80,11022.70,0.00
2024-12-10 17:24:36,119,8183,60,59,6158.81,11023.00,0.00
2024-12-10 17:24:36,120,8183,61,59,6107.48,11023.01,0.00
2024-12-10 17:24:36,120,8184,61,59,6043.00,11024.00,0.00
2024-12-10 17:24:36,121,8184,61,60,5993.06,11024.01,0.00
2024-12-10 17:24:36,120,8184,60,60,5943.42,11024.70,0.00
2024-12-10 17:24:36,120,8185,60,60,5979.42,11025.00,0.00
2024-12-10 17:24:36,121,8185,61,60,5930.00,11025.01,0.00
2024-12-10 17:24:36,120,8185,61,59,5973.01,11025.06,0.00
2024-12-10 17:24:37,120,8186,61,59,5915.28,11026.00,0.00
2024-12-10 17:24:37,121,8186,62,59,5866.39,11026.01,0.00
2024-12-10 17:24:37,120,8186,61,59,5908.87,11026.06,0.00
2024-12-10 17:24:37,121,8185,61,60,5781.08,11026.64,0.00
2024-12-10 17:24:37,122,8184,61,61,5747.10,11026.74,0.00
2024-12-10 17:24:37,122,8185,61,61,5819.21,11027.00,0.00
2024-12-10 17:24:37,123,8185,61,62,5771.90,11027.01,0.00
2024-12-10 17:24:37,122,8185,60,62,5752.21,11027.59,0.00
2024-12-10 17:24:37,121,8185,59,62,5783.93,11027.66,0.00
2024-12-10 17:24:37,121,8186,59,62,5990.59,11028.00,0.00
2024-12-10 17:24:37,122,8186,60,62,5941.48,11028.01,0.00
2024-12-10 17:24:37,122,8187,60,62,5880.80,11029.00,0.00
2024-12-10 17:24:37,123,8187,61,62,5832.99,11029.01,0.00
2024-12-10 17:24:37,124,8186,61,63,5715.51,11029.62,0.00
2024-12-10 17:24:37,124,8187,61,63,5762.17,11030.00,0.00
2024-12-10 17:24:37,125,8187,61,64,5716.07,11030.01,0.00
2024-12-10 17:24:37,125,8188,61,64,5709.85,11031.00,0.00
2024-12-10 17:24:37,126,8188,62,64,5664.53,11031.01,0.00
2024-12-10 17:24:37,125,8188,61,64,5704.57,11031.05,0.00
2024-12-10 17:24:37,124,8188,60,64,5747.91,11031.06,0.00
2024-12-10 17:24:37,125,8187,60,65,5575.91,11031.71,0.00
2024-12-10 17:24:37,124,8187,59,65,5632.47,11031.73,0.00
2024-12-10 17:24:37,124,8188,59,65,5676.36,11032.00,0.00
2024-12-10 17:24:37,125,8188,60,65,5630.95,11032.01,0.00
2024-12-10 17:24:37,124,8188,59,65,5669.27,11032.06,0.00
2024-12-10 17:24:37,123,8188,58,65,5602.36,11032.67,0.00
2024-12-10 17:24:37,122,8188,57,65,5616.79,11032.87,0.00
2024-12-10 17:24:37,122,8189,57,65,5774.40,11033.00,0.00
2024-12-10 17:24:37,123,8189,57,66,5727.45,11033.01,0.00
2024-12-10 17:24:37,122,8189,56,66,5767.19,11033.07,0.00
2024-12-10 17:24:37,121,8189,55,66,5725.32,11033.62,0.00
2024-12-10 17:24:37,121,8190,55,66,5760.69,11034.00,0.00
2024-12-10 17:24:37,122,8190,56,66,5713.48,11034.01,0.00
2024-12-10 17:24:37,121,8190,56,65,5753.42,11034.07,0.00
2024-12-10 17:24:37,122,8189,57,65,5580.81,11034.93,0.00
2024-12-10 17:24:37,122,8190,57,65,5666.81,11035.00,0.00
2024-12-10 17:24:37,123,8190,57,66,5620.74,11035.01,0.00
2024-12-10 17:24:37,122,8190,57,65,5658.69,11035.07,0.00
2024-12-10 17:24:37,122,8191,57,65,5695.96,11036.00,0.00
2024-12-10 17:24:37,123,8191,57,66,5649.65,11036.01,0.00
2024-12-10 17:24:37,122,8191,56,66,5695.05,11036.01,0.00
2024-12-10 17:24:37,121,8191,55,66,5734.85,11036.07,0.00
2024-12-10 17:24:37,122,8190,55,67,5594.36,11036.67,0.00
2024-12-10 17:24:37,122,8191,55,67,5720.80,11037.00,0.00
2024-12-10 17:24:37,123,8191,55,68,5674.29,11037.01,0.00
2024-12-10 17:24:37,124,8190,55,69,5624.98,11037.06,0.00
2024-12-10 17:24:37,123,8190,55,68,5690.48,11037.08,0.00
2024-12-10 17:24:37,122,8190,55,67,5661.92,11037.55,0.00
2024-12-10 17:24:37,122,8191,55,67,5766.07,11038.00,0.00
2024-12-10 17:24:37,123,8191,56,67,5719.19,11038.01,0.00
2024-12-10 17:24:37,122,8191,56,66,5757.96,11038.07,0.00
2024-12-10 17:24:37,121,8191,56,65,5770.17,11038.38,0.00
2024-12-10 17:24:37,121,8192,56,65,5857.59,11039.00,0.00
2024-12-10 17:24:37,122,8192,56,66,5809.57,11039.01,0.00
2024-12-10 17:24:37,123,8191,57,66,5676.49,11039.69,0.00
2024-12-10 17:24:37,122,8191,57,65,5734.17,11039.79,0.00
2024-12-10 17:24:37,122,8192,57,65,5791.74,11040.00,0.00
2024-12-10 17:24:37,123,8192,58,65,5744.66,11040.01,0.00
2024-12-10 17:24:37,122,8192,57,65,5782.73,11040.08,0.00
2024-12-10 17:24:37,122,8193,57,65,5824.77,11041.00,0.00
2024-12-10 17:24:37,123,8193,57,66,5777.42,11041.01,0.00
2024-12-10 17:24:37,123,8194,57,66,5699.48,11042.00,0.00
2024-12-10 17:24:37,124,8194,58,66,5653.51,11042.01,0.00
2024-12-10 17:24:37,125,8193,58,67,5604.76,11042.06,0.00
2024-12-10 17:24:37,124,8193,58,66,5648.21,11042.10,0.00
2024-12-10 17:24:37,125,8192,59,66,5590.67,11042.22,0.00
2024-12-10 17:24:37,124,8192,59,65,5655.02,11042.61,0.00
2024-12-10 17:24:37,123,8192,58,65,5652.18,11042.76,0.00
2024-12-10 17:24:37,123,8193,58,65,5692.49,11043.00,0.00
2024-12-10 17:24:37,124,8193,59,65,5646.59,11043.01,0.00
2024-12-10 17:24:37,123,8193,59,64,5682.65,11043.09,0.00
2024-12-10 17:24:37,123,8194,59,64,5813.75,11044.00,0.00
2024-12-10 17:24:37,124,8194,60,64,5766.86,11044.01,0.00
2024-12-10 17:24:37,123,8194,60,63,5803.91,11044.09,0.00
2024-12-10 17:24:37,123,8195,60,63,5730.57,11045.00,0.00
2024-12-10 17:24:37,124,8195,60,64,5684.36,11045.01,0.00
2024-12-10 17:24:37,123,8195,59,64,5720.73,11045.09,0.00
2024-12-10 17:24:37,122,8195,59,63,5710.75,11045.43,0.00
2024-12-10 17:24:37,123,8194,60,63,5617.29,11045.62,0.00
2024-12-10 17:24:37,122,8194,59,63,5616.12,11045.88,0.00
2024-12-10 17:24:37,122,8195,59,63,5685.56,11046.00,0.00
2024-12-10 17:24:37,123,8195,59,64,5639.34,11046.01,0.00
2024-12-10 17:24:37,122,8195,58,64,5675.64,11046.09,0.00
2024-12-10 17:24:37,122,8196,58,64,5618.98,11047.00,0.00
2024-12-10 17:24:37,123,8196,59,64,5573.30,11047.01,0.00
2024-12-10 17:24:37,122,8196,59,63,5609.05,11047.09,0.00
2024-12-10 17:24:37,121,8196,59,62,5654.50,11047.09,0.00
2024-12-10 17:24:37,120,8196,58,62,5614.35,11047.47,0.00
2024-12-10 17:24:37,119,8196,57,62,5641.31,11047.56,0.00
2024-12-10 17:24:37,120,8195,57,63,5556.02,11047.82,0.00
2024-12-10 17:24:37,120,8196,57,63,5614.50,11048.00,0.00
2024-12-10 17:24:37,121,8196,58,63,5568.10,11048.01,0.00
2024-12-10 17:24:37,120,8196,58,62,5542.23,11048.45,0.00
2024-12-10 17:24:37,119,8196,57,62,5494.12,11048.80,0.00
2024-12-10 17:24:37,118,8196,57,61,5525.38,11048.82,0.00
2024-12-10 17:24:37,117,8196,57,60,5563.45,11048.85,0.00
2024-12-10 17:24:38,117,8197,57,60,5684.44,11049.00,0.00
2024-12-10 17:24:38,118,8197,58,60,5636.27,11049.01,0.00
2024-12-10 17:24:38,117,8197,57,60,5681.95,11049.03,0.00
2024-12-10 17:24:38,116,8197,57,59,5722.40,11049.09,0.00
2024-12-10 17:24:38,115,8197,56,59,5738.47,11049.30,0.00
2024-12-10 17:24:38,115,8198,56,59,5666.09,11050.00,0.00
2024-12-10 17:24:38,116,8198,56,60,5617.24,11050.01,0.00
2024-12-10 17:24:38,115,8198,55,60,5655.55,11050.10,0.00
2024-12-10 17:24:38,114,8198,55,59,5704.20,11050.10,0.00
2024-12-10 17:24:38,113,8198,55,58,5538.52,11050.98,0.00
2024-12-10 17:24:38,113,8199,55,58,5634.37,11051.00,0.00
2024-12-10 17:24:38,114,8199,56,58,5584.94,11051.01,0.00
2024-12-10 17:24:38,113,8199,56,57,5623.65,11051.10,0.00
2024-12-10 17:24:38,114,8198,57,57,5495.52,11051.63,0.00
2024-12-10 17:24:38,113,8198,57,56,5596.77,11051.66,0.00
2024-12-10 17:24:38,113,8199,57,56,5550.62,11052.00,0.00
2024-12-10 17:24:38,114,8199,57,57,5501.93,11052.01,0.00
2024-12-10 17:24:38,115,8198,57,58,5418.41,11052.15,0.00
2024-12-10 17:24:38,114,8198,57,57,5434.19,11052.81,0.00
2024-12-10 17:24:38,113,8198,57,56,5458.81,11052.82,0.00
2024-12-10 17:24:38,113,8199,57,56,5578.90,11053.00,0.00
2024-12-10 17:24:38,114,8199,58,56,5529.96,11053.01,0.00
2024-12-10 17:24:38,113,8199,57,56,5546.39,11053.11,0.00
2024-12-10 17:24:38,112,8199,56,56,5527.99,11053.56,0.00
2024-12-10 17:24:38,111,8199,55,56,5479.41,11053.89,0.00
2024-12-10 17:24:38,112,8198,55,57,5428.53,11053.92,0.00
2024-12-10 17:24:38,112,8199,55,57,5624.02,11054.00,0.00
2024-12-10 17:24:38,113,8199,56,57,5574.25,11054.01,0.00
2024-12-10 17:24:38,112,8199,55,57,5577.11,11054.11,0.00
2024-12-10 17:24:38,111,8199,55,56,5626.89,11054.11,0.00
2024-12-10 17:24:38,110,8199,54,56,5542.06,11054.81,0.00
2024-12-10 17:24:38,110,8200,54,56,5721.54,11055.00,0.00
2024-12-10 17:24:38,111,8200,55,56,5669.99,11055.01,0.00
2024-12-10 17:24:38,110,8200,54,56,5694.39,11055.04,0.00
2024-12-10 17:24:38,109,8200,54,55,5661.98,11055.71,0.00
2024-12-10 17:24:38,109,8201,54,55,5717.74,11056.00,0.00
2024-12-10 17:24:38,110,8201,54,56,5665.76,11056.01,0.00
2024-12-10 17:24:38,109,8201,54,55,5716.73,11056.01,0.00
2024-12-10 17:24:38,109,8202,54,55,5673.37,11057.00,0.00
2024-12-10 17:24:38,110,8202,55,55,5621.79,11057.01,0.00
2024-12-10 17:24:38,109,8202,55,54,5662.25,11057.10,0.00
2024-12-10 17:24:38,109,8203,55,54,5612.34,11058.00,0.00
2024-12-10 17:24:38,110,8203,56,54,5561.31,11058.01,0.00
2024-12-10 17:24:38,109,8203,55,54,5601.21,11058.10,0.00
2024-12-10 17:24:38,108,8203,55,53,5571.51,11058.73,0.00
2024-12-10 17:24:38,108,8204,55,53,5592.10,11059.00,0.00
2024-12-10 17:24:38,109,8204,56,53,5540.80,11059.01,0.00
2024-12-10 17:24:38,108,8204,56,52,5580.87,11059.10,0.00
2024-12-10 17:24:38,109,8203,56,53,5479.08,11059.58,0.00
2024-12-10 17:24:38,108,8203,55,53,5517.03,11059.83,0.00
2024-12-10 17:24:38,108,8204,55,53,5600.50,11060.00,0.00
2024-12-10 17:24:38,109,8204,55,54,5549.12,11060.01,0.00
2024-12-10 17:24:38,108,8204,55,53,5589.27,11060.10,0.00
2024-12-10 17:24:38,107,8204,55,52,5640.47,11060.10,0.00
2024-12-10 17:24:38,107,8205,55,52,5719.79,11061.00,0.00
2024-12-10 17:24:38,108,8205,56,52,5666.83,11061.01,0.00
2024-12-10 17:24:38,107,8205,55,52,5707.42,11061.11,0.00
2024-12-10 17:24:38,107,8206,55,52,5669.78,11062.00,0.00
2024-12-10 17:24:38,108,8206,55,53,5617.28,11062.01,0.00
2024-12-10 17:24:38,107,8206,54,53,5657.41,11062.11,0.00
2024-12-10 17:24:38,107,8207,54,53,5596.62,11063.00,0.00
2024-12-10 17:24:38,108,8207,55,53,5544.80,11063.01,0.00
2024-12-10 17:24:38,107,8207,54,53,5584.25,11063.11,0.00
2024-12-10 17:24:38,107,8208,54,53,5505.07,11064.00,0.00
2024-12-10 17:24:38,108,8208,55,53,5454.10,11064.01,0.00
2024-12-10 17:24:38,107,8208,55,52,5492.70,11064.11,0.00
2024-12-10 17:24:38,106,8208,54,52,5463.66,11064.65,0.00
2024-12-10 17:24:38,105,8208,53,52,5482.92,11064.77,0.00
2024-12-10 17:24:38,105,8209,53,52,5550.27,11065.00,0.00
2024-12-10 17:24:38,106,8209,54,52,5497.91,11065.01,0.00
2024-12-10 17:24:38,106,8210,54,52,5446.51,11066.00,0.00
2024-12-10 17:24:38,107,8210,55,52,5395.61,11066.01,0.00
2024-12-10 17:24:38,106,8210,55,51,5434.02,11066.11,0.00
2024-12-10 17:24:38,105,8210,54,51,5388.99,11066.71,0.00
2024-12-10 17:24:38,105,8211,54,51,5425.45,11067.00,0.00
2024-12-10 17:24:38,106,8211,55,51,5374.26,11067.01,0.00
2024-12-10 17:24:38,105,8211,54,51,5412.83,11067.11,0.00
2024-12-10 17:24:38,104,8211,53,51,5461.63,11067.14,0.00
2024-12-10 17:24:38,105,8210,54,51,5358.47,11067.51,0.00
2024-12-10 17:24:38,105,8211,54,51,5420.59,11068.00,0.00
2024-12-10 17:24:38,106,8211,54,52,5369.46,11068.01,0.00
2024-12-10 17:24:38,105,8211,53,52,5407.98,11068.11,0.00
2024-12-10 17:24:38,104,8211,53,51,5425.47,11068.33,0.00
2024-12-10 17:24:38,103,8211,52,51,5371.45,11068.83,0.00
2024-12-10 17:24:38,102,8211,52,50,5406.77,11068.91,0.00
2024-12-10 17:24:38,102,8212,52,50,5601.41,11069.00,0.00
2024-12-10 17:24:38,103,8212,52,51,5547.03,11069.01,0.00
2024-12-10 17:24:38,102,8212,51,51,5588.42,11069.12,0.00
2024-12-10 17:24:38,101,8212,51,50,5592.65,11069.35,0.00
2024-12-10 17:24:39,101,8213,51,50,5585.79,11070.00,0.00
2024-12-10 17:24:39,102,8213,52,50,5531.03,11070.01,0.00
2024-12-10 17:24:39,101,8213,52,49,5581.41,11070.04,0.00
2024-12-10 17:24:39,102,8212,52,50,5506.11,11070.25,0.00
2024-12-10 17:24:39,103,8211,52,51,5506.34,11070.49,0.00
2024-12-10 17:24:39,103,8212,52,51,5529.30,11071.00,0.00
2024-12-10 17:24:39,104,8212,53,51,5476.13,11071.01,0.00
2024-12-10 17:24:39,103,8212,53,50,5516.44,11071.12,0.00
2024-12-10 17:24:39,102,8212,53,49,5428.69,11071.64,0.00
2024-12-10 17:24:39,102,8213,53,49,5645.39,11072.00,0.00
2024-12-10 17:24:39,103,8213,53,50,5590.58,11072.01,0.00
2024-12-10 17:24:39,102,8213,52,50,5632.39,11072.12,0.00
2024-12-10 17:24:39,101,8213,51,50,5651.13,11072.28,0.00
2024-12-10 17:24:39,100,8213,51,49,5589.42,11072.52,0.00
2024-12-10 17:24:39,99,8213,50,49,5597.01,11072.69,0.00
2024-12-10 17:24:39,99,8214,50,49,5638.46,11073.00,0.00
2024-12-10 17:24:39,100,8214,50,50,5582.08,11073.01,0.00
2024-12-10 17:24:39,99,8214,49,50,5625.07,11073.12,0.00
2024-12-10 17:24:39,98,8214,48,50,5650.21,11073.28,0.00
2024-12-10 17:24:39,97,8214,47,50,5693.14,11073.36,0.00
2024-12-10 17:24:39,97,8215,47,50,5678.43,11074.00,0.00
2024-12-10 17:24:39,98,8215,48,50,5620.49,11074.01,0.00
2024-12-10 17:24:39,97,8215,47,50,5664.76,11074.12,0.00
2024-12-10 17:24:39,96,8215,46,50,5610.60,11074.92,0.00
2024-12-10 17:24:39,96,8216,46,50,5696.90,11075.00,0.00
2024-12-10 17:24:39,97,8216,46,51,5638.17,11075.01,0.00
2024-12-10 17:24:39,96,8216,45,51,5683.09,11075.13,0.00
2024-12-10 17:24:39,95,8216,45,50,5693.85,11075.41,0.00
2024-12-10 17:24:39,95,8217,45,50,5724.60,11076.00,0.00
2024-12-10 17:24:39,96,8217,46,50,5664.97,11076.01,0.00
2024-12-10 17:24:39,95,8217,46,49,5586.93,11076.95,0.00
2024-12-10 17:24:39,95,8218,46,49,5697.74,11077.00,0.00
2024-12-10 17:24:39,96,8218,46,50,5638.39,11077.01,0.00
2024-12-10 17:24:39,95,8218,45,50,5683.78,11077.13,0.00
2024-12-10 17:24:39,95,8219,45,50,5661.78,11078.00,0.00
2024-12-10 17:24:39,96,8219,46,50,5602.81,11078.01,0.00
2024-12-10 17:24:39,95,8219,46,49,5563.83,11078.60,0.00
2024-12-10 17:24:39,95,8220,46,49,5636.45,11079.00,0.00
2024-12-10 17:24:39,96,8220,47,49,5577.74,11079.01,0.00
2024-12-10 17:24:39,97,8219,48,49,5511.11,11079.11,0.00
2024-12-10 17:24:39,96,8219,47,49,5595.08,11079.14,0.00
2024-12-10 17:24:39,96,8220,47,49,5590.88,11080.00,0.00
2024-12-10 17:24:39,97,8220,48,49,5533.24,11080.01,0.00
2024-12-10 17:24:39,96,8220,48,48,5588.57,11080.02,0.00
2024-12-10 17:24:39,95,8220,47,48,5635.76,11080.12,0.00
2024-12-10 17:24:39,94,8220,46,48,5694.54,11080.12,0.00
2024-12-10 17:24:39,93,8220,45,48,5693.12,11080.52,0.00
2024-12-10 17:24:39,94,8219,45,49,5598.59,11080.84,0.00
2024-12-10 17:24:39,94,8220,45,49,5832.14,11081.00,0.00
2024-12-10 17:24:39,95,8220,46,49,5770.75,11081.01,0.00
2024-12-10 17:24:39,95,8221,46,49,5893.99,11082.00,0.00
2024-12-10 17:24:39,96,8221,47,49,5832.59,11082.01,0.00
2024-12-10 17:24:39,96,8222,47,49,5824.63,11083.00,0.00
2024-12-10 17:24:39,97,8222,48,49,5764.58,11083.01,0.00
2024-12-10 17:24:39,96,8222,48,48,5811.95,11083.11,0.00
2024-12-10 17:24:39,96,8223,48,48,5799.97,11084.00,0.00
2024-12-10 17:24:39,97,8223,49,48,5740.18,11084.01,0.00
2024-12-10 17:24:39,96,8223,49,47,5793.05,11084.06,0.00
2024-12-10 17:24:39,95,8223,49,46,5848.22,11084.11,0.00
2024-12-10 17:24:39,96,8222,49,47,5775.77,11084.23,0.00
2024-12-10 17:24:39,95,8222,48,47,5865.14,11084.52,0.00
2024-12-10 17:24:39,95,8223,48,47,5928.53,11085.00,0.00
2024-12-10 17:24:39,96,8223,49,47,5866.78,11085.01,0.00
2024-12-10 17:24:39,95,8223,49,46,5925.03,11085.03,0.00
2024-12-10 17:24:39,94,8223,48,46,5978.66,11085.11,0.00
2024-12-10 17:24:39,95,8222,48,47,5838.00,11085.78,0.00
2024-12-10 17:24:39,95,8223,48,47,6066.92,11086.00,0.00
2024-12-10 17:24:39,96,8223,48,48,6003.72,11086.01,0.00
2024-12-10 17:24:39,95,8223,48,47,6055.28,11086.11,0.00
2024-12-10 17:24:39,94,8223,48,46,6079.57,11086.43,0.00
2024-12-10 17:24:39,94,8224,48,46,6252.20,11087.00,0.00
2024-12-10 17:24:39,95,8224,48,47,6186.39,11087.01,0.00
2024-12-10 17:24:39,95,8225,48,47,6191.06,11088.00,0.00
2024-12-10 17:24:39,96,8225,48,48,6126.57,11088.01,0.00
2024-12-10 17:24:39,96,8226,48,48,6108.91,11089.00,0.00
2024-12-10 17:24:39,97,8226,49,48,6045.93,11089.01,0.00
2024-12-10 17:24:39,96,8226,48,48,6106.60,11089.02,0.00
2024-12-10 17:24:39,97,8225,49,48,6036.81,11089.10,0.00
2024-12-10 17:24:39,96,8225,49,47,6119.34,11089.10,0.00
2024-12-10 17:24:39,95,8225,49,46,6182.58,11089.11,0.00
2024-12-10 17:24:39,95,8226,49,46,6141.58,11090.00,0.00
2024-12-10 17:24:39,96,8226,49,47,6077.61,11090.01,0.00
2024-12-10 17:24:39,97,8225,49,48,5969.34,11090.44,0.00
2024-12-10 17:24:39,96,8225,49,47,6018.39,11090.54,0.00
2024-12-10 17:24:39,96,8226,49,47,6198.95,11091.00,0.00
2024-12-10 17:24:39,97,8226,50,47,6135.04,11091.01,0.00
2024-12-10 17:24:39,96,8226,50,46,6071.54,11091.46,0.00
2024-12-10 17:24:39,96,8227,50,46,6212.80,11092.00,0.00
2024-12-10 17:24:39,97,8227,51,46,6148.75,11092.01,0.00
2024-12-10 17:24:39,96,8227,51,45,6205.55,11092.06,0.00
2024-12-10 17:24:39,95,8227,51,44,6267.38,11092.08,0.00
2024-12-10 17:24:39,94,8227,51,43,6332.88,11092.08,0.00
2024-12-10 17:24:39,93,8227,50,43,6292.44,11092.41,0.00
2024-12-10 17:24:39,93,8228,50,43,6329.05,11093.00,0.00
2024-12-10 17:24:39,94,8228,51,43,6261.72,11093.01,0.00
2024-12-10 17:24:39,93,8228,51,42,6279.95,11093.37,0.00
2024-12-10 17:24:39,93,8229,51,42,6328.72,11094.00,0.00
2024-12-10 17:24:39,94,8229,51,43,6261.40,11094.01,0.00
2024-12-10 17:24:40,94,8230,51,43,6268.31,11095.00,0.00
2024-12-10 17:24:40,95,8230,52,43,6202.32,11095.01,0.00
2024-12-10 17:24:40,94,8230,52,42,6257.57,11095.08,0.00
2024-12-10 17:24:40,94,8231,52,42,6274.64,11096.00,0.00
2024-12-10 17:24:40,95,8231,52,43,6208.59,11096.01,0.00
2024-12-10 17:24:40,95,8232,52,43,6216.16,11097.00,0.00
2024-12-10 17:24:40,96,8232,53,43,6151.40,11097.01,0.00
2024-12-10 17:24:40,96,8233,53,43,6157.74,11098.00,0.00
2024-12-10 17:24:40,97,8233,53,44,6094.26,11098.01,0.00
2024-12-10 17:24:40,97,8234,53,44,6099.38,11099.00,0.00
2024-12-10 17:24:40,98,8234,53,45,6037.15,11099.01,0.00
2024-12-10 17:24:40,98,8235,53,45,6041.09,11100.00,0.00
2024-12-10 17:24:40,99,8235,53,46,5980.07,11100.01,0.00
2024-12-10 17:24:40,99,8236,53,46,5982.85,11101.00,0.00
2024-12-10 17:24:40,100,8236,54,46,5923.02,11101.01,0.00
2024-12-10 17:24:40,99,8236,54,45,5982.05,11101.01,0.00
2024-12-10 17:24:40,98,8236,54,44,6035.18,11101.07,0.00
2024-12-10 17:24:40,98,8237,54,44,6045.65,11102.00,0.00
2024-12-10 17:24:40,99,8237,54,45,5984.58,11102.01,0.00
2024-12-10 17:24:40,99,8238,54,45,5986.94,11103.00,0.00
2024-12-10 17:24:40,100,8238,54,46,5927.07,11103.01,0.00
2024-12-10 17:24:40,99,8238,54,45,5985.82,11103.01,0.00
2024-12-10 17:24:40,98,8238,54,44,6040.12,11103.06,0.00
2024-12-10 17:24:40,98,8239,54,44,6049.69,11104.00,0.00
2024-12-10 17:24:40,99,8239,54,45,5988.58,11104.01,0.00
2024-12-10 17:24:40,100,8238,54,46,5894.33,11104.34,0.00
2024-12-10 17:24:40,100,8239,54,46,5996.91,11105.00,0.00
2024-12-10 17:24:40,101,8239,55,46,5937.53,11105.01,0.00
2024-12-10 17:24:40,101,8240,55,46,6039.87,11106.00,0.00
2024-12-10 17:24:40,102,8240,55,47,5980.65,11106.01,0.00
2024-12-10 17:24:40,102,8241,55,47,5969.35,11107.00,0.00
2024-12-10 17:24:40,103,8241,55,48,5911.39,11107.01,0.00
2024-12-10 17:24:40,102,8241,55,47,5960.66,11107.08,0.00
2024-12-10 17:24:40,101,8241,55,46,6000.04,11107.25,0.00
2024-12-10 17:24:40,101,8242,55,46,6015.04,11108.00,0.00
2024-12-10 17:24:40,102,8242,55,47,5956.07,11108.01,0.00
2024-12-10 17:24:40,101,8242,54,47,5972.40,11108.32,0.00
2024-12-10 17:24:40,101,8243,54,47,6006.84,11109.00,0.00
2024-12-10 17:24:40,102,8243,54,48,5947.95,11109.01,0.00
2024-12-10 17:24:40,101,8243,54,47,5998.07,11109.08,0.00
2024-12-10 17:24:40,101,8244,54,47,6004.71,11110.00,0.00
2024-12-10 17:24:40,102,8244,55,47,5945.84,11110.01,0.00
2024-12-10 17:24:40,101,8244,55,46,6000.31,11110.04,0.00
2024-12-10 17:24:40,100,8244,54,46,6055.89,11110.07,0.00
2024-12-10 17:24:40,100,8245,54,46,6061.00,11111.00,0.00
2024-12-10 17:24:40,101,8245,55,46,6000.99,11111.01,0.00
2024-12-10 17:24:40,100,8245,54,46,6053.25,11111.07,0.00
2024-12-10 17:24:40,100,8246,54,46,6056.78,11112.00,0.00
2024-12-10 17:24:40,101,8246,54,47,5996.82,11112.01,0.00
2024-12-10 17:24:40,100,8246,53,47,6055.67,11112.01,0.00
2024-12-10 17:24:40,99,8246,53,46,6110.13,11112.06,0.00
2024-12-10 17:24:40,99,8247,53,46,6113.46,11113.00,0.00
2024-12-10 17:24:40,100,8247,54,46,6052.32,11113.01,0.00
2024-12-10 17:24:40,99,8247,54,45,6106.75,11113.06,0.00
2024-12-10 17:24:40,99,8248,54,45,6110.95,11114.00,0.00
2024-12-10 17:24:40,100,8248,54,46,6049.84,11114.01,0.00
2024-12-10 17:24:40,99,8248,54,45,6104.23,11114.06,0.00
2024-12-10 17:24:40,98,8248,53,45,6159.16,11114.12,0.00
2024-12-10 17:24:40,99,8247,53,46,6080.15,11114.29,0.00
2024-12-10 17:24:40,99,8248,53,46,6208.89,11115.00,0.00
2024-12-10 17:24:40,100,8248,53,47,6146.80,11115.01,0.00
2024-12-10 17:24:40,99,8248,53,46,6202.17,11115.06,0.00
2024-12-10 17:24:40,99,8249,53,46,6316.47,11116.00,0.00
2024-12-10 17:24:40,100,8249,53,47,6253.30,11116.01,0.00
2024-12-10 17:24:40,99,8249,52,47,6309.75,11116.06,0.00
2024-12-10 17:24:40,99,8250,52,47,6311.86,11117.00,0.00
2024-12-10 17:24:40,100,8250,53,47,6248.75,11117.01,0.00
2024-12-10 17:24:40,101,8249,54,47,6183.59,11117.06,0.00
2024-12-10 17:24:40,100,8249,53,47,6278.79,11117.07,0.00
2024-12-10 17:24:40,100,8250,53,47,6280.70,11118.00,0.00
2024-12-10 17:24:40,101,8250,54,47,6218.51,11118.01,0.00
2024-12-10 17:24:40,100,8250,53,47,6279.59,11118.01,0.00
2024-12-10 17:24:40,99,8250,52,47,6337.43,11118.05,0.00
2024-12-10 17:24:40,98,8250,52,46,6400.96,11118.05,0.00
2024-12-10 17:24:40,98,8251,52,46,6516.40,11119.00,0.00
2024-12-10 17:24:40,99,8251,53,46,6450.58,11119.01,0.00
2024-12-10 17:24:40,98,8251,52,46,6510.75,11119.05,0.00
2024-12-10 17:24:40,98,8252,52,46,6514.96,11120.00,0.00
2024-12-10 17:24:40,99,8252,52,47,6449.15,11120.01,0.00
2024-12-10 17:24:40,99,8253,52,47,6449.49,11121.00,0.00
2024-12-10 17:24:40,100,8253,52,48,6384.99,11121.01,0.00
2024-12-10 17:24:40,99,8253,52,47,6435.69,11121.13,0.00
2024-12-10 17:24:40,99,8254,52,47,6448.24,11122.00,0.00
2024-12-10 17:24:40,100,8254,53,47,6383.76,11122.01,0.00
2024-12-10 17:24:40,99,8254,52,47,6442.65,11122.05,0.00
2024-12-10 17:24:41,99,8255,52,47,6445.00,11123.00,0.00
2024-12-10 17:24:41,100,8255,53,47,6380.55,11123.01,0.00
2024-12-10 17:24:41,99,8255,52,47,6439.40,11123.05,0.00
2024-12-10 17:24:41,99,8256,52,47,6438.78,11124.00,0.00
2024-12-10 17:24:41,100,8256,52,48,6374.39,11124.01,0.00
2024-12-10 17:24:41,100,8257,52,48,6349.01,11125.00,0.00
2024-12-10 17:24:41,101,8257,52,49,6286.15,11125.01,0.00
2024-12-10 17:24:41,100,8257,51,49,6343.47,11125.05,0.00
2024-12-10 17:24:41,100,8258,51,49,6298.83,11126.00,0.00
2024-12-10 17:24:41,101,8258,51,50,6236.47,11126.01,0.00
2024-12-10 17:24:41,100,8258,50,50,6293.29,11126.05,0.00
2024-12-10 17:24:41,99,8258,49,50,6268.19,11126.52,0.00
2024-12-10 17:24:41,99,8259,49,50,6317.31,11127.00,0.00
2024-12-10 17:24:41,100,8259,50,50,6254.14,11127.01,0.00
2024-12-10 17:24:41,99,8259,50,49,6311.71,11127.05,0.00
2024-12-10 17:24:41,98,8259,50,48,6286.86,11127.60,0.00
2024-12-10 17:24:41,98,8260,50,48,6355.52,11128.00,0.00
2024-12-10 17:24:41,99,8260,50,49,6291.32,11128.01,0.00
2024-12-10 17:24:41,98,8260,49,49,6349.86,11128.05,0.00
2024-12-10 17:24:41,97,8260,48,49,6400.58,11128.13,0.00
2024-12-10 17:24:41,97,8261,48,49,6412.17,11129.00,0.00
2024-12-10 17:24:41,98,8261,49,49,6346.74,11129.01,0.00
2024-12-10 17:24:41,98,8262,49,49,6344.22,11130.00,0.00
2024-12-10 17:24:41,99,8262,49,50,6280.14,11130.01,0.00
2024-12-10 17:24:41,99,8263,49,50,6280.12,11131.00,0.00
2024-12-10 17:24:41,100,8263,49,51,6217.32,11131.01,0.00
2024-12-10 17:24:41,99,8263,48,51,6275.64,11131.04,0.00
2024-12-10 17:24:41,99,8264,48,51,6280.69,11132.00,0.00
2024-12-10 17:24:41,100,8264,48,52,6217.89,11132.01,0.00
2024-12-10 17:24:41,100,8265,48,52,6214.92,11133.00,0.00
2024-12-10 17:24:41,101,8265,49,52,6153.39,11133.01,0.00
2024-12-10 17:24:41,102,8264,50,52,6060.90,11133.29,0.00
2024-12-10 17:24:41,102,8265,50,52,6157.90,11134.00,0.00
2024-12-10 17:24:41,103,8265,51,52,6098.11,11134.01,0.00
2024-12-10 17:24:41,102,8265,50,52,6153.55,11134.04,0.00
2024-12-10 17:24:41,101,8265,50,51,6205.43,11134.12,0.00
2024-12-10 17:24:41,101,8266,50,51,6326.31,11135.00,0.00
2024-12-10 17:24:41,102,8266,51,51,6264.29,11135.01,0.00
2024-12-10 17:24:41,102,8267,51,51,6263.13,11136.00,0.00
2024-12-10 17:24:41,103,8267,52,51,6202.33,11136.01,0.00
2024-12-10 17:24:41,102,8267,52,50,6258.78,11136.04,0.00
2024-12-10 17:24:41,102,8268,52,50,6261.10,11137.00,0.00
2024-12-10 17:24:41,103,8268,52,51,6200.32,11137.01,0.00
2024-12-10 17:24:41,103,8269,52,51,6198.68,11138.00,0.00
2024-12-10 17:24:41,104,8269,52,52,6139.08,11138.01,0.00
2024-12-10 17:24:41,104,8270,52,52,6132.09,11139.00,0.00
2024-12-10 17:24:41,105,8270,53,52,6073.69,11139.01,0.00
2024-12-10 17:24:41,105,8271,53,52,6057.40,11140.00,0.00
2024-12-10 17:24:41,106,8271,53,53,6000.26,11140.01,0.00
2024-12-10 17:24:41,106,8272,53,53,5972.95,11141.00,0.00
2024-12-10 17:24:41,107,8272,53,54,5917.13,11141.01,0.00
2024-12-10 17:24:41,106,8272,53,53,5876.07,11141.68,0.00
2024-12-10 17:24:41,106,8273,53,53,5945.71,11142.00,0.00
2024-12-10 17:24:41,107,8273,54,53,5890.14,11142.01,0.00
2024-12-10 17:24:41,108,8272,55,53,5751.33,11142.79,0.00
2024-12-10 17:24:41,108,8273,55,53,5853.67,11143.00,0.00
2024-12-10 17:24:41,109,8273,56,53,5799.96,11143.01,0.00
2024-12-10 17:24:41,109,8274,56,53,5894.55,11144.00,0.00
2024-12-10 17:24:41,110,8274,57,53,5840.96,11144.01,0.00
2024-12-10 17:24:41,110,8275,57,53,5831.43,11145.00,0.00
2024-12-10 17:24:41,111,8275,57,54,5778.90,11145.01,0.00
2024-12-10 17:24:41,110,8275,57,53,5826.39,11145.05,0.00
2024-12-10 17:24:41,110,8276,57,53,5820.25,11146.00,0.00
2024-12-10 17:24:41,111,8276,58,53,5767.82,11146.01,0.00
2024-12-10 17:24:41,111,8277,58,53,5757.16,11147.00,0.00
2024-12-10 17:24:41,112,8277,59,53,5705.76,11147.01,0.00
2024-12-10 17:24:41,112,8278,59,53,5693.93,11148.00,0.00
2024-12-10 17:24:41,113,8278,60,53,5643.55,11148.01,0.00
2024-12-10 17:24:41,112,8278,59,53,5688.98,11148.04,0.00
2024-12-10 17:24:41,112,8279,59,53,5678.98,11149.00,0.00
2024-12-10 17:24:41,113,8279,59,54,5628.73,11149.01,0.00
2024-12-10 17:24:41,112,8279,58,54,5674.02,11149.04,0.00
2024-12-10 17:24:41,113,8278,58,55,5543.52,11149.78,0.00
2024-12-10 17:24:41,113,8279,58,55,5638.96,11150.00,0.00
2024-12-10 17:24:41,114,8279,59,55,5589.49,11150.01,0.00
2024-12-10 17:24:41,113,8279,59,54,5634.04,11150.04,0.00
2024-12-10 17:24:42,113,8280,59,54,5711.10,11151.00,0.00
2024-12-10 17:24:42,114,8280,60,54,5661.00,11151.01,0.00
2024-12-10 17:24:42,113,8280,59,54,5706.18,11151.04,0.00
2024-12-10 17:24:42,113,8281,59,54,5682.31,11152.00,0.00
2024-12-10 17:24:42,114,8281,60,54,5632.47,11152.01,0.00
2024-12-10 17:24:42,113,8281,60,53,5677.39,11152.04,0.00
2024-12-10 17:24:42,113,8282,60,53,5651.83,11153.00,0.00
2024-12-10 17:24:42,114,8282,61,53,5602.25,11153.01,0.00
2024-12-10 17:24:42,115,8281,62,53,5551.60,11153.04,0.00
2024-12-10 17:24:42,115,8282,62,53,5556.27,11154.00,0.00
2024-12-10 17:24:42,116,8282,62,54,5508.37,11154.01,0.00
2024-12-10 17:24:42,115,8282,61,54,5551.44,11154.04,0.00
2024-12-10 17:24:42,114,8282,61,53,5557.91,11154.36,0.00
2024-12-10 17:24:42,114,8283,61,53,5672.56,11155.00,0.00
2024-12-10 17:24:42,115,8283,62,53,5623.23,11155.01,0.00
2024-12-10 17:24:42,114,8283,61,53,5667.68,11155.04,0.00
2024-12-10 17:24:42,114,8283,61,53,5649.09,11156.00,0.00
2024-12-10 17:24:42,115,8283,61,54,5599.97,11156.01,0.00
2024-12-10 17:24:42,114,8283,61,53,5644.22,11156.04,0.00
2024-12-10 17:24:42,114,8284,61,53,5623.80,11157.00,0.00
2024-12-10 17:24:42,115,8284,62,53,5574.90,11157.01,0.00
2024-12-10 17:24:42,114,8284,61,53,5618.93,11157.04,0.00
2024-12-10 17:24:42,114,8285,61,53,5597.11,11158.00,0.00
2024-12-10 17:24:42,115,8285,62,53,5548.44,11158.01,0.00
2024-12-10 17:24:42,114,8285,61,53,5592.24,11158.04,0.00
2024-12-10 17:24:42,115,8284,61,54,5516.48,11158.30,0.00
2024-12-10 17:24:42,115,8285,61,54,5592.57,11159.00,0.00
2024-12-10 17:24:42,116,8285,61,55,5544.36,11159.01,0.00
2024-12-10 17:24:42,115,8285,60,55,5587.73,11159.04,0.00
2024-12-10 17:24:42,114,8285,60,54,5554.91,11159.67,0.00
2024-12-10 17:24:42,114,8286,60,54,5713.76,11160.00,0.00
2024-12-10 17:24:42,115,8286,61,54,5664.08,11160.01,0.00
2024-12-10 17:24:42,114,8286,61,53,5708.88,11160.04,0.00
2024-12-10 17:24:42,114,8287,61,53,5691.83,11161.00,0.00
2024-12-10 17:24:42,115,8287,61,54,5642.33,11161.01,0.00
2024-12-10 17:24:42,114,8287,60,54,5686.95,11161.04,0.00
2024-12-10 17:24:42,115,8286,61,54,5607.39,11161.33,0.00
2024-12-10 17:24:42,114,8286,60,54,5720.96,11161.36,0.00
2024-12-10 17:24:42,114,8287,60,54,5746.20,11162.00,0.00
2024-12-10 17:24:42,115,8287,61,54,5696.23,11162.01,0.00
2024-12-10 17:24:42,114,8287,61,53,5741.32,11162.04,0.00
2024-12-10 17:24:42,114,8288,61,53,5827.89,11163.00,0.00
2024-12-10 17:24:42,115,8288,62,53,5777.22,11163.01,0.00
2024-12-10 17:24:42,114,8288,61,53,5823.01,11163.04,0.00
2024-12-10 17:24:42,114,8289,61,53,5811.14,11164.00,0.00
2024-12-10 17:24:42,115,8289,62,53,5760.61,11164.01,0.00
2024-12-10 17:24:42,114,8289,61,53,5806.26,11164.04,0.00
2024-12-10 17:24:42,114,8290,61,53,5793.81,11165.00,0.00
2024-12-10 17:24:42,115,8290,62,53,5743.42,11165.01,0.00
2024-12-10 17:24:42,114,8290,61,53,5788.92,11165.04,0.00
2024-12-10 17:24:42,114,8291,61,53,5775.13,11166.00,0.00
2024-12-10 17:24:42,115,8291,61,54,5724.91,11166.01,0.00
2024-12-10 17:24:42,115,8292,61,54,5704.44,11167.00,0.00
2024-12-10 17:24:42,116,8292,61,55,5655.27,11167.01,0.00
2024-12-10 17:24:42,116,8293,61,55,5632.02,11168.00,0.00
2024-12-10 17:24:42,117,8293,62,55,5583.89,11168.01,0.00
2024-12-10 17:24:42,117,8294,62,55,5558.18,11169.00,0.00
2024-12-10 17:24:42,118,8294,62,56,5511.08,11169.01,0.00
2024-12-10 17:24:42,117,8294,62,55,5550.57,11169.07,0.00
2024-12-10 17:24:42,117,8295,62,55,5530.57,11170.00,0.00
2024-12-10 17:24:42,118,8295,63,55,5483.70,11170.01,0.00
2024-12-10 17:24:42,117,8295,62,55,5522.95,11170.07,0.00
2024-12-10 17:24:42,116,8295,62,54,5569.60,11170.07,0.00
2024-12-10 17:24:42,116,8296,62,54,5549.72,11171.00,0.00
2024-12-10 17:24:42,117,8296,62,55,5502.28,11171.01,0.00
2024-12-10 17:24:42,116,8296,61,55,5542.03,11171.07,0.00
2024-12-10 17:24:42,116,8297,61,55,5521.68,11172.00,0.00
2024-12-10 17:24:42,117,8297,61,56,5474.48,11172.01,0.00
2024-12-10 17:24:42,116,8297,61,55,5513.99,11172.07,0.00
2024-12-10 17:24:42,116,8298,61,55,5491.04,11173.00,0.00
2024-12-10 17:24:42,117,8298,62,55,5444.11,11173.01,0.00
2024-12-10 17:24:42,116,8298,62,54,5483.35,11173.07,0.00
2024-12-10 17:24:42,116,8299,62,54,5457.60,11174.00,0.00
2024-12-10 17:24:42,117,8299,62,55,5410.96,11174.01,0.00
2024-12-10 17:24:42,116,8299,61,55,5449.91,11174.07,0.00
2024-12-10 17:24:42,115,8299,61,54,5406.49,11174.77,0.00
2024-12-10 17:24:43,115,8300,61,54,5469.90,11175.00,0.00
2024-12-10 17:24:43,116,8300,62,54,5422.75,11175.01,0.00
2024-12-10 17:24:43,115,8300,62,53,5462.14,11175.07,0.00
2024-12-10 17:24:43,115,8301,62,53,5438.63,11176.00,0.00
2024-12-10 17:24:43,116,8301,63,53,5391.74,11176.01,0.00
2024-12-10 17:24:43,115,8301,62,53,5430.87,11176.07,0.00
2024-12-10 17:24:43,114,8301,61,53,5431.80,11176.47,0.00
2024-12-10 17:24:43,114,8302,61,53,5459.56,11177.00,0.00
2024-12-10 17:24:43,115,8302,62,53,5412.09,11177.01,0.00
2024-12-10 17:24:43,114,8302,62,52,5451.74,11177.07,0.00
2024-12-10 17:24:43,114,8303,62,52,5434.15,11178.00,0.00
2024-12-10 17:24:43,115,8303,62,53,5386.89,11178.01,0.00
2024-12-10 17:24:43,114,8303,61,53,5426.32,11178.07,0.00
2024-12-10 17:24:43,114,8304,61,53,5408.36,11179.00,0.00
2024-12-10 17:24:43,115,8304,61,54,5361.33,11179.01,0.00
2024-12-10 17:24:43,114,8304,60,54,5407.38,11179.01,0.00
2024-12-10 17:24:43,113,8304,59,54,5448.32,11179.06,0.00
2024-12-10 17:24:43,112,8304,58,54,5495.97,11179.06,0.00
2024-12-10 17:24:43,112,8305,58,54,5478.31,11180.00,0.00
2024-12-10 17:24:43,113,8305,58,55,5429.83,11180.01,0.00
2024-12-10 17:24:43,112,8305,57,55,5474.33,11180.04,0.00
2024-12-10 17:24:43,111,8305,56,55,5520.63,11180.05,0.00
2024-12-10 17:24:43,110,8305,56,54,5569.80,11180.05,0.00
2024-12-10 17:24:43,109,8305,55,54,5543.05,11180.72,0.00
2024-12-10 17:24:43,109,8306,55,54,5614.06,11181.00,0.00
2024-12-10 17:24:43,110,8306,55,55,5563.02,11181.01,0.00
2024-12-10 17:24:43,109,8306,54,55,5607.92,11181.05,0.00
2024-12-10 17:24:43,109,8307,54,55,5604.27,11182.00,0.00
2024-12-10 17:24:43,110,8307,54,56,5553.33,11182.01,0.00
2024-12-10 17:24:43,109,8307,53,56,5598.13,11182.05,0.00
2024-12-10 17:24:43,109,8308,53,56,5594.62,11183.00,0.00
2024-12-10 17:24:43,110,8308,54,56,5543.76,11183.01,0.00
2024-12-10 17:24:43,109,8308,53,56,5588.48,11183.05,0.00
2024-12-10 17:24:43,109,8309,53,56,5584.59,11184.00,0.00
2024-12-10 17:24:43,110,8309,53,57,5533.82,11184.01,0.00
2024-12-10 17:24:43,110,8309,53,57,5523.58,11185.00,0.00
2024-12-10 17:24:43,111,8309,53,58,5473.82,11185.01,0.00
2024-12-10 17:24:43,110,8309,52,58,5519.53,11185.04,0.00
2024-12-10 17:24:43,109,8309,51,58,5567.10,11185.05,0.00
2024-12-10 17:24:43,108,8309,51,57,5617.61,11185.06,0.00
2024-12-10 17:24:43,108,8310,51,57,5614.16,11186.00,0.00
2024-12-10 17:24:43,109,8310,51,58,5562.65,11186.01,0.00
2024-12-10 17:24:43,108,8310,51,57,5607.96,11186.06,0.00
2024-12-10 17:24:43,108,8311,51,57,5605.27,11187.00,0.00
2024-12-10 17:24:43,109,8311,51,58,5553.85,11187.01,0.00
2024-12-10 17:24:43,109,8312,51,58,5544.65,11188.00,0.00
2024-12-10 17:24:43,110,8312,52,58,5494.24,11188.01,0.00
2024-12-10 17:24:43,109,8312,52,57,5538.51,11188.05,0.00
2024-12-10 17:24:43,108,8312,51,57,5589.05,11188.06,0.00
2024-12-10 17:24:43,109,8311,51,58,5462.07,11188.74,0.00
2024-12-10 17:24:43,109,8312,51,58,5563.91,11189.00,0.00
2024-12-10 17:24:43,110,8312,52,58,5513.33,11189.01,0.00
2024-12-10 17:24:43,109,8312,52,57,5562.89,11189.01,0.00
2024-12-10 17:24:43,109,8313,52,57,5656.65,11190.00,0.00
2024-12-10 17:24:43,110,8313,53,57,5605.22,11190.01,0.00
2024-12-10 17:24:43,109,8313,53,56,5650.51,11190.05,0.00
2024-12-10 17:24:43,109,8314,53,56,5646.36,11191.00,0.00
2024-12-10 17:24:43,110,8314,53,57,5595.02,11191.01,0.00
2024-12-10 17:24:43,109,8314,52,57,5640.22,11191.05,0.00
2024-12-10 17:24:43,109,8315,52,57,5635.70,11192.00,0.00
2024-12-10 17:24:43,110,8315,52,58,5584.47,11192.01,0.00
2024-12-10 17:24:43,109,8315,51,58,5629.57,11192.05,0.00
2024-12-10 17:24:43,110,8314,51,59,5558.06,11192.25,0.00
2024-12-10 17:24:43,110,8315,51,59,5652.65,11193.00,0.00
2024-12-10 17:24:43,111,8315,52,59,5601.72,11193.01,0.00
2024-12-10 17:24:43,111,8316,52,59,5689.63,11194.00,0.00
2024-12-10 17:24:43,112,8316,52,60,5638.83,11194.01,0.00
2024-12-10 17:24:43,111,8316,52,59,5683.60,11194.05,0.00
2024-12-10 17:24:43,110,8316,52,58,5693.83,11194.38,0.00
2024-12-10 17:24:43,110,8317,52,58,5726.82,11195.00,0.00
2024-12-10 17:24:43,111,8317,53,58,5675.23,11195.01,0.00
2024-12-10 17:24:43,110,8317,52,58,5720.74,11195.05,0.00
2024-12-10 17:24:43,109,8317,52,57,5753.07,11195.23,0.00
2024-12-10 17:24:43,110,8316,53,57,5633.92,11195.85,0.00
2024-12-10 17:24:43,110,8317,53,57,5733.81,11196.00,0.00
2024-12-10 17:24:43,111,8317,54,57,5682.15,11196.01,0.00
2024-12-10 17:24:43,110,8317,54,56,5727.72,11196.05,0.00
2024-12-10 17:24:43,110,8318,54,56,5825.93,11197.00,0.00
2024-12-10 17:24:43,111,8318,54,57,5773.44,11197.01,0.00
2024-12-10 17:24:43,110,8318,53,57,5819.84,11197.05,0.00
2024-12-10 17:24:43,110,8319,53,57,5816.27,11198.00,0.00
2024-12-10 17:24:43,111,8319,54,57,5763.87,11198.01,0.00
2024-12-10 17:24:43,110,8319,54,56,5810.18,11198.05,0.00
2024-12-10 17:24:43,110,8320,54,56,5806.61,11199.00,0.00
2024-12-10 17:24:43,111,8320,55,56,5754.30,11199.01,0.00
2024-12-10 17:24:43,110,8320,55,55,5800.52,11199.05,0.00
2024-12-10 17:24:43,110,8321,55,55,5796.95,11200.00,0.00
2024-12-10 17:24:43,111,8321,56,55,5744.72,11200.01,0.00
2024-12-10 17:24:43,110,8321,56,54,5790.86,11200.05,0.00
2024-12-10 17:24:44,111,8320,57,54,5680.19,11200.59,0.00
2024-12-10 17:24:44,111,8321,57,54,5776.39,11201.00,0.00
2024-12-10 17:24:44,112,8321,58,54,5724.81,11201.01,0.00
2024-12-10 17:24:44,111,8321,57,54,5770.35,11201.05,0.00
2024-12-10 17:24:44,111,8322,57,54,5864.03,11202.00,0.00
2024-12-10 17:24:44,112,8322,57,55,5811.68,11202.01,0.00
2024-12-10 17:24:44,111,8322,57,54,5858.00,11202.05,0.00
2024-12-10 17:24:44,112,8321,58,54,5761.78,11202.46,0.00
2024-12-10 17:24:44,112,8322,58,54,5852.27,11203.00,0.00
2024-12-10 17:24:44,113,8322,58,55,5800.48,11203.01,0.00
2024-12-10 17:24:44,112,8322,58,54,5850.44,11203.02,0.00
2024-12-10 17:24:44,111,8322,58,53,5899.12,11203.04,0.00
2024-12-10 17:24:44,111,8323,58,53,5989.51,11204.00,0.00
2024-12-10 17:24:44,112,8323,58,54,5936.03,11204.01,0.00
2024-12-10 17:24:44,111,8323,58,53,5984.48,11204.04,0.00
2024-12-10 17:24:44,110,8323,58,52,6037.86,11204.05,0.00
2024-12-10 17:24:44,111,8322,58,53,5924.56,11204.54,0.00
2024-12-10 17:24:44,111,8323,58,53,6019.81,11205.00,0.00
2024-12-10 17:24:44,112,8323,58,54,5966.07,11205.01,0.00
2024-12-10 17:24:44,111,8323,57,54,6014.78,11205.04,0.00
2024-12-10 17:24:44,111,8324,57,54,6104.39,11206.00,0.00
2024-12-10 17:24:44,112,8324,58,54,6049.89,11206.01,0.00
2024-12-10 17:24:44,111,8324,58,53,6099.36,11206.04,0.00
2024-12-10 17:24:44,111,8325,58,53,6088.10,11207.00,0.00
2024-12-10 17:24:44,112,8325,59,53,6033.75,11207.01,0.00
2024-12-10 17:24:44,111,8325,59,52,6083.07,11207.04,0.00
2024-12-10 17:24:44,111,8326,59,52,6072.03,11208.00,0.00
2024-12-10 17:24:44,112,8326,59,53,6017.81,11208.01,0.00
2024-12-10 17:24:44,111,8326,59,52,6066.99,11208.04,0.00
2024-12-10 17:24:44,111,8327,59,52,6056.22,11209.00,0.00
2024-12-10 17:24:44,112,8327,59,53,6002.15,11209.01,0.00
2024-12-10 17:24:44,111,8327,58,53,6007.10,11209.41,0.00
2024-12-10 17:24:44,112,8326,59,53,5945.50,11209.50,0.00
2024-12-10 17:24:44,112,8327,59,53,6038.97,11210.00,0.00
2024-12-10 17:24:44,113,8327,59,54,5985.53,11210.01,0.00
2024-12-10 17:24:44,112,8327,58,54,6033.98,11210.04,0.00
2024-12-10 17:24:44,112,8328,58,54,6127.60,11211.00,0.00
2024-12-10 17:24:44,113,8328,58,55,6073.37,11211.01,0.00
2024-12-10 17:24:44,112,8328,57,55,6122.60,11211.04,0.00
2024-12-10 17:24:44,112,8329,57,55,6116.13,11212.00,0.00
2024-12-10 17:24:44,113,8329,58,55,6062.00,11212.01,0.00
2024-12-10 17:24:44,112,8329,58,54,6111.14,11212.04,0.00
2024-12-10 17:24:44,112,8330,58,54,6104.66,11213.00,0.00
2024-12-10 17:24:44,113,8330,58,55,6050.64,11213.01,0.00
2024-12-10 17:24:44,114,8329,58,56,5997.56,11213.03,0.00
2024-12-10 17:24:44,113,8329,57,56,6105.23,11213.05,0.00
2024-12-10 17:24:44,113,8330,57,56,6098.81,11214.00,0.00
2024-12-10 17:24:44,114,8330,57,57,6045.31,11214.01,0.00
2024-12-10 17:24:44,114,8331,57,57,6131.44,11215.00,0.00
2024-12-10 17:24:44,115,8331,58,57,6078.13,11215.01,0.00
2024-12-10 17:24:44,114,8331,58,56,6125.56,11215.05,0.00
2024-12-10 17:24:44,114,8332,58,56,6118.21,11216.00,0.00
2024-12-10 17:24:44,115,8332,58,57,6065.01,11216.01,0.00
2024-12-10 17:24:44,114,8332,58,56,6112.34,11216.05,0.00
2024-12-10 17:24:44,114,8333,58,56,6104.98,11217.00,0.00
2024-12-10 17:24:44,115,8333,58,57,6051.90,11217.01,0.00
2024-12-10 17:24:44,114,8333,57,57,6099.10,11217.05,0.00
2024-12-10 17:24:44,113,8333,56,57,6152.09,11217.05,0.00
2024-12-10 17:24:44,113,8334,56,57,6145.66,11218.00,0.00
2024-12-10 17:24:44,114,8334,56,58,6091.75,11218.01,0.00
2024-12-10 17:24:44,113,8334,55,58,6139.73,11218.05,0.00
2024-12-10 17:24:44,113,8335,55,58,6133.30,11219.00,0.00
2024-12-10 17:24:44,114,8335,55,59,6079.50,11219.01,0.00
2024-12-10 17:24:44,115,8334,55,60,5988.67,11219.37,0.00
2024-12-10 17:24:44,116,8333,56,60,5996.06,11219.40,0.00
2024-12-10 17:24:44,116,8334,56,60,6042.92,11220.00,0.00
2024-12-10 17:24:44,117,8334,57,60,5991.27,11220.01,0.00
2024-12-10 17:24:44,116,8334,57,59,6037.14,11220.05,0.00
2024-12-10 17:24:44,116,8335,57,59,6221.45,11221.00,0.00
2024-12-10 17:24:44,117,8335,58,59,6168.27,11221.01,0.00
2024-12-10 17:24:44,116,8335,58,58,6215.67,11221.05,0.00
2024-12-10 17:24:44,116,8336,58,58,6206.52,11222.00,0.00
2024-12-10 17:24:44,117,8336,59,58,6153.48,11222.01,0.00
2024-12-10 17:24:44,116,8336,58,58,6200.74,11222.05,0.00
2024-12-10 17:24:44,116,8337,58,58,6191.60,11223.00,0.00
2024-12-10 17:24:44,117,8337,59,58,6138.68,11223.01,0.00
2024-12-10 17:24:44,116,8337,58,58,6185.81,11223.05,0.00
2024-12-10 17:24:44,116,8338,58,58,6176.67,11224.00,0.00
2024-12-10 17:24:44,117,8338,58,59,6123.88,11224.01,0.00
2024-12-10 17:24:44,116,8338,58,58,6170.88,11224.05,0.00
2024-12-10 17:24:44,115,8338,57,58,6222.75,11224.06,0.00
2024-12-10 17:24:44,115,8339,57,58,6215.48,11225.00,0.00
2024-12-10 17:24:45,116,8339,57,59,6161.90,11225.01,0.00
2024-12-10 17:24:45,116,8340,57,59,6147.93,11226.00,0.00
2024-12-10 17:24:45,117,8340,58,59,6095.38,11226.01,0.00
2024-12-10 17:24:45,116,8340,58,58,6142.14,11226.05,0.00
2024-12-10 17:24:45,116,8341,58,58,6132.99,11227.00,0.00
2024-12-10 17:24:45,117,8341,59,58,6080.57,11227.01,0.00
2024-12-10 17:24:45,117,8342,59,58,6065.76,11228.00,0.00
2024-12-10 17:24:45,118,8342,60,58,6014.35,11228.01,0.00
2024-12-10 17:24:45,117,8342,60,57,6060.02,11228.05,0.00
2024-12-10 17:24:45,117,8343,60,57,6049.34,11229.00,0.00
2024-12-10 17:24:45,118,8343,60,58,5998.07,11229.01,0.00
2024-12-10 17:24:45,117,8343,59,58,6043.60,11229.05,0.00
2024-12-10 17:24:45,117,8344,59,58,6030.77,11230.00,0.00
2024-12-10 17:24:45,118,8344,59,59,5979.66,11230.01,0.00
2024-12-10 17:24:45,117,8344,59,58,6025.03,11230.05,0.00
2024-12-10 17:24:45,118,8343,59,59,5887.45,11230.79,0.00
2024-12-10 17:24:45,118,8344,59,59,5979.01,11231.00,0.00
2024-12-10 17:24:45,119,8344,59,60,5928.76,11231.01,0.00
2024-12-10 17:24:45,119,8345,59,60,5999.30,11232.00,0.00
2024-12-10 17:24:45,120,8345,60,60,5949.31,11232.01,0.00
2024-12-10 17:24:45,119,8345,60,59,5993.66,11232.05,0.00
2024-12-10 17:24:45,119,8346,60,59,5972.63,11233.00,0.00
2024-12-10 17:24:45,120,8346,61,59,5922.86,11233.01,0.00
2024-12-10 17:24:45,121,8345,62,59,5873.91,11233.02,0.00
2024-12-10 17:24:45,120,8345,62,58,5939.72,11233.03,0.00
2024-12-10 17:24:45,119,8345,61,58,5985.87,11233.05,0.00
2024-12-10 17:24:45,118,8345,60,58,6035.64,11233.05,0.00
2024-12-10 17:24:45,118,8346,60,58,6014.69,11234.00,0.00
2024-12-10 17:24:45,119,8346,61,58,5964.15,11234.01,0.00
2024-12-10 17:24:45,118,8346,60,58,6009.95,11234.04,0.00
2024-12-10 17:24:45,118,8347,60,58,6083.81,11235.00,0.00
2024-12-10 17:24:45,119,8347,60,59,6032.69,11235.01,0.00
2024-12-10 17:24:45,118,8347,59,59,6079.07,11235.04,0.00
2024-12-10 17:24:45,118,8348,59,59,6058.36,11236.00,0.00
2024-12-10 17:24:45,119,8348,60,59,6007.45,11236.01,0.00
2024-12-10 17:24:45,118,8348,59,59,6053.61,11236.04,0.00
2024-12-10 17:24:45,118,8349,59,59,6032.80,11237.00,0.00
2024-12-10 17:24:45,119,8349,60,59,5982.11,11237.01,0.00
2024-12-10 17:24:45,118,8349,60,58,6028.06,11237.04,0.00
2024-12-10 17:24:45,118,8350,60,58,6007.65,11238.00,0.00
2024-12-10 17:24:45,119,8350,61,58,5957.17,11238.01,0.00
2024-12-10 17:24:45,118,8350,61,57,6002.91,11238.04,0.00
2024-12-10 17:24:45,117,8350,60,57,6028.69,11238.26,0.00
2024-12-10 17:24:45,116,8350,59,57,6078.56,11238.27,0.00
2024-12-10 17:24:45,116,8351,59,57,6089.24,11239.00,0.00
2024-12-10 17:24:45,117,8351,59,58,6037.20,11239.01,0.00
2024-12-10 17:24:45,116,8351,58,58,6084.41,11239.04,0.00
2024-12-10 17:24:45,116,8352,58,58,6071.66,11240.00,0.00
2024-12-10 17:24:45,117,8352,59,58,6019.77,11240.01,0.00
2024-12-10 17:24:45,116,8352,59,57,6066.83,11240.04,0.00
2024-12-10 17:24:45,116,8353,59,57,6054.03,11241.00,0.00
2024-12-10 17:24:45,117,8353,60,57,6002.28,11241.01,0.00
2024-12-10 17:24:45,116,8353,60,56,6049.20,11241.04,0.00
2024-12-10 17:24:45,116,8354,60,56,6036.66,11242.00,0.00
2024-12-10 17:24:45,117,8354,60,57,5985.07,11242.01,0.00
2024-12-10 17:24:45,116,8354,59,57,6031.83,11242.04,0.00
2024-12-10 17:24:45,115,8354,58,57,6083.31,11242.04,0.00
2024-12-10 17:24:45,115,8355,58,57,6072.01,11243.00,0.00
2024-12-10 17:24:45,116,8355,59,57,6019.67,11243.01,0.00
2024-12-10 17:24:45,115,8355,58,57,6067.14,11243.04,0.00
2024-12-10 17:24:45,115,8356,58,57,6056.09,11244.00,0.00
2024-12-10 17:24:45,116,8356,59,57,6003.89,11244.01,0.00
2024-12-10 17:24:45,115,8356,58,57,6051.22,11244.04,0.00
2024-12-10 17:24:45,115,8357,58,57,6040.09,11245.00,0.00
2024-12-10 17:24:45,116,8357,59,57,5988.02,11245.01,0.00
2024-12-10 17:24:45,115,8357,59,56,6035.22,11245.04,0.00
2024-12-10 17:24:45,116,8356,60,56,5978.35,11245.10,0.00
2024-12-10 17:24:45,115,8356,59,56,6102.79,11245.23,0.00
2024-12-10 17:24:45,115,8357,59,56,6113.39,11246.00,0.00
2024-12-10 17:24:45,116,8357,59,57,6060.69,11246.01,0.00
2024-12-10 17:24:45,115,8357,58,57,6108.51,11246.04,0.00
2024-12-10 17:24:45,114,8357,57,57,6144.14,11246.19,0.00
2024-12-10 17:24:45,115,8356,58,57,6011.46,11246.90,0.00
2024-12-10 17:24:45,115,8357,58,57,6206.17,11247.00,0.00
2024-12-10 17:24:45,116,8357,59,57,6152.67,11247.01,0.00
2024-12-10 17:24:45,116,8358,59,57,6233.42,11248.00,0.00
2024-12-10 17:24:45,117,8358,59,58,6180.14,11248.01,0.00
2024-12-10 17:24:45,116,8358,58,58,6227.62,11248.05,0.00
2024-12-10 17:24:45,116,8359,58,58,6216.73,11249.00,0.00
2024-12-10 17:24:45,117,8359,58,59,6163.59,11249.01,0.00
2024-12-10 17:24:45,116,8359,58,58,6210.93,11249.05,0.00
2024-12-10 17:24:45,116,8360,58,58,6201.11,11250.00,0.00
2024-12-10 17:24:45,117,8360,59,58,6148.11,11250.01,0.00
2024-12-10 17:24:45,116,8360,58,58,6195.31,11250.05,0.00
2024-12-10 17:24:46,116,8361,58,58,6186.03,11251.00,0.00
2024-12-10 17:24:46,117,8361,59,58,6133.16,11251.01,0.00
2024-12-10 17:24:46,118,8360,60,58,6066.93,11251.15,0.00
2024-12-10 17:24:46,118,8361,60,58,6148.94,11252.00,0.00
2024-12-10 17:24:46,119,8361,61,58,6097.26,11252.01,0.00
2024-12-10 17:24:46,119,8362,61,58,6171.30,11253.00,0.00
2024-12-10 17:24:46,120,8362,62,58,6119.87,11253.01,0.00
2024-12-10 17:24:46,119,8362,61,58,6164.70,11253.06,0.00
2024-12-10 17:24:46,119,8363,61,58,6150.29,11254.00,0.00
2024-12-10 17:24:46,120,8363,62,58,6099.04,11254.01,0.00
2024-12-10 17:24:46,119,8363,62,57,6143.69,11254.06,0.00
2024-12-10 17:24:46,118,8363,62,56,6180.25,11254.16,0.00
2024-12-10 17:24:46,118,8364,62,56,6180.94,11255.00,0.00
2024-12-10 17:24:46,119,8364,63,56,6129.00,11255.01,0.00
2024-12-10 17:24:46,120,8363,63,57,5987.44,11255.82,0.00
2024-12-10 17:24:46,120,8364,63,57,6078.59,11256.00,0.00
2024-12-10 17:24:46,121,8364,63,58,6028.35,11256.01,0.00
2024-12-10 17:24:46,120,8364,63,57,6071.11,11256.07,0.00
2024-12-10 17:24:46,120,8365,63,57,6152.30,11257.00,0.00
2024-12-10 17:24:46,121,8365,63,58,6101.46,11257.01,0.00
2024-12-10 17:24:46,120,8365,62,58,6144.82,11257.07,0.00
2024-12-10 17:24:46,120,8366,62,58,6132.36,11258.00,0.00
2024-12-10 17:24:46,121,8366,62,59,6081.68,11258.01,0.00
2024-12-10 17:24:46,120,8366,62,58,6130.49,11258.02,0.00
2024-12-10 17:24:46,120,8367,62,58,6113.46,11259.00,0.00
2024-12-10 17:24:46,121,8367,62,59,6062.93,11259.01,0.00
2024-12-10 17:24:46,121,8368,62,59,6044.86,11260.00,0.00
2024-12-10 17:24:46,122,8368,63,59,5995.31,11260.01,0.00
2024-12-10 17:24:46,122,8369,63,59,5976.46,11261.00,0.00
2024-12-10 17:24:46,123,8369,63,60,5927.87,11261.01,0.00
2024-12-10 17:24:46,122,8369,62,60,5974.62,11261.02,0.00
2024-12-10 17:24:46,121,8369,61,60,6014.73,11261.09,0.00
2024-12-10 17:24:46,121,8370,61,60,6005.91,11262.00,0.00
2024-12-10 17:24:46,122,8370,62,60,5956.68,11262.01,0.00
2024-12-10 17:24:46,121,8370,61,60,5995.72,11262.09,0.00
2024-12-10 17:24:46,121,8371,61,60,5986.90,11263.00,0.00
2024-12-10 17:24:46,122,8371,62,60,5937.83,11263.01,0.00
2024-12-10 17:24:46,121,8371,61,60,5975.05,11263.11,0.00
2024-12-10 17:24:46,122,8370,61,61,5874.53,11263.58,0.00
2024-12-10 17:24:46,122,8371,61,61,5959.80,11264.00,0.00
2024-12-10 17:24:46,123,8371,62,61,5911.34,11264.01,0.00
2024-12-10 17:24:46,123,8372,62,61,5982.80,11265.00,0.00
2024-12-10 17:24:46,124,8372,63,61,5934.55,11265.01,0.00
2024-12-10 17:24:46,124,8373,63,61,5914.18,11266.00,0.00
2024-12-10 17:24:46,125,8373,63,62,5866.87,11266.01,0.00
2024-12-10 17:24:46,124,8373,63,61,5904.50,11266.09,0.00
2024-12-10 17:24:46,125,8372,64,61,5764.83,11266.93,0.00
2024-12-10 17:24:46,125,8373,64,61,5854.14,11267.00,0.00
2024-12-10 17:24:46,126,8373,64,62,5807.68,11267.01,0.00
2024-12-10 17:24:46,125,8373,64,61,5844.26,11267.09,0.00
2024-12-10 17:24:46,125,8374,64,61,5922.27,11268.00,0.00
2024-12-10 17:24:46,126,8374,64,62,5875.26,11268.01,0.00
2024-12-10 17:24:46,126,8375,64,62,5853.43,11269.00,0.00
2024-12-10 17:24:46,127,8375,64,63,5807.34,11269.01,0.00
2024-12-10 17:24:46,127,8376,64,63,5784.78,11270.00,0.00
2024-12-10 17:24:46,128,8376,64,64,5739.58,11270.01,0.00
2024-12-10 17:24:46,128,8377,64,64,5716.32,11271.00,0.00
2024-12-10 17:24:46,129,8377,65,64,5672.01,11271.01,0.00
2024-12-10 17:24:46,128,8377,65,63,5707.00,11271.09,0.00
2024-12-10 17:24:46,128,8378,65,63,5692.50,11272.00,0.00
2024-12-10 17:24:46,129,8378,66,63,5648.37,11272.01,0.00
2024-12-10 17:24:46,128,8378,66,62,5682.85,11272.09,0.00
2024-12-10 17:24:46,129,8377,66,63,5556.09,11272.84,0.00
2024-12-10 17:24:46,129,8378,66,63,5641.01,11273.00,0.00
2024-12-10 17:24:46,130,8378,67,63,5597.61,11273.01,0.00
2024-12-10 17:24:46,129,8378,66,63,5631.43,11273.08,0.00
2024-12-10 17:24:46,129,8379,66,63,5703.56,11274.00,0.00
2024-12-10 17:24:46,130,8379,66,64,5659.68,11274.01,0.00
2024-12-10 17:24:46,129,8379,66,63,5693.98,11274.08,0.00
2024-12-10 17:24:46,129,8380,66,63,5678.72,11275.00,0.00
2024-12-10 17:24:46,130,8380,67,63,5635.04,11275.01,0.00
2024-12-10 17:24:46,129,8380,66,63,5669.14,11275.08,0.00
2024-12-10 17:24:46,129,8381,66,63,5653.87,11276.00,0.00
2024-12-10 17:24:46,130,8381,66,64,5610.38,11276.01,0.00
2024-12-10 17:24:46,129,8381,65,64,5644.29,11276.08,0.00
2024-12-10 17:24:47,129,8382,65,64,5629.02,11277.00,0.00
2024-12-10 17:24:47,130,8382,65,65,5585.72,11277.01,0.00
2024-12-10 17:24:47,129,8382,64,65,5619.94,11277.08,0.00
2024-12-10 17:24:47,129,8383,64,65,5604.67,11278.00,0.00
2024-12-10 17:24:47,130,8383,65,65,5561.56,11278.01,0.00
2024-12-10 17:24:47,131,8382,66,65,5512.24,11278.08,0.00
2024-12-10 17:24:47,130,8382,66,64,5630.13,11278.09,0.00
2024-12-10 17:24:47,130,8383,66,64,5614.97,11279.00,0.00
2024-12-10 17:24:47,131,8383,66,65,5572.11,11279.01,0.00
2024-12-10 17:24:47,131,8384,66,65,5632.88,11280.00,0.00
2024-12-10 17:24:47,132,8384,67,65,5590.21,11280.01,0.00
2024-12-10 17:24:47,131,8384,67,64,5622.58,11280.09,0.00
2024-12-10 17:24:47,131,8385,67,64,5606.68,11281.00,0.00
2024-12-10 17:24:47,132,8385,68,64,5564.21,11281.01,0.00
2024-12-10 17:24:47,131,8385,68,63,5596.50,11281.09,0.00
2024-12-10 17:24:47,132,8384,69,63,5482.54,11281.74,0.00
2024-12-10 17:24:47,132,8385,69,63,5563.96,11282.00,0.00
2024-12-10 17:24:47,133,8385,70,63,5522.13,11282.01,0.00
2024-12-10 17:24:47,132,8385,70,62,5553.74,11282.09,0.00
2024-12-10 17:24:47,133,8384,71,62,5461.20,11282.56,0.00
2024-12-10 17:24:47,133,8385,71,62,5622.72,11283.00,0.00
2024-12-10 17:24:47,134,8385,72,62,5580.76,11283.01,0.00
2024-12-10 17:24:47,133,8385,71,62,5612.58,11283.09,0.00
2024-12-10 17:24:47,133,8386,71,62,5680.07,11284.00,0.00
2024-12-10 17:24:47,134,8386,71,63,5637.68,11284.01,0.00
2024-12-10 17:24:47,133,8386,71,62,5671.26,11284.08,0.00
2024-12-10 17:24:47,132,8386,71,61,5713.37,11284.08,0.00
2024-12-10 17:24:47,132,8387,71,61,5695.89,11285.00,0.00
2024-12-10 17:24:47,133,8387,71,62,5653.06,11285.01,0.00
2024-12-10 17:24:47,132,8387,71,61,5686.52,11285.08,0.00
2024-12-10 17:24:47,132,8388,71,61,5669.04,11286.00,0.00
2024-12-10 17:24:47,133,8388,72,61,5626.41,11286.01,0.00
2024-12-10 17:24:47,132,8388,72,60,5659.66,11286.08,0.00
2024-12-10 17:24:47,132,8389,72,60,5642.17,11287.00,0.00
2024-12-10 17:24:47,133,8389,72,61,5599.75,11287.01,0.00
2024-12-10 17:24:47,132,8389,72,60,5632.80,11287.08,0.00
2024-12-10 17:24:47,132,8390,72,60,5615.31,11288.00,0.00
2024-12-10 17:24:47,133,8390,72,61,5573.09,11288.01,0.00
2024-12-10 17:24:47,132,8390,71,61,5605.93,11288.08,0.00
2024-12-10 17:24:47,131,8390,71,60,5647.86,11288.08,0.00
2024-12-10 17:24:47,131,8391,71,60,5631.10,11289.00,0.00
2024-12-10 17:24:47,132,8391,71,61,5588.44,11289.01,0.00
2024-12-10 17:24:47,131,8391,70,61,5621.65,11289.08,0.00
2024-12-10 17:24:47,131,8392,70,61,5604.88,11290.00,0.00
2024-12-10 17:24:47,132,8392,70,62,5562.42,11290.01,0.00
2024-12-10 17:24:47,131,8392,69,62,5595.43,11290.08,0.00
2024-12-10 17:24:47,131,8393,69,62,5578.66,11291.00,0.00
2024-12-10 17:24:47,132,8393,69,63,5536.40,11291.01,0.00
2024-12-10 17:24:47,131,8393,69,62,5569.20,11291.08,0.00
2024-12-10 17:24:47,131,8394,69,62,5552.43,11292.00,0.00
2024-12-10 17:24:47,132,8394,69,63,5510.37,11292.01,0.00
2024-12-10 17:24:47,131,8394,69,62,5550.71,11292.02,0.00
2024-12-10 17:24:47,130,8394,69,61,5585.61,11292.08,0.00
2024-12-10 17:24:47,129,8394,69,60,5628.04,11292.08,0.00
2024-12-10 17:24:47,129,8395,69,60,5611.88,11293.00,0.00
2024-12-10 17:24:47,130,8395,69,61,5568.71,11293.01,0.00
2024-12-10 17:24:47,129,8395,68,61,5603.15,11293.08,0.00
2024-12-10 17:24:47,129,8396,68,61,5586.98,11294.00,0.00
2024-12-10 17:24:47,130,8396,69,61,5544.01,11294.01,0.00
2024-12-10 17:24:47,129,8396,69,60,5578.25,11294.08,0.00
2024-12-10 17:24:47,129,8397,69,60,5562.09,11295.00,0.00
2024-12-10 17:24:47,130,8397,69,61,5519.30,11295.01,0.00
2024-12-10 17:24:47,131,8396,69,62,5476.31,11295.03,0.00
2024-12-10 17:24:47,130,8396,68,62,5591.45,11295.08,0.00
2024-12-10 17:24:47,129,8396,67,62,5633.92,11295.08,0.00
2024-12-10 17:24:47,129,8397,67,62,5618.62,11296.00,0.00
2024-12-10 17:24:47,130,8397,67,63,5575.40,11296.01,0.00
2024-12-10 17:24:47,129,8397,66,63,5609.90,11296.08,0.00
2024-12-10 17:24:47,129,8398,66,63,5681.16,11297.00,0.00
2024-12-10 17:24:47,130,8398,67,63,5637.46,11297.01,0.00
2024-12-10 17:24:47,129,8398,67,62,5672.44,11297.08,0.00
2024-12-10 17:24:47,129,8399,67,62,5653.70,11298.00,0.00
2024-12-10 17:24:47,130,8399,68,62,5610.21,11298.01,0.00
2024-12-10 17:24:47,129,8399,67,62,5644.97,11298.08,0.00
2024-12-10 17:24:47,129,8400,67,62,5623.61,11299.00,0.00
2024-12-10 17:24:47,130,8400,67,63,5580.35,11299.01,0.00
2024-12-10 17:24:48,129,8400,66,63,5614.88,11299.08,0.00
2024-12-10 17:24:48,130,8399,66,64,5550.84,11299.28,0.00
2024-12-10 17:24:48,130,8400,66,64,5585.56,11300.00,0.00
2024-12-10 17:24:48,131,8400,66,65,5542.92,11300.01,0.00
2024-12-10 17:24:48,130,8400,65,65,5576.89,11300.08,0.00
2024-12-10 17:24:48,129,8400,64,65,5619.25,11300.08,0.00
2024-12-10 17:24:48,129,8401,64,65,5690.68,11301.00,0.00
2024-12-10 17:24:48,130,8401,64,66,5646.90,11301.01,0.00
2024-12-10 17:24:48,129,8401,63,66,5681.94,11301.08,0.00
2024-12-10 17:24:48,129,8402,63,66,5665.77,11302.00,0.00
2024-12-10 17:24:48,130,8402,63,67,5622.19,11302.01,0.00
2024-12-10 17:24:48,131,8401,64,67,5572.39,11302.08,0.00
2024-12-10 17:24:48,130,8401,64,66,5658.34,11302.08,0.00
2024-12-10 17:24:48,129,8401,63,66,5701.33,11302.08,0.00
2024-12-10 17:24:48,129,8402,63,66,5683.31,11303.00,0.00
2024-12-10 17:24:48,130,8402,63,67,5639.59,11303.01,0.00
2024-12-10 17:24:48,129,8402,63,66,5674.58,11303.08,0.00
2024-12-10 17:24:48,129,8403,63,66,5741.71,11304.00,0.00
2024-12-10 17:24:48,130,8403,63,67,5697.54,11304.01,0.00
2024-12-10 17:24:48,129,8403,63,66,5736.47,11304.05,0.00
2024-12-10 17:24:48,128,8403,63,65,5777.76,11304.07,0.00
2024-12-10 17:24:48,127,8403,63,64,5822.37,11304.07,0.00
2024-12-10 17:24:48,127,8404,63,64,5805.61,11305.00,0.00
2024-12-10 17:24:48,128,8404,64,64,5760.25,11305.01,0.00
2024-12-10 17:24:48,127,8404,64,63,5797.63,11305.07,0.00
2024-12-10 17:24:48,128,8403,65,63,5672.83,11305.79,0.00
2024-12-10 17:24:48,128,8404,65,63,5757.81,11306.00,0.00
2024-12-10 17:24:48,129,8404,65,64,5713.17,11306.01,0.00
2024-12-10 17:24:48,128,8404,64,64,5749.89,11306.07,0.00
2024-12-10 17:24:48,128,8405,64,64,5821.53,11307.00,0.00
2024-12-10 17:24:48,129,8405,64,65,5776.40,11307.01,0.00
2024-12-10 17:24:48,128,8405,63,65,5813.61,11307.07,0.00
2024-12-10 17:24:48,128,8406,63,65,5795.62,11308.00,0.00
2024-12-10 17:24:48,129,8406,63,66,5750.69,11308.01,0.00
2024-12-10 17:24:48,129,8407,63,66,5724.18,11309.00,0.00
2024-12-10 17:24:48,130,8407,63,67,5680.15,11309.01,0.00
2024-12-10 17:24:48,129,8407,63,66,5718.93,11309.05,0.00
2024-12-10 17:24:48,128,8407,63,65,5760.09,11309.07,0.00
2024-12-10 17:24:48,127,8407,62,65,5804.55,11309.07,0.00
2024-12-10 17:24:48,127,8408,62,65,5784.67,11310.00,0.00
2024-12-10 17:24:48,128,8408,62,66,5739.47,11310.01,0.00
2024-12-10 17:24:48,127,8408,62,65,5776.68,11310.07,0.00
2024-12-10 17:24:48,127,8409,62,65,5754.14,11311.00,0.00
2024-12-10 17:24:48,128,8409,62,66,5709.19,11311.01,0.00
2024-12-10 17:24:48,127,8409,62,65,5746.15,11311.07,0.00
2024-12-10 17:24:48,127,8410,62,65,5720.04,11312.00,0.00
2024-12-10 17:24:48,128,8410,62,66,5675.35,11312.01,0.00
2024-12-10 17:24:48,127,8410,61,66,5712.05,11312.07,0.00
2024-12-10 17:24:48,127,8411,61,66,5688.27,11313.00,0.00
2024-12-10 17:24:48,128,8411,61,67,5643.84,11313.01,0.00
2024-12-10 17:24:48,127,8411,61,66,5680.28,11313.07,0.00
2024-12-10 17:24:48,126,8411,61,65,5724.47,11313.07,0.00
2024-12-10 17:24:48,126,8412,61,65,5703.17,11314.00,0.00
2024-12-10 17:24:48,127,8412,61,66,5658.26,11314.01,0.00
2024-12-10 17:24:48,126,8412,61,65,5695.11,11314.07,0.00
2024-12-10 17:24:48,126,8413,61,65,5674.74,11315.00,0.00
2024-12-10 17:24:48,127,8413,62,65,5630.06,11315.01,0.00
2024-12-10 17:24:48,126,8413,61,65,5666.68,11315.07,0.00
2024-12-10 17:24:48,126,8414,61,65,5649.47,11316.00,0.00
2024-12-10 17:24:48,127,8414,61,66,5604.98,11316.01,0.00
2024-12-10 17:24:48,126,8414,61,65,5641.41,11316.07,0.00
2024-12-10 17:24:48,126,8415,61,65,5622.94,11317.00,0.00
2024-12-10 17:24:48,127,8415,61,66,5578.66,11317.01,0.00
2024-12-10 17:24:48,126,8415,61,65,5614.87,11317.07,0.00
2024-12-10 17:24:48,126,8416,61,65,5594.40,11318.00,0.00
2024-12-10 17:24:48,127,8416,62,65,5550.34,11318.01,0.00
2024-12-10 17:24:48,126,8416,62,64,5586.33,11318.07,0.00
2024-12-10 17:24:48,125,8416,62,63,5562.74,11318.62,0.00
2024-12-10 17:24:48,125,8417,62,63,5610.13,11319.00,0.00
2024-12-10 17:24:48,126,8417,62,64,5565.60,11319.01,0.00
2024-12-10 17:24:48,125,8417,61,64,5606.52,11319.03,0.00
2024-12-10 17:24:48,124,8417,60,64,5650.82,11319.03,0.00
2024-12-10 17:24:48,123,8417,60,63,5692.14,11319.07,0.00
2024-12-10 17:24:48,122,8417,59,63,5737.87,11319.07,0.00
2024-12-10 17:24:48,122,8418,59,63,5721.72,11320.00,0.00
2024-12-10 17:24:48,123,8418,59,64,5675.20,11320.01,0.00
2024-12-10 17:24:48,122,8418,58,64,5714.32,11320.07,0.00
2024-12-10 17:24:48,122,8419,58,64,5698.21,11321.00,0.00
2024-12-10 17:24:48,123,8419,58,65,5651.88,11321.01,0.00
2024-12-10 17:24:48,122,8419,57,65,5690.81,11321.07,0.00
2024-12-10 17:24:48,122,8420,57,65,5674.80,11322.00,0.00
2024-12-10 17:24:48,123,8420,57,66,5628.67,11322.01,0.00
2024-12-10 17:24:48,122,8420,56,66,5667.41,11322.07,0.00
2024-12-10 17:24:48,122,8421,56,66,5651.48,11323.00,0.00
2024-12-10 17:24:48,123,8421,57,66,5605.53,11323.01,0.00
2024-12-10 17:24:49,122,8421,56,66,5644.08,11323.07,0.00
2024-12-10 17:24:49,122,8422,56,66,5627.92,11324.00,0.00
2024-12-10 17:24:49,123,8422,57,66,5582.17,11324.01,0.00
2024-12-10 17:24:49,122,8422,57,65,5620.52,11324.07,0.00
2024-12-10 17:24:49,123,8421,57,66,5528.90,11324.49,0.00
2024-12-10 17:24:49,123,8422,57,66,5637.24,11325.00,0.00
2024-12-10 17:24:49,124,8422,57,67,5591.78,11325.01,0.00
2024-12-10 17:24:49,123,8422,57,66,5629.90,11325.07,0.00
2024-12-10 17:24:49,123,8423,57,66,5701.59,11326.00,0.00
2024-12-10 17:24:49,124,8423,57,67,5655.61,11326.01,0.00
2024-12-10 17:24:49,123,8423,56,67,5694.25,11326.07,0.00
2024-12-10 17:24:49,123,8424,56,67,5673.62,11327.00,0.00
2024-12-10 17:24:49,124,8424,56,68,5627.87,11327.01,0.00
2024-12-10 17:24:49,123,8424,55,68,5666.28,11327.07,0.00
2024-12-10 17:24:49,123,8425,55,68,5644.36,11328.00,0.00
2024-12-10 17:24:49,124,8425,56,68,5598.84,11328.01,0.00
2024-12-10 17:24:49,123,8425,55,68,5636.94,11328.07,0.00
2024-12-10 17:24:49,123,8426,55,68,5613.62,11329.00,0.00
2024-12-10 17:24:49,124,8426,55,69,5568.35,11329.01,0.00
2024-12-10 17:24:49,123,8426,55,68,5606.24,11329.07,0.00
2024-12-10 17:24:49,123,8427,55,68,5576.59,11330.00,0.00
2024-12-10 17:24:49,124,8427,55,69,5531.62,11330.01,0.00
2024-12-10 17:24:49,123,8427,55,68,5571.08,11330.05,0.00
2024-12-10 17:24:49,122,8427,55,67,5614.90,11330.06,0.00
2024-12-10 17:24:49,121,8427,55,66,5660.36,11330.06,0.00
2024-12-10 17:24:49,121,8428,55,66,5619.23,11331.00,0.00
2024-12-10 17:24:49,122,8428,56,66,5573.17,11331.01,0.00
2024-12-10 17:24:49,121,8428,56,65,5612.69,11331.06,0.00
2024-12-10 17:24:49,122,8427,56,66,5486.22,11331.71,0.00
2024-12-10 17:24:49,122,8428,56,66,5555.00,11332.00,0.00
2024-12-10 17:24:49,123,8428,56,67,5509.83,11332.01,0.00
2024-12-10 17:24:49,123,8429,56,67,5571.20,11333.00,0.00
2024-12-10 17:24:49,124,8429,56,68,5526.27,11333.01,0.00
2024-12-10 17:24:49,123,8429,56,67,5570.28,11333.01,0.00
2024-12-10 17:24:49,122,8429,55,67,5609.46,11333.06,0.00
2024-12-10 17:24:49,121,8429,54,67,5654.88,11333.06,0.00
2024-12-10 17:24:49,121,8430,54,67,5636.12,11334.00,0.00
2024-12-10 17:24:49,122,8430,55,67,5589.92,11334.01,0.00
2024-12-10 17:24:49,123,8429,56,67,5481.96,11334.47,0.00
2024-12-10 17:24:49,123,8430,56,67,5563.03,11335.00,0.00
2024-12-10 17:24:49,124,8430,56,68,5518.17,11335.01,0.00
2024-12-10 17:24:49,123,8430,56,67,5510.44,11335.37,0.00
2024-12-10 17:24:49,123,8431,56,67,5613.45,11336.00,0.00
2024-12-10 17:24:49,124,8431,56,68,5568.18,11336.01,0.00
2024-12-10 17:24:49,123,8431,55,68,5605.18,11336.07,0.00
2024-12-10 17:24:49,123,8432,55,68,5583.13,11337.00,0.00
2024-12-10 17:24:49,124,8432,56,68,5538.10,11337.01,0.00
2024-12-10 17:24:49,123,8432,55,68,5574.86,11337.07,0.00
2024-12-10 17:24:49,123,8433,55,68,5558.92,11338.00,0.00
2024-12-10 17:24:49,124,8433,56,68,5514.08,11338.01,0.00
2024-12-10 17:24:49,123,8433,55,68,5550.64,11338.07,0.00
2024-12-10 17:24:49,123,8434,55,68,5537.25,11339.00,0.00
2024-12-10 17:24:49,124,8434,56,68,5492.59,11339.01,0.00
2024-12-10 17:24:49,123,8434,56,67,5528.97,11339.07,0.00
2024-12-10 17:24:49,123,8435,56,67,5515.25,11340.00,0.00
2024-12-10 17:24:49,124,8435,56,68,5470.78,11340.01,0.00
2024-12-10 17:24:49,123,8435,55,68,5506.98,11340.07,0.00
2024-12-10 17:24:49,123,8436,55,68,5492.80,11341.00,0.00
2024-12-10 17:24:49,124,8436,55,69,5448.50,11341.01,0.00
2024-12-10 17:24:49,123,8436,54,69,5484.53,11341.07,0.00
2024-12-10 17:24:49,124,8435,54,70,5357.36,11341.82,0.00
2024-12-10 17:24:49,123,8435,54,69,5408.16,11341.85,0.00
2024-12-10 17:24:49,123,8436,54,69,5483.90,11342.00,0.00
2024-12-10 17:24:49,124,8436,55,69,5439.67,11342.01,0.00
2024-12-10 17:24:49,123,8436,55,68,5475.62,11342.07,0.00
2024-12-10 17:24:49,123,8437,55,68,5539.79,11343.00,0.00
2024-12-10 17:24:49,124,8437,55,69,5495.11,11343.01,0.00
2024-12-10 17:24:49,123,8437,54,69,5531.51,11343.07,0.00
2024-12-10 17:24:49,123,8438,54,69,5513.73,11344.00,0.00
2024-12-10 17:24:49,124,8438,54,70,5469.26,11344.01,0.00
2024-12-10 17:24:49,123,8438,53,70,5505.45,11344.07,0.00
2024-12-10 17:24:49,123,8439,53,70,5486.96,11345.00,0.00
2024-12-10 17:24:49,124,8439,54,70,5442.71,11345.01,0.00
2024-12-10 17:24:49,123,8439,53,70,5485.12,11345.02,0.00
2024-12-10 17:24:49,122,8439,52,70,5523.59,11345.07,0.00
2024-12-10 17:24:49,121,8439,51,70,5568.30,11345.07,0.00
2024-12-10 17:24:49,122,8438,51,71,5412.51,11345.98,0.00
2024-12-10 17:24:49,122,8439,51,71,5511.83,11346.00,0.00
2024-12-10 17:24:49,123,8439,52,71,5467.01,11346.01,0.00
2024-12-10 17:24:49,122,8439,51,71,5506.26,11346.05,0.00
2024-12-10 17:24:49,121,8439,51,70,5549.90,11346.06,0.00
2024-12-10 17:24:49,120,8439,50,70,5595.20,11346.06,0.00
2024-12-10 17:24:49,120,8440,50,70,5668.94,11347.00,0.00
2024-12-10 17:24:49,121,8440,50,71,5622.09,11347.01,0.00
2024-12-10 17:24:49,120,8440,49,71,5662.34,11347.06,0.00
2024-12-10 17:24:49,119,8440,48,71,5684.60,11347.28,0.00
2024-12-10 17:24:50,119,8441,48,71,5691.83,11348.00,0.00
2024-12-10 17:24:50,120,8441,48,72,5644.39,11348.01,0.00
2024-12-10 17:24:50,119,8441,48,71,5685.17,11348.06,0.00
2024-12-10 17:24:50,120,8440,49,71,5538.13,11348.91,0.00
2024-12-10 17:24:50,120,8441,49,71,5630.90,11349.00,0.00
2024-12-10 17:24:50,121,8441,50,71,5584.36,11349.01,0.00
2024-12-10 17:24:50,120,8441,50,70,5624.30,11349.06,0.00
2024-12-10 17:24:50,120,8442,50,70,5700.19,11350.00,0.00
2024-12-10 17:24:50,121,8442,50,71,5653.08,11350.01,0.00
2024-12-10 17:24:50,120,8442,49,71,5693.59,11350.06,0.00
2024-12-10 17:24:50,120,8443,49,71,5671.70,11351.00,0.00
2024-12-10 17:24:50,121,8443,50,71,5624.83,11351.01,0.00
2024-12-10 17:24:50,120,8443,49,71,5665.10,11351.06,0.00
2024-12-10 17:24:50,120,8444,49,71,5649.00,11352.00,0.00
2024-12-10 17:24:50,121,8444,50,71,5602.32,11352.01,0.00
2024-12-10 17:24:50,120,8444,49,71,5641.45,11352.07,0.00
2024-12-10 17:24:50,120,8445,49,71,5621.92,11353.00,0.00
2024-12-10 17:24:50,121,8445,49,72,5575.46,11353.01,0.00
2024-12-10 17:24:50,122,8444,49,73,5461.08,11353.63,0.00
2024-12-10 17:24:50,122,8445,49,73,5571.76,11354.00,0.00
2024-12-10 17:24:50,123,8445,49,74,5526.47,11354.01,0.00
2024-12-10 17:24:50,122,8445,48,74,5563.41,11354.07,0.00
2024-12-10 17:24:50,122,8446,48,74,5619.62,11355.00,0.00
2024-12-10 17:24:50,123,8446,48,75,5573.94,11355.01,0.00
2024-12-10 17:24:50,122,8446,48,74,5614.05,11355.05,0.00
2024-12-10 17:24:50,121,8446,47,74,5658.07,11355.07,0.00
2024-12-10 17:24:50,120,8446,47,73,5704.28,11355.07,0.00
2024-12-10 17:24:50,119,8446,47,72,5677.20,11355.67,0.00
2024-12-10 17:24:50,119,8447,47,72,5733.67,11356.00,0.00
2024-12-10 17:24:50,120,8447,47,73,5685.89,11356.01,0.00
2024-12-10 17:24:50,119,8447,47,72,5726.06,11356.07,0.00
2024-12-10 17:24:50,119,8448,47,72,5711.76,11357.00,0.00
2024-12-10 17:24:50,120,8448,47,73,5664.16,11357.01,0.00
2024-12-10 17:24:50,120,8449,47,73,5639.53,11358.00,0.00
2024-12-10 17:24:50,121,8449,48,73,5592.92,11358.01,0.00
2024-12-10 17:24:50,120,8449,48,72,5631.03,11358.08,0.00
2024-12-10 17:24:50,120,8450,48,72,5607.54,11359.00,0.00
2024-12-10 17:24:50,121,8450,48,73,5561.20,11359.01,0.00
2024-12-10 17:24:50,120,8450,48,72,5599.04,11359.08,0.00
2024-12-10 17:24:50,121,8449,48,73,5503.83,11359.50,0.00
2024-12-10 17:24:50,121,8450,48,73,5581.07,11360.00,0.00
2024-12-10 17:24:50,122,8450,48,74,5535.32,11360.01,0.00
2024-12-10 17:24:50,121,8450,47,74,5572.63,11360.07,0.00
2024-12-10 17:24:50,121,8451,47,74,5651.92,11361.00,0.00
2024-12-10 17:24:50,122,8451,47,75,5605.59,11361.01,0.00
2024-12-10 17:24:50,121,8451,47,74,5643.48,11361.07,0.00
2024-12-10 17:24:50,122,8450,47,75,5559.04,11361.43,0.00
2024-12-10 17:24:50,123,8449,48,75,5485.66,11361.85,0.00
2024-12-10 17:24:50,123,8450,48,75,5576.34,11362.00,0.00
2024-12-10 17:24:50,124,8450,49,75,5531.37,11362.01,0.00
2024-12-10 17:24:50,123,8450,48,75,5568.04,11362.07,0.00
2024-12-10 17:24:50,122,8450,48,74,5546.01,11362.57,0.00
2024-12-10 17:24:50,122,8451,48,74,5771.85,11363.00,0.00
2024-12-10 17:24:50,123,8451,49,74,5724.92,11363.01,0.00
2024-12-10 17:24:50,122,8451,48,74,5763.48,11363.07,0.00
2024-12-10 17:24:50,121,8451,48,73,5810.17,11363.07,0.00
2024-12-10 17:24:50,122,8450,49,73,5725.80,11363.38,0.00
2024-12-10 17:24:50,122,8451,49,73,5801.15,11364.00,0.00
2024-12-10 17:24:50,123,8451,50,73,5753.99,11364.01,0.00
2024-12-10 17:24:50,122,8451,49,73,5792.78,11364.07,0.00
2024-12-10 17:24:50,123,8450,49,74,5676.65,11364.65,0.00
2024-12-10 17:24:50,123,8451,49,74,5869.54,11365.00,0.00
2024-12-10 17:24:50,124,8451,49,75,5822.20,11365.01,0.00
2024-12-10 17:24:50,123,8451,48,75,5861.23,11365.07,0.00
2024-12-10 17:24:50,123,8452,48,75,5924.39,11366.00,0.00
2024-12-10 17:24:50,124,8452,48,76,5876.61,11366.01,0.00
2024-12-10 17:24:50,123,8452,48,75,5917.01,11366.07,0.00
2024-12-10 17:24:50,122,8452,48,74,5964.58,11366.07,0.00
2024-12-10 17:24:50,121,8452,47,74,6012.94,11366.07,0.00
2024-12-10 17:24:50,122,8451,48,74,5935.56,11366.33,0.00
2024-12-10 17:24:50,122,8452,48,74,6000.41,11367.00,0.00
2024-12-10 17:24:50,123,8452,49,74,5951.63,11367.01,0.00
2024-12-10 17:24:50,123,8453,49,74,6004.83,11368.00,0.00
2024-12-10 17:24:50,124,8453,50,74,5956.40,11368.01,0.00
2024-12-10 17:24:50,123,8453,50,73,5997.44,11368.07,0.00
2024-12-10 17:24:50,123,8454,50,73,5963.39,11369.00,0.00
2024-12-10 17:24:50,124,8454,50,74,5915.29,11369.01,0.00
2024-12-10 17:24:50,123,8454,50,73,5956.00,11369.07,0.00
2024-12-10 17:24:50,122,8454,49,73,5965.73,11369.37,0.00
2024-12-10 17:24:50,122,8455,49,73,5978.57,11370.00,0.00
2024-12-10 17:24:50,123,8455,50,73,5929.96,11370.01,0.00
2024-12-10 17:24:50,122,8455,50,72,5971.12,11370.07,0.00
2024-12-10 17:24:50,121,8455,49,72,6013.00,11370.12,0.00
2024-12-10 17:24:50,121,8456,49,72,5993.67,11371.00,0.00
2024-12-10 17:24:50,122,8456,50,72,5944.54,11371.01,0.00
2024-12-10 17:24:51,122,8457,50,72,5907.79,11372.00,0.00
2024-12-10 17:24:51,123,8457,51,72,5859.76,11372.01,0.00
2024-12-10 17:24:51,122,8457,50,72,5901.27,11372.06,0.00
2024-12-10 17:24:51,121,8457,49,72,5949.10,11372.06,0.00
2024-12-10 17:24:51,120,8457,49,71,5997.73,11372.06,0.00
2024-12-10 17:24:51,121,8456,50,71,5828.98,11372.93,0.00
2024-12-10 17:24:51,121,8457,50,71,5932.31,11373.00,0.00
2024-12-10 17:24:51,122,8457,51,71,5883.68,11373.01,0.00
2024-12-10 17:24:51,121,8457,50,71,5925.74,11373.06,0.00
2024-12-10 17:24:51,121,8458,50,71,5976.18,11374.00,0.00
2024-12-10 17:24:51,122,8458,50,72,5927.20,11374.01,0.00
2024-12-10 17:24:51,121,8458,50,71,5969.61,11374.06,0.00
2024-12-10 17:24:51,121,8459,50,71,5920.58,11375.00,0.00
2024-12-10 17:24:51,122,8459,50,72,5872.05,11375.01,0.00
2024-12-10 17:24:51,121,8459,49,72,5914.00,11375.06,0.00
2024-12-10 17:24:51,121,8460,49,72,5861.64,11376.00,0.00
2024-12-10 17:24:51,122,8460,49,73,5813.59,11376.01,0.00
2024-12-10 17:24:51,122,8460,49,73,5756.90,11377.00,0.00
2024-12-10 17:24:51,123,8460,50,73,5710.10,11377.01,0.00
2024-12-10 17:24:51,122,8460,50,72,5684.69,11377.58,0.00
2024-12-10 17:24:51,122,8461,50,72,5692.45,11378.00,0.00
2024-12-10 17:24:51,123,8461,50,73,5646.17,11378.01,0.00
2024-12-10 17:24:51,122,8461,49,73,5690.73,11378.02,0.00
2024-12-10 17:24:51,121,8461,48,73,5732.13,11378.06,0.00
2024-12-10 17:24:51,121,8462,48,73,5680.55,11379.00,0.00
2024-12-10 17:24:51,122,8462,48,74,5633.99,11379.01,0.00
2024-12-10 17:24:51,121,8462,48,73,5673.98,11379.06,0.00
2024-12-10 17:24:51,122,8461,48,74,5589.31,11379.41,0.00
2024-12-10 17:24:51,123,8460,49,74,5544.49,11379.80,0.00
2024-12-10 17:24:51,123,8461,49,74,5616.05,11380.00,0.00
2024-12-10 17:24:51,124,8461,49,75,5570.76,11380.01,0.00
2024-12-10 17:24:51,123,8461,48,75,5609.59,11380.06,0.00
2024-12-10 17:24:51,124,8460,49,75,5555.17,11380.15,0.00
2024-12-10 17:24:51,124,8461,49,75,5794.40,11381.00,0.00
2024-12-10 17:24:51,125,8461,50,75,5748.04,11381.01,0.00
2024-12-10 17:24:51,124,8461,49,75,5789.81,11381.04,0.00
2024-12-10 17:24:51,123,8461,48,75,5835.04,11381.05,0.00
2024-12-10 17:24:51,122,8461,47,75,5822.08,11381.55,0.00
2024-12-10 17:24:51,121,8461,47,74,5823.32,11381.83,0.00
2024-12-10 17:24:51,122,8460,47,75,5767.26,11381.91,0.00
2024-12-10 17:24:51,122,8461,47,75,6015.52,11382.00,0.00
2024-12-10 17:24:51,123,8461,48,75,5966.61,11382.01,0.00
2024-12-10 17:24:51,122,8461,47,75,6011.79,11382.03,0.00
2024-12-10 17:24:51,121,8461,46,75,6058.66,11382.05,0.00
2024-12-10 17:24:51,120,8461,45,75,6108.20,11382.05,0.00
2024-12-10 17:24:51,120,8462,45,75,6169.90,11383.00,0.00
2024-12-10 17:24:51,121,8462,45,76,6118.91,11383.01,0.00
2024-12-10 17:24:51,120,8462,44,76,6164.21,11383.05,0.00
2024-12-10 17:24:51,120,8463,44,76,6125.93,11384.00,0.00
2024-12-10 17:24:51,121,8463,44,77,6075.30,11384.01,0.00
2024-12-10 17:24:51,120,8463,44,76,6120.24,11384.05,0.00
2024-12-10 17:24:51,120,8464,44,76,6085.01,11385.00,0.00
2024-12-10 17:24:51,121,8464,44,77,6034.72,11385.01,0.00
2024-12-10 17:24:51,120,8464,44,76,6079.32,11385.05,0.00
2024-12-10 17:24:51,119,8464,44,75,6073.60,11385.55,0.00
2024-12-10 17:24:51,119,8465,44,75,6103.25,11386.00,0.00
2024-12-10 17:24:51,120,8465,44,76,6052.39,11386.01,0.00
2024-12-10 17:24:51,119,8465,43,76,6097.51,11386.05,0.00
2024-12-10 17:24:51,120,8464,44,76,5956.65,11386.86,0.00
2024-12-10 17:24:51,120,8465,44,76,6077.40,11387.00,0.00
2024-12-10 17:24:51,121,8465,44,77,6027.17,11387.01,0.00
2024-12-10 17:24:51,120,8465,44,76,6071.71,11387.05,0.00
2024-12-10 17:24:51,120,8466,44,76,6145.45,11388.00,0.00
2024-12-10 17:24:51,121,8466,44,77,6094.66,11388.01,0.00
2024-12-10 17:24:51,120,8466,44,76,6139.76,11388.05,0.00
2024-12-10 17:24:51,121,8465,44,77,6050.53,11388.41,0.00
2024-12-10 17:24:51,121,8466,44,77,6112.26,11389.00,0.00
2024-12-10 17:24:51,122,8466,44,78,6062.16,11389.01,0.00
2024-12-10 17:24:51,123,8465,44,79,5934.61,11389.66,0.00
2024-12-10 17:24:51,123,8466,44,79,6071.70,11390.00,0.00
2024-12-10 17:24:51,124,8466,45,79,6022.73,11390.01,0.00
2024-12-10 17:24:51,123,8466,45,78,6065.23,11390.06,0.00
2024-12-10 17:24:51,123,8467,45,78,6095.99,11391.00,0.00
2024-12-10 17:24:51,124,8467,46,78,6046.83,11391.01,0.00
2024-12-10 17:24:51,123,8467,46,77,6089.52,11391.06,0.00
2024-12-10 17:24:51,123,8468,46,77,6044.91,11392.00,0.00
2024-12-10 17:24:51,124,8468,47,77,5996.16,11392.01,0.00
2024-12-10 17:24:51,123,8468,47,76,6038.44,11392.06,0.00
2024-12-10 17:24:51,123,8469,47,76,5998.01,11393.00,0.00
2024-12-10 17:24:51,124,8469,47,77,5949.64,11393.01,0.00
2024-12-10 17:24:51,123,8469,47,76,5991.54,11393.06,0.00
2024-12-10 17:24:51,122,8469,46,76,5926.62,11393.93,0.00
2024-12-10 17:24:51,122,8470,46,76,6012.60,11394.00,0.00
2024-12-10 17:24:51,123,8470,47,76,5963.71,11394.01,0.00
2024-12-10 17:24:51,122,8470,46,76,6006.07,11394.06,0.00
2024-12-10 17:24:51,122,8471,46,76,5975.76,11395.00,0.00
2024-12-10 17:24:51,123,8471,47,76,5927.18,11395.01,0.00
2024-12-10 17:24:51,122,8471,46,76,5974.83,11395.01,0.00
2024-12-10 17:24:51,121,8471,46,75,6018.56,11395.05,0.00
2024-12-10 17:24:51,121,8472,46,75,5989.97,11396.00,0.00
2024-12-10 17:24:51,122,8472,46,76,5940.87,11396.01,0.00
2024-12-10 17:24:51,121,8472,46,75,5983.39,11396.06,0.00
2024-12-10 17:24:52,121,8473,46,75,5950.83,11397.00,0.00
2024-12-10 17:24:52,122,8473,47,75,5902.05,11397.01,0.00
2024-12-10 17:24:52,122,8474,47,75,5863.59,11398.00,0.00
2024-12-10 17:24:52,123,8474,47,76,5815.92,11398.01,0.00
2024-12-10 17:24:52,122,8474,46,76,5855.69,11398.07,0.00
2024-12-10 17:24:52,121,8474,45,76,5858.61,11398.37,0.00
2024-12-10 17:24:52,121,8475,45,76,5878.45,11399.00,0.00
2024-12-10 17:24:52,122,8475,46,76,5830.27,11399.01,0.00
2024-12-10 17:24:52,121,8475,46,75,5876.57,11399.02,0.00
2024-12-10 17:24:52,120,8475,46,74,5918.65,11399.07,0.00
2024-12-10 17:24:52,121,8474,46,75,5836.60,11399.36,0.00
2024-12-10 17:24:52,121,8475,46,75,5930.43,11400.00,0.00
2024-12-10 17:24:52,122,8475,46,76,5881.82,11400.01,0.00
2024-12-10 17:24:52,121,8475,46,75,5918.98,11400.07,0.00
2024-12-10 17:24:52,121,8476,46,75,5985.65,11401.00,0.00
2024-12-10 17:24:52,122,8476,47,75,5936.58,11401.01,0.00
2024-12-10 17:24:52,121,8476,47,74,5971.88,11401.07,0.00
2024-12-10 17:24:52,121,8476,47,74,5946.47,11402.00,0.00
2024-12-10 17:24:52,122,8476,48,74,5897.73,11402.01,0.00
2024-12-10 17:24:52,121,8476,48,73,5945.52,11402.01,0.00
2024-12-10 17:24:52,120,8476,48,72,5991.78,11402.01,0.00
2024-12-10 17:24:52,119,8476,48,71,6036.41,11402.05,0.00
2024-12-10 17:24:52,120,8475,48,72,5961.45,11402.28,0.00
2024-12-10 17:24:52,121,8474,49,72,5958.94,11402.55,0.00
2024-12-10 17:24:52,121,8475,49,72,6039.06,11403.00,0.00
2024-12-10 17:24:52,122,8475,50,72,5989.56,11403.01,0.00
2024-12-10 17:24:52,121,8475,50,71,6033.43,11403.05,0.00
2024-12-10 17:24:52,121,8476,50,71,6189.49,11404.00,0.00
2024-12-10 17:24:52,122,8476,50,72,6138.75,11404.01,0.00
2024-12-10 17:24:52,121,8476,50,71,6132.12,11404.46,0.00
2024-12-10 17:24:52,121,8477,50,71,6150.95,11405.00,0.00
2024-12-10 17:24:52,122,8477,51,71,6100.53,11405.01,0.00
2024-12-10 17:24:52,121,8477,50,71,6150.00,11405.01,0.00
2024-12-10 17:24:52,120,8477,49,71,6195.58,11405.05,0.00
2024-12-10 17:24:52,119,8477,48,71,6246.68,11405.05,0.00
2024-12-10 17:24:52,120,8476,48,72,6101.06,11405.76,0.00
2024-12-10 17:24:52,120,8477,48,72,6182.96,11406.00,0.00
2024-12-10 17:24:52,121,8477,49,72,6131.87,11406.01,0.00
2024-12-10 17:24:52,120,8477,49,71,6176.32,11406.05,0.00
2024-12-10 17:24:52,121,8476,50,71,6105.52,11406.24,0.00
2024-12-10 17:24:52,120,8476,50,70,6157.06,11406.36,0.00
2024-12-10 17:24:52,121,8475,51,70,6081.78,11406.59,0.00
2024-12-10 17:24:52,121,8476,51,70,6253.53,11407.00,0.00
2024-12-10 17:24:52,122,8476,52,70,6202.27,11407.01,0.00
2024-12-10 17:24:52,121,8476,52,69,6247.89,11407.05,0.00
2024-12-10 17:24:52,121,8477,52,69,6381.19,11408.00,0.00
2024-12-10 17:24:52,122,8477,53,69,6328.88,11408.01,0.00
2024-12-10 17:24:52,121,8477,53,68,6375.56,11408.05,0.00
2024-12-10 17:24:52,122,8476,54,68,6305.56,11408.22,0.00
2024-12-10 17:24:52,122,8477,54,68,6284.33,11409.00,0.00
2024-12-10 17:24:52,123,8477,55,68,6233.23,11409.01,0.00
2024-12-10 17:24:52,122,8477,55,67,6278.74,11409.05,0.00
2024-12-10 17:24:52,122,8478,55,67,6307.45,11410.00,0.00
2024-12-10 17:24:52,123,8478,56,67,6256.17,11410.01,0.00
2024-12-10 17:24:52,122,8478,56,66,6301.86,11410.05,0.00
2024-12-10 17:24:52,123,8477,57,66,6234.89,11410.20,0.00
2024-12-10 17:24:52,123,8478,57,66,6199.59,11411.00,0.00
2024-12-10 17:24:52,124,8478,57,67,6149.59,11411.01,0.00
2024-12-10 17:24:52,125,8477,57,68,6100.39,11411.02,0.00
2024-12-10 17:24:52,124,8477,57,67,6173.55,11411.06,0.00
2024-12-10 17:24:52,123,8477,57,66,6218.10,11411.11,0.00
2024-12-10 17:24:52,122,8477,56,66,6198.04,11411.57,0.00
2024-12-10 17:24:52,121,8477,56,65,6198.97,11411.88,0.00
2024-12-10 17:24:52,121,8478,56,65,6344.96,11412.00,0.00
2024-12-10 17:24:52,122,8478,57,65,6292.95,11412.01,0.00
2024-12-10 17:24:52,122,8479,57,65,6320.87,11413.00,0.00
2024-12-10 17:24:52,123,8479,58,65,6269.48,11413.01,0.00
2024-12-10 17:24:52,122,8479,58,64,6314.33,11413.06,0.00
2024-12-10 17:24:52,122,8480,58,64,6248.75,11414.00,0.00
2024-12-10 17:24:52,123,8480,58,65,6197.95,11414.01,0.00
2024-12-10 17:24:52,122,8480,58,64,6238.83,11414.06,0.00
2024-12-10 17:24:52,122,8481,58,64,6161.60,11415.00,0.00
2024-12-10 17:24:52,123,8481,59,64,6111.50,11415.01,0.00
2024-12-10 17:24:52,122,8481,58,64,6147.78,11415.06,0.00
2024-12-10 17:24:52,121,8481,57,64,6132.21,11415.49,0.00
2024-12-10 17:24:52,121,8482,57,64,6116.41,11416.00,0.00
2024-12-10 17:24:52,122,8482,57,65,6066.28,11416.01,0.00
2024-12-10 17:24:52,121,8482,57,64,6032.21,11416.64,0.00
2024-12-10 17:24:52,121,8483,57,64,6040.16,11417.00,0.00
2024-12-10 17:24:52,122,8483,58,64,5990.65,11417.01,0.00
2024-12-10 17:24:52,121,8483,57,64,5918.58,11417.88,0.00
2024-12-10 17:24:52,120,8483,56,64,5948.91,11417.92,0.00
2024-12-10 17:24:52,120,8484,56,64,6019.47,11418.00,0.00
2024-12-10 17:24:52,121,8484,56,65,5969.72,11418.01,0.00
2024-12-10 17:24:52,120,8484,55,65,6009.85,11418.07,0.00
2024-12-10 17:24:52,120,8485,55,65,5961.43,11419.00,0.00
2024-12-10 17:24:52,121,8485,56,65,5912.16,11419.01,0.00
2024-12-10 17:24:52,122,8484,57,65,5763.89,11419.83,0.00
2024-12-10 17:24:52,121,8484,56,65,5802.10,11419.93,0.00
2024-12-10 17:24:53,121,8485,56,65,5873.24,11420.00,0.00
2024-12-10 17:24:53,122,8485,56,66,5825.10,11420.01,0.00
2024-12-10 17:24:53,121,8485,56,65,5863.40,11420.07,0.00
2024-12-10 17:24:53,121,8486,56,65,5915.42,11421.00,0.00
2024-12-10 17:24:53,122,8486,56,66,5866.94,11421.01,0.00
2024-12-10 17:24:53,123,8485,56,67,5704.57,11421.92,0.00
2024-12-10 17:24:53,123,8486,56,67,5804.92,11422.00,0.00
2024-12-10 17:24:53,124,8486,56,68,5758.11,11422.01,0.00
2024-12-10 17:24:53,123,8486,56,67,5795.47,11422.07,0.00
2024-12-10 17:24:53,123,8487,56,67,5839.71,11423.00,0.00
2024-12-10 17:24:53,124,8487,56,68,5792.61,11423.01,0.00
2024-12-10 17:24:53,123,8487,55,68,5830.41,11423.07,0.00
2024-12-10 17:24:53,122,8487,54,68,5866.03,11423.12,0.00
2024-12-10 17:24:53,122,8488,54,68,5832.46,11424.00,0.00
2024-12-10 17:24:53,123,8488,55,68,5785.04,11424.01,0.00
2024-12-10 17:24:53,122,8488,54,68,5823.16,11424.07,0.00
2024-12-10 17:24:53,121,8488,54,67,5863.88,11424.11,0.00
2024-12-10 17:24:53,122,8487,54,68,5707.69,11424.93,0.00
2024-12-10 17:24:53,122,8488,54,68,5795.31,11425.00,0.00
2024-12-10 17:24:53,123,8488,54,69,5748.20,11425.01,0.00
2024-12-10 17:24:53,122,8488,54,68,5785.54,11425.07,0.00
2024-12-10 17:24:53,121,8488,54,67,5814.56,11425.22,0.00
2024-12-10 17:24:53,121,8489,54,67,5871.02,11426.00,0.00
2024-12-10 17:24:53,122,8489,55,67,5822.89,11426.01,0.00
2024-12-10 17:24:53,121,8489,55,66,5857.43,11426.07,0.00
2024-12-10 17:24:53,121,8490,55,66,5802.39,11427.00,0.00
2024-12-10 17:24:53,122,8490,56,66,5754.83,11427.01,0.00
2024-12-10 17:24:53,121,8490,56,65,5784.92,11427.07,0.00
2024-12-10 17:24:53,121,8491,56,65,5740.32,11428.00,0.00
2024-12-10 17:24:53,122,8491,56,66,5693.27,11428.01,0.00
2024-12-10 17:24:53,121,8491,55,66,5729.77,11428.07,0.00
2024-12-10 17:24:53,122,8490,55,67,5647.26,11428.38,0.00
2024-12-10 17:24:53,122,8491,55,67,5678.43,11429.00,0.00
2024-12-10 17:24:53,123,8491,56,67,5632.27,11429.01,0.00
2024-12-10 17:24:53,122,8491,56,66,5661.85,11429.15,0.00
2024-12-10 17:24:53,122,8492,56,66,5674.53,11430.00,0.00
2024-12-10 17:24:53,123,8492,56,67,5628.39,11430.01,0.00
2024-12-10 17:24:53,123,8493,56,67,5512.42,11431.00,0.00
2024-12-10 17:24:53,124,8493,56,68,5467.97,11431.01,0.00
2024-12-10 17:24:53,123,8493,56,67,5498.35,11431.07,0.00
2024-12-10 17:24:53,124,8492,57,67,5381.88,11431.70,0.00
2024-12-10 17:24:53,123,8492,56,67,5433.38,11431.78,0.00
2024-12-10 17:24:53,123,8493,56,67,5460.14,11432.00,0.00
2024-12-10 17:24:53,124,8493,56,68,5416.10,11432.01,0.00
2024-12-10 17:24:53,123,8493,56,67,5448.48,11432.07,0.00
2024-12-10 17:24:53,122,8493,56,66,5487.88,11432.12,0.00
2024-12-10 17:24:53,122,8494,56,66,5534.44,11433.00,0.00
2024-12-10 17:24:53,123,8494,56,67,5489.45,11433.01,0.00
2024-12-10 17:24:53,124,8493,57,67,5435.05,11433.11,0.00
2024-12-10 17:24:53,124,8494,57,67,5454.47,11434.00,0.00
2024-12-10 17:24:53,125,8494,57,68,5410.83,11434.01,0.00
2024-12-10 17:24:53,124,8494,56,68,5444.61,11434.08,0.00
2024-12-10 17:24:53,124,8495,56,68,5452.94,11435.00,0.00
2024-12-10 17:24:53,125,8495,57,68,5409.32,11435.01,0.00
2024-12-10 17:24:53,124,8495,57,67,5443.32,11435.08,0.00
2024-12-10 17:24:53,125,8494,57,68,5386.99,11435.21,0.00
2024-12-10 17:24:53,126,8493,58,68,5403.27,11435.34,0.00
2024-12-10 17:24:53,126,8494,58,68,5442.67,11436.00,0.00
2024-12-10 17:24:53,127,8494,58,69,5399.82,11436.01,0.00
2024-12-10 17:24:53,126,8494,57,69,5342.66,11436.78,0.00
2024-12-10 17:24:53,126,8495,57,69,5565.94,11437.00,0.00
2024-12-10 17:24:53,127,8495,58,69,5522.12,11437.01,0.00
2024-12-10 17:24:53,127,8496,58,69,5461.89,11438.00,0.00
2024-12-10 17:24:53,128,8496,58,70,5419.22,11438.01,0.00
2024-12-10 17:24:53,127,8496,58,69,5357.08,11438.82,0.00
2024-12-10 17:24:53,127,8497,58,69,5406.07,11439.00,0.00
2024-12-10 17:24:53,128,8497,58,70,5363.84,11439.01,0.00
2024-12-10 17:24:53,127,8497,58,69,5310.60,11439.81,0.00
2024-12-10 17:24:53,127,8498,58,69,5363.03,11440.00,0.00
2024-12-10 17:24:53,128,8498,58,70,5321.14,11440.01,0.00
2024-12-10 17:24:53,128,8499,58,70,5274.03,11441.00,0.00
2024-12-10 17:24:53,129,8499,58,71,5233.15,11441.01,0.00
2024-12-10 17:24:53,128,8499,58,70,5263.33,11441.09,0.00
2024-12-10 17:24:53,127,8499,57,70,5285.87,11441.26,0.00
2024-12-10 17:24:53,127,8500,57,70,5266.73,11442.00,0.00
2024-12-10 17:24:53,128,8500,57,71,5225.58,11442.01,0.00
2024-12-10 17:24:53,127,8500,57,70,5266.08,11442.01,0.00
2024-12-10 17:24:53,126,8500,56,70,5297.49,11442.09,0.00
2024-12-10 17:24:53,125,8500,56,69,5255.41,11442.81,0.00
2024-12-10 17:24:53,126,8499,57,69,5203.49,11442.87,0.00
2024-12-10 17:24:53,126,8500,57,69,5274.10,11443.00,0.00
2024-12-10 17:24:53,127,8500,57,70,5232.57,11443.01,0.00
2024-12-10 17:24:53,126,8500,57,69,5264.76,11443.09,0.00
2024-12-10 17:24:53,127,8499,57,70,5136.88,11443.83,0.00
2024-12-10 17:24:54,127,8500,57,70,5317.39,11444.00,0.00
2024-12-10 17:24:54,128,8500,57,71,5275.85,11444.01,0.00
2024-12-10 17:24:54,128,8501,57,71,5320.55,11445.00,0.00
2024-12-10 17:24:54,129,8501,57,72,5279.30,11445.01,0.00
2024-12-10 17:24:54,128,8501,56,72,5310.73,11445.09,0.00
2024-12-10 17:24:54,127,8501,55,72,5351.78,11445.09,0.00
2024-12-10 17:24:54,126,8501,55,71,5288.23,11445.87,0.00
2024-12-10 17:24:54,126,8502,55,71,5361.68,11446.00,0.00
2024-12-10 17:24:54,127,8502,55,72,5319.46,11446.01,0.00
2024-12-10 17:24:54,128,8501,55,73,5274.33,11446.05,0.00
2024-12-10 17:24:54,127,8501,55,72,5309.01,11446.79,0.00
2024-12-10 17:24:54,127,8502,55,72,5370.62,11447.00,0.00
2024-12-10 17:24:54,128,8502,56,72,5328.66,11447.01,0.00
2024-12-10 17:24:54,127,8502,56,71,5360.74,11447.09,0.00
2024-12-10 17:24:54,127,8503,56,71,5426.31,11448.00,0.00
2024-12-10 17:24:54,128,8503,57,71,5383.91,11448.01,0.00
2024-12-10 17:24:54,127,8503,56,71,5417.09,11448.08,0.00
2024-12-10 17:24:54,126,8503,55,71,5459.17,11448.08,0.00
2024-12-10 17:24:54,126,8504,55,71,5430.58,11449.00,0.00
2024-12-10 17:24:54,127,8504,55,72,5387.82,11449.01,0.00
2024-12-10 17:24:54,126,8504,54,72,5420.26,11449.08,0.00
2024-12-10 17:24:54,127,8503,54,73,5315.85,11449.61,0.00
2024-12-10 17:24:54,127,8504,54,73,5386.30,11450.00,0.00
2024-12-10 17:24:54,128,8504,55,73,5344.22,11450.01,0.00
2024-12-10 17:24:54,129,8503,55,74,5302.79,11450.02,0.00
2024-12-10 17:24:54,128,8503,55,73,5409.59,11450.09,0.00
2024-12-10 17:24:54,128,8504,55,73,5450.35,11451.00,0.00
2024-12-10 17:24:54,129,8504,56,73,5408.09,11451.01,0.00
2024-12-10 17:24:54,128,8504,55,73,5437.48,11451.08,0.00
2024-12-10 17:24:54,128,8505,55,73,5473.43,11452.00,0.00
2024-12-10 17:24:54,129,8505,55,74,5431.00,11452.01,0.00
2024-12-10 17:24:54,128,8505,54,74,5459.92,11452.08,0.00
2024-12-10 17:24:54,129,8504,54,75,5390.12,11452.33,0.00
2024-12-10 17:24:54,129,8505,54,75,5454.03,11453.00,0.00
2024-12-10 17:24:54,130,8505,55,75,5412.08,11453.01,0.00
2024-12-10 17:24:54,129,8505,55,74,5440.98,11453.08,0.00
2024-12-10 17:24:54,128,8505,54,74,5415.39,11453.63,0.00
2024-12-10 17:24:54,128,8506,54,74,5542.61,11454.00,0.00
2024-12-10 17:24:54,129,8506,54,75,5499.65,11454.01,0.00
2024-12-10 17:24:54,128,8506,54,74,5530.44,11454.03,0.00
2024-12-10 17:24:54,128,8507,54,74,5491.93,11455.00,0.00
2024-12-10 17:24:54,129,8507,55,74,5449.36,11455.01,0.00
2024-12-10 17:24:54,128,8507,55,73,5477.88,11455.08,0.00
2024-12-10 17:24:54,129,8506,55,74,5399.97,11455.40,0.00
2024-12-10 17:24:54,129,8507,55,74,5436.18,11456.00,0.00
2024-12-10 17:24:54,130,8507,56,74,5394.37,11456.01,0.00
2024-12-10 17:24:54,129,8507,56,73,5421.97,11456.08,0.00
2024-12-10 17:24:54,128,8507,56,72,5462.53,11456.09,0.00
2024-12-10 17:24:54,127,8507,56,71,5489.78,11456.23,0.00
2024-12-10 17:24:54,126,8507,56,70,5473.02,11456.65,0.00
2024-12-10 17:24:54,125,8507,56,69,5499.68,11456.76,0.00
2024-12-10 17:24:54,125,8508,56,69,5590.60,11457.00,0.00
2024-12-10 17:24:54,126,8508,57,69,5546.24,11457.01,0.00
2024-12-10 17:24:54,127,8507,58,69,5502.56,11457.02,0.00
2024-12-10 17:24:54,126,8507,58,68,5558.10,11457.09,0.00
2024-12-10 17:24:54,125,8507,57,68,5596.49,11457.14,0.00
2024-12-10 17:24:54,124,8507,57,67,5545.32,11457.85,0.00
2024-12-10 17:24:54,124,8508,57,67,5614.66,11458.00,0.00
2024-12-10 17:24:54,125,8508,57,68,5569.74,11458.01,0.00
2024-12-10 17:24:54,124,8508,56,68,5544.02,11458.54,0.00
2024-12-10 17:24:54,124,8509,56,68,5613.84,11459.00,0.00
2024-12-10 17:24:54,125,8509,57,68,5568.93,11459.01,0.00
2024-12-10 17:24:54,126,8508,57,69,5480.39,11459.33,0.00
2024-12-10 17:24:54,125,8508,57,68,5563.25,11459.60,0.00
2024-12-10 17:24:54,124,8508,57,67,5524.61,11459.84,0.00
2024-12-10 17:24:54,124,8509,57,67,5585.28,11460.00,0.00
2024-12-10 17:24:54,125,8509,57,68,5540.60,11460.01,0.00
2024-12-10 17:24:54,125,8510,57,68,5566.65,11461.00,0.00
2024-12-10 17:24:54,126,8510,58,68,5522.47,11461.01,0.00
2024-12-10 17:24:54,125,8510,58,67,5553.86,11461.02,0.00
2024-12-10 17:24:54,124,8510,58,66,5589.44,11461.10,0.00
2024-12-10 17:24:54,123,8510,58,65,5633.95,11461.10,0.00
2024-12-10 17:24:54,124,8509,59,65,5519.02,11461.69,0.00
2024-12-10 17:24:54,124,8510,59,65,5576.78,11462.00,0.00
2024-12-10 17:24:54,125,8510,59,66,5532.17,11462.01,0.00
2024-12-10 17:24:54,126,8509,59,67,5488.26,11462.02,0.00
2024-12-10 17:24:54,125,8509,58,67,5558.47,11462.10,0.00
2024-12-10 17:24:54,125,8510,58,67,5547.17,11463.00,0.00
2024-12-10 17:24:54,126,8510,59,67,5503.15,11463.01,0.00
2024-12-10 17:24:54,127,8509,59,68,5445.36,11463.03,0.00
2024-12-10 17:24:54,126,8509,58,68,5569.59,11463.10,0.00
2024-12-10 17:24:54,126,8510,58,68,5538.93,11464.00,0.00
2024-12-10 17:24:54,127,8510,59,68,5495.32,11464.01,0.00
2024-12-10 17:24:54,128,8509,60,68,5350.86,11464.67,0.00
2024-12-10 17:24:54,128,8510,60,68,5426.20,11465.00,0.00
2024-12-10 17:24:54,129,8510,60,69,5384.14,11465.01,0.00
2024-12-10 17:24:54,128,8510,60,68,5397.13,11465.10,0.00
2024-12-10 17:24:54,127,8510,60,67,5371.99,11465.58,0.00
2024-12-10 17:24:54,127,8511,60,67,5397.33,11466.00,0.00
2024-12-10 17:24:54,128,8511,61,67,5355.16,11466.01,0.00
2024-12-10 17:24:54,127,8511,61,66,5222.08,11466.93,0.00
2024-12-10 17:24:54,127,8512,61,66,5228.38,11467.00,0.00
2024-12-10 17:24:54,128,8512,61,67,5187.54,11467.01,0.00
2024-12-10 17:24:54,127,8512,61,66,5221.98,11467.01,0.00
2024-12-10 17:24:55,126,8512,60,66,5251.64,11467.10,0.00
2024-12-10 17:24:55,125,8512,60,65,5135.80,11467.94,0.00
2024-12-10 17:24:55,125,8513,60,65,5143.47,11468.00,0.00
2024-12-10 17:24:55,126,8513,61,65,5102.65,11468.01,0.00
2024-12-10 17:24:55,125,8513,60,65,5131.59,11468.10,0.00
2024-12-10 17:24:55,124,8513,59,65,5168.97,11468.14,0.00
2024-12-10 17:24:55,123,8513,58,65,5160.88,11468.52,0.00
2024-12-10 17:24:55,122,8513,58,64,5124.49,11468.90,0.00
2024-12-10 17:24:55,122,8514,58,64,5096.23,11469.00,0.00
2024-12-10 17:24:55,123,8514,58,65,5054.80,11469.01,0.00
2024-12-10 17:24:55,122,8514,58,64,5084.05,11469.11,0.00
2024-12-10 17:24:55,121,8514,58,63,5069.83,11469.55,0.00
2024-12-10 17:24:55,120,8514,57,63,5086.48,11469.67,0.00
2024-12-10 17:24:55,119,8514,56,63,5055.12,11469.96,0.00
2024-12-10 17:24:55,119,8515,56,63,5080.15,11470.00,0.00
2024-12-10 17:24:55,120,8515,56,64,5037.81,11470.01,0.00
2024-12-10 17:24:55,119,8515,55,64,5067.66,11470.11,0.00
2024-12-10 17:24:55,118,8515,55,63,5001.05,11470.80,0.00
2024-12-10 17:24:55,117,8515,54,63,4986.94,11470.97,0.00
2024-12-10 17:24:55,116,8515,54,62,4994.85,11470.98,0.00
2024-12-10 17:24:55,116,8516,54,62,5091.77,11471.00,0.00
2024-12-10 17:24:55,117,8516,55,62,5048.25,11471.01,0.00
2024-12-10 17:24:55,116,8516,55,61,5086.94,11471.04,0.00
2024-12-10 17:24:55,115,8516,54,61,5123.23,11471.10,0.00
2024-12-10 17:24:55,114,8516,53,61,5044.15,11471.90,0.00
2024-12-10 17:24:55,114,8517,53,61,5105.76,11472.00,0.00
2024-12-10 17:24:55,115,8517,54,61,5061.37,11472.01,0.00
2024-12-10 17:24:55,114,8517,53,61,5093.73,11472.11,0.00
2024-12-10 17:24:55,113,8517,53,60,5137.69,11472.12,0.00
2024-12-10 17:24:55,112,8517,52,60,5160.03,11472.32,0.00
2024-12-10 17:24:55,111,8517,51,60,5095.71,11472.94,0.00
2024-12-10 17:24:55,111,8517,51,60,5185.55,11473.00,0.00
2024-12-10 17:24:55,112,8517,52,60,5139.25,11473.01,0.00
2024-12-10 17:24:55,111,8517,51,60,5111.40,11473.55,0.00
2024-12-10 17:24:55,110,8517,51,59,5150.41,11473.56,0.00
2024-12-10 17:24:55,110,8518,51,59,5183.79,11474.00,0.00
2024-12-10 17:24:55,111,8518,52,59,5137.09,11474.01,0.00
2024-12-10 17:24:55,110,8518,51,59,5151.99,11474.28,0.00
2024-12-10 17:24:55,109,8518,51,58,5119.67,11474.72,0.00
2024-12-10 17:24:55,109,8519,51,58,5186.30,11475.00,0.00
2024-12-10 17:24:55,110,8519,51,59,5139.15,11475.01,0.00
2024-12-10 17:24:55,109,8519,51,58,5173.71,11475.11,0.00
2024-12-10 17:24:55,108,8519,50,58,5184.75,11475.42,0.00
2024-12-10 17:24:55,108,8520,50,58,5191.79,11476.00,0.00
2024-12-10 17:24:55,109,8520,50,59,5144.16,11476.01,0.00
2024-12-10 17:24:55,108,8520,50,58,5102.30,11476.66,0.00
2024-12-10 17:24:55,109,8519,50,59,5048.93,11476.72,0.00
2024-12-10 17:24:55,109,8520,50,59,5149.09,11477.00,0.00
2024-12-10 17:24:55,110,8520,51,59,5102.28,11477.01,0.00
2024-12-10 17:24:55,109,8520,50,59,5136.50,11477.11,0.00
2024-12-10 17:24:55,108,8520,49,59,5146.23,11477.44,0.00
2024-12-10 17:24:55,108,8521,49,59,5286.04,11478.00,0.00
2024-12-10 17:24:55,109,8521,50,59,5237.54,11478.01,0.00
2024-12-10 17:24:55,108,8521,50,58,5273.32,11478.11,0.00
2024-12-10 17:24:55,107,8521,49,58,5317.85,11478.15,0.00
2024-12-10 17:24:55,106,8521,49,57,5304.45,11478.61,0.00
2024-12-10 17:24:55,106,8522,49,57,5365.01,11479.00,0.00
2024-12-10 17:24:55,107,8522,49,58,5314.87,11479.01,0.00
2024-12-10 17:24:55,106,8522,49,57,5361.78,11479.03,0.00
2024-12-10 17:24:55,105,8522,49,56,5406.30,11479.08,0.00
2024-12-10 17:24:55,104,8522,49,55,5454.98,11479.10,0.00
2024-12-10 17:24:55,103,8522,49,54,5506.83,11479.10,0.00
2024-12-10 17:24:55,104,8521,50,54,5402.01,11479.53,0.00
2024-12-10 17:24:55,103,8521,50,53,5460.94,11479.88,0.00
2024-12-10 17:24:55,103,8522,50,53,5559.12,11480.00,0.00
2024-12-10 17:24:55,104,8522,50,54,5505.66,11480.01,0.00
2024-12-10 17:24:55,103,8522,50,53,5546.90,11480.11,0.00
2024-12-10 17:24:55,103,8523,50,53,5651.43,11481.00,0.00
2024-12-10 17:24:55,104,8523,50,54,5597.09,11481.01,0.00
2024-12-10 17:24:55,103,8523,49,54,5599.76,11481.45,0.00
2024-12-10 17:24:55,102,8523,49,53,5635.27,11481.60,0.00
2024-12-10 17:24:55,102,8524,49,53,5691.65,11482.00,0.00
2024-12-10 17:24:55,103,8524,49,54,5636.39,11482.01,0.00
2024-12-10 17:24:55,102,8524,48,54,5678.18,11482.12,0.00
2024-12-10 17:24:55,102,8525,48,54,5677.02,11483.00,0.00
2024-12-10 17:24:55,103,8525,48,55,5621.90,11483.01,0.00
2024-12-10 17:24:55,102,8525,48,54,5663.55,11483.12,0.00
2024-12-10 17:24:55,102,8526,48,54,5664.19,11484.00,0.00
2024-12-10 17:24:55,103,8526,48,55,5609.20,11484.01,0.00
2024-12-10 17:24:55,102,8526,48,54,5650.72,11484.12,0.00
2024-12-10 17:24:55,102,8527,48,54,5661.33,11485.00,0.00
2024-12-10 17:24:55,103,8527,49,54,5606.36,11485.01,0.00
2024-12-10 17:24:55,102,8527,49,53,5616.15,11485.40,0.00
2024-12-10 17:24:55,101,8527,48,53,5669.23,11485.43,0.00
2024-12-10 17:24:55,102,8526,48,54,5596.83,11485.59,0.00
2024-12-10 17:24:55,102,8527,48,54,5703.32,11486.00,0.00
2024-12-10 17:24:55,103,8527,48,55,5647.95,11486.01,0.00
2024-12-10 17:24:55,102,8527,48,54,5688.73,11486.13,0.00
2024-12-10 17:24:55,102,8528,48,54,5800.53,11487.00,0.00
2024-12-10 17:24:55,103,8528,49,54,5744.22,11487.01,0.00
2024-12-10 17:24:55,102,8528,49,53,5785.94,11487.13,0.00
2024-12-10 17:24:55,102,8529,49,53,5781.92,11488.00,0.00
2024-12-10 17:24:55,103,8529,50,53,5725.79,11488.01,0.00
2024-12-10 17:24:55,102,8529,50,52,5778.56,11488.03,0.00
2024-12-10 17:24:55,101,8529,50,51,5824.43,11488.12,0.00
2024-12-10 17:24:55,100,8529,50,50,5881.52,11488.12,0.00
2024-12-10 17:24:55,100,8530,50,50,5880.77,11489.00,0.00
2024-12-10 17:24:55,101,8530,51,50,5822.54,11489.01,0.00
2024-12-10 17:24:55,100,8530,50,50,5875.04,11489.05,0.00
2024-12-10 17:24:55,99,8530,50,49,5924.65,11489.12,0.00
2024-12-10 17:24:55,98,8530,50,48,5957.55,11489.35,0.00
2024-12-10 17:24:55,98,8531,50,48,5987.66,11490.00,0.00
2024-12-10 17:24:55,99,8531,51,48,5927.18,11490.01,0.00
2024-12-10 17:24:55,98,8531,51,47,5972.26,11490.14,0.00
2024-12-10 17:24:56,98,8532,51,47,5978.66,11491.00,0.00
2024-12-10 17:24:56,99,8532,52,47,5918.27,11491.01,0.00
2024-12-10 17:24:56,98,8532,51,47,5964.64,11491.12,0.00
2024-12-10 17:24:56,97,8532,50,47,5991.86,11491.36,0.00
2024-12-10 17:24:56,97,8533,50,47,6027.81,11492.00,0.00
2024-12-10 17:24:56,98,8533,51,47,5966.30,11492.01,0.00
2024-12-10 17:24:56,97,8533,50,47,6013.64,11492.12,0.00
2024-12-10 17:24:56,97,8534,50,47,6013.45,11493.00,0.00
2024-12-10 17:24:56,98,8534,50,48,5952.08,11493.01,0.00
2024-12-10 17:24:56,97,8534,49,48,5983.88,11493.27,0.00
2024-12-10 17:24:56,96,8534,49,47,6043.05,11493.29,0.00
2024-12-10 17:24:56,96,8535,49,47,6058.04,11494.00,0.00
2024-12-10 17:24:56,97,8535,49,48,5995.59,11494.01,0.00
2024-12-10 17:24:56,96,8535,48,48,6043.73,11494.13,0.00
2024-12-10 17:24:56,95,8535,48,47,6073.20,11494.34,0.00
2024-12-10 17:24:56,95,8536,48,47,6114.03,11495.00,0.00
2024-12-10 17:24:56,96,8536,48,48,6050.34,11495.01,0.00
2024-12-10 17:24:56,95,8536,48,47,6094.69,11495.17,0.00
2024-12-10 17:24:56,95,8537,48,47,6119.02,11496.00,0.00
2024-12-10 17:24:56,96,8537,48,48,6055.28,11496.01,0.00
2024-12-10 17:24:56,95,8537,48,47,6101.11,11496.13,0.00
2024-12-10 17:24:56,95,8538,48,47,6119.56,11497.00,0.00
2024-12-10 17:24:56,96,8538,49,47,6055.82,11497.01,0.00
2024-12-10 17:24:56,95,8538,48,47,6098.51,11497.13,0.00
2024-12-10 17:24:56,94,8538,47,47,6148.59,11497.25,0.00
2024-12-10 17:24:56,94,8539,47,47,6180.01,11498.00,0.00
2024-12-10 17:24:56,95,8539,47,48,6114.95,11498.01,0.00
2024-12-10 17:24:56,94,8539,47,47,6158.17,11498.13,0.00
2024-12-10 17:24:56,93,8539,46,47,6212.44,11498.23,0.00
2024-12-10 17:24:56,93,8540,46,47,6233.95,11499.00,0.00
2024-12-10 17:24:56,94,8540,47,47,6167.63,11499.01,0.00
2024-12-10 17:24:56,93,8540,46,47,6212.94,11499.13,0.00
2024-12-10 17:24:56,92,8540,46,46,6249.48,11499.34,0.00
2024-12-10 17:24:56,93,8539,46,47,6150.85,11499.61,0.00
2024-12-10 17:24:56,93,8540,46,47,6322.34,11500.00,0.00
2024-12-10 17:24:56,94,8540,47,47,6255.08,11500.01,0.00
2024-12-10 17:24:56,93,8540,47,46,6302.91,11500.13,0.00
2024-12-10 17:24:56,92,8540,46,46,6366.53,11500.16,0.00
2024-12-10 17:24:56,92,8541,46,46,6515.62,11501.00,0.00
2024-12-10 17:24:56,93,8541,46,47,6445.56,11501.01,0.00
2024-12-10 17:24:56,93,8542,46,47,6446.00,11502.00,0.00
2024-12-10 17:24:56,94,8542,46,48,6377.42,11502.01,0.00
2024-12-10 17:24:56,93,8542,46,47,6439.83,11502.05,0.00
2024-12-10 17:24:56,94,8541,47,47,6361.62,11502.15,0.00
2024-12-10 17:24:56,93,8541,46,47,6530.21,11502.15,0.00
2024-12-10 17:24:56,93,8542,46,47,6542.44,11503.00,0.00
2024-12-10 17:24:56,94,8542,47,47,6472.84,11503.01,0.00
2024-12-10 17:24:56,94,8543,47,47,6593.79,11504.00,0.00
2024-12-10 17:24:56,95,8543,48,47,6524.38,11504.01,0.00
2024-12-10 17:24:56,94,8543,48,46,6577.63,11504.14,0.00
2024-12-10 17:24:56,94,8544,48,46,6598.91,11505.00,0.00
2024-12-10 17:24:56,95,8544,49,46,6529.45,11505.01,0.00
2024-12-10 17:24:56,94,8544,48,46,6589.14,11505.08,0.00
2024-12-10 17:24:56,93,8544,48,45,6653.74,11505.13,0.00
2024-12-10 17:24:56,93,8545,48,45,6662.46,11506.00,0.00
2024-12-10 17:24:56,94,8545,49,45,6591.58,11506.01,0.00
2024-12-10 17:24:56,93,8545,48,45,6646.63,11506.13,0.00
2024-12-10 17:24:56,93,8545,48,45,6639.02,11507.00,0.00
2024-12-10 17:24:56,94,8545,49,45,6568.39,11507.01,0.00
2024-12-10 17:24:56,93,8545,49,44,6579.02,11507.34,0.00
2024-12-10 17:24:56,92,8545,48,44,6612.12,11507.67,0.00
2024-12-10 17:24:56,92,8546,48,44,6699.96,11508.00,0.00
2024-12-10 17:24:56,93,8546,48,45,6627.92,11508.01,0.00
2024-12-10 17:24:56,94,8545,48,46,6509.98,11508.30,0.00
2024-12-10 17:24:56,93,8545,47,46,6585.16,11508.48,0.00
2024-12-10 17:24:56,93,8546,47,46,6649.91,11509.00,0.00
2024-12-10 17:24:56,94,8546,48,46,6579.17,11509.01,0.00
2024-12-10 17:24:56,94,8547,48,46,6690.00,11510.00,0.00
2024-12-10 17:24:56,95,8547,49,46,6619.58,11510.01,0.00
2024-12-10 17:24:56,94,8547,49,45,6669.09,11510.13,0.00
2024-12-10 17:24:56,94,8548,49,45,6680.71,11511.00,0.00
2024-12-10 17:24:56,95,8548,49,46,6610.39,11511.01,0.00
2024-12-10 17:24:56,95,8549,49,46,6603.62,11512.00,0.00
2024-12-10 17:24:56,96,8549,50,46,6534.83,11512.01,0.00
2024-12-10 17:24:56,96,8550,50,46,6515.18,11513.00,0.00
2024-12-10 17:24:56,97,8550,51,46,6448.01,11513.01,0.00
2024-12-10 17:24:56,98,8549,51,47,6366.53,11513.13,0.00
2024-12-10 17:24:56,97,8549,50,47,6419.50,11513.21,0.00
2024-12-10 17:24:56,97,8550,50,47,6424.51,11514.00,0.00
2024-12-10 17:24:56,98,8550,50,48,6358.95,11514.01,0.00
2024-12-10 17:24:56,97,8550,49,48,6341.78,11514.41,0.00
2024-12-10 17:24:56,97,8551,49,48,6510.10,11515.00,0.00
2024-12-10 17:24:56,98,8551,49,49,6443.68,11515.01,0.00
2024-12-10 17:24:56,97,8551,49,48,6497.04,11515.08,0.00
2024-12-10 17:24:56,96,8551,49,47,6535.65,11515.21,0.00
2024-12-10 17:24:56,97,8550,50,47,6439.87,11515.47,0.00
2024-12-10 17:24:56,97,8551,50,47,6551.88,11516.00,0.00
2024-12-10 17:24:56,98,8551,51,47,6485.02,11516.01,0.00
2024-12-10 17:24:56,99,8550,52,47,6365.64,11516.45,0.00
2024-12-10 17:24:56,99,8551,52,47,6590.58,11517.00,0.00
2024-12-10 17:24:56,100,8551,53,47,6524.68,11517.01,0.00
2024-12-10 17:24:57,99,8551,53,46,6570.55,11517.14,0.00
2024-12-10 17:24:57,98,8551,52,46,6634.79,11517.16,0.00
2024-12-10 17:24:57,98,8552,52,46,6769.80,11518.00,0.00
2024-12-10 17:24:57,99,8552,52,47,6701.42,11518.01,0.00
2024-12-10 17:24:57,100,8551,52,48,6627.51,11518.09,0.00
2024-12-10 17:24:57,99,8551,51,48,6778.11,11518.15,0.00
2024-12-10 17:24:57,99,8552,51,48,6787.14,11519.00,0.00
2024-12-10 17:24:57,100,8552,51,49,6719.27,11519.01,0.00
2024-12-10 17:24:57,99,8552,50,49,6765.44,11519.11,0.00
2024-12-10 17:24:57,100,8551,51,49,6694.32,11519.16,0.00
2024-12-10 17:24:57,100,8552,51,49,6907.29,11520.00,0.00
2024-12-10 17:24:57,101,8552,51,50,6838.90,11520.01,0.00
2024-12-10 17:24:57,101,8553,51,50,6931.51,11521.00,0.00
2024-12-10 17:24:57,102,8553,52,50,6863.55,11521.01,0.00
2024-12-10 17:24:57,102,8554,52,50,6842.73,11522.00,0.00
2024-12-10 17:24:57,103,8554,53,50,6776.30,11522.01,0.00
2024-12-10 17:24:57,103,8555,53,50,6751.33,11523.00,0.00
2024-12-10 17:24:57,104,8555,53,51,6686.41,11523.01,0.00
2024-12-10 17:24:57,104,8556,53,51,6655.97,11524.00,0.00
2024-12-10 17:24:57,105,8556,53,52,6592.58,11524.01,0.00
2024-12-10 17:24:57,104,8556,53,51,6598.48,11524.33,0.00
2024-12-10 17:24:57,104,8557,53,51,6626.30,11525.00,0.00
2024-12-10 17:24:57,105,8557,54,51,6563.20,11525.01,0.00
2024-12-10 17:24:57,105,8558,54,51,6539.66,11526.00,0.00
2024-12-10 17:24:57,106,8558,55,51,6477.97,11526.01,0.00
2024-12-10 17:24:57,105,8558,54,51,6523.95,11526.07,0.00
2024-12-10 17:24:57,105,8559,54,51,6521.11,11527.00,0.00
2024-12-10 17:24:57,106,8559,55,51,6459.59,11527.01,0.00
2024-12-10 17:24:57,106,8560,55,51,6446.44,11528.00,0.00
2024-12-10 17:24:57,107,8560,56,51,6386.19,11528.01,0.00
2024-12-10 17:24:57,106,8560,55,51,6441.01,11528.05,0.00
2024-12-10 17:24:57,106,8561,55,51,6430.76,11529.00,0.00
2024-12-10 17:24:57,107,8561,55,52,6370.66,11529.01,0.00
2024-12-10 17:24:57,106,8561,54,52,6421.53,11529.08,0.00
2024-12-10 17:24:57,106,8562,54,52,6413.74,11530.00,0.00
2024-12-10 17:24:57,107,8562,55,52,6353.80,11530.01,0.00
2024-12-10 17:24:57,107,8563,55,52,6329.00,11531.00,0.00
2024-12-10 17:24:57,108,8563,55,53,6270.39,11531.01,0.00
2024-12-10 17:24:57,107,8563,54,53,6321.46,11531.07,0.00
2024-12-10 17:24:57,107,8564,54,53,6302.21,11532.00,0.00
2024-12-10 17:24:57,108,8564,55,53,6243.86,11532.01,0.00
2024-12-10 17:24:57,108,8565,55,53,6215.18,11533.00,0.00
2024-12-10 17:24:57,109,8565,56,53,6158.16,11533.01,0.00
2024-12-10 17:24:57,108,8565,55,53,6211.98,11533.03,0.00
2024-12-10 17:24:57,108,8566,55,53,6178.50,11534.00,0.00
2024-12-10 17:24:57,109,8566,56,53,6121.82,11534.01,0.00
2024-12-10 17:24:57,109,8567,56,53,6084.22,11535.00,0.00
2024-12-10 17:24:57,110,8567,56,54,6028.91,11535.01,0.00
2024-12-10 17:24:57,109,8567,56,53,6081.05,11535.03,0.00
2024-12-10 17:24:57,108,8567,56,52,6136.29,11535.03,0.00
2024-12-10 17:24:57,107,8567,55,52,6187.19,11535.08,0.00
2024-12-10 17:24:57,106,8567,54,52,6148.76,11535.81,0.00
2024-12-10 17:24:57,106,8568,54,52,6235.99,11536.00,0.00
2024-12-10 17:24:57,107,8568,54,53,6177.71,11536.01,0.00
2024-12-10 17:24:57,107,8569,54,53,6164.31,11537.00,0.00
2024-12-10 17:24:57,108,8569,55,53,6107.23,11537.01,0.00
2024-12-10 17:24:57,108,8570,55,53,6094.42,11538.00,0.00
2024-12-10 17:24:57,109,8570,55,54,6038.51,11538.01,0.00
2024-12-10 17:24:57,108,8570,55,53,6075.06,11538.18,0.00
2024-12-10 17:24:57,108,8571,55,53,6080.39,11539.00,0.00
2024-12-10 17:24:57,109,8571,55,54,6024.61,11539.01,0.00
2024-12-10 17:24:57,109,8572,55,54,6007.56,11540.00,0.00
2024-12-10 17:24:57,110,8572,55,55,5952.94,11540.01,0.00
2024-12-10 17:24:57,109,8572,54,55,5994.00,11540.12,0.00
2024-12-10 17:24:57,109,8573,54,55,5988.27,11541.00,0.00
2024-12-10 17:24:57,110,8573,54,56,5933.83,11541.01,0.00
2024-12-10 17:24:57,110,8574,54,56,5914.28,11542.00,0.00
2024-12-10 17:24:57,111,8574,55,56,5861.00,11542.01,0.00
2024-12-10 17:24:57,110,8574,55,55,5909.04,11542.05,0.00
2024-12-10 17:24:57,109,8574,55,54,5958.47,11542.06,0.00
2024-12-10 17:24:57,108,8574,54,54,6012.57,11542.06,0.00
2024-12-10 17:24:57,108,8575,54,54,6003.75,11543.00,0.00
2024-12-10 17:24:57,109,8575,54,55,5948.67,11543.01,0.00
2024-12-10 17:24:57,108,8575,53,55,5977.93,11543.23,0.00
2024-12-10 17:24:57,108,8576,53,55,5987.33,11544.00,0.00
2024-12-10 17:24:57,109,8576,53,56,5932.40,11544.01,0.00
2024-12-10 17:24:58,109,8577,53,56,5913.73,11545.00,0.00
2024-12-10 17:24:58,110,8577,53,57,5859.97,11545.01,0.00
2024-12-10 17:24:58,110,8578,53,57,5838.81,11546.00,0.00
2024-12-10 17:24:58,111,8578,53,58,5786.21,11546.01,0.00
2024-12-10 17:24:58,110,8578,53,57,5836.97,11546.02,0.00
2024-12-10 17:24:58,109,8578,53,56,5882.68,11546.07,0.00
2024-12-10 17:24:58,108,8578,52,56,5930.82,11546.12,0.00
2024-12-10 17:24:58,107,8578,51,56,5916.63,11546.70,0.00
2024-12-10 17:24:58,107,8579,51,56,5989.41,11547.00,0.00
2024-12-10 17:24:58,108,8579,51,57,5933.95,11547.01,0.00
2024-12-10 17:24:58,108,8580,51,57,5919.55,11548.00,0.00
2024-12-10 17:24:58,109,8580,52,57,5865.24,11548.01,0.00
2024-12-10 17:24:58,108,8580,51,57,5910.35,11548.07,0.00
2024-12-10 17:24:58,108,8581,51,57,5900.31,11549.00,0.00
2024-12-10 17:24:58,109,8581,52,57,5846.18,11549.01,0.00
2024-12-10 17:24:58,108,8581,52,56,5890.49,11549.07,0.00
2024-12-10 17:24:58,107,8581,52,55,5925.39,11549.19,0.00
2024-12-10 17:24:58,107,8582,52,55,5938.47,11550.00,0.00
2024-12-10 17:24:58,108,8582,52,56,5883.48,11550.01,0.00
2024-12-10 17:24:58,107,8582,52,55,5935.05,11550.04,0.00
2024-12-10 17:24:58,106,8582,51,55,5986.69,11550.07,0.00
2024-12-10 17:24:58,106,8583,51,55,5984.97,11551.00,0.00
2024-12-10 17:24:58,107,8583,51,56,5929.03,11551.01,0.00
2024-12-10 17:24:58,106,8583,50,56,5977.36,11551.07,0.00
2024-12-10 17:24:58,106,8584,50,56,5970.62,11552.00,0.00
2024-12-10 17:24:58,107,8584,51,56,5914.82,11552.01,0.00
2024-12-10 17:24:58,106,8584,51,55,5963.02,11552.07,0.00
2024-12-10 17:24:58,106,8585,51,55,5956.45,11553.00,0.00
2024-12-10 17:24:58,107,8585,52,55,5900.78,11553.01,0.00
2024-12-10 17:24:58,107,8586,52,55,5878.12,11554.00,0.00
2024-12-10 17:24:58,108,8586,52,56,5823.69,11554.01,0.00
2024-12-10 17:24:58,107,8586,52,55,5870.58,11554.07,0.00
2024-12-10 17:24:58,107,8587,52,55,5857.58,11555.00,0.00
2024-12-10 17:24:58,108,8587,53,55,5803.35,11555.01,0.00
2024-12-10 17:24:58,107,8587,53,54,5855.43,11555.02,0.00
2024-12-10 17:24:58,106,8587,52,54,5905.23,11555.06,0.00
2024-12-10 17:24:58,105,8587,52,53,5960.37,11555.06,0.00
2024-12-10 17:24:58,105,8588,52,53,5954.95,11556.00,0.00
2024-12-10 17:24:58,106,8588,53,53,5898.77,11556.01,0.00
2024-12-10 17:24:58,105,8588,52,53,5948.37,11556.06,0.00
2024-12-10 17:24:58,104,8588,51,53,6004.07,11556.07,0.00
2024-12-10 17:24:58,104,8589,51,53,6005.13,11557.00,0.00
2024-12-10 17:24:58,105,8589,51,54,5947.94,11557.01,0.00
2024-12-10 17:24:58,104,8589,50,54,5998.48,11557.06,0.00
2024-12-10 17:24:58,104,8590,50,54,5995.03,11558.00,0.00
2024-12-10 17:24:58,105,8590,51,54,5937.93,11558.01,0.00
2024-12-10 17:24:58,105,8591,51,54,5925.09,11559.00,0.00
2024-12-10 17:24:58,106,8591,52,54,5869.19,11559.01,0.00
2024-12-10 17:24:58,106,8592,52,54,5849.66,11560.00,0.00
2024-12-10 17:24:58,107,8592,53,54,5794.99,11560.01,0.00
2024-12-10 17:24:58,107,8593,53,54,5766.06,11561.00,0.00
2024-12-10 17:24:58,108,8593,53,55,5712.67,11561.01,0.00
2024-12-10 17:24:58,109,8592,53,56,5558.45,11561.89,0.00
2024-12-10 17:24:58,109,8593,53,56,5658.45,11562.00,0.00
2024-12-10 17:24:58,110,8593,53,57,5607.01,11562.01,0.00
2024-12-10 17:24:58,110,8594,53,57,5670.68,11563.00,0.00
2024-12-10 17:24:58,111,8594,54,57,5619.59,11563.01,0.00
2024-12-10 17:24:58,110,8594,53,57,5669.63,11563.01,0.00
2024-12-10 17:24:58,109,8594,53,56,5715.30,11563.05,0.00
2024-12-10 17:24:58,108,8594,52,56,5660.97,11563.87,0.00
2024-12-10 17:24:58,108,8595,52,56,5748.72,11564.00,0.00
2024-12-10 17:24:58,109,8595,52,57,5695.98,11564.01,0.00
2024-12-10 17:24:58,108,8595,51,57,5742.31,11564.06,0.00
2024-12-10 17:24:58,108,8596,51,57,5729.84,11565.00,0.00
2024-12-10 17:24:58,109,8596,51,58,5677.27,11565.01,0.00
2024-12-10 17:24:58,109,8597,51,58,5651.47,11566.00,0.00
2024-12-10 17:24:58,110,8597,52,58,5600.10,11566.01,0.00
2024-12-10 17:24:58,110,8598,52,58,5559.92,11567.00,0.00
2024-12-10 17:24:58,111,8598,52,59,5509.84,11567.01,0.00
2024-12-10 17:24:58,111,8599,52,59,5472.18,11568.00,0.00
2024-12-10 17:24:58,112,8599,53,59,5423.32,11568.01,0.00
2024-12-10 17:24:58,112,8600,53,59,5396.02,11569.00,0.00
2024-12-10 17:24:58,113,8600,53,60,5348.26,11569.01,0.00
2024-12-10 17:24:58,113,8601,53,60,5322.07,11570.00,0.00
2024-12-10 17:24:59,114,8601,54,60,5275.39,11570.01,0.00
2024-12-10 17:24:59,113,8601,54,59,5315.94,11570.05,0.00
2024-12-10 17:24:59,113,8602,54,59,5291.25,11571.00,0.00
2024-12-10 17:24:59,114,8602,55,59,5244.84,11571.01,0.00
2024-12-10 17:24:59,113,8602,54,59,5285.12,11571.05,0.00
2024-12-10 17:24:59,114,8601,55,59,5150.94,11571.81,0.00
2024-12-10 17:24:59,114,8602,55,59,5294.84,11572.00,0.00
2024-12-10 17:24:59,115,8602,55,60,5248.79,11572.01,0.00
2024-12-10 17:24:59,114,8602,54,60,5288.76,11572.05,0.00
2024-12-10 17:24:59,114,8603,54,60,5356.72,11573.00,0.00
2024-12-10 17:24:59,115,8603,55,60,5310.14,11573.01,0.00
2024-12-10 17:24:59,114,8603,54,60,5350.64,11573.05,0.00
2024-12-10 17:24:59,114,8604,54,60,5329.73,11574.00,0.00
2024-12-10 17:24:59,115,8604,55,60,5283.39,11574.01,0.00
2024-12-10 17:24:59,114,8604,54,60,5323.65,11574.05,0.00
2024-12-10 17:24:59,114,8605,54,60,5299.25,11575.00,0.00
2024-12-10 17:24:59,115,8605,55,60,5253.17,11575.01,0.00
2024-12-10 17:24:59,114,8605,55,59,5293.17,11575.05,0.00
2024-12-10 17:24:59,114,8606,55,59,5258.61,11576.00,0.00
2024-12-10 17:24:59,115,8606,55,60,5212.88,11576.01,0.00
2024-12-10 17:24:59,114,8606,55,59,5254.56,11576.04,0.00
2024-12-10 17:24:59,113,8606,55,58,5299.01,11576.04,0.00
2024-12-10 17:24:59,112,8606,55,57,5345.29,11576.04,0.00
2024-12-10 17:24:59,111,8606,55,56,5362.94,11576.26,0.00
2024-12-10 17:24:59,111,8607,55,56,5361.78,11577.00,0.00
2024-12-10 17:24:59,112,8607,55,57,5313.91,11577.01,0.00
2024-12-10 17:24:59,111,8607,54,57,5356.58,11577.04,0.00
2024-12-10 17:24:59,111,8608,54,57,5331.99,11578.00,0.00
2024-12-10 17:24:59,112,8608,55,57,5284.38,11578.01,0.00
2024-12-10 17:24:59,111,8608,54,57,5326.78,11578.04,0.00
2024-12-10 17:24:59,111,8609,54,57,5310.22,11579.00,0.00
2024-12-10 17:24:59,112,8609,55,57,5262.80,11579.01,0.00
2024-12-10 17:24:59,111,8609,55,56,5304.78,11579.04,0.00
2024-12-10 17:24:59,111,8610,55,56,5289.52,11580.00,0.00
2024-12-10 17:24:59,112,8610,55,57,5242.29,11580.01,0.00
2024-12-10 17:24:59,111,8610,55,56,5284.31,11580.04,0.00
2024-12-10 17:24:59,111,8611,55,56,5268.18,11581.00,0.00
2024-12-10 17:24:59,112,8611,56,56,5221.15,11581.01,0.00
2024-12-10 17:24:59,111,8611,56,55,5262.98,11581.04,0.00
2024-12-10 17:24:59,111,8612,56,55,5246.67,11582.00,0.00
2024-12-10 17:24:59,112,8612,56,56,5199.82,11582.01,0.00
2024-12-10 17:24:59,111,8612,56,55,5241.46,11582.04,0.00
2024-12-10 17:24:59,111,8613,56,55,5224.97,11583.00,0.00
2024-12-10 17:24:59,112,8613,57,55,5178.32,11583.01,0.00
2024-12-10 17:24:59,111,8613,57,54,5219.76,11583.04,0.00
2024-12-10 17:24:59,111,8614,57,54,5205.09,11584.00,0.00
2024-12-10 17:24:59,112,8614,57,55,5158.62,11584.01,0.00
2024-12-10 17:24:59,111,8614,57,54,5199.88,11584.04,0.00
2024-12-10 17:24:59,111,8615,57,54,5187.81,11585.00,0.00
2024-12-10 17:24:59,112,8615,58,54,5141.49,11585.01,0.00
2024-12-10 17:24:59,111,8615,57,54,5182.60,11585.04,0.00
2024-12-10 17:24:59,110,8615,57,53,5228.66,11585.05,0.00
2024-12-10 17:24:59,110,8616,57,53,5215.04,11586.00,0.00
2024-12-10 17:24:59,111,8616,57,54,5168.05,11586.01,0.00
2024-12-10 17:24:59,110,8616,57,53,5209.78,11586.05,0.00
2024-12-10 17:24:59,109,8616,57,52,5188.50,11586.62,0.00
2024-12-10 17:24:59,109,8617,57,52,5249.44,11587.00,0.00
2024-12-10 17:24:59,110,8617,57,53,5201.72,11587.01,0.00
2024-12-10 17:24:59,109,8617,56,53,5244.13,11587.05,0.00
2024-12-10 17:24:59,108,8617,55,53,5217.27,11587.64,0.00
2024-12-10 17:24:59,108,8618,55,53,5281.79,11588.00,0.00
2024-12-10 17:24:59,109,8618,55,54,5233.34,11588.01,0.00
2024-12-10 17:24:59,108,8618,54,54,5276.44,11588.05,0.00
2024-12-10 17:24:59,108,8619,54,54,5271.10,11589.00,0.00
2024-12-10 17:24:59,109,8619,55,54,5222.74,11589.01,0.00
2024-12-10 17:24:59,108,8619,54,54,5265.75,11589.05,0.00
2024-12-10 17:24:59,108,8620,54,54,5257.54,11590.00,0.00
2024-12-10 17:24:59,109,8620,55,54,5209.31,11590.01,0.00
2024-12-10 17:24:59,108,8620,54,54,5252.19,11590.05,0.00
2024-12-10 17:24:59,108,8621,54,54,5242.44,11591.00,0.00
2024-12-10 17:24:59,109,8621,55,54,5194.35,11591.01,0.00
2024-12-10 17:24:59,108,8621,54,54,5237.08,11591.05,0.00
2024-12-10 17:24:59,108,8622,54,54,5229.51,11592.00,0.00
2024-12-10 17:24:59,109,8622,55,54,5181.53,11592.01,0.00
2024-12-10 17:24:59,108,8622,54,54,5224.15,11592.05,0.00
2024-12-10 17:24:59,108,8623,54,54,5219.51,11593.00,0.00
2024-12-10 17:24:59,109,8623,54,55,5171.63,11593.01,0.00
2024-12-10 17:24:59,108,8623,54,54,5214.15,11593.05,0.00
2024-12-10 17:24:59,108,8624,54,54,5210.36,11594.00,0.00
2024-12-10 17:24:59,109,8624,55,54,5162.56,11594.01,0.00
2024-12-10 17:24:59,108,8624,55,53,5205.00,11594.05,0.00
2024-12-10 17:24:59,107,8624,55,52,5178.28,11594.69,0.00
2024-12-10 17:24:59,107,8625,55,52,5250.76,11595.00,0.00
2024-12-10 17:25:00,108,8625,56,52,5202.14,11595.01,0.00
2024-12-10 17:25:00,107,8625,56,51,5245.34,11595.05,0.00
2024-12-10 17:25:00,107,8626,56,51,5243.50,11596.00,0.00
2024-12-10 17:25:00,108,8626,56,52,5194.95,11596.01,0.00
2024-12-10 17:25:00,107,8626,56,51,5238.09,11596.05,0.00
2024-12-10 17:25:00,107,8627,56,51,5236.31,11597.00,0.00
2024-12-10 17:25:00,108,8627,56,52,5187.82,11597.01,0.00
2024-12-10 17:25:00,107,8627,55,52,5230.89,11597.05,0.00
2024-12-10 17:25:00,107,8628,55,52,5227.50,11598.00,0.00
2024-12-10 17:25:00,108,8628,55,53,5179.10,11598.01,0.00
2024-12-10 17:25:00,107,8628,55,52,5222.08,11598.05,0.00
2024-12-10 17:25:00,106,8628,55,51,5245.12,11598.26,0.00
2024-12-10 17:25:00,106,8629,55,51,5262.21,11599.00,0.00
2024-12-10 17:25:00,107,8629,55,52,5213.03,11599.01,0.00
2024-12-10 17:25:00,106,8629,55,51,5257.84,11599.04,0.00
2024-12-10 17:25:00,105,8629,54,51,5306.81,11599.04,0.00
2024-12-10 17:25:00,104,8629,54,50,5305.02,11599.49,0.00
2024-12-10 17:25:00,104,8630,54,50,5353.38,11600.00,0.00
2024-12-10 17:25:00,105,8630,54,51,5302.39,11600.01,0.00
2024-12-10 17:25:00,104,8630,53,51,5348.92,11600.04,0.00
2024-12-10 17:25:00,104,8631,53,51,5349.37,11601.00,0.00
2024-12-10 17:25:00,105,8631,54,51,5298.43,11601.01,0.00
2024-12-10 17:25:00,104,8631,54,50,5344.91,11601.04,0.00
2024-12-10 17:25:00,104,8632,54,50,5345.37,11602.00,0.00
2024-12-10 17:25:00,105,8632,55,50,5294.46,11602.01,0.00
2024-12-10 17:25:00,104,8632,55,49,5340.91,11602.04,0.00
2024-12-10 17:25:00,103,8632,54,49,5391.64,11602.04,0.00
2024-12-10 17:25:00,103,8633,54,49,5393.06,11603.00,0.00
2024-12-10 17:25:00,104,8633,54,50,5341.20,11603.01,0.00
2024-12-10 17:25:00,103,8633,53,50,5388.55,11603.04,0.00
2024-12-10 17:25:00,103,8634,53,50,5388.12,11604.00,0.00
2024-12-10 17:25:00,104,8634,54,50,5336.31,11604.01,0.00
2024-12-10 17:25:00,103,8634,53,50,5383.62,11604.04,0.00
2024-12-10 17:25:00,103,8635,53,50,5380.29,11605.00,0.00
2024-12-10 17:25:00,104,8635,53,51,5328.55,11605.01,0.00
2024-12-10 17:25:00,103,8635,52,51,5375.78,11605.04,0.00
2024-12-10 17:25:00,103,8636,52,51,5368.22,11606.00,0.00
2024-12-10 17:25:00,104,8636,53,51,5316.60,11606.01,0.00
2024-12-10 17:25:00,103,8636,52,51,5363.71,11606.04,0.00
2024-12-10 17:25:00,103,8637,52,51,5356.16,11607.00,0.00
2024-12-10 17:25:00,104,8637,53,51,5304.65,11607.01,0.00
2024-12-10 17:25:00,103,8637,52,51,5351.65,11607.04,0.00
2024-12-10 17:25:00,103,8638,52,51,5345.55,11608.00,0.00
2024-12-10 17:25:00,104,8638,52,52,5294.15,11608.01,0.00
2024-12-10 17:25:00,103,8638,52,51,5342.17,11608.03,0.00
2024-12-10 17:25:00,102,8638,52,50,5393.40,11608.03,0.00
2024-12-10 17:25:00,101,8638,52,49,5445.65,11608.03,0.00
2024-12-10 17:25:00,101,8639,52,49,5445.63,11609.00,0.00
2024-12-10 17:25:00,102,8639,52,50,5392.24,11609.01,0.00
2024-12-10 17:25:00,101,8639,51,50,5442.18,11609.03,0.00
2024-12-10 17:25:00,100,8639,51,49,5454.08,11609.39,0.00
2024-12-10 17:25:00,100,8640,51,49,5495.29,11610.00,0.00
2024-12-10 17:25:00,101,8640,52,49,5440.89,11610.01,0.00
2024-12-10 17:25:00,100,8640,51,49,5491.81,11610.03,0.00
2024-12-10 17:25:00,100,8641,51,49,5491.16,11611.00,0.00
2024-12-10 17:25:00,101,8641,51,50,5436.80,11611.01,0.00
2024-12-10 17:25:00,100,8641,51,49,5487.68,11611.03,0.00
2024-12-10 17:25:00,100,8642,51,49,5488.65,11612.00,0.00
2024-12-10 17:25:00,101,8642,51,50,5434.31,11612.01,0.00
2024-12-10 17:25:00,100,8642,50,50,5485.17,11612.03,0.00
2024-12-10 17:25:00,99,8642,50,49,5539.29,11612.04,0.00
2024-12-10 17:25:00,99,8643,50,49,5543.44,11613.00,0.00
2024-12-10 17:25:00,100,8643,51,49,5488.01,11613.01,0.00
2024-12-10 17:25:00,99,8643,50,49,5542.53,11613.01,0.00
2024-12-10 17:25:00,98,8643,49,49,5596.71,11613.02,0.00
2024-12-10 17:25:00,99,8642,50,49,5473.48,11613.62,0.00
2024-12-10 17:25:00,99,8643,50,49,5601.38,11614.00,0.00
2024-12-10 17:25:00,100,8643,50,50,5545.36,11614.01,0.00
2024-12-10 17:25:00,99,8643,50,49,5599.03,11614.02,0.00
2024-12-10 17:25:00,99,8644,50,49,5703.34,11615.00,0.00
2024-12-10 17:25:00,100,8644,50,50,5646.30,11615.01,0.00
2024-12-10 17:25:00,99,8644,50,49,5700.99,11615.02,0.00
2024-12-10 17:25:00,98,8644,50,48,5722.16,11615.33,0.00
2024-12-10 17:25:00,98,8645,50,48,5752.12,11616.00,0.00
2024-12-10 17:25:00,99,8645,51,48,5694.02,11616.01,0.00
2024-12-10 17:25:00,98,8645,50,48,5749.75,11616.02,0.00
2024-12-10 17:25:00,98,8646,50,48,5741.04,11617.00,0.00
2024-12-10 17:25:00,99,8646,50,49,5683.04,11617.01,0.00
2024-12-10 17:25:00,98,8646,49,49,5738.66,11617.02,0.00
2024-12-10 17:25:00,97,8646,48,49,5734.75,11617.53,0.00
2024-12-10 17:25:00,97,8647,48,49,5786.44,11618.00,0.00
2024-12-10 17:25:00,98,8647,49,49,5727.39,11618.01,0.00
2024-12-10 17:25:00,97,8647,49,48,5784.04,11618.02,0.00
2024-12-10 17:25:00,97,8648,49,48,5775.66,11619.00,0.00
2024-12-10 17:25:00,98,8648,50,48,5716.72,11619.01,0.00
2024-12-10 17:25:00,97,8648,50,47,5774.46,11619.01,0.00
2024-12-10 17:25:00,96,8648,50,46,5833.40,11619.01,0.00
2024-12-10 17:25:00,95,8648,49,46,5893.58,11619.01,0.00
2024-12-10 17:25:00,95,8649,49,46,5882.93,11620.00,0.00
2024-12-10 17:25:00,96,8649,50,46,5821.65,11620.01,0.00
2024-12-10 17:25:00,95,8649,50,45,5881.70,11620.01,0.00
2024-12-10 17:25:00,94,8649,50,44,5912.32,11620.25,0.00
2024-12-10 17:25:01,94,8650,50,44,5936.32,11621.00,0.00
2024-12-10 17:25:01,95,8650,51,44,5873.84,11621.01,0.00
2024-12-10 17:25:01,94,8650,50,44,5935.09,11621.01,0.00
2024-12-10 17:25:01,95,8649,51,44,5817.69,11621.50,0.00
2024-12-10 17:25:01,95,8650,51,44,5940.71,11622.00,0.00
2024-12-10 17:25:01,96,8650,52,44,5878.83,11622.01,0.00
2024-12-10 17:25:01,95,8650,51,44,5939.49,11622.01,0.00
2024-12-10 17:25:01,95,8651,51,44,6038.41,11623.00,0.00
2024-12-10 17:25:01,96,8651,51,45,5975.51,11623.01,0.00
2024-12-10 17:25:01,95,8651,51,44,6037.19,11623.01,0.00
2024-12-10 17:25:01,95,8652,51,44,6001.33,11624.00,0.00
2024-12-10 17:25:01,96,8652,51,45,5938.82,11624.01,0.00
2024-12-10 17:25:01,95,8652,51,44,6000.11,11624.01,0.00
2024-12-10 17:25:01,95,8653,51,44,5956.83,11625.00,0.00
2024-12-10 17:25:01,96,8653,51,45,5894.78,11625.01,0.00
2024-12-10 17:25:01,95,8653,50,45,5955.60,11625.01,0.00
2024-12-10 17:25:01,95,8654,50,45,5906.67,11626.00,0.00
2024-12-10 17:25:01,96,8654,51,45,5845.15,11626.01,0.00
2024-12-10 17:25:01,95,8654,50,45,5905.45,11626.01,0.00
2024-12-10 17:25:01,95,8655,50,45,5863.89,11627.00,0.00
2024-12-10 17:25:01,96,8655,51,45,5802.80,11627.01,0.00
2024-12-10 17:25:01,95,8655,50,45,5862.66,11627.01,0.00
2024-12-10 17:25:01,94,8655,49,45,5792.39,11627.95,0.00
2024-12-10 17:25:01,94,8656,49,45,5909.95,11628.00,0.00
2024-12-10 17:25:01,95,8656,50,45,5847.74,11628.01,0.00
2024-12-10 17:25:01,94,8656,49,45,5908.71,11628.01,0.00
2024-12-10 17:25:01,94,8657,49,45,5908.78,11629.00,0.00
2024-12-10 17:25:01,95,8657,50,45,5846.58,11629.01,0.00
2024-12-10 17:25:01,94,8657,50,44,5907.54,11629.01,0.00
2024-12-10 17:25:01,94,8658,50,44,5912.60,11630.00,0.00
2024-12-10 17:25:01,95,8658,50,45,5850.36,11630.01,0.00
2024-12-10 17:25:01,94,8658,49,45,5911.36,11630.01,0.00
2024-12-10 17:25:01,93,8658,48,45,5917.51,11630.40,0.00
2024-12-10 17:25:01,93,8659,48,45,5968.82,11631.00,0.00
2024-12-10 17:25:01,94,8659,48,46,5905.32,11631.01,0.00
2024-12-10 17:25:01,93,8659,48,45,5967.57,11631.01,0.00
2024-12-10 17:25:01,93,8660,48,45,5970.69,11632.00,0.00
2024-12-10 17:25:01,94,8660,49,45,5907.18,11632.01,0.00
2024-12-10 17:25:01,93,8660,48,45,5969.44,11632.01,0.00
2024-12-10 17:25:01,92,8660,48,44,6020.58,11632.12,0.00
2024-12-10 17:25:01,92,8661,48,44,6035.58,11633.00,0.00
2024-12-10 17:25:01,93,8661,49,44,5970.68,11633.01,0.00
2024-12-10 17:25:01,92,8661,48,44,6034.32,11633.01,0.00
2024-12-10 17:25:01,92,8662,48,44,6032.53,11634.00,0.00
2024-12-10 17:25:01,93,8662,48,45,5967.67,11634.01,0.00
2024-12-10 17:25:01,92,8662,47,45,6031.27,11634.01,0.00
2024-12-10 17:25:01,91,8662,46,45,5999.67,11634.78,0.00
2024-12-10 17:25:01,91,8663,46,45,6102.15,11635.00,0.00
2024-12-10 17:25:01,92,8663,47,45,6035.82,11635.01,0.00
2024-12-10 17:25:01,91,8663,47,44,6100.87,11635.01,0.00
2024-12-10 17:25:01,91,8664,47,44,6107.27,11636.00,0.00
2024-12-10 17:25:01,92,8664,48,44,6040.88,11636.01,0.00
2024-12-10 17:25:01,91,8664,48,43,6105.99,11636.01,0.00
2024-12-10 17:25:01,92,8663,49,43,6009.31,11636.29,0.00
2024-12-10 17:25:01,91,8663,48,43,6142.88,11636.41,0.00
2024-12-10 17:25:01,91,8664,48,43,6202.13,11637.00,0.00
2024-12-10 17:25:01,92,8664,48,44,6134.72,11637.01,0.00
2024-12-10 17:25:01,91,8664,47,44,6200.85,11637.01,0.00
2024-12-10 17:25:01,91,8665,47,44,6342.07,11638.00,0.00
2024-12-10 17:25:01,92,8665,48,44,6273.13,11638.01,0.00
2024-12-10 17:25:01,91,8665,48,43,6340.79,11638.01,0.00
2024-12-10 17:25:01,91,8666,48,43,6354.12,11639.00,0.00
2024-12-10 17:25:01,92,8666,49,43,6285.06,11639.01,0.00
2024-12-10 17:25:01,91,8666,49,42,6352.85,11639.01,0.00
2024-12-10 17:25:01,91,8667,49,42,6366.18,11640.00,0.00
2024-12-10 17:25:01,92,8667,50,42,6296.98,11640.01,0.00
2024-12-10 17:25:01,91,8667,50,41,6364.90,11640.01,0.00
2024-12-10 17:25:01,91,8668,50,41,6377.70,11641.00,0.00
2024-12-10 17:25:01,92,8668,51,41,6308.38,11641.01,0.00
2024-12-10 17:25:01,91,8668,51,40,6376.42,11641.01,0.00
2024-12-10 17:25:01,91,8669,51,40,6388.34,11642.00,0.00
2024-12-10 17:25:01,92,8669,51,41,6318.90,11642.01,0.00
2024-12-10 17:25:01,91,8669,50,41,6387.06,11642.01,0.00
2024-12-10 17:25:01,91,8670,50,41,6399.54,11643.00,0.00
2024-12-10 17:25:01,92,8670,50,42,6329.98,11643.01,0.00
2024-12-10 17:25:01,92,8671,50,42,6341.17,11644.00,0.00
2024-12-10 17:25:01,93,8671,50,43,6272.99,11644.01,0.00
2024-12-10 17:25:01,93,8672,50,43,6282.30,11645.00,0.00
2024-12-10 17:25:01,94,8672,50,44,6215.47,11645.01,0.00
2024-12-10 17:25:01,94,8673,50,44,6220.99,11646.00,0.00
2024-12-10 17:25:01,95,8673,50,45,6155.51,11646.01,0.00
2024-12-10 17:25:01,95,8674,50,45,6157.28,11647.00,0.00
2024-12-10 17:25:01,96,8674,50,46,6093.14,11647.01,0.00
2024-12-10 17:25:02,96,8675,50,46,6093.41,11648.00,0.00
2024-12-10 17:25:02,97,8675,51,46,6030.59,11648.01,0.00
2024-12-10 17:25:02,97,8676,51,46,6030.18,11649.00,0.00
2024-12-10 17:25:02,98,8676,52,46,5968.65,11649.01,0.00
2024-12-10 17:25:02,98,8677,52,46,5966.58,11650.00,0.00
2024-12-10 17:25:02,99,8677,53,46,5906.31,11650.01,0.00
2024-12-10 17:25:02,99,8678,53,46,5896.84,11651.00,0.00
2024-12-10 17:25:02,100,8678,53,47,5837.87,11651.01,0.00
2024-12-10 17:25:02,99,8678,53,46,5895.66,11651.01,0.00
2024-12-10 17:25:02,99,8679,53,46,5878.43,11652.00,0.00
2024-12-10 17:25:02,100,8679,53,47,5819.64,11652.01,0.00
2024-12-10 17:25:02,99,8679,52,47,5877.25,11652.01,0.00
2024-12-10 17:25:02,99,8680,52,47,5861.01,11653.00,0.00
2024-12-10 17:25:02,100,8680,53,47,5802.40,11653.01,0.00
2024-12-10 17:25:02,99,8680,52,47,5859.83,11653.01,0.00
2024-12-10 17:25:02,98,8680,52,46,5860.52,11653.43,0.00
2024-12-10 17:25:02,98,8681,52,46,5913.25,11654.00,0.00
2024-12-10 17:25:02,99,8681,53,46,5853.52,11654.01,0.00
2024-12-10 17:25:02,98,8681,53,45,5912.06,11654.01,0.00
2024-12-10 17:25:02,98,8681,53,45,5910.41,11655.00,0.00
2024-12-10 17:25:02,99,8681,54,45,5850.71,11655.01,0.00
2024-12-10 17:25:02,98,8681,53,45,5909.22,11655.01,0.00
2024-12-10 17:25:02,97,8681,52,45,5926.10,11655.38,0.00
2024-12-10 17:25:02,97,8682,52,45,5974.60,11656.00,0.00
2024-12-10 17:25:02,98,8682,53,45,5913.63,11656.01,0.00
2024-12-10 17:25:02,97,8682,52,45,5973.40,11656.01,0.00
2024-12-10 17:25:02,97,8683,52,45,5978.72,11657.00,0.00
2024-12-10 17:25:02,98,8683,52,46,5917.71,11657.01,0.00
2024-12-10 17:25:02,97,8683,52,45,5977.51,11657.01,0.00
2024-12-10 17:25:02,97,8684,52,45,5982.83,11658.00,0.00
2024-12-10 17:25:02,98,8684,53,45,5921.78,11658.01,0.00
2024-12-10 17:25:02,97,8684,52,45,5981.63,11658.01,0.00
2024-12-10 17:25:02,97,8685,52,45,5986.95,11659.00,0.00
2024-12-10 17:25:02,98,8685,53,45,5925.86,11659.01,0.00
2024-12-10 17:25:02,97,8685,52,45,5985.75,11659.01,0.00
2024-12-10 17:25:02,97,8686,52,45,5991.07,11660.00,0.00
2024-12-10 17:25:02,98,8686,52,46,5929.94,11660.01,0.00
2024-12-10 17:25:02,97,8686,51,46,5989.87,11660.01,0.00
2024-12-10 17:25:02,97,8687,51,46,5995.19,11661.00,0.00
2024-12-10 17:25:02,98,8687,51,47,5934.02,11661.01,0.00
2024-12-10 17:25:02,97,8687,51,46,5993.99,11661.01,0.00
2024-12-10 17:25:02,97,8688,51,46,5999.31,11662.00,0.00
2024-12-10 17:25:02,98,8688,52,46,5938.09,11662.01,0.00
2024-12-10 17:25:02,97,8688,52,45,5998.11,11662.01,0.00
2024-12-10 17:25:02,97,8689,52,45,6003.44,11663.00,0.00
2024-12-10 17:25:02,98,8689,53,45,5942.18,11663.01,0.00
2024-12-10 17:25:02,97,8689,52,45,6002.23,11663.01,0.00
2024-12-10 17:25:02,98,8688,52,46,5887.55,11663.49,0.00
2024-12-10 17:25:02,98,8689,52,46,6005.77,11664.00,0.00
2024-12-10 17:25:02,99,8689,53,46,5945.10,11664.01,0.00
2024-12-10 17:25:02,98,8689,53,45,6004.58,11664.01,0.00
2024-12-10 17:25:02,98,8690,53,45,6127.69,11665.00,0.00
2024-12-10 17:25:02,99,8690,54,45,6065.80,11665.01,0.00
2024-12-10 17:25:02,98,8690,54,44,6126.50,11665.01,0.00
2024-12-10 17:25:02,98,8691,54,44,6130.60,11666.00,0.00
2024-12-10 17:25:02,99,8691,54,45,6068.67,11666.01,0.00
2024-12-10 17:25:02,98,8691,53,45,6129.41,11666.01,0.00
2024-12-10 17:25:02,98,8692,53,45,6133.50,11667.00,0.00
2024-12-10 17:25:02,99,8692,53,46,6071.55,11667.01,0.00
2024-12-10 17:25:02,98,8692,53,45,6132.31,11667.01,0.00
2024-12-10 17:25:02,98,8693,53,45,6136.41,11668.00,0.00
2024-12-10 17:25:02,99,8693,54,45,6074.43,11668.01,0.00
2024-12-10 17:25:02,98,8693,53,45,6135.22,11668.01,0.00
2024-12-10 17:25:02,98,8694,53,45,6139.32,11669.00,0.00
2024-12-10 17:25:02,99,8694,54,45,6077.31,11669.01,0.00
2024-12-10 17:25:02,99,8695,54,45,6080.19,11670.00,0.00
2024-12-10 17:25:02,100,8695,54,46,6019.38,11670.01,0.00
2024-12-10 17:25:02,99,8695,53,46,6077.83,11670.02,0.00
2024-12-10 17:25:02,99,8696,53,46,6080.85,11671.00,0.00
2024-12-10 17:25:02,100,8696,54,46,6020.04,11671.01,0.00
2024-12-10 17:25:02,99,8696,53,46,6078.49,11671.02,0.00
2024-12-10 17:25:02,100,8695,53,47,5990.74,11671.26,0.00
2024-12-10 17:25:02,100,8696,53,47,6103.66,11672.00,0.00
2024-12-10 17:25:02,101,8696,54,47,6043.23,11672.01,0.00
2024-12-10 17:25:02,100,8696,54,46,6101.33,11672.02,0.00
2024-12-10 17:25:02,100,8697,54,46,6218.83,11673.00,0.00
2024-12-10 17:25:02,101,8697,55,46,6157.25,11673.01,0.00
2024-12-10 17:25:02,100,8697,54,46,6216.50,11673.02,0.00
2024-12-10 17:25:02,100,8698,54,46,6219.36,11674.00,0.00
2024-12-10 17:25:02,101,8698,54,47,6157.78,11674.01,0.00
2024-12-10 17:25:02,101,8699,54,47,6158.31,11675.00,0.00
2024-12-10 17:25:02,102,8699,55,47,6097.94,11675.01,0.00
2024-12-10 17:25:02,101,8699,54,47,6156.01,11675.02,0.00
2024-12-10 17:25:03,101,8700,54,47,6157.68,11676.00,0.00
2024-12-10 17:25:03,102,8700,54,48,6097.31,11676.01,0.00
2024-12-10 17:25:03,101,8700,54,47,6155.37,11676.02,0.00
2024-12-10 17:25:03,102,8699,54,48,6082.44,11676.15,0.00
2024-12-10 17:25:03,102,8700,54,48,6195.96,11677.00,0.00
2024-12-10 17:25:03,103,8700,55,48,6135.81,11677.01,0.00
2024-12-10 17:25:03,102,8700,55,47,6193.68,11677.02,0.00
2024-12-10 17:25:03,102,8701,55,47,6307.08,11678.00,0.00
2024-12-10 17:25:03,103,8701,56,47,6245.85,11678.01,0.00
2024-12-10 17:25:03,102,8701,55,47,6304.80,11678.02,0.00
2024-12-10 17:25:03,102,8702,55,47,6303.38,11679.00,0.00
2024-12-10 17:25:03,103,8702,56,47,6242.18,11679.01,0.00
2024-12-10 17:25:03,102,8702,55,47,6301.10,11679.02,0.00
2024-12-10 17:25:03,102,8703,55,47,6296.97,11680.00,0.00
2024-12-10 17:25:03,103,8703,56,47,6235.84,11680.01,0.00
2024-12-10 17:25:03,102,8703,56,46,6294.69,11680.02,0.00
2024-12-10 17:25:03,102,8704,56,46,6290.44,11681.00,0.00
2024-12-10 17:25:03,103,8704,57,46,6229.37,11681.01,0.00
2024-12-10 17:25:03,103,8705,57,46,6224.19,11682.00,0.00
2024-12-10 17:25:03,104,8705,58,46,6164.35,11682.01,0.00
2024-12-10 17:25:03,103,8705,58,45,6221.93,11682.02,0.00
2024-12-10 17:25:03,102,8705,57,45,6279.20,11682.04,0.00
2024-12-10 17:25:03,102,8706,57,45,6275.27,11683.00,0.00
2024-12-10 17:25:03,103,8706,58,45,6214.34,11683.01,0.00
2024-12-10 17:25:03,102,8706,57,45,6272.98,11683.02,0.00
2024-12-10 17:25:03,102,8707,57,45,6260.55,11684.00,0.00
2024-12-10 17:25:03,103,8707,58,45,6199.76,11684.01,0.00
2024-12-10 17:25:03,102,8707,58,44,6258.26,11684.02,0.00
2024-12-10 17:25:03,102,8708,58,44,6244.26,11685.00,0.00
2024-12-10 17:25:03,103,8708,59,44,6183.63,11685.01,0.00
2024-12-10 17:25:03,103,8709,59,44,6170.07,11686.00,0.00
2024-12-10 17:25:03,104,8709,59,45,6110.74,11686.01,0.00
2024-12-10 17:25:03,103,8709,59,44,6167.80,11686.02,0.00
2024-12-10 17:25:03,103,8710,59,44,6162.82,11687.00,0.00
2024-12-10 17:25:03,104,8710,59,45,6103.56,11687.01,0.00
2024-12-10 17:25:03,103,8710,59,44,6160.56,11687.02,0.00
2024-12-10 17:25:03,103,8711,59,44,6159.85,11688.00,0.00
2024-12-10 17:25:03,104,8711,60,44,6100.62,11688.01,0.00
2024-12-10 17:25:03,103,8711,60,43,6157.58,11688.02,0.00
2024-12-10 17:25:03,104,8710,61,43,6049.56,11688.42,0.00
2024-12-10 17:25:03,104,8711,61,43,6157.87,11689.00,0.00
2024-12-10 17:25:03,105,8711,61,44,6099.23,11689.01,0.00
2024-12-10 17:25:03,105,8712,61,44,6200.30,11690.00,0.00
2024-12-10 17:25:03,106,8712,61,45,6141.81,11690.01,0.00
2024-12-10 17:25:03,105,8712,60,45,6193.23,11690.03,0.00
2024-12-10 17:25:03,105,8713,60,45,6187.04,11691.00,0.00
2024-12-10 17:25:03,106,8713,61,45,6128.68,11691.01,0.00
2024-12-10 17:25:03,105,8713,60,45,6178.34,11691.03,0.00
2024-12-10 17:25:03,105,8714,60,45,6174.47,11692.00,0.00
2024-12-10 17:25:03,106,8714,60,46,6116.22,11692.01,0.00
2024-12-10 17:25:03,105,8714,59,46,6163.15,11692.03,0.00
2024-12-10 17:25:03,105,8715,59,46,6160.97,11693.00,0.00
2024-12-10 17:25:03,106,8715,59,47,6102.85,11693.01,0.00
2024-12-10 17:25:03,105,8715,59,46,6148.45,11693.03,0.00
2024-12-10 17:25:03,105,8716,59,46,6146.74,11694.00,0.00
2024-12-10 17:25:03,106,8716,60,46,6088.75,11694.01,0.00
2024-12-10 17:25:03,106,8717,60,46,6074.89,11695.00,0.00
2024-12-10 17:25:03,107,8717,60,47,6018.11,11695.01,0.00
2024-12-10 17:25:03,106,8717,59,47,6062.85,11695.03,0.00
2024-12-10 17:25:03,105,8717,58,47,6083.93,11695.33,0.00
2024-12-10 17:25:03,105,8718,58,47,6117.80,11696.00,0.00
2024-12-10 17:25:03,106,8718,58,48,6060.08,11696.01,0.00
2024-12-10 17:25:03,105,8718,58,47,6106.17,11696.03,0.00
2024-12-10 17:25:03,105,8719,58,47,6101.75,11697.00,0.00
2024-12-10 17:25:03,106,8719,59,47,6044.19,11697.01,0.00
2024-12-10 17:25:03,106,8720,59,47,6026.60,11698.00,0.00
2024-12-10 17:25:03,107,8720,60,47,5970.27,11698.01,0.00
2024-12-10 17:25:03,106,8720,59,47,6021.36,11698.02,0.00
2024-12-10 17:25:03,106,8721,59,47,6016.55,11699.00,0.00
2024-12-10 17:25:03,107,8721,59,48,5960.32,11699.01,0.00
2024-12-10 17:25:03,106,8721,59,47,6013.25,11699.03,0.00
2024-12-10 17:25:03,106,8722,59,47,6010.45,11700.00,0.00
2024-12-10 17:25:03,107,8722,60,47,5954.28,11700.01,0.00
2024-12-10 17:25:03,106,8722,60,46,6007.15,11700.03,0.00
2024-12-10 17:25:04,106,8723,60,46,6004.34,11701.00,0.00
2024-12-10 17:25:04,107,8723,60,47,5948.22,11701.01,0.00
2024-12-10 17:25:04,106,8723,59,47,6001.03,11701.03,0.00
2024-12-10 17:25:04,106,8724,59,47,5998.23,11702.00,0.00
2024-12-10 17:25:04,107,8724,60,47,5942.17,11702.01,0.00
2024-12-10 17:25:04,106,8724,59,47,5994.92,11702.03,0.00
2024-12-10 17:25:04,106,8725,59,47,5992.10,11703.00,0.00
2024-12-10 17:25:04,107,8725,60,47,5936.10,11703.01,0.00
2024-12-10 17:25:04,106,8725,60,46,5988.80,11703.03,0.00
2024-12-10 17:25:04,106,8726,60,46,5985.99,11704.00,0.00
2024-12-10 17:25:04,107,8726,61,46,5930.05,11704.01,0.00
2024-12-10 17:25:04,106,8726,60,46,5982.69,11704.03,0.00
2024-12-10 17:25:04,106,8727,60,46,5979.88,11705.00,0.00
2024-12-10 17:25:04,107,8727,61,46,5923.99,11705.01,0.00
2024-12-10 17:25:04,106,8727,61,45,5976.57,11705.03,0.00
2024-12-10 17:25:04,106,8728,61,45,5973.76,11706.00,0.00
2024-12-10 17:25:04,107,8728,61,46,5917.93,11706.01,0.00
2024-12-10 17:25:04,106,8728,60,46,5970.46,11706.03,0.00
2024-12-10 17:25:04,106,8729,60,46,5967.65,11707.00,0.00
2024-12-10 17:25:04,107,8729,60,47,5911.87,11707.01,0.00
2024-12-10 17:25:04,106,8729,59,47,5964.34,11707.03,0.00
2024-12-10 17:25:04,106,8730,59,47,5961.53,11708.00,0.00
2024-12-10 17:25:04,107,8730,60,47,5905.81,11708.01,0.00
2024-12-10 17:25:04,106,8730,60,46,5958.22,11708.03,0.00
2024-12-10 17:25:04,106,8731,60,46,5954.04,11709.00,0.00
2024-12-10 17:25:04,107,8731,61,46,5898.40,11709.01,0.00
2024-12-10 17:25:04,106,8731,61,45,5950.74,11709.03,0.00
2024-12-10 17:25:04,106,8732,61,45,5944.76,11710.00,0.00
2024-12-10 17:25:04,107,8732,62,45,5889.20,11710.01,0.00
2024-12-10 17:25:04,106,8732,61,45,5941.46,11710.03,0.00
2024-12-10 17:25:04,105,8732,60,45,5977.19,11710.19,0.00
2024-12-10 17:25:04,105,8733,60,45,5994.41,11711.00,0.00
2024-12-10 17:25:04,106,8733,61,45,5937.86,11711.01,0.00
2024-12-10 17:25:04,105,8733,61,44,5991.07,11711.03,0.00
2024-12-10 17:25:04,105,8734,61,44,5989.34,11712.00,0.00
2024-12-10 17:25:04,106,8734,62,44,5932.84,11712.01,0.00
2024-12-10 17:25:04,105,8734,62,43,5986.00,11712.03,0.00
2024-12-10 17:25:04,105,8735,62,43,5984.28,11713.00,0.00
2024-12-10 17:25:04,106,8735,63,43,5927.82,11713.01,0.00
2024-12-10 17:25:04,106,8736,63,43,5922.80,11714.00,0.00
2024-12-10 17:25:04,107,8736,64,43,5867.45,11714.01,0.00
2024-12-10 17:25:04,106,8736,64,42,5918.39,11714.04,0.00
2024-12-10 17:25:04,106,8737,64,42,5916.68,11715.00,0.00
2024-12-10 17:25:04,107,8737,64,43,5861.38,11715.01,0.00
2024-12-10 17:25:04,106,8737,64,42,5912.27,11715.04,0.00
2024-12-10 17:25:04,105,8737,63,42,5956.04,11715.14,0.00
2024-12-10 17:25:04,105,8738,63,42,5967.69,11716.00,0.00
2024-12-10 17:25:04,106,8738,63,43,5911.39,11716.01,0.00
2024-12-10 17:25:04,105,8738,62,43,5963.24,11716.04,0.00
2024-12-10 17:25:04,105,8739,62,43,5962.62,11717.00,0.00
2024-12-10 17:25:04,106,8739,63,43,5906.37,11717.01,0.00
2024-12-10 17:25:04,105,8739,63,42,5958.17,11717.04,0.00
2024-12-10 17:25:04,105,8740,63,42,5957.55,11718.00,0.00
2024-12-10 17:25:04,106,8740,63,43,5901.35,11718.01,0.00
2024-12-10 17:25:04,105,8740,62,43,5953.10,11718.04,0.00
2024-12-10 17:25:04,105,8741,62,43,5952.48,11719.00,0.00
2024-12-10 17:25:04,106,8741,63,43,5896.32,11719.01,0.00
2024-12-10 17:25:04,105,8741,62,43,5948.03,11719.04,0.00
2024-12-10 17:25:04,105,8742,62,43,5947.41,11720.00,0.00
2024-12-10 17:25:04,106,8742,62,44,5891.30,11720.01,0.00
2024-12-10 17:25:04,105,8742,61,44,5942.95,11720.04,0.00
2024-12-10 17:25:04,106,8741,62,44,5825.13,11720.58,0.00
2024-12-10 17:25:04,106,8742,62,44,5935.24,11721.00,0.00
2024-12-10 17:25:04,107,8742,62,45,5879.77,11721.01,0.00
2024-12-10 17:25:04,106,8742,61,45,5930.82,11721.04,0.00
2024-12-10 17:25:04,106,8743,61,45,6039.69,11722.00,0.00
2024-12-10 17:25:04,107,8743,62,45,5983.25,11722.01,0.00
2024-12-10 17:25:04,106,8743,61,45,6035.28,11722.04,0.00
2024-12-10 17:25:04,105,8743,61,44,6089.86,11722.06,0.00
2024-12-10 17:25:04,105,8744,61,44,6091.49,11723.00,0.00
2024-12-10 17:25:04,106,8744,62,44,6034.02,11723.01,0.00
2024-12-10 17:25:04,105,8744,62,43,6087.04,11723.04,0.00
2024-12-10 17:25:04,105,8745,62,43,6086.43,11724.00,0.00
2024-12-10 17:25:04,106,8745,63,43,6029.01,11724.01,0.00
2024-12-10 17:25:04,105,8745,63,42,6081.97,11724.04,0.00
2024-12-10 17:25:04,105,8746,63,42,6081.37,11725.00,0.00
2024-12-10 17:25:04,106,8746,64,42,6024.00,11725.01,0.00
2024-12-10 17:25:04,106,8747,64,42,6018.97,11726.00,0.00
2024-12-10 17:25:04,107,8747,65,42,5962.72,11726.01,0.00
2024-12-10 17:25:04,106,8747,64,42,6014.56,11726.04,0.00
2024-12-10 17:25:04,106,8748,64,42,6012.85,11727.00,0.00
2024-12-10 17:25:04,107,8748,64,43,5956.65,11727.01,0.00
2024-12-10 17:25:05,107,8749,64,43,5950.59,11728.00,0.00
2024-12-10 17:25:05,108,8749,64,44,5895.49,11728.01,0.00
2024-12-10 17:25:05,108,8750,64,44,5888.39,11729.00,0.00
2024-12-10 17:25:05,109,8750,64,45,5834.37,11729.01,0.00
2024-12-10 17:25:05,109,8751,64,45,5826.25,11730.00,0.00
2024-12-10 17:25:05,110,8751,64,46,5773.29,11730.01,0.00
2024-12-10 17:25:05,109,8751,64,45,5821.96,11730.04,0.00
2024-12-10 17:25:05,109,8752,64,45,5817.06,11731.00,0.00
2024-12-10 17:25:05,110,8752,65,45,5764.18,11731.01,0.00
2024-12-10 17:25:05,110,8753,65,45,5755.08,11732.00,0.00
2024-12-10 17:25:05,111,8753,66,45,5703.23,11732.01,0.00
2024-12-10 17:25:05,110,8753,65,45,5749.75,11732.05,0.00
2024-12-10 17:25:05,110,8754,65,45,5744.90,11733.00,0.00
2024-12-10 17:25:05,111,8754,65,46,5693.14,11733.01,0.00
2024-12-10 17:25:05,110,8754,64,46,5739.58,11733.05,0.00
2024-12-10 17:25:05,110,8755,64,46,5734.72,11734.00,0.00
2024-12-10 17:25:05,111,8755,64,47,5683.06,11734.01,0.00
2024-12-10 17:25:05,110,8755,64,46,5729.40,11734.05,0.00
2024-12-10 17:25:05,110,8756,64,46,5724.54,11735.00,0.00
2024-12-10 17:25:05,111,8756,64,47,5672.97,11735.01,0.00
2024-12-10 17:25:05,110,8756,63,47,5719.22,11735.05,0.00
2024-12-10 17:25:05,110,8757,63,47,5714.36,11736.00,0.00
2024-12-10 17:25:05,111,8757,63,48,5662.88,11736.01,0.00
2024-12-10 17:25:05,110,8757,63,47,5713.29,11736.01,0.00
2024-12-10 17:25:05,109,8757,62,47,5761.41,11736.04,0.00
2024-12-10 17:25:05,108,8757,61,47,5813.67,11736.04,0.00
2024-12-10 17:25:05,108,8758,61,47,5809.81,11737.00,0.00
2024-12-10 17:25:05,109,8758,62,47,5756.51,11737.01,0.00
2024-12-10 17:25:05,108,8758,62,46,5805.47,11737.04,0.00
2024-12-10 17:25:05,108,8759,62,46,5801.61,11738.00,0.00
2024-12-10 17:25:05,109,8759,63,46,5748.39,11738.01,0.00
2024-12-10 17:25:05,108,8759,62,46,5797.27,11738.04,0.00
2024-12-10 17:25:05,108,8760,62,46,5793.41,11739.00,0.00
2024-12-10 17:25:05,109,8760,62,47,5740.26,11739.01,0.00
2024-12-10 17:25:05,108,8760,61,47,5789.07,11739.04,0.00
2024-12-10 17:25:05,108,8761,61,47,5785.21,11740.00,0.00
2024-12-10 17:25:05,109,8761,61,48,5732.13,11740.01,0.00
2024-12-10 17:25:05,108,8761,60,48,5780.87,11740.04,0.00
2024-12-10 17:25:05,108,8762,60,48,5777.00,11741.00,0.00
2024-12-10 17:25:05,109,8762,60,49,5724.00,11741.01,0.00
2024-12-10 17:25:05,108,8762,59,49,5772.66,11741.04,0.00
2024-12-10 17:25:05,108,8763,59,49,5768.80,11742.00,0.00
2024-12-10 17:25:05,109,8763,59,50,5715.87,11742.01,0.00
2024-12-10 17:25:05,108,8763,59,49,5764.46,11742.04,0.00
2024-12-10 17:25:05,108,8764,59,49,5760.59,11743.00,0.00
2024-12-10 17:25:05,109,8764,60,49,5707.74,11743.01,0.00
2024-12-10 17:25:05,108,8764,60,48,5756.25,11743.04,0.00
2024-12-10 17:25:05,108,8765,60,48,5752.38,11744.00,0.00
2024-12-10 17:25:05,109,8765,60,49,5699.61,11744.01,0.00
2024-12-10 17:25:05,108,8765,60,48,5748.04,11744.04,0.00
2024-12-10 17:25:05,108,8766,60,48,5744.17,11745.00,0.00
2024-12-10 17:25:05,109,8766,60,49,5691.47,11745.01,0.00
2024-12-10 17:25:05,108,8766,60,48,5739.83,11745.04,0.00
2024-12-10 17:25:05,108,8767,60,48,5735.96,11746.00,0.00
2024-12-10 17:25:05,109,8767,61,48,5683.34,11746.01,0.00
2024-12-10 17:25:05,108,8767,61,47,5731.62,11746.04,0.00
2024-12-10 17:25:05,108,8768,61,47,5727.75,11747.00,0.00
2024-12-10 17:25:05,109,8768,62,47,5675.20,11747.01,0.00
2024-12-10 17:25:05,108,8768,62,46,5723.40,11747.04,0.00
2024-12-10 17:25:05,108,8769,62,46,5719.53,11748.00,0.00
2024-12-10 17:25:05,109,8769,62,47,5667.06,11748.01,0.00
2024-12-10 17:25:05,108,8769,61,47,5715.19,11748.04,0.00
2024-12-10 17:25:05,108,8770,61,47,5711.32,11749.00,0.00
2024-12-10 17:25:05,109,8770,61,48,5658.92,11749.01,0.00
2024-12-10 17:25:05,108,8770,60,48,5706.97,11749.04,0.00
2024-12-10 17:25:05,108,8771,60,48,5703.10,11750.00,0.00
2024-12-10 17:25:05,109,8771,60,49,5650.78,11750.01,0.00
2024-12-10 17:25:05,108,8771,59,49,5698.76,11750.04,0.00
2024-12-10 17:25:05,108,8772,59,49,5694.88,11751.00,0.00
2024-12-10 17:25:05,109,8772,60,49,5642.63,11751.01,0.00
2024-12-10 17:25:05,108,8772,60,48,5690.53,11751.04,0.00
2024-12-10 17:25:05,108,8773,60,48,5686.66,11752.00,0.00
2024-12-10 17:25:05,109,8773,60,49,5634.49,11752.01,0.00
2024-12-10 17:25:05,108,8773,60,48,5682.31,11752.04,0.00
2024-12-10 17:25:05,108,8774,60,48,5678.44,11753.00,0.00
2024-12-10 17:25:05,109,8774,60,49,5626.34,11753.01,0.00
2024-12-10 17:25:05,108,8774,59,49,5674.09,11753.04,0.00
2024-12-10 17:25:05,108,8775,59,49,5670.21,11754.00,0.00
2024-12-10 17:25:05,109,8775,59,50,5618.19,11754.01,0.00
2024-12-10 17:25:06,108,8775,58,50,5665.86,11754.04,0.00
2024-12-10 17:25:06,108,8776,58,50,5661.99,11755.00,0.00
2024-12-10 17:25:06,109,8776,58,51,5610.04,11755.01,0.00
2024-12-10 17:25:06,108,8776,57,51,5657.64,11755.04,0.00
2024-12-10 17:25:06,108,8777,57,51,5653.76,11756.00,0.00
2024-12-10 17:25:06,109,8777,57,52,5601.89,11756.01,0.00
2024-12-10 17:25:06,108,8777,56,52,5649.41,11756.04,0.00
2024-12-10 17:25:06,108,8778,56,52,5645.53,11757.00,0.00
2024-12-10 17:25:06,109,8778,56,53,5593.74,11757.01,0.00
2024-12-10 17:25:06,108,8778,56,52,5641.18,11757.04,0.00
2024-12-10 17:25:06,108,8779,56,52,5637.30,11758.00,0.00
2024-12-10 17:25:06,109,8779,57,52,5585.59,11758.01,0.00
2024-12-10 17:25:06,108,8779,56,52,5632.95,11758.04,0.00
2024-12-10 17:25:06,108,8780,56,52,5629.07,11759.00,0.00
2024-12-10 17:25:06,109,8780,57,52,5577.43,11759.01,0.00
2024-12-10 17:25:06,108,8780,56,52,5624.72,11759.04,0.00
2024-12-10 17:25:06,108,8781,56,52,5620.84,11760.00,0.00
2024-12-10 17:25:06,109,8781,57,52,5569.27,11760.01,0.00
2024-12-10 17:25:06,108,8781,57,51,5616.49,11760.04,0.00
2024-12-10 17:25:06,108,8782,57,51,5612.61,11761.00,0.00
2024-12-10 17:25:06,109,8782,58,51,5561.12,11761.01,0.00
2024-12-10 17:25:06,108,8782,58,50,5608.25,11761.04,0.00
2024-12-10 17:25:06,108,8783,58,50,5604.37,11762.00,0.00
2024-12-10 17:25:06,109,8783,59,50,5552.95,11762.01,0.00
2024-12-10 17:25:06,108,8783,58,50,5600.02,11762.04,0.00
2024-12-10 17:25:06,108,8784,58,50,5596.13,11763.00,0.00
2024-12-10 17:25:06,109,8784,58,51,5544.79,11763.01,0.00
2024-12-10 17:25:06,108,8784,57,51,5593.96,11763.02,0.00
2024-12-10 17:25:06,107,8784,56,51,5644.04,11763.03,0.00
2024-12-10 17:25:06,106,8784,56,50,5696.18,11763.03,0.00
2024-12-10 17:25:06,106,8785,56,50,5693.33,11764.00,0.00
2024-12-10 17:25:06,107,8785,57,50,5640.12,11764.01,0.00
2024-12-10 17:25:06,106,8785,56,50,5690.00,11764.03,0.00
2024-12-10 17:25:06,106,8786,56,50,5687.15,11765.00,0.00
2024-12-10 17:25:06,107,8786,57,50,5634.00,11765.01,0.00
2024-12-10 17:25:06,106,8786,56,50,5683.83,11765.03,0.00
2024-12-10 17:25:06,106,8787,56,50,5680.98,11766.00,0.00
2024-12-10 17:25:06,107,8787,57,50,5627.88,11766.01,0.00
2024-12-10 17:25:06,106,8787,57,49,5677.65,11766.03,0.00
2024-12-10 17:25:06,107,8786,58,49,5594.93,11766.30,0.00
2024-12-10 17:25:06,107,8787,58,49,5704.24,11767.00,0.00
2024-12-10 17:25:06,108,8787,58,50,5651.43,11767.01,0.00
2024-12-10 17:25:06,107,8787,58,49,5700.95,11767.03,0.00
2024-12-10 17:25:06,107,8788,58,49,5807.01,11768.00,0.00
2024-12-10 17:25:06,108,8788,59,49,5753.24,11768.01,0.00
2024-12-10 17:25:06,107,8788,58,49,5803.71,11768.03,0.00
2024-12-10 17:25:06,107,8789,58,49,5799.80,11769.00,0.00
2024-12-10 17:25:06,108,8789,59,49,5746.10,11769.01,0.00
2024-12-10 17:25:06,107,8789,58,49,5796.51,11769.03,0.00
2024-12-10 17:25:06,107,8790,58,49,5792.60,11770.00,0.00
2024-12-10 17:25:06,108,8790,59,49,5738.96,11770.01,0.00
2024-12-10 17:25:06,107,8790,59,48,5789.30,11770.03,0.00
2024-12-10 17:25:06,107,8791,59,48,5785.39,11771.00,0.00
2024-12-10 17:25:06,108,8791,59,49,5731.82,11771.01,0.00
2024-12-10 17:25:06,107,8791,59,48,5784.29,11771.01,0.00
2024-12-10 17:25:06,106,8791,58,48,5836.64,11771.02,0.00
2024-12-10 17:25:06,105,8791,58,47,5891.10,11771.02,0.00
2024-12-10 17:25:06,105,8792,58,47,5888.24,11772.00,0.00
2024-12-10 17:25:06,106,8792,58,48,5832.69,11772.01,0.00
2024-12-10 17:25:06,105,8792,57,48,5886.00,11772.02,0.00
2024-12-10 17:25:06,105,8793,57,48,5881.92,11773.00,0.00
2024-12-10 17:25:06,106,8793,57,49,5826.43,11773.01,0.00
2024-12-10 17:25:06,105,8793,56,49,5879.68,11773.02,0.00
2024-12-10 17:25:06,105,8794,56,49,5872.66,11774.00,0.00
2024-12-10 17:25:06,106,8794,57,49,5817.26,11774.01,0.00
2024-12-10 17:25:06,105,8794,57,48,5870.42,11774.02,0.00
2024-12-10 17:25:06,105,8795,57,48,5861.26,11775.00,0.00
2024-12-10 17:25:06,106,8795,57,49,5805.97,11775.01,0.00
2024-12-10 17:25:06,105,8795,56,49,5859.02,11775.02,0.00
2024-12-10 17:25:06,105,8796,56,49,5847.84,11776.00,0.00
2024-12-10 17:25:06,106,8796,56,50,5792.67,11776.01,0.00
2024-12-10 17:25:06,105,8796,56,49,5845.60,11776.02,0.00
2024-12-10 17:25:06,105,8797,56,49,5832.91,11777.00,0.00
2024-12-10 17:25:06,106,8797,56,50,5777.88,11777.01,0.00
2024-12-10 17:25:06,105,8797,55,50,5829.55,11777.03,0.00
2024-12-10 17:25:06,105,8798,55,50,5816.44,11778.00,0.00
2024-12-10 17:25:06,106,8798,55,51,5761.57,11778.01,0.00
2024-12-10 17:25:06,105,8798,54,51,5813.08,11778.03,0.00
2024-12-10 17:25:06,105,8799,54,51,5799.70,11779.00,0.00
2024-12-10 17:25:06,106,8799,55,51,5744.99,11779.01,0.00
2024-12-10 17:25:06,105,8799,54,51,5796.34,11779.03,0.00
2024-12-10 17:25:06,105,8800,54,51,5784.12,11780.00,0.00
2024-12-10 17:25:06,106,8800,55,51,5729.55,11780.01,0.00
2024-12-10 17:25:06,105,8800,54,51,5780.75,11780.03,0.00
2024-12-10 17:25:07,105,8801,54,51,5769.60,11781.00,0.00
2024-12-10 17:25:07,106,8801,54,52,5715.17,11781.01,0.00
2024-12-10 17:25:07,105,8801,53,52,5766.24,11781.03,0.00
2024-12-10 17:25:07,105,8802,53,52,5754.91,11782.00,0.00
2024-12-10 17:25:07,106,8802,53,53,5700.62,11782.01,0.00
2024-12-10 17:25:07,105,8802,52,53,5751.55,11782.03,0.00
2024-12-10 17:25:07,105,8802,52,53,5739.87,11783.00,0.00
2024-12-10 17:25:07,106,8802,53,53,5685.72,11783.01,0.00
2024-12-10 17:25:07,105,8802,52,53,5736.50,11783.03,0.00
2024-12-10 17:25:07,105,8803,52,53,5726.55,11784.00,0.00
2024-12-10 17:25:07,106,8803,52,54,5672.53,11784.01,0.00
2024-12-10 17:25:07,105,8803,51,54,5723.19,11784.03,0.00
2024-12-10 17:25:07,105,8804,51,54,5714.73,11785.00,0.00
2024-12-10 17:25:07,106,8804,51,55,5660.82,11785.01,0.00
2024-12-10 17:25:07,105,8804,50,55,5711.37,11785.03,0.00
2024-12-10 17:25:07,105,8805,50,55,5704.62,11786.00,0.00
2024-12-10 17:25:07,106,8805,51,55,5650.81,11786.01,0.00
2024-12-10 17:25:07,105,8805,51,54,5701.26,11786.03,0.00
2024-12-10 17:25:07,105,8806,51,54,5695.94,11787.00,0.00
2024-12-10 17:25:07,106,8806,51,55,5642.21,11787.01,0.00
2024-12-10 17:25:07,105,8806,51,54,5692.58,11787.03,0.00
2024-12-10 17:25:07,105,8807,51,54,5688.63,11788.00,0.00
2024-12-10 17:25:07,106,8807,52,54,5634.96,11788.01,0.00
2024-12-10 17:25:07,105,8807,52,53,5687.50,11788.01,0.00
2024-12-10 17:25:07,104,8807,51,53,5739.93,11788.02,0.00
2024-12-10 17:25:07,103,8807,50,53,5794.51,11788.02,0.00
2024-12-10 17:25:07,103,8808,50,53,5792.92,11789.00,0.00
2024-12-10 17:25:07,104,8808,51,53,5737.22,11789.01,0.00
2024-12-10 17:25:07,103,8808,51,52,5790.64,11789.02,0.00
2024-12-10 17:25:07,103,8809,51,52,5789.97,11790.00,0.00
2024-12-10 17:25:07,104,8809,51,53,5734.29,11790.01,0.00
2024-12-10 17:25:07,103,8809,51,52,5787.68,11790.02,0.00
2024-12-10 17:25:07,103,8810,51,52,5787.02,11791.00,0.00
2024-12-10 17:25:07,104,8810,52,52,5731.38,11791.01,0.00
2024-12-10 17:25:07,104,8811,52,52,5725.97,11792.00,0.00
2024-12-10 17:25:07,105,8811,52,53,5671.44,11792.01,0.00
2024-12-10 17:25:07,104,8811,52,52,5722.58,11792.03,0.00
2024-12-10 17:25:07,104,8812,52,52,5713.18,11793.00,0.00
2024-12-10 17:25:07,105,8812,52,53,5658.76,11793.01,0.00
2024-12-10 17:25:07,104,8812,52,52,5709.78,11793.03,0.00
2024-12-10 17:25:07,104,8813,52,52,5701.27,11794.00,0.00
2024-12-10 17:25:07,105,8813,53,52,5646.97,11794.01,0.00
2024-12-10 17:25:07,104,8813,52,52,5697.87,11794.03,0.00
2024-12-10 17:25:07,103,8813,51,52,5669.02,11794.74,0.00
2024-12-10 17:25:07,103,8813,51,52,5752.83,11795.00,0.00
2024-12-10 17:25:07,104,8813,52,52,5697.52,11795.01,0.00
2024-12-10 17:25:07,103,8813,52,51,5749.40,11795.03,0.00
2024-12-10 17:25:07,103,8814,52,51,5749.89,11796.00,0.00
2024-12-10 17:25:07,104,8814,53,51,5694.60,11796.01,0.00
2024-12-10 17:25:07,103,8814,53,50,5746.46,11796.03,0.00
2024-12-10 17:25:07,103,8815,53,50,5745.79,11797.00,0.00
2024-12-10 17:25:07,104,8815,53,51,5690.54,11797.01,0.00
2024-12-10 17:25:07,103,8815,52,51,5742.36,11797.03,0.00
2024-12-10 17:25:07,103,8816,52,51,5736.30,11798.00,0.00
2024-12-10 17:25:07,104,8816,53,51,5681.15,11798.01,0.00
2024-12-10 17:25:07,103,8816,52,51,5732.87,11798.03,0.00
2024-12-10 17:25:07,103,8817,52,51,5718.08,11799.00,0.00
2024-12-10 17:25:07,104,8817,52,52,5663.10,11799.01,0.00
2024-12-10 17:25:07,103,8817,52,51,5714.65,11799.03,0.00
2024-12-10 17:25:07,103,8818,52,51,5698.16,11800.00,0.00
2024-12-10 17:25:07,104,8818,52,52,5643.37,11800.01,0.00
2024-12-10 17:25:07,103,8818,51,52,5694.73,11800.03,0.00
2024-12-10 17:25:07,103,8819,51,52,5679.13,11801.00,0.00
2024-12-10 17:25:07,104,8819,51,53,5624.53,11801.01,0.00
2024-12-10 17:25:07,103,8819,51,52,5675.70,11801.03,0.00
2024-12-10 17:25:07,102,8819,50,52,5646.94,11801.61,0.00
2024-12-10 17:25:07,102,8820,50,52,5714.12,11802.00,0.00
2024-12-10 17:25:07,103,8820,50,53,5658.64,11802.01,0.00
2024-12-10 17:25:07,102,8820,49,53,5710.65,11802.03,0.00
2024-12-10 17:25:07,102,8821,49,53,5705.20,11803.00,0.00
2024-12-10 17:25:07,103,8821,50,53,5649.81,11803.01,0.00
2024-12-10 17:25:07,102,8821,49,53,5701.73,11803.03,0.00
2024-12-10 17:25:07,102,8822,49,53,5686.34,11804.00,0.00
2024-12-10 17:25:07,103,8822,50,53,5631.13,11804.01,0.00
2024-12-10 17:25:07,102,8822,49,53,5682.87,11804.03,0.00
2024-12-10 17:25:07,102,8823,49,53,5673.19,11805.00,0.00
2024-12-10 17:25:07,103,8823,49,54,5618.11,11805.01,0.00
2024-12-10 17:25:07,102,8823,48,54,5669.72,11805.03,0.00
2024-12-10 17:25:07,102,8824,48,54,5665.10,11806.00,0.00
2024-12-10 17:25:07,103,8824,48,55,5610.10,11806.01,0.00
2024-12-10 17:25:07,102,8824,48,54,5661.63,11806.03,0.00
2024-12-10 17:25:08,102,8825,48,54,5659.67,11807.00,0.00
2024-12-10 17:25:08,103,8825,48,55,5604.73,11807.01,0.00
2024-12-10 17:25:08,102,8825,48,54,5656.20,11807.03,0.00
2024-12-10 17:25:08,102,8826,48,54,5645.56,11808.00,0.00
2024-12-10 17:25:08,103,8826,49,54,5590.75,11808.01,0.00
2024-12-10 17:25:08,102,8826,48,54,5642.09,11808.03,0.00
2024-12-10 17:25:08,102,8827,48,54,5624.73,11809.00,0.00
2024-12-10 17:25:08,103,8827,48,55,5570.12,11809.01,0.00
2024-12-10 17:25:08,102,8827,47,55,5621.26,11809.03,0.00
2024-12-10 17:25:08,102,8828,47,55,5589.37,11810.00,0.00
2024-12-10 17:25:08,103,8828,48,55,5535.10,11810.01,0.00
2024-12-10 17:25:08,102,8828,47,55,5585.90,11810.03,0.00
2024-12-10 17:25:08,101,8828,47,54,5526.27,11810.81,0.00
2024-12-10 17:25:08,101,8829,47,54,5621.15,11811.00,0.00
2024-12-10 17:25:08,102,8829,48,54,5566.04,11811.01,0.00
2024-12-10 17:25:08,101,8829,47,54,5617.64,11811.03,0.00
2024-12-10 17:25:08,101,8830,47,54,5617.43,11812.00,0.00
2024-12-10 17:25:08,102,8830,47,55,5562.36,11812.01,0.00
2024-12-10 17:25:08,101,8830,46,55,5613.92,11812.03,0.00
2024-12-10 17:25:08,102,8829,46,56,5497.64,11812.57,0.00
2024-12-10 17:25:08,102,8830,46,56,5615.81,11813.00,0.00
2024-12-10 17:25:08,103,8830,46,57,5561.29,11813.01,0.00
2024-12-10 17:25:08,102,8830,45,57,5612.34,11813.03,0.00
2024-12-10 17:25:08,103,8829,45,58,5552.11,11813.10,0.00
2024-12-10 17:25:08,103,8830,45,58,5775.61,11814.00,0.00
2024-12-10 17:25:08,104,8830,45,59,5720.08,11814.01,0.00
2024-12-10 17:25:08,103,8830,44,59,5772.17,11814.03,0.00
2024-12-10 17:25:08,103,8831,44,59,5880.46,11815.00,0.00
2024-12-10 17:25:08,104,8831,44,60,5823.92,11815.01,0.00
2024-12-10 17:25:08,103,8831,44,59,5877.02,11815.03,0.00
2024-12-10 17:25:08,103,8832,44,59,5869.18,11816.00,0.00
2024-12-10 17:25:08,104,8832,44,60,5812.75,11816.01,0.00
2024-12-10 17:25:08,103,8832,44,59,5865.74,11816.03,0.00
2024-12-10 17:25:08,103,8833,44,59,5856.33,11817.00,0.00
2024-12-10 17:25:08,104,8833,45,59,5800.02,11817.01,0.00
2024-12-10 17:25:08,103,8833,44,59,5852.89,11817.03,0.00
2024-12-10 17:25:08,103,8834,44,59,5842.54,11818.00,0.00
2024-12-10 17:25:08,104,8834,44,60,5786.36,11818.01,0.00
2024-12-10 17:25:08,103,8834,44,59,5839.09,11818.03,0.00
2024-12-10 17:25:08,103,8835,44,59,5828.22,11819.00,0.00
2024-12-10 17:25:08,104,8835,45,59,5772.18,11819.01,0.00
2024-12-10 17:25:08,104,8836,45,59,5757.16,11820.00,0.00
2024-12-10 17:25:08,105,8836,46,59,5702.33,11820.01,0.00
2024-12-10 17:25:08,104,8836,46,58,5756.02,11820.01,0.00
2024-12-10 17:25:08,103,8836,46,57,5808.47,11820.03,0.00
2024-12-10 17:25:08,102,8836,45,57,5864.26,11820.03,0.00
2024-12-10 17:25:08,102,8837,45,57,5852.97,11821.00,0.00
2024-12-10 17:25:08,103,8837,46,57,5796.15,11821.01,0.00
2024-12-10 17:25:08,102,8837,45,57,5852.40,11821.01,0.00
2024-12-10 17:25:08,101,8837,45,56,5908.01,11821.02,0.00
2024-12-10 17:25:08,101,8838,45,56,5895.52,11822.00,0.00
2024-12-10 17:25:08,102,8838,45,57,5837.72,11822.01,0.00
2024-12-10 17:25:08,101,8838,44,57,5893.19,11822.02,0.00
2024-12-10 17:25:08,101,8839,44,57,5879.41,11823.00,0.00
2024-12-10 17:25:08,102,8839,44,58,5821.77,11823.01,0.00
2024-12-10 17:25:08,101,8839,43,58,5877.08,11823.02,0.00
2024-12-10 17:25:08,101,8840,43,58,5861.87,11824.00,0.00
2024-12-10 17:25:08,102,8840,44,58,5804.40,11824.01,0.00
2024-12-10 17:25:08,101,8840,43,58,5859.54,11824.02,0.00
2024-12-10 17:25:08,101,8841,43,58,5841.60,11825.00,0.00
2024-12-10 17:25:08,102,8841,44,58,5784.33,11825.01,0.00
2024-12-10 17:25:08,101,8841,43,58,5839.27,11825.02,0.00
2024-12-10 17:25:08,100,8841,42,58,5849.98,11825.35,0.00
2024-12-10 17:25:08,100,8842,42,58,5878.04,11826.00,0.00
2024-12-10 17:25:08,101,8842,42,59,5819.84,11826.01,0.00
2024-12-10 17:25:08,100,8842,41,59,5875.68,11826.02,0.00
2024-12-10 17:25:08,100,8843,41,59,5862.90,11827.00,0.00
2024-12-10 17:25:08,101,8843,42,59,5804.85,11827.01,0.00
2024-12-10 17:25:08,100,8843,42,58,5860.55,11827.02,0.00
2024-12-10 17:25:08,100,8844,42,58,5845.88,11828.00,0.00
2024-12-10 17:25:08,101,8844,43,58,5788.00,11828.01,0.00
2024-12-10 17:25:08,100,8844,43,57,5843.52,11828.02,0.00
2024-12-10 17:25:08,100,8845,43,57,5828.40,11829.00,0.00
2024-12-10 17:25:08,101,8845,44,57,5770.70,11829.01,0.00
2024-12-10 17:25:08,100,8845,44,56,5826.05,11829.02,0.00
2024-12-10 17:25:08,99,8845,43,56,5845.87,11829.31,0.00
2024-12-10 17:25:08,99,8846,43,56,5872.58,11830.00,0.00
2024-12-10 17:25:08,100,8846,44,56,5813.85,11830.01,0.00
2024-12-10 17:25:08,99,8846,44,55,5870.20,11830.02,0.00
2024-12-10 17:25:08,99,8847,44,55,5862.06,11831.00,0.00
2024-12-10 17:25:08,100,8847,44,56,5803.44,11831.01,0.00
2024-12-10 17:25:08,99,8847,43,56,5859.68,11831.02,0.00
2024-12-10 17:25:08,99,8848,43,56,5851.75,11832.00,0.00
2024-12-10 17:25:08,100,8848,43,57,5793.23,11832.01,0.00
2024-12-10 17:25:08,99,8848,42,57,5849.37,11832.02,0.00
2024-12-10 17:25:08,100,8847,42,58,5746.55,11832.38,0.00
2024-12-10 17:25:09,100,8848,42,58,5855.62,11833.00,0.00
2024-12-10 17:25:09,101,8848,43,58,5797.64,11833.01,0.00
2024-12-10 17:25:09,100,8848,43,57,5853.26,11833.02,0.00
2024-12-10 17:25:09,100,8849,43,57,5960.36,11834.00,0.00
2024-12-10 17:25:09,101,8849,43,58,5901.35,11834.01,0.00
2024-12-10 17:25:09,100,8849,43,57,5958.01,11834.02,0.00
2024-12-10 17:25:09,99,8849,42,57,5952.93,11834.54,0.00
2024-12-10 17:25:09,99,8850,42,57,6006.55,11835.00,0.00
2024-12-10 17:25:09,100,8850,43,57,5946.49,11835.01,0.00
2024-12-10 17:25:09,99,8850,43,56,6004.17,11835.02,0.00
2024-12-10 17:25:09,99,8851,43,56,5988.79,11836.00,0.00
2024-12-10 17:25:09,100,8851,43,57,5928.90,11836.01,0.00
2024-12-10 17:25:09,99,8851,43,56,5986.41,11836.02,0.00
2024-12-10 17:25:09,99,8852,43,56,5964.28,11837.00,0.00
2024-12-10 17:25:09,100,8852,43,57,5904.64,11837.01,0.00
2024-12-10 17:25:09,99,8852,42,57,5961.90,11837.02,0.00
2024-12-10 17:25:09,98,8852,42,56,5916.56,11837.73,0.00
2024-12-10 17:25:09,98,8853,42,56,6006.18,11838.00,0.00
2024-12-10 17:25:09,99,8853,43,56,5945.51,11838.01,0.00
2024-12-10 17:25:09,98,8853,42,56,6003.77,11838.02,0.00
2024-12-10 17:25:09,97,8853,41,56,6036.12,11838.22,0.00
2024-12-10 17:25:09,97,8854,41,56,6050.19,11839.00,0.00
2024-12-10 17:25:09,98,8854,41,57,5988.46,11839.01,0.00
2024-12-10 17:25:09,97,8854,41,56,6047.76,11839.02,0.00
2024-12-10 17:25:09,96,8854,41,55,6100.08,11839.10,0.00
2024-12-10 17:25:09,96,8855,41,55,6101.41,11840.00,0.00
2024-12-10 17:25:09,97,8855,41,56,6038.51,11840.01,0.00
2024-12-10 17:25:09,96,8855,41,55,6098.95,11840.02,0.00
2024-12-10 17:25:09,96,8856,41,55,6092.87,11841.00,0.00
2024-12-10 17:25:09,97,8856,41,56,6030.05,11841.01,0.00
2024-12-10 17:25:09,96,8856,41,55,6090.41,11841.02,0.00
2024-12-10 17:25:09,96,8857,41,55,6087.04,11842.00,0.00
2024-12-10 17:25:09,97,8857,42,55,6024.29,11842.01,0.00
2024-12-10 17:25:09,96,8857,42,54,6084.58,11842.02,0.00
2024-12-10 17:25:09,96,8858,42,54,6079.09,11843.00,0.00
2024-12-10 17:25:09,97,8858,42,55,6016.42,11843.01,0.00
2024-12-10 17:25:09,96,8858,41,55,6076.63,11843.02,0.00
2024-12-10 17:25:09,96,8859,41,55,6070.94,11844.00,0.00
2024-12-10 17:25:09,97,8859,42,55,6008.35,11844.01,0.00
2024-12-10 17:25:09,96,8859,42,54,6068.48,11844.02,0.00
2024-12-10 17:25:09,95,8859,42,53,6118.40,11844.14,0.00
2024-12-10 17:25:09,94,8859,41,53,6139.13,11844.46,0.00
2024-12-10 17:25:09,94,8860,41,53,6181.68,11845.00,0.00
2024-12-10 17:25:09,95,8860,42,53,6116.61,11845.01,0.00
2024-12-10 17:25:09,94,8860,42,52,6179.16,11845.02,0.00
2024-12-10 17:25:09,93,8860,42,51,6181.39,11845.51,0.00
2024-12-10 17:25:09,93,8861,42,51,6237.28,11846.00,0.00
2024-12-10 17:25:09,94,8861,43,51,6170.93,11846.01,0.00
2024-12-10 17:25:09,93,8861,42,51,6234.74,11846.02,0.00
2024-12-10 17:25:09,93,8862,42,51,6233.65,11847.00,0.00
2024-12-10 17:25:09,94,8862,43,51,6167.33,11847.01,0.00
2024-12-10 17:25:09,93,8862,42,51,6231.11,11847.02,0.00
2024-12-10 17:25:09,92,8862,41,51,6283.26,11847.15,0.00
2024-12-10 17:25:09,92,8863,41,51,6304.14,11848.00,0.00
2024-12-10 17:25:09,93,8863,42,51,6236.36,11848.01,0.00
2024-12-10 17:25:09,93,8864,42,51,6241.90,11849.00,0.00
2024-12-10 17:25:09,94,8864,43,51,6175.50,11849.01,0.00
2024-12-10 17:25:09,93,8864,43,50,6239.36,11849.02,0.00
2024-12-10 17:25:09,93,8865,43,50,6244.74,11850.00,0.00
2024-12-10 17:25:09,94,8865,43,51,6178.30,11850.01,0.00
2024-12-10 17:25:09,93,8865,43,50,6242.20,11850.02,0.00
2024-12-10 17:25:09,92,8865,42,50,6259.25,11850.43,0.00
2024-12-10 17:25:09,92,8866,42,50,6316.20,11851.00,0.00
2024-12-10 17:25:09,93,8866,42,51,6248.28,11851.01,0.00
2024-12-10 17:25:09,92,8866,41,51,6313.63,11851.02,0.00
2024-12-10 17:25:09,92,8867,41,51,6321.31,11852.00,0.00
2024-12-10 17:25:09,93,8867,41,52,6253.34,11852.01,0.00
2024-12-10 17:25:09,92,8867,41,51,6318.74,11852.02,0.00
2024-12-10 17:25:09,92,8868,41,51,6324.34,11853.00,0.00
2024-12-10 17:25:09,93,8868,42,51,6256.34,11853.01,0.00
2024-12-10 17:25:09,92,8868,42,50,6321.77,11853.02,0.00
2024-12-10 17:25:09,92,8869,42,50,6320.94,11854.00,0.00
2024-12-10 17:25:09,93,8869,43,50,6252.98,11854.01,0.00
2024-12-10 17:25:09,92,8869,43,49,6318.37,11854.02,0.00
2024-12-10 17:25:09,93,8868,43,50,6188.29,11854.49,0.00
2024-12-10 17:25:09,93,8869,43,50,6351.06,11855.00,0.00
2024-12-10 17:25:09,94,8869,44,50,6283.49,11855.01,0.00
2024-12-10 17:25:09,93,8869,44,49,6348.51,11855.02,0.00
2024-12-10 17:25:09,93,8870,44,49,6474.74,11856.00,0.00
2024-12-10 17:25:09,94,8870,44,50,6405.86,11856.01,0.00
2024-12-10 17:25:09,93,8870,44,49,6472.20,11856.02,0.00
2024-12-10 17:25:09,93,8871,44,49,6465.18,11857.00,0.00
2024-12-10 17:25:09,94,8871,45,49,6396.40,11857.01,0.00
2024-12-10 17:25:09,94,8872,45,49,6384.84,11858.00,0.00
2024-12-10 17:25:09,95,8872,45,50,6317.63,11858.01,0.00
2024-12-10 17:25:09,95,8873,45,50,6304.63,11859.00,0.00
2024-12-10 17:25:09,96,8873,45,51,6238.96,11859.01,0.00
2024-12-10 17:25:09,96,8874,45,51,6222.79,11860.00,0.00
2024-12-10 17:25:09,97,8874,46,51,6158.64,11860.01,0.00
2024-12-10 17:25:10,97,8875,46,51,6145.31,11861.00,0.00
2024-12-10 17:25:10,98,8875,46,52,6082.60,11861.01,0.00
2024-12-10 17:25:10,98,8876,46,52,6070.25,11862.00,0.00
2024-12-10 17:25:10,99,8876,47,52,6008.94,11862.01,0.00
2024-12-10 17:25:10,98,8876,46,52,6067.84,11862.02,0.00
2024-12-10 17:25:10,98,8877,46,52,6058.02,11863.00,0.00
2024-12-10 17:25:10,99,8877,46,53,5996.83,11863.01,0.00
2024-12-10 17:25:10,98,8877,46,52,6055.60,11863.02,0.00
2024-12-10 17:25:10,98,8878,46,52,6044.55,11864.00,0.00
2024-12-10 17:25:10,99,8878,47,52,5983.50,11864.01,0.00
2024-12-10 17:25:10,98,8878,46,52,6042.14,11864.02,0.00
2024-12-10 17:25:10,98,8879,46,52,6035.46,11865.00,0.00
2024-12-10 17:25:10,99,8879,47,52,5974.50,11865.01,0.00
2024-12-10 17:25:10,98,8879,46,52,6033.05,11865.02,0.00
2024-12-10 17:25:10,98,8880,46,52,6028.31,11866.00,0.00
2024-12-10 17:25:10,99,8880,46,53,5967.42,11866.01,0.00
2024-12-10 17:25:10,99,8881,46,53,5957.97,11867.00,0.00
2024-12-10 17:25:10,100,8881,46,54,5898.39,11867.01,0.00
2024-12-10 17:25:10,99,8881,46,53,5955.58,11867.02,0.00
2024-12-10 17:25:10,100,8880,46,54,5820.63,11867.54,0.00
2024-12-10 17:25:10,100,8881,46,54,5937.29,11868.00,0.00
2024-12-10 17:25:10,101,8881,47,54,5878.50,11868.01,0.00
2024-12-10 17:25:10,100,8881,46,54,5934.92,11868.02,0.00
2024-12-10 17:25:10,99,8881,46,53,5956.27,11868.34,0.00
2024-12-10 17:25:10,98,8881,45,53,5997.75,11868.46,0.00
2024-12-10 17:25:10,98,8882,45,53,6176.18,11869.00,0.00
2024-12-10 17:25:10,99,8882,46,53,6113.79,11869.01,0.00
2024-12-10 17:25:10,98,8882,45,53,6173.76,11869.02,0.00
2024-12-10 17:25:10,98,8883,45,53,6179.12,11870.00,0.00
2024-12-10 17:25:10,99,8883,46,53,6116.71,11870.01,0.00
2024-12-10 17:25:10,99,8884,46,53,6112.46,11871.00,0.00
2024-12-10 17:25:10,100,8884,46,54,6051.34,11871.01,0.00
2024-12-10 17:25:10,99,8884,46,53,6108.88,11871.03,0.00
2024-12-10 17:25:10,98,8884,45,53,6125.02,11871.34,0.00
2024-12-10 17:25:10,98,8885,45,53,6164.37,11872.00,0.00
2024-12-10 17:25:10,99,8885,46,53,6102.10,11872.01,0.00
2024-12-10 17:25:10,98,8885,46,52,6160.75,11872.03,0.00
2024-12-10 17:25:10,98,8886,46,52,6162.55,11873.00,0.00
2024-12-10 17:25:10,99,8886,46,53,6100.30,11873.01,0.00
2024-12-10 17:25:10,98,8886,46,52,6158.93,11873.03,0.00
2024-12-10 17:25:10,99,8885,46,53,5991.93,11873.90,0.00
2024-12-10 17:25:10,99,8886,46,53,6110.77,11874.00,0.00
2024-12-10 17:25:10,100,8886,47,53,6049.66,11874.01,0.00
2024-12-10 17:25:10,99,8886,46,53,6107.18,11874.03,0.00
2024-12-10 17:25:10,99,8887,46,53,6229.43,11875.00,0.00
2024-12-10 17:25:10,100,8887,47,53,6167.13,11875.01,0.00
2024-12-10 17:25:10,99,8887,47,52,6225.84,11875.03,0.00
2024-12-10 17:25:10,99,8888,47,52,6231.15,11876.00,0.00
2024-12-10 17:25:10,100,8888,47,53,6168.84,11876.01,0.00
2024-12-10 17:25:10,99,8888,47,52,6227.56,11876.03,0.00
2024-12-10 17:25:10,99,8889,47,52,6232.79,11877.00,0.00
2024-12-10 17:25:10,100,8889,48,52,6170.47,11877.01,0.00
2024-12-10 17:25:10,99,8889,48,51,6229.20,11877.03,0.00
2024-12-10 17:25:10,99,8890,48,51,6232.68,11878.00,0.00
2024-12-10 17:25:10,100,8890,48,52,6170.35,11878.01,0.00
2024-12-10 17:25:10,99,8890,48,51,6229.09,11878.03,0.00
2024-12-10 17:25:10,99,8891,48,51,6228.17,11879.00,0.00
2024-12-10 17:25:10,100,8891,49,51,6165.89,11879.01,0.00
2024-12-10 17:25:10,99,8891,48,51,6224.58,11879.03,0.00
2024-12-10 17:25:10,98,8891,48,50,6245.33,11879.35,0.00
2024-12-10 17:25:10,98,8892,48,50,6289.30,11880.00,0.00
2024-12-10 17:25:10,99,8892,49,50,6225.77,11880.01,0.00
2024-12-10 17:25:10,98,8892,48,50,6285.67,11880.03,0.00
2024-12-10 17:25:10,98,8893,48,50,6292.25,11881.00,0.00
2024-12-10 17:25:10,99,8893,48,51,6228.69,11881.01,0.00
2024-12-10 17:25:10,98,8893,48,50,6288.62,11881.03,0.00
2024-12-10 17:25:10,98,8894,48,50,6295.20,11882.00,0.00
2024-12-10 17:25:10,99,8894,49,50,6231.62,11882.01,0.00
2024-12-10 17:25:10,98,8894,49,49,6291.57,11882.03,0.00
2024-12-10 17:25:10,98,8895,49,49,6298.16,11883.00,0.00
2024-12-10 17:25:10,99,8895,49,50,6234.54,11883.01,0.00
2024-12-10 17:25:10,100,8894,50,50,6172.20,11883.03,0.00
2024-12-10 17:25:10,99,8894,49,50,6314.98,11883.04,0.00
2024-12-10 17:25:10,99,8895,49,50,6321.49,11884.00,0.00
2024-12-10 17:25:10,100,8895,49,51,6258.28,11884.01,0.00
2024-12-10 17:25:10,99,8895,49,50,6317.91,11884.03,0.00
2024-12-10 17:25:10,100,8894,50,50,6251.17,11884.08,0.00
2024-12-10 17:25:10,100,8895,50,50,6492.94,11885.00,0.00
2024-12-10 17:25:10,101,8895,51,50,6428.65,11885.01,0.00
2024-12-10 17:25:10,100,8895,51,49,6489.39,11885.03,0.00
2024-12-10 17:25:10,100,8896,51,49,6612.33,11886.00,0.00
2024-12-10 17:25:10,101,8896,52,49,6546.86,11886.01,0.00
2024-12-10 17:25:10,100,8896,51,49,6608.77,11886.03,0.00
2024-12-10 17:25:11,100,8897,51,49,6611.95,11887.00,0.00
2024-12-10 17:25:11,101,8897,52,49,6546.49,11887.01,0.00
2024-12-10 17:25:11,100,8897,52,48,6608.40,11887.03,0.00
2024-12-10 17:25:11,100,8898,52,48,6611.60,11888.00,0.00
2024-12-10 17:25:11,101,8898,53,48,6546.14,11888.01,0.00
2024-12-10 17:25:11,101,8899,53,48,6545.53,11889.00,0.00
2024-12-10 17:25:11,102,8899,54,48,6481.36,11889.01,0.00
2024-12-10 17:25:11,102,8900,54,48,6479.48,11890.00,0.00
2024-12-10 17:25:11,103,8900,54,49,6416.57,11890.01,0.00
2024-12-10 17:25:11,103,8901,54,49,6412.42,11891.00,0.00
2024-12-10 17:25:11,104,8901,55,49,6350.76,11891.01,0.00
2024-12-10 17:25:11,103,8901,54,49,6407.82,11891.04,0.00
2024-12-10 17:25:11,103,8902,54,49,6408.75,11892.00,0.00
2024-12-10 17:25:11,104,8902,54,50,6347.13,11892.01,0.00
2024-12-10 17:25:11,103,8902,54,49,6404.16,11892.04,0.00
2024-12-10 17:25:11,103,8903,54,49,6405.44,11893.00,0.00
2024-12-10 17:25:11,104,8903,55,49,6343.85,11893.01,0.00
2024-12-10 17:25:11,103,8903,55,48,6400.84,11893.04,0.00
2024-12-10 17:25:11,103,8904,55,48,6402.46,11894.00,0.00
2024-12-10 17:25:11,104,8904,56,48,6340.90,11894.01,0.00
2024-12-10 17:25:11,104,8905,56,48,6337.68,11895.00,0.00
2024-12-10 17:25:11,105,8905,57,48,6277.32,11895.01,0.00
2024-12-10 17:25:11,104,8905,56,48,6333.13,11895.04,0.00
2024-12-10 17:25:11,104,8906,56,48,6333.64,11896.00,0.00
2024-12-10 17:25:11,105,8906,56,49,6273.32,11896.01,0.00
2024-12-10 17:25:11,104,8906,55,49,6329.08,11896.04,0.00
2024-12-10 17:25:11,104,8907,55,49,6329.59,11897.00,0.00
2024-12-10 17:25:11,105,8907,55,50,6269.31,11897.01,0.00
2024-12-10 17:25:11,104,8907,55,49,6325.04,11897.04,0.00
2024-12-10 17:25:11,103,8907,55,48,6369.97,11897.17,0.00
2024-12-10 17:25:11,103,8908,55,48,6387.80,11898.00,0.00
2024-12-10 17:25:11,104,8908,55,49,6326.38,11898.01,0.00
2024-12-10 17:25:11,104,8909,55,49,6323.48,11899.00,0.00
2024-12-10 17:25:11,105,8909,56,49,6263.25,11899.01,0.00
2024-12-10 17:25:11,104,8909,56,48,6318.92,11899.04,0.00
2024-12-10 17:25:11,104,8910,56,48,6319.43,11900.00,0.00
2024-12-10 17:25:11,105,8910,56,49,6259.25,11900.01,0.00
2024-12-10 17:25:11,104,8910,56,48,6315.39,11900.04,0.00
2024-12-10 17:25:11,104,8911,56,48,6315.79,11901.00,0.00
2024-12-10 17:25:11,105,8911,56,49,6255.64,11901.01,0.00
2024-12-10 17:25:11,105,8912,56,49,6251.63,11902.00,0.00
2024-12-10 17:25:11,106,8912,57,49,6192.65,11902.01,0.00
2024-12-10 17:25:11,105,8912,57,48,6247.11,11902.04,0.00
2024-12-10 17:25:11,105,8913,57,48,6245.53,11903.00,0.00
2024-12-10 17:25:11,106,8913,57,49,6186.61,11903.01,0.00
2024-12-10 17:25:11,105,8913,56,49,6241.01,11903.04,0.00
2024-12-10 17:25:11,105,8914,56,49,6240.03,11904.00,0.00
2024-12-10 17:25:11,106,8914,56,50,6181.16,11904.01,0.00
2024-12-10 17:25:11,105,8914,55,50,6235.51,11904.04,0.00
2024-12-10 17:25:11,105,8915,55,50,6234.51,11905.00,0.00
2024-12-10 17:25:11,106,8915,56,50,6175.69,11905.01,0.00
2024-12-10 17:25:11,105,8915,56,49,6229.99,11905.04,0.00
2024-12-10 17:25:11,105,8916,56,49,6223.21,11906.00,0.00
2024-12-10 17:25:11,106,8916,57,49,6164.50,11906.01,0.00
2024-12-10 17:25:11,106,8917,57,49,6157.12,11907.00,0.00
2024-12-10 17:25:11,107,8917,58,49,6099.58,11907.01,0.00
2024-12-10 17:25:11,106,8917,58,48,6152.65,11907.04,0.00
2024-12-10 17:25:11,106,8918,58,48,6150.90,11908.00,0.00
2024-12-10 17:25:11,107,8918,58,49,6093.42,11908.01,0.00
2024-12-10 17:25:11,107,8919,58,49,6084.91,11909.00,0.00
2024-12-10 17:25:11,108,8919,59,49,6028.57,11909.01,0.00
2024-12-10 17:25:11,107,8919,59,48,6080.48,11909.04,0.00
2024-12-10 17:25:11,107,8920,59,48,6068.06,11910.00,0.00
2024-12-10 17:25:11,108,8920,60,48,6011.87,11910.01,0.00
2024-12-10 17:25:11,107,8920,59,48,6063.62,11910.04,0.00
2024-12-10 17:25:11,106,8920,58,48,6118.89,11910.04,0.00
2024-12-10 17:25:11,106,8921,58,48,6112.71,11911.00,0.00
2024-12-10 17:25:11,107,8921,59,48,6055.58,11911.01,0.00
2024-12-10 17:25:11,107,8922,59,48,6045.81,11912.00,0.00
2024-12-10 17:25:11,108,8922,60,48,5989.83,11912.01,0.00
2024-12-10 17:25:11,107,8922,60,47,6041.37,11912.04,0.00
2024-12-10 17:25:11,107,8923,60,47,6031.72,11913.00,0.00
2024-12-10 17:25:11,108,8923,60,48,5975.88,11913.01,0.00
2024-12-10 17:25:11,107,8923,60,47,6027.29,11913.04,0.00
2024-12-10 17:25:11,106,8923,60,46,6083.02,11913.04,0.00
2024-12-10 17:25:11,106,8924,60,46,6073.36,11914.00,0.00
2024-12-10 17:25:11,107,8924,60,47,6016.60,11914.01,0.00
2024-12-10 17:25:11,106,8924,60,46,6068.88,11914.04,0.00
2024-12-10 17:25:12,106,8925,60,46,6061.15,11915.00,0.00
2024-12-10 17:25:12,107,8925,61,46,6004.50,11915.01,0.00
2024-12-10 17:25:12,107,8926,61,46,5994.40,11916.00,0.00
2024-12-10 17:25:12,108,8926,61,47,5938.89,11916.01,0.00
2024-12-10 17:25:12,107,8926,61,46,5989.96,11916.04,0.00
2024-12-10 17:25:12,107,8927,61,46,5984.33,11917.00,0.00
2024-12-10 17:25:12,108,8927,61,47,5928.92,11917.01,0.00
2024-12-10 17:25:12,108,8928,61,47,5918.08,11918.00,0.00
2024-12-10 17:25:12,109,8928,62,47,5863.78,11918.01,0.00
2024-12-10 17:25:12,109,8929,62,47,5843.01,11919.00,0.00
2024-12-10 17:25:12,110,8929,63,47,5789.89,11919.01,0.00
2024-12-10 17:25:12,109,8929,62,47,5838.65,11919.04,0.00
2024-12-10 17:25:12,108,8929,62,46,5838.00,11919.49,0.00
2024-12-10 17:25:12,108,8930,62,46,5875.63,11920.00,0.00
2024-12-10 17:25:12,109,8930,62,47,5821.72,11920.01,0.00
2024-12-10 17:25:12,108,8930,61,47,5871.23,11920.04,0.00
2024-12-10 17:25:12,108,8931,61,47,5854.47,11921.00,0.00
2024-12-10 17:25:12,109,8931,62,47,5800.76,11921.01,0.00
2024-12-10 17:25:12,108,8931,61,47,5850.06,11921.04,0.00
2024-12-10 17:25:12,108,8932,61,47,5824.68,11922.00,0.00
2024-12-10 17:25:12,109,8932,62,47,5771.25,11922.01,0.00
2024-12-10 17:25:12,109,8933,62,47,5734.61,11923.00,0.00
2024-12-10 17:25:12,110,8933,62,48,5682.48,11923.01,0.00
2024-12-10 17:25:12,109,8933,62,47,5729.15,11923.05,0.00
2024-12-10 17:25:12,109,8934,62,47,5692.14,11924.00,0.00
2024-12-10 17:25:12,110,8934,63,47,5640.39,11924.01,0.00
2024-12-10 17:25:12,109,8934,62,47,5686.68,11924.05,0.00
2024-12-10 17:25:12,108,8934,62,46,5638.13,11924.76,0.00
2024-12-10 17:25:12,108,8935,62,46,5716.86,11925.00,0.00
2024-12-10 17:25:12,109,8935,62,47,5664.41,11925.01,0.00
2024-12-10 17:25:12,108,8935,61,47,5711.36,11925.05,0.00
2024-12-10 17:25:12,108,8936,61,47,5694.07,11926.00,0.00
2024-12-10 17:25:12,109,8936,61,48,5641.83,11926.01,0.00
2024-12-10 17:25:12,108,8936,61,47,5688.56,11926.05,0.00
2024-12-10 17:25:12,108,8937,61,47,5669.90,11927.00,0.00
2024-12-10 17:25:12,109,8937,62,47,5617.88,11927.01,0.00
2024-12-10 17:25:12,108,8937,61,47,5664.39,11927.05,0.00
2024-12-10 17:25:12,109,8936,61,48,5543.84,11927.61,0.00
2024-12-10 17:25:12,109,8937,61,48,5639.97,11928.00,0.00
2024-12-10 17:25:12,110,8937,61,49,5588.70,11928.01,0.00
2024-12-10 17:25:12,109,8937,60,49,5634.52,11928.05,0.00
2024-12-10 17:25:12,108,8937,59,49,5633.09,11928.44,0.00
2024-12-10 17:25:12,108,8938,59,49,5772.58,11929.00,0.00
2024-12-10 17:25:12,109,8938,59,50,5719.62,11929.01,0.00
2024-12-10 17:25:12,108,8938,58,50,5767.07,11929.05,0.00
2024-12-10 17:25:12,108,8939,58,50,5748.22,11930.00,0.00
2024-12-10 17:25:12,109,8939,58,51,5695.49,11930.01,0.00
2024-12-10 17:25:12,108,8939,57,51,5742.71,11930.05,0.00
2024-12-10 17:25:12,108,8940,57,51,5723.36,11931.00,0.00
2024-12-10 17:25:12,109,8940,58,51,5670.85,11931.01,0.00
2024-12-10 17:25:12,108,8940,58,50,5717.85,11931.05,0.00
2024-12-10 17:25:12,107,8940,58,49,5692.56,11931.64,0.00
2024-12-10 17:25:12,107,8941,58,49,5750.88,11932.00,0.00
2024-12-10 17:25:12,108,8941,59,49,5697.63,11932.01,0.00
2024-12-10 17:25:12,107,8941,58,49,5748.65,11932.02,0.00
2024-12-10 17:25:12,106,8941,58,48,5799.51,11932.04,0.00
2024-12-10 17:25:12,105,8941,58,47,5853.61,11932.04,0.00
2024-12-10 17:25:12,105,8942,58,47,5837.99,11933.00,0.00
2024-12-10 17:25:12,106,8942,58,48,5782.92,11933.01,0.00
2024-12-10 17:25:12,105,8942,57,48,5833.46,11933.04,0.00
2024-12-10 17:25:12,105,8943,57,48,5819.40,11934.00,0.00
2024-12-10 17:25:12,106,8943,58,48,5764.50,11934.01,0.00
2024-12-10 17:25:12,105,8943,58,47,5814.87,11934.04,0.00
2024-12-10 17:25:12,105,8944,58,47,5802.90,11935.00,0.00
2024-12-10 17:25:12,106,8944,58,48,5748.16,11935.01,0.00
2024-12-10 17:25:12,105,8944,57,48,5798.37,11935.04,0.00
2024-12-10 17:25:12,105,8945,57,48,5786.22,11936.00,0.00
2024-12-10 17:25:12,106,8945,57,49,5731.63,11936.01,0.00
2024-12-10 17:25:12,105,8945,57,48,5781.68,11936.04,0.00
2024-12-10 17:25:12,105,8946,57,48,5770.80,11937.00,0.00
2024-12-10 17:25:12,106,8946,57,49,5716.36,11937.01,0.00
2024-12-10 17:25:12,105,8946,57,48,5766.26,11937.04,0.00
2024-12-10 17:25:12,104,8946,57,47,5802.17,11937.20,0.00
2024-12-10 17:25:12,105,8945,58,47,5688.01,11937.71,0.00
2024-12-10 17:25:12,105,8946,58,47,5830.66,11938.00,0.00
2024-12-10 17:25:12,106,8946,59,47,5775.65,11938.01,0.00
2024-12-10 17:25:12,105,8946,58,47,5826.12,11938.04,0.00
2024-12-10 17:25:12,105,8947,58,47,5905.17,11939.00,0.00
2024-12-10 17:25:12,106,8947,59,47,5849.46,11939.01,0.00
2024-12-10 17:25:12,105,8947,59,46,5900.63,11939.04,0.00
2024-12-10 17:25:12,105,8948,59,46,5870.59,11940.00,0.00
2024-12-10 17:25:12,106,8948,60,46,5815.21,11940.01,0.00
2024-12-10 17:25:12,105,8948,60,45,5866.06,11940.04,0.00
2024-12-10 17:25:13,105,8949,60,45,5859.84,11941.00,0.00
2024-12-10 17:25:13,106,8949,60,46,5804.56,11941.01,0.00
2024-12-10 17:25:13,105,8949,60,45,5855.30,11941.04,0.00
2024-12-10 17:25:13,104,8949,59,45,5817.64,11941.70,0.00
2024-12-10 17:25:13,104,8950,59,45,5894.53,11942.00,0.00
2024-12-10 17:25:13,105,8950,59,46,5838.39,11942.01,0.00
2024-12-10 17:25:13,104,8950,58,46,5890.92,11942.04,0.00
2024-12-10 17:25:13,104,8951,58,46,5886.75,11943.00,0.00
2024-12-10 17:25:13,105,8951,58,47,5830.69,11943.01,0.00
2024-12-10 17:25:13,104,8951,58,46,5882.17,11943.04,0.00
2024-12-10 17:25:13,104,8952,58,46,5873.00,11944.00,0.00
2024-12-10 17:25:13,105,8952,59,46,5817.07,11944.01,0.00
2024-12-10 17:25:13,104,8952,58,46,5868.42,11944.04,0.00
2024-12-10 17:25:13,103,8952,57,46,5924.66,11944.04,0.00
2024-12-10 17:25:13,102,8952,57,45,5977.71,11944.08,0.00
2024-12-10 17:25:13,102,8953,57,45,5971.00,11945.00,0.00
2024-12-10 17:25:13,103,8953,57,46,5913.03,11945.01,0.00
2024-12-10 17:25:13,103,8954,57,46,5896.78,11946.00,0.00
2024-12-10 17:25:13,104,8954,58,46,5840.08,11946.01,0.00
2024-12-10 17:25:13,103,8954,57,46,5892.15,11946.04,0.00
2024-12-10 17:25:13,103,8955,57,46,5883.12,11947.00,0.00
2024-12-10 17:25:13,104,8955,57,47,5826.55,11947.01,0.00
2024-12-10 17:25:13,103,8955,56,47,5878.48,11947.04,0.00
2024-12-10 17:25:13,103,8956,56,47,5873.39,11948.00,0.00
2024-12-10 17:25:13,104,8956,57,47,5816.91,11948.01,0.00
2024-12-10 17:25:13,103,8956,56,47,5868.76,11948.04,0.00
2024-12-10 17:25:13,103,8957,56,47,5859.01,11949.00,0.00
2024-12-10 17:25:13,104,8957,56,48,5802.67,11949.01,0.00
2024-12-10 17:25:13,103,8957,55,48,5854.38,11949.04,0.00
2024-12-10 17:25:13,102,8957,54,48,5855.42,11949.51,0.00
2024-12-10 17:25:13,102,8958,54,48,5891.52,11950.00,0.00
2024-12-10 17:25:13,103,8958,55,48,5834.33,11950.01,0.00
2024-12-10 17:25:13,104,8957,55,49,5723.18,11950.49,0.00
2024-12-10 17:25:13,104,8958,55,49,5809.70,11951.00,0.00
2024-12-10 17:25:13,105,8958,55,50,5754.36,11951.01,0.00
2024-12-10 17:25:13,104,8958,55,49,5805.11,11951.04,0.00
2024-12-10 17:25:13,103,8958,54,49,5737.62,11951.86,0.00
2024-12-10 17:25:13,103,8959,54,49,5953.56,11952.00,0.00
2024-12-10 17:25:13,104,8959,55,49,5896.32,11952.01,0.00
2024-12-10 17:25:13,103,8959,55,48,5948.93,11952.04,0.00
2024-12-10 17:25:13,102,8959,54,48,5927.85,11952.56,0.00
2024-12-10 17:25:13,102,8960,54,48,5985.15,11953.00,0.00
2024-12-10 17:25:13,103,8960,54,49,5927.05,11953.01,0.00
2024-12-10 17:25:13,102,8960,53,49,5980.47,11953.04,0.00
2024-12-10 17:25:13,102,8961,53,49,5976.44,11954.00,0.00
2024-12-10 17:25:13,103,8961,53,50,5918.41,11954.01,0.00
2024-12-10 17:25:13,102,8961,52,50,5971.75,11954.04,0.00
2024-12-10 17:25:13,102,8962,52,50,5968.65,11955.00,0.00
2024-12-10 17:25:13,103,8962,52,51,5910.71,11955.01,0.00
2024-12-10 17:25:13,102,8962,51,51,5963.97,11955.04,0.00
2024-12-10 17:25:13,102,8963,51,51,5961.59,11956.00,0.00
2024-12-10 17:25:13,103,8963,51,52,5903.71,11956.01,0.00
2024-12-10 17:25:13,102,8963,51,51,5956.91,11956.04,0.00
2024-12-10 17:25:13,102,8964,51,51,5955.95,11957.00,0.00
2024-12-10 17:25:13,103,8964,52,51,5898.13,11957.01,0.00
2024-12-10 17:25:13,102,8964,51,51,5951.27,11957.04,0.00
2024-12-10 17:25:13,102,8965,51,51,5951.72,11958.00,0.00
2024-12-10 17:25:13,103,8965,51,52,5893.93,11958.01,0.00
2024-12-10 17:25:13,102,8965,51,51,5947.03,11958.04,0.00
2024-12-10 17:25:13,102,8966,51,51,5945.97,11959.00,0.00
2024-12-10 17:25:13,103,8966,52,51,5888.24,11959.01,0.00
2024-12-10 17:25:13,102,8966,52,50,5941.29,11959.04,0.00
2024-12-10 17:25:13,102,8967,52,50,5936.38,11960.00,0.00
2024-12-10 17:25:13,103,8967,52,51,5878.74,11960.01,0.00
2024-12-10 17:25:13,102,8967,51,51,5931.69,11960.04,0.00
2024-12-10 17:25:13,102,8968,51,51,5930.53,11961.00,0.00
2024-12-10 17:25:13,103,8968,52,51,5872.96,11961.01,0.00
2024-12-10 17:25:13,102,8968,52,50,5925.85,11961.04,0.00
2024-12-10 17:25:13,102,8969,52,50,5927.25,11962.00,0.00
2024-12-10 17:25:13,103,8969,52,51,5869.71,11962.01,0.00
2024-12-10 17:25:13,102,8969,51,51,5922.57,11962.04,0.00
2024-12-10 17:25:13,102,8970,51,51,5917.38,11963.00,0.00
2024-12-10 17:25:13,103,8970,52,51,5859.93,11963.01,0.00
2024-12-10 17:25:13,103,8971,52,51,5846.77,11964.00,0.00
2024-12-10 17:25:13,104,8971,53,51,5790.55,11964.01,0.00
2024-12-10 17:25:13,103,8971,52,51,5840.97,11964.05,0.00
2024-12-10 17:25:13,103,8972,52,51,5833.59,11965.00,0.00
2024-12-10 17:25:13,104,8972,52,52,5777.50,11965.01,0.00
2024-12-10 17:25:13,103,8972,51,52,5827.79,11965.05,0.00
2024-12-10 17:25:13,103,8973,51,52,5817.72,11966.00,0.00
2024-12-10 17:25:13,104,8973,52,52,5761.78,11966.01,0.00
2024-12-10 17:25:13,103,8973,52,51,5811.92,11966.05,0.00
2024-12-10 17:25:13,103,8974,52,51,5796.79,11967.00,0.00
2024-12-10 17:25:13,104,8974,52,52,5741.05,11967.01,0.00
2024-12-10 17:25:13,103,8974,52,51,5793.30,11967.03,0.00
2024-12-10 17:25:13,102,8974,52,50,5847.76,11967.04,0.00
2024-12-10 17:25:13,101,8974,52,49,5834.93,11967.52,0.00
2024-12-10 17:25:13,102,8973,52,50,5760.22,11967.69,0.00
2024-12-10 17:25:14,102,8974,52,50,5876.64,11968.00,0.00
2024-12-10 17:25:14,103,8974,52,51,5819.58,11968.01,0.00
2024-12-10 17:25:14,102,8974,51,51,5871.95,11968.04,0.00
2024-12-10 17:25:14,102,8975,51,51,5991.76,11969.00,0.00
2024-12-10 17:25:14,103,8975,52,51,5933.58,11969.01,0.00
2024-12-10 17:25:14,102,8975,51,51,5987.07,11969.04,0.00
2024-12-10 17:25:14,102,8976,51,51,5985.45,11970.00,0.00
2024-12-10 17:25:14,103,8976,52,51,5927.34,11970.01,0.00
2024-12-10 17:25:14,102,8976,51,51,5928.06,11970.42,0.00
2024-12-10 17:25:14,102,8977,51,51,5976.59,11971.00,0.00
2024-12-10 17:25:14,103,8977,52,51,5918.57,11971.01,0.00
2024-12-10 17:25:14,102,8977,52,50,5971.90,11971.04,0.00
2024-12-10 17:25:14,101,8977,51,50,5997.97,11971.27,0.00
2024-12-10 17:25:14,101,8978,51,50,6026.80,11972.00,0.00
2024-12-10 17:25:14,102,8978,52,50,5967.71,11972.01,0.00
2024-12-10 17:25:14,101,8978,51,50,6022.06,11972.04,0.00
2024-12-10 17:25:14,101,8979,51,50,6022.80,11973.00,0.00
2024-12-10 17:25:14,102,8979,52,50,5963.75,11973.01,0.00
2024-12-10 17:25:14,101,8979,52,49,6019.25,11973.03,0.00
2024-12-10 17:25:14,100,8979,52,48,6078.24,11973.03,0.00
2024-12-10 17:25:14,99,8979,52,47,6138.43,11973.03,0.00
2024-12-10 17:25:14,99,8980,52,47,6139.53,11974.00,0.00
2024-12-10 17:25:14,100,8980,53,47,6078.13,11974.01,0.00
2024-12-10 17:25:14,99,8980,52,47,6135.90,11974.03,0.00
2024-12-10 17:25:14,99,8981,52,47,6135.79,11975.00,0.00
2024-12-10 17:25:14,100,8981,53,47,6074.43,11975.01,0.00
2024-12-10 17:25:14,99,8981,52,47,6132.16,11975.03,0.00
2024-12-10 17:25:14,99,8982,52,47,6130.58,11976.00,0.00
2024-12-10 17:25:14,100,8982,53,47,6069.28,11976.01,0.00
2024-12-10 17:25:14,99,8982,53,46,6126.95,11976.03,0.00
2024-12-10 17:25:14,99,8983,53,46,6124.37,11977.00,0.00
2024-12-10 17:25:14,100,8983,54,46,6063.13,11977.01,0.00
2024-12-10 17:25:14,99,8983,53,46,6120.74,11977.03,0.00
2024-12-10 17:25:14,99,8984,53,46,6117.44,11978.00,0.00
2024-12-10 17:25:14,100,8984,54,46,6056.26,11978.01,0.00
2024-12-10 17:25:14,99,8984,54,45,6113.81,11978.03,0.00
2024-12-10 17:25:14,98,8984,54,44,6149.51,11978.21,0.00
2024-12-10 17:25:14,98,8984,54,44,6174.22,11979.00,0.00
2024-12-10 17:25:14,99,8984,55,44,6111.86,11979.01,0.00
2024-12-10 17:25:14,98,8984,54,44,6170.56,11979.03,0.00
2024-12-10 17:25:14,99,8983,54,45,6087.68,11979.22,0.00
2024-12-10 17:25:14,99,8984,54,45,6206.40,11980.00,0.00
2024-12-10 17:25:14,100,8984,54,46,6144.34,11980.01,0.00
2024-12-10 17:25:14,99,8984,53,46,6202.77,11980.03,0.00
2024-12-10 17:25:14,98,8984,53,45,6241.51,11980.22,0.00
2024-12-10 17:25:14,98,8985,53,45,6393.59,11981.00,0.00
2024-12-10 17:25:14,99,8985,53,46,6329.01,11981.01,0.00
2024-12-10 17:25:14,98,8985,53,45,6389.92,11981.03,0.00
2024-12-10 17:25:14,97,8985,52,45,6440.17,11981.15,0.00
2024-12-10 17:25:14,97,8986,52,45,6462.93,11982.00,0.00
2024-12-10 17:25:14,98,8986,52,46,6396.98,11982.01,0.00
2024-12-10 17:25:14,97,8986,51,46,6459.23,11982.03,0.00
2024-12-10 17:25:14,97,8987,51,46,6467.18,11983.00,0.00
2024-12-10 17:25:14,98,8987,52,46,6401.19,11983.01,0.00
2024-12-10 17:25:14,97,8987,51,46,6465.94,11983.01,0.00
2024-12-10 17:25:14,96,8987,51,45,6530.80,11983.02,0.00
2024-12-10 17:25:14,96,8988,51,45,6538.83,11984.00,0.00
2024-12-10 17:25:14,97,8988,51,46,6471.42,11984.01,0.00
2024-12-10 17:25:14,96,8988,50,46,6537.58,11984.01,0.00
2024-12-10 17:25:14,95,8988,50,45,6603.88,11984.02,0.00
2024-12-10 17:25:14,94,8988,49,45,6672.86,11984.02,0.00
2024-12-10 17:25:14,94,8989,49,45,6683.62,11985.00,0.00
2024-12-10 17:25:14,95,8989,49,46,6613.26,11985.01,0.00
2024-12-10 17:25:14,94,8989,48,46,6681.07,11985.02,0.00
2024-12-10 17:25:14,95,8988,48,47,6544.09,11985.60,0.00
2024-12-10 17:25:14,95,8989,48,47,6666.80,11986.00,0.00
2024-12-10 17:25:14,96,8989,48,48,6597.36,11986.01,0.00
2024-12-10 17:25:14,95,8989,47,48,6664.29,11986.02,0.00
2024-12-10 17:25:14,95,8990,47,48,6799.85,11987.00,0.00
2024-12-10 17:25:14,96,8990,48,48,6729.02,11987.01,0.00
2024-12-10 17:25:14,95,8990,47,48,6797.33,11987.02,0.00
2024-12-10 17:25:14,95,8991,47,48,6806.73,11988.00,0.00
2024-12-10 17:25:14,96,8991,48,48,6735.82,11988.01,0.00
2024-12-10 17:25:14,95,8991,47,48,6804.21,11988.02,0.00
2024-12-10 17:25:14,95,8992,47,48,6813.60,11989.00,0.00
2024-12-10 17:25:14,96,8992,47,49,6742.63,11989.01,0.00
2024-12-10 17:25:14,95,8992,46,49,6811.08,11989.02,0.00
2024-12-10 17:25:14,95,8993,46,49,6820.23,11990.00,0.00
2024-12-10 17:25:14,96,8993,47,49,6749.19,11990.01,0.00
2024-12-10 17:25:14,95,8993,47,48,6817.71,11990.02,0.00
2024-12-10 17:25:14,95,8993,47,48,6827.11,11991.00,0.00
2024-12-10 17:25:14,96,8993,47,49,6756.00,11991.01,0.00
2024-12-10 17:25:14,95,8993,46,49,6824.59,11991.02,0.00
2024-12-10 17:25:14,95,8994,46,49,6833.99,11992.00,0.00
2024-12-10 17:25:14,96,8994,46,50,6762.81,11992.01,0.00
2024-12-10 17:25:14,96,8995,46,50,6769.07,11993.00,0.00
2024-12-10 17:25:14,97,8995,47,50,6699.28,11993.01,0.00
2024-12-10 17:25:15,97,8996,47,50,6697.42,11994.00,0.00
2024-12-10 17:25:15,98,8996,47,51,6629.08,11994.01,0.00
2024-12-10 17:25:15,97,8996,47,50,6693.50,11994.03,0.00
2024-12-10 17:25:15,97,8997,47,50,6694.85,11995.00,0.00
2024-12-10 17:25:15,98,8997,48,50,6626.54,11995.01,0.00
2024-12-10 17:25:15,99,8996,48,51,6450.60,11995.88,0.00
2024-12-10 17:25:15,99,8997,48,51,6567.97,11996.00,0.00
2024-12-10 17:25:15,100,8997,49,51,6502.29,11996.01,0.00
2024-12-10 17:25:15,100,8998,49,51,6613.58,11997.00,0.00
2024-12-10 17:25:15,101,8998,50,51,6548.10,11997.01,0.00
2024-12-10 17:25:15,101,8999,50,51,6532.44,11998.00,0.00
2024-12-10 17:25:15,102,8999,50,52,6468.40,11998.01,0.00
2024-12-10 17:25:15,102,9000,50,52,6447.07,11999.00,0.00
2024-12-10 17:25:15,103,9000,50,53,6384.48,11999.01,0.00
2024-12-10 17:25:15,102,9000,49,53,6439.68,11999.05,0.00
2024-12-10 17:25:15,102,9001,49,53,6423.20,12000.00,0.00
2024-12-10 17:25:15,103,9001,49,54,6360.84,12000.01,0.00
2024-12-10 17:25:15,104,9000,50,54,6289.95,12000.11,0.00
2024-12-10 17:25:15,104,9001,50,54,6385.82,12001.00,0.00
2024-12-10 17:25:15,105,9001,51,54,6325.00,12001.01,0.00
2024-12-10 17:25:15,104,9001,51,53,6381.08,12001.04,0.00
2024-12-10 17:25:15,104,9002,51,53,6477.30,12002.00,0.00
2024-12-10 17:25:15,105,9002,51,54,6415.62,12002.01,0.00
2024-12-10 17:25:15,105,9003,51,54,6392.29,12003.00,0.00
2024-12-10 17:25:15,106,9003,52,54,6331.98,12003.01,0.00
2024-12-10 17:25:15,105,9003,51,54,6375.42,12003.11,0.00
2024-12-10 17:25:15,105,9004,51,54,6365.39,12004.00,0.00
2024-12-10 17:25:15,106,9004,51,55,6305.34,12004.01,0.00
2024-12-10 17:25:15,105,9004,51,54,6360.83,12004.04,0.00
2024-12-10 17:25:15,105,9005,51,54,6335.34,12005.00,0.00
2024-12-10 17:25:15,106,9005,52,54,6275.57,12005.01,0.00
2024-12-10 17:25:15,105,9005,51,54,6330.78,12005.04,0.00
2024-12-10 17:25:15,106,9004,52,54,6204.44,12005.61,0.00
2024-12-10 17:25:15,106,9005,52,54,6301.33,12006.00,0.00
2024-12-10 17:25:15,107,9005,52,55,6242.44,12006.01,0.00
2024-12-10 17:25:15,106,9005,51,55,6296.81,12006.04,0.00
2024-12-10 17:25:15,106,9006,51,55,6355.96,12007.00,0.00
2024-12-10 17:25:15,107,9006,52,55,6296.56,12007.01,0.00
2024-12-10 17:25:15,107,9007,52,55,6237.49,12008.00,0.00
2024-12-10 17:25:15,108,9007,52,56,6179.74,12008.01,0.00
2024-12-10 17:25:15,107,9007,52,55,6233.01,12008.04,0.00
2024-12-10 17:25:15,107,9008,52,55,6178.53,12009.00,0.00
2024-12-10 17:25:15,108,9008,53,55,6121.32,12009.01,0.00
2024-12-10 17:25:15,108,9009,53,55,6067.08,12010.00,0.00
2024-12-10 17:25:15,109,9009,53,56,6011.42,12010.01,0.00
2024-12-10 17:25:15,108,9009,52,56,6061.54,12010.05,0.00
2024-12-10 17:25:15,108,9010,52,56,6014.53,12011.00,0.00
2024-12-10 17:25:15,109,9010,53,56,5959.35,12011.01,0.00
2024-12-10 17:25:15,108,9010,53,55,5938.28,12011.56,0.00
2024-12-10 17:25:15,108,9011,53,55,5970.63,12012.00,0.00
2024-12-10 17:25:15,109,9011,54,55,5915.86,12012.01,0.00
2024-12-10 17:25:15,109,9012,54,55,5875.53,12013.00,0.00
2024-12-10 17:25:15,110,9012,55,55,5822.12,12013.01,0.00
2024-12-10 17:25:15,109,9012,55,54,5870.04,12013.05,0.00
2024-12-10 17:25:15,109,9013,55,54,5839.79,12014.00,0.00
2024-12-10 17:25:15,110,9013,56,54,5786.70,12014.01,0.00
2024-12-10 17:25:15,109,9013,56,53,5834.30,12014.05,0.00
2024-12-10 17:25:15,108,9013,56,52,5887.37,12014.05,0.00
2024-12-10 17:25:15,108,9014,56,52,5862.64,12015.00,0.00
2024-12-10 17:25:15,109,9014,56,53,5808.85,12015.01,0.00
2024-12-10 17:25:15,109,9015,56,53,5781.62,12016.00,0.00
2024-12-10 17:25:15,110,9015,56,54,5729.06,12016.01,0.00
2024-12-10 17:25:15,110,9016,56,54,5704.32,12017.00,0.00
2024-12-10 17:25:15,111,9016,56,55,5652.93,12017.01,0.00
2024-12-10 17:25:15,110,9016,56,54,5698.87,12017.05,0.00
2024-12-10 17:25:15,110,9017,56,54,5681.46,12018.00,0.00
2024-12-10 17:25:15,111,9017,57,54,5630.28,12018.01,0.00
2024-12-10 17:25:15,110,9017,56,54,5675.36,12018.05,0.00
2024-12-10 17:25:15,110,9017,56,54,5657.24,12019.00,0.00
2024-12-10 17:25:15,111,9017,57,54,5606.28,12019.01,0.00
2024-12-10 17:25:15,110,9017,56,54,5649.74,12019.05,0.00
2024-12-10 17:25:16,110,9018,56,54,5631.12,12020.00,0.00
2024-12-10 17:25:16,111,9018,56,55,5580.39,12020.01,0.00
2024-12-10 17:25:16,111,9019,56,55,5550.30,12021.00,0.00
2024-12-10 17:25:16,112,9019,56,56,5500.74,12021.01,0.00
2024-12-10 17:25:16,111,9019,55,56,5544.90,12021.04,0.00
2024-12-10 17:25:16,111,9020,55,56,5514.82,12022.00,0.00
2024-12-10 17:25:16,112,9020,55,57,5465.58,12022.01,0.00
2024-12-10 17:25:16,111,9020,54,57,5509.42,12022.04,0.00
2024-12-10 17:25:16,111,9021,54,57,5464.66,12023.00,0.00
2024-12-10 17:25:16,112,9021,55,57,5415.86,12023.01,0.00
2024-12-10 17:25:16,111,9021,55,56,5459.25,12023.04,0.00
2024-12-10 17:25:16,111,9022,55,56,5391.99,12024.00,0.00
2024-12-10 17:25:16,112,9022,55,57,5343.85,12024.01,0.00
2024-12-10 17:25:16,111,9022,54,57,5385.69,12024.04,0.00
2024-12-10 17:25:16,111,9023,54,57,5300.53,12025.00,0.00
2024-12-10 17:25:16,112,9023,54,58,5253.20,12025.01,0.00
2024-12-10 17:25:16,111,9023,54,57,5295.06,12025.04,0.00
2024-12-10 17:25:16,110,9023,54,56,5296.08,12025.44,0.00
2024-12-10 17:25:16,110,9024,54,56,5253.99,12026.00,0.00
2024-12-10 17:25:16,111,9024,54,57,5206.66,12026.01,0.00
2024-12-10 17:25:16,110,9024,54,56,5248.54,12026.05,0.00
2024-12-10 17:25:16,110,9025,54,56,5148.37,12027.00,0.00
2024-12-10 17:25:16,111,9025,54,57,5101.99,12027.01,0.00
2024-12-10 17:25:16,110,9025,53,57,5147.28,12027.01,0.00
2024-12-10 17:25:16,109,9025,52,57,5190.10,12027.04,0.00
2024-12-10 17:25:16,108,9025,52,56,5237.04,12027.04,0.00
2024-12-10 17:25:16,109,9024,52,57,5085.23,12027.85,0.00
2024-12-10 17:25:16,109,9025,52,57,5150.96,12028.00,0.00
2024-12-10 17:25:16,110,9025,53,57,5104.13,12028.01,0.00
2024-12-10 17:25:16,109,9025,53,56,5146.56,12028.04,0.00
2024-12-10 17:25:16,110,9024,54,56,4992.40,12028.87,0.00
2024-12-10 17:25:16,110,9025,54,56,5239.38,12029.00,0.00
2024-12-10 17:25:16,111,9025,54,57,5192.18,12029.01,0.00
2024-12-10 17:25:16,110,9025,54,56,5235.02,12029.04,0.00
2024-12-10 17:25:16,110,9026,54,56,5262.92,12030.00,0.00
2024-12-10 17:25:16,111,9026,55,56,5215.50,12030.01,0.00
2024-12-10 17:25:16,110,9026,55,55,5258.55,12030.04,0.00
2024-12-10 17:25:16,109,9026,55,54,5159.28,12030.91,0.00
2024-12-10 17:25:16,109,9027,55,54,5229.20,12031.00,0.00
2024-12-10 17:25:16,110,9027,56,54,5181.66,12031.01,0.00
2024-12-10 17:25:16,109,9027,55,54,5224.80,12031.04,0.00
2024-12-10 17:25:16,108,9027,55,53,5127.25,12031.91,0.00
2024-12-10 17:25:16,108,9028,55,53,5198.77,12032.00,0.00
2024-12-10 17:25:16,109,9028,56,53,5151.07,12032.01,0.00
2024-12-10 17:25:16,108,9028,55,53,5194.32,12032.04,0.00
2024-12-10 17:25:16,108,9029,55,53,5125.17,12033.00,0.00
2024-12-10 17:25:16,109,9029,56,53,5078.15,12033.01,0.00
2024-12-10 17:25:16,108,9029,56,52,5120.72,12033.04,0.00
2024-12-10 17:25:16,109,9028,57,52,4997.50,12033.67,0.00
2024-12-10 17:25:16,109,9029,57,52,5085.43,12034.00,0.00
2024-12-10 17:25:16,110,9029,58,52,5039.20,12034.01,0.00
2024-12-10 17:25:16,109,9029,57,52,5081.02,12034.04,0.00
2024-12-10 17:25:16,108,9029,57,51,5110.10,12034.19,0.00
2024-12-10 17:25:16,108,9030,57,51,5177.61,12035.00,0.00
2024-12-10 17:25:16,109,9030,57,52,5130.11,12035.01,0.00
2024-12-10 17:25:16,109,9031,57,52,5060.08,12036.00,0.00
2024-12-10 17:25:16,110,9031,57,53,5014.08,12036.01,0.00
2024-12-10 17:25:16,109,9031,57,52,5051.59,12036.02,0.00
2024-12-10 17:25:16,108,9031,57,51,5095.03,12036.04,0.00
2024-12-10 17:25:16,107,9031,57,50,5074.62,12036.58,0.00
2024-12-10 17:25:16,106,9031,56,50,5115.21,12036.61,0.00
2024-12-10 17:25:16,106,9032,56,50,5117.06,12037.00,0.00
2024-12-10 17:25:16,107,9032,56,51,5069.24,12037.01,0.00
2024-12-10 17:25:16,106,9032,56,50,5112.53,12037.04,0.00
2024-12-10 17:25:16,107,9031,57,50,4954.97,12037.79,0.00
2024-12-10 17:25:16,106,9031,57,49,5078.11,12037.84,0.00
2024-12-10 17:25:16,106,9032,57,49,5113.82,12038.00,0.00
2024-12-10 17:25:16,107,9032,57,50,5066.03,12038.01,0.00
2024-12-10 17:25:16,106,9032,56,50,5109.29,12038.04,0.00
2024-12-10 17:25:16,106,9033,56,50,5109.85,12039.00,0.00
2024-12-10 17:25:16,107,9033,56,51,5062.09,12039.01,0.00
2024-12-10 17:25:16,106,9033,55,51,5105.31,12039.04,0.00
2024-12-10 17:25:16,107,9032,55,52,4990.27,12039.62,0.00
2024-12-10 17:25:16,107,9033,55,52,5027.06,12040.00,0.00
2024-12-10 17:25:16,108,9033,55,53,4980.51,12040.01,0.00
2024-12-10 17:25:16,107,9033,54,53,5022.57,12040.04,0.00
2024-12-10 17:25:16,107,9034,54,53,4969.65,12041.00,0.00
2024-12-10 17:25:16,108,9034,54,54,4923.63,12041.01,0.00
2024-12-10 17:25:16,107,9034,54,53,4965.15,12041.04,0.00
2024-12-10 17:25:16,106,9034,53,53,4915.66,12041.65,0.00
2024-12-10 17:25:16,105,9034,53,52,4944.91,12041.66,0.00
2024-12-10 17:25:16,105,9035,53,52,4887.21,12042.00,0.00
2024-12-10 17:25:16,106,9035,53,53,4841.11,12042.01,0.00
2024-12-10 17:25:16,105,9035,53,52,4882.64,12042.04,0.00
2024-12-10 17:25:16,105,9036,53,52,4751.02,12043.00,0.00
2024-12-10 17:25:16,106,9036,53,53,4706.19,12043.01,0.00
2024-12-10 17:25:16,105,9036,53,52,4746.44,12043.04,0.00
2024-12-10 17:25:16,104,9036,53,51,4712.18,12043.61,0.00
2024-12-10 17:25:16,104,9037,53,51,4692.56,12044.00,0.00
2024-12-10 17:25:16,105,9037,53,52,4647.87,12044.01,0.00
2024-12-10 17:25:17,104,9037,52,52,4687.94,12044.04,0.00
2024-12-10 17:25:17,103,9037,51,52,4641.50,12044.70,0.00
2024-12-10 17:25:17,103,9038,51,52,4675.70,12045.00,0.00
2024-12-10 17:25:17,104,9038,52,52,4630.74,12045.01,0.00
2024-12-10 17:25:17,103,9038,52,51,4671.03,12045.04,0.00
2024-12-10 17:25:17,103,9039,52,51,4614.52,12046.00,0.00
2024-12-10 17:25:17,104,9039,53,51,4570.15,12046.01,0.00
2024-12-10 17:25:17,103,9039,52,51,4609.85,12046.04,0.00
2024-12-10 17:25:17,102,9039,51,51,4545.08,12046.80,0.00
2024-12-10 17:25:17,101,9039,51,50,4571.18,12046.89,0.00
2024-12-10 17:25:17,101,9040,51,50,4656.45,12047.00,0.00
2024-12-10 17:25:17,102,9040,52,50,4610.80,12047.01,0.00
2024-12-10 17:25:17,101,9040,52,49,4651.69,12047.04,0.00
2024-12-10 17:25:17,101,9041,52,49,4618.03,12048.00,0.00
2024-12-10 17:25:17,102,9041,52,50,4572.76,12048.01,0.00
2024-12-10 17:25:17,101,9041,51,50,4613.27,12048.04,0.00
2024-12-10 17:25:17,100,9041,51,49,4519.73,12048.92,0.00
2024-12-10 17:25:17,100,9042,51,49,4630.65,12049.00,0.00
2024-12-10 17:25:17,101,9042,51,50,4584.80,12049.01,0.00
2024-12-10 17:25:17,101,9043,51,50,4553.37,12050.00,0.00
2024-12-10 17:25:17,102,9043,51,51,4508.72,12050.01,0.00
2024-12-10 17:25:17,101,9043,50,51,4552.17,12050.01,0.00
2024-12-10 17:25:17,100,9043,49,51,4592.88,12050.04,0.00
2024-12-10 17:25:17,100,9044,49,51,4563.32,12051.00,0.00
2024-12-10 17:25:17,101,9044,50,51,4518.14,12051.01,0.00
2024-12-10 17:25:17,100,9044,50,50,4558.51,12051.04,0.00
2024-12-10 17:25:17,99,9044,49,50,4522.63,12051.64,0.00
2024-12-10 17:25:17,99,9045,49,50,4582.60,12052.00,0.00
2024-12-10 17:25:17,100,9045,49,51,4536.77,12052.01,0.00
2024-12-10 17:25:17,99,9045,48,51,4577.74,12052.04,0.00
2024-12-10 17:25:17,99,9046,48,51,4560.09,12053.00,0.00
2024-12-10 17:25:17,100,9046,49,51,4514.49,12053.01,0.00
2024-12-10 17:25:17,99,9046,49,50,4555.23,12053.04,0.00
2024-12-10 17:25:17,100,9045,50,50,4395.24,12053.85,0.00
2024-12-10 17:25:17,100,9046,50,50,4568.16,12054.00,0.00
2024-12-10 17:25:17,101,9046,50,51,4522.93,12054.01,0.00
2024-12-10 17:25:17,100,9046,50,50,4563.34,12054.04,0.00
2024-12-10 17:25:17,99,9046,49,50,4530.05,12054.60,0.00
2024-12-10 17:25:17,98,9046,48,50,4563.52,12054.66,0.00
2024-12-10 17:25:17,98,9047,48,50,4747.63,12055.00,0.00
2024-12-10 17:25:17,99,9047,48,51,4699.68,12055.01,0.00
2024-12-10 17:25:17,98,9047,48,50,4742.72,12055.04,0.00
2024-12-10 17:25:17,98,9048,48,50,4713.41,12056.00,0.00
2024-12-10 17:25:17,99,9048,48,51,4665.80,12056.01,0.00
2024-12-10 17:25:17,98,9048,48,50,4708.49,12056.04,0.00
2024-12-10 17:25:17,99,9047,49,50,4575.73,12056.66,0.00
2024-12-10 17:25:17,99,9048,49,50,4747.77,12057.00,0.00
2024-12-10 17:25:17,100,9048,49,51,4700.29,12057.01,0.00
2024-12-10 17:25:17,99,9048,48,51,4742.90,12057.04,0.00
2024-12-10 17:25:17,98,9048,48,50,4738.25,12057.47,0.00
2024-12-10 17:25:17,98,9049,48,50,4895.14,12058.00,0.00
2024-12-10 17:25:17,99,9049,48,51,4845.69,12058.01,0.00
2024-12-10 17:25:17,98,9049,48,50,4890.22,12058.04,0.00
2024-12-10 17:25:17,98,9050,48,50,4867.76,12059.00,0.00
2024-12-10 17:25:17,99,9050,48,51,4818.59,12059.01,0.00
2024-12-10 17:25:17,98,9050,47,51,4862.84,12059.04,0.00
2024-12-10 17:25:17,97,9050,47,50,4823.24,12059.67,0.00
2024-12-10 17:25:17,97,9051,47,50,4887.67,12060.00,0.00
2024-12-10 17:25:17,98,9051,48,50,4837.80,12060.01,0.00
2024-12-10 17:25:17,97,9051,48,49,4882.71,12060.04,0.00
2024-12-10 17:25:17,97,9052,48,49,4846.02,12061.00,0.00
2024-12-10 17:25:17,98,9052,49,49,4796.57,12061.01,0.00
2024-12-10 17:25:17,97,9052,48,49,4841.05,12061.04,0.00
2024-12-10 17:25:17,96,9052,47,49,4822.02,12061.45,0.00
2024-12-10 17:25:17,96,9053,47,49,4845.49,12062.00,0.00
2024-12-10 17:25:17,97,9053,48,49,4795.54,12062.01,0.00
2024-12-10 17:25:17,96,9053,48,48,4840.47,12062.04,0.00
2024-12-10 17:25:17,95,9053,48,47,4818.86,12062.50,0.00
2024-12-10 17:25:17,95,9054,48,47,4845.92,12063.00,0.00
2024-12-10 17:25:17,96,9054,48,48,4795.45,12063.01,0.00
2024-12-10 17:25:17,95,9054,47,48,4840.85,12063.04,0.00
2024-12-10 17:25:17,94,9054,46,48,4844.62,12063.37,0.00
2024-12-10 17:25:17,93,9054,46,47,4869.03,12063.59,0.00
2024-12-10 17:25:17,92,9054,45,47,4914.54,12063.63,0.00
2024-12-10 17:25:17,92,9055,45,47,4971.14,12064.00,0.00
2024-12-10 17:25:17,93,9055,46,47,4917.69,12064.01,0.00
2024-12-10 17:25:17,92,9055,45,47,4965.90,12064.04,0.00
2024-12-10 17:25:17,92,9056,45,47,4954.00,12065.00,0.00
2024-12-10 17:25:17,93,9056,45,48,4900.73,12065.01,0.00
2024-12-10 17:25:17,92,9056,45,47,4948.76,12065.04,0.00
2024-12-10 17:25:17,91,9056,44,47,4883.46,12065.87,0.00
2024-12-10 17:25:17,91,9057,44,47,5000.25,12066.00,0.00
2024-12-10 17:25:17,92,9057,44,48,4945.90,12066.01,0.00
2024-12-10 17:25:17,91,9057,43,48,4994.96,12066.04,0.00
2024-12-10 17:25:17,92,9056,44,48,4881.23,12066.54,0.00
2024-12-10 17:25:17,92,9057,44,48,5068.63,12067.00,0.00
2024-12-10 17:25:17,93,9057,44,49,5014.13,12067.01,0.00
2024-12-10 17:25:17,92,9057,44,48,5066.01,12067.02,0.00
2024-12-10 17:25:17,92,9058,44,48,5200.40,12068.00,0.00
2024-12-10 17:25:17,93,9058,45,48,5144.48,12068.01,0.00
2024-12-10 17:25:17,92,9058,45,47,5196.47,12068.03,0.00
2024-12-10 17:25:17,92,9059,45,47,5197.21,12069.00,0.00
2024-12-10 17:25:17,93,9059,46,47,5141.33,12069.01,0.00
2024-12-10 17:25:17,92,9059,45,47,5193.28,12069.03,0.00
2024-12-10 17:25:18,92,9060,45,47,5184.01,12070.00,0.00
2024-12-10 17:25:18,93,9060,46,47,5128.27,12070.01,0.00
2024-12-10 17:25:18,92,9060,45,47,5180.08,12070.03,0.00
2024-12-10 17:25:18,91,9060,45,46,5205.02,12070.27,0.00
2024-12-10 17:25:18,92,9059,46,46,5110.25,12070.49,0.00
2024-12-10 17:25:18,92,9060,46,46,5167.75,12071.00,0.00
2024-12-10 17:25:18,93,9060,46,47,5112.18,12071.01,0.00
2024-12-10 17:25:18,92,9060,45,47,5163.82,12071.03,0.00
2024-12-10 17:25:18,91,9060,45,46,5165.17,12071.44,0.00
2024-12-10 17:25:18,91,9061,45,46,5315.55,12072.00,0.00
2024-12-10 17:25:18,92,9061,45,47,5257.77,12072.01,0.00
2024-12-10 17:25:18,91,9061,44,47,5311.58,12072.03,0.00
2024-12-10 17:25:18,90,9061,44,46,5293.62,12072.48,0.00
2024-12-10 17:25:18,90,9062,44,46,5347.84,12073.00,0.00
2024-12-10 17:25:18,91,9062,44,47,5289.07,12073.01,0.00
2024-12-10 17:25:18,90,9062,43,47,5343.82,12073.03,0.00
2024-12-10 17:25:18,89,9062,43,46,5356.64,12073.40,0.00
2024-12-10 17:25:18,88,9062,42,46,5367.11,12073.57,0.00
2024-12-10 17:25:18,88,9063,42,46,5449.64,12074.00,0.00
2024-12-10 17:25:18,89,9063,42,47,5388.41,12074.01,0.00
2024-12-10 17:25:18,88,9063,41,47,5445.53,12074.03,0.00
2024-12-10 17:25:18,88,9064,41,47,5431.61,12075.00,0.00
2024-12-10 17:25:18,89,9064,42,47,5370.58,12075.01,0.00
2024-12-10 17:25:18,88,9064,41,47,5427.50,12075.03,0.00
2024-12-10 17:25:18,89,9063,42,47,5343.47,12075.25,0.00
2024-12-10 17:25:18,89,9064,42,47,5479.07,12076.00,0.00
2024-12-10 17:25:18,90,9064,42,48,5418.19,12076.01,0.00
2024-12-10 17:25:18,89,9064,41,48,5475.00,12076.03,0.00
2024-12-10 17:25:18,88,9064,40,48,5482.38,12076.39,0.00
2024-12-10 17:25:18,88,9065,40,48,5637.14,12077.00,0.00
2024-12-10 17:25:18,89,9065,40,49,5573.80,12077.01,0.00
2024-12-10 17:25:18,88,9065,39,49,5633.02,12077.03,0.00
2024-12-10 17:25:18,87,9065,39,48,5694.82,12077.06,0.00
2024-12-10 17:25:18,86,9065,38,48,5727.27,12077.23,0.00
2024-12-10 17:25:18,85,9065,38,47,5776.53,12077.38,0.00
2024-12-10 17:25:18,85,9066,38,47,5815.99,12078.00,0.00
2024-12-10 17:25:18,86,9066,38,48,5748.36,12078.01,0.00
2024-12-10 17:25:18,85,9066,37,48,5811.73,12078.04,0.00
2024-12-10 17:25:18,84,9066,36,48,5821.12,12078.40,0.00
2024-12-10 17:25:18,84,9067,36,48,5869.49,12079.00,0.00
2024-12-10 17:25:18,85,9067,37,48,5800.43,12079.01,0.00
2024-12-10 17:25:18,84,9067,36,48,5865.18,12079.04,0.00
2024-12-10 17:25:18,83,9067,35,48,5874.81,12079.40,0.00
2024-12-10 17:25:18,83,9068,35,48,5925.94,12080.00,0.00
2024-12-10 17:25:18,84,9068,36,48,5855.39,12080.01,0.00
2024-12-10 17:25:18,83,9068,36,47,5921.57,12080.04,0.00
2024-12-10 17:25:18,82,9068,35,47,5952.70,12080.24,0.00
2024-12-10 17:25:18,81,9068,34,47,6007.27,12080.40,0.00
2024-12-10 17:25:18,80,9068,33,47,6031.63,12080.67,0.00
2024-12-10 17:25:18,80,9069,33,47,6143.65,12081.00,0.00
2024-12-10 17:25:18,81,9069,34,47,6067.80,12081.01,0.00
2024-12-10 17:25:18,80,9069,34,46,6139.12,12081.04,0.00
2024-12-10 17:25:18,79,9069,33,46,6173.12,12081.25,0.00
2024-12-10 17:25:18,79,9070,33,46,6225.04,12082.00,0.00
2024-12-10 17:25:18,80,9070,34,46,6147.23,12082.01,0.00
2024-12-10 17:25:18,79,9070,34,45,6220.46,12082.04,0.00
2024-12-10 17:25:18,79,9071,34,45,6221.12,12083.00,0.00
2024-12-10 17:25:18,80,9071,35,45,6143.36,12083.01,0.00
2024-12-10 17:25:18,79,9071,35,44,6165.26,12083.32,0.00
2024-12-10 17:25:18,79,9072,35,44,6209.66,12084.00,0.00
2024-12-10 17:25:18,80,9072,36,44,6132.03,12084.01,0.00
2024-12-10 17:25:18,79,9072,36,43,6203.54,12084.05,0.00
2024-12-10 17:25:18,78,9072,36,42,6254.66,12084.14,0.00
2024-12-10 17:25:18,77,9072,36,41,6323.79,12084.23,0.00
2024-12-10 17:25:18,77,9073,36,41,6355.77,12085.00,0.00
2024-12-10 17:25:18,78,9073,37,41,6274.29,12085.01,0.00
2024-12-10 17:25:18,77,9073,37,40,6352.63,12085.03,0.00
2024-12-10 17:25:18,76,9073,37,39,6433.04,12085.04,0.00
2024-12-10 17:25:18,75,9073,37,38,6517.20,12085.04,0.00
2024-12-10 17:25:18,74,9073,36,38,6553.03,12085.43,0.00
2024-12-10 17:25:18,74,9074,36,38,6648.20,12086.00,0.00
2024-12-10 17:25:18,75,9074,37,38,6559.56,12086.01,0.00
2024-12-10 17:25:18,74,9074,37,37,6643.30,12086.04,0.00
2024-12-10 17:25:18,73,9074,36,37,6727.66,12086.10,0.00
2024-12-10 17:25:18,72,9074,35,37,6801.61,12086.25,0.00
2024-12-10 17:25:18,72,9075,35,37,6879.36,12087.00,0.00
2024-12-10 17:25:18,73,9075,35,38,6785.13,12087.01,0.00
2024-12-10 17:25:18,72,9075,34,38,6874.33,12087.04,0.00
2024-12-10 17:25:18,71,9075,34,37,6962.06,12087.11,0.00
2024-12-10 17:25:18,70,9075,33,37,7053.43,12087.17,0.00
2024-12-10 17:25:18,69,9075,33,36,7146.25,12087.20,0.00
2024-12-10 17:25:18,69,9076,33,36,7225.19,12088.00,0.00
2024-12-10 17:25:18,70,9076,33,37,7121.98,12088.01,0.00
2024-12-10 17:25:18,69,9076,32,37,7219.94,12088.04,0.00
2024-12-10 17:25:18,68,9076,32,36,7300.88,12088.16,0.00
2024-12-10 17:25:18,68,9077,32,36,7376.46,12089.00,0.00
2024-12-10 17:25:18,69,9077,33,36,7269.55,12089.01,0.00
2024-12-10 17:25:18,68,9077,33,35,7371.13,12089.04,0.00
2024-12-10 17:25:18,67,9077,33,34,7462.27,12089.19,0.00
2024-12-10 17:25:18,67,9078,33,34,7543.66,12090.00,0.00
2024-12-10 17:25:18,68,9078,33,35,7432.73,12090.01,0.00
2024-12-10 17:25:18,67,9078,32,35,7538.25,12090.04,0.00
2024-12-10 17:25:18,67,9079,32,35,7600.89,12091.00,0.00
2024-12-10 17:25:18,68,9079,32,36,7489.11,12091.01,0.00
2024-12-10 17:25:18,68,9080,32,36,7544.50,12092.00,0.00
2024-12-10 17:25:18,69,9080,33,36,7435.16,12092.01,0.00
2024-12-10 17:25:18,68,9080,32,36,7525.35,12092.16,0.00
2024-12-10 17:25:18,68,9081,32,36,7599.12,12093.00,0.00
2024-12-10 17:25:18,69,9081,33,36,7488.99,12093.01,0.00
2024-12-10 17:25:18,68,9081,32,36,7585.12,12093.12,0.00
2024-12-10 17:25:18,68,9082,32,36,7653.54,12094.00,0.00
2024-12-10 17:25:18,69,9082,33,36,7542.62,12094.01,0.00
2024-12-10 17:25:18,69,9083,33,36,7596.57,12095.00,0.00
2024-12-10 17:25:18,70,9083,33,37,7488.04,12095.01,0.00
2024-12-10 17:25:18,69,9083,32,37,7593.06,12095.03,0.00
2024-12-10 17:25:18,68,9083,32,36,7702.95,12095.03,0.00
2024-12-10 17:25:18,68,9084,32,36,7761.85,12096.00,0.00
2024-12-10 17:25:18,69,9084,33,36,7649.36,12096.01,0.00
2024-12-10 17:25:19,69,9085,33,36,7704.65,12097.00,0.00
2024-12-10 17:25:19,70,9085,34,36,7594.59,12097.01,0.00
2024-12-10 17:25:19,69,9085,33,36,7696.22,12097.07,0.00
2024-12-10 17:25:19,69,9086,33,36,7759.80,12098.00,0.00
2024-12-10 17:25:19,70,9086,33,37,7648.94,12098.01,0.00
2024-12-10 17:25:19,70,9087,33,37,7703.16,12099.00,0.00
2024-12-10 17:25:19,71,9087,34,37,7594.66,12099.01,0.00
2024-12-10 17:25:19,71,9088,34,37,7646.42,12100.00,0.00
2024-12-10 17:25:19,72,9088,34,38,7540.22,12100.01,0.00
2024-12-10 17:25:19,71,9088,33,38,7644.71,12100.01,0.00
2024-12-10 17:25:19,72,9087,33,39,7538.54,12100.04,0.00
2024-12-10 17:25:19,71,9087,32,39,7755.50,12100.04,0.00
2024-12-10 17:25:19,71,9088,32,39,7810.67,12101.00,0.00
2024-12-10 17:25:19,72,9088,33,39,7702.19,12101.01,0.00
2024-12-10 17:25:19,73,9087,34,39,7553.74,12101.40,0.00
2024-12-10 17:25:19,73,9088,34,39,7877.99,12102.00,0.00
2024-12-10 17:25:19,74,9088,35,39,7771.53,12102.01,0.00
2024-12-10 17:25:19,74,9089,35,39,7974.17,12103.00,0.00
2024-12-10 17:25:19,75,9089,36,39,7867.84,12103.01,0.00
2024-12-10 17:25:19,75,9090,36,39,7897.11,12104.00,0.00
2024-12-10 17:25:19,76,9090,37,39,7793.20,12104.01,0.00
2024-12-10 17:25:19,75,9090,37,38,7894.80,12104.03,0.00
2024-12-10 17:25:19,75,9091,37,38,7907.13,12105.00,0.00
2024-12-10 17:25:19,76,9091,37,39,7803.09,12105.01,0.00
2024-12-10 17:25:19,76,9092,37,39,7789.35,12106.00,0.00
2024-12-10 17:25:19,77,9092,37,40,7688.19,12106.01,0.00
2024-12-10 17:25:19,77,9093,37,40,7650.85,12107.00,0.00
2024-12-10 17:25:19,78,9093,38,40,7552.77,12107.01,0.00
2024-12-10 17:25:19,77,9093,38,39,7589.98,12107.31,0.00
2024-12-10 17:25:19,77,9094,38,39,7606.41,12108.00,0.00
2024-12-10 17:25:19,78,9094,38,40,7508.89,12108.01,0.00
2024-12-10 17:25:19,78,9095,38,40,7478.95,12109.00,0.00
2024-12-10 17:25:19,79,9095,39,40,7384.28,12109.01,0.00
2024-12-10 17:25:19,79,9096,39,40,7354.36,12110.00,0.00
2024-12-10 17:25:19,80,9096,39,41,7262.43,12110.01,0.00
2024-12-10 17:25:19,79,9096,38,41,7306.13,12110.32,0.00
2024-12-10 17:25:19,78,9096,38,40,7384.93,12110.37,0.00
2024-12-10 17:25:19,77,9096,37,40,7455.74,12110.53,0.00
2024-12-10 17:25:19,77,9097,37,40,7556.78,12111.00,0.00
2024-12-10 17:25:19,78,9097,38,40,7459.90,12111.01,0.00
2024-12-10 17:25:19,77,9097,37,40,7552.31,12111.04,0.00
2024-12-10 17:25:19,77,9098,37,40,7578.59,12112.00,0.00
2024-12-10 17:25:19,78,9098,38,40,7481.43,12112.01,0.00
2024-12-10 17:25:19,78,9099,38,40,7496.95,12113.00,0.00
2024-12-10 17:25:19,79,9099,39,40,7402.05,12113.01,0.00
2024-12-10 17:25:19,79,9099,39,40,7404.45,12114.00,0.00
2024-12-10 17:25:19,80,9099,40,40,7311.89,12114.01,0.00
2024-12-10 17:25:19,80,9100,40,40,7292.94,12115.00,0.00
2024-12-10 17:25:19,81,9100,40,41,7202.90,12115.01,0.00
2024-12-10 17:25:19,81,9101,40,41,7171.10,12116.00,0.00
2024-12-10 17:25:19,82,9101,40,42,7083.64,12116.01,0.00
2024-12-10 17:25:19,81,9101,39,42,7120.42,12116.31,0.00
2024-12-10 17:25:19,81,9102,39,42,7140.63,12117.00,0.00
2024-12-10 17:25:19,82,9102,39,43,7053.55,12117.01,0.00
2024-12-10 17:25:19,82,9103,39,43,7034.24,12118.00,0.00
2024-12-10 17:25:19,83,9103,40,43,6949.49,12118.01,0.00
2024-12-10 17:25:19,83,9104,40,43,6938.01,12119.00,0.00
2024-12-10 17:25:19,84,9104,41,43,6855.41,12119.01,0.00
2024-12-10 17:25:19,84,9105,41,43,6855.28,12120.00,0.00
2024-12-10 17:25:19,85,9105,42,43,6774.63,12120.01,0.00
2024-12-10 17:25:19,85,9106,42,43,6778.84,12121.00,0.00
2024-12-10 17:25:19,86,9106,43,43,6700.02,12121.01,0.00
2024-12-10 17:25:19,86,9107,43,43,6704.00,12122.00,0.00
2024-12-10 17:25:19,87,9107,44,43,6626.94,12122.01,0.00
2024-12-10 17:25:19,87,9108,44,43,6629.58,12123.00,0.00
2024-12-10 17:25:19,88,9108,45,43,6554.24,12123.01,0.00
2024-12-10 17:25:19,89,9107,45,44,6367.56,12123.84,0.00
2024-12-10 17:25:19,89,9108,45,44,6515.49,12124.00,0.00
2024-12-10 17:25:19,90,9108,46,44,6443.09,12124.01,0.00
2024-12-10 17:25:19,91,9107,47,44,6336.40,12124.33,0.00
2024-12-10 17:25:19,91,9108,47,44,6626.04,12125.00,0.00
2024-12-10 17:25:19,92,9108,48,44,6554.02,12125.01,0.00
2024-12-10 17:25:20,92,9109,48,44,6684.47,12126.00,0.00
2024-12-10 17:25:20,93,9109,48,45,6612.59,12126.01,0.00
2024-12-10 17:25:20,94,9108,48,46,6507.49,12126.32,0.00
2024-12-10 17:25:20,94,9109,48,46,6551.61,12127.00,0.00
2024-12-10 17:25:20,95,9109,48,47,6482.65,12127.01,0.00
2024-12-10 17:25:20,95,9110,48,47,6594.49,12128.00,0.00
2024-12-10 17:25:20,96,9110,48,48,6525.79,12128.01,0.00
2024-12-10 17:25:20,97,9109,48,49,6407.36,12128.36,0.00
2024-12-10 17:25:20,97,9110,48,49,6549.86,12129.00,0.00
2024-12-10 17:25:20,98,9110,48,50,6483.03,12129.01,0.00
2024-12-10 17:25:20,98,9110,48,50,6578.60,12130.00,0.00
2024-12-10 17:25:20,99,9110,48,51,6512.15,12130.01,0.00
2024-12-10 17:25:20,100,9109,48,52,6322.66,12130.90,0.00
2024-12-10 17:25:20,100,9110,48,52,6425.92,12131.00,0.00
2024-12-10 17:25:20,101,9110,48,53,6362.30,12131.01,0.00
2024-12-10 17:25:20,102,9109,48,54,6162.39,12131.97,0.00
2024-12-10 17:25:20,102,9110,48,54,6402.51,12132.00,0.00
2024-12-10 17:25:20,103,9110,48,55,6340.35,12132.01,0.00
2024-12-10 17:25:20,104,9109,48,56,6154.73,12132.89,0.00
2024-12-10 17:25:20,104,9110,48,56,6380.26,12133.00,0.00
2024-12-10 17:25:20,105,9110,48,57,6319.50,12133.01,0.00
2024-12-10 17:25:20,105,9111,48,57,6408.41,12134.00,0.00
2024-12-10 17:25:20,106,9111,48,58,6347.95,12134.01,0.00
2024-12-10 17:25:20,106,9112,48,58,6321.28,12135.00,0.00
2024-12-10 17:25:20,107,9112,48,59,6262.20,12135.01,0.00
2024-12-10 17:25:20,107,9113,48,59,6234.51,12136.00,0.00
2024-12-10 17:25:20,108,9113,49,59,6176.79,12136.01,0.00
2024-12-10 17:25:20,108,9114,49,59,6145.33,12137.00,0.00
2024-12-10 17:25:20,109,9114,49,60,6088.95,12137.01,0.00
2024-12-10 17:25:20,108,9114,49,59,6141.97,12137.03,0.00
2024-12-10 17:25:20,108,9115,49,59,6105.36,12138.00,0.00
2024-12-10 17:25:20,109,9115,50,59,6049.35,12138.01,0.00
2024-12-10 17:25:20,108,9115,50,58,6101.99,12138.03,0.00
2024-12-10 17:25:20,108,9116,50,58,6053.64,12139.00,0.00
2024-12-10 17:25:20,109,9116,50,59,5998.10,12139.01,0.00
2024-12-10 17:25:20,108,9116,50,58,6050.27,12139.03,0.00
2024-12-10 17:25:20,109,9115,51,58,5958.98,12139.29,0.00
2024-12-10 17:25:20,109,9116,51,58,5955.81,12140.00,0.00
2024-12-10 17:25:20,110,9116,52,58,5901.66,12140.01,0.00
2024-12-10 17:25:20,109,9116,52,57,5952.47,12140.03,0.00
2024-12-10 17:25:20,109,9117,52,57,6002.06,12141.00,0.00
2024-12-10 17:25:20,110,9117,53,57,5947.50,12141.01,0.00
2024-12-10 17:25:20,109,9117,53,56,5998.73,12141.03,0.00
2024-12-10 17:25:20,109,9118,53,56,5931.44,12142.00,0.00
2024-12-10 17:25:20,110,9118,53,57,5877.52,12142.01,0.00
2024-12-10 17:25:20,109,9118,53,56,5926.64,12142.03,0.00
2024-12-10 17:25:20,109,9119,53,56,5864.07,12143.00,0.00
2024-12-10 17:25:20,110,9119,54,56,5810.76,12143.01,0.00
2024-12-10 17:25:20,109,9119,54,55,5857.80,12143.03,0.00
2024-12-10 17:25:20,109,9120,54,55,5794.61,12144.00,0.00
2024-12-10 17:25:20,110,9120,54,56,5741.93,12144.01,0.00
2024-12-10 17:25:20,109,9120,54,55,5788.19,12144.03,0.00
2024-12-10 17:25:20,110,9119,54,56,5722.33,12144.15,0.00
2024-12-10 17:25:20,110,9120,54,56,5761.76,12145.00,0.00
2024-12-10 17:25:20,111,9120,55,56,5709.86,12145.01,0.00
2024-12-10 17:25:20,110,9120,54,56,5738.55,12145.18,0.00
2024-12-10 17:25:20,110,9121,54,56,5795.90,12146.00,0.00
2024-12-10 17:25:20,111,9121,55,56,5743.69,12146.01,0.00
2024-12-10 17:25:20,110,9121,54,56,5792.59,12146.03,0.00
2024-12-10 17:25:20,110,9122,54,56,5742.89,12147.00,0.00
2024-12-10 17:25:20,111,9122,54,57,5691.15,12147.01,0.00
2024-12-10 17:25:20,110,9122,53,57,5739.58,12147.03,0.00
2024-12-10 17:25:20,111,9121,54,57,5667.11,12147.22,0.00
2024-12-10 17:25:20,110,9121,53,57,5701.92,12147.52,0.00
2024-12-10 17:25:20,110,9122,53,57,5731.69,12148.00,0.00
2024-12-10 17:25:20,111,9122,53,58,5680.06,12148.01,0.00
2024-12-10 17:25:20,110,9122,53,57,5727.52,12148.03,0.00
2024-12-10 17:25:20,109,9122,53,56,5719.73,12148.45,0.00
2024-12-10 17:25:20,110,9121,53,57,5629.64,12148.72,0.00
2024-12-10 17:25:20,110,9122,53,57,5823.19,12149.00,0.00
2024-12-10 17:25:20,111,9122,53,58,5770.73,12149.01,0.00
2024-12-10 17:25:20,110,9122,53,57,5819.88,12149.03,0.00
2024-12-10 17:25:20,110,9123,53,57,5889.57,12150.00,0.00
2024-12-10 17:25:20,111,9123,54,57,5836.51,12150.01,0.00
2024-12-10 17:25:20,110,9123,54,56,5886.26,12150.03,0.00
2024-12-10 17:25:20,109,9123,54,55,5868.43,12150.50,0.00
2024-12-10 17:25:20,109,9124,54,55,5899.76,12151.00,0.00
2024-12-10 17:25:20,110,9124,55,55,5846.13,12151.01,0.00
2024-12-10 17:25:20,109,9124,54,55,5896.42,12151.03,0.00
2024-12-10 17:25:20,110,9123,54,56,5731.21,12151.76,0.00
2024-12-10 17:25:20,110,9124,54,56,5823.81,12152.00,0.00
2024-12-10 17:25:20,111,9124,55,56,5771.34,12152.01,0.00
2024-12-10 17:25:20,110,9124,55,55,5818.28,12152.03,0.00
2024-12-10 17:25:20,111,9123,55,56,5638.67,12152.86,0.00
2024-12-10 17:25:21,111,9124,55,56,5876.51,12153.00,0.00
2024-12-10 17:25:21,112,9124,56,56,5824.04,12153.01,0.00
2024-12-10 17:25:21,111,9124,55,56,5873.23,12153.03,0.00
2024-12-10 17:25:21,112,9123,55,57,5723.07,12153.65,0.00
2024-12-10 17:25:21,113,9122,55,58,5674.11,12153.68,0.00
2024-12-10 17:25:21,112,9122,55,57,5752.76,12153.77,0.00
2024-12-10 17:25:21,112,9123,55,57,5924.20,12154.00,0.00
2024-12-10 17:25:21,113,9123,55,58,5871.78,12154.01,0.00
2024-12-10 17:25:21,112,9123,55,57,5920.95,12154.03,0.00
2024-12-10 17:25:21,111,9123,55,56,5875.04,12154.68,0.00
2024-12-10 17:25:21,110,9123,55,55,5914.66,12154.73,0.00
2024-12-10 17:25:21,110,9124,55,55,6193.40,12155.00,0.00
2024-12-10 17:25:21,111,9124,56,55,6137.60,12155.01,0.00
2024-12-10 17:25:21,110,9124,56,54,6190.08,12155.03,0.00
2024-12-10 17:25:21,111,9123,57,54,6099.73,12155.30,0.00
2024-12-10 17:25:21,110,9123,57,53,6195.51,12155.54,0.00
2024-12-10 17:25:21,110,9124,57,53,6220.61,12156.00,0.00
2024-12-10 17:25:21,111,9124,57,54,6164.57,12156.01,0.00
2024-12-10 17:25:21,110,9124,57,53,6217.30,12156.03,0.00
2024-12-10 17:25:21,111,9123,58,53,6066.72,12156.68,0.00
2024-12-10 17:25:21,111,9124,58,53,6251.90,12157.00,0.00
2024-12-10 17:25:21,112,9124,58,54,6196.08,12157.01,0.00
2024-12-10 17:25:21,111,9124,57,54,6249.79,12157.02,0.00
2024-12-10 17:25:21,110,9124,57,53,6305.50,12157.02,0.00
2024-12-10 17:25:21,110,9125,57,53,6352.35,12158.00,0.00
2024-12-10 17:25:21,111,9125,57,54,6295.13,12158.01,0.00
2024-12-10 17:25:21,111,9126,57,54,6232.96,12159.00,0.00
2024-12-10 17:25:21,112,9126,57,55,6177.31,12159.01,0.00
2024-12-10 17:25:21,112,9127,57,55,6122.80,12160.00,0.00
2024-12-10 17:25:21,113,9127,58,55,6068.62,12160.01,0.00
2024-12-10 17:25:21,113,9128,58,55,6008.78,12161.00,0.00
2024-12-10 17:25:21,114,9128,59,55,5956.07,12161.01,0.00
2024-12-10 17:25:21,113,9128,58,55,6005.56,12161.03,0.00
2024-12-10 17:25:21,114,9127,58,56,5945.41,12161.11,0.00
2024-12-10 17:25:21,115,9126,58,57,5957.12,12161.38,0.00
2024-12-10 17:25:21,114,9126,57,57,5989.45,12161.82,0.00
2024-12-10 17:25:21,114,9127,57,57,6062.68,12162.00,0.00
2024-12-10 17:25:21,115,9127,58,57,6009.96,12162.01,0.00
2024-12-10 17:25:21,115,9128,58,57,6149.24,12163.00,0.00
2024-12-10 17:25:21,116,9128,59,57,6096.22,12163.01,0.00
2024-12-10 17:25:21,115,9128,59,56,6146.07,12163.03,0.00
2024-12-10 17:25:21,116,9127,59,57,6052.59,12163.37,0.00
2024-12-10 17:25:21,116,9128,59,57,6077.10,12164.00,0.00
2024-12-10 17:25:21,117,9128,60,57,6025.15,12164.01,0.00
2024-12-10 17:25:21,116,9128,59,57,6073.96,12164.03,0.00
2024-12-10 17:25:21,115,9128,59,56,6062.28,12164.45,0.00
2024-12-10 17:25:21,115,9129,59,56,6138.41,12165.00,0.00
2024-12-10 17:25:21,116,9129,60,56,6085.49,12165.01,0.00
2024-12-10 17:25:21,115,9129,59,56,6074.85,12165.46,0.00
2024-12-10 17:25:21,116,9128,60,56,5952.52,12165.77,0.00
2024-12-10 17:25:21,116,9129,60,56,6047.49,12166.00,0.00
2024-12-10 17:25:21,117,9129,61,56,5995.80,12166.01,0.00
2024-12-10 17:25:21,116,9129,61,55,6044.35,12166.03,0.00
2024-12-10 17:25:21,115,9129,61,54,6004.04,12166.54,0.00
2024-12-10 17:25:21,115,9130,61,54,6084.78,12167.00,0.00
2024-12-10 17:25:21,116,9130,62,54,6032.33,12167.01,0.00
2024-12-10 17:25:21,115,9130,62,53,6081.61,12167.03,0.00
2024-12-10 17:25:21,114,9130,61,53,6103.54,12167.28,0.00
2024-12-10 17:25:21,114,9131,61,53,6029.59,12168.00,0.00
2024-12-10 17:25:21,115,9131,61,54,5977.16,12168.01,0.00
2024-12-10 17:25:21,114,9131,60,54,6026.40,12168.03,0.00
2024-12-10 17:25:21,115,9130,61,54,5971.88,12168.06,0.00
2024-12-10 17:25:21,116,9129,61,55,5906.79,12168.24,0.00
2024-12-10 17:25:21,116,9130,61,55,5904.01,12169.00,0.00
2024-12-10 17:25:21,117,9130,62,55,5853.55,12169.01,0.00
2024-12-10 17:25:21,116,9130,61,55,5900.87,12169.03,0.00
2024-12-10 17:25:21,115,9130,61,54,5793.65,12169.77,0.00
2024-12-10 17:25:21,115,9131,61,54,6054.21,12170.00,0.00
2024-12-10 17:25:21,116,9131,61,55,6002.02,12170.01,0.00
2024-12-10 17:25:21,115,9131,61,54,6053.38,12170.01,0.00
2024-12-10 17:25:21,114,9131,60,54,6104.35,12170.02,0.00
2024-12-10 17:25:21,113,9131,60,53,6116.90,12170.34,0.00
2024-12-10 17:25:21,112,9131,60,52,6066.26,12170.78,0.00
2024-12-10 17:25:21,112,9132,60,52,6129.41,12171.00,0.00
2024-12-10 17:25:21,113,9132,61,52,6075.17,12171.01,0.00
2024-12-10 17:25:21,112,9132,61,51,6124.50,12171.03,0.00
2024-12-10 17:25:21,112,9133,61,51,6054.49,12172.00,0.00
2024-12-10 17:25:21,113,9133,62,51,6000.91,12172.01,0.00
2024-12-10 17:25:21,112,9133,62,50,6047.88,12172.03,0.00
2024-12-10 17:25:21,111,9133,61,50,6045.02,12172.37,0.00
2024-12-10 17:25:21,112,9132,62,50,5981.46,12172.44,0.00
2024-12-10 17:25:21,111,9132,61,50,6130.48,12172.45,0.00
2024-12-10 17:25:21,110,9132,60,50,6186.16,12172.45,0.00
2024-12-10 17:25:21,110,9133,60,50,6183.80,12173.00,0.00
2024-12-10 17:25:21,111,9133,61,50,6128.09,12173.01,0.00
2024-12-10 17:25:21,110,9133,61,49,6176.12,12173.03,0.00
2024-12-10 17:25:21,109,9133,61,48,6179.45,12173.33,0.00
2024-12-10 17:25:21,109,9134,61,48,6276.58,12174.00,0.00
2024-12-10 17:25:21,110,9134,61,49,6219.52,12174.01,0.00
2024-12-10 17:25:21,109,9134,61,48,6268.42,12174.03,0.00
2024-12-10 17:25:21,108,9134,60,48,6283.71,12174.31,0.00
2024-12-10 17:25:21,107,9134,59,48,6324.05,12174.41,0.00
2024-12-10 17:25:21,106,9134,59,47,6325.04,12174.66,0.00
2024-12-10 17:25:21,105,9134,59,46,6376.95,12174.72,0.00
2024-12-10 17:25:21,105,9135,59,46,6455.38,12175.00,0.00
2024-12-10 17:25:21,106,9135,60,46,6394.48,12175.01,0.00
2024-12-10 17:25:21,105,9135,59,46,6446.70,12175.03,0.00
2024-12-10 17:25:21,106,9134,59,47,6323.53,12175.47,0.00
2024-12-10 17:25:21,106,9135,59,47,6379.84,12176.00,0.00
2024-12-10 17:25:21,107,9135,60,47,6320.22,12176.01,0.00
2024-12-10 17:25:21,108,9134,61,47,6261.70,12176.03,0.00
2024-12-10 17:25:21,107,9134,61,46,6348.31,12176.04,0.00
2024-12-10 17:25:21,106,9134,60,46,6330.14,12176.51,0.00
2024-12-10 17:25:21,105,9134,59,46,6344.20,12176.67,0.00
2024-12-10 17:25:22,105,9135,59,46,6525.56,12177.00,0.00
2024-12-10 17:25:22,106,9135,60,46,6464.00,12177.01,0.00
2024-12-10 17:25:22,107,9134,60,47,6402.46,12177.04,0.00
2024-12-10 17:25:22,106,9134,60,46,6491.01,12177.04,0.00
2024-12-10 17:25:22,106,9135,60,46,6567.03,12178.00,0.00
2024-12-10 17:25:22,107,9135,60,47,6505.66,12178.01,0.00
2024-12-10 17:25:22,106,9135,60,46,6557.85,12178.03,0.00
2024-12-10 17:25:22,107,9134,61,46,6486.33,12178.13,0.00
2024-12-10 17:25:22,108,9133,62,46,6475.06,12178.44,0.00
2024-12-10 17:25:22,109,9132,63,46,6345.88,12178.96,0.00
2024-12-10 17:25:22,109,9133,63,46,6564.80,12179.00,0.00
2024-12-10 17:25:22,110,9133,63,47,6505.12,12179.01,0.00
2024-12-10 17:25:22,109,9133,62,47,6555.17,12179.03,0.00
2024-12-10 17:25:22,109,9134,62,47,6832.33,12180.00,0.00
2024-12-10 17:25:22,110,9134,63,47,6770.21,12180.01,0.00
2024-12-10 17:25:22,109,9134,62,47,6821.75,12180.03,0.00
2024-12-10 17:25:22,109,9135,62,47,6762.34,12181.00,0.00
2024-12-10 17:25:22,110,9135,62,48,6700.86,12181.01,0.00
2024-12-10 17:25:22,109,9135,61,48,6750.64,12181.03,0.00
2024-12-10 17:25:22,110,9134,61,49,6636.00,12181.40,0.00
2024-12-10 17:25:22,110,9135,61,49,6632.67,12182.00,0.00
2024-12-10 17:25:22,111,9135,61,50,6572.92,12182.01,0.00
2024-12-10 17:25:22,110,9135,60,50,6619.61,12182.03,0.00
2024-12-10 17:25:22,109,9135,60,49,6651.77,12182.22,0.00
2024-12-10 17:25:22,109,9136,60,49,6721.85,12183.00,0.00
2024-12-10 17:25:22,110,9136,61,49,6660.74,12183.01,0.00
2024-12-10 17:25:22,109,9136,60,49,6707.08,12183.03,0.00
2024-12-10 17:25:22,108,9136,59,49,6728.83,12183.30,0.00
2024-12-10 17:25:22,108,9137,59,49,6703.08,12184.00,0.00
2024-12-10 17:25:22,109,9137,60,49,6641.58,12184.01,0.00
2024-12-10 17:25:22,108,9137,59,49,6686.61,12184.03,0.00
2024-12-10 17:25:22,108,9138,59,49,6612.36,12185.00,0.00
2024-12-10 17:25:22,109,9138,60,49,6551.69,12185.01,0.00
2024-12-10 17:25:22,108,9138,59,49,6594.34,12185.03,0.00
2024-12-10 17:25:22,109,9137,59,50,6492.95,12185.35,0.00
2024-12-10 17:25:22,109,9138,59,50,6495.77,12186.00,0.00
2024-12-10 17:25:22,110,9138,59,51,6436.72,12186.01,0.00
2024-12-10 17:25:22,109,9138,58,51,6478.22,12186.03,0.00
2024-12-10 17:25:22,109,9139,58,51,6515.95,12187.00,0.00
2024-12-10 17:25:22,110,9139,58,52,6456.72,12187.01,0.00
2024-12-10 17:25:22,109,9139,57,52,6508.62,12187.02,0.00
2024-12-10 17:25:22,108,9139,56,52,6533.53,12187.25,0.00
2024-12-10 17:25:22,107,9139,56,51,6537.93,12187.49,0.00
2024-12-10 17:25:22,108,9138,56,52,6399.66,12187.91,0.00
2024-12-10 17:25:22,108,9139,56,52,6508.22,12188.00,0.00
2024-12-10 17:25:22,109,9139,57,52,6448.51,12188.01,0.00
2024-12-10 17:25:22,109,9140,57,52,6471.71,12189.00,0.00
2024-12-10 17:25:22,110,9140,58,52,6412.87,12189.01,0.00
2024-12-10 17:25:22,111,9139,58,53,6351.83,12189.05,0.00
2024-12-10 17:25:22,110,9139,57,53,6506.24,12189.15,0.00
2024-12-10 17:25:22,109,9139,57,52,6526.42,12189.35,0.00
2024-12-10 17:25:22,108,9139,56,52,6517.16,12189.71,0.00
2024-12-10 17:25:22,108,9140,56,52,6576.69,12190.00,0.00
2024-12-10 17:25:22,109,9140,57,52,6516.36,12190.01,0.00
2024-12-10 17:25:22,110,9139,58,52,6368.02,12190.57,0.00
2024-12-10 17:25:22,110,9140,58,52,6569.47,12191.00,0.00
2024-12-10 17:25:22,111,9140,58,53,6510.29,12191.01,0.00
2024-12-10 17:25:22,110,9140,58,52,6562.86,12191.05,0.00
2024-12-10 17:25:22,109,9140,58,51,6616.07,12191.11,0.00
2024-12-10 17:25:22,108,9140,57,51,6671.87,12191.14,0.00
2024-12-10 17:25:22,107,9140,56,51,6690.98,12191.35,0.00
2024-12-10 17:25:22,106,9140,56,50,6709.35,12191.58,0.00
2024-12-10 17:25:22,106,9141,56,50,6856.76,12192.00,0.00
2024-12-10 17:25:22,107,9141,57,50,6792.67,12192.01,0.00
2024-12-10 17:25:22,106,9141,56,50,6849.89,12192.06,0.00
2024-12-10 17:25:22,105,9141,56,49,6870.65,12192.29,0.00
2024-12-10 17:25:22,104,9141,56,48,6894.91,12192.50,0.00
2024-12-10 17:25:22,104,9142,56,48,6913.66,12193.00,0.00
2024-12-10 17:25:22,105,9142,57,48,6847.82,12193.01,0.00
2024-12-10 17:25:22,104,9142,56,48,6906.67,12193.06,0.00
2024-12-10 17:25:22,103,9142,55,48,6965.72,12193.12,0.00
2024-12-10 17:25:22,103,9143,55,48,6907.13,12194.00,0.00
2024-12-10 17:25:22,104,9143,55,49,6840.72,12194.01,0.00
2024-12-10 17:25:22,103,9143,54,49,6900.07,12194.06,0.00
2024-12-10 17:25:22,102,9143,54,48,6945.57,12194.23,0.00
2024-12-10 17:25:22,101,9143,54,47,7012.92,12194.24,0.00
2024-12-10 17:25:22,102,9142,55,47,6832.78,12194.84,0.00
2024-12-10 17:25:22,102,9143,55,47,7007.04,12195.00,0.00
2024-12-10 17:25:22,103,9143,56,47,6939.01,12195.01,0.00
2024-12-10 17:25:22,102,9143,56,46,6999.90,12195.06,0.00
2024-12-10 17:25:22,102,9144,56,46,7050.47,12196.00,0.00
2024-12-10 17:25:22,103,9144,57,46,6982.02,12196.01,0.00
2024-12-10 17:25:22,102,9144,56,46,7009.13,12196.31,0.00
2024-12-10 17:25:22,102,9145,56,46,6973.21,12197.00,0.00
2024-12-10 17:25:22,103,9145,56,47,6905.50,12197.01,0.00
2024-12-10 17:25:22,102,9145,55,47,6966.07,12197.06,0.00
2024-12-10 17:25:22,103,9144,55,48,6840.31,12197.50,0.00
2024-12-10 17:25:22,103,9145,55,48,6883.58,12198.00,0.00
2024-12-10 17:25:22,104,9145,55,49,6817.39,12198.01,0.00
2024-12-10 17:25:22,103,9145,55,48,6774.50,12198.71,0.00
2024-12-10 17:25:22,103,9146,55,48,6947.51,12199.00,0.00
2024-12-10 17:25:22,104,9146,56,48,6880.70,12199.01,0.00
2024-12-10 17:25:22,103,9146,55,48,6940.44,12199.06,0.00
2024-12-10 17:25:22,102,9146,55,47,7006.98,12199.06,0.00
2024-12-10 17:25:22,101,9146,55,46,7052.48,12199.25,0.00
2024-12-10 17:25:22,101,9147,55,46,7041.18,12200.00,0.00
2024-12-10 17:25:22,102,9147,55,47,6972.14,12200.01,0.00
2024-12-10 17:25:23,102,9148,55,47,6929.88,12201.00,0.00
2024-12-10 17:25:23,103,9148,55,48,6862.60,12201.01,0.00
2024-12-10 17:25:23,103,9149,55,48,6824.29,12202.00,0.00
2024-12-10 17:25:23,104,9149,55,49,6758.67,12202.01,0.00
2024-12-10 17:25:23,104,9150,55,49,6717.39,12203.00,0.00
2024-12-10 17:25:23,105,9150,55,50,6653.42,12203.01,0.00
2024-12-10 17:25:23,104,9150,54,50,6708.88,12203.08,0.00
2024-12-10 17:25:23,103,9150,54,49,6706.67,12203.48,0.00
2024-12-10 17:25:23,102,9150,53,49,6736.65,12203.70,0.00
2024-12-10 17:25:23,102,9151,53,49,6808.49,12204.00,0.00
2024-12-10 17:25:23,103,9151,54,49,6742.39,12204.01,0.00
2024-12-10 17:25:23,103,9152,54,49,6703.64,12205.00,0.00
2024-12-10 17:25:23,104,9152,54,50,6639.19,12205.01,0.00
2024-12-10 17:25:23,103,9152,53,50,6596.93,12205.68,0.00
2024-12-10 17:25:23,103,9153,53,50,6665.91,12206.00,0.00
2024-12-10 17:25:23,104,9153,54,50,6601.82,12206.01,0.00
2024-12-10 17:25:23,104,9154,54,50,6572.85,12207.00,0.00
2024-12-10 17:25:23,105,9154,55,50,6510.25,12207.01,0.00
2024-12-10 17:25:23,104,9154,55,49,6463.53,12207.75,0.00
2024-12-10 17:25:23,103,9154,55,48,6522.54,12207.78,0.00
2024-12-10 17:25:23,103,9155,55,48,6600.89,12208.00,0.00
2024-12-10 17:25:23,104,9155,55,49,6537.42,12208.01,0.00
2024-12-10 17:25:23,103,9155,55,48,6583.34,12208.15,0.00
2024-12-10 17:25:23,103,9156,55,48,6585.28,12209.00,0.00
2024-12-10 17:25:23,104,9156,56,48,6521.96,12209.01,0.00
2024-12-10 17:25:23,103,9156,55,48,6577.01,12209.07,0.00
2024-12-10 17:25:23,102,9156,54,48,6640.46,12209.07,0.00
2024-12-10 17:25:23,101,9156,54,47,6666.79,12209.39,0.00
2024-12-10 17:25:23,101,9157,54,47,6709.90,12210.00,0.00
2024-12-10 17:25:23,102,9157,54,48,6644.11,12210.01,0.00
2024-12-10 17:25:23,102,9158,54,48,6635.06,12211.00,0.00
2024-12-10 17:25:23,103,9158,55,48,6570.64,12211.01,0.00
2024-12-10 17:25:23,103,9159,55,48,6565.89,12212.00,0.00
2024-12-10 17:25:23,104,9159,55,49,6502.75,12212.01,0.00
2024-12-10 17:25:23,103,9159,54,49,6557.98,12212.07,0.00
2024-12-10 17:25:23,102,9159,53,49,6618.21,12212.10,0.00
2024-12-10 17:25:23,101,9159,52,49,6664.62,12212.25,0.00
2024-12-10 17:25:23,100,9159,52,48,6717.13,12212.36,0.00
2024-12-10 17:25:23,100,9160,52,48,6751.18,12213.00,0.00
2024-12-10 17:25:23,101,9160,53,48,6684.33,12213.01,0.00
2024-12-10 17:25:23,100,9160,53,47,6731.21,12213.17,0.00
2024-12-10 17:25:23,100,9161,53,47,6729.27,12214.00,0.00
2024-12-10 17:25:23,101,9161,53,48,6662.64,12214.01,0.00
2024-12-10 17:25:23,100,9161,53,47,6715.03,12214.12,0.00
2024-12-10 17:25:23,99,9161,53,46,6771.00,12214.19,0.00
2024-12-10 17:25:23,99,9162,53,46,6781.81,12215.00,0.00
2024-12-10 17:25:23,100,9162,53,47,6713.99,12215.01,0.00
2024-12-10 17:25:23,101,9161,53,48,6543.76,12215.79,0.00
2024-12-10 17:25:23,101,9162,53,48,6721.56,12216.00,0.00
2024-12-10 17:25:23,102,9162,53,49,6655.66,12216.01,0.00
2024-12-10 17:25:23,101,9162,53,48,6713.43,12216.07,0.00
2024-12-10 17:25:23,100,9162,52,48,6689.22,12216.72,0.00
2024-12-10 17:25:23,100,9163,52,48,6888.48,12217.00,0.00
2024-12-10 17:25:23,101,9163,52,49,6820.28,12217.01,0.00
2024-12-10 17:25:23,101,9164,52,49,6798.95,12218.00,0.00
2024-12-10 17:25:23,102,9164,53,49,6732.29,12218.01,0.00
2024-12-10 17:25:23,101,9164,53,48,6782.69,12218.14,0.00
2024-12-10 17:25:23,100,9164,53,47,6792.33,12218.60,0.00
2024-12-10 17:25:23,100,9165,53,47,6855.66,12219.00,0.00
2024-12-10 17:25:23,101,9165,53,48,6787.78,12219.01,0.00
2024-12-10 17:25:23,100,9165,52,48,6847.54,12219.07,0.00
2024-12-10 17:25:23,99,9165,51,48,6902.96,12219.14,0.00
2024-12-10 17:25:23,98,9165,50,48,6956.46,12219.28,0.00
2024-12-10 17:25:23,98,9166,50,48,6986.32,12220.00,0.00
2024-12-10 17:25:23,99,9166,50,49,6915.75,12220.01,0.00
2024-12-10 17:25:23,98,9166,49,49,6977.62,12220.07,0.00
2024-12-10 17:25:23,98,9166,49,49,6984.42,12221.00,0.00
2024-12-10 17:25:23,99,9166,50,49,6913.87,12221.01,0.00
2024-12-10 17:25:23,99,9167,50,49,6916.90,12222.00,0.00
2024-12-10 17:25:23,100,9167,51,49,6847.74,12222.01,0.00
2024-12-10 17:25:23,101,9166,52,49,6718.41,12222.53,0.00
2024-12-10 17:25:23,101,9167,52,49,6837.86,12223.00,0.00
2024-12-10 17:25:23,102,9167,52,50,6770.82,12223.01,0.00
2024-12-10 17:25:23,102,9168,52,50,6890.02,12224.00,0.00
2024-12-10 17:25:23,103,9168,52,51,6823.13,12224.01,0.00
2024-12-10 17:25:23,103,9169,52,51,6817.91,12225.00,0.00
2024-12-10 17:25:23,104,9169,53,51,6752.35,12225.01,0.00
2024-12-10 17:25:23,104,9170,53,51,6739.86,12226.00,0.00
2024-12-10 17:25:23,105,9170,54,51,6675.67,12226.01,0.00
2024-12-10 17:25:23,105,9171,54,51,6657.47,12227.00,0.00
2024-12-10 17:25:23,106,9171,54,52,6594.66,12227.01,0.00
2024-12-10 17:25:23,105,9171,54,51,6648.79,12227.08,0.00
2024-12-10 17:25:23,105,9172,54,51,6635.34,12228.00,0.00
2024-12-10 17:25:23,106,9172,55,51,6572.74,12228.01,0.00
2024-12-10 17:25:24,107,9171,55,52,6416.59,12228.68,0.00
2024-12-10 17:25:24,107,9172,55,52,6525.87,12229.00,0.00
2024-12-10 17:25:24,108,9172,56,52,6465.45,12229.01,0.00
2024-12-10 17:25:24,107,9172,55,52,6433.60,12229.64,0.00
2024-12-10 17:25:24,107,9173,55,52,6618.85,12230.00,0.00
2024-12-10 17:25:24,108,9173,55,53,6557.56,12230.01,0.00
2024-12-10 17:25:24,107,9173,55,52,6609.73,12230.08,0.00
2024-12-10 17:25:24,107,9174,55,52,6611.38,12231.00,0.00
2024-12-10 17:25:24,108,9174,55,53,6550.17,12231.01,0.00
2024-12-10 17:25:24,107,9174,55,52,6602.27,12231.08,0.00
2024-12-10 17:25:24,106,9174,54,52,6661.82,12231.09,0.00
2024-12-10 17:25:24,107,9173,54,53,6531.21,12231.67,0.00
2024-12-10 17:25:24,107,9174,54,53,6642.37,12232.00,0.00
2024-12-10 17:25:24,108,9174,54,54,6580.87,12232.01,0.00
2024-12-10 17:25:24,109,9173,54,55,6408.84,12232.93,0.00
2024-12-10 17:25:24,109,9174,54,55,6631.11,12233.00,0.00
2024-12-10 17:25:24,110,9174,55,55,6570.83,12233.01,0.00
2024-12-10 17:25:24,109,9174,55,54,6622.16,12233.07,0.00
2024-12-10 17:25:24,109,9175,55,54,6727.87,12234.00,0.00
2024-12-10 17:25:24,110,9175,56,54,6666.71,12234.01,0.00
2024-12-10 17:25:24,110,9176,56,54,6648.36,12235.00,0.00
2024-12-10 17:25:24,111,9176,56,55,6588.46,12235.01,0.00
2024-12-10 17:25:24,110,9176,55,55,6631.16,12235.15,0.00
2024-12-10 17:25:24,110,9177,55,55,6627.75,12236.00,0.00
2024-12-10 17:25:24,111,9177,55,56,6568.04,12236.01,0.00
2024-12-10 17:25:24,111,9178,55,56,6538.85,12237.00,0.00
2024-12-10 17:25:24,112,9178,55,57,6480.47,12237.01,0.00
2024-12-10 17:25:24,112,9179,55,57,6444.33,12238.00,0.00
2024-12-10 17:25:24,113,9179,56,57,6387.30,12238.01,0.00
2024-12-10 17:25:24,112,9179,55,57,6435.61,12238.07,0.00
2024-12-10 17:25:24,112,9180,55,57,6418.83,12239.00,0.00
2024-12-10 17:25:24,113,9180,56,57,6362.02,12239.01,0.00
2024-12-10 17:25:24,114,9179,57,57,6209.80,12239.76,0.00
2024-12-10 17:25:24,114,9180,57,57,6366.23,12240.00,0.00
2024-12-10 17:25:24,115,9180,58,57,6310.87,12240.01,0.00
2024-12-10 17:25:24,115,9181,58,57,6385.67,12241.00,0.00
2024-12-10 17:25:24,116,9181,59,57,6330.62,12241.01,0.00
2024-12-10 17:25:24,117,9180,59,58,6227.17,12241.40,0.00
2024-12-10 17:25:24,117,9181,59,58,6260.12,12242.00,0.00
2024-12-10 17:25:24,118,9181,60,58,6207.07,12242.01,0.00
2024-12-10 17:25:24,117,9181,60,57,6252.57,12242.07,0.00
2024-12-10 17:25:24,116,9181,59,57,6304.39,12242.08,0.00
2024-12-10 17:25:24,116,9182,59,57,6378.50,12243.00,0.00
2024-12-10 17:25:24,117,9182,59,58,6323.99,12243.01,0.00
2024-12-10 17:25:24,116,9182,59,57,6338.58,12243.33,0.00
2024-12-10 17:25:24,116,9183,59,57,6338.64,12244.00,0.00
2024-12-10 17:25:24,117,9183,60,57,6284.46,12244.01,0.00
2024-12-10 17:25:24,116,9183,60,56,6330.21,12244.07,0.00
2024-12-10 17:25:24,116,9184,60,56,6297.39,12245.00,0.00
2024-12-10 17:25:24,117,9184,61,56,6243.57,12245.01,0.00
2024-12-10 17:25:24,116,9184,60,56,6275.00,12245.19,0.00
2024-12-10 17:25:24,115,9184,59,56,6328.17,12245.20,0.00
2024-12-10 17:25:24,114,9184,58,56,6328.58,12245.51,0.00
2024-12-10 17:25:24,114,9185,58,56,6375.04,12246.00,0.00
2024-12-10 17:25:24,115,9185,58,57,6319.61,12246.01,0.00
2024-12-10 17:25:24,115,9186,58,57,6295.76,12247.00,0.00
2024-12-10 17:25:24,116,9186,59,57,6241.49,12247.01,0.00
2024-12-10 17:25:24,115,9186,59,56,6286.25,12247.08,0.00
2024-12-10 17:25:24,115,9187,59,56,6268.71,12248.00,0.00
2024-12-10 17:25:24,116,9187,60,56,6214.67,12248.01,0.00
2024-12-10 17:25:24,115,9187,59,56,6227.68,12248.31,0.00
2024-12-10 17:25:24,116,9186,60,56,6093.30,12248.92,0.00
2024-12-10 17:25:24,116,9187,60,56,6225.28,12249.00,0.00
2024-12-10 17:25:24,117,9187,61,56,6172.07,12249.01,0.00
2024-12-10 17:25:24,117,9188,61,56,6249.78,12250.00,0.00
2024-12-10 17:25:24,118,9188,62,56,6196.82,12250.01,0.00
2024-12-10 17:25:24,117,9188,61,56,6240.37,12250.08,0.00
2024-12-10 17:25:24,117,9189,61,56,6219.14,12251.00,0.00
2024-12-10 17:25:24,118,9189,62,56,6166.44,12251.01,0.00
2024-12-10 17:25:24,117,9189,62,55,6209.73,12251.08,0.00
2024-12-10 17:25:24,116,9189,62,54,6233.65,12251.29,0.00
2024-12-10 17:25:24,116,9190,62,54,6246.20,12252.00,0.00
2024-12-10 17:25:24,117,9190,63,54,6192.81,12252.01,0.00
2024-12-10 17:25:24,116,9190,62,54,6237.46,12252.08,0.00
2024-12-10 17:25:24,116,9191,62,54,6223.00,12253.00,0.00
2024-12-10 17:25:24,117,9191,62,55,6169.81,12253.01,0.00
2024-12-10 17:25:24,116,9191,62,54,6214.73,12253.07,0.00
2024-12-10 17:25:24,116,9192,62,54,6199.15,12254.00,0.00
2024-12-10 17:25:24,117,9192,63,54,6146.16,12254.01,0.00
2024-12-10 17:25:24,116,9192,63,53,6190.71,12254.07,0.00
2024-12-10 17:25:25,116,9193,63,53,6174.70,12255.00,0.00
2024-12-10 17:25:25,117,9193,64,53,6121.93,12255.01,0.00
2024-12-10 17:25:25,116,9193,64,52,6172.59,12255.02,0.00
2024-12-10 17:25:25,115,9193,63,52,6219.88,12255.06,0.00
2024-12-10 17:25:25,114,9193,62,52,6273.36,12255.06,0.00
2024-12-10 17:25:25,114,9194,62,52,6256.72,12256.00,0.00
2024-12-10 17:25:25,115,9194,63,52,6202.31,12256.01,0.00
2024-12-10 17:25:25,115,9195,63,52,6173.88,12257.00,0.00
2024-12-10 17:25:25,116,9195,63,53,6120.65,12257.01,0.00
2024-12-10 17:25:25,115,9195,63,52,6166.42,12257.06,0.00
2024-12-10 17:25:25,115,9196,63,52,6142.47,12258.00,0.00
2024-12-10 17:25:25,116,9196,64,52,6089.52,12258.01,0.00
2024-12-10 17:25:25,116,9197,64,52,6056.41,12259.00,0.00
2024-12-10 17:25:25,117,9197,64,53,6004.65,12259.01,0.00
2024-12-10 17:25:25,117,9198,64,53,5967.02,12260.00,0.00
2024-12-10 17:25:25,118,9198,65,53,5916.45,12260.01,0.00
2024-12-10 17:25:25,117,9198,64,53,5959.69,12260.06,0.00
2024-12-10 17:25:25,117,9199,64,53,5927.22,12261.00,0.00
2024-12-10 17:25:25,118,9199,65,53,5876.99,12261.01,0.00
2024-12-10 17:25:25,117,9199,64,53,5921.99,12261.04,0.00
2024-12-10 17:25:25,116,9199,63,53,5970.93,12261.05,0.00
2024-12-10 17:25:25,115,9199,63,52,5946.81,12261.59,0.00
2024-12-10 17:25:25,115,9200,63,52,5995.74,12262.00,0.00
2024-12-10 17:25:25,116,9200,63,53,5944.05,12262.01,0.00
2024-12-10 17:25:25,115,9200,62,53,5988.28,12262.06,0.00
2024-12-10 17:25:25,115,9201,62,53,5969.50,12263.00,0.00
2024-12-10 17:25:25,116,9201,63,53,5918.04,12263.01,0.00
2024-12-10 17:25:25,115,9201,62,53,5962.04,12263.06,0.00
2024-12-10 17:25:25,115,9202,62,53,5938.26,12264.00,0.00
2024-12-10 17:25:25,116,9202,63,53,5887.06,12264.01,0.00
2024-12-10 17:25:25,116,9203,63,53,5850.41,12265.00,0.00
2024-12-10 17:25:25,117,9203,63,54,5800.41,12265.01,0.00
2024-12-10 17:25:25,116,9203,62,54,5843.11,12265.06,0.00
2024-12-10 17:25:25,117,9202,63,54,5771.18,12265.26,0.00
2024-12-10 17:25:25,117,9203,63,54,5854.32,12266.00,0.00
2024-12-10 17:25:25,118,9203,64,54,5804.71,12266.01,0.00
2024-12-10 17:25:25,117,9203,63,54,5846.99,12266.06,0.00
2024-12-10 17:25:25,116,9203,62,54,5856.91,12266.26,0.00
2024-12-10 17:25:25,116,9204,62,54,5954.43,12267.00,0.00
2024-12-10 17:25:25,117,9204,62,55,5903.53,12267.01,0.00
2024-12-10 17:25:25,116,9204,61,55,5947.03,12267.06,0.00
2024-12-10 17:25:25,115,9204,61,54,5998.67,12267.06,0.00
2024-12-10 17:25:25,114,9204,61,53,6018.91,12267.23,0.00
2024-12-10 17:25:25,114,9205,61,53,6009.49,12268.00,0.00
2024-12-10 17:25:25,115,9205,61,54,5957.23,12268.01,0.00
2024-12-10 17:25:25,114,9205,61,53,6005.19,12268.04,0.00
2024-12-10 17:25:25,113,9205,61,52,6055.08,12268.05,0.00
2024-12-10 17:25:25,112,9205,60,52,6068.59,12268.27,0.00
2024-12-10 17:25:25,112,9206,60,52,6071.94,12269.00,0.00
2024-12-10 17:25:25,113,9206,61,52,6018.21,12269.01,0.00
2024-12-10 17:25:25,112,9206,60,52,6065.38,12269.05,0.00
2024-12-10 17:25:25,113,9205,60,53,5999.77,12269.17,0.00
2024-12-10 17:25:25,112,9205,60,52,6083.49,12269.59,0.00
2024-12-10 17:25:25,112,9206,60,52,6141.06,12270.00,0.00
2024-12-10 17:25:25,113,9206,61,52,6086.72,12270.01,0.00
2024-12-10 17:25:25,114,9205,62,52,6032.25,12270.04,0.00
2024-12-10 17:25:25,113,9205,62,51,6180.11,12270.06,0.00
2024-12-10 17:25:25,112,9205,61,51,6232.41,12270.08,0.00
2024-12-10 17:25:25,113,9204,62,51,6164.25,12270.20,0.00
2024-12-10 17:25:25,113,9205,62,51,6326.01,12271.00,0.00
2024-12-10 17:25:25,114,9205,63,51,6270.52,12271.01,0.00
2024-12-10 17:25:25,113,9205,62,51,6319.50,12271.05,0.00
2024-12-10 17:25:25,113,9206,62,51,6497.27,12272.00,0.00
2024-12-10 17:25:25,114,9206,63,51,6440.27,12272.01,0.00
2024-12-10 17:25:25,113,9206,63,50,6492.98,12272.04,0.00
2024-12-10 17:25:25,112,9206,62,50,6548.76,12272.04,0.00
2024-12-10 17:25:25,112,9207,62,50,6504.73,12273.00,0.00
2024-12-10 17:25:25,113,9207,62,51,6447.16,12273.01,0.00
2024-12-10 17:25:25,112,9207,61,51,6499.26,12273.04,0.00
2024-12-10 17:25:25,111,9207,61,50,6502.70,12273.41,0.00
2024-12-10 17:25:25,111,9208,61,50,6512.17,12274.00,0.00
2024-12-10 17:25:25,112,9208,61,51,6454.02,12274.01,0.00
2024-12-10 17:25:25,111,9208,61,50,6506.65,12274.04,0.00
2024-12-10 17:25:25,111,9209,61,50,6454.53,12275.00,0.00
2024-12-10 17:25:25,112,9209,62,50,6396.90,12275.01,0.00
2024-12-10 17:25:25,111,9209,61,50,6449.01,12275.04,0.00
2024-12-10 17:25:25,112,9208,62,50,6340.66,12275.42,0.00
2024-12-10 17:25:25,111,9208,61,50,6423.49,12275.63,0.00
2024-12-10 17:25:25,111,9209,61,50,6465.37,12276.00,0.00
2024-12-10 17:25:25,112,9209,61,51,6407.64,12276.01,0.00
2024-12-10 17:25:25,111,9209,61,50,6464.26,12276.01,0.00
2024-12-10 17:25:25,110,9209,60,50,6518.58,12276.04,0.00
2024-12-10 17:25:25,109,9209,59,50,6577.25,12276.04,0.00
2024-12-10 17:25:25,108,9209,58,50,6494.87,12276.94,0.00
2024-12-10 17:25:25,108,9210,58,50,6715.43,12277.00,0.00
2024-12-10 17:25:25,109,9210,59,50,6653.82,12277.01,0.00
2024-12-10 17:25:25,109,9211,59,50,6639.25,12278.00,0.00
2024-12-10 17:25:25,110,9211,59,51,6578.90,12278.01,0.00
2024-12-10 17:25:25,110,9212,59,51,6560.90,12279.00,0.00
2024-12-10 17:25:25,111,9212,60,51,6501.79,12279.01,0.00
2024-12-10 17:25:25,110,9212,60,50,6555.33,12279.05,0.00
2024-12-10 17:25:26,110,9213,60,50,6534.58,12280.00,0.00
2024-12-10 17:25:26,111,9213,61,50,6475.71,12280.01,0.00
2024-12-10 17:25:26,111,9214,61,50,6435.86,12281.00,0.00
2024-12-10 17:25:26,112,9214,62,50,6378.40,12281.01,0.00
2024-12-10 17:25:26,111,9214,62,49,6429.24,12281.05,0.00
2024-12-10 17:25:26,110,9214,62,48,6487.15,12281.05,0.00
2024-12-10 17:25:26,111,9213,63,48,6312.30,12281.84,0.00
2024-12-10 17:25:26,111,9214,63,48,6462.06,12282.00,0.00
2024-12-10 17:25:26,112,9214,63,49,6404.36,12282.01,0.00
2024-12-10 17:25:26,112,9215,63,49,6449.71,12283.00,0.00
2024-12-10 17:25:26,113,9215,63,50,6392.64,12283.01,0.00
2024-12-10 17:25:26,112,9215,62,50,6443.16,12283.05,0.00
2024-12-10 17:25:26,111,9215,61,50,6500.93,12283.05,0.00
2024-12-10 17:25:26,111,9216,61,50,6434.42,12284.00,0.00
2024-12-10 17:25:26,112,9216,62,50,6376.97,12284.01,0.00
2024-12-10 17:25:26,111,9216,61,50,6413.13,12284.13,0.00
2024-12-10 17:25:26,111,9217,61,50,6344.18,12285.00,0.00
2024-12-10 17:25:26,112,9217,62,50,6287.54,12285.01,0.00
2024-12-10 17:25:26,112,9218,62,50,6184.88,12286.00,0.00
2024-12-10 17:25:26,113,9218,62,51,6130.15,12286.01,0.00
2024-12-10 17:25:26,112,9218,61,51,6061.40,12286.63,0.00
2024-12-10 17:25:26,111,9218,60,51,6069.55,12286.78,0.00
2024-12-10 17:25:26,111,9219,60,51,6131.35,12287.00,0.00
2024-12-10 17:25:26,112,9219,61,51,6076.60,12287.01,0.00
2024-12-10 17:25:26,111,9219,61,50,6118.75,12287.06,0.00
2024-12-10 17:25:26,111,9220,61,50,6044.25,12288.00,0.00
2024-12-10 17:25:26,112,9220,62,50,5990.29,12288.01,0.00
2024-12-10 17:25:26,111,9220,61,50,6034.17,12288.05,0.00
2024-12-10 17:25:26,110,9220,60,50,6017.50,12288.55,0.00
2024-12-10 17:25:26,110,9221,60,50,6016.39,12289.00,0.00
2024-12-10 17:25:26,111,9221,60,51,5962.19,12289.01,0.00
2024-12-10 17:25:26,110,9221,59,51,6014.16,12289.02,0.00
2024-12-10 17:25:26,109,9221,58,51,6064.84,12289.05,0.00
2024-12-10 17:25:26,108,9221,58,50,6119.86,12289.05,0.00
2024-12-10 17:25:26,107,9221,57,50,5996.63,12289.93,0.00
2024-12-10 17:25:26,108,9220,58,50,5938.85,12289.96,0.00
2024-12-10 17:25:26,108,9221,58,50,6052.68,12290.00,0.00
2024-12-10 17:25:26,109,9221,58,51,5997.15,12290.01,0.00
2024-12-10 17:25:26,108,9221,57,51,6047.01,12290.05,0.00
2024-12-10 17:25:26,108,9222,57,51,6073.74,12291.00,0.00
2024-12-10 17:25:26,109,9222,57,52,6018.01,12291.01,0.00
2024-12-10 17:25:26,108,9222,57,51,6068.07,12291.05,0.00
2024-12-10 17:25:26,107,9222,57,50,6082.11,12291.25,0.00
2024-12-10 17:25:26,107,9223,57,50,6044.62,12292.00,0.00
2024-12-10 17:25:26,108,9223,58,50,5988.65,12292.01,0.00
2024-12-10 17:25:26,107,9223,57,50,6038.90,12292.05,0.00
2024-12-10 17:25:26,106,9223,56,50,6084.87,12292.13,0.00
2024-12-10 17:25:26,106,9224,56,50,6039.39,12293.00,0.00
2024-12-10 17:25:26,107,9224,56,51,5982.95,12293.01,0.00
2024-12-10 17:25:26,107,9225,56,51,5919.63,12294.00,0.00
2024-12-10 17:25:26,108,9225,57,51,5864.81,12294.01,0.00
2024-12-10 17:25:26,107,9225,57,50,5913.90,12294.05,0.00
2024-12-10 17:25:26,106,9225,57,49,5807.21,12294.80,0.00
2024-12-10 17:25:26,106,9226,57,49,5894.28,12295.00,0.00
2024-12-10 17:25:26,107,9226,58,49,5839.19,12295.01,0.00
2024-12-10 17:25:26,106,9226,57,49,5814.45,12295.51,0.00
2024-12-10 17:25:26,106,9227,57,49,5806.65,12296.00,0.00
2024-12-10 17:25:26,107,9227,57,50,5752.38,12296.01,0.00
2024-12-10 17:25:26,106,9227,56,50,5684.06,12296.59,0.00
2024-12-10 17:25:26,105,9227,56,49,5713.84,12296.69,0.00
2024-12-10 17:25:26,105,9228,56,49,5758.25,12297.00,0.00
2024-12-10 17:25:26,106,9228,57,49,5703.93,12297.01,0.00
2024-12-10 17:25:26,105,9228,57,48,5755.91,12297.02,0.00
2024-12-10 17:25:26,104,9228,57,47,5807.72,12297.04,0.00
2024-12-10 17:25:26,103,9228,57,46,5862.92,12297.04,0.00
2024-12-10 17:25:26,102,9228,56,46,5795.77,12297.51,0.00
2024-12-10 17:25:26,101,9228,55,46,5849.56,12297.51,0.00
2024-12-10 17:25:26,100,9228,54,46,5831.10,12297.78,0.00
2024-12-10 17:25:26,100,9229,54,46,5927.21,12298.00,0.00
2024-12-10 17:25:26,101,9229,54,47,5868.52,12298.01,0.00
2024-12-10 17:25:26,100,9229,54,46,5902.07,12298.17,0.00
2024-12-10 17:25:26,99,9229,53,46,5944.13,12298.21,0.00
2024-12-10 17:25:26,98,9229,52,46,5960.56,12298.45,0.00
2024-12-10 17:25:26,97,9229,51,46,5983.07,12298.61,0.00
2024-12-10 17:25:26,97,9230,51,46,6039.48,12299.00,0.00
2024-12-10 17:25:26,98,9230,51,47,5977.86,12299.01,0.00
2024-12-10 17:25:26,97,9230,50,47,6033.17,12299.05,0.00
2024-12-10 17:25:26,98,9229,50,48,5945.28,12299.29,0.00
2024-12-10 17:25:26,98,9230,50,48,6063.36,12300.00,0.00
2024-12-10 17:25:26,99,9230,51,48,6002.11,12300.01,0.00
2024-12-10 17:25:26,98,9230,51,47,6057.10,12300.05,0.00
2024-12-10 17:25:26,98,9231,51,47,6143.34,12301.00,0.00
2024-12-10 17:25:26,99,9231,51,48,6081.28,12301.01,0.00
2024-12-10 17:25:26,98,9231,51,47,6137.08,12301.05,0.00
2024-12-10 17:25:26,97,9231,50,47,6142.80,12301.45,0.00
2024-12-10 17:25:26,97,9232,50,47,6173.70,12302.00,0.00
2024-12-10 17:25:26,98,9232,51,47,6110.71,12302.01,0.00
2024-12-10 17:25:26,97,9232,51,46,6167.38,12302.05,0.00
2024-12-10 17:25:26,97,9233,51,46,6139.32,12303.00,0.00
2024-12-10 17:25:26,98,9233,52,46,6076.67,12303.01,0.00
2024-12-10 17:25:26,97,9233,52,45,6133.00,12303.05,0.00
2024-12-10 17:25:26,96,9233,51,45,6112.20,12303.59,0.00
2024-12-10 17:25:26,96,9234,51,45,6171.73,12304.00,0.00
2024-12-10 17:25:26,97,9234,51,46,6108.11,12304.01,0.00
2024-12-10 17:25:26,98,9233,51,47,6031.99,12304.14,0.00
2024-12-10 17:25:27,98,9234,51,47,6135.35,12305.00,0.00
2024-12-10 17:25:27,99,9234,52,47,6073.37,12305.01,0.00
2024-12-10 17:25:27,98,9234,52,46,6129.09,12305.05,0.00
2024-12-10 17:25:27,99,9233,52,47,5997.43,12305.56,0.00
2024-12-10 17:25:27,99,9234,52,47,6224.41,12306.00,0.00
2024-12-10 17:25:27,100,9234,52,48,6162.16,12306.01,0.00
2024-12-10 17:25:27,99,9234,51,48,6218.21,12306.05,0.00
2024-12-10 17:25:27,98,9234,51,47,6129.96,12306.92,0.00
2024-12-10 17:25:27,98,9235,51,47,6364.51,12307.00,0.00
2024-12-10 17:25:27,99,9235,51,48,6300.22,12307.01,0.00
2024-12-10 17:25:27,98,9235,50,48,6358.25,12307.05,0.00
2024-12-10 17:25:27,98,9236,50,48,6331.83,12308.00,0.00
2024-12-10 17:25:27,99,9236,51,48,6267.88,12308.01,0.00
2024-12-10 17:25:27,98,9236,51,47,6325.57,12308.05,0.00
2024-12-10 17:25:27,98,9237,51,47,6297.94,12309.00,0.00
2024-12-10 17:25:27,99,9237,51,48,6234.33,12309.01,0.00
2024-12-10 17:25:27,98,9237,50,48,6291.68,12309.05,0.00
2024-12-10 17:25:27,98,9238,50,48,6266.53,12310.00,0.00
2024-12-10 17:25:27,99,9238,51,48,6203.23,12310.01,0.00
2024-12-10 17:25:27,98,9238,51,47,6260.26,12310.05,0.00
2024-12-10 17:25:27,97,9238,50,47,6266.28,12310.40,0.00
2024-12-10 17:25:27,97,9239,50,47,6302.55,12311.00,0.00
2024-12-10 17:25:27,98,9239,51,47,6238.24,12311.01,0.00
2024-12-10 17:25:27,97,9239,50,47,6296.22,12311.05,0.00
2024-12-10 17:25:27,96,9239,50,46,6324.43,12311.25,0.00
2024-12-10 17:25:27,96,9240,50,46,6344.74,12312.00,0.00
2024-12-10 17:25:27,97,9240,51,46,6279.33,12312.01,0.00
2024-12-10 17:25:27,96,9240,50,46,6321.51,12312.16,0.00
2024-12-10 17:25:27,96,9241,50,46,6329.83,12313.00,0.00
2024-12-10 17:25:27,97,9241,50,47,6264.57,12313.01,0.00
2024-12-10 17:25:27,96,9241,49,47,6312.91,12313.11,0.00
2024-12-10 17:25:27,96,9242,49,47,6315.37,12314.00,0.00
2024-12-10 17:25:27,97,9242,50,47,6250.26,12314.01,0.00
2024-12-10 17:25:27,96,9242,50,46,6307.70,12314.06,0.00
2024-12-10 17:25:27,95,9242,49,46,6294.66,12314.54,0.00
2024-12-10 17:25:27,95,9243,49,46,6365.92,12315.00,0.00
2024-12-10 17:25:27,96,9243,49,47,6299.61,12315.01,0.00
2024-12-10 17:25:27,95,9243,49,46,6358.17,12315.06,0.00
2024-12-10 17:25:27,94,9243,49,45,6368.45,12315.44,0.00
2024-12-10 17:25:27,94,9244,49,45,6425.79,12316.00,0.00
2024-12-10 17:25:27,95,9244,49,46,6358.15,12316.01,0.00
2024-12-10 17:25:27,95,9245,49,46,6361.31,12317.00,0.00
2024-12-10 17:25:27,96,9245,50,46,6295.05,12317.01,0.00
2024-12-10 17:25:27,95,9245,50,45,6353.56,12317.06,0.00
2024-12-10 17:25:27,94,9245,50,44,6373.35,12317.45,0.00
2024-12-10 17:25:27,94,9246,50,44,6434.74,12318.00,0.00
2024-12-10 17:25:27,95,9246,50,45,6367.01,12318.01,0.00
2024-12-10 17:25:27,95,9247,50,45,6373.63,12319.00,0.00
2024-12-10 17:25:27,96,9247,50,46,6307.23,12319.01,0.00
2024-12-10 17:25:27,95,9247,50,45,6365.87,12319.06,0.00
2024-12-10 17:25:27,95,9248,50,45,6378.45,12320.00,0.00
2024-12-10 17:25:27,96,9248,50,46,6312.01,12320.01,0.00
2024-12-10 17:25:27,97,9247,51,46,6133.90,12320.92,0.00
2024-12-10 17:25:27,97,9248,51,46,6261.00,12321.00,0.00
2024-12-10 17:25:27,98,9248,52,46,6197.12,12321.01,0.00
2024-12-10 17:25:27,97,9248,51,46,6253.40,12321.06,0.00
2024-12-10 17:25:27,97,9249,51,46,6386.34,12322.00,0.00
2024-12-10 17:25:27,98,9249,51,47,6321.17,12322.01,0.00
2024-12-10 17:25:27,99,9248,51,48,6254.84,12322.05,0.00
2024-12-10 17:25:27,98,9248,50,48,6380.29,12322.07,0.00
2024-12-10 17:25:27,99,9247,51,48,6268.00,12322.46,0.00
2024-12-10 17:25:27,99,9248,51,48,6385.45,12323.00,0.00
2024-12-10 17:25:27,100,9248,52,48,6321.60,12323.01,0.00
2024-12-10 17:25:27,99,9248,52,47,6378.01,12323.06,0.00
2024-12-10 17:25:27,99,9249,52,47,6628.43,12324.00,0.00
2024-12-10 17:25:27,100,9249,53,47,6562.14,12324.01,0.00
2024-12-10 17:25:27,99,9249,53,46,6620.98,12324.06,0.00
2024-12-10 17:25:27,99,9250,53,46,6623.99,12325.00,0.00
2024-12-10 17:25:27,100,9250,53,47,6557.75,12325.01,0.00
2024-12-10 17:25:27,100,9251,53,47,6556.09,12326.00,0.00
2024-12-10 17:25:27,101,9251,53,48,6491.18,12326.01,0.00
2024-12-10 17:25:27,100,9251,52,48,6548.72,12326.06,0.00
2024-12-10 17:25:27,100,9252,52,48,6555.10,12327.00,0.00
2024-12-10 17:25:27,101,9252,52,49,6490.20,12327.01,0.00
2024-12-10 17:25:27,100,9252,52,48,6547.73,12327.06,0.00
2024-12-10 17:25:27,100,9253,52,48,6553.09,12328.00,0.00
2024-12-10 17:25:27,101,9253,53,48,6488.20,12328.01,0.00
2024-12-10 17:25:27,100,9253,52,48,6545.71,12328.06,0.00
2024-12-10 17:25:27,100,9254,52,48,6546.01,12329.00,0.00
2024-12-10 17:25:27,101,9254,52,49,6481.20,12329.01,0.00
2024-12-10 17:25:27,100,9254,51,49,6538.64,12329.06,0.00
2024-12-10 17:25:27,100,9255,51,49,6531.18,12330.00,0.00
2024-12-10 17:25:27,101,9255,52,49,6466.51,12330.01,0.00
2024-12-10 17:25:27,100,9255,52,48,6523.80,12330.06,0.00
2024-12-10 17:25:27,99,9255,51,48,6550.41,12330.35,0.00
2024-12-10 17:25:28,99,9256,51,48,6573.90,12331.00,0.00
2024-12-10 17:25:28,100,9256,52,48,6508.16,12331.01,0.00
2024-12-10 17:25:28,99,9256,52,47,6568.93,12331.04,0.00
2024-12-10 17:25:28,98,9256,52,46,6633.46,12331.05,0.00
2024-12-10 17:25:28,97,9256,52,45,6700.57,12331.05,0.00
2024-12-10 17:25:28,97,9257,52,45,6679.50,12332.00,0.00
2024-12-10 17:25:28,98,9257,52,46,6611.34,12332.01,0.00
2024-12-10 17:25:28,97,9257,52,45,6673.16,12332.05,0.00
2024-12-10 17:25:28,97,9258,52,45,6644.97,12333.00,0.00
2024-12-10 17:25:28,98,9258,53,45,6577.17,12333.01,0.00
2024-12-10 17:25:28,97,9258,52,45,6638.64,12333.05,0.00
2024-12-10 17:25:28,97,9259,52,45,6603.63,12334.00,0.00
2024-12-10 17:25:28,98,9259,53,45,6536.25,12334.01,0.00
2024-12-10 17:25:28,97,9259,52,45,6597.29,12334.05,0.00
2024-12-10 17:25:28,97,9260,52,45,6562.57,12335.00,0.00
2024-12-10 17:25:28,98,9260,53,45,6495.60,12335.01,0.00
2024-12-10 17:25:28,97,9260,53,44,6556.23,12335.05,0.00
2024-12-10 17:25:28,97,9261,53,44,6521.16,12336.00,0.00
2024-12-10 17:25:28,98,9261,53,45,6454.62,12336.01,0.00
2024-12-10 17:25:28,97,9261,53,44,6514.82,12336.05,0.00
2024-12-10 17:25:28,97,9262,53,44,6478.33,12337.00,0.00
2024-12-10 17:25:28,98,9262,53,45,6412.22,12337.01,0.00
2024-12-10 17:25:28,97,9262,53,44,6473.00,12337.05,0.00
2024-12-10 17:25:28,97,9263,53,44,6434.72,12338.00,0.00
2024-12-10 17:25:28,98,9263,54,44,6369.06,12338.01,0.00
2024-12-10 17:25:28,97,9263,53,44,6428.38,12338.05,0.00
2024-12-10 17:25:28,97,9264,53,44,6393.95,12339.00,0.00
2024-12-10 17:25:28,98,9264,54,44,6328.70,12339.01,0.00
2024-12-10 17:25:28,97,9264,53,44,6387.60,12339.05,0.00
2024-12-10 17:25:28,96,9264,53,43,6437.11,12339.18,0.00
2024-12-10 17:25:28,96,9265,53,43,6431.30,12340.00,0.00
2024-12-10 17:25:28,97,9265,53,44,6365.00,12340.01,0.00
2024-12-10 17:25:28,96,9265,53,43,6421.86,12340.08,0.00
2024-12-10 17:25:28,96,9266,53,43,6402.74,12341.00,0.00
2024-12-10 17:25:28,97,9266,54,43,6336.74,12341.01,0.00
2024-12-10 17:25:28,96,9266,53,43,6400.17,12341.02,0.00
2024-12-10 17:25:28,95,9266,52,43,6463.66,12341.04,0.00
2024-12-10 17:25:28,94,9266,52,42,6531.11,12341.04,0.00
2024-12-10 17:25:28,93,9266,51,42,6507.05,12341.62,0.00
2024-12-10 17:25:28,93,9267,51,42,6583.18,12342.00,0.00
2024-12-10 17:25:28,94,9267,52,42,6513.15,12342.01,0.00
2024-12-10 17:25:28,93,9267,51,42,6575.27,12342.06,0.00
2024-12-10 17:25:28,92,9267,50,42,6633.06,12342.14,0.00
2024-12-10 17:25:28,92,9268,50,42,6623.03,12343.00,0.00
2024-12-10 17:25:28,93,9268,50,43,6551.81,12343.01,0.00
2024-12-10 17:25:28,92,9268,50,42,6616.77,12343.04,0.00
2024-12-10 17:25:28,93,9267,51,42,6404.25,12343.84,0.00
2024-12-10 17:25:28,93,9268,51,42,6533.84,12344.00,0.00
2024-12-10 17:25:28,94,9268,51,43,6464.33,12344.01,0.00
2024-12-10 17:25:28,93,9268,50,43,6481.26,12344.40,0.00
2024-12-10 17:25:28,92,9268,50,42,6491.90,12344.63,0.00
2024-12-10 17:25:28,92,9269,50,42,6689.49,12345.00,0.00
2024-12-10 17:25:28,93,9269,50,43,6617.56,12345.01,0.00
2024-12-10 17:25:28,93,9270,50,43,6558.43,12346.00,0.00
2024-12-10 17:25:28,94,9270,51,43,6488.66,12346.01,0.00
2024-12-10 17:25:28,95,9269,51,44,6420.35,12346.03,0.00
2024-12-10 17:25:28,96,9268,52,44,6438.04,12346.19,0.00
2024-12-10 17:25:28,95,9268,52,43,6533.02,12346.54,0.00
2024-12-10 17:25:28,95,9269,52,43,6565.22,12347.00,0.00
2024-12-10 17:25:28,96,9269,52,44,6496.83,12347.01,0.00
2024-12-10 17:25:28,95,9269,52,43,6497.85,12347.44,0.00
2024-12-10 17:25:28,95,9270,52,43,6789.24,12348.00,0.00
2024-12-10 17:25:28,96,9270,53,43,6718.52,12348.01,0.00
2024-12-10 17:25:28,96,9271,53,43,6682.93,12349.00,0.00
2024-12-10 17:25:28,97,9271,54,43,6614.04,12349.01,0.00
2024-12-10 17:25:28,96,9271,53,43,6677.81,12349.04,0.00
2024-12-10 17:25:28,96,9272,53,43,6631.31,12350.00,0.00
2024-12-10 17:25:28,97,9272,53,44,6562.95,12350.01,0.00
2024-12-10 17:25:28,96,9272,52,44,6548.78,12350.49,0.00
2024-12-10 17:25:28,96,9273,52,44,6581.13,12351.00,0.00
2024-12-10 17:25:28,97,9273,53,44,6513.28,12351.01,0.00
2024-12-10 17:25:28,96,9273,52,44,6523.57,12351.39,0.00
2024-12-10 17:25:28,96,9274,52,44,6553.52,12352.00,0.00
2024-12-10 17:25:28,97,9274,53,44,6485.96,12352.01,0.00
2024-12-10 17:25:28,96,9274,52,44,6548.40,12352.04,0.00
2024-12-10 17:25:28,96,9275,52,44,6534.31,12353.00,0.00
2024-12-10 17:25:28,97,9275,53,44,6466.94,12353.01,0.00
2024-12-10 17:25:28,96,9275,53,43,6529.18,12353.04,0.00
2024-12-10 17:25:28,95,9275,52,43,6591.16,12353.09,0.00
2024-12-10 17:25:28,94,9275,52,42,6649.42,12353.17,0.00
2024-12-10 17:25:28,94,9276,52,42,6666.94,12354.00,0.00
2024-12-10 17:25:28,95,9276,52,43,6596.76,12354.01,0.00
2024-12-10 17:25:28,94,9276,51,43,6661.71,12354.04,0.00
2024-12-10 17:25:28,94,9277,51,43,6657.76,12355.00,0.00
2024-12-10 17:25:28,95,9277,52,43,6587.68,12355.01,0.00
2024-12-10 17:25:29,95,9278,52,43,6571.13,12356.00,0.00
2024-12-10 17:25:29,96,9278,52,44,6502.68,12356.01,0.00
2024-12-10 17:25:29,95,9278,51,44,6565.95,12356.04,0.00
2024-12-10 17:25:29,96,9277,52,44,6427.80,12356.58,0.00
2024-12-10 17:25:29,96,9278,52,44,6608.43,12357.00,0.00
2024-12-10 17:25:29,97,9278,53,44,6540.30,12357.01,0.00
2024-12-10 17:25:29,96,9278,53,43,6603.30,12357.04,0.00
2024-12-10 17:25:29,97,9277,53,44,6477.23,12357.48,0.00
2024-12-10 17:25:29,98,9276,53,45,6464.20,12357.89,0.00
2024-12-10 17:25:29,98,9277,53,45,6706.65,12358.00,0.00
2024-12-10 17:25:29,99,9277,54,45,6638.91,12358.01,0.00
2024-12-10 17:25:29,98,9277,53,45,6701.63,12358.04,0.00
2024-12-10 17:25:29,97,9277,53,44,6682.64,12358.62,0.00
2024-12-10 17:25:29,97,9278,53,44,7006.71,12359.00,0.00
2024-12-10 17:25:29,98,9278,54,44,6935.21,12359.01,0.00
2024-12-10 17:25:29,97,9278,54,43,7001.43,12359.05,0.00
2024-12-10 17:25:29,97,9279,54,43,6999.53,12360.00,0.00
2024-12-10 17:25:29,98,9279,55,43,6928.10,12360.01,0.00
2024-12-10 17:25:29,98,9280,55,43,6920.99,12361.00,0.00
2024-12-10 17:25:29,99,9280,56,43,6851.08,12361.01,0.00
2024-12-10 17:25:29,98,9280,55,43,6915.96,12361.04,0.00
2024-12-10 17:25:29,98,9281,55,43,6910.27,12362.00,0.00
2024-12-10 17:25:29,99,9281,56,43,6840.47,12362.01,0.00
2024-12-10 17:25:29,99,9282,56,43,6826.31,12363.00,0.00
2024-12-10 17:25:29,100,9282,57,43,6758.05,12363.01,0.00
2024-12-10 17:25:29,99,9282,56,43,6787.50,12363.31,0.00
2024-12-10 17:25:29,99,9283,56,43,6808.11,12364.00,0.00
2024-12-10 17:25:29,100,9283,56,44,6740.03,12364.01,0.00
2024-12-10 17:25:29,100,9284,56,44,6724.63,12365.00,0.00
2024-12-10 17:25:29,101,9284,56,45,6658.05,12365.01,0.00
2024-12-10 17:25:29,101,9285,56,45,6647.68,12366.00,0.00
2024-12-10 17:25:29,102,9285,56,46,6582.50,12366.01,0.00
2024-12-10 17:25:29,102,9286,56,46,6578.29,12367.00,0.00
2024-12-10 17:25:29,103,9286,56,47,6514.43,12367.01,0.00
2024-12-10 17:25:29,103,9287,56,47,6508.52,12368.00,0.00
2024-12-10 17:25:29,104,9287,56,48,6445.93,12368.01,0.00
2024-12-10 17:25:29,104,9288,56,48,6433.18,12369.00,0.00
2024-12-10 17:25:29,105,9288,56,49,6371.91,12369.01,0.00
2024-12-10 17:25:29,104,9288,55,49,6428.44,12369.04,0.00
2024-12-10 17:25:29,104,9289,55,49,6417.25,12370.00,0.00
2024-12-10 17:25:29,105,9289,56,49,6356.13,12370.01,0.00
2024-12-10 17:25:29,104,9289,56,48,6401.86,12370.10,0.00
2024-12-10 17:25:29,104,9290,56,48,6406.08,12371.00,0.00
2024-12-10 17:25:29,105,9290,57,48,6345.07,12371.01,0.00
2024-12-10 17:25:29,106,9289,57,49,6234.82,12371.39,0.00
2024-12-10 17:25:29,105,9289,56,49,6295.33,12371.50,0.00
2024-12-10 17:25:29,105,9290,56,49,6352.25,12372.00,0.00
2024-12-10 17:25:29,106,9290,57,49,6292.32,12372.01,0.00
2024-12-10 17:25:29,105,9290,56,49,6345.21,12372.06,0.00
2024-12-10 17:25:29,104,9290,55,49,6402.91,12372.08,0.00
2024-12-10 17:25:29,104,9291,55,49,6523.62,12373.00,0.00
2024-12-10 17:25:29,105,9291,56,49,6461.49,12373.01,0.00
2024-12-10 17:25:29,104,9291,56,48,6516.51,12373.06,0.00
2024-12-10 17:25:29,104,9292,56,48,6518.68,12374.00,0.00
2024-12-10 17:25:29,105,9292,57,48,6456.60,12374.01,0.00
2024-12-10 17:25:29,105,9293,57,48,6450.80,12375.00,0.00
2024-12-10 17:25:29,106,9293,57,49,6389.94,12375.01,0.00
2024-12-10 17:25:29,105,9293,56,49,6443.75,12375.06,0.00
2024-12-10 17:25:29,104,9293,56,48,6499.67,12375.09,0.00
2024-12-10 17:25:29,104,9294,56,48,6502.37,12376.00,0.00
2024-12-10 17:25:29,105,9294,56,49,6440.44,12376.01,0.00
2024-12-10 17:25:29,104,9294,55,49,6496.00,12376.06,0.00
2024-12-10 17:25:29,104,9295,55,49,6491.31,12377.00,0.00
2024-12-10 17:25:29,105,9295,55,50,6429.49,12377.01,0.00
2024-12-10 17:25:29,105,9296,55,50,6413.88,12378.00,0.00
2024-12-10 17:25:29,106,9296,56,50,6353.37,12378.01,0.00
2024-12-10 17:25:29,106,9297,56,50,6332.96,12379.00,0.00
2024-12-10 17:25:29,107,9297,57,50,6273.77,12379.01,0.00
2024-12-10 17:25:29,106,9297,56,50,6326.57,12379.06,0.00
2024-12-10 17:25:29,106,9298,56,50,6308.48,12380.00,0.00
2024-12-10 17:25:29,107,9298,56,51,6249.52,12380.01,0.00
2024-12-10 17:25:30,107,9299,56,51,6220.40,12381.00,0.00
2024-12-10 17:25:30,108,9299,57,51,6162.80,12381.01,0.00
2024-12-10 17:25:30,107,9299,56,51,6213.48,12381.06,0.00
2024-12-10 17:25:30,106,9299,56,50,6166.96,12381.76,0.00
2024-12-10 17:25:30,106,9300,56,50,6254.77,12382.00,0.00
2024-12-10 17:25:30,107,9300,57,50,6196.31,12382.01,0.00
2024-12-10 17:25:30,107,9301,57,50,6182.38,12383.00,0.00
2024-12-10 17:25:30,108,9301,58,50,6125.14,12383.01,0.00
2024-12-10 17:25:30,107,9301,58,49,6175.46,12383.06,0.00
2024-12-10 17:25:30,107,9302,58,49,6166.79,12384.00,0.00
2024-12-10 17:25:30,108,9302,59,49,6109.69,12384.01,0.00
2024-12-10 17:25:30,108,9303,59,49,6096.99,12385.00,0.00
2024-12-10 17:25:30,109,9303,59,50,6041.05,12385.01,0.00
2024-12-10 17:25:30,108,9303,58,50,6088.98,12385.06,0.00
2024-12-10 17:25:30,107,9303,58,49,6126.25,12385.21,0.00
2024-12-10 17:25:30,107,9304,58,49,6140.24,12386.00,0.00
2024-12-10 17:25:30,108,9304,59,49,6083.38,12386.01,0.00
2024-12-10 17:25:30,107,9304,59,48,6132.16,12386.07,0.00
2024-12-10 17:25:30,108,9303,60,48,6031.19,12386.44,0.00
2024-12-10 17:25:30,108,9304,60,48,6150.29,12387.00,0.00
2024-12-10 17:25:30,109,9304,60,49,6093.87,12387.01,0.00
2024-12-10 17:25:30,108,9304,59,49,6142.28,12387.06,0.00
2024-12-10 17:25:30,107,9304,59,48,6198.43,12387.08,0.00
2024-12-10 17:25:30,106,9304,59,47,6254.42,12387.09,0.00
2024-12-10 17:25:30,106,9305,59,47,6370.87,12388.00,0.00
2024-12-10 17:25:30,107,9305,59,48,6311.33,12388.01,0.00
2024-12-10 17:25:30,106,9305,58,48,6362.71,12388.07,0.00
2024-12-10 17:25:30,106,9306,58,48,6363.16,12389.00,0.00
2024-12-10 17:25:30,107,9306,58,49,6303.69,12389.01,0.00
2024-12-10 17:25:30,106,9306,57,49,6356.17,12389.06,0.00
2024-12-10 17:25:30,105,9306,56,49,6415.52,12389.06,0.00
2024-12-10 17:25:30,105,9307,56,49,6415.31,12390.00,0.00
2024-12-10 17:25:30,106,9307,57,49,6354.78,12390.01,0.00
2024-12-10 17:25:30,105,9307,57,48,6408.82,12390.06,0.00
2024-12-10 17:25:30,105,9308,57,48,6404.11,12391.00,0.00
2024-12-10 17:25:30,106,9308,57,49,6343.69,12391.01,0.00
2024-12-10 17:25:30,105,9308,57,48,6386.97,12391.14,0.00
2024-12-10 17:25:30,105,9309,57,48,6389.29,12392.00,0.00
2024-12-10 17:25:30,106,9309,57,49,6329.01,12392.01,0.00
2024-12-10 17:25:30,105,9309,57,48,6345.67,12392.34,0.00
2024-12-10 17:25:30,105,9310,57,48,6375.54,12393.00,0.00
2024-12-10 17:25:30,106,9310,57,49,6315.39,12393.01,0.00
2024-12-10 17:25:30,105,9310,57,48,6367.54,12393.06,0.00
2024-12-10 17:25:30,104,9310,57,47,6423.37,12393.10,0.00
2024-12-10 17:25:30,104,9311,57,47,6422.74,12394.00,0.00
2024-12-10 17:25:30,105,9311,57,48,6361.57,12394.01,0.00
2024-12-10 17:25:30,105,9312,57,48,6344.40,12395.00,0.00
2024-12-10 17:25:30,106,9312,58,48,6284.55,12395.01,0.00
2024-12-10 17:25:30,105,9312,57,48,6336.00,12395.06,0.00
2024-12-10 17:25:30,105,9313,57,48,6321.31,12396.00,0.00
2024-12-10 17:25:30,106,9313,57,49,6261.68,12396.01,0.00
2024-12-10 17:25:30,105,9313,57,48,6312.51,12396.06,0.00
2024-12-10 17:25:30,105,9314,57,48,6297.46,12397.00,0.00
2024-12-10 17:25:30,106,9314,57,49,6238.05,12397.01,0.00
2024-12-10 17:25:30,105,9314,56,49,6291.66,12397.03,0.00
2024-12-10 17:25:30,104,9314,55,49,6348.59,12397.05,0.00
2024-12-10 17:25:30,103,9314,55,48,6409.29,12397.05,0.00
2024-12-10 17:25:30,103,9315,55,48,6395.69,12398.00,0.00
2024-12-10 17:25:30,104,9315,56,48,6334.20,12398.01,0.00
2024-12-10 17:25:30,103,9315,55,48,6389.42,12398.06,0.00
2024-12-10 17:25:30,104,9314,56,48,6262.97,12398.53,0.00
2024-12-10 17:25:30,105,9313,56,49,6230.40,12398.74,0.00
2024-12-10 17:25:30,105,9314,56,49,6346.61,12399.00,0.00
2024-12-10 17:25:30,106,9314,56,50,6286.74,12399.01,0.00
2024-12-10 17:25:30,105,9314,56,49,6319.61,12399.20,0.00
2024-12-10 17:25:30,105,9315,56,49,6571.82,12400.00,0.00
2024-12-10 17:25:30,106,9315,57,49,6509.82,12400.01,0.00
2024-12-10 17:25:30,106,9316,57,49,6500.79,12401.00,0.00
2024-12-10 17:25:30,107,9316,57,50,6440.03,12401.01,0.00
2024-12-10 17:25:30,106,9316,57,49,6493.99,12401.06,0.00
2024-12-10 17:25:30,105,9316,57,48,6509.63,12401.42,0.00
2024-12-10 17:25:30,105,9317,57,48,6550.93,12402.00,0.00
2024-12-10 17:25:30,106,9317,58,48,6489.13,12402.01,0.00
2024-12-10 17:25:30,105,9317,57,48,6545.04,12402.05,0.00
2024-12-10 17:25:30,104,9317,56,48,6605.25,12402.07,0.00
2024-12-10 17:25:30,104,9318,56,48,6600.65,12403.00,0.00
2024-12-10 17:25:30,105,9318,56,49,6537.78,12403.01,0.00
2024-12-10 17:25:30,104,9318,55,49,6563.09,12403.28,0.00
2024-12-10 17:25:30,104,9319,55,49,6583.97,12404.00,0.00
2024-12-10 17:25:30,105,9319,55,50,6521.27,12404.01,0.00
2024-12-10 17:25:30,104,9319,54,50,6575.84,12404.07,0.00
2024-12-10 17:25:30,103,9319,53,50,6575.48,12404.50,0.00
2024-12-10 17:25:30,103,9320,53,50,6632.39,12405.00,0.00
2024-12-10 17:25:30,104,9320,53,51,6568.62,12405.01,0.00
2024-12-10 17:25:30,104,9321,53,51,6553.95,12406.00,0.00
2024-12-10 17:25:30,105,9321,53,52,6491.53,12406.01,0.00
2024-12-10 17:25:31,105,9322,53,52,6476.18,12407.00,0.00
2024-12-10 17:25:31,106,9322,54,52,6415.09,12407.01,0.00
2024-12-10 17:25:31,105,9322,54,51,6470.28,12407.05,0.00
2024-12-10 17:25:31,104,9322,53,51,6519.80,12407.14,0.00
2024-12-10 17:25:31,103,9322,52,51,6581.43,12407.16,0.00
2024-12-10 17:25:31,103,9323,52,51,6590.63,12408.00,0.00
2024-12-10 17:25:31,104,9323,52,52,6527.26,12408.01,0.00
2024-12-10 17:25:31,103,9323,52,51,6542.00,12408.37,0.00
2024-12-10 17:25:31,103,9324,52,51,6582.46,12409.00,0.00
2024-12-10 17:25:31,104,9324,53,51,6519.17,12409.01,0.00
2024-12-10 17:25:31,103,9324,53,50,6576.45,12409.05,0.00
2024-12-10 17:25:31,103,9325,53,50,6575.39,12410.00,0.00
2024-12-10 17:25:31,104,9325,54,50,6512.17,12410.01,0.00
2024-12-10 17:25:31,103,9325,53,50,6557.51,12410.15,0.00
2024-12-10 17:25:31,103,9326,53,50,6563.17,12411.00,0.00
2024-12-10 17:25:31,104,9326,54,50,6500.07,12411.01,0.00
2024-12-10 17:25:31,104,9327,54,50,6482.31,12412.00,0.00
2024-12-10 17:25:31,105,9327,55,50,6420.57,12412.01,0.00
2024-12-10 17:25:31,104,9327,55,49,6470.75,12412.10,0.00
2024-12-10 17:25:31,104,9328,55,49,6465.79,12413.00,0.00
2024-12-10 17:25:31,105,9328,56,49,6404.21,12413.01,0.00
2024-12-10 17:25:31,105,9329,56,49,6389.96,12414.00,0.00
2024-12-10 17:25:31,106,9329,57,49,6329.67,12414.01,0.00
2024-12-10 17:25:31,105,9329,56,49,6382.88,12414.06,0.00
2024-12-10 17:25:31,104,9329,56,48,6443.29,12414.06,0.00
2024-12-10 17:25:31,103,9329,55,48,6495.43,12414.14,0.00
2024-12-10 17:25:31,103,9330,55,48,6498.59,12415.00,0.00
2024-12-10 17:25:31,104,9330,55,49,6436.10,12415.01,0.00
2024-12-10 17:25:31,103,9330,54,49,6490.73,12415.07,0.00
2024-12-10 17:25:31,102,9330,54,48,6552.76,12415.08,0.00
2024-12-10 17:25:31,102,9331,54,48,6548.11,12416.00,0.00
2024-12-10 17:25:31,103,9331,54,49,6484.53,12416.01,0.00
2024-12-10 17:25:31,102,9331,54,48,6540.81,12416.06,0.00
2024-12-10 17:25:31,102,9332,54,48,6532.23,12417.00,0.00
2024-12-10 17:25:31,103,9332,55,48,6468.81,12417.01,0.00
2024-12-10 17:25:31,102,9332,54,48,6447.25,12417.69,0.00
2024-12-10 17:25:31,102,9333,54,48,6530.30,12418.00,0.00
2024-12-10 17:25:31,103,9333,55,48,6466.90,12418.01,0.00
2024-12-10 17:25:31,102,9333,54,48,6516.47,12418.12,0.00
2024-12-10 17:25:31,101,9333,53,48,6579.66,12418.13,0.00
2024-12-10 17:25:31,101,9334,53,48,6594.73,12419.00,0.00
2024-12-10 17:25:31,102,9334,53,49,6530.07,12419.01,0.00
2024-12-10 17:25:31,101,9334,53,48,6587.36,12419.06,0.00
2024-12-10 17:25:31,101,9335,53,48,6593.33,12420.00,0.00
2024-12-10 17:25:31,102,9335,54,48,6528.69,12420.01,0.00
2024-12-10 17:25:31,103,9334,54,49,6401.56,12420.54,0.00
2024-12-10 17:25:31,103,9335,54,49,6518.72,12421.00,0.00
2024-12-10 17:25:31,104,9335,54,50,6456.04,12421.01,0.00
2024-12-10 17:25:31,104,9336,54,50,6570.48,12422.00,0.00
2024-12-10 17:25:31,105,9336,55,50,6507.91,12422.01,0.00
2024-12-10 17:25:31,104,9336,54,50,6568.10,12422.02,0.00
2024-12-10 17:25:31,103,9336,53,50,6629.46,12422.03,0.00
2024-12-10 17:25:31,102,9336,53,49,6690.80,12422.05,0.00
2024-12-10 17:25:31,102,9337,53,49,6692.28,12423.00,0.00
2024-12-10 17:25:31,103,9337,53,50,6627.30,12423.01,0.00
2024-12-10 17:25:31,103,9338,53,50,6621.93,12424.00,0.00
2024-12-10 17:25:31,104,9338,54,50,6558.26,12424.01,0.00
2024-12-10 17:25:31,104,9339,54,50,6550.57,12425.00,0.00
2024-12-10 17:25:31,105,9339,55,50,6488.19,12425.01,0.00
2024-12-10 17:25:31,104,9339,55,49,6544.61,12425.05,0.00
2024-12-10 17:25:31,104,9340,55,49,6541.19,12426.00,0.00
2024-12-10 17:25:31,105,9340,56,49,6478.89,12426.01,0.00
2024-12-10 17:25:31,105,9341,56,49,6468.56,12427.00,0.00
2024-12-10 17:25:31,106,9341,57,49,6407.53,12427.01,0.00
2024-12-10 17:25:31,106,9342,57,49,6392.58,12428.00,0.00
2024-12-10 17:25:31,107,9342,58,49,6332.84,12428.01,0.00
2024-12-10 17:25:31,107,9343,58,49,6317.90,12429.00,0.00
2024-12-10 17:25:31,108,9343,59,49,6259.40,12429.01,0.00
2024-12-10 17:25:31,108,9344,59,49,6224.66,12430.00,0.00
2024-12-10 17:25:31,109,9344,59,50,6167.55,12430.01,0.00
2024-12-10 17:25:31,108,9344,59,49,6073.10,12430.71,0.00
2024-12-10 17:25:32,108,9345,59,49,6152.75,12431.00,0.00
2024-12-10 17:25:32,109,9345,60,49,6096.31,12431.01,0.00
2024-12-10 17:25:32,110,9344,60,50,5968.73,12431.61,0.00
2024-12-10 17:25:32,110,9345,60,50,6120.10,12432.00,0.00
2024-12-10 17:25:32,111,9345,60,51,6064.96,12432.01,0.00
2024-12-10 17:25:32,110,9345,60,50,6112.20,12432.06,0.00
2024-12-10 17:25:32,110,9346,60,50,6217.11,12433.00,0.00
2024-12-10 17:25:32,111,9346,60,51,6161.10,12433.01,0.00
2024-12-10 17:25:32,111,9347,60,51,6147.63,12434.00,0.00
2024-12-10 17:25:32,112,9347,60,52,6092.74,12434.01,0.00
2024-12-10 17:25:32,111,9347,59,52,6139.80,12434.06,0.00
2024-12-10 17:25:32,112,9346,60,52,6022.95,12434.58,0.00
2024-12-10 17:25:32,112,9347,60,52,6085.25,12435.00,0.00
2024-12-10 17:25:32,113,9347,60,53,6031.39,12435.01,0.00
2024-12-10 17:25:32,113,9348,60,53,6119.92,12436.00,0.00
2024-12-10 17:25:32,114,9348,60,54,6066.24,12436.01,0.00
2024-12-10 17:25:32,113,9348,60,53,6112.23,12436.06,0.00
2024-12-10 17:25:32,112,9348,60,52,6159.44,12436.12,0.00
2024-12-10 17:25:32,112,9349,60,52,6149.14,12437.00,0.00
2024-12-10 17:25:32,113,9349,61,52,6094.72,12437.01,0.00
2024-12-10 17:25:32,112,9349,61,51,6141.38,12437.06,0.00
2024-12-10 17:25:32,112,9350,61,51,6118.45,12438.00,0.00
2024-12-10 17:25:32,113,9350,62,51,6064.31,12438.01,0.00
2024-12-10 17:25:32,112,9350,61,51,6110.78,12438.06,0.00
2024-12-10 17:25:32,112,9351,61,51,6085.09,12439.00,0.00
2024-12-10 17:25:32,113,9351,61,52,6031.24,12439.01,0.00
2024-12-10 17:25:32,112,9351,60,52,6077.32,12439.06,0.00
2024-12-10 17:25:32,111,9351,60,51,6131.38,12439.06,0.00
2024-12-10 17:25:32,110,9351,59,51,6185.92,12439.07,0.00
2024-12-10 17:25:32,110,9352,59,51,6161.46,12440.00,0.00
2024-12-10 17:25:32,111,9352,59,52,6105.95,12440.01,0.00
2024-12-10 17:25:32,110,9352,59,51,6152.03,12440.08,0.00
2024-12-10 17:25:32,110,9353,59,51,6130.86,12441.00,0.00
2024-12-10 17:25:32,111,9353,59,52,6075.63,12441.01,0.00
2024-12-10 17:25:32,110,9353,58,52,6122.95,12441.06,0.00
2024-12-10 17:25:32,109,9353,57,52,6173.11,12441.11,0.00
2024-12-10 17:25:32,108,9353,56,52,6223.78,12441.16,0.00
2024-12-10 17:25:32,108,9354,56,52,6215.68,12442.00,0.00
2024-12-10 17:25:32,109,9354,56,53,6158.66,12442.01,0.00
2024-12-10 17:25:32,109,9355,56,53,6121.46,12443.00,0.00
2024-12-10 17:25:32,110,9355,56,54,6065.81,12443.01,0.00
2024-12-10 17:25:32,109,9355,56,53,6115.75,12443.05,0.00
2024-12-10 17:25:32,108,9355,55,53,6170.08,12443.06,0.00
2024-12-10 17:25:32,107,9355,55,52,6217.92,12443.13,0.00
2024-12-10 17:25:32,107,9356,55,52,6180.04,12444.00,0.00
2024-12-10 17:25:32,108,9356,55,53,6122.82,12444.01,0.00
2024-12-10 17:25:32,107,9356,54,53,6175.91,12444.04,0.00
2024-12-10 17:25:32,106,9356,54,52,6202.13,12444.28,0.00
2024-12-10 17:25:32,106,9357,54,52,6224.14,12445.00,0.00
2024-12-10 17:25:32,107,9357,55,52,6165.97,12445.01,0.00
2024-12-10 17:25:32,106,9357,55,51,6218.43,12445.05,0.00
2024-12-10 17:25:32,106,9358,55,51,6211.29,12446.00,0.00
2024-12-10 17:25:32,107,9358,56,51,6153.24,12446.01,0.00
2024-12-10 17:25:32,106,9358,56,50,6210.11,12446.01,0.00
2024-12-10 17:25:32,105,9358,56,49,6268.07,12446.01,0.00
2024-12-10 17:25:32,104,9358,55,49,6325.20,12446.03,0.00
2024-12-10 17:25:32,104,9359,55,49,6316.64,12447.00,0.00
2024-12-10 17:25:32,105,9359,56,49,6256.48,12447.01,0.00
2024-12-10 17:25:32,105,9360,56,49,6243.53,12448.00,0.00
2024-12-10 17:25:32,106,9360,56,50,6184.63,12448.01,0.00
2024-12-10 17:25:32,105,9360,55,50,6238.80,12448.04,0.00
2024-12-10 17:25:32,104,9360,54,50,6292.19,12448.09,0.00
2024-12-10 17:25:32,104,9361,54,50,6246.20,12449.00,0.00
2024-12-10 17:25:32,105,9361,55,50,6186.71,12449.01,0.00
2024-12-10 17:25:32,104,9361,55,49,6179.81,12449.50,0.00
2024-12-10 17:25:32,103,9361,54,49,6160.22,12449.75,0.00
2024-12-10 17:25:32,103,9362,54,49,6246.27,12450.00,0.00
2024-12-10 17:25:32,104,9362,54,50,6186.21,12450.01,0.00
2024-12-10 17:25:32,103,9362,54,49,6241.44,12450.04,0.00
2024-12-10 17:25:32,103,9363,54,49,6238.93,12451.00,0.00
2024-12-10 17:25:32,104,9363,54,50,6178.94,12451.01,0.00
2024-12-10 17:25:32,103,9363,53,50,6234.10,12451.04,0.00
2024-12-10 17:25:32,103,9364,53,50,6231.04,12452.00,0.00
2024-12-10 17:25:32,104,9364,53,51,6171.13,12452.01,0.00
2024-12-10 17:25:32,103,9364,53,50,6223.90,12452.06,0.00
2024-12-10 17:25:32,103,9365,53,50,6222.84,12453.00,0.00
2024-12-10 17:25:32,104,9365,53,51,6163.01,12453.01,0.00
2024-12-10 17:25:32,103,9365,52,51,6216.80,12453.05,0.00
2024-12-10 17:25:32,103,9366,52,51,6213.77,12454.00,0.00
2024-12-10 17:25:32,104,9366,53,51,6154.03,12454.01,0.00
2024-12-10 17:25:32,105,9365,54,51,6088.31,12454.09,0.00
2024-12-10 17:25:32,105,9366,54,51,6198.48,12455.00,0.00
2024-12-10 17:25:32,106,9366,54,52,6140.01,12455.01,0.00
2024-12-10 17:25:32,106,9367,54,52,6201.95,12456.00,0.00
2024-12-10 17:25:32,107,9367,55,52,6143.98,12456.01,0.00
2024-12-10 17:25:32,106,9367,54,52,6042.74,12456.73,0.00
2024-12-10 17:25:32,105,9367,53,52,6082.40,12456.79,0.00
2024-12-10 17:25:33,105,9368,53,52,6175.12,12457.00,0.00
2024-12-10 17:25:33,106,9368,53,53,6116.87,12457.01,0.00
2024-12-10 17:25:33,105,9368,52,53,6171.57,12457.03,0.00
2024-12-10 17:25:33,104,9368,52,52,6228.52,12457.04,0.00
2024-12-10 17:25:33,104,9369,52,52,6157.70,12458.00,0.00
2024-12-10 17:25:33,105,9369,53,52,6099.05,12458.01,0.00
2024-12-10 17:25:33,104,9369,52,52,6152.91,12458.04,0.00
2024-12-10 17:25:33,103,9369,51,52,6117.68,12458.70,0.00
2024-12-10 17:25:33,103,9370,51,52,6150.62,12459.00,0.00
2024-12-10 17:25:33,104,9370,52,52,6091.48,12459.01,0.00
2024-12-10 17:25:33,103,9370,52,51,6036.61,12459.74,0.00
2024-12-10 17:25:33,103,9371,52,51,6125.14,12460.00,0.00
2024-12-10 17:25:33,104,9371,52,52,6066.24,12460.01,0.00
2024-12-10 17:25:33,103,9371,51,52,6119.11,12460.05,0.00
2024-12-10 17:25:33,104,9370,51,53,5960.16,12460.84,0.00
2024-12-10 17:25:33,104,9371,51,53,6078.93,12461.00,0.00
2024-12-10 17:25:33,105,9371,51,54,6021.04,12461.01,0.00
2024-12-10 17:25:33,104,9371,50,54,6072.95,12461.05,0.00
2024-12-10 17:25:33,104,9372,50,54,6188.55,12462.00,0.00
2024-12-10 17:25:33,105,9372,50,55,6129.61,12462.01,0.00
2024-12-10 17:25:33,104,9372,49,55,6182.58,12462.05,0.00
2024-12-10 17:25:33,104,9373,49,55,6176.07,12463.00,0.00
2024-12-10 17:25:33,105,9373,49,56,6117.25,12463.01,0.00
2024-12-10 17:25:33,104,9373,48,56,6170.09,12463.05,0.00
2024-12-10 17:25:33,104,9374,48,56,6145.44,12464.00,0.00
2024-12-10 17:25:33,105,9374,49,56,6086.91,12464.01,0.00
2024-12-10 17:25:33,104,9374,49,55,6139.46,12464.05,0.00
2024-12-10 17:25:33,103,9374,49,54,6198.39,12464.05,0.00
2024-12-10 17:25:33,103,9375,49,54,6158.73,12465.00,0.00
2024-12-10 17:25:33,104,9375,50,54,6099.51,12465.01,0.00
2024-12-10 17:25:33,103,9375,50,53,6029.62,12465.79,0.00
2024-12-10 17:25:33,103,9376,50,53,6124.21,12466.00,0.00
2024-12-10 17:25:33,104,9376,50,54,6065.32,12466.01,0.00
2024-12-10 17:25:33,103,9376,50,53,6118.17,12466.05,0.00
2024-12-10 17:25:33,103,9377,50,53,6121.07,12467.00,0.00
2024-12-10 17:25:33,104,9377,50,54,6062.21,12467.01,0.00
2024-12-10 17:25:33,103,9377,50,53,6115.03,12467.05,0.00
2024-12-10 17:25:33,103,9378,50,53,6117.93,12468.00,0.00
2024-12-10 17:25:33,104,9378,51,53,6059.10,12468.01,0.00
2024-12-10 17:25:33,103,9378,51,52,6111.89,12468.05,0.00
2024-12-10 17:25:33,103,9379,51,52,6114.79,12469.00,0.00
2024-12-10 17:25:33,104,9379,52,52,6055.99,12469.01,0.00
2024-12-10 17:25:33,103,9379,52,51,6108.75,12469.05,0.00
2024-12-10 17:25:33,103,9380,52,51,6111.64,12470.00,0.00
2024-12-10 17:25:33,104,9380,53,51,6052.88,12470.01,0.00
2024-12-10 17:25:33,103,9380,52,51,6110.81,12470.01,0.00
2024-12-10 17:25:33,102,9380,51,51,6165.84,12470.04,0.00
2024-12-10 17:25:33,102,9381,51,51,6168.77,12471.00,0.00
2024-12-10 17:25:33,103,9381,52,51,6108.88,12471.01,0.00
2024-12-10 17:25:33,102,9381,51,51,6163.89,12471.04,0.00
2024-12-10 17:25:33,102,9382,51,51,6166.82,12472.00,0.00
2024-12-10 17:25:33,103,9382,51,52,6106.94,12472.01,0.00
2024-12-10 17:25:33,102,9382,50,52,6161.94,12472.04,0.00
2024-12-10 17:25:33,102,9383,50,52,6164.87,12473.00,0.00
2024-12-10 17:25:33,103,9383,51,52,6105.01,12473.01,0.00
2024-12-10 17:25:33,102,9383,50,52,6159.99,12473.04,0.00
2024-12-10 17:25:33,101,9383,50,51,6201.56,12473.19,0.00
2024-12-10 17:25:33,101,9383,50,51,6224.26,12474.00,0.00
2024-12-10 17:25:33,102,9383,51,51,6163.24,12474.01,0.00
2024-12-10 17:25:33,102,9384,51,51,6162.51,12475.00,0.00
2024-12-10 17:25:33,103,9384,51,52,6102.68,12475.01,0.00
2024-12-10 17:25:33,102,9384,51,51,6156.41,12475.05,0.00
2024-12-10 17:25:33,102,9385,51,51,6160.55,12476.00,0.00
2024-12-10 17:25:33,103,9385,51,52,6100.74,12476.01,0.00
2024-12-10 17:25:33,102,9385,51,51,6154.45,12476.05,0.00
2024-12-10 17:25:33,102,9386,51,51,6158.60,12477.00,0.00
2024-12-10 17:25:33,103,9386,52,51,6098.81,12477.01,0.00
2024-12-10 17:25:33,102,9386,52,50,6152.50,12477.05,0.00
2024-12-10 17:25:33,102,9387,52,50,6156.65,12478.00,0.00
2024-12-10 17:25:33,103,9387,53,50,6096.88,12478.01,0.00
2024-12-10 17:25:33,102,9387,52,50,6150.55,12478.05,0.00
2024-12-10 17:25:33,103,9386,52,51,6017.12,12478.66,0.00
2024-12-10 17:25:33,103,9387,52,51,6116.75,12479.00,0.00
2024-12-10 17:25:33,104,9387,53,51,6057.93,12479.01,0.00
2024-12-10 17:25:33,103,9387,52,51,6110.70,12479.05,0.00
2024-12-10 17:25:33,103,9388,52,51,6230.23,12480.00,0.00
2024-12-10 17:25:33,104,9388,53,51,6170.33,12480.01,0.00
2024-12-10 17:25:33,103,9388,53,50,6224.19,12480.05,0.00
2024-12-10 17:25:33,103,9389,53,50,6184.09,12481.00,0.00
2024-12-10 17:25:33,104,9389,53,51,6124.63,12481.01,0.00
2024-12-10 17:25:33,103,9389,52,51,6178.05,12481.05,0.00
2024-12-10 17:25:33,102,9389,52,50,6114.31,12481.69,0.00
2024-12-10 17:25:33,102,9390,52,50,6197.78,12482.00,0.00
2024-12-10 17:25:33,103,9390,53,50,6137.61,12482.01,0.00
2024-12-10 17:25:33,102,9390,52,50,6191.67,12482.05,0.00
2024-12-10 17:25:33,103,9389,52,51,6038.34,12482.79,0.00
2024-12-10 17:25:33,103,9390,52,51,6147.50,12483.00,0.00
2024-12-10 17:25:33,104,9390,53,51,6088.39,12483.01,0.00
2024-12-10 17:25:33,103,9390,52,51,6141.45,12483.05,0.00
2024-12-10 17:25:34,103,9391,52,51,6189.43,12484.00,0.00
2024-12-10 17:25:34,104,9391,52,52,6129.92,12484.01,0.00
2024-12-10 17:25:34,103,9391,51,52,6188.58,12484.01,0.00
2024-12-10 17:25:34,102,9391,50,52,6244.37,12484.04,0.00
2024-12-10 17:25:34,101,9391,49,52,6150.67,12484.92,0.00
2024-12-10 17:25:34,101,9392,49,52,6264.46,12485.00,0.00
2024-12-10 17:25:34,102,9392,49,53,6203.04,12485.01,0.00
2024-12-10 17:25:34,101,9392,49,52,6259.53,12485.04,0.00
2024-12-10 17:25:34,101,9393,49,52,6261.01,12486.00,0.00
2024-12-10 17:25:34,102,9393,50,52,6199.63,12486.01,0.00
2024-12-10 17:25:34,101,9393,49,52,6256.08,12486.04,0.00
2024-12-10 17:25:34,101,9394,49,52,6260.28,12487.00,0.00
2024-12-10 17:25:34,102,9394,50,52,6198.90,12487.01,0.00
2024-12-10 17:25:34,103,9393,51,52,6137.51,12487.04,0.00
2024-12-10 17:25:34,102,9393,51,51,6234.42,12487.05,0.00
2024-12-10 17:25:34,102,9394,51,51,6238.58,12488.00,0.00
2024-12-10 17:25:34,103,9394,51,52,6178.01,12488.01,0.00
2024-12-10 17:25:34,102,9394,51,51,6233.69,12488.04,0.00
2024-12-10 17:25:34,102,9395,51,51,6301.51,12489.00,0.00
2024-12-10 17:25:34,103,9395,51,52,6240.33,12489.01,0.00
2024-12-10 17:25:34,102,9395,50,52,6272.24,12489.24,0.00
2024-12-10 17:25:34,101,9395,50,51,6246.77,12489.69,0.00
2024-12-10 17:25:34,101,9396,50,51,6332.35,12490.00,0.00
2024-12-10 17:25:34,102,9396,50,52,6270.27,12490.01,0.00
2024-12-10 17:25:34,101,9396,49,52,6327.42,12490.04,0.00
2024-12-10 17:25:34,102,9395,50,52,6193.32,12490.64,0.00
2024-12-10 17:25:34,102,9396,50,52,6199.01,12491.00,0.00
2024-12-10 17:25:34,103,9396,50,53,6138.83,12491.01,0.00
2024-12-10 17:25:34,102,9396,50,52,6194.13,12491.04,0.00
2024-12-10 17:25:34,101,9396,50,51,6208.78,12491.41,0.00
2024-12-10 17:25:34,102,9395,50,52,6135.71,12491.52,0.00
2024-12-10 17:25:34,101,9395,50,51,6158.70,12491.69,0.00
2024-12-10 17:25:34,100,9395,50,50,6180.62,12491.73,0.00
2024-12-10 17:25:34,100,9396,50,50,6396.95,12492.00,0.00
2024-12-10 17:25:34,101,9396,51,50,6333.61,12492.01,0.00
2024-12-10 17:25:34,100,9396,51,49,6391.97,12492.04,0.00
2024-12-10 17:25:34,100,9397,51,49,6522.39,12493.00,0.00
2024-12-10 17:25:34,101,9397,51,50,6457.81,12493.01,0.00
2024-12-10 17:25:34,100,9397,51,49,6517.41,12493.04,0.00
2024-12-10 17:25:34,101,9396,51,50,6380.09,12493.64,0.00
2024-12-10 17:25:34,101,9397,51,50,6501.63,12494.00,0.00
2024-12-10 17:25:34,102,9397,51,51,6437.89,12494.01,0.00
2024-12-10 17:25:34,101,9397,51,50,6496.69,12494.04,0.00
2024-12-10 17:25:34,101,9398,51,50,6624.62,12495.00,0.00
2024-12-10 17:25:34,102,9398,51,51,6559.68,12495.01,0.00
2024-12-10 17:25:34,101,9398,50,51,6619.69,12495.04,0.00
2024-12-10 17:25:34,101,9399,50,51,6623.91,12496.00,0.00
2024-12-10 17:25:34,102,9399,50,52,6558.97,12496.01,0.00
2024-12-10 17:25:34,101,9399,50,51,6618.98,12496.04,0.00
2024-12-10 17:25:34,101,9400,50,51,6623.21,12497.00,0.00
2024-12-10 17:25:34,102,9400,50,52,6558.27,12497.01,0.00
2024-12-10 17:25:34,101,9400,50,51,6618.27,12497.04,0.00
2024-12-10 17:25:34,101,9401,50,51,6620.33,12498.00,0.00
2024-12-10 17:25:34,102,9401,51,51,6555.42,12498.01,0.00
2024-12-10 17:25:34,101,9401,50,51,6619.09,12498.01,0.00
2024-12-10 17:25:34,100,9401,49,51,6681.54,12498.03,0.00
2024-12-10 17:25:34,99,9401,48,51,6747.77,12498.03,0.00
2024-12-10 17:25:34,99,9402,48,51,6753.04,12499.00,0.00
2024-12-10 17:25:34,100,9402,49,51,6685.51,12499.01,0.00
2024-12-10 17:25:34,100,9403,49,51,6687.30,12500.00,0.00
2024-12-10 17:25:34,101,9403,49,52,6621.09,12500.01,0.00
2024-12-10 17:25:34,100,9403,48,52,6683.56,12500.03,0.00
2024-12-10 17:25:34,100,9404,48,52,6631.72,12501.00,0.00
2024-12-10 17:25:34,101,9404,49,52,6566.06,12501.01,0.00
2024-12-10 17:25:34,100,9404,49,51,6627.98,12501.03,0.00
2024-12-10 17:25:34,99,9404,49,50,6571.31,12501.71,0.00
2024-12-10 17:25:34,99,9405,49,50,6661.22,12502.00,0.00
2024-12-10 17:25:34,100,9405,50,50,6594.60,12502.01,0.00
2024-12-10 17:25:34,99,9405,49,50,6657.44,12502.03,0.00
2024-12-10 17:25:34,99,9406,49,50,6617.72,12503.00,0.00
2024-12-10 17:25:34,100,9406,50,50,6551.54,12503.01,0.00
2024-12-10 17:25:34,99,9406,50,49,6613.94,12503.03,0.00
2024-12-10 17:25:34,99,9407,50,49,6553.89,12504.00,0.00
2024-12-10 17:25:34,100,9407,50,50,6488.35,12504.01,0.00
2024-12-10 17:25:34,99,9407,50,49,6550.11,12504.03,0.00
2024-12-10 17:25:34,98,9407,50,48,6560.36,12504.31,0.00
2024-12-10 17:25:34,97,9407,49,48,6562.77,12504.75,0.00
2024-12-10 17:25:34,97,9408,49,48,6638.84,12505.00,0.00
2024-12-10 17:25:34,98,9408,50,48,6571.10,12505.01,0.00
2024-12-10 17:25:34,97,9408,50,47,6634.98,12505.03,0.00
2024-12-10 17:25:34,97,9409,50,47,6562.14,12506.00,0.00
2024-12-10 17:25:34,98,9409,51,47,6495.18,12506.01,0.00
2024-12-10 17:25:34,97,9409,51,46,6558.28,12506.03,0.00
2024-12-10 17:25:34,96,9409,51,45,6522.66,12506.81,0.00
2024-12-10 17:25:34,96,9410,51,45,6629.65,12507.00,0.00
2024-12-10 17:25:34,97,9410,51,46,6561.31,12507.01,0.00
2024-12-10 17:25:34,96,9410,50,46,6625.75,12507.03,0.00
2024-12-10 17:25:34,96,9411,50,46,6583.07,12508.00,0.00
2024-12-10 17:25:34,97,9411,51,46,6515.21,12508.01,0.00
2024-12-10 17:25:34,96,9411,51,45,6579.17,12508.03,0.00
2024-12-10 17:25:34,95,9411,51,44,6501.49,12508.78,0.00
2024-12-10 17:25:34,95,9412,51,44,6605.71,12509.00,0.00
2024-12-10 17:25:34,96,9412,52,44,6536.90,12509.01,0.00
2024-12-10 17:25:34,95,9412,51,44,6601.77,12509.03,0.00
2024-12-10 17:25:35,95,9413,51,44,6612.82,12510.00,0.00
2024-12-10 17:25:35,96,9413,51,45,6543.93,12510.01,0.00
2024-12-10 17:25:35,96,9414,51,45,6550.97,12511.00,0.00
2024-12-10 17:25:35,97,9414,52,45,6483.44,12511.01,0.00
2024-12-10 17:25:35,96,9414,51,45,6547.07,12511.03,0.00
2024-12-10 17:25:35,96,9415,51,45,6556.71,12512.00,0.00
2024-12-10 17:25:35,97,9415,51,46,6489.12,12512.01,0.00
2024-12-10 17:25:35,96,9415,50,46,6552.81,12512.03,0.00
2024-12-10 17:25:35,96,9416,50,46,6562.45,12513.00,0.00
2024-12-10 17:25:35,97,9416,51,46,6494.80,12513.01,0.00
2024-12-10 17:25:35,96,9416,50,46,6558.55,12513.03,0.00
2024-12-10 17:25:35,96,9417,50,46,6568.19,12514.00,0.00
2024-12-10 17:25:35,97,9417,50,47,6500.47,12514.01,0.00
2024-12-10 17:25:35,96,9417,49,47,6564.29,12514.03,0.00
2024-12-10 17:25:35,96,9418,49,47,6573.93,12515.00,0.00
2024-12-10 17:25:35,97,9418,49,48,6506.16,12515.01,0.00
2024-12-10 17:25:35,96,9418,49,47,6570.02,12515.03,0.00
2024-12-10 17:25:35,96,9419,49,47,6540.65,12516.00,0.00
2024-12-10 17:25:35,97,9419,50,47,6473.22,12516.01,0.00
2024-12-10 17:25:35,96,9419,50,46,6536.75,12516.03,0.00
2024-12-10 17:25:35,96,9420,50,46,6500.48,12517.00,0.00
2024-12-10 17:25:35,97,9420,50,47,6433.46,12517.01,0.00
2024-12-10 17:25:35,96,9420,49,47,6496.57,12517.03,0.00
2024-12-10 17:25:35,95,9420,49,46,6450.84,12517.79,0.00
2024-12-10 17:25:35,95,9421,49,46,6513.10,12518.00,0.00
2024-12-10 17:25:35,96,9421,50,46,6445.26,12518.01,0.00
2024-12-10 17:25:35,95,9421,49,46,6509.16,12518.03,0.00
2024-12-10 17:25:35,95,9422,49,46,6473.77,12519.00,0.00
2024-12-10 17:25:35,96,9422,49,47,6406.33,12519.01,0.00
2024-12-10 17:25:35,95,9422,49,46,6469.82,12519.03,0.00
2024-12-10 17:25:35,94,9422,48,46,6428.61,12519.79,0.00
2024-12-10 17:25:35,94,9423,48,46,6535.34,12520.00,0.00
2024-12-10 17:25:35,95,9423,48,47,6466.55,12520.01,0.00
2024-12-10 17:25:35,94,9423,47,47,6532.68,12520.02,0.00
2024-12-10 17:25:35,93,9423,46,47,6601.58,12520.02,0.00
2024-12-10 17:25:35,92,9423,46,46,6671.98,12520.02,0.00
2024-12-10 17:25:35,92,9424,46,46,6658.75,12521.00,0.00
2024-12-10 17:25:35,93,9424,46,47,6587.15,12521.01,0.00
2024-12-10 17:25:35,92,9424,46,46,6656.04,12521.02,0.00
2024-12-10 17:25:35,92,9425,46,46,6633.29,12522.00,0.00
2024-12-10 17:25:35,93,9425,47,46,6561.97,12522.01,0.00
2024-12-10 17:25:35,92,9425,46,46,6630.58,12522.02,0.00
2024-12-10 17:25:35,92,9426,46,46,6599.35,12523.00,0.00
2024-12-10 17:25:35,93,9426,46,47,6528.39,12523.01,0.00
2024-12-10 17:25:35,92,9426,46,46,6596.63,12523.02,0.00
2024-12-10 17:25:35,91,9426,45,46,6564.25,12523.82,0.00
2024-12-10 17:25:35,91,9427,45,46,6680.01,12524.00,0.00
2024-12-10 17:25:35,92,9427,46,46,6607.40,12524.01,0.00
2024-12-10 17:25:35,92,9428,46,46,6620.18,12525.00,0.00
2024-12-10 17:25:35,93,9428,47,46,6549.00,12525.01,0.00
2024-12-10 17:25:35,92,9428,46,46,6617.46,12525.02,0.00
2024-12-10 17:25:35,91,9428,46,45,6633.78,12525.21,0.00
2024-12-10 17:25:35,91,9429,46,45,6672.81,12526.00,0.00
2024-12-10 17:25:35,92,9429,46,46,6600.28,12526.01,0.00
2024-12-10 17:25:35,91,9429,45,46,6670.07,12526.02,0.00
2024-12-10 17:25:35,91,9430,45,46,6685.73,12527.00,0.00
2024-12-10 17:25:35,92,9430,46,46,6613.06,12527.01,0.00
2024-12-10 17:25:35,92,9431,46,46,6625.85,12528.00,0.00
2024-12-10 17:25:35,93,9431,46,47,6554.60,12528.01,0.00
2024-12-10 17:25:35,92,9431,45,47,6623.13,12528.02,0.00
2024-12-10 17:25:35,92,9432,45,47,6637.27,12529.00,0.00
2024-12-10 17:25:35,93,9432,46,47,6565.90,12529.01,0.00
2024-12-10 17:25:35,93,9433,46,47,6577.21,12530.00,0.00
2024-12-10 17:25:35,94,9433,46,48,6507.24,12530.01,0.00
2024-12-10 17:25:35,93,9433,46,47,6574.52,12530.02,0.00
2024-12-10 17:25:35,93,9434,46,47,6587.16,12531.00,0.00
2024-12-10 17:25:35,94,9434,47,47,6517.09,12531.01,0.00
2024-12-10 17:25:35,93,9434,46,47,6584.47,12531.02,0.00
2024-12-10 17:25:35,93,9435,46,47,6597.12,12532.00,0.00
2024-12-10 17:25:35,94,9435,47,47,6526.94,12532.01,0.00
2024-12-10 17:25:35,94,9436,47,47,6536.79,12533.00,0.00
2024-12-10 17:25:35,95,9436,48,47,6467.98,12533.01,0.00
2024-12-10 17:25:35,94,9436,48,46,6534.13,12533.02,0.00
2024-12-10 17:25:35,94,9437,48,46,6545.31,12534.00,0.00
2024-12-10 17:25:35,95,9437,48,47,6476.42,12534.01,0.00
2024-12-10 17:25:35,94,9437,48,46,6542.65,12534.02,0.00
2024-12-10 17:25:35,93,9437,48,45,6593.02,12534.17,0.00
2024-12-10 17:25:35,93,9438,48,45,6582.84,12535.00,0.00
2024-12-10 17:25:35,94,9438,48,46,6512.81,12535.01,0.00
2024-12-10 17:25:35,93,9438,48,45,6580.15,12535.02,0.00
2024-12-10 17:25:35,93,9439,48,45,6542.97,12536.00,0.00
2024-12-10 17:25:35,94,9439,49,45,6473.37,12536.01,0.00
2024-12-10 17:25:35,93,9439,48,45,6411.12,12536.86,0.00
2024-12-10 17:25:35,93,9440,48,45,6528.52,12537.00,0.00
2024-12-10 17:25:35,94,9440,48,46,6459.07,12537.01,0.00
2024-12-10 17:25:35,93,9440,47,46,6525.83,12537.02,0.00
2024-12-10 17:25:36,93,9441,47,46,6538.48,12538.00,0.00
2024-12-10 17:25:36,94,9441,48,46,6468.92,12538.01,0.00
2024-12-10 17:25:36,93,9441,47,46,6535.79,12538.02,0.00
2024-12-10 17:25:36,93,9442,47,46,6548.44,12539.00,0.00
2024-12-10 17:25:36,94,9442,47,47,6478.78,12539.01,0.00
2024-12-10 17:25:36,93,9442,47,46,6545.75,12539.02,0.00
2024-12-10 17:25:36,93,9443,47,46,6558.40,12540.00,0.00
2024-12-10 17:25:36,94,9443,47,47,6488.63,12540.01,0.00
2024-12-10 17:25:36,93,9443,47,46,6555.71,12540.02,0.00
2024-12-10 17:25:36,93,9444,47,46,6568.36,12541.00,0.00
2024-12-10 17:25:36,94,9444,47,47,6498.49,12541.01,0.00
2024-12-10 17:25:36,93,9444,47,46,6565.67,12541.02,0.00
2024-12-10 17:25:36,93,9445,47,46,6578.33,12542.00,0.00
2024-12-10 17:25:36,94,9445,48,46,6508.34,12542.01,0.00
2024-12-10 17:25:36,93,9445,48,45,6575.63,12542.02,0.00
2024-12-10 17:25:36,93,9446,48,45,6520.03,12543.00,0.00
2024-12-10 17:25:36,94,9446,48,46,6450.67,12543.01,0.00
2024-12-10 17:25:36,93,9446,47,46,6370.17,12543.84,0.00
2024-12-10 17:25:36,93,9447,47,46,6484.96,12544.00,0.00
2024-12-10 17:25:36,94,9447,48,46,6415.97,12544.01,0.00
2024-12-10 17:25:36,94,9448,48,46,6425.82,12545.00,0.00
2024-12-10 17:25:36,95,9448,49,46,6358.18,12545.01,0.00
2024-12-10 17:25:36,94,9448,48,46,6421.83,12545.03,0.00
2024-12-10 17:25:36,94,9449,48,46,6434.34,12546.00,0.00
2024-12-10 17:25:36,95,9449,49,46,6366.61,12546.01,0.00
2024-12-10 17:25:36,94,9449,48,46,6430.35,12546.03,0.00
2024-12-10 17:25:36,94,9450,48,46,6442.86,12547.00,0.00
2024-12-10 17:25:36,95,9450,48,47,6375.04,12547.01,0.00
2024-12-10 17:25:36,94,9450,47,47,6438.87,12547.03,0.00
2024-12-10 17:25:36,94,9451,47,47,6451.39,12548.00,0.00
2024-12-10 17:25:36,95,9451,47,48,6383.48,12548.01,0.00
2024-12-10 17:25:36,95,9452,47,48,6391.91,12549.00,0.00
2024-12-10 17:25:36,96,9452,48,48,6325.33,12549.01,0.00
2024-12-10 17:25:36,95,9452,47,48,6387.96,12549.03,0.00
2024-12-10 17:25:36,95,9453,47,48,6355.21,12550.00,0.00
2024-12-10 17:25:36,96,9453,48,48,6289.01,12550.01,0.00
2024-12-10 17:25:36,95,9453,48,47,6351.25,12550.03,0.00
2024-12-10 17:25:36,95,9454,48,47,6313.37,12551.00,0.00
2024-12-10 17:25:36,96,9454,49,47,6247.61,12551.01,0.00
2024-12-10 17:25:36,95,9454,49,46,6208.27,12551.77,0.00
2024-12-10 17:25:36,95,9455,49,46,6311.52,12552.00,0.00
2024-12-10 17:25:36,96,9455,50,46,6245.78,12552.01,0.00
2024-12-10 17:25:36,95,9455,50,45,6307.57,12552.03,0.00
2024-12-10 17:25:36,95,9456,50,45,6250.77,12553.00,0.00
2024-12-10 17:25:36,96,9456,50,46,6185.66,12553.01,0.00
2024-12-10 17:25:36,97,9455,50,47,6121.89,12553.03,0.00
2024-12-10 17:25:36,96,9455,50,46,6125.02,12553.84,0.00
2024-12-10 17:25:36,96,9456,50,46,6236.31,12554.00,0.00
2024-12-10 17:25:36,97,9456,51,46,6172.02,12554.01,0.00
2024-12-10 17:25:36,96,9456,50,46,6232.40,12554.03,0.00
2024-12-10 17:25:36,95,9456,49,46,6259.70,12554.17,0.00
2024-12-10 17:25:36,95,9457,49,46,6420.08,12555.00,0.00
2024-12-10 17:25:36,96,9457,50,46,6353.20,12555.01,0.00
2024-12-10 17:25:36,95,9457,50,45,6414.81,12555.04,0.00
2024-12-10 17:25:36,95,9458,50,45,6427.20,12556.00,0.00
2024-12-10 17:25:36,96,9458,51,45,6360.25,12556.01,0.00
2024-12-10 17:25:36,95,9458,50,45,6421.93,12556.04,0.00
2024-12-10 17:25:36,95,9459,50,45,6434.32,12557.00,0.00
2024-12-10 17:25:36,96,9459,50,46,6367.30,12557.01,0.00
2024-12-10 17:25:36,95,9459,50,45,6429.05,12557.04,0.00
2024-12-10 17:25:36,95,9460,50,45,6441.44,12558.00,0.00
2024-12-10 17:25:36,96,9460,50,46,6374.34,12558.01,0.00
2024-12-10 17:25:36,96,9461,50,46,6381.39,12559.00,0.00
2024-12-10 17:25:36,97,9461,51,46,6315.60,12559.01,0.00
2024-12-10 17:25:36,96,9461,50,46,6374.87,12559.05,0.00
2024-12-10 17:25:36,96,9462,50,46,6387.13,12560.00,0.00
2024-12-10 17:25:36,97,9462,50,47,6321.29,12560.01,0.00
2024-12-10 17:25:36,97,9463,50,47,6326.97,12561.00,0.00
2024-12-10 17:25:36,98,9463,50,48,6262.41,12561.01,0.00
2024-12-10 17:25:36,97,9463,50,47,6319.22,12561.06,0.00
2024-12-10 17:25:36,97,9464,50,47,6302.02,12562.00,0.00
2024-12-10 17:25:36,98,9464,50,48,6237.72,12562.01,0.00
2024-12-10 17:25:36,97,9464,49,48,6222.67,12562.44,0.00
2024-12-10 17:25:36,97,9465,49,48,6258.17,12563.00,0.00
2024-12-10 17:25:36,98,9465,50,48,6194.31,12563.01,0.00
2024-12-10 17:25:36,97,9465,50,47,6250.42,12563.06,0.00
2024-12-10 17:25:36,97,9466,50,47,6229.66,12564.00,0.00
2024-12-10 17:25:36,98,9466,51,47,6166.09,12564.01,0.00
2024-12-10 17:25:36,97,9466,50,47,6221.91,12564.06,0.00
2024-12-10 17:25:36,96,9466,50,46,6169.55,12564.71,0.00
2024-12-10 17:25:36,96,9467,50,46,6264.03,12565.00,0.00
2024-12-10 17:25:36,97,9467,51,46,6199.45,12565.01,0.00
2024-12-10 17:25:36,96,9467,50,46,6256.19,12565.06,0.00
2024-12-10 17:25:37,96,9468,50,46,6269.76,12566.00,0.00
2024-12-10 17:25:37,97,9468,50,47,6205.12,12566.01,0.00
2024-12-10 17:25:37,98,9467,51,47,6134.13,12566.09,0.00
2024-12-10 17:25:37,98,9468,51,47,6273.09,12567.00,0.00
2024-12-10 17:25:37,99,9468,52,47,6209.73,12567.01,0.00
2024-12-10 17:25:37,100,9467,53,47,6147.63,12567.03,0.00
2024-12-10 17:25:37,99,9467,53,46,6219.90,12567.07,0.00
2024-12-10 17:25:37,99,9468,53,46,6357.49,12568.00,0.00
2024-12-10 17:25:37,100,9468,53,47,6293.91,12568.01,0.00
2024-12-10 17:25:37,100,9469,53,47,6421.36,12569.00,0.00
2024-12-10 17:25:37,101,9469,53,48,6357.78,12569.01,0.00
2024-12-10 17:25:37,100,9469,52,48,6413.84,12569.07,0.00
2024-12-10 17:25:37,100,9470,52,48,6423.12,12570.00,0.00
2024-12-10 17:25:37,101,9470,52,49,6359.53,12570.01,0.00
2024-12-10 17:25:37,102,9469,53,49,6297.18,12570.03,0.00
2024-12-10 17:25:37,102,9470,53,49,6301.38,12571.00,0.00
2024-12-10 17:25:37,103,9470,54,49,6240.20,12571.01,0.00
2024-12-10 17:25:37,102,9470,53,49,6292.78,12571.07,0.00
2024-12-10 17:25:37,102,9471,53,49,6422.67,12572.00,0.00
2024-12-10 17:25:37,103,9471,53,50,6360.31,12572.01,0.00
2024-12-10 17:25:37,102,9471,53,49,6414.07,12572.07,0.00
2024-12-10 17:25:37,102,9472,53,49,6420.72,12573.00,0.00
2024-12-10 17:25:37,103,9472,53,50,6358.38,12573.01,0.00
2024-12-10 17:25:37,102,9472,52,50,6412.11,12573.07,0.00
2024-12-10 17:25:37,102,9473,52,50,6418.76,12574.00,0.00
2024-12-10 17:25:37,103,9473,52,51,6356.44,12574.01,0.00
2024-12-10 17:25:37,102,9473,51,51,6410.15,12574.07,0.00
2024-12-10 17:25:37,102,9474,51,51,6416.81,12575.00,0.00
2024-12-10 17:25:37,103,9474,52,51,6354.51,12575.01,0.00
2024-12-10 17:25:37,102,9474,52,50,6408.20,12575.07,0.00
2024-12-10 17:25:37,102,9475,52,50,6414.85,12576.00,0.00
2024-12-10 17:25:37,103,9475,53,50,6352.57,12576.01,0.00
2024-12-10 17:25:37,103,9476,53,50,6350.63,12577.00,0.00
2024-12-10 17:25:37,104,9476,53,51,6289.57,12577.01,0.00
2024-12-10 17:25:37,104,9477,53,51,6286.44,12578.00,0.00
2024-12-10 17:25:37,105,9477,53,52,6226.57,12578.01,0.00
2024-12-10 17:25:37,104,9477,52,52,6278.13,12578.07,0.00
2024-12-10 17:25:37,103,9477,52,51,6337.87,12578.07,0.00
2024-12-10 17:25:37,103,9478,52,51,6343.23,12579.00,0.00
2024-12-10 17:25:37,104,9478,52,52,6282.24,12579.01,0.00
2024-12-10 17:25:37,103,9478,51,52,6334.70,12579.07,0.00
2024-12-10 17:25:37,103,9479,51,52,6340.07,12580.00,0.00
2024-12-10 17:25:37,104,9479,52,52,6279.11,12580.01,0.00
2024-12-10 17:25:37,103,9479,51,52,6331.54,12580.07,0.00
2024-12-10 17:25:37,103,9480,51,52,6336.91,12581.00,0.00
2024-12-10 17:25:37,104,9480,52,52,6275.98,12581.01,0.00
2024-12-10 17:25:37,103,9480,52,51,6328.38,12581.07,0.00
2024-12-10 17:25:37,103,9481,52,51,6333.75,12582.00,0.00
2024-12-10 17:25:37,104,9481,52,52,6272.85,12582.01,0.00
2024-12-10 17:25:37,103,9481,52,51,6327.65,12582.05,0.00
2024-12-10 17:25:37,102,9481,51,51,6387.23,12582.06,0.00
2024-12-10 17:25:37,101,9481,51,50,6449.22,12582.06,0.00
2024-12-10 17:25:37,101,9482,51,50,6455.95,12583.00,0.00
2024-12-10 17:25:37,102,9482,52,50,6392.65,12583.01,0.00
2024-12-10 17:25:37,102,9483,52,50,6391.93,12584.00,0.00
2024-12-10 17:25:37,103,9483,52,51,6329.87,12584.01,0.00
2024-12-10 17:25:37,102,9483,52,50,6384.54,12584.06,0.00
2024-12-10 17:25:37,102,9484,52,50,6389.97,12585.00,0.00
2024-12-10 17:25:37,103,9484,53,50,6327.93,12585.01,0.00
2024-12-10 17:25:37,102,9484,53,49,6382.58,12585.06,0.00
2024-12-10 17:25:37,102,9485,53,49,6388.01,12586.00,0.00
2024-12-10 17:25:37,103,9485,53,50,6325.99,12586.01,0.00
2024-12-10 17:25:37,102,9485,52,50,6380.62,12586.06,0.00
2024-12-10 17:25:37,102,9486,52,50,6386.05,12587.00,0.00
2024-12-10 17:25:37,103,9486,52,51,6324.05,12587.01,0.00
2024-12-10 17:25:37,102,9486,51,51,6378.66,12587.06,0.00
2024-12-10 17:25:37,101,9486,50,51,6440.57,12587.06,0.00
2024-12-10 17:25:37,100,9486,49,51,6468.48,12587.19,0.00
2024-12-10 17:25:37,100,9487,49,51,6492.89,12588.00,0.00
2024-12-10 17:25:37,101,9487,49,52,6428.60,12588.01,0.00
2024-12-10 17:25:37,101,9488,49,52,6429.11,12589.00,0.00
2024-12-10 17:25:37,102,9488,49,53,6366.08,12589.01,0.00
2024-12-10 17:25:37,101,9488,49,52,6421.65,12589.06,0.00
2024-12-10 17:25:37,102,9487,50,52,6236.55,12589.75,0.00
2024-12-10 17:25:37,102,9488,50,52,6356.50,12590.00,0.00
2024-12-10 17:25:37,103,9488,51,52,6294.78,12590.01,0.00
2024-12-10 17:25:37,102,9488,50,52,6352.80,12590.03,0.00
2024-12-10 17:25:37,101,9488,49,52,6411.97,12590.05,0.00
2024-12-10 17:25:37,100,9488,48,52,6431.03,12590.35,0.00
2024-12-10 17:25:37,100,9489,48,52,6601.46,12591.00,0.00
2024-12-10 17:25:37,101,9489,49,52,6536.10,12591.01,0.00
2024-12-10 17:25:37,102,9488,50,52,6472.02,12591.03,0.00
2024-12-10 17:25:37,101,9488,50,51,6559.79,12591.03,0.00
2024-12-10 17:25:37,100,9488,50,50,6621.62,12591.05,0.00
2024-12-10 17:25:37,99,9488,50,49,6687.23,12591.05,0.00
2024-12-10 17:25:37,99,9489,50,49,6695.38,12592.00,0.00
2024-12-10 17:25:37,100,9489,51,49,6628.42,12592.01,0.00
2024-12-10 17:25:37,99,9489,50,49,6690.31,12592.04,0.00
2024-12-10 17:25:37,99,9490,50,49,6824.38,12593.00,0.00
2024-12-10 17:25:38,100,9490,50,50,6756.14,12593.01,0.00
2024-12-10 17:25:38,99,9490,49,50,6821.85,12593.02,0.00
2024-12-10 17:25:38,98,9490,49,49,6888.90,12593.03,0.00
2024-12-10 17:25:38,97,9490,49,48,6958.62,12593.03,0.00
2024-12-10 17:25:38,97,9491,49,48,6966.95,12594.00,0.00
2024-12-10 17:25:38,98,9491,50,48,6895.85,12594.01,0.00
2024-12-10 17:25:38,97,9491,50,47,6963.07,12594.03,0.00
2024-12-10 17:25:38,97,9492,50,47,6971.39,12595.00,0.00
2024-12-10 17:25:38,98,9492,51,47,6900.26,12595.01,0.00
2024-12-10 17:25:38,97,9492,51,46,6967.52,12595.03,0.00
2024-12-10 17:25:38,98,9491,52,46,6795.28,12595.86,0.00
2024-12-10 17:25:38,98,9492,52,46,6921.37,12596.00,0.00
2024-12-10 17:25:38,99,9492,52,47,6851.46,12596.01,0.00
2024-12-10 17:25:38,99,9493,52,47,6981.79,12597.00,0.00
2024-12-10 17:25:38,100,9493,52,48,6911.97,12597.01,0.00
2024-12-10 17:25:38,99,9493,52,47,6977.99,12597.03,0.00
2024-12-10 17:25:38,99,9494,52,47,6983.61,12598.00,0.00
2024-12-10 17:25:38,100,9494,53,47,6913.78,12598.01,0.00
2024-12-10 17:25:38,101,9493,53,48,6845.32,12598.03,0.00
2024-12-10 17:25:38,101,9494,53,48,6855.85,12599.00,0.00
2024-12-10 17:25:38,102,9494,54,48,6788.63,12599.01,0.00
2024-12-10 17:25:38,101,9494,53,48,6852.12,12599.03,0.00
2024-12-10 17:25:38,101,9495,53,48,6979.90,12600.00,0.00
2024-12-10 17:25:38,102,9495,54,48,6911.47,12600.01,0.00
2024-12-10 17:25:38,101,9495,54,47,6976.17,12600.03,0.00
2024-12-10 17:25:38,101,9496,54,47,6979.20,12601.00,0.00
2024-12-10 17:25:38,102,9496,55,47,6910.78,12601.01,0.00
2024-12-10 17:25:38,101,9496,54,47,6975.48,12601.03,0.00
2024-12-10 17:25:38,101,9497,54,47,6978.51,12602.00,0.00
2024-12-10 17:25:38,102,9497,55,47,6910.09,12602.01,0.00
2024-12-10 17:25:38,103,9496,56,47,6786.86,12602.48,0.00
2024-12-10 17:25:38,103,9497,56,47,6901.06,12603.00,0.00
2024-12-10 17:25:38,104,9497,57,47,6834.70,12603.01,0.00
2024-12-10 17:25:38,104,9498,57,47,6904.10,12604.00,0.00
2024-12-10 17:25:38,105,9498,58,47,6838.35,12604.01,0.00
2024-12-10 17:25:38,104,9498,58,46,6900.48,12604.03,0.00
2024-12-10 17:25:38,105,9497,58,47,6744.42,12604.75,0.00
2024-12-10 17:25:38,104,9497,58,46,6768.30,12604.77,0.00
2024-12-10 17:25:38,104,9498,58,46,6860.62,12605.00,0.00
2024-12-10 17:25:38,105,9498,58,47,6795.28,12605.01,0.00
2024-12-10 17:25:38,104,9498,57,47,6857.00,12605.03,0.00
2024-12-10 17:25:38,103,9498,56,47,6916.85,12605.05,0.00
2024-12-10 17:25:38,103,9499,56,47,7042.22,12606.00,0.00
2024-12-10 17:25:38,104,9499,56,48,6974.51,12606.01,0.00
2024-12-10 17:25:38,104,9500,56,48,6913.55,12607.00,0.00
2024-12-10 17:25:38,105,9500,57,48,6847.71,12607.01,0.00
2024-12-10 17:25:38,104,9500,57,47,6909.93,12607.03,0.00
2024-12-10 17:25:38,103,9500,57,46,6793.63,12607.99,0.00
2024-12-10 17:25:38,103,9501,57,46,6914.81,12608.00,0.00
2024-12-10 17:25:38,104,9501,58,46,6848.32,12608.01,0.00
2024-12-10 17:25:38,103,9501,57,46,6911.15,12608.03,0.00
2024-12-10 17:25:38,103,9502,57,46,6911.69,12609.00,0.00
2024-12-10 17:25:38,104,9502,58,46,6845.23,12609.01,0.00
2024-12-10 17:25:38,104,9503,58,46,6842.13,12610.00,0.00
2024-12-10 17:25:38,105,9503,58,47,6776.97,12610.01,0.00
2024-12-10 17:25:38,104,9503,58,46,6838.51,12610.03,0.00
2024-12-10 17:25:38,104,9504,58,46,6836.97,12611.00,0.00
2024-12-10 17:25:38,105,9504,58,47,6771.86,12611.01,0.00
2024-12-10 17:25:38,104,9504,57,47,6833.35,12611.03,0.00
2024-12-10 17:25:38,104,9505,57,47,6786.11,12612.00,0.00
2024-12-10 17:25:38,105,9505,58,47,6721.48,12612.01,0.00
2024-12-10 17:25:38,104,9505,58,46,6782.48,12612.03,0.00
2024-12-10 17:25:38,103,9505,57,46,6808.10,12612.34,0.00
2024-12-10 17:25:38,103,9506,57,46,6847.75,12613.00,0.00
2024-12-10 17:25:38,104,9506,58,46,6781.91,12613.01,0.00
2024-12-10 17:25:38,103,9506,57,46,6844.09,12613.03,0.00
2024-12-10 17:25:38,104,9505,58,46,6714.17,12613.56,0.00
2024-12-10 17:25:38,104,9506,58,46,6830.96,12614.00,0.00
2024-12-10 17:25:38,105,9506,59,46,6765.91,12614.01,0.00
2024-12-10 17:25:38,104,9506,59,45,6827.34,12614.03,0.00
2024-12-10 17:25:38,104,9507,59,45,6826.25,12615.00,0.00
2024-12-10 17:25:38,105,9507,60,45,6761.24,12615.01,0.00
2024-12-10 17:25:38,104,9507,60,44,6822.63,12615.03,0.00
2024-12-10 17:25:38,103,9507,59,44,6743.94,12615.83,0.00
2024-12-10 17:25:38,102,9507,58,44,6759.33,12615.86,0.00
2024-12-10 17:25:38,103,9506,59,44,6686.41,12615.93,0.00
2024-12-10 17:25:38,103,9507,59,44,6807.73,12616.00,0.00
2024-12-10 17:25:38,104,9507,60,44,6742.27,12616.01,0.00
2024-12-10 17:25:38,105,9506,61,44,6676.87,12616.04,0.00
2024-12-10 17:25:38,104,9506,60,44,6799.30,12616.04,0.00
2024-12-10 17:25:38,104,9507,60,44,6846.24,12617.00,0.00
2024-12-10 17:25:38,105,9507,61,44,6781.04,12617.01,0.00
2024-12-10 17:25:38,104,9507,61,43,6842.62,12617.03,0.00
2024-12-10 17:25:38,103,9507,60,43,6767.92,12617.82,0.00
2024-12-10 17:25:38,103,9508,60,43,6989.81,12618.00,0.00
2024-12-10 17:25:38,104,9508,60,44,6922.60,12618.01,0.00
2024-12-10 17:25:38,103,9508,59,44,6986.15,12618.03,0.00
2024-12-10 17:25:38,103,9509,59,44,6938.94,12619.00,0.00
2024-12-10 17:25:38,104,9509,60,44,6872.22,12619.01,0.00
2024-12-10 17:25:38,103,9509,60,43,6935.28,12619.03,0.00
2024-12-10 17:25:39,103,9510,60,43,6840.80,12620.00,0.00
2024-12-10 17:25:39,104,9510,61,43,6775.03,12620.01,0.00
2024-12-10 17:25:39,103,9510,61,42,6837.14,12620.03,0.00
2024-12-10 17:25:39,102,9510,60,42,6698.62,12620.95,0.00
2024-12-10 17:25:39,102,9511,60,42,6816.21,12621.00,0.00
2024-12-10 17:25:39,103,9511,60,43,6750.04,12621.01,0.00
2024-12-10 17:25:39,102,9511,60,42,6812.52,12621.03,0.00
2024-12-10 17:25:39,101,9511,59,42,6750.78,12621.72,0.00
2024-12-10 17:25:39,100,9511,59,41,6801.79,12621.76,0.00
2024-12-10 17:25:39,100,9512,59,41,6897.92,12622.00,0.00
2024-12-10 17:25:39,101,9512,60,41,6829.62,12622.01,0.00
2024-12-10 17:25:39,102,9511,60,42,6677.56,12622.71,0.00
2024-12-10 17:25:39,102,9512,60,42,6801.57,12623.00,0.00
2024-12-10 17:25:39,103,9512,60,43,6735.53,12623.01,0.00
2024-12-10 17:25:39,102,9512,60,42,6797.87,12623.03,0.00
2024-12-10 17:25:39,102,9513,60,42,6923.39,12624.00,0.00
2024-12-10 17:25:39,103,9513,60,43,6856.18,12624.01,0.00
2024-12-10 17:25:39,102,9513,59,43,6919.70,12624.03,0.00
2024-12-10 17:25:39,103,9512,59,44,6820.70,12624.30,0.00
2024-12-10 17:25:39,103,9513,59,44,6937.62,12625.00,0.00
2024-12-10 17:25:39,104,9513,60,44,6870.91,12625.01,0.00
2024-12-10 17:25:39,105,9512,60,45,6726.37,12625.66,0.00
2024-12-10 17:25:39,105,9513,60,45,6963.54,12626.00,0.00
2024-12-10 17:25:39,106,9513,61,45,6897.84,12626.01,0.00
2024-12-10 17:25:39,105,9513,61,44,6959.94,12626.03,0.00
2024-12-10 17:25:39,105,9514,61,44,7078.33,12627.00,0.00
2024-12-10 17:25:39,106,9514,62,44,7011.56,12627.01,0.00
2024-12-10 17:25:39,106,9515,62,44,6944.56,12628.00,0.00
2024-12-10 17:25:39,107,9515,62,45,6879.66,12628.01,0.00
2024-12-10 17:25:39,106,9515,61,45,6826.77,12628.67,0.00
2024-12-10 17:25:39,106,9516,61,45,6847.98,12629.00,0.00
2024-12-10 17:25:39,107,9516,62,45,6783.98,12629.01,0.00
2024-12-10 17:25:39,106,9516,61,45,6844.42,12629.03,0.00
2024-12-10 17:25:39,105,9516,61,44,6786.33,12629.79,0.00
2024-12-10 17:25:39,105,9517,61,44,6880.34,12630.00,0.00
2024-12-10 17:25:39,106,9517,62,44,6815.43,12630.01,0.00
2024-12-10 17:25:39,105,9517,62,43,6876.75,12630.03,0.00
2024-12-10 17:25:39,105,9518,62,43,6874.87,12631.00,0.00
2024-12-10 17:25:39,106,9518,62,44,6810.01,12631.01,0.00
2024-12-10 17:25:39,105,9518,61,44,6871.27,12631.03,0.00
2024-12-10 17:25:39,105,9519,61,44,6869.40,12632.00,0.00
2024-12-10 17:25:39,106,9519,62,44,6804.59,12632.01,0.00
2024-12-10 17:25:39,105,9519,61,44,6865.80,12632.03,0.00
2024-12-10 17:25:39,105,9520,61,44,6863.93,12633.00,0.00
2024-12-10 17:25:39,106,9520,61,45,6799.17,12633.01,0.00
2024-12-10 17:25:39,105,9520,60,45,6860.33,12633.03,0.00
2024-12-10 17:25:39,105,9521,60,45,6858.45,12634.00,0.00
2024-12-10 17:25:39,106,9521,60,46,6793.75,12634.01,0.00
2024-12-10 17:25:39,105,9521,60,45,6854.86,12634.03,0.00
2024-12-10 17:25:39,105,9522,60,45,6711.49,12635.00,0.00
2024-12-10 17:25:39,106,9522,60,46,6648.17,12635.01,0.00
2024-12-10 17:25:39,105,9522,59,46,6581.73,12635.81,0.00
2024-12-10 17:25:39,104,9522,58,46,6609.45,12635.84,0.00
2024-12-10 17:25:39,104,9523,58,46,6710.44,12636.00,0.00
2024-12-10 17:25:39,105,9523,58,47,6646.53,12636.01,0.00
2024-12-10 17:25:39,104,9523,57,47,6706.81,12636.03,0.00
2024-12-10 17:25:39,105,9522,58,47,6543.41,12636.84,0.00
2024-12-10 17:25:39,105,9523,58,47,6597.64,12637.00,0.00
2024-12-10 17:25:39,106,9523,58,48,6535.40,12637.01,0.00
2024-12-10 17:25:39,105,9523,58,47,6450.07,12637.85,0.00
2024-12-10 17:25:39,106,9522,58,48,6378.56,12637.94,0.00
2024-12-10 17:25:39,106,9523,58,48,6615.87,12638.00,0.00
2024-12-10 17:25:39,107,9523,58,49,6554.04,12638.01,0.00
2024-12-10 17:25:39,106,9523,57,49,6612.31,12638.03,0.00
2024-12-10 17:25:39,106,9524,57,49,6728.48,12639.00,0.00
2024-12-10 17:25:39,107,9524,57,50,6665.59,12639.01,0.00
2024-12-10 17:25:39,106,9524,57,49,6724.91,12639.03,0.00
2024-12-10 17:25:39,106,9525,57,49,6718.02,12640.00,0.00
2024-12-10 17:25:39,107,9525,57,50,6655.24,12640.01,0.00
2024-12-10 17:25:39,106,9525,57,49,6714.46,12640.03,0.00
2024-12-10 17:25:39,106,9526,57,49,6653.36,12641.00,0.00
2024-12-10 17:25:39,107,9526,58,49,6591.18,12641.01,0.00
2024-12-10 17:25:39,106,9526,58,48,6649.79,12641.03,0.00
2024-12-10 17:25:39,105,9526,57,48,6583.66,12641.66,0.00
2024-12-10 17:25:39,105,9527,57,48,6640.39,12642.00,0.00
2024-12-10 17:25:39,106,9527,58,48,6577.75,12642.01,0.00
2024-12-10 17:25:39,105,9527,57,48,6636.79,12642.03,0.00
2024-12-10 17:25:39,104,9527,57,47,6621.24,12642.47,0.00
2024-12-10 17:25:39,104,9527,57,47,6575.60,12643.00,0.00
2024-12-10 17:25:39,105,9527,57,48,6512.98,12643.01,0.00
2024-12-10 17:25:39,104,9527,57,47,6571.97,12643.03,0.00
2024-12-10 17:25:39,103,9527,57,46,6421.65,12643.94,0.00
2024-12-10 17:25:39,103,9528,57,46,6537.09,12644.00,0.00
2024-12-10 17:25:39,104,9528,58,46,6474.23,12644.01,0.00
2024-12-10 17:25:39,103,9528,57,46,6533.42,12644.03,0.00
2024-12-10 17:25:39,102,9528,57,45,6352.19,12644.91,0.00
2024-12-10 17:25:40,102,9529,57,45,6428.11,12645.00,0.00
2024-12-10 17:25:40,103,9529,57,46,6365.71,12645.01,0.00
2024-12-10 17:25:40,102,9529,56,46,6424.41,12645.03,0.00
2024-12-10 17:25:40,101,9529,56,45,6340.54,12645.84,0.00
2024-12-10 17:25:40,101,9530,56,45,6281.02,12646.00,0.00
2024-12-10 17:25:40,102,9530,57,45,6219.44,12646.01,0.00
2024-12-10 17:25:40,101,9530,56,45,6277.28,12646.03,0.00
2024-12-10 17:25:40,100,9530,56,44,6178.78,12646.86,0.00
2024-12-10 17:25:40,99,9530,55,44,6190.99,12646.87,0.00
2024-12-10 17:25:40,98,9530,55,43,6225.01,12646.90,0.00
2024-12-10 17:25:40,98,9531,55,43,6341.24,12647.00,0.00
2024-12-10 17:25:40,99,9531,56,43,6277.19,12647.01,0.00
2024-12-10 17:25:40,98,9531,56,42,6337.38,12647.03,0.00
2024-12-10 17:25:40,97,9531,55,42,6301.56,12647.67,0.00
2024-12-10 17:25:40,97,9532,55,42,6390.50,12648.00,0.00
2024-12-10 17:25:40,98,9532,56,42,6325.29,12648.01,0.00
2024-12-10 17:25:40,97,9532,56,41,6386.60,12648.03,0.00
2024-12-10 17:25:40,97,9533,56,41,6368.09,12649.00,0.00
2024-12-10 17:25:40,98,9533,57,41,6303.11,12649.01,0.00
2024-12-10 17:25:40,97,9533,56,41,6364.19,12649.03,0.00
2024-12-10 17:25:40,97,9534,56,41,6305.03,12650.00,0.00
2024-12-10 17:25:40,98,9534,57,41,6240.69,12650.01,0.00
2024-12-10 17:25:40,97,9534,56,41,6301.13,12650.03,0.00
2024-12-10 17:25:40,98,9533,56,42,6176.29,12650.53,0.00
2024-12-10 17:25:40,98,9534,56,42,6245.06,12651.00,0.00
2024-12-10 17:25:40,99,9534,57,42,6181.98,12651.01,0.00
2024-12-10 17:25:40,98,9534,56,42,6080.35,12651.79,0.00
2024-12-10 17:25:40,97,9534,56,41,6105.93,12651.83,0.00
2024-12-10 17:25:40,97,9535,56,41,6346.06,12652.00,0.00
2024-12-10 17:25:40,98,9535,56,42,6281.31,12652.01,0.00
2024-12-10 17:25:40,97,9535,55,42,6342.16,12652.03,0.00
2024-12-10 17:25:40,96,9535,55,41,6311.70,12652.63,0.00
2024-12-10 17:25:40,96,9536,55,41,6396.35,12653.00,0.00
2024-12-10 17:25:40,97,9536,56,41,6330.41,12653.01,0.00
2024-12-10 17:25:40,96,9536,56,40,6392.41,12653.03,0.00
2024-12-10 17:25:40,95,9536,56,39,6458.36,12653.03,0.00
2024-12-10 17:25:40,95,9537,56,39,6414.40,12654.00,0.00
2024-12-10 17:25:40,96,9537,57,39,6347.58,12654.01,0.00
2024-12-10 17:25:40,96,9538,57,39,6305.76,12655.00,0.00
2024-12-10 17:25:40,97,9538,58,39,6240.75,12655.01,0.00
2024-12-10 17:25:40,96,9538,57,39,6300.50,12655.04,0.00
2024-12-10 17:25:40,95,9538,57,38,6258.57,12655.83,0.00
2024-12-10 17:25:40,95,9539,57,38,6370.63,12656.00,0.00
2024-12-10 17:25:40,96,9539,58,38,6304.27,12656.01,0.00
2024-12-10 17:25:40,96,9540,58,38,6311.36,12657.00,0.00
2024-12-10 17:25:40,97,9540,59,38,6246.29,12657.01,0.00
2024-12-10 17:25:40,96,9540,59,37,6304.79,12657.05,0.00
2024-12-10 17:25:40,96,9541,59,37,6317.13,12658.00,0.00
2024-12-10 17:25:40,97,9541,60,37,6252.00,12658.01,0.00
2024-12-10 17:25:40,96,9541,60,36,6310.56,12658.05,0.00
2024-12-10 17:25:40,96,9542,60,36,6322.90,12659.00,0.00
2024-12-10 17:25:40,97,9542,61,36,6257.72,12659.01,0.00
2024-12-10 17:25:40,96,9542,60,36,6316.33,12659.05,0.00
2024-12-10 17:25:40,96,9543,60,36,6328.68,12660.00,0.00
2024-12-10 17:25:40,97,9543,61,36,6263.43,12660.01,0.00
2024-12-10 17:25:40,96,9543,61,35,6322.10,12660.05,0.00
2024-12-10 17:25:40,96,9544,61,35,6263.99,12661.00,0.00
2024-12-10 17:25:40,97,9544,62,35,6199.41,12661.01,0.00
2024-12-10 17:25:40,96,9544,62,34,6257.41,12661.05,0.00
2024-12-10 17:25:40,95,9544,62,33,6168.30,12661.89,0.00
2024-12-10 17:25:40,95,9545,62,33,6288.34,12662.00,0.00
2024-12-10 17:25:40,96,9545,62,34,6222.84,12662.01,0.00
2024-12-10 17:25:40,95,9545,62,33,6281.70,12662.05,0.00
2024-12-10 17:25:40,96,9544,62,34,6204.40,12662.17,0.00
2024-12-10 17:25:40,96,9545,62,34,6351.28,12663.00,0.00
2024-12-10 17:25:40,97,9545,63,34,6285.81,12663.01,0.00
2024-12-10 17:25:40,96,9545,62,34,6344.71,12663.05,0.00
2024-12-10 17:25:40,96,9546,62,34,6488.98,12664.00,0.00
2024-12-10 17:25:40,97,9546,63,34,6422.08,12664.01,0.00
2024-12-10 17:25:40,96,9546,62,34,6482.40,12664.05,0.00
2024-12-10 17:25:40,96,9547,62,34,6421.81,12665.00,0.00
2024-12-10 17:25:40,97,9547,62,35,6355.61,12665.01,0.00
2024-12-10 17:25:40,96,9547,61,35,6415.23,12665.05,0.00
2024-12-10 17:25:40,95,9547,60,35,6344.85,12665.83,0.00
2024-12-10 17:25:40,95,9548,60,35,6456.99,12666.00,0.00
2024-12-10 17:25:40,96,9548,61,35,6389.73,12666.01,0.00
2024-12-10 17:25:40,95,9548,60,35,6449.01,12666.06,0.00
2024-12-10 17:25:40,95,9549,60,35,6464.17,12667.00,0.00
2024-12-10 17:25:40,96,9549,60,36,6396.83,12667.01,0.00
2024-12-10 17:25:40,95,9549,59,36,6456.19,12667.06,0.00
2024-12-10 17:25:40,94,9549,58,36,6523.52,12667.06,0.00
2024-12-10 17:25:40,94,9550,58,36,6473.54,12668.00,0.00
2024-12-10 17:25:40,95,9550,59,36,6405.40,12668.01,0.00
2024-12-10 17:25:40,94,9550,59,35,6465.47,12668.06,0.00
2024-12-10 17:25:40,93,9550,58,35,6399.71,12668.80,0.00
2024-12-10 17:25:40,93,9551,58,35,6510.23,12669.00,0.00
2024-12-10 17:25:40,94,9551,59,35,6440.97,12669.01,0.00
2024-12-10 17:25:40,93,9551,59,34,6502.07,12669.06,0.00
2024-12-10 17:25:40,94,9550,59,35,6431.56,12669.10,0.00
2024-12-10 17:25:40,93,9550,58,35,6493.98,12669.39,0.00
2024-12-10 17:25:40,92,9550,57,35,6475.12,12669.54,0.00
2024-12-10 17:25:40,92,9551,57,35,6555.34,12670.00,0.00
2024-12-10 17:25:40,93,9551,57,36,6484.86,12670.01,0.00
2024-12-10 17:25:41,93,9552,57,36,6632.52,12671.00,0.00
2024-12-10 17:25:41,94,9552,57,37,6561.96,12671.01,0.00
2024-12-10 17:25:41,93,9552,56,37,6621.66,12671.09,0.00
2024-12-10 17:25:41,93,9553,56,37,6611.02,12672.00,0.00
2024-12-10 17:25:41,94,9553,57,37,6540.69,12672.01,0.00
2024-12-10 17:25:41,93,9553,57,36,6600.15,12672.09,0.00
2024-12-10 17:25:41,92,9553,56,36,6597.83,12672.46,0.00
2024-12-10 17:25:41,92,9554,56,36,6667.10,12673.00,0.00
2024-12-10 17:25:41,93,9554,57,36,6595.41,12673.01,0.00
2024-12-10 17:25:41,92,9554,57,35,6656.11,12673.09,0.00
2024-12-10 17:25:41,92,9555,57,35,6678.64,12674.00,0.00
2024-12-10 17:25:41,93,9555,57,36,6606.83,12674.01,0.00
2024-12-10 17:25:41,92,9555,57,35,6667.66,12674.09,0.00
2024-12-10 17:25:41,93,9554,58,35,6568.74,12674.32,0.00
2024-12-10 17:25:41,93,9555,58,35,6650.97,12675.00,0.00
2024-12-10 17:25:41,94,9555,59,35,6580.21,12675.01,0.00
2024-12-10 17:25:41,93,9555,58,35,6640.10,12675.09,0.00
2024-12-10 17:25:41,93,9556,58,35,6797.33,12676.00,0.00
2024-12-10 17:25:41,94,9556,58,36,6725.02,12676.01,0.00
2024-12-10 17:25:41,93,9556,57,36,6786.46,12676.09,0.00
2024-12-10 17:25:41,93,9557,57,36,6737.66,12677.00,0.00
2024-12-10 17:25:41,94,9557,57,37,6665.98,12677.01,0.00
2024-12-10 17:25:41,93,9557,57,36,6726.79,12677.09,0.00
2024-12-10 17:25:41,92,9557,56,36,6727.26,12677.57,0.00
2024-12-10 17:25:41,92,9558,56,36,6810.29,12678.00,0.00
2024-12-10 17:25:41,93,9558,57,36,6737.06,12678.01,0.00
2024-12-10 17:25:41,92,9558,57,35,6799.30,12678.09,0.00
2024-12-10 17:25:41,92,9559,57,35,6777.77,12679.00,0.00
2024-12-10 17:25:41,93,9559,57,36,6704.89,12679.01,0.00
2024-12-10 17:25:41,92,9559,57,35,6766.77,12679.09,0.00
2024-12-10 17:25:41,92,9560,57,35,6739.20,12680.00,0.00
2024-12-10 17:25:41,93,9560,58,35,6666.73,12680.01,0.00
2024-12-10 17:25:41,92,9560,57,35,6728.21,12680.09,0.00
2024-12-10 17:25:41,93,9559,57,36,6585.17,12680.67,0.00
2024-12-10 17:25:41,93,9560,57,36,6697.61,12681.00,0.00
2024-12-10 17:25:41,94,9560,58,36,6626.36,12681.01,0.00
2024-12-10 17:25:41,95,9559,59,36,6548.62,12681.09,0.00
2024-12-10 17:25:41,94,9559,58,36,6631.79,12681.10,0.00
2024-12-10 17:25:41,93,9559,57,36,6559.45,12681.65,0.00
2024-12-10 17:25:41,92,9559,56,36,6577.83,12681.67,0.00
2024-12-10 17:25:41,92,9560,56,36,6749.71,12682.00,0.00
2024-12-10 17:25:41,93,9560,57,36,6677.13,12682.01,0.00
2024-12-10 17:25:41,93,9561,57,36,6784.14,12683.00,0.00
2024-12-10 17:25:41,94,9561,57,37,6711.97,12683.01,0.00
2024-12-10 17:25:41,93,9561,56,37,6771.90,12683.10,0.00
2024-12-10 17:25:41,94,9560,56,38,6681.00,12683.27,0.00
2024-12-10 17:25:41,93,9560,56,37,6742.95,12683.97,0.00
2024-12-10 17:25:41,93,9561,56,37,6875.27,12684.00,0.00
2024-12-10 17:25:41,94,9561,57,37,6802.13,12684.01,0.00
2024-12-10 17:25:41,94,9562,57,37,6947.06,12685.00,0.00
2024-12-10 17:25:41,95,9562,58,37,6873.93,12685.01,0.00
2024-12-10 17:25:41,94,9562,57,37,6934.94,12685.10,0.00
2024-12-10 17:25:41,94,9563,57,37,6955.70,12686.00,0.00
2024-12-10 17:25:41,95,9563,58,37,6882.48,12686.01,0.00
2024-12-10 17:25:41,94,9563,58,36,6943.59,12686.10,0.00
2024-12-10 17:25:41,94,9564,58,36,6964.35,12687.00,0.00
2024-12-10 17:25:41,95,9564,59,36,6891.04,12687.01,0.00
2024-12-10 17:25:41,95,9565,59,36,6899.60,12688.00,0.00
2024-12-10 17:25:41,96,9565,59,37,6827.73,12688.01,0.00
2024-12-10 17:25:41,95,9565,59,36,6887.61,12688.09,0.00
2024-12-10 17:25:41,95,9566,59,36,6906.82,12689.00,0.00
2024-12-10 17:25:41,96,9566,60,36,6834.87,12689.01,0.00
2024-12-10 17:25:41,95,9566,60,35,6900.15,12689.05,0.00
2024-12-10 17:25:41,94,9566,60,34,6968.18,12689.08,0.00
2024-12-10 17:25:41,93,9566,59,34,7041.74,12689.09,0.00
2024-12-10 17:25:41,93,9567,59,34,7062.73,12690.00,0.00
2024-12-10 17:25:41,94,9567,59,35,6987.60,12690.01,0.00
2024-12-10 17:25:41,93,9567,58,35,7051.84,12690.09,0.00
2024-12-10 17:25:41,93,9568,58,35,7072.84,12691.00,0.00
2024-12-10 17:25:41,94,9568,58,36,6997.60,12691.01,0.00
2024-12-10 17:25:41,94,9569,58,36,7007.60,12692.00,0.00
2024-12-10 17:25:41,95,9569,59,36,6933.84,12692.01,0.00
2024-12-10 17:25:41,94,9569,58,36,6994.13,12692.11,0.00
2024-12-10 17:25:41,94,9570,58,36,7016.25,12693.00,0.00
2024-12-10 17:25:41,95,9570,59,36,6942.40,12693.01,0.00
2024-12-10 17:25:41,94,9570,59,35,7002.78,12693.11,0.00
2024-12-10 17:25:41,94,9571,59,35,7024.91,12694.00,0.00
2024-12-10 17:25:41,95,9571,60,35,6950.96,12694.01,0.00
2024-12-10 17:25:41,95,9572,60,35,6959.53,12695.00,0.00
2024-12-10 17:25:41,96,9572,60,36,6887.03,12695.01,0.00
2024-12-10 17:25:41,95,9572,59,36,6946.20,12695.11,0.00
2024-12-10 17:25:41,95,9573,59,36,6966.76,12696.00,0.00
2024-12-10 17:25:41,96,9573,59,37,6894.19,12696.01,0.00
2024-12-10 17:25:41,96,9574,59,37,6901.34,12697.00,0.00
2024-12-10 17:25:41,97,9574,60,37,6830.20,12697.01,0.00
2024-12-10 17:25:41,98,9573,61,37,6759.20,12697.04,0.00
2024-12-10 17:25:41,98,9574,61,37,6871.17,12698.00,0.00
2024-12-10 17:25:41,99,9574,61,38,6801.76,12698.01,0.00
2024-12-10 17:25:41,98,9574,60,38,6869.87,12698.01,0.00
2024-12-10 17:25:42,97,9574,59,38,6927.65,12698.10,0.00
2024-12-10 17:25:42,96,9574,59,37,6998.49,12698.10,0.00
2024-12-10 17:25:42,96,9575,59,37,7149.80,12699.00,0.00
2024-12-10 17:25:42,97,9575,59,38,7076.09,12699.01,0.00
2024-12-10 17:25:42,98,9574,59,39,6993.55,12699.11,0.00
2024-12-10 17:25:42,98,9575,59,39,7042.02,12700.00,0.00
2024-12-10 17:25:42,99,9575,60,39,6970.89,12700.01,0.00
2024-12-10 17:25:42,99,9576,60,39,7102.29,12701.00,0.00
2024-12-10 17:25:42,100,9576,60,40,7031.27,12701.01,0.00
2024-12-10 17:25:42,100,9577,60,40,7032.12,12702.00,0.00
2024-12-10 17:25:42,101,9577,60,41,6962.50,12702.01,0.00
2024-12-10 17:25:42,100,9577,59,41,7029.59,12702.02,0.00
2024-12-10 17:25:42,100,9578,59,41,7029.99,12703.00,0.00
2024-12-10 17:25:42,101,9578,60,41,6960.38,12703.01,0.00
2024-12-10 17:25:42,100,9578,59,41,7017.33,12703.10,0.00
2024-12-10 17:25:42,99,9578,59,40,7083.22,12703.12,0.00
2024-12-10 17:25:42,99,9579,59,40,7087.99,12704.00,0.00
2024-12-10 17:25:42,100,9579,60,40,7017.11,12704.01,0.00
2024-12-10 17:25:42,99,9579,60,39,7081.60,12704.05,0.00
2024-12-10 17:25:42,98,9579,59,39,7147.40,12704.09,0.00
2024-12-10 17:25:42,97,9579,59,38,7219.78,12704.09,0.00
2024-12-10 17:25:42,97,9580,59,38,7225.44,12705.00,0.00
2024-12-10 17:25:42,98,9580,59,39,7151.71,12705.01,0.00
2024-12-10 17:25:42,98,9581,59,39,7148.71,12706.00,0.00
2024-12-10 17:25:42,99,9581,60,39,7076.50,12706.01,0.00
2024-12-10 17:25:42,98,9581,59,39,7135.52,12706.09,0.00
2024-12-10 17:25:42,99,9580,60,39,7021.18,12706.44,0.00
2024-12-10 17:25:42,100,9579,60,40,6967.67,12706.79,0.00
2024-12-10 17:25:42,100,9580,60,40,7092.39,12707.00,0.00
2024-12-10 17:25:42,101,9580,61,40,7022.17,12707.01,0.00
2024-12-10 17:25:42,101,9581,61,40,7272.79,12708.00,0.00
2024-12-10 17:25:42,102,9581,61,41,7201.49,12708.01,0.00
2024-12-10 17:25:42,103,9580,62,41,7046.73,12708.70,0.00
2024-12-10 17:25:42,103,9581,62,41,7163.18,12709.00,0.00
2024-12-10 17:25:42,104,9581,62,42,7094.30,12709.01,0.00
2024-12-10 17:25:42,103,9581,61,42,7152.12,12709.09,0.00
2024-12-10 17:25:42,104,9580,61,43,7027.29,12709.55,0.00
2024-12-10 17:25:42,104,9581,61,43,7262.29,12710.00,0.00
2024-12-10 17:25:42,105,9581,62,43,7193.13,12710.01,0.00
2024-12-10 17:25:42,106,9580,62,44,7053.55,12710.59,0.00
2024-12-10 17:25:42,107,9579,62,45,6982.01,12710.98,0.00
2024-12-10 17:25:42,107,9580,62,45,7218.42,12711.00,0.00
2024-12-10 17:25:42,108,9580,62,46,7151.58,12711.01,0.00
2024-12-10 17:25:42,108,9581,62,46,7376.79,12712.00,0.00
2024-12-10 17:25:42,109,9581,62,47,7309.11,12712.01,0.00
2024-12-10 17:25:42,110,9580,62,48,7231.15,12712.12,0.00
2024-12-10 17:25:42,111,9579,63,48,7261.08,12712.25,0.00
2024-12-10 17:25:42,111,9580,63,48,7359.71,12713.00,0.00
2024-12-10 17:25:42,112,9580,64,48,7294.00,12713.01,0.00
2024-12-10 17:25:42,111,9580,63,48,7349.44,12713.08,0.00
2024-12-10 17:25:42,110,9580,62,48,7415.10,12713.08,0.00
2024-12-10 17:25:42,111,9579,62,49,7319.72,12713.32,0.00
2024-12-10 17:25:42,111,9580,62,49,7607.19,12714.00,0.00
2024-12-10 17:25:42,112,9580,63,49,7539.26,12714.01,0.00
2024-12-10 17:25:42,113,9579,64,49,7443.36,12714.26,0.00
2024-12-10 17:25:42,112,9579,64,48,7494.85,12714.63,0.00
2024-12-10 17:25:42,112,9580,64,48,7675.67,12715.00,0.00
2024-12-10 17:25:42,113,9580,65,48,7607.74,12715.01,0.00
2024-12-10 17:25:42,112,9580,64,48,7605.33,12715.46,0.00
2024-12-10 17:25:42,112,9581,64,48,7746.40,12716.00,0.00
2024-12-10 17:25:42,113,9581,65,48,7677.84,12716.01,0.00
2024-12-10 17:25:42,112,9581,64,48,7735.08,12716.09,0.00
2024-12-10 17:25:42,111,9581,63,48,7803.62,12716.09,0.00
2024-12-10 17:25:42,111,9582,63,48,7784.03,12717.00,0.00
2024-12-10 17:25:42,112,9582,63,49,7714.53,12717.01,0.00
2024-12-10 17:25:42,113,9581,63,50,7557.70,12717.73,0.00
2024-12-10 17:25:42,113,9582,63,50,7633.38,12718.00,0.00
2024-12-10 17:25:42,114,9582,63,51,7566.42,12718.01,0.00
2024-12-10 17:25:42,113,9582,63,50,7622.17,12718.09,0.00
2024-12-10 17:25:42,114,9581,63,51,7526.36,12718.33,0.00
2024-12-10 17:25:42,114,9582,63,51,7649.28,12719.00,0.00
2024-12-10 17:25:42,115,9582,64,51,7582.76,12719.01,0.00
2024-12-10 17:25:42,114,9582,64,50,7524.77,12719.87,0.00
2024-12-10 17:25:42,114,9583,64,50,7731.30,12720.00,0.00
2024-12-10 17:25:42,115,9583,65,50,7664.07,12720.01,0.00
2024-12-10 17:25:42,114,9583,64,50,7643.27,12720.34,0.00
2024-12-10 17:25:42,114,9584,64,50,7671.65,12721.00,0.00
2024-12-10 17:25:42,115,9584,65,50,7604.94,12721.01,0.00
2024-12-10 17:25:42,115,9585,65,50,7590.05,12722.00,0.00
2024-12-10 17:25:42,116,9585,66,50,7524.62,12722.01,0.00
2024-12-10 17:25:42,115,9585,65,50,7583.43,12722.05,0.00
2024-12-10 17:25:42,114,9585,64,50,7644.39,12722.09,0.00
2024-12-10 17:25:42,113,9585,64,49,7710.92,12722.09,0.00
2024-12-10 17:25:42,113,9586,64,49,7708.11,12723.00,0.00
2024-12-10 17:25:42,114,9586,64,50,7640.49,12723.01,0.00
2024-12-10 17:25:42,114,9587,64,50,7626.58,12724.00,0.00
2024-12-10 17:25:42,115,9587,64,51,7560.27,12724.01,0.00
2024-12-10 17:25:42,114,9587,63,51,7624.36,12724.02,0.00
2024-12-10 17:25:42,113,9587,63,50,7682.85,12724.08,0.00
2024-12-10 17:25:42,112,9587,63,49,7750.31,12724.08,0.00
2024-12-10 17:25:43,112,9588,63,49,7747.48,12725.00,0.00
2024-12-10 17:25:43,113,9588,64,49,7678.92,12725.01,0.00
2024-12-10 17:25:43,112,9588,63,49,7742.95,12725.04,0.00
2024-12-10 17:25:43,111,9588,62,49,7806.99,12725.07,0.00
2024-12-10 17:25:43,110,9588,62,48,7876.81,12725.07,0.00
2024-12-10 17:25:43,110,9588,62,48,7875.07,12726.00,0.00
2024-12-10 17:25:43,111,9588,62,49,7804.13,12726.01,0.00
2024-12-10 17:25:43,111,9589,62,49,7793.27,12727.00,0.00
2024-12-10 17:25:43,112,9589,62,50,7723.69,12727.01,0.00
2024-12-10 17:25:43,111,9589,61,50,7784.14,12727.07,0.00
2024-12-10 17:25:43,111,9590,61,50,7781.28,12728.00,0.00
2024-12-10 17:25:43,112,9590,62,50,7711.80,12728.01,0.00
2024-12-10 17:25:43,112,9591,62,50,7699.90,12729.00,0.00
2024-12-10 17:25:43,113,9591,62,51,7631.76,12729.01,0.00
2024-12-10 17:25:43,112,9591,61,51,7690.84,12729.07,0.00
2024-12-10 17:25:43,112,9592,61,51,7686.87,12730.00,0.00
2024-12-10 17:25:43,113,9592,61,52,7618.84,12730.01,0.00
2024-12-10 17:25:43,112,9592,60,52,7677.81,12730.07,0.00
2024-12-10 17:25:43,112,9593,60,52,7673.83,12731.00,0.00
2024-12-10 17:25:43,113,9593,61,52,7605.92,12731.01,0.00
2024-12-10 17:25:43,113,9594,61,52,7592.15,12732.00,0.00
2024-12-10 17:25:43,114,9594,62,52,7525.55,12732.01,0.00
2024-12-10 17:25:43,114,9595,62,52,7506.74,12733.00,0.00
2024-12-10 17:25:43,115,9595,63,52,7441.47,12733.01,0.00
2024-12-10 17:25:43,116,9594,63,53,7294.40,12733.59,0.00
2024-12-10 17:25:43,116,9595,63,53,7391.34,12734.00,0.00
2024-12-10 17:25:43,117,9595,64,53,7328.16,12734.01,0.00
2024-12-10 17:25:43,117,9596,64,53,7404.80,12735.00,0.00
2024-12-10 17:25:43,118,9596,65,53,7342.05,12735.01,0.00
2024-12-10 17:25:43,118,9597,65,53,7257.45,12736.00,0.00
2024-12-10 17:25:43,119,9597,66,53,7196.46,12736.01,0.00
2024-12-10 17:25:43,118,9597,66,52,7246.51,12736.06,0.00
2024-12-10 17:25:43,117,9597,66,51,7209.35,12736.50,0.00
2024-12-10 17:25:43,117,9598,66,51,7255.45,12737.00,0.00
2024-12-10 17:25:43,118,9598,67,51,7193.97,12737.01,0.00
2024-12-10 17:25:43,117,9598,67,50,7246.78,12737.07,0.00
2024-12-10 17:25:43,116,9598,67,49,7266.56,12737.29,0.00
2024-12-10 17:25:43,116,9599,67,49,7286.81,12738.00,0.00
2024-12-10 17:25:43,117,9599,68,49,7224.53,12738.01,0.00
2024-12-10 17:25:43,116,9599,68,48,7278.05,12738.07,0.00
2024-12-10 17:25:43,117,9598,69,48,7201.72,12738.20,0.00
2024-12-10 17:25:43,118,9597,69,49,7084.89,12738.81,0.00
2024-12-10 17:25:43,118,9598,69,49,7190.85,12739.00,0.00
2024-12-10 17:25:43,119,9598,69,50,7130.43,12739.01,0.00
2024-12-10 17:25:43,120,9597,70,50,7021.25,12739.42,0.00
2024-12-10 17:25:43,121,9596,71,50,7004.36,12739.56,0.00
2024-12-10 17:25:43,121,9597,71,50,7305.82,12740.00,0.00
2024-12-10 17:25:43,122,9597,71,51,7245.94,12740.01,0.00
2024-12-10 17:25:43,121,9597,71,50,7297.43,12740.07,0.00
2024-12-10 17:25:43,121,9598,71,50,7494.88,12741.00,0.00
2024-12-10 17:25:43,122,9598,72,50,7433.44,12741.01,0.00
2024-12-10 17:25:43,122,9599,72,50,7408.46,12742.00,0.00
2024-12-10 17:25:43,123,9599,73,50,7348.23,12742.01,0.00
2024-12-10 17:25:43,122,9599,72,50,7392.06,12742.07,0.00
2024-12-10 17:25:43,123,9598,73,50,7266.91,12742.60,0.00
2024-12-10 17:25:43,123,9599,73,50,7356.33,12743.00,0.00
2024-12-10 17:25:43,124,9599,73,51,7297.01,12743.01,0.00
2024-12-10 17:25:43,123,9599,73,50,7341.54,12743.07,0.00
2024-12-10 17:25:43,123,9600,73,50,7431.19,12744.00,0.00
2024-12-10 17:25:43,124,9600,74,50,7371.26,12744.01,0.00
2024-12-10 17:25:43,125,9599,75,50,7302.18,12744.08,0.00
2024-12-10 17:25:43,124,9599,74,50,7389.85,12744.08,0.00
2024-12-10 17:25:43,124,9600,74,50,7376.01,12745.00,0.00
2024-12-10 17:25:43,125,9600,75,50,7317.00,12745.01,0.00
2024-12-10 17:25:43,126,9599,75,51,7258.93,12745.02,0.00
2024-12-10 17:25:43,125,9599,75,50,7356.80,12745.08,0.00
2024-12-10 17:25:43,125,9600,75,50,7443.88,12746.00,0.00
2024-12-10 17:25:43,126,9600,76,50,7384.80,12746.01,0.00
2024-12-10 17:25:43,125,9600,75,50,7434.73,12746.07,0.00
2024-12-10 17:25:43,126,9599,75,51,7369.67,12746.13,0.00
2024-12-10 17:25:43,126,9600,75,51,7468.35,12747.00,0.00
2024-12-10 17:25:43,127,9600,76,51,7409.55,12747.01,0.00
2024-12-10 17:25:43,126,9600,75,51,7459.28,12747.07,0.00
2024-12-10 17:25:43,125,9600,74,51,7490.43,12747.16,0.00
2024-12-10 17:25:43,125,9601,74,51,7585.99,12748.00,0.00
2024-12-10 17:25:43,126,9601,74,52,7525.79,12748.01,0.00
2024-12-10 17:25:43,127,9600,75,52,7465.53,12748.03,0.00
2024-12-10 17:25:43,127,9601,75,52,7525.50,12749.00,0.00
2024-12-10 17:25:43,128,9601,75,53,7466.71,12749.01,0.00
2024-12-10 17:25:44,129,9600,75,54,7325.14,12749.65,0.00
2024-12-10 17:25:44,129,9601,75,54,7511.25,12750.00,0.00
2024-12-10 17:25:44,130,9601,76,54,7453.47,12750.01,0.00
2024-12-10 17:25:44,130,9602,76,54,7518.86,12751.00,0.00
2024-12-10 17:25:44,131,9602,76,55,7461.47,12751.01,0.00
2024-12-10 17:25:44,132,9601,76,56,7337.54,12751.55,0.00
2024-12-10 17:25:44,132,9602,76,56,7426.45,12752.00,0.00
2024-12-10 17:25:44,133,9602,77,56,7370.61,12752.01,0.00
2024-12-10 17:25:44,132,9602,77,55,7416.83,12752.08,0.00
2024-12-10 17:25:44,133,9601,78,55,7258.91,12752.86,0.00
2024-12-10 17:25:44,133,9602,78,55,7439.31,12753.00,0.00
2024-12-10 17:25:44,134,9602,78,56,7383.80,12753.01,0.00
2024-12-10 17:25:44,133,9602,77,56,7429.76,12753.08,0.00
2024-12-10 17:25:44,133,9603,77,56,7494.89,12754.00,0.00
2024-12-10 17:25:44,134,9603,78,56,7438.95,12754.01,0.00
2024-12-10 17:25:44,134,9604,78,56,7399.28,12755.00,0.00
2024-12-10 17:25:44,135,9604,78,57,7344.47,12755.01,0.00
2024-12-10 17:25:44,134,9604,77,57,7389.80,12755.07,0.00
2024-12-10 17:25:44,135,9603,78,57,7258.57,12755.67,0.00
2024-12-10 17:25:44,135,9604,78,57,7336.42,12756.00,0.00
2024-12-10 17:25:44,136,9604,79,57,7282.47,12756.01,0.00
2024-12-10 17:25:44,135,9604,78,57,7327.01,12756.07,0.00
2024-12-10 17:25:44,135,9605,78,57,7391.94,12757.00,0.00
2024-12-10 17:25:44,136,9605,79,57,7337.59,12757.01,0.00
2024-12-10 17:25:44,136,9606,79,57,7301.13,12758.00,0.00
2024-12-10 17:25:44,137,9606,79,58,7247.83,12758.01,0.00
2024-12-10 17:25:44,136,9606,78,58,7290.85,12758.08,0.00
2024-12-10 17:25:44,137,9605,78,59,7217.17,12758.26,0.00
2024-12-10 17:25:44,137,9606,78,59,7258.65,12759.00,0.00
2024-12-10 17:25:44,138,9606,79,59,7206.05,12759.01,0.00
2024-12-10 17:25:44,137,9606,78,59,7248.44,12759.08,0.00
2024-12-10 17:25:44,137,9607,78,59,7315.91,12760.00,0.00
2024-12-10 17:25:44,138,9607,78,60,7262.90,12760.01,0.00
2024-12-10 17:25:44,138,9608,78,60,7228.04,12761.00,0.00
2024-12-10 17:25:44,139,9608,78,61,7176.04,12761.01,0.00
2024-12-10 17:25:44,138,9608,77,61,7217.90,12761.08,0.00
2024-12-10 17:25:44,138,9609,77,61,7192.98,12762.00,0.00
2024-12-10 17:25:44,139,9609,78,61,7141.23,12762.01,0.00
2024-12-10 17:25:44,138,9609,78,60,7182.85,12762.08,0.00
2024-12-10 17:25:44,137,9609,78,59,7234.34,12762.08,0.00
2024-12-10 17:25:44,137,9610,78,59,7210.65,12763.00,0.00
2024-12-10 17:25:44,138,9610,78,60,7158.40,12763.01,0.00
2024-12-10 17:25:44,139,9609,79,60,7094.08,12763.12,0.00
2024-12-10 17:25:44,140,9608,80,60,7105.46,12763.31,0.00
2024-12-10 17:25:44,140,9609,80,60,7171.57,12764.00,0.00
2024-12-10 17:25:44,141,9609,81,60,7120.70,12764.01,0.00
2024-12-10 17:25:44,140,9609,81,59,7168.52,12764.03,0.00
2024-12-10 17:25:44,139,9609,80,59,7213.69,12764.07,0.00
2024-12-10 17:25:44,139,9610,80,59,7371.26,12765.00,0.00
2024-12-10 17:25:44,140,9610,81,59,7318.60,12765.01,0.00
2024-12-10 17:25:44,139,9610,81,58,7362.11,12765.07,0.00
2024-12-10 17:25:44,139,9611,81,58,7336.02,12766.00,0.00
2024-12-10 17:25:44,140,9611,82,58,7283.62,12766.01,0.00
2024-12-10 17:25:44,139,9611,81,58,7326.87,12766.07,0.00
2024-12-10 17:25:44,140,9610,81,59,7217.55,12766.53,0.00
2024-12-10 17:25:44,140,9611,81,59,7273.54,12767.00,0.00
2024-12-10 17:25:44,141,9611,81,60,7221.96,12767.01,0.00
2024-12-10 17:25:44,140,9611,81,59,7264.46,12767.07,0.00
2024-12-10 17:25:44,141,9610,81,60,7158.10,12767.51,0.00
2024-12-10 17:25:44,141,9611,81,60,7321.10,12768.00,0.00
2024-12-10 17:25:44,142,9611,82,60,7269.54,12768.01,0.00
2024-12-10 17:25:44,142,9612,82,60,7321.27,12769.00,0.00
2024-12-10 17:25:44,143,9612,83,60,7270.07,12769.01,0.00
2024-12-10 17:25:44,144,9611,83,61,7202.78,12769.15,0.00
2024-12-10 17:25:44,144,9612,83,61,7262.63,12770.00,0.00
2024-12-10 17:25:44,145,9612,84,61,7212.54,12770.01,0.00
2024-12-10 17:25:44,144,9612,84,60,7252.91,12770.08,0.00
2024-12-10 17:25:44,144,9613,84,60,7310.01,12771.00,0.00
2024-12-10 17:25:44,145,9613,84,61,7259.60,12771.01,0.00
2024-12-10 17:25:44,144,9613,84,60,7300.29,12771.08,0.00
2024-12-10 17:25:44,144,9614,84,60,7266.54,12772.00,0.00
2024-12-10 17:25:44,145,9614,85,60,7216.43,12772.01,0.00
2024-12-10 17:25:44,144,9614,84,60,7256.82,12772.08,0.00
2024-12-10 17:25:44,144,9615,84,60,7221.78,12773.00,0.00
2024-12-10 17:25:44,145,9615,85,60,7171.97,12773.01,0.00
2024-12-10 17:25:44,144,9615,84,60,7212.06,12773.08,0.00
2024-12-10 17:25:45,144,9616,84,60,7175.98,12774.00,0.00
2024-12-10 17:25:45,145,9616,85,60,7126.49,12774.01,0.00
2024-12-10 17:25:45,144,9616,85,59,7166.26,12774.08,0.00
2024-12-10 17:25:45,144,9617,85,59,7126.44,12775.00,0.00
2024-12-10 17:25:45,145,9617,86,59,7077.29,12775.01,0.00
2024-12-10 17:25:45,144,9617,85,59,7108.28,12775.08,0.00
2024-12-10 17:25:45,143,9617,85,58,7113.06,12775.39,0.00
2024-12-10 17:25:45,143,9618,85,58,7125.09,12776.00,0.00
2024-12-10 17:25:45,144,9618,86,58,7075.61,12776.01,0.00
2024-12-10 17:25:45,143,9618,86,57,7103.53,12776.08,0.00
2024-12-10 17:25:45,143,9619,86,57,7076.36,12777.00,0.00
2024-12-10 17:25:45,144,9619,86,58,7027.22,12777.01,0.00
2024-12-10 17:25:45,143,9619,85,58,7060.20,12777.08,0.00
2024-12-10 17:25:45,142,9619,85,57,7109.02,12777.08,0.00
2024-12-10 17:25:45,142,9620,85,57,7081.65,12778.00,0.00
2024-12-10 17:25:45,143,9620,86,57,7032.13,12778.01,0.00
2024-12-10 17:25:45,143,9621,86,57,6995.14,12779.00,0.00
2024-12-10 17:25:45,144,9621,87,57,6946.57,12779.01,0.00
2024-12-10 17:25:45,143,9621,87,56,6984.46,12779.08,0.00
2024-12-10 17:25:45,143,9622,87,56,6957.26,12780.00,0.00
2024-12-10 17:25:45,144,9622,87,57,6908.95,12780.01,0.00
2024-12-10 17:25:45,143,9622,86,57,6946.58,12780.08,0.00
2024-12-10 17:25:45,144,9621,87,57,6842.80,12780.52,0.00
2024-12-10 17:25:45,144,9622,87,57,6914.16,12781.00,0.00
2024-12-10 17:25:45,145,9622,88,57,6866.48,12781.01,0.00
2024-12-10 17:25:45,144,9622,87,57,6911.51,12781.02,0.00
2024-12-10 17:25:45,143,9622,86,57,6951.82,12781.08,0.00
2024-12-10 17:25:45,143,9623,86,57,7008.33,12782.00,0.00
2024-12-10 17:25:45,144,9623,86,58,6959.66,12782.01,0.00
2024-12-10 17:25:45,143,9623,85,58,6997.65,12782.08,0.00
2024-12-10 17:25:45,143,9624,85,58,6961.09,12783.00,0.00
2024-12-10 17:25:45,144,9624,85,59,6912.75,12783.01,0.00
2024-12-10 17:25:45,143,9624,84,59,6958.42,12783.02,0.00
2024-12-10 17:25:45,143,9625,84,59,6910.73,12784.00,0.00
2024-12-10 17:25:45,144,9625,84,60,6862.74,12784.01,0.00
2024-12-10 17:25:45,143,9625,83,60,6900.05,12784.08,0.00
2024-12-10 17:25:45,142,9625,82,60,6893.67,12784.24,0.00
2024-12-10 17:25:45,142,9626,82,60,6885.40,12785.00,0.00
2024-12-10 17:25:45,143,9626,82,61,6837.25,12785.01,0.00
2024-12-10 17:25:45,142,9626,81,61,6874.64,12785.08,0.00
2024-12-10 17:25:45,141,9626,81,60,6901.12,12785.18,0.00
2024-12-10 17:25:45,141,9627,81,60,6885.86,12786.00,0.00
2024-12-10 17:25:45,142,9627,82,60,6837.36,12786.01,0.00
2024-12-10 17:25:45,143,9626,83,60,6746.02,12786.34,0.00
2024-12-10 17:25:45,143,9627,83,60,6815.30,12787.00,0.00
2024-12-10 17:25:45,144,9627,84,60,6767.97,12787.01,0.00
2024-12-10 17:25:45,143,9627,83,60,6803.72,12787.09,0.00
2024-12-10 17:25:45,143,9628,83,60,6863.46,12788.00,0.00
2024-12-10 17:25:45,144,9628,83,61,6815.80,12788.01,0.00
2024-12-10 17:25:45,143,9628,83,60,6851.88,12788.09,0.00
2024-12-10 17:25:45,143,9629,83,60,6820.73,12789.00,0.00
2024-12-10 17:25:45,144,9629,83,61,6773.37,12789.01,0.00
2024-12-10 17:25:45,143,9629,82,61,6809.15,12789.09,0.00
2024-12-10 17:25:45,143,9630,82,61,6775.66,12790.00,0.00
2024-12-10 17:25:45,144,9630,83,61,6728.61,12790.01,0.00
2024-12-10 17:25:45,143,9630,83,60,6764.17,12790.09,0.00
2024-12-10 17:25:45,142,9630,83,59,6778.50,12790.22,0.00
2024-12-10 17:25:45,142,9631,83,59,6759.90,12791.00,0.00
2024-12-10 17:25:45,143,9631,84,59,6712.62,12791.01,0.00
2024-12-10 17:25:45,142,9631,84,58,6729.40,12791.23,0.00
2024-12-10 17:25:45,142,9632,84,58,6719.56,12792.00,0.00
2024-12-10 17:25:45,143,9632,85,58,6672.57,12792.01,0.00
2024-12-10 17:25:45,142,9632,84,58,6707.89,12792.09,0.00
2024-12-10 17:25:45,142,9633,84,58,6679.57,12793.00,0.00
2024-12-10 17:25:45,143,9633,85,58,6632.86,12793.01,0.00
2024-12-10 17:25:45,142,9633,84,58,6667.90,12793.09,0.00
2024-12-10 17:25:45,142,9634,84,58,6639.03,12794.00,0.00
2024-12-10 17:25:45,143,9634,84,59,6592.61,12794.01,0.00
2024-12-10 17:25:45,143,9635,84,59,6551.77,12795.00,0.00
2024-12-10 17:25:45,144,9635,85,59,6506.27,12795.01,0.00
2024-12-10 17:25:45,143,9635,85,58,6539.29,12795.10,0.00
2024-12-10 17:25:45,142,9635,85,57,6562.87,12795.25,0.00
2024-12-10 17:25:45,142,9636,85,57,6557.91,12796.00,0.00
2024-12-10 17:25:45,143,9636,86,57,6512.05,12796.01,0.00
2024-12-10 17:25:45,142,9636,86,56,6545.34,12796.10,0.00
2024-12-10 17:25:46,142,9637,86,56,6520.58,12797.00,0.00
2024-12-10 17:25:46,143,9637,86,57,6474.98,12797.01,0.00
2024-12-10 17:25:46,143,9638,86,57,6437.89,12798.00,0.00
2024-12-10 17:25:46,144,9638,86,58,6393.19,12798.01,0.00
2024-12-10 17:25:46,145,9637,86,59,6341.18,12798.08,0.00
2024-12-10 17:25:46,144,9637,86,58,6414.56,12798.12,0.00
2024-12-10 17:25:46,144,9638,86,58,6391.02,12799.00,0.00
2024-12-10 17:25:46,145,9638,86,59,6346.95,12799.01,0.00
2024-12-10 17:25:46,144,9638,86,58,6376.84,12799.11,0.00
2024-12-10 17:25:46,144,9639,86,58,6441.30,12800.00,0.00
2024-12-10 17:25:46,145,9639,87,58,6396.88,12800.01,0.00
2024-12-10 17:25:46,144,9639,86,58,6427.12,12800.11,0.00
2024-12-10 17:25:46,144,9640,86,58,6402.69,12801.00,0.00
2024-12-10 17:25:46,145,9640,86,59,6358.53,12801.01,0.00
2024-12-10 17:25:46,144,9640,86,58,6388.50,12801.11,0.00
2024-12-10 17:25:46,144,9641,86,58,6364.07,12802.00,0.00
2024-12-10 17:25:46,145,9641,86,59,6320.18,12802.01,0.00
2024-12-10 17:25:46,144,9641,86,58,6349.88,12802.11,0.00
2024-12-10 17:25:46,144,9642,86,58,6325.45,12803.00,0.00
2024-12-10 17:25:46,145,9642,87,58,6281.82,12803.01,0.00
2024-12-10 17:25:46,144,9642,86,58,6311.26,12803.11,0.00
2024-12-10 17:25:46,145,9641,86,59,6227.20,12803.44,0.00
2024-12-10 17:25:46,145,9642,86,59,6288.49,12804.00,0.00
2024-12-10 17:25:46,146,9642,86,60,6245.42,12804.01,0.00
2024-12-10 17:25:46,145,9642,85,60,6274.40,12804.11,0.00
2024-12-10 17:25:46,145,9643,85,60,6337.56,12805.00,0.00
2024-12-10 17:25:46,146,9643,85,61,6294.15,12805.01,0.00
2024-12-10 17:25:46,145,9643,85,60,6323.46,12805.11,0.00
2024-12-10 17:25:46,145,9644,85,60,6298.31,12806.00,0.00
2024-12-10 17:25:46,146,9644,86,60,6255.17,12806.01,0.00
2024-12-10 17:25:46,145,9644,85,60,6287.74,12806.08,0.00
2024-12-10 17:25:46,144,9644,84,60,6327.85,12806.10,0.00
2024-12-10 17:25:46,144,9645,84,60,6302.25,12807.00,0.00
2024-12-10 17:25:46,145,9645,85,60,6258.79,12807.01,0.00
2024-12-10 17:25:46,146,9644,85,61,6205.43,12807.10,0.00
2024-12-10 17:25:46,145,9644,84,61,6324.19,12807.12,0.00
2024-12-10 17:25:46,145,9645,84,61,6299.09,12808.00,0.00
2024-12-10 17:25:46,146,9645,84,62,6255.95,12808.01,0.00
2024-12-10 17:25:46,145,9645,83,62,6285.37,12808.11,0.00
2024-12-10 17:25:46,145,9646,83,62,6347.05,12809.00,0.00
2024-12-10 17:25:46,146,9646,84,62,6303.58,12809.01,0.00
2024-12-10 17:25:46,145,9646,84,61,6332.96,12809.11,0.00
2024-12-10 17:25:46,145,9647,84,61,6305.43,12810.00,0.00
2024-12-10 17:25:46,146,9647,85,61,6262.24,12810.01,0.00
2024-12-10 17:25:46,145,9647,84,61,6291.33,12810.11,0.00
2024-12-10 17:25:46,144,9647,84,60,6334.13,12810.11,0.00
2024-12-10 17:25:46,144,9648,84,60,6306.43,12811.00,0.00
2024-12-10 17:25:46,145,9648,84,61,6262.94,12811.01,0.00
2024-12-10 17:25:46,144,9648,84,60,6292.24,12811.11,0.00
2024-12-10 17:25:46,145,9647,84,61,6189.78,12811.59,0.00
2024-12-10 17:25:46,145,9648,84,61,6265.82,12812.00,0.00
2024-12-10 17:25:46,146,9648,84,62,6222.91,12812.01,0.00
2024-12-10 17:25:46,145,9648,83,62,6263.18,12812.02,0.00
2024-12-10 17:25:46,144,9648,83,61,6305.78,12812.02,0.00
2024-12-10 17:25:46,143,9648,83,60,6339.16,12812.10,0.00
2024-12-10 17:25:46,142,9648,82,60,6382.90,12812.10,0.00
2024-12-10 17:25:46,143,9647,83,60,6307.86,12812.35,0.00
2024-12-10 17:25:46,144,9646,83,61,6252.54,12812.51,0.00
2024-12-10 17:25:46,144,9647,83,61,6415.06,12813.00,0.00
2024-12-10 17:25:46,145,9647,83,62,6370.81,12813.01,0.00
2024-12-10 17:25:46,146,9646,84,62,6325.43,12813.03,0.00
2024-12-10 17:25:46,145,9646,83,62,6428.26,12813.03,0.00
2024-12-10 17:25:46,144,9646,82,62,6464.04,12813.10,0.00
2024-12-10 17:25:46,143,9646,82,61,6461.96,12813.46,0.00
2024-12-10 17:25:46,143,9647,82,61,6657.73,12814.00,0.00
2024-12-10 17:25:46,144,9647,82,62,6611.50,12814.01,0.00
2024-12-10 17:25:46,143,9647,81,62,6646.12,12814.09,0.00
2024-12-10 17:25:46,144,9646,82,62,6592.87,12814.16,0.00
2024-12-10 17:25:46,144,9647,82,62,6742.20,12815.00,0.00
2024-12-10 17:25:46,145,9647,82,63,6695.70,12815.01,0.00
2024-12-10 17:25:46,146,9646,82,64,6648.96,12815.03,0.00
2024-12-10 17:25:46,147,9645,82,65,6544.01,12815.93,0.00
2024-12-10 17:25:46,147,9646,82,65,6714.08,12816.00,0.00
2024-12-10 17:25:46,148,9646,82,66,6668.71,12816.01,0.00
2024-12-10 17:25:46,147,9646,81,66,6701.05,12816.10,0.00
2024-12-10 17:25:46,147,9647,81,66,6846.11,12817.00,0.00
2024-12-10 17:25:46,148,9647,82,66,6799.86,12817.01,0.00
2024-12-10 17:25:46,148,9648,82,66,6759.68,12818.00,0.00
2024-12-10 17:25:46,149,9648,82,67,6714.31,12818.01,0.00
2024-12-10 17:25:46,148,9648,82,66,6745.01,12818.12,0.00
2024-12-10 17:25:46,147,9648,82,65,6790.02,12818.12,0.00
2024-12-10 17:25:46,147,9649,82,65,6764.34,12819.00,0.00
2024-12-10 17:25:46,148,9649,83,65,6718.63,12819.01,0.00
2024-12-10 17:25:46,147,9649,82,65,6749.57,12819.12,0.00
2024-12-10 17:25:47,147,9650,82,65,6723.88,12820.00,0.00
2024-12-10 17:25:47,148,9650,83,65,6678.45,12820.01,0.00
2024-12-10 17:25:47,149,9649,83,66,6620.77,12820.12,0.00
2024-12-10 17:25:47,149,9650,83,66,6637.93,12821.00,0.00
2024-12-10 17:25:47,150,9650,84,66,6593.68,12821.01,0.00
2024-12-10 17:25:47,149,9650,83,66,6622.50,12821.12,0.00
2024-12-10 17:25:47,149,9651,83,66,6676.34,12822.00,0.00
2024-12-10 17:25:47,150,9651,84,66,6631.83,12822.01,0.00
2024-12-10 17:25:47,150,9652,84,66,6585.44,12823.00,0.00
2024-12-10 17:25:47,151,9652,85,66,6541.83,12823.01,0.00
2024-12-10 17:25:47,150,9652,85,65,6569.26,12823.13,0.00
2024-12-10 17:25:47,150,9653,85,65,6536.67,12824.00,0.00
2024-12-10 17:25:47,151,9653,85,66,6493.38,12824.01,0.00
2024-12-10 17:25:47,150,9653,85,65,6520.48,12824.13,0.00
2024-12-10 17:25:47,151,9652,85,66,6456.10,12824.30,0.00
2024-12-10 17:25:47,151,9653,85,66,6505.90,12825.00,0.00
2024-12-10 17:25:47,152,9653,85,67,6463.10,12825.01,0.00
2024-12-10 17:25:47,151,9653,84,67,6489.83,12825.13,0.00
2024-12-10 17:25:47,152,9652,84,68,6441.23,12825.18,0.00
2024-12-10 17:25:47,152,9653,84,68,6572.90,12826.00,0.00
2024-12-10 17:25:47,153,9653,85,68,6529.94,12826.01,0.00
2024-12-10 17:25:47,152,9653,85,67,6556.93,12826.13,0.00
2024-12-10 17:25:47,153,9652,86,67,6452.19,12826.62,0.00
2024-12-10 17:25:47,153,9653,86,67,6603.96,12827.00,0.00
2024-12-10 17:25:47,154,9653,87,67,6561.07,12827.01,0.00
2024-12-10 17:25:47,153,9653,87,66,6588.08,12827.12,0.00
2024-12-10 17:25:47,153,9654,87,66,6637.53,12828.00,0.00
2024-12-10 17:25:47,154,9654,88,66,6594.43,12828.01,0.00
2024-12-10 17:25:47,153,9654,87,66,6621.65,12828.12,0.00
2024-12-10 17:25:47,153,9655,87,66,6591.38,12829.00,0.00
2024-12-10 17:25:47,154,9655,88,66,6548.58,12829.01,0.00
2024-12-10 17:25:47,153,9655,88,65,6575.50,12829.12,0.00
2024-12-10 17:25:47,152,9655,87,65,6589.57,12829.35,0.00
2024-12-10 17:25:47,152,9656,87,65,6588.87,12830.00,0.00
2024-12-10 17:25:47,153,9656,87,66,6545.80,12830.01,0.00
2024-12-10 17:25:47,153,9657,87,66,6498.95,12831.00,0.00
2024-12-10 17:25:47,154,9657,88,66,6456.75,12831.01,0.00
2024-12-10 17:25:47,153,9657,87,66,6482.23,12831.13,0.00
2024-12-10 17:25:47,153,9658,87,66,6452.30,12832.00,0.00
2024-12-10 17:25:47,154,9658,88,66,6410.40,12832.01,0.00
2024-12-10 17:25:47,153,9658,87,66,6435.58,12832.13,0.00
2024-12-10 17:25:47,153,9659,87,66,6407.04,12833.00,0.00
2024-12-10 17:25:47,154,9659,88,66,6365.44,12833.01,0.00
2024-12-10 17:25:47,153,9659,87,66,6397.84,12833.07,0.00
2024-12-10 17:25:47,152,9659,87,65,6431.52,12833.13,0.00
2024-12-10 17:25:47,152,9660,87,65,6400.79,12834.00,0.00
2024-12-10 17:25:47,153,9660,87,66,6358.96,12834.01,0.00
2024-12-10 17:25:47,152,9660,86,66,6383.96,12834.13,0.00
2024-12-10 17:25:47,153,9659,86,67,6296.18,12834.50,0.00
2024-12-10 17:25:47,152,9659,86,66,6356.19,12834.72,0.00
2024-12-10 17:25:47,152,9660,86,66,6405.19,12835.00,0.00
2024-12-10 17:25:47,153,9660,86,67,6363.33,12835.01,0.00
2024-12-10 17:25:47,152,9660,85,67,6388.36,12835.13,0.00
2024-12-10 17:25:47,152,9660,85,67,6445.32,12836.00,0.00
2024-12-10 17:25:47,153,9660,85,68,6403.19,12836.01,0.00
2024-12-10 17:25:47,152,9660,84,68,6428.48,12836.13,0.00
2024-12-10 17:25:47,152,9661,84,68,6399.82,12837.00,0.00
2024-12-10 17:25:47,153,9661,84,69,6357.99,12837.01,0.00
2024-12-10 17:25:47,152,9661,83,69,6382.98,12837.13,0.00
2024-12-10 17:25:47,152,9662,83,69,6355.10,12838.00,0.00
2024-12-10 17:25:47,153,9662,84,69,6313.56,12838.01,0.00
2024-12-10 17:25:47,152,9662,83,69,6338.25,12838.13,0.00
2024-12-10 17:25:47,151,9662,82,69,6379.38,12838.13,0.00
2024-12-10 17:25:47,150,9662,82,68,6421.05,12838.13,0.00
2024-12-10 17:25:47,150,9663,82,68,6392.17,12839.00,0.00
2024-12-10 17:25:47,151,9663,82,69,6349.84,12839.01,0.00
2024-12-10 17:25:47,150,9663,82,68,6385.35,12839.05,0.00
2024-12-10 17:25:47,149,9663,82,67,6417.89,12839.13,0.00
2024-12-10 17:25:47,150,9662,82,68,6375.11,12839.14,0.00
2024-12-10 17:25:47,150,9663,82,68,6429.79,12840.00,0.00
2024-12-10 17:25:47,151,9663,83,68,6387.21,12840.01,0.00
2024-12-10 17:25:47,150,9663,83,67,6408.00,12840.14,0.00
2024-12-10 17:25:47,150,9664,83,67,6469.22,12841.00,0.00
2024-12-10 17:25:47,151,9664,83,68,6426.38,12841.01,0.00
2024-12-10 17:25:47,150,9664,82,68,6451.30,12841.14,0.00
2024-12-10 17:25:47,150,9665,82,68,6426.92,12842.00,0.00
2024-12-10 17:25:47,151,9665,82,69,6384.35,12842.01,0.00
2024-12-10 17:25:48,150,9665,82,68,6418.38,12842.07,0.00
2024-12-10 17:25:48,149,9665,81,68,6452.01,12842.13,0.00
2024-12-10 17:25:48,148,9665,80,68,6494.73,12842.13,0.00
2024-12-10 17:25:48,148,9666,80,68,6470.88,12843.00,0.00
2024-12-10 17:25:48,149,9666,80,69,6427.46,12843.01,0.00
2024-12-10 17:25:48,150,9665,80,70,6377.77,12843.07,0.00
2024-12-10 17:25:48,151,9664,80,71,6360.22,12843.13,0.00
2024-12-10 17:25:48,150,9664,80,70,6452.31,12843.15,0.00
2024-12-10 17:25:48,151,9663,81,70,6367.13,12843.49,0.00
2024-12-10 17:25:48,151,9664,81,70,6400.66,12844.00,0.00
2024-12-10 17:25:48,152,9664,81,71,6358.55,12844.01,0.00
2024-12-10 17:25:48,151,9664,80,71,6382.86,12844.14,0.00
2024-12-10 17:25:48,151,9665,80,71,6612.97,12845.00,0.00
2024-12-10 17:25:48,152,9665,80,72,6569.47,12845.01,0.00
2024-12-10 17:25:48,151,9665,79,72,6612.12,12845.01,0.00
2024-12-10 17:25:48,150,9665,78,72,6639.14,12845.13,0.00
2024-12-10 17:25:48,149,9665,78,71,6682.84,12845.13,0.00
2024-12-10 17:25:48,150,9664,78,72,6539.32,12845.92,0.00
2024-12-10 17:25:48,150,9665,78,72,6621.61,12846.00,0.00
2024-12-10 17:25:48,151,9665,78,73,6577.76,12846.01,0.00
2024-12-10 17:25:48,150,9665,77,73,6619.05,12846.02,0.00
2024-12-10 17:25:48,149,9665,76,73,6648.87,12846.13,0.00
2024-12-10 17:25:48,148,9665,76,72,6692.93,12846.13,0.00
2024-12-10 17:25:48,148,9666,76,72,6755.01,12847.00,0.00
2024-12-10 17:25:48,149,9666,77,72,6709.68,12847.01,0.00
2024-12-10 17:25:48,150,9665,77,73,6656.41,12847.09,0.00
2024-12-10 17:25:48,149,9665,76,73,6716.64,12847.13,0.00
2024-12-10 17:25:48,149,9666,76,73,6692.09,12848.00,0.00
2024-12-10 17:25:48,150,9666,76,74,6647.48,12848.01,0.00
2024-12-10 17:25:48,151,9665,77,74,6589.90,12848.13,0.00
2024-12-10 17:25:48,150,9665,77,73,6689.22,12848.13,0.00
2024-12-10 17:25:48,149,9665,76,73,6733.26,12848.13,0.00
2024-12-10 17:25:48,149,9666,76,73,6794.94,12849.00,0.00
2024-12-10 17:25:48,150,9666,77,73,6749.64,12849.01,0.00
2024-12-10 17:25:48,149,9666,76,73,6787.20,12849.06,0.00
2024-12-10 17:25:48,148,9666,76,72,6824.42,12849.12,0.00
2024-12-10 17:25:48,147,9666,76,71,6869.97,12849.12,0.00
2024-12-10 17:25:48,147,9667,76,71,6932.51,12850.00,0.00
2024-12-10 17:25:48,148,9667,77,71,6885.67,12850.01,0.00
2024-12-10 17:25:48,147,9667,76,71,6916.84,12850.12,0.00
2024-12-10 17:25:48,148,9666,76,72,6858.83,12850.22,0.00
2024-12-10 17:25:48,148,9667,76,72,6921.33,12851.00,0.00
2024-12-10 17:25:48,149,9667,77,72,6874.87,12851.01,0.00
2024-12-10 17:25:48,148,9667,77,71,6905.76,12851.12,0.00
2024-12-10 17:25:48,148,9668,77,71,6964.65,12852.00,0.00
2024-12-10 17:25:48,149,9668,77,72,6917.90,12852.01,0.00
2024-12-10 17:25:48,148,9668,76,72,6949.08,12852.12,0.00
2024-12-10 17:25:48,149,9667,76,73,6812.19,12852.84,0.00
2024-12-10 17:25:48,149,9668,76,73,6887.89,12853.00,0.00
2024-12-10 17:25:48,150,9668,76,74,6841.97,12853.01,0.00
2024-12-10 17:25:48,150,9669,76,74,6881.96,12854.00,0.00
2024-12-10 17:25:48,151,9669,77,74,6836.39,12854.01,0.00
2024-12-10 17:25:48,152,9668,77,75,6786.35,12854.06,0.00
2024-12-10 17:25:48,151,9668,76,75,6829.64,12854.13,0.00
2024-12-10 17:25:48,151,9669,76,75,6799.30,12855.00,0.00
2024-12-10 17:25:48,152,9669,77,75,6754.57,12855.01,0.00
2024-12-10 17:25:48,151,9669,76,75,6789.12,12855.08,0.00
2024-12-10 17:25:48,150,9669,76,74,6828.41,12855.12,0.00
2024-12-10 17:25:48,149,9669,75,74,6873.38,12855.12,0.00
2024-12-10 17:25:48,150,9668,76,74,6725.12,12855.93,0.00
2024-12-10 17:25:48,150,9669,76,74,6888.38,12856.00,0.00
2024-12-10 17:25:48,151,9669,76,75,6842.77,12856.01,0.00
2024-12-10 17:25:48,150,9669,75,75,6873.02,12856.12,0.00
2024-12-10 17:25:48,150,9670,75,75,6927.08,12857.00,0.00
2024-12-10 17:25:48,151,9670,76,75,6881.21,12857.01,0.00
2024-12-10 17:25:48,150,9670,75,75,6911.72,12857.12,0.00
2024-12-10 17:25:48,150,9671,75,75,6880.08,12858.00,0.00
2024-12-10 17:25:48,151,9671,76,75,6834.52,12858.01,0.00
2024-12-10 17:25:48,152,9670,77,75,6778.60,12858.11,0.00
2024-12-10 17:25:48,151,9670,77,74,6835.43,12858.13,0.00
2024-12-10 17:25:48,150,9670,77,73,6880.14,12858.13,0.00
2024-12-10 17:25:48,150,9671,77,73,6848.63,12859.00,0.00
2024-12-10 17:25:48,151,9671,77,74,6803.28,12859.01,0.00
2024-12-10 17:25:48,152,9670,78,74,6745.04,12859.13,0.00
2024-12-10 17:25:48,151,9670,77,74,6828.04,12859.13,0.00
2024-12-10 17:25:48,151,9671,77,74,6880.53,12860.00,0.00
2024-12-10 17:25:48,152,9671,77,75,6835.26,12860.01,0.00
2024-12-10 17:25:48,152,9672,77,75,6871.05,12861.00,0.00
2024-12-10 17:25:48,153,9672,77,76,6826.14,12861.01,0.00
2024-12-10 17:25:48,154,9671,77,77,6767.68,12861.13,0.00
2024-12-10 17:25:48,153,9671,77,76,6852.27,12861.13,0.00
2024-12-10 17:25:48,153,9672,77,76,6818.97,12862.00,0.00
2024-12-10 17:25:48,154,9672,78,76,6774.69,12862.01,0.00
2024-12-10 17:25:48,154,9673,78,76,6808.70,12863.00,0.00
2024-12-10 17:25:48,155,9673,78,77,6764.77,12863.01,0.00
2024-12-10 17:25:48,154,9673,77,77,6806.20,12863.02,0.00
2024-12-10 17:25:48,153,9673,76,77,6848.17,12863.03,0.00
2024-12-10 17:25:48,152,9673,76,76,6881.43,12863.12,0.00
2024-12-10 17:25:48,151,9673,75,76,6926.15,12863.12,0.00
2024-12-10 17:25:48,150,9673,74,76,6971.47,12863.12,0.00
2024-12-10 17:25:49,150,9674,74,76,6938.90,12864.00,0.00
2024-12-10 17:25:49,151,9674,75,76,6892.95,12864.01,0.00
2024-12-10 17:25:49,150,9674,74,76,6923.53,12864.12,0.00
2024-12-10 17:25:49,150,9675,74,76,6890.94,12865.00,0.00
2024-12-10 17:25:49,151,9675,75,76,6845.30,12865.01,0.00
2024-12-10 17:25:49,152,9674,76,76,6790.15,12865.10,0.00
2024-12-10 17:25:49,151,9674,75,76,6844.52,12865.13,0.00
2024-12-10 17:25:49,150,9674,74,76,6796.18,12865.85,0.00
2024-12-10 17:25:49,150,9675,74,76,6862.36,12866.00,0.00
2024-12-10 17:25:49,151,9675,74,77,6816.91,12866.01,0.00
2024-12-10 17:25:49,150,9675,73,77,6846.99,12866.12,0.00
2024-12-10 17:25:49,149,9675,73,76,6892.07,12866.12,0.00
2024-12-10 17:25:49,149,9676,73,76,6952.13,12867.00,0.00
2024-12-10 17:25:49,150,9676,73,77,6905.78,12867.01,0.00
2024-12-10 17:25:49,149,9676,73,76,6946.10,12867.05,0.00
2024-12-10 17:25:49,148,9676,73,75,6983.52,12867.12,0.00
2024-12-10 17:25:49,147,9676,73,74,7030.15,12867.12,0.00
2024-12-10 17:25:49,148,9675,73,75,6972.22,12867.21,0.00
2024-12-10 17:25:49,148,9676,73,75,7033.55,12868.00,0.00
2024-12-10 17:25:49,149,9676,74,75,6986.35,12868.01,0.00
2024-12-10 17:25:49,148,9676,73,75,7018.84,12868.12,0.00
2024-12-10 17:25:49,148,9677,73,75,7079.32,12869.00,0.00
2024-12-10 17:25:49,149,9677,73,76,7031.80,12869.01,0.00
2024-12-10 17:25:49,148,9677,72,76,7076.71,12869.02,0.00
2024-12-10 17:25:49,147,9677,71,76,7112.66,12869.11,0.00
2024-12-10 17:25:49,146,9677,71,75,7160.49,12869.11,0.00
2024-12-10 17:25:49,146,9678,71,75,7134.54,12870.00,0.00
2024-12-10 17:25:49,147,9678,71,76,7086.00,12870.01,0.00
2024-12-10 17:25:49,146,9678,70,76,7120.50,12870.11,0.00
2024-12-10 17:25:49,146,9679,70,76,7094.54,12871.00,0.00
2024-12-10 17:25:49,147,9679,71,76,7046.28,12871.01,0.00
2024-12-10 17:25:49,146,9679,71,75,7080.50,12871.11,0.00
2024-12-10 17:25:49,146,9680,71,75,7054.53,12872.00,0.00
2024-12-10 17:25:49,147,9680,72,75,7006.54,12872.01,0.00
2024-12-10 17:25:49,146,9680,71,75,7040.49,12872.11,0.00
2024-12-10 17:25:49,146,9681,71,75,7014.52,12873.00,0.00
2024-12-10 17:25:49,147,9681,71,76,6966.81,12873.01,0.00
2024-12-10 17:25:49,148,9680,72,76,6809.69,12873.88,0.00
2024-12-10 17:25:49,148,9681,72,76,6893.31,12874.00,0.00
2024-12-10 17:25:49,149,9681,73,76,6847.04,12874.01,0.00
2024-12-10 17:25:49,148,9681,72,76,6878.58,12874.12,0.00
2024-12-10 17:25:49,148,9682,72,76,6939.08,12875.00,0.00
2024-12-10 17:25:49,149,9682,73,76,6892.51,12875.01,0.00
2024-12-10 17:25:49,148,9682,72,76,6924.36,12875.12,0.00
2024-12-10 17:25:49,148,9683,72,76,6897.04,12876.00,0.00
2024-12-10 17:25:49,149,9683,72,77,6850.75,12876.01,0.00
2024-12-10 17:25:49,148,9683,71,77,6882.31,12876.12,0.00
2024-12-10 17:25:49,148,9684,71,77,6853.60,12877.00,0.00
2024-12-10 17:25:49,149,9684,72,77,6807.60,12877.01,0.00
2024-12-10 17:25:49,148,9684,72,76,6838.87,12877.12,0.00
2024-12-10 17:25:49,148,9685,72,76,6808.71,12878.00,0.00
2024-12-10 17:25:49,149,9685,72,77,6763.02,12878.01,0.00
2024-12-10 17:25:49,148,9685,71,77,6793.98,12878.12,0.00
2024-12-10 17:25:49,148,9686,71,77,6762.32,12879.00,0.00
2024-12-10 17:25:49,149,9686,71,78,6716.93,12879.01,0.00
2024-12-10 17:25:49,149,9687,71,78,6669.37,12880.00,0.00
2024-12-10 17:25:49,150,9687,72,78,6624.91,12880.01,0.00
2024-12-10 17:25:49,149,9687,72,77,6653.87,12880.12,0.00
2024-12-10 17:25:49,148,9687,71,77,6697.96,12880.12,0.00
2024-12-10 17:25:49,149,9686,72,77,6555.68,12880.89,0.00
2024-12-10 17:25:49,149,9687,72,77,6650.88,12881.00,0.00
2024-12-10 17:25:49,150,9687,72,78,6606.54,12881.01,0.00
2024-12-10 17:25:49,150,9688,72,78,6633.91,12882.00,0.00
2024-12-10 17:25:49,151,9688,72,79,6589.98,12882.01,0.00
2024-12-10 17:25:49,150,9688,72,78,6617.66,12882.13,0.00
2024-12-10 17:25:49,150,9689,72,78,6574.41,12883.00,0.00
2024-12-10 17:25:49,151,9689,72,79,6530.87,12883.01,0.00
2024-12-10 17:25:49,150,9689,72,78,6558.16,12883.13,0.00
2024-12-10 17:25:49,151,9688,72,79,6485.75,12883.36,0.00
2024-12-10 17:25:49,151,9689,72,79,6532.68,12884.00,0.00
2024-12-10 17:25:49,152,9689,73,79,6489.70,12884.01,0.00
2024-12-10 17:25:49,151,9689,73,78,6516.53,12884.13,0.00
2024-12-10 17:25:49,151,9690,73,78,6558.67,12885.00,0.00
2024-12-10 17:25:49,152,9690,74,78,6515.52,12885.01,0.00
2024-12-10 17:25:49,151,9690,74,77,6542.52,12885.13,0.00
2024-12-10 17:25:49,151,9691,74,77,6500.18,12886.00,0.00
2024-12-10 17:25:49,152,9691,74,78,6457.41,12886.01,0.00
2024-12-10 17:25:49,151,9691,73,78,6495.92,12886.03,0.00
2024-12-10 17:25:49,150,9691,72,78,6527.25,12886.12,0.00
2024-12-10 17:25:49,149,9691,71,78,6570.19,12886.12,0.00
2024-12-10 17:25:50,150,9690,71,79,6474.09,12886.54,0.00
2024-12-10 17:25:50,150,9691,71,79,6530.30,12887.00,0.00
2024-12-10 17:25:50,151,9691,71,80,6487.05,12887.01,0.00
2024-12-10 17:25:50,150,9691,70,80,6514.89,12887.12,0.00
2024-12-10 17:25:50,150,9692,70,80,6559.98,12888.00,0.00
2024-12-10 17:25:50,151,9692,70,81,6516.54,12888.01,0.00
2024-12-10 17:25:50,150,9692,70,80,6544.58,12888.12,0.00
2024-12-10 17:25:50,150,9693,70,80,6504.36,12889.00,0.00
2024-12-10 17:25:50,151,9693,70,81,6461.28,12889.01,0.00
2024-12-10 17:25:50,150,9693,70,80,6488.95,12889.12,0.00
2024-12-10 17:25:50,149,9693,69,80,6440.87,12889.81,0.00
2024-12-10 17:25:50,149,9694,69,80,6495.97,12890.00,0.00
2024-12-10 17:25:50,150,9694,70,80,6452.66,12890.01,0.00
2024-12-10 17:25:50,149,9694,69,80,6480.45,12890.12,0.00
2024-12-10 17:25:50,149,9695,69,80,6446.16,12891.00,0.00
2024-12-10 17:25:50,150,9695,70,80,6403.18,12891.01,0.00
2024-12-10 17:25:50,149,9695,69,80,6430.64,12891.12,0.00
2024-12-10 17:25:50,148,9695,68,80,6365.42,12891.92,0.00
2024-12-10 17:25:50,148,9696,68,80,6442.14,12892.00,0.00
2024-12-10 17:25:50,149,9696,69,80,6398.91,12892.01,0.00
2024-12-10 17:25:50,148,9696,68,80,6426.52,12892.12,0.00
2024-12-10 17:25:50,148,9697,68,80,6400.83,12893.00,0.00
2024-12-10 17:25:50,149,9697,69,80,6357.87,12893.01,0.00
2024-12-10 17:25:50,148,9697,68,80,6385.20,12893.12,0.00
2024-12-10 17:25:50,148,9698,68,80,6359.51,12894.00,0.00
2024-12-10 17:25:50,149,9698,69,80,6316.82,12894.01,0.00
2024-12-10 17:25:50,148,9698,69,79,6343.88,12894.12,0.00
2024-12-10 17:25:50,148,9699,69,79,6318.17,12895.00,0.00
2024-12-10 17:25:50,149,9699,69,80,6275.77,12895.01,0.00
2024-12-10 17:25:50,148,9699,68,80,6302.54,12895.12,0.00
2024-12-10 17:25:50,147,9699,67,80,6327.38,12895.26,0.00
2024-12-10 17:25:50,148,9698,67,81,6257.68,12895.48,0.00
2024-12-10 17:25:50,148,9699,67,81,6285.05,12896.00,0.00
2024-12-10 17:25:50,149,9699,67,82,6242.87,12896.01,0.00
2024-12-10 17:25:50,148,9699,66,82,6269.42,12896.12,0.00
2024-12-10 17:25:50,148,9700,66,82,6330.85,12897.00,0.00
2024-12-10 17:25:50,149,9700,67,82,6288.37,12897.01,0.00
2024-12-10 17:25:50,148,9700,67,81,6315.22,12897.12,0.00
2024-12-10 17:25:50,149,9699,68,81,6193.42,12897.75,0.00
2024-12-10 17:25:50,149,9700,68,81,6275.87,12898.00,0.00
2024-12-10 17:25:50,150,9700,69,81,6234.03,12898.01,0.00
2024-12-10 17:25:50,149,9700,68,81,6273.27,12898.02,0.00
2024-12-10 17:25:50,148,9700,68,80,6302.63,12898.12,0.00
2024-12-10 17:25:50,147,9700,68,79,6344.63,12898.12,0.00
2024-12-10 17:25:50,147,9701,68,79,6406.50,12899.00,0.00
2024-12-10 17:25:50,148,9701,68,80,6363.21,12899.01,0.00
2024-12-10 17:25:50,147,9701,68,79,6391.63,12899.12,0.00
2024-12-10 17:25:50,148,9700,69,79,6248.57,12899.91,0.00
2024-12-10 17:25:50,148,9701,69,79,6334.07,12900.00,0.00
2024-12-10 17:25:50,149,9701,69,80,6291.56,12900.01,0.00
2024-12-10 17:25:50,148,9701,68,80,6319.30,12900.12,0.00
2024-12-10 17:25:50,149,9700,69,80,6206.08,12900.68,0.00
2024-12-10 17:25:50,149,9701,69,80,6372.57,12901.00,0.00
2024-12-10 17:25:50,150,9701,70,80,6330.09,12901.01,0.00
2024-12-10 17:25:50,149,9701,70,79,6357.90,12901.11,0.00
2024-12-10 17:25:50,149,9702,70,79,6417.23,12902.00,0.00
2024-12-10 17:25:50,150,9702,71,79,6374.44,12902.01,0.00
2024-12-10 17:25:50,149,9702,71,78,6402.55,12902.11,0.00
2024-12-10 17:25:50,149,9703,71,78,6375.29,12903.00,0.00
2024-12-10 17:25:50,150,9703,71,79,6332.79,12903.01,0.00
2024-12-10 17:25:50,149,9703,70,79,6360.61,12903.11,0.00
2024-12-10 17:25:50,150,9702,70,80,6282.13,12903.41,0.00
2024-12-10 17:25:50,150,9703,70,80,6298.01,12904.00,0.00
2024-12-10 17:25:50,151,9703,70,81,6256.30,12904.01,0.00
2024-12-10 17:25:50,150,9703,70,80,6283.21,12904.11,0.00
2024-12-10 17:25:50,150,9704,70,80,6341.30,12905.00,0.00
2024-12-10 17:25:50,151,9704,70,81,6299.31,12905.01,0.00
2024-12-10 17:25:50,150,9704,70,80,6325.87,12905.11,0.00
2024-12-10 17:25:50,150,9705,70,80,6297.93,12906.00,0.00
2024-12-10 17:25:50,151,9705,70,81,6256.22,12906.01,0.00
2024-12-10 17:25:50,150,9705,69,81,6283.34,12906.11,0.00
2024-12-10 17:25:50,150,9706,69,81,6255.39,12907.00,0.00
2024-12-10 17:25:50,151,9706,69,82,6213.96,12907.01,0.00
2024-12-10 17:25:50,150,9706,68,82,6240.80,12907.11,0.00
2024-12-10 17:25:50,149,9706,68,81,6281.82,12907.11,0.00
2024-12-10 17:25:50,149,9707,68,81,6254.55,12908.00,0.00
2024-12-10 17:25:50,150,9707,69,81,6212.85,12908.01,0.00
2024-12-10 17:25:50,149,9707,69,80,6239.86,12908.11,0.00
2024-12-10 17:25:51,149,9708,69,80,6212.58,12909.00,0.00
2024-12-10 17:25:51,150,9708,70,80,6171.16,12909.01,0.00
2024-12-10 17:25:51,150,9709,70,80,6129.47,12910.00,0.00
2024-12-10 17:25:51,151,9709,70,81,6088.87,12910.01,0.00
2024-12-10 17:25:51,150,9709,69,81,6114.01,12910.12,0.00
2024-12-10 17:25:51,150,9710,69,81,6086.90,12911.00,0.00
2024-12-10 17:25:51,151,9710,70,81,6046.59,12911.01,0.00
2024-12-10 17:25:51,150,9710,70,80,6069.95,12911.12,0.00
2024-12-10 17:25:51,149,9710,70,79,6109.82,12911.12,0.00
2024-12-10 17:25:51,150,9709,71,79,6032.13,12911.42,0.00
2024-12-10 17:25:51,150,9710,71,79,6101.38,12912.00,0.00
2024-12-10 17:25:51,151,9710,71,80,6060.97,12912.01,0.00
2024-12-10 17:25:51,150,9710,71,79,6085.07,12912.12,0.00
2024-12-10 17:25:51,150,9711,71,79,6144.05,12913.00,0.00
2024-12-10 17:25:51,151,9711,72,79,6103.36,12913.01,0.00
2024-12-10 17:25:51,150,9711,71,79,6142.33,12913.01,0.00
2024-12-10 17:25:51,149,9711,71,78,6168.86,12913.12,0.00
2024-12-10 17:25:51,148,9711,70,78,6209.66,12913.12,0.00
2024-12-10 17:25:51,148,9712,70,78,6183.93,12914.00,0.00
2024-12-10 17:25:51,149,9712,71,78,6142.43,12914.01,0.00
2024-12-10 17:25:51,148,9712,70,78,6180.45,12914.03,0.00
2024-12-10 17:25:51,147,9712,70,77,6210.22,12914.12,0.00
2024-12-10 17:25:51,146,9712,69,77,6251.87,12914.12,0.00
2024-12-10 17:25:51,146,9713,69,77,6226.67,12915.00,0.00
2024-12-10 17:25:51,147,9713,69,78,6184.31,12915.01,0.00
2024-12-10 17:25:51,146,9713,69,77,6225.78,12915.01,0.00
2024-12-10 17:25:51,145,9713,68,77,6256.28,12915.10,0.00
2024-12-10 17:25:51,144,9713,68,76,6297.94,12915.10,0.00
2024-12-10 17:25:51,143,9713,68,75,6341.08,12915.10,0.00
2024-12-10 17:25:51,142,9713,68,74,6384.82,12915.11,0.00
2024-12-10 17:25:51,142,9714,68,74,6360.72,12916.00,0.00
2024-12-10 17:25:51,143,9714,69,74,6316.24,12916.01,0.00
2024-12-10 17:25:51,142,9714,69,73,6347.11,12916.11,0.00
2024-12-10 17:25:51,143,9713,69,74,6229.76,12916.69,0.00
2024-12-10 17:25:51,143,9714,69,74,6313.12,12917.00,0.00
2024-12-10 17:25:51,144,9714,70,74,6269.28,12917.01,0.00
2024-12-10 17:25:51,143,9714,69,74,6299.60,12917.10,0.00
2024-12-10 17:25:51,143,9715,69,74,6365.10,12918.00,0.00
2024-12-10 17:25:51,144,9715,70,74,6320.90,12918.01,0.00
2024-12-10 17:25:51,143,9715,70,73,6351.58,12918.10,0.00
2024-12-10 17:25:51,143,9716,70,73,6326.74,12919.00,0.00
2024-12-10 17:25:51,144,9716,70,74,6282.81,12919.01,0.00
2024-12-10 17:25:51,143,9716,69,74,6313.22,12919.10,0.00
2024-12-10 17:25:51,143,9717,69,74,6288.38,12920.00,0.00
2024-12-10 17:25:51,144,9717,69,75,6244.71,12920.01,0.00
2024-12-10 17:25:51,143,9717,68,75,6274.86,12920.10,0.00
2024-12-10 17:25:51,142,9717,68,74,6318.14,12920.11,0.00
2024-12-10 17:25:51,142,9718,68,74,6294.03,12921.00,0.00
2024-12-10 17:25:51,143,9718,68,75,6250.02,12921.01,0.00
2024-12-10 17:25:51,142,9718,67,75,6280.41,12921.11,0.00
2024-12-10 17:25:51,142,9719,67,75,6256.30,12922.00,0.00
2024-12-10 17:25:51,143,9719,68,75,6212.55,12922.01,0.00
2024-12-10 17:25:51,142,9719,67,75,6242.67,12922.11,0.00
2024-12-10 17:25:51,142,9720,67,75,6218.21,12923.00,0.00
2024-12-10 17:25:51,143,9720,68,75,6174.72,12923.01,0.00
2024-12-10 17:25:51,142,9720,67,75,6204.58,12923.11,0.00
2024-12-10 17:25:51,142,9721,67,75,6179.37,12924.00,0.00
2024-12-10 17:25:51,143,9721,68,75,6136.16,12924.01,0.00
2024-12-10 17:25:51,142,9721,67,75,6173.01,12924.05,0.00
2024-12-10 17:25:51,141,9721,67,74,6209.47,12924.10,0.00
2024-12-10 17:25:51,140,9721,67,73,6252.90,12924.10,0.00
2024-12-10 17:25:51,140,9722,67,73,6228.09,12925.00,0.00
2024-12-10 17:25:51,141,9722,68,73,6183.92,12925.01,0.00
2024-12-10 17:25:51,140,9722,67,73,6224.40,12925.03,0.00
2024-12-10 17:25:51,139,9722,67,72,6259.90,12925.09,0.00
2024-12-10 17:25:51,138,9722,67,71,6304.33,12925.09,0.00
2024-12-10 17:25:51,138,9723,67,71,6279.93,12926.00,0.00
2024-12-10 17:25:51,139,9723,68,71,6234.75,12926.01,0.00
2024-12-10 17:25:51,140,9722,68,72,6186.53,12926.05,0.00
2024-12-10 17:25:51,139,9722,67,72,6283.09,12926.10,0.00
2024-12-10 17:25:51,138,9722,66,72,6327.68,12926.10,0.00
2024-12-10 17:25:51,138,9723,66,72,6304.25,12927.00,0.00
2024-12-10 17:25:51,139,9723,66,73,6258.89,12927.01,0.00
2024-12-10 17:25:51,140,9722,66,74,6209.58,12927.06,0.00
2024-12-10 17:25:51,139,9722,65,74,6310.08,12927.10,0.00
2024-12-10 17:25:51,139,9723,65,74,6378.90,12928.00,0.00
2024-12-10 17:25:51,140,9723,66,74,6333.34,12928.01,0.00
2024-12-10 17:25:51,139,9723,65,74,6366.84,12928.09,0.00
2024-12-10 17:25:51,139,9724,65,74,6435.27,12929.00,0.00
2024-12-10 17:25:51,140,9724,65,75,6389.30,12929.01,0.00
2024-12-10 17:25:51,139,9724,64,75,6423.21,12929.09,0.00
2024-12-10 17:25:51,139,9725,64,75,6399.13,12930.00,0.00
2024-12-10 17:25:52,140,9725,64,76,6353.42,12930.01,0.00
2024-12-10 17:25:52,139,9725,64,75,6387.07,12930.09,0.00
2024-12-10 17:25:52,139,9726,64,75,6362.83,12931.00,0.00
2024-12-10 17:25:52,140,9726,65,75,6317.39,12931.01,0.00
2024-12-10 17:25:52,139,9726,64,75,6350.77,12931.09,0.00
2024-12-10 17:25:52,139,9727,64,75,6326.05,12932.00,0.00
2024-12-10 17:25:52,140,9727,64,76,6280.87,12932.01,0.00
2024-12-10 17:25:52,139,9727,63,76,6311.10,12932.09,0.00
2024-12-10 17:25:52,138,9727,62,76,6341.31,12932.20,0.00
2024-12-10 17:25:52,138,9728,62,76,6332.21,12933.00,0.00
2024-12-10 17:25:52,139,9728,62,77,6286.65,12933.01,0.00
2024-12-10 17:25:52,140,9727,63,77,6238.06,12933.05,0.00
2024-12-10 17:25:52,139,9727,62,77,6277.09,12933.10,0.00
2024-12-10 17:25:52,139,9728,62,77,6253.08,12934.00,0.00
2024-12-10 17:25:52,140,9728,63,77,6208.42,12934.01,0.00
2024-12-10 17:25:52,139,9728,62,77,6238.05,12934.06,0.00
2024-12-10 17:25:52,138,9728,62,76,6279.51,12934.09,0.00
2024-12-10 17:25:52,139,9727,63,76,6230.62,12934.13,0.00
2024-12-10 17:25:52,139,9728,63,76,6383.57,12935.00,0.00
2024-12-10 17:25:52,140,9728,64,76,6337.98,12935.01,0.00
2024-12-10 17:25:52,141,9727,64,77,6270.39,12935.17,0.00
2024-12-10 17:25:52,141,9728,64,77,6424.02,12936.00,0.00
2024-12-10 17:25:52,142,9728,64,78,6378.78,12936.01,0.00
2024-12-10 17:25:52,142,9729,64,78,6429.78,12937.00,0.00
2024-12-10 17:25:52,143,9729,64,79,6384.81,12937.01,0.00
2024-12-10 17:25:52,142,9729,64,78,6416.14,12937.11,0.00
2024-12-10 17:25:52,142,9730,64,78,6386.62,12938.00,0.00
2024-12-10 17:25:52,143,9730,65,78,6341.96,12938.01,0.00
2024-12-10 17:25:52,143,9731,65,78,6298.55,12939.00,0.00
2024-12-10 17:25:52,144,9731,65,79,6254.81,12939.01,0.00
2024-12-10 17:25:52,143,9731,65,78,6283.46,12939.11,0.00
2024-12-10 17:25:52,142,9731,65,77,6326.80,12939.11,0.00
2024-12-10 17:25:52,142,9732,65,77,6297.48,12940.00,0.00
2024-12-10 17:25:52,143,9732,66,77,6253.44,12940.01,0.00
2024-12-10 17:25:52,142,9732,65,77,6277.83,12940.11,0.00
2024-12-10 17:25:52,143,9731,66,77,6168.93,12940.63,0.00
2024-12-10 17:25:52,143,9732,66,77,6243.07,12941.00,0.00
2024-12-10 17:25:52,144,9732,66,78,6199.72,12941.01,0.00
2024-12-10 17:25:52,143,9732,66,77,6221.01,12941.11,0.00
2024-12-10 17:25:52,143,9733,66,77,6281.69,12942.00,0.00
2024-12-10 17:25:52,144,9733,66,78,6238.06,12942.01,0.00
2024-12-10 17:25:52,145,9732,67,78,6180.50,12942.10,0.00
2024-12-10 17:25:52,144,9732,67,77,6253.99,12942.12,0.00
2024-12-10 17:25:52,144,9733,67,77,6224.56,12943.00,0.00
2024-12-10 17:25:52,145,9733,67,78,6181.63,12943.01,0.00
2024-12-10 17:25:52,144,9733,67,77,6221.86,12943.02,0.00
2024-12-10 17:25:52,143,9733,66,77,6258.84,12943.06,0.00
2024-12-10 17:25:52,142,9733,66,76,6295.65,12943.11,0.00
2024-12-10 17:25:52,142,9734,66,76,6357.67,12944.00,0.00
2024-12-10 17:25:52,143,9734,66,77,6313.21,12944.01,0.00
2024-12-10 17:25:52,142,9734,66,76,6343.12,12944.11,0.00
2024-12-10 17:25:52,142,9735,66,76,6311.50,12945.00,0.00
2024-12-10 17:25:52,143,9735,67,76,6267.36,12945.01,0.00
2024-12-10 17:25:52,142,9735,67,75,6300.58,12945.08,0.00
2024-12-10 17:25:52,141,9735,67,74,6341.61,12945.11,0.00
2024-12-10 17:25:52,140,9735,67,73,6385.99,12945.11,0.00
2024-12-10 17:25:52,140,9736,67,73,6353.45,12946.00,0.00
2024-12-10 17:25:52,141,9736,67,74,6308.39,12946.01,0.00
2024-12-10 17:25:52,140,9736,67,73,6339.62,12946.11,0.00
2024-12-10 17:25:52,139,9736,67,72,6289.01,12946.82,0.00
2024-12-10 17:25:52,139,9737,67,72,6359.03,12947.00,0.00
2024-12-10 17:25:52,140,9737,68,72,6313.61,12947.01,0.00
2024-12-10 17:25:52,139,9737,68,71,6357.17,12947.01,0.00
2024-12-10 17:25:52,138,9737,67,71,6391.07,12947.10,0.00
2024-12-10 17:25:52,137,9737,67,70,6436.78,12947.10,0.00
2024-12-10 17:25:52,137,9738,67,70,6415.50,12948.00,0.00
2024-12-10 17:25:52,138,9738,68,70,6369.01,12948.01,0.00
2024-12-10 17:25:52,138,9739,68,70,6332.83,12949.00,0.00
2024-12-10 17:25:52,139,9739,68,71,6287.27,12949.01,0.00
2024-12-10 17:25:52,138,9739,67,71,6313.56,12949.11,0.00
2024-12-10 17:25:52,138,9740,67,71,6292.44,12950.00,0.00
2024-12-10 17:25:52,139,9740,68,71,6247.17,12950.01,0.00
2024-12-10 17:25:52,138,9740,67,71,6280.79,12950.04,0.00
2024-12-10 17:25:52,137,9740,66,71,6318.16,12950.10,0.00
2024-12-10 17:25:52,136,9740,66,70,6363.66,12950.10,0.00
2024-12-10 17:25:52,136,9741,66,70,6343.16,12951.00,0.00
2024-12-10 17:25:52,137,9741,66,71,6296.86,12951.01,0.00
2024-12-10 17:25:52,136,9741,65,71,6327.21,12951.10,0.00
2024-12-10 17:25:52,137,9740,66,71,6186.80,12951.85,0.00
2024-12-10 17:25:52,137,9741,66,71,6288.23,12952.00,0.00
2024-12-10 17:25:52,138,9741,67,71,6242.66,12952.01,0.00
2024-12-10 17:25:52,137,9741,67,70,6276.40,12952.07,0.00
2024-12-10 17:25:52,136,9741,67,69,6317.81,12952.10,0.00
2024-12-10 17:25:52,135,9741,67,68,6363.65,12952.10,0.00
2024-12-10 17:25:53,135,9742,67,68,6438.95,12953.00,0.00
2024-12-10 17:25:53,136,9742,67,69,6391.60,12953.01,0.00
2024-12-10 17:25:53,135,9742,67,68,6425.21,12953.10,0.00
2024-12-10 17:25:53,135,9743,67,68,6404.56,12954.00,0.00
2024-12-10 17:25:53,136,9743,67,69,6357.47,12954.01,0.00
2024-12-10 17:25:53,135,9743,66,69,6403.60,12954.01,0.00
2024-12-10 17:25:53,134,9743,65,69,6438.88,12954.09,0.00
2024-12-10 17:25:53,133,9743,65,68,6486.32,12954.09,0.00
2024-12-10 17:25:53,133,9744,65,68,6466.34,12955.00,0.00
2024-12-10 17:25:53,134,9744,66,68,6418.08,12955.01,0.00
2024-12-10 17:25:53,135,9743,66,69,6364.13,12955.04,0.00
2024-12-10 17:25:53,134,9743,66,68,6430.03,12955.09,0.00
2024-12-10 17:25:53,133,9743,65,68,6477.40,12955.09,0.00
2024-12-10 17:25:53,132,9743,64,68,6525.49,12955.09,0.00
2024-12-10 17:25:53,132,9744,64,68,6506.32,12956.00,0.00
2024-12-10 17:25:53,133,9744,65,68,6457.40,12956.01,0.00
2024-12-10 17:25:53,132,9744,65,67,6490.71,12956.08,0.00
2024-12-10 17:25:53,132,9745,65,67,6568.73,12957.00,0.00
2024-12-10 17:25:53,133,9745,66,67,6519.34,12957.01,0.00
2024-12-10 17:25:53,132,9745,65,67,6561.93,12957.02,0.00
2024-12-10 17:25:53,131,9745,64,67,6603.15,12957.08,0.00
2024-12-10 17:25:53,131,9746,64,67,6582.86,12958.00,0.00
2024-12-10 17:25:53,132,9746,65,67,6532.99,12958.01,0.00
2024-12-10 17:25:53,131,9746,64,67,6581.87,12958.01,0.00
2024-12-10 17:25:53,130,9746,63,67,6623.56,12958.07,0.00
2024-12-10 17:25:53,130,9747,63,67,6603.11,12959.00,0.00
2024-12-10 17:25:53,131,9747,63,68,6552.70,12959.01,0.00
2024-12-10 17:25:53,130,9747,63,67,6593.17,12959.08,0.00
2024-12-10 17:25:53,130,9748,63,67,6573.71,12960.00,0.00
2024-12-10 17:25:53,131,9748,63,68,6523.52,12960.01,0.00
2024-12-10 17:25:53,130,9748,63,67,6562.77,12960.08,0.00
2024-12-10 17:25:53,130,9749,63,67,6544.30,12961.00,0.00
2024-12-10 17:25:53,131,9749,64,67,6494.35,12961.01,0.00
2024-12-10 17:25:53,130,9749,64,66,6542.32,12961.02,0.00
2024-12-10 17:25:53,129,9749,64,65,6584.02,12961.08,0.00
2024-12-10 17:25:53,128,9749,64,64,6634.44,12961.08,0.00
2024-12-10 17:25:53,129,9748,64,65,6494.87,12961.78,0.00
2024-12-10 17:25:53,129,9749,64,65,6591.52,12962.00,0.00
2024-12-10 17:25:53,130,9749,65,65,6540.82,12962.01,0.00
2024-12-10 17:25:53,129,9749,64,65,6581.51,12962.08,0.00
2024-12-10 17:25:53,129,9750,64,65,6663.38,12963.00,0.00
2024-12-10 17:25:53,130,9750,64,66,6612.12,12963.01,0.00
2024-12-10 17:25:53,129,9750,64,65,6653.36,12963.08,0.00
2024-12-10 17:25:53,129,9751,64,65,6634.75,12964.00,0.00
2024-12-10 17:25:53,130,9751,65,65,6583.71,12964.01,0.00
2024-12-10 17:25:53,131,9750,65,66,6466.32,12964.54,0.00
2024-12-10 17:25:53,131,9751,65,66,6555.73,12965.00,0.00
2024-12-10 17:25:53,132,9751,66,66,6506.07,12965.01,0.00
2024-12-10 17:25:53,131,9751,65,66,6544.88,12965.08,0.00
2024-12-10 17:25:53,131,9752,65,66,6624.53,12966.00,0.00
2024-12-10 17:25:53,132,9752,65,67,6574.35,12966.01,0.00
2024-12-10 17:25:53,131,9752,65,66,6613.68,12966.08,0.00
2024-12-10 17:25:53,131,9753,65,66,6594.36,12967.00,0.00
2024-12-10 17:25:53,132,9753,65,67,6544.40,12967.01,0.00
2024-12-10 17:25:53,131,9753,64,67,6592.39,12967.02,0.00
2024-12-10 17:25:53,130,9753,64,66,6634.15,12967.08,0.00
2024-12-10 17:25:53,129,9753,64,65,6684.57,12967.08,0.00
2024-12-10 17:25:53,129,9754,64,65,6665.95,12968.00,0.00
2024-12-10 17:25:53,130,9754,65,65,6614.67,12968.01,0.00
2024-12-10 17:25:53,129,9754,64,65,6655.93,12968.08,0.00
2024-12-10 17:25:53,129,9755,64,65,6637.31,12969.00,0.00
2024-12-10 17:25:53,130,9755,65,65,6586.25,12969.01,0.00
2024-12-10 17:25:53,129,9755,65,64,6627.29,12969.08,0.00
2024-12-10 17:25:53,129,9756,65,64,6608.66,12970.00,0.00
2024-12-10 17:25:53,130,9756,65,65,6557.83,12970.01,0.00
2024-12-10 17:25:53,129,9756,65,64,6598.64,12970.08,0.00
2024-12-10 17:25:53,129,9757,65,64,6580.01,12971.00,0.00
2024-12-10 17:25:53,130,9757,66,64,6529.40,12971.01,0.00
2024-12-10 17:25:53,129,9757,65,64,6569.99,12971.08,0.00
2024-12-10 17:25:53,129,9758,65,64,6551.36,12972.00,0.00
2024-12-10 17:25:53,130,9758,65,65,6500.96,12972.01,0.00
2024-12-10 17:25:53,129,9758,64,65,6541.33,12972.08,0.00
2024-12-10 17:25:53,129,9759,64,65,6522.70,12973.00,0.00
2024-12-10 17:25:53,130,9759,65,65,6472.52,12973.01,0.00
2024-12-10 17:25:53,129,9759,64,65,6515.69,12973.05,0.00
2024-12-10 17:25:53,128,9759,64,64,6563.55,12973.07,0.00
2024-12-10 17:25:53,127,9759,63,64,6614.21,12973.07,0.00
2024-12-10 17:25:53,127,9760,63,64,6596.30,12974.00,0.00
2024-12-10 17:25:53,128,9760,63,65,6544.77,12974.01,0.00
2024-12-10 17:25:53,127,9760,62,65,6587.14,12974.07,0.00
2024-12-10 17:25:53,127,9761,62,65,6569.23,12975.00,0.00
2024-12-10 17:25:53,128,9761,62,66,6517.91,12975.01,0.00
2024-12-10 17:25:53,127,9761,61,66,6560.06,12975.07,0.00
2024-12-10 17:25:53,127,9762,61,66,6542.15,12976.00,0.00
2024-12-10 17:25:53,128,9762,61,67,6491.04,12976.01,0.00
2024-12-10 17:25:53,127,9762,61,66,6532.98,12976.07,0.00
2024-12-10 17:25:54,127,9763,61,66,6515.06,12977.00,0.00
2024-12-10 17:25:54,128,9763,61,67,6464.16,12977.01,0.00
2024-12-10 17:25:54,127,9763,60,67,6505.89,12977.07,0.00
2024-12-10 17:25:54,127,9764,60,67,6487.98,12978.00,0.00
2024-12-10 17:25:54,128,9764,60,68,6437.29,12978.01,0.00
2024-12-10 17:25:54,128,9765,60,68,6410.40,12979.00,0.00
2024-12-10 17:25:54,129,9765,61,68,6360.71,12979.01,0.00
2024-12-10 17:25:54,128,9765,61,67,6400.29,12979.08,0.00
2024-12-10 17:25:54,129,9764,62,67,6252.40,12979.85,0.00
2024-12-10 17:25:54,129,9765,62,67,6351.14,12980.00,0.00
2024-12-10 17:25:54,130,9765,63,67,6302.28,12980.01,0.00
2024-12-10 17:25:54,129,9765,62,67,6341.11,12980.08,0.00
2024-12-10 17:25:54,129,9766,62,67,6423.07,12981.00,0.00
2024-12-10 17:25:54,130,9766,63,67,6373.67,12981.01,0.00
2024-12-10 17:25:54,129,9766,63,66,6413.04,12981.08,0.00
2024-12-10 17:25:54,129,9767,63,66,6394.39,12982.00,0.00
2024-12-10 17:25:54,130,9767,63,67,6345.20,12982.01,0.00
2024-12-10 17:25:54,129,9767,63,66,6384.35,12982.08,0.00
2024-12-10 17:25:54,129,9768,63,66,6365.69,12983.00,0.00
2024-12-10 17:25:54,130,9768,63,67,6316.73,12983.01,0.00
2024-12-10 17:25:54,129,9768,63,66,6363.69,12983.02,0.00
2024-12-10 17:25:54,128,9768,63,65,6405.31,12983.07,0.00
2024-12-10 17:25:54,127,9768,63,64,6454.72,12983.07,0.00
2024-12-10 17:25:54,127,9769,63,64,6436.79,12984.00,0.00
2024-12-10 17:25:54,128,9769,63,65,6386.50,12984.01,0.00
2024-12-10 17:25:54,127,9769,62,65,6427.61,12984.07,0.00
2024-12-10 17:25:54,127,9770,62,65,6409.68,12985.00,0.00
2024-12-10 17:25:54,128,9770,62,66,6359.60,12985.01,0.00
2024-12-10 17:25:54,127,9770,61,66,6400.50,12985.07,0.00
2024-12-10 17:25:54,127,9771,61,66,6382.56,12986.00,0.00
2024-12-10 17:25:54,128,9771,62,66,6332.70,12986.01,0.00
2024-12-10 17:25:54,127,9771,62,65,6373.38,12986.07,0.00
2024-12-10 17:25:54,127,9772,62,65,6355.45,12987.00,0.00
2024-12-10 17:25:54,128,9772,62,66,6305.79,12987.01,0.00
2024-12-10 17:25:54,127,9772,62,65,6345.24,12987.08,0.00
2024-12-10 17:25:54,127,9773,62,65,6328.32,12988.00,0.00
2024-12-10 17:25:54,128,9773,63,65,6278.88,12988.01,0.00
2024-12-10 17:25:54,127,9773,63,64,6318.12,12988.08,0.00
2024-12-10 17:25:54,127,9774,63,64,6300.69,12989.00,0.00
2024-12-10 17:25:54,128,9774,64,64,6251.47,12989.01,0.00
2024-12-10 17:25:54,127,9774,64,63,6290.48,12989.08,0.00
2024-12-10 17:25:54,127,9775,64,63,6272.42,12990.00,0.00
2024-12-10 17:25:54,128,9775,64,64,6223.41,12990.01,0.00
2024-12-10 17:25:54,127,9775,63,64,6262.21,12990.08,0.00
2024-12-10 17:25:54,127,9776,63,64,6243.55,12991.00,0.00
2024-12-10 17:25:54,128,9776,64,64,6194.77,12991.01,0.00
2024-12-10 17:25:54,127,9776,63,64,6233.34,12991.08,0.00
2024-12-10 17:25:54,127,9777,63,64,6212.39,12992.00,0.00
2024-12-10 17:25:54,128,9777,63,65,6163.86,12992.01,0.00
2024-12-10 17:25:54,127,9777,62,65,6202.18,12992.08,0.00
2024-12-10 17:25:54,127,9778,62,65,6177.54,12993.00,0.00
2024-12-10 17:25:54,128,9778,62,66,6129.28,12993.01,0.00
2024-12-10 17:25:54,127,9778,61,66,6167.33,12993.08,0.00
2024-12-10 17:25:54,127,9779,61,66,6136.05,12994.00,0.00
2024-12-10 17:25:54,128,9779,61,67,6088.11,12994.01,0.00
2024-12-10 17:25:54,127,9779,60,67,6125.84,12994.08,0.00
2024-12-10 17:25:54,127,9780,60,67,6092.35,12995.00,0.00
2024-12-10 17:25:54,128,9780,60,68,6044.76,12995.01,0.00
2024-12-10 17:25:54,127,9780,60,67,6082.14,12995.08,0.00
2024-12-10 17:25:54,126,9780,60,66,6129.38,12995.08,0.00
2024-12-10 17:25:54,126,9781,60,66,6097.48,12996.00,0.00
2024-12-10 17:25:54,127,9781,61,66,6049.47,12996.01,0.00
2024-12-10 17:25:54,128,9780,62,66,6001.20,12996.03,0.00
2024-12-10 17:25:54,127,9780,62,65,6094.52,12996.09,0.00
2024-12-10 17:25:54,128,9779,63,65,5970.94,12996.69,0.00
2024-12-10 17:25:54,128,9780,63,65,6059.00,12997.00,0.00
2024-12-10 17:25:54,129,9780,63,66,6012.03,12997.01,0.00
2024-12-10 17:25:54,128,9780,62,66,6051.91,12997.05,0.00
2024-12-10 17:25:54,127,9780,61,66,6095.48,12997.08,0.00
2024-12-10 17:25:54,127,9781,61,66,6276.51,12998.00,0.00
2024-12-10 17:25:54,128,9781,61,67,6227.47,12998.01,0.00
2024-12-10 17:25:54,127,9781,60,67,6266.30,12998.08,0.00
2024-12-10 17:25:54,127,9782,60,67,6246.52,12999.00,0.00
2024-12-10 17:25:54,128,9782,61,67,6197.72,12999.01,0.00
2024-12-10 17:25:54,127,9782,61,66,6238.35,12999.06,0.00
2024-12-10 17:25:54,126,9782,61,65,6285.80,12999.07,0.00
2024-12-10 17:25:54,125,9782,60,65,6335.05,12999.07,0.00
2024-12-10 17:25:54,125,9783,60,65,6318.88,13000.00,0.00
2024-12-10 17:25:55,126,9783,60,66,6268.73,13000.01,0.00
2024-12-10 17:25:55,125,9783,59,66,6312.66,13000.05,0.00
2024-12-10 17:25:55,124,9783,59,65,6360.42,13000.06,0.00
2024-12-10 17:25:55,123,9783,58,65,6411.08,13000.07,0.00
2024-12-10 17:25:55,124,9782,58,66,6260.72,13000.81,0.00
2024-12-10 17:25:55,124,9783,58,66,6362.58,13001.00,0.00
2024-12-10 17:25:55,125,9783,59,66,6311.68,13001.01,0.00
2024-12-10 17:25:55,124,9783,58,66,6354.22,13001.06,0.00
2024-12-10 17:25:55,124,9784,58,66,6433.25,13002.00,0.00
2024-12-10 17:25:55,125,9784,58,67,6381.78,13002.01,0.00
2024-12-10 17:25:55,124,9784,57,67,6424.88,13002.06,0.00
2024-12-10 17:25:55,124,9785,57,67,6399.84,13003.00,0.00
2024-12-10 17:25:55,125,9785,58,67,6348.65,13003.01,0.00
2024-12-10 17:25:55,126,9784,58,68,6291.06,13003.08,0.00
2024-12-10 17:25:55,125,9784,58,67,6443.34,13003.08,0.00
2024-12-10 17:25:55,126,9783,58,68,6324.67,13003.58,0.00
2024-12-10 17:25:55,126,9784,58,68,6438.21,13004.00,0.00
2024-12-10 17:25:55,127,9784,59,68,6387.51,13004.01,0.00
2024-12-10 17:25:55,126,9784,59,67,6428.95,13004.07,0.00
2024-12-10 17:25:55,126,9785,59,67,6618.29,13005.00,0.00
2024-12-10 17:25:55,127,9785,59,68,6566.18,13005.01,0.00
2024-12-10 17:25:55,126,9785,59,67,6609.03,13005.07,0.00
2024-12-10 17:25:55,126,9786,59,67,6591.96,13006.00,0.00
2024-12-10 17:25:55,127,9786,60,67,6540.06,13006.01,0.00
2024-12-10 17:25:55,126,9786,60,66,6582.70,13006.07,0.00
2024-12-10 17:25:55,126,9787,60,66,6565.63,13007.00,0.00
2024-12-10 17:25:55,127,9787,61,66,6513.93,13007.01,0.00
2024-12-10 17:25:55,126,9787,61,65,6556.36,13007.07,0.00
2024-12-10 17:25:55,126,9788,61,65,6539.29,13008.00,0.00
2024-12-10 17:25:55,127,9788,61,66,6487.80,13008.01,0.00
2024-12-10 17:25:55,126,9788,60,66,6530.03,13008.07,0.00
2024-12-10 17:25:55,126,9789,60,66,6512.95,13009.00,0.00
2024-12-10 17:25:55,127,9789,61,66,6461.67,13009.01,0.00
2024-12-10 17:25:55,126,9789,60,66,6503.68,13009.07,0.00
2024-12-10 17:25:55,127,9788,60,67,6401.35,13009.48,0.00
2024-12-10 17:25:55,127,9789,60,67,6516.10,13010.00,0.00
2024-12-10 17:25:55,128,9789,61,67,6465.19,13010.01,0.00
2024-12-10 17:25:55,127,9789,61,66,6506.90,13010.07,0.00
2024-12-10 17:25:55,127,9790,61,66,6580.26,13011.00,0.00
2024-12-10 17:25:55,128,9790,62,66,6528.85,13011.01,0.00
2024-12-10 17:25:55,127,9790,62,65,6575.15,13011.04,0.00
2024-12-10 17:25:55,126,9790,61,65,6623.22,13011.06,0.00
2024-12-10 17:25:55,125,9790,60,65,6675.16,13011.06,0.00
2024-12-10 17:25:55,125,9791,60,65,6638.94,13012.00,0.00
2024-12-10 17:25:55,126,9791,60,66,6586.25,13012.01,0.00
2024-12-10 17:25:55,125,9791,60,65,6630.64,13012.06,0.00
2024-12-10 17:25:55,124,9791,59,65,6596.35,13012.69,0.00
2024-12-10 17:25:55,124,9792,59,65,6655.86,13013.00,0.00
2024-12-10 17:25:55,125,9792,59,66,6602.61,13013.01,0.00
2024-12-10 17:25:55,125,9793,59,66,6572.15,13014.00,0.00
2024-12-10 17:25:55,126,9793,59,67,6519.99,13014.01,0.00
2024-12-10 17:25:55,125,9793,58,67,6562.81,13014.07,0.00
2024-12-10 17:25:55,125,9794,58,67,6540.70,13015.00,0.00
2024-12-10 17:25:55,126,9794,58,68,6488.79,13015.01,0.00
2024-12-10 17:25:55,125,9794,58,67,6531.36,13015.07,0.00
2024-12-10 17:25:55,125,9795,58,67,6507.96,13016.00,0.00
2024-12-10 17:25:55,126,9795,58,68,6456.31,13016.01,0.00
2024-12-10 17:25:55,125,9795,58,67,6502.77,13016.04,0.00
2024-12-10 17:25:55,124,9795,57,67,6551.03,13016.06,0.00
2024-12-10 17:25:55,123,9795,57,66,6603.23,13016.07,0.00
2024-12-10 17:25:55,123,9796,57,66,6585.47,13017.00,0.00
2024-12-10 17:25:55,124,9796,57,67,6532.36,13017.01,0.00
2024-12-10 17:25:55,123,9796,56,67,6577.02,13017.07,0.00
2024-12-10 17:25:55,123,9797,56,67,6557.45,13018.00,0.00
2024-12-10 17:25:55,124,9797,56,68,6504.57,13018.01,0.00
2024-12-10 17:25:55,123,9797,55,68,6549.01,13018.07,0.00
2024-12-10 17:25:55,123,9798,55,68,6525.36,13019.00,0.00
2024-12-10 17:25:55,124,9798,55,69,6472.73,13019.01,0.00
2024-12-10 17:25:55,123,9798,55,68,6516.92,13019.07,0.00
2024-12-10 17:25:55,123,9799,55,68,6479.32,13020.00,0.00
2024-12-10 17:25:55,124,9799,55,69,6427.07,13020.01,0.00
2024-12-10 17:25:55,123,9799,55,68,6470.88,13020.07,0.00
2024-12-10 17:25:55,123,9800,55,68,6426.94,13021.00,0.00
2024-12-10 17:25:55,124,9800,56,68,6375.11,13021.01,0.00
2024-12-10 17:25:55,125,9799,56,69,6318.91,13021.06,0.00
2024-12-10 17:25:55,124,9799,56,68,6385.63,13021.07,0.00
2024-12-10 17:25:55,124,9800,56,68,6345.98,13022.00,0.00
2024-12-10 17:25:55,125,9800,57,68,6295.21,13022.01,0.00
2024-12-10 17:25:55,124,9800,56,68,6337.60,13022.06,0.00
2024-12-10 17:25:55,124,9801,56,68,6412.21,13023.00,0.00
2024-12-10 17:25:55,125,9801,57,68,6360.92,13023.01,0.00
2024-12-10 17:25:55,124,9801,56,68,6403.84,13023.06,0.00
2024-12-10 17:25:56,124,9802,56,68,6385.55,13024.00,0.00
2024-12-10 17:25:56,125,9802,56,69,6334.47,13024.01,0.00
2024-12-10 17:25:56,124,9802,55,69,6377.17,13024.06,0.00
2024-12-10 17:25:56,123,9802,54,69,6386.51,13024.33,0.00
2024-12-10 17:25:56,123,9803,54,69,6406.00,13025.00,0.00
2024-12-10 17:25:56,124,9803,55,69,6354.34,13025.01,0.00
2024-12-10 17:25:56,123,9803,54,69,6397.55,13025.07,0.00
2024-12-10 17:25:56,124,9802,54,70,6295.63,13025.47,0.00
2024-12-10 17:25:56,125,9801,54,71,6298.44,13025.54,0.00
2024-12-10 17:25:56,125,9802,54,71,6394.07,13026.00,0.00
2024-12-10 17:25:56,126,9802,54,72,6343.32,13026.01,0.00
2024-12-10 17:25:56,125,9802,53,72,6385.76,13026.06,0.00
2024-12-10 17:25:56,125,9803,53,72,6575.22,13027.00,0.00
2024-12-10 17:25:56,126,9803,53,73,6523.03,13027.01,0.00
2024-12-10 17:25:56,125,9803,53,72,6566.90,13027.06,0.00
2024-12-10 17:25:56,124,9803,53,71,6618.81,13027.06,0.00
2024-12-10 17:25:56,125,9802,53,72,6460.97,13027.89,0.00
2024-12-10 17:25:56,125,9803,53,72,6562.18,13028.00,0.00
2024-12-10 17:25:56,126,9803,53,73,6510.10,13028.01,0.00
2024-12-10 17:25:56,125,9803,52,73,6553.86,13028.06,0.00
2024-12-10 17:25:56,125,9804,52,73,6640.85,13029.00,0.00
2024-12-10 17:25:56,126,9804,52,74,6588.15,13029.01,0.00
2024-12-10 17:25:56,125,9804,52,73,6632.53,13029.06,0.00
2024-12-10 17:25:56,125,9805,52,73,6615.30,13030.00,0.00
2024-12-10 17:25:56,126,9805,53,73,6562.80,13030.01,0.00
2024-12-10 17:25:56,125,9805,53,72,6606.98,13030.06,0.00
2024-12-10 17:25:56,125,9806,53,72,6589.25,13031.00,0.00
2024-12-10 17:25:56,126,9806,54,72,6536.96,13031.01,0.00
2024-12-10 17:25:56,125,9806,53,72,6580.93,13031.06,0.00
2024-12-10 17:25:56,125,9807,53,72,6561.78,13032.00,0.00
2024-12-10 17:25:56,126,9807,54,72,6509.70,13032.01,0.00
2024-12-10 17:25:56,125,9807,54,71,6553.46,13032.06,0.00
2024-12-10 17:25:56,125,9808,54,71,6532.74,13033.00,0.00
2024-12-10 17:25:56,126,9808,55,71,6480.90,13033.01,0.00
2024-12-10 17:25:56,125,9808,55,70,6524.42,13033.06,0.00
2024-12-10 17:25:56,126,9807,56,70,6362.27,13033.89,0.00
2024-12-10 17:25:56,126,9808,56,70,6462.71,13034.00,0.00
2024-12-10 17:25:56,127,9808,56,71,6411.82,13034.01,0.00
2024-12-10 17:25:56,126,9808,55,71,6459.61,13034.02,0.00
2024-12-10 17:25:56,125,9808,54,71,6505.05,13034.06,0.00
2024-12-10 17:25:56,124,9808,53,71,6556.46,13034.06,0.00
2024-12-10 17:25:56,123,9808,52,71,6584.03,13034.21,0.00
2024-12-10 17:25:56,123,9809,52,71,6693.39,13035.00,0.00
2024-12-10 17:25:56,124,9809,53,71,6639.41,13035.01,0.00
2024-12-10 17:25:56,123,9809,53,70,6690.21,13035.02,0.00
2024-12-10 17:25:56,122,9809,52,70,6739.72,13035.06,0.00
2024-12-10 17:25:56,122,9810,52,70,6721.52,13036.00,0.00
2024-12-10 17:25:56,123,9810,52,71,6666.88,13036.01,0.00
2024-12-10 17:25:56,122,9810,52,70,6713.00,13036.07,0.00
2024-12-10 17:25:56,122,9811,52,70,6693.90,13037.00,0.00
2024-12-10 17:25:56,123,9811,52,71,6639.48,13037.01,0.00
2024-12-10 17:25:56,122,9811,52,70,6685.37,13037.07,0.00
2024-12-10 17:25:56,122,9812,52,70,6665.10,13038.00,0.00
2024-12-10 17:25:56,123,9812,52,71,6610.91,13038.01,0.00
2024-12-10 17:25:56,122,9812,51,71,6656.57,13038.07,0.00
2024-12-10 17:25:56,123,9811,51,72,6559.07,13038.42,0.00
2024-12-10 17:25:56,122,9811,51,71,6636.07,13038.73,0.00
2024-12-10 17:25:56,122,9812,51,71,6704.94,13039.00,0.00
2024-12-10 17:25:56,123,9812,51,72,6650.43,13039.01,0.00
2024-12-10 17:25:56,122,9812,51,71,6696.40,13039.07,0.00
2024-12-10 17:25:56,122,9813,51,71,6786.28,13040.00,0.00
2024-12-10 17:25:56,123,9813,52,71,6731.10,13040.01,0.00
2024-12-10 17:25:56,122,9813,51,71,6783.08,13040.02,0.00
2024-12-10 17:25:56,121,9813,50,71,6833.76,13040.06,0.00
2024-12-10 17:25:56,120,9813,49,71,6889.62,13040.06,0.00
2024-12-10 17:25:56,120,9814,49,71,6873.81,13041.00,0.00
2024-12-10 17:25:56,121,9814,49,72,6817.00,13041.01,0.00
2024-12-10 17:25:56,120,9814,49,71,6866.22,13041.06,0.00
2024-12-10 17:25:56,120,9815,49,71,6850.77,13042.00,0.00
2024-12-10 17:25:56,121,9815,50,71,6794.15,13042.01,0.00
2024-12-10 17:25:56,120,9815,50,70,6843.17,13042.06,0.00
2024-12-10 17:25:56,119,9815,49,70,6899.58,13042.06,0.00
2024-12-10 17:25:56,119,9816,49,70,6885.79,13043.00,0.00
2024-12-10 17:25:56,120,9816,50,70,6828.41,13043.01,0.00
2024-12-10 17:25:56,119,9816,50,69,6878.13,13043.06,0.00
2024-12-10 17:25:56,119,9817,50,69,6865.13,13044.00,0.00
2024-12-10 17:25:56,120,9817,50,70,6807.92,13044.01,0.00
2024-12-10 17:25:56,119,9817,50,69,6857.47,13044.06,0.00
2024-12-10 17:25:56,119,9818,50,69,6844.83,13045.00,0.00
2024-12-10 17:25:56,120,9818,51,69,6787.79,13045.01,0.00
2024-12-10 17:25:56,121,9817,52,69,6728.47,13045.05,0.00
2024-12-10 17:25:56,120,9817,51,69,6868.25,13045.07,0.00
2024-12-10 17:25:56,120,9818,51,69,6855.71,13046.00,0.00
2024-12-10 17:25:56,121,9818,51,70,6799.05,13046.01,0.00
2024-12-10 17:25:56,120,9818,51,69,6848.12,13046.06,0.00
2024-12-10 17:25:57,120,9819,51,69,6939.31,13047.00,0.00
2024-12-10 17:25:57,121,9819,52,69,6881.96,13047.01,0.00
2024-12-10 17:25:57,120,9819,51,69,6931.72,13047.06,0.00
2024-12-10 17:25:57,120,9820,51,69,6906.05,13048.00,0.00
2024-12-10 17:25:57,121,9820,51,70,6848.97,13048.01,0.00
2024-12-10 17:25:57,120,9820,50,70,6898.46,13048.06,0.00
2024-12-10 17:25:57,120,9821,50,70,6871.06,13049.00,0.00
2024-12-10 17:25:57,121,9821,50,71,6814.27,13049.01,0.00
2024-12-10 17:25:57,120,9821,50,70,6863.46,13049.06,0.00
2024-12-10 17:25:57,121,9820,51,70,6778.74,13049.29,0.00
2024-12-10 17:25:57,122,9819,51,71,6728.59,13049.45,0.00
2024-12-10 17:25:57,122,9820,51,71,6812.86,13050.00,0.00
2024-12-10 17:25:57,123,9820,52,71,6757.47,13050.01,0.00
2024-12-10 17:25:57,122,9820,51,71,6726.93,13050.61,0.00
2024-12-10 17:25:57,122,9821,51,71,6996.81,13051.00,0.00
2024-12-10 17:25:57,123,9821,52,71,6939.92,13051.01,0.00
2024-12-10 17:25:57,122,9821,51,71,6991.48,13051.04,0.00
2024-12-10 17:25:57,121,9821,51,70,7047.10,13051.05,0.00
2024-12-10 17:25:57,121,9822,51,70,7031.44,13052.00,0.00
2024-12-10 17:25:57,122,9822,52,70,6973.81,13052.01,0.00
2024-12-10 17:25:57,123,9821,53,70,6914.99,13052.04,0.00
2024-12-10 17:25:57,122,9821,52,70,7000.57,13052.06,0.00
2024-12-10 17:25:57,122,9822,52,70,6985.05,13053.00,0.00
2024-12-10 17:25:57,123,9822,52,71,6928.26,13053.01,0.00
2024-12-10 17:25:57,122,9822,52,70,6978.65,13053.05,0.00
2024-12-10 17:25:57,122,9823,52,70,7069.04,13054.00,0.00
2024-12-10 17:25:57,123,9823,52,71,7011.57,13054.01,0.00
2024-12-10 17:25:57,122,9823,52,70,7062.64,13054.05,0.00
2024-12-10 17:25:57,122,9824,52,70,7046.04,13055.00,0.00
2024-12-10 17:25:57,123,9824,53,70,6988.75,13055.01,0.00
2024-12-10 17:25:57,122,9824,53,69,7044.97,13055.01,0.00
2024-12-10 17:25:57,121,9824,52,69,7097.82,13055.04,0.00
2024-12-10 17:25:57,121,9825,52,69,7081.07,13056.00,0.00
2024-12-10 17:25:57,122,9825,53,69,7023.03,13056.01,0.00
2024-12-10 17:25:57,121,9825,52,69,7074.62,13056.05,0.00
2024-12-10 17:25:57,122,9824,52,70,6923.84,13056.78,0.00
2024-12-10 17:25:57,122,9825,52,70,7025.71,13057.00,0.00
2024-12-10 17:25:57,123,9825,52,71,6968.59,13057.01,0.00
2024-12-10 17:25:57,122,9825,51,71,7019.31,13057.05,0.00
2024-12-10 17:25:57,122,9826,51,71,7109.74,13058.00,0.00
2024-12-10 17:25:57,123,9826,51,72,7051.94,13058.01,0.00
2024-12-10 17:25:57,123,9827,51,72,7029.12,13059.00,0.00
2024-12-10 17:25:57,124,9827,51,73,6972.43,13059.01,0.00
2024-12-10 17:25:57,123,9827,51,72,7021.71,13059.06,0.00
2024-12-10 17:25:57,123,9828,51,72,7005.23,13060.00,0.00
2024-12-10 17:25:57,124,9828,52,72,6948.74,13060.01,0.00
2024-12-10 17:25:57,123,9828,52,71,6997.82,13060.06,0.00
2024-12-10 17:25:57,123,9829,52,71,6981.35,13061.00,0.00
2024-12-10 17:25:57,124,9829,53,71,6925.04,13061.01,0.00
2024-12-10 17:25:57,123,9829,53,70,6977.12,13061.03,0.00
2024-12-10 17:25:57,122,9829,53,69,7030.03,13061.06,0.00
2024-12-10 17:25:57,122,9830,53,69,7014.49,13062.00,0.00
2024-12-10 17:25:57,123,9830,53,70,6957.46,13062.01,0.00
2024-12-10 17:25:57,122,9830,52,70,7007.22,13062.06,0.00
2024-12-10 17:25:57,122,9831,52,70,6991.67,13063.00,0.00
2024-12-10 17:25:57,123,9831,53,70,6934.83,13063.01,0.00
2024-12-10 17:25:57,122,9831,53,69,6984.20,13063.06,0.00
2024-12-10 17:25:57,121,9831,52,69,7035.77,13063.10,0.00
2024-12-10 17:25:57,121,9832,52,69,7026.57,13064.00,0.00
2024-12-10 17:25:57,122,9832,53,69,6968.97,13064.01,0.00
2024-12-10 17:25:57,121,9832,52,69,7019.03,13064.06,0.00
2024-12-10 17:25:57,120,9832,52,68,7076.44,13064.06,0.00
2024-12-10 17:25:57,120,9833,52,68,7062.80,13065.00,0.00
2024-12-10 17:25:57,121,9833,52,69,7004.43,13065.01,0.00
2024-12-10 17:25:57,121,9834,52,69,6983.37,13066.00,0.00
2024-12-10 17:25:57,122,9834,53,69,6926.13,13066.01,0.00
2024-12-10 17:25:57,121,9834,53,68,6974.76,13066.07,0.00
2024-12-10 17:25:57,121,9835,53,68,6961.22,13067.00,0.00
2024-12-10 17:25:57,122,9835,53,69,6904.17,13067.01,0.00
2024-12-10 17:25:57,121,9835,53,68,6952.61,13067.07,0.00
2024-12-10 17:25:57,121,9836,53,68,6939.08,13068.00,0.00
2024-12-10 17:25:57,122,9836,54,68,6882.20,13068.01,0.00
2024-12-10 17:25:57,122,9837,54,68,6860.23,13069.00,0.00
2024-12-10 17:25:57,123,9837,54,69,6804.45,13069.01,0.00
2024-12-10 17:25:57,122,9837,53,69,6851.69,13069.07,0.00
2024-12-10 17:25:58,122,9838,53,69,6837.19,13070.00,0.00
2024-12-10 17:25:58,123,9838,54,69,6781.60,13070.01,0.00
2024-12-10 17:25:58,122,9838,54,68,6828.64,13070.07,0.00
2024-12-10 17:25:58,122,9839,54,68,6814.14,13071.00,0.00
2024-12-10 17:25:58,123,9839,55,68,6758.74,13071.01,0.00
2024-12-10 17:25:58,122,9839,54,68,6805.59,13071.07,0.00
2024-12-10 17:25:58,122,9840,54,68,6791.08,13072.00,0.00
2024-12-10 17:25:58,123,9840,55,68,6735.87,13072.01,0.00
2024-12-10 17:25:58,122,9840,55,67,6782.54,13072.07,0.00
2024-12-10 17:25:58,122,9841,55,67,6768.03,13073.00,0.00
2024-12-10 17:25:58,123,9841,56,67,6713.01,13073.01,0.00
2024-12-10 17:25:58,122,9841,55,67,6759.48,13073.07,0.00
2024-12-10 17:25:58,122,9842,55,67,6744.97,13074.00,0.00
2024-12-10 17:25:58,123,9842,56,67,6690.14,13074.01,0.00
2024-12-10 17:25:58,123,9843,56,67,6667.27,13075.00,0.00
2024-12-10 17:25:58,124,9843,57,67,6613.50,13075.01,0.00
2024-12-10 17:25:58,123,9843,57,66,6657.73,13075.07,0.00
2024-12-10 17:25:58,123,9844,57,66,6643.32,13076.00,0.00
2024-12-10 17:25:58,124,9844,58,66,6589.75,13076.01,0.00
2024-12-10 17:25:58,125,9843,58,67,6535.98,13076.03,0.00
2024-12-10 17:25:58,125,9844,58,67,6538.57,13077.00,0.00
2024-12-10 17:25:58,126,9844,59,67,6486.68,13077.01,0.00
2024-12-10 17:25:58,125,9844,59,66,6528.14,13077.08,0.00
2024-12-10 17:25:58,125,9845,59,66,6617.54,13078.00,0.00
2024-12-10 17:25:58,126,9845,60,66,6565.02,13078.01,0.00
2024-12-10 17:25:58,125,9845,60,65,6607.11,13078.08,0.00
2024-12-10 17:25:58,126,9844,60,66,6474.89,13078.71,0.00
2024-12-10 17:25:58,126,9845,60,66,6573.75,13079.00,0.00
2024-12-10 17:25:58,127,9845,60,67,6521.98,13079.01,0.00
2024-12-10 17:25:58,126,9845,59,67,6567.54,13079.05,0.00
2024-12-10 17:25:58,126,9846,59,67,6650.71,13080.00,0.00
2024-12-10 17:25:58,127,9846,59,68,6598.35,13080.01,0.00
2024-12-10 17:25:58,126,9846,58,68,6640.37,13080.08,0.00
2024-12-10 17:25:58,126,9847,58,68,6623.05,13081.00,0.00
2024-12-10 17:25:58,127,9847,58,69,6570.90,13081.01,0.00
2024-12-10 17:25:58,126,9847,57,69,6612.70,13081.08,0.00
2024-12-10 17:25:58,126,9848,57,69,6593.60,13082.00,0.00
2024-12-10 17:25:58,127,9848,57,70,6541.68,13082.01,0.00
2024-12-10 17:25:58,126,9848,57,69,6583.25,13082.08,0.00
2024-12-10 17:25:58,126,9849,57,69,6562.24,13083.00,0.00
2024-12-10 17:25:58,127,9849,58,69,6510.57,13083.01,0.00
2024-12-10 17:25:58,126,9849,58,68,6551.89,13083.08,0.00
2024-12-10 17:25:58,126,9850,58,68,6530.68,13084.00,0.00
2024-12-10 17:25:58,127,9850,58,69,6479.26,13084.01,0.00
2024-12-10 17:25:58,126,9850,58,68,6520.33,13084.08,0.00
2024-12-10 17:25:58,125,9850,58,67,6555.73,13084.20,0.00
2024-12-10 17:25:58,125,9851,58,67,6556.18,13085.00,0.00
2024-12-10 17:25:58,126,9851,59,67,6504.15,13085.01,0.00
2024-12-10 17:25:58,125,9851,59,66,6545.74,13085.08,0.00
2024-12-10 17:25:58,125,9852,59,66,6530.51,13086.00,0.00
2024-12-10 17:25:59,126,9852,60,66,6478.68,13086.01,0.00
2024-12-10 17:25:59,125,9852,59,66,6520.07,13086.08,0.00
2024-12-10 17:25:59,125,9853,59,66,6504.84,13087.00,0.00
2024-12-10 17:25:59,126,9853,60,66,6453.21,13087.01,0.00
2024-12-10 17:25:59,125,9853,60,65,6494.40,13087.08,0.00
2024-12-10 17:25:59,125,9854,60,65,6479.16,13088.00,0.00
2024-12-10 17:25:59,126,9854,61,65,6427.74,13088.01,0.00
2024-12-10 17:25:59,125,9854,60,65,6468.71,13088.08,0.00
2024-12-10 17:25:59,125,9855,60,65,6453.48,13089.00,0.00
2024-12-10 17:25:59,126,9855,60,66,6402.26,13089.01,0.00
2024-12-10 17:25:59,125,9855,59,66,6443.03,13089.08,0.00
2024-12-10 17:25:59,125,9856,59,66,6427.79,13090.00,0.00
2024-12-10 17:25:59,126,9856,59,67,6376.77,13090.01,0.00
2024-12-10 17:25:59,125,9856,59,66,6417.34,13090.08,0.00
2024-12-10 17:25:59,125,9857,59,66,6402.10,13091.00,0.00
2024-12-10 17:25:59,126,9857,60,66,6351.29,13091.01,0.00
2024-12-10 17:25:59,125,9857,59,66,6391.65,13091.08,0.00
2024-12-10 17:25:59,125,9858,59,66,6376.40,13092.00,0.00
2024-12-10 17:25:59,126,9858,60,66,6325.80,13092.01,0.00
2024-12-10 17:25:59,125,9858,60,65,6365.95,13092.08,0.00
2024-12-10 17:25:59,125,9859,60,65,6350.70,13093.00,0.00
2024-12-10 17:25:59,126,9859,60,66,6300.30,13093.01,0.00
2024-12-10 17:25:59,126,9860,60,66,6274.80,13094.00,0.00
2024-12-10 17:25:59,127,9860,61,66,6225.39,13094.01,0.00
2024-12-10 17:25:59,126,9860,61,65,6263.40,13094.09,0.00
2024-12-10 17:25:59,125,9860,61,64,6300.43,13094.18,0.00
2024-12-10 17:25:59,126,9859,61,65,6197.57,13094.60,0.00
2024-12-10 17:25:59,126,9860,61,65,6295.57,13095.00,0.00
2024-12-10 17:25:59,127,9860,62,65,6245.99,13095.01,0.00
2024-12-10 17:25:59,126,9860,62,64,6284.16,13095.09,0.00
2024-12-10 17:25:59,126,9861,62,64,6372.96,13096.00,0.00
2024-12-10 17:25:59,127,9861,63,64,6322.78,13096.01,0.00
2024-12-10 17:25:59,126,9861,63,63,6371.92,13096.01,0.00
2024-12-10 17:25:59,125,9861,62,63,6418.71,13096.03,0.00
2024-12-10 17:25:59,124,9861,61,63,6464.16,13096.07,0.00
2024-12-10 17:25:59,123,9861,60,63,6515.65,13096.07,0.00
2024-12-10 17:25:59,122,9861,59,63,6567.98,13096.07,0.00
2024-12-10 17:25:59,122,9862,59,63,6554.50,13097.00,0.00
2024-12-10 17:25:59,123,9862,60,63,6501.21,13097.01,0.00
2024-12-10 17:25:59,122,9862,60,62,6544.86,13097.07,0.00
2024-12-10 17:25:59,123,9861,60,63,6381.31,13097.93,0.00
2024-12-10 17:25:59,123,9862,60,63,6486.80,13098.00,0.00
2024-12-10 17:25:59,124,9862,60,64,6434.49,13098.01,0.00
2024-12-10 17:26:00,124,9863,60,64,6516.32,13099.00,0.00
2024-12-10 17:26:00,125,9863,60,65,6464.19,13099.01,0.00
2024-12-10 17:26:00,124,9863,59,65,6506.83,13099.07,0.00
2024-12-10 17:26:00,124,9864,59,65,6491.46,13100.00,0.00
2024-12-10 17:26:00,125,9864,59,66,6439.53,13100.01,0.00
2024-12-10 17:26:00,124,9864,58,66,6484.09,13100.06,0.00
2024-12-10 17:26:00,123,9864,58,65,6534.68,13100.07,0.00
2024-12-10 17:26:00,122,9864,58,64,6587.17,13100.07,0.00
2024-12-10 17:26:00,122,9865,58,64,6572.61,13101.00,0.00
2024-12-10 17:26:00,123,9865,59,64,6519.17,13101.01,0.00
2024-12-10 17:26:00,122,9865,58,64,6564.04,13101.07,0.00
2024-12-10 17:26:00,121,9865,57,64,6612.24,13101.11,0.00
2024-12-10 17:26:00,121,9866,57,64,6604.05,13102.00,0.00
2024-12-10 17:26:00,122,9866,57,65,6549.92,13102.01,0.00
2024-12-10 17:26:00,121,9866,57,64,6595.41,13102.07,0.00
2024-12-10 17:26:00,121,9867,57,64,6581.82,13103.00,0.00
2024-12-10 17:26:00,122,9867,58,64,6527.87,13103.01,0.00
2024-12-10 17:26:00,121,9867,58,63,6578.58,13103.02,0.00
2024-12-10 17:26:00,120,9867,57,63,6627.95,13103.06,0.00
2024-12-10 17:26:00,119,9867,57,62,6682.55,13103.06,0.00
2024-12-10 17:26:00,119,9868,57,62,6669.82,13104.00,0.00
2024-12-10 17:26:00,120,9868,58,62,6614.24,13104.01,0.00
2024-12-10 17:26:00,119,9868,57,62,6662.13,13104.06,0.00
2024-12-10 17:26:00,119,9869,57,62,6649.41,13105.00,0.00
2024-12-10 17:26:00,120,9869,58,62,6593.99,13105.01,0.00
2024-12-10 17:26:00,119,9869,58,61,6641.72,13105.06,0.00
2024-12-10 17:26:00,119,9870,58,61,6627.23,13106.00,0.00
2024-12-10 17:26:00,120,9870,59,61,6572.00,13106.01,0.00
2024-12-10 17:26:00,120,9871,59,61,6551.27,13107.00,0.00
2024-12-10 17:26:00,121,9871,59,62,6497.13,13107.01,0.00
2024-12-10 17:26:00,120,9871,58,62,6543.65,13107.06,0.00
2024-12-10 17:26:00,120,9872,58,62,6529.93,13108.00,0.00
2024-12-10 17:26:00,121,9872,58,63,6475.96,13108.01,0.00
2024-12-10 17:26:00,120,9872,58,62,6522.30,13108.06,0.00
2024-12-10 17:26:00,120,9873,58,62,6508.58,13109.00,0.00
2024-12-10 17:26:00,121,9873,59,62,6454.79,13109.01,0.00
2024-12-10 17:26:00,120,9873,58,62,6500.95,13109.06,0.00
2024-12-10 17:26:00,120,9874,58,62,6487.22,13110.00,0.00
2024-12-10 17:26:00,121,9874,58,63,6433.61,13110.01,0.00
2024-12-10 17:26:00,121,9875,58,63,6412.43,13111.00,0.00
2024-12-10 17:26:00,122,9875,58,64,6359.87,13111.01,0.00
2024-12-10 17:26:00,123,9874,59,64,6307.10,13111.03,0.00
2024-12-10 17:26:00,122,9874,58,64,6423.30,13111.07,0.00
2024-12-10 17:26:00,122,9875,58,64,6408.72,13112.00,0.00
2024-12-10 17:26:00,123,9875,59,64,6356.61,13112.01,0.00
2024-12-10 17:26:00,122,9875,59,63,6401.22,13112.06,0.00
2024-12-10 17:26:00,122,9876,59,63,6493.04,13113.00,0.00
2024-12-10 17:26:00,123,9876,60,63,6440.26,13113.01,0.00
2024-12-10 17:26:00,122,9876,60,62,6485.54,13113.06,0.00
2024-12-10 17:26:00,123,9875,60,63,6349.88,13113.71,0.00
2024-12-10 17:26:01,123,9876,60,63,6453.54,13114.00,0.00
2024-12-10 17:26:01,124,9876,60,64,6401.50,13114.01,0.00
2024-12-10 17:26:01,123,9876,60,63,6446.10,13114.06,0.00
2024-12-10 17:26:01,124,9875,60,64,6357.15,13114.35,0.00
2024-12-10 17:26:01,124,9876,60,64,6557.46,13115.00,0.00
2024-12-10 17:26:01,125,9876,61,64,6505.00,13115.01,0.00
2024-12-10 17:26:01,125,9877,61,64,6585.24,13116.00,0.00
2024-12-10 17:26:01,126,9877,61,65,6532.98,13116.01,0.00
2024-12-10 17:26:01,125,9877,61,64,6576.87,13116.06,0.00
2024-12-10 17:26:01,126,9876,61,65,6453.02,13116.63,0.00
2024-12-10 17:26:01,126,9876,61,65,6550.13,13117.00,0.00
2024-12-10 17:26:01,127,9876,62,65,6498.56,13117.01,0.00
2024-12-10 17:26:01,126,9876,62,64,6541.82,13117.06,0.00
2024-12-10 17:26:01,126,9877,62,64,6627.67,13118.00,0.00
2024-12-10 17:26:01,127,9877,63,64,6575.49,13118.01,0.00
2024-12-10 17:26:01,126,9877,63,63,6619.36,13118.06,0.00
2024-12-10 17:26:01,126,9878,63,63,6601.11,13119.00,0.00
2024-12-10 17:26:01,127,9878,63,64,6549.13,13119.01,0.00
2024-12-10 17:26:01,126,9878,63,63,6592.80,13119.06,0.00
2024-12-10 17:26:01,126,9879,63,63,6574.54,13120.00,0.00
2024-12-10 17:26:01,127,9879,64,63,6522.77,13120.01,0.00
2024-12-10 17:26:01,126,9879,64,62,6566.23,13120.06,0.00
2024-12-10 17:26:01,126,9880,64,62,6547.97,13121.00,0.00
2024-12-10 17:26:01,127,9880,65,62,6496.41,13121.01,0.00
2024-12-10 17:26:01,126,9880,64,62,6539.65,13121.06,0.00
2024-12-10 17:26:01,126,9881,64,62,6521.39,13122.00,0.00
2024-12-10 17:26:01,127,9881,64,63,6470.04,13122.01,0.00
2024-12-10 17:26:01,126,9881,63,63,6512.03,13122.07,0.00
2024-12-10 17:26:01,126,9882,63,63,6494.80,13123.00,0.00
2024-12-10 17:26:01,127,9882,64,63,6443.66,13123.01,0.00
2024-12-10 17:26:01,126,9882,63,63,6485.45,13123.07,0.00
2024-12-10 17:26:01,126,9883,63,63,6468.22,13124.00,0.00
2024-12-10 17:26:01,127,9883,64,63,6417.29,13124.01,0.00
2024-12-10 17:26:01,126,9883,64,62,6458.86,13124.07,0.00
2024-12-10 17:26:01,126,9884,64,62,6441.63,13125.00,0.00
2024-12-10 17:26:01,127,9884,65,62,6390.91,13125.01,0.00
2024-12-10 17:26:01,126,9884,64,62,6438.52,13125.02,0.00
2024-12-10 17:26:01,125,9884,63,62,6483.73,13125.06,0.00
2024-12-10 17:26:01,124,9884,63,61,6534.96,13125.06,0.00
2024-12-10 17:26:01,123,9884,63,60,6587.02,13125.07,0.00
2024-12-10 17:26:01,123,9885,63,60,6571.50,13126.00,0.00
2024-12-10 17:26:01,124,9885,64,60,6518.50,13126.01,0.00
2024-12-10 17:26:01,123,9885,64,59,6562.98,13126.07,0.00
2024-12-10 17:26:01,123,9886,64,59,6547.45,13127.00,0.00
2024-12-10 17:26:01,124,9886,64,60,6494.65,13127.01,0.00
2024-12-10 17:26:01,123,9886,64,59,6541.06,13127.05,0.00
2024-12-10 17:26:01,122,9886,64,58,6592.53,13127.06,0.00
2024-12-10 17:26:01,121,9886,64,57,6645.93,13127.06,0.00
2024-12-10 17:26:01,121,9887,64,57,6631.23,13128.00,0.00
2024-12-10 17:26:01,122,9887,64,58,6576.87,13128.01,0.00
2024-12-10 17:26:01,121,9887,64,57,6623.65,13128.06,0.00
2024-12-10 17:26:01,121,9888,64,57,6608.95,13129.00,0.00
2024-12-10 17:26:01,122,9888,64,58,6554.77,13129.01,0.00
2024-12-10 17:26:01,121,9888,64,57,6601.37,13129.06,0.00
2024-12-10 17:26:01,121,9889,64,57,6586.66,13130.00,0.00
2024-12-10 17:26:01,122,9889,64,58,6532.67,13130.01,0.00
2024-12-10 17:26:01,121,9889,63,58,6579.08,13130.06,0.00
2024-12-10 17:26:01,121,9890,63,58,6564.37,13131.00,0.00
2024-12-10 17:26:01,122,9890,63,59,6510.57,13131.01,0.00
2024-12-10 17:26:01,121,9890,62,59,6556.79,13131.06,0.00
2024-12-10 17:26:01,121,9891,62,59,6542.08,13132.00,0.00
2024-12-10 17:26:01,122,9891,63,59,6488.46,13132.01,0.00
2024-12-10 17:26:01,121,9891,62,59,6534.50,13132.06,0.00
2024-12-10 17:26:01,121,9892,62,59,6519.79,13133.00,0.00
2024-12-10 17:26:01,122,9892,63,59,6466.35,13133.01,0.00
2024-12-10 17:26:01,121,9892,63,58,6513.29,13133.05,0.00
2024-12-10 17:26:01,120,9892,62,58,6566.47,13133.05,0.00
2024-12-10 17:26:01,120,9893,62,58,6551.63,13134.00,0.00
2024-12-10 17:26:01,121,9893,63,58,6497.49,13134.01,0.00
2024-12-10 17:26:01,120,9893,63,57,6543.99,13134.06,0.00
2024-12-10 17:26:02,120,9894,63,57,6530.24,13135.00,0.00
2024-12-10 17:26:02,121,9894,64,57,6476.27,13135.01,0.00
2024-12-10 17:26:02,120,9894,63,57,6522.59,13135.06,0.00
2024-12-10 17:26:02,120,9895,63,57,6508.85,13136.00,0.00
2024-12-10 17:26:02,121,9895,64,57,6455.05,13136.01,0.00
2024-12-10 17:26:02,120,9895,64,56,6501.20,13136.06,0.00
2024-12-10 17:26:02,121,9894,65,56,6350.07,13136.82,0.00
2024-12-10 17:26:02,121,9895,65,56,6457.72,13137.00,0.00
2024-12-10 17:26:02,122,9895,65,57,6404.79,13137.01,0.00
2024-12-10 17:26:02,121,9895,65,56,6450.13,13137.06,0.00
2024-12-10 17:26:02,121,9896,65,56,6543.99,13138.00,0.00
2024-12-10 17:26:02,122,9896,65,57,6490.35,13138.01,0.00
2024-12-10 17:26:02,121,9896,65,56,6539.65,13138.03,0.00
2024-12-10 17:26:02,120,9896,65,55,6590.87,13138.05,0.00
2024-12-10 17:26:02,119,9896,65,54,6645.15,13138.05,0.00
2024-12-10 17:26:02,120,9895,66,54,6582.12,13138.13,0.00
2024-12-10 17:26:02,120,9896,66,54,6641.73,13139.00,0.00
2024-12-10 17:26:02,121,9896,66,55,6586.83,13139.01,0.00
2024-12-10 17:26:02,120,9896,66,54,6635.17,13139.05,0.00
2024-12-10 17:26:02,120,9897,66,54,6729.83,13140.00,0.00
2024-12-10 17:26:02,121,9897,66,55,6674.21,13140.01,0.00
2024-12-10 17:26:02,120,9897,65,55,6723.27,13140.05,0.00
2024-12-10 17:26:02,121,9896,65,56,6603.78,13140.55,0.00
2024-12-10 17:26:02,121,9897,65,56,6704.04,13141.00,0.00
2024-12-10 17:26:02,122,9897,66,56,6649.09,13141.01,0.00
2024-12-10 17:26:02,121,9897,66,55,6697.54,13141.05,0.00
2024-12-10 17:26:02,121,9898,66,55,6790.35,13142.00,0.00
2024-12-10 17:26:02,122,9898,66,56,6734.70,13142.01,0.00
2024-12-10 17:26:02,121,9898,65,56,6783.85,13142.05,0.00
2024-12-10 17:26:02,121,9899,65,56,6768.06,13143.00,0.00
2024-12-10 17:26:02,122,9899,65,57,6712.58,13143.01,0.00
2024-12-10 17:26:02,121,9899,64,57,6761.55,13143.05,0.00
2024-12-10 17:26:02,122,9898,65,57,6609.49,13143.80,0.00
2024-12-10 17:26:02,122,9899,65,57,6714.17,13144.00,0.00
2024-12-10 17:26:02,123,9899,65,58,6659.59,13144.01,0.00
2024-12-10 17:26:02,124,9898,65,59,6595.30,13144.10,0.00
2024-12-10 17:26:02,124,9899,65,59,6790.84,13145.00,0.00
2024-12-10 17:26:02,125,9899,65,60,6736.51,13145.01,0.00
2024-12-10 17:26:02,124,9899,64,60,6783.43,13145.06,0.00
2024-12-10 17:26:02,124,9900,64,60,6871.93,13146.00,0.00
2024-12-10 17:26:02,125,9900,65,60,6816.95,13146.01,0.00
2024-12-10 17:26:02,124,9900,65,59,6863.47,13146.06,0.00
2024-12-10 17:26:02,124,9901,65,59,6847.00,13147.00,0.00
2024-12-10 17:26:02,125,9901,65,60,6792.23,13147.01,0.00
2024-12-10 17:26:02,124,9901,64,60,6838.54,13147.06,0.00
2024-12-10 17:26:02,124,9902,64,60,6822.08,13148.00,0.00
2024-12-10 17:26:02,125,9902,64,61,6767.50,13148.01,0.00
2024-12-10 17:26:02,125,9903,64,61,6742.77,13149.00,0.00
2024-12-10 17:26:02,126,9903,65,61,6689.25,13149.01,0.00
2024-12-10 17:26:02,125,9903,65,60,6739.62,13149.02,0.00
2024-12-10 17:26:02,124,9903,65,59,6792.91,13149.02,0.00
2024-12-10 17:26:02,123,9903,64,59,6841.75,13149.07,0.00
2024-12-10 17:26:02,122,9903,64,58,6896.75,13149.07,0.00
2024-12-10 17:26:02,122,9904,64,58,6882.16,13150.00,0.00
2024-12-10 17:26:02,123,9904,65,58,6826.20,13150.01,0.00
2024-12-10 17:26:02,122,9904,64,58,6873.56,13150.07,0.00
2024-12-10 17:26:02,123,9903,65,58,6816.61,13150.09,0.00
2024-12-10 17:26:02,123,9904,65,58,6907.98,13151.00,0.00
2024-12-10 17:26:02,124,9904,66,58,6852.27,13151.01,0.00
2024-12-10 17:26:02,123,9904,65,58,6899.45,13151.07,0.00
2024-12-10 17:26:02,123,9905,65,58,6990.83,13152.00,0.00
2024-12-10 17:26:02,124,9905,66,58,6934.46,13152.01,0.00
2024-12-10 17:26:02,123,9905,65,58,6981.25,13152.07,0.00
2024-12-10 17:26:02,123,9906,65,58,6966.77,13153.00,0.00
2024-12-10 17:26:03,124,9906,66,58,6910.59,13153.01,0.00
2024-12-10 17:26:03,123,9906,66,57,6957.19,13153.07,0.00
2024-12-10 17:26:03,123,9907,66,57,6942.71,13154.00,0.00
2024-12-10 17:26:03,124,9907,67,57,6886.72,13154.01,0.00
2024-12-10 17:26:03,123,9907,67,56,6933.12,13154.07,0.00
2024-12-10 17:26:03,123,9908,67,56,6918.63,13155.00,0.00
2024-12-10 17:26:03,124,9908,68,56,6862.84,13155.01,0.00
2024-12-10 17:26:03,123,9908,67,56,6909.04,13155.07,0.00
2024-12-10 17:26:03,124,9907,68,56,6841.66,13155.18,0.00
2024-12-10 17:26:03,125,9906,69,56,6863.79,13155.31,0.00
2024-12-10 17:26:03,126,9905,70,56,6876.17,13155.40,0.00
2024-12-10 17:26:03,127,9904,70,57,6855.30,13155.66,0.00
2024-12-10 17:26:03,127,9905,70,57,6952.96,13156.00,0.00
2024-12-10 17:26:03,128,9905,71,57,6898.64,13156.01,0.00
2024-12-10 17:26:03,127,9905,70,57,6949.86,13156.02,0.00
2024-12-10 17:26:03,126,9905,69,57,6998.78,13156.06,0.00
2024-12-10 17:26:03,125,9905,69,56,7053.72,13156.06,0.00
2024-12-10 17:26:03,125,9906,69,56,7457.35,13157.00,0.00
2024-12-10 17:26:03,126,9906,70,56,7398.16,13157.01,0.00
2024-12-10 17:26:03,125,9906,70,55,7448.96,13157.06,0.00
2024-12-10 17:26:03,125,9907,70,55,7431.60,13158.00,0.00
2024-12-10 17:26:03,126,9907,71,55,7372.62,13158.01,0.00
2024-12-10 17:26:03,125,9907,71,54,7423.21,13158.06,0.00
2024-12-10 17:26:03,125,9908,71,54,7405.85,13159.00,0.00
2024-12-10 17:26:03,126,9908,71,55,7347.07,13159.01,0.00
2024-12-10 17:26:03,125,9908,71,54,7397.46,13159.06,0.00
2024-12-10 17:26:03,125,9909,71,54,7380.09,13160.00,0.00
2024-12-10 17:26:03,126,9909,72,54,7321.52,13160.01,0.00
2024-12-10 17:26:03,125,9909,71,54,7371.70,13160.06,0.00
2024-12-10 17:26:03,125,9910,71,54,7354.33,13161.00,0.00
2024-12-10 17:26:03,126,9910,72,54,7295.96,13161.01,0.00
2024-12-10 17:26:03,125,9910,71,54,7345.94,13161.06,0.00
2024-12-10 17:26:03,125,9911,71,54,7328.56,13162.00,0.00
2024-12-10 17:26:03,126,9911,71,55,7270.40,13162.01,0.00
2024-12-10 17:26:03,125,9911,71,54,7320.17,13162.06,0.00
2024-12-10 17:26:03,126,9910,71,55,7187.08,13162.65,0.00
2024-12-10 17:26:03,126,9911,71,55,7281.40,13163.00,0.00
2024-12-10 17:26:03,127,9911,72,55,7224.06,13163.01,0.00
2024-12-10 17:26:03,126,9911,71,55,7273.07,13163.06,0.00
2024-12-10 17:26:03,126,9912,71,55,7359.26,13164.00,0.00
2024-12-10 17:26:03,127,9912,72,55,7301.32,13164.01,0.00
2024-12-10 17:26:03,126,9912,71,55,7350.94,13164.06,0.00
2024-12-10 17:26:03,126,9913,71,55,7332.66,13165.00,0.00
2024-12-10 17:26:03,127,9913,71,56,7274.92,13165.01,0.00
2024-12-10 17:26:03,128,9912,72,56,7217.05,13165.03,0.00
2024-12-10 17:26:03,127,9912,72,55,7322.64,13165.07,0.00
2024-12-10 17:26:03,127,9913,72,55,7304.50,13166.00,0.00
2024-12-10 17:26:03,128,9913,73,55,7247.43,13166.01,0.00
2024-12-10 17:26:03,128,9914,73,55,7323.08,13167.00,0.00
2024-12-10 17:26:03,129,9914,74,55,7266.31,13167.01,0.00
2024-12-10 17:26:03,128,9914,74,54,7313.86,13167.07,0.00
2024-12-10 17:26:03,128,9915,74,54,7294.83,13168.00,0.00
2024-12-10 17:26:03,129,9915,75,54,7238.28,13168.01,0.00
2024-12-10 17:26:03,128,9915,74,54,7285.61,13168.07,0.00
2024-12-10 17:26:03,128,9915,74,54,7266.57,13169.00,0.00
2024-12-10 17:26:03,129,9915,74,55,7210.24,13169.01,0.00
2024-12-10 17:26:03,128,9915,74,54,7257.35,13169.07,0.00
2024-12-10 17:26:03,128,9916,74,54,7238.32,13170.00,0.00
2024-12-10 17:26:03,129,9916,75,54,7182.21,13170.01,0.00
2024-12-10 17:26:03,130,9915,75,55,7124.94,13170.04,0.00
2024-12-10 17:26:03,129,9915,74,55,7230.23,13170.08,0.00
2024-12-10 17:26:03,129,9916,74,55,7211.34,13171.00,0.00
2024-12-10 17:26:03,130,9916,74,56,7155.87,13171.01,0.00
2024-12-10 17:26:03,129,9916,73,56,7202.19,13171.07,0.00
2024-12-10 17:26:03,129,9917,73,56,7284.38,13172.00,0.00
2024-12-10 17:26:03,130,9917,73,57,7228.35,13172.01,0.00
2024-12-10 17:26:03,129,9917,72,57,7275.23,13172.07,0.00
2024-12-10 17:26:03,129,9918,72,57,7255.32,13173.00,0.00
2024-12-10 17:26:03,130,9918,73,57,7199.51,13173.01,0.00
2024-12-10 17:26:03,129,9918,72,57,7246.17,13173.07,0.00
2024-12-10 17:26:03,129,9919,72,57,7226.26,13174.00,0.00
2024-12-10 17:26:03,130,9919,73,57,7170.67,13174.01,0.00
2024-12-10 17:26:03,129,9919,72,57,7217.10,13174.07,0.00
2024-12-10 17:26:03,129,9920,72,57,7197.19,13175.00,0.00
2024-12-10 17:26:03,130,9920,72,58,7141.83,13175.01,0.00
2024-12-10 17:26:03,130,9921,72,58,7112.98,13176.00,0.00
2024-12-10 17:26:03,131,9921,72,59,7058.68,13176.01,0.00
2024-12-10 17:26:03,130,9921,72,58,7111.96,13176.01,0.00
2024-12-10 17:26:03,129,9921,71,58,7157.94,13176.07,0.00
2024-12-10 17:26:03,128,9921,71,57,7212.83,13176.07,0.00
2024-12-10 17:26:04,128,9922,71,57,7193.78,13177.00,0.00
2024-12-10 17:26:04,129,9922,72,57,7138.01,13177.01,0.00
2024-12-10 17:26:04,128,9922,71,57,7184.55,13177.07,0.00
2024-12-10 17:26:04,128,9923,71,57,7165.50,13178.00,0.00
2024-12-10 17:26:04,129,9923,72,57,7109.95,13178.01,0.00
2024-12-10 17:26:04,128,9923,71,57,7156.27,13178.07,0.00
2024-12-10 17:26:04,127,9923,71,56,7211.58,13178.07,0.00
2024-12-10 17:26:04,128,9922,72,56,7080.30,13178.66,0.00
2024-12-10 17:26:04,129,9921,73,56,7046.95,13178.77,0.00
2024-12-10 17:26:04,129,9922,73,56,7142.16,13179.00,0.00
2024-12-10 17:26:04,130,9922,73,57,7087.22,13179.01,0.00
2024-12-10 17:26:04,130,9923,73,57,7261.13,13180.00,0.00
2024-12-10 17:26:04,131,9923,74,57,7205.70,13180.01,0.00
2024-12-10 17:26:04,131,9924,74,57,7176.06,13181.00,0.00
2024-12-10 17:26:04,132,9924,75,57,7121.70,13181.01,0.00
2024-12-10 17:26:04,131,9924,75,56,7165.04,13181.08,0.00
2024-12-10 17:26:04,131,9925,75,56,7145.41,13182.00,0.00
2024-12-10 17:26:04,132,9925,76,56,7091.28,13182.01,0.00
2024-12-10 17:26:04,131,9925,76,55,7134.39,13182.08,0.00
2024-12-10 17:26:04,131,9926,76,55,7114.76,13183.00,0.00
2024-12-10 17:26:04,132,9926,77,55,7060.86,13183.01,0.00
2024-12-10 17:26:04,131,9926,76,55,7103.73,13183.08,0.00
2024-12-10 17:26:04,132,9925,76,56,6950.40,13183.86,0.00
2024-12-10 17:26:04,132,9926,76,56,7047.41,13184.00,0.00
2024-12-10 17:26:04,133,9926,76,57,6994.42,13184.01,0.00
2024-12-10 17:26:04,132,9926,76,56,7036.47,13184.08,0.00
2024-12-10 17:26:04,133,9925,77,56,6971.68,13184.19,0.00
2024-12-10 17:26:04,133,9926,77,56,7149.60,13185.00,0.00
2024-12-10 17:26:04,134,9926,78,56,7096.25,13185.01,0.00
2024-12-10 17:26:04,133,9926,77,56,7138.74,13185.08,0.00
2024-12-10 17:26:04,133,9927,77,56,7216.57,13186.00,0.00
2024-12-10 17:26:04,134,9927,77,57,7162.71,13186.01,0.00
2024-12-10 17:26:04,133,9927,76,57,7205.71,13186.08,0.00
2024-12-10 17:26:04,133,9928,76,57,7182.47,13187.00,0.00
2024-12-10 17:26:04,134,9928,76,58,7128.87,13187.01,0.00
2024-12-10 17:26:04,133,9928,75,58,7171.60,13187.08,0.00
2024-12-10 17:26:04,133,9929,75,58,7144.59,13188.00,0.00
2024-12-10 17:26:04,134,9929,75,59,7091.27,13188.01,0.00
2024-12-10 17:26:04,133,9929,74,59,7133.72,13188.08,0.00
2024-12-10 17:26:04,134,9928,75,59,7055.92,13188.28,0.00
2024-12-10 17:26:04,134,9929,75,59,7125.79,13189.00,0.00
2024-12-10 17:26:04,135,9929,76,59,7073.01,13189.01,0.00
2024-12-10 17:26:04,136,9928,76,60,6930.13,13189.71,0.00
2024-12-10 17:26:04,137,9927,76,61,6909.40,13189.72,0.00
2024-12-10 17:26:04,137,9928,76,61,7086.08,13190.00,0.00
2024-12-10 17:26:04,138,9928,77,61,7034.73,13190.01,0.00
2024-12-10 17:26:04,139,9927,78,61,6982.23,13190.04,0.00
2024-12-10 17:26:04,138,9927,78,60,7073.00,13190.09,0.00
2024-12-10 17:26:04,138,9928,78,60,7232.78,13191.00,0.00
2024-12-10 17:26:04,139,9928,79,60,7180.75,13191.01,0.00
2024-12-10 17:26:04,139,9929,79,60,7227.72,13192.00,0.00
2024-12-10 17:26:04,140,9929,79,61,7176.10,13192.01,0.00
2024-12-10 17:26:04,139,9929,78,61,7215.43,13192.09,0.00
2024-12-10 17:26:04,138,9929,78,60,7264.88,13192.11,0.00
2024-12-10 17:26:04,138,9930,78,60,7224.83,13193.00,0.00
2024-12-10 17:26:04,139,9930,79,60,7172.85,13193.01,0.00
2024-12-10 17:26:04,139,9931,79,60,7116.35,13194.00,0.00
2024-12-10 17:26:04,140,9931,80,60,7065.52,13194.01,0.00
2024-12-10 17:26:04,139,9931,80,59,7111.62,13194.04,0.00
2024-12-10 17:26:04,138,9931,79,59,7154.57,13194.09,0.00
2024-12-10 17:26:04,138,9932,79,59,7111.42,13195.00,0.00
2024-12-10 17:26:04,139,9932,80,59,7060.26,13195.01,0.00
2024-12-10 17:26:04,138,9932,79,59,7099.03,13195.09,0.00
2024-12-10 17:26:04,139,9931,79,60,6929.75,13195.89,0.00
2024-12-10 17:26:04,139,9932,79,60,7015.43,13196.00,0.00
2024-12-10 17:26:04,140,9932,80,60,6965.32,13196.01,0.00
2024-12-10 17:26:04,141,9931,80,61,6816.75,13196.68,0.00
2024-12-10 17:26:04,141,9932,80,61,6978.30,13197.00,0.00
2024-12-10 17:26:04,142,9932,81,61,6929.16,13197.01,0.00
2024-12-10 17:26:04,141,9932,81,60,6968.98,13197.07,0.00
2024-12-10 17:26:04,140,9932,80,60,7015.00,13197.09,0.00
2024-12-10 17:26:04,139,9932,80,59,7064.51,13197.09,0.00
2024-12-10 17:26:04,138,9932,79,59,7016.52,13197.68,0.00
2024-12-10 17:26:04,138,9933,79,59,7160.61,13198.00,0.00
2024-12-10 17:26:04,139,9933,80,59,7109.10,13198.01,0.00
2024-12-10 17:26:04,138,9933,80,58,7148.23,13198.09,0.00
2024-12-10 17:26:04,138,9934,80,58,7096.55,13199.00,0.00
2024-12-10 17:26:04,139,9934,80,59,7045.50,13199.01,0.00
2024-12-10 17:26:04,138,9934,80,58,7084.17,13199.09,0.00
2024-12-10 17:26:04,137,9934,79,58,7060.07,13199.62,0.00
2024-12-10 17:26:05,137,9935,79,58,7085.41,13200.00,0.00
2024-12-10 17:26:05,138,9935,79,59,7034.07,13200.01,0.00
2024-12-10 17:26:05,137,9935,79,58,7072.94,13200.09,0.00
2024-12-10 17:26:05,137,9936,79,58,7024.75,13201.00,0.00
2024-12-10 17:26:05,138,9936,80,58,6973.85,13201.01,0.00
2024-12-10 17:26:05,137,9936,79,58,7012.27,13201.09,0.00
2024-12-10 17:26:05,136,9936,79,57,6944.00,13201.90,0.00
2024-12-10 17:26:05,136,9937,79,57,7027.54,13202.00,0.00
2024-12-10 17:26:05,137,9937,79,58,6976.24,13202.01,0.00
2024-12-10 17:26:05,136,9937,79,57,7014.96,13202.10,0.00
2024-12-10 17:26:05,136,9938,79,57,6984.49,13203.00,0.00
2024-12-10 17:26:05,137,9938,80,57,6933.51,13203.01,0.00
2024-12-10 17:26:05,136,9938,79,57,6971.92,13203.10,0.00
2024-12-10 17:26:05,137,9937,79,58,6885.43,13203.38,0.00
2024-12-10 17:26:05,138,9936,80,58,6844.89,13203.75,0.00
2024-12-10 17:26:05,138,9937,80,58,6929.90,13204.00,0.00
2024-12-10 17:26:05,139,9937,80,59,6880.04,13204.01,0.00
2024-12-10 17:26:05,138,9937,79,59,6917.50,13204.09,0.00
2024-12-10 17:26:05,139,9936,80,59,6840.23,13204.32,0.00
2024-12-10 17:26:05,139,9937,80,59,7092.57,13205.00,0.00
2024-12-10 17:26:05,140,9937,81,59,7041.91,13205.01,0.00
2024-12-10 17:26:05,139,9937,80,59,7080.27,13205.09,0.00
2024-12-10 17:26:05,140,9936,80,60,7001.44,13205.32,0.00
2024-12-10 17:26:05,140,9937,80,60,7158.88,13206.00,0.00
2024-12-10 17:26:05,141,9937,81,60,7108.10,13206.01,0.00
2024-12-10 17:26:05,140,9937,80,60,7146.65,13206.09,0.00
2024-12-10 17:26:05,140,9938,80,60,7204.06,13207.00,0.00
2024-12-10 17:26:05,141,9938,81,60,7152.96,13207.01,0.00
2024-12-10 17:26:05,140,9938,81,59,7191.83,13207.09,0.00
2024-12-10 17:26:05,139,9938,80,59,7176.22,13207.57,0.00
2024-12-10 17:26:05,139,9939,80,59,7208.43,13208.00,0.00
2024-12-10 17:26:05,140,9939,81,59,7156.94,13208.01,0.00
2024-12-10 17:26:05,139,9939,81,58,7196.11,13208.09,0.00
2024-12-10 17:26:05,139,9940,81,58,7164.89,13209.00,0.00
2024-12-10 17:26:05,140,9940,82,58,7113.71,13209.01,0.00
2024-12-10 17:26:05,139,9940,81,58,7152.58,13209.09,0.00
2024-12-10 17:26:05,139,9941,81,58,7120.23,13210.00,0.00
2024-12-10 17:26:05,140,9941,81,59,7069.37,13210.01,0.00
2024-12-10 17:26:05,139,9941,81,58,7107.91,13210.09,0.00
2024-12-10 17:26:05,139,9942,81,58,7074.81,13211.00,0.00
2024-12-10 17:26:05,140,9942,81,59,7024.27,13211.01,0.00
2024-12-10 17:26:05,139,9942,81,58,7062.49,13211.09,0.00
2024-12-10 17:26:05,139,9943,81,58,7028.38,13212.00,0.00
2024-12-10 17:26:05,140,9943,81,59,6978.18,13212.01,0.00
2024-12-10 17:26:05,139,9943,80,59,7015.11,13212.10,0.00
2024-12-10 17:26:05,139,9944,80,59,6976.19,13213.00,0.00
2024-12-10 17:26:05,140,9944,80,60,6926.35,13213.01,0.00
2024-12-10 17:26:05,139,9944,80,59,6968.60,13213.06,0.00
2024-12-10 17:26:05,138,9944,79,59,7013.37,13213.09,0.00
2024-12-10 17:26:05,137,9944,79,58,7063.60,13213.09,0.00
2024-12-10 17:26:05,136,9944,79,57,6993.03,13213.85,0.00
2024-12-10 17:26:05,136,9945,79,57,7070.89,13214.00,0.00
2024-12-10 17:26:05,137,9945,79,58,7019.27,13214.01,0.00
2024-12-10 17:26:05,136,9945,79,57,7058.29,13214.10,0.00
2024-12-10 17:26:05,136,9946,79,57,7016.56,13215.00,0.00
2024-12-10 17:26:05,137,9946,80,57,6965.35,13215.01,0.00
2024-12-10 17:26:05,136,9946,79,57,7003.00,13215.10,0.00
2024-12-10 17:26:05,136,9947,79,57,6955.59,13216.00,0.00
2024-12-10 17:26:05,137,9947,80,57,6904.81,13216.01,0.00
2024-12-10 17:26:05,136,9947,79,57,6948.80,13216.05,0.00
2024-12-10 17:26:05,135,9947,79,56,6993.44,13216.10,0.00
2024-12-10 17:26:05,134,9947,79,55,7044.65,13216.10,0.00
2024-12-10 17:26:05,134,9948,79,55,6999.59,13217.00,0.00
2024-12-10 17:26:05,135,9948,79,56,6947.74,13217.01,0.00
2024-12-10 17:26:05,136,9947,79,57,6871.45,13217.21,0.00
2024-12-10 17:26:05,137,9946,80,57,6898.49,13217.26,0.00
2024-12-10 17:26:05,138,9945,81,57,6756.83,13217.89,0.00
2024-12-10 17:26:05,138,9946,81,57,6850.80,13218.00,0.00
2024-12-10 17:26:05,139,9946,81,58,6801.51,13218.01,0.00
2024-12-10 17:26:05,138,9946,80,58,6837.43,13218.10,0.00
2024-12-10 17:26:05,138,9947,80,58,7080.71,13219.00,0.00
2024-12-10 17:26:05,139,9947,81,58,7029.77,13219.01,0.00
2024-12-10 17:26:05,138,9947,81,57,7067.34,13219.10,0.00
2024-12-10 17:26:05,138,9948,81,57,7021.66,13220.00,0.00
2024-12-10 17:26:05,139,9948,81,58,6971.15,13220.01,0.00
2024-12-10 17:26:05,138,9948,80,58,7008.29,13220.10,0.00
2024-12-10 17:26:05,138,9949,80,58,6960.36,13221.00,0.00
2024-12-10 17:26:05,139,9949,80,59,6910.29,13221.01,0.00
2024-12-10 17:26:06,139,9950,80,59,6844.94,13222.00,0.00
2024-12-10 17:26:06,140,9950,80,60,6796.04,13222.01,0.00
2024-12-10 17:26:06,139,9950,80,59,6830.70,13222.11,0.00
2024-12-10 17:26:06,139,9951,80,59,6772.88,13223.00,0.00
2024-12-10 17:26:06,140,9951,80,60,6724.50,13223.01,0.00
2024-12-10 17:26:06,139,9951,79,60,6758.65,13223.11,0.00
2024-12-10 17:26:06,138,9951,79,59,6727.35,13223.59,0.00
2024-12-10 17:26:06,138,9952,79,59,6752.88,13224.00,0.00
2024-12-10 17:26:06,139,9952,79,60,6704.30,13224.01,0.00
2024-12-10 17:26:06,138,9952,78,60,6738.54,13224.11,0.00
2024-12-10 17:26:06,137,9952,77,60,6695.73,13224.64,0.00
2024-12-10 17:26:06,137,9953,77,60,6730.77,13225.00,0.00
2024-12-10 17:26:06,138,9953,78,60,6682.00,13225.01,0.00
2024-12-10 17:26:06,137,9953,77,60,6716.33,13225.11,0.00
2024-12-10 17:26:06,136,9953,77,59,6656.25,13225.71,0.00
2024-12-10 17:26:06,136,9954,77,59,6703.62,13226.00,0.00
2024-12-10 17:26:06,137,9954,77,60,6654.69,13226.01,0.00
2024-12-10 17:26:06,136,9954,76,60,6689.07,13226.11,0.00
2024-12-10 17:26:06,135,9954,75,60,6708.71,13226.33,0.00
2024-12-10 17:26:06,134,9954,75,59,6718.40,13226.54,0.00
2024-12-10 17:26:06,134,9955,75,59,6734.81,13227.00,0.00
2024-12-10 17:26:06,135,9955,76,59,6684.92,13227.01,0.00
2024-12-10 17:26:06,135,9956,76,59,6605.42,13228.00,0.00
2024-12-10 17:26:06,136,9956,77,59,6556.85,13228.01,0.00
2024-12-10 17:26:06,135,9956,77,58,6589.78,13228.12,0.00
2024-12-10 17:26:06,134,9956,76,58,6585.10,13228.49,0.00
2024-12-10 17:26:06,134,9957,76,58,6569.61,13229.00,0.00
2024-12-10 17:26:06,135,9957,77,58,6520.94,13229.01,0.00
2024-12-10 17:26:06,134,9957,77,57,6553.85,13229.12,0.00
2024-12-10 17:26:06,135,9956,77,58,6456.41,13229.50,0.00
2024-12-10 17:26:06,134,9956,76,58,6504.70,13229.72,0.00
2024-12-10 17:26:06,134,9957,76,58,6539.20,13230.00,0.00
2024-12-10 17:26:06,135,9957,77,58,6490.76,13230.01,0.00
2024-12-10 17:26:06,136,9956,78,58,6386.73,13230.45,0.00
2024-12-10 17:26:06,136,9957,78,58,6530.09,13231.00,0.00
2024-12-10 17:26:06,137,9957,78,59,6482.43,13231.01,0.00
2024-12-10 17:26:06,136,9957,77,59,6455.37,13231.56,0.00
2024-12-10 17:26:06,137,9956,78,59,6359.90,13231.82,0.00
2024-12-10 17:26:06,137,9957,78,59,6559.58,13232.00,0.00
2024-12-10 17:26:06,138,9957,78,60,6512.04,13232.01,0.00
2024-12-10 17:26:06,137,9957,78,59,6464.37,13232.69,0.00
2024-12-10 17:26:06,137,9958,78,59,6599.62,13233.00,0.00
2024-12-10 17:26:06,138,9958,79,59,6551.79,13233.01,0.00
2024-12-10 17:26:06,139,9957,80,59,6504.66,13233.02,0.00
2024-12-10 17:26:06,138,9957,79,59,6598.83,13233.14,0.00
2024-12-10 17:26:06,138,9958,79,59,6563.65,13234.00,0.00
2024-12-10 17:26:06,139,9958,80,59,6516.43,13234.01,0.00
2024-12-10 17:26:06,138,9958,79,59,6545.48,13234.14,0.00
2024-12-10 17:26:06,139,9957,80,59,6402.36,13234.83,0.00
2024-12-10 17:26:06,139,9958,80,59,6578.62,13235.00,0.00
2024-12-10 17:26:06,140,9958,80,60,6531.63,13235.01,0.00
2024-12-10 17:26:06,139,9958,79,60,6560.58,13235.14,0.00
2024-12-10 17:26:06,139,9959,79,60,6626.91,13236.00,0.00
2024-12-10 17:26:06,140,9959,80,60,6579.57,13236.01,0.00
2024-12-10 17:26:06,139,9959,80,59,6615.50,13236.09,0.00
2024-12-10 17:26:06,138,9959,79,59,6656.75,13236.13,0.00
2024-12-10 17:26:06,138,9960,79,59,6625.65,13237.00,0.00
2024-12-10 17:26:06,139,9960,79,60,6577.99,13237.01,0.00
2024-12-10 17:26:06,138,9960,79,59,6607.48,13237.14,0.00
2024-12-10 17:26:06,138,9961,79,59,6569.91,13238.00,0.00
2024-12-10 17:26:06,139,9961,80,59,6522.64,13238.01,0.00
2024-12-10 17:26:06,138,9961,80,58,6551.73,13238.14,0.00
2024-12-10 17:26:06,137,9961,79,58,6598.59,13238.14,0.00
2024-12-10 17:26:06,136,9961,78,58,6569.31,13238.66,0.00
2024-12-10 17:26:06,136,9962,78,58,6599.89,13239.00,0.00
2024-12-10 17:26:06,137,9962,79,58,6551.71,13239.01,0.00
2024-12-10 17:26:06,136,9962,79,57,6581.44,13239.14,0.00
2024-12-10 17:26:06,137,9961,79,58,6419.62,13239.79,0.00
2024-12-10 17:26:06,137,9962,79,58,6504.77,13240.00,0.00
2024-12-10 17:26:06,138,9962,79,59,6457.63,13240.01,0.00
2024-12-10 17:26:06,137,9962,79,58,6496.09,13240.07,0.00
2024-12-10 17:26:06,136,9962,79,57,6534.15,13240.13,0.00
2024-12-10 17:26:06,135,9962,79,56,6581.57,13240.13,0.00
2024-12-10 17:26:06,135,9963,79,56,6617.51,13241.00,0.00
2024-12-10 17:26:06,136,9963,80,56,6568.85,13241.01,0.00
2024-12-10 17:26:06,135,9963,79,56,6599.90,13241.13,0.00
2024-12-10 17:26:06,134,9963,78,56,6570.49,13241.60,0.00
2024-12-10 17:26:06,133,9963,77,56,6587.51,13241.68,0.00
2024-12-10 17:26:06,133,9964,77,56,6625.23,13242.00,0.00
2024-12-10 17:26:06,134,9964,78,56,6575.79,13242.01,0.00
2024-12-10 17:26:06,133,9964,78,55,6607.35,13242.14,0.00
2024-12-10 17:26:06,132,9964,77,55,6641.94,13242.22,0.00
2024-12-10 17:26:06,132,9965,77,55,6597.29,13243.00,0.00
2024-12-10 17:26:06,133,9965,78,55,6547.69,13243.01,0.00
2024-12-10 17:26:06,132,9965,77,55,6585.27,13243.09,0.00
2024-12-10 17:26:06,131,9965,76,55,6628.49,13243.14,0.00
2024-12-10 17:26:06,130,9965,76,54,6650.29,13243.35,0.00
2024-12-10 17:26:07,130,9966,76,54,6613.73,13244.00,0.00
2024-12-10 17:26:07,131,9966,77,54,6563.25,13244.01,0.00
2024-12-10 17:26:07,130,9966,77,53,6609.67,13244.03,0.00
2024-12-10 17:26:07,129,9966,77,52,6646.57,13244.13,0.00
2024-12-10 17:26:07,128,9966,77,51,6697.46,13244.13,0.00
2024-12-10 17:26:07,127,9966,76,51,6672.25,13244.61,0.00
2024-12-10 17:26:07,126,9966,75,51,6714.48,13244.64,0.00
2024-12-10 17:26:07,125,9966,75,50,6727.11,13244.85,0.00
2024-12-10 17:26:07,125,9966,75,50,6808.34,13245.00,0.00
2024-12-10 17:26:07,126,9966,75,51,6754.31,13245.01,0.00
2024-12-10 17:26:07,125,9966,75,50,6790.38,13245.14,0.00
2024-12-10 17:26:07,125,9967,75,50,6749.54,13246.00,0.00
2024-12-10 17:26:07,126,9967,75,51,6695.97,13246.01,0.00
2024-12-10 17:26:07,125,9967,74,51,6731.57,13246.14,0.00
2024-12-10 17:26:07,125,9968,74,51,6671.36,13247.00,0.00
2024-12-10 17:26:07,126,9968,75,51,6618.42,13247.01,0.00
2024-12-10 17:26:07,125,9968,75,50,6653.39,13247.14,0.00
2024-12-10 17:26:07,125,9969,75,50,6577.58,13248.00,0.00
2024-12-10 17:26:07,126,9969,76,50,6525.38,13248.01,0.00
2024-12-10 17:26:07,125,9969,76,49,6559.61,13248.14,0.00
2024-12-10 17:26:07,126,9968,77,49,6441.76,13248.60,0.00
2024-12-10 17:26:07,126,9969,77,49,6468.57,13249.00,0.00
2024-12-10 17:26:07,127,9969,78,49,6417.64,13249.01,0.00
2024-12-10 17:26:07,126,9969,77,49,6450.74,13249.13,0.00
2024-12-10 17:26:07,125,9969,77,48,6403.65,13249.62,0.00
2024-12-10 17:26:07,124,9969,76,48,6380.83,13249.83,0.00
2024-12-10 17:26:07,124,9970,76,48,6572.24,13250.00,0.00
2024-12-10 17:26:07,125,9970,76,49,6519.66,13250.01,0.00
2024-12-10 17:26:07,124,9970,75,49,6567.98,13250.03,0.00
2024-12-10 17:26:07,125,9969,75,50,6504.86,13250.13,0.00
2024-12-10 17:26:07,124,9969,74,50,6589.38,13250.14,0.00
2024-12-10 17:26:07,123,9969,73,50,6641.88,13250.14,0.00
2024-12-10 17:26:07,122,9969,72,50,6625.96,13250.59,0.00
2024-12-10 17:26:07,122,9970,72,50,6653.93,13251.00,0.00
2024-12-10 17:26:07,123,9970,73,50,6599.83,13251.01,0.00
2024-12-10 17:26:07,124,9969,73,51,6540.21,13251.07,0.00
2024-12-10 17:26:07,124,9970,73,51,6666.88,13252.00,0.00
2024-12-10 17:26:07,125,9970,73,52,6613.54,13252.01,0.00
2024-12-10 17:26:07,126,9969,74,52,6441.46,13252.75,0.00
2024-12-10 17:26:07,126,9970,74,52,6691.57,13253.00,0.00
2024-12-10 17:26:07,127,9970,74,53,6638.88,13253.01,0.00
2024-12-10 17:26:07,126,9970,73,53,6674.79,13253.13,0.00
2024-12-10 17:26:07,125,9970,72,53,6630.60,13253.66,0.00
2024-12-10 17:26:07,125,9971,72,53,6770.55,13254.00,0.00
2024-12-10 17:26:07,126,9971,72,54,6716.81,13254.01,0.00
2024-12-10 17:26:07,125,9971,72,53,6726.89,13254.29,0.00
2024-12-10 17:26:07,125,9972,72,53,6701.06,13255.00,0.00
2024-12-10 17:26:07,126,9972,73,53,6647.87,13255.01,0.00
2024-12-10 17:26:07,125,9972,72,53,6696.82,13255.03,0.00
2024-12-10 17:26:07,124,9972,72,52,6749.76,13255.03,0.00
2024-12-10 17:26:07,123,9972,71,52,6803.56,13255.03,0.00
2024-12-10 17:26:07,122,9972,70,52,6856.08,13255.05,0.00
2024-12-10 17:26:07,121,9972,69,52,6904.00,13255.11,0.00
2024-12-10 17:26:07,120,9972,68,52,6960.43,13255.11,0.00
2024-12-10 17:26:07,119,9972,67,52,7017.81,13255.11,0.00
2024-12-10 17:26:07,118,9972,66,52,7076.16,13255.11,0.00
2024-12-10 17:26:07,117,9972,66,51,7135.50,13255.11,0.00
2024-12-10 17:26:07,118,9971,67,51,7017.42,13255.54,0.00
2024-12-10 17:26:07,118,9972,67,51,7077.17,13256.00,0.00
2024-12-10 17:26:07,119,9972,68,51,7017.70,13256.01,0.00
2024-12-10 17:26:07,118,9972,67,51,7062.61,13256.11,0.00
2024-12-10 17:26:07,117,9972,67,50,7049.42,13256.58,0.00
2024-12-10 17:26:07,117,9973,67,50,7184.85,13257.00,0.00
2024-12-10 17:26:07,118,9973,68,50,7123.97,13257.01,0.00
2024-12-10 17:26:07,118,9974,68,50,7062.56,13258.00,0.00
2024-12-10 17:26:07,119,9974,69,50,7003.21,13258.01,0.00
2024-12-10 17:26:07,118,9974,69,49,7047.85,13258.12,0.00
2024-12-10 17:26:07,118,9975,69,49,6996.84,13259.00,0.00
2024-12-10 17:26:07,119,9975,69,50,6938.04,13259.01,0.00
2024-12-10 17:26:07,119,9976,69,50,6865.02,13260.00,0.00
2024-12-10 17:26:07,120,9976,70,50,6807.81,13260.01,0.00
2024-12-10 17:26:07,119,9976,69,50,6849.47,13260.12,0.00
2024-12-10 17:26:07,118,9976,68,50,6801.94,13260.75,0.00
2024-12-10 17:26:07,118,9977,68,50,6854.24,13261.00,0.00
2024-12-10 17:26:07,119,9977,68,51,6796.65,13261.01,0.00
2024-12-10 17:26:07,118,9977,68,50,6783.27,13261.43,0.00
2024-12-10 17:26:07,118,9978,68,50,6788.86,13262.00,0.00
2024-12-10 17:26:07,119,9978,69,50,6731.82,13262.01,0.00
2024-12-10 17:26:07,118,9978,69,49,6782.14,13262.05,0.00
2024-12-10 17:26:07,117,9978,69,48,6829.93,13262.12,0.00
2024-12-10 17:26:07,117,9979,69,48,6787.40,13263.00,0.00
2024-12-10 17:26:07,118,9979,69,49,6729.88,13263.01,0.00
2024-12-10 17:26:07,119,9978,69,50,6661.11,13263.12,0.00
2024-12-10 17:26:07,118,9978,68,50,6797.37,13263.13,0.00
2024-12-10 17:26:07,118,9979,68,50,6748.10,13264.00,0.00
2024-12-10 17:26:07,119,9979,68,51,6691.40,13264.01,0.00
2024-12-10 17:26:07,118,9979,68,50,6641.23,13264.61,0.00
2024-12-10 17:26:07,118,9980,68,50,6786.50,13265.00,0.00
2024-12-10 17:26:07,119,9980,69,50,6729.47,13265.01,0.00
2024-12-10 17:26:07,118,9980,69,49,6770.65,13265.12,0.00
2024-12-10 17:26:07,118,9981,69,49,6714.00,13266.00,0.00
2024-12-10 17:26:07,119,9981,69,50,6657.58,13266.01,0.00
2024-12-10 17:26:07,118,9981,69,49,6687.72,13266.19,0.00
2024-12-10 17:26:08,118,9982,69,49,6643.45,13267.00,0.00
2024-12-10 17:26:08,119,9982,70,49,6587.63,13267.01,0.00
2024-12-10 17:26:08,118,9982,69,49,6625.52,13267.14,0.00
2024-12-10 17:26:08,117,9982,68,49,6583.54,13267.71,0.00
2024-12-10 17:26:08,117,9983,68,49,6630.41,13268.00,0.00
2024-12-10 17:26:08,118,9983,68,50,6574.22,13268.01,0.00
2024-12-10 17:26:08,117,9983,67,50,6611.85,13268.14,0.00
2024-12-10 17:26:08,117,9984,67,50,6569.67,13269.00,0.00
2024-12-10 17:26:08,118,9984,67,51,6513.99,13269.01,0.00
2024-12-10 17:26:08,117,9984,67,50,6483.76,13269.55,0.00
2024-12-10 17:26:08,117,9985,67,50,6511.35,13270.00,0.00
2024-12-10 17:26:08,118,9985,67,51,6456.17,13270.01,0.00
2024-12-10 17:26:08,117,9985,67,50,6509.08,13270.02,0.00
2024-12-10 17:26:08,116,9985,67,49,6549.23,13270.13,0.00
2024-12-10 17:26:08,116,9986,67,49,6505.52,13271.00,0.00
2024-12-10 17:26:08,117,9986,67,50,6449.91,13271.01,0.00
2024-12-10 17:26:08,116,9986,67,49,6488.40,13271.13,0.00
2024-12-10 17:26:08,115,9986,66,49,6489.60,13271.46,0.00
2024-12-10 17:26:08,115,9987,66,49,6499.84,13272.00,0.00
2024-12-10 17:26:08,116,9987,67,49,6443.80,13272.01,0.00
2024-12-10 17:26:08,115,9987,66,49,6405.97,13272.70,0.00
2024-12-10 17:26:08,115,9988,66,49,6457.22,13273.00,0.00
2024-12-10 17:26:08,116,9988,66,50,6401.56,13273.01,0.00
2024-12-10 17:26:08,115,9988,65,50,6439.96,13273.13,0.00
2024-12-10 17:26:08,114,9988,64,50,6418.13,13273.70,0.00
2024-12-10 17:26:08,114,9989,64,50,6478.65,13274.00,0.00
2024-12-10 17:26:08,115,9989,65,50,6422.32,13274.01,0.00
2024-12-10 17:26:08,114,9989,64,50,6461.23,13274.13,0.00
2024-12-10 17:26:08,114,9990,64,50,6442.50,13275.00,0.00
2024-12-10 17:26:08,115,9990,65,50,6386.48,13275.01,0.00
2024-12-10 17:26:08,115,9991,65,50,6344.99,13276.00,0.00
2024-12-10 17:26:08,116,9991,66,50,6290.29,13276.01,0.00
2024-12-10 17:26:08,115,9991,65,50,6308.31,13276.28,0.00
2024-12-10 17:26:08,114,9991,65,49,6306.78,13276.69,0.00
2024-12-10 17:26:08,113,9991,64,49,6349.90,13276.70,0.00
2024-12-10 17:26:08,113,9992,64,49,6414.81,13277.00,0.00
2024-12-10 17:26:08,114,9992,64,50,6358.54,13277.01,0.00
2024-12-10 17:26:08,113,9992,63,50,6397.23,13277.13,0.00
2024-12-10 17:26:08,113,9993,63,50,6381.78,13278.00,0.00
2024-12-10 17:26:08,114,9993,63,51,6325.80,13278.01,0.00
2024-12-10 17:26:08,113,9993,63,50,6371.23,13278.08,0.00
2024-12-10 17:26:08,112,9993,62,50,6426.93,13278.08,0.00
2024-12-10 17:26:08,111,9993,61,50,6478.86,13278.12,0.00
2024-12-10 17:26:08,110,9993,60,50,6536.55,13278.12,0.00
2024-12-10 17:26:08,109,9993,59,50,6595.30,13278.12,0.00
2024-12-10 17:26:08,108,9993,58,50,6579.58,13278.68,0.00
2024-12-10 17:26:08,108,9994,58,50,6654.51,13279.00,0.00
2024-12-10 17:26:08,109,9994,59,50,6593.46,13279.01,0.00
2024-12-10 17:26:08,109,9995,59,50,6572.77,13280.00,0.00
2024-12-10 17:26:08,110,9995,59,51,6513.02,13280.01,0.00
2024-12-10 17:26:08,109,9995,58,51,6556.97,13280.12,0.00
2024-12-10 17:26:08,109,9996,58,51,6546.06,13281.00,0.00
2024-12-10 17:26:08,110,9996,58,52,6486.55,13281.01,0.00
2024-12-10 17:26:08,111,9995,59,52,6428.11,13281.03,0.00
2024-12-10 17:26:08,110,9995,59,51,6532.63,13281.10,0.00
2024-12-10 17:26:08,109,9995,58,51,6588.91,13281.12,0.00
2024-12-10 17:26:08,109,9996,58,51,6574.47,13282.00,0.00
2024-12-10 17:26:08,110,9996,58,52,6514.70,13282.01,0.00
2024-12-10 17:26:08,110,9997,58,52,6601.71,13283.00,0.00
2024-12-10 17:26:08,111,9997,59,52,6542.24,13283.01,0.00
2024-12-10 17:26:08,112,9996,59,53,6475.55,13283.09,0.00
2024-12-10 17:26:08,111,9996,58,53,6568.61,13283.11,0.00
2024-12-10 17:26:08,110,9996,57,53,6627.12,13283.11,0.00
2024-12-10 17:26:08,109,9996,57,52,6686.70,13283.11,0.00
2024-12-10 17:26:08,108,9996,57,51,6723.24,13283.27,0.00
2024-12-10 17:26:08,107,9996,56,51,6726.76,13283.69,0.00
2024-12-10 17:26:08,106,9996,56,50,6778.57,13283.70,0.00
2024-12-10 17:26:08,106,9997,56,50,6859.16,13284.00,0.00
2024-12-10 17:26:08,107,9997,56,51,6795.06,13284.01,0.00
2024-12-10 17:26:08,106,9997,55,51,6844.17,13284.11,0.00
2024-12-10 17:26:08,106,9998,55,51,6968.06,13285.00,0.00
2024-12-10 17:26:08,107,9998,55,52,6902.94,13285.01,0.00
2024-12-10 17:26:08,107,9999,55,52,6882.50,13286.00,0.00
2024-12-10 17:26:08,108,9999,55,53,6818.77,13286.01,0.00
2024-12-10 17:26:08,109,9998,55,54,6756.22,13286.03,0.00
2024-12-10 17:26:08,108,9998,55,53,6810.21,13286.12,0.00
2024-12-10 17:26:08,109,9997,56,53,6720.94,13286.34,0.00
2024-12-10 17:26:08,109,9998,56,53,6821.99,13287.00,0.00
2024-12-10 17:26:08,110,9998,57,53,6759.98,13287.01,0.00
2024-12-10 17:26:08,109,9998,57,52,6807.41,13287.11,0.00
2024-12-10 17:26:08,108,9998,57,51,6803.69,13287.52,0.00
2024-12-10 17:26:08,108,9999,57,51,7097.40,13288.00,0.00
2024-12-10 17:26:08,109,9999,58,51,7032.29,13288.01,0.00
2024-12-10 17:26:08,108,9999,57,51,7092.50,13288.04,0.00
2024-12-10 17:26:08,107,9999,57,50,7148.87,13288.10,0.00
2024-12-10 17:26:08,106,9999,56,50,7215.06,13288.10,0.00
2024-12-10 17:26:08,106,10000,56,50,7197.79,13289.00,0.00
2024-12-10 17:26:08,107,10000,57,50,7130.52,13289.01,0.00
2024-12-10 17:26:08,106,10000,56,50,7184.04,13289.10,0.00
2024-12-10 17:26:08,105,10000,56,49,7251.20,13289.10,0.00
2024-12-10 17:26:08,105,10001,56,49,7229.01,13290.00,0.00
2024-12-10 17:26:08,106,10001,56,50,7160.81,13290.01,0.00
2024-12-10 17:26:08,105,10001,55,50,7226.48,13290.02,0.00
2024-12-10 17:26:08,104,10001,54,50,7284.50,13290.10,0.00
2024-12-10 17:26:09,104,10002,54,50,7258.03,13291.00,0.00
2024-12-10 17:26:09,105,10002,55,50,7188.91,13291.01,0.00
2024-12-10 17:26:09,104,10002,54,50,7245.29,13291.10,0.00
2024-12-10 17:26:09,103,10002,53,50,7291.71,13291.27,0.00
2024-12-10 17:26:09,103,10003,53,50,7293.29,13292.00,0.00
2024-12-10 17:26:09,104,10003,54,50,7223.17,13292.01,0.00
2024-12-10 17:26:09,104,10004,54,50,7185.61,13293.00,0.00
2024-12-10 17:26:09,105,10004,55,50,7117.18,13293.01,0.00
2024-12-10 17:26:09,104,10004,54,50,7172.87,13293.10,0.00
2024-12-10 17:26:09,104,10005,54,50,7143.08,13294.00,0.00
2024-12-10 17:26:09,105,10005,55,50,7075.05,13294.01,0.00
2024-12-10 17:26:09,104,10005,54,50,7130.34,13294.10,0.00
2024-12-10 17:26:09,104,10006,54,50,7097.59,13295.00,0.00
2024-12-10 17:26:09,105,10006,55,50,7029.99,13295.01,0.00
2024-12-10 17:26:09,104,10006,55,49,7086.12,13295.09,0.00
2024-12-10 17:26:09,103,10006,54,49,7153.62,13295.09,0.00
2024-12-10 17:26:09,102,10006,54,48,7222.45,13295.09,0.00
2024-12-10 17:26:09,101,10006,53,48,7224.42,13295.58,0.00
2024-12-10 17:26:09,100,10006,53,47,7269.56,13295.65,0.00
2024-12-10 17:26:09,99,10006,52,47,7336.69,13295.67,0.00
2024-12-10 17:26:09,99,10007,52,47,7426.95,13296.00,0.00
2024-12-10 17:26:09,100,10007,53,47,7352.68,13296.01,0.00
2024-12-10 17:26:09,100,10008,53,47,7354.56,13297.00,0.00
2024-12-10 17:26:09,101,10008,54,47,7281.74,13297.01,0.00
2024-12-10 17:26:09,101,10009,54,47,7282.29,13298.00,0.00
2024-12-10 17:26:09,102,10009,55,47,7210.89,13298.01,0.00
2024-12-10 17:26:09,101,10009,54,47,7270.48,13298.09,0.00
2024-12-10 17:26:09,101,10010,54,47,7281.52,13299.00,0.00
2024-12-10 17:26:09,102,10010,55,47,7210.13,13299.01,0.00
2024-12-10 17:26:09,103,10009,55,48,7093.75,13299.38,0.00
2024-12-10 17:26:09,103,10010,55,48,7224.60,13300.00,0.00
2024-12-10 17:26:09,104,10010,55,49,7155.14,13300.01,0.00
2024-12-10 17:26:09,103,10010,54,49,7213.37,13300.09,0.00
2024-12-10 17:26:09,103,10011,54,49,7350.76,13301.00,0.00
2024-12-10 17:26:09,104,10011,55,49,7280.08,13301.01,0.00
2024-12-10 17:26:09,105,10010,56,49,7203.17,13301.09,0.00
2024-12-10 17:26:09,105,10011,56,49,7254.98,13302.00,0.00
2024-12-10 17:26:09,106,10011,57,49,7186.54,13302.01,0.00
2024-12-10 17:26:09,105,10011,57,48,7243.62,13302.09,0.00
2024-12-10 17:26:09,105,10012,57,48,7372.21,13303.00,0.00
2024-12-10 17:26:09,106,10012,58,48,7302.66,13303.01,0.00
2024-12-10 17:26:09,107,10011,58,49,7131.06,13303.76,0.00
2024-12-10 17:26:09,107,10012,58,49,7249.39,13304.00,0.00
2024-12-10 17:26:09,108,10012,59,49,7182.27,13304.01,0.00
2024-12-10 17:26:09,107,10012,59,48,7245.68,13304.03,0.00
2024-12-10 17:26:09,106,10012,59,47,7306.52,13304.08,0.00
2024-12-10 17:26:09,106,10013,59,47,7426.67,13305.00,0.00
2024-12-10 17:26:09,107,10013,59,48,7357.27,13305.01,0.00
2024-12-10 17:26:09,106,10013,58,48,7421.67,13305.04,0.00
2024-12-10 17:26:09,105,10013,58,47,7486.04,13305.08,0.00
2024-12-10 17:26:09,106,10012,58,48,7381.59,13305.35,0.00
2024-12-10 17:26:09,107,10011,58,49,7366.40,13305.50,0.00
2024-12-10 17:26:09,107,10012,58,49,7484.92,13306.00,0.00
2024-12-10 17:26:09,108,10012,58,50,7415.62,13306.01,0.00
2024-12-10 17:26:09,108,10013,58,50,7640.28,13307.00,0.00
2024-12-10 17:26:09,109,10013,59,50,7570.19,13307.01,0.00
2024-12-10 17:26:09,108,10013,59,49,7584.21,13307.37,0.00
2024-12-10 17:26:09,108,10014,59,49,7618.66,13308.00,0.00
2024-12-10 17:26:09,109,10014,59,50,7548.77,13308.01,0.00
2024-12-10 17:26:09,108,10014,58,50,7608.84,13308.07,0.00
2024-12-10 17:26:09,108,10015,58,50,7603.46,13309.00,0.00
2024-12-10 17:26:09,109,10015,59,50,7533.70,13309.01,0.00
2024-12-10 17:26:09,109,10016,59,50,7519.36,13310.00,0.00
2024-12-10 17:26:09,110,10016,59,51,7451.00,13310.01,0.00
2024-12-10 17:26:09,110,10017,59,51,7438.77,13311.00,0.00
2024-12-10 17:26:09,111,10017,60,51,7371.75,13311.01,0.00
2024-12-10 17:26:09,110,10017,60,50,7427.91,13311.08,0.00
2024-12-10 17:26:09,110,10018,60,50,7427.23,13312.00,0.00
2024-12-10 17:26:09,111,10018,60,51,7360.31,13312.01,0.00
2024-12-10 17:26:09,110,10018,60,50,7416.37,13312.08,0.00
2024-12-10 17:26:09,111,10017,60,51,7345.96,13312.13,0.00
2024-12-10 17:26:09,111,10018,60,51,7461.22,13313.00,0.00
2024-12-10 17:26:09,112,10018,60,52,7394.60,13313.01,0.00
2024-12-10 17:26:09,111,10018,60,51,7450.46,13313.08,0.00
2024-12-10 17:26:09,111,10019,60,51,7562.68,13314.00,0.00
2024-12-10 17:26:09,112,10019,60,52,7495.15,13314.01,0.00
2024-12-10 17:26:09,112,10020,60,52,7473.86,13315.00,0.00
2024-12-10 17:26:09,113,10020,60,53,7407.72,13315.01,0.00
2024-12-10 17:26:09,113,10021,60,53,7379.48,13316.00,0.00
2024-12-10 17:26:09,114,10021,61,53,7314.74,13316.01,0.00
2024-12-10 17:26:10,114,10022,61,53,7270.77,13317.00,0.00
2024-12-10 17:26:10,115,10022,62,53,7207.54,13317.01,0.00
2024-12-10 17:26:10,114,10022,62,52,7267.27,13317.03,0.00
2024-12-10 17:26:10,113,10022,61,52,7256.97,13317.39,0.00
2024-12-10 17:26:10,113,10023,61,52,7281.51,13318.00,0.00
2024-12-10 17:26:10,114,10023,61,53,7217.64,13318.01,0.00
2024-12-10 17:26:10,113,10023,61,52,7268.59,13318.10,0.00
2024-12-10 17:26:10,112,10023,60,52,7284.40,13318.43,0.00
2024-12-10 17:26:10,112,10024,60,52,7327.62,13319.00,0.00
2024-12-10 17:26:10,113,10024,61,52,7262.78,13319.01,0.00
2024-12-10 17:26:10,112,10024,60,52,7314.59,13319.10,0.00
2024-12-10 17:26:10,112,10025,60,52,7311.83,13320.00,0.00
2024-12-10 17:26:10,113,10025,60,53,7247.13,13320.01,0.00
2024-12-10 17:26:10,112,10025,60,52,7298.80,13320.10,0.00
2024-12-10 17:26:10,112,10026,60,52,7289.37,13321.00,0.00
2024-12-10 17:26:10,113,10026,60,53,7224.86,13321.01,0.00
2024-12-10 17:26:10,114,10025,61,53,7157.99,13321.05,0.00
2024-12-10 17:26:10,113,10025,61,52,7235.52,13321.11,0.00
2024-12-10 17:26:10,113,10026,61,52,7224.57,13322.00,0.00
2024-12-10 17:26:10,114,10026,61,53,7161.20,13322.01,0.00
2024-12-10 17:26:10,114,10027,61,53,7252.80,13323.00,0.00
2024-12-10 17:26:10,115,10027,62,53,7189.73,13323.01,0.00
2024-12-10 17:26:10,116,10026,62,54,7127.75,13323.03,0.00
2024-12-10 17:26:10,115,10026,62,53,7219.90,13323.10,0.00
2024-12-10 17:26:10,115,10027,62,53,7203.77,13324.00,0.00
2024-12-10 17:26:10,116,10027,62,54,7141.67,13324.01,0.00
2024-12-10 17:26:10,115,10027,62,53,7191.07,13324.10,0.00
2024-12-10 17:26:10,115,10028,62,53,7283.85,13325.00,0.00
2024-12-10 17:26:10,116,10028,62,54,7221.06,13325.01,0.00
2024-12-10 17:26:10,115,10028,61,54,7271.15,13325.10,0.00
2024-12-10 17:26:10,114,10028,60,54,7263.55,13325.46,0.00
2024-12-10 17:26:10,115,10027,61,54,7178.75,13325.63,0.00
2024-12-10 17:26:10,115,10027,61,54,7285.66,13326.00,0.00
2024-12-10 17:26:10,116,10027,61,55,7222.85,13326.01,0.00
2024-12-10 17:26:10,116,10028,61,55,7315.64,13327.00,0.00
2024-12-10 17:26:10,117,10028,62,55,7253.11,13327.01,0.00
2024-12-10 17:26:10,116,10028,61,55,7303.04,13327.09,0.00
2024-12-10 17:26:10,116,10029,61,55,7285.19,13328.00,0.00
2024-12-10 17:26:10,117,10029,61,56,7222.92,13328.01,0.00
2024-12-10 17:26:10,116,10029,60,56,7272.59,13328.09,0.00
2024-12-10 17:26:10,115,10029,60,55,7316.56,13328.20,0.00
2024-12-10 17:26:10,115,10030,60,55,7315.85,13329.00,0.00
2024-12-10 17:26:10,116,10030,61,55,7252.78,13329.01,0.00
2024-12-10 17:26:10,117,10029,61,56,7183.98,13329.08,0.00
2024-12-10 17:26:10,116,10029,60,56,7325.21,13329.10,0.00
2024-12-10 17:26:10,116,10030,60,56,7300.15,13330.00,0.00
2024-12-10 17:26:10,117,10030,60,57,7237.76,13330.01,0.00
2024-12-10 17:26:10,116,10030,59,57,7294.43,13330.04,0.00
2024-12-10 17:26:10,115,10030,58,57,7350.93,13330.09,0.00
2024-12-10 17:26:10,114,10030,57,57,7414.24,13330.09,0.00
2024-12-10 17:26:10,113,10030,56,57,7466.01,13330.18,0.00
2024-12-10 17:26:10,113,10031,56,57,7552.22,13331.00,0.00
2024-12-10 17:26:10,114,10031,56,58,7485.97,13331.01,0.00
2024-12-10 17:26:10,113,10031,56,57,7540.46,13331.09,0.00
2024-12-10 17:26:10,112,10031,55,57,7580.91,13331.24,0.00
2024-12-10 17:26:10,113,10030,55,58,7430.00,13331.52,0.00
2024-12-10 17:26:10,113,10031,55,58,7529.47,13332.00,0.00
2024-12-10 17:26:10,114,10031,56,58,7463.42,13332.01,0.00
2024-12-10 17:26:10,113,10031,56,57,7517.71,13332.09,0.00
2024-12-10 17:26:10,112,10031,55,57,7538.32,13332.35,0.00
2024-12-10 17:26:10,111,10031,55,56,7585.18,13332.39,0.00
2024-12-10 17:26:10,111,10032,55,56,7736.17,13333.00,0.00
2024-12-10 17:26:10,112,10032,56,56,7667.09,13333.01,0.00
2024-12-10 17:26:10,111,10032,55,56,7724.20,13333.09,0.00
2024-12-10 17:26:10,111,10033,55,56,7709.17,13334.00,0.00
2024-12-10 17:26:10,112,10033,55,57,7640.34,13334.01,0.00
2024-12-10 17:26:10,111,10033,54,57,7699.60,13334.07,0.00
2024-12-10 17:26:10,110,10033,53,57,7765.97,13334.09,0.00
2024-12-10 17:26:10,109,10033,52,57,7835.99,13334.09,0.00
2024-12-10 17:26:10,109,10034,52,57,7823.18,13335.00,0.00
2024-12-10 17:26:10,110,10034,53,57,7752.06,13335.01,0.00
2024-12-10 17:26:10,109,10034,53,56,7810.99,13335.09,0.00
2024-12-10 17:26:10,108,10034,53,55,7852.09,13335.30,0.00
2024-12-10 17:26:10,108,10035,53,55,7869.70,13336.00,0.00
2024-12-10 17:26:10,109,10035,53,56,7797.50,13336.01,0.00
2024-12-10 17:26:10,109,10036,53,56,7771.26,13337.00,0.00
2024-12-10 17:26:10,110,10036,54,56,7700.61,13337.01,0.00
2024-12-10 17:26:10,110,10037,54,56,7672.13,13338.00,0.00
2024-12-10 17:26:10,111,10037,55,56,7603.02,13338.01,0.00
2024-12-10 17:26:10,112,10036,56,56,7482.03,13338.38,0.00
2024-12-10 17:26:10,113,10035,57,56,7428.93,13338.59,0.00
2024-12-10 17:26:10,113,10036,57,56,7524.53,13339.00,0.00
2024-12-10 17:26:10,114,10036,58,56,7458.52,13339.01,0.00
2024-12-10 17:26:10,113,10036,58,55,7511.59,13339.10,0.00
2024-12-10 17:26:10,113,10037,58,55,7731.70,13340.00,0.00
2024-12-10 17:26:10,114,10037,59,55,7663.88,13340.01,0.00
2024-12-10 17:26:11,114,10038,59,55,7637.00,13341.00,0.00
2024-12-10 17:26:11,115,10038,59,56,7570.59,13341.01,0.00
2024-12-10 17:26:11,114,10038,58,56,7624.17,13341.10,0.00
2024-12-10 17:26:11,114,10039,58,56,7612.70,13342.00,0.00
2024-12-10 17:26:11,115,10039,58,57,7546.50,13342.01,0.00
2024-12-10 17:26:11,116,10038,59,57,7408.65,13342.56,0.00
2024-12-10 17:26:11,116,10039,59,57,7562.60,13343.00,0.00
2024-12-10 17:26:11,117,10039,59,58,7497.96,13343.01,0.00
2024-12-10 17:26:11,116,10039,59,57,7518.31,13343.32,0.00
2024-12-10 17:26:11,116,10040,59,57,7650.10,13344.00,0.00
2024-12-10 17:26:11,117,10040,60,57,7584.71,13344.01,0.00
2024-12-10 17:26:11,117,10041,60,57,7554.63,13345.00,0.00
2024-12-10 17:26:11,118,10041,60,58,7490.61,13345.01,0.00
2024-12-10 17:26:11,118,10042,60,58,7457.33,13346.00,0.00
2024-12-10 17:26:11,119,10042,60,59,7394.66,13346.01,0.00
2024-12-10 17:26:11,118,10042,59,59,7410.93,13346.28,0.00
2024-12-10 17:26:11,118,10043,59,59,7412.36,13347.00,0.00
2024-12-10 17:26:11,119,10043,59,60,7350.08,13347.01,0.00
2024-12-10 17:26:11,119,10044,59,60,7309.10,13348.00,0.00
2024-12-10 17:26:11,120,10044,59,61,7248.20,13348.01,0.00
2024-12-10 17:26:11,119,10044,58,61,7303.51,13348.04,0.00
2024-12-10 17:26:11,118,10044,57,61,7358.64,13348.08,0.00
2024-12-10 17:26:11,118,10045,57,61,7323.91,13349.00,0.00
2024-12-10 17:26:11,119,10045,58,61,7262.37,13349.01,0.00
2024-12-10 17:26:11,118,10045,57,61,7312.64,13349.08,0.00
2024-12-10 17:26:11,118,10046,57,61,7271.04,13350.00,0.00
2024-12-10 17:26:11,119,10046,57,62,7209.94,13350.01,0.00
2024-12-10 17:26:11,118,10046,57,61,7259.76,13350.08,0.00
2024-12-10 17:26:11,117,10046,57,60,7320.67,13350.09,0.00
2024-12-10 17:26:11,118,10045,57,61,7214.82,13350.34,0.00
2024-12-10 17:26:11,117,10045,57,60,7311.91,13350.57,0.00
2024-12-10 17:26:11,117,10046,57,60,7353.08,13351.00,0.00
2024-12-10 17:26:11,118,10046,58,60,7290.76,13351.01,0.00
2024-12-10 17:26:11,117,10046,57,60,7350.80,13351.02,0.00
2024-12-10 17:26:11,116,10046,56,60,7405.00,13351.08,0.00
2024-12-10 17:26:11,115,10046,56,59,7468.23,13351.08,0.00
2024-12-10 17:26:11,114,10046,55,59,7523.70,13351.10,0.00
2024-12-10 17:26:11,115,10045,55,60,7450.15,13351.17,0.00
2024-12-10 17:26:11,115,10046,55,60,7645.70,13352.00,0.00
2024-12-10 17:26:11,116,10046,56,60,7579.79,13352.01,0.00
2024-12-10 17:26:11,115,10046,56,59,7635.29,13352.08,0.00
2024-12-10 17:26:11,115,10047,56,59,7716.57,13353.00,0.00
2024-12-10 17:26:11,116,10047,56,60,7650.05,13353.01,0.00
2024-12-10 17:26:11,116,10048,56,60,7598.45,13354.00,0.00
2024-12-10 17:26:11,117,10048,57,60,7533.51,13354.01,0.00
2024-12-10 17:26:11,116,10048,57,59,7588.13,13354.08,0.00
2024-12-10 17:26:11,116,10049,57,59,7541.01,13355.00,0.00
2024-12-10 17:26:11,117,10049,58,59,7476.56,13355.01,0.00
2024-12-10 17:26:11,117,10050,58,59,7416.52,13356.00,0.00
2024-12-10 17:26:11,118,10050,59,59,7353.67,13356.01,0.00
2024-12-10 17:26:11,117,10050,58,59,7357.75,13356.43,0.00
2024-12-10 17:26:11,116,10050,57,59,7338.02,13356.87,0.00
2024-12-10 17:26:11,116,10051,57,59,7436.01,13357.00,0.00
2024-12-10 17:26:11,117,10051,58,59,7372.45,13357.01,0.00
2024-12-10 17:26:11,118,10050,59,59,7238.67,13357.56,0.00
2024-12-10 17:26:11,117,10050,59,58,7333.67,13357.67,0.00
2024-12-10 17:26:11,117,10051,59,58,7399.10,13358.00,0.00
2024-12-10 17:26:11,118,10051,60,58,7336.39,13358.01,0.00
2024-12-10 17:26:11,117,10051,59,58,7388.85,13358.08,0.00
2024-12-10 17:26:11,117,10052,59,58,7484.23,13359.00,0.00
2024-12-10 17:26:11,118,10052,60,58,7420.80,13359.01,0.00
2024-12-10 17:26:11,117,10052,60,57,7473.98,13359.08,0.00
2024-12-10 17:26:11,117,10053,60,57,7450.40,13360.00,0.00
2024-12-10 17:26:11,118,10053,61,57,7387.26,13360.01,0.00
2024-12-10 17:26:11,117,10053,60,57,7440.15,13360.08,0.00
2024-12-10 17:26:11,118,10052,61,57,7278.82,13360.74,0.00
2024-12-10 17:26:11,118,10053,61,57,7387.64,13361.00,0.00
2024-12-10 17:26:11,119,10053,61,58,7325.56,13361.01,0.00
2024-12-10 17:26:11,118,10053,61,57,7377.48,13361.08,0.00
2024-12-10 17:26:11,118,10054,61,57,7454.43,13362.00,0.00
2024-12-10 17:26:11,119,10054,61,58,7391.79,13362.01,0.00
2024-12-10 17:26:11,119,10055,61,58,7343.64,13363.00,0.00
2024-12-10 17:26:11,120,10055,62,58,7282.44,13363.01,0.00
2024-12-10 17:26:11,119,10055,62,57,7333.56,13363.08,0.00
2024-12-10 17:26:11,120,10054,62,58,7152.13,13363.77,0.00
2024-12-10 17:26:11,120,10055,62,58,7259.25,13364.00,0.00
2024-12-10 17:26:11,121,10055,63,58,7199.25,13364.01,0.00
2024-12-10 17:26:11,120,10055,63,57,7249.25,13364.08,0.00
2024-12-10 17:26:11,119,10055,63,56,7222.32,13364.63,0.00
2024-12-10 17:26:11,119,10056,63,56,7381.70,13365.00,0.00
2024-12-10 17:26:11,120,10056,63,57,7320.19,13365.01,0.00
2024-12-10 17:26:12,120,10057,63,57,7273.04,13366.00,0.00
2024-12-10 17:26:12,121,10057,64,57,7212.93,13366.01,0.00
2024-12-10 17:26:12,120,10057,64,56,7263.04,13366.08,0.00
2024-12-10 17:26:12,120,10058,64,56,7218.76,13367.00,0.00
2024-12-10 17:26:12,121,10058,64,57,7159.10,13367.01,0.00
2024-12-10 17:26:12,121,10059,64,57,7097.62,13368.00,0.00
2024-12-10 17:26:12,122,10059,64,58,7039.44,13368.01,0.00
2024-12-10 17:26:12,121,10059,64,57,7079.62,13368.08,0.00
2024-12-10 17:26:12,121,10060,64,57,7025.66,13369.00,0.00
2024-12-10 17:26:12,122,10060,65,57,6968.07,13369.01,0.00
2024-12-10 17:26:12,121,10060,65,56,7006.23,13369.08,0.00
2024-12-10 17:26:12,120,10060,64,56,6951.19,13369.68,0.00
2024-12-10 17:26:12,120,10061,64,56,7002.16,13370.00,0.00
2024-12-10 17:26:12,121,10061,64,57,6944.29,13370.01,0.00
2024-12-10 17:26:12,120,10061,63,57,6895.20,13370.65,0.00
2024-12-10 17:26:12,121,10060,64,57,6799.64,13370.83,0.00
2024-12-10 17:26:12,121,10061,64,57,6901.09,13371.00,0.00
2024-12-10 17:26:12,122,10061,65,57,6844.52,13371.01,0.00
2024-12-10 17:26:12,121,10061,65,56,6879.52,13371.08,0.00
2024-12-10 17:26:12,122,10060,66,56,6781.57,13371.41,0.00
2024-12-10 17:26:12,122,10061,66,56,6960.72,13372.00,0.00
2024-12-10 17:26:12,123,10061,67,56,6904.13,13372.01,0.00
2024-12-10 17:26:12,122,10061,67,55,6885.49,13372.48,0.00
2024-12-10 17:26:12,122,10062,67,55,7012.62,13373.00,0.00
2024-12-10 17:26:12,123,10062,68,55,6955.61,13373.01,0.00
2024-12-10 17:26:12,122,10062,67,55,7002.77,13373.07,0.00
2024-12-10 17:26:12,121,10062,67,54,7059.54,13373.07,0.00
2024-12-10 17:26:12,121,10063,67,54,7019.22,13374.00,0.00
2024-12-10 17:26:12,122,10063,68,54,6961.69,13374.01,0.00
2024-12-10 17:26:12,121,10063,67,54,7009.30,13374.07,0.00
2024-12-10 17:26:12,121,10064,67,54,6966.41,13375.00,0.00
2024-12-10 17:26:12,122,10064,67,55,6909.30,13375.01,0.00
2024-12-10 17:26:12,122,10065,67,55,6852.74,13376.00,0.00
2024-12-10 17:26:12,123,10065,67,56,6797.03,13376.01,0.00
2024-12-10 17:26:12,122,10065,67,55,6752.92,13376.71,0.00
2024-12-10 17:26:12,122,10066,67,55,6800.96,13377.00,0.00
2024-12-10 17:26:12,123,10066,68,55,6745.67,13377.01,0.00
2024-12-10 17:26:12,122,10066,68,54,6791.11,13377.07,0.00
2024-12-10 17:26:12,122,10067,68,54,6744.98,13378.00,0.00
2024-12-10 17:26:12,123,10067,69,54,6690.14,13378.01,0.00
2024-12-10 17:26:12,124,10066,70,54,6623.27,13378.12,0.00
2024-12-10 17:26:12,125,10065,71,54,6574.73,13378.74,0.00
2024-12-10 17:26:12,124,10065,70,54,6647.87,13378.74,0.00
2024-12-10 17:26:12,124,10066,70,54,6713.49,13379.00,0.00
2024-12-10 17:26:12,125,10066,70,55,6659.78,13379.01,0.00
2024-12-10 17:26:12,124,10066,69,55,6703.80,13379.07,0.00
2024-12-10 17:26:12,123,10066,69,54,6656.89,13379.71,0.00
2024-12-10 17:26:12,124,10065,69,55,6583.63,13379.81,0.00
2024-12-10 17:26:12,124,10066,69,55,6900.57,13380.00,0.00
2024-12-10 17:26:12,125,10066,70,55,6845.36,13380.01,0.00
2024-12-10 17:26:12,124,10066,70,54,6890.88,13380.07,0.00
2024-12-10 17:26:12,124,10067,70,54,6961.54,13381.00,0.00
2024-12-10 17:26:12,125,10067,71,54,6905.85,13381.01,0.00
2024-12-10 17:26:12,125,10068,71,54,6855.86,13382.00,0.00
2024-12-10 17:26:12,126,10068,71,55,6801.45,13382.01,0.00
2024-12-10 17:26:12,125,10068,71,54,6845.17,13382.08,0.00
2024-12-10 17:26:12,124,10068,70,54,6792.14,13382.73,0.00
2024-12-10 17:26:12,124,10069,70,54,6861.40,13383.00,0.00
2024-12-10 17:26:12,125,10069,70,55,6806.50,13383.01,0.00
2024-12-10 17:26:12,124,10069,69,55,6859.24,13383.02,0.00
2024-12-10 17:26:12,123,10069,69,54,6905.24,13383.08,0.00
2024-12-10 17:26:12,122,10069,69,53,6925.14,13383.34,0.00
2024-12-10 17:26:12,122,10070,69,53,6927.01,13384.00,0.00
2024-12-10 17:26:12,123,10070,69,54,6870.70,13384.01,0.00
2024-12-10 17:26:12,122,10070,69,53,6916.07,13384.08,0.00
2024-12-10 17:26:12,122,10071,69,53,6860.60,13385.00,0.00
2024-12-10 17:26:12,123,10071,69,54,6804.82,13385.01,0.00
2024-12-10 17:26:12,122,10071,69,53,6849.66,13385.08,0.00
2024-12-10 17:26:12,121,10071,69,52,6832.23,13385.55,0.00
2024-12-10 17:26:12,121,10072,69,52,6871.45,13386.00,0.00
2024-12-10 17:26:12,122,10072,70,52,6815.13,13386.01,0.00
2024-12-10 17:26:12,121,10072,70,51,6867.03,13386.03,0.00
2024-12-10 17:26:12,120,10072,70,50,6917.58,13386.08,0.00
2024-12-10 17:26:12,120,10073,70,50,6895.26,13387.00,0.00
2024-12-10 17:26:12,121,10073,71,50,6838.28,13387.01,0.00
2024-12-10 17:26:12,120,10073,70,50,6883.03,13387.09,0.00
2024-12-10 17:26:12,120,10074,70,50,6862.10,13388.00,0.00
2024-12-10 17:26:12,121,10074,71,50,6805.39,13388.01,0.00
2024-12-10 17:26:12,120,10074,70,50,6849.45,13388.09,0.00
2024-12-10 17:26:12,120,10075,70,50,6807.30,13389.00,0.00
2024-12-10 17:26:12,121,10075,70,51,6751.04,13389.01,0.00
2024-12-10 17:26:12,120,10075,69,51,6694.44,13389.54,0.00
2024-12-10 17:26:12,119,10075,69,50,6744.87,13389.57,0.00
2024-12-10 17:26:13,119,10076,69,50,6787.89,13390.00,0.00
2024-12-10 17:26:13,120,10076,69,51,6731.33,13390.01,0.00
2024-12-10 17:26:13,119,10076,69,50,6774.43,13390.10,0.00
2024-12-10 17:26:13,120,10075,70,50,6702.36,13390.23,0.00
2024-12-10 17:26:13,120,10076,70,50,6789.58,13391.00,0.00
2024-12-10 17:26:13,121,10076,71,50,6733.47,13391.01,0.00
2024-12-10 17:26:13,120,10076,70,50,6776.23,13391.10,0.00
2024-12-10 17:26:13,119,10076,70,49,6811.82,13391.24,0.00
2024-12-10 17:26:13,119,10077,70,49,6913.70,13392.00,0.00
2024-12-10 17:26:13,120,10077,71,49,6856.09,13392.01,0.00
2024-12-10 17:26:13,119,10077,70,49,6900.23,13392.10,0.00
2024-12-10 17:26:13,119,10078,70,49,6866.24,13393.00,0.00
2024-12-10 17:26:13,120,10078,71,49,6809.02,13393.01,0.00
2024-12-10 17:26:13,119,10078,70,49,6852.77,13393.10,0.00
2024-12-10 17:26:13,119,10079,70,49,6817.34,13394.00,0.00
2024-12-10 17:26:13,120,10079,71,49,6760.53,13394.01,0.00
2024-12-10 17:26:13,119,10079,70,49,6803.87,13394.10,0.00
2024-12-10 17:26:13,119,10080,70,49,6766.69,13395.00,0.00
2024-12-10 17:26:13,120,10080,71,49,6710.30,13395.01,0.00
2024-12-10 17:26:13,119,10080,70,49,6753.21,13395.10,0.00
2024-12-10 17:26:13,119,10081,70,49,6706.13,13396.00,0.00
2024-12-10 17:26:13,120,10081,70,50,6650.24,13396.01,0.00
2024-12-10 17:26:13,119,10081,69,50,6692.65,13396.10,0.00
2024-12-10 17:26:13,118,10081,68,50,6634.56,13396.69,0.00
2024-12-10 17:26:13,118,10082,68,50,6695.46,13397.00,0.00
2024-12-10 17:26:13,119,10082,68,51,6639.19,13397.01,0.00
2024-12-10 17:26:13,118,10082,67,51,6681.86,13397.10,0.00
2024-12-10 17:26:13,117,10082,66,51,6652.23,13397.50,0.00
2024-12-10 17:26:13,117,10083,66,51,6674.23,13398.00,0.00
2024-12-10 17:26:13,118,10083,67,51,6617.67,13398.01,0.00
2024-12-10 17:26:13,117,10083,66,51,6660.51,13398.10,0.00
2024-12-10 17:26:13,116,10083,66,50,6643.14,13398.43,0.00
2024-12-10 17:26:13,117,10082,66,51,6532.60,13398.73,0.00
2024-12-10 17:26:13,117,10083,66,51,6619.76,13399.00,0.00
2024-12-10 17:26:13,118,10083,67,51,6563.66,13399.01,0.00
2024-12-10 17:26:13,117,10083,66,51,6614.04,13399.04,0.00
2024-12-10 17:26:13,116,10083,65,51,6662.99,13399.09,0.00
2024-12-10 17:26:13,115,10083,65,50,6719.77,13399.10,0.00
2024-12-10 17:26:13,114,10083,64,50,6647.54,13399.72,0.00
2024-12-10 17:26:13,114,10084,64,50,6840.57,13400.00,0.00
2024-12-10 17:26:13,115,10084,65,50,6781.09,13400.01,0.00
2024-12-10 17:26:13,114,10084,65,49,6827.67,13400.10,0.00
2024-12-10 17:26:13,113,10084,65,48,6810.24,13400.51,0.00
2024-12-10 17:26:13,113,10085,65,48,6821.34,13401.00,0.00
2024-12-10 17:26:13,114,10085,66,48,6761.51,13401.01,0.00
2024-12-10 17:26:13,113,10085,66,47,6733.75,13401.48,0.00
2024-12-10 17:26:13,114,10084,66,48,6648.57,13401.64,0.00
2024-12-10 17:26:13,114,10085,66,48,6706.76,13402.00,0.00
2024-12-10 17:26:13,115,10085,67,48,6648.44,13402.01,0.00
2024-12-10 17:26:13,114,10085,66,48,6692.68,13402.11,0.00
2024-12-10 17:26:13,113,10085,65,48,6625.06,13402.71,0.00
2024-12-10 17:26:13,113,10086,65,48,6816.86,13403.00,0.00
2024-12-10 17:26:13,114,10086,66,48,6757.07,13403.01,0.00
2024-12-10 17:26:13,113,10086,65,48,6802.66,13403.11,0.00
2024-12-10 17:26:13,113,10087,65,48,6769.25,13404.00,0.00
2024-12-10 17:26:13,114,10087,65,49,6709.87,13404.01,0.00
2024-12-10 17:26:13,113,10087,64,49,6753.86,13404.12,0.00
2024-12-10 17:26:13,113,10088,64,49,6719.58,13405.00,0.00
2024-12-10 17:26:13,114,10088,65,49,6660.63,13405.01,0.00
2024-12-10 17:26:13,113,10088,64,49,6713.65,13405.04,0.00
2024-12-10 17:26:13,112,10088,64,48,6764.05,13405.11,0.00
2024-12-10 17:26:13,111,10088,64,47,6823.78,13405.11,0.00
2024-12-10 17:26:13,110,10088,63,47,6823.48,13405.55,0.00
2024-12-10 17:26:13,110,10089,63,47,6859.58,13406.00,0.00
2024-12-10 17:26:13,111,10089,64,47,6797.78,13406.01,0.00
2024-12-10 17:26:13,110,10089,64,46,6844.99,13406.11,0.00
2024-12-10 17:26:13,109,10089,63,46,6811.77,13406.64,0.00
2024-12-10 17:26:13,109,10090,63,46,6877.29,13407.00,0.00
2024-12-10 17:26:13,110,10090,63,47,6814.77,13407.01,0.00
2024-12-10 17:26:13,110,10091,63,47,6775.94,13408.00,0.00
2024-12-10 17:26:13,111,10091,63,48,6714.90,13408.01,0.00
2024-12-10 17:26:13,111,10092,63,48,6669.86,13409.00,0.00
2024-12-10 17:26:13,112,10092,64,48,6610.31,13409.01,0.00
2024-12-10 17:26:13,111,10092,63,48,6654.19,13409.12,0.00
2024-12-10 17:26:13,110,10092,62,48,6655.39,13409.52,0.00
2024-12-10 17:26:13,110,10093,62,48,6690.89,13410.00,0.00
2024-12-10 17:26:13,111,10093,63,48,6630.61,13410.01,0.00
2024-12-10 17:26:13,112,10092,63,49,6515.23,13410.45,0.00
2024-12-10 17:26:13,111,10092,62,49,6571.39,13410.62,0.00
2024-12-10 17:26:13,111,10093,62,49,6630.24,13411.00,0.00
2024-12-10 17:26:13,112,10093,63,49,6571.04,13411.01,0.00
2024-12-10 17:26:13,111,10093,62,49,6614.57,13411.12,0.00
2024-12-10 17:26:13,111,10094,62,49,6703.82,13412.00,0.00
2024-12-10 17:26:13,112,10094,63,49,6643.97,13412.01,0.00
2024-12-10 17:26:13,111,10094,63,48,6698.99,13412.04,0.00
2024-12-10 17:26:13,110,10094,63,47,6748.95,13412.11,0.00
2024-12-10 17:26:13,109,10094,63,46,6809.64,13412.11,0.00
2024-12-10 17:26:13,108,10094,63,45,6788.98,13412.49,0.00
2024-12-10 17:26:13,108,10095,63,45,6829.00,13413.00,0.00
2024-12-10 17:26:14,109,10095,64,45,6766.35,13413.01,0.00
2024-12-10 17:26:14,109,10096,64,45,6737.73,13414.00,0.00
2024-12-10 17:26:14,110,10096,65,45,6676.48,13414.01,0.00
2024-12-10 17:26:14,109,10096,65,44,6721.77,13414.12,0.00
2024-12-10 17:26:14,109,10097,65,44,6703.75,13415.00,0.00
2024-12-10 17:26:14,110,10097,65,45,6642.81,13415.01,0.00
2024-12-10 17:26:14,109,10097,65,44,6687.78,13415.12,0.00
2024-12-10 17:26:14,109,10098,65,44,6661.62,13416.00,0.00
2024-12-10 17:26:14,110,10098,65,45,6601.06,13416.01,0.00
2024-12-10 17:26:14,109,10098,64,45,6645.65,13416.12,0.00
2024-12-10 17:26:14,110,10097,64,46,6505.85,13416.62,0.00
2024-12-10 17:26:14,110,10098,64,46,6599.26,13417.00,0.00
2024-12-10 17:26:14,111,10098,64,47,6539.81,13417.01,0.00
2024-12-10 17:26:14,110,10098,63,47,6583.44,13417.12,0.00
2024-12-10 17:26:14,109,10098,63,46,6586.51,13417.48,0.00
2024-12-10 17:26:14,108,10098,62,46,6614.74,13417.63,0.00
2024-12-10 17:26:14,108,10099,62,46,6805.10,13418.00,0.00
2024-12-10 17:26:14,109,10099,63,46,6742.67,13418.01,0.00
2024-12-10 17:26:14,109,10100,63,46,6718.08,13419.00,0.00
2024-12-10 17:26:14,110,10100,63,47,6657.00,13419.01,0.00
2024-12-10 17:26:14,109,10100,62,47,6702.10,13419.12,0.00
2024-12-10 17:26:14,109,10101,62,47,6695.58,13420.00,0.00
2024-12-10 17:26:14,110,10101,63,47,6634.71,13420.01,0.00
2024-12-10 17:26:14,111,10100,63,48,6570.10,13420.06,0.00
2024-12-10 17:26:14,110,10100,63,47,6672.52,13420.13,0.00
2024-12-10 17:26:14,110,10101,63,47,6669.99,13421.00,0.00
2024-12-10 17:26:14,111,10101,64,47,6609.90,13421.01,0.00
2024-12-10 17:26:14,110,10101,63,47,6667.55,13421.02,0.00
2024-12-10 17:26:14,109,10101,63,46,6715.20,13421.11,0.00
2024-12-10 17:26:14,108,10101,62,46,6776.14,13421.11,0.00
2024-12-10 17:26:14,107,10101,61,46,6816.10,13421.27,0.00
2024-12-10 17:26:14,108,10100,62,46,6674.26,13421.85,0.00
2024-12-10 17:26:14,108,10101,62,46,6919.21,13422.00,0.00
2024-12-10 17:26:14,109,10101,62,47,6855.74,13422.01,0.00
2024-12-10 17:26:14,108,10101,62,46,6904.33,13422.11,0.00
2024-12-10 17:26:14,107,10101,61,46,6907.33,13422.56,0.00
2024-12-10 17:26:14,107,10102,61,46,7099.61,13423.00,0.00
2024-12-10 17:26:14,108,10102,61,47,7033.87,13423.01,0.00
2024-12-10 17:26:14,107,10102,60,47,7098.35,13423.01,0.00
2024-12-10 17:26:14,106,10102,59,47,7151.42,13423.10,0.00
2024-12-10 17:26:14,105,10102,59,46,7218.25,13423.10,0.00
2024-12-10 17:26:14,105,10103,59,46,7226.43,13424.00,0.00
2024-12-10 17:26:14,106,10103,60,46,7158.25,13424.01,0.00
2024-12-10 17:26:14,107,10102,61,46,7087.60,13424.06,0.00
2024-12-10 17:26:14,106,10102,61,45,7238.07,13424.11,0.00
2024-12-10 17:26:14,106,10102,61,45,7246.18,13425.00,0.00
2024-12-10 17:26:14,107,10102,62,45,7178.46,13425.01,0.00
2024-12-10 17:26:14,106,10102,61,45,7238.60,13425.06,0.00
2024-12-10 17:26:14,105,10102,60,45,7301.16,13425.10,0.00
2024-12-10 17:26:14,105,10103,60,45,7435.93,13426.00,0.00
2024-12-10 17:26:14,106,10103,61,45,7365.78,13426.01,0.00
2024-12-10 17:26:14,105,10103,61,44,7423.17,13426.10,0.00
2024-12-10 17:26:14,105,10104,61,44,7430.09,13427.00,0.00
2024-12-10 17:26:14,106,10104,62,44,7359.99,13427.01,0.00
2024-12-10 17:26:14,105,10104,61,44,7417.33,13427.10,0.00
2024-12-10 17:26:14,105,10105,61,44,7424.25,13428.00,0.00
2024-12-10 17:26:14,106,10105,62,44,7354.21,13428.01,0.00
2024-12-10 17:26:14,106,10106,62,44,7348.42,13429.00,0.00
2024-12-10 17:26:14,107,10106,62,45,7279.74,13429.01,0.00
2024-12-10 17:26:14,106,10106,61,45,7347.15,13429.01,0.00
2024-12-10 17:26:14,105,10106,60,45,7405.65,13429.09,0.00
2024-12-10 17:26:14,104,10106,60,44,7475.56,13429.09,0.00
2024-12-10 17:26:14,104,10107,60,44,7482.54,13430.00,0.00
2024-12-10 17:26:14,105,10107,60,45,7411.28,13430.01,0.00
2024-12-10 17:26:14,104,10107,60,44,7470.95,13430.09,0.00
2024-12-10 17:26:14,104,10108,60,44,7477.93,13431.00,0.00
2024-12-10 17:26:14,105,10108,60,45,7406.71,13431.01,0.00
2024-12-10 17:26:14,104,10108,59,45,7472.78,13431.04,0.00
2024-12-10 17:26:14,103,10108,59,44,7538.83,13431.08,0.00
2024-12-10 17:26:14,102,10108,59,43,7611.42,13431.08,0.00
2024-12-10 17:26:14,102,10109,59,43,7619.86,13432.00,0.00
2024-12-10 17:26:14,103,10109,59,44,7545.88,13432.01,0.00
2024-12-10 17:26:14,102,10109,58,44,7609.36,13432.08,0.00
2024-12-10 17:26:14,102,10110,58,44,7617.80,13433.00,0.00
2024-12-10 17:26:14,103,10110,59,44,7543.84,13433.01,0.00
2024-12-10 17:26:14,103,10111,59,44,7541.79,13434.00,0.00
2024-12-10 17:26:14,104,10111,60,44,7469.27,13434.01,0.00
2024-12-10 17:26:14,104,10112,60,44,7464.17,13435.00,0.00
2024-12-10 17:26:14,105,10112,60,45,7393.08,13435.01,0.00
2024-12-10 17:26:14,104,10112,59,45,7453.86,13435.08,0.00
2024-12-10 17:26:14,104,10113,59,45,7439.13,13436.00,0.00
2024-12-10 17:26:14,105,10113,59,46,7368.28,13436.01,0.00
2024-12-10 17:26:14,105,10114,59,46,7306.31,13437.00,0.00
2024-12-10 17:26:14,106,10114,60,46,7237.38,13437.01,0.00
2024-12-10 17:26:14,105,10114,59,46,7228.20,13437.46,0.00
2024-12-10 17:26:14,105,10115,59,46,7266.43,13438.00,0.00
2024-12-10 17:26:14,106,10115,60,46,7197.88,13438.01,0.00
2024-12-10 17:26:15,105,10115,59,46,7265.15,13438.01,0.00
2024-12-10 17:26:15,104,10115,58,46,7331.14,13438.03,0.00
2024-12-10 17:26:15,103,10115,57,46,7397.11,13438.06,0.00
2024-12-10 17:26:15,102,10115,56,46,7468.31,13438.06,0.00
2024-12-10 17:26:15,101,10115,56,45,7510.85,13438.23,0.00
2024-12-10 17:26:15,101,10116,56,45,7506.82,13439.00,0.00
2024-12-10 17:26:15,102,10116,57,45,7433.23,13439.01,0.00
2024-12-10 17:26:15,101,10116,56,45,7431.05,13439.47,0.00
2024-12-10 17:26:15,101,10117,56,45,7490.39,13440.00,0.00
2024-12-10 17:26:15,102,10117,56,46,7416.95,13440.01,0.00
2024-12-10 17:26:15,102,10118,56,46,7406.67,13441.00,0.00
2024-12-10 17:26:15,103,10118,57,46,7334.76,13441.01,0.00
2024-12-10 17:26:15,102,10118,57,45,7397.47,13441.07,0.00
2024-12-10 17:26:15,102,10119,57,45,7391.20,13442.00,0.00
2024-12-10 17:26:15,103,10119,58,45,7319.44,13442.01,0.00
2024-12-10 17:26:15,102,10119,58,44,7382.00,13442.07,0.00
2024-12-10 17:26:15,102,10120,58,44,7372.82,13443.00,0.00
2024-12-10 17:26:15,103,10120,58,45,7301.24,13443.01,0.00
2024-12-10 17:26:15,103,10121,58,45,7280.69,13444.00,0.00
2024-12-10 17:26:15,104,10121,59,45,7210.68,13444.01,0.00
2024-12-10 17:26:15,105,10120,60,45,7101.12,13444.33,0.00
2024-12-10 17:26:15,105,10121,60,45,7154.33,13445.00,0.00
2024-12-10 17:26:15,106,10121,61,45,7086.84,13445.01,0.00
2024-12-10 17:26:15,105,10121,61,44,7145.39,13445.07,0.00
2024-12-10 17:26:15,104,10121,61,43,7177.01,13445.34,0.00
2024-12-10 17:26:15,104,10122,61,43,7337.81,13446.00,0.00
2024-12-10 17:26:15,105,10122,62,43,7267.93,13446.01,0.00
2024-12-10 17:26:15,104,10122,62,42,7240.94,13446.52,0.00
2024-12-10 17:26:15,105,10121,63,42,7151.59,13446.69,0.00
2024-12-10 17:26:15,105,10122,63,42,7274.80,13447.00,0.00
2024-12-10 17:26:15,106,10122,64,42,7206.17,13447.01,0.00
2024-12-10 17:26:15,105,10122,63,42,7214.24,13447.28,0.00
2024-12-10 17:26:15,105,10123,63,42,7347.14,13448.00,0.00
2024-12-10 17:26:15,106,10123,64,42,7277.83,13448.01,0.00
2024-12-10 17:26:15,105,10123,64,41,7338.20,13448.07,0.00
2024-12-10 17:26:15,104,10123,64,40,7371.28,13448.30,0.00
2024-12-10 17:26:15,105,10122,65,40,7228.41,13448.86,0.00
2024-12-10 17:26:15,106,10121,66,40,7176.72,13448.87,0.00
2024-12-10 17:26:15,106,10122,66,40,7301.18,13449.00,0.00
2024-12-10 17:26:15,107,10122,66,41,7232.95,13449.01,0.00
2024-12-10 17:26:15,106,10122,65,41,7292.32,13449.07,0.00
2024-12-10 17:26:15,106,10123,65,41,7547.89,13450.00,0.00
2024-12-10 17:26:15,107,10123,66,41,7477.35,13450.01,0.00
2024-12-10 17:26:15,107,10124,66,41,7470.36,13451.00,0.00
2024-12-10 17:26:15,108,10124,66,42,7401.19,13451.01,0.00
2024-12-10 17:26:15,108,10125,66,42,7391.64,13452.00,0.00
2024-12-10 17:26:15,109,10125,66,43,7323.83,13452.01,0.00
2024-12-10 17:26:15,108,10125,65,43,7381.70,13452.07,0.00
2024-12-10 17:26:15,108,10126,65,43,7371.51,13453.00,0.00
2024-12-10 17:26:15,109,10126,66,43,7303.88,13453.01,0.00
2024-12-10 17:26:15,108,10126,66,42,7361.56,13453.07,0.00
2024-12-10 17:26:15,108,10127,66,42,7343.55,13454.00,0.00
2024-12-10 17:26:15,109,10127,67,42,7276.18,13454.01,0.00
2024-12-10 17:26:15,108,10127,66,42,7333.61,13454.07,0.00
2024-12-10 17:26:15,107,10127,65,42,7362.70,13454.29,0.00
2024-12-10 17:26:15,107,10128,65,42,7393.36,13455.00,0.00
2024-12-10 17:26:15,108,10128,65,43,7324.90,13455.01,0.00
2024-12-10 17:26:15,108,10129,65,43,7316.72,13456.00,0.00
2024-12-10 17:26:15,109,10129,66,43,7249.60,13456.01,0.00
2024-12-10 17:26:15,108,10129,65,43,7306.78,13456.07,0.00
2024-12-10 17:26:15,108,10130,65,43,7307.30,13457.00,0.00
2024-12-10 17:26:15,109,10130,65,44,7240.26,13457.01,0.00
2024-12-10 17:26:15,108,10130,65,43,7301.08,13457.05,0.00
2024-12-10 17:26:15,107,10130,64,43,7365.55,13457.07,0.00
2024-12-10 17:26:15,106,10130,63,43,7433.77,13457.07,0.00
2024-12-10 17:26:15,106,10131,63,43,7435.57,13458.00,0.00
2024-12-10 17:26:15,107,10131,63,44,7366.08,13458.01,0.00
2024-12-10 17:26:15,106,10131,62,44,7426.70,13458.07,0.00
2024-12-10 17:26:15,105,10131,62,43,7474.71,13458.23,0.00
2024-12-10 17:26:15,105,10132,62,43,7499.57,13459.00,0.00
2024-12-10 17:26:15,106,10132,63,43,7428.82,13459.01,0.00
2024-12-10 17:26:15,105,10132,62,43,7490.62,13459.07,0.00
2024-12-10 17:26:15,105,10133,62,43,7493.72,13460.00,0.00
2024-12-10 17:26:15,106,10133,62,44,7423.02,13460.01,0.00
2024-12-10 17:26:15,105,10133,61,44,7484.74,13460.08,0.00
2024-12-10 17:26:15,105,10134,61,44,7489.12,13461.00,0.00
2024-12-10 17:26:15,106,10134,61,45,7418.47,13461.01,0.00
2024-12-10 17:26:15,106,10135,61,45,7412.67,13462.00,0.00
2024-12-10 17:26:15,107,10135,61,46,7343.39,13462.01,0.00
2024-12-10 17:26:15,106,10135,61,45,7403.80,13462.07,0.00
2024-12-10 17:26:15,106,10136,61,45,7405.34,13463.00,0.00
2024-12-10 17:26:15,107,10136,61,46,7336.13,13463.01,0.00
2024-12-10 17:26:15,106,10136,60,46,7399.01,13463.05,0.00
2024-12-10 17:26:16,106,10137,60,46,7394.33,13464.00,0.00
2024-12-10 17:26:16,107,10137,60,47,7325.23,13464.01,0.00
2024-12-10 17:26:16,106,10137,60,46,7383.30,13464.08,0.00
2024-12-10 17:26:16,106,10138,60,46,7386.37,13465.00,0.00
2024-12-10 17:26:16,107,10138,60,47,7317.34,13465.01,0.00
2024-12-10 17:26:16,107,10139,60,47,7301.89,13466.00,0.00
2024-12-10 17:26:16,108,10139,60,48,7234.28,13466.01,0.00
2024-12-10 17:26:16,107,10139,59,48,7294.36,13466.06,0.00
2024-12-10 17:26:16,106,10139,59,47,7330.44,13466.16,0.00
2024-12-10 17:26:16,106,10140,59,47,7344.92,13467.00,0.00
2024-12-10 17:26:16,107,10140,60,47,7276.28,13467.01,0.00
2024-12-10 17:26:16,106,10140,60,46,7337.32,13467.06,0.00
2024-12-10 17:26:16,105,10140,60,45,7395.00,13467.10,0.00
2024-12-10 17:26:16,106,10139,61,45,7320.17,13467.15,0.00
2024-12-10 17:26:16,107,10138,62,45,7356.56,13467.24,0.00
2024-12-10 17:26:16,107,10139,62,45,7470.33,13468.00,0.00
2024-12-10 17:26:16,108,10139,63,45,7401.16,13468.01,0.00
2024-12-10 17:26:16,108,10140,63,45,7642.41,13469.00,0.00
2024-12-10 17:26:16,109,10140,64,45,7572.29,13469.01,0.00
2024-12-10 17:26:16,108,10140,63,45,7634.94,13469.06,0.00
2024-12-10 17:26:16,108,10141,63,45,7633.00,13470.00,0.00
2024-12-10 17:26:16,109,10141,63,46,7562.97,13470.01,0.00
2024-12-10 17:26:16,108,10141,63,45,7625.53,13470.06,0.00
2024-12-10 17:26:16,108,10142,63,45,7621.71,13471.00,0.00
2024-12-10 17:26:16,109,10142,63,46,7551.79,13471.01,0.00
2024-12-10 17:26:16,108,10142,62,46,7616.73,13471.04,0.00
2024-12-10 17:26:16,108,10143,62,46,7604.30,13472.00,0.00
2024-12-10 17:26:16,109,10143,63,46,7534.54,13472.01,0.00
2024-12-10 17:26:16,109,10144,63,46,7511.55,13473.00,0.00
2024-12-10 17:26:16,110,10144,63,47,7443.26,13473.01,0.00
2024-12-10 17:26:16,109,10144,62,47,7504.15,13473.05,0.00
2024-12-10 17:26:16,109,10145,62,47,7482.66,13474.00,0.00
2024-12-10 17:26:16,110,10145,62,48,7414.64,13474.01,0.00
2024-12-10 17:26:16,110,10146,62,48,7381.85,13475.00,0.00
2024-12-10 17:26:16,111,10146,62,49,7315.35,13475.01,0.00
2024-12-10 17:26:16,111,10147,62,49,7277.98,13476.00,0.00
2024-12-10 17:26:16,112,10147,62,50,7213.00,13476.01,0.00
2024-12-10 17:26:16,111,10147,62,49,7270.71,13476.05,0.00
2024-12-10 17:26:16,111,10148,62,49,7236.44,13477.00,0.00
2024-12-10 17:26:16,112,10148,62,50,7171.83,13477.01,0.00
2024-12-10 17:26:16,112,10149,62,50,7126.70,13478.00,0.00
2024-12-10 17:26:16,113,10149,62,51,7063.64,13478.01,0.00
2024-12-10 17:26:16,112,10149,61,51,7119.50,13478.05,0.00
2024-12-10 17:26:16,111,10149,60,51,7182.42,13478.05,0.00
2024-12-10 17:26:16,110,10149,59,51,7098.27,13478.90,0.00
2024-12-10 17:26:16,110,10150,59,51,7207.41,13479.00,0.00
2024-12-10 17:26:16,111,10150,59,52,7142.48,13479.01,0.00
2024-12-10 17:26:16,112,10149,60,52,7018.23,13479.38,0.00
2024-12-10 17:26:16,112,10150,60,52,7093.28,13480.00,0.00
2024-12-10 17:26:16,113,10150,60,53,7030.51,13480.01,0.00
2024-12-10 17:26:16,113,10151,60,53,7122.98,13481.00,0.00
2024-12-10 17:26:16,114,10151,60,54,7060.50,13481.01,0.00
2024-12-10 17:26:16,113,10151,60,53,7113.92,13481.06,0.00
2024-12-10 17:26:16,113,10152,60,53,7107.28,13482.00,0.00
2024-12-10 17:26:16,114,10152,61,53,7044.93,13482.01,0.00
2024-12-10 17:26:16,114,10153,61,53,7030.08,13483.00,0.00
2024-12-10 17:26:16,115,10153,62,53,6968.95,13483.01,0.00
2024-12-10 17:26:16,115,10154,62,53,6953.05,13484.00,0.00
2024-12-10 17:26:16,116,10154,63,53,6893.11,13484.01,0.00
2024-12-10 17:26:16,116,10155,63,53,6876.18,13485.00,0.00
2024-12-10 17:26:16,117,10155,64,53,6817.41,13485.01,0.00
2024-12-10 17:26:16,116,10155,64,52,6868.06,13485.06,0.00
2024-12-10 17:26:16,116,10156,64,52,6858.09,13486.00,0.00
2024-12-10 17:26:16,117,10156,64,53,6799.47,13486.01,0.00
2024-12-10 17:26:16,117,10157,64,53,6781.53,13487.00,0.00
2024-12-10 17:26:16,118,10157,64,54,6724.06,13487.01,0.00
2024-12-10 17:26:16,119,10156,64,55,6586.15,13487.63,0.00
2024-12-10 17:26:16,119,10157,64,55,6695.26,13488.00,0.00
2024-12-10 17:26:16,120,10157,64,56,6639.46,13488.01,0.00
2024-12-10 17:26:16,119,10157,63,56,6687.34,13488.06,0.00
2024-12-10 17:26:16,119,10158,63,56,6787.57,13489.00,0.00
2024-12-10 17:26:16,120,10158,64,56,6731.01,13489.01,0.00
2024-12-10 17:26:16,119,10158,64,55,6779.65,13489.06,0.00
2024-12-10 17:26:17,119,10159,64,55,6766.53,13490.00,0.00
2024-12-10 17:26:17,120,10159,65,55,6710.15,13490.01,0.00
2024-12-10 17:26:17,119,10159,65,54,6763.14,13490.03,0.00
2024-12-10 17:26:17,118,10159,65,53,6815.89,13490.05,0.00
2024-12-10 17:26:17,117,10159,64,53,6872.99,13490.05,0.00
2024-12-10 17:26:17,117,10160,64,53,6860.80,13491.00,0.00
2024-12-10 17:26:17,118,10160,64,54,6802.66,13491.01,0.00
2024-12-10 17:26:17,118,10161,64,54,6783.73,13492.00,0.00
2024-12-10 17:26:17,119,10161,64,55,6726.72,13492.01,0.00
2024-12-10 17:26:17,118,10161,63,55,6776.88,13492.05,0.00
2024-12-10 17:26:17,118,10162,63,55,6763.65,13493.00,0.00
2024-12-10 17:26:17,119,10162,63,56,6706.81,13493.01,0.00
2024-12-10 17:26:17,118,10162,62,56,6756.80,13493.05,0.00
2024-12-10 17:26:17,119,10161,62,57,6632.14,13493.57,0.00
2024-12-10 17:26:17,119,10162,62,57,6693.70,13494.00,0.00
2024-12-10 17:26:17,120,10162,62,58,6637.92,13494.01,0.00
2024-12-10 17:26:17,119,10162,61,58,6686.91,13494.05,0.00
2024-12-10 17:26:17,119,10163,61,58,6786.05,13495.00,0.00
2024-12-10 17:26:17,120,10163,62,58,6729.50,13495.01,0.00
2024-12-10 17:26:17,120,10164,62,58,6708.63,13496.00,0.00
2024-12-10 17:26:17,121,10164,63,58,6653.19,13496.01,0.00
2024-12-10 17:26:17,120,10164,63,57,6700.78,13496.06,0.00
2024-12-10 17:26:17,120,10165,63,57,6686.63,13497.00,0.00
2024-12-10 17:26:17,121,10165,64,57,6631.37,13497.01,0.00
2024-12-10 17:26:17,120,10165,64,56,6678.78,13497.06,0.00
2024-12-10 17:26:17,120,10166,64,56,6664.63,13498.00,0.00
2024-12-10 17:26:17,121,10166,64,57,6609.55,13498.01,0.00
2024-12-10 17:26:17,120,10166,63,57,6660.14,13498.03,0.00
2024-12-10 17:26:17,119,10166,62,57,6712.71,13498.05,0.00
2024-12-10 17:26:17,118,10166,62,56,6768.46,13498.05,0.00
2024-12-10 17:26:17,118,10167,62,56,6755.22,13499.00,0.00
2024-12-10 17:26:17,119,10167,63,56,6698.45,13499.01,0.00
2024-12-10 17:26:17,118,10167,62,56,6748.37,13499.05,0.00
2024-12-10 17:26:17,118,10168,62,56,6735.13,13500.00,0.00
2024-12-10 17:26:17,119,10168,63,56,6678.53,13500.01,0.00
2024-12-10 17:26:17,118,10168,62,56,6728.28,13500.05,0.00
2024-12-10 17:26:17,118,10169,62,56,6715.03,13501.00,0.00
2024-12-10 17:26:17,119,10169,63,56,6658.60,13501.01,0.00
2024-12-10 17:26:17,118,10169,62,56,6708.18,13501.05,0.00
2024-12-10 17:26:17,118,10170,62,56,6694.93,13502.00,0.00
2024-12-10 17:26:17,119,10170,62,57,6638.67,13502.01,0.00
2024-12-10 17:26:17,118,10170,61,57,6688.08,13502.05,0.00
2024-12-10 17:26:17,118,10171,61,57,6674.83,13503.00,0.00
2024-12-10 17:26:17,119,10171,61,58,6618.74,13503.01,0.00
2024-12-10 17:26:17,118,10171,60,58,6667.98,13503.05,0.00
2024-12-10 17:26:17,118,10172,60,58,6654.72,13504.00,0.00
2024-12-10 17:26:17,119,10172,61,58,6598.80,13504.01,0.00
2024-12-10 17:26:17,118,10172,61,57,6647.87,13504.05,0.00
2024-12-10 17:26:17,119,10171,61,58,6537.63,13504.47,0.00
2024-12-10 17:26:17,119,10172,61,58,6591.34,13505.00,0.00
2024-12-10 17:26:17,120,10172,62,58,6536.42,13505.01,0.00
2024-12-10 17:26:17,119,10172,61,58,6584.55,13505.05,0.00
2024-12-10 17:26:17,119,10173,61,58,6683.76,13506.00,0.00
2024-12-10 17:26:17,120,10173,62,58,6628.06,13506.01,0.00
2024-12-10 17:26:17,119,10173,61,58,6676.96,13506.05,0.00
2024-12-10 17:26:17,119,10174,61,58,6662.69,13507.00,0.00
2024-12-10 17:26:17,120,10174,61,59,6607.17,13507.01,0.00
2024-12-10 17:26:17,121,10173,61,60,6489.05,13507.50,0.00
2024-12-10 17:26:17,121,10174,61,60,6595.47,13508.00,0.00
2024-12-10 17:26:17,122,10174,61,61,6541.41,13508.01,0.00
2024-12-10 17:26:17,121,10174,61,60,6587.67,13508.06,0.00
2024-12-10 17:26:17,121,10175,61,60,6684.16,13509.00,0.00
2024-12-10 17:26:17,122,10175,61,61,6629.37,13509.01,0.00
2024-12-10 17:26:17,121,10175,60,61,6676.36,13509.06,0.00
2024-12-10 17:26:17,121,10176,60,61,6661.21,13510.00,0.00
2024-12-10 17:26:17,122,10176,60,62,6606.61,13510.01,0.00
2024-12-10 17:26:17,121,10176,60,61,6657.86,13510.02,0.00
2024-12-10 17:26:17,120,10176,59,61,6708.85,13510.05,0.00
2024-12-10 17:26:17,119,10176,59,60,6764.09,13510.05,0.00
2024-12-10 17:26:17,119,10177,59,60,6749.82,13511.00,0.00
2024-12-10 17:26:17,120,10177,59,61,6693.57,13511.01,0.00
2024-12-10 17:26:17,119,10177,58,61,6743.02,13511.05,0.00
2024-12-10 17:26:17,119,10178,58,61,6728.74,13512.00,0.00
2024-12-10 17:26:17,120,10178,58,62,6672.67,13512.01,0.00
2024-12-10 17:26:17,119,10178,57,62,6721.94,13512.05,0.00
2024-12-10 17:26:17,120,10177,57,63,6661.42,13512.10,0.00
2024-12-10 17:26:17,120,10178,57,63,6688.93,13513.00,0.00
2024-12-10 17:26:17,121,10178,58,63,6633.65,13513.01,0.00
2024-12-10 17:26:17,120,10178,57,63,6682.18,13513.05,0.00
2024-12-10 17:26:17,120,10179,57,63,6779.52,13514.00,0.00
2024-12-10 17:26:18,121,10179,58,63,6723.49,13514.01,0.00
2024-12-10 17:26:18,120,10179,57,63,6772.77,13514.05,0.00
2024-12-10 17:26:18,121,10178,57,64,6674.42,13514.38,0.00
2024-12-10 17:26:18,121,10179,57,64,6776.48,13515.00,0.00
2024-12-10 17:26:18,122,10179,57,65,6720.94,13515.01,0.00
2024-12-10 17:26:18,121,10179,57,64,6769.79,13515.05,0.00
2024-12-10 17:26:18,121,10180,57,64,6865.23,13516.00,0.00
2024-12-10 17:26:18,122,10180,57,65,6808.96,13516.01,0.00
2024-12-10 17:26:18,121,10180,57,64,6858.54,13516.05,0.00
2024-12-10 17:26:18,121,10181,57,64,6842.28,13517.00,0.00
2024-12-10 17:26:18,122,10181,57,65,6786.20,13517.01,0.00
2024-12-10 17:26:18,121,10181,57,64,6834.47,13517.06,0.00
2024-12-10 17:26:18,121,10182,57,64,6819.32,13518.00,0.00
2024-12-10 17:26:18,122,10182,58,64,6763.43,13518.01,0.00
2024-12-10 17:26:18,121,10182,57,64,6811.52,13518.06,0.00
2024-12-10 17:26:18,121,10183,57,64,6796.37,13519.00,0.00
2024-12-10 17:26:18,122,10183,58,64,6740.66,13519.01,0.00
2024-12-10 17:26:18,121,10183,58,63,6788.56,13519.06,0.00
2024-12-10 17:26:18,121,10184,58,63,6773.40,13520.00,0.00
2024-12-10 17:26:18,122,10184,58,64,6717.89,13520.01,0.00
2024-12-10 17:26:18,121,10184,57,64,6772.29,13520.01,0.00
2024-12-10 17:26:18,120,10184,56,64,6821.98,13520.05,0.00
2024-12-10 17:26:18,119,10184,56,63,6878.17,13520.05,0.00
2024-12-10 17:26:18,119,10185,56,63,6863.89,13521.00,0.00
2024-12-10 17:26:18,120,10185,57,63,6806.69,13521.01,0.00
2024-12-10 17:26:18,119,10185,57,62,6859.35,13521.03,0.00
2024-12-10 17:26:18,118,10185,56,62,6915.20,13521.04,0.00
2024-12-10 17:26:18,117,10185,55,62,6973.15,13521.04,0.00
2024-12-10 17:26:18,117,10186,55,62,6959.78,13522.00,0.00
2024-12-10 17:26:18,118,10186,55,63,6900.80,13522.01,0.00
2024-12-10 17:26:18,117,10186,55,62,6954.02,13522.04,0.00
2024-12-10 17:26:18,117,10187,55,62,6940.65,13523.00,0.00
2024-12-10 17:26:18,118,10187,56,62,6881.83,13523.01,0.00
2024-12-10 17:26:18,117,10187,56,61,6934.88,13523.04,0.00
2024-12-10 17:26:18,118,10186,56,62,6847.49,13523.27,0.00
2024-12-10 17:26:18,118,10187,56,62,6884.63,13524.00,0.00
2024-12-10 17:26:18,119,10187,56,63,6826.77,13524.01,0.00
2024-12-10 17:26:18,118,10187,56,62,6883.48,13524.01,0.00
2024-12-10 17:26:18,117,10187,55,62,6937.71,13524.03,0.00
2024-12-10 17:26:18,116,10187,54,62,6996.35,13524.03,0.00
2024-12-10 17:26:18,116,10188,54,62,7099.46,13525.00,0.00
2024-12-10 17:26:18,117,10188,55,62,7038.78,13525.01,0.00
2024-12-10 17:26:18,116,10188,54,62,7094.81,13525.03,0.00
2024-12-10 17:26:18,116,10189,54,62,7081.32,13526.00,0.00
2024-12-10 17:26:18,117,10189,55,62,7020.80,13526.01,0.00
2024-12-10 17:26:18,116,10189,54,62,7076.67,13526.03,0.00
2024-12-10 17:26:18,116,10190,54,62,7063.19,13527.00,0.00
2024-12-10 17:26:18,117,10190,55,62,7002.82,13527.01,0.00
2024-12-10 17:26:18,116,10190,54,62,7058.54,13527.03,0.00
2024-12-10 17:26:18,116,10191,54,62,7045.05,13528.00,0.00
2024-12-10 17:26:18,117,10191,55,62,6984.84,13528.01,0.00
2024-12-10 17:26:18,116,10191,54,62,7040.40,13528.03,0.00
2024-12-10 17:26:18,116,10192,54,62,7026.91,13529.00,0.00
2024-12-10 17:26:18,117,10192,54,63,6966.85,13529.01,0.00
2024-12-10 17:26:18,116,10192,54,62,7022.26,13529.03,0.00
2024-12-10 17:26:18,116,10193,54,62,7008.77,13530.00,0.00
2024-12-10 17:26:18,117,10193,55,62,6948.86,13530.01,0.00
2024-12-10 17:26:18,116,10193,55,61,7004.11,13530.03,0.00
2024-12-10 17:26:18,116,10194,55,61,6990.62,13531.00,0.00
2024-12-10 17:26:18,117,10194,55,62,6930.87,13531.01,0.00
2024-12-10 17:26:18,116,10194,55,61,6985.97,13531.03,0.00
2024-12-10 17:26:18,116,10195,55,61,6972.48,13532.00,0.00
2024-12-10 17:26:18,117,10195,56,61,6912.88,13532.01,0.00
2024-12-10 17:26:18,116,10195,56,60,6967.82,13532.03,0.00
2024-12-10 17:26:18,116,10196,56,60,6954.32,13533.00,0.00
2024-12-10 17:26:18,117,10196,57,60,6894.89,13533.01,0.00
2024-12-10 17:26:18,116,10196,56,60,6949.67,13533.03,0.00
2024-12-10 17:26:18,117,10195,57,60,6770.41,13533.94,0.00
2024-12-10 17:26:18,117,10196,57,60,6886.14,13534.00,0.00
2024-12-10 17:26:18,118,10196,57,61,6827.78,13534.01,0.00
2024-12-10 17:26:18,118,10197,57,61,6923.49,13535.00,0.00
2024-12-10 17:26:18,119,10197,57,62,6865.31,13535.01,0.00
2024-12-10 17:26:18,119,10198,57,62,6845.34,13536.00,0.00
2024-12-10 17:26:18,120,10198,58,62,6788.30,13536.01,0.00
2024-12-10 17:26:18,119,10198,58,61,6838.53,13536.05,0.00
2024-12-10 17:26:18,120,10197,58,62,6668.01,13536.91,0.00
2024-12-10 17:26:18,120,10198,58,62,6770.75,13537.00,0.00
2024-12-10 17:26:18,121,10198,58,63,6714.79,13537.01,0.00
2024-12-10 17:26:18,120,10198,57,63,6763.99,13537.05,0.00
2024-12-10 17:26:19,120,10199,57,63,6861.51,13538.00,0.00
2024-12-10 17:26:19,121,10199,57,64,6804.80,13538.01,0.00
2024-12-10 17:26:19,120,10199,56,64,6854.75,13538.05,0.00
2024-12-10 17:26:19,120,10200,56,64,6839.45,13539.00,0.00
2024-12-10 17:26:19,121,10200,56,65,6782.92,13539.01,0.00
2024-12-10 17:26:19,120,10200,55,65,6832.69,13539.05,0.00
2024-12-10 17:26:19,120,10201,55,65,6817.39,13540.00,0.00
2024-12-10 17:26:19,121,10201,55,66,6761.04,13540.01,0.00
2024-12-10 17:26:19,120,10201,55,65,6810.63,13540.05,0.00
2024-12-10 17:26:19,121,10200,55,66,6749.86,13540.10,0.00
2024-12-10 17:26:19,121,10200,55,66,6846.59,13541.00,0.00
2024-12-10 17:26:19,122,10200,56,66,6790.47,13541.01,0.00
2024-12-10 17:26:19,121,10200,55,66,6839.89,13541.05,0.00
2024-12-10 17:26:19,121,10201,55,66,6935.51,13542.00,0.00
2024-12-10 17:26:19,122,10201,55,67,6878.67,13542.01,0.00
2024-12-10 17:26:19,121,10201,54,67,6928.81,13542.05,0.00
2024-12-10 17:26:19,121,10202,54,67,6912.52,13543.00,0.00
2024-12-10 17:26:19,122,10202,54,68,6855.86,13543.01,0.00
2024-12-10 17:26:19,121,10202,54,67,6905.81,13543.05,0.00
2024-12-10 17:26:19,121,10203,54,67,6889.53,13544.00,0.00
2024-12-10 17:26:19,122,10203,55,67,6833.06,13544.01,0.00
2024-12-10 17:26:19,121,10203,54,67,6888.41,13544.01,0.00
2024-12-10 17:26:19,120,10203,53,67,6940.18,13544.04,0.00
2024-12-10 17:26:19,120,10204,53,67,6923.75,13545.00,0.00
2024-12-10 17:26:19,121,10204,54,67,6866.53,13545.01,0.00
2024-12-10 17:26:19,120,10204,53,67,6916.99,13545.05,0.00
2024-12-10 17:26:19,120,10205,53,67,6901.68,13546.00,0.00
2024-12-10 17:26:19,121,10205,53,68,6844.64,13546.01,0.00
2024-12-10 17:26:19,120,10205,52,68,6894.92,13546.05,0.00
2024-12-10 17:26:19,120,10206,52,68,6879.61,13547.00,0.00
2024-12-10 17:26:19,121,10206,52,69,6822.76,13547.01,0.00
2024-12-10 17:26:19,121,10207,52,69,6800.87,13548.00,0.00
2024-12-10 17:26:19,122,10207,53,69,6745.12,13548.01,0.00
2024-12-10 17:26:19,123,10206,53,70,6689.18,13548.03,0.00
2024-12-10 17:26:19,122,10206,52,70,6781.78,13548.03,0.00
2024-12-10 17:26:19,121,10206,52,69,6836.71,13548.03,0.00
2024-12-10 17:26:19,120,10206,51,69,6889.18,13548.06,0.00
2024-12-10 17:26:19,119,10206,50,69,6945.94,13548.06,0.00
2024-12-10 17:26:19,118,10206,49,69,7003.65,13548.06,0.00
2024-12-10 17:26:19,118,10207,49,69,6991.51,13549.00,0.00
2024-12-10 17:26:19,119,10207,49,70,6932.76,13549.01,0.00
2024-12-10 17:26:19,118,10207,49,69,6984.65,13549.05,0.00
2024-12-10 17:26:19,119,10206,49,70,6819.28,13549.86,0.00
2024-12-10 17:26:19,119,10207,49,70,7043.72,13550.00,0.00
2024-12-10 17:26:19,120,10207,49,71,6985.02,13550.01,0.00
2024-12-10 17:26:19,120,10208,49,71,7077.00,13551.00,0.00
2024-12-10 17:26:19,121,10208,49,72,7018.52,13551.01,0.00
2024-12-10 17:26:19,120,10208,49,71,7069.13,13551.06,0.00
2024-12-10 17:26:19,120,10209,49,71,7054.94,13552.00,0.00
2024-12-10 17:26:19,121,10209,49,72,6996.63,13552.01,0.00
2024-12-10 17:26:19,120,10209,49,71,7047.07,13552.06,0.00
2024-12-10 17:26:19,120,10210,49,71,7032.88,13553.00,0.00
2024-12-10 17:26:19,121,10210,49,72,6974.75,13553.01,0.00
2024-12-10 17:26:19,120,10210,48,72,7025.00,13553.06,0.00
2024-12-10 17:26:19,120,10211,48,72,7010.80,13554.00,0.00
2024-12-10 17:26:19,121,10211,48,73,6952.86,13554.01,0.00
2024-12-10 17:26:19,120,10211,47,73,7002.93,13554.06,0.00
2024-12-10 17:26:19,120,10212,47,73,6988.73,13555.00,0.00
2024-12-10 17:26:19,121,10212,47,74,6930.97,13555.01,0.00
2024-12-10 17:26:19,120,10212,47,73,6980.85,13555.06,0.00
2024-12-10 17:26:19,120,10213,47,73,6966.65,13556.00,0.00
2024-12-10 17:26:19,121,10213,48,73,6909.07,13556.01,0.00
2024-12-10 17:26:19,120,10213,47,73,6958.77,13556.06,0.00
2024-12-10 17:26:19,120,10214,47,73,6944.57,13557.00,0.00
2024-12-10 17:26:19,121,10214,48,73,6887.18,13557.01,0.00
2024-12-10 17:26:19,120,10214,48,72,6936.69,13557.06,0.00
2024-12-10 17:26:19,120,10215,48,72,6922.48,13558.00,0.00
2024-12-10 17:26:19,121,10215,48,73,6865.27,13558.01,0.00
2024-12-10 17:26:19,120,10215,48,72,6914.60,13558.06,0.00
2024-12-10 17:26:19,121,10214,48,73,6764.72,13558.76,0.00
2024-12-10 17:26:19,121,10215,48,73,6871.38,13559.00,0.00
2024-12-10 17:26:19,122,10215,49,73,6815.06,13559.01,0.00
2024-12-10 17:26:20,121,10215,48,73,6863.57,13559.06,0.00
2024-12-10 17:26:20,121,10216,48,73,6960.42,13560.00,0.00
2024-12-10 17:26:20,122,10216,49,73,6903.37,13560.01,0.00
2024-12-10 17:26:20,121,10216,49,72,6952.61,13560.06,0.00
2024-12-10 17:26:20,122,10215,50,72,6841.25,13560.48,0.00
2024-12-10 17:26:20,122,10216,50,72,6941.67,13561.00,0.00
2024-12-10 17:26:20,123,10216,50,73,6885.23,13561.01,0.00
2024-12-10 17:26:20,122,10216,50,72,6933.92,13561.06,0.00
2024-12-10 17:26:20,122,10217,50,72,7028.89,13562.00,0.00
2024-12-10 17:26:20,123,10217,51,72,6971.75,13562.01,0.00
2024-12-10 17:26:20,122,10217,51,71,7021.14,13562.06,0.00
2024-12-10 17:26:20,122,10218,51,71,7004.95,13563.00,0.00
2024-12-10 17:26:20,123,10218,51,72,6948.00,13563.01,0.00
2024-12-10 17:26:20,122,10218,51,71,6997.20,13563.06,0.00
2024-12-10 17:26:20,122,10219,51,71,6981.01,13564.00,0.00
2024-12-10 17:26:20,123,10219,52,71,6924.25,13564.01,0.00
2024-12-10 17:26:20,122,10219,52,70,6973.25,13564.06,0.00
2024-12-10 17:26:20,122,10220,52,70,6957.06,13565.00,0.00
2024-12-10 17:26:20,123,10220,52,71,6900.50,13565.01,0.00
2024-12-10 17:26:20,122,10220,52,70,6949.30,13565.06,0.00
2024-12-10 17:26:20,122,10221,52,70,6933.11,13566.00,0.00
2024-12-10 17:26:20,123,10221,53,70,6876.74,13566.01,0.00
2024-12-10 17:26:20,122,10221,53,69,6925.35,13566.06,0.00
2024-12-10 17:26:20,123,10220,53,70,6811.80,13566.50,0.00
2024-12-10 17:26:20,123,10221,53,70,6912.55,13567.00,0.00
2024-12-10 17:26:20,124,10221,53,71,6856.80,13567.01,0.00
2024-12-10 17:26:20,123,10221,52,71,6911.45,13567.01,0.00
2024-12-10 17:26:20,122,10221,51,71,6961.45,13567.05,0.00
2024-12-10 17:26:20,121,10221,50,71,7017.86,13567.05,0.00
2024-12-10 17:26:20,121,10221,50,71,7113.66,13568.00,0.00
2024-12-10 17:26:20,122,10221,51,71,7055.35,13568.01,0.00
2024-12-10 17:26:20,121,10221,50,71,7106.96,13568.05,0.00
2024-12-10 17:26:20,121,10222,50,71,7090.64,13569.00,0.00
2024-12-10 17:26:20,122,10222,50,72,7032.52,13569.01,0.00
2024-12-10 17:26:20,121,10222,49,72,7083.94,13569.05,0.00
2024-12-10 17:26:20,121,10223,49,72,7067.61,13570.00,0.00
2024-12-10 17:26:20,122,10223,49,73,7009.68,13570.01,0.00
2024-12-10 17:26:20,121,10223,49,72,7060.90,13570.05,0.00
2024-12-10 17:26:20,121,10224,49,72,7044.58,13571.00,0.00
2024-12-10 17:26:20,122,10224,49,73,6986.84,13571.01,0.00
2024-12-10 17:26:20,121,10224,49,72,7037.87,13571.05,0.00
2024-12-10 17:26:20,121,10225,49,72,7021.54,13572.00,0.00
2024-12-10 17:26:20,122,10225,49,73,6963.99,13572.01,0.00
2024-12-10 17:26:20,121,10225,48,73,7014.83,13572.05,0.00
2024-12-10 17:26:20,121,10226,48,73,6998.50,13573.00,0.00
2024-12-10 17:26:20,122,10226,48,74,6941.14,13573.01,0.00
2024-12-10 17:26:20,121,10226,48,73,6991.80,13573.05,0.00
2024-12-10 17:26:20,121,10227,48,73,6975.46,13574.00,0.00
2024-12-10 17:26:20,122,10227,49,73,6918.29,13574.01,0.00
2024-12-10 17:26:20,121,10227,49,72,6968.75,13574.05,0.00
2024-12-10 17:26:20,121,10228,49,72,6952.42,13575.00,0.00
2024-12-10 17:26:20,122,10228,49,73,6895.43,13575.01,0.00
2024-12-10 17:26:20,121,10228,49,72,6945.71,13575.05,0.00
2024-12-10 17:26:20,121,10229,49,72,6929.36,13576.00,0.00
2024-12-10 17:26:20,122,10229,49,73,6872.57,13576.01,0.00
2024-12-10 17:26:20,121,10229,49,72,6922.65,13576.05,0.00
2024-12-10 17:26:20,121,10230,49,72,6906.31,13577.00,0.00
2024-12-10 17:26:20,122,10230,49,73,6849.70,13577.01,0.00
2024-12-10 17:26:20,121,10230,49,72,6899.60,13577.05,0.00
2024-12-10 17:26:20,121,10231,49,72,6883.26,13578.00,0.00
2024-12-10 17:26:20,122,10231,50,72,6826.84,13578.01,0.00
2024-12-10 17:26:20,121,10231,50,71,6876.54,13578.05,0.00
2024-12-10 17:26:20,121,10232,50,71,6860.20,13579.00,0.00
2024-12-10 17:26:20,122,10232,50,72,6803.96,13579.01,0.00
2024-12-10 17:26:20,121,10232,50,71,6853.48,13579.05,0.00
2024-12-10 17:26:20,120,10232,49,71,6909.46,13579.05,0.00
2024-12-10 17:26:20,120,10233,49,71,6894.11,13580.00,0.00
2024-12-10 17:26:20,121,10233,50,71,6837.13,13580.01,0.00
2024-12-10 17:26:20,120,10233,50,70,6887.34,13580.05,0.00
2024-12-10 17:26:20,120,10233,50,70,6871.98,13581.00,0.00
2024-12-10 17:26:20,121,10233,51,70,6815.19,13581.01,0.00
2024-12-10 17:26:20,120,10233,51,69,6865.21,13581.05,0.00
2024-12-10 17:26:20,121,10232,51,70,6769.24,13581.36,0.00
2024-12-10 17:26:20,121,10233,51,70,6810.08,13582.00,0.00
2024-12-10 17:26:20,122,10233,51,71,6754.26,13582.01,0.00
2024-12-10 17:26:20,121,10233,50,71,6803.36,13582.05,0.00
2024-12-10 17:26:20,122,10232,50,72,6651.03,13582.78,0.00
2024-12-10 17:26:20,122,10233,50,72,6869.43,13583.00,0.00
2024-12-10 17:26:20,123,10233,50,73,6813.58,13583.01,0.00
2024-12-10 17:26:20,122,10233,49,73,6862.77,13583.05,0.00
2024-12-10 17:26:21,122,10234,49,73,6956.79,13584.00,0.00
2024-12-10 17:26:21,123,10234,50,73,6900.23,13584.01,0.00
2024-12-10 17:26:21,122,10234,49,73,6950.12,13584.05,0.00
2024-12-10 17:26:21,122,10235,49,73,6932.80,13585.00,0.00
2024-12-10 17:26:21,123,10235,50,73,6876.44,13585.01,0.00
2024-12-10 17:26:21,122,10235,49,73,6926.14,13585.05,0.00
2024-12-10 17:26:21,122,10236,49,73,6908.81,13586.00,0.00
2024-12-10 17:26:21,123,10236,50,73,6852.64,13586.01,0.00
2024-12-10 17:26:21,122,10236,50,72,6902.15,13586.05,0.00
2024-12-10 17:26:21,122,10237,50,72,6884.82,13587.00,0.00
2024-12-10 17:26:21,123,10237,50,73,6828.84,13587.01,0.00
2024-12-10 17:26:21,122,10237,50,72,6878.15,13587.05,0.00
2024-12-10 17:26:21,121,10237,50,71,6933.87,13587.05,0.00
2024-12-10 17:26:21,121,10238,50,71,6917.52,13588.00,0.00
2024-12-10 17:26:21,122,10238,50,72,6860.82,13588.01,0.00
2024-12-10 17:26:21,121,10238,50,71,6910.80,13588.05,0.00
2024-12-10 17:26:21,121,10239,50,71,6894.45,13589.00,0.00
2024-12-10 17:26:21,122,10239,50,72,6837.94,13589.01,0.00
2024-12-10 17:26:21,121,10239,49,72,6887.73,13589.05,0.00
2024-12-10 17:26:21,121,10240,49,72,6871.37,13590.00,0.00
2024-12-10 17:26:21,122,10240,49,73,6815.05,13590.01,0.00
2024-12-10 17:26:21,121,10240,48,73,6864.65,13590.05,0.00
2024-12-10 17:26:21,121,10241,48,73,6848.29,13591.00,0.00
2024-12-10 17:26:21,122,10241,48,74,6792.15,13591.01,0.00
2024-12-10 17:26:21,121,10241,48,73,6841.56,13591.05,0.00
2024-12-10 17:26:21,122,10240,48,74,6739.88,13591.40,0.00
2024-12-10 17:26:21,122,10241,48,74,6840.56,13592.00,0.00
2024-12-10 17:26:21,123,10241,49,74,6784.95,13592.01,0.00
2024-12-10 17:26:21,122,10241,49,73,6833.89,13592.05,0.00
2024-12-10 17:26:21,122,10242,49,73,6927.97,13593.00,0.00
2024-12-10 17:26:21,123,10242,50,73,6871.64,13593.01,0.00
2024-12-10 17:26:21,122,10242,50,72,6921.30,13593.05,0.00
2024-12-10 17:26:21,121,10242,50,71,6977.37,13593.05,0.00
2024-12-10 17:26:21,121,10243,50,71,6961.02,13594.00,0.00
2024-12-10 17:26:21,122,10243,51,71,6903.96,13594.01,0.00
2024-12-10 17:26:21,121,10243,51,70,6954.29,13594.05,0.00
2024-12-10 17:26:21,121,10244,51,70,6937.94,13595.00,0.00
2024-12-10 17:26:21,122,10244,52,70,6881.07,13595.01,0.00
2024-12-10 17:26:21,121,10244,51,70,6931.21,13595.05,0.00
2024-12-10 17:26:21,121,10245,51,70,6914.85,13596.00,0.00
2024-12-10 17:26:21,122,10245,52,70,6858.18,13596.01,0.00
2024-12-10 17:26:21,121,10245,51,70,6908.13,13596.05,0.00
2024-12-10 17:26:21,122,10244,51,71,6799.22,13596.45,0.00
2024-12-10 17:26:21,122,10245,51,71,6901.03,13597.00,0.00
2024-12-10 17:26:21,123,10245,51,72,6844.92,13597.01,0.00
2024-12-10 17:26:21,122,10245,50,72,6894.35,13597.05,0.00
2024-12-10 17:26:21,122,10246,50,72,6988.48,13598.00,0.00
2024-12-10 17:26:21,123,10246,51,72,6931.66,13598.01,0.00
2024-12-10 17:26:21,122,10246,51,71,6981.80,13598.05,0.00
2024-12-10 17:26:21,122,10247,51,71,6964.47,13599.00,0.00
2024-12-10 17:26:21,123,10247,52,71,6907.85,13599.01,0.00
2024-12-10 17:26:21,122,10247,51,71,6957.79,13599.05,0.00
2024-12-10 17:26:21,123,10246,52,71,6863.69,13599.34,0.00
2024-12-10 17:26:21,124,10245,52,72,6802.15,13599.96,0.00
2024-12-10 17:26:21,124,10246,52,72,6910.77,13600.00,0.00
2024-12-10 17:26:21,125,10246,53,72,6855.49,13600.01,0.00
2024-12-10 17:26:21,124,10246,52,72,6904.20,13600.05,0.00
2024-12-10 17:26:21,124,10247,52,72,7104.32,13601.00,0.00
2024-12-10 17:26:21,125,10247,52,73,7047.49,13601.01,0.00
2024-12-10 17:26:21,124,10247,51,73,7097.75,13601.05,0.00
2024-12-10 17:26:21,124,10248,51,73,7078.52,13602.00,0.00
2024-12-10 17:26:21,125,10248,51,74,7021.89,13602.01,0.00
2024-12-10 17:26:21,124,10248,51,73,7071.95,13602.05,0.00
2024-12-10 17:26:21,124,10249,51,73,7052.71,13603.00,0.00
2024-12-10 17:26:21,125,10249,51,74,6996.29,13603.01,0.00
2024-12-10 17:26:21,124,10249,51,73,7046.14,13603.05,0.00
2024-12-10 17:26:21,124,10250,51,73,7026.90,13604.00,0.00
2024-12-10 17:26:21,125,10250,51,74,6970.68,13604.01,0.00
2024-12-10 17:26:21,124,10250,50,74,7020.33,13604.05,0.00
2024-12-10 17:26:21,123,10250,50,73,7076.30,13604.05,0.00
2024-12-10 17:26:21,124,10249,51,73,6942.63,13604.63,0.00
2024-12-10 17:26:21,124,10250,51,73,7044.97,13605.00,0.00
2024-12-10 17:26:21,125,10250,51,74,6988.61,13605.01,0.00
2024-12-10 17:26:21,125,10251,51,74,7071.85,13606.00,0.00
2024-12-10 17:26:21,126,10251,51,75,7015.72,13606.01,0.00
2024-12-10 17:26:21,125,10251,50,75,7064.24,13606.06,0.00
2024-12-10 17:26:21,126,10250,51,75,6925.26,13606.68,0.00
2024-12-10 17:26:21,126,10251,51,75,7025.96,13607.00,0.00
2024-12-10 17:26:21,127,10251,51,76,6970.64,13607.01,0.00
2024-12-10 17:26:21,126,10251,50,76,7020.57,13607.04,0.00
2024-12-10 17:26:21,125,10251,50,75,7074.56,13607.05,0.00
2024-12-10 17:26:21,124,10251,50,74,7130.51,13607.05,0.00
2024-12-10 17:26:22,124,10252,50,74,7221.02,13608.00,0.00
2024-12-10 17:26:22,125,10252,50,75,7163.25,13608.01,0.00
2024-12-10 17:26:22,124,10252,50,74,7214.44,13608.05,0.00
2024-12-10 17:26:22,124,10253,50,74,7195.21,13609.00,0.00
2024-12-10 17:26:22,125,10253,50,75,7137.64,13609.01,0.00
2024-12-10 17:26:22,124,10253,50,74,7188.63,13609.05,0.00
2024-12-10 17:26:22,124,10254,50,74,7169.39,13610.00,0.00
2024-12-10 17:26:22,125,10254,50,75,7112.04,13610.01,0.00
2024-12-10 17:26:22,124,10254,50,74,7162.82,13610.05,0.00
2024-12-10 17:26:22,124,10255,50,74,7143.57,13611.00,0.00
2024-12-10 17:26:22,125,10255,51,74,7086.43,13611.01,0.00
2024-12-10 17:26:22,124,10255,51,73,7137.00,13611.05,0.00
2024-12-10 17:26:22,125,10254,52,73,7053.81,13611.26,0.00
2024-12-10 17:26:22,125,10255,52,73,7118.53,13612.00,0.00
2024-12-10 17:26:22,126,10255,53,73,7062.03,13612.01,0.00
2024-12-10 17:26:22,125,10255,53,72,7112.00,13612.05,0.00
2024-12-10 17:26:22,125,10256,53,72,7200.73,13613.00,0.00
2024-12-10 17:26:22,126,10256,54,72,7143.58,13613.01,0.00
2024-12-10 17:26:22,125,10256,53,72,7193.12,13613.06,0.00
2024-12-10 17:26:22,125,10257,53,72,7174.03,13614.00,0.00
2024-12-10 17:26:22,126,10257,54,72,7117.09,13614.01,0.00
2024-12-10 17:26:22,125,10257,53,72,7169.68,13614.03,0.00
2024-12-10 17:26:22,124,10257,52,72,7224.22,13614.05,0.00
2024-12-10 17:26:22,123,10257,52,71,7281.84,13614.05,0.00
2024-12-10 17:26:22,123,10258,52,71,7263.54,13615.00,0.00
2024-12-10 17:26:22,124,10258,52,72,7204.97,13615.01,0.00
2024-12-10 17:26:22,123,10258,52,71,7256.92,13615.05,0.00
2024-12-10 17:26:22,123,10259,52,71,7238.62,13616.00,0.00
2024-12-10 17:26:22,124,10259,52,72,7180.24,13616.01,0.00
2024-12-10 17:26:22,125,10258,53,72,7120.62,13616.04,0.00
2024-12-10 17:26:22,124,10258,53,71,7275.79,13616.06,0.00
2024-12-10 17:26:22,124,10259,53,71,7257.64,13617.00,0.00
2024-12-10 17:26:22,125,10259,54,71,7199.58,13617.01,0.00
2024-12-10 17:26:22,124,10259,54,70,7251.07,13617.05,0.00
2024-12-10 17:26:22,124,10260,54,70,7341.63,13618.00,0.00
2024-12-10 17:26:22,125,10260,55,70,7282.90,13618.01,0.00
2024-12-10 17:26:22,124,10260,54,70,7335.06,13618.05,0.00
2024-12-10 17:26:22,124,10261,54,70,7315.81,13619.00,0.00
2024-12-10 17:26:22,125,10261,54,71,7257.29,13619.01,0.00
2024-12-10 17:26:22,124,10261,53,71,7309.25,13619.05,0.00
2024-12-10 17:26:22,124,10262,53,71,7289.99,13620.00,0.00
2024-12-10 17:26:22,125,10262,53,72,7231.67,13620.01,0.00
2024-12-10 17:26:22,124,10262,53,71,7283.42,13620.05,0.00
2024-12-10 17:26:22,124,10263,53,71,7264.16,13621.00,0.00
2024-12-10 17:26:22,125,10263,53,72,7206.05,13621.01,0.00
2024-12-10 17:26:22,124,10263,52,72,7257.59,13621.05,0.00
2024-12-10 17:26:22,124,10264,52,72,7238.33,13622.00,0.00
2024-12-10 17:26:22,125,10264,52,73,7180.42,13622.01,0.00
2024-12-10 17:26:22,124,10264,52,72,7231.76,13622.05,0.00
2024-12-10 17:26:22,124,10265,52,72,7212.50,13623.00,0.00
2024-12-10 17:26:22,125,10265,52,73,7154.79,13623.01,0.00
2024-12-10 17:26:22,124,10265,51,73,7205.92,13623.05,0.00
2024-12-10 17:26:22,123,10265,51,72,7263.40,13623.05,0.00
2024-12-10 17:26:22,123,10266,51,72,7245.08,13624.00,0.00
2024-12-10 17:26:22,124,10266,52,72,7186.66,13624.01,0.00
2024-12-10 17:26:22,123,10266,52,71,7238.46,13624.05,0.00
2024-12-10 17:26:22,123,10267,52,71,7220.14,13625.00,0.00
2024-12-10 17:26:22,124,10267,52,72,7161.92,13625.01,0.00
2024-12-10 17:26:22,124,10268,52,72,7137.16,13626.00,0.00
2024-12-10 17:26:22,125,10268,53,72,7080.06,13626.01,0.00
2024-12-10 17:26:22,124,10268,52,72,7129.49,13626.06,0.00
2024-12-10 17:26:22,124,10269,52,72,7111.31,13627.00,0.00
2024-12-10 17:26:22,125,10269,53,72,7054.42,13627.01,0.00
2024-12-10 17:26:22,125,10270,53,72,7028.77,13628.00,0.00
2024-12-10 17:26:22,126,10270,53,73,6972.99,13628.01,0.00
2024-12-10 17:26:22,125,10270,52,73,7020.07,13628.06,0.00
2024-12-10 17:26:22,125,10271,52,73,7002.03,13629.00,0.00
2024-12-10 17:26:22,126,10271,53,73,6946.46,13629.01,0.00
2024-12-10 17:26:22,126,10272,53,73,6919.93,13630.00,0.00
2024-12-10 17:26:22,127,10272,54,73,6865.44,13630.01,0.00
2024-12-10 17:26:22,126,10272,53,73,6910.22,13630.07,0.00
2024-12-10 17:26:22,126,10273,53,73,6892.30,13631.00,0.00
2024-12-10 17:26:22,127,10273,53,74,6838.03,13631.01,0.00
2024-12-10 17:26:22,126,10273,53,73,6882.59,13631.07,0.00
2024-12-10 17:26:22,126,10274,53,73,6864.68,13632.00,0.00
2024-12-10 17:26:22,127,10274,54,73,6810.63,13632.01,0.00
2024-12-10 17:26:23,126,10274,53,73,6854.97,13632.07,0.00
2024-12-10 17:26:23,127,10273,54,73,6792.42,13632.15,0.00
2024-12-10 17:26:23,127,10274,54,73,6883.05,13633.00,0.00
2024-12-10 17:26:23,128,10274,55,73,6829.28,13633.01,0.00
2024-12-10 17:26:23,127,10274,54,73,6872.35,13633.08,0.00
2024-12-10 17:26:23,128,10273,55,73,6730.51,13633.74,0.00
2024-12-10 17:26:23,128,10274,55,73,6938.42,13634.00,0.00
2024-12-10 17:26:23,129,10274,56,73,6884.64,13634.01,0.00
2024-12-10 17:26:23,130,10273,56,74,6733.38,13634.75,0.00
2024-12-10 17:26:23,130,10274,56,74,6938.11,13635.00,0.00
2024-12-10 17:26:23,131,10274,56,75,6885.15,13635.01,0.00
2024-12-10 17:26:23,130,10274,56,74,6926.60,13635.08,0.00
2024-12-10 17:26:23,131,10273,57,74,6870.61,13635.12,0.00
2024-12-10 17:26:23,132,10272,58,74,6802.49,13635.98,0.00
2024-12-10 17:26:23,132,10273,58,74,7008.07,13636.00,0.00
2024-12-10 17:26:23,133,10273,59,74,6955.38,13636.01,0.00
2024-12-10 17:26:23,132,10273,58,74,7001.89,13636.05,0.00
2024-12-10 17:26:23,131,10273,57,74,7050.15,13636.08,0.00
2024-12-10 17:26:23,130,10273,57,73,7103.33,13636.08,0.00
2024-12-10 17:26:23,130,10274,57,73,7292.64,13637.00,0.00
2024-12-10 17:26:23,131,10274,58,73,7236.97,13637.01,0.00
2024-12-10 17:26:23,131,10275,58,73,7206.27,13638.00,0.00
2024-12-10 17:26:23,132,10275,58,74,7151.68,13638.01,0.00
2024-12-10 17:26:23,132,10276,58,74,7120.17,13639.00,0.00
2024-12-10 17:26:23,133,10276,59,74,7066.64,13639.01,0.00
2024-12-10 17:26:23,133,10277,59,74,7034.34,13640.00,0.00
2024-12-10 17:26:23,134,10277,59,75,6981.84,13640.01,0.00
2024-12-10 17:26:23,133,10277,58,75,7032.29,13640.01,0.00
2024-12-10 17:26:23,132,10277,58,74,7074.24,13640.09,0.00
2024-12-10 17:26:23,131,10277,58,73,7127.20,13640.09,0.00
2024-12-10 17:26:23,131,10278,58,73,7107.89,13641.00,0.00
2024-12-10 17:26:23,132,10278,59,73,7054.05,13641.01,0.00
2024-12-10 17:26:23,131,10278,58,73,7095.44,13641.09,0.00
2024-12-10 17:26:23,131,10279,58,73,7076.13,13642.00,0.00
2024-12-10 17:26:23,132,10279,58,74,7022.53,13642.01,0.00
2024-12-10 17:26:23,131,10279,58,73,7063.68,13642.09,0.00
2024-12-10 17:26:23,131,10280,58,73,7044.37,13643.00,0.00
2024-12-10 17:26:23,132,10280,58,74,6991.00,13643.01,0.00
2024-12-10 17:26:23,131,10280,58,73,7031.91,13643.09,0.00
2024-12-10 17:26:23,131,10281,58,73,7012.60,13644.00,0.00
2024-12-10 17:26:23,132,10281,59,73,6959.47,13644.01,0.00
2024-12-10 17:26:23,131,10281,58,73,7000.14,13644.09,0.00
2024-12-10 17:26:23,131,10282,58,73,6980.82,13645.00,0.00
2024-12-10 17:26:23,132,10282,59,73,6927.93,13645.01,0.00
2024-12-10 17:26:23,131,10282,58,73,6968.36,13645.09,0.00
2024-12-10 17:26:23,131,10283,58,73,6949.04,13646.00,0.00
2024-12-10 17:26:23,132,10283,58,74,6896.39,13646.01,0.00
2024-12-10 17:26:23,131,10283,58,73,6936.58,13646.09,0.00
2024-12-10 17:26:23,131,10284,58,73,6917.25,13647.00,0.00
2024-12-10 17:26:23,132,10284,59,73,6864.85,13647.01,0.00
2024-12-10 17:26:23,131,10284,59,72,6904.79,13647.09,0.00
2024-12-10 17:26:23,131,10285,59,72,6885.46,13648.00,0.00
2024-12-10 17:26:23,132,10285,60,72,6833.30,13648.01,0.00
2024-12-10 17:26:23,131,10285,60,71,6884.42,13648.01,0.00
2024-12-10 17:26:23,130,10285,59,71,6925.87,13648.08,0.00
2024-12-10 17:26:23,129,10285,59,70,6978.50,13648.08,0.00
2024-12-10 17:26:23,129,10286,59,70,6959.93,13649.00,0.00
2024-12-10 17:26:23,130,10286,59,71,6906.39,13649.01,0.00
2024-12-10 17:26:23,129,10286,59,70,6952.54,13649.05,0.00
2024-12-10 17:26:23,128,10286,59,69,7002.61,13649.08,0.00
2024-12-10 17:26:23,127,10286,59,68,7056.67,13649.08,0.00
2024-12-10 17:26:23,127,10287,59,68,7038.89,13650.00,0.00
2024-12-10 17:26:23,128,10287,60,68,6983.89,13650.01,0.00
2024-12-10 17:26:23,127,10287,60,67,7028.17,13650.08,0.00
2024-12-10 17:26:23,127,10288,60,67,7010.37,13651.00,0.00
2024-12-10 17:26:23,128,10288,61,67,6955.60,13651.01,0.00
2024-12-10 17:26:23,127,10288,61,66,6999.66,13651.08,0.00
2024-12-10 17:26:23,127,10289,61,66,6981.86,13652.00,0.00
2024-12-10 17:26:23,128,10289,62,66,6927.32,13652.01,0.00
2024-12-10 17:26:23,127,10289,62,65,6971.15,13652.08,0.00
2024-12-10 17:26:23,127,10290,62,65,6953.35,13653.00,0.00
2024-12-10 17:26:23,128,10290,63,65,6899.03,13653.01,0.00
2024-12-10 17:26:23,127,10290,63,64,6942.64,13653.08,0.00
2024-12-10 17:26:23,127,10291,63,64,6924.83,13654.00,0.00
2024-12-10 17:26:23,128,10291,63,65,6870.73,13654.01,0.00
2024-12-10 17:26:23,129,10290,64,65,6811.14,13654.07,0.00
2024-12-10 17:26:23,128,10290,64,64,6921.97,13654.09,0.00
2024-12-10 17:26:23,128,10291,64,64,6904.31,13655.00,0.00
2024-12-10 17:26:23,129,10291,65,64,6850.78,13655.01,0.00
2024-12-10 17:26:23,128,10291,65,63,6893.68,13655.08,0.00
2024-12-10 17:26:23,129,10290,66,63,6813.80,13655.29,0.00
2024-12-10 17:26:23,129,10291,66,63,7009.02,13656.00,0.00
2024-12-10 17:26:23,130,10291,67,63,6955.10,13656.01,0.00
2024-12-10 17:26:23,129,10291,66,63,6998.47,13656.08,0.00
2024-12-10 17:26:24,129,10292,66,63,7084.70,13657.00,0.00
2024-12-10 17:26:24,130,10292,66,64,7030.20,13657.01,0.00
2024-12-10 17:26:24,129,10292,65,64,7074.15,13657.08,0.00
2024-12-10 17:26:24,129,10293,65,64,7054.51,13658.00,0.00
2024-12-10 17:26:24,130,10293,65,65,7000.25,13658.01,0.00
2024-12-10 17:26:24,129,10293,65,64,7042.90,13658.08,0.00
2024-12-10 17:26:24,129,10294,65,64,7024.32,13659.00,0.00
2024-12-10 17:26:24,130,10294,66,64,6970.29,13659.01,0.00
2024-12-10 17:26:24,129,10294,65,64,7012.71,13659.08,0.00
2024-12-10 17:26:24,129,10295,65,64,6994.13,13660.00,0.00
2024-12-10 17:26:24,130,10295,66,64,6940.33,13660.01,0.00
2024-12-10 17:26:24,129,10295,65,64,6992.01,13660.02,0.00
2024-12-10 17:26:24,128,10295,64,64,7037.06,13660.08,0.00
2024-12-10 17:26:24,127,10295,63,64,7091.40,13660.08,0.00
2024-12-10 17:26:24,127,10296,63,64,7073.60,13661.00,0.00
2024-12-10 17:26:24,128,10296,63,65,7018.33,13661.01,0.00
2024-12-10 17:26:24,127,10296,63,64,7062.87,13661.08,0.00
2024-12-10 17:26:24,127,10297,63,64,7045.07,13662.00,0.00
2024-12-10 17:26:24,128,10297,63,65,6990.03,13662.01,0.00
2024-12-10 17:26:24,127,10297,62,65,7034.35,13662.08,0.00
2024-12-10 17:26:24,127,10298,62,65,7016.54,13663.00,0.00
2024-12-10 17:26:24,128,10298,63,65,6961.72,13663.01,0.00
2024-12-10 17:26:24,127,10298,63,64,7005.81,13663.08,0.00
2024-12-10 17:26:24,127,10299,63,64,6988.00,13664.00,0.00
2024-12-10 17:26:24,128,10299,64,64,6933.41,13664.01,0.00
2024-12-10 17:26:24,128,10300,64,64,6905.09,13665.00,0.00
2024-12-10 17:26:24,129,10300,65,64,6851.56,13665.01,0.00
2024-12-10 17:26:24,128,10300,65,63,6893.38,13665.09,0.00
2024-12-10 17:26:24,128,10301,65,63,6875.70,13666.00,0.00
2024-12-10 17:26:24,129,10301,66,63,6822.40,13666.01,0.00
2024-12-10 17:26:24,128,10301,65,63,6863.99,13666.09,0.00
2024-12-10 17:26:24,127,10301,65,62,6916.96,13666.09,0.00
2024-12-10 17:26:24,127,10302,65,62,6900.22,13667.00,0.00
2024-12-10 17:26:24,128,10302,65,63,6846.31,13667.01,0.00
2024-12-10 17:26:24,127,10302,65,62,6888.41,13667.09,0.00
2024-12-10 17:26:24,127,10303,65,62,6871.66,13668.00,0.00
2024-12-10 17:26:24,128,10303,65,63,6817.98,13668.01,0.00
2024-12-10 17:26:24,127,10303,64,63,6859.86,13668.09,0.00
2024-12-10 17:26:24,127,10304,64,63,6843.11,13669.00,0.00
2024-12-10 17:26:24,128,10304,64,64,6789.64,13669.01,0.00
2024-12-10 17:26:24,127,10304,64,63,6831.30,13669.09,0.00
2024-12-10 17:26:24,127,10305,64,63,6814.54,13670.00,0.00
2024-12-10 17:26:24,128,10305,65,63,6761.31,13670.01,0.00
2024-12-10 17:26:24,127,10305,65,62,6802.74,13670.09,0.00
2024-12-10 17:26:24,127,10306,65,62,6785.98,13671.00,0.00
2024-12-10 17:26:24,128,10306,66,62,6732.96,13671.01,0.00
2024-12-10 17:26:24,127,10306,66,61,6774.17,13671.09,0.00
2024-12-10 17:26:24,127,10307,66,61,6757.41,13672.00,0.00
2024-12-10 17:26:24,128,10307,67,61,6704.61,13672.01,0.00
2024-12-10 17:26:24,128,10308,67,61,6676.26,13673.00,0.00
2024-12-10 17:26:24,129,10308,68,61,6624.51,13673.01,0.00
2024-12-10 17:26:24,128,10308,68,60,6663.48,13673.09,0.00
2024-12-10 17:26:24,128,10309,68,60,6646.84,13674.00,0.00
2024-12-10 17:26:24,129,10309,69,60,6595.32,13674.01,0.00
2024-12-10 17:26:24,128,10309,68,60,6634.05,13674.09,0.00
2024-12-10 17:26:24,128,10310,68,60,6617.42,13675.00,0.00
2024-12-10 17:26:24,129,10310,68,61,6566.12,13675.01,0.00
2024-12-10 17:26:24,128,10310,68,60,6604.63,13675.09,0.00
2024-12-10 17:26:24,128,10311,68,60,6587.98,13676.00,0.00
2024-12-10 17:26:24,129,10311,69,60,6536.91,13676.01,0.00
2024-12-10 17:26:24,128,10311,69,59,6575.19,13676.09,0.00
2024-12-10 17:26:24,128,10312,69,59,6558.54,13677.00,0.00
2024-12-10 17:26:24,129,10312,69,60,6507.70,13677.01,0.00
2024-12-10 17:26:24,128,10312,69,59,6545.75,13677.09,0.00
2024-12-10 17:26:24,128,10313,69,59,6529.10,13678.00,0.00
2024-12-10 17:26:24,129,10313,69,60,6478.49,13678.01,0.00
2024-12-10 17:26:24,129,10314,69,60,6449.27,13679.00,0.00
2024-12-10 17:26:24,130,10314,70,60,6399.66,13679.01,0.00
2024-12-10 17:26:24,129,10314,70,59,6435.52,13679.10,0.00
2024-12-10 17:26:24,129,10315,70,59,6418.99,13680.00,0.00
2024-12-10 17:26:24,130,10315,71,59,6369.61,13680.01,0.00
2024-12-10 17:26:24,131,10314,71,60,6311.61,13680.09,0.00
2024-12-10 17:26:24,130,10314,70,60,6435.95,13680.11,0.00
2024-12-10 17:26:24,130,10315,70,60,6419.54,13681.00,0.00
2024-12-10 17:26:24,131,10315,70,61,6370.54,13681.01,0.00
2024-12-10 17:26:24,130,10315,70,60,6417.44,13681.02,0.00
2024-12-10 17:26:24,131,10314,71,60,6363.24,13681.07,0.00
2024-12-10 17:26:25,130,10314,70,60,6457.47,13681.10,0.00
2024-12-10 17:26:25,129,10314,70,59,6506.46,13681.10,0.00
2024-12-10 17:26:25,129,10314,70,59,6595.99,13682.00,0.00
2024-12-10 17:26:25,130,10314,71,59,6545.25,13682.01,0.00
2024-12-10 17:26:25,129,10314,71,58,6587.53,13682.06,0.00
2024-12-10 17:26:25,128,10314,71,57,6634.74,13682.09,0.00
2024-12-10 17:26:25,127,10314,71,56,6685.90,13682.09,0.00
2024-12-10 17:26:25,128,10313,72,56,6565.40,13682.60,0.00
2024-12-10 17:26:25,128,10314,72,56,6774.15,13683.00,0.00
2024-12-10 17:26:25,129,10314,72,57,6721.64,13683.01,0.00
2024-12-10 17:26:25,130,10313,72,58,6669.93,13683.02,0.00
2024-12-10 17:26:25,129,10313,72,57,6781.08,13683.09,0.00
2024-12-10 17:26:25,129,10314,72,57,6869.58,13684.00,0.00
2024-12-10 17:26:25,130,10314,72,58,6816.73,13684.01,0.00
2024-12-10 17:26:25,129,10314,71,58,6857.95,13684.08,0.00
2024-12-10 17:26:25,129,10315,71,58,6945.40,13685.00,0.00
2024-12-10 17:26:25,130,10315,71,59,6891.97,13685.01,0.00
2024-12-10 17:26:25,129,10315,70,59,6933.77,13685.08,0.00
2024-12-10 17:26:25,129,10316,70,59,6915.14,13686.00,0.00
2024-12-10 17:26:25,130,10316,70,60,6861.94,13686.01,0.00
2024-12-10 17:26:25,129,10316,69,60,6903.51,13686.08,0.00
2024-12-10 17:26:25,130,10315,69,61,6786.32,13686.57,0.00
2024-12-10 17:26:25,130,10316,69,61,6885.61,13687.00,0.00
2024-12-10 17:26:25,131,10316,70,61,6833.05,13687.01,0.00
2024-12-10 17:26:25,130,10316,70,60,6874.07,13687.08,0.00
2024-12-10 17:26:25,130,10317,70,60,6959.82,13688.00,0.00
2024-12-10 17:26:25,131,10317,70,61,6906.69,13688.01,0.00
2024-12-10 17:26:25,130,10317,70,60,6948.27,13688.08,0.00
2024-12-10 17:26:25,130,10318,70,60,6928.74,13689.00,0.00
2024-12-10 17:26:25,131,10318,70,61,6875.85,13689.01,0.00
2024-12-10 17:26:25,130,10318,70,60,6917.19,13689.08,0.00
2024-12-10 17:26:25,131,10317,71,60,6792.45,13689.63,0.00
2024-12-10 17:26:25,131,10318,71,60,6889.93,13690.00,0.00
2024-12-10 17:26:25,132,10318,72,60,6837.74,13690.01,0.00
2024-12-10 17:26:25,131,10318,72,59,6878.48,13690.08,0.00
2024-12-10 17:26:25,131,10319,72,59,6962.55,13691.00,0.00
2024-12-10 17:26:25,132,10319,73,59,6909.80,13691.01,0.00
2024-12-10 17:26:25,131,10319,72,59,6960.46,13691.02,0.00
2024-12-10 17:26:25,130,10319,72,58,7004.56,13691.08,0.00
2024-12-10 17:26:25,129,10319,72,57,7057.80,13691.08,0.00
2024-12-10 17:26:25,129,10320,72,57,7038.11,13692.00,0.00
2024-12-10 17:26:25,130,10320,72,58,6983.97,13692.01,0.00
2024-12-10 17:26:25,129,10320,71,58,7027.53,13692.08,0.00
2024-12-10 17:26:25,130,10319,72,58,6958.73,13692.20,0.00
2024-12-10 17:26:25,130,10320,72,58,7013.68,13693.00,0.00
2024-12-10 17:26:25,131,10320,73,58,6960.14,13693.01,0.00
2024-12-10 17:26:25,130,10320,72,58,7003.18,13693.08,0.00
2024-12-10 17:26:25,130,10321,72,58,7081.99,13694.00,0.00
2024-12-10 17:26:25,131,10321,73,58,7027.93,13694.01,0.00
2024-12-10 17:26:25,131,10322,73,58,6987.62,13695.00,0.00
2024-12-10 17:26:25,132,10322,74,58,6934.68,13695.01,0.00
2024-12-10 17:26:25,131,10322,73,58,6976.15,13695.08,0.00
2024-12-10 17:26:25,131,10323,73,58,6943.51,13696.00,0.00
2024-12-10 17:26:25,132,10323,73,59,6890.91,13696.01,0.00
2024-12-10 17:26:25,131,10323,72,59,6932.04,13696.08,0.00
2024-12-10 17:26:25,130,10323,72,58,6984.31,13696.08,0.00
2024-12-10 17:26:25,130,10324,72,58,6949.64,13697.00,0.00
2024-12-10 17:26:25,131,10324,72,59,6896.58,13697.01,0.00
2024-12-10 17:26:25,130,10324,72,58,6938.08,13697.08,0.00
2024-12-10 17:26:25,130,10325,72,58,6899.26,13698.00,0.00
2024-12-10 17:26:25,131,10325,73,58,6846.60,13698.01,0.00
2024-12-10 17:26:25,130,10325,72,58,6887.70,13698.08,0.00
2024-12-10 17:26:25,131,10324,73,58,6757.94,13698.66,0.00
2024-12-10 17:26:25,131,10325,73,58,6831.87,13699.00,0.00
2024-12-10 17:26:25,132,10325,74,58,6780.11,13699.01,0.00
2024-12-10 17:26:25,131,10325,74,57,6829.78,13699.02,0.00
2024-12-10 17:26:25,130,10325,73,57,6873.91,13699.07,0.00
2024-12-10 17:26:25,129,10325,72,57,6926.14,13699.07,0.00
2024-12-10 17:26:25,128,10325,71,57,6979.18,13699.07,0.00
2024-12-10 17:26:25,127,10325,71,56,7033.05,13699.07,0.00
2024-12-10 17:26:25,127,10326,71,56,7091.65,13700.00,0.00
2024-12-10 17:26:25,128,10326,71,57,7036.25,13700.01,0.00
2024-12-10 17:26:25,127,10326,70,57,7081.97,13700.07,0.00
2024-12-10 17:26:25,126,10326,70,56,7030.22,13700.85,0.00
2024-12-10 17:26:25,126,10327,70,56,7098.81,13701.00,0.00
2024-12-10 17:26:25,127,10327,70,57,7042.91,13701.01,0.00
2024-12-10 17:26:25,126,10327,70,56,7089.05,13701.07,0.00
2024-12-10 17:26:25,127,10326,70,57,6924.64,13701.88,0.00
2024-12-10 17:26:25,127,10327,70,57,7005.68,13702.00,0.00
2024-12-10 17:26:25,128,10327,71,57,6950.95,13702.01,0.00
2024-12-10 17:26:25,127,10327,71,56,6996.00,13702.07,0.00
2024-12-10 17:26:25,127,10328,71,56,7057.74,13703.00,0.00
2024-12-10 17:26:25,128,10328,71,57,7002.60,13703.01,0.00
2024-12-10 17:26:25,127,10328,71,56,7048.06,13703.07,0.00
2024-12-10 17:26:25,127,10328,71,56,6999.10,13704.00,0.00
2024-12-10 17:26:25,128,10328,71,57,6944.41,13704.01,0.00
2024-12-10 17:26:25,127,10328,70,57,6988.34,13704.08,0.00
2024-12-10 17:26:26,127,10329,70,57,6939.59,13705.00,0.00
2024-12-10 17:26:26,128,10329,70,58,6885.37,13705.01,0.00
2024-12-10 17:26:26,127,10329,69,58,6795.76,13705.87,0.00
2024-12-10 17:26:26,127,10330,69,58,6880.42,13706.00,0.00
2024-12-10 17:26:26,128,10330,70,58,6826.66,13706.01,0.00
2024-12-10 17:26:26,127,10330,70,57,6872.89,13706.05,0.00
2024-12-10 17:26:26,126,10330,70,56,6923.09,13706.08,0.00
2024-12-10 17:26:26,125,10330,69,56,6977.38,13706.08,0.00
2024-12-10 17:26:26,124,10330,69,55,6925.84,13706.85,0.00
2024-12-10 17:26:26,124,10331,69,55,7008.54,13707.00,0.00
2024-12-10 17:26:26,125,10331,69,56,6952.47,13707.01,0.00
2024-12-10 17:26:26,124,10331,69,55,6997.52,13707.08,0.00
2024-12-10 17:26:26,124,10332,69,55,6975.70,13708.00,0.00
2024-12-10 17:26:26,125,10332,70,55,6919.90,13708.01,0.00
2024-12-10 17:26:26,124,10332,70,54,6964.68,13708.08,0.00
2024-12-10 17:26:26,125,10331,70,55,6899.10,13708.17,0.00
2024-12-10 17:26:26,125,10332,70,55,6988.85,13709.00,0.00
2024-12-10 17:26:26,126,10332,71,55,6933.38,13709.01,0.00
2024-12-10 17:26:26,125,10332,71,54,6977.92,13709.08,0.00
2024-12-10 17:26:26,125,10333,71,54,7066.15,13710.00,0.00
2024-12-10 17:26:26,126,10333,72,54,7010.07,13710.01,0.00
2024-12-10 17:26:26,125,10333,72,53,7055.21,13710.08,0.00
2024-12-10 17:26:26,125,10334,72,53,7035.38,13711.00,0.00
2024-12-10 17:26:26,126,10334,72,54,6979.54,13711.01,0.00
2024-12-10 17:26:26,125,10334,71,54,7033.19,13711.02,0.00
2024-12-10 17:26:26,124,10334,70,54,7081.09,13711.07,0.00
2024-12-10 17:26:26,123,10334,69,54,7137.55,13711.07,0.00
2024-12-10 17:26:26,123,10335,69,54,7121.54,13712.00,0.00
2024-12-10 17:26:26,124,10335,70,54,7064.10,13712.01,0.00
2024-12-10 17:26:26,123,10335,69,54,7111.54,13712.07,0.00
2024-12-10 17:26:26,124,10334,70,54,7005.62,13712.44,0.00
2024-12-10 17:26:26,124,10335,70,54,7106.64,13713.00,0.00
2024-12-10 17:26:26,125,10335,70,55,7049.79,13713.01,0.00
2024-12-10 17:26:26,124,10335,69,55,7096.72,13713.07,0.00
2024-12-10 17:26:26,125,10334,69,56,7035.57,13713.12,0.00
2024-12-10 17:26:26,125,10335,69,56,7239.01,13714.00,0.00
2024-12-10 17:26:26,126,10335,70,56,7181.56,13714.01,0.00
2024-12-10 17:26:26,127,10334,70,57,7121.78,13714.05,0.00
2024-12-10 17:26:26,126,10334,69,57,7207.71,13714.08,0.00
2024-12-10 17:26:26,126,10335,69,57,7299.64,13715.00,0.00
2024-12-10 17:26:26,127,10335,70,57,7242.16,13715.01,0.00
2024-12-10 17:26:26,128,10334,70,58,7180.25,13715.06,0.00
2024-12-10 17:26:26,127,10334,70,57,7297.27,13715.08,0.00
2024-12-10 17:26:26,127,10335,70,57,7387.41,13716.00,0.00
2024-12-10 17:26:26,128,10335,70,58,7329.69,13716.01,0.00
2024-12-10 17:26:26,127,10335,70,57,7377.73,13716.07,0.00
2024-12-10 17:26:26,128,10334,70,58,7319.02,13716.09,0.00
2024-12-10 17:26:26,128,10335,70,58,7411.67,13717.00,0.00
2024-12-10 17:26:26,129,10335,70,59,7354.22,13717.01,0.00
2024-12-10 17:26:26,129,10336,70,59,7431.32,13718.00,0.00
2024-12-10 17:26:26,130,10336,70,60,7374.15,13718.01,0.00
2024-12-10 17:26:26,129,10336,69,60,7419.67,13718.08,0.00
2024-12-10 17:26:26,129,10337,69,60,7401.02,13719.00,0.00
2024-12-10 17:26:26,130,10337,69,61,7344.09,13719.01,0.00
2024-12-10 17:26:26,129,10337,69,60,7389.37,13719.08,0.00
2024-12-10 17:26:26,129,10338,69,60,7370.72,13720.00,0.00
2024-12-10 17:26:26,130,10338,69,61,7314.02,13720.01,0.00
2024-12-10 17:26:26,129,10338,69,60,7359.07,13720.08,0.00
2024-12-10 17:26:26,129,10339,69,60,7340.41,13721.00,0.00
2024-12-10 17:26:26,130,10339,70,60,7283.94,13721.01,0.00
2024-12-10 17:26:26,129,10339,70,59,7328.76,13721.08,0.00
2024-12-10 17:26:26,129,10340,70,59,7310.09,13722.00,0.00
2024-12-10 17:26:26,130,10340,71,59,7253.86,13722.01,0.00
2024-12-10 17:26:26,129,10340,71,58,7298.44,13722.08,0.00
2024-12-10 17:26:26,129,10341,71,58,7279.78,13723.00,0.00
2024-12-10 17:26:26,130,10341,71,59,7223.78,13723.01,0.00
2024-12-10 17:26:26,129,10341,71,58,7268.12,13723.08,0.00
2024-12-10 17:26:26,129,10342,71,58,7249.46,13724.00,0.00
2024-12-10 17:26:26,130,10342,71,59,7193.69,13724.01,0.00
2024-12-10 17:26:26,129,10342,70,59,7237.80,13724.08,0.00
2024-12-10 17:26:26,129,10343,70,59,7219.13,13725.00,0.00
2024-12-10 17:26:26,130,10343,71,59,7163.60,13725.01,0.00
2024-12-10 17:26:26,129,10343,71,58,7207.47,13725.08,0.00
2024-12-10 17:26:26,129,10344,71,58,7188.80,13726.00,0.00
2024-12-10 17:26:26,130,10344,72,58,7133.50,13726.01,0.00
2024-12-10 17:26:26,129,10344,71,58,7177.14,13726.08,0.00
2024-12-10 17:26:26,129,10345,71,58,7158.46,13727.00,0.00
2024-12-10 17:26:26,130,10345,72,58,7103.40,13727.01,0.00
2024-12-10 17:26:26,129,10345,71,58,7146.80,13727.08,0.00
2024-12-10 17:26:26,129,10346,71,58,7128.12,13728.00,0.00
2024-12-10 17:26:26,130,10346,71,59,7073.29,13728.01,0.00
2024-12-10 17:26:26,129,10346,71,58,7116.46,13728.08,0.00
2024-12-10 17:26:27,129,10347,71,58,7097.78,13729.00,0.00
2024-12-10 17:26:27,130,10347,71,59,7043.18,13729.01,0.00
2024-12-10 17:26:27,129,10347,70,59,7086.11,13729.08,0.00
2024-12-10 17:26:27,129,10348,70,59,7067.43,13730.00,0.00
2024-12-10 17:26:27,130,10348,71,59,7013.06,13730.01,0.00
2024-12-10 17:26:27,129,10348,70,59,7055.76,13730.08,0.00
2024-12-10 17:26:27,129,10349,70,59,7037.08,13731.00,0.00
2024-12-10 17:26:27,130,10349,71,59,6982.94,13731.01,0.00
2024-12-10 17:26:27,129,10349,71,58,7025.41,13731.08,0.00
2024-12-10 17:26:27,129,10350,71,58,7002.51,13732.00,0.00
2024-12-10 17:26:27,130,10350,71,59,6948.65,13732.01,0.00
2024-12-10 17:26:27,129,10350,70,59,6990.84,13732.08,0.00
2024-12-10 17:26:27,128,10350,69,59,7044.39,13732.09,0.00
2024-12-10 17:26:27,128,10351,69,59,7015.41,13733.00,0.00
2024-12-10 17:26:27,129,10351,70,59,6961.03,13733.01,0.00
2024-12-10 17:26:27,128,10351,69,59,7003.65,13733.09,0.00
2024-12-10 17:26:27,128,10352,69,59,6967.88,13734.00,0.00
2024-12-10 17:26:27,129,10352,69,60,6913.87,13734.01,0.00
2024-12-10 17:26:27,128,10352,69,59,6959.32,13734.06,0.00
2024-12-10 17:26:27,127,10352,68,59,7009.81,13734.09,0.00
2024-12-10 17:26:27,126,10352,68,58,7064.35,13734.09,0.00
2024-12-10 17:26:27,126,10353,68,58,7028.04,13735.00,0.00
2024-12-10 17:26:27,127,10353,69,58,6972.70,13735.01,0.00
2024-12-10 17:26:27,126,10353,69,57,7024.77,13735.02,0.00
2024-12-10 17:26:27,125,10353,68,57,7073.31,13735.07,0.00
2024-12-10 17:26:27,124,10353,68,56,7129.25,13735.07,0.00
2024-12-10 17:26:27,124,10354,68,56,7091.19,13736.00,0.00
2024-12-10 17:26:27,125,10354,68,57,7034.46,13736.01,0.00
2024-12-10 17:26:27,124,10354,67,57,7079.05,13736.09,0.00
2024-12-10 17:26:27,123,10354,66,57,7028.26,13736.80,0.00
2024-12-10 17:26:27,123,10355,66,57,7113.30,13737.00,0.00
2024-12-10 17:26:27,124,10355,67,57,7055.94,13737.01,0.00
2024-12-10 17:26:27,123,10355,66,57,7101.06,13737.09,0.00
2024-12-10 17:26:27,123,10356,66,57,7088.13,13738.00,0.00
2024-12-10 17:26:27,124,10356,66,58,7030.97,13738.01,0.00
2024-12-10 17:26:27,123,10356,66,57,7075.89,13738.09,0.00
2024-12-10 17:26:27,123,10357,66,57,7062.95,13739.00,0.00
2024-12-10 17:26:27,124,10357,66,58,7006.00,13739.01,0.00
2024-12-10 17:26:27,123,10357,65,58,7050.71,13739.09,0.00
2024-12-10 17:26:27,123,10358,65,58,7037.77,13740.00,0.00
2024-12-10 17:26:27,124,10358,66,58,6981.02,13740.01,0.00
2024-12-10 17:26:27,123,10358,66,57,7025.53,13740.09,0.00
2024-12-10 17:26:27,124,10357,67,57,6855.14,13740.94,0.00
2024-12-10 17:26:27,124,10358,67,57,6966.01,13741.00,0.00
2024-12-10 17:26:27,125,10358,68,57,6910.28,13741.01,0.00
2024-12-10 17:26:27,124,10358,67,57,6953.86,13741.09,0.00
2024-12-10 17:26:27,124,10359,67,57,7050.75,13742.00,0.00
2024-12-10 17:26:27,125,10359,67,58,6994.34,13742.01,0.00
2024-12-10 17:26:27,124,10359,67,57,7038.60,13742.09,0.00
2024-12-10 17:26:27,125,10358,68,57,6876.00,13742.88,0.00
2024-12-10 17:26:27,125,10359,68,57,6981.84,13743.00,0.00
2024-12-10 17:26:27,126,10359,68,58,6926.43,13743.01,0.00
2024-12-10 17:26:27,125,10359,68,57,6969.79,13743.09,0.00
2024-12-10 17:26:27,126,10358,68,58,6828.54,13743.73,0.00
2024-12-10 17:26:27,126,10359,68,58,7033.47,13744.00,0.00
2024-12-10 17:26:27,127,10359,69,58,6978.09,13744.01,0.00
2024-12-10 17:26:27,126,10359,68,58,7021.51,13744.09,0.00
2024-12-10 17:26:27,126,10360,68,58,7107.48,13745.00,0.00
2024-12-10 17:26:27,127,10360,68,59,7051.51,13745.01,0.00
2024-12-10 17:26:27,126,10360,67,59,7095.51,13745.09,0.00
2024-12-10 17:26:27,126,10361,67,59,7072.05,13746.00,0.00
2024-12-10 17:26:27,127,10361,68,59,7016.37,13746.01,0.00
2024-12-10 17:26:27,127,10362,68,59,6979.93,13747.00,0.00
2024-12-10 17:26:27,128,10362,68,60,6925.40,13747.01,0.00
2024-12-10 17:26:27,127,10362,67,60,6966.98,13747.09,0.00
2024-12-10 17:26:27,128,10361,68,60,6778.74,13747.99,0.00
2024-12-10 17:26:27,128,10362,68,60,6886.15,13748.00,0.00
2024-12-10 17:26:27,129,10362,69,60,6832.77,13748.01,0.00
2024-12-10 17:26:27,128,10362,68,60,6873.30,13748.09,0.00
2024-12-10 17:26:27,128,10363,68,60,6944.28,13749.00,0.00
2024-12-10 17:26:27,129,10363,68,61,6890.45,13749.01,0.00
2024-12-10 17:26:27,128,10363,68,60,6931.43,13749.09,0.00
2024-12-10 17:26:27,128,10364,68,60,6889.54,13750.00,0.00
2024-12-10 17:26:27,129,10364,69,60,6836.13,13750.01,0.00
2024-12-10 17:26:27,128,10364,68,60,6876.68,13750.09,0.00
2024-12-10 17:26:27,128,10365,68,60,6830.92,13751.00,0.00
2024-12-10 17:26:27,129,10365,68,61,6777.97,13751.01,0.00
2024-12-10 17:26:27,130,10364,69,61,6718.45,13751.08,0.00
2024-12-10 17:26:27,130,10365,69,61,6705.86,13752.00,0.00
2024-12-10 17:26:27,131,10365,70,61,6654.67,13752.01,0.00
2024-12-10 17:26:27,130,10365,69,61,6692.15,13752.10,0.00
2024-12-10 17:26:28,129,10365,69,60,6684.72,13752.49,0.00
2024-12-10 17:26:28,128,10365,68,60,6686.24,13752.77,0.00
2024-12-10 17:26:28,128,10366,68,60,6861.40,13753.00,0.00
2024-12-10 17:26:28,129,10366,68,61,6808.22,13753.01,0.00
2024-12-10 17:26:28,128,10366,67,61,6847.48,13753.10,0.00
2024-12-10 17:26:28,128,10367,67,61,6822.89,13754.00,0.00
2024-12-10 17:26:28,129,10367,68,61,6770.00,13754.01,0.00
2024-12-10 17:26:28,128,10367,68,60,6820.75,13754.02,0.00
2024-12-10 17:26:28,127,10367,68,59,6862.58,13754.09,0.00
2024-12-10 17:26:28,126,10367,67,59,6915.95,13754.10,0.00
2024-12-10 17:26:28,126,10368,67,59,6892.46,13755.00,0.00
2024-12-10 17:26:28,127,10368,67,60,6838.19,13755.01,0.00
2024-12-10 17:26:28,126,10368,66,60,6879.40,13755.10,0.00
2024-12-10 17:26:28,125,10368,65,60,6933.34,13755.10,0.00
2024-12-10 17:26:28,125,10369,65,60,6908.46,13756.00,0.00
2024-12-10 17:26:28,126,10369,65,61,6853.63,13756.01,0.00
2024-12-10 17:26:28,125,10369,64,61,6895.29,13756.10,0.00
2024-12-10 17:26:28,124,10369,63,61,6849.63,13756.78,0.00
2024-12-10 17:26:28,124,10370,63,61,6925.61,13757.00,0.00
2024-12-10 17:26:28,125,10370,63,62,6870.20,13757.01,0.00
2024-12-10 17:26:28,124,10370,63,61,6912.33,13757.10,0.00
2024-12-10 17:26:28,124,10371,63,61,6890.94,13758.00,0.00
2024-12-10 17:26:28,125,10371,63,62,6835.81,13758.01,0.00
2024-12-10 17:26:28,124,10371,63,61,6877.66,13758.10,0.00
2024-12-10 17:26:28,124,10372,63,61,6853.02,13759.00,0.00
2024-12-10 17:26:28,125,10372,64,61,6798.20,13759.01,0.00
2024-12-10 17:26:28,124,10372,63,61,6839.74,13759.10,0.00
2024-12-10 17:26:28,124,10373,63,61,6808.89,13760.00,0.00
2024-12-10 17:26:28,125,10373,63,62,6754.42,13760.01,0.00
2024-12-10 17:26:28,125,10374,63,62,6701.75,13761.00,0.00
2024-12-10 17:26:28,126,10374,63,63,6648.57,13761.01,0.00
2024-12-10 17:26:28,125,10374,63,62,6687.48,13761.10,0.00
2024-12-10 17:26:28,125,10375,63,62,6640.97,13762.00,0.00
2024-12-10 17:26:28,126,10375,63,63,6588.26,13762.01,0.00
2024-12-10 17:26:28,125,10375,63,62,6626.70,13762.10,0.00
2024-12-10 17:26:28,125,10376,63,62,6579.43,13763.00,0.00
2024-12-10 17:26:28,126,10376,63,63,6527.21,13763.01,0.00
2024-12-10 17:26:28,127,10375,64,63,6466.09,13763.09,0.00
2024-12-10 17:26:28,126,10375,63,63,6593.89,13763.11,0.00
2024-12-10 17:26:28,125,10375,63,62,6619.87,13763.29,0.00
2024-12-10 17:26:28,126,10374,64,62,6451.08,13763.96,0.00
2024-12-10 17:26:28,126,10375,64,62,6560.36,13764.00,0.00
2024-12-10 17:26:28,127,10375,65,62,6508.70,13764.01,0.00
2024-12-10 17:26:28,126,10375,64,62,6546.20,13764.10,0.00
2024-12-10 17:26:28,127,10374,65,62,6391.75,13764.76,0.00
2024-12-10 17:26:28,127,10375,65,62,6701.47,13765.00,0.00
2024-12-10 17:26:28,128,10375,65,63,6649.11,13765.01,0.00
2024-12-10 17:26:28,127,10375,64,63,6687.42,13765.10,0.00
2024-12-10 17:26:28,126,10375,64,62,6648.18,13765.71,0.00
2024-12-10 17:26:28,127,10374,65,62,6552.89,13765.95,0.00
2024-12-10 17:26:28,127,10375,65,62,6766.47,13766.00,0.00
2024-12-10 17:26:28,128,10375,65,63,6713.61,13766.01,0.00
2024-12-10 17:26:28,127,10375,64,63,6752.42,13766.10,0.00
2024-12-10 17:26:28,127,10376,64,63,6833.58,13767.00,0.00
2024-12-10 17:26:28,128,10376,65,63,6780.19,13767.01,0.00
2024-12-10 17:26:28,127,10376,65,62,6819.53,13767.10,0.00
2024-12-10 17:26:28,127,10377,65,62,6791.61,13768.00,0.00
2024-12-10 17:26:28,128,10377,66,62,6738.55,13768.01,0.00
2024-12-10 17:26:28,127,10377,66,61,6777.55,13768.10,0.00
2024-12-10 17:26:28,126,10377,65,61,6749.92,13768.69,0.00
2024-12-10 17:26:29,126,10378,65,61,6810.16,13769.00,0.00
2024-12-10 17:26:29,127,10378,65,62,6756.54,13769.01,0.00
2024-12-10 17:26:29,126,10378,65,61,6795.99,13769.10,0.00
2024-12-10 17:26:29,126,10379,65,61,6776.26,13770.00,0.00
2024-12-10 17:26:29,127,10379,66,61,6722.90,13770.01,0.00
2024-12-10 17:26:29,126,10379,65,61,6762.09,13770.10,0.00
2024-12-10 17:26:29,127,10378,65,62,6647.16,13770.57,0.00
2024-12-10 17:26:29,127,10379,65,62,6744.72,13771.00,0.00
2024-12-10 17:26:29,128,10379,65,63,6692.03,13771.01,0.00
2024-12-10 17:26:29,127,10379,64,63,6730.66,13771.10,0.00
2024-12-10 17:26:29,126,10379,63,63,6693.19,13771.75,0.00
2024-12-10 17:26:29,126,10380,63,63,6878.12,13772.00,0.00
2024-12-10 17:26:29,127,10380,64,63,6823.96,13772.01,0.00
2024-12-10 17:26:29,126,10380,63,63,6863.94,13772.10,0.00
2024-12-10 17:26:29,126,10381,63,63,6850.19,13773.00,0.00
2024-12-10 17:26:29,127,10381,64,63,6796.26,13773.01,0.00
2024-12-10 17:26:29,126,10381,63,63,6836.02,13773.10,0.00
2024-12-10 17:26:29,126,10382,63,63,6822.27,13774.00,0.00
2024-12-10 17:26:29,127,10382,64,63,6768.55,13774.01,0.00
2024-12-10 17:26:29,126,10382,63,63,6808.09,13774.10,0.00
2024-12-10 17:26:29,126,10383,63,63,6794.34,13775.00,0.00
2024-12-10 17:26:29,127,10383,64,63,6740.84,13775.01,0.00
2024-12-10 17:26:29,126,10383,64,62,6780.16,13775.10,0.00
2024-12-10 17:26:29,126,10384,64,62,6766.41,13776.00,0.00
2024-12-10 17:26:29,127,10384,65,62,6713.13,13776.01,0.00
2024-12-10 17:26:29,126,10384,64,62,6752.22,13776.10,0.00
2024-12-10 17:26:29,126,10385,64,62,6738.47,13777.00,0.00
2024-12-10 17:26:29,127,10385,65,62,6685.41,13777.01,0.00
2024-12-10 17:26:29,126,10385,65,61,6724.28,13777.10,0.00
2024-12-10 17:26:29,126,10386,65,61,6710.53,13778.00,0.00
2024-12-10 17:26:29,127,10386,65,62,6657.69,13778.01,0.00
2024-12-10 17:26:29,126,10386,65,61,6696.34,13778.10,0.00
2024-12-10 17:26:29,126,10387,65,61,6682.58,13779.00,0.00
2024-12-10 17:26:29,127,10387,66,61,6629.96,13779.01,0.00
2024-12-10 17:26:29,126,10387,65,61,6668.39,13779.10,0.00
2024-12-10 17:26:29,126,10388,65,61,6654.63,13780.00,0.00
2024-12-10 17:26:29,127,10388,66,61,6602.23,13780.01,0.00
2024-12-10 17:26:29,126,10388,65,61,6651.35,13780.02,0.00
2024-12-10 17:26:29,125,10388,64,61,6693.56,13780.10,0.00
2024-12-10 17:26:29,124,10388,64,60,6746.43,13780.10,0.00
2024-12-10 17:26:29,125,10387,65,60,6603.41,13780.76,0.00
2024-12-10 17:26:29,125,10388,65,60,6708.35,13781.00,0.00
2024-12-10 17:26:29,126,10388,66,60,6655.11,13781.01,0.00
2024-12-10 17:26:29,125,10388,66,59,6695.15,13781.10,0.00
2024-12-10 17:26:29,124,10388,65,59,6748.03,13781.10,0.00
2024-12-10 17:26:29,124,10389,65,59,6846.29,13782.00,0.00
2024-12-10 17:26:29,125,10389,66,59,6791.52,13782.01,0.00
2024-12-10 17:26:29,124,10389,65,59,6838.53,13782.06,0.00
2024-12-10 17:26:29,123,10389,64,59,6888.53,13782.09,0.00
2024-12-10 17:26:29,122,10389,63,59,6943.87,13782.09,0.00
2024-12-10 17:26:29,121,10389,62,59,6986.69,13782.19,0.00
2024-12-10 17:26:29,121,10390,62,59,6989.44,13783.00,0.00
2024-12-10 17:26:29,122,10390,62,60,6932.15,13783.01,0.00
2024-12-10 17:26:29,121,10390,61,60,6988.30,13783.01,0.00
2024-12-10 17:26:29,120,10390,61,59,7035.07,13783.08,0.00
2024-12-10 17:26:29,121,10389,61,60,6876.04,13783.83,0.00
2024-12-10 17:26:29,122,10388,61,61,6827.68,13783.93,0.00
2024-12-10 17:26:29,122,10389,61,61,6939.60,13784.00,0.00
2024-12-10 17:26:29,123,10389,62,61,6883.18,13784.01,0.00
2024-12-10 17:26:29,122,10389,62,60,6928.64,13784.08,0.00
2024-12-10 17:26:29,122,10390,62,60,7141.55,13785.00,0.00
2024-12-10 17:26:29,123,10390,62,61,7083.48,13785.01,0.00
2024-12-10 17:26:29,123,10391,62,61,7059.34,13786.00,0.00
2024-12-10 17:26:29,124,10391,62,62,7002.41,13786.01,0.00
2024-12-10 17:26:29,123,10391,61,62,7052.63,13786.05,0.00
2024-12-10 17:26:29,122,10391,61,61,7105.93,13786.07,0.00
2024-12-10 17:26:29,121,10391,61,60,7163.51,13786.07,0.00
2024-12-10 17:26:29,121,10392,61,60,7150.34,13787.00,0.00
2024-12-10 17:26:29,122,10392,62,60,7091.73,13787.01,0.00
2024-12-10 17:26:29,121,10392,61,60,7140.10,13787.07,0.00
2024-12-10 17:26:30,121,10393,61,60,7126.25,13788.00,0.00
2024-12-10 17:26:30,122,10393,61,61,7067.84,13788.01,0.00
2024-12-10 17:26:30,122,10394,61,61,7044.00,13789.00,0.00
2024-12-10 17:26:30,123,10394,62,61,6986.73,13789.01,0.00
2024-12-10 17:26:30,122,10394,61,61,7032.72,13789.08,0.00
2024-12-10 17:26:30,122,10395,61,61,7019.64,13790.00,0.00
2024-12-10 17:26:30,123,10395,61,62,6962.57,13790.01,0.00
2024-12-10 17:26:30,122,10395,60,62,7008.36,13790.08,0.00
2024-12-10 17:26:30,122,10396,60,62,6995.28,13791.00,0.00
2024-12-10 17:26:30,123,10396,61,62,6938.41,13791.01,0.00
2024-12-10 17:26:30,123,10397,61,62,6914.24,13792.00,0.00
2024-12-10 17:26:30,124,10397,61,63,6858.48,13792.01,0.00
2024-12-10 17:26:30,123,10397,61,62,6910.88,13792.02,0.00
2024-12-10 17:26:30,122,10397,61,61,6959.63,13792.07,0.00
2024-12-10 17:26:30,121,10397,60,61,7016.01,13792.07,0.00
2024-12-10 17:26:30,122,10396,61,61,6891.95,13792.57,0.00
2024-12-10 17:26:30,122,10397,61,61,6995.17,13793.00,0.00
2024-12-10 17:26:30,123,10397,62,61,6938.30,13793.01,0.00
2024-12-10 17:26:30,122,10397,61,61,6985.01,13793.07,0.00
2024-12-10 17:26:30,122,10398,61,61,7082.01,13794.00,0.00
2024-12-10 17:26:30,123,10398,62,61,7024.43,13794.01,0.00
2024-12-10 17:26:30,122,10398,61,61,7071.85,13794.07,0.00
2024-12-10 17:26:30,122,10399,61,61,7049.00,13795.00,0.00
2024-12-10 17:26:30,123,10399,61,62,6991.69,13795.01,0.00
2024-12-10 17:26:30,124,10398,62,62,6883.09,13795.40,0.00
2024-12-10 17:26:30,124,10399,62,62,6971.14,13796.00,0.00
2024-12-10 17:26:30,125,10399,63,62,6915.37,13796.01,0.00
2024-12-10 17:26:30,124,10399,63,61,6961.14,13796.07,0.00
2024-12-10 17:26:30,124,10400,63,61,7049.08,13797.00,0.00
2024-12-10 17:26:30,125,10400,63,62,6992.69,13797.01,0.00
2024-12-10 17:26:30,125,10401,63,62,6960.53,13798.00,0.00
2024-12-10 17:26:30,126,10401,63,63,6905.29,13798.01,0.00
2024-12-10 17:26:30,125,10401,62,63,6952.82,13798.06,0.00
2024-12-10 17:26:30,124,10401,61,63,7006.67,13798.06,0.00
2024-12-10 17:26:30,123,10401,60,63,7062.51,13798.07,0.00
2024-12-10 17:26:30,123,10402,60,63,7035.63,13799.00,0.00
2024-12-10 17:26:30,124,10402,60,64,6978.89,13799.01,0.00
2024-12-10 17:26:30,123,10402,59,64,7026.67,13799.07,0.00
2024-12-10 17:26:30,123,10403,59,64,6992.24,13800.00,0.00
2024-12-10 17:26:30,124,10403,59,65,6935.85,13800.01,0.00
2024-12-10 17:26:30,123,10403,59,64,6983.28,13800.07,0.00
2024-12-10 17:26:30,123,10404,59,64,6950.29,13801.00,0.00
2024-12-10 17:26:30,124,10404,59,65,6894.24,13801.01,0.00
2024-12-10 17:26:30,123,10404,59,64,6942.45,13801.06,0.00
2024-12-10 17:26:30,122,10404,59,63,6998.22,13801.06,0.00
2024-12-10 17:26:30,121,10404,59,62,7054.92,13801.06,0.00
2024-12-10 17:26:30,121,10405,59,62,7025.17,13802.00,0.00
2024-12-10 17:26:30,122,10405,60,62,6967.59,13802.01,0.00
2024-12-10 17:26:30,121,10405,59,62,7017.20,13802.06,0.00
2024-12-10 17:26:30,122,10404,60,62,6900.97,13802.50,0.00
2024-12-10 17:26:30,122,10405,60,62,6977.81,13803.00,0.00
2024-12-10 17:26:30,123,10405,61,62,6921.08,13803.01,0.00
2024-12-10 17:26:30,122,10405,61,61,6969.90,13803.06,0.00
2024-12-10 17:26:30,122,10406,61,61,7030.08,13804.00,0.00
2024-12-10 17:26:30,123,10406,61,62,6972.93,13804.01,0.00
2024-12-10 17:26:30,122,10406,61,61,7022.17,13804.06,0.00
2024-12-10 17:26:30,122,10407,61,61,6972.52,13805.00,0.00
2024-12-10 17:26:30,123,10407,62,61,6915.83,13805.01,0.00
2024-12-10 17:26:30,122,10407,62,60,6964.61,13805.06,0.00
2024-12-10 17:26:30,122,10407,62,60,6930.07,13806.00,0.00
2024-12-10 17:26:30,123,10407,63,60,6873.73,13806.01,0.00
2024-12-10 17:26:30,122,10407,62,60,6922.16,13806.06,0.00
2024-12-10 17:26:30,122,10408,62,60,6870.15,13807.00,0.00
2024-12-10 17:26:30,123,10408,62,61,6814.29,13807.01,0.00
2024-12-10 17:26:30,122,10408,62,60,6862.23,13807.06,0.00
2024-12-10 17:26:30,122,10409,62,60,6801.19,13808.00,0.00
2024-12-10 17:26:30,123,10409,63,60,6745.89,13808.01,0.00
2024-12-10 17:26:30,122,10409,62,60,6797.79,13808.02,0.00
2024-12-10 17:26:30,121,10409,61,60,6849.42,13808.05,0.00
2024-12-10 17:26:30,120,10409,61,59,6905.34,13808.05,0.00
2024-12-10 17:26:30,119,10409,60,59,6849.68,13808.74,0.00
2024-12-10 17:26:30,119,10410,60,59,6929.44,13809.00,0.00
2024-12-10 17:26:30,120,10410,61,59,6871.70,13809.01,0.00
2024-12-10 17:26:30,119,10410,60,59,6922.49,13809.05,0.00
2024-12-10 17:26:30,119,10411,60,59,6890.75,13810.00,0.00
2024-12-10 17:26:30,120,10411,61,59,6833.33,13810.01,0.00
2024-12-10 17:26:30,119,10411,60,59,6883.80,13810.05,0.00
2024-12-10 17:26:30,119,10412,60,59,6853.28,13811.00,0.00
2024-12-10 17:26:30,120,10412,60,60,6796.17,13811.01,0.00
2024-12-10 17:26:30,119,10412,60,59,6846.33,13811.05,0.00
2024-12-10 17:26:31,119,10413,60,59,6814.72,13812.00,0.00
2024-12-10 17:26:31,120,10413,60,60,6757.93,13812.01,0.00
2024-12-10 17:26:31,119,10413,59,60,6808.92,13812.04,0.00
2024-12-10 17:26:31,118,10413,58,60,6865.46,13812.04,0.00
2024-12-10 17:26:31,117,10413,57,60,6922.95,13812.04,0.00
2024-12-10 17:26:31,116,10413,56,60,6876.17,13812.66,0.00
2024-12-10 17:26:31,116,10414,56,60,6937.94,13813.00,0.00
2024-12-10 17:26:31,117,10414,57,60,6878.65,13813.01,0.00
2024-12-10 17:26:31,116,10414,57,59,6930.81,13813.05,0.00
2024-12-10 17:26:31,116,10415,57,59,6881.31,13814.00,0.00
2024-12-10 17:26:31,117,10415,58,59,6822.50,13814.01,0.00
2024-12-10 17:26:31,116,10415,58,58,6880.12,13814.01,0.00
2024-12-10 17:26:31,115,10415,58,57,6933.95,13814.04,0.00
2024-12-10 17:26:31,116,10414,59,57,6844.44,13814.28,0.00
2024-12-10 17:26:31,115,10414,58,57,6934.34,13814.63,0.00
2024-12-10 17:26:31,116,10413,58,58,6866.26,13814.70,0.00
2024-12-10 17:26:31,116,10414,58,58,6967.04,13815.00,0.00
2024-12-10 17:26:31,117,10414,59,58,6907.49,13815.01,0.00
2024-12-10 17:26:31,116,10414,58,58,6965.85,13815.01,0.00
2024-12-10 17:26:31,115,10414,57,58,7021.62,13815.04,0.00
2024-12-10 17:26:31,114,10414,57,57,7082.00,13815.04,0.00
2024-12-10 17:26:31,114,10415,57,57,7295.40,13816.00,0.00
2024-12-10 17:26:31,115,10415,57,58,7231.96,13816.01,0.00
2024-12-10 17:26:31,114,10415,57,57,7290.56,13816.04,0.00
2024-12-10 17:26:31,113,10415,57,56,7353.86,13816.04,0.00
2024-12-10 17:26:31,113,10416,57,56,7319.97,13817.00,0.00
2024-12-10 17:26:31,114,10416,58,56,7255.76,13817.01,0.00
2024-12-10 17:26:31,113,10416,58,55,7315.09,13817.04,0.00
2024-12-10 17:26:31,112,10416,57,55,7292.26,13817.56,0.00
2024-12-10 17:26:31,112,10417,57,55,7346.55,13818.00,0.00
2024-12-10 17:26:31,113,10417,58,55,7281.54,13818.01,0.00
2024-12-10 17:26:31,112,10417,58,54,7341.62,13818.04,0.00
2024-12-10 17:26:31,112,10418,58,54,7322.95,13819.00,0.00
2024-12-10 17:26:31,113,10418,58,55,7258.15,13819.01,0.00
2024-12-10 17:26:31,113,10419,58,55,7237.48,13820.00,0.00
2024-12-10 17:26:31,114,10419,59,55,7173.99,13820.01,0.00
2024-12-10 17:26:31,113,10419,59,54,7231.38,13820.04,0.00
2024-12-10 17:26:31,113,10420,59,54,7213.96,13821.00,0.00
2024-12-10 17:26:31,114,10420,59,55,7150.68,13821.01,0.00
2024-12-10 17:26:31,113,10420,58,55,7207.86,13821.04,0.00
2024-12-10 17:26:31,113,10421,58,55,7188.68,13822.00,0.00
2024-12-10 17:26:31,114,10421,58,56,7125.63,13822.01,0.00
2024-12-10 17:26:31,113,10421,57,56,7182.58,13822.04,0.00
2024-12-10 17:26:31,112,10421,57,55,7145.12,13822.76,0.00
2024-12-10 17:26:31,112,10422,57,55,7233.08,13823.00,0.00
2024-12-10 17:26:31,113,10422,58,55,7169.07,13823.01,0.00
2024-12-10 17:26:31,112,10422,58,54,7226.92,13823.04,0.00
2024-12-10 17:26:31,112,10423,58,54,7212.58,13824.00,0.00
2024-12-10 17:26:31,113,10423,59,54,7148.75,13824.01,0.00
2024-12-10 17:26:31,112,10423,59,53,7206.42,13824.04,0.00
2024-12-10 17:26:31,112,10424,59,53,7193.52,13825.00,0.00
2024-12-10 17:26:31,113,10424,60,53,7129.86,13825.01,0.00
2024-12-10 17:26:31,112,10424,59,53,7187.36,13825.04,0.00
2024-12-10 17:26:31,112,10425,59,53,7173.21,13826.00,0.00
2024-12-10 17:26:31,113,10425,59,54,7109.73,13826.01,0.00
2024-12-10 17:26:31,112,10425,58,54,7167.05,13826.04,0.00
2024-12-10 17:26:31,112,10426,58,54,7151.03,13827.00,0.00
2024-12-10 17:26:31,113,10426,58,55,7087.75,13827.01,0.00
2024-12-10 17:26:31,113,10427,58,55,7064.65,13828.00,0.00
2024-12-10 17:26:31,114,10427,58,56,7002.68,13828.01,0.00
2024-12-10 17:26:31,113,10427,58,55,7058.54,13828.04,0.00
2024-12-10 17:26:31,113,10428,58,55,7039.57,13829.00,0.00
2024-12-10 17:26:31,114,10428,58,56,6977.82,13829.01,0.00
2024-12-10 17:26:31,113,10428,58,55,7033.46,13829.04,0.00
2024-12-10 17:26:31,113,10429,58,55,7013.94,13830.00,0.00
2024-12-10 17:26:31,114,10429,58,56,6952.41,13830.01,0.00
2024-12-10 17:26:31,114,10430,58,56,6925.35,13831.00,0.00
2024-12-10 17:26:31,115,10430,58,57,6865.13,13831.01,0.00
2024-12-10 17:26:31,116,10429,58,58,6747.10,13831.45,0.00
2024-12-10 17:26:31,116,10430,58,58,6852.92,13832.00,0.00
2024-12-10 17:26:31,117,10430,59,58,6794.35,13832.01,0.00
2024-12-10 17:26:31,116,10430,59,57,6844.59,13832.06,0.00
2024-12-10 17:26:31,115,10430,59,56,6806.95,13832.70,0.00
2024-12-10 17:26:31,115,10431,59,56,7005.67,13833.00,0.00
2024-12-10 17:26:31,116,10431,60,56,6945.27,13833.01,0.00
2024-12-10 17:26:31,117,10430,61,56,6776.71,13833.70,0.00
2024-12-10 17:26:31,117,10431,61,56,6890.47,13834.00,0.00
2024-12-10 17:26:31,118,10431,61,57,6832.08,13834.01,0.00
2024-12-10 17:26:31,117,10431,61,56,6882.21,13834.06,0.00
2024-12-10 17:26:31,117,10432,61,56,6984.77,13835.00,0.00
2024-12-10 17:26:31,118,10432,61,57,6925.58,13835.01,0.00
2024-12-10 17:26:31,117,10432,60,57,6976.50,13835.06,0.00
2024-12-10 17:26:32,117,10433,60,57,6959.13,13836.00,0.00
2024-12-10 17:26:32,118,10433,60,58,6900.15,13836.01,0.00
2024-12-10 17:26:32,117,10433,60,57,6855.10,13836.56,0.00
2024-12-10 17:26:32,117,10434,60,57,6906.61,13837.00,0.00
2024-12-10 17:26:32,118,10434,61,57,6848.08,13837.01,0.00
2024-12-10 17:26:32,118,10435,61,57,6804.80,13838.00,0.00
2024-12-10 17:26:32,119,10435,61,58,6747.62,13838.01,0.00
2024-12-10 17:26:32,118,10435,61,57,6796.61,13838.06,0.00
2024-12-10 17:26:32,118,10436,61,57,6759.66,13839.00,0.00
2024-12-10 17:26:32,119,10436,62,57,6702.86,13839.01,0.00
2024-12-10 17:26:32,118,10436,61,57,6746.29,13839.10,0.00
2024-12-10 17:26:32,118,10437,61,57,6726.52,13840.00,0.00
2024-12-10 17:26:32,119,10437,62,57,6670.00,13840.01,0.00
2024-12-10 17:26:32,118,10437,61,57,6719.50,13840.05,0.00
2024-12-10 17:26:32,117,10437,60,57,6774.56,13840.06,0.00
2024-12-10 17:26:32,116,10437,59,57,6831.77,13840.06,0.00
2024-12-10 17:26:32,117,10436,59,58,6722.18,13840.44,0.00
2024-12-10 17:26:32,117,10437,59,58,6820.31,13841.00,0.00
2024-12-10 17:26:32,118,10437,59,59,6762.51,13841.01,0.00
2024-12-10 17:26:32,119,10436,59,60,6630.24,13841.57,0.00
2024-12-10 17:26:32,119,10437,59,60,6831.06,13842.00,0.00
2024-12-10 17:26:32,120,10437,60,60,6774.14,13842.01,0.00
2024-12-10 17:26:32,119,10437,60,59,6821.77,13842.07,0.00
2024-12-10 17:26:32,119,10438,60,59,6906.11,13843.00,0.00
2024-12-10 17:26:32,120,10438,61,59,6848.56,13843.01,0.00
2024-12-10 17:26:32,119,10438,61,58,6902.63,13843.03,0.00
2024-12-10 17:26:32,118,10438,61,57,6955.27,13843.06,0.00
2024-12-10 17:26:32,117,10438,61,56,7013.53,13843.06,0.00
2024-12-10 17:26:32,116,10438,60,56,7024.45,13843.41,0.00
2024-12-10 17:26:32,116,10439,60,56,7034.05,13844.00,0.00
2024-12-10 17:26:32,117,10439,60,57,6973.93,13844.01,0.00
2024-12-10 17:26:32,116,10439,59,57,7025.72,13844.06,0.00
2024-12-10 17:26:32,115,10439,58,57,6998.62,13844.55,0.00
2024-12-10 17:26:32,115,10440,58,57,7042.59,13845.00,0.00
2024-12-10 17:26:32,116,10440,58,58,6981.88,13845.01,0.00
2024-12-10 17:26:32,117,10439,58,59,6866.69,13845.43,0.00
2024-12-10 17:26:32,116,10439,57,59,6967.90,13845.61,0.00
2024-12-10 17:26:32,116,10440,57,59,7033.86,13846.00,0.00
2024-12-10 17:26:32,117,10440,58,59,6973.74,13846.01,0.00
2024-12-10 17:26:32,117,10441,58,59,7066.64,13847.00,0.00
2024-12-10 17:26:32,118,10441,59,59,7006.76,13847.01,0.00
2024-12-10 17:26:32,117,10441,59,58,7058.37,13847.06,0.00
2024-12-10 17:26:32,116,10441,59,57,7118.03,13847.06,0.00
2024-12-10 17:26:32,115,10441,58,57,7178.72,13847.06,0.00
2024-12-10 17:26:32,115,10442,58,57,7156.87,13848.00,0.00
2024-12-10 17:26:32,116,10442,59,57,7095.18,13848.01,0.00
2024-12-10 17:26:32,116,10443,59,57,7055.20,13849.00,0.00
2024-12-10 17:26:32,117,10443,59,58,6994.90,13849.01,0.00
2024-12-10 17:26:32,116,10443,59,57,7045.67,13849.07,0.00
2024-12-10 17:26:32,116,10444,59,57,7011.17,13850.00,0.00
2024-12-10 17:26:32,117,10444,60,57,6951.25,13850.01,0.00
2024-12-10 17:26:32,116,10444,59,57,7001.64,13850.07,0.00
2024-12-10 17:26:32,115,10444,58,57,6968.70,13850.53,0.00
2024-12-10 17:26:32,116,10443,58,58,6908.63,13850.54,0.00
2024-12-10 17:26:32,116,10444,58,58,7018.21,13851.00,0.00
2024-12-10 17:26:32,117,10444,59,58,6958.23,13851.01,0.00
2024-12-10 17:26:32,116,10444,58,58,7017.02,13851.01,0.00
2024-12-10 17:26:32,115,10444,57,58,7068.42,13851.07,0.00
2024-12-10 17:26:32,114,10444,57,57,7083.13,13851.39,0.00
2024-12-10 17:26:32,114,10445,57,57,7235.67,13852.00,0.00
2024-12-10 17:26:32,115,10445,58,57,7172.75,13852.01,0.00
2024-12-10 17:26:32,114,10445,57,57,7225.97,13852.07,0.00
2024-12-10 17:26:32,114,10446,57,57,7219.18,13853.00,0.00
2024-12-10 17:26:32,115,10446,58,57,7156.40,13853.01,0.00
2024-12-10 17:26:32,114,10446,58,56,7209.48,13853.07,0.00
2024-12-10 17:26:32,114,10447,58,56,7191.49,13854.00,0.00
2024-12-10 17:26:32,115,10447,58,57,7128.96,13854.01,0.00
2024-12-10 17:26:33,116,10446,59,57,7035.29,13854.26,0.00
2024-12-10 17:26:33,115,10446,59,56,7106.87,13854.37,0.00
2024-12-10 17:26:33,114,10446,58,56,7157.34,13854.43,0.00
2024-12-10 17:26:33,114,10447,58,56,7199.80,13855.00,0.00
2024-12-10 17:26:33,115,10447,59,56,7137.19,13855.01,0.00
2024-12-10 17:26:33,114,10447,59,55,7188.88,13855.08,0.00
2024-12-10 17:26:33,113,10447,59,54,7244.00,13855.13,0.00
2024-12-10 17:26:33,113,10448,59,54,7368.57,13856.00,0.00
2024-12-10 17:26:33,114,10448,59,55,7303.93,13856.01,0.00
2024-12-10 17:26:33,113,10448,59,54,7357.56,13856.08,0.00
2024-12-10 17:26:33,112,10448,58,54,7387.12,13856.34,0.00
2024-12-10 17:26:33,112,10449,58,54,7419.75,13857.00,0.00
2024-12-10 17:26:33,113,10449,58,55,7354.09,13857.01,0.00
2024-12-10 17:26:33,113,10450,58,55,7338.51,13858.00,0.00
2024-12-10 17:26:33,114,10450,59,55,7274.14,13858.01,0.00
2024-12-10 17:26:33,113,10450,59,54,7326.27,13858.09,0.00
2024-12-10 17:26:33,113,10451,59,54,7321.22,13859.00,0.00
2024-12-10 17:26:33,114,10451,59,55,7257.00,13859.01,0.00
2024-12-10 17:26:33,113,10451,58,55,7308.97,13859.09,0.00
2024-12-10 17:26:33,113,10452,58,55,7305.80,13860.00,0.00
2024-12-10 17:26:33,114,10452,58,56,7241.71,13860.01,0.00
2024-12-10 17:26:33,115,10451,58,57,7153.46,13860.21,0.00
2024-12-10 17:26:33,114,10451,58,56,7322.73,13860.26,0.00
2024-12-10 17:26:33,114,10452,58,56,7335.40,13861.00,0.00
2024-12-10 17:26:33,115,10452,59,56,7271.62,13861.01,0.00
2024-12-10 17:26:33,114,10452,59,55,7322.05,13861.10,0.00
2024-12-10 17:26:33,114,10453,59,55,7422.10,13862.00,0.00
2024-12-10 17:26:33,115,10453,59,56,7357.56,13862.01,0.00
2024-12-10 17:26:33,116,10452,60,56,7282.20,13862.11,0.00
2024-12-10 17:26:33,116,10453,60,56,7383.53,13863.00,0.00
2024-12-10 17:26:33,117,10453,60,57,7320.42,13863.01,0.00
2024-12-10 17:26:33,116,10453,60,56,7382.33,13863.01,0.00
2024-12-10 17:26:33,115,10453,60,55,7436.90,13863.07,0.00
2024-12-10 17:26:33,114,10453,59,55,7498.50,13863.09,0.00
2024-12-10 17:26:33,113,10453,58,55,7563.63,13863.09,0.00
2024-12-10 17:26:33,112,10453,57,55,7611.66,13863.22,0.00
2024-12-10 17:26:33,111,10453,57,54,7643.73,13863.45,0.00
2024-12-10 17:26:33,111,10454,57,54,7817.74,13864.00,0.00
2024-12-10 17:26:33,112,10454,58,54,7747.94,13864.01,0.00
2024-12-10 17:26:33,111,10454,58,53,7814.00,13864.03,0.00
2024-12-10 17:26:33,110,10454,57,53,7876.23,13864.08,0.00
2024-12-10 17:26:33,110,10455,57,53,7873.66,13865.00,0.00
2024-12-10 17:26:33,111,10455,57,54,7802.72,13865.01,0.00
2024-12-10 17:26:33,110,10455,57,53,7864.85,13865.06,0.00
2024-12-10 17:26:33,109,10455,57,52,7933.20,13865.08,0.00
2024-12-10 17:26:33,108,10455,56,52,8005.37,13865.08,0.00
2024-12-10 17:26:33,108,10456,56,52,8002.69,13866.00,0.00
2024-12-10 17:26:33,109,10456,56,53,7929.27,13866.01,0.00
2024-12-10 17:26:33,108,10456,56,52,7991.16,13866.08,0.00
2024-12-10 17:26:33,108,10457,56,52,7986.72,13867.00,0.00
2024-12-10 17:26:33,109,10457,56,53,7913.45,13867.01,0.00
2024-12-10 17:26:33,108,10457,55,53,7975.19,13867.08,0.00
2024-12-10 17:26:33,107,10457,54,53,8048.89,13867.08,0.00
2024-12-10 17:26:33,107,10458,54,53,8044.07,13868.00,0.00
2024-12-10 17:26:33,108,10458,55,53,7969.59,13868.01,0.00
2024-12-10 17:26:33,108,10459,55,53,7951.79,13869.00,0.00
2024-12-10 17:26:33,109,10459,56,53,7878.83,13869.01,0.00
2024-12-10 17:26:33,109,10460,56,53,7859.44,13870.00,0.00
2024-12-10 17:26:33,110,10460,56,54,7787.99,13870.01,0.00
2024-12-10 17:26:33,109,10460,56,53,7858.17,13870.01,0.00
2024-12-10 17:26:33,108,10460,56,52,7918.12,13870.09,0.00
2024-12-10 17:26:33,108,10461,56,52,7911.38,13871.00,0.00
2024-12-10 17:26:33,109,10461,57,52,7838.80,13871.01,0.00
2024-12-10 17:26:33,108,10461,57,51,7898.58,13871.09,0.00
2024-12-10 17:26:33,108,10462,57,51,7891.67,13872.00,0.00
2024-12-10 17:26:33,109,10462,57,52,7819.26,13872.01,0.00
2024-12-10 17:26:33,110,10461,58,52,7633.80,13872.78,0.00
2024-12-10 17:26:34,110,10462,58,52,7756.33,13873.00,0.00
2024-12-10 17:26:34,111,10462,59,52,7686.45,13873.01,0.00
2024-12-10 17:26:34,110,10462,58,52,7743.75,13873.09,0.00
2024-12-10 17:26:34,110,10463,58,52,7859.47,13874.00,0.00
2024-12-10 17:26:34,111,10463,58,53,7788.67,13874.01,0.00
2024-12-10 17:26:34,111,10464,58,53,7765.09,13875.00,0.00
2024-12-10 17:26:34,112,10464,59,53,7695.76,13875.01,0.00
2024-12-10 17:26:34,113,10463,60,53,7620.30,13875.08,0.00
2024-12-10 17:26:34,112,10463,59,53,7797.38,13875.10,0.00
2024-12-10 17:26:34,112,10464,59,53,7783.62,13876.00,0.00
2024-12-10 17:26:34,113,10464,59,54,7714.74,13876.01,0.00
2024-12-10 17:26:34,112,10464,58,54,7679.95,13876.72,0.00
2024-12-10 17:26:34,112,10465,58,54,7885.84,13877.00,0.00
2024-12-10 17:26:34,113,10465,59,54,7816.05,13877.01,0.00
2024-12-10 17:26:34,112,10465,58,54,7873.48,13877.09,0.00
2024-12-10 17:26:34,112,10466,58,54,7857.64,13878.00,0.00
2024-12-10 17:26:34,113,10466,59,54,7788.11,13878.01,0.00
2024-12-10 17:26:34,113,10467,59,54,7755.82,13879.00,0.00
2024-12-10 17:26:34,114,10467,59,55,7687.79,13879.01,0.00
2024-12-10 17:26:34,114,10468,59,55,7662.57,13880.00,0.00
2024-12-10 17:26:34,115,10468,59,56,7595.94,13880.01,0.00
2024-12-10 17:26:34,114,10468,58,56,7656.49,13880.04,0.00
2024-12-10 17:26:34,113,10468,57,56,7716.91,13880.09,0.00
2024-12-10 17:26:34,113,10469,57,56,7713.33,13881.00,0.00
2024-12-10 17:26:34,114,10469,57,57,7645.67,13881.01,0.00
2024-12-10 17:26:34,114,10470,57,57,7630.32,13882.00,0.00
2024-12-10 17:26:34,115,10470,57,58,7563.97,13882.01,0.00
2024-12-10 17:26:34,116,10469,57,59,7384.81,13882.80,0.00
2024-12-10 17:26:34,116,10470,57,59,7501.08,13883.00,0.00
2024-12-10 17:26:34,117,10470,57,60,7436.97,13883.01,0.00
2024-12-10 17:26:34,116,10470,57,59,7486.76,13883.10,0.00
2024-12-10 17:26:34,116,10471,57,59,7592.56,13884.00,0.00
2024-12-10 17:26:34,117,10471,58,59,7527.67,13884.01,0.00
2024-12-10 17:26:34,118,10470,58,60,7411.05,13884.41,0.00
2024-12-10 17:26:34,118,10471,58,60,7512.97,13885.00,0.00
2024-12-10 17:26:34,119,10471,59,60,7449.84,13885.01,0.00
2024-12-10 17:26:34,119,10472,59,60,7544.77,13886.00,0.00
2024-12-10 17:26:34,120,10472,59,61,7481.90,13886.01,0.00
2024-12-10 17:26:34,121,10471,59,62,7412.06,13886.08,0.00
2024-12-10 17:26:34,121,10472,59,62,7434.53,13887.00,0.00
2024-12-10 17:26:34,122,10472,60,62,7373.59,13887.01,0.00
2024-12-10 17:26:34,121,10472,59,62,7421.70,13887.10,0.00
2024-12-10 17:26:34,121,10473,59,62,7525.95,13888.00,0.00
2024-12-10 17:26:34,122,10473,59,63,7464.26,13888.01,0.00
2024-12-10 17:26:34,123,10472,60,63,7378.79,13888.20,0.00
2024-12-10 17:26:34,124,10471,61,63,7329.44,13888.44,0.00
2024-12-10 17:26:34,124,10472,61,63,7426.99,13889.00,0.00
2024-12-10 17:26:34,125,10472,61,64,7367.58,13889.01,0.00
2024-12-10 17:26:34,124,10472,60,64,7413.59,13889.10,0.00
2024-12-10 17:26:34,124,10473,60,64,7622.90,13890.00,0.00
2024-12-10 17:26:34,125,10473,61,64,7561.91,13890.01,0.00
2024-12-10 17:26:34,124,10473,61,63,7609.49,13890.10,0.00
2024-12-10 17:26:34,123,10473,61,62,7606.35,13890.52,0.00
2024-12-10 17:26:34,123,10474,61,62,7650.21,13891.00,0.00
2024-12-10 17:26:34,124,10474,62,62,7588.52,13891.01,0.00
2024-12-10 17:26:34,123,10474,61,62,7636.70,13891.10,0.00
2024-12-10 17:26:34,123,10475,61,62,7610.23,13892.00,0.00
2024-12-10 17:26:34,124,10475,62,62,7548.86,13892.01,0.00
2024-12-10 17:26:34,123,10475,61,62,7606.85,13892.02,0.00
2024-12-10 17:26:34,122,10475,61,61,7658.99,13892.09,0.00
2024-12-10 17:26:34,121,10475,60,61,7721.13,13892.09,0.00
2024-12-10 17:26:35,121,10476,60,61,7689.52,13893.00,0.00
2024-12-10 17:26:35,122,10476,61,61,7626.50,13893.01,0.00
2024-12-10 17:26:35,121,10476,61,60,7645.37,13893.28,0.00
2024-12-10 17:26:35,121,10477,61,60,7650.71,13894.00,0.00
2024-12-10 17:26:35,122,10477,61,61,7588.00,13894.01,0.00
2024-12-10 17:26:35,122,10478,61,61,7553.10,13895.00,0.00
2024-12-10 17:26:35,123,10478,62,61,7491.69,13895.01,0.00
2024-12-10 17:26:35,122,10478,61,61,7551.96,13895.01,0.00
2024-12-10 17:26:35,121,10478,61,60,7601.78,13895.09,0.00
2024-12-10 17:26:35,120,10478,60,60,7663.97,13895.09,0.00
2024-12-10 17:26:35,120,10479,60,60,7641.67,13896.00,0.00
2024-12-10 17:26:35,121,10479,60,61,7578.51,13896.01,0.00
2024-12-10 17:26:35,121,10480,60,61,7543.67,13897.00,0.00
2024-12-10 17:26:35,122,10480,61,61,7481.84,13897.01,0.00
2024-12-10 17:26:35,122,10481,61,61,7447.45,13898.00,0.00
2024-12-10 17:26:35,123,10481,61,62,7386.90,13898.01,0.00
2024-12-10 17:26:35,122,10481,61,61,7434.96,13898.09,0.00
2024-12-10 17:26:35,122,10482,61,61,7413.21,13899.00,0.00
2024-12-10 17:26:35,123,10482,62,61,7352.94,13899.01,0.00
2024-12-10 17:26:35,122,10482,62,60,7400.71,13899.09,0.00
2024-12-10 17:26:35,122,10483,62,60,7378.49,13900.00,0.00
2024-12-10 17:26:35,123,10483,63,60,7318.50,13900.01,0.00
2024-12-10 17:26:35,123,10484,63,60,7284.05,13901.00,0.00
2024-12-10 17:26:35,124,10484,63,61,7225.31,13901.01,0.00
2024-12-10 17:26:35,124,10485,63,61,7188.58,13902.00,0.00
2024-12-10 17:26:35,125,10485,63,62,7131.07,13902.01,0.00
2024-12-10 17:26:35,124,10485,63,61,7186.34,13902.02,0.00
2024-12-10 17:26:35,123,10485,62,61,7150.32,13902.68,0.00
2024-12-10 17:26:35,123,10486,62,61,7214.92,13903.00,0.00
2024-12-10 17:26:35,124,10486,62,62,7156.73,13903.01,0.00
2024-12-10 17:26:35,123,10486,61,62,7201.40,13903.10,0.00
2024-12-10 17:26:35,123,10487,61,62,7180.69,13904.00,0.00
2024-12-10 17:26:35,124,10487,61,63,7122.78,13904.01,0.00
2024-12-10 17:26:35,123,10487,61,62,7167.17,13904.10,0.00
2024-12-10 17:26:35,123,10488,61,62,7142.80,13905.00,0.00
2024-12-10 17:26:35,124,10488,61,63,7085.20,13905.01,0.00
2024-12-10 17:26:35,124,10489,61,63,7042.93,13906.00,0.00
2024-12-10 17:26:35,125,10489,62,63,6986.59,13906.01,0.00
2024-12-10 17:26:35,124,10489,61,63,7029.52,13906.10,0.00
2024-12-10 17:26:35,123,10489,61,62,7086.33,13906.10,0.00
2024-12-10 17:26:35,122,10489,61,61,7078.02,13906.57,0.00
2024-12-10 17:26:35,122,10490,61,61,7111.38,13907.00,0.00
2024-12-10 17:26:35,123,10490,61,62,7053.56,13907.01,0.00
2024-12-10 17:26:35,123,10491,61,62,7004.27,13908.00,0.00
2024-12-10 17:26:35,124,10491,61,63,6947.79,13908.01,0.00
2024-12-10 17:26:35,123,10491,60,63,6990.74,13908.10,0.00
2024-12-10 17:26:35,124,10490,60,64,6792.81,13908.94,0.00
2024-12-10 17:26:35,124,10491,60,64,6905.04,13909.00,0.00
2024-12-10 17:26:35,125,10491,61,64,6849.80,13909.01,0.00
2024-12-10 17:26:35,124,10491,60,64,6891.62,13909.10,0.00
2024-12-10 17:26:36,124,10492,60,64,6960.47,13910.00,0.00
2024-12-10 17:26:36,125,10492,60,65,6904.79,13910.01,0.00
2024-12-10 17:26:36,126,10491,60,66,6845.59,13910.06,0.00
2024-12-10 17:26:36,127,10490,61,66,6815.79,13910.08,0.00
2024-12-10 17:26:36,126,10490,60,66,6969.26,13910.11,0.00
2024-12-10 17:26:36,125,10490,59,66,6899.93,13910.78,0.00
2024-12-10 17:26:36,125,10491,59,66,6980.25,13911.00,0.00
2024-12-10 17:26:36,126,10491,59,67,6924.85,13911.01,0.00
2024-12-10 17:26:36,125,10491,59,66,6966.94,13911.10,0.00
2024-12-10 17:26:36,125,10492,59,66,7157.71,13912.00,0.00
2024-12-10 17:26:36,126,10492,60,66,7100.90,13912.01,0.00
2024-12-10 17:26:36,125,10492,59,66,7044.21,13912.74,0.00
2024-12-10 17:26:36,125,10493,59,66,7119.01,13913.00,0.00
2024-12-10 17:26:36,126,10493,60,66,7062.51,13913.01,0.00
2024-12-10 17:26:36,125,10493,59,66,7105.69,13913.10,0.00
2024-12-10 17:26:36,125,10494,59,66,7082.77,13914.00,0.00
2024-12-10 17:26:36,126,10494,59,67,7026.55,13914.01,0.00
2024-12-10 17:26:36,125,10494,58,67,7081.65,13914.01,0.00
2024-12-10 17:26:36,124,10494,57,67,7126.46,13914.09,0.00
2024-12-10 17:26:36,123,10494,56,67,7183.27,13914.09,0.00
2024-12-10 17:26:36,122,10494,56,66,7241.01,13914.09,0.00
2024-12-10 17:26:36,122,10494,56,66,7219.66,13915.00,0.00
2024-12-10 17:26:36,123,10494,56,67,7160.96,13915.01,0.00
2024-12-10 17:26:36,124,10493,57,67,7100.98,13915.04,0.00
2024-12-10 17:26:36,123,10493,56,67,7210.79,13915.10,0.00
2024-12-10 17:26:36,123,10494,56,67,7188.25,13916.00,0.00
2024-12-10 17:26:36,124,10494,57,67,7130.28,13916.01,0.00
2024-12-10 17:26:36,123,10494,57,66,7175.85,13916.09,0.00
2024-12-10 17:26:36,122,10494,57,65,7140.51,13916.69,0.00
2024-12-10 17:26:36,122,10495,57,65,7325.56,13917.00,0.00
2024-12-10 17:26:36,123,10495,57,66,7266.00,13917.01,0.00
2024-12-10 17:26:36,122,10495,56,66,7313.06,13917.09,0.00
2024-12-10 17:26:36,122,10496,56,66,7294.02,13918.00,0.00
2024-12-10 17:26:36,123,10496,56,67,7234.72,13918.01,0.00
2024-12-10 17:26:36,122,10496,55,67,7281.52,13918.09,0.00
2024-12-10 17:26:36,122,10497,55,67,7260.39,13919.00,0.00
2024-12-10 17:26:36,123,10497,56,67,7201.36,13919.01,0.00
2024-12-10 17:26:36,123,10498,56,67,7165.21,13920.00,0.00
2024-12-10 17:26:36,124,10498,56,68,7107.43,13920.01,0.00
2024-12-10 17:26:36,123,10498,55,68,7152.81,13920.09,0.00
2024-12-10 17:26:36,124,10497,55,69,7045.81,13920.46,0.00
2024-12-10 17:26:36,124,10498,55,69,7134.15,13921.00,0.00
2024-12-10 17:26:36,125,10498,55,70,7077.08,13921.01,0.00
2024-12-10 17:26:36,124,10498,55,69,7121.84,13921.09,0.00
2024-12-10 17:26:36,124,10499,55,69,7202.09,13922.00,0.00
2024-12-10 17:26:36,125,10499,56,69,7144.48,13922.01,0.00
2024-12-10 17:26:36,124,10499,56,68,7189.78,13922.09,0.00
2024-12-10 17:26:36,123,10499,56,67,7166.11,13922.63,0.00
2024-12-10 17:26:36,123,10500,56,67,7222.70,13923.00,0.00
2024-12-10 17:26:36,124,10500,57,67,7164.46,13923.01,0.00
2024-12-10 17:26:36,123,10500,56,67,7210.29,13923.09,0.00
2024-12-10 17:26:36,123,10501,56,67,7190.27,13924.00,0.00
2024-12-10 17:26:36,124,10501,57,67,7132.28,13924.01,0.00
2024-12-10 17:26:36,124,10502,57,67,7096.52,13925.00,0.00
2024-12-10 17:26:36,125,10502,58,67,7039.75,13925.01,0.00
2024-12-10 17:26:36,124,10502,57,67,7083.09,13925.10,0.00
2024-12-10 17:26:36,124,10503,57,67,7056.11,13926.00,0.00
2024-12-10 17:26:36,125,10503,58,67,6999.66,13926.01,0.00
2024-12-10 17:26:36,124,10503,58,66,7042.68,13926.10,0.00
2024-12-10 17:26:36,124,10504,58,66,7012.33,13927.00,0.00
2024-12-10 17:26:36,125,10504,58,67,6956.23,13927.01,0.00
2024-12-10 17:26:36,124,10504,58,66,6998.89,13927.10,0.00
2024-12-10 17:26:36,125,10503,59,66,6852.74,13927.70,0.00
2024-12-10 17:26:36,126,10502,60,66,6849.96,13927.83,0.00
2024-12-10 17:26:36,126,10503,60,66,6956.23,13928.00,0.00
2024-12-10 17:26:36,127,10503,60,67,6901.46,13928.01,0.00
2024-12-10 17:26:36,128,10502,61,67,6837.78,13928.09,0.00
2024-12-10 17:26:36,127,10502,61,66,6932.21,13928.10,0.00
2024-12-10 17:26:36,127,10503,61,66,7101.75,13929.00,0.00
2024-12-10 17:26:36,128,10503,61,67,7046.27,13929.01,0.00
2024-12-10 17:26:36,129,10502,62,67,6987.34,13929.05,0.00
2024-12-10 17:26:36,128,10502,62,66,7130.10,13929.10,0.00
2024-12-10 17:26:36,128,10503,62,66,7183.72,13930.00,0.00
2024-12-10 17:26:36,129,10503,63,66,7128.03,13930.01,0.00
2024-12-10 17:26:36,128,10503,63,65,7170.70,13930.09,0.00
2024-12-10 17:26:36,128,10504,63,65,7217.69,13931.00,0.00
2024-12-10 17:26:36,129,10504,63,66,7161.74,13931.01,0.00
2024-12-10 17:26:36,128,10504,63,65,7203.59,13931.10,0.00
2024-12-10 17:26:36,129,10503,64,65,7097.88,13931.46,0.00
2024-12-10 17:26:36,128,10503,63,65,7187.65,13931.63,0.00
2024-12-10 17:26:36,128,10504,63,65,7210.65,13932.00,0.00
2024-12-10 17:26:36,129,10504,63,66,7154.75,13932.01,0.00
2024-12-10 17:26:36,128,10504,62,66,7196.55,13932.10,0.00
2024-12-10 17:26:36,129,10503,63,66,7070.52,13932.60,0.00
2024-12-10 17:26:37,129,10504,63,66,7241.35,13933.00,0.00
2024-12-10 17:26:37,130,10504,64,66,7185.65,13933.01,0.00
2024-12-10 17:26:37,129,10504,64,65,7231.66,13933.07,0.00
2024-12-10 17:26:37,128,10504,63,65,7283.82,13933.09,0.00
2024-12-10 17:26:37,127,10504,62,65,7340.07,13933.09,0.00
2024-12-10 17:26:37,126,10504,61,65,7307.69,13933.60,0.00
2024-12-10 17:26:37,126,10505,61,65,7453.69,13934.00,0.00
2024-12-10 17:26:37,127,10505,61,66,7395.00,13934.01,0.00
2024-12-10 17:26:37,126,10505,61,65,7440.46,13934.10,0.00
2024-12-10 17:26:37,125,10505,60,65,7373.92,13934.91,0.00
2024-12-10 17:26:37,125,10506,60,65,7473.22,13935.00,0.00
2024-12-10 17:26:37,126,10506,60,66,7413.91,13935.01,0.00
2024-12-10 17:26:37,125,10506,60,65,7459.89,13935.10,0.00
2024-12-10 17:26:37,125,10507,60,65,7438.98,13936.00,0.00
2024-12-10 17:26:37,126,10507,61,65,7379.94,13936.01,0.00
2024-12-10 17:26:37,125,10507,61,64,7425.65,13936.10,0.00
2024-12-10 17:26:37,125,10508,61,64,7403.95,13937.00,0.00
2024-12-10 17:26:37,126,10508,62,64,7345.18,13937.01,0.00
2024-12-10 17:26:37,125,10508,61,64,7390.61,13937.10,0.00
2024-12-10 17:26:37,124,10508,60,64,7422.87,13937.28,0.00
2024-12-10 17:26:37,124,10509,60,64,7430.17,13938.00,0.00
2024-12-10 17:26:37,125,10509,61,64,7370.73,13938.01,0.00
2024-12-10 17:26:37,124,10509,61,63,7416.73,13938.10,0.00
2024-12-10 17:26:37,124,10510,61,63,7397.41,13939.00,0.00
2024-12-10 17:26:37,125,10510,61,64,7338.23,13939.01,0.00
2024-12-10 17:26:37,124,10510,60,64,7383.96,13939.10,0.00
2024-12-10 17:26:37,124,10511,60,64,7364.38,13940.00,0.00
2024-12-10 17:26:37,125,10511,61,64,7305.47,13940.01,0.00
2024-12-10 17:26:37,124,10511,60,64,7350.94,13940.10,0.00
2024-12-10 17:26:37,123,10511,60,63,7409.56,13940.10,0.00
2024-12-10 17:26:37,124,10510,61,63,7286.39,13940.51,0.00
2024-12-10 17:26:37,125,10509,61,64,7255.01,13940.74,0.00
2024-12-10 17:26:37,125,10510,61,64,7357.39,13941.00,0.00
2024-12-10 17:26:37,126,10510,62,64,7299.00,13941.01,0.00
2024-12-10 17:26:37,125,10510,61,64,7348.50,13941.06,0.00
2024-12-10 17:26:37,124,10510,61,63,7403.28,13941.09,0.00
2024-12-10 17:26:37,124,10511,61,63,7599.53,13942.00,0.00
2024-12-10 17:26:37,125,10511,61,64,7538.73,13942.01,0.00
2024-12-10 17:26:37,124,10511,60,64,7587.20,13942.09,0.00
2024-12-10 17:26:37,123,10511,59,64,7604.12,13942.40,0.00
2024-12-10 17:26:37,123,10512,59,64,7621.73,13943.00,0.00
2024-12-10 17:26:37,124,10512,59,65,7560.27,13943.01,0.00
2024-12-10 17:26:37,123,10512,58,65,7609.31,13943.09,0.00
2024-12-10 17:26:37,123,10513,58,65,7581.14,13944.00,0.00
2024-12-10 17:26:37,124,10513,59,65,7520.00,13944.01,0.00
2024-12-10 17:26:37,123,10513,59,64,7568.71,13944.09,0.00
2024-12-10 17:26:37,123,10514,59,64,7537.80,13945.00,0.00
2024-12-10 17:26:37,124,10514,60,64,7477.01,13945.01,0.00
2024-12-10 17:26:37,123,10514,60,63,7529.89,13945.06,0.00
2024-12-10 17:26:37,122,10514,60,62,7587.05,13945.08,0.00
2024-12-10 17:26:37,121,10514,60,61,7648.60,13945.08,0.00
2024-12-10 17:26:37,120,10514,60,60,7663.00,13945.37,0.00
2024-12-10 17:26:37,120,10515,60,60,7684.81,13946.00,0.00
2024-12-10 17:26:37,121,10515,61,60,7621.30,13946.01,0.00
2024-12-10 17:26:37,120,10515,60,60,7673.23,13946.08,0.00
2024-12-10 17:26:37,120,10516,60,60,7649.49,13947.00,0.00
2024-12-10 17:26:37,121,10516,61,60,7586.27,13947.01,0.00
2024-12-10 17:26:37,120,10516,60,60,7637.91,13947.08,0.00
2024-12-10 17:26:37,120,10517,60,60,7611.60,13948.00,0.00
2024-12-10 17:26:37,121,10517,60,61,7548.70,13948.01,0.00
2024-12-10 17:26:37,120,10517,59,61,7600.02,13948.08,0.00
2024-12-10 17:26:37,119,10517,59,60,7637.15,13948.24,0.00
2024-12-10 17:26:37,120,10516,59,61,7507.12,13948.70,0.00
2024-12-10 17:26:37,120,10517,59,61,7605.83,13949.00,0.00
2024-12-10 17:26:37,121,10517,59,62,7542.98,13949.01,0.00
2024-12-10 17:26:37,120,10517,59,61,7594.25,13949.08,0.00
2024-12-10 17:26:37,121,10516,59,62,7440.62,13949.72,0.00
2024-12-10 17:26:37,121,10517,59,62,7653.25,13950.00,0.00
2024-12-10 17:26:37,122,10517,60,62,7590.51,13950.01,0.00
2024-12-10 17:26:37,122,10518,60,62,7666.68,13951.00,0.00
2024-12-10 17:26:37,123,10518,61,62,7604.35,13951.01,0.00
2024-12-10 17:26:37,122,10518,60,62,7654.14,13951.09,0.00
2024-12-10 17:26:37,122,10519,60,62,7626.86,13952.00,0.00
2024-12-10 17:26:37,123,10519,60,63,7564.85,13952.01,0.00
2024-12-10 17:26:37,122,10519,59,63,7614.32,13952.09,0.00
2024-12-10 17:26:37,123,10518,60,63,7528.62,13952.28,0.00
2024-12-10 17:26:37,123,10519,60,63,7611.33,13953.00,0.00
2024-12-10 17:26:37,124,10519,60,64,7549.95,13953.01,0.00
2024-12-10 17:26:37,123,10519,59,64,7598.89,13953.09,0.00
2024-12-10 17:26:37,122,10519,58,64,7545.62,13953.79,0.00
2024-12-10 17:26:37,122,10520,58,64,7745.95,13954.00,0.00
2024-12-10 17:26:37,123,10520,58,65,7682.98,13954.01,0.00
2024-12-10 17:26:37,122,10520,58,64,7733.41,13954.09,0.00
2024-12-10 17:26:37,121,10520,57,64,7796.17,13954.09,0.00
2024-12-10 17:26:37,121,10521,57,64,7773.80,13955.00,0.00
2024-12-10 17:26:37,122,10521,58,64,7710.08,13955.01,0.00
2024-12-10 17:26:37,121,10521,57,64,7761.14,13955.09,0.00
2024-12-10 17:26:38,121,10522,57,64,7737.29,13956.00,0.00
2024-12-10 17:26:38,122,10522,57,65,7673.87,13956.01,0.00
2024-12-10 17:26:38,121,10522,57,64,7724.64,13956.09,0.00
2024-12-10 17:26:38,120,10522,57,63,7758.80,13956.25,0.00
2024-12-10 17:26:38,119,10522,57,62,7793.51,13956.44,0.00
2024-12-10 17:26:38,119,10523,57,62,7832.64,13957.00,0.00
2024-12-10 17:26:38,120,10523,57,63,7767.37,13957.01,0.00
2024-12-10 17:26:38,119,10523,57,62,7819.77,13957.09,0.00
2024-12-10 17:26:38,119,10524,57,62,7805.54,13958.00,0.00
2024-12-10 17:26:38,120,10524,58,62,7740.49,13958.01,0.00
2024-12-10 17:26:38,119,10524,58,61,7785.92,13958.13,0.00
2024-12-10 17:26:38,119,10525,58,61,7780.47,13959.00,0.00
2024-12-10 17:26:38,120,10525,58,62,7715.64,13959.01,0.00
2024-12-10 17:26:38,119,10525,58,61,7767.60,13959.09,0.00
2024-12-10 17:26:38,119,10526,58,61,7757.46,13960.00,0.00
2024-12-10 17:26:38,120,10526,59,61,7692.81,13960.01,0.00
2024-12-10 17:26:38,120,10527,59,61,7663.84,13961.00,0.00
2024-12-10 17:26:38,121,10527,60,61,7600.50,13961.01,0.00
2024-12-10 17:26:38,121,10528,60,61,7571.84,13962.00,0.00
2024-12-10 17:26:38,122,10528,61,61,7509.77,13962.01,0.00
2024-12-10 17:26:38,121,10528,61,60,7570.69,13962.01,0.00
2024-12-10 17:26:38,120,10528,61,59,7619.85,13962.10,0.00
2024-12-10 17:26:38,119,10528,60,59,7682.71,13962.10,0.00
2024-12-10 17:26:38,119,10529,60,59,7664.14,13963.00,0.00
2024-12-10 17:26:38,120,10529,61,59,7600.27,13963.01,0.00
2024-12-10 17:26:38,119,10529,61,58,7617.73,13963.24,0.00
2024-12-10 17:26:38,119,10530,61,58,7625.48,13964.00,0.00
2024-12-10 17:26:38,120,10530,62,58,7561.94,13964.01,0.00
2024-12-10 17:26:38,119,10530,61,58,7611.44,13964.10,0.00
2024-12-10 17:26:38,119,10531,61,58,7590.71,13965.00,0.00
2024-12-10 17:26:38,120,10531,62,58,7527.46,13965.01,0.00
2024-12-10 17:26:38,119,10531,62,57,7576.66,13965.10,0.00
2024-12-10 17:26:38,119,10532,62,57,7547.10,13966.00,0.00
2024-12-10 17:26:38,120,10532,63,57,7484.20,13966.01,0.00
2024-12-10 17:26:38,119,10532,63,56,7486.40,13966.29,0.00
2024-12-10 17:26:38,119,10533,63,56,7501.98,13967.00,0.00
2024-12-10 17:26:38,120,10533,63,57,7439.47,13967.01,0.00
2024-12-10 17:26:38,119,10533,63,56,7487.93,13967.10,0.00
2024-12-10 17:26:38,119,10534,63,56,7464.88,13968.00,0.00
2024-12-10 17:26:38,120,10534,63,57,7402.67,13968.01,0.00
2024-12-10 17:26:38,119,10534,62,57,7450.83,13968.10,0.00
2024-12-10 17:26:38,119,10535,62,57,7427.18,13969.00,0.00
2024-12-10 17:26:38,120,10535,63,57,7365.29,13969.01,0.00
2024-12-10 17:26:38,120,10536,63,57,7320.99,13970.00,0.00
2024-12-10 17:26:38,121,10536,63,58,7260.49,13970.01,0.00
2024-12-10 17:26:38,120,10536,63,57,7307.05,13970.10,0.00
2024-12-10 17:26:38,119,10536,63,56,7356.54,13970.11,0.00
2024-12-10 17:26:38,119,10537,63,56,7340.32,13971.00,0.00
2024-12-10 17:26:38,120,10537,64,56,7279.15,13971.01,0.00
2024-12-10 17:26:38,119,10537,63,56,7326.26,13971.10,0.00
2024-12-10 17:26:38,119,10538,63,56,7308.25,13972.00,0.00
2024-12-10 17:26:38,120,10538,63,57,7247.35,13972.01,0.00
2024-12-10 17:26:38,119,10538,63,56,7297.71,13972.08,0.00
2024-12-10 17:26:38,118,10538,62,56,7356.00,13972.09,0.00
2024-12-10 17:26:38,118,10539,62,56,7333.14,13973.00,0.00
2024-12-10 17:26:38,119,10539,63,56,7271.51,13973.01,0.00
2024-12-10 17:26:38,118,10539,62,56,7320.14,13973.09,0.00
2024-12-10 17:26:38,119,10538,62,57,7176.94,13973.59,0.00
2024-12-10 17:26:38,119,10539,62,57,7284.28,13974.00,0.00
2024-12-10 17:26:38,120,10539,63,57,7223.58,13974.01,0.00
2024-12-10 17:26:38,120,10540,63,57,7298.56,13975.00,0.00
2024-12-10 17:26:38,121,10540,64,57,7238.24,13975.01,0.00
2024-12-10 17:26:38,120,10540,63,57,7297.40,13975.01,0.00
2024-12-10 17:26:38,119,10540,62,57,7324.15,13975.09,0.00
2024-12-10 17:26:38,118,10540,61,57,7385.04,13975.09,0.00
2024-12-10 17:26:38,118,10541,61,57,7374.46,13976.00,0.00
2024-12-10 17:26:38,119,10541,62,57,7312.49,13976.01,0.00
2024-12-10 17:26:38,118,10541,62,56,7357.92,13976.08,0.00
2024-12-10 17:26:38,118,10542,62,56,7345.50,13977.00,0.00
2024-12-10 17:26:38,119,10542,62,57,7283.77,13977.01,0.00
2024-12-10 17:26:38,118,10542,61,57,7333.67,13977.08,0.00
2024-12-10 17:26:38,118,10543,61,57,7323.10,13978.00,0.00
2024-12-10 17:26:38,119,10543,62,57,7261.56,13978.01,0.00
2024-12-10 17:26:38,118,10543,62,56,7309.68,13978.09,0.00
2024-12-10 17:26:38,118,10544,62,56,7300.71,13979.00,0.00
2024-12-10 17:26:38,119,10544,63,56,7239.36,13979.01,0.00
2024-12-10 17:26:38,120,10543,64,56,7114.90,13979.47,0.00
2024-12-10 17:26:38,120,10544,64,56,7220.13,13980.00,0.00
2024-12-10 17:26:38,121,10544,65,56,7160.46,13980.01,0.00
2024-12-10 17:26:39,120,10544,65,55,7208.50,13980.08,0.00
2024-12-10 17:26:39,120,10545,65,55,7313.85,13981.00,0.00
2024-12-10 17:26:39,121,10545,66,55,7253.41,13981.01,0.00
2024-12-10 17:26:39,121,10546,66,55,7227.49,13982.00,0.00
2024-12-10 17:26:39,122,10546,67,55,7168.25,13982.01,0.00
2024-12-10 17:26:39,121,10546,66,55,7217.11,13982.07,0.00
2024-12-10 17:26:39,120,10546,66,54,7276.09,13982.08,0.00
2024-12-10 17:26:39,119,10546,65,54,7333.75,13982.09,0.00
2024-12-10 17:26:39,120,10545,66,54,7163.32,13982.89,0.00
2024-12-10 17:26:39,120,10546,66,54,7277.61,13983.00,0.00
2024-12-10 17:26:39,121,10546,66,55,7217.47,13983.01,0.00
2024-12-10 17:26:39,121,10547,66,55,7309.77,13984.00,0.00
2024-12-10 17:26:39,122,10547,67,55,7249.86,13984.01,0.00
2024-12-10 17:26:39,121,10547,66,55,7302.85,13984.05,0.00
2024-12-10 17:26:39,120,10547,66,54,7360.22,13984.07,0.00
2024-12-10 17:26:39,120,10548,66,54,7345.59,13985.00,0.00
2024-12-10 17:26:39,121,10548,66,55,7284.88,13985.01,0.00
2024-12-10 17:26:39,121,10549,66,55,7259.53,13986.00,0.00
2024-12-10 17:26:39,122,10549,66,56,7200.03,13986.01,0.00
2024-12-10 17:26:39,121,10549,66,55,7250.30,13986.07,0.00
2024-12-10 17:26:39,121,10550,66,55,7233.21,13987.00,0.00
2024-12-10 17:26:39,122,10550,67,55,7173.92,13987.01,0.00
2024-12-10 17:26:39,122,10551,67,55,7149.84,13988.00,0.00
2024-12-10 17:26:39,123,10551,67,56,7091.71,13988.01,0.00
2024-12-10 17:26:39,122,10551,67,55,7142.98,13988.05,0.00
2024-12-10 17:26:39,121,10551,66,55,7198.55,13988.07,0.00
2024-12-10 17:26:39,121,10552,66,55,7184.00,13989.00,0.00
2024-12-10 17:26:39,122,10552,67,55,7125.11,13989.01,0.00
2024-12-10 17:26:39,121,10552,67,54,7173.61,13989.07,0.00
2024-12-10 17:26:39,121,10553,67,54,7160.23,13990.00,0.00
2024-12-10 17:26:39,122,10553,67,55,7101.54,13990.01,0.00
2024-12-10 17:26:39,121,10553,66,55,7149.85,13990.07,0.00
2024-12-10 17:26:39,121,10554,66,55,7136.46,13991.00,0.00
2024-12-10 17:26:39,122,10554,67,55,7077.96,13991.01,0.00
2024-12-10 17:26:39,122,10555,67,55,7053.09,13992.00,0.00
2024-12-10 17:26:39,123,10555,68,55,6995.75,13992.01,0.00
2024-12-10 17:26:39,122,10555,67,55,7042.79,13992.07,0.00
2024-12-10 17:26:39,122,10556,67,55,7025.77,13993.00,0.00
2024-12-10 17:26:39,123,10556,67,56,6968.65,13993.01,0.00
2024-12-10 17:26:39,124,10555,67,57,6815.63,13993.72,0.00
2024-12-10 17:26:39,124,10556,67,57,6924.39,13994.00,0.00
2024-12-10 17:26:39,125,10556,68,57,6869.00,13994.01,0.00
2024-12-10 17:26:39,125,10557,68,57,6952.05,13995.00,0.00
2024-12-10 17:26:39,126,10557,68,58,6896.87,13995.01,0.00
2024-12-10 17:26:39,125,10557,67,58,6941.99,13995.07,0.00
2024-12-10 17:26:39,125,10558,67,58,6919.59,13996.00,0.00
2024-12-10 17:26:39,126,10558,68,58,6864.67,13996.01,0.00
2024-12-10 17:26:39,125,10558,68,57,6909.53,13996.07,0.00
2024-12-10 17:26:39,125,10559,68,57,6885.55,13997.00,0.00
2024-12-10 17:26:39,126,10559,69,57,6830.90,13997.01,0.00
2024-12-10 17:26:39,125,10559,68,57,6875.49,13997.07,0.00
2024-12-10 17:26:39,126,10558,68,58,6779.88,13997.38,0.00
2024-12-10 17:26:39,126,10559,68,58,6871.36,13998.00,0.00
2024-12-10 17:26:39,127,10559,69,58,6817.26,13998.01,0.00
2024-12-10 17:26:39,126,10559,69,57,6861.38,13998.07,0.00
2024-12-10 17:26:39,126,10560,69,57,6944.83,13999.00,0.00
2024-12-10 17:26:39,127,10560,69,58,6890.14,13999.01,0.00
2024-12-10 17:26:39,128,10559,70,58,6781.72,13999.41,0.00
2024-12-10 17:26:39,129,10558,71,58,6796.21,13999.45,0.00
2024-12-10 17:26:39,129,10559,71,58,6883.82,14000.00,0.00
2024-12-10 17:26:39,130,10559,71,59,6830.87,14000.01,0.00
2024-12-10 17:26:39,129,10559,70,59,6872.76,14000.08,0.00
2024-12-10 17:26:39,128,10559,69,59,6865.53,14000.45,0.00
2024-12-10 17:26:39,129,10558,70,59,6796.09,14000.58,0.00
2024-12-10 17:26:39,129,10559,70,59,7124.32,14001.00,0.00
2024-12-10 17:26:39,130,10559,71,59,7069.52,14001.01,0.00
2024-12-10 17:26:39,129,10559,71,58,7112.88,14001.08,0.00
2024-12-10 17:26:39,128,10559,71,57,7165.28,14001.09,0.00
2024-12-10 17:26:39,128,10560,71,57,7255.79,14002.00,0.00
2024-12-10 17:26:39,129,10560,71,58,7199.54,14002.01,0.00
2024-12-10 17:26:39,129,10561,71,58,7166.90,14003.00,0.00
2024-12-10 17:26:39,130,10561,71,59,7111.77,14003.01,0.00
2024-12-10 17:26:39,129,10561,71,58,7156.06,14003.08,0.00
2024-12-10 17:26:39,129,10562,71,58,7134.56,14004.00,0.00
2024-12-10 17:26:39,130,10562,71,59,7079.68,14004.01,0.00
2024-12-10 17:26:39,129,10562,71,58,7123.72,14004.08,0.00
2024-12-10 17:26:39,129,10563,71,58,7103.13,14005.00,0.00
2024-12-10 17:26:39,130,10563,71,59,7048.49,14005.01,0.00
2024-12-10 17:26:40,129,10563,71,58,7086.16,14005.12,0.00
2024-12-10 17:26:40,129,10564,71,58,7070.14,14006.00,0.00
2024-12-10 17:26:40,130,10564,71,59,7015.76,14006.01,0.00
2024-12-10 17:26:40,129,10564,70,59,7059.30,14006.08,0.00
2024-12-10 17:26:40,128,10564,69,59,7078.27,14006.33,0.00
2024-12-10 17:26:40,128,10565,69,59,7086.89,14007.00,0.00
2024-12-10 17:26:40,129,10565,70,59,7031.95,14007.01,0.00
2024-12-10 17:26:40,128,10565,70,58,7075.96,14007.08,0.00
2024-12-10 17:26:40,128,10566,70,58,7049.72,14008.00,0.00
2024-12-10 17:26:40,129,10566,71,58,6995.08,14008.01,0.00
2024-12-10 17:26:40,128,10566,70,58,7039.88,14008.07,0.00
2024-12-10 17:26:40,127,10566,70,57,7094.21,14008.07,0.00
2024-12-10 17:26:40,127,10567,70,57,7070.00,14009.00,0.00
2024-12-10 17:26:40,128,10567,71,57,7014.76,14009.01,0.00
2024-12-10 17:26:40,127,10567,70,57,7058.98,14009.08,0.00
2024-12-10 17:26:40,126,10567,70,56,7111.87,14009.10,0.00
2024-12-10 17:26:40,126,10568,70,56,7093.36,14010.00,0.00
2024-12-10 17:26:40,127,10568,71,56,7037.50,14010.01,0.00
2024-12-10 17:26:40,126,10568,70,56,7091.13,14010.02,0.00
2024-12-10 17:26:40,125,10568,70,55,7145.62,14010.02,0.00
2024-12-10 17:26:40,124,10568,70,54,7196.89,14010.06,0.00
2024-12-10 17:26:40,123,10568,69,54,7254.26,14010.07,0.00
2024-12-10 17:26:40,123,10569,69,54,7232.86,14011.00,0.00
2024-12-10 17:26:40,124,10569,70,54,7174.53,14011.01,0.00
2024-12-10 17:26:40,124,10570,70,54,7142.12,14012.00,0.00
2024-12-10 17:26:40,125,10570,71,54,7084.98,14012.01,0.00
2024-12-10 17:26:40,126,10569,72,54,7027.64,14012.03,0.00
2024-12-10 17:26:40,125,10569,71,54,7170.57,14012.07,0.00
2024-12-10 17:26:40,125,10570,71,54,7147.15,14013.00,0.00
2024-12-10 17:26:40,126,10570,71,55,7090.42,14013.01,0.00
2024-12-10 17:26:40,126,10571,71,55,7165.52,14014.00,0.00
2024-12-10 17:26:40,127,10571,72,55,7109.10,14014.01,0.00
2024-12-10 17:26:40,126,10571,72,54,7155.39,14014.07,0.00
2024-12-10 17:26:40,126,10572,72,54,7124.91,14015.00,0.00
2024-12-10 17:26:40,127,10572,72,55,7068.81,14015.01,0.00
2024-12-10 17:26:40,126,10572,72,54,7123.80,14015.01,0.00
2024-12-10 17:26:40,125,10572,72,53,7171.83,14015.06,0.00
2024-12-10 17:26:40,124,10572,71,53,7228.54,14015.06,0.00
2024-12-10 17:26:40,124,10573,71,53,7193.74,14016.00,0.00
2024-12-10 17:26:40,125,10573,71,54,7136.19,14016.01,0.00
2024-12-10 17:26:40,124,10573,70,54,7184.71,14016.06,0.00
2024-12-10 17:26:40,124,10574,70,54,7152.34,14017.00,0.00
2024-12-10 17:26:40,125,10574,70,55,7095.12,14017.01,0.00
2024-12-10 17:26:40,124,10574,70,54,7143.31,14017.06,0.00
2024-12-10 17:26:40,123,10574,70,53,7131.58,14017.54,0.00
2024-12-10 17:26:40,123,10575,70,53,7169.78,14018.00,0.00
2024-12-10 17:26:40,124,10575,71,53,7111.96,14018.01,0.00
2024-12-10 17:26:40,123,10575,71,52,7160.68,14018.07,0.00
2024-12-10 17:26:40,122,10575,71,51,7217.66,14018.07,0.00
2024-12-10 17:26:40,122,10576,71,51,7179.09,14019.00,0.00
2024-12-10 17:26:40,123,10576,72,51,7120.72,14019.01,0.00
2024-12-10 17:26:40,123,10577,72,51,7078.85,14020.00,0.00
2024-12-10 17:26:40,124,10577,72,52,7021.77,14020.01,0.00
2024-12-10 17:26:40,123,10577,72,51,7075.44,14020.02,0.00
2024-12-10 17:26:40,122,10577,72,50,7126.55,14020.07,0.00
2024-12-10 17:26:40,122,10578,72,50,7098.27,14021.00,0.00
2024-12-10 17:26:40,123,10578,73,50,7040.56,14021.01,0.00
2024-12-10 17:26:40,122,10578,73,49,7089.09,14021.07,0.00
2024-12-10 17:26:40,122,10579,73,49,7063.42,14022.00,0.00
2024-12-10 17:26:40,123,10579,73,50,7005.99,14022.01,0.00
2024-12-10 17:26:40,124,10578,74,50,6946.11,14022.05,0.00
2024-12-10 17:26:40,125,10577,75,50,6896.27,14022.68,0.00
2024-12-10 17:26:40,125,10578,75,50,7001.99,14023.00,0.00
2024-12-10 17:26:40,126,10578,76,50,6946.42,14023.01,0.00
2024-12-10 17:26:40,125,10578,75,50,6991.91,14023.07,0.00
2024-12-10 17:26:40,124,10578,74,50,7043.12,14023.10,0.00
2024-12-10 17:26:40,123,10578,73,50,7030.52,14023.54,0.00
2024-12-10 17:26:40,123,10579,73,50,7307.92,14024.00,0.00
2024-12-10 17:26:40,124,10579,74,50,7248.98,14024.01,0.00
2024-12-10 17:26:40,123,10579,73,50,7297.68,14024.07,0.00
2024-12-10 17:26:40,123,10580,73,50,7273.81,14025.00,0.00
2024-12-10 17:26:40,124,10580,74,50,7215.15,14025.01,0.00
2024-12-10 17:26:40,124,10581,74,50,7182.91,14026.00,0.00
2024-12-10 17:26:40,125,10581,75,50,7125.45,14026.01,0.00
2024-12-10 17:26:40,124,10581,74,50,7171.62,14026.08,0.00
2024-12-10 17:26:40,123,10581,74,49,7212.89,14026.20,0.00
2024-12-10 17:26:40,122,10581,74,48,7226.16,14026.50,0.00
2024-12-10 17:26:40,122,10582,74,48,7271.37,14027.00,0.00
2024-12-10 17:26:40,123,10582,74,49,7212.25,14027.01,0.00
2024-12-10 17:26:40,122,10582,74,48,7265.64,14027.04,0.00
2024-12-10 17:26:40,121,10582,74,47,7319.90,14027.07,0.00
2024-12-10 17:26:40,122,10581,74,48,7227.72,14027.32,0.00
2024-12-10 17:26:40,122,10582,74,48,7332.80,14028.00,0.00
2024-12-10 17:26:40,123,10582,74,49,7273.19,14028.01,0.00
2024-12-10 17:26:40,122,10582,73,49,7330.51,14028.02,0.00
2024-12-10 17:26:40,121,10582,73,48,7382.99,14028.07,0.00
2024-12-10 17:26:40,120,10582,72,48,7443.35,14028.07,0.00
2024-12-10 17:26:41,120,10583,72,48,7544.45,14029.00,0.00
2024-12-10 17:26:41,121,10583,72,49,7482.09,14029.01,0.00
2024-12-10 17:26:41,121,10584,72,49,7455.35,14030.00,0.00
2024-12-10 17:26:41,122,10584,72,50,7394.24,14030.01,0.00
2024-12-10 17:26:41,121,10584,71,50,7443.79,14030.08,0.00
2024-12-10 17:26:41,121,10585,71,50,7427.53,14031.00,0.00
2024-12-10 17:26:41,122,10585,72,50,7366.65,14031.01,0.00
2024-12-10 17:26:41,121,10585,72,49,7415.96,14031.08,0.00
2024-12-10 17:26:41,120,10585,72,48,7454.52,14031.24,0.00
2024-12-10 17:26:41,120,10586,72,48,7465.52,14032.00,0.00
2024-12-10 17:26:41,121,10586,72,49,7403.82,14032.01,0.00
2024-12-10 17:26:41,120,10586,72,48,7453.86,14032.08,0.00
2024-12-10 17:26:41,120,10587,72,48,7429.10,14033.00,0.00
2024-12-10 17:26:41,121,10587,72,49,7367.70,14033.01,0.00
2024-12-10 17:26:41,121,10588,72,49,7324.11,14034.00,0.00
2024-12-10 17:26:41,122,10588,73,49,7264.08,14034.01,0.00
2024-12-10 17:26:41,121,10588,73,48,7311.39,14034.09,0.00
2024-12-10 17:26:41,122,10587,74,48,7244.56,14034.16,0.00
2024-12-10 17:26:41,123,10586,75,48,7222.27,14034.58,0.00
2024-12-10 17:26:41,123,10587,75,48,7326.44,14035.00,0.00
2024-12-10 17:26:41,124,10587,75,49,7267.35,14035.01,0.00
2024-12-10 17:26:41,123,10587,75,48,7313.92,14035.09,0.00
2024-12-10 17:26:41,123,10588,75,48,7521.04,14036.00,0.00
2024-12-10 17:26:41,124,10588,76,48,7460.39,14036.01,0.00
2024-12-10 17:26:41,125,10587,77,48,7395.11,14036.06,0.00
2024-12-10 17:26:41,124,10587,76,48,7546.46,14036.10,0.00
2024-12-10 17:26:41,125,10586,77,48,7379.66,14036.85,0.00
2024-12-10 17:26:41,125,10587,77,48,7486.48,14037.00,0.00
2024-12-10 17:26:41,126,10587,77,49,7427.06,14037.01,0.00
2024-12-10 17:26:41,127,10586,78,49,7352.05,14037.14,0.00
2024-12-10 17:26:41,127,10587,78,49,7664.61,14038.00,0.00
2024-12-10 17:26:41,128,10587,78,50,7604.73,14038.01,0.00
2024-12-10 17:26:41,127,10587,77,50,7660.50,14038.03,0.00
2024-12-10 17:26:41,126,10587,76,50,7712.41,14038.09,0.00
2024-12-10 17:26:41,126,10588,76,50,7804.00,14039.00,0.00
2024-12-10 17:26:41,127,10588,77,50,7742.55,14039.01,0.00
2024-12-10 17:26:41,128,10587,77,51,7680.97,14039.03,0.00
2024-12-10 17:26:41,129,10586,77,52,7717.24,14039.12,0.00
2024-12-10 17:26:41,129,10587,77,52,7705.04,14040.00,0.00
2024-12-10 17:26:41,130,10587,77,53,7645.77,14040.01,0.00
2024-12-10 17:26:41,129,10587,76,53,7693.12,14040.08,0.00
2024-12-10 17:26:41,128,10587,76,52,7752.12,14040.09,0.00
2024-12-10 17:26:41,127,10587,75,52,7767.67,14040.41,0.00
2024-12-10 17:26:41,127,10588,75,52,8009.46,14041.00,0.00
2024-12-10 17:26:41,128,10588,75,53,7946.88,14041.01,0.00
2024-12-10 17:26:41,128,10589,75,53,7905.14,14042.00,0.00
2024-12-10 17:26:41,129,10589,75,54,7843.86,14042.01,0.00
2024-12-10 17:26:41,128,10589,75,53,7892.00,14042.10,0.00
2024-12-10 17:26:41,129,10588,76,53,7715.33,14042.88,0.00
2024-12-10 17:26:41,129,10589,76,53,7809.10,14043.00,0.00
2024-12-10 17:26:41,130,10589,76,54,7749.03,14043.01,0.00
2024-12-10 17:26:41,131,10588,77,54,7570.36,14043.83,0.00
2024-12-10 17:26:41,131,10589,77,54,7775.37,14044.00,0.00
2024-12-10 17:26:41,132,10589,78,54,7716.47,14044.01,0.00
2024-12-10 17:26:41,131,10589,77,54,7761.49,14044.10,0.00
2024-12-10 17:26:41,130,10589,76,54,7776.07,14044.39,0.00
2024-12-10 17:26:41,130,10590,76,54,7899.34,14045.00,0.00
2024-12-10 17:26:41,131,10590,77,54,7839.04,14045.01,0.00
2024-12-10 17:26:41,130,10590,76,54,7881.86,14045.10,0.00
2024-12-10 17:26:41,130,10591,76,54,7852.51,14046.00,0.00
2024-12-10 17:26:41,131,10591,77,54,7792.57,14046.01,0.00
2024-12-10 17:26:41,130,10591,76,54,7828.36,14046.10,0.00
2024-12-10 17:26:41,130,10592,76,54,7785.52,14047.00,0.00
2024-12-10 17:26:41,131,10592,77,54,7726.09,14047.01,0.00
2024-12-10 17:26:41,130,10592,76,54,7756.90,14047.10,0.00
2024-12-10 17:26:41,130,10593,76,54,7694.90,14048.00,0.00
2024-12-10 17:26:41,131,10593,76,55,7636.16,14048.01,0.00
2024-12-10 17:26:41,130,10593,75,55,7690.60,14048.03,0.00
2024-12-10 17:26:41,129,10593,75,54,7721.73,14048.09,0.00
2024-12-10 17:26:41,128,10593,75,53,7780.96,14048.09,0.00
2024-12-10 17:26:41,127,10593,75,52,7824.29,14048.18,0.00
2024-12-10 17:26:41,127,10594,75,52,7774.07,14049.00,0.00
2024-12-10 17:26:41,128,10594,76,52,7713.33,14049.01,0.00
2024-12-10 17:26:41,127,10594,76,51,7741.79,14049.09,0.00
2024-12-10 17:26:41,126,10594,76,50,7761.97,14049.34,0.00
2024-12-10 17:26:41,126,10595,76,50,7749.25,14050.00,0.00
2024-12-10 17:26:41,127,10595,76,51,7688.23,14050.01,0.00
2024-12-10 17:26:41,126,10595,75,51,7717.11,14050.10,0.00
2024-12-10 17:26:41,126,10596,75,51,7670.27,14051.00,0.00
2024-12-10 17:26:41,127,10596,76,51,7609.87,14051.01,0.00
2024-12-10 17:26:41,126,10596,75,51,7647.39,14051.08,0.00
2024-12-10 17:26:41,125,10596,74,51,7706.33,14051.09,0.00
2024-12-10 17:26:41,125,10597,74,51,7665.63,14052.00,0.00
2024-12-10 17:26:41,126,10597,75,51,7604.79,14052.01,0.00
2024-12-10 17:26:42,125,10597,75,50,7625.24,14052.24,0.00
2024-12-10 17:26:42,124,10597,74,50,7605.15,14052.80,0.00
2024-12-10 17:26:42,124,10598,74,50,7674.50,14053.00,0.00
2024-12-10 17:26:42,125,10598,75,50,7613.10,14053.01,0.00
2024-12-10 17:26:42,124,10598,75,49,7659.82,14053.10,0.00
2024-12-10 17:26:42,123,10598,74,49,7684.98,14053.35,0.00
2024-12-10 17:26:42,122,10598,74,48,7669.82,14053.88,0.00
2024-12-10 17:26:42,122,10599,74,48,7767.84,14054.00,0.00
2024-12-10 17:26:42,123,10599,75,48,7704.69,14054.01,0.00
2024-12-10 17:26:42,122,10599,75,47,7752.92,14054.11,0.00
2024-12-10 17:26:42,122,10600,75,47,7739.52,14055.00,0.00
2024-12-10 17:26:42,123,10600,76,47,7676.60,14055.01,0.00
2024-12-10 17:26:42,122,10600,75,47,7724.60,14055.11,0.00
2024-12-10 17:26:42,122,10601,75,47,7711.99,14056.00,0.00
2024-12-10 17:26:42,123,10601,76,47,7649.30,14056.01,0.00
2024-12-10 17:26:42,122,10601,76,46,7697.07,14056.11,0.00
2024-12-10 17:26:42,122,10602,76,46,7685.11,14057.00,0.00
2024-12-10 17:26:42,123,10602,76,47,7622.63,14057.01,0.00
2024-12-10 17:26:42,122,10602,76,46,7670.18,14057.11,0.00
2024-12-10 17:26:42,122,10603,76,46,7658.74,14058.00,0.00
2024-12-10 17:26:42,123,10603,76,47,7596.47,14058.01,0.00
2024-12-10 17:26:42,122,10603,75,47,7643.81,14058.11,0.00
2024-12-10 17:26:42,122,10604,75,47,7633.23,14059.00,0.00
2024-12-10 17:26:42,123,10604,75,48,7571.17,14059.01,0.00
2024-12-10 17:26:42,123,10605,75,48,7544.94,14060.00,0.00
2024-12-10 17:26:42,124,10605,75,49,7484.09,14060.01,0.00
2024-12-10 17:26:42,124,10606,75,49,7455.25,14061.00,0.00
2024-12-10 17:26:42,125,10606,76,49,7395.61,14061.01,0.00
2024-12-10 17:26:42,126,10605,77,49,7326.90,14061.10,0.00
2024-12-10 17:26:42,125,10605,76,49,7406.91,14061.12,0.00
2024-12-10 17:26:42,125,10606,76,49,7390.48,14062.00,0.00
2024-12-10 17:26:42,126,10606,77,49,7331.82,14062.01,0.00
2024-12-10 17:26:42,125,10606,76,49,7374.78,14062.11,0.00
2024-12-10 17:26:42,125,10607,76,49,7470.72,14063.00,0.00
2024-12-10 17:26:42,126,10607,76,50,7411.43,14063.01,0.00
2024-12-10 17:26:42,125,10607,75,50,7455.02,14063.11,0.00
2024-12-10 17:26:42,125,10608,75,50,7439.00,14064.00,0.00
2024-12-10 17:26:42,126,10608,75,51,7379.96,14064.01,0.00
2024-12-10 17:26:42,125,10608,74,51,7423.30,14064.11,0.00
2024-12-10 17:26:42,125,10609,74,51,7406.94,14065.00,0.00
2024-12-10 17:26:42,126,10609,74,52,7348.16,14065.01,0.00
2024-12-10 17:26:42,125,10609,73,52,7391.24,14065.11,0.00
2024-12-10 17:26:42,125,10610,73,52,7374.38,14066.00,0.00
2024-12-10 17:26:42,126,10610,74,52,7315.85,14066.01,0.00
2024-12-10 17:26:42,125,10610,73,52,7358.67,14066.11,0.00
2024-12-10 17:26:42,126,10609,74,52,7196.57,14066.83,0.00
2024-12-10 17:26:42,127,10608,75,52,7151.07,14066.92,0.00
2024-12-10 17:26:42,127,10609,75,52,7260.80,14067.00,0.00
2024-12-10 17:26:42,128,10609,75,53,7204.07,14067.01,0.00
2024-12-10 17:26:42,127,10609,75,52,7245.33,14067.11,0.00
2024-12-10 17:26:42,127,10610,75,52,7445.56,14068.00,0.00
2024-12-10 17:26:42,128,10610,76,52,7387.39,14068.01,0.00
2024-12-10 17:26:42,128,10611,76,52,7349.32,14069.00,0.00
2024-12-10 17:26:42,129,10611,77,52,7292.35,14069.01,0.00
2024-12-10 17:26:42,128,10611,76,52,7333.98,14069.11,0.00
2024-12-10 17:26:42,128,10612,76,52,7309.68,14070.00,0.00
2024-12-10 17:26:42,129,10612,76,53,7253.02,14070.01,0.00
2024-12-10 17:26:42,129,10613,76,53,7212.99,14071.00,0.00
2024-12-10 17:26:42,130,10613,76,54,7157.51,14071.01,0.00
2024-12-10 17:26:42,129,10613,75,54,7206.41,14071.05,0.00
2024-12-10 17:26:42,128,10613,74,54,7250.76,14071.11,0.00
2024-12-10 17:26:42,128,10614,74,54,7225.10,14072.00,0.00
2024-12-10 17:26:42,129,10614,74,55,7169.09,14072.01,0.00
2024-12-10 17:26:42,128,10614,74,54,7145.49,14072.52,0.00
2024-12-10 17:26:42,128,10615,74,54,7187.62,14073.00,0.00
2024-12-10 17:26:42,129,10615,75,54,7131.91,14073.01,0.00
2024-12-10 17:26:42,128,10615,74,54,7168.28,14073.11,0.00
2024-12-10 17:26:42,128,10616,74,54,7147.44,14074.00,0.00
2024-12-10 17:26:42,129,10616,75,54,7092.03,14074.01,0.00
2024-12-10 17:26:42,128,10616,74,54,7127.89,14074.11,0.00
2024-12-10 17:26:42,127,10616,73,54,7174.68,14074.17,0.00
2024-12-10 17:26:42,128,10615,74,54,7060.50,14074.59,0.00
2024-12-10 17:26:42,128,10616,74,54,7159.78,14075.00,0.00
2024-12-10 17:26:42,129,10616,75,54,7104.28,14075.01,0.00
2024-12-10 17:26:43,129,10617,75,54,7178.49,14076.00,0.00
2024-12-10 17:26:43,130,10617,75,55,7123.27,14076.01,0.00
2024-12-10 17:26:43,129,10617,74,55,7157.90,14076.11,0.00
2024-12-10 17:26:43,129,10618,74,55,7142.01,14077.00,0.00
2024-12-10 17:26:43,130,10618,75,55,7087.07,14077.01,0.00
2024-12-10 17:26:43,129,10618,75,54,7121.48,14077.11,0.00
2024-12-10 17:26:43,129,10619,75,54,7105.58,14078.00,0.00
2024-12-10 17:26:43,130,10619,76,54,7050.92,14078.01,0.00
2024-12-10 17:26:43,129,10619,75,54,7085.74,14078.11,0.00
2024-12-10 17:26:43,129,10620,75,54,7069.84,14079.00,0.00
2024-12-10 17:26:43,130,10620,76,54,7015.46,14079.01,0.00
2024-12-10 17:26:43,129,10620,75,54,7064.40,14079.04,0.00
2024-12-10 17:26:43,128,10620,74,54,7108.00,14079.10,0.00
2024-12-10 17:26:43,127,10620,73,54,7162.86,14079.10,0.00
2024-12-10 17:26:43,127,10621,73,54,7147.82,14080.00,0.00
2024-12-10 17:26:43,128,10621,74,54,7091.97,14080.01,0.00
2024-12-10 17:26:43,127,10621,73,54,7133.43,14080.10,0.00
2024-12-10 17:26:43,128,10620,73,55,7004.18,14080.64,0.00
2024-12-10 17:26:43,128,10621,73,55,7107.88,14081.00,0.00
2024-12-10 17:26:43,129,10621,73,56,7052.78,14081.01,0.00
2024-12-10 17:26:43,130,10620,74,56,6998.53,14081.02,0.00
2024-12-10 17:26:43,130,10621,74,56,7151.76,14082.00,0.00
2024-12-10 17:26:43,131,10621,75,56,7097.17,14082.01,0.00
2024-12-10 17:26:43,130,10621,75,55,7138.79,14082.09,0.00
2024-12-10 17:26:43,129,10621,74,55,7193.04,14082.09,0.00
2024-12-10 17:26:43,129,10622,74,55,7283.22,14083.00,0.00
2024-12-10 17:26:43,130,10622,75,55,7227.19,14083.01,0.00
2024-12-10 17:26:43,130,10623,75,55,7193.65,14084.00,0.00
2024-12-10 17:26:43,131,10623,76,55,7138.74,14084.01,0.00
2024-12-10 17:26:43,131,10624,76,55,7102.54,14085.00,0.00
2024-12-10 17:26:43,132,10624,76,56,7048.74,14085.01,0.00
2024-12-10 17:26:43,131,10624,76,55,7089.62,14085.09,0.00
2024-12-10 17:26:43,131,10625,76,55,7066.08,14086.00,0.00
2024-12-10 17:26:43,132,10625,77,55,7012.55,14086.01,0.00
2024-12-10 17:26:43,131,10625,77,54,7053.04,14086.09,0.00
2024-12-10 17:26:43,131,10626,77,54,7027.62,14087.00,0.00
2024-12-10 17:26:43,132,10626,78,54,6974.38,14087.01,0.00
2024-12-10 17:26:43,133,10625,79,54,6919.83,14087.04,0.00
2024-12-10 17:26:43,133,10626,79,54,6948.63,14088.00,0.00
2024-12-10 17:26:43,134,10626,80,54,6896.78,14088.01,0.00
2024-12-10 17:26:43,133,10626,79,54,6941.63,14088.04,0.00
2024-12-10 17:26:43,132,10626,79,53,6986.76,14088.09,0.00
2024-12-10 17:26:43,132,10627,79,53,7064.47,14089.00,0.00
2024-12-10 17:26:43,133,10627,80,53,7011.36,14089.01,0.00
2024-12-10 17:26:43,132,10627,79,53,7016.61,14089.30,0.00
2024-12-10 17:26:43,132,10628,79,53,7020.42,14090.00,0.00
2024-12-10 17:26:43,133,10628,80,53,6967.63,14090.01,0.00
2024-12-10 17:26:43,134,10627,81,53,6913.54,14090.04,0.00
2024-12-10 17:26:43,135,10626,82,53,6742.39,14090.87,0.00
2024-12-10 17:26:43,135,10627,82,53,6843.75,14091.00,0.00
2024-12-10 17:26:43,136,10627,82,54,6793.43,14091.01,0.00
2024-12-10 17:26:43,135,10627,81,54,6827.36,14091.10,0.00
2024-12-10 17:26:43,135,10628,81,54,7006.34,14092.00,0.00
2024-12-10 17:26:43,136,10628,82,54,6954.82,14092.01,0.00
2024-12-10 17:26:43,135,10628,81,54,6987.33,14092.10,0.00
2024-12-10 17:26:43,135,10629,81,54,6960.99,14093.00,0.00
2024-12-10 17:26:43,136,10629,82,54,6909.81,14093.01,0.00
2024-12-10 17:26:43,135,10629,81,54,6942.73,14093.07,0.00
2024-12-10 17:26:43,134,10629,81,53,6991.39,14093.09,0.00
2024-12-10 17:26:43,133,10629,81,52,7042.90,14093.09,0.00
2024-12-10 17:26:43,133,10630,81,52,7017.99,14094.00,0.00
2024-12-10 17:26:43,134,10630,82,52,6965.61,14094.01,0.00
2024-12-10 17:26:43,133,10630,81,52,6996.71,14094.09,0.00
2024-12-10 17:26:43,133,10631,81,52,6970.66,14095.00,0.00
2024-12-10 17:26:43,134,10631,82,52,6918.64,14095.01,0.00
2024-12-10 17:26:43,133,10631,82,51,6951.41,14095.09,0.00
2024-12-10 17:26:43,133,10632,82,51,6924.01,14096.00,0.00
2024-12-10 17:26:43,134,10632,83,51,6872.34,14096.01,0.00
2024-12-10 17:26:43,133,10632,82,51,6906.84,14096.09,0.00
2024-12-10 17:26:43,132,10632,81,51,6954.51,14096.12,0.00
2024-12-10 17:26:43,131,10632,80,51,6961.50,14096.44,0.00
2024-12-10 17:26:43,131,10633,80,51,6984.66,14097.00,0.00
2024-12-10 17:26:43,132,10633,80,52,6931.74,14097.01,0.00
2024-12-10 17:26:43,131,10633,80,51,6979.30,14097.04,0.00
2024-12-10 17:26:43,130,10633,79,51,7025.40,14097.08,0.00
2024-12-10 17:26:43,129,10633,79,50,7078.77,14097.08,0.00
2024-12-10 17:26:43,129,10634,79,50,7051.65,14098.00,0.00
2024-12-10 17:26:43,130,10634,80,50,6997.40,14098.01,0.00
2024-12-10 17:26:43,129,10634,79,50,7039.65,14098.08,0.00
2024-12-10 17:26:44,129,10635,79,50,7011.35,14099.00,0.00
2024-12-10 17:26:44,130,10635,79,51,6957.41,14099.01,0.00
2024-12-10 17:26:44,129,10635,78,51,7005.90,14099.04,0.00
2024-12-10 17:26:44,128,10635,78,50,7060.49,14099.04,0.00
2024-12-10 17:26:44,127,10635,78,49,7110.54,14099.07,0.00
2024-12-10 17:26:44,126,10635,77,49,7165.85,14099.07,0.00
2024-12-10 17:26:44,125,10635,77,48,7164.39,14099.41,0.00
2024-12-10 17:26:44,125,10636,77,48,7194.13,14100.00,0.00
2024-12-10 17:26:44,126,10636,77,49,7137.03,14100.01,0.00
2024-12-10 17:26:44,125,10636,76,49,7187.38,14100.05,0.00
2024-12-10 17:26:44,124,10636,76,48,7241.94,14100.06,0.00
2024-12-10 17:26:44,123,10636,75,48,7299.67,14100.07,0.00
2024-12-10 17:26:44,124,10635,75,49,7133.91,14100.83,0.00
2024-12-10 17:26:44,124,10636,75,49,7244.37,14101.00,0.00
2024-12-10 17:26:44,125,10636,75,50,7186.41,14101.01,0.00
2024-12-10 17:26:44,124,10636,74,50,7235.30,14101.06,0.00
2024-12-10 17:26:44,124,10637,74,50,7329.67,14102.00,0.00
2024-12-10 17:26:44,125,10637,75,50,7271.03,14102.01,0.00
2024-12-10 17:26:44,124,10637,75,49,7320.60,14102.06,0.00
2024-12-10 17:26:44,124,10638,75,49,7301.11,14103.00,0.00
2024-12-10 17:26:44,125,10638,75,50,7242.70,14103.01,0.00
2024-12-10 17:26:44,124,10638,75,49,7292.03,14103.06,0.00
2024-12-10 17:26:44,123,10638,74,49,7340.13,14103.13,0.00
2024-12-10 17:26:44,123,10639,74,49,7332.60,14104.00,0.00
2024-12-10 17:26:44,124,10639,75,49,7273.46,14104.01,0.00
2024-12-10 17:26:44,123,10639,75,48,7323.45,14104.07,0.00
2024-12-10 17:26:44,123,10640,75,48,7306.74,14105.00,0.00
2024-12-10 17:26:44,124,10640,76,48,7247.82,14105.01,0.00
2024-12-10 17:26:44,123,10640,76,47,7297.59,14105.07,0.00
2024-12-10 17:26:44,123,10641,76,47,7280.88,14106.00,0.00
2024-12-10 17:26:44,124,10641,77,47,7222.17,14106.01,0.00
2024-12-10 17:26:44,123,10641,77,46,7271.73,14106.07,0.00
2024-12-10 17:26:44,124,10640,77,47,7159.72,14106.46,0.00
2024-12-10 17:26:44,124,10641,77,47,7262.50,14107.00,0.00
2024-12-10 17:26:44,125,10641,78,47,7204.40,14107.01,0.00
2024-12-10 17:26:44,124,10641,77,47,7253.42,14107.06,0.00
2024-12-10 17:26:44,123,10641,76,47,7295.98,14107.18,0.00
2024-12-10 17:26:44,124,10640,76,48,7164.56,14107.71,0.00
2024-12-10 17:26:44,124,10641,76,48,7384.39,14108.00,0.00
2024-12-10 17:26:44,125,10641,77,48,7325.31,14108.01,0.00
2024-12-10 17:26:44,124,10641,76,48,7375.31,14108.06,0.00
2024-12-10 17:26:44,124,10642,76,48,7471.39,14109.00,0.00
2024-12-10 17:26:44,125,10642,77,48,7411.62,14109.01,0.00
2024-12-10 17:26:44,124,10642,76,48,7462.31,14109.06,0.00
2024-12-10 17:26:44,124,10643,76,48,7444.61,14110.00,0.00
2024-12-10 17:26:44,125,10643,76,49,7385.05,14110.01,0.00
2024-12-10 17:26:44,124,10643,75,49,7435.53,14110.06,0.00
2024-12-10 17:26:44,124,10644,75,49,7417.82,14111.00,0.00
2024-12-10 17:26:44,125,10644,75,50,7358.48,14111.01,0.00
2024-12-10 17:26:44,124,10644,74,50,7408.74,14111.06,0.00
2024-12-10 17:26:44,124,10645,74,50,7391.04,14112.00,0.00
2024-12-10 17:26:44,125,10645,75,50,7331.91,14112.01,0.00
2024-12-10 17:26:44,125,10646,75,50,7305.33,14113.00,0.00
2024-12-10 17:26:44,126,10646,76,50,7247.35,14113.01,0.00
2024-12-10 17:26:44,125,10646,76,49,7296.32,14113.06,0.00
2024-12-10 17:26:44,125,10647,76,49,7277.62,14114.00,0.00
2024-12-10 17:26:44,126,10647,76,50,7219.86,14114.01,0.00
2024-12-10 17:26:44,125,10647,75,50,7268.61,14114.06,0.00
2024-12-10 17:26:44,125,10648,75,50,7249.90,14115.00,0.00
2024-12-10 17:26:44,126,10648,75,51,7192.37,14115.01,0.00
2024-12-10 17:26:44,125,10648,75,50,7240.89,14115.06,0.00
2024-12-10 17:26:44,125,10649,75,50,7222.19,14116.00,0.00
2024-12-10 17:26:44,126,10649,75,51,7164.87,14116.01,0.00
2024-12-10 17:26:44,125,10649,75,50,7213.17,14116.06,0.00
2024-12-10 17:26:44,125,10650,75,50,7194.46,14117.00,0.00
2024-12-10 17:26:44,126,10650,76,50,7137.37,14117.01,0.00
2024-12-10 17:26:44,125,10650,76,49,7185.45,14117.06,0.00
2024-12-10 17:26:44,125,10651,76,49,7166.74,14118.00,0.00
2024-12-10 17:26:44,126,10651,77,49,7109.86,14118.01,0.00
2024-12-10 17:26:44,125,10651,76,49,7157.72,14118.06,0.00
2024-12-10 17:26:44,125,10652,76,49,7139.01,14119.00,0.00
2024-12-10 17:26:44,126,10652,76,50,7082.35,14119.01,0.00
2024-12-10 17:26:44,125,10652,75,50,7129.99,14119.06,0.00
2024-12-10 17:26:44,125,10653,75,50,7111.27,14120.00,0.00
2024-12-10 17:26:44,126,10653,75,51,7054.83,14120.01,0.00
2024-12-10 17:26:44,125,10653,75,50,7102.25,14120.06,0.00
2024-12-10 17:26:44,125,10654,75,50,7083.54,14121.00,0.00
2024-12-10 17:26:44,126,10654,76,50,7027.32,14121.01,0.00
2024-12-10 17:26:44,126,10655,76,50,6999.79,14122.00,0.00
2024-12-10 17:26:44,127,10655,76,51,6944.68,14122.01,0.00
2024-12-10 17:26:44,126,10655,75,51,6992.89,14122.05,0.00
2024-12-10 17:26:44,125,10655,74,51,7045.44,14122.06,0.00
2024-12-10 17:26:44,126,10654,75,51,6917.95,14122.59,0.00
2024-12-10 17:26:45,126,10654,75,51,6987.77,14123.00,0.00
2024-12-10 17:26:45,127,10654,75,52,6932.75,14123.01,0.00
2024-12-10 17:26:45,126,10654,74,52,6978.81,14123.06,0.00
2024-12-10 17:26:45,126,10655,74,52,7071.21,14124.00,0.00
2024-12-10 17:26:45,127,10655,74,53,7015.53,14124.01,0.00
2024-12-10 17:26:45,126,10655,73,53,7062.26,14124.06,0.00
2024-12-10 17:26:45,126,10656,73,53,7042.57,14125.00,0.00
2024-12-10 17:26:45,127,10656,73,54,6987.12,14125.01,0.00
2024-12-10 17:26:45,126,10656,72,54,7033.61,14125.06,0.00
2024-12-10 17:26:45,126,10657,72,54,7013.92,14126.00,0.00
2024-12-10 17:26:45,127,10657,73,54,6958.69,14126.01,0.00
2024-12-10 17:26:45,126,10657,72,54,7004.96,14126.06,0.00
2024-12-10 17:26:45,127,10656,72,55,6899.83,14126.43,0.00
2024-12-10 17:26:45,127,10657,72,55,6998.11,14127.00,0.00
2024-12-10 17:26:45,128,10657,72,56,6943.44,14127.01,0.00
2024-12-10 17:26:45,127,10657,72,55,6992.56,14127.04,0.00
2024-12-10 17:26:45,126,10657,72,54,7044.70,14127.06,0.00
2024-12-10 17:26:45,125,10657,72,53,7099.92,14127.06,0.00
2024-12-10 17:26:45,126,10656,73,53,6965.28,14127.63,0.00
2024-12-10 17:26:45,126,10657,73,53,7180.86,14128.00,0.00
2024-12-10 17:26:45,127,10657,73,54,7124.32,14128.01,0.00
2024-12-10 17:26:45,127,10658,73,54,7207.14,14129.00,0.00
2024-12-10 17:26:45,128,10658,74,54,7150.84,14129.01,0.00
2024-12-10 17:26:45,127,10658,74,53,7198.26,14129.06,0.00
2024-12-10 17:26:45,127,10659,74,53,7177.61,14130.00,0.00
2024-12-10 17:26:45,128,10659,74,54,7121.54,14130.01,0.00
2024-12-10 17:26:45,129,10658,75,54,7064.15,14130.04,0.00
2024-12-10 17:26:45,128,10658,75,53,7156.88,14130.07,0.00
2024-12-10 17:26:45,128,10659,75,53,7136.39,14131.00,0.00
2024-12-10 17:26:45,129,10659,76,53,7081.07,14131.01,0.00
2024-12-10 17:26:45,129,10660,76,53,7160.45,14132.00,0.00
2024-12-10 17:26:45,130,10660,77,53,7105.37,14132.01,0.00
2024-12-10 17:26:45,129,10660,77,52,7150.61,14132.07,0.00
2024-12-10 17:26:45,129,10661,77,52,7129.19,14133.00,0.00
2024-12-10 17:26:45,130,10661,78,52,7074.35,14133.01,0.00
2024-12-10 17:26:45,130,10662,78,52,7043.32,14134.00,0.00
2024-12-10 17:26:45,131,10662,79,52,6989.55,14134.01,0.00
2024-12-10 17:26:45,130,10662,79,51,7037.89,14134.04,0.00
2024-12-10 17:26:45,129,10662,78,51,7086.98,14134.07,0.00
2024-12-10 17:26:45,128,10662,77,51,7141.24,14134.07,0.00
2024-12-10 17:26:45,128,10663,77,51,7120.75,14135.00,0.00
2024-12-10 17:26:45,129,10663,78,51,7065.55,14135.01,0.00
2024-12-10 17:26:45,128,10663,78,50,7110.82,14135.07,0.00
2024-12-10 17:26:45,128,10664,78,50,7090.33,14136.00,0.00
2024-12-10 17:26:45,129,10664,79,50,7035.36,14136.01,0.00
2024-12-10 17:26:45,128,10664,78,50,7085.92,14136.03,0.00
2024-12-10 17:26:45,127,10664,77,50,7140.60,14136.03,0.00
2024-12-10 17:26:45,126,10664,76,50,7192.79,14136.06,0.00
2024-12-10 17:26:45,125,10664,75,50,7249.20,14136.06,0.00
2024-12-10 17:26:45,125,10665,75,50,7229.34,14137.00,0.00
2024-12-10 17:26:45,126,10665,75,51,7171.97,14137.01,0.00
2024-12-10 17:26:45,125,10665,74,51,7221.44,14137.06,0.00
2024-12-10 17:26:45,125,10666,74,51,7201.58,14138.00,0.00
2024-12-10 17:26:45,126,10666,74,52,7144.42,14138.01,0.00
2024-12-10 17:26:45,125,10666,74,51,7193.67,14138.06,0.00
2024-12-10 17:26:45,126,10665,74,52,7053.76,14138.66,0.00
2024-12-10 17:26:45,126,10666,74,52,7159.52,14139.00,0.00
2024-12-10 17:26:45,127,10666,75,52,7103.14,14139.01,0.00
2024-12-10 17:26:45,126,10666,75,51,7157.27,14139.02,0.00
2024-12-10 17:26:45,125,10666,74,51,7208.89,14139.05,0.00
2024-12-10 17:26:45,125,10667,74,51,7301.01,14140.00,0.00
2024-12-10 17:26:45,126,10667,75,51,7243.07,14140.01,0.00
2024-12-10 17:26:45,125,10667,75,50,7293.11,14140.06,0.00
2024-12-10 17:26:45,126,10666,75,51,7156.86,14140.63,0.00
2024-12-10 17:26:45,127,10665,75,52,7140.61,14140.66,0.00
2024-12-10 17:26:45,127,10666,75,52,7244.44,14141.00,0.00
2024-12-10 17:26:45,128,10666,76,52,7187.85,14141.01,0.00
2024-12-10 17:26:45,127,10666,76,51,7236.67,14141.05,0.00
2024-12-10 17:26:45,127,10667,76,51,7437.60,14142.00,0.00
2024-12-10 17:26:45,128,10667,77,51,7379.49,14142.01,0.00
2024-12-10 17:26:45,127,10667,77,50,7432.04,14142.04,0.00
2024-12-10 17:26:45,126,10667,77,49,7488.79,14142.05,0.00
2024-12-10 17:26:45,125,10667,76,49,7547.56,14142.05,0.00
2024-12-10 17:26:45,125,10668,76,49,7526.58,14143.00,0.00
2024-12-10 17:26:45,126,10668,77,49,7466.85,14143.01,0.00
2024-12-10 17:26:45,125,10668,77,48,7523.20,14143.02,0.00
2024-12-10 17:26:45,124,10668,77,47,7580.46,14143.04,0.00
2024-12-10 17:26:45,123,10668,76,47,7640.94,14143.04,0.00
2024-12-10 17:26:45,124,10667,76,48,7537.18,14143.35,0.00
2024-12-10 17:26:45,124,10668,76,48,7583.26,14144.00,0.00
2024-12-10 17:26:45,125,10668,76,49,7522.59,14144.01,0.00
2024-12-10 17:26:45,125,10669,76,49,7609.12,14145.00,0.00
2024-12-10 17:26:45,126,10669,77,49,7548.73,14145.01,0.00
2024-12-10 17:26:45,125,10669,76,49,7602.35,14145.05,0.00
2024-12-10 17:26:46,125,10670,76,49,7579.17,14146.00,0.00
2024-12-10 17:26:46,126,10670,77,49,7519.02,14146.01,0.00
2024-12-10 17:26:46,125,10670,76,49,7572.40,14146.05,0.00
2024-12-10 17:26:46,125,10671,76,49,7548.71,14147.00,0.00
2024-12-10 17:26:46,126,10671,76,50,7488.80,14147.01,0.00
2024-12-10 17:26:46,125,10671,75,50,7541.93,14147.05,0.00
2024-12-10 17:26:46,124,10671,74,50,7586.35,14147.16,0.00
2024-12-10 17:26:46,125,10670,75,50,7494.04,14147.40,0.00
2024-12-10 17:26:46,125,10671,75,50,7589.32,14148.00,0.00
2024-12-10 17:26:46,126,10671,76,50,7529.09,14148.01,0.00
2024-12-10 17:26:46,126,10672,76,50,7613.84,14149.00,0.00
2024-12-10 17:26:46,127,10672,76,51,7553.89,14149.01,0.00
2024-12-10 17:26:46,128,10671,76,52,7493.77,14149.03,0.00
2024-12-10 17:26:46,127,10671,75,52,7567.28,14149.06,0.00
2024-12-10 17:26:46,127,10672,75,52,7546.63,14150.00,0.00
2024-12-10 17:26:46,128,10672,75,53,7487.67,14150.01,0.00
2024-12-10 17:26:46,127,10672,75,52,7538.85,14150.05,0.00
2024-12-10 17:26:46,127,10673,75,52,7628.14,14151.00,0.00
2024-12-10 17:26:46,128,10673,75,53,7568.55,14151.01,0.00
2024-12-10 17:26:46,127,10673,74,53,7620.36,14151.05,0.00
2024-12-10 17:26:46,127,10674,74,53,7597.41,14152.00,0.00
2024-12-10 17:26:46,128,10674,75,53,7538.05,14152.01,0.00
2024-12-10 17:26:46,127,10674,74,53,7589.63,14152.05,0.00
2024-12-10 17:26:46,127,10675,74,53,7567.86,14153.00,0.00
2024-12-10 17:26:46,128,10675,75,53,7508.73,14153.01,0.00
2024-12-10 17:26:46,127,10675,74,53,7560.07,14153.05,0.00
2024-12-10 17:26:46,127,10676,74,53,7538.30,14154.00,0.00
2024-12-10 17:26:46,128,10676,74,54,7479.41,14154.01,0.00
2024-12-10 17:26:46,127,10676,73,54,7530.52,14154.05,0.00
2024-12-10 17:26:46,127,10677,73,54,7508.74,14155.00,0.00
2024-12-10 17:26:46,128,10677,73,55,7450.08,14155.01,0.00
2024-12-10 17:26:46,129,10676,74,55,7392.32,14155.02,0.00
2024-12-10 17:26:46,128,10676,73,55,7524.38,14155.06,0.00
2024-12-10 17:26:46,128,10677,73,55,7502.77,14156.00,0.00
2024-12-10 17:26:46,129,10677,73,56,7444.61,14156.01,0.00
2024-12-10 17:26:46,130,10676,74,56,7276.20,14156.81,0.00
2024-12-10 17:26:46,130,10677,74,56,7486.55,14157.00,0.00
2024-12-10 17:26:46,131,10677,74,57,7429.40,14157.01,0.00
2024-12-10 17:26:46,130,10677,74,56,7477.86,14157.06,0.00
2024-12-10 17:26:46,131,10676,74,57,7346.75,14157.57,0.00
2024-12-10 17:26:46,131,10677,74,57,7549.30,14158.00,0.00
2024-12-10 17:26:46,132,10677,74,58,7492.11,14158.01,0.00
2024-12-10 17:26:46,131,10677,74,57,7540.68,14158.06,0.00
2024-12-10 17:26:46,132,10676,75,57,7430.44,14158.42,0.00
2024-12-10 17:26:46,132,10677,75,57,7625.94,14159.00,0.00
2024-12-10 17:26:46,133,10677,76,57,7568.60,14159.01,0.00
2024-12-10 17:26:46,132,10677,76,56,7617.38,14159.06,0.00
2024-12-10 17:26:46,132,10678,76,56,7693.13,14160.00,0.00
2024-12-10 17:26:46,133,10678,77,56,7635.28,14160.01,0.00
2024-12-10 17:26:46,132,10678,77,55,7684.57,14160.06,0.00
2024-12-10 17:26:46,133,10677,78,55,7575.66,14160.41,0.00
2024-12-10 17:26:46,133,10678,78,55,7660.38,14161.00,0.00
2024-12-10 17:26:46,134,10678,79,55,7603.21,14161.01,0.00
2024-12-10 17:26:46,133,10678,78,55,7651.88,14161.06,0.00
2024-12-10 17:26:46,133,10679,78,55,7725.80,14162.00,0.00
2024-12-10 17:26:46,134,10679,78,56,7668.15,14162.01,0.00
2024-12-10 17:26:46,133,10679,77,56,7717.30,14162.06,0.00
2024-12-10 17:26:46,133,10680,77,56,7686.10,14163.00,0.00
2024-12-10 17:26:46,134,10680,78,56,7628.75,14163.01,0.00
2024-12-10 17:26:46,133,10680,78,55,7677.60,14163.06,0.00
2024-12-10 17:26:46,133,10681,78,55,7644.70,14164.00,0.00
2024-12-10 17:26:46,134,10681,79,55,7587.65,14164.01,0.00
2024-12-10 17:26:46,133,10681,79,54,7636.20,14164.06,0.00
2024-12-10 17:26:46,132,10681,78,54,7658.31,14164.30,0.00
2024-12-10 17:26:46,132,10682,78,54,7661.30,14165.00,0.00
2024-12-10 17:26:46,133,10682,78,55,7603.70,14165.01,0.00
2024-12-10 17:26:46,133,10683,78,55,7563.53,14166.00,0.00
2024-12-10 17:26:46,134,10683,78,56,7507.08,14166.01,0.00
2024-12-10 17:26:46,133,10683,77,56,7558.22,14166.04,0.00
2024-12-10 17:26:46,132,10683,76,56,7613.33,14166.05,0.00
2024-12-10 17:26:46,131,10683,75,56,7669.29,14166.05,0.00
2024-12-10 17:26:46,130,10683,74,56,7727.20,14166.05,0.00
2024-12-10 17:26:46,129,10683,73,56,7786.00,14166.05,0.00
2024-12-10 17:26:46,129,10684,73,56,7753.86,14167.00,0.00
2024-12-10 17:26:46,130,10684,74,56,7694.21,14167.01,0.00
2024-12-10 17:26:46,129,10684,74,55,7746.19,14167.05,0.00
2024-12-10 17:26:46,129,10685,74,55,7707.08,14168.00,0.00
2024-12-10 17:26:46,130,10685,74,56,7647.80,14168.01,0.00
2024-12-10 17:26:46,129,10685,73,56,7699.41,14168.05,0.00
2024-12-10 17:26:46,129,10686,73,56,7657.28,14169.00,0.00
2024-12-10 17:26:46,130,10686,74,56,7598.38,14169.01,0.00
2024-12-10 17:26:46,129,10686,73,56,7649.61,14169.05,0.00
2024-12-10 17:26:47,129,10687,73,56,7605.01,14170.00,0.00
2024-12-10 17:26:47,130,10687,74,56,7546.51,14170.01,0.00
2024-12-10 17:26:47,129,10687,74,55,7597.34,14170.05,0.00
2024-12-10 17:26:47,129,10688,74,55,7553.78,14171.00,0.00
2024-12-10 17:26:47,130,10688,74,56,7495.67,14171.01,0.00
2024-12-10 17:26:47,129,10688,74,55,7546.11,14171.05,0.00
2024-12-10 17:26:47,129,10689,74,55,7503.64,14172.00,0.00
2024-12-10 17:26:47,130,10689,75,55,7445.92,14172.01,0.00
2024-12-10 17:26:47,129,10689,75,54,7495.97,14172.05,0.00
2024-12-10 17:26:47,128,10689,75,53,7449.96,14172.79,0.00
2024-12-10 17:26:47,128,10690,75,53,7519.65,14173.00,0.00
2024-12-10 17:26:47,129,10690,76,53,7461.35,14173.01,0.00
2024-12-10 17:26:47,128,10690,75,53,7511.92,14173.05,0.00
2024-12-10 17:26:47,128,10691,75,53,7478.27,14174.00,0.00
2024-12-10 17:26:47,129,10691,76,53,7420.30,14174.01,0.00
2024-12-10 17:26:47,128,10691,75,53,7474.96,14174.02,0.00
2024-12-10 17:26:47,127,10691,74,53,7529.36,14174.05,0.00
2024-12-10 17:26:47,126,10691,73,53,7587.99,14174.05,0.00
2024-12-10 17:26:47,125,10691,73,52,7537.51,14174.78,0.00
2024-12-10 17:26:47,125,10692,73,52,7620.48,14175.00,0.00
2024-12-10 17:26:47,126,10692,74,52,7560.00,14175.01,0.00
2024-12-10 17:26:47,126,10693,74,52,7532.40,14176.00,0.00
2024-12-10 17:26:47,127,10693,74,53,7473.09,14176.01,0.00
2024-12-10 17:26:47,126,10693,74,52,7524.54,14176.06,0.00
2024-12-10 17:26:47,126,10694,74,52,7502.20,14177.00,0.00
2024-12-10 17:26:47,127,10694,75,52,7443.13,14177.01,0.00
2024-12-10 17:26:47,127,10695,75,52,7411.31,14178.00,0.00
2024-12-10 17:26:47,128,10695,75,53,7353.41,14178.01,0.00
2024-12-10 17:26:47,127,10695,74,53,7402.40,14178.06,0.00
2024-12-10 17:26:47,127,10696,74,53,7376.72,14179.00,0.00
2024-12-10 17:26:47,128,10696,75,53,7319.09,14179.01,0.00
2024-12-10 17:26:47,127,10696,74,53,7367.81,14179.06,0.00
2024-12-10 17:26:47,127,10697,74,53,7340.84,14180.00,0.00
2024-12-10 17:26:47,128,10697,75,53,7283.49,14180.01,0.00
2024-12-10 17:26:47,127,10697,75,52,7337.50,14180.02,0.00
2024-12-10 17:26:47,126,10697,74,52,7390.12,14180.06,0.00
2024-12-10 17:26:47,125,10697,74,51,7448.11,14180.06,0.00
2024-12-10 17:26:47,125,10698,74,51,7414.76,14181.00,0.00
2024-12-10 17:26:47,126,10698,74,52,7355.92,14181.01,0.00
2024-12-10 17:26:47,125,10698,74,51,7406.85,14181.06,0.00
2024-12-10 17:26:47,125,10699,74,51,7367.82,14182.00,0.00
2024-12-10 17:26:47,126,10699,74,52,7309.34,14182.01,0.00
2024-12-10 17:26:47,125,10699,73,52,7358.76,14182.06,0.00
2024-12-10 17:26:47,125,10700,73,52,7315.66,14183.00,0.00
2024-12-10 17:26:47,126,10700,74,52,7257.60,14183.01,0.00
2024-12-10 17:26:47,125,10700,73,52,7306.60,14183.06,0.00
2024-12-10 17:26:47,125,10701,73,52,7265.09,14184.00,0.00
2024-12-10 17:26:47,126,10701,74,52,7207.43,14184.01,0.00
2024-12-10 17:26:47,125,10701,73,52,7256.03,14184.06,0.00
2024-12-10 17:26:47,125,10702,73,52,7219.51,14185.00,0.00
2024-12-10 17:26:47,126,10702,73,53,7162.21,14185.01,0.00
2024-12-10 17:26:47,126,10703,73,53,7120.21,14186.00,0.00
2024-12-10 17:26:47,127,10703,74,53,7064.15,14186.01,0.00
2024-12-10 17:26:47,126,10703,73,53,7110.11,14186.07,0.00
2024-12-10 17:26:47,125,10703,73,52,7080.96,14186.66,0.00
2024-12-10 17:26:47,125,10704,73,52,7136.35,14187.00,0.00
2024-12-10 17:26:47,126,10704,74,52,7079.71,14187.01,0.00
2024-12-10 17:26:47,125,10704,73,52,7125.03,14187.08,0.00
2024-12-10 17:26:47,124,10704,73,51,7082.31,14187.73,0.00
2024-12-10 17:26:47,124,10705,73,51,7155.77,14188.00,0.00
2024-12-10 17:26:47,125,10705,74,51,7098.52,14188.01,0.00
2024-12-10 17:26:47,124,10705,73,51,7144.36,14188.08,0.00
2024-12-10 17:26:47,124,10706,73,51,7124.78,14189.00,0.00
2024-12-10 17:26:47,125,10706,73,52,7067.78,14189.01,0.00
2024-12-10 17:26:47,124,10706,72,52,7113.36,14189.08,0.00
2024-12-10 17:26:47,124,10706,72,52,7092.12,14190.00,0.00
2024-12-10 17:26:47,125,10706,72,53,7035.38,14190.01,0.00
2024-12-10 17:26:47,126,10705,72,54,6978.42,14190.03,0.00
2024-12-10 17:26:47,125,10705,71,54,7076.27,14190.05,0.00
2024-12-10 17:26:47,124,10705,70,54,7127.62,14190.08,0.00
2024-12-10 17:26:47,123,10705,69,54,7184.42,14190.08,0.00
2024-12-10 17:26:47,123,10706,69,54,7163.06,14191.00,0.00
2024-12-10 17:26:47,124,10706,69,55,7105.29,14191.01,0.00
2024-12-10 17:26:47,123,10706,69,54,7152.70,14191.07,0.00
2024-12-10 17:26:47,123,10707,69,54,7245.18,14192.00,0.00
2024-12-10 17:26:47,124,10707,70,54,7186.75,14192.01,0.00
2024-12-10 17:26:47,123,10707,69,54,7234.83,14192.07,0.00
2024-12-10 17:26:47,124,10706,69,55,7149.06,14192.28,0.00
2024-12-10 17:26:47,124,10707,69,55,7242.72,14193.00,0.00
2024-12-10 17:26:47,125,10707,70,55,7184.78,14193.01,0.00
2024-12-10 17:26:47,124,10707,69,55,7232.45,14193.07,0.00
2024-12-10 17:26:48,124,10708,69,55,7321.44,14194.00,0.00
2024-12-10 17:26:48,125,10708,69,56,7262.86,14194.01,0.00
2024-12-10 17:26:48,124,10708,68,56,7311.16,14194.07,0.00
2024-12-10 17:26:48,124,10709,68,56,7284.39,14195.00,0.00
2024-12-10 17:26:48,125,10709,69,56,7226.12,14195.01,0.00
2024-12-10 17:26:48,124,10709,68,56,7274.11,14195.07,0.00
2024-12-10 17:26:48,124,10710,68,56,7246.08,14196.00,0.00
2024-12-10 17:26:48,125,10710,69,56,7188.11,14196.01,0.00
2024-12-10 17:26:48,125,10711,69,56,7148.37,14197.00,0.00
2024-12-10 17:26:48,126,10711,69,57,7091.63,14197.01,0.00
2024-12-10 17:26:48,125,10711,69,56,7137.04,14197.08,0.00
2024-12-10 17:26:48,125,10712,69,56,7105.41,14198.00,0.00
2024-12-10 17:26:48,126,10712,70,56,7049.01,14198.01,0.00
2024-12-10 17:26:48,126,10713,70,56,7004.06,14199.00,0.00
2024-12-10 17:26:48,127,10713,70,57,6948.92,14199.01,0.00
2024-12-10 17:26:48,126,10713,70,56,6991.70,14199.09,0.00
2024-12-10 17:26:48,125,10713,70,55,6936.18,14199.74,0.00
2024-12-10 17:26:48,125,10714,70,55,7013.64,14200.00,0.00
2024-12-10 17:26:48,126,10714,71,55,6957.98,14200.01,0.00
2024-12-10 17:26:48,125,10714,70,55,7006.84,14200.05,0.00
2024-12-10 17:26:48,125,10715,70,55,6971.04,14201.00,0.00
2024-12-10 17:26:48,126,10715,70,56,6915.71,14201.01,0.00
2024-12-10 17:26:48,125,10715,70,55,6957.44,14201.10,0.00
2024-12-10 17:26:48,124,10715,70,54,6922.07,14201.69,0.00
2024-12-10 17:26:48,124,10716,70,54,6992.19,14202.00,0.00
2024-12-10 17:26:48,125,10716,70,55,6936.25,14202.01,0.00
2024-12-10 17:26:48,124,10716,69,55,6978.48,14202.10,0.00
2024-12-10 17:26:48,124,10717,69,55,6965.19,14203.00,0.00
2024-12-10 17:26:48,125,10717,70,55,6909.47,14203.01,0.00
2024-12-10 17:26:48,126,10716,71,55,6795.00,14203.44,0.00
2024-12-10 17:26:48,126,10717,71,55,6901.34,14204.00,0.00
2024-12-10 17:26:48,127,10717,71,56,6846.99,14204.01,0.00
2024-12-10 17:26:48,126,10717,70,56,6886.72,14204.10,0.00
2024-12-10 17:26:48,126,10718,70,56,6985.25,14205.00,0.00
2024-12-10 17:26:48,127,10718,71,56,6930.25,14205.01,0.00
2024-12-10 17:26:48,128,10717,72,56,6865.04,14205.10,0.00
2024-12-10 17:26:48,127,10717,71,56,6990.69,14205.11,0.00
2024-12-10 17:26:48,127,10718,71,56,6975.99,14206.00,0.00
2024-12-10 17:26:48,128,10718,72,56,6921.49,14206.01,0.00
2024-12-10 17:26:48,127,10718,72,55,6972.64,14206.02,0.00
2024-12-10 17:26:48,126,10718,71,55,7016.74,14206.10,0.00
2024-12-10 17:26:48,125,10718,71,54,7071.74,14206.10,0.00
2024-12-10 17:26:48,125,10719,71,54,7166.32,14207.00,0.00
2024-12-10 17:26:48,126,10719,71,55,7109.45,14207.01,0.00
2024-12-10 17:26:48,125,10719,70,55,7152.73,14207.10,0.00
2024-12-10 17:26:48,124,10719,70,54,7209.26,14207.10,0.00
2024-12-10 17:26:48,124,10720,70,54,7187.20,14208.00,0.00
2024-12-10 17:26:48,125,10720,70,55,7129.70,14208.01,0.00
2024-12-10 17:26:48,124,10720,69,55,7173.49,14208.10,0.00
2024-12-10 17:26:48,124,10721,69,55,7149.99,14209.00,0.00
2024-12-10 17:26:48,125,10721,69,56,7092.79,14209.01,0.00
2024-12-10 17:26:48,126,10720,70,56,7035.37,14209.03,0.00
2024-12-10 17:26:48,125,10720,69,56,7100.79,14209.10,0.00
2024-12-10 17:26:48,125,10721,69,56,7077.38,14210.00,0.00
2024-12-10 17:26:48,126,10721,70,56,7021.22,14210.01,0.00
2024-12-10 17:26:48,127,10720,71,56,6965.93,14210.02,0.00
2024-12-10 17:26:48,126,10720,71,55,7069.75,14210.10,0.00
2024-12-10 17:26:48,126,10721,71,55,7158.36,14211.00,0.00
2024-12-10 17:26:48,127,10721,72,55,7102.00,14211.01,0.00
2024-12-10 17:26:48,126,10721,72,54,7144.87,14211.10,0.00
2024-12-10 17:26:48,126,10722,72,54,7232.90,14212.00,0.00
2024-12-10 17:26:48,127,10722,73,54,7175.95,14212.01,0.00
2024-12-10 17:26:48,127,10723,73,54,7139.77,14213.00,0.00
2024-12-10 17:26:48,128,10723,74,54,7083.99,14213.01,0.00
2024-12-10 17:26:48,127,10723,73,54,7125.26,14213.10,0.00
2024-12-10 17:26:48,126,10723,72,54,7110.07,14213.60,0.00
2024-12-10 17:26:48,126,10723,72,54,7166.79,14214.00,0.00
2024-12-10 17:26:48,127,10723,72,55,7110.35,14214.01,0.00
2024-12-10 17:26:48,127,10724,72,55,7081.75,14215.00,0.00
2024-12-10 17:26:48,128,10724,72,56,7026.43,14215.01,0.00
2024-12-10 17:26:48,127,10724,72,55,7066.13,14215.11,0.00
2024-12-10 17:26:48,127,10725,72,55,7052.03,14216.00,0.00
2024-12-10 17:26:48,128,10725,73,55,6996.93,14216.01,0.00
2024-12-10 17:26:48,129,10724,73,56,6940.50,14216.04,0.00
2024-12-10 17:26:48,128,10724,73,55,7081.40,14216.12,0.00
2024-12-10 17:26:48,128,10725,73,55,7067.40,14217.00,0.00
2024-12-10 17:26:48,129,10725,74,55,7012.61,14217.01,0.00
2024-12-10 17:26:48,128,10725,73,55,7051.90,14217.11,0.00
2024-12-10 17:26:48,128,10726,73,55,7147.87,14218.00,0.00
2024-12-10 17:26:48,129,10726,74,55,7092.46,14218.01,0.00
2024-12-10 17:26:48,128,10726,73,55,7132.37,14218.11,0.00
2024-12-10 17:26:49,128,10727,73,55,7117.27,14219.00,0.00
2024-12-10 17:26:49,129,10727,73,56,7062.10,14219.01,0.00
2024-12-10 17:26:49,128,10727,73,55,7101.77,14219.11,0.00
2024-12-10 17:26:49,128,10728,73,55,7086.67,14220.00,0.00
2024-12-10 17:26:49,129,10728,74,55,7031.73,14220.01,0.00
2024-12-10 17:26:49,128,10728,74,54,7071.16,14220.11,0.00
2024-12-10 17:26:49,128,10729,74,54,7055.21,14221.00,0.00
2024-12-10 17:26:49,129,10729,75,54,7000.52,14221.01,0.00
2024-12-10 17:26:49,128,10729,74,54,7039.70,14221.11,0.00
2024-12-10 17:26:49,128,10730,74,54,7023.12,14222.00,0.00
2024-12-10 17:26:49,129,10730,75,54,6968.68,14222.01,0.00
2024-12-10 17:26:49,128,10730,75,53,7007.61,14222.11,0.00
2024-12-10 17:26:49,127,10730,74,53,7061.67,14222.11,0.00
2024-12-10 17:26:49,127,10731,74,53,7044.99,14223.00,0.00
2024-12-10 17:26:49,128,10731,74,54,6989.95,14223.01,0.00
2024-12-10 17:26:49,127,10731,74,53,7029.36,14223.11,0.00
2024-12-10 17:26:49,127,10732,74,53,7010.22,14224.00,0.00
2024-12-10 17:26:49,128,10732,75,53,6955.45,14224.01,0.00
2024-12-10 17:26:49,129,10731,76,53,6888.34,14224.12,0.00
2024-12-10 17:26:49,128,10731,76,52,6975.50,14224.12,0.00
2024-12-10 17:26:49,127,10731,75,52,7016.63,14224.20,0.00
2024-12-10 17:26:49,127,10732,75,52,7010.69,14225.00,0.00
2024-12-10 17:26:49,128,10732,75,53,6955.92,14225.01,0.00
2024-12-10 17:26:49,127,10732,75,52,6995.05,14225.11,0.00
2024-12-10 17:26:49,127,10733,75,52,7086.55,14226.00,0.00
2024-12-10 17:26:49,128,10733,76,52,7031.18,14226.01,0.00
2024-12-10 17:26:49,127,10733,75,52,7070.91,14226.11,0.00
2024-12-10 17:26:49,126,10733,75,51,7125.90,14226.11,0.00
2024-12-10 17:26:49,126,10734,75,51,7101.29,14227.00,0.00
2024-12-10 17:26:49,127,10734,75,52,7045.37,14227.01,0.00
2024-12-10 17:26:49,126,10734,74,52,7094.53,14227.05,0.00
2024-12-10 17:26:49,125,10734,74,51,7142.21,14227.10,0.00
2024-12-10 17:26:49,124,10734,73,51,7198.66,14227.10,0.00
2024-12-10 17:26:49,124,10735,73,51,7167.52,14228.00,0.00
2024-12-10 17:26:49,125,10735,73,52,7110.18,14228.01,0.00
2024-12-10 17:26:49,124,10735,73,51,7152.65,14228.10,0.00
2024-12-10 17:26:49,124,10736,73,51,7113.73,14229.00,0.00
2024-12-10 17:26:49,125,10736,73,52,7056.82,14229.01,0.00
2024-12-10 17:26:49,124,10736,72,52,7098.86,14229.10,0.00
2024-12-10 17:26:49,123,10736,72,51,7111.23,14229.36,0.00
2024-12-10 17:26:49,122,10736,71,51,7154.27,14229.46,0.00
2024-12-10 17:26:49,122,10737,71,51,7194.31,14230.00,0.00
2024-12-10 17:26:49,123,10737,72,51,7135.82,14230.01,0.00
2024-12-10 17:26:49,122,10737,72,50,7179.19,14230.11,0.00
2024-12-10 17:26:49,121,10737,71,50,7237.35,14230.11,0.00
2024-12-10 17:26:49,121,10738,71,50,7228.40,14231.00,0.00
2024-12-10 17:26:49,122,10738,72,50,7169.15,14231.01,0.00
2024-12-10 17:26:49,121,10738,71,50,7213.16,14231.11,0.00
2024-12-10 17:26:49,121,10739,71,50,7204.21,14232.00,0.00
2024-12-10 17:26:49,122,10739,71,51,7145.16,14232.01,0.00
2024-12-10 17:26:49,122,10740,71,51,7121.16,14233.00,0.00
2024-12-10 17:26:49,123,10740,71,52,7063.27,14233.01,0.00
2024-12-10 17:26:49,122,10740,70,52,7106.04,14233.11,0.00
2024-12-10 17:26:49,122,10741,70,52,7095.99,14234.00,0.00
2024-12-10 17:26:49,123,10741,70,53,7038.30,14234.01,0.00
2024-12-10 17:26:49,122,10741,69,53,7080.87,14234.11,0.00
2024-12-10 17:26:49,123,10740,70,53,6995.55,14234.32,0.00
2024-12-10 17:26:49,123,10741,70,53,7104.76,14235.00,0.00
2024-12-10 17:26:49,124,10741,70,54,7047.47,14235.01,0.00
2024-12-10 17:26:49,123,10741,69,54,7089.76,14235.11,0.00
2024-12-10 17:26:49,123,10742,69,54,7194.38,14236.00,0.00
2024-12-10 17:26:49,124,10742,69,55,7136.36,14236.01,0.00
2024-12-10 17:26:49,125,10741,70,55,7079.27,14236.02,0.00
2024-12-10 17:26:49,124,10741,69,55,7151.33,14236.11,0.00
2024-12-10 17:26:49,124,10742,69,55,7140.31,14237.00,0.00
2024-12-10 17:26:49,125,10742,69,56,7083.19,14237.01,0.00
2024-12-10 17:26:49,125,10743,69,56,7170.25,14238.00,0.00
2024-12-10 17:26:49,126,10743,69,57,7113.35,14238.01,0.00
2024-12-10 17:26:49,125,10743,69,56,7154.35,14238.11,0.00
2024-12-10 17:26:49,125,10744,69,56,7142.28,14239.00,0.00
2024-12-10 17:26:49,126,10744,69,57,7085.59,14239.01,0.00
2024-12-10 17:26:49,125,10744,68,57,7125.24,14239.12,0.00
2024-12-10 17:26:49,126,10743,68,58,6986.40,14239.71,0.00
2024-12-10 17:26:49,126,10744,68,58,7092.87,14240.00,0.00
2024-12-10 17:26:49,127,10744,68,59,7037.02,14240.01,0.00
2024-12-10 17:26:49,126,10744,68,58,7083.85,14240.06,0.00
2024-12-10 17:26:49,125,10744,68,57,7138.25,14240.07,0.00
2024-12-10 17:26:49,124,10744,67,57,7190.09,14240.10,0.00
2024-12-10 17:26:49,123,10744,67,56,7247.39,14240.11,0.00
2024-12-10 17:26:49,122,10744,67,55,7305.63,14240.11,0.00
2024-12-10 17:26:49,122,10745,67,55,7412.32,14241.00,0.00
2024-12-10 17:26:49,123,10745,67,56,7352.06,14241.01,0.00
2024-12-10 17:26:49,122,10745,66,56,7397.19,14241.11,0.00
2024-12-10 17:26:49,122,10746,66,56,7387.16,14242.00,0.00
2024-12-10 17:26:49,123,10746,67,56,7327.10,14242.01,0.00
2024-12-10 17:26:49,122,10746,66,56,7372.02,14242.11,0.00
2024-12-10 17:26:50,122,10747,66,56,7361.99,14243.00,0.00
2024-12-10 17:26:50,123,10747,67,56,7302.14,14243.01,0.00
2024-12-10 17:26:50,122,10747,66,56,7357.34,14243.03,0.00
2024-12-10 17:26:50,121,10747,65,56,7407.57,14243.10,0.00
2024-12-10 17:26:50,120,10747,65,55,7468.12,14243.10,0.00
2024-12-10 17:26:50,120,10748,65,55,7459.10,14244.00,0.00
2024-12-10 17:26:50,121,10748,66,55,7397.46,14244.01,0.00
2024-12-10 17:26:50,120,10748,66,54,7444.90,14244.10,0.00
2024-12-10 17:26:50,120,10749,66,54,7435.88,14245.00,0.00
2024-12-10 17:26:50,121,10749,67,54,7374.43,14245.01,0.00
2024-12-10 17:26:50,120,10749,66,54,7421.68,14245.10,0.00
2024-12-10 17:26:50,120,10750,66,54,7412.67,14246.00,0.00
2024-12-10 17:26:50,121,10750,67,54,7351.40,14246.01,0.00
2024-12-10 17:26:50,120,10750,66,54,7398.46,14246.10,0.00
2024-12-10 17:26:50,120,10751,66,54,7389.44,14247.00,0.00
2024-12-10 17:26:50,121,10751,67,54,7328.37,14247.01,0.00
2024-12-10 17:26:50,120,10751,67,53,7384.71,14247.03,0.00
2024-12-10 17:26:50,119,10751,66,53,7437.21,14247.09,0.00
2024-12-10 17:26:50,119,10752,66,53,7428.11,14248.00,0.00
2024-12-10 17:26:50,120,10752,67,53,7366.21,14248.01,0.00
2024-12-10 17:26:50,119,10752,66,53,7414.98,14248.09,0.00
2024-12-10 17:26:50,119,10753,66,53,7403.44,14249.00,0.00
2024-12-10 17:26:50,120,10753,66,54,7341.75,14249.01,0.00
2024-12-10 17:26:50,119,10753,66,53,7390.31,14249.09,0.00
2024-12-10 17:26:50,119,10754,66,53,7376.60,14250.00,0.00
2024-12-10 17:26:50,120,10754,67,53,7315.13,14250.01,0.00
2024-12-10 17:26:50,119,10754,67,52,7363.46,14250.09,0.00
2024-12-10 17:26:50,119,10755,67,52,7348.61,14251.00,0.00
2024-12-10 17:26:50,120,10755,68,52,7287.37,14251.01,0.00
2024-12-10 17:26:50,120,10756,68,52,7255.07,14252.00,0.00
2024-12-10 17:26:50,121,10756,68,53,7195.11,14252.01,0.00
2024-12-10 17:26:50,120,10756,67,53,7242.04,14252.09,0.00
2024-12-10 17:26:50,119,10756,66,53,7278.45,14252.19,0.00
2024-12-10 17:26:50,119,10757,66,53,7277.93,14253.00,0.00
2024-12-10 17:26:50,120,10757,66,54,7217.28,14253.01,0.00
2024-12-10 17:26:50,119,10757,65,54,7264.79,14253.09,0.00
2024-12-10 17:26:50,119,10758,65,54,7249.88,14254.00,0.00
2024-12-10 17:26:50,120,10758,66,54,7189.47,14254.01,0.00
2024-12-10 17:26:50,119,10758,66,53,7236.74,14254.09,0.00
2024-12-10 17:26:50,119,10759,66,53,7220.61,14255.00,0.00
2024-12-10 17:26:50,120,10759,67,53,7160.44,14255.01,0.00
2024-12-10 17:26:50,119,10759,67,52,7207.46,14255.09,0.00
2024-12-10 17:26:50,119,10760,67,52,7190.72,14256.00,0.00
2024-12-10 17:26:50,120,10760,67,53,7130.80,14256.01,0.00
2024-12-10 17:26:50,119,10760,67,52,7179.96,14256.08,0.00
2024-12-10 17:26:50,118,10760,66,52,7237.20,14256.09,0.00
2024-12-10 17:26:50,118,10761,66,52,7220.93,14257.00,0.00
2024-12-10 17:26:50,119,10761,66,53,7160.25,14257.01,0.00
2024-12-10 17:26:50,120,10760,67,53,7100.59,14257.03,0.00
2024-12-10 17:26:50,121,10759,68,53,7064.30,14257.05,0.00
2024-12-10 17:26:50,120,10759,67,53,7165.96,14257.08,0.00
2024-12-10 17:26:50,119,10759,67,52,7221.40,14257.10,0.00
2024-12-10 17:26:50,118,10759,66,52,7270.34,14257.18,0.00
2024-12-10 17:26:50,119,10758,66,53,7135.18,14257.71,0.00
2024-12-10 17:26:50,119,10759,66,53,7250.19,14258.00,0.00
2024-12-10 17:26:50,120,10759,67,53,7189.78,14258.01,0.00
2024-12-10 17:26:50,119,10759,66,53,7245.42,14258.03,0.00
2024-12-10 17:26:50,118,10759,66,52,7299.60,14258.08,0.00
2024-12-10 17:26:50,117,10759,65,52,7360.77,14258.08,0.00
2024-12-10 17:26:50,117,10760,65,52,7715.68,14259.00,0.00
2024-12-10 17:26:50,118,10760,65,53,7650.29,14259.01,0.00
2024-12-10 17:26:50,117,10760,64,53,7704.75,14259.08,0.00
2024-12-10 17:26:50,117,10761,64,53,7695.50,14260.00,0.00
2024-12-10 17:26:50,118,10761,64,54,7630.28,14260.01,0.00
2024-12-10 17:26:50,117,10761,63,54,7690.64,14260.03,0.00
2024-12-10 17:26:50,116,10761,62,54,7750.82,14260.07,0.00
2024-12-10 17:26:50,115,10761,61,54,7816.98,14260.07,0.00
2024-12-10 17:26:50,115,10762,61,54,7808.80,14261.00,0.00
2024-12-10 17:26:50,116,10762,61,55,7741.48,14261.01,0.00
2024-12-10 17:26:50,115,10762,60,55,7798.92,14261.07,0.00
2024-12-10 17:26:50,115,10763,60,55,7790.75,14262.00,0.00
2024-12-10 17:26:50,116,10763,61,55,7723.58,14262.01,0.00
2024-12-10 17:26:50,117,10762,62,55,7590.68,14262.50,0.00
2024-12-10 17:26:50,117,10763,62,55,7703.21,14263.00,0.00
2024-12-10 17:26:50,118,10763,62,56,7637.93,14263.01,0.00
2024-12-10 17:26:50,119,10762,62,57,7566.59,14263.08,0.00
2024-12-10 17:26:50,119,10763,62,57,7708.53,14264.00,0.00
2024-12-10 17:26:50,120,10763,63,57,7644.29,14264.01,0.00
2024-12-10 17:26:50,119,10763,62,57,7698.98,14264.07,0.00
2024-12-10 17:26:50,119,10764,62,57,7806.17,14265.00,0.00
2024-12-10 17:26:50,120,10764,63,57,7741.11,14265.01,0.00
2024-12-10 17:26:50,119,10764,63,56,7796.61,14265.07,0.00
2024-12-10 17:26:50,119,10765,63,56,7783.93,14266.00,0.00
2024-12-10 17:26:50,120,10765,63,57,7719.07,14266.01,0.00
2024-12-10 17:26:51,119,10765,63,56,7774.38,14266.07,0.00
2024-12-10 17:26:51,120,10764,64,56,7624.23,14266.68,0.00
2024-12-10 17:26:51,120,10765,64,56,7739.04,14267.00,0.00
2024-12-10 17:26:51,121,10765,64,57,7675.08,14267.01,0.00
2024-12-10 17:26:51,121,10766,64,57,7769.96,14268.00,0.00
2024-12-10 17:26:51,122,10766,64,58,7706.27,14268.01,0.00
2024-12-10 17:26:51,122,10767,64,58,7682.25,14269.00,0.00
2024-12-10 17:26:51,123,10767,65,58,7619.79,14269.01,0.00
2024-12-10 17:26:51,123,10768,65,58,7594.80,14270.00,0.00
2024-12-10 17:26:51,124,10768,65,59,7533.55,14270.01,0.00
2024-12-10 17:26:51,124,10769,65,59,7507.61,14271.00,0.00
2024-12-10 17:26:51,125,10769,65,60,7447.55,14271.01,0.00
2024-12-10 17:26:51,124,10769,65,59,7498.44,14271.06,0.00
2024-12-10 17:26:51,124,10770,65,59,7480.51,14272.00,0.00
2024-12-10 17:26:51,125,10770,66,59,7420.67,14272.01,0.00
2024-12-10 17:26:51,124,10770,65,59,7471.34,14272.06,0.00
2024-12-10 17:26:51,124,10771,65,59,7451.54,14273.00,0.00
2024-12-10 17:26:51,125,10771,65,60,7391.93,14273.01,0.00
2024-12-10 17:26:51,124,10771,64,60,7442.37,14273.06,0.00
2024-12-10 17:26:51,124,10772,64,60,7419.93,14274.00,0.00
2024-12-10 17:26:51,125,10772,65,60,7360.57,14274.01,0.00
2024-12-10 17:26:51,124,10772,64,60,7410.75,14274.06,0.00
2024-12-10 17:26:51,124,10773,64,60,7386.49,14275.00,0.00
2024-12-10 17:26:51,125,10773,65,60,7327.40,14275.01,0.00
2024-12-10 17:26:51,124,10773,64,60,7377.32,14275.06,0.00
2024-12-10 17:26:51,125,10772,64,61,7253.33,14275.54,0.00
2024-12-10 17:26:51,125,10773,64,61,7314.05,14276.00,0.00
2024-12-10 17:26:51,126,10773,64,62,7256.00,14276.01,0.00
2024-12-10 17:26:51,125,10773,64,61,7304.95,14276.06,0.00
2024-12-10 17:26:51,125,10774,64,61,7392.83,14277.00,0.00
2024-12-10 17:26:51,126,10774,64,62,7334.16,14277.01,0.00
2024-12-10 17:26:51,125,10774,63,62,7383.73,14277.06,0.00
2024-12-10 17:26:51,125,10775,63,62,7357.62,14278.00,0.00
2024-12-10 17:26:51,126,10775,63,63,7299.23,14278.01,0.00
2024-12-10 17:26:51,125,10775,63,62,7348.51,14278.06,0.00
2024-12-10 17:26:51,125,10776,63,62,7322.13,14279.00,0.00
2024-12-10 17:26:51,126,10776,63,63,7264.02,14279.01,0.00
2024-12-10 17:26:51,125,10776,62,63,7313.02,14279.06,0.00
2024-12-10 17:26:51,125,10777,62,63,7289.48,14280.00,0.00
2024-12-10 17:26:51,126,10777,62,64,7231.63,14280.01,0.00
2024-12-10 17:26:51,125,10777,61,64,7280.37,14280.06,0.00
2024-12-10 17:26:51,125,10778,61,64,7258.64,14281.00,0.00
2024-12-10 17:26:51,126,10778,62,64,7201.03,14281.01,0.00
2024-12-10 17:26:51,125,10778,62,63,7249.53,14281.06,0.00
2024-12-10 17:26:51,124,10778,61,63,7266.21,14281.35,0.00
2024-12-10 17:26:51,124,10779,61,63,7288.22,14282.00,0.00
2024-12-10 17:26:51,125,10779,61,64,7229.91,14282.01,0.00
2024-12-10 17:26:51,124,10779,61,63,7279.03,14282.06,0.00
2024-12-10 17:26:51,124,10780,61,63,7260.35,14283.00,0.00
2024-12-10 17:26:51,125,10780,62,63,7202.26,14283.01,0.00
2024-12-10 17:26:51,124,10780,61,63,7251.16,14283.06,0.00
2024-12-10 17:26:51,125,10779,62,63,7185.15,14283.14,0.00
2024-12-10 17:26:51,125,10780,62,63,7280.65,14284.00,0.00
2024-12-10 17:26:51,126,10780,63,63,7222.87,14284.01,0.00
2024-12-10 17:26:51,125,10780,62,63,7271.53,14284.06,0.00
2024-12-10 17:26:51,125,10781,62,63,7365.46,14285.00,0.00
2024-12-10 17:26:51,126,10781,62,64,7307.01,14285.01,0.00
2024-12-10 17:26:51,125,10781,62,63,7355.17,14285.06,0.00
2024-12-10 17:26:51,126,10780,62,64,7173.23,14285.92,0.00
2024-12-10 17:26:51,126,10781,62,64,7285.55,14286.00,0.00
2024-12-10 17:26:51,127,10781,63,64,7228.18,14286.01,0.00
2024-12-10 17:26:51,126,10781,62,64,7276.50,14286.06,0.00
2024-12-10 17:26:51,127,10780,63,64,7103.69,14286.83,0.00
2024-12-10 17:26:51,127,10781,63,64,7325.46,14287.00,0.00
2024-12-10 17:26:51,128,10781,63,65,7268.23,14287.01,0.00
2024-12-10 17:26:51,127,10781,62,65,7316.49,14287.06,0.00
2024-12-10 17:26:51,127,10782,62,65,7400.43,14288.00,0.00
2024-12-10 17:26:51,128,10782,62,66,7342.61,14288.01,0.00
2024-12-10 17:26:51,127,10782,61,66,7391.45,14288.06,0.00
2024-12-10 17:26:51,127,10783,61,66,7361.13,14289.00,0.00
2024-12-10 17:26:51,128,10783,62,66,7303.62,14289.01,0.00
2024-12-10 17:26:51,127,10783,62,65,7353.17,14289.06,0.00
2024-12-10 17:26:51,127,10784,62,65,7319.42,14290.00,0.00
2024-12-10 17:26:51,128,10784,62,66,7262.24,14290.01,0.00
2024-12-10 17:26:51,127,10784,62,65,7310.44,14290.06,0.00
2024-12-10 17:26:52,127,10785,62,65,7278.05,14291.00,0.00
2024-12-10 17:26:52,128,10785,63,65,7221.19,14291.01,0.00
2024-12-10 17:26:52,127,10785,63,64,7267.95,14291.07,0.00
2024-12-10 17:26:52,127,10786,63,64,7240.02,14292.00,0.00
2024-12-10 17:26:52,128,10786,64,64,7183.46,14292.01,0.00
2024-12-10 17:26:52,127,10786,63,64,7229.92,14292.07,0.00
2024-12-10 17:26:52,126,10786,63,63,7286.17,14292.07,0.00
2024-12-10 17:26:52,126,10787,63,63,7263.22,14293.00,0.00
2024-12-10 17:26:52,127,10787,63,64,7206.03,14293.01,0.00
2024-12-10 17:26:52,126,10787,62,64,7253.04,14293.07,0.00
2024-12-10 17:26:52,126,10788,62,64,7230.25,14294.00,0.00
2024-12-10 17:26:52,127,10788,63,64,7173.31,14294.01,0.00
2024-12-10 17:26:52,126,10788,63,63,7220.06,14294.07,0.00
2024-12-10 17:26:52,127,10787,64,63,7142.64,14294.22,0.00
2024-12-10 17:26:52,127,10788,64,63,7238.77,14295.00,0.00
2024-12-10 17:26:52,128,10788,64,64,7182.22,14295.01,0.00
2024-12-10 17:26:52,127,10788,63,64,7228.67,14295.07,0.00
2024-12-10 17:26:52,128,10787,64,64,7054.98,14295.89,0.00
2024-12-10 17:26:52,128,10788,64,64,7275.09,14296.00,0.00
2024-12-10 17:26:52,129,10788,64,65,7218.70,14296.01,0.00
2024-12-10 17:26:52,128,10788,63,65,7265.07,14296.07,0.00
2024-12-10 17:26:52,128,10789,63,65,7351.96,14297.00,0.00
2024-12-10 17:26:52,129,10789,63,66,7294.97,14297.01,0.00
2024-12-10 17:26:52,128,10789,63,65,7341.94,14297.07,0.00
2024-12-10 17:26:52,127,10789,62,65,7389.50,14297.14,0.00
2024-12-10 17:26:52,127,10790,62,65,7373.62,14298.00,0.00
2024-12-10 17:26:52,128,10790,62,66,7316.01,14298.01,0.00
2024-12-10 17:26:52,127,10790,61,66,7363.51,14298.07,0.00
2024-12-10 17:26:52,127,10791,61,66,7337.49,14299.00,0.00
2024-12-10 17:26:52,128,10791,61,67,7280.17,14299.01,0.00
2024-12-10 17:26:52,127,10791,61,66,7327.38,14299.07,0.00
2024-12-10 17:26:52,126,10791,60,66,7335.85,14299.38,0.00
2024-12-10 17:26:52,126,10792,60,66,7358.08,14300.00,0.00
2024-12-10 17:26:52,127,10792,60,67,7300.14,14300.01,0.00
2024-12-10 17:26:52,126,10792,59,67,7347.89,14300.07,0.00
2024-12-10 17:26:52,126,10793,59,67,7323.59,14301.00,0.00
2024-12-10 17:26:52,127,10793,59,68,7265.93,14301.01,0.00
2024-12-10 17:26:52,126,10793,59,67,7313.40,14301.07,0.00
2024-12-10 17:26:52,126,10794,59,67,7290.78,14302.00,0.00
2024-12-10 17:26:52,127,10794,59,68,7233.38,14302.01,0.00
2024-12-10 17:26:52,128,10793,60,68,7169.06,14302.08,0.00
2024-12-10 17:26:52,127,10793,60,67,7244.66,14302.08,0.00
2024-12-10 17:26:52,127,10794,60,67,7224.23,14303.00,0.00
2024-12-10 17:26:52,128,10794,61,67,7167.79,14303.01,0.00
2024-12-10 17:26:52,127,10794,61,66,7217.48,14303.05,0.00
2024-12-10 17:26:52,126,10794,60,66,7271.37,14303.06,0.00
2024-12-10 17:26:52,125,10794,59,66,7328.40,14303.06,0.00
2024-12-10 17:26:52,125,10795,59,66,7421.84,14304.00,0.00
2024-12-10 17:26:52,126,10795,60,66,7362.94,14304.01,0.00
2024-12-10 17:26:52,125,10795,60,65,7417.31,14304.03,0.00
2024-12-10 17:26:52,124,10795,60,64,7472.53,14304.06,0.00
2024-12-10 17:26:52,124,10796,60,64,7449.94,14305.00,0.00
2024-12-10 17:26:52,125,10796,61,64,7390.35,14305.01,0.00
2024-12-10 17:26:52,124,10796,60,64,7441.89,14305.06,0.00
2024-12-10 17:26:52,125,10795,60,65,7298.76,14305.64,0.00
2024-12-10 17:26:52,125,10796,60,65,7382.61,14306.00,0.00
2024-12-10 17:26:52,126,10796,60,66,7324.01,14306.01,0.00
2024-12-10 17:26:52,125,10796,59,66,7374.62,14306.06,0.00
2024-12-10 17:26:52,125,10797,59,66,7466.26,14307.00,0.00
2024-12-10 17:26:52,126,10797,60,66,7407.00,14307.01,0.00
2024-12-10 17:26:52,125,10797,60,65,7458.27,14307.06,0.00
2024-12-10 17:26:52,125,10798,60,65,7434.31,14308.00,0.00
2024-12-10 17:26:52,126,10798,60,66,7375.31,14308.01,0.00
2024-12-10 17:26:52,126,10799,60,66,7342.49,14309.00,0.00
2024-12-10 17:26:52,127,10799,60,67,7284.67,14309.01,0.00
2024-12-10 17:26:52,126,10799,59,67,7340.22,14309.02,0.00
2024-12-10 17:26:52,125,10799,59,66,7392.09,14309.06,0.00
2024-12-10 17:26:52,125,10800,59,66,7367.47,14310.00,0.00
2024-12-10 17:26:52,126,10800,60,66,7309.00,14310.01,0.00
2024-12-10 17:26:52,125,10800,59,66,7358.34,14310.06,0.00
2024-12-10 17:26:52,125,10801,59,66,7334.69,14311.00,0.00
2024-12-10 17:26:52,126,10801,60,66,7276.48,14311.01,0.00
2024-12-10 17:26:52,125,10801,59,66,7322.11,14311.07,0.00
2024-12-10 17:26:52,125,10802,59,66,7301.99,14312.00,0.00
2024-12-10 17:26:52,126,10802,59,67,7244.04,14312.01,0.00
2024-12-10 17:26:52,127,10801,60,67,7077.70,14312.76,0.00
2024-12-10 17:26:52,127,10802,60,67,7192.21,14313.00,0.00
2024-12-10 17:26:52,128,10802,60,68,7136.02,14313.01,0.00
2024-12-10 17:26:52,127,10802,59,68,7181.14,14313.07,0.00
2024-12-10 17:26:52,127,10803,59,68,7271.28,14314.00,0.00
2024-12-10 17:26:52,128,10803,60,68,7214.48,14314.01,0.00
2024-12-10 17:26:52,127,10803,60,67,7260.85,14314.07,0.00
2024-12-10 17:26:53,127,10804,60,67,7235.29,14315.00,0.00
2024-12-10 17:26:53,128,10804,60,68,7178.77,14315.01,0.00
2024-12-10 17:26:53,127,10804,60,67,7225.18,14315.07,0.00
2024-12-10 17:26:53,128,10803,61,67,7108.44,14315.51,0.00
2024-12-10 17:26:53,129,10802,61,68,7120.19,14315.53,0.00
2024-12-10 17:26:53,129,10803,61,68,7228.63,14316.00,0.00
2024-12-10 17:26:53,130,10803,62,68,7173.03,14316.01,0.00
2024-12-10 17:26:53,129,10803,61,68,7218.67,14316.07,0.00
2024-12-10 17:26:53,128,10803,61,67,7273.95,14316.07,0.00
2024-12-10 17:26:53,128,10804,61,67,7458.45,14317.00,0.00
2024-12-10 17:26:53,129,10804,61,68,7400.63,14317.01,0.00
2024-12-10 17:26:53,128,10804,60,68,7448.41,14317.07,0.00
2024-12-10 17:26:53,127,10804,59,68,7493.68,14317.14,0.00
2024-12-10 17:26:53,127,10805,59,68,7468.78,14318.00,0.00
2024-12-10 17:26:53,128,10805,60,68,7410.43,14318.01,0.00
2024-12-10 17:26:53,127,10805,59,68,7458.66,14318.07,0.00
2024-12-10 17:26:53,127,10806,59,68,7421.91,14319.00,0.00
2024-12-10 17:26:53,128,10806,59,69,7363.93,14319.01,0.00
2024-12-10 17:26:53,127,10806,59,68,7411.79,14319.07,0.00
2024-12-10 17:26:53,128,10805,60,68,7218.80,14319.98,0.00
2024-12-10 17:26:53,128,10806,60,68,7349.04,14320.00,0.00
2024-12-10 17:26:53,129,10806,61,68,7292.07,14320.01,0.00
2024-12-10 17:26:53,128,10806,60,68,7339.00,14320.07,0.00
2024-12-10 17:26:53,127,10806,59,68,7395.69,14320.07,0.00
2024-12-10 17:26:53,127,10807,59,68,7470.88,14321.00,0.00
2024-12-10 17:26:53,128,10807,59,69,7412.52,14321.01,0.00
2024-12-10 17:26:53,127,10807,58,69,7426.57,14321.28,0.00
2024-12-10 17:26:53,127,10808,58,69,7427.77,14322.00,0.00
2024-12-10 17:26:53,128,10808,59,69,7369.74,14322.01,0.00
2024-12-10 17:26:53,127,10808,58,69,7417.64,14322.07,0.00
2024-12-10 17:26:53,127,10809,58,69,7388.60,14323.00,0.00
2024-12-10 17:26:53,128,10809,58,70,7330.88,14323.01,0.00
2024-12-10 17:26:53,127,10809,58,69,7378.47,14323.07,0.00
2024-12-10 17:26:53,127,10810,58,69,7348.89,14324.00,0.00
2024-12-10 17:26:53,128,10810,59,69,7291.47,14324.01,0.00
2024-12-10 17:26:53,127,10810,59,68,7345.51,14324.02,0.00
2024-12-10 17:26:53,126,10810,58,68,7397.00,14324.06,0.00
2024-12-10 17:26:53,125,10810,57,68,7455.03,14324.06,0.00
2024-12-10 17:26:53,125,10811,57,68,7427.14,14325.00,0.00
2024-12-10 17:26:53,126,10811,58,68,7368.19,14325.01,0.00
2024-12-10 17:26:53,125,10811,58,67,7413.87,14325.06,0.00
2024-12-10 17:26:53,125,10812,58,67,7394.12,14326.00,0.00
2024-12-10 17:26:53,126,10812,58,68,7335.44,14326.01,0.00
2024-12-10 17:26:53,126,10813,58,68,7307.23,14327.00,0.00
2024-12-10 17:26:53,127,10813,59,68,7249.70,14327.01,0.00
2024-12-10 17:26:53,126,10813,59,67,7298.16,14327.06,0.00
2024-12-10 17:26:53,126,10814,59,67,7275.54,14328.00,0.00
2024-12-10 17:26:53,127,10814,60,67,7218.25,14328.01,0.00
2024-12-10 17:26:53,126,10814,60,66,7266.46,14328.06,0.00
2024-12-10 17:26:53,126,10815,60,66,7241.46,14329.00,0.00
2024-12-10 17:26:53,127,10815,61,66,7184.44,14329.01,0.00
2024-12-10 17:26:53,126,10815,61,65,7232.39,14329.06,0.00
2024-12-10 17:26:53,126,10816,61,65,7204.96,14330.00,0.00
2024-12-10 17:26:53,127,10816,62,65,7148.23,14330.01,0.00
2024-12-10 17:26:53,126,10816,61,65,7176.86,14330.06,0.00
2024-12-10 17:26:53,127,10815,61,66,7008.71,14330.84,0.00
2024-12-10 17:26:53,127,10816,61,66,7111.32,14331.00,0.00
2024-12-10 17:26:53,128,10816,61,67,7055.77,14331.01,0.00
2024-12-10 17:26:53,127,10816,60,67,7099.73,14331.01,0.00
2024-12-10 17:26:53,126,10816,59,67,7147.66,14331.06,0.00
2024-12-10 17:26:53,126,10817,59,67,7229.24,14332.00,0.00
2024-12-10 17:26:53,127,10817,59,68,7172.32,14332.01,0.00
2024-12-10 17:26:53,128,10816,60,68,7114.05,14332.04,0.00
2024-12-10 17:26:53,127,10816,60,67,7197.21,14332.06,0.00
2024-12-10 17:26:53,126,10816,60,66,7250.90,14332.09,0.00
2024-12-10 17:26:53,126,10817,60,66,7223.14,14333.00,0.00
2024-12-10 17:26:53,127,10817,60,67,7166.26,14333.01,0.00
2024-12-10 17:26:53,126,10817,59,67,7216.33,14333.05,0.00
2024-12-10 17:26:53,125,10817,59,66,7272.91,14333.05,0.00
2024-12-10 17:26:53,125,10818,59,66,7354.44,14334.00,0.00
2024-12-10 17:26:53,126,10818,59,67,7296.07,14334.01,0.00
2024-12-10 17:26:53,125,10818,59,66,7347.57,14334.05,0.00
2024-12-10 17:26:53,125,10819,59,66,7313.54,14335.00,0.00
2024-12-10 17:26:53,126,10819,60,66,7255.50,14335.01,0.00
2024-12-10 17:26:53,125,10819,60,65,7306.68,14335.05,0.00
2024-12-10 17:26:53,126,10818,61,65,7163.20,14335.61,0.00
2024-12-10 17:26:53,126,10819,61,65,7260.04,14336.00,0.00
2024-12-10 17:26:53,127,10819,61,66,7202.87,14336.01,0.00
2024-12-10 17:26:53,126,10819,60,66,7253.23,14336.05,0.00
2024-12-10 17:26:53,126,10819,60,66,7329.29,14337.00,0.00
2024-12-10 17:26:53,127,10819,60,67,7271.58,14337.01,0.00
2024-12-10 17:26:53,126,10819,60,66,7322.48,14337.05,0.00
2024-12-10 17:26:53,125,10819,60,65,7343.94,14337.29,0.00
2024-12-10 17:26:54,125,10820,60,65,7346.34,14338.00,0.00
2024-12-10 17:26:54,126,10820,60,66,7288.04,14338.01,0.00
2024-12-10 17:26:54,125,10820,60,65,7339.47,14338.05,0.00
2024-12-10 17:26:54,125,10821,60,65,7306.51,14339.00,0.00
2024-12-10 17:26:54,126,10821,61,65,7248.52,14339.01,0.00
2024-12-10 17:26:54,125,10821,61,64,7301.93,14339.03,0.00
2024-12-10 17:26:54,124,10821,61,63,7358.51,14339.04,0.00
2024-12-10 17:26:54,123,10821,61,62,7417.17,14339.04,0.00
2024-12-10 17:26:54,123,10822,61,62,7387.30,14340.00,0.00
2024-12-10 17:26:54,124,10822,61,63,7327.72,14340.01,0.00
2024-12-10 17:26:54,123,10822,61,62,7381.48,14340.04,0.00
2024-12-10 17:26:54,123,10823,61,62,7351.02,14341.00,0.00
2024-12-10 17:26:54,124,10823,62,62,7291.73,14341.01,0.00
2024-12-10 17:26:54,123,10823,62,61,7345.20,14341.04,0.00
2024-12-10 17:26:54,123,10824,62,61,7314.58,14342.00,0.00
2024-12-10 17:26:54,124,10824,63,61,7255.59,14342.01,0.00
2024-12-10 17:26:54,123,10824,62,61,7308.76,14342.04,0.00
2024-12-10 17:26:54,124,10823,63,61,7118.07,14342.90,0.00
2024-12-10 17:26:54,124,10824,63,61,7235.94,14343.00,0.00
2024-12-10 17:26:54,125,10824,64,61,7178.05,14343.01,0.00
2024-12-10 17:26:54,124,10824,63,61,7230.17,14343.04,0.00
2024-12-10 17:26:54,124,10825,63,61,7309.86,14344.00,0.00
2024-12-10 17:26:54,125,10825,63,62,7251.39,14344.01,0.00
2024-12-10 17:26:54,124,10825,62,62,7304.09,14344.04,0.00
2024-12-10 17:26:54,124,10826,62,62,7261.83,14345.00,0.00
2024-12-10 17:26:54,125,10826,62,63,7203.74,14345.01,0.00
2024-12-10 17:26:54,124,10826,61,63,7256.06,14345.04,0.00
2024-12-10 17:26:54,124,10827,61,63,7212.11,14346.00,0.00
2024-12-10 17:26:54,125,10827,61,64,7154.42,14346.01,0.00
2024-12-10 17:26:54,125,10828,61,64,7105.88,14347.00,0.00
2024-12-10 17:26:54,126,10828,61,65,7049.48,14347.01,0.00
2024-12-10 17:26:54,125,10828,60,65,7100.15,14347.04,0.00
2024-12-10 17:26:54,124,10828,59,65,7156.43,14347.04,0.00
2024-12-10 17:26:54,124,10829,59,65,7117.78,14348.00,0.00
2024-12-10 17:26:54,125,10829,59,66,7060.84,14348.01,0.00
2024-12-10 17:26:54,124,10829,59,65,7050.36,14348.40,0.00
2024-12-10 17:26:54,124,10830,59,65,7076.53,14349.00,0.00
2024-12-10 17:26:54,125,10830,60,65,7019.91,14349.01,0.00
2024-12-10 17:26:54,124,10830,60,64,7070.75,14349.04,0.00
2024-12-10 17:26:54,124,10831,60,64,7047.45,14350.00,0.00
2024-12-10 17:26:54,125,10831,61,64,6991.07,14350.01,0.00
2024-12-10 17:26:54,124,10831,60,64,7041.68,14350.04,0.00
2024-12-10 17:26:54,124,10832,60,64,7016.41,14351.00,0.00
2024-12-10 17:26:54,125,10832,61,64,6960.28,14351.01,0.00
2024-12-10 17:26:54,124,10832,60,64,7010.63,14351.04,0.00
2024-12-10 17:26:54,125,10831,61,64,6910.98,14351.36,0.00
2024-12-10 17:26:54,125,10832,61,64,6997.50,14352.00,0.00
2024-12-10 17:26:54,126,10832,62,64,6941.97,14352.01,0.00
2024-12-10 17:26:54,125,10832,62,63,6991.78,14352.04,0.00
2024-12-10 17:26:54,125,10833,62,63,7082.96,14353.00,0.00
2024-12-10 17:26:54,126,10833,63,63,7026.74,14353.01,0.00
2024-12-10 17:26:54,125,10833,63,62,7077.22,14353.04,0.00
2024-12-10 17:26:54,125,10834,63,62,7049.39,14354.00,0.00
2024-12-10 17:26:54,126,10834,63,63,6993.45,14354.01,0.00
2024-12-10 17:26:54,125,10834,62,63,7043.66,14354.04,0.00
2024-12-10 17:26:54,125,10835,62,63,7014.65,14355.00,0.00
2024-12-10 17:26:54,126,10835,62,64,6958.97,14355.01,0.00
2024-12-10 17:26:54,125,10835,61,64,7008.91,14355.04,0.00
2024-12-10 17:26:54,125,10836,61,64,6983.23,14356.00,0.00
2024-12-10 17:26:54,126,10836,62,64,6927.81,14356.01,0.00
2024-12-10 17:26:54,125,10836,62,63,6977.50,14356.04,0.00
2024-12-10 17:26:54,125,10837,62,63,6951.23,14357.00,0.00
2024-12-10 17:26:54,126,10837,62,64,6896.07,14357.01,0.00
2024-12-10 17:26:54,125,10837,62,63,6950.09,14357.01,0.00
2024-12-10 17:26:54,124,10837,62,62,7001.51,14357.03,0.00
2024-12-10 17:26:54,123,10837,61,62,7057.27,14357.03,0.00
2024-12-10 17:26:54,122,10837,60,62,7113.94,14357.03,0.00
2024-12-10 17:26:54,121,10837,60,61,7171.54,14357.03,0.00
2024-12-10 17:26:54,122,10836,60,62,7027.20,14357.62,0.00
2024-12-10 17:26:54,122,10837,60,62,7202.72,14358.00,0.00
2024-12-10 17:26:54,123,10837,60,63,7144.16,14358.01,0.00
2024-12-10 17:26:54,122,10837,59,63,7198.02,14358.03,0.00
2024-12-10 17:26:54,122,10838,59,63,7284.25,14359.00,0.00
2024-12-10 17:26:54,123,10838,59,64,7225.03,14359.01,0.00
2024-12-10 17:26:54,122,10838,59,63,7279.55,14359.03,0.00
2024-12-10 17:26:54,123,10837,59,64,7119.88,14359.72,0.00
2024-12-10 17:26:54,123,10838,59,64,7227.71,14360.00,0.00
2024-12-10 17:26:54,124,10838,60,64,7169.42,14360.01,0.00
2024-12-10 17:26:54,123,10838,60,63,7223.05,14360.03,0.00
2024-12-10 17:26:54,123,10839,60,63,7311.26,14361.00,0.00
2024-12-10 17:26:54,124,10839,61,63,7252.30,14361.01,0.00
2024-12-10 17:26:54,123,10839,61,62,7306.60,14361.03,0.00
2024-12-10 17:26:54,123,10840,61,62,7273.91,14362.00,0.00
2024-12-10 17:26:54,124,10840,62,62,7215.25,14362.01,0.00
2024-12-10 17:26:54,123,10840,61,62,7269.25,14362.03,0.00
2024-12-10 17:26:54,122,10840,60,62,7315.20,14362.12,0.00
2024-12-10 17:26:55,121,10840,60,61,7350.97,14362.27,0.00
2024-12-10 17:26:55,121,10841,60,61,7353.31,14363.00,0.00
2024-12-10 17:26:55,122,10841,60,62,7293.04,14363.01,0.00
2024-12-10 17:26:55,121,10841,59,62,7352.12,14363.01,0.00
2024-12-10 17:26:55,120,10841,59,61,7408.62,14363.03,0.00
2024-12-10 17:26:55,120,10842,59,61,7373.30,14364.00,0.00
2024-12-10 17:26:55,121,10842,59,62,7312.37,14364.01,0.00
2024-12-10 17:26:55,120,10842,58,62,7368.53,14364.03,0.00
2024-12-10 17:26:55,120,10843,58,62,7325.36,14365.00,0.00
2024-12-10 17:26:55,121,10843,59,62,7264.82,14365.01,0.00
2024-12-10 17:26:55,120,10843,58,62,7320.58,14365.03,0.00
2024-12-10 17:26:55,120,10844,58,62,7265.95,14366.00,0.00
2024-12-10 17:26:55,121,10844,58,63,7205.90,14366.01,0.00
2024-12-10 17:26:55,120,10844,58,62,7261.17,14366.03,0.00
2024-12-10 17:26:55,120,10845,58,62,7197.88,14367.00,0.00
2024-12-10 17:26:55,121,10845,59,62,7138.39,14367.01,0.00
2024-12-10 17:26:55,120,10845,59,61,7191.90,14367.04,0.00
2024-12-10 17:26:55,120,10846,59,61,7118.71,14368.00,0.00
2024-12-10 17:26:55,121,10846,59,62,7059.88,14368.01,0.00
2024-12-10 17:26:55,120,10846,59,61,7112.74,14368.04,0.00
2024-12-10 17:26:55,119,10846,59,60,7051.27,14368.71,0.00
2024-12-10 17:26:55,119,10847,59,60,7098.42,14369.00,0.00
2024-12-10 17:26:55,120,10847,60,60,7039.27,14369.01,0.00
2024-12-10 17:26:55,119,10847,59,60,7092.40,14369.04,0.00
2024-12-10 17:26:55,118,10847,59,59,6995.58,14369.91,0.00
2024-12-10 17:26:55,118,10848,59,59,7088.63,14370.00,0.00
2024-12-10 17:26:55,119,10848,60,59,7029.06,14370.01,0.00
2024-12-10 17:26:55,118,10848,60,58,7082.56,14370.04,0.00
2024-12-10 17:26:55,117,10848,60,57,7134.35,14370.09,0.00
2024-12-10 17:26:55,116,10848,59,57,7182.92,14370.18,0.00
2024-12-10 17:26:55,117,10847,59,58,7111.72,14370.26,0.00
2024-12-10 17:26:55,116,10847,58,58,7225.02,14370.47,0.00
2024-12-10 17:26:55,116,10848,58,58,7233.46,14371.00,0.00
2024-12-10 17:26:55,117,10848,58,59,7171.64,14371.01,0.00
2024-12-10 17:26:55,116,10848,58,58,7227.28,14371.04,0.00
2024-12-10 17:26:55,115,10848,57,58,7223.31,14371.50,0.00
2024-12-10 17:26:55,115,10849,57,58,7350.14,14372.00,0.00
2024-12-10 17:26:55,116,10849,58,58,7286.77,14372.01,0.00
2024-12-10 17:26:55,115,10849,57,58,7243.02,14372.66,0.00
2024-12-10 17:26:55,116,10848,57,59,7153.51,14372.81,0.00
2024-12-10 17:26:55,116,10849,57,59,7245.17,14373.00,0.00
2024-12-10 17:26:55,117,10849,57,60,7183.25,14373.01,0.00
2024-12-10 17:26:55,116,10849,57,59,7238.99,14373.04,0.00
2024-12-10 17:26:55,116,10850,57,59,7297.44,14374.00,0.00
2024-12-10 17:26:55,117,10850,58,59,7235.07,14374.01,0.00
2024-12-10 17:26:55,116,10850,57,59,7291.25,14374.04,0.00
2024-12-10 17:26:55,115,10850,56,59,7221.92,14374.87,0.00
2024-12-10 17:26:55,115,10851,56,59,7311.55,14375.00,0.00
2024-12-10 17:26:55,116,10851,56,60,7248.52,14375.01,0.00
2024-12-10 17:26:55,115,10851,55,60,7305.31,14375.04,0.00
2024-12-10 17:26:55,115,10852,55,60,7257.41,14376.00,0.00
2024-12-10 17:26:55,116,10852,56,60,7194.85,14376.01,0.00
2024-12-10 17:26:55,115,10852,56,59,7249.93,14376.05,0.00
2024-12-10 17:26:55,114,10852,55,59,7142.16,14376.86,0.00
2024-12-10 17:26:55,114,10853,55,59,7228.00,14377.00,0.00
2024-12-10 17:26:55,115,10853,56,59,7165.15,14377.01,0.00
2024-12-10 17:26:55,114,10853,56,58,7127.55,14377.57,0.00
2024-12-10 17:26:55,114,10854,56,58,7137.12,14378.00,0.00
2024-12-10 17:26:55,115,10854,57,58,7075.05,14378.01,0.00
2024-12-10 17:26:55,114,10854,57,57,7129.56,14378.05,0.00
2024-12-10 17:26:55,113,10854,56,57,7084.17,14378.67,0.00
2024-12-10 17:26:55,113,10855,56,57,7124.48,14379.00,0.00
2024-12-10 17:26:55,114,10855,57,57,7061.99,14379.01,0.00
2024-12-10 17:26:55,113,10855,57,56,7116.86,14379.05,0.00
2024-12-10 17:26:55,114,10854,57,57,7035.53,14379.20,0.00
2024-12-10 17:26:55,115,10853,57,58,6933.44,14379.88,0.00
2024-12-10 17:26:55,114,10853,56,58,6989.66,14379.90,0.00
2024-12-10 17:26:55,114,10854,56,58,7102.01,14380.00,0.00
2024-12-10 17:26:55,115,10854,56,59,7040.25,14380.01,0.00
2024-12-10 17:26:55,114,10854,56,58,7094.45,14380.05,0.00
2024-12-10 17:26:55,114,10855,56,58,7337.14,14381.00,0.00
2024-12-10 17:26:55,115,10855,57,58,7273.34,14381.01,0.00
2024-12-10 17:26:55,114,10855,56,58,7329.58,14381.05,0.00
2024-12-10 17:26:55,114,10856,56,58,7318.80,14382.00,0.00
2024-12-10 17:26:55,115,10856,56,59,7255.16,14382.01,0.00
2024-12-10 17:26:55,114,10856,56,58,7311.24,14382.05,0.00
2024-12-10 17:26:55,114,10857,56,58,7298.41,14383.00,0.00
2024-12-10 17:26:55,115,10857,57,58,7234.94,14383.01,0.00
2024-12-10 17:26:55,114,10857,56,58,7290.84,14383.05,0.00
2024-12-10 17:26:55,114,10858,56,58,7275.70,14384.00,0.00
2024-12-10 17:26:55,115,10858,57,58,7212.43,14384.01,0.00
2024-12-10 17:26:55,114,10858,56,58,7266.88,14384.06,0.00
2024-12-10 17:26:55,114,10859,56,58,7252.23,14385.00,0.00
2024-12-10 17:26:55,115,10859,56,59,7189.17,14385.01,0.00
2024-12-10 17:26:55,114,10859,56,58,7247.01,14385.04,0.00
2024-12-10 17:26:55,113,10859,56,57,7308.60,14385.05,0.00
2024-12-10 17:26:55,114,10858,57,57,7139.45,14385.76,0.00
2024-12-10 17:26:56,114,10859,57,57,7263.33,14386.00,0.00
2024-12-10 17:26:56,115,10859,57,58,7200.17,14386.01,0.00
2024-12-10 17:26:56,114,10859,56,58,7255.77,14386.05,0.00
2024-12-10 17:26:56,114,10860,56,58,7372.37,14387.00,0.00
2024-12-10 17:26:56,115,10860,57,58,7308.26,14387.01,0.00
2024-12-10 17:26:56,114,10860,57,57,7364.81,14387.05,0.00
2024-12-10 17:26:56,115,10859,57,58,7232.10,14387.55,0.00
2024-12-10 17:26:56,115,10860,57,58,7374.28,14388.00,0.00
2024-12-10 17:26:56,116,10860,57,59,7310.71,14388.01,0.00
2024-12-10 17:26:56,116,10861,57,59,7416.66,14389.00,0.00
2024-12-10 17:26:56,117,10861,57,60,7353.27,14389.01,0.00
2024-12-10 17:26:56,116,10861,56,60,7412.02,14389.03,0.00
2024-12-10 17:26:56,115,10861,55,60,7473.98,14389.04,0.00
2024-12-10 17:26:56,115,10862,55,60,7450.71,14390.00,0.00
2024-12-10 17:26:56,116,10862,55,61,7386.48,14390.01,0.00
2024-12-10 17:26:56,115,10862,55,60,7444.46,14390.04,0.00
2024-12-10 17:26:56,114,10862,54,60,7508.34,14390.05,0.00
2024-12-10 17:26:56,114,10863,54,60,7469.86,14391.00,0.00
2024-12-10 17:26:56,115,10863,54,61,7404.90,14391.01,0.00
2024-12-10 17:26:56,114,10863,53,61,7463.56,14391.04,0.00
2024-12-10 17:26:56,114,10864,53,61,7410.33,14392.00,0.00
2024-12-10 17:26:56,115,10864,53,62,7345.89,14392.01,0.00
2024-12-10 17:26:56,114,10864,52,62,7251.64,14392.86,0.00
2024-12-10 17:26:56,114,10865,52,62,7351.28,14393.00,0.00
2024-12-10 17:26:56,115,10865,52,63,7287.36,14393.01,0.00
2024-12-10 17:26:56,114,10865,52,62,7344.98,14393.04,0.00
2024-12-10 17:26:56,114,10866,52,62,7329.37,14394.00,0.00
2024-12-10 17:26:56,115,10866,53,62,7265.63,14394.01,0.00
2024-12-10 17:26:56,114,10866,52,62,7326.85,14394.02,0.00
2024-12-10 17:26:56,113,10866,51,62,7387.87,14394.04,0.00
2024-12-10 17:26:56,113,10867,51,62,7374.43,14395.00,0.00
2024-12-10 17:26:56,114,10867,52,62,7309.74,14395.01,0.00
2024-12-10 17:26:56,113,10867,51,62,7366.81,14395.05,0.00
2024-12-10 17:26:56,113,10868,51,62,7354.31,14396.00,0.00
2024-12-10 17:26:56,114,10868,52,62,7289.80,14396.01,0.00
2024-12-10 17:26:56,113,10868,52,61,7346.69,14396.05,0.00
2024-12-10 17:26:56,113,10869,52,61,7330.09,14397.00,0.00
2024-12-10 17:26:56,114,10869,52,62,7265.79,14397.01,0.00
2024-12-10 17:26:56,113,10869,52,61,7322.47,14397.05,0.00
2024-12-10 17:26:56,114,10868,52,62,7229.22,14397.27,0.00
2024-12-10 17:26:56,114,10869,52,62,7342.84,14398.00,0.00
2024-12-10 17:26:56,115,10869,53,62,7278.99,14398.01,0.00
2024-12-10 17:26:56,114,10869,53,61,7335.28,14398.05,0.00
2024-12-10 17:26:56,114,10870,53,61,7449.46,14399.00,0.00
2024-12-10 17:26:56,115,10870,54,61,7384.68,14399.01,0.00
2024-12-10 17:26:56,114,10870,54,60,7441.90,14399.05,0.00
2024-12-10 17:26:56,114,10871,54,60,7429.39,14400.00,0.00
2024-12-10 17:26:56,115,10871,54,61,7364.78,14400.01,0.00
2024-12-10 17:26:56,114,10871,54,60,7421.83,14400.05,0.00
2024-12-10 17:26:56,115,10870,54,61,7334.77,14400.23,0.00
2024-12-10 17:26:56,116,10869,54,62,7232.16,14400.88,0.00
2024-12-10 17:26:56,117,10868,54,63,7181.24,14400.90,0.00
2024-12-10 17:26:56,117,10869,54,63,7303.19,14401.00,0.00
2024-12-10 17:26:56,118,10869,55,63,7241.30,14401.01,0.00
2024-12-10 17:26:56,117,10869,55,62,7295.83,14401.05,0.00
2024-12-10 17:26:56,117,10870,55,62,7649.58,14402.00,0.00
2024-12-10 17:26:56,118,10870,56,62,7584.76,14402.01,0.00
2024-12-10 17:26:56,117,10870,56,61,7642.22,14402.05,0.00
2024-12-10 17:26:56,116,10870,55,61,7706.86,14402.05,0.00
2024-12-10 17:26:56,116,10871,55,61,7692.25,14403.00,0.00
2024-12-10 17:26:56,117,10871,56,61,7626.50,14403.01,0.00
2024-12-10 17:26:56,116,10871,55,61,7684.82,14403.05,0.00
2024-12-10 17:26:56,116,10872,55,61,7669.43,14404.00,0.00
2024-12-10 17:26:56,117,10872,55,62,7603.88,14404.01,0.00
2024-12-10 17:26:56,116,10872,54,62,7662.00,14404.05,0.00
2024-12-10 17:26:56,116,10873,54,62,7646.18,14405.00,0.00
2024-12-10 17:26:56,117,10873,54,63,7580.83,14405.01,0.00
2024-12-10 17:26:56,116,10873,53,63,7638.75,14405.05,0.00
2024-12-10 17:26:56,115,10873,53,62,7703.92,14405.05,0.00
2024-12-10 17:26:56,115,10874,53,62,7689.61,14406.00,0.00
2024-12-10 17:26:56,116,10874,54,62,7623.32,14406.01,0.00
2024-12-10 17:26:56,115,10874,54,61,7682.11,14406.05,0.00
2024-12-10 17:26:56,115,10875,54,61,7668.68,14407.00,0.00
2024-12-10 17:26:56,116,10875,54,62,7602.57,14407.01,0.00
2024-12-10 17:26:56,115,10875,53,62,7661.18,14407.05,0.00
2024-12-10 17:26:56,115,10876,53,62,7647.40,14408.00,0.00
2024-12-10 17:26:56,116,10876,54,62,7581.47,14408.01,0.00
2024-12-10 17:26:56,115,10876,54,61,7639.90,14408.05,0.00
2024-12-10 17:26:56,115,10877,54,61,7623.35,14409.00,0.00
2024-12-10 17:26:56,116,10877,54,62,7557.63,14409.01,0.00
2024-12-10 17:26:56,115,10877,54,61,7615.85,14409.05,0.00
2024-12-10 17:26:56,116,10876,54,62,7474.70,14409.57,0.00
2024-12-10 17:26:56,116,10877,54,62,7565.48,14410.00,0.00
2024-12-10 17:26:56,117,10877,55,62,7500.81,14410.01,0.00
2024-12-10 17:26:56,116,10877,54,62,7558.04,14410.05,0.00
2024-12-10 17:26:56,117,10876,55,62,7425.85,14410.54,0.00
2024-12-10 17:26:56,118,10875,56,62,7367.10,14410.86,0.00
2024-12-10 17:26:57,118,10876,56,62,7606.58,14411.00,0.00
2024-12-10 17:26:57,119,10876,57,62,7542.66,14411.01,0.00
2024-12-10 17:26:57,118,10876,56,62,7599.41,14411.05,0.00
2024-12-10 17:26:57,118,10877,56,62,7825.53,14412.00,0.00
2024-12-10 17:26:57,119,10877,56,63,7759.77,14412.01,0.00
2024-12-10 17:26:57,118,10877,56,62,7818.22,14412.05,0.00
2024-12-10 17:26:57,118,10878,56,62,7766.53,14413.00,0.00
2024-12-10 17:26:57,119,10878,57,62,7701.26,14413.01,0.00
2024-12-10 17:26:57,118,10878,57,61,7758.00,14413.06,0.00
2024-12-10 17:26:57,119,10877,57,62,7542.71,14413.88,0.00
2024-12-10 17:26:57,119,10878,57,62,7636.73,14414.00,0.00
2024-12-10 17:26:57,120,10878,58,62,7573.09,14414.01,0.00
2024-12-10 17:26:57,119,10878,57,62,7634.32,14414.02,0.00
2024-12-10 17:26:57,118,10878,56,62,7692.93,14414.05,0.00
2024-12-10 17:26:57,118,10879,56,62,7761.86,14415.00,0.00
2024-12-10 17:26:57,119,10879,56,63,7696.63,14415.01,0.00
2024-12-10 17:26:57,118,10879,56,62,7754.54,14415.05,0.00
2024-12-10 17:26:57,119,10878,57,62,7563.14,14415.88,0.00
2024-12-10 17:26:57,119,10879,57,62,7647.82,14416.00,0.00
2024-12-10 17:26:57,120,10879,58,62,7584.08,14416.01,0.00
2024-12-10 17:26:57,119,10879,57,62,7639.36,14416.06,0.00
2024-12-10 17:26:57,118,10879,56,62,7558.67,14416.94,0.00
2024-12-10 17:26:57,118,10880,56,62,7794.52,14417.00,0.00
2024-12-10 17:26:57,119,10880,57,62,7729.02,14417.01,0.00
2024-12-10 17:26:57,118,10880,57,61,7762.06,14417.21,0.00
2024-12-10 17:26:57,119,10879,57,62,7660.58,14417.48,0.00
2024-12-10 17:26:57,119,10880,57,62,7712.94,14418.00,0.00
2024-12-10 17:26:57,120,10880,58,62,7648.66,14418.01,0.00
2024-12-10 17:26:57,119,10880,57,62,7703.27,14418.07,0.00
2024-12-10 17:26:57,118,10880,57,61,7745.51,14418.20,0.00
2024-12-10 17:26:57,119,10879,58,61,7576.88,14418.92,0.00
2024-12-10 17:26:57,119,10880,58,61,7815.66,14419.00,0.00
2024-12-10 17:26:57,120,10880,59,61,7750.53,14419.01,0.00
2024-12-10 17:26:57,121,10879,59,62,7682.91,14419.05,0.00
2024-12-10 17:26:57,120,10879,59,61,7799.82,14419.08,0.00
2024-12-10 17:26:57,119,10879,59,60,7780.49,14419.66,0.00
2024-12-10 17:26:57,119,10880,59,60,7950.31,14420.00,0.00
2024-12-10 17:26:57,120,10880,60,60,7884.05,14420.01,0.00
2024-12-10 17:26:57,119,10880,59,60,7940.64,14420.07,0.00
2024-12-10 17:26:57,119,10881,59,60,7989.61,14421.00,0.00
2024-12-10 17:26:57,120,10881,59,61,7923.03,14421.01,0.00
2024-12-10 17:26:57,119,10881,59,60,7979.94,14421.07,0.00
2024-12-10 17:26:57,118,10881,58,60,7856.13,14421.74,0.00
2024-12-10 17:26:58,118,10882,58,60,7786.55,14422.00,0.00
2024-12-10 17:26:58,119,10882,58,61,7721.11,14422.01,0.00
2024-12-10 17:26:58,118,10882,57,61,7776.80,14422.07,0.00
2024-12-10 17:26:58,117,10882,57,60,7735.12,14422.64,0.00
2024-12-10 17:26:58,117,10883,57,60,7573.82,14423.00,0.00
2024-12-10 17:26:58,118,10883,58,60,7509.63,14423.01,0.00
2024-12-10 17:26:58,117,10883,58,59,7563.99,14423.07,0.00
2024-12-10 17:26:58,116,10883,58,58,7458.87,14423.78,0.00
2024-12-10 17:26:58,115,10883,57,58,7510.81,14423.86,0.00
2024-12-10 17:26:58,116,10882,57,59,7446.06,14423.87,0.00
2024-12-10 17:26:58,117,10881,58,59,7333.25,14423.91,0.00
2024-12-10 17:26:58,116,10881,57,59,7332.05,14423.92,0.00
2024-12-10 17:26:58,116,10882,57,59,7400.01,14424.00,0.00
2024-12-10 17:26:58,117,10882,58,59,7336.76,14424.01,0.00
2024-12-10 17:26:58,116,10882,57,59,7390.09,14424.07,0.00
2024-12-10 17:26:58,115,10882,56,59,7281.33,14424.86,0.00
2024-12-10 17:26:58,114,10882,55,59,7290.32,14424.90,0.00
2024-12-10 17:26:58,114,10883,55,59,7642.65,14425.00,0.00
2024-12-10 17:26:58,115,10883,56,59,7576.19,14425.01,0.00
2024-12-10 17:26:58,114,10883,55,59,7632.55,14425.07,0.00
2024-12-10 17:26:58,113,10883,54,59,7690.58,14425.13,0.00
2024-12-10 17:26:58,114,10882,55,59,7582.71,14425.43,0.00
2024-12-10 17:26:58,115,10881,56,59,7476.77,14425.83,0.00
2024-12-10 17:26:58,114,10881,55,59,7485.74,14425.89,0.00
2024-12-10 17:26:58,114,10882,55,59,7575.07,14426.00,0.00
2024-12-10 17:26:58,115,10882,56,59,7509.20,14426.01,0.00
2024-12-10 17:26:58,114,10882,56,58,7564.97,14426.07,0.00
2024-12-10 17:26:58,115,10881,56,59,7461.61,14426.35,0.00
2024-12-10 17:26:58,116,10880,57,59,7442.08,14426.40,0.00
2024-12-10 17:26:58,115,10880,56,59,7486.15,14426.77,0.00
2024-12-10 17:26:58,115,10881,56,59,7674.48,14427.00,0.00
2024-12-10 17:26:58,116,10881,57,59,7608.32,14427.01,0.00
2024-12-10 17:26:58,115,10881,56,59,7664.47,14427.07,0.00
2024-12-10 17:26:58,114,10881,55,59,7609.48,14427.68,0.00
2024-12-10 17:26:58,115,10880,56,59,7306.24,14427.93,0.00
2024-12-10 17:26:58,115,10881,56,59,7672.09,14428.00,0.00
2024-12-10 17:26:58,116,10881,56,60,7605.95,14428.01,0.00
2024-12-10 17:26:58,115,10881,55,60,7662.08,14428.07,0.00
2024-12-10 17:26:58,114,10881,55,59,7533.50,14428.80,0.00
2024-12-10 17:26:58,113,10881,55,58,7590.96,14428.82,0.00
2024-12-10 17:26:58,113,10882,55,58,7609.48,14429.00,0.00
2024-12-10 17:26:58,114,10882,56,58,7542.73,14429.01,0.00
2024-12-10 17:26:58,113,10882,55,58,7603.39,14429.04,0.00
2024-12-10 17:26:58,114,10881,55,59,7498.78,14429.32,0.00
2024-12-10 17:26:58,113,10881,55,58,7419.20,14429.78,0.00
2024-12-10 17:26:58,112,10881,54,58,7432.85,14429.83,0.00
2024-12-10 17:26:58,111,10881,53,58,7407.21,14429.92,0.00
2024-12-10 17:26:58,111,10882,53,58,7430.72,14430.00,0.00
2024-12-10 17:26:58,112,10882,54,58,7364.38,14430.01,0.00
2024-12-10 17:26:58,111,10882,53,58,7420.35,14430.07,0.00
2024-12-10 17:26:58,110,10882,53,57,7485.19,14430.07,0.00
2024-12-10 17:26:58,109,10882,52,57,7527.39,14430.14,0.00
2024-12-10 17:26:58,108,10882,52,56,7517.37,14430.68,0.00
2024-12-10 17:26:58,107,10882,52,55,7540.92,14430.77,0.00
2024-12-10 17:26:58,106,10882,51,55,7594.07,14430.88,0.00
2024-12-10 17:26:58,106,10883,51,55,7671.07,14431.00,0.00
2024-12-10 17:26:58,107,10883,52,55,7599.38,14431.01,0.00
2024-12-10 17:26:58,106,10883,52,54,7537.86,14431.88,0.00
2024-12-10 17:26:58,105,10883,51,54,7557.27,14431.92,0.00
2024-12-10 17:26:58,105,10884,51,54,7622.69,14432.00,0.00
2024-12-10 17:26:58,106,10884,51,55,7550.78,14432.01,0.00
2024-12-10 17:26:58,105,10884,51,54,7621.32,14432.01,0.00
2024-12-10 17:26:58,104,10884,51,53,7684.92,14432.07,0.00
2024-12-10 17:26:58,103,10884,50,53,7614.98,14432.91,0.00
2024-12-10 17:26:58,103,10885,50,53,7695.00,14433.00,0.00
2024-12-10 17:26:58,104,10885,51,53,7621.01,14433.01,0.00
2024-12-10 17:26:58,103,10885,51,52,7547.82,14433.95,0.00
2024-12-10 17:26:58,103,10886,51,52,7680.99,14434.00,0.00
2024-12-10 17:26:58,104,10886,52,52,7607.14,14434.01,0.00
2024-12-10 17:26:58,105,10885,53,52,7526.47,14434.09,0.00
2024-12-10 17:26:58,105,10886,53,52,7639.05,14435.00,0.00
2024-12-10 17:26:58,106,10886,53,53,7566.98,14435.01,0.00
2024-12-10 17:26:58,106,10887,53,53,7655.56,14436.00,0.00
2024-12-10 17:26:58,107,10887,54,53,7584.01,14436.01,0.00
2024-12-10 17:26:58,106,10887,54,52,7487.75,14436.84,0.00
2024-12-10 17:26:58,106,10888,54,52,7600.93,14437.00,0.00
2024-12-10 17:26:58,107,10888,55,52,7529.89,14437.01,0.00
2024-12-10 17:26:58,106,10888,55,51,7590.07,14437.08,0.00
2024-12-10 17:26:58,106,10889,55,51,7593.29,14438.00,0.00
2024-12-10 17:26:58,107,10889,56,51,7522.32,14438.01,0.00
2024-12-10 17:26:58,107,10890,56,51,7514.74,14439.00,0.00
2024-12-10 17:26:58,108,10890,57,51,7445.16,14439.01,0.00
2024-12-10 17:26:58,107,10890,56,51,7502.64,14439.08,0.00
2024-12-10 17:26:58,107,10891,56,51,7505.82,14440.00,0.00
2024-12-10 17:26:58,108,10891,56,52,7436.32,14440.01,0.00
2024-12-10 17:26:58,107,10891,56,51,7493.71,14440.08,0.00
2024-12-10 17:26:58,108,10890,56,52,7272.08,14440.97,0.00
2024-12-10 17:26:58,108,10891,56,52,7405.82,14441.00,0.00
2024-12-10 17:26:58,109,10891,56,53,7337.88,14441.01,0.00
2024-12-10 17:26:58,108,10891,55,53,7393.82,14441.08,0.00
2024-12-10 17:26:58,109,10890,56,53,7166.97,14441.95,0.00
2024-12-10 17:26:58,109,10891,56,53,7430.69,14442.00,0.00
2024-12-10 17:26:58,110,10891,56,54,7363.13,14442.01,0.00
2024-12-10 17:26:59,110,10892,56,54,7434.64,14443.00,0.00
2024-12-10 17:26:59,111,10892,57,54,7367.66,14443.01,0.00
2024-12-10 17:26:59,110,10892,56,54,7422.85,14443.08,0.00
2024-12-10 17:26:59,109,10892,55,54,7379.27,14443.84,0.00
2024-12-10 17:26:59,109,10893,55,54,7489.40,14444.00,0.00
2024-12-10 17:26:59,110,10893,56,54,7421.32,14444.01,0.00
2024-12-10 17:26:59,109,10893,56,53,7477.51,14444.08,0.00
2024-12-10 17:26:59,109,10894,56,53,7477.99,14445.00,0.00
2024-12-10 17:26:59,110,10894,57,53,7410.01,14445.01,0.00
2024-12-10 17:26:59,109,10894,57,52,7465.52,14445.08,0.00
2024-12-10 17:26:59,109,10895,57,52,7466.01,14446.00,0.00
2024-12-10 17:26:59,110,10895,58,52,7398.14,14446.01,0.00
2024-12-10 17:26:59,109,10895,58,51,7451.95,14446.08,0.00
2024-12-10 17:26:59,109,10896,58,51,7452.44,14447.00,0.00
2024-12-10 17:26:59,110,10896,59,51,7384.69,14447.01,0.00
2024-12-10 17:26:59,109,10896,59,50,7436.27,14447.08,0.00
2024-12-10 17:26:59,110,10895,59,51,7278.29,14447.73,0.00
2024-12-10 17:26:59,110,10896,59,51,7405.93,14448.00,0.00
2024-12-10 17:26:59,111,10896,59,52,7339.21,14448.01,0.00
2024-12-10 17:26:59,110,10896,59,51,7389.40,14448.08,0.00
2024-12-10 17:26:59,110,10897,59,51,7519.92,14449.00,0.00
2024-12-10 17:26:59,111,10897,60,51,7452.17,14449.01,0.00
2024-12-10 17:26:59,110,10897,59,51,7501.67,14449.08,0.00
2024-12-10 17:26:59,111,10896,59,52,7400.30,14449.33,0.00
2024-12-10 17:26:59,111,10897,59,52,7505.76,14450.00,0.00
2024-12-10 17:26:59,112,10897,59,53,7438.75,14450.01,0.00
2024-12-10 17:26:59,111,10897,58,53,7488.06,14450.08,0.00
2024-12-10 17:26:59,111,10898,58,53,7578.69,14451.00,0.00
2024-12-10 17:26:59,112,10898,59,53,7511.02,14451.01,0.00
2024-12-10 17:26:59,111,10898,58,53,7577.38,14451.01,0.00
2024-12-10 17:26:59,110,10898,57,53,7629.91,14451.07,0.00
2024-12-10 17:26:59,109,10898,56,53,7551.15,14451.77,0.00
2024-12-10 17:26:59,109,10899,56,53,7650.79,14452.00,0.00
2024-12-10 17:26:59,110,10899,56,54,7581.24,14452.01,0.00
2024-12-10 17:26:59,109,10899,56,53,7642.11,14452.06,0.00
2024-12-10 17:26:59,108,10899,55,53,7710.20,14452.07,0.00
2024-12-10 17:26:59,108,10900,55,53,7703.89,14453.00,0.00
2024-12-10 17:26:59,109,10900,55,54,7633.22,14453.01,0.00
2024-12-10 17:26:59,108,10900,54,54,7693.22,14453.07,0.00
2024-12-10 17:26:59,107,10900,53,54,7753.78,14453.14,0.00
2024-12-10 17:26:59,107,10901,53,54,7765.08,14454.00,0.00
2024-12-10 17:26:59,108,10901,54,54,7693.18,14454.01,0.00
2024-12-10 17:26:59,109,10900,54,55,7619.96,14454.05,0.00
2024-12-10 17:26:59,108,10900,54,54,7754.78,14454.08,0.00
2024-12-10 17:26:59,107,10900,53,54,7733.88,14454.73,0.00
2024-12-10 17:26:59,107,10901,53,54,7830.03,14455.00,0.00
2024-12-10 17:26:59,108,10901,53,55,7757.53,14455.01,0.00
2024-12-10 17:26:59,107,10901,53,54,7819.25,14455.08,0.00
2024-12-10 17:26:59,107,10902,53,54,7956.21,14456.00,0.00
2024-12-10 17:26:59,108,10902,54,54,7882.54,14456.01,0.00
2024-12-10 17:26:59,107,10902,53,54,7945.43,14456.08,0.00
2024-12-10 17:26:59,108,10901,54,54,7773.12,14456.78,0.00
2024-12-10 17:26:59,108,10902,54,54,7895.14,14457.00,0.00
2024-12-10 17:26:59,109,10902,54,55,7822.71,14457.01,0.00
2024-12-10 17:26:59,108,10902,54,54,7884.46,14457.07,0.00
2024-12-10 17:26:59,107,10902,54,53,7956.80,14457.08,0.00
2024-12-10 17:26:59,108,10901,54,54,7800.36,14457.67,0.00
2024-12-10 17:26:59,108,10902,54,54,8060.35,14458.00,0.00
2024-12-10 17:26:59,109,10902,54,55,7986.40,14458.01,0.00
2024-12-10 17:26:59,110,10901,55,55,7913.79,14458.03,0.00
2024-12-10 17:26:59,110,10902,55,55,8139.11,14459.00,0.00
2024-12-10 17:26:59,111,10902,55,56,8065.79,14459.01,0.00
2024-12-10 17:26:59,110,10902,54,56,8132.57,14459.05,0.00
2024-12-10 17:26:59,109,10902,54,55,8201.89,14459.07,0.00
2024-12-10 17:27:00,109,10903,54,55,8333.75,14460.00,0.00
2024-12-10 17:27:00,110,10903,54,56,8257.98,14460.01,0.00
2024-12-10 17:27:00,111,10902,55,56,8061.57,14460.87,0.00
2024-12-10 17:27:00,111,10903,55,56,8186.76,14461.00,0.00
2024-12-10 17:27:00,112,10903,56,56,8113.66,14461.01,0.00
2024-12-10 17:27:00,112,10904,56,56,8229.15,14462.00,0.00
2024-12-10 17:27:00,113,10904,57,56,8156.32,14462.01,0.00
2024-12-10 17:27:00,114,10903,58,56,7992.43,14462.67,0.00
2024-12-10 17:27:00,114,10904,58,56,8106.90,14463.00,0.00
2024-12-10 17:27:00,115,10904,58,57,8036.41,14463.01,0.00
2024-12-10 17:27:00,114,10904,58,56,8096.79,14463.07,0.00
2024-12-10 17:27:00,114,10905,58,56,8216.58,14464.00,0.00
2024-12-10 17:27:00,115,10905,58,57,8145.13,14464.01,0.00
2024-12-10 17:27:00,115,10906,58,57,8128.08,14465.00,0.00
2024-12-10 17:27:00,116,10906,58,58,8058.01,14465.01,0.00
2024-12-10 17:27:00,116,10907,58,58,8039.86,14466.00,0.00
2024-12-10 17:27:00,117,10907,59,58,7971.15,14466.01,0.00
2024-12-10 17:27:00,117,10908,59,58,7951.91,14467.00,0.00
2024-12-10 17:27:00,118,10908,60,58,7884.52,14467.01,0.00
2024-12-10 17:27:00,117,10908,59,58,7938.36,14467.09,0.00
2024-12-10 17:27:00,117,10909,59,58,7923.95,14468.00,0.00
2024-12-10 17:27:00,118,10909,60,58,7856.80,14468.01,0.00
2024-12-10 17:27:00,118,10910,60,58,7794.98,14469.00,0.00
2024-12-10 17:27:00,119,10910,60,59,7729.48,14469.01,0.00
2024-12-10 17:27:00,118,10910,59,59,7700.62,14469.53,0.00
2024-12-10 17:27:00,118,10911,59,59,7756.17,14470.00,0.00
2024-12-10 17:27:00,119,10911,59,60,7691.00,14470.01,0.00
2024-12-10 17:27:00,118,10911,58,60,7741.51,14470.10,0.00
2024-12-10 17:27:00,117,10911,58,59,7806.44,14470.10,0.00
2024-12-10 17:27:00,117,10912,58,59,7800.74,14471.00,0.00
2024-12-10 17:27:00,118,10912,58,60,7734.64,14471.01,0.00
2024-12-10 17:27:00,119,10911,59,60,7669.64,14471.03,0.00
2024-12-10 17:27:00,118,10911,59,59,7735.91,14471.11,0.00
2024-12-10 17:27:00,117,10911,59,58,7767.42,14471.35,0.00
2024-12-10 17:27:00,117,10912,59,58,7797.56,14472.00,0.00
2024-12-10 17:27:00,118,10912,59,59,7731.48,14472.01,0.00
2024-12-10 17:27:00,117,10912,58,59,7790.16,14472.05,0.00
2024-12-10 17:27:00,116,10912,57,59,7849.85,14472.09,0.00
2024-12-10 17:27:00,115,10912,57,58,7916.86,14472.10,0.00
2024-12-10 17:27:00,115,10913,57,58,8038.17,14473.00,0.00
2024-12-10 17:27:00,116,10913,57,59,7968.88,14473.01,0.00
2024-12-10 17:27:00,115,10913,57,58,8024.38,14473.10,0.00
2024-12-10 17:27:00,116,10912,57,59,7870.60,14473.70,0.00
2024-12-10 17:27:00,116,10913,57,59,7984.40,14474.00,0.00
2024-12-10 17:27:00,117,10913,58,59,7916.16,14474.01,0.00
2024-12-10 17:27:00,118,10912,58,60,7842.97,14474.07,0.00
2024-12-10 17:27:00,117,10912,57,60,7958.27,14474.10,0.00
2024-12-10 17:27:00,117,10913,57,60,8076.31,14475.00,0.00
2024-12-10 17:27:00,118,10913,58,60,8007.86,14475.01,0.00
2024-12-10 17:27:00,118,10914,58,60,8110.24,14476.00,0.00
2024-12-10 17:27:00,119,10914,58,61,8042.08,14476.01,0.00
2024-12-10 17:27:00,118,10914,57,61,8095.57,14476.10,0.00
2024-12-10 17:27:00,118,10915,57,61,8088.71,14477.00,0.00
2024-12-10 17:27:00,119,10915,58,61,8020.74,14477.01,0.00
2024-12-10 17:27:00,118,10915,57,61,8074.04,14477.10,0.00
2024-12-10 17:27:00,119,10914,57,62,7941.86,14477.56,0.00
2024-12-10 17:27:00,119,10915,57,62,8048.06,14478.00,0.00
2024-12-10 17:27:00,120,10915,57,63,7980.99,14478.01,0.00
2024-12-10 17:27:00,119,10915,56,63,8033.51,14478.10,0.00
2024-12-10 17:27:00,120,10914,57,63,7888.36,14478.66,0.00
2024-12-10 17:27:01,120,10915,57,63,8116.68,14479.00,0.00
2024-12-10 17:27:01,121,10915,58,63,8049.60,14479.01,0.00
2024-12-10 17:27:01,120,10915,58,62,8102.25,14479.10,0.00
2024-12-10 17:27:01,119,10915,58,61,8169.12,14479.10,0.00
2024-12-10 17:27:01,119,10916,58,61,8282.80,14480.00,0.00
2024-12-10 17:27:01,120,10916,58,62,8213.77,14480.01,0.00
2024-12-10 17:27:01,119,10916,58,61,8268.25,14480.10,0.00
2024-12-10 17:27:01,120,10915,58,62,8099.53,14480.81,0.00
2024-12-10 17:27:01,121,10914,59,62,8052.94,14480.82,0.00
2024-12-10 17:27:01,121,10915,59,62,8166.80,14481.00,0.00
2024-12-10 17:27:01,122,10915,59,63,8099.86,14481.01,0.00
2024-12-10 17:27:01,123,10914,59,64,8022.27,14481.11,0.00
2024-12-10 17:27:01,122,10914,58,64,8123.65,14481.11,0.00
2024-12-10 17:27:01,123,10913,59,64,7995.35,14481.55,0.00
2024-12-10 17:27:01,123,10914,59,64,8330.09,14482.00,0.00
2024-12-10 17:27:01,124,10914,60,64,8262.91,14482.01,0.00
2024-12-10 17:27:01,123,10914,60,63,8316.01,14482.10,0.00
2024-12-10 17:27:01,123,10915,60,63,8539.08,14483.00,0.00
2024-12-10 17:27:01,124,10915,60,64,8470.21,14483.01,0.00
2024-12-10 17:27:01,125,10914,61,64,8400.15,14483.04,0.00
2024-12-10 17:27:01,124,10914,60,64,8490.12,14483.10,0.00
2024-12-10 17:27:01,124,10915,60,64,8477.81,14484.00,0.00
2024-12-10 17:27:01,125,10915,61,64,8409.99,14484.01,0.00
2024-12-10 17:27:01,124,10915,60,64,8463.84,14484.10,0.00
2024-12-10 17:27:01,124,10916,60,64,8567.17,14485.00,0.00
2024-12-10 17:27:01,125,10916,60,65,8498.63,14485.01,0.00
2024-12-10 17:27:01,124,10916,60,64,8553.20,14485.10,0.00
2024-12-10 17:27:01,123,10916,59,64,8621.56,14485.10,0.00
2024-12-10 17:27:01,123,10917,59,64,8609.15,14486.00,0.00
2024-12-10 17:27:01,124,10917,59,65,8539.73,14486.01,0.00
2024-12-10 17:27:01,123,10917,59,64,8595.07,14486.10,0.00
2024-12-10 17:27:01,124,10916,60,64,8466.32,14486.52,0.00
2024-12-10 17:27:01,124,10917,60,64,8562.51,14487.00,0.00
2024-12-10 17:27:01,125,10917,61,64,8494.01,14487.01,0.00
2024-12-10 17:27:01,125,10918,61,64,8582.69,14488.00,0.00
2024-12-10 17:27:01,126,10918,62,64,8514.57,14488.01,0.00
2024-12-10 17:27:01,126,10919,62,64,8486.41,14489.00,0.00
2024-12-10 17:27:01,127,10919,63,64,8419.59,14489.01,0.00
2024-12-10 17:27:01,127,10920,63,64,8390.50,14490.00,0.00
2024-12-10 17:27:01,128,10920,63,65,8324.95,14490.01,0.00
2024-12-10 17:27:01,127,10920,63,64,8374.58,14490.11,0.00
2024-12-10 17:27:01,128,10919,64,64,8276.37,14490.35,0.00
2024-12-10 17:27:01,128,10920,64,64,8367.42,14491.00,0.00
2024-12-10 17:27:01,129,10920,64,65,8302.55,14491.01,0.00
2024-12-10 17:27:01,128,10920,64,64,8351.61,14491.11,0.00
2024-12-10 17:27:01,127,10920,64,63,8399.11,14491.16,0.00
2024-12-10 17:27:01,127,10921,64,63,8505.77,14492.00,0.00
2024-12-10 17:27:01,128,10921,64,64,8439.32,14492.01,0.00
2024-12-10 17:27:01,127,10921,64,63,8489.84,14492.11,0.00
2024-12-10 17:27:01,128,10920,65,63,8336.63,14492.73,0.00
2024-12-10 17:27:01,128,10921,65,63,8436.51,14493.00,0.00
2024-12-10 17:27:01,129,10921,66,63,8371.11,14493.01,0.00
2024-12-10 17:27:01,128,10921,66,62,8420.69,14493.11,0.00
2024-12-10 17:27:01,128,10922,66,62,8518.62,14494.00,0.00
2024-12-10 17:27:01,129,10922,67,62,8452.58,14494.01,0.00
2024-12-10 17:27:01,128,10922,66,62,8502.80,14494.11,0.00
2024-12-10 17:27:01,129,10921,67,62,8384.22,14494.49,0.00
2024-12-10 17:27:01,130,10920,67,63,8313.14,14494.66,0.00
2024-12-10 17:27:01,130,10921,67,63,8390.37,14495.00,0.00
2024-12-10 17:27:01,131,10921,67,64,8326.32,14495.01,0.00
2024-12-10 17:27:01,130,10921,66,64,8374.80,14495.11,0.00
2024-12-10 17:27:01,130,10922,66,64,8580.51,14496.00,0.00
2024-12-10 17:27:01,131,10922,66,65,8515.01,14496.01,0.00
2024-12-10 17:27:01,130,10922,65,65,8564.94,14496.11,0.00
2024-12-10 17:27:02,130,10923,65,65,8545.01,14497.00,0.00
2024-12-10 17:27:02,131,10923,66,65,8479.78,14497.01,0.00
2024-12-10 17:27:02,130,10923,66,64,8540.57,14497.03,0.00
2024-12-10 17:27:02,129,10923,66,63,8595.56,14497.10,0.00
2024-12-10 17:27:02,130,10922,66,64,8467.87,14497.51,0.00
2024-12-10 17:27:02,130,10923,66,64,8556.36,14498.00,0.00
2024-12-10 17:27:02,131,10923,66,65,8491.05,14498.01,0.00
2024-12-10 17:27:02,131,10924,66,65,8563.73,14499.00,0.00
2024-12-10 17:27:02,132,10924,67,65,8498.85,14499.01,0.00
2024-12-10 17:27:02,132,10925,67,65,8456.77,14500.00,0.00
2024-12-10 17:27:02,133,10925,67,66,8393.19,14500.01,0.00
2024-12-10 17:27:02,132,10925,66,66,8444.72,14500.08,0.00
2024-12-10 17:27:02,131,10925,66,65,8508.08,14500.08,0.00
2024-12-10 17:27:02,130,10925,66,64,8572.41,14500.08,0.00
2024-12-10 17:27:02,129,10925,66,63,8637.74,14500.08,0.00
2024-12-10 17:27:02,130,10924,66,64,8479.46,14500.71,0.00
2024-12-10 17:27:02,130,10925,66,64,8574.35,14501.00,0.00
2024-12-10 17:27:02,131,10925,66,65,8508.90,14501.01,0.00
2024-12-10 17:27:02,132,10924,67,65,8303.55,14501.92,0.00
2024-12-10 17:27:02,132,10925,67,65,8512.55,14502.00,0.00
2024-12-10 17:27:02,133,10925,67,66,8448.54,14502.01,0.00
2024-12-10 17:27:02,132,10925,66,66,8499.40,14502.09,0.00
2024-12-10 17:27:02,132,10926,66,66,8574.21,14503.00,0.00
2024-12-10 17:27:02,133,10926,67,66,8509.74,14503.01,0.00
2024-12-10 17:27:02,134,10925,68,66,8436.52,14503.09,0.00
