Timestamp,NAnimals,NResources,NFemales,NMales,MeanLifeSuccess,MeanAge,%MatingAccept
2024-12-08 17:08:33,100,0,52,48,0.00,0.00,0.00
2024-12-08 17:08:34,100,0,52,48,0.00,0.00,0.00
2024-12-08 17:08:34,100,1,52,48,0.78,1.00,0.00
2024-12-08 17:08:34,99,1,52,47,0.79,1.03,0.00
2024-12-08 17:08:34,98,1,51,47,0.80,1.04,0.00
2024-12-08 17:08:34,97,1,51,46,0.81,1.04,0.00
2024-12-08 17:08:34,96,1,50,46,0.81,1.04,0.00
2024-12-08 17:08:34,95,1,49,46,0.83,1.05,0.00
2024-12-08 17:08:34,94,1,48,46,0.85,1.09,0.00
2024-12-08 17:08:34,93,1,48,45,0.94,1.25,0.00
2024-12-08 17:08:34,92,1,48,44,0.98,1.29,0.00
2024-12-08 17:08:34,91,1,48,43,1.00,1.32,0.00
2024-12-08 17:08:34,90,1,47,43,1.14,1.60,0.00
2024-12-08 17:08:34,89,1,46,43,1.23,1.74,0.00
2024-12-08 17:08:34,88,1,46,42,1.24,1.75,0.00
2024-12-08 17:08:34,87,1,45,42,1.26,1.77,0.00
2024-12-08 17:08:34,86,1,44,42,1.27,1.78,0.00
2024-12-08 17:08:34,85,1,43,42,1.33,1.91,0.00
2024-12-08 17:08:34,84,1,43,41,1.37,1.95,0.00
2024-12-08 17:08:35,84,2,43,41,1.38,2.00,0.00
2024-12-08 17:08:35,83,2,42,41,1.41,2.06,0.00
2024-12-08 17:08:35,82,2,42,40,1.46,2.10,0.00
2024-12-08 17:08:35,81,2,41,40,1.47,2.11,0.00
2024-12-08 17:08:35,80,2,41,39,1.53,2.20,0.00
2024-12-08 17:08:35,79,2,41,38,1.57,2.25,0.00
2024-12-08 17:08:35,78,2,40,38,1.66,2.36,0.00
2024-12-08 17:08:35,77,2,40,37,1.70,2.39,0.00
2024-12-08 17:08:35,76,2,40,36,1.75,2.42,0.00
2024-12-08 17:08:35,75,2,40,35,1.78,2.44,0.00
2024-12-08 17:08:35,74,2,39,35,1.84,2.50,0.00
2024-12-08 17:08:35,73,2,38,35,1.85,2.51,0.00
2024-12-08 17:08:35,72,2,38,34,1.91,2.57,0.00
2024-12-08 17:08:35,71,2,38,33,1.93,2.58,0.00
2024-12-08 17:08:35,70,2,38,32,2.03,2.74,0.00
2024-12-08 17:08:35,69,2,37,32,2.07,2.81,0.00
2024-12-08 17:08:35,68,2,37,31,2.13,2.90,0.00
2024-12-08 17:08:35,67,2,37,30,2.15,2.91,0.00
2024-12-08 17:08:35,66,2,37,29,2.22,2.98,0.00
2024-12-08 17:08:35,65,2,37,28,2.25,3.00,0.00
2024-12-08 17:08:35,65,3,37,28,2.25,3.00,0.00
2024-12-08 17:08:35,64,3,36,28,2.28,3.00,0.00
2024-12-08 17:08:35,63,3,35,28,2.30,3.02,0.00
2024-12-08 17:08:35,62,3,34,28,2.42,3.19,0.00
2024-12-08 17:08:36,61,3,33,28,2.74,3.67,0.00
2024-12-08 17:08:36,60,3,32,28,2.83,3.73,0.00
2024-12-08 17:08:36,59,3,32,27,2.88,3.76,0.00
2024-12-08 17:08:36,58,3,31,27,2.95,3.84,0.00
2024-12-08 17:08:36,57,3,30,27,2.99,3.86,0.00
2024-12-08 17:08:36,57,4,30,27,3.05,4.00,0.00
2024-12-08 17:08:36,56,4,29,27,3.16,4.14,0.00
2024-12-08 17:08:36,55,4,28,27,3.22,4.16,0.00
2024-12-08 17:08:36,54,4,28,26,3.49,4.61,0.00
2024-12-08 17:08:36,53,4,27,26,3.66,4.79,0.00
2024-12-08 17:08:36,52,4,26,26,3.74,4.83,0.00
2024-12-08 17:08:36,51,4,25,26,3.86,4.90,0.00
2024-12-08 17:08:36,50,4,24,26,4.00,5.00,0.00
2024-12-08 17:08:36,50,5,24,26,4.00,5.00,0.00
2024-12-08 17:08:36,49,5,24,25,4.17,5.12,0.00
2024-12-08 17:08:36,48,5,23,25,4.33,5.21,0.00
2024-12-08 17:08:36,47,5,22,25,4.45,5.40,0.00
2024-12-08 17:08:36,46,5,21,25,4.69,5.61,0.00
2024-12-08 17:08:36,46,6,21,25,4.98,6.00,0.00
2024-12-08 17:08:36,45,6,20,25,5.29,6.40,0.00
2024-12-08 17:08:36,45,7,20,25,5.70,7.00,0.00
2024-12-08 17:08:36,44,7,20,24,6.01,7.39,0.00
2024-12-08 17:08:36,43,7,20,23,6.27,7.63,0.00
2024-12-08 17:08:36,43,8,20,23,6.55,8.00,0.00
2024-12-08 17:08:36,42,8,20,22,6.67,8.00,0.00
2024-12-08 17:08:36,41,8,19,22,7.16,8.56,0.00
2024-12-08 17:08:36,41,9,19,22,7.47,9.00,0.00
2024-12-08 17:08:36,41,10,19,22,8.14,10.00,0.00
2024-12-08 17:08:36,42,10,20,22,7.94,10.02,0.00
2024-12-08 17:08:36,41,10,20,21,8.16,10.24,0.00
2024-12-08 17:08:36,41,11,20,21,8.62,11.00,0.00
2024-12-08 17:08:36,42,11,20,22,8.42,11.02,0.00
2024-12-08 17:08:36,42,12,20,22,9.06,12.00,0.00
2024-12-08 17:08:36,43,12,20,23,8.85,12.02,0.00
2024-12-08 17:08:36,43,13,20,23,9.41,13.00,0.00
2024-12-08 17:08:36,44,13,21,23,9.19,13.02,0.00
2024-12-08 17:08:36,43,13,20,23,9.44,13.12,0.00
2024-12-08 17:08:36,43,14,20,23,10.00,14.00,0.00
2024-12-08 17:08:36,44,14,21,23,9.77,14.02,0.00
2024-12-08 17:08:36,43,14,21,22,10.09,14.19,0.00
2024-12-08 17:08:36,42,14,20,22,10.54,14.71,0.00
2024-12-08 17:08:36,42,15,20,22,10.98,15.00,0.00
2024-12-08 17:08:36,43,15,21,22,10.72,15.02,0.00
2024-12-08 17:08:36,42,15,20,22,11.19,15.60,0.00
2024-12-08 17:08:36,42,16,20,22,11.73,16.00,0.00
2024-12-08 17:08:36,43,16,21,22,11.45,16.02,0.00
2024-12-08 17:08:37,43,17,21,22,12.19,17.00,0.00
2024-12-08 17:08:37,44,17,21,23,11.91,17.02,0.00
2024-12-08 17:08:37,43,17,20,23,12.27,17.19,0.00
2024-12-08 17:08:37,43,18,20,23,12.86,18.00,0.00
2024-12-08 17:08:37,44,18,20,24,12.56,18.02,0.00
2024-12-08 17:08:37,43,18,20,23,13.09,18.70,0.00
2024-12-08 17:08:37,43,19,20,23,13.53,19.00,0.00
2024-12-08 17:08:37,44,19,21,23,13.22,19.02,0.00
2024-12-08 17:08:37,43,19,21,22,13.65,19.26,0.00
2024-12-08 17:08:37,43,20,21,22,14.25,20.00,0.00
2024-12-08 17:08:37,44,20,22,22,13.92,20.02,0.00
2024-12-08 17:08:37,43,20,22,21,14.23,20.67,0.00
2024-12-08 17:08:37,43,21,22,21,14.89,21.00,0.00
2024-12-08 17:08:37,44,21,23,21,14.55,21.02,0.00
2024-12-08 17:08:37,44,22,23,21,15.24,22.00,0.00
2024-12-08 17:08:37,45,22,23,22,14.90,22.02,0.00
2024-12-08 17:08:37,45,23,23,22,15.57,23.00,0.00
2024-12-08 17:08:37,46,23,23,23,15.23,23.02,0.00
2024-12-08 17:08:37,45,23,23,22,15.58,23.38,0.00
2024-12-08 17:08:37,45,24,23,22,16.25,24.00,0.00
2024-12-08 17:08:37,46,24,24,22,15.89,24.02,0.00
2024-12-08 17:08:37,45,24,24,21,16.12,24.44,0.00
2024-12-08 17:08:37,45,25,24,21,16.92,25.00,0.00
2024-12-08 17:08:37,46,25,24,22,16.55,25.02,0.00
2024-12-08 17:08:37,46,26,24,22,17.19,26.00,0.00
2024-12-08 17:08:37,47,26,25,22,16.83,26.02,0.00
2024-12-08 17:08:37,46,26,24,22,17.12,26.39,0.00
2024-12-08 17:08:37,46,27,24,22,17.84,27.00,0.00
2024-12-08 17:08:37,47,27,25,22,17.46,27.02,0.00
2024-12-08 17:08:37,46,27,25,21,17.88,27.24,0.00
2024-12-08 17:08:37,46,28,25,21,18.55,28.00,0.00
2024-12-08 17:08:37,47,28,25,22,18.16,28.02,0.00
2024-12-08 17:08:37,47,29,25,22,18.84,29.00,0.00
2024-12-08 17:08:37,48,29,26,22,18.45,29.02,0.00
2024-12-08 17:08:37,47,29,26,21,18.88,29.17,0.00
2024-12-08 17:08:37,46,29,26,20,19.37,29.57,0.00
2024-12-08 17:08:37,46,30,26,20,20.06,30.00,0.00
2024-12-08 17:08:37,47,30,27,20,19.63,30.02,0.00
2024-12-08 17:08:38,47,31,27,20,20.38,31.00,0.00
2024-12-08 17:08:38,48,31,28,20,19.95,31.02,0.00
2024-12-08 17:08:38,48,32,28,20,20.68,32.00,0.00
2024-12-08 17:08:38,49,32,29,20,20.26,32.02,0.00
2024-12-08 17:08:38,48,32,29,19,20.69,32.58,0.00
2024-12-08 17:08:38,48,33,29,19,21.41,33.00,0.00
2024-12-08 17:08:38,49,33,29,20,20.97,33.02,0.00
2024-12-08 17:08:38,49,34,29,20,21.67,34.00,0.00
2024-12-08 17:08:38,50,34,30,20,21.24,34.02,0.00
2024-12-08 17:08:38,50,35,30,20,21.92,35.00,0.00
2024-12-08 17:08:38,51,35,30,21,21.49,35.02,0.00
2024-12-08 17:08:38,50,35,29,21,22.02,35.54,0.00
2024-12-08 17:08:38,50,36,29,21,22.60,36.00,0.00
2024-12-08 17:08:38,51,36,29,22,22.16,36.02,0.00
2024-12-08 17:08:38,51,37,29,22,22.80,37.00,0.00
2024-12-08 17:08:38,52,37,29,23,22.36,37.02,0.00
2024-12-08 17:08:38,52,38,29,23,22.98,38.00,0.00
2024-12-08 17:08:38,53,38,30,23,22.54,38.02,0.00
2024-12-08 17:08:38,52,38,29,23,22.87,38.42,0.00
2024-12-08 17:08:38,52,39,29,23,23.72,39.00,0.00
2024-12-08 17:08:38,53,39,29,24,23.27,39.02,0.00
2024-12-08 17:08:38,52,39,29,23,23.72,39.12,0.00
2024-12-08 17:08:38,52,40,29,23,24.46,40.00,0.00
2024-12-08 17:08:38,53,40,29,24,24.00,40.02,0.00
2024-12-08 17:08:38,52,40,28,24,24.46,40.08,0.00
2024-12-08 17:08:38,51,40,28,23,24.80,40.47,0.00
2024-12-08 17:08:38,51,41,28,23,25.75,41.00,0.00
2024-12-08 17:08:38,52,41,28,24,25.26,41.02,0.00
2024-12-08 17:08:38,51,41,28,23,25.74,41.39,0.00
2024-12-08 17:08:38,51,42,28,23,26.40,42.00,0.00
2024-12-08 17:08:38,52,42,29,23,25.89,42.02,0.00
2024-12-08 17:08:38,52,43,29,23,26.58,43.00,0.00
2024-12-08 17:08:38,53,43,29,24,26.08,43.02,0.00
2024-12-08 17:08:38,53,44,29,24,26.76,44.00,0.00
2024-12-08 17:08:38,54,44,30,24,26.26,44.02,0.00
2024-12-08 17:08:38,53,44,30,23,26.65,44.51,0.00
2024-12-08 17:08:38,53,45,30,23,27.48,45.00,0.00
2024-12-08 17:08:38,54,45,31,23,26.97,45.02,0.00
2024-12-08 17:08:38,53,45,30,23,27.40,45.47,0.00
2024-12-08 17:08:38,53,46,30,23,28.24,46.00,0.00
2024-12-08 17:08:38,54,46,30,24,27.72,46.02,0.00
2024-12-08 17:08:38,54,47,30,24,28.38,47.00,0.00
2024-12-08 17:08:38,55,47,31,24,27.87,47.02,0.00
2024-12-08 17:08:38,55,48,31,24,28.51,48.00,0.00
2024-12-08 17:08:38,56,48,31,25,28.00,48.02,0.00
2024-12-08 17:08:38,55,48,31,24,28.40,48.47,0.00
2024-12-08 17:08:38,55,49,31,24,29.24,49.00,0.00
2024-12-08 17:08:38,56,49,32,24,28.72,49.02,0.00
2024-12-08 17:08:38,56,50,32,24,29.35,50.00,0.00
2024-12-08 17:08:38,57,50,32,25,28.83,50.02,0.00
2024-12-08 17:08:38,56,50,31,25,29.20,50.50,0.00
2024-12-08 17:08:38,56,51,31,25,30.05,51.00,0.00
2024-12-08 17:08:38,57,51,31,26,29.52,51.02,0.00
2024-12-08 17:08:39,57,52,31,26,30.13,52.00,0.00
2024-12-08 17:08:39,58,52,32,26,29.61,52.02,0.00
2024-12-08 17:08:39,57,52,32,25,29.96,52.49,0.00
2024-12-08 17:08:39,57,53,32,25,30.81,53.00,0.00
2024-12-08 17:08:39,58,53,33,25,30.28,53.02,0.00
2024-12-08 17:08:39,58,54,33,25,30.87,54.00,0.00
2024-12-08 17:08:39,59,54,33,26,30.34,54.02,0.00
2024-12-08 17:08:39,58,54,32,26,30.80,54.41,0.00
2024-12-08 17:08:39,58,55,32,26,31.45,55.00,0.00
2024-12-08 17:08:39,59,55,32,27,30.92,55.02,0.00
2024-12-08 17:08:39,59,56,32,27,31.50,56.00,0.00
2024-12-08 17:08:39,60,56,33,27,30.97,56.02,0.00
2024-12-08 17:08:39,59,56,32,27,31.38,56.44,0.00
2024-12-08 17:08:39,58,56,32,26,31.84,56.45,0.00
2024-12-08 17:08:39,58,57,32,26,32.91,57.00,0.00
2024-12-08 17:08:39,59,57,33,26,32.35,57.02,0.00
2024-12-08 17:08:39,58,57,32,26,32.86,57.14,0.00
2024-12-08 17:08:39,57,57,31,26,33.39,57.40,0.00
2024-12-08 17:08:39,57,58,31,26,34.29,58.00,0.00
2024-12-08 17:08:39,58,58,31,27,33.70,58.02,0.00
2024-12-08 17:08:39,58,59,31,27,34.31,59.00,0.00
2024-12-08 17:08:39,59,59,31,28,33.73,59.02,0.00
2024-12-08 17:08:39,59,60,31,28,34.31,60.00,0.00
2024-12-08 17:08:39,60,60,31,29,33.74,60.02,0.00
2024-12-08 17:08:39,60,61,31,29,34.28,61.00,0.00
2024-12-08 17:08:39,61,61,32,29,33.72,61.02,0.00
2024-12-08 17:08:39,60,61,32,28,34.13,61.42,0.00
2024-12-08 17:08:39,60,62,32,28,34.96,62.00,0.00
2024-12-08 17:08:39,61,62,32,29,34.39,62.02,0.00
2024-12-08 17:08:39,61,63,32,29,34.89,63.00,0.00
2024-12-08 17:08:39,62,63,33,29,34.33,63.02,0.00
2024-12-08 17:08:39,61,63,32,29,34.74,63.41,0.00
2024-12-08 17:08:39,61,64,32,29,35.57,64.00,0.00
2024-12-08 17:08:39,62,64,32,30,34.99,64.02,0.00
2024-12-08 17:08:39,61,64,32,29,35.40,64.43,0.00
2024-12-08 17:08:39,61,65,32,29,36.24,65.00,0.00
2024-12-08 17:08:39,62,65,33,29,35.66,65.02,0.00
2024-12-08 17:08:39,62,66,33,29,36.16,66.00,0.00
2024-12-08 17:08:39,63,66,33,30,35.59,66.02,0.00
2024-12-08 17:08:39,63,67,33,30,36.08,67.00,0.00
2024-12-08 17:08:39,64,67,34,30,35.52,67.02,0.00
2024-12-08 17:08:39,64,68,34,30,36.00,68.00,0.00
2024-12-08 17:08:39,65,68,34,31,35.45,68.02,0.00
2024-12-08 17:08:39,64,68,34,30,35.78,68.47,0.00
2024-12-08 17:08:39,64,69,34,30,36.64,69.00,0.00
2024-12-08 17:08:39,65,69,35,30,36.08,69.02,0.00
2024-12-08 17:08:39,65,70,35,30,36.56,70.00,0.00
2024-12-08 17:08:39,66,70,36,30,36.01,70.02,0.00
2024-12-08 17:08:39,66,71,36,30,36.47,71.00,0.00
2024-12-08 17:08:39,67,71,37,30,35.92,71.01,0.00
2024-12-08 17:08:39,67,72,37,30,36.36,72.00,0.00
2024-12-08 17:08:39,68,72,38,30,35.83,72.01,0.00
2024-12-08 17:08:39,67,72,38,29,36.12,72.46,0.00
2024-12-08 17:08:39,67,73,38,29,36.97,73.00,0.00
2024-12-08 17:08:39,68,73,39,29,36.43,73.01,0.00
2024-12-08 17:08:39,68,74,39,29,36.84,74.00,0.00
2024-12-08 17:08:39,69,74,39,30,36.31,74.01,0.00
2024-12-08 17:08:39,68,74,38,30,36.80,74.09,0.00
2024-12-08 17:08:39,67,74,37,30,37.24,74.31,0.00
2024-12-08 17:08:39,66,74,36,30,37.76,74.42,0.00
2024-12-08 17:08:40,66,75,36,30,38.40,75.00,0.00
2024-12-08 17:08:40,67,75,36,31,37.83,75.01,0.00
2024-12-08 17:08:40,66,75,35,31,37.92,75.45,0.00
2024-12-08 17:08:40,66,76,35,31,39.04,76.00,0.00
2024-12-08 17:08:40,67,76,36,31,38.45,76.01,0.00
2024-12-08 17:08:40,66,76,36,30,38.82,76.42,0.00
2024-12-08 17:08:40,66,77,36,30,39.71,77.00,0.00
2024-12-08 17:08:40,67,77,37,30,39.12,77.01,0.00
2024-12-08 17:08:40,67,78,37,30,39.56,78.00,0.00
2024-12-08 17:08:40,68,78,38,30,38.98,78.01,0.00
2024-12-08 17:08:40,68,79,38,30,39.40,79.00,0.00
2024-12-08 17:08:40,69,79,39,30,38.83,79.01,0.00
2024-12-08 17:08:40,68,79,39,29,38.95,79.41,0.00
2024-12-08 17:08:40,68,80,39,29,39.82,80.00,0.00
2024-12-08 17:08:40,69,80,40,29,39.25,80.01,0.00
2024-12-08 17:08:40,69,81,40,29,39.64,81.00,0.00
2024-12-08 17:08:40,70,81,41,29,39.08,81.01,0.00
2024-12-08 17:08:40,70,82,41,29,39.45,82.00,0.00
2024-12-08 17:08:40,71,82,41,30,38.90,82.01,0.00
2024-12-08 17:08:40,70,82,41,29,39.09,82.24,0.00
2024-12-08 17:08:40,70,83,41,29,39.85,83.00,0.00
2024-12-08 17:08:40,71,83,41,30,39.29,83.01,0.00
2024-12-08 17:08:40,70,83,41,29,39.42,83.39,0.00
2024-12-08 17:08:40,70,84,41,29,40.26,84.00,0.00
2024-12-08 17:08:40,71,84,42,29,39.69,84.01,0.00
2024-12-08 17:08:40,71,85,42,29,40.05,85.00,0.00
2024-12-08 17:08:40,72,85,43,29,39.49,85.01,0.00
2024-12-08 17:08:40,72,86,43,29,39.82,86.00,0.00
2024-12-08 17:08:40,73,86,43,30,39.28,86.01,0.00
2024-12-08 17:08:40,72,86,43,29,39.39,86.38,0.00
2024-12-08 17:08:40,72,87,43,29,40.21,87.00,0.00
2024-12-08 17:08:40,73,87,44,29,39.66,87.01,0.00
2024-12-08 17:08:40,72,87,43,29,39.46,87.43,0.00
2024-12-08 17:08:40,72,88,43,29,40.55,88.00,0.00
2024-12-08 17:08:40,73,88,44,29,40.00,88.01,0.00
2024-12-08 17:08:40,73,89,44,29,40.31,89.00,0.00
2024-12-08 17:08:40,74,89,44,30,39.76,89.01,0.00
2024-12-08 17:08:40,73,89,43,30,40.05,89.32,0.00
2024-12-08 17:08:40,72,89,43,29,40.42,89.36,0.00
2024-12-08 17:08:40,72,90,43,29,41.24,90.00,0.00
2024-12-08 17:08:40,73,90,44,29,40.68,90.01,0.00
2024-12-08 17:08:40,72,90,44,28,41.15,90.08,0.00
2024-12-08 17:08:40,72,91,44,28,41.51,91.00,0.00
2024-12-08 17:08:40,73,91,45,28,40.94,91.01,0.00
2024-12-08 17:08:40,73,92,45,28,41.21,92.00,0.00
2024-12-08 17:08:40,74,92,45,29,40.66,92.01,0.00
2024-12-08 17:08:40,73,92,45,28,40.79,92.36,0.00
2024-12-08 17:08:40,73,93,45,28,41.59,93.00,0.00
2024-12-08 17:08:40,74,93,46,28,41.03,93.01,0.00
2024-12-08 17:08:40,74,94,46,28,41.28,94.00,0.00
2024-12-08 17:08:40,75,94,46,29,40.73,94.01,0.00
2024-12-08 17:08:40,75,95,46,29,40.97,95.00,0.00
2024-12-08 17:08:41,76,95,47,29,40.43,95.01,0.00
2024-12-08 17:08:41,75,95,47,28,40.53,95.36,0.00
2024-12-08 17:08:41,75,96,47,28,41.31,96.00,0.00
2024-12-08 17:08:41,76,96,47,29,40.76,96.01,0.00
2024-12-08 17:08:41,76,97,47,29,40.96,97.00,0.00
2024-12-08 17:08:41,77,97,48,29,40.43,97.01,0.00
2024-12-08 17:08:41,76,97,47,29,40.38,97.38,0.00
2024-12-08 17:08:41,76,98,47,29,41.15,98.00,0.00
2024-12-08 17:08:41,77,98,47,30,40.62,98.01,0.00
2024-12-08 17:08:41,76,98,47,29,40.69,98.37,0.00
2024-12-08 17:08:41,75,98,46,29,41.15,98.47,0.00
2024-12-08 17:08:41,75,99,46,29,42.02,99.00,0.00
2024-12-08 17:08:41,76,99,46,30,41.47,99.01,0.00
2024-12-08 17:08:41,75,99,46,29,42.01,99.01,0.00
2024-12-08 17:08:41,74,99,45,29,42.56,99.01,0.00
2024-12-08 17:08:41,73,99,45,28,43.13,99.01,0.00
2024-12-08 17:08:41,72,99,45,27,43.72,99.01,0.00
2024-12-08 17:08:41,71,99,44,27,44.32,99.01,0.00
2024-12-08 17:08:41,70,99,43,27,44.94,99.01,0.00
2024-12-08 17:08:41,69,99,42,27,45.57,99.01,0.00
2024-12-08 17:08:41,68,99,41,27,46.23,99.01,0.00
2024-12-08 17:08:41,67,99,41,26,46.90,99.01,0.00
2024-12-08 17:08:41,66,99,40,26,47.60,99.02,0.00
2024-12-08 17:08:41,65,99,40,25,48.32,99.02,0.00
2024-12-08 17:08:41,64,99,40,24,49.06,99.02,0.00
2024-12-08 17:08:41,63,99,39,24,49.82,99.02,0.00
2024-12-08 17:08:41,62,99,39,23,50.61,99.02,0.00
2024-12-08 17:08:41,61,99,38,23,51.42,99.02,0.00
2024-12-08 17:08:41,60,99,37,23,52.26,99.02,0.00
2024-12-08 17:08:41,59,99,36,23,53.13,99.02,0.00
2024-12-08 17:08:41,58,99,36,22,54.03,99.02,0.00
2024-12-08 17:08:41,57,99,35,22,54.21,99.21,0.00
2024-12-08 17:08:41,57,100,35,22,55.68,100.00,0.00
2024-12-08 17:08:41,58,100,35,23,54.72,100.02,0.00
2024-12-08 17:08:41,58,101,35,23,55.28,101.00,0.00
2024-12-08 17:08:41,59,101,35,24,54.34,101.02,0.00
2024-12-08 17:08:41,58,101,35,23,55.09,101.17,0.00
2024-12-08 17:08:41,58,102,35,23,56.14,102.00,0.00
2024-12-08 17:08:41,59,102,36,23,55.19,102.02,0.00
2024-12-08 17:08:41,58,102,35,23,55.14,102.72,0.00
2024-12-08 17:08:41,58,103,35,23,56.79,103.00,0.00
2024-12-08 17:08:41,59,103,35,24,55.83,103.02,0.00
2024-12-08 17:08:41,58,103,34,24,56.70,103.12,0.00
2024-12-08 17:08:41,58,104,34,24,57.34,104.00,0.00
2024-12-08 17:08:41,59,104,34,25,56.36,104.02,0.00
2024-12-08 17:08:41,58,104,34,24,57.07,104.16,0.00
2024-12-08 17:08:41,58,105,34,24,58.09,105.00,0.00
2024-12-08 17:08:41,59,105,35,24,57.10,105.02,0.00
2024-12-08 17:08:41,59,106,35,24,57.60,106.00,0.00
2024-12-08 17:08:41,60,106,35,25,56.64,106.02,0.00
2024-12-08 17:08:41,60,107,35,25,57.09,107.00,0.00
2024-12-08 17:08:41,61,107,36,25,56.15,107.02,0.00
2024-12-08 17:08:41,60,107,35,25,56.84,107.15,0.00
2024-12-08 17:08:41,59,107,35,24,57.66,107.15,0.00
2024-12-08 17:08:41,59,108,35,24,58.95,108.00,0.00
2024-12-08 17:08:41,60,108,36,24,57.96,108.02,0.00
2024-12-08 17:08:41,59,108,35,24,58.91,108.05,0.00
2024-12-08 17:08:41,59,109,35,24,59.32,109.00,0.00
2024-12-08 17:08:41,60,109,36,24,58.33,109.02,0.00
2024-12-08 17:08:41,59,109,35,24,58.15,109.66,0.00
2024-12-08 17:08:41,59,110,35,24,59.65,110.00,0.00
2024-12-08 17:08:41,60,110,36,24,58.65,110.02,0.00
2024-12-08 17:08:41,59,110,36,23,59.42,110.14,0.00
2024-12-08 17:08:41,59,111,36,23,60.18,111.00,0.00
2024-12-08 17:08:41,60,111,37,23,59.18,111.02,0.00
2024-12-08 17:08:41,59,111,36,23,60.14,111.05,0.00
2024-12-08 17:08:41,59,112,36,23,60.42,112.00,0.00
2024-12-08 17:08:41,60,112,37,23,59.41,112.02,0.00
2024-12-08 17:08:41,59,112,36,23,60.39,112.05,0.00
2024-12-08 17:08:41,59,113,36,23,60.63,113.00,0.00
2024-12-08 17:08:41,60,113,36,24,59.62,113.02,0.00
2024-12-08 17:08:41,59,113,36,23,60.41,113.12,0.00
2024-12-08 17:08:41,59,114,36,23,61.11,114.00,0.00
2024-12-08 17:08:41,60,114,37,23,60.09,114.02,0.00
2024-12-08 17:08:42,60,115,37,23,60.29,115.00,0.00
2024-12-08 17:08:42,61,115,37,24,59.30,115.02,0.00
2024-12-08 17:08:42,60,115,37,23,59.27,115.75,0.00
2024-12-08 17:08:42,60,116,37,23,60.64,116.00,0.00
2024-12-08 17:08:42,61,116,37,24,59.65,116.02,0.00
2024-12-08 17:08:42,60,116,36,24,60.54,116.10,0.00
2024-12-08 17:08:42,60,117,36,24,61.09,117.00,0.00
2024-12-08 17:08:42,61,117,36,25,60.09,117.02,0.00
2024-12-08 17:08:42,60,117,36,24,60.95,117.10,0.00
2024-12-08 17:08:42,60,118,36,24,61.91,118.00,0.00
2024-12-08 17:08:42,61,118,36,25,60.90,118.02,0.00
2024-12-08 17:08:42,61,119,36,25,61.36,119.00,0.00
2024-12-08 17:08:42,62,119,36,26,60.37,119.02,0.00
2024-12-08 17:08:42,61,119,35,26,61.34,119.02,0.00
2024-12-08 17:08:42,61,120,35,26,61.80,120.00,0.00
2024-12-08 17:08:42,62,120,36,26,60.80,120.02,0.00
2024-12-08 17:08:42,61,120,36,25,61.71,120.08,0.00
2024-12-08 17:08:42,60,120,35,25,61.80,120.92,0.00
2024-12-08 17:08:42,60,121,35,25,63.78,121.00,0.00
2024-12-08 17:08:42,61,121,35,26,62.74,121.02,0.00
2024-12-08 17:08:42,61,122,35,26,63.15,122.00,0.00
2024-12-08 17:08:42,62,122,36,26,62.13,122.02,0.00
2024-12-08 17:08:42,61,122,36,25,63.04,122.10,0.00
2024-12-08 17:08:42,60,122,35,25,64.05,122.10,0.00
2024-12-08 17:08:42,60,123,35,25,65.35,123.00,0.00
2024-12-08 17:08:42,61,123,35,26,64.28,123.02,0.00
2024-12-08 17:08:42,60,123,35,25,63.94,123.65,0.00
2024-12-08 17:08:42,60,124,35,25,65.70,124.00,0.00
2024-12-08 17:08:42,61,124,36,25,64.62,124.02,0.00
2024-12-08 17:08:42,60,124,35,25,65.68,124.02,0.00
2024-12-08 17:08:42,60,125,35,25,66.05,125.00,0.00
2024-12-08 17:08:42,61,125,35,26,64.96,125.02,0.00
2024-12-08 17:08:42,60,125,35,25,65.55,125.08,0.00
2024-12-08 17:08:42,60,126,35,25,66.40,126.00,0.00
2024-12-08 17:08:42,61,126,36,25,65.31,126.02,0.00
2024-12-08 17:08:42,60,126,35,25,66.33,126.08,0.00
2024-12-08 17:08:42,59,126,35,24,67.00,126.08,0.00
2024-12-08 17:08:42,59,127,35,24,67.89,127.00,0.00
2024-12-08 17:08:42,60,127,36,24,66.76,127.02,0.00
2024-12-08 17:08:42,59,127,35,24,67.76,127.02,0.00
2024-12-08 17:08:42,59,128,35,24,68.57,128.00,0.00
2024-12-08 17:08:42,60,128,36,24,67.43,128.02,0.00
2024-12-08 17:08:42,59,128,35,24,68.56,128.03,0.00
2024-12-08 17:08:42,58,128,34,24,69.72,128.05,0.00
2024-12-08 17:08:42,57,128,34,23,70.47,128.05,0.00
2024-12-08 17:08:42,57,129,34,23,71.41,129.00,0.00
2024-12-08 17:08:42,58,129,34,24,70.18,129.02,0.00
2024-12-08 17:08:42,57,129,33,24,70.49,129.23,0.00
2024-12-08 17:08:42,57,130,33,24,72.08,130.00,0.00
2024-12-08 17:08:42,58,130,34,24,70.83,130.02,0.00
2024-12-08 17:08:42,57,130,33,24,71.99,130.07,0.00
2024-12-08 17:08:42,57,131,33,24,72.53,131.00,0.00
2024-12-08 17:08:42,58,131,34,24,71.28,131.02,0.00
2024-12-08 17:08:42,57,131,34,23,72.31,131.12,0.00
2024-12-08 17:08:42,57,132,34,23,73.40,132.00,0.00
2024-12-08 17:08:42,58,132,34,24,72.14,132.02,0.00
2024-12-08 17:08:42,57,132,33,24,73.34,132.07,0.00
2024-12-08 17:08:42,57,133,33,24,73.96,133.00,0.00
2024-12-08 17:08:42,58,133,34,24,72.68,133.02,0.00
2024-12-08 17:08:42,57,133,33,24,73.19,133.16,0.00
2024-12-08 17:08:42,57,134,33,24,74.87,134.00,0.00
2024-12-08 17:08:42,58,134,33,25,73.58,134.02,0.00
2024-12-08 17:08:42,57,134,33,24,74.73,134.11,0.00
2024-12-08 17:08:43,57,135,33,24,75.93,135.00,0.00
2024-12-08 17:08:43,58,135,34,24,74.62,135.02,0.00
2024-12-08 17:08:43,57,135,33,24,75.60,135.16,0.00
2024-12-08 17:08:43,57,136,33,24,76.88,136.00,0.00
2024-12-08 17:08:43,58,136,34,24,75.55,136.02,0.00
2024-12-08 17:08:43,58,137,34,24,76.18,137.00,0.00
2024-12-08 17:08:43,59,137,35,24,74.89,137.02,0.00
2024-12-08 17:08:43,58,137,35,23,75.87,137.16,0.00
2024-12-08 17:08:43,58,138,35,23,77.14,138.00,0.00
2024-12-08 17:08:43,59,138,35,24,75.83,138.02,0.00
2024-12-08 17:08:43,59,139,35,24,76.43,139.00,0.00
2024-12-08 17:08:43,60,139,36,24,75.15,139.02,0.00
2024-12-08 17:08:43,60,140,36,24,75.71,140.00,0.00
2024-12-08 17:08:43,61,140,36,25,74.47,140.02,0.00
2024-12-08 17:08:43,60,140,35,25,75.43,140.05,0.00
2024-12-08 17:08:43,59,140,35,24,76.41,140.17,0.00
2024-12-08 17:08:43,59,141,35,24,78.13,141.00,0.00
2024-12-08 17:08:43,60,141,36,24,76.82,141.02,0.00
2024-12-08 17:08:43,59,141,35,24,78.08,141.03,0.00
2024-12-08 17:08:43,59,142,35,24,78.68,142.00,0.00
2024-12-08 17:08:43,60,142,36,24,77.37,142.02,0.00
2024-12-08 17:08:43,60,143,36,24,77.90,143.00,0.00
2024-12-08 17:08:43,61,143,36,25,76.62,143.02,0.00
2024-12-08 17:08:43,60,143,36,24,77.54,143.17,0.00
2024-12-08 17:08:43,60,144,36,24,78.74,144.00,0.00
2024-12-08 17:08:43,61,144,36,25,77.45,144.02,0.00
2024-12-08 17:08:43,60,144,35,25,78.72,144.02,0.00
2024-12-08 17:08:43,59,144,34,25,79.90,144.12,0.00
2024-12-08 17:08:43,59,145,34,25,80.58,145.00,0.00
2024-12-08 17:08:43,60,145,35,25,79.24,145.02,0.00
2024-12-08 17:08:43,59,145,34,25,79.48,145.25,0.00
2024-12-08 17:08:43,59,146,34,25,81.32,146.00,0.00
2024-12-08 17:08:43,60,146,35,25,79.96,146.02,0.00
2024-12-08 17:08:43,59,146,35,24,80.94,146.17,0.00
2024-12-08 17:08:43,59,147,35,24,82.19,147.00,0.00
2024-12-08 17:08:43,60,147,35,25,80.82,147.02,0.00
2024-12-08 17:08:43,59,147,34,25,81.19,147.37,0.00
2024-12-08 17:08:43,59,148,34,25,82.71,148.00,0.00
2024-12-08 17:08:43,60,148,34,26,81.33,148.02,0.00
2024-12-08 17:08:43,59,148,33,26,82.58,148.12,0.00
2024-12-08 17:08:43,59,149,33,26,83.26,149.00,0.00
2024-12-08 17:08:43,60,149,34,26,81.87,149.02,0.00
2024-12-08 17:08:43,59,149,34,25,82.90,149.17,0.00
2024-12-08 17:08:43,59,150,34,25,84.20,150.00,0.00
2024-12-08 17:08:43,60,150,34,26,82.80,150.02,0.00
2024-12-08 17:08:43,59,150,33,26,83.40,150.24,0.00
2024-12-08 17:08:43,59,151,33,26,84.81,151.00,0.00
2024-12-08 17:08:43,60,151,34,26,83.39,151.02,0.00
2024-12-08 17:08:43,59,151,33,26,84.67,151.12,0.00
2024-12-08 17:08:43,59,152,33,26,85.42,152.00,0.00
2024-12-08 17:08:43,60,152,33,27,84.00,152.02,0.00
2024-12-08 17:08:43,59,152,33,26,85.08,152.17,0.00
2024-12-08 17:08:44,59,153,33,26,86.42,153.00,0.00
2024-12-08 17:08:44,60,153,33,27,84.98,153.02,0.00
2024-12-08 17:08:44,60,154,33,27,85.56,154.00,0.00
2024-12-08 17:08:44,61,154,33,28,84.16,154.02,0.00
2024-12-08 17:08:44,60,154,32,28,85.54,154.03,0.00
2024-12-08 17:08:44,59,154,31,28,86.87,154.12,0.00
2024-12-08 17:08:44,59,155,31,28,87.63,155.00,0.00
2024-12-08 17:08:44,60,155,32,28,86.17,155.02,0.00
2024-12-08 17:08:44,59,155,32,27,87.36,155.14,0.00
2024-12-08 17:08:44,59,156,32,27,88.67,156.00,0.00
2024-12-08 17:08:44,60,156,32,28,87.20,156.02,0.00
2024-12-08 17:08:44,60,157,32,28,87.78,157.00,0.00
2024-12-08 17:08:44,61,157,33,28,86.34,157.02,0.00
2024-12-08 17:08:44,60,157,32,28,87.76,157.03,0.00
2024-12-08 17:08:44,59,157,32,27,88.70,157.12,0.00
2024-12-08 17:08:44,59,158,32,27,90.00,158.00,0.00
2024-12-08 17:08:44,60,158,33,27,88.50,158.02,0.00
2024-12-08 17:08:44,59,158,32,27,89.97,158.03,0.00
2024-12-08 17:08:44,58,158,31,27,90.46,158.19,0.00
2024-12-08 17:08:44,58,159,31,27,92.40,159.00,0.00
2024-12-08 17:08:44,59,159,31,28,90.84,159.02,0.00
2024-12-08 17:08:44,58,159,30,28,91.60,159.19,0.00
2024-12-08 17:08:44,58,160,30,28,93.04,160.00,0.00
2024-12-08 17:08:44,59,160,30,29,91.46,160.02,0.00
2024-12-08 17:08:44,58,160,29,29,92.98,160.03,0.00
2024-12-08 17:08:44,57,160,29,28,94.43,160.09,0.00
2024-12-08 17:08:44,57,161,29,28,95.80,161.00,0.00
2024-12-08 17:08:44,58,161,29,29,94.15,161.02,0.00
2024-12-08 17:08:44,58,162,29,29,94.81,162.00,0.00
2024-12-08 17:08:44,59,162,30,29,93.21,162.02,0.00
2024-12-08 17:08:44,58,162,30,28,94.42,162.09,0.00
2024-12-08 17:08:44,57,162,29,28,95.48,162.65,0.00
2024-12-08 17:08:44,57,163,29,28,97.46,163.00,0.00
2024-12-08 17:08:44,58,163,30,28,95.78,163.02,0.00
2024-12-08 17:08:44,58,164,30,28,96.45,164.00,0.00
2024-12-08 17:08:44,59,164,31,28,94.81,164.02,0.00
2024-12-08 17:08:44,59,165,31,28,95.45,165.00,0.00
2024-12-08 17:08:44,60,165,31,29,93.86,165.02,0.00
2024-12-08 17:08:44,59,165,31,28,95.27,165.10,0.00
2024-12-08 17:08:44,59,166,31,28,96.59,166.00,0.00
2024-12-08 17:08:44,60,166,32,28,94.98,166.02,0.00
2024-12-08 17:08:44,59,166,32,27,96.06,166.03,0.00
2024-12-08 17:08:44,59,167,32,27,97.28,167.00,0.00
2024-12-08 17:08:44,60,167,33,27,95.66,167.02,0.00
2024-12-08 17:08:44,60,168,33,27,96.26,168.00,0.00
2024-12-08 17:08:44,61,168,33,28,94.69,168.02,0.00
2024-12-08 17:08:44,61,169,33,28,95.25,169.00,0.00
2024-12-08 17:08:44,62,169,33,29,93.71,169.02,0.00
2024-12-08 17:08:44,61,169,33,28,94.94,169.13,0.00
2024-12-08 17:08:44,61,170,33,28,96.14,170.00,0.00
2024-12-08 17:08:44,62,170,34,28,94.59,170.02,0.00
2024-12-08 17:08:44,61,170,33,28,95.91,170.11,0.00
2024-12-08 17:08:44,61,171,33,28,97.07,171.00,0.00
2024-12-08 17:08:44,62,171,33,29,95.51,171.02,0.00
2024-12-08 17:08:44,62,172,33,29,95.86,172.00,0.00
2024-12-08 17:08:44,63,172,33,30,94.34,172.02,0.00
2024-12-08 17:08:44,62,172,32,30,95.83,172.02,0.00
2024-12-08 17:08:44,61,172,31,30,97.41,172.02,0.00
2024-12-08 17:08:44,61,173,31,30,97.75,173.00,0.00
2024-12-08 17:08:44,62,173,32,30,96.17,173.02,0.00
2024-12-08 17:08:44,61,173,32,29,97.56,173.08,0.00
2024-12-08 17:08:45,61,174,32,29,98.53,174.00,0.00
2024-12-08 17:08:45,62,174,32,30,96.94,174.02,0.00
2024-12-08 17:08:45,62,175,32,30,97.26,175.00,0.00
2024-12-08 17:08:45,63,175,33,30,95.72,175.02,0.00
2024-12-08 17:08:45,62,175,33,29,97.11,175.08,0.00
2024-12-08 17:08:45,61,175,32,29,98.46,175.13,0.00
2024-12-08 17:08:45,61,176,32,29,100.20,176.00,0.00
2024-12-08 17:08:45,62,176,33,29,98.58,176.02,0.00
2024-12-08 17:08:45,62,177,33,29,99.03,177.00,0.00
2024-12-08 17:08:45,63,177,33,30,97.46,177.02,0.00
2024-12-08 17:08:45,63,178,33,30,97.90,178.00,0.00
2024-12-08 17:08:45,64,178,34,30,96.37,178.02,0.00
2024-12-08 17:08:45,63,178,34,29,97.18,178.10,0.00
2024-12-08 17:08:45,63,179,34,29,98.33,179.00,0.00
2024-12-08 17:08:45,64,179,35,29,96.80,179.02,0.00
2024-12-08 17:08:45,64,180,35,29,97.18,180.00,0.00
2024-12-08 17:08:45,65,180,35,30,95.68,180.02,0.00
2024-12-08 17:08:45,65,181,35,30,95.98,181.00,0.00
2024-12-08 17:08:45,66,181,36,30,94.52,181.02,0.00
2024-12-08 17:08:45,65,181,36,29,95.32,181.09,0.00
2024-12-08 17:08:45,64,181,36,28,96.79,181.09,0.00
2024-12-08 17:08:45,64,182,36,28,97.73,182.00,0.00
2024-12-08 17:08:45,65,182,37,28,96.23,182.02,0.00
2024-12-08 17:08:45,65,183,37,28,96.37,183.00,0.00
2024-12-08 17:08:45,66,183,37,29,94.91,183.02,0.00
2024-12-08 17:08:45,65,183,36,29,96.24,183.09,0.00
2024-12-08 17:08:45,64,183,36,28,97.15,183.09,0.00
2024-12-08 17:08:45,64,184,36,28,97.93,184.00,0.00
2024-12-08 17:08:45,65,184,37,28,96.42,184.02,0.00
2024-12-08 17:08:45,64,184,36,28,97.77,184.09,0.00
2024-12-08 17:08:45,64,185,36,28,97.89,185.00,0.00
2024-12-08 17:08:45,65,185,37,28,96.38,185.02,0.00
2024-12-08 17:08:45,64,185,36,28,95.68,185.69,0.00
2024-12-08 17:08:45,64,186,36,28,98.00,186.00,0.00
2024-12-08 17:08:45,65,186,36,29,96.49,186.02,0.00
2024-12-08 17:08:45,64,186,36,28,97.29,186.09,0.00
2024-12-08 17:08:45,63,186,35,28,98.36,186.40,0.00
2024-12-08 17:08:45,63,187,35,28,99.72,187.00,0.00
2024-12-08 17:08:45,64,187,35,29,98.16,187.02,0.00
2024-12-08 17:08:45,63,187,34,29,99.63,187.05,0.00
2024-12-08 17:08:45,63,188,34,29,99.85,188.00,0.00
2024-12-08 17:08:45,64,188,34,30,98.29,188.02,0.00
2024-12-08 17:08:45,63,188,34,29,99.61,188.13,0.00
2024-12-08 17:08:45,63,189,34,29,100.56,189.00,0.00
2024-12-08 17:08:45,64,189,35,29,98.99,189.02,0.00
2024-12-08 17:08:45,63,189,35,28,98.33,189.63,0.00
2024-12-08 17:08:46,63,190,35,28,100.92,190.00,0.00
2024-12-08 17:08:46,64,190,36,28,99.34,190.02,0.00
2024-12-08 17:08:46,64,191,36,28,99.69,191.00,0.00
2024-12-08 17:08:46,65,191,36,29,98.16,191.02,0.00
2024-12-08 17:08:46,64,191,36,28,99.39,191.16,0.00
2024-12-08 17:08:46,63,191,35,28,100.07,191.68,0.00
2024-12-08 17:08:46,63,192,35,28,102.14,192.00,0.00
2024-12-08 17:08:46,64,192,35,29,100.54,192.02,0.00
2024-12-08 17:08:46,63,192,34,29,102.08,192.05,0.00
2024-12-08 17:08:46,63,193,34,29,102.42,193.00,0.00
2024-12-08 17:08:46,64,193,34,30,100.82,193.02,0.00
2024-12-08 17:08:46,63,193,33,30,102.18,193.14,0.00
2024-12-08 17:08:46,63,194,33,30,103.28,194.00,0.00
2024-12-08 17:08:46,64,194,34,30,101.66,194.02,0.00
2024-12-08 17:08:46,63,194,34,29,103.02,194.14,0.00
2024-12-08 17:08:46,63,195,34,29,104.13,195.00,0.00
2024-12-08 17:08:46,64,195,35,29,102.50,195.02,0.00
2024-12-08 17:08:46,63,195,34,29,104.10,195.02,0.00
2024-12-08 17:08:46,63,196,34,29,104.38,196.00,0.00
2024-12-08 17:08:46,64,196,34,30,102.75,196.02,0.00
2024-12-08 17:08:46,64,197,34,30,103.04,197.00,0.00
2024-12-08 17:08:46,65,197,34,31,101.45,197.02,0.00
2024-12-08 17:08:46,64,197,34,30,102.70,197.17,0.00
2024-12-08 17:08:46,64,198,34,30,103.96,198.00,0.00
2024-12-08 17:08:46,65,198,35,30,102.36,198.02,0.00
2024-12-08 17:08:46,64,198,34,30,103.51,198.08,0.00
2024-12-08 17:08:46,64,199,34,30,104.67,199.00,0.00
2024-12-08 17:08:46,65,199,34,31,103.06,199.02,0.00
2024-12-08 17:08:46,64,199,33,31,103.22,199.50,0.00
2024-12-08 17:08:46,64,200,33,31,105.08,200.00,0.00
2024-12-08 17:08:46,65,200,33,32,103.46,200.02,0.00
2024-12-08 17:08:46,64,200,33,31,104.76,200.17,0.00
2024-12-08 17:08:46,64,201,33,31,106.11,201.00,0.00
2024-12-08 17:08:46,65,201,34,31,104.47,201.02,0.00
2024-12-08 17:08:46,65,202,34,31,104.87,202.00,0.00
2024-12-08 17:08:46,66,202,34,32,103.28,202.02,0.00
2024-12-08 17:08:46,65,202,33,32,103.43,202.29,0.00
2024-12-08 17:08:46,65,203,33,32,105.57,203.00,0.00
2024-12-08 17:08:46,66,203,33,33,103.97,203.02,0.00
2024-12-08 17:08:46,65,203,32,33,105.28,203.17,0.00
2024-12-08 17:08:46,64,203,32,32,106.89,203.17,0.00
2024-12-08 17:08:46,64,204,32,32,108.24,204.00,0.00
2024-12-08 17:08:46,65,204,33,32,106.57,204.02,0.00
2024-12-08 17:08:46,65,205,33,32,106.95,205.00,0.00
2024-12-08 17:08:46,66,205,33,33,105.33,205.02,0.00
2024-12-08 17:08:46,65,205,32,33,106.92,205.02,0.00
2024-12-08 17:08:46,64,205,32,32,107.68,205.16,0.00
2024-12-08 17:08:46,64,206,32,32,109.02,206.00,0.00
2024-12-08 17:08:46,65,206,33,32,107.34,206.02,0.00
2024-12-08 17:08:46,64,206,32,32,108.75,206.16,0.00
2024-12-08 17:08:47,64,207,32,32,109.45,207.00,0.00
2024-12-08 17:08:47,65,207,32,33,107.77,207.02,0.00
2024-12-08 17:08:47,64,207,32,32,108.50,207.16,0.00
2024-12-08 17:08:47,64,208,32,32,109.85,208.00,0.00
2024-12-08 17:08:47,65,208,33,32,108.16,208.02,0.00
2024-12-08 17:08:47,64,208,32,32,109.79,208.05,0.00
2024-12-08 17:08:47,64,209,32,32,110.28,209.00,0.00
2024-12-08 17:08:47,65,209,33,32,108.58,209.02,0.00
2024-12-08 17:08:47,64,209,33,31,109.38,209.14,0.00
2024-12-08 17:08:47,64,210,33,31,110.71,210.00,0.00
2024-12-08 17:08:47,65,210,33,32,109.00,210.02,0.00
2024-12-08 17:08:47,64,210,32,32,110.46,210.14,0.00
2024-12-08 17:08:47,64,211,32,32,111.80,211.00,0.00
2024-12-08 17:08:47,65,211,33,32,110.08,211.02,0.00
2024-12-08 17:08:47,64,211,32,32,111.73,211.05,0.00
2024-12-08 17:08:47,63,211,32,31,112.68,211.13,0.00
2024-12-08 17:08:47,63,212,32,31,114.03,212.00,0.00
2024-12-08 17:08:47,64,212,33,31,112.25,212.02,0.00
2024-12-08 17:08:47,64,213,33,31,112.66,213.00,0.00
2024-12-08 17:08:47,65,213,33,32,110.93,213.02,0.00
2024-12-08 17:08:47,64,213,33,31,111.77,213.13,0.00
2024-12-08 17:08:47,64,214,33,31,113.07,214.00,0.00
2024-12-08 17:08:47,65,214,33,32,111.33,214.02,0.00
2024-12-08 17:08:47,65,215,33,32,111.69,215.00,0.00
2024-12-08 17:08:47,66,215,34,32,110.00,215.02,0.00
2024-12-08 17:08:47,65,215,34,31,110.84,215.12,0.00
2024-12-08 17:08:47,64,215,33,31,112.51,215.14,0.00
2024-12-08 17:08:48,64,216,33,31,114.50,216.00,0.00
2024-12-08 17:08:48,65,216,34,31,112.74,216.02,0.00
2024-12-08 17:08:48,64,216,33,31,114.40,216.06,0.00
2024-12-08 17:08:48,63,216,32,31,114.93,216.37,0.00
2024-12-08 17:08:48,63,217,32,31,116.74,217.00,0.00
2024-12-08 17:08:48,64,217,32,32,114.92,217.02,0.00
2024-12-08 17:08:48,63,217,32,31,116.71,217.02,0.00
2024-12-08 17:08:48,62,217,31,31,118.52,217.05,0.00
2024-12-08 17:08:48,61,217,31,30,119.76,217.08,0.00
2024-12-08 17:08:48,61,218,31,30,121.12,218.00,0.00
2024-12-08 17:08:48,62,218,31,31,119.17,218.02,0.00
2024-12-08 17:08:48,61,218,30,31,120.23,218.10,0.00
2024-12-08 17:08:48,61,219,30,31,122.38,219.00,0.00
2024-12-08 17:08:48,62,219,31,31,120.41,219.02,0.00
2024-12-08 17:08:48,61,219,30,31,122.25,219.07,0.00
2024-12-08 17:08:48,60,219,30,30,124.05,219.07,0.00
2024-12-08 17:08:48,59,219,29,30,126.15,219.07,0.00
2024-12-08 17:08:48,59,220,29,30,127.64,220.00,0.00
2024-12-08 17:08:48,60,220,29,31,125.51,220.02,0.00
2024-12-08 17:08:48,60,221,29,31,126.12,221.00,0.00
2024-12-08 17:08:48,61,221,29,32,124.05,221.02,0.00
2024-12-08 17:08:48,60,221,29,31,125.32,221.07,0.00
2024-12-08 17:08:48,60,222,29,31,126.77,222.00,0.00
2024-12-08 17:08:48,61,222,30,31,124.69,222.02,0.00
2024-12-08 17:08:48,60,222,29,31,125.82,222.10,0.00
2024-12-08 17:08:48,60,223,29,31,128.08,223.00,0.00
2024-12-08 17:08:48,61,223,30,31,125.98,223.02,0.00
2024-12-08 17:08:48,60,223,30,30,127.30,223.07,0.00
2024-12-08 17:08:48,60,224,30,30,128.75,224.00,0.00
2024-12-08 17:08:48,61,224,30,31,126.64,224.02,0.00
2024-12-08 17:08:48,61,225,30,31,127.16,225.00,0.00
2024-12-08 17:08:48,62,225,31,31,125.11,225.02,0.00
2024-12-08 17:08:48,61,225,31,30,126.43,225.07,0.00
2024-12-08 17:08:48,61,226,31,30,127.80,226.00,0.00
2024-12-08 17:08:48,62,226,32,30,125.74,226.02,0.00
2024-12-08 17:08:48,61,226,31,30,127.76,226.02,0.00
2024-12-08 17:08:48,60,226,30,30,129.78,226.05,0.00
2024-12-08 17:08:48,59,226,29,30,129.94,226.32,0.00
2024-12-08 17:08:48,59,227,29,30,132.68,227.00,0.00
2024-12-08 17:08:48,60,227,29,31,130.47,227.02,0.00
2024-12-08 17:08:48,60,228,29,31,131.06,228.00,0.00
2024-12-08 17:08:48,61,228,30,31,128.91,228.02,0.00
2024-12-08 17:08:48,60,228,30,30,130.91,228.07,0.00
2024-12-08 17:08:48,60,229,30,30,132.39,229.00,0.00
2024-12-08 17:08:48,61,229,31,30,130.22,229.02,0.00
2024-12-08 17:08:48,60,229,30,30,131.59,229.05,0.00
2024-12-08 17:08:48,60,230,30,30,133.05,230.00,0.00
2024-12-08 17:08:48,61,230,30,31,130.87,230.02,0.00
2024-12-08 17:08:48,61,231,30,31,131.44,231.00,0.00
2024-12-08 17:08:48,62,231,31,31,129.32,231.02,0.00
2024-12-08 17:08:48,61,231,30,31,131.40,231.02,0.00
2024-12-08 17:08:48,60,231,30,30,132.82,231.03,0.00
2024-12-08 17:08:48,60,232,30,30,134.24,232.00,0.00
2024-12-08 17:08:48,61,232,30,31,132.04,232.02,0.00
2024-12-08 17:08:49,61,233,30,31,132.61,233.00,0.00
2024-12-08 17:08:49,62,233,30,32,130.47,233.02,0.00
2024-12-08 17:08:49,61,233,30,31,131.78,233.05,0.00
2024-12-08 17:08:49,60,233,29,31,133.93,233.05,0.00
2024-12-08 17:08:49,60,234,29,31,136.18,234.00,0.00
2024-12-08 17:08:49,61,234,30,31,133.95,234.02,0.00
2024-12-08 17:08:49,61,235,30,31,134.52,235.00,0.00
2024-12-08 17:08:49,62,235,30,32,132.35,235.02,0.00
2024-12-08 17:08:49,62,236,30,32,132.88,236.00,0.00
2024-12-08 17:08:49,63,236,30,33,130.77,236.02,0.00
2024-12-08 17:08:49,62,236,30,32,132.08,236.05,0.00
2024-12-08 17:08:49,61,236,29,32,133.65,236.34,0.00
2024-12-08 17:08:49,61,237,29,32,135.67,237.00,0.00
2024-12-08 17:08:49,62,237,30,32,133.48,237.02,0.00
2024-12-08 17:08:49,61,237,29,32,135.63,237.02,0.00
2024-12-08 17:08:49,60,237,29,31,136.99,237.05,0.00
2024-12-08 17:08:49,59,237,28,31,139.23,237.05,0.00
2024-12-08 17:08:49,59,238,28,31,141.58,238.00,0.00
2024-12-08 17:08:49,60,238,29,31,139.22,238.02,0.00
2024-12-08 17:08:49,60,239,29,31,139.83,239.00,0.00
2024-12-08 17:08:49,61,239,29,32,137.54,239.02,0.00
2024-12-08 17:08:49,61,240,29,32,138.09,240.00,0.00
2024-12-08 17:08:49,62,240,29,33,135.86,240.02,0.00
2024-12-08 17:08:49,61,240,28,33,138.02,240.05,0.00
2024-12-08 17:08:49,60,240,28,32,139.48,240.05,0.00
2024-12-08 17:08:49,60,241,28,32,140.95,241.00,0.00
2024-12-08 17:08:49,61,241,28,33,138.64,241.02,0.00
2024-12-08 17:08:49,60,241,28,32,140.01,241.08,0.00
2024-12-08 17:08:49,60,242,28,32,141.56,242.00,0.00
2024-12-08 17:08:49,61,242,29,32,139.24,242.02,0.00
2024-12-08 17:08:49,61,243,29,32,139.79,243.00,0.00
2024-12-08 17:08:49,62,243,29,33,137.53,243.02,0.00
2024-12-08 17:08:49,61,243,28,33,139.68,243.07,0.00
2024-12-08 17:08:49,61,244,28,33,140.33,244.00,0.00
2024-12-08 17:08:49,62,244,28,34,138.07,244.02,0.00
2024-12-08 17:08:49,62,245,28,34,138.55,245.00,0.00
2024-12-08 17:08:49,63,245,29,34,136.36,245.02,0.00
2024-12-08 17:08:49,62,245,28,34,138.45,245.06,0.00
2024-12-08 17:08:49,61,245,28,33,140.64,245.07,0.00
2024-12-08 17:08:49,61,246,28,33,142.01,246.00,0.00
2024-12-08 17:08:49,62,246,29,33,139.72,246.02,0.00
2024-12-08 17:08:49,61,246,28,33,140.86,246.10,0.00
2024-12-08 17:08:49,61,247,28,33,143.06,247.00,0.00
2024-12-08 17:08:49,62,247,28,34,140.76,247.02,0.00
2024-12-08 17:08:49,61,247,28,33,142.91,247.07,0.00
2024-12-08 17:08:49,60,247,27,33,144.75,247.33,0.00
2024-12-08 17:08:49,60,248,27,33,146.66,248.00,0.00
2024-12-08 17:08:49,61,248,28,33,144.25,248.02,0.00
2024-12-08 17:08:49,61,249,28,33,144.62,249.00,0.00
2024-12-08 17:08:49,62,249,28,34,142.28,249.02,0.00
2024-12-08 17:08:49,61,249,28,33,143.69,249.07,0.00
2024-12-08 17:08:49,61,250,28,33,144.98,250.00,0.00
2024-12-08 17:08:49,62,250,29,33,142.64,250.02,0.00
2024-12-08 17:08:49,62,251,29,33,142.98,251.00,0.00
2024-12-08 17:08:49,63,251,29,34,140.71,251.02,0.00
2024-12-08 17:08:49,62,251,29,33,142.94,251.02,0.00
2024-12-08 17:08:49,61,251,28,33,145.21,251.05,0.00
2024-12-08 17:08:49,60,251,28,32,146.75,251.05,0.00
2024-12-08 17:08:49,60,252,28,32,148.10,252.00,0.00
2024-12-08 17:08:49,61,252,29,32,145.68,252.02,0.00
2024-12-08 17:08:49,61,253,29,32,146.12,253.00,0.00
2024-12-08 17:08:49,62,253,30,32,143.76,253.02,0.00
2024-12-08 17:08:49,61,253,30,31,145.22,253.05,0.00
2024-12-08 17:08:49,60,253,29,31,145.27,253.90,0.00
2024-12-08 17:08:50,60,254,29,31,149.33,254.00,0.00
2024-12-08 17:08:50,61,254,29,32,146.88,254.02,0.00
2024-12-08 17:08:50,61,255,29,32,147.38,255.00,0.00
2024-12-08 17:08:50,62,255,30,32,145.00,255.02,0.00
2024-12-08 17:08:50,61,255,29,32,146.15,255.11,0.00
2024-12-08 17:08:50,61,256,29,32,148.61,256.00,0.00
2024-12-08 17:08:50,62,256,30,32,146.21,256.02,0.00
2024-12-08 17:08:50,61,256,30,31,148.42,256.08,0.00
2024-12-08 17:08:50,60,256,29,31,150.17,256.42,0.00
2024-12-08 17:08:50,60,257,29,31,152.51,257.00,0.00
2024-12-08 17:08:50,61,257,29,32,150.01,257.02,0.00
2024-12-08 17:08:50,61,258,29,32,150.60,258.00,0.00
2024-12-08 17:08:50,62,258,29,33,148.17,258.02,0.00
2024-12-08 17:08:50,61,258,29,32,149.60,258.08,0.00
2024-12-08 17:08:50,61,259,29,32,151.18,259.00,0.00
2024-12-08 17:08:50,62,259,29,33,148.74,259.02,0.00
2024-12-08 17:08:50,62,260,29,33,149.27,260.00,0.00
2024-12-08 17:08:50,63,260,30,33,146.90,260.02,0.00
2024-12-08 17:08:50,62,260,30,32,148.28,260.08,0.00
2024-12-08 17:08:50,62,261,30,32,149.81,261.00,0.00
2024-12-08 17:08:50,63,261,30,33,147.43,261.02,0.00
2024-12-08 17:08:50,63,262,30,33,147.91,262.00,0.00
2024-12-08 17:08:50,64,262,31,33,145.60,262.02,0.00
2024-12-08 17:08:50,63,262,31,32,146.97,262.08,0.00
2024-12-08 17:08:50,62,262,30,32,149.34,262.08,0.00
2024-12-08 17:08:50,61,262,29,32,149.44,262.92,0.00
2024-12-08 17:08:50,61,263,29,32,153.60,263.00,0.00
2024-12-08 17:08:50,62,263,30,32,151.12,263.02,0.00
2024-12-08 17:08:50,62,264,30,32,151.66,264.00,0.00
2024-12-08 17:08:50,63,264,31,32,149.25,264.02,0.00
2024-12-08 17:08:50,62,264,31,31,150.69,264.08,0.00
2024-12-08 17:08:50,62,265,31,31,152.23,265.00,0.00
2024-12-08 17:08:50,63,265,32,31,149.81,265.02,0.00
2024-12-08 17:08:50,62,265,31,31,151.18,265.10,0.00
2024-12-08 17:08:50,62,266,31,31,152.76,266.00,0.00
2024-12-08 17:08:50,63,266,32,31,150.34,266.02,0.00
2024-12-08 17:08:50,62,266,32,30,151.83,266.08,0.00
2024-12-08 17:08:50,62,267,32,30,153.38,267.00,0.00
2024-12-08 17:08:50,63,267,33,30,150.94,267.02,0.00
2024-12-08 17:08:50,63,268,33,30,151.42,268.00,0.00
2024-12-08 17:08:50,64,268,33,31,149.06,268.02,0.00
2024-12-08 17:08:50,63,268,33,30,150.50,268.08,0.00
2024-12-08 17:08:50,63,269,33,30,151.99,269.00,0.00
2024-12-08 17:08:50,64,269,33,31,149.61,269.02,0.00
2024-12-08 17:08:50,64,270,33,31,150.04,270.00,0.00
2024-12-08 17:08:50,65,270,34,31,147.74,270.02,0.00
2024-12-08 17:08:50,64,270,34,30,149.13,270.08,0.00
2024-12-08 17:08:50,63,270,33,30,150.97,270.19,0.00
2024-12-08 17:08:50,63,271,33,30,153.59,271.00,0.00
2024-12-08 17:08:50,64,271,33,31,151.19,271.02,0.00
2024-12-08 17:08:50,63,271,32,31,152.41,271.13,0.00
2024-12-08 17:08:50,63,272,32,31,154.03,272.00,0.00
2024-12-08 17:08:50,64,272,33,31,151.62,272.02,0.00
2024-12-08 17:08:50,63,272,33,30,152.97,272.11,0.00
2024-12-08 17:08:50,63,273,33,30,154.55,273.00,0.00
2024-12-08 17:08:50,64,273,33,31,152.14,273.02,0.00
2024-12-08 17:08:50,64,274,33,31,152.57,274.00,0.00
2024-12-08 17:08:50,65,274,33,32,150.22,274.02,0.00
2024-12-08 17:08:51,64,274,33,31,151.43,274.13,0.00
2024-12-08 17:08:51,64,275,33,31,152.99,275.00,0.00
2024-12-08 17:08:51,65,275,33,32,150.64,275.02,0.00
2024-12-08 17:08:51,65,276,33,32,151.02,276.00,0.00
2024-12-08 17:08:51,66,276,33,33,148.73,276.02,0.00
2024-12-08 17:08:51,65,276,32,33,150.98,276.02,0.00
2024-12-08 17:08:51,64,276,32,32,152.28,276.11,0.00
2024-12-08 17:08:51,64,277,32,32,153.80,277.00,0.00
2024-12-08 17:08:51,65,277,33,32,151.44,277.02,0.00
2024-12-08 17:08:51,64,277,32,32,153.56,277.11,0.00
2024-12-08 17:08:51,64,278,32,32,155.09,278.00,0.00
2024-12-08 17:08:51,65,278,33,32,152.71,278.02,0.00
2024-12-08 17:08:51,64,278,33,31,153.98,278.11,0.00
2024-12-08 17:08:51,64,279,33,31,155.50,279.00,0.00
2024-12-08 17:08:51,65,279,33,32,153.10,279.02,0.00
2024-12-08 17:08:51,64,279,32,32,152.76,279.41,0.00
2024-12-08 17:08:51,64,280,32,32,155.89,280.00,0.00
2024-12-08 17:08:51,65,280,32,33,153.49,280.02,0.00
2024-12-08 17:08:51,64,280,32,32,155.07,280.11,0.00
2024-12-08 17:08:51,64,281,32,32,156.62,281.00,0.00
2024-12-08 17:08:51,65,281,32,33,154.21,281.02,0.00
2024-12-08 17:08:51,64,281,31,33,156.58,281.02,0.00
2024-12-08 17:08:51,63,281,30,33,157.79,281.13,0.00
2024-12-08 17:08:51,63,282,30,33,160.31,282.00,0.00
2024-12-08 17:08:51,64,282,31,33,157.80,282.02,0.00
2024-12-08 17:08:51,63,282,31,32,159.40,282.10,0.00
2024-12-08 17:08:51,63,283,31,32,160.92,283.00,0.00
2024-12-08 17:08:51,64,283,31,33,158.40,283.02,0.00
2024-12-08 17:08:51,64,284,31,33,158.74,284.00,0.00
2024-12-08 17:08:51,65,284,31,34,156.30,284.02,0.00
2024-12-08 17:08:51,64,284,31,33,157.73,284.09,0.00
2024-12-08 17:08:51,63,284,30,33,160.24,284.10,0.00
2024-12-08 17:08:51,63,285,30,33,161.73,285.00,0.00
2024-12-08 17:08:51,64,285,31,33,159.20,285.02,0.00
2024-12-08 17:08:51,63,285,30,33,160.52,285.11,0.00
2024-12-08 17:08:51,63,286,30,33,162.06,286.00,0.00
2024-12-08 17:08:51,64,286,30,34,159.53,286.02,0.00
2024-12-08 17:08:51,63,286,30,33,160.99,286.10,0.00
2024-12-08 17:08:51,63,287,30,33,162.49,287.00,0.00
2024-12-08 17:08:51,64,287,30,34,159.95,287.02,0.00
2024-12-08 17:08:51,63,287,29,34,162.27,287.10,0.00
2024-12-08 17:08:51,63,288,29,34,162.88,288.00,0.00
2024-12-08 17:08:51,64,288,30,34,160.33,288.02,0.00
2024-12-08 17:08:51,63,288,30,33,161.74,288.10,0.00
2024-12-08 17:08:51,63,289,30,33,163.24,289.00,0.00
2024-12-08 17:08:51,64,289,30,34,160.69,289.02,0.00
2024-12-08 17:08:51,64,290,30,34,161.00,290.00,0.00
2024-12-08 17:08:51,65,290,30,35,158.53,290.02,0.00
2024-12-08 17:08:51,64,290,29,35,160.74,290.11,0.00
2024-12-08 17:08:51,63,290,29,34,162.33,290.11,0.00
2024-12-08 17:08:51,63,291,29,34,163.88,291.00,0.00
2024-12-08 17:08:51,64,291,30,34,161.32,291.02,0.00
2024-12-08 17:08:51,64,292,30,34,161.68,292.00,0.00
2024-12-08 17:08:51,65,292,31,34,159.19,292.02,0.00
2024-12-08 17:08:51,64,292,31,33,161.59,292.02,0.00
2024-12-08 17:08:51,63,292,30,33,162.24,292.56,0.00
2024-12-08 17:08:51,63,293,30,33,165.89,293.00,0.00
2024-12-08 17:08:51,64,293,30,34,163.30,293.02,0.00
2024-12-08 17:08:51,63,293,29,34,165.76,293.06,0.00
2024-12-08 17:08:51,62,293,29,33,167.40,293.10,0.00
2024-12-08 17:08:51,61,293,28,33,169.33,293.23,0.00
2024-12-08 17:08:51,61,294,28,33,172.39,294.00,0.00
2024-12-08 17:08:51,62,294,28,34,169.61,294.02,0.00
2024-12-08 17:08:51,61,294,27,34,172.35,294.02,0.00
2024-12-08 17:08:52,61,295,27,34,172.93,295.00,0.00
2024-12-08 17:08:52,62,295,28,34,170.14,295.02,0.00
2024-12-08 17:08:52,61,295,28,33,171.84,295.08,0.00
2024-12-08 17:08:52,61,296,28,33,173.57,296.00,0.00
2024-12-08 17:08:52,62,296,28,34,170.77,296.02,0.00
2024-12-08 17:08:52,61,296,27,34,172.19,296.13,0.00
2024-12-08 17:08:52,61,297,27,34,175.03,297.00,0.00
2024-12-08 17:08:52,62,297,27,35,172.21,297.02,0.00
2024-12-08 17:08:52,61,297,26,35,173.97,297.08,0.00
2024-12-08 17:08:52,60,297,26,34,175.93,297.08,0.00
2024-12-08 17:08:52,60,298,26,34,178.74,298.00,0.00
2024-12-08 17:08:52,61,298,26,35,175.81,298.02,0.00
2024-12-08 17:08:52,61,299,26,35,176.40,299.00,0.00
2024-12-08 17:08:52,62,299,26,36,173.56,299.02,0.00
2024-12-08 17:08:52,61,299,26,35,175.34,299.08,0.00
2024-12-08 17:08:52,61,300,26,35,177.09,300.00,0.00
2024-12-08 17:08:52,62,300,26,36,174.24,300.02,0.00
2024-12-08 17:08:52,62,301,26,36,174.77,301.00,0.00
2024-12-08 17:08:52,63,301,26,37,171.99,301.02,0.00
2024-12-08 17:08:52,62,301,26,36,173.66,301.08,0.00
2024-12-08 17:08:52,63,300,27,36,168.16,301.84,0.00
2024-12-08 17:08:52,63,301,27,36,173.09,302.00,0.00
2024-12-08 17:08:52,64,301,27,37,170.39,302.02,0.00
2024-12-08 17:08:52,63,301,26,37,171.59,302.14,0.00
2024-12-08 17:08:52,63,302,26,37,179.15,303.00,0.00
2024-12-08 17:08:52,64,302,27,37,176.35,303.02,0.00
2024-12-08 17:08:52,63,302,27,36,178.10,303.08,0.00
2024-12-08 17:08:52,63,303,27,36,179.74,304.00,0.00
2024-12-08 17:08:52,64,303,28,36,176.93,304.02,0.00
2024-12-08 17:08:52,63,303,28,35,179.28,304.08,0.00
2024-12-08 17:08:52,63,304,28,35,180.93,305.00,0.00
2024-12-08 17:08:52,64,304,29,35,178.10,305.02,0.00
2024-12-08 17:08:52,64,305,29,35,178.54,306.00,0.00
2024-12-08 17:08:52,65,305,30,35,175.80,306.02,0.00
2024-12-08 17:08:52,64,305,30,34,177.50,306.08,0.00
2024-12-08 17:08:52,64,306,30,34,179.08,307.00,0.00
2024-12-08 17:08:52,65,306,30,35,176.32,307.02,0.00
2024-12-08 17:08:52,65,307,30,35,176.71,308.00,0.00
2024-12-08 17:08:52,66,307,30,36,174.03,308.02,0.00
2024-12-08 17:08:52,65,307,29,36,176.66,308.02,0.00
2024-12-08 17:08:52,64,307,28,36,179.14,308.05,0.00
2024-12-08 17:08:52,63,307,28,35,181.15,308.05,0.00
2024-12-08 17:08:52,63,308,28,35,183.69,309.00,0.00
2024-12-08 17:08:52,64,308,28,36,180.82,309.02,0.00
2024-12-08 17:08:52,63,308,27,36,183.65,309.02,0.00
2024-12-08 17:08:52,63,309,27,36,184.14,310.00,0.00
2024-12-08 17:08:52,64,309,28,36,181.26,310.02,0.00
2024-12-08 17:08:52,63,309,27,36,183.12,310.05,0.00
2024-12-08 17:08:52,62,309,27,35,185.07,310.05,0.00
2024-12-08 17:08:52,62,310,27,35,187.71,311.00,0.00
2024-12-08 17:08:52,63,310,28,35,184.73,311.02,0.00
2024-12-08 17:08:52,63,311,28,35,185.23,312.00,0.00
2024-12-08 17:08:52,64,311,28,36,182.34,312.02,0.00
2024-12-08 17:08:52,63,311,28,35,184.10,312.06,0.00
2024-12-08 17:08:53,63,312,28,35,185.72,313.00,0.00
2024-12-08 17:08:53,64,312,28,36,182.82,313.02,0.00
2024-12-08 17:08:53,63,312,27,36,183.70,313.21,0.00
2024-12-08 17:08:53,64,311,27,37,179.84,313.61,0.00
2024-12-08 17:08:53,64,312,27,37,185.03,314.00,0.00
2024-12-08 17:08:53,65,312,28,37,182.18,314.02,0.00
2024-12-08 17:08:53,64,312,28,36,183.77,314.09,0.00
2024-12-08 17:08:53,63,312,27,36,186.59,314.10,0.00
2024-12-08 17:08:53,63,313,27,36,194.31,315.00,0.00
2024-12-08 17:08:53,64,313,28,36,191.27,315.02,0.00
2024-12-08 17:08:53,64,314,28,36,191.73,316.00,0.00
2024-12-08 17:08:53,65,314,28,37,188.78,316.02,0.00
2024-12-08 17:08:53,65,315,28,37,189.19,317.00,0.00
2024-12-08 17:08:53,66,315,29,37,186.32,317.02,0.00
2024-12-08 17:08:53,65,315,29,36,188.91,317.09,0.00
2024-12-08 17:08:53,65,316,29,36,190.52,318.00,0.00
2024-12-08 17:08:53,66,316,29,37,187.63,318.02,0.00
2024-12-08 17:08:53,66,317,29,37,187.98,319.00,0.00
2024-12-08 17:08:53,67,317,29,38,185.17,319.01,0.00
2024-12-08 17:08:53,66,317,29,37,186.79,319.09,0.00
2024-12-08 17:08:53,65,317,28,37,189.52,319.11,0.00
2024-12-08 17:08:53,65,318,28,37,192.16,320.00,0.00
2024-12-08 17:08:53,66,318,28,38,189.25,320.02,0.00
2024-12-08 17:08:53,66,319,28,38,189.60,321.00,0.00
2024-12-08 17:08:53,67,319,28,39,186.77,321.01,0.00
2024-12-08 17:08:53,66,319,28,38,188.44,321.09,0.00
2024-12-08 17:08:53,66,320,28,38,189.99,322.00,0.00
2024-12-08 17:08:53,67,320,29,38,187.16,322.01,0.00
2024-12-08 17:08:53,67,321,29,38,187.45,323.00,0.00
2024-12-08 17:08:53,68,321,29,39,184.69,323.01,0.00
2024-12-08 17:08:53,67,321,29,38,186.30,323.09,0.00
2024-12-08 17:08:53,66,321,28,38,188.35,323.36,0.00
2024-12-08 17:08:53,66,322,28,38,190.68,324.00,0.00
2024-12-08 17:08:53,67,322,29,38,187.83,324.01,0.00
2024-12-08 17:08:53,66,322,28,38,190.24,324.05,0.00
2024-12-08 17:08:53,66,323,28,38,191.63,325.00,0.00
2024-12-08 17:08:53,67,323,28,39,188.77,325.01,0.00
2024-12-08 17:08:53,66,323,27,39,191.44,325.08,0.00
2024-12-08 17:08:53,66,324,27,39,191.90,326.00,0.00
2024-12-08 17:08:53,67,324,28,39,189.04,326.01,0.00
2024-12-08 17:08:53,66,324,27,39,191.62,326.09,0.00
2024-12-08 17:08:53,65,324,27,38,194.37,326.11,0.00
2024-12-08 17:08:53,65,325,27,38,195.97,327.00,0.00
2024-12-08 17:08:53,66,325,28,38,193.00,327.02,0.00
2024-12-08 17:08:53,65,325,27,38,194.25,327.15,0.00
2024-12-08 17:08:53,65,326,27,38,197.01,328.00,0.00
2024-12-08 17:08:53,66,326,27,39,194.03,328.02,0.00
2024-12-08 17:08:53,65,326,26,39,196.96,328.02,0.00
2024-12-08 17:08:53,65,327,26,39,197.32,329.00,0.00
2024-12-08 17:08:53,66,327,27,39,194.33,329.02,0.00
2024-12-08 17:08:53,65,327,27,38,197.03,329.09,0.00
2024-12-08 17:08:53,65,328,27,38,198.67,330.00,0.00
2024-12-08 17:08:53,66,328,28,38,195.66,330.02,0.00
2024-12-08 17:08:53,65,328,27,38,196.74,330.18,0.00
2024-12-08 17:08:53,65,329,27,38,199.68,331.00,0.00
2024-12-08 17:08:53,66,329,28,38,196.65,331.02,0.00
2024-12-08 17:08:53,65,329,28,37,198.32,331.11,0.00
2024-12-08 17:08:54,65,330,28,37,200.03,332.00,0.00
2024-12-08 17:08:54,66,330,28,38,197.00,332.02,0.00
2024-12-08 17:08:54,65,330,27,38,198.02,332.35,0.00
2024-12-08 17:08:54,65,331,27,38,200.42,333.00,0.00
2024-12-08 17:08:54,66,331,27,39,197.39,333.02,0.00
2024-12-08 17:08:54,65,331,27,38,199.06,333.11,0.00
2024-12-08 17:08:54,65,332,27,38,200.77,334.00,0.00
2024-12-08 17:08:54,66,332,27,39,197.73,334.02,0.00
2024-12-08 17:08:54,66,333,27,39,198.07,335.00,0.00
2024-12-08 17:08:54,67,333,28,39,195.11,335.01,0.00
2024-12-08 17:08:54,66,333,28,38,196.76,335.11,0.00
2024-12-08 17:08:54,66,334,28,38,198.40,336.00,0.00
2024-12-08 17:08:54,67,334,28,39,195.44,336.01,0.00
2024-12-08 17:08:54,67,335,28,39,195.72,337.00,0.00
2024-12-08 17:08:54,68,335,29,39,192.84,337.01,0.00
2024-12-08 17:08:54,67,335,29,38,194.48,337.10,0.00
2024-12-08 17:08:54,67,336,29,38,196.05,338.00,0.00
2024-12-08 17:08:54,68,336,29,39,193.17,338.01,0.00
2024-12-08 17:08:54,68,337,29,39,193.39,339.00,0.00
2024-12-08 17:08:54,69,337,30,39,190.59,339.01,0.00
2024-12-08 17:08:54,68,337,29,39,192.55,339.09,0.00
2024-12-08 17:08:54,67,337,29,38,194.51,339.09,0.00
2024-12-08 17:08:54,67,338,29,38,197.06,340.00,0.00
2024-12-08 17:08:54,68,338,30,38,194.16,340.01,0.00
2024-12-08 17:08:54,67,338,29,38,194.45,340.46,0.00
2024-12-08 17:08:54,67,339,29,38,198.10,341.00,0.00
2024-12-08 17:08:54,68,339,30,38,195.18,341.01,0.00
2024-12-08 17:08:54,67,339,30,37,196.83,341.10,0.00
2024-12-08 17:08:54,67,340,30,37,198.42,342.00,0.00
2024-12-08 17:08:54,68,340,30,38,195.50,342.01,0.00
2024-12-08 17:08:54,69,339,30,39,190.96,342.28,0.00
2024-12-08 17:08:54,69,340,30,39,197.36,343.00,0.00
2024-12-08 17:08:54,70,340,31,39,194.54,343.01,0.00
2024-12-08 17:08:54,69,340,31,38,196.76,343.10,0.00
2024-12-08 17:08:54,69,341,31,38,203.21,344.00,0.00
2024-12-08 17:08:54,70,341,31,39,200.31,344.01,0.00
2024-12-08 17:08:54,70,342,31,39,200.44,345.00,0.00
2024-12-08 17:08:54,71,342,31,40,197.62,345.01,0.00
2024-12-08 17:08:54,70,342,31,39,199.32,345.10,0.00
2024-12-08 17:08:54,69,342,30,39,202.07,345.13,0.00
2024-12-08 17:08:54,69,343,30,39,204.64,346.00,0.00
2024-12-08 17:08:54,70,343,30,40,201.72,346.01,0.00
2024-12-08 17:08:54,69,343,29,40,204.49,346.06,0.00
2024-12-08 17:08:54,69,344,29,40,204.83,347.00,0.00
2024-12-08 17:08:54,70,344,30,40,201.90,347.01,0.00
2024-12-08 17:08:54,69,344,30,39,204.78,347.01,0.00
2024-12-08 17:08:54,68,344,30,38,206.73,347.07,0.00
2024-12-08 17:08:54,68,345,30,38,208.19,348.00,0.00
2024-12-08 17:08:54,69,345,31,38,205.17,348.01,0.00
2024-12-08 17:08:54,68,345,30,38,208.08,348.04,0.00
2024-12-08 17:08:54,68,346,30,38,208.42,349.00,0.00
2024-12-08 17:08:54,69,346,31,38,205.40,349.01,0.00
2024-12-08 17:08:54,68,346,31,37,207.45,349.06,0.00
2024-12-08 17:08:54,68,347,31,37,208.87,350.00,0.00
2024-12-08 17:08:54,69,347,32,37,205.84,350.01,0.00
2024-12-08 17:08:55,69,348,32,37,206.02,351.00,0.00
2024-12-08 17:08:55,70,348,32,38,203.07,351.01,0.00
2024-12-08 17:08:55,69,348,32,37,205.05,351.06,0.00
2024-12-08 17:08:55,69,349,32,37,206.36,352.00,0.00
2024-12-08 17:08:55,70,349,32,38,203.41,352.01,0.00
2024-12-08 17:08:55,69,349,31,38,206.31,352.01,0.00
2024-12-08 17:08:55,69,350,31,38,206.43,353.00,0.00
2024-12-08 17:08:55,70,350,31,39,203.48,353.01,0.00
2024-12-08 17:08:55,69,350,30,39,206.38,353.01,0.00
2024-12-08 17:08:55,68,350,30,38,208.58,353.03,0.00
2024-12-08 17:08:55,68,351,30,38,209.84,354.00,0.00
2024-12-08 17:08:55,69,351,31,38,206.80,354.01,0.00
2024-12-08 17:08:55,69,352,31,38,206.93,355.00,0.00
2024-12-08 17:08:55,70,352,31,39,203.97,355.01,0.00
2024-12-08 17:08:55,69,352,31,38,206.06,355.04,0.00
2024-12-08 17:08:55,68,352,30,38,206.94,355.40,0.00
2024-12-08 17:08:55,68,353,30,38,210.42,356.00,0.00
2024-12-08 17:08:55,69,353,31,38,207.37,356.01,0.00
2024-12-08 17:08:55,68,353,30,38,209.10,356.10,0.00
2024-12-08 17:08:55,67,353,29,38,211.62,356.19,0.00
2024-12-08 17:08:55,67,354,29,38,214.56,357.00,0.00
2024-12-08 17:08:55,68,354,29,39,211.41,357.01,0.00
2024-12-08 17:08:55,68,355,29,39,211.62,358.00,0.00
2024-12-08 17:08:55,69,355,29,40,208.56,358.01,0.00
2024-12-08 17:08:55,69,356,29,40,208.72,359.00,0.00
2024-12-08 17:08:55,70,356,30,40,205.74,359.01,0.00
2024-12-08 17:08:55,69,356,30,39,208.47,359.04,0.00
2024-12-08 17:08:55,69,357,30,39,209.77,360.00,0.00
2024-12-08 17:08:55,70,357,31,39,206.78,360.01,0.00
2024-12-08 17:08:55,69,357,31,38,207.86,360.06,0.00
2024-12-08 17:08:55,69,358,31,38,210.24,361.00,0.00
2024-12-08 17:08:55,70,358,31,39,207.24,361.01,0.00
2024-12-08 17:08:55,70,359,31,39,207.34,362.00,0.00
2024-12-08 17:08:55,71,359,32,39,204.42,362.01,0.00
2024-12-08 17:08:55,71,360,32,39,204.47,363.00,0.00
2024-12-08 17:08:55,72,360,32,40,201.63,363.01,0.00
2024-12-08 17:08:55,71,360,32,39,203.57,363.07,0.00
2024-12-08 17:08:55,70,360,31,39,206.14,363.16,0.00
2024-12-08 17:08:55,70,361,31,39,207.75,364.00,0.00
2024-12-08 17:08:55,71,361,32,39,204.83,364.01,0.00
2024-12-08 17:08:55,70,361,32,38,207.04,364.06,0.00
2024-12-08 17:08:55,70,362,32,38,208.32,365.00,0.00
2024-12-08 17:08:55,71,362,33,38,205.39,365.01,0.00
2024-12-08 17:08:55,71,363,33,38,205.44,366.00,0.00
2024-12-08 17:08:55,72,363,34,38,202.58,366.01,0.00
2024-12-08 17:08:55,71,363,33,38,204.98,366.03,0.00
2024-12-08 17:08:55,71,364,33,38,206.10,367.00,0.00
2024-12-08 17:08:55,72,364,34,38,203.24,367.01,0.00
2024-12-08 17:08:55,71,364,34,37,205.44,367.04,0.00
2024-12-08 17:08:55,71,365,34,37,206.61,368.00,0.00
2024-12-08 17:08:55,72,365,34,38,203.74,368.01,0.00
2024-12-08 17:08:55,71,365,34,37,205.95,368.04,0.00
2024-12-08 17:08:56,71,366,34,37,207.04,369.00,0.00
2024-12-08 17:08:56,72,366,35,37,204.16,369.01,0.00
2024-12-08 17:08:56,72,367,35,37,204.01,370.00,0.00
2024-12-08 17:08:56,73,367,35,38,201.21,370.01,0.00
2024-12-08 17:08:56,73,368,35,38,200.96,371.00,0.00
2024-12-08 17:08:56,74,368,35,39,198.24,371.01,0.00
2024-12-08 17:08:56,73,368,35,38,200.41,371.04,0.00
2024-12-08 17:08:56,72,368,34,38,202.71,371.17,0.00
2024-12-08 17:08:56,72,369,34,38,204.05,372.00,0.00
2024-12-08 17:08:56,73,369,34,39,201.25,372.01,0.00
2024-12-08 17:08:56,72,369,34,38,203.49,372.04,0.00
2024-12-08 17:08:56,71,369,33,38,204.93,372.30,0.00
2024-12-08 17:08:56,71,370,33,38,207.82,373.00,0.00
2024-12-08 17:08:56,72,370,33,39,204.93,373.01,0.00
2024-12-08 17:08:56,72,371,33,39,204.87,374.00,0.00
2024-12-08 17:08:56,73,371,33,40,202.06,374.01,0.00
2024-12-08 17:08:56,72,371,33,39,204.36,374.04,0.00
2024-12-08 17:08:56,72,372,33,39,205.47,375.00,0.00
2024-12-08 17:08:56,73,372,34,39,202.65,375.01,0.00
2024-12-08 17:08:56,72,372,33,39,202.72,375.51,0.00
2024-12-08 17:08:56,72,373,33,39,205.41,376.00,0.00
2024-12-08 17:08:56,73,373,33,40,202.59,376.01,0.00
2024-12-08 17:08:56,72,373,32,40,201.92,376.74,0.00
2024-12-08 17:08:56,72,374,32,40,205.32,377.00,0.00
2024-12-08 17:08:56,73,374,32,41,202.51,377.01,0.00
2024-12-08 17:08:56,72,374,32,40,204.91,377.04,0.00
2024-12-08 17:08:56,72,375,32,40,206.03,378.00,0.00
2024-12-08 17:08:56,73,375,32,41,203.20,378.01,0.00
2024-12-08 17:08:56,72,375,31,41,205.97,378.01,0.00
2024-12-08 17:08:56,72,376,31,41,205.94,379.00,0.00
2024-12-08 17:08:56,73,376,32,41,203.12,379.01,0.00
2024-12-08 17:08:56,72,376,32,40,205.32,379.06,0.00
2024-12-08 17:08:56,72,377,32,40,206.48,380.00,0.00
2024-12-08 17:08:56,73,377,32,41,203.65,380.01,0.00
2024-12-08 17:08:56,72,377,32,40,205.86,380.06,0.00
2024-12-08 17:08:56,72,378,32,40,207.03,381.00,0.00
2024-12-08 17:08:56,73,378,33,40,204.19,381.01,0.00
2024-12-08 17:08:56,72,378,32,40,205.24,381.07,0.00
2024-12-08 17:08:56,72,379,32,40,207.52,382.00,0.00
2024-12-08 17:08:56,73,379,32,41,204.67,382.01,0.00
2024-12-08 17:08:56,72,379,32,40,206.94,382.06,0.00
2024-12-08 17:08:56,71,379,31,40,208.56,382.44,0.00
2024-12-08 17:08:56,71,380,31,40,211.10,383.00,0.00
2024-12-08 17:08:56,72,380,32,40,208.17,383.01,0.00
2024-12-08 17:08:56,71,380,31,40,209.01,383.24,0.00
2024-12-08 17:08:56,71,381,31,40,211.97,384.00,0.00
2024-12-08 17:08:56,72,381,32,40,209.03,384.01,0.00
2024-12-08 17:08:56,71,381,32,39,211.34,384.06,0.00
2024-12-08 17:08:56,71,382,32,39,212.58,385.00,0.00
2024-12-08 17:08:56,72,382,33,39,209.63,385.01,0.00
2024-12-08 17:08:56,71,382,32,39,209.76,385.20,0.00
2024-12-08 17:08:56,71,383,32,39,212.59,386.00,0.00
2024-12-08 17:08:56,72,383,32,40,209.64,386.01,0.00
2024-12-08 17:08:56,71,383,31,40,212.54,386.03,0.00
2024-12-08 17:08:56,70,383,31,39,215.08,386.04,0.00
2024-12-08 17:08:57,70,384,31,39,216.35,387.00,0.00
2024-12-08 17:08:57,71,384,31,40,213.30,387.01,0.00
2024-12-08 17:08:57,70,384,30,40,211.96,387.84,0.00
2024-12-08 17:08:57,70,385,30,40,217.02,388.00,0.00
2024-12-08 17:08:57,71,385,30,41,213.96,388.01,0.00
2024-12-08 17:08:57,70,385,30,40,216.59,388.04,0.00
2024-12-08 17:08:57,70,386,30,40,217.86,389.00,0.00
2024-12-08 17:08:57,71,386,31,40,214.79,389.01,0.00
2024-12-08 17:08:57,71,387,31,40,214.79,390.00,0.00
2024-12-08 17:08:57,72,387,32,40,211.81,390.01,0.00
2024-12-08 17:08:57,71,387,32,39,214.25,390.06,0.00
2024-12-08 17:08:57,70,387,31,39,216.87,390.06,0.00
2024-12-08 17:08:57,70,388,31,39,219.31,391.00,0.00
2024-12-08 17:08:57,71,388,32,39,216.22,391.01,0.00
2024-12-08 17:08:57,71,389,32,39,216.22,392.00,0.00
2024-12-08 17:08:57,72,389,32,40,213.22,392.01,0.00
2024-12-08 17:08:57,71,389,32,39,215.68,392.06,0.00
2024-12-08 17:08:57,71,390,32,39,216.94,393.00,0.00
2024-12-08 17:08:57,72,390,32,40,213.93,393.01,0.00
2024-12-08 17:08:57,72,391,32,40,213.87,394.00,0.00
2024-12-08 17:08:57,73,391,32,41,210.94,394.01,0.00
2024-12-08 17:08:57,72,391,32,40,213.39,394.06,0.00
2024-12-08 17:08:57,72,392,32,40,214.58,395.00,0.00
2024-12-08 17:08:57,73,392,33,40,211.64,395.01,0.00
2024-12-08 17:08:57,72,392,32,40,214.42,395.04,0.00
2024-12-08 17:08:57,72,393,32,40,214.46,396.00,0.00
2024-12-08 17:08:57,73,393,33,40,211.52,396.01,0.00
2024-12-08 17:08:57,72,393,33,39,214.08,396.04,0.00
2024-12-08 17:08:57,72,394,33,39,215.22,397.00,0.00
2024-12-08 17:08:57,73,394,33,40,212.27,397.01,0.00
2024-12-08 17:08:57,73,395,33,40,212.14,398.00,0.00
2024-12-08 17:08:57,74,395,33,41,209.27,398.01,0.00
2024-12-08 17:08:57,73,395,33,40,211.82,398.04,0.00
2024-12-08 17:08:57,73,396,33,40,212.89,399.00,0.00
2024-12-08 17:08:57,74,396,34,40,210.01,399.01,0.00
2024-12-08 17:08:57,73,396,33,40,207.98,399.90,0.00
2024-12-08 17:08:57,73,397,33,40,213.15,400.00,0.00
2024-12-08 17:08:57,74,397,33,41,210.27,400.01,0.00
2024-12-08 17:08:57,73,397,33,40,212.82,400.04,0.00
2024-12-08 17:08:57,73,398,33,40,213.90,401.00,0.00
2024-12-08 17:08:57,74,398,33,41,211.01,401.01,0.00
2024-12-08 17:08:57,74,399,33,41,210.83,402.00,0.00
2024-12-08 17:08:57,75,399,33,42,208.02,402.01,0.00
2024-12-08 17:08:57,74,399,33,41,210.51,402.04,0.00
2024-12-08 17:08:57,73,399,32,41,212.00,402.18,0.00
2024-12-08 17:08:57,73,400,32,41,214.69,403.00,0.00
2024-12-08 17:08:57,74,400,32,42,211.79,403.01,0.00
2024-12-08 17:08:57,73,400,31,42,211.64,403.23,0.00
2024-12-08 17:08:57,73,401,31,42,214.54,404.00,0.00
2024-12-08 17:08:57,74,401,32,42,211.65,404.01,0.00
2024-12-08 17:08:57,73,401,31,42,213.49,404.01,0.00
2024-12-08 17:08:57,72,401,31,41,215.63,404.10,0.00
2024-12-08 17:08:58,72,402,31,41,218.12,405.00,0.00
2024-12-08 17:08:58,73,402,32,41,215.13,405.01,0.00
2024-12-08 17:08:58,73,403,32,41,215.00,406.00,0.00
2024-12-08 17:08:58,74,403,33,41,212.09,406.01,0.00
2024-12-08 17:08:58,73,403,32,41,214.94,406.01,0.00
2024-12-08 17:08:58,72,403,32,40,217.09,406.10,0.00
2024-12-08 17:08:58,71,403,31,40,219.58,406.10,0.00
2024-12-08 17:08:58,71,404,31,40,222.17,407.00,0.00
2024-12-08 17:08:58,72,404,32,40,219.08,407.01,0.00
2024-12-08 17:08:58,72,405,32,40,219.00,408.00,0.00
2024-12-08 17:08:58,73,405,33,40,216.00,408.01,0.00
2024-12-08 17:08:58,72,405,32,40,219.00,408.01,0.00
2024-12-08 17:08:58,71,405,32,39,221.29,408.08,0.00
2024-12-08 17:08:58,71,406,32,39,222.68,409.00,0.00
2024-12-08 17:08:58,72,406,33,39,219.59,409.01,0.00
2024-12-08 17:08:58,72,407,33,39,219.50,410.00,0.00
2024-12-08 17:08:58,73,407,33,40,216.49,410.01,0.00
2024-12-08 17:08:58,72,407,33,39,218.71,410.08,0.00
2024-12-08 17:08:58,72,408,33,39,219.94,411.00,0.00
2024-12-08 17:08:58,73,408,34,39,216.93,411.01,0.00
2024-12-08 17:08:58,72,408,33,39,219.83,411.04,0.00
2024-12-08 17:08:58,71,408,32,39,222.87,411.04,0.00
2024-12-08 17:08:58,70,408,31,39,223.15,411.17,0.00
2024-12-08 17:08:58,70,409,31,39,226.13,412.00,0.00
2024-12-08 17:08:58,71,409,31,40,222.94,412.01,0.00
2024-12-08 17:08:58,70,409,31,39,225.26,412.07,0.00
2024-12-08 17:08:58,69,409,30,39,227.35,412.13,0.00
2024-12-08 17:08:58,69,410,30,39,230.26,413.00,0.00
2024-12-08 17:08:58,70,410,31,39,226.97,413.01,0.00
2024-12-08 17:08:58,69,410,30,39,229.19,413.03,0.00
2024-12-08 17:08:58,69,411,30,39,230.52,414.00,0.00
2024-12-08 17:08:58,70,411,30,40,227.23,414.01,0.00
2024-12-08 17:08:58,69,411,30,39,229.81,414.06,0.00
2024-12-08 17:08:58,69,412,30,39,231.26,415.00,0.00
2024-12-08 17:08:58,70,412,31,39,227.95,415.01,0.00
2024-12-08 17:08:58,69,412,30,39,228.87,415.10,0.00
2024-12-08 17:08:58,69,413,30,39,231.69,416.00,0.00
2024-12-08 17:08:58,70,413,30,40,228.38,416.01,0.00
2024-12-08 17:08:58,69,413,30,39,230.98,416.06,0.00
2024-12-08 17:08:58,69,414,30,39,232.43,417.00,0.00
2024-12-08 17:08:58,70,414,31,39,229.11,417.01,0.00
2024-12-08 17:08:58,70,415,31,39,229.12,418.00,0.00
2024-12-08 17:08:58,71,415,31,40,225.90,418.01,0.00
2024-12-08 17:08:58,70,415,31,39,228.47,418.06,0.00
2024-12-08 17:08:58,70,416,31,39,229.85,419.00,0.00
2024-12-08 17:08:58,71,416,31,40,226.61,419.01,0.00
2024-12-08 17:08:58,71,417,31,40,226.56,420.00,0.00
2024-12-08 17:08:58,72,417,31,41,223.42,420.01,0.00
2024-12-08 17:08:58,71,417,31,40,225.98,420.06,0.00
2024-12-08 17:08:58,71,418,31,40,227.28,421.00,0.00
2024-12-08 17:08:58,72,418,32,40,224.12,421.01,0.00
2024-12-08 17:08:58,71,418,31,40,225.42,421.18,0.00
2024-12-08 17:08:58,70,418,30,40,225.59,421.70,0.00
2024-12-08 17:08:59,70,419,30,40,230.59,422.00,0.00
2024-12-08 17:08:59,71,419,30,41,227.35,422.01,0.00
2024-12-08 17:08:59,70,419,30,40,229.75,422.07,0.00
2024-12-08 17:08:59,70,420,30,40,231.20,423.00,0.00
2024-12-08 17:08:59,71,420,30,41,227.94,423.01,0.00
2024-12-08 17:08:59,70,420,29,41,229.30,423.19,0.00
2024-12-08 17:08:59,70,421,29,41,231.20,424.00,0.00
2024-12-08 17:08:59,71,421,30,41,227.94,424.01,0.00
2024-12-08 17:08:59,70,421,30,40,230.42,424.07,0.00
2024-12-08 17:08:59,70,422,30,40,231.87,425.00,0.00
2024-12-08 17:08:59,71,422,30,41,228.60,425.01,0.00
2024-12-08 17:08:59,70,422,29,41,228.75,425.19,0.00
2024-12-08 17:08:59,70,423,29,41,231.87,426.00,0.00
2024-12-08 17:08:59,71,423,30,41,228.60,426.01,0.00
2024-12-08 17:08:59,70,423,30,40,231.14,426.07,0.00
2024-12-08 17:08:59,70,424,30,40,232.59,427.00,0.00
2024-12-08 17:08:59,71,424,31,40,229.32,427.01,0.00
2024-12-08 17:08:59,70,424,30,40,231.86,427.07,0.00
2024-12-08 17:08:59,69,424,29,40,233.58,427.17,0.00
2024-12-08 17:08:59,69,425,29,40,236.76,428.00,0.00
2024-12-08 17:08:59,70,425,30,40,233.38,428.01,0.00
2024-12-08 17:08:59,69,425,30,39,236.70,428.01,0.00
2024-12-08 17:08:59,69,426,30,39,236.76,429.00,0.00
2024-12-08 17:08:59,70,426,31,39,233.38,429.01,0.00
2024-12-08 17:08:59,69,426,31,38,236.14,429.06,0.00
2024-12-08 17:08:59,69,427,31,38,237.62,430.00,0.00
2024-12-08 17:08:59,70,427,31,39,234.23,430.01,0.00
2024-12-08 17:08:59,69,427,31,38,236.94,430.06,0.00
2024-12-08 17:08:59,69,428,31,38,238.42,431.00,0.00
2024-12-08 17:08:59,70,428,31,39,235.02,431.01,0.00
2024-12-08 17:08:59,69,428,30,39,238.30,431.04,0.00
2024-12-08 17:08:59,69,429,30,39,238.48,432.00,0.00
2024-12-08 17:08:59,70,429,30,40,235.07,432.01,0.00
2024-12-08 17:08:59,69,429,30,39,237.91,432.04,0.00
2024-12-08 17:08:59,68,429,29,39,240.90,432.04,0.00
2024-12-08 17:08:59,68,430,29,39,243.69,433.00,0.00
2024-12-08 17:08:59,69,430,30,39,240.16,433.01,0.00
2024-12-08 17:08:59,68,430,30,38,243.63,433.01,0.00
2024-12-08 17:08:59,67,430,29,38,244.94,433.06,0.00
2024-12-08 17:09:00,67,431,29,38,247.90,434.00,0.00
2024-12-08 17:09:00,68,431,29,39,244.25,434.01,0.00
2024-12-08 17:09:00,68,432,29,39,244.37,435.00,0.00
2024-12-08 17:09:00,69,432,29,40,240.83,435.01,0.00
2024-12-08 17:09:00,68,432,29,39,243.86,435.03,0.00
2024-12-08 17:09:00,68,433,29,39,245.31,436.00,0.00
2024-12-08 17:09:00,69,433,30,39,241.76,436.01,0.00
2024-12-08 17:09:00,69,434,30,39,241.81,437.00,0.00
2024-12-08 17:09:00,70,434,30,40,238.35,437.01,0.00
2024-12-08 17:09:00,69,434,30,39,240.86,437.06,0.00
2024-12-08 17:09:00,69,435,30,39,242.36,438.00,0.00
2024-12-08 17:09:00,70,435,30,40,238.90,438.01,0.00
2024-12-08 17:09:00,69,435,30,39,241.92,438.03,0.00
2024-12-08 17:09:00,69,436,30,39,243.30,439.00,0.00
2024-12-08 17:09:00,70,436,31,39,239.82,439.01,0.00
2024-12-08 17:09:00,69,436,30,39,243.23,439.01,0.00
2024-12-08 17:09:00,68,436,29,39,244.85,439.16,0.00
2024-12-08 17:09:00,67,436,28,39,246.44,439.39,0.00
2024-12-08 17:09:00,67,437,28,39,250.73,440.00,0.00
2024-12-08 17:09:00,68,437,28,40,247.05,440.01,0.00
2024-12-08 17:09:00,67,437,28,39,249.89,440.04,0.00
2024-12-08 17:09:00,67,438,28,39,251.50,441.00,0.00
2024-12-08 17:09:00,68,438,28,40,247.80,441.01,0.00
2024-12-08 17:09:00,68,439,28,40,247.91,442.00,0.00
2024-12-08 17:09:00,69,439,28,41,244.32,442.01,0.00
2024-12-08 17:09:00,68,439,28,40,247.13,442.04,0.00
2024-12-08 17:09:00,68,440,28,40,248.67,443.00,0.00
2024-12-08 17:09:00,69,440,29,40,245.06,443.01,0.00
2024-12-08 17:09:00,69,441,29,40,245.10,444.00,0.00
2024-12-08 17:09:00,70,441,30,40,241.60,444.01,0.00
2024-12-08 17:09:00,69,441,30,39,244.40,444.04,0.00
2024-12-08 17:09:00,69,442,30,39,245.85,445.00,0.00
2024-12-08 17:09:00,70,442,30,40,242.33,445.01,0.00
2024-12-08 17:09:00,70,443,30,40,242.31,446.00,0.00
2024-12-08 17:09:00,71,443,30,41,238.89,446.01,0.00
2024-12-08 17:09:00,70,443,30,40,241.67,446.04,0.00
2024-12-08 17:09:00,69,443,29,40,244.63,446.17,0.00
2024-12-08 17:09:00,68,443,28,40,247.10,446.29,0.00
2024-12-08 17:09:00,68,444,28,40,250.98,447.00,0.00
2024-12-08 17:09:00,69,444,28,41,247.34,447.01,0.00
2024-12-08 17:09:00,69,445,28,41,247.37,448.00,0.00
2024-12-08 17:09:00,70,445,29,41,243.84,448.01,0.00
2024-12-08 17:09:00,69,445,29,40,246.79,448.04,0.00
2024-12-08 17:09:00,69,446,29,40,248.25,449.00,0.00
2024-12-08 17:09:00,70,446,30,40,244.70,449.01,0.00
2024-12-08 17:09:00,69,446,29,40,243.09,449.68,0.00
2024-12-08 17:09:00,69,447,29,40,248.41,450.00,0.00
2024-12-08 17:09:00,70,447,30,40,244.86,450.01,0.00
2024-12-08 17:09:00,69,447,29,40,248.35,450.03,0.00
2024-12-08 17:09:01,69,448,29,40,248.44,451.00,0.00
2024-12-08 17:09:01,70,448,29,41,244.89,451.01,0.00
2024-12-08 17:09:01,69,448,29,40,247.99,451.03,0.00
2024-12-08 17:09:01,69,449,29,40,249.39,452.00,0.00
2024-12-08 17:09:01,70,449,29,41,245.82,452.01,0.00
2024-12-08 17:09:01,70,450,29,41,245.78,453.00,0.00
2024-12-08 17:09:01,71,450,30,41,242.32,453.01,0.00
2024-12-08 17:09:01,70,450,30,40,245.40,453.03,0.00
2024-12-08 17:09:01,70,451,30,40,246.72,454.00,0.00
2024-12-08 17:09:01,71,451,31,40,243.24,454.01,0.00
2024-12-08 17:09:01,70,451,30,40,241.26,454.71,0.00
2024-12-08 17:09:01,70,452,30,40,246.67,455.00,0.00
2024-12-08 17:09:01,71,452,30,41,243.20,455.01,0.00
2024-12-08 17:09:01,71,453,30,41,243.09,456.00,0.00
2024-12-08 17:09:01,72,453,31,41,239.72,456.01,0.00
2024-12-08 17:09:01,71,453,31,40,242.84,456.03,0.00
2024-12-08 17:09:01,70,453,30,40,243.40,456.59,0.00
2024-12-08 17:09:01,70,454,30,40,248.35,457.00,0.00
2024-12-08 17:09:01,71,454,31,40,244.85,457.01,0.00
2024-12-08 17:09:01,70,454,31,39,248.02,457.03,0.00
2024-12-08 17:09:01,70,455,31,39,249.35,458.00,0.00
2024-12-08 17:09:01,71,455,31,40,245.84,458.01,0.00
2024-12-08 17:09:01,70,455,31,39,248.89,458.04,0.00
2024-12-08 17:09:01,70,456,31,39,250.29,459.00,0.00
2024-12-08 17:09:01,71,456,32,39,246.76,459.01,0.00
2024-12-08 17:09:01,71,457,32,39,246.65,460.00,0.00
2024-12-08 17:09:01,72,457,33,39,243.22,460.01,0.00
2024-12-08 17:09:01,71,457,33,38,245.94,460.07,0.00
2024-12-08 17:09:01,71,458,33,38,247.38,461.00,0.00
2024-12-08 17:09:01,72,458,34,38,243.95,461.01,0.00
2024-12-08 17:09:01,72,459,34,38,243.77,462.00,0.00
2024-12-08 17:09:01,73,459,35,38,240.43,462.01,0.00
2024-12-08 17:09:01,72,459,34,38,243.71,462.03,0.00
2024-12-08 17:09:01,72,460,34,38,243.59,463.00,0.00
2024-12-08 17:09:01,73,460,34,39,240.25,463.01,0.00
2024-12-08 17:09:01,72,460,34,38,243.08,463.06,0.00
2024-12-08 17:09:01,72,461,34,38,244.37,464.00,0.00
2024-12-08 17:09:01,73,461,34,39,241.03,464.01,0.00
2024-12-08 17:09:01,72,461,33,39,244.31,464.03,0.00
2024-12-08 17:09:01,72,462,33,39,244.19,465.00,0.00
2024-12-08 17:09:01,73,462,33,40,240.84,465.01,0.00
2024-12-08 17:09:01,72,462,33,39,243.80,465.04,0.00
2024-12-08 17:09:01,72,463,33,39,245.04,466.00,0.00
2024-12-08 17:09:01,73,463,34,39,241.68,466.01,0.00
2024-12-08 17:09:01,72,463,34,38,244.34,466.07,0.00
2024-12-08 17:09:01,72,464,34,38,245.69,467.00,0.00
2024-12-08 17:09:01,73,464,34,39,242.33,467.01,0.00
2024-12-08 17:09:01,72,464,33,39,245.63,467.01,0.00
2024-12-08 17:09:02,72,465,33,39,245.44,468.00,0.00
2024-12-08 17:09:02,73,465,33,40,242.08,468.01,0.00
2024-12-08 17:09:02,72,465,33,39,244.86,468.06,0.00
2024-12-08 17:09:02,72,466,33,39,246.16,469.00,0.00
2024-12-08 17:09:02,73,466,34,39,242.79,469.01,0.00
2024-12-08 17:09:02,73,467,34,39,242.53,470.00,0.00
2024-12-08 17:09:02,74,467,34,40,239.26,470.01,0.00
2024-12-08 17:09:02,73,467,34,39,242.02,470.05,0.00
2024-12-08 17:09:02,73,468,34,39,243.24,471.00,0.00
2024-12-08 17:09:02,74,468,35,39,239.96,471.01,0.00
2024-12-08 17:09:02,74,469,35,39,239.64,472.00,0.00
2024-12-08 17:09:02,75,469,36,39,236.44,472.01,0.00
2024-12-08 17:09:02,74,469,36,38,239.07,472.05,0.00
2024-12-08 17:09:02,74,470,36,38,240.21,473.00,0.00
2024-12-08 17:09:02,75,470,36,39,237.00,473.01,0.00
2024-12-08 17:09:02,75,471,36,39,236.62,474.00,0.00
2024-12-08 17:09:02,76,471,37,39,233.51,474.01,0.00
2024-12-08 17:09:02,75,471,37,38,236.12,474.05,0.00
2024-12-08 17:09:02,75,472,37,38,237.18,475.00,0.00
2024-12-08 17:09:02,76,472,37,39,234.06,475.01,0.00
2024-12-08 17:09:02,76,473,37,39,233.62,476.00,0.00
2024-12-08 17:09:02,77,473,37,40,230.58,476.01,0.00
2024-12-08 17:09:02,76,473,37,39,233.12,476.05,0.00
2024-12-08 17:09:02,75,473,36,39,234.61,476.19,0.00
2024-12-08 17:09:02,74,473,35,39,237.60,476.23,0.00
2024-12-08 17:09:02,74,474,35,39,240.82,477.00,0.00
2024-12-08 17:09:02,75,474,35,40,237.61,477.01,0.00
2024-12-08 17:09:02,74,474,34,40,238.01,477.16,0.00
2024-12-08 17:09:02,74,475,34,40,240.94,478.00,0.00
2024-12-08 17:09:02,75,475,34,41,237.73,478.01,0.00
2024-12-08 17:09:02,74,475,34,40,240.49,478.05,0.00
2024-12-08 17:09:02,74,476,34,40,241.64,479.00,0.00
2024-12-08 17:09:02,75,476,34,41,238.41,479.01,0.00
2024-12-08 17:09:02,74,476,33,41,241.25,479.01,0.00
2024-12-08 17:09:02,74,477,33,41,242.21,480.00,0.00
2024-12-08 17:09:02,75,477,34,41,238.98,480.01,0.00
2024-12-08 17:09:02,74,477,33,41,241.25,480.11,0.00
2024-12-08 17:09:02,73,477,33,40,243.77,480.12,0.00
2024-12-08 17:09:02,72,477,32,40,245.74,480.44,0.00
2024-12-08 17:09:02,72,478,32,40,250.12,481.00,0.00
2024-12-08 17:09:02,73,478,32,41,246.69,481.01,0.00
2024-12-08 17:09:02,73,479,32,41,246.41,482.00,0.00
2024-12-08 17:09:02,74,479,32,42,243.08,482.01,0.00
2024-12-08 17:09:02,73,479,32,41,245.17,482.12,0.00
2024-12-08 17:09:02,73,480,32,41,246.73,483.00,0.00
2024-12-08 17:09:02,74,480,33,41,243.39,483.01,0.00
2024-12-08 17:09:02,74,481,33,41,243.05,484.00,0.00
2024-12-08 17:09:02,75,481,33,42,239.81,484.01,0.00
2024-12-08 17:09:02,74,481,33,41,241.75,484.14,0.00
2024-12-08 17:09:03,74,482,33,41,243.29,485.00,0.00
2024-12-08 17:09:03,75,482,34,41,240.04,485.01,0.00
2024-12-08 17:09:03,74,482,33,41,240.48,485.15,0.00
2024-12-08 17:09:03,74,483,33,41,243.39,486.00,0.00
2024-12-08 17:09:03,75,483,34,41,240.15,486.01,0.00
2024-12-08 17:09:03,74,483,33,41,243.07,486.08,0.00
2024-12-08 17:09:03,73,483,33,40,245.48,486.12,0.00
2024-12-08 17:09:03,73,484,33,40,247.04,487.00,0.00
2024-12-08 17:09:03,74,484,33,41,243.70,487.01,0.00
2024-12-08 17:09:03,74,485,33,41,243.34,488.00,0.00
2024-12-08 17:09:03,75,485,33,42,240.10,488.01,0.00
2024-12-08 17:09:03,74,485,32,42,242.89,488.09,0.00
2024-12-08 17:09:03,73,485,32,41,245.41,488.11,0.00
2024-12-08 17:09:03,73,486,32,41,246.91,489.00,0.00
2024-12-08 17:09:03,74,486,32,42,243.57,489.01,0.00
2024-12-08 17:09:03,73,486,31,42,246.84,489.01,0.00
2024-12-08 17:09:03,72,486,31,41,249.25,489.03,0.00
2024-12-08 17:09:03,72,487,31,41,250.44,490.00,0.00
2024-12-08 17:09:03,73,487,31,42,247.01,490.01,0.00
2024-12-08 17:09:03,72,487,30,42,250.38,490.01,0.00
2024-12-08 17:09:03,71,487,29,42,251.29,490.10,0.00
2024-12-08 17:09:03,70,487,28,42,253.40,490.43,0.00
2024-12-08 17:09:03,70,488,28,42,257.99,491.00,0.00
2024-12-08 17:09:03,71,488,28,43,254.35,491.01,0.00
2024-12-08 17:09:03,70,488,27,43,253.22,491.59,0.00
2024-12-08 17:09:03,70,489,27,43,258.51,492.00,0.00
2024-12-08 17:09:03,71,489,27,44,254.87,492.01,0.00
2024-12-08 17:09:03,70,489,27,43,257.19,492.11,0.00
2024-12-08 17:09:03,70,490,27,43,258.97,493.00,0.00
2024-12-08 17:09:03,71,490,28,43,255.32,493.01,0.00
2024-12-08 17:09:03,71,491,28,43,255.14,494.00,0.00
2024-12-08 17:09:03,72,491,28,44,251.60,494.01,0.00
2024-12-08 17:09:03,71,491,27,44,254.94,494.06,0.00
2024-12-08 17:09:03,70,491,26,44,257.18,494.13,0.00
2024-12-08 17:09:03,70,492,26,44,259.03,495.00,0.00
2024-12-08 17:09:03,71,492,26,45,255.38,495.01,0.00
2024-12-08 17:09:03,70,492,26,44,257.84,495.10,0.00
2024-12-08 17:09:03,70,493,26,44,259.55,496.00,0.00
2024-12-08 17:09:03,71,493,27,44,255.89,496.01,0.00
2024-12-08 17:09:03,70,493,27,43,257.94,496.13,0.00
2024-12-08 17:09:03,70,494,27,43,259.79,497.00,0.00
2024-12-08 17:09:03,71,494,28,43,256.13,497.01,0.00
2024-12-08 17:09:03,70,494,27,43,258.59,497.10,0.00
2024-12-08 17:09:03,70,495,27,43,260.31,498.00,0.00
2024-12-08 17:09:03,71,495,28,43,256.65,498.01,0.00
2024-12-08 17:09:03,70,495,27,43,256.78,498.17,0.00
2024-12-08 17:09:03,70,496,27,43,260.26,499.00,0.00
2024-12-08 17:09:03,71,496,28,43,256.60,499.01,0.00
2024-12-08 17:09:03,70,496,28,42,259.98,499.06,0.00
2024-12-08 17:09:03,69,496,28,41,262.60,499.10,0.00
2024-12-08 17:09:03,69,497,28,41,264.21,500.00,0.00
2024-12-08 17:09:03,70,497,28,42,260.44,500.01,0.00
2024-12-08 17:09:04,69,497,28,41,262.49,500.13,0.00
2024-12-08 17:09:04,69,498,28,41,263.99,501.00,0.00
2024-12-08 17:09:04,70,498,28,42,260.22,501.01,0.00
2024-12-08 17:09:04,70,499,28,42,259.57,502.00,0.00
2024-12-08 17:09:04,71,499,28,43,255.91,502.01,0.00
2024-12-08 17:09:04,70,499,28,42,258.36,502.10,0.00
2024-12-08 17:09:04,70,500,28,42,259.51,503.00,0.00
2024-12-08 17:09:04,71,500,28,43,255.85,503.01,0.00
2024-12-08 17:09:04,70,500,28,42,259.44,503.01,0.00
2024-12-08 17:09:04,70,501,28,42,258.77,504.00,0.00
2024-12-08 17:09:04,71,501,29,42,255.13,504.01,0.00
2024-12-08 17:09:04,70,501,28,42,258.70,504.01,0.00
2024-12-08 17:09:04,69,501,28,41,261.07,504.09,0.00
2024-12-08 17:09:04,68,501,27,41,264.64,504.15,0.00
2024-12-08 17:09:04,68,502,27,41,266.24,505.00,0.00
2024-12-08 17:09:04,69,502,27,42,262.38,505.01,0.00
2024-12-08 17:09:04,68,502,26,42,264.11,505.15,0.00
2024-12-08 17:09:04,68,503,26,42,265.76,506.00,0.00
2024-12-08 17:09:04,69,503,26,43,261.91,506.01,0.00
2024-12-08 17:09:04,68,503,25,43,265.69,506.01,0.00
2024-12-08 17:09:04,67,503,25,42,268.38,506.07,0.00
2024-12-08 17:09:04,67,504,25,42,269.80,507.00,0.00
2024-12-08 17:09:04,68,504,26,42,265.84,507.01,0.00
2024-12-08 17:09:04,67,504,25,42,266.46,507.40,0.00
2024-12-08 17:09:04,66,504,24,42,269.84,507.47,0.00
2024-12-08 17:09:04,66,505,24,42,274.76,508.00,0.00
2024-12-08 17:09:04,67,505,24,43,270.66,508.01,0.00
2024-12-08 17:09:04,66,505,24,42,273.46,508.08,0.00
2024-12-08 17:09:04,66,506,24,42,275.02,509.00,0.00
2024-12-08 17:09:04,67,506,25,42,270.92,509.01,0.00
2024-12-08 17:09:04,67,507,25,42,270.60,510.00,0.00
2024-12-08 17:09:04,68,507,26,42,266.62,510.01,0.00
2024-12-08 17:09:04,68,508,26,42,266.25,511.00,0.00
2024-12-08 17:09:04,69,508,26,43,262.39,511.01,0.00
2024-12-08 17:09:04,68,508,26,42,265.13,511.07,0.00
2024-12-08 17:09:04,67,508,25,42,266.20,511.64,0.00
2024-12-08 17:09:04,67,509,25,42,270.75,512.00,0.00
2024-12-08 17:09:04,68,509,26,42,266.77,512.01,0.00
2024-12-08 17:09:04,67,509,26,41,269.61,512.07,0.00
2024-12-08 17:09:04,67,510,26,41,271.51,513.00,0.00
2024-12-08 17:09:04,68,510,27,41,267.51,513.01,0.00
2024-12-08 17:09:04,67,510,26,41,269.09,513.18,0.00
2024-12-08 17:09:04,66,510,25,41,270.54,513.41,0.00
2024-12-08 17:09:04,66,511,25,41,275.69,514.00,0.00
2024-12-08 17:09:04,67,511,26,41,271.57,514.02,0.00
2024-12-08 17:09:04,66,511,26,40,274.45,514.08,0.00
2024-12-08 17:09:04,66,512,26,40,276.46,515.00,0.00
2024-12-08 17:09:04,67,512,27,40,272.33,515.02,0.00
2024-12-08 17:09:04,66,512,26,40,274.15,515.17,0.00
2024-12-08 17:09:04,66,513,26,40,276.61,516.00,0.00
2024-12-08 17:09:04,67,513,26,41,272.48,516.02,0.00
2024-12-08 17:09:04,66,513,26,40,275.44,516.08,0.00
2024-12-08 17:09:05,66,514,26,40,277.46,517.00,0.00
2024-12-08 17:09:05,67,514,26,41,273.31,517.02,0.00
2024-12-08 17:09:05,66,514,25,41,275.14,517.17,0.00
2024-12-08 17:09:05,66,515,25,41,277.60,518.00,0.00
2024-12-08 17:09:05,67,515,25,42,273.46,518.02,0.00
2024-12-08 17:09:05,66,515,25,41,276.51,518.08,0.00
2024-12-08 17:09:05,66,516,25,41,278.53,519.00,0.00
2024-12-08 17:09:05,67,516,26,41,274.37,519.02,0.00
2024-12-08 17:09:05,67,517,26,41,274.43,520.00,0.00
2024-12-08 17:09:05,68,517,26,42,270.40,520.01,0.00
2024-12-08 17:09:05,67,517,26,41,274.36,520.02,0.00
2024-12-08 17:09:05,67,518,26,41,274.42,521.00,0.00
2024-12-08 17:09:05,68,518,26,42,270.38,521.01,0.00
2024-12-08 17:09:05,67,518,26,41,273.18,521.09,0.00
2024-12-08 17:09:05,67,519,26,41,275.18,522.00,0.00
2024-12-08 17:09:05,68,519,26,42,271.13,522.01,0.00
2024-12-08 17:09:05,67,519,26,41,275.10,522.02,0.00
2024-12-08 17:09:05,66,519,26,40,278.09,522.08,0.00
2024-12-08 17:09:05,66,520,26,40,280.12,523.00,0.00
2024-12-08 17:09:05,67,520,27,40,275.94,523.02,0.00
2024-12-08 17:09:05,67,521,27,40,276.00,524.00,0.00
2024-12-08 17:09:05,68,521,27,41,271.94,524.01,0.00
2024-12-08 17:09:05,68,522,27,41,271.92,525.00,0.00
2024-12-08 17:09:05,69,522,27,42,267.98,525.01,0.00
2024-12-08 17:09:05,68,522,27,41,270.76,525.07,0.00
2024-12-08 17:09:05,68,523,27,41,272.59,526.00,0.00
2024-12-08 17:09:05,69,523,28,41,268.64,526.01,0.00
2024-12-08 17:09:05,68,523,28,40,270.52,526.15,0.00
2024-12-08 17:09:05,67,523,27,40,273.26,526.42,0.00
2024-12-08 17:09:05,67,524,27,40,276.87,527.00,0.00
2024-12-08 17:09:05,68,524,27,41,272.80,527.01,0.00
2024-12-08 17:09:05,67,524,26,41,275.23,527.12,0.00
2024-12-08 17:09:05,67,525,26,41,277.40,528.00,0.00
2024-12-08 17:09:05,68,525,26,42,273.32,528.01,0.00
2024-12-08 17:09:05,67,525,25,42,277.16,528.04,0.00
2024-12-08 17:09:05,67,526,25,42,277.37,529.00,0.00
2024-12-08 17:09:05,68,526,26,42,273.29,529.01,0.00
2024-12-08 17:09:05,67,526,25,42,277.29,529.02,0.00
2024-12-08 17:09:05,66,526,25,41,279.74,529.11,0.00
2024-12-08 17:09:05,66,527,25,41,281.94,530.00,0.00
2024-12-08 17:09:05,67,527,25,42,277.73,530.02,0.00
2024-12-08 17:09:05,66,527,24,42,281.78,530.03,0.00
2024-12-08 17:09:05,65,527,23,42,285.15,530.06,0.00
2024-12-08 17:09:05,64,527,23,41,287.95,530.09,0.00
2024-12-08 17:09:05,64,528,23,41,291.97,531.00,0.00
2024-12-08 17:09:05,65,528,24,41,287.47,531.02,0.00
2024-12-08 17:09:05,65,529,24,41,287.69,532.00,0.00
2024-12-08 17:09:05,66,529,25,41,283.33,532.02,0.00
2024-12-08 17:09:05,65,529,25,40,286.22,532.08,0.00
2024-12-08 17:09:05,65,530,25,40,288.39,533.00,0.00
2024-12-08 17:09:05,66,530,26,40,284.02,533.02,0.00
2024-12-08 17:09:05,65,530,25,40,287.33,533.06,0.00
2024-12-08 17:09:05,65,531,25,40,289.43,534.00,0.00
2024-12-08 17:09:05,66,531,25,41,285.04,534.02,0.00
2024-12-08 17:09:05,65,531,25,40,289.34,534.02,0.00
2024-12-08 17:09:05,64,531,25,39,292.45,534.05,0.00
2024-12-08 17:09:05,63,531,24,39,295.53,534.37,0.00
2024-12-08 17:09:06,63,532,24,39,299.34,535.00,0.00
2024-12-08 17:09:06,64,532,25,39,294.66,535.02,0.00
2024-12-08 17:09:06,64,533,25,39,294.96,536.00,0.00
2024-12-08 17:09:06,65,533,25,40,290.42,536.02,0.00
2024-12-08 17:09:06,64,533,25,39,293.46,536.06,0.00
2024-12-08 17:09:06,64,534,25,39,295.64,537.00,0.00
2024-12-08 17:09:06,65,534,26,39,291.09,537.02,0.00
2024-12-08 17:09:06,64,534,25,39,292.12,537.08,0.00
2024-12-08 17:09:06,64,535,25,39,296.04,538.00,0.00
2024-12-08 17:09:06,65,535,26,39,291.49,538.02,0.00
2024-12-08 17:09:06,64,535,26,38,294.46,538.06,0.00
2024-12-08 17:09:06,63,535,25,38,297.63,538.37,0.00
2024-12-08 17:09:06,63,536,25,38,301.40,539.00,0.00
2024-12-08 17:09:06,64,536,25,39,296.69,539.02,0.00
2024-12-08 17:09:06,63,536,24,39,297.94,539.37,0.00
2024-12-08 17:09:06,62,536,23,39,300.34,539.60,0.00
2024-12-08 17:09:06,62,537,23,39,307.12,540.00,0.00
2024-12-08 17:09:06,63,537,24,39,302.24,540.02,0.00
2024-12-08 17:09:06,62,537,24,38,305.47,540.06,0.00
2024-12-08 17:09:06,62,538,24,38,307.90,541.00,0.00
2024-12-08 17:09:06,63,538,24,39,303.02,541.02,0.00
2024-12-08 17:09:06,63,539,24,39,303.39,542.00,0.00
2024-12-08 17:09:06,64,539,24,40,298.65,542.02,0.00
2024-12-08 17:09:06,63,539,24,39,301.85,542.06,0.00
2024-12-08 17:09:06,63,540,24,39,304.21,543.00,0.00
2024-12-08 17:09:06,64,540,24,40,299.46,543.02,0.00
2024-12-08 17:09:06,63,540,23,40,300.44,543.11,0.00
2024-12-08 17:09:06,63,541,23,40,304.77,544.00,0.00
2024-12-08 17:09:06,64,541,24,40,300.01,544.02,0.00
2024-12-08 17:09:06,63,541,23,40,302.38,544.14,0.00
2024-12-08 17:09:06,62,541,22,40,305.96,544.39,0.00
2024-12-08 17:09:06,62,542,22,40,310.08,545.00,0.00
2024-12-08 17:09:06,63,542,23,40,305.16,545.02,0.00
2024-12-08 17:09:06,62,542,23,39,308.08,545.11,0.00
2024-12-08 17:09:06,62,543,23,39,310.83,546.00,0.00
2024-12-08 17:09:06,63,543,23,40,305.89,546.02,0.00
2024-12-08 17:09:06,63,544,23,40,306.28,547.00,0.00
2024-12-08 17:09:06,64,544,23,41,301.49,547.02,0.00
2024-12-08 17:09:06,63,544,23,40,304.38,547.11,0.00
2024-12-08 17:09:06,62,544,22,40,307.83,547.39,0.00
2024-12-08 17:09:06,62,545,22,40,311.97,548.00,0.00
2024-12-08 17:09:06,63,545,23,40,307.01,548.02,0.00
2024-12-08 17:09:06,63,546,23,40,307.40,549.00,0.00
2024-12-08 17:09:06,64,546,23,41,302.60,549.02,0.00
2024-12-08 17:09:06,63,546,23,40,305.15,549.13,0.00
2024-12-08 17:09:06,62,546,22,40,304.72,549.94,0.00
2024-12-08 17:09:06,62,547,22,40,313.28,550.00,0.00
2024-12-08 17:09:06,63,547,23,40,308.31,550.02,0.00
2024-12-08 17:09:06,62,547,22,40,313.11,550.05,0.00
2024-12-08 17:09:06,62,548,22,40,313.76,551.00,0.00
2024-12-08 17:09:06,63,548,22,41,308.78,551.02,0.00
2024-12-08 17:09:06,62,548,22,40,311.65,551.11,0.00
2024-12-08 17:09:06,61,548,21,40,315.42,551.38,0.00
2024-12-08 17:09:06,61,549,21,40,319.67,552.00,0.00
2024-12-08 17:09:06,62,549,22,40,314.51,552.02,0.00
2024-12-08 17:09:07,62,550,22,40,314.91,553.00,0.00
2024-12-08 17:09:07,63,550,22,41,309.91,553.02,0.00
2024-12-08 17:09:07,62,550,22,40,312.53,553.15,0.00
2024-12-08 17:09:07,61,550,21,40,313.65,553.64,0.00
2024-12-08 17:09:07,61,551,21,40,320.91,554.00,0.00
2024-12-08 17:09:07,62,551,21,41,315.73,554.02,0.00
2024-12-08 17:09:07,62,552,21,41,316.10,555.00,0.00
2024-12-08 17:09:07,63,552,21,42,311.08,555.02,0.00
2024-12-08 17:09:07,62,552,21,41,313.80,555.15,0.00
2024-12-08 17:09:07,62,553,21,41,316.66,556.00,0.00
2024-12-08 17:09:07,63,553,21,42,311.63,556.02,0.00
2024-12-08 17:09:07,63,554,21,42,311.93,557.00,0.00
2024-12-08 17:09:07,64,554,21,43,307.05,557.02,0.00
2024-12-08 17:09:07,63,554,20,43,311.84,557.02,0.00
2024-12-08 17:09:07,62,554,20,42,314.64,557.13,0.00
2024-12-08 17:09:07,61,554,19,42,319.72,557.15,0.00
2024-12-08 17:09:07,60,554,18,42,321.21,557.62,0.00
2024-12-08 17:09:07,60,555,18,42,328.61,558.00,0.00
2024-12-08 17:09:07,61,555,18,43,323.22,558.02,0.00
2024-12-08 17:09:07,60,555,18,42,328.52,558.02,0.00
2024-12-08 17:09:07,59,555,18,41,333.90,558.03,0.00
2024-12-08 17:09:07,59,556,18,41,334.72,559.00,0.00
2024-12-08 17:09:07,60,556,18,42,329.15,559.02,0.00
2024-12-08 17:09:07,59,556,18,41,332.66,559.10,0.00
2024-12-08 17:09:07,59,557,18,41,335.77,560.00,0.00
2024-12-08 17:09:07,60,557,18,42,330.17,560.02,0.00
2024-12-08 17:09:07,59,557,17,42,335.32,560.10,0.00
2024-12-08 17:09:07,58,557,16,42,337.10,560.43,0.00
2024-12-08 17:09:07,58,558,16,42,343.87,561.00,0.00
2024-12-08 17:09:07,59,558,17,42,338.04,561.02,0.00
2024-12-08 17:09:07,59,559,17,42,338.62,562.00,0.00
2024-12-08 17:09:07,60,559,17,43,332.97,562.02,0.00
2024-12-08 17:09:07,59,559,17,42,336.35,562.10,0.00
2024-12-08 17:09:07,58,559,16,42,340.83,562.21,0.00
2024-12-08 17:09:07,58,560,16,42,346.36,563.00,0.00
2024-12-08 17:09:07,59,560,16,43,340.49,563.02,0.00
2024-12-08 17:09:07,59,561,16,43,340.99,564.00,0.00
2024-12-08 17:09:07,60,561,16,44,335.30,564.02,0.00
2024-12-08 17:09:07,60,562,16,44,335.70,565.00,0.00
2024-12-08 17:09:07,61,562,17,44,330.20,565.02,0.00
2024-12-08 17:09:07,60,562,17,43,333.46,565.12,0.00
2024-12-08 17:09:07,60,563,17,43,336.31,566.00,0.00
2024-12-08 17:09:07,61,563,18,43,330.80,566.02,0.00
2024-12-08 17:09:07,60,563,18,42,334.07,566.12,0.00
2024-12-08 17:09:07,60,564,18,42,336.96,567.00,0.00
2024-12-08 17:09:07,61,564,18,43,331.44,567.02,0.00
2024-12-08 17:09:07,61,565,18,43,331.81,568.00,0.00
2024-12-08 17:09:07,62,565,19,43,326.46,568.02,0.00
2024-12-08 17:09:07,61,565,19,42,329.59,568.11,0.00
2024-12-08 17:09:07,61,566,19,42,332.41,569.00,0.00
2024-12-08 17:09:07,62,566,19,43,327.05,569.02,0.00
2024-12-08 17:09:07,62,567,19,43,327.37,570.00,0.00
2024-12-08 17:09:07,63,567,19,44,322.18,570.02,0.00
2024-12-08 17:09:07,62,567,19,43,325.27,570.11,0.00
2024-12-08 17:09:07,63,566,19,44,317.63,570.62,0.00
2024-12-08 17:09:07,63,567,19,44,327.16,571.00,0.00
2024-12-08 17:09:07,64,567,19,45,322.05,571.02,0.00
2024-12-08 17:09:08,64,568,19,45,330.95,572.00,0.00
2024-12-08 17:09:08,65,568,19,46,325.86,572.02,0.00
2024-12-08 17:09:08,64,568,19,45,328.90,572.11,0.00
2024-12-08 17:09:08,65,567,19,46,319.99,572.52,0.00
2024-12-08 17:09:08,66,566,20,46,316.04,572.88,0.00
2024-12-08 17:09:08,66,567,20,46,324.59,573.00,0.00
2024-12-08 17:09:08,67,567,20,47,319.75,573.02,0.00
2024-12-08 17:09:08,67,568,20,47,336.60,574.00,0.00
2024-12-08 17:09:08,68,568,21,47,331.65,574.01,0.00
2024-12-08 17:09:08,68,569,21,47,331.39,575.00,0.00
2024-12-08 17:09:08,69,569,21,48,326.58,575.01,0.00
2024-12-08 17:09:08,69,570,21,48,326.34,576.00,0.00
2024-12-08 17:09:08,70,570,22,48,321.68,576.01,0.00
2024-12-08 17:09:08,69,570,22,47,324.51,576.10,0.00
2024-12-08 17:09:08,68,570,22,46,328.95,576.15,0.00
2024-12-08 17:09:08,67,570,21,46,332.61,576.37,0.00
2024-12-08 17:09:08,67,571,21,46,336.35,577.00,0.00
2024-12-08 17:09:08,68,571,22,46,331.40,577.01,0.00
2024-12-08 17:09:08,67,571,22,45,336.26,577.02,0.00
2024-12-08 17:09:08,66,571,21,45,339.31,577.11,0.00
2024-12-08 17:09:08,66,572,21,45,341.70,578.00,0.00
2024-12-08 17:09:08,67,572,22,45,336.60,578.02,0.00
2024-12-08 17:09:08,66,572,22,44,340.00,578.12,0.00
2024-12-08 17:09:08,66,573,22,44,342.51,579.00,0.00
2024-12-08 17:09:08,67,573,23,44,337.39,579.02,0.00
2024-12-08 17:09:08,66,573,23,43,342.42,579.02,0.00
2024-12-08 17:09:08,66,574,23,43,342.57,580.00,0.00
2024-12-08 17:09:08,67,574,23,44,337.46,580.02,0.00
2024-12-08 17:09:08,66,574,23,43,340.38,580.11,0.00
2024-12-08 17:09:08,66,575,23,43,342.72,581.00,0.00
2024-12-08 17:09:08,67,575,23,44,337.61,581.02,0.00
2024-12-08 17:09:08,66,575,23,43,342.37,581.06,0.00
2024-12-08 17:09:08,65,575,22,43,342.59,581.66,0.00
2024-12-08 17:09:08,65,576,22,43,347.87,582.00,0.00
2024-12-08 17:09:08,66,576,23,43,342.60,582.02,0.00
2024-12-08 17:09:08,65,576,23,42,345.64,582.11,0.00
2024-12-08 17:09:08,65,577,23,42,347.93,583.00,0.00
2024-12-08 17:09:08,66,577,23,43,342.66,583.02,0.00
2024-12-08 17:09:08,65,577,22,43,345.96,583.09,0.00
2024-12-08 17:09:08,65,578,22,43,348.16,584.00,0.00
2024-12-08 17:09:08,66,578,23,43,342.89,584.02,0.00
2024-12-08 17:09:08,65,578,23,42,348.07,584.02,0.00
2024-12-08 17:09:08,64,578,23,41,351.33,584.09,0.00
2024-12-08 17:09:08,63,578,22,41,356.46,584.13,0.00
2024-12-08 17:09:08,63,579,22,41,361.04,585.00,0.00
2024-12-08 17:09:08,64,579,23,41,355.40,585.02,0.00
2024-12-08 17:09:08,64,580,23,41,355.65,586.00,0.00
2024-12-08 17:09:08,65,580,24,41,350.18,586.02,0.00
2024-12-08 17:09:08,65,581,24,41,350.41,587.00,0.00
2024-12-08 17:09:08,66,581,24,42,345.11,587.02,0.00
2024-12-08 17:09:08,65,581,24,41,348.35,587.09,0.00
2024-12-08 17:09:08,65,582,24,41,350.83,588.00,0.00
2024-12-08 17:09:08,66,582,25,41,345.52,588.02,0.00
2024-12-08 17:09:08,65,582,25,40,348.76,588.09,0.00
2024-12-08 17:09:08,65,583,25,40,351.25,589.00,0.00
2024-12-08 17:09:08,66,583,25,41,345.92,589.02,0.00
2024-12-08 17:09:08,65,583,25,40,351.16,589.02,0.00
2024-12-08 17:09:08,64,583,24,40,351.15,589.34,0.00
2024-12-08 17:09:09,64,584,24,40,356.97,590.00,0.00
2024-12-08 17:09:09,65,584,25,40,351.48,590.02,0.00
2024-12-08 17:09:09,64,584,25,39,356.88,590.02,0.00
2024-12-08 17:09:09,63,584,25,38,360.58,590.06,0.00
2024-12-08 17:09:09,62,584,24,38,365.75,590.11,0.00
2024-12-08 17:09:09,62,585,24,38,370.56,591.00,0.00
2024-12-08 17:09:09,63,585,24,39,364.67,591.02,0.00
2024-12-08 17:09:09,63,586,24,39,365.01,592.00,0.00
2024-12-08 17:09:09,64,586,24,40,359.30,592.02,0.00
2024-12-08 17:09:09,63,586,23,40,364.91,592.02,0.00
2024-12-08 17:09:09,62,586,23,39,368.99,592.05,0.00
2024-12-08 17:09:09,61,586,22,39,371.38,592.33,0.00
2024-12-08 17:09:09,61,587,22,39,377.61,593.00,0.00
2024-12-08 17:09:09,62,587,23,39,371.52,593.02,0.00
2024-12-08 17:09:09,62,588,23,39,371.89,594.00,0.00
2024-12-08 17:09:09,63,588,24,39,365.99,594.02,0.00
2024-12-08 17:09:09,62,588,24,38,370.08,594.05,0.00
2024-12-08 17:09:09,62,589,24,38,372.47,595.00,0.00
2024-12-08 17:09:09,63,589,24,39,366.56,595.02,0.00
2024-12-08 17:09:09,63,590,24,39,366.71,596.00,0.00
2024-12-08 17:09:09,64,590,25,39,360.98,596.02,0.00
2024-12-08 17:09:09,63,590,24,39,366.71,596.02,0.00
2024-12-08 17:09:09,62,590,24,38,370.62,596.05,0.00
2024-12-08 17:09:09,62,591,24,38,372.91,597.00,0.00
2024-12-08 17:09:09,63,591,24,39,366.99,597.02,0.00
2024-12-08 17:09:09,63,592,24,39,366.94,598.00,0.00
2024-12-08 17:09:09,64,592,24,40,361.21,598.02,0.00
2024-12-08 17:09:09,63,592,24,39,364.96,598.05,0.00
2024-12-08 17:09:09,62,592,23,39,370.85,598.05,0.00
2024-12-08 17:09:09,62,593,23,39,372.68,599.00,0.00
2024-12-08 17:09:09,63,593,24,39,366.76,599.02,0.00
2024-12-08 17:09:09,63,594,24,39,366.21,600.00,0.00
2024-12-08 17:09:09,64,594,25,39,360.48,600.02,0.00
2024-12-08 17:09:09,63,594,25,38,364.03,600.06,0.00
2024-12-08 17:09:09,63,595,25,38,365.56,601.00,0.00
2024-12-08 17:09:09,64,595,25,39,359.84,601.02,0.00
2024-12-08 17:09:09,65,594,25,40,348.01,601.46,0.00
2024-12-08 17:09:09,65,595,25,40,356.63,602.00,0.00
2024-12-08 17:09:09,66,595,25,41,351.23,602.02,0.00
2024-12-08 17:09:09,65,595,25,40,352.57,602.08,0.00
2024-12-08 17:09:09,65,596,25,40,365.10,603.00,0.00
2024-12-08 17:09:09,66,596,26,40,359.57,603.02,0.00
2024-12-08 17:09:09,66,597,26,40,358.73,604.00,0.00
2024-12-08 17:09:09,67,597,26,41,353.37,604.02,0.00
2024-12-08 17:09:09,66,597,26,40,356.63,604.08,0.00
2024-12-08 17:09:09,66,598,26,40,357.94,605.00,0.00
2024-12-08 17:09:09,67,598,26,41,352.59,605.02,0.00
2024-12-08 17:09:09,67,599,26,41,351.53,606.00,0.00
2024-12-08 17:09:09,68,599,27,41,346.36,606.01,0.00
2024-12-08 17:09:09,67,599,27,40,350.16,606.10,0.00
2024-12-08 17:09:09,67,600,27,40,351.45,607.00,0.00
2024-12-08 17:09:09,68,600,28,40,346.28,607.01,0.00
2024-12-08 17:09:10,68,601,28,40,344.83,608.00,0.00
2024-12-08 17:09:10,69,601,28,41,339.83,608.01,0.00
2024-12-08 17:09:10,68,601,28,40,342.36,608.10,0.00
2024-12-08 17:09:10,68,602,28,40,343.24,609.00,0.00
2024-12-08 17:09:10,69,602,29,40,338.27,609.01,0.00
2024-12-08 17:09:10,68,602,28,40,338.03,609.53,0.00
2024-12-08 17:09:10,68,603,28,40,341.48,610.00,0.00
2024-12-08 17:09:10,69,603,28,41,336.53,610.01,0.00
2024-12-08 17:09:10,68,603,28,40,339.09,610.10,0.00
2024-12-08 17:09:10,69,602,29,40,332.79,610.38,0.00
2024-12-08 17:09:10,69,603,29,40,338.64,611.00,0.00
2024-12-08 17:09:10,70,603,29,41,333.80,611.01,0.00
2024-12-08 17:09:10,69,603,28,41,336.32,611.10,0.00
2024-12-08 17:09:10,69,604,28,41,345.93,612.00,0.00
2024-12-08 17:09:10,70,604,28,42,340.99,612.01,0.00
2024-12-08 17:09:10,69,604,27,42,345.58,612.06,0.00
2024-12-08 17:09:10,68,604,27,41,348.69,612.09,0.00
2024-12-08 17:09:10,68,605,27,41,349.58,613.00,0.00
2024-12-08 17:09:10,69,605,27,42,344.51,613.01,0.00
2024-12-08 17:09:10,68,605,26,42,347.78,613.03,0.00
2024-12-08 17:09:10,67,605,25,42,352.77,613.06,0.00
2024-12-08 17:09:10,66,605,25,41,352.00,613.74,0.00
2024-12-08 17:09:10,66,606,25,41,359.79,614.00,0.00
2024-12-08 17:09:10,67,606,26,41,354.42,614.02,0.00
2024-12-08 17:09:10,66,606,26,40,357.66,614.06,0.00
2024-12-08 17:09:10,66,607,26,40,359.89,615.00,0.00
2024-12-08 17:09:10,67,607,26,41,354.52,615.02,0.00
2024-12-08 17:09:10,66,607,25,41,355.68,615.23,0.00
2024-12-08 17:09:10,66,608,25,41,360.76,616.00,0.00
2024-12-08 17:09:10,67,608,26,41,355.37,616.02,0.00
2024-12-08 17:09:10,66,608,26,40,358.71,616.06,0.00
2024-12-08 17:09:10,66,609,26,40,360.87,617.00,0.00
2024-12-08 17:09:10,67,609,27,40,355.49,617.02,0.00
2024-12-08 17:09:10,67,610,27,40,355.29,618.00,0.00
2024-12-08 17:09:10,68,610,27,41,350.07,618.01,0.00
2024-12-08 17:09:10,68,611,27,41,349.64,619.00,0.00
2024-12-08 17:09:10,69,611,27,42,344.57,619.01,0.00
2024-12-08 17:09:10,68,611,26,42,349.55,619.03,0.00
2024-12-08 17:09:10,67,611,26,41,353.10,619.04,0.00
2024-12-08 17:09:10,67,612,26,41,354.73,620.00,0.00
2024-12-08 17:09:10,68,612,26,42,349.51,620.01,0.00
2024-12-08 17:09:10,67,612,25,42,350.62,620.37,0.00
2024-12-08 17:09:10,67,613,25,42,354.42,621.00,0.00
2024-12-08 17:09:10,68,613,26,42,349.21,621.01,0.00
2024-12-08 17:09:10,67,613,26,41,354.33,621.02,0.00
2024-12-08 17:09:10,66,613,26,40,358.10,621.03,0.00
2024-12-08 17:09:10,66,614,26,40,360.08,622.00,0.00
2024-12-08 17:09:10,67,614,27,40,354.71,622.02,0.00
2024-12-08 17:09:10,66,614,27,39,358.48,622.03,0.00
2024-12-08 17:09:10,66,615,27,39,360.53,623.00,0.00
2024-12-08 17:09:10,67,615,28,39,355.15,623.02,0.00
2024-12-08 17:09:10,66,615,27,39,356.53,623.38,0.00
2024-12-08 17:09:11,66,616,27,39,360.64,624.00,0.00
2024-12-08 17:09:11,67,616,27,40,355.26,624.02,0.00
2024-12-08 17:09:11,67,617,27,40,355.25,625.00,0.00
2024-12-08 17:09:11,68,617,28,40,350.03,625.01,0.00
2024-12-08 17:09:11,67,617,28,39,353.86,625.03,0.00
2024-12-08 17:09:11,67,618,28,39,355.72,626.00,0.00
2024-12-08 17:09:11,68,618,28,40,350.49,626.01,0.00
2024-12-08 17:09:11,67,618,28,39,354.32,626.03,0.00
2024-12-08 17:09:11,66,618,27,39,359.33,626.09,0.00
2024-12-08 17:09:11,65,618,26,39,363.25,626.37,0.00
2024-12-08 17:09:11,65,619,26,39,367.26,627.00,0.00
2024-12-08 17:09:11,66,619,27,39,361.70,627.02,0.00
2024-12-08 17:09:11,65,619,27,38,364.52,627.15,0.00
2024-12-08 17:09:11,65,620,27,38,367.26,628.00,0.00
2024-12-08 17:09:11,66,620,27,39,361.69,628.02,0.00
2024-12-08 17:09:11,65,620,27,38,365.91,628.03,0.00
2024-12-08 17:09:11,65,621,27,38,367.92,629.00,0.00
2024-12-08 17:09:11,66,621,27,39,362.35,629.02,0.00
2024-12-08 17:09:11,66,622,27,39,362.27,630.00,0.00
2024-12-08 17:09:11,67,622,27,40,356.86,630.02,0.00
2024-12-08 17:09:11,66,622,27,39,360.93,630.03,0.00
2024-12-08 17:09:11,66,623,27,39,362.88,631.00,0.00
2024-12-08 17:09:11,67,623,28,39,357.46,631.02,0.00
2024-12-08 17:09:11,66,623,27,39,356.90,631.38,0.00
2024-12-08 17:09:11,66,624,27,39,362.84,632.00,0.00
2024-12-08 17:09:11,67,624,27,40,357.42,632.02,0.00
2024-12-08 17:09:11,67,625,27,40,357.31,633.00,0.00
2024-12-08 17:09:11,68,625,28,40,352.06,633.01,0.00
2024-12-08 17:09:11,67,625,28,39,355.24,633.04,0.00
2024-12-08 17:09:11,66,625,27,39,359.99,633.15,0.00
2024-12-08 17:09:11,66,626,27,39,362.73,634.00,0.00
2024-12-08 17:09:11,67,626,27,40,357.32,634.02,0.00
2024-12-08 17:09:11,66,626,27,39,361.20,634.05,0.00
2024-12-08 17:09:11,66,627,27,39,363.32,635.00,0.00
2024-12-08 17:09:11,67,627,28,39,357.90,635.02,0.00
2024-12-08 17:09:11,67,628,28,39,357.73,636.00,0.00
2024-12-08 17:09:11,68,628,29,39,352.47,636.01,0.00
2024-12-08 17:09:11,68,629,29,39,352.15,637.00,0.00
2024-12-08 17:09:11,69,629,29,40,347.05,637.01,0.00
2024-12-08 17:09:11,69,630,29,40,346.62,638.00,0.00
2024-12-08 17:09:11,70,630,30,40,341.67,638.01,0.00
2024-12-08 17:09:11,70,631,30,40,341.13,639.00,0.00
2024-12-08 17:09:11,71,631,31,40,336.33,639.01,0.00
2024-12-08 17:09:11,71,632,31,40,335.68,640.00,0.00
2024-12-08 17:09:11,72,632,31,41,331.02,640.01,0.00
2024-12-08 17:09:11,71,632,31,40,335.23,640.03,0.00
2024-12-08 17:09:11,70,632,30,40,337.48,640.40,0.00
2024-12-08 17:09:11,70,633,30,40,341.37,641.00,0.00
2024-12-08 17:09:11,71,633,31,40,336.56,641.01,0.00
2024-12-08 17:09:11,70,633,31,39,340.27,641.04,0.00
2024-12-08 17:09:11,70,634,31,39,341.69,642.00,0.00
2024-12-08 17:09:11,71,634,31,40,336.88,642.01,0.00
2024-12-08 17:09:11,70,634,31,39,340.69,642.04,0.00
2024-12-08 17:09:12,70,635,31,39,342.14,643.00,0.00
2024-12-08 17:09:12,71,635,31,40,337.32,643.01,0.00
2024-12-08 17:09:12,70,635,31,39,342.05,643.01,0.00
2024-12-08 17:09:12,69,635,31,38,341.20,643.35,0.00
2024-12-08 17:09:12,69,636,31,38,346.77,644.00,0.00
2024-12-08 17:09:12,70,636,31,39,341.82,644.01,0.00
2024-12-08 17:09:12,69,636,31,38,345.93,644.03,0.00
2024-12-08 17:09:12,68,636,30,38,350.02,644.18,0.00
2024-12-08 17:09:12,68,637,30,38,352.80,645.00,0.00
2024-12-08 17:09:12,69,637,31,38,347.68,645.01,0.00
2024-12-08 17:09:12,68,637,30,38,347.95,645.31,0.00
2024-12-08 17:09:12,68,638,30,38,353.44,646.00,0.00
2024-12-08 17:09:12,69,638,31,38,348.31,646.01,0.00
2024-12-08 17:09:12,68,638,31,37,352.68,646.03,0.00
2024-12-08 17:09:12,68,639,31,37,354.56,647.00,0.00
2024-12-08 17:09:12,69,639,31,38,349.42,647.01,0.00
2024-12-08 17:09:12,68,639,30,38,348.40,647.40,0.00
2024-12-08 17:09:12,68,640,30,38,354.44,648.00,0.00
2024-12-08 17:09:12,69,640,30,39,349.30,648.01,0.00
2024-12-08 17:09:12,68,640,30,38,353.87,648.03,0.00
2024-12-08 17:09:12,67,640,29,38,358.12,648.18,0.00
2024-12-08 17:09:12,66,640,28,38,361.06,648.33,0.00
2024-12-08 17:09:12,66,641,28,38,367.02,649.00,0.00
2024-12-08 17:09:12,67,641,28,39,361.54,649.02,0.00
2024-12-08 17:09:12,66,641,28,38,364.89,649.03,0.00
2024-12-08 17:09:12,66,642,28,38,367.00,650.00,0.00
2024-12-08 17:09:12,67,642,28,39,361.52,650.02,0.00
2024-12-08 17:09:12,67,643,28,39,361.46,651.00,0.00
2024-12-08 17:09:12,68,643,29,39,356.15,651.01,0.00
2024-12-08 17:09:12,67,643,29,38,360.78,651.04,0.00
2024-12-08 17:09:12,67,644,29,38,362.89,652.00,0.00
2024-12-08 17:09:12,68,644,29,39,357.55,652.01,0.00
2024-12-08 17:09:12,67,644,28,39,361.82,652.06,0.00
2024-12-08 17:09:12,67,645,28,39,364.03,653.00,0.00
2024-12-08 17:09:12,68,645,29,39,358.67,653.01,0.00
2024-12-08 17:09:12,67,645,29,38,362.96,653.06,0.00
2024-12-08 17:09:12,67,646,29,38,365.16,654.00,0.00
2024-12-08 17:09:12,68,646,29,39,359.79,654.01,0.00
2024-12-08 17:09:12,67,646,28,39,361.46,654.09,0.00
2024-12-08 17:09:12,66,646,27,39,366.56,654.15,0.00
2024-12-08 17:09:12,67,645,27,40,357.35,654.79,0.00
2024-12-08 17:09:12,67,646,27,40,369.26,655.00,0.00
2024-12-08 17:09:12,68,646,28,40,363.83,655.01,0.00
2024-12-08 17:09:12,67,646,27,40,369.16,655.03,0.00
2024-12-08 17:09:12,66,646,27,39,373.97,655.05,0.00
2024-12-08 17:09:12,65,646,26,39,377.60,655.37,0.00
2024-12-08 17:09:12,65,647,26,39,392.07,656.00,0.00
2024-12-08 17:09:12,66,647,26,40,386.13,656.02,0.00
2024-12-08 17:09:12,66,648,26,40,386.06,657.00,0.00
2024-12-08 17:09:12,67,648,27,40,380.30,657.02,0.00
2024-12-08 17:09:12,67,649,27,40,380.16,658.00,0.00
2024-12-08 17:09:12,68,649,28,40,374.57,658.01,0.00
2024-12-08 17:09:12,67,649,28,39,378.89,658.06,0.00
2024-12-08 17:09:12,67,650,28,39,381.09,659.00,0.00
2024-12-08 17:09:12,68,650,28,40,375.49,659.01,0.00
2024-12-08 17:09:12,67,650,28,39,380.41,659.04,0.00
2024-12-08 17:09:12,67,651,28,39,382.54,660.00,0.00
2024-12-08 17:09:12,68,651,28,40,376.92,660.01,0.00
2024-12-08 17:09:12,68,652,28,40,376.81,661.00,0.00
2024-12-08 17:09:12,69,652,29,40,371.35,661.01,0.00
2024-12-08 17:09:12,68,652,28,40,376.71,661.01,0.00
2024-12-08 17:09:12,67,652,28,39,381.35,661.03,0.00
2024-12-08 17:09:12,66,652,27,39,385.53,661.06,0.00
2024-12-08 17:09:13,66,653,27,39,389.80,662.00,0.00
2024-12-08 17:09:13,67,653,27,40,383.98,662.02,0.00
2024-12-08 17:09:13,67,654,27,40,383.69,663.00,0.00
2024-12-08 17:09:13,68,654,27,41,378.04,663.01,0.00
2024-12-08 17:09:13,67,654,27,40,382.70,663.03,0.00
2024-12-08 17:09:13,67,655,27,40,384.36,664.00,0.00
2024-12-08 17:09:13,68,655,28,40,378.71,664.01,0.00
2024-12-08 17:09:13,67,655,27,40,378.22,664.36,0.00
2024-12-08 17:09:13,67,656,27,40,384.09,665.00,0.00
2024-12-08 17:09:13,68,656,27,41,378.44,665.01,0.00
2024-12-08 17:09:13,68,657,27,41,377.89,666.00,0.00
2024-12-08 17:09:13,69,657,28,41,372.41,666.01,0.00
2024-12-08 17:09:13,68,657,28,40,377.11,666.03,0.00
2024-12-08 17:09:13,68,658,28,40,378.65,667.00,0.00
2024-12-08 17:09:13,69,658,28,41,373.16,667.01,0.00
2024-12-08 17:09:13,68,658,28,40,377.84,667.03,0.00
2024-12-08 17:09:13,68,659,28,40,379.51,668.00,0.00
2024-12-08 17:09:13,69,659,29,40,374.01,668.01,0.00
2024-12-08 17:09:13,69,660,29,40,373.69,669.00,0.00
2024-12-08 17:09:13,70,660,30,40,368.35,669.01,0.00
2024-12-08 17:09:13,69,660,30,39,372.24,669.04,0.00
2024-12-08 17:09:13,69,661,30,39,374.05,670.00,0.00
2024-12-08 17:09:13,70,661,31,39,368.71,670.01,0.00
2024-12-08 17:09:13,69,661,30,39,371.00,670.16,0.00
2024-12-08 17:09:13,69,662,30,39,373.65,671.00,0.00
2024-12-08 17:09:13,70,662,31,39,368.32,671.01,0.00
2024-12-08 17:09:13,70,663,31,39,367.94,672.00,0.00
2024-12-08 17:09:13,71,663,31,40,362.76,672.01,0.00
2024-12-08 17:09:13,70,663,31,39,366.80,672.04,0.00
2024-12-08 17:09:13,70,664,31,39,368.55,673.00,0.00
2024-12-08 17:09:13,71,664,31,40,363.36,673.01,0.00
2024-12-08 17:09:13,70,664,31,39,367.40,673.04,0.00
2024-12-08 17:09:13,69,664,31,38,372.56,673.06,0.00
2024-12-08 17:09:13,70,663,32,38,365.32,673.39,0.00
2024-12-08 17:09:13,70,664,32,38,373.36,674.00,0.00
2024-12-08 17:09:13,71,664,33,38,368.10,674.01,0.00
2024-12-08 17:09:13,71,665,33,38,377.20,675.00,0.00
2024-12-08 17:09:13,72,665,34,38,371.96,675.01,0.00
2024-12-08 17:09:13,71,665,34,37,376.06,675.04,0.00
2024-12-08 17:09:13,71,666,34,37,377.76,676.00,0.00
2024-12-08 17:09:13,72,666,34,38,372.51,676.01,0.00
2024-12-08 17:09:13,71,666,33,38,377.66,676.01,0.00
2024-12-08 17:09:13,71,667,33,38,377.27,677.00,0.00
2024-12-08 17:09:13,72,667,34,38,372.03,677.01,0.00
2024-12-08 17:09:13,71,667,33,38,376.13,677.03,0.00
2024-12-08 17:09:13,70,667,33,37,380.34,677.03,0.00
2024-12-08 17:09:13,70,668,33,37,384.00,678.00,0.00
2024-12-08 17:09:13,71,668,34,37,378.59,678.01,0.00
2024-12-08 17:09:13,70,668,33,37,382.81,678.03,0.00
2024-12-08 17:09:13,69,668,32,37,385.83,678.12,0.00
2024-12-08 17:09:14,69,669,32,37,390.21,679.00,0.00
2024-12-08 17:09:14,70,669,33,37,384.64,679.01,0.00
2024-12-08 17:09:14,69,669,33,36,389.87,679.03,0.00
2024-12-08 17:09:14,68,669,32,36,393.34,679.38,0.00
2024-12-08 17:09:14,68,670,32,36,397.58,680.00,0.00
2024-12-08 17:09:14,69,670,32,37,391.82,680.01,0.00
2024-12-08 17:09:14,70,669,33,37,379.17,680.86,0.00
2024-12-08 17:09:14,70,670,33,37,388.93,681.00,0.00
2024-12-08 17:09:14,71,670,33,38,383.45,681.01,0.00
2024-12-08 17:09:14,70,670,33,37,387.77,681.03,0.00
2024-12-08 17:09:14,70,671,33,37,399.24,682.00,0.00
2024-12-08 17:09:14,71,671,33,38,393.62,682.01,0.00
2024-12-08 17:09:14,70,671,32,38,396.45,682.13,0.00
2024-12-08 17:09:14,70,672,32,38,398.85,683.00,0.00
2024-12-08 17:09:14,71,672,33,38,393.24,683.01,0.00
2024-12-08 17:09:14,70,672,33,37,397.78,683.03,0.00
2024-12-08 17:09:14,70,673,33,37,399.54,684.00,0.00
2024-12-08 17:09:14,71,673,34,37,393.91,684.01,0.00
2024-12-08 17:09:14,70,673,33,37,396.93,684.11,0.00
2024-12-08 17:09:14,70,674,33,37,399.24,685.00,0.00
2024-12-08 17:09:14,71,674,34,37,393.62,685.01,0.00
2024-12-08 17:09:14,70,674,33,37,396.43,685.13,0.00
2024-12-08 17:09:14,70,675,33,37,400.79,686.00,0.00
2024-12-08 17:09:14,71,675,34,37,395.15,686.01,0.00
2024-12-08 17:09:14,70,675,34,36,399.91,686.03,0.00
2024-12-08 17:09:14,70,676,34,36,401.64,687.00,0.00
2024-12-08 17:09:14,71,676,34,37,395.99,687.01,0.00
2024-12-08 17:09:14,70,676,34,36,400.66,687.03,0.00
2024-12-08 17:09:14,69,676,33,36,404.23,687.38,0.00
2024-12-08 17:09:14,69,677,33,36,408.35,688.00,0.00
2024-12-08 17:09:14,70,677,33,37,402.52,688.01,0.00
2024-12-08 17:09:14,70,678,33,37,402.22,689.00,0.00
2024-12-08 17:09:14,71,678,34,37,396.55,689.01,0.00
2024-12-08 17:09:14,70,678,34,36,401.04,689.04,0.00
2024-12-08 17:09:14,70,679,34,36,402.90,690.00,0.00
2024-12-08 17:09:14,71,679,34,37,397.23,690.01,0.00
2024-12-08 17:09:14,70,679,33,37,398.58,690.10,0.00
2024-12-08 17:09:14,70,680,33,37,402.79,691.00,0.00
2024-12-08 17:09:14,71,680,33,38,397.12,691.01,0.00
2024-12-08 17:09:14,71,681,33,38,396.67,692.00,0.00
2024-12-08 17:09:14,72,681,33,39,391.16,692.01,0.00
2024-12-08 17:09:14,71,681,33,38,395.70,692.04,0.00
2024-12-08 17:09:14,71,682,33,38,397.34,693.00,0.00
2024-12-08 17:09:14,72,682,34,38,391.83,693.01,0.00
2024-12-08 17:09:14,71,682,34,37,396.37,693.04,0.00
2024-12-08 17:09:14,71,683,34,37,397.96,694.00,0.00
2024-12-08 17:09:14,72,683,35,37,392.43,694.01,0.00
2024-12-08 17:09:14,72,684,35,37,391.80,695.00,0.00
2024-12-08 17:09:14,73,684,36,37,386.43,695.01,0.00
2024-12-08 17:09:14,73,685,36,37,385.73,696.00,0.00
2024-12-08 17:09:14,74,685,36,38,380.52,696.01,0.00
2024-12-08 17:09:14,73,685,36,37,384.68,696.04,0.00
2024-12-08 17:09:15,73,686,36,37,386.09,697.00,0.00
2024-12-08 17:09:15,74,686,36,38,380.87,697.01,0.00
2024-12-08 17:09:15,74,687,36,38,380.13,698.00,0.00
2024-12-08 17:09:15,75,687,37,38,375.06,698.01,0.00
2024-12-08 17:09:15,74,687,37,37,379.09,698.04,0.00
2024-12-08 17:09:15,74,688,37,37,380.30,699.00,0.00
2024-12-08 17:09:15,75,688,38,37,375.23,699.01,0.00
2024-12-08 17:09:15,74,688,38,36,379.17,699.04,0.00
2024-12-08 17:09:15,73,688,37,36,379.93,699.41,0.00
2024-12-08 17:09:15,73,689,37,36,385.69,700.00,0.00
2024-12-08 17:09:15,74,689,38,36,380.48,700.01,0.00
2024-12-08 17:09:15,73,689,37,36,385.59,700.01,0.00
2024-12-08 17:09:15,73,690,37,36,384.70,701.00,0.00
2024-12-08 17:09:15,74,690,37,37,379.50,701.01,0.00
2024-12-08 17:09:15,73,690,37,36,383.74,701.03,0.00
2024-12-08 17:09:15,73,691,37,36,384.87,702.00,0.00
2024-12-08 17:09:15,74,691,37,37,379.67,702.01,0.00
2024-12-08 17:09:15,74,692,37,37,378.75,703.00,0.00
2024-12-08 17:09:15,75,692,37,38,373.70,703.01,0.00
2024-12-08 17:09:15,75,693,37,38,372.78,704.00,0.00
2024-12-08 17:09:15,76,693,37,39,367.88,704.01,0.00
2024-12-08 17:09:15,75,693,36,39,365.83,704.53,0.00
2024-12-08 17:09:15,75,694,36,39,372.27,705.00,0.00
2024-12-08 17:09:15,76,694,36,40,367.37,705.01,0.00
2024-12-08 17:09:15,75,694,36,39,371.33,705.03,0.00
2024-12-08 17:09:15,74,694,35,39,373.55,705.45,0.00
2024-12-08 17:09:15,74,695,35,39,377.65,706.00,0.00
2024-12-08 17:09:15,75,695,36,39,372.61,706.01,0.00
2024-12-08 17:09:15,74,695,35,39,374.45,706.20,0.00
2024-12-08 17:09:15,74,696,35,39,376.94,707.00,0.00
2024-12-08 17:09:15,75,696,35,40,371.91,707.01,0.00
2024-12-08 17:09:15,74,696,35,39,376.18,707.04,0.00
2024-12-08 17:09:15,73,696,34,39,378.61,707.32,0.00
2024-12-08 17:09:15,73,697,34,39,383.91,708.00,0.00
2024-12-08 17:09:15,74,697,35,39,378.72,708.01,0.00
2024-12-08 17:09:15,73,697,34,39,383.13,708.04,0.00
2024-12-08 17:09:15,73,698,34,39,384.64,709.00,0.00
2024-12-08 17:09:15,74,698,35,39,379.44,709.01,0.00
2024-12-08 17:09:15,74,699,35,39,378.73,710.00,0.00
2024-12-08 17:09:15,75,699,36,39,373.68,710.01,0.00
2024-12-08 17:09:15,74,699,36,38,378.06,710.04,0.00
2024-12-08 17:09:15,74,700,36,38,379.46,711.00,0.00
2024-12-08 17:09:15,75,700,37,38,374.40,711.01,0.00
2024-12-08 17:09:15,74,700,37,37,378.40,711.07,0.00
2024-12-08 17:09:15,74,701,37,37,379.99,712.00,0.00
2024-12-08 17:09:15,75,701,38,37,374.93,712.01,0.00
2024-12-08 17:09:15,74,701,37,37,379.90,712.03,0.00
2024-12-08 17:09:15,74,702,37,37,379.27,713.00,0.00
2024-12-08 17:09:15,75,702,38,37,374.22,713.01,0.00
2024-12-08 17:09:15,75,703,38,37,373.41,714.00,0.00
2024-12-08 17:09:15,76,703,38,38,368.49,714.01,0.00
2024-12-08 17:09:15,75,703,37,38,373.03,714.05,0.00
2024-12-08 17:09:15,74,703,37,37,377.39,714.05,0.00
2024-12-08 17:09:15,74,704,37,37,378.89,715.00,0.00
2024-12-08 17:09:15,75,704,38,37,373.84,715.01,0.00
2024-12-08 17:09:16,74,704,37,37,370.20,715.73,0.00
2024-12-08 17:09:16,74,705,37,37,378.16,716.00,0.00
2024-12-08 17:09:16,75,705,37,38,373.12,716.01,0.00
2024-12-08 17:09:16,74,705,36,38,378.06,716.01,0.00
2024-12-08 17:09:16,73,705,35,38,383.24,716.01,0.00
2024-12-08 17:09:16,72,705,35,37,387.67,716.04,0.00
2024-12-08 17:09:16,72,706,35,37,389.31,717.00,0.00
2024-12-08 17:09:16,73,706,36,37,383.97,717.01,0.00
2024-12-08 17:09:16,72,706,35,37,389.31,717.01,0.00
2024-12-08 17:09:16,71,706,35,36,393.98,717.03,0.00
2024-12-08 17:09:16,71,707,35,36,395.64,718.00,0.00
2024-12-08 17:09:16,72,707,35,37,390.15,718.01,0.00
2024-12-08 17:09:16,72,708,35,37,389.59,719.00,0.00
2024-12-08 17:09:16,73,708,35,38,384.26,719.01,0.00
2024-12-08 17:09:16,72,708,35,37,388.90,719.03,0.00
2024-12-08 17:09:16,71,708,34,37,391.59,719.44,0.00
2024-12-08 17:09:16,71,709,34,37,396.04,720.00,0.00
2024-12-08 17:09:16,72,709,35,37,390.54,720.01,0.00
2024-12-08 17:09:16,72,710,35,37,389.98,721.00,0.00
2024-12-08 17:09:16,73,710,36,37,384.63,721.01,0.00
2024-12-08 17:09:16,72,710,36,36,389.18,721.03,0.00
2024-12-08 17:09:16,72,711,36,36,390.71,722.00,0.00
2024-12-08 17:09:16,73,711,37,36,385.36,722.01,0.00
2024-12-08 17:09:16,72,711,36,36,386.90,722.10,0.00
2024-12-08 17:09:16,71,711,35,36,391.76,722.18,0.00
2024-12-08 17:09:16,71,712,35,36,396.54,723.00,0.00
2024-12-08 17:09:16,72,712,36,36,391.03,723.01,0.00
2024-12-08 17:09:16,71,712,36,35,395.83,723.03,0.00
2024-12-08 17:09:16,71,713,36,35,397.48,724.00,0.00
2024-12-08 17:09:16,72,713,37,35,391.96,724.01,0.00
2024-12-08 17:09:16,71,713,37,34,397.24,724.03,0.00
2024-12-08 17:09:16,70,713,36,34,399.16,724.37,0.00
2024-12-08 17:09:16,70,714,36,34,405.39,725.00,0.00
2024-12-08 17:09:16,71,714,36,35,399.68,725.01,0.00
2024-12-08 17:09:16,71,715,36,35,399.21,726.00,0.00
2024-12-08 17:09:16,72,715,37,35,393.66,726.01,0.00
2024-12-08 17:09:16,71,715,37,34,398.60,726.03,0.00
2024-12-08 17:09:16,70,715,36,34,403.67,726.03,0.00
2024-12-08 17:09:16,70,716,36,34,407.55,727.00,0.00
2024-12-08 17:09:16,71,716,37,34,401.81,727.01,0.00
2024-12-08 17:09:16,71,717,37,34,401.33,728.00,0.00
2024-12-08 17:09:16,72,717,37,35,395.76,728.01,0.00
2024-12-08 17:09:16,71,717,37,34,400.72,728.03,0.00
2024-12-08 17:09:16,71,718,37,34,402.40,729.00,0.00
2024-12-08 17:09:16,72,718,37,35,396.81,729.01,0.00
2024-12-08 17:09:16,71,718,36,35,399.16,729.18,0.00
2024-12-08 17:09:17,71,719,36,35,401.84,730.00,0.00
2024-12-08 17:09:17,72,719,37,35,396.26,730.01,0.00
2024-12-08 17:09:17,71,719,37,34,401.23,730.03,0.00
2024-12-08 17:09:17,70,719,36,34,403.97,730.44,0.00
2024-12-08 17:09:17,70,720,36,34,408.58,731.00,0.00
2024-12-08 17:09:17,71,720,36,35,402.83,731.01,0.00
2024-12-08 17:09:17,71,721,36,35,402.09,732.00,0.00
2024-12-08 17:09:17,72,721,37,35,396.50,732.01,0.00
2024-12-08 17:09:17,71,721,37,34,401.67,732.03,0.00
2024-12-08 17:09:17,70,721,36,34,404.63,732.16,0.00
2024-12-08 17:09:17,70,722,36,34,409.13,733.00,0.00
2024-12-08 17:09:17,71,722,36,35,403.37,733.01,0.00
2024-12-08 17:09:17,71,723,36,35,402.62,734.00,0.00
2024-12-08 17:09:17,72,723,36,36,397.03,734.01,0.00
2024-12-08 17:09:17,71,723,36,35,402.21,734.03,0.00
2024-12-08 17:09:17,70,723,35,35,407.43,734.03,0.00
2024-12-08 17:09:17,70,724,35,35,411.10,735.00,0.00
2024-12-08 17:09:17,71,724,35,36,405.31,735.01,0.00
2024-12-08 17:09:17,70,724,34,36,407.79,735.19,0.00
2024-12-08 17:09:17,70,725,34,36,410.60,736.00,0.00
2024-12-08 17:09:17,71,725,34,37,404.82,736.01,0.00
2024-12-08 17:09:17,70,725,34,36,410.08,736.03,0.00
2024-12-08 17:09:17,69,725,33,36,412.59,736.46,0.00
2024-12-08 17:09:17,69,726,33,36,419.70,737.00,0.00
2024-12-08 17:09:17,70,726,33,37,413.71,737.01,0.00
2024-12-08 17:09:17,70,727,33,37,413.26,738.00,0.00
2024-12-08 17:09:17,71,727,34,37,407.44,738.01,0.00
2024-12-08 17:09:17,70,727,34,36,412.84,738.03,0.00
2024-12-08 17:09:17,69,727,33,36,412.36,738.68,0.00
2024-12-08 17:09:17,69,728,33,36,420.97,739.00,0.00
2024-12-08 17:09:17,70,728,33,37,414.96,739.01,0.00
2024-12-08 17:09:17,70,729,33,37,414.57,740.00,0.00
2024-12-08 17:09:17,71,729,33,38,408.73,740.01,0.00
2024-12-08 17:09:17,70,729,33,37,414.15,740.03,0.00
2024-12-08 17:09:17,69,729,32,37,419.19,740.06,0.00
2024-12-08 17:09:17,69,730,32,37,423.51,741.00,0.00
2024-12-08 17:09:17,70,730,33,37,417.46,741.01,0.00
2024-12-08 17:09:17,69,730,32,37,423.40,741.01,0.00
2024-12-08 17:09:17,69,731,32,37,423.11,742.00,0.00
2024-12-08 17:09:17,70,731,33,37,417.07,742.01,0.00
2024-12-08 17:09:17,70,732,33,37,416.67,743.00,0.00
2024-12-08 17:09:17,71,732,34,37,410.80,743.01,0.00
2024-12-08 17:09:17,70,732,34,36,416.57,743.01,0.00
2024-12-08 17:09:17,70,733,34,36,418.30,744.00,0.00
2024-12-08 17:09:17,71,733,34,37,412.41,744.01,0.00
2024-12-08 17:09:17,70,733,34,36,418.08,744.01,0.00
2024-12-08 17:09:17,70,734,34,36,419.82,745.00,0.00
2024-12-08 17:09:17,71,734,35,36,413.90,745.01,0.00
2024-12-08 17:09:17,70,734,34,36,411.06,745.69,0.00
2024-12-08 17:09:17,70,735,34,36,419.63,746.00,0.00
2024-12-08 17:09:17,71,735,34,37,413.72,746.01,0.00
2024-12-08 17:09:17,70,735,34,36,419.42,746.01,0.00
2024-12-08 17:09:17,69,735,33,36,424.14,746.20,0.00
2024-12-08 17:09:17,69,736,33,36,427.37,747.00,0.00
2024-12-08 17:09:17,70,736,33,37,421.26,747.01,0.00
2024-12-08 17:09:18,70,737,33,37,420.87,748.00,0.00
2024-12-08 17:09:18,71,737,33,38,414.94,748.01,0.00
2024-12-08 17:09:18,70,737,33,37,420.23,748.03,0.00
2024-12-08 17:09:18,69,737,32,37,424.28,748.12,0.00
2024-12-08 17:09:18,69,738,32,37,429.06,749.00,0.00
2024-12-08 17:09:18,70,738,33,37,422.93,749.01,0.00
2024-12-08 17:09:18,70,739,33,37,422.53,750.00,0.00
2024-12-08 17:09:18,71,739,34,37,416.58,750.01,0.00
2024-12-08 17:09:18,70,739,34,36,421.99,750.03,0.00
2024-12-08 17:09:18,70,740,34,36,423.84,751.00,0.00
2024-12-08 17:09:18,71,740,35,36,417.87,751.01,0.00
2024-12-08 17:09:18,71,741,35,36,417.37,752.00,0.00
2024-12-08 17:09:18,72,741,35,37,411.57,752.01,0.00
2024-12-08 17:09:18,71,741,34,37,417.37,752.01,0.00
2024-12-08 17:09:18,70,741,34,36,422.58,752.04,0.00
2024-12-08 17:09:18,70,742,34,36,424.54,753.00,0.00
2024-12-08 17:09:18,71,742,35,36,418.56,753.01,0.00
2024-12-08 17:09:18,70,742,35,35,422.05,753.06,0.00
2024-12-08 17:09:18,70,743,35,35,424.12,754.00,0.00
2024-12-08 17:09:18,71,743,35,36,418.14,754.01,0.00
2024-12-08 17:09:18,71,744,35,36,417.63,755.00,0.00
2024-12-08 17:09:18,72,744,36,36,411.83,755.01,0.00
2024-12-08 17:09:18,71,744,35,36,417.42,755.03,0.00
2024-12-08 17:09:18,70,744,35,35,422.52,755.04,0.00
2024-12-08 17:09:18,69,744,34,35,428.46,755.06,0.00
2024-12-08 17:09:18,69,745,34,35,430.67,756.00,0.00
2024-12-08 17:09:18,70,745,35,35,424.51,756.01,0.00
2024-12-08 17:09:18,70,746,35,35,424.10,757.00,0.00
2024-12-08 17:09:18,71,746,35,36,418.13,757.01,0.00
2024-12-08 17:09:18,70,746,34,36,423.89,757.03,0.00
2024-12-08 17:09:18,69,746,34,35,429.37,757.03,0.00
2024-12-08 17:09:18,69,747,34,35,431.37,758.00,0.00
2024-12-08 17:09:18,70,747,34,36,425.20,758.01,0.00
2024-12-08 17:09:18,70,748,34,36,424.78,759.00,0.00
2024-12-08 17:09:18,71,748,35,36,418.80,759.01,0.00
2024-12-08 17:09:18,70,748,35,35,423.48,759.06,0.00
2024-12-08 17:09:18,70,749,35,35,425.55,760.00,0.00
2024-12-08 17:09:18,71,749,35,36,419.56,760.01,0.00
2024-12-08 17:09:18,71,750,35,36,419.04,761.00,0.00
2024-12-08 17:09:18,72,750,36,36,413.22,761.01,0.00
2024-12-08 17:09:18,71,750,36,35,417.86,761.06,0.00
2024-12-08 17:09:18,70,750,35,35,421.04,761.16,0.00
2024-12-08 17:09:18,69,750,34,35,427.14,761.16,0.00
2024-12-08 17:09:18,69,751,34,35,432.31,762.00,0.00
2024-12-08 17:09:18,70,751,35,35,426.13,762.01,0.00
2024-12-08 17:09:18,70,752,35,35,425.71,763.00,0.00
2024-12-08 17:09:18,71,752,36,35,419.71,763.01,0.00
2024-12-08 17:09:18,71,753,36,35,419.19,764.00,0.00
2024-12-08 17:09:18,72,753,36,36,413.36,764.01,0.00
2024-12-08 17:09:18,71,753,36,35,418.11,764.06,0.00
2024-12-08 17:09:19,71,754,36,35,420.06,765.00,0.00
2024-12-08 17:09:19,72,754,36,36,414.22,765.01,0.00
2024-12-08 17:09:19,71,754,35,36,419.95,765.03,0.00
2024-12-08 17:09:19,70,754,35,35,425.08,765.04,0.00
2024-12-08 17:09:19,70,755,35,35,427.04,766.00,0.00
2024-12-08 17:09:19,71,755,35,36,421.03,766.01,0.00
2024-12-08 17:09:19,70,755,34,36,426.82,766.03,0.00
2024-12-08 17:09:19,69,755,33,36,429.61,766.17,0.00
2024-12-08 17:09:19,69,756,33,36,432.61,767.00,0.00
2024-12-08 17:09:19,70,756,34,36,426.43,767.01,0.00
2024-12-08 17:09:19,69,756,34,35,431.83,767.03,0.00
2024-12-08 17:09:19,70,755,35,35,422.31,767.21,0.00
2024-12-08 17:09:19,70,756,35,35,433.83,768.00,0.00
2024-12-08 17:09:19,71,756,35,36,427.72,768.01,0.00
2024-12-08 17:09:19,71,757,35,36,437.69,769.00,0.00
2024-12-08 17:09:19,72,757,36,36,431.61,769.01,0.00
2024-12-08 17:09:19,71,757,36,35,436.50,769.06,0.00
2024-12-08 17:09:19,71,758,36,35,438.11,770.00,0.00
2024-12-08 17:09:19,72,758,36,36,432.02,770.01,0.00
2024-12-08 17:09:19,71,758,35,36,431.11,770.35,0.00
2024-12-08 17:09:19,71,759,35,36,437.26,771.00,0.00
2024-12-08 17:09:19,72,759,36,36,431.19,771.01,0.00
2024-12-08 17:09:19,71,759,36,35,436.18,771.06,0.00
2024-12-08 17:09:19,70,759,35,35,441.14,771.20,0.00
2024-12-08 17:09:19,70,760,35,35,446.37,772.00,0.00
2024-12-08 17:09:19,71,760,35,36,440.09,772.01,0.00
2024-12-08 17:09:19,70,760,34,36,446.15,772.01,0.00
2024-12-08 17:09:19,70,761,34,36,447.88,773.00,0.00
2024-12-08 17:09:19,71,761,35,36,441.58,773.01,0.00
2024-12-08 17:09:19,70,761,34,36,447.77,773.01,0.00
2024-12-08 17:09:19,69,761,33,36,449.04,773.14,0.00
2024-12-08 17:09:19,69,762,33,36,454.18,774.00,0.00
2024-12-08 17:09:19,70,762,33,37,447.69,774.01,0.00
2024-12-08 17:09:19,69,762,32,37,449.49,774.12,0.00
2024-12-08 17:09:19,69,763,32,37,454.43,775.00,0.00
2024-12-08 17:09:19,70,763,32,38,447.94,775.01,0.00
2024-12-08 17:09:19,69,763,32,37,453.53,775.03,0.00
2024-12-08 17:09:19,69,764,32,37,455.58,776.00,0.00
2024-12-08 17:09:19,70,764,33,37,449.07,776.01,0.00
2024-12-08 17:09:19,69,764,33,36,454.68,776.03,0.00
2024-12-08 17:09:19,69,765,33,36,456.73,777.00,0.00
2024-12-08 17:09:19,70,765,33,37,450.20,777.01,0.00
2024-12-08 17:09:19,70,766,33,37,449.78,778.00,0.00
2024-12-08 17:09:19,71,766,34,37,443.45,778.01,0.00
2024-12-08 17:09:19,70,766,34,36,449.01,778.03,0.00
2024-12-08 17:09:19,69,766,33,36,454.65,778.14,0.00
2024-12-08 17:09:19,69,767,33,36,457.56,779.00,0.00
2024-12-08 17:09:19,70,767,33,37,451.03,779.01,0.00
2024-12-08 17:09:19,70,768,33,37,450.60,780.00,0.00
2024-12-08 17:09:19,71,768,33,38,444.26,780.01,0.00
2024-12-08 17:09:19,71,769,33,38,443.73,781.00,0.00
2024-12-08 17:09:19,72,769,33,39,437.56,781.01,0.00
2024-12-08 17:09:19,73,768,34,39,431.46,781.05,0.00
2024-12-08 17:09:19,73,769,34,39,441.66,782.00,0.00
2024-12-08 17:09:19,74,769,34,40,435.69,782.01,0.00
2024-12-08 17:09:20,74,770,34,40,445.44,783.00,0.00
2024-12-08 17:09:20,75,770,34,41,439.50,783.01,0.00
2024-12-08 17:09:20,74,770,33,41,440.00,783.45,0.00
2024-12-08 17:09:20,74,771,33,41,444.47,784.00,0.00
2024-12-08 17:09:20,75,771,33,42,438.55,784.01,0.00
2024-12-08 17:09:20,75,772,33,42,437.58,785.00,0.00
2024-12-08 17:09:20,76,772,34,42,431.82,785.01,0.00
2024-12-08 17:09:20,75,772,34,41,435.38,785.03,0.00
2024-12-08 17:09:20,74,772,34,40,441.16,785.03,0.00
2024-12-08 17:09:20,74,773,34,40,442.50,786.00,0.00
2024-12-08 17:09:20,75,773,35,40,436.60,786.01,0.00
2024-12-08 17:09:20,74,773,35,39,442.18,786.03,0.00
2024-12-08 17:09:20,74,774,35,39,443.54,787.00,0.00
2024-12-08 17:09:20,75,774,36,39,437.63,787.01,0.00
2024-12-08 17:09:20,74,774,35,39,442.49,787.05,0.00
2024-12-08 17:09:20,74,775,35,39,444.06,788.00,0.00
2024-12-08 17:09:20,75,775,35,40,438.14,788.01,0.00
2024-12-08 17:09:20,75,776,35,40,437.19,789.00,0.00
2024-12-08 17:09:20,76,776,36,40,431.44,789.01,0.00
2024-12-08 17:09:20,75,776,36,39,436.26,789.05,0.00
2024-12-08 17:09:20,75,777,36,39,437.72,790.00,0.00
2024-12-08 17:09:20,76,777,36,40,431.96,790.01,0.00
2024-12-08 17:09:20,76,778,36,40,430.94,791.00,0.00
2024-12-08 17:09:20,77,778,37,40,425.35,791.01,0.00
2024-12-08 17:09:20,76,778,37,39,429.71,791.07,0.00
2024-12-08 17:09:20,75,778,36,39,433.76,791.11,0.00
2024-12-08 17:09:20,75,779,36,39,437.77,792.00,0.00
2024-12-08 17:09:20,76,779,37,39,432.01,792.01,0.00
2024-12-08 17:09:20,77,778,38,39,423.04,792.21,0.00
2024-12-08 17:09:20,77,779,38,39,431.67,793.00,0.00
2024-12-08 17:09:20,78,779,39,39,426.14,793.01,0.00
2024-12-08 17:09:20,77,779,39,38,430.55,793.06,0.00
2024-12-08 17:09:20,77,780,39,38,442.22,794.00,0.00
2024-12-08 17:09:20,78,780,39,39,436.55,794.01,0.00
2024-12-08 17:09:20,78,781,39,39,435.37,795.00,0.00
2024-12-08 17:09:20,79,781,40,39,429.86,795.01,0.00
2024-12-08 17:09:20,78,781,39,39,435.27,795.01,0.00
2024-12-08 17:09:20,77,781,39,38,439.28,795.08,0.00
2024-12-08 17:09:20,77,782,39,38,440.75,796.00,0.00
2024-12-08 17:09:20,78,782,40,38,435.10,796.01,0.00
2024-12-08 17:09:20,77,782,40,37,440.45,796.04,0.00
2024-12-08 17:09:20,76,782,39,37,444.89,796.07,0.00
2024-12-08 17:09:20,76,783,39,37,446.38,797.00,0.00
2024-12-08 17:09:20,77,783,40,37,440.58,797.01,0.00
2024-12-08 17:09:20,76,783,40,36,444.61,797.08,0.00
2024-12-08 17:09:20,76,784,40,36,446.20,798.00,0.00
2024-12-08 17:09:20,77,784,41,36,440.41,798.01,0.00
2024-12-08 17:09:20,77,785,41,36,439.30,799.00,0.00
2024-12-08 17:09:20,78,785,41,37,433.67,799.01,0.00
2024-12-08 17:09:20,78,786,41,37,432.47,800.00,0.00
2024-12-08 17:09:20,79,786,42,37,426.99,800.01,0.00
2024-12-08 17:09:20,78,786,42,36,430.94,800.08,0.00
2024-12-08 17:09:20,79,785,42,37,425.29,800.13,0.00
2024-12-08 17:09:20,79,786,42,37,433.71,801.00,0.00
2024-12-08 17:09:20,80,786,43,37,428.29,801.01,0.00
2024-12-08 17:09:20,79,786,42,37,433.52,801.04,0.00
2024-12-08 17:09:20,78,786,41,37,438.97,801.04,0.00
2024-12-08 17:09:21,78,787,41,37,448.25,802.00,0.00
2024-12-08 17:09:21,79,787,41,38,442.58,802.01,0.00
2024-12-08 17:09:21,78,787,40,38,440.86,802.72,0.00
2024-12-08 17:09:21,78,788,40,38,447.06,803.00,0.00
2024-12-08 17:09:21,79,788,41,38,441.40,803.01,0.00
2024-12-08 17:09:21,79,789,41,38,440.10,804.00,0.00
2024-12-08 17:09:21,80,789,41,39,434.60,804.01,0.00
2024-12-08 17:09:21,80,790,41,39,433.13,805.00,0.00
2024-12-08 17:09:21,81,790,41,40,427.78,805.01,0.00
2024-12-08 17:09:21,80,790,41,39,431.93,805.06,0.00
2024-12-08 17:09:21,79,790,40,39,435.25,805.32,0.00
2024-12-08 17:09:21,79,791,40,39,438.34,806.00,0.00
2024-12-08 17:09:21,80,791,40,40,432.87,806.01,0.00
2024-12-08 17:09:21,79,791,40,39,437.04,806.08,0.00
2024-12-08 17:09:21,79,792,40,39,438.28,807.00,0.00
2024-12-08 17:09:21,80,792,41,39,432.80,807.01,0.00
2024-12-08 17:09:21,80,793,41,39,431.41,808.00,0.00
2024-12-08 17:09:21,81,793,41,40,426.09,808.01,0.00
2024-12-08 17:09:21,80,793,40,40,431.22,808.04,0.00
2024-12-08 17:09:21,80,794,40,40,430.03,809.00,0.00
2024-12-08 17:09:21,81,794,40,41,424.72,809.01,0.00
2024-12-08 17:09:21,80,794,40,40,429.04,809.06,0.00
2024-12-08 17:09:21,80,795,40,40,430.05,810.00,0.00
2024-12-08 17:09:21,81,795,41,40,424.74,810.01,0.00
2024-12-08 17:09:21,80,795,41,39,429.06,810.06,0.00
2024-12-08 17:09:21,80,796,41,39,430.08,811.00,0.00
2024-12-08 17:09:21,81,796,41,40,424.77,811.01,0.00
2024-12-08 17:09:21,80,796,40,40,429.88,811.03,0.00
2024-12-08 17:09:21,81,795,40,41,417.46,811.72,0.00
2024-12-08 17:09:21,81,796,40,41,425.49,812.00,0.00
2024-12-08 17:09:21,82,796,40,42,420.30,812.01,0.00
2024-12-08 17:09:21,81,796,40,41,424.71,812.05,0.00
2024-12-08 17:09:21,80,796,39,41,424.65,812.74,0.00
2024-12-08 17:09:21,80,797,39,41,440.95,813.00,0.00
2024-12-08 17:09:21,81,797,39,42,435.51,813.01,0.00
2024-12-08 17:09:21,81,798,39,42,433.92,814.00,0.00
2024-12-08 17:09:21,82,798,39,43,428.63,814.01,0.00
2024-12-08 17:09:21,81,798,39,42,433.24,814.05,0.00
2024-12-08 17:09:21,80,798,38,42,437.34,814.10,0.00
2024-12-08 17:09:21,80,799,38,42,440.56,815.00,0.00
2024-12-08 17:09:21,81,799,38,43,435.12,815.01,0.00
2024-12-08 17:09:21,80,799,37,43,437.22,815.09,0.00
2024-12-08 17:09:21,80,800,37,43,440.32,816.00,0.00
2024-12-08 17:09:21,81,800,38,43,434.88,816.01,0.00
2024-12-08 17:09:21,80,800,38,42,439.52,816.06,0.00
2024-12-08 17:09:21,80,801,38,42,440.38,817.00,0.00
2024-12-08 17:09:21,81,801,38,43,434.94,817.01,0.00
2024-12-08 17:09:22,80,801,37,43,436.83,817.09,0.00
2024-12-08 17:09:22,80,802,37,43,439.94,818.00,0.00
2024-12-08 17:09:22,81,802,38,43,434.51,818.01,0.00
2024-12-08 17:09:22,81,803,38,43,432.90,819.00,0.00
2024-12-08 17:09:22,82,803,38,44,427.62,819.01,0.00
2024-12-08 17:09:22,81,803,38,43,432.31,819.06,0.00
2024-12-08 17:09:22,80,803,37,43,436.28,819.23,0.00
2024-12-08 17:09:22,79,803,36,43,437.95,819.72,0.00
2024-12-08 17:09:22,79,804,36,43,444.19,820.00,0.00
2024-12-08 17:09:22,80,804,36,44,438.64,820.01,0.00
2024-12-08 17:09:22,79,804,36,43,443.28,820.06,0.00
2024-12-08 17:09:22,79,805,36,43,444.35,821.00,0.00
2024-12-08 17:09:22,80,805,36,44,438.80,821.01,0.00
2024-12-08 17:09:22,80,806,36,44,437.33,822.00,0.00
2024-12-08 17:09:22,81,806,36,45,431.93,822.01,0.00
2024-12-08 17:09:22,80,806,36,44,436.42,822.06,0.00
2024-12-08 17:09:22,80,807,36,44,437.41,823.00,0.00
2024-12-08 17:09:22,81,807,37,44,432.01,823.01,0.00
2024-12-08 17:09:22,80,807,36,44,430.31,823.44,0.00
2024-12-08 17:09:22,80,808,36,44,436.37,824.00,0.00
2024-12-08 17:09:22,81,808,36,45,430.98,824.01,0.00
2024-12-08 17:09:22,80,808,35,45,434.74,824.11,0.00
2024-12-08 17:09:22,80,809,35,45,436.16,825.00,0.00
2024-12-08 17:09:22,81,809,35,46,430.77,825.01,0.00
2024-12-08 17:09:22,80,809,35,45,435.45,825.06,0.00
2024-12-08 17:09:22,80,810,35,45,436.47,826.00,0.00
2024-12-08 17:09:22,81,810,36,45,431.08,826.01,0.00
2024-12-08 17:09:22,81,811,36,45,429.56,827.00,0.00
2024-12-08 17:09:22,82,811,36,46,424.33,827.01,0.00
2024-12-08 17:09:22,81,811,36,45,428.26,827.10,0.00
2024-12-08 17:09:22,80,811,35,45,432.38,827.13,0.00
2024-12-08 17:09:22,80,812,35,45,435.98,828.00,0.00
2024-12-08 17:09:22,81,812,36,45,430.60,828.01,0.00
2024-12-08 17:09:22,80,812,36,44,435.48,828.06,0.00
2024-12-08 17:09:22,80,813,36,44,436.50,829.00,0.00
2024-12-08 17:09:22,81,813,37,44,431.12,829.01,0.00
2024-12-08 17:09:22,80,813,36,44,430.25,829.26,0.00
2024-12-08 17:09:22,80,814,36,44,434.96,830.00,0.00
2024-12-08 17:09:22,81,814,36,45,429.59,830.01,0.00
2024-12-08 17:09:22,80,814,35,45,434.75,830.03,0.00
2024-12-08 17:09:22,79,814,34,45,440.06,830.05,0.00
2024-12-08 17:09:22,78,814,34,44,445.09,830.06,0.00
2024-12-08 17:09:22,77,814,33,44,450.22,830.06,0.00
2024-12-08 17:09:22,77,815,33,44,453.77,831.00,0.00
2024-12-08 17:09:22,78,815,34,44,447.95,831.01,0.00
2024-12-08 17:09:23,78,816,34,44,446.67,832.00,0.00
2024-12-08 17:09:23,79,816,34,45,441.02,832.01,0.00
2024-12-08 17:09:23,78,816,34,44,446.23,832.06,0.00
2024-12-08 17:09:23,77,816,33,44,448.82,832.47,0.00
2024-12-08 17:09:23,77,817,33,44,453.42,833.00,0.00
2024-12-08 17:09:23,78,817,34,44,447.61,833.01,0.00
2024-12-08 17:09:23,77,817,33,44,447.52,833.22,0.00
2024-12-08 17:09:23,77,818,33,44,452.34,834.00,0.00
2024-12-08 17:09:23,78,818,33,45,446.54,834.01,0.00
2024-12-08 17:09:23,77,818,32,45,446.22,834.23,0.00
2024-12-08 17:09:23,77,819,32,45,451.14,835.00,0.00
2024-12-08 17:09:23,78,819,32,46,445.36,835.01,0.00
2024-12-08 17:09:23,77,819,32,45,450.29,835.06,0.00
2024-12-08 17:09:23,77,820,32,45,451.69,836.00,0.00
2024-12-08 17:09:23,78,820,33,45,445.89,836.01,0.00
2024-12-08 17:09:23,77,820,33,44,450.72,836.06,0.00
2024-12-08 17:09:23,76,820,32,44,455.99,836.07,0.00
2024-12-08 17:09:23,76,821,32,44,459.72,837.00,0.00
2024-12-08 17:09:23,77,821,33,44,453.75,837.01,0.00
2024-12-08 17:09:23,76,821,32,44,458.63,837.07,0.00
2024-12-08 17:09:23,75,821,31,44,461.32,837.21,0.00
2024-12-08 17:09:23,75,822,31,44,466.40,838.00,0.00
2024-12-08 17:09:23,76,822,32,44,460.27,838.01,0.00
2024-12-08 17:09:23,75,822,31,44,466.08,838.04,0.00
2024-12-08 17:09:23,74,822,30,44,471.59,838.05,0.00
2024-12-08 17:09:23,74,823,30,44,473.27,839.00,0.00
2024-12-08 17:09:23,75,823,31,44,466.96,839.01,0.00
2024-12-08 17:09:23,74,823,31,43,472.26,839.05,0.00
2024-12-08 17:09:23,74,824,31,43,473.95,840.00,0.00
2024-12-08 17:09:23,75,824,31,44,467.63,840.01,0.00
2024-12-08 17:09:23,74,824,31,43,472.94,840.05,0.00
2024-12-08 17:09:23,74,825,31,43,474.63,841.00,0.00
2024-12-08 17:09:23,75,825,31,44,468.30,841.01,0.00
2024-12-08 17:09:23,74,825,30,44,468.98,841.43,0.00
2024-12-08 17:09:23,74,826,30,44,473.69,842.00,0.00
2024-12-08 17:09:23,75,826,30,45,467.38,842.01,0.00
2024-12-08 17:09:23,74,826,30,44,472.79,842.05,0.00
2024-12-08 17:09:23,74,827,30,44,474.41,843.00,0.00
2024-12-08 17:09:23,75,827,31,44,468.08,843.01,0.00
2024-12-08 17:09:23,75,828,31,44,466.68,844.00,0.00
2024-12-08 17:09:23,76,828,31,45,460.54,844.01,0.00
2024-12-08 17:09:23,75,828,31,44,465.57,844.08,0.00
2024-12-08 17:09:23,75,829,31,44,466.78,845.00,0.00
2024-12-08 17:09:23,76,829,32,44,460.64,845.01,0.00
2024-12-08 17:09:23,76,830,32,44,458.88,846.00,0.00
2024-12-08 17:09:23,77,830,33,44,452.92,846.01,0.00
2024-12-08 17:09:23,78,829,33,45,441.61,846.45,0.00
2024-12-08 17:09:23,78,830,33,45,452.10,847.00,0.00
2024-12-08 17:09:23,79,830,33,46,446.37,847.01,0.00
2024-12-08 17:09:23,78,830,32,46,451.67,847.05,0.00
2024-12-08 17:09:23,77,830,32,45,456.99,847.06,0.00
2024-12-08 17:09:23,76,830,31,45,461.82,847.21,0.00
2024-12-08 17:09:23,76,831,31,45,475.07,848.00,0.00
2024-12-08 17:09:23,77,831,31,46,468.90,848.01,0.00
2024-12-08 17:09:23,76,831,31,45,474.08,848.07,0.00
2024-12-08 17:09:23,76,832,31,45,475.03,849.00,0.00
2024-12-08 17:09:23,77,832,31,46,468.86,849.01,0.00
2024-12-08 17:09:24,77,833,31,46,467.08,850.00,0.00
2024-12-08 17:09:24,78,833,32,46,461.09,850.01,0.00
2024-12-08 17:09:24,77,833,31,46,466.75,850.04,0.00
2024-12-08 17:09:24,76,833,31,45,472.23,850.05,0.00
2024-12-08 17:09:24,76,834,31,45,473.04,851.00,0.00
2024-12-08 17:09:24,77,834,31,46,466.90,851.01,0.00
2024-12-08 17:09:24,77,835,31,46,465.06,852.00,0.00
2024-12-08 17:09:24,78,835,31,47,459.09,852.01,0.00
2024-12-08 17:09:24,77,835,31,46,464.29,852.05,0.00
2024-12-08 17:09:24,77,836,31,46,464.98,853.00,0.00
2024-12-08 17:09:24,78,836,31,47,459.02,853.01,0.00
2024-12-08 17:09:24,78,837,31,47,457.28,854.00,0.00
2024-12-08 17:09:24,79,837,32,47,451.49,854.01,0.00
2024-12-08 17:09:24,78,837,32,46,456.52,854.05,0.00
2024-12-08 17:09:24,78,838,32,46,457.50,855.00,0.00
2024-12-08 17:09:24,79,838,32,47,451.71,855.01,0.00
2024-12-08 17:09:24,79,839,32,47,450.10,856.00,0.00
2024-12-08 17:09:24,80,839,32,48,444.48,856.01,0.00
2024-12-08 17:09:24,79,839,32,47,449.35,856.05,0.00
2024-12-08 17:09:24,78,839,31,47,453.45,856.23,0.00
2024-12-08 17:09:24,77,839,30,47,453.57,856.70,0.00
2024-12-08 17:09:24,77,840,30,47,462.37,857.00,0.00
2024-12-08 17:09:24,78,840,30,48,456.44,857.01,0.00
2024-12-08 17:09:24,78,841,30,48,455.11,858.00,0.00
2024-12-08 17:09:24,79,841,31,48,449.35,858.01,0.00
2024-12-08 17:09:24,78,841,31,47,454.46,858.05,0.00
2024-12-08 17:09:24,77,841,30,47,459.03,858.10,0.00
2024-12-08 17:09:24,78,840,30,48,447.34,858.85,0.00
2024-12-08 17:09:24,78,841,30,48,458.39,859.00,0.00
2024-12-08 17:09:24,79,841,31,48,452.59,859.01,0.00
2024-12-08 17:09:24,78,841,30,48,450.69,859.58,0.00
2024-12-08 17:09:24,78,842,30,48,469.40,860.00,0.00
2024-12-08 17:09:24,79,842,30,49,463.46,860.01,0.00
2024-12-08 17:09:24,79,843,30,49,462.03,861.00,0.00
2024-12-08 17:09:24,80,843,31,49,456.26,861.01,0.00
2024-12-08 17:09:24,79,843,31,48,461.60,861.05,0.00
2024-12-08 17:09:24,79,844,31,48,462.68,862.00,0.00
2024-12-08 17:09:24,80,844,32,48,456.90,862.01,0.00
2024-12-08 17:09:24,80,845,32,48,455.38,863.00,0.00
2024-12-08 17:09:24,81,845,32,49,449.76,863.01,0.00
2024-12-08 17:09:24,80,845,32,48,452.90,863.05,0.00
2024-12-08 17:09:24,79,845,32,47,458.53,863.05,0.00
2024-12-08 17:09:24,79,846,32,47,459.60,864.00,0.00
2024-12-08 17:09:24,80,846,32,48,453.85,864.01,0.00
2024-12-08 17:09:24,79,846,32,47,459.17,864.05,0.00
2024-12-08 17:09:24,80,845,32,48,446.53,864.93,0.00
2024-12-08 17:09:24,80,846,32,48,459.46,865.00,0.00
2024-12-08 17:09:24,81,846,32,49,453.79,865.01,0.00
2024-12-08 17:09:24,81,847,32,49,462.87,866.00,0.00
2024-12-08 17:09:24,82,847,33,49,457.22,866.01,0.00
2024-12-08 17:09:24,81,847,33,48,462.12,866.06,0.00
2024-12-08 17:09:24,80,847,32,48,465.48,866.29,0.00
2024-12-08 17:09:24,80,848,32,48,470.60,867.00,0.00
2024-12-08 17:09:24,81,848,33,48,464.79,867.01,0.00
2024-12-08 17:09:24,80,848,32,48,470.49,867.01,0.00
2024-12-08 17:09:24,79,848,31,48,476.23,867.03,0.00
2024-12-08 17:09:24,78,848,30,48,479.12,867.06,0.00
2024-12-08 17:09:25,78,849,30,48,482.67,868.00,0.00
2024-12-08 17:09:25,79,849,30,49,476.56,868.01,0.00
2024-12-08 17:09:25,78,849,30,48,482.01,868.05,0.00
2024-12-08 17:09:25,78,850,30,48,483.22,869.00,0.00
2024-12-08 17:09:25,79,850,30,49,477.11,869.01,0.00
2024-12-08 17:09:25,79,851,30,49,475.67,870.00,0.00
2024-12-08 17:09:25,80,851,30,50,469.73,870.01,0.00
2024-12-08 17:09:25,79,851,30,49,474.69,870.06,0.00
2024-12-08 17:09:25,78,851,29,49,480.11,870.06,0.00
2024-12-08 17:09:25,78,852,29,49,483.67,871.00,0.00
2024-12-08 17:09:25,79,852,29,50,477.54,871.01,0.00
2024-12-08 17:09:25,78,852,28,50,476.73,871.45,0.00
2024-12-08 17:09:25,78,853,28,50,483.50,872.00,0.00
2024-12-08 17:09:25,79,853,29,50,477.38,872.01,0.00
2024-12-08 17:09:25,78,853,29,49,482.06,872.08,0.00
2024-12-08 17:09:25,78,854,29,49,483.49,873.00,0.00
2024-12-08 17:09:25,79,854,29,50,477.37,873.01,0.00
2024-12-08 17:09:25,79,855,29,50,475.93,874.00,0.00
2024-12-08 17:09:25,80,855,29,51,469.98,874.01,0.00
2024-12-08 17:09:25,79,855,28,51,475.61,874.05,0.00
2024-12-08 17:09:25,78,855,28,50,480.81,874.06,0.00
2024-12-08 17:09:25,77,855,27,50,486.15,874.06,0.00
2024-12-08 17:09:25,77,856,27,50,489.87,875.00,0.00
2024-12-08 17:09:25,78,856,28,50,483.59,875.01,0.00
2024-12-08 17:09:25,78,857,28,50,482.24,876.00,0.00
2024-12-08 17:09:25,79,857,28,51,476.13,876.01,0.00
2024-12-08 17:09:25,79,858,28,51,474.68,877.00,0.00
2024-12-08 17:09:25,80,858,28,52,468.74,877.01,0.00
2024-12-08 17:09:25,79,858,27,52,474.24,877.05,0.00
2024-12-08 17:09:25,78,858,27,51,479.65,877.05,0.00
2024-12-08 17:09:25,78,859,27,51,480.84,878.00,0.00
2024-12-08 17:09:25,79,859,27,52,474.76,878.01,0.00
2024-12-08 17:09:25,78,859,27,51,479.61,878.06,0.00
2024-12-08 17:09:25,78,860,27,51,480.87,879.00,0.00
2024-12-08 17:09:25,79,860,28,51,474.78,879.01,0.00
2024-12-08 17:09:25,78,860,27,51,479.64,879.05,0.00
2024-12-08 17:09:25,77,860,26,51,480.18,879.44,0.00
2024-12-08 17:09:25,77,861,26,51,487.10,880.00,0.00
2024-12-08 17:09:25,78,861,27,51,480.86,880.01,0.00
2024-12-08 17:09:25,77,861,26,51,479.40,880.42,0.00
2024-12-08 17:09:25,77,862,26,51,486.12,881.00,0.00
2024-12-08 17:09:25,78,862,26,52,479.89,881.01,0.00
2024-12-08 17:09:25,77,862,26,51,485.21,881.05,0.00
2024-12-08 17:09:25,77,863,26,51,486.56,882.00,0.00
2024-12-08 17:09:25,78,863,27,51,480.32,882.01,0.00
2024-12-08 17:09:25,77,863,27,50,485.65,882.05,0.00
2024-12-08 17:09:25,77,864,27,50,486.98,883.00,0.00
2024-12-08 17:09:25,78,864,27,51,480.73,883.01,0.00
2024-12-08 17:09:25,77,864,26,51,486.29,883.03,0.00
2024-12-08 17:09:25,77,865,26,51,487.34,884.00,0.00
2024-12-08 17:09:25,78,865,27,51,481.09,884.01,0.00
2024-12-08 17:09:25,77,865,27,50,486.43,884.05,0.00
2024-12-08 17:09:25,76,865,26,50,491.26,884.24,0.00
2024-12-08 17:09:25,76,866,26,50,494.22,885.00,0.00
2024-12-08 17:09:25,77,866,26,51,487.80,885.01,0.00
2024-12-08 17:09:26,77,867,26,51,486.48,886.00,0.00
2024-12-08 17:09:26,78,867,27,51,480.24,886.01,0.00
2024-12-08 17:09:26,77,867,27,50,485.68,886.05,0.00
2024-12-08 17:09:26,76,867,26,50,488.82,886.43,0.00
2024-12-08 17:09:26,75,867,25,50,490.35,886.75,0.00
2024-12-08 17:09:26,75,868,25,50,500.13,887.00,0.00
2024-12-08 17:09:26,76,868,26,50,493.55,887.01,0.00
2024-12-08 17:09:26,76,869,26,50,492.25,888.00,0.00
2024-12-08 17:09:26,77,869,26,51,485.86,888.01,0.00
2024-12-08 17:09:26,76,869,25,51,492.02,888.04,0.00
2024-12-08 17:09:26,75,869,25,50,498.11,888.04,0.00
2024-12-08 17:09:26,74,869,24,50,502.98,888.24,0.00
2024-12-08 17:09:26,74,870,24,50,506.18,889.00,0.00
2024-12-08 17:09:26,75,870,24,51,499.43,889.01,0.00
2024-12-08 17:09:26,75,871,24,51,498.09,890.00,0.00
2024-12-08 17:09:26,76,871,24,52,491.54,890.01,0.00
2024-12-08 17:09:26,75,871,24,51,497.62,890.04,0.00
2024-12-08 17:09:26,75,872,24,51,498.87,891.00,0.00
2024-12-08 17:09:26,76,872,24,52,492.31,891.01,0.00
2024-12-08 17:09:26,76,873,24,52,490.83,892.00,0.00
2024-12-08 17:09:26,77,873,25,52,484.46,892.01,0.00
2024-12-08 17:09:26,76,873,25,51,490.48,892.04,0.00
2024-12-08 17:09:26,75,873,24,51,495.40,892.23,0.00
2024-12-08 17:09:26,75,874,24,51,498.27,893.00,0.00
2024-12-08 17:09:26,76,874,25,51,491.71,893.01,0.00
2024-12-08 17:09:26,75,874,25,50,495.53,893.04,0.00
2024-12-08 17:09:26,75,875,25,50,496.79,894.00,0.00
2024-12-08 17:09:26,76,875,25,51,490.25,894.01,0.00
2024-12-08 17:09:26,75,875,25,50,494.05,894.04,0.00
2024-12-08 17:09:26,75,876,25,50,495.31,895.00,0.00
2024-12-08 17:09:26,76,876,25,51,488.80,895.01,0.00
2024-12-08 17:09:26,75,876,25,50,492.57,895.04,0.00
2024-12-08 17:09:26,74,876,24,50,498.51,895.07,0.00
2024-12-08 17:09:26,74,877,24,50,502.62,896.00,0.00
2024-12-08 17:09:26,75,877,24,51,495.92,896.01,0.00
2024-12-08 17:09:26,75,878,24,51,494.68,897.00,0.00
2024-12-08 17:09:26,76,878,25,51,488.17,897.01,0.00
2024-12-08 17:09:26,75,878,24,51,494.45,897.04,0.00
2024-12-08 17:09:26,74,878,24,50,501.01,897.04,0.00
2024-12-08 17:09:26,73,878,23,50,501.74,897.60,0.00
2024-12-08 17:09:26,73,879,23,50,510.73,898.00,0.00
2024-12-08 17:09:26,74,879,24,50,503.83,898.01,0.00
2024-12-08 17:09:26,74,880,24,50,502.81,899.00,0.00
2024-12-08 17:09:26,75,880,25,50,496.10,899.01,0.00
2024-12-08 17:09:26,74,880,25,49,502.44,899.04,0.00
2024-12-08 17:09:26,74,881,25,49,504.10,900.00,0.00
2024-12-08 17:09:26,75,881,25,50,497.37,900.01,0.00
2024-12-08 17:09:26,74,881,24,50,503.97,900.01,0.00
2024-12-08 17:09:26,73,881,24,49,508.17,900.03,0.00
2024-12-08 17:09:26,73,882,24,49,509.84,901.00,0.00
2024-12-08 17:09:26,74,882,25,49,502.95,901.01,0.00
2024-12-08 17:09:26,73,882,25,48,507.13,901.03,0.00
2024-12-08 17:09:26,72,882,24,48,508.26,901.72,0.00
2024-12-08 17:09:26,72,883,24,48,515.99,902.00,0.00
2024-12-08 17:09:26,73,883,25,48,508.92,902.01,0.00
2024-12-08 17:09:26,72,883,25,47,513.24,902.03,0.00
2024-12-08 17:09:26,72,884,25,47,515.06,903.00,0.00
2024-12-08 17:09:26,73,884,26,47,508.00,903.01,0.00
2024-12-08 17:09:27,73,885,26,47,507.08,904.00,0.00
2024-12-08 17:09:27,74,885,27,47,500.23,904.01,0.00
2024-12-08 17:09:27,73,885,27,46,506.83,904.03,0.00
2024-12-08 17:09:27,73,886,27,46,508.51,905.00,0.00
2024-12-08 17:09:27,74,886,28,46,501.64,905.01,0.00
2024-12-08 17:09:27,73,886,28,45,505.78,905.03,0.00
2024-12-08 17:09:27,73,887,28,45,507.46,906.00,0.00
2024-12-08 17:09:27,74,887,28,46,500.60,906.01,0.00
2024-12-08 17:09:27,74,888,28,46,499.56,907.00,0.00
2024-12-08 17:09:27,75,888,29,46,492.90,907.01,0.00
2024-12-08 17:09:27,74,888,29,45,499.31,907.03,0.00
2024-12-08 17:09:27,74,889,29,45,498.39,908.00,0.00
2024-12-08 17:09:27,75,889,29,46,491.75,908.01,0.00
2024-12-08 17:09:27,74,889,29,45,497.90,908.03,0.00
2024-12-08 17:09:27,74,890,29,45,499.43,909.00,0.00
2024-12-08 17:09:27,75,890,30,45,492.77,909.01,0.00
2024-12-08 17:09:27,74,890,30,44,496.89,909.03,0.00
2024-12-08 17:09:27,74,891,30,44,498.42,910.00,0.00
2024-12-08 17:09:27,75,891,30,45,491.77,910.01,0.00
2024-12-08 17:09:27,75,892,30,45,490.61,911.00,0.00
2024-12-08 17:09:27,76,892,30,46,484.16,911.01,0.00
2024-12-08 17:09:27,75,892,29,46,490.49,911.01,0.00
2024-12-08 17:09:27,74,892,29,45,496.63,911.01,0.00
2024-12-08 17:09:27,74,893,29,45,498.03,912.00,0.00
2024-12-08 17:09:27,75,893,29,46,491.39,912.01,0.00
2024-12-08 17:09:27,74,893,28,46,489.04,912.61,0.00
2024-12-08 17:09:27,74,894,28,46,498.09,913.00,0.00
2024-12-08 17:09:27,75,894,28,47,491.45,913.01,0.00
2024-12-08 17:09:27,74,894,28,46,497.72,913.01,0.00
2024-12-08 17:09:27,74,895,28,46,499.13,914.00,0.00
2024-12-08 17:09:27,75,895,29,46,492.47,914.01,0.00
2024-12-08 17:09:27,75,896,29,46,491.30,915.00,0.00
2024-12-08 17:09:27,76,896,29,47,484.84,915.01,0.00
2024-12-08 17:09:27,75,896,29,46,490.33,915.04,0.00
2024-12-08 17:09:27,75,897,29,46,491.82,916.00,0.00
2024-12-08 17:09:27,76,897,29,47,485.35,916.01,0.00
2024-12-08 17:09:27,76,898,29,47,484.07,917.00,0.00
2024-12-08 17:09:27,77,898,30,47,477.79,917.01,0.00
2024-12-08 17:09:27,76,898,30,46,483.23,917.04,0.00
2024-12-08 17:09:27,75,898,29,46,488.70,917.05,0.00
2024-12-08 17:09:27,75,899,29,46,492.66,918.00,0.00
2024-12-08 17:09:27,76,899,30,46,486.17,918.01,0.00
2024-12-08 17:09:27,75,899,29,46,492.66,918.01,0.00
2024-12-08 17:09:27,74,899,28,46,487.64,918.74,0.00
2024-12-08 17:09:27,74,900,28,46,497.91,919.00,0.00
2024-12-08 17:09:27,75,900,29,46,491.27,919.01,0.00
2024-12-08 17:09:28,75,901,29,46,489.72,920.00,0.00
2024-12-08 17:09:28,76,901,30,46,483.27,920.01,0.00
2024-12-08 17:09:28,75,901,30,45,489.23,920.03,0.00
2024-12-08 17:09:28,74,901,29,45,493.92,920.24,0.00
2024-12-08 17:09:28,74,902,29,45,496.90,921.00,0.00
2024-12-08 17:09:28,75,902,30,45,490.28,921.01,0.00
2024-12-08 17:09:28,74,902,30,44,496.28,921.03,0.00
2024-12-08 17:09:28,74,903,30,44,497.51,922.00,0.00
2024-12-08 17:09:28,75,903,31,44,490.87,922.01,0.00
2024-12-08 17:09:28,75,904,31,44,489.54,923.00,0.00
2024-12-08 17:09:28,76,904,32,44,483.10,923.01,0.00
2024-12-08 17:09:28,76,905,32,44,481.72,924.00,0.00
2024-12-08 17:09:28,77,905,33,44,475.46,924.01,0.00
2024-12-08 17:09:28,76,905,33,43,481.12,924.04,0.00
2024-12-08 17:09:28,76,906,33,43,482.39,925.00,0.00
2024-12-08 17:09:28,77,906,33,44,476.12,925.01,0.00
2024-12-08 17:09:28,76,906,33,43,481.78,925.04,0.00
2024-12-08 17:09:28,76,907,33,43,482.97,926.00,0.00
2024-12-08 17:09:28,77,907,33,44,476.70,926.01,0.00
2024-12-08 17:09:28,76,907,32,44,476.80,926.21,0.00
2024-12-08 17:09:28,75,907,31,44,480.31,926.49,0.00
2024-12-08 17:09:28,75,908,31,44,488.34,927.00,0.00
2024-12-08 17:09:28,76,908,32,44,481.91,927.01,0.00
2024-12-08 17:09:28,75,908,32,43,485.37,927.04,0.00
2024-12-08 17:09:28,75,909,32,43,489.09,928.00,0.00
2024-12-08 17:09:28,76,909,32,44,482.65,928.01,0.00
2024-12-08 17:09:28,76,910,32,44,480.85,929.00,0.00
2024-12-08 17:09:28,77,910,32,45,474.60,929.01,0.00
2024-12-08 17:09:28,76,910,32,44,480.49,929.04,0.00
2024-12-08 17:09:28,75,910,31,44,479.20,929.31,0.00
2024-12-08 17:09:28,75,911,31,44,485.10,930.00,0.00
2024-12-08 17:09:28,76,911,32,44,478.71,930.01,0.00
2024-12-08 17:09:28,75,911,31,44,484.73,930.04,0.00
2024-12-08 17:09:28,74,911,31,43,491.03,930.04,0.00
2024-12-08 17:09:28,73,911,30,43,495.10,930.12,0.00
2024-12-08 17:09:28,73,912,30,43,499.56,931.00,0.00
2024-12-08 17:09:28,74,912,30,44,492.81,931.01,0.00
2024-12-08 17:09:28,73,912,29,44,494.22,931.15,0.00
2024-12-08 17:09:28,73,913,29,44,499.07,932.00,0.00
2024-12-08 17:09:28,74,913,29,45,492.33,932.01,0.00
2024-12-08 17:09:28,73,913,29,44,498.69,932.04,0.00
2024-12-08 17:09:29,73,914,29,44,500.21,933.00,0.00
2024-12-08 17:09:29,74,914,29,45,493.45,933.01,0.00
2024-12-08 17:09:29,73,914,29,44,497.27,933.04,0.00
2024-12-08 17:09:29,73,915,29,44,498.93,934.00,0.00
2024-12-08 17:09:29,74,915,30,44,492.18,934.01,0.00
2024-12-08 17:09:29,73,915,29,44,498.54,934.04,0.00
2024-12-08 17:09:29,72,915,29,43,501.40,934.19,0.00
2024-12-08 17:09:29,71,915,28,43,506.20,934.45,0.00
2024-12-08 17:09:29,71,916,28,43,514.63,935.00,0.00
2024-12-08 17:09:29,72,916,28,44,507.48,935.01,0.00
2024-12-08 17:09:29,71,916,28,43,514.23,935.04,0.00
2024-12-08 17:09:29,71,917,28,43,513.73,936.00,0.00
2024-12-08 17:09:29,72,917,29,43,506.59,936.01,0.00
2024-12-08 17:09:29,71,917,29,42,513.33,936.04,0.00
2024-12-08 17:09:29,70,917,28,42,519.11,936.21,0.00
2024-12-08 17:09:29,70,918,28,42,522.96,937.00,0.00
2024-12-08 17:09:29,71,918,29,42,515.60,937.01,0.00
2024-12-08 17:09:29,70,918,29,41,519.89,937.04,0.00
2024-12-08 17:09:29,70,919,29,41,522.18,938.00,0.00
2024-12-08 17:09:29,71,919,30,41,514.83,938.01,0.00
2024-12-08 17:09:29,70,919,29,41,521.91,938.03,0.00
2024-12-08 17:09:29,69,919,29,40,526.62,938.03,0.00
2024-12-08 17:09:29,69,920,29,40,528.95,939.00,0.00
2024-12-08 17:09:29,70,920,29,41,521.40,939.01,0.00
2024-12-08 17:09:29,69,920,28,41,528.82,939.01,0.00
2024-12-08 17:09:29,69,921,28,41,528.29,940.00,0.00
2024-12-08 17:09:29,70,921,29,41,520.74,940.01,0.00
2024-12-08 17:09:29,69,921,29,40,528.15,940.01,0.00
2024-12-08 17:09:29,69,922,29,40,530.35,941.00,0.00
2024-12-08 17:09:29,70,922,29,41,522.78,941.01,0.00
2024-12-08 17:09:29,70,923,29,41,522.12,942.00,0.00
2024-12-08 17:09:29,71,923,29,42,514.77,942.01,0.00
2024-12-08 17:09:29,70,923,29,41,521.85,942.01,0.00
2024-12-08 17:09:29,70,924,29,41,523.89,943.00,0.00
2024-12-08 17:09:29,71,924,29,42,516.51,943.01,0.00
2024-12-08 17:09:29,71,925,29,42,515.73,944.00,0.00
2024-12-08 17:09:29,72,925,29,43,508.56,944.01,0.00
2024-12-08 17:09:29,71,925,29,42,515.59,944.01,0.00
2024-12-08 17:09:29,71,926,29,42,517.47,945.00,0.00
2024-12-08 17:09:29,72,926,29,43,510.28,945.01,0.00
2024-12-08 17:09:29,71,926,29,42,514.81,945.01,0.00
2024-12-08 17:09:29,70,926,28,42,518.14,945.44,0.00
2024-12-08 17:09:29,70,927,28,42,524.07,946.00,0.00
2024-12-08 17:09:29,71,927,28,43,516.69,946.01,0.00
2024-12-08 17:09:29,70,927,28,42,521.36,946.01,0.00
2024-12-08 17:09:29,69,927,27,42,526.92,946.20,0.00
2024-12-08 17:09:29,69,928,27,42,533.60,947.00,0.00
2024-12-08 17:09:29,70,928,27,43,525.97,947.01,0.00
2024-12-08 17:09:29,70,929,27,43,525.27,948.00,0.00
2024-12-08 17:09:29,71,929,28,43,517.87,948.01,0.00
2024-12-08 17:09:29,70,929,28,42,525.13,948.01,0.00
2024-12-08 17:09:29,69,929,27,42,528.72,948.30,0.00
2024-12-08 17:09:29,69,930,27,42,536.33,949.00,0.00
2024-12-08 17:09:29,70,930,27,43,528.67,949.01,0.00
2024-12-08 17:09:29,69,930,27,42,533.44,949.01,0.00
2024-12-08 17:09:30,69,931,27,42,535.66,950.00,0.00
2024-12-08 17:09:30,70,931,28,42,528.00,950.01,0.00
2024-12-08 17:09:30,70,932,28,42,527.34,951.00,0.00
2024-12-08 17:09:30,71,932,28,43,519.91,951.01,0.00
2024-12-08 17:09:30,70,932,28,42,526.80,951.03,0.00
2024-12-08 17:09:30,70,933,28,42,528.93,952.00,0.00
2024-12-08 17:09:30,71,933,29,42,521.48,952.01,0.00
2024-12-08 17:09:30,70,933,28,42,524.45,952.09,0.00
2024-12-08 17:09:30,70,934,28,42,529.58,953.00,0.00
2024-12-08 17:09:30,71,934,29,42,522.12,953.01,0.00
2024-12-08 17:09:30,71,935,29,42,520.89,954.00,0.00
2024-12-08 17:09:30,72,935,30,42,513.65,954.01,0.00
2024-12-08 17:09:30,71,935,30,41,520.62,954.03,0.00
2024-12-08 17:09:30,71,936,30,41,522.04,955.00,0.00
2024-12-08 17:09:30,72,936,31,41,514.79,955.01,0.00
2024-12-08 17:09:30,71,936,31,40,521.64,955.03,0.00
2024-12-08 17:09:30,70,936,30,40,522.44,955.43,0.00
2024-12-08 17:09:30,70,937,30,40,530.50,956.00,0.00
2024-12-08 17:09:30,71,937,30,41,523.03,956.01,0.00
2024-12-08 17:09:30,71,938,30,41,521.48,957.00,0.00
2024-12-08 17:09:30,72,938,30,42,514.24,957.01,0.00
2024-12-08 17:09:30,71,938,30,41,521.22,957.03,0.00
2024-12-08 17:09:30,71,939,30,41,522.79,958.00,0.00
2024-12-08 17:09:30,72,939,31,41,515.53,958.01,0.00
2024-12-08 17:09:30,71,939,31,40,519.83,958.03,0.00
2024-12-08 17:09:30,71,940,31,40,521.72,959.00,0.00
2024-12-08 17:09:30,72,940,32,40,514.48,959.01,0.00
2024-12-08 17:09:30,71,940,31,40,515.07,959.44,0.00
2024-12-08 17:09:30,71,941,31,40,520.86,960.00,0.00
2024-12-08 17:09:30,72,941,32,40,513.63,960.01,0.00
2024-12-08 17:09:30,72,942,32,40,512.69,961.00,0.00
2024-12-08 17:09:30,73,942,33,40,505.67,961.01,0.00
2024-12-08 17:09:30,72,942,33,39,512.43,961.03,0.00
2024-12-08 17:09:30,72,943,33,39,514.29,962.00,0.00
2024-12-08 17:09:30,73,943,34,39,507.25,962.01,0.00
2024-12-08 17:09:30,72,943,34,38,513.90,962.03,0.00
2024-12-08 17:09:30,72,944,34,38,515.77,963.00,0.00
2024-12-08 17:09:30,73,944,34,39,508.70,963.01,0.00
2024-12-08 17:09:30,72,944,33,39,509.09,963.44,0.00
2024-12-08 17:09:30,72,945,33,39,514.83,964.00,0.00
2024-12-08 17:09:30,73,945,34,39,507.78,964.01,0.00
2024-12-08 17:09:30,72,945,33,39,514.56,964.03,0.00
2024-12-08 17:09:30,71,945,33,38,521.54,964.03,0.00
2024-12-08 17:09:30,70,945,32,38,527.38,964.20,0.00
2024-12-08 17:09:30,70,946,32,38,531.19,965.00,0.00
2024-12-08 17:09:30,71,946,32,39,523.71,965.01,0.00
2024-12-08 17:09:30,70,946,31,39,524.57,965.43,0.00
2024-12-08 17:09:30,70,947,31,39,530.50,966.00,0.00
2024-12-08 17:09:30,71,947,31,40,523.03,966.01,0.00
2024-12-08 17:09:30,70,947,31,39,529.95,966.03,0.00
2024-12-08 17:09:30,70,948,31,39,532.15,967.00,0.00
2024-12-08 17:09:30,71,948,31,40,524.66,967.01,0.00
2024-12-08 17:09:30,71,949,31,40,523.84,968.00,0.00
2024-12-08 17:09:30,72,949,31,41,516.56,968.01,0.00
2024-12-08 17:09:31,71,949,31,40,523.43,968.03,0.00
2024-12-08 17:09:31,71,950,31,40,525.47,969.00,0.00
2024-12-08 17:09:31,72,950,32,40,518.17,969.01,0.00
2024-12-08 17:09:31,72,951,32,40,517.22,970.00,0.00
2024-12-08 17:09:31,73,951,33,40,510.14,970.01,0.00
2024-12-08 17:09:31,72,951,33,39,516.96,970.03,0.00
2024-12-08 17:09:31,71,951,32,39,521.35,970.32,0.00
2024-12-08 17:09:31,70,951,31,39,522.34,970.87,0.00
2024-12-08 17:09:31,70,952,31,39,535.07,971.00,0.00
2024-12-08 17:09:31,71,952,31,40,527.53,971.01,0.00
2024-12-08 17:09:31,70,952,31,39,534.93,971.01,0.00
2024-12-08 17:09:31,69,952,31,38,539.73,971.01,0.00
2024-12-08 17:09:31,68,952,30,38,547.38,971.01,0.00
2024-12-08 17:09:31,68,953,30,38,552.66,972.00,0.00
2024-12-08 17:09:31,69,953,31,38,544.65,972.01,0.00
2024-12-08 17:09:31,69,954,31,38,544.08,973.00,0.00
2024-12-08 17:09:31,70,954,31,39,536.31,973.01,0.00
2024-12-08 17:09:31,69,954,31,38,543.80,973.01,0.00
2024-12-08 17:09:31,69,955,31,38,546.06,974.00,0.00
2024-12-08 17:09:31,70,955,32,38,538.25,974.01,0.00
2024-12-08 17:09:31,70,956,32,38,537.55,975.00,0.00
2024-12-08 17:09:31,71,956,33,38,529.98,975.01,0.00
2024-12-08 17:09:31,70,956,33,37,537.41,975.01,0.00
2024-12-08 17:09:31,70,957,33,37,539.50,976.00,0.00
2024-12-08 17:09:31,71,957,33,38,531.90,976.01,0.00
2024-12-08 17:09:31,70,957,33,37,538.96,976.01,0.00
2024-12-08 17:09:31,70,958,33,37,541.04,977.00,0.00
2024-12-08 17:09:31,71,958,34,37,533.42,977.01,0.00
2024-12-08 17:09:31,71,959,34,37,532.59,978.00,0.00
2024-12-08 17:09:31,72,959,34,38,525.20,978.01,0.00
2024-12-08 17:09:31,71,959,34,37,532.04,978.03,0.00
2024-12-08 17:09:31,70,959,33,37,535.73,978.44,0.00
2024-12-08 17:09:31,70,960,33,37,541.87,979.00,0.00
2024-12-08 17:09:31,71,960,33,38,534.24,979.01,0.00
2024-12-08 17:09:31,70,960,32,38,541.73,979.01,0.00
2024-12-08 17:09:31,70,961,32,38,541.03,980.00,0.00
2024-12-08 17:09:31,71,961,32,39,533.41,980.01,0.00
2024-12-08 17:09:31,70,961,31,39,539.81,980.07,0.00
2024-12-08 17:09:31,69,961,30,39,543.42,980.20,0.00
2024-12-08 17:09:31,69,962,30,39,550.32,981.00,0.00
2024-12-08 17:09:31,70,962,30,40,542.46,981.01,0.00
2024-12-08 17:09:31,69,962,29,40,550.18,981.01,0.00
2024-12-08 17:09:31,68,962,29,39,556.69,981.06,0.00
2024-12-08 17:09:31,68,963,29,39,559.56,982.00,0.00
2024-12-08 17:09:31,69,963,30,39,551.45,982.01,0.00
2024-12-08 17:09:31,68,963,29,39,559.42,982.01,0.00
2024-12-08 17:09:31,68,964,29,39,558.98,983.00,0.00
2024-12-08 17:09:31,69,964,30,39,550.88,983.01,0.00
2024-12-08 17:09:31,68,964,30,38,558.26,983.03,0.00
2024-12-08 17:09:31,68,965,30,38,560.85,984.00,0.00
2024-12-08 17:09:31,69,965,31,38,552.72,984.01,0.00
2024-12-08 17:09:31,68,965,31,37,559.55,984.04,0.00
2024-12-08 17:09:31,67,965,30,37,566.91,984.15,0.00
2024-12-08 17:09:31,67,966,30,37,570.83,985.00,0.00
2024-12-08 17:09:31,68,966,30,38,562.43,985.01,0.00
2024-12-08 17:09:31,68,967,30,38,561.99,986.00,0.00
2024-12-08 17:09:31,69,967,30,39,553.84,986.01,0.00
2024-12-08 17:09:31,68,967,30,38,560.83,986.04,0.00
2024-12-08 17:09:31,68,968,30,38,563.57,987.00,0.00
2024-12-08 17:09:32,69,968,31,38,555.41,987.01,0.00
2024-12-08 17:09:32,69,969,31,38,554.81,988.00,0.00
2024-12-08 17:09:32,70,969,32,38,546.89,988.01,0.00
2024-12-08 17:09:32,70,970,32,38,546.17,989.00,0.00
2024-12-08 17:09:32,71,970,32,39,538.47,989.01,0.00
2024-12-08 17:09:32,70,970,31,39,545.93,989.03,0.00
2024-12-08 17:09:32,69,970,31,38,553.27,989.03,0.00
2024-12-08 17:09:32,68,970,30,38,557.63,989.43,0.00
2024-12-08 17:09:32,68,971,30,38,564.01,990.00,0.00
2024-12-08 17:09:32,69,971,31,38,555.83,990.01,0.00
2024-12-08 17:09:32,68,971,31,37,563.28,990.03,0.00
2024-12-08 17:09:32,68,972,31,37,565.89,991.00,0.00
2024-12-08 17:09:32,69,972,31,38,557.69,991.01,0.00
2024-12-08 17:09:32,68,972,30,38,561.55,991.16,0.00
2024-12-08 17:09:32,68,973,30,38,565.44,992.00,0.00
2024-12-08 17:09:32,69,973,31,38,557.24,992.01,0.00
2024-12-08 17:09:32,68,973,31,37,564.71,992.03,0.00
2024-12-08 17:09:32,67,973,30,37,568.28,992.48,0.00
2024-12-08 17:09:32,67,974,30,37,578.31,993.00,0.00
2024-12-08 17:09:32,68,974,31,37,569.81,993.01,0.00
2024-12-08 17:09:32,68,975,31,37,569.36,994.00,0.00
2024-12-08 17:09:32,69,975,31,38,561.11,994.01,0.00
2024-12-08 17:09:32,68,975,31,37,568.77,994.03,0.00
2024-12-08 17:09:32,68,976,31,37,571.39,995.00,0.00
2024-12-08 17:09:32,69,976,32,37,563.11,995.01,0.00
2024-12-08 17:09:32,69,977,32,37,562.52,996.00,0.00
2024-12-08 17:09:32,70,977,32,38,554.49,996.01,0.00
2024-12-08 17:09:32,70,978,32,38,553.76,997.00,0.00
2024-12-08 17:09:32,71,978,32,39,545.96,997.01,0.00
2024-12-08 17:09:32,70,978,32,38,552.06,997.06,0.00
2024-12-08 17:09:32,70,979,32,38,554.60,998.00,0.00
2024-12-08 17:09:32,71,979,33,38,546.79,998.01,0.00
2024-12-08 17:09:32,70,979,33,37,552.90,998.06,0.00
2024-12-08 17:09:32,69,979,32,37,556.60,998.19,0.00
2024-12-08 17:09:32,69,980,32,37,563.49,999.00,0.00
2024-12-08 17:09:32,70,980,32,38,555.44,999.01,0.00
2024-12-08 17:09:32,70,981,32,38,554.71,1000.00,0.00
2024-12-08 17:09:32,71,981,32,39,546.90,1000.01,0.00
2024-12-08 17:09:32,70,981,32,38,552.58,1000.09,0.00
2024-12-08 17:09:32,69,981,31,38,559.46,1000.19,0.00
2024-12-08 17:09:32,69,982,31,38,566.36,1001.00,0.00
2024-12-08 17:09:32,70,982,32,38,558.27,1001.01,0.00
2024-12-08 17:09:32,69,982,31,38,565.93,1001.04,0.00
2024-12-08 17:09:32,68,982,30,38,573.22,1001.04,0.00
2024-12-08 17:09:32,68,983,30,38,576.00,1002.00,0.00
2024-12-08 17:09:32,69,983,31,38,567.65,1002.01,0.00
2024-12-08 17:09:32,69,984,31,38,567.06,1003.00,0.00
2024-12-08 17:09:32,70,984,32,38,558.96,1003.01,0.00
2024-12-08 17:09:32,69,984,32,37,565.32,1003.06,0.00
2024-12-08 17:09:32,69,985,32,37,568.06,1004.00,0.00
2024-12-08 17:09:32,70,985,33,37,559.95,1004.01,0.00
2024-12-08 17:09:32,69,985,32,37,567.91,1004.01,0.00
2024-12-08 17:09:32,69,986,32,37,567.31,1005.00,0.00
2024-12-08 17:09:32,70,986,32,38,559.21,1005.01,0.00
2024-12-08 17:09:32,69,986,32,37,565.86,1005.04,0.00
2024-12-08 17:09:33,69,987,32,37,568.46,1006.00,0.00
2024-12-08 17:09:33,70,987,33,37,560.34,1006.01,0.00
2024-12-08 17:09:33,69,987,33,36,567.01,1006.04,0.00
2024-12-08 17:09:33,69,988,33,36,569.61,1007.00,0.00
2024-12-08 17:09:33,70,988,34,36,561.47,1007.01,0.00
2024-12-08 17:09:33,70,989,34,36,560.74,1008.00,0.00
2024-12-08 17:09:33,71,989,35,36,552.84,1008.01,0.00
2024-12-08 17:09:33,70,989,35,35,559.16,1008.06,0.00
2024-12-08 17:09:33,70,990,35,35,561.72,1009.00,0.00
2024-12-08 17:09:33,71,990,36,35,553.81,1009.01,0.00
2024-12-08 17:09:33,71,991,36,35,552.94,1010.00,0.00
2024-12-08 17:09:33,72,991,37,35,545.26,1010.01,0.00
2024-12-08 17:09:33,72,992,37,35,544.25,1011.00,0.00
2024-12-08 17:09:33,73,992,38,35,536.80,1011.01,0.00
2024-12-08 17:09:33,72,992,38,34,542.02,1011.08,0.00
2024-12-08 17:09:33,72,993,38,34,544.51,1012.00,0.00
2024-12-08 17:09:33,73,993,39,34,537.05,1012.01,0.00
2024-12-08 17:09:33,72,993,39,33,542.27,1012.08,0.00
2024-12-08 17:09:33,72,994,39,33,544.77,1013.00,0.00
2024-12-08 17:09:33,73,994,40,33,537.31,1013.01,0.00
2024-12-08 17:09:33,72,994,39,33,540.16,1013.19,0.00
2024-12-08 17:09:33,71,994,38,33,547.63,1013.20,0.00
2024-12-08 17:09:33,71,995,38,33,551.42,1014.00,0.00
2024-12-08 17:09:33,72,995,38,34,543.76,1014.01,0.00
2024-12-08 17:09:33,71,995,38,33,549.13,1014.03,0.00
2024-12-08 17:09:33,70,995,37,33,556.83,1014.03,0.00
2024-12-08 17:09:33,70,996,37,33,559.12,1015.00,0.00
2024-12-08 17:09:33,71,996,37,34,551.24,1015.01,0.00
2024-12-08 17:09:33,70,996,36,34,552.62,1015.14,0.00
2024-12-08 17:09:33,70,997,36,34,558.94,1016.00,0.00
2024-12-08 17:09:33,71,997,37,34,551.07,1016.01,0.00
2024-12-08 17:09:33,70,997,36,34,558.65,1016.03,0.00
2024-12-08 17:09:33,69,997,36,33,566.16,1016.03,0.00
2024-12-08 17:09:33,69,998,36,33,568.64,1017.00,0.00
2024-12-08 17:09:33,70,998,37,33,560.51,1017.01,0.00
2024-12-08 17:09:33,69,998,36,33,568.49,1017.01,0.00
2024-12-08 17:09:33,68,998,36,32,575.80,1017.02,0.00
2024-12-08 17:09:33,68,999,36,32,578.31,1018.00,0.00
2024-12-08 17:09:33,69,999,37,32,569.93,1018.01,0.00
2024-12-08 17:09:33,68,999,36,32,573.86,1018.15,0.00
2024-12-08 17:09:33,68,1000,36,32,577.68,1019.00,0.00
2024-12-08 17:09:33,69,1000,36,33,569.31,1019.01,0.00
2024-12-08 17:09:33,69,1001,36,33,568.69,1020.00,0.00
2024-12-08 17:09:33,70,1001,37,33,560.56,1020.01,0.00
2024-12-08 17:09:33,69,1001,37,32,567.95,1020.01,0.00
2024-12-08 17:09:33,68,1001,36,32,575.13,1020.13,0.00
2024-12-08 17:09:33,68,1002,36,32,578.82,1021.00,0.00
2024-12-08 17:09:33,69,1002,37,32,570.43,1021.01,0.00
2024-12-08 17:09:33,68,1002,37,31,578.07,1021.02,0.00
2024-12-08 17:09:33,68,1003,37,31,580.59,1022.00,0.00
2024-12-08 17:09:33,69,1003,37,32,572.17,1022.01,0.00
2024-12-08 17:09:33,69,1004,37,32,571.55,1023.00,0.00
2024-12-08 17:09:33,70,1004,37,33,563.38,1023.01,0.00
2024-12-08 17:09:33,69,1004,37,32,570.95,1023.01,0.00
2024-12-08 17:09:33,69,1005,37,32,573.29,1024.00,0.00
2024-12-08 17:09:33,70,1005,37,33,565.10,1024.01,0.00
2024-12-08 17:09:33,70,1006,37,33,564.34,1025.00,0.00
2024-12-08 17:09:33,71,1006,38,33,556.39,1025.01,0.00
2024-12-08 17:09:34,70,1006,38,32,563.90,1025.01,0.00
2024-12-08 17:09:34,69,1006,37,32,567.12,1025.32,0.00
2024-12-08 17:09:34,69,1007,37,32,575.45,1026.00,0.00
2024-12-08 17:09:34,70,1007,38,32,567.23,1026.01,0.00
2024-12-08 17:09:34,70,1008,38,32,566.18,1027.00,0.00
2024-12-08 17:09:34,71,1008,38,33,558.21,1027.01,0.00
2024-12-08 17:09:34,70,1008,38,32,565.74,1027.01,0.00
2024-12-08 17:09:34,70,1009,38,32,567.32,1028.00,0.00
2024-12-08 17:09:34,71,1009,39,32,559.33,1028.01,0.00
2024-12-08 17:09:34,70,1009,38,32,563.21,1028.03,0.00
2024-12-08 17:09:34,70,1010,38,32,567.87,1029.00,0.00
2024-12-08 17:09:34,71,1010,39,32,559.87,1029.01,0.00
2024-12-08 17:09:34,71,1011,39,32,558.44,1030.00,0.00
2024-12-08 17:09:34,72,1011,40,32,550.68,1030.01,0.00
2024-12-08 17:09:34,71,1011,40,31,558.15,1030.01,0.00
2024-12-08 17:09:34,71,1012,40,31,559.82,1031.00,0.00
2024-12-08 17:09:34,72,1012,40,32,552.05,1031.01,0.00
2024-12-08 17:09:34,71,1012,40,31,558.95,1031.01,0.00
2024-12-08 17:09:34,71,1013,40,31,560.94,1032.00,0.00
2024-12-08 17:09:34,72,1013,41,31,553.15,1032.01,0.00
2024-12-08 17:09:34,71,1013,40,31,555.58,1032.07,0.00
2024-12-08 17:09:34,71,1014,40,31,561.05,1033.00,0.00
2024-12-08 17:09:34,72,1014,40,32,553.26,1033.01,0.00
2024-12-08 17:09:34,71,1014,39,32,554.25,1033.14,0.00
2024-12-08 17:09:34,71,1015,39,32,560.43,1034.00,0.00
2024-12-08 17:09:34,72,1015,39,33,552.65,1034.01,0.00
2024-12-08 17:09:34,71,1015,39,32,558.55,1034.06,0.00
2024-12-08 17:09:34,71,1016,39,32,560.97,1035.00,0.00
2024-12-08 17:09:34,72,1016,39,33,553.18,1035.01,0.00
2024-12-08 17:09:34,71,1016,39,32,558.94,1035.06,0.00
2024-12-08 17:09:34,71,1017,39,32,561.37,1036.00,0.00
2024-12-08 17:09:34,72,1017,39,33,553.57,1036.01,0.00
2024-12-08 17:09:34,72,1018,39,33,552.52,1037.00,0.00
2024-12-08 17:09:34,73,1018,39,34,544.95,1037.01,0.00
2024-12-08 17:09:34,72,1018,39,33,550.66,1037.06,0.00
2024-12-08 17:09:34,71,1018,38,33,556.23,1037.08,0.00
2024-12-08 17:09:34,71,1019,38,33,561.87,1038.00,0.00
2024-12-08 17:09:34,72,1019,38,34,554.06,1038.01,0.00
2024-12-08 17:09:34,71,1019,37,34,554.65,1038.30,0.00
2024-12-08 17:09:34,71,1020,37,34,562.41,1039.00,0.00
2024-12-08 17:09:34,72,1020,37,35,554.60,1039.01,0.00
2024-12-08 17:09:34,71,1020,37,34,560.66,1039.06,0.00
2024-12-08 17:09:34,71,1021,37,34,563.10,1040.00,0.00
2024-12-08 17:09:34,72,1021,38,34,555.28,1040.01,0.00
2024-12-08 17:09:34,72,1022,38,34,554.22,1041.00,0.00
2024-12-08 17:09:34,73,1022,38,35,546.63,1041.01,0.00
2024-12-08 17:09:34,73,1023,38,35,545.44,1042.00,0.00
2024-12-08 17:09:34,74,1023,39,35,538.07,1042.01,0.00
2024-12-08 17:09:34,73,1023,39,34,545.41,1042.01,0.00
2024-12-08 17:09:34,72,1023,39,33,551.69,1042.04,0.00
2024-12-08 17:09:34,71,1023,38,33,555.49,1042.44,0.00
2024-12-08 17:09:34,71,1024,38,33,561.75,1043.00,0.00
2024-12-08 17:09:34,72,1024,38,34,553.95,1043.01,0.00
2024-12-08 17:09:34,71,1024,38,33,560.14,1043.04,0.00
2024-12-08 17:09:34,70,1024,37,33,566.84,1043.17,0.00
2024-12-08 17:09:35,70,1025,37,33,570.62,1044.00,0.00
2024-12-08 17:09:35,71,1025,38,33,562.58,1044.01,0.00
2024-12-08 17:09:35,70,1025,37,33,568.98,1044.04,0.00
2024-12-08 17:09:35,70,1026,37,33,571.47,1045.00,0.00
2024-12-08 17:09:35,71,1026,38,33,563.42,1045.01,0.00
2024-12-08 17:09:35,70,1026,38,32,569.83,1045.04,0.00
2024-12-08 17:09:35,70,1027,38,32,572.31,1046.00,0.00
2024-12-08 17:09:35,71,1027,39,32,564.25,1046.01,0.00
2024-12-08 17:09:35,70,1027,38,32,564.83,1046.44,0.00
2024-12-08 17:09:35,70,1028,38,32,571.36,1047.00,0.00
2024-12-08 17:09:35,71,1028,38,33,563.32,1047.01,0.00
2024-12-08 17:09:35,70,1028,38,32,569.28,1047.07,0.00
2024-12-08 17:09:35,70,1029,38,32,572.06,1048.00,0.00
2024-12-08 17:09:35,71,1029,38,33,564.00,1048.01,0.00
2024-12-08 17:09:35,71,1030,38,33,563.06,1049.00,0.00
2024-12-08 17:09:35,72,1030,38,34,555.24,1049.01,0.00
2024-12-08 17:09:35,71,1030,38,33,561.00,1049.07,0.00
2024-12-08 17:09:35,71,1031,38,33,563.60,1050.00,0.00
2024-12-08 17:09:35,72,1031,38,34,555.77,1050.01,0.00
2024-12-08 17:09:35,71,1031,37,34,555.65,1050.20,0.00
2024-12-08 17:09:35,71,1032,37,34,562.51,1051.00,0.00
2024-12-08 17:09:35,72,1032,38,34,554.69,1051.01,0.00
2024-12-08 17:09:35,71,1032,38,33,560.59,1051.07,0.00
2024-12-08 17:09:35,70,1032,37,33,566.35,1051.10,0.00
2024-12-08 17:09:35,69,1032,36,33,571.33,1051.42,0.00
2024-12-08 17:09:35,69,1033,36,33,580.89,1052.00,0.00
2024-12-08 17:09:35,70,1033,36,34,572.59,1052.01,0.00
2024-12-08 17:09:35,70,1034,36,34,571.78,1053.00,0.00
2024-12-08 17:09:35,71,1034,36,35,563.73,1053.01,0.00
2024-12-08 17:09:35,70,1034,36,34,569.98,1053.07,0.00
2024-12-08 17:09:35,70,1035,36,34,572.77,1054.00,0.00
2024-12-08 17:09:35,71,1035,37,34,564.71,1054.01,0.00
2024-12-08 17:09:35,70,1035,36,34,560.84,1054.66,0.00
2024-12-08 17:09:35,70,1036,36,34,572.56,1055.00,0.00
2024-12-08 17:09:35,71,1036,37,34,564.50,1055.01,0.00
2024-12-08 17:09:35,70,1036,36,34,572.26,1055.04,0.00
2024-12-08 17:09:35,69,1036,36,33,579.34,1055.06,0.00
2024-12-08 17:09:35,69,1037,36,33,582.18,1056.00,0.00
2024-12-08 17:09:35,70,1037,36,34,573.86,1056.01,0.00
2024-12-08 17:09:35,69,1037,35,34,577.32,1056.19,0.00
2024-12-08 17:09:35,69,1038,35,34,581.50,1057.00,0.00
2024-12-08 17:09:35,70,1038,36,34,573.20,1057.01,0.00
2024-12-08 17:09:35,69,1038,36,33,579.52,1057.07,0.00
2024-12-08 17:09:35,69,1039,36,33,582.51,1058.00,0.00
2024-12-08 17:09:35,70,1039,37,33,574.19,1058.01,0.00
2024-12-08 17:09:35,69,1039,36,33,575.64,1058.15,0.00
2024-12-08 17:09:35,69,1040,36,33,582.45,1059.00,0.00
2024-12-08 17:09:35,70,1040,37,33,574.13,1059.01,0.00
2024-12-08 17:09:35,70,1041,37,33,573.31,1060.00,0.00
2024-12-08 17:09:35,71,1041,38,33,565.23,1060.01,0.00
2024-12-08 17:09:35,70,1041,38,32,570.44,1060.11,0.00
2024-12-08 17:09:35,70,1042,38,32,573.70,1061.00,0.00
2024-12-08 17:09:35,71,1042,39,32,565.62,1061.01,0.00
2024-12-08 17:09:35,70,1042,38,32,573.55,1061.01,0.00
2024-12-08 17:09:35,69,1042,38,31,580.48,1061.06,0.00
2024-12-08 17:09:36,69,1043,38,31,583.33,1062.00,0.00
2024-12-08 17:09:36,70,1043,38,32,575.00,1062.01,0.00
2024-12-08 17:09:36,69,1043,37,32,583.18,1062.02,0.00
2024-12-08 17:09:36,68,1043,36,32,586.80,1062.18,0.00
2024-12-08 17:09:36,68,1044,36,32,591.00,1063.00,0.00
2024-12-08 17:09:36,69,1044,37,32,582.43,1063.02,0.00
2024-12-08 17:09:36,68,1044,37,31,588.35,1063.09,0.00
2024-12-08 17:09:36,68,1045,37,31,591.57,1064.00,0.00
2024-12-08 17:09:36,69,1045,38,31,583.00,1064.02,0.00
2024-12-08 17:09:36,68,1045,37,31,591.26,1064.03,0.00
2024-12-08 17:09:36,67,1045,36,31,590.29,1064.54,0.00
2024-12-08 17:09:36,67,1046,36,31,601.45,1065.00,0.00
2024-12-08 17:09:36,68,1046,36,32,592.60,1065.02,0.00
2024-12-08 17:09:36,67,1046,36,31,598.91,1065.08,0.00
2024-12-08 17:09:36,66,1046,35,31,607.21,1065.15,0.00
2024-12-08 17:09:36,65,1046,34,31,611.10,1065.69,0.00
2024-12-08 17:09:36,65,1047,34,31,621.19,1066.00,0.00
2024-12-08 17:09:36,66,1047,35,31,611.78,1066.02,0.00
2024-12-08 17:09:36,65,1047,34,31,610.36,1066.43,0.00
2024-12-08 17:09:36,65,1048,34,31,621.10,1067.00,0.00
2024-12-08 17:09:36,66,1048,34,32,611.69,1067.02,0.00
2024-12-08 17:09:36,66,1049,34,32,611.34,1068.00,0.00
2024-12-08 17:09:36,67,1049,34,33,602.22,1068.02,0.00
2024-12-08 17:09:36,66,1049,34,32,609.08,1068.08,0.00
2024-12-08 17:09:36,66,1050,34,32,612.54,1069.00,0.00
2024-12-08 17:09:36,67,1050,35,32,603.39,1069.02,0.00
2024-12-08 17:09:36,66,1050,35,31,609.96,1069.09,0.00
2024-12-08 17:09:36,66,1051,35,31,613.43,1070.00,0.00
2024-12-08 17:09:36,67,1051,35,32,604.28,1070.02,0.00
2024-12-08 17:09:36,66,1051,34,32,606.96,1070.11,0.00
2024-12-08 17:09:36,66,1052,34,32,613.85,1071.00,0.00
2024-12-08 17:09:36,67,1052,34,33,604.69,1071.02,0.00
2024-12-08 17:09:36,66,1052,34,32,611.43,1071.09,0.00
2024-12-08 17:09:36,66,1053,34,32,614.84,1072.00,0.00
2024-12-08 17:09:36,67,1053,34,33,605.67,1072.02,0.00
2024-12-08 17:09:36,68,1052,34,34,586.18,1072.74,0.00
2024-12-08 17:09:36,69,1051,35,34,575.09,1072.99,0.00
2024-12-08 17:09:36,69,1052,35,34,590.65,1073.00,0.00
2024-12-08 17:09:36,70,1052,36,34,582.22,1073.01,0.00
2024-12-08 17:09:36,70,1053,36,34,611.84,1074.00,0.00
2024-12-08 17:09:36,71,1053,36,35,603.22,1074.01,0.00
2024-12-08 17:09:36,70,1053,36,34,609.24,1074.09,0.00
2024-12-08 17:09:36,70,1054,36,34,612.21,1075.00,0.00
2024-12-08 17:09:36,71,1054,37,34,603.59,1075.01,0.00
2024-12-08 17:09:36,70,1054,36,34,612.06,1075.01,0.00
2024-12-08 17:09:36,69,1054,36,33,616.28,1075.16,0.00
2024-12-08 17:09:36,70,1053,36,34,602.65,1075.66,0.00
2024-12-08 17:09:36,70,1054,36,34,614.93,1076.00,0.00
2024-12-08 17:09:36,71,1054,36,35,606.27,1076.01,0.00
2024-12-08 17:09:36,71,1055,36,35,620.31,1077.00,0.00
2024-12-08 17:09:36,72,1055,37,35,611.69,1077.01,0.00
2024-12-08 17:09:36,71,1055,37,34,615.94,1077.16,0.00
2024-12-08 17:09:36,70,1055,36,34,621.66,1077.16,0.00
2024-12-08 17:09:36,70,1056,36,34,628.08,1078.00,0.00
2024-12-08 17:09:36,71,1056,36,35,619.23,1078.01,0.00
2024-12-08 17:09:36,71,1057,36,35,617.67,1079.00,0.00
2024-12-08 17:09:36,72,1057,36,36,609.09,1079.01,0.00
2024-12-08 17:09:36,71,1057,36,35,612.69,1079.18,0.00
2024-12-08 17:09:37,71,1058,36,35,615.78,1080.00,0.00
2024-12-08 17:09:37,72,1058,37,35,607.23,1080.01,0.00
2024-12-08 17:09:37,72,1059,37,35,605.07,1081.00,0.00
2024-12-08 17:09:37,73,1059,37,36,596.78,1081.01,0.00
2024-12-08 17:09:37,72,1059,36,36,602.99,1081.19,0.00
2024-12-08 17:09:37,71,1059,35,36,606.00,1081.41,0.00
2024-12-08 17:09:37,71,1060,35,36,611.08,1082.00,0.00
2024-12-08 17:09:37,72,1060,35,37,602.59,1082.01,0.00
2024-12-08 17:09:37,71,1060,35,36,605.93,1082.20,0.00
2024-12-08 17:09:37,71,1061,35,36,608.12,1083.00,0.00
2024-12-08 17:09:37,72,1061,36,36,599.67,1083.01,0.00
2024-12-08 17:09:37,71,1061,36,35,602.96,1083.20,0.00
2024-12-08 17:09:37,71,1062,36,35,604.82,1084.00,0.00
2024-12-08 17:09:37,72,1062,37,35,596.42,1084.01,0.00
2024-12-08 17:09:37,72,1063,37,35,593.21,1085.00,0.00
2024-12-08 17:09:37,73,1063,37,36,585.08,1085.01,0.00
2024-12-08 17:09:37,72,1063,37,35,588.26,1085.19,0.00
2024-12-08 17:09:37,72,1064,37,35,590.04,1086.00,0.00
2024-12-08 17:09:37,73,1064,37,36,581.96,1086.01,0.00
2024-12-08 17:09:37,73,1065,37,36,578.93,1087.00,0.00
2024-12-08 17:09:37,74,1065,37,37,571.10,1087.01,0.00
2024-12-08 17:09:37,73,1065,36,37,578.18,1087.07,0.00
2024-12-08 17:09:37,72,1065,36,36,581.70,1087.19,0.00
2024-12-08 17:09:37,72,1066,36,36,583.86,1088.00,0.00
2024-12-08 17:09:37,73,1066,37,36,575.87,1088.01,0.00
2024-12-08 17:09:37,72,1066,36,36,583.71,1088.01,0.00
2024-12-08 17:09:37,71,1066,35,36,591.32,1088.06,0.00
2024-12-08 17:09:37,70,1066,35,35,596.87,1088.20,0.00
2024-12-08 17:09:37,70,1067,35,35,600.36,1089.00,0.00
2024-12-08 17:09:37,71,1067,36,35,591.91,1089.01,0.00
2024-12-08 17:09:37,70,1067,36,34,600.21,1089.01,0.00
2024-12-08 17:09:37,69,1067,35,34,607.35,1089.16,0.00
2024-12-08 17:09:37,69,1068,35,34,607.43,1090.00,0.00
2024-12-08 17:09:37,70,1068,35,35,598.75,1090.01,0.00
2024-12-08 17:09:37,69,1068,34,35,607.11,1090.04,0.00
2024-12-08 17:09:37,68,1068,34,34,608.20,1090.43,0.00
2024-12-08 17:09:37,68,1069,34,34,615.19,1091.00,0.00
2024-12-08 17:09:37,69,1069,35,34,606.27,1091.02,0.00
2024-12-08 17:09:37,68,1069,35,33,613.12,1091.16,0.00
2024-12-08 17:09:37,68,1070,35,33,617.36,1092.00,0.00
2024-12-08 17:09:37,69,1070,35,34,608.41,1092.02,0.00
2024-12-08 17:09:37,68,1070,34,34,617.20,1092.02,0.00
2024-12-08 17:09:37,68,1071,34,34,619.85,1093.00,0.00
2024-12-08 17:09:37,69,1071,35,34,610.87,1093.02,0.00
2024-12-08 17:09:37,69,1072,35,34,610.16,1094.00,0.00
2024-12-08 17:09:37,70,1072,35,35,601.44,1094.01,0.00
2024-12-08 17:09:37,69,1072,34,35,609.69,1094.06,0.00
2024-12-08 17:09:37,68,1072,34,34,617.70,1094.13,0.00
2024-12-08 17:09:37,68,1073,34,34,618.41,1095.00,0.00
2024-12-08 17:09:37,69,1073,35,34,609.45,1095.02,0.00
2024-12-08 17:09:37,68,1073,35,33,613.76,1095.13,0.00
2024-12-08 17:09:37,68,1074,35,33,617.68,1096.00,0.00
2024-12-08 17:09:37,69,1074,35,34,608.73,1096.02,0.00
2024-12-08 17:09:37,69,1075,35,34,608.02,1097.00,0.00
2024-12-08 17:09:37,70,1075,35,35,599.33,1097.01,0.00
2024-12-08 17:09:37,69,1075,34,35,607.38,1097.06,0.00
2024-12-08 17:09:37,68,1075,34,34,612.45,1097.12,0.00
2024-12-08 17:09:37,68,1076,34,34,616.23,1098.00,0.00
2024-12-08 17:09:37,69,1076,34,35,607.30,1098.02,0.00
2024-12-08 17:09:37,68,1076,33,35,616.07,1098.02,0.00
2024-12-08 17:09:38,67,1076,32,35,613.78,1098.75,0.00
2024-12-08 17:09:38,67,1077,32,35,627.60,1099.00,0.00
2024-12-08 17:09:38,68,1077,32,36,618.37,1099.02,0.00
2024-12-08 17:09:38,67,1077,31,36,627.27,1099.05,0.00
2024-12-08 17:09:38,66,1077,31,35,633.12,1099.09,0.00
2024-12-08 17:09:38,66,1078,31,35,636.88,1100.00,0.00
2024-12-08 17:09:38,67,1078,31,36,627.38,1100.02,0.00
2024-12-08 17:09:38,66,1078,30,36,629.67,1100.36,0.00
2024-12-08 17:09:38,66,1079,30,36,636.46,1101.00,0.00
2024-12-08 17:09:38,67,1079,30,37,626.96,1101.02,0.00
2024-12-08 17:09:38,66,1079,30,36,632.31,1101.11,0.00
2024-12-08 17:09:38,66,1080,30,36,636.35,1102.00,0.00
2024-12-08 17:09:38,67,1080,30,37,626.86,1102.02,0.00
2024-12-08 17:09:38,67,1081,30,37,626.44,1103.00,0.00
2024-12-08 17:09:38,68,1081,31,37,617.23,1103.02,0.00
2024-12-08 17:09:38,67,1081,31,36,622.34,1103.10,0.00
2024-12-08 17:09:38,66,1081,30,36,623.19,1103.80,0.00
2024-12-08 17:09:38,66,1082,30,36,637.91,1104.00,0.00
2024-12-08 17:09:38,67,1082,30,37,628.38,1104.02,0.00
2024-12-08 17:09:38,67,1083,30,37,627.65,1105.00,0.00
2024-12-08 17:09:38,68,1083,30,38,618.42,1105.02,0.00
2024-12-08 17:09:38,67,1083,30,37,623.38,1105.12,0.00
2024-12-08 17:09:38,66,1083,29,37,632.66,1105.12,0.00
2024-12-08 17:09:38,66,1084,29,37,636.45,1106.00,0.00
2024-12-08 17:09:38,67,1084,30,37,626.95,1106.02,0.00
2024-12-08 17:09:38,66,1084,29,37,635.78,1106.06,0.00
2024-12-08 17:09:38,65,1084,28,37,642.30,1106.11,0.00
2024-12-08 17:09:38,65,1085,28,37,646.21,1107.00,0.00
2024-12-08 17:09:38,66,1085,29,37,636.42,1107.02,0.00
2024-12-08 17:09:38,65,1085,29,36,642.38,1107.11,0.00
2024-12-08 17:09:38,65,1086,29,36,646.27,1108.00,0.00
2024-12-08 17:09:38,66,1086,29,37,636.47,1108.02,0.00
2024-12-08 17:09:38,66,1087,29,37,635.82,1109.00,0.00
2024-12-08 17:09:38,67,1087,29,38,626.33,1109.02,0.00
2024-12-08 17:09:38,66,1087,29,37,631.47,1109.11,0.00
2024-12-08 17:09:38,66,1088,29,37,635.32,1110.00,0.00
2024-12-08 17:09:38,67,1088,30,37,625.84,1110.02,0.00
2024-12-08 17:09:38,66,1088,29,37,622.79,1110.64,0.00
2024-12-08 17:09:38,66,1089,29,37,635.88,1111.00,0.00
2024-12-08 17:09:38,67,1089,29,38,626.39,1111.02,0.00
2024-12-08 17:09:38,66,1089,28,38,635.71,1111.02,0.00
2024-12-08 17:09:38,65,1089,28,37,641.40,1111.09,0.00
2024-12-08 17:09:38,65,1090,28,37,645.56,1112.00,0.00
2024-12-08 17:09:38,66,1090,29,37,635.78,1112.02,0.00
2024-12-08 17:09:38,65,1090,28,37,645.39,1112.02,0.00
2024-12-08 17:09:38,65,1091,28,37,645.28,1113.00,0.00
2024-12-08 17:09:38,66,1091,28,38,635.51,1113.02,0.00
2024-12-08 17:09:38,65,1091,27,38,634.12,1113.42,0.00
2024-12-08 17:09:38,65,1092,27,38,645.12,1114.00,0.00
2024-12-08 17:09:38,66,1092,28,38,635.35,1114.02,0.00
2024-12-08 17:09:38,65,1092,28,37,641.53,1114.08,0.00
2024-12-08 17:09:38,65,1093,28,37,645.39,1115.00,0.00
2024-12-08 17:09:38,66,1093,29,37,635.61,1115.02,0.00
2024-12-08 17:09:38,65,1093,28,37,640.95,1115.11,0.00
2024-12-08 17:09:39,65,1094,28,37,648.51,1116.00,0.00
2024-12-08 17:09:39,66,1094,28,38,638.68,1116.02,0.00
2024-12-08 17:09:39,65,1094,28,37,644.23,1116.09,0.00
2024-12-08 17:09:39,65,1095,28,37,648.00,1117.00,0.00
2024-12-08 17:09:39,66,1095,29,37,638.18,1117.02,0.00
2024-12-08 17:09:39,66,1096,29,37,637.53,1118.00,0.00
2024-12-08 17:09:39,67,1096,30,37,628.02,1118.02,0.00
2024-12-08 17:09:39,66,1096,29,37,632.97,1118.12,0.00
2024-12-08 17:09:39,66,1097,29,37,636.52,1119.00,0.00
2024-12-08 17:09:39,67,1097,30,37,627.02,1119.02,0.00
2024-12-08 17:09:39,66,1097,30,36,632.46,1119.11,0.00
2024-12-08 17:09:39,66,1098,30,36,635.71,1120.00,0.00
2024-12-08 17:09:39,67,1098,31,36,626.22,1120.02,0.00
2024-12-08 17:09:39,66,1098,30,36,635.54,1120.02,0.00
2024-12-08 17:09:39,65,1098,29,36,639.66,1120.15,0.00
2024-12-08 17:09:39,65,1099,29,36,647.31,1121.00,0.00
2024-12-08 17:09:39,66,1099,30,36,637.50,1121.02,0.00
2024-12-08 17:09:39,66,1100,30,36,636.87,1122.00,0.00
2024-12-08 17:09:39,67,1100,30,37,627.37,1122.02,0.00
2024-12-08 17:09:39,66,1100,29,37,636.36,1122.05,0.00
2024-12-08 17:09:39,65,1100,29,36,645.14,1122.12,0.00
2024-12-08 17:09:39,65,1101,29,36,649.60,1123.00,0.00
2024-12-08 17:09:39,66,1101,29,37,639.76,1123.02,0.00
2024-12-08 17:09:39,65,1101,28,37,641.45,1123.43,0.00
2024-12-08 17:09:39,65,1102,28,37,649.32,1124.00,0.00
2024-12-08 17:09:39,66,1102,29,37,639.48,1124.02,0.00
2024-12-08 17:09:39,65,1102,29,36,647.61,1124.14,0.00
2024-12-08 17:09:39,65,1103,29,36,652.32,1125.00,0.00
2024-12-08 17:09:39,66,1103,30,36,642.43,1125.02,0.00
2024-12-08 17:09:39,65,1103,29,36,647.66,1125.12,0.00
2024-12-08 17:09:39,65,1104,29,36,652.20,1126.00,0.00
2024-12-08 17:09:39,66,1104,29,37,642.32,1126.02,0.00
2024-12-08 17:09:39,66,1105,29,37,641.95,1127.00,0.00
2024-12-08 17:09:39,67,1105,29,38,632.37,1127.02,0.00
2024-12-08 17:09:39,66,1105,28,38,640.77,1127.12,0.00
2024-12-08 17:09:39,66,1106,28,38,641.54,1128.00,0.00
2024-12-08 17:09:39,67,1106,29,38,631.97,1128.02,0.00
2024-12-08 17:09:39,66,1106,29,37,640.03,1128.14,0.00
2024-12-08 17:09:39,66,1107,29,37,644.41,1129.00,0.00
2024-12-08 17:09:39,67,1107,29,38,634.79,1129.02,0.00
2024-12-08 17:09:39,66,1107,28,38,642.89,1129.14,0.00
2024-12-08 17:09:39,66,1108,28,38,647.33,1130.00,0.00
2024-12-08 17:09:39,67,1108,28,39,637.67,1130.02,0.00
2024-12-08 17:09:39,66,1108,27,39,647.16,1130.02,0.00
2024-12-08 17:09:39,65,1108,27,38,655.39,1130.12,0.00
2024-12-08 17:09:39,65,1109,27,38,659.87,1131.00,0.00
2024-12-08 17:09:39,66,1109,28,38,649.87,1131.02,0.00
2024-12-08 17:09:39,66,1110,28,38,649.45,1132.00,0.00
2024-12-08 17:09:39,67,1110,29,38,639.76,1132.02,0.00
2024-12-08 17:09:39,66,1110,29,37,644.84,1132.12,0.00
2024-12-08 17:09:39,66,1111,29,37,648.48,1133.00,0.00
2024-12-08 17:09:39,67,1111,30,37,638.80,1133.02,0.00
2024-12-08 17:09:39,67,1112,30,37,637.42,1134.00,0.00
2024-12-08 17:09:39,68,1112,31,37,628.05,1134.02,0.00
2024-12-08 17:09:39,67,1112,31,36,632.45,1134.13,0.00
2024-12-08 17:09:39,66,1112,30,36,642.03,1134.14,0.00
2024-12-08 17:09:40,66,1113,30,36,645.45,1135.00,0.00
2024-12-08 17:09:40,67,1113,30,37,635.82,1135.02,0.00
2024-12-08 17:09:40,66,1113,29,37,644.94,1135.05,0.00
2024-12-08 17:09:40,65,1113,28,37,653.66,1135.14,0.00
2024-12-08 17:09:40,64,1113,28,36,660.89,1135.14,0.00
2024-12-08 17:09:40,64,1114,28,36,664.68,1136.00,0.00
2024-12-08 17:09:40,65,1114,29,36,654.46,1136.02,0.00
2024-12-08 17:09:40,64,1114,29,35,660.61,1136.11,0.00
2024-12-08 17:09:40,63,1114,28,35,663.55,1136.68,0.00
2024-12-08 17:09:40,63,1115,28,35,673.37,1137.00,0.00
2024-12-08 17:09:40,64,1115,28,36,662.85,1137.02,0.00
2024-12-08 17:09:40,64,1116,28,36,660.17,1138.00,0.00
2024-12-08 17:09:40,65,1116,29,36,650.01,1138.02,0.00
2024-12-08 17:09:40,64,1116,29,35,659.99,1138.02,0.00
2024-12-08 17:09:40,64,1117,29,35,656.53,1139.00,0.00
2024-12-08 17:09:40,65,1117,29,36,646.43,1139.02,0.00
2024-12-08 17:09:40,64,1117,28,36,654.21,1139.02,0.00
2024-12-08 17:09:40,63,1117,27,36,664.60,1139.02,0.00
2024-12-08 17:09:40,63,1118,27,36,664.32,1140.00,0.00
2024-12-08 17:09:40,64,1118,28,36,653.94,1140.02,0.00
2024-12-08 17:09:40,63,1118,28,35,661.07,1140.06,0.00
2024-12-08 17:09:40,63,1119,28,35,661.15,1141.00,0.00
2024-12-08 17:09:40,64,1119,28,36,650.82,1141.02,0.00
2024-12-08 17:09:40,63,1119,27,36,660.79,1141.03,0.00
2024-12-08 17:09:40,62,1119,27,35,668.32,1141.05,0.00
2024-12-08 17:09:40,62,1120,27,35,668.57,1142.00,0.00
2024-12-08 17:09:40,63,1120,28,35,657.96,1142.02,0.00
2024-12-08 17:09:40,62,1120,28,34,664.90,1142.07,0.00
2024-12-08 17:09:40,61,1120,27,34,663.84,1142.87,0.00
2024-12-08 17:09:40,61,1121,27,34,676.39,1143.00,0.00
2024-12-08 17:09:40,62,1121,28,34,665.48,1143.02,0.00
2024-12-08 17:09:40,62,1122,28,34,664.77,1144.00,0.00
2024-12-08 17:09:40,63,1122,29,34,654.22,1144.02,0.00
2024-12-08 17:09:40,62,1122,29,33,661.28,1144.07,0.00
2024-12-08 17:09:40,62,1123,29,33,664.60,1145.00,0.00
2024-12-08 17:09:40,63,1123,29,34,654.05,1145.02,0.00
2024-12-08 17:09:40,63,1124,29,34,652.85,1146.00,0.00
2024-12-08 17:09:40,64,1124,29,35,642.65,1146.02,0.00
2024-12-08 17:09:40,63,1124,29,34,649.41,1146.06,0.00
2024-12-08 17:09:40,63,1125,29,34,652.35,1147.00,0.00
2024-12-08 17:09:40,64,1125,29,35,642.16,1147.02,0.00
2024-12-08 17:09:40,64,1126,29,35,640.91,1148.00,0.00
2024-12-08 17:09:40,65,1126,29,36,631.05,1148.02,0.00
2024-12-08 17:09:40,64,1126,29,35,637.69,1148.06,0.00
2024-12-08 17:09:40,64,1127,29,35,640.86,1149.00,0.00
2024-12-08 17:09:40,65,1127,30,35,631.00,1149.02,0.00
2024-12-08 17:09:40,65,1128,30,35,630.43,1150.00,0.00
2024-12-08 17:09:40,66,1128,31,35,620.88,1150.02,0.00
2024-12-08 17:09:40,65,1128,31,34,627.07,1150.06,0.00
2024-12-08 17:09:40,65,1129,31,34,630.84,1151.00,0.00
2024-12-08 17:09:40,66,1129,32,34,621.28,1151.02,0.00
2024-12-08 17:09:40,66,1130,32,34,620.77,1152.00,0.00
2024-12-08 17:09:40,67,1130,33,34,611.51,1152.02,0.00
2024-12-08 17:09:40,66,1130,33,33,617.63,1152.06,0.00
2024-12-08 17:09:41,66,1131,33,33,621.13,1153.00,0.00
2024-12-08 17:09:41,67,1131,33,34,611.86,1153.02,0.00
2024-12-08 17:09:41,66,1131,32,34,616.09,1153.14,0.00
2024-12-08 17:09:41,66,1132,32,34,620.47,1154.00,0.00
2024-12-08 17:09:41,67,1132,32,35,611.21,1154.02,0.00
2024-12-08 17:09:41,66,1132,32,34,617.50,1154.06,0.00
2024-12-08 17:09:41,66,1133,32,34,620.90,1155.00,0.00
2024-12-08 17:09:41,67,1133,33,34,611.63,1155.02,0.00
2024-12-08 17:09:41,67,1134,33,34,610.78,1156.00,0.00
2024-12-08 17:09:41,68,1134,33,35,601.80,1156.02,0.00
2024-12-08 17:09:41,67,1134,32,35,607.17,1156.09,0.00
2024-12-08 17:09:41,66,1134,32,34,605.71,1156.70,0.00
2024-12-08 17:09:41,66,1135,32,34,619.96,1157.00,0.00
2024-12-08 17:09:41,67,1135,33,34,610.71,1157.02,0.00
2024-12-08 17:09:41,66,1135,32,34,619.44,1157.05,0.00
2024-12-08 17:09:41,65,1135,32,33,626.30,1157.06,0.00
2024-12-08 17:09:41,65,1136,32,33,630.22,1158.00,0.00
2024-12-08 17:09:41,66,1136,33,33,620.67,1158.02,0.00
2024-12-08 17:09:41,65,1136,33,32,627.02,1158.06,0.00
2024-12-08 17:09:41,65,1137,33,32,630.94,1159.00,0.00
2024-12-08 17:09:41,66,1137,33,33,621.38,1159.02,0.00
2024-12-08 17:09:41,66,1138,33,33,621.04,1160.00,0.00
2024-12-08 17:09:41,67,1138,33,34,611.77,1160.02,0.00
2024-12-08 17:09:41,66,1138,32,34,620.86,1160.02,0.00
2024-12-08 17:09:41,65,1138,32,33,627.39,1160.05,0.00
2024-12-08 17:09:41,65,1139,32,33,631.14,1161.00,0.00
2024-12-08 17:09:41,66,1139,32,34,621.58,1161.02,0.00
2024-12-08 17:09:41,66,1140,32,34,621.22,1162.00,0.00
2024-12-08 17:09:41,67,1140,33,34,611.95,1162.02,0.00
2024-12-08 17:09:41,66,1140,33,33,618.06,1162.06,0.00
2024-12-08 17:09:41,66,1141,33,33,621.66,1163.00,0.00
2024-12-08 17:09:41,67,1141,33,34,612.38,1163.02,0.00
2024-12-08 17:09:41,66,1141,32,34,616.41,1163.15,0.00
2024-12-08 17:09:41,66,1142,32,34,621.00,1164.00,0.00
2024-12-08 17:09:41,67,1142,32,35,611.73,1164.02,0.00
2024-12-08 17:09:41,66,1142,32,34,618.00,1164.06,0.00
2024-12-08 17:09:41,65,1142,31,34,616.17,1164.88,0.00
2024-12-08 17:09:41,65,1143,31,34,632.76,1165.00,0.00
2024-12-08 17:09:41,66,1143,32,34,623.18,1165.02,0.00
2024-12-08 17:09:41,66,1144,32,34,622.77,1166.00,0.00
2024-12-08 17:09:41,67,1144,32,35,613.48,1166.02,0.00
2024-12-08 17:09:41,66,1144,31,35,620.65,1166.05,0.00
2024-12-08 17:09:41,66,1145,31,35,624.10,1167.00,0.00
2024-12-08 17:09:41,67,1145,31,36,614.79,1167.02,0.00
2024-12-08 17:09:41,66,1145,31,35,623.92,1167.02,0.00
2024-12-08 17:09:41,65,1145,31,34,631.19,1167.03,0.00
2024-12-08 17:09:42,65,1146,31,34,634.62,1168.00,0.00
2024-12-08 17:09:42,66,1146,31,35,625.01,1168.02,0.00
2024-12-08 17:09:42,65,1146,31,34,632.29,1168.03,0.00
2024-12-08 17:09:42,64,1146,30,34,637.19,1168.28,0.00
2024-12-08 17:09:42,64,1147,30,34,647.52,1169.00,0.00
2024-12-08 17:09:42,65,1147,30,35,637.56,1169.02,0.00
2024-12-08 17:09:42,64,1147,29,35,637.87,1169.31,0.00
2024-12-08 17:09:42,64,1148,29,35,648.57,1170.00,0.00
2024-12-08 17:09:42,65,1148,30,35,638.59,1170.02,0.00
2024-12-08 17:09:42,64,1148,30,34,646.38,1170.03,0.00
2024-12-08 17:09:42,64,1149,30,34,649.92,1171.00,0.00
2024-12-08 17:09:42,65,1149,31,34,639.92,1171.02,0.00
2024-12-08 17:09:42,64,1149,30,34,644.20,1171.16,0.00
2024-12-08 17:09:42,64,1150,30,34,649.48,1172.00,0.00
2024-12-08 17:09:42,65,1150,30,35,639.49,1172.02,0.00
2024-12-08 17:09:42,64,1150,29,35,643.97,1172.11,0.00
2024-12-08 17:09:42,64,1151,29,35,648.72,1173.00,0.00
2024-12-08 17:09:42,65,1151,29,36,638.74,1173.02,0.00
2024-12-08 17:09:42,64,1151,29,35,646.89,1173.03,0.00
2024-12-08 17:09:42,63,1151,28,35,655.70,1173.14,0.00
2024-12-08 17:09:42,63,1152,28,35,661.07,1174.00,0.00
2024-12-08 17:09:42,64,1152,29,35,650.74,1174.02,0.00
2024-12-08 17:09:42,63,1152,29,34,659.21,1174.03,0.00
2024-12-08 17:09:42,64,1151,29,35,641.43,1174.39,0.00
2024-12-08 17:09:42,64,1152,29,35,664.43,1175.00,0.00
2024-12-08 17:09:42,65,1152,30,35,654.21,1175.02,0.00
2024-12-08 17:09:42,65,1153,30,35,672.14,1176.00,0.00
2024-12-08 17:09:42,66,1153,31,35,661.95,1176.02,0.00
2024-12-08 17:09:42,65,1153,31,34,670.33,1176.03,0.00
2024-12-08 17:09:42,65,1154,31,34,673.98,1177.00,0.00
2024-12-08 17:09:42,66,1154,32,34,663.77,1177.02,0.00
2024-12-08 17:09:42,66,1155,32,34,663.44,1178.00,0.00
2024-12-08 17:09:42,67,1155,32,35,653.53,1178.02,0.00
2024-12-08 17:09:42,66,1155,32,34,661.83,1178.03,0.00
2024-12-08 17:09:42,65,1155,31,34,670.78,1178.14,0.00
2024-12-08 17:09:42,65,1156,31,34,675.67,1179.00,0.00
2024-12-08 17:09:42,66,1156,31,35,665.43,1179.02,0.00
2024-12-08 17:09:42,66,1157,31,35,665.10,1180.00,0.00
2024-12-08 17:09:42,67,1157,32,35,655.17,1180.02,0.00
2024-12-08 17:09:43,66,1157,32,34,663.13,1180.05,0.00
2024-12-08 17:09:43,65,1157,31,34,672.10,1180.14,0.00
2024-12-08 17:09:43,65,1158,31,34,676.99,1181.00,0.00
2024-12-08 17:09:43,66,1158,31,35,666.74,1181.02,0.00
2024-12-08 17:09:43,66,1159,31,35,666.41,1182.00,0.00
2024-12-08 17:09:43,67,1159,32,35,656.46,1182.02,0.00
2024-12-08 17:09:43,66,1159,31,35,666.21,1182.03,0.00
2024-12-08 17:09:43,65,1159,31,34,675.00,1182.03,0.00
2024-12-08 17:09:43,65,1160,31,34,678.66,1183.00,0.00
2024-12-08 17:09:43,66,1160,32,34,668.38,1183.02,0.00
2024-12-08 17:09:43,66,1161,32,34,668.05,1184.00,0.00
2024-12-08 17:09:43,67,1161,33,34,658.08,1184.02,0.00
2024-12-08 17:09:43,66,1161,33,33,666.44,1184.03,0.00
2024-12-08 17:09:43,66,1162,33,33,669.87,1185.00,0.00
2024-12-08 17:09:43,67,1162,34,33,659.87,1185.02,0.00
2024-12-08 17:09:43,66,1162,33,33,669.15,1185.02,0.00
2024-12-08 17:09:43,65,1162,33,32,675.63,1185.02,0.00
2024-12-08 17:09:43,65,1163,33,32,682.77,1186.00,0.00
2024-12-08 17:09:43,66,1163,34,32,672.43,1186.02,0.00
2024-12-08 17:09:43,65,1163,33,32,678.05,1186.11,0.00
2024-12-08 17:09:43,65,1164,33,32,682.62,1187.00,0.00
2024-12-08 17:09:43,66,1164,33,33,672.27,1187.02,0.00
2024-12-08 17:09:43,65,1164,33,32,680.61,1187.03,0.00
2024-12-08 17:09:43,65,1165,33,32,684.29,1188.00,0.00
2024-12-08 17:09:43,66,1165,34,32,673.92,1188.02,0.00
2024-12-08 17:09:43,66,1166,34,32,673.59,1189.00,0.00
2024-12-08 17:09:43,67,1166,34,33,663.53,1189.02,0.00
2024-12-08 17:09:43,67,1167,34,33,663.03,1190.00,0.00
2024-12-08 17:09:43,68,1167,35,33,653.27,1190.02,0.00
2024-12-08 17:09:43,67,1167,35,32,660.37,1190.05,0.00
2024-12-08 17:09:43,67,1168,35,32,663.76,1191.00,0.00
2024-12-08 17:09:43,68,1168,36,32,654.00,1191.02,0.00
2024-12-08 17:09:43,67,1168,36,31,661.10,1191.05,0.00
2024-12-08 17:09:43,67,1169,36,31,664.50,1192.00,0.00
2024-12-08 17:09:43,68,1169,36,32,654.72,1192.02,0.00
2024-12-08 17:09:43,67,1169,35,32,652.89,1192.40,0.00
2024-12-08 17:09:43,67,1170,35,32,663.98,1193.00,0.00
2024-12-08 17:09:43,68,1170,35,33,654.22,1193.02,0.00
2024-12-08 17:09:43,67,1170,35,32,660.97,1193.06,0.00
2024-12-08 17:09:43,66,1170,34,32,670.11,1193.14,0.00
2024-12-08 17:09:43,65,1170,33,32,678.06,1193.22,0.00
2024-12-08 17:09:43,65,1171,33,32,687.56,1194.00,0.00
2024-12-08 17:09:43,66,1171,33,33,677.14,1194.02,0.00
2024-12-08 17:09:43,65,1171,32,33,680.41,1194.08,0.00
2024-12-08 17:09:43,65,1172,32,33,688.32,1195.00,0.00
2024-12-08 17:09:43,66,1172,33,33,677.89,1195.02,0.00
2024-12-08 17:09:43,65,1172,33,32,685.39,1195.06,0.00
2024-12-08 17:09:43,65,1173,33,32,689.45,1196.00,0.00
2024-12-08 17:09:43,66,1173,34,32,679.00,1196.02,0.00
2024-12-08 17:09:43,65,1173,33,32,674.32,1196.69,0.00
2024-12-08 17:09:43,65,1174,33,32,689.29,1197.00,0.00
2024-12-08 17:09:43,66,1174,33,33,678.84,1197.02,0.00
2024-12-08 17:09:43,65,1174,33,32,686.35,1197.06,0.00
2024-12-08 17:09:43,64,1174,32,32,696.54,1197.11,0.00
2024-12-08 17:09:43,63,1174,31,32,704.28,1197.38,0.00
2024-12-08 17:09:44,63,1175,31,32,712.52,1198.00,0.00
2024-12-08 17:09:44,64,1175,32,32,701.39,1198.02,0.00
2024-12-08 17:09:44,64,1176,32,32,701.41,1199.00,0.00
2024-12-08 17:09:44,65,1176,33,32,690.62,1199.02,0.00
2024-12-08 17:09:44,64,1176,33,31,698.61,1199.06,0.00
2024-12-08 17:09:44,63,1176,32,31,709.16,1199.11,0.00
2024-12-08 17:09:44,62,1176,31,31,719.07,1199.16,0.00
2024-12-08 17:09:44,62,1177,31,31,728.90,1200.00,0.00
2024-12-08 17:09:44,63,1177,32,31,717.33,1200.02,0.00
2024-12-08 17:09:44,63,1178,32,31,717.12,1201.00,0.00
2024-12-08 17:09:44,64,1178,33,31,705.92,1201.02,0.00
2024-12-08 17:09:44,63,1178,32,31,714.46,1201.02,0.00
2024-12-08 17:09:44,63,1179,32,31,717.59,1202.00,0.00
2024-12-08 17:09:44,64,1179,32,32,706.38,1202.02,0.00
2024-12-08 17:09:44,63,1179,32,31,713.80,1202.08,0.00
2024-12-08 17:09:44,63,1180,32,31,717.51,1203.00,0.00
2024-12-08 17:09:44,64,1180,33,31,706.29,1203.02,0.00
2024-12-08 17:09:44,63,1180,33,30,713.52,1203.08,0.00
2024-12-08 17:09:44,63,1181,33,30,717.25,1204.00,0.00
2024-12-08 17:09:44,64,1181,34,30,706.04,1204.02,0.00
2024-12-08 17:09:44,64,1181,34,30,705.01,1205.00,0.00
2024-12-08 17:09:44,65,1181,35,30,694.16,1205.02,0.00
2024-12-08 17:09:44,64,1181,35,29,697.30,1205.08,0.00
2024-12-08 17:09:44,64,1182,35,29,704.17,1206.00,0.00
2024-12-08 17:09:44,65,1182,35,30,693.34,1206.02,0.00
2024-12-08 17:09:44,65,1183,35,30,691.63,1207.00,0.00
2024-12-08 17:09:44,66,1183,35,31,681.15,1207.02,0.00
2024-12-08 17:09:44,65,1183,35,30,687.01,1207.11,0.00
2024-12-08 17:09:44,64,1183,34,30,690.97,1207.53,0.00
2024-12-08 17:09:44,64,1184,34,30,703.11,1208.00,0.00
2024-12-08 17:09:44,65,1184,34,31,692.29,1208.02,0.00
2024-12-08 17:09:44,65,1185,34,31,690.81,1209.00,0.00
2024-12-08 17:09:44,66,1185,35,31,680.34,1209.02,0.00
2024-12-08 17:09:44,65,1185,35,30,686.36,1209.11,0.00
2024-12-08 17:09:44,65,1186,35,30,689.80,1210.00,0.00
2024-12-08 17:09:44,66,1186,35,31,679.35,1210.02,0.00
2024-12-08 17:09:44,65,1186,34,31,680.39,1210.29,0.00
2024-12-08 17:09:44,65,1187,34,31,689.78,1211.00,0.00
2024-12-08 17:09:44,66,1187,34,32,679.33,1211.02,0.00
2024-12-08 17:09:44,65,1187,34,31,685.51,1211.11,0.00
2024-12-08 17:09:44,65,1188,34,31,689.05,1212.00,0.00
2024-12-08 17:09:44,66,1188,35,31,678.61,1212.02,0.00
2024-12-08 17:09:44,65,1188,34,31,683.48,1212.15,0.00
2024-12-08 17:09:44,65,1189,34,31,687.66,1213.00,0.00
2024-12-08 17:09:44,66,1189,34,32,677.24,1213.02,0.00
2024-12-08 17:09:44,65,1189,33,32,676.66,1213.51,0.00
2024-12-08 17:09:44,65,1190,33,32,688.69,1214.00,0.00
2024-12-08 17:09:44,66,1190,33,33,678.26,1214.02,0.00
2024-12-08 17:09:44,65,1190,33,32,684.78,1214.11,0.00
2024-12-08 17:09:44,66,1189,33,33,665.53,1214.83,0.00
2024-12-08 17:09:44,66,1190,33,33,680.41,1215.00,0.00
2024-12-08 17:09:44,67,1190,34,33,670.25,1215.02,0.00
2024-12-08 17:09:44,66,1190,34,32,675.46,1215.14,0.00
2024-12-08 17:09:44,66,1191,34,32,698.09,1216.00,0.00
2024-12-08 17:09:44,67,1191,35,32,687.67,1216.02,0.00
2024-12-08 17:09:45,67,1192,35,32,687.15,1217.00,0.00
2024-12-08 17:09:45,68,1192,35,33,677.04,1217.02,0.00
2024-12-08 17:09:45,67,1192,35,32,682.44,1217.13,0.00
2024-12-08 17:09:45,67,1193,35,32,686.99,1218.00,0.00
2024-12-08 17:09:45,68,1193,36,32,676.88,1218.02,0.00
2024-12-08 17:09:45,68,1194,36,32,676.18,1219.00,0.00
2024-12-08 17:09:45,69,1194,36,33,666.38,1219.02,0.00
2024-12-08 17:09:45,68,1194,35,33,676.00,1219.02,0.00
2024-12-08 17:09:45,68,1195,35,33,675.30,1220.00,0.00
2024-12-08 17:09:45,69,1195,35,34,665.52,1220.02,0.00
2024-12-08 17:09:45,68,1195,35,33,671.01,1220.12,0.00
2024-12-08 17:09:45,67,1195,34,33,676.59,1220.49,0.00
2024-12-08 17:09:45,67,1196,34,33,685.36,1221.00,0.00
2024-12-08 17:09:45,68,1196,34,34,675.28,1221.02,0.00
2024-12-08 17:09:45,67,1196,34,33,680.45,1221.13,0.00
2024-12-08 17:09:45,67,1197,34,33,685.00,1222.00,0.00
2024-12-08 17:09:45,68,1197,34,34,674.93,1222.02,0.00
2024-12-08 17:09:45,67,1197,33,34,678.47,1222.19,0.00
2024-12-08 17:09:45,67,1198,33,34,687.39,1223.00,0.00
2024-12-08 17:09:45,68,1198,34,34,677.28,1223.02,0.00
2024-12-08 17:09:45,67,1198,34,33,682.66,1223.13,0.00
2024-12-08 17:09:45,67,1199,34,33,687.22,1224.00,0.00
2024-12-08 17:09:45,68,1199,34,34,677.12,1224.02,0.00
2024-12-08 17:09:45,67,1199,33,34,687.04,1224.02,0.00
2024-12-08 17:09:45,66,1199,32,34,696.71,1224.06,0.00
2024-12-08 17:09:45,66,1200,32,34,696.91,1225.00,0.00
2024-12-08 17:09:45,67,1200,33,34,686.50,1225.02,0.00
2024-12-08 17:09:45,66,1200,33,33,692.64,1225.11,0.00
2024-12-08 17:09:45,66,1201,33,33,697.10,1226.00,0.00
2024-12-08 17:09:45,67,1201,34,33,686.70,1226.02,0.00
2024-12-08 17:09:45,66,1201,33,33,690.27,1226.20,0.00
2024-12-08 17:09:45,66,1202,33,33,699.53,1227.00,0.00
2024-12-08 17:09:45,67,1202,34,33,689.09,1227.02,0.00
2024-12-08 17:09:45,68,1201,35,33,662.56,1227.82,0.00
2024-12-08 17:09:45,68,1202,35,33,680.77,1228.00,0.00
2024-12-08 17:09:45,69,1202,35,34,670.91,1228.02,0.00
2024-12-08 17:09:45,68,1202,35,33,676.81,1228.10,0.00
2024-12-08 17:09:45,68,1203,35,33,698.86,1229.00,0.00
2024-12-08 17:09:45,69,1203,35,34,688.73,1229.02,0.00
2024-12-08 17:09:45,68,1203,35,33,694.89,1229.10,0.00
2024-12-08 17:09:45,67,1203,34,33,702.07,1229.37,0.00
2024-12-08 17:09:45,67,1204,34,33,709.50,1230.00,0.00
2024-12-08 17:09:45,68,1204,34,34,699.07,1230.02,0.00
2024-12-08 17:09:45,67,1204,33,34,708.95,1230.06,0.00
2024-12-08 17:09:45,66,1204,32,34,719.51,1230.06,0.00
2024-12-08 17:09:45,65,1204,31,34,722.93,1230.37,0.00
2024-12-08 17:09:45,65,1205,31,34,730.79,1231.00,0.00
2024-12-08 17:09:45,66,1205,31,35,719.72,1231.02,0.00
2024-12-08 17:09:45,66,1206,31,35,719.37,1232.00,0.00
2024-12-08 17:09:45,67,1206,31,36,708.63,1232.02,0.00
2024-12-08 17:09:45,66,1206,31,35,715.45,1232.09,0.00
2024-12-08 17:09:45,66,1207,31,35,719.76,1233.00,0.00
2024-12-08 17:09:45,67,1207,32,35,709.02,1233.02,0.00
2024-12-08 17:09:45,67,1208,32,35,708.49,1234.00,0.00
2024-12-08 17:09:45,68,1208,32,36,698.07,1234.02,0.00
2024-12-08 17:09:45,67,1208,31,36,708.31,1234.02,0.00
2024-12-08 17:09:45,66,1208,30,36,718.85,1234.02,0.00
2024-12-08 17:09:45,66,1209,30,36,718.50,1235.00,0.00
2024-12-08 17:09:45,67,1209,30,37,707.78,1235.02,0.00
2024-12-08 17:09:45,66,1209,30,36,715.32,1235.06,0.00
2024-12-08 17:09:45,65,1209,29,36,718.66,1235.37,0.00
2024-12-08 17:09:45,65,1210,29,36,730.33,1236.00,0.00
2024-12-08 17:09:46,66,1210,29,37,719.27,1236.02,0.00
2024-12-08 17:09:46,65,1210,29,36,727.10,1236.06,0.00
2024-12-08 17:09:46,65,1211,29,36,730.85,1237.00,0.00
2024-12-08 17:09:46,66,1211,29,37,719.78,1237.02,0.00
2024-12-08 17:09:46,65,1211,29,36,719.43,1237.26,0.00
2024-12-08 17:09:46,65,1212,29,36,729.85,1238.00,0.00
2024-12-08 17:09:46,66,1212,30,36,718.79,1238.02,0.00
2024-12-08 17:09:46,65,1212,29,36,729.47,1238.03,0.00
2024-12-08 17:09:46,64,1212,29,35,737.58,1238.06,0.00
2024-12-08 17:09:46,63,1212,28,35,745.76,1238.08,0.00
2024-12-08 17:09:46,63,1213,28,35,754.61,1239.00,0.00
2024-12-08 17:09:46,64,1213,28,36,742.82,1239.02,0.00
2024-12-08 17:09:46,64,1214,28,36,742.84,1240.00,0.00
2024-12-08 17:09:46,65,1214,28,37,731.41,1240.02,0.00
2024-12-08 17:09:46,64,1214,28,36,739.55,1240.06,0.00
2024-12-08 17:09:46,63,1214,27,36,747.55,1240.08,0.00
2024-12-08 17:09:46,63,1215,27,36,756.42,1241.00,0.00
2024-12-08 17:09:46,64,1215,27,37,744.60,1241.02,0.00
2024-12-08 17:09:46,64,1216,27,37,744.62,1242.00,0.00
2024-12-08 17:09:46,65,1216,28,37,733.16,1242.02,0.00
2024-12-08 17:09:46,64,1216,27,37,744.42,1242.02,0.00
2024-12-08 17:09:46,63,1216,27,36,753.28,1242.05,0.00
2024-12-08 17:09:46,63,1217,27,36,757.84,1243.00,0.00
2024-12-08 17:09:46,64,1217,28,36,745.99,1243.02,0.00
2024-12-08 17:09:46,63,1217,27,36,755.86,1243.03,0.00
2024-12-08 17:09:46,63,1218,27,36,760.22,1244.00,0.00
2024-12-08 17:09:46,64,1218,27,37,748.34,1244.02,0.00
2024-12-08 17:09:46,63,1218,26,37,751.74,1244.08,0.00
2024-12-08 17:09:46,63,1219,26,37,760.64,1245.00,0.00
2024-12-08 17:09:46,64,1219,26,38,748.75,1245.02,0.00
2024-12-08 17:09:46,63,1219,26,37,757.67,1245.03,0.00
2024-12-08 17:09:46,63,1220,26,37,762.04,1246.00,0.00
2024-12-08 17:09:46,64,1220,26,38,750.13,1246.02,0.00
2024-12-08 17:09:46,63,1220,26,37,761.84,1246.02,0.00
2024-12-08 17:09:46,62,1220,26,36,771.31,1246.02,0.00
2024-12-08 17:09:46,62,1221,26,36,775.75,1247.00,0.00
2024-12-08 17:09:46,63,1221,26,37,763.44,1247.02,0.00
2024-12-08 17:09:46,63,1222,26,37,763.66,1248.00,0.00
2024-12-08 17:09:46,64,1222,27,37,751.72,1248.02,0.00
2024-12-08 17:09:46,63,1222,27,36,760.88,1248.02,0.00
2024-12-08 17:09:46,63,1223,27,36,765.06,1249.00,0.00
2024-12-08 17:09:46,64,1223,27,37,753.11,1249.02,0.00
2024-12-08 17:09:46,64,1224,27,37,753.12,1250.00,0.00
2024-12-08 17:09:46,65,1224,27,38,741.54,1250.02,0.00
2024-12-08 17:09:46,64,1224,27,37,748.64,1250.06,0.00
2024-12-08 17:09:46,64,1225,27,37,753.14,1251.00,0.00
2024-12-08 17:09:46,65,1225,27,38,741.55,1251.02,0.00
2024-12-08 17:09:46,64,1225,26,38,745.95,1251.16,0.00
2024-12-08 17:09:46,64,1226,26,38,755.50,1252.00,0.00
2024-12-08 17:09:46,65,1226,26,39,743.88,1252.02,0.00
2024-12-08 17:09:46,64,1226,26,38,750.63,1252.08,0.00
2024-12-08 17:09:46,63,1226,25,38,760.18,1252.14,0.00
2024-12-08 17:09:46,63,1227,25,38,769.90,1253.00,0.00
2024-12-08 17:09:46,64,1227,26,38,757.87,1253.02,0.00
2024-12-08 17:09:46,64,1228,26,38,757.89,1254.00,0.00
2024-12-08 17:09:46,65,1228,26,39,746.23,1254.02,0.00
2024-12-08 17:09:46,64,1228,26,38,753.20,1254.08,0.00
2024-12-08 17:09:47,64,1229,26,38,757.90,1255.00,0.00
2024-12-08 17:09:47,65,1229,27,38,746.24,1255.02,0.00
2024-12-08 17:09:47,65,1230,27,38,746.06,1256.00,0.00
2024-12-08 17:09:47,66,1230,27,39,734.76,1256.02,0.00
2024-12-08 17:09:47,65,1230,26,39,734.03,1256.37,0.00
2024-12-08 17:09:47,65,1231,26,39,745.82,1257.00,0.00
2024-12-08 17:09:47,66,1231,27,39,734.52,1257.02,0.00
2024-12-08 17:09:47,65,1231,27,38,741.58,1257.08,0.00
2024-12-08 17:09:47,64,1231,26,38,753.16,1257.08,0.00
2024-12-08 17:09:47,64,1232,26,38,757.84,1258.00,0.00
2024-12-08 17:09:47,65,1232,27,38,746.18,1258.02,0.00
2024-12-08 17:09:47,64,1232,27,37,753.13,1258.08,0.00
2024-12-08 17:09:47,64,1233,27,37,757.85,1259.00,0.00
2024-12-08 17:09:47,65,1233,28,37,746.19,1259.02,0.00
2024-12-08 17:09:47,65,1234,28,37,746.01,1260.00,0.00
2024-12-08 17:09:47,66,1234,29,37,734.71,1260.02,0.00
2024-12-08 17:09:47,66,1235,29,37,734.33,1261.00,0.00
2024-12-08 17:09:47,67,1235,29,38,723.37,1261.02,0.00
2024-12-08 17:09:47,66,1235,28,38,733.58,1261.08,0.00
2024-12-08 17:09:47,66,1236,28,38,733.96,1262.00,0.00
2024-12-08 17:09:47,67,1236,28,39,723.01,1262.02,0.00
2024-12-08 17:09:47,66,1236,28,38,730.53,1262.09,0.00
2024-12-08 17:09:47,66,1237,28,38,734.92,1263.00,0.00
2024-12-08 17:09:47,67,1237,29,38,723.96,1263.02,0.00
2024-12-08 17:09:47,67,1238,29,38,723.40,1264.00,0.00
2024-12-08 17:09:47,68,1238,29,39,712.76,1264.02,0.00
2024-12-08 17:09:47,67,1238,28,39,723.40,1264.02,0.00
2024-12-08 17:09:47,66,1238,28,38,732.47,1264.12,0.00
2024-12-08 17:09:47,66,1239,28,38,737.01,1265.00,0.00
2024-12-08 17:09:47,67,1239,28,39,726.01,1265.02,0.00
2024-12-08 17:09:47,67,1240,28,39,725.45,1266.00,0.00
2024-12-08 17:09:47,68,1240,28,40,714.78,1266.02,0.00
2024-12-08 17:09:47,67,1240,27,40,725.26,1266.03,0.00
2024-12-08 17:09:47,67,1241,27,40,724.88,1267.00,0.00
2024-12-08 17:09:47,68,1241,27,41,714.22,1267.02,0.00
2024-12-08 17:09:47,67,1241,27,40,723.59,1267.10,0.00
2024-12-08 17:09:47,67,1242,27,40,727.92,1268.00,0.00
2024-12-08 17:09:47,68,1242,28,40,717.21,1268.02,0.00
2024-12-08 17:09:47,68,1243,28,40,716.40,1269.00,0.00
2024-12-08 17:09:47,69,1243,28,41,706.02,1269.02,0.00
2024-12-08 17:09:47,68,1243,27,41,705.87,1269.32,0.00
2024-12-08 17:09:47,68,1244,27,41,716.40,1270.00,0.00
2024-12-08 17:09:47,69,1244,27,42,706.02,1270.02,0.00
2024-12-08 17:09:47,68,1244,27,41,711.75,1270.10,0.00
2024-12-08 17:09:47,68,1245,27,41,715.55,1271.00,0.00
2024-12-08 17:09:47,69,1245,27,42,705.18,1271.02,0.00
2024-12-08 17:09:47,68,1245,27,41,710.53,1271.12,0.00
2024-12-08 17:09:47,68,1246,27,41,714.36,1272.00,0.00
2024-12-08 17:09:47,69,1246,28,41,704.01,1272.02,0.00
2024-12-08 17:09:47,68,1246,27,41,710.44,1272.03,0.00
2024-12-08 17:09:47,68,1247,27,41,712.98,1273.00,0.00
2024-12-08 17:09:47,69,1247,27,42,702.64,1273.02,0.00
2024-12-08 17:09:47,68,1247,26,42,711.69,1273.12,0.00
2024-12-08 17:09:47,67,1247,25,42,717.20,1273.16,0.00
2024-12-08 17:09:47,67,1248,25,42,725.13,1274.00,0.00
2024-12-08 17:09:47,68,1248,25,43,714.46,1274.02,0.00
2024-12-08 17:09:47,67,1248,25,42,720.58,1274.10,0.00
2024-12-08 17:09:47,67,1249,25,42,723.70,1275.00,0.00
2024-12-08 17:09:47,68,1249,25,43,713.06,1275.02,0.00
2024-12-08 17:09:47,67,1249,24,43,721.80,1275.02,0.00
2024-12-08 17:09:47,66,1249,24,42,728.12,1275.09,0.00
2024-12-08 17:09:48,66,1250,24,42,735.12,1276.00,0.00
2024-12-08 17:09:48,67,1250,24,43,724.15,1276.02,0.00
2024-12-08 17:09:48,67,1251,24,43,722.19,1277.00,0.00
2024-12-08 17:09:48,68,1251,25,43,711.57,1277.02,0.00
2024-12-08 17:09:48,67,1251,25,42,717.83,1277.09,0.00
2024-12-08 17:09:48,66,1251,24,42,723.11,1277.24,0.00
2024-12-08 17:09:48,66,1252,24,42,733.30,1278.00,0.00
2024-12-08 17:09:48,67,1252,24,43,722.35,1278.02,0.00
2024-12-08 17:09:48,66,1252,24,42,727.68,1278.15,0.00
2024-12-08 17:09:48,65,1252,23,42,731.71,1278.40,0.00
2024-12-08 17:09:48,65,1253,23,42,744.14,1279.00,0.00
2024-12-08 17:09:48,66,1253,23,43,732.86,1279.02,0.00
2024-12-08 17:09:48,66,1254,23,43,732.47,1280.00,0.00
2024-12-08 17:09:48,67,1254,24,43,721.53,1280.02,0.00
2024-12-08 17:09:48,67,1255,24,43,720.95,1281.00,0.00
2024-12-08 17:09:48,68,1255,24,44,710.35,1281.02,0.00
2024-12-08 17:09:48,67,1255,24,43,718.67,1281.09,0.00
2024-12-08 17:09:48,67,1256,24,43,722.85,1282.00,0.00
2024-12-08 17:09:48,68,1256,24,44,712.22,1282.02,0.00
2024-12-08 17:09:48,67,1256,23,44,722.85,1282.02,0.00
2024-12-08 17:09:48,66,1256,23,43,729.93,1282.08,0.00
2024-12-08 17:09:48,66,1257,23,43,734.18,1283.00,0.00
2024-12-08 17:09:48,67,1257,24,43,723.23,1283.02,0.00
2024-12-08 17:09:48,67,1258,24,43,722.64,1284.00,0.00
2024-12-08 17:09:48,68,1258,25,43,712.01,1284.02,0.00
2024-12-08 17:09:48,67,1258,24,43,719.24,1284.08,0.00
2024-12-08 17:09:48,66,1258,23,43,722.29,1284.39,0.00
2024-12-08 17:09:48,66,1259,23,43,734.40,1285.00,0.00
2024-12-08 17:09:48,67,1259,23,44,723.44,1285.02,0.00
2024-12-08 17:09:48,66,1259,23,43,730.71,1285.08,0.00
2024-12-08 17:09:48,66,1260,23,43,734.97,1286.00,0.00
2024-12-08 17:09:48,67,1260,24,43,724.00,1286.02,0.00
2024-12-08 17:09:48,66,1260,24,42,731.08,1286.08,0.00
2024-12-08 17:09:48,66,1261,24,42,735.34,1287.00,0.00
2024-12-08 17:09:48,67,1261,24,43,724.37,1287.02,0.00
2024-12-08 17:09:48,66,1261,23,43,730.10,1287.12,0.00
2024-12-08 17:09:48,65,1261,22,43,741.14,1287.12,0.00
2024-12-08 17:09:48,65,1262,22,43,746.25,1288.00,0.00
2024-12-08 17:09:48,66,1262,22,44,734.94,1288.02,0.00
2024-12-08 17:09:48,65,1262,22,43,742.49,1288.08,0.00
2024-12-08 17:09:48,65,1263,22,43,747.02,1289.00,0.00
2024-12-08 17:09:48,66,1263,23,43,735.71,1289.02,0.00
2024-12-08 17:09:48,65,1263,22,43,746.24,1289.06,0.00
2024-12-08 17:09:48,65,1264,22,43,746.61,1290.00,0.00
2024-12-08 17:09:48,66,1264,23,43,735.30,1290.02,0.00
2024-12-08 17:09:48,66,1265,23,43,734.89,1291.00,0.00
2024-12-08 17:09:48,67,1265,24,43,723.92,1291.02,0.00
2024-12-08 17:09:48,66,1265,24,42,731.57,1291.06,0.00
2024-12-08 17:09:48,66,1266,24,42,735.66,1292.00,0.00
2024-12-08 17:09:48,67,1266,24,43,724.68,1292.02,0.00
2024-12-08 17:09:48,66,1266,24,42,731.55,1292.08,0.00
2024-12-08 17:09:49,66,1267,24,42,735.83,1293.00,0.00
2024-12-08 17:09:49,67,1267,24,43,724.85,1293.02,0.00
2024-12-08 17:09:49,67,1268,24,43,724.25,1294.00,0.00
2024-12-08 17:09:49,68,1268,25,43,713.60,1294.02,0.00
2024-12-08 17:09:49,67,1268,25,42,720.40,1294.08,0.00
2024-12-08 17:09:49,67,1269,25,42,724.43,1295.00,0.00
2024-12-08 17:09:49,68,1269,25,43,713.77,1295.02,0.00
2024-12-08 17:09:49,68,1270,25,43,712.99,1296.00,0.00
2024-12-08 17:09:49,69,1270,26,43,702.66,1296.02,0.00
2024-12-08 17:09:49,68,1270,26,42,709.37,1296.07,0.00
2024-12-08 17:09:49,68,1271,26,42,713.16,1297.00,0.00
2024-12-08 17:09:49,69,1271,26,43,702.82,1297.02,0.00
2024-12-08 17:09:49,68,1271,25,43,700.32,1297.72,0.00
2024-12-08 17:09:49,68,1272,25,43,712.18,1298.00,0.00
2024-12-08 17:09:49,69,1272,26,43,701.86,1298.02,0.00
2024-12-08 17:09:49,68,1272,26,42,708.75,1298.07,0.00
2024-12-08 17:09:49,68,1273,26,42,712.54,1299.00,0.00
2024-12-08 17:09:49,69,1273,27,42,702.21,1299.02,0.00
2024-12-08 17:09:49,69,1274,27,42,701.25,1300.00,0.00
2024-12-08 17:09:49,70,1274,28,42,691.23,1300.01,0.00
2024-12-08 17:09:49,69,1274,28,41,698.05,1300.07,0.00
2024-12-08 17:09:49,68,1274,27,41,703.86,1300.43,0.00
2024-12-08 17:09:49,67,1274,26,41,714.17,1300.43,0.00
2024-12-08 17:09:49,67,1275,26,41,722.73,1301.00,0.00
2024-12-08 17:09:49,68,1275,26,42,712.11,1301.02,0.00
2024-12-08 17:09:49,68,1276,26,42,711.31,1302.00,0.00
2024-12-08 17:09:49,69,1276,26,43,701.00,1302.02,0.00
2024-12-08 17:09:49,68,1276,26,42,707.87,1302.09,0.00
2024-12-08 17:09:49,67,1276,25,42,717.11,1302.18,0.00
2024-12-08 17:09:49,67,1277,25,42,722.48,1303.00,0.00
2024-12-08 17:09:49,68,1277,26,42,711.86,1303.02,0.00
2024-12-08 17:09:49,67,1277,25,42,722.29,1303.02,0.00
2024-12-08 17:09:49,67,1278,25,42,721.68,1304.00,0.00
2024-12-08 17:09:49,68,1278,26,42,711.06,1304.02,0.00
2024-12-08 17:09:49,67,1278,25,42,721.48,1304.02,0.00
2024-12-08 17:09:49,67,1279,25,42,720.87,1305.00,0.00
2024-12-08 17:09:49,68,1279,25,43,710.27,1305.02,0.00
2024-12-08 17:09:49,67,1279,24,43,720.67,1305.02,0.00
2024-12-08 17:09:49,66,1279,23,43,731.39,1305.02,0.00
2024-12-08 17:09:49,65,1279,23,42,740.24,1305.03,0.00
2024-12-08 17:09:49,65,1280,23,42,744.22,1306.00,0.00
2024-12-08 17:09:49,66,1280,24,42,732.94,1306.02,0.00
2024-12-08 17:09:49,65,1280,24,41,741.81,1306.03,0.00
2024-12-08 17:09:49,65,1281,24,41,745.79,1307.00,0.00
2024-12-08 17:09:49,66,1281,25,41,734.49,1307.02,0.00
2024-12-08 17:09:49,65,1281,24,41,736.83,1307.26,0.00
2024-12-08 17:09:50,65,1282,24,41,747.77,1308.00,0.00
2024-12-08 17:09:50,66,1282,25,41,736.44,1308.02,0.00
2024-12-08 17:09:50,65,1282,24,41,741.78,1308.15,0.00
2024-12-08 17:09:50,65,1283,24,41,747.34,1309.00,0.00
2024-12-08 17:09:50,66,1283,25,41,736.01,1309.02,0.00
2024-12-08 17:09:50,65,1283,25,40,745.33,1309.03,0.00
2024-12-08 17:09:50,65,1284,25,40,749.32,1310.00,0.00
2024-12-08 17:09:50,66,1284,25,41,737.97,1310.02,0.00
2024-12-08 17:09:50,65,1284,25,40,747.11,1310.03,0.00
2024-12-08 17:09:50,65,1285,25,40,751.10,1311.00,0.00
2024-12-08 17:09:50,66,1285,26,40,739.72,1311.02,0.00
2024-12-08 17:09:50,66,1286,26,40,739.29,1312.00,0.00
2024-12-08 17:09:50,67,1286,26,41,728.26,1312.02,0.00
2024-12-08 17:09:50,66,1286,26,40,737.31,1312.03,0.00
2024-12-08 17:09:50,66,1287,26,40,741.05,1313.00,0.00
2024-12-08 17:09:50,67,1287,26,41,729.99,1313.02,0.00
2024-12-08 17:09:50,66,1287,25,41,734.93,1313.17,0.00
2024-12-08 17:09:50,66,1288,25,41,744.40,1314.00,0.00
2024-12-08 17:09:50,67,1288,26,41,733.29,1314.02,0.00
2024-12-08 17:09:50,66,1288,26,40,742.61,1314.03,0.00
2024-12-08 17:09:50,66,1289,26,40,746.36,1315.00,0.00
2024-12-08 17:09:50,67,1289,26,41,735.22,1315.02,0.00
2024-12-08 17:09:50,67,1290,26,41,734.60,1316.00,0.00
2024-12-08 17:09:50,68,1290,26,42,723.80,1316.02,0.00
2024-12-08 17:09:50,67,1290,26,41,732.64,1316.03,0.00
2024-12-08 17:09:50,67,1291,26,41,736.14,1317.00,0.00
2024-12-08 17:09:50,68,1291,26,42,725.32,1317.02,0.00
2024-12-08 17:09:50,67,1291,25,42,730.09,1317.16,0.00
2024-12-08 17:09:50,67,1292,25,42,735.33,1318.00,0.00
2024-12-08 17:09:50,68,1292,25,43,724.51,1318.02,0.00
2024-12-08 17:09:50,67,1292,25,42,733.56,1318.03,0.00
2024-12-08 17:09:50,66,1292,24,42,742.91,1318.15,0.00
2024-12-08 17:09:50,66,1293,24,42,748.23,1319.00,0.00
2024-12-08 17:09:50,67,1293,25,42,737.06,1319.02,0.00
2024-12-08 17:09:50,67,1294,25,42,736.44,1320.00,0.00
2024-12-08 17:09:50,68,1294,25,43,725.61,1320.02,0.00
2024-12-08 17:09:50,67,1294,25,42,734.87,1320.03,0.00
2024-12-08 17:09:50,66,1294,24,42,740.96,1320.41,0.00
2024-12-08 17:09:50,66,1295,24,42,749.57,1321.00,0.00
2024-12-08 17:09:50,67,1295,25,42,738.38,1321.02,0.00
2024-12-08 17:09:50,67,1296,25,42,737.61,1322.00,0.00
2024-12-08 17:09:50,68,1296,25,43,726.77,1322.02,0.00
2024-12-08 17:09:50,67,1296,25,42,736.23,1322.03,0.00
2024-12-08 17:09:50,66,1296,24,42,741.68,1322.44,0.00
2024-12-08 17:09:50,66,1297,24,42,750.70,1323.00,0.00
2024-12-08 17:09:50,67,1297,25,42,739.50,1323.02,0.00
2024-12-08 17:09:50,66,1297,24,42,744.72,1323.15,0.00
2024-12-08 17:09:50,66,1298,24,42,750.07,1324.00,0.00
2024-12-08 17:09:50,67,1298,24,43,738.87,1324.02,0.00
2024-12-08 17:09:50,66,1298,23,43,740.99,1324.41,0.00
2024-12-08 17:09:50,66,1299,23,43,749.63,1325.00,0.00
2024-12-08 17:09:50,67,1299,24,43,738.44,1325.02,0.00
2024-12-08 17:09:50,66,1299,24,42,748.43,1325.03,0.00
2024-12-08 17:09:51,66,1300,24,42,752.20,1326.00,0.00
2024-12-08 17:09:51,67,1300,25,42,740.98,1326.02,0.00
2024-12-08 17:09:51,66,1300,25,41,751.00,1326.03,0.00
2024-12-08 17:09:51,66,1301,25,41,754.78,1327.00,0.00
2024-12-08 17:09:51,67,1301,26,41,743.52,1327.02,0.00
2024-12-08 17:09:51,67,1302,26,41,742.89,1328.00,0.00
2024-12-08 17:09:51,68,1302,27,41,731.96,1328.02,0.00
2024-12-08 17:09:51,67,1302,27,40,741.90,1328.03,0.00
2024-12-08 17:09:51,66,1302,26,40,744.56,1328.70,0.00
2024-12-08 17:09:51,66,1303,26,40,756.88,1329.00,0.00
2024-12-08 17:09:51,67,1303,26,41,745.58,1329.02,0.00
2024-12-08 17:09:51,67,1304,26,41,744.29,1330.00,0.00
2024-12-08 17:09:51,68,1304,26,42,733.35,1330.02,0.00
2024-12-08 17:09:51,67,1304,26,41,743.50,1330.03,0.00
2024-12-08 17:09:51,67,1305,26,41,746.21,1331.00,0.00
2024-12-08 17:09:51,68,1305,27,41,735.23,1331.02,0.00
2024-12-08 17:09:51,68,1306,27,41,734.40,1332.00,0.00
2024-12-08 17:09:51,69,1306,27,42,723.76,1332.02,0.00
2024-12-08 17:09:51,69,1307,27,42,722.74,1333.00,0.00
2024-12-08 17:09:51,70,1307,28,42,712.41,1333.01,0.00
2024-12-08 17:09:51,69,1307,27,42,722.54,1333.02,0.00
2024-12-08 17:09:51,68,1307,27,41,732.78,1333.02,0.00
2024-12-08 17:09:51,67,1307,26,41,741.57,1333.18,0.00
2024-12-08 17:09:51,67,1308,26,41,746.94,1334.00,0.00
2024-12-08 17:09:51,68,1308,26,42,735.96,1334.02,0.00
2024-12-08 17:09:51,67,1308,26,41,746.34,1334.02,0.00
2024-12-08 17:09:51,67,1309,26,41,749.52,1335.00,0.00
2024-12-08 17:09:51,68,1309,26,42,738.50,1335.02,0.00
2024-12-08 17:09:51,68,1310,26,42,737.59,1336.00,0.00
2024-12-08 17:09:51,69,1310,27,42,726.90,1336.02,0.00
2024-12-08 17:09:51,68,1310,27,41,736.41,1336.02,0.00
2024-12-08 17:09:51,68,1311,27,41,739.52,1337.00,0.00
2024-12-08 17:09:51,69,1311,27,42,728.80,1337.02,0.00
2024-12-08 17:09:51,69,1312,27,42,727.77,1338.00,0.00
2024-12-08 17:09:51,70,1312,28,42,717.38,1338.01,0.00
2024-12-08 17:09:51,70,1313,28,42,715.48,1339.00,0.00
2024-12-08 17:09:51,71,1313,28,43,705.40,1339.01,0.00
2024-12-08 17:09:51,70,1313,28,42,714.14,1339.03,0.00
2024-12-08 17:09:51,69,1313,27,42,714.83,1339.58,0.00
2024-12-08 17:09:51,69,1314,27,42,728.93,1340.00,0.00
2024-12-08 17:09:51,70,1314,28,42,718.52,1340.01,0.00
2024-12-08 17:09:52,69,1314,28,41,728.35,1340.02,0.00
2024-12-08 17:09:52,69,1315,28,41,730.87,1341.00,0.00
2024-12-08 17:09:52,70,1315,28,42,720.43,1341.01,0.00
2024-12-08 17:09:52,70,1316,28,42,718.79,1342.00,0.00
2024-12-08 17:09:52,71,1316,29,42,708.67,1342.01,0.00
2024-12-08 17:09:52,70,1316,29,41,718.02,1342.01,0.00
2024-12-08 17:09:52,71,1315,30,41,704.07,1342.30,0.00
2024-12-08 17:09:52,70,1315,29,41,722.73,1342.43,0.00
2024-12-08 17:09:52,70,1316,29,41,734.63,1343.00,0.00
2024-12-08 17:09:52,71,1316,29,42,724.28,1343.01,0.00
2024-12-08 17:09:52,71,1317,29,42,741.00,1344.00,0.00
2024-12-08 17:09:52,72,1317,29,43,730.71,1344.01,0.00
2024-12-08 17:09:52,71,1317,29,42,740.44,1344.01,0.00
2024-12-08 17:09:52,71,1318,29,42,741.83,1345.00,0.00
2024-12-08 17:09:52,72,1318,29,43,731.53,1345.01,0.00
2024-12-08 17:09:52,72,1319,29,43,728.91,1346.00,0.00
2024-12-08 17:09:52,73,1319,29,44,718.92,1346.01,0.00
2024-12-08 17:09:52,72,1319,29,43,728.53,1346.01,0.00
2024-12-08 17:09:52,72,1320,29,43,729.61,1347.00,0.00
2024-12-08 17:09:52,73,1320,29,44,719.62,1347.01,0.00
2024-12-08 17:09:52,72,1320,28,44,729.24,1347.01,0.00
2024-12-08 17:09:52,72,1321,28,44,730.27,1348.00,0.00
2024-12-08 17:09:52,73,1321,29,44,720.27,1348.01,0.00
2024-12-08 17:09:52,72,1321,29,43,729.90,1348.01,0.00
2024-12-08 17:09:52,71,1321,29,42,737.96,1348.11,0.00
2024-12-08 17:09:52,71,1322,29,42,741.40,1349.00,0.00
2024-12-08 17:09:52,72,1322,29,43,731.10,1349.01,0.00
2024-12-08 17:09:52,72,1323,29,43,729.11,1350.00,0.00
2024-12-08 17:09:52,73,1323,29,44,719.13,1350.01,0.00
2024-12-08 17:09:52,72,1323,29,43,728.93,1350.01,0.00
2024-12-08 17:09:52,72,1324,29,43,730.40,1351.00,0.00
2024-12-08 17:09:52,73,1324,30,43,720.40,1351.01,0.00
2024-12-08 17:09:52,72,1324,30,42,726.46,1351.01,0.00
2024-12-08 17:09:52,71,1324,29,42,734.47,1351.18,0.00
2024-12-08 17:09:52,70,1324,28,42,742.82,1351.26,0.00
2024-12-08 17:09:52,70,1325,28,42,748.69,1352.00,0.00
2024-12-08 17:09:52,71,1325,29,42,738.15,1352.01,0.00
2024-12-08 17:09:52,70,1325,28,42,742.57,1352.19,0.00
2024-12-08 17:09:52,70,1326,28,42,747.51,1353.00,0.00
2024-12-08 17:09:52,71,1326,29,42,736.98,1353.01,0.00
2024-12-08 17:09:52,70,1326,29,41,747.32,1353.01,0.00
2024-12-08 17:09:52,70,1327,29,41,750.00,1354.00,0.00
2024-12-08 17:09:52,71,1327,30,41,739.43,1354.01,0.00
2024-12-08 17:09:52,70,1327,30,40,745.93,1354.01,0.00
2024-12-08 17:09:52,69,1327,29,40,747.28,1354.42,0.00
2024-12-08 17:09:52,69,1328,29,40,759.46,1355.00,0.00
2024-12-08 17:09:52,70,1328,30,40,748.61,1355.01,0.00
2024-12-08 17:09:52,69,1328,30,39,755.34,1355.02,0.00
2024-12-08 17:09:52,69,1329,30,39,758.25,1356.00,0.00
2024-12-08 17:09:52,70,1329,31,39,747.42,1356.01,0.00
2024-12-08 17:09:53,69,1329,31,38,754.13,1356.02,0.00
2024-12-08 17:09:53,69,1330,31,38,757.04,1357.00,0.00
2024-12-08 17:09:53,70,1330,31,39,746.23,1357.01,0.00
2024-12-08 17:09:53,70,1331,31,39,745.03,1358.00,0.00
2024-12-08 17:09:53,71,1331,31,40,734.54,1358.01,0.00
2024-12-08 17:09:53,70,1331,31,39,744.84,1358.01,0.00
2024-12-08 17:09:53,70,1332,31,39,747.52,1359.00,0.00
2024-12-08 17:09:53,71,1332,31,40,736.99,1359.01,0.00
2024-12-08 17:09:53,70,1332,30,40,730.74,1359.70,0.00
2024-12-08 17:09:53,70,1333,30,40,746.32,1360.00,0.00
2024-12-08 17:09:53,71,1333,31,40,735.81,1360.01,0.00
2024-12-08 17:09:53,70,1333,31,39,745.94,1360.01,0.00
2024-12-08 17:09:53,69,1333,30,39,754.24,1360.19,0.00
2024-12-08 17:09:53,68,1333,29,39,762.43,1360.41,0.00
2024-12-08 17:09:53,68,1334,29,39,770.84,1361.00,0.00
2024-12-08 17:09:53,69,1334,30,39,759.67,1361.02,0.00
2024-12-08 17:09:53,69,1335,30,39,758.65,1362.00,0.00
2024-12-08 17:09:53,70,1335,30,40,747.81,1362.01,0.00
2024-12-08 17:09:53,69,1335,30,39,758.45,1362.02,0.00
2024-12-08 17:09:53,69,1336,30,39,761.38,1363.00,0.00
2024-12-08 17:09:53,70,1336,31,39,750.50,1363.01,0.00
2024-12-08 17:09:53,69,1336,30,39,748.44,1363.70,0.00
2024-12-08 17:09:53,69,1337,30,39,760.36,1364.00,0.00
2024-12-08 17:09:53,70,1337,30,40,749.49,1364.01,0.00
2024-12-08 17:09:53,70,1338,30,40,748.29,1365.00,0.00
2024-12-08 17:09:53,71,1338,31,40,737.75,1365.01,0.00
2024-12-08 17:09:53,70,1338,31,39,748.09,1365.01,0.00
2024-12-08 17:09:53,69,1338,30,39,756.41,1365.20,0.00
2024-12-08 17:09:53,69,1339,30,39,761.87,1366.00,0.00
2024-12-08 17:09:53,70,1339,30,40,750.98,1366.01,0.00
2024-12-08 17:09:53,69,1339,30,39,761.28,1366.03,0.00
2024-12-08 17:09:53,68,1339,29,39,769.88,1366.09,0.00
2024-12-08 17:09:53,67,1339,28,39,776.62,1366.43,0.00
2024-12-08 17:09:53,67,1340,28,39,789.67,1367.00,0.00
2024-12-08 17:09:53,68,1340,29,39,778.06,1367.02,0.00
2024-12-08 17:09:53,68,1341,29,39,777.08,1368.00,0.00
2024-12-08 17:09:53,69,1341,30,39,765.82,1368.02,0.00
2024-12-08 17:09:53,68,1341,30,38,776.68,1368.03,0.00
2024-12-08 17:09:53,68,1342,30,38,779.97,1369.00,0.00
2024-12-08 17:09:53,69,1342,30,39,768.66,1369.02,0.00
2024-12-08 17:09:53,69,1343,30,39,767.64,1370.00,0.00
2024-12-08 17:09:53,70,1343,30,40,756.67,1370.01,0.00
2024-12-08 17:09:53,69,1343,30,39,766.66,1370.04,0.00
2024-12-08 17:09:53,69,1344,30,39,769.98,1371.00,0.00
2024-12-08 17:09:53,70,1344,31,39,758.98,1371.01,0.00
2024-12-08 17:09:53,70,1345,31,39,757.77,1372.00,0.00
2024-12-08 17:09:53,71,1345,31,40,747.10,1372.01,0.00
2024-12-08 17:09:53,70,1345,31,39,757.00,1372.04,0.00
2024-12-08 17:09:53,69,1345,30,39,762.74,1372.44,0.00
2024-12-08 17:09:54,69,1346,30,39,771.31,1373.00,0.00
2024-12-08 17:09:54,70,1346,31,39,760.29,1373.01,0.00
2024-12-08 17:09:54,69,1346,30,39,765.32,1373.12,0.00
2024-12-08 17:09:54,69,1347,30,39,773.62,1374.00,0.00
2024-12-08 17:09:54,70,1347,31,39,762.57,1374.01,0.00
2024-12-08 17:09:54,69,1347,31,38,773.07,1374.04,0.00
2024-12-08 17:09:54,69,1348,31,38,772.43,1375.00,0.00
2024-12-08 17:09:54,70,1348,32,38,761.39,1375.01,0.00
2024-12-08 17:09:54,69,1348,32,37,771.44,1375.04,0.00
2024-12-08 17:09:54,69,1349,32,37,774.78,1376.00,0.00
2024-12-08 17:09:54,70,1349,33,37,763.72,1376.01,0.00
2024-12-08 17:09:54,70,1350,33,37,762.50,1377.00,0.00
2024-12-08 17:09:54,71,1350,34,37,751.76,1377.01,0.00
2024-12-08 17:09:54,70,1350,34,36,760.94,1377.06,0.00
2024-12-08 17:09:54,70,1351,34,36,764.24,1378.00,0.00
2024-12-08 17:09:54,71,1351,34,37,753.47,1378.01,0.00
2024-12-08 17:09:54,70,1351,33,37,763.66,1378.04,0.00
2024-12-08 17:09:54,69,1351,32,37,764.82,1378.32,0.00
2024-12-08 17:09:54,69,1352,32,37,775.87,1379.00,0.00
2024-12-08 17:09:54,70,1352,33,37,764.79,1379.01,0.00
2024-12-08 17:09:54,69,1352,33,36,774.69,1379.04,0.00
2024-12-08 17:09:54,69,1353,33,36,778.04,1380.00,0.00
2024-12-08 17:09:54,70,1353,33,37,766.92,1380.01,0.00
2024-12-08 17:09:54,70,1354,33,37,765.37,1381.00,0.00
2024-12-08 17:09:54,71,1354,34,37,754.59,1381.01,0.00
2024-12-08 17:09:54,70,1354,33,37,764.52,1381.01,0.00
2024-12-08 17:09:54,69,1354,33,36,775.37,1381.03,0.00
2024-12-08 17:09:54,69,1355,33,36,778.53,1382.00,0.00
2024-12-08 17:09:54,70,1355,33,37,767.40,1382.01,0.00
2024-12-08 17:09:54,69,1355,32,37,776.74,1382.04,0.00
2024-12-08 17:09:54,68,1355,31,37,782.30,1382.18,0.00
2024-12-08 17:09:54,68,1356,31,37,791.77,1383.00,0.00
2024-12-08 17:09:54,69,1356,31,38,780.29,1383.02,0.00
2024-12-08 17:09:54,68,1356,31,37,789.75,1383.04,0.00
2024-12-08 17:09:54,68,1357,31,37,793.36,1384.00,0.00
2024-12-08 17:09:54,69,1357,31,38,781.86,1384.02,0.00
2024-12-08 17:09:54,68,1357,30,38,783.03,1384.18,0.00
2024-12-08 17:09:54,68,1358,30,38,792.50,1385.00,0.00
2024-12-08 17:09:54,69,1358,30,39,781.02,1385.02,0.00
2024-12-08 17:09:54,68,1358,29,39,790.68,1385.04,0.00
2024-12-08 17:09:54,67,1358,29,38,800.83,1385.05,0.00
2024-12-08 17:09:54,67,1359,29,38,808.84,1386.00,0.00
2024-12-08 17:09:54,68,1359,29,39,796.95,1386.02,0.00
2024-12-08 17:09:54,68,1360,29,39,796.10,1387.00,0.00
2024-12-08 17:09:54,69,1360,29,40,784.56,1387.02,0.00
2024-12-08 17:09:54,68,1360,29,39,794.27,1387.04,0.00
2024-12-08 17:09:54,68,1361,29,39,797.90,1388.00,0.00
2024-12-08 17:09:54,69,1361,29,40,786.33,1388.02,0.00
2024-12-08 17:09:54,69,1362,29,40,785.29,1389.00,0.00
2024-12-08 17:09:54,70,1362,30,40,774.07,1389.01,0.00
2024-12-08 17:09:54,69,1362,30,39,783.49,1389.04,0.00
2024-12-08 17:09:54,69,1363,30,39,786.86,1390.00,0.00
2024-12-08 17:09:54,70,1363,30,40,775.62,1390.01,0.00
2024-12-08 17:09:54,69,1363,29,40,772.62,1390.59,0.00
2024-12-08 17:09:54,69,1364,29,40,787.43,1391.00,0.00
2024-12-08 17:09:54,70,1364,30,40,776.18,1391.01,0.00
2024-12-08 17:09:54,69,1364,30,39,785.82,1391.04,0.00
2024-12-08 17:09:54,69,1365,30,39,789.20,1392.00,0.00
2024-12-08 17:09:55,70,1365,31,39,777.93,1392.01,0.00
2024-12-08 17:09:55,70,1366,31,39,776.70,1393.00,0.00
2024-12-08 17:09:55,71,1366,31,40,765.76,1393.01,0.00
2024-12-08 17:09:55,71,1367,31,40,764.34,1394.00,0.00
2024-12-08 17:09:55,72,1367,31,41,753.73,1394.01,0.00
2024-12-08 17:09:55,72,1368,31,41,752.14,1395.00,0.00
2024-12-08 17:09:55,73,1368,31,42,741.83,1395.01,0.00
2024-12-08 17:09:55,72,1368,31,41,750.79,1395.06,0.00
2024-12-08 17:09:55,72,1369,31,41,753.65,1396.00,0.00
2024-12-08 17:09:55,73,1369,31,42,743.32,1396.01,0.00
2024-12-08 17:09:55,72,1369,31,41,752.10,1396.06,0.00
2024-12-08 17:09:55,72,1370,31,41,754.96,1397.00,0.00
2024-12-08 17:09:55,73,1370,32,41,744.62,1397.01,0.00
2024-12-08 17:09:55,72,1370,32,40,754.39,1397.04,0.00
2024-12-08 17:09:55,71,1370,31,40,759.14,1397.18,0.00
2024-12-08 17:09:55,71,1371,31,40,763.86,1398.00,0.00
2024-12-08 17:09:55,72,1371,31,41,753.25,1398.01,0.00
2024-12-08 17:09:55,71,1371,31,40,762.49,1398.04,0.00
2024-12-08 17:09:55,70,1371,30,40,759.61,1398.89,0.00
2024-12-08 17:09:55,70,1372,30,40,778.09,1399.00,0.00
2024-12-08 17:09:55,71,1372,31,40,767.13,1399.01,0.00
2024-12-08 17:09:55,71,1373,31,40,765.71,1400.00,0.00
2024-12-08 17:09:55,72,1373,31,41,755.07,1400.01,0.00
2024-12-08 17:09:55,71,1373,30,41,763.35,1400.07,0.00
2024-12-08 17:09:55,71,1374,30,41,766.65,1401.00,0.00
2024-12-08 17:09:55,72,1374,30,42,756.00,1401.01,0.00
2024-12-08 17:09:55,71,1374,30,41,765.47,1401.04,0.00
2024-12-08 17:09:55,71,1375,30,41,768.38,1402.00,0.00
2024-12-08 17:09:55,72,1375,31,41,757.71,1402.01,0.00
2024-12-08 17:09:55,71,1375,31,40,766.22,1402.06,0.00
2024-12-08 17:09:55,70,1375,30,40,774.37,1402.09,0.00
2024-12-08 17:09:55,70,1376,30,40,782.12,1403.00,0.00
2024-12-08 17:09:55,71,1376,31,40,771.10,1403.01,0.00
2024-12-08 17:09:55,71,1377,31,40,769.68,1404.00,0.00
2024-12-08 17:09:55,72,1377,31,41,758.99,1404.01,0.00
2024-12-08 17:09:55,71,1377,31,40,767.71,1404.06,0.00
2024-12-08 17:09:55,70,1377,30,40,773.41,1404.44,0.00
2024-12-08 17:09:55,70,1378,30,40,782.03,1405.00,0.00
2024-12-08 17:09:55,71,1378,31,40,771.02,1405.01,0.00
2024-12-08 17:09:55,70,1378,30,40,781.43,1405.04,0.00
2024-12-08 17:09:55,70,1379,30,40,780.58,1406.00,0.00
2024-12-08 17:09:55,71,1379,31,40,769.59,1406.01,0.00
2024-12-08 17:09:55,70,1379,30,40,780.18,1406.03,0.00
2024-12-08 17:09:55,69,1379,30,39,790.06,1406.03,0.00
2024-12-08 17:09:55,69,1380,30,39,793.27,1407.00,0.00
2024-12-08 17:09:55,70,1380,30,40,781.94,1407.01,0.00
2024-12-08 17:09:55,70,1381,30,40,780.68,1408.00,0.00
2024-12-08 17:09:55,71,1381,31,40,769.69,1408.01,0.00
2024-12-08 17:09:55,70,1381,31,39,779.08,1408.03,0.00
2024-12-08 17:09:55,70,1382,31,39,782.04,1409.00,0.00
2024-12-08 17:09:55,71,1382,32,39,771.03,1409.01,0.00
2024-12-08 17:09:55,71,1383,32,39,769.59,1410.00,0.00
2024-12-08 17:09:55,72,1383,33,39,758.90,1410.01,0.00
2024-12-08 17:09:55,72,1384,33,39,757.28,1411.00,0.00
2024-12-08 17:09:55,73,1384,33,40,746.91,1411.01,0.00
2024-12-08 17:09:56,72,1384,33,39,756.11,1411.03,0.00
2024-12-08 17:09:56,73,1383,33,40,734.36,1411.60,0.00
2024-12-08 17:09:56,73,1384,33,40,754.36,1412.00,0.00
2024-12-08 17:09:56,74,1384,34,40,744.16,1412.01,0.00
2024-12-08 17:09:56,73,1384,34,39,753.01,1412.03,0.00
2024-12-08 17:09:56,73,1385,34,39,774.63,1413.00,0.00
2024-12-08 17:09:56,74,1385,35,39,764.17,1413.01,0.00
2024-12-08 17:09:56,73,1385,34,39,764.34,1413.47,0.00
2024-12-08 17:09:56,72,1385,33,39,771.77,1413.71,0.00
2024-12-08 17:09:56,72,1386,33,39,783.59,1414.00,0.00
2024-12-08 17:09:56,73,1386,34,39,772.86,1414.01,0.00
2024-12-08 17:09:56,72,1386,33,39,776.77,1414.22,0.00
2024-12-08 17:09:56,72,1387,33,39,781.98,1415.00,0.00
2024-12-08 17:09:56,73,1387,33,40,771.27,1415.01,0.00
2024-12-08 17:09:56,73,1388,33,40,769.49,1416.00,0.00
2024-12-08 17:09:56,74,1388,34,40,759.09,1416.01,0.00
2024-12-08 17:09:56,73,1388,34,39,768.52,1416.03,0.00
2024-12-08 17:09:56,73,1389,34,39,770.65,1417.00,0.00
2024-12-08 17:09:56,74,1389,35,39,760.24,1417.01,0.00
2024-12-08 17:09:56,73,1389,35,38,769.30,1417.04,0.00
2024-12-08 17:09:56,73,1390,35,38,770.90,1418.00,0.00
2024-12-08 17:09:56,74,1390,36,38,760.48,1418.01,0.00
2024-12-08 17:09:56,73,1390,36,37,768.77,1418.07,0.00
2024-12-08 17:09:56,73,1391,36,37,770.38,1419.00,0.00
2024-12-08 17:09:56,74,1391,36,38,759.97,1419.01,0.00
2024-12-08 17:09:56,74,1392,36,38,757.40,1420.00,0.00
2024-12-08 17:09:56,75,1392,37,38,747.30,1420.01,0.00
2024-12-08 17:09:56,74,1392,36,38,757.01,1420.03,0.00
2024-12-08 17:09:56,73,1392,36,37,766.41,1420.04,0.00
2024-12-08 17:09:56,73,1393,36,37,768.90,1421.00,0.00
2024-12-08 17:09:56,74,1393,36,38,758.50,1421.01,0.00
2024-12-08 17:09:56,74,1394,36,38,756.54,1422.00,0.00
2024-12-08 17:09:56,75,1394,37,38,746.45,1422.01,0.00
2024-12-08 17:09:56,75,1395,37,38,744.32,1423.00,0.00
2024-12-08 17:09:56,76,1395,38,38,734.53,1423.01,0.00
2024-12-08 17:09:56,75,1395,38,37,743.38,1423.04,0.00
2024-12-08 17:09:56,75,1396,38,37,745.41,1424.00,0.00
2024-12-08 17:09:56,76,1396,39,37,735.61,1424.01,0.00
2024-12-08 17:09:56,75,1396,39,36,744.47,1424.04,0.00
2024-12-08 17:09:56,75,1397,39,36,746.51,1425.00,0.00
2024-12-08 17:09:56,76,1397,39,37,736.69,1425.01,0.00
2024-12-08 17:09:56,76,1398,39,37,734.39,1426.00,0.00
2024-12-08 17:09:56,77,1398,40,37,724.85,1426.01,0.00
2024-12-08 17:09:56,76,1398,40,36,733.64,1426.04,0.00
2024-12-08 17:09:56,75,1398,39,36,740.02,1426.13,0.00
2024-12-08 17:09:56,74,1398,38,36,748.89,1426.22,0.00
2024-12-08 17:09:56,74,1399,38,36,757.18,1427.00,0.00
2024-12-08 17:09:56,75,1399,39,36,747.09,1427.01,0.00
2024-12-08 17:09:56,75,1400,39,36,743.97,1428.00,0.00
2024-12-08 17:09:56,76,1400,39,37,734.18,1428.01,0.00
2024-12-08 17:09:56,75,1400,38,37,737.16,1428.23,0.00
2024-12-08 17:09:56,75,1401,38,37,740.65,1429.00,0.00
2024-12-08 17:09:56,76,1401,38,38,730.91,1429.01,0.00
2024-12-08 17:09:56,75,1401,38,37,739.89,1429.05,0.00
2024-12-08 17:09:56,74,1401,37,37,747.61,1429.22,0.00
2024-12-08 17:09:56,74,1401,37,37,751.73,1430.00,0.00
2024-12-08 17:09:56,75,1401,38,37,741.70,1430.01,0.00
2024-12-08 17:09:56,74,1401,38,36,747.09,1430.05,0.00
2024-12-08 17:09:57,74,1402,38,36,749.48,1431.00,0.00
2024-12-08 17:09:57,75,1402,39,36,739.49,1431.01,0.00
2024-12-08 17:09:57,74,1402,39,35,746.78,1431.11,0.00
2024-12-08 17:09:57,73,1402,38,35,753.54,1431.27,0.00
2024-12-08 17:09:57,73,1403,38,35,763.22,1432.00,0.00
2024-12-08 17:09:57,74,1403,39,35,752.91,1432.01,0.00
2024-12-08 17:09:57,73,1403,38,35,762.64,1432.06,0.00
2024-12-08 17:09:57,73,1404,38,35,761.40,1433.00,0.00
2024-12-08 17:09:57,74,1404,39,35,751.11,1433.01,0.00
2024-12-08 17:09:57,73,1404,38,35,760.81,1433.06,0.00
2024-12-08 17:09:57,72,1404,37,35,758.16,1433.72,0.00
2024-12-08 17:09:57,72,1405,37,35,770.32,1434.00,0.00
2024-12-08 17:09:57,73,1405,38,35,759.77,1434.01,0.00
2024-12-08 17:09:57,72,1405,38,34,768.34,1434.08,0.00
2024-12-08 17:09:57,72,1406,38,34,771.65,1435.00,0.00
2024-12-08 17:09:57,73,1406,38,35,761.08,1435.01,0.00
2024-12-08 17:09:57,72,1406,38,34,769.67,1435.08,0.00
2024-12-08 17:09:57,72,1407,38,34,772.99,1436.00,0.00
2024-12-08 17:09:57,73,1407,39,34,762.40,1436.01,0.00
2024-12-08 17:09:57,73,1408,39,34,760.57,1437.00,0.00
2024-12-08 17:09:57,74,1408,39,35,750.29,1437.01,0.00
2024-12-08 17:09:57,73,1408,39,34,758.22,1437.10,0.00
2024-12-08 17:09:57,73,1409,39,34,761.49,1438.00,0.00
2024-12-08 17:09:57,74,1409,39,35,751.20,1438.01,0.00
2024-12-08 17:09:57,73,1409,39,34,757.66,1438.10,0.00
2024-12-08 17:09:57,73,1410,39,34,760.94,1439.00,0.00
2024-12-08 17:09:57,74,1410,40,34,750.65,1439.01,0.00
2024-12-08 17:09:57,73,1410,39,34,760.45,1439.01,0.00
2024-12-08 17:09:57,73,1411,39,34,758.61,1440.00,0.00
2024-12-08 17:09:57,74,1411,40,34,748.36,1440.01,0.00
2024-12-08 17:09:57,73,1411,40,33,756.25,1440.08,0.00
2024-12-08 17:09:57,72,1411,39,33,762.57,1440.15,0.00
2024-12-08 17:09:57,71,1411,38,33,772.92,1440.18,0.00
2024-12-08 17:09:57,71,1412,38,33,781.94,1441.00,0.00
2024-12-08 17:09:57,72,1412,38,34,771.08,1441.01,0.00
2024-12-08 17:09:57,72,1413,38,34,769.41,1442.00,0.00
2024-12-08 17:09:57,73,1413,39,34,758.87,1442.01,0.00
2024-12-08 17:09:57,72,1413,38,34,769.21,1442.01,0.00
2024-12-08 17:09:57,71,1413,38,33,777.61,1442.07,0.00
2024-12-08 17:09:57,70,1413,37,33,786.46,1442.09,0.00
2024-12-08 17:09:57,70,1414,37,33,794.42,1443.00,0.00
2024-12-08 17:09:57,71,1414,37,34,783.23,1443.01,0.00
2024-12-08 17:09:57,72,1413,37,35,771.55,1443.10,0.00
2024-12-08 17:09:57,72,1414,37,35,785.52,1444.00,0.00
2024-12-08 17:09:57,73,1414,37,36,774.76,1444.01,0.00
2024-12-08 17:09:57,72,1414,36,36,775.65,1444.43,0.00
2024-12-08 17:09:57,72,1415,36,36,803.93,1445.00,0.00
2024-12-08 17:09:57,73,1415,37,36,792.91,1445.01,0.00
2024-12-08 17:09:57,73,1416,37,36,791.09,1446.00,0.00
2024-12-08 17:09:57,74,1416,38,36,780.39,1446.01,0.00
2024-12-08 17:09:57,73,1416,38,35,788.72,1446.08,0.00
2024-12-08 17:09:57,73,1417,38,35,791.83,1447.00,0.00
2024-12-08 17:09:57,74,1417,38,36,781.13,1447.01,0.00
2024-12-08 17:09:57,73,1417,37,36,778.07,1447.71,0.00
2024-12-08 17:09:57,73,1418,37,36,790.00,1448.00,0.00
2024-12-08 17:09:57,74,1418,37,37,779.32,1448.01,0.00
2024-12-08 17:09:57,73,1418,36,37,789.80,1448.01,0.00
2024-12-08 17:09:57,73,1419,36,37,787.93,1449.00,0.00
2024-12-08 17:09:57,74,1419,37,37,777.28,1449.01,0.00
2024-12-08 17:09:57,73,1419,37,36,784.36,1449.06,0.00
2024-12-08 17:09:57,73,1420,37,36,786.91,1450.00,0.00
2024-12-08 17:09:57,74,1420,37,37,776.28,1450.01,0.00
2024-12-08 17:09:58,74,1421,37,37,773.81,1451.00,0.00
2024-12-08 17:09:58,75,1421,38,37,763.50,1451.01,0.00
2024-12-08 17:09:58,74,1421,38,36,771.27,1451.08,0.00
2024-12-08 17:09:58,73,1421,37,36,775.58,1451.36,0.00
2024-12-08 17:09:58,73,1422,37,36,785.74,1452.00,0.00
2024-12-08 17:09:58,74,1422,37,37,775.12,1452.01,0.00
2024-12-08 17:09:58,74,1423,37,37,772.04,1453.00,0.00
2024-12-08 17:09:58,75,1423,38,37,761.75,1453.01,0.00
2024-12-08 17:09:58,75,1424,38,37,758.29,1454.00,0.00
2024-12-08 17:09:58,76,1424,39,37,748.31,1454.01,0.00
2024-12-08 17:09:58,75,1424,38,37,758.10,1454.01,0.00
2024-12-08 17:09:58,75,1425,38,37,754.42,1455.00,0.00
2024-12-08 17:09:58,76,1425,38,38,744.49,1455.01,0.00
2024-12-08 17:09:58,75,1425,37,38,754.22,1455.01,0.00
2024-12-08 17:09:58,74,1425,37,37,760.49,1455.05,0.00
2024-12-08 17:09:58,74,1426,37,37,761.29,1456.00,0.00
2024-12-08 17:09:58,75,1426,37,38,751.14,1456.01,0.00
2024-12-08 17:09:58,74,1426,37,37,759.13,1456.07,0.00
2024-12-08 17:09:58,73,1426,37,36,763.69,1456.41,0.00
2024-12-08 17:09:58,73,1427,37,36,771.41,1457.00,0.00
2024-12-08 17:09:58,74,1427,37,37,760.99,1457.01,0.00
2024-12-08 17:09:58,73,1427,36,37,770.81,1457.04,0.00
2024-12-08 17:09:58,73,1428,36,37,769.34,1458.00,0.00
2024-12-08 17:09:58,74,1428,37,37,758.95,1458.01,0.00
2024-12-08 17:09:58,73,1428,37,36,767.55,1458.06,0.00
2024-12-08 17:09:58,72,1428,36,36,772.67,1458.44,0.00
2024-12-08 17:09:58,72,1429,36,36,781.17,1459.00,0.00
2024-12-08 17:09:58,73,1429,37,36,770.47,1459.01,0.00
2024-12-08 17:09:58,73,1430,37,36,768.60,1460.00,0.00
2024-12-08 17:09:58,74,1430,38,36,758.21,1460.01,0.00
2024-12-08 17:09:58,73,1430,37,36,768.40,1460.01,0.00
2024-12-08 17:09:58,73,1431,37,36,766.52,1461.00,0.00
2024-12-08 17:09:58,74,1431,37,37,756.16,1461.01,0.00
2024-12-08 17:09:58,73,1431,36,37,766.12,1461.03,0.00
2024-12-08 17:09:58,72,1431,36,36,775.95,1461.03,0.00
2024-12-08 17:09:58,72,1432,36,36,778.51,1462.00,0.00
2024-12-08 17:09:58,73,1432,36,37,767.85,1462.01,0.00
2024-12-08 17:09:58,72,1432,36,36,777.50,1462.03,0.00
2024-12-08 17:09:58,72,1433,36,36,780.06,1463.00,0.00
2024-12-08 17:09:58,73,1433,36,37,769.38,1463.01,0.00
2024-12-08 17:09:58,73,1434,36,37,767.50,1464.00,0.00
2024-12-08 17:09:58,74,1434,37,37,757.12,1464.01,0.00
2024-12-08 17:09:58,73,1434,37,36,766.69,1464.03,0.00
2024-12-08 17:09:58,73,1435,37,36,769.02,1465.00,0.00
2024-12-08 17:09:58,74,1435,38,36,758.63,1465.01,0.00
2024-12-08 17:09:58,73,1435,37,36,762.81,1465.07,0.00
2024-12-08 17:09:58,73,1436,37,36,769.75,1466.00,0.00
2024-12-08 17:09:58,74,1436,37,37,759.35,1466.01,0.00
2024-12-08 17:09:58,73,1436,36,37,761.74,1466.12,0.00
2024-12-08 17:09:58,73,1437,36,37,769.47,1467.00,0.00
2024-12-08 17:09:58,74,1437,36,38,759.07,1467.01,0.00
2024-12-08 17:09:58,73,1437,36,37,769.07,1467.03,0.00
2024-12-08 17:09:58,73,1438,36,37,771.40,1468.00,0.00
2024-12-08 17:09:58,74,1438,36,38,760.98,1468.01,0.00
2024-12-08 17:09:58,73,1438,36,37,771.00,1468.03,0.00
2024-12-08 17:09:58,73,1439,36,37,773.34,1469.00,0.00
2024-12-08 17:09:58,74,1439,37,37,762.89,1469.01,0.00
2024-12-08 17:09:58,73,1439,36,37,766.14,1469.22,0.00
2024-12-08 17:09:58,73,1440,36,37,771.24,1470.00,0.00
2024-12-08 17:09:58,74,1440,37,37,760.82,1470.01,0.00
2024-12-08 17:09:58,73,1440,37,36,770.84,1470.03,0.00
2024-12-08 17:09:59,73,1441,37,36,773.18,1471.00,0.00
2024-12-08 17:09:59,74,1441,38,36,762.73,1471.01,0.00
2024-12-08 17:09:59,74,1442,38,36,760.66,1472.00,0.00
2024-12-08 17:09:59,75,1442,39,36,750.52,1472.01,0.00
2024-12-08 17:09:59,74,1442,39,35,760.07,1472.03,0.00
2024-12-08 17:09:59,73,1442,38,35,764.57,1472.44,0.00
2024-12-08 17:09:59,73,1443,38,35,772.82,1473.00,0.00
2024-12-08 17:09:59,74,1443,38,36,762.38,1473.01,0.00
2024-12-08 17:09:59,73,1443,37,36,765.60,1473.22,0.00
2024-12-08 17:09:59,72,1443,36,36,773.25,1473.43,0.00
2024-12-08 17:09:59,72,1444,36,36,781.63,1474.00,0.00
2024-12-08 17:09:59,73,1444,37,36,770.92,1474.01,0.00
2024-12-08 17:09:59,72,1444,36,36,781.42,1474.01,0.00
2024-12-08 17:09:59,71,1444,36,35,792.22,1474.01,0.00
2024-12-08 17:09:59,71,1445,36,35,794.47,1475.00,0.00
2024-12-08 17:09:59,72,1445,37,35,783.44,1475.01,0.00
2024-12-08 17:09:59,72,1446,37,35,781.04,1476.00,0.00
2024-12-08 17:09:59,73,1446,37,36,770.34,1476.01,0.00
2024-12-08 17:09:59,72,1446,37,35,776.94,1476.01,0.00
2024-12-08 17:09:59,71,1446,37,34,787.68,1476.01,0.00
2024-12-08 17:09:59,71,1447,37,34,789.44,1477.00,0.00
2024-12-08 17:09:59,72,1447,38,34,778.47,1477.01,0.00
2024-12-08 17:09:59,71,1447,37,34,782.61,1477.20,0.00
2024-12-08 17:09:59,71,1448,37,34,787.06,1478.00,0.00
2024-12-08 17:09:59,72,1448,37,35,776.13,1478.01,0.00
2024-12-08 17:09:59,71,1448,37,34,786.85,1478.01,0.00
2024-12-08 17:09:59,71,1449,37,34,788.79,1479.00,0.00
2024-12-08 17:09:59,72,1449,38,34,777.84,1479.01,0.00
2024-12-08 17:09:59,72,1450,38,34,775.64,1480.00,0.00
2024-12-08 17:09:59,73,1450,39,34,765.02,1480.01,0.00
2024-12-08 17:09:59,72,1450,38,34,775.64,1480.01,0.00
2024-12-08 17:09:59,71,1450,38,33,786.36,1480.01,0.00
2024-12-08 17:09:59,71,1451,38,33,784.38,1481.00,0.00
2024-12-08 17:09:59,72,1451,38,34,773.49,1481.01,0.00
2024-12-08 17:09:59,71,1451,38,33,780.00,1481.01,0.00
2024-12-08 17:09:59,70,1451,37,33,788.85,1481.17,0.00
2024-12-08 17:09:59,70,1452,37,33,793.56,1482.00,0.00
2024-12-08 17:09:59,71,1452,38,33,782.38,1482.01,0.00
2024-12-08 17:09:59,70,1452,38,32,792.92,1482.01,0.00
2024-12-08 17:09:59,70,1453,38,32,795.30,1483.00,0.00
2024-12-08 17:09:59,71,1453,39,32,784.10,1483.01,0.00
2024-12-08 17:09:59,70,1453,38,32,789.16,1483.06,0.00
2024-12-08 17:09:59,69,1453,37,32,795.57,1483.41,0.00
2024-12-08 17:09:59,69,1454,37,32,808.10,1484.00,0.00
2024-12-08 17:09:59,70,1454,37,33,796.56,1484.01,0.00
2024-12-08 17:09:59,69,1454,37,32,806.82,1484.04,0.00
2024-12-08 17:09:59,69,1455,37,32,809.66,1485.00,0.00
2024-12-08 17:09:59,70,1455,38,32,798.09,1485.01,0.00
2024-12-08 17:09:59,70,1456,38,32,795.79,1486.00,0.00
2024-12-08 17:09:59,71,1456,39,32,784.58,1486.01,0.00
2024-12-08 17:09:59,70,1456,38,32,795.79,1486.01,0.00
2024-12-08 17:09:59,69,1456,38,31,805.60,1486.04,0.00
2024-12-08 17:09:59,68,1456,37,31,812.92,1486.24,0.00
2024-12-08 17:09:59,67,1456,36,31,822.70,1486.40,0.00
2024-12-08 17:09:59,67,1457,36,31,835.04,1487.00,0.00
2024-12-08 17:09:59,68,1457,37,31,822.76,1487.02,0.00
2024-12-08 17:09:59,68,1458,37,31,820.72,1488.00,0.00
2024-12-08 17:09:59,69,1458,37,32,808.83,1488.02,0.00
2024-12-08 17:09:59,69,1459,37,32,807.23,1489.00,0.00
2024-12-08 17:09:59,70,1459,38,32,795.70,1489.01,0.00
2024-12-08 17:09:59,69,1459,38,31,805.08,1489.06,0.00
2024-12-08 17:09:59,69,1460,38,31,808.85,1490.00,0.00
2024-12-08 17:09:59,70,1460,38,32,797.30,1490.01,0.00
2024-12-08 17:09:59,69,1460,37,32,808.42,1490.03,0.00
2024-12-08 17:09:59,68,1460,37,31,817.69,1490.06,0.00
2024-12-08 17:09:59,67,1460,36,31,826.34,1490.09,0.00
2024-12-08 17:10:00,67,1461,36,31,835.56,1491.00,0.00
2024-12-08 17:10:00,68,1461,37,31,823.27,1491.02,0.00
2024-12-08 17:10:00,68,1462,37,31,822.29,1492.00,0.00
2024-12-08 17:10:00,69,1462,38,31,810.37,1492.02,0.00
2024-12-08 17:10:00,68,1462,37,31,810.83,1492.46,0.00
2024-12-08 17:10:00,68,1463,37,31,825.04,1493.00,0.00
2024-12-08 17:10:00,69,1463,38,31,813.08,1493.02,0.00
2024-12-08 17:10:00,68,1463,38,30,822.41,1493.06,0.00
2024-12-08 17:10:00,68,1464,38,30,826.47,1494.00,0.00
2024-12-08 17:10:00,69,1464,38,31,814.49,1494.02,0.00
2024-12-08 17:10:00,68,1464,38,30,822.75,1494.09,0.00
2024-12-08 17:10:00,68,1465,38,30,827.24,1495.00,0.00
2024-12-08 17:10:00,69,1465,39,30,815.25,1495.02,0.00
2024-12-08 17:10:00,68,1465,38,30,827.02,1495.03,0.00
2024-12-08 17:10:00,67,1465,37,30,830.02,1495.12,0.00
2024-12-08 17:10:00,67,1466,37,30,839.70,1496.00,0.00
2024-12-08 17:10:00,68,1466,37,31,827.35,1496.02,0.00
2024-12-08 17:10:00,68,1467,37,31,826.37,1497.00,0.00
2024-12-08 17:10:00,69,1467,37,32,814.39,1497.02,0.00
2024-12-08 17:10:00,68,1467,37,31,822.64,1497.09,0.00
2024-12-08 17:10:00,68,1468,37,31,827.14,1498.00,0.00
2024-12-08 17:10:00,69,1468,37,32,815.15,1498.02,0.00
2024-12-08 17:10:00,68,1468,37,31,823.41,1498.09,0.00
2024-12-08 17:10:00,68,1469,37,31,827.91,1499.00,0.00
2024-12-08 17:10:00,69,1469,38,31,815.91,1499.02,0.00
2024-12-08 17:10:00,68,1469,37,31,816.70,1499.16,0.00
2024-12-08 17:10:00,68,1470,37,31,826.70,1500.00,0.00
2024-12-08 17:10:00,69,1470,38,31,814.72,1500.02,0.00
2024-12-08 17:10:00,68,1470,37,31,819.89,1500.16,0.00
2024-12-08 17:10:00,68,1471,37,31,825.48,1501.00,0.00
2024-12-08 17:10:00,69,1471,37,32,813.52,1501.02,0.00
2024-12-08 17:10:00,68,1471,37,31,820.86,1501.10,0.00
2024-12-08 17:10:00,68,1472,37,31,825.59,1502.00,0.00
2024-12-08 17:10:00,69,1472,37,32,813.63,1502.02,0.00
2024-12-08 17:10:00,68,1472,37,31,820.53,1502.12,0.00
2024-12-08 17:10:00,68,1473,37,31,825.48,1503.00,0.00
2024-12-08 17:10:00,69,1473,38,31,813.52,1503.02,0.00
2024-12-08 17:10:00,68,1473,37,31,814.11,1503.29,0.00
2024-12-08 17:10:00,68,1474,37,31,826.06,1504.00,0.00
2024-12-08 17:10:00,69,1474,38,31,814.09,1504.02,0.00
2024-12-08 17:10:00,69,1475,38,31,812.89,1505.00,0.00
2024-12-08 17:10:00,70,1475,38,32,801.27,1505.01,0.00
2024-12-08 17:10:00,69,1475,38,31,808.54,1505.12,0.00
2024-12-08 17:10:00,69,1476,38,31,813.21,1506.00,0.00
2024-12-08 17:10:00,70,1476,38,32,801.59,1506.01,0.00
2024-12-08 17:10:00,69,1476,37,32,812.99,1506.02,0.00
2024-12-08 17:10:00,68,1476,37,31,820.09,1506.10,0.00
2024-12-08 17:10:01,68,1477,37,31,824.83,1507.00,0.00
2024-12-08 17:10:01,69,1477,37,32,812.88,1507.02,0.00
2024-12-08 17:10:01,68,1477,36,32,823.95,1507.06,0.00
2024-12-08 17:10:01,67,1477,35,32,829.31,1507.18,0.00
2024-12-08 17:10:01,67,1478,35,32,839.95,1508.00,0.00
2024-12-08 17:10:01,68,1478,36,32,827.60,1508.02,0.00
2024-12-08 17:10:01,67,1478,36,31,835.23,1508.09,0.00
2024-12-08 17:10:01,67,1479,36,31,840.05,1509.00,0.00
2024-12-08 17:10:01,68,1479,36,32,827.70,1509.02,0.00
2024-12-08 17:10:01,68,1480,36,32,826.69,1510.00,0.00
2024-12-08 17:10:01,69,1480,37,32,814.71,1510.02,0.00
2024-12-08 17:10:01,68,1480,37,31,822.48,1510.09,0.00
2024-12-08 17:10:01,67,1480,36,31,830.71,1510.10,0.00
2024-12-08 17:10:01,66,1480,35,31,839.06,1510.39,0.00
2024-12-08 17:10:01,66,1481,35,31,853.23,1511.00,0.00
2024-12-08 17:10:01,67,1481,36,31,840.49,1511.02,0.00
2024-12-08 17:10:01,67,1482,36,31,839.69,1512.00,0.00
2024-12-08 17:10:01,68,1482,37,31,827.34,1512.02,0.00
2024-12-08 17:10:01,67,1482,37,30,835.64,1512.09,0.00
2024-12-08 17:10:01,67,1483,37,30,840.47,1513.00,0.00
2024-12-08 17:10:01,68,1483,38,30,828.11,1513.02,0.00
2024-12-08 17:10:01,68,1484,38,30,827.10,1514.00,0.00
2024-12-08 17:10:01,69,1484,39,30,815.12,1514.02,0.00
2024-12-08 17:10:01,69,1485,39,30,813.90,1515.00,0.00
2024-12-08 17:10:01,70,1485,40,30,802.27,1515.01,0.00
2024-12-08 17:10:01,69,1485,40,29,809.95,1515.09,0.00
2024-12-08 17:10:01,69,1486,40,29,814.22,1516.00,0.00
2024-12-08 17:10:01,70,1486,40,30,802.58,1516.01,0.00
2024-12-08 17:10:01,70,1487,40,30,801.16,1517.00,0.00
2024-12-08 17:10:01,71,1487,40,31,789.88,1517.01,0.00
2024-12-08 17:10:01,70,1487,39,31,800.30,1517.07,0.00
2024-12-08 17:10:01,69,1487,39,30,809.26,1517.07,0.00
2024-12-08 17:10:01,69,1488,39,30,813.31,1518.00,0.00
2024-12-08 17:10:01,70,1488,40,30,801.69,1518.01,0.00
2024-12-08 17:10:01,69,1488,39,30,813.09,1518.02,0.00
2024-12-08 17:10:01,68,1488,39,29,821.48,1518.06,0.00
2024-12-08 17:10:01,68,1489,39,29,825.41,1519.00,0.00
2024-12-08 17:10:01,69,1489,39,30,813.45,1519.02,0.00
2024-12-08 17:10:01,68,1489,39,29,822.77,1519.09,0.00
2024-12-08 17:10:01,68,1490,39,29,826.80,1520.00,0.00
2024-12-08 17:10:01,69,1490,40,29,814.82,1520.02,0.00
2024-12-08 17:10:01,68,1490,39,29,820.57,1520.13,0.00
2024-12-08 17:10:01,67,1490,38,29,832.59,1520.13,0.00
2024-12-08 17:10:01,67,1491,38,29,837.40,1521.00,0.00
2024-12-08 17:10:01,68,1491,38,30,825.09,1521.02,0.00
2024-12-08 17:10:01,67,1491,38,29,832.65,1521.09,0.00
2024-12-08 17:10:01,67,1492,38,29,836.81,1522.00,0.00
2024-12-08 17:10:01,68,1492,39,29,824.50,1522.02,0.00
2024-12-08 17:10:01,67,1492,38,29,836.58,1522.02,0.00
2024-12-08 17:10:01,67,1493,38,29,835.23,1523.00,0.00
2024-12-08 17:10:01,68,1493,39,29,822.95,1523.02,0.00
2024-12-08 17:10:01,68,1494,39,29,821.70,1524.00,0.00
2024-12-08 17:10:01,69,1494,40,29,809.79,1524.02,0.00
2024-12-08 17:10:01,68,1494,39,29,821.48,1524.02,0.00
2024-12-08 17:10:01,67,1494,39,28,829.88,1524.06,0.00
2024-12-08 17:10:01,67,1495,39,28,834.28,1525.00,0.00
2024-12-08 17:10:01,68,1495,39,29,822.02,1525.02,0.00
2024-12-08 17:10:01,67,1495,39,28,829.52,1525.08,0.00
2024-12-08 17:10:01,68,1494,40,28,807.76,1525.75,0.00
2024-12-08 17:10:01,68,1495,40,28,825.92,1526.00,0.00
2024-12-08 17:10:01,69,1495,40,29,813.95,1526.02,0.00
2024-12-08 17:10:01,68,1495,39,29,819.89,1526.12,0.00
2024-12-08 17:10:01,68,1496,39,29,847.35,1527.00,0.00
2024-12-08 17:10:02,69,1496,40,29,835.07,1527.02,0.00
2024-12-08 17:10:02,68,1496,40,28,842.87,1527.07,0.00
2024-12-08 17:10:02,67,1496,39,28,850.34,1527.40,0.00
2024-12-08 17:10:02,67,1497,39,28,864.43,1528.00,0.00
2024-12-08 17:10:02,68,1497,40,28,851.72,1528.02,0.00
2024-12-08 17:10:02,68,1498,40,28,850.70,1529.00,0.00
2024-12-08 17:10:02,69,1498,40,29,838.38,1529.02,0.00
2024-12-08 17:10:02,68,1498,39,29,843.32,1529.16,0.00
2024-12-08 17:10:02,68,1499,39,29,853.51,1530.00,0.00
2024-12-08 17:10:02,69,1499,40,29,841.14,1530.02,0.00
2024-12-08 17:10:02,68,1499,40,28,849.47,1530.07,0.00
2024-12-08 17:10:02,68,1500,40,28,853.84,1531.00,0.00
2024-12-08 17:10:02,69,1500,41,28,841.47,1531.02,0.00
2024-12-08 17:10:02,68,1500,41,27,849.13,1531.09,0.00
2024-12-08 17:10:02,68,1501,41,27,853.45,1532.00,0.00
2024-12-08 17:10:02,69,1501,41,28,841.08,1532.02,0.00
2024-12-08 17:10:02,69,1502,41,28,839.18,1533.00,0.00
2024-12-08 17:10:02,70,1502,41,29,827.19,1533.01,0.00
2024-12-08 17:10:02,69,1502,41,28,834.75,1533.09,0.00
2024-12-08 17:10:02,69,1503,41,28,837.83,1534.00,0.00
2024-12-08 17:10:02,70,1503,42,28,825.86,1534.01,0.00
2024-12-08 17:10:02,69,1503,41,28,837.61,1534.02,0.00
2024-12-08 17:10:02,69,1504,41,28,835.43,1535.00,0.00
2024-12-08 17:10:02,70,1504,42,28,823.49,1535.01,0.00
2024-12-08 17:10:02,69,1504,42,27,831.43,1535.07,0.00
2024-12-08 17:10:02,69,1505,42,27,835.38,1536.00,0.00
2024-12-08 17:10:02,70,1505,43,27,823.45,1536.01,0.00
2024-12-08 17:10:02,69,1505,42,27,825.16,1536.12,0.00
2024-12-08 17:10:02,68,1505,41,27,833.10,1536.40,0.00
2024-12-08 17:10:02,68,1506,41,27,846.86,1537.00,0.00
2024-12-08 17:10:02,69,1506,42,27,834.59,1537.02,0.00
2024-12-08 17:10:02,68,1506,42,26,841.68,1537.10,0.00
2024-12-08 17:10:02,68,1507,42,26,846.51,1538.00,0.00
2024-12-08 17:10:02,69,1507,42,27,834.24,1538.02,0.00
2024-12-08 17:10:02,68,1507,41,27,840.20,1538.13,0.00
2024-12-08 17:10:02,68,1508,41,27,845.48,1539.00,0.00
2024-12-08 17:10:02,69,1508,42,27,833.22,1539.02,0.00
2024-12-08 17:10:02,68,1508,42,26,839.84,1539.12,0.00
2024-12-08 17:10:02,68,1509,42,26,844.89,1540.00,0.00
2024-12-08 17:10:02,69,1509,42,27,832.65,1540.02,0.00
2024-12-08 17:10:02,69,1510,42,27,831.40,1541.00,0.00
2024-12-08 17:10:02,70,1510,42,28,819.52,1541.01,0.00
2024-12-08 17:10:02,69,1510,42,27,825.84,1541.12,0.00
2024-12-08 17:10:02,69,1511,42,27,830.60,1542.00,0.00
2024-12-08 17:10:02,70,1511,43,27,818.74,1542.01,0.00
2024-12-08 17:10:02,69,1511,42,27,820.82,1542.25,0.00
2024-12-08 17:10:02,69,1512,42,27,832.03,1543.00,0.00
2024-12-08 17:10:02,70,1512,42,28,820.15,1543.01,0.00
2024-12-08 17:10:02,70,1513,42,28,818.69,1544.00,0.00
2024-12-08 17:10:02,71,1513,42,29,807.16,1544.01,0.00
2024-12-08 17:10:02,70,1513,41,29,817.82,1544.06,0.00
2024-12-08 17:10:02,69,1513,41,28,824.54,1544.13,0.00
2024-12-08 17:10:02,68,1513,40,28,836.44,1544.15,0.00
2024-12-08 17:10:02,68,1514,40,28,841.96,1545.00,0.00
2024-12-08 17:10:02,69,1514,41,28,829.75,1545.02,0.00
2024-12-08 17:10:02,68,1514,41,27,835.39,1545.15,0.00
2024-12-08 17:10:02,68,1515,41,27,840.91,1546.00,0.00
2024-12-08 17:10:02,69,1515,41,28,828.72,1546.02,0.00
2024-12-08 17:10:02,68,1515,40,28,838.43,1546.16,0.00
2024-12-08 17:10:02,68,1516,40,28,839.63,1547.00,0.00
2024-12-08 17:10:02,69,1516,40,29,827.46,1547.02,0.00
2024-12-08 17:10:03,69,1517,40,29,826.20,1548.00,0.00
2024-12-08 17:10:03,70,1517,40,30,814.40,1548.01,0.00
2024-12-08 17:10:03,69,1517,40,29,823.76,1548.16,0.00
2024-12-08 17:10:03,68,1517,39,29,834.74,1548.18,0.00
2024-12-08 17:10:03,68,1518,39,29,845.27,1549.00,0.00
2024-12-08 17:10:03,69,1518,40,29,833.02,1549.02,0.00
2024-12-08 17:10:03,68,1518,39,29,828.19,1549.62,0.00
2024-12-08 17:10:03,68,1519,39,29,845.36,1550.00,0.00
2024-12-08 17:10:03,69,1519,40,29,833.11,1550.02,0.00
2024-12-08 17:10:03,69,1520,40,29,831.85,1551.00,0.00
2024-12-08 17:10:03,70,1520,41,29,819.97,1551.01,0.00
2024-12-08 17:10:03,69,1520,40,29,831.63,1551.02,0.00
2024-12-08 17:10:03,68,1520,40,28,837.26,1551.15,0.00
2024-12-08 17:10:03,67,1520,39,28,847.41,1551.30,0.00
2024-12-08 17:10:03,67,1521,39,28,855.53,1552.00,0.00
2024-12-08 17:10:03,68,1521,39,29,842.94,1552.02,0.00
2024-12-08 17:10:03,67,1521,39,28,855.29,1552.02,0.00
2024-12-08 17:10:03,67,1522,39,28,854.45,1553.00,0.00
2024-12-08 17:10:03,68,1522,40,28,841.89,1553.02,0.00
2024-12-08 17:10:03,67,1522,39,28,852.61,1553.13,0.00
2024-12-08 17:10:03,66,1522,39,27,864.83,1553.15,0.00
2024-12-08 17:10:03,66,1523,39,27,871.02,1554.00,0.00
2024-12-08 17:10:03,67,1523,39,28,858.02,1554.02,0.00
2024-12-08 17:10:03,66,1523,38,28,860.55,1554.39,0.00
2024-12-08 17:10:03,66,1524,38,28,870.40,1555.00,0.00
2024-12-08 17:10:03,67,1524,39,28,857.41,1555.02,0.00
2024-12-08 17:10:03,66,1524,38,28,869.47,1555.06,0.00
2024-12-08 17:10:03,66,1525,38,28,869.55,1556.00,0.00
2024-12-08 17:10:03,67,1525,38,29,856.57,1556.02,0.00
2024-12-08 17:10:03,66,1525,38,28,867.44,1556.14,0.00
2024-12-08 17:10:03,66,1526,38,28,868.69,1557.00,0.00
2024-12-08 17:10:03,67,1526,38,29,855.73,1557.02,0.00
2024-12-08 17:10:03,67,1527,38,29,854.88,1558.00,0.00
2024-12-08 17:10:03,68,1527,39,29,842.31,1558.02,0.00
2024-12-08 17:10:03,67,1527,38,29,854.65,1558.02,0.00
2024-12-08 17:10:03,66,1527,38,28,860.77,1558.14,0.00
2024-12-08 17:10:03,66,1528,38,28,866.74,1559.00,0.00
2024-12-08 17:10:03,67,1528,39,28,853.80,1559.02,0.00
2024-12-08 17:10:03,66,1528,38,28,866.03,1559.05,0.00
2024-12-08 17:10:03,65,1528,37,28,877.93,1559.12,0.00
2024-12-08 17:10:03,65,1529,37,28,883.99,1560.00,0.00
2024-12-08 17:10:03,66,1529,37,29,870.60,1560.02,0.00
2024-12-08 17:10:03,66,1530,37,29,869.98,1561.00,0.00
2024-12-08 17:10:03,67,1530,37,30,856.99,1561.02,0.00
2024-12-08 17:10:03,66,1530,36,30,869.51,1561.05,0.00
2024-12-08 17:10:03,65,1530,36,29,881.46,1561.12,0.00
2024-12-08 17:10:03,65,1531,36,29,887.53,1562.00,0.00
2024-12-08 17:10:03,66,1531,37,29,874.08,1562.02,0.00
2024-12-08 17:10:03,65,1531,37,28,880.82,1562.12,0.00
2024-12-08 17:10:03,64,1531,36,28,884.56,1562.58,0.00
2024-12-08 17:10:03,64,1532,36,28,902.71,1563.00,0.00
2024-12-08 17:10:03,65,1532,37,28,888.82,1563.02,0.00
2024-12-08 17:10:03,65,1533,37,28,888.43,1564.00,0.00
2024-12-08 17:10:03,66,1533,37,29,874.97,1564.02,0.00
2024-12-08 17:10:03,67,1532,38,29,847.26,1564.70,0.00
2024-12-08 17:10:03,67,1533,38,29,866.20,1565.00,0.00
2024-12-08 17:10:03,68,1533,38,30,853.46,1565.02,0.00
2024-12-08 17:10:03,67,1533,37,30,865.27,1565.06,0.00
2024-12-08 17:10:03,66,1533,36,30,877.68,1565.11,0.00
2024-12-08 17:10:03,65,1533,36,29,890.94,1565.11,0.00
2024-12-08 17:10:03,65,1534,36,29,920.88,1566.00,0.00
2024-12-08 17:10:03,66,1534,37,29,906.93,1566.02,0.00
2024-12-08 17:10:03,66,1535,37,29,906.09,1567.00,0.00
2024-12-08 17:10:03,67,1535,37,30,892.57,1567.02,0.00
2024-12-08 17:10:03,68,1534,37,31,877.39,1567.15,0.00
2024-12-08 17:10:04,68,1535,37,31,892.46,1568.00,0.00
2024-12-08 17:10:04,69,1535,38,31,879.53,1568.02,0.00
2024-12-08 17:10:04,68,1535,38,30,886.03,1568.10,0.00
2024-12-08 17:10:04,68,1536,38,30,914.04,1569.00,0.00
2024-12-08 17:10:04,69,1536,39,30,900.80,1569.02,0.00
2024-12-08 17:10:04,69,1537,39,30,898.66,1570.00,0.00
2024-12-08 17:10:04,70,1537,40,30,885.83,1570.01,0.00
2024-12-08 17:10:04,69,1537,39,30,898.44,1570.02,0.00
2024-12-08 17:10:04,69,1538,39,30,896.07,1571.00,0.00
2024-12-08 17:10:04,70,1538,40,30,883.27,1571.01,0.00
2024-12-08 17:10:04,69,1538,39,30,887.93,1571.15,0.00
2024-12-08 17:10:04,69,1539,39,30,893.26,1572.00,0.00
2024-12-08 17:10:04,70,1539,40,30,880.49,1572.01,0.00
2024-12-08 17:10:04,69,1539,39,30,893.03,1572.02,0.00
2024-12-08 17:10:04,68,1539,39,29,904.44,1572.04,0.00
2024-12-08 17:10:04,68,1540,39,29,903.85,1573.00,0.00
2024-12-08 17:10:04,69,1540,39,30,890.75,1573.02,0.00
2024-12-08 17:10:04,68,1540,39,29,899.69,1573.06,0.00
2024-12-08 17:10:04,68,1541,39,29,903.96,1574.00,0.00
2024-12-08 17:10:04,69,1541,39,30,890.86,1574.02,0.00
2024-12-08 17:10:04,69,1542,39,30,889.60,1575.00,0.00
2024-12-08 17:10:04,70,1542,40,30,876.90,1575.01,0.00
2024-12-08 17:10:04,69,1542,40,29,885.27,1575.07,0.00
2024-12-08 17:10:04,68,1542,39,29,892.75,1575.12,0.00
2024-12-08 17:10:04,68,1543,39,29,902.56,1576.00,0.00
2024-12-08 17:10:04,69,1543,40,29,889.48,1576.02,0.00
2024-12-08 17:10:04,69,1544,40,29,888.22,1577.00,0.00
2024-12-08 17:10:04,70,1544,40,30,875.53,1577.01,0.00
2024-12-08 17:10:04,70,1545,40,30,874.06,1578.00,0.00
2024-12-08 17:10:04,71,1545,41,30,861.75,1578.01,0.00
2024-12-08 17:10:04,70,1545,41,29,868.21,1578.11,0.00
2024-12-08 17:10:04,70,1546,41,29,872.81,1579.00,0.00
2024-12-08 17:10:04,71,1546,41,30,860.51,1579.01,0.00
2024-12-08 17:10:04,70,1546,41,29,866.96,1579.11,0.00
2024-12-08 17:10:04,70,1547,41,29,871.55,1580.00,0.00
2024-12-08 17:10:04,71,1547,41,30,859.28,1580.01,0.00
2024-12-08 17:10:04,70,1547,40,30,852.65,1580.67,0.00
2024-12-08 17:10:04,70,1548,40,30,870.30,1581.00,0.00
2024-12-08 17:10:04,71,1548,40,31,858.04,1581.01,0.00
2024-12-08 17:10:04,70,1548,39,31,869.85,1581.04,0.00
2024-12-08 17:10:04,70,1549,39,31,868.22,1582.00,0.00
2024-12-08 17:10:04,71,1549,39,32,855.99,1582.01,0.00
2024-12-08 17:10:04,70,1549,38,32,868.00,1582.01,0.00
2024-12-08 17:10:04,69,1549,38,31,879.06,1582.10,0.00
2024-12-08 17:10:04,68,1549,38,30,887.10,1582.12,0.00
2024-12-08 17:10:04,67,1549,37,30,892.03,1582.52,0.00
2024-12-08 17:10:04,67,1550,37,30,908.45,1583.00,0.00
2024-12-08 17:10:04,68,1550,37,31,895.09,1583.02,0.00
2024-12-08 17:10:04,67,1550,36,31,906.82,1583.12,0.00
2024-12-08 17:10:04,66,1550,35,31,911.56,1583.39,0.00
2024-12-08 17:10:04,67,1549,35,32,887.80,1583.78,0.00
2024-12-08 17:10:04,67,1550,35,32,911.63,1584.00,0.00
2024-12-08 17:10:04,68,1550,35,33,898.22,1584.02,0.00
2024-12-08 17:10:04,68,1551,35,33,920.46,1585.00,0.00
2024-12-08 17:10:04,69,1551,36,33,907.12,1585.02,0.00
2024-12-08 17:10:04,68,1551,36,32,918.39,1585.13,0.00
2024-12-08 17:10:04,67,1551,35,32,931.86,1585.13,0.00
2024-12-08 17:10:04,67,1552,35,32,937.63,1586.00,0.00
2024-12-08 17:10:04,68,1552,35,33,923.84,1586.02,0.00
2024-12-08 17:10:04,68,1553,35,33,922.79,1587.00,0.00
2024-12-08 17:10:04,69,1553,36,33,909.42,1587.02,0.00
2024-12-08 17:10:04,68,1553,35,33,916.97,1587.12,0.00
2024-12-08 17:10:04,67,1553,35,32,925.92,1587.12,0.00
2024-12-08 17:10:04,68,1552,35,33,903.97,1587.69,0.00
2024-12-08 17:10:05,68,1553,35,33,927.11,1588.00,0.00
2024-12-08 17:10:05,69,1553,36,33,913.67,1588.02,0.00
2024-12-08 17:10:05,68,1553,35,33,926.65,1588.03,0.00
2024-12-08 17:10:05,68,1554,35,33,949.19,1589.00,0.00
2024-12-08 17:10:05,69,1554,35,34,935.44,1589.02,0.00
2024-12-08 17:10:05,68,1554,35,33,942.44,1589.13,0.00
2024-12-08 17:10:05,68,1555,35,33,947.92,1590.00,0.00
2024-12-08 17:10:05,69,1555,36,33,934.18,1590.02,0.00
2024-12-08 17:10:05,68,1555,35,33,945.37,1590.15,0.00
2024-12-08 17:10:05,68,1556,35,33,951.09,1591.00,0.00
2024-12-08 17:10:05,69,1556,35,34,937.31,1591.02,0.00
2024-12-08 17:10:05,68,1556,34,34,940.84,1591.24,0.00
2024-12-08 17:10:05,68,1557,34,34,952.62,1592.00,0.00
2024-12-08 17:10:05,69,1557,35,34,938.82,1592.02,0.00
2024-12-08 17:10:05,68,1557,35,33,945.62,1592.15,0.00
2024-12-08 17:10:05,68,1558,35,33,951.35,1593.00,0.00
2024-12-08 17:10:05,69,1558,35,34,937.56,1593.02,0.00
2024-12-08 17:10:05,68,1558,34,34,951.11,1593.02,0.00
2024-12-08 17:10:05,68,1559,34,34,950.07,1594.00,0.00
2024-12-08 17:10:05,69,1559,35,34,936.30,1594.02,0.00
2024-12-08 17:10:05,68,1559,35,33,941.43,1594.19,0.00
2024-12-08 17:10:05,68,1560,35,33,952.54,1595.00,0.00
2024-12-08 17:10:05,69,1560,36,33,938.74,1595.02,0.00
2024-12-08 17:10:05,68,1560,35,33,952.08,1595.04,0.00
2024-12-08 17:10:05,68,1561,35,33,951.50,1596.00,0.00
2024-12-08 17:10:05,69,1561,36,33,937.71,1596.02,0.00
2024-12-08 17:10:05,69,1562,36,33,936.44,1597.00,0.00
2024-12-08 17:10:05,70,1562,37,33,923.07,1597.01,0.00
2024-12-08 17:10:05,69,1562,36,33,934.38,1597.15,0.00
2024-12-08 17:10:05,68,1562,36,32,946.95,1597.16,0.00
2024-12-08 17:10:05,68,1563,36,32,952.92,1598.00,0.00
2024-12-08 17:10:05,69,1563,37,32,939.11,1598.02,0.00
2024-12-08 17:10:05,68,1563,36,32,952.22,1598.04,0.00
2024-12-08 17:10:05,68,1564,36,32,951.64,1599.00,0.00
2024-12-08 17:10:05,69,1564,36,33,937.85,1599.02,0.00
2024-12-08 17:10:05,69,1565,36,33,936.58,1600.00,0.00
2024-12-08 17:10:05,70,1565,36,34,923.20,1600.01,0.00
2024-12-08 17:10:05,69,1565,35,34,935.89,1600.04,0.00
2024-12-08 17:10:05,68,1565,35,33,947.79,1600.13,0.00
2024-12-08 17:10:05,68,1566,35,33,953.30,1601.00,0.00
2024-12-08 17:10:05,69,1566,35,34,939.48,1601.02,0.00
2024-12-08 17:10:05,69,1567,35,34,938.21,1602.00,0.00
2024-12-08 17:10:05,70,1567,36,34,924.81,1602.01,0.00
2024-12-08 17:10:05,70,1568,36,34,923.33,1603.00,0.00
2024-12-08 17:10:05,71,1568,36,35,910.32,1603.01,0.00
2024-12-08 17:10:05,71,1569,36,35,908.63,1604.00,0.00
2024-12-08 17:10:05,72,1569,37,35,896.01,1604.01,0.00
2024-12-08 17:10:05,71,1569,37,34,902.10,1604.13,0.00
2024-12-08 17:10:05,71,1570,37,34,906.71,1605.00,0.00
2024-12-08 17:10:05,72,1570,37,35,894.12,1605.01,0.00
2024-12-08 17:10:05,71,1570,37,34,900.40,1605.13,0.00
2024-12-08 17:10:05,71,1571,37,34,905.01,1606.00,0.00
2024-12-08 17:10:05,72,1571,37,35,892.44,1606.01,0.00
2024-12-08 17:10:05,73,1570,37,36,863.68,1606.53,0.00
2024-12-08 17:10:05,73,1571,37,36,885.61,1607.00,0.00
2024-12-08 17:10:05,74,1571,38,36,873.64,1607.01,0.00
2024-12-08 17:10:05,73,1571,38,35,879.25,1607.14,0.00
2024-12-08 17:10:05,73,1572,38,35,905.55,1608.00,0.00
2024-12-08 17:10:05,74,1572,39,35,893.31,1608.01,0.00
2024-12-08 17:10:05,73,1572,38,35,900.70,1608.04,0.00
2024-12-08 17:10:06,73,1573,38,35,903.46,1609.00,0.00
2024-12-08 17:10:06,74,1573,38,36,891.25,1609.01,0.00
2024-12-08 17:10:06,73,1573,37,36,903.02,1609.04,0.00
2024-12-08 17:10:06,73,1574,37,36,901.38,1610.00,0.00
2024-12-08 17:10:06,74,1574,37,37,889.20,1610.01,0.00
2024-12-08 17:10:06,73,1574,36,37,901.16,1610.01,0.00
2024-12-08 17:10:06,72,1574,35,37,913.23,1610.03,0.00
2024-12-08 17:10:06,71,1574,35,36,920.66,1610.10,0.00
2024-12-08 17:10:06,70,1574,34,36,933.82,1610.10,0.00
2024-12-08 17:10:06,69,1574,33,36,937.64,1610.71,0.00
2024-12-08 17:10:06,69,1575,33,36,951.89,1611.00,0.00
2024-12-08 17:10:06,70,1575,34,36,938.29,1611.01,0.00
2024-12-08 17:10:06,69,1575,34,35,946.77,1611.09,0.00
2024-12-08 17:10:06,68,1575,33,35,960.45,1611.09,0.00
2024-12-08 17:10:06,68,1576,33,35,970.04,1612.00,0.00
2024-12-08 17:10:06,69,1576,33,36,955.99,1612.02,0.00
2024-12-08 17:10:06,68,1576,32,36,969.81,1612.02,0.00
2024-12-08 17:10:06,68,1577,32,36,968.75,1613.00,0.00
2024-12-08 17:10:06,69,1577,32,37,954.71,1613.02,0.00
2024-12-08 17:10:06,68,1577,32,36,963.07,1613.07,0.00
2024-12-08 17:10:06,68,1578,32,36,967.69,1614.00,0.00
2024-12-08 17:10:06,69,1578,32,37,953.66,1614.02,0.00
2024-12-08 17:10:06,68,1578,31,37,957.54,1614.21,0.00
2024-12-08 17:10:06,68,1579,31,37,969.00,1615.00,0.00
2024-12-08 17:10:06,69,1579,32,37,954.96,1615.02,0.00
2024-12-08 17:10:06,68,1579,31,37,968.53,1615.03,0.00
2024-12-08 17:10:06,67,1579,31,36,977.45,1615.08,0.00
2024-12-08 17:10:06,66,1579,30,36,992.01,1615.08,0.00
2024-12-08 17:10:06,66,1580,30,36,1002.16,1616.00,0.00
2024-12-08 17:10:06,67,1580,31,36,987.21,1616.02,0.00
2024-12-08 17:10:06,67,1581,31,36,986.37,1617.00,0.00
2024-12-08 17:10:06,68,1581,32,36,971.86,1617.02,0.00
2024-12-08 17:10:06,68,1582,32,36,970.80,1618.00,0.00
2024-12-08 17:10:06,69,1582,32,37,956.73,1618.02,0.00
2024-12-08 17:10:06,68,1582,32,36,965.34,1618.07,0.00
2024-12-08 17:10:06,68,1583,32,36,969.97,1619.00,0.00
2024-12-08 17:10:06,69,1583,32,37,955.91,1619.02,0.00
2024-12-08 17:10:06,68,1583,32,36,964.51,1619.07,0.00
2024-12-08 17:10:06,68,1584,32,36,969.14,1620.00,0.00
2024-12-08 17:10:06,69,1584,33,36,955.10,1620.02,0.00
2024-12-08 17:10:06,69,1585,33,36,953.81,1621.00,0.00
2024-12-08 17:10:06,70,1585,33,37,940.18,1621.01,0.00
2024-12-08 17:10:06,69,1585,33,36,947.94,1621.09,0.00
2024-12-08 17:10:06,69,1586,33,36,952.51,1622.00,0.00
2024-12-08 17:10:06,70,1586,34,36,938.91,1622.01,0.00
2024-12-08 17:10:06,70,1587,34,36,937.40,1623.00,0.00
2024-12-08 17:10:06,71,1587,35,36,924.20,1623.01,0.00
2024-12-08 17:10:06,71,1588,35,36,922.48,1624.00,0.00
2024-12-08 17:10:06,72,1588,36,36,909.67,1624.01,0.00
2024-12-08 17:10:06,71,1588,36,35,917.23,1624.08,0.00
2024-12-08 17:10:06,70,1588,35,35,929.64,1624.11,0.00
2024-12-08 17:10:06,70,1589,35,35,934.37,1625.00,0.00
2024-12-08 17:10:06,71,1589,35,36,921.21,1625.01,0.00
2024-12-08 17:10:06,71,1590,35,36,919.49,1626.00,0.00
2024-12-08 17:10:06,72,1590,35,37,906.72,1626.01,0.00
2024-12-08 17:10:06,72,1591,35,37,904.79,1627.00,0.00
2024-12-08 17:10:06,73,1591,36,37,892.40,1627.01,0.00
2024-12-08 17:10:06,72,1591,36,36,898.04,1627.14,0.00
2024-12-08 17:10:06,71,1591,35,36,905.47,1627.30,0.00
2024-12-08 17:10:06,71,1592,35,36,917.41,1628.00,0.00
2024-12-08 17:10:06,72,1592,35,37,904.67,1628.01,0.00
2024-12-08 17:10:06,71,1592,34,37,908.96,1628.20,0.00
2024-12-08 17:10:07,71,1593,34,37,919.35,1629.00,0.00
2024-12-08 17:10:07,72,1593,35,37,906.58,1629.01,0.00
2024-12-08 17:10:07,72,1594,35,37,904.65,1630.00,0.00
2024-12-08 17:10:07,73,1594,35,38,892.26,1630.01,0.00
2024-12-08 17:10:07,72,1594,35,37,899.46,1630.14,0.00
2024-12-08 17:10:07,71,1594,34,37,911.91,1630.16,0.00
2024-12-08 17:10:07,70,1594,33,37,924.70,1630.16,0.00
2024-12-08 17:10:07,70,1595,33,37,934.80,1631.00,0.00
2024-12-08 17:10:07,71,1595,33,38,921.63,1631.01,0.00
2024-12-08 17:10:07,71,1596,33,38,919.90,1632.00,0.00
2024-12-08 17:10:07,72,1596,34,38,907.12,1632.01,0.00
2024-12-08 17:10:07,72,1597,34,38,905.18,1633.00,0.00
2024-12-08 17:10:07,73,1597,35,38,892.78,1633.01,0.00
2024-12-08 17:10:07,72,1597,35,37,904.95,1633.01,0.00
2024-12-08 17:10:07,71,1597,34,37,917.01,1633.04,0.00
2024-12-08 17:10:07,71,1598,34,37,915.73,1634.00,0.00
2024-12-08 17:10:07,72,1598,35,37,903.01,1634.01,0.00
2024-12-08 17:10:07,72,1599,35,37,901.07,1635.00,0.00
2024-12-08 17:10:07,73,1599,36,37,888.72,1635.01,0.00
2024-12-08 17:10:07,72,1599,36,36,896.32,1635.14,0.00
2024-12-08 17:10:07,72,1600,36,36,900.94,1636.00,0.00
2024-12-08 17:10:07,73,1600,37,36,888.59,1636.01,0.00
2024-12-08 17:10:07,72,1600,37,35,897.99,1636.07,0.00
2024-12-08 17:10:07,71,1600,36,35,909.50,1636.14,0.00
2024-12-08 17:10:07,71,1601,36,35,914.41,1637.00,0.00
2024-12-08 17:10:07,72,1601,37,35,901.71,1637.01,0.00
2024-12-08 17:10:07,71,1601,36,35,914.18,1637.01,0.00
2024-12-08 17:10:07,70,1601,35,35,923.98,1637.07,0.00
2024-12-08 17:10:07,71,1600,35,36,894.32,1637.86,0.00
2024-12-08 17:10:07,71,1601,35,36,917.51,1638.00,0.00
2024-12-08 17:10:07,72,1601,35,37,904.77,1638.01,0.00
2024-12-08 17:10:07,71,1601,34,37,906.58,1638.41,0.00
2024-12-08 17:10:07,71,1602,34,37,938.85,1639.00,0.00
2024-12-08 17:10:07,72,1602,34,38,925.81,1639.01,0.00
2024-12-08 17:10:07,71,1602,33,38,938.39,1639.03,0.00
2024-12-08 17:10:07,70,1602,33,37,947.12,1639.09,0.00
2024-12-08 17:10:07,70,1603,33,37,951.43,1640.00,0.00
2024-12-08 17:10:07,71,1603,34,37,938.03,1640.01,0.00
2024-12-08 17:10:07,71,1604,34,37,936.29,1641.00,0.00
2024-12-08 17:10:07,72,1604,34,38,923.29,1641.01,0.00
2024-12-08 17:10:07,72,1605,34,38,921.34,1642.00,0.00
2024-12-08 17:10:07,73,1605,34,39,908.72,1642.01,0.00
2024-12-08 17:10:07,72,1605,34,38,916.34,1642.10,0.00
2024-12-08 17:10:07,73,1604,34,39,900.06,1642.36,0.00
2024-12-08 17:10:07,73,1605,34,39,918.28,1643.00,0.00
2024-12-08 17:10:07,74,1605,34,40,905.87,1643.01,0.00
2024-12-08 17:10:07,73,1605,34,39,917.16,1643.04,0.00
2024-12-08 17:10:07,73,1606,34,39,942.48,1644.00,0.00
2024-12-08 17:10:07,74,1606,34,40,929.75,1644.01,0.00
2024-12-08 17:10:07,73,1606,34,39,937.77,1644.08,0.00
2024-12-08 17:10:07,73,1607,34,39,941.25,1645.00,0.00
2024-12-08 17:10:07,74,1607,34,40,928.54,1645.01,0.00
2024-12-08 17:10:07,73,1607,33,40,941.03,1645.01,0.00
2024-12-08 17:10:07,72,1607,33,39,949.54,1645.07,0.00
2024-12-08 17:10:07,72,1608,33,39,953.08,1646.00,0.00
2024-12-08 17:10:07,73,1608,34,39,940.02,1646.01,0.00
2024-12-08 17:10:07,73,1609,34,39,937.89,1647.00,0.00
2024-12-08 17:10:07,74,1609,35,39,925.21,1647.01,0.00
2024-12-08 17:10:07,73,1609,34,39,930.70,1647.16,0.00
2024-12-08 17:10:07,73,1610,34,39,940.04,1648.00,0.00
2024-12-08 17:10:07,74,1610,35,39,927.33,1648.01,0.00
2024-12-08 17:10:08,73,1610,34,39,939.59,1648.03,0.00
2024-12-08 17:10:08,72,1610,34,38,948.98,1648.06,0.00
2024-12-08 17:10:08,72,1611,34,38,952.30,1649.00,0.00
2024-12-08 17:10:08,73,1611,35,38,939.25,1649.01,0.00
2024-12-08 17:10:08,72,1611,35,37,948.41,1649.06,0.00
2024-12-08 17:10:08,72,1612,35,37,951.73,1650.00,0.00
2024-12-08 17:10:08,73,1612,35,38,938.69,1650.01,0.00
2024-12-08 17:10:08,73,1613,35,38,936.55,1651.00,0.00
2024-12-08 17:10:08,74,1613,35,39,923.89,1651.01,0.00
2024-12-08 17:10:08,73,1613,35,38,932.93,1651.06,0.00
2024-12-08 17:10:08,73,1614,35,38,935.98,1652.00,0.00
2024-12-08 17:10:08,74,1614,36,38,923.33,1652.01,0.00
2024-12-08 17:10:08,74,1615,36,38,920.99,1653.00,0.00
2024-12-08 17:10:08,75,1615,37,38,908.71,1653.01,0.00
2024-12-08 17:10:08,74,1615,36,38,916.98,1653.08,0.00
2024-12-08 17:10:08,74,1616,36,38,920.20,1654.00,0.00
2024-12-08 17:10:08,75,1616,37,38,907.94,1654.01,0.00
2024-12-08 17:10:08,74,1616,37,37,916.86,1654.07,0.00
2024-12-08 17:10:08,73,1616,36,37,927.64,1654.16,0.00
2024-12-08 17:10:08,73,1617,36,37,932.47,1655.00,0.00
2024-12-08 17:10:08,74,1617,37,37,919.87,1655.01,0.00
2024-12-08 17:10:08,75,1616,37,38,906.94,1655.08,0.00
2024-12-08 17:10:08,74,1616,37,37,932.41,1655.08,0.00
2024-12-08 17:10:08,74,1617,37,37,935.64,1656.00,0.00
2024-12-08 17:10:08,75,1617,37,38,923.16,1656.01,0.00
2024-12-08 17:10:08,74,1617,36,38,931.61,1656.03,0.00
2024-12-08 17:10:08,73,1617,35,38,933.65,1656.41,0.00
2024-12-08 17:10:08,73,1618,35,38,969.68,1657.00,0.00
2024-12-08 17:10:08,74,1618,35,39,956.58,1657.01,0.00
2024-12-08 17:10:08,73,1618,34,39,969.46,1657.03,0.00
2024-12-08 17:10:08,72,1618,34,38,980.18,1657.04,0.00
2024-12-08 17:10:08,71,1618,33,38,978.67,1657.69,0.00
2024-12-08 17:10:08,71,1619,33,38,997.13,1658.00,0.00
2024-12-08 17:10:08,72,1619,34,38,983.29,1658.01,0.00
2024-12-08 17:10:08,71,1619,33,38,985.51,1658.14,0.00
2024-12-08 17:10:08,71,1620,33,38,995.17,1659.00,0.00
2024-12-08 17:10:08,72,1620,33,39,981.34,1659.01,0.00
2024-12-08 17:10:08,71,1620,32,39,992.38,1659.04,0.00
2024-12-08 17:10:08,70,1620,32,38,1003.95,1659.04,0.00
2024-12-08 17:10:08,70,1621,32,38,1012.36,1660.00,0.00
2024-12-08 17:10:08,71,1621,33,38,998.10,1660.01,0.00
2024-12-08 17:10:08,72,1620,33,39,970.23,1660.63,0.00
2024-12-08 17:10:08,72,1621,33,39,997.75,1661.00,0.00
2024-12-08 17:10:08,73,1621,33,40,984.09,1661.01,0.00
2024-12-08 17:10:08,72,1621,33,39,994.77,1661.04,0.00
2024-12-08 17:10:08,72,1622,33,39,1020.98,1662.00,0.00
2024-12-08 17:10:08,73,1622,33,40,1006.99,1662.01,0.00
2024-12-08 17:10:08,72,1622,32,40,1020.75,1662.01,0.00
2024-12-08 17:10:08,72,1623,32,40,1018.82,1663.00,0.00
2024-12-08 17:10:08,73,1623,33,40,1004.86,1663.01,0.00
2024-12-08 17:10:08,72,1623,33,39,1015.83,1663.04,0.00
2024-12-08 17:10:08,72,1624,33,39,1018.97,1664.00,0.00
2024-12-08 17:10:08,73,1624,33,40,1005.01,1664.01,0.00
2024-12-08 17:10:08,73,1625,33,40,1002.88,1665.00,0.00
2024-12-08 17:10:08,74,1625,34,40,989.32,1665.01,0.00
2024-12-08 17:10:08,73,1625,34,39,994.01,1665.07,0.00
2024-12-08 17:10:08,73,1626,34,39,1001.88,1666.00,0.00
2024-12-08 17:10:08,74,1626,35,39,988.34,1666.01,0.00
2024-12-08 17:10:09,74,1627,35,39,986.01,1667.00,0.00
2024-12-08 17:10:09,75,1627,35,40,972.86,1667.01,0.00
2024-12-08 17:10:09,74,1627,35,39,981.97,1667.07,0.00
2024-12-08 17:10:09,74,1628,35,39,985.02,1668.00,0.00
2024-12-08 17:10:09,75,1628,35,40,971.89,1668.01,0.00
2024-12-08 17:10:09,74,1628,34,40,976.03,1668.08,0.00
2024-12-08 17:10:09,74,1629,34,40,983.81,1669.00,0.00
2024-12-08 17:10:09,75,1629,35,40,970.69,1669.01,0.00
2024-12-08 17:10:09,74,1629,35,39,979.99,1669.07,0.00
2024-12-08 17:10:09,74,1630,35,39,983.04,1670.00,0.00
2024-12-08 17:10:09,75,1630,36,39,969.94,1670.01,0.00
2024-12-08 17:10:09,74,1630,35,39,971.92,1670.42,0.00
2024-12-08 17:10:09,74,1631,35,39,980.70,1671.00,0.00
2024-12-08 17:10:09,75,1631,36,39,967.62,1671.01,0.00
2024-12-08 17:10:09,75,1632,36,39,965.08,1672.00,0.00
2024-12-08 17:10:09,76,1632,36,40,952.38,1672.01,0.00
2024-12-08 17:10:09,75,1632,36,39,960.64,1672.09,0.00
2024-12-08 17:10:09,75,1633,36,39,963.87,1673.00,0.00
2024-12-08 17:10:09,76,1633,36,40,951.19,1673.01,0.00
2024-12-08 17:10:09,75,1633,36,39,959.43,1673.09,0.00
2024-12-08 17:10:09,75,1634,36,39,962.66,1674.00,0.00
2024-12-08 17:10:09,76,1634,36,40,949.99,1674.01,0.00
2024-12-08 17:10:09,76,1635,36,40,947.26,1675.00,0.00
2024-12-08 17:10:09,77,1635,37,40,934.95,1675.01,0.00
2024-12-08 17:10:09,76,1635,37,39,942.00,1675.13,0.00
2024-12-08 17:10:09,75,1635,36,39,950.54,1675.15,0.00
2024-12-08 17:10:09,75,1636,36,39,959.12,1676.00,0.00
2024-12-08 17:10:09,76,1636,36,40,946.50,1676.01,0.00
2024-12-08 17:10:09,75,1636,35,40,958.24,1676.05,0.00
2024-12-08 17:10:09,74,1636,34,40,967.35,1676.11,0.00
2024-12-08 17:10:09,74,1637,34,40,971.07,1677.00,0.00
2024-12-08 17:10:09,75,1637,35,40,958.13,1677.01,0.00
2024-12-08 17:10:09,74,1637,35,39,966.34,1677.11,0.00
2024-12-08 17:10:09,74,1638,35,39,970.06,1678.00,0.00
2024-12-08 17:10:09,75,1638,35,40,957.13,1678.01,0.00
2024-12-08 17:10:09,74,1638,34,40,963.07,1678.16,0.00
2024-12-08 17:10:09,74,1639,34,40,967.69,1679.00,0.00
2024-12-08 17:10:09,75,1639,35,40,954.79,1679.01,0.00
2024-12-08 17:10:09,75,1640,35,40,952.22,1680.00,0.00
2024-12-08 17:10:09,76,1640,35,41,939.69,1680.01,0.00
2024-12-08 17:10:09,75,1640,35,40,947.76,1680.11,0.00
2024-12-08 17:10:09,75,1641,35,40,951.22,1681.00,0.00
2024-12-08 17:10:09,76,1641,35,41,938.71,1681.01,0.00
2024-12-08 17:10:09,75,1641,35,40,949.89,1681.05,0.00
2024-12-08 17:10:09,75,1642,35,40,952.46,1682.00,0.00
2024-12-08 17:10:09,76,1642,36,40,939.93,1682.01,0.00
2024-12-08 17:10:09,76,1643,36,40,937.16,1683.00,0.00
2024-12-08 17:10:09,77,1643,37,40,924.99,1683.01,0.00
2024-12-08 17:10:09,77,1644,37,40,922.04,1684.00,0.00
2024-12-08 17:10:09,78,1644,38,40,910.22,1684.01,0.00
2024-12-08 17:10:09,77,1644,37,40,921.18,1684.05,0.00
2024-12-08 17:10:09,76,1644,37,39,930.65,1684.08,0.00
2024-12-08 17:10:09,76,1645,37,39,933.40,1685.00,0.00
2024-12-08 17:10:09,77,1645,37,40,921.28,1685.01,0.00
2024-12-08 17:10:09,76,1645,37,39,930.09,1685.08,0.00
2024-12-08 17:10:09,76,1646,37,39,932.85,1686.00,0.00
2024-12-08 17:10:09,77,1646,37,40,920.73,1686.01,0.00
2024-12-08 17:10:09,76,1646,36,40,929.31,1686.08,0.00
2024-12-08 17:10:10,76,1647,36,40,932.07,1687.00,0.00
2024-12-08 17:10:10,77,1647,36,41,919.96,1687.01,0.00
2024-12-08 17:10:10,76,1647,35,41,930.97,1687.07,0.00
2024-12-08 17:10:10,75,1647,35,40,940.69,1687.07,0.00
2024-12-08 17:10:10,74,1647,34,40,949.08,1687.11,0.00
2024-12-08 17:10:10,73,1647,33,40,956.90,1687.43,0.00
2024-12-08 17:10:10,73,1648,33,40,970.72,1688.00,0.00
2024-12-08 17:10:10,74,1648,34,40,957.60,1688.01,0.00
2024-12-08 17:10:10,74,1649,34,40,955.20,1689.00,0.00
2024-12-08 17:10:10,75,1649,34,41,942.46,1689.01,0.00
2024-12-08 17:10:10,74,1649,34,40,951.79,1689.07,0.00
2024-12-08 17:10:10,74,1650,34,40,954.85,1690.00,0.00
2024-12-08 17:10:10,75,1650,34,41,942.12,1690.01,0.00
2024-12-08 17:10:10,74,1650,33,41,951.44,1690.07,0.00
2024-12-08 17:10:10,75,1649,34,41,926.34,1690.57,0.00
2024-12-08 17:10:10,75,1650,34,41,948.99,1691.00,0.00
2024-12-08 17:10:10,76,1650,34,42,936.50,1691.01,0.00
2024-12-08 17:10:10,75,1650,34,41,945.62,1691.07,0.00
2024-12-08 17:10:10,75,1651,34,41,970.98,1692.00,0.00
2024-12-08 17:10:10,76,1651,35,41,958.21,1692.01,0.00
2024-12-08 17:10:10,75,1651,34,41,970.54,1692.03,0.00
2024-12-08 17:10:10,75,1652,34,41,968.17,1693.00,0.00
2024-12-08 17:10:10,76,1652,35,41,955.43,1693.01,0.00
2024-12-08 17:10:10,77,1651,36,41,936.46,1693.17,0.00
2024-12-08 17:10:10,77,1652,36,41,953.92,1694.00,0.00
2024-12-08 17:10:10,78,1652,36,42,941.69,1694.01,0.00
2024-12-08 17:10:10,77,1652,36,41,950.20,1694.08,0.00
2024-12-08 17:10:10,76,1652,35,41,961.39,1694.16,0.00
2024-12-08 17:10:10,76,1653,35,41,987.78,1695.00,0.00
2024-12-08 17:10:10,77,1653,35,42,974.95,1695.01,0.00
2024-12-08 17:10:10,77,1654,35,42,972.01,1696.00,0.00
2024-12-08 17:10:10,78,1654,36,42,959.54,1696.01,0.00
2024-12-08 17:10:10,77,1654,36,41,970.48,1696.08,0.00
2024-12-08 17:10:10,77,1655,36,41,973.02,1697.00,0.00
2024-12-08 17:10:10,78,1655,37,41,960.55,1697.01,0.00
2024-12-08 17:10:10,78,1656,37,41,957.41,1698.00,0.00
2024-12-08 17:10:10,79,1656,37,42,945.29,1698.01,0.00
2024-12-08 17:10:10,78,1656,37,41,955.02,1698.04,0.00
2024-12-08 17:10:10,78,1657,37,41,956.67,1699.00,0.00
2024-12-08 17:10:10,79,1657,37,42,944.56,1699.01,0.00
2024-12-08 17:10:10,78,1657,37,41,953.41,1699.08,0.00
2024-12-08 17:10:10,78,1658,37,41,955.71,1700.00,0.00
2024-12-08 17:10:10,79,1658,37,42,943.61,1700.01,0.00
2024-12-08 17:10:10,79,1659,37,42,940.29,1701.00,0.00
2024-12-08 17:10:10,80,1659,38,42,928.53,1701.01,0.00
2024-12-08 17:10:10,79,1659,38,41,937.07,1701.08,0.00
2024-12-08 17:10:10,79,1660,38,41,939.12,1702.00,0.00
2024-12-08 17:10:10,80,1660,38,42,927.38,1702.01,0.00
2024-12-08 17:10:10,79,1660,37,42,938.69,1702.03,0.00
2024-12-08 17:10:10,79,1661,37,42,935.57,1703.00,0.00
2024-12-08 17:10:10,80,1661,37,43,923.88,1703.01,0.00
2024-12-08 17:10:10,80,1662,37,43,920.37,1704.00,0.00
2024-12-08 17:10:10,81,1662,38,43,909.01,1704.01,0.00
2024-12-08 17:10:10,80,1662,37,43,912.09,1704.10,0.00
2024-12-08 17:10:10,80,1663,37,43,918.57,1705.00,0.00
2024-12-08 17:10:10,81,1663,38,43,907.23,1705.01,0.00
2024-12-08 17:10:10,81,1664,38,43,903.55,1706.00,0.00
2024-12-08 17:10:10,82,1664,38,44,892.53,1706.01,0.00
2024-12-08 17:10:10,81,1664,38,43,901.03,1706.06,0.00
2024-12-08 17:10:11,81,1665,38,43,902.39,1707.00,0.00
2024-12-08 17:10:11,82,1665,39,43,891.39,1707.01,0.00
2024-12-08 17:10:11,81,1665,38,43,901.56,1707.05,0.00
2024-12-08 17:10:11,81,1666,38,43,898.49,1708.00,0.00
2024-12-08 17:10:11,82,1666,39,43,887.53,1708.01,0.00
2024-12-08 17:10:11,81,1666,38,43,893.87,1708.12,0.00
2024-12-08 17:10:11,80,1666,37,43,899.10,1708.21,0.00
2024-12-08 17:10:11,80,1667,37,43,907.48,1709.00,0.00
2024-12-08 17:10:11,81,1667,37,44,896.28,1709.01,0.00
2024-12-08 17:10:11,80,1667,37,43,903.86,1709.10,0.00
2024-12-08 17:10:11,80,1668,37,43,906.09,1710.00,0.00
2024-12-08 17:10:11,81,1668,37,44,894.90,1710.01,0.00
2024-12-08 17:10:11,82,1667,37,45,860.66,1710.94,0.00
2024-12-08 17:10:11,82,1668,37,45,889.93,1711.00,0.00
2024-12-08 17:10:11,83,1668,37,46,879.21,1711.01,0.00
2024-12-08 17:10:11,82,1668,37,45,886.60,1711.10,0.00
2024-12-08 17:10:11,82,1669,37,45,909.24,1712.00,0.00
2024-12-08 17:10:11,83,1669,38,45,898.28,1712.01,0.00
2024-12-08 17:10:11,82,1669,37,45,908.41,1712.05,0.00
2024-12-08 17:10:11,81,1669,37,44,916.88,1712.09,0.00
2024-12-08 17:10:11,81,1670,37,44,918.68,1713.00,0.00
2024-12-08 17:10:11,82,1670,38,44,907.47,1713.01,0.00
2024-12-08 17:10:11,83,1669,39,44,890.98,1713.12,0.00
2024-12-08 17:10:11,82,1669,38,44,915.04,1713.21,0.00
2024-12-08 17:10:11,82,1670,38,44,918.66,1714.00,0.00
2024-12-08 17:10:11,83,1670,38,45,907.59,1714.01,0.00
2024-12-08 17:10:11,82,1670,37,45,911.39,1714.20,0.00
2024-12-08 17:10:11,82,1671,37,45,935.72,1715.00,0.00
2024-12-08 17:10:11,83,1671,38,45,924.45,1715.01,0.00
2024-12-08 17:10:11,82,1671,38,44,935.51,1715.01,0.00
2024-12-08 17:10:11,82,1672,38,44,935.85,1716.00,0.00
2024-12-08 17:10:11,83,1672,38,45,924.57,1716.01,0.00
2024-12-08 17:10:11,83,1673,38,45,920.56,1717.00,0.00
2024-12-08 17:10:11,84,1673,38,46,909.60,1717.01,0.00
2024-12-08 17:10:11,83,1673,37,46,919.94,1717.05,0.00
2024-12-08 17:10:11,82,1673,37,45,929.70,1717.06,0.00
2024-12-08 17:10:11,82,1674,37,45,930.86,1718.00,0.00
2024-12-08 17:10:11,83,1674,38,45,919.65,1718.01,0.00
2024-12-08 17:10:11,82,1674,37,45,914.63,1718.73,0.00
2024-12-08 17:10:11,82,1675,37,45,927.00,1719.00,0.00
2024-12-08 17:10:11,83,1675,38,45,915.83,1719.01,0.00
2024-12-08 17:10:11,83,1676,38,45,911.75,1720.00,0.00
2024-12-08 17:10:11,84,1676,39,45,900.90,1720.01,0.00
2024-12-08 17:10:11,83,1676,38,45,911.13,1720.04,0.00
2024-12-08 17:10:11,82,1676,37,45,910.66,1720.48,0.00
2024-12-08 17:10:11,83,1675,37,46,892.74,1720.66,0.00
2024-12-08 17:10:11,83,1676,37,46,925.68,1721.00,0.00
2024-12-08 17:10:11,84,1676,37,47,914.66,1721.01,0.00
2024-12-08 17:10:11,83,1676,36,47,917.86,1721.23,0.00
2024-12-08 17:10:11,83,1677,36,47,941.94,1722.00,0.00
2024-12-08 17:10:11,84,1677,37,47,930.73,1722.01,0.00
2024-12-08 17:10:11,84,1678,37,47,925.47,1723.00,0.00
2024-12-08 17:10:11,85,1678,37,48,914.58,1723.01,0.00
2024-12-08 17:10:11,84,1678,36,48,925.27,1723.01,0.00
2024-12-08 17:10:11,83,1678,36,47,931.43,1723.05,0.00
2024-12-08 17:10:11,83,1679,36,47,930.86,1724.00,0.00
2024-12-08 17:10:11,84,1679,37,47,919.78,1724.01,0.00
2024-12-08 17:10:11,83,1679,36,47,930.65,1724.01,0.00
2024-12-08 17:10:11,82,1679,36,46,939.69,1724.02,0.00
2024-12-08 17:10:11,81,1679,36,45,951.08,1724.03,0.00
2024-12-08 17:10:11,80,1679,35,45,955.79,1724.45,0.00
2024-12-08 17:10:12,80,1680,35,45,962.17,1725.00,0.00
2024-12-08 17:10:12,81,1680,36,45,950.29,1725.01,0.00
2024-12-08 17:10:12,80,1680,36,44,957.43,1725.03,0.00
2024-12-08 17:10:12,79,1680,35,44,963.73,1725.29,0.00
2024-12-08 17:10:12,79,1681,35,44,971.93,1726.00,0.00
2024-12-08 17:10:12,80,1681,36,44,959.78,1726.01,0.00
2024-12-08 17:10:12,80,1682,36,44,954.39,1727.00,0.00
2024-12-08 17:10:12,81,1682,36,45,942.61,1727.01,0.00
2024-12-08 17:10:12,80,1682,36,44,952.88,1727.05,0.00
2024-12-08 17:10:12,79,1682,35,44,955.46,1727.41,0.00
2024-12-08 17:10:12,79,1683,35,44,965.17,1728.00,0.00
2024-12-08 17:10:12,80,1683,36,44,953.11,1728.01,0.00
2024-12-08 17:10:12,79,1683,35,44,964.95,1728.03,0.00
2024-12-08 17:10:12,79,1684,35,44,958.60,1729.00,0.00
2024-12-08 17:10:12,80,1684,36,44,946.62,1729.01,0.00
2024-12-08 17:10:12,79,1684,35,44,958.16,1729.03,0.00
2024-12-08 17:10:12,79,1685,35,44,950.70,1730.00,0.00
2024-12-08 17:10:12,80,1685,36,44,938.81,1730.01,0.00
2024-12-08 17:10:12,79,1685,36,43,950.04,1730.03,0.00
2024-12-08 17:10:12,78,1685,35,43,951.49,1730.51,0.00
2024-12-08 17:10:12,77,1685,35,42,960.10,1730.61,0.00
2024-12-08 17:10:12,78,1684,36,42,947.15,1730.67,0.00
2024-12-08 17:10:12,78,1685,36,42,964.50,1731.00,0.00
2024-12-08 17:10:12,79,1685,37,42,952.29,1731.01,0.00
2024-12-08 17:10:12,79,1686,37,42,970.82,1732.00,0.00
2024-12-08 17:10:12,80,1686,37,43,958.69,1732.01,0.00
2024-12-08 17:10:12,79,1686,37,42,968.42,1732.08,0.00
2024-12-08 17:10:12,80,1685,38,42,945.17,1732.76,0.00
2024-12-08 17:10:12,80,1686,38,42,962.27,1733.00,0.00
2024-12-08 17:10:12,81,1686,39,42,950.39,1733.01,0.00
2024-12-08 17:10:12,80,1686,39,41,960.55,1733.06,0.00
2024-12-08 17:10:12,80,1687,39,41,983.85,1734.00,0.00
2024-12-08 17:10:12,81,1687,40,41,971.71,1734.01,0.00
2024-12-08 17:10:12,81,1688,40,41,967.98,1735.00,0.00
2024-12-08 17:10:12,82,1688,40,42,956.18,1735.01,0.00
2024-12-08 17:10:12,81,1688,40,41,965.85,1735.07,0.00
2024-12-08 17:10:12,81,1689,40,41,967.47,1736.00,0.00
2024-12-08 17:10:12,82,1689,41,41,955.67,1736.01,0.00
2024-12-08 17:10:12,83,1688,41,42,929.57,1736.65,0.00
2024-12-08 17:10:12,83,1689,41,42,945.75,1737.00,0.00
2024-12-08 17:10:12,84,1689,42,42,934.49,1737.01,0.00
2024-12-08 17:10:12,83,1689,42,41,945.54,1737.01,0.00
2024-12-08 17:10:12,84,1688,42,42,933.87,1737.06,0.00
2024-12-08 17:10:12,84,1689,42,42,967.92,1738.00,0.00
2024-12-08 17:10:12,85,1689,43,42,956.54,1738.01,0.00
2024-12-08 17:10:12,84,1689,43,41,966.49,1738.06,0.00
2024-12-08 17:10:12,84,1690,43,41,987.94,1739.00,0.00
2024-12-08 17:10:12,85,1690,43,42,976.32,1739.01,0.00
2024-12-08 17:10:12,84,1690,43,41,986.10,1739.07,0.00
2024-12-08 17:10:12,84,1691,43,41,987.06,1740.00,0.00
2024-12-08 17:10:12,85,1691,43,42,975.45,1740.01,0.00
2024-12-08 17:10:12,84,1691,42,42,979.83,1740.11,0.00
2024-12-08 17:10:12,85,1690,43,42,966.89,1740.21,0.00
2024-12-08 17:10:12,85,1691,43,42,987.27,1741.00,0.00
2024-12-08 17:10:12,86,1691,44,42,975.79,1741.01,0.00
2024-12-08 17:10:12,85,1691,44,41,985.24,1741.08,0.00
2024-12-08 17:10:12,84,1691,43,41,995.94,1741.08,0.00
2024-12-08 17:10:12,84,1692,43,41,1022.00,1742.00,0.00
2024-12-08 17:10:12,85,1692,43,42,1009.97,1742.01,0.00
2024-12-08 17:10:12,85,1693,43,42,1005.63,1743.00,0.00
2024-12-08 17:10:12,86,1693,43,43,993.94,1743.01,0.00
2024-12-08 17:10:12,85,1693,42,43,1004.42,1743.07,0.00
2024-12-08 17:10:12,84,1693,42,42,1015.34,1743.07,0.00
2024-12-08 17:10:12,83,1693,41,42,1014.21,1743.65,0.00
2024-12-08 17:10:12,83,1694,41,42,1029.40,1744.00,0.00
2024-12-08 17:10:13,84,1694,42,42,1017.15,1744.01,0.00
2024-12-08 17:10:13,84,1695,42,42,1012.82,1745.00,0.00
2024-12-08 17:10:13,85,1695,42,43,1000.90,1745.01,0.00
2024-12-08 17:10:13,84,1695,42,42,1010.97,1745.07,0.00
2024-12-08 17:10:13,83,1695,41,42,1022.10,1745.07,0.00
2024-12-08 17:10:13,83,1696,41,42,1027.38,1746.00,0.00
2024-12-08 17:10:13,84,1696,42,42,1015.15,1746.01,0.00
2024-12-08 17:10:13,84,1697,42,42,1010.65,1747.00,0.00
2024-12-08 17:10:13,85,1697,42,43,998.76,1747.01,0.00
2024-12-08 17:10:13,84,1697,41,43,1008.59,1747.07,0.00
2024-12-08 17:10:13,84,1698,41,43,1009.34,1748.00,0.00
2024-12-08 17:10:13,85,1698,41,44,997.46,1748.01,0.00
2024-12-08 17:10:13,84,1698,41,43,1007.33,1748.07,0.00
2024-12-08 17:10:13,84,1699,41,43,1008.18,1749.00,0.00
2024-12-08 17:10:13,85,1699,41,44,996.32,1749.01,0.00
2024-12-08 17:10:13,84,1699,41,43,1006.11,1749.07,0.00
2024-12-08 17:10:13,84,1700,41,43,1007.03,1750.00,0.00
2024-12-08 17:10:13,85,1700,41,44,995.18,1750.01,0.00
2024-12-08 17:10:13,86,1699,42,44,966.67,1750.55,0.00
2024-12-08 17:10:13,86,1700,42,44,986.35,1751.00,0.00
2024-12-08 17:10:13,87,1700,43,44,975.02,1751.01,0.00
2024-12-08 17:10:13,86,1700,43,43,984.54,1751.07,0.00
2024-12-08 17:10:13,86,1701,43,43,1005.22,1752.00,0.00
2024-12-08 17:10:13,87,1701,44,43,993.67,1752.01,0.00
2024-12-08 17:10:13,87,1702,44,43,988.87,1753.00,0.00
2024-12-08 17:10:13,88,1702,44,44,977.64,1753.01,0.00
2024-12-08 17:10:13,87,1702,44,43,986.87,1753.08,0.00
2024-12-08 17:10:13,86,1702,43,43,997.33,1753.08,0.00
2024-12-08 17:10:13,85,1702,42,43,1006.63,1753.22,0.00
2024-12-08 17:10:13,85,1703,42,43,1014.11,1754.00,0.00
2024-12-08 17:10:13,86,1703,43,43,1002.32,1754.01,0.00
2024-12-08 17:10:13,85,1703,42,43,1013.90,1754.01,0.00
2024-12-08 17:10:13,84,1703,41,43,1008.08,1754.63,0.00
2024-12-08 17:10:13,84,1704,41,43,1022.80,1755.00,0.00
2024-12-08 17:10:13,85,1704,41,44,1010.76,1755.01,0.00
2024-12-08 17:10:13,84,1704,40,44,1022.59,1755.01,0.00
2024-12-08 17:10:13,83,1704,39,44,1027.10,1755.10,0.00
2024-12-08 17:10:13,83,1705,39,44,1032.96,1756.00,0.00
2024-12-08 17:10:13,84,1705,39,45,1020.66,1756.01,0.00
2024-12-08 17:10:13,83,1705,39,44,1031.49,1756.06,0.00
2024-12-08 17:10:13,83,1706,39,44,1032.49,1757.00,0.00
2024-12-08 17:10:13,84,1706,40,44,1020.20,1757.01,0.00
2024-12-08 17:10:13,83,1706,40,43,1030.81,1757.06,0.00
2024-12-08 17:10:13,83,1707,40,43,1031.56,1758.00,0.00
2024-12-08 17:10:13,84,1707,40,44,1019.28,1758.01,0.00
2024-12-08 17:10:13,84,1708,40,44,1014.63,1759.00,0.00
2024-12-08 17:10:13,85,1708,41,44,1002.69,1759.01,0.00
2024-12-08 17:10:13,84,1708,41,43,1013.17,1759.06,0.00
2024-12-08 17:10:13,84,1709,41,43,1013.47,1760.00,0.00
2024-12-08 17:10:13,85,1709,42,43,1001.55,1760.01,0.00
2024-12-08 17:10:13,85,1710,42,43,996.74,1761.00,0.00
2024-12-08 17:10:13,86,1710,42,44,985.15,1761.01,0.00
2024-12-08 17:10:13,85,1710,42,43,996.13,1761.04,0.00
2024-12-08 17:10:13,86,1709,43,43,978.03,1761.20,0.00
2024-12-08 17:10:13,86,1710,43,43,993.90,1762.00,0.00
2024-12-08 17:10:13,87,1710,44,43,982.48,1762.01,0.00
2024-12-08 17:10:13,86,1710,44,42,992.48,1762.05,0.00
2024-12-08 17:10:14,86,1711,44,42,1012.95,1763.00,0.00
2024-12-08 17:10:14,87,1711,45,42,1001.31,1763.01,0.00
2024-12-08 17:10:14,86,1711,45,41,1011.53,1763.05,0.00
2024-12-08 17:10:14,85,1711,44,41,1017.60,1763.27,0.00
2024-12-08 17:10:14,85,1712,44,41,1025.73,1764.00,0.00
2024-12-08 17:10:14,86,1712,44,42,1013.81,1764.01,0.00
2024-12-08 17:10:14,85,1712,43,42,1023.88,1764.06,0.00
2024-12-08 17:10:14,85,1713,43,42,1022.56,1765.00,0.00
2024-12-08 17:10:14,86,1713,43,43,1010.67,1765.01,0.00
2024-12-08 17:10:14,86,1714,43,43,1004.12,1766.00,0.00
2024-12-08 17:10:14,87,1714,43,44,992.58,1766.01,0.00
2024-12-08 17:10:14,86,1714,43,43,1003.11,1766.05,0.00
2024-12-08 17:10:14,86,1715,43,43,1001.94,1767.00,0.00
2024-12-08 17:10:14,87,1715,44,43,990.43,1767.01,0.00
2024-12-08 17:10:14,86,1715,44,42,1000.72,1767.05,0.00
2024-12-08 17:10:14,87,1714,45,42,987.63,1767.16,0.00
2024-12-08 17:10:14,87,1715,45,42,1003.39,1768.00,0.00
2024-12-08 17:10:14,88,1715,46,42,991.99,1768.01,0.00
2024-12-08 17:10:14,88,1716,46,42,1005.00,1769.00,0.00
2024-12-08 17:10:14,89,1716,47,42,993.71,1769.01,0.00
2024-12-08 17:10:14,88,1716,47,41,1004.00,1769.05,0.00
2024-12-08 17:10:14,88,1717,47,41,1000.81,1770.00,0.00
2024-12-08 17:10:14,89,1717,48,41,989.56,1770.01,0.00
2024-12-08 17:10:14,88,1717,47,41,1000.42,1770.02,0.00
2024-12-08 17:10:14,89,1716,48,41,983.44,1770.15,0.00
2024-12-08 17:10:14,88,1716,48,40,1005.37,1770.19,0.00
2024-12-08 17:10:14,88,1717,48,40,1007.52,1771.00,0.00
2024-12-08 17:10:14,89,1717,49,40,996.20,1771.01,0.00
2024-12-08 17:10:14,88,1717,49,39,1006.73,1771.05,0.00
2024-12-08 17:10:14,88,1718,49,39,1026.60,1772.00,0.00
2024-12-08 17:10:14,89,1718,50,39,1015.07,1772.01,0.00
2024-12-08 17:10:14,89,1719,50,39,1010.06,1773.00,0.00
2024-12-08 17:10:14,90,1719,50,40,998.84,1773.01,0.00
2024-12-08 17:10:14,89,1719,49,40,998.39,1773.23,0.00
2024-12-08 17:10:14,89,1720,49,40,1005.05,1774.00,0.00
2024-12-08 17:10:14,90,1720,50,40,993.89,1774.01,0.00
2024-12-08 17:10:14,89,1720,50,39,1004.07,1774.06,0.00
2024-12-08 17:10:14,88,1720,49,39,1012.72,1774.22,0.00
2024-12-08 17:10:14,88,1721,49,39,1015.43,1775.00,0.00
2024-12-08 17:10:14,89,1721,49,40,1004.02,1775.01,0.00
2024-12-08 17:10:14,88,1721,49,39,1014.44,1775.06,0.00
2024-12-08 17:10:14,88,1722,49,39,1014.39,1776.00,0.00
2024-12-08 17:10:14,89,1722,49,40,1002.99,1776.01,0.00
2024-12-08 17:10:14,89,1723,49,40,997.97,1777.00,0.00
2024-12-08 17:10:14,90,1723,49,41,986.88,1777.01,0.00
2024-12-08 17:10:14,89,1723,49,40,996.59,1777.07,0.00
2024-12-08 17:10:14,88,1723,48,40,1005.11,1777.13,0.00
2024-12-08 17:10:14,88,1724,48,40,1010.28,1778.00,0.00
2024-12-08 17:10:14,89,1724,48,41,998.93,1778.01,0.00
2024-12-08 17:10:14,89,1725,48,41,993.89,1779.00,0.00
2024-12-08 17:10:14,90,1725,49,41,982.85,1779.01,0.00
2024-12-08 17:10:14,89,1725,48,41,986.88,1779.18,0.00
2024-12-08 17:10:14,89,1726,48,41,988.78,1780.00,0.00
2024-12-08 17:10:14,90,1726,49,41,977.80,1780.01,0.00
2024-12-08 17:10:14,89,1726,49,40,985.18,1780.01,0.00
2024-12-08 17:10:14,88,1726,48,40,996.18,1780.01,0.00
2024-12-08 17:10:14,88,1727,48,40,995.20,1781.00,0.00
2024-12-08 17:10:14,89,1727,48,41,984.02,1781.01,0.00
2024-12-08 17:10:15,89,1728,48,41,978.86,1782.00,0.00
2024-12-08 17:10:15,90,1728,49,41,967.98,1782.01,0.00
2024-12-08 17:10:15,89,1728,48,41,971.67,1782.09,0.00
2024-12-08 17:10:15,89,1729,48,41,976.00,1783.00,0.00
2024-12-08 17:10:15,90,1729,48,42,965.16,1783.01,0.00
2024-12-08 17:10:15,90,1730,48,42,959.95,1784.00,0.00
2024-12-08 17:10:15,91,1730,48,43,949.40,1784.01,0.00
2024-12-08 17:10:15,90,1730,47,43,951.50,1784.26,0.00
2024-12-08 17:10:15,89,1730,46,43,962.14,1784.26,0.00
2024-12-08 17:10:15,89,1731,46,43,965.42,1785.00,0.00
2024-12-08 17:10:15,90,1731,46,44,954.69,1785.01,0.00
2024-12-08 17:10:15,89,1731,46,43,964.22,1785.05,0.00
2024-12-08 17:10:15,89,1732,46,43,963.75,1786.00,0.00
2024-12-08 17:10:15,90,1732,46,44,953.04,1786.01,0.00
2024-12-08 17:10:15,90,1733,46,44,947.82,1787.00,0.00
2024-12-08 17:10:15,91,1733,46,45,937.40,1787.01,0.00
2024-12-08 17:10:15,92,1732,47,45,921.22,1787.15,0.00
2024-12-08 17:10:15,93,1731,47,46,921.70,1787.17,0.00
2024-12-08 17:10:15,92,1731,46,46,932.64,1787.52,0.00
2024-12-08 17:10:15,92,1732,46,46,939.98,1788.00,0.00
2024-12-08 17:10:15,93,1732,46,47,929.87,1788.01,0.00
2024-12-08 17:10:15,92,1732,45,47,934.93,1788.08,0.00
2024-12-08 17:10:15,92,1733,45,47,973.36,1789.00,0.00
2024-12-08 17:10:15,93,1733,45,48,962.90,1789.01,0.00
2024-12-08 17:10:15,93,1734,45,48,957.28,1790.00,0.00
2024-12-08 17:10:15,94,1734,45,49,947.09,1790.01,0.00
2024-12-08 17:10:15,93,1734,44,49,957.08,1790.01,0.00
2024-12-08 17:10:15,92,1734,44,48,966.91,1790.03,0.00
2024-12-08 17:10:15,91,1734,43,48,974.05,1790.23,0.00
2024-12-08 17:10:15,90,1734,42,48,975.42,1790.77,0.00
2024-12-08 17:10:15,90,1735,42,48,991.33,1791.00,0.00
2024-12-08 17:10:15,91,1735,43,48,980.44,1791.01,0.00
2024-12-08 17:10:15,90,1735,43,47,989.88,1791.04,0.00
2024-12-08 17:10:15,90,1736,43,47,989.23,1792.00,0.00
2024-12-08 17:10:15,91,1736,43,48,978.36,1792.01,0.00
2024-12-08 17:10:15,90,1736,43,47,985.05,1792.04,0.00
2024-12-08 17:10:15,90,1737,43,47,984.40,1793.00,0.00
2024-12-08 17:10:15,91,1737,43,48,973.59,1793.01,0.00
2024-12-08 17:10:15,90,1737,43,47,980.22,1793.04,0.00
2024-12-08 17:10:15,90,1738,43,47,979.57,1794.00,0.00
2024-12-08 17:10:15,91,1738,44,47,968.80,1794.01,0.00
2024-12-08 17:10:15,91,1739,44,47,963.43,1795.00,0.00
2024-12-08 17:10:15,92,1739,44,48,952.96,1795.01,0.00
2024-12-08 17:10:15,91,1739,44,47,958.88,1795.04,0.00
2024-12-08 17:10:15,91,1740,44,47,958.02,1796.00,0.00
2024-12-08 17:10:15,92,1740,45,47,947.61,1796.01,0.00
2024-12-08 17:10:15,91,1740,45,46,954.28,1796.04,0.00
2024-12-08 17:10:15,92,1739,46,46,943.72,1796.08,0.00
2024-12-08 17:10:15,92,1740,46,46,944.82,1797.00,0.00
2024-12-08 17:10:15,93,1740,47,46,934.66,1797.01,0.00
2024-12-08 17:10:15,93,1741,47,46,948.33,1798.00,0.00
2024-12-08 17:10:15,94,1741,48,46,938.24,1798.01,0.00
2024-12-08 17:10:15,93,1741,47,46,947.92,1798.03,0.00
2024-12-08 17:10:15,94,1740,48,46,915.48,1798.89,0.00
2024-12-08 17:10:15,94,1741,48,46,934.52,1799.00,0.00
2024-12-08 17:10:15,95,1741,48,47,924.69,1799.01,0.00
2024-12-08 17:10:15,94,1741,47,47,929.57,1799.07,0.00
2024-12-08 17:10:15,94,1742,47,47,947.87,1800.00,0.00
2024-12-08 17:10:15,95,1742,47,48,937.89,1800.01,0.00
2024-12-08 17:10:15,94,1742,47,47,943.87,1800.05,0.00
2024-12-08 17:10:15,93,1742,46,47,953.63,1800.07,0.00
2024-12-08 17:10:16,93,1743,46,47,952.79,1801.00,0.00
2024-12-08 17:10:16,94,1743,46,48,942.65,1801.01,0.00
2024-12-08 17:10:16,93,1743,45,48,952.79,1801.01,0.00
2024-12-08 17:10:16,92,1743,45,47,959.24,1801.04,0.00
2024-12-08 17:10:16,92,1744,45,47,958.19,1802.00,0.00
2024-12-08 17:10:16,93,1744,46,47,947.89,1802.01,0.00
2024-12-08 17:10:16,92,1744,45,47,954.28,1802.01,0.00
2024-12-08 17:10:16,91,1744,45,46,960.62,1802.03,0.00
2024-12-08 17:10:16,91,1745,45,46,963.51,1803.00,0.00
2024-12-08 17:10:16,92,1745,46,46,953.04,1803.01,0.00
2024-12-08 17:10:16,91,1745,46,45,959.37,1803.03,0.00
2024-12-08 17:10:16,90,1745,45,45,970.03,1803.03,0.00
2024-12-08 17:10:16,89,1745,44,45,964.61,1803.73,0.00
2024-12-08 17:10:16,89,1746,44,45,980.24,1804.00,0.00
2024-12-08 17:10:16,90,1746,45,45,969.35,1804.01,0.00
2024-12-08 17:10:16,89,1746,45,44,975.79,1804.03,0.00
2024-12-08 17:10:16,90,1745,45,45,953.39,1804.71,0.00
2024-12-08 17:10:16,90,1746,45,45,969.08,1805.00,0.00
2024-12-08 17:10:16,91,1746,46,45,958.43,1805.01,0.00
2024-12-08 17:10:16,91,1747,46,45,972.86,1806.00,0.00
2024-12-08 17:10:16,92,1747,46,46,962.28,1806.01,0.00
2024-12-08 17:10:16,91,1747,45,46,970.49,1806.08,0.00
2024-12-08 17:10:16,91,1748,45,46,970.22,1807.00,0.00
2024-12-08 17:10:16,92,1748,46,46,959.67,1807.01,0.00
2024-12-08 17:10:16,91,1748,46,45,969.44,1807.04,0.00
2024-12-08 17:10:16,91,1749,46,45,968.57,1808.00,0.00
2024-12-08 17:10:16,92,1749,47,45,958.04,1808.01,0.00
2024-12-08 17:10:16,91,1749,47,44,966.60,1808.07,0.00
2024-12-08 17:10:16,92,1748,48,44,956.09,1808.09,0.00
2024-12-08 17:10:16,92,1749,48,44,970.53,1809.00,0.00
2024-12-08 17:10:16,93,1749,49,44,960.10,1809.01,0.00
2024-12-08 17:10:16,92,1749,48,44,968.00,1809.09,0.00
2024-12-08 17:10:16,92,1750,48,44,987.37,1810.00,0.00
2024-12-08 17:10:16,93,1750,48,45,976.76,1810.01,0.00
2024-12-08 17:10:16,92,1750,47,45,986.60,1810.04,0.00
2024-12-08 17:10:16,91,1750,46,45,997.24,1810.04,0.00
2024-12-08 17:10:16,90,1750,46,44,1006.72,1810.07,0.00
2024-12-08 17:10:16,89,1750,45,44,1014.43,1810.26,0.00
2024-12-08 17:10:16,89,1751,45,44,1017.70,1811.00,0.00
2024-12-08 17:10:16,90,1751,45,45,1006.40,1811.01,0.00
2024-12-08 17:10:16,90,1752,45,45,1001.04,1812.00,0.00
2024-12-08 17:10:16,91,1752,45,46,990.04,1812.01,0.00
2024-12-08 17:10:16,90,1752,45,45,998.85,1812.08,0.00
2024-12-08 17:10:16,91,1751,45,46,979.87,1812.55,0.00
2024-12-08 17:10:16,91,1752,45,46,995.17,1813.00,0.00
2024-12-08 17:10:16,92,1752,45,47,984.35,1813.01,0.00
2024-12-08 17:10:16,91,1752,44,47,994.19,1813.06,0.00
2024-12-08 17:10:16,91,1753,44,47,1009.42,1814.00,0.00
2024-12-08 17:10:16,92,1753,44,48,998.44,1814.01,0.00
2024-12-08 17:10:16,91,1753,43,48,1007.65,1814.07,0.00
2024-12-08 17:10:16,90,1753,43,47,1017.23,1814.09,0.00
2024-12-08 17:10:16,90,1754,43,47,1021.24,1815.00,0.00
2024-12-08 17:10:16,91,1754,43,48,1010.02,1815.01,0.00
2024-12-08 17:10:16,90,1754,42,48,1009.01,1815.24,0.00
2024-12-08 17:10:16,90,1755,42,48,1015.91,1816.00,0.00
2024-12-08 17:10:16,91,1755,43,48,1004.75,1816.01,0.00
2024-12-08 17:10:16,90,1755,43,47,1013.51,1816.09,0.00
2024-12-08 17:10:16,89,1755,42,47,1023.48,1816.10,0.00
2024-12-08 17:10:16,89,1756,42,47,1028.09,1817.00,0.00
2024-12-08 17:10:16,90,1756,42,48,1016.67,1817.01,0.00
2024-12-08 17:10:16,89,1756,41,48,1027.30,1817.06,0.00
2024-12-08 17:10:16,88,1756,40,48,1025.66,1817.41,0.00
2024-12-08 17:10:17,88,1757,40,48,1036.01,1818.00,0.00
2024-12-08 17:10:17,89,1757,40,49,1024.37,1818.01,0.00
2024-12-08 17:10:17,88,1757,39,49,1034.80,1818.07,0.00
2024-12-08 17:10:17,88,1758,39,49,1030.79,1819.00,0.00
2024-12-08 17:10:17,89,1758,40,49,1019.21,1819.01,0.00
2024-12-08 17:10:17,88,1758,40,48,1028.75,1819.08,0.00
2024-12-08 17:10:17,87,1758,39,48,1037.49,1819.24,0.00
2024-12-08 17:10:17,87,1759,39,48,1040.72,1820.00,0.00
2024-12-08 17:10:17,88,1759,40,48,1028.89,1820.01,0.00
2024-12-08 17:10:17,87,1759,40,47,1038.65,1820.08,0.00
2024-12-08 17:10:17,88,1758,40,48,1013.52,1820.81,0.00
2024-12-08 17:10:17,88,1759,40,48,1029.83,1821.00,0.00
2024-12-08 17:10:17,89,1759,40,49,1018.26,1821.01,0.00
2024-12-08 17:10:17,88,1759,39,49,1017.68,1821.23,0.00
2024-12-08 17:10:17,88,1760,39,49,1044.00,1822.00,0.00
2024-12-08 17:10:17,89,1760,39,50,1032.27,1822.01,0.00
2024-12-08 17:10:17,88,1760,38,50,1042.16,1822.08,0.00
2024-12-08 17:10:17,87,1760,38,49,1053.30,1822.08,0.00
2024-12-08 17:10:17,87,1761,38,49,1056.50,1823.00,0.00
2024-12-08 17:10:17,88,1761,39,49,1044.49,1823.01,0.00
2024-12-08 17:10:17,88,1762,39,49,1038.61,1824.00,0.00
2024-12-08 17:10:17,89,1762,40,49,1026.94,1824.01,0.00
2024-12-08 17:10:17,88,1762,40,48,1034.90,1824.06,0.00
2024-12-08 17:10:17,87,1762,39,48,1043.69,1824.23,0.00
2024-12-08 17:10:17,87,1763,39,48,1046.67,1825.00,0.00
2024-12-08 17:10:17,88,1763,39,49,1034.78,1825.01,0.00
2024-12-08 17:10:17,87,1763,39,48,1045.02,1825.07,0.00
2024-12-08 17:10:17,87,1764,39,48,1045.36,1826.00,0.00
2024-12-08 17:10:17,88,1764,40,48,1033.48,1826.01,0.00
2024-12-08 17:10:17,87,1764,39,48,1044.74,1826.03,0.00
2024-12-08 17:10:17,87,1765,39,48,1040.26,1827.00,0.00
2024-12-08 17:10:17,88,1765,39,49,1028.44,1827.01,0.00
2024-12-08 17:10:17,87,1765,39,48,1040.05,1827.01,0.00
2024-12-08 17:10:17,86,1765,38,48,1048.76,1827.04,0.00
2024-12-08 17:10:17,86,1766,38,48,1048.68,1828.00,0.00
2024-12-08 17:10:17,87,1766,39,48,1036.63,1828.01,0.00
2024-12-08 17:10:17,86,1766,39,47,1048.06,1828.04,0.00
2024-12-08 17:10:17,86,1767,39,47,1047.98,1829.00,0.00
2024-12-08 17:10:17,87,1767,39,48,1035.93,1829.01,0.00
2024-12-08 17:10:17,86,1767,39,47,1047.36,1829.04,0.00
2024-12-08 17:10:17,86,1768,39,47,1047.17,1830.00,0.00
2024-12-08 17:10:17,87,1768,40,47,1035.14,1830.01,0.00
2024-12-08 17:10:17,86,1768,40,46,1042.30,1830.04,0.00
2024-12-08 17:10:17,85,1768,39,46,1054.13,1830.04,0.00
2024-12-08 17:10:17,85,1769,39,46,1058.29,1831.00,0.00
2024-12-08 17:10:17,86,1769,40,46,1045.98,1831.01,0.00
2024-12-08 17:10:17,87,1768,41,46,1020.79,1831.30,0.00
2024-12-08 17:10:17,88,1767,42,46,1023.67,1831.41,0.00
2024-12-08 17:10:17,88,1768,42,46,1043.09,1832.00,0.00
2024-12-08 17:10:17,89,1768,43,46,1031.37,1832.01,0.00
2024-12-08 17:10:17,88,1768,42,46,1042.48,1832.03,0.00
2024-12-08 17:10:17,88,1769,42,46,1079.37,1833.00,0.00
2024-12-08 17:10:17,89,1769,42,47,1067.24,1833.01,0.00
2024-12-08 17:10:17,88,1769,42,46,1078.76,1833.03,0.00
2024-12-08 17:10:17,88,1770,42,46,1078.29,1834.00,0.00
2024-12-08 17:10:17,89,1770,42,47,1066.17,1834.01,0.00
2024-12-08 17:10:17,88,1770,42,46,1077.47,1834.03,0.00
2024-12-08 17:10:17,88,1771,42,46,1077.00,1835.00,0.00
2024-12-08 17:10:17,89,1771,43,46,1064.90,1835.01,0.00
2024-12-08 17:10:17,89,1772,43,46,1059.70,1836.00,0.00
2024-12-08 17:10:17,90,1772,43,47,1047.93,1836.01,0.00
2024-12-08 17:10:17,89,1772,43,46,1059.10,1836.03,0.00
2024-12-08 17:10:18,89,1773,43,46,1058.28,1837.00,0.00
2024-12-08 17:10:18,90,1773,43,47,1046.52,1837.01,0.00
2024-12-08 17:10:18,89,1773,42,47,1057.68,1837.03,0.00
2024-12-08 17:10:18,89,1774,42,47,1052.79,1838.00,0.00
2024-12-08 17:10:18,90,1774,42,48,1041.09,1838.01,0.00
2024-12-08 17:10:18,89,1774,42,47,1052.18,1838.03,0.00
2024-12-08 17:10:18,89,1775,42,47,1051.26,1839.00,0.00
2024-12-08 17:10:18,90,1775,43,47,1039.58,1839.01,0.00
2024-12-08 17:10:18,90,1776,43,47,1033.25,1840.00,0.00
2024-12-08 17:10:18,91,1776,43,48,1021.90,1840.01,0.00
2024-12-08 17:10:18,91,1777,43,48,1015.18,1841.00,0.00
2024-12-08 17:10:18,92,1777,43,49,1004.14,1841.01,0.00
2024-12-08 17:10:18,91,1777,43,48,1014.58,1841.03,0.00
2024-12-08 17:10:18,91,1778,43,48,1012.52,1842.00,0.00
2024-12-08 17:10:18,92,1778,44,48,1001.52,1842.01,0.00
2024-12-08 17:10:18,91,1778,44,47,1011.12,1842.06,0.00
2024-12-08 17:10:18,90,1778,43,47,1020.73,1842.08,0.00
2024-12-08 17:10:18,91,1777,44,47,998.78,1842.65,0.00
2024-12-08 17:10:18,91,1778,44,47,1018.56,1843.00,0.00
2024-12-08 17:10:18,92,1778,45,47,1007.49,1843.01,0.00
2024-12-08 17:10:18,92,1779,45,47,1020.90,1844.00,0.00
2024-12-08 17:10:18,93,1779,45,48,1009.92,1844.01,0.00
2024-12-08 17:10:18,92,1779,45,47,1019.32,1844.07,0.00
2024-12-08 17:10:18,93,1778,46,47,1001.17,1844.48,0.00
2024-12-08 17:10:18,93,1779,46,47,1014.99,1845.00,0.00
2024-12-08 17:10:18,94,1779,47,47,1004.19,1845.01,0.00
2024-12-08 17:10:18,93,1779,47,46,1010.05,1845.05,0.00
2024-12-08 17:10:18,93,1780,47,46,1027.80,1846.00,0.00
2024-12-08 17:10:18,94,1780,48,46,1016.86,1846.01,0.00
2024-12-08 17:10:18,93,1780,47,46,1024.24,1846.03,0.00
2024-12-08 17:10:18,94,1779,47,47,1007.85,1846.14,0.00
2024-12-08 17:10:18,94,1780,47,47,1017.61,1847.00,0.00
2024-12-08 17:10:18,95,1780,48,47,1006.89,1847.01,0.00
2024-12-08 17:10:18,95,1781,48,47,1018.67,1848.00,0.00
2024-12-08 17:10:18,96,1781,49,47,1008.06,1848.01,0.00
2024-12-08 17:10:18,95,1781,49,46,1015.96,1848.10,0.00
2024-12-08 17:10:18,96,1780,50,46,1000.66,1848.38,0.00
2024-12-08 17:10:18,97,1779,50,47,999.62,1848.41,0.00
2024-12-08 17:10:18,97,1780,50,47,1012.88,1849.00,0.00
2024-12-08 17:10:18,98,1780,51,47,1002.55,1849.01,0.00
2024-12-08 17:10:18,97,1780,50,47,1012.13,1849.05,0.00
2024-12-08 17:10:18,96,1780,49,47,1022.48,1849.05,0.00
2024-12-08 17:10:18,96,1781,49,47,1055.09,1850.00,0.00
2024-12-08 17:10:18,97,1781,50,47,1044.21,1850.01,0.00
2024-12-08 17:10:18,97,1782,50,47,1037.30,1851.00,0.00
2024-12-08 17:10:18,98,1782,50,48,1026.71,1851.01,0.00
2024-12-08 17:10:18,97,1782,49,48,1028.22,1851.26,0.00
2024-12-08 17:10:18,97,1783,49,48,1030.00,1852.00,0.00
2024-12-08 17:10:18,98,1783,50,48,1019.49,1852.01,0.00
2024-12-08 17:10:18,99,1782,50,49,1009.01,1852.04,0.00
2024-12-08 17:10:18,99,1783,50,49,1010.67,1853.00,0.00
2024-12-08 17:10:18,100,1783,51,49,1000.56,1853.01,0.00
2024-12-08 17:10:18,99,1783,50,49,1009.75,1853.06,0.00
2024-12-08 17:10:18,99,1784,50,49,1022.63,1854.00,0.00
2024-12-08 17:10:18,100,1784,51,49,1012.41,1854.01,0.00
2024-12-08 17:10:18,99,1784,50,49,1021.31,1854.06,0.00
2024-12-08 17:10:18,98,1784,50,48,1029.28,1854.06,0.00
2024-12-08 17:10:18,97,1784,49,48,1036.32,1854.25,0.00
2024-12-08 17:10:18,96,1784,48,48,1044.84,1854.35,0.00
2024-12-08 17:10:18,96,1785,48,48,1048.75,1855.00,0.00
2024-12-08 17:10:18,97,1785,49,48,1037.94,1855.01,0.00
2024-12-08 17:10:19,98,1784,49,49,1018.02,1855.32,0.00
2024-12-08 17:10:19,98,1785,49,49,1031.53,1856.00,0.00
2024-12-08 17:10:19,99,1785,49,50,1021.11,1856.01,0.00
2024-12-08 17:10:19,98,1785,49,49,1027.26,1856.06,0.00
2024-12-08 17:10:19,98,1786,49,49,1044.46,1857.00,0.00
2024-12-08 17:10:19,99,1786,50,49,1033.91,1857.01,0.00
2024-12-08 17:10:19,98,1786,50,48,1035.51,1857.06,0.00
2024-12-08 17:10:19,97,1786,49,48,1042.98,1857.24,0.00
2024-12-08 17:10:19,97,1787,49,48,1048.45,1858.00,0.00
2024-12-08 17:10:19,98,1787,49,49,1037.75,1858.01,0.00
2024-12-08 17:10:19,97,1787,49,48,1043.44,1858.06,0.00
2024-12-08 17:10:19,97,1788,49,48,1041.86,1859.00,0.00
2024-12-08 17:10:19,98,1788,50,48,1031.23,1859.01,0.00
2024-12-08 17:10:19,97,1788,49,48,1029.86,1859.25,0.00
2024-12-08 17:10:19,97,1789,49,48,1035.38,1860.00,0.00
2024-12-08 17:10:19,98,1789,50,48,1024.81,1860.01,0.00
2024-12-08 17:10:19,97,1789,49,48,1034.43,1860.06,0.00
2024-12-08 17:10:19,96,1789,49,47,1044.71,1860.07,0.00
2024-12-08 17:10:19,95,1789,48,47,1048.05,1860.48,0.00
2024-12-08 17:10:19,95,1790,48,47,1054.27,1861.00,0.00
2024-12-08 17:10:19,96,1790,49,47,1043.29,1861.01,0.00
2024-12-08 17:10:19,95,1790,48,47,1053.61,1861.04,0.00
2024-12-08 17:10:19,95,1791,48,47,1047.91,1862.00,0.00
2024-12-08 17:10:19,96,1791,49,47,1036.99,1862.01,0.00
2024-12-08 17:10:19,95,1791,48,47,1047.33,1862.03,0.00
2024-12-08 17:10:19,94,1791,48,46,1057.75,1862.05,0.00
2024-12-08 17:10:19,95,1790,48,47,1032.33,1862.86,0.00
2024-12-08 17:10:19,95,1791,48,47,1051.67,1863.00,0.00
2024-12-08 17:10:19,96,1791,48,48,1040.72,1863.01,0.00
2024-12-08 17:10:19,96,1792,48,48,1053.89,1864.00,0.00
2024-12-08 17:10:19,97,1792,49,48,1043.03,1864.01,0.00
2024-12-08 17:10:19,96,1792,49,47,1052.94,1864.05,0.00
2024-12-08 17:10:19,95,1792,48,47,1060.33,1864.17,0.00
2024-12-08 17:10:19,95,1793,48,47,1064.97,1865.00,0.00
2024-12-08 17:10:19,96,1793,48,48,1053.88,1865.01,0.00
2024-12-08 17:10:19,95,1793,48,47,1060.68,1865.05,0.00
2024-12-08 17:10:19,95,1794,48,47,1059.27,1866.00,0.00
2024-12-08 17:10:19,96,1794,49,47,1048.24,1866.01,0.00
2024-12-08 17:10:19,95,1794,48,47,1051.11,1866.24,0.00
2024-12-08 17:10:19,95,1795,48,47,1053.16,1867.00,0.00
2024-12-08 17:10:19,96,1795,48,48,1042.19,1867.01,0.00
2024-12-08 17:10:19,96,1796,48,48,1035.94,1868.00,0.00
2024-12-08 17:10:19,97,1796,48,49,1025.26,1868.01,0.00
2024-12-08 17:10:19,96,1796,47,49,1030.89,1868.07,0.00
2024-12-08 17:10:19,97,1795,48,49,1017.63,1868.24,0.00
2024-12-08 17:10:19,96,1795,47,49,1036.81,1868.26,0.00
2024-12-08 17:10:19,96,1795,47,49,1038.89,1869.00,0.00
2024-12-08 17:10:19,97,1795,48,49,1028.18,1869.01,0.00
2024-12-08 17:10:19,98,1794,48,50,1016.94,1869.07,0.00
2024-12-08 17:10:19,98,1795,48,50,1048.96,1870.00,0.00
2024-12-08 17:10:19,99,1795,48,51,1038.37,1870.01,0.00
2024-12-08 17:10:19,99,1796,48,51,1049.70,1871.00,0.00
2024-12-08 17:10:19,100,1796,48,52,1039.20,1871.01,0.00
2024-12-08 17:10:19,99,1796,47,52,1049.14,1871.03,0.00
2024-12-08 17:10:19,100,1795,48,52,1022.32,1871.74,0.00
2024-12-08 17:10:19,99,1795,47,52,1029.17,1871.94,0.00
2024-12-08 17:10:19,99,1796,47,52,1047.00,1872.00,0.00
2024-12-08 17:10:19,100,1796,47,53,1036.53,1872.01,0.00
2024-12-08 17:10:19,101,1795,48,53,1012.58,1872.57,0.00
2024-12-08 17:10:20,101,1796,48,53,1044.43,1873.00,0.00
2024-12-08 17:10:20,102,1796,48,54,1034.19,1873.01,0.00
2024-12-08 17:10:20,101,1796,48,53,1040.36,1873.04,0.00
2024-12-08 17:10:20,100,1796,47,53,1042.46,1873.49,0.00
2024-12-08 17:10:20,100,1797,47,53,1067.00,1874.00,0.00
2024-12-08 17:10:20,101,1797,48,53,1056.44,1874.01,0.00
2024-12-08 17:10:20,100,1797,48,52,1063.83,1874.04,0.00
2024-12-08 17:10:20,100,1798,48,52,1060.72,1875.00,0.00
2024-12-08 17:10:20,101,1798,48,53,1050.22,1875.01,0.00
2024-12-08 17:10:20,100,1798,48,52,1053.98,1875.04,0.00
2024-12-08 17:10:20,100,1799,48,52,1054.60,1876.00,0.00
2024-12-08 17:10:20,101,1799,49,52,1044.16,1876.01,0.00
2024-12-08 17:10:20,100,1799,48,52,1054.42,1876.01,0.00
2024-12-08 17:10:20,100,1800,48,52,1045.83,1877.00,0.00
2024-12-08 17:10:20,101,1800,48,53,1035.48,1877.01,0.00
2024-12-08 17:10:20,100,1800,48,52,1045.09,1877.03,0.00
2024-12-08 17:10:20,99,1800,47,52,1051.18,1877.27,0.00
2024-12-08 17:10:20,99,1801,47,52,1049.23,1878.00,0.00
2024-12-08 17:10:20,100,1801,47,53,1038.74,1878.01,0.00
2024-12-08 17:10:20,99,1801,47,52,1046.58,1878.03,0.00
2024-12-08 17:10:20,99,1802,47,52,1041.10,1879.00,0.00
2024-12-08 17:10:20,100,1802,47,53,1030.69,1879.01,0.00
2024-12-08 17:10:20,99,1802,47,52,1040.25,1879.03,0.00
2024-12-08 17:10:20,99,1803,47,52,1036.16,1880.00,0.00
2024-12-08 17:10:20,100,1803,47,53,1025.80,1880.01,0.00
2024-12-08 17:10:20,99,1803,47,52,1033.32,1880.03,0.00
2024-12-08 17:10:20,99,1804,47,52,1028.54,1881.00,0.00
2024-12-08 17:10:20,100,1804,47,53,1018.25,1881.01,0.00
2024-12-08 17:10:20,99,1804,47,52,1025.69,1881.03,0.00
2024-12-08 17:10:20,99,1805,47,52,1021.76,1882.00,0.00
2024-12-08 17:10:20,100,1805,47,53,1011.54,1882.01,0.00
2024-12-08 17:10:20,99,1805,47,52,1018.84,1882.03,0.00
2024-12-08 17:10:20,99,1806,47,52,1014.82,1883.00,0.00
2024-12-08 17:10:20,100,1806,48,52,1004.68,1883.01,0.00
2024-12-08 17:10:20,100,1807,48,52,995.13,1884.00,0.00
2024-12-08 17:10:20,101,1807,48,53,985.27,1884.01,0.00
2024-12-08 17:10:20,100,1807,47,53,994.76,1884.02,0.00
2024-12-08 17:10:20,99,1807,46,53,999.69,1884.08,0.00
2024-12-08 17:10:20,98,1807,45,53,1006.49,1884.27,0.00
2024-12-08 17:10:20,97,1807,44,53,1009.67,1884.64,0.00
2024-12-08 17:10:20,97,1808,44,53,1017.09,1885.00,0.00
2024-12-08 17:10:20,98,1808,44,54,1006.71,1885.01,0.00
2024-12-08 17:10:20,98,1809,44,54,999.15,1886.00,0.00
2024-12-08 17:10:20,99,1809,45,54,989.06,1886.01,0.00
2024-12-08 17:10:20,98,1809,45,53,998.01,1886.04,0.00
2024-12-08 17:10:20,99,1808,45,54,972.92,1886.84,0.00
2024-12-08 17:10:20,99,1809,45,54,987.92,1887.00,0.00
2024-12-08 17:10:20,100,1809,45,55,978.04,1887.01,0.00
2024-12-08 17:10:20,99,1809,45,54,984.70,1887.04,0.00
2024-12-08 17:10:20,98,1809,44,54,986.25,1887.50,0.00
2024-12-08 17:10:20,98,1810,44,54,1010.94,1888.00,0.00
2024-12-08 17:10:20,99,1810,44,55,1000.73,1888.01,0.00
2024-12-08 17:10:20,98,1810,44,54,1007.68,1888.04,0.00
2024-12-08 17:10:20,97,1810,43,54,1005.59,1888.51,0.00
2024-12-08 17:10:20,97,1811,43,54,1015.09,1889.00,0.00
2024-12-08 17:10:20,98,1811,43,55,1004.73,1889.01,0.00
2024-12-08 17:10:20,98,1812,43,55,997.37,1890.00,0.00
2024-12-08 17:10:20,99,1812,44,55,987.30,1890.01,0.00
2024-12-08 17:10:20,98,1812,43,55,992.00,1890.09,0.00
2024-12-08 17:10:20,99,1811,44,55,965.07,1890.79,0.00
2024-12-08 17:10:21,99,1812,44,55,980.92,1891.00,0.00
2024-12-08 17:10:21,100,1812,45,55,971.11,1891.01,0.00
2024-12-08 17:10:21,99,1812,44,55,971.26,1891.31,0.00
2024-12-08 17:10:21,100,1811,45,55,958.05,1891.52,0.00
2024-12-08 17:10:21,101,1810,45,56,948.21,1891.72,0.00
2024-12-08 17:10:21,101,1811,45,56,981.02,1892.00,0.00
2024-12-08 17:10:21,102,1811,46,56,971.40,1892.01,0.00
2024-12-08 17:10:21,101,1811,46,55,977.10,1892.05,0.00
2024-12-08 17:10:21,101,1812,46,55,1011.72,1893.00,0.00
2024-12-08 17:10:21,102,1812,47,55,1001.80,1893.01,0.00
2024-12-08 17:10:21,101,1812,47,54,1008.37,1893.05,0.00
2024-12-08 17:10:21,101,1813,47,54,1005.60,1894.00,0.00
2024-12-08 17:10:21,102,1813,48,54,995.74,1894.01,0.00
2024-12-08 17:10:21,101,1813,48,53,1001.31,1894.07,0.00
2024-12-08 17:10:21,100,1813,47,53,1008.69,1894.15,0.00
2024-12-08 17:10:21,100,1814,47,53,1011.81,1895.00,0.00
2024-12-08 17:10:21,101,1814,48,53,1001.80,1895.01,0.00
2024-12-08 17:10:21,100,1814,48,52,1007.48,1895.07,0.00
2024-12-08 17:10:21,100,1815,48,52,1005.32,1896.00,0.00
2024-12-08 17:10:21,101,1815,48,53,995.37,1896.01,0.00
2024-12-08 17:10:21,100,1815,48,52,1001.14,1896.07,0.00
2024-12-08 17:10:21,100,1816,48,52,998.94,1897.00,0.00
2024-12-08 17:10:21,101,1816,49,52,989.05,1897.01,0.00
2024-12-08 17:10:21,100,1816,49,51,981.52,1897.52,0.00
2024-12-08 17:10:21,100,1817,49,51,991.73,1898.00,0.00
2024-12-08 17:10:21,101,1817,50,51,981.91,1898.01,0.00
2024-12-08 17:10:21,101,1818,50,51,974.82,1899.00,0.00
2024-12-08 17:10:21,102,1818,51,51,965.27,1899.01,0.00
2024-12-08 17:10:21,101,1818,51,50,970.70,1899.08,0.00
2024-12-08 17:10:21,100,1818,50,50,973.80,1899.26,0.00
2024-12-08 17:10:21,100,1819,50,50,979.20,1900.00,0.00
2024-12-08 17:10:21,101,1819,50,51,969.50,1900.01,0.00
2024-12-08 17:10:21,100,1819,50,50,977.51,1900.07,0.00
2024-12-08 17:10:21,101,1818,51,50,961.72,1900.42,0.00
2024-12-08 17:10:21,101,1819,51,50,975.66,1901.00,0.00
2024-12-08 17:10:21,102,1819,52,50,966.10,1901.01,0.00
2024-12-08 17:10:21,101,1819,52,49,971.91,1901.07,0.00
2024-12-08 17:10:21,102,1818,53,49,952.07,1901.44,0.00
2024-12-08 17:10:21,102,1819,53,49,991.78,1902.00,0.00
2024-12-08 17:10:21,103,1819,53,50,982.15,1902.01,0.00
2024-12-08 17:10:21,102,1819,53,49,988.06,1902.07,0.00
2024-12-08 17:10:21,101,1819,52,49,995.31,1902.20,0.00
2024-12-08 17:10:21,100,1819,51,49,1003.40,1902.29,0.00
2024-12-08 17:10:21,100,1820,51,49,1024.60,1903.00,0.00
2024-12-08 17:10:21,101,1820,51,50,1014.45,1903.01,0.00
2024-12-08 17:10:21,100,1820,51,49,1020.62,1903.07,0.00
2024-12-08 17:10:21,99,1820,50,49,1024.43,1903.24,0.00
2024-12-08 17:10:21,98,1820,49,49,1030.34,1903.49,0.00
2024-12-08 17:10:21,98,1821,49,49,1040.42,1904.00,0.00
2024-12-08 17:10:21,99,1821,49,50,1029.91,1904.01,0.00
2024-12-08 17:10:21,98,1821,49,49,1036.36,1904.07,0.00
2024-12-08 17:10:21,98,1822,49,49,1034.75,1905.00,0.00
2024-12-08 17:10:21,99,1822,49,50,1024.30,1905.01,0.00
2024-12-08 17:10:21,98,1822,49,49,1030.49,1905.07,0.00
2024-12-08 17:10:21,97,1822,48,49,1031.67,1905.54,0.00
2024-12-08 17:10:21,97,1823,48,49,1042.61,1906.00,0.00
2024-12-08 17:10:21,98,1823,48,50,1031.97,1906.01,0.00
2024-12-08 17:10:21,97,1823,48,49,1038.30,1906.07,0.00
2024-12-08 17:10:21,97,1824,48,49,1036.14,1907.00,0.00
2024-12-08 17:10:21,98,1824,48,50,1025.57,1907.01,0.00
2024-12-08 17:10:21,97,1824,47,50,1035.17,1907.05,0.00
2024-12-08 17:10:21,96,1824,47,49,1042.58,1907.06,0.00
2024-12-08 17:10:21,95,1824,46,49,1053.16,1907.08,0.00
2024-12-08 17:10:21,94,1824,45,49,1062.54,1907.13,0.00
2024-12-08 17:10:21,94,1825,45,49,1066.24,1908.00,0.00
2024-12-08 17:10:21,95,1825,45,50,1055.02,1908.01,0.00
2024-12-08 17:10:21,94,1825,44,50,1065.24,1908.05,0.00
2024-12-08 17:10:21,93,1825,44,49,1072.80,1908.07,0.00
2024-12-08 17:10:22,92,1825,43,49,1084.05,1908.08,0.00
2024-12-08 17:10:22,91,1825,42,49,1095.13,1908.09,0.00
2024-12-08 17:10:22,91,1826,42,49,1099.25,1909.00,0.00
2024-12-08 17:10:22,92,1826,42,50,1087.30,1909.01,0.00
2024-12-08 17:10:22,93,1825,43,50,1060.46,1909.62,0.00
2024-12-08 17:10:22,93,1826,43,50,1075.84,1910.00,0.00
2024-12-08 17:10:22,94,1826,44,50,1064.40,1910.01,0.00
2024-12-08 17:10:22,93,1826,44,49,1071.14,1910.07,0.00
2024-12-08 17:10:22,93,1827,44,49,1090.42,1911.00,0.00
2024-12-08 17:10:22,94,1827,45,49,1078.82,1911.01,0.00
2024-12-08 17:10:22,93,1827,45,48,1088.58,1911.08,0.00
2024-12-08 17:10:22,92,1827,44,48,1096.01,1911.30,0.00
2024-12-08 17:10:22,92,1828,44,48,1099.12,1912.00,0.00
2024-12-08 17:10:22,93,1828,44,49,1087.30,1912.01,0.00
2024-12-08 17:10:22,92,1828,44,48,1094.36,1912.07,0.00
2024-12-08 17:10:22,92,1829,44,48,1092.49,1913.00,0.00
2024-12-08 17:10:22,93,1829,44,49,1080.74,1913.01,0.00
2024-12-08 17:10:22,93,1830,44,49,1073.92,1914.00,0.00
2024-12-08 17:10:22,94,1830,44,50,1062.50,1914.01,0.00
2024-12-08 17:10:22,93,1830,44,49,1072.70,1914.07,0.00
2024-12-08 17:10:22,93,1831,44,49,1070.55,1915.00,0.00
2024-12-08 17:10:22,94,1831,45,49,1059.17,1915.01,0.00
2024-12-08 17:10:22,93,1831,44,49,1056.23,1915.50,0.00
2024-12-08 17:10:22,93,1832,44,49,1063.32,1916.00,0.00
2024-12-08 17:10:22,94,1832,44,50,1052.00,1916.01,0.00
2024-12-08 17:10:22,93,1832,44,49,1062.09,1916.07,0.00
2024-12-08 17:10:22,92,1832,44,48,1058.88,1916.34,0.00
2024-12-08 17:10:22,93,1831,44,49,1042.48,1916.62,0.00
2024-12-08 17:10:22,93,1832,44,49,1062.14,1917.00,0.00
2024-12-08 17:10:22,94,1832,44,50,1050.85,1917.01,0.00
2024-12-08 17:10:22,93,1832,44,49,1060.92,1917.07,0.00
2024-12-08 17:10:22,92,1832,43,49,1069.55,1917.13,0.00
2024-12-08 17:10:22,92,1833,43,49,1095.10,1918.00,0.00
2024-12-08 17:10:22,93,1833,43,50,1083.32,1918.01,0.00
2024-12-08 17:10:22,94,1832,44,50,1071.19,1918.06,0.00
2024-12-08 17:10:22,94,1833,44,50,1080.93,1919.00,0.00
2024-12-08 17:10:22,95,1833,44,51,1069.55,1919.01,0.00
2024-12-08 17:10:22,94,1833,43,51,1066.18,1919.43,0.00
2024-12-08 17:10:22,94,1834,43,51,1096.40,1920.00,0.00
2024-12-08 17:10:22,95,1834,44,51,1084.86,1920.01,0.00
2024-12-08 17:10:22,96,1833,44,52,1073.36,1920.04,0.00
2024-12-08 17:10:22,95,1833,44,51,1095.80,1920.07,0.00
2024-12-08 17:10:22,94,1833,43,51,1103.64,1920.28,0.00
2024-12-08 17:10:22,94,1834,43,51,1106.46,1921.00,0.00
2024-12-08 17:10:22,95,1834,43,52,1094.81,1921.01,0.00
2024-12-08 17:10:22,94,1834,43,51,1101.38,1921.06,0.00
2024-12-08 17:10:22,93,1834,42,51,1112.60,1921.08,0.00
2024-12-08 17:10:22,93,1835,42,51,1136.61,1922.00,0.00
2024-12-08 17:10:22,94,1835,43,51,1124.52,1922.01,0.00
2024-12-08 17:10:22,94,1836,43,51,1118.22,1923.00,0.00
2024-12-08 17:10:22,95,1836,44,51,1106.44,1923.01,0.00
2024-12-08 17:10:22,94,1836,43,51,1116.81,1923.07,0.00
2024-12-08 17:10:22,93,1836,43,50,1128.40,1923.08,0.00
2024-12-08 17:10:22,93,1837,43,50,1127.54,1924.00,0.00
2024-12-08 17:10:22,94,1837,43,51,1115.54,1924.01,0.00
2024-12-08 17:10:22,93,1837,42,51,1126.52,1924.05,0.00
2024-12-08 17:10:22,92,1837,41,51,1122.58,1924.46,0.00
2024-12-08 17:10:22,92,1838,41,51,1133.44,1925.00,0.00
2024-12-08 17:10:22,93,1838,42,51,1121.26,1925.01,0.00
2024-12-08 17:10:22,92,1838,42,50,1131.80,1925.08,0.00
2024-12-08 17:10:22,91,1838,41,50,1140.46,1925.17,0.00
2024-12-08 17:10:22,91,1839,41,50,1145.79,1926.00,0.00
2024-12-08 17:10:23,92,1839,42,50,1133.34,1926.01,0.00
2024-12-08 17:10:23,92,1840,42,50,1126.88,1927.00,0.00
2024-12-08 17:10:23,93,1840,42,51,1114.77,1927.01,0.00
2024-12-08 17:10:23,93,1841,42,51,1108.28,1928.00,0.00
2024-12-08 17:10:23,94,1841,42,52,1096.49,1928.01,0.00
2024-12-08 17:10:23,94,1842,42,52,1089.88,1929.00,0.00
2024-12-08 17:10:23,95,1842,42,53,1078.41,1929.01,0.00
2024-12-08 17:10:23,94,1842,42,52,1085.80,1929.10,0.00
2024-12-08 17:10:23,94,1843,42,52,1084.86,1930.00,0.00
2024-12-08 17:10:23,95,1843,42,53,1073.44,1930.01,0.00
2024-12-08 17:10:23,94,1843,41,53,1075.61,1930.26,0.00
2024-12-08 17:10:23,94,1844,41,53,1078.15,1931.00,0.00
2024-12-08 17:10:23,95,1844,41,54,1066.80,1931.01,0.00
2024-12-08 17:10:23,94,1844,41,53,1075.92,1931.12,0.00
2024-12-08 17:10:23,93,1844,40,53,1076.09,1931.47,0.00
2024-12-08 17:10:23,93,1845,40,53,1087.05,1932.00,0.00
2024-12-08 17:10:23,94,1845,40,54,1075.48,1932.01,0.00
2024-12-08 17:10:23,93,1845,39,54,1086.84,1932.01,0.00
2024-12-08 17:10:23,92,1845,39,53,1092.19,1932.12,0.00
2024-12-08 17:10:23,92,1846,39,53,1091.85,1933.00,0.00
2024-12-08 17:10:23,93,1846,40,53,1080.11,1933.01,0.00
2024-12-08 17:10:23,93,1847,40,53,1073.27,1934.00,0.00
2024-12-08 17:10:23,94,1847,40,54,1061.86,1934.01,0.00
2024-12-08 17:10:23,93,1847,40,53,1070.82,1934.12,0.00
2024-12-08 17:10:23,93,1848,40,53,1070.07,1935.00,0.00
2024-12-08 17:10:23,94,1848,40,54,1058.68,1935.01,0.00
2024-12-08 17:10:23,94,1849,40,54,1051.52,1936.00,0.00
2024-12-08 17:10:23,95,1849,41,54,1040.45,1936.01,0.00
2024-12-08 17:10:23,94,1849,40,54,1051.32,1936.02,0.00
2024-12-08 17:10:23,93,1849,40,53,1060.15,1936.12,0.00
2024-12-08 17:10:23,92,1849,40,52,1070.10,1936.17,0.00
2024-12-08 17:10:23,91,1849,39,52,1077.63,1936.22,0.00
2024-12-08 17:10:23,91,1850,39,52,1084.01,1937.00,0.00
2024-12-08 17:10:23,92,1850,39,53,1072.23,1937.01,0.00
2024-12-08 17:10:23,91,1850,38,53,1081.92,1937.11,0.00
2024-12-08 17:10:23,90,1850,37,53,1087.28,1937.14,0.00
2024-12-08 17:10:23,91,1849,38,53,1072.10,1937.32,0.00
2024-12-08 17:10:23,91,1850,38,53,1092.14,1938.00,0.00
2024-12-08 17:10:23,92,1850,38,54,1080.27,1938.01,0.00
2024-12-08 17:10:23,92,1851,38,54,1095.03,1939.00,0.00
2024-12-08 17:10:23,93,1851,38,55,1083.25,1939.01,0.00
2024-12-08 17:10:23,92,1851,38,54,1091.06,1939.14,0.00
2024-12-08 17:10:23,91,1851,37,54,1093.21,1939.45,0.00
2024-12-08 17:10:23,90,1851,36,54,1104.51,1939.49,0.00
2024-12-08 17:10:23,91,1850,37,54,1084.77,1939.91,0.00
2024-12-08 17:10:23,91,1851,37,54,1105.96,1940.00,0.00
2024-12-08 17:10:23,92,1851,37,55,1093.94,1940.01,0.00
2024-12-08 17:10:23,92,1852,37,55,1108.64,1941.00,0.00
2024-12-08 17:10:23,93,1852,38,55,1096.72,1941.01,0.00
2024-12-08 17:10:23,92,1852,38,54,1108.02,1941.03,0.00
2024-12-08 17:10:23,91,1852,37,54,1118.51,1941.11,0.00
2024-12-08 17:10:23,90,1852,37,53,1127.24,1941.17,0.00
2024-12-08 17:10:23,89,1852,36,53,1133.72,1941.48,0.00
2024-12-08 17:10:23,89,1853,36,53,1145.90,1942.00,0.00
2024-12-08 17:10:23,90,1853,36,54,1133.17,1942.01,0.00
2024-12-08 17:10:23,91,1852,37,54,1118.61,1942.14,0.00
2024-12-08 17:10:23,91,1853,37,54,1130.26,1943.00,0.00
2024-12-08 17:10:23,92,1853,38,54,1117.97,1943.01,0.00
2024-12-08 17:10:23,91,1853,38,53,1128.16,1943.11,0.00
2024-12-08 17:10:24,91,1854,38,53,1145.58,1944.00,0.00
2024-12-08 17:10:24,92,1854,38,54,1133.13,1944.01,0.00
2024-12-08 17:10:24,92,1855,38,54,1127.16,1945.00,0.00
2024-12-08 17:10:24,93,1855,38,55,1115.04,1945.01,0.00
2024-12-08 17:10:24,92,1855,37,55,1126.54,1945.03,0.00
2024-12-08 17:10:24,92,1856,37,55,1120.97,1946.00,0.00
2024-12-08 17:10:24,93,1856,37,56,1108.92,1946.01,0.00
2024-12-08 17:10:24,93,1857,37,56,1102.79,1947.00,0.00
2024-12-08 17:10:24,94,1857,38,56,1091.05,1947.01,0.00
2024-12-08 17:10:24,93,1857,38,55,1097.79,1947.10,0.00
2024-12-08 17:10:24,92,1857,37,55,1097.35,1947.75,0.00
2024-12-08 17:10:24,92,1858,37,55,1109.63,1948.00,0.00
2024-12-08 17:10:24,93,1858,37,56,1097.70,1948.01,0.00
2024-12-08 17:10:24,92,1858,36,56,1109.01,1948.03,0.00
2024-12-08 17:10:24,91,1858,35,56,1120.98,1948.03,0.00
2024-12-08 17:10:24,92,1857,35,57,1090.73,1948.78,0.00
2024-12-08 17:10:24,92,1858,35,57,1107.23,1949.00,0.00
2024-12-08 17:10:24,93,1858,36,57,1095.33,1949.01,0.00
2024-12-08 17:10:24,92,1858,36,56,1105.36,1949.09,0.00
2024-12-08 17:10:24,92,1859,36,56,1126.24,1950.00,0.00
2024-12-08 17:10:24,93,1859,37,56,1114.13,1950.01,0.00
2024-12-08 17:10:24,94,1858,38,56,1081.79,1950.89,0.00
2024-12-08 17:10:24,94,1859,38,56,1098.07,1951.00,0.00
2024-12-08 17:10:24,95,1859,38,57,1086.51,1951.01,0.00
2024-12-08 17:10:24,94,1859,38,56,1092.49,1951.09,0.00
2024-12-08 17:10:24,94,1860,38,56,1112.55,1952.00,0.00
2024-12-08 17:10:24,95,1860,39,56,1100.83,1952.01,0.00
2024-12-08 17:10:24,95,1861,39,56,1094.41,1953.00,0.00
2024-12-08 17:10:24,96,1861,40,56,1083.01,1953.01,0.00
2024-12-08 17:10:24,95,1861,40,55,1092.79,1953.08,0.00
2024-12-08 17:10:24,96,1860,40,56,1072.84,1953.55,0.00
2024-12-08 17:10:24,96,1861,40,56,1088.04,1954.00,0.00
2024-12-08 17:10:24,97,1861,40,57,1076.82,1954.01,0.00
2024-12-08 17:10:24,96,1861,40,56,1086.23,1954.08,0.00
2024-12-08 17:10:24,96,1862,40,56,1105.50,1955.00,0.00
2024-12-08 17:10:24,97,1862,40,57,1094.10,1955.01,0.00
2024-12-08 17:10:24,96,1862,40,56,1101.25,1955.07,0.00
2024-12-08 17:10:24,95,1862,39,56,1108.79,1955.28,0.00
2024-12-08 17:10:24,95,1863,39,56,1111.74,1956.00,0.00
2024-12-08 17:10:24,96,1863,39,57,1100.16,1956.01,0.00
2024-12-08 17:10:24,96,1864,39,57,1093.58,1957.00,0.00
2024-12-08 17:10:24,97,1864,39,58,1082.31,1957.01,0.00
2024-12-08 17:10:24,96,1864,39,57,1087.90,1957.08,0.00
2024-12-08 17:10:24,96,1865,39,57,1090.88,1958.00,0.00
2024-12-08 17:10:24,97,1865,39,58,1079.63,1958.01,0.00
2024-12-08 17:10:24,98,1864,39,59,1067.83,1958.07,0.00
2024-12-08 17:10:24,97,1864,38,59,1086.12,1958.08,0.00
2024-12-08 17:10:24,96,1864,38,58,1093.15,1958.08,0.00
2024-12-08 17:10:24,97,1863,38,59,1080.49,1958.18,0.00
2024-12-08 17:10:24,97,1864,38,59,1093.31,1959.00,0.00
2024-12-08 17:10:24,98,1864,38,60,1082.16,1959.01,0.00
2024-12-08 17:10:24,98,1865,38,60,1115.31,1960.00,0.00
2024-12-08 17:10:24,99,1865,38,61,1104.04,1960.01,0.00
2024-12-08 17:10:24,98,1865,37,61,1114.13,1960.06,0.00
2024-12-08 17:10:24,97,1865,36,61,1117.19,1960.28,0.00
2024-12-08 17:10:24,97,1866,36,61,1119.57,1961.00,0.00
2024-12-08 17:10:24,98,1866,36,62,1108.15,1961.01,0.00
2024-12-08 17:10:24,97,1866,36,61,1116.76,1961.06,0.00
2024-12-08 17:10:24,96,1866,35,61,1120.73,1961.37,0.00
2024-12-08 17:10:24,96,1867,35,61,1129.04,1962.00,0.00
2024-12-08 17:10:24,97,1867,35,62,1117.40,1962.01,0.00
2024-12-08 17:10:24,96,1867,34,62,1128.23,1962.04,0.00
2024-12-08 17:10:25,95,1867,34,61,1135.99,1962.05,0.00
2024-12-08 17:10:25,95,1868,34,61,1134.36,1963.00,0.00
2024-12-08 17:10:25,96,1868,34,62,1122.54,1963.01,0.00
2024-12-08 17:10:25,96,1869,34,62,1115.85,1964.00,0.00
2024-12-08 17:10:25,97,1869,34,63,1104.34,1964.01,0.00
2024-12-08 17:10:25,96,1869,34,62,1111.37,1964.05,0.00
2024-12-08 17:10:25,95,1869,33,62,1105.72,1964.74,0.00
2024-12-08 17:10:25,95,1870,33,62,1121.45,1965.00,0.00
2024-12-08 17:10:25,96,1870,34,62,1109.77,1965.01,0.00
2024-12-08 17:10:25,96,1871,34,62,1103.16,1966.00,0.00
2024-12-08 17:10:25,97,1871,35,62,1091.79,1966.01,0.00
2024-12-08 17:10:25,98,1870,36,62,1080.45,1966.04,0.00
2024-12-08 17:10:25,97,1870,35,62,1095.87,1966.09,0.00
2024-12-08 17:10:25,97,1871,35,62,1094.78,1967.00,0.00
2024-12-08 17:10:25,98,1871,36,62,1083.61,1967.01,0.00
2024-12-08 17:10:25,97,1871,36,61,1091.76,1967.05,0.00
2024-12-08 17:10:25,97,1872,36,61,1110.15,1968.00,0.00
2024-12-08 17:10:25,98,1872,36,62,1098.82,1968.01,0.00
2024-12-08 17:10:25,97,1872,36,61,1105.91,1968.05,0.00
2024-12-08 17:10:25,97,1873,36,61,1104.01,1969.00,0.00
2024-12-08 17:10:25,98,1873,37,61,1092.75,1969.01,0.00
2024-12-08 17:10:25,99,1872,38,61,1070.30,1969.41,0.00
2024-12-08 17:10:25,99,1873,38,61,1089.02,1970.00,0.00
2024-12-08 17:10:25,100,1873,38,62,1078.13,1970.01,0.00
2024-12-08 17:10:25,99,1873,37,62,1083.09,1970.10,0.00
2024-12-08 17:10:25,100,1872,37,63,1061.65,1970.66,0.00
2024-12-08 17:10:25,99,1872,36,63,1076.02,1970.75,0.00
2024-12-08 17:10:25,99,1873,36,63,1111.06,1971.00,0.00
2024-12-08 17:10:25,100,1873,36,64,1099.95,1971.01,0.00
2024-12-08 17:10:25,101,1872,37,64,1088.87,1971.04,0.00
2024-12-08 17:10:25,102,1871,38,64,1062.10,1971.72,0.00
2024-12-08 17:10:25,102,1872,38,64,1095.78,1972.00,0.00
2024-12-08 17:10:25,103,1872,39,64,1085.14,1972.01,0.00
2024-12-08 17:10:25,102,1872,38,64,1090.20,1972.10,0.00
2024-12-08 17:10:25,102,1873,38,64,1126.68,1973.00,0.00
2024-12-08 17:10:25,103,1873,38,65,1115.74,1973.01,0.00
2024-12-08 17:10:25,102,1873,38,64,1124.58,1973.06,0.00
2024-12-08 17:10:25,101,1873,37,64,1134.35,1973.12,0.00
2024-12-08 17:10:25,101,1874,37,64,1132.38,1974.00,0.00
2024-12-08 17:10:25,102,1874,38,64,1121.27,1974.01,0.00
2024-12-08 17:10:25,103,1873,38,65,1109.82,1974.06,0.00
2024-12-08 17:10:25,102,1873,38,64,1121.30,1974.06,0.00
2024-12-08 17:10:25,101,1873,37,64,1128.30,1974.09,0.00
2024-12-08 17:10:25,100,1873,37,63,1138.74,1974.11,0.00
2024-12-08 17:10:25,100,1874,37,63,1141.08,1975.00,0.00
2024-12-08 17:10:25,101,1874,38,63,1129.78,1975.01,0.00
2024-12-08 17:10:25,100,1874,38,62,1136.96,1975.07,0.00
2024-12-08 17:10:25,100,1875,38,62,1154.24,1976.00,0.00
2024-12-08 17:10:25,101,1875,39,62,1142.81,1976.01,0.00
2024-12-08 17:10:25,100,1875,39,61,1150.71,1976.06,0.00
2024-12-08 17:10:25,99,1875,38,61,1154.59,1976.25,0.00
2024-12-08 17:10:25,99,1876,38,61,1159.77,1977.00,0.00
2024-12-08 17:10:25,100,1876,38,62,1148.18,1977.01,0.00
2024-12-08 17:10:25,99,1876,38,61,1155.80,1977.06,0.00
2024-12-08 17:10:25,99,1877,38,61,1153.17,1978.00,0.00
2024-12-08 17:10:25,100,1877,39,61,1141.64,1978.01,0.00
2024-12-08 17:10:25,99,1877,38,61,1151.60,1978.08,0.00
2024-12-08 17:10:25,99,1878,38,61,1149.26,1979.00,0.00
2024-12-08 17:10:25,100,1878,39,61,1137.77,1979.01,0.00
2024-12-08 17:10:26,100,1879,39,61,1129.83,1980.00,0.00
2024-12-08 17:10:26,101,1879,39,62,1118.64,1980.01,0.00
2024-12-08 17:10:26,100,1879,38,62,1129.63,1980.01,0.00
2024-12-08 17:10:26,99,1879,38,61,1139.66,1980.07,0.00
2024-12-08 17:10:26,100,1878,39,61,1128.27,1980.09,0.00
2024-12-08 17:10:26,100,1879,39,61,1141.18,1981.00,0.00
2024-12-08 17:10:26,101,1879,40,61,1129.88,1981.01,0.00
2024-12-08 17:10:26,100,1879,40,60,1139.22,1981.04,0.00
2024-12-08 17:10:26,99,1879,39,60,1148.32,1981.04,0.00
2024-12-08 17:10:26,99,1880,39,60,1168.91,1982.00,0.00
2024-12-08 17:10:26,100,1880,39,61,1157.22,1982.01,0.00
2024-12-08 17:10:26,99,1880,39,60,1167.74,1982.06,0.00
2024-12-08 17:10:26,99,1881,39,60,1164.60,1983.00,0.00
2024-12-08 17:10:26,100,1881,39,61,1152.95,1983.01,0.00
2024-12-08 17:10:26,99,1881,39,60,1159.42,1983.06,0.00
2024-12-08 17:10:26,98,1881,38,60,1167.27,1983.27,0.00
2024-12-08 17:10:26,97,1881,37,60,1169.83,1983.48,0.00
2024-12-08 17:10:26,97,1882,37,60,1180.45,1984.00,0.00
2024-12-08 17:10:26,98,1882,37,61,1168.40,1984.01,0.00
2024-12-08 17:10:26,97,1882,37,60,1175.16,1984.06,0.00
2024-12-08 17:10:26,97,1883,37,60,1172.19,1985.00,0.00
2024-12-08 17:10:26,98,1883,38,60,1160.23,1985.01,0.00
2024-12-08 17:10:26,97,1883,38,59,1166.90,1985.06,0.00
2024-12-08 17:10:26,97,1884,38,59,1163.83,1986.00,0.00
2024-12-08 17:10:26,98,1884,39,59,1151.96,1986.01,0.00
2024-12-08 17:10:26,99,1883,39,60,1139.93,1986.05,0.00
2024-12-08 17:10:26,98,1883,39,59,1149.15,1986.07,0.00
2024-12-08 17:10:26,97,1883,38,59,1159.37,1986.10,0.00
2024-12-08 17:10:26,97,1884,38,59,1161.20,1987.00,0.00
2024-12-08 17:10:26,98,1884,39,59,1149.35,1987.01,0.00
2024-12-08 17:10:26,97,1884,38,59,1158.57,1987.09,0.00
2024-12-08 17:10:26,97,1885,38,59,1176.61,1988.00,0.00
2024-12-08 17:10:26,98,1885,39,59,1164.60,1988.01,0.00
2024-12-08 17:10:26,97,1885,39,58,1171.11,1988.07,0.00
2024-12-08 17:10:26,97,1886,39,58,1168.23,1989.00,0.00
2024-12-08 17:10:26,98,1886,40,58,1156.31,1989.01,0.00
2024-12-08 17:10:26,97,1886,40,57,1165.60,1989.09,0.00
2024-12-08 17:10:26,96,1886,39,57,1170.67,1989.40,0.00
2024-12-08 17:10:26,97,1885,39,58,1156.41,1989.53,0.00
2024-12-08 17:10:26,97,1886,39,58,1175.04,1990.00,0.00
2024-12-08 17:10:26,98,1886,40,58,1163.05,1990.01,0.00
2024-12-08 17:10:26,98,1887,40,58,1175.84,1991.00,0.00
2024-12-08 17:10:26,99,1887,40,59,1163.96,1991.01,0.00
2024-12-08 17:10:26,98,1887,39,59,1175.44,1991.02,0.00
2024-12-08 17:10:26,97,1887,39,58,1186.15,1991.07,0.00
2024-12-08 17:10:26,98,1886,40,58,1168.21,1991.36,0.00
2024-12-08 17:10:26,98,1887,40,58,1182.49,1992.00,0.00
2024-12-08 17:10:26,99,1887,40,59,1170.55,1992.01,0.00
2024-12-08 17:10:26,99,1888,40,59,1182.95,1993.00,0.00
2024-12-08 17:10:26,100,1888,41,59,1171.12,1993.01,0.00
2024-12-08 17:10:26,99,1888,41,58,1181.37,1993.07,0.00
2024-12-08 17:10:26,99,1889,41,58,1178.81,1994.00,0.00
2024-12-08 17:10:26,100,1889,42,58,1167.02,1994.01,0.00
2024-12-08 17:10:26,100,1890,42,58,1159.11,1995.00,0.00
2024-12-08 17:10:26,101,1890,43,58,1147.63,1995.01,0.00
2024-12-08 17:10:26,100,1890,43,57,1155.14,1995.06,0.00
2024-12-08 17:10:26,99,1890,43,56,1162.08,1995.25,0.00
2024-12-08 17:10:26,99,1891,43,56,1163.76,1996.00,0.00
2024-12-08 17:10:26,100,1891,43,57,1152.12,1996.01,0.00
2024-12-08 17:10:26,101,1890,44,57,1140.53,1996.04,0.00
2024-12-08 17:10:27,101,1891,44,57,1135.42,1997.00,0.00
2024-12-08 17:10:27,102,1891,44,58,1124.29,1997.01,0.00
2024-12-08 17:10:27,101,1891,43,58,1134.84,1997.03,0.00
2024-12-08 17:10:27,100,1891,43,57,1142.41,1997.05,0.00
2024-12-08 17:10:27,99,1891,42,57,1149.57,1997.26,0.00
2024-12-08 17:10:27,99,1892,42,57,1171.42,1998.00,0.00
2024-12-08 17:10:27,100,1892,43,57,1159.71,1998.01,0.00
2024-12-08 17:10:27,99,1892,43,56,1166.81,1998.05,0.00
2024-12-08 17:10:27,99,1893,43,56,1164.21,1999.00,0.00
2024-12-08 17:10:27,100,1893,43,57,1152.56,1999.01,0.00
2024-12-08 17:10:27,99,1893,43,56,1155.55,1999.05,0.00
2024-12-08 17:10:27,100,1892,43,57,1138.37,1999.35,0.00
2024-12-08 17:10:27,100,1893,43,57,1150.78,2000.00,0.00
2024-12-08 17:10:27,101,1893,44,57,1139.39,2000.01,0.00
2024-12-08 17:10:27,100,1893,44,56,1146.21,2000.05,0.00
2024-12-08 17:10:27,99,1893,43,56,1153.15,2000.07,0.00
2024-12-08 17:10:27,100,1892,43,57,1135.14,2000.39,0.00
2024-12-08 17:10:27,101,1891,43,58,1124.74,2000.47,0.00
2024-12-08 17:10:27,101,1892,43,58,1162.16,2001.00,0.00
2024-12-08 17:10:27,102,1892,44,58,1150.76,2001.01,0.00
2024-12-08 17:10:27,101,1892,44,57,1157.04,2001.07,0.00
2024-12-08 17:10:27,101,1893,44,57,1193.79,2002.00,0.00
2024-12-08 17:10:27,102,1893,44,58,1182.09,2002.01,0.00
2024-12-08 17:10:27,101,1893,44,57,1189.26,2002.06,0.00
2024-12-08 17:10:27,101,1894,44,57,1185.48,2003.00,0.00
2024-12-08 17:10:27,102,1894,45,57,1173.86,2003.01,0.00
2024-12-08 17:10:27,101,1894,45,56,1180.75,2003.06,0.00
2024-12-08 17:10:27,100,1894,44,56,1192.35,2003.06,0.00
2024-12-08 17:10:27,100,1895,44,56,1189.03,2004.00,0.00
2024-12-08 17:10:27,101,1895,45,56,1177.26,2004.01,0.00
2024-12-08 17:10:27,100,1895,45,55,1183.85,2004.06,0.00
2024-12-08 17:10:27,100,1896,45,55,1180.38,2005.00,0.00
2024-12-08 17:10:27,101,1896,46,55,1168.69,2005.01,0.00
2024-12-08 17:10:27,100,1896,45,55,1179.20,2005.06,0.00
2024-12-08 17:10:27,100,1897,45,55,1171.61,2006.00,0.00
2024-12-08 17:10:27,101,1897,46,55,1160.01,2006.01,0.00
2024-12-08 17:10:27,100,1897,46,54,1170.24,2006.06,0.00
2024-12-08 17:10:27,100,1898,46,54,1165.78,2007.00,0.00
2024-12-08 17:10:27,101,1898,47,54,1154.24,2007.01,0.00
2024-12-08 17:10:27,100,1898,47,53,1165.00,2007.04,0.00
2024-12-08 17:10:27,100,1899,47,53,1155.94,2008.00,0.00
2024-12-08 17:10:27,101,1899,47,54,1144.50,2008.01,0.00
2024-12-08 17:10:27,100,1899,47,53,1154.97,2008.05,0.00
2024-12-08 17:10:27,99,1899,46,53,1163.44,2008.21,0.00
2024-12-08 17:10:27,98,1899,45,53,1173.93,2008.25,0.00
2024-12-08 17:10:27,98,1900,45,53,1175.17,2009.00,0.00
2024-12-08 17:10:27,99,1900,45,54,1163.30,2009.01,0.00
2024-12-08 17:10:27,98,1900,45,53,1170.07,2009.05,0.00
2024-12-08 17:10:27,98,1901,45,53,1167.66,2010.00,0.00
2024-12-08 17:10:27,99,1901,46,53,1155.87,2010.01,0.00
2024-12-08 17:10:27,100,1900,47,53,1144.11,2010.04,0.00
2024-12-08 17:10:27,100,1901,47,53,1139.47,2011.00,0.00
2024-12-08 17:10:27,101,1901,48,53,1128.19,2011.01,0.00
2024-12-08 17:10:27,100,1901,47,53,1130.64,2011.14,0.00
2024-12-08 17:10:27,101,1900,47,54,1113.45,2011.44,0.00
2024-12-08 17:10:27,101,1901,47,54,1154.86,2012.00,0.00
2024-12-08 17:10:27,102,1901,47,55,1143.54,2012.01,0.00
2024-12-08 17:10:27,103,1900,48,55,1132.44,2012.03,0.00
2024-12-08 17:10:27,102,1900,48,54,1147.51,2012.06,0.00
2024-12-08 17:10:27,102,1901,48,54,1164.11,2013.00,0.00
2024-12-08 17:10:27,103,1901,48,55,1152.81,2013.01,0.00
2024-12-08 17:10:27,102,1901,48,54,1161.97,2013.05,0.00
2024-12-08 17:10:27,102,1902,48,54,1178.90,2014.00,0.00
2024-12-08 17:10:27,103,1902,48,55,1167.46,2014.01,0.00
2024-12-08 17:10:27,102,1902,48,54,1174.39,2014.05,0.00
2024-12-08 17:10:27,101,1902,47,54,1186.02,2014.05,0.00
2024-12-08 17:10:28,101,1903,47,54,1183.39,2015.00,0.00
2024-12-08 17:10:28,102,1903,48,54,1171.78,2015.01,0.00
2024-12-08 17:10:28,101,1903,48,53,1178.43,2015.05,0.00
2024-12-08 17:10:28,100,1903,47,53,1189.81,2015.05,0.00
2024-12-08 17:10:28,101,1902,48,53,1171.39,2015.41,0.00
2024-12-08 17:10:28,101,1903,48,53,1192.76,2016.00,0.00
2024-12-08 17:10:28,102,1903,49,53,1181.06,2016.01,0.00
2024-12-08 17:10:28,101,1903,49,52,1185.51,2016.05,0.00
2024-12-08 17:10:28,101,1904,49,52,1206.83,2017.00,0.00
2024-12-08 17:10:28,102,1904,49,53,1194.99,2017.01,0.00
2024-12-08 17:10:28,102,1905,49,53,1187.48,2018.00,0.00
2024-12-08 17:10:28,103,1905,50,53,1175.95,2018.01,0.00
2024-12-08 17:10:28,102,1905,50,52,1186.51,2018.05,0.00
2024-12-08 17:10:28,101,1905,49,52,1189.80,2018.36,0.00
2024-12-08 17:10:28,101,1906,49,52,1197.23,2019.00,0.00
2024-12-08 17:10:28,102,1906,50,52,1185.49,2019.01,0.00
2024-12-08 17:10:28,102,1907,50,52,1177.96,2020.00,0.00
2024-12-08 17:10:28,103,1907,50,53,1166.52,2020.01,0.00
2024-12-08 17:10:28,103,1908,50,53,1158.86,2021.00,0.00
2024-12-08 17:10:28,104,1908,50,54,1147.72,2021.01,0.00
2024-12-08 17:10:28,104,1909,50,54,1139.92,2022.00,0.00
2024-12-08 17:10:28,105,1909,50,55,1129.07,2022.01,0.00
2024-12-08 17:10:28,104,1909,50,54,1137.22,2022.05,0.00
2024-12-08 17:10:28,104,1910,50,54,1134.07,2023.00,0.00
2024-12-08 17:10:28,105,1910,51,54,1123.27,2023.01,0.00
2024-12-08 17:10:28,104,1910,51,53,1129.81,2023.05,0.00
2024-12-08 17:10:28,103,1910,50,53,1135.98,2023.28,0.00
2024-12-08 17:10:28,102,1910,49,53,1146.92,2023.28,0.00
2024-12-08 17:10:28,102,1911,49,53,1148.77,2024.00,0.00
2024-12-08 17:10:28,103,1911,50,53,1137.62,2024.01,0.00
2024-12-08 17:10:28,103,1912,50,53,1129.92,2025.00,0.00
2024-12-08 17:10:28,104,1912,51,53,1119.06,2025.01,0.00
2024-12-08 17:10:28,104,1913,51,53,1111.23,2026.00,0.00
2024-12-08 17:10:28,105,1913,52,53,1100.65,2026.01,0.00
2024-12-08 17:10:28,104,1913,52,52,1109.50,2026.05,0.00
2024-12-08 17:10:28,104,1914,52,52,1106.32,2027.00,0.00
2024-12-08 17:10:28,105,1914,52,53,1095.79,2027.01,0.00
2024-12-08 17:10:28,104,1914,52,52,1102.06,2027.05,0.00
2024-12-08 17:10:28,105,1913,53,52,1078.62,2027.52,0.00
2024-12-08 17:10:28,106,1912,53,53,1074.05,2027.64,0.00
2024-12-08 17:10:28,106,1913,53,53,1091.92,2028.00,0.00
2024-12-08 17:10:28,107,1913,54,53,1081.71,2028.01,0.00
2024-12-08 17:10:28,106,1913,54,52,1087.73,2028.05,0.00
2024-12-08 17:10:28,106,1914,54,52,1122.51,2029.00,0.00
2024-12-08 17:10:28,107,1914,54,53,1112.02,2029.01,0.00
2024-12-08 17:10:28,106,1914,54,52,1118.32,2029.05,0.00
2024-12-08 17:10:28,106,1915,54,52,1114.83,2030.00,0.00
2024-12-08 17:10:28,107,1915,54,53,1104.41,2030.01,0.00
2024-12-08 17:10:28,106,1915,53,53,1106.04,2030.07,0.00
2024-12-08 17:10:28,106,1916,53,53,1106.75,2031.00,0.00
2024-12-08 17:10:28,107,1916,53,54,1096.41,2031.01,0.00
2024-12-08 17:10:28,107,1917,53,54,1088.21,2032.00,0.00
2024-12-08 17:10:28,108,1917,54,54,1078.14,2032.01,0.00
2024-12-08 17:10:28,107,1917,53,54,1082.92,2032.08,0.00
2024-12-08 17:10:28,106,1917,53,53,1092.13,2032.12,0.00
2024-12-08 17:10:28,106,1918,53,53,1093.97,2033.00,0.00
2024-12-08 17:10:28,107,1918,54,53,1083.75,2033.01,0.00
2024-12-08 17:10:29,106,1918,54,52,1091.88,2033.05,0.00
2024-12-08 17:10:29,107,1917,55,52,1078.12,2033.24,0.00
2024-12-08 17:10:29,107,1918,55,52,1081.62,2034.00,0.00
2024-12-08 17:10:29,108,1918,55,53,1071.60,2034.01,0.00
2024-12-08 17:10:29,107,1918,55,52,1078.03,2034.05,0.00
2024-12-08 17:10:29,108,1917,56,52,1051.01,2034.73,0.00
2024-12-08 17:10:29,108,1918,56,52,1087.77,2035.00,0.00
2024-12-08 17:10:29,109,1918,56,53,1077.79,2035.01,0.00
2024-12-08 17:10:29,108,1918,56,52,1083.83,2035.05,0.00
2024-12-08 17:10:29,109,1917,57,52,1071.68,2035.17,0.00
2024-12-08 17:10:29,108,1917,56,52,1089.75,2035.27,0.00
2024-12-08 17:10:29,109,1916,57,52,1079.75,2035.28,0.00
2024-12-08 17:10:29,109,1917,57,52,1114.37,2036.00,0.00
2024-12-08 17:10:29,110,1917,58,52,1104.24,2036.01,0.00
2024-12-08 17:10:29,109,1917,58,51,1109.72,2036.06,0.00
2024-12-08 17:10:29,110,1916,59,51,1094.18,2036.35,0.00
2024-12-08 17:10:29,110,1917,59,51,1147.00,2037.00,0.00
2024-12-08 17:10:29,111,1917,60,51,1136.67,2037.01,0.00
2024-12-08 17:10:29,110,1917,60,50,1142.40,2037.06,0.00
2024-12-08 17:10:29,110,1918,60,50,1157.20,2038.00,0.00
2024-12-08 17:10:29,111,1918,61,50,1146.78,2038.01,0.00
2024-12-08 17:10:29,110,1918,61,49,1152.04,2038.07,0.00
2024-12-08 17:10:29,110,1919,61,49,1148.49,2039.00,0.00
2024-12-08 17:10:29,111,1919,61,50,1138.15,2039.01,0.00
2024-12-08 17:10:29,110,1919,61,49,1143.33,2039.08,0.00
2024-12-08 17:10:29,110,1920,61,49,1139.34,2040.00,0.00
2024-12-08 17:10:29,111,1920,61,50,1129.07,2040.01,0.00
2024-12-08 17:10:29,112,1919,62,50,1118.82,2040.04,0.00
2024-12-08 17:10:29,111,1919,62,49,1129.47,2040.09,0.00
2024-12-08 17:10:29,110,1919,61,49,1135.92,2040.28,0.00
2024-12-08 17:10:29,109,1919,60,49,1145.97,2040.29,0.00
2024-12-08 17:10:29,109,1920,60,49,1146.47,2041.00,0.00
2024-12-08 17:10:29,110,1920,60,50,1136.05,2041.01,0.00
2024-12-08 17:10:29,109,1920,60,49,1141.25,2041.08,0.00
2024-12-08 17:10:29,109,1921,60,49,1156.77,2042.00,0.00
2024-12-08 17:10:29,110,1921,60,50,1146.26,2042.01,0.00
2024-12-08 17:10:29,109,1921,60,49,1151.55,2042.08,0.00
2024-12-08 17:10:29,110,1920,61,49,1133.27,2042.49,0.00
2024-12-08 17:10:29,110,1921,61,49,1145.89,2043.00,0.00
2024-12-08 17:10:29,111,1921,61,50,1135.56,2043.01,0.00
2024-12-08 17:10:29,110,1921,61,49,1140.72,2043.08,0.00
2024-12-08 17:10:29,110,1922,61,49,1155.93,2044.00,0.00
2024-12-08 17:10:29,111,1922,61,50,1145.51,2044.01,0.00
2024-12-08 17:10:29,112,1921,61,51,1134.57,2044.06,0.00
2024-12-08 17:10:29,112,1922,61,51,1138.40,2045.00,0.00
2024-12-08 17:10:29,113,1922,62,51,1128.32,2045.01,0.00
2024-12-08 17:10:29,113,1923,62,51,1137.56,2046.00,0.00
2024-12-08 17:10:29,114,1923,63,51,1127.59,2046.01,0.00
2024-12-08 17:10:29,113,1923,62,51,1123.29,2046.53,0.00
2024-12-08 17:10:29,113,1924,62,51,1128.52,2047.00,0.00
2024-12-08 17:10:29,114,1924,62,52,1118.62,2047.01,0.00
2024-12-08 17:10:29,114,1925,62,52,1109.65,2048.00,0.00
2024-12-08 17:10:29,115,1925,62,53,1100.00,2048.01,0.00
2024-12-08 17:10:29,114,1925,62,52,1106.80,2048.08,0.00
2024-12-08 17:10:29,113,1925,61,52,1112.14,2048.30,0.00
2024-12-08 17:10:29,113,1926,61,52,1112.76,2049.00,0.00
2024-12-08 17:10:29,114,1926,62,52,1103.00,2049.01,0.00
2024-12-08 17:10:29,113,1926,61,52,1112.05,2049.04,0.00
2024-12-08 17:10:29,112,1926,61,51,1120.16,2049.05,0.00
2024-12-08 17:10:29,111,1926,60,51,1125.53,2049.29,0.00
2024-12-08 17:10:29,111,1927,60,51,1126.16,2050.00,0.00
2024-12-08 17:10:29,112,1927,61,51,1116.10,2050.01,0.00
2024-12-08 17:10:29,111,1927,61,50,1122.31,2050.06,0.00
2024-12-08 17:10:29,110,1927,60,50,1128.11,2050.28,0.00
2024-12-08 17:10:29,109,1927,59,50,1136.79,2050.33,0.00
2024-12-08 17:10:30,109,1928,59,50,1142.30,2051.00,0.00
2024-12-08 17:10:30,110,1928,59,51,1131.92,2051.01,0.00
2024-12-08 17:10:30,109,1928,59,50,1137.44,2051.08,0.00
2024-12-08 17:10:30,108,1928,58,50,1146.85,2051.13,0.00
2024-12-08 17:10:30,109,1927,58,51,1130.42,2051.44,0.00
2024-12-08 17:10:30,109,1928,58,51,1143.43,2052.00,0.00
2024-12-08 17:10:30,110,1928,58,52,1133.04,2052.01,0.00
2024-12-08 17:10:30,109,1928,58,51,1138.20,2052.09,0.00
2024-12-08 17:10:30,109,1929,58,51,1153.97,2053.00,0.00
2024-12-08 17:10:30,110,1929,59,51,1143.48,2053.01,0.00
2024-12-08 17:10:30,109,1929,59,50,1153.06,2053.05,0.00
2024-12-08 17:10:30,108,1929,59,49,1159.57,2053.08,0.00
2024-12-08 17:10:30,108,1930,59,49,1156.48,2054.00,0.00
2024-12-08 17:10:30,109,1930,60,49,1145.87,2054.01,0.00
2024-12-08 17:10:30,108,1930,60,48,1147.77,2054.08,0.00
2024-12-08 17:10:30,107,1930,59,48,1157.93,2054.10,0.00
2024-12-08 17:10:30,107,1931,59,48,1159.21,2055.00,0.00
2024-12-08 17:10:30,108,1931,59,49,1148.48,2055.01,0.00
2024-12-08 17:10:30,108,1932,59,49,1140.09,2056.00,0.00
2024-12-08 17:10:30,109,1932,59,50,1129.63,2056.01,0.00
2024-12-08 17:10:30,108,1932,58,50,1121.00,2056.77,0.00
2024-12-08 17:10:30,108,1933,58,50,1131.67,2057.00,0.00
2024-12-08 17:10:30,109,1933,59,50,1121.28,2057.01,0.00
2024-12-08 17:10:30,110,1932,60,50,1105.52,2057.12,0.00
2024-12-08 17:10:30,111,1931,60,51,1108.75,2057.23,0.00
2024-12-08 17:10:30,111,1932,60,51,1113.48,2058.00,0.00
2024-12-08 17:10:30,112,1932,60,52,1103.54,2058.01,0.00
2024-12-08 17:10:30,111,1932,60,51,1108.51,2058.09,0.00
2024-12-08 17:10:30,111,1933,60,51,1142.21,2059.00,0.00
2024-12-08 17:10:30,112,1933,60,52,1132.01,2059.01,0.00
2024-12-08 17:10:30,111,1933,59,52,1136.13,2059.13,0.00
2024-12-08 17:10:30,110,1933,58,52,1143.15,2059.29,0.00
2024-12-08 17:10:30,111,1932,59,52,1129.58,2059.47,0.00
2024-12-08 17:10:30,111,1933,59,52,1142.39,2060.00,0.00
2024-12-08 17:10:30,112,1933,60,52,1132.19,2060.01,0.00
2024-12-08 17:10:30,111,1933,59,52,1141.85,2060.03,0.00
2024-12-08 17:10:30,110,1933,58,52,1138.57,2060.52,0.00
2024-12-08 17:10:30,110,1934,58,52,1162.71,2061.00,0.00
2024-12-08 17:10:30,111,1934,59,52,1152.23,2061.01,0.00
2024-12-08 17:10:30,110,1934,59,51,1157.50,2061.11,0.00
2024-12-08 17:10:30,111,1933,60,51,1137.44,2061.60,0.00
2024-12-08 17:10:30,111,1934,60,51,1150.56,2062.00,0.00
2024-12-08 17:10:30,112,1934,61,51,1140.29,2062.01,0.00
2024-12-08 17:10:30,113,1933,62,51,1108.95,2062.90,0.00
2024-12-08 17:10:30,113,1934,62,51,1152.11,2063.00,0.00
2024-12-08 17:10:30,114,1934,62,52,1142.00,2063.01,0.00
2024-12-08 17:10:30,114,1935,62,52,1151.06,2064.00,0.00
2024-12-08 17:10:30,115,1935,63,52,1141.05,2064.01,0.00
2024-12-08 17:10:30,114,1935,63,51,1147.11,2064.08,0.00
2024-12-08 17:10:30,113,1935,62,51,1137.97,2064.91,0.00
2024-12-08 17:10:30,113,1936,62,51,1154.50,2065.00,0.00
2024-12-08 17:10:30,114,1936,63,51,1144.37,2065.01,0.00
2024-12-08 17:10:30,113,1936,63,50,1149.78,2065.10,0.00
2024-12-08 17:10:30,114,1935,64,50,1136.85,2065.23,0.00
2024-12-08 17:10:30,114,1936,64,50,1148.40,2066.00,0.00
2024-12-08 17:10:30,115,1936,64,51,1138.41,2066.01,0.00
2024-12-08 17:10:30,114,1936,63,51,1143.88,2066.04,0.00
2024-12-08 17:10:30,113,1936,63,50,1149.82,2066.10,0.00
2024-12-08 17:10:30,112,1936,62,50,1154.46,2066.31,0.00
2024-12-08 17:10:30,113,1935,62,51,1138.00,2066.64,0.00
2024-12-08 17:10:30,113,1936,62,51,1172.86,2067.00,0.00
2024-12-08 17:10:30,114,1936,63,51,1162.57,2067.01,0.00
2024-12-08 17:10:30,113,1936,63,50,1164.29,2067.10,0.00
2024-12-08 17:10:30,112,1936,62,50,1174.32,2067.12,0.00
2024-12-08 17:10:31,112,1937,62,50,1191.70,2068.00,0.00
2024-12-08 17:10:31,113,1937,63,50,1181.16,2068.01,0.00
2024-12-08 17:10:31,112,1937,63,49,1186.75,2068.10,0.00
2024-12-08 17:10:31,111,1937,62,49,1195.83,2068.14,0.00
2024-12-08 17:10:31,110,1937,61,49,1203.94,2068.28,0.00
2024-12-08 17:10:31,110,1938,61,49,1204.41,2069.00,0.00
2024-12-08 17:10:31,111,1938,62,49,1193.56,2069.01,0.00
2024-12-08 17:10:31,112,1937,62,50,1157.78,2069.89,0.00
2024-12-08 17:10:31,112,1938,62,50,1175.62,2070.00,0.00
2024-12-08 17:10:31,113,1938,63,50,1165.21,2070.01,0.00
2024-12-08 17:10:31,112,1938,63,49,1169.74,2070.12,0.00
2024-12-08 17:10:31,112,1939,63,49,1184.89,2071.00,0.00
2024-12-08 17:10:31,113,1939,63,50,1174.40,2071.01,0.00
2024-12-08 17:10:31,114,1938,64,50,1163.39,2071.06,0.00
2024-12-08 17:10:31,113,1938,63,50,1184.15,2071.07,0.00
2024-12-08 17:10:31,112,1938,62,50,1186.65,2071.29,0.00
2024-12-08 17:10:31,113,1937,63,50,1175.43,2071.34,0.00
2024-12-08 17:10:31,113,1938,63,50,1178.42,2072.00,0.00
2024-12-08 17:10:31,114,1938,63,51,1168.08,2072.01,0.00
2024-12-08 17:10:31,115,1937,63,52,1157.92,2072.03,0.00
2024-12-08 17:10:31,115,1938,63,52,1195.31,2073.00,0.00
2024-12-08 17:10:31,116,1938,63,53,1185.01,2073.01,0.00
2024-12-08 17:10:31,116,1939,63,53,1193.09,2074.00,0.00
2024-12-08 17:10:31,117,1939,64,53,1182.89,2074.01,0.00
2024-12-08 17:10:31,118,1938,65,53,1172.02,2074.07,0.00
2024-12-08 17:10:31,117,1938,65,52,1187.72,2074.10,0.00
2024-12-08 17:10:31,118,1937,66,52,1174.37,2074.28,0.00
2024-12-08 17:10:31,118,1938,66,52,1180.22,2075.00,0.00
2024-12-08 17:10:31,119,1938,66,53,1170.30,2075.01,0.00
2024-12-08 17:10:31,118,1938,65,53,1179.02,2075.06,0.00
2024-12-08 17:10:31,117,1938,64,53,1185.74,2075.09,0.00
2024-12-08 17:10:31,116,1938,64,52,1192.92,2075.09,0.00
2024-12-08 17:10:31,115,1938,63,52,1203.11,2075.10,0.00
2024-12-08 17:10:31,115,1939,63,52,1237.83,2076.00,0.00
2024-12-08 17:10:31,116,1939,64,52,1227.16,2076.01,0.00
2024-12-08 17:10:31,115,1939,63,52,1236.60,2076.06,0.00
2024-12-08 17:10:31,114,1939,63,51,1243.99,2076.08,0.00
2024-12-08 17:10:31,114,1940,63,51,1238.64,2077.00,0.00
2024-12-08 17:10:31,115,1940,64,51,1227.87,2077.01,0.00
2024-12-08 17:10:31,115,1941,64,51,1217.92,2078.00,0.00
2024-12-08 17:10:31,116,1941,65,51,1207.42,2078.01,0.00
2024-12-08 17:10:31,117,1940,65,52,1190.41,2078.18,0.00
2024-12-08 17:10:31,117,1941,65,52,1191.94,2079.00,0.00
2024-12-08 17:10:31,118,1941,66,52,1181.84,2079.01,0.00
2024-12-08 17:10:31,117,1941,65,52,1182.46,2079.30,0.00
2024-12-08 17:10:31,117,1942,65,52,1199.60,2080.00,0.00
2024-12-08 17:10:31,118,1942,65,53,1189.44,2080.01,0.00
2024-12-08 17:10:31,119,1941,66,53,1179.10,2080.04,0.00
2024-12-08 17:10:31,118,1941,66,52,1196.36,2080.09,0.00
2024-12-08 17:10:31,119,1940,66,53,1180.97,2080.37,0.00
2024-12-08 17:10:31,119,1941,66,53,1190.62,2081.00,0.00
2024-12-08 17:10:31,120,1941,67,53,1180.70,2081.01,0.00
2024-12-08 17:10:31,119,1941,67,52,1185.95,2081.09,0.00
2024-12-08 17:10:31,118,1941,66,52,1195.65,2081.11,0.00
2024-12-08 17:10:31,117,1941,65,52,1205.34,2081.13,0.00
2024-12-08 17:10:31,117,1942,65,52,1236.72,2082.00,0.00
2024-12-08 17:10:31,118,1942,65,53,1226.24,2082.01,0.00
2024-12-08 17:10:31,119,1941,66,53,1203.01,2082.49,0.00
2024-12-08 17:10:31,118,1941,65,53,1218.16,2082.59,0.00
2024-12-08 17:10:31,118,1942,65,53,1224.13,2083.00,0.00
2024-12-08 17:10:31,119,1942,66,53,1213.84,2083.01,0.00
2024-12-08 17:10:31,118,1942,66,52,1219.41,2083.09,0.00
2024-12-08 17:10:31,117,1942,65,52,1228.95,2083.13,0.00
2024-12-08 17:10:31,117,1943,65,52,1243.38,2084.00,0.00
2024-12-08 17:10:31,118,1943,65,53,1232.84,2084.01,0.00
2024-12-08 17:10:31,117,1943,65,52,1238.26,2084.09,0.00
2024-12-08 17:10:32,116,1943,64,52,1245.40,2084.27,0.00
2024-12-08 17:10:32,116,1944,64,52,1244.99,2085.00,0.00
2024-12-08 17:10:32,117,1944,65,52,1234.35,2085.01,0.00
2024-12-08 17:10:32,116,1944,64,52,1243.59,2085.07,0.00
2024-12-08 17:10:32,115,1944,64,51,1251.15,2085.09,0.00
2024-12-08 17:10:32,114,1944,63,51,1258.71,2085.25,0.00
2024-12-08 17:10:32,114,1945,63,51,1258.29,2086.00,0.00
2024-12-08 17:10:32,115,1945,64,51,1247.35,2086.01,0.00
2024-12-08 17:10:32,114,1945,64,50,1253.95,2086.09,0.00
2024-12-08 17:10:32,114,1946,64,50,1250.11,2087.00,0.00
2024-12-08 17:10:32,115,1946,64,51,1239.24,2087.01,0.00
2024-12-08 17:10:32,114,1946,63,51,1237.67,2087.25,0.00
2024-12-08 17:10:32,114,1947,63,51,1240.84,2088.00,0.00
2024-12-08 17:10:32,115,1947,63,52,1230.05,2088.01,0.00
2024-12-08 17:10:32,114,1947,63,51,1238.41,2088.11,0.00
2024-12-08 17:10:32,113,1947,62,51,1243.31,2088.24,0.00
2024-12-08 17:10:32,113,1948,62,51,1246.27,2089.00,0.00
2024-12-08 17:10:32,114,1948,62,52,1235.34,2089.01,0.00
2024-12-08 17:10:32,113,1948,62,51,1239.93,2089.11,0.00
2024-12-08 17:10:32,112,1948,61,51,1233.90,2089.74,0.00
2024-12-08 17:10:32,112,1949,61,51,1247.36,2090.00,0.00
2024-12-08 17:10:32,113,1949,61,52,1236.33,2090.01,0.00
2024-12-08 17:10:32,113,1950,61,52,1226.63,2091.00,0.00
2024-12-08 17:10:32,114,1950,61,53,1215.87,2091.01,0.00
2024-12-08 17:10:32,113,1950,61,52,1219.53,2091.12,0.00
2024-12-08 17:10:32,113,1951,61,52,1220.22,2092.00,0.00
2024-12-08 17:10:32,114,1951,61,53,1209.52,2092.01,0.00
2024-12-08 17:10:32,113,1951,60,53,1213.20,2092.12,0.00
2024-12-08 17:10:32,112,1951,60,52,1220.11,2092.12,0.00
2024-12-08 17:10:32,112,1952,60,52,1220.37,2093.00,0.00
2024-12-08 17:10:32,113,1952,60,53,1209.57,2093.01,0.00
2024-12-08 17:10:32,112,1952,60,52,1212.64,2093.13,0.00
2024-12-08 17:10:32,113,1951,60,53,1201.36,2093.17,0.00
2024-12-08 17:10:32,113,1952,60,53,1216.16,2094.00,0.00
2024-12-08 17:10:32,114,1952,61,53,1205.49,2094.01,0.00
2024-12-08 17:10:32,113,1952,61,52,1208.28,2094.12,0.00
2024-12-08 17:10:32,113,1953,61,52,1222.68,2095.00,0.00
2024-12-08 17:10:32,114,1953,61,53,1211.96,2095.01,0.00
2024-12-08 17:10:32,115,1952,62,53,1198.02,2095.10,0.00
2024-12-08 17:10:32,114,1952,61,53,1199.79,2095.31,0.00
2024-12-08 17:10:32,115,1951,62,53,1174.72,2095.97,0.00
2024-12-08 17:10:32,115,1952,62,53,1192.79,2096.00,0.00
2024-12-08 17:10:32,116,1952,63,53,1182.51,2096.01,0.00
2024-12-08 17:10:32,115,1952,62,53,1189.28,2096.08,0.00
2024-12-08 17:10:32,114,1952,61,53,1191.52,2096.29,0.00
2024-12-08 17:10:32,114,1953,61,53,1227.20,2097.00,0.00
2024-12-08 17:10:32,115,1953,61,54,1216.53,2097.01,0.00
2024-12-08 17:10:32,116,1952,62,54,1206.04,2097.03,0.00
2024-12-08 17:10:32,115,1952,62,53,1212.70,2097.15,0.00
2024-12-08 17:10:32,116,1951,63,53,1197.45,2097.40,0.00
2024-12-08 17:10:32,116,1952,63,53,1207.86,2098.00,0.00
2024-12-08 17:10:32,117,1952,63,54,1197.54,2098.01,0.00
2024-12-08 17:10:32,116,1952,62,54,1206.29,2098.07,0.00
2024-12-08 17:10:32,116,1953,62,54,1232.62,2099.00,0.00
2024-12-08 17:10:32,117,1953,62,55,1222.08,2099.01,0.00
2024-12-08 17:10:33,117,1954,62,55,1211.58,2100.00,0.00
2024-12-08 17:10:33,118,1954,62,56,1201.31,2100.01,0.00
2024-12-08 17:10:33,117,1954,61,56,1211.23,2100.02,0.00
2024-12-08 17:10:33,116,1954,61,55,1221.31,2100.03,0.00
2024-12-08 17:10:33,115,1954,61,54,1228.66,2100.05,0.00
2024-12-08 17:10:33,116,1953,61,55,1211.47,2100.38,0.00
2024-12-08 17:10:33,116,1954,61,55,1221.87,2101.00,0.00
2024-12-08 17:10:33,117,1954,61,56,1211.43,2101.01,0.00
2024-12-08 17:10:33,116,1954,61,55,1216.31,2101.10,0.00
2024-12-08 17:10:33,115,1954,60,55,1224.52,2101.15,0.00
2024-12-08 17:10:33,115,1955,60,55,1241.54,2102.00,0.00
2024-12-08 17:10:33,116,1955,60,56,1230.84,2102.01,0.00
2024-12-08 17:10:33,115,1955,60,55,1238.17,2102.10,0.00
2024-12-08 17:10:33,115,1956,60,55,1233.17,2103.00,0.00
2024-12-08 17:10:33,116,1956,61,55,1222.54,2103.01,0.00
2024-12-08 17:10:33,115,1956,61,54,1223.89,2103.10,0.00
2024-12-08 17:10:33,115,1957,61,54,1222.24,2104.00,0.00
2024-12-08 17:10:33,116,1957,61,55,1211.70,2104.01,0.00
2024-12-08 17:10:33,115,1957,60,55,1221.17,2104.05,0.00
2024-12-08 17:10:33,115,1958,60,55,1210.48,2105.00,0.00
2024-12-08 17:10:33,116,1958,60,56,1200.04,2105.01,0.00
2024-12-08 17:10:33,116,1959,60,56,1188.21,2106.00,0.00
2024-12-08 17:10:33,117,1959,61,56,1178.06,2106.01,0.00
2024-12-08 17:10:33,116,1959,61,55,1169.15,2106.69,0.00
2024-12-08 17:10:33,116,1960,61,55,1176.84,2107.00,0.00
2024-12-08 17:10:33,117,1960,61,56,1166.79,2107.01,0.00
2024-12-08 17:10:33,116,1960,61,55,1172.53,2107.10,0.00
2024-12-08 17:10:33,115,1960,60,55,1182.54,2107.10,0.00
2024-12-08 17:10:33,114,1960,59,55,1188.28,2107.30,0.00
2024-12-08 17:10:33,113,1960,58,55,1185.68,2107.74,0.00
2024-12-08 17:10:33,113,1961,58,55,1198.96,2108.00,0.00
2024-12-08 17:10:33,114,1961,59,55,1188.44,2108.01,0.00
2024-12-08 17:10:33,115,1960,59,56,1176.68,2108.10,0.00
2024-12-08 17:10:33,116,1959,59,57,1175.02,2108.29,0.00
2024-12-08 17:10:33,117,1958,59,58,1162.57,2108.74,0.00
2024-12-08 17:10:33,117,1959,59,58,1179.72,2109.00,0.00
2024-12-08 17:10:33,118,1959,60,58,1169.72,2109.01,0.00
2024-12-08 17:10:33,117,1959,60,57,1176.75,2109.10,0.00
2024-12-08 17:10:33,117,1960,60,57,1224.72,2110.00,0.00
2024-12-08 17:10:33,118,1960,61,57,1214.35,2110.01,0.00
2024-12-08 17:10:33,118,1961,61,57,1202.03,2111.00,0.00
2024-12-08 17:10:33,119,1961,61,58,1191.93,2111.01,0.00
2024-12-08 17:10:33,118,1961,60,58,1201.51,2111.03,0.00
2024-12-08 17:10:33,117,1961,60,57,1206.76,2111.09,0.00
2024-12-08 17:10:33,117,1962,60,57,1200.41,2112.00,0.00
2024-12-08 17:10:33,118,1962,60,58,1190.24,2112.01,0.00
2024-12-08 17:10:33,117,1962,60,57,1197.03,2112.09,0.00
2024-12-08 17:10:33,117,1963,60,57,1191.64,2113.00,0.00
2024-12-08 17:10:33,118,1963,60,58,1181.55,2113.01,0.00
2024-12-08 17:10:33,117,1963,60,57,1186.63,2113.09,0.00
2024-12-08 17:10:33,116,1963,59,57,1196.86,2113.09,0.00
2024-12-08 17:10:33,115,1963,58,57,1207.08,2113.09,0.00
2024-12-08 17:10:33,114,1963,57,57,1215.83,2113.13,0.00
2024-12-08 17:10:33,114,1964,57,57,1214.39,2114.00,0.00
2024-12-08 17:10:33,115,1964,58,57,1203.83,2114.01,0.00
2024-12-08 17:10:33,114,1964,57,57,1213.29,2114.04,0.00
2024-12-08 17:10:33,113,1964,57,56,1219.01,2114.09,0.00
2024-12-08 17:10:34,113,1965,57,56,1216.13,2115.00,0.00
2024-12-08 17:10:34,114,1965,58,56,1205.46,2115.01,0.00
2024-12-08 17:10:34,113,1965,57,56,1215.03,2115.05,0.00
2024-12-08 17:10:34,113,1966,57,56,1203.10,2116.00,0.00
2024-12-08 17:10:34,114,1966,58,56,1192.55,2116.01,0.00
2024-12-08 17:10:34,113,1966,57,56,1192.36,2116.35,0.00
2024-12-08 17:10:34,112,1966,56,56,1192.18,2116.78,0.00
2024-12-08 17:10:34,112,1967,56,56,1202.15,2117.00,0.00
2024-12-08 17:10:34,113,1967,56,57,1191.51,2117.01,0.00
2024-12-08 17:10:34,112,1967,56,56,1198.61,2117.09,0.00
2024-12-08 17:10:34,113,1966,56,57,1182.47,2117.37,0.00
2024-12-08 17:10:34,113,1967,56,57,1191.86,2118.00,0.00
2024-12-08 17:10:34,114,1967,57,57,1181.41,2118.01,0.00
2024-12-08 17:10:34,115,1966,58,57,1163.48,2118.22,0.00
2024-12-08 17:10:34,114,1966,57,57,1185.06,2118.29,0.00
2024-12-08 17:10:34,113,1966,56,57,1190.23,2118.55,0.00
2024-12-08 17:10:34,112,1966,56,56,1199.86,2118.59,0.00
2024-12-08 17:10:34,112,1967,56,56,1222.88,2119.00,0.00
2024-12-08 17:10:34,113,1967,57,56,1212.06,2119.01,0.00
2024-12-08 17:10:34,112,1967,56,56,1207.98,2119.55,0.00
2024-12-08 17:10:34,112,1968,56,56,1230.12,2120.00,0.00
2024-12-08 17:10:34,113,1968,56,57,1219.24,2120.01,0.00
2024-12-08 17:10:34,114,1967,57,57,1199.71,2120.27,0.00
2024-12-08 17:10:34,114,1968,57,57,1208.31,2121.00,0.00
2024-12-08 17:10:34,115,1968,58,57,1197.81,2121.01,0.00
2024-12-08 17:10:34,114,1968,58,56,1205.94,2121.11,0.00
2024-12-08 17:10:34,115,1967,59,56,1183.02,2121.72,0.00
2024-12-08 17:10:34,114,1967,58,56,1191.19,2121.88,0.00
2024-12-08 17:10:34,114,1968,58,56,1225.91,2122.00,0.00
2024-12-08 17:10:34,115,1968,58,57,1215.25,2122.01,0.00
2024-12-08 17:10:34,114,1968,58,56,1220.36,2122.11,0.00
2024-12-08 17:10:34,113,1968,57,56,1226.93,2122.31,0.00
2024-12-08 17:10:34,113,1969,57,56,1244.60,2123.00,0.00
2024-12-08 17:10:34,114,1969,57,57,1233.68,2123.01,0.00
2024-12-08 17:10:34,115,1968,57,58,1221.33,2123.10,0.00
2024-12-08 17:10:34,114,1968,57,57,1244.16,2123.12,0.00
2024-12-08 17:10:34,114,1969,57,57,1238.97,2124.00,0.00
2024-12-08 17:10:34,115,1969,57,58,1228.20,2124.01,0.00
2024-12-08 17:10:34,114,1969,57,57,1233.24,2124.11,0.00
2024-12-08 17:10:34,113,1969,56,57,1243.05,2124.15,0.00
2024-12-08 17:10:34,113,1970,56,57,1261.31,2125.00,0.00
2024-12-08 17:10:34,114,1970,57,57,1250.25,2125.01,0.00
2024-12-08 17:10:34,113,1970,57,56,1255.35,2125.12,0.00
2024-12-08 17:10:34,113,1971,57,56,1250.11,2126.00,0.00
2024-12-08 17:10:34,114,1971,57,57,1239.14,2126.01,0.00
2024-12-08 17:10:34,114,1972,57,57,1226.57,2127.00,0.00
2024-12-08 17:10:34,115,1972,58,57,1215.90,2127.01,0.00
2024-12-08 17:10:34,116,1971,58,58,1204.88,2127.05,0.00
2024-12-08 17:10:34,115,1971,58,57,1212.84,2127.34,0.00
2024-12-08 17:10:34,115,1972,58,57,1212.09,2128.00,0.00
2024-12-08 17:10:34,116,1972,59,57,1201.64,2128.01,0.00
2024-12-08 17:10:34,115,1972,58,57,1195.23,2128.63,0.00
2024-12-08 17:10:34,115,1973,58,57,1218.81,2129.00,0.00
2024-12-08 17:10:34,116,1973,58,58,1208.31,2129.01,0.00
2024-12-08 17:10:34,115,1973,58,57,1214.61,2129.13,0.00
2024-12-08 17:10:34,115,1974,58,57,1209.20,2130.00,0.00
2024-12-08 17:10:34,116,1974,59,57,1198.77,2130.01,0.00
2024-12-08 17:10:34,115,1974,58,57,1198.71,2130.15,0.00
2024-12-08 17:10:34,114,1974,57,57,1204.99,2130.34,0.00
2024-12-08 17:10:34,114,1975,57,57,1207.93,2131.00,0.00
2024-12-08 17:10:34,115,1975,58,57,1197.43,2131.01,0.00
2024-12-08 17:10:35,114,1975,58,56,1190.54,2131.65,0.00
2024-12-08 17:10:35,115,1974,58,57,1174.62,2131.88,0.00
2024-12-08 17:10:35,115,1975,58,57,1188.42,2132.00,0.00
2024-12-08 17:10:35,116,1975,58,58,1178.18,2132.01,0.00
2024-12-08 17:10:35,116,1976,58,58,1183.42,2133.00,0.00
2024-12-08 17:10:35,117,1976,58,59,1173.31,2133.01,0.00
2024-12-08 17:10:35,116,1976,57,59,1181.99,2133.07,0.00
2024-12-08 17:10:35,115,1976,57,58,1189.69,2133.12,0.00
2024-12-08 17:10:35,116,1975,57,59,1160.35,2133.88,0.00
2024-12-08 17:10:35,116,1976,57,59,1174.35,2134.00,0.00
2024-12-08 17:10:35,117,1976,57,60,1164.32,2134.01,0.00
2024-12-08 17:10:35,116,1976,56,60,1172.92,2134.07,0.00
2024-12-08 17:10:35,116,1977,56,60,1177.15,2135.00,0.00
2024-12-08 17:10:35,117,1977,57,60,1167.09,2135.01,0.00
2024-12-08 17:10:35,116,1977,57,59,1160.41,2135.61,0.00
2024-12-08 17:10:35,116,1978,57,59,1162.69,2136.00,0.00
2024-12-08 17:10:35,117,1978,57,60,1152.75,2136.01,0.00
2024-12-08 17:10:35,117,1979,57,60,1139.96,2137.00,0.00
2024-12-08 17:10:35,118,1979,58,60,1130.30,2137.01,0.00
2024-12-08 17:10:35,117,1979,57,60,1123.94,2137.59,0.00
2024-12-08 17:10:35,117,1980,57,60,1127.24,2138.00,0.00
2024-12-08 17:10:35,118,1980,58,60,1117.69,2138.01,0.00
2024-12-08 17:10:35,117,1980,57,60,1125.63,2138.08,0.00
2024-12-08 17:10:35,116,1980,57,59,1134.61,2138.10,0.00
2024-12-08 17:10:35,115,1980,56,59,1129.74,2138.78,0.00
2024-12-08 17:10:35,115,1981,56,59,1137.55,2139.00,0.00
2024-12-08 17:10:35,116,1981,57,59,1127.75,2139.01,0.00
2024-12-08 17:10:35,115,1981,57,58,1133.13,2139.10,0.00
2024-12-08 17:10:35,115,1982,57,58,1126.70,2140.00,0.00
2024-12-08 17:10:35,116,1982,58,58,1116.98,2140.01,0.00
2024-12-08 17:10:35,115,1982,57,58,1125.06,2140.08,0.00
2024-12-08 17:10:35,114,1982,57,57,1132.31,2140.10,0.00
2024-12-08 17:10:35,114,1983,57,57,1125.57,2141.00,0.00
2024-12-08 17:10:35,115,1983,57,58,1115.78,2141.01,0.00
2024-12-08 17:10:35,114,1983,57,57,1121.48,2141.10,0.00
2024-12-08 17:10:35,114,1984,57,57,1114.84,2142.00,0.00
2024-12-08 17:10:35,115,1984,57,58,1105.15,2142.01,0.00
2024-12-08 17:10:35,114,1984,56,58,1113.19,2142.08,0.00
2024-12-08 17:10:35,113,1984,56,57,1119.83,2142.11,0.00
2024-12-08 17:10:35,112,1984,55,57,1128.50,2142.16,0.00
2024-12-08 17:10:35,112,1985,55,57,1123.79,2143.00,0.00
2024-12-08 17:10:35,113,1985,56,57,1113.85,2143.01,0.00
2024-12-08 17:10:35,112,1985,56,56,1119.53,2143.11,0.00
2024-12-08 17:10:35,111,1985,55,56,1113.55,2143.70,0.00
2024-12-08 17:10:35,110,1985,55,55,1122.35,2143.75,0.00
2024-12-08 17:10:35,110,1986,55,55,1135.80,2144.00,0.00
2024-12-08 17:10:35,111,1986,56,55,1125.56,2144.01,0.00
2024-12-08 17:10:35,110,1986,56,54,1130.97,2144.11,0.00
2024-12-08 17:10:35,110,1987,56,54,1127.30,2145.00,0.00
2024-12-08 17:10:35,111,1987,56,55,1117.15,2145.01,0.00
2024-12-08 17:10:35,112,1986,57,55,1102.97,2145.05,0.00
2024-12-08 17:10:35,111,1986,57,54,1122.23,2145.12,0.00
2024-12-08 17:10:35,112,1985,57,55,1098.88,2145.77,0.00
2024-12-08 17:10:35,112,1986,57,55,1117.00,2146.00,0.00
2024-12-08 17:10:35,113,1986,58,55,1107.11,2146.01,0.00
2024-12-08 17:10:35,112,1986,58,54,1112.26,2146.11,0.00
2024-12-08 17:10:35,112,1987,58,54,1146.95,2147.00,0.00
2024-12-08 17:10:35,113,1987,58,55,1136.80,2147.01,0.00
2024-12-08 17:10:35,114,1986,59,55,1125.54,2147.09,0.00
2024-12-08 17:10:35,113,1986,58,55,1135.14,2147.15,0.00
2024-12-08 17:10:35,114,1985,59,55,1117.88,2147.33,0.00
2024-12-08 17:10:35,115,1984,60,55,1115.31,2147.77,0.00
2024-12-08 17:10:36,115,1985,60,55,1133.09,2148.00,0.00
2024-12-08 17:10:36,116,1985,60,56,1123.33,2148.01,0.00
2024-12-08 17:10:36,115,1985,60,55,1127.54,2148.13,0.00
2024-12-08 17:10:36,114,1985,59,55,1136.87,2148.16,0.00
2024-12-08 17:10:36,115,1984,59,56,1122.39,2148.39,0.00
2024-12-08 17:10:36,114,1984,59,55,1134.18,2148.81,0.00
2024-12-08 17:10:36,114,1985,59,55,1201.81,2149.00,0.00
2024-12-08 17:10:36,115,1985,60,55,1191.36,2149.01,0.00
2024-12-08 17:10:36,114,1985,59,55,1199.41,2149.11,0.00
2024-12-08 17:10:36,113,1985,59,54,1208.90,2149.16,0.00
2024-12-08 17:10:36,113,1986,59,54,1225.57,2150.00,0.00
2024-12-08 17:10:36,114,1986,59,55,1214.82,2150.01,0.00
2024-12-08 17:10:36,113,1986,58,55,1216.51,2150.21,0.00
2024-12-08 17:10:36,113,1987,58,55,1219.10,2151.00,0.00
2024-12-08 17:10:36,114,1987,59,55,1208.40,2151.01,0.00
2024-12-08 17:10:36,113,1987,58,55,1218.17,2151.04,0.00
2024-12-08 17:10:36,112,1987,58,54,1226.58,2151.15,0.00
2024-12-08 17:10:36,112,1988,58,54,1224.21,2152.00,0.00
2024-12-08 17:10:36,113,1988,59,54,1213.38,2152.01,0.00
2024-12-08 17:10:36,112,1988,59,53,1216.78,2152.17,0.00
2024-12-08 17:10:36,112,1989,59,53,1214.52,2153.00,0.00
2024-12-08 17:10:36,113,1989,60,53,1203.77,2153.01,0.00
2024-12-08 17:10:36,112,1989,59,53,1212.83,2153.08,0.00
2024-12-08 17:10:36,111,1989,59,52,1218.15,2153.16,0.00
2024-12-08 17:10:36,111,1990,59,52,1215.79,2154.00,0.00
2024-12-08 17:10:36,112,1990,59,53,1204.93,2154.01,0.00
2024-12-08 17:10:36,111,1990,58,53,1210.21,2154.14,0.00
2024-12-08 17:10:36,110,1990,58,52,1216.91,2154.16,0.00
2024-12-08 17:10:36,110,1991,58,52,1218.59,2155.00,0.00
2024-12-08 17:10:36,111,1991,59,52,1207.61,2155.01,0.00
2024-12-08 17:10:36,111,1992,59,52,1198.28,2156.00,0.00
2024-12-08 17:10:36,112,1992,60,52,1187.58,2156.01,0.00
2024-12-08 17:10:36,112,1993,60,52,1178.00,2157.00,0.00
2024-12-08 17:10:36,113,1993,61,52,1167.58,2157.01,0.00
2024-12-08 17:10:36,112,1993,61,51,1173.24,2157.20,0.00
2024-12-08 17:10:36,112,1994,61,51,1171.13,2158.00,0.00
2024-12-08 17:10:36,113,1994,61,52,1160.76,2158.01,0.00
2024-12-08 17:10:36,114,1993,61,53,1138.96,2158.40,0.00
2024-12-08 17:10:36,114,1994,61,53,1150.88,2159.00,0.00
2024-12-08 17:10:36,115,1994,61,54,1140.87,2159.01,0.00
2024-12-08 17:10:36,114,1994,60,54,1149.03,2159.09,0.00
2024-12-08 17:10:36,113,1994,59,54,1157.10,2159.18,0.00
2024-12-08 17:10:36,112,1994,59,53,1165.13,2159.20,0.00
2024-12-08 17:10:36,112,1995,59,53,1181.69,2160.00,0.00
2024-12-08 17:10:36,113,1995,60,53,1171.23,2160.01,0.00
2024-12-08 17:10:36,112,1995,59,53,1181.30,2160.02,0.00
2024-12-08 17:10:36,112,1996,59,53,1171.35,2161.00,0.00
2024-12-08 17:10:36,113,1996,59,54,1160.99,2161.01,0.00
2024-12-08 17:10:36,113,1997,59,54,1150.86,2162.00,0.00
2024-12-08 17:10:36,114,1997,60,54,1140.76,2162.01,0.00
2024-12-08 17:10:36,115,1996,60,55,1130.84,2162.03,0.00
2024-12-08 17:10:36,114,1996,59,55,1145.75,2162.18,0.00
2024-12-08 17:10:36,115,1995,59,56,1122.76,2162.80,0.00
2024-12-08 17:10:36,115,1996,59,56,1136.66,2163.00,0.00
2024-12-08 17:10:36,116,1996,60,56,1126.86,2163.01,0.00
2024-12-08 17:10:36,115,1996,60,55,1134.44,2163.06,0.00
2024-12-08 17:10:36,115,1997,60,55,1166.41,2164.00,0.00
2024-12-08 17:10:36,116,1997,60,56,1156.35,2164.01,0.00
2024-12-08 17:10:36,115,1997,60,55,1162.70,2164.17,0.00
2024-12-08 17:10:37,115,1998,60,55,1157.69,2165.00,0.00
2024-12-08 17:10:37,116,1998,61,55,1147.71,2165.01,0.00
2024-12-08 17:10:37,115,1998,60,55,1156.04,2165.08,0.00
2024-12-08 17:10:37,114,1998,59,55,1165.99,2165.08,0.00
2024-12-08 17:10:37,113,1998,58,55,1174.40,2165.16,0.00
2024-12-08 17:10:37,112,1998,57,55,1177.38,2165.24,0.00
2024-12-08 17:10:37,113,1997,58,55,1156.59,2165.62,0.00
2024-12-08 17:10:37,113,1998,58,55,1174.14,2166.00,0.00
2024-12-08 17:10:37,114,1998,59,55,1163.84,2166.01,0.00
2024-12-08 17:10:37,113,1998,59,54,1172.46,2166.08,0.00
2024-12-08 17:10:37,112,1998,59,53,1180.22,2166.12,0.00
2024-12-08 17:10:37,113,1997,60,53,1158.58,2166.59,0.00
2024-12-08 17:10:37,114,1996,61,53,1165.92,2166.63,0.00
2024-12-08 17:10:37,114,1997,61,53,1198.52,2167.00,0.00
2024-12-08 17:10:37,115,1997,62,53,1188.10,2167.01,0.00
2024-12-08 17:10:37,114,1997,62,52,1195.34,2167.15,0.00
2024-12-08 17:10:37,113,1997,62,51,1197.97,2167.49,0.00
2024-12-08 17:10:37,113,1998,62,51,1240.93,2168.00,0.00
2024-12-08 17:10:37,114,1998,62,52,1230.05,2168.01,0.00
2024-12-08 17:10:37,113,1998,62,51,1233.88,2168.15,0.00
2024-12-08 17:10:37,114,1997,63,51,1212.64,2168.62,0.00
2024-12-08 17:10:37,114,1998,63,51,1225.87,2169.00,0.00
2024-12-08 17:10:37,115,1998,63,52,1215.21,2169.01,0.00
2024-12-08 17:10:37,114,1998,63,51,1218.88,2169.15,0.00
2024-12-08 17:10:37,114,1999,63,51,1233.82,2170.00,0.00
2024-12-08 17:10:37,115,1999,64,51,1223.09,2170.01,0.00
2024-12-08 17:10:37,114,1999,63,51,1231.95,2170.08,0.00
2024-12-08 17:10:37,114,2000,63,51,1224.88,2171.00,0.00
2024-12-08 17:10:37,115,2000,63,52,1214.23,2171.01,0.00
2024-12-08 17:10:37,114,2000,62,52,1223.20,2171.08,0.00
2024-12-08 17:10:37,114,2001,62,52,1211.19,2172.00,0.00
2024-12-08 17:10:37,115,2001,63,52,1200.66,2172.01,0.00
2024-12-08 17:10:37,116,2000,64,52,1190.31,2172.03,0.00
2024-12-08 17:10:37,115,2000,63,52,1193.53,2172.25,0.00
2024-12-08 17:10:37,114,2000,62,52,1202.86,2172.27,0.00
2024-12-08 17:10:37,114,2001,62,52,1202.37,2173.00,0.00
2024-12-08 17:10:37,115,2001,62,53,1191.91,2173.01,0.00
2024-12-08 17:10:37,114,2001,62,52,1196.69,2173.13,0.00
2024-12-08 17:10:37,114,2002,62,52,1211.52,2174.00,0.00
2024-12-08 17:10:37,115,2002,63,52,1200.98,2174.01,0.00
2024-12-08 17:10:37,114,2002,62,52,1209.84,2174.08,0.00
2024-12-08 17:10:37,113,2002,61,52,1220.35,2174.08,0.00
2024-12-08 17:10:37,112,2002,61,51,1226.98,2174.12,0.00
2024-12-08 17:10:37,112,2003,61,51,1222.17,2175.00,0.00
2024-12-08 17:10:37,113,2003,62,51,1211.35,2175.01,0.00
2024-12-08 17:10:37,112,2003,62,50,1215.80,2175.12,0.00
2024-12-08 17:10:37,111,2003,61,50,1222.06,2175.14,0.00
2024-12-08 17:10:37,110,2003,61,49,1231.28,2175.20,0.00
2024-12-08 17:10:37,110,2004,61,49,1233.83,2176.00,0.00
2024-12-08 17:10:37,111,2004,61,50,1222.71,2176.01,0.00
2024-12-08 17:10:37,110,2004,60,50,1232.08,2176.08,0.00
2024-12-08 17:10:37,109,2004,60,49,1239.00,2176.12,0.00
2024-12-08 17:10:37,108,2004,59,49,1244.73,2176.20,0.00
2024-12-08 17:10:37,108,2005,59,49,1247.85,2177.00,0.00
2024-12-08 17:10:37,109,2005,59,50,1236.40,2177.01,0.00
2024-12-08 17:10:37,108,2005,58,50,1246.27,2177.07,0.00
2024-12-08 17:10:37,107,2005,57,50,1255.87,2177.13,0.00
2024-12-08 17:10:37,107,2006,57,50,1248.84,2178.00,0.00
2024-12-08 17:10:37,108,2006,57,51,1237.27,2178.01,0.00
2024-12-08 17:10:37,108,2007,57,51,1227.03,2179.00,0.00
2024-12-08 17:10:37,109,2007,58,51,1215.77,2179.01,0.00
2024-12-08 17:10:37,109,2008,58,51,1205.71,2180.00,0.00
2024-12-08 17:10:37,110,2008,59,51,1194.75,2180.01,0.00
2024-12-08 17:10:37,109,2008,59,50,1198.85,2180.14,0.00
2024-12-08 17:10:38,109,2009,59,50,1196.00,2181.00,0.00
2024-12-08 17:10:38,110,2009,60,50,1185.13,2181.01,0.00
2024-12-08 17:10:38,111,2008,61,50,1173.69,2181.06,0.00
2024-12-08 17:10:38,112,2007,62,50,1178.81,2181.14,0.00
2024-12-08 17:10:38,111,2007,61,50,1186.68,2181.76,0.00
2024-12-08 17:10:38,111,2008,61,50,1197.29,2182.00,0.00
2024-12-08 17:10:38,112,2008,62,50,1186.60,2182.01,0.00
2024-12-08 17:10:38,113,2007,62,51,1175.92,2182.04,0.00
2024-12-08 17:10:38,112,2007,62,50,1189.89,2182.16,0.00
2024-12-08 17:10:38,112,2008,62,50,1226.04,2183.00,0.00
2024-12-08 17:10:38,113,2008,63,50,1215.19,2183.01,0.00
2024-12-08 17:10:38,112,2008,62,50,1224.33,2183.08,0.00
2024-12-08 17:10:38,111,2008,62,49,1232.46,2183.14,0.00
2024-12-08 17:10:38,110,2008,61,49,1237.06,2183.27,0.00
2024-12-08 17:10:38,110,2009,61,49,1260.98,2184.00,0.00
2024-12-08 17:10:38,111,2009,61,50,1249.62,2184.01,0.00
2024-12-08 17:10:38,112,2008,61,51,1215.41,2184.73,0.00
2024-12-08 17:10:38,112,2009,61,51,1233.33,2185.00,0.00
2024-12-08 17:10:38,113,2009,62,51,1222.41,2185.01,0.00
2024-12-08 17:10:38,112,2009,62,50,1225.71,2185.14,0.00
2024-12-08 17:10:38,112,2010,62,50,1246.50,2186.00,0.00
2024-12-08 17:10:38,113,2010,62,51,1235.47,2186.01,0.00
2024-12-08 17:10:38,112,2010,61,51,1244.78,2186.08,0.00
2024-12-08 17:10:38,112,2011,61,51,1236.52,2187.00,0.00
2024-12-08 17:10:38,113,2011,61,52,1225.58,2187.01,0.00
2024-12-08 17:10:38,112,2011,61,51,1234.11,2187.11,0.00
2024-12-08 17:10:38,111,2011,61,50,1244.44,2187.13,0.00
2024-12-08 17:10:38,110,2011,60,50,1247.76,2187.50,0.00
2024-12-08 17:10:38,110,2012,60,50,1252.81,2188.00,0.00
2024-12-08 17:10:38,111,2012,61,50,1241.52,2188.01,0.00
2024-12-08 17:10:38,110,2012,61,49,1245.73,2188.13,0.00
2024-12-08 17:10:38,111,2011,62,49,1225.81,2188.55,0.00
2024-12-08 17:10:38,111,2012,62,49,1239.27,2189.00,0.00
2024-12-08 17:10:38,112,2012,62,50,1228.20,2189.01,0.00
2024-12-08 17:10:38,113,2011,63,50,1216.96,2189.04,0.00
2024-12-08 17:10:38,112,2011,62,50,1226.20,2189.30,0.00
2024-12-08 17:10:38,112,2012,62,50,1249.38,2190.00,0.00
2024-12-08 17:10:38,113,2012,62,51,1238.33,2190.01,0.00
2024-12-08 17:10:38,112,2012,62,50,1246.31,2190.13,0.00
2024-12-08 17:10:38,112,2013,62,50,1261.96,2191.00,0.00
2024-12-08 17:10:38,113,2013,62,51,1250.79,2191.01,0.00
2024-12-08 17:10:38,112,2013,61,51,1259.47,2191.13,0.00
2024-12-08 17:10:38,112,2014,61,51,1251.13,2192.00,0.00
2024-12-08 17:10:38,113,2014,62,51,1240.06,2192.01,0.00
2024-12-08 17:10:38,112,2014,62,50,1246.68,2192.12,0.00
2024-12-08 17:10:38,113,2013,62,51,1219.59,2192.70,0.00
2024-12-08 17:10:38,113,2014,62,51,1247.73,2193.00,0.00
2024-12-08 17:10:38,114,2014,63,51,1236.78,2193.01,0.00
2024-12-08 17:10:38,113,2014,63,50,1246.02,2193.08,0.00
2024-12-08 17:10:38,112,2014,63,49,1256.56,2193.08,0.00
2024-12-08 17:10:38,113,2013,64,49,1236.86,2193.50,0.00
2024-12-08 17:10:38,113,2014,64,49,1266.16,2194.00,0.00
2024-12-08 17:10:38,114,2014,65,49,1255.06,2194.01,0.00
2024-12-08 17:10:38,113,2014,65,48,1262.91,2194.09,0.00
2024-12-08 17:10:38,112,2014,65,47,1273.28,2194.13,0.00
2024-12-08 17:10:38,113,2013,65,48,1256.49,2194.40,0.00
2024-12-08 17:10:38,113,2014,65,48,1280.71,2195.00,0.00
2024-12-08 17:10:38,114,2014,65,49,1269.47,2195.01,0.00
2024-12-08 17:10:38,113,2014,65,48,1275.01,2195.10,0.00
2024-12-08 17:10:38,113,2015,65,48,1287.48,2196.00,0.00
2024-12-08 17:10:38,114,2015,65,49,1276.19,2196.01,0.00
2024-12-08 17:10:39,113,2015,64,49,1280.70,2196.11,0.00
2024-12-08 17:10:39,113,2016,64,49,1272.69,2197.00,0.00
2024-12-08 17:10:39,114,2016,64,50,1261.52,2197.01,0.00
2024-12-08 17:10:39,115,2015,65,50,1250.00,2197.05,0.00
2024-12-08 17:10:39,114,2015,64,50,1276.79,2197.07,0.00
2024-12-08 17:10:39,113,2015,64,49,1285.66,2197.11,0.00
2024-12-08 17:10:39,112,2015,63,49,1288.68,2197.50,0.00
2024-12-08 17:10:39,111,2015,62,49,1289.50,2197.83,0.00
2024-12-08 17:10:39,111,2016,62,49,1305.68,2198.00,0.00
2024-12-08 17:10:39,112,2016,63,49,1294.02,2198.01,0.00
2024-12-08 17:10:39,112,2017,63,49,1299.14,2199.00,0.00
2024-12-08 17:10:39,113,2017,64,49,1287.64,2199.01,0.00
2024-12-08 17:10:39,114,2016,65,49,1276.35,2199.03,0.00
2024-12-08 17:10:39,113,2016,64,49,1287.96,2199.12,0.00
2024-12-08 17:10:39,114,2015,65,49,1269.96,2199.26,0.00
2024-12-08 17:10:39,114,2016,65,49,1278.92,2200.00,0.00
2024-12-08 17:10:39,115,2016,66,49,1267.80,2200.01,0.00
2024-12-08 17:10:39,114,2016,66,48,1272.08,2200.12,0.00
2024-12-08 17:10:39,114,2017,66,48,1304.10,2201.00,0.00
2024-12-08 17:10:39,115,2017,66,49,1292.76,2201.01,0.00
2024-12-08 17:10:39,116,2016,66,50,1258.72,2201.51,0.00
2024-12-08 17:10:39,116,2017,66,50,1271.44,2202.00,0.00
2024-12-08 17:10:39,117,2017,66,51,1260.57,2202.01,0.00
2024-12-08 17:10:39,116,2017,66,50,1266.21,2202.07,0.00
2024-12-08 17:10:39,115,2017,66,49,1275.65,2202.11,0.00
2024-12-08 17:10:39,114,2017,66,48,1273.55,2202.62,0.00
2024-12-08 17:10:39,114,2018,66,48,1302.45,2203.00,0.00
2024-12-08 17:10:39,115,2018,66,49,1291.12,2203.01,0.00
2024-12-08 17:10:39,114,2018,65,49,1286.19,2203.52,0.00
2024-12-08 17:10:39,114,2019,65,49,1289.49,2204.00,0.00
2024-12-08 17:10:39,115,2019,66,49,1278.28,2204.01,0.00
2024-12-08 17:10:39,114,2019,66,48,1287.02,2204.11,0.00
2024-12-08 17:10:39,114,2020,66,48,1279.09,2205.00,0.00
2024-12-08 17:10:39,115,2020,67,48,1267.97,2205.01,0.00
2024-12-08 17:10:39,114,2020,66,48,1271.76,2205.13,0.00
2024-12-08 17:10:39,113,2020,66,47,1268.74,2205.62,0.00
2024-12-08 17:10:39,113,2021,66,47,1277.56,2206.00,0.00
2024-12-08 17:10:39,114,2021,66,48,1266.36,2206.01,0.00
2024-12-08 17:10:39,113,2021,66,47,1274.87,2206.07,0.00
2024-12-08 17:10:39,112,2021,66,46,1284.11,2206.12,0.00
2024-12-08 17:10:39,112,2022,66,46,1275.14,2207.00,0.00
2024-12-08 17:10:39,113,2022,66,47,1263.85,2207.01,0.00
2024-12-08 17:10:39,112,2022,65,47,1270.04,2207.05,0.00
2024-12-08 17:10:39,111,2022,64,47,1280.50,2207.09,0.00
2024-12-08 17:10:39,110,2022,64,46,1287.73,2207.10,0.00
2024-12-08 17:10:39,110,2023,64,46,1279.24,2208.00,0.00
2024-12-08 17:10:39,111,2023,64,47,1267.71,2208.01,0.00
2024-12-08 17:10:39,110,2023,63,47,1250.62,2208.67,0.00
2024-12-08 17:10:39,110,2024,63,47,1259.72,2209.00,0.00
2024-12-08 17:10:39,111,2024,63,48,1248.37,2209.01,0.00
2024-12-08 17:10:39,110,2024,63,47,1257.55,2209.10,0.00
2024-12-08 17:10:39,110,2025,63,47,1250.78,2210.00,0.00
2024-12-08 17:10:39,111,2025,64,47,1239.51,2210.01,0.00
2024-12-08 17:10:39,111,2026,64,47,1226.96,2211.00,0.00
2024-12-08 17:10:39,112,2026,64,48,1216.00,2211.01,0.00
2024-12-08 17:10:39,111,2026,64,47,1220.23,2211.12,0.00
2024-12-08 17:10:39,110,2026,64,46,1226.51,2211.31,0.00
2024-12-08 17:10:39,109,2026,63,46,1232.81,2211.54,0.00
2024-12-08 17:10:39,109,2027,63,46,1242.58,2212.00,0.00
2024-12-08 17:10:39,110,2027,64,46,1231.28,2212.01,0.00
2024-12-08 17:10:39,109,2027,63,46,1236.94,2212.07,0.00
2024-12-08 17:10:39,108,2027,62,46,1231.90,2212.62,0.00
2024-12-08 17:10:40,108,2028,62,46,1244.29,2213.00,0.00
2024-12-08 17:10:40,109,2028,62,47,1232.87,2213.01,0.00
2024-12-08 17:10:40,108,2028,62,46,1237.77,2213.11,0.00
2024-12-08 17:10:40,108,2029,62,46,1239.11,2214.00,0.00
2024-12-08 17:10:40,109,2029,62,47,1227.74,2214.01,0.00
2024-12-08 17:10:40,108,2029,61,47,1237.70,2214.07,0.00
2024-12-08 17:10:40,108,2030,61,47,1228.57,2215.00,0.00
2024-12-08 17:10:40,109,2030,62,47,1217.30,2215.01,0.00
2024-12-08 17:10:40,110,2029,63,47,1204.66,2215.10,0.00
2024-12-08 17:10:40,109,2029,63,46,1222.03,2215.11,0.00
2024-12-08 17:10:40,108,2029,62,46,1222.14,2215.47,0.00
2024-12-08 17:10:40,108,2030,62,46,1228.89,2216.00,0.00
2024-12-08 17:10:40,109,2030,63,46,1217.61,2216.01,0.00
2024-12-08 17:10:40,109,2031,63,46,1227.08,2217.00,0.00
2024-12-08 17:10:40,110,2031,63,47,1215.92,2217.01,0.00
2024-12-08 17:10:40,110,2032,63,47,1205.68,2218.00,0.00
2024-12-08 17:10:40,111,2032,64,47,1194.81,2218.01,0.00
2024-12-08 17:10:40,110,2032,63,47,1199.07,2218.13,0.00
2024-12-08 17:10:40,109,2032,62,47,1209.86,2218.13,0.00
2024-12-08 17:10:40,108,2032,61,47,1212.52,2218.48,0.00
2024-12-08 17:10:40,108,2033,61,47,1217.82,2219.00,0.00
2024-12-08 17:10:40,109,2033,62,47,1206.65,2219.01,0.00
2024-12-08 17:10:40,110,2032,62,48,1194.49,2219.08,0.00
2024-12-08 17:10:40,109,2032,62,47,1220.54,2219.11,0.00
2024-12-08 17:10:40,108,2032,61,47,1231.23,2219.13,0.00
2024-12-08 17:10:40,108,2033,61,47,1228.86,2220.00,0.00
2024-12-08 17:10:40,109,2033,61,48,1217.58,2220.01,0.00
2024-12-08 17:10:40,110,2032,62,48,1194.13,2220.41,0.00
2024-12-08 17:10:40,110,2033,62,48,1228.66,2221.00,0.00
2024-12-08 17:10:40,111,2033,63,48,1217.59,2221.01,0.00
2024-12-08 17:10:40,112,2032,64,48,1205.94,2221.06,0.00
2024-12-08 17:10:40,112,2033,64,48,1225.12,2222.00,0.00
2024-12-08 17:10:40,113,2033,64,49,1214.28,2222.01,0.00
2024-12-08 17:10:40,114,2032,64,50,1203.24,2222.04,0.00
2024-12-08 17:10:40,113,2032,64,49,1221.21,2222.12,0.00
2024-12-08 17:10:40,113,2033,64,49,1237.45,2223.00,0.00
2024-12-08 17:10:40,114,2033,65,49,1226.59,2223.01,0.00
2024-12-08 17:10:40,113,2033,65,48,1227.46,2223.12,0.00
2024-12-08 17:10:40,113,2034,65,48,1247.65,2224.00,0.00
2024-12-08 17:10:40,114,2034,65,49,1236.70,2224.01,0.00
2024-12-08 17:10:40,113,2034,65,48,1241.59,2224.12,0.00
2024-12-08 17:10:40,113,2035,65,48,1238.17,2225.00,0.00
2024-12-08 17:10:40,114,2035,65,49,1227.31,2225.01,0.00
2024-12-08 17:10:40,113,2035,64,49,1236.24,2225.09,0.00
2024-12-08 17:10:40,112,2035,63,49,1246.69,2225.12,0.00
2024-12-08 17:10:40,111,2035,63,48,1253.32,2225.14,0.00
2024-12-08 17:10:40,111,2036,63,48,1250.24,2226.00,0.00
2024-12-08 17:10:40,112,2036,63,49,1239.08,2226.01,0.00
2024-12-08 17:10:40,111,2036,62,49,1248.28,2226.10,0.00
2024-12-08 17:10:40,110,2036,61,49,1250.79,2226.32,0.00
2024-12-08 17:10:40,110,2037,61,49,1251.66,2227.00,0.00
2024-12-08 17:10:40,111,2037,62,49,1240.38,2227.01,0.00
2024-12-08 17:10:40,110,2037,61,49,1250.47,2227.05,0.00
2024-12-08 17:10:40,109,2037,61,48,1260.33,2227.12,0.00
2024-12-08 17:10:40,108,2037,60,48,1271.39,2227.14,0.00
2024-12-08 17:10:40,108,2038,60,48,1268.74,2228.00,0.00
2024-12-08 17:10:40,109,2038,61,48,1257.10,2228.01,0.00
2024-12-08 17:10:40,108,2038,61,47,1261.57,2228.14,0.00
2024-12-08 17:10:40,108,2039,61,47,1259.40,2229.00,0.00
2024-12-08 17:10:40,109,2039,62,47,1247.85,2229.01,0.00
2024-12-08 17:10:41,109,2040,62,47,1238.57,2230.00,0.00
2024-12-08 17:10:41,110,2040,62,48,1227.31,2230.01,0.00
2024-12-08 17:10:41,109,2040,61,48,1236.07,2230.12,0.00
2024-12-08 17:10:41,108,2040,60,48,1246.49,2230.15,0.00
2024-12-08 17:10:41,107,2040,60,47,1256.68,2230.17,0.00
2024-12-08 17:10:41,107,2041,60,47,1259.48,2231.00,0.00
2024-12-08 17:10:41,108,2041,61,47,1247.81,2231.01,0.00
2024-12-08 17:10:41,109,2040,62,47,1208.88,2231.90,0.00
2024-12-08 17:10:41,109,2041,62,47,1233.14,2232.00,0.00
2024-12-08 17:10:41,110,2041,62,48,1221.93,2232.01,0.00
2024-12-08 17:10:41,109,2041,61,48,1229.87,2232.15,0.00
2024-12-08 17:10:41,108,2041,61,47,1239.19,2232.18,0.00
2024-12-08 17:10:41,108,2042,61,47,1257.81,2233.00,0.00
2024-12-08 17:10:41,109,2042,62,47,1246.27,2233.01,0.00
2024-12-08 17:10:41,108,2042,61,47,1237.47,2233.51,0.00
2024-12-08 17:10:41,108,2043,61,47,1247.55,2234.00,0.00
2024-12-08 17:10:41,109,2043,61,48,1236.10,2234.01,0.00
2024-12-08 17:10:41,110,2042,62,48,1221.68,2234.16,0.00
2024-12-08 17:10:41,109,2042,62,47,1248.28,2234.18,0.00
2024-12-08 17:10:41,109,2043,62,47,1246.16,2235.00,0.00
2024-12-08 17:10:41,110,2043,62,48,1234.83,2235.01,0.00
2024-12-08 17:10:41,109,2043,61,48,1244.35,2235.08,0.00
2024-12-08 17:10:41,108,2043,60,48,1255.57,2235.08,0.00
2024-12-08 17:10:41,109,2042,60,49,1230.80,2235.33,0.00
2024-12-08 17:10:41,110,2041,61,49,1226.82,2235.52,0.00
2024-12-08 17:10:41,110,2042,61,49,1273.51,2236.00,0.00
2024-12-08 17:10:41,111,2042,62,49,1262.04,2236.01,0.00
2024-12-08 17:10:41,110,2042,61,49,1266.66,2236.14,0.00
2024-12-08 17:10:41,110,2043,61,49,1304.39,2237.00,0.00
2024-12-08 17:10:41,111,2043,62,49,1292.63,2237.01,0.00
2024-12-08 17:10:41,111,2044,62,49,1282.85,2238.00,0.00
2024-12-08 17:10:41,112,2044,63,49,1271.39,2238.01,0.00
2024-12-08 17:10:41,112,2045,63,49,1261.53,2239.00,0.00
2024-12-08 17:10:41,113,2045,63,50,1250.36,2239.01,0.00
2024-12-08 17:10:41,112,2045,63,49,1256.76,2239.08,0.00
2024-12-08 17:10:41,111,2045,63,48,1266.69,2239.14,0.00
2024-12-08 17:10:41,112,2044,63,49,1254.39,2239.20,0.00
2024-12-08 17:10:41,111,2044,62,49,1265.72,2239.53,0.00
2024-12-08 17:10:41,111,2045,62,49,1271.72,2240.00,0.00
2024-12-08 17:10:41,112,2045,62,50,1260.37,2240.01,0.00
2024-12-08 17:10:41,113,2044,63,50,1239.15,2240.30,0.00
2024-12-08 17:10:41,112,2044,62,50,1262.42,2240.30,0.00
2024-12-08 17:10:41,113,2043,63,50,1242.48,2240.70,0.00
2024-12-08 17:10:41,113,2044,63,50,1276.43,2241.00,0.00
2024-12-08 17:10:41,114,2044,63,51,1265.23,2241.01,0.00
2024-12-08 17:10:41,114,2045,63,51,1293.69,2242.00,0.00
2024-12-08 17:10:41,115,2045,64,51,1282.44,2242.01,0.00
2024-12-08 17:10:41,114,2045,63,51,1286.66,2242.14,0.00
2024-12-08 17:10:41,114,2046,63,51,1282.14,2243.00,0.00
2024-12-08 17:10:41,115,2046,63,52,1270.99,2243.01,0.00
2024-12-08 17:10:41,116,2045,64,52,1260.03,2243.03,0.00
2024-12-08 17:10:41,115,2045,63,52,1287.18,2243.03,0.00
2024-12-08 17:10:41,116,2044,64,52,1275.71,2243.06,0.00
2024-12-08 17:10:41,115,2044,63,52,1278.64,2243.37,0.00
2024-12-08 17:10:41,115,2045,63,52,1280.27,2244.00,0.00
2024-12-08 17:10:41,116,2045,64,52,1269.23,2244.01,0.00
2024-12-08 17:10:41,115,2045,64,51,1276.21,2244.10,0.00
2024-12-08 17:10:41,115,2046,64,51,1309.92,2245.00,0.00
2024-12-08 17:10:41,116,2046,64,52,1298.63,2245.01,0.00
2024-12-08 17:10:41,115,2046,63,52,1308.40,2245.07,0.00
2024-12-08 17:10:41,115,2047,63,52,1298.28,2246.00,0.00
2024-12-08 17:10:41,116,2047,64,52,1287.09,2246.01,0.00
2024-12-08 17:10:41,115,2047,64,51,1293.05,2246.10,0.00
2024-12-08 17:10:42,115,2048,64,51,1287.33,2247.00,0.00
2024-12-08 17:10:42,116,2048,65,51,1276.23,2247.01,0.00
2024-12-08 17:10:42,115,2048,64,51,1286.19,2247.05,0.00
2024-12-08 17:10:42,114,2048,63,51,1297.08,2247.06,0.00
2024-12-08 17:10:42,113,2048,62,51,1302.07,2247.14,0.00
2024-12-08 17:10:42,113,2049,62,51,1298.17,2248.00,0.00
2024-12-08 17:10:42,114,2049,63,51,1286.78,2248.01,0.00
2024-12-08 17:10:42,113,2049,63,50,1293.04,2248.09,0.00
2024-12-08 17:10:42,112,2049,62,50,1302.74,2248.14,0.00
2024-12-08 17:10:42,111,2049,61,50,1313.27,2248.15,0.00
2024-12-08 17:10:42,110,2049,60,50,1322.19,2248.28,0.00
2024-12-08 17:10:42,110,2050,60,50,1326.15,2249.00,0.00
2024-12-08 17:10:42,111,2050,61,50,1314.20,2249.01,0.00
2024-12-08 17:10:42,110,2050,61,49,1317.40,2249.09,0.00
2024-12-08 17:10:42,110,2051,61,49,1317.07,2250.00,0.00
2024-12-08 17:10:42,111,2051,61,50,1305.20,2250.01,0.00
2024-12-08 17:10:42,110,2051,61,49,1312.20,2250.09,0.00
2024-12-08 17:10:42,110,2052,61,49,1308.21,2251.00,0.00
2024-12-08 17:10:42,111,2052,61,50,1296.42,2251.01,0.00
2024-12-08 17:10:42,112,2051,61,51,1256.60,2251.93,0.00
2024-12-08 17:10:42,112,2052,61,51,1280.60,2252.00,0.00
2024-12-08 17:10:42,113,2052,62,51,1269.26,2252.01,0.00
2024-12-08 17:10:42,113,2053,62,51,1278.98,2253.00,0.00
2024-12-08 17:10:42,114,2053,62,52,1267.76,2253.01,0.00
2024-12-08 17:10:42,113,2053,61,52,1277.42,2253.07,0.00
2024-12-08 17:10:42,114,2052,61,53,1258.75,2253.25,0.00
2024-12-08 17:10:42,113,2052,60,53,1281.68,2253.30,0.00
2024-12-08 17:10:42,113,2053,60,53,1281.97,2254.00,0.00
2024-12-08 17:10:42,114,2053,61,53,1270.72,2254.01,0.00
2024-12-08 17:10:42,114,2054,61,53,1280.21,2255.00,0.00
2024-12-08 17:10:42,115,2054,61,54,1269.08,2255.01,0.00
2024-12-08 17:10:42,114,2054,61,53,1276.90,2255.15,0.00
2024-12-08 17:10:42,113,2054,60,53,1275.13,2255.74,0.00
2024-12-08 17:10:42,113,2055,60,53,1285.22,2256.00,0.00
2024-12-08 17:10:42,114,2055,60,54,1273.95,2256.01,0.00
2024-12-08 17:10:42,115,2054,61,54,1238.89,2256.76,0.00
2024-12-08 17:10:42,115,2055,61,54,1256.84,2257.00,0.00
2024-12-08 17:10:42,116,2055,61,55,1246.01,2257.01,0.00
2024-12-08 17:10:42,115,2055,60,55,1255.31,2257.07,0.00
2024-12-08 17:10:42,114,2055,59,55,1248.47,2257.52,0.00
2024-12-08 17:10:42,114,2056,59,55,1277.07,2258.00,0.00
2024-12-08 17:10:42,115,2056,59,56,1265.96,2258.01,0.00
2024-12-08 17:10:42,114,2056,58,56,1262.95,2258.40,0.00
2024-12-08 17:10:42,114,2057,58,56,1269.06,2259.00,0.00
2024-12-08 17:10:42,115,2057,59,56,1258.03,2259.01,0.00
2024-12-08 17:10:42,114,2057,58,56,1263.16,2259.12,0.00
2024-12-08 17:10:42,113,2057,58,55,1270.74,2259.12,0.00
2024-12-08 17:10:42,113,2058,58,55,1270.63,2260.00,0.00
2024-12-08 17:10:42,114,2058,59,55,1259.48,2260.01,0.00
2024-12-08 17:10:42,115,2057,59,56,1246.80,2260.10,0.00
2024-12-08 17:10:42,114,2057,59,55,1266.27,2260.13,0.00
2024-12-08 17:10:42,113,2057,58,55,1277.28,2260.13,0.00
2024-12-08 17:10:42,113,2058,58,55,1273.20,2261.00,0.00
2024-12-08 17:10:42,114,2058,59,55,1262.03,2261.01,0.00
2024-12-08 17:10:43,114,2059,59,55,1270.84,2262.00,0.00
2024-12-08 17:10:43,115,2059,59,56,1259.78,2262.01,0.00
2024-12-08 17:10:43,114,2059,59,55,1267.71,2262.14,0.00
2024-12-08 17:10:43,113,2059,58,55,1273.73,2262.16,0.00
2024-12-08 17:10:43,113,2060,58,55,1274.14,2263.00,0.00
2024-12-08 17:10:43,114,2060,59,55,1262.96,2263.01,0.00
2024-12-08 17:10:43,113,2060,59,54,1270.78,2263.14,0.00
2024-12-08 17:10:43,113,2061,59,54,1266.96,2264.00,0.00
2024-12-08 17:10:43,114,2061,60,54,1255.85,2264.01,0.00
2024-12-08 17:10:43,113,2061,60,53,1259.80,2264.14,0.00
2024-12-08 17:10:43,112,2061,60,52,1257.63,2264.71,0.00
2024-12-08 17:10:43,112,2062,60,52,1267.57,2265.00,0.00
2024-12-08 17:10:43,113,2062,60,53,1256.35,2265.01,0.00
2024-12-08 17:10:43,113,2063,60,53,1246.48,2266.00,0.00
2024-12-08 17:10:43,114,2063,61,53,1235.55,2266.01,0.00
2024-12-08 17:10:43,113,2063,60,53,1244.71,2266.08,0.00
2024-12-08 17:10:43,112,2063,59,53,1246.19,2266.33,0.00
2024-12-08 17:10:43,112,2064,59,53,1247.49,2267.00,0.00
2024-12-08 17:10:43,113,2064,59,54,1236.45,2267.01,0.00
2024-12-08 17:10:43,113,2065,59,54,1226.29,2268.00,0.00
2024-12-08 17:10:43,114,2065,59,55,1215.54,2268.01,0.00
2024-12-08 17:10:43,113,2065,59,54,1224.33,2268.09,0.00
2024-12-08 17:10:43,113,2066,59,54,1215.84,2269.00,0.00
2024-12-08 17:10:43,114,2066,59,55,1205.17,2269.01,0.00
2024-12-08 17:10:43,113,2066,59,54,1213.87,2269.09,0.00
2024-12-08 17:10:43,112,2066,59,53,1223.09,2269.12,0.00
2024-12-08 17:10:43,112,2067,59,53,1219.37,2270.00,0.00
2024-12-08 17:10:43,113,2067,59,54,1208.58,2270.01,0.00
2024-12-08 17:10:43,112,2067,59,53,1213.33,2270.12,0.00
2024-12-08 17:10:43,112,2068,59,53,1209.59,2271.00,0.00
2024-12-08 17:10:43,113,2068,59,54,1198.89,2271.01,0.00
2024-12-08 17:10:43,112,2068,59,53,1203.35,2271.12,0.00
2024-12-08 17:10:43,111,2068,58,53,1202.17,2271.44,0.00
2024-12-08 17:10:43,111,2069,58,53,1210.33,2272.00,0.00
2024-12-08 17:10:43,112,2069,58,54,1199.53,2272.01,0.00
2024-12-08 17:10:43,111,2069,58,53,1203.82,2272.13,0.00
2024-12-08 17:10:43,110,2069,57,53,1210.46,2272.24,0.00
2024-12-08 17:10:43,110,2070,57,53,1213.62,2273.00,0.00
2024-12-08 17:10:43,111,2070,57,54,1202.69,2273.01,0.00
2024-12-08 17:10:43,110,2070,57,53,1207.05,2273.13,0.00
2024-12-08 17:10:43,110,2071,57,53,1203.52,2274.00,0.00
2024-12-08 17:10:43,111,2071,57,54,1192.68,2274.01,0.00
2024-12-08 17:10:43,110,2071,56,54,1197.35,2274.09,0.00
2024-12-08 17:10:43,109,2071,56,53,1203.75,2274.12,0.00
2024-12-08 17:10:43,109,2072,56,53,1204.26,2275.00,0.00
2024-12-08 17:10:43,110,2072,56,54,1193.31,2275.01,0.00
2024-12-08 17:10:43,109,2072,56,53,1197.21,2275.14,0.00
2024-12-08 17:10:43,109,2073,56,53,1193.84,2276.00,0.00
2024-12-08 17:10:43,110,2073,56,54,1182.99,2276.01,0.00
2024-12-08 17:10:43,109,2073,55,54,1187.20,2276.13,0.00
2024-12-08 17:10:43,108,2073,55,53,1193.98,2276.13,0.00
2024-12-08 17:10:43,108,2074,55,53,1194.83,2277.00,0.00
2024-12-08 17:10:43,109,2074,55,54,1183.87,2277.01,0.00
2024-12-08 17:10:43,108,2074,54,54,1193.37,2277.05,0.00
2024-12-08 17:10:43,107,2074,54,53,1198.59,2277.12,0.00
2024-12-08 17:10:44,107,2075,54,53,1199.41,2278.00,0.00
2024-12-08 17:10:44,108,2075,55,53,1188.31,2278.01,0.00
2024-12-08 17:10:44,107,2075,55,52,1192.64,2278.12,0.00
2024-12-08 17:10:44,107,2076,55,52,1189.19,2279.00,0.00
2024-12-08 17:10:44,108,2076,56,52,1178.18,2279.01,0.00
2024-12-08 17:10:44,107,2076,55,52,1182.63,2279.12,0.00
2024-12-08 17:10:44,106,2076,55,51,1183.86,2279.33,0.00
2024-12-08 17:10:44,106,2077,55,51,1190.52,2280.00,0.00
2024-12-08 17:10:44,107,2077,55,52,1179.40,2280.01,0.00
2024-12-08 17:10:44,106,2077,55,51,1186.91,2280.15,0.00
2024-12-08 17:10:44,105,2077,54,51,1194.14,2280.32,0.00
2024-12-08 17:10:44,105,2078,54,51,1196.52,2281.00,0.00
2024-12-08 17:10:44,106,2078,55,51,1185.24,2281.01,0.00
2024-12-08 17:10:44,105,2078,54,51,1194.60,2281.09,0.00
2024-12-08 17:10:44,104,2078,54,50,1199.95,2281.14,0.00
2024-12-08 17:10:44,104,2079,54,50,1198.46,2282.00,0.00
2024-12-08 17:10:44,105,2079,54,51,1187.05,2282.01,0.00
2024-12-08 17:10:44,104,2079,53,51,1196.52,2282.09,0.00
2024-12-08 17:10:44,103,2079,53,50,1197.45,2282.14,0.00
2024-12-08 17:10:44,103,2080,53,50,1200.38,2283.00,0.00
2024-12-08 17:10:44,104,2080,53,51,1188.84,2283.01,0.00
2024-12-08 17:10:44,103,2080,52,51,1194.21,2283.12,0.00
2024-12-08 17:10:44,102,2080,52,50,1200.16,2283.13,0.00
2024-12-08 17:10:44,102,2081,52,50,1203.11,2284.00,0.00
2024-12-08 17:10:44,103,2081,53,50,1191.43,2284.01,0.00
2024-12-08 17:10:44,103,2082,53,50,1181.51,2285.00,0.00
2024-12-08 17:10:44,104,2082,53,51,1170.15,2285.01,0.00
2024-12-08 17:10:44,103,2082,52,51,1178.45,2285.12,0.00
2024-12-08 17:10:44,102,2082,52,50,1189.11,2285.13,0.00
2024-12-08 17:10:44,102,2083,52,50,1187.38,2286.00,0.00
2024-12-08 17:10:44,103,2083,53,50,1175.86,2286.01,0.00
2024-12-08 17:10:44,102,2083,52,50,1172.67,2286.28,0.00
2024-12-08 17:10:44,102,2084,52,50,1178.73,2287.00,0.00
2024-12-08 17:10:44,103,2084,52,51,1167.29,2287.01,0.00
2024-12-08 17:10:44,102,2084,52,50,1175.63,2287.13,0.00
2024-12-08 17:10:44,102,2085,52,50,1173.43,2288.00,0.00
2024-12-08 17:10:44,103,2085,52,51,1162.04,2288.01,0.00
2024-12-08 17:10:44,103,2086,52,51,1152.37,2289.00,0.00
2024-12-08 17:10:44,104,2086,53,51,1141.29,2289.01,0.00
2024-12-08 17:10:44,103,2086,52,51,1150.39,2289.09,0.00
2024-12-08 17:10:44,102,2086,52,50,1160.78,2289.12,0.00
2024-12-08 17:10:44,102,2087,52,50,1158.02,2290.00,0.00
2024-12-08 17:10:44,103,2087,53,50,1146.78,2290.01,0.00
2024-12-08 17:10:44,103,2088,53,50,1136.80,2291.00,0.00
2024-12-08 17:10:44,104,2088,53,51,1125.86,2291.01,0.00
2024-12-08 17:10:44,105,2087,53,52,1114.28,2291.07,0.00
2024-12-08 17:10:44,104,2087,53,51,1144.19,2291.14,0.00
2024-12-08 17:10:44,104,2088,53,51,1141.10,2292.00,0.00
2024-12-08 17:10:44,105,2088,53,52,1130.23,2292.01,0.00
2024-12-08 17:10:44,104,2088,52,52,1138.27,2292.13,0.00
2024-12-08 17:10:44,103,2088,51,52,1140.91,2292.30,0.00
2024-12-08 17:10:44,104,2087,52,52,1115.49,2292.69,0.00
2024-12-08 17:10:44,104,2088,52,52,1159.60,2293.00,0.00
2024-12-08 17:10:44,105,2088,53,52,1148.55,2293.01,0.00
2024-12-08 17:10:44,104,2088,52,52,1158.30,2293.06,0.00
2024-12-08 17:10:44,103,2088,52,51,1168.00,2293.12,0.00
2024-12-08 17:10:44,102,2088,51,51,1175.01,2293.30,0.00
2024-12-08 17:10:44,102,2089,51,51,1202.39,2294.00,0.00
2024-12-08 17:10:44,103,2089,52,51,1190.71,2294.01,0.00
2024-12-08 17:10:44,102,2089,51,51,1193.43,2294.16,0.00
2024-12-08 17:10:45,102,2090,51,51,1194.67,2295.00,0.00
2024-12-08 17:10:45,103,2090,52,51,1183.07,2295.01,0.00
2024-12-08 17:10:45,102,2090,52,50,1190.89,2295.15,0.00
2024-12-08 17:10:45,101,2090,52,49,1193.32,2295.52,0.00
2024-12-08 17:10:45,101,2091,52,49,1200.72,2296.00,0.00
2024-12-08 17:10:45,102,2091,53,49,1188.94,2296.01,0.00
2024-12-08 17:10:45,101,2091,52,49,1188.76,2296.33,0.00
2024-12-08 17:10:45,101,2092,52,49,1191.91,2297.00,0.00
2024-12-08 17:10:45,102,2092,52,50,1180.23,2297.01,0.00
2024-12-08 17:10:45,101,2092,51,50,1191.24,2297.03,0.00
2024-12-08 17:10:45,100,2092,51,49,1199.74,2297.15,0.00
2024-12-08 17:10:45,100,2093,51,49,1199.07,2298.00,0.00
2024-12-08 17:10:45,101,2093,52,49,1187.20,2298.01,0.00
2024-12-08 17:10:45,100,2093,51,49,1182.66,2298.44,0.00
2024-12-08 17:10:45,100,2094,51,49,1193.16,2299.00,0.00
2024-12-08 17:10:45,101,2094,51,50,1181.34,2299.01,0.00
2024-12-08 17:10:45,100,2094,50,50,1191.35,2299.08,0.00
2024-12-08 17:10:45,99,2094,49,50,1202.00,2299.13,0.00
2024-12-08 17:10:45,98,2094,49,49,1213.09,2299.14,0.00
2024-12-08 17:10:45,98,2095,49,49,1212.64,2300.00,0.00
2024-12-08 17:10:45,99,2095,49,50,1200.39,2300.01,0.00
2024-12-08 17:10:45,99,2096,49,50,1191.69,2301.00,0.00
2024-12-08 17:10:45,100,2096,49,51,1179.78,2301.01,0.00
2024-12-08 17:10:45,99,2096,49,50,1188.25,2301.14,0.00
2024-12-08 17:10:45,99,2097,49,50,1186.78,2302.00,0.00
2024-12-08 17:10:45,100,2097,49,51,1174.91,2302.01,0.00
2024-12-08 17:10:45,100,2098,49,51,1165.12,2303.00,0.00
2024-12-08 17:10:45,101,2098,49,52,1153.59,2303.01,0.00
2024-12-08 17:10:45,100,2098,49,51,1161.70,2303.14,0.00
2024-12-08 17:10:45,100,2099,49,51,1159.04,2304.00,0.00
2024-12-08 17:10:45,101,2099,50,51,1147.56,2304.01,0.00
2024-12-08 17:10:45,102,2098,50,52,1122.99,2304.37,0.00
2024-12-08 17:10:45,102,2099,50,52,1139.82,2305.00,0.00
2024-12-08 17:10:45,103,2099,51,52,1128.75,2305.01,0.00
2024-12-08 17:10:45,102,2099,51,51,1136.68,2305.14,0.00
2024-12-08 17:10:45,102,2100,51,51,1156.45,2306.00,0.00
2024-12-08 17:10:45,103,2100,51,52,1145.22,2306.01,0.00
2024-12-08 17:10:45,102,2100,51,51,1154.66,2306.08,0.00
2024-12-08 17:10:45,101,2100,51,50,1160.16,2306.13,0.00
2024-12-08 17:10:45,101,2101,51,50,1157.58,2307.00,0.00
2024-12-08 17:10:45,102,2101,52,50,1146.23,2307.01,0.00
2024-12-08 17:10:45,103,2100,52,51,1134.88,2307.04,0.00
2024-12-08 17:10:45,102,2100,51,51,1142.28,2307.58,0.00
2024-12-08 17:10:45,103,2099,51,52,1125.10,2307.86,0.00
2024-12-08 17:10:45,103,2100,51,52,1147.40,2308.00,0.00
2024-12-08 17:10:45,104,2100,51,53,1136.36,2308.01,0.00
2024-12-08 17:10:45,104,2101,51,53,1168.82,2309.00,0.00
2024-12-08 17:10:45,105,2101,52,53,1157.69,2309.01,0.00
2024-12-08 17:10:45,104,2101,51,53,1165.53,2309.14,0.00
2024-12-08 17:10:45,103,2101,51,52,1176.40,2309.15,0.00
2024-12-08 17:10:45,102,2101,50,52,1185.34,2309.26,0.00
2024-12-08 17:10:45,102,2102,50,52,1185.44,2310.00,0.00
2024-12-08 17:10:45,103,2102,50,53,1173.93,2310.01,0.00
2024-12-08 17:10:45,102,2102,49,53,1183.66,2310.08,0.00
2024-12-08 17:10:45,101,2102,49,52,1193.10,2310.15,0.00
2024-12-08 17:10:45,101,2103,49,52,1190.93,2311.00,0.00
2024-12-08 17:10:45,102,2103,50,52,1179.25,2311.01,0.00
2024-12-08 17:10:45,102,2104,50,52,1169.25,2312.00,0.00
2024-12-08 17:10:45,103,2104,50,53,1157.89,2312.01,0.00
2024-12-08 17:10:45,102,2104,50,52,1165.43,2312.15,0.00
2024-12-08 17:10:45,101,2104,50,51,1171.19,2312.39,0.00
2024-12-08 17:10:46,101,2105,50,51,1175.71,2313.00,0.00
2024-12-08 17:10:46,102,2105,51,51,1164.19,2313.01,0.00
2024-12-08 17:10:46,101,2105,50,51,1165.20,2313.14,0.00
2024-12-08 17:10:46,100,2105,49,51,1167.65,2313.34,0.00
2024-12-08 17:10:46,100,2106,49,51,1175.94,2314.00,0.00
2024-12-08 17:10:46,101,2106,49,52,1164.30,2314.01,0.00
2024-12-08 17:10:46,100,2106,49,51,1174.11,2314.08,0.00
2024-12-08 17:10:46,99,2106,48,51,1182.95,2314.08,0.00
2024-12-08 17:10:46,98,2106,48,50,1193.60,2314.12,0.00
2024-12-08 17:10:46,98,2107,48,50,1192.67,2315.00,0.00
2024-12-08 17:10:46,99,2107,48,51,1180.63,2315.01,0.00
2024-12-08 17:10:46,98,2107,47,51,1191.04,2315.07,0.00
2024-12-08 17:10:46,97,2107,46,51,1203.08,2315.07,0.00
2024-12-08 17:10:46,96,2107,45,51,1209.59,2315.12,0.00
2024-12-08 17:10:46,95,2107,44,51,1207.76,2315.76,0.00
2024-12-08 17:10:46,95,2108,44,51,1226.72,2316.00,0.00
2024-12-08 17:10:46,96,2108,44,52,1213.94,2316.01,0.00
2024-12-08 17:10:46,95,2108,43,52,1224.82,2316.05,0.00
2024-12-08 17:10:46,94,2108,43,51,1231.70,2316.10,0.00
2024-12-08 17:10:46,95,2107,43,52,1208.66,2316.56,0.00
2024-12-08 17:10:46,95,2108,43,52,1232.40,2317.00,0.00
2024-12-08 17:10:46,96,2108,43,53,1219.56,2317.01,0.00
2024-12-08 17:10:46,95,2108,42,53,1229.75,2317.11,0.00
2024-12-08 17:10:46,95,2109,42,53,1253.43,2318.00,0.00
2024-12-08 17:10:46,96,2109,42,54,1240.37,2318.01,0.00
2024-12-08 17:10:46,95,2109,41,54,1251.50,2318.10,0.00
2024-12-08 17:10:46,94,2109,41,53,1264.32,2318.10,0.00
2024-12-08 17:10:46,95,2108,42,53,1250.29,2318.15,0.00
2024-12-08 17:10:46,95,2109,42,53,1273.74,2319.00,0.00
2024-12-08 17:10:46,96,2109,43,53,1260.47,2319.01,0.00
2024-12-08 17:10:46,96,2110,43,53,1276.72,2320.00,0.00
2024-12-08 17:10:46,97,2110,44,53,1263.56,2320.01,0.00
2024-12-08 17:10:46,96,2110,44,52,1274.57,2320.09,0.00
2024-12-08 17:10:46,95,2110,43,52,1287.75,2320.10,0.00
2024-12-08 17:10:46,94,2110,42,52,1291.40,2320.31,0.00
2024-12-08 17:10:46,94,2111,42,52,1295.56,2321.00,0.00
2024-12-08 17:10:46,95,2111,43,52,1281.92,2321.01,0.00
2024-12-08 17:10:46,94,2111,42,52,1294.10,2321.06,0.00
2024-12-08 17:10:46,93,2111,42,51,1306.29,2321.11,0.00
2024-12-08 17:10:46,94,2110,42,52,1273.60,2321.96,0.00
2024-12-08 17:10:46,94,2111,42,52,1293.16,2322.00,0.00
2024-12-08 17:10:46,95,2111,42,53,1279.54,2322.01,0.00
2024-12-08 17:10:46,95,2112,42,53,1296.23,2323.00,0.00
2024-12-08 17:10:46,96,2112,43,53,1282.73,2323.01,0.00
2024-12-08 17:10:46,97,2111,43,54,1266.68,2323.16,0.00
2024-12-08 17:10:46,97,2112,43,54,1285.63,2324.00,0.00
2024-12-08 17:10:46,98,2112,43,55,1272.51,2324.01,0.00
2024-12-08 17:10:46,97,2112,42,55,1269.05,2324.52,0.00
2024-12-08 17:10:46,97,2113,42,55,1301.28,2325.00,0.00
2024-12-08 17:10:46,98,2113,43,55,1288.00,2325.01,0.00
2024-12-08 17:10:46,98,2114,43,55,1279.77,2326.00,0.00
2024-12-08 17:10:46,99,2114,44,55,1266.85,2326.01,0.00
2024-12-08 17:10:46,100,2113,44,56,1251.66,2326.14,0.00
2024-12-08 17:10:46,101,2112,45,56,1237.56,2326.85,0.00
2024-12-08 17:10:46,101,2113,45,56,1255.20,2327.00,0.00
2024-12-08 17:10:46,102,2113,45,57,1242.89,2327.01,0.00
2024-12-08 17:10:46,101,2113,44,57,1253.83,2327.06,0.00
2024-12-08 17:10:46,100,2113,44,56,1260.58,2327.12,0.00
2024-12-08 17:10:46,99,2113,43,56,1264.76,2327.50,0.00
2024-12-08 17:10:46,99,2114,43,56,1319.20,2328.00,0.00
2024-12-08 17:10:46,100,2114,43,57,1306.01,2328.01,0.00
2024-12-08 17:10:46,99,2114,42,57,1317.81,2328.06,0.00
2024-12-08 17:10:46,98,2114,41,57,1324.87,2328.12,0.00
2024-12-08 17:10:46,98,2115,41,57,1323.96,2329.00,0.00
2024-12-08 17:10:46,99,2115,42,57,1310.59,2329.01,0.00
2024-12-08 17:10:46,100,2114,43,57,1297.25,2329.04,0.00
2024-12-08 17:10:46,99,2114,42,57,1313.45,2329.09,0.00
2024-12-08 17:10:46,98,2114,41,57,1325.92,2329.12,0.00
2024-12-08 17:10:46,97,2114,41,56,1339.11,2329.12,0.00
2024-12-08 17:10:46,98,2113,41,57,1309.65,2329.84,0.00
2024-12-08 17:10:46,98,2114,41,57,1331.43,2330.00,0.00
2024-12-08 17:10:46,99,2114,41,58,1317.98,2330.01,0.00
2024-12-08 17:10:47,99,2115,41,58,1356.69,2331.00,0.00
2024-12-08 17:10:47,100,2115,41,59,1343.12,2331.01,0.00
2024-12-08 17:10:47,99,2115,41,58,1349.44,2331.11,0.00
2024-12-08 17:10:47,99,2116,41,58,1348.08,2332.00,0.00
2024-12-08 17:10:47,100,2116,41,59,1334.60,2332.01,0.00
2024-12-08 17:10:47,99,2116,41,58,1345.07,2332.12,0.00
2024-12-08 17:10:47,99,2117,41,58,1343.95,2333.00,0.00
2024-12-08 17:10:47,100,2117,42,58,1330.51,2333.01,0.00
2024-12-08 17:10:47,101,2116,42,59,1302.26,2333.49,0.00
2024-12-08 17:10:47,101,2117,42,59,1318.59,2334.00,0.00
2024-12-08 17:10:47,102,2117,42,60,1305.67,2334.01,0.00
2024-12-08 17:10:47,101,2117,42,59,1315.17,2334.13,0.00
2024-12-08 17:10:47,101,2118,42,59,1336.96,2335.00,0.00
2024-12-08 17:10:47,102,2118,43,59,1323.85,2335.01,0.00
2024-12-08 17:10:47,101,2118,42,59,1334.46,2335.12,0.00
2024-12-08 17:10:47,101,2119,42,59,1328.28,2336.00,0.00
2024-12-08 17:10:47,102,2119,42,60,1315.26,2336.01,0.00
2024-12-08 17:10:47,101,2119,42,59,1325.09,2336.13,0.00
2024-12-08 17:10:47,101,2120,42,59,1323.76,2337.00,0.00
2024-12-08 17:10:47,102,2120,42,60,1310.78,2337.01,0.00
2024-12-08 17:10:47,102,2121,42,60,1301.95,2338.00,0.00
2024-12-08 17:10:47,103,2121,42,61,1289.30,2338.01,0.00
2024-12-08 17:10:47,102,2121,42,60,1299.01,2338.13,0.00
2024-12-08 17:10:47,101,2121,41,60,1307.53,2338.31,0.00
2024-12-08 17:10:47,101,2122,41,60,1310.30,2339.00,0.00
2024-12-08 17:10:47,102,2122,42,60,1297.46,2339.01,0.00
2024-12-08 17:10:47,101,2122,41,60,1308.93,2339.05,0.00
2024-12-08 17:10:47,101,2123,41,60,1305.77,2340.00,0.00
2024-12-08 17:10:47,102,2123,41,61,1292.96,2340.01,0.00
2024-12-08 17:10:47,102,2124,41,61,1284.11,2341.00,0.00
2024-12-08 17:10:47,103,2124,41,62,1271.64,2341.01,0.00
2024-12-08 17:10:47,102,2124,41,61,1282.97,2341.05,0.00
2024-12-08 17:10:47,101,2124,41,60,1291.30,2341.12,0.00
2024-12-08 17:10:47,101,2125,41,60,1289.72,2342.00,0.00
2024-12-08 17:10:47,102,2125,41,61,1277.08,2342.01,0.00
2024-12-08 17:10:47,101,2125,40,61,1287.21,2342.12,0.00
2024-12-08 17:10:47,100,2125,40,60,1295.17,2342.12,0.00
2024-12-08 17:10:47,99,2125,39,60,1289.63,2342.73,0.00
2024-12-08 17:10:47,99,2126,39,60,1306.74,2343.00,0.00
2024-12-08 17:10:47,100,2126,40,60,1293.67,2343.01,0.00
2024-12-08 17:10:47,99,2126,39,60,1306.50,2343.01,0.00
2024-12-08 17:10:47,100,2125,40,60,1293.44,2343.03,0.00
2024-12-08 17:10:47,99,2125,39,60,1309.35,2343.03,0.00
2024-12-08 17:10:47,98,2125,38,60,1320.59,2343.11,0.00
2024-12-08 17:10:47,97,2125,37,60,1321.21,2343.27,0.00
2024-12-08 17:10:47,97,2126,37,60,1327.65,2344.00,0.00
2024-12-08 17:10:47,98,2126,37,61,1314.10,2344.01,0.00
2024-12-08 17:10:47,97,2126,37,60,1324.79,2344.11,0.00
2024-12-08 17:10:47,97,2127,37,60,1346.58,2345.00,0.00
2024-12-08 17:10:47,98,2127,37,61,1332.84,2345.01,0.00
2024-12-08 17:10:47,99,2126,37,62,1306.62,2345.37,0.00
2024-12-08 17:10:47,99,2127,37,62,1323.06,2346.00,0.00
2024-12-08 17:10:47,100,2127,37,63,1309.83,2346.01,0.00
2024-12-08 17:10:47,101,2126,38,63,1295.96,2346.07,0.00
2024-12-08 17:10:47,100,2126,38,62,1311.75,2346.12,0.00
2024-12-08 17:10:48,100,2127,38,62,1331.76,2347.00,0.00
2024-12-08 17:10:48,101,2127,38,63,1318.57,2347.01,0.00
2024-12-08 17:10:48,100,2127,37,63,1330.39,2347.06,0.00
2024-12-08 17:10:48,100,2128,37,63,1343.98,2348.00,0.00
2024-12-08 17:10:48,101,2128,37,64,1330.67,2348.01,0.00
2024-12-08 17:10:48,100,2128,37,63,1341.67,2348.10,0.00
2024-12-08 17:10:48,100,2129,37,63,1336.72,2349.00,0.00
2024-12-08 17:10:48,101,2129,38,63,1323.49,2349.01,0.00
2024-12-08 17:10:48,100,2129,38,62,1329.71,2349.10,0.00
2024-12-08 17:10:48,100,2130,38,62,1324.55,2350.00,0.00
2024-12-08 17:10:48,101,2130,39,62,1311.44,2350.01,0.00
2024-12-08 17:10:48,100,2130,39,61,1317.54,2350.10,0.00
2024-12-08 17:10:48,100,2131,39,61,1312.25,2351.00,0.00
2024-12-08 17:10:48,101,2131,39,62,1299.25,2351.01,0.00
2024-12-08 17:10:48,100,2131,39,61,1283.53,2351.75,0.00
2024-12-08 17:10:48,100,2132,39,61,1301.36,2352.00,0.00
2024-12-08 17:10:48,101,2132,40,61,1288.48,2352.01,0.00
2024-12-08 17:10:48,100,2132,40,60,1298.81,2352.11,0.00
2024-12-08 17:10:48,99,2132,39,60,1306.07,2352.31,0.00
2024-12-08 17:10:48,99,2133,39,60,1314.11,2353.00,0.00
2024-12-08 17:10:48,100,2133,39,61,1300.97,2353.01,0.00
2024-12-08 17:10:48,99,2133,39,60,1312.72,2353.06,0.00
2024-12-08 17:10:48,100,2132,39,61,1270.85,2353.92,0.00
2024-12-08 17:10:48,100,2133,39,61,1294.23,2354.00,0.00
2024-12-08 17:10:48,101,2133,40,61,1281.41,2354.01,0.00
2024-12-08 17:10:48,102,2132,41,61,1268.40,2354.05,0.00
2024-12-08 17:10:48,101,2132,41,60,1287.28,2354.12,0.00
2024-12-08 17:10:48,100,2132,40,60,1292.20,2354.27,0.00
2024-12-08 17:10:48,101,2131,41,60,1277.12,2354.39,0.00
2024-12-08 17:10:48,102,2130,41,61,1264.90,2354.88,0.00
2024-12-08 17:10:48,102,2131,41,61,1310.49,2355.00,0.00
2024-12-08 17:10:48,103,2131,41,62,1297.76,2355.01,0.00
2024-12-08 17:10:48,104,2130,41,63,1285.29,2355.03,0.00
2024-12-08 17:10:48,103,2130,41,62,1293.46,2355.12,0.00
2024-12-08 17:10:48,104,2129,42,62,1261.44,2355.79,0.00
2024-12-08 17:10:48,104,2130,42,62,1359.68,2356.00,0.00
2024-12-08 17:10:48,105,2130,43,62,1346.73,2356.01,0.00
2024-12-08 17:10:48,104,2130,42,62,1358.36,2356.06,0.00
2024-12-08 17:10:48,104,2131,42,62,1395.62,2357.00,0.00
2024-12-08 17:10:48,105,2131,43,62,1382.32,2357.01,0.00
2024-12-08 17:10:48,104,2131,43,61,1390.67,2357.08,0.00
2024-12-08 17:10:48,104,2132,43,61,1387.59,2358.00,0.00
2024-12-08 17:10:48,105,2132,43,62,1374.38,2358.01,0.00
2024-12-08 17:10:48,104,2132,43,61,1382.41,2358.08,0.00
2024-12-08 17:10:48,104,2133,43,61,1379.33,2359.00,0.00
2024-12-08 17:10:48,105,2133,44,61,1366.20,2359.01,0.00
2024-12-08 17:10:48,104,2133,43,61,1378.01,2359.06,0.00
2024-12-08 17:10:48,104,2134,43,61,1369.93,2360.00,0.00
2024-12-08 17:10:48,105,2134,43,62,1356.89,2360.01,0.00
2024-12-08 17:10:48,104,2134,43,61,1364.52,2360.08,0.00
2024-12-08 17:10:48,103,2134,42,61,1377.77,2360.08,0.00
2024-12-08 17:10:48,103,2135,42,61,1374.88,2361.00,0.00
2024-12-08 17:10:48,104,2135,42,62,1361.66,2361.01,0.00
2024-12-08 17:10:48,103,2135,42,61,1364.14,2361.08,0.00
2024-12-08 17:10:48,102,2135,41,61,1368.42,2361.47,0.00
2024-12-08 17:10:48,103,2134,42,61,1353.56,2361.55,0.00
2024-12-08 17:10:48,103,2135,42,61,1374.09,2362.00,0.00
2024-12-08 17:10:48,104,2135,42,62,1360.88,2362.01,0.00
2024-12-08 17:10:48,103,2135,41,62,1351.45,2362.65,0.00
2024-12-08 17:10:48,103,2136,41,62,1389.35,2363.00,0.00
2024-12-08 17:10:48,104,2136,42,62,1375.99,2363.01,0.00
2024-12-08 17:10:48,103,2136,42,61,1387.32,2363.09,0.00
2024-12-08 17:10:48,104,2135,42,62,1371.52,2363.21,0.00
2024-12-08 17:10:49,104,2136,42,62,1390.67,2364.00,0.00
2024-12-08 17:10:49,105,2136,42,63,1377.42,2364.01,0.00
2024-12-08 17:10:49,104,2136,41,63,1389.33,2364.06,0.00
2024-12-08 17:10:49,103,2136,40,63,1378.80,2364.70,0.00
2024-12-08 17:10:49,103,2137,40,63,1417.85,2365.00,0.00
2024-12-08 17:10:49,104,2137,40,64,1404.22,2365.01,0.00
2024-12-08 17:10:49,103,2137,40,63,1416.64,2365.06,0.00
2024-12-08 17:10:49,102,2137,40,62,1430.07,2365.07,0.00
2024-12-08 17:10:49,102,2138,40,62,1427.16,2366.00,0.00
2024-12-08 17:10:49,103,2138,40,63,1413.31,2366.01,0.00
2024-12-08 17:10:49,102,2138,39,63,1411.59,2366.48,0.00
2024-12-08 17:10:49,102,2139,39,63,1418.25,2367.00,0.00
2024-12-08 17:10:49,103,2139,39,64,1404.48,2367.01,0.00
2024-12-08 17:10:49,102,2139,39,63,1416.66,2367.07,0.00
2024-12-08 17:10:49,102,2140,39,63,1413.74,2368.00,0.00
2024-12-08 17:10:49,103,2140,39,64,1400.02,2368.01,0.00
2024-12-08 17:10:49,102,2140,39,63,1407.51,2368.07,0.00
2024-12-08 17:10:49,103,2139,40,63,1383.45,2368.53,0.00
2024-12-08 17:10:49,103,2140,40,63,1399.92,2369.00,0.00
2024-12-08 17:10:49,104,2140,41,63,1386.46,2369.01,0.00
2024-12-08 17:10:49,103,2140,40,63,1397.88,2369.08,0.00
2024-12-08 17:10:49,103,2141,40,63,1418.00,2370.00,0.00
2024-12-08 17:10:49,104,2141,41,63,1404.36,2370.01,0.00
2024-12-08 17:10:49,103,2141,41,62,1415.96,2370.08,0.00
2024-12-08 17:10:49,102,2141,40,62,1420.25,2370.49,0.00
2024-12-08 17:10:49,102,2142,40,62,1427.16,2371.00,0.00
2024-12-08 17:10:49,103,2142,41,62,1413.30,2371.01,0.00
2024-12-08 17:10:49,102,2142,40,62,1426.70,2371.02,0.00
2024-12-08 17:10:49,103,2141,40,63,1394.48,2371.63,0.00
2024-12-08 17:10:49,103,2142,40,63,1415.28,2372.00,0.00
2024-12-08 17:10:49,104,2142,41,63,1401.67,2372.01,0.00
2024-12-08 17:10:49,104,2143,41,63,1415.27,2373.00,0.00
2024-12-08 17:10:49,105,2143,42,63,1401.79,2373.01,0.00
2024-12-08 17:10:49,104,2143,42,62,1409.14,2373.07,0.00
2024-12-08 17:10:49,104,2144,42,62,1405.82,2374.00,0.00
2024-12-08 17:10:49,105,2144,43,62,1392.43,2374.01,0.00
2024-12-08 17:10:49,104,2144,43,61,1400.14,2374.07,0.00
2024-12-08 17:10:49,103,2144,42,61,1405.27,2374.25,0.00
2024-12-08 17:10:49,103,2145,42,61,1411.07,2375.00,0.00
2024-12-08 17:10:49,104,2145,43,61,1397.51,2375.01,0.00
2024-12-08 17:10:49,103,2145,43,60,1408.33,2375.05,0.00
2024-12-08 17:10:49,102,2145,42,60,1421.45,2375.07,0.00
2024-12-08 17:10:49,102,2146,42,60,1418.45,2376.00,0.00
2024-12-08 17:10:49,103,2146,42,61,1404.67,2376.01,0.00
2024-12-08 17:10:49,102,2146,41,61,1407.93,2376.16,0.00
2024-12-08 17:10:49,102,2147,41,61,1411.73,2377.00,0.00
2024-12-08 17:10:49,103,2147,42,61,1398.02,2377.01,0.00
2024-12-08 17:10:49,102,2147,42,60,1410.13,2377.07,0.00
2024-12-08 17:10:49,102,2148,42,60,1402.20,2378.00,0.00
2024-12-08 17:10:49,103,2148,43,60,1388.59,2378.01,0.00
2024-12-08 17:10:49,102,2148,43,59,1400.14,2378.08,0.00
2024-12-08 17:10:49,102,2149,43,59,1396.88,2379.00,0.00
2024-12-08 17:10:49,103,2149,43,60,1383.32,2379.01,0.00
2024-12-08 17:10:49,102,2149,42,60,1384.63,2379.29,0.00
2024-12-08 17:10:49,102,2150,42,60,1391.64,2380.00,0.00
2024-12-08 17:10:49,103,2150,42,61,1378.13,2380.01,0.00
2024-12-08 17:10:49,102,2150,42,60,1389.82,2380.08,0.00
2024-12-08 17:10:49,101,2150,42,59,1399.67,2380.09,0.00
2024-12-08 17:10:49,100,2150,41,59,1412.24,2380.10,0.00
2024-12-08 17:10:50,100,2151,41,59,1415.17,2381.00,0.00
2024-12-08 17:10:50,101,2151,42,59,1401.16,2381.01,0.00
2024-12-08 17:10:50,102,2150,43,59,1366.99,2381.71,0.00
2024-12-08 17:10:50,102,2151,43,59,1383.81,2382.00,0.00
2024-12-08 17:10:50,103,2151,43,60,1370.37,2382.01,0.00
2024-12-08 17:10:50,102,2151,43,59,1381.51,2382.09,0.00
2024-12-08 17:10:50,102,2152,43,59,1401.60,2383.00,0.00
2024-12-08 17:10:50,103,2152,44,59,1387.99,2383.01,0.00
2024-12-08 17:10:50,104,2151,44,60,1345.77,2383.88,0.00
2024-12-08 17:10:50,104,2152,44,60,1381.60,2384.00,0.00
2024-12-08 17:10:50,105,2152,44,61,1368.44,2384.01,0.00
2024-12-08 17:10:50,104,2152,43,61,1370.91,2384.27,0.00
2024-12-08 17:10:50,104,2153,43,61,1395.10,2385.00,0.00
2024-12-08 17:10:50,105,2153,44,61,1381.81,2385.01,0.00
2024-12-08 17:10:50,106,2152,44,62,1368.77,2385.03,0.00
2024-12-08 17:10:50,107,2151,44,63,1350.31,2385.37,0.00
2024-12-08 17:10:50,107,2152,44,63,1365.47,2386.00,0.00
2024-12-08 17:10:50,108,2152,45,63,1352.83,2386.01,0.00
2024-12-08 17:10:50,107,2152,45,62,1361.72,2386.08,0.00
2024-12-08 17:10:50,106,2152,44,62,1360.39,2386.60,0.00
2024-12-08 17:10:50,106,2153,44,62,1418.79,2387.00,0.00
2024-12-08 17:10:50,107,2153,44,63,1405.53,2387.01,0.00
2024-12-08 17:10:50,106,2153,44,62,1411.84,2387.10,0.00
2024-12-08 17:10:50,106,2154,44,62,1409.02,2388.00,0.00
2024-12-08 17:10:50,107,2154,44,63,1395.85,2388.01,0.00
2024-12-08 17:10:50,106,2154,43,63,1407.03,2388.09,0.00
2024-12-08 17:10:50,105,2154,43,62,1415.88,2388.10,0.00
2024-12-08 17:10:50,105,2155,43,62,1413.02,2389.00,0.00
2024-12-08 17:10:50,106,2155,44,62,1399.69,2389.01,0.00
2024-12-08 17:10:50,105,2155,43,62,1412.00,2389.05,0.00
2024-12-08 17:10:50,104,2155,43,61,1420.07,2389.09,0.00
2024-12-08 17:10:50,105,2154,44,61,1398.94,2389.43,0.00
2024-12-08 17:10:50,104,2154,43,61,1413.15,2389.53,0.00
2024-12-08 17:10:50,104,2155,43,61,1425.23,2390.00,0.00
2024-12-08 17:10:50,105,2155,44,61,1411.65,2390.01,0.00
2024-12-08 17:10:50,104,2155,44,60,1418.37,2390.10,0.00
2024-12-08 17:10:50,104,2156,44,60,1438.70,2391.00,0.00
2024-12-08 17:10:50,105,2156,45,60,1425.00,2391.01,0.00
2024-12-08 17:10:50,105,2157,45,60,1415.57,2392.00,0.00
2024-12-08 17:10:50,106,2157,46,60,1402.21,2392.01,0.00
2024-12-08 17:10:50,105,2157,46,59,1413.33,2392.10,0.00
2024-12-08 17:10:50,105,2158,46,59,1410.46,2393.00,0.00
2024-12-08 17:10:50,106,2158,47,59,1397.16,2393.01,0.00
2024-12-08 17:10:50,106,2159,47,59,1387.58,2394.00,0.00
2024-12-08 17:10:50,107,2159,48,59,1374.61,2394.01,0.00
2024-12-08 17:10:50,106,2159,47,59,1385.58,2394.09,0.00
2024-12-08 17:10:50,105,2159,47,58,1395.81,2394.10,0.00
2024-12-08 17:10:50,105,2160,47,58,1392.94,2395.00,0.00
2024-12-08 17:10:50,106,2160,47,59,1379.80,2395.01,0.00
2024-12-08 17:10:50,105,2160,47,58,1386.13,2395.10,0.00
2024-12-08 17:10:50,104,2160,46,58,1394.19,2395.20,0.00
2024-12-08 17:10:50,104,2161,46,58,1398.63,2396.00,0.00
2024-12-08 17:10:50,105,2161,46,59,1385.31,2396.01,0.00
2024-12-08 17:10:50,104,2161,46,58,1391.75,2396.10,0.00
2024-12-08 17:10:50,104,2162,46,58,1389.07,2397.00,0.00
2024-12-08 17:10:50,105,2162,47,58,1375.84,2397.01,0.00
2024-12-08 17:10:50,104,2162,47,57,1382.42,2397.10,0.00
2024-12-08 17:10:50,104,2163,47,57,1379.73,2398.00,0.00
2024-12-08 17:10:50,105,2163,47,58,1366.59,2398.01,0.00
2024-12-08 17:10:50,104,2163,47,57,1372.62,2398.11,0.00
2024-12-08 17:10:51,103,2163,46,57,1371.46,2398.52,0.00
2024-12-08 17:10:51,103,2164,46,57,1383.69,2399.00,0.00
2024-12-08 17:10:51,104,2164,47,57,1370.39,2399.01,0.00
2024-12-08 17:10:51,103,2164,47,56,1381.63,2399.07,0.00
2024-12-08 17:10:51,104,2163,47,57,1355.10,2399.45,0.00
2024-12-08 17:10:51,104,2164,47,57,1375.81,2400.00,0.00
2024-12-08 17:10:51,105,2164,47,58,1362.70,2400.01,0.00
2024-12-08 17:10:51,104,2164,47,57,1372.84,2400.07,0.00
2024-12-08 17:10:51,105,2163,48,57,1336.86,2400.87,0.00
2024-12-08 17:10:51,105,2164,48,57,1382.25,2401.00,0.00
2024-12-08 17:10:51,106,2164,48,58,1369.21,2401.01,0.00
2024-12-08 17:10:51,106,2165,48,58,1382.24,2402.00,0.00
2024-12-08 17:10:51,107,2165,49,58,1369.33,2402.01,0.00
2024-12-08 17:10:51,106,2165,49,57,1379.78,2402.10,0.00
2024-12-08 17:10:51,105,2165,48,57,1387.93,2402.20,0.00
2024-12-08 17:10:51,105,2166,48,57,1392.10,2403.00,0.00
2024-12-08 17:10:51,106,2166,49,57,1378.97,2403.01,0.00
2024-12-08 17:10:51,105,2166,49,56,1385.04,2403.11,0.00
2024-12-08 17:10:51,104,2166,48,56,1397.20,2403.12,0.00
2024-12-08 17:10:51,104,2167,48,56,1399.60,2404.00,0.00
2024-12-08 17:10:51,105,2167,48,57,1386.27,2404.01,0.00
2024-12-08 17:10:51,104,2167,47,57,1398.92,2404.03,0.00
2024-12-08 17:10:51,103,2167,47,56,1405.98,2404.10,0.00
2024-12-08 17:10:51,103,2168,47,56,1403.50,2405.00,0.00
2024-12-08 17:10:51,104,2168,47,57,1390.00,2405.01,0.00
2024-12-08 17:10:51,104,2169,47,57,1380.63,2406.00,0.00
2024-12-08 17:10:51,105,2169,48,57,1367.48,2406.01,0.00
2024-12-08 17:10:51,106,2168,49,57,1354.14,2406.05,0.00
2024-12-08 17:10:51,105,2168,48,57,1369.66,2406.31,0.00
2024-12-08 17:10:51,105,2169,48,57,1376.31,2407.00,0.00
2024-12-08 17:10:51,106,2169,48,58,1363.32,2407.01,0.00
2024-12-08 17:10:51,107,2168,48,59,1350.36,2407.04,0.00
2024-12-08 17:10:51,106,2168,48,58,1368.36,2407.11,0.00
2024-12-08 17:10:51,106,2169,48,58,1388.42,2408.00,0.00
2024-12-08 17:10:51,107,2169,49,58,1375.45,2408.01,0.00
2024-12-08 17:10:51,106,2169,49,57,1383.24,2408.09,0.00
2024-12-08 17:10:51,106,2170,49,57,1402.86,2409.00,0.00
2024-12-08 17:10:51,107,2170,50,57,1389.75,2409.01,0.00
2024-12-08 17:10:51,108,2169,51,57,1376.24,2409.06,0.00
2024-12-08 17:10:51,107,2169,50,57,1402.85,2409.07,0.00
2024-12-08 17:10:51,106,2169,50,56,1410.86,2409.09,0.00
2024-12-08 17:10:51,106,2170,50,56,1407.76,2410.00,0.00
2024-12-08 17:10:51,107,2170,51,56,1394.61,2410.01,0.00
2024-12-08 17:10:51,106,2170,51,55,1400.99,2410.09,0.00
2024-12-08 17:10:51,105,2170,50,55,1410.27,2410.27,0.00
2024-12-08 17:10:51,105,2171,50,55,1434.39,2411.00,0.00
2024-12-08 17:10:51,106,2171,50,56,1420.86,2411.01,0.00
2024-12-08 17:10:51,105,2171,50,55,1428.92,2411.06,0.00
2024-12-08 17:10:51,106,2170,51,55,1401.60,2411.66,0.00
2024-12-08 17:10:51,106,2171,51,55,1418.04,2412.00,0.00
2024-12-08 17:10:51,107,2171,52,55,1404.78,2412.01,0.00
2024-12-08 17:10:51,107,2172,52,55,1417.54,2413.00,0.00
2024-12-08 17:10:51,108,2172,53,55,1404.42,2413.01,0.00
2024-12-08 17:10:51,109,2171,53,56,1391.53,2413.03,0.00
2024-12-08 17:10:51,108,2171,53,55,1407.36,2413.07,0.00
2024-12-08 17:10:51,108,2172,53,55,1403.43,2414.00,0.00
2024-12-08 17:10:51,109,2172,53,56,1390.56,2414.01,0.00
2024-12-08 17:10:51,109,2173,53,56,1402.66,2415.00,0.00
2024-12-08 17:10:51,110,2173,53,57,1389.90,2415.01,0.00
2024-12-08 17:10:52,110,2174,53,57,1379.72,2416.00,0.00
2024-12-08 17:10:52,111,2174,53,58,1367.29,2416.01,0.00
2024-12-08 17:10:52,110,2174,53,57,1376.03,2416.07,0.00
2024-12-08 17:10:52,110,2175,53,57,1371.72,2417.00,0.00
2024-12-08 17:10:52,111,2175,53,58,1359.36,2417.01,0.00
2024-12-08 17:10:52,110,2175,53,57,1366.71,2417.07,0.00
2024-12-08 17:10:52,109,2175,52,57,1373.56,2417.31,0.00
2024-12-08 17:10:52,109,2176,52,57,1375.12,2418.00,0.00
2024-12-08 17:10:52,110,2176,53,57,1362.62,2418.01,0.00
2024-12-08 17:10:52,109,2176,52,57,1373.82,2418.06,0.00
2024-12-08 17:10:52,108,2176,52,56,1382.74,2418.07,0.00
2024-12-08 17:10:52,108,2177,52,56,1378.57,2419.00,0.00
2024-12-08 17:10:52,109,2177,52,57,1365.92,2419.01,0.00
2024-12-08 17:10:52,108,2177,52,56,1373.68,2419.07,0.00
2024-12-08 17:10:52,108,2178,52,56,1369.50,2420.00,0.00
2024-12-08 17:10:52,109,2178,52,57,1356.94,2420.01,0.00
2024-12-08 17:10:52,108,2178,52,56,1364.39,2420.07,0.00
2024-12-08 17:10:52,107,2178,51,56,1371.78,2420.29,0.00
2024-12-08 17:10:52,107,2179,51,56,1373.14,2421.00,0.00
2024-12-08 17:10:52,108,2179,51,57,1360.43,2421.01,0.00
2024-12-08 17:10:52,107,2179,51,56,1367.98,2421.07,0.00
2024-12-08 17:10:52,106,2179,50,56,1364.70,2421.65,0.00
2024-12-08 17:10:52,106,2180,50,56,1379.36,2422.00,0.00
2024-12-08 17:10:52,107,2180,51,56,1366.47,2422.01,0.00
2024-12-08 17:10:52,106,2180,51,55,1374.14,2422.07,0.00
2024-12-08 17:10:52,105,2180,50,55,1364.84,2422.91,0.00
2024-12-08 17:10:52,105,2181,50,55,1385.69,2423.00,0.00
2024-12-08 17:10:52,106,2181,51,55,1372.61,2423.01,0.00
2024-12-08 17:10:52,105,2181,51,54,1379.96,2423.08,0.00
2024-12-08 17:10:52,105,2182,51,54,1376.56,2424.00,0.00
2024-12-08 17:10:52,106,2182,51,55,1363.58,2424.01,0.00
2024-12-08 17:10:52,105,2182,51,54,1370.83,2424.08,0.00
2024-12-08 17:10:52,105,2183,51,54,1367.43,2425.00,0.00
2024-12-08 17:10:52,106,2183,52,54,1354.53,2425.01,0.00
2024-12-08 17:10:52,106,2184,52,54,1344.79,2426.00,0.00
2024-12-08 17:10:52,107,2184,53,54,1332.22,2426.01,0.00
2024-12-08 17:10:52,106,2184,53,53,1340.72,2426.09,0.00
2024-12-08 17:10:52,107,2183,54,53,1313.49,2426.73,0.00
2024-12-08 17:10:52,107,2184,54,53,1330.95,2427.00,0.00
2024-12-08 17:10:52,108,2184,55,53,1318.63,2427.01,0.00
2024-12-08 17:10:52,107,2184,55,52,1324.65,2427.09,0.00
2024-12-08 17:10:52,106,2184,54,52,1328.95,2427.27,0.00
2024-12-08 17:10:52,106,2185,54,52,1357.58,2428.00,0.00
2024-12-08 17:10:52,107,2185,54,53,1344.89,2428.01,0.00
2024-12-08 17:10:52,107,2186,54,53,1335.00,2429.00,0.00
2024-12-08 17:10:52,108,2186,54,54,1322.64,2429.01,0.00
2024-12-08 17:10:52,107,2186,54,53,1327.32,2429.09,0.00
2024-12-08 17:10:52,107,2187,54,53,1328.51,2430.00,0.00
2024-12-08 17:10:52,108,2187,55,53,1316.21,2430.01,0.00
2024-12-08 17:10:52,107,2187,55,52,1322.65,2430.09,0.00
2024-12-08 17:10:52,106,2187,54,52,1334.44,2430.11,0.00
2024-12-08 17:10:52,107,2186,55,52,1306.16,2430.79,0.00
2024-12-08 17:10:52,107,2187,55,52,1324.06,2431.00,0.00
2024-12-08 17:10:52,108,2187,55,53,1311.80,2431.01,0.00
2024-12-08 17:10:52,109,2186,55,54,1297.35,2431.13,0.00
2024-12-08 17:10:52,109,2187,55,54,1334.44,2432.00,0.00
2024-12-08 17:10:52,110,2187,55,55,1322.31,2432.01,0.00
2024-12-08 17:10:53,110,2188,55,55,1334.13,2433.00,0.00
2024-12-08 17:10:53,111,2188,55,56,1322.11,2433.01,0.00
2024-12-08 17:10:53,112,2187,56,56,1294.83,2433.49,0.00
2024-12-08 17:10:53,111,2187,55,56,1312.22,2433.53,0.00
2024-12-08 17:10:53,111,2188,55,56,1323.09,2434.00,0.00
2024-12-08 17:10:53,112,2188,56,56,1311.28,2434.01,0.00
2024-12-08 17:10:53,111,2188,56,55,1316.12,2434.12,0.00
2024-12-08 17:10:53,110,2188,55,55,1327.65,2434.13,0.00
2024-12-08 17:10:53,109,2188,54,55,1334.53,2434.34,0.00
2024-12-08 17:10:53,109,2189,54,55,1358.84,2435.00,0.00
2024-12-08 17:10:53,110,2189,54,56,1346.49,2435.01,0.00
2024-12-08 17:10:53,109,2189,53,56,1345.94,2435.17,0.00
2024-12-08 17:10:53,109,2190,53,56,1348.45,2436.00,0.00
2024-12-08 17:10:53,110,2190,53,57,1336.19,2436.01,0.00
2024-12-08 17:10:53,109,2190,52,57,1344.67,2436.04,0.00
2024-12-08 17:10:53,109,2191,52,57,1339.34,2437.00,0.00
2024-12-08 17:10:53,110,2191,53,57,1327.16,2437.01,0.00
2024-12-08 17:10:53,110,2192,53,57,1316.23,2438.00,0.00
2024-12-08 17:10:53,111,2192,53,58,1304.37,2438.01,0.00
2024-12-08 17:10:53,110,2192,53,57,1312.51,2438.11,0.00
2024-12-08 17:10:53,110,2193,53,57,1309.02,2439.00,0.00
2024-12-08 17:10:53,111,2193,53,58,1297.23,2439.01,0.00
2024-12-08 17:10:53,110,2193,53,57,1302.11,2439.12,0.00
2024-12-08 17:10:53,110,2194,53,57,1298.84,2440.00,0.00
2024-12-08 17:10:53,111,2194,54,57,1287.14,2440.01,0.00
2024-12-08 17:10:53,110,2194,54,56,1292.13,2440.12,0.00
2024-12-08 17:10:53,110,2195,54,56,1288.85,2441.00,0.00
2024-12-08 17:10:53,111,2195,55,56,1277.24,2441.01,0.00
2024-12-08 17:10:53,110,2195,55,55,1287.03,2441.08,0.00
2024-12-08 17:10:53,109,2195,55,54,1298.61,2441.08,0.00
2024-12-08 17:10:53,110,2194,55,55,1275.01,2441.59,0.00
2024-12-08 17:10:53,110,2195,55,55,1294.69,2442.00,0.00
2024-12-08 17:10:53,111,2195,55,56,1283.03,2442.01,0.00
2024-12-08 17:10:53,110,2195,55,55,1288.72,2442.06,0.00
2024-12-08 17:10:53,111,2194,56,55,1267.92,2442.28,0.00
2024-12-08 17:10:53,112,2193,56,56,1268.81,2442.38,0.00
2024-12-08 17:10:53,112,2194,56,56,1305.43,2443.00,0.00
2024-12-08 17:10:53,113,2194,56,57,1293.88,2443.01,0.00
2024-12-08 17:10:53,112,2194,56,56,1299.79,2443.10,0.00
2024-12-08 17:10:53,112,2195,56,56,1331.42,2444.00,0.00
2024-12-08 17:10:53,113,2195,56,57,1319.64,2444.01,0.00
2024-12-08 17:10:53,112,2195,56,56,1325.51,2444.10,0.00
2024-12-08 17:10:53,111,2195,55,56,1325.47,2444.47,0.00
2024-12-08 17:10:53,110,2195,54,56,1325.52,2444.79,0.00
2024-12-08 17:10:53,110,2196,54,56,1342.81,2445.00,0.00
2024-12-08 17:10:53,111,2196,55,56,1330.71,2445.01,0.00
2024-12-08 17:10:53,110,2196,55,55,1336.62,2445.10,0.00
2024-12-08 17:10:53,110,2197,55,55,1332.91,2446.00,0.00
2024-12-08 17:10:53,111,2197,55,56,1320.90,2446.01,0.00
2024-12-08 17:10:53,110,2197,55,55,1326.38,2446.11,0.00
2024-12-08 17:10:53,110,2198,55,55,1322.89,2447.00,0.00
2024-12-08 17:10:53,111,2198,56,55,1310.97,2447.01,0.00
2024-12-08 17:10:53,110,2198,56,54,1317.22,2447.09,0.00
2024-12-08 17:10:53,110,2199,56,54,1313.28,2448.00,0.00
2024-12-08 17:10:53,111,2199,57,54,1301.45,2448.01,0.00
2024-12-08 17:10:53,110,2199,56,54,1311.81,2448.05,0.00
2024-12-08 17:10:53,109,2199,56,53,1318.69,2448.10,0.00
2024-12-08 17:10:53,110,2198,57,53,1300.34,2448.38,0.00
2024-12-08 17:10:53,110,2199,57,53,1316.23,2449.00,0.00
2024-12-08 17:10:53,111,2199,58,53,1304.37,2449.01,0.00
2024-12-08 17:10:53,110,2199,58,52,1309.89,2449.10,0.00
2024-12-08 17:10:54,110,2200,58,52,1328.10,2450.00,0.00
2024-12-08 17:10:54,111,2200,59,52,1316.14,2450.01,0.00
2024-12-08 17:10:54,110,2200,58,52,1320.23,2450.14,0.00
2024-12-08 17:10:54,109,2200,57,52,1332.12,2450.14,0.00
2024-12-08 17:10:54,109,2201,57,52,1328.97,2451.00,0.00
2024-12-08 17:10:54,110,2201,57,53,1316.89,2451.01,0.00
2024-12-08 17:10:54,109,2201,57,52,1320.71,2451.15,0.00
2024-12-08 17:10:54,108,2201,56,52,1321.68,2451.56,0.00
2024-12-08 17:10:54,108,2202,56,52,1333.82,2452.00,0.00
2024-12-08 17:10:54,109,2202,56,53,1321.58,2452.01,0.00
2024-12-08 17:10:54,108,2202,55,53,1330.35,2452.04,0.00
2024-12-08 17:10:54,109,2201,56,53,1301.00,2452.50,0.00
2024-12-08 17:10:54,109,2202,56,53,1326.13,2453.00,0.00
2024-12-08 17:10:54,110,2202,57,53,1314.07,2453.01,0.00
2024-12-08 17:10:54,109,2202,56,53,1325.91,2453.01,0.00
2024-12-08 17:10:54,108,2202,56,52,1333.36,2453.16,0.00
2024-12-08 17:10:54,109,2201,57,52,1320.45,2453.20,0.00
2024-12-08 17:10:54,109,2202,57,52,1360.23,2454.00,0.00
2024-12-08 17:10:54,110,2202,57,53,1347.86,2454.01,0.00
2024-12-08 17:10:54,109,2202,56,53,1358.54,2454.06,0.00
2024-12-08 17:10:54,108,2202,55,53,1361.15,2454.19,0.00
2024-12-08 17:10:54,107,2202,54,53,1370.94,2454.32,0.00
2024-12-08 17:10:54,107,2203,54,53,1398.50,2455.00,0.00
2024-12-08 17:10:54,108,2203,54,54,1385.55,2455.01,0.00
2024-12-08 17:10:54,107,2203,53,54,1397.15,2455.03,0.00
2024-12-08 17:10:54,106,2203,53,53,1405.73,2455.16,0.00
2024-12-08 17:10:54,106,2204,53,53,1402.66,2456.00,0.00
2024-12-08 17:10:54,107,2204,54,53,1389.56,2456.01,0.00
2024-12-08 17:10:54,107,2205,54,53,1376.50,2457.00,0.00
2024-12-08 17:10:54,108,2205,54,54,1363.75,2457.01,0.00
2024-12-08 17:10:54,107,2205,54,53,1361.90,2457.31,0.00
2024-12-08 17:10:54,107,2206,54,53,1362.61,2458.00,0.00
2024-12-08 17:10:54,108,2206,54,54,1350.00,2458.01,0.00
2024-12-08 17:10:54,107,2206,53,54,1358.26,2458.14,0.00
2024-12-08 17:10:54,108,2205,53,55,1322.32,2458.91,0.00
2024-12-08 17:10:54,108,2206,53,55,1342.29,2459.00,0.00
2024-12-08 17:10:54,109,2206,54,55,1329.97,2459.01,0.00
2024-12-08 17:10:54,109,2207,54,55,1337.21,2460.00,0.00
2024-12-08 17:10:54,110,2207,55,55,1325.05,2460.01,0.00
2024-12-08 17:10:54,109,2207,55,54,1333.03,2460.15,0.00
2024-12-08 17:10:54,109,2208,55,54,1327.09,2461.00,0.00
2024-12-08 17:10:54,110,2208,56,54,1315.02,2461.01,0.00
2024-12-08 17:10:54,109,2208,55,54,1325.56,2461.05,0.00
2024-12-08 17:10:54,109,2209,55,54,1313.95,2462.00,0.00
2024-12-08 17:10:54,110,2209,55,55,1302.01,2462.01,0.00
2024-12-08 17:10:54,109,2209,54,55,1310.34,2462.14,0.00
2024-12-08 17:10:54,108,2209,54,54,1321.57,2462.16,0.00
2024-12-08 17:10:54,108,2210,54,54,1319.19,2463.00,0.00
2024-12-08 17:10:54,109,2210,55,54,1307.09,2463.01,0.00
2024-12-08 17:10:54,108,2210,55,53,1318.06,2463.05,0.00
2024-12-08 17:10:54,107,2210,54,53,1329.23,2463.08,0.00
2024-12-08 17:10:54,106,2210,53,53,1341.43,2463.09,0.00
2024-12-08 17:10:54,106,2211,53,53,1331.96,2464.00,0.00
2024-12-08 17:10:54,107,2211,54,53,1319.51,2464.01,0.00
2024-12-08 17:10:54,107,2212,54,53,1308.01,2465.00,0.00
2024-12-08 17:10:54,108,2212,55,53,1295.90,2465.01,0.00
2024-12-08 17:10:54,107,2212,54,53,1299.58,2465.14,0.00
2024-12-08 17:10:54,107,2213,54,53,1301.09,2466.00,0.00
2024-12-08 17:10:54,108,2213,55,53,1289.04,2466.01,0.00
2024-12-08 17:10:54,107,2213,54,53,1300.15,2466.01,0.00
2024-12-08 17:10:54,106,2213,54,52,1311.50,2466.04,0.00
2024-12-08 17:10:55,106,2214,54,52,1302.25,2467.00,0.00
2024-12-08 17:10:55,107,2214,55,52,1290.07,2467.01,0.00
2024-12-08 17:10:55,106,2214,55,51,1301.32,2467.04,0.00
2024-12-08 17:10:55,106,2215,55,51,1292.06,2468.00,0.00
2024-12-08 17:10:55,107,2215,56,51,1279.99,2468.01,0.00
2024-12-08 17:10:55,106,2215,56,50,1291.14,2468.04,0.00
2024-12-08 17:10:55,105,2215,55,50,1303.20,2468.04,0.00
2024-12-08 17:10:55,104,2215,55,49,1311.00,2468.09,0.00
2024-12-08 17:10:55,105,2214,55,50,1281.92,2468.79,0.00
2024-12-08 17:10:55,105,2215,55,50,1300.19,2469.00,0.00
2024-12-08 17:10:55,106,2215,55,51,1287.92,2469.01,0.00
2024-12-08 17:10:55,107,2214,55,52,1256.06,2469.65,0.00
2024-12-08 17:10:55,107,2215,55,52,1295.45,2470.00,0.00
2024-12-08 17:10:55,108,2215,56,52,1283.46,2470.01,0.00
2024-12-08 17:10:55,107,2215,56,51,1292.70,2470.08,0.00
2024-12-08 17:10:55,108,2214,57,51,1269.25,2470.57,0.00
2024-12-08 17:10:55,108,2215,57,51,1307.35,2471.00,0.00
2024-12-08 17:10:55,109,2215,58,51,1295.36,2471.01,0.00
2024-12-08 17:10:55,108,2215,58,50,1303.24,2471.07,0.00
2024-12-08 17:10:55,108,2216,58,50,1319.13,2472.00,0.00
2024-12-08 17:10:55,109,2216,58,51,1307.03,2472.01,0.00
2024-12-08 17:10:55,108,2216,58,50,1314.10,2472.03,0.00
2024-12-08 17:10:55,107,2216,57,50,1326.15,2472.03,0.00
2024-12-08 17:10:55,106,2216,56,50,1336.82,2472.10,0.00
2024-12-08 17:10:55,105,2216,55,50,1349.31,2472.11,0.00
2024-12-08 17:10:55,105,2217,55,50,1343.02,2473.00,0.00
2024-12-08 17:10:55,106,2217,56,50,1330.35,2473.01,0.00
2024-12-08 17:10:55,105,2217,56,49,1338.79,2473.06,0.00
2024-12-08 17:10:55,105,2218,56,49,1330.03,2474.00,0.00
2024-12-08 17:10:55,106,2218,57,49,1317.49,2474.01,0.00
2024-12-08 17:10:55,105,2218,56,49,1300.20,2474.77,0.00
2024-12-08 17:10:55,105,2219,56,49,1313.88,2475.00,0.00
2024-12-08 17:10:55,106,2219,57,49,1301.48,2475.01,0.00
2024-12-08 17:10:55,105,2219,57,48,1308.94,2475.08,0.00
2024-12-08 17:10:55,105,2220,57,48,1298.65,2476.00,0.00
2024-12-08 17:10:55,106,2220,57,49,1286.40,2476.01,0.00
2024-12-08 17:10:55,107,2219,58,49,1274.15,2476.04,0.00
2024-12-08 17:10:55,106,2219,58,48,1304.18,2476.08,0.00
2024-12-08 17:10:55,105,2219,58,47,1295.73,2476.80,0.00
2024-12-08 17:10:55,105,2220,58,47,1307.59,2477.00,0.00
2024-12-08 17:10:55,106,2220,58,48,1295.25,2477.01,0.00
2024-12-08 17:10:55,105,2220,57,48,1306.43,2477.04,0.00
2024-12-08 17:10:55,104,2220,57,47,1313.29,2477.08,0.00
2024-12-08 17:10:55,104,2221,57,47,1333.57,2478.00,0.00
2024-12-08 17:10:55,105,2221,57,48,1320.87,2478.01,0.00
2024-12-08 17:10:55,105,2222,57,48,1306.24,2479.00,0.00
2024-12-08 17:10:55,106,2222,58,48,1293.92,2479.01,0.00
2024-12-08 17:10:55,105,2222,57,48,1304.15,2479.09,0.00
2024-12-08 17:10:55,104,2222,57,47,1316.45,2479.09,0.00
2024-12-08 17:10:55,103,2222,56,47,1311.04,2479.52,0.00
2024-12-08 17:10:55,103,2223,56,47,1321.52,2480.00,0.00
2024-12-08 17:10:55,104,2223,56,48,1308.82,2480.01,0.00
2024-12-08 17:10:55,103,2223,55,48,1313.37,2480.12,0.00
2024-12-08 17:10:55,103,2224,55,48,1310.66,2481.00,0.00
2024-12-08 17:10:55,104,2224,55,49,1298.05,2481.01,0.00
2024-12-08 17:10:55,103,2224,55,48,1308.04,2481.11,0.00
2024-12-08 17:10:55,102,2224,54,48,1313.64,2481.35,0.00
2024-12-08 17:10:55,101,2224,54,47,1324.03,2481.45,0.00
2024-12-08 17:10:55,101,2225,54,47,1332.85,2482.00,0.00
2024-12-08 17:10:55,102,2225,55,47,1319.78,2482.01,0.00
2024-12-08 17:10:55,101,2225,54,47,1319.92,2482.33,0.00
2024-12-08 17:10:55,100,2225,53,47,1314.21,2482.88,0.00
2024-12-08 17:10:55,100,2226,53,47,1336.16,2483.00,0.00
2024-12-08 17:10:55,101,2226,54,47,1322.93,2483.01,0.00
2024-12-08 17:10:55,100,2226,54,46,1332.97,2483.12,0.00
2024-12-08 17:10:56,101,2225,54,47,1305.65,2483.52,0.00
2024-12-08 17:10:56,101,2226,54,47,1328.63,2484.00,0.00
2024-12-08 17:10:56,102,2226,54,48,1315.60,2484.01,0.00
2024-12-08 17:10:56,102,2227,54,48,1330.51,2485.00,0.00
2024-12-08 17:10:56,103,2227,55,48,1317.59,2485.01,0.00
2024-12-08 17:10:56,102,2227,54,48,1330.02,2485.01,0.00
2024-12-08 17:10:56,101,2227,54,47,1340.52,2485.11,0.00
2024-12-08 17:10:56,102,2226,55,47,1315.40,2485.62,0.00
2024-12-08 17:10:56,102,2227,55,47,1338.84,2486.00,0.00
2024-12-08 17:10:56,103,2227,55,48,1325.84,2486.01,0.00
2024-12-08 17:10:56,102,2227,54,48,1337.88,2486.04,0.00
2024-12-08 17:10:56,101,2227,53,48,1339.39,2486.31,0.00
2024-12-08 17:10:56,101,2228,53,48,1366.92,2487.00,0.00
2024-12-08 17:10:56,102,2228,53,49,1353.52,2487.01,0.00
2024-12-08 17:10:56,101,2228,53,48,1364.01,2487.12,0.00
2024-12-08 17:10:56,100,2228,52,48,1372.97,2487.30,0.00
2024-12-08 17:10:56,100,2229,52,48,1380.90,2488.00,0.00
2024-12-08 17:10:56,101,2229,52,49,1367.23,2488.01,0.00
2024-12-08 17:10:56,102,2228,53,49,1353.82,2488.03,0.00
2024-12-08 17:10:56,101,2228,53,48,1362.59,2488.13,0.00
2024-12-08 17:10:56,101,2229,53,48,1361.12,2489.00,0.00
2024-12-08 17:10:56,102,2229,54,48,1347.78,2489.01,0.00
2024-12-08 17:10:56,101,2229,53,48,1357.96,2489.13,0.00
2024-12-08 17:10:56,100,2229,52,48,1364.57,2489.16,0.00
2024-12-08 17:10:56,100,2230,52,48,1393.96,2490.00,0.00
2024-12-08 17:10:56,101,2230,52,49,1380.16,2490.01,0.00
2024-12-08 17:10:56,100,2230,52,48,1390.27,2490.14,0.00
2024-12-08 17:10:56,100,2231,52,48,1389.29,2491.00,0.00
2024-12-08 17:10:56,101,2231,52,49,1375.54,2491.01,0.00
2024-12-08 17:10:56,102,2230,53,49,1338.58,2491.59,0.00
2024-12-08 17:10:56,102,2231,53,49,1361.86,2492.00,0.00
2024-12-08 17:10:56,103,2231,54,49,1348.64,2492.01,0.00
2024-12-08 17:10:56,102,2231,54,48,1353.10,2492.15,0.00
2024-12-08 17:10:56,102,2232,54,48,1381.23,2493.00,0.00
2024-12-08 17:10:56,103,2232,55,48,1367.82,2493.01,0.00
2024-12-08 17:10:56,102,2232,54,48,1368.60,2493.31,0.00
2024-12-08 17:10:56,102,2233,54,48,1371.51,2494.00,0.00
2024-12-08 17:10:56,103,2233,55,48,1358.20,2494.01,0.00
2024-12-08 17:10:56,102,2233,54,48,1370.31,2494.05,0.00
2024-12-08 17:10:56,103,2232,54,49,1351.20,2494.11,0.00
2024-12-08 17:10:56,102,2232,54,48,1373.26,2494.15,0.00
2024-12-08 17:10:56,102,2233,54,48,1372.06,2495.00,0.00
2024-12-08 17:10:56,103,2233,55,48,1358.74,2495.01,0.00
2024-12-08 17:10:56,102,2233,55,47,1363.78,2495.14,0.00
2024-12-08 17:10:57,102,2234,55,47,1386.81,2496.00,0.00
2024-12-08 17:10:57,103,2234,55,48,1373.34,2496.01,0.00
2024-12-08 17:10:57,102,2234,55,47,1378.52,2496.14,0.00
2024-12-08 17:10:57,103,2233,55,48,1351.82,2496.70,0.00
2024-12-08 17:10:57,103,2234,55,48,1370.01,2497.00,0.00
2024-12-08 17:10:57,104,2234,56,48,1356.84,2497.01,0.00
2024-12-08 17:10:57,103,2234,56,47,1366.65,2497.14,0.00
2024-12-08 17:10:57,103,2235,56,47,1389.24,2498.00,0.00
2024-12-08 17:10:57,104,2235,57,47,1375.88,2498.01,0.00
2024-12-08 17:10:57,103,2235,57,46,1388.04,2498.05,0.00
2024-12-08 17:10:57,103,2236,57,46,1379.36,2499.00,0.00
2024-12-08 17:10:57,104,2236,58,46,1366.10,2499.01,0.00
2024-12-08 17:10:57,103,2236,58,45,1375.99,2499.14,0.00
2024-12-08 17:10:57,103,2237,58,45,1369.48,2500.00,0.00
2024-12-08 17:10:57,104,2237,58,46,1356.31,2500.01,0.00
2024-12-08 17:10:57,103,2237,58,45,1368.27,2500.05,0.00
2024-12-08 17:10:57,102,2237,58,44,1379.50,2500.13,0.00
2024-12-08 17:10:57,102,2238,58,44,1377.82,2501.00,0.00
2024-12-08 17:10:57,103,2238,58,45,1364.44,2501.01,0.00
2024-12-08 17:10:57,102,2238,58,44,1369.75,2501.13,0.00
2024-12-08 17:10:57,101,2238,57,44,1360.98,2501.91,0.00
2024-12-08 17:10:57,101,2239,57,44,1383.59,2502.00,0.00
2024-12-08 17:10:57,102,2239,58,44,1370.03,2502.01,0.00
2024-12-08 17:10:57,102,2240,58,44,1360.51,2503.00,0.00
2024-12-08 17:10:57,103,2240,58,45,1347.30,2503.01,0.00
2024-12-08 17:10:57,102,2240,58,44,1355.63,2503.15,0.00
2024-12-08 17:10:57,102,2241,58,44,1354.43,2504.00,0.00
2024-12-08 17:10:57,103,2241,59,44,1341.28,2504.01,0.00
2024-12-08 17:10:57,102,2241,58,44,1351.51,2504.13,0.00
2024-12-08 17:10:57,102,2242,58,44,1344.90,2505.00,0.00
2024-12-08 17:10:57,103,2242,58,45,1331.84,2505.01,0.00
2024-12-08 17:10:57,102,2242,58,44,1340.50,2505.14,0.00
2024-12-08 17:10:57,103,2241,58,45,1321.26,2505.41,0.00
2024-12-08 17:10:57,103,2242,58,45,1338.94,2506.00,0.00
2024-12-08 17:10:57,104,2242,58,46,1326.07,2506.01,0.00
2024-12-08 17:10:57,103,2242,57,46,1337.74,2506.05,0.00
2024-12-08 17:10:57,102,2242,56,46,1350.13,2506.07,0.00
2024-12-08 17:10:57,102,2243,56,46,1366.50,2507.00,0.00
2024-12-08 17:10:57,103,2243,57,46,1353.23,2507.01,0.00
2024-12-08 17:10:57,102,2243,57,45,1361.35,2507.16,0.00
2024-12-08 17:10:57,102,2244,57,45,1359.70,2508.00,0.00
2024-12-08 17:10:57,103,2244,58,45,1346.50,2508.01,0.00
2024-12-08 17:10:57,102,2244,57,45,1358.73,2508.04,0.00
2024-12-08 17:10:57,101,2244,56,45,1371.45,2508.06,0.00
2024-12-08 17:10:57,102,2243,56,46,1336.14,2508.75,0.00
2024-12-08 17:10:57,102,2244,56,46,1353.82,2509.00,0.00
2024-12-08 17:10:57,103,2244,56,47,1340.67,2509.01,0.00
2024-12-08 17:10:57,102,2244,56,46,1349.79,2509.12,0.00
2024-12-08 17:10:57,103,2243,57,46,1328.98,2509.44,0.00
2024-12-08 17:10:57,103,2244,57,46,1370.40,2510.00,0.00
2024-12-08 17:10:57,104,2244,58,46,1357.23,2510.01,0.00
2024-12-08 17:10:57,104,2245,58,46,1368.45,2511.00,0.00
2024-12-08 17:10:57,105,2245,59,46,1355.42,2511.01,0.00
2024-12-08 17:10:57,104,2245,58,46,1367.74,2511.03,0.00
2024-12-08 17:10:57,103,2245,57,46,1380.54,2511.05,0.00
2024-12-08 17:10:57,102,2245,56,46,1393.82,2511.05,0.00
2024-12-08 17:10:57,101,2245,56,45,1405.47,2511.09,0.00
2024-12-08 17:10:57,101,2246,56,45,1400.46,2512.00,0.00
2024-12-08 17:10:57,102,2246,56,46,1386.73,2512.01,0.00
2024-12-08 17:10:57,101,2246,56,45,1398.72,2512.06,0.00
2024-12-08 17:10:57,100,2246,55,45,1396.28,2512.51,0.00
2024-12-08 17:10:58,100,2247,55,45,1402.19,2513.00,0.00
2024-12-08 17:10:58,101,2247,56,45,1388.31,2513.01,0.00
2024-12-08 17:10:58,100,2247,56,44,1399.45,2513.09,0.00
2024-12-08 17:10:58,99,2247,55,44,1397.63,2513.52,0.00
2024-12-08 17:10:58,100,2246,55,45,1380.47,2513.66,0.00
2024-12-08 17:10:58,100,2247,55,45,1401.71,2514.00,0.00
2024-12-08 17:10:58,101,2247,56,45,1387.83,2514.01,0.00
2024-12-08 17:10:58,100,2247,55,45,1378.38,2514.70,0.00
2024-12-08 17:10:58,100,2248,55,45,1416.33,2515.00,0.00
2024-12-08 17:10:58,101,2248,56,45,1402.31,2515.01,0.00
2024-12-08 17:10:58,100,2248,56,44,1413.84,2515.09,0.00
2024-12-08 17:10:58,100,2249,56,44,1411.56,2516.00,0.00
2024-12-08 17:10:58,101,2249,57,44,1397.59,2516.01,0.00
2024-12-08 17:10:58,101,2250,57,44,1388.05,2517.00,0.00
2024-12-08 17:10:58,102,2250,57,45,1374.44,2517.01,0.00
2024-12-08 17:10:58,102,2251,57,45,1364.86,2518.00,0.00
2024-12-08 17:10:58,103,2251,58,45,1351.61,2518.01,0.00
2024-12-08 17:10:58,102,2251,57,45,1363.65,2518.05,0.00
2024-12-08 17:10:58,101,2251,57,44,1373.41,2518.08,0.00
2024-12-08 17:10:58,100,2251,56,44,1378.43,2518.37,0.00
2024-12-08 17:10:58,100,2252,56,44,1388.18,2519.00,0.00
2024-12-08 17:10:58,101,2252,57,44,1374.44,2519.01,0.00
2024-12-08 17:10:58,100,2252,57,43,1381.15,2519.08,0.00
2024-12-08 17:10:58,100,2253,57,43,1378.65,2520.00,0.00
2024-12-08 17:10:58,101,2253,58,43,1365.00,2520.01,0.00
2024-12-08 17:10:58,100,2253,57,43,1374.89,2520.05,0.00
2024-12-08 17:10:58,101,2252,57,44,1360.53,2520.10,0.00
2024-12-08 17:10:58,100,2252,56,44,1373.32,2520.29,0.00
2024-12-08 17:10:58,101,2251,56,45,1352.86,2520.58,0.00
2024-12-08 17:10:58,101,2252,56,45,1376.40,2521.00,0.00
2024-12-08 17:10:58,102,2252,56,46,1362.91,2521.01,0.00
2024-12-08 17:10:58,101,2252,55,46,1375.66,2521.03,0.00
2024-12-08 17:10:58,100,2252,54,46,1388.67,2521.06,0.00
2024-12-08 17:10:58,99,2252,54,45,1402.20,2521.07,0.00
2024-12-08 17:10:58,99,2253,54,45,1450.56,2522.00,0.00
2024-12-08 17:10:58,100,2253,55,45,1436.05,2522.01,0.00
2024-12-08 17:10:58,99,2253,54,45,1444.96,2522.02,0.00
2024-12-08 17:10:58,98,2253,54,44,1453.29,2522.06,0.00
2024-12-08 17:10:58,98,2254,54,44,1455.55,2523.00,0.00
2024-12-08 17:10:58,99,2254,55,44,1440.84,2523.01,0.00
2024-12-08 17:10:58,98,2254,54,44,1454.28,2523.06,0.00
2024-12-08 17:10:58,97,2254,54,43,1464.07,2523.06,0.00
2024-12-08 17:10:58,97,2255,54,43,1460.69,2524.00,0.00
2024-12-08 17:10:58,98,2255,55,43,1445.78,2524.01,0.00
2024-12-08 17:10:58,99,2254,56,43,1430.93,2524.04,0.00
2024-12-08 17:10:58,98,2254,56,42,1441.94,2524.07,0.00
2024-12-08 17:10:58,98,2255,56,42,1443.29,2525.00,0.00
2024-12-08 17:10:58,99,2255,56,43,1428.71,2525.01,0.00
2024-12-08 17:10:58,98,2255,56,42,1436.87,2525.06,0.00
2024-12-08 17:10:58,99,2254,56,43,1416.06,2525.33,0.00
2024-12-08 17:10:58,99,2255,56,43,1457.42,2526.00,0.00
2024-12-08 17:10:58,100,2255,56,44,1442.85,2526.01,0.00
2024-12-08 17:10:58,99,2255,56,43,1450.56,2526.07,0.00
2024-12-08 17:10:58,98,2255,55,43,1460.78,2526.26,0.00
2024-12-08 17:10:58,98,2256,55,43,1485.69,2527.00,0.00
2024-12-08 17:10:58,99,2256,56,43,1470.68,2527.01,0.00
2024-12-08 17:10:58,98,2256,55,43,1474.42,2527.26,0.00
2024-12-08 17:10:58,98,2257,55,43,1471.74,2528.00,0.00
2024-12-08 17:10:58,99,2257,56,43,1456.87,2528.01,0.00
2024-12-08 17:10:58,98,2257,55,43,1461.52,2528.20,0.00
2024-12-08 17:10:58,98,2258,55,43,1456.18,2529.00,0.00
2024-12-08 17:10:58,99,2258,55,44,1441.47,2529.01,0.00
2024-12-08 17:10:58,98,2258,55,43,1452.61,2529.12,0.00
2024-12-08 17:10:58,99,2257,56,43,1430.15,2529.46,0.00
2024-12-08 17:10:59,99,2258,56,43,1435.19,2530.00,0.00
2024-12-08 17:10:59,100,2258,57,43,1420.84,2530.01,0.00
2024-12-08 17:10:59,99,2258,56,43,1434.44,2530.03,0.00
2024-12-08 17:10:59,98,2258,55,43,1416.80,2530.75,0.00
2024-12-08 17:10:59,98,2259,55,43,1460.43,2531.00,0.00
2024-12-08 17:10:59,99,2259,55,44,1445.68,2531.01,0.00
2024-12-08 17:10:59,98,2259,55,43,1453.93,2531.16,0.00
2024-12-08 17:10:59,98,2260,55,43,1450.44,2532.00,0.00
2024-12-08 17:10:59,99,2260,55,44,1435.79,2532.01,0.00
2024-12-08 17:10:59,98,2260,55,43,1441.96,2532.14,0.00
2024-12-08 17:10:59,97,2260,54,43,1442.22,2532.50,0.00
2024-12-08 17:10:59,97,2261,54,43,1453.11,2533.00,0.00
2024-12-08 17:10:59,98,2261,54,44,1438.28,2533.01,0.00
2024-12-08 17:10:59,99,2260,54,45,1407.36,2533.42,0.00
2024-12-08 17:10:59,99,2261,54,45,1411.75,2534.00,0.00
2024-12-08 17:10:59,100,2261,54,46,1397.64,2534.01,0.00
2024-12-08 17:10:59,99,2261,53,46,1411.00,2534.03,0.00
2024-12-08 17:10:59,98,2261,53,45,1421.59,2534.13,0.00
2024-12-08 17:10:59,98,2262,53,45,1442.73,2535.00,0.00
2024-12-08 17:10:59,99,2262,53,46,1428.16,2535.01,0.00
2024-12-08 17:10:59,98,2262,52,46,1434.98,2535.11,0.00
2024-12-08 17:10:59,97,2262,51,46,1426.83,2535.69,0.00
2024-12-08 17:10:59,97,2263,51,46,1444.83,2536.00,0.00
2024-12-08 17:10:59,98,2263,51,47,1430.08,2536.01,0.00
2024-12-08 17:10:59,97,2263,50,47,1443.04,2536.04,0.00
2024-12-08 17:10:59,97,2264,50,47,1435.86,2537.00,0.00
2024-12-08 17:10:59,98,2264,51,47,1421.21,2537.01,0.00
2024-12-08 17:10:59,97,2264,50,47,1431.46,2537.13,0.00
2024-12-08 17:10:59,96,2264,50,46,1444.78,2537.14,0.00
2024-12-08 17:10:59,96,2265,50,46,1444.46,2538.00,0.00
2024-12-08 17:10:59,97,2265,51,46,1429.57,2538.01,0.00
2024-12-08 17:10:59,96,2265,50,46,1442.64,2538.07,0.00
2024-12-08 17:10:59,95,2265,50,45,1456.77,2538.11,0.00
2024-12-08 17:10:59,94,2265,49,45,1470.11,2538.12,0.00
2024-12-08 17:10:59,94,2266,49,45,1463.67,2539.00,0.00
2024-12-08 17:10:59,95,2266,50,45,1448.26,2539.01,0.00
2024-12-08 17:10:59,96,2265,50,46,1432.40,2539.06,0.00
2024-12-08 17:10:59,95,2265,50,45,1463.37,2539.24,0.00
2024-12-08 17:10:59,95,2266,50,45,1461.01,2540.00,0.00
2024-12-08 17:10:59,96,2266,51,45,1445.79,2540.01,0.00
2024-12-08 17:10:59,96,2267,51,45,1458.10,2541.00,0.00
2024-12-08 17:10:59,97,2267,51,46,1443.07,2541.01,0.00
2024-12-08 17:10:59,96,2267,51,45,1452.07,2541.16,0.00
2024-12-08 17:10:59,96,2268,51,45,1446.41,2542.00,0.00
2024-12-08 17:10:59,97,2268,52,45,1431.50,2542.01,0.00
2024-12-08 17:10:59,96,2268,52,44,1427.60,2542.54,0.00
2024-12-08 17:10:59,96,2269,52,44,1432.53,2543.00,0.00
2024-12-08 17:10:59,97,2269,52,45,1417.76,2543.01,0.00
2024-12-08 17:10:59,97,2270,52,45,1404.08,2544.00,0.00
2024-12-08 17:10:59,98,2270,53,45,1389.75,2544.01,0.00
2024-12-08 17:10:59,97,2270,53,44,1400.19,2544.14,0.00
2024-12-08 17:10:59,96,2270,53,43,1402.77,2544.57,0.00
2024-12-08 17:10:59,96,2271,53,43,1411.52,2545.00,0.00
2024-12-08 17:10:59,97,2271,53,44,1396.97,2545.01,0.00
2024-12-08 17:10:59,96,2271,52,44,1404.77,2545.17,0.00
2024-12-08 17:10:59,97,2270,52,45,1384.00,2545.23,0.00
2024-12-08 17:10:59,97,2271,52,45,1411.80,2546.00,0.00
2024-12-08 17:10:59,98,2271,52,46,1397.40,2546.01,0.00
2024-12-08 17:10:59,98,2272,52,46,1413.07,2547.00,0.00
2024-12-08 17:10:59,99,2272,52,47,1398.80,2547.01,0.00
2024-12-08 17:10:59,98,2272,52,46,1405.34,2547.19,0.00
2024-12-08 17:11:00,98,2273,52,46,1405.31,2548.00,0.00
2024-12-08 17:11:00,99,2273,53,46,1391.12,2548.01,0.00
2024-12-08 17:11:00,98,2273,52,46,1404.04,2548.05,0.00
2024-12-08 17:11:00,97,2273,51,46,1416.69,2548.11,0.00
2024-12-08 17:11:00,97,2274,51,46,1409.54,2549.00,0.00
2024-12-08 17:11:00,98,2274,52,46,1395.16,2549.01,0.00
2024-12-08 17:11:00,97,2274,52,45,1401.99,2549.19,0.00
2024-12-08 17:11:00,97,2275,52,45,1401.69,2550.00,0.00
2024-12-08 17:11:00,98,2275,52,46,1387.39,2550.01,0.00
2024-12-08 17:11:00,98,2276,52,46,1376.72,2551.00,0.00
2024-12-08 17:11:00,99,2276,52,47,1362.81,2551.01,0.00
2024-12-08 17:11:00,98,2276,52,46,1369.49,2551.18,0.00
2024-12-08 17:11:00,98,2277,52,46,1368.34,2552.00,0.00
2024-12-08 17:11:00,99,2277,53,46,1354.52,2552.01,0.00
2024-12-08 17:11:00,98,2277,52,46,1366.03,2552.08,0.00
2024-12-08 17:11:00,98,2278,52,46,1362.72,2553.00,0.00
2024-12-08 17:11:00,99,2278,53,46,1348.96,2553.01,0.00
2024-12-08 17:11:00,98,2278,53,45,1355.23,2553.19,0.00
2024-12-08 17:11:00,98,2279,53,45,1354.48,2554.00,0.00
2024-12-08 17:11:00,99,2279,54,45,1340.80,2554.01,0.00
2024-12-08 17:11:00,99,2280,54,45,1329.61,2555.00,0.00
2024-12-08 17:11:00,100,2280,55,45,1316.32,2555.01,0.00
2024-12-08 17:11:00,99,2280,55,44,1321.17,2555.22,0.00
2024-12-08 17:11:00,98,2280,54,44,1333.11,2555.29,0.00
2024-12-08 17:11:00,97,2280,53,44,1343.09,2555.34,0.00
2024-12-08 17:11:00,97,2281,53,44,1352.20,2556.00,0.00
2024-12-08 17:11:00,98,2281,53,45,1338.41,2556.01,0.00
2024-12-08 17:11:00,97,2281,53,44,1348.56,2556.14,0.00
2024-12-08 17:11:00,96,2281,52,44,1362.37,2556.15,0.00
2024-12-08 17:11:00,95,2281,51,44,1362.50,2556.28,0.00
2024-12-08 17:11:00,94,2281,50,44,1370.99,2556.42,0.00
2024-12-08 17:11:00,94,2282,50,44,1381.99,2557.00,0.00
2024-12-08 17:11:00,95,2282,50,45,1367.44,2557.01,0.00
2024-12-08 17:11:00,94,2282,50,44,1373.90,2557.21,0.00
2024-12-08 17:11:00,94,2283,50,44,1367.87,2558.00,0.00
2024-12-08 17:11:00,95,2283,50,45,1353.47,2558.01,0.00
2024-12-08 17:11:00,96,2282,50,46,1336.66,2558.14,0.00
2024-12-08 17:11:00,95,2282,50,45,1355.72,2558.30,0.00
2024-12-08 17:11:00,94,2282,49,45,1366.31,2558.39,0.00
2024-12-08 17:11:00,93,2282,48,45,1368.47,2558.77,0.00
2024-12-08 17:11:00,93,2283,48,45,1384.61,2559.00,0.00
2024-12-08 17:11:00,94,2283,49,45,1369.88,2559.01,0.00
2024-12-08 17:11:00,93,2283,49,44,1375.46,2559.24,0.00
2024-12-08 17:11:00,93,2284,49,44,1403.56,2560.00,0.00
2024-12-08 17:11:00,94,2284,49,45,1388.63,2560.01,0.00
2024-12-08 17:11:00,94,2285,49,45,1376.46,2561.00,0.00
2024-12-08 17:11:00,95,2285,50,45,1361.98,2561.01,0.00
2024-12-08 17:11:00,94,2285,50,44,1367.56,2561.23,0.00
2024-12-08 17:11:00,94,2286,50,44,1365.41,2562.00,0.00
2024-12-08 17:11:00,95,2286,50,45,1351.03,2562.01,0.00
2024-12-08 17:11:00,95,2287,50,45,1336.51,2563.00,0.00
2024-12-08 17:11:00,96,2287,51,45,1322.58,2563.01,0.00
2024-12-08 17:11:00,95,2287,50,45,1331.97,2563.17,0.00
2024-12-08 17:11:00,94,2287,50,44,1341.26,2563.23,0.00
2024-12-08 17:11:00,94,2288,50,44,1337.55,2564.00,0.00
2024-12-08 17:11:00,95,2288,51,44,1323.47,2564.01,0.00
2024-12-08 17:11:00,94,2288,50,44,1321.24,2564.26,0.00
2024-12-08 17:11:00,93,2288,49,44,1322.61,2564.73,0.00
2024-12-08 17:11:00,93,2289,49,44,1343.51,2565.00,0.00
2024-12-08 17:11:00,94,2289,50,44,1329.22,2565.01,0.00
2024-12-08 17:11:01,93,2289,49,44,1330.29,2565.30,0.00
2024-12-08 17:11:01,93,2290,49,44,1334.34,2566.00,0.00
2024-12-08 17:11:01,94,2290,50,44,1320.15,2566.01,0.00
2024-12-08 17:11:01,93,2290,50,43,1325.21,2566.24,0.00
2024-12-08 17:11:01,93,2291,50,43,1327.32,2567.00,0.00
2024-12-08 17:11:01,94,2291,51,43,1313.20,2567.01,0.00
2024-12-08 17:11:01,93,2291,50,43,1324.47,2567.10,0.00
2024-12-08 17:11:01,92,2291,50,42,1331.38,2567.24,0.00
2024-12-08 17:11:01,92,2292,50,42,1331.52,2568.00,0.00
2024-12-08 17:11:01,93,2292,50,43,1317.20,2568.01,0.00
2024-12-08 17:11:01,92,2292,49,43,1331.24,2568.01,0.00
2024-12-08 17:11:01,91,2292,48,43,1344.75,2568.04,0.00
2024-12-08 17:11:01,90,2292,48,42,1358.11,2568.08,0.00
2024-12-08 17:11:01,90,2293,48,42,1347.45,2569.00,0.00
2024-12-08 17:11:01,91,2293,48,43,1332.64,2569.01,0.00
2024-12-08 17:11:01,90,2293,48,42,1338.19,2569.21,0.00
2024-12-08 17:11:01,90,2294,48,42,1336.09,2570.00,0.00
2024-12-08 17:11:01,91,2294,48,43,1321.40,2570.01,0.00
2024-12-08 17:11:01,90,2294,48,42,1315.97,2570.56,0.00
2024-12-08 17:11:01,90,2295,48,42,1322.76,2571.00,0.00
2024-12-08 17:11:01,91,2295,48,43,1308.23,2571.01,0.00
2024-12-08 17:11:01,90,2295,48,42,1313.27,2571.22,0.00
2024-12-08 17:11:01,89,2295,47,42,1311.47,2571.69,0.00
2024-12-08 17:11:01,89,2296,47,42,1326.73,2572.00,0.00
2024-12-08 17:11:01,90,2296,47,43,1311.99,2572.01,0.00
2024-12-08 17:11:01,89,2296,47,42,1324.05,2572.09,0.00
2024-12-08 17:11:01,88,2296,46,42,1330.65,2572.18,0.00
2024-12-08 17:11:01,88,2297,46,42,1333.45,2573.00,0.00
2024-12-08 17:11:01,89,2297,46,43,1318.46,2573.01,0.00
2024-12-08 17:11:01,88,2297,46,42,1318.49,2573.21,0.00
2024-12-08 17:11:01,88,2298,46,42,1327.72,2574.00,0.00
2024-12-08 17:11:01,89,2298,47,42,1312.80,2574.01,0.00
2024-12-08 17:11:01,89,2299,47,42,1304.79,2575.00,0.00
2024-12-08 17:11:01,90,2299,48,42,1290.30,2575.01,0.00
2024-12-08 17:11:01,89,2299,47,42,1302.06,2575.09,0.00
2024-12-08 17:11:01,88,2299,47,41,1310.74,2575.19,0.00
2024-12-08 17:11:01,87,2299,46,41,1324.09,2575.25,0.00
2024-12-08 17:11:01,87,2300,46,41,1328.86,2576.00,0.00
2024-12-08 17:11:01,88,2300,47,41,1313.76,2576.01,0.00
2024-12-08 17:11:01,89,2299,47,42,1296.50,2576.11,0.00
2024-12-08 17:11:01,89,2300,47,42,1311.71,2577.00,0.00
2024-12-08 17:11:01,90,2300,47,43,1297.14,2577.01,0.00
2024-12-08 17:11:01,89,2300,47,42,1303.16,2577.19,0.00
2024-12-08 17:11:01,89,2301,47,42,1334.89,2578.00,0.00
2024-12-08 17:11:01,90,2301,47,43,1320.06,2578.01,0.00
2024-12-08 17:11:01,89,2301,46,43,1328.67,2578.18,0.00
2024-12-08 17:11:01,90,2300,46,44,1297.46,2578.62,0.00
2024-12-08 17:11:01,90,2301,46,44,1325.82,2579.00,0.00
2024-12-08 17:11:01,91,2301,46,45,1311.25,2579.01,0.00
2024-12-08 17:11:01,90,2301,45,45,1323.73,2579.07,0.00
2024-12-08 17:11:01,89,2301,45,44,1331.69,2579.18,0.00
2024-12-08 17:11:01,89,2302,45,44,1363.17,2580.00,0.00
2024-12-08 17:11:01,90,2302,45,45,1348.02,2580.01,0.00
2024-12-08 17:11:01,90,2303,45,45,1340.23,2581.00,0.00
2024-12-08 17:11:01,91,2303,46,45,1325.50,2581.01,0.00
2024-12-08 17:11:01,90,2303,46,44,1326.23,2581.19,0.00
2024-12-08 17:11:01,89,2303,45,44,1339.69,2581.25,0.00
2024-12-08 17:11:01,90,2302,45,45,1317.73,2581.54,0.00
2024-12-08 17:11:01,90,2303,45,45,1345.89,2582.00,0.00
2024-12-08 17:11:01,91,2303,45,46,1331.10,2582.01,0.00
2024-12-08 17:11:01,90,2303,44,46,1343.63,2582.09,0.00
2024-12-08 17:11:01,89,2303,43,46,1347.96,2582.27,0.00
2024-12-08 17:11:01,89,2304,43,46,1381.78,2583.00,0.00
2024-12-08 17:11:01,90,2304,43,47,1366.43,2583.01,0.00
2024-12-08 17:11:01,89,2304,43,46,1372.55,2583.20,0.00
2024-12-08 17:11:02,88,2304,42,46,1386.25,2583.26,0.00
2024-12-08 17:11:02,87,2304,41,46,1392.16,2583.46,0.00
2024-12-08 17:11:02,87,2305,41,46,1408.30,2584.00,0.00
2024-12-08 17:11:02,88,2305,42,46,1392.29,2584.01,0.00
2024-12-08 17:11:02,87,2305,41,46,1402.96,2584.02,0.00
2024-12-08 17:11:02,86,2305,41,45,1412.06,2584.22,0.00
2024-12-08 17:11:02,86,2306,41,45,1422.46,2585.00,0.00
2024-12-08 17:11:02,87,2306,41,46,1406.11,2585.01,0.00
2024-12-08 17:11:02,86,2306,40,46,1421.57,2585.04,0.00
2024-12-08 17:11:02,86,2307,40,46,1415.20,2586.00,0.00
2024-12-08 17:11:02,87,2307,40,47,1398.93,2586.01,0.00
2024-12-08 17:11:02,86,2307,40,46,1405.63,2586.21,0.00
2024-12-08 17:11:02,85,2307,39,46,1408.44,2586.74,0.00
2024-12-08 17:11:02,85,2308,39,46,1426.31,2587.00,0.00
2024-12-08 17:11:02,86,2308,39,47,1409.73,2587.01,0.00
2024-12-08 17:11:02,87,2307,39,48,1380.22,2587.32,0.00
2024-12-08 17:11:02,87,2308,39,48,1403.88,2588.00,0.00
2024-12-08 17:11:02,88,2308,39,49,1387.93,2588.01,0.00
2024-12-08 17:11:02,87,2308,38,49,1401.54,2588.09,0.00
2024-12-08 17:11:02,86,2308,38,48,1417.53,2588.09,0.00
2024-12-08 17:11:02,85,2308,37,48,1433.90,2588.09,0.00
2024-12-08 17:11:02,84,2308,37,47,1447.47,2588.18,0.00
2024-12-08 17:11:02,83,2308,36,47,1462.75,2588.25,0.00
2024-12-08 17:11:02,83,2309,36,47,1500.05,2589.00,0.00
2024-12-08 17:11:02,84,2309,37,47,1482.19,2589.01,0.00
2024-12-08 17:11:02,83,2309,36,47,1497.54,2589.11,0.00
2024-12-08 17:11:02,82,2309,35,47,1509.19,2589.17,0.00
2024-12-08 17:11:02,82,2310,35,47,1513.51,2590.00,0.00
2024-12-08 17:11:02,83,2310,35,48,1495.27,2590.01,0.00
2024-12-08 17:11:02,82,2310,35,47,1504.09,2590.18,0.00
2024-12-08 17:11:02,82,2311,35,47,1508.72,2591.00,0.00
2024-12-08 17:11:02,83,2311,36,47,1490.54,2591.01,0.00
2024-12-08 17:11:02,82,2311,35,47,1497.11,2591.21,0.00
2024-12-08 17:11:02,82,2312,35,47,1502.37,2592.00,0.00
2024-12-08 17:11:02,83,2312,36,47,1484.26,2592.01,0.00
2024-12-08 17:11:02,82,2312,36,46,1492.94,2592.20,0.00
2024-12-08 17:11:02,82,2313,36,46,1497.89,2593.00,0.00
2024-12-08 17:11:02,83,2313,36,47,1479.84,2593.01,0.00
2024-12-08 17:11:02,83,2314,36,47,1473.53,2594.00,0.00
2024-12-08 17:11:02,84,2314,37,47,1455.99,2594.01,0.00
2024-12-08 17:11:02,83,2314,36,47,1470.10,2594.01,0.00
2024-12-08 17:11:02,83,2315,36,47,1470.04,2595.00,0.00
2024-12-08 17:11:02,84,2315,36,48,1452.54,2595.01,0.00
2024-12-08 17:11:02,85,2314,37,48,1435.45,2595.04,0.00
2024-12-08 17:11:02,84,2314,36,48,1460.05,2595.21,0.00
2024-12-08 17:11:02,84,2315,36,48,1464.88,2596.00,0.00
2024-12-08 17:11:02,85,2315,37,48,1447.65,2596.01,0.00
2024-12-08 17:11:02,84,2315,36,48,1446.99,2596.46,0.00
2024-12-08 17:11:02,84,2316,36,48,1489.11,2597.00,0.00
2024-12-08 17:11:02,85,2316,37,48,1471.59,2597.01,0.00
2024-12-08 17:11:02,84,2316,36,48,1486.98,2597.08,0.00
2024-12-08 17:11:02,83,2316,36,47,1495.83,2597.19,0.00
2024-12-08 17:11:02,83,2317,36,47,1500.42,2598.00,0.00
2024-12-08 17:11:02,84,2317,36,48,1482.56,2598.01,0.00
2024-12-08 17:11:02,83,2317,36,47,1488.41,2598.17,0.00
2024-12-08 17:11:02,84,2316,36,48,1466.34,2598.35,0.00
2024-12-08 17:11:02,84,2317,36,48,1490.31,2599.00,0.00
2024-12-08 17:11:02,85,2317,37,48,1472.77,2599.01,0.00
2024-12-08 17:11:02,84,2317,36,48,1486.94,2599.13,0.00
2024-12-08 17:11:02,85,2316,37,48,1453.59,2599.51,0.00
2024-12-08 17:11:02,85,2317,37,48,1511.37,2600.00,0.00
2024-12-08 17:11:02,86,2317,38,48,1493.80,2600.01,0.00
2024-12-08 17:11:02,87,2316,38,49,1445.84,2600.74,0.00
2024-12-08 17:11:02,87,2317,38,49,1515.10,2601.00,0.00
2024-12-08 17:11:02,88,2317,39,49,1497.89,2601.01,0.00
2024-12-08 17:11:02,87,2317,39,48,1507.37,2601.16,0.00
2024-12-08 17:11:02,87,2318,39,48,1537.75,2602.00,0.00
2024-12-08 17:11:03,88,2318,40,48,1520.27,2602.01,0.00
2024-12-08 17:11:03,87,2318,40,47,1530.89,2602.06,0.00
2024-12-08 17:11:03,87,2319,40,47,1527.65,2603.00,0.00
2024-12-08 17:11:03,88,2319,40,48,1510.29,2603.01,0.00
2024-12-08 17:11:03,87,2319,40,47,1519.62,2603.17,0.00
2024-12-08 17:11:03,87,2320,40,47,1518.53,2604.00,0.00
2024-12-08 17:11:03,88,2320,41,47,1501.27,2604.01,0.00
2024-12-08 17:11:03,87,2320,40,47,1509.58,2604.12,0.00
2024-12-08 17:11:03,87,2321,40,47,1506.68,2605.00,0.00
2024-12-08 17:11:03,88,2321,41,47,1489.56,2605.01,0.00
2024-12-08 17:11:03,87,2321,41,46,1500.10,2605.02,0.00
2024-12-08 17:11:03,87,2322,41,46,1495.67,2606.00,0.00
2024-12-08 17:11:03,88,2322,41,47,1478.67,2606.01,0.00
2024-12-08 17:11:03,87,2322,41,46,1489.71,2606.14,0.00
2024-12-08 17:11:03,87,2323,41,46,1489.09,2607.00,0.00
2024-12-08 17:11:03,88,2323,41,47,1472.17,2607.01,0.00
2024-12-08 17:11:03,87,2323,41,46,1485.70,2607.14,0.00
2024-12-08 17:11:03,86,2323,41,45,1498.83,2607.15,0.00
2024-12-08 17:11:03,86,2324,41,45,1499.44,2608.00,0.00
2024-12-08 17:11:03,87,2324,41,46,1482.21,2608.01,0.00
2024-12-08 17:11:03,86,2324,40,46,1494.01,2608.09,0.00
2024-12-08 17:11:03,87,2323,41,46,1452.94,2608.82,0.00
2024-12-08 17:11:03,86,2323,40,46,1471.01,2608.84,0.00
2024-12-08 17:11:03,86,2324,40,46,1497.23,2609.00,0.00
2024-12-08 17:11:03,87,2324,41,46,1480.02,2609.01,0.00
2024-12-08 17:11:03,86,2324,40,46,1493.01,2609.08,0.00
2024-12-08 17:11:03,85,2324,39,46,1509.96,2609.09,0.00
2024-12-08 17:11:03,84,2324,39,45,1523.28,2609.12,0.00
2024-12-08 17:11:03,84,2325,39,45,1562.98,2610.00,0.00
2024-12-08 17:11:03,85,2325,40,45,1544.60,2610.01,0.00
2024-12-08 17:11:03,84,2325,39,45,1551.87,2610.20,0.00
2024-12-08 17:11:03,84,2326,39,45,1556.38,2611.00,0.00
2024-12-08 17:11:03,85,2326,39,46,1538.07,2611.01,0.00
2024-12-08 17:11:03,85,2327,39,46,1530.97,2612.00,0.00
2024-12-08 17:11:03,86,2327,39,47,1513.17,2612.01,0.00
2024-12-08 17:11:03,85,2327,39,46,1523.33,2612.14,0.00
2024-12-08 17:11:03,85,2328,39,46,1525.18,2613.00,0.00
2024-12-08 17:11:03,86,2328,39,47,1507.44,2613.01,0.00
2024-12-08 17:11:03,85,2328,38,47,1517.82,2613.05,0.00
2024-12-08 17:11:03,84,2328,37,47,1535.57,2613.05,0.00
2024-12-08 17:11:03,84,2329,37,47,1534.70,2614.00,0.00
2024-12-08 17:11:03,85,2329,37,48,1516.64,2614.01,0.00
2024-12-08 17:11:03,85,2330,37,48,1507.89,2615.00,0.00
2024-12-08 17:11:03,86,2330,38,48,1490.35,2615.01,0.00
2024-12-08 17:11:03,85,2330,37,48,1506.67,2615.04,0.00
2024-12-08 17:11:03,84,2330,36,48,1524.30,2615.04,0.00
2024-12-08 17:11:03,83,2330,36,47,1539.84,2615.10,0.00
2024-12-08 17:11:03,82,2330,35,47,1550.46,2615.42,0.00
2024-12-08 17:11:03,82,2331,35,47,1564.94,2616.00,0.00
2024-12-08 17:11:03,83,2331,36,47,1546.08,2616.01,0.00
2024-12-08 17:11:03,82,2331,35,47,1548.08,2616.18,0.00
2024-12-08 17:11:03,82,2332,35,47,1556.36,2617.00,0.00
2024-12-08 17:11:03,83,2332,35,48,1537.61,2617.01,0.00
2024-12-08 17:11:03,82,2332,34,48,1538.60,2617.32,0.00
2024-12-08 17:11:03,82,2333,34,48,1549.96,2618.00,0.00
2024-12-08 17:11:03,83,2333,35,48,1531.28,2618.01,0.00
2024-12-08 17:11:03,84,2332,35,49,1496.99,2618.42,0.00
2024-12-08 17:11:03,84,2333,35,49,1523.83,2619.00,0.00
2024-12-08 17:11:03,85,2333,35,50,1505.90,2619.01,0.00
2024-12-08 17:11:03,84,2333,35,49,1515.43,2619.10,0.00
2024-12-08 17:11:03,84,2334,35,49,1546.42,2620.00,0.00
2024-12-08 17:11:03,85,2334,35,50,1528.23,2620.01,0.00
2024-12-08 17:11:04,85,2335,35,50,1519.94,2621.00,0.00
2024-12-08 17:11:04,86,2335,36,50,1502.26,2621.01,0.00
2024-12-08 17:11:04,85,2335,36,49,1515.01,2621.05,0.00
2024-12-08 17:11:04,85,2336,36,49,1514.65,2622.00,0.00
2024-12-08 17:11:04,86,2336,37,49,1497.04,2622.01,0.00
2024-12-08 17:11:04,85,2336,37,48,1510.97,2622.08,0.00
2024-12-08 17:11:04,85,2337,37,48,1511.18,2623.00,0.00
2024-12-08 17:11:04,86,2337,37,49,1493.61,2623.01,0.00
2024-12-08 17:11:04,85,2337,36,49,1498.91,2623.24,0.00
2024-12-08 17:11:04,85,2338,36,49,1502.42,2624.00,0.00
2024-12-08 17:11:04,86,2338,37,49,1484.95,2624.01,0.00
2024-12-08 17:11:04,85,2338,37,48,1498.12,2624.09,0.00
2024-12-08 17:11:04,85,2339,37,48,1496.36,2625.00,0.00
2024-12-08 17:11:04,86,2339,37,49,1478.96,2625.01,0.00
2024-12-08 17:11:04,85,2339,37,48,1495.45,2625.04,0.00
2024-12-08 17:11:04,85,2340,37,48,1484.45,2626.00,0.00
2024-12-08 17:11:04,86,2340,38,48,1467.19,2626.01,0.00
2024-12-08 17:11:04,85,2340,37,48,1482.00,2626.07,0.00
2024-12-08 17:11:04,84,2340,37,47,1497.77,2626.07,0.00
2024-12-08 17:11:04,85,2339,37,48,1471.34,2626.44,0.00
2024-12-08 17:11:04,85,2340,37,48,1495.04,2627.00,0.00
2024-12-08 17:11:04,86,2340,38,48,1477.65,2627.01,0.00
2024-12-08 17:11:04,85,2340,37,48,1478.10,2627.20,0.00
2024-12-08 17:11:04,86,2339,37,49,1454.32,2627.48,0.00
2024-12-08 17:11:04,85,2339,37,48,1477.27,2627.60,0.00
2024-12-08 17:11:04,85,2340,37,48,1526.29,2628.00,0.00
2024-12-08 17:11:04,86,2340,37,49,1508.54,2628.01,0.00
2024-12-08 17:11:04,86,2341,37,49,1529.22,2629.00,0.00
2024-12-08 17:11:04,87,2341,37,50,1511.64,2629.01,0.00
2024-12-08 17:11:04,86,2341,37,49,1524.65,2629.09,0.00
2024-12-08 17:11:04,86,2342,37,49,1522.88,2630.00,0.00
2024-12-08 17:11:04,87,2342,38,49,1505.38,2630.01,0.00
2024-12-08 17:11:04,86,2342,38,48,1518.31,2630.09,0.00
2024-12-08 17:11:04,86,2343,38,48,1514.75,2631.00,0.00
2024-12-08 17:11:04,87,2343,39,48,1497.34,2631.01,0.00
2024-12-08 17:11:04,88,2342,39,49,1458.43,2631.55,0.00
2024-12-08 17:11:04,88,2343,39,49,1490.13,2632.00,0.00
2024-12-08 17:11:04,89,2343,39,50,1473.38,2632.01,0.00
2024-12-08 17:11:04,88,2343,39,49,1485.96,2632.09,0.00
2024-12-08 17:11:04,88,2344,39,49,1511.31,2633.00,0.00
2024-12-08 17:11:04,89,2344,40,49,1494.33,2633.01,0.00
2024-12-08 17:11:04,88,2344,39,49,1503.84,2633.07,0.00
2024-12-08 17:11:04,89,2343,40,49,1468.33,2633.53,0.00
2024-12-08 17:11:04,89,2344,40,49,1491.64,2634.00,0.00
2024-12-08 17:11:04,90,2344,41,49,1475.07,2634.01,0.00
2024-12-08 17:11:04,90,2345,41,49,1490.63,2635.00,0.00
2024-12-08 17:11:04,91,2345,42,49,1474.25,2635.01,0.00
2024-12-08 17:11:04,90,2345,42,48,1487.55,2635.08,0.00
2024-12-08 17:11:04,89,2345,42,47,1482.96,2635.78,0.00
2024-12-08 17:11:04,89,2346,42,47,1500.92,2636.00,0.00
2024-12-08 17:11:04,90,2346,42,48,1484.24,2636.01,0.00
2024-12-08 17:11:04,89,2346,41,48,1499.90,2636.03,0.00
2024-12-08 17:11:04,88,2346,41,47,1514.25,2636.08,0.00
2024-12-08 17:11:04,88,2347,41,47,1510.99,2637.00,0.00
2024-12-08 17:11:04,89,2347,41,48,1494.01,2637.01,0.00
2024-12-08 17:11:04,89,2348,41,48,1481.79,2638.00,0.00
2024-12-08 17:11:04,90,2348,41,49,1465.32,2638.01,0.00
2024-12-08 17:11:04,89,2348,41,48,1478.25,2638.09,0.00
2024-12-08 17:11:04,88,2348,40,48,1489.37,2638.31,0.00
2024-12-08 17:11:04,88,2349,40,48,1490.49,2639.00,0.00
2024-12-08 17:11:04,89,2349,41,48,1473.74,2639.01,0.00
2024-12-08 17:11:04,88,2349,40,48,1488.70,2639.07,0.00
2024-12-08 17:11:04,87,2349,39,48,1481.01,2639.63,0.00
2024-12-08 17:11:05,87,2350,39,48,1495.86,2640.00,0.00
2024-12-08 17:11:05,88,2350,40,48,1478.86,2640.01,0.00
2024-12-08 17:11:05,88,2351,40,48,1467.29,2641.00,0.00
2024-12-08 17:11:05,89,2351,41,48,1450.81,2641.01,0.00
2024-12-08 17:11:05,88,2351,41,47,1462.81,2641.09,0.00
2024-12-08 17:11:05,87,2351,41,46,1473.12,2641.33,0.00
2024-12-08 17:11:05,87,2352,41,46,1478.02,2642.00,0.00
2024-12-08 17:11:05,88,2352,42,46,1461.22,2642.01,0.00
2024-12-08 17:11:05,89,2351,42,47,1444.51,2642.05,0.00
2024-12-08 17:11:05,88,2351,42,46,1481.37,2642.11,0.00
2024-12-08 17:11:05,88,2352,42,46,1481.61,2643.00,0.00
2024-12-08 17:11:05,89,2352,42,47,1464.96,2643.01,0.00
2024-12-08 17:11:05,88,2352,42,46,1480.43,2643.05,0.00
2024-12-08 17:11:05,88,2353,42,46,1503.14,2644.00,0.00
2024-12-08 17:11:05,89,2353,42,47,1486.25,2644.01,0.00
2024-12-08 17:11:05,88,2353,42,46,1499.56,2644.08,0.00
2024-12-08 17:11:05,88,2354,42,46,1498.14,2645.00,0.00
2024-12-08 17:11:05,89,2354,43,46,1481.31,2645.01,0.00
2024-12-08 17:11:05,90,2353,44,46,1464.55,2645.04,0.00
2024-12-08 17:11:05,89,2353,43,46,1480.73,2645.08,0.00
2024-12-08 17:11:05,88,2353,42,46,1472.14,2645.76,0.00
2024-12-08 17:11:05,88,2354,42,46,1496.09,2646.00,0.00
2024-12-08 17:11:05,89,2354,42,47,1479.28,2646.01,0.00
2024-12-08 17:11:05,88,2354,42,46,1492.81,2646.07,0.00
2024-12-08 17:11:05,89,2353,42,47,1460.21,2646.67,0.00
2024-12-08 17:11:05,89,2354,42,47,1524.41,2647.00,0.00
2024-12-08 17:11:05,90,2354,42,48,1507.48,2647.01,0.00
2024-12-08 17:11:05,90,2355,42,48,1528.22,2648.00,0.00
2024-12-08 17:11:05,91,2355,43,48,1511.43,2648.01,0.00
2024-12-08 17:11:05,90,2355,43,47,1525.30,2648.07,0.00
2024-12-08 17:11:05,89,2355,42,47,1525.91,2648.57,0.00
2024-12-08 17:11:05,89,2356,42,47,1544.69,2649.00,0.00
2024-12-08 17:11:05,90,2356,43,47,1527.53,2649.01,0.00
2024-12-08 17:11:05,90,2357,43,47,1518.09,2650.00,0.00
2024-12-08 17:11:05,91,2357,43,48,1501.41,2650.01,0.00
2024-12-08 17:11:05,90,2357,43,47,1515.46,2650.07,0.00
2024-12-08 17:11:05,90,2358,43,47,1512.83,2651.00,0.00
2024-12-08 17:11:05,91,2358,43,48,1496.20,2651.01,0.00
2024-12-08 17:11:05,90,2358,42,48,1484.44,2651.50,0.00
2024-12-08 17:11:05,90,2359,42,48,1501.02,2652.00,0.00
2024-12-08 17:11:05,91,2359,43,48,1484.53,2652.01,0.00
2024-12-08 17:11:05,90,2359,43,47,1497.51,2652.09,0.00
2024-12-08 17:11:05,89,2359,42,47,1509.34,2652.27,0.00
2024-12-08 17:11:05,88,2359,41,47,1520.65,2652.42,0.00
2024-12-08 17:11:05,89,2358,41,48,1502.98,2652.46,0.00
2024-12-08 17:11:05,89,2359,41,48,1521.58,2653.00,0.00
2024-12-08 17:11:05,90,2359,41,49,1504.67,2653.01,0.00
2024-12-08 17:11:05,89,2359,40,49,1520.40,2653.05,0.00
2024-12-08 17:11:05,88,2359,39,49,1519.01,2653.46,0.00
2024-12-08 17:11:05,88,2360,39,49,1559.21,2654.00,0.00
2024-12-08 17:11:05,89,2360,39,50,1541.69,2654.01,0.00
2024-12-08 17:11:05,88,2360,39,49,1556.22,2654.08,0.00
2024-12-08 17:11:05,88,2361,39,49,1553.99,2655.00,0.00
2024-12-08 17:11:05,89,2361,40,49,1536.53,2655.01,0.00
2024-12-08 17:11:05,88,2361,39,49,1553.69,2655.01,0.00
2024-12-08 17:11:05,88,2362,39,49,1542.05,2656.00,0.00
2024-12-08 17:11:05,89,2362,40,49,1524.72,2656.01,0.00
2024-12-08 17:11:05,88,2362,40,48,1539.66,2656.07,0.00
2024-12-08 17:11:06,88,2363,40,48,1534.43,2657.00,0.00
2024-12-08 17:11:06,89,2363,41,48,1517.19,2657.01,0.00
2024-12-08 17:11:06,88,2363,40,48,1510.32,2657.47,0.00
2024-12-08 17:11:06,88,2364,40,48,1520.68,2658.00,0.00
2024-12-08 17:11:06,89,2364,41,48,1503.59,2658.01,0.00
2024-12-08 17:11:06,88,2364,41,47,1518.89,2658.07,0.00
2024-12-08 17:11:06,87,2364,40,47,1525.05,2658.37,0.00
2024-12-08 17:11:06,87,2365,40,47,1533.14,2659.00,0.00
2024-12-08 17:11:06,88,2365,40,48,1515.71,2659.01,0.00
2024-12-08 17:11:06,87,2365,40,47,1525.21,2659.07,0.00
2024-12-08 17:11:06,87,2366,40,47,1525.46,2660.00,0.00
2024-12-08 17:11:06,88,2366,41,47,1508.12,2660.01,0.00
2024-12-08 17:11:06,87,2366,40,47,1506.29,2660.28,0.00
2024-12-08 17:11:06,87,2367,40,47,1517.94,2661.00,0.00
2024-12-08 17:11:06,88,2367,41,47,1500.69,2661.01,0.00
2024-12-08 17:11:06,87,2367,40,47,1517.33,2661.02,0.00
2024-12-08 17:11:06,86,2367,40,46,1533.14,2661.08,0.00
2024-12-08 17:11:06,85,2367,39,46,1544.82,2661.31,0.00
2024-12-08 17:11:06,85,2368,39,46,1558.14,2662.00,0.00
2024-12-08 17:11:06,86,2368,40,46,1540.02,2662.01,0.00
2024-12-08 17:11:06,85,2368,40,45,1549.71,2662.08,0.00
2024-12-08 17:11:06,85,2369,40,45,1550.89,2663.00,0.00
2024-12-08 17:11:06,86,2369,41,45,1532.86,2663.01,0.00
2024-12-08 17:11:06,86,2370,41,45,1525.69,2664.00,0.00
2024-12-08 17:11:06,87,2370,41,46,1508.15,2664.01,0.00
2024-12-08 17:11:06,87,2371,41,46,1500.76,2665.00,0.00
2024-12-08 17:11:06,88,2371,41,47,1483.70,2665.01,0.00
2024-12-08 17:11:06,88,2372,41,47,1476.08,2666.00,0.00
2024-12-08 17:11:06,89,2372,42,47,1459.49,2666.01,0.00
2024-12-08 17:11:06,88,2372,42,46,1473.98,2666.08,0.00
2024-12-08 17:11:06,89,2371,43,46,1457.12,2666.11,0.00
2024-12-08 17:11:06,89,2372,43,46,1481.62,2667.00,0.00
2024-12-08 17:11:06,90,2372,44,46,1465.15,2667.01,0.00
2024-12-08 17:11:06,89,2372,43,46,1478.33,2667.03,0.00
2024-12-08 17:11:07,88,2372,43,45,1487.27,2667.09,0.00
2024-12-08 17:11:07,88,2373,43,45,1524.18,2668.00,0.00
2024-12-08 17:11:07,89,2373,43,46,1507.05,2668.01,0.00
2024-12-08 17:11:07,88,2373,43,45,1517.23,2668.07,0.00
2024-12-08 17:11:07,88,2374,43,45,1517.17,2669.00,0.00
2024-12-08 17:11:07,89,2374,44,45,1500.12,2669.01,0.00
2024-12-08 17:11:07,89,2375,44,45,1492.28,2670.00,0.00
2024-12-08 17:11:07,90,2375,45,45,1475.70,2670.01,0.00
2024-12-08 17:11:07,89,2375,44,45,1484.21,2670.09,0.00
2024-12-08 17:11:07,88,2375,43,45,1498.66,2670.13,0.00
2024-12-08 17:11:07,88,2376,43,45,1506.16,2671.00,0.00
2024-12-08 17:11:07,89,2376,44,45,1489.24,2671.01,0.00
2024-12-08 17:11:07,90,2375,44,46,1460.89,2671.26,0.00
2024-12-08 17:11:07,90,2376,44,46,1470.57,2672.00,0.00
2024-12-08 17:11:07,91,2376,44,47,1454.41,2672.01,0.00
2024-12-08 17:11:07,91,2377,44,47,1475.49,2673.00,0.00
2024-12-08 17:11:07,92,2377,45,47,1459.45,2673.01,0.00
2024-12-08 17:11:07,93,2376,45,48,1418.80,2673.76,0.00
2024-12-08 17:11:07,93,2377,45,48,1441.01,2674.00,0.00
2024-12-08 17:11:07,94,2377,46,48,1425.68,2674.01,0.00
2024-12-08 17:11:07,94,2378,46,48,1443.66,2675.00,0.00
2024-12-08 17:11:07,95,2378,47,48,1428.47,2675.01,0.00
2024-12-08 17:11:07,94,2378,47,47,1438.84,2675.06,0.00
2024-12-08 17:11:07,94,2379,47,47,1434.93,2676.00,0.00
2024-12-08 17:11:07,95,2379,47,48,1419.82,2676.01,0.00
2024-12-08 17:11:07,94,2379,47,47,1430.10,2676.06,0.00
2024-12-08 17:11:08,94,2380,47,47,1426.71,2677.00,0.00
2024-12-08 17:11:08,95,2380,48,47,1411.69,2677.01,0.00
2024-12-08 17:11:08,94,2380,48,46,1419.89,2677.09,0.00
2024-12-08 17:11:08,95,2379,48,47,1402.15,2677.21,0.00
2024-12-08 17:11:08,95,2380,48,47,1401.15,2678.00,0.00
2024-12-08 17:11:08,96,2380,48,48,1386.56,2678.01,0.00
2024-12-08 17:11:08,95,2380,48,47,1398.22,2678.08,0.00
2024-12-08 17:11:08,95,2381,48,47,1421.42,2679.00,0.00
2024-12-08 17:11:08,96,2381,49,47,1406.61,2679.01,0.00
2024-12-08 17:11:08,95,2381,49,46,1413.27,2679.11,0.00
2024-12-08 17:11:08,94,2381,48,46,1428.02,2679.11,0.00
2024-12-08 17:11:08,93,2381,47,46,1439.96,2679.24,0.00
2024-12-08 17:11:08,93,2382,47,46,1440.11,2680.00,0.00
2024-12-08 17:11:08,94,2382,47,47,1424.79,2680.01,0.00
2024-12-08 17:11:08,93,2382,47,46,1438.97,2680.04,0.00
2024-12-08 17:11:08,92,2382,46,46,1448.49,2680.04,0.00
2024-12-08 17:11:08,91,2382,46,45,1456.77,2680.10,0.00
2024-12-08 17:11:08,90,2382,45,45,1451.89,2680.87,0.00
2024-12-08 17:11:08,90,2383,45,45,1478.22,2681.00,0.00
2024-12-08 17:11:08,91,2383,45,46,1461.97,2681.01,0.00
2024-12-08 17:11:08,90,2383,44,46,1475.95,2681.09,0.00
2024-12-08 17:11:08,89,2383,43,46,1486.20,2681.09,0.00
2024-12-08 17:11:08,89,2384,43,46,1486.43,2682.00,0.00
2024-12-08 17:11:08,90,2384,43,47,1469.92,2682.01,0.00
2024-12-08 17:11:08,90,2385,43,47,1461.64,2683.00,0.00
2024-12-08 17:11:08,91,2385,43,48,1445.58,2683.01,0.00
2024-12-08 17:11:08,90,2385,43,47,1459.09,2683.09,0.00
2024-12-08 17:11:08,91,2384,44,47,1434.91,2683.42,0.00
2024-12-08 17:11:08,91,2385,44,47,1456.77,2684.00,0.00
2024-12-08 17:11:08,92,2385,45,47,1440.94,2684.01,0.00
2024-12-08 17:11:08,91,2385,45,46,1453.61,2684.09,0.00
2024-12-08 17:11:08,92,2384,46,46,1416.66,2684.91,0.00
2024-12-08 17:11:08,92,2385,46,46,1486.18,2685.00,0.00
2024-12-08 17:11:08,93,2385,47,46,1470.20,2685.01,0.00
2024-12-08 17:11:08,92,2385,46,46,1468.24,2685.22,0.00
2024-12-08 17:11:08,92,2386,46,46,1506.09,2686.00,0.00
2024-12-08 17:11:08,93,2386,46,47,1489.90,2686.01,0.00
2024-12-08 17:11:08,93,2387,46,47,1479.59,2687.00,0.00
2024-12-08 17:11:08,94,2387,47,47,1463.85,2687.01,0.00
2024-12-08 17:11:08,93,2387,46,47,1476.30,2687.06,0.00
2024-12-08 17:11:08,93,2388,46,47,1472.16,2688.00,0.00
2024-12-08 17:11:08,94,2388,47,47,1456.50,2688.01,0.00
2024-12-08 17:11:08,93,2388,46,47,1471.26,2688.03,0.00
2024-12-08 17:11:08,92,2388,46,46,1481.98,2688.07,0.00
2024-12-08 17:11:08,92,2389,46,46,1480.77,2689.00,0.00
2024-12-08 17:11:08,93,2389,46,47,1464.85,2689.01,0.00
2024-12-08 17:11:08,92,2389,46,46,1473.47,2689.07,0.00
2024-12-08 17:11:08,92,2390,46,46,1468.70,2690.00,0.00
2024-12-08 17:11:08,93,2390,47,46,1452.91,2690.01,0.00
2024-12-08 17:11:08,92,2390,47,45,1467.83,2690.03,0.00
2024-12-08 17:11:08,91,2390,46,45,1459.89,2690.49,0.00
2024-12-08 17:11:08,92,2389,46,46,1437.16,2690.77,0.00
2024-12-08 17:11:08,92,2390,46,46,1462.63,2691.00,0.00
2024-12-08 17:11:08,93,2390,47,46,1446.91,2691.01,0.00
2024-12-08 17:11:08,92,2390,46,46,1461.76,2691.03,0.00
2024-12-08 17:11:08,91,2390,46,45,1477.24,2691.04,0.00
2024-12-08 17:11:08,92,2389,47,45,1439.39,2691.89,0.00
2024-12-08 17:11:08,92,2390,47,45,1487.08,2692.00,0.00
2024-12-08 17:11:08,93,2390,48,45,1471.09,2692.01,0.00
2024-12-08 17:11:08,92,2390,47,45,1475.11,2692.12,0.00
2024-12-08 17:11:08,93,2389,48,45,1440.18,2692.86,0.00
2024-12-08 17:11:09,93,2390,48,45,1492.44,2693.00,0.00
2024-12-08 17:11:09,94,2390,48,46,1476.56,2693.01,0.00
2024-12-08 17:11:09,93,2390,48,45,1491.00,2693.05,0.00
2024-12-08 17:11:09,93,2391,48,45,1512.84,2694.00,0.00
2024-12-08 17:11:09,94,2391,48,46,1496.74,2694.01,0.00
2024-12-08 17:11:09,93,2391,48,45,1505.61,2694.05,0.00
2024-12-08 17:11:09,94,2390,48,46,1463.89,2694.83,0.00
2024-12-08 17:11:09,93,2390,47,46,1471.93,2694.91,0.00
2024-12-08 17:11:09,93,2391,47,46,1498.66,2695.00,0.00
2024-12-08 17:11:09,94,2391,47,47,1482.72,2695.01,0.00
2024-12-08 17:11:09,94,2392,47,47,1502.49,2696.00,0.00
2024-12-08 17:11:09,95,2392,47,48,1486.67,2696.01,0.00
2024-12-08 17:11:09,94,2392,47,47,1500.78,2696.05,0.00
2024-12-08 17:11:09,95,2391,48,47,1484.42,2696.10,0.00
2024-12-08 17:11:09,95,2392,48,47,1508.52,2697.00,0.00
2024-12-08 17:11:09,96,2392,49,47,1492.80,2697.01,0.00
2024-12-08 17:11:09,97,2391,49,48,1476.31,2697.07,0.00
2024-12-08 17:11:09,97,2392,49,48,1523.30,2698.00,0.00
2024-12-08 17:11:09,98,2392,50,48,1507.75,2698.01,0.00
2024-12-08 17:11:09,98,2393,50,48,1525.66,2699.00,0.00
2024-12-08 17:11:09,99,2393,50,49,1510.25,2699.01,0.00
2024-12-08 17:11:09,98,2393,49,49,1525.12,2699.02,0.00
2024-12-08 17:11:09,98,2394,49,49,1514.75,2700.00,0.00
2024-12-08 17:11:09,99,2394,49,50,1499.45,2700.01,0.00
2024-12-08 17:11:09,99,2395,49,50,1487.91,2701.00,0.00
2024-12-08 17:11:09,100,2395,50,50,1473.03,2701.01,0.00
2024-12-08 17:11:09,100,2396,50,50,1461.42,2702.00,0.00
2024-12-08 17:11:09,101,2396,50,51,1446.95,2702.01,0.00
2024-12-08 17:11:09,100,2396,50,50,1456.29,2702.04,0.00
2024-12-08 17:11:09,101,2395,51,50,1426.58,2702.59,0.00
2024-12-08 17:11:09,101,2396,51,50,1451.25,2703.00,0.00
2024-12-08 17:11:09,102,2396,51,51,1437.02,2703.01,0.00
2024-12-08 17:11:09,101,2396,51,50,1445.64,2703.04,0.00
2024-12-08 17:11:09,101,2397,51,50,1468.23,2704.00,0.00
2024-12-08 17:11:09,102,2397,51,51,1453.83,2704.01,0.00
2024-12-08 17:11:09,101,2397,51,50,1461.82,2704.05,0.00
2024-12-08 17:11:09,100,2397,50,50,1472.39,2704.12,0.00
2024-12-08 17:11:09,99,2397,49,50,1477.57,2704.49,0.00
2024-12-08 17:11:09,99,2398,49,50,1491.34,2705.00,0.00
2024-12-08 17:11:09,100,2398,49,51,1476.42,2705.01,0.00
2024-12-08 17:11:09,99,2398,49,50,1484.52,2705.05,0.00
2024-12-08 17:11:09,99,2399,49,50,1480.31,2706.00,0.00
2024-12-08 17:11:09,100,2399,50,50,1465.50,2706.01,0.00
2024-12-08 17:11:09,99,2399,49,50,1478.96,2706.05,0.00
2024-12-08 17:11:09,98,2399,49,49,1488.25,2706.05,0.00
2024-12-08 17:11:09,99,2398,49,50,1455.61,2706.53,0.00
2024-12-08 17:11:09,100,2397,50,50,1436.38,2706.96,0.00
2024-12-08 17:11:09,100,2398,50,50,1463.22,2707.00,0.00
2024-12-08 17:11:09,101,2398,50,51,1448.73,2707.01,0.00
2024-12-08 17:11:09,101,2399,50,51,1485.35,2708.00,0.00
2024-12-08 17:11:09,102,2399,51,51,1470.79,2708.01,0.00
2024-12-08 17:11:09,101,2399,51,50,1483.76,2708.06,0.00
2024-12-08 17:11:09,100,2399,50,50,1487.30,2708.36,0.00
2024-12-08 17:11:09,99,2399,49,50,1485.62,2708.72,0.00
2024-12-08 17:11:10,99,2400,49,50,1505.55,2709.00,0.00
2024-12-08 17:11:10,100,2400,50,50,1490.50,2709.01,0.00
2024-12-08 17:11:10,99,2400,50,49,1498.46,2709.06,0.00
2024-12-08 17:11:10,98,2400,49,49,1513.19,2709.06,0.00
2024-12-08 17:11:10,97,2400,49,48,1525.77,2709.13,0.00
2024-12-08 17:11:10,97,2401,49,48,1529.77,2710.00,0.00
2024-12-08 17:11:10,98,2401,49,49,1514.16,2710.01,0.00
2024-12-08 17:11:10,98,2402,49,49,1503.63,2711.00,0.00
2024-12-08 17:11:10,99,2402,49,50,1488.45,2711.01,0.00
2024-12-08 17:11:10,98,2402,49,49,1501.99,2711.06,0.00
2024-12-08 17:11:10,98,2403,49,49,1498.22,2712.00,0.00
2024-12-08 17:11:10,99,2403,50,49,1483.08,2712.01,0.00
2024-12-08 17:11:10,98,2403,50,48,1497.39,2712.03,0.00
2024-12-08 17:11:10,97,2403,50,47,1506.41,2712.05,0.00
2024-12-08 17:11:10,96,2403,49,47,1518.16,2712.12,0.00
2024-12-08 17:11:10,95,2403,48,47,1525.13,2712.45,0.00
2024-12-08 17:11:10,95,2404,48,47,1538.20,2713.00,0.00
2024-12-08 17:11:10,96,2404,49,47,1522.18,2713.01,0.00
2024-12-08 17:11:10,95,2404,48,47,1524.50,2713.26,0.00
2024-12-08 17:11:10,95,2405,48,47,1526.80,2714.00,0.00
2024-12-08 17:11:10,96,2405,49,47,1510.89,2714.01,0.00
2024-12-08 17:11:10,95,2405,48,47,1525.67,2714.05,0.00
2024-12-08 17:11:10,95,2406,48,47,1513.55,2715.00,0.00
2024-12-08 17:11:10,96,2406,49,47,1497.78,2715.01,0.00
2024-12-08 17:11:10,95,2406,48,47,1512.14,2715.06,0.00
2024-12-08 17:11:10,94,2406,47,47,1527.93,2715.06,0.00
2024-12-08 17:11:10,93,2406,46,47,1530.88,2715.16,0.00
2024-12-08 17:11:10,93,2407,46,47,1528.89,2716.00,0.00
2024-12-08 17:11:10,94,2407,47,47,1512.62,2716.01,0.00
2024-12-08 17:11:10,94,2408,47,47,1498.81,2717.00,0.00
2024-12-08 17:11:10,95,2408,48,47,1483.03,2717.01,0.00
2024-12-08 17:11:10,94,2408,48,46,1496.63,2717.07,0.00
2024-12-08 17:11:10,94,2409,48,46,1489.43,2718.00,0.00
2024-12-08 17:11:10,95,2409,49,46,1473.75,2718.01,0.00
2024-12-08 17:11:10,94,2409,49,45,1485.68,2718.04,0.00
2024-12-08 17:11:10,95,2408,49,46,1468.62,2718.12,0.00
2024-12-08 17:11:10,95,2409,49,46,1482.93,2719.00,0.00
2024-12-08 17:11:10,96,2409,50,46,1467.48,2719.01,0.00
2024-12-08 17:11:10,95,2409,50,45,1480.37,2719.05,0.00
2024-12-08 17:11:10,94,2409,50,44,1483.31,2719.44,0.00
2024-12-08 17:11:10,93,2409,49,44,1498.11,2719.47,0.00
2024-12-08 17:11:10,93,2410,49,44,1532.75,2720.00,0.00
2024-12-08 17:11:10,94,2410,49,45,1516.45,2720.01,0.00
2024-12-08 17:11:10,94,2411,49,45,1502.92,2721.00,0.00
2024-12-08 17:11:10,95,2411,49,46,1487.10,2721.01,0.00
2024-12-08 17:11:10,94,2411,48,46,1501.47,2721.01,0.00
2024-12-08 17:11:10,93,2411,47,46,1504.52,2721.27,0.00
2024-12-08 17:11:10,93,2412,47,46,1509.51,2722.00,0.00
2024-12-08 17:11:10,94,2412,48,46,1493.45,2722.01,0.00
2024-12-08 17:11:10,93,2412,47,46,1506.00,2722.01,0.00
2024-12-08 17:11:10,93,2413,47,46,1498.04,2723.00,0.00
2024-12-08 17:11:10,94,2413,48,46,1482.11,2723.01,0.00
2024-12-08 17:11:10,93,2413,47,46,1491.61,2723.04,0.00
2024-12-08 17:11:10,92,2413,47,45,1501.02,2723.07,0.00
2024-12-08 17:11:10,92,2414,47,45,1500.31,2724.00,0.00
2024-12-08 17:11:10,93,2414,48,45,1484.17,2724.01,0.00
2024-12-08 17:11:10,93,2415,48,45,1469.52,2725.00,0.00
2024-12-08 17:11:10,94,2415,49,45,1453.88,2725.01,0.00
2024-12-08 17:11:10,93,2415,49,44,1462.20,2725.06,0.00
2024-12-08 17:11:11,92,2415,48,44,1471.61,2725.17,0.00
2024-12-08 17:11:11,92,2416,48,44,1472.51,2726.00,0.00
2024-12-08 17:11:11,93,2416,48,45,1456.68,2726.01,0.00
2024-12-08 17:11:11,92,2416,48,44,1467.48,2726.05,0.00
2024-12-08 17:11:11,91,2416,47,44,1483.61,2726.06,0.00
2024-12-08 17:11:11,90,2416,46,44,1487.25,2726.47,0.00
2024-12-08 17:11:11,89,2416,45,44,1496.42,2726.69,0.00
2024-12-08 17:11:11,89,2417,45,44,1512.61,2727.00,0.00
2024-12-08 17:11:11,90,2417,46,44,1495.80,2727.01,0.00
2024-12-08 17:11:11,89,2417,46,43,1505.27,2727.06,0.00
2024-12-08 17:11:11,88,2417,45,43,1517.46,2727.24,0.00
2024-12-08 17:11:11,88,2418,45,43,1519.21,2728.00,0.00
2024-12-08 17:11:11,89,2418,46,43,1502.14,2728.01,0.00
2024-12-08 17:11:11,88,2418,46,42,1512.10,2728.06,0.00
2024-12-08 17:11:11,87,2418,45,42,1528.85,2728.07,0.00
2024-12-08 17:11:11,87,2419,45,42,1526.52,2729.00,0.00
2024-12-08 17:11:11,88,2419,46,42,1509.17,2729.01,0.00
2024-12-08 17:11:11,87,2419,46,41,1519.31,2729.06,0.00
2024-12-08 17:11:11,88,2418,47,41,1497.45,2729.25,0.00
2024-12-08 17:11:11,88,2419,47,41,1507.09,2730.00,0.00
2024-12-08 17:11:11,89,2419,47,42,1490.16,2730.01,0.00
2024-12-08 17:11:11,88,2419,47,41,1499.34,2730.06,0.00
2024-12-08 17:11:11,89,2418,48,41,1478.55,2730.23,0.00
2024-12-08 17:11:11,89,2419,48,41,1515.52,2731.00,0.00
2024-12-08 17:11:11,90,2419,49,41,1498.68,2731.01,0.00
2024-12-08 17:11:11,89,2419,49,40,1507.86,2731.06,0.00
2024-12-08 17:11:11,89,2420,49,40,1531.49,2732.00,0.00
2024-12-08 17:11:11,90,2420,49,41,1514.48,2732.01,0.00
2024-12-08 17:11:11,89,2420,48,41,1530.58,2732.02,0.00
2024-12-08 17:11:11,88,2420,47,41,1530.25,2732.38,0.00
2024-12-08 17:11:11,87,2420,47,40,1542.26,2732.58,0.00
2024-12-08 17:11:11,87,2421,47,40,1560.66,2733.00,0.00
2024-12-08 17:11:11,88,2421,47,41,1542.92,2733.01,0.00
2024-12-08 17:11:11,87,2421,47,40,1553.13,2733.05,0.00
2024-12-08 17:11:11,86,2421,46,40,1559.81,2733.22,0.00
2024-12-08 17:11:11,86,2422,46,40,1568.95,2734.00,0.00
2024-12-08 17:11:11,87,2422,47,40,1550.92,2734.01,0.00
2024-12-08 17:11:11,86,2422,47,39,1561.65,2734.05,0.00
2024-12-08 17:11:11,87,2421,48,39,1532.74,2734.47,0.00
2024-12-08 17:11:11,87,2422,48,39,1554.57,2735.00,0.00
2024-12-08 17:11:11,88,2422,48,40,1536.90,2735.01,0.00
2024-12-08 17:11:11,87,2422,48,39,1547.34,2735.05,0.00
2024-12-08 17:11:11,87,2423,48,39,1576.96,2736.00,0.00
2024-12-08 17:11:11,88,2423,49,39,1559.04,2736.01,0.00
2024-12-08 17:11:11,88,2424,49,39,1549.77,2737.00,0.00
2024-12-08 17:11:11,89,2424,50,39,1532.36,2737.01,0.00
2024-12-08 17:11:11,88,2424,50,38,1547.29,2737.07,0.00
2024-12-08 17:11:11,89,2423,51,38,1519.58,2737.47,0.00
2024-12-08 17:11:11,89,2424,51,38,1541.03,2738.00,0.00
2024-12-08 17:11:11,90,2424,51,39,1523.91,2738.01,0.00
2024-12-08 17:11:11,89,2424,50,39,1540.11,2738.05,0.00
2024-12-08 17:11:11,88,2424,49,39,1555.44,2738.07,0.00
2024-12-08 17:11:11,87,2424,48,39,1555.41,2738.48,0.00
2024-12-08 17:11:11,87,2425,48,39,1603.14,2739.00,0.00
2024-12-08 17:11:11,88,2425,48,40,1584.93,2739.01,0.00
2024-12-08 17:11:11,87,2425,48,39,1599.69,2739.07,0.00
2024-12-08 17:11:11,86,2425,47,39,1615.43,2739.08,0.00
2024-12-08 17:11:11,86,2426,47,39,1620.51,2740.00,0.00
2024-12-08 17:11:11,87,2426,48,39,1601.88,2740.01,0.00
2024-12-08 17:11:11,86,2426,47,39,1619.88,2740.02,0.00
2024-12-08 17:11:11,85,2426,46,39,1637.97,2740.05,0.00
2024-12-08 17:11:11,85,2427,46,39,1628.68,2741.00,0.00
2024-12-08 17:11:12,86,2427,46,40,1609.74,2741.01,0.00
2024-12-08 17:11:12,85,2427,46,39,1626.11,2741.05,0.00
2024-12-08 17:11:12,85,2428,46,39,1622.62,2742.00,0.00
2024-12-08 17:11:12,86,2428,46,40,1603.75,2742.01,0.00
2024-12-08 17:11:12,85,2428,45,40,1621.98,2742.02,0.00
2024-12-08 17:11:12,85,2429,45,40,1611.54,2743.00,0.00
2024-12-08 17:11:12,86,2429,45,41,1592.80,2743.01,0.00
2024-12-08 17:11:12,85,2429,44,41,1585.42,2743.65,0.00
2024-12-08 17:11:12,85,2430,44,41,1601.84,2744.00,0.00
2024-12-08 17:11:12,86,2430,45,41,1583.21,2744.01,0.00
2024-12-08 17:11:12,85,2430,44,41,1588.95,2744.22,0.00
2024-12-08 17:11:12,86,2429,44,42,1546.08,2744.86,0.00
2024-12-08 17:11:12,86,2430,44,42,1577.48,2745.00,0.00
2024-12-08 17:11:12,87,2430,45,42,1559.35,2745.01,0.00
2024-12-08 17:11:12,87,2431,45,42,1583.28,2746.00,0.00
2024-12-08 17:11:12,88,2431,45,43,1565.29,2746.01,0.00
2024-12-08 17:11:12,89,2430,46,43,1533.90,2746.32,0.00
2024-12-08 17:11:12,89,2431,46,43,1560.49,2747.00,0.00
2024-12-08 17:11:12,90,2431,47,43,1543.15,2747.01,0.00
2024-12-08 17:11:12,89,2431,47,42,1558.34,2747.05,0.00
2024-12-08 17:11:12,89,2432,47,42,1587.65,2748.00,0.00
2024-12-08 17:11:12,90,2432,48,42,1570.01,2748.01,0.00
2024-12-08 17:11:12,91,2431,48,43,1532.88,2748.53,0.00
2024-12-08 17:11:12,91,2432,48,43,1555.58,2749.00,0.00
2024-12-08 17:11:12,92,2432,48,44,1538.68,2749.01,0.00
2024-12-08 17:11:12,91,2432,48,43,1551.99,2749.12,0.00
2024-12-08 17:11:12,92,2431,48,44,1527.70,2749.38,0.00
2024-12-08 17:11:12,92,2432,48,44,1578.33,2750.00,0.00
2024-12-08 17:11:12,93,2432,48,45,1561.35,2750.01,0.00
2024-12-08 17:11:12,92,2432,48,44,1571.88,2750.12,0.00
2024-12-08 17:11:12,92,2433,48,44,1598.70,2751.00,0.00
2024-12-08 17:11:12,93,2433,48,45,1581.51,2751.01,0.00
2024-12-08 17:11:12,92,2433,47,45,1581.71,2751.20,0.00
2024-12-08 17:11:12,92,2434,47,45,1587.81,2752.00,0.00
2024-12-08 17:11:12,93,2434,48,45,1570.74,2752.01,0.00
2024-12-08 17:11:12,92,2434,47,45,1584.84,2752.09,0.00
2024-12-08 17:11:12,91,2434,47,44,1598.93,2752.11,0.00
2024-12-08 17:11:12,90,2434,46,44,1614.59,2752.19,0.00
2024-12-08 17:11:12,90,2435,46,44,1622.15,2753.00,0.00
2024-12-08 17:11:12,91,2435,46,45,1604.32,2753.01,0.00
2024-12-08 17:11:12,91,2436,46,45,1594.00,2754.00,0.00
2024-12-08 17:11:12,92,2436,47,45,1576.67,2754.01,0.00
2024-12-08 17:11:12,91,2436,47,44,1588.88,2754.11,0.00
2024-12-08 17:11:13,91,2437,47,44,1588.14,2755.00,0.00
2024-12-08 17:11:13,92,2437,48,44,1570.88,2755.01,0.00
2024-12-08 17:11:13,91,2437,47,44,1585.74,2755.09,0.00
2024-12-08 17:11:13,91,2438,47,44,1576.75,2756.00,0.00
2024-12-08 17:11:13,92,2438,48,44,1559.62,2756.01,0.00
2024-12-08 17:11:13,91,2438,48,43,1568.60,2756.10,0.00
2024-12-08 17:11:13,91,2439,48,43,1565.82,2757.00,0.00
2024-12-08 17:11:13,92,2439,48,44,1548.80,2757.01,0.00
2024-12-08 17:11:13,92,2440,48,44,1538.14,2758.00,0.00
2024-12-08 17:11:13,93,2440,49,44,1521.60,2758.01,0.00
2024-12-08 17:11:13,92,2440,48,44,1537.54,2758.02,0.00
2024-12-08 17:11:13,91,2440,48,43,1548.39,2758.09,0.00
2024-12-08 17:11:13,90,2440,47,43,1560.09,2758.13,0.00
2024-12-08 17:11:13,91,2439,47,44,1530.43,2758.55,0.00
2024-12-08 17:11:13,91,2440,47,44,1576.58,2759.00,0.00
2024-12-08 17:11:13,92,2440,47,45,1559.44,2759.01,0.00
2024-12-08 17:11:13,91,2440,46,45,1562.96,2759.13,0.00
2024-12-08 17:11:13,91,2441,46,45,1598.30,2760.00,0.00
2024-12-08 17:11:13,92,2441,47,45,1580.93,2760.01,0.00
2024-12-08 17:11:13,91,2441,47,44,1592.56,2760.11,0.00
2024-12-08 17:11:13,91,2442,47,44,1590.51,2761.00,0.00
2024-12-08 17:11:13,92,2442,48,44,1573.22,2761.01,0.00
2024-12-08 17:11:13,92,2443,48,44,1559.30,2762.00,0.00
2024-12-08 17:11:13,93,2443,49,44,1542.53,2762.01,0.00
2024-12-08 17:11:13,92,2443,49,43,1555.41,2762.04,0.00
2024-12-08 17:11:13,92,2444,49,43,1542.46,2763.00,0.00
2024-12-08 17:11:13,93,2444,50,43,1525.87,2763.01,0.00
2024-12-08 17:11:13,92,2444,50,42,1537.67,2763.10,0.00
2024-12-08 17:11:13,91,2444,49,42,1554.11,2763.10,0.00
2024-12-08 17:11:13,91,2445,49,42,1539.67,2764.00,0.00
2024-12-08 17:11:13,92,2445,50,42,1522.93,2764.01,0.00
2024-12-08 17:11:13,91,2445,50,41,1535.43,2764.06,0.00
2024-12-08 17:11:13,90,2445,50,40,1520.86,2764.82,0.00
2024-12-08 17:11:13,90,2446,50,40,1537.48,2765.00,0.00
2024-12-08 17:11:13,91,2446,50,41,1520.58,2765.01,0.00
2024-12-08 17:11:13,91,2447,50,41,1506.73,2766.00,0.00
2024-12-08 17:11:13,92,2447,50,42,1490.35,2766.01,0.00
2024-12-08 17:11:13,91,2447,50,41,1498.54,2766.08,0.00
2024-12-08 17:11:13,90,2447,49,41,1510.02,2766.23,0.00
2024-12-08 17:11:13,91,2446,50,41,1477.28,2766.81,0.00
2024-12-08 17:11:13,91,2447,50,41,1496.55,2767.00,0.00
2024-12-08 17:11:13,92,2447,50,42,1480.28,2767.01,0.00
2024-12-08 17:11:13,91,2447,49,42,1495.94,2767.02,0.00
2024-12-08 17:11:13,90,2447,49,41,1509.19,2767.07,0.00
2024-12-08 17:11:14,90,2448,49,41,1531.53,2768.00,0.00
2024-12-08 17:11:14,91,2448,50,41,1514.70,2768.01,0.00
2024-12-08 17:11:14,90,2448,49,41,1509.31,2768.33,0.00
2024-12-08 17:11:14,89,2448,49,40,1510.04,2768.79,0.00
2024-12-08 17:11:14,89,2449,49,40,1535.42,2769.00,0.00
2024-12-08 17:11:14,90,2449,50,40,1518.36,2769.01,0.00
2024-12-08 17:11:14,89,2449,49,40,1516.07,2769.46,0.00
2024-12-08 17:11:14,88,2449,48,40,1532.68,2769.48,0.00
2024-12-08 17:11:14,87,2449,47,40,1548.72,2769.51,0.00
2024-12-08 17:11:14,87,2450,47,40,1566.74,2770.00,0.00
2024-12-08 17:11:14,88,2450,47,41,1548.93,2770.01,0.00
2024-12-08 17:11:14,87,2450,47,40,1565.86,2770.03,0.00
2024-12-08 17:11:14,86,2450,47,39,1580.57,2770.07,0.00
2024-12-08 17:11:14,86,2451,47,39,1579.91,2771.00,0.00
2024-12-08 17:11:14,87,2451,48,39,1561.75,2771.01,0.00
2024-12-08 17:11:14,87,2452,48,39,1552.10,2772.00,0.00
2024-12-08 17:11:14,88,2452,48,40,1534.46,2772.01,0.00
2024-12-08 17:11:14,87,2452,47,40,1540.19,2772.10,0.00
2024-12-08 17:11:14,87,2453,47,40,1546.97,2773.00,0.00
2024-12-08 17:11:14,88,2453,47,41,1529.39,2773.01,0.00
2024-12-08 17:11:14,88,2454,47,41,1519.48,2774.00,0.00
2024-12-08 17:11:14,89,2454,47,42,1502.41,2774.01,0.00
2024-12-08 17:11:14,88,2454,47,41,1515.36,2774.08,0.00
2024-12-08 17:11:14,88,2455,47,41,1514.14,2775.00,0.00
2024-12-08 17:11:14,89,2455,47,42,1497.12,2775.01,0.00
2024-12-08 17:11:14,88,2455,47,41,1511.24,2775.07,0.00
2024-12-08 17:11:14,88,2456,47,41,1503.15,2776.00,0.00
2024-12-08 17:11:14,89,2456,47,42,1486.26,2776.01,0.00
2024-12-08 17:11:14,88,2456,46,42,1502.84,2776.01,0.00
2024-12-08 17:11:14,87,2456,46,41,1515.99,2776.07,0.00
2024-12-08 17:11:14,87,2457,46,41,1513.92,2777.00,0.00
2024-12-08 17:11:14,88,2457,47,41,1496.72,2777.01,0.00
2024-12-08 17:11:14,87,2457,46,41,1491.47,2777.51,0.00
2024-12-08 17:11:14,87,2458,46,41,1502.12,2778.00,0.00
2024-12-08 17:11:14,88,2458,47,41,1485.05,2778.01,0.00
2024-12-08 17:11:14,87,2458,46,41,1487.09,2778.26,0.00
2024-12-08 17:11:14,88,2457,47,41,1459.04,2778.69,0.00
2024-12-08 17:11:14,88,2458,47,41,1491.48,2779.00,0.00
2024-12-08 17:11:14,89,2458,47,42,1474.72,2779.01,0.00
2024-12-08 17:11:14,88,2458,46,42,1476.30,2779.27,0.00
2024-12-08 17:11:14,88,2459,46,42,1512.43,2780.00,0.00
2024-12-08 17:11:14,89,2459,46,43,1495.43,2780.01,0.00
2024-12-08 17:11:14,88,2459,46,42,1506.40,2780.07,0.00
2024-12-08 17:11:14,88,2460,46,42,1504.98,2781.00,0.00
2024-12-08 17:11:14,89,2460,46,43,1488.07,2781.01,0.00
2024-12-08 17:11:14,88,2460,46,42,1503.14,2781.05,0.00
2024-12-08 17:11:14,87,2460,45,42,1495.64,2781.48,0.00
2024-12-08 17:11:14,87,2461,45,42,1512.53,2782.00,0.00
2024-12-08 17:11:14,88,2461,45,43,1495.34,2782.01,0.00
2024-12-08 17:11:14,87,2461,45,42,1510.73,2782.06,0.00
2024-12-08 17:11:14,86,2461,44,42,1525.90,2782.12,0.00
2024-12-08 17:11:14,86,2462,44,42,1533.41,2783.00,0.00
2024-12-08 17:11:14,87,2462,45,42,1515.79,2783.01,0.00
2024-12-08 17:11:14,86,2462,44,42,1532.45,2783.04,0.00
2024-12-08 17:11:14,85,2462,43,42,1550.39,2783.04,0.00
2024-12-08 17:11:14,84,2462,43,41,1561.56,2783.05,0.00
2024-12-08 17:11:14,83,2462,42,41,1575.39,2783.23,0.00
2024-12-08 17:11:14,83,2463,42,41,1580.80,2784.00,0.00
2024-12-08 17:11:14,84,2463,42,42,1561.98,2784.01,0.00
2024-12-08 17:11:14,83,2463,41,42,1580.13,2784.02,0.00
2024-12-08 17:11:14,82,2463,41,41,1591.93,2784.04,0.00
2024-12-08 17:11:14,81,2463,40,41,1606.11,2784.12,0.00
2024-12-08 17:11:14,82,2462,41,41,1575.83,2784.54,0.00
2024-12-08 17:11:14,82,2463,41,41,1608.65,2785.00,0.00
2024-12-08 17:11:14,83,2463,42,41,1589.27,2785.01,0.00
2024-12-08 17:11:14,82,2463,42,40,1600.84,2785.04,0.00
2024-12-08 17:11:15,82,2464,42,40,1635.60,2786.00,0.00
2024-12-08 17:11:15,83,2464,43,40,1615.90,2786.01,0.00
2024-12-08 17:11:15,82,2464,43,39,1627.80,2786.04,0.00
2024-12-08 17:11:15,82,2465,43,39,1628.67,2787.00,0.00
2024-12-08 17:11:15,83,2465,44,39,1609.05,2787.01,0.00
2024-12-08 17:11:15,82,2465,44,38,1624.13,2787.04,0.00
2024-12-08 17:11:15,82,2466,44,38,1624.87,2788.00,0.00
2024-12-08 17:11:15,83,2466,45,38,1605.29,2788.01,0.00
2024-12-08 17:11:15,83,2467,45,38,1598.36,2789.00,0.00
2024-12-08 17:11:15,84,2467,45,39,1579.33,2789.01,0.00
2024-12-08 17:11:15,84,2468,45,39,1571.97,2790.00,0.00
2024-12-08 17:11:15,85,2468,46,39,1553.48,2790.01,0.00
2024-12-08 17:11:15,85,2469,46,39,1545.68,2791.00,0.00
2024-12-08 17:11:15,86,2469,47,39,1527.71,2791.01,0.00
2024-12-08 17:11:15,85,2469,47,38,1538.47,2791.06,0.00
2024-12-08 17:11:15,84,2469,47,37,1556.45,2791.06,0.00
2024-12-08 17:11:15,85,2468,48,37,1537.81,2791.09,0.00
2024-12-08 17:11:15,85,2469,48,37,1569.99,2792.00,0.00
2024-12-08 17:11:15,86,2469,48,38,1551.73,2792.01,0.00
2024-12-08 17:11:15,86,2470,48,38,1575.07,2793.00,0.00
2024-12-08 17:11:15,87,2470,48,39,1556.96,2793.01,0.00
2024-12-08 17:11:15,86,2470,48,38,1570.87,2793.09,0.00
2024-12-08 17:11:15,85,2470,47,38,1580.71,2793.40,0.00
2024-12-08 17:11:15,85,2471,47,38,1588.79,2794.00,0.00
2024-12-08 17:11:15,86,2471,47,39,1570.31,2794.01,0.00
2024-12-08 17:11:15,85,2471,46,39,1587.48,2794.06,0.00
2024-12-08 17:11:15,86,2470,46,40,1540.69,2794.64,0.00
2024-12-08 17:11:15,86,2471,46,40,1570.18,2795.00,0.00
2024-12-08 17:11:15,87,2471,46,41,1552.13,2795.01,0.00
2024-12-08 17:11:15,86,2471,46,40,1566.30,2795.08,0.00
2024-12-08 17:11:15,86,2472,46,40,1597.49,2796.00,0.00
2024-12-08 17:11:15,87,2472,47,40,1579.13,2796.01,0.00
2024-12-08 17:11:15,86,2472,46,40,1595.88,2796.07,0.00
2024-12-08 17:11:15,86,2473,46,40,1588.43,2797.00,0.00
2024-12-08 17:11:15,87,2473,46,41,1570.17,2797.01,0.00
2024-12-08 17:11:15,88,2472,47,41,1537.17,2797.35,0.00
2024-12-08 17:11:15,88,2473,47,41,1566.63,2798.00,0.00
2024-12-08 17:11:15,89,2473,47,42,1549.02,2798.01,0.00
2024-12-08 17:11:15,88,2473,47,41,1563.78,2798.07,0.00
2024-12-08 17:11:15,88,2474,47,41,1594.50,2799.00,0.00
2024-12-08 17:11:15,89,2474,48,41,1576.58,2799.01,0.00
2024-12-08 17:11:15,88,2474,48,40,1589.43,2799.10,0.00
2024-12-08 17:11:15,89,2473,49,40,1553.55,2799.73,0.00
2024-12-08 17:11:15,89,2474,49,40,1592.80,2800.00,0.00
2024-12-08 17:11:15,90,2474,49,41,1575.11,2800.01,0.00
2024-12-08 17:11:15,90,2475,49,41,1594.50,2801.00,0.00
2024-12-08 17:11:15,91,2475,50,41,1576.98,2801.01,0.00
2024-12-08 17:11:15,90,2475,50,40,1588.30,2801.12,0.00
2024-12-08 17:11:15,91,2474,50,41,1562.15,2801.45,0.00
2024-12-08 17:11:15,91,2475,50,41,1588.11,2802.00,0.00
2024-12-08 17:11:15,92,2475,51,41,1570.85,2802.01,0.00
2024-12-08 17:11:15,91,2475,50,41,1587.50,2802.02,0.00
2024-12-08 17:11:15,90,2475,49,41,1584.40,2802.50,0.00
2024-12-08 17:11:15,90,2476,49,41,1629.89,2803.00,0.00
2024-12-08 17:11:15,91,2476,49,42,1611.98,2803.01,0.00
2024-12-08 17:11:15,90,2476,48,42,1628.34,2803.06,0.00
2024-12-08 17:11:15,91,2475,49,42,1571.03,2803.96,0.00
2024-12-08 17:11:15,91,2476,49,42,1603.88,2804.00,0.00
2024-12-08 17:11:15,92,2476,49,43,1586.45,2804.01,0.00
2024-12-08 17:11:15,91,2476,49,42,1598.36,2804.11,0.00
2024-12-08 17:11:16,91,2477,49,42,1621.85,2805.00,0.00
2024-12-08 17:11:16,92,2477,50,42,1604.22,2805.01,0.00
2024-12-08 17:11:16,91,2477,50,41,1612.93,2805.11,0.00
2024-12-08 17:11:16,90,2477,49,41,1627.77,2805.22,0.00
2024-12-08 17:11:16,90,2478,49,41,1623.68,2806.00,0.00
2024-12-08 17:11:16,91,2478,50,41,1605.84,2806.01,0.00
2024-12-08 17:11:16,90,2478,49,41,1622.14,2806.07,0.00
2024-12-08 17:11:16,90,2479,49,41,1608.67,2807.00,0.00
2024-12-08 17:11:16,91,2479,49,42,1590.99,2807.01,0.00
2024-12-08 17:11:16,90,2479,49,41,1602.77,2807.12,0.00
2024-12-08 17:11:16,90,2480,49,41,1595.61,2808.00,0.00
2024-12-08 17:11:16,91,2480,49,42,1578.08,2808.01,0.00
2024-12-08 17:11:16,90,2480,48,42,1594.99,2808.02,0.00
2024-12-08 17:11:16,90,2481,48,42,1578.92,2809.00,0.00
2024-12-08 17:11:16,91,2481,49,42,1561.57,2809.01,0.00
2024-12-08 17:11:16,90,2481,48,42,1578.29,2809.02,0.00
2024-12-08 17:11:16,89,2481,48,41,1590.05,2809.12,0.00
2024-12-08 17:11:16,88,2481,47,41,1598.18,2809.47,0.00
2024-12-08 17:11:16,87,2481,46,41,1607.44,2809.70,0.00
2024-12-08 17:11:16,87,2482,46,41,1618.91,2810.00,0.00
2024-12-08 17:11:16,88,2482,47,41,1600.51,2810.01,0.00
2024-12-08 17:11:16,89,2481,48,41,1559.27,2810.58,0.00
2024-12-08 17:11:16,89,2482,48,41,1589.37,2811.00,0.00
2024-12-08 17:11:16,90,2482,48,42,1571.71,2811.01,0.00
2024-12-08 17:11:16,89,2482,48,41,1583.39,2811.12,0.00
2024-12-08 17:11:16,89,2483,48,41,1599.79,2812.00,0.00
2024-12-08 17:11:16,90,2483,49,41,1582.01,2812.01,0.00
2024-12-08 17:11:16,91,2482,50,41,1554.46,2812.18,0.00
2024-12-08 17:11:16,90,2482,50,40,1588.41,2812.23,0.00
2024-12-08 17:11:16,90,2483,50,40,1578.71,2813.00,0.00
2024-12-08 17:11:16,91,2483,51,40,1561.36,2813.01,0.00
2024-12-08 17:11:16,90,2483,51,39,1572.79,2813.12,0.00
2024-12-08 17:11:16,89,2483,50,39,1559.20,2813.81,0.00
2024-12-08 17:11:16,88,2483,49,39,1571.39,2813.88,0.00
2024-12-08 17:11:16,88,2484,49,39,1630.08,2814.00,0.00
2024-12-08 17:11:16,89,2484,50,39,1611.76,2814.01,0.00
2024-12-08 17:11:16,88,2484,49,39,1627.85,2814.08,0.00
2024-12-08 17:11:16,88,2485,49,39,1616.19,2815.00,0.00
2024-12-08 17:11:16,89,2485,49,40,1598.03,2815.01,0.00
2024-12-08 17:11:16,90,2484,49,41,1579.66,2815.06,0.00
2024-12-08 17:11:16,90,2485,49,41,1595.84,2816.00,0.00
2024-12-08 17:11:16,91,2485,49,42,1578.31,2816.01,0.00
2024-12-08 17:11:16,90,2485,49,41,1590.86,2816.11,0.00
2024-12-08 17:11:16,90,2486,49,41,1616.59,2817.00,0.00
2024-12-08 17:11:16,91,2486,49,42,1598.82,2817.01,0.00
2024-12-08 17:11:16,90,2486,48,42,1614.42,2817.09,0.00
2024-12-08 17:11:16,89,2486,47,42,1632.25,2817.09,0.00
2024-12-08 17:11:16,88,2486,47,41,1648.55,2817.09,0.00
2024-12-08 17:11:16,87,2486,46,41,1652.71,2817.48,0.00
2024-12-08 17:11:16,87,2487,46,41,1664.01,2818.00,0.00
2024-12-08 17:11:16,88,2487,47,41,1645.10,2818.01,0.00
2024-12-08 17:11:16,88,2488,47,41,1636.54,2819.00,0.00
2024-12-08 17:11:16,89,2488,47,42,1618.15,2819.01,0.00
2024-12-08 17:11:16,89,2489,47,42,1609.56,2820.00,0.00
2024-12-08 17:11:16,90,2489,47,43,1591.67,2820.01,0.00
2024-12-08 17:11:16,90,2490,47,43,1583.15,2821.00,0.00
2024-12-08 17:11:16,91,2490,48,43,1565.75,2821.01,0.00
2024-12-08 17:11:16,91,2491,48,43,1557.00,2822.00,0.00
2024-12-08 17:11:16,92,2491,49,43,1540.08,2822.01,0.00
2024-12-08 17:11:16,93,2490,50,43,1500.11,2822.66,0.00
2024-12-08 17:11:17,93,2491,50,43,1523.15,2823.00,0.00
2024-12-08 17:11:17,94,2491,51,43,1506.94,2823.01,0.00
2024-12-08 17:11:17,93,2491,51,42,1518.01,2823.09,0.00
2024-12-08 17:11:17,92,2491,50,42,1523.01,2823.49,0.00
2024-12-08 17:11:17,92,2492,50,42,1564.19,2824.00,0.00
2024-12-08 17:11:17,93,2492,50,43,1547.37,2824.01,0.00
2024-12-08 17:11:17,92,2492,50,42,1560.69,2824.10,0.00
2024-12-08 17:11:17,92,2493,50,42,1560.15,2825.00,0.00
2024-12-08 17:11:17,93,2493,51,42,1543.38,2825.01,0.00
2024-12-08 17:11:17,93,2494,51,42,1533.92,2826.00,0.00
2024-12-08 17:11:17,94,2494,52,42,1517.60,2826.01,0.00
2024-12-08 17:11:17,93,2494,51,42,1516.36,2826.25,0.00
2024-12-08 17:11:17,93,2495,51,42,1525.60,2827.00,0.00
2024-12-08 17:11:17,94,2495,51,43,1509.37,2827.01,0.00
2024-12-08 17:11:17,93,2495,50,43,1524.40,2827.04,0.00
2024-12-08 17:11:17,92,2495,49,43,1539.44,2827.09,0.00
2024-12-08 17:11:17,91,2495,49,42,1555.43,2827.10,0.00
2024-12-08 17:11:17,91,2496,49,42,1554.88,2828.00,0.00
2024-12-08 17:11:17,92,2496,49,43,1537.98,2828.01,0.00
2024-12-08 17:11:17,91,2496,49,42,1551.18,2828.10,0.00
2024-12-08 17:11:17,91,2497,49,42,1550.55,2829.00,0.00
2024-12-08 17:11:17,92,2497,50,42,1533.70,2829.01,0.00
2024-12-08 17:11:17,91,2497,49,42,1550.24,2829.01,0.00
2024-12-08 17:11:17,90,2497,48,42,1566.54,2829.03,0.00
2024-12-08 17:11:17,89,2497,47,42,1572.87,2829.19,0.00
2024-12-08 17:11:17,89,2498,47,42,1575.90,2830.00,0.00
2024-12-08 17:11:17,90,2498,48,42,1558.39,2830.01,0.00
2024-12-08 17:11:17,89,2498,47,42,1574.97,2830.03,0.00
2024-12-08 17:11:17,89,2499,47,42,1567.23,2831.00,0.00
2024-12-08 17:11:17,90,2499,48,42,1549.82,2831.01,0.00
2024-12-08 17:11:17,89,2499,48,41,1564.40,2831.08,0.00
2024-12-08 17:11:17,89,2500,48,41,1564.29,2832.00,0.00
2024-12-08 17:11:17,90,2500,49,41,1546.91,2832.01,0.00
2024-12-08 17:11:17,89,2500,49,40,1559.55,2832.11,0.00
2024-12-08 17:11:17,89,2501,49,40,1560.38,2833.00,0.00
2024-12-08 17:11:17,90,2501,50,40,1543.05,2833.01,0.00
2024-12-08 17:11:17,89,2501,49,40,1559.70,2833.03,0.00
2024-12-08 17:11:17,88,2501,48,40,1557.59,2833.38,0.00
2024-12-08 17:11:17,88,2502,48,40,1572.49,2834.00,0.00
2024-12-08 17:11:17,89,2502,49,40,1554.82,2834.01,0.00
2024-12-08 17:11:17,89,2503,49,40,1546.45,2835.00,0.00
2024-12-08 17:11:17,90,2503,50,40,1529.27,2835.01,0.00
2024-12-08 17:11:17,89,2503,50,39,1542.36,2835.11,0.00
2024-12-08 17:11:17,89,2504,50,39,1543.18,2836.00,0.00
2024-12-08 17:11:17,90,2504,51,39,1526.03,2836.01,0.00
2024-12-08 17:11:17,89,2504,51,38,1539.07,2836.11,0.00
2024-12-08 17:11:17,88,2504,50,38,1554.95,2836.11,0.00
2024-12-08 17:11:17,88,2505,50,38,1562.55,2837.00,0.00
2024-12-08 17:11:17,89,2505,51,38,1545.00,2837.01,0.00
2024-12-08 17:11:17,88,2505,50,38,1542.12,2837.50,0.00
2024-12-08 17:11:17,88,2506,50,38,1554.07,2838.00,0.00
2024-12-08 17:11:17,89,2506,51,38,1536.61,2838.01,0.00
2024-12-08 17:11:17,88,2506,51,37,1548.31,2838.13,0.00
2024-12-08 17:11:17,88,2507,51,37,1549.78,2839.00,0.00
2024-12-08 17:11:17,89,2507,51,38,1532.37,2839.01,0.00
2024-12-08 17:11:17,88,2507,50,38,1536.31,2839.26,0.00
2024-12-08 17:11:18,88,2508,50,38,1541.61,2840.00,0.00
2024-12-08 17:11:18,89,2508,50,39,1524.29,2840.01,0.00
2024-12-08 17:11:18,90,2507,50,40,1489.21,2840.46,0.00
2024-12-08 17:11:18,89,2507,49,40,1516.84,2840.54,0.00
2024-12-08 17:11:18,89,2508,49,40,1536.00,2841.00,0.00
2024-12-08 17:11:18,90,2508,50,40,1518.93,2841.01,0.00
2024-12-08 17:11:18,89,2508,50,39,1528.38,2841.12,0.00
2024-12-08 17:11:18,88,2508,49,39,1527.26,2841.65,0.00
2024-12-08 17:11:18,88,2509,49,39,1582.10,2842.00,0.00
2024-12-08 17:11:18,89,2509,50,39,1564.32,2842.01,0.00
2024-12-08 17:11:18,89,2510,50,39,1555.93,2843.00,0.00
2024-12-08 17:11:18,90,2510,50,40,1538.64,2843.01,0.00
2024-12-08 17:11:18,89,2510,50,39,1550.86,2843.14,0.00
2024-12-08 17:11:18,89,2511,50,39,1552.32,2844.00,0.00
2024-12-08 17:11:18,90,2511,50,40,1535.07,2844.01,0.00
2024-12-08 17:11:18,89,2511,49,40,1546.60,2844.08,0.00
2024-12-08 17:11:18,89,2512,49,40,1546.48,2845.00,0.00
2024-12-08 17:11:18,90,2512,49,41,1529.29,2845.01,0.00
2024-12-08 17:11:18,91,2511,49,42,1510.64,2845.10,0.00
2024-12-08 17:11:18,91,2512,49,42,1531.78,2846.00,0.00
2024-12-08 17:11:18,92,2512,50,42,1515.13,2846.01,0.00
2024-12-08 17:11:18,91,2512,49,42,1526.20,2846.14,0.00
2024-12-08 17:11:18,90,2512,49,41,1540.94,2846.15,0.00
2024-12-08 17:11:18,90,2513,49,41,1580.12,2847.00,0.00
2024-12-08 17:11:18,91,2513,50,41,1562.76,2847.01,0.00
2024-12-08 17:11:18,90,2513,49,41,1577.31,2847.11,0.00
2024-12-08 17:11:18,89,2513,49,40,1593.44,2847.12,0.00
2024-12-08 17:11:18,89,2514,49,40,1594.50,2848.00,0.00
2024-12-08 17:11:18,90,2514,49,41,1576.78,2848.01,0.00
2024-12-08 17:11:18,90,2515,49,41,1567.69,2849.00,0.00
2024-12-08 17:11:18,91,2515,49,42,1550.46,2849.01,0.00
2024-12-08 17:11:18,90,2515,48,42,1564.88,2849.11,0.00
2024-12-08 17:11:18,89,2515,48,41,1580.86,2849.11,0.00
2024-12-08 17:11:18,89,2516,48,41,1581.09,2850.00,0.00
2024-12-08 17:11:18,90,2516,49,41,1563.53,2850.01,0.00
2024-12-08 17:11:18,90,2517,49,41,1554.37,2851.00,0.00
2024-12-08 17:11:18,91,2517,49,42,1537.29,2851.01,0.00
2024-12-08 17:11:18,90,2517,49,41,1550.29,2851.11,0.00
2024-12-08 17:11:18,90,2518,49,41,1550.53,2852.00,0.00
2024-12-08 17:11:18,91,2518,49,42,1533.49,2852.01,0.00
2024-12-08 17:11:18,91,2519,49,42,1524.32,2853.00,0.00
2024-12-08 17:11:18,92,2519,50,42,1507.75,2853.01,0.00
2024-12-08 17:11:18,91,2519,50,41,1520.59,2853.11,0.00
2024-12-08 17:11:18,90,2519,49,41,1516.58,2853.80,0.00
2024-12-08 17:11:18,90,2520,49,41,1542.74,2854.00,0.00
2024-12-08 17:11:18,91,2520,49,42,1525.79,2854.01,0.00
2024-12-08 17:11:18,90,2520,48,42,1540.86,2854.07,0.00
2024-12-08 17:11:18,90,2521,48,42,1533.42,2855.00,0.00
2024-12-08 17:11:18,91,2521,49,42,1516.57,2855.01,0.00
2024-12-08 17:11:18,90,2521,49,41,1530.28,2855.10,0.00
2024-12-08 17:11:18,90,2522,49,41,1530.15,2856.00,0.00
2024-12-08 17:11:18,91,2522,50,41,1513.34,2856.01,0.00
2024-12-08 17:11:18,90,2522,49,41,1527.01,2856.10,0.00
2024-12-08 17:11:18,91,2521,50,41,1491.26,2856.57,0.00
2024-12-08 17:11:18,92,2520,51,41,1490.48,2856.88,0.00
2024-12-08 17:11:18,92,2521,51,41,1521.33,2857.00,0.00
2024-12-08 17:11:18,93,2521,52,41,1504.97,2857.01,0.00
2024-12-08 17:11:18,92,2521,52,40,1517.94,2857.10,0.00
2024-12-08 17:11:19,92,2522,52,40,1579.64,2858.00,0.00
2024-12-08 17:11:19,93,2522,52,41,1562.66,2858.01,0.00
2024-12-08 17:11:19,93,2523,52,41,1553.36,2859.00,0.00
2024-12-08 17:11:19,94,2523,52,42,1536.84,2859.01,0.00
2024-12-08 17:11:19,93,2523,52,41,1548.17,2859.13,0.00
2024-12-08 17:11:19,92,2523,51,41,1562.83,2859.13,0.00
2024-12-08 17:11:19,92,2524,51,41,1569.56,2860.00,0.00
2024-12-08 17:11:19,93,2524,52,41,1552.68,2860.01,0.00
2024-12-08 17:11:19,94,2523,53,41,1534.65,2860.09,0.00
2024-12-08 17:11:19,94,2524,53,41,1531.52,2861.00,0.00
2024-12-08 17:11:19,95,2524,54,41,1515.40,2861.01,0.00
2024-12-08 17:11:19,94,2524,54,40,1524.86,2861.15,0.00
2024-12-08 17:11:19,95,2523,55,40,1486.42,2861.75,0.00
2024-12-08 17:11:19,95,2524,55,40,1545.68,2862.00,0.00
2024-12-08 17:11:19,96,2524,56,40,1529.58,2862.01,0.00
2024-12-08 17:11:19,95,2524,55,40,1531.90,2862.28,0.00
2024-12-08 17:11:19,95,2525,55,40,1565.82,2863.00,0.00
2024-12-08 17:11:19,96,2525,55,41,1549.51,2863.01,0.00
2024-12-08 17:11:19,95,2525,54,41,1563.44,2863.08,0.00
2024-12-08 17:11:19,95,2526,54,41,1553.43,2864.00,0.00
2024-12-08 17:11:19,96,2526,55,41,1537.25,2864.01,0.00
2024-12-08 17:11:19,95,2526,55,40,1546.24,2864.17,0.00
2024-12-08 17:11:19,95,2527,55,40,1541.89,2865.00,0.00
2024-12-08 17:11:19,96,2527,56,40,1525.83,2865.01,0.00
2024-12-08 17:11:19,95,2527,55,40,1540.99,2865.04,0.00
2024-12-08 17:11:19,94,2527,55,39,1545.22,2865.16,0.00
2024-12-08 17:11:19,94,2528,55,39,1544.86,2866.00,0.00
2024-12-08 17:11:19,95,2528,55,40,1528.59,2866.01,0.00
2024-12-08 17:11:19,94,2528,54,40,1541.80,2866.11,0.00
2024-12-08 17:11:19,94,2529,54,40,1526.91,2867.00,0.00
2024-12-08 17:11:19,95,2529,55,40,1510.84,2867.01,0.00
2024-12-08 17:11:19,94,2529,55,39,1520.47,2867.15,0.00
2024-12-08 17:11:19,93,2529,55,38,1514.01,2867.73,0.00
2024-12-08 17:11:19,93,2530,55,38,1531.19,2868.00,0.00
2024-12-08 17:11:19,94,2530,56,38,1514.90,2868.01,0.00
2024-12-08 17:11:19,94,2531,56,38,1504.26,2869.00,0.00
2024-12-08 17:11:19,95,2531,57,38,1488.43,2869.01,0.00
2024-12-08 17:11:19,95,2532,57,38,1477.42,2870.00,0.00
2024-12-08 17:11:19,96,2532,58,38,1462.03,2870.01,0.00
2024-12-08 17:11:19,95,2532,57,38,1474.13,2870.12,0.00
2024-12-08 17:11:19,95,2533,57,38,1465.95,2871.00,0.00
2024-12-08 17:11:19,96,2533,57,39,1450.68,2871.01,0.00
2024-12-08 17:11:19,95,2533,56,39,1462.65,2871.12,0.00
2024-12-08 17:11:19,94,2533,55,39,1457.92,2871.53,0.00
2024-12-08 17:11:19,94,2534,55,39,1469.27,2872.00,0.00
2024-12-08 17:11:19,95,2534,56,39,1453.80,2872.01,0.00
2024-12-08 17:11:19,94,2534,56,38,1462.57,2872.13,0.00
2024-12-08 17:11:19,93,2534,56,37,1468.10,2872.46,0.00
2024-12-08 17:11:19,93,2535,56,37,1477.74,2873.00,0.00
2024-12-08 17:11:19,94,2535,56,38,1462.02,2873.01,0.00
2024-12-08 17:11:19,94,2536,56,38,1452.44,2874.00,0.00
2024-12-08 17:11:19,95,2536,57,38,1437.15,2874.01,0.00
2024-12-08 17:11:19,94,2536,57,37,1446.96,2874.13,0.00
2024-12-08 17:11:19,94,2537,57,37,1446.83,2875.00,0.00
2024-12-08 17:11:20,95,2537,58,37,1431.60,2875.01,0.00
2024-12-08 17:11:20,94,2537,57,37,1445.75,2875.04,0.00
2024-12-08 17:11:20,93,2537,56,37,1458.53,2875.12,0.00
2024-12-08 17:11:20,94,2536,56,38,1434.77,2875.21,0.00
2024-12-08 17:11:20,93,2536,55,38,1475.90,2875.27,0.00
2024-12-08 17:11:20,92,2536,54,38,1491.02,2875.30,0.00
2024-12-08 17:11:20,92,2537,54,38,1502.54,2876.00,0.00
2024-12-08 17:11:20,93,2537,55,38,1486.38,2876.01,0.00
2024-12-08 17:11:20,93,2538,55,38,1507.31,2877.00,0.00
2024-12-08 17:11:20,94,2538,55,39,1491.27,2877.01,0.00
2024-12-08 17:11:20,93,2538,55,38,1503.92,2877.12,0.00
2024-12-08 17:11:20,93,2539,55,38,1502.73,2878.00,0.00
2024-12-08 17:11:20,94,2539,56,38,1486.74,2878.01,0.00
2024-12-08 17:11:20,93,2539,56,37,1493.16,2878.12,0.00
2024-12-08 17:11:20,93,2540,56,37,1491.78,2879.00,0.00
2024-12-08 17:11:20,94,2540,57,37,1475.91,2879.01,0.00
2024-12-08 17:11:20,93,2540,57,36,1487.77,2879.13,0.00
2024-12-08 17:11:20,94,2539,57,37,1448.40,2879.93,0.00
2024-12-08 17:11:20,94,2540,57,37,1472.67,2880.00,0.00
2024-12-08 17:11:20,95,2540,58,37,1457.17,2880.01,0.00
2024-12-08 17:11:20,94,2540,58,36,1470.85,2880.06,0.00
2024-12-08 17:11:20,95,2539,58,37,1445.09,2880.23,0.00
2024-12-08 17:11:20,95,2540,58,37,1496.93,2881.00,0.00
2024-12-08 17:11:20,96,2540,59,37,1481.33,2881.01,0.00
2024-12-08 17:11:20,95,2540,58,37,1495.42,2881.05,0.00
2024-12-08 17:11:20,94,2540,58,36,1511.13,2881.05,0.00
2024-12-08 17:11:20,93,2540,58,35,1525.83,2881.10,0.00
2024-12-08 17:11:20,93,2541,58,35,1554.14,2882.00,0.00
2024-12-08 17:11:20,94,2541,59,35,1537.61,2882.01,0.00
2024-12-08 17:11:20,93,2541,59,34,1552.82,2882.05,0.00
2024-12-08 17:11:20,92,2541,58,34,1550.44,2882.50,0.00
2024-12-08 17:11:20,92,2542,58,34,1559.44,2883.00,0.00
2024-12-08 17:11:20,93,2542,59,34,1542.67,2883.01,0.00
2024-12-08 17:11:20,92,2542,59,33,1556.95,2883.09,0.00
2024-12-08 17:11:20,92,2543,59,33,1548.19,2884.00,0.00
2024-12-08 17:11:20,93,2543,59,34,1531.54,2884.01,0.00
2024-12-08 17:11:20,92,2543,59,33,1545.70,2884.09,0.00
2024-12-08 17:11:20,91,2543,58,33,1561.43,2884.10,0.00
2024-12-08 17:11:20,91,2544,58,33,1557.69,2885.00,0.00
2024-12-08 17:11:20,92,2544,59,33,1540.76,2885.01,0.00
2024-12-08 17:11:20,91,2544,58,33,1532.24,2885.58,0.00
2024-12-08 17:11:20,91,2545,58,33,1543.48,2886.00,0.00
2024-12-08 17:11:20,92,2545,58,34,1526.70,2886.01,0.00
2024-12-08 17:11:20,91,2545,58,33,1539.70,2886.11,0.00
2024-12-08 17:11:20,90,2545,57,33,1532.74,2886.78,0.00
2024-12-08 17:11:20,90,2546,57,33,1547.60,2887.00,0.00
2024-12-08 17:11:20,91,2546,58,33,1530.60,2887.01,0.00
2024-12-08 17:11:20,90,2546,57,33,1546.01,2887.06,0.00
2024-12-08 17:11:20,89,2546,57,32,1562.10,2887.09,0.00
2024-12-08 17:11:20,89,2547,57,32,1550.19,2888.00,0.00
2024-12-08 17:11:20,90,2547,58,32,1532.97,2888.01,0.00
2024-12-08 17:11:20,89,2547,57,32,1521.90,2888.78,0.00
2024-12-08 17:11:20,89,2548,57,32,1541.56,2889.00,0.00
2024-12-08 17:11:20,90,2548,58,32,1524.43,2889.01,0.00
2024-12-08 17:11:20,90,2549,58,32,1515.64,2890.00,0.00
2024-12-08 17:11:20,91,2549,58,33,1498.99,2890.01,0.00
2024-12-08 17:11:20,91,2550,58,33,1489.98,2891.00,0.00
2024-12-08 17:11:20,92,2550,59,33,1473.78,2891.01,0.00
2024-12-08 17:11:20,91,2550,58,33,1489.66,2891.01,0.00
2024-12-08 17:11:20,90,2550,57,33,1504.94,2891.04,0.00
2024-12-08 17:11:20,89,2550,56,33,1520.88,2891.08,0.00
2024-12-08 17:11:20,88,2550,56,32,1534.88,2891.08,0.00
2024-12-08 17:11:20,89,2549,57,32,1499.41,2891.74,0.00
2024-12-08 17:11:20,89,2550,57,32,1544.46,2892.00,0.00
2024-12-08 17:11:20,90,2550,57,33,1527.30,2892.01,0.00
2024-12-08 17:11:20,89,2550,56,33,1542.19,2892.02,0.00
2024-12-08 17:11:21,89,2551,56,33,1572.95,2893.00,0.00
2024-12-08 17:11:21,90,2551,56,34,1555.47,2893.01,0.00
2024-12-08 17:11:21,90,2552,56,34,1546.68,2894.00,0.00
2024-12-08 17:11:21,91,2552,57,34,1529.69,2894.01,0.00
2024-12-08 17:11:21,90,2552,57,33,1543.49,2894.10,0.00
2024-12-08 17:11:21,90,2553,57,33,1543.68,2895.00,0.00
2024-12-08 17:11:21,91,2553,58,33,1526.71,2895.01,0.00
2024-12-08 17:11:21,90,2553,58,32,1541.13,2895.09,0.00
2024-12-08 17:11:21,90,2554,58,32,1534.56,2896.00,0.00
2024-12-08 17:11:21,91,2554,59,32,1517.69,2896.01,0.00
2024-12-08 17:11:21,91,2555,59,32,1508.67,2897.00,0.00
2024-12-08 17:11:21,92,2555,59,33,1492.27,2897.01,0.00
2024-12-08 17:11:21,91,2555,59,32,1503.93,2897.13,0.00
2024-12-08 17:11:21,91,2556,59,32,1504.73,2898.00,0.00
2024-12-08 17:11:21,92,2556,59,33,1488.37,2898.01,0.00
2024-12-08 17:11:21,93,2555,60,33,1468.35,2898.17,0.00
2024-12-08 17:11:21,92,2555,60,32,1510.16,2898.21,0.00
2024-12-08 17:11:21,92,2556,60,32,1512.84,2899.00,0.00
2024-12-08 17:11:21,93,2556,60,33,1496.57,2899.01,0.00
2024-12-08 17:11:21,92,2556,59,33,1511.90,2899.03,0.00
2024-12-08 17:11:21,91,2556,58,33,1521.50,2899.18,0.00
2024-12-08 17:11:21,91,2557,58,33,1555.45,2900.00,0.00
2024-12-08 17:11:21,92,2557,59,33,1538.54,2900.01,0.00
2024-12-08 17:11:21,91,2557,58,33,1544.05,2900.15,0.00
2024-12-08 17:11:21,91,2558,58,33,1544.58,2901.00,0.00
2024-12-08 17:11:21,92,2558,58,34,1527.79,2901.01,0.00
2024-12-08 17:11:21,91,2558,57,34,1529.67,2901.30,0.00
2024-12-08 17:11:21,90,2558,56,34,1535.54,2901.53,0.00
2024-12-08 17:11:21,91,2557,56,35,1516.17,2901.64,0.00
2024-12-08 17:11:21,91,2558,56,35,1538.14,2902.00,0.00
2024-12-08 17:11:21,92,2558,56,36,1521.42,2902.01,0.00
2024-12-08 17:11:21,91,2558,55,36,1534.34,2902.13,0.00
2024-12-08 17:11:21,90,2558,55,35,1542.07,2902.26,0.00
2024-12-08 17:11:21,91,2557,56,35,1502.65,2902.75,0.00
2024-12-08 17:11:21,91,2558,56,35,1559.31,2903.00,0.00
2024-12-08 17:11:21,92,2558,57,35,1542.36,2903.01,0.00
2024-12-08 17:11:21,91,2558,57,34,1546.61,2903.25,0.00
2024-12-08 17:11:21,90,2558,56,34,1556.14,2903.41,0.00
2024-12-08 17:11:21,90,2559,56,34,1597.52,2904.00,0.00
2024-12-08 17:11:21,91,2559,56,35,1579.97,2904.01,0.00
2024-12-08 17:11:21,91,2560,56,35,1570.93,2905.00,0.00
2024-12-08 17:11:21,92,2560,56,36,1553.86,2905.01,0.00
2024-12-08 17:11:21,92,2561,56,36,1544.60,2906.00,0.00
2024-12-08 17:11:21,93,2561,56,37,1527.99,2906.01,0.00
2024-12-08 17:11:21,92,2561,55,37,1540.84,2906.14,0.00
2024-12-08 17:11:21,91,2561,55,36,1549.81,2906.24,0.00
2024-12-08 17:11:21,91,2562,55,36,1553.81,2907.00,0.00
2024-12-08 17:11:21,92,2562,55,37,1536.92,2907.01,0.00
2024-12-08 17:11:21,91,2562,54,37,1526.18,2907.52,0.00
2024-12-08 17:11:21,91,2563,54,37,1544.44,2908.00,0.00
2024-12-08 17:11:21,92,2563,55,37,1527.65,2908.01,0.00
2024-12-08 17:11:21,91,2563,55,36,1540.31,2908.14,0.00
2024-12-08 17:11:21,90,2563,54,36,1551.62,2908.22,0.00
2024-12-08 17:11:21,89,2563,54,35,1563.83,2908.23,0.00
2024-12-08 17:11:21,89,2564,54,35,1574.45,2909.00,0.00
2024-12-08 17:11:21,90,2564,54,36,1556.96,2909.01,0.00
2024-12-08 17:11:21,89,2564,53,36,1573.16,2909.05,0.00
2024-12-08 17:11:21,89,2565,53,36,1565.51,2910.00,0.00
2024-12-08 17:11:21,90,2565,54,36,1548.12,2910.01,0.00
2024-12-08 17:11:21,89,2565,53,36,1561.95,2910.14,0.00
2024-12-08 17:11:21,88,2565,53,35,1572.76,2910.21,0.00
2024-12-08 17:11:21,87,2565,52,35,1584.16,2910.23,0.00
2024-12-08 17:11:22,87,2566,52,35,1595.50,2911.00,0.00
2024-12-08 17:11:22,88,2566,52,36,1577.37,2911.01,0.00
2024-12-08 17:11:22,88,2567,52,36,1567.81,2912.00,0.00
2024-12-08 17:11:22,89,2567,52,37,1550.19,2912.01,0.00
2024-12-08 17:11:22,88,2567,51,37,1566.49,2912.05,0.00
2024-12-08 17:11:22,89,2566,52,37,1546.94,2912.14,0.00
2024-12-08 17:11:22,89,2567,52,37,1540.33,2913.00,0.00
2024-12-08 17:11:22,90,2567,53,37,1523.22,2913.01,0.00
2024-12-08 17:11:22,89,2567,52,37,1539.03,2913.05,0.00
2024-12-08 17:11:22,88,2567,52,36,1551.25,2913.18,0.00
2024-12-08 17:11:22,87,2567,51,36,1564.77,2913.29,0.00
2024-12-08 17:11:22,87,2568,51,36,1597.97,2914.00,0.00
2024-12-08 17:11:22,88,2568,51,37,1579.81,2914.01,0.00
2024-12-08 17:11:22,87,2568,50,37,1594.31,2914.14,0.00
2024-12-08 17:11:22,86,2568,50,36,1561.48,2914.84,0.00
2024-12-08 17:11:22,86,2569,50,36,1590.77,2915.00,0.00
2024-12-08 17:11:22,87,2569,51,36,1572.48,2915.01,0.00
2024-12-08 17:11:22,86,2569,50,36,1590.43,2915.01,0.00
2024-12-08 17:11:22,85,2569,50,35,1599.58,2915.18,0.00
2024-12-08 17:11:22,85,2570,50,35,1600.81,2916.00,0.00
2024-12-08 17:11:22,86,2570,51,35,1582.20,2916.01,0.00
2024-12-08 17:11:22,85,2570,51,34,1599.79,2916.04,0.00
2024-12-08 17:11:22,84,2570,50,34,1602.55,2916.18,0.00
2024-12-08 17:11:22,84,2571,50,34,1612.37,2917.00,0.00
2024-12-08 17:11:22,85,2571,50,35,1593.40,2917.01,0.00
2024-12-08 17:11:22,84,2571,50,34,1611.34,2917.04,0.00
2024-12-08 17:11:22,83,2571,50,33,1622.70,2917.16,0.00
2024-12-08 17:11:22,82,2571,49,33,1634.17,2917.44,0.00
2024-12-08 17:11:22,82,2572,49,33,1646.68,2918.00,0.00
2024-12-08 17:11:22,83,2572,50,33,1626.84,2918.01,0.00
2024-12-08 17:11:22,82,2572,49,33,1643.16,2918.13,0.00
2024-12-08 17:11:22,81,2572,48,33,1651.71,2918.28,0.00
2024-12-08 17:11:22,81,2573,48,33,1660.13,2919.00,0.00
2024-12-08 17:11:22,82,2573,49,33,1639.89,2919.01,0.00
2024-12-08 17:11:22,81,2573,49,32,1658.70,2919.05,0.00
2024-12-08 17:11:22,80,2573,49,31,1672.16,2919.14,0.00
2024-12-08 17:11:22,80,2574,49,31,1676.72,2920.00,0.00
2024-12-08 17:11:22,81,2574,49,32,1656.02,2920.01,0.00
2024-12-08 17:11:22,81,2575,49,32,1649.37,2921.00,0.00
2024-12-08 17:11:22,82,2575,49,33,1629.26,2921.01,0.00
2024-12-08 17:11:22,81,2575,48,33,1647.94,2921.05,0.00
2024-12-08 17:11:22,80,2575,48,32,1661.99,2921.13,0.00
2024-12-08 17:11:22,79,2575,47,32,1679.73,2921.23,0.00
2024-12-08 17:11:22,79,2576,47,32,1687.27,2922.00,0.00
2024-12-08 17:11:22,80,2576,48,32,1666.18,2922.01,0.00
2024-12-08 17:11:22,79,2576,47,32,1671.03,2922.14,0.00
2024-12-08 17:11:22,79,2577,47,32,1683.24,2923.00,0.00
2024-12-08 17:11:22,80,2577,47,33,1662.20,2923.01,0.00
2024-12-08 17:11:22,79,2577,47,32,1675.50,2923.13,0.00
2024-12-08 17:11:22,79,2578,47,32,1678.73,2924.00,0.00
2024-12-08 17:11:22,80,2578,48,32,1657.74,2924.01,0.00
2024-12-08 17:11:22,80,2579,48,32,1649.62,2925.00,0.00
2024-12-08 17:11:22,81,2579,49,32,1629.25,2925.01,0.00
2024-12-08 17:11:22,81,2580,49,32,1618.58,2926.00,0.00
2024-12-08 17:11:22,82,2580,50,32,1598.84,2926.01,0.00
2024-12-08 17:11:22,81,2580,50,31,1606.70,2926.20,0.00
2024-12-08 17:11:22,81,2581,50,31,1604.35,2927.00,0.00
2024-12-08 17:11:22,82,2581,50,32,1584.79,2927.01,0.00
2024-12-08 17:11:22,82,2582,50,32,1562.12,2928.00,0.00
2024-12-08 17:11:22,83,2582,50,33,1543.30,2928.01,0.00
2024-12-08 17:11:22,82,2582,50,32,1553.96,2928.24,0.00
2024-12-08 17:11:22,81,2582,49,32,1567.29,2928.25,0.00
2024-12-08 17:11:22,80,2582,48,32,1583.38,2928.31,0.00
2024-12-08 17:11:22,80,2583,48,32,1587.39,2929.00,0.00
2024-12-08 17:11:22,81,2583,48,33,1567.80,2929.01,0.00
2024-12-08 17:11:22,82,2582,49,33,1547.61,2929.07,0.00
2024-12-08 17:11:22,81,2582,49,32,1552.38,2929.33,0.00
2024-12-08 17:11:23,81,2583,49,32,1569.47,2930.00,0.00
2024-12-08 17:11:23,82,2583,49,33,1550.33,2930.01,0.00
2024-12-08 17:11:23,82,2584,49,33,1578.87,2931.00,0.00
2024-12-08 17:11:23,83,2584,49,34,1559.85,2931.01,0.00
2024-12-08 17:11:23,82,2584,48,34,1577.11,2931.06,0.00
2024-12-08 17:11:23,81,2584,47,34,1584.30,2931.22,0.00
2024-12-08 17:11:23,80,2584,47,33,1603.00,2931.23,0.00
2024-12-08 17:11:23,80,2585,47,33,1617.39,2932.00,0.00
2024-12-08 17:11:23,81,2585,47,34,1597.43,2932.01,0.00
2024-12-08 17:11:23,80,2585,46,34,1615.58,2932.06,0.00
2024-12-08 17:11:23,80,2586,46,34,1610.61,2933.00,0.00
2024-12-08 17:11:23,81,2586,46,35,1590.73,2933.01,0.00
2024-12-08 17:11:23,81,2587,46,35,1584.03,2934.00,0.00
2024-12-08 17:11:23,82,2587,47,35,1564.71,2934.01,0.00
2024-12-08 17:11:23,81,2587,46,35,1582.23,2934.06,0.00
2024-12-08 17:11:23,80,2587,46,34,1596.54,2934.23,0.00
2024-12-08 17:11:23,79,2587,45,34,1608.32,2934.48,0.00
2024-12-08 17:11:23,79,2588,45,34,1630.63,2935.00,0.00
2024-12-08 17:11:23,80,2588,45,35,1610.24,2935.01,0.00
2024-12-08 17:11:23,79,2588,44,35,1629.89,2935.03,0.00
2024-12-08 17:11:23,78,2588,43,35,1649.67,2935.05,0.00
2024-12-08 17:11:23,79,2587,43,36,1626.20,2935.17,0.00
2024-12-08 17:11:23,78,2587,42,36,1677.65,2935.21,0.00
2024-12-08 17:11:23,78,2588,42,36,1684.94,2936.00,0.00
2024-12-08 17:11:23,79,2588,42,37,1663.61,2936.01,0.00
2024-12-08 17:11:23,78,2588,41,37,1683.08,2936.06,0.00
2024-12-08 17:11:23,78,2589,41,37,1723.92,2937.00,0.00
2024-12-08 17:11:23,79,2589,42,37,1702.10,2937.01,0.00
2024-12-08 17:11:23,78,2589,42,36,1711.17,2937.18,0.00
2024-12-08 17:11:23,78,2590,42,36,1717.73,2938.00,0.00
2024-12-08 17:11:23,79,2590,43,36,1695.98,2938.01,0.00
2024-12-08 17:11:23,78,2590,42,36,1696.73,2938.32,0.00
2024-12-08 17:11:23,78,2591,42,36,1714.92,2939.00,0.00
2024-12-08 17:11:23,79,2591,42,37,1693.21,2939.01,0.00
2024-12-08 17:11:23,78,2591,42,36,1712.30,2939.09,0.00
2024-12-08 17:11:23,78,2592,42,36,1708.72,2940.00,0.00
2024-12-08 17:11:23,79,2592,43,36,1687.09,2940.01,0.00
2024-12-08 17:11:23,78,2592,42,36,1706.10,2940.09,0.00
2024-12-08 17:11:23,77,2592,42,35,1725.24,2940.18,0.00
2024-12-08 17:11:23,76,2592,41,35,1740.52,2940.43,0.00
2024-12-08 17:11:23,76,2593,41,35,1755.26,2941.00,0.00
2024-12-08 17:11:23,77,2593,41,36,1732.46,2941.01,0.00
2024-12-08 17:11:23,77,2594,41,36,1726.93,2942.00,0.00
2024-12-08 17:11:23,78,2594,41,37,1704.79,2942.01,0.00
2024-12-08 17:11:23,77,2594,41,36,1721.62,2942.13,0.00
2024-12-08 17:11:23,77,2595,41,36,1727.14,2943.00,0.00
2024-12-08 17:11:23,78,2595,41,37,1705.00,2943.01,0.00
2024-12-08 17:11:23,78,2596,41,37,1699.16,2944.00,0.00
2024-12-08 17:11:23,79,2596,42,37,1677.65,2944.01,0.00
2024-12-08 17:11:23,79,2597,42,37,1671.51,2945.00,0.00
2024-12-08 17:11:23,80,2597,43,37,1650.62,2945.01,0.00
2024-12-08 17:11:23,79,2597,42,37,1668.19,2945.11,0.00
2024-12-08 17:11:23,78,2597,42,36,1685.83,2945.22,0.00
2024-12-08 17:11:23,78,2598,42,36,1693.52,2946.00,0.00
2024-12-08 17:11:23,79,2598,42,37,1672.08,2946.01,0.00
2024-12-08 17:11:23,78,2598,41,37,1691.92,2946.05,0.00
2024-12-08 17:11:23,78,2599,41,37,1686.57,2947.00,0.00
2024-12-08 17:11:23,79,2599,41,38,1665.22,2947.01,0.00
2024-12-08 17:11:23,79,2600,41,38,1657.55,2948.00,0.00
2024-12-08 17:11:23,80,2600,41,39,1636.83,2948.01,0.00
2024-12-08 17:11:23,79,2600,41,38,1646.72,2948.23,0.00
2024-12-08 17:11:23,79,2601,41,38,1654.10,2949.00,0.00
2024-12-08 17:11:23,80,2601,42,38,1633.43,2949.01,0.00
2024-12-08 17:11:24,80,2602,42,38,1621.93,2950.00,0.00
2024-12-08 17:11:24,81,2602,43,38,1601.91,2950.01,0.00
2024-12-08 17:11:24,81,2603,43,38,1587.05,2951.00,0.00
2024-12-08 17:11:24,82,2603,44,38,1567.69,2951.01,0.00
2024-12-08 17:11:24,81,2603,43,38,1583.10,2951.14,0.00
2024-12-08 17:11:24,80,2603,42,38,1599.96,2951.23,0.00
2024-12-08 17:11:24,80,2604,42,38,1599.01,2952.00,0.00
2024-12-08 17:11:24,81,2604,42,39,1579.27,2952.01,0.00
2024-12-08 17:11:24,81,2605,42,39,1569.95,2953.00,0.00
2024-12-08 17:11:24,82,2605,42,40,1550.81,2953.01,0.00
2024-12-08 17:11:24,81,2605,42,39,1562.90,2953.24,0.00
2024-12-08 17:11:24,82,2604,43,39,1533.22,2953.62,0.00
2024-12-08 17:11:24,82,2605,43,39,1557.71,2954.00,0.00
2024-12-08 17:11:24,83,2605,43,40,1538.94,2954.01,0.00
2024-12-08 17:11:24,82,2605,43,39,1548.65,2954.26,0.00
2024-12-08 17:11:24,82,2606,43,39,1587.84,2955.00,0.00
2024-12-08 17:11:24,83,2606,44,39,1568.71,2955.01,0.00
2024-12-08 17:11:24,83,2607,44,39,1557.73,2956.00,0.00
2024-12-08 17:11:24,84,2607,44,40,1539.18,2956.01,0.00
2024-12-08 17:11:24,83,2607,43,40,1557.02,2956.02,0.00
2024-12-08 17:11:24,84,2606,44,40,1523.42,2956.32,0.00
2024-12-08 17:11:24,84,2607,44,40,1556.23,2957.00,0.00
2024-12-08 17:11:24,85,2607,44,41,1537.92,2957.01,0.00
2024-12-08 17:11:24,84,2607,43,41,1555.18,2957.04,0.00
2024-12-08 17:11:24,84,2608,43,41,1583.51,2958.00,0.00
2024-12-08 17:11:24,85,2608,44,41,1564.89,2958.01,0.00
2024-12-08 17:11:24,84,2608,43,41,1583.44,2958.01,0.00
2024-12-08 17:11:24,83,2608,43,40,1601.82,2958.02,0.00
2024-12-08 17:11:24,82,2608,43,39,1615.62,2958.21,0.00
2024-12-08 17:11:24,82,2609,43,39,1621.53,2959.00,0.00
2024-12-08 17:11:24,83,2609,44,39,1601.99,2959.01,0.00
2024-12-08 17:11:24,83,2610,44,39,1594.69,2960.00,0.00
2024-12-08 17:11:24,84,2610,44,40,1575.71,2960.01,0.00
2024-12-08 17:11:24,83,2610,43,40,1593.99,2960.02,0.00
2024-12-08 17:11:24,82,2610,42,40,1612.71,2960.05,0.00
2024-12-08 17:11:24,81,2610,42,39,1627.18,2960.21,0.00
2024-12-08 17:11:24,81,2611,42,39,1631.54,2961.00,0.00
2024-12-08 17:11:24,82,2611,42,40,1611.64,2961.01,0.00
2024-12-08 17:11:24,82,2612,42,40,1598.19,2962.00,0.00
2024-12-08 17:11:24,83,2612,42,41,1578.93,2962.01,0.00
2024-12-08 17:11:24,82,2612,42,40,1585.07,2962.21,0.00
2024-12-08 17:11:24,81,2612,42,39,1595.76,2962.25,0.00
2024-12-08 17:11:24,81,2613,42,39,1603.18,2963.00,0.00
2024-12-08 17:11:24,82,2613,42,40,1583.63,2963.01,0.00
2024-12-08 17:11:24,81,2613,41,40,1598.07,2963.04,0.00
2024-12-08 17:11:24,80,2613,40,40,1616.94,2963.06,0.00
2024-12-08 17:11:24,80,2614,40,40,1619.32,2964.00,0.00
2024-12-08 17:11:24,81,2614,41,40,1599.33,2964.01,0.00
2024-12-08 17:11:24,81,2615,41,40,1592.55,2965.00,0.00
2024-12-08 17:11:24,82,2615,41,41,1573.13,2965.01,0.00
2024-12-08 17:11:24,83,2614,41,42,1548.16,2965.24,0.00
2024-12-08 17:11:24,84,2613,41,43,1556.57,2965.30,0.00
2024-12-08 17:11:24,84,2614,41,43,1583.50,2966.00,0.00
2024-12-08 17:11:24,85,2614,41,44,1564.87,2966.01,0.00
2024-12-08 17:11:24,84,2614,40,44,1581.76,2966.07,0.00
2024-12-08 17:11:24,84,2615,40,44,1646.56,2967.00,0.00
2024-12-08 17:11:24,85,2615,41,44,1627.18,2967.01,0.00
2024-12-08 17:11:24,85,2616,41,44,1619.35,2968.00,0.00
2024-12-08 17:11:24,86,2616,42,44,1600.52,2968.01,0.00
2024-12-08 17:11:24,85,2616,41,44,1617.62,2968.07,0.00
2024-12-08 17:11:25,85,2617,41,44,1611.52,2969.00,0.00
2024-12-08 17:11:25,86,2617,42,44,1592.78,2969.01,0.00
2024-12-08 17:11:25,85,2617,41,44,1609.79,2969.07,0.00
2024-12-08 17:11:25,84,2617,41,43,1619.44,2969.18,0.00
2024-12-08 17:11:25,85,2616,42,43,1590.07,2969.55,0.00
2024-12-08 17:11:25,85,2617,42,43,1616.56,2970.00,0.00
2024-12-08 17:11:25,86,2617,42,44,1597.76,2970.01,0.00
2024-12-08 17:11:25,86,2618,42,44,1624.21,2971.00,0.00
2024-12-08 17:11:25,87,2618,43,44,1605.54,2971.01,0.00
2024-12-08 17:11:25,86,2618,43,43,1613.54,2971.17,0.00
2024-12-08 17:11:25,86,2619,43,43,1617.15,2972.00,0.00
2024-12-08 17:11:25,87,2619,44,43,1598.56,2972.01,0.00
2024-12-08 17:11:25,87,2620,44,43,1590.22,2973.00,0.00
2024-12-08 17:11:25,88,2620,44,44,1572.15,2973.01,0.00
2024-12-08 17:11:25,88,2621,44,44,1563.25,2974.00,0.00
2024-12-08 17:11:25,89,2621,44,45,1545.68,2974.01,0.00
2024-12-08 17:11:25,88,2621,43,45,1560.56,2974.09,0.00
2024-12-08 17:11:25,87,2621,43,44,1568.83,2974.17,0.00
2024-12-08 17:11:25,87,2622,43,44,1572.06,2975.00,0.00
2024-12-08 17:11:25,88,2622,44,44,1554.19,2975.01,0.00
2024-12-08 17:11:25,88,2623,44,44,1542.05,2976.00,0.00
2024-12-08 17:11:25,89,2623,45,44,1524.73,2976.01,0.00
2024-12-08 17:11:25,88,2623,44,44,1537.23,2976.10,0.00
2024-12-08 17:11:25,87,2623,44,43,1551.46,2976.14,0.00
2024-12-08 17:11:25,88,2622,45,43,1515.95,2976.76,0.00
2024-12-08 17:11:25,87,2622,44,43,1534.48,2976.84,0.00
2024-12-08 17:11:25,87,2623,44,43,1564.04,2977.00,0.00
2024-12-08 17:11:25,88,2623,44,44,1546.27,2977.01,0.00
2024-12-08 17:11:25,87,2623,44,43,1553.81,2977.17,0.00
2024-12-08 17:11:25,86,2623,43,43,1565.65,2977.19,0.00
2024-12-08 17:11:25,85,2623,42,43,1583.38,2977.21,0.00
2024-12-08 17:11:25,85,2624,42,43,1629.92,2978.00,0.00
2024-12-08 17:11:25,86,2624,43,43,1610.97,2978.01,0.00
2024-12-08 17:11:25,85,2624,42,43,1603.21,2978.57,0.00
2024-12-08 17:11:25,85,2625,42,43,1625.63,2979.00,0.00
2024-12-08 17:11:25,86,2625,42,44,1606.73,2979.01,0.00
2024-12-08 17:11:25,85,2625,42,43,1613.07,2979.21,0.00
2024-12-08 17:11:25,84,2625,41,43,1632.27,2979.21,0.00
2024-12-08 17:11:25,84,2626,41,43,1637.01,2980.00,0.00
2024-12-08 17:11:25,85,2626,41,44,1617.75,2980.01,0.00
2024-12-08 17:11:25,84,2626,40,44,1635.95,2980.04,0.00
2024-12-08 17:11:25,83,2626,39,44,1649.58,2980.13,0.00
2024-12-08 17:11:25,83,2627,39,44,1652.32,2981.00,0.00
2024-12-08 17:11:25,84,2627,40,44,1632.65,2981.01,0.00
2024-12-08 17:11:25,83,2627,40,43,1639.44,2981.21,0.00
2024-12-08 17:11:25,83,2628,40,43,1643.60,2982.00,0.00
2024-12-08 17:11:25,84,2628,41,43,1624.03,2982.01,0.00
2024-12-08 17:11:25,83,2628,40,43,1642.53,2982.04,0.00
2024-12-08 17:11:25,82,2628,39,43,1635.80,2982.45,0.00
2024-12-08 17:11:25,82,2629,39,43,1653.42,2983.00,0.00
2024-12-08 17:11:25,83,2629,40,43,1633.50,2983.01,0.00
2024-12-08 17:11:25,82,2629,39,43,1650.17,2983.11,0.00
2024-12-08 17:11:25,81,2629,39,42,1661.36,2983.19,0.00
2024-12-08 17:11:25,80,2629,38,42,1682.12,2983.19,0.00
2024-12-08 17:11:25,80,2630,38,42,1683.19,2984.00,0.00
2024-12-08 17:11:25,81,2630,38,43,1662.41,2984.01,0.00
2024-12-08 17:11:25,80,2630,38,42,1682.08,2984.04,0.00
2024-12-08 17:11:25,79,2630,37,42,1693.59,2984.17,0.00
2024-12-08 17:11:25,78,2630,36,42,1703.11,2984.32,0.00
2024-12-08 17:11:26,78,2631,36,42,1715.39,2985.00,0.00
2024-12-08 17:11:26,79,2631,37,42,1693.68,2985.01,0.00
2024-12-08 17:11:26,79,2632,37,42,1681.00,2986.00,0.00
2024-12-08 17:11:26,80,2632,38,42,1659.99,2986.01,0.00
2024-12-08 17:11:26,79,2632,37,42,1668.19,2986.19,0.00
2024-12-08 17:11:26,78,2632,36,42,1689.20,2986.19,0.00
2024-12-08 17:11:26,78,2633,36,42,1690.26,2987.00,0.00
2024-12-08 17:11:26,79,2633,36,43,1668.86,2987.01,0.00
2024-12-08 17:11:26,78,2633,36,42,1683.02,2987.17,0.00
2024-12-08 17:11:26,78,2634,36,42,1683.22,2988.00,0.00
2024-12-08 17:11:26,79,2634,36,43,1661.92,2988.01,0.00
2024-12-08 17:11:26,79,2635,36,43,1644.90,2989.00,0.00
2024-12-08 17:11:26,80,2635,36,44,1624.34,2989.01,0.00
2024-12-08 17:11:26,79,2635,36,43,1632.83,2989.18,0.00
2024-12-08 17:11:26,78,2635,36,42,1643.20,2989.19,0.00
2024-12-08 17:11:26,77,2635,35,42,1639.00,2989.70,0.00
2024-12-08 17:11:26,77,2636,35,42,1666.19,2990.00,0.00
2024-12-08 17:11:26,78,2636,35,43,1644.82,2990.01,0.00
2024-12-08 17:11:26,77,2636,34,43,1658.42,2990.01,0.00
2024-12-08 17:11:26,77,2637,34,43,1654.05,2991.00,0.00
2024-12-08 17:11:26,78,2637,35,43,1632.84,2991.01,0.00
2024-12-08 17:11:26,77,2637,34,43,1653.28,2991.03,0.00
2024-12-08 17:11:26,76,2637,34,42,1664.04,2991.16,0.00
2024-12-08 17:11:26,75,2637,34,41,1683.83,2991.24,0.00
2024-12-08 17:11:26,74,2637,33,41,1686.28,2991.70,0.00
2024-12-08 17:11:26,74,2638,33,41,1709.97,2992.00,0.00
2024-12-08 17:11:26,75,2638,34,41,1687.17,2992.01,0.00
2024-12-08 17:11:26,74,2638,34,40,1709.16,2992.03,0.00
2024-12-08 17:11:26,74,2639,34,40,1698.53,2993.00,0.00
2024-12-08 17:11:26,75,2639,34,41,1675.88,2993.01,0.00
2024-12-08 17:11:26,75,2640,34,41,1662.35,2994.00,0.00
2024-12-08 17:11:26,76,2640,34,42,1640.47,2994.01,0.00
2024-12-08 17:11:26,75,2640,34,41,1645.18,2994.16,0.00
2024-12-08 17:11:26,75,2641,34,41,1646.41,2995.00,0.00
2024-12-08 17:11:26,76,2641,34,42,1624.75,2995.01,0.00
2024-12-08 17:11:26,75,2641,33,42,1645.61,2995.03,0.00
2024-12-08 17:11:26,76,2640,33,43,1612.97,2995.16,0.00
2024-12-08 17:11:26,75,2640,33,42,1661.86,2995.16,0.00
2024-12-08 17:11:26,75,2641,33,42,1662.66,2996.00,0.00
2024-12-08 17:11:26,76,2641,33,43,1640.79,2996.01,0.00
2024-12-08 17:11:26,75,2641,32,43,1655.95,2996.04,0.00
2024-12-08 17:11:26,74,2641,31,43,1672.68,2996.11,0.00
2024-12-08 17:11:26,74,2642,31,43,1712.09,2997.00,0.00
2024-12-08 17:11:26,75,2642,31,44,1689.26,2997.01,0.00
2024-12-08 17:11:26,75,2643,31,44,1675.79,2998.00,0.00
2024-12-08 17:11:26,76,2643,31,45,1653.74,2998.01,0.00
2024-12-08 17:11:26,75,2643,31,44,1646.31,2998.57,0.00
2024-12-08 17:11:26,75,2644,31,44,1664.13,2999.00,0.00
2024-12-08 17:11:26,76,2644,32,44,1642.24,2999.01,0.00
2024-12-08 17:11:26,75,2644,32,43,1663.34,2999.03,0.00
2024-12-08 17:11:26,74,2644,31,43,1681.41,2999.18,0.00
2024-12-08 17:11:26,73,2644,31,42,1704.03,2999.18,0.00
2024-12-08 17:11:26,73,2645,31,42,1707.96,3000.00,0.00
2024-12-08 17:11:26,74,2645,32,42,1684.88,3000.01,0.00
2024-12-08 17:11:26,74,2646,32,42,1670.34,3001.00,0.00
2024-12-08 17:11:26,75,2646,32,43,1648.07,3001.01,0.00
2024-12-08 17:11:26,74,2646,32,42,1656.97,3001.18,0.00
2024-12-08 17:11:26,73,2646,31,42,1654.40,3001.64,0.00
2024-12-08 17:11:26,73,2647,31,42,1669.43,3002.00,0.00
2024-12-08 17:11:26,74,2647,32,42,1646.87,3002.01,0.00
2024-12-08 17:11:26,73,2647,32,41,1645.37,3002.45,0.00
2024-12-08 17:11:26,72,2647,32,40,1635.06,3002.92,0.00
2024-12-08 17:11:27,72,2648,32,40,1665.99,3003.00,0.00
2024-12-08 17:11:27,73,2648,33,40,1643.17,3003.01,0.00
2024-12-08 17:11:27,72,2648,33,39,1652.45,3003.18,0.00
2024-12-08 17:11:27,71,2648,32,39,1658.43,3003.72,0.00
2024-12-08 17:11:27,71,2649,32,39,1678.62,3004.00,0.00
2024-12-08 17:11:27,72,2649,33,39,1655.31,3004.01,0.00
2024-12-08 17:11:27,72,2650,33,39,1638.02,3005.00,0.00
2024-12-08 17:11:27,73,2650,33,40,1615.58,3005.01,0.00
2024-12-08 17:11:27,72,2650,33,39,1625.12,3005.18,0.00
2024-12-08 17:11:27,72,2651,33,39,1615.91,3006.00,0.00
2024-12-08 17:11:27,73,2651,34,39,1593.77,3006.01,0.00
2024-12-08 17:11:27,72,2651,34,38,1593.44,3006.43,0.00
2024-12-08 17:11:27,71,2651,34,37,1592.88,3006.85,0.00
2024-12-08 17:11:27,71,2652,34,37,1630.69,3007.00,0.00
2024-12-08 17:11:27,72,2652,34,38,1608.04,3007.01,0.00
2024-12-08 17:11:27,71,2652,33,38,1612.94,3007.17,0.00
2024-12-08 17:11:27,71,2653,33,38,1630.81,3008.00,0.00
2024-12-08 17:11:27,72,2653,34,38,1608.16,3008.01,0.00
2024-12-08 17:11:27,71,2653,34,37,1617.71,3008.18,0.00
2024-12-08 17:11:27,71,2654,34,37,1627.46,3009.00,0.00
2024-12-08 17:11:27,72,2654,34,38,1604.86,3009.01,0.00
2024-12-08 17:11:27,72,2655,34,38,1600.54,3010.00,0.00
2024-12-08 17:11:27,73,2655,34,39,1578.62,3010.01,0.00
2024-12-08 17:11:27,72,2655,34,38,1588.03,3010.18,0.00
2024-12-08 17:11:27,72,2656,34,38,1596.85,3011.00,0.00
2024-12-08 17:11:27,73,2656,35,38,1574.98,3011.01,0.00
2024-12-08 17:11:27,72,2656,35,37,1595.60,3011.04,0.00
2024-12-08 17:11:27,71,2656,34,37,1617.88,3011.04,0.00
2024-12-08 17:11:27,70,2656,33,37,1628.12,3011.19,0.00
2024-12-08 17:11:27,70,2657,33,37,1637.53,3012.00,0.00
2024-12-08 17:11:27,71,2657,33,38,1614.47,3012.01,0.00
2024-12-08 17:11:27,70,2657,33,37,1634.97,3012.09,0.00
2024-12-08 17:11:27,69,2657,33,36,1649.51,3012.15,0.00
2024-12-08 17:11:27,69,2658,33,36,1656.35,3013.00,0.00
2024-12-08 17:11:27,70,2658,33,37,1632.68,3013.01,0.00
2024-12-08 17:11:27,69,2658,33,36,1653.74,3013.09,0.00
2024-12-08 17:11:27,69,2659,33,36,1648.57,3014.00,0.00
2024-12-08 17:11:27,70,2659,34,36,1625.02,3014.01,0.00
2024-12-08 17:11:27,69,2659,34,35,1647.27,3014.04,0.00
2024-12-08 17:11:27,68,2659,34,34,1660.00,3014.15,0.00
2024-12-08 17:11:27,68,2660,34,34,1663.06,3015.00,0.00
2024-12-08 17:11:27,69,2660,34,35,1638.96,3015.01,0.00
2024-12-08 17:11:27,68,2660,33,35,1661.73,3015.04,0.00
2024-12-08 17:11:27,67,2660,32,35,1678.01,3015.10,0.00
2024-12-08 17:11:27,66,2660,31,35,1683.75,3015.20,0.00
2024-12-08 17:11:27,66,2661,31,35,1703.87,3016.00,0.00
2024-12-08 17:11:27,67,2661,32,35,1678.44,3016.02,0.00
2024-12-08 17:11:27,66,2661,32,34,1692.48,3016.12,0.00
2024-12-08 17:11:27,65,2661,31,34,1717.60,3016.15,0.00
2024-12-08 17:11:27,65,2662,31,34,1727.55,3017.00,0.00
2024-12-08 17:11:27,66,2662,32,34,1701.38,3017.02,0.00
2024-12-08 17:11:27,66,2663,32,34,1697.41,3018.00,0.00
2024-12-08 17:11:27,67,2663,32,35,1672.07,3018.02,0.00
2024-12-08 17:11:27,66,2663,32,34,1686.01,3018.14,0.00
2024-12-08 17:11:27,65,2663,31,34,1710.57,3018.17,0.00
2024-12-08 17:11:27,65,2664,31,34,1720.79,3019.00,0.00
2024-12-08 17:11:27,66,2664,32,34,1694.72,3019.02,0.00
2024-12-08 17:11:27,65,2664,31,34,1698.08,3019.37,0.00
2024-12-08 17:11:27,64,2664,30,34,1723.69,3019.41,0.00
2024-12-08 17:11:27,64,2665,30,34,1743.93,3020.00,0.00
2024-12-08 17:11:27,65,2665,30,35,1717.10,3020.02,0.00
2024-12-08 17:11:27,64,2665,30,34,1732.17,3020.14,0.00
2024-12-08 17:11:27,64,2666,30,34,1744.51,3021.00,0.00
2024-12-08 17:11:27,65,2666,30,35,1717.67,3021.02,0.00
2024-12-08 17:11:28,65,2667,30,35,1716.38,3022.00,0.00
2024-12-08 17:11:28,66,2667,30,36,1690.37,3022.02,0.00
2024-12-08 17:11:28,66,2668,30,36,1688.63,3023.00,0.00
2024-12-08 17:11:28,67,2668,31,36,1663.43,3023.02,0.00
2024-12-08 17:11:28,66,2668,31,35,1678.58,3023.14,0.00
2024-12-08 17:11:28,65,2668,31,34,1702.89,3023.19,0.00
2024-12-08 17:11:28,64,2668,30,34,1718.70,3023.33,0.00
2024-12-08 17:11:28,64,2669,30,34,1744.05,3024.00,0.00
2024-12-08 17:11:28,65,2669,31,34,1717.22,3024.02,0.00
2024-12-08 17:11:28,64,2669,30,34,1732.73,3024.14,0.00
2024-12-08 17:11:28,64,2670,30,34,1741.24,3025.00,0.00
2024-12-08 17:11:28,65,2670,30,35,1714.45,3025.02,0.00
2024-12-08 17:11:28,64,2670,29,35,1738.89,3025.09,0.00
2024-12-08 17:11:28,64,2671,29,35,1735.52,3026.00,0.00
2024-12-08 17:11:28,65,2671,29,36,1708.82,3026.02,0.00
2024-12-08 17:11:28,64,2671,28,36,1735.05,3026.03,0.00
2024-12-08 17:11:28,63,2671,28,35,1753.01,3026.11,0.00
2024-12-08 17:11:28,63,2672,28,35,1760.08,3027.00,0.00
2024-12-08 17:11:28,64,2672,28,36,1732.58,3027.02,0.00
2024-12-08 17:11:28,63,2672,28,35,1749.87,3027.11,0.00
2024-12-08 17:11:28,62,2672,27,35,1752.65,3027.58,0.00
2024-12-08 17:11:28,62,2673,27,35,1789.11,3028.00,0.00
2024-12-08 17:11:28,63,2673,28,35,1760.71,3028.02,0.00
2024-12-08 17:11:28,62,2673,27,35,1751.84,3028.79,0.00
2024-12-08 17:11:28,62,2674,27,35,1794.52,3029.00,0.00
2024-12-08 17:11:28,63,2674,27,36,1766.03,3029.02,0.00
2024-12-08 17:11:28,62,2674,27,35,1783.29,3029.05,0.00
2024-12-08 17:11:28,62,2675,27,35,1792.62,3030.00,0.00
2024-12-08 17:11:28,63,2675,28,35,1764.16,3030.02,0.00
2024-12-08 17:11:28,63,2676,28,35,1761.89,3031.00,0.00
2024-12-08 17:11:28,64,2676,28,36,1734.36,3031.02,0.00
2024-12-08 17:11:28,63,2676,28,35,1752.28,3031.10,0.00
2024-12-08 17:11:28,64,2675,28,36,1723.97,3031.16,0.00
2024-12-08 17:11:28,64,2676,28,36,1763.75,3032.00,0.00
2024-12-08 17:11:28,65,2676,29,36,1736.61,3032.02,0.00
2024-12-08 17:11:28,64,2676,28,36,1762.34,3032.06,0.00
2024-12-08 17:11:28,64,2677,28,36,1801.23,3033.00,0.00
2024-12-08 17:11:28,65,2677,28,37,1773.52,3033.02,0.00
2024-12-08 17:11:28,64,2677,27,37,1769.02,3033.41,0.00
2024-12-08 17:11:28,64,2678,27,37,1779.13,3034.00,0.00
2024-12-08 17:11:28,65,2678,27,38,1751.75,3034.02,0.00
2024-12-08 17:11:28,64,2678,27,37,1771.55,3034.08,0.00
2024-12-08 17:11:28,64,2679,27,37,1749.51,3035.00,0.00
2024-12-08 17:11:28,65,2679,28,37,1722.59,3035.02,0.00
2024-12-08 17:11:28,64,2679,27,37,1749.04,3035.02,0.00
2024-12-08 17:11:28,63,2679,27,36,1766.71,3035.10,0.00
2024-12-08 17:11:28,62,2679,26,36,1784.02,3035.27,0.00
2024-12-08 17:11:28,61,2679,26,35,1771.35,3035.87,0.00
2024-12-08 17:11:28,61,2680,26,35,1817.24,3036.00,0.00
2024-12-08 17:11:28,62,2680,27,35,1787.93,3036.02,0.00
2024-12-08 17:11:28,61,2680,27,34,1816.25,3036.03,0.00
2024-12-08 17:11:28,60,2680,26,34,1816.34,3036.68,0.00
2024-12-08 17:11:28,60,2681,26,34,1847.48,3037.00,0.00
2024-12-08 17:11:28,61,2681,27,34,1817.19,3037.02,0.00
2024-12-08 17:11:28,61,2682,27,34,1817.79,3038.00,0.00
2024-12-08 17:11:28,62,2682,28,34,1788.47,3038.02,0.00
2024-12-08 17:11:28,61,2682,28,33,1805.88,3038.13,0.00
2024-12-08 17:11:28,61,2683,28,33,1819.88,3039.00,0.00
2024-12-08 17:11:28,62,2683,28,34,1790.53,3039.02,0.00
2024-12-08 17:11:28,61,2683,28,33,1805.48,3039.15,0.00
2024-12-08 17:11:28,61,2684,28,33,1819.98,3040.00,0.00
2024-12-08 17:11:28,62,2684,28,34,1790.63,3040.02,0.00
2024-12-08 17:11:28,62,2685,28,34,1790.72,3041.00,0.00
2024-12-08 17:11:28,63,2685,28,35,1762.30,3041.02,0.00
2024-12-08 17:11:28,62,2685,28,34,1777.04,3041.15,0.00
2024-12-08 17:11:28,61,2685,27,34,1805.67,3041.15,0.00
2024-12-08 17:11:29,61,2686,27,34,1820.18,3042.00,0.00
2024-12-08 17:11:29,62,2686,27,35,1790.82,3042.02,0.00
2024-12-08 17:11:29,61,2686,26,35,1813.71,3042.03,0.00
2024-12-08 17:11:29,61,2687,26,35,1824.77,3043.00,0.00
2024-12-08 17:11:29,62,2687,26,36,1795.34,3043.02,0.00
2024-12-08 17:11:29,62,2688,26,36,1795.44,3044.00,0.00
2024-12-08 17:11:29,63,2688,27,36,1766.94,3044.02,0.00
2024-12-08 17:11:29,62,2688,27,35,1791.06,3044.15,0.00
2024-12-08 17:11:29,62,2689,27,35,1804.87,3045.00,0.00
2024-12-08 17:11:29,63,2689,28,35,1776.22,3045.02,0.00
2024-12-08 17:11:29,62,2689,27,35,1774.07,3045.39,0.00
2024-12-08 17:11:29,62,2690,27,35,1804.97,3046.00,0.00
2024-12-08 17:11:29,63,2690,28,35,1776.32,3046.02,0.00
2024-12-08 17:11:29,62,2690,27,35,1800.57,3046.06,0.00
2024-12-08 17:11:29,62,2691,27,35,1811.95,3047.00,0.00
2024-12-08 17:11:29,63,2691,28,35,1783.19,3047.02,0.00
2024-12-08 17:11:29,62,2691,28,34,1807.57,3047.15,0.00
2024-12-08 17:11:29,62,2692,28,34,1821.39,3048.00,0.00
2024-12-08 17:11:29,63,2692,29,34,1792.48,3048.02,0.00
2024-12-08 17:11:29,62,2692,29,33,1809.39,3048.15,0.00
2024-12-08 17:11:29,62,2693,29,33,1823.22,3049.00,0.00
2024-12-08 17:11:29,63,2693,29,34,1794.28,3049.02,0.00
2024-12-08 17:11:29,63,2694,29,34,1793.67,3050.00,0.00
2024-12-08 17:11:29,64,2694,29,35,1765.64,3050.02,0.00
2024-12-08 17:11:29,64,2695,29,35,1764.79,3051.00,0.00
2024-12-08 17:11:29,65,2695,30,35,1737.64,3051.02,0.00
2024-12-08 17:11:29,64,2695,30,34,1751.95,3051.14,0.00
2024-12-08 17:11:29,64,2696,30,34,1764.41,3052.00,0.00
2024-12-08 17:11:29,65,2696,31,34,1737.27,3052.02,0.00
2024-12-08 17:11:29,64,2696,30,34,1752.98,3052.06,0.00
2024-12-08 17:11:29,64,2697,30,34,1763.08,3053.00,0.00
2024-12-08 17:11:29,65,2697,31,34,1735.96,3053.02,0.00
2024-12-08 17:11:29,66,2696,31,35,1708.73,3053.08,0.00
2024-12-08 17:11:29,65,2696,31,34,1732.31,3053.17,0.00
2024-12-08 17:11:29,65,2697,31,34,1745.06,3054.00,0.00
2024-12-08 17:11:29,66,2697,31,35,1718.62,3054.02,0.00
2024-12-08 17:11:29,65,2697,30,35,1744.12,3054.02,0.00
2024-12-08 17:11:29,65,2698,30,35,1799.21,3055.00,0.00
2024-12-08 17:11:29,66,2698,30,36,1771.95,3055.02,0.00
2024-12-08 17:11:29,65,2698,29,36,1799.08,3055.02,0.00
2024-12-08 17:11:29,64,2698,29,35,1817.19,3055.09,0.00
2024-12-08 17:11:29,64,2699,29,35,1828.27,3056.00,0.00
2024-12-08 17:11:29,65,2699,29,36,1800.14,3056.02,0.00
2024-12-08 17:11:29,64,2699,29,35,1815.88,3056.11,0.00
2024-12-08 17:11:29,63,2699,28,35,1828.01,3056.67,0.00
2024-12-08 17:11:29,63,2700,28,35,1856.91,3057.00,0.00
2024-12-08 17:11:29,64,2700,28,36,1827.89,3057.02,0.00
2024-12-08 17:11:29,64,2701,28,36,1826.75,3058.00,0.00
2024-12-08 17:11:29,65,2701,28,37,1798.65,3058.02,0.00
2024-12-08 17:11:29,64,2701,28,36,1813.88,3058.13,0.00
2024-12-08 17:11:29,63,2701,27,36,1835.43,3058.22,0.00
2024-12-08 17:11:29,63,2702,27,36,1860.21,3059.00,0.00
2024-12-08 17:11:29,64,2702,28,36,1831.14,3059.02,0.00
2024-12-08 17:11:29,64,2703,28,36,1829.61,3060.00,0.00
2024-12-08 17:11:29,65,2703,29,36,1801.46,3060.02,0.00
2024-12-08 17:11:29,64,2703,29,35,1817.21,3060.13,0.00
2024-12-08 17:11:29,64,2704,29,35,1828.40,3061.00,0.00
2024-12-08 17:11:29,65,2704,29,36,1800.27,3061.02,0.00
2024-12-08 17:11:29,65,2705,29,36,1797.94,3062.00,0.00
2024-12-08 17:11:29,66,2705,29,37,1770.70,3062.02,0.00
2024-12-08 17:11:29,65,2705,29,36,1785.11,3062.14,0.00
2024-12-08 17:11:29,65,2706,29,36,1795.75,3063.00,0.00
2024-12-08 17:11:30,66,2706,29,37,1768.55,3063.02,0.00
2024-12-08 17:11:30,65,2706,28,37,1793.89,3063.06,0.00
2024-12-08 17:11:30,65,2707,28,37,1792.56,3064.00,0.00
2024-12-08 17:11:30,66,2707,29,37,1765.40,3064.02,0.00
2024-12-08 17:11:30,66,2708,29,37,1761.43,3065.00,0.00
2024-12-08 17:11:30,67,2708,30,37,1735.14,3065.02,0.00
2024-12-08 17:11:30,66,2708,30,36,1756.82,3065.15,0.00
2024-12-08 17:11:30,66,2709,30,36,1765.54,3066.00,0.00
2024-12-08 17:11:30,67,2709,30,37,1739.19,3066.02,0.00
2024-12-08 17:11:30,68,2708,30,38,1682.22,3066.49,0.00
2024-12-08 17:11:30,69,2707,30,39,1667.86,3066.84,0.00
2024-12-08 17:11:30,69,2708,30,39,1712.44,3067.00,0.00
2024-12-08 17:11:30,70,2708,31,39,1687.98,3067.01,0.00
2024-12-08 17:11:30,69,2708,31,38,1699.35,3067.15,0.00
2024-12-08 17:11:30,70,2707,31,39,1671.18,3067.30,0.00
2024-12-08 17:11:30,70,2708,31,39,1793.57,3068.00,0.00
2024-12-08 17:11:30,71,2708,31,40,1768.31,3068.01,0.00
2024-12-08 17:11:30,70,2708,30,40,1785.70,3068.10,0.00
2024-12-08 17:11:30,69,2708,29,40,1810.26,3068.13,0.00
2024-12-08 17:11:30,69,2709,29,40,1847.85,3069.00,0.00
2024-12-08 17:11:30,70,2709,30,40,1821.45,3069.01,0.00
2024-12-08 17:11:30,69,2709,30,39,1834.98,3069.13,0.00
2024-12-08 17:11:30,68,2709,29,39,1823.41,3069.71,0.00
2024-12-08 17:11:30,68,2710,29,39,1848.79,3070.00,0.00
2024-12-08 17:11:30,69,2710,30,39,1822.00,3070.01,0.00
2024-12-08 17:11:30,69,2711,30,39,1799.99,3071.00,0.00
2024-12-08 17:11:30,70,2711,30,40,1774.27,3071.01,0.00
2024-12-08 17:11:30,69,2711,29,40,1797.77,3071.07,0.00
2024-12-08 17:11:30,68,2711,29,39,1813.84,3071.12,0.00
2024-12-08 17:11:30,67,2711,28,39,1833.69,3071.36,0.00
2024-12-08 17:11:30,66,2711,28,38,1841.33,3071.64,0.00
2024-12-08 17:11:30,65,2711,27,38,1860.33,3071.80,0.00
2024-12-08 17:11:30,65,2712,27,38,1899.59,3072.00,0.00
2024-12-08 17:11:30,66,2712,27,39,1870.81,3072.02,0.00
2024-12-08 17:11:30,65,2712,26,39,1891.57,3072.06,0.00
2024-12-08 17:11:30,66,2711,27,39,1847.63,3072.29,0.00
2024-12-08 17:11:30,66,2712,27,39,1890.99,3073.00,0.00
2024-12-08 17:11:30,67,2712,28,39,1862.77,3073.02,0.00
2024-12-08 17:11:30,66,2712,28,38,1890.07,3073.03,0.00
2024-12-08 17:11:30,65,2712,28,37,1907.34,3073.11,0.00
2024-12-08 17:11:30,65,2713,28,37,1961.38,3074.00,0.00
2024-12-08 17:11:30,66,2713,28,38,1931.66,3074.02,0.00
2024-12-08 17:11:30,66,2714,28,38,1925.88,3075.00,0.00
2024-12-08 17:11:30,67,2714,29,38,1897.13,3075.02,0.00
2024-12-08 17:11:30,66,2714,29,37,1914.25,3075.11,0.00
2024-12-08 17:11:30,66,2715,29,37,1920.97,3076.00,0.00
2024-12-08 17:11:30,67,2715,29,38,1892.30,3076.02,0.00
2024-12-08 17:11:30,67,2716,29,38,1887.07,3077.00,0.00
2024-12-08 17:11:30,68,2716,30,38,1859.32,3077.02,0.00
2024-12-08 17:11:30,67,2716,30,37,1886.17,3077.03,0.00
2024-12-08 17:11:30,66,2716,30,36,1904.03,3077.09,0.00
2024-12-08 17:11:30,65,2716,29,36,1932.85,3077.09,0.00
2024-12-08 17:11:30,64,2716,28,36,1956.38,3077.19,0.00
2024-12-08 17:11:30,64,2717,28,36,1977.15,3078.00,0.00
2024-12-08 17:11:30,65,2717,29,36,1946.74,3078.02,0.00
2024-12-08 17:11:30,65,2718,29,36,1942.79,3079.00,0.00
2024-12-08 17:11:30,66,2718,29,37,1913.35,3079.02,0.00
2024-12-08 17:11:30,65,2718,28,37,1922.50,3079.22,0.00
2024-12-08 17:11:30,65,2719,28,37,1943.31,3080.00,0.00
2024-12-08 17:11:30,66,2719,29,37,1913.87,3080.02,0.00
2024-12-08 17:11:30,65,2719,29,36,1931.96,3080.09,0.00
2024-12-08 17:11:30,65,2720,29,36,1939.48,3081.00,0.00
2024-12-08 17:11:30,66,2720,29,37,1910.09,3081.02,0.00
2024-12-08 17:11:30,65,2720,29,36,1926.24,3081.12,0.00
2024-12-08 17:11:30,65,2721,29,36,1934.53,3082.00,0.00
2024-12-08 17:11:30,66,2721,29,37,1905.22,3082.02,0.00
2024-12-08 17:11:31,66,2722,29,37,1899.31,3083.00,0.00
2024-12-08 17:11:31,67,2722,30,37,1870.96,3083.02,0.00
2024-12-08 17:11:31,66,2722,29,37,1897.46,3083.06,0.00
2024-12-08 17:11:31,65,2722,29,36,1917.18,3083.09,0.00
2024-12-08 17:11:31,65,2723,29,36,1922.26,3084.00,0.00
2024-12-08 17:11:31,66,2723,29,37,1893.14,3084.02,0.00
2024-12-08 17:11:31,66,2724,29,37,1885.00,3085.00,0.00
2024-12-08 17:11:31,67,2724,30,37,1856.86,3085.02,0.00
2024-12-08 17:11:31,66,2724,30,36,1874.27,3085.09,0.00
2024-12-08 17:11:31,67,2723,31,36,1831.79,3085.51,0.00
2024-12-08 17:11:31,67,2724,31,36,1857.73,3086.00,0.00
2024-12-08 17:11:31,68,2724,32,36,1830.41,3086.02,0.00
2024-12-08 17:11:31,67,2724,31,36,1834.31,3086.40,0.00
2024-12-08 17:11:31,66,2724,31,35,1846.48,3086.58,0.00
2024-12-08 17:11:31,66,2725,31,35,1927.25,3087.00,0.00
2024-12-08 17:11:31,67,2725,32,35,1898.49,3087.02,0.00
2024-12-08 17:11:31,67,2726,32,35,1895.80,3088.00,0.00
2024-12-08 17:11:31,68,2726,32,36,1867.92,3088.02,0.00
2024-12-08 17:11:31,67,2726,32,35,1884.77,3088.10,0.00
2024-12-08 17:11:31,67,2727,32,35,1894.06,3089.00,0.00
2024-12-08 17:11:31,68,2727,33,35,1866.20,3089.02,0.00
2024-12-08 17:11:31,67,2727,33,34,1871.96,3089.12,0.00
2024-12-08 17:11:31,67,2728,33,34,1890.03,3090.00,0.00
2024-12-08 17:11:31,68,2728,34,34,1862.24,3090.02,0.00
2024-12-08 17:11:31,68,2729,34,34,1856.91,3091.00,0.00
2024-12-08 17:11:31,69,2729,34,35,1830.00,3091.01,0.00
2024-12-08 17:11:31,68,2729,34,34,1846.94,3091.10,0.00
2024-12-08 17:11:31,67,2729,33,34,1848.31,3091.76,0.00
2024-12-08 17:11:31,67,2730,33,34,1887.27,3092.00,0.00
2024-12-08 17:11:31,68,2730,33,35,1859.52,3092.02,0.00
2024-12-08 17:11:31,67,2730,32,35,1881.28,3092.05,0.00
2024-12-08 17:11:31,66,2730,31,35,1909.79,3092.05,0.00
2024-12-08 17:11:31,65,2730,30,35,1927.47,3092.11,0.00
2024-12-08 17:11:31,64,2730,29,35,1950.44,3092.34,0.00
2024-12-08 17:11:31,64,2731,29,35,1973.88,3093.00,0.00
2024-12-08 17:11:31,65,2731,30,35,1943.51,3093.02,0.00
2024-12-08 17:11:31,64,2731,30,34,1965.37,3093.08,0.00
2024-12-08 17:11:31,64,2732,30,34,1970.81,3094.00,0.00
2024-12-08 17:11:31,65,2732,31,34,1940.49,3094.02,0.00
2024-12-08 17:11:31,65,2733,31,34,1933.79,3095.00,0.00
2024-12-08 17:11:31,66,2733,32,34,1904.49,3095.02,0.00
2024-12-08 17:11:31,65,2733,32,33,1925.10,3095.08,0.00
2024-12-08 17:11:31,64,2733,32,32,1943.25,3095.38,0.00
2024-12-08 17:11:31,64,2734,32,32,1963.07,3096.00,0.00
2024-12-08 17:11:31,65,2734,33,32,1932.87,3096.02,0.00
2024-12-08 17:11:31,64,2734,33,31,1962.11,3096.03,0.00
2024-12-08 17:11:31,63,2734,32,31,1971.23,3096.25,0.00
2024-12-08 17:11:31,63,2735,32,31,1997.82,3097.00,0.00
2024-12-08 17:11:31,64,2735,32,32,1966.60,3097.02,0.00
2024-12-08 17:11:31,63,2735,32,31,1988.01,3097.06,0.00
2024-12-08 17:11:31,63,2736,32,31,1998.77,3098.00,0.00
2024-12-08 17:11:31,64,2736,33,31,1967.54,3098.02,0.00
2024-12-08 17:11:31,64,2737,33,31,1961.48,3099.00,0.00
2024-12-08 17:11:31,65,2737,33,32,1931.30,3099.02,0.00
2024-12-08 17:11:31,65,2738,33,32,1919.21,3100.00,0.00
2024-12-08 17:11:31,66,2738,33,33,1890.14,3100.02,0.00
2024-12-08 17:11:31,65,2738,33,32,1910.65,3100.06,0.00
2024-12-08 17:11:31,65,2739,33,32,1903.83,3101.00,0.00
2024-12-08 17:11:31,66,2739,33,33,1874.98,3101.02,0.00
2024-12-08 17:11:31,65,2739,33,32,1891.93,3101.11,0.00
2024-12-08 17:11:31,64,2739,33,31,1908.68,3101.27,0.00
2024-12-08 17:11:31,64,2740,33,31,1925.19,3102.00,0.00
2024-12-08 17:11:31,65,2740,34,31,1895.57,3102.02,0.00
2024-12-08 17:11:31,65,2741,34,31,1894.27,3103.00,0.00
2024-12-08 17:11:31,66,2741,35,31,1865.57,3103.02,0.00
2024-12-08 17:11:31,65,2741,35,30,1882.84,3103.11,0.00
2024-12-08 17:11:32,65,2742,35,30,1893.93,3104.00,0.00
2024-12-08 17:11:32,66,2742,35,31,1865.23,3104.02,0.00
2024-12-08 17:11:32,66,2743,35,31,1863.48,3105.00,0.00
2024-12-08 17:11:32,67,2743,36,31,1835.67,3105.02,0.00
2024-12-08 17:11:32,66,2743,36,30,1852.68,3105.11,0.00
2024-12-08 17:11:32,65,2743,35,30,1870.69,3105.14,0.00
2024-12-08 17:11:32,65,2744,35,30,1892.28,3106.00,0.00
2024-12-08 17:11:32,66,2744,36,30,1863.61,3106.02,0.00
2024-12-08 17:11:32,66,2745,36,30,1861.85,3107.00,0.00
2024-12-08 17:11:32,67,2745,37,30,1834.07,3107.02,0.00
2024-12-08 17:11:32,66,2745,37,29,1851.52,3107.11,0.00
2024-12-08 17:11:32,66,2746,37,29,1861.98,3108.00,0.00
2024-12-08 17:11:32,67,2746,37,30,1834.19,3108.02,0.00
2024-12-08 17:11:32,67,2747,37,30,1832.00,3109.00,0.00
2024-12-08 17:11:32,68,2747,38,30,1805.06,3109.02,0.00
2024-12-08 17:11:32,67,2747,38,29,1822.27,3109.10,0.00
2024-12-08 17:11:32,67,2748,38,29,1832.12,3110.00,0.00
2024-12-08 17:11:32,68,2748,38,30,1805.18,3110.02,0.00
2024-12-08 17:11:32,68,2749,38,30,1802.56,3111.00,0.00
2024-12-08 17:11:32,69,2749,39,30,1776.44,3111.01,0.00
2024-12-08 17:11:32,68,2749,39,29,1789.77,3111.13,0.00
2024-12-08 17:11:32,67,2749,38,29,1793.54,3111.64,0.00
2024-12-08 17:11:32,67,2750,38,29,1828.69,3112.00,0.00
2024-12-08 17:11:32,68,2750,39,29,1801.80,3112.02,0.00
2024-12-08 17:11:32,68,2751,39,29,1797.87,3113.00,0.00
2024-12-08 17:11:32,69,2751,39,30,1771.81,3113.01,0.00
2024-12-08 17:11:32,68,2751,38,30,1797.41,3113.02,0.00
2024-12-08 17:11:32,67,2751,38,29,1810.79,3113.13,0.00
2024-12-08 17:11:32,67,2752,38,29,1819.74,3114.00,0.00
2024-12-08 17:11:32,68,2752,39,29,1792.98,3114.02,0.00
2024-12-08 17:11:32,68,2753,39,29,1787.58,3115.00,0.00
2024-12-08 17:11:32,69,2753,40,29,1761.68,3115.01,0.00
2024-12-08 17:11:32,69,2754,40,29,1755.66,3116.00,0.00
2024-12-08 17:11:32,70,2754,41,29,1730.58,3116.01,0.00
2024-12-08 17:11:32,69,2754,41,28,1743.04,3116.13,0.00
2024-12-08 17:11:32,69,2755,41,28,1749.24,3117.00,0.00
2024-12-08 17:11:32,70,2755,42,28,1724.25,3117.01,0.00
2024-12-08 17:11:32,69,2755,41,28,1748.34,3117.04,0.00
2024-12-08 17:11:32,68,2755,41,27,1762.15,3117.12,0.00
2024-12-08 17:11:32,68,2756,41,27,1768.48,3118.00,0.00
2024-12-08 17:11:32,69,2756,41,28,1742.85,3118.01,0.00
2024-12-08 17:11:32,68,2756,40,28,1766.65,3118.06,0.00
2024-12-08 17:11:32,69,2755,41,28,1693.47,3118.94,0.00
2024-12-08 17:11:32,69,2756,41,28,1738.72,3119.00,0.00
2024-12-08 17:11:32,70,2756,41,29,1713.88,3119.01,0.00
2024-12-08 17:11:32,69,2756,41,28,1726.64,3119.10,0.00
2024-12-08 17:11:32,69,2757,41,28,1777.65,3120.00,0.00
2024-12-08 17:11:32,70,2757,41,29,1752.26,3120.01,0.00
2024-12-08 17:11:32,69,2757,40,29,1765.60,3120.10,0.00
2024-12-08 17:11:32,69,2758,40,29,1771.79,3121.00,0.00
2024-12-08 17:11:32,70,2758,40,30,1746.48,3121.01,0.00
2024-12-08 17:11:33,69,2758,39,30,1764.54,3121.09,0.00
2024-12-08 17:11:33,68,2758,39,29,1780.85,3121.09,0.00
2024-12-08 17:11:33,68,2759,39,29,1796.14,3122.00,0.00
2024-12-08 17:11:33,69,2759,39,30,1770.11,3122.01,0.00
2024-12-08 17:11:33,69,2760,39,30,1764.42,3123.00,0.00
2024-12-08 17:11:33,70,2760,39,31,1739.22,3123.01,0.00
2024-12-08 17:11:33,69,2760,39,30,1752.62,3123.09,0.00
2024-12-08 17:11:33,68,2760,38,30,1755.11,3123.50,0.00
2024-12-08 17:11:33,68,2761,38,30,1785.65,3124.00,0.00
2024-12-08 17:11:33,69,2761,38,31,1759.77,3124.01,0.00
2024-12-08 17:11:33,70,2760,39,31,1690.58,3124.89,0.00
2024-12-08 17:11:33,70,2761,39,31,1734.89,3125.00,0.00
2024-12-08 17:11:33,71,2761,40,31,1710.45,3125.01,0.00
2024-12-08 17:11:33,70,2761,39,31,1731.68,3125.10,0.00
2024-12-08 17:11:33,69,2761,38,31,1734.56,3125.32,0.00
2024-12-08 17:11:33,69,2762,38,31,1803.62,3126.00,0.00
2024-12-08 17:11:33,70,2762,39,31,1777.86,3126.01,0.00
2024-12-08 17:11:33,69,2762,39,30,1800.35,3126.10,0.00
2024-12-08 17:11:33,68,2762,39,29,1823.60,3126.10,0.00
2024-12-08 17:11:33,68,2763,39,29,1831.40,3127.00,0.00
2024-12-08 17:11:33,69,2763,39,30,1804.86,3127.01,0.00
2024-12-08 17:11:33,68,2763,38,30,1831.11,3127.02,0.00
2024-12-08 17:11:33,67,2763,37,30,1856.42,3127.06,0.00
2024-12-08 17:11:33,67,2764,37,30,1853.20,3128.00,0.00
2024-12-08 17:11:33,68,2764,38,30,1825.95,3128.02,0.00
2024-12-08 17:11:33,67,2764,38,29,1842.22,3128.08,0.00
2024-12-08 17:11:33,67,2765,38,29,1848.02,3129.00,0.00
2024-12-08 17:11:33,68,2765,39,29,1820.85,3129.02,0.00
2024-12-08 17:11:33,67,2765,38,29,1834.52,3129.12,0.00
2024-12-08 17:11:33,67,2766,38,29,1840.83,3130.00,0.00
2024-12-08 17:11:33,68,2766,38,30,1813.75,3130.02,0.00
2024-12-08 17:11:33,67,2766,37,30,1831.81,3130.06,0.00
2024-12-08 17:11:33,66,2766,36,30,1848.20,3130.11,0.00
2024-12-08 17:11:33,66,2767,36,30,1863.12,3131.00,0.00
2024-12-08 17:11:33,67,2767,36,31,1835.32,3131.02,0.00
2024-12-08 17:11:33,66,2767,36,30,1852.42,3131.08,0.00
2024-12-08 17:11:33,66,2768,36,30,1855.98,3132.00,0.00
2024-12-08 17:11:33,67,2768,36,31,1828.28,3132.02,0.00
2024-12-08 17:11:33,66,2768,36,30,1845.15,3132.08,0.00
2024-12-08 17:11:33,66,2769,36,30,1847.69,3133.00,0.00
2024-12-08 17:11:33,67,2769,36,31,1820.12,3133.02,0.00
2024-12-08 17:11:33,67,2770,36,31,1809.87,3134.00,0.00
2024-12-08 17:11:33,68,2770,36,32,1783.26,3134.02,0.00
2024-12-08 17:11:33,67,2770,36,31,1798.54,3134.08,0.00
2024-12-08 17:11:33,67,2771,36,31,1800.48,3135.00,0.00
2024-12-08 17:11:33,68,2771,36,32,1774.00,3135.02,0.00
2024-12-08 17:11:33,67,2771,35,32,1797.47,3135.03,0.00
2024-12-08 17:11:33,67,2772,35,32,1797.73,3136.00,0.00
2024-12-08 17:11:33,68,2772,35,33,1771.30,3136.02,0.00
2024-12-08 17:11:33,67,2772,34,33,1796.35,3136.02,0.00
2024-12-08 17:11:33,66,2772,33,33,1818.82,3136.02,0.00
2024-12-08 17:11:33,65,2772,33,32,1838.12,3136.03,0.00
2024-12-08 17:11:33,65,2773,33,32,1848.30,3137.00,0.00
2024-12-08 17:11:33,66,2773,34,32,1820.29,3137.02,0.00
2024-12-08 17:11:33,66,2774,34,32,1809.78,3138.00,0.00
2024-12-08 17:11:33,67,2774,34,33,1782.77,3138.02,0.00
2024-12-08 17:11:33,66,2774,33,33,1805.02,3138.02,0.00
2024-12-08 17:11:33,65,2774,33,32,1820.97,3138.06,0.00
2024-12-08 17:11:33,65,2775,33,32,1831.93,3139.00,0.00
2024-12-08 17:11:33,66,2775,33,33,1804.17,3139.02,0.00
2024-12-08 17:11:33,65,2775,33,32,1780.39,3139.72,0.00
2024-12-08 17:11:33,65,2775,33,32,1820.24,3140.00,0.00
2024-12-08 17:11:33,66,2775,33,33,1792.66,3140.02,0.00
2024-12-08 17:11:33,65,2775,33,32,1807.43,3140.08,0.00
2024-12-08 17:11:33,64,2775,32,32,1824.35,3140.13,0.00
2024-12-08 17:11:33,65,2774,32,33,1791.99,3140.29,0.00
2024-12-08 17:11:34,65,2775,32,33,1844.13,3141.00,0.00
2024-12-08 17:11:34,66,2775,32,34,1816.19,3141.02,0.00
2024-12-08 17:11:34,65,2775,31,34,1841.08,3141.08,0.00
2024-12-08 17:11:34,65,2776,31,34,1883.19,3142.00,0.00
2024-12-08 17:11:34,66,2776,31,35,1854.65,3142.02,0.00
2024-12-08 17:11:34,66,2777,31,35,1844.86,3143.00,0.00
2024-12-08 17:11:34,67,2777,32,35,1817.33,3143.02,0.00
2024-12-08 17:11:34,66,2777,32,34,1832.95,3143.08,0.00
2024-12-08 17:11:34,66,2778,32,34,1835.29,3144.00,0.00
2024-12-08 17:11:34,67,2778,32,35,1807.89,3144.02,0.00
2024-12-08 17:11:34,66,2778,32,34,1823.35,3144.08,0.00
2024-12-08 17:11:34,65,2778,31,34,1845.74,3144.23,0.00
2024-12-08 17:11:34,64,2778,31,33,1861.89,3144.63,0.00
2024-12-08 17:11:34,64,2779,31,33,1889.29,3145.00,0.00
2024-12-08 17:11:34,65,2779,32,33,1860.22,3145.02,0.00
2024-12-08 17:11:34,64,2779,31,33,1889.25,3145.02,0.00
2024-12-08 17:11:34,64,2780,31,33,1886.87,3146.00,0.00
2024-12-08 17:11:34,65,2780,31,34,1857.84,3146.02,0.00
2024-12-08 17:11:34,65,2781,31,34,1854.57,3147.00,0.00
2024-12-08 17:11:34,66,2781,31,35,1826.47,3147.02,0.00
2024-12-08 17:11:34,65,2781,31,34,1850.21,3147.03,0.00
2024-12-08 17:11:34,65,2782,31,34,1856.77,3148.00,0.00
2024-12-08 17:11:34,66,2782,31,35,1828.63,3148.02,0.00
2024-12-08 17:11:34,65,2782,31,34,1847.57,3148.05,0.00
2024-12-08 17:11:34,65,2783,31,34,1854.03,3149.00,0.00
2024-12-08 17:11:34,66,2783,32,34,1825.94,3149.02,0.00
2024-12-08 17:11:34,66,2784,32,34,1820.59,3150.00,0.00
2024-12-08 17:11:34,67,2784,32,35,1793.42,3150.02,0.00
2024-12-08 17:11:34,67,2785,32,35,1786.74,3151.00,0.00
2024-12-08 17:11:34,68,2785,33,35,1760.46,3151.02,0.00
2024-12-08 17:11:34,67,2785,33,34,1775.94,3151.09,0.00
2024-12-08 17:11:34,68,2784,34,34,1722.38,3151.87,0.00
2024-12-08 17:11:34,68,2785,34,34,1759.57,3152.00,0.00
2024-12-08 17:11:34,69,2785,35,34,1734.07,3152.01,0.00
2024-12-08 17:11:34,68,2785,35,33,1746.60,3152.12,0.00
2024-12-08 17:11:34,68,2786,35,33,1798.96,3153.00,0.00
2024-12-08 17:11:34,69,2786,35,34,1772.89,3153.01,0.00
2024-12-08 17:11:34,68,2786,34,34,1794.98,3153.12,0.00
2024-12-08 17:11:34,67,2786,33,34,1819.43,3153.13,0.00
2024-12-08 17:11:34,67,2787,33,34,1826.60,3154.00,0.00
2024-12-08 17:11:34,68,2787,33,35,1799.74,3154.02,0.00
2024-12-08 17:11:34,67,2787,32,35,1817.19,3154.02,0.00
2024-12-08 17:11:34,67,2788,32,35,1820.50,3155.00,0.00
2024-12-08 17:11:34,68,2788,32,36,1793.72,3155.02,0.00
2024-12-08 17:11:34,67,2788,32,35,1815.36,3155.12,0.00
2024-12-08 17:11:34,66,2788,31,35,1835.32,3155.36,0.00
2024-12-08 17:11:34,66,2789,31,35,1851.14,3156.00,0.00
2024-12-08 17:11:34,67,2789,32,35,1823.51,3156.02,0.00
2024-12-08 17:11:34,66,2789,31,35,1830.27,3156.36,0.00
2024-12-08 17:11:34,66,2790,31,35,1855.69,3157.00,0.00
2024-12-08 17:11:34,67,2790,32,35,1828.00,3157.02,0.00
2024-12-08 17:11:34,67,2791,32,35,1822.34,3158.00,0.00
2024-12-08 17:11:34,68,2791,33,35,1795.54,3158.02,0.00
2024-12-08 17:11:34,67,2791,33,34,1817.66,3158.13,0.00
2024-12-08 17:11:34,67,2792,33,34,1824.98,3159.00,0.00
2024-12-08 17:11:34,68,2792,33,35,1798.14,3159.02,0.00
2024-12-08 17:11:34,67,2792,32,35,1812.28,3159.12,0.00
2024-12-08 17:11:34,68,2791,33,35,1767.93,3159.40,0.00
2024-12-08 17:11:34,68,2792,33,35,1831.02,3160.00,0.00
2024-12-08 17:11:34,69,2792,34,35,1804.48,3160.01,0.00
2024-12-08 17:11:34,70,2791,35,35,1777.36,3160.09,0.00
2024-12-08 17:11:34,70,2792,35,35,1858.62,3161.00,0.00
2024-12-08 17:11:35,71,2792,35,36,1832.45,3161.01,0.00
2024-12-08 17:11:35,71,2793,35,36,1867.64,3162.00,0.00
2024-12-08 17:11:35,72,2793,36,36,1841.70,3162.01,0.00
2024-12-08 17:11:35,71,2793,36,35,1860.98,3162.08,0.00
2024-12-08 17:11:35,71,2794,36,35,1861.16,3163.00,0.00
2024-12-08 17:11:35,72,2794,36,36,1835.31,3163.01,0.00
2024-12-08 17:11:35,71,2794,36,35,1849.61,3163.11,0.00
2024-12-08 17:11:35,71,2795,36,35,1848.63,3164.00,0.00
2024-12-08 17:11:35,72,2795,36,36,1822.95,3164.01,0.00
2024-12-08 17:11:35,72,2796,36,36,1806.46,3165.00,0.00
2024-12-08 17:11:35,73,2796,37,36,1781.72,3165.01,0.00
2024-12-08 17:11:35,72,2796,37,35,1793.68,3165.14,0.00
2024-12-08 17:11:35,71,2796,36,35,1807.33,3165.23,0.00
2024-12-08 17:11:35,70,2796,35,35,1826.21,3165.44,0.00
2024-12-08 17:11:35,70,2797,35,35,1840.17,3166.00,0.00
2024-12-08 17:11:35,71,2797,35,36,1814.26,3166.01,0.00
2024-12-08 17:11:35,72,2796,35,37,1785.48,3166.15,0.00
2024-12-08 17:11:35,71,2796,34,37,1836.51,3166.18,0.00
2024-12-08 17:11:35,70,2796,33,37,1839.17,3166.54,0.00
2024-12-08 17:11:35,70,2797,33,37,1858.62,3167.00,0.00
2024-12-08 17:11:35,71,2797,34,37,1832.44,3167.01,0.00
2024-12-08 17:11:35,70,2797,33,37,1842.75,3167.19,0.00
2024-12-08 17:11:35,70,2798,33,37,1897.09,3168.00,0.00
2024-12-08 17:11:35,71,2798,34,37,1870.37,3168.01,0.00
2024-12-08 17:11:35,70,2798,34,36,1891.60,3168.17,0.00
2024-12-08 17:11:35,70,2799,34,36,1892.05,3169.00,0.00
2024-12-08 17:11:35,71,2799,35,36,1865.40,3169.01,0.00
2024-12-08 17:11:35,71,2800,35,36,1851.18,3170.00,0.00
2024-12-08 17:11:35,72,2800,36,36,1825.47,3170.01,0.00
2024-12-08 17:11:35,71,2800,35,36,1809.61,3170.70,0.00
2024-12-08 17:11:35,71,2801,35,36,1841.15,3171.00,0.00
2024-12-08 17:11:35,72,2801,35,37,1815.58,3171.01,0.00
2024-12-08 17:11:35,71,2801,35,36,1826.82,3171.17,0.00
2024-12-08 17:11:35,71,2802,35,36,1832.48,3172.00,0.00
2024-12-08 17:11:35,72,2802,35,37,1807.03,3172.01,0.00
2024-12-08 17:11:35,71,2802,34,37,1831.05,3172.03,0.00
2024-12-08 17:11:35,71,2803,34,37,1823.82,3173.00,0.00
2024-12-08 17:11:35,72,2803,34,38,1798.49,3173.01,0.00
2024-12-08 17:11:35,71,2803,34,37,1815.91,3173.17,0.00
2024-12-08 17:11:35,71,2804,34,37,1823.05,3174.00,0.00
2024-12-08 17:11:35,72,2804,34,38,1797.73,3174.01,0.00
2024-12-08 17:11:35,72,2805,34,38,1790.88,3175.00,0.00
2024-12-08 17:11:35,73,2805,35,38,1766.35,3175.01,0.00
2024-12-08 17:11:35,73,2806,35,38,1759.28,3176.00,0.00
2024-12-08 17:11:35,74,2806,36,38,1735.51,3176.01,0.00
2024-12-08 17:11:35,73,2806,36,37,1752.23,3176.19,0.00
2024-12-08 17:11:35,73,2807,36,37,1757.91,3177.00,0.00
2024-12-08 17:11:35,74,2807,36,38,1734.15,3177.01,0.00
2024-12-08 17:11:35,73,2807,35,38,1757.47,3177.01,0.00
2024-12-08 17:11:35,72,2807,34,38,1776.54,3177.17,0.00
2024-12-08 17:11:35,71,2807,33,38,1771.19,3177.68,0.00
2024-12-08 17:11:35,71,2808,33,38,1805.20,3178.00,0.00
2024-12-08 17:11:35,72,2808,33,39,1780.13,3178.01,0.00
2024-12-08 17:11:35,72,2809,33,39,1770.95,3179.00,0.00
2024-12-08 17:11:35,73,2809,34,39,1746.69,3179.01,0.00
2024-12-08 17:11:35,72,2809,34,38,1765.25,3179.18,0.00
2024-12-08 17:11:35,72,2810,34,38,1770.85,3180.00,0.00
2024-12-08 17:11:35,73,2810,35,38,1746.60,3180.01,0.00
2024-12-08 17:11:35,72,2810,35,37,1768.66,3180.07,0.00
2024-12-08 17:11:35,71,2810,34,37,1761.63,3180.69,0.00
2024-12-08 17:11:35,71,2811,34,37,1787.86,3181.00,0.00
2024-12-08 17:11:36,72,2811,35,37,1763.03,3181.01,0.00
2024-12-08 17:11:36,72,2812,35,37,1757.61,3182.00,0.00
2024-12-08 17:11:36,73,2812,35,38,1733.53,3182.01,0.00
2024-12-08 17:11:36,72,2812,35,37,1752.35,3182.17,0.00
2024-12-08 17:11:36,72,2813,35,37,1759.21,3183.00,0.00
2024-12-08 17:11:36,73,2813,35,38,1735.11,3183.01,0.00
2024-12-08 17:11:36,72,2813,34,38,1757.45,3183.07,0.00
2024-12-08 17:11:36,71,2813,33,38,1780.84,3183.11,0.00
2024-12-08 17:11:36,71,2814,33,38,1775.96,3184.00,0.00
2024-12-08 17:11:36,72,2814,33,39,1751.29,3184.01,0.00
2024-12-08 17:11:36,71,2814,33,38,1762.99,3184.14,0.00
2024-12-08 17:11:36,70,2814,32,38,1776.16,3184.41,0.00
2024-12-08 17:11:36,70,2815,32,38,1793.59,3185.00,0.00
2024-12-08 17:11:36,71,2815,32,39,1768.33,3185.01,0.00
2024-12-08 17:11:36,70,2815,31,39,1793.13,3185.01,0.00
2024-12-08 17:11:36,69,2815,30,39,1804.86,3185.16,0.00
2024-12-08 17:11:36,69,2816,30,39,1809.11,3186.00,0.00
2024-12-08 17:11:36,70,2816,31,39,1783.26,3186.01,0.00
2024-12-08 17:11:36,69,2816,30,39,1775.00,3186.41,0.00
2024-12-08 17:11:36,70,2815,31,39,1747.85,3186.49,0.00
2024-12-08 17:11:36,70,2816,31,39,1788.77,3187.00,0.00
2024-12-08 17:11:36,71,2816,31,40,1763.58,3187.01,0.00
2024-12-08 17:11:36,70,2816,30,40,1786.52,3187.09,0.00
2024-12-08 17:11:36,69,2816,30,39,1804.86,3187.19,0.00
2024-12-08 17:11:36,69,2817,30,39,1855.62,3188.00,0.00
2024-12-08 17:11:36,70,2817,30,40,1829.11,3188.01,0.00
2024-12-08 17:11:36,70,2818,30,40,1815.24,3189.00,0.00
2024-12-08 17:11:36,71,2818,30,41,1789.67,3189.01,0.00
2024-12-08 17:11:36,71,2819,30,41,1776.19,3190.00,0.00
2024-12-08 17:11:36,72,2819,30,42,1751.53,3190.01,0.00
2024-12-08 17:11:36,71,2819,29,42,1766.31,3190.03,0.00
2024-12-08 17:11:36,70,2819,29,41,1784.23,3190.17,0.00
2024-12-08 17:11:36,69,2819,29,40,1795.41,3190.57,0.00
2024-12-08 17:11:36,69,2820,29,40,1828.11,3191.00,0.00
2024-12-08 17:11:36,70,2820,29,41,1802.00,3191.01,0.00
2024-12-08 17:11:36,69,2820,28,41,1823.22,3191.13,0.00
2024-12-08 17:11:36,69,2821,28,41,1822.10,3192.00,0.00
2024-12-08 17:11:36,70,2821,29,41,1796.07,3192.01,0.00
2024-12-08 17:11:36,69,2821,29,40,1805.45,3192.16,0.00
2024-12-08 17:11:36,69,2822,29,40,1816.00,3193.00,0.00
2024-12-08 17:11:36,70,2822,29,41,1790.05,3193.01,0.00
2024-12-08 17:11:36,70,2823,29,41,1784.21,3194.00,0.00
2024-12-08 17:11:36,71,2823,29,42,1759.08,3194.01,0.00
2024-12-08 17:11:36,70,2823,28,42,1780.12,3194.14,0.00
2024-12-08 17:11:36,69,2823,28,41,1796.66,3194.15,0.00
2024-12-08 17:11:36,69,2824,28,41,1805.82,3195.00,0.00
2024-12-08 17:11:36,70,2824,29,41,1780.02,3195.01,0.00
2024-12-08 17:11:36,70,2825,29,41,1775.81,3196.00,0.00
2024-12-08 17:11:37,71,2825,29,42,1750.80,3196.01,0.00
2024-12-08 17:11:37,70,2825,29,41,1763.05,3196.14,0.00
2024-12-08 17:11:37,69,2825,28,41,1770.98,3196.70,0.00
2024-12-08 17:11:37,69,2826,28,41,1798.55,3197.00,0.00
2024-12-08 17:11:37,70,2826,28,42,1772.86,3197.01,0.00
2024-12-08 17:11:37,69,2826,28,41,1782.78,3197.19,0.00
2024-12-08 17:11:37,69,2827,28,41,1793.54,3198.00,0.00
2024-12-08 17:11:37,70,2827,28,42,1767.92,3198.01,0.00
2024-12-08 17:11:37,69,2827,28,41,1781.05,3198.15,0.00
2024-12-08 17:11:37,69,2828,28,41,1789.56,3199.00,0.00
2024-12-08 17:11:37,70,2828,29,41,1763.99,3199.01,0.00
2024-12-08 17:11:37,69,2828,28,41,1786.79,3199.09,0.00
2024-12-08 17:11:37,69,2829,28,41,1783.15,3200.00,0.00
2024-12-08 17:11:37,70,2829,29,41,1757.68,3200.01,0.00
2024-12-08 17:11:37,69,2829,28,41,1782.69,3200.01,0.00
2024-12-08 17:11:37,68,2829,28,40,1790.10,3200.22,0.00
2024-12-08 17:11:37,67,2829,27,40,1803.57,3200.52,0.00
2024-12-08 17:11:37,67,2830,27,40,1836.42,3201.00,0.00
2024-12-08 17:11:37,68,2830,27,41,1809.41,3201.02,0.00
2024-12-08 17:11:37,67,2830,27,40,1832.61,3201.08,0.00
2024-12-08 17:11:37,67,2831,27,40,1840.10,3202.00,0.00
2024-12-08 17:11:37,68,2831,27,41,1813.04,3202.02,0.00
2024-12-08 17:11:37,67,2831,27,40,1830.08,3202.10,0.00
2024-12-08 17:11:37,67,2832,27,40,1837.53,3203.00,0.00
2024-12-08 17:11:37,68,2832,27,41,1810.50,3203.02,0.00
2024-12-08 17:11:37,68,2833,27,41,1803.95,3204.00,0.00
2024-12-08 17:11:37,69,2833,27,42,1777.80,3204.01,0.00
2024-12-08 17:11:37,68,2833,27,41,1793.44,3204.10,0.00
2024-12-08 17:11:37,67,2833,27,40,1818.68,3204.13,0.00
2024-12-08 17:11:37,66,2833,26,40,1827.30,3204.38,0.00
2024-12-08 17:11:37,66,2834,26,40,1856.40,3205.00,0.00
2024-12-08 17:11:37,67,2834,26,41,1828.69,3205.02,0.00
2024-12-08 17:11:37,66,2834,25,41,1853.91,3205.05,0.00
2024-12-08 17:11:37,66,2835,25,41,1850.72,3206.00,0.00
2024-12-08 17:11:37,67,2835,25,42,1823.10,3206.02,0.00
2024-12-08 17:11:37,66,2835,25,41,1839.21,3206.11,0.00
2024-12-08 17:11:37,66,2836,25,41,1847.48,3207.00,0.00
2024-12-08 17:11:37,67,2836,26,41,1819.91,3207.02,0.00
2024-12-08 17:11:37,66,2836,25,41,1845.93,3207.02,0.00
2024-12-08 17:11:37,66,2837,25,41,1841.38,3208.00,0.00
2024-12-08 17:11:37,67,2837,26,41,1813.90,3208.02,0.00
2024-12-08 17:11:37,66,2837,25,41,1832.15,3208.05,0.00
2024-12-08 17:11:37,66,2838,25,41,1837.90,3209.00,0.00
2024-12-08 17:11:37,67,2838,26,41,1810.47,3209.02,0.00
2024-12-08 17:11:37,66,2838,25,41,1818.19,3209.30,0.00
2024-12-08 17:11:37,66,2839,25,41,1834.76,3210.00,0.00
2024-12-08 17:11:37,67,2839,26,41,1807.38,3210.02,0.00
2024-12-08 17:11:37,67,2840,26,41,1805.00,3211.00,0.00
2024-12-08 17:11:37,68,2840,26,42,1778.45,3211.02,0.00
2024-12-08 17:11:37,67,2840,26,41,1798.85,3211.09,0.00
2024-12-08 17:11:37,66,2840,25,41,1823.69,3211.15,0.00
2024-12-08 17:11:37,66,2841,25,41,1835.91,3212.00,0.00
2024-12-08 17:11:37,67,2841,25,42,1808.51,3212.02,0.00
2024-12-08 17:11:37,67,2842,25,42,1806.19,3213.00,0.00
2024-12-08 17:11:37,68,2842,26,42,1779.63,3213.02,0.00
2024-12-08 17:11:37,67,2842,26,41,1804.52,3213.06,0.00
2024-12-08 17:11:37,66,2842,26,40,1826.99,3213.06,0.00
2024-12-08 17:11:37,66,2843,26,40,1836.25,3214.00,0.00
2024-12-08 17:11:37,67,2843,27,40,1808.85,3214.02,0.00
2024-12-08 17:11:37,66,2843,27,39,1826.57,3214.08,0.00
2024-12-08 17:11:38,66,2844,27,39,1836.04,3215.00,0.00
2024-12-08 17:11:38,67,2844,27,40,1808.64,3215.02,0.00
2024-12-08 17:11:38,66,2844,27,39,1826.87,3215.06,0.00
2024-12-08 17:11:38,66,2845,27,39,1835.54,3216.00,0.00
2024-12-08 17:11:38,67,2845,27,40,1808.15,3216.02,0.00
2024-12-08 17:11:38,67,2846,27,40,1802.67,3217.00,0.00
2024-12-08 17:11:38,68,2846,27,41,1776.16,3217.02,0.00
2024-12-08 17:11:38,67,2846,27,40,1800.96,3217.05,0.00
2024-12-08 17:11:38,67,2847,27,40,1799.35,3218.00,0.00
2024-12-08 17:11:38,68,2847,27,41,1772.89,3218.02,0.00
2024-12-08 17:11:38,67,2847,27,40,1793.59,3218.06,0.00
2024-12-08 17:11:38,66,2847,26,40,1817.86,3218.14,0.00
2024-12-08 17:11:38,66,2848,26,40,1829.62,3219.00,0.00
2024-12-08 17:11:38,67,2848,26,41,1802.31,3219.02,0.00
2024-12-08 17:11:38,68,2847,26,42,1749.34,3219.57,0.00
2024-12-08 17:11:38,68,2848,26,42,1787.30,3220.00,0.00
2024-12-08 17:11:38,69,2848,27,42,1761.40,3220.01,0.00
2024-12-08 17:11:38,68,2848,27,41,1778.79,3220.07,0.00
2024-12-08 17:11:38,68,2849,27,41,1833.73,3221.00,0.00
2024-12-08 17:11:38,69,2849,28,41,1807.15,3221.01,0.00
2024-12-08 17:11:38,69,2850,28,41,1803.81,3222.00,0.00
2024-12-08 17:11:38,70,2850,29,41,1778.05,3222.01,0.00
2024-12-08 17:11:38,69,2850,29,40,1795.88,3222.07,0.00
2024-12-08 17:11:38,69,2851,29,40,1803.91,3223.00,0.00
2024-12-08 17:11:38,70,2851,29,41,1778.14,3223.01,0.00
2024-12-08 17:11:38,69,2851,28,41,1765.43,3223.67,0.00
2024-12-08 17:11:38,69,2852,28,41,1801.39,3224.00,0.00
2024-12-08 17:11:38,70,2852,28,42,1775.66,3224.01,0.00
2024-12-08 17:11:38,69,2852,27,42,1800.46,3224.03,0.00
2024-12-08 17:11:38,68,2852,27,41,1820.30,3224.06,0.00
2024-12-08 17:11:38,68,2853,27,41,1827.45,3225.00,0.00
2024-12-08 17:11:38,69,2853,28,41,1800.96,3225.01,0.00
2024-12-08 17:11:38,68,2853,27,41,1817.50,3225.09,0.00
2024-12-08 17:11:38,68,2854,27,41,1825.01,3226.00,0.00
2024-12-08 17:11:38,69,2854,28,41,1798.56,3226.01,0.00
2024-12-08 17:11:38,68,2854,27,41,1824.53,3226.02,0.00
2024-12-08 17:11:38,67,2854,27,40,1841.18,3226.08,0.00
2024-12-08 17:11:38,67,2855,27,40,1848.21,3227.00,0.00
2024-12-08 17:11:38,68,2855,27,41,1821.03,3227.02,0.00
2024-12-08 17:11:38,67,2855,26,41,1826.68,3227.39,0.00
2024-12-08 17:11:38,67,2856,26,41,1843.14,3228.00,0.00
2024-12-08 17:11:38,68,2856,27,41,1816.04,3228.02,0.00
2024-12-08 17:11:38,67,2856,27,40,1833.03,3228.08,0.00
2024-12-08 17:11:38,67,2857,27,40,1839.36,3229.00,0.00
2024-12-08 17:11:38,68,2857,27,41,1812.31,3229.02,0.00
2024-12-08 17:11:38,68,2858,27,41,1806.14,3230.00,0.00
2024-12-08 17:11:38,69,2858,27,42,1779.96,3230.01,0.00
2024-12-08 17:11:38,68,2858,26,42,1806.14,3230.02,0.00
2024-12-08 17:11:38,67,2858,26,41,1822.51,3230.09,0.00
2024-12-08 17:11:38,66,2858,25,41,1838.44,3230.27,0.00
2024-12-08 17:11:38,66,2859,25,41,1860.75,3231.00,0.00
2024-12-08 17:11:38,67,2859,25,42,1832.98,3231.02,0.00
2024-12-08 17:11:38,67,2860,25,42,1827.11,3232.00,0.00
2024-12-08 17:11:38,68,2860,25,43,1800.24,3232.02,0.00
2024-12-08 17:11:38,67,2860,24,43,1815.31,3232.12,0.00
2024-12-08 17:11:38,66,2860,24,42,1832.04,3232.14,0.00
2024-12-08 17:11:38,66,2861,24,42,1850.09,3233.00,0.00
2024-12-08 17:11:38,67,2861,25,42,1822.48,3233.02,0.00
2024-12-08 17:11:38,67,2862,25,42,1816.71,3234.00,0.00
2024-12-08 17:11:38,68,2862,26,42,1789.99,3234.02,0.00
2024-12-08 17:11:38,67,2862,26,41,1802.26,3234.15,0.00
2024-12-08 17:11:39,67,2863,26,41,1810.40,3235.00,0.00
2024-12-08 17:11:39,68,2863,27,41,1783.78,3235.02,0.00
2024-12-08 17:11:39,67,2863,26,41,1780.60,3235.37,0.00
2024-12-08 17:11:39,66,2863,26,40,1797.93,3235.56,0.00
2024-12-08 17:11:39,66,2864,26,40,1833.06,3236.00,0.00
2024-12-08 17:11:39,67,2864,26,41,1805.70,3236.02,0.00
2024-12-08 17:11:39,67,2865,26,41,1803.36,3237.00,0.00
2024-12-08 17:11:39,68,2865,27,41,1776.84,3237.02,0.00
2024-12-08 17:11:39,67,2865,27,40,1798.08,3237.16,0.00
2024-12-08 17:11:39,67,2866,27,40,1810.20,3238.00,0.00
2024-12-08 17:11:39,68,2866,27,41,1783.58,3238.02,0.00
2024-12-08 17:11:39,67,2866,26,41,1809.72,3238.03,0.00
2024-12-08 17:11:39,67,2867,26,41,1807.86,3239.00,0.00
2024-12-08 17:11:39,68,2867,26,42,1781.27,3239.02,0.00
2024-12-08 17:11:39,69,2866,26,43,1754.99,3239.06,0.00
2024-12-08 17:11:39,68,2866,26,42,1805.61,3239.16,0.00
2024-12-08 17:11:39,68,2867,26,42,1817.08,3240.00,0.00
2024-12-08 17:11:39,69,2867,26,43,1790.74,3240.01,0.00
2024-12-08 17:11:39,68,2867,25,43,1812.83,3240.15,0.00
2024-12-08 17:11:39,68,2868,25,43,1861.97,3241.00,0.00
2024-12-08 17:11:39,69,2868,25,44,1834.98,3241.01,0.00
2024-12-08 17:11:39,68,2868,24,44,1857.72,3241.15,0.00
2024-12-08 17:11:39,68,2869,24,44,1868.74,3242.00,0.00
2024-12-08 17:11:39,69,2869,25,44,1841.65,3242.01,0.00
2024-12-08 17:11:39,68,2869,25,43,1864.01,3242.15,0.00
2024-12-08 17:11:39,68,2870,25,43,1875.04,3243.00,0.00
2024-12-08 17:11:39,69,2870,25,44,1847.86,3243.01,0.00
2024-12-08 17:11:39,69,2871,25,44,1844.41,3244.00,0.00
2024-12-08 17:11:39,70,2871,25,45,1818.06,3244.01,0.00
2024-12-08 17:11:39,69,2871,25,44,1830.81,3244.15,0.00
2024-12-08 17:11:39,69,2872,25,44,1841.22,3245.00,0.00
2024-12-08 17:11:39,70,2872,26,44,1814.91,3245.01,0.00
2024-12-08 17:11:39,70,2873,26,44,1811.30,3246.00,0.00
2024-12-08 17:11:39,71,2873,27,44,1785.79,3246.01,0.00
2024-12-08 17:11:39,70,2873,27,43,1798.35,3246.14,0.00
2024-12-08 17:11:39,70,2874,27,43,1808.15,3247.00,0.00
2024-12-08 17:11:39,71,2874,28,43,1782.68,3247.01,0.00
2024-12-08 17:11:39,71,2875,28,43,1778.55,3248.00,0.00
2024-12-08 17:11:39,72,2875,29,43,1753.85,3248.01,0.00
2024-12-08 17:11:39,71,2875,29,42,1766.23,3248.14,0.00
2024-12-08 17:11:39,70,2875,28,42,1783.23,3248.40,0.00
2024-12-08 17:11:39,69,2875,27,42,1808.60,3248.41,0.00
2024-12-08 17:11:39,69,2876,27,42,1827.37,3249.00,0.00
2024-12-08 17:11:39,70,2876,27,43,1801.27,3249.01,0.00
2024-12-08 17:11:39,70,2877,27,43,1797.52,3250.00,0.00
2024-12-08 17:11:39,71,2877,27,44,1772.20,3250.01,0.00
2024-12-08 17:11:39,70,2877,26,44,1795.22,3250.09,0.00
2024-12-08 17:11:39,69,2877,26,43,1810.50,3250.15,0.00
2024-12-08 17:11:39,69,2878,26,43,1820.92,3251.00,0.00
2024-12-08 17:11:39,70,2878,26,44,1794.90,3251.01,0.00
2024-12-08 17:11:39,70,2879,26,44,1790.73,3252.00,0.00
2024-12-08 17:11:39,71,2879,26,45,1765.51,3252.01,0.00
2024-12-08 17:11:39,70,2879,25,45,1790.26,3252.01,0.00
2024-12-08 17:11:39,71,2878,25,46,1765.05,3252.04,0.00
2024-12-08 17:11:39,70,2878,24,46,1787.12,3252.13,0.00
2024-12-08 17:11:39,69,2878,24,45,1805.01,3252.13,0.00
2024-12-08 17:11:39,69,2879,24,45,1822.83,3253.00,0.00
2024-12-08 17:11:39,70,2879,24,46,1796.79,3253.01,0.00
2024-12-08 17:11:39,70,2880,24,46,1835.41,3254.00,0.00
2024-12-08 17:11:39,71,2880,24,47,1809.56,3254.01,0.00
2024-12-08 17:11:39,70,2880,24,46,1822.27,3254.14,0.00
2024-12-08 17:11:40,69,2880,23,46,1839.91,3254.33,0.00
2024-12-08 17:11:40,68,2880,22,46,1851.33,3254.60,0.00
2024-12-08 17:11:40,68,2881,22,46,1886.57,3255.00,0.00
2024-12-08 17:11:40,69,2881,23,46,1859.23,3255.01,0.00
2024-12-08 17:11:40,69,2882,23,46,1855.52,3256.00,0.00
2024-12-08 17:11:40,70,2882,23,47,1829.02,3256.01,0.00
2024-12-08 17:11:40,69,2882,22,47,1852.07,3256.10,0.00
2024-12-08 17:11:40,68,2882,22,46,1869.74,3256.13,0.00
2024-12-08 17:11:40,67,2882,21,46,1878.50,3256.70,0.00
2024-12-08 17:11:40,67,2883,21,46,1917.64,3257.00,0.00
2024-12-08 17:11:40,68,2883,22,46,1889.44,3257.02,0.00
2024-12-08 17:11:40,68,2884,22,46,1886.66,3258.00,0.00
2024-12-08 17:11:40,69,2884,23,46,1859.32,3258.01,0.00
2024-12-08 17:11:40,68,2884,23,45,1874.72,3258.13,0.00
2024-12-08 17:11:40,68,2885,23,45,1885.33,3259.00,0.00
2024-12-08 17:11:40,69,2885,24,45,1858.00,3259.01,0.00
2024-12-08 17:11:40,69,2886,24,45,1854.79,3260.00,0.00
2024-12-08 17:11:40,70,2886,25,45,1828.30,3260.01,0.00
2024-12-08 17:11:40,69,2886,25,44,1842.54,3260.15,0.00
2024-12-08 17:11:40,68,2886,24,44,1868.69,3260.18,0.00
2024-12-08 17:11:40,68,2887,24,44,1880.73,3261.00,0.00
2024-12-08 17:11:40,69,2887,24,45,1853.47,3261.01,0.00
2024-12-08 17:11:40,69,2888,24,45,1850.26,3262.00,0.00
2024-12-08 17:11:40,70,2888,24,46,1823.83,3262.01,0.00
2024-12-08 17:11:40,69,2888,24,45,1838.47,3262.15,0.00
2024-12-08 17:11:40,68,2888,23,45,1856.04,3262.43,0.00
2024-12-08 17:11:40,68,2889,23,45,1885.72,3263.00,0.00
2024-12-08 17:11:40,69,2889,23,46,1858.39,3263.01,0.00
2024-12-08 17:11:40,68,2889,22,46,1883.81,3263.03,0.00
2024-12-08 17:11:40,68,2890,22,46,1891.10,3264.00,0.00
2024-12-08 17:11:40,69,2890,22,47,1863.69,3264.01,0.00
2024-12-08 17:11:40,68,2890,21,47,1887.75,3264.04,0.00
2024-12-08 17:11:40,67,2890,21,46,1915.87,3264.05,0.00
2024-12-08 17:11:40,66,2890,21,45,1935.51,3264.11,0.00
2024-12-08 17:11:40,66,2891,21,45,1956.29,3265.00,0.00
2024-12-08 17:11:40,67,2891,21,46,1927.09,3265.02,0.00
2024-12-08 17:11:40,67,2892,21,46,1924.39,3266.00,0.00
2024-12-08 17:11:40,68,2892,22,46,1896.09,3266.02,0.00
2024-12-08 17:11:40,67,2892,22,45,1923.43,3266.03,0.00
2024-12-08 17:11:40,66,2892,22,44,1942.69,3266.09,0.00
2024-12-08 17:11:40,65,2892,21,44,1964.86,3266.20,0.00
2024-12-08 17:11:40,65,2893,21,44,1989.52,3267.00,0.00
2024-12-08 17:11:40,66,2893,21,45,1959.37,3267.02,0.00
2024-12-08 17:11:40,66,2894,21,45,1957.39,3268.00,0.00
2024-12-08 17:11:40,67,2894,22,45,1928.17,3268.02,0.00
2024-12-08 17:11:40,66,2894,22,44,1947.51,3268.09,0.00
2024-12-08 17:11:40,65,2894,21,44,1964.35,3268.29,0.00
2024-12-08 17:11:40,65,2895,21,44,1992.00,3269.00,0.00
2024-12-08 17:11:40,66,2895,22,44,1961.82,3269.02,0.00
2024-12-08 17:11:40,66,2896,22,44,1959.81,3270.00,0.00
2024-12-08 17:11:40,67,2896,22,45,1930.56,3270.02,0.00
2024-12-08 17:11:40,66,2896,21,45,1947.10,3270.14,0.00
2024-12-08 17:11:40,66,2897,21,45,1959.06,3271.00,0.00
2024-12-08 17:11:40,67,2897,21,46,1929.82,3271.02,0.00
2024-12-08 17:11:40,66,2897,21,45,1950.16,3271.09,0.00
2024-12-08 17:11:40,66,2898,21,45,1960.65,3272.00,0.00
2024-12-08 17:11:40,67,2898,21,46,1931.39,3272.02,0.00
2024-12-08 17:11:40,67,2899,21,46,1929.05,3273.00,0.00
2024-12-08 17:11:40,68,2899,22,46,1900.68,3273.02,0.00
2024-12-08 17:11:40,67,2899,22,45,1928.08,3273.03,0.00
2024-12-08 17:11:40,66,2899,22,44,1949.87,3273.08,0.00
2024-12-08 17:11:41,66,2900,22,44,1959.86,3274.00,0.00
2024-12-08 17:11:41,67,2900,22,45,1930.61,3274.02,0.00
2024-12-08 17:11:41,67,2901,22,45,1928.27,3275.00,0.00
2024-12-08 17:11:41,68,2901,23,45,1899.91,3275.02,0.00
2024-12-08 17:11:41,67,2901,22,45,1926.33,3275.06,0.00
2024-12-08 17:11:41,66,2901,22,44,1947.54,3275.08,0.00
2024-12-08 17:11:41,65,2901,21,44,1968.06,3275.37,0.00
2024-12-08 17:11:41,65,2902,21,44,1988.16,3276.00,0.00
2024-12-08 17:11:41,66,2902,22,44,1958.04,3276.02,0.00
2024-12-08 17:11:41,65,2902,22,43,1977.60,3276.08,0.00
2024-12-08 17:11:41,64,2902,21,43,1998.78,3276.08,0.00
2024-12-08 17:11:41,63,2902,20,43,2021.78,3276.35,0.00
2024-12-08 17:11:41,63,2903,20,43,2052.95,3277.00,0.00
2024-12-08 17:11:41,64,2903,20,44,2020.87,3277.02,0.00
2024-12-08 17:11:41,64,2904,20,44,2019.95,3278.00,0.00
2024-12-08 17:11:41,65,2904,20,45,1988.87,3278.02,0.00
2024-12-08 17:11:41,64,2904,20,44,2008.70,3278.08,0.00
2024-12-08 17:11:41,64,2905,20,44,2020.05,3279.00,0.00
2024-12-08 17:11:41,65,2905,21,44,1988.98,3279.02,0.00
2024-12-08 17:11:41,65,2906,21,44,1987.56,3280.00,0.00
2024-12-08 17:11:41,66,2906,21,45,1957.45,3280.02,0.00
2024-12-08 17:11:41,65,2906,21,44,1973.98,3280.12,0.00
2024-12-08 17:11:41,65,2907,21,44,1982.31,3281.00,0.00
2024-12-08 17:11:41,66,2907,21,45,1952.28,3281.02,0.00
2024-12-08 17:11:41,66,2908,21,45,1941.15,3282.00,0.00
2024-12-08 17:11:41,67,2908,22,45,1912.18,3282.02,0.00
2024-12-08 17:11:41,66,2908,22,44,1901.53,3282.26,0.00
2024-12-08 17:11:41,66,2909,22,44,1927.40,3283.00,0.00
2024-12-08 17:11:41,67,2909,23,44,1898.64,3283.02,0.00
2024-12-08 17:11:41,66,2909,23,43,1922.47,3283.15,0.00
2024-12-08 17:11:41,66,2910,23,43,1934.96,3284.00,0.00
2024-12-08 17:11:41,67,2910,23,44,1906.08,3284.02,0.00
2024-12-08 17:11:41,67,2911,23,44,1903.72,3285.00,0.00
2024-12-08 17:11:41,68,2911,24,44,1875.72,3285.02,0.00
2024-12-08 17:11:41,67,2911,24,43,1889.54,3285.15,0.00
2024-12-08 17:11:41,67,2912,24,43,1901.35,3286.00,0.00
2024-12-08 17:11:41,68,2912,25,43,1873.39,3286.02,0.00
2024-12-08 17:11:41,67,2912,24,43,1896.00,3286.16,0.00
2024-12-08 17:11:41,66,2912,23,43,1886.70,3286.71,0.00
2024-12-08 17:11:41,66,2913,23,43,1927.26,3287.00,0.00
2024-12-08 17:11:41,67,2913,24,43,1898.50,3287.02,0.00
2024-12-08 17:11:41,66,2913,24,42,1911.86,3287.17,0.00
2024-12-08 17:11:41,66,2914,24,42,1924.86,3288.00,0.00
2024-12-08 17:11:41,67,2914,25,42,1896.13,3288.02,0.00
2024-12-08 17:11:41,67,2915,25,42,1893.76,3289.00,0.00
2024-12-08 17:11:41,68,2915,26,42,1865.91,3289.02,0.00
2024-12-08 17:11:41,67,2915,26,41,1878.58,3289.16,0.00
2024-12-08 17:11:41,67,2916,26,41,1890.90,3290.00,0.00
2024-12-08 17:11:41,68,2916,26,42,1863.09,3290.02,0.00
2024-12-08 17:11:41,67,2916,26,41,1889.44,3290.05,0.00
2024-12-08 17:11:41,67,2917,26,41,1888.04,3291.00,0.00
2024-12-08 17:11:41,68,2917,27,41,1860.27,3291.02,0.00
2024-12-08 17:11:41,67,2917,27,40,1873.83,3291.15,0.00
2024-12-08 17:11:41,67,2918,27,40,1885.66,3292.00,0.00
2024-12-08 17:11:41,68,2918,28,40,1857.93,3292.02,0.00
2024-12-08 17:11:41,68,2919,28,40,1855.11,3293.00,0.00
2024-12-08 17:11:41,69,2919,29,40,1828.22,3293.01,0.00
2024-12-08 17:11:41,68,2919,29,39,1841.09,3293.15,0.00
2024-12-08 17:11:42,68,2920,29,39,1852.28,3294.00,0.00
2024-12-08 17:11:42,69,2920,30,39,1825.43,3294.01,0.00
2024-12-08 17:11:42,68,2920,29,39,1847.95,3294.15,0.00
2024-12-08 17:11:42,68,2921,29,39,1849.45,3295.00,0.00
2024-12-08 17:11:42,69,2921,30,39,1822.65,3295.01,0.00
2024-12-08 17:11:42,69,2922,30,39,1819.38,3296.00,0.00
2024-12-08 17:11:42,70,2922,30,40,1793.39,3296.01,0.00
2024-12-08 17:11:42,69,2922,30,39,1814.63,3296.15,0.00
2024-12-08 17:11:42,68,2922,29,39,1823.19,3296.71,0.00
2024-12-08 17:11:42,68,2923,29,39,1852.51,3297.00,0.00
2024-12-08 17:11:42,69,2923,30,39,1825.66,3297.01,0.00
2024-12-08 17:11:42,69,2924,30,39,1822.28,3298.00,0.00
2024-12-08 17:11:42,70,2924,30,40,1796.25,3298.01,0.00
2024-12-08 17:11:42,69,2924,30,39,1807.97,3298.15,0.00
2024-12-08 17:11:42,69,2925,30,39,1818.10,3299.00,0.00
2024-12-08 17:11:42,70,2925,30,40,1792.12,3299.01,0.00
2024-12-08 17:11:42,69,2925,30,39,1816.78,3299.04,0.00
2024-12-08 17:11:42,69,2926,30,39,1813.80,3300.00,0.00
2024-12-08 17:11:42,70,2926,31,39,1787.89,3300.01,0.00
2024-12-08 17:11:42,69,2926,31,38,1800.43,3300.13,0.00
2024-12-08 17:11:42,68,2926,30,38,1806.18,3300.44,0.00
2024-12-08 17:11:42,67,2926,29,38,1824.93,3300.70,0.00
2024-12-08 17:11:42,67,2927,29,38,1864.58,3301.00,0.00
2024-12-08 17:11:42,68,2927,29,39,1837.16,3301.02,0.00
2024-12-08 17:11:42,68,2928,29,39,1833.27,3302.00,0.00
2024-12-08 17:11:42,69,2928,29,40,1806.71,3302.01,0.00
2024-12-08 17:11:42,68,2928,28,40,1830.38,3302.10,0.00
2024-12-08 17:11:42,67,2928,28,39,1847.36,3302.13,0.00
2024-12-08 17:11:42,68,2927,28,40,1814.42,3302.34,0.00
2024-12-08 17:11:42,68,2928,28,40,1857.71,3303.00,0.00
2024-12-08 17:11:42,69,2928,29,40,1830.79,3303.01,0.00
2024-12-08 17:11:42,69,2929,29,40,1873.02,3304.00,0.00
2024-12-08 17:11:42,70,2929,29,41,1846.26,3304.01,0.00
2024-12-08 17:11:42,69,2929,29,40,1860.59,3304.13,0.00
2024-12-08 17:11:42,69,2930,29,40,1868.18,3305.00,0.00
2024-12-08 17:11:42,70,2930,29,41,1841.49,3305.01,0.00
2024-12-08 17:11:42,69,2930,28,41,1852.89,3305.17,0.00
2024-12-08 17:11:42,70,2929,29,41,1809.84,3305.67,0.00
2024-12-08 17:11:42,70,2930,29,41,1855.52,3306.00,0.00
2024-12-08 17:11:42,71,2930,29,42,1829.39,3306.01,0.00
2024-12-08 17:11:42,70,2930,28,42,1852.70,3306.10,0.00
2024-12-08 17:11:42,69,2930,28,41,1869.98,3306.13,0.00
2024-12-08 17:11:42,69,2931,28,41,1925.45,3307.00,0.00
2024-12-08 17:11:42,70,2931,29,41,1897.95,3307.01,0.00
2024-12-08 17:11:42,69,2931,28,41,1911.58,3307.15,0.00
2024-12-08 17:11:42,69,2932,28,41,1919.45,3308.00,0.00
2024-12-08 17:11:42,70,2932,29,41,1892.03,3308.01,0.00
2024-12-08 17:11:42,69,2932,29,40,1907.49,3308.13,0.00
2024-12-08 17:11:42,69,2933,29,40,1914.87,3309.00,0.00
2024-12-08 17:11:42,70,2933,30,40,1887.51,3309.01,0.00
2024-12-08 17:11:42,69,2933,29,40,1904.81,3309.12,0.00
2024-12-08 17:11:42,69,2934,29,40,1911.49,3310.00,0.00
2024-12-08 17:11:42,70,2934,29,41,1884.18,3310.01,0.00
2024-12-08 17:11:42,69,2934,29,40,1897.60,3310.15,0.00
2024-12-08 17:11:42,69,2935,29,40,1905.02,3311.00,0.00
2024-12-08 17:11:42,70,2935,29,41,1877.81,3311.01,0.00
2024-12-08 17:11:43,70,2936,29,41,1870.94,3312.00,0.00
2024-12-08 17:11:43,71,2936,29,42,1844.59,3312.01,0.00
2024-12-08 17:11:43,70,2936,29,41,1857.71,3312.14,0.00
2024-12-08 17:11:43,69,2936,28,41,1874.14,3312.28,0.00
2024-12-08 17:11:43,69,2937,28,41,1897.76,3313.00,0.00
2024-12-08 17:11:43,70,2937,28,42,1870.64,3313.01,0.00
2024-12-08 17:11:43,70,2938,28,42,1864.36,3314.00,0.00
2024-12-08 17:11:43,71,2938,29,42,1838.10,3314.01,0.00
2024-12-08 17:11:43,70,2938,29,41,1847.34,3314.19,0.00
2024-12-08 17:11:43,70,2939,29,41,1858.01,3315.00,0.00
2024-12-08 17:11:43,71,2939,30,41,1831.84,3315.01,0.00
2024-12-08 17:11:43,70,2939,29,41,1847.61,3315.13,0.00
2024-12-08 17:11:43,70,2940,29,41,1854.41,3316.00,0.00
2024-12-08 17:11:43,71,2940,29,42,1828.29,3316.01,0.00
2024-12-08 17:11:43,70,2940,29,41,1852.99,3316.04,0.00
2024-12-08 17:11:43,69,2940,29,40,1864.36,3316.16,0.00
2024-12-08 17:11:43,69,2941,29,40,1874.95,3317.00,0.00
2024-12-08 17:11:43,70,2941,29,41,1848.16,3317.01,0.00
2024-12-08 17:11:43,69,2941,29,40,1873.51,3317.04,0.00
2024-12-08 17:11:43,69,2942,29,40,1867.80,3318.00,0.00
2024-12-08 17:11:43,70,2942,30,40,1841.12,3318.01,0.00
2024-12-08 17:11:43,69,2942,30,39,1866.36,3318.04,0.00
2024-12-08 17:11:43,68,2942,30,38,1877.29,3318.15,0.00
2024-12-08 17:11:43,67,2942,29,38,1905.31,3318.15,0.00
2024-12-08 17:11:43,66,2942,28,38,1915.28,3318.55,0.00
2024-12-08 17:11:43,66,2943,28,38,1950.42,3319.00,0.00
2024-12-08 17:11:43,67,2943,28,39,1921.31,3319.02,0.00
2024-12-08 17:11:43,66,2943,28,38,1949.42,3319.03,0.00
2024-12-08 17:11:43,65,2943,28,37,1978.90,3319.03,0.00
2024-12-08 17:11:43,65,2944,28,37,1972.88,3320.00,0.00
2024-12-08 17:11:43,66,2944,29,37,1942.99,3320.02,0.00
2024-12-08 17:11:43,65,2944,29,36,1967.05,3320.09,0.00
2024-12-08 17:11:43,65,2945,29,36,1967.81,3321.00,0.00
2024-12-08 17:11:43,66,2945,30,36,1937.99,3321.02,0.00
2024-12-08 17:11:43,65,2945,30,35,1963.75,3321.12,0.00
2024-12-08 17:11:43,65,2946,30,35,1975.86,3322.00,0.00
2024-12-08 17:11:43,66,2946,31,35,1945.92,3322.02,0.00
2024-12-08 17:11:43,67,2945,32,35,1916.39,3322.06,0.00
2024-12-08 17:11:43,67,2946,32,35,1955.95,3323.00,0.00
2024-12-08 17:11:43,68,2946,32,36,1927.18,3323.02,0.00
2024-12-08 17:11:43,67,2946,32,35,1942.59,3323.12,0.00
2024-12-08 17:11:43,67,2947,32,35,2003.17,3324.00,0.00
2024-12-08 17:11:43,68,2947,32,36,1973.71,3324.02,0.00
2024-12-08 17:11:43,68,2948,32,36,1970.88,3325.00,0.00
2024-12-08 17:11:43,69,2948,32,37,1942.32,3325.01,0.00
2024-12-08 17:11:43,69,2949,32,37,1935.97,3326.00,0.00
2024-12-08 17:11:43,70,2949,32,38,1908.32,3326.01,0.00
2024-12-08 17:11:43,70,2950,32,38,1899.00,3327.00,0.00
2024-12-08 17:11:43,71,2950,32,39,1872.25,3327.01,0.00
2024-12-08 17:11:43,70,2950,31,39,1888.07,3327.04,0.00
2024-12-08 17:11:43,70,2951,31,39,1885.06,3328.00,0.00
2024-12-08 17:11:43,71,2951,31,40,1858.51,3328.01,0.00
2024-12-08 17:11:43,70,2951,31,39,1877.46,3328.03,0.00
2024-12-08 17:11:43,69,2951,31,38,1904.33,3328.03,0.00
2024-12-08 17:11:43,70,2950,32,38,1864.92,3328.43,0.00
2024-12-08 17:11:43,69,2950,31,38,1891.83,3328.93,0.00
2024-12-08 17:11:43,69,2951,31,38,1936.12,3329.00,0.00
2024-12-08 17:11:43,70,2951,32,38,1908.46,3329.01,0.00
2024-12-08 17:11:44,70,2952,32,38,1949.67,3330.00,0.00
2024-12-08 17:11:44,71,2952,33,38,1922.21,3330.01,0.00
2024-12-08 17:11:44,70,2952,33,37,1941.12,3330.07,0.00
2024-12-08 17:11:44,70,2953,33,37,1945.25,3331.00,0.00
2024-12-08 17:11:44,71,2953,33,38,1917.85,3331.01,0.00
2024-12-08 17:11:44,72,2952,34,38,1864.16,3331.58,0.00
2024-12-08 17:11:44,72,2953,34,38,1911.57,3332.00,0.00
2024-12-08 17:11:44,73,2953,34,39,1885.38,3332.01,0.00
2024-12-08 17:11:44,72,2953,34,38,1903.71,3332.07,0.00
2024-12-08 17:11:44,72,2954,34,38,1939.11,3333.00,0.00
2024-12-08 17:11:44,73,2954,34,39,1912.55,3333.01,0.00
2024-12-08 17:11:44,73,2955,34,39,1877.62,3334.00,0.00
2024-12-08 17:11:44,74,2955,34,40,1852.24,3334.01,0.00
2024-12-08 17:11:44,73,2955,34,39,1868.96,3334.08,0.00
2024-12-08 17:11:44,72,2955,33,39,1857.01,3334.71,0.00
2024-12-08 17:11:44,72,2956,33,39,1856.72,3335.00,0.00
2024-12-08 17:11:44,73,2956,33,40,1831.29,3335.01,0.00
2024-12-08 17:11:44,72,2956,33,39,1798.34,3335.83,0.00
2024-12-08 17:11:44,71,2956,33,38,1813.21,3335.87,0.00
2024-12-08 17:11:44,71,2957,33,38,1839.93,3336.00,0.00
2024-12-08 17:11:44,72,2957,33,39,1814.38,3336.01,0.00
2024-12-08 17:11:44,71,2957,33,38,1829.62,3336.11,0.00
2024-12-08 17:11:44,71,2958,33,38,1807.84,3337.00,0.00
2024-12-08 17:11:44,72,2958,33,39,1782.73,3337.01,0.00
2024-12-08 17:11:44,71,2958,33,38,1767.49,3337.52,0.00
2024-12-08 17:11:44,71,2959,33,38,1778.96,3338.00,0.00
2024-12-08 17:11:44,72,2959,34,38,1754.26,3338.01,0.00
2024-12-08 17:11:44,71,2959,34,37,1769.11,3338.11,0.00
2024-12-08 17:11:44,70,2959,33,37,1745.88,3338.91,0.00
2024-12-08 17:11:44,70,2960,33,37,1790.79,3339.00,0.00
2024-12-08 17:11:44,71,2960,34,37,1765.57,3339.01,0.00
2024-12-08 17:11:44,70,2960,33,37,1770.30,3339.13,0.00
2024-12-08 17:11:44,70,2961,33,37,1777.08,3340.00,0.00
2024-12-08 17:11:44,71,2961,33,38,1752.05,3340.01,0.00
2024-12-08 17:11:44,70,2961,33,37,1726.60,3340.83,0.00
2024-12-08 17:11:44,70,2962,33,37,1768.74,3341.00,0.00
2024-12-08 17:11:44,71,2962,33,38,1743.83,3341.01,0.00
2024-12-08 17:11:44,70,2962,33,37,1759.69,3341.11,0.00
2024-12-08 17:11:44,69,2962,32,37,1774.17,3341.45,0.00
2024-12-08 17:11:44,69,2963,32,37,1789.14,3342.00,0.00
2024-12-08 17:11:44,70,2963,32,38,1763.58,3342.01,0.00
2024-12-08 17:11:44,69,2963,32,37,1779.47,3342.12,0.00
2024-12-08 17:11:44,68,2963,31,37,1798.27,3342.12,0.00
2024-12-08 17:11:44,68,2964,31,37,1811.20,3343.00,0.00
2024-12-08 17:11:44,69,2964,31,38,1784.95,3343.01,0.00
2024-12-08 17:11:44,69,2965,31,38,1775.59,3344.00,0.00
2024-12-08 17:11:44,70,2965,31,39,1750.22,3344.01,0.00
2024-12-08 17:11:44,69,2965,31,38,1765.42,3344.12,0.00
2024-12-08 17:11:44,69,2966,31,38,1771.50,3345.00,0.00
2024-12-08 17:11:44,70,2966,31,39,1746.19,3345.01,0.00
2024-12-08 17:11:44,69,2966,30,39,1755.06,3345.20,0.00
2024-12-08 17:11:44,69,2967,30,39,1766.84,3346.00,0.00
2024-12-08 17:11:44,70,2967,30,40,1741.60,3346.01,0.00
2024-12-08 17:11:44,69,2967,30,39,1757.16,3346.12,0.00
2024-12-08 17:11:44,68,2967,30,38,1762.38,3346.74,0.00
2024-12-08 17:11:44,68,2968,30,38,1793.11,3347.00,0.00
2024-12-08 17:11:44,69,2968,30,39,1767.12,3347.01,0.00
2024-12-08 17:11:44,68,2968,29,39,1770.00,3347.16,0.00
2024-12-08 17:11:44,67,2968,28,39,1794.93,3347.19,0.00
2024-12-08 17:11:44,67,2969,28,39,1818.41,3348.00,0.00
2024-12-08 17:11:44,68,2969,28,40,1791.67,3348.02,0.00
2024-12-08 17:11:44,67,2969,27,40,1815.42,3348.09,0.00
2024-12-08 17:11:44,66,2969,27,39,1835.83,3348.11,0.00
2024-12-08 17:11:44,66,2969,27,39,1857.17,3349.00,0.00
2024-12-08 17:11:44,67,2969,27,40,1829.45,3349.02,0.00
2024-12-08 17:11:45,67,2970,27,40,1827.00,3350.00,0.00
2024-12-08 17:11:45,68,2970,27,41,1800.13,3350.02,0.00
2024-12-08 17:11:45,67,2970,27,40,1818.01,3350.10,0.00
2024-12-08 17:11:45,67,2971,27,40,1828.55,3351.00,0.00
2024-12-08 17:11:45,68,2971,28,40,1801.65,3351.02,0.00
2024-12-08 17:11:45,68,2972,28,40,1798.74,3352.00,0.00
2024-12-08 17:11:45,69,2972,28,41,1772.67,3352.01,0.00
2024-12-08 17:11:45,68,2972,28,40,1798.25,3352.02,0.00
2024-12-08 17:11:45,67,2972,28,39,1824.59,3352.02,0.00
2024-12-08 17:11:45,66,2972,28,38,1843.11,3352.09,0.00
2024-12-08 17:11:45,65,2972,27,38,1868.90,3352.15,0.00
2024-12-08 17:11:45,65,2973,27,38,1882.32,3353.00,0.00
2024-12-08 17:11:45,66,2973,27,39,1853.80,3353.02,0.00
2024-12-08 17:11:45,65,2973,26,39,1866.88,3353.15,0.00
2024-12-08 17:11:45,65,2974,26,39,1880.30,3354.00,0.00
2024-12-08 17:11:45,66,2974,26,40,1851.81,3354.02,0.00
2024-12-08 17:11:45,66,2975,26,40,1848.70,3355.00,0.00
2024-12-08 17:11:45,67,2975,27,40,1821.11,3355.02,0.00
2024-12-08 17:11:45,66,2975,26,40,1848.19,3355.02,0.00
2024-12-08 17:11:45,66,2976,26,40,1843.95,3356.00,0.00
2024-12-08 17:11:45,67,2976,27,40,1816.43,3356.02,0.00
2024-12-08 17:11:45,66,2976,27,39,1834.31,3356.11,0.00
2024-12-08 17:11:45,65,2976,26,39,1837.94,3356.59,0.00
2024-12-08 17:11:45,65,2977,26,39,1875.96,3357.00,0.00
2024-12-08 17:11:45,66,2977,26,40,1847.53,3357.02,0.00
2024-12-08 17:11:45,65,2977,25,40,1863.06,3357.12,0.00
2024-12-08 17:11:45,65,2978,25,40,1875.07,3358.00,0.00
2024-12-08 17:11:45,66,2978,25,41,1846.66,3358.02,0.00
2024-12-08 17:11:45,65,2978,24,41,1874.56,3358.02,0.00
2024-12-08 17:11:45,64,2978,24,40,1890.23,3358.13,0.00
2024-12-08 17:11:45,63,2978,23,40,1909.57,3358.13,0.00
2024-12-08 17:11:45,63,2979,23,40,1934.11,3359.00,0.00
2024-12-08 17:11:45,64,2979,23,41,1903.89,3359.02,0.00
2024-12-08 17:11:45,63,2979,22,41,1924.52,3359.10,0.00
2024-12-08 17:11:45,63,2980,22,41,1937.35,3360.00,0.00
2024-12-08 17:11:45,64,2980,22,42,1907.08,3360.02,0.00
2024-12-08 17:11:45,63,2980,22,41,1924.04,3360.11,0.00
2024-12-08 17:11:45,63,2981,22,41,1937.39,3361.00,0.00
2024-12-08 17:11:45,64,2981,23,41,1907.12,3361.02,0.00
2024-12-08 17:11:45,64,2982,23,41,1906.11,3362.00,0.00
2024-12-08 17:11:45,65,2982,23,42,1876.79,3362.02,0.00
2024-12-08 17:11:45,64,2982,23,41,1893.52,3362.11,0.00
2024-12-08 17:11:45,64,2983,23,41,1906.16,3363.00,0.00
2024-12-08 17:11:45,65,2983,23,42,1876.83,3363.02,0.00
2024-12-08 17:11:45,66,2982,24,42,1846.87,3363.09,0.00
2024-12-08 17:11:45,65,2982,23,42,1905.36,3363.26,0.00
2024-12-08 17:11:45,65,2983,23,42,1932.76,3364.00,0.00
2024-12-08 17:11:45,66,2983,24,42,1903.48,3364.02,0.00
2024-12-08 17:11:45,65,2983,24,41,1920.37,3364.11,0.00
2024-12-08 17:11:45,64,2983,23,41,1949.86,3364.13,0.00
2024-12-08 17:11:45,64,2984,23,41,2015.60,3365.00,0.00
2024-12-08 17:11:45,65,2984,23,42,1984.59,3365.02,0.00
2024-12-08 17:11:45,64,2984,23,41,2015.07,3365.02,0.00
2024-12-08 17:11:45,64,2985,23,41,2014.10,3366.00,0.00
2024-12-08 17:11:45,65,2985,24,41,1983.11,3366.02,0.00
2024-12-08 17:11:45,64,2985,24,40,2002.55,3366.09,0.00
2024-12-08 17:11:45,64,2986,24,40,2013.40,3367.00,0.00
2024-12-08 17:11:45,65,2986,25,40,1982.43,3367.02,0.00
2024-12-08 17:11:45,65,2987,25,40,1977.70,3368.00,0.00
2024-12-08 17:11:45,66,2987,25,41,1947.74,3368.02,0.00
2024-12-08 17:11:45,65,2987,25,40,1966.33,3368.09,0.00
2024-12-08 17:11:46,65,2988,25,40,1973.87,3369.00,0.00
2024-12-08 17:11:46,66,2988,26,40,1943.97,3369.02,0.00
2024-12-08 17:11:46,65,2988,25,40,1973.36,3369.02,0.00
2024-12-08 17:11:46,64,2988,24,40,2003.16,3369.05,0.00
2024-12-08 17:11:46,64,2989,24,40,1998.82,3370.00,0.00
2024-12-08 17:11:46,65,2989,25,40,1968.07,3370.02,0.00
2024-12-08 17:11:46,64,2989,25,39,1988.84,3370.06,0.00
2024-12-08 17:11:46,63,2989,24,39,2005.94,3370.35,0.00
2024-12-08 17:11:46,63,2990,24,39,2027.27,3371.00,0.00
2024-12-08 17:11:46,64,2990,24,40,1995.60,3371.02,0.00
2024-12-08 17:11:46,63,2990,23,40,2004.83,3371.10,0.00
2024-12-08 17:11:46,63,2991,23,40,2025.29,3372.00,0.00
2024-12-08 17:11:46,64,2991,24,40,1993.65,3372.02,0.00
2024-12-08 17:11:46,63,2991,24,39,2004.44,3372.08,0.00
2024-12-08 17:11:46,62,2991,24,38,2027.66,3372.31,0.00
2024-12-08 17:11:46,62,2992,24,38,2059.16,3373.00,0.00
2024-12-08 17:11:46,63,2992,24,39,2026.48,3373.02,0.00
2024-12-08 17:11:46,63,2993,24,39,2026.01,3374.00,0.00
2024-12-08 17:11:46,64,2993,24,40,1994.35,3374.02,0.00
2024-12-08 17:11:46,63,2993,24,39,2014.25,3374.10,0.00
2024-12-08 17:11:46,63,2994,24,39,2027.14,3375.00,0.00
2024-12-08 17:11:46,64,2994,24,40,1995.47,3375.02,0.00
2024-12-08 17:11:46,63,2994,23,40,2025.55,3375.05,0.00
2024-12-08 17:11:46,62,2994,22,40,2044.09,3375.13,0.00
2024-12-08 17:11:46,62,2995,22,40,2069.71,3376.00,0.00
2024-12-08 17:11:46,63,2995,23,40,2036.85,3376.02,0.00
2024-12-08 17:11:46,62,2995,23,39,2058.84,3376.08,0.00
2024-12-08 17:11:46,62,2996,23,39,2071.95,3377.00,0.00
2024-12-08 17:11:46,63,2996,24,39,2039.06,3377.02,0.00
2024-12-08 17:11:46,63,2997,24,39,2038.60,3378.00,0.00
2024-12-08 17:11:46,64,2997,24,40,2006.74,3378.02,0.00
2024-12-08 17:11:46,63,2997,24,39,2028.43,3378.08,0.00
2024-12-08 17:11:46,63,2998,24,39,2040.81,3379.00,0.00
2024-12-08 17:11:46,64,2998,24,40,2008.92,3379.02,0.00
2024-12-08 17:11:46,64,2999,24,40,2007.93,3380.00,0.00
2024-12-08 17:11:46,65,2999,24,41,1977.04,3380.02,0.00
2024-12-08 17:11:46,64,2999,24,40,1998.45,3380.08,0.00
2024-12-08 17:11:46,63,2999,23,40,2016.78,3380.14,0.00
2024-12-08 17:11:46,62,2999,22,40,2042.84,3380.34,0.00
2024-12-08 17:11:46,62,3000,22,40,2075.50,3381.00,0.00
2024-12-08 17:11:46,63,3000,23,40,2042.55,3381.02,0.00
2024-12-08 17:11:46,63,3001,23,40,2042.08,3382.00,0.00
2024-12-08 17:11:46,64,3001,23,41,2010.18,3382.02,0.00
2024-12-08 17:11:46,63,3001,23,40,2031.90,3382.08,0.00
2024-12-08 17:11:46,63,3002,23,40,2044.30,3383.00,0.00
2024-12-08 17:11:46,64,3002,23,41,2012.36,3383.02,0.00
2024-12-08 17:11:46,63,3002,22,41,2029.30,3383.14,0.00
2024-12-08 17:11:46,63,3003,22,41,2043.83,3384.00,0.00
2024-12-08 17:11:46,64,3003,23,41,2011.89,3384.02,0.00
2024-12-08 17:11:46,63,3003,23,40,2034.18,3384.08,0.00
2024-12-08 17:11:46,63,3004,23,40,2046.58,3385.00,0.00
2024-12-08 17:11:46,64,3004,24,40,2014.60,3385.02,0.00
2024-12-08 17:11:46,64,3005,24,40,2013.61,3386.00,0.00
2024-12-08 17:11:46,65,3005,25,40,1982.63,3386.02,0.00
2024-12-08 17:11:46,64,3005,25,39,2003.58,3386.09,0.00
2024-12-08 17:11:46,64,3006,25,39,2015.79,3387.00,0.00
2024-12-08 17:11:46,65,3006,25,40,1984.78,3387.02,0.00
2024-12-08 17:11:46,65,3007,25,40,1983.28,3388.00,0.00
2024-12-08 17:11:46,66,3007,26,40,1953.23,3388.02,0.00
2024-12-08 17:11:46,65,3007,25,40,1981.21,3388.06,0.00
2024-12-08 17:11:46,64,3007,25,39,2002.65,3388.09,0.00
2024-12-08 17:11:47,63,3007,24,39,2004.09,3388.68,0.00
2024-12-08 17:11:47,63,3008,24,39,2047.39,3389.00,0.00
2024-12-08 17:11:47,64,3008,24,40,2015.40,3389.02,0.00
2024-12-08 17:11:47,64,3009,24,40,2014.40,3390.00,0.00
2024-12-08 17:11:47,65,3009,24,41,1983.41,3390.02,0.00
2024-12-08 17:11:47,64,3009,23,41,2011.25,3390.09,0.00
2024-12-08 17:11:47,64,3010,23,41,2023.47,3391.00,0.00
2024-12-08 17:11:47,65,3010,23,42,1992.34,3391.02,0.00
2024-12-08 17:11:47,64,3010,23,41,2020.31,3391.09,0.00
2024-12-08 17:11:47,64,3011,23,41,2032.55,3392.00,0.00
2024-12-08 17:11:47,65,3011,24,41,2001.28,3392.02,0.00
2024-12-08 17:11:47,64,3011,23,41,2009.91,3392.38,0.00
2024-12-08 17:11:47,64,3012,23,41,2031.56,3393.00,0.00
2024-12-08 17:11:47,65,3012,23,42,2000.30,3393.02,0.00
2024-12-08 17:11:47,64,3012,23,41,2018.32,3393.09,0.00
2024-12-08 17:11:47,64,3013,23,41,2030.57,3394.00,0.00
2024-12-08 17:11:47,65,3013,24,41,1999.33,3394.02,0.00
2024-12-08 17:11:47,65,3014,24,41,1997.83,3395.00,0.00
2024-12-08 17:11:47,66,3014,25,41,1967.56,3395.02,0.00
2024-12-08 17:11:47,65,3014,25,40,1985.31,3395.09,0.00
2024-12-08 17:11:47,65,3015,25,40,1996.85,3396.00,0.00
2024-12-08 17:11:47,66,3015,25,41,1966.59,3396.02,0.00
2024-12-08 17:11:47,66,3016,25,41,1964.54,3397.00,0.00
2024-12-08 17:11:47,67,3016,25,42,1935.21,3397.02,0.00
2024-12-08 17:11:47,66,3016,25,41,1952.71,3397.09,0.00
2024-12-08 17:11:47,66,3017,25,41,1963.43,3398.00,0.00
2024-12-08 17:11:47,67,3017,26,41,1934.13,3398.02,0.00
2024-12-08 17:11:47,66,3017,25,41,1948.53,3398.14,0.00
2024-12-08 17:11:47,66,3018,25,41,1971.09,3399.00,0.00
2024-12-08 17:11:47,67,3018,25,42,1941.67,3399.02,0.00
2024-12-08 17:11:47,67,3019,25,42,1939.12,3400.00,0.00
2024-12-08 17:11:47,68,3019,26,42,1910.60,3400.02,0.00
2024-12-08 17:11:47,67,3019,26,41,1928.47,3400.09,0.00
2024-12-08 17:11:47,67,3020,26,41,1938.43,3401.00,0.00
2024-12-08 17:11:47,68,3020,27,41,1909.92,3401.02,0.00
2024-12-08 17:11:47,67,3020,26,41,1935.90,3401.08,0.00
2024-12-08 17:11:47,67,3021,26,41,1935.06,3402.00,0.00
2024-12-08 17:11:47,68,3021,27,41,1906.61,3402.02,0.00
2024-12-08 17:11:47,68,3022,27,41,1903.08,3403.00,0.00
2024-12-08 17:11:47,69,3022,28,41,1875.50,3403.01,0.00
2024-12-08 17:11:47,69,3023,28,41,1871.15,3404.00,0.00
2024-12-08 17:11:47,70,3023,29,41,1844.42,3404.01,0.00
2024-12-08 17:11:47,69,3023,29,40,1861.79,3404.09,0.00
2024-12-08 17:11:47,69,3024,29,40,1869.00,3405.00,0.00
2024-12-08 17:11:47,70,3024,29,41,1842.30,3405.01,0.00
2024-12-08 17:11:47,69,3024,28,41,1868.51,3405.01,0.00
2024-12-08 17:11:47,68,3024,27,41,1894.99,3405.03,0.00
2024-12-08 17:11:47,68,3025,27,41,1890.07,3406.00,0.00
2024-12-08 17:11:47,69,3025,28,41,1862.68,3406.01,0.00
2024-12-08 17:11:47,68,3025,28,40,1881.07,3406.06,0.00
2024-12-08 17:11:47,67,3025,27,40,1893.21,3406.43,0.00
2024-12-08 17:11:47,66,3025,26,40,1913.29,3406.70,0.00
2024-12-08 17:11:47,66,3026,26,40,1944.49,3407.00,0.00
2024-12-08 17:11:47,67,3026,27,40,1915.47,3407.02,0.00
2024-12-08 17:11:47,66,3026,27,39,1933.16,3407.09,0.00
2024-12-08 17:11:47,65,3026,27,38,1960.82,3407.14,0.00
2024-12-08 17:11:47,65,3027,27,38,1970.82,3408.00,0.00
2024-12-08 17:11:47,66,3027,27,39,1940.95,3408.02,0.00
2024-12-08 17:11:47,66,3028,27,39,1935.71,3409.00,0.00
2024-12-08 17:11:47,67,3028,28,39,1906.81,3409.02,0.00
2024-12-08 17:11:47,66,3028,28,38,1927.46,3409.06,0.00
2024-12-08 17:11:48,66,3029,28,38,1933.99,3410.00,0.00
2024-12-08 17:11:48,67,3029,28,39,1905.13,3410.02,0.00
2024-12-08 17:11:48,67,3030,28,39,1899.43,3411.00,0.00
2024-12-08 17:11:48,68,3030,29,39,1871.49,3411.02,0.00
2024-12-08 17:11:48,67,3030,28,39,1881.20,3411.22,0.00
2024-12-08 17:11:48,67,3031,28,39,1895.95,3412.00,0.00
2024-12-08 17:11:48,68,3031,28,40,1868.07,3412.02,0.00
2024-12-08 17:11:48,67,3031,28,39,1887.31,3412.08,0.00
2024-12-08 17:11:48,66,3031,27,39,1882.75,3412.88,0.00
2024-12-08 17:11:48,66,3032,27,39,1930.41,3413.00,0.00
2024-12-08 17:11:48,67,3032,27,40,1901.60,3413.02,0.00
2024-12-08 17:11:48,66,3032,27,39,1923.70,3413.06,0.00
2024-12-08 17:11:48,66,3033,27,39,1933.56,3414.00,0.00
2024-12-08 17:11:48,67,3033,27,40,1904.71,3414.02,0.00
2024-12-08 17:11:48,67,3034,27,40,1902.21,3415.00,0.00
2024-12-08 17:11:48,68,3034,28,40,1874.23,3415.02,0.00
2024-12-08 17:11:48,67,3034,28,39,1895.08,3415.06,0.00
2024-12-08 17:11:48,66,3034,27,39,1919.69,3415.17,0.00
2024-12-08 17:11:48,66,3035,27,39,1933.15,3416.00,0.00
2024-12-08 17:11:48,67,3035,28,39,1904.29,3416.02,0.00
2024-12-08 17:11:48,67,3036,28,39,1901.79,3417.00,0.00
2024-12-08 17:11:48,68,3036,28,40,1873.82,3417.02,0.00
2024-12-08 17:11:48,67,3036,28,39,1895.17,3417.06,0.00
2024-12-08 17:11:48,67,3037,28,39,1904.39,3418.00,0.00
2024-12-08 17:11:48,68,3037,29,39,1876.38,3418.02,0.00
2024-12-08 17:11:48,67,3037,28,39,1903.37,3418.03,0.00
2024-12-08 17:11:48,67,3038,28,39,1901.37,3419.00,0.00
2024-12-08 17:11:48,68,3038,28,40,1873.41,3419.02,0.00
2024-12-08 17:11:48,67,3038,28,39,1895.26,3419.05,0.00
2024-12-08 17:11:48,66,3038,27,39,1901.42,3419.56,0.00
2024-12-08 17:11:48,67,3037,28,39,1870.53,3419.66,0.00
2024-12-08 17:11:48,67,3038,28,39,1922.35,3420.00,0.00
2024-12-08 17:11:48,68,3038,28,40,1894.08,3420.02,0.00
2024-12-08 17:11:48,68,3039,28,40,1941.42,3421.00,0.00
2024-12-08 17:11:48,69,3039,28,41,1913.28,3421.01,0.00
2024-12-08 17:11:48,68,3039,28,40,1935.89,3421.04,0.00
2024-12-08 17:11:48,68,3040,28,40,1944.00,3422.00,0.00
2024-12-08 17:11:48,69,3040,28,41,1915.82,3422.01,0.00
2024-12-08 17:11:48,68,3040,27,41,1928.94,3422.16,0.00
2024-12-08 17:11:48,67,3040,26,41,1938.53,3422.57,0.00
2024-12-08 17:11:48,67,3041,26,41,1975.12,3423.00,0.00
2024-12-08 17:11:48,68,3041,26,42,1946.08,3423.02,0.00
2024-12-08 17:11:48,67,3041,26,41,1970.02,3423.05,0.00
2024-12-08 17:11:48,66,3041,25,41,1994.73,3423.18,0.00
2024-12-08 17:11:48,66,3042,25,41,2019.12,3424.00,0.00
2024-12-08 17:11:48,67,3042,26,41,1988.99,3424.02,0.00
2024-12-08 17:11:48,67,3043,26,41,1986.50,3425.00,0.00
2024-12-08 17:11:48,68,3043,26,42,1957.29,3425.02,0.00
2024-12-08 17:11:48,67,3043,26,41,1980.38,3425.06,0.00
2024-12-08 17:11:48,67,3044,26,41,1989.64,3426.00,0.00
2024-12-08 17:11:48,68,3044,27,41,1960.38,3426.02,0.00
2024-12-08 17:11:48,68,3045,27,41,1957.42,3427.00,0.00
2024-12-08 17:11:48,69,3045,27,42,1929.05,3427.01,0.00
2024-12-08 17:11:48,68,3045,27,41,1951.89,3427.06,0.00
2024-12-08 17:11:48,68,3046,27,41,1960.51,3428.00,0.00
2024-12-08 17:11:48,69,3046,27,42,1932.10,3428.01,0.00
2024-12-08 17:11:48,68,3046,26,42,1931.40,3428.37,0.00
2024-12-08 17:11:48,68,3047,26,42,1960.58,3429.00,0.00
2024-12-08 17:11:48,69,3047,27,42,1932.17,3429.01,0.00
2024-12-08 17:11:48,68,3047,27,41,1954.54,3429.06,0.00
2024-12-08 17:11:48,68,3048,27,41,1963.17,3430.00,0.00
2024-12-08 17:11:48,69,3048,27,42,1934.72,3430.01,0.00
2024-12-08 17:11:49,69,3049,27,42,1931.30,3431.00,0.00
2024-12-08 17:11:49,70,3049,28,42,1903.71,3431.01,0.00
2024-12-08 17:11:49,71,3048,29,42,1875.94,3431.07,0.00
2024-12-08 17:11:49,70,3048,29,41,1937.06,3431.07,0.00
2024-12-08 17:11:49,70,3049,29,41,1944.96,3432.00,0.00
2024-12-08 17:11:49,71,3049,29,42,1917.57,3432.01,0.00
2024-12-08 17:11:49,71,3050,29,42,1961.64,3433.00,0.00
2024-12-08 17:11:49,72,3050,29,43,1934.40,3433.01,0.00
2024-12-08 17:11:49,72,3051,29,43,1929.72,3434.00,0.00
2024-12-08 17:11:49,73,3051,29,44,1903.28,3434.01,0.00
2024-12-08 17:11:49,73,3052,29,44,1898.19,3435.00,0.00
2024-12-08 17:11:49,74,3052,30,44,1872.54,3435.01,0.00
2024-12-08 17:11:49,74,3053,30,44,1867.05,3436.00,0.00
2024-12-08 17:11:49,75,3053,31,44,1842.15,3436.01,0.00
2024-12-08 17:11:49,74,3053,31,43,1866.12,3436.03,0.00
2024-12-08 17:11:49,73,3053,31,42,1884.15,3436.03,0.00
2024-12-08 17:11:49,73,3054,31,42,1888.94,3437.00,0.00
2024-12-08 17:11:49,74,3054,32,42,1863.41,3437.01,0.00
2024-12-08 17:11:49,74,3055,32,42,1857.91,3438.00,0.00
2024-12-08 17:11:49,75,3055,32,43,1833.14,3438.01,0.00
2024-12-08 17:11:49,74,3055,32,42,1856.52,3438.03,0.00
2024-12-08 17:11:49,74,3056,32,42,1860.78,3439.00,0.00
2024-12-08 17:11:49,75,3056,33,42,1835.97,3439.01,0.00
2024-12-08 17:11:49,74,3056,32,42,1835.73,3439.22,0.00
2024-12-08 17:11:49,73,3056,31,42,1853.44,3439.44,0.00
2024-12-08 17:11:49,73,3057,31,42,1881.63,3440.00,0.00
2024-12-08 17:11:49,74,3057,31,43,1856.20,3440.01,0.00
2024-12-08 17:11:49,73,3057,31,42,1880.69,3440.03,0.00
2024-12-08 17:11:49,72,3057,30,42,1903.48,3440.06,0.00
2024-12-08 17:11:49,72,3058,30,42,1919.31,3441.00,0.00
2024-12-08 17:11:49,73,3058,31,42,1893.02,3441.01,0.00
2024-12-08 17:11:49,73,3059,31,42,1887.91,3442.00,0.00
2024-12-08 17:11:49,74,3059,32,42,1862.40,3442.01,0.00
2024-12-08 17:11:49,73,3059,32,41,1886.97,3442.03,0.00
2024-12-08 17:11:49,73,3060,32,41,1891.76,3443.00,0.00
2024-12-08 17:11:49,74,3060,32,42,1866.20,3443.01,0.00
2024-12-08 17:11:49,73,3060,31,42,1891.29,3443.01,0.00
2024-12-08 17:11:49,72,3060,31,41,1907.52,3443.01,0.00
2024-12-08 17:11:49,72,3061,31,41,1912.38,3444.00,0.00
2024-12-08 17:11:49,73,3061,31,42,1886.18,3444.01,0.00
2024-12-08 17:11:49,73,3062,31,42,1881.06,3445.00,0.00
2024-12-08 17:11:49,74,3062,32,42,1855.64,3445.01,0.00
2024-12-08 17:11:49,73,3062,32,41,1880.59,3445.01,0.00
2024-12-08 17:11:49,74,3061,33,41,1837.69,3445.55,0.00
2024-12-08 17:11:49,74,3062,33,41,1874.34,3446.00,0.00
2024-12-08 17:11:49,75,3062,33,42,1849.35,3446.01,0.00
2024-12-08 17:11:49,75,3063,33,42,1889.42,3447.00,0.00
2024-12-08 17:11:49,76,3063,34,42,1864.55,3447.01,0.00
2024-12-08 17:11:49,75,3063,34,41,1888.50,3447.01,0.00
2024-12-08 17:11:49,75,3064,34,41,1891.80,3448.00,0.00
2024-12-08 17:11:49,76,3064,35,41,1866.91,3448.01,0.00
2024-12-08 17:11:49,75,3064,34,41,1878.93,3448.05,0.00
2024-12-08 17:11:49,75,3065,34,41,1892.81,3449.00,0.00
2024-12-08 17:11:49,76,3065,34,42,1867.91,3449.01,0.00
2024-12-08 17:11:49,75,3065,34,41,1890.51,3449.04,0.00
2024-12-08 17:11:49,75,3066,34,41,1894.74,3450.00,0.00
2024-12-08 17:11:49,76,3066,35,41,1869.81,3450.01,0.00
2024-12-08 17:11:49,75,3066,34,41,1894.74,3450.01,0.00
2024-12-08 17:11:50,75,3067,34,41,1888.85,3451.00,0.00
2024-12-08 17:11:50,76,3067,34,42,1863.99,3451.01,0.00
2024-12-08 17:11:50,75,3067,34,41,1887.01,3451.03,0.00
2024-12-08 17:11:50,75,3068,34,41,1890.78,3452.00,0.00
2024-12-08 17:11:50,76,3068,35,41,1865.90,3452.01,0.00
2024-12-08 17:11:50,75,3068,34,41,1867.44,3452.43,0.00
2024-12-08 17:11:50,74,3068,33,41,1883.07,3452.72,0.00
2024-12-08 17:11:50,74,3069,33,41,1910.81,3453.00,0.00
2024-12-08 17:11:50,75,3069,34,41,1885.34,3453.01,0.00
2024-12-08 17:11:50,74,3069,34,40,1909.42,3453.03,0.00
2024-12-08 17:11:50,74,3070,34,40,1913.70,3454.00,0.00
2024-12-08 17:11:50,75,3070,35,40,1888.19,3454.01,0.00
2024-12-08 17:11:50,75,3071,35,40,1882.28,3455.00,0.00
2024-12-08 17:11:50,76,3071,36,40,1857.52,3455.01,0.00
2024-12-08 17:11:50,75,3071,36,39,1881.36,3455.03,0.00
2024-12-08 17:11:50,75,3072,36,39,1885.13,3456.00,0.00
2024-12-08 17:11:50,76,3072,36,40,1860.33,3456.01,0.00
2024-12-08 17:11:50,75,3072,35,40,1869.06,3456.21,0.00
2024-12-08 17:11:50,75,3073,35,40,1879.22,3457.00,0.00
2024-12-08 17:11:50,76,3073,36,40,1854.50,3457.01,0.00
2024-12-08 17:11:50,75,3073,36,39,1877.39,3457.04,0.00
2024-12-08 17:11:50,75,3074,36,39,1881.61,3458.00,0.00
2024-12-08 17:11:50,76,3074,36,40,1856.85,3458.01,0.00
2024-12-08 17:11:50,76,3075,36,40,1850.56,3459.00,0.00
2024-12-08 17:11:50,77,3075,37,40,1826.53,3459.01,0.00
2024-12-08 17:11:50,76,3075,37,39,1849.20,3459.04,0.00
2024-12-08 17:11:50,75,3075,36,39,1868.33,3459.09,0.00
2024-12-08 17:11:50,75,3076,36,39,1883.62,3460.00,0.00
2024-12-08 17:11:50,76,3076,37,39,1858.84,3460.01,0.00
2024-12-08 17:11:50,75,3076,37,38,1873.02,3460.04,0.00
2024-12-08 17:11:50,75,3077,37,38,1876.63,3461.00,0.00
2024-12-08 17:11:50,76,3077,37,39,1851.94,3461.01,0.00
2024-12-08 17:11:50,76,3078,37,39,1844.25,3462.00,0.00
2024-12-08 17:11:50,77,3078,37,40,1820.30,3462.01,0.00
2024-12-08 17:11:50,76,3078,37,39,1842.89,3462.04,0.00
2024-12-08 17:11:50,77,3077,38,39,1814.50,3462.20,0.00
2024-12-08 17:11:50,77,3078,38,39,1848.63,3463.00,0.00
2024-12-08 17:11:50,78,3078,38,40,1824.93,3463.01,0.00
2024-12-08 17:11:50,77,3078,38,39,1838.29,3463.04,0.00
2024-12-08 17:11:50,76,3078,37,39,1861.57,3463.04,0.00
2024-12-08 17:11:50,75,3078,36,39,1881.37,3463.19,0.00
2024-12-08 17:11:50,75,3079,36,39,1943.31,3464.00,0.00
2024-12-08 17:11:50,76,3079,37,39,1917.74,3464.01,0.00
2024-12-08 17:11:50,76,3080,37,39,1907.87,3465.00,0.00
2024-12-08 17:11:50,77,3080,38,39,1883.09,3465.01,0.00
2024-12-08 17:11:50,76,3080,38,38,1905.59,3465.04,0.00
2024-12-08 17:11:50,76,3081,38,38,1904.98,3466.00,0.00
2024-12-08 17:11:50,77,3081,39,38,1880.24,3466.01,0.00
2024-12-08 17:11:50,77,3082,39,38,1869.01,3467.00,0.00
2024-12-08 17:11:50,78,3082,39,39,1845.05,3467.01,0.00
2024-12-08 17:11:50,77,3082,39,38,1866.76,3467.04,0.00
2024-12-08 17:11:50,76,3082,38,38,1886.36,3467.18,0.00
2024-12-08 17:11:50,76,3083,38,38,1890.64,3468.00,0.00
2024-12-08 17:11:50,77,3083,38,39,1866.09,3468.01,0.00
2024-12-08 17:11:50,77,3084,38,39,1855.97,3469.00,0.00
2024-12-08 17:11:50,78,3084,39,39,1832.18,3469.01,0.00
2024-12-08 17:11:50,77,3084,39,38,1854.17,3469.04,0.00
2024-12-08 17:11:50,77,3085,39,38,1854.81,3470.00,0.00
2024-12-08 17:11:50,78,3085,40,38,1831.03,3470.01,0.00
2024-12-08 17:11:50,77,3085,39,38,1854.36,3470.01,0.00
2024-12-08 17:11:50,76,3085,38,38,1854.73,3470.45,0.00
2024-12-08 17:11:50,76,3086,38,38,1870.05,3471.00,0.00
2024-12-08 17:11:50,77,3086,38,39,1845.76,3471.01,0.00
2024-12-08 17:11:50,76,3086,38,38,1869.13,3471.03,0.00
2024-12-08 17:11:51,76,3087,38,38,1869.93,3472.00,0.00
2024-12-08 17:11:51,77,3087,38,39,1845.64,3472.01,0.00
2024-12-08 17:11:51,77,3088,38,39,1836.24,3473.00,0.00
2024-12-08 17:11:51,78,3088,39,39,1812.70,3473.01,0.00
2024-12-08 17:11:51,77,3088,39,38,1835.34,3473.03,0.00
2024-12-08 17:11:51,78,3087,39,39,1803.00,3473.31,0.00
2024-12-08 17:11:51,78,3088,39,39,1835.29,3474.00,0.00
2024-12-08 17:11:51,79,3088,40,39,1812.06,3474.01,0.00
2024-12-08 17:11:51,79,3089,40,39,1845.09,3475.00,0.00
2024-12-08 17:11:51,80,3089,40,40,1822.03,3475.01,0.00
2024-12-08 17:11:51,79,3089,40,39,1843.34,3475.04,0.00
2024-12-08 17:11:51,79,3090,40,39,1841.40,3476.00,0.00
2024-12-08 17:11:51,80,3090,40,40,1818.38,3476.01,0.00
2024-12-08 17:11:51,79,3090,39,40,1840.96,3476.01,0.00
2024-12-08 17:11:51,79,3091,39,40,1829.03,3477.00,0.00
2024-12-08 17:11:51,80,3091,40,40,1806.17,3477.01,0.00
2024-12-08 17:11:51,79,3091,40,39,1828.16,3477.03,0.00
2024-12-08 17:11:51,78,3091,40,38,1836.19,3477.41,0.00
2024-12-08 17:11:51,78,3092,40,38,1851.71,3478.00,0.00
2024-12-08 17:11:51,79,3092,41,38,1828.27,3478.01,0.00
2024-12-08 17:11:51,79,3093,41,38,1820.23,3479.00,0.00
2024-12-08 17:11:51,80,3093,41,39,1797.48,3479.01,0.00
2024-12-08 17:11:51,79,3093,40,39,1794.63,3479.47,0.00
2024-12-08 17:11:51,79,3094,40,39,1811.71,3480.00,0.00
2024-12-08 17:11:51,80,3094,41,39,1789.06,3480.01,0.00
2024-12-08 17:11:51,79,3094,40,39,1776.74,3480.73,0.00
2024-12-08 17:11:51,79,3095,40,39,1802.93,3481.00,0.00
2024-12-08 17:11:51,80,3095,41,39,1780.40,3481.01,0.00
2024-12-08 17:11:51,79,3095,40,39,1793.25,3481.04,0.00
2024-12-08 17:11:51,79,3096,40,39,1794.57,3482.00,0.00
2024-12-08 17:11:51,80,3096,40,40,1772.14,3482.01,0.00
2024-12-08 17:11:51,79,3096,40,39,1793.70,3482.03,0.00
2024-12-08 17:11:51,79,3097,40,39,1793.60,3483.00,0.00
2024-12-08 17:11:51,80,3097,40,40,1771.18,3483.01,0.00
2024-12-08 17:11:51,79,3097,39,40,1779.06,3483.09,0.00
2024-12-08 17:11:51,79,3098,39,40,1789.58,3484.00,0.00
2024-12-08 17:11:51,80,3098,39,41,1767.21,3484.01,0.00
2024-12-08 17:11:51,79,3098,39,40,1787.38,3484.05,0.00
2024-12-08 17:11:52,79,3099,39,40,1786.33,3485.00,0.00
2024-12-08 17:11:52,80,3099,40,40,1764.00,3485.01,0.00
2024-12-08 17:11:52,79,3099,39,40,1767.84,3485.14,0.00
2024-12-08 17:11:52,78,3099,38,40,1786.97,3485.24,0.00
2024-12-08 17:11:52,77,3099,37,40,1796.47,3485.48,0.00
2024-12-08 17:11:52,76,3099,36,40,1811.08,3485.74,0.00
2024-12-08 17:11:52,76,3100,36,40,1847.98,3486.00,0.00
2024-12-08 17:11:52,77,3100,36,41,1823.98,3486.01,0.00
2024-12-08 17:11:52,76,3100,36,40,1816.50,3486.33,0.00
2024-12-08 17:11:52,76,3101,36,40,1839.40,3487.00,0.00
2024-12-08 17:11:52,77,3101,37,40,1815.51,3487.01,0.00
2024-12-08 17:11:52,76,3101,36,40,1837.58,3487.05,0.00
2024-12-08 17:11:52,75,3101,36,39,1861.15,3487.05,0.00
2024-12-08 17:11:52,76,3100,37,39,1810.87,3487.83,0.00
2024-12-08 17:11:52,76,3101,37,39,1847.73,3488.00,0.00
2024-12-08 17:11:52,77,3101,37,40,1823.74,3488.01,0.00
2024-12-08 17:11:52,76,3101,37,39,1844.99,3488.05,0.00
2024-12-08 17:11:52,76,3102,37,39,1895.09,3489.00,0.00
2024-12-08 17:11:52,77,3102,38,39,1870.48,3489.01,0.00
2024-12-08 17:11:52,76,3102,37,39,1879.96,3489.09,0.00
2024-12-08 17:11:52,76,3103,37,39,1894.71,3490.00,0.00
2024-12-08 17:11:52,77,3103,38,39,1870.11,3490.01,0.00
2024-12-08 17:11:52,78,3102,38,40,1811.56,3490.78,0.00
2024-12-08 17:11:52,78,3103,38,40,1840.84,3491.00,0.00
2024-12-08 17:11:52,79,3103,39,40,1817.54,3491.01,0.00
2024-12-08 17:11:52,78,3103,39,39,1838.61,3491.05,0.00
2024-12-08 17:11:52,78,3104,39,39,1886.59,3492.00,0.00
2024-12-08 17:11:52,79,3104,40,39,1862.70,3492.01,0.00
2024-12-08 17:11:52,79,3105,40,39,1855.28,3493.00,0.00
2024-12-08 17:11:52,80,3105,41,39,1832.09,3493.01,0.00
2024-12-08 17:11:52,80,3106,41,39,1824.31,3494.00,0.00
2024-12-08 17:11:52,81,3106,41,40,1801.79,3494.01,0.00
2024-12-08 17:11:52,80,3106,41,39,1817.77,3494.05,0.00
2024-12-08 17:11:52,79,3106,41,38,1840.34,3494.05,0.00
2024-12-08 17:11:52,79,3107,41,38,1843.07,3495.00,0.00
2024-12-08 17:11:52,80,3107,42,38,1820.03,3495.01,0.00
2024-12-08 17:11:52,80,3108,42,38,1812.25,3496.00,0.00
2024-12-08 17:11:52,81,3108,43,38,1789.88,3496.01,0.00
2024-12-08 17:11:52,81,3109,43,38,1781.75,3497.00,0.00
2024-12-08 17:11:52,82,3109,43,39,1760.02,3497.01,0.00
2024-12-08 17:11:52,81,3109,43,38,1780.03,3497.05,0.00
2024-12-08 17:11:52,81,3110,43,38,1781.83,3498.00,0.00
2024-12-08 17:11:52,82,3110,43,39,1760.10,3498.01,0.00
2024-12-08 17:11:52,81,3110,42,39,1780.10,3498.05,0.00
2024-12-08 17:11:52,80,3110,42,38,1801.48,3498.05,0.00
2024-12-08 17:11:52,80,3111,42,38,1803.74,3499.00,0.00
2024-12-08 17:11:52,81,3111,43,38,1781.48,3499.01,0.00
2024-12-08 17:11:52,80,3111,42,38,1803.31,3499.01,0.00
2024-12-08 17:11:52,80,3112,42,38,1795.51,3500.00,0.00
2024-12-08 17:11:52,81,3112,43,38,1773.34,3500.01,0.00
2024-12-08 17:11:53,80,3112,43,37,1793.77,3500.05,0.00
2024-12-08 17:11:53,80,3113,43,37,1796.02,3501.00,0.00
2024-12-08 17:11:53,81,3113,44,37,1773.85,3501.01,0.00
2024-12-08 17:11:53,80,3113,43,37,1795.59,3501.01,0.00
2024-12-08 17:11:53,79,3113,43,36,1808.13,3501.04,0.00
2024-12-08 17:11:53,79,3114,43,36,1810.41,3502.00,0.00
2024-12-08 17:11:53,80,3114,43,37,1787.78,3502.01,0.00
2024-12-08 17:11:53,79,3114,43,36,1800.22,3502.04,0.00
2024-12-08 17:11:53,79,3115,43,36,1802.50,3503.00,0.00
2024-12-08 17:11:53,80,3115,43,37,1779.97,3503.01,0.00
2024-12-08 17:11:53,79,3115,43,36,1792.31,3503.04,0.00
2024-12-08 17:11:53,78,3115,42,36,1809.49,3503.21,0.00
2024-12-08 17:11:53,78,3116,42,36,1818.05,3504.00,0.00
2024-12-08 17:11:53,79,3116,43,36,1795.03,3504.01,0.00
2024-12-08 17:11:53,78,3116,42,36,1817.60,3504.01,0.00
2024-12-08 17:11:53,77,3116,41,36,1816.71,3504.33,0.00
2024-12-08 17:11:53,77,3117,41,36,1838.94,3505.00,0.00
2024-12-08 17:11:53,78,3117,41,37,1815.36,3505.01,0.00
2024-12-08 17:11:53,77,3117,41,36,1838.04,3505.03,0.00
2024-12-08 17:11:53,76,3117,40,36,1855.35,3505.21,0.00
2024-12-08 17:11:53,76,3118,40,36,1865.05,3506.00,0.00
2024-12-08 17:11:53,77,3118,41,36,1840.83,3506.01,0.00
2024-12-08 17:11:53,77,3119,41,36,1834.07,3507.00,0.00
2024-12-08 17:11:53,78,3119,41,37,1810.55,3507.01,0.00
2024-12-08 17:11:53,77,3119,40,37,1833.62,3507.03,0.00
2024-12-08 17:11:53,76,3119,40,36,1857.29,3507.03,0.00
2024-12-08 17:11:53,76,3120,40,36,1860.58,3508.00,0.00
2024-12-08 17:11:53,77,3120,41,36,1836.41,3508.01,0.00
2024-12-08 17:11:53,76,3120,41,35,1850.43,3508.03,0.00
2024-12-08 17:11:53,75,3120,40,35,1860.17,3508.19,0.00
2024-12-08 17:11:53,76,3119,41,35,1817.95,3508.72,0.00
2024-12-08 17:11:53,76,3120,41,35,1863.88,3509.00,0.00
2024-12-08 17:11:53,77,3120,41,36,1839.67,3509.01,0.00
2024-12-08 17:11:53,76,3120,40,36,1839.44,3509.18,0.00
2024-12-08 17:11:53,76,3121,40,36,1903.52,3510.00,0.00
2024-12-08 17:11:53,77,3121,41,36,1878.80,3510.01,0.00
2024-12-08 17:11:53,76,3121,41,35,1899.84,3510.05,0.00
2024-12-08 17:11:53,75,3121,40,35,1921.43,3510.07,0.00
2024-12-08 17:11:53,75,3122,40,35,1935.63,3511.00,0.00
2024-12-08 17:11:53,76,3122,41,35,1910.16,3511.01,0.00
2024-12-08 17:11:53,75,3122,40,35,1934.23,3511.04,0.00
2024-12-08 17:11:53,74,3122,39,35,1953.26,3511.09,0.00
2024-12-08 17:11:53,73,3122,38,35,1959.93,3511.40,0.00
2024-12-08 17:11:53,73,3123,38,35,1986.77,3512.00,0.00
2024-12-08 17:11:53,74,3123,39,35,1959.92,3512.01,0.00
2024-12-08 17:11:53,73,3123,39,34,1977.16,3512.03,0.00
2024-12-08 17:11:53,73,3124,39,34,1981.46,3513.00,0.00
2024-12-08 17:11:53,74,3124,40,34,1954.68,3513.01,0.00
2024-12-08 17:11:53,74,3125,40,34,1947.92,3514.00,0.00
2024-12-08 17:11:53,75,3125,41,34,1921.95,3514.01,0.00
2024-12-08 17:11:53,74,3125,41,33,1940.81,3514.08,0.00
2024-12-08 17:11:53,74,3126,41,33,1945.43,3515.00,0.00
2024-12-08 17:11:53,75,3126,41,34,1919.49,3515.01,0.00
2024-12-08 17:11:53,76,3125,42,34,1875.80,3515.30,0.00
2024-12-08 17:11:53,75,3125,41,34,1920.57,3515.43,0.00
2024-12-08 17:11:53,75,3126,41,34,1936.73,3516.00,0.00
2024-12-08 17:11:53,76,3126,42,34,1911.25,3516.01,0.00
2024-12-08 17:11:53,75,3126,41,34,1936.27,3516.03,0.00
2024-12-08 17:11:53,74,3126,41,33,1959.11,3516.05,0.00
2024-12-08 17:11:53,74,3127,41,33,2010.36,3517.00,0.00
2024-12-08 17:11:53,75,3127,42,33,1983.55,3517.01,0.00
2024-12-08 17:11:53,74,3127,42,32,2005.14,3517.05,0.00
2024-12-08 17:11:53,74,3128,42,32,2009.11,3518.00,0.00
2024-12-08 17:11:53,75,3128,42,33,1982.32,3518.01,0.00
2024-12-08 17:11:53,74,3128,41,33,2008.64,3518.03,0.00
2024-12-08 17:11:54,74,3129,41,33,2002.60,3519.00,0.00
2024-12-08 17:11:54,75,3129,41,34,1975.90,3519.01,0.00
2024-12-08 17:11:54,74,3129,41,33,1992.62,3519.03,0.00
2024-12-08 17:11:54,73,3129,40,33,2008.85,3519.11,0.00
2024-12-08 17:11:54,73,3130,40,33,2025.44,3520.00,0.00
2024-12-08 17:11:54,74,3130,40,34,1998.07,3520.01,0.00
2024-12-08 17:11:54,73,3130,40,33,2021.59,3520.03,0.00
2024-12-08 17:11:54,72,3130,39,33,2040.39,3520.08,0.00
2024-12-08 17:11:54,72,3131,39,33,2056.68,3521.00,0.00
2024-12-08 17:11:54,73,3131,40,33,2028.51,3521.01,0.00
2024-12-08 17:11:54,73,3132,40,33,2022.36,3522.00,0.00
2024-12-08 17:11:54,74,3132,40,34,1995.03,3522.01,0.00
2024-12-08 17:11:54,73,3132,40,33,2018.03,3522.03,0.00
2024-12-08 17:11:54,72,3132,39,33,2041.26,3522.15,0.00
2024-12-08 17:11:54,72,3133,39,33,2050.33,3523.00,0.00
2024-12-08 17:11:54,73,3133,39,34,2022.24,3523.01,0.00
2024-12-08 17:11:54,72,3133,38,34,2034.19,3523.06,0.00
2024-12-08 17:11:54,72,3134,38,34,2049.70,3524.00,0.00
2024-12-08 17:11:54,73,3134,38,35,2021.63,3524.01,0.00
2024-12-08 17:11:54,72,3134,38,34,2044.82,3524.04,0.00
2024-12-08 17:11:54,72,3135,38,34,2049.71,3525.00,0.00
2024-12-08 17:11:54,73,3135,38,35,2021.64,3525.01,0.00
2024-12-08 17:11:54,74,3134,38,36,1981.01,3525.15,0.00
2024-12-08 17:11:54,74,3135,38,36,1992.34,3526.00,0.00
2024-12-08 17:11:54,75,3135,39,36,1965.78,3526.01,0.00
2024-12-08 17:11:54,74,3135,39,35,1986.15,3526.04,0.00
2024-12-08 17:11:54,74,3136,39,35,2034.73,3527.00,0.00
2024-12-08 17:11:54,75,3136,40,35,2007.60,3527.01,0.00
2024-12-08 17:11:54,74,3136,39,35,2019.35,3527.14,0.00
2024-12-08 17:11:54,75,3135,39,36,1989.64,3527.24,0.00
2024-12-08 17:11:54,75,3136,39,36,2025.69,3528.00,0.00
2024-12-08 17:11:54,76,3136,40,36,1999.04,3528.01,0.00
2024-12-08 17:11:54,75,3136,40,35,2019.12,3528.05,0.00
2024-12-08 17:11:54,75,3137,40,35,2067.70,3529.00,0.00
2024-12-08 17:11:54,76,3137,41,35,2040.49,3529.01,0.00
2024-12-08 17:11:54,77,3136,42,35,1989.39,3529.40,0.00
2024-12-08 17:11:54,77,3137,42,35,2013.11,3530.00,0.00
2024-12-08 17:11:54,78,3137,42,36,1987.30,3530.01,0.00
2024-12-08 17:11:54,77,3137,42,35,2005.78,3530.07,0.00
2024-12-08 17:11:54,77,3138,42,35,2051.34,3531.00,0.00
2024-12-08 17:11:54,78,3138,42,36,2025.04,3531.01,0.00
2024-12-08 17:11:54,77,3138,41,36,2050.88,3531.03,0.00
2024-12-08 17:11:54,77,3139,41,36,2040.12,3532.00,0.00
2024-12-08 17:11:54,78,3139,42,36,2013.97,3532.01,0.00
2024-12-08 17:11:54,77,3139,42,35,2033.71,3532.05,0.00
2024-12-08 17:11:54,77,3140,42,35,2033.84,3533.00,0.00
2024-12-08 17:11:54,78,3140,42,36,2007.76,3533.01,0.00
2024-12-08 17:11:54,78,3141,42,36,1996.98,3534.00,0.00
2024-12-08 17:11:54,79,3141,42,37,1971.70,3534.01,0.00
2024-12-08 17:11:54,79,3142,42,37,1960.47,3535.00,0.00
2024-12-08 17:11:54,80,3142,42,38,1935.96,3535.01,0.00
2024-12-08 17:11:54,79,3142,42,37,1952.49,3535.05,0.00
2024-12-08 17:11:54,80,3141,42,38,1924.15,3535.19,0.00
2024-12-08 17:11:54,80,3142,42,38,1952.83,3536.00,0.00
2024-12-08 17:11:54,81,3142,43,38,1928.73,3536.01,0.00
2024-12-08 17:11:54,81,3143,43,38,1956.74,3537.00,0.00
2024-12-08 17:11:54,82,3143,44,38,1932.88,3537.01,0.00
2024-12-08 17:11:54,81,3143,44,37,1950.20,3537.06,0.00
2024-12-08 17:11:54,82,3142,44,38,1916.62,3537.37,0.00
2024-12-08 17:11:54,81,3142,43,38,1946.33,3537.72,0.00
2024-12-08 17:11:54,81,3143,43,38,1967.39,3538.00,0.00
2024-12-08 17:11:54,82,3143,43,39,1943.39,3538.01,0.00
2024-12-08 17:11:54,81,3143,42,39,1951.24,3538.07,0.00
2024-12-08 17:11:55,81,3144,42,39,2002.01,3539.00,0.00
2024-12-08 17:11:55,82,3144,42,40,1977.60,3539.01,0.00
2024-12-08 17:11:55,81,3144,41,40,2000.71,3539.04,0.00
2024-12-08 17:11:55,80,3144,41,39,2020.85,3539.05,0.00
2024-12-08 17:11:55,80,3145,41,39,2027.03,3540.00,0.00
2024-12-08 17:11:55,81,3145,41,40,2002.01,3540.01,0.00
2024-12-08 17:11:55,81,3146,41,40,1986.51,3541.00,0.00
2024-12-08 17:11:55,82,3146,42,40,1962.28,3541.01,0.00
2024-12-08 17:11:55,81,3146,42,39,1980.40,3541.05,0.00
2024-12-08 17:11:55,80,3146,42,38,1975.42,3541.76,0.00
2024-12-08 17:11:55,80,3147,42,38,2000.68,3542.00,0.00
2024-12-08 17:11:55,81,3147,42,39,1975.98,3542.01,0.00
2024-12-08 17:11:55,81,3148,42,39,1965.63,3543.00,0.00
2024-12-08 17:11:55,82,3148,42,40,1941.65,3543.01,0.00
2024-12-08 17:11:55,81,3148,42,39,1959.95,3543.05,0.00
2024-12-08 17:11:55,80,3148,41,39,1979.57,3543.05,0.00
2024-12-08 17:11:55,81,3147,42,39,1952.12,3543.16,0.00
2024-12-08 17:11:55,81,3148,42,39,1999.34,3544.00,0.00
2024-12-08 17:11:55,82,3148,42,40,1974.96,3544.01,0.00
2024-12-08 17:11:55,82,3149,42,40,2002.41,3545.00,0.00
2024-12-08 17:11:55,83,3149,42,41,1978.29,3545.01,0.00
2024-12-08 17:11:55,82,3149,41,41,1969.98,3545.44,0.00
2024-12-08 17:11:55,82,3150,41,41,1986.51,3546.00,0.00
2024-12-08 17:11:55,83,3150,41,42,1962.57,3546.01,0.00
2024-12-08 17:11:55,83,3151,41,42,1946.46,3547.00,0.00
2024-12-08 17:11:55,84,3151,41,43,1923.29,3547.01,0.00
2024-12-08 17:11:55,83,3151,41,42,1936.77,3547.05,0.00
2024-12-08 17:11:55,83,3152,41,42,1931.34,3548.00,0.00
2024-12-08 17:11:55,84,3152,42,42,1908.35,3548.01,0.00
2024-12-08 17:11:55,83,3152,41,42,1916.44,3548.19,0.00
2024-12-08 17:11:55,83,3153,41,42,1917.20,3549.00,0.00
2024-12-08 17:11:55,84,3153,42,42,1894.38,3549.01,0.00
2024-12-08 17:11:55,83,3153,42,41,1912.93,3549.05,0.00
2024-12-08 17:11:55,82,3153,41,41,1931.28,3549.18,0.00
2024-12-08 17:11:55,82,3154,41,41,1932.28,3550.00,0.00
2024-12-08 17:11:55,83,3154,41,42,1909.00,3550.01,0.00
2024-12-08 17:11:55,84,3153,41,43,1875.31,3550.11,0.00
2024-12-08 17:11:55,83,3153,41,42,1898.81,3550.78,0.00
2024-12-08 17:11:55,83,3154,41,42,1925.51,3551.00,0.00
2024-12-08 17:11:55,84,3154,41,43,1902.59,3551.01,0.00
2024-12-08 17:11:55,84,3155,41,43,1933.51,3552.00,0.00
2024-12-08 17:11:55,85,3155,42,43,1910.76,3552.01,0.00
2024-12-08 17:11:55,85,3156,42,43,1897.62,3553.00,0.00
2024-12-08 17:11:55,86,3156,43,43,1875.55,3553.01,0.00
2024-12-08 17:11:55,85,3156,42,43,1870.95,3553.47,0.00
2024-12-08 17:11:55,85,3157,42,43,1885.06,3554.00,0.00
2024-12-08 17:11:55,86,3157,43,43,1863.14,3554.01,0.00
2024-12-08 17:11:55,85,3157,43,42,1882.97,3554.05,0.00
2024-12-08 17:11:55,85,3158,43,42,1880.94,3555.00,0.00
2024-12-08 17:11:55,86,3158,44,42,1859.07,3555.01,0.00
2024-12-08 17:11:55,85,3158,43,42,1875.93,3555.04,0.00
2024-12-08 17:11:55,84,3158,42,42,1875.24,3555.41,0.00
2024-12-08 17:11:55,83,3158,41,42,1896.14,3555.46,0.00
2024-12-08 17:11:55,82,3158,40,42,1918.41,3555.48,0.00
2024-12-08 17:11:55,82,3159,40,42,1943.51,3556.00,0.00
2024-12-08 17:11:55,83,3159,41,42,1920.09,3556.01,0.00
2024-12-08 17:11:55,82,3159,40,42,1923.15,3556.26,0.00
2024-12-08 17:11:55,81,3159,40,41,1946.33,3556.27,0.00
2024-12-08 17:11:56,81,3160,40,41,1956.03,3557.00,0.00
2024-12-08 17:11:56,82,3160,40,42,1932.18,3557.01,0.00
2024-12-08 17:11:56,81,3160,39,42,1955.15,3557.03,0.00
2024-12-08 17:11:56,81,3161,39,42,1943.11,3558.00,0.00
2024-12-08 17:11:56,82,3161,39,43,1919.41,3558.01,0.00
2024-12-08 17:11:56,82,3162,39,43,1909.78,3559.00,0.00
2024-12-08 17:11:56,83,3162,40,43,1886.77,3559.01,0.00
2024-12-08 17:11:56,84,3161,40,44,1864.31,3559.04,0.00
2024-12-08 17:11:56,83,3161,40,43,1917.65,3559.06,0.00
2024-12-08 17:11:56,83,3162,40,43,1917.11,3560.00,0.00
2024-12-08 17:11:56,84,3162,41,43,1894.29,3560.01,0.00
2024-12-08 17:11:56,83,3162,40,43,1897.59,3560.25,0.00
2024-12-08 17:11:56,83,3163,40,43,1948.68,3561.00,0.00
2024-12-08 17:11:56,84,3163,41,43,1925.48,3561.01,0.00
2024-12-08 17:11:56,83,3163,41,42,1945.70,3561.07,0.00
2024-12-08 17:11:56,82,3163,40,42,1951.48,3561.26,0.00
2024-12-08 17:11:56,82,3164,40,42,1968.90,3562.00,0.00
2024-12-08 17:11:56,83,3164,41,42,1945.18,3562.01,0.00
2024-12-08 17:11:56,82,3164,40,42,1955.47,3562.10,0.00
2024-12-08 17:11:56,82,3165,40,42,1963.94,3563.00,0.00
2024-12-08 17:11:56,83,3165,41,42,1940.28,3563.01,0.00
2024-12-08 17:11:56,82,3165,40,42,1963.14,3563.02,0.00
2024-12-08 17:11:56,81,3165,40,41,1985.63,3563.06,0.00
2024-12-08 17:11:56,81,3166,40,41,1973.34,3564.00,0.00
2024-12-08 17:11:56,82,3166,41,41,1949.28,3564.01,0.00
2024-12-08 17:11:56,81,3166,41,40,1962.37,3564.06,0.00
2024-12-08 17:11:56,80,3166,40,40,1982.44,3564.10,0.00
2024-12-08 17:11:56,80,3167,40,40,1992.66,3565.00,0.00
2024-12-08 17:11:56,81,3167,40,41,1968.06,3565.01,0.00
2024-12-08 17:11:56,80,3167,40,40,1990.01,3565.06,0.00
2024-12-08 17:11:56,81,3166,41,40,1964.56,3565.11,0.00
2024-12-08 17:11:56,81,3167,41,40,2006.63,3566.00,0.00
2024-12-08 17:11:56,82,3167,41,41,1982.16,3566.01,0.00
2024-12-08 17:11:56,82,3168,41,41,2014.00,3567.00,0.00
2024-12-08 17:11:56,83,3168,42,41,1989.73,3567.01,0.00
2024-12-08 17:11:56,82,3168,42,40,2011.41,3567.06,0.00
2024-12-08 17:11:56,82,3169,42,40,2007.82,3568.00,0.00
2024-12-08 17:11:56,83,3169,43,40,1983.63,3568.01,0.00
2024-12-08 17:11:56,83,3170,43,40,1966.42,3569.00,0.00
2024-12-08 17:11:56,84,3170,43,41,1943.01,3569.01,0.00
2024-12-08 17:11:56,84,3171,43,41,1928.24,3570.00,0.00
2024-12-08 17:11:56,85,3171,43,42,1905.55,3570.01,0.00
2024-12-08 17:11:56,84,3171,42,42,1926.56,3570.06,0.00
2024-12-08 17:11:56,84,3172,42,42,1916.01,3571.00,0.00
2024-12-08 17:11:56,85,3172,43,42,1893.47,3571.01,0.00
2024-12-08 17:11:56,84,3172,43,41,1906.60,3571.06,0.00
2024-12-08 17:11:56,84,3173,43,41,1905.75,3572.00,0.00
2024-12-08 17:11:56,85,3173,43,42,1883.33,3572.01,0.00
2024-12-08 17:11:56,84,3173,42,42,1904.07,3572.06,0.00
2024-12-08 17:11:56,83,3173,41,42,1926.58,3572.06,0.00
2024-12-08 17:11:56,83,3174,41,42,1925.65,3573.00,0.00
2024-12-08 17:11:56,84,3174,41,43,1902.73,3573.01,0.00
2024-12-08 17:11:56,83,3174,40,43,1923.52,3573.06,0.00
2024-12-08 17:11:56,82,3174,40,42,1946.10,3573.06,0.00
2024-12-08 17:11:56,82,3175,40,42,1946.62,3574.00,0.00
2024-12-08 17:11:56,83,3175,41,42,1923.17,3574.01,0.00
2024-12-08 17:11:56,82,3175,40,42,1943.59,3574.06,0.00
2024-12-08 17:11:56,82,3176,40,42,1942.72,3575.00,0.00
2024-12-08 17:11:56,83,3176,41,42,1919.31,3575.01,0.00
2024-12-08 17:11:56,82,3176,41,41,1939.25,3575.06,0.00
2024-12-08 17:11:57,82,3177,41,41,1932.59,3576.00,0.00
2024-12-08 17:11:57,83,3177,41,42,1909.30,3576.01,0.00
2024-12-08 17:11:57,83,3178,41,42,1891.66,3577.00,0.00
2024-12-08 17:11:57,84,3178,41,43,1869.14,3577.01,0.00
2024-12-08 17:11:57,83,3178,41,42,1886.94,3577.07,0.00
2024-12-08 17:11:57,83,3179,41,42,1880.94,3578.00,0.00
2024-12-08 17:11:57,84,3179,41,43,1858.55,3578.01,0.00
2024-12-08 17:11:57,83,3179,40,43,1880.08,3578.02,0.00
2024-12-08 17:11:57,82,3179,39,43,1868.96,3578.45,0.00
2024-12-08 17:11:57,82,3180,39,43,1887.87,3579.00,0.00
2024-12-08 17:11:57,83,3180,40,43,1865.13,3579.01,0.00
2024-12-08 17:11:57,82,3180,40,42,1883.96,3579.06,0.00
2024-12-08 17:11:57,82,3181,40,42,1878.29,3580.00,0.00
2024-12-08 17:11:57,83,3181,41,42,1855.66,3580.01,0.00
2024-12-08 17:11:57,82,3181,40,42,1877.43,3580.02,0.00
2024-12-08 17:11:57,82,3182,40,42,1856.58,3581.00,0.00
2024-12-08 17:11:57,83,3182,40,43,1834.21,3581.01,0.00
2024-12-08 17:11:57,82,3182,40,42,1853.11,3581.05,0.00
2024-12-08 17:11:57,83,3181,40,43,1794.65,3581.87,0.00
2024-12-08 17:11:57,83,3182,40,43,1827.16,3582.00,0.00
2024-12-08 17:11:57,84,3182,41,43,1805.41,3582.01,0.00
2024-12-08 17:11:57,83,3182,40,43,1823.73,3582.05,0.00
2024-12-08 17:11:57,82,3182,39,43,1827.57,3582.31,0.00
2024-12-08 17:11:57,82,3183,39,43,1882.51,3583.00,0.00
2024-12-08 17:11:57,83,3183,40,43,1859.83,3583.01,0.00
2024-12-08 17:11:57,82,3183,40,42,1879.03,3583.05,0.00
2024-12-08 17:11:57,82,3184,40,42,1871.56,3584.00,0.00
2024-12-08 17:11:57,83,3184,41,42,1849.01,3584.01,0.00
2024-12-08 17:11:57,82,3184,40,42,1849.32,3584.17,0.00
2024-12-08 17:11:57,82,3185,40,42,1856.17,3585.00,0.00
2024-12-08 17:11:57,83,3185,41,42,1833.80,3585.01,0.00
2024-12-08 17:11:57,82,3185,41,41,1847.28,3585.11,0.00
2024-12-08 17:11:57,82,3186,41,41,1844.58,3586.00,0.00
2024-12-08 17:11:57,83,3186,41,42,1822.35,3586.01,0.00
2024-12-08 17:11:57,82,3186,40,42,1818.61,3586.21,0.00
2024-12-08 17:11:57,81,3186,40,41,1831.38,3586.35,0.00
2024-12-08 17:11:57,80,3186,39,41,1835.74,3586.78,0.00
2024-12-08 17:11:57,81,3185,40,41,1808.87,3586.85,0.00
2024-12-08 17:11:57,81,3186,40,41,1861.57,3587.00,0.00
2024-12-08 17:11:57,82,3186,41,41,1838.86,3587.01,0.00
2024-12-08 17:11:57,81,3186,41,40,1850.84,3587.12,0.00
2024-12-08 17:11:57,81,3187,41,40,1891.96,3588.00,0.00
2024-12-08 17:11:57,82,3187,42,40,1868.89,3588.01,0.00
2024-12-08 17:11:57,81,3187,41,40,1873.45,3588.22,0.00
2024-12-08 17:11:57,82,3186,41,41,1821.96,3588.77,0.00
2024-12-08 17:11:57,82,3187,41,41,1872.21,3589.00,0.00
2024-12-08 17:11:57,83,3187,41,42,1849.66,3589.01,0.00
2024-12-08 17:11:57,82,3187,40,42,1870.92,3589.05,0.00
2024-12-08 17:11:57,81,3187,40,41,1885.10,3589.11,0.00
2024-12-08 17:11:57,81,3188,40,41,1926.84,3590.00,0.00
2024-12-08 17:11:57,82,3188,41,41,1903.34,3590.01,0.00
2024-12-08 17:11:57,81,3188,41,40,1923.53,3590.05,0.00
2024-12-08 17:11:57,81,3189,41,40,1909.47,3591.00,0.00
2024-12-08 17:11:57,82,3189,41,41,1886.19,3591.01,0.00
2024-12-08 17:11:57,81,3189,41,40,1901.96,3591.10,0.00
2024-12-08 17:11:57,81,3190,41,40,1895.37,3592.00,0.00
2024-12-08 17:11:57,82,3190,42,40,1872.25,3592.01,0.00
2024-12-08 17:11:57,81,3190,41,40,1893.61,3592.06,0.00
2024-12-08 17:11:57,80,3190,40,40,1914.59,3592.08,0.00
2024-12-08 17:11:57,79,3190,40,39,1918.82,3592.37,0.00
2024-12-08 17:11:57,79,3191,40,39,1934.92,3593.00,0.00
2024-12-08 17:11:57,80,3191,41,39,1910.73,3593.01,0.00
2024-12-08 17:11:57,79,3191,41,38,1928.12,3593.08,0.00
2024-12-08 17:11:57,78,3191,40,38,1939.73,3593.44,0.00
2024-12-08 17:11:57,78,3192,40,38,1948.46,3594.00,0.00
2024-12-08 17:11:57,79,3192,41,38,1923.80,3594.01,0.00
2024-12-08 17:11:58,79,3193,41,38,1906.63,3595.00,0.00
2024-12-08 17:11:58,80,3193,41,39,1882.79,3595.01,0.00
2024-12-08 17:11:58,79,3193,41,38,1900.27,3595.08,0.00
2024-12-08 17:11:58,78,3193,40,38,1905.17,3595.60,0.00
2024-12-08 17:11:58,78,3194,40,38,1919.97,3596.00,0.00
2024-12-08 17:11:58,79,3194,40,39,1895.66,3596.01,0.00
2024-12-08 17:11:58,78,3194,39,39,1893.92,3596.46,0.00
2024-12-08 17:11:58,77,3194,39,38,1910.96,3596.62,0.00
2024-12-08 17:11:58,77,3195,39,38,1930.77,3597.00,0.00
2024-12-08 17:11:58,78,3195,39,39,1906.02,3597.01,0.00
2024-12-08 17:11:58,77,3195,39,38,1924.72,3597.08,0.00
2024-12-08 17:11:58,77,3196,39,38,1925.62,3598.00,0.00
2024-12-08 17:11:58,78,3196,40,38,1900.93,3598.01,0.00
2024-12-08 17:11:58,78,3197,40,38,1887.17,3599.00,0.00
2024-12-08 17:11:58,79,3197,40,39,1863.28,3599.01,0.00
2024-12-08 17:11:58,78,3197,40,38,1881.65,3599.08,0.00
2024-12-08 17:11:58,77,3197,39,38,1884.16,3599.61,0.00
2024-12-08 17:11:58,77,3198,39,38,1903.36,3600.00,0.00
2024-12-08 17:11:58,78,3198,39,39,1878.96,3600.01,0.00
2024-12-08 17:11:58,77,3198,38,39,1901.97,3600.04,0.00
2024-12-08 17:11:58,77,3199,38,39,1888.40,3601.00,0.00
2024-12-08 17:11:58,78,3199,39,39,1864.19,3601.01,0.00
2024-12-08 17:11:58,77,3199,39,38,1882.80,3601.08,0.00
2024-12-08 17:11:58,76,3199,38,38,1901.93,3601.22,0.00
2024-12-08 17:11:58,76,3200,38,38,1905.40,3602.00,0.00
2024-12-08 17:11:58,77,3200,39,38,1880.65,3602.01,0.00
2024-12-08 17:11:58,77,3201,39,38,1865.62,3603.00,0.00
2024-12-08 17:11:58,78,3201,40,38,1841.70,3603.01,0.00
2024-12-08 17:11:58,77,3201,40,37,1859.09,3603.09,0.00
2024-12-08 17:11:58,77,3202,40,37,1854.62,3604.00,0.00
2024-12-08 17:11:58,78,3202,40,38,1830.85,3604.01,0.00
2024-12-08 17:11:58,78,3203,40,38,1814.30,3605.00,0.00
2024-12-08 17:11:58,79,3203,41,38,1791.33,3605.01,0.00
2024-12-08 17:11:58,78,3203,41,37,1808.30,3605.09,0.00
2024-12-08 17:11:58,79,3202,42,37,1780.89,3605.24,0.00
2024-12-08 17:11:58,79,3203,42,37,1808.96,3606.00,0.00
2024-12-08 17:11:58,80,3203,42,38,1786.35,3606.01,0.00
2024-12-08 17:11:58,81,3202,42,39,1724.88,3606.68,0.00
2024-12-08 17:11:58,81,3203,42,39,1810.53,3607.00,0.00
2024-12-08 17:11:58,82,3203,43,39,1788.45,3607.01,0.00
2024-12-08 17:11:58,81,3203,43,38,1804.31,3607.10,0.00
2024-12-08 17:11:58,80,3203,42,38,1794.87,3607.73,0.00
2024-12-08 17:11:58,80,3204,42,38,1872.98,3608.00,0.00
2024-12-08 17:11:58,81,3204,43,38,1849.85,3608.01,0.00
2024-12-08 17:11:58,80,3204,42,38,1871.18,3608.06,0.00
2024-12-08 17:11:58,79,3204,42,37,1877.01,3608.23,0.00
2024-12-08 17:11:58,78,3204,41,37,1900.62,3608.23,0.00
2024-12-08 17:11:58,77,3204,41,36,1913.73,3608.48,0.00
2024-12-08 17:11:58,77,3205,41,36,1938.42,3609.00,0.00
2024-12-08 17:11:58,78,3205,41,37,1913.57,3609.01,0.00
2024-12-08 17:11:58,77,3205,41,36,1931.88,3609.10,0.00
2024-12-08 17:11:58,76,3205,41,35,1939.07,3609.61,0.00
2024-12-08 17:11:58,76,3206,41,35,1960.52,3610.00,0.00
2024-12-08 17:11:58,77,3206,41,36,1935.06,3610.01,0.00
2024-12-08 17:11:58,76,3206,40,36,1959.11,3610.04,0.00
2024-12-08 17:11:58,75,3206,39,36,1984.75,3610.05,0.00
2024-12-08 17:11:58,74,3206,38,36,1996.49,3610.20,0.00
2024-12-08 17:11:58,74,3207,38,36,2015.39,3611.00,0.00
2024-12-08 17:11:58,75,3207,39,36,1988.52,3611.01,0.00
2024-12-08 17:11:59,74,3207,39,35,2008.58,3611.09,0.00
2024-12-08 17:11:59,74,3208,39,35,2014.42,3612.00,0.00
2024-12-08 17:11:59,75,3208,39,36,1987.57,3612.01,0.00
2024-12-08 17:11:59,75,3209,39,36,1978.87,3613.00,0.00
2024-12-08 17:11:59,76,3209,40,36,1952.83,3613.01,0.00
2024-12-08 17:11:59,75,3209,39,36,1977.44,3613.04,0.00
2024-12-08 17:11:59,74,3209,39,35,1999.28,3613.08,0.00
2024-12-08 17:11:59,73,3209,39,34,2006.42,3613.64,0.00
2024-12-08 17:11:59,73,3210,39,34,2033.43,3614.00,0.00
2024-12-08 17:11:59,74,3210,39,35,2005.95,3614.01,0.00
2024-12-08 17:11:59,74,3211,39,35,2000.15,3615.00,0.00
2024-12-08 17:11:59,75,3211,39,36,1973.49,3615.01,0.00
2024-12-08 17:11:59,74,3211,39,35,1998.21,3615.05,0.00
2024-12-08 17:11:59,74,3212,39,35,2003.64,3616.00,0.00
2024-12-08 17:11:59,75,3212,40,35,1976.92,3616.01,0.00
2024-12-08 17:11:59,75,3213,40,35,1970.72,3617.00,0.00
2024-12-08 17:11:59,76,3213,41,35,1944.79,3617.01,0.00
2024-12-08 17:11:59,75,3213,40,35,1969.28,3617.05,0.00
2024-12-08 17:11:59,74,3213,40,34,1993.94,3617.05,0.00
2024-12-08 17:11:59,75,3212,41,34,1944.97,3617.71,0.00
2024-12-08 17:11:59,75,3213,41,34,1982.84,3618.00,0.00
2024-12-08 17:11:59,76,3213,41,35,1956.75,3618.01,0.00
2024-12-08 17:11:59,75,3213,40,35,1965.16,3618.23,0.00
2024-12-08 17:11:59,75,3214,40,35,2024.51,3619.00,0.00
2024-12-08 17:11:59,76,3214,41,35,1997.87,3619.01,0.00
2024-12-08 17:11:59,75,3214,41,34,2021.14,3619.05,0.00
2024-12-08 17:11:59,75,3215,41,34,2026.03,3620.00,0.00
2024-12-08 17:11:59,76,3215,42,34,1999.38,3620.01,0.00
2024-12-08 17:11:59,76,3216,42,34,1992.78,3621.00,0.00
2024-12-08 17:11:59,77,3216,42,35,1966.90,3621.01,0.00
2024-12-08 17:11:59,76,3216,42,34,1989.93,3621.05,0.00
2024-12-08 17:11:59,75,3216,41,34,2003.09,3621.43,0.00
2024-12-08 17:11:59,75,3217,41,34,2021.36,3622.00,0.00
2024-12-08 17:11:59,76,3217,41,35,1994.76,3622.01,0.00
2024-12-08 17:11:59,75,3217,41,34,2017.93,3622.07,0.00
2024-12-08 17:11:59,75,3218,41,34,2023.30,3623.00,0.00
2024-12-08 17:11:59,76,3218,41,35,1996.68,3623.01,0.00
2024-12-08 17:11:59,75,3218,40,35,2012.68,3623.03,0.00
2024-12-08 17:11:59,74,3218,39,35,2023.29,3623.22,0.00
2024-12-08 17:11:59,74,3219,39,35,2044.35,3624.00,0.00
2024-12-08 17:11:59,75,3219,39,36,2017.10,3624.01,0.00
2024-12-08 17:11:59,74,3219,39,35,2042.68,3624.05,0.00
2024-12-08 17:11:59,74,3220,39,35,2047.96,3625.00,0.00
2024-12-08 17:11:59,75,3220,40,35,2020.65,3625.01,0.00
2024-12-08 17:11:59,74,3220,39,35,2030.84,3625.09,0.00
2024-12-08 17:11:59,74,3221,39,35,2047.13,3626.00,0.00
2024-12-08 17:11:59,75,3221,40,35,2019.84,3626.01,0.00
2024-12-08 17:12:00,74,3221,40,34,2043.23,3626.05,0.00
2024-12-08 17:12:00,74,3222,40,34,2048.16,3627.00,0.00
2024-12-08 17:12:00,75,3222,40,35,2020.85,3627.01,0.00
2024-12-08 17:12:00,75,3223,40,35,2013.97,3628.00,0.00
2024-12-08 17:12:00,76,3223,40,36,1987.47,3628.01,0.00
2024-12-08 17:12:00,75,3223,40,35,2011.08,3628.05,0.00
2024-12-08 17:12:00,74,3223,39,35,2027.99,3628.15,0.00
2024-12-08 17:12:00,74,3224,39,35,2046.09,3629.00,0.00
2024-12-08 17:12:00,75,3224,40,35,2018.81,3629.01,0.00
2024-12-08 17:12:00,75,3225,40,35,2011.89,3630.00,0.00
2024-12-08 17:12:00,76,3225,41,35,1985.41,3630.01,0.00
2024-12-08 17:12:00,75,3225,41,34,2009.48,3630.05,0.00
2024-12-08 17:12:00,75,3226,41,34,2013.10,3631.00,0.00
2024-12-08 17:12:00,76,3226,41,35,1986.61,3631.01,0.00
2024-12-08 17:12:00,75,3226,40,35,2008.75,3631.07,0.00
2024-12-08 17:12:00,75,3227,40,35,2012.46,3632.00,0.00
2024-12-08 17:12:00,76,3227,40,36,1985.98,3632.01,0.00
2024-12-08 17:12:00,75,3227,39,36,2011.49,3632.03,0.00
2024-12-08 17:12:00,74,3227,39,35,2034.99,3632.05,0.00
2024-12-08 17:12:00,73,3227,38,35,2027.40,3632.71,0.00
2024-12-08 17:12:00,73,3228,38,35,2066.94,3633.00,0.00
2024-12-08 17:12:00,74,3228,38,36,2039.01,3633.01,0.00
2024-12-08 17:12:00,74,3229,38,36,2031.18,3634.00,0.00
2024-12-08 17:12:00,75,3229,39,36,2004.10,3634.01,0.00
2024-12-08 17:12:00,74,3229,38,36,2029.72,3634.04,0.00
2024-12-08 17:12:00,73,3229,38,35,2055.22,3634.04,0.00
2024-12-08 17:12:00,73,3230,38,35,2059.32,3635.00,0.00
2024-12-08 17:12:00,74,3230,39,35,2031.49,3635.01,0.00
2024-12-08 17:12:00,73,3230,38,35,2043.13,3635.12,0.00
2024-12-08 17:12:00,73,3231,38,35,2051.64,3636.00,0.00
2024-12-08 17:12:00,74,3231,39,35,2023.91,3636.01,0.00
2024-12-08 17:12:00,73,3231,39,34,2038.70,3636.04,0.00
2024-12-08 17:12:00,73,3232,39,34,2054.19,3637.00,0.00
2024-12-08 17:12:00,74,3232,39,35,2026.43,3637.01,0.00
2024-12-08 17:12:00,73,3232,38,35,2049.22,3637.06,0.00
2024-12-08 17:12:00,73,3233,38,35,2055.26,3638.00,0.00
2024-12-08 17:12:00,74,3233,39,35,2027.48,3638.01,0.00
2024-12-08 17:12:00,73,3233,39,34,2038.33,3638.08,0.00
2024-12-08 17:12:00,73,3234,39,34,2055.32,3639.00,0.00
2024-12-08 17:12:00,74,3234,39,35,2027.55,3639.01,0.00
2024-12-08 17:12:00,73,3234,38,35,2054.82,3639.01,0.00
2024-12-08 17:12:00,72,3234,37,35,2079.33,3639.04,0.00
2024-12-08 17:12:00,72,3235,37,35,2085.43,3640.00,0.00
2024-12-08 17:12:00,73,3235,38,35,2056.86,3640.01,0.00
2024-12-08 17:12:00,72,3235,38,34,2080.43,3640.06,0.00
2024-12-08 17:12:00,71,3235,37,34,2095.70,3640.44,0.00
2024-12-08 17:12:00,71,3236,37,34,2116.07,3641.00,0.00
2024-12-08 17:12:00,72,3236,37,35,2086.68,3641.01,0.00
2024-12-08 17:12:00,71,3236,37,34,2106.08,3641.06,0.00
2024-12-08 17:12:01,71,3237,37,34,2112.11,3642.00,0.00
2024-12-08 17:12:01,72,3237,37,35,2082.78,3642.01,0.00
2024-12-08 17:12:01,72,3238,37,35,2076.25,3643.00,0.00
2024-12-08 17:12:01,73,3238,37,36,2047.81,3643.01,0.00
2024-12-08 17:12:01,72,3238,37,35,2066.66,3643.08,0.00
2024-12-08 17:12:01,72,3239,37,35,2072.67,3644.00,0.00
2024-12-08 17:12:01,73,3239,37,36,2044.28,3644.01,0.00
2024-12-08 17:12:01,73,3240,37,36,2038.54,3645.00,0.00
2024-12-08 17:12:01,74,3240,37,37,2010.99,3645.01,0.00
2024-12-08 17:12:01,73,3240,37,36,2029.57,3645.08,0.00
2024-12-08 17:12:01,73,3241,37,36,2036.44,3646.00,0.00
2024-12-08 17:12:01,74,3241,37,37,2008.92,3646.01,0.00
2024-12-08 17:12:01,74,3242,37,37,2003.01,3647.00,0.00
2024-12-08 17:12:01,75,3242,37,38,1976.31,3647.01,0.00
2024-12-08 17:12:01,74,3242,36,38,1985.32,3647.20,0.00
2024-12-08 17:12:01,74,3243,36,38,2005.20,3648.00,0.00
2024-12-08 17:12:01,75,3243,37,38,1978.47,3648.01,0.00
2024-12-08 17:12:01,74,3243,37,37,1994.87,3648.11,0.00
2024-12-08 17:12:01,73,3243,36,37,2017.23,3648.21,0.00
2024-12-08 17:12:01,73,3244,36,37,2036.94,3649.00,0.00
2024-12-08 17:12:01,74,3244,36,38,2009.41,3649.01,0.00
2024-12-08 17:12:01,74,3245,36,38,2000.69,3650.00,0.00
2024-12-08 17:12:01,75,3245,36,39,1974.02,3650.01,0.00
2024-12-08 17:12:01,74,3245,36,38,1986.91,3650.16,0.00
2024-12-08 17:12:01,74,3246,36,38,1992.03,3651.00,0.00
2024-12-08 17:12:01,75,3246,37,38,1965.47,3651.01,0.00
2024-12-08 17:12:01,75,3247,37,38,1955.14,3652.00,0.00
2024-12-08 17:12:01,76,3247,37,39,1929.42,3652.01,0.00
2024-12-08 17:12:01,75,3247,37,38,1949.31,3652.08,0.00
2024-12-08 17:12:01,75,3248,37,38,1951.26,3653.00,0.00
2024-12-08 17:12:01,76,3248,37,39,1925.58,3653.01,0.00
2024-12-08 17:12:01,75,3248,37,38,1937.65,3653.16,0.00
2024-12-08 17:12:01,74,3248,36,38,1962.36,3653.19,0.00
2024-12-08 17:12:01,74,3249,36,38,1968.25,3654.00,0.00
2024-12-08 17:12:01,75,3249,36,39,1942.01,3654.01,0.00
2024-12-08 17:12:01,75,3250,36,39,1930.19,3655.00,0.00
2024-12-08 17:12:01,76,3250,36,40,1904.79,3655.01,0.00
2024-12-08 17:12:01,75,3250,35,40,1927.76,3655.07,0.00
2024-12-08 17:12:01,74,3250,35,39,1942.46,3655.15,0.00
2024-12-08 17:12:01,74,3251,35,39,1943.86,3656.00,0.00
2024-12-08 17:12:01,75,3251,35,40,1917.94,3656.01,0.00
2024-12-08 17:12:01,75,3252,35,40,1902.91,3657.00,0.00
2024-12-08 17:12:01,76,3252,36,40,1877.88,3657.01,0.00
2024-12-08 17:12:01,75,3252,36,39,1887.83,3657.17,0.00
2024-12-08 17:12:01,74,3252,35,39,1893.68,3657.45,0.00
2024-12-08 17:12:02,74,3253,35,39,1912.87,3658.00,0.00
2024-12-08 17:12:02,75,3253,36,39,1887.37,3658.01,0.00
2024-12-08 17:12:02,75,3254,36,39,1869.70,3659.00,0.00
2024-12-08 17:12:02,76,3254,37,39,1845.10,3659.01,0.00
2024-12-08 17:12:02,75,3254,36,39,1867.27,3659.07,0.00
2024-12-08 17:12:02,75,3255,36,39,1851.28,3660.00,0.00
2024-12-08 17:12:02,76,3255,36,40,1826.92,3660.01,0.00
2024-12-08 17:12:02,75,3255,35,40,1850.31,3660.03,0.00
2024-12-08 17:12:02,74,3255,35,39,1861.98,3660.15,0.00
2024-12-08 17:12:02,73,3255,35,38,1864.51,3660.73,0.00
2024-12-08 17:12:02,73,3256,35,38,1891.55,3661.00,0.00
2024-12-08 17:12:02,74,3256,36,38,1865.99,3661.01,0.00
2024-12-08 17:12:02,74,3257,36,38,1853.68,3662.00,0.00
2024-12-08 17:12:02,75,3257,37,38,1828.97,3662.01,0.00
2024-12-08 17:12:02,74,3257,37,37,1840.84,3662.15,0.00
2024-12-08 17:12:02,74,3258,37,37,1843.02,3663.00,0.00
2024-12-08 17:12:02,75,3258,37,38,1818.44,3663.01,0.00
2024-12-08 17:12:02,74,3258,36,38,1830.17,3663.15,0.00
2024-12-08 17:12:02,74,3259,36,38,1832.07,3664.00,0.00
2024-12-08 17:12:02,75,3259,36,39,1807.64,3664.01,0.00
2024-12-08 17:12:02,74,3259,36,38,1819.21,3664.15,0.00
2024-12-08 17:12:02,73,3259,36,37,1819.95,3664.70,0.00
2024-12-08 17:12:02,73,3260,36,37,1849.30,3665.00,0.00
2024-12-08 17:12:02,74,3260,36,38,1824.31,3665.01,0.00
2024-12-08 17:12:02,73,3260,36,37,1848.30,3665.03,0.00
2024-12-08 17:12:02,72,3260,35,37,1872.45,3665.07,0.00
2024-12-08 17:12:02,71,3260,34,37,1883.88,3665.18,0.00
2024-12-08 17:12:02,71,3261,34,37,1892.07,3666.00,0.00
2024-12-08 17:12:02,72,3261,35,37,1865.79,3666.01,0.00
2024-12-08 17:12:02,71,3261,34,37,1890.01,3666.07,0.00
2024-12-08 17:12:02,70,3261,33,37,1916.49,3666.07,0.00
2024-12-08 17:12:02,69,3261,33,36,1935.24,3666.10,0.00
2024-12-08 17:12:02,69,3262,33,36,1941.01,3667.00,0.00
2024-12-08 17:12:02,70,3262,33,37,1913.28,3667.01,0.00
2024-12-08 17:12:02,69,3262,32,37,1939.96,3667.04,0.00
2024-12-08 17:12:02,68,3262,31,37,1952.34,3667.18,0.00
2024-12-08 17:12:02,68,3263,31,37,1961.52,3668.00,0.00
2024-12-08 17:12:02,69,3263,32,37,1933.10,3668.01,0.00
2024-12-08 17:12:02,68,3263,32,36,1948.60,3668.12,0.00
2024-12-08 17:12:02,67,3263,32,35,1964.76,3668.36,0.00
2024-12-08 17:12:02,67,3264,32,35,1985.45,3669.00,0.00
2024-12-08 17:12:02,68,3264,33,35,1956.25,3669.02,0.00
2024-12-08 17:12:02,68,3265,33,35,1950.26,3670.00,0.00
2024-12-08 17:12:02,69,3265,34,35,1921.99,3670.01,0.00
2024-12-08 17:12:02,68,3265,34,34,1936.79,3670.13,0.00
2024-12-08 17:12:02,68,3266,34,34,1945.16,3671.00,0.00
2024-12-08 17:12:02,69,3266,34,35,1916.97,3671.01,0.00
2024-12-08 17:12:02,69,3267,34,35,1907.89,3672.00,0.00
2024-12-08 17:12:02,70,3267,34,36,1880.63,3672.01,0.00
2024-12-08 17:12:02,69,3267,33,36,1898.32,3672.10,0.00
2024-12-08 17:12:02,68,3267,33,35,1914.91,3672.15,0.00
2024-12-08 17:12:02,67,3267,32,35,1915.97,3672.70,0.00
2024-12-08 17:12:02,67,3268,32,35,1960.06,3673.00,0.00
2024-12-08 17:12:02,68,3268,32,36,1931.24,3673.02,0.00
2024-12-08 17:12:02,67,3268,32,35,1922.04,3673.31,0.00
2024-12-08 17:12:02,67,3269,32,35,1952.11,3674.00,0.00
2024-12-08 17:12:02,68,3269,32,36,1923.40,3674.02,0.00
2024-12-08 17:12:02,67,3269,32,35,1937.87,3674.15,0.00
2024-12-08 17:12:02,66,3269,31,35,1966.69,3674.17,0.00
2024-12-08 17:12:02,65,3269,31,34,1995.17,3674.17,0.00
2024-12-08 17:12:02,65,3270,31,34,2021.69,3675.00,0.00
2024-12-08 17:12:02,66,3270,32,34,1991.06,3675.02,0.00
2024-12-08 17:12:02,65,3270,31,34,2019.44,3675.08,0.00
2024-12-08 17:12:02,65,3271,31,34,2019.98,3676.00,0.00
2024-12-08 17:12:02,66,3271,32,34,1989.37,3676.02,0.00
2024-12-08 17:12:02,65,3271,32,33,2005.86,3676.14,0.00
2024-12-08 17:12:03,65,3272,32,33,2019.96,3677.00,0.00
2024-12-08 17:12:03,66,3272,33,33,1989.36,3677.02,0.00
2024-12-08 17:12:03,65,3272,32,33,2014.88,3677.05,0.00
2024-12-08 17:12:03,64,3272,31,33,2030.86,3677.14,0.00
2024-12-08 17:12:03,64,3273,31,33,2057.25,3678.00,0.00
2024-12-08 17:12:03,65,3273,31,34,2025.60,3678.02,0.00
2024-12-08 17:12:03,64,3273,31,33,2042.90,3678.13,0.00
2024-12-08 17:12:03,64,3274,31,33,2057.24,3679.00,0.00
2024-12-08 17:12:03,65,3274,31,34,2025.59,3679.02,0.00
2024-12-08 17:12:03,65,3275,31,34,2023.71,3680.00,0.00
2024-12-08 17:12:03,66,3275,32,34,1993.05,3680.02,0.00
2024-12-08 17:12:03,65,3275,32,33,2008.44,3680.14,0.00
2024-12-08 17:12:03,64,3275,31,33,2039.82,3680.14,0.00
2024-12-08 17:12:03,64,3276,31,33,2054.74,3681.00,0.00
2024-12-08 17:12:03,65,3276,31,34,2023.13,3681.02,0.00
2024-12-08 17:12:03,65,3277,31,34,2021.41,3682.00,0.00
2024-12-08 17:12:03,66,3277,32,34,1990.79,3682.02,0.00
2024-12-08 17:12:03,65,3277,32,33,2005.00,3682.15,0.00
2024-12-08 17:12:03,65,3278,32,33,2019.70,3683.00,0.00
2024-12-08 17:12:03,66,3278,33,33,1989.09,3683.02,0.00
2024-12-08 17:12:03,65,3278,32,33,2006.67,3683.06,0.00
2024-12-08 17:12:03,65,3279,32,33,2017.98,3684.00,0.00
2024-12-08 17:12:03,66,3279,32,34,1987.40,3684.02,0.00
2024-12-08 17:12:03,65,3279,32,33,2002.57,3684.14,0.00
2024-12-08 17:12:03,65,3280,32,33,2016.71,3685.00,0.00
2024-12-08 17:12:03,66,3280,32,34,1986.16,3685.02,0.00
2024-12-08 17:12:03,65,3280,31,34,2016.15,3685.02,0.00
2024-12-08 17:12:03,64,3280,30,34,2045.92,3685.05,0.00
2024-12-08 17:12:03,63,3280,29,34,2053.46,3685.25,0.00
2024-12-08 17:12:03,63,3281,29,34,2084.98,3686.00,0.00
2024-12-08 17:12:03,64,3281,29,35,2052.40,3686.02,0.00
2024-12-08 17:12:03,63,3281,28,35,2084.39,3686.02,0.00
2024-12-08 17:12:03,62,3281,27,35,2113.86,3686.11,0.00
2024-12-08 17:12:03,62,3282,27,35,2117.40,3687.00,0.00
2024-12-08 17:12:03,63,3282,28,35,2083.79,3687.02,0.00
2024-12-08 17:12:03,62,3282,28,34,2113.25,3687.11,0.00
2024-12-08 17:12:03,62,3283,28,34,2128.68,3688.00,0.00
2024-12-08 17:12:03,63,3283,29,34,2094.89,3688.02,0.00
2024-12-08 17:12:03,62,3283,28,34,2102.64,3688.39,0.00
2024-12-08 17:12:03,62,3284,28,34,2128.07,3689.00,0.00
2024-12-08 17:12:03,63,3284,29,34,2094.29,3689.02,0.00
2024-12-08 17:12:03,62,3284,28,34,2126.88,3689.05,0.00
2024-12-08 17:12:03,61,3284,28,33,2147.84,3689.10,0.00
2024-12-08 17:12:03,61,3285,28,33,2163.43,3690.00,0.00
2024-12-08 17:12:03,62,3285,28,34,2128.54,3690.02,0.00
2024-12-08 17:12:03,62,3286,28,34,2128.52,3691.00,0.00
2024-12-08 17:12:03,63,3286,29,34,2094.73,3691.02,0.00
2024-12-08 17:12:03,62,3286,29,33,2112.11,3691.13,0.00
2024-12-08 17:12:03,61,3286,28,33,2119.76,3691.61,0.00
2024-12-08 17:12:03,61,3287,28,33,2166.07,3692.00,0.00
2024-12-08 17:12:03,62,3287,29,33,2131.13,3692.02,0.00
2024-12-08 17:12:03,61,3287,28,33,2165.46,3692.02,0.00
2024-12-08 17:12:03,61,3288,28,33,2166.05,3693.00,0.00
2024-12-08 17:12:03,62,3288,29,33,2131.11,3693.02,0.00
2024-12-08 17:12:03,61,3288,29,32,2150.32,3693.12,0.00
2024-12-08 17:12:03,61,3289,29,32,2166.63,3694.00,0.00
2024-12-08 17:12:03,62,3289,30,32,2131.69,3694.02,0.00
2024-12-08 17:12:03,62,3290,30,32,2131.67,3695.00,0.00
2024-12-08 17:12:03,63,3290,31,32,2097.83,3695.02,0.00
2024-12-08 17:12:04,63,3291,31,32,2097.23,3696.00,0.00
2024-12-08 17:12:04,64,3291,32,32,2064.46,3696.02,0.00
2024-12-08 17:12:04,64,3292,32,32,2063.28,3697.00,0.00
2024-12-08 17:12:04,65,3292,33,32,2031.54,3697.02,0.00
2024-12-08 17:12:04,64,3292,32,32,2062.13,3697.03,0.00
2024-12-08 17:12:04,63,3292,32,31,2082.54,3697.10,0.00
2024-12-08 17:12:04,63,3293,32,31,2096.60,3698.00,0.00
2024-12-08 17:12:04,64,3293,33,31,2063.84,3698.02,0.00
2024-12-08 17:12:04,63,3293,33,30,2080.77,3698.13,0.00
2024-12-08 17:12:04,63,3294,33,30,2095.99,3699.00,0.00
2024-12-08 17:12:04,64,3294,33,31,2063.24,3699.02,0.00
2024-12-08 17:12:04,63,3294,32,31,2091.90,3699.13,0.00
2024-12-08 17:12:04,63,3295,32,31,2095.39,3700.00,0.00
2024-12-08 17:12:04,64,3295,33,31,2062.65,3700.02,0.00
2024-12-08 17:12:04,63,3295,33,30,2088.95,3700.14,0.00
2024-12-08 17:12:04,63,3296,33,30,2104.76,3701.00,0.00
2024-12-08 17:12:04,64,3296,33,31,2071.88,3701.02,0.00
2024-12-08 17:12:04,63,3296,32,31,2104.18,3701.03,0.00
2024-12-08 17:12:04,64,3295,33,31,2020.80,3701.81,0.00
2024-12-08 17:12:04,64,3296,33,31,2090.37,3702.00,0.00
2024-12-08 17:12:04,65,3296,33,32,2058.21,3702.02,0.00
2024-12-08 17:12:04,65,3297,33,32,2113.46,3703.00,0.00
2024-12-08 17:12:04,66,3297,34,32,2081.43,3703.02,0.00
2024-12-08 17:12:04,65,3297,34,31,2108.91,3703.12,0.00
2024-12-08 17:12:04,65,3298,34,31,2122.57,3704.00,0.00
2024-12-08 17:12:04,66,3298,34,32,2090.41,3704.02,0.00
2024-12-08 17:12:04,66,3299,34,32,2088.17,3705.00,0.00
2024-12-08 17:12:04,67,3299,35,32,2057.00,3705.02,0.00
2024-12-08 17:12:04,66,3299,35,31,2073.03,3705.12,0.00
2024-12-08 17:12:04,66,3300,35,31,2085.93,3706.00,0.00
2024-12-08 17:12:04,67,3300,36,31,2054.79,3706.02,0.00
2024-12-08 17:12:04,66,3300,36,30,2085.37,3706.02,0.00
2024-12-08 17:12:04,65,3300,35,30,2117.45,3706.02,0.00
2024-12-08 17:12:04,65,3301,35,30,2115.74,3707.00,0.00
2024-12-08 17:12:04,66,3301,35,31,2083.68,3707.02,0.00
2024-12-08 17:12:04,65,3301,35,30,2102.06,3707.09,0.00
2024-12-08 17:12:04,65,3302,35,30,2114.60,3708.00,0.00
2024-12-08 17:12:04,66,3302,36,30,2082.56,3708.02,0.00
2024-12-08 17:12:04,65,3302,35,30,2080.01,3708.51,0.00
2024-12-08 17:12:04,65,3303,35,30,2119.16,3709.00,0.00
2024-12-08 17:12:04,66,3303,36,30,2087.05,3709.02,0.00
2024-12-08 17:12:04,65,3303,36,29,2106.05,3709.09,0.00
2024-12-08 17:12:04,65,3304,36,29,2118.59,3710.00,0.00
2024-12-08 17:12:04,66,3304,36,30,2086.49,3710.02,0.00
2024-12-08 17:12:04,65,3304,35,30,2118.59,3710.02,0.00
2024-12-08 17:12:04,64,3304,34,30,2151.12,3710.02,0.00
2024-12-08 17:12:04,64,3305,34,30,2149.96,3711.00,0.00
2024-12-08 17:12:04,65,3305,34,31,2116.88,3711.02,0.00
2024-12-08 17:12:04,64,3305,34,30,2138.37,3711.06,0.00
2024-12-08 17:12:04,64,3306,34,30,2150.54,3712.00,0.00
2024-12-08 17:12:04,65,3306,34,31,2117.45,3712.02,0.00
2024-12-08 17:12:04,66,3305,35,31,2041.75,3712.62,0.00
2024-12-08 17:12:04,66,3306,35,31,2120.25,3713.00,0.00
2024-12-08 17:12:04,67,3306,36,31,2088.60,3713.02,0.00
2024-12-08 17:12:04,66,3306,36,30,2109.00,3713.06,0.00
2024-12-08 17:12:04,65,3306,35,30,2129.51,3713.23,0.00
2024-12-08 17:12:04,65,3307,35,30,2215.73,3714.00,0.00
2024-12-08 17:12:04,66,3307,36,30,2182.15,3714.02,0.00
2024-12-08 17:12:04,65,3307,35,30,2194.63,3714.19,0.00
2024-12-08 17:12:04,65,3308,35,30,2222.04,3715.00,0.00
2024-12-08 17:12:04,66,3308,36,30,2188.37,3715.02,0.00
2024-12-08 17:12:04,65,3308,36,29,2211.19,3715.06,0.00
2024-12-08 17:12:05,64,3308,35,29,2222.83,3715.67,0.00
2024-12-08 17:12:05,64,3309,35,29,2257.37,3716.00,0.00
2024-12-08 17:12:05,65,3309,35,30,2222.64,3716.02,0.00
2024-12-08 17:12:05,65,3310,35,30,2220.95,3717.00,0.00
2024-12-08 17:12:05,66,3310,36,30,2187.30,3717.02,0.00
2024-12-08 17:12:05,65,3310,36,29,2210.09,3717.06,0.00
2024-12-08 17:12:05,64,3310,35,29,2241.74,3717.13,0.00
2024-12-08 17:12:05,63,3310,34,29,2257.95,3717.35,0.00
2024-12-08 17:12:05,63,3311,34,29,2293.25,3718.00,0.00
2024-12-08 17:12:05,64,3311,35,29,2257.42,3718.02,0.00
2024-12-08 17:12:05,64,3312,35,29,2256.28,3719.00,0.00
2024-12-08 17:12:05,65,3312,36,29,2221.57,3719.02,0.00
2024-12-08 17:12:05,64,3312,36,28,2245.83,3719.06,0.00
2024-12-08 17:12:05,63,3312,35,28,2276.78,3719.14,0.00
2024-12-08 17:12:05,63,3313,35,28,2304.52,3720.00,0.00
2024-12-08 17:12:05,64,3313,36,28,2268.51,3720.02,0.00
2024-12-08 17:12:05,63,3313,35,28,2302.76,3720.05,0.00
2024-12-08 17:12:05,63,3314,35,28,2303.37,3721.00,0.00
2024-12-08 17:12:05,64,3314,35,29,2267.38,3721.02,0.00
2024-12-08 17:12:05,63,3314,35,28,2293.92,3721.05,0.00
2024-12-08 17:12:05,63,3315,35,28,2306.35,3722.00,0.00
2024-12-08 17:12:05,64,3315,36,28,2270.32,3722.02,0.00
2024-12-08 17:12:05,63,3315,35,28,2269.27,3722.37,0.00
2024-12-08 17:12:05,63,3316,35,28,2305.20,3723.00,0.00
2024-12-08 17:12:05,64,3316,35,29,2269.18,3723.02,0.00
2024-12-08 17:12:05,63,3316,35,28,2296.34,3723.05,0.00
2024-12-08 17:12:05,62,3316,34,28,2324.42,3723.18,0.00
2024-12-08 17:12:05,62,3317,34,28,2354.42,3724.00,0.00
2024-12-08 17:12:05,63,3317,34,29,2317.05,3724.02,0.00
2024-12-08 17:12:05,63,3318,34,29,2316.49,3725.00,0.00
2024-12-08 17:12:05,64,3318,35,29,2280.29,3725.02,0.00
2024-12-08 17:12:05,63,3318,35,28,2308.21,3725.05,0.00
2024-12-08 17:12:05,63,3319,35,28,2320.66,3726.00,0.00
2024-12-08 17:12:05,64,3319,35,29,2284.40,3726.02,0.00
2024-12-08 17:12:05,64,3320,35,29,2283.26,3727.00,0.00
2024-12-08 17:12:05,65,3320,35,30,2248.14,3727.02,0.00
2024-12-08 17:12:05,64,3320,35,29,2273.37,3727.06,0.00
2024-12-08 17:12:05,64,3321,35,29,2285.62,3728.00,0.00
2024-12-08 17:12:05,65,3321,36,29,2250.46,3728.02,0.00
2024-12-08 17:12:05,65,3322,36,29,2248.77,3729.00,0.00
2024-12-08 17:12:05,66,3322,36,30,2214.70,3729.02,0.00
2024-12-08 17:12:05,65,3322,36,29,2238.45,3729.06,0.00
2024-12-08 17:12:05,64,3322,35,29,2239.38,3729.67,0.00
2024-12-08 17:12:05,64,3323,35,29,2285.69,3730.00,0.00
2024-12-08 17:12:05,65,3323,36,29,2250.52,3730.02,0.00
2024-12-08 17:12:05,65,3324,36,29,2248.83,3731.00,0.00
2024-12-08 17:12:05,66,3324,37,29,2214.76,3731.02,0.00
2024-12-08 17:12:05,65,3324,37,28,2239.07,3731.06,0.00
2024-12-08 17:12:05,66,3323,38,28,2184.53,3731.65,0.00
2024-12-08 17:12:05,66,3324,38,28,2230.05,3732.00,0.00
2024-12-08 17:12:05,67,3324,38,29,2196.77,3732.02,0.00
2024-12-08 17:12:05,67,3325,38,29,2249.73,3733.00,0.00
2024-12-08 17:12:05,68,3325,39,29,2216.64,3733.02,0.00
2024-12-08 17:12:05,67,3325,39,28,2240.92,3733.06,0.00
2024-12-08 17:12:06,67,3326,39,28,2250.99,3734.00,0.00
2024-12-08 17:12:06,68,3326,40,28,2217.89,3734.02,0.00
2024-12-08 17:12:06,68,3327,40,28,2214.63,3735.00,0.00
2024-12-08 17:12:06,69,3327,40,29,2182.54,3735.01,0.00
2024-12-08 17:12:06,68,3327,39,29,2214.09,3735.02,0.00
2024-12-08 17:12:06,67,3327,39,28,2238.77,3735.05,0.00
2024-12-08 17:12:06,67,3328,39,28,2248.29,3736.00,0.00
2024-12-08 17:12:06,68,3328,40,28,2215.23,3736.02,0.00
2024-12-08 17:12:06,67,3328,39,28,2247.73,3736.02,0.00
2024-12-08 17:12:06,67,3329,39,28,2244.99,3737.00,0.00
2024-12-08 17:12:06,68,3329,40,28,2211.97,3737.02,0.00
2024-12-08 17:12:06,67,3329,40,27,2234.96,3737.06,0.00
2024-12-08 17:12:06,67,3330,40,27,2245.03,3738.00,0.00
2024-12-08 17:12:06,68,3330,40,28,2212.02,3738.02,0.00
2024-12-08 17:12:06,68,3331,40,28,2208.76,3739.00,0.00
2024-12-08 17:12:06,69,3331,40,29,2176.75,3739.01,0.00
2024-12-08 17:12:06,68,3331,39,29,2208.76,3739.02,0.00
2024-12-08 17:12:06,67,3331,39,28,2232.81,3739.05,0.00
2024-12-08 17:12:06,67,3332,39,28,2242.32,3740.00,0.00
2024-12-08 17:12:06,68,3332,39,29,2209.35,3740.02,0.00
2024-12-08 17:12:06,68,3332,39,29,2206.09,3741.00,0.00
2024-12-08 17:12:06,69,3332,40,29,2174.12,3741.01,0.00
2024-12-08 17:12:06,68,3332,40,28,2197.85,3741.04,0.00
2024-12-08 17:12:06,68,3333,40,28,2206.68,3742.00,0.00
2024-12-08 17:12:06,69,3333,41,28,2174.70,3742.01,0.00
2024-12-08 17:12:06,69,3334,41,28,2170.94,3743.00,0.00
2024-12-08 17:12:06,70,3334,41,29,2139.93,3743.01,0.00
2024-12-08 17:12:06,69,3334,41,28,2163.35,3743.04,0.00
2024-12-08 17:12:06,69,3335,41,28,2171.19,3744.00,0.00
2024-12-08 17:12:06,70,3335,42,28,2140.17,3744.01,0.00
2024-12-08 17:12:06,69,3335,41,28,2162.52,3744.04,0.00
2024-12-08 17:12:06,68,3335,40,28,2181.12,3744.10,0.00
2024-12-08 17:12:06,68,3336,40,28,2202.00,3745.00,0.00
2024-12-08 17:12:06,69,3336,41,28,2170.09,3745.01,0.00
2024-12-08 17:12:06,68,3336,41,27,2193.20,3745.04,0.00
2024-12-08 17:12:06,68,3337,41,27,2200.58,3746.00,0.00
2024-12-08 17:12:06,69,3337,41,28,2168.68,3746.01,0.00
2024-12-08 17:12:06,69,3338,41,28,2162.87,3747.00,0.00
2024-12-08 17:12:06,70,3338,41,29,2131.98,3747.01,0.00
2024-12-08 17:12:06,69,3338,41,28,2154.73,3747.04,0.00
2024-12-08 17:12:06,68,3338,40,28,2155.07,3747.78,0.00
2024-12-08 17:12:06,68,3339,40,28,2202.10,3748.00,0.00
2024-12-08 17:12:06,69,3339,41,28,2170.18,3748.01,0.00
2024-12-08 17:12:06,69,3339,41,28,2166.32,3749.00,0.00
2024-12-08 17:12:06,70,3339,41,29,2135.37,3749.01,0.00
2024-12-08 17:12:06,69,3339,41,28,2157.63,3749.06,0.00
2024-12-08 17:12:06,69,3340,41,28,2166.35,3750.00,0.00
2024-12-08 17:12:06,70,3340,42,28,2135.40,3750.01,0.00
2024-12-08 17:12:06,70,3341,42,28,2131.15,3751.00,0.00
2024-12-08 17:12:06,71,3341,43,28,2101.13,3751.01,0.00
2024-12-08 17:12:06,70,3341,43,27,2122.05,3751.06,0.00
2024-12-08 17:12:06,70,3342,43,27,2130.11,3752.00,0.00
2024-12-08 17:12:06,71,3342,43,28,2100.11,3752.01,0.00
2024-12-08 17:12:06,71,3343,43,28,2095.38,3753.00,0.00
2024-12-08 17:12:06,72,3343,44,28,2066.28,3753.01,0.00
2024-12-08 17:12:06,71,3343,44,27,2086.93,3753.06,0.00
2024-12-08 17:12:06,70,3343,43,27,2106.04,3753.10,0.00
2024-12-08 17:12:06,70,3344,43,27,2126.42,3754.00,0.00
2024-12-08 17:12:06,71,3344,43,28,2096.47,3754.01,0.00
2024-12-08 17:12:07,71,3345,43,28,2091.74,3755.00,0.00
2024-12-08 17:12:07,72,3345,43,29,2062.69,3755.01,0.00
2024-12-08 17:12:07,72,3346,43,29,2057.50,3756.00,0.00
2024-12-08 17:12:07,73,3346,43,30,2029.31,3756.01,0.00
2024-12-08 17:12:07,72,3346,43,29,2046.56,3756.10,0.00
2024-12-08 17:12:07,72,3347,43,29,2054.91,3757.00,0.00
2024-12-08 17:12:07,73,3347,44,29,2026.76,3757.01,0.00
2024-12-08 17:12:07,72,3347,43,29,2049.73,3757.15,0.00
2024-12-08 17:12:07,72,3348,43,29,2049.72,3758.00,0.00
2024-12-08 17:12:07,73,3348,44,29,2021.64,3758.01,0.00
2024-12-08 17:12:07,73,3349,44,29,2015.85,3759.00,0.00
2024-12-08 17:12:07,74,3349,44,30,1988.61,3759.01,0.00
2024-12-08 17:12:07,75,3348,45,30,1961.60,3759.05,0.00
2024-12-08 17:12:07,74,3348,45,29,2027.27,3759.19,0.00
2024-12-08 17:12:07,74,3349,45,29,2037.21,3760.00,0.00
2024-12-08 17:12:07,75,3349,45,30,2010.05,3760.01,0.00
2024-12-08 17:12:07,75,3350,45,30,2053.47,3761.00,0.00
2024-12-08 17:12:07,76,3350,45,31,2026.45,3761.01,0.00
2024-12-08 17:12:07,75,3350,45,30,2036.46,3761.19,0.00
2024-12-08 17:12:07,74,3350,44,30,2061.45,3761.22,0.00
2024-12-08 17:12:07,74,3351,44,30,2083.29,3762.00,0.00
2024-12-08 17:12:07,75,3351,45,30,2055.52,3762.01,0.00
2024-12-08 17:12:07,75,3352,45,30,2049.04,3763.00,0.00
2024-12-08 17:12:07,76,3352,45,31,2022.08,3763.01,0.00
2024-12-08 17:12:07,75,3352,45,30,2032.03,3763.20,0.00
2024-12-08 17:12:07,74,3352,44,30,2031.27,3763.70,0.00
2024-12-08 17:12:07,74,3353,44,30,2071.18,3764.00,0.00
2024-12-08 17:12:07,75,3353,45,30,2043.56,3764.01,0.00
2024-12-08 17:12:07,75,3354,45,30,2037.08,3765.00,0.00
2024-12-08 17:12:07,76,3354,45,31,2010.27,3765.01,0.00
2024-12-08 17:12:07,75,3354,45,30,2020.05,3765.20,0.00
2024-12-08 17:12:07,75,3355,45,30,2030.59,3766.00,0.00
2024-12-08 17:12:07,76,3355,46,30,2003.87,3766.01,0.00
2024-12-08 17:12:07,75,3355,46,29,2028.59,3766.05,0.00
2024-12-08 17:12:07,74,3355,45,29,2049.93,3766.20,0.00
2024-12-08 17:12:07,74,3356,45,29,2050.94,3767.00,0.00
2024-12-08 17:12:07,75,3356,45,30,2023.59,3767.01,0.00
2024-12-08 17:12:07,75,3357,45,30,2017.10,3768.00,0.00
2024-12-08 17:12:07,76,3357,45,31,1990.55,3768.01,0.00
2024-12-08 17:12:07,75,3357,44,31,2016.59,3768.01,0.00
2024-12-08 17:12:07,74,3357,43,31,2007.87,3768.58,0.00
2024-12-08 17:12:07,74,3358,43,31,2043.34,3769.00,0.00
2024-12-08 17:12:07,75,3358,44,31,2016.09,3769.01,0.00
2024-12-08 17:12:07,74,3358,44,30,2035.23,3769.19,0.00
2024-12-08 17:12:07,74,3359,44,30,2045.91,3770.00,0.00
2024-12-08 17:12:07,75,3359,44,31,2018.64,3770.01,0.00
2024-12-08 17:12:07,74,3359,43,31,2019.51,3770.32,0.00
2024-12-08 17:12:07,74,3360,43,31,2045.44,3771.00,0.00
2024-12-08 17:12:07,75,3360,44,31,2018.17,3771.01,0.00
2024-12-08 17:12:07,74,3360,44,30,2028.16,3771.20,0.00
2024-12-08 17:12:07,74,3361,44,30,2038.85,3772.00,0.00
2024-12-08 17:12:07,75,3361,45,30,2011.67,3772.01,0.00
2024-12-08 17:12:07,74,3361,44,30,2036.83,3772.07,0.00
2024-12-08 17:12:07,75,3360,45,30,1994.11,3772.24,0.00
2024-12-08 17:12:07,75,3361,45,30,2034.53,3773.00,0.00
2024-12-08 17:12:07,76,3361,46,30,2007.76,3773.01,0.00
2024-12-08 17:12:07,75,3361,45,30,2032.53,3773.07,0.00
2024-12-08 17:12:07,74,3361,45,29,2046.25,3773.18,0.00
2024-12-08 17:12:07,74,3362,45,29,2105.02,3774.00,0.00
2024-12-08 17:12:07,75,3362,45,30,2076.95,3774.01,0.00
2024-12-08 17:12:08,75,3363,45,30,2066.65,3775.00,0.00
2024-12-08 17:12:08,76,3363,45,31,2039.45,3775.01,0.00
2024-12-08 17:12:08,75,3363,44,31,2064.15,3775.08,0.00
2024-12-08 17:12:08,74,3363,44,30,2079.82,3775.16,0.00
2024-12-08 17:12:08,73,3363,43,30,2106.97,3775.19,0.00
2024-12-08 17:12:08,73,3364,43,30,2124.27,3776.00,0.00
2024-12-08 17:12:08,74,3364,44,30,2095.56,3776.01,0.00
2024-12-08 17:12:08,74,3365,44,30,2085.13,3777.00,0.00
2024-12-08 17:12:08,75,3365,45,30,2057.33,3777.01,0.00
2024-12-08 17:12:08,74,3365,44,30,2082.09,3777.08,0.00
2024-12-08 17:12:08,73,3365,44,29,2096.16,3777.19,0.00
2024-12-08 17:12:08,72,3365,43,29,2124.75,3777.19,0.00
2024-12-08 17:12:08,72,3366,43,29,2132.64,3778.00,0.00
2024-12-08 17:12:08,73,3366,44,29,2103.43,3778.01,0.00
2024-12-08 17:12:08,73,3367,44,29,2094.74,3779.00,0.00
2024-12-08 17:12:08,74,3367,44,30,2066.43,3779.01,0.00
2024-12-08 17:12:08,73,3367,43,30,2086.51,3779.21,0.00
2024-12-08 17:12:08,73,3368,43,30,2096.43,3780.00,0.00
2024-12-08 17:12:08,74,3368,43,31,2068.10,3780.01,0.00
2024-12-08 17:12:08,73,3368,42,31,2095.40,3780.03,0.00
2024-12-08 17:12:08,72,3368,42,30,2117.20,3780.19,0.00
2024-12-08 17:12:08,72,3369,42,30,2127.72,3781.00,0.00
2024-12-08 17:12:08,73,3369,42,31,2098.57,3781.01,0.00
2024-12-08 17:12:08,72,3369,41,31,2126.16,3781.04,0.00
2024-12-08 17:12:08,72,3370,41,31,2120.56,3782.00,0.00
2024-12-08 17:12:08,73,3370,42,31,2091.52,3782.01,0.00
2024-12-08 17:12:08,72,3370,41,31,2085.31,3782.64,0.00
2024-12-08 17:12:08,72,3371,41,31,2113.52,3783.00,0.00
2024-12-08 17:12:08,73,3371,41,32,2084.56,3783.01,0.00
2024-12-08 17:12:08,72,3371,40,32,2107.26,3783.18,0.00
2024-12-08 17:12:08,71,3371,40,31,2136.41,3783.18,0.00
2024-12-08 17:12:08,71,3372,40,31,2148.40,3784.00,0.00
2024-12-08 17:12:08,72,3372,41,31,2118.56,3784.01,0.00
2024-12-08 17:12:08,72,3373,41,31,2113.33,3785.00,0.00
2024-12-08 17:12:08,73,3373,41,32,2084.38,3785.01,0.00
2024-12-08 17:12:08,72,3373,41,31,2096.56,3785.18,0.00
2024-12-08 17:12:08,72,3374,41,31,2108.11,3786.00,0.00
2024-12-08 17:12:08,73,3374,41,32,2079.23,3786.01,0.00
2024-12-08 17:12:08,72,3374,40,32,2091.33,3786.18,0.00
2024-12-08 17:12:08,72,3375,40,32,2102.88,3787.00,0.00
2024-12-08 17:12:08,73,3375,41,32,2074.07,3787.01,0.00
2024-12-08 17:12:08,72,3375,40,32,2099.78,3787.08,0.00
2024-12-08 17:12:08,71,3375,39,32,2122.45,3787.14,0.00
2024-12-08 17:12:08,70,3375,39,31,2141.41,3787.16,0.00
2024-12-08 17:12:08,70,3376,39,31,2164.12,3788.00,0.00
2024-12-08 17:12:08,71,3376,39,32,2133.64,3788.01,0.00
2024-12-08 17:12:08,71,3377,39,32,2128.79,3789.00,0.00
2024-12-08 17:12:08,72,3377,40,32,2099.22,3789.01,0.00
2024-12-08 17:12:08,71,3377,40,31,2113.35,3789.16,0.00
2024-12-08 17:12:08,71,3378,40,31,2123.73,3790.00,0.00
2024-12-08 17:12:08,72,3378,41,31,2094.24,3790.01,0.00
2024-12-08 17:12:08,72,3379,41,31,2088.80,3791.00,0.00
2024-12-08 17:12:08,73,3379,42,31,2060.19,3791.01,0.00
2024-12-08 17:12:08,72,3379,42,30,2073.05,3791.17,0.00
2024-12-08 17:12:08,72,3380,42,30,2083.87,3792.00,0.00
2024-12-08 17:12:08,73,3380,42,31,2055.32,3792.01,0.00
2024-12-08 17:12:08,72,3380,41,31,2036.59,3792.71,0.00
2024-12-08 17:12:08,72,3381,41,31,2078.43,3793.00,0.00
2024-12-08 17:12:08,73,3381,42,31,2049.96,3793.01,0.00
2024-12-08 17:12:08,72,3381,41,31,2076.86,3793.04,0.00
2024-12-08 17:12:08,71,3381,41,30,2090.15,3793.18,0.00
2024-12-08 17:12:08,70,3381,40,30,2119.97,3793.19,0.00
2024-12-08 17:12:09,70,3382,40,30,2143.79,3794.00,0.00
2024-12-08 17:12:09,71,3382,41,30,2113.60,3794.01,0.00
2024-12-08 17:12:09,71,3383,41,30,2108.53,3795.00,0.00
2024-12-08 17:12:09,72,3383,41,31,2079.25,3795.01,0.00
2024-12-08 17:12:09,71,3383,41,30,2090.40,3795.20,0.00
2024-12-08 17:12:09,71,3384,41,30,2103.15,3796.00,0.00
2024-12-08 17:12:09,72,3384,42,30,2073.94,3796.01,0.00
2024-12-08 17:12:09,71,3384,41,30,2095.17,3796.20,0.00
2024-12-08 17:12:09,71,3385,41,30,2107.05,3797.00,0.00
2024-12-08 17:12:09,72,3385,42,30,2077.79,3797.01,0.00
2024-12-08 17:12:09,72,3386,42,30,2072.53,3798.00,0.00
2024-12-08 17:12:09,73,3386,43,30,2044.14,3798.01,0.00
2024-12-08 17:12:09,72,3386,42,30,2070.96,3798.04,0.00
2024-12-08 17:12:09,71,3386,42,29,2094.27,3798.18,0.00
2024-12-08 17:12:09,71,3387,42,29,2106.56,3799.00,0.00
2024-12-08 17:12:09,72,3387,43,29,2077.30,3799.01,0.00
2024-12-08 17:12:09,72,3388,43,29,2072.04,3800.00,0.00
2024-12-08 17:12:09,73,3388,44,29,2043.66,3800.01,0.00
2024-12-08 17:12:09,72,3388,43,29,2070.47,3800.04,0.00
2024-12-08 17:12:09,71,3388,43,28,2084.13,3800.17,0.00
2024-12-08 17:12:09,71,3389,43,28,2095.89,3801.00,0.00
2024-12-08 17:12:09,72,3389,44,28,2066.78,3801.01,0.00
2024-12-08 17:12:09,72,3390,44,28,2061.51,3802.00,0.00
2024-12-08 17:12:09,73,3390,45,28,2033.27,3802.01,0.00
2024-12-08 17:12:09,72,3390,45,27,2045.70,3802.17,0.00
2024-12-08 17:12:09,72,3391,45,27,2056.77,3803.00,0.00
2024-12-08 17:12:09,73,3391,46,27,2028.60,3803.01,0.00
2024-12-08 17:12:09,73,3392,46,27,2022.88,3804.00,0.00
2024-12-08 17:12:09,74,3392,47,27,1995.54,3804.01,0.00
2024-12-08 17:12:09,73,3392,47,26,2006.23,3804.18,0.00
2024-12-08 17:12:09,73,3393,47,26,2017.16,3805.00,0.00
2024-12-08 17:12:09,74,3393,48,26,1989.90,3805.01,0.00
2024-12-08 17:12:09,73,3393,47,26,2015.60,3805.04,0.00
2024-12-08 17:12:09,73,3394,47,26,2010.91,3806.00,0.00
2024-12-08 17:12:09,74,3394,48,26,1983.73,3806.01,0.00
2024-12-08 17:12:09,73,3394,48,25,1993.21,3806.19,0.00
2024-12-08 17:12:09,73,3395,48,25,2004.66,3807.00,0.00
2024-12-08 17:12:09,74,3395,48,26,1977.57,3807.01,0.00
2024-12-08 17:12:09,74,3396,48,26,1970.84,3808.00,0.00
2024-12-08 17:12:09,75,3396,48,27,1944.56,3808.01,0.00
2024-12-08 17:12:09,74,3396,48,26,1953.88,3808.19,0.00
2024-12-08 17:12:09,74,3397,48,26,1964.39,3809.00,0.00
2024-12-08 17:12:09,75,3397,49,26,1938.20,3809.01,0.00
2024-12-08 17:12:09,74,3397,48,26,1962.85,3809.04,0.00
2024-12-08 17:12:09,73,3397,47,26,1987.47,3809.08,0.00
2024-12-08 17:12:09,72,3397,46,26,2001.33,3809.17,0.00
2024-12-08 17:12:09,72,3398,46,26,2012.35,3810.00,0.00
2024-12-08 17:12:09,73,3398,46,27,1984.78,3810.01,0.00
2024-12-08 17:12:09,72,3398,46,26,1993.86,3810.17,0.00
2024-12-08 17:12:09,72,3399,46,26,2004.00,3811.00,0.00
2024-12-08 17:12:09,73,3399,47,26,1976.55,3811.01,0.00
2024-12-08 17:12:09,72,3399,46,26,1998.86,3811.08,0.00
2024-12-08 17:12:09,71,3399,45,26,2026.48,3811.08,0.00
2024-12-08 17:12:09,71,3400,45,26,2022.43,3812.00,0.00
2024-12-08 17:12:09,72,3400,45,27,1994.34,3812.01,0.00
2024-12-08 17:12:09,71,3400,44,27,2021.37,3812.03,0.00
2024-12-08 17:12:10,71,3401,44,27,2012.52,3813.00,0.00
2024-12-08 17:12:10,72,3401,45,27,1984.57,3813.01,0.00
2024-12-08 17:12:10,71,3401,44,27,2008.73,3813.04,0.00
2024-12-08 17:12:10,70,3401,44,26,2029.29,3813.20,0.00
2024-12-08 17:12:10,70,3402,44,26,2040.84,3814.00,0.00
2024-12-08 17:12:10,71,3402,45,26,2012.10,3814.01,0.00
2024-12-08 17:12:10,71,3403,45,26,2002.79,3815.00,0.00
2024-12-08 17:12:10,72,3403,45,27,1974.97,3815.01,0.00
2024-12-08 17:12:10,71,3403,44,27,1998.77,3815.06,0.00
2024-12-08 17:12:10,71,3404,44,27,1993.87,3816.00,0.00
2024-12-08 17:12:10,72,3404,44,28,1966.18,3816.01,0.00
2024-12-08 17:12:10,71,3404,43,28,1962.97,3816.31,0.00
2024-12-08 17:12:10,71,3405,43,28,1989.44,3817.00,0.00
2024-12-08 17:12:10,72,3405,43,29,1961.81,3817.01,0.00
2024-12-08 17:12:10,72,3406,43,29,1950.78,3818.00,0.00
2024-12-08 17:12:10,73,3406,44,29,1924.05,3818.01,0.00
2024-12-08 17:12:10,72,3406,44,28,1936.71,3818.22,0.00
2024-12-08 17:12:10,72,3407,44,28,1947.19,3819.00,0.00
2024-12-08 17:12:10,73,3407,44,29,1920.52,3819.01,0.00
2024-12-08 17:12:10,72,3407,43,29,1945.73,3819.03,0.00
2024-12-08 17:12:10,71,3407,42,29,1972.60,3819.03,0.00
2024-12-08 17:12:10,70,3407,42,28,1994.80,3819.17,0.00
2024-12-08 17:12:10,69,3407,41,28,2006.14,3819.33,0.00
2024-12-08 17:12:10,69,3408,41,28,2025.39,3820.00,0.00
2024-12-08 17:12:10,70,3408,41,29,1996.46,3820.01,0.00
2024-12-08 17:12:10,69,3408,40,29,1971.59,3820.93,0.00
2024-12-08 17:12:10,69,3409,40,29,2024.26,3821.00,0.00
2024-12-08 17:12:10,70,3409,40,30,1995.34,3821.01,0.00
2024-12-08 17:12:10,69,3409,40,29,2016.38,3821.19,0.00
2024-12-08 17:12:10,69,3410,40,29,2030.16,3822.00,0.00
2024-12-08 17:12:10,70,3410,41,29,2001.16,3822.01,0.00
2024-12-08 17:12:10,70,3411,41,29,1995.11,3823.00,0.00
2024-12-08 17:12:10,71,3411,42,29,1967.01,3823.01,0.00
2024-12-08 17:12:10,70,3411,41,29,1994.57,3823.03,0.00
2024-12-08 17:12:10,69,3411,41,28,2003.57,3823.19,0.00
2024-12-08 17:12:10,69,3412,41,28,2017.36,3824.00,0.00
2024-12-08 17:12:10,70,3412,42,28,1988.54,3824.01,0.00
2024-12-08 17:12:10,70,3413,42,28,1981.85,3825.00,0.00
2024-12-08 17:12:10,71,3413,43,28,1953.94,3825.01,0.00
2024-12-08 17:12:10,70,3413,42,28,1981.31,3825.03,0.00
2024-12-08 17:12:10,69,3413,42,27,1990.31,3825.19,0.00
2024-12-08 17:12:10,69,3414,42,27,2004.11,3826.00,0.00
2024-12-08 17:12:10,70,3414,42,28,1975.48,3826.01,0.00
2024-12-08 17:12:10,70,3415,42,28,1969.47,3827.00,0.00
2024-12-08 17:12:10,71,3415,42,29,1941.73,3827.01,0.00
2024-12-08 17:12:10,70,3415,42,28,1950.57,3827.19,0.00
2024-12-08 17:12:10,70,3416,42,28,1963.63,3828.00,0.00
2024-12-08 17:12:10,71,3416,42,29,1935.97,3828.01,0.00
2024-12-08 17:12:10,71,3417,42,29,1930.89,3829.00,0.00
2024-12-08 17:12:10,72,3417,43,29,1904.07,3829.01,0.00
2024-12-08 17:12:10,71,3417,43,28,1913.66,3829.18,0.00
2024-12-08 17:12:10,70,3417,42,28,1940.45,3829.19,0.00
2024-12-08 17:12:10,70,3418,42,28,1953.52,3830.00,0.00
2024-12-08 17:12:10,71,3418,43,28,1926.00,3830.01,0.00
2024-12-08 17:12:10,70,3418,42,28,1951.88,3830.04,0.00
2024-12-08 17:12:11,70,3419,42,28,1948.39,3831.00,0.00
2024-12-08 17:12:11,71,3419,43,28,1920.95,3831.01,0.00
2024-12-08 17:12:11,72,3418,43,29,1890.56,3831.14,0.00
2024-12-08 17:12:11,71,3418,43,28,1943.36,3831.18,0.00
2024-12-08 17:12:11,71,3419,43,28,1955.70,3832.00,0.00
2024-12-08 17:12:11,72,3419,44,28,1928.54,3832.01,0.00
2024-12-08 17:12:11,71,3419,43,28,1954.63,3832.04,0.00
2024-12-08 17:12:11,70,3419,42,28,1949.65,3832.37,0.00
2024-12-08 17:12:11,70,3420,42,28,2035.01,3833.00,0.00
2024-12-08 17:12:11,71,3420,42,29,2006.35,3833.01,0.00
2024-12-08 17:12:11,70,3420,42,28,2031.91,3833.09,0.00
2024-12-08 17:12:11,69,3420,41,28,2057.04,3833.16,0.00
2024-12-08 17:12:11,69,3421,41,28,2058.37,3834.00,0.00
2024-12-08 17:12:11,70,3421,41,29,2028.96,3834.01,0.00
2024-12-08 17:12:11,69,3421,40,29,2056.71,3834.06,0.00
2024-12-08 17:12:11,68,3421,40,28,2081.74,3834.15,0.00
2024-12-08 17:12:11,68,3422,40,28,2094.56,3835.00,0.00
2024-12-08 17:12:11,69,3422,40,29,2064.21,3835.01,0.00
2024-12-08 17:12:11,68,3422,40,28,2083.29,3835.04,0.00
2024-12-08 17:12:11,68,3423,40,28,2090.82,3836.00,0.00
2024-12-08 17:12:11,69,3423,40,29,2060.52,3836.01,0.00
2024-12-08 17:12:11,68,3423,40,28,2078.98,3836.04,0.00
2024-12-08 17:12:11,68,3424,40,28,2086.35,3837.00,0.00
2024-12-08 17:12:11,69,3424,40,29,2056.11,3837.01,0.00
2024-12-08 17:12:11,69,3425,40,29,2050.43,3838.00,0.00
2024-12-08 17:12:11,70,3425,41,29,2021.14,3838.01,0.00
2024-12-08 17:12:11,69,3425,41,28,2034.61,3838.12,0.00
2024-12-08 17:12:11,69,3426,41,28,2045.69,3839.00,0.00
2024-12-08 17:12:11,70,3426,41,29,2016.47,3839.01,0.00
2024-12-08 17:12:11,69,3426,40,29,2038.62,3839.15,0.00
2024-12-08 17:12:11,69,3427,40,29,2050.81,3840.00,0.00
2024-12-08 17:12:11,70,3427,40,30,2021.51,3840.01,0.00
2024-12-08 17:12:11,69,3427,40,29,2032.47,3840.15,0.00
2024-12-08 17:12:11,69,3428,40,29,2044.66,3841.00,0.00
2024-12-08 17:12:11,70,3428,40,30,2015.45,3841.01,0.00
2024-12-08 17:12:11,71,3427,40,31,1983.07,3841.08,0.00
2024-12-08 17:12:11,71,3428,40,31,2024.70,3842.00,0.00
2024-12-08 17:12:11,72,3428,41,31,1996.58,3842.01,0.00
2024-12-08 17:12:11,71,3428,40,31,2019.19,3842.07,0.00
2024-12-08 17:12:11,70,3428,40,30,2035.42,3842.13,0.00
2024-12-08 17:12:11,69,3428,39,30,2054.43,3842.41,0.00
2024-12-08 17:12:11,69,3429,39,30,2132.26,3843.00,0.00
2024-12-08 17:12:11,70,3429,39,31,2101.79,3843.01,0.00
2024-12-08 17:12:11,69,3429,38,31,2113.30,3843.15,0.00
2024-12-08 17:12:11,69,3430,38,31,2125.51,3844.00,0.00
2024-12-08 17:12:11,70,3430,39,31,2095.15,3844.01,0.00
2024-12-08 17:12:11,69,3430,39,30,2109.56,3844.13,0.00
2024-12-08 17:12:11,69,3431,39,30,2121.14,3845.00,0.00
2024-12-08 17:12:11,70,3431,40,30,2090.83,3845.01,0.00
2024-12-08 17:12:11,69,3431,39,30,2120.02,3845.03,0.00
2024-12-08 17:12:11,68,3431,38,30,2150.09,3845.06,0.00
2024-12-08 17:12:11,68,3432,38,30,2148.36,3846.00,0.00
2024-12-08 17:12:11,69,3432,39,30,2117.23,3846.01,0.00
2024-12-08 17:12:11,68,3432,39,29,2134.82,3846.10,0.00
2024-12-08 17:12:11,68,3433,39,29,2146.09,3847.00,0.00
2024-12-08 17:12:11,69,3433,39,30,2114.99,3847.01,0.00
2024-12-08 17:12:11,69,3434,39,30,2110.90,3848.00,0.00
2024-12-08 17:12:11,70,3434,40,30,2080.74,3848.01,0.00
2024-12-08 17:12:11,71,3433,40,31,2049.83,3848.08,0.00
2024-12-08 17:12:11,70,3433,40,30,2119.81,3848.13,0.00
2024-12-08 17:12:11,70,3434,40,30,2130.77,3849.00,0.00
2024-12-08 17:12:11,71,3434,41,30,2100.76,3849.01,0.00
2024-12-08 17:12:11,70,3434,40,30,2114.32,3849.14,0.00
2024-12-08 17:12:11,69,3434,39,30,2120.16,3849.74,0.00
2024-12-08 17:12:12,69,3435,39,30,2221.91,3850.00,0.00
2024-12-08 17:12:12,70,3435,39,31,2190.17,3850.01,0.00
2024-12-08 17:12:12,69,3435,39,30,2208.34,3850.12,0.00
2024-12-08 17:12:12,69,3436,39,30,2219.47,3851.00,0.00
2024-12-08 17:12:12,70,3436,39,31,2187.77,3851.01,0.00
2024-12-08 17:12:12,70,3437,39,31,2181.15,3852.00,0.00
2024-12-08 17:12:12,71,3437,40,31,2150.43,3852.01,0.00
2024-12-08 17:12:12,70,3437,40,30,2163.75,3852.11,0.00
2024-12-08 17:12:12,70,3438,40,30,2174.18,3853.00,0.00
2024-12-08 17:12:12,71,3438,40,31,2143.56,3853.01,0.00
2024-12-08 17:12:12,70,3438,39,31,2141.95,3853.16,0.00
2024-12-08 17:12:12,70,3439,39,31,2165.04,3854.00,0.00
2024-12-08 17:12:12,71,3439,40,31,2134.54,3854.01,0.00
2024-12-08 17:12:12,70,3439,40,30,2145.28,3854.14,0.00
2024-12-08 17:12:12,69,3439,39,30,2157.64,3854.38,0.00
2024-12-08 17:12:12,70,3438,40,30,2108.42,3854.89,0.00
2024-12-08 17:12:12,70,3439,40,30,2163.04,3855.00,0.00
2024-12-08 17:12:12,71,3439,41,30,2132.57,3855.01,0.00
2024-12-08 17:12:12,70,3439,40,30,2161.63,3855.03,0.00
2024-12-08 17:12:12,69,3439,39,30,2189.09,3855.13,0.00
2024-12-08 17:12:12,69,3440,39,30,2245.50,3856.00,0.00
2024-12-08 17:12:12,70,3440,40,30,2213.42,3856.01,0.00
2024-12-08 17:12:12,69,3440,39,30,2243.29,3856.06,0.00
2024-12-08 17:12:12,68,3440,39,29,2262.68,3856.12,0.00
2024-12-08 17:12:12,68,3441,39,29,2274.58,3857.00,0.00
2024-12-08 17:12:12,69,3441,40,29,2241.61,3857.01,0.00
2024-12-08 17:12:12,68,3441,39,29,2270.64,3857.12,0.00
2024-12-08 17:12:12,68,3442,39,29,2271.19,3858.00,0.00
2024-12-08 17:12:12,69,3442,40,29,2238.28,3858.01,0.00
2024-12-08 17:12:12,69,3443,40,29,2234.39,3859.00,0.00
2024-12-08 17:12:12,70,3443,40,30,2202.47,3859.01,0.00
2024-12-08 17:12:12,69,3443,39,30,2233.83,3859.01,0.00
2024-12-08 17:12:12,68,3443,38,30,2256.52,3859.19,0.00
2024-12-08 17:12:12,67,3443,38,29,2283.88,3859.22,0.00
2024-12-08 17:12:12,67,3444,38,29,2312.05,3860.00,0.00
2024-12-08 17:12:12,68,3444,39,29,2278.05,3860.02,0.00
2024-12-08 17:12:12,67,3444,38,29,2306.53,3860.15,0.00
2024-12-08 17:12:12,67,3445,38,29,2308.80,3861.00,0.00
2024-12-08 17:12:12,68,3445,38,30,2274.85,3861.02,0.00
2024-12-08 17:12:12,68,3446,38,30,2270.53,3862.00,0.00
2024-12-08 17:12:12,69,3446,38,31,2237.62,3862.01,0.00
2024-12-08 17:12:12,68,3446,38,30,2259.24,3862.21,0.00
2024-12-08 17:12:12,68,3447,38,30,2270.54,3863.00,0.00
2024-12-08 17:12:12,69,3447,39,30,2237.64,3863.01,0.00
2024-12-08 17:12:12,68,3447,38,30,2259.24,3863.21,0.00
2024-12-08 17:12:12,67,3447,37,30,2275.73,3863.36,0.00
2024-12-08 17:12:12,67,3448,37,30,2307.57,3864.00,0.00
2024-12-08 17:12:12,68,3448,38,30,2273.63,3864.02,0.00
2024-12-08 17:12:12,68,3449,38,30,2270.24,3865.00,0.00
2024-12-08 17:12:12,69,3449,39,30,2237.34,3865.01,0.00
2024-12-08 17:12:12,68,3449,38,30,2268.56,3865.06,0.00
2024-12-08 17:12:12,67,3449,38,29,2293.80,3865.19,0.00
2024-12-08 17:12:12,67,3450,38,29,2309.34,3866.00,0.00
2024-12-08 17:12:12,68,3450,38,30,2275.38,3866.02,0.00
2024-12-08 17:12:12,67,3450,37,30,2292.08,3866.16,0.00
2024-12-08 17:12:12,67,3451,37,30,2303.49,3867.00,0.00
2024-12-08 17:12:12,68,3451,37,31,2269.62,3867.02,0.00
2024-12-08 17:12:12,67,3451,36,31,2288.53,3867.15,0.00
2024-12-08 17:12:12,67,3452,36,31,2302.01,3868.00,0.00
2024-12-08 17:12:12,68,3452,37,31,2268.15,3868.02,0.00
2024-12-08 17:12:12,67,3452,37,30,2293.74,3868.16,0.00
2024-12-08 17:12:12,67,3453,37,30,2307.43,3869.00,0.00
2024-12-08 17:12:12,68,3453,38,30,2273.50,3869.02,0.00
2024-12-08 17:12:13,68,3454,38,30,2269.69,3870.00,0.00
2024-12-08 17:12:13,69,3454,39,30,2236.80,3870.01,0.00
2024-12-08 17:12:13,69,3455,39,30,2232.89,3871.00,0.00
2024-12-08 17:12:13,70,3455,40,30,2200.99,3871.01,0.00
2024-12-08 17:12:13,69,3455,39,30,2231.23,3871.06,0.00
2024-12-08 17:12:13,68,3455,39,29,2257.23,3871.16,0.00
2024-12-08 17:12:13,68,3456,39,29,2270.87,3872.00,0.00
2024-12-08 17:12:13,69,3456,39,30,2237.96,3872.01,0.00
2024-12-08 17:12:13,69,3457,39,30,2234.04,3873.00,0.00
2024-12-08 17:12:13,70,3457,39,31,2202.13,3873.01,0.00
2024-12-08 17:12:13,69,3457,38,31,2228.47,3873.15,0.00
2024-12-08 17:12:13,69,3458,38,31,2229.57,3874.00,0.00
2024-12-08 17:12:13,70,3458,39,31,2197.72,3874.01,0.00
2024-12-08 17:12:13,69,3458,39,30,2222.87,3874.15,0.00
2024-12-08 17:12:13,69,3459,39,30,2235.20,3875.00,0.00
2024-12-08 17:12:13,70,3459,40,30,2203.27,3875.01,0.00
2024-12-08 17:12:13,69,3459,39,30,2180.67,3875.93,0.00
2024-12-08 17:12:13,69,3460,39,30,2234.09,3876.00,0.00
2024-12-08 17:12:13,70,3460,39,31,2202.17,3876.01,0.00
2024-12-08 17:12:13,70,3461,39,31,2197.76,3877.00,0.00
2024-12-08 17:12:13,71,3461,40,31,2166.80,3877.01,0.00
2024-12-08 17:12:13,70,3461,39,31,2196.11,3877.04,0.00
2024-12-08 17:12:13,69,3461,39,30,2224.02,3877.13,0.00
2024-12-08 17:12:13,69,3462,39,30,2235.80,3878.00,0.00
2024-12-08 17:12:13,70,3462,39,31,2203.86,3878.01,0.00
2024-12-08 17:12:13,70,3463,39,31,2199.44,3879.00,0.00
2024-12-08 17:12:13,71,3463,39,32,2168.47,3879.01,0.00
2024-12-08 17:12:13,70,3463,38,32,2195.04,3879.13,0.00
2024-12-08 17:12:13,69,3463,38,31,2215.05,3879.13,0.00
2024-12-08 17:12:13,69,3464,38,31,2226.84,3880.00,0.00
2024-12-08 17:12:13,70,3464,39,31,2195.02,3880.01,0.00
2024-12-08 17:12:13,69,3464,38,31,2224.05,3880.09,0.00
2024-12-08 17:12:13,69,3465,38,31,2234.16,3881.00,0.00
2024-12-08 17:12:13,70,3465,39,31,2202.24,3881.01,0.00
2024-12-08 17:12:13,69,3465,39,30,2219.00,3881.12,0.00
2024-12-08 17:12:13,69,3466,39,30,2230.23,3882.00,0.00
2024-12-08 17:12:13,70,3466,40,30,2198.37,3882.01,0.00
2024-12-08 17:12:13,70,3467,40,30,2193.95,3883.00,0.00
2024-12-08 17:12:13,71,3467,40,31,2163.05,3883.01,0.00
2024-12-08 17:12:13,70,3467,40,30,2179.55,3883.11,0.00
2024-12-08 17:12:13,69,3467,39,30,2210.58,3883.12,0.00
2024-12-08 17:12:13,69,3468,39,30,2221.81,3884.00,0.00
2024-12-08 17:12:13,70,3468,40,30,2190.07,3884.01,0.00
2024-12-08 17:12:13,70,3469,40,30,2185.64,3885.00,0.00
2024-12-08 17:12:13,71,3469,41,30,2154.86,3885.01,0.00
2024-12-08 17:12:13,70,3469,40,30,2180.68,3885.13,0.00
2024-12-08 17:12:13,69,3469,39,30,2168.10,3885.71,0.00
2024-12-08 17:12:13,69,3470,39,30,2213.38,3886.00,0.00
2024-12-08 17:12:13,70,3470,39,31,2181.76,3886.01,0.00
2024-12-08 17:12:13,69,3470,39,30,2208.34,3886.13,0.00
2024-12-08 17:12:13,69,3471,39,30,2220.15,3887.00,0.00
2024-12-08 17:12:13,70,3471,40,30,2188.43,3887.01,0.00
2024-12-08 17:12:13,70,3472,40,30,2184.00,3888.00,0.00
2024-12-08 17:12:13,71,3472,41,30,2153.24,3888.01,0.00
2024-12-08 17:12:13,70,3472,41,29,2168.47,3888.13,0.00
2024-12-08 17:12:14,70,3473,41,29,2179.56,3889.00,0.00
2024-12-08 17:12:14,71,3473,41,30,2148.86,3889.01,0.00
2024-12-08 17:12:14,71,3474,41,30,2143.93,3890.00,0.00
2024-12-08 17:12:14,72,3474,41,31,2114.16,3890.01,0.00
2024-12-08 17:12:14,71,3474,41,30,2129.16,3890.13,0.00
2024-12-08 17:12:14,71,3475,41,30,2139.55,3891.00,0.00
2024-12-08 17:12:14,72,3475,42,30,2109.84,3891.01,0.00
2024-12-08 17:12:14,71,3475,41,30,2137.92,3891.04,0.00
2024-12-08 17:12:14,70,3475,40,30,2165.14,3891.13,0.00
2024-12-08 17:12:14,70,3476,40,30,2165.12,3892.00,0.00
2024-12-08 17:12:14,71,3476,40,31,2134.62,3892.01,0.00
2024-12-08 17:12:14,71,3477,40,31,2129.69,3893.00,0.00
2024-12-08 17:12:14,72,3477,40,32,2100.11,3893.01,0.00
2024-12-08 17:12:14,71,3477,40,31,2123.69,3893.16,0.00
2024-12-08 17:12:14,71,3478,40,31,2135.17,3894.00,0.00
2024-12-08 17:12:14,72,3478,41,31,2105.51,3894.01,0.00
2024-12-08 17:12:14,71,3478,40,31,2113.83,3894.21,0.00
2024-12-08 17:12:14,71,3479,40,31,2138.46,3895.00,0.00
2024-12-08 17:12:14,72,3479,41,31,2108.76,3895.01,0.00
2024-12-08 17:12:14,73,3478,41,32,2079.87,3895.04,0.00
2024-12-08 17:12:14,72,3478,41,31,2121.78,3895.17,0.00
2024-12-08 17:12:14,72,3479,41,31,2133.11,3896.00,0.00
2024-12-08 17:12:14,73,3479,41,32,2103.89,3896.01,0.00
2024-12-08 17:12:14,72,3479,40,32,2084.73,3896.71,0.00
2024-12-08 17:12:14,72,3480,40,32,2181.83,3897.00,0.00
2024-12-08 17:12:14,73,3480,40,33,2151.94,3897.01,0.00
2024-12-08 17:12:14,72,3480,39,33,2180.10,3897.04,0.00
2024-12-08 17:12:14,71,3480,39,32,2194.37,3897.17,0.00
2024-12-08 17:12:14,71,3481,39,32,2206.42,3898.00,0.00
2024-12-08 17:12:14,72,3481,39,33,2175.77,3898.01,0.00
2024-12-08 17:12:14,71,3481,38,33,2204.08,3898.04,0.00
2024-12-08 17:12:14,71,3482,38,33,2200.23,3899.00,0.00
2024-12-08 17:12:14,72,3482,38,34,2169.67,3899.01,0.00
2024-12-08 17:12:14,71,3482,38,33,2182.05,3899.16,0.00
2024-12-08 17:12:14,71,3483,38,33,2193.55,3900.00,0.00
2024-12-08 17:12:14,72,3483,38,34,2163.09,3900.01,0.00
2024-12-08 17:12:14,71,3483,37,34,2186.69,3900.07,0.00
2024-12-08 17:12:14,71,3484,37,34,2194.92,3901.00,0.00
2024-12-08 17:12:14,72,3484,38,34,2164.44,3901.01,0.00
2024-12-08 17:12:14,71,3484,38,33,2176.88,3901.14,0.00
2024-12-08 17:12:14,71,3485,38,33,2187.85,3902.00,0.00
2024-12-08 17:12:14,72,3485,38,34,2157.46,3902.01,0.00
2024-12-08 17:12:14,71,3485,37,34,2183.90,3902.04,0.00
2024-12-08 17:12:14,71,3486,37,34,2180.04,3903.00,0.00
2024-12-08 17:12:14,72,3486,38,34,2149.76,3903.01,0.00
2024-12-08 17:12:14,71,3486,38,33,2163.29,3903.13,0.00
2024-12-08 17:12:14,71,3487,38,33,2173.71,3904.00,0.00
2024-12-08 17:12:14,72,3487,39,33,2143.52,3904.01,0.00
2024-12-08 17:12:14,72,3488,39,33,2135.89,3905.00,0.00
2024-12-08 17:12:14,73,3488,39,34,2106.63,3905.01,0.00
2024-12-08 17:12:14,72,3488,39,33,2121.14,3905.13,0.00
2024-12-08 17:12:14,72,3489,39,33,2128.06,3906.00,0.00
2024-12-08 17:12:14,73,3489,39,34,2098.91,3906.01,0.00
2024-12-08 17:12:14,72,3489,38,34,2125.84,3906.04,0.00
2024-12-08 17:12:14,72,3490,38,34,2117.75,3907.00,0.00
2024-12-08 17:12:14,73,3490,38,35,2088.74,3907.01,0.00
2024-12-08 17:12:14,72,3490,38,34,2104.21,3907.13,0.00
2024-12-08 17:12:15,72,3491,38,34,2108.98,3908.00,0.00
2024-12-08 17:12:15,73,3491,39,34,2080.09,3908.01,0.00
2024-12-08 17:12:15,73,3492,39,34,2068.11,3909.00,0.00
2024-12-08 17:12:15,74,3492,40,34,2040.16,3909.01,0.00
2024-12-08 17:12:15,73,3492,40,33,2052.08,3909.16,0.00
2024-12-08 17:12:15,72,3492,39,33,2080.58,3909.17,0.00
2024-12-08 17:12:15,72,3493,39,33,2087.31,3910.00,0.00
2024-12-08 17:12:15,73,3493,40,33,2058.71,3910.01,0.00
2024-12-08 17:12:15,72,3493,39,33,2069.96,3910.18,0.00
2024-12-08 17:12:15,72,3494,39,33,2078.82,3911.00,0.00
2024-12-08 17:12:15,73,3494,39,34,2050.34,3911.01,0.00
2024-12-08 17:12:15,72,3494,38,34,2076.66,3911.06,0.00
2024-12-08 17:12:15,71,3494,38,33,2090.50,3911.17,0.00
2024-12-08 17:12:15,71,3495,38,33,2102.54,3912.00,0.00
2024-12-08 17:12:15,72,3495,39,33,2073.34,3912.01,0.00
2024-12-08 17:12:15,71,3495,38,33,2084.39,3912.18,0.00
2024-12-08 17:12:15,70,3495,37,33,2094.30,3912.70,0.00
2024-12-08 17:12:15,70,3496,37,33,2138.71,3913.00,0.00
2024-12-08 17:12:15,71,3496,37,34,2108.59,3913.01,0.00
2024-12-08 17:12:15,70,3496,37,33,2121.82,3913.17,0.00
2024-12-08 17:12:15,70,3497,37,33,2133.88,3914.00,0.00
2024-12-08 17:12:15,71,3497,37,34,2103.82,3914.01,0.00
2024-12-08 17:12:15,70,3497,37,33,2131.99,3914.06,0.00
2024-12-08 17:12:15,69,3497,36,33,2159.50,3914.13,0.00
2024-12-08 17:12:15,68,3497,35,33,2189.54,3914.16,0.00
2024-12-08 17:12:15,67,3497,34,33,2221.63,3914.16,0.00
2024-12-08 17:12:15,67,3498,34,33,2235.42,3915.00,0.00
2024-12-08 17:12:15,68,3498,35,33,2202.55,3915.02,0.00
2024-12-08 17:12:15,68,3499,35,33,2199.08,3916.00,0.00
2024-12-08 17:12:15,69,3499,35,34,2167.21,3916.01,0.00
2024-12-08 17:12:15,68,3499,34,34,2192.20,3916.18,0.00
2024-12-08 17:12:15,67,3499,34,33,2221.42,3916.21,0.00
2024-12-08 17:12:15,67,3500,34,33,2237.73,3917.00,0.00
2024-12-08 17:12:15,68,3500,34,34,2204.82,3917.02,0.00
2024-12-08 17:12:15,68,3501,34,34,2200.97,3918.00,0.00
2024-12-08 17:12:15,69,3501,35,34,2169.07,3918.01,0.00
2024-12-08 17:12:15,70,3500,36,34,2091.25,3918.67,0.00
2024-12-08 17:12:15,70,3501,36,34,2146.95,3919.00,0.00
2024-12-08 17:12:15,71,3501,36,35,2116.72,3919.01,0.00
2024-12-08 17:12:15,71,3502,36,35,2166.95,3920.00,0.00
2024-12-08 17:12:15,72,3502,37,35,2136.85,3920.01,0.00
2024-12-08 17:12:15,71,3502,37,34,2155.77,3920.14,0.00
2024-12-08 17:12:15,71,3503,37,34,2166.66,3921.00,0.00
2024-12-08 17:12:15,72,3503,38,34,2136.57,3921.01,0.00
2024-12-08 17:12:15,71,3503,37,34,2160.06,3921.18,0.00
2024-12-08 17:12:15,71,3504,37,34,2161.69,3922.00,0.00
2024-12-08 17:12:15,72,3504,37,35,2131.66,3922.01,0.00
2024-12-08 17:12:15,71,3504,36,35,2158.39,3922.08,0.00
2024-12-08 17:12:15,70,3504,36,34,2184.75,3922.19,0.00
2024-12-08 17:12:15,70,3505,36,34,2198.17,3923.00,0.00
2024-12-08 17:12:15,71,3505,36,35,2167.21,3923.01,0.00
2024-12-08 17:12:15,71,3506,36,35,2162.24,3924.00,0.00
2024-12-08 17:12:15,72,3506,37,35,2132.21,3924.01,0.00
2024-12-08 17:12:15,71,3506,36,35,2158.93,3924.08,0.00
2024-12-08 17:12:15,70,3506,36,34,2173.85,3924.20,0.00
2024-12-08 17:12:15,70,3507,36,34,2187.83,3925.00,0.00
2024-12-08 17:12:15,71,3507,36,35,2157.02,3925.01,0.00
2024-12-08 17:12:15,70,3507,36,34,2179.99,3925.06,0.00
2024-12-08 17:12:15,70,3508,36,34,2188.39,3926.00,0.00
2024-12-08 17:12:15,71,3508,37,34,2157.56,3926.01,0.00
2024-12-08 17:12:15,70,3508,37,33,2180.54,3926.06,0.00
2024-12-08 17:12:15,69,3508,36,33,2212.14,3926.06,0.00
2024-12-08 17:12:16,69,3509,36,33,2221.24,3927.00,0.00
2024-12-08 17:12:16,70,3509,37,33,2189.51,3927.01,0.00
2024-12-08 17:12:16,69,3509,37,32,2208.88,3927.12,0.00
2024-12-08 17:12:16,69,3510,37,32,2220.24,3928.00,0.00
2024-12-08 17:12:16,70,3510,38,32,2188.52,3928.01,0.00
2024-12-08 17:12:16,69,3510,37,32,2202.62,3928.16,0.00
2024-12-08 17:12:16,69,3511,37,32,2215.68,3929.00,0.00
2024-12-08 17:12:16,70,3511,38,32,2184.03,3929.01,0.00
2024-12-08 17:12:16,69,3511,37,32,2213.98,3929.04,0.00
2024-12-08 17:12:16,68,3511,37,31,2232.11,3929.13,0.00
2024-12-08 17:12:16,68,3512,37,31,2244.79,3930.00,0.00
2024-12-08 17:12:16,69,3512,37,32,2212.25,3930.01,0.00
2024-12-08 17:12:16,69,3513,37,32,2208.26,3931.00,0.00
2024-12-08 17:12:16,70,3513,37,33,2176.71,3931.01,0.00
2024-12-08 17:12:16,70,3514,37,33,2172.21,3932.00,0.00
2024-12-08 17:12:16,71,3514,38,33,2141.62,3932.01,0.00
2024-12-08 17:12:16,70,3514,38,32,2166.06,3932.16,0.00
2024-12-08 17:12:16,69,3514,37,32,2195.18,3932.17,0.00
2024-12-08 17:12:16,69,3515,37,32,2220.21,3933.00,0.00
2024-12-08 17:12:16,70,3515,38,32,2188.50,3933.01,0.00
2024-12-08 17:12:16,70,3516,38,32,2183.99,3934.00,0.00
2024-12-08 17:12:16,71,3516,39,32,2153.23,3934.01,0.00
2024-12-08 17:12:16,70,3516,39,31,2167.16,3934.16,0.00
2024-12-08 17:12:16,70,3517,39,31,2179.49,3935.00,0.00
2024-12-08 17:12:16,71,3517,39,32,2148.79,3935.01,0.00
2024-12-08 17:12:16,70,3517,38,32,2159.89,3935.21,0.00
2024-12-08 17:12:16,70,3518,38,32,2174.46,3936.00,0.00
2024-12-08 17:12:16,71,3518,38,33,2143.83,3936.01,0.00
2024-12-08 17:12:16,70,3518,37,33,2172.77,3936.06,0.00
2024-12-08 17:12:16,69,3518,37,32,2188.88,3936.15,0.00
2024-12-08 17:12:16,69,3519,37,32,2201.39,3937.00,0.00
2024-12-08 17:12:16,70,3519,38,32,2169.95,3937.01,0.00
2024-12-08 17:12:16,69,3519,37,32,2199.12,3937.06,0.00
2024-12-08 17:12:16,69,3520,37,32,2196.82,3938.00,0.00
2024-12-08 17:12:16,70,3520,37,33,2165.43,3938.01,0.00
2024-12-08 17:12:16,69,3520,37,32,2179.72,3938.15,0.00
2024-12-08 17:12:16,68,3520,36,32,2171.72,3938.94,0.00
2024-12-08 17:12:16,68,3521,36,32,2227.37,3939.00,0.00
2024-12-08 17:12:16,69,3521,36,33,2195.09,3939.01,0.00
2024-12-08 17:12:16,69,3522,36,33,2191.08,3940.00,0.00
2024-12-08 17:12:16,70,3522,36,34,2159.78,3940.01,0.00
2024-12-08 17:12:16,69,3522,35,34,2185.37,3940.03,0.00
2024-12-08 17:12:16,68,3522,35,33,2212.29,3940.03,0.00
2024-12-08 17:12:16,68,3523,35,33,2232.56,3941.00,0.00
2024-12-08 17:12:16,69,3523,35,34,2200.20,3941.01,0.00
2024-12-08 17:12:16,68,3523,35,33,2205.92,3941.12,0.00
2024-12-08 17:12:16,67,3523,34,33,2215.63,3941.72,0.00
2024-12-08 17:12:16,67,3524,34,33,2263.51,3942.00,0.00
2024-12-08 17:12:16,68,3524,34,34,2230.23,3942.02,0.00
2024-12-08 17:12:16,68,3525,34,34,2226.73,3943.00,0.00
2024-12-08 17:12:16,69,3525,35,34,2194.46,3943.01,0.00
2024-12-08 17:12:16,68,3525,34,34,2219.78,3943.07,0.00
2024-12-08 17:12:16,67,3525,33,34,2251.16,3943.12,0.00
2024-12-08 17:12:16,66,3525,33,33,2272.72,3943.12,0.00
2024-12-08 17:12:16,66,3526,33,33,2298.38,3944.00,0.00
2024-12-08 17:12:16,67,3526,34,33,2264.07,3944.02,0.00
2024-12-08 17:12:16,67,3527,34,33,2261.12,3945.00,0.00
2024-12-08 17:12:16,68,3527,35,33,2227.86,3945.02,0.00
2024-12-08 17:12:16,67,3527,34,33,2259.94,3945.05,0.00
2024-12-08 17:12:16,66,3527,33,33,2256.26,3945.71,0.00
2024-12-08 17:12:17,66,3528,33,33,2292.97,3946.00,0.00
2024-12-08 17:12:17,67,3528,33,34,2258.74,3946.02,0.00
2024-12-08 17:12:17,66,3528,32,34,2288.80,3946.12,0.00
2024-12-08 17:12:17,65,3528,32,33,2323.41,3946.12,0.00
2024-12-08 17:12:17,65,3529,32,33,2337.94,3947.00,0.00
2024-12-08 17:12:17,66,3529,32,34,2302.52,3947.02,0.00
2024-12-08 17:12:17,66,3530,32,34,2300.11,3948.00,0.00
2024-12-08 17:12:17,67,3530,32,35,2265.78,3948.02,0.00
2024-12-08 17:12:17,66,3530,31,35,2295.94,3948.12,0.00
2024-12-08 17:12:17,66,3531,31,35,2297.70,3949.00,0.00
2024-12-08 17:12:17,67,3531,31,36,2263.41,3949.02,0.00
2024-12-08 17:12:17,66,3531,31,35,2292.34,3949.14,0.00
2024-12-08 17:12:17,66,3532,31,35,2306.66,3950.00,0.00
2024-12-08 17:12:17,67,3532,31,36,2272.24,3950.02,0.00
2024-12-08 17:12:17,66,3532,30,36,2306.48,3950.02,0.00
2024-12-08 17:12:17,66,3533,30,36,2304.07,3951.00,0.00
2024-12-08 17:12:17,67,3533,30,37,2269.68,3951.02,0.00
2024-12-08 17:12:17,66,3533,30,36,2287.92,3951.12,0.00
2024-12-08 17:12:17,66,3534,30,36,2301.66,3952.00,0.00
2024-12-08 17:12:17,67,3534,31,36,2267.30,3952.02,0.00
2024-12-08 17:12:17,67,3535,31,36,2264.34,3953.00,0.00
2024-12-08 17:12:17,68,3535,32,36,2231.04,3953.02,0.00
2024-12-08 17:12:17,67,3535,32,35,2248.43,3953.12,0.00
2024-12-08 17:12:17,67,3536,32,35,2261.37,3954.00,0.00
2024-12-08 17:12:17,68,3536,32,36,2228.11,3954.02,0.00
2024-12-08 17:12:17,68,3537,32,36,2224.61,3955.00,0.00
2024-12-08 17:12:17,69,3537,33,36,2192.37,3955.01,0.00
2024-12-08 17:12:17,68,3537,33,35,2209.50,3955.12,0.00
2024-12-08 17:12:17,68,3538,33,35,2221.68,3956.00,0.00
2024-12-08 17:12:17,69,3538,34,35,2189.48,3956.01,0.00
2024-12-08 17:12:17,69,3539,34,35,2185.45,3957.00,0.00
2024-12-08 17:12:17,70,3539,34,36,2154.23,3957.01,0.00
2024-12-08 17:12:17,69,3539,33,36,2183.16,3957.06,0.00
2024-12-08 17:12:17,68,3539,33,35,2200.16,3957.15,0.00
2024-12-08 17:12:17,67,3539,32,35,2214.77,3957.37,0.00
2024-12-08 17:12:17,67,3540,32,35,2249.48,3958.00,0.00
2024-12-08 17:12:17,68,3540,33,35,2216.40,3958.02,0.00
2024-12-08 17:12:17,67,3540,32,35,2248.89,3958.02,0.00
2024-12-08 17:12:17,67,3541,32,35,2245.91,3959.00,0.00
2024-12-08 17:12:17,68,3541,33,35,2212.88,3959.02,0.00
2024-12-08 17:12:17,67,3541,33,34,2229.99,3959.13,0.00
2024-12-08 17:12:17,67,3542,33,34,2243.52,3960.00,0.00
2024-12-08 17:12:17,68,3542,34,34,2210.53,3960.02,0.00
2024-12-08 17:12:17,67,3542,33,34,2224.06,3960.18,0.00
2024-12-08 17:12:17,67,3543,33,34,2251.19,3961.00,0.00
2024-12-08 17:12:17,68,3543,33,35,2218.08,3961.02,0.00
2024-12-08 17:12:17,67,3543,33,34,2235.84,3961.13,0.00
2024-12-08 17:12:17,66,3543,32,34,2266.82,3961.20,0.00
2024-12-08 17:12:17,66,3544,32,34,2283.51,3962.00,0.00
2024-12-08 17:12:17,67,3544,32,35,2249.43,3962.02,0.00
2024-12-08 17:12:17,67,3545,32,35,2246.07,3963.00,0.00
2024-12-08 17:12:17,68,3545,32,36,2213.04,3963.02,0.00
2024-12-08 17:12:17,67,3545,32,35,2231.30,3963.13,0.00
2024-12-08 17:12:17,67,3546,32,35,2244.14,3964.00,0.00
2024-12-08 17:12:17,68,3546,33,35,2211.14,3964.02,0.00
2024-12-08 17:12:17,68,3547,33,35,2206.80,3965.00,0.00
2024-12-08 17:12:17,69,3547,33,36,2174.81,3965.01,0.00
2024-12-08 17:12:17,68,3547,32,36,2206.21,3965.02,0.00
2024-12-08 17:12:17,67,3547,31,36,2237.96,3965.05,0.00
2024-12-08 17:12:17,66,3547,31,35,2259.87,3965.11,0.00
2024-12-08 17:12:18,66,3548,31,35,2272.12,3966.00,0.00
2024-12-08 17:12:18,67,3548,31,36,2238.21,3966.02,0.00
2024-12-08 17:12:18,67,3549,31,36,2234.37,3967.00,0.00
2024-12-08 17:12:18,68,3549,32,36,2201.51,3967.02,0.00
2024-12-08 17:12:18,67,3549,32,35,2221.36,3967.10,0.00
2024-12-08 17:12:18,67,3550,32,35,2232.97,3968.00,0.00
2024-12-08 17:12:18,68,3550,33,35,2200.13,3968.02,0.00
2024-12-08 17:12:18,68,3551,33,35,2195.85,3969.00,0.00
2024-12-08 17:12:18,69,3551,34,35,2164.02,3969.01,0.00
2024-12-08 17:12:18,68,3551,34,34,2180.70,3969.13,0.00
2024-12-08 17:12:18,67,3551,33,34,2211.48,3969.16,0.00
2024-12-08 17:12:18,67,3552,33,34,2225.38,3970.00,0.00
2024-12-08 17:12:18,68,3552,34,34,2192.66,3970.02,0.00
2024-12-08 17:12:18,69,3551,35,34,2158.01,3970.12,0.00
2024-12-08 17:12:18,69,3552,35,34,2199.63,3971.00,0.00
2024-12-08 17:12:18,70,3552,35,35,2168.21,3971.01,0.00
2024-12-08 17:12:18,69,3552,34,35,2199.05,3971.01,0.00
2024-12-08 17:12:18,68,3552,33,35,2214.50,3971.15,0.00
2024-12-08 17:12:18,68,3553,33,35,2285.23,3972.00,0.00
2024-12-08 17:12:18,69,3553,33,36,2252.11,3972.01,0.00
2024-12-08 17:12:18,68,3553,33,35,2271.83,3972.12,0.00
2024-12-08 17:12:18,67,3553,32,35,2292.32,3972.42,0.00
2024-12-08 17:12:18,67,3554,32,35,2317.04,3973.00,0.00
2024-12-08 17:12:18,68,3554,33,35,2282.97,3973.02,0.00
2024-12-08 17:12:18,67,3554,32,35,2277.72,3973.69,0.00
2024-12-08 17:12:18,67,3555,32,35,2312.95,3974.00,0.00
2024-12-08 17:12:18,68,3555,32,36,2278.94,3974.02,0.00
2024-12-08 17:12:18,67,3555,32,35,2297.56,3974.13,0.00
2024-12-08 17:12:18,67,3556,32,35,2310.15,3975.00,0.00
2024-12-08 17:12:18,68,3556,32,36,2276.17,3975.02,0.00
2024-12-08 17:12:18,67,3556,31,36,2308.96,3975.05,0.00
2024-12-08 17:12:18,67,3557,31,36,2306.29,3976.00,0.00
2024-12-08 17:12:18,68,3557,31,37,2272.37,3976.02,0.00
2024-12-08 17:12:18,67,3557,31,36,2291.48,3976.12,0.00
2024-12-08 17:12:18,67,3558,31,36,2303.80,3977.00,0.00
2024-12-08 17:12:18,68,3558,32,36,2269.92,3977.02,0.00
2024-12-08 17:12:18,68,3559,32,36,2265.91,3978.00,0.00
2024-12-08 17:12:18,69,3559,32,37,2233.07,3978.01,0.00
2024-12-08 17:12:18,68,3559,32,36,2251.90,3978.12,0.00
2024-12-08 17:12:18,68,3560,32,36,2263.78,3979.00,0.00
2024-12-08 17:12:18,69,3560,33,36,2230.97,3979.01,0.00
2024-12-08 17:12:18,68,3560,32,36,2246.27,3979.16,0.00
2024-12-08 17:12:18,68,3561,32,36,2260.01,3980.00,0.00
2024-12-08 17:12:18,69,3561,32,37,2227.26,3980.01,0.00
2024-12-08 17:12:18,68,3561,32,36,2245.41,3980.13,0.00
2024-12-08 17:12:18,68,3562,32,36,2258.07,3981.00,0.00
2024-12-08 17:12:18,69,3562,32,37,2225.35,3981.01,0.00
2024-12-08 17:12:18,68,3562,31,37,2257.49,3981.02,0.00
2024-12-08 17:12:18,67,3562,30,37,2252.88,3981.69,0.00
2024-12-08 17:12:18,67,3563,30,37,2288.19,3982.00,0.00
2024-12-08 17:12:18,68,3563,31,37,2254.54,3982.02,0.00
2024-12-08 17:12:18,67,3563,31,36,2274.55,3982.12,0.00
2024-12-08 17:12:18,67,3564,31,36,2287.57,3983.00,0.00
2024-12-08 17:12:18,68,3564,32,36,2253.93,3983.02,0.00
2024-12-08 17:12:18,68,3565,32,36,2250.40,3984.00,0.00
2024-12-08 17:12:18,69,3565,32,37,2217.78,3984.01,0.00
2024-12-08 17:12:18,68,3565,32,36,2236.37,3984.13,0.00
2024-12-08 17:12:19,68,3566,32,36,2249.21,3985.00,0.00
2024-12-08 17:12:19,69,3566,33,36,2216.61,3985.01,0.00
2024-12-08 17:12:19,68,3566,32,36,2234.59,3985.13,0.00
2024-12-08 17:12:19,68,3567,32,36,2247.43,3986.00,0.00
2024-12-08 17:12:19,69,3567,33,36,2214.85,3986.01,0.00
2024-12-08 17:12:19,68,3567,33,35,2232.80,3986.13,0.00
2024-12-08 17:12:19,68,3568,33,35,2245.64,3987.00,0.00
2024-12-08 17:12:19,69,3568,33,36,2213.10,3987.01,0.00
2024-12-08 17:12:19,69,3569,33,36,2209.03,3988.00,0.00
2024-12-08 17:12:19,70,3569,33,37,2177.47,3988.01,0.00
2024-12-08 17:12:19,69,3569,32,37,2208.45,3988.01,0.00
2024-12-08 17:12:19,68,3569,32,36,2227.47,3988.12,0.00
2024-12-08 17:12:19,67,3569,31,36,2247.63,3988.15,0.00
2024-12-08 17:12:19,67,3570,31,36,2273.75,3989.00,0.00
2024-12-08 17:12:19,68,3570,32,36,2240.32,3989.02,0.00
2024-12-08 17:12:19,68,3571,32,36,2236.77,3990.00,0.00
2024-12-08 17:12:19,69,3571,33,36,2204.35,3990.01,0.00
2024-12-08 17:12:19,68,3571,33,35,2218.04,3990.18,0.00
2024-12-08 17:12:19,68,3572,33,35,2232.64,3991.00,0.00
2024-12-08 17:12:19,69,3572,33,36,2200.28,3991.01,0.00
2024-12-08 17:12:19,69,3573,33,36,2196.20,3992.00,0.00
2024-12-08 17:12:19,70,3573,34,36,2164.83,3992.01,0.00
2024-12-08 17:12:19,69,3573,34,35,2178.31,3992.17,0.00
2024-12-08 17:12:19,68,3573,33,35,2208.58,3992.18,0.00
2024-12-08 17:12:19,68,3574,33,35,2234.93,3993.00,0.00
2024-12-08 17:12:19,69,3574,34,35,2202.54,3993.01,0.00
2024-12-08 17:12:19,69,3575,34,35,2198.46,3994.00,0.00
2024-12-08 17:12:19,70,3575,34,36,2167.05,3994.01,0.00
2024-12-08 17:12:19,70,3576,34,36,2162.10,3995.00,0.00
2024-12-08 17:12:19,71,3576,34,37,2131.65,3995.01,0.00
2024-12-08 17:12:19,70,3576,34,36,2155.10,3995.17,0.00
2024-12-08 17:12:19,70,3577,34,36,2168.17,3996.00,0.00
2024-12-08 17:12:19,71,3577,34,37,2137.63,3996.01,0.00
2024-12-08 17:12:19,71,3578,34,37,2132.54,3997.00,0.00
2024-12-08 17:12:19,72,3578,35,37,2102.92,3997.01,0.00
2024-12-08 17:12:19,71,3578,35,36,2115.11,3997.17,0.00
2024-12-08 17:12:19,70,3578,34,36,2122.77,3997.73,0.00
2024-12-08 17:12:19,70,3579,34,36,2157.83,3998.00,0.00
2024-12-08 17:12:19,71,3579,34,37,2127.44,3998.01,0.00
2024-12-08 17:12:19,70,3579,33,37,2151.58,3998.17,0.00
2024-12-08 17:12:19,70,3580,33,37,2153.23,3999.00,0.00
2024-12-08 17:12:19,71,3580,34,37,2122.90,3999.01,0.00
2024-12-08 17:12:19,70,3580,34,36,2135.55,3999.17,0.00
2024-12-08 17:12:19,70,3581,34,36,2148.62,4000.00,0.00
2024-12-08 17:12:19,71,3581,34,37,2118.36,4000.01,0.00
2024-12-08 17:12:19,71,3582,34,37,2112.63,4001.00,0.00
2024-12-08 17:12:19,72,3582,35,37,2083.29,4001.01,0.00
2024-12-08 17:12:19,71,3582,35,36,2108.65,4001.11,0.00
2024-12-08 17:12:19,70,3582,35,35,2126.21,4001.16,0.00
2024-12-08 17:12:19,70,3583,35,35,2137.98,4002.00,0.00
2024-12-08 17:12:19,71,3583,35,36,2107.86,4002.01,0.00
2024-12-08 17:12:19,71,3584,35,36,2102.75,4003.00,0.00
2024-12-08 17:12:19,72,3584,36,36,2073.55,4003.01,0.00
2024-12-08 17:12:19,71,3584,35,36,2101.07,4003.04,0.00
2024-12-08 17:12:19,70,3584,35,35,2115.66,4003.16,0.00
2024-12-08 17:12:19,69,3584,34,35,2145.17,4003.17,0.00
2024-12-08 17:12:19,68,3584,33,35,2175.54,4003.18,0.00
2024-12-08 17:12:19,68,3585,33,35,2201.96,4004.00,0.00
2024-12-08 17:12:19,69,3585,33,36,2170.05,4004.01,0.00
2024-12-08 17:12:19,69,3586,33,36,2165.94,4005.00,0.00
2024-12-08 17:12:19,70,3586,34,36,2135.00,4005.01,0.00
2024-12-08 17:12:19,69,3586,34,35,2164.21,4005.04,0.00
2024-12-08 17:12:19,68,3586,34,34,2181.33,4005.15,0.00
2024-12-08 17:12:20,68,3587,34,34,2194.81,4006.00,0.00
2024-12-08 17:12:20,69,3587,35,34,2163.00,4006.01,0.00
2024-12-08 17:12:20,68,3587,34,34,2177.75,4006.15,0.00
2024-12-08 17:12:20,68,3588,34,34,2191.23,4007.00,0.00
2024-12-08 17:12:20,69,3588,35,34,2159.48,4007.01,0.00
2024-12-08 17:12:20,68,3588,35,33,2174.17,4007.15,0.00
2024-12-08 17:12:20,68,3589,35,33,2187.65,4008.00,0.00
2024-12-08 17:12:20,69,3589,35,34,2155.95,4008.01,0.00
2024-12-08 17:12:20,68,3589,34,34,2185.89,4008.04,0.00
2024-12-08 17:12:20,68,3590,34,34,2183.48,4009.00,0.00
2024-12-08 17:12:20,69,3590,34,35,2151.84,4009.01,0.00
2024-12-08 17:12:20,68,3590,33,35,2180.55,4009.09,0.00
2024-12-08 17:12:20,67,3590,33,34,2200.54,4009.12,0.00
2024-12-08 17:12:20,66,3590,32,34,2209.89,4009.71,0.00
2024-12-08 17:12:20,66,3591,32,34,2259.32,4010.00,0.00
2024-12-08 17:12:20,67,3591,32,35,2225.60,4010.02,0.00
2024-12-08 17:12:20,67,3592,32,35,2222.57,4011.00,0.00
2024-12-08 17:12:20,68,3592,33,35,2189.88,4011.02,0.00
2024-12-08 17:12:20,67,3592,33,34,2207.62,4011.12,0.00
2024-12-08 17:12:20,67,3593,33,34,2220.73,4012.00,0.00
2024-12-08 17:12:20,68,3593,33,35,2188.07,4012.02,0.00
2024-12-08 17:12:20,67,3593,32,35,2180.32,4012.72,0.00
2024-12-08 17:12:20,67,3594,32,35,2217.09,4013.00,0.00
2024-12-08 17:12:20,68,3594,32,36,2184.48,4013.02,0.00
2024-12-08 17:12:20,67,3594,32,35,2202.73,4013.12,0.00
2024-12-08 17:12:20,67,3595,32,35,2215.84,4014.00,0.00
2024-12-08 17:12:20,68,3595,32,36,2183.26,4014.02,0.00
2024-12-08 17:12:20,67,3595,31,36,2164.61,4014.70,0.00
2024-12-08 17:12:20,67,3596,31,36,2212.80,4015.00,0.00
2024-12-08 17:12:20,68,3596,32,36,2180.26,4015.02,0.00
2024-12-08 17:12:20,67,3596,31,36,2211.01,4015.05,0.00
2024-12-08 17:12:20,66,3596,31,35,2232.35,4015.11,0.00
2024-12-08 17:12:20,65,3596,30,35,2264.24,4015.15,0.00
2024-12-08 17:12:20,65,3597,30,35,2280.22,4016.00,0.00
2024-12-08 17:12:20,66,3597,31,35,2245.67,4016.02,0.00
2024-12-08 17:12:20,65,3597,30,35,2261.71,4016.15,0.00
2024-12-08 17:12:20,65,3598,30,35,2277.69,4017.00,0.00
2024-12-08 17:12:20,66,3598,30,36,2243.18,4017.02,0.00
2024-12-08 17:12:20,65,3598,30,35,2261.65,4017.14,0.00
2024-12-08 17:12:20,65,3599,30,35,2276.94,4018.00,0.00
2024-12-08 17:12:20,66,3599,31,35,2242.44,4018.02,0.00
2024-12-08 17:12:20,65,3599,30,35,2276.32,4018.02,0.00
2024-12-08 17:12:20,64,3599,29,35,2310.64,4018.03,0.00
2024-12-08 17:12:20,64,3600,29,35,2321.76,4019.00,0.00
2024-12-08 17:12:20,65,3600,30,35,2286.04,4019.02,0.00
2024-12-08 17:12:20,64,3600,30,34,2306.08,4019.11,0.00
2024-12-08 17:12:20,63,3600,29,34,2342.69,4019.11,0.00
2024-12-08 17:12:20,63,3601,29,34,2357.15,4020.00,0.00
2024-12-08 17:12:20,64,3601,30,34,2320.32,4020.02,0.00
2024-12-08 17:12:20,64,3602,30,34,2317.01,4021.00,0.00
2024-12-08 17:12:20,65,3602,30,35,2281.36,4021.02,0.00
2024-12-08 17:12:20,64,3602,30,34,2299.44,4021.13,0.00
2024-12-08 17:12:20,64,3603,30,34,2312.48,4022.00,0.00
2024-12-08 17:12:20,65,3603,31,34,2276.91,4022.02,0.00
2024-12-08 17:12:20,64,3603,30,34,2292.41,4022.16,0.00
2024-12-08 17:12:20,64,3604,30,34,2319.14,4023.00,0.00
2024-12-08 17:12:20,65,3604,30,35,2283.46,4023.02,0.00
2024-12-08 17:12:20,64,3604,30,34,2302.19,4023.13,0.00
2024-12-08 17:12:20,64,3605,30,34,2315.41,4024.00,0.00
2024-12-08 17:12:20,65,3605,31,34,2279.79,4024.02,0.00
2024-12-08 17:12:21,65,3606,31,34,2275.32,4025.00,0.00
2024-12-08 17:12:21,66,3606,32,34,2240.84,4025.02,0.00
2024-12-08 17:12:21,65,3606,32,33,2259.24,4025.12,0.00
2024-12-08 17:12:21,65,3607,32,33,2271.57,4026.00,0.00
2024-12-08 17:12:21,66,3607,33,33,2237.16,4026.02,0.00
2024-12-08 17:12:21,65,3607,32,33,2270.34,4026.03,0.00
2024-12-08 17:12:21,65,3608,32,33,2266.59,4027.00,0.00
2024-12-08 17:12:21,66,3608,32,34,2232.25,4027.02,0.00
2024-12-08 17:12:21,65,3608,32,33,2251.12,4027.11,0.00
2024-12-08 17:12:21,65,3609,32,33,2262.76,4028.00,0.00
2024-12-08 17:12:21,66,3609,32,34,2228.47,4028.02,0.00
2024-12-08 17:12:21,66,3610,32,34,2223.07,4029.00,0.00
2024-12-08 17:12:21,67,3610,33,34,2189.89,4029.02,0.00
2024-12-08 17:12:21,66,3610,32,34,2221.86,4029.03,0.00
2024-12-08 17:12:21,65,3610,32,33,2242.41,4029.09,0.00
2024-12-08 17:12:21,64,3610,31,33,2265.49,4029.09,0.00
2024-12-08 17:12:21,63,3610,30,33,2301.45,4029.10,0.00
2024-12-08 17:12:21,62,3610,30,32,2334.63,4029.15,0.00
2024-12-08 17:12:21,62,3611,30,32,2365.73,4030.00,0.00
2024-12-08 17:12:21,63,3611,30,33,2328.18,4030.02,0.00
2024-12-08 17:12:21,62,3611,29,33,2362.50,4030.10,0.00
2024-12-08 17:12:21,62,3612,29,33,2378.67,4031.00,0.00
2024-12-08 17:12:21,63,3612,30,33,2340.92,4031.02,0.00
2024-12-08 17:12:21,64,3611,30,34,2304.34,4031.05,0.00
2024-12-08 17:12:21,64,3612,30,34,2354.68,4032.00,0.00
2024-12-08 17:12:21,65,3612,30,35,2318.46,4032.02,0.00
2024-12-08 17:12:21,64,3612,30,34,2349.67,4032.13,0.00
2024-12-08 17:12:21,64,3613,30,34,2428.36,4033.00,0.00
2024-12-08 17:12:21,65,3613,30,35,2391.00,4033.02,0.00
2024-12-08 17:12:21,65,3614,30,35,2389.11,4034.00,0.00
2024-12-08 17:12:21,66,3614,31,35,2352.92,4034.02,0.00
2024-12-08 17:12:21,65,3614,31,34,2371.15,4034.14,0.00
2024-12-08 17:12:21,65,3615,31,34,2386.60,4035.00,0.00
2024-12-08 17:12:21,66,3615,32,34,2350.44,4035.02,0.00
2024-12-08 17:12:21,66,3616,32,34,2347.97,4036.00,0.00
2024-12-08 17:12:21,67,3616,33,34,2312.92,4036.02,0.00
2024-12-08 17:12:21,66,3616,33,33,2330.88,4036.14,0.00
2024-12-08 17:12:21,66,3617,33,33,2344.89,4037.00,0.00
2024-12-08 17:12:21,67,3617,34,33,2309.89,4037.02,0.00
2024-12-08 17:12:21,67,3618,34,33,2305.97,4038.00,0.00
2024-12-08 17:12:21,68,3618,34,34,2272.06,4038.02,0.00
2024-12-08 17:12:21,67,3618,34,33,2289.73,4038.13,0.00
2024-12-08 17:12:21,67,3619,34,33,2303.53,4039.00,0.00
2024-12-08 17:12:21,68,3619,34,34,2269.65,4039.02,0.00
2024-12-08 17:12:21,68,3620,34,34,2266.06,4040.00,0.00
2024-12-08 17:12:21,69,3620,35,34,2233.21,4040.01,0.00
2024-12-08 17:12:21,68,3620,35,33,2264.88,4040.03,0.00
2024-12-08 17:12:21,67,3620,35,32,2283.62,4040.12,0.00
2024-12-08 17:12:21,67,3621,35,32,2296.83,4041.00,0.00
2024-12-08 17:12:21,68,3621,36,32,2263.05,4041.02,0.00
2024-12-08 17:12:21,68,3622,36,32,2258.77,4042.00,0.00
2024-12-08 17:12:21,69,3622,36,33,2226.03,4042.01,0.00
2024-12-08 17:12:21,68,3622,36,32,2238.82,4042.13,0.00
2024-12-08 17:12:21,68,3623,36,32,2251.83,4043.00,0.00
2024-12-08 17:12:21,69,3623,37,32,2219.20,4043.01,0.00
2024-12-08 17:12:21,68,3623,36,32,2248.73,4043.09,0.00
2024-12-08 17:12:21,68,3624,36,32,2248.08,4044.00,0.00
2024-12-08 17:12:21,69,3624,36,33,2215.50,4044.01,0.00
2024-12-08 17:12:22,68,3624,36,32,2233.24,4044.12,0.00
2024-12-08 17:12:22,68,3625,36,32,2245.66,4045.00,0.00
2024-12-08 17:12:22,69,3625,37,32,2213.12,4045.01,0.00
2024-12-08 17:12:22,68,3625,36,32,2229.63,4045.13,0.00
2024-12-08 17:12:22,68,3626,36,32,2242.65,4046.00,0.00
2024-12-08 17:12:22,69,3626,37,32,2210.14,4046.01,0.00
2024-12-08 17:12:22,68,3626,37,31,2226.61,4046.13,0.00
2024-12-08 17:12:22,68,3627,37,31,2239.63,4047.00,0.00
2024-12-08 17:12:22,69,3627,38,31,2207.17,4047.01,0.00
2024-12-08 17:12:22,69,3628,38,31,2203.02,4048.00,0.00
2024-12-08 17:12:22,70,3628,39,31,2171.55,4048.01,0.00
2024-12-08 17:12:22,69,3628,39,30,2185.46,4048.16,0.00
2024-12-08 17:12:22,69,3629,39,30,2198.87,4049.00,0.00
2024-12-08 17:12:22,70,3629,39,31,2167.46,4049.01,0.00
2024-12-08 17:12:22,70,3630,39,31,2162.79,4050.00,0.00
2024-12-08 17:12:22,71,3630,39,32,2132.33,4050.01,0.00
2024-12-08 17:12:22,70,3630,38,32,2159.91,4050.07,0.00
2024-12-08 17:12:22,69,3630,38,31,2177.14,4050.15,0.00
2024-12-08 17:12:22,69,3631,38,31,2189.98,4051.00,0.00
2024-12-08 17:12:22,70,3631,38,32,2158.69,4051.01,0.00
2024-12-08 17:12:22,69,3631,38,31,2188.82,4051.03,0.00
2024-12-08 17:12:22,69,3632,38,31,2185.23,4052.00,0.00
2024-12-08 17:12:22,70,3632,39,31,2154.02,4052.01,0.00
2024-12-08 17:12:22,69,3632,39,30,2168.23,4052.15,0.00
2024-12-08 17:12:22,68,3632,38,30,2184.11,4052.32,0.00
2024-12-08 17:12:22,68,3633,38,30,2216.72,4053.00,0.00
2024-12-08 17:12:22,69,3633,38,31,2184.60,4053.01,0.00
2024-12-08 17:12:22,68,3633,37,31,2215.54,4053.03,0.00
2024-12-08 17:12:22,67,3633,36,31,2227.47,4053.18,0.00
2024-12-08 17:12:22,67,3634,36,31,2255.21,4054.00,0.00
2024-12-08 17:12:22,68,3634,37,31,2222.04,4054.02,0.00
2024-12-08 17:12:22,67,3634,37,30,2237.69,4054.13,0.00
2024-12-08 17:12:22,67,3635,37,30,2251.53,4055.00,0.00
2024-12-08 17:12:22,68,3635,38,30,2218.42,4055.02,0.00
2024-12-08 17:12:22,67,3635,37,30,2237.63,4055.12,0.00
2024-12-08 17:12:22,67,3636,37,30,2250.87,4056.00,0.00
2024-12-08 17:12:22,68,3636,37,31,2217.77,4056.02,0.00
2024-12-08 17:12:22,67,3636,37,30,2234.55,4056.12,0.00
2024-12-08 17:12:22,67,3637,37,30,2247.79,4057.00,0.00
2024-12-08 17:12:22,68,3637,38,30,2214.74,4057.02,0.00
2024-12-08 17:12:22,68,3638,38,30,2211.10,4058.00,0.00
2024-12-08 17:12:22,69,3638,38,31,2179.06,4058.01,0.00
2024-12-08 17:12:22,68,3638,38,30,2195.61,4058.12,0.00
2024-12-08 17:12:22,68,3639,38,30,2208.07,4059.00,0.00
2024-12-08 17:12:22,69,3639,38,31,2176.07,4059.01,0.00
2024-12-08 17:12:22,68,3639,37,31,2206.89,4059.03,0.00
2024-12-08 17:12:22,67,3639,36,31,2223.48,4059.12,0.00
2024-12-08 17:12:22,67,3640,36,31,2248.85,4060.00,0.00
2024-12-08 17:12:22,68,3640,36,32,2215.78,4060.02,0.00
2024-12-08 17:12:22,67,3640,36,31,2233.72,4060.10,0.00
2024-12-08 17:12:22,67,3641,36,31,2246.37,4061.00,0.00
2024-12-08 17:12:22,68,3641,37,31,2213.34,4061.02,0.00
2024-12-08 17:12:22,67,3641,36,31,2243.87,4061.08,0.00
2024-12-08 17:12:22,66,3641,35,31,2241.06,4061.38,0.00
2024-12-08 17:12:22,66,3642,35,31,2277.80,4062.00,0.00
2024-12-08 17:12:22,67,3642,36,31,2243.80,4062.02,0.00
2024-12-08 17:12:22,66,3642,35,31,2275.35,4062.06,0.00
2024-12-08 17:12:22,65,3642,35,30,2297.86,4062.08,0.00
2024-12-08 17:12:22,65,3643,35,30,2310.91,4063.00,0.00
2024-12-08 17:12:22,66,3643,36,30,2275.89,4063.02,0.00
2024-12-08 17:12:22,65,3643,35,30,2284.15,4063.37,0.00
2024-12-08 17:12:22,65,3644,35,30,2308.98,4064.00,0.00
2024-12-08 17:12:22,66,3644,35,31,2273.99,4064.02,0.00
2024-12-08 17:12:23,65,3644,35,30,2293.99,4064.09,0.00
2024-12-08 17:12:23,65,3645,35,30,2307.67,4065.00,0.00
2024-12-08 17:12:23,66,3645,35,31,2272.70,4065.02,0.00
2024-12-08 17:12:23,65,3645,34,31,2277.68,4065.12,0.00
2024-12-08 17:12:23,65,3646,34,31,2305.11,4066.00,0.00
2024-12-08 17:12:23,66,3646,34,32,2270.18,4066.02,0.00
2024-12-08 17:12:23,65,3646,34,31,2289.49,4066.11,0.00
2024-12-08 17:12:23,65,3647,34,31,2303.80,4067.00,0.00
2024-12-08 17:12:23,66,3647,35,31,2268.89,4067.02,0.00
2024-12-08 17:12:23,65,3647,34,31,2299.44,4067.11,0.00
2024-12-08 17:12:23,65,3648,34,31,2301.24,4068.00,0.00
2024-12-08 17:12:23,66,3648,34,32,2266.37,4068.02,0.00
2024-12-08 17:12:23,65,3648,34,31,2284.36,4068.11,0.00
2024-12-08 17:12:23,65,3649,34,31,2298.67,4069.00,0.00
2024-12-08 17:12:23,66,3649,35,31,2263.84,4069.02,0.00
2024-12-08 17:12:23,66,3650,35,31,2261.32,4070.00,0.00
2024-12-08 17:12:23,67,3650,35,32,2227.57,4070.02,0.00
2024-12-08 17:12:23,66,3650,35,31,2245.30,4070.11,0.00
2024-12-08 17:12:23,66,3651,35,31,2258.79,4071.00,0.00
2024-12-08 17:12:23,67,3651,36,31,2225.07,4071.02,0.00
2024-12-08 17:12:23,66,3651,35,31,2241.54,4071.12,0.00
2024-12-08 17:12:23,66,3652,35,31,2255.64,4072.00,0.00
2024-12-08 17:12:23,67,3652,36,31,2221.97,4072.02,0.00
2024-12-08 17:12:23,66,3652,36,30,2240.23,4072.11,0.00
2024-12-08 17:12:23,66,3653,36,30,2253.73,4073.00,0.00
2024-12-08 17:12:23,67,3653,37,30,2220.09,4073.02,0.00
2024-12-08 17:12:23,66,3653,36,30,2252.50,4073.03,0.00
2024-12-08 17:12:23,66,3654,36,30,2250.58,4074.00,0.00
2024-12-08 17:12:23,67,3654,36,31,2216.99,4074.02,0.00
2024-12-08 17:12:23,66,3654,36,30,2235.78,4074.09,0.00
2024-12-08 17:12:23,66,3655,36,30,2248.66,4075.00,0.00
2024-12-08 17:12:23,67,3655,37,30,2215.10,4075.02,0.00
2024-12-08 17:12:23,67,3656,37,30,2211.99,4076.00,0.00
2024-12-08 17:12:23,68,3656,38,30,2179.46,4076.02,0.00
2024-12-08 17:12:23,67,3656,38,29,2198.01,4076.09,0.00
2024-12-08 17:12:23,67,3657,38,29,2210.10,4077.00,0.00
2024-12-08 17:12:23,68,3657,38,30,2177.60,4077.02,0.00
2024-12-08 17:12:23,68,3658,38,30,2173.93,4078.00,0.00
2024-12-08 17:12:23,69,3658,39,30,2142.43,4078.01,0.00
2024-12-08 17:12:23,68,3658,39,29,2160.75,4078.09,0.00
2024-12-08 17:12:23,68,3659,39,29,2172.07,4079.00,0.00
2024-12-08 17:12:23,69,3659,40,29,2140.59,4079.01,0.00
2024-12-08 17:12:23,68,3659,39,29,2170.88,4079.03,0.00
2024-12-08 17:12:23,67,3659,38,29,2186.25,4079.13,0.00
2024-12-08 17:12:23,67,3660,38,29,2200.15,4080.00,0.00
2024-12-08 17:12:23,68,3660,39,29,2167.80,4080.02,0.00
2024-12-08 17:12:23,67,3660,39,28,2185.56,4080.10,0.00
2024-12-08 17:12:23,67,3661,39,28,2198.26,4081.00,0.00
2024-12-08 17:12:23,68,3661,40,28,2165.93,4081.02,0.00
2024-12-08 17:12:23,67,3661,39,28,2196.44,4081.05,0.00
2024-12-08 17:12:23,67,3662,39,28,2194.53,4082.00,0.00
2024-12-08 17:12:23,68,3662,40,28,2162.26,4082.02,0.00
2024-12-08 17:12:23,67,3662,40,27,2178.71,4082.10,0.00
2024-12-08 17:12:23,67,3663,40,27,2191.41,4083.00,0.00
2024-12-08 17:12:23,68,3663,40,28,2159.19,4083.02,0.00
2024-12-08 17:12:23,68,3664,40,28,2155.51,4084.00,0.00
2024-12-08 17:12:23,69,3664,40,29,2124.27,4084.01,0.00
2024-12-08 17:12:23,68,3664,40,28,2139.91,4084.10,0.00
2024-12-08 17:12:23,67,3664,39,28,2171.24,4084.10,0.00
2024-12-08 17:12:23,67,3665,39,28,2196.14,4085.00,0.00
2024-12-08 17:12:24,68,3665,39,29,2163.85,4085.02,0.00
2024-12-08 17:12:24,67,3665,38,29,2191.89,4085.10,0.00
2024-12-08 17:12:24,67,3666,38,29,2192.41,4086.00,0.00
2024-12-08 17:12:24,68,3666,38,30,2160.17,4086.02,0.00
2024-12-08 17:12:24,67,3666,37,30,2191.20,4086.03,0.00
2024-12-08 17:12:24,66,3666,36,30,2221.31,4086.09,0.00
2024-12-08 17:12:24,66,3667,36,30,2221.84,4087.00,0.00
2024-12-08 17:12:24,67,3667,36,31,2188.68,4087.02,0.00
2024-12-08 17:12:24,66,3667,36,30,2218.14,4087.09,0.00
2024-12-08 17:12:24,66,3668,36,30,2231.06,4088.00,0.00
2024-12-08 17:12:24,67,3668,36,31,2197.76,4088.02,0.00
2024-12-08 17:12:24,67,3669,36,31,2194.63,4089.00,0.00
2024-12-08 17:12:24,68,3669,36,32,2162.36,4089.02,0.00
2024-12-08 17:12:24,67,3669,36,31,2179.39,4089.09,0.00
2024-12-08 17:12:24,66,3669,35,31,2176.75,4089.68,0.00
2024-12-08 17:12:24,66,3670,35,31,2225.95,4090.00,0.00
2024-12-08 17:12:24,67,3670,35,32,2192.73,4090.02,0.00
2024-12-08 17:12:24,67,3671,35,32,2189.60,4091.00,0.00
2024-12-08 17:12:24,68,3671,35,33,2157.40,4091.02,0.00
2024-12-08 17:12:24,67,3671,35,32,2173.74,4091.10,0.00
2024-12-08 17:12:24,66,3671,34,32,2172.95,4091.82,0.00
2024-12-08 17:12:24,66,3672,34,32,2227.66,4092.00,0.00
2024-12-08 17:12:24,67,3672,34,33,2194.41,4092.02,0.00
2024-12-08 17:12:24,66,3672,33,33,2211.55,4092.11,0.00
2024-12-08 17:12:24,66,3673,33,33,2225.10,4093.00,0.00
2024-12-08 17:12:24,67,3673,33,34,2191.89,4093.02,0.00
2024-12-08 17:12:24,66,3673,32,34,2222.01,4093.05,0.00
2024-12-08 17:12:24,65,3673,32,33,2241.09,4093.11,0.00
2024-12-08 17:12:24,65,3674,32,33,2268.08,4094.00,0.00
2024-12-08 17:12:24,66,3674,32,34,2233.71,4094.02,0.00
2024-12-08 17:12:24,65,3674,31,34,2263.04,4094.06,0.00
2024-12-08 17:12:24,64,3674,30,34,2283.06,4094.11,0.00
2024-12-08 17:12:24,63,3674,29,34,2306.43,4094.41,0.00
2024-12-08 17:12:24,63,3675,29,34,2347.80,4095.00,0.00
2024-12-08 17:12:24,64,3675,29,35,2311.12,4095.02,0.00
2024-12-08 17:12:24,63,3675,29,34,2332.21,4095.10,0.00
2024-12-08 17:12:24,63,3676,29,34,2347.72,4096.00,0.00
2024-12-08 17:12:24,64,3676,29,35,2311.04,4096.02,0.00
2024-12-08 17:12:24,63,3676,28,35,2306.24,4096.40,0.00
2024-12-08 17:12:24,63,3677,28,35,2347.00,4097.00,0.00
2024-12-08 17:12:24,64,3677,29,35,2310.32,4097.02,0.00
2024-12-08 17:12:24,63,3677,28,35,2345.70,4097.05,0.00
2024-12-08 17:12:24,62,3677,27,35,2381.57,4097.10,0.00
2024-12-08 17:12:24,62,3678,27,35,2397.99,4098.00,0.00
2024-12-08 17:12:24,63,3678,27,36,2359.93,4098.02,0.00
2024-12-08 17:12:24,62,3678,27,35,2393.39,4098.11,0.00
2024-12-08 17:12:24,62,3679,27,35,2410.48,4099.00,0.00
2024-12-08 17:12:24,63,3679,28,35,2372.21,4099.02,0.00
2024-12-08 17:12:24,63,3680,28,35,2371.49,4100.00,0.00
2024-12-08 17:12:24,64,3680,29,35,2334.44,4100.02,0.00
2024-12-08 17:12:24,63,3680,29,34,2354.59,4100.11,0.00
2024-12-08 17:12:24,63,3681,29,34,2370.77,4101.00,0.00
2024-12-08 17:12:24,64,3681,30,34,2333.73,4101.02,0.00
2024-12-08 17:12:24,64,3682,30,34,2332.37,4102.00,0.00
2024-12-08 17:12:24,65,3682,30,35,2296.49,4102.02,0.00
2024-12-08 17:12:24,64,3682,29,35,2327.91,4102.13,0.00
2024-12-08 17:12:24,63,3682,29,34,2351.18,4102.13,0.00
2024-12-08 17:12:24,63,3683,29,34,2368.02,4103.00,0.00
2024-12-08 17:12:24,64,3683,30,34,2331.02,4103.02,0.00
2024-12-08 17:12:24,63,3683,29,34,2366.72,4103.03,0.00
2024-12-08 17:12:25,63,3684,29,34,2366.64,4104.00,0.00
2024-12-08 17:12:25,64,3684,30,34,2329.66,4104.02,0.00
2024-12-08 17:12:25,63,3684,30,33,2348.42,4104.13,0.00
2024-12-08 17:12:25,63,3685,30,33,2365.26,4105.00,0.00
2024-12-08 17:12:25,64,3685,31,33,2328.30,4105.02,0.00
2024-12-08 17:12:25,63,3685,30,33,2360.07,4105.13,0.00
2024-12-08 17:12:25,63,3686,30,33,2376.92,4106.00,0.00
2024-12-08 17:12:25,64,3686,31,33,2339.78,4106.02,0.00
2024-12-08 17:12:25,64,3687,31,33,2338.42,4107.00,0.00
2024-12-08 17:12:25,65,3687,32,33,2302.45,4107.02,0.00
2024-12-08 17:12:25,64,3687,31,33,2333.95,4107.13,0.00
2024-12-08 17:12:25,63,3687,31,32,2367.75,4107.16,0.00
2024-12-08 17:12:25,64,3686,31,33,2314.90,4107.58,0.00
2024-12-08 17:12:25,64,3687,31,33,2366.59,4108.00,0.00
2024-12-08 17:12:25,65,3687,32,33,2330.18,4108.02,0.00
2024-12-08 17:12:25,66,3686,33,33,2247.43,4108.91,0.00
2024-12-08 17:12:25,66,3687,33,33,2358.65,4109.00,0.00
2024-12-08 17:12:25,67,3687,33,34,2323.44,4109.02,0.00
2024-12-08 17:12:25,66,3687,32,34,2357.41,4109.03,0.00
2024-12-08 17:12:25,66,3688,32,34,2416.96,4110.00,0.00
2024-12-08 17:12:25,67,3688,33,34,2380.88,4110.02,0.00
2024-12-08 17:12:25,66,3688,33,33,2411.38,4110.14,0.00
2024-12-08 17:12:25,66,3689,33,33,2422.57,4111.00,0.00
2024-12-08 17:12:25,67,3689,34,33,2386.41,4111.02,0.00
2024-12-08 17:12:25,67,3690,34,33,2380.93,4112.00,0.00
2024-12-08 17:12:25,68,3690,34,34,2345.92,4112.02,0.00
2024-12-08 17:12:25,67,3690,34,33,2363.77,4112.13,0.00
2024-12-08 17:12:25,67,3691,34,33,2376.47,4113.00,0.00
2024-12-08 17:12:25,68,3691,35,33,2341.52,4113.02,0.00
2024-12-08 17:12:25,68,3692,35,33,2336.01,4114.00,0.00
2024-12-08 17:12:25,69,3692,35,34,2302.16,4114.02,0.00
2024-12-08 17:12:25,68,3692,35,33,2318.49,4114.15,0.00
2024-12-08 17:12:25,68,3693,35,33,2326.88,4115.00,0.00
2024-12-08 17:12:25,69,3693,36,33,2293.16,4115.02,0.00
2024-12-08 17:12:25,69,3694,36,33,2281.51,4116.00,0.00
2024-12-08 17:12:25,70,3694,36,34,2248.91,4116.01,0.00
2024-12-08 17:12:25,69,3694,36,33,2263.63,4116.15,0.00
2024-12-08 17:12:25,69,3695,36,33,2271.31,4117.00,0.00
2024-12-08 17:12:25,70,3695,37,33,2238.86,4117.01,0.00
2024-12-08 17:12:25,70,3696,37,33,2230.45,4118.00,0.00
2024-12-08 17:12:25,71,3696,37,34,2199.04,4118.01,0.00
2024-12-08 17:12:25,70,3696,36,34,2228.69,4118.06,0.00
2024-12-08 17:12:25,69,3696,35,34,2258.02,4118.13,0.00
2024-12-08 17:12:25,68,3696,35,33,2278.51,4118.13,0.00
2024-12-08 17:12:25,68,3697,35,33,2289.59,4119.00,0.00
2024-12-08 17:12:25,69,3697,36,33,2256.41,4119.02,0.00
2024-12-08 17:12:25,69,3698,36,33,2251.15,4120.00,0.00
2024-12-08 17:12:25,70,3698,37,33,2218.99,4120.01,0.00
2024-12-08 17:12:25,69,3698,37,32,2234.45,4120.13,0.00
2024-12-08 17:12:25,69,3699,37,32,2244.46,4121.00,0.00
2024-12-08 17:12:25,70,3699,37,33,2212.39,4121.01,0.00
2024-12-08 17:12:25,69,3699,36,33,2242.67,4121.06,0.00
2024-12-08 17:12:25,69,3700,36,33,2233.96,4122.00,0.00
2024-12-08 17:12:25,70,3700,36,34,2202.04,4122.01,0.00
2024-12-08 17:12:25,69,3700,36,33,2218.44,4122.12,0.00
2024-12-08 17:12:25,68,3700,35,33,2239.59,4122.25,0.00
2024-12-08 17:12:25,68,3701,35,33,2262.78,4123.00,0.00
2024-12-08 17:12:25,69,3701,35,34,2229.99,4123.02,0.00
2024-12-08 17:12:26,69,3702,35,34,2222.21,4124.00,0.00
2024-12-08 17:12:26,70,3702,36,34,2190.46,4124.01,0.00
2024-12-08 17:12:26,69,3702,35,34,2220.42,4124.06,0.00
2024-12-08 17:12:26,68,3702,34,34,2250.06,4124.13,0.00
2024-12-08 17:12:26,67,3702,34,33,2270.71,4124.13,0.00
2024-12-08 17:12:26,67,3703,34,33,2280.99,4125.00,0.00
2024-12-08 17:12:26,68,3703,34,34,2247.45,4125.02,0.00
2024-12-08 17:12:26,68,3704,34,34,2237.21,4126.00,0.00
2024-12-08 17:12:26,69,3704,34,35,2204.79,4126.02,0.00
2024-12-08 17:12:26,68,3704,34,34,2220.24,4126.13,0.00
2024-12-08 17:12:26,68,3705,34,34,2221.28,4127.00,0.00
2024-12-08 17:12:26,69,3705,34,35,2189.09,4127.02,0.00
2024-12-08 17:12:26,68,3705,33,35,2163.28,4127.74,0.00
2024-12-08 17:12:26,68,3706,33,35,2213.27,4128.00,0.00
2024-12-08 17:12:26,69,3706,34,35,2181.19,4128.02,0.00
2024-12-08 17:12:26,68,3706,34,34,2196.89,4128.13,0.00
2024-12-08 17:12:26,67,3706,33,34,2223.53,4128.19,0.00
2024-12-08 17:12:26,67,3707,33,34,2251.32,4129.00,0.00
2024-12-08 17:12:26,68,3707,33,35,2218.21,4129.02,0.00
2024-12-08 17:12:26,68,3708,33,35,2214.33,4130.00,0.00
2024-12-08 17:12:26,69,3708,33,36,2182.24,4130.02,0.00
2024-12-08 17:12:26,68,3708,33,35,2197.95,4130.13,0.00
2024-12-08 17:12:26,67,3708,32,35,2230.75,4130.13,0.00
2024-12-08 17:12:26,67,3709,32,35,2257.06,4131.00,0.00
2024-12-08 17:12:26,68,3709,33,35,2223.87,4131.02,0.00
2024-12-08 17:12:26,67,3709,33,34,2256.44,4131.02,0.00
2024-12-08 17:12:26,66,3709,33,33,2290.01,4131.02,0.00
2024-12-08 17:12:26,66,3710,33,33,2287.43,4132.00,0.00
2024-12-08 17:12:26,67,3710,33,34,2253.29,4132.02,0.00
2024-12-08 17:12:26,66,3710,32,34,2284.93,4132.06,0.00
2024-12-08 17:12:26,65,3710,32,33,2306.74,4132.09,0.00
2024-12-08 17:12:26,65,3711,32,33,2320.64,4133.00,0.00
2024-12-08 17:12:26,66,3711,33,33,2285.48,4133.02,0.00
2024-12-08 17:12:26,65,3711,32,33,2317.47,4133.09,0.00
2024-12-08 17:12:26,64,3711,31,33,2312.68,4133.73,0.00
2024-12-08 17:12:26,64,3712,31,33,2366.51,4134.00,0.00
2024-12-08 17:12:26,65,3712,31,34,2330.11,4134.02,0.00
2024-12-08 17:12:26,64,3712,31,33,2349.73,4134.09,0.00
2024-12-08 17:12:26,64,3713,31,33,2364.50,4135.00,0.00
2024-12-08 17:12:26,65,3713,32,33,2328.12,4135.02,0.00
2024-12-08 17:12:26,64,3713,31,33,2363.86,4135.02,0.00
2024-12-08 17:12:26,64,3714,31,33,2361.50,4136.00,0.00
2024-12-08 17:12:26,65,3714,31,34,2325.17,4136.02,0.00
2024-12-08 17:12:26,65,3715,31,34,2323.18,4137.00,0.00
2024-12-08 17:12:26,66,3715,32,34,2287.98,4137.02,0.00
2024-12-08 17:12:26,65,3715,32,33,2318.74,4137.11,0.00
2024-12-08 17:12:26,65,3716,32,33,2333.29,4138.00,0.00
2024-12-08 17:12:26,66,3716,32,34,2297.94,4138.02,0.00
2024-12-08 17:12:26,66,3717,32,34,2295.36,4139.00,0.00
2024-12-08 17:12:26,67,3717,33,34,2261.10,4139.02,0.00
2024-12-08 17:12:26,67,3718,33,34,2257.94,4140.00,0.00
2024-12-08 17:12:26,68,3718,33,35,2224.73,4140.02,0.00
2024-12-08 17:12:26,67,3718,33,34,2249.32,4140.16,0.00
2024-12-08 17:12:26,66,3718,32,34,2274.11,4140.39,0.00
2024-12-08 17:12:26,66,3719,32,34,2299.61,4141.00,0.00
2024-12-08 17:12:26,67,3719,33,34,2265.28,4141.02,0.00
2024-12-08 17:12:26,67,3720,33,34,2262.12,4142.00,0.00
2024-12-08 17:12:26,68,3720,33,35,2228.86,4142.02,0.00
2024-12-08 17:12:26,69,3719,33,36,2196.55,4142.04,0.00
2024-12-08 17:12:26,68,3719,32,36,2285.52,4142.06,0.00
2024-12-08 17:12:26,67,3719,31,36,2315.33,4142.15,0.00
2024-12-08 17:12:26,66,3719,30,36,2327.93,4142.39,0.00
2024-12-08 17:12:26,66,3720,30,36,2353.45,4143.00,0.00
2024-12-08 17:12:26,67,3720,30,37,2318.32,4143.02,0.00
2024-12-08 17:12:26,66,3720,30,36,2347.21,4143.14,0.00
2024-12-08 17:12:26,66,3721,30,36,2424.96,4144.00,0.00
2024-12-08 17:12:26,67,3721,31,36,2388.77,4144.02,0.00
2024-12-08 17:12:27,66,3721,30,36,2409.30,4144.12,0.00
2024-12-08 17:12:27,66,3722,30,36,2423.67,4145.00,0.00
2024-12-08 17:12:27,67,3722,31,36,2387.49,4145.02,0.00
2024-12-08 17:12:27,66,3722,31,35,2406.12,4145.12,0.00
2024-12-08 17:12:27,66,3723,31,35,2420.48,4146.00,0.00
2024-12-08 17:12:27,67,3723,32,35,2384.36,4146.02,0.00
2024-12-08 17:12:27,67,3724,32,35,2381.22,4147.00,0.00
2024-12-08 17:12:27,68,3724,32,36,2346.20,4147.02,0.00
2024-12-08 17:12:27,67,3724,32,35,2364.54,4147.12,0.00
2024-12-08 17:12:27,67,3725,32,35,2377.88,4148.00,0.00
2024-12-08 17:12:27,68,3725,33,35,2342.91,4148.02,0.00
2024-12-08 17:12:27,67,3725,32,35,2376.66,4148.03,0.00
2024-12-08 17:12:27,67,3726,32,35,2373.52,4149.00,0.00
2024-12-08 17:12:27,68,3726,32,36,2338.62,4149.02,0.00
2024-12-08 17:12:27,67,3726,32,35,2358.07,4149.10,0.00
2024-12-08 17:12:27,66,3726,32,34,2385.16,4149.29,0.00
2024-12-08 17:12:27,66,3727,32,34,2406.37,4150.00,0.00
2024-12-08 17:12:27,67,3727,32,35,2370.46,4150.02,0.00
2024-12-08 17:12:27,67,3728,32,35,2367.31,4151.00,0.00
2024-12-08 17:12:27,68,3728,33,35,2332.49,4151.02,0.00
2024-12-08 17:12:27,68,3729,33,35,2328.78,4152.00,0.00
2024-12-08 17:12:27,69,3729,34,35,2295.03,4152.02,0.00
2024-12-08 17:12:27,68,3729,34,34,2313.55,4152.12,0.00
2024-12-08 17:12:27,68,3730,34,34,2326.29,4153.00,0.00
2024-12-08 17:12:27,69,3730,34,35,2292.58,4153.02,0.00
2024-12-08 17:12:27,69,3731,34,35,2288.31,4154.00,0.00
2024-12-08 17:12:27,70,3731,35,35,2255.62,4154.01,0.00
2024-12-08 17:12:27,69,3731,35,34,2273.89,4154.12,0.00
2024-12-08 17:12:27,69,3732,35,34,2285.85,4155.00,0.00
2024-12-08 17:12:27,70,3732,36,34,2253.20,4155.01,0.00
2024-12-08 17:12:27,70,3733,36,34,2248.40,4156.00,0.00
2024-12-08 17:12:27,71,3733,37,34,2216.73,4156.01,0.00
2024-12-08 17:12:27,70,3733,36,34,2247.22,4156.04,0.00
2024-12-08 17:12:27,69,3733,36,33,2267.76,4156.10,0.00
2024-12-08 17:12:27,68,3733,35,33,2276.95,4156.69,0.00
2024-12-08 17:12:27,68,3734,35,33,2313.25,4157.00,0.00
2024-12-08 17:12:27,69,3734,35,34,2279.72,4157.02,0.00
2024-12-08 17:12:27,70,3733,35,35,2247.16,4157.04,0.00
2024-12-08 17:12:27,70,3734,35,35,2251.85,4158.00,0.00
2024-12-08 17:12:27,71,3734,35,36,2220.14,4158.01,0.00
2024-12-08 17:12:27,70,3734,35,35,2239.41,4158.10,0.00
2024-12-08 17:12:27,70,3735,35,35,2309.43,4159.00,0.00
2024-12-08 17:12:27,71,3735,36,35,2276.91,4159.01,0.00
2024-12-08 17:12:27,71,3736,36,35,2271.59,4160.00,0.00
2024-12-08 17:12:27,72,3736,36,36,2240.04,4160.01,0.00
2024-12-08 17:12:27,71,3736,35,36,2268.69,4160.07,0.00
2024-12-08 17:12:27,70,3736,35,35,2292.18,4160.09,0.00
2024-12-08 17:12:27,70,3737,35,35,2302.22,4161.00,0.00
2024-12-08 17:12:27,71,3737,36,35,2269.80,4161.01,0.00
2024-12-08 17:12:27,71,3738,36,35,2264.48,4162.00,0.00
2024-12-08 17:12:27,72,3738,36,36,2233.03,4162.01,0.00
2024-12-08 17:12:27,71,3738,35,36,2263.32,4162.03,0.00
2024-12-08 17:12:27,70,3738,35,35,2286.15,4162.07,0.00
2024-12-08 17:12:27,70,3739,35,35,2295.60,4163.00,0.00
2024-12-08 17:12:27,71,3739,35,36,2263.26,4163.01,0.00
2024-12-08 17:12:27,71,3740,35,36,2257.94,4164.00,0.00
2024-12-08 17:12:27,72,3740,36,36,2226.58,4164.01,0.00
2024-12-08 17:12:27,71,3740,35,36,2254.44,4164.04,0.00
2024-12-08 17:12:27,70,3740,35,35,2278.91,4164.06,0.00
2024-12-08 17:12:28,70,3741,35,35,2299.67,4165.00,0.00
2024-12-08 17:12:28,71,3741,36,35,2267.28,4165.01,0.00
2024-12-08 17:12:28,71,3742,36,35,2261.96,4166.00,0.00
2024-12-08 17:12:28,72,3742,37,35,2230.55,4166.01,0.00
2024-12-08 17:12:28,71,3742,37,34,2253.76,4166.06,0.00
2024-12-08 17:12:28,71,3743,37,34,2261.92,4167.00,0.00
2024-12-08 17:12:28,72,3743,37,35,2230.50,4167.01,0.00
2024-12-08 17:12:28,71,3743,36,35,2244.93,4167.14,0.00
2024-12-08 17:12:28,71,3744,36,35,2256.59,4168.00,0.00
2024-12-08 17:12:28,72,3744,37,35,2225.25,4168.01,0.00
2024-12-08 17:12:28,71,3744,37,34,2254.84,4168.04,0.00
2024-12-08 17:12:28,70,3744,37,33,2279.91,4168.06,0.00
2024-12-08 17:12:28,70,3745,37,33,2288.78,4169.00,0.00
2024-12-08 17:12:28,71,3745,38,33,2256.54,4169.01,0.00
2024-12-08 17:12:28,70,3745,37,33,2271.55,4169.14,0.00
2024-12-08 17:12:28,70,3746,37,33,2283.97,4170.00,0.00
2024-12-08 17:12:28,71,3746,37,34,2251.80,4170.01,0.00
2024-12-08 17:12:28,70,3746,37,33,2268.51,4170.13,0.00
2024-12-08 17:12:28,70,3747,37,33,2280.34,4171.00,0.00
2024-12-08 17:12:28,71,3747,38,33,2248.23,4171.01,0.00
2024-12-08 17:12:28,70,3747,37,33,2267.86,4171.10,0.00
2024-12-08 17:12:28,70,3748,37,33,2278.51,4172.00,0.00
2024-12-08 17:12:28,71,3748,37,34,2246.42,4172.01,0.00
2024-12-08 17:12:28,70,3748,37,33,2263.64,4172.11,0.00
2024-12-08 17:12:28,70,3749,37,33,2274.88,4173.00,0.00
2024-12-08 17:12:28,71,3749,38,33,2242.84,4173.01,0.00
2024-12-08 17:12:28,71,3750,38,33,2237.50,4174.00,0.00
2024-12-08 17:12:28,72,3750,39,33,2206.42,4174.01,0.00
2024-12-08 17:12:28,71,3750,39,32,2221.07,4174.14,0.00
2024-12-08 17:12:28,70,3750,38,32,2252.80,4174.14,0.00
2024-12-08 17:12:28,70,3751,38,32,2265.24,4175.00,0.00
2024-12-08 17:12:28,71,3751,39,32,2233.33,4175.01,0.00
2024-12-08 17:12:28,70,3751,38,32,2228.39,4175.37,0.00
2024-12-08 17:12:28,70,3752,38,32,2262.20,4176.00,0.00
2024-12-08 17:12:28,71,3752,38,33,2230.34,4176.01,0.00
2024-12-08 17:12:28,70,3752,37,33,2261.02,4176.03,0.00
2024-12-08 17:12:28,69,3752,37,32,2278.07,4176.13,0.00
2024-12-08 17:12:28,69,3753,37,32,2290.69,4177.00,0.00
2024-12-08 17:12:28,70,3753,38,32,2257.97,4177.01,0.00
2024-12-08 17:12:28,70,3754,38,32,2253.14,4178.00,0.00
2024-12-08 17:12:28,71,3754,38,33,2221.40,4178.01,0.00
2024-12-08 17:12:28,70,3754,37,33,2252.55,4178.03,0.00
2024-12-08 17:12:28,69,3754,37,32,2270.08,4178.12,0.00
2024-12-08 17:12:28,68,3754,36,32,2292.51,4178.38,0.00
2024-12-08 17:12:28,68,3755,36,32,2316.27,4179.00,0.00
2024-12-08 17:12:28,69,3755,36,33,2282.70,4179.02,0.00
2024-12-08 17:12:28,69,3756,36,33,2278.40,4180.00,0.00
2024-12-08 17:12:28,70,3756,37,33,2245.85,4180.01,0.00
2024-12-08 17:12:28,69,3756,37,32,2262.08,4180.13,0.00
2024-12-08 17:12:28,69,3757,37,32,2274.71,4181.00,0.00
2024-12-08 17:12:28,70,3757,38,32,2242.21,4181.01,0.00
2024-12-08 17:12:28,70,3758,38,32,2237.37,4182.00,0.00
2024-12-08 17:12:28,71,3758,39,32,2205.86,4182.01,0.00
2024-12-08 17:12:28,70,3758,39,31,2219.48,4182.16,0.00
2024-12-08 17:12:28,69,3758,38,31,2242.05,4182.39,0.00
2024-12-08 17:12:28,69,3759,38,31,2265.49,4183.00,0.00
2024-12-08 17:12:28,70,3759,39,31,2233.12,4183.01,0.00
2024-12-08 17:12:28,70,3760,39,31,2228.28,4184.00,0.00
2024-12-08 17:12:28,71,3760,39,32,2196.89,4184.01,0.00
2024-12-08 17:12:28,70,3760,38,32,2227.10,4184.04,0.00
2024-12-08 17:12:28,69,3760,38,31,2243.62,4184.15,0.00
2024-12-08 17:12:29,69,3761,38,31,2256.87,4185.00,0.00
2024-12-08 17:12:29,70,3761,38,32,2224.63,4185.01,0.00
2024-12-08 17:12:29,70,3762,38,32,2219.78,4186.00,0.00
2024-12-08 17:12:29,71,3762,39,32,2188.51,4186.01,0.00
2024-12-08 17:12:29,70,3762,39,31,2203.66,4186.14,0.00
2024-12-08 17:12:29,69,3762,38,31,2224.07,4186.15,0.00
2024-12-08 17:12:29,69,3763,38,31,2249.45,4187.00,0.00
2024-12-08 17:12:29,70,3763,38,32,2217.32,4187.01,0.00
2024-12-08 17:12:29,69,3763,37,32,2208.93,4187.41,0.00
2024-12-08 17:12:29,69,3764,37,32,2245.13,4188.00,0.00
2024-12-08 17:12:29,70,3764,38,32,2213.06,4188.01,0.00
2024-12-08 17:12:29,69,3764,38,31,2228.77,4188.15,0.00
2024-12-08 17:12:29,68,3764,37,31,2259.71,4188.18,0.00
2024-12-08 17:12:29,68,3765,37,31,2287.32,4189.00,0.00
2024-12-08 17:12:29,69,3765,38,31,2254.17,4189.02,0.00
2024-12-08 17:12:29,69,3766,38,31,2249.85,4190.00,0.00
2024-12-08 17:12:29,70,3766,39,31,2217.71,4190.01,0.00
2024-12-08 17:12:29,69,3766,39,30,2234.08,4190.15,0.00
2024-12-08 17:12:29,69,3767,39,30,2247.35,4191.00,0.00
2024-12-08 17:12:29,70,3767,40,30,2215.24,4191.01,0.00
2024-12-08 17:12:29,70,3768,40,30,2210.38,4192.00,0.00
2024-12-08 17:12:29,71,3768,41,30,2179.25,4192.01,0.00
2024-12-08 17:12:29,70,3768,40,30,2207.40,4192.09,0.00
2024-12-08 17:12:29,69,3768,40,29,2227.85,4192.13,0.00
2024-12-08 17:12:29,69,3769,40,29,2240.52,4193.00,0.00
2024-12-08 17:12:29,70,3769,41,29,2208.51,4193.01,0.00
2024-12-08 17:12:29,70,3770,41,29,2203.65,4194.00,0.00
2024-12-08 17:12:29,71,3770,41,30,2172.61,4194.01,0.00
2024-12-08 17:12:29,70,3770,41,29,2189.28,4194.13,0.00
2024-12-08 17:12:29,70,3771,41,29,2201.18,4195.00,0.00
2024-12-08 17:12:29,71,3771,42,29,2170.17,4195.01,0.00
2024-12-08 17:12:29,71,3772,42,29,2164.78,4196.00,0.00
2024-12-08 17:12:29,72,3772,43,29,2134.72,4196.01,0.00
2024-12-08 17:12:29,71,3772,43,28,2151.20,4196.13,0.00
2024-12-08 17:12:29,71,3773,43,28,2162.34,4197.00,0.00
2024-12-08 17:12:29,72,3773,43,29,2132.31,4197.01,0.00
2024-12-08 17:12:29,71,3773,42,29,2120.09,4197.73,0.00
2024-12-08 17:12:29,71,3774,42,29,2168.18,4198.00,0.00
2024-12-08 17:12:29,72,3774,43,29,2138.06,4198.01,0.00
2024-12-08 17:12:29,71,3774,42,29,2165.23,4198.08,0.00
2024-12-08 17:12:29,70,3774,42,28,2185.97,4198.11,0.00
2024-12-08 17:12:29,70,3775,42,28,2197.28,4199.00,0.00
2024-12-08 17:12:29,71,3775,43,28,2166.33,4199.01,0.00
2024-12-08 17:12:29,71,3776,43,28,2160.93,4200.00,0.00
2024-12-08 17:12:29,72,3776,43,29,2130.92,4200.01,0.00
2024-12-08 17:12:29,71,3776,42,29,2159.75,4200.03,0.00
2024-12-08 17:12:29,70,3776,41,29,2188.81,4200.07,0.00
2024-12-08 17:12:29,69,3776,40,29,2219.92,4200.07,0.00
2024-12-08 17:12:29,68,3776,40,28,2242.69,4200.09,0.00
2024-12-08 17:12:29,68,3777,40,28,2254.33,4201.00,0.00
2024-12-08 17:12:29,69,3777,40,29,2221.66,4201.02,0.00
2024-12-08 17:12:29,69,3778,40,29,2217.32,4202.00,0.00
2024-12-08 17:12:29,70,3778,40,30,2185.64,4202.01,0.00
2024-12-08 17:12:29,69,3778,40,29,2205.15,4202.09,0.00
2024-12-08 17:12:29,68,3778,39,29,2219.12,4202.32,0.00
2024-12-08 17:12:29,67,3778,38,29,2248.53,4202.42,0.00
2024-12-08 17:12:29,67,3779,38,29,2287.18,4203.00,0.00
2024-12-08 17:12:29,68,3779,39,29,2253.55,4203.02,0.00
2024-12-08 17:12:29,67,3779,38,29,2265.27,4203.19,0.00
2024-12-08 17:12:29,67,3780,38,29,2294.63,4204.00,0.00
2024-12-08 17:12:29,68,3780,39,29,2260.89,4204.02,0.00
2024-12-08 17:12:29,67,3780,38,29,2293.38,4204.03,0.00
2024-12-08 17:12:29,66,3780,38,28,2316.67,4204.08,0.00
2024-12-08 17:12:29,66,3781,38,28,2329.32,4205.00,0.00
2024-12-08 17:12:29,67,3781,39,28,2294.55,4205.02,0.00
2024-12-08 17:12:30,67,3782,39,28,2291.33,4206.00,0.00
2024-12-08 17:12:30,68,3782,39,29,2257.63,4206.02,0.00
2024-12-08 17:12:30,67,3782,39,28,2278.79,4206.09,0.00
2024-12-08 17:12:30,67,3783,39,28,2291.24,4207.00,0.00
2024-12-08 17:12:30,68,3783,40,28,2257.55,4207.02,0.00
2024-12-08 17:12:30,67,3783,39,28,2290.00,4207.03,0.00
2024-12-08 17:12:30,67,3784,39,28,2287.39,4208.00,0.00
2024-12-08 17:12:30,68,3784,39,29,2253.75,4208.02,0.00
2024-12-08 17:12:30,67,3784,39,28,2275.47,4208.08,0.00
2024-12-08 17:12:30,67,3785,39,28,2287.31,4209.00,0.00
2024-12-08 17:12:30,68,3785,40,28,2253.67,4209.02,0.00
2024-12-08 17:12:30,68,3786,40,28,2249.87,4210.00,0.00
2024-12-08 17:12:30,69,3786,40,29,2217.27,4210.02,0.00
2024-12-08 17:12:30,68,3786,39,29,2248.64,4210.03,0.00
2024-12-08 17:12:30,67,3786,39,28,2272.78,4210.06,0.00
2024-12-08 17:12:30,67,3787,39,28,2284.00,4211.00,0.00
2024-12-08 17:12:30,68,3787,39,29,2250.41,4211.02,0.00
2024-12-08 17:12:30,67,3787,38,29,2277.09,4211.05,0.00
2024-12-08 17:12:30,67,3788,38,29,2287.68,4212.00,0.00
2024-12-08 17:12:30,68,3788,38,30,2254.04,4212.02,0.00
2024-12-08 17:12:30,67,3788,38,29,2278.89,4212.05,0.00
2024-12-08 17:12:30,66,3788,37,29,2305.12,4212.05,0.00
2024-12-08 17:12:30,66,3789,37,29,2329.28,4213.00,0.00
2024-12-08 17:12:30,67,3789,37,30,2294.51,4213.02,0.00
2024-12-08 17:12:30,67,3790,37,30,2291.28,4214.00,0.00
2024-12-08 17:12:30,68,3790,37,31,2257.59,4214.02,0.00
2024-12-08 17:12:30,67,3790,36,31,2290.66,4214.03,0.00
2024-12-08 17:12:30,66,3790,36,30,2316.43,4214.03,0.00
2024-12-08 17:12:30,66,3791,36,30,2327.19,4215.00,0.00
2024-12-08 17:12:30,67,3791,37,30,2292.46,4215.02,0.00
2024-12-08 17:12:30,67,3792,37,30,2289.23,4216.00,0.00
2024-12-08 17:12:30,68,3792,37,31,2255.56,4216.02,0.00
2024-12-08 17:12:30,67,3792,37,30,2279.17,4216.05,0.00
2024-12-08 17:12:30,66,3792,36,30,2309.89,4216.12,0.00
2024-12-08 17:12:30,66,3793,36,30,2324.46,4217.00,0.00
2024-12-08 17:12:30,67,3793,36,31,2289.77,4217.02,0.00
2024-12-08 17:12:30,67,3794,36,31,2286.53,4218.00,0.00
2024-12-08 17:12:30,68,3794,36,32,2252.91,4218.02,0.00
2024-12-08 17:12:30,67,3794,36,31,2277.10,4218.05,0.00
2024-12-08 17:12:30,67,3795,36,31,2287.71,4219.00,0.00
2024-12-08 17:12:30,68,3795,37,31,2254.06,4219.02,0.00
2024-12-08 17:12:30,68,3796,37,31,2250.25,4220.00,0.00
2024-12-08 17:12:30,69,3796,37,32,2217.64,4220.02,0.00
2024-12-08 17:12:30,68,3796,37,31,2239.10,4220.07,0.00
2024-12-08 17:12:30,67,3796,36,31,2270.01,4220.13,0.00
2024-12-08 17:12:30,66,3796,35,31,2285.30,4220.35,0.00
2024-12-08 17:12:30,66,3797,35,31,2322.19,4221.00,0.00
2024-12-08 17:12:30,67,3797,35,32,2287.53,4221.02,0.00
2024-12-08 17:12:30,67,3798,35,32,2284.29,4222.00,0.00
2024-12-08 17:12:30,68,3798,35,33,2250.70,4222.02,0.00
2024-12-08 17:12:30,67,3798,35,32,2271.07,4222.09,0.00
2024-12-08 17:12:30,67,3799,35,32,2283.57,4223.00,0.00
2024-12-08 17:12:30,68,3799,36,32,2249.99,4223.02,0.00
2024-12-08 17:12:30,68,3800,36,32,2246.17,4224.00,0.00
2024-12-08 17:12:30,69,3800,36,33,2213.62,4224.02,0.00
2024-12-08 17:12:30,68,3800,36,32,2234.38,4224.09,0.00
2024-12-08 17:12:30,68,3801,36,32,2246.08,4225.00,0.00
2024-12-08 17:12:30,69,3801,37,32,2213.53,4225.02,0.00
2024-12-08 17:12:31,69,3802,37,32,2209.16,4226.00,0.00
2024-12-08 17:12:31,70,3802,37,33,2177.60,4226.01,0.00
2024-12-08 17:12:31,69,3802,37,32,2198.14,4226.09,0.00
2024-12-08 17:12:31,68,3802,36,32,2204.64,4226.71,0.00
2024-12-08 17:12:31,68,3803,36,32,2242.17,4227.00,0.00
2024-12-08 17:12:31,69,3803,37,32,2209.68,4227.02,0.00
2024-12-08 17:12:31,68,3803,36,32,2223.56,4227.16,0.00
2024-12-08 17:12:31,68,3804,36,32,2238.35,4228.00,0.00
2024-12-08 17:12:31,69,3804,37,32,2205.91,4228.02,0.00
2024-12-08 17:12:31,68,3804,37,31,2227.17,4228.09,0.00
2024-12-08 17:12:31,68,3805,37,31,2238.88,4229.00,0.00
2024-12-08 17:12:31,69,3805,38,31,2206.43,4229.02,0.00
2024-12-08 17:12:31,68,3805,37,31,2238.26,4229.03,0.00
2024-12-08 17:12:31,67,3805,36,31,2241.40,4229.15,0.00
2024-12-08 17:12:31,67,3806,36,31,2269.05,4230.00,0.00
2024-12-08 17:12:31,68,3806,37,31,2235.68,4230.02,0.00
2024-12-08 17:12:31,67,3806,37,30,2258.32,4230.08,0.00
2024-12-08 17:12:31,66,3806,36,30,2289.99,4230.14,0.00
2024-12-08 17:12:31,66,3807,36,30,2305.25,4231.00,0.00
2024-12-08 17:12:31,67,3807,36,31,2270.85,4231.02,0.00
2024-12-08 17:12:31,67,3808,36,31,2267.59,4232.00,0.00
2024-12-08 17:12:31,68,3808,37,31,2234.25,4232.02,0.00
2024-12-08 17:12:31,67,3808,36,31,2266.97,4232.03,0.00
2024-12-08 17:12:31,66,3808,36,30,2292.34,4232.06,0.00
2024-12-08 17:12:31,65,3808,35,30,2325.02,4232.12,0.00
2024-12-08 17:12:31,65,3809,35,30,2340.52,4233.00,0.00
2024-12-08 17:12:31,66,3809,35,31,2305.06,4233.02,0.00
2024-12-08 17:12:31,66,3810,35,31,2302.40,4234.00,0.00
2024-12-08 17:12:31,67,3810,36,31,2268.03,4234.02,0.00
2024-12-08 17:12:31,66,3810,36,30,2290.22,4234.09,0.00
2024-12-08 17:12:31,66,3811,36,30,2303.58,4235.00,0.00
2024-12-08 17:12:31,67,3811,36,31,2269.20,4235.02,0.00
2024-12-08 17:12:31,66,3811,35,31,2302.31,4235.05,0.00
2024-12-08 17:12:31,66,3812,35,31,2300.92,4236.00,0.00
2024-12-08 17:12:31,67,3812,36,31,2266.58,4236.02,0.00
2024-12-08 17:12:31,66,3812,36,30,2288.73,4236.08,0.00
2024-12-08 17:12:31,66,3813,36,30,2301.46,4237.00,0.00
2024-12-08 17:12:31,67,3813,36,31,2267.11,4237.02,0.00
2024-12-08 17:12:31,68,3812,36,32,2233.77,4237.04,0.00
2024-12-08 17:12:31,67,3812,35,32,2291.17,4237.10,0.00
2024-12-08 17:12:31,67,3813,35,32,2316.98,4238.00,0.00
2024-12-08 17:12:31,68,3813,36,32,2282.91,4238.02,0.00
2024-12-08 17:12:31,67,3813,35,32,2296.79,4238.15,0.00
2024-12-08 17:12:31,67,3814,35,32,2387.76,4239.00,0.00
2024-12-08 17:12:31,68,3814,35,33,2352.64,4239.02,0.00
2024-12-08 17:12:31,67,3814,35,32,2372.60,4239.10,0.00
2024-12-08 17:12:31,67,3815,35,32,2385.79,4240.00,0.00
2024-12-08 17:12:31,68,3815,35,33,2350.71,4240.02,0.00
2024-12-08 17:12:31,68,3816,35,33,2346.89,4241.00,0.00
2024-12-08 17:12:31,69,3816,36,33,2312.88,4241.02,0.00
2024-12-08 17:12:31,68,3816,36,32,2331.95,4241.10,0.00
2024-12-08 17:12:31,67,3816,35,32,2350.35,4241.30,0.00
2024-12-08 17:12:31,67,3817,35,32,2384.38,4242.00,0.00
2024-12-08 17:12:31,68,3817,35,33,2349.32,4242.02,0.00
2024-12-08 17:12:31,68,3818,35,33,2345.51,4243.00,0.00
2024-12-08 17:12:31,69,3818,36,33,2311.51,4243.02,0.00
2024-12-08 17:12:31,68,3818,36,32,2331.18,4243.10,0.00
2024-12-08 17:12:31,67,3818,35,32,2364.08,4243.13,0.00
2024-12-08 17:12:31,67,3819,35,32,2391.21,4244.00,0.00
2024-12-08 17:12:31,68,3819,35,33,2356.04,4244.02,0.00
2024-12-08 17:12:31,67,3819,34,33,2362.58,4244.25,0.00
2024-12-08 17:12:31,67,3820,34,33,2394.76,4245.00,0.00
2024-12-08 17:12:31,68,3820,34,34,2359.54,4245.02,0.00
2024-12-08 17:12:31,67,3820,34,33,2377.04,4245.13,0.00
2024-12-08 17:12:32,67,3821,34,33,2389.40,4246.00,0.00
2024-12-08 17:12:32,68,3821,35,33,2354.26,4246.02,0.00
2024-12-08 17:12:32,67,3821,34,33,2387.52,4246.06,0.00
2024-12-08 17:12:32,66,3821,33,33,2406.98,4246.14,0.00
2024-12-08 17:12:32,66,3822,33,33,2420.61,4247.00,0.00
2024-12-08 17:12:32,67,3822,34,33,2384.48,4247.02,0.00
2024-12-08 17:12:32,66,3822,34,32,2406.02,4247.14,0.00
2024-12-08 17:12:32,66,3823,34,32,2421.36,4248.00,0.00
2024-12-08 17:12:32,67,3823,34,33,2385.22,4248.02,0.00
2024-12-08 17:12:32,67,3824,34,33,2380.74,4249.00,0.00
2024-12-08 17:12:32,68,3824,35,33,2345.73,4249.02,0.00
2024-12-08 17:12:32,68,3825,35,33,2339.11,4250.00,0.00
2024-12-08 17:12:32,69,3825,36,33,2305.21,4250.02,0.00
2024-12-08 17:12:32,68,3825,35,33,2333.51,4250.15,0.00
2024-12-08 17:12:32,67,3825,35,32,2363.91,4250.18,0.00
2024-12-08 17:12:32,67,3826,35,32,2379.27,4251.00,0.00
2024-12-08 17:12:32,68,3826,35,33,2344.28,4251.02,0.00
2024-12-08 17:12:32,67,3826,34,33,2373.59,4251.15,0.00
2024-12-08 17:12:32,67,3827,34,33,2375.25,4252.00,0.00
2024-12-08 17:12:32,68,3827,34,34,2340.32,4252.02,0.00
2024-12-08 17:12:32,67,3827,33,34,2374.00,4252.03,0.00
2024-12-08 17:12:32,66,3827,33,33,2408.68,4252.05,0.00
2024-12-08 17:12:32,66,3828,33,33,2406.49,4253.00,0.00
2024-12-08 17:12:32,67,3828,34,33,2370.57,4253.02,0.00
2024-12-08 17:12:32,66,3828,34,32,2396.86,4253.17,0.00
2024-12-08 17:12:32,66,3829,34,32,2412.63,4254.00,0.00
2024-12-08 17:12:32,67,3829,35,32,2376.62,4254.02,0.00
2024-12-08 17:12:32,67,3830,35,32,2372.45,4255.00,0.00
2024-12-08 17:12:32,68,3830,35,33,2337.56,4255.02,0.00
2024-12-08 17:12:32,67,3830,34,33,2362.33,4255.18,0.00
2024-12-08 17:12:32,67,3831,34,33,2377.76,4256.00,0.00
2024-12-08 17:12:32,68,3831,34,34,2342.80,4256.02,0.00
2024-12-08 17:12:32,67,3831,34,33,2367.64,4256.18,0.00
2024-12-08 17:12:32,66,3831,33,33,2395.21,4256.38,0.00
2024-12-08 17:12:32,67,3830,33,34,2346.31,4256.72,0.00
2024-12-08 17:12:32,67,3831,33,34,2395.75,4257.00,0.00
2024-12-08 17:12:32,68,3831,34,34,2360.52,4257.02,0.00
2024-12-08 17:12:32,67,3831,33,34,2369.11,4257.22,0.00
2024-12-08 17:12:32,67,3832,33,34,2461.23,4258.00,0.00
2024-12-08 17:12:32,68,3832,34,34,2425.03,4258.02,0.00
2024-12-08 17:12:32,68,3833,34,34,2415.03,4259.00,0.00
2024-12-08 17:12:32,69,3833,34,35,2380.03,4259.02,0.00
2024-12-08 17:12:32,68,3833,33,35,2385.71,4259.40,0.00
2024-12-08 17:12:32,68,3834,33,35,2408.68,4260.00,0.00
2024-12-08 17:12:32,69,3834,34,35,2373.77,4260.02,0.00
2024-12-08 17:12:32,68,3834,34,34,2401.80,4260.09,0.00
2024-12-08 17:12:32,68,3835,34,34,2413.63,4261.00,0.00
2024-12-08 17:12:32,69,3835,35,34,2378.65,4261.02,0.00
2024-12-08 17:12:32,68,3835,35,33,2406.76,4261.16,0.00
2024-12-08 17:12:32,68,3836,35,33,2419.23,4262.00,0.00
2024-12-08 17:12:32,69,3836,35,34,2384.17,4262.02,0.00
2024-12-08 17:12:32,68,3836,34,34,2417.37,4262.06,0.00
2024-12-08 17:12:32,68,3837,34,34,2407.32,4263.00,0.00
2024-12-08 17:12:32,69,3837,34,35,2372.43,4263.02,0.00
2024-12-08 17:12:32,68,3837,33,35,2405.45,4263.06,0.00
2024-12-08 17:12:32,67,3837,33,34,2425.46,4263.13,0.00
2024-12-08 17:12:32,67,3838,33,34,2435.03,4264.00,0.00
2024-12-08 17:12:32,68,3838,33,35,2399.22,4264.02,0.00
2024-12-08 17:12:32,67,3838,32,35,2433.77,4264.03,0.00
2024-12-08 17:12:32,66,3838,31,35,2466.78,4264.12,0.00
2024-12-08 17:12:32,66,3839,31,35,2467.32,4265.00,0.00
2024-12-08 17:12:32,67,3839,31,36,2430.49,4265.02,0.00
2024-12-08 17:12:32,67,3840,31,36,2427.10,4266.00,0.00
2024-12-08 17:12:32,68,3840,32,36,2391.41,4266.02,0.00
2024-12-08 17:12:32,67,3840,32,35,2422.03,4266.12,0.00
2024-12-08 17:12:33,67,3841,32,35,2435.35,4267.00,0.00
2024-12-08 17:12:33,68,3841,32,36,2399.53,4267.02,0.00
2024-12-08 17:12:33,68,3842,32,36,2394.27,4268.00,0.00
2024-12-08 17:12:33,69,3842,33,36,2359.57,4268.02,0.00
2024-12-08 17:12:33,68,3842,33,35,2376.09,4268.13,0.00
2024-12-08 17:12:33,68,3843,33,35,2387.72,4269.00,0.00
2024-12-08 17:12:33,69,3843,33,36,2353.11,4269.02,0.00
2024-12-08 17:12:33,68,3843,32,36,2386.47,4269.04,0.00
2024-12-08 17:12:33,68,3844,32,36,2381.57,4270.00,0.00
2024-12-08 17:12:33,69,3844,33,36,2347.05,4270.02,0.00
2024-12-08 17:12:33,68,3844,33,35,2363.38,4270.13,0.00
2024-12-08 17:12:33,68,3845,33,35,2374.90,4271.00,0.00
2024-12-08 17:12:33,69,3845,34,35,2340.48,4271.02,0.00
2024-12-08 17:12:33,68,3845,33,35,2373.03,4271.04,0.00
2024-12-08 17:12:33,67,3845,32,35,2369.04,4271.37,0.00
2024-12-08 17:12:33,66,3845,31,35,2392.05,4271.64,0.00
2024-12-08 17:12:33,66,3846,31,35,2441.51,4272.00,0.00
2024-12-08 17:12:33,67,3846,31,36,2405.07,4272.02,0.00
2024-12-08 17:12:33,68,3845,32,36,2369.70,4272.04,0.00
2024-12-08 17:12:33,67,3845,32,35,2410.20,4272.13,0.00
2024-12-08 17:12:33,67,3846,32,35,2424.77,4273.00,0.00
2024-12-08 17:12:33,68,3846,33,35,2389.11,4273.02,0.00
2024-12-08 17:12:33,67,3846,32,35,2418.41,4273.08,0.00
2024-12-08 17:12:33,67,3847,32,35,2494.23,4274.00,0.00
2024-12-08 17:12:33,68,3847,33,35,2457.55,4274.02,0.00
2024-12-08 17:12:33,67,3847,32,35,2492.97,4274.03,0.00
2024-12-08 17:12:33,66,3847,32,34,2515.85,4274.09,0.00
2024-12-08 17:12:33,66,3848,32,34,2529.37,4275.00,0.00
2024-12-08 17:12:33,67,3848,32,35,2491.62,4275.02,0.00
2024-12-08 17:12:33,67,3849,32,35,2488.38,4276.00,0.00
2024-12-08 17:12:33,68,3849,32,36,2451.78,4276.02,0.00
2024-12-08 17:12:33,67,3849,31,36,2487.75,4276.03,0.00
2024-12-08 17:12:33,66,3849,31,35,2511.85,4276.08,0.00
2024-12-08 17:12:33,66,3850,31,35,2524.73,4277.00,0.00
2024-12-08 17:12:33,67,3850,32,35,2487.04,4277.02,0.00
2024-12-08 17:12:33,67,3851,32,35,2483.79,4278.00,0.00
2024-12-08 17:12:33,68,3851,33,35,2447.27,4278.02,0.00
2024-12-08 17:12:33,67,3851,33,34,2470.40,4278.08,0.00
2024-12-08 17:12:33,67,3852,33,34,2482.46,4279.00,0.00
2024-12-08 17:12:33,68,3852,34,34,2445.95,4279.02,0.00
2024-12-08 17:12:33,69,3851,34,35,2361.16,4279.62,0.00
2024-12-08 17:12:33,69,3852,34,35,2459.45,4280.00,0.00
2024-12-08 17:12:33,70,3852,34,36,2424.31,4280.01,0.00
2024-12-08 17:12:33,69,3852,34,35,2446.44,4280.07,0.00
2024-12-08 17:12:33,69,3853,34,35,2518.96,4281.00,0.00
2024-12-08 17:12:33,70,3853,34,36,2482.98,4281.01,0.00
2024-12-08 17:12:33,69,3853,33,36,2508.43,4281.03,0.00
2024-12-08 17:12:33,69,3854,33,36,2517.07,4282.00,0.00
2024-12-08 17:12:33,70,3854,34,36,2481.11,4282.01,0.00
2024-12-08 17:12:33,69,3854,34,35,2505.29,4282.06,0.00
2024-12-08 17:12:33,68,3854,33,35,2503.40,4282.68,0.00
2024-12-08 17:12:33,68,3855,33,35,2552.79,4283.00,0.00
2024-12-08 17:12:33,69,3855,34,35,2515.80,4283.02,0.00
2024-12-08 17:12:33,69,3856,34,35,2511.42,4284.00,0.00
2024-12-08 17:12:33,70,3856,35,35,2475.54,4284.01,0.00
2024-12-08 17:12:33,69,3856,35,34,2500.26,4284.06,0.00
2024-12-08 17:12:33,68,3856,34,34,2535.15,4284.10,0.00
2024-12-08 17:12:33,68,3857,34,34,2547.68,4285.00,0.00
2024-12-08 17:12:33,69,3857,34,35,2510.76,4285.02,0.00
2024-12-08 17:12:33,69,3858,34,35,2506.38,4286.00,0.00
2024-12-08 17:12:33,70,3858,35,35,2470.57,4286.01,0.00
2024-12-08 17:12:33,69,3858,35,34,2495.21,4286.06,0.00
2024-12-08 17:12:34,69,3859,35,34,2505.10,4287.00,0.00
2024-12-08 17:12:34,70,3859,35,35,2469.31,4287.01,0.00
2024-12-08 17:12:34,69,3859,34,35,2487.11,4287.13,0.00
2024-12-08 17:12:34,69,3860,34,35,2500.09,4288.00,0.00
2024-12-08 17:12:34,70,3860,34,36,2464.37,4288.01,0.00
2024-12-08 17:12:34,69,3860,33,36,2499.48,4288.03,0.00
2024-12-08 17:12:34,68,3860,33,35,2526.78,4288.04,0.00
2024-12-08 17:12:34,68,3861,33,35,2536.82,4289.00,0.00
2024-12-08 17:12:34,69,3861,34,35,2500.05,4289.02,0.00
2024-12-08 17:12:34,68,3861,33,35,2513.52,4289.18,0.00
2024-12-08 17:12:34,68,3862,33,35,2541.82,4290.00,0.00
2024-12-08 17:12:34,69,3862,33,36,2504.99,4290.02,0.00
2024-12-08 17:12:34,68,3862,32,36,2541.21,4290.03,0.00
2024-12-08 17:12:34,67,3862,32,35,2570.81,4290.03,0.00
2024-12-08 17:12:34,67,3863,32,35,2581.00,4291.00,0.00
2024-12-08 17:12:34,68,3863,32,36,2543.05,4291.02,0.00
2024-12-08 17:12:34,67,3863,31,36,2552.85,4291.09,0.00
2024-12-08 17:12:34,67,3864,31,36,2578.40,4292.00,0.00
2024-12-08 17:12:34,68,3864,31,37,2540.48,4292.02,0.00
2024-12-08 17:12:34,67,3864,31,36,2569.45,4292.03,0.00
2024-12-08 17:12:34,67,3865,31,36,2579.64,4293.00,0.00
2024-12-08 17:12:34,68,3865,32,36,2541.71,4293.02,0.00
2024-12-08 17:12:34,67,3865,31,36,2570.69,4293.03,0.00
2024-12-08 17:12:34,66,3865,30,36,2594.68,4293.08,0.00
2024-12-08 17:12:34,66,3866,30,36,2620.64,4294.00,0.00
2024-12-08 17:12:34,67,3866,31,36,2581.53,4294.02,0.00
2024-12-08 17:12:34,66,3866,31,35,2611.54,4294.03,0.00
2024-12-08 17:12:34,66,3867,31,35,2622.55,4295.00,0.00
2024-12-08 17:12:34,67,3867,31,36,2583.41,4295.02,0.00
2024-12-08 17:12:34,67,3868,31,36,2580.16,4296.00,0.00
2024-12-08 17:12:34,68,3868,31,37,2542.22,4296.02,0.00
2024-12-08 17:12:34,67,3868,31,36,2568.64,4296.05,0.00
2024-12-08 17:12:34,67,3869,31,36,2579.48,4297.00,0.00
2024-12-08 17:12:34,68,3869,32,36,2541.55,4297.02,0.00
2024-12-08 17:12:34,68,3870,32,36,2537.71,4298.00,0.00
2024-12-08 17:12:34,69,3870,32,37,2500.94,4298.02,0.00
2024-12-08 17:12:34,68,3870,32,36,2526.35,4298.04,0.00
2024-12-08 17:12:34,67,3870,31,36,2548.17,4298.40,0.00
2024-12-08 17:12:34,67,3871,31,36,2574.27,4299.00,0.00
2024-12-08 17:12:34,68,3871,31,37,2536.41,4299.02,0.00
2024-12-08 17:12:34,68,3872,31,37,2532.57,4300.00,0.00
2024-12-08 17:12:34,69,3872,32,37,2495.87,4300.02,0.00
2024-12-08 17:12:34,68,3872,32,36,2521.20,4300.04,0.00
2024-12-08 17:12:34,68,3873,32,36,2531.26,4301.00,0.00
2024-12-08 17:12:34,69,3873,33,36,2494.58,4301.02,0.00
2024-12-08 17:12:34,69,3874,33,36,2490.17,4302.00,0.00
2024-12-08 17:12:34,70,3874,33,37,2454.60,4302.01,0.00
2024-12-08 17:12:34,70,3875,33,37,2449.64,4303.00,0.00
2024-12-08 17:12:34,71,3875,34,37,2415.13,4303.01,0.00
2024-12-08 17:12:34,70,3875,34,36,2439.20,4303.06,0.00
2024-12-08 17:12:34,70,3876,34,36,2448.36,4304.00,0.00
2024-12-08 17:12:34,71,3876,35,36,2413.88,4304.01,0.00
2024-12-08 17:12:34,71,3877,35,36,2408.37,4305.00,0.00
2024-12-08 17:12:34,72,3877,36,36,2374.92,4305.01,0.00
2024-12-08 17:12:34,71,3877,36,35,2398.68,4305.06,0.00
2024-12-08 17:12:35,71,3878,36,35,2407.11,4306.00,0.00
2024-12-08 17:12:35,72,3878,36,36,2373.68,4306.01,0.00
2024-12-08 17:12:35,72,3879,36,36,2367.65,4307.00,0.00
2024-12-08 17:12:35,73,3879,36,37,2335.22,4307.01,0.00
2024-12-08 17:12:35,72,3879,36,36,2357.50,4307.07,0.00
2024-12-08 17:12:35,71,3879,35,36,2382.85,4307.20,0.00
2024-12-08 17:12:35,71,3880,35,36,2409.45,4308.00,0.00
2024-12-08 17:12:35,72,3880,36,36,2375.98,4308.01,0.00
2024-12-08 17:12:35,71,3880,35,36,2408.24,4308.03,0.00
2024-12-08 17:12:35,71,3881,35,36,2403.33,4309.00,0.00
2024-12-08 17:12:35,72,3881,36,36,2369.95,4309.01,0.00
2024-12-08 17:12:35,71,3881,36,35,2394.24,4309.06,0.00
2024-12-08 17:12:35,72,3880,37,35,2342.61,4309.51,0.00
2024-12-08 17:12:35,72,3881,37,35,2390.25,4310.00,0.00
2024-12-08 17:12:35,73,3881,38,35,2357.51,4310.01,0.00
2024-12-08 17:12:35,72,3881,37,35,2360.36,4310.15,0.00
2024-12-08 17:12:35,72,3882,37,35,2444.10,4311.00,0.00
2024-12-08 17:12:35,73,3882,37,36,2410.62,4311.01,0.00
2024-12-08 17:12:35,72,3882,37,35,2434.53,4311.07,0.00
2024-12-08 17:12:35,72,3883,37,35,2442.87,4312.00,0.00
2024-12-08 17:12:35,73,3883,37,36,2409.40,4312.01,0.00
2024-12-08 17:12:35,72,3883,36,36,2437.49,4312.04,0.00
2024-12-08 17:12:35,72,3884,36,36,2444.63,4313.00,0.00
2024-12-08 17:12:35,73,3884,37,36,2411.14,4313.01,0.00
2024-12-08 17:12:35,72,3884,37,35,2435.06,4313.07,0.00
2024-12-08 17:12:35,71,3884,36,35,2465.73,4313.14,0.00
2024-12-08 17:12:35,71,3885,36,35,2477.81,4314.00,0.00
2024-12-08 17:12:35,72,3885,37,35,2443.40,4314.01,0.00
2024-12-08 17:12:35,72,3886,37,35,2437.37,4315.00,0.00
2024-12-08 17:12:35,73,3886,37,36,2403.99,4315.01,0.00
2024-12-08 17:12:35,72,3886,36,36,2431.99,4315.04,0.00
2024-12-08 17:12:35,72,3887,36,36,2439.14,4316.00,0.00
2024-12-08 17:12:35,73,3887,36,37,2405.73,4316.01,0.00
2024-12-08 17:12:35,72,3887,35,37,2437.95,4316.03,0.00
2024-12-08 17:12:35,71,3887,35,36,2465.60,4316.04,0.00
2024-12-08 17:12:35,71,3888,35,36,2473.46,4317.00,0.00
2024-12-08 17:12:35,72,3888,36,36,2439.10,4317.01,0.00
2024-12-08 17:12:35,71,3888,36,35,2464.35,4317.06,0.00
2024-12-08 17:12:35,71,3889,36,35,2472.81,4318.00,0.00
2024-12-08 17:12:35,72,3889,36,36,2438.47,4318.01,0.00
2024-12-08 17:12:35,71,3889,35,36,2455.22,4318.14,0.00
2024-12-08 17:12:35,70,3889,34,36,2479.31,4318.40,0.00
2024-12-08 17:12:35,70,3890,34,36,2503.17,4319.00,0.00
2024-12-08 17:12:35,71,3890,35,36,2467.91,4319.01,0.00
2024-12-08 17:12:35,70,3890,35,35,2493.31,4319.06,0.00
2024-12-08 17:12:35,70,3891,35,35,2502.51,4320.00,0.00
2024-12-08 17:12:35,71,3891,35,36,2467.27,4320.01,0.00
2024-12-08 17:12:35,70,3891,34,36,2461.32,4320.40,0.00
2024-12-08 17:12:35,70,3892,34,36,2497.54,4321.00,0.00
2024-12-08 17:12:35,71,3892,34,37,2462.36,4321.01,0.00
2024-12-08 17:12:35,70,3892,34,36,2488.29,4321.06,0.00
2024-12-08 17:12:36,70,3893,34,36,2497.50,4322.00,0.00
2024-12-08 17:12:36,71,3893,35,36,2462.32,4322.01,0.00
2024-12-08 17:12:36,71,3894,35,36,2456.80,4323.00,0.00
2024-12-08 17:12:36,72,3894,36,36,2422.68,4323.01,0.00
2024-12-08 17:12:36,71,3894,35,36,2455.59,4323.03,0.00
2024-12-08 17:12:36,70,3894,35,35,2481.42,4323.06,0.00
2024-12-08 17:12:36,70,3895,35,35,2490.62,4324.00,0.00
2024-12-08 17:12:36,71,3895,35,36,2455.54,4324.01,0.00
2024-12-08 17:12:36,70,3895,34,36,2461.13,4324.41,0.00
2024-12-08 17:12:36,70,3896,34,36,2485.64,4325.00,0.00
2024-12-08 17:12:36,71,3896,35,36,2450.63,4325.01,0.00
2024-12-08 17:12:36,70,3896,35,35,2476.39,4325.06,0.00
2024-12-08 17:12:36,70,3897,35,35,2485.60,4326.00,0.00
2024-12-08 17:12:36,71,3897,36,35,2450.59,4326.01,0.00
2024-12-08 17:12:36,71,3898,36,35,2445.06,4327.00,0.00
2024-12-08 17:12:36,72,3898,36,36,2411.10,4327.01,0.00
2024-12-08 17:12:36,71,3898,35,36,2444.46,4327.03,0.00
2024-12-08 17:12:36,70,3898,35,35,2472.58,4327.04,0.00
2024-12-08 17:12:36,70,3899,35,35,2481.18,4328.00,0.00
2024-12-08 17:12:36,71,3899,36,35,2446.23,4328.01,0.00
2024-12-08 17:12:36,71,3900,36,35,2440.70,4329.00,0.00
2024-12-08 17:12:36,72,3900,37,35,2406.80,4329.01,0.00
2024-12-08 17:12:36,71,3900,37,34,2432.79,4329.04,0.00
2024-12-08 17:12:36,71,3901,37,34,2440.66,4330.00,0.00
2024-12-08 17:12:36,72,3901,37,35,2406.76,4330.01,0.00
2024-12-08 17:12:36,72,3902,37,35,2400.70,4331.00,0.00
2024-12-08 17:12:36,73,3902,38,35,2367.81,4331.01,0.00
2024-12-08 17:12:36,72,3902,38,34,2391.68,4331.06,0.00
2024-12-08 17:12:36,72,3903,38,34,2399.45,4332.00,0.00
2024-12-08 17:12:36,73,3903,39,34,2366.58,4332.01,0.00
2024-12-08 17:12:36,72,3903,38,34,2368.80,4332.17,0.00
2024-12-08 17:12:36,72,3904,38,34,2393.38,4333.00,0.00
2024-12-08 17:12:36,73,3904,38,35,2360.59,4333.01,0.00
2024-12-08 17:12:36,72,3904,38,34,2384.96,4333.06,0.00
2024-12-08 17:12:36,72,3905,38,34,2392.73,4334.00,0.00
2024-12-08 17:12:36,73,3905,38,35,2359.95,4334.01,0.00
2024-12-08 17:12:36,73,3906,38,35,2353.37,4335.00,0.00
2024-12-08 17:12:36,74,3906,39,35,2321.57,4335.01,0.00
2024-12-08 17:12:36,73,3906,39,34,2345.66,4335.06,0.00
2024-12-08 17:12:36,73,3907,39,34,2352.72,4336.00,0.00
2024-12-08 17:12:36,74,3907,39,35,2320.93,4336.01,0.00
2024-12-08 17:12:36,73,3907,38,35,2331.95,4336.07,0.00
2024-12-08 17:12:36,73,3908,38,35,2351.49,4337.00,0.00
2024-12-08 17:12:36,74,3908,39,35,2319.71,4337.01,0.00
2024-12-08 17:12:36,73,3908,39,34,2344.36,4337.06,0.00
2024-12-08 17:12:36,73,3909,39,34,2351.43,4338.00,0.00
2024-12-08 17:12:36,74,3909,40,34,2319.66,4338.01,0.00
2024-12-08 17:12:36,73,3909,39,34,2331.27,4338.19,0.00
2024-12-08 17:12:36,73,3910,39,34,2344.25,4339.00,0.00
2024-12-08 17:12:36,74,3910,39,35,2312.57,4339.01,0.00
2024-12-08 17:12:36,73,3910,39,34,2337.12,4339.06,0.00
2024-12-08 17:12:36,73,3911,39,34,2344.19,4340.00,0.00
2024-12-08 17:12:36,74,3911,39,35,2312.52,4340.01,0.00
2024-12-08 17:12:36,73,3911,38,35,2342.42,4340.04,0.00
2024-12-08 17:12:36,73,3912,38,35,2337.00,4341.00,0.00
2024-12-08 17:12:36,74,3912,39,35,2305.42,4341.01,0.00
2024-12-08 17:12:36,73,3912,39,34,2329.88,4341.06,0.00
2024-12-08 17:12:36,72,3912,38,34,2342.43,4341.33,0.00
2024-12-08 17:12:36,72,3913,38,34,2374.23,4342.00,0.00
2024-12-08 17:12:36,73,3913,38,35,2341.71,4342.01,0.00
2024-12-08 17:12:37,73,3914,38,35,2335.11,4343.00,0.00
2024-12-08 17:12:37,74,3914,38,36,2303.55,4343.01,0.00
2024-12-08 17:12:37,73,3914,38,35,2326.78,4343.07,0.00
2024-12-08 17:12:37,73,3915,38,35,2334.45,4344.00,0.00
2024-12-08 17:12:37,74,3915,38,36,2302.91,4344.01,0.00
2024-12-08 17:12:37,73,3915,37,36,2314.26,4344.19,0.00
2024-12-08 17:12:37,73,3916,37,36,2327.25,4345.00,0.00
2024-12-08 17:12:37,74,3916,38,36,2295.80,4345.01,0.00
2024-12-08 17:12:37,73,3916,38,35,2316.56,4345.11,0.00
2024-12-08 17:12:37,73,3917,38,35,2326.00,4346.00,0.00
2024-12-08 17:12:37,74,3917,39,35,2294.57,4346.01,0.00
2024-12-08 17:12:37,73,3917,38,35,2323.03,4346.04,0.00
2024-12-08 17:12:37,72,3917,37,35,2336.62,4346.18,0.00
2024-12-08 17:12:37,72,3918,37,35,2361.87,4347.00,0.00
2024-12-08 17:12:37,73,3918,37,36,2329.52,4347.01,0.00
2024-12-08 17:12:37,72,3918,37,35,2352.23,4347.10,0.00
2024-12-08 17:12:37,72,3919,37,35,2361.81,4348.00,0.00
2024-12-08 17:12:37,73,3919,38,35,2329.46,4348.01,0.00
2024-12-08 17:12:37,72,3919,37,35,2353.96,4348.03,0.00
2024-12-08 17:12:37,72,3920,37,35,2360.54,4349.00,0.00
2024-12-08 17:12:37,73,3920,38,35,2328.20,4349.01,0.00
2024-12-08 17:12:37,72,3920,38,34,2350.89,4349.08,0.00
2024-12-08 17:12:37,71,3920,37,34,2367.61,4349.45,0.00
2024-12-08 17:12:37,71,3921,37,34,2393.11,4350.00,0.00
2024-12-08 17:12:37,72,3921,38,34,2359.87,4350.01,0.00
2024-12-08 17:12:37,73,3920,39,34,2327.55,4350.04,0.00
2024-12-08 17:12:37,72,3920,38,34,2405.81,4350.04,0.00
2024-12-08 17:12:37,72,3921,38,34,2400.91,4351.00,0.00
2024-12-08 17:12:37,73,3921,38,35,2368.02,4351.01,0.00
2024-12-08 17:12:37,72,3921,38,34,2392.46,4351.07,0.00
2024-12-08 17:12:37,72,3922,38,34,2461.30,4352.00,0.00
2024-12-08 17:12:37,73,3922,39,34,2427.58,4352.01,0.00
2024-12-08 17:12:37,72,3922,38,34,2460.10,4352.03,0.00
2024-12-08 17:12:37,72,3923,38,34,2454.61,4353.00,0.00
2024-12-08 17:12:37,73,3923,39,34,2420.98,4353.01,0.00
2024-12-08 17:12:37,72,3923,39,33,2447.37,4353.06,0.00
2024-12-08 17:12:37,72,3924,39,33,2455.17,4354.00,0.00
2024-12-08 17:12:37,73,3924,40,33,2421.54,4354.01,0.00
2024-12-08 17:12:37,72,3924,39,33,2454.58,4354.03,0.00
2024-12-08 17:12:37,72,3925,39,33,2449.08,4355.00,0.00
2024-12-08 17:12:37,73,3925,40,33,2415.53,4355.01,0.00
2024-12-08 17:12:37,72,3925,40,32,2440.63,4355.06,0.00
2024-12-08 17:12:37,71,3925,39,32,2459.20,4355.42,0.00
2024-12-08 17:12:37,71,3926,39,32,2483.53,4356.00,0.00
2024-12-08 17:12:37,72,3926,40,32,2449.04,4356.01,0.00
2024-12-08 17:12:37,72,3927,40,32,2442.95,4357.00,0.00
2024-12-08 17:12:37,73,3927,41,32,2409.48,4357.01,0.00
2024-12-08 17:12:37,72,3927,41,31,2434.49,4357.06,0.00
2024-12-08 17:12:37,72,3928,41,31,2442.30,4358.00,0.00
2024-12-08 17:12:37,73,3928,42,31,2408.84,4358.01,0.00
2024-12-08 17:12:37,73,3929,42,31,2402.23,4359.00,0.00
2024-12-08 17:12:37,74,3929,43,31,2369.76,4359.01,0.00
2024-12-08 17:12:37,73,3929,43,30,2394.48,4359.06,0.00
2024-12-08 17:12:37,72,3929,42,30,2394.68,4359.63,0.00
2024-12-08 17:12:37,72,3930,42,30,2439.18,4360.00,0.00
2024-12-08 17:12:37,73,3930,43,30,2405.76,4360.01,0.00
2024-12-08 17:12:37,72,3930,42,30,2408.45,4360.44,0.00
2024-12-08 17:12:37,72,3931,42,30,2433.07,4361.00,0.00
2024-12-08 17:12:37,73,3931,42,31,2399.74,4361.01,0.00
2024-12-08 17:12:37,72,3931,42,30,2424.61,4361.07,0.00
2024-12-08 17:12:37,72,3932,42,30,2433.03,4362.00,0.00
2024-12-08 17:12:37,73,3932,42,31,2399.70,4362.01,0.00
2024-12-08 17:12:37,72,3932,41,31,2431.22,4362.04,0.00
2024-12-08 17:12:38,71,3932,40,31,2447.07,4362.18,0.00
2024-12-08 17:12:38,71,3933,40,31,2461.10,4363.00,0.00
2024-12-08 17:12:38,72,3933,40,32,2426.92,4363.01,0.00
2024-12-08 17:12:38,71,3933,40,31,2453.74,4363.06,0.00
2024-12-08 17:12:38,70,3933,39,31,2472.74,4363.43,0.00
2024-12-08 17:12:38,70,3934,39,31,2498.08,4364.00,0.00
2024-12-08 17:12:38,71,3934,40,31,2462.89,4364.01,0.00
2024-12-08 17:12:38,71,3935,40,31,2457.20,4365.00,0.00
2024-12-08 17:12:38,72,3935,41,31,2423.07,4365.01,0.00
2024-12-08 17:12:38,71,3935,41,30,2450.45,4365.06,0.00
2024-12-08 17:12:38,70,3935,40,30,2437.01,4365.94,0.00
2024-12-08 17:12:38,70,3936,40,30,2496.93,4366.00,0.00
2024-12-08 17:12:38,71,3936,40,31,2461.76,4366.01,0.00
2024-12-08 17:12:38,71,3937,40,31,2455.67,4367.00,0.00
2024-12-08 17:12:38,72,3937,41,31,2421.57,4367.01,0.00
2024-12-08 17:12:38,71,3937,41,30,2447.70,4367.07,0.00
2024-12-08 17:12:38,70,3937,40,30,2471.45,4367.13,0.00
2024-12-08 17:12:38,70,3938,40,30,2495.60,4368.00,0.00
2024-12-08 17:12:38,71,3938,40,31,2460.45,4368.01,0.00
2024-12-08 17:12:38,71,3939,40,31,2453.86,4369.00,0.00
2024-12-08 17:12:38,72,3939,41,31,2419.78,4369.01,0.00
2024-12-08 17:12:38,71,3939,41,30,2446.49,4369.07,0.00
2024-12-08 17:12:38,71,3940,41,30,2454.42,4370.00,0.00
2024-12-08 17:12:38,72,3940,42,30,2420.33,4370.01,0.00
2024-12-08 17:12:38,71,3940,41,30,2453.20,4370.04,0.00
2024-12-08 17:12:38,70,3940,40,30,2485.12,4370.04,0.00
2024-12-08 17:12:38,70,3941,40,30,2492.35,4371.00,0.00
2024-12-08 17:12:38,71,3941,40,31,2457.25,4371.01,0.00
2024-12-08 17:12:38,70,3941,39,31,2486.75,4371.04,0.00
2024-12-08 17:12:38,69,3941,39,30,2517.72,4371.04,0.00
2024-12-08 17:12:38,69,3942,39,30,2538.08,4372.00,0.00
2024-12-08 17:12:38,70,3942,40,30,2501.83,4372.01,0.00
2024-12-08 17:12:38,70,3943,40,30,2494.55,4373.00,0.00
2024-12-08 17:12:38,71,3943,40,31,2459.41,4373.01,0.00
2024-12-08 17:12:38,70,3943,40,30,2488.94,4373.04,0.00
2024-12-08 17:12:38,69,3943,39,30,2479.31,4373.73,0.00
2024-12-08 17:12:38,69,3944,39,30,2530.89,4374.00,0.00
2024-12-08 17:12:38,70,3944,39,31,2494.74,4374.01,0.00
2024-12-08 17:12:38,70,3945,39,31,2484.31,4375.00,0.00
2024-12-08 17:12:38,71,3945,40,31,2449.32,4375.01,0.00
2024-12-08 17:12:38,72,3944,41,31,2374.87,4375.69,0.00
2024-12-08 17:12:38,72,3945,41,31,2417.21,4376.00,0.00
2024-12-08 17:12:38,73,3945,42,31,2384.09,4376.01,0.00
2024-12-08 17:12:38,72,3945,42,30,2406.90,4376.10,0.00
2024-12-08 17:12:38,72,3946,42,30,2466.55,4377.00,0.00
2024-12-08 17:12:38,73,3946,43,30,2432.77,4377.01,0.00
2024-12-08 17:12:38,72,3946,43,29,2404.59,4377.67,0.00
2024-12-08 17:12:38,72,3947,43,29,2451.07,4378.00,0.00
2024-12-08 17:12:38,73,3947,44,29,2417.49,4378.01,0.00
2024-12-08 17:12:38,72,3947,44,28,2441.36,4378.10,0.00
2024-12-08 17:12:38,72,3948,44,28,2451.02,4379.00,0.00
2024-12-08 17:12:38,73,3948,44,29,2417.45,4379.01,0.00
2024-12-08 17:12:38,72,3948,43,29,2441.31,4379.10,0.00
2024-12-08 17:12:38,72,3949,43,29,2450.97,4380.00,0.00
2024-12-08 17:12:38,73,3949,44,29,2417.40,4380.01,0.00
2024-12-08 17:12:38,72,3949,43,29,2440.05,4380.11,0.00
2024-12-08 17:12:38,71,3949,43,28,2467.01,4380.11,0.00
2024-12-08 17:12:38,71,3950,43,28,2490.38,4381.00,0.00
2024-12-08 17:12:38,72,3950,43,29,2455.79,4381.01,0.00
2024-12-08 17:12:38,72,3951,43,29,2449.66,4382.00,0.00
2024-12-08 17:12:38,73,3951,43,30,2416.10,4382.01,0.00
2024-12-08 17:12:38,72,3951,43,29,2447.84,4382.04,0.00
2024-12-08 17:12:38,71,3951,43,28,2473.07,4382.10,0.00
2024-12-08 17:12:39,71,3952,43,28,2483.49,4383.00,0.00
2024-12-08 17:12:39,72,3952,43,29,2449.00,4383.01,0.00
2024-12-08 17:12:39,71,3952,42,29,2481.65,4383.04,0.00
2024-12-08 17:12:39,71,3953,42,29,2477.27,4384.00,0.00
2024-12-08 17:12:39,72,3953,43,29,2442.86,4384.01,0.00
2024-12-08 17:12:39,71,3953,43,28,2466.17,4384.10,0.00
2024-12-08 17:12:39,70,3953,42,28,2460.50,4384.87,0.00
2024-12-08 17:12:39,70,3954,42,28,2517.62,4385.00,0.00
2024-12-08 17:12:39,71,3954,42,29,2482.16,4385.01,0.00
2024-12-08 17:12:39,71,3955,42,29,2476.55,4386.00,0.00
2024-12-08 17:12:39,72,3955,42,30,2442.15,4386.01,0.00
2024-12-08 17:12:39,71,3955,42,29,2466.06,4386.10,0.00
2024-12-08 17:12:39,71,3956,42,29,2476.49,4387.00,0.00
2024-12-08 17:12:39,72,3956,43,29,2442.10,4387.01,0.00
2024-12-08 17:12:39,71,3956,42,29,2456.15,4387.20,0.00
2024-12-08 17:12:39,71,3957,42,29,2470.88,4388.00,0.00
2024-12-08 17:12:39,72,3957,43,29,2436.56,4388.01,0.00
2024-12-08 17:12:39,71,3957,43,28,2459.77,4388.11,0.00
2024-12-08 17:12:39,71,3958,43,28,2470.82,4389.00,0.00
2024-12-08 17:12:39,72,3958,44,28,2436.50,4389.01,0.00
2024-12-08 17:12:39,72,3959,44,28,2430.35,4390.00,0.00
2024-12-08 17:12:39,73,3959,44,29,2397.06,4390.01,0.00
2024-12-08 17:12:39,72,3959,43,29,2429.75,4390.03,0.00
2024-12-08 17:12:39,71,3959,43,28,2454.09,4390.10,0.00
2024-12-08 17:12:39,71,3960,43,28,2464.53,4391.00,0.00
2024-12-08 17:12:39,72,3960,44,28,2430.30,4391.01,0.00
2024-12-08 17:12:39,71,3960,43,28,2442.93,4391.21,0.00
2024-12-08 17:12:39,71,3961,43,28,2458.28,4392.00,0.00
2024-12-08 17:12:39,72,3961,43,29,2424.14,4392.01,0.00
2024-12-08 17:12:39,71,3961,43,28,2448.40,4392.10,0.00
2024-12-08 17:12:39,71,3962,43,28,2458.84,4393.00,0.00
2024-12-08 17:12:39,72,3962,43,29,2424.69,4393.01,0.00
2024-12-08 17:12:39,72,3963,43,29,2418.53,4394.00,0.00
2024-12-08 17:12:39,73,3963,44,29,2385.40,4394.01,0.00
2024-12-08 17:12:39,72,3963,43,29,2416.10,4394.07,0.00
2024-12-08 17:12:39,71,3963,43,28,2442.09,4394.10,0.00
2024-12-08 17:12:39,71,3964,43,28,2452.53,4395.00,0.00
2024-12-08 17:12:39,72,3964,44,28,2418.47,4395.01,0.00
2024-12-08 17:12:39,72,3965,44,28,2412.30,4396.00,0.00
2024-12-08 17:12:39,73,3965,45,28,2379.26,4396.01,0.00
2024-12-08 17:12:39,72,3965,45,27,2400.73,4396.11,0.00
2024-12-08 17:12:39,72,3966,45,27,2411.02,4397.00,0.00
2024-12-08 17:12:39,73,3966,46,27,2377.99,4397.01,0.00
2024-12-08 17:12:39,73,3967,46,27,2371.30,4398.00,0.00
2024-12-08 17:12:39,74,3967,46,28,2339.26,4398.01,0.00
2024-12-08 17:12:39,73,3967,46,27,2358.08,4398.14,0.00
2024-12-08 17:12:39,73,3968,46,27,2368.83,4399.00,0.00
2024-12-08 17:12:39,74,3968,47,27,2336.82,4399.01,0.00
2024-12-08 17:12:39,73,3968,46,27,2348.39,4399.21,0.00
2024-12-08 17:12:39,73,3969,46,27,2374.19,4400.00,0.00
2024-12-08 17:12:39,74,3969,46,28,2342.11,4400.01,0.00
2024-12-08 17:12:39,73,3969,46,27,2360.35,4400.14,0.00
2024-12-08 17:12:39,73,3970,46,27,2371.11,4401.00,0.00
2024-12-08 17:12:39,74,3970,47,27,2339.07,4401.01,0.00
2024-12-08 17:12:39,73,3970,46,27,2337.40,4401.22,0.00
2024-12-08 17:12:39,73,3971,46,27,2363.81,4402.00,0.00
2024-12-08 17:12:39,74,3971,47,27,2331.87,4402.01,0.00
2024-12-08 17:12:40,73,3971,47,26,2350.57,4402.14,0.00
2024-12-08 17:12:40,73,3972,47,26,2361.33,4403.00,0.00
2024-12-08 17:12:40,74,3972,48,26,2329.42,4403.01,0.00
2024-12-08 17:12:40,74,3973,48,26,2322.22,4404.00,0.00
2024-12-08 17:12:40,75,3973,49,26,2291.25,4404.01,0.00
2024-12-08 17:12:40,74,3973,48,26,2321.03,4404.03,0.00
2024-12-08 17:12:40,73,3973,47,26,2341.38,4404.12,0.00
2024-12-08 17:12:40,72,3973,47,25,2365.94,4404.13,0.00
2024-12-08 17:12:40,72,3974,47,25,2389.10,4405.00,0.00
2024-12-08 17:12:40,73,3974,47,26,2356.37,4405.01,0.00
2024-12-08 17:12:40,72,3974,46,26,2387.88,4405.03,0.00
2024-12-08 17:12:40,72,3975,46,26,2382.30,4406.00,0.00
2024-12-08 17:12:40,73,3975,46,27,2349.66,4406.01,0.00
2024-12-08 17:12:40,72,3975,46,26,2368.42,4406.13,0.00
2024-12-08 17:12:40,71,3975,45,26,2382.62,4406.37,0.00
2024-12-08 17:12:40,71,3976,45,26,2417.20,4407.00,0.00
2024-12-08 17:12:40,72,3976,45,27,2383.63,4407.01,0.00
2024-12-08 17:12:40,72,3977,45,27,2377.44,4408.00,0.00
2024-12-08 17:12:40,73,3977,46,27,2344.87,4408.01,0.00
2024-12-08 17:12:40,72,3977,46,26,2364.60,4408.13,0.00
2024-12-08 17:12:40,71,3977,45,26,2372.12,4408.72,0.00
2024-12-08 17:12:40,71,3978,45,26,2409.60,4409.00,0.00
2024-12-08 17:12:40,72,3978,45,27,2376.14,4409.01,0.00
2024-12-08 17:12:40,71,3978,44,27,2408.81,4409.03,0.00
2024-12-08 17:12:40,70,3978,43,27,2441.34,4409.07,0.00
2024-12-08 17:12:40,70,3979,43,27,2438.73,4410.00,0.00
2024-12-08 17:12:40,71,3979,44,27,2404.38,4410.01,0.00
2024-12-08 17:12:40,70,3979,44,26,2426.78,4410.10,0.00
2024-12-08 17:12:40,70,3980,44,26,2438.02,4411.00,0.00
2024-12-08 17:12:40,71,3980,44,27,2403.68,4411.01,0.00
2024-12-08 17:12:40,71,3981,44,27,2398.01,4412.00,0.00
2024-12-08 17:12:40,72,3981,45,27,2364.71,4412.01,0.00
2024-12-08 17:12:40,71,3981,45,26,2386.84,4412.10,0.00
2024-12-08 17:12:40,71,3982,45,26,2397.31,4413.00,0.00
2024-12-08 17:12:40,72,3982,46,26,2364.02,4413.01,0.00
2024-12-08 17:12:40,72,3983,46,26,2357.81,4414.00,0.00
2024-12-08 17:12:40,73,3983,46,27,2325.51,4414.01,0.00
2024-12-08 17:12:40,72,3983,46,26,2347.40,4414.10,0.00
2024-12-08 17:12:40,71,3983,45,26,2373.00,4414.10,0.00
2024-12-08 17:12:40,71,3984,45,26,2395.91,4415.00,0.00
2024-12-08 17:12:40,72,3984,45,27,2362.64,4415.01,0.00
2024-12-08 17:12:40,71,3984,44,27,2390.95,4415.08,0.00
2024-12-08 17:12:40,71,3985,44,27,2400.81,4416.00,0.00
2024-12-08 17:12:40,72,3985,45,27,2367.47,4416.01,0.00
2024-12-08 17:12:40,71,3985,45,26,2389.63,4416.10,0.00
2024-12-08 17:12:40,71,3986,45,26,2400.11,4417.00,0.00
2024-12-08 17:12:40,72,3986,46,26,2366.77,4417.01,0.00
2024-12-08 17:12:40,71,3986,45,26,2398.87,4417.03,0.00
2024-12-08 17:12:40,70,3986,44,26,2426.23,4417.19,0.00
2024-12-08 17:12:40,70,3987,44,26,2428.64,4418.00,0.00
2024-12-08 17:12:40,71,3987,44,27,2394.43,4418.01,0.00
2024-12-08 17:12:40,72,3986,45,27,2361.17,4418.04,0.00
2024-12-08 17:12:40,71,3986,44,27,2405.79,4418.45,0.00
2024-12-08 17:12:40,71,3987,44,27,2431.69,4419.00,0.00
2024-12-08 17:12:40,72,3987,44,28,2397.92,4419.01,0.00
2024-12-08 17:12:40,71,3987,44,27,2421.16,4419.21,0.00
2024-12-08 17:12:40,71,3988,44,27,2498.86,4420.00,0.00
2024-12-08 17:12:40,72,3988,45,27,2464.15,4420.01,0.00
2024-12-08 17:12:40,72,3989,45,27,2457.95,4421.00,0.00
2024-12-08 17:12:41,73,3989,46,27,2424.28,4421.01,0.00
2024-12-08 17:12:41,73,3990,46,27,2417.56,4422.00,0.00
2024-12-08 17:12:41,74,3990,46,28,2384.89,4422.01,0.00
2024-12-08 17:12:41,73,3990,46,27,2408.52,4422.21,0.00
2024-12-08 17:12:41,73,3991,46,27,2422.35,4423.00,0.00
2024-12-08 17:12:41,74,3991,46,28,2389.61,4423.01,0.00
2024-12-08 17:12:41,73,3991,45,28,2421.15,4423.03,0.00
2024-12-08 17:12:41,73,3992,45,28,2415.02,4424.00,0.00
2024-12-08 17:12:41,74,3992,46,28,2382.38,4424.01,0.00
2024-12-08 17:12:41,73,3992,46,27,2395.06,4424.19,0.00
2024-12-08 17:12:41,73,3993,46,27,2408.29,4425.00,0.00
2024-12-08 17:12:41,74,3993,46,28,2375.75,4425.01,0.00
2024-12-08 17:12:41,73,3993,45,28,2407.09,4425.03,0.00
2024-12-08 17:12:41,72,3993,44,28,2432.56,4425.19,0.00
2024-12-08 17:12:41,72,3994,44,28,2434.30,4426.00,0.00
2024-12-08 17:12:41,73,3994,44,29,2400.95,4426.01,0.00
2024-12-08 17:12:41,72,3994,44,28,2413.44,4426.19,0.00
2024-12-08 17:12:41,72,3995,44,28,2427.47,4427.00,0.00
2024-12-08 17:12:41,73,3995,44,29,2394.22,4427.01,0.00
2024-12-08 17:12:41,72,3995,43,29,2426.25,4427.04,0.00
2024-12-08 17:12:41,72,3996,43,29,2421.25,4428.00,0.00
2024-12-08 17:12:41,73,3996,43,30,2388.09,4428.01,0.00
2024-12-08 17:12:41,72,3996,43,29,2400.39,4428.19,0.00
2024-12-08 17:12:41,73,3995,44,29,2352.36,4428.29,0.00
2024-12-08 17:12:41,73,3996,44,29,2414.11,4429.00,0.00
2024-12-08 17:12:41,74,3996,45,29,2381.48,4429.01,0.00
2024-12-08 17:12:41,73,3996,44,29,2412.91,4429.03,0.00
2024-12-08 17:12:41,72,3996,43,29,2446.42,4429.03,0.00
2024-12-08 17:12:41,71,3996,42,29,2480.25,4429.03,0.00
2024-12-08 17:12:41,70,3996,41,29,2509.39,4429.16,0.00
2024-12-08 17:12:41,70,3997,41,29,2573.83,4430.00,0.00
2024-12-08 17:12:41,71,3997,42,29,2537.58,4430.01,0.00
2024-12-08 17:12:41,71,3998,42,29,2531.91,4431.00,0.00
2024-12-08 17:12:41,72,3998,42,30,2496.74,4431.01,0.00
2024-12-08 17:12:41,71,3998,41,30,2531.30,4431.03,0.00
2024-12-08 17:12:41,70,3998,41,29,2561.16,4431.16,0.00
2024-12-08 17:12:41,70,3999,41,29,2574.99,4432.00,0.00
2024-12-08 17:12:41,71,3999,42,29,2538.72,4432.01,0.00
2024-12-08 17:12:41,70,3999,41,29,2568.07,4432.16,0.00
2024-12-08 17:12:41,70,4000,41,29,2581.90,4433.00,0.00
2024-12-08 17:12:41,71,4000,41,30,2545.54,4433.01,0.00
2024-12-08 17:12:41,70,4000,41,29,2562.31,4433.16,0.00
2024-12-08 17:12:41,70,4001,41,29,2576.15,4434.00,0.00
2024-12-08 17:12:41,71,4001,42,29,2539.87,4434.01,0.00
2024-12-08 17:12:41,70,4001,41,29,2573.64,4434.06,0.00
2024-12-08 17:12:41,70,4002,41,29,2570.40,4435.00,0.00
2024-12-08 17:12:41,71,4002,41,30,2534.20,4435.01,0.00
2024-12-08 17:12:41,70,4002,40,30,2567.88,4435.06,0.00
2024-12-08 17:12:41,70,4003,40,30,2564.64,4436.00,0.00
2024-12-08 17:12:41,71,4003,40,31,2528.52,4436.01,0.00
2024-12-08 17:12:41,70,4003,39,31,2545.04,4436.16,0.00
2024-12-08 17:12:41,70,4004,39,31,2558.88,4437.00,0.00
2024-12-08 17:12:41,71,4004,39,32,2522.84,4437.01,0.00
2024-12-08 17:12:41,72,4003,39,33,2421.78,4437.99,0.00
2024-12-08 17:12:41,72,4004,39,33,2483.43,4438.00,0.00
2024-12-08 17:12:41,73,4004,40,33,2449.41,4438.01,0.00
2024-12-08 17:12:41,72,4004,40,32,2471.75,4438.13,0.00
2024-12-08 17:12:41,71,4004,39,32,2494.81,4438.40,0.00
2024-12-08 17:12:41,71,4005,39,32,2580.87,4439.00,0.00
2024-12-08 17:12:41,72,4005,39,33,2545.03,4439.01,0.00
2024-12-08 17:12:41,71,4005,38,33,2560.28,4439.17,0.00
2024-12-08 17:12:41,71,4006,38,33,2586.46,4440.00,0.00
2024-12-08 17:12:41,72,4006,38,34,2550.53,4440.01,0.00
2024-12-08 17:12:41,71,4006,38,33,2567.74,4440.16,0.00
2024-12-08 17:12:42,71,4007,38,33,2580.78,4441.00,0.00
2024-12-08 17:12:42,72,4007,39,33,2544.94,4441.01,0.00
2024-12-08 17:12:42,72,4008,39,33,2538.72,4442.00,0.00
2024-12-08 17:12:42,73,4008,39,34,2503.95,4442.01,0.00
2024-12-08 17:12:42,72,4008,39,33,2520.26,4442.15,0.00
2024-12-08 17:12:42,71,4008,38,33,2545.22,4442.40,0.00
2024-12-08 17:12:42,71,4009,38,33,2568.80,4443.00,0.00
2024-12-08 17:12:42,72,4009,39,33,2533.13,4443.01,0.00
2024-12-08 17:12:42,72,4010,39,33,2526.91,4444.00,0.00
2024-12-08 17:12:42,73,4010,40,33,2492.29,4444.01,0.00
2024-12-08 17:12:42,72,4010,40,32,2509.04,4444.15,0.00
2024-12-08 17:12:42,71,4010,39,32,2530.62,4444.17,0.00
2024-12-08 17:12:42,71,4011,39,32,2556.81,4445.00,0.00
2024-12-08 17:12:42,72,4011,40,32,2521.30,4445.01,0.00
2024-12-08 17:12:42,71,4011,39,32,2533.70,4445.20,0.00
2024-12-08 17:12:42,72,4010,39,33,2468.67,4445.90,0.00
2024-12-08 17:12:42,72,4011,39,33,2530.51,4446.00,0.00
2024-12-08 17:12:42,73,4011,39,34,2495.85,4446.01,0.00
2024-12-08 17:12:42,72,4011,39,33,2513.26,4446.15,0.00
2024-12-08 17:12:42,72,4012,39,33,2587.29,4447.00,0.00
2024-12-08 17:12:42,73,4012,39,34,2551.85,4447.01,0.00
2024-12-08 17:12:42,73,4013,39,34,2545.11,4448.00,0.00
2024-12-08 17:12:42,74,4013,39,35,2510.72,4448.01,0.00
2024-12-08 17:12:42,73,4013,39,34,2528.08,4448.15,0.00
2024-12-08 17:12:42,73,4014,39,34,2539.59,4449.00,0.00
2024-12-08 17:12:42,74,4014,40,34,2505.27,4449.01,0.00
2024-12-08 17:12:42,74,4015,40,34,2498.01,4450.00,0.00
2024-12-08 17:12:42,75,4015,40,35,2464.71,4450.01,0.00
2024-12-08 17:12:42,74,4015,39,35,2493.22,4450.11,0.00
2024-12-08 17:12:42,74,4016,39,35,2490.15,4451.00,0.00
2024-12-08 17:12:42,75,4016,39,36,2456.95,4451.01,0.00
2024-12-08 17:12:42,74,4016,39,35,2475.14,4451.14,0.00
2024-12-08 17:12:42,74,4017,39,35,2485.30,4452.00,0.00
2024-12-08 17:12:42,75,4017,40,35,2452.16,4452.01,0.00
2024-12-08 17:12:42,74,4017,40,34,2455.84,4452.15,0.00
2024-12-08 17:12:42,75,4016,40,35,2397.88,4452.75,0.00
2024-12-08 17:12:42,75,4017,40,35,2491.90,4453.00,0.00
2024-12-08 17:12:42,76,4017,41,35,2459.11,4453.01,0.00
2024-12-08 17:12:42,75,4017,40,35,2490.13,4453.04,0.00
2024-12-08 17:12:42,75,4018,40,35,2542.94,4454.00,0.00
2024-12-08 17:12:42,76,4018,40,36,2509.48,4454.01,0.00
2024-12-08 17:12:42,75,4018,40,35,2525.74,4454.15,0.00
2024-12-08 17:12:42,75,4019,40,35,2535.79,4455.00,0.00
2024-12-08 17:12:42,76,4019,40,36,2502.42,4455.01,0.00
2024-12-08 17:12:42,76,4020,40,36,2494.19,4456.00,0.00
2024-12-08 17:12:42,77,4020,41,36,2461.79,4456.01,0.00
2024-12-08 17:12:42,76,4020,40,36,2488.34,4456.11,0.00
2024-12-08 17:12:42,75,4020,40,35,2509.64,4456.13,0.00
2024-12-08 17:12:42,75,4021,40,35,2530.98,4457.00,0.00
2024-12-08 17:12:42,76,4021,40,36,2497.68,4457.01,0.00
2024-12-08 17:12:42,75,4021,39,36,2529.21,4457.04,0.00
2024-12-08 17:12:42,75,4022,39,36,2534.52,4458.00,0.00
2024-12-08 17:12:42,76,4022,39,37,2501.17,4458.01,0.00
2024-12-08 17:12:42,75,4022,38,37,2532.75,4458.04,0.00
2024-12-08 17:12:42,74,4022,38,36,2549.52,4458.15,0.00
2024-12-08 17:12:42,74,4023,38,36,2560.31,4459.00,0.00
2024-12-08 17:12:42,75,4023,39,36,2526.17,4459.01,0.00
2024-12-08 17:12:42,75,4024,39,36,2518.41,4460.00,0.00
2024-12-08 17:12:42,76,4024,40,36,2485.28,4460.01,0.00
2024-12-08 17:12:42,75,4024,39,36,2512.49,4460.15,0.00
2024-12-08 17:12:42,74,4024,39,35,2533.79,4460.15,0.00
2024-12-08 17:12:43,74,4025,39,35,2544.58,4461.00,0.00
2024-12-08 17:12:43,75,4025,39,36,2510.65,4461.01,0.00
2024-12-08 17:12:43,74,4025,38,36,2515.71,4461.26,0.00
2024-12-08 17:12:43,74,4026,38,36,2543.34,4462.00,0.00
2024-12-08 17:12:43,75,4026,39,36,2509.43,4462.01,0.00
2024-12-08 17:12:43,74,4026,38,36,2507.26,4462.34,0.00
2024-12-08 17:12:43,74,4027,38,36,2538.48,4463.00,0.00
2024-12-08 17:12:43,75,4027,38,37,2504.63,4463.01,0.00
2024-12-08 17:12:43,74,4027,38,36,2528.87,4463.19,0.00
2024-12-08 17:12:43,74,4028,38,36,2541.46,4464.00,0.00
2024-12-08 17:12:43,75,4028,39,36,2507.58,4464.01,0.00
2024-12-08 17:12:43,74,4028,38,36,2539.66,4464.04,0.00
2024-12-08 17:12:43,74,4029,38,36,2533.58,4465.00,0.00
2024-12-08 17:12:43,75,4029,39,36,2499.80,4465.01,0.00
2024-12-08 17:12:43,75,4030,39,36,2492.03,4466.00,0.00
2024-12-08 17:12:43,76,4030,39,37,2459.24,4466.01,0.00
2024-12-08 17:12:43,75,4030,39,36,2484.32,4466.17,0.00
2024-12-08 17:12:43,75,4031,39,36,2495.56,4467.00,0.00
2024-12-08 17:12:43,76,4031,39,37,2462.73,4467.01,0.00
2024-12-08 17:12:43,75,4031,38,37,2493.78,4467.04,0.00
2024-12-08 17:12:43,75,4032,38,37,2487.19,4468.00,0.00
2024-12-08 17:12:43,76,4032,38,38,2454.46,4468.01,0.00
2024-12-08 17:12:43,75,4032,38,37,2468.75,4468.16,0.00
2024-12-08 17:12:43,75,4033,38,37,2479.40,4469.00,0.00
2024-12-08 17:12:43,76,4033,38,38,2446.78,4469.01,0.00
2024-12-08 17:12:43,75,4033,37,38,2477.03,4469.05,0.00
2024-12-08 17:12:43,75,4034,37,38,2471.01,4470.00,0.00
2024-12-08 17:12:43,76,4034,38,38,2438.50,4470.01,0.00
2024-12-08 17:12:43,75,4034,38,37,2452.57,4470.16,0.00
2024-12-08 17:12:43,75,4035,38,37,2463.22,4471.00,0.00
2024-12-08 17:12:43,76,4035,38,38,2430.81,4471.01,0.00
2024-12-08 17:12:43,75,4035,37,38,2460.84,4471.05,0.00
2024-12-08 17:12:43,74,4035,36,38,2465.82,4471.42,0.00
2024-12-08 17:12:43,74,4036,36,38,2488.61,4472.00,0.00
2024-12-08 17:12:43,75,4036,37,38,2455.43,4472.01,0.00
2024-12-08 17:12:43,74,4036,37,37,2470.50,4472.15,0.00
2024-12-08 17:12:43,74,4037,37,37,2481.30,4473.00,0.00
2024-12-08 17:12:43,75,4037,37,38,2448.22,4473.01,0.00
2024-12-08 17:12:43,74,4037,36,38,2451.20,4473.42,0.00
2024-12-08 17:12:43,74,4038,36,38,2474.00,4474.00,0.00
2024-12-08 17:12:43,75,4038,37,38,2441.01,4474.01,0.00
2024-12-08 17:12:43,74,4038,36,38,2471.59,4474.05,0.00
2024-12-08 17:12:43,73,4038,36,37,2487.70,4474.17,0.00
2024-12-08 17:12:43,73,4039,36,37,2499.87,4475.00,0.00
2024-12-08 17:12:43,74,4039,36,38,2466.09,4475.01,0.00
2024-12-08 17:12:43,73,4039,35,38,2498.65,4475.03,0.00
2024-12-08 17:12:43,72,4039,34,38,2532.73,4475.03,0.00
2024-12-08 17:12:43,72,4040,34,38,2527.07,4476.00,0.00
2024-12-08 17:12:43,73,4040,34,39,2492.46,4476.01,0.00
2024-12-08 17:12:43,72,4040,34,38,2509.07,4476.14,0.00
2024-12-08 17:12:43,71,4040,33,38,2543.78,4476.14,0.00
2024-12-08 17:12:43,71,4041,33,38,2556.30,4477.00,0.00
2024-12-08 17:12:43,72,4041,33,39,2520.80,4477.01,0.00
2024-12-08 17:12:43,72,4042,33,39,2514.52,4478.00,0.00
2024-12-08 17:12:43,73,4042,34,39,2480.07,4478.01,0.00
2024-12-08 17:12:43,72,4042,34,38,2495.89,4478.14,0.00
2024-12-08 17:12:43,71,4042,33,38,2499.23,4478.79,0.00
2024-12-08 17:12:43,71,4043,33,38,2553.03,4479.00,0.00
2024-12-08 17:12:44,72,4043,33,39,2517.57,4479.01,0.00
2024-12-08 17:12:44,72,4044,33,39,2511.29,4480.00,0.00
2024-12-08 17:12:44,73,4044,34,39,2476.89,4480.01,0.00
2024-12-08 17:12:44,72,4044,33,39,2498.86,4480.11,0.00
2024-12-08 17:12:44,71,4044,33,38,2520.18,4480.14,0.00
2024-12-08 17:12:44,71,4045,33,38,2545.33,4481.00,0.00
2024-12-08 17:12:44,72,4045,33,39,2509.98,4481.01,0.00
2024-12-08 17:12:44,71,4045,32,39,2539.68,4481.14,0.00
2024-12-08 17:12:44,70,4045,31,39,2575.32,4481.14,0.00
2024-12-08 17:12:44,70,4046,31,39,2575.87,4482.00,0.00
2024-12-08 17:12:44,71,4046,32,39,2539.59,4482.01,0.00
2024-12-08 17:12:44,70,4046,32,38,2556.68,4482.14,0.00
2024-12-08 17:12:44,69,4046,31,38,2584.03,4482.25,0.00
2024-12-08 17:12:44,68,4046,30,38,2615.52,4482.40,0.00
2024-12-08 17:12:44,68,4047,30,38,2654.86,4483.00,0.00
2024-12-08 17:12:44,69,4047,30,39,2616.38,4483.02,0.00
2024-12-08 17:12:44,69,4048,30,39,2611.77,4484.00,0.00
2024-12-08 17:12:44,70,4048,31,39,2574.46,4484.01,0.00
2024-12-08 17:12:44,69,4048,31,38,2592.94,4484.15,0.00
2024-12-08 17:12:44,68,4048,30,38,2630.41,4484.15,0.00
2024-12-08 17:12:44,68,4049,30,38,2645.49,4485.00,0.00
2024-12-08 17:12:44,69,4049,31,38,2607.15,4485.02,0.00
2024-12-08 17:12:44,68,4049,30,38,2642.20,4485.09,0.00
2024-12-08 17:12:44,68,4050,30,38,2641.46,4486.00,0.00
2024-12-08 17:12:44,69,4050,30,39,2603.18,4486.02,0.00
2024-12-08 17:12:44,68,4050,30,38,2623.01,4486.13,0.00
2024-12-08 17:12:44,67,4050,29,38,2650.90,4486.39,0.00
2024-12-08 17:12:44,67,4051,29,38,2677.47,4487.00,0.00
2024-12-08 17:12:44,68,4051,29,39,2638.09,4487.02,0.00
2024-12-08 17:12:44,69,4050,29,40,2577.79,4487.25,0.00
2024-12-08 17:12:44,69,4051,29,40,2618.65,4488.00,0.00
2024-12-08 17:12:44,70,4051,29,41,2581.24,4488.01,0.00
2024-12-08 17:12:44,69,4051,29,40,2601.10,4488.13,0.00
2024-12-08 17:12:44,69,4052,29,40,2679.74,4489.00,0.00
2024-12-08 17:12:44,70,4052,30,40,2641.45,4489.01,0.00
2024-12-08 17:12:44,69,4052,29,40,2676.49,4489.09,0.00
2024-12-08 17:12:44,68,4052,28,40,2700.02,4489.15,0.00
2024-12-08 17:12:44,69,4051,28,41,2658.32,4489.23,0.00
2024-12-08 17:12:44,68,4051,27,41,2706.33,4489.75,0.00
2024-12-08 17:12:44,68,4052,27,41,2761.35,4490.00,0.00
2024-12-08 17:12:44,69,4052,28,41,2721.33,4490.02,0.00
2024-12-08 17:12:44,69,4053,28,41,2781.81,4491.00,0.00
2024-12-08 17:12:44,70,4053,28,42,2742.07,4491.01,0.00
2024-12-08 17:12:44,71,4052,29,42,2703.45,4491.04,0.00
2024-12-08 17:12:44,70,4052,29,41,2772.25,4491.14,0.00
2024-12-08 17:12:44,70,4053,29,41,2785.68,4492.00,0.00
2024-12-08 17:12:44,71,4053,29,42,2746.45,4492.01,0.00
2024-12-08 17:12:44,70,4053,29,41,2770.94,4492.11,0.00
2024-12-08 17:12:44,70,4054,29,41,2847.28,4493.00,0.00
2024-12-08 17:12:44,71,4054,29,42,2807.17,4493.01,0.00
2024-12-08 17:12:44,70,4054,28,42,2843.44,4493.09,0.00
2024-12-08 17:12:44,70,4055,28,42,2841.49,4494.00,0.00
2024-12-08 17:12:44,71,4055,29,42,2801.47,4494.01,0.00
2024-12-08 17:12:44,70,4055,29,41,2826.10,4494.10,0.00
2024-12-08 17:12:44,70,4056,29,41,2837.63,4495.00,0.00
2024-12-08 17:12:44,71,4056,30,41,2797.66,4495.01,0.00
2024-12-08 17:12:44,70,4056,29,41,2836.36,4495.03,0.00
2024-12-08 17:12:44,71,4055,30,41,2773.71,4495.28,0.00
2024-12-08 17:12:44,71,4056,30,41,2823.61,4496.00,0.00
2024-12-08 17:12:44,72,4056,30,42,2784.40,4496.01,0.00
2024-12-08 17:12:44,71,4056,29,42,2822.36,4496.03,0.00
2024-12-08 17:12:44,70,4056,29,41,2849.20,4496.07,0.00
2024-12-08 17:12:44,70,4057,29,41,2923.67,4497.00,0.00
2024-12-08 17:12:44,71,4057,30,41,2882.49,4497.01,0.00
2024-12-08 17:12:45,71,4058,30,41,2876.80,4498.00,0.00
2024-12-08 17:12:45,72,4058,30,42,2836.84,4498.01,0.00
2024-12-08 17:12:45,71,4058,30,41,2860.99,4498.08,0.00
2024-12-08 17:12:45,70,4058,29,41,2886.47,4498.13,0.00
2024-12-08 17:12:45,70,4059,29,41,2912.08,4499.00,0.00
2024-12-08 17:12:45,71,4059,30,41,2871.07,4499.01,0.00
2024-12-08 17:12:45,71,4060,30,41,2865.37,4500.00,0.00
2024-12-08 17:12:45,72,4060,30,42,2825.57,4500.01,0.00
2024-12-08 17:12:45,72,4061,30,42,2819.32,4501.00,0.00
2024-12-08 17:12:45,73,4061,30,43,2780.70,4501.01,0.00
2024-12-08 17:12:45,73,4062,30,43,2773.92,4502.00,0.00
2024-12-08 17:12:45,74,4062,31,43,2736.44,4502.01,0.00
2024-12-08 17:12:45,73,4062,30,43,2772.70,4502.03,0.00
2024-12-08 17:12:45,73,4063,30,43,2766.52,4503.00,0.00
2024-12-08 17:12:45,74,4063,30,44,2729.13,4503.01,0.00
2024-12-08 17:12:45,75,4062,31,44,2692.74,4503.04,0.00
2024-12-08 17:12:45,74,4062,30,44,2735.23,4503.04,0.00
2024-12-08 17:12:45,73,4062,30,43,2767.16,4503.07,0.00
2024-12-08 17:12:45,73,4063,30,43,2775.15,4504.00,0.00
2024-12-08 17:12:45,74,4063,30,44,2737.65,4504.01,0.00
2024-12-08 17:12:45,74,4064,30,44,2791.22,4505.00,0.00
2024-12-08 17:12:45,75,4064,31,44,2754.01,4505.01,0.00
2024-12-08 17:12:45,74,4064,31,43,2781.51,4505.05,0.00
2024-12-08 17:12:45,74,4065,31,43,2788.19,4506.00,0.00
2024-12-08 17:12:45,75,4065,32,43,2751.01,4506.01,0.00
2024-12-08 17:12:45,74,4065,31,43,2730.24,4506.88,0.00
2024-12-08 17:12:45,74,4065,31,43,2785.76,4507.00,0.00
2024-12-08 17:12:45,75,4065,32,43,2748.62,4507.01,0.00
2024-12-08 17:12:45,74,4065,32,42,2772.39,4507.05,0.00
2024-12-08 17:12:45,74,4066,32,42,2779.07,4508.00,0.00
2024-12-08 17:12:45,75,4066,33,42,2742.02,4508.01,0.00
2024-12-08 17:12:45,75,4067,33,42,2734.21,4509.00,0.00
2024-12-08 17:12:45,76,4067,34,42,2698.23,4509.01,0.00
2024-12-08 17:12:45,75,4067,34,41,2725.82,4509.05,0.00
2024-12-08 17:12:45,76,4066,35,41,2675.25,4509.41,0.00
2024-12-08 17:12:45,77,4065,35,42,2645.51,4509.87,0.00
2024-12-08 17:12:45,77,4066,35,42,2715.32,4510.00,0.00
2024-12-08 17:12:45,78,4066,36,42,2680.51,4510.01,0.00
2024-12-08 17:12:45,77,4066,35,42,2697.23,4510.16,0.00
2024-12-08 17:12:45,77,4067,35,42,2823.72,4511.00,0.00
2024-12-08 17:12:45,78,4067,35,43,2787.52,4511.01,0.00
2024-12-08 17:12:45,77,4067,35,42,2816.13,4511.05,0.00
2024-12-08 17:12:45,77,4068,35,42,2820.83,4512.00,0.00
2024-12-08 17:12:45,78,4068,35,43,2784.67,4512.01,0.00
2024-12-08 17:12:45,78,4069,35,43,2775.45,4513.00,0.00
2024-12-08 17:12:45,79,4069,36,43,2740.31,4513.01,0.00
2024-12-08 17:12:45,78,4069,36,42,2767.95,4513.05,0.00
2024-12-08 17:12:45,77,4069,35,42,2787.52,4513.16,0.00
2024-12-08 17:12:45,77,4070,35,42,2808.60,4514.00,0.00
2024-12-08 17:12:45,78,4070,36,42,2772.59,4514.01,0.00
2024-12-08 17:12:45,78,4071,36,42,2763.36,4515.00,0.00
2024-12-08 17:12:45,79,4071,36,43,2728.38,4515.01,0.00
2024-12-08 17:12:46,79,4072,36,43,2718.70,4516.00,0.00
2024-12-08 17:12:46,80,4072,37,43,2684.71,4516.01,0.00
2024-12-08 17:12:46,80,4073,37,43,2674.58,4517.00,0.00
2024-12-08 17:12:46,81,4073,38,43,2641.56,4517.01,0.00
2024-12-08 17:12:46,80,4073,38,42,2661.06,4517.08,0.00
2024-12-08 17:12:46,80,4074,38,42,2665.01,4518.00,0.00
2024-12-08 17:12:46,81,4074,39,42,2632.11,4518.01,0.00
2024-12-08 17:12:46,80,4074,38,42,2663.89,4518.03,0.00
2024-12-08 17:12:46,80,4075,38,42,2654.30,4519.00,0.00
2024-12-08 17:12:46,81,4075,38,43,2621.53,4519.01,0.00
2024-12-08 17:12:46,80,4075,38,42,2647.55,4519.06,0.00
2024-12-08 17:12:46,80,4076,38,42,2650.12,4520.00,0.00
2024-12-08 17:12:46,81,4076,38,43,2617.40,4520.01,0.00
2024-12-08 17:12:46,81,4077,38,43,2604.37,4521.00,0.00
2024-12-08 17:12:46,82,4077,38,44,2572.61,4521.01,0.00
2024-12-08 17:12:46,81,4077,38,43,2598.26,4521.06,0.00
2024-12-08 17:12:46,81,4078,38,43,2600.31,4522.00,0.00
2024-12-08 17:12:46,82,4078,39,43,2568.60,4522.01,0.00
2024-12-08 17:12:46,82,4079,39,43,2556.89,4523.00,0.00
2024-12-08 17:12:46,83,4079,39,44,2526.08,4523.01,0.00
2024-12-08 17:12:46,82,4079,38,44,2544.22,4523.04,0.00
2024-12-08 17:12:46,82,4080,38,44,2539.28,4524.00,0.00
2024-12-08 17:12:46,83,4080,38,45,2508.69,4524.01,0.00
2024-12-08 17:12:46,82,4080,38,44,2534.89,4524.05,0.00
2024-12-08 17:12:46,82,4081,38,44,2535.09,4525.00,0.00
2024-12-08 17:12:46,83,4081,39,44,2504.54,4525.01,0.00
2024-12-08 17:12:46,82,4081,38,44,2522.96,4525.04,0.00
2024-12-08 17:12:46,81,4081,38,43,2550.76,4525.04,0.00
2024-12-08 17:12:46,80,4081,37,43,2575.90,4525.19,0.00
2024-12-08 17:12:46,79,4081,36,43,2607.93,4525.19,0.00
2024-12-08 17:12:46,79,4082,36,43,2629.07,4526.00,0.00
2024-12-08 17:12:46,80,4082,37,43,2596.21,4526.01,0.00
2024-12-08 17:12:46,79,4082,36,43,2610.76,4526.06,0.00
2024-12-08 17:12:46,79,4083,36,43,2624.81,4527.00,0.00
2024-12-08 17:12:46,80,4083,37,43,2592.00,4527.01,0.00
2024-12-08 17:12:46,79,4083,37,42,2596.45,4527.08,0.00
2024-12-08 17:12:46,79,4084,37,42,2612.48,4528.00,0.00
2024-12-08 17:12:46,80,4084,37,43,2579.83,4528.01,0.00
2024-12-08 17:12:46,79,4084,37,42,2609.06,4528.04,0.00
2024-12-08 17:12:46,79,4085,37,42,2611.91,4529.00,0.00
2024-12-08 17:12:46,80,4085,37,43,2579.26,4529.01,0.00
2024-12-08 17:12:46,79,4085,37,42,2608.49,4529.04,0.00
2024-12-08 17:12:46,79,4086,37,42,2611.34,4530.00,0.00
2024-12-08 17:12:46,80,4086,37,43,2578.70,4530.01,0.00
2024-12-08 17:12:46,79,4086,36,43,2591.34,4530.19,0.00
2024-12-08 17:12:46,79,4087,36,43,2601.02,4531.00,0.00
2024-12-08 17:12:46,80,4087,36,44,2568.51,4531.01,0.00
2024-12-08 17:12:46,79,4087,36,43,2597.59,4531.04,0.00
2024-12-08 17:12:46,78,4087,35,43,2613.05,4531.44,0.00
2024-12-08 17:12:46,78,4088,35,43,2634.37,4532.00,0.00
2024-12-08 17:12:46,79,4088,36,43,2601.02,4532.01,0.00
2024-12-08 17:12:46,79,4089,36,43,2591.27,4533.00,0.00
2024-12-08 17:12:46,80,4089,37,43,2558.88,4533.01,0.00
2024-12-08 17:12:46,81,4088,37,44,2526.74,4533.05,0.00
2024-12-08 17:12:46,80,4088,37,43,2591.77,4533.06,0.00
2024-12-08 17:12:46,80,4089,37,43,2595.15,4534.00,0.00
2024-12-08 17:12:46,81,4089,37,44,2563.11,4534.01,0.00
2024-12-08 17:12:47,81,4090,37,44,2608.46,4535.00,0.00
2024-12-08 17:12:47,82,4090,37,45,2576.65,4535.01,0.00
2024-12-08 17:12:47,81,4090,37,44,2604.57,4535.05,0.00
2024-12-08 17:12:47,81,4091,37,44,2606.80,4536.00,0.00
2024-12-08 17:12:47,82,4091,38,44,2575.01,4536.01,0.00
2024-12-08 17:12:47,82,4092,38,44,2563.96,4537.00,0.00
2024-12-08 17:12:47,83,4092,38,45,2533.07,4537.01,0.00
2024-12-08 17:12:47,82,4092,38,44,2558.45,4537.07,0.00
2024-12-08 17:12:47,82,4093,38,44,2561.20,4538.00,0.00
2024-12-08 17:12:47,83,4093,38,45,2530.34,4538.01,0.00
2024-12-08 17:12:47,83,4094,38,45,2518.87,4539.00,0.00
2024-12-08 17:12:47,84,4094,39,45,2488.88,4539.01,0.00
2024-12-08 17:12:47,83,4094,38,45,2516.70,4539.05,0.00
2024-12-08 17:12:47,82,4094,38,44,2544.08,4539.06,0.00
2024-12-08 17:12:47,82,4095,38,44,2546.27,4540.00,0.00
2024-12-08 17:12:47,83,4095,39,44,2515.60,4540.01,0.00
2024-12-08 17:12:47,82,4095,38,44,2533.01,4540.05,0.00
2024-12-08 17:12:47,81,4095,37,44,2545.83,4540.20,0.00
2024-12-08 17:12:47,81,4096,37,44,2565.94,4541.00,0.00
2024-12-08 17:12:47,82,4096,38,44,2534.65,4541.01,0.00
2024-12-08 17:12:47,82,4097,38,44,2523.58,4542.00,0.00
2024-12-08 17:12:47,83,4097,39,44,2493.17,4542.01,0.00
2024-12-08 17:12:47,83,4098,39,44,2481.68,4543.00,0.00
2024-12-08 17:12:47,84,4098,40,44,2452.14,4543.01,0.00
2024-12-08 17:12:47,83,4098,40,43,2476.23,4543.05,0.00
2024-12-08 17:12:47,83,4099,40,43,2477.30,4544.00,0.00
2024-12-08 17:12:47,84,4099,40,44,2447.81,4544.01,0.00
2024-12-08 17:12:47,84,4100,40,44,2435.90,4545.00,0.00
2024-12-08 17:12:47,85,4100,40,45,2407.25,4545.01,0.00
2024-12-08 17:12:47,84,4100,40,44,2432.68,4545.05,0.00
2024-12-08 17:12:47,84,4101,40,44,2433.19,4546.00,0.00
2024-12-08 17:12:47,85,4101,41,44,2404.57,4546.01,0.00
2024-12-08 17:12:47,86,4100,42,44,2339.32,4546.63,0.00
2024-12-08 17:12:47,86,4101,42,44,2391.93,4547.00,0.00
2024-12-08 17:12:47,87,4101,42,45,2364.44,4547.01,0.00
2024-12-08 17:12:47,86,4101,42,44,2389.31,4547.05,0.00
2024-12-08 17:12:47,85,4101,41,44,2397.79,4547.48,0.00
2024-12-08 17:12:47,85,4102,41,44,2470.90,4548.00,0.00
2024-12-08 17:12:47,86,4102,42,44,2442.17,4548.01,0.00
2024-12-08 17:12:47,86,4103,42,44,2429.48,4549.00,0.00
2024-12-08 17:12:47,87,4103,42,45,2401.56,4549.01,0.00
2024-12-08 17:12:47,86,4103,42,44,2427.38,4549.05,0.00
2024-12-08 17:12:47,86,4104,42,44,2426.84,4550.00,0.00
2024-12-08 17:12:47,87,4104,42,45,2398.95,4550.01,0.00
2024-12-08 17:12:47,88,4103,42,46,2332.53,4550.44,0.00
2024-12-08 17:12:47,88,4104,42,46,2383.07,4551.00,0.00
2024-12-08 17:12:47,89,4104,42,47,2356.29,4551.01,0.00
2024-12-08 17:12:47,88,4104,42,46,2381.02,4551.05,0.00
2024-12-08 17:12:47,87,4104,41,46,2394.81,4551.17,0.00
2024-12-08 17:12:47,87,4105,41,46,2462.27,4552.00,0.00
2024-12-08 17:12:47,88,4105,42,46,2434.28,4552.01,0.00
2024-12-08 17:12:47,89,4104,42,47,2378.44,4552.44,0.00
2024-12-08 17:12:47,89,4105,42,47,2417.69,4553.00,0.00
2024-12-08 17:12:47,90,4105,43,47,2390.83,4553.01,0.00
2024-12-08 17:12:47,89,4105,43,46,2415.66,4553.05,0.00
2024-12-08 17:12:48,88,4105,42,46,2412.38,4553.73,0.00
2024-12-08 17:12:48,88,4106,42,46,2493.31,4554.00,0.00
2024-12-08 17:12:48,89,4106,43,46,2465.30,4554.01,0.00
2024-12-08 17:12:48,88,4106,42,46,2491.26,4554.05,0.00
2024-12-08 17:12:48,88,4107,42,46,2479.37,4555.00,0.00
2024-12-08 17:12:48,89,4107,43,46,2451.51,4555.01,0.00
2024-12-08 17:12:48,88,4107,43,45,2477.31,4555.05,0.00
2024-12-08 17:12:48,88,4108,43,45,2475.77,4556.00,0.00
2024-12-08 17:12:48,89,4108,44,45,2447.95,4556.01,0.00
2024-12-08 17:12:48,88,4108,43,45,2474.23,4556.03,0.00
2024-12-08 17:12:48,87,4108,43,44,2491.67,4556.04,0.00
2024-12-08 17:12:48,87,4109,43,44,2490.11,4557.00,0.00
2024-12-08 17:12:48,88,4109,43,45,2461.82,4557.01,0.00
2024-12-08 17:12:48,87,4109,43,44,2478.08,4557.04,0.00
2024-12-08 17:12:48,86,4109,42,44,2475.42,4557.73,0.00
2024-12-08 17:12:48,86,4110,42,44,2505.84,4558.00,0.00
2024-12-08 17:12:48,87,4110,42,45,2477.04,4558.01,0.00
2024-12-08 17:12:48,88,4109,42,46,2387.21,4558.94,0.00
2024-12-08 17:12:48,88,4110,42,46,2439.06,4559.00,0.00
2024-12-08 17:12:48,89,4110,42,47,2411.66,4559.01,0.00
2024-12-08 17:12:48,88,4110,42,46,2437.01,4559.05,0.00
2024-12-08 17:12:48,89,4109,42,47,2381.71,4559.69,0.00
2024-12-08 17:12:48,89,4110,42,47,2472.65,4560.00,0.00
2024-12-08 17:12:48,90,4110,42,48,2445.17,4560.01,0.00
2024-12-08 17:12:48,90,4111,42,48,2481.69,4561.00,0.00
2024-12-08 17:12:48,91,4111,43,48,2454.42,4561.01,0.00
2024-12-08 17:12:48,90,4111,43,47,2479.68,4561.04,0.00
2024-12-08 17:12:48,90,4112,43,47,2477.17,4562.00,0.00
2024-12-08 17:12:48,91,4112,44,47,2449.94,4562.01,0.00
2024-12-08 17:12:48,91,4113,44,47,2435.44,4563.00,0.00
2024-12-08 17:12:48,92,4113,44,48,2408.97,4563.01,0.00
2024-12-08 17:12:48,91,4113,44,47,2432.95,4563.06,0.00
2024-12-08 17:12:48,91,4114,44,47,2430.45,4564.00,0.00
2024-12-08 17:12:48,92,4114,45,47,2404.04,4564.01,0.00
2024-12-08 17:12:48,91,4114,44,47,2427.96,4564.06,0.00
2024-12-08 17:12:48,90,4114,43,47,2439.73,4564.10,0.00
2024-12-08 17:12:48,90,4115,43,47,2449.88,4565.00,0.00
2024-12-08 17:12:48,91,4115,44,47,2422.96,4565.01,0.00
2024-12-08 17:12:48,90,4115,44,46,2446.85,4565.06,0.00
2024-12-08 17:12:48,90,4116,44,46,2444.84,4566.00,0.00
2024-12-08 17:12:48,91,4116,45,46,2417.97,4566.01,0.00
2024-12-08 17:12:48,91,4117,45,46,2403.32,4567.00,0.00
2024-12-08 17:12:48,92,4117,46,46,2377.20,4567.01,0.00
2024-12-08 17:12:48,91,4117,46,45,2400.83,4567.06,0.00
2024-12-08 17:12:48,90,4117,45,45,2406.18,4567.51,0.00
2024-12-08 17:12:48,91,4116,45,46,2377.76,4567.57,0.00
2024-12-08 17:12:48,91,4117,45,46,2416.23,4568.00,0.00
2024-12-08 17:12:48,92,4117,45,47,2389.97,4568.01,0.00
2024-12-08 17:12:48,91,4117,45,46,2404.20,4568.06,0.00
2024-12-08 17:12:48,91,4118,45,46,2450.74,4569.00,0.00
2024-12-08 17:12:48,92,4118,46,46,2424.10,4569.01,0.00
2024-12-08 17:12:48,91,4118,46,45,2438.70,4569.06,0.00
2024-12-08 17:12:48,90,4118,45,45,2454.30,4569.27,0.00
2024-12-08 17:12:48,89,4118,44,45,2480.85,4569.28,0.00
2024-12-08 17:12:48,89,4119,44,45,2489.53,4570.00,0.00
2024-12-08 17:12:48,90,4119,44,46,2461.87,4570.01,0.00
2024-12-08 17:12:48,89,4119,44,45,2477.22,4570.06,0.00
2024-12-08 17:12:48,89,4120,44,45,2472.76,4571.00,0.00
2024-12-08 17:12:48,90,4120,44,46,2445.29,4571.01,0.00
2024-12-08 17:12:48,89,4120,44,45,2459.94,4571.06,0.00
2024-12-08 17:12:49,89,4121,44,45,2454.23,4572.00,0.00
2024-12-08 17:12:49,90,4121,44,46,2426.96,4572.01,0.00
2024-12-08 17:12:49,89,4121,44,45,2440.88,4572.07,0.00
2024-12-08 17:12:49,88,4121,43,45,2465.51,4572.09,0.00
2024-12-08 17:12:49,88,4122,43,45,2470.99,4573.00,0.00
2024-12-08 17:12:49,89,4122,43,46,2443.22,4573.01,0.00
2024-12-08 17:12:49,88,4122,43,45,2457.49,4573.07,0.00
2024-12-08 17:12:49,87,4122,42,45,2459.66,4573.48,0.00
2024-12-08 17:12:49,87,4123,42,45,2478.43,4574.00,0.00
2024-12-08 17:12:49,88,4123,43,45,2450.27,4574.01,0.00
2024-12-08 17:12:49,87,4123,42,45,2475.29,4574.07,0.00
2024-12-08 17:12:49,87,4124,42,45,2456.61,4575.00,0.00
2024-12-08 17:12:49,88,4124,42,46,2428.69,4575.01,0.00
2024-12-08 17:12:49,87,4124,41,46,2453.47,4575.07,0.00
2024-12-08 17:12:49,86,4124,41,45,2480.93,4575.07,0.00
2024-12-08 17:12:49,85,4124,40,45,2498.52,4575.14,0.00
2024-12-08 17:12:49,85,4125,40,45,2502.80,4576.00,0.00
2024-12-08 17:12:49,86,4125,41,45,2473.70,4576.01,0.00
2024-12-08 17:12:49,85,4125,40,45,2483.44,4576.12,0.00
2024-12-08 17:12:49,85,4126,40,45,2497.43,4577.00,0.00
2024-12-08 17:12:49,86,4126,40,46,2468.39,4577.01,0.00
2024-12-08 17:12:49,85,4126,40,45,2493.67,4577.07,0.00
2024-12-08 17:12:49,85,4127,40,45,2494.74,4578.00,0.00
2024-12-08 17:12:49,86,4127,41,45,2465.73,4578.01,0.00
2024-12-08 17:12:49,85,4127,40,45,2493.13,4578.04,0.00
2024-12-08 17:12:49,84,4127,39,45,2492.35,4578.24,0.00
2024-12-08 17:12:49,84,4128,39,45,2512.45,4579.00,0.00
2024-12-08 17:12:49,85,4128,39,46,2482.89,4579.01,0.00
2024-12-08 17:12:49,84,4128,39,45,2508.65,4579.07,0.00
2024-12-08 17:12:49,84,4129,39,45,2509.69,4580.00,0.00
2024-12-08 17:12:49,85,4129,39,46,2480.16,4580.01,0.00
2024-12-08 17:12:49,86,4128,40,46,2436.96,4580.12,0.00
2024-12-08 17:12:49,87,4127,40,47,2444.26,4580.23,0.00
2024-12-08 17:12:49,86,4127,39,47,2480.15,4580.24,0.00
2024-12-08 17:12:49,86,4128,39,47,2497.89,4581.00,0.00
2024-12-08 17:12:49,87,4128,40,47,2469.18,4581.01,0.00
2024-12-08 17:12:49,86,4128,40,46,2484.05,4581.07,0.00
2024-12-08 17:12:49,86,4129,40,46,2599.50,4582.00,0.00
2024-12-08 17:12:49,87,4129,41,46,2569.62,4582.01,0.00
2024-12-08 17:12:49,86,4129,40,46,2597.91,4582.04,0.00
2024-12-08 17:12:49,85,4129,39,46,2588.75,4582.44,0.00
2024-12-08 17:12:49,85,4130,39,46,2613.73,4583.00,0.00
2024-12-08 17:12:49,86,4130,39,47,2583.34,4583.01,0.00
2024-12-08 17:12:49,85,4130,39,46,2611.05,4583.06,0.00
2024-12-08 17:12:49,84,4130,38,46,2625.38,4583.43,0.00
2024-12-08 17:12:49,84,4131,38,46,2638.41,4584.00,0.00
2024-12-08 17:12:49,85,4131,39,46,2607.37,4584.01,0.00
2024-12-08 17:12:49,86,4130,40,46,2545.78,4584.49,0.00
2024-12-08 17:12:49,86,4131,40,46,2578.94,4585.00,0.00
2024-12-08 17:12:49,87,4131,41,46,2549.30,4585.01,0.00
2024-12-08 17:12:49,87,4132,41,46,2581.20,4586.00,0.00
2024-12-08 17:12:49,88,4132,41,47,2551.86,4586.01,0.00
2024-12-08 17:12:49,87,4132,41,46,2539.37,4586.52,0.00
2024-12-08 17:12:49,88,4131,42,46,2505.89,4586.64,0.00
2024-12-08 17:12:49,88,4132,42,46,2545.26,4587.00,0.00
2024-12-08 17:12:49,89,4132,42,47,2516.67,4587.01,0.00
2024-12-08 17:12:49,88,4132,41,47,2531.21,4587.08,0.00
2024-12-08 17:12:49,88,4133,41,47,2583.36,4588.00,0.00
2024-12-08 17:12:49,89,4133,41,48,2554.33,4588.01,0.00
2024-12-08 17:12:49,90,4132,42,48,2524.42,4588.07,0.00
2024-12-08 17:12:49,89,4132,42,47,2586.31,4588.07,0.00
2024-12-08 17:12:49,89,4133,42,47,2585.31,4589.00,0.00
2024-12-08 17:12:49,90,4133,43,47,2556.58,4589.01,0.00
2024-12-08 17:12:49,89,4133,43,46,2571.41,4589.08,0.00
2024-12-08 17:12:50,89,4134,43,46,2622.49,4590.00,0.00
2024-12-08 17:12:50,90,4134,44,46,2593.35,4590.01,0.00
2024-12-08 17:12:50,89,4134,43,46,2619.93,4590.07,0.00
2024-12-08 17:12:50,89,4135,43,46,2618.93,4591.00,0.00
2024-12-08 17:12:50,90,4135,43,47,2589.83,4591.01,0.00
2024-12-08 17:12:50,89,4135,42,47,2617.39,4591.03,0.00
2024-12-08 17:12:50,88,4135,41,47,2646.11,4591.06,0.00
2024-12-08 17:12:50,87,4135,41,46,2675.99,4591.06,0.00
2024-12-08 17:12:50,86,4135,40,46,2700.72,4591.10,0.00
2024-12-08 17:12:50,86,4136,40,46,2713.55,4592.00,0.00
2024-12-08 17:12:50,87,4136,41,46,2682.36,4592.01,0.00
2024-12-08 17:12:50,86,4136,41,45,2700.22,4592.06,0.00
2024-12-08 17:12:50,85,4136,40,45,2730.91,4592.06,0.00
2024-12-08 17:12:50,85,4137,40,45,2742.29,4593.00,0.00
2024-12-08 17:12:50,86,4137,40,46,2710.40,4593.01,0.00
2024-12-08 17:12:50,87,4136,40,47,2632.69,4593.83,0.00
2024-12-08 17:12:50,87,4137,40,47,2673.50,4594.00,0.00
2024-12-08 17:12:50,88,4137,40,48,2643.12,4594.01,0.00
2024-12-08 17:12:50,87,4137,39,48,2653.47,4594.12,0.00
2024-12-08 17:12:50,87,4138,39,48,2718.97,4595.00,0.00
2024-12-08 17:12:50,88,4138,39,49,2688.07,4595.01,0.00
2024-12-08 17:12:50,87,4138,39,48,2715.83,4595.07,0.00
2024-12-08 17:12:50,86,4138,39,47,2744.74,4595.07,0.00
2024-12-08 17:12:50,85,4138,38,47,2760.96,4595.42,0.00
2024-12-08 17:12:50,85,4139,38,47,2778.15,4596.00,0.00
2024-12-08 17:12:50,86,4139,38,48,2745.84,4596.01,0.00
2024-12-08 17:12:50,86,4140,38,48,2733.08,4597.00,0.00
2024-12-08 17:12:50,87,4140,38,49,2701.66,4597.01,0.00
2024-12-08 17:12:50,86,4140,38,48,2728.29,4597.07,0.00
2024-12-08 17:12:50,85,4140,37,48,2737.80,4597.38,0.00
2024-12-08 17:12:50,85,4141,37,48,2763.67,4598.00,0.00
2024-12-08 17:12:50,86,4141,37,49,2731.53,4598.01,0.00
2024-12-08 17:12:50,86,4142,37,49,2718.76,4599.00,0.00
2024-12-08 17:12:50,87,4142,37,50,2687.51,4599.01,0.00
2024-12-08 17:12:50,86,4142,37,49,2714.51,4599.07,0.00
2024-12-08 17:12:50,87,4141,37,50,2639.29,4599.83,0.00
2024-12-08 17:12:50,87,4142,37,50,2690.74,4600.00,0.00
2024-12-08 17:12:50,88,4142,37,51,2660.16,4600.01,0.00
2024-12-08 17:12:50,88,4143,37,51,2698.90,4601.00,0.00
2024-12-08 17:12:50,89,4143,38,51,2668.58,4601.01,0.00
2024-12-08 17:12:50,88,4143,38,50,2694.75,4601.07,0.00
2024-12-08 17:12:50,87,4143,37,50,2722.55,4601.08,0.00
2024-12-08 17:12:50,87,4144,37,50,2733.69,4602.00,0.00
2024-12-08 17:12:50,88,4144,37,51,2702.63,4602.01,0.00
2024-12-08 17:12:50,87,4144,36,51,2726.82,4602.02,0.00
2024-12-08 17:12:50,87,4145,36,51,2724.76,4603.00,0.00
2024-12-08 17:12:50,88,4145,37,51,2693.80,4603.01,0.00
2024-12-08 17:12:50,87,4145,36,51,2724.23,4603.01,0.00
2024-12-08 17:12:50,87,4146,36,51,2711.07,4604.00,0.00
2024-12-08 17:12:50,88,4146,37,51,2680.26,4604.01,0.00
2024-12-08 17:12:50,87,4146,37,50,2708.97,4604.05,0.00
2024-12-08 17:12:50,87,4147,37,50,2707.95,4605.00,0.00
2024-12-08 17:12:50,88,4147,38,50,2677.18,4605.01,0.00
2024-12-08 17:12:50,87,4147,38,49,2703.74,4605.06,0.00
2024-12-08 17:12:50,87,4148,38,49,2703.25,4606.00,0.00
2024-12-08 17:12:50,88,4148,38,50,2672.53,4606.01,0.00
2024-12-08 17:12:50,87,4148,37,50,2700.62,4606.05,0.00
2024-12-08 17:12:50,87,4149,37,50,2699.60,4607.00,0.00
2024-12-08 17:12:50,88,4149,37,51,2668.92,4607.01,0.00
2024-12-08 17:12:51,87,4149,37,50,2696.44,4607.05,0.00
2024-12-08 17:12:51,87,4150,37,50,2695.41,4608.00,0.00
2024-12-08 17:12:51,88,4150,38,50,2664.78,4608.01,0.00
2024-12-08 17:12:51,89,4149,38,51,2598.34,4608.61,0.00
2024-12-08 17:12:51,89,4150,38,51,2636.45,4609.00,0.00
2024-12-08 17:12:51,90,4150,39,51,2607.16,4609.01,0.00
2024-12-08 17:12:51,89,4150,39,50,2633.88,4609.05,0.00
2024-12-08 17:12:51,88,4150,38,50,2656.54,4609.21,0.00
2024-12-08 17:12:51,88,4151,38,50,2714.66,4610.00,0.00
2024-12-08 17:12:51,89,4151,39,50,2684.16,4610.01,0.00
2024-12-08 17:12:51,89,4152,39,50,2670.23,4611.00,0.00
2024-12-08 17:12:51,90,4152,40,50,2640.56,4611.01,0.00
2024-12-08 17:12:51,90,4153,40,50,2626.28,4612.00,0.00
2024-12-08 17:12:51,91,4153,40,51,2597.42,4612.01,0.00
2024-12-08 17:12:51,91,4154,40,51,2582.77,4613.00,0.00
2024-12-08 17:12:51,92,4154,41,51,2554.70,4613.01,0.00
2024-12-08 17:12:51,92,4155,41,51,2539.71,4614.00,0.00
2024-12-08 17:12:51,93,4155,41,52,2512.40,4614.01,0.00
2024-12-08 17:12:51,92,4155,41,51,2531.20,4614.04,0.00
2024-12-08 17:12:51,92,4156,41,51,2527.71,4615.00,0.00
2024-12-08 17:12:51,93,4156,42,51,2500.54,4615.01,0.00
2024-12-08 17:12:51,92,4156,42,50,2523.72,4615.04,0.00
2024-12-08 17:12:51,93,4155,42,51,2479.34,4615.44,0.00
2024-12-08 17:12:51,93,4156,42,51,2515.47,4616.00,0.00
2024-12-08 17:12:51,94,4156,43,51,2488.71,4616.01,0.00
2024-12-08 17:12:51,93,4156,43,50,2504.57,4616.04,0.00
2024-12-08 17:12:51,93,4157,43,50,2550.27,4617.00,0.00
2024-12-08 17:12:51,94,4157,43,51,2523.14,4617.01,0.00
2024-12-08 17:12:51,93,4157,43,50,2539.37,4617.04,0.00
2024-12-08 17:12:51,93,4158,43,50,2535.43,4618.00,0.00
2024-12-08 17:12:51,94,4158,44,50,2508.46,4618.01,0.00
2024-12-08 17:12:51,93,4158,44,49,2524.03,4618.04,0.00
2024-12-08 17:12:51,92,4158,43,49,2534.48,4618.33,0.00
2024-12-08 17:12:51,93,4157,44,49,2483.22,4618.87,0.00
2024-12-08 17:12:51,93,4158,44,49,2532.01,4619.00,0.00
2024-12-08 17:12:51,94,4158,45,49,2505.07,4619.01,0.00
2024-12-08 17:12:51,93,4158,45,48,2520.60,4619.04,0.00
2024-12-08 17:12:51,92,4158,44,48,2534.48,4619.17,0.00
2024-12-08 17:12:51,92,4159,44,48,2597.24,4620.00,0.00
2024-12-08 17:12:51,93,4159,44,49,2569.32,4620.01,0.00
2024-12-08 17:12:51,92,4159,43,49,2579.69,4620.10,0.00
2024-12-08 17:12:51,92,4159,43,49,2588.76,4621.00,0.00
2024-12-08 17:12:51,93,4159,44,49,2560.93,4621.01,0.00
2024-12-08 17:12:51,92,4159,43,49,2584.77,4621.07,0.00
2024-12-08 17:12:51,91,4159,43,48,2611.14,4621.07,0.00
2024-12-08 17:12:51,91,4160,43,48,2619.30,4622.00,0.00
2024-12-08 17:12:51,92,4160,44,48,2590.83,4622.01,0.00
2024-12-08 17:12:51,91,4160,43,48,2607.64,4622.06,0.00
2024-12-08 17:12:51,91,4161,43,48,2605.14,4623.00,0.00
2024-12-08 17:12:51,92,4161,44,48,2576.82,4623.01,0.00
2024-12-08 17:12:51,91,4161,44,47,2601.60,4623.06,0.00
2024-12-08 17:12:51,91,4162,44,47,2599.09,4624.00,0.00
2024-12-08 17:12:51,92,4162,44,48,2570.84,4624.01,0.00
2024-12-08 17:12:51,92,4163,44,48,2555.82,4625.00,0.00
2024-12-08 17:12:51,93,4163,44,49,2528.33,4625.01,0.00
2024-12-08 17:12:51,92,4163,44,48,2551.82,4625.07,0.00
2024-12-08 17:12:52,92,4164,44,48,2549.33,4626.00,0.00
2024-12-08 17:12:52,93,4164,44,49,2521.92,4626.01,0.00
2024-12-08 17:12:52,94,4163,45,49,2464.25,4626.49,0.00
2024-12-08 17:12:52,93,4163,44,49,2511.15,4626.50,0.00
2024-12-08 17:12:52,93,4164,44,49,2527.93,4627.00,0.00
2024-12-08 17:12:52,94,4164,45,49,2501.04,4627.01,0.00
2024-12-08 17:12:52,93,4164,45,48,2523.98,4627.06,0.00
2024-12-08 17:12:52,93,4165,45,48,2570.78,4628.00,0.00
2024-12-08 17:12:52,94,4165,46,48,2543.43,4628.01,0.00
2024-12-08 17:12:52,93,4165,45,48,2547.96,4628.27,0.00
2024-12-08 17:12:52,94,4164,46,48,2512.08,4628.48,0.00
2024-12-08 17:12:52,94,4165,46,48,2551.37,4629.00,0.00
2024-12-08 17:12:52,95,4165,46,49,2524.51,4629.01,0.00
2024-12-08 17:12:52,94,4165,46,48,2547.94,4629.06,0.00
2024-12-08 17:12:52,94,4166,46,48,2593.78,4630.00,0.00
2024-12-08 17:12:52,95,4166,46,49,2566.48,4630.01,0.00
2024-12-08 17:12:52,95,4167,46,49,2550.46,4631.00,0.00
2024-12-08 17:12:52,96,4167,47,49,2523.89,4631.01,0.00
2024-12-08 17:12:52,95,4167,47,48,2547.56,4631.06,0.00
2024-12-08 17:12:52,95,4168,47,48,2543.70,4632.00,0.00
2024-12-08 17:12:52,96,4168,47,49,2517.20,4632.01,0.00
2024-12-08 17:12:52,96,4169,47,49,2500.85,4633.00,0.00
2024-12-08 17:12:52,97,4169,48,49,2475.07,4633.01,0.00
2024-12-08 17:12:52,96,4169,48,48,2495.56,4633.06,0.00
2024-12-08 17:12:52,96,4170,48,48,2491.26,4634.00,0.00
2024-12-08 17:12:52,97,4170,49,48,2465.57,4634.01,0.00
2024-12-08 17:12:52,98,4169,49,49,2416.85,4634.34,0.00
2024-12-08 17:12:52,98,4170,49,49,2436.21,4635.00,0.00
2024-12-08 17:12:52,99,4170,50,49,2411.60,4635.01,0.00
2024-12-08 17:12:52,98,4170,49,49,2433.39,4635.06,0.00
2024-12-08 17:12:52,97,4170,49,48,2456.57,4635.07,0.00
2024-12-08 17:12:52,96,4170,48,48,2474.00,4635.25,0.00
2024-12-08 17:12:52,96,4171,48,48,2526.62,4636.00,0.00
2024-12-08 17:12:52,97,4171,48,49,2500.57,4636.01,0.00
2024-12-08 17:12:52,96,4171,47,49,2523.74,4636.06,0.00
2024-12-08 17:12:52,96,4172,47,49,2509.78,4637.00,0.00
2024-12-08 17:12:52,97,4172,47,50,2483.90,4637.01,0.00
2024-12-08 17:12:52,96,4172,47,49,2506.41,4637.06,0.00
2024-12-08 17:12:52,96,4173,47,49,2502.10,4638.00,0.00
2024-12-08 17:12:52,97,4173,48,49,2476.31,4638.01,0.00
2024-12-08 17:12:52,97,4174,48,49,2459.63,4639.00,0.00
2024-12-08 17:12:52,98,4174,48,50,2434.53,4639.01,0.00
2024-12-08 17:12:52,99,4173,48,51,2409.47,4639.04,0.00
2024-12-08 17:12:52,98,4173,47,51,2473.84,4639.05,0.00
2024-12-08 17:12:52,99,4172,47,52,2424.12,4639.40,0.00
2024-12-08 17:12:52,99,4173,47,52,2457.79,4640.00,0.00
2024-12-08 17:12:52,100,4173,47,53,2433.21,4640.01,0.00
2024-12-08 17:12:52,99,4173,47,52,2452.66,4640.05,0.00
2024-12-08 17:12:52,99,4174,47,52,2540.36,4641.00,0.00
2024-12-08 17:12:52,100,4174,48,52,2514.96,4641.01,0.00
2024-12-08 17:12:52,99,4174,48,51,2529.60,4641.05,0.00
2024-12-08 17:12:52,98,4174,47,51,2554.00,4641.07,0.00
2024-12-08 17:12:52,98,4175,47,51,2549.31,4642.00,0.00
2024-12-08 17:12:52,99,4175,47,52,2523.56,4642.01,0.00
2024-12-08 17:12:52,98,4175,47,51,2538.91,4642.05,0.00
2024-12-08 17:12:52,98,4176,47,51,2533.28,4643.00,0.00
2024-12-08 17:12:52,99,4176,48,51,2507.69,4643.01,0.00
2024-12-08 17:12:52,98,4176,48,50,2522.88,4643.05,0.00
2024-12-08 17:12:52,97,4176,47,50,2548.89,4643.05,0.00
2024-12-08 17:12:53,97,4177,47,50,2543.67,4644.00,0.00
2024-12-08 17:12:53,98,4177,48,50,2517.71,4644.01,0.00
2024-12-08 17:12:53,97,4177,48,49,2532.20,4644.05,0.00
2024-12-08 17:12:53,97,4178,48,49,2526.97,4645.00,0.00
2024-12-08 17:12:53,98,4178,49,49,2501.19,4645.01,0.00
2024-12-08 17:12:53,97,4178,48,49,2525.08,4645.05,0.00
2024-12-08 17:12:53,98,4177,49,49,2461.08,4645.49,0.00
2024-12-08 17:12:53,98,4178,49,49,2505.05,4646.00,0.00
2024-12-08 17:12:53,99,4178,50,49,2479.74,4646.01,0.00
2024-12-08 17:12:53,98,4178,50,48,2501.28,4646.07,0.00
2024-12-08 17:12:53,97,4178,49,48,2515.17,4646.30,0.00
2024-12-08 17:12:53,97,4179,49,48,2578.84,4647.00,0.00
2024-12-08 17:12:53,98,4179,50,48,2552.53,4647.01,0.00
2024-12-08 17:12:53,97,4179,49,48,2576.95,4647.05,0.00
2024-12-08 17:12:53,97,4180,49,48,2562.15,4648.00,0.00
2024-12-08 17:12:53,98,4180,49,49,2536.01,4648.01,0.00
2024-12-08 17:12:53,97,4180,48,49,2560.25,4648.05,0.00
2024-12-08 17:12:53,96,4180,48,48,2586.44,4648.05,0.00
2024-12-08 17:12:53,96,4181,48,48,2581.65,4649.00,0.00
2024-12-08 17:12:53,97,4181,49,48,2555.03,4649.01,0.00
2024-12-08 17:12:53,97,4182,49,48,2538.32,4650.00,0.00
2024-12-08 17:12:53,98,4182,49,49,2512.42,4650.01,0.00
2024-12-08 17:12:53,99,4181,50,49,2472.52,4650.14,0.00
2024-12-08 17:12:53,99,4182,50,49,2513.42,4651.00,0.00
2024-12-08 17:12:53,100,4182,50,50,2488.28,4651.01,0.00
2024-12-08 17:12:53,100,4183,50,50,2517.20,4652.00,0.00
2024-12-08 17:12:53,101,4183,51,50,2492.27,4652.01,0.00
2024-12-08 17:12:53,100,4183,50,50,2509.77,4652.04,0.00
2024-12-08 17:12:53,99,4183,50,49,2533.24,4652.04,0.00
2024-12-08 17:12:53,100,4182,50,50,2499.13,4652.25,0.00
2024-12-08 17:12:53,100,4183,50,50,2516.81,4653.00,0.00
2024-12-08 17:12:53,101,4183,50,51,2491.89,4653.01,0.00
2024-12-08 17:12:53,100,4183,50,50,2506.58,4653.04,0.00
2024-12-08 17:12:53,99,4183,49,50,2494.58,4653.69,0.00
2024-12-08 17:12:53,99,4184,49,50,2574.27,4654.00,0.00
2024-12-08 17:12:53,100,4184,50,50,2548.53,4654.01,0.00
2024-12-08 17:12:53,99,4184,50,49,2563.94,4654.04,0.00
2024-12-08 17:12:53,98,4184,49,49,2561.31,4654.48,0.00
2024-12-08 17:12:53,98,4185,49,49,2584.95,4655.00,0.00
2024-12-08 17:12:53,99,4185,50,49,2558.84,4655.01,0.00
2024-12-08 17:12:53,98,4185,50,48,2574.51,4655.04,0.00
2024-12-08 17:12:53,99,4184,51,48,2542.90,4655.18,0.00
2024-12-08 17:12:53,99,4185,51,48,2556.10,4656.00,0.00
2024-12-08 17:12:53,100,4185,52,48,2530.53,4656.01,0.00
2024-12-08 17:12:53,99,4185,52,47,2545.29,4656.04,0.00
2024-12-08 17:12:53,99,4186,52,47,2585.81,4657.00,0.00
2024-12-08 17:12:53,100,4186,53,47,2559.95,4657.01,0.00
2024-12-08 17:12:53,99,4186,52,47,2584.41,4657.04,0.00
2024-12-08 17:12:53,98,4186,52,46,2600.81,4657.04,0.00
2024-12-08 17:12:53,97,4186,51,46,2614.71,4657.19,0.00
2024-12-08 17:12:53,97,4187,51,46,2625.29,4658.00,0.00
2024-12-08 17:12:53,98,4187,52,46,2598.50,4658.01,0.00
2024-12-08 17:12:53,98,4188,52,46,2581.46,4659.00,0.00
2024-12-08 17:12:53,99,4188,52,47,2555.39,4659.01,0.00
2024-12-08 17:12:53,98,4188,51,47,2538.40,4659.52,0.00
2024-12-08 17:12:53,98,4189,51,47,2563.95,4660.00,0.00
2024-12-08 17:12:53,99,4189,51,48,2538.05,4660.01,0.00
2024-12-08 17:12:53,99,4190,51,48,2520.71,4661.00,0.00
2024-12-08 17:12:53,100,4190,51,49,2495.50,4661.01,0.00
2024-12-08 17:12:53,99,4190,51,48,2502.83,4661.05,0.00
2024-12-08 17:12:54,98,4190,50,48,2527.89,4661.06,0.00
2024-12-08 17:12:54,97,4190,49,48,2553.00,4661.07,0.00
2024-12-08 17:12:54,97,4191,49,48,2558.33,4662.00,0.00
2024-12-08 17:12:54,98,4191,50,48,2532.23,4662.01,0.00
2024-12-08 17:12:54,97,4191,50,47,2547.29,4662.05,0.00
2024-12-08 17:12:54,96,4191,49,47,2563.22,4662.28,0.00
2024-12-08 17:12:54,95,4191,48,47,2580.48,4662.50,0.00
2024-12-08 17:12:54,95,4192,48,47,2596.55,4663.00,0.00
2024-12-08 17:12:54,96,4192,48,48,2569.51,4663.01,0.00
2024-12-08 17:12:54,97,4191,48,49,2542.07,4663.05,0.00
2024-12-08 17:12:54,96,4191,47,49,2597.70,4663.07,0.00
2024-12-08 17:12:54,96,4192,47,49,2593.86,4664.00,0.00
2024-12-08 17:12:54,97,4192,47,50,2567.12,4664.01,0.00
2024-12-08 17:12:54,96,4192,47,49,2587.08,4664.05,0.00
2024-12-08 17:12:54,97,4191,48,49,2521.27,4664.71,0.00
2024-12-08 17:12:54,97,4192,48,49,2615.28,4665.00,0.00
2024-12-08 17:12:54,98,4192,48,50,2588.60,4665.01,0.00
2024-12-08 17:12:54,97,4192,48,49,2604.24,4665.05,0.00
2024-12-08 17:12:54,96,4192,47,49,2631.37,4665.05,0.00
2024-12-08 17:12:54,95,4192,46,49,2648.35,4665.27,0.00
2024-12-08 17:12:54,95,4193,46,49,2703.33,4666.00,0.00
2024-12-08 17:12:54,96,4193,47,49,2675.17,4666.01,0.00
2024-12-08 17:12:54,95,4193,46,49,2690.11,4666.07,0.00
2024-12-08 17:12:54,95,4194,46,49,2696.54,4667.00,0.00
2024-12-08 17:12:54,96,4194,46,50,2668.45,4667.01,0.00
2024-12-08 17:12:54,96,4195,46,50,2652.01,4668.00,0.00
2024-12-08 17:12:54,97,4195,46,51,2624.67,4668.01,0.00
2024-12-08 17:12:54,96,4195,46,50,2639.39,4668.06,0.00
2024-12-08 17:12:54,97,4194,47,50,2586.90,4668.63,0.00
2024-12-08 17:12:54,97,4195,47,50,2621.86,4669.00,0.00
2024-12-08 17:12:54,98,4195,47,51,2595.10,4669.01,0.00
2024-12-08 17:12:54,97,4195,47,50,2610.33,4669.06,0.00
2024-12-08 17:12:54,97,4196,47,50,2653.71,4670.00,0.00
2024-12-08 17:12:54,98,4196,47,51,2626.64,4670.01,0.00
2024-12-08 17:12:54,97,4196,46,51,2651.81,4670.04,0.00
2024-12-08 17:12:54,97,4197,46,51,2636.47,4671.00,0.00
2024-12-08 17:12:54,98,4197,46,52,2609.56,4671.01,0.00
2024-12-08 17:12:54,97,4197,45,52,2634.09,4671.06,0.00
2024-12-08 17:12:54,96,4197,45,51,2661.05,4671.06,0.00
2024-12-08 17:12:54,95,4197,44,51,2679.77,4671.26,0.00
2024-12-08 17:12:54,95,4198,44,51,2685.17,4672.00,0.00
2024-12-08 17:12:54,96,4198,45,51,2657.20,4672.01,0.00
2024-12-08 17:12:54,96,4199,45,51,2640.73,4673.00,0.00
2024-12-08 17:12:54,97,4199,45,52,2613.51,4673.01,0.00
2024-12-08 17:12:54,96,4199,45,51,2637.36,4673.07,0.00
2024-12-08 17:12:54,96,4200,45,51,2633.51,4674.00,0.00
2024-12-08 17:12:54,97,4200,45,52,2606.36,4674.01,0.00
2024-12-08 17:12:54,96,4200,45,51,2620.88,4674.07,0.00
2024-12-08 17:12:54,95,4200,44,51,2612.33,4674.68,0.00
2024-12-08 17:12:54,95,4201,44,51,2647.03,4675.00,0.00
2024-12-08 17:12:54,96,4201,44,52,2619.46,4675.01,0.00
2024-12-08 17:12:54,95,4201,44,51,2634.28,4675.07,0.00
2024-12-08 17:12:54,95,4202,44,51,2630.86,4676.00,0.00
2024-12-08 17:12:54,96,4202,45,51,2603.46,4676.01,0.00
2024-12-08 17:12:54,95,4202,45,50,2618.10,4676.07,0.00
2024-12-08 17:12:54,94,4202,44,50,2634.05,4676.19,0.00
2024-12-08 17:12:54,94,4203,44,50,2646.48,4677.00,0.00
2024-12-08 17:12:54,95,4203,45,50,2618.63,4677.01,0.00
2024-12-08 17:12:54,94,4203,45,49,2633.58,4677.08,0.00
2024-12-08 17:12:54,94,4204,45,49,2630.63,4678.00,0.00
2024-12-08 17:12:54,95,4204,45,50,2602.94,4678.01,0.00
2024-12-08 17:12:54,94,4204,45,49,2617.72,4678.08,0.00
2024-12-08 17:12:54,94,4205,45,49,2614.76,4679.00,0.00
2024-12-08 17:12:54,95,4205,45,50,2587.24,4679.01,0.00
2024-12-08 17:12:54,94,4205,45,49,2601.85,4679.08,0.00
2024-12-08 17:12:54,93,4205,44,49,2621.33,4679.26,0.00
2024-12-08 17:12:55,93,4206,44,49,2627.34,4680.00,0.00
2024-12-08 17:12:55,94,4206,45,49,2599.39,4680.01,0.00
2024-12-08 17:12:55,93,4206,45,48,2614.29,4680.08,0.00
2024-12-08 17:12:55,93,4207,45,48,2611.80,4681.00,0.00
2024-12-08 17:12:55,94,4207,45,49,2584.01,4681.01,0.00
2024-12-08 17:12:55,93,4207,45,48,2599.25,4681.08,0.00
2024-12-08 17:12:55,93,4208,45,48,2596.75,4682.00,0.00
2024-12-08 17:12:55,94,4208,45,49,2569.12,4682.01,0.00
2024-12-08 17:12:55,93,4208,45,48,2584.19,4682.08,0.00
2024-12-08 17:12:55,94,4207,46,48,2523.67,4682.81,0.00
2024-12-08 17:12:55,94,4208,46,48,2573.16,4683.00,0.00
2024-12-08 17:12:55,95,4208,47,48,2546.07,4683.01,0.00
2024-12-08 17:12:55,95,4209,47,48,2579.16,4684.00,0.00
2024-12-08 17:12:55,96,4209,48,48,2552.29,4684.01,0.00
2024-12-08 17:12:55,96,4210,48,48,2535.75,4685.00,0.00
2024-12-08 17:12:55,97,4210,49,48,2509.61,4685.01,0.00
2024-12-08 17:12:55,96,4210,48,48,2522.12,4685.09,0.00
2024-12-08 17:12:55,96,4211,48,48,2519.21,4686.00,0.00
2024-12-08 17:12:55,97,4211,49,48,2493.24,4686.01,0.00
2024-12-08 17:12:55,96,4211,49,47,2506.55,4686.07,0.00
2024-12-08 17:12:55,95,4211,49,46,2531.95,4686.08,0.00
2024-12-08 17:12:55,94,4211,48,46,2549.96,4686.27,0.00
2024-12-08 17:12:55,94,4212,48,46,2555.91,4687.00,0.00
2024-12-08 17:12:55,95,4212,48,47,2529.01,4687.01,0.00
2024-12-08 17:12:55,95,4213,48,47,2512.77,4688.00,0.00
2024-12-08 17:12:55,96,4213,48,48,2486.59,4688.01,0.00
2024-12-08 17:12:55,95,4213,47,48,2512.27,4688.01,0.00
2024-12-08 17:12:55,94,4213,47,47,2530.55,4688.08,0.00
2024-12-08 17:12:55,93,4213,46,47,2547.70,4688.17,0.00
2024-12-08 17:12:55,93,4214,46,47,2559.79,4689.00,0.00
2024-12-08 17:12:55,94,4214,46,48,2532.56,4689.01,0.00
2024-12-08 17:12:55,93,4214,46,47,2546.71,4689.08,0.00
2024-12-08 17:12:55,92,4214,45,47,2566.79,4689.24,0.00
2024-12-08 17:12:55,92,4215,45,47,2572.36,4690.00,0.00
2024-12-08 17:12:55,93,4215,45,48,2544.70,4690.01,0.00
2024-12-08 17:12:55,93,4216,45,48,2529.10,4691.00,0.00
2024-12-08 17:12:55,94,4216,45,49,2502.20,4691.01,0.00
2024-12-08 17:12:55,93,4216,45,48,2524.59,4691.09,0.00
2024-12-08 17:12:55,92,4216,44,48,2548.47,4691.11,0.00
2024-12-08 17:12:55,93,4215,44,49,2513.04,4691.30,0.00
2024-12-08 17:12:55,93,4216,44,49,2559.41,4692.00,0.00
2024-12-08 17:12:55,94,4216,45,49,2532.18,4692.01,0.00
2024-12-08 17:12:55,93,4216,44,49,2556.91,4692.05,0.00
2024-12-08 17:12:55,93,4217,44,49,2593.76,4693.00,0.00
2024-12-08 17:12:55,94,4217,44,50,2566.17,4693.01,0.00
2024-12-08 17:12:55,93,4217,43,50,2590.26,4693.08,0.00
2024-12-08 17:12:55,92,4217,43,49,2617.39,4693.08,0.00
2024-12-08 17:12:55,92,4218,43,49,2615.37,4694.00,0.00
2024-12-08 17:12:55,93,4218,43,50,2587.25,4694.01,0.00
2024-12-08 17:12:55,93,4219,43,50,2571.65,4695.00,0.00
2024-12-08 17:12:55,94,4219,43,51,2544.29,4695.01,0.00
2024-12-08 17:12:55,93,4219,43,50,2568.14,4695.08,0.00
2024-12-08 17:12:55,92,4219,42,50,2588.95,4695.23,0.00
2024-12-08 17:12:55,92,4220,42,50,2594.03,4696.00,0.00
2024-12-08 17:12:55,93,4220,42,51,2566.14,4696.01,0.00
2024-12-08 17:12:55,93,4221,42,51,2550.52,4697.00,0.00
2024-12-08 17:12:55,94,4221,42,52,2523.39,4697.01,0.00
2024-12-08 17:12:55,93,4221,42,51,2546.51,4697.09,0.00
2024-12-08 17:12:55,92,4221,41,51,2557.94,4697.35,0.00
2024-12-08 17:12:55,91,4221,40,51,2577.86,4697.52,0.00
2024-12-08 17:12:56,91,4222,40,51,2607.13,4698.00,0.00
2024-12-08 17:12:56,92,4222,40,52,2578.79,4698.01,0.00
2024-12-08 17:12:56,92,4223,40,52,2563.51,4699.00,0.00
2024-12-08 17:12:56,93,4223,41,52,2535.94,4699.01,0.00
2024-12-08 17:12:56,92,4223,41,51,2558.94,4699.09,0.00
2024-12-08 17:12:56,91,4223,40,51,2579.36,4699.25,0.00
2024-12-08 17:12:56,91,4224,40,51,2586.03,4700.00,0.00
2024-12-08 17:12:56,92,4224,41,51,2557.92,4700.01,0.00
2024-12-08 17:12:56,92,4225,41,51,2542.63,4701.00,0.00
2024-12-08 17:12:56,93,4225,42,51,2515.29,4701.01,0.00
2024-12-08 17:12:56,92,4225,42,50,2536.01,4701.11,0.00
2024-12-08 17:12:56,91,4225,41,50,2555.16,4701.29,0.00
2024-12-08 17:12:56,90,4225,40,50,2581.47,4701.30,0.00
2024-12-08 17:12:56,90,4226,40,50,2601.25,4702.00,0.00
2024-12-08 17:12:56,91,4226,41,50,2572.66,4702.01,0.00
2024-12-08 17:12:56,91,4227,41,50,2557.71,4703.00,0.00
2024-12-08 17:12:56,92,4227,42,50,2529.91,4703.01,0.00
2024-12-08 17:12:56,91,4227,41,50,2555.14,4703.06,0.00
2024-12-08 17:12:56,90,4227,40,50,2582.49,4703.08,0.00
2024-12-08 17:12:56,89,4227,40,49,2609.40,4703.09,0.00
2024-12-08 17:12:56,89,4228,40,49,2609.40,4704.00,0.00
2024-12-08 17:12:56,90,4228,40,50,2580.40,4704.01,0.00
2024-12-08 17:12:56,89,4228,39,50,2606.25,4704.08,0.00
2024-12-08 17:12:56,88,4228,38,50,2622.50,4704.09,0.00
2024-12-08 17:12:56,88,4229,38,50,2633.73,4705.00,0.00
2024-12-08 17:12:56,89,4229,39,50,2604.14,4705.01,0.00
2024-12-08 17:12:56,88,4229,39,49,2629.48,4705.08,0.00
2024-12-08 17:12:56,87,4229,38,49,2651.11,4705.25,0.00
2024-12-08 17:12:56,87,4230,38,49,2659.70,4706.00,0.00
2024-12-08 17:12:56,88,4230,39,49,2629.48,4706.01,0.00
2024-12-08 17:12:56,89,4229,40,49,2598.88,4706.06,0.00
2024-12-08 17:12:56,89,4230,40,49,2613.18,4707.00,0.00
2024-12-08 17:12:56,90,4230,41,49,2584.14,4707.01,0.00
2024-12-08 17:12:56,89,4230,41,48,2608.44,4707.08,0.00
2024-12-08 17:12:56,88,4230,40,48,2629.59,4707.25,0.00
2024-12-08 17:12:56,88,4231,40,48,2691.05,4708.00,0.00
2024-12-08 17:12:56,89,4231,40,49,2660.81,4708.01,0.00
2024-12-08 17:12:56,89,4232,40,49,2646.56,4709.00,0.00
2024-12-08 17:12:56,90,4232,41,49,2617.16,4709.01,0.00
2024-12-08 17:12:56,89,4232,40,49,2643.94,4709.06,0.00
2024-12-08 17:12:56,88,4232,40,48,2672.38,4709.07,0.00
2024-12-08 17:12:56,88,4233,40,48,2671.85,4710.00,0.00
2024-12-08 17:12:56,89,4233,40,49,2641.83,4710.01,0.00
2024-12-08 17:12:56,88,4233,39,49,2640.39,4710.35,0.00
2024-12-08 17:12:56,88,4234,39,49,2663.85,4711.00,0.00
2024-12-08 17:12:56,89,4234,39,50,2633.92,4711.01,0.00
2024-12-08 17:12:56,88,4234,38,50,2660.67,4711.07,0.00
2024-12-08 17:12:56,87,4234,38,49,2690.17,4711.07,0.00
2024-12-08 17:12:56,87,4235,38,49,2690.17,4712.00,0.00
2024-12-08 17:12:56,88,4235,39,49,2659.60,4712.01,0.00
2024-12-08 17:12:56,88,4236,39,49,2645.71,4713.00,0.00
2024-12-08 17:12:56,89,4236,39,50,2615.98,4713.01,0.00
2024-12-08 17:12:56,88,4236,38,50,2642.52,4713.07,0.00
2024-12-08 17:12:56,88,4237,38,50,2631.27,4714.00,0.00
2024-12-08 17:12:56,89,4237,39,50,2601.70,4714.01,0.00
2024-12-08 17:12:56,89,4238,39,50,2587.42,4715.00,0.00
2024-12-08 17:12:56,90,4238,40,50,2558.67,4715.01,0.00
2024-12-08 17:12:56,89,4238,40,49,2575.79,4715.07,0.00
2024-12-08 17:12:56,88,4238,39,49,2596.01,4715.26,0.00
2024-12-08 17:12:56,88,4239,39,49,2604.21,4716.00,0.00
2024-12-08 17:12:56,89,4239,39,50,2574.95,4716.01,0.00
2024-12-08 17:12:56,88,4239,38,50,2601.56,4716.06,0.00
2024-12-08 17:12:56,87,4239,38,49,2619.54,4716.07,0.00
2024-12-08 17:12:57,86,4239,37,49,2628.14,4716.51,0.00
2024-12-08 17:12:57,86,4240,37,49,2649.34,4717.00,0.00
2024-12-08 17:12:57,87,4240,37,50,2618.89,4717.01,0.00
2024-12-08 17:12:57,86,4240,37,49,2635.11,4717.07,0.00
2024-12-08 17:12:57,86,4241,37,49,2634.72,4718.00,0.00
2024-12-08 17:12:57,87,4241,38,49,2604.44,4718.01,0.00
2024-12-08 17:12:57,87,4242,38,49,2589.53,4719.00,0.00
2024-12-08 17:12:57,88,4242,39,49,2560.10,4719.01,0.00
2024-12-08 17:12:57,88,4243,39,49,2544.24,4720.00,0.00
2024-12-08 17:12:57,89,4243,40,49,2515.66,4720.01,0.00
2024-12-08 17:12:57,88,4243,40,48,2536.76,4720.07,0.00
2024-12-08 17:12:57,88,4244,40,48,2534.41,4721.00,0.00
2024-12-08 17:12:57,89,4244,40,49,2505.93,4721.01,0.00
2024-12-08 17:12:57,88,4244,40,48,2521.55,4721.07,0.00
2024-12-08 17:12:57,88,4245,40,48,2520.01,4722.00,0.00
2024-12-08 17:12:57,89,4245,40,49,2491.69,4722.01,0.00
2024-12-08 17:12:57,88,4245,40,48,2507.69,4722.07,0.00
2024-12-08 17:12:57,88,4246,40,48,2507.12,4723.00,0.00
2024-12-08 17:12:57,89,4246,41,48,2478.95,4723.01,0.00
2024-12-08 17:12:57,89,4247,41,48,2464.62,4724.00,0.00
2024-12-08 17:12:57,90,4247,42,48,2437.23,4724.01,0.00
2024-12-08 17:12:57,89,4247,42,47,2450.84,4724.07,0.00
2024-12-08 17:12:57,89,4248,42,47,2449.74,4725.00,0.00
2024-12-08 17:12:57,90,4248,43,47,2422.52,4725.01,0.00
2024-12-08 17:12:57,89,4248,43,46,2437.55,4725.07,0.00
2024-12-08 17:12:57,88,4248,42,46,2464.71,4725.07,0.00
2024-12-08 17:12:57,87,4248,41,46,2466.02,4725.46,0.00
2024-12-08 17:12:57,86,4248,40,46,2491.43,4725.52,0.00
2024-12-08 17:12:57,86,4249,40,46,2524.20,4726.00,0.00
2024-12-08 17:12:57,87,4249,41,46,2495.18,4726.01,0.00
2024-12-08 17:12:57,87,4250,41,46,2481.58,4727.00,0.00
2024-12-08 17:12:57,88,4250,42,46,2453.38,4727.01,0.00
2024-12-08 17:12:57,88,4251,42,46,2439.40,4728.00,0.00
2024-12-08 17:12:57,89,4251,43,46,2411.99,4728.01,0.00
2024-12-08 17:12:57,88,4251,43,45,2435.11,4728.05,0.00
2024-12-08 17:12:57,87,4251,43,44,2461.47,4728.07,0.00
2024-12-08 17:12:57,87,4252,43,44,2461.43,4729.00,0.00
2024-12-08 17:12:57,88,4252,44,44,2433.46,4729.01,0.00
2024-12-08 17:12:58,88,4253,44,44,2419.47,4730.00,0.00
2024-12-08 17:12:58,89,4253,44,45,2392.28,4730.01,0.00
2024-12-08 17:12:58,88,4253,44,44,2416.26,4730.07,0.00
2024-12-08 17:12:58,87,4253,43,44,2443.49,4730.07,0.00
2024-12-08 17:12:58,87,4254,43,44,2443.44,4731.00,0.00
2024-12-08 17:12:58,88,4254,44,44,2415.68,4731.01,0.00
2024-12-08 17:12:58,87,4254,44,43,2429.32,4731.07,0.00
2024-12-08 17:12:58,87,4255,44,43,2429.27,4732.00,0.00
2024-12-08 17:12:58,88,4255,45,43,2401.67,4732.01,0.00
2024-12-08 17:12:58,87,4255,44,43,2410.26,4732.13,0.00
2024-12-08 17:12:58,87,4256,44,43,2423.80,4733.00,0.00
2024-12-08 17:12:58,88,4256,45,43,2396.26,4733.01,0.00
2024-12-08 17:12:58,87,4256,45,42,2419.47,4733.09,0.00
2024-12-08 17:12:58,86,4256,44,42,2437.75,4733.30,0.00
2024-12-08 17:12:58,86,4257,44,42,2449.20,4734.00,0.00
2024-12-08 17:12:58,87,4257,45,42,2421.05,4734.01,0.00
2024-12-08 17:12:58,87,4258,45,42,2407.41,4735.00,0.00
2024-12-08 17:12:58,88,4258,45,43,2380.05,4735.01,0.00
2024-12-08 17:12:58,87,4258,44,43,2405.25,4735.05,0.00
2024-12-08 17:12:58,86,4258,43,43,2431.02,4735.08,0.00
2024-12-08 17:12:58,85,4258,43,42,2456.28,4735.09,0.00
2024-12-08 17:12:58,85,4259,43,42,2458.45,4736.00,0.00
2024-12-08 17:12:58,86,4259,44,42,2429.86,4736.01,0.00
2024-12-08 17:12:58,86,4260,44,42,2416.60,4737.00,0.00
2024-12-08 17:12:58,87,4260,44,43,2388.83,4737.01,0.00
2024-12-08 17:12:58,86,4260,44,42,2410.56,4737.09,0.00
2024-12-08 17:12:58,86,4261,44,42,2412.15,4738.00,0.00
2024-12-08 17:12:58,87,4261,44,43,2384.43,4738.01,0.00
2024-12-08 17:12:58,88,4260,45,43,2302.17,4738.75,0.00
2024-12-08 17:12:58,88,4261,45,43,2366.99,4739.00,0.00
2024-12-08 17:12:58,89,4261,46,43,2340.39,4739.01,0.00
2024-12-08 17:12:58,88,4261,45,43,2366.45,4739.01,0.00
2024-12-08 17:12:58,87,4261,45,42,2388.76,4739.08,0.00
2024-12-08 17:12:58,87,4262,45,42,2443.73,4740.00,0.00
2024-12-08 17:12:58,88,4262,45,43,2415.96,4740.01,0.00
2024-12-08 17:12:58,87,4262,45,42,2434.48,4740.06,0.00
2024-12-08 17:12:58,87,4263,45,42,2433.89,4741.00,0.00
2024-12-08 17:12:58,88,4263,46,42,2406.24,4741.01,0.00
2024-12-08 17:12:58,88,4264,46,42,2392.19,4742.00,0.00
2024-12-08 17:12:58,89,4264,46,43,2365.32,4742.01,0.00
2024-12-08 17:12:58,88,4264,45,43,2391.12,4742.01,0.00
2024-12-08 17:12:58,87,4264,45,42,2414.80,4742.07,0.00
2024-12-08 17:12:58,86,4264,44,42,2431.91,4742.29,0.00
2024-12-08 17:12:58,86,4265,44,42,2453.86,4743.00,0.00
2024-12-08 17:12:58,87,4265,44,43,2425.65,4743.01,0.00
2024-12-08 17:12:58,86,4265,44,42,2439.53,4743.07,0.00
2024-12-08 17:12:58,86,4266,44,42,2440.03,4744.00,0.00
2024-12-08 17:12:58,87,4266,44,43,2411.99,4744.01,0.00
2024-12-08 17:12:58,88,4265,45,43,2382.97,4744.07,0.00
2024-12-08 17:12:58,87,4265,45,42,2446.36,4744.08,0.00
2024-12-08 17:12:58,86,4265,44,42,2465.48,4744.28,0.00
2024-12-08 17:12:58,86,4266,44,42,2475.86,4745.00,0.00
2024-12-08 17:12:58,87,4266,44,43,2447.40,4745.01,0.00
2024-12-08 17:12:58,86,4266,44,42,2460.99,4745.08,0.00
2024-12-08 17:12:58,86,4267,44,42,2517.22,4746.00,0.00
2024-12-08 17:12:58,87,4267,45,42,2488.28,4746.01,0.00
2024-12-08 17:12:58,86,4267,44,42,2516.12,4746.02,0.00
2024-12-08 17:12:58,85,4267,44,41,2538.86,4746.08,0.00
2024-12-08 17:12:58,85,4268,44,41,2540.48,4747.00,0.00
2024-12-08 17:12:58,86,4268,45,41,2510.94,4747.01,0.00
2024-12-08 17:12:58,85,4268,44,41,2526.54,4747.07,0.00
2024-12-08 17:12:59,85,4269,44,41,2527.61,4748.00,0.00
2024-12-08 17:12:59,86,4269,44,42,2498.22,4748.01,0.00
2024-12-08 17:12:59,85,4269,44,41,2524.28,4748.07,0.00
2024-12-08 17:12:59,84,4269,43,41,2553.77,4748.07,0.00
2024-12-08 17:12:59,84,4270,43,41,2555.41,4749.00,0.00
2024-12-08 17:12:59,85,4270,43,42,2525.35,4749.01,0.00
2024-12-08 17:12:59,84,4270,43,41,2540.74,4749.07,0.00
2024-12-08 17:12:59,84,4271,43,41,2542.38,4750.00,0.00
2024-12-08 17:12:59,85,4271,43,42,2512.47,4750.01,0.00
2024-12-08 17:12:59,85,4272,43,42,2499.58,4751.00,0.00
2024-12-08 17:12:59,86,4272,44,42,2470.52,4751.01,0.00
2024-12-08 17:12:59,85,4272,44,41,2495.69,4751.08,0.00
2024-12-08 17:12:59,84,4272,43,41,2511.29,4751.19,0.00
2024-12-08 17:12:59,84,4273,43,41,2529.87,4752.00,0.00
2024-12-08 17:12:59,85,4273,43,42,2500.11,4752.01,0.00
2024-12-08 17:12:59,84,4273,42,42,2528.75,4752.02,0.00
2024-12-08 17:12:59,84,4273,42,42,2516.83,4753.00,0.00
2024-12-08 17:12:59,85,4273,42,43,2487.22,4753.01,0.00
2024-12-08 17:12:59,84,4273,42,42,2513.45,4753.07,0.00
2024-12-08 17:12:59,84,4274,42,42,2515.09,4754.00,0.00
2024-12-08 17:12:59,85,4274,43,42,2485.50,4754.01,0.00
2024-12-08 17:12:59,84,4274,43,41,2500.40,4754.07,0.00
2024-12-08 17:12:59,84,4275,43,41,2502.03,4755.00,0.00
2024-12-08 17:12:59,85,4275,44,41,2472.60,4755.01,0.00
2024-12-08 17:12:59,84,4275,44,40,2487.34,4755.07,0.00
2024-12-08 17:12:59,83,4275,43,40,2497.41,4755.49,0.00
2024-12-08 17:12:59,83,4276,43,40,2519.53,4756.00,0.00
2024-12-08 17:12:59,84,4276,44,40,2489.54,4756.01,0.00
2024-12-08 17:12:59,84,4277,44,40,2477.04,4757.00,0.00
2024-12-08 17:12:59,85,4277,45,40,2447.90,4757.01,0.00
2024-12-08 17:12:59,84,4277,45,39,2472.53,4757.08,0.00
2024-12-08 17:12:59,85,4276,46,39,2406.88,4757.88,0.00
2024-12-08 17:12:59,85,4277,46,39,2451.77,4758.00,0.00
2024-12-08 17:12:59,86,4277,46,40,2423.26,4758.01,0.00
2024-12-08 17:12:59,87,4276,47,40,2346.54,4758.84,0.00
2024-12-08 17:12:59,87,4277,47,40,2444.59,4759.00,0.00
2024-12-08 17:12:59,88,4277,47,41,2416.81,4759.01,0.00
2024-12-08 17:12:59,87,4277,47,40,2440.78,4759.08,0.00
2024-12-08 17:12:59,87,4278,47,40,2495.99,4760.00,0.00
2024-12-08 17:12:59,88,4278,47,41,2467.63,4760.01,0.00
2024-12-08 17:12:59,87,4278,46,41,2458.37,4760.43,0.00
2024-12-08 17:12:59,86,4278,45,41,2484.22,4760.49,0.00
2024-12-08 17:12:59,86,4279,45,41,2515.23,4761.00,0.00
2024-12-08 17:12:59,87,4279,46,41,2486.32,4761.01,0.00
2024-12-08 17:12:59,86,4279,46,40,2511.37,4761.08,0.00
2024-12-08 17:12:59,86,4280,46,40,2511.88,4762.00,0.00
2024-12-08 17:12:59,87,4280,47,40,2483.00,4762.01,0.00
2024-12-08 17:12:59,86,4280,46,40,2510.23,4762.04,0.00
2024-12-08 17:12:59,85,4280,45,40,2539.20,4762.04,0.00
2024-12-08 17:12:59,84,4280,45,39,2556.39,4762.06,0.00
2024-12-08 17:12:59,84,4281,45,39,2556.97,4763.00,0.00
2024-12-08 17:12:59,85,4281,45,40,2526.89,4763.01,0.00
2024-12-08 17:12:59,84,4281,45,39,2551.32,4763.04,0.00
2024-12-08 17:13:00,84,4282,45,39,2550.22,4764.00,0.00
2024-12-08 17:13:00,85,4282,46,39,2520.22,4764.01,0.00
2024-12-08 17:13:00,84,4282,45,39,2536.63,4764.05,0.00
2024-12-08 17:13:00,84,4283,45,39,2536.73,4765.00,0.00
2024-12-08 17:13:00,85,4283,45,40,2506.89,4765.01,0.00
2024-12-08 17:13:00,84,4283,45,39,2533.34,4765.05,0.00
2024-12-08 17:13:00,84,4284,45,39,2533.63,4766.00,0.00
2024-12-08 17:13:00,85,4284,46,39,2503.83,4766.01,0.00
2024-12-08 17:13:00,86,4283,46,40,2441.07,4766.51,0.00
2024-12-08 17:13:00,86,4284,46,40,2493.20,4767.00,0.00
2024-12-08 17:13:00,87,4284,47,40,2464.54,4767.01,0.00
2024-12-08 17:13:00,86,4284,47,39,2490.44,4767.05,0.00
2024-12-08 17:13:00,85,4284,46,39,2499.69,4767.47,0.00
2024-12-08 17:13:00,85,4285,46,39,2572.97,4768.00,0.00
2024-12-08 17:13:00,86,4285,47,39,2543.05,4768.01,0.00
2024-12-08 17:13:00,85,4285,46,39,2548.92,4768.28,0.00
2024-12-08 17:13:00,85,4286,46,39,2556.52,4769.00,0.00
2024-12-08 17:13:00,86,4286,47,39,2526.80,4769.01,0.00
2024-12-08 17:13:00,87,4285,47,40,2496.12,4769.07,0.00
2024-12-08 17:13:00,87,4286,47,40,2536.15,4770.00,0.00
2024-12-08 17:13:00,88,4286,48,40,2507.33,4770.01,0.00
2024-12-08 17:13:00,87,4286,47,40,2503.02,4770.47,0.00
2024-12-08 17:13:00,87,4287,47,40,2572.77,4771.00,0.00
2024-12-08 17:13:00,88,4287,47,41,2543.53,4771.01,0.00
2024-12-08 17:13:00,88,4288,47,41,2523.73,4772.00,0.00
2024-12-08 17:13:00,89,4288,47,42,2495.37,4772.01,0.00
2024-12-08 17:13:00,88,4288,46,42,2508.57,4772.09,0.00
2024-12-08 17:13:00,89,4287,46,43,2439.69,4772.83,0.00
2024-12-08 17:13:00,89,4288,46,43,2481.67,4773.00,0.00
2024-12-08 17:13:00,90,4288,47,43,2454.10,4773.01,0.00
2024-12-08 17:13:00,89,4288,47,42,2470.96,4773.05,0.00
2024-12-08 17:13:00,89,4289,47,42,2515.14,4774.00,0.00
2024-12-08 17:13:00,90,4289,47,43,2487.20,4774.01,0.00
2024-12-08 17:13:00,89,4289,47,42,2504.43,4774.05,0.00
2024-12-08 17:13:00,89,4290,47,42,2495.06,4775.00,0.00
2024-12-08 17:13:00,90,4290,48,42,2467.34,4775.01,0.00
2024-12-08 17:13:00,89,4290,48,41,2484.34,4775.05,0.00
2024-12-08 17:13:00,89,4291,48,41,2475.43,4776.00,0.00
2024-12-08 17:13:00,90,4291,48,42,2447.92,4776.01,0.00
2024-12-08 17:13:00,89,4291,48,41,2465.24,4776.05,0.00
2024-12-08 17:13:00,90,4290,48,42,2377.69,4776.97,0.00
2024-12-08 17:13:00,90,4291,48,42,2430.80,4777.00,0.00
2024-12-08 17:13:00,91,4291,48,43,2404.09,4777.01,0.00
2024-12-08 17:13:00,90,4291,47,43,2429.22,4777.03,0.00
2024-12-08 17:13:00,89,4291,47,42,2447.39,4777.03,0.00
2024-12-08 17:13:00,88,4291,46,42,2437.42,4777.73,0.00
2024-12-08 17:13:00,88,4292,46,42,2522.33,4778.00,0.00
2024-12-08 17:13:00,89,4292,46,43,2493.99,4778.01,0.00
2024-12-08 17:13:00,88,4292,46,42,2512.02,4778.03,0.00
2024-12-08 17:13:00,88,4293,46,42,2506.67,4779.00,0.00
2024-12-08 17:13:00,89,4293,47,42,2478.50,4779.01,0.00
2024-12-08 17:13:00,88,4293,47,41,2496.36,4779.03,0.00
2024-12-08 17:13:00,87,4293,46,41,2514.12,4779.26,0.00
2024-12-08 17:13:00,87,4294,46,41,2520.08,4780.00,0.00
2024-12-08 17:13:00,88,4294,46,42,2491.45,4780.01,0.00
2024-12-08 17:13:00,87,4294,46,41,2509.65,4780.04,0.00
2024-12-08 17:13:00,86,4294,45,41,2537.73,4780.06,0.00
2024-12-08 17:13:00,87,4293,46,41,2493.74,4780.16,0.00
2024-12-08 17:13:00,87,4294,46,41,2546.76,4781.00,0.00
2024-12-08 17:13:00,88,4294,46,42,2517.82,4781.01,0.00
2024-12-08 17:13:00,87,4294,46,41,2536.33,4781.04,0.00
2024-12-08 17:13:01,87,4295,46,41,2587.98,4782.00,0.00
2024-12-08 17:13:01,88,4295,47,41,2558.57,4782.01,0.00
2024-12-08 17:13:01,87,4295,47,40,2577.54,4782.04,0.00
2024-12-08 17:13:01,86,4295,46,40,2605.85,4782.06,0.00
2024-12-08 17:13:01,86,4296,46,40,2603.80,4783.00,0.00
2024-12-08 17:13:01,87,4296,46,41,2573.87,4783.01,0.00
2024-12-08 17:13:01,86,4296,45,41,2601.03,4783.06,0.00
2024-12-08 17:13:01,86,4297,45,41,2587.66,4784.00,0.00
2024-12-08 17:13:01,87,4297,46,41,2557.92,4784.01,0.00
2024-12-08 17:13:01,86,4297,46,40,2584.89,4784.06,0.00
2024-12-08 17:13:01,85,4297,45,40,2579.31,4784.61,0.00
2024-12-08 17:13:01,85,4298,45,40,2617.33,4785.00,0.00
2024-12-08 17:13:01,86,4298,46,40,2586.90,4785.01,0.00
2024-12-08 17:13:01,85,4298,45,40,2614.53,4785.06,0.00
2024-12-08 17:13:01,84,4298,44,40,2629.72,4785.10,0.00
2024-12-08 17:13:01,84,4299,44,40,2641.38,4786.00,0.00
2024-12-08 17:13:01,85,4299,44,41,2610.31,4786.01,0.00
2024-12-08 17:13:01,84,4299,44,40,2636.28,4786.08,0.00
2024-12-08 17:13:01,83,4299,43,40,2657.64,4786.24,0.00
2024-12-08 17:13:01,83,4300,43,40,2667.82,4787.00,0.00
2024-12-08 17:13:01,84,4300,44,40,2636.06,4787.01,0.00
2024-12-08 17:13:01,83,4300,43,40,2665.52,4787.06,0.00
2024-12-08 17:13:01,82,4300,42,40,2671.24,4787.28,0.00
2024-12-08 17:13:01,82,4301,42,40,2695.15,4788.00,0.00
2024-12-08 17:13:01,83,4301,42,41,2662.68,4788.01,0.00
2024-12-08 17:13:01,82,4301,42,40,2690.50,4788.07,0.00
2024-12-08 17:13:01,82,4302,42,40,2692.55,4789.00,0.00
2024-12-08 17:13:01,83,4302,43,40,2660.11,4789.01,0.00
2024-12-08 17:13:01,83,4303,43,40,2646.71,4790.00,0.00
2024-12-08 17:13:01,84,4303,43,41,2615.20,4790.01,0.00
2024-12-08 17:13:01,85,4302,44,41,2583.87,4790.05,0.00
2024-12-08 17:13:01,84,4302,44,40,2637.47,4790.08,0.00
2024-12-08 17:13:01,85,4301,45,40,2582.19,4790.58,0.00
2024-12-08 17:13:01,85,4302,45,40,2616.90,4791.00,0.00
2024-12-08 17:13:01,86,4302,46,40,2586.47,4791.01,0.00
2024-12-08 17:13:01,87,4301,47,40,2529.86,4791.37,0.00
2024-12-08 17:13:01,87,4302,47,40,2677.58,4792.00,0.00
2024-12-08 17:13:01,88,4302,47,41,2647.15,4792.01,0.00
2024-12-08 17:13:01,87,4302,47,40,2673.75,4792.07,0.00
2024-12-08 17:13:01,87,4303,47,40,2725.64,4793.00,0.00
2024-12-08 17:13:01,88,4303,47,41,2694.66,4793.01,0.00
2024-12-08 17:13:01,87,4303,46,41,2705.31,4793.21,0.00
2024-12-08 17:13:01,87,4304,46,41,2709.83,4794.00,0.00
2024-12-08 17:13:01,88,4304,47,41,2679.03,4794.01,0.00
2024-12-08 17:13:01,87,4304,47,40,2704.90,4794.08,0.00
2024-12-08 17:13:01,87,4305,47,40,2704.67,4795.00,0.00
2024-12-08 17:13:01,88,4305,48,40,2673.94,4795.01,0.00
2024-12-08 17:13:01,88,4306,48,40,2659.47,4796.00,0.00
2024-12-08 17:13:01,89,4306,48,41,2629.59,4796.01,0.00
2024-12-08 17:13:01,88,4306,48,40,2655.14,4796.08,0.00
2024-12-08 17:13:01,88,4307,48,40,2654.61,4797.00,0.00
2024-12-08 17:13:01,89,4307,49,40,2624.78,4797.01,0.00
2024-12-08 17:13:01,89,4308,49,40,2609.55,4798.00,0.00
2024-12-08 17:13:01,90,4308,50,40,2580.55,4798.01,0.00
2024-12-08 17:13:01,89,4308,50,39,2603.64,4798.09,0.00
2024-12-08 17:13:01,89,4309,50,39,2602.59,4799.00,0.00
2024-12-08 17:13:01,90,4309,51,39,2573.67,4799.01,0.00
2024-12-08 17:13:01,89,4309,50,39,2597.14,4799.11,0.00
2024-12-08 17:13:01,88,4309,49,39,2607.03,4799.15,0.00
2024-12-08 17:13:01,88,4310,49,39,2620.27,4800.00,0.00
2024-12-08 17:13:01,89,4310,49,40,2590.82,4800.01,0.00
2024-12-08 17:13:01,88,4310,48,40,2618.64,4800.03,0.00
2024-12-08 17:13:02,87,4310,47,40,2646.54,4800.07,0.00
2024-12-08 17:13:02,86,4310,47,39,2668.96,4800.12,0.00
2024-12-08 17:13:02,85,4310,46,39,2696.99,4800.19,0.00
2024-12-08 17:13:02,85,4311,46,39,2702.39,4801.00,0.00
2024-12-08 17:13:02,86,4311,46,40,2670.96,4801.01,0.00
2024-12-08 17:13:02,85,4311,45,40,2700.70,4801.04,0.00
2024-12-08 17:13:02,84,4311,44,40,2713.46,4801.19,0.00
2024-12-08 17:13:02,85,4310,45,40,2678.75,4801.27,0.00
2024-12-08 17:13:02,85,4311,45,40,2754.75,4802.00,0.00
2024-12-08 17:13:02,86,4311,45,41,2722.72,4802.01,0.00
2024-12-08 17:13:02,85,4311,45,40,2751.95,4802.06,0.00
2024-12-08 17:13:02,85,4312,45,40,2795.15,4803.00,0.00
2024-12-08 17:13:02,86,4312,46,40,2762.65,4803.01,0.00
2024-12-08 17:13:02,85,4312,45,40,2792.35,4803.06,0.00
2024-12-08 17:13:02,84,4312,45,39,2816.45,4803.10,0.00
2024-12-08 17:13:02,83,4312,44,39,2839.40,4803.13,0.00
2024-12-08 17:13:02,83,4313,44,39,2853.25,4804.00,0.00
2024-12-08 17:13:02,84,4313,44,40,2819.29,4804.01,0.00
2024-12-08 17:13:02,83,4313,43,40,2841.71,4804.10,0.00
2024-12-08 17:13:02,83,4314,43,40,2841.89,4805.00,0.00
2024-12-08 17:13:02,84,4314,43,41,2808.06,4805.01,0.00
2024-12-08 17:13:02,83,4314,43,40,2830.34,4805.10,0.00
2024-12-08 17:13:02,83,4315,43,40,2830.07,4806.00,0.00
2024-12-08 17:13:02,84,4315,44,40,2796.38,4806.01,0.00
2024-12-08 17:13:02,83,4315,43,40,2829.49,4806.01,0.00
2024-12-08 17:13:02,82,4315,42,40,2855.22,4806.04,0.00
2024-12-08 17:13:02,82,4316,42,40,2853.65,4807.00,0.00
2024-12-08 17:13:02,83,4316,42,41,2819.27,4807.01,0.00
2024-12-08 17:13:02,82,4316,42,40,2841.96,4807.09,0.00
2024-12-08 17:13:02,82,4317,42,40,2844.71,4808.00,0.00
2024-12-08 17:13:02,83,4317,42,41,2810.43,4808.01,0.00
2024-12-08 17:13:02,84,4316,42,42,2776.41,4808.05,0.00
2024-12-08 17:13:02,83,4316,41,42,2808.19,4808.17,0.00
2024-12-08 17:13:02,83,4317,41,42,2815.07,4809.00,0.00
2024-12-08 17:13:02,84,4317,42,42,2781.56,4809.01,0.00
2024-12-08 17:13:02,83,4317,42,41,2803.52,4809.08,0.00
2024-12-08 17:13:02,83,4318,42,41,2863.86,4810.00,0.00
2024-12-08 17:13:02,84,4318,43,41,2829.76,4810.01,0.00
2024-12-08 17:13:02,84,4319,43,41,2816.08,4811.00,0.00
2024-12-08 17:13:02,85,4319,44,41,2782.95,4811.01,0.00
2024-12-08 17:13:02,84,4319,43,41,2796.11,4811.18,0.00
2024-12-08 17:13:02,84,4320,43,41,2800.80,4812.00,0.00
2024-12-08 17:13:02,85,4320,43,42,2767.85,4812.01,0.00
2024-12-08 17:13:02,85,4321,43,42,2751.48,4813.00,0.00
2024-12-08 17:13:02,86,4321,43,43,2719.48,4813.01,0.00
2024-12-08 17:13:02,85,4321,42,43,2748.67,4813.06,0.00
2024-12-08 17:13:02,84,4321,42,42,2777.95,4813.06,0.00
2024-12-08 17:13:02,83,4321,42,41,2794.28,4813.34,0.00
2024-12-08 17:13:02,84,4320,42,42,2721.30,4813.95,0.00
2024-12-08 17:13:02,84,4321,42,42,2778.65,4814.00,0.00
2024-12-08 17:13:02,85,4321,42,43,2745.96,4814.01,0.00
2024-12-08 17:13:02,85,4322,42,43,2789.58,4815.00,0.00
2024-12-08 17:13:02,86,4322,42,44,2757.14,4815.01,0.00
2024-12-08 17:13:02,85,4322,42,43,2777.71,4815.06,0.00
2024-12-08 17:13:02,86,4321,43,43,2710.52,4815.81,0.00
2024-12-08 17:13:02,86,4322,43,43,2753.80,4816.00,0.00
2024-12-08 17:13:02,87,4322,44,43,2722.14,4816.01,0.00
2024-12-08 17:13:02,86,4322,43,43,2734.82,4816.17,0.00
2024-12-08 17:13:02,87,4321,43,44,2673.30,4816.83,0.00
2024-12-08 17:13:02,87,4322,43,44,2782.51,4817.00,0.00
2024-12-08 17:13:02,88,4322,44,44,2750.89,4817.01,0.00
2024-12-08 17:13:02,87,4322,44,43,2775.88,4817.06,0.00
2024-12-08 17:13:02,86,4322,43,43,2802.60,4817.16,0.00
2024-12-08 17:13:02,86,4323,43,43,2863.62,4818.00,0.00
2024-12-08 17:13:02,87,4323,43,44,2830.71,4818.01,0.00
2024-12-08 17:13:03,87,4324,43,44,2816.89,4819.00,0.00
2024-12-08 17:13:03,88,4324,44,44,2784.88,4819.01,0.00
2024-12-08 17:13:03,87,4324,44,43,2810.27,4819.07,0.00
2024-12-08 17:13:03,88,4323,45,43,2766.38,4819.34,0.00
2024-12-08 17:13:03,88,4324,45,43,2804.63,4820.00,0.00
2024-12-08 17:13:03,89,4324,46,43,2773.12,4820.01,0.00
2024-12-08 17:13:03,89,4325,46,43,2812.70,4821.00,0.00
2024-12-08 17:13:03,90,4325,46,44,2781.44,4821.01,0.00
2024-12-08 17:13:03,89,4325,46,43,2805.15,4821.08,0.00
2024-12-08 17:13:03,89,4326,46,43,2804.61,4822.00,0.00
2024-12-08 17:13:03,90,4326,47,43,2773.45,4822.01,0.00
2024-12-08 17:13:03,90,4327,47,43,2758.48,4823.00,0.00
2024-12-08 17:13:03,91,4327,47,44,2728.17,4823.01,0.00
2024-12-08 17:13:03,90,4327,47,43,2748.48,4823.08,0.00
2024-12-08 17:13:03,90,4328,47,43,2747.41,4824.00,0.00
2024-12-08 17:13:03,91,4328,47,44,2717.22,4824.01,0.00
2024-12-08 17:13:03,91,4329,47,44,2698.38,4825.00,0.00
2024-12-08 17:13:03,92,4329,48,44,2669.05,4825.01,0.00
2024-12-08 17:13:03,91,4329,47,44,2696.81,4825.03,0.00
2024-12-08 17:13:03,90,4329,47,43,2719.67,4825.07,0.00
2024-12-08 17:13:03,89,4329,46,43,2736.16,4825.16,0.00
2024-12-08 17:13:03,88,4329,45,43,2766.71,4825.17,0.00
2024-12-08 17:13:03,88,4330,45,43,2782.02,4826.00,0.00
2024-12-08 17:13:03,89,4330,45,44,2750.76,4826.01,0.00
2024-12-08 17:13:03,90,4329,46,44,2720.20,4826.03,0.00
2024-12-08 17:13:03,90,4330,46,44,2725.03,4827.00,0.00
2024-12-08 17:13:03,91,4330,46,45,2695.08,4827.01,0.00
2024-12-08 17:13:03,90,4330,46,44,2715.62,4827.07,0.00
2024-12-08 17:13:03,91,4329,47,44,2664.22,4827.54,0.00
2024-12-08 17:13:03,90,4329,46,44,2701.92,4827.62,0.00
2024-12-08 17:13:03,90,4330,46,44,2790.48,4828.00,0.00
2024-12-08 17:13:03,91,4330,46,45,2759.81,4828.01,0.00
2024-12-08 17:13:03,90,4330,45,45,2758.20,4828.44,0.00
2024-12-08 17:13:03,90,4331,45,45,2827.85,4829.00,0.00
2024-12-08 17:13:03,91,4331,46,45,2796.78,4829.01,0.00
2024-12-08 17:13:03,90,4331,46,44,2822.52,4829.07,0.00
2024-12-08 17:13:03,89,4331,45,44,2848.84,4829.18,0.00
2024-12-08 17:13:03,89,4332,45,44,2853.15,4830.00,0.00
2024-12-08 17:13:03,90,4332,45,45,2821.44,4830.01,0.00
2024-12-08 17:13:03,89,4332,44,45,2832.30,4830.18,0.00
2024-12-08 17:13:03,90,4331,44,46,2753.02,4830.98,0.00
2024-12-08 17:13:03,90,4332,44,46,2806.71,4831.00,0.00
2024-12-08 17:13:03,91,4332,44,47,2775.87,4831.01,0.00
2024-12-08 17:13:03,90,4332,44,46,2794.74,4831.08,0.00
2024-12-08 17:13:03,89,4332,43,46,2803.47,4831.38,0.00
2024-12-08 17:13:03,89,4333,43,46,2882.61,4832.00,0.00
2024-12-08 17:13:03,90,4333,44,46,2850.58,4832.01,0.00
2024-12-08 17:13:03,90,4334,44,46,2835.44,4833.00,0.00
2024-12-08 17:13:03,91,4334,45,46,2804.29,4833.01,0.00
2024-12-08 17:13:03,90,4334,45,45,2827.96,4833.09,0.00
2024-12-08 17:13:03,91,4333,45,46,2772.17,4833.63,0.00
2024-12-08 17:13:03,91,4334,45,46,2842.58,4834.00,0.00
2024-12-08 17:13:03,92,4334,45,47,2811.68,4834.01,0.00
2024-12-08 17:13:03,91,4334,44,47,2823.42,4834.10,0.00
2024-12-08 17:13:03,91,4335,44,47,2886.66,4835.00,0.00
2024-12-08 17:13:03,92,4335,44,48,2855.29,4835.01,0.00
2024-12-08 17:13:03,91,4335,44,47,2879.54,4835.09,0.00
2024-12-08 17:13:03,92,4334,44,48,2834.17,4835.40,0.00
2024-12-08 17:13:03,93,4333,45,48,2802.83,4835.70,0.00
2024-12-08 17:13:03,93,4334,45,48,2851.45,4836.00,0.00
2024-12-08 17:13:03,94,4334,46,48,2821.12,4836.01,0.00
2024-12-08 17:13:04,94,4335,46,48,2907.63,4837.00,0.00
2024-12-08 17:13:04,95,4335,46,49,2877.03,4837.01,0.00
2024-12-08 17:13:04,94,4335,46,48,2898.92,4837.10,0.00
2024-12-08 17:13:04,93,4335,45,48,2923.85,4837.11,0.00
2024-12-08 17:13:04,93,4336,45,48,2933.26,4838.00,0.00
2024-12-08 17:13:04,94,4336,46,48,2902.06,4838.01,0.00
2024-12-08 17:13:04,94,4337,46,48,2885.56,4839.00,0.00
2024-12-08 17:13:04,95,4337,47,48,2855.19,4839.01,0.00
2024-12-08 17:13:04,95,4338,47,48,2837.96,4840.00,0.00
2024-12-08 17:13:04,96,4338,47,49,2808.39,4840.01,0.00
2024-12-08 17:13:04,96,4339,47,49,2791.13,4841.00,0.00
2024-12-08 17:13:04,97,4339,47,50,2762.35,4841.01,0.00
2024-12-08 17:13:04,96,4339,47,49,2775.89,4841.13,0.00
2024-12-08 17:13:04,96,4340,47,49,2774.41,4842.00,0.00
2024-12-08 17:13:04,97,4340,47,50,2745.81,4842.01,0.00
2024-12-08 17:13:04,97,4341,47,50,2728.04,4843.00,0.00
2024-12-08 17:13:04,98,4341,47,51,2700.20,4843.01,0.00
2024-12-08 17:13:04,97,4341,47,50,2705.10,4843.13,0.00
2024-12-08 17:13:04,97,4342,47,50,2713.62,4844.00,0.00
2024-12-08 17:13:04,98,4342,47,51,2685.93,4844.01,0.00
2024-12-08 17:13:04,97,4342,46,51,2712.56,4844.03,0.00
2024-12-08 17:13:04,97,4343,46,51,2695.90,4845.00,0.00
2024-12-08 17:13:04,98,4343,47,51,2668.39,4845.01,0.00
2024-12-08 17:13:04,97,4343,47,50,2684.95,4845.13,0.00
2024-12-08 17:13:04,97,4344,47,50,2683.47,4846.00,0.00
2024-12-08 17:13:04,98,4344,47,51,2656.09,4846.01,0.00
2024-12-08 17:13:04,99,4343,48,51,2581.52,4846.62,0.00
2024-12-08 17:13:04,99,4344,48,51,2626.86,4847.00,0.00
2024-12-08 17:13:04,100,4344,49,51,2600.59,4847.01,0.00
2024-12-08 17:13:04,99,4344,48,51,2623.46,4847.08,0.00
2024-12-08 17:13:04,99,4345,48,51,2657.77,4848.00,0.00
2024-12-08 17:13:04,100,4345,49,51,2631.19,4848.01,0.00
2024-12-08 17:13:04,99,4345,49,50,2653.38,4848.08,0.00
2024-12-08 17:13:04,99,4346,49,50,2648.52,4849.00,0.00
2024-12-08 17:13:04,100,4346,50,50,2622.03,4849.01,0.00
2024-12-08 17:13:04,100,4347,50,50,2603.66,4850.00,0.00
2024-12-08 17:13:04,101,4347,51,50,2577.88,4850.01,0.00
2024-12-08 17:13:04,100,4347,51,49,2594.95,4850.12,0.00
2024-12-08 17:13:04,99,4347,50,49,2615.32,4850.24,0.00
2024-12-08 17:13:04,98,4347,49,49,2640.54,4850.27,0.00
2024-12-08 17:13:04,98,4348,49,49,2644.97,4851.00,0.00
2024-12-08 17:13:04,99,4348,49,50,2618.25,4851.01,0.00
2024-12-08 17:13:04,98,4348,48,50,2631.62,4851.08,0.00
2024-12-08 17:13:04,97,4348,48,49,2654.25,4851.11,0.00
2024-12-08 17:13:04,96,4348,47,49,2664.86,4851.47,0.00
2024-12-08 17:13:04,96,4349,47,49,2690.01,4852.00,0.00
2024-12-08 17:13:04,97,4349,47,50,2662.28,4852.01,0.00
2024-12-08 17:13:04,96,4349,47,49,2675.88,4852.08,0.00
2024-12-08 17:13:04,95,4349,46,49,2672.62,4852.62,0.00
2024-12-08 17:13:04,95,4350,46,49,2705.61,4853.00,0.00
2024-12-08 17:13:04,96,4350,46,50,2677.42,4853.01,0.00
2024-12-08 17:13:04,96,4351,46,50,2660.28,4854.00,0.00
2024-12-08 17:13:04,97,4351,46,51,2632.85,4854.01,0.00
2024-12-08 17:13:04,96,4351,45,51,2657.76,4854.05,0.00
2024-12-08 17:13:04,95,4351,45,50,2681.66,4854.10,0.00
2024-12-08 17:13:05,95,4352,45,50,2679.13,4855.00,0.00
2024-12-08 17:13:05,96,4352,45,51,2651.22,4855.01,0.00
2024-12-08 17:13:05,96,4353,45,51,2634.06,4856.00,0.00
2024-12-08 17:13:05,97,4353,46,51,2606.91,4856.01,0.00
2024-12-08 17:13:05,96,4353,45,51,2630.53,4856.08,0.00
2024-12-08 17:13:05,95,4353,45,50,2656.69,4856.08,0.00
2024-12-08 17:13:05,94,4353,44,50,2676.74,4856.26,0.00
2024-12-08 17:13:05,94,4354,44,50,2682.39,4857.00,0.00
2024-12-08 17:13:05,95,4354,45,50,2654.16,4857.01,0.00
2024-12-08 17:13:05,95,4355,45,50,2634.97,4858.00,0.00
2024-12-08 17:13:05,96,4355,46,50,2607.52,4858.01,0.00
2024-12-08 17:13:05,95,4355,45,50,2633.44,4858.03,0.00
2024-12-08 17:13:05,94,4355,45,49,2657.33,4858.09,0.00
2024-12-08 17:13:05,93,4355,44,49,2678.12,4858.25,0.00
2024-12-08 17:13:05,94,4354,44,50,2612.24,4858.94,0.00
2024-12-08 17:13:05,94,4355,44,50,2653.66,4859.00,0.00
2024-12-08 17:13:05,95,4355,45,50,2625.72,4859.01,0.00
2024-12-08 17:13:05,95,4356,45,50,2655.65,4860.00,0.00
2024-12-08 17:13:05,96,4356,45,51,2627.99,4860.01,0.00
2024-12-08 17:13:05,95,4356,45,50,2650.55,4860.10,0.00
2024-12-08 17:13:05,95,4357,45,50,2644.75,4861.00,0.00
2024-12-08 17:13:05,96,4357,46,50,2617.20,4861.01,0.00
2024-12-08 17:13:05,96,4358,46,50,2600.01,4862.00,0.00
2024-12-08 17:13:05,97,4358,46,51,2573.20,4862.01,0.00
2024-12-08 17:13:05,96,4358,45,51,2598.40,4862.03,0.00
2024-12-08 17:13:05,95,4358,45,50,2621.67,4862.10,0.00
2024-12-08 17:13:05,94,4358,44,50,2600.38,4862.95,0.00
2024-12-08 17:13:05,94,4359,44,50,2649.57,4863.00,0.00
2024-12-08 17:13:05,95,4359,44,51,2621.68,4863.01,0.00
2024-12-08 17:13:05,94,4359,44,50,2647.51,4863.04,0.00
2024-12-08 17:13:05,93,4359,43,50,2672.85,4863.09,0.00
2024-12-08 17:13:05,93,4360,43,50,2670.77,4864.00,0.00
2024-12-08 17:13:05,94,4360,44,50,2642.35,4864.01,0.00
2024-12-08 17:13:05,93,4360,44,49,2665.55,4864.09,0.00
2024-12-08 17:13:05,93,4361,44,49,2663.47,4865.00,0.00
2024-12-08 17:13:05,94,4361,45,49,2635.13,4865.01,0.00
2024-12-08 17:13:05,94,4362,45,49,2618.59,4866.00,0.00
2024-12-08 17:13:05,95,4362,46,49,2591.03,4866.01,0.00
2024-12-08 17:13:05,94,4362,45,49,2618.08,4866.01,0.00
2024-12-08 17:13:05,93,4362,45,48,2641.53,4866.08,0.00
2024-12-08 17:13:05,92,4362,44,48,2663.13,4866.20,0.00
2024-12-08 17:13:05,91,4362,43,48,2685.98,4866.21,0.00
2024-12-08 17:13:05,91,4363,43,48,2701.45,4867.00,0.00
2024-12-08 17:13:05,92,4363,44,48,2672.09,4867.01,0.00
2024-12-08 17:13:05,91,4363,43,48,2664.69,4867.41,0.00
2024-12-08 17:13:05,92,4362,43,49,2618.99,4867.77,0.00
2024-12-08 17:13:05,92,4363,43,49,2671.58,4868.00,0.00
2024-12-08 17:13:05,93,4363,43,50,2642.85,4868.01,0.00
2024-12-08 17:13:05,92,4363,43,49,2666.83,4868.08,0.00
2024-12-08 17:13:05,92,4364,43,49,2717.64,4869.00,0.00
2024-12-08 17:13:05,93,4364,43,50,2688.42,4869.01,0.00
2024-12-08 17:13:05,92,4364,42,50,2698.09,4869.13,0.00
2024-12-08 17:13:05,92,4365,42,50,2709.20,4870.00,0.00
2024-12-08 17:13:05,93,4365,43,50,2680.07,4870.01,0.00
2024-12-08 17:13:05,92,4365,43,49,2701.82,4870.12,0.00
2024-12-08 17:13:05,92,4366,43,49,2701.82,4871.00,0.00
2024-12-08 17:13:05,93,4366,43,50,2672.76,4871.01,0.00
2024-12-08 17:13:05,93,4367,43,50,2656.55,4872.00,0.00
2024-12-08 17:13:05,94,4367,44,50,2628.29,4872.01,0.00
2024-12-08 17:13:05,93,4367,43,50,2652.90,4872.09,0.00
2024-12-08 17:13:05,92,4367,43,49,2678.03,4872.11,0.00
2024-12-08 17:13:05,91,4367,42,49,2701.61,4872.23,0.00
2024-12-08 17:13:06,91,4368,42,49,2707.46,4873.00,0.00
2024-12-08 17:13:06,92,4368,42,50,2678.03,4873.01,0.00
2024-12-08 17:13:06,91,4368,41,50,2705.86,4873.03,0.00
2024-12-08 17:13:06,90,4368,41,49,2722.40,4873.09,0.00
2024-12-08 17:13:06,90,4369,41,49,2721.86,4874.00,0.00
2024-12-08 17:13:06,91,4369,42,49,2691.95,4874.01,0.00
2024-12-08 17:13:06,90,4369,41,49,2681.40,4874.44,0.00
2024-12-08 17:13:06,90,4370,41,49,2708.88,4875.00,0.00
2024-12-08 17:13:06,91,4370,42,49,2679.11,4875.01,0.00
2024-12-08 17:13:06,90,4370,42,48,2701.31,4875.10,0.00
2024-12-08 17:13:06,90,4371,42,48,2701.30,4876.00,0.00
2024-12-08 17:13:06,91,4371,43,48,2671.62,4876.01,0.00
2024-12-08 17:13:06,90,4371,42,48,2664.13,4876.54,0.00
2024-12-08 17:13:06,90,4372,42,48,2685.60,4877.00,0.00
2024-12-08 17:13:06,91,4372,43,48,2656.09,4877.01,0.00
2024-12-08 17:13:06,90,4372,43,47,2670.99,4877.10,0.00
2024-12-08 17:13:06,90,4373,43,47,2670.97,4878.00,0.00
2024-12-08 17:13:06,91,4373,44,47,2641.62,4878.01,0.00
2024-12-08 17:13:06,91,4374,44,47,2626.08,4879.00,0.00
2024-12-08 17:13:06,92,4374,45,47,2597.54,4879.01,0.00
2024-12-08 17:13:06,91,4374,44,47,2624.48,4879.03,0.00
2024-12-08 17:13:06,90,4374,44,46,2648.77,4879.09,0.00
2024-12-08 17:13:06,90,4375,44,46,2648.21,4880.00,0.00
2024-12-08 17:13:06,91,4375,45,46,2619.11,4880.01,0.00
2024-12-08 17:13:06,90,4375,44,46,2646.59,4880.03,0.00
2024-12-08 17:13:06,90,4376,44,46,2632.49,4881.00,0.00
2024-12-08 17:13:06,91,4376,44,47,2603.56,4881.01,0.00
2024-12-08 17:13:06,90,4376,44,46,2627.08,4881.08,0.00
2024-12-08 17:13:06,90,4377,44,46,2625.97,4882.00,0.00
2024-12-08 17:13:06,91,4377,44,47,2597.12,4882.01,0.00
2024-12-08 17:13:06,90,4377,43,47,2624.35,4882.03,0.00
2024-12-08 17:13:06,90,4378,43,47,2610.23,4883.00,0.00
2024-12-08 17:13:06,91,4378,43,48,2581.55,4883.01,0.00
2024-12-08 17:13:06,90,4378,43,47,2605.91,4883.07,0.00
2024-12-08 17:13:06,90,4379,43,47,2604.26,4884.00,0.00
2024-12-08 17:13:06,91,4379,44,47,2575.64,4884.01,0.00
2024-12-08 17:13:06,91,4380,44,47,2560.06,4885.00,0.00
2024-12-08 17:13:06,92,4380,44,48,2532.23,4885.01,0.00
2024-12-08 17:13:06,91,4380,43,48,2552.56,4885.07,0.00
2024-12-08 17:13:06,90,4380,43,47,2579.29,4885.07,0.00
2024-12-08 17:13:06,91,4379,43,48,2525.93,4885.60,0.00
2024-12-08 17:13:06,91,4380,43,48,2590.12,4886.00,0.00
2024-12-08 17:13:06,92,4380,44,48,2561.96,4886.01,0.00
2024-12-08 17:13:06,92,4381,44,48,2599.14,4887.00,0.00
2024-12-08 17:13:06,93,4381,44,49,2571.19,4887.01,0.00
2024-12-08 17:13:06,92,4381,44,48,2595.43,4887.07,0.00
2024-12-08 17:13:06,92,4382,44,48,2592.76,4888.00,0.00
2024-12-08 17:13:06,93,4382,45,48,2564.89,4888.01,0.00
2024-12-08 17:13:06,94,4381,45,49,2536.05,4888.06,0.00
2024-12-08 17:13:06,94,4382,45,49,2553.20,4889.00,0.00
2024-12-08 17:13:06,95,4382,46,49,2526.33,4889.01,0.00
2024-12-08 17:13:06,94,4382,46,48,2548.02,4889.06,0.00
2024-12-08 17:13:06,95,4381,46,49,2498.21,4889.56,0.00
2024-12-08 17:13:06,95,4382,46,49,2571.11,4890.00,0.00
2024-12-08 17:13:06,96,4382,46,50,2544.33,4890.01,0.00
2024-12-08 17:13:06,95,4382,45,50,2570.08,4890.02,0.00
2024-12-08 17:13:06,94,4382,44,50,2595.88,4890.05,0.00
2024-12-08 17:13:06,93,4382,43,50,2602.79,4890.16,0.00
2024-12-08 17:13:06,93,4383,43,50,2667.44,4891.00,0.00
2024-12-08 17:13:06,94,4383,43,51,2639.06,4891.01,0.00
2024-12-08 17:13:06,93,4383,43,50,2664.30,4891.05,0.00
2024-12-08 17:13:07,92,4383,42,50,2672.10,4891.39,0.00
2024-12-08 17:13:07,92,4384,42,50,2695.92,4892.00,0.00
2024-12-08 17:13:07,93,4384,42,51,2666.93,4892.01,0.00
2024-12-08 17:13:07,93,4385,42,51,2650.64,4893.00,0.00
2024-12-08 17:13:07,94,4385,42,52,2622.44,4893.01,0.00
2024-12-08 17:13:07,93,4385,42,51,2648.02,4893.05,0.00
2024-12-08 17:13:07,93,4386,42,51,2644.34,4894.00,0.00
2024-12-08 17:13:07,94,4386,43,51,2616.21,4894.01,0.00
2024-12-08 17:13:07,94,4387,43,51,2599.56,4895.00,0.00
2024-12-08 17:13:07,95,4387,43,52,2572.19,4895.01,0.00
2024-12-08 17:13:07,94,4387,43,51,2586.55,4895.05,0.00
2024-12-08 17:13:07,94,4388,43,51,2582.38,4896.00,0.00
2024-12-08 17:13:07,95,4388,44,51,2555.20,4896.01,0.00
2024-12-08 17:13:07,94,4388,44,50,2570.41,4896.05,0.00
2024-12-08 17:13:07,94,4389,44,50,2566.24,4897.00,0.00
2024-12-08 17:13:07,95,4389,45,50,2539.22,4897.01,0.00
2024-12-08 17:13:07,94,4389,45,49,2554.27,4897.05,0.00
2024-12-08 17:13:07,93,4389,44,49,2581.21,4897.06,0.00
2024-12-08 17:13:07,93,4390,44,49,2578.03,4898.00,0.00
2024-12-08 17:13:07,94,4390,44,50,2550.61,4898.01,0.00
2024-12-08 17:13:07,93,4390,43,50,2575.94,4898.04,0.00
2024-12-08 17:13:07,92,4390,43,49,2593.30,4898.05,0.00
2024-12-08 17:13:07,92,4391,43,49,2590.08,4899.00,0.00
2024-12-08 17:13:07,93,4391,43,50,2562.23,4899.01,0.00
2024-12-08 17:13:07,92,4391,43,49,2576.79,4899.07,0.00
2024-12-08 17:13:07,92,4392,43,49,2574.10,4900.00,0.00
2024-12-08 17:13:07,93,4392,44,49,2546.42,4900.01,0.00
2024-12-08 17:13:07,93,4393,44,49,2530.07,4901.00,0.00
2024-12-08 17:13:07,94,4393,44,50,2503.16,4901.01,0.00
2024-12-08 17:13:07,93,4393,43,50,2527.46,4901.06,0.00
2024-12-08 17:13:07,92,4393,43,49,2554.40,4901.07,0.00
2024-12-08 17:13:07,92,4394,43,49,2551.70,4902.00,0.00
2024-12-08 17:13:07,93,4394,44,49,2524.27,4902.01,0.00
2024-12-08 17:13:07,93,4395,44,49,2507.91,4903.00,0.00
2024-12-08 17:13:07,94,4395,44,50,2481.23,4903.01,0.00
2024-12-08 17:13:07,93,4395,44,49,2504.77,4903.06,0.00
2024-12-08 17:13:07,92,4395,43,49,2504.47,4903.58,0.00
2024-12-08 17:13:07,92,4396,43,49,2537.29,4904.00,0.00
2024-12-08 17:13:07,93,4396,44,49,2510.00,4904.01,0.00
2024-12-08 17:13:07,92,4396,44,48,2523.45,4904.07,0.00
2024-12-08 17:13:07,92,4397,44,48,2520.74,4905.00,0.00
2024-12-08 17:13:07,93,4397,44,49,2493.64,4905.01,0.00
2024-12-08 17:13:07,93,4398,44,49,2477.27,4906.00,0.00
2024-12-08 17:13:07,94,4398,45,49,2450.91,4906.01,0.00
2024-12-08 17:13:07,93,4398,45,48,2473.59,4906.08,0.00
2024-12-08 17:13:07,92,4398,44,48,2489.34,4906.30,0.00
2024-12-08 17:13:07,91,4398,43,48,2515.62,4906.32,0.00
2024-12-08 17:13:07,91,4399,43,48,2525.76,4907.00,0.00
2024-12-08 17:13:07,92,4399,44,48,2498.30,4907.01,0.00
2024-12-08 17:13:07,91,4399,44,47,2510.68,4907.09,0.00
2024-12-08 17:13:07,91,4400,44,47,2509.55,4908.00,0.00
2024-12-08 17:13:07,92,4400,44,48,2482.27,4908.01,0.00
2024-12-08 17:13:07,91,4400,43,48,2509.01,4908.01,0.00
2024-12-08 17:13:07,90,4400,43,47,2521.64,4908.09,0.00
2024-12-08 17:13:07,90,4401,43,47,2521.04,4909.00,0.00
2024-12-08 17:13:07,91,4401,44,47,2493.34,4909.01,0.00
2024-12-08 17:13:07,92,4400,44,48,2465.71,4909.04,0.00
2024-12-08 17:13:08,92,4401,44,48,2461.94,4910.00,0.00
2024-12-08 17:13:08,93,4401,45,48,2435.46,4910.01,0.00
2024-12-08 17:13:08,92,4401,45,47,2457.69,4910.09,0.00
2024-12-08 17:13:08,92,4402,45,47,2509.41,4911.00,0.00
2024-12-08 17:13:08,93,4402,46,47,2482.43,4911.01,0.00
2024-12-08 17:13:08,92,4402,45,47,2498.22,4911.07,0.00
2024-12-08 17:13:08,91,4402,45,46,2514.34,4911.08,0.00
2024-12-08 17:13:08,91,4403,45,46,2523.47,4912.00,0.00
2024-12-08 17:13:08,92,4403,46,46,2496.04,4912.01,0.00
2024-12-08 17:13:08,91,4403,46,45,2509.46,4912.08,0.00
2024-12-08 17:13:08,91,4404,46,45,2507.79,4913.00,0.00
2024-12-08 17:13:08,92,4404,47,45,2480.53,4913.01,0.00
2024-12-08 17:13:08,91,4404,46,45,2504.57,4913.08,0.00
2024-12-08 17:13:08,90,4404,45,45,2531.85,4913.08,0.00
2024-12-08 17:13:08,89,4404,45,44,2548.71,4913.08,0.00
2024-12-08 17:13:08,89,4405,45,44,2548.10,4914.00,0.00
2024-12-08 17:13:08,90,4405,46,44,2519.79,4914.01,0.00
2024-12-08 17:13:08,89,4405,46,43,2533.21,4914.08,0.00
2024-12-08 17:13:08,89,4406,46,43,2532.60,4915.00,0.00
2024-12-08 17:13:08,90,4406,46,44,2504.46,4915.01,0.00
2024-12-08 17:13:08,89,4406,46,43,2517.71,4915.08,0.00
2024-12-08 17:13:08,88,4406,45,43,2545.21,4915.09,0.00
2024-12-08 17:13:08,87,4406,44,43,2553.71,4915.51,0.00
2024-12-08 17:13:08,87,4407,44,43,2574.97,4916.00,0.00
2024-12-08 17:13:08,88,4407,45,43,2545.70,4916.01,0.00
2024-12-08 17:13:08,87,4407,44,43,2563.66,4916.01,0.00
2024-12-08 17:13:08,86,4407,44,42,2579.20,4916.07,0.00
2024-12-08 17:13:08,87,4406,44,43,2508.74,4916.93,0.00
2024-12-08 17:13:08,87,4407,44,43,2565.32,4917.00,0.00
2024-12-08 17:13:08,88,4407,45,43,2536.17,4917.01,0.00
2024-12-08 17:13:08,87,4407,44,43,2563.64,4917.04,0.00
2024-12-08 17:13:08,86,4407,44,42,2580.30,4917.06,0.00
2024-12-08 17:13:08,86,4408,44,42,2637.42,4918.00,0.00
2024-12-08 17:13:08,87,4408,45,42,2607.10,4918.01,0.00
2024-12-08 17:13:08,86,4408,44,42,2634.58,4918.06,0.00
2024-12-08 17:13:08,86,4409,44,42,2634.52,4919.00,0.00
2024-12-08 17:13:08,87,4409,45,42,2604.24,4919.01,0.00
2024-12-08 17:13:08,86,4409,45,41,2631.11,4919.06,0.00
2024-12-08 17:13:08,86,4410,45,41,2631.05,4920.00,0.00
2024-12-08 17:13:08,87,4410,45,42,2600.81,4920.01,0.00
2024-12-08 17:13:08,86,4410,44,42,2596.88,4920.48,0.00
2024-12-08 17:13:08,86,4411,44,42,2617.28,4921.00,0.00
2024-12-08 17:13:08,87,4411,45,42,2587.20,4921.01,0.00
2024-12-08 17:13:08,86,4411,45,41,2614.44,4921.06,0.00
2024-12-08 17:13:08,86,4412,45,41,2614.38,4922.00,0.00
2024-12-08 17:13:08,87,4412,46,41,2584.33,4922.01,0.00
2024-12-08 17:13:08,86,4412,46,40,2600.09,4922.06,0.00
2024-12-08 17:13:08,85,4412,45,40,2604.21,4922.54,0.00
2024-12-08 17:13:08,86,4411,45,41,2559.83,4922.85,0.00
2024-12-08 17:13:08,86,4412,45,41,2612.62,4923.00,0.00
2024-12-08 17:13:08,87,4412,45,42,2582.59,4923.01,0.00
2024-12-08 17:13:08,86,4412,45,41,2598.33,4923.06,0.00
2024-12-08 17:13:08,86,4413,45,41,2655.52,4924.00,0.00
2024-12-08 17:13:08,87,4413,45,42,2625.00,4924.01,0.00
2024-12-08 17:13:08,86,4413,45,41,2641.22,4924.06,0.00
2024-12-08 17:13:08,86,4414,45,41,2641.17,4925.00,0.00
2024-12-08 17:13:08,87,4414,45,42,2610.82,4925.01,0.00
2024-12-08 17:13:08,86,4414,44,42,2639.47,4925.04,0.00
2024-12-08 17:13:08,86,4415,44,42,2626.82,4926.00,0.00
2024-12-08 17:13:08,87,4415,44,43,2596.62,4926.01,0.00
2024-12-08 17:13:08,86,4415,43,43,2602.83,4926.27,0.00
2024-12-08 17:13:08,86,4416,43,43,2613.03,4927.00,0.00
2024-12-08 17:13:08,87,4416,44,43,2582.99,4927.01,0.00
2024-12-08 17:13:08,86,4416,44,42,2610.75,4927.05,0.00
2024-12-08 17:13:09,86,4417,44,42,2610.12,4928.00,0.00
2024-12-08 17:13:09,87,4417,45,42,2580.12,4928.01,0.00
2024-12-08 17:13:09,87,4418,45,42,2565.91,4929.00,0.00
2024-12-08 17:13:09,88,4418,46,42,2536.75,4929.01,0.00
2024-12-08 17:13:09,87,4418,46,41,2556.30,4929.09,0.00
2024-12-08 17:13:09,87,4419,46,41,2557.37,4930.00,0.00
2024-12-08 17:13:09,88,4419,46,42,2528.30,4930.01,0.00
2024-12-08 17:13:09,87,4419,45,42,2555.68,4930.04,0.00
2024-12-08 17:13:09,86,4419,44,42,2573.93,4930.05,0.00
2024-12-08 17:13:09,85,4419,43,42,2603.06,4930.06,0.00
2024-12-08 17:13:09,85,4420,43,42,2603.57,4931.00,0.00
2024-12-08 17:13:09,86,4420,43,43,2573.29,4931.01,0.00
2024-12-08 17:13:09,85,4420,42,43,2592.56,4931.04,0.00
2024-12-08 17:13:09,84,4420,42,42,2621.66,4931.05,0.00
2024-12-08 17:13:09,83,4420,41,42,2643.79,4931.24,0.00
2024-12-08 17:13:09,83,4421,41,42,2666.25,4932.00,0.00
2024-12-08 17:13:09,84,4421,41,43,2634.51,4932.01,0.00
2024-12-08 17:13:09,84,4422,41,43,2621.54,4933.00,0.00
2024-12-08 17:13:09,85,4422,42,43,2590.69,4933.01,0.00
2024-12-08 17:13:09,86,4421,43,43,2560.57,4933.04,0.00
2024-12-08 17:13:09,85,4421,43,42,2602.32,4933.06,0.00
2024-12-08 17:13:09,85,4422,43,42,2602.83,4934.00,0.00
2024-12-08 17:13:09,86,4422,43,43,2572.56,4934.01,0.00
2024-12-08 17:13:09,85,4422,43,42,2588.92,4934.05,0.00
2024-12-08 17:13:09,85,4423,43,42,2646.90,4935.00,0.00
2024-12-08 17:13:09,86,4423,44,42,2616.12,4935.01,0.00
2024-12-08 17:13:09,85,4423,44,41,2632.98,4935.05,0.00
2024-12-08 17:13:09,84,4423,43,41,2654.98,4935.24,0.00
2024-12-08 17:13:09,84,4424,43,41,2676.60,4936.00,0.00
2024-12-08 17:13:09,85,4424,44,41,2645.11,4936.01,0.00
2024-12-08 17:13:09,85,4425,44,41,2631.71,4937.00,0.00
2024-12-08 17:13:09,86,4425,45,41,2601.11,4937.01,0.00
2024-12-08 17:13:09,85,4425,45,40,2627.66,4937.07,0.00
2024-12-08 17:13:09,84,4425,44,40,2651.34,4937.23,0.00
2024-12-08 17:13:09,84,4426,44,40,2660.64,4938.00,0.00
2024-12-08 17:13:09,85,4426,44,41,2629.34,4938.01,0.00
2024-12-08 17:13:09,84,4426,43,41,2642.44,4938.10,0.00
2024-12-08 17:13:09,84,4427,43,41,2657.06,4939.00,0.00
2024-12-08 17:13:09,85,4427,43,42,2625.80,4939.01,0.00
2024-12-08 17:13:09,84,4427,42,42,2654.73,4939.06,0.00
2024-12-08 17:13:09,83,4427,42,41,2684.93,4939.07,0.00
2024-12-08 17:13:09,82,4427,41,41,2699.04,4939.21,0.00
2024-12-08 17:13:09,82,4428,41,41,2720.61,4940.00,0.00
2024-12-08 17:13:09,83,4428,42,41,2687.83,4940.01,0.00
2024-12-08 17:13:09,83,4429,42,41,2675.28,4941.00,0.00
2024-12-08 17:13:09,84,4429,43,41,2643.43,4941.01,0.00
2024-12-08 17:13:09,83,4429,43,40,2671.13,4941.07,0.00
2024-12-08 17:13:09,83,4430,43,40,2673.44,4942.00,0.00
2024-12-08 17:13:09,84,4430,43,41,2641.62,4942.01,0.00
2024-12-08 17:13:09,83,4430,42,41,2656.19,4942.08,0.00
2024-12-08 17:13:09,83,4431,42,41,2671.01,4943.00,0.00
2024-12-08 17:13:09,84,4431,43,41,2639.21,4943.01,0.00
2024-12-08 17:13:09,83,4431,42,41,2658.51,4943.06,0.00
2024-12-08 17:13:09,82,4431,42,40,2690.33,4943.06,0.00
2024-12-08 17:13:09,82,4432,42,40,2704.73,4944.00,0.00
2024-12-08 17:13:09,83,4432,43,40,2672.14,4944.01,0.00
2024-12-08 17:13:09,82,4432,42,40,2669.32,4944.48,0.00
2024-12-08 17:13:09,82,4433,42,40,2692.01,4945.00,0.00
2024-12-08 17:13:09,83,4433,42,41,2659.57,4945.01,0.00
2024-12-08 17:13:09,82,4433,42,40,2687.20,4945.07,0.00
2024-12-08 17:13:09,81,4433,41,40,2714.30,4945.20,0.00
2024-12-08 17:13:10,81,4434,41,40,2723.96,4946.00,0.00
2024-12-08 17:13:10,82,4434,42,40,2690.74,4946.01,0.00
2024-12-08 17:13:10,81,4434,41,40,2722.75,4946.03,0.00
2024-12-08 17:13:10,80,4434,40,40,2754.94,4946.05,0.00
2024-12-08 17:13:10,79,4434,39,40,2748.62,4946.42,0.00
2024-12-08 17:13:10,79,4435,39,40,2782.84,4947.00,0.00
2024-12-08 17:13:10,80,4435,39,41,2748.06,4947.01,0.00
2024-12-08 17:13:10,79,4435,39,40,2779.73,4947.05,0.00
2024-12-08 17:13:10,79,4436,39,40,2783.41,4948.00,0.00
2024-12-08 17:13:10,80,4436,39,41,2748.61,4948.01,0.00
2024-12-08 17:13:10,80,4437,39,41,2737.41,4949.00,0.00
2024-12-08 17:13:10,81,4437,39,42,2703.62,4949.01,0.00
2024-12-08 17:13:10,80,4437,39,41,2734.95,4949.05,0.00
2024-12-08 17:13:10,80,4438,39,41,2737.97,4950.00,0.00
2024-12-08 17:13:10,81,4438,39,42,2704.17,4950.01,0.00
2024-12-08 17:13:10,81,4439,39,42,2692.49,4951.00,0.00
2024-12-08 17:13:10,82,4439,39,43,2659.65,4951.01,0.00
2024-12-08 17:13:10,81,4439,39,42,2690.06,4951.05,0.00
2024-12-08 17:13:10,81,4440,39,42,2692.42,4952.00,0.00
2024-12-08 17:13:10,82,4440,39,43,2659.58,4952.01,0.00
2024-12-08 17:13:10,81,4440,38,43,2680.81,4952.03,0.00
2024-12-08 17:13:10,80,4440,37,43,2713.09,4952.04,0.00
2024-12-08 17:13:10,80,4441,37,43,2715.48,4953.00,0.00
2024-12-08 17:13:10,81,4441,38,43,2681.96,4953.01,0.00
2024-12-08 17:13:10,80,4441,38,42,2713.63,4953.04,0.00
2024-12-08 17:13:10,80,4442,38,42,2716.03,4954.00,0.00
2024-12-08 17:13:10,81,4442,39,42,2682.50,4954.01,0.00
2024-12-08 17:13:10,80,4442,38,42,2709.85,4954.05,0.00
2024-12-08 17:13:10,80,4443,38,42,2712.86,4955.00,0.00
2024-12-08 17:13:10,81,4443,39,42,2679.37,4955.01,0.00
2024-12-08 17:13:10,80,4443,39,41,2706.68,4955.05,0.00
2024-12-08 17:13:10,80,4444,39,41,2709.69,4956.00,0.00
2024-12-08 17:13:10,81,4444,39,42,2676.24,4956.01,0.00
2024-12-08 17:13:10,80,4444,38,42,2708.46,4956.03,0.00
2024-12-08 17:13:10,80,4445,38,42,2697.85,4957.00,0.00
2024-12-08 17:13:10,81,4445,39,42,2664.54,4957.01,0.00
2024-12-08 17:13:10,80,4445,39,41,2692.90,4957.04,0.00
2024-12-08 17:13:10,80,4446,39,41,2695.29,4958.00,0.00
2024-12-08 17:13:10,81,4446,40,41,2662.02,4958.01,0.00
2024-12-08 17:13:10,81,4447,40,41,2650.31,4959.00,0.00
2024-12-08 17:13:10,82,4447,41,41,2617.99,4959.01,0.00
2024-12-08 17:13:10,81,4447,41,40,2646.03,4959.04,0.00
2024-12-08 17:13:10,80,4447,40,40,2657.58,4959.48,0.00
2024-12-08 17:13:10,80,4448,40,40,2681.50,4960.00,0.00
2024-12-08 17:13:10,81,4448,41,40,2648.39,4960.01,0.00
2024-12-08 17:13:10,80,4448,40,40,2669.73,4960.03,0.00
2024-12-08 17:13:10,80,4449,40,40,2671.50,4961.00,0.00
2024-12-08 17:13:10,81,4449,40,41,2638.52,4961.01,0.00
2024-12-08 17:13:10,80,4449,40,40,2667.79,4961.03,0.00
2024-12-08 17:13:10,79,4449,39,40,2664.84,4961.76,0.00
2024-12-08 17:13:10,79,4449,39,40,2703.35,4962.00,0.00
2024-12-08 17:13:10,80,4449,40,40,2669.56,4962.01,0.00
2024-12-08 17:13:10,80,4450,40,40,2658.31,4963.00,0.00
2024-12-08 17:13:10,81,4450,40,41,2625.49,4963.01,0.00
2024-12-08 17:13:10,80,4450,40,40,2655.83,4963.03,0.00
2024-12-08 17:13:10,79,4450,39,40,2667.00,4963.48,0.00
2024-12-08 17:13:11,79,4451,39,40,2691.87,4964.00,0.00
2024-12-08 17:13:11,80,4451,39,41,2658.22,4964.01,0.00
2024-12-08 17:13:11,79,4451,38,41,2662.38,4964.18,0.00
2024-12-08 17:13:11,79,4452,38,41,2684.87,4965.00,0.00
2024-12-08 17:13:11,80,4452,39,41,2651.31,4965.01,0.00
2024-12-08 17:13:11,79,4452,39,40,2682.36,4965.03,0.00
2024-12-08 17:13:11,79,4453,39,40,2684.78,4966.00,0.00
2024-12-08 17:13:11,80,4453,39,41,2651.22,4966.01,0.00
2024-12-08 17:13:11,81,4452,40,41,2552.08,4966.89,0.00
2024-12-08 17:13:11,81,4453,40,41,2613.50,4967.00,0.00
2024-12-08 17:13:11,82,4453,41,41,2581.63,4967.01,0.00
2024-12-08 17:13:11,81,4453,41,40,2611.06,4967.04,0.00
2024-12-08 17:13:11,80,4453,40,40,2620.27,4967.50,0.00
2024-12-08 17:13:11,80,4454,40,40,2719.98,4968.00,0.00
2024-12-08 17:13:11,81,4454,41,40,2686.40,4968.01,0.00
2024-12-08 17:13:11,81,4455,41,40,2674.67,4969.00,0.00
2024-12-08 17:13:11,82,4455,41,41,2642.05,4969.01,0.00
2024-12-08 17:13:11,81,4455,40,41,2674.06,4969.03,0.00
2024-12-08 17:13:11,80,4455,40,40,2706.25,4969.04,0.00
2024-12-08 17:13:11,80,4456,40,40,2708.65,4970.00,0.00
2024-12-08 17:13:11,81,4456,41,40,2675.21,4970.01,0.00
2024-12-08 17:13:11,80,4456,41,39,2694.37,4970.04,0.00
2024-12-08 17:13:11,79,4456,40,39,2719.09,4970.23,0.00
2024-12-08 17:13:11,79,4457,40,39,2731.53,4971.00,0.00
2024-12-08 17:13:11,80,4457,41,39,2697.39,4971.01,0.00
2024-12-08 17:13:11,79,4457,41,38,2717.07,4971.04,0.00
2024-12-08 17:13:11,79,4458,41,38,2720.12,4972.00,0.00
2024-12-08 17:13:11,80,4458,42,38,2686.12,4972.01,0.00
2024-12-08 17:13:11,79,4458,42,37,2705.66,4972.04,0.00
2024-12-08 17:13:11,79,4459,42,37,2708.71,4973.00,0.00
2024-12-08 17:13:11,80,4459,42,38,2674.85,4973.01,0.00
2024-12-08 17:13:11,79,4459,42,37,2694.24,4973.04,0.00
2024-12-08 17:13:11,78,4459,41,37,2727.51,4973.04,0.00
2024-12-08 17:13:11,78,4460,41,37,2743.99,4974.00,0.00
2024-12-08 17:13:11,79,4460,42,37,2709.25,4974.01,0.00
2024-12-08 17:13:11,79,4461,42,37,2698.46,4975.00,0.00
2024-12-08 17:13:11,80,4461,43,37,2664.73,4975.01,0.00
2024-12-08 17:13:11,79,4461,43,36,2696.58,4975.04,0.00
2024-12-08 17:13:11,78,4461,42,36,2721.64,4975.23,0.00
2024-12-08 17:13:11,78,4462,42,36,2734.89,4976.00,0.00
2024-12-08 17:13:11,79,4462,43,36,2700.27,4976.01,0.00
2024-12-08 17:13:11,78,4462,42,36,2732.98,4976.04,0.00
2024-12-08 17:13:11,77,4462,41,36,2708.69,4976.73,0.00
2024-12-08 17:13:11,77,4463,41,36,2759.97,4977.00,0.00
2024-12-08 17:13:11,78,4463,41,37,2724.59,4977.01,0.00
2024-12-08 17:13:11,77,4463,41,36,2757.40,4977.04,0.00
2024-12-08 17:13:11,77,4464,41,36,2761.82,4978.00,0.00
2024-12-08 17:13:11,78,4464,41,37,2726.41,4978.01,0.00
2024-12-08 17:13:11,78,4465,41,37,2716.11,4979.00,0.00
2024-12-08 17:13:11,79,4465,41,38,2681.73,4979.01,0.00
2024-12-08 17:13:11,78,4465,41,37,2714.20,4979.04,0.00
2024-12-08 17:13:11,77,4465,40,37,2738.52,4979.25,0.00
2024-12-08 17:13:11,77,4466,40,37,2753.23,4980.00,0.00
2024-12-08 17:13:11,78,4466,41,37,2717.93,4980.01,0.00
2024-12-08 17:13:11,77,4466,40,37,2751.30,4980.04,0.00
2024-12-08 17:13:11,77,4467,40,37,2755.72,4981.00,0.00
2024-12-08 17:13:11,78,4467,40,38,2720.39,4981.01,0.00
2024-12-08 17:13:11,77,4467,40,37,2753.79,4981.04,0.00
2024-12-08 17:13:12,77,4468,40,37,2758.22,4982.00,0.00
2024-12-08 17:13:12,78,4468,40,38,2722.85,4982.01,0.00
2024-12-08 17:13:12,77,4468,39,38,2715.72,4982.55,0.00
2024-12-08 17:13:12,77,4469,39,38,2758.12,4983.00,0.00
2024-12-08 17:13:12,78,4469,39,39,2722.76,4983.01,0.00
2024-12-08 17:13:12,77,4469,39,38,2756.19,4983.04,0.00
2024-12-08 17:13:12,77,4470,39,38,2760.62,4984.00,0.00
2024-12-08 17:13:12,78,4470,40,38,2725.22,4984.01,0.00
2024-12-08 17:13:12,78,4471,40,38,2714.91,4985.00,0.00
2024-12-08 17:13:12,79,4471,40,39,2680.54,4985.01,0.00
2024-12-08 17:13:12,78,4471,40,38,2713.00,4985.04,0.00
2024-12-08 17:13:12,78,4472,40,38,2716.73,4986.00,0.00
2024-12-08 17:13:12,79,4472,40,39,2682.34,4986.01,0.00
2024-12-08 17:13:12,78,4472,39,39,2702.03,4986.04,0.00
2024-12-08 17:13:12,78,4473,39,39,2705.77,4987.00,0.00
2024-12-08 17:13:12,79,4473,39,40,2671.52,4987.01,0.00
2024-12-08 17:13:12,78,4473,38,40,2691.07,4987.04,0.00
2024-12-08 17:13:12,77,4473,38,39,2724.72,4987.04,0.00
2024-12-08 17:13:12,77,4474,38,39,2742.10,4988.00,0.00
2024-12-08 17:13:12,78,4474,38,40,2706.95,4988.01,0.00
2024-12-08 17:13:12,78,4475,38,40,2696.62,4989.00,0.00
2024-12-08 17:13:12,79,4475,38,41,2662.48,4989.01,0.00
2024-12-08 17:13:12,78,4475,37,41,2695.34,4989.03,0.00
2024-12-08 17:13:12,77,4475,37,40,2722.59,4989.09,0.00
2024-12-08 17:13:12,77,4476,37,40,2729.59,4990.00,0.00
2024-12-08 17:13:12,78,4476,38,40,2694.60,4990.01,0.00
2024-12-08 17:13:12,78,4477,38,40,2683.53,4991.00,0.00
2024-12-08 17:13:12,79,4477,39,40,2649.56,4991.01,0.00
2024-12-08 17:13:12,78,4477,39,39,2671.40,4991.13,0.00
2024-12-08 17:13:12,78,4478,39,39,2677.89,4992.00,0.00
2024-12-08 17:13:12,79,4478,40,39,2643.99,4992.01,0.00
2024-12-08 17:13:12,78,4478,39,39,2663.18,4992.05,0.00
2024-12-08 17:13:12,78,4479,39,39,2665.16,4993.00,0.00
2024-12-08 17:13:12,79,4479,39,40,2631.42,4993.01,0.00
2024-12-08 17:13:12,78,4479,38,40,2661.97,4993.06,0.00
2024-12-08 17:13:12,77,4479,38,39,2686.18,4993.13,0.00
2024-12-08 17:13:12,77,4480,38,39,2692.34,4994.00,0.00
2024-12-08 17:13:12,78,4480,38,40,2657.82,4994.01,0.00
2024-12-08 17:13:12,77,4480,37,40,2685.87,4994.09,0.00
2024-12-08 17:13:12,77,4481,37,40,2690.04,4995.00,0.00
2024-12-08 17:13:12,78,4481,38,40,2655.55,4995.01,0.00
2024-12-08 17:13:12,77,4481,37,40,2653.87,4995.48,0.00
2024-12-08 17:13:12,77,4482,37,40,2678.40,4996.00,0.00
2024-12-08 17:13:12,78,4482,38,40,2644.06,4996.01,0.00
2024-12-08 17:13:12,78,4483,38,40,2633.53,4997.00,0.00
2024-12-08 17:13:12,79,4483,39,40,2600.20,4997.01,0.00
2024-12-08 17:13:12,78,4483,39,39,2622.02,4997.13,0.00
2024-12-08 17:13:12,77,4483,38,39,2649.62,4997.26,0.00
2024-12-08 17:13:12,77,4484,38,39,2665.02,4998.00,0.00
2024-12-08 17:13:12,78,4484,39,39,2630.86,4998.01,0.00
2024-12-08 17:13:12,77,4484,39,38,2653.36,4998.13,0.00
2024-12-08 17:13:12,76,4484,38,38,2679.73,4998.15,0.00
2024-12-08 17:13:12,75,4484,37,38,2710.82,4998.24,0.00
2024-12-08 17:13:12,75,4485,37,38,2739.97,4999.00,0.00
2024-12-08 17:13:12,76,4485,37,39,2703.92,4999.01,0.00
2024-12-08 17:13:12,77,4484,37,40,2611.28,4999.68,0.00
2024-12-08 17:13:12,77,4485,37,40,2676.48,5000.00,0.00
2024-12-08 17:13:12,78,4485,38,40,2642.17,5000.01,0.00
2024-12-08 17:13:12,77,4485,38,39,2660.28,5000.17,0.00
2024-12-08 17:13:12,76,4485,37,39,2686.07,5000.17,0.00
2024-12-08 17:13:13,76,4486,37,39,2776.73,5001.00,0.00
2024-12-08 17:13:13,77,4486,37,40,2740.66,5001.01,0.00
2024-12-08 17:13:13,76,4486,36,40,2772.13,5001.09,0.00
2024-12-08 17:13:13,76,4487,36,40,2766.75,5002.00,0.00
2024-12-08 17:13:13,77,4487,36,41,2730.82,5002.01,0.00
2024-12-08 17:13:13,76,4487,36,40,2760.18,5002.11,0.00
2024-12-08 17:13:13,76,4488,36,40,2768.62,5003.00,0.00
2024-12-08 17:13:13,77,4488,36,41,2732.66,5003.01,0.00
2024-12-08 17:13:13,76,4488,36,40,2753.51,5003.16,0.00
2024-12-08 17:13:13,76,4489,36,40,2764.56,5004.00,0.00
2024-12-08 17:13:13,77,4489,37,40,2728.66,5004.01,0.00
2024-12-08 17:13:13,76,4489,36,40,2731.02,5004.20,0.00
2024-12-08 17:13:13,76,4490,36,40,2757.21,5005.00,0.00
2024-12-08 17:13:13,77,4490,36,41,2721.41,5005.01,0.00
2024-12-08 17:13:13,76,4490,36,40,2740.12,5005.17,0.00
2024-12-08 17:13:13,75,4490,35,40,2762.09,5005.45,0.00
2024-12-08 17:13:13,75,4491,35,40,2788.53,5006.00,0.00
2024-12-08 17:13:13,76,4491,35,41,2751.84,5006.01,0.00
2024-12-08 17:13:13,76,4492,35,41,2740.92,5007.00,0.00
2024-12-08 17:13:13,77,4492,35,42,2705.32,5007.01,0.00
2024-12-08 17:13:13,76,4492,35,41,2733.02,5007.12,0.00
2024-12-08 17:13:13,77,4491,35,42,2680.76,5007.48,0.00
2024-12-08 17:13:13,76,4491,34,42,2721.90,5007.92,0.00
2024-12-08 17:13:13,76,4492,34,42,2783.90,5008.00,0.00
2024-12-08 17:13:13,77,4492,34,43,2747.75,5008.01,0.00
2024-12-08 17:13:13,77,4493,34,43,2794.91,5009.00,0.00
2024-12-08 17:13:13,78,4493,35,43,2759.08,5009.01,0.00
2024-12-08 17:13:13,77,4493,35,42,2780.62,5009.16,0.00
2024-12-08 17:13:13,77,4494,35,42,2784.11,5010.00,0.00
2024-12-08 17:13:13,78,4494,36,42,2748.41,5010.01,0.00
2024-12-08 17:13:13,77,4494,35,42,2782.16,5010.04,0.00
2024-12-08 17:13:13,77,4495,35,42,2767.45,5011.00,0.00
2024-12-08 17:13:13,78,4495,35,43,2731.97,5011.01,0.00
2024-12-08 17:13:13,77,4495,35,42,2753.15,5011.14,0.00
2024-12-08 17:13:13,77,4496,35,42,2756.57,5012.00,0.00
2024-12-08 17:13:13,78,4496,36,42,2721.23,5012.01,0.00
2024-12-08 17:13:13,77,4496,35,42,2754.62,5012.04,0.00
2024-12-08 17:13:13,77,4497,35,42,2739.87,5013.00,0.00
2024-12-08 17:13:13,78,4497,36,42,2704.74,5013.01,0.00
2024-12-08 17:13:13,77,4497,36,41,2724.26,5013.16,0.00
2024-12-08 17:13:13,76,4497,35,41,2755.52,5013.24,0.00
2024-12-08 17:13:13,76,4498,35,41,2764.57,5014.00,0.00
2024-12-08 17:13:13,77,4498,35,42,2728.67,5014.01,0.00
2024-12-08 17:13:13,77,4499,35,42,2713.08,5015.00,0.00
2024-12-08 17:13:13,78,4499,36,42,2678.30,5015.01,0.00
2024-12-08 17:13:13,77,4499,35,42,2707.23,5015.12,0.00
2024-12-08 17:13:13,76,4499,35,41,2731.64,5015.16,0.00
2024-12-08 17:13:13,76,4500,35,41,2737.03,5016.00,0.00
2024-12-08 17:13:13,77,4500,35,42,2701.49,5016.01,0.00
2024-12-08 17:13:13,76,4500,34,42,2735.06,5016.04,0.00
2024-12-08 17:13:13,75,4500,34,41,2770.86,5016.04,0.00
2024-12-08 17:13:13,75,4501,34,41,2757.81,5017.00,0.00
2024-12-08 17:13:13,76,4501,35,41,2721.52,5017.01,0.00
2024-12-08 17:13:13,75,4501,35,40,2743.11,5017.13,0.00
2024-12-08 17:13:13,74,4501,34,40,2766.16,5017.32,0.00
2024-12-08 17:13:14,74,4502,34,40,2786.96,5018.00,0.00
2024-12-08 17:13:14,75,4502,34,41,2749.81,5018.01,0.00
2024-12-08 17:13:14,76,4501,34,42,2711.65,5018.08,0.00
2024-12-08 17:13:14,76,4502,34,42,2764.35,5019.00,0.00
2024-12-08 17:13:14,77,4502,35,42,2728.45,5019.01,0.00
2024-12-08 17:13:14,76,4502,35,41,2750.52,5019.13,0.00
2024-12-08 17:13:14,76,4503,35,41,2826.33,5020.00,0.00
2024-12-08 17:13:14,77,4503,36,41,2789.63,5020.01,0.00
2024-12-08 17:13:14,77,4504,36,41,2779.75,5021.00,0.00
2024-12-08 17:13:14,78,4504,37,41,2744.11,5021.01,0.00
2024-12-08 17:13:14,77,4504,37,40,2766.74,5021.13,0.00
2024-12-08 17:13:14,77,4505,37,40,2775.74,5022.00,0.00
2024-12-08 17:13:14,78,4505,37,41,2740.15,5022.01,0.00
2024-12-08 17:13:14,77,4505,37,40,2774.44,5022.03,0.00
2024-12-08 17:13:14,76,4505,37,39,2810.28,5022.03,0.00
2024-12-08 17:13:14,76,4506,37,39,2801.59,5023.00,0.00
2024-12-08 17:13:14,77,4506,38,39,2765.20,5023.01,0.00
2024-12-08 17:13:14,76,4506,38,38,2790.38,5023.11,0.00
2024-12-08 17:13:14,75,4506,37,38,2805.58,5023.36,0.00
2024-12-08 17:13:14,75,4507,37,38,2840.85,5024.00,0.00
2024-12-08 17:13:14,76,4507,37,39,2803.47,5024.01,0.00
2024-12-08 17:13:14,75,4507,36,39,2811.40,5024.13,0.00
2024-12-08 17:13:14,75,4508,36,39,2835.38,5025.00,0.00
2024-12-08 17:13:14,76,4508,36,40,2798.07,5025.01,0.00
2024-12-08 17:13:14,76,4509,36,40,2788.71,5026.00,0.00
2024-12-08 17:13:14,77,4509,36,41,2752.49,5026.01,0.00
2024-12-08 17:13:14,76,4509,36,40,2783.44,5026.11,0.00
2024-12-08 17:13:14,75,4509,35,40,2810.51,5026.12,0.00
2024-12-08 17:13:14,75,4510,35,40,2833.83,5027.00,0.00
2024-12-08 17:13:14,76,4510,35,41,2796.54,5027.01,0.00
2024-12-08 17:13:14,76,4511,35,41,2787.17,5028.00,0.00
2024-12-08 17:13:14,77,4511,36,41,2750.98,5028.01,0.00
2024-12-08 17:13:14,76,4511,36,40,2771.98,5028.13,0.00
2024-12-08 17:13:14,75,4511,35,40,2796.93,5028.28,0.00
2024-12-08 17:13:14,75,4512,35,40,2828.25,5029.00,0.00
2024-12-08 17:13:14,76,4512,35,41,2791.04,5029.01,0.00
2024-12-08 17:13:14,76,4513,35,41,2781.66,5030.00,0.00
2024-12-08 17:13:14,77,4513,35,42,2745.54,5030.01,0.00
2024-12-08 17:13:14,78,4512,35,43,2709.70,5030.05,0.00
2024-12-08 17:13:14,77,4512,35,42,2737.73,5030.16,0.00
2024-12-08 17:13:14,76,4512,34,42,2761.18,5030.18,0.00
2024-12-08 17:13:14,76,4513,34,42,2786.85,5031.00,0.00
2024-12-08 17:13:14,77,4513,35,42,2750.66,5031.01,0.00
2024-12-08 17:13:14,76,4513,35,41,2784.88,5031.04,0.00
2024-12-08 17:13:14,76,4514,35,41,2843.02,5032.00,0.00
2024-12-08 17:13:14,77,4514,36,41,2806.10,5032.01,0.00
2024-12-08 17:13:14,78,4513,37,41,2770.13,5032.04,0.00
2024-12-08 17:13:14,77,4513,37,40,2856.46,5032.14,0.00
2024-12-08 17:13:14,77,4514,37,40,2866.14,5033.00,0.00
2024-12-08 17:13:14,78,4514,38,40,2829.39,5033.01,0.00
2024-12-08 17:13:14,77,4514,37,40,2864.20,5033.04,0.00
2024-12-08 17:13:14,77,4515,37,40,2920.97,5034.00,0.00
2024-12-08 17:13:14,78,4515,38,40,2883.52,5034.01,0.00
2024-12-08 17:13:14,77,4515,38,39,2904.01,5034.14,0.00
2024-12-08 17:13:14,76,4515,37,39,2928.32,5034.17,0.00
2024-12-08 17:13:14,76,4516,37,39,2953.37,5035.00,0.00
2024-12-08 17:13:14,77,4516,38,39,2915.01,5035.01,0.00
2024-12-08 17:13:15,77,4517,38,39,2905.13,5036.00,0.00
2024-12-08 17:13:15,78,4517,38,40,2867.88,5036.01,0.00
2024-12-08 17:13:15,77,4517,37,40,2857.70,5036.70,0.00
2024-12-08 17:13:15,77,4518,37,40,2895.24,5037.00,0.00
2024-12-08 17:13:15,78,4518,37,41,2858.12,5037.01,0.00
2024-12-08 17:13:15,78,4519,37,41,2847.71,5038.00,0.00
2024-12-08 17:13:15,79,4519,37,42,2811.66,5038.01,0.00
2024-12-08 17:13:15,78,4519,37,41,2838.70,5038.17,0.00
2024-12-08 17:13:15,78,4520,37,41,2848.92,5039.00,0.00
2024-12-08 17:13:15,79,4520,37,42,2812.85,5039.01,0.00
2024-12-08 17:13:15,79,4521,37,42,2801.93,5040.00,0.00
2024-12-08 17:13:15,80,4521,38,42,2766.90,5040.01,0.00
2024-12-08 17:13:15,79,4521,38,41,2782.19,5040.18,0.00
2024-12-08 17:13:15,79,4522,38,41,2792.27,5041.00,0.00
2024-12-08 17:13:15,80,4522,38,42,2757.37,5041.01,0.00
2024-12-08 17:13:15,79,4522,37,42,2788.47,5041.09,0.00
2024-12-08 17:13:15,78,4522,36,42,2793.22,5041.19,0.00
2024-12-08 17:13:15,78,4523,36,42,2817.65,5042.00,0.00
2024-12-08 17:13:15,79,4523,36,43,2781.98,5042.01,0.00
2024-12-08 17:13:15,79,4524,36,43,2771.04,5043.00,0.00
2024-12-08 17:13:15,80,4524,36,44,2736.40,5043.01,0.00
2024-12-08 17:13:15,79,4524,35,44,2769.14,5043.04,0.00
2024-12-08 17:13:15,80,4523,36,44,2732.64,5043.10,0.00
2024-12-08 17:13:15,79,4523,35,44,2822.82,5043.23,0.00
2024-12-08 17:13:15,79,4524,35,44,2835.44,5044.00,0.00
2024-12-08 17:13:15,80,4524,35,45,2800.00,5044.01,0.00
2024-12-08 17:13:15,79,4524,34,45,2833.54,5044.04,0.00
2024-12-08 17:13:15,78,4524,33,45,2860.17,5044.05,0.00
2024-12-08 17:13:15,77,4524,33,44,2888.85,5044.20,0.00
2024-12-08 17:13:15,77,4525,33,44,2979.77,5045.00,0.00
2024-12-08 17:13:15,78,4525,33,45,2941.57,5045.01,0.00
2024-12-08 17:13:15,77,4525,32,45,2945.86,5045.43,0.00
2024-12-08 17:13:15,77,4526,32,45,2969.87,5046.00,0.00
2024-12-08 17:13:15,78,4526,33,45,2931.80,5046.01,0.00
2024-12-08 17:13:15,78,4527,33,45,2921.38,5047.00,0.00
2024-12-08 17:13:15,79,4527,34,45,2884.40,5047.01,0.00
2024-12-08 17:13:15,78,4527,34,44,2919.46,5047.04,0.00
2024-12-08 17:13:15,77,4527,34,43,2947.59,5047.21,0.00
2024-12-08 17:13:15,77,4528,34,43,2960.56,5048.00,0.00
2024-12-08 17:13:15,78,4528,35,43,2922.61,5048.01,0.00
2024-12-08 17:13:15,79,4527,36,43,2884.98,5048.05,0.00
2024-12-08 17:13:15,78,4527,35,43,2892.48,5048.65,0.00
2024-12-08 17:13:15,78,4528,35,43,2940.01,5049.00,0.00
2024-12-08 17:13:15,79,4528,35,44,2902.80,5049.01,0.00
2024-12-08 17:13:15,78,4528,34,44,2937.46,5049.06,0.00
2024-12-08 17:13:15,77,4528,34,43,2955.32,5049.20,0.00
2024-12-08 17:13:15,77,4529,34,43,3033.22,5050.00,0.00
2024-12-08 17:13:15,78,4529,35,43,2994.33,5050.01,0.00
2024-12-08 17:13:15,77,4529,34,43,2998.64,5050.44,0.00
2024-12-08 17:13:15,77,4530,34,43,3023.33,5051.00,0.00
2024-12-08 17:13:15,78,4530,34,44,2984.57,5051.01,0.00
2024-12-08 17:13:15,77,4530,34,43,3010.26,5051.13,0.00
2024-12-08 17:13:15,77,4531,34,43,3019.33,5052.00,0.00
2024-12-08 17:13:15,78,4531,35,43,2980.62,5052.01,0.00
2024-12-08 17:13:15,78,4532,35,43,2970.20,5053.00,0.00
2024-12-08 17:13:15,79,4532,35,44,2932.60,5053.01,0.00
2024-12-08 17:13:15,78,4532,35,43,2946.31,5053.22,0.00
2024-12-08 17:13:15,77,4532,34,43,2945.48,5053.73,0.00
2024-12-08 17:13:16,77,4533,34,43,2997.55,5054.00,0.00
2024-12-08 17:13:16,78,4533,35,43,2959.12,5054.01,0.00
2024-12-08 17:13:16,78,4534,35,43,2948.69,5055.00,0.00
2024-12-08 17:13:16,79,4534,36,43,2911.37,5055.01,0.00
2024-12-08 17:13:16,78,4534,36,42,2925.43,5055.22,0.00
2024-12-08 17:13:16,78,4535,36,42,2938.26,5056.00,0.00
2024-12-08 17:13:16,79,4535,37,42,2901.06,5056.01,0.00
2024-12-08 17:13:16,78,4535,36,42,2927.95,5056.22,0.00
2024-12-08 17:13:16,78,4536,36,42,2927.82,5057.00,0.00
2024-12-08 17:13:16,79,4536,36,43,2890.76,5057.01,0.00
2024-12-08 17:13:16,79,4537,36,43,2879.80,5058.00,0.00
2024-12-08 17:13:16,80,4537,37,43,2843.80,5058.01,0.00
2024-12-08 17:13:16,79,4537,37,42,2874.72,5058.10,0.00
2024-12-08 17:13:16,78,4537,36,42,2904.47,5058.23,0.00
2024-12-08 17:13:16,77,4537,36,41,2940.88,5058.23,0.00
2024-12-08 17:13:16,77,4538,36,41,2955.19,5059.00,0.00
2024-12-08 17:13:16,78,4538,36,42,2917.30,5059.01,0.00
2024-12-08 17:13:16,78,4539,36,42,2906.85,5060.00,0.00
2024-12-08 17:13:16,79,4539,37,42,2870.05,5060.01,0.00
2024-12-08 17:13:16,78,4539,37,41,2882.91,5060.23,0.00
2024-12-08 17:13:16,78,4540,37,41,2896.39,5061.00,0.00
2024-12-08 17:13:16,79,4540,37,42,2859.73,5061.01,0.00
2024-12-08 17:13:16,80,4539,38,42,2823.98,5061.04,0.00
2024-12-08 17:13:16,80,4540,38,42,2831.50,5062.00,0.00
2024-12-08 17:13:16,81,4540,39,42,2796.54,5062.01,0.00
2024-12-08 17:13:16,80,4540,39,41,2808.15,5062.23,0.00
2024-12-08 17:13:16,80,4541,39,41,2883.32,5063.00,0.00
2024-12-08 17:13:16,81,4541,40,41,2847.73,5063.01,0.00
2024-12-08 17:13:16,81,4542,40,41,2835.78,5064.00,0.00
2024-12-08 17:13:16,82,4542,41,41,2801.20,5064.01,0.00
2024-12-08 17:13:16,81,4542,41,40,2812.09,5064.23,0.00
2024-12-08 17:13:16,81,4543,41,40,2823.84,5065.00,0.00
2024-12-08 17:13:16,82,4543,42,40,2789.40,5065.01,0.00
2024-12-08 17:13:16,82,4544,42,40,2776.98,5066.00,0.00
2024-12-08 17:13:16,83,4544,42,41,2743.52,5066.01,0.00
2024-12-08 17:13:16,82,4544,42,40,2774.54,5066.05,0.00
2024-12-08 17:13:16,81,4544,42,39,2787.56,5066.22,0.00
2024-12-08 17:13:16,81,4545,42,39,2798.68,5067.00,0.00
2024-12-08 17:13:16,82,4545,42,40,2764.55,5067.01,0.00
2024-12-08 17:13:16,81,4545,41,40,2734.70,5067.89,0.00
2024-12-08 17:13:16,81,4546,41,40,2791.72,5068.00,0.00
2024-12-08 17:13:16,82,4546,42,40,2757.68,5068.01,0.00
2024-12-08 17:13:16,81,4546,42,39,2768.01,5068.23,0.00
2024-12-08 17:13:16,81,4547,42,39,2779.76,5069.00,0.00
2024-12-08 17:13:16,82,4547,43,39,2745.86,5069.01,0.00
2024-12-08 17:13:16,81,4547,43,38,2766.65,5069.10,0.00
2024-12-08 17:13:16,81,4548,43,38,2771.54,5070.00,0.00
2024-12-08 17:13:16,82,4548,43,39,2737.75,5070.01,0.00
2024-12-08 17:13:16,81,4548,42,39,2769.07,5070.05,0.00
2024-12-08 17:13:16,80,4548,42,38,2796.08,5070.08,0.00
2024-12-08 17:13:16,80,4549,42,38,2800.40,5071.00,0.00
2024-12-08 17:13:16,81,4549,42,39,2765.83,5071.01,0.00
2024-12-08 17:13:16,80,4549,41,39,2797.90,5071.05,0.00
2024-12-08 17:13:16,79,4549,41,38,2824.33,5071.06,0.00
2024-12-08 17:13:16,78,4549,40,38,2859.24,5071.09,0.00
2024-12-08 17:13:16,78,4550,40,38,2865.62,5072.00,0.00
2024-12-08 17:13:16,79,4550,41,38,2829.35,5072.01,0.00
2024-12-08 17:13:17,79,4551,41,38,2818.35,5073.00,0.00
2024-12-08 17:13:17,80,4551,42,38,2783.12,5073.01,0.00
2024-12-08 17:13:17,79,4551,42,37,2805.55,5073.14,0.00
2024-12-08 17:13:17,79,4552,42,37,2813.77,5074.00,0.00
2024-12-08 17:13:17,80,4552,42,38,2778.59,5074.01,0.00
2024-12-08 17:13:17,81,4551,43,38,2709.38,5074.48,0.00
2024-12-08 17:13:17,80,4551,42,38,2735.97,5074.95,0.00
2024-12-08 17:13:17,80,4552,42,38,2796.90,5075.00,0.00
2024-12-08 17:13:17,81,4552,42,39,2762.37,5075.01,0.00
2024-12-08 17:13:17,80,4552,41,39,2794.40,5075.05,0.00
2024-12-08 17:13:17,79,4552,41,38,2818.21,5075.13,0.00
2024-12-08 17:13:17,79,4553,41,38,2890.05,5076.00,0.00
2024-12-08 17:13:17,80,4553,42,38,2853.93,5076.01,0.00
2024-12-08 17:13:17,81,4552,43,38,2814.96,5076.11,0.00
2024-12-08 17:13:17,82,4551,44,38,2790.67,5076.46,0.00
2024-12-08 17:13:17,81,4551,43,38,2825.14,5076.48,0.00
2024-12-08 17:13:17,81,4552,43,38,2861.87,5077.00,0.00
2024-12-08 17:13:17,82,4552,43,39,2826.97,5077.01,0.00
2024-12-08 17:13:17,81,4552,42,39,2856.27,5077.11,0.00
2024-12-08 17:13:17,80,4552,42,38,2889.49,5077.11,0.00
2024-12-08 17:13:17,79,4552,41,38,2913.87,5077.15,0.00
2024-12-08 17:13:17,79,4553,41,38,3064.15,5078.00,0.00
2024-12-08 17:13:17,80,4553,41,39,3025.85,5078.01,0.00
2024-12-08 17:13:17,80,4554,41,39,3014.39,5079.00,0.00
2024-12-08 17:13:17,81,4554,42,39,2977.17,5079.01,0.00
2024-12-08 17:13:17,80,4554,42,38,3003.00,5079.11,0.00
2024-12-08 17:13:17,79,4554,41,38,3002.72,5079.67,0.00
2024-12-08 17:13:17,79,4555,41,38,3050.57,5080.00,0.00
2024-12-08 17:13:17,80,4555,41,39,3012.44,5080.01,0.00
2024-12-08 17:13:17,79,4555,40,39,3038.40,5080.11,0.00
2024-12-08 17:13:17,79,4556,40,39,3045.38,5081.00,0.00
2024-12-08 17:13:17,80,4556,40,40,3007.32,5081.01,0.00
2024-12-08 17:13:17,79,4556,40,39,3033.21,5081.11,0.00
2024-12-08 17:13:17,78,4556,39,39,3054.53,5081.21,0.00
2024-12-08 17:13:17,78,4557,39,39,3079.82,5082.00,0.00
2024-12-08 17:13:17,79,4557,40,39,3040.84,5082.01,0.00
2024-12-08 17:13:17,78,4557,39,39,3026.05,5082.64,0.00
2024-12-08 17:13:17,78,4558,39,39,3073.26,5083.00,0.00
2024-12-08 17:13:17,79,4558,39,40,3034.36,5083.01,0.00
2024-12-08 17:13:17,78,4558,39,39,3059.62,5083.13,0.00
2024-12-08 17:13:17,78,4559,39,39,3068.00,5084.00,0.00
2024-12-08 17:13:17,79,4559,40,39,3029.16,5084.01,0.00
2024-12-08 17:13:17,79,4560,40,39,3018.17,5085.00,0.00
2024-12-08 17:13:17,80,4560,41,39,2980.44,5085.01,0.00
2024-12-08 17:13:17,81,4559,41,40,2943.65,5085.04,0.00
2024-12-08 17:13:17,80,4559,41,39,2982.40,5085.14,0.00
2024-12-08 17:13:17,80,4560,41,39,2989.93,5086.00,0.00
2024-12-08 17:13:17,81,4560,42,39,2953.02,5086.01,0.00
2024-12-08 17:13:17,80,4560,42,38,2987.42,5086.05,0.00
2024-12-08 17:13:17,79,4560,41,38,2998.22,5086.15,0.00
2024-12-08 17:13:17,79,4561,41,38,3084.39,5087.00,0.00
2024-12-08 17:13:17,80,4561,42,38,3045.84,5087.01,0.00
2024-12-08 17:13:17,79,4561,42,37,3081.85,5087.05,0.00
2024-12-08 17:13:17,78,4561,42,36,3110.29,5087.12,0.00
2024-12-08 17:13:17,78,4562,42,36,3118.03,5088.00,0.00
2024-12-08 17:13:17,79,4562,43,36,3078.56,5088.01,0.00
2024-12-08 17:13:17,78,4562,42,36,3094.62,5088.21,0.00
2024-12-08 17:13:17,78,4563,42,36,3106.90,5089.00,0.00
2024-12-08 17:13:17,79,4563,43,36,3067.57,5089.01,0.00
2024-12-08 17:13:17,78,4563,43,35,3095.20,5089.12,0.00
2024-12-08 17:13:17,78,4564,43,35,3102.94,5090.00,0.00
2024-12-08 17:13:17,79,4564,44,35,3063.66,5090.01,0.00
2024-12-08 17:13:17,80,4563,45,35,3021.59,5090.11,0.00
2024-12-08 17:13:18,80,4564,45,35,3063.51,5091.00,0.00
2024-12-08 17:13:18,81,4564,45,36,3025.69,5091.01,0.00
2024-12-08 17:13:18,80,4564,44,36,3060.99,5091.05,0.00
2024-12-08 17:13:18,79,4564,44,35,3088.81,5091.11,0.00
2024-12-08 17:13:18,79,4565,44,35,3160.26,5092.00,0.00
2024-12-08 17:13:18,80,4565,45,35,3120.76,5092.01,0.00
2024-12-08 17:13:18,80,4566,45,35,3109.27,5093.00,0.00
2024-12-08 17:13:18,81,4566,46,35,3070.89,5093.01,0.00
2024-12-08 17:13:18,80,4566,46,34,3096.59,5093.11,0.00
2024-12-08 17:13:18,80,4567,46,34,3102.88,5094.00,0.00
2024-12-08 17:13:18,81,4567,47,34,3064.57,5094.01,0.00
2024-12-08 17:13:18,81,4568,47,34,3052.60,5095.00,0.00
2024-12-08 17:13:18,82,4568,47,35,3015.37,5095.01,0.00
2024-12-08 17:13:18,81,4568,47,34,3040.69,5095.11,0.00
2024-12-08 17:13:18,81,4569,47,34,3046.27,5096.00,0.00
2024-12-08 17:13:18,82,4569,47,35,3009.12,5096.01,0.00
2024-12-08 17:13:18,81,4569,46,35,3043.16,5096.06,0.00
2024-12-08 17:13:18,81,4570,46,35,3033.66,5097.00,0.00
2024-12-08 17:13:18,82,4570,46,36,2996.66,5097.01,0.00
2024-12-08 17:13:18,81,4570,45,36,3029.93,5097.07,0.00
2024-12-08 17:13:18,80,4570,45,35,3060.79,5097.09,0.00
2024-12-08 17:13:18,80,4571,45,35,3065.81,5098.00,0.00
2024-12-08 17:13:18,81,4571,45,36,3027.96,5098.01,0.00
2024-12-08 17:13:18,81,4572,45,36,3015.96,5099.00,0.00
2024-12-08 17:13:18,82,4572,45,37,2979.18,5099.01,0.00
2024-12-08 17:13:18,81,4572,45,36,3006.56,5099.09,0.00
2024-12-08 17:13:18,81,4573,45,36,3010.89,5100.00,0.00
2024-12-08 17:13:18,82,4573,45,37,2974.17,5100.01,0.00
2024-12-08 17:13:18,82,4574,45,37,2961.69,5101.00,0.00
2024-12-08 17:13:18,83,4574,46,37,2926.01,5101.01,0.00
2024-12-08 17:13:18,82,4574,45,37,2958.00,5101.07,0.00
2024-12-08 17:13:18,81,4574,45,36,2988.85,5101.07,0.00
2024-12-08 17:13:18,80,4574,44,36,3014.12,5101.14,0.00
2024-12-08 17:13:18,80,4575,44,36,3034.41,5102.00,0.00
2024-12-08 17:13:18,81,4575,45,36,2996.95,5102.01,0.00
2024-12-08 17:13:18,81,4576,45,36,2984.94,5103.00,0.00
2024-12-08 17:13:18,82,4576,45,37,2948.54,5103.01,0.00
2024-12-08 17:13:18,81,4576,45,36,2976.79,5103.07,0.00
2024-12-08 17:13:18,81,4577,45,36,2980.48,5104.00,0.00
2024-12-08 17:13:18,82,4577,45,37,2944.14,5104.01,0.00
2024-12-08 17:13:18,81,4577,44,37,2922.32,5104.83,0.00
2024-12-08 17:13:18,81,4578,44,37,2976.66,5105.00,0.00
2024-12-08 17:13:18,82,4578,44,38,2940.35,5105.01,0.00
2024-12-08 17:13:18,81,4578,44,37,2969.76,5105.07,0.00
2024-12-08 17:13:18,81,4579,44,37,2973.46,5106.00,0.00
2024-12-08 17:13:18,82,4579,44,38,2937.19,5106.01,0.00
2024-12-08 17:13:18,81,4579,43,38,2945.19,5106.28,0.00
2024-12-08 17:13:18,81,4580,43,38,2972.15,5107.00,0.00
2024-12-08 17:13:18,82,4580,43,39,2935.90,5107.01,0.00
2024-12-08 17:13:18,81,4580,43,38,2948.24,5107.11,0.00
2024-12-08 17:13:18,80,4580,42,38,2977.47,5107.25,0.00
2024-12-08 17:13:18,80,4581,42,38,3003.50,5108.00,0.00
2024-12-08 17:13:18,81,4581,42,39,2966.42,5108.01,0.00
2024-12-08 17:13:18,80,4581,41,39,2997.79,5108.08,0.00
2024-12-08 17:13:19,80,4582,41,39,3002.17,5109.00,0.00
2024-12-08 17:13:19,81,4582,42,39,2965.11,5109.01,0.00
2024-12-08 17:13:19,80,4582,42,38,2979.23,5109.10,0.00
2024-12-08 17:13:19,80,4583,42,38,2997.65,5110.00,0.00
2024-12-08 17:13:19,81,4583,42,39,2960.64,5110.01,0.00
2024-12-08 17:13:19,81,4584,42,39,2948.60,5111.00,0.00
2024-12-08 17:13:19,82,4584,43,39,2912.65,5111.01,0.00
2024-12-08 17:13:19,81,4584,42,39,2944.22,5111.07,0.00
2024-12-08 17:13:19,80,4584,42,38,2975.28,5111.09,0.00
2024-12-08 17:13:19,80,4585,42,38,2993.07,5112.00,0.00
2024-12-08 17:13:19,81,4585,43,38,2956.12,5112.01,0.00
2024-12-08 17:13:19,81,4586,43,38,2944.08,5113.00,0.00
2024-12-08 17:13:19,82,4586,44,38,2908.17,5113.01,0.00
2024-12-08 17:13:19,81,4586,44,37,2935.91,5113.09,0.00
2024-12-08 17:13:19,81,4587,44,37,2940.23,5114.00,0.00
2024-12-08 17:13:19,82,4587,44,38,2904.38,5114.01,0.00
2024-12-08 17:13:19,82,4588,44,38,2891.84,5115.00,0.00
2024-12-08 17:13:19,83,4588,45,38,2857.00,5115.01,0.00
2024-12-08 17:13:19,82,4588,45,37,2883.15,5115.10,0.00
2024-12-08 17:13:19,81,4588,44,37,2890.45,5115.43,0.00
2024-12-08 17:13:19,81,4589,44,37,2924.96,5116.00,0.00
2024-12-08 17:13:19,82,4589,44,38,2889.29,5116.01,0.00
2024-12-08 17:13:19,81,4589,43,38,2918.05,5116.09,0.00
2024-12-08 17:13:19,81,4590,43,38,2922.37,5117.00,0.00
2024-12-08 17:13:19,82,4590,43,39,2886.74,5117.01,0.00
2024-12-08 17:13:19,81,4590,43,38,2914.83,5117.09,0.00
2024-12-08 17:13:19,80,4590,42,38,2940.41,5117.15,0.00
2024-12-08 17:13:19,80,4591,42,38,2961.40,5118.00,0.00
2024-12-08 17:13:19,81,4591,42,39,2924.84,5118.01,0.00
2024-12-08 17:13:19,81,4592,42,39,2912.77,5119.00,0.00
2024-12-08 17:13:19,82,4592,43,39,2877.25,5119.01,0.00
2024-12-08 17:13:19,81,4592,43,38,2905.86,5119.09,0.00
2024-12-08 17:13:19,81,4593,43,38,2910.18,5120.00,0.00
2024-12-08 17:13:19,82,4593,43,39,2874.69,5120.01,0.00
2024-12-08 17:13:19,82,4594,43,39,2862.14,5121.00,0.00
2024-12-08 17:13:19,83,4594,43,40,2827.66,5121.01,0.00
2024-12-08 17:13:19,82,4594,43,39,2855.30,5121.10,0.00
2024-12-08 17:13:19,82,4595,43,39,2859.57,5122.00,0.00
2024-12-08 17:13:19,83,4595,44,39,2825.12,5122.01,0.00
2024-12-08 17:13:19,83,4596,44,39,2812.09,5123.00,0.00
2024-12-08 17:13:19,84,4596,45,39,2778.62,5123.01,0.00
2024-12-08 17:13:19,83,4596,44,39,2807.81,5123.08,0.00
2024-12-08 17:13:19,82,4596,44,38,2840.17,5123.09,0.00
2024-12-08 17:13:19,82,4597,44,38,2843.82,5124.00,0.00
2024-12-08 17:13:19,83,4597,44,39,2809.56,5124.01,0.00
2024-12-08 17:13:19,83,4598,44,39,2796.52,5125.00,0.00
2024-12-08 17:13:19,84,4598,45,39,2763.23,5125.01,0.00
2024-12-08 17:13:19,83,4598,45,38,2789.14,5125.10,0.00
2024-12-08 17:13:19,83,4599,45,38,2792.74,5126.00,0.00
2024-12-08 17:13:19,84,4599,45,39,2759.50,5126.01,0.00
2024-12-08 17:13:19,83,4599,44,39,2788.45,5126.08,0.00
2024-12-08 17:13:19,83,4600,44,39,2779.08,5127.00,0.00
2024-12-08 17:13:19,84,4600,44,40,2746.00,5127.01,0.00
2024-12-08 17:13:19,85,4599,45,40,2710.70,5127.09,0.00
2024-12-08 17:13:19,84,4599,44,40,2771.06,5127.10,0.00
2024-12-08 17:13:19,83,4599,44,39,2801.35,5127.10,0.00
2024-12-08 17:13:20,83,4600,44,39,2817.31,5128.00,0.00
2024-12-08 17:13:20,84,4600,45,39,2783.77,5128.01,0.00
2024-12-08 17:13:20,84,4601,45,39,2831.33,5129.00,0.00
2024-12-08 17:13:20,85,4601,46,39,2798.02,5129.01,0.00
2024-12-08 17:13:20,84,4601,46,38,2820.38,5129.12,0.00
2024-12-08 17:13:20,84,4602,46,38,2824.55,5130.00,0.00
2024-12-08 17:13:20,85,4602,47,38,2791.32,5130.01,0.00
2024-12-08 17:13:20,85,4603,47,38,2777.38,5131.00,0.00
2024-12-08 17:13:20,86,4603,48,38,2745.08,5131.01,0.00
2024-12-08 17:13:20,87,4602,48,39,2709.44,5131.12,0.00
2024-12-08 17:13:20,86,4602,48,38,2780.93,5131.13,0.00
2024-12-08 17:13:20,86,4603,48,38,2784.41,5132.00,0.00
2024-12-08 17:13:20,87,4603,49,38,2752.40,5132.01,0.00
2024-12-08 17:13:20,86,4603,48,38,2756.42,5132.17,0.00
2024-12-08 17:13:20,86,4604,48,38,2833.89,5133.00,0.00
2024-12-08 17:13:20,87,4604,49,38,2801.32,5133.01,0.00
2024-12-08 17:13:20,86,4604,49,37,2822.60,5133.13,0.00
2024-12-08 17:13:20,85,4604,48,37,2836.63,5133.51,0.00
2024-12-08 17:13:20,85,4605,48,37,2859.94,5134.00,0.00
2024-12-08 17:13:20,86,4605,48,38,2826.68,5134.01,0.00
2024-12-08 17:13:20,85,4605,47,38,2844.90,5134.17,0.00
2024-12-08 17:13:20,85,4606,47,38,2850.83,5135.00,0.00
2024-12-08 17:13:20,86,4606,47,39,2817.68,5135.01,0.00
2024-12-08 17:13:20,85,4606,47,38,2835.78,5135.17,0.00
2024-12-08 17:13:20,84,4606,46,38,2840.33,5135.50,0.00
2024-12-08 17:13:20,84,4607,46,38,2876.16,5136.00,0.00
2024-12-08 17:13:20,85,4607,46,39,2842.32,5136.01,0.00
2024-12-08 17:13:20,85,4608,46,39,2828.37,5137.00,0.00
2024-12-08 17:13:20,86,4608,46,40,2795.48,5137.01,0.00
2024-12-08 17:13:20,85,4608,46,39,2813.92,5137.17,0.00
2024-12-08 17:13:20,84,4608,45,39,2835.20,5137.20,0.00
2024-12-08 17:13:20,84,4609,45,39,2855.87,5138.00,0.00
2024-12-08 17:13:20,85,4609,46,39,2822.27,5138.01,0.00
2024-12-08 17:13:20,85,4610,46,39,2808.31,5139.00,0.00
2024-12-08 17:13:20,86,4610,46,40,2775.66,5139.01,0.00
2024-12-08 17:13:20,85,4610,46,39,2792.64,5139.18,0.00
2024-12-08 17:13:20,85,4611,46,39,2799.18,5140.00,0.00
2024-12-08 17:13:20,86,4611,46,40,2766.63,5140.01,0.00
2024-12-08 17:13:20,85,4611,45,40,2793.18,5140.12,0.00
2024-12-08 17:13:20,85,4612,45,40,2784.61,5141.00,0.00
2024-12-08 17:13:20,86,4612,45,41,2752.23,5141.01,0.00
2024-12-08 17:13:20,87,4611,45,42,2720.59,5141.04,0.00
2024-12-08 17:13:20,88,4610,45,43,2719.49,5141.10,0.00
2024-12-08 17:13:20,87,4610,45,42,2747.83,5141.18,0.00
2024-12-08 17:13:20,86,4610,44,42,2745.33,5141.69,0.00
2024-12-08 17:13:20,86,4611,44,42,2789.24,5142.00,0.00
2024-12-08 17:13:20,87,4611,44,43,2757.18,5142.01,0.00
2024-12-08 17:13:20,87,4612,44,43,2860.57,5143.00,0.00
2024-12-08 17:13:20,88,4612,44,44,2828.06,5143.01,0.00
2024-12-08 17:13:20,87,4612,43,44,2859.40,5143.04,0.00
2024-12-08 17:13:20,86,4612,43,43,2879.53,5143.15,0.00
2024-12-08 17:13:20,85,4612,42,43,2907.40,5143.27,0.00
2024-12-08 17:13:20,84,4612,41,43,2931.08,5143.49,0.00
2024-12-08 17:13:20,84,4613,41,43,2954.12,5144.00,0.00
2024-12-08 17:13:20,85,4613,42,43,2919.37,5144.01,0.00
2024-12-08 17:13:20,85,4614,42,43,2905.41,5145.00,0.00
2024-12-08 17:13:20,86,4614,42,44,2871.63,5145.01,0.00
2024-12-08 17:13:20,85,4614,42,43,2890.94,5145.17,0.00
2024-12-08 17:13:21,85,4615,42,43,2896.89,5146.00,0.00
2024-12-08 17:13:21,86,4615,43,43,2863.21,5146.01,0.00
2024-12-08 17:13:21,86,4616,43,43,2848.80,5147.00,0.00
2024-12-08 17:13:21,87,4616,43,44,2816.06,5147.01,0.00
2024-12-08 17:13:21,86,4616,42,44,2835.09,5147.16,0.00
2024-12-08 17:13:21,85,4616,42,43,2860.58,5147.19,0.00
2024-12-08 17:13:21,85,4617,42,43,2879.85,5148.00,0.00
2024-12-08 17:13:21,86,4617,42,44,2846.36,5148.01,0.00
2024-12-08 17:13:21,85,4617,41,44,2878.65,5148.02,0.00
2024-12-08 17:13:21,85,4618,41,44,2865.27,5149.00,0.00
2024-12-08 17:13:21,86,4618,41,45,2831.95,5149.01,0.00
2024-12-08 17:13:21,85,4618,40,45,2859.25,5149.13,0.00
2024-12-08 17:13:21,84,4618,40,44,2885.33,5149.17,0.00
2024-12-08 17:13:21,83,4618,39,44,2913.27,5149.17,0.00
2024-12-08 17:13:21,83,4619,39,44,2933.02,5150.00,0.00
2024-12-08 17:13:21,84,4619,40,44,2898.10,5150.01,0.00
2024-12-08 17:13:21,83,4619,39,44,2900.20,5150.22,0.00
2024-12-08 17:13:21,83,4620,39,44,2922.42,5151.00,0.00
2024-12-08 17:13:21,84,4620,39,45,2887.63,5151.01,0.00
2024-12-08 17:13:21,85,4619,39,46,2846.43,5151.18,0.00
2024-12-08 17:13:21,84,4619,39,45,2919.57,5151.18,0.00
2024-12-08 17:13:21,84,4620,39,45,2926.83,5152.00,0.00
2024-12-08 17:13:21,85,4620,40,45,2892.39,5152.01,0.00
2024-12-08 17:13:21,84,4620,39,45,2923.79,5152.06,0.00
2024-12-08 17:13:21,84,4621,39,45,2974.02,5153.00,0.00
2024-12-08 17:13:21,85,4621,39,46,2939.03,5153.01,0.00
2024-12-08 17:13:21,84,4621,39,45,2961.19,5153.16,0.00
2024-12-08 17:13:21,84,4622,39,45,2967.23,5154.00,0.00
2024-12-08 17:13:21,85,4622,40,45,2932.32,5154.01,0.00
2024-12-08 17:13:21,84,4622,39,45,2936.62,5154.20,0.00
2024-12-08 17:13:21,84,4623,39,45,2957.37,5155.00,0.00
2024-12-08 17:13:21,85,4623,40,45,2922.58,5155.01,0.00
2024-12-08 17:13:21,84,4623,40,44,2944.54,5155.16,0.00
2024-12-08 17:13:21,84,4624,40,44,2950.58,5156.00,0.00
2024-12-08 17:13:21,85,4624,40,45,2915.87,5156.01,0.00
2024-12-08 17:13:21,84,4624,39,45,2946.93,5156.07,0.00
2024-12-08 17:13:21,83,4624,38,45,2940.94,5156.43,0.00
2024-12-08 17:13:21,83,4625,38,45,2974.28,5157.00,0.00
2024-12-08 17:13:21,84,4625,38,46,2938.88,5157.01,0.00
2024-12-08 17:13:21,83,4625,38,45,2954.47,5157.22,0.00
2024-12-08 17:13:21,82,4625,37,45,2971.15,5157.52,0.00
2024-12-08 17:13:21,83,4624,37,46,2921.87,5157.81,0.00
2024-12-08 17:13:21,83,4625,37,46,2983.56,5158.00,0.00
2024-12-08 17:13:21,84,4625,37,47,2948.04,5158.01,0.00
2024-12-08 17:13:21,84,4626,37,47,2995.90,5159.00,0.00
2024-12-08 17:13:21,85,4626,37,48,2960.66,5159.01,0.00
2024-12-08 17:13:21,84,4626,37,47,2974.47,5159.23,0.00
2024-12-08 17:13:21,85,4625,38,47,2900.93,5159.77,0.00
2024-12-08 17:13:21,85,4626,38,47,2960.02,5160.00,0.00
2024-12-08 17:13:21,86,4626,39,47,2925.60,5160.01,0.00
2024-12-08 17:13:21,86,4627,39,47,2971.17,5161.00,0.00
2024-12-08 17:13:21,87,4627,40,47,2937.02,5161.01,0.00
2024-12-08 17:13:21,86,4627,39,47,2967.61,5161.07,0.00
2024-12-08 17:13:21,85,4627,39,46,2985.55,5161.21,0.00
2024-12-08 17:13:21,85,4628,39,46,2993.96,5162.00,0.00
2024-12-08 17:13:21,86,4628,39,47,2959.15,5162.01,0.00
2024-12-08 17:13:21,85,4628,38,47,2990.35,5162.07,0.00
2024-12-08 17:13:21,85,4629,38,47,2979.35,5163.00,0.00
2024-12-08 17:13:21,86,4629,39,47,2944.71,5163.01,0.00
2024-12-08 17:13:22,85,4629,38,47,2975.74,5163.07,0.00
2024-12-08 17:13:22,84,4629,38,46,2995.83,5163.19,0.00
2024-12-08 17:13:22,84,4630,38,46,3003.73,5164.00,0.00
2024-12-08 17:13:22,85,4630,39,46,2968.39,5164.01,0.00
2024-12-08 17:13:22,85,4631,39,46,2954.38,5165.00,0.00
2024-12-08 17:13:22,86,4631,40,46,2920.03,5165.01,0.00
2024-12-08 17:13:22,85,4631,39,46,2949.56,5165.11,0.00
2024-12-08 17:13:22,84,4631,39,45,2972.39,5165.18,0.00
2024-12-08 17:13:22,83,4631,38,45,2994.00,5165.45,0.00
2024-12-08 17:13:22,83,4632,38,45,3015.57,5166.00,0.00
2024-12-08 17:13:22,84,4632,39,45,2979.67,5166.01,0.00
2024-12-08 17:13:22,84,4633,39,45,2966.10,5167.00,0.00
2024-12-08 17:13:22,85,4633,39,46,2931.21,5167.01,0.00
2024-12-08 17:13:22,84,4633,38,46,2960.61,5167.12,0.00
2024-12-08 17:13:22,83,4633,38,45,2985.71,5167.17,0.00
2024-12-08 17:13:22,83,4634,38,45,2993.08,5168.00,0.00
2024-12-08 17:13:22,84,4634,38,46,2957.45,5168.01,0.00
2024-12-08 17:13:22,84,4635,38,46,2943.87,5169.00,0.00
2024-12-08 17:13:22,85,4635,39,46,2909.23,5169.01,0.00
2024-12-08 17:13:22,84,4635,38,46,2938.37,5169.12,0.00
2024-12-08 17:13:22,83,4635,38,45,2964.44,5169.16,0.00
2024-12-08 17:13:22,83,4636,38,45,2971.19,5170.00,0.00
2024-12-08 17:13:22,84,4636,38,46,2935.82,5170.01,0.00
2024-12-08 17:13:22,84,4637,38,46,2922.23,5171.00,0.00
2024-12-08 17:13:22,85,4637,38,47,2887.85,5171.01,0.00
2024-12-08 17:13:22,84,4637,38,46,2906.27,5171.17,0.00
2024-12-08 17:13:22,84,4638,38,46,2912.94,5172.00,0.00
2024-12-08 17:13:22,85,4638,39,46,2878.67,5172.01,0.00
2024-12-08 17:13:22,84,4638,38,46,2896.36,5172.12,0.00
2024-12-08 17:13:22,84,4639,38,46,2900.57,5173.00,0.00
2024-12-08 17:13:22,85,4639,39,46,2866.45,5173.01,0.00
2024-12-08 17:13:22,84,4639,39,45,2885.84,5173.16,0.00
2024-12-08 17:13:22,83,4639,38,45,2915.65,5173.24,0.00
2024-12-08 17:13:22,83,4640,38,45,2926.74,5174.00,0.00
2024-12-08 17:13:22,84,4640,39,45,2891.90,5174.01,0.00
2024-12-08 17:13:22,83,4640,38,45,2923.02,5174.07,0.00
2024-12-08 17:13:22,83,4641,38,45,2912.96,5175.00,0.00
2024-12-08 17:13:22,84,4641,39,45,2878.29,5175.01,0.00
2024-12-08 17:13:22,83,4641,39,44,2899.29,5175.15,0.00
2024-12-08 17:13:22,83,4642,39,44,2905.42,5176.00,0.00
2024-12-08 17:13:22,84,4642,40,44,2870.83,5176.01,0.00
2024-12-08 17:13:22,83,4642,39,44,2904.18,5176.02,0.00
2024-12-08 17:13:22,82,4642,38,44,2937.09,5176.06,0.00
2024-12-08 17:13:22,82,4643,38,44,2926.90,5177.00,0.00
2024-12-08 17:13:22,83,4643,39,44,2891.63,5177.01,0.00
2024-12-08 17:13:22,82,4643,39,43,2918.09,5177.07,0.00
2024-12-08 17:13:22,82,4644,39,43,2921.15,5178.00,0.00
2024-12-08 17:13:22,83,4644,40,43,2885.95,5178.01,0.00
2024-12-08 17:13:22,82,4644,40,42,2910.45,5178.11,0.00
2024-12-08 17:13:22,82,4645,40,42,2915.40,5179.00,0.00
2024-12-08 17:13:22,83,4645,41,42,2880.27,5179.01,0.00
2024-12-08 17:13:22,82,4645,40,42,2880.20,5179.45,0.00
2024-12-08 17:13:22,82,4646,40,42,2902.69,5180.00,0.00
2024-12-08 17:13:22,83,4646,41,42,2867.72,5180.01,0.00
2024-12-08 17:13:22,82,4646,41,41,2892.60,5180.11,0.00
2024-12-08 17:13:22,82,4647,41,41,2897.55,5181.00,0.00
2024-12-08 17:13:22,83,4647,41,42,2862.64,5181.01,0.00
2024-12-08 17:13:22,83,4648,41,42,2848.80,5182.00,0.00
2024-12-08 17:13:22,84,4648,41,43,2814.88,5182.01,0.00
2024-12-08 17:13:23,83,4648,40,43,2843.03,5182.10,0.00
2024-12-08 17:13:23,82,4648,40,42,2873.27,5182.10,0.00
2024-12-08 17:13:23,82,4649,40,42,2877.59,5183.00,0.00
2024-12-08 17:13:23,83,4649,41,42,2842.92,5183.01,0.00
2024-12-08 17:13:23,84,4648,41,43,2807.85,5183.06,0.00
2024-12-08 17:13:23,84,4649,41,43,2819.70,5184.00,0.00
2024-12-08 17:13:23,85,4649,41,44,2786.52,5184.01,0.00
2024-12-08 17:13:23,84,4649,41,43,2807.84,5184.11,0.00
2024-12-08 17:13:23,84,4650,41,43,2873.16,5185.00,0.00
2024-12-08 17:13:23,85,4650,41,44,2839.35,5185.01,0.00
2024-12-08 17:13:23,85,4651,41,44,2822.36,5186.00,0.00
2024-12-08 17:13:23,86,4651,41,45,2789.54,5186.01,0.00
2024-12-08 17:13:23,86,4652,41,45,2771.99,5187.00,0.00
2024-12-08 17:13:23,87,4652,42,45,2740.13,5187.01,0.00
2024-12-08 17:13:23,86,4652,42,44,2756.82,5187.13,0.00
2024-12-08 17:13:23,85,4652,41,44,2780.11,5187.15,0.00
2024-12-08 17:13:23,85,4653,41,44,2797.69,5188.00,0.00
2024-12-08 17:13:23,86,4653,42,44,2765.16,5188.01,0.00
2024-12-08 17:13:23,86,4654,42,44,2747.01,5189.00,0.00
2024-12-08 17:13:23,87,4654,42,45,2715.44,5189.01,0.00
2024-12-08 17:13:23,86,4654,42,44,2731.52,5189.13,0.00
2024-12-08 17:13:23,86,4655,42,44,2735.03,5190.00,0.00
2024-12-08 17:13:23,87,4655,42,45,2703.59,5190.01,0.00
2024-12-08 17:13:23,86,4655,41,45,2733.83,5190.02,0.00
2024-12-08 17:13:23,85,4655,41,44,2763.54,5190.04,0.00
2024-12-08 17:13:23,84,4655,40,44,2795.21,5190.05,0.00
2024-12-08 17:13:23,83,4655,39,44,2828.26,5190.06,0.00
2024-12-08 17:13:23,83,4655,39,44,2817.52,5191.00,0.00
2024-12-08 17:13:23,84,4655,40,44,2783.98,5191.01,0.00
2024-12-08 17:13:23,83,4655,40,43,2808.80,5191.08,0.00
2024-12-08 17:13:23,82,4655,39,43,2837.39,5191.20,0.00
2024-12-08 17:13:23,81,4655,38,43,2871.78,5191.20,0.00
2024-12-08 17:13:23,81,4656,38,43,2881.88,5192.00,0.00
2024-12-08 17:13:23,82,4656,38,44,2846.74,5192.01,0.00
2024-12-08 17:13:23,81,4656,37,44,2878.70,5192.05,0.00
2024-12-08 17:13:23,80,4656,37,43,2912.09,5192.06,0.00
2024-12-08 17:13:23,80,4657,37,43,2928.85,5193.00,0.00
2024-12-08 17:13:23,81,4657,38,43,2892.69,5193.01,0.00
2024-12-08 17:13:23,81,4658,38,43,2880.42,5194.00,0.00
2024-12-08 17:13:23,82,4658,39,43,2845.30,5194.01,0.00
2024-12-08 17:13:23,81,4658,39,42,2873.40,5194.06,0.00
2024-12-08 17:13:23,81,4659,39,42,2876.49,5195.00,0.00
2024-12-08 17:13:23,82,4659,39,43,2841.41,5195.01,0.00
2024-12-08 17:13:23,82,4660,39,43,2828.65,5196.00,0.00
2024-12-08 17:13:23,83,4660,39,44,2794.57,5196.01,0.00
2024-12-08 17:13:23,82,4660,39,43,2822.34,5196.06,0.00
2024-12-08 17:13:23,82,4661,39,43,2824.76,5197.00,0.00
2024-12-08 17:13:23,83,4661,39,44,2790.73,5197.01,0.00
2024-12-08 17:13:23,82,4661,38,44,2817.81,5197.06,0.00
2024-12-08 17:13:23,82,4662,38,44,2820.23,5198.00,0.00
2024-12-08 17:13:23,83,4662,39,44,2786.25,5198.01,0.00
2024-12-08 17:13:23,82,4662,39,43,2813.28,5198.06,0.00
2024-12-08 17:13:23,82,4663,39,43,2815.70,5199.00,0.00
2024-12-08 17:13:23,83,4663,39,44,2781.78,5199.01,0.00
2024-12-08 17:13:23,83,4664,39,44,2768.53,5200.00,0.00
2024-12-08 17:13:23,84,4664,39,45,2735.57,5200.01,0.00
2024-12-08 17:13:23,83,4664,39,44,2761.66,5200.06,0.00
2024-12-08 17:13:23,82,4664,38,44,2760.06,5200.62,0.00
2024-12-08 17:13:23,82,4665,38,44,2804.10,5201.00,0.00
2024-12-08 17:13:23,83,4665,38,45,2770.31,5201.01,0.00
2024-12-08 17:13:23,82,4665,37,45,2765.61,5201.51,0.00
2024-12-08 17:13:24,82,4666,37,45,2791.32,5202.00,0.00
2024-12-08 17:13:24,83,4666,38,45,2757.69,5202.01,0.00
2024-12-08 17:13:24,82,4666,38,44,2784.99,5202.06,0.00
2024-12-08 17:13:24,82,4667,38,44,2787.41,5203.00,0.00
2024-12-08 17:13:24,83,4667,38,45,2753.83,5203.01,0.00
2024-12-08 17:13:24,83,4668,38,45,2740.56,5204.00,0.00
2024-12-08 17:13:24,84,4668,38,46,2707.94,5204.01,0.00
2024-12-08 17:13:24,83,4668,38,45,2727.43,5204.13,0.00
2024-12-08 17:13:24,82,4668,37,45,2740.48,5204.39,0.00
2024-12-08 17:13:24,82,4669,37,45,2772.61,5205.00,0.00
2024-12-08 17:13:24,83,4669,37,46,2739.21,5205.01,0.00
2024-12-08 17:13:24,82,4669,36,46,2747.30,5205.26,0.00
2024-12-08 17:13:24,82,4670,36,46,2759.81,5206.00,0.00
2024-12-08 17:13:24,83,4670,36,47,2726.56,5206.01,0.00
2024-12-08 17:13:24,82,4670,36,46,2747.15,5206.13,0.00
2024-12-08 17:13:24,82,4671,36,46,2753.36,5207.00,0.00
2024-12-08 17:13:24,83,4671,37,46,2720.19,5207.01,0.00
2024-12-08 17:13:24,83,4672,37,46,2706.90,5208.00,0.00
2024-12-08 17:13:24,84,4672,38,46,2674.68,5208.01,0.00
2024-12-08 17:13:24,83,4672,38,45,2695.01,5208.13,0.00
2024-12-08 17:13:24,83,4673,38,45,2700.52,5209.00,0.00
2024-12-08 17:13:24,84,4673,39,45,2668.37,5209.01,0.00
2024-12-08 17:13:24,84,4674,39,45,2654.62,5210.00,0.00
2024-12-08 17:13:24,85,4674,40,45,2623.39,5210.01,0.00
2024-12-08 17:13:24,84,4674,40,44,2643.48,5210.13,0.00
2024-12-08 17:13:24,85,4673,41,44,2609.95,5210.20,0.00
2024-12-08 17:13:24,85,4674,41,44,2649.64,5211.00,0.00
2024-12-08 17:13:24,86,4674,41,45,2618.83,5211.01,0.00
2024-12-08 17:13:24,85,4674,40,45,2647.20,5211.05,0.00
2024-12-08 17:13:24,84,4674,39,45,2655.21,5211.26,0.00
2024-12-08 17:13:24,84,4675,39,45,2728.85,5212.00,0.00
2024-12-08 17:13:24,85,4675,40,45,2696.75,5212.01,0.00
2024-12-08 17:13:24,84,4675,40,44,2718.33,5212.12,0.00
2024-12-08 17:13:24,84,4676,40,44,2722.55,5213.00,0.00
2024-12-08 17:13:24,85,4676,40,45,2690.52,5213.01,0.00
2024-12-08 17:13:24,84,4676,39,45,2718.23,5213.10,0.00
2024-12-08 17:13:24,83,4676,38,45,2716.59,5213.51,0.00
2024-12-08 17:13:24,83,4677,38,45,2741.43,5214.00,0.00
2024-12-08 17:13:24,84,4677,38,46,2708.80,5214.01,0.00
2024-12-08 17:13:24,83,4677,38,45,2732.03,5214.11,0.00
2024-12-08 17:13:24,83,4678,38,45,2736.30,5215.00,0.00
2024-12-08 17:13:24,84,4678,39,45,2703.73,5215.01,0.00
2024-12-08 17:13:24,83,4678,38,45,2709.37,5215.28,0.00
2024-12-08 17:13:24,83,4679,38,45,2722.37,5216.00,0.00
2024-12-08 17:13:24,84,4679,38,46,2689.97,5216.01,0.00
2024-12-08 17:13:24,83,4679,38,45,2713.60,5216.11,0.00
2024-12-08 17:13:24,83,4680,38,45,2717.87,5217.00,0.00
2024-12-08 17:13:24,84,4680,39,45,2685.51,5217.01,0.00
2024-12-08 17:13:24,84,4681,39,45,2671.74,5218.00,0.00
2024-12-08 17:13:24,85,4681,40,45,2640.31,5218.01,0.00
2024-12-08 17:13:24,86,4680,40,46,2568.54,5218.59,0.00
2024-12-08 17:13:24,86,4681,40,46,2616.78,5219.00,0.00
2024-12-08 17:13:24,87,4681,40,47,2586.70,5219.01,0.00
2024-12-08 17:13:24,88,4680,40,48,2523.63,5219.46,0.00
2024-12-08 17:13:24,87,4680,39,48,2589.86,5219.51,0.00
2024-12-08 17:13:24,87,4681,39,48,2672.40,5220.00,0.00
2024-12-08 17:13:24,88,4681,39,49,2642.03,5220.01,0.00
2024-12-08 17:13:25,88,4682,39,49,2685.85,5221.00,0.00
2024-12-08 17:13:25,89,4682,39,50,2655.67,5221.01,0.00
2024-12-08 17:13:25,88,4682,39,49,2674.60,5221.11,0.00
2024-12-08 17:13:25,88,4683,39,49,2676.27,5222.00,0.00
2024-12-08 17:13:25,89,4683,39,50,2646.20,5222.01,0.00
2024-12-08 17:13:25,88,4683,39,49,2658.49,5222.11,0.00
2024-12-08 17:13:25,88,4684,39,49,2660.17,5223.00,0.00
2024-12-08 17:13:25,89,4684,39,50,2630.28,5223.01,0.00
2024-12-08 17:13:25,88,4684,39,49,2642.38,5223.11,0.00
2024-12-08 17:13:25,87,4684,38,49,2662.01,5223.31,0.00
2024-12-08 17:13:25,87,4685,38,49,2674.45,5224.00,0.00
2024-12-08 17:13:25,88,4685,38,50,2644.06,5224.01,0.00
2024-12-08 17:13:25,87,4685,37,50,2617.75,5224.81,0.00
2024-12-08 17:13:25,87,4686,37,50,2667.75,5225.00,0.00
2024-12-08 17:13:25,88,4686,37,51,2637.44,5225.01,0.00
2024-12-08 17:13:25,87,4686,37,50,2661.77,5225.12,0.00
2024-12-08 17:13:25,86,4686,36,50,2683.05,5225.30,0.00
2024-12-08 17:13:25,86,4687,36,50,2695.64,5226.00,0.00
2024-12-08 17:13:25,87,4687,36,51,2664.66,5226.01,0.00
2024-12-08 17:13:25,86,4687,35,51,2677.43,5226.12,0.00
2024-12-08 17:13:25,86,4688,35,51,2680.36,5227.00,0.00
2024-12-08 17:13:25,87,4688,36,51,2649.55,5227.01,0.00
2024-12-08 17:13:25,86,4688,35,51,2677.94,5227.05,0.00
2024-12-08 17:13:25,85,4688,35,50,2705.76,5227.11,0.00
2024-12-08 17:13:25,84,4688,34,50,2719.31,5227.16,0.00
2024-12-08 17:13:25,84,4689,34,50,2737.85,5228.00,0.00
2024-12-08 17:13:25,85,4689,35,50,2705.64,5228.01,0.00
2024-12-08 17:13:25,84,4689,34,50,2735.37,5228.05,0.00
2024-12-08 17:13:25,83,4689,34,49,2765.19,5228.10,0.00
2024-12-08 17:13:25,82,4689,33,49,2778.66,5228.49,0.00
2024-12-08 17:13:25,81,4689,32,49,2800.85,5228.73,0.00
2024-12-08 17:13:25,81,4690,32,49,2838.51,5229.00,0.00
2024-12-08 17:13:25,82,4690,32,50,2803.89,5229.01,0.00
2024-12-08 17:13:25,81,4690,31,50,2835.94,5229.05,0.00
2024-12-08 17:13:25,80,4690,31,49,2855.70,5229.09,0.00
2024-12-08 17:13:25,80,4691,31,49,2860.81,5230.00,0.00
2024-12-08 17:13:25,81,4691,32,49,2825.49,5230.01,0.00
2024-12-08 17:13:25,81,4692,32,49,2813.11,5231.00,0.00
2024-12-08 17:13:25,82,4692,33,49,2778.81,5231.01,0.00
2024-12-08 17:13:25,81,4692,33,48,2810.54,5231.05,0.00
2024-12-08 17:13:25,80,4692,33,47,2843.72,5231.08,0.00
2024-12-08 17:13:25,80,4693,33,47,2848.17,5232.00,0.00
2024-12-08 17:13:25,81,4693,33,48,2813.01,5232.01,0.00
2024-12-08 17:13:25,80,4693,33,47,2818.75,5232.08,0.00
2024-12-08 17:13:25,80,4694,33,47,2836.29,5233.00,0.00
2024-12-08 17:13:25,81,4694,34,47,2801.27,5233.01,0.00
2024-12-08 17:13:25,80,4694,33,47,2833.68,5233.05,0.00
2024-12-08 17:13:25,79,4694,33,46,2854.98,5233.06,0.00
2024-12-08 17:13:25,79,4695,33,46,2859.49,5234.00,0.00
2024-12-08 17:13:25,80,4695,33,47,2823.74,5234.01,0.00
2024-12-08 17:13:25,79,4695,32,47,2821.89,5234.48,0.00
2024-12-08 17:13:25,79,4696,32,47,2861.36,5235.00,0.00
2024-12-08 17:13:25,80,4696,32,48,2825.59,5235.01,0.00
2024-12-08 17:13:25,79,4696,32,47,2857.39,5235.06,0.00
2024-12-08 17:13:25,79,4697,32,47,2861.90,5236.00,0.00
2024-12-08 17:13:25,80,4697,32,48,2826.13,5236.01,0.00
2024-12-08 17:13:25,81,4696,33,48,2791.24,5236.04,0.00
2024-12-08 17:13:25,80,4696,32,48,2876.54,5236.05,0.00
2024-12-08 17:13:25,80,4697,32,48,2879.69,5237.00,0.00
2024-12-08 17:13:25,81,4697,32,49,2844.14,5237.01,0.00
2024-12-08 17:13:25,80,4697,32,48,2876.44,5237.06,0.00
2024-12-08 17:13:25,79,4697,31,48,2878.42,5237.23,0.00
2024-12-08 17:13:26,79,4698,31,48,2971.07,5238.00,0.00
2024-12-08 17:13:26,80,4698,32,48,2933.93,5238.01,0.00
2024-12-08 17:13:26,79,4698,32,47,2967.78,5238.06,0.00
2024-12-08 17:13:26,78,4698,31,47,3001.80,5238.09,0.00
2024-12-08 17:13:26,77,4698,30,47,3009.12,5238.70,0.00
2024-12-08 17:13:26,77,4699,30,47,3061.75,5239.00,0.00
2024-12-08 17:13:26,78,4699,31,47,3022.50,5239.01,0.00
2024-12-08 17:13:26,77,4699,31,46,3044.76,5239.07,0.00
2024-12-08 17:13:26,77,4700,31,46,3050.77,5240.00,0.00
2024-12-08 17:13:26,78,4700,32,46,3011.66,5240.01,0.00
2024-12-08 17:13:26,79,4699,33,46,2906.28,5240.82,0.00
2024-12-08 17:13:26,79,4700,33,46,2972.11,5241.00,0.00
2024-12-08 17:13:26,80,4700,33,47,2934.96,5241.01,0.00
2024-12-08 17:13:26,79,4700,33,46,2967.49,5241.08,0.00
2024-12-08 17:13:26,79,4701,33,46,3039.03,5242.00,0.00
2024-12-08 17:13:26,80,4701,33,47,3001.04,5242.01,0.00
2024-12-08 17:13:26,79,4701,32,47,3031.76,5242.09,0.00
2024-12-08 17:13:26,79,4702,32,47,3037.62,5243.00,0.00
2024-12-08 17:13:26,80,4702,32,48,2999.65,5243.01,0.00
2024-12-08 17:13:26,79,4702,32,47,3030.34,5243.09,0.00
2024-12-08 17:13:26,78,4702,31,47,3058.46,5243.14,0.00
2024-12-08 17:13:26,78,4703,31,47,3081.19,5244.00,0.00
2024-12-08 17:13:26,79,4703,32,47,3042.18,5244.01,0.00
2024-12-08 17:13:26,79,4704,32,47,3030.81,5245.00,0.00
2024-12-08 17:13:26,80,4704,33,47,2992.93,5245.01,0.00
2024-12-08 17:13:26,79,4704,33,46,3024.19,5245.09,0.00
2024-12-08 17:13:26,80,4703,34,46,2969.48,5245.44,0.00
2024-12-08 17:13:26,80,4704,34,46,3021.04,5246.00,0.00
2024-12-08 17:13:26,81,4704,34,47,2983.74,5246.01,0.00
2024-12-08 17:13:26,81,4705,34,47,3036.13,5247.00,0.00
2024-12-08 17:13:26,82,4705,35,47,2999.11,5247.01,0.00
2024-12-08 17:13:26,81,4705,35,46,3029.67,5247.09,0.00
2024-12-08 17:13:26,81,4706,35,46,3034.12,5248.00,0.00
2024-12-08 17:13:26,82,4706,35,47,2997.12,5248.01,0.00
2024-12-08 17:13:26,81,4706,34,47,2984.57,5248.72,0.00
2024-12-08 17:13:26,81,4707,34,47,3021.74,5249.00,0.00
2024-12-08 17:13:26,82,4707,35,47,2984.89,5249.01,0.00
2024-12-08 17:13:26,81,4707,35,46,3015.92,5249.09,0.00
2024-12-08 17:13:26,81,4708,35,46,3020.37,5250.00,0.00
2024-12-08 17:13:26,82,4708,36,46,2983.54,5250.01,0.00
2024-12-08 17:13:26,83,4707,37,46,2947.59,5250.04,0.00
2024-12-08 17:13:26,84,4706,38,46,2920.64,5250.06,0.00
2024-12-08 17:13:26,83,4706,38,45,3004.54,5250.07,0.00
2024-12-08 17:13:26,83,4707,38,45,3006.99,5251.00,0.00
2024-12-08 17:13:26,84,4707,38,46,2971.19,5251.01,0.00
2024-12-08 17:13:26,83,4707,37,46,2999.43,5251.08,0.00
2024-12-08 17:13:26,84,4706,38,46,2928.28,5251.55,0.00
2024-12-08 17:13:27,84,4707,38,46,3112.43,5252.00,0.00
2024-12-08 17:13:27,85,4707,38,47,3075.82,5252.01,0.00
2024-12-08 17:13:27,84,4707,37,47,3103.09,5252.10,0.00
2024-12-08 17:13:27,83,4707,37,46,3133.52,5252.11,0.00
2024-12-08 17:13:27,83,4708,37,46,3213.82,5253.00,0.00
2024-12-08 17:13:27,84,4708,38,46,3175.56,5253.01,0.00
2024-12-08 17:13:27,84,4709,38,46,3161.78,5254.00,0.00
2024-12-08 17:13:27,85,4709,39,46,3124.58,5254.01,0.00
2024-12-08 17:13:27,85,4710,39,46,3110.34,5255.00,0.00
2024-12-08 17:13:27,86,4710,40,46,3074.17,5255.01,0.00
2024-12-08 17:13:28,86,4711,40,46,3059.48,5256.00,0.00
2024-12-08 17:13:28,87,4711,41,46,3024.31,5256.01,0.00
2024-12-08 17:13:28,86,4711,41,45,3051.57,5256.13,0.00
2024-12-08 17:13:28,86,4712,41,45,3055.17,5257.00,0.00
2024-12-08 17:13:28,87,4712,41,46,3020.06,5257.01,0.00
2024-12-08 17:13:28,86,4712,40,46,3045.43,5257.12,0.00
2024-12-08 17:13:28,86,4713,40,46,3048.42,5258.00,0.00
2024-12-08 17:13:28,87,4713,41,46,3013.38,5258.01,0.00
2024-12-08 17:13:28,86,4713,41,45,3026.44,5258.12,0.00
2024-12-08 17:13:29,86,4714,41,45,3041.66,5259.00,0.00
2024-12-08 17:13:29,87,4714,41,46,3006.70,5259.01,0.00
2024-12-08 17:13:29,86,4714,41,45,3039.84,5259.04,0.00
2024-12-08 17:13:29,85,4714,40,45,3074.99,5259.04,0.00
2024-12-08 17:13:29,84,4714,39,45,3077.26,5259.33,0.00
2024-12-08 17:13:30,84,4715,39,45,3105.28,5260.00,0.00
2024-12-08 17:13:30,85,4715,40,45,3068.74,5260.01,0.00
2024-12-08 17:13:30,84,4715,39,45,3101.55,5260.07,0.00
2024-12-08 17:13:30,83,4715,39,44,3134.49,5260.08,0.00
2024-12-08 17:13:34,83,4716,39,44,3137.58,5261.00,0.00
2024-12-08 17:13:34,84,4716,39,45,3100.23,5261.01,0.00
2024-12-08 17:13:35,84,4717,39,45,3086.41,5262.00,0.00
2024-12-08 17:13:35,85,4717,40,45,3050.10,5262.01,0.00
2024-12-08 17:13:35,84,4717,40,44,3079.55,5262.08,0.00
2024-12-08 17:13:35,84,4718,40,44,3081.99,5263.00,0.00
2024-12-08 17:13:35,85,4718,41,44,3045.73,5263.01,0.00
2024-12-08 17:13:35,84,4718,40,44,3074.50,5263.08,0.00
2024-12-08 17:13:35,84,4719,40,44,3076.93,5264.00,0.00
2024-12-08 17:13:35,85,4719,40,45,3040.73,5264.01,0.00
2024-12-08 17:13:35,84,4719,40,44,3069.44,5264.08,0.00
2024-12-08 17:13:35,85,4718,41,44,3017.35,5264.41,0.00
2024-12-08 17:13:35,85,4719,41,44,3063.61,5265.00,0.00
2024-12-08 17:13:35,86,4719,42,44,3027.99,5265.01,0.00
2024-12-08 17:13:35,85,4719,41,44,3061.77,5265.04,0.00
2024-12-08 17:13:35,86,4718,42,44,3006.01,5265.21,0.00
2024-12-08 17:13:36,86,4719,42,44,3086.73,5266.00,0.00
2024-12-08 17:13:36,87,4719,42,45,3051.25,5266.01,0.00
2024-12-08 17:13:36,86,4719,42,44,3080.64,5266.07,0.00
2024-12-08 17:13:36,86,4720,42,44,3142.44,5267.00,0.00
2024-12-08 17:13:36,87,4720,42,45,3106.32,5267.01,0.00
2024-12-08 17:13:36,87,4721,42,45,3091.16,5268.00,0.00
2024-12-08 17:13:36,88,4721,42,46,3056.04,5268.01,0.00
2024-12-08 17:13:36,87,4721,42,45,3084.53,5268.08,0.00
2024-12-08 17:13:36,87,4722,42,45,3085.09,5269.00,0.00
2024-12-08 17:13:36,88,4722,42,46,3050.03,5269.01,0.00
2024-12-08 17:13:36,88,4723,42,46,3034.44,5270.00,0.00
2024-12-08 17:13:36,89,4723,43,46,3000.35,5270.01,0.00
2024-12-08 17:13:36,88,4723,43,45,3026.69,5270.09,0.00
2024-12-08 17:13:36,87,4723,42,45,3019.37,5270.69,0.00
2024-12-08 17:13:36,87,4724,42,45,3063.84,5271.00,0.00
2024-12-08 17:13:36,88,4724,42,46,3029.03,5271.01,0.00
2024-12-08 17:13:36,89,4723,42,47,2964.92,5271.38,0.00
2024-12-08 17:13:36,89,4724,42,47,3009.19,5272.00,0.00
2024-12-08 17:13:36,90,4724,42,48,2975.75,5272.01,0.00
2024-12-08 17:13:36,89,4724,42,47,3002.11,5272.09,0.00
2024-12-08 17:13:36,89,4725,42,47,3061.30,5273.00,0.00
2024-12-08 17:13:36,90,4725,43,47,3027.29,5273.01,0.00
2024-12-08 17:13:36,91,4724,43,48,2965.17,5273.36,0.00
2024-12-08 17:13:36,91,4725,43,48,2978.94,5274.00,0.00
2024-12-08 17:13:36,92,4725,44,48,2946.56,5274.01,0.00
2024-12-08 17:13:37,91,4725,44,47,2972.59,5274.09,0.00
2024-12-08 17:13:37,91,4726,44,47,3029.36,5275.00,0.00
2024-12-08 17:13:37,92,4726,45,47,2996.43,5275.01,0.00
2024-12-08 17:13:37,93,4725,46,47,2903.86,5275.75,0.00
2024-12-08 17:13:37,94,4724,46,48,2894.87,5275.77,0.00
2024-12-08 17:13:37,94,4725,46,48,2948.95,5276.00,0.00
2024-12-08 17:13:37,95,4725,47,48,2917.91,5276.01,0.00
2024-12-08 17:13:37,94,4725,47,47,2941.12,5276.11,0.00
2024-12-08 17:13:37,93,4725,46,47,2965.97,5276.24,0.00
2024-12-08 17:13:37,93,4726,46,47,3085.06,5277.00,0.00
2024-12-08 17:13:37,94,4726,47,47,3052.24,5277.01,0.00
2024-12-08 17:13:37,93,4726,46,47,3082.81,5277.04,0.00
2024-12-08 17:13:37,93,4727,46,47,3066.91,5278.00,0.00
2024-12-08 17:13:37,94,4727,46,48,3034.29,5278.01,0.00
2024-12-08 17:13:37,93,4727,45,48,3062.96,5278.08,0.00
2024-12-08 17:13:37,93,4728,45,48,3048.76,5279.00,0.00
2024-12-08 17:13:37,94,4728,45,49,3016.33,5279.01,0.00
2024-12-08 17:13:37,93,4728,44,49,3013.76,5279.46,0.00
2024-12-08 17:13:37,93,4729,44,49,3031.17,5280.00,0.00
2024-12-08 17:13:37,94,4729,45,49,2998.93,5280.01,0.00
2024-12-08 17:13:37,95,4728,46,49,2929.21,5280.55,0.00
2024-12-08 17:13:37,95,4729,46,49,2991.25,5281.00,0.00
2024-12-08 17:13:37,96,4729,47,49,2960.09,5281.01,0.00
2024-12-08 17:13:37,95,4729,47,48,2984.61,5281.08,0.00
2024-12-08 17:13:37,94,4729,46,48,2996.85,5281.46,0.00
2024-12-08 17:13:37,94,4730,46,48,3069.73,5282.00,0.00
2024-12-08 17:13:37,95,4730,47,48,3037.41,5282.01,0.00
2024-12-08 17:13:37,94,4730,47,47,3067.50,5282.04,0.00
2024-12-08 17:13:37,94,4731,47,47,3051.20,5283.00,0.00
2024-12-08 17:13:37,95,4731,48,47,3019.08,5283.01,0.00
2024-12-08 17:13:37,94,4731,48,46,3046.73,5283.09,0.00
2024-12-08 17:13:38,94,4732,48,46,3043.91,5284.00,0.00
2024-12-08 17:13:38,95,4732,48,47,3011.86,5284.01,0.00
2024-12-08 17:13:38,94,4732,48,46,3028.19,5284.09,0.00
2024-12-08 17:13:38,93,4732,47,46,3046.63,5284.30,0.00
2024-12-08 17:13:38,93,4732,47,46,3066.99,5285.00,0.00
2024-12-08 17:13:38,94,4732,47,47,3034.36,5285.01,0.00
2024-12-08 17:13:38,93,4732,47,46,3051.10,5285.09,0.00
2024-12-08 17:13:38,93,4733,47,46,3048.81,5286.00,0.00
2024-12-08 17:13:38,94,4733,47,47,3016.38,5286.01,0.00
2024-12-08 17:13:38,93,4733,47,46,3032.92,5286.09,0.00
2024-12-08 17:13:38,94,4732,48,46,2994.50,5286.22,0.00
2024-12-08 17:13:38,94,4733,48,46,3034.25,5287.00,0.00
2024-12-08 17:13:38,95,4733,49,46,3002.31,5287.01,0.00
2024-12-08 17:13:38,95,4734,49,46,3037.22,5288.00,0.00
2024-12-08 17:13:38,96,4734,50,46,3005.58,5288.01,0.00
2024-12-08 17:13:38,95,4734,50,45,3030.01,5288.11,0.00
2024-12-08 17:13:38,95,4735,50,45,3024.35,5289.00,0.00
2024-12-08 17:13:38,96,4735,50,46,2992.84,5289.01,0.00
2024-12-08 17:13:38,96,4736,50,46,2974.12,5290.00,0.00
2024-12-08 17:13:38,97,4736,50,47,2943.46,5290.01,0.00
2024-12-08 17:13:38,96,4736,49,47,2969.46,5290.08,0.00
2024-12-08 17:13:38,95,4736,49,46,2997.38,5290.11,0.00
2024-12-08 17:13:38,94,4736,48,46,3010.86,5290.46,0.00
2024-12-08 17:13:38,94,4737,48,46,3027.47,5291.00,0.00
2024-12-08 17:13:38,95,4737,48,47,2995.60,5291.01,0.00
2024-12-08 17:13:38,94,4737,47,47,3025.23,5291.04,0.00
2024-12-08 17:13:38,93,4737,46,47,3055.74,5291.08,0.00
2024-12-08 17:13:38,94,4736,46,48,3009.17,5291.15,0.00
2024-12-08 17:13:38,95,4735,47,48,2972.67,5291.54,0.00
2024-12-08 17:13:38,95,4736,47,48,3024.27,5292.00,0.00
2024-12-08 17:13:38,96,4736,47,49,2992.76,5292.01,0.00
2024-12-08 17:13:38,95,4736,46,49,3020.38,5292.07,0.00
2024-12-08 17:13:38,94,4736,46,48,3050.83,5292.08,0.00
2024-12-08 17:13:38,94,4737,46,48,3160.06,5293.00,0.00
2024-12-08 17:13:38,95,4737,47,48,3126.80,5293.01,0.00
2024-12-08 17:13:38,95,4738,47,48,3108.44,5294.00,0.00
2024-12-08 17:13:38,96,4738,47,49,3076.06,5294.01,0.00
2024-12-08 17:13:38,95,4738,46,49,3106.23,5294.04,0.00
2024-12-08 17:13:38,94,4738,46,48,3136.46,5294.06,0.00
2024-12-08 17:13:39,94,4739,46,48,3132.53,5295.00,0.00
2024-12-08 17:13:39,95,4739,47,48,3099.55,5295.01,0.00
2024-12-08 17:13:39,96,4738,48,48,3066.17,5295.05,0.00
2024-12-08 17:13:39,96,4739,48,48,3091.01,5296.00,0.00
2024-12-08 17:13:39,97,4739,48,49,3059.15,5296.01,0.00
2024-12-08 17:13:39,96,4739,48,48,3086.08,5296.07,0.00
2024-12-08 17:13:39,96,4740,48,48,3136.06,5297.00,0.00
2024-12-08 17:13:39,97,4740,49,48,3103.73,5297.01,0.00
2024-12-08 17:13:39,98,4739,50,48,3017.24,5297.66,0.00
2024-12-08 17:13:39,98,4740,50,48,3067.12,5298.00,0.00
2024-12-08 17:13:39,99,4740,50,49,3036.14,5298.01,0.00
2024-12-08 17:13:39,98,4740,50,48,3065.02,5298.04,0.00
2024-12-08 17:13:39,98,4741,50,48,3101.26,5299.00,0.00
2024-12-08 17:13:39,99,4741,50,49,3069.94,5299.01,0.00
2024-12-08 17:13:39,99,4742,50,49,3050.18,5300.00,0.00
2024-12-08 17:13:39,100,4742,50,50,3019.67,5300.01,0.00
2024-12-08 17:13:39,100,4743,50,50,2999.57,5301.00,0.00
2024-12-08 17:13:39,101,4743,50,51,2969.87,5301.01,0.00
2024-12-08 17:13:39,100,4743,50,50,2991.11,5301.06,0.00
2024-12-08 17:13:39,100,4744,50,50,2982.01,5302.00,0.00
2024-12-08 17:13:39,101,4744,50,51,2952.48,5302.01,0.00
2024-12-08 17:13:39,100,4744,49,51,2979.91,5302.04,0.00
2024-12-08 17:13:39,99,4744,49,50,2999.84,5302.05,0.00
2024-12-08 17:13:39,99,4745,49,50,2990.27,5303.00,0.00
2024-12-08 17:13:39,100,4745,49,51,2960.37,5303.01,0.00
2024-12-08 17:13:39,100,4746,49,51,2940.24,5304.00,0.00
2024-12-08 17:13:39,101,4746,49,52,2911.13,5304.01,0.00
2024-12-08 17:13:39,101,4747,49,52,2890.67,5305.00,0.00
2024-12-08 17:13:39,102,4747,49,53,2862.33,5305.01,0.00
2024-12-08 17:13:39,103,4746,50,53,2815.02,5305.20,0.00
2024-12-08 17:13:39,102,4746,49,53,2874.38,5305.27,0.00
2024-12-08 17:13:39,102,4747,49,53,2877.95,5306.00,0.00
2024-12-08 17:13:39,103,4747,49,54,2850.01,5306.01,0.00
2024-12-08 17:13:39,104,4746,50,54,2822.60,5306.03,0.00
2024-12-08 17:13:39,103,4746,50,53,2866.01,5306.06,0.00
2024-12-08 17:13:39,104,4745,50,54,2838.45,5306.08,0.00
2024-12-08 17:13:40,103,4745,49,54,2835.43,5306.77,0.00
2024-12-08 17:13:40,103,4746,49,54,2926.29,5307.00,0.00
2024-12-08 17:13:40,104,4746,49,55,2898.15,5307.01,0.00
2024-12-08 17:13:40,103,4746,49,54,2915.50,5307.06,0.00
2024-12-08 17:13:40,102,4746,48,54,2907.47,5307.75,0.00
2024-12-08 17:13:40,102,4747,48,54,3039.84,5308.00,0.00
2024-12-08 17:13:40,103,4747,49,54,3010.32,5308.01,0.00
2024-12-08 17:13:40,102,4747,49,53,3028.95,5308.06,0.00
2024-12-08 17:13:40,102,4748,49,53,3021.15,5309.00,0.00
2024-12-08 17:13:40,103,4748,49,54,2991.82,5309.01,0.00
2024-12-08 17:13:40,102,4748,49,53,3010.26,5309.06,0.00
2024-12-08 17:13:40,101,4748,48,53,3016.01,5309.40,0.00
2024-12-08 17:13:40,101,4749,48,53,3035.87,5310.00,0.00
2024-12-08 17:13:40,102,4749,49,53,3006.10,5310.01,0.00
2024-12-08 17:13:40,101,4749,49,52,3024.86,5310.06,0.00
2024-12-08 17:13:40,101,4750,49,52,3015.97,5311.00,0.00
2024-12-08 17:13:40,102,4750,50,52,2986.41,5311.01,0.00
2024-12-08 17:13:40,101,4750,49,52,3001.81,5311.08,0.00
2024-12-08 17:13:40,101,4751,49,52,2995.50,5312.00,0.00
2024-12-08 17:13:40,102,4751,50,52,2966.14,5312.01,0.00
2024-12-08 17:13:40,101,4751,50,51,2988.18,5312.06,0.00
2024-12-08 17:13:40,100,4751,49,51,3006.44,5312.28,0.00
2024-12-08 17:13:40,100,4752,49,51,3011.15,5313.00,0.00
2024-12-08 17:13:40,101,4752,50,51,2981.34,5313.01,0.00
2024-12-08 17:13:40,100,4752,50,50,2999.50,5313.06,0.00
2024-12-08 17:13:40,99,4752,49,50,3019.60,5313.06,0.00
2024-12-08 17:13:40,99,4753,49,50,3023.89,5314.00,0.00
2024-12-08 17:13:40,100,4753,49,51,2993.65,5314.01,0.00
2024-12-08 17:13:40,99,4753,49,50,3011.04,5314.06,0.00
2024-12-08 17:13:40,98,4753,48,50,3000.91,5314.80,0.00
2024-12-08 17:13:40,98,4754,48,50,3044.48,5315.00,0.00
2024-12-08 17:13:40,99,4754,49,50,3013.72,5315.01,0.00
2024-12-08 17:13:40,98,4754,49,49,3030.41,5315.07,0.00
2024-12-08 17:13:40,97,4754,48,49,3033.30,5315.44,0.00
2024-12-08 17:13:40,97,4755,48,49,3058.90,5316.00,0.00
2024-12-08 17:13:40,98,4755,48,50,3027.69,5316.01,0.00
2024-12-08 17:13:40,97,4755,48,49,3044.69,5316.07,0.00
2024-12-08 17:13:40,97,4756,48,49,3039.74,5317.00,0.00
2024-12-08 17:13:40,98,4756,48,50,3008.73,5317.01,0.00
2024-12-08 17:13:40,99,4755,49,50,2954.26,5317.28,0.00
2024-12-08 17:13:40,100,4754,50,50,2904.34,5317.90,0.00
2024-12-08 17:13:40,100,4755,50,50,2957.62,5318.00,0.00
2024-12-08 17:13:40,101,4755,51,50,2928.33,5318.01,0.00
2024-12-08 17:13:40,102,4754,52,50,2866.86,5318.26,0.00
2024-12-08 17:13:40,101,4754,51,50,2925.39,5318.53,0.00
2024-12-08 17:13:40,102,4753,51,51,2881.77,5318.82,0.00
2024-12-08 17:13:41,102,4754,51,51,3035.75,5319.00,0.00
2024-12-08 17:13:41,103,4754,52,51,3006.28,5319.01,0.00
2024-12-08 17:13:41,103,4755,52,51,3088.45,5320.00,0.00
2024-12-08 17:13:41,104,4755,52,52,3058.75,5320.01,0.00
2024-12-08 17:13:41,103,4755,51,52,3072.47,5320.11,0.00
2024-12-08 17:13:41,103,4756,51,52,3066.82,5321.00,0.00
2024-12-08 17:13:41,104,4756,51,53,3037.33,5321.01,0.00
2024-12-08 17:13:41,103,4756,51,52,3061.16,5321.07,0.00
2024-12-08 17:13:41,103,4757,51,52,3053.44,5322.00,0.00
2024-12-08 17:13:41,104,4757,52,52,3024.08,5322.01,0.00
2024-12-08 17:13:41,103,4757,52,51,3041.59,5322.08,0.00
2024-12-08 17:13:41,103,4758,52,51,3034.18,5323.00,0.00
2024-12-08 17:13:41,104,4758,53,51,3005.01,5323.01,0.00
2024-12-08 17:13:41,103,4758,53,50,3020.26,5323.09,0.00
2024-12-08 17:13:41,102,4758,52,50,3040.03,5323.27,0.00
2024-12-08 17:13:41,102,4759,52,50,3041.23,5324.00,0.00
2024-12-08 17:13:41,103,4759,53,50,3011.70,5324.01,0.00
2024-12-08 17:13:41,102,4759,53,49,3027.16,5324.09,0.00
2024-12-08 17:13:41,103,4758,54,49,2967.58,5324.66,0.00
2024-12-08 17:13:41,103,4759,54,49,3005.61,5325.00,0.00
2024-12-08 17:13:41,104,4759,54,50,2976.71,5325.01,0.00
2024-12-08 17:13:41,103,4759,54,49,2991.68,5325.09,0.00
2024-12-08 17:13:41,103,4760,54,49,3034.57,5326.00,0.00
2024-12-08 17:13:41,104,4760,54,50,3005.39,5326.01,0.00
2024-12-08 17:13:41,103,4760,54,49,3018.57,5326.11,0.00
2024-12-08 17:13:41,103,4761,54,49,3009.89,5327.00,0.00
2024-12-08 17:13:41,104,4761,55,49,2980.94,5327.01,0.00
2024-12-08 17:13:41,105,4760,55,50,2918.05,5327.46,0.00
2024-12-08 17:13:41,105,4761,55,50,2963.22,5328.00,0.00
2024-12-08 17:13:41,106,4761,55,51,2935.27,5328.01,0.00
2024-12-08 17:13:41,107,4760,55,52,2905.86,5328.07,0.00
2024-12-08 17:13:41,106,4760,55,51,2940.83,5328.11,0.00
2024-12-08 17:13:41,105,4760,54,51,2945.51,5328.51,0.00
2024-12-08 17:13:41,105,4761,54,51,3004.73,5329.00,0.00
2024-12-08 17:13:41,106,4761,54,52,2976.39,5329.01,0.00
2024-12-08 17:13:41,107,4760,54,53,2942.13,5329.15,0.00
2024-12-08 17:13:41,107,4761,54,53,3018.24,5330.00,0.00
2024-12-08 17:13:41,108,4761,54,54,2990.29,5330.01,0.00
2024-12-08 17:13:41,107,4761,53,54,3012.79,5330.10,0.00
2024-12-08 17:13:41,106,4761,52,54,3022.15,5330.19,0.00
2024-12-08 17:13:41,106,4762,52,54,3070.59,5331.00,0.00
2024-12-08 17:13:41,107,4762,53,54,3041.89,5331.01,0.00
2024-12-08 17:13:41,106,4762,52,54,3068.59,5331.04,0.00
2024-12-08 17:13:41,107,4761,53,54,2974.83,5331.69,0.00
2024-12-08 17:13:42,107,4762,53,54,3020.44,5332.00,0.00
2024-12-08 17:13:42,108,4762,53,55,2992.47,5332.01,0.00
2024-12-08 17:13:42,107,4762,53,54,3007.55,5332.18,0.00
2024-12-08 17:13:42,107,4763,53,54,3041.58,5333.00,0.00
2024-12-08 17:13:42,108,4763,53,55,3013.42,5333.01,0.00
2024-12-08 17:13:42,107,4763,52,55,3039.11,5333.05,0.00
2024-12-08 17:13:42,106,4763,52,54,3017.02,5333.59,0.00
2024-12-08 17:13:42,106,4764,52,54,3035.46,5334.00,0.00
2024-12-08 17:13:42,107,4764,53,54,3007.09,5334.01,0.00
2024-12-08 17:13:42,106,4764,53,53,3022.95,5334.17,0.00
2024-12-08 17:13:42,105,4764,52,53,3045.68,5334.29,0.00
2024-12-08 17:13:42,105,4765,52,53,3043.42,5335.00,0.00
2024-12-08 17:13:42,106,4765,52,54,3014.71,5335.01,0.00
2024-12-08 17:13:42,107,4764,53,54,2986.53,5335.03,0.00
2024-12-08 17:13:42,106,4764,52,54,3016.29,5335.18,0.00
2024-12-08 17:13:42,105,4764,51,54,3027.78,5335.31,0.00
2024-12-08 17:13:42,104,4764,51,53,3040.67,5335.56,0.00
2024-12-08 17:13:42,104,4765,51,53,3068.72,5336.00,0.00
2024-12-08 17:13:42,105,4765,51,54,3039.49,5336.01,0.00
2024-12-08 17:13:42,104,4765,50,54,3066.18,5336.05,0.00
2024-12-08 17:13:42,103,4765,49,54,3093.87,5336.05,0.00
2024-12-08 17:13:42,102,4765,49,53,3113.79,5336.16,0.00
2024-12-08 17:13:42,102,4766,49,53,3173.95,5337.00,0.00
2024-12-08 17:13:42,103,4766,50,53,3143.13,5337.01,0.00
2024-12-08 17:13:42,102,4766,49,53,3160.94,5337.17,0.00
2024-12-08 17:13:42,103,4765,50,53,3103.14,5337.49,0.00
2024-12-08 17:13:42,103,4766,50,53,3159.51,5338.00,0.00
2024-12-08 17:13:42,104,4766,51,53,3129.13,5338.01,0.00
2024-12-08 17:13:42,103,4766,51,52,3146.10,5338.18,0.00
2024-12-08 17:13:42,104,4765,52,52,3102.99,5338.42,0.00
2024-12-08 17:13:42,104,4766,52,52,3188.64,5339.00,0.00
2024-12-08 17:13:42,105,4766,53,52,3158.27,5339.01,0.00
2024-12-08 17:13:42,106,4765,53,53,3122.48,5339.14,0.00
2024-12-08 17:13:42,106,4766,53,53,3168.10,5340.00,0.00
2024-12-08 17:13:42,107,4766,53,54,3138.49,5340.01,0.00
2024-12-08 17:13:42,106,4766,53,53,3155.57,5340.17,0.00
2024-12-08 17:13:42,105,4766,52,53,3178.55,5340.30,0.00
2024-12-08 17:13:42,105,4767,52,53,3232.95,5341.00,0.00
2024-12-08 17:13:42,106,4767,53,53,3202.45,5341.01,0.00
2024-12-08 17:13:42,106,4768,53,53,3180.37,5342.00,0.00
2024-12-08 17:13:42,107,4768,54,53,3150.65,5342.01,0.00
2024-12-08 17:13:42,106,4768,54,52,3167.27,5342.18,0.00
2024-12-08 17:13:42,107,4767,55,52,3118.87,5342.55,0.00
2024-12-08 17:13:42,108,4766,55,53,3100.89,5342.58,0.00
2024-12-08 17:13:43,108,4767,55,53,3134.36,5343.00,0.00
2024-12-08 17:13:43,109,4767,56,53,3105.61,5343.01,0.00
2024-12-08 17:13:43,109,4768,56,53,3179.79,5344.00,0.00
2024-12-08 17:13:43,110,4768,56,54,3150.88,5344.01,0.00
2024-12-08 17:13:43,111,4767,56,55,3119.15,5344.09,0.00
2024-12-08 17:13:43,110,4767,55,55,3188.84,5344.16,0.00
2024-12-08 17:13:43,109,4767,55,54,3213.19,5344.17,0.00
2024-12-08 17:13:43,108,4767,54,54,3237.04,5344.29,0.00
2024-12-08 17:13:43,108,4768,54,54,3239.03,5345.00,0.00
2024-12-08 17:13:43,109,4768,54,55,3209.31,5345.01,0.00
2024-12-08 17:13:43,108,4768,53,55,3236.08,5345.06,0.00
2024-12-08 17:13:43,107,4768,53,54,3246.90,5345.22,0.00
2024-12-08 17:13:43,107,4769,53,54,3295.89,5346.00,0.00
2024-12-08 17:13:43,108,4769,54,54,3265.37,5346.01,0.00
2024-12-08 17:13:43,109,4768,55,54,3232.98,5346.07,0.00
2024-12-08 17:13:43,108,4768,54,54,3306.03,5346.15,0.00
2024-12-08 17:13:43,108,4769,54,54,3289.28,5347.00,0.00
2024-12-08 17:13:43,109,4769,54,55,3259.11,5347.01,0.00
2024-12-08 17:13:43,108,4769,54,54,3276.45,5347.15,0.00
2024-12-08 17:13:43,108,4770,54,54,3318.63,5348.00,0.00
2024-12-08 17:13:43,109,4770,55,54,3288.18,5348.01,0.00
2024-12-08 17:13:43,108,4770,55,53,3304.41,5348.14,0.00
2024-12-08 17:13:43,108,4771,55,53,3297.92,5349.00,0.00
2024-12-08 17:13:43,109,4771,55,54,3267.67,5349.01,0.00
2024-12-08 17:13:43,108,4771,54,54,3246.74,5349.65,0.00
2024-12-08 17:13:43,109,4770,54,55,3203.38,5349.92,0.00
2024-12-08 17:13:43,109,4771,54,55,3251.07,5350.00,0.00
2024-12-08 17:13:43,110,4771,54,56,3221.51,5350.01,0.00
2024-12-08 17:13:43,109,4771,53,56,3250.09,5350.02,0.00
2024-12-08 17:13:43,108,4771,53,55,3272.81,5350.13,0.00
2024-12-08 17:13:43,108,4772,53,55,3315.79,5351.00,0.00
2024-12-08 17:13:43,109,4772,54,55,3285.37,5351.01,0.00
2024-12-08 17:13:43,109,4773,54,55,3262.04,5352.00,0.00
2024-12-08 17:13:43,110,4773,54,56,3232.38,5352.01,0.00
2024-12-08 17:13:43,109,4773,54,55,3258.16,5352.07,0.00
2024-12-08 17:13:43,108,4773,54,54,3284.87,5352.12,0.00
2024-12-08 17:13:43,108,4774,54,54,3277.35,5353.00,0.00
2024-12-08 17:13:43,109,4774,54,55,3247.28,5353.01,0.00
2024-12-08 17:13:43,110,4773,54,56,3217.76,5353.03,0.00
2024-12-08 17:13:43,110,4774,54,56,3203.76,5354.00,0.00
2024-12-08 17:13:43,111,4774,54,57,3174.90,5354.01,0.00
2024-12-08 17:13:43,110,4774,53,57,3191.16,5354.08,0.00
2024-12-08 17:13:43,109,4774,52,57,3218.48,5354.11,0.00
2024-12-08 17:13:43,108,4774,52,56,3246.79,5354.12,0.00
2024-12-08 17:13:44,108,4775,52,56,3299.40,5355.00,0.00
2024-12-08 17:13:44,109,4775,52,57,3269.13,5355.01,0.00
2024-12-08 17:13:44,109,4776,52,57,3246.15,5356.00,0.00
2024-12-08 17:13:44,110,4776,52,58,3216.64,5356.01,0.00
2024-12-08 17:13:44,109,4776,51,58,3234.92,5356.16,0.00
2024-12-08 17:13:44,108,4776,51,57,3260.41,5356.16,0.00
2024-12-08 17:13:44,108,4777,51,57,3265.41,5357.00,0.00
2024-12-08 17:13:44,109,4777,51,58,3235.46,5357.01,0.00
2024-12-08 17:13:44,108,4777,51,57,3260.01,5357.10,0.00
2024-12-08 17:13:44,107,4777,50,57,3271.02,5357.27,0.00
2024-12-08 17:13:44,107,4778,50,57,3272.51,5358.00,0.00
2024-12-08 17:13:44,108,4778,50,58,3242.21,5358.01,0.00
2024-12-08 17:13:44,107,4778,50,57,3261.06,5358.15,0.00
2024-12-08 17:13:44,108,4777,50,58,3186.58,5358.82,0.00
2024-12-08 17:13:44,108,4778,50,58,3230.41,5359.00,0.00
2024-12-08 17:13:44,109,4778,51,58,3200.77,5359.01,0.00
2024-12-08 17:13:44,108,4778,50,58,3190.79,5359.41,0.00
2024-12-08 17:13:44,108,4779,50,58,3258.70,5360.00,0.00
2024-12-08 17:13:44,109,4779,51,58,3228.80,5360.01,0.00
2024-12-08 17:13:44,108,4779,51,57,3247.79,5360.15,0.00
2024-12-08 17:13:44,109,4778,51,58,3208.73,5360.34,0.00
2024-12-08 17:13:44,110,4777,52,58,3187.42,5360.46,0.00
2024-12-08 17:13:44,110,4778,52,58,3218.51,5361.00,0.00
2024-12-08 17:13:44,111,4778,53,58,3189.52,5361.01,0.00
2024-12-08 17:13:44,112,4777,53,59,3104.92,5361.72,0.00
2024-12-08 17:13:44,112,4778,53,59,3253.55,5362.00,0.00
2024-12-08 17:13:44,113,4778,53,60,3224.76,5362.01,0.00
2024-12-08 17:13:44,112,4778,53,59,3242.60,5362.14,0.00
2024-12-08 17:13:44,112,4779,53,59,3283.37,5363.00,0.00
2024-12-08 17:13:44,113,4779,53,60,3254.31,5363.01,0.00
2024-12-08 17:13:44,113,4780,53,60,3229.68,5364.00,0.00
2024-12-08 17:13:44,114,4780,54,60,3201.35,5364.01,0.00
2024-12-08 17:13:44,115,4779,55,60,3172.59,5364.04,0.00
2024-12-08 17:13:44,114,4779,55,59,3208.00,5364.15,0.00
2024-12-08 17:13:44,114,4780,55,59,3200.54,5365.00,0.00
2024-12-08 17:13:44,115,4780,55,60,3172.71,5365.01,0.00
2024-12-08 17:13:44,116,4779,56,60,3098.99,5365.72,0.00
2024-12-08 17:13:44,116,4780,56,60,3170.46,5366.00,0.00
2024-12-08 17:13:44,117,4780,57,60,3143.36,5366.01,0.00
2024-12-08 17:13:44,117,4781,57,60,3164.13,5367.00,0.00
2024-12-08 17:13:44,118,4781,58,60,3137.31,5367.01,0.00
2024-12-08 17:13:44,119,4780,59,60,3097.46,5367.11,0.00
2024-12-08 17:13:45,119,4781,59,60,3127.32,5368.00,0.00
2024-12-08 17:13:45,120,4781,60,60,3101.26,5368.01,0.00
2024-12-08 17:13:45,119,4781,59,60,3112.02,5368.13,0.00
2024-12-08 17:13:45,118,4781,58,60,3119.44,5368.48,0.00
2024-12-08 17:13:45,118,4782,58,60,3173.96,5369.00,0.00
2024-12-08 17:13:45,119,4782,59,60,3147.29,5369.01,0.00
2024-12-08 17:13:45,118,4782,59,59,3165.78,5369.03,0.00
2024-12-08 17:13:45,117,4782,59,58,3188.31,5369.10,0.00
2024-12-08 17:13:45,117,4783,59,58,3177.38,5370.00,0.00
2024-12-08 17:13:45,118,4783,60,58,3150.45,5370.01,0.00
2024-12-08 17:13:45,117,4783,59,58,3148.56,5370.24,0.00
2024-12-08 17:13:45,118,4782,59,59,3114.65,5370.39,0.00
2024-12-08 17:13:45,118,4783,59,59,3151.04,5371.00,0.00
2024-12-08 17:13:45,119,4783,60,59,3124.56,5371.01,0.00
2024-12-08 17:13:45,119,4784,60,59,3144.10,5372.00,0.00
2024-12-08 17:13:45,120,4784,60,60,3117.90,5372.01,0.00
2024-12-08 17:13:45,120,4785,60,60,3092.06,5373.00,0.00
2024-12-08 17:13:45,121,4785,60,61,3066.51,5373.01,0.00
2024-12-08 17:13:45,120,4785,60,60,3083.60,5373.12,0.00
2024-12-08 17:13:45,119,4785,59,60,3108.16,5373.13,0.00
2024-12-08 17:13:45,119,4786,59,60,3098.31,5374.00,0.00
2024-12-08 17:13:45,120,4786,60,60,3072.49,5374.01,0.00
2024-12-08 17:13:45,119,4786,60,59,3083.45,5374.13,0.00
2024-12-08 17:13:45,120,4785,60,60,3056.87,5374.16,0.00
2024-12-08 17:13:45,121,4784,61,60,3035.75,5374.50,0.00
2024-12-08 17:13:45,121,4785,61,60,3063.65,5375.00,0.00
2024-12-08 17:13:45,122,4785,62,60,3038.54,5375.01,0.00
2024-12-08 17:13:45,121,4785,61,60,3059.69,5375.07,0.00
2024-12-08 17:13:45,121,4786,61,60,3125.98,5376.00,0.00
2024-12-08 17:13:45,122,4786,62,60,3100.36,5376.01,0.00
2024-12-08 17:13:45,121,4786,61,60,3121.58,5376.08,0.00
2024-12-08 17:13:45,120,4786,61,59,3135.51,5376.13,0.00
2024-12-08 17:13:45,121,4785,62,59,3069.59,5376.90,0.00
2024-12-08 17:13:45,121,4786,62,59,3121.23,5377.00,0.00
2024-12-08 17:13:45,122,4786,63,59,3095.65,5377.01,0.00
2024-12-08 17:13:45,121,4786,62,59,3096.90,5377.29,0.00
2024-12-08 17:13:45,122,4785,62,60,3027.00,5377.98,0.00
2024-12-08 17:13:45,122,4786,62,60,3114.73,5378.00,0.00
2024-12-08 17:13:45,123,4786,62,61,3089.41,5378.01,0.00
2024-12-08 17:13:45,122,4786,62,60,3107.74,5378.13,0.00
2024-12-08 17:13:45,122,4787,62,60,3140.89,5379.00,0.00
2024-12-08 17:13:45,123,4787,63,60,3115.35,5379.01,0.00
2024-12-08 17:13:45,123,4788,63,60,3088.81,5380.00,0.00
2024-12-08 17:13:45,124,4788,63,61,3063.90,5380.01,0.00
2024-12-08 17:13:45,123,4788,62,61,3087.51,5380.02,0.00
2024-12-08 17:13:45,122,4788,62,60,3106.68,5380.12,0.00
2024-12-08 17:13:45,121,4788,61,60,3123.09,5380.30,0.00
2024-12-08 17:13:45,121,4789,61,60,3121.33,5381.00,0.00
2024-12-08 17:13:45,122,4789,61,61,3095.74,5381.01,0.00
2024-12-08 17:13:45,123,4788,62,61,3070.14,5381.03,0.00
2024-12-08 17:13:45,124,4787,63,61,3077.54,5381.14,0.00
2024-12-08 17:13:45,125,4786,63,62,3044.76,5381.19,0.00
2024-12-08 17:13:45,126,4785,64,62,3029.14,5381.21,0.00
2024-12-08 17:13:46,126,4786,64,62,3037.10,5382.00,0.00
2024-12-08 17:13:46,127,4786,64,63,3013.18,5382.01,0.00
2024-12-08 17:13:46,126,4786,64,62,3030.74,5382.12,0.00
2024-12-08 17:13:46,126,4787,64,62,3188.68,5383.00,0.00
2024-12-08 17:13:46,127,4787,64,63,3163.57,5383.01,0.00
2024-12-08 17:13:46,126,4787,64,62,3165.24,5383.12,0.00
2024-12-08 17:13:46,126,4788,64,62,3160.69,5384.00,0.00
2024-12-08 17:13:46,127,4788,64,63,3135.80,5384.01,0.00
2024-12-08 17:13:46,126,4788,64,62,3153.47,5384.08,0.00
2024-12-08 17:13:46,126,4789,64,62,3138.05,5385.00,0.00
2024-12-08 17:13:46,127,4789,64,63,3113.34,5385.01,0.00
2024-12-08 17:13:46,126,4789,64,62,3123.14,5385.12,0.00
2024-12-08 17:13:46,126,4790,64,62,3103.21,5386.00,0.00
2024-12-08 17:13:46,127,4790,65,62,3078.77,5386.01,0.00
2024-12-08 17:13:46,127,4791,65,62,3030.70,5387.00,0.00
2024-12-08 17:13:46,128,4791,66,62,3007.02,5387.01,0.00
2024-12-08 17:13:46,127,4791,66,61,3023.10,5387.09,0.00
2024-12-08 17:13:46,126,4791,65,61,2987.77,5387.91,0.00
2024-12-08 17:13:46,126,4792,65,61,3025.90,5388.00,0.00
2024-12-08 17:13:46,127,4792,66,61,3002.08,5388.01,0.00
2024-12-08 17:13:46,126,4792,65,61,3009.72,5388.14,0.00
2024-12-08 17:13:46,127,4791,66,61,2946.92,5388.88,0.00
2024-12-08 17:13:46,127,4792,66,61,2979.27,5389.00,0.00
2024-12-08 17:13:46,128,4792,67,61,2956.00,5389.01,0.00
2024-12-08 17:13:46,129,4791,68,61,2931.02,5389.06,0.00
2024-12-08 17:13:46,129,4792,68,61,2984.62,5390.00,0.00
2024-12-08 17:13:46,130,4792,68,62,2961.66,5390.01,0.00
2024-12-08 17:13:46,131,4791,68,63,2932.94,5390.14,0.00
2024-12-08 17:13:46,130,4791,67,63,2982.47,5390.15,0.00
2024-12-08 17:13:46,131,4790,68,63,2944.32,5390.44,0.00
2024-12-08 17:13:46,131,4791,68,63,3009.30,5391.00,0.00
2024-12-08 17:13:46,132,4791,68,64,2986.51,5391.01,0.00
2024-12-08 17:13:46,131,4791,67,64,3005.23,5391.08,0.00
2024-12-08 17:13:46,132,4790,67,65,2981.65,5391.11,0.00
2024-12-08 17:13:46,133,4789,68,65,2975.08,5391.22,0.00
2024-12-08 17:13:46,133,4790,68,65,3062.61,5392.00,0.00
2024-12-08 17:13:46,134,4790,68,66,3039.76,5392.01,0.00
2024-12-08 17:13:46,133,4790,67,66,3047.68,5392.14,0.00
2024-12-08 17:13:46,132,4790,66,66,3061.84,5392.30,0.00
2024-12-08 17:13:46,132,4791,66,66,3139.09,5393.00,0.00
2024-12-08 17:13:46,133,4791,66,67,3115.49,5393.01,0.00
2024-12-08 17:13:46,133,4792,66,67,3086.87,5394.00,0.00
2024-12-08 17:13:46,134,4792,67,67,3063.83,5394.01,0.00
2024-12-08 17:13:46,133,4792,66,67,3022.88,5394.93,0.00
2024-12-08 17:13:46,133,4793,66,67,3059.85,5395.00,0.00
2024-12-08 17:13:46,134,4793,66,68,3037.02,5395.01,0.00
2024-12-08 17:13:46,133,4793,66,67,3047.74,5395.11,0.00
2024-12-08 17:13:47,133,4794,66,67,3032.83,5396.00,0.00
2024-12-08 17:13:47,134,4794,67,67,3010.20,5396.01,0.00
2024-12-08 17:13:47,133,4794,67,66,3022.34,5396.11,0.00
2024-12-08 17:13:47,132,4794,66,66,3044.02,5396.14,0.00
2024-12-08 17:13:47,131,4794,65,66,3026.76,5396.75,0.00
2024-12-08 17:13:47,131,4795,65,66,3054.58,5397.00,0.00
2024-12-08 17:13:47,132,4795,66,66,3031.43,5397.01,0.00
2024-12-08 17:13:47,131,4795,65,66,3050.49,5397.08,0.00
2024-12-08 17:13:47,131,4796,65,66,3025.72,5398.00,0.00
2024-12-08 17:13:47,132,4796,65,67,3002.80,5398.01,0.00
2024-12-08 17:13:47,133,4795,65,68,2945.48,5398.51,0.00
2024-12-08 17:13:47,134,4794,65,69,2933.25,5398.68,0.00
2024-12-08 17:13:47,134,4795,65,69,2956.88,5399.00,0.00
2024-12-08 17:13:47,135,4795,66,69,2934.98,5399.01,0.00
2024-12-08 17:13:47,134,4795,66,68,2950.08,5399.10,0.00
2024-12-08 17:13:47,133,4795,65,68,2970.24,5399.14,0.00
2024-12-08 17:13:47,134,4794,65,69,2915.31,5399.75,0.00
2024-12-08 17:13:47,134,4795,65,69,3019.07,5400.00,0.00
2024-12-08 17:13:47,135,4795,66,69,2996.70,5400.01,0.00
2024-12-08 17:13:47,134,4795,66,68,3007.43,5400.11,0.00
2024-12-08 17:13:47,134,4796,66,68,3031.29,5401.00,0.00
2024-12-08 17:13:47,135,4796,67,68,3008.84,5401.01,0.00
2024-12-08 17:13:47,134,4796,67,67,3019.25,5401.11,0.00
2024-12-08 17:13:47,134,4797,67,67,3002.45,5402.00,0.00
2024-12-08 17:13:47,135,4797,67,68,2980.21,5402.01,0.00
2024-12-08 17:13:47,134,4797,67,67,2990.41,5402.11,0.00
2024-12-08 17:13:47,133,4797,66,67,2986.96,5402.56,0.00
2024-12-08 17:13:47,133,4798,66,67,2995.82,5403.00,0.00
2024-12-08 17:13:47,134,4798,67,67,2973.46,5403.01,0.00
2024-12-08 17:13:47,133,4798,67,66,2981.66,5403.14,0.00
2024-12-08 17:13:47,132,4798,66,66,3003.84,5403.14,0.00
2024-12-08 17:13:47,132,4799,66,66,2988.66,5404.00,0.00
2024-12-08 17:13:47,133,4799,67,66,2966.19,5404.01,0.00
2024-12-08 17:13:47,132,4799,67,65,2974.40,5404.14,0.00
2024-12-08 17:13:47,131,4799,66,65,2996.69,5404.14,0.00
2024-12-08 17:13:47,130,4799,65,65,3011.39,5404.29,0.00
2024-12-08 17:13:47,129,4799,64,65,3031.82,5404.34,0.00
2024-12-08 17:13:47,129,4800,64,65,3030.16,5405.00,0.00
2024-12-08 17:13:47,130,4800,64,66,3006.85,5405.01,0.00
2024-12-08 17:13:47,129,4800,64,65,3013.88,5405.15,0.00
2024-12-08 17:13:47,128,4800,63,65,3021.85,5405.31,0.00
2024-12-08 17:13:47,128,4801,63,65,3026.94,5406.00,0.00
2024-12-08 17:13:47,129,4801,63,66,3003.48,5406.01,0.00
2024-12-08 17:13:47,128,4801,63,65,3021.92,5406.09,0.00
2024-12-08 17:13:47,127,4801,63,64,3034.24,5406.14,0.00
2024-12-08 17:13:47,128,4800,64,64,2972.05,5406.88,0.00
2024-12-08 17:13:47,128,4801,64,64,3004.69,5407.00,0.00
2024-12-08 17:13:47,129,4801,64,65,2981.40,5407.01,0.00
2024-12-08 17:13:47,128,4801,63,65,2992.47,5407.07,0.00
2024-12-08 17:13:47,127,4801,63,64,3010.10,5407.13,0.00
2024-12-08 17:13:47,127,4802,63,64,3043.84,5408.00,0.00
2024-12-08 17:13:47,128,4802,63,65,3020.06,5408.01,0.00
2024-12-08 17:13:47,127,4802,63,64,3028.14,5408.13,0.00
2024-12-08 17:13:48,127,4803,63,64,2999.15,5409.00,0.00
2024-12-08 17:13:48,128,4803,64,64,2975.72,5409.01,0.00
2024-12-08 17:13:48,127,4803,64,63,2974.51,5409.14,0.00
2024-12-08 17:13:48,126,4803,64,62,2960.65,5409.68,0.00
2024-12-08 17:13:48,127,4802,65,62,2920.96,5409.99,0.00
2024-12-08 17:13:48,127,4803,65,62,2963.57,5410.00,0.00
2024-12-08 17:13:48,128,4803,66,62,2940.42,5410.01,0.00
2024-12-08 17:13:48,127,4803,66,61,2961.88,5410.04,0.00
2024-12-08 17:13:48,127,4804,66,61,2987.13,5411.00,0.00
2024-12-08 17:13:48,128,4804,67,61,2963.79,5411.01,0.00
2024-12-08 17:13:48,127,4804,67,60,2973.12,5411.13,0.00
2024-12-08 17:13:48,128,4803,67,61,2938.97,5411.34,0.00
2024-12-08 17:13:48,128,4804,67,61,2963.49,5412.00,0.00
2024-12-08 17:13:48,129,4804,68,61,2940.52,5412.01,0.00
2024-12-08 17:13:48,128,4804,67,61,2958.88,5412.09,0.00
2024-12-08 17:13:48,127,4804,67,60,2972.82,5412.12,0.00
2024-12-08 17:13:48,128,4803,68,60,2905.64,5412.95,0.00
2024-12-08 17:13:48,128,4804,68,60,2980.11,5413.00,0.00
2024-12-08 17:13:48,129,4804,69,60,2957.01,5413.01,0.00
2024-12-08 17:13:48,128,4804,69,59,2964.94,5413.13,0.00
2024-12-08 17:13:48,128,4805,69,59,2994.62,5414.00,0.00
2024-12-08 17:13:48,129,4805,69,60,2971.40,5414.01,0.00
2024-12-08 17:13:48,130,4804,69,61,2948.13,5414.03,0.00
2024-12-08 17:13:48,129,4804,69,60,2972.30,5414.12,0.00
2024-12-08 17:13:48,130,4803,70,60,2949.43,5414.14,0.00
2024-12-08 17:13:48,131,4802,71,60,2935.23,5414.30,0.00
2024-12-08 17:13:48,131,4803,71,60,2957.99,5415.00,0.00
2024-12-08 17:13:48,132,4803,72,60,2935.59,5415.01,0.00
2024-12-08 17:13:48,131,4803,72,59,2944.00,5415.12,0.00
2024-12-08 17:13:48,131,4804,72,59,3054.05,5416.00,0.00
2024-12-08 17:13:48,132,4804,73,59,3030.91,5416.01,0.00
2024-12-08 17:13:48,131,4804,73,58,3039.22,5416.13,0.00
2024-12-08 17:13:48,130,4804,72,58,3031.10,5416.55,0.00
2024-12-08 17:13:48,131,4803,73,58,2999.38,5416.73,0.00
2024-12-08 17:13:48,131,4804,73,58,3036.00,5417.00,0.00
2024-12-08 17:13:48,132,4804,73,59,3013.00,5417.01,0.00
2024-12-08 17:13:48,131,4804,72,59,3022.41,5417.12,0.00
2024-12-08 17:13:48,130,4804,72,58,3036.91,5417.13,0.00
2024-12-08 17:13:48,130,4805,72,58,3073.67,5418.00,0.00
2024-12-08 17:13:48,131,4805,72,59,3050.21,5418.01,0.00
2024-12-08 17:13:48,130,4805,72,58,3068.30,5418.10,0.00
2024-12-08 17:13:48,129,4805,71,58,3090.84,5418.12,0.00
2024-12-08 17:13:48,128,4805,70,58,3114.14,5418.13,0.00
2024-12-08 17:13:48,128,4806,70,58,3093.06,5419.00,0.00
2024-12-08 17:13:48,129,4806,70,59,3069.08,5419.01,0.00
2024-12-08 17:13:48,129,4807,70,59,3041.08,5420.00,0.00
2024-12-08 17:13:48,130,4807,71,59,3017.69,5420.01,0.00
2024-12-08 17:13:48,130,4808,71,59,2989.47,5421.00,0.00
2024-12-08 17:13:48,131,4808,71,60,2966.65,5421.01,0.00
2024-12-08 17:13:48,132,4807,71,61,2941.73,5421.07,0.00
2024-12-08 17:13:48,131,4807,71,60,2977.89,5421.15,0.00
2024-12-08 17:13:48,131,4808,71,60,2965.13,5422.00,0.00
2024-12-08 17:13:48,132,4808,72,60,2942.67,5422.01,0.00
2024-12-08 17:13:48,131,4808,72,59,2950.29,5422.14,0.00
2024-12-08 17:13:48,130,4808,71,59,2972.57,5422.14,0.00
2024-12-08 17:13:48,129,4808,70,59,2989.33,5422.20,0.00
2024-12-08 17:13:49,129,4809,70,59,3030.42,5423.00,0.00
2024-12-08 17:13:49,130,4809,71,59,3007.11,5423.01,0.00
2024-12-08 17:13:49,129,4809,71,58,3014.50,5423.15,0.00
2024-12-08 17:13:49,128,4809,70,58,3011.97,5423.59,0.00
2024-12-08 17:13:49,129,4808,70,59,2985.71,5423.66,0.00
2024-12-08 17:13:49,129,4809,70,59,3022.57,5424.00,0.00
2024-12-08 17:13:49,130,4809,70,60,2999.32,5424.01,0.00
2024-12-08 17:13:49,129,4809,69,60,3017.15,5424.10,0.00
2024-12-08 17:13:49,128,4809,69,59,3029.72,5424.14,0.00
2024-12-08 17:13:49,129,4808,70,59,2990.35,5424.45,0.00
2024-12-08 17:13:49,129,4809,70,59,3057.61,5425.00,0.00
2024-12-08 17:13:49,130,4809,70,60,3034.09,5425.01,0.00
2024-12-08 17:13:49,129,4809,70,59,3042.11,5425.14,0.00
2024-12-08 17:13:49,128,4809,69,59,3055.35,5425.34,0.00
2024-12-08 17:13:49,129,4808,70,59,3025.40,5425.47,0.00
2024-12-08 17:13:49,129,4809,70,59,3082.99,5426.00,0.00
2024-12-08 17:13:49,130,4809,70,60,3059.27,5426.01,0.00
2024-12-08 17:13:49,129,4809,70,59,3067.48,5426.14,0.00
2024-12-08 17:13:49,130,4808,71,59,3027.31,5426.46,0.00
2024-12-08 17:13:49,129,4808,70,59,3078.57,5426.51,0.00
2024-12-08 17:13:49,129,4809,70,59,3136.56,5427.00,0.00
2024-12-08 17:13:49,130,4809,70,60,3112.44,5427.01,0.00
2024-12-08 17:13:49,129,4809,69,60,3127.74,5427.03,0.00
2024-12-08 17:13:49,128,4809,68,60,3146.71,5427.13,0.00
2024-12-08 17:13:49,129,4808,68,61,3108.05,5427.26,0.00
2024-12-08 17:13:49,129,4809,68,61,3180.66,5428.00,0.00
2024-12-08 17:13:49,130,4809,69,61,3156.19,5428.01,0.00
2024-12-08 17:13:49,131,4808,69,62,3130.04,5428.06,0.00
2024-12-08 17:13:49,131,4809,69,62,3147.87,5429.00,0.00
2024-12-08 17:13:49,132,4809,69,63,3124.02,5429.01,0.00
2024-12-08 17:13:49,131,4809,68,63,3112.32,5429.36,0.00
2024-12-08 17:13:49,132,4808,68,64,3060.71,5429.89,0.00
2024-12-08 17:13:49,132,4809,68,64,3140.20,5430.00,0.00
2024-12-08 17:13:49,133,4809,68,65,3116.59,5430.01,0.00
2024-12-08 17:13:49,132,4809,67,65,3122.57,5430.17,0.00
2024-12-08 17:13:49,131,4809,66,65,3125.84,5430.54,0.00
2024-12-08 17:13:49,131,4810,66,65,3184.14,5431.00,0.00
2024-12-08 17:13:49,132,4810,67,65,3160.02,5431.01,0.00
2024-12-08 17:13:49,131,4810,67,64,3175.49,5431.14,0.00
2024-12-08 17:13:49,132,4809,67,65,3131.42,5431.52,0.00
2024-12-08 17:13:49,132,4810,67,65,3155.31,5432.00,0.00
2024-12-08 17:13:49,133,4810,68,65,3131.59,5432.01,0.00
2024-12-08 17:13:49,134,4809,69,65,3105.40,5432.08,0.00
2024-12-08 17:13:49,133,4809,69,64,3134.09,5432.14,0.00
2024-12-08 17:13:49,132,4809,68,64,3146.79,5432.35,0.00
2024-12-08 17:13:49,132,4810,68,64,3185.29,5433.00,0.00
2024-12-08 17:13:49,133,4810,68,65,3161.35,5433.01,0.00
2024-12-08 17:13:49,133,4811,68,65,3172.45,5434.00,0.00
2024-12-08 17:13:49,134,4811,68,66,3148.77,5434.01,0.00
2024-12-08 17:13:49,135,4810,69,66,3124.25,5434.04,0.00
2024-12-08 17:13:49,135,4811,69,66,3113.64,5435.00,0.00
2024-12-08 17:13:50,136,4811,69,67,3090.75,5435.01,0.00
2024-12-08 17:13:50,135,4811,68,67,3100.40,5435.10,0.00
2024-12-08 17:13:50,136,4810,68,68,3062.90,5435.38,0.00
2024-12-08 17:13:50,137,4809,68,69,3038.22,5435.50,0.00
2024-12-08 17:13:50,137,4810,68,69,3098.80,5436.00,0.00
2024-12-08 17:13:50,138,4810,69,69,3076.34,5436.01,0.00
2024-12-08 17:13:50,138,4811,69,69,3123.93,5437.00,0.00
2024-12-08 17:13:50,139,4811,70,69,3101.45,5437.01,0.00
2024-12-08 17:13:50,138,4811,70,68,3114.89,5437.06,0.00
2024-12-08 17:13:50,139,4810,71,68,3091.70,5437.09,0.00
2024-12-08 17:13:50,138,4810,70,68,3138.94,5437.09,0.00
2024-12-08 17:13:50,138,4811,70,68,3120.13,5438.00,0.00
2024-12-08 17:13:50,139,4811,71,68,3097.68,5438.01,0.00
2024-12-08 17:13:50,139,4812,71,68,3105.11,5439.00,0.00
2024-12-08 17:13:50,140,4812,72,68,3082.93,5439.01,0.00
2024-12-08 17:13:50,139,4812,71,68,3103.16,5439.04,0.00
2024-12-08 17:13:50,140,4811,72,68,3061.25,5439.27,0.00
2024-12-08 17:13:50,140,4812,72,68,3066.83,5440.00,0.00
2024-12-08 17:13:50,141,4812,73,68,3045.08,5440.01,0.00
2024-12-08 17:13:50,142,4811,73,69,3022.11,5440.05,0.00
2024-12-08 17:13:50,141,4811,72,69,3046.65,5440.06,0.00
2024-12-08 17:13:50,140,4811,71,69,3054.45,5440.18,0.00
2024-12-08 17:13:50,140,4812,71,69,3078.20,5441.00,0.00
2024-12-08 17:13:50,141,4812,72,69,3056.37,5441.01,0.00
2024-12-08 17:13:50,140,4812,72,68,3069.31,5441.09,0.00
2024-12-08 17:13:50,139,4812,71,68,3066.52,5441.55,0.00
2024-12-08 17:13:50,139,4813,71,68,3110.57,5442.00,0.00
2024-12-08 17:13:50,140,4813,72,68,3088.35,5442.01,0.00
2024-12-08 17:13:50,139,4813,72,67,3102.39,5442.09,0.00
2024-12-08 17:13:50,140,4812,72,68,3060.16,5442.48,0.00
2024-12-08 17:13:50,140,4813,72,68,3087.07,5443.00,0.00
2024-12-08 17:13:50,141,4813,72,69,3065.17,5443.01,0.00
2024-12-08 17:13:50,142,4812,73,69,3023.72,5443.25,0.00
2024-12-08 17:13:50,143,4811,73,70,3013.33,5443.45,0.00
2024-12-08 17:13:50,143,4812,73,70,3064.63,5444.00,0.00
2024-12-08 17:13:50,144,4812,73,71,3043.34,5444.01,0.00
2024-12-08 17:13:50,143,4812,72,71,3034.68,5444.39,0.00
2024-12-08 17:13:50,143,4813,72,71,3113.38,5445.00,0.00
2024-12-08 17:13:50,144,4813,73,71,3091.76,5445.01,0.00
2024-12-08 17:13:50,143,4813,73,70,3103.52,5445.09,0.00
2024-12-08 17:13:50,142,4813,72,70,3120.02,5445.19,0.00
2024-12-08 17:13:50,141,4813,71,70,3141.38,5445.20,0.00
2024-12-08 17:13:50,140,4813,70,70,3161.11,5445.22,0.00
2024-12-08 17:13:50,140,4814,70,70,3155.73,5446.00,0.00
2024-12-08 17:13:50,141,4814,70,71,3133.34,5446.01,0.00
2024-12-08 17:13:50,140,4814,69,71,3154.56,5446.02,0.00
2024-12-08 17:13:50,139,4814,68,71,3173.76,5446.08,0.00
2024-12-08 17:13:50,138,4814,68,70,3193.61,5446.08,0.00
2024-12-08 17:13:50,137,4814,67,70,3183.02,5446.56,0.00
2024-12-08 17:13:50,137,4815,67,70,3198.87,5447.00,0.00
2024-12-08 17:13:50,138,4815,68,70,3175.69,5447.01,0.00
2024-12-08 17:13:50,137,4815,68,69,3191.35,5447.09,0.00
2024-12-08 17:13:50,136,4815,67,69,3210.03,5447.18,0.00
2024-12-08 17:13:50,137,4814,68,69,3156.20,5447.61,0.00
2024-12-08 17:13:50,137,4815,68,69,3187.53,5448.00,0.00
2024-12-08 17:13:50,138,4815,69,69,3164.43,5448.01,0.00
2024-12-08 17:13:50,137,4815,69,68,3180.01,5448.09,0.00
2024-12-08 17:13:51,136,4815,68,68,3196.59,5448.12,0.00
2024-12-08 17:13:51,136,4816,68,68,3229.18,5449.00,0.00
2024-12-08 17:13:51,137,4816,68,69,3205.61,5449.01,0.00
2024-12-08 17:13:51,136,4816,68,68,3221.61,5449.09,0.00
2024-12-08 17:13:51,137,4815,68,69,3176.39,5449.50,0.00
2024-12-08 17:13:51,137,4816,68,69,3198.25,5450.00,0.00
2024-12-08 17:13:51,138,4816,68,70,3175.07,5450.01,0.00
2024-12-08 17:13:51,137,4816,68,69,3190.72,5450.09,0.00
2024-12-08 17:13:51,138,4815,69,69,3158.18,5450.28,0.00
2024-12-08 17:13:51,139,4814,70,69,3137.31,5450.75,0.00
2024-12-08 17:13:51,139,4815,70,69,3202.61,5451.00,0.00
2024-12-08 17:13:51,140,4815,70,70,3179.73,5451.01,0.00
2024-12-08 17:13:51,139,4815,70,69,3195.19,5451.09,0.00
2024-12-08 17:13:51,140,4814,71,69,3138.43,5451.73,0.00
2024-12-08 17:13:51,140,4815,71,69,3232.89,5452.00,0.00
2024-12-08 17:13:51,141,4815,72,69,3209.96,5452.01,0.00
2024-12-08 17:13:51,142,4814,72,70,3183.93,5452.08,0.00
2024-12-08 17:13:51,141,4814,71,70,3221.24,5452.16,0.00
2024-12-08 17:13:51,141,4815,71,70,3253.09,5453.00,0.00
2024-12-08 17:13:51,142,4815,71,71,3230.18,5453.01,0.00
2024-12-08 17:13:51,143,4814,71,72,3207.59,5453.02,0.00
2024-12-08 17:13:51,142,4814,71,71,3264.40,5453.08,0.00
2024-12-08 17:13:51,141,4814,70,71,3243.82,5453.75,0.00
2024-12-08 17:13:51,142,4813,70,72,3214.16,5453.89,0.00
2024-12-08 17:13:51,143,4812,71,72,3194.75,5453.90,0.00
2024-12-08 17:13:51,143,4813,71,72,3261.20,5454.00,0.00
2024-12-08 17:13:51,144,4813,71,73,3238.55,5454.01,0.00
2024-12-08 17:13:51,145,4812,72,73,3216.21,5454.02,0.00
2024-12-08 17:13:51,146,4811,73,73,3151.92,5454.68,0.00
2024-12-08 17:13:51,147,4810,73,74,3125.52,5454.96,0.00
2024-12-08 17:13:51,147,4811,73,74,3265.07,5455.00,0.00
2024-12-08 17:13:51,148,4811,74,74,3243.01,5455.01,0.00
2024-12-08 17:13:51,149,4810,75,74,3217.62,5455.09,0.00
2024-12-08 17:13:51,148,4810,74,74,3263.29,5455.18,0.00
2024-12-08 17:13:51,149,4809,74,75,3223.97,5455.51,0.00
2024-12-08 17:13:51,148,4809,73,75,3247.24,5455.53,0.00
2024-12-08 17:13:51,148,4810,73,75,3361.88,5456.00,0.00
2024-12-08 17:13:51,149,4810,73,76,3339.32,5456.01,0.00
2024-12-08 17:13:51,149,4811,73,76,3371.77,5457.00,0.00
2024-12-08 17:13:51,150,4811,74,76,3349.29,5457.01,0.00
2024-12-08 17:13:51,150,4812,74,76,3294.77,5458.00,0.00
2024-12-08 17:13:51,151,4812,75,76,3272.95,5458.01,0.00
2024-12-08 17:13:51,152,4811,76,76,3211.59,5458.61,0.00
2024-12-08 17:13:51,151,4811,75,76,3229.86,5458.84,0.00
2024-12-08 17:13:51,151,4812,75,76,3250.24,5459.00,0.00
2024-12-08 17:13:51,152,4812,75,77,3228.86,5459.01,0.00
2024-12-08 17:13:51,153,4811,75,78,3206.70,5459.04,0.00
2024-12-08 17:13:51,153,4812,75,78,3216.95,5460.00,0.00
2024-12-08 17:13:51,154,4812,75,79,3196.06,5460.01,0.00
2024-12-08 17:13:51,153,4812,75,78,3210.57,5460.07,0.00
2024-12-08 17:13:51,152,4812,75,77,3231.33,5460.07,0.00
2024-12-08 17:13:51,151,4812,74,77,3252.37,5460.07,0.00
2024-12-08 17:13:51,150,4812,74,76,3270.46,5460.12,0.00
2024-12-08 17:13:51,151,4811,74,77,3210.51,5460.84,0.00
2024-12-08 17:13:52,151,4812,74,77,3270.68,5461.00,0.00
2024-12-08 17:13:52,152,4812,75,77,3249.16,5461.01,0.00
2024-12-08 17:13:52,153,4811,76,77,3226.87,5461.04,0.00
2024-12-08 17:13:52,152,4811,75,77,3246.68,5461.07,0.00
2024-12-08 17:13:52,151,4811,75,76,3267.46,5461.07,0.00
2024-12-08 17:13:52,151,4812,75,76,3289.30,5462.00,0.00
2024-12-08 17:13:52,152,4812,76,76,3267.66,5462.01,0.00
2024-12-08 17:13:52,153,4811,77,76,3245.95,5462.03,0.00
2024-12-08 17:13:52,152,4811,77,75,3281.36,5462.07,0.00
2024-12-08 17:13:52,152,4812,77,75,3294.77,5463.00,0.00
2024-12-08 17:13:52,153,4812,77,76,3273.24,5463.01,0.00
2024-12-08 17:13:52,152,4812,77,75,3291.22,5463.07,0.00
2024-12-08 17:13:52,151,4812,76,75,3293.93,5463.31,0.00
2024-12-08 17:13:52,152,4811,77,75,3257.20,5463.57,0.00
2024-12-08 17:13:52,152,4812,77,75,3318.29,5464.00,0.00
2024-12-08 17:13:52,153,4812,78,75,3296.60,5464.01,0.00
2024-12-08 17:13:52,152,4812,78,74,3314.37,5464.07,0.00
2024-12-08 17:13:52,152,4813,78,74,3326.84,5465.00,0.00
2024-12-08 17:13:52,153,4813,79,74,3305.09,5465.01,0.00
2024-12-08 17:13:52,152,4813,79,73,3320.77,5465.08,0.00
2024-12-08 17:13:52,152,4814,79,73,3298.30,5466.00,0.00
2024-12-08 17:13:52,153,4814,80,73,3276.74,5466.01,0.00
2024-12-08 17:13:52,154,4813,81,73,3197.74,5466.80,0.00
2024-12-08 17:13:52,154,4814,81,73,3227.74,5467.00,0.00
2024-12-08 17:13:52,155,4814,82,73,3206.91,5467.01,0.00
2024-12-08 17:13:52,156,4813,83,73,3186.01,5467.03,0.00
2024-12-08 17:13:52,157,4812,83,74,3164.36,5467.09,0.00
2024-12-08 17:13:52,158,4811,83,75,3111.06,5467.72,0.00
2024-12-08 17:13:52,158,4812,83,75,3165.97,5468.00,0.00
2024-12-08 17:13:52,159,4812,84,75,3146.06,5468.01,0.00
2024-12-08 17:13:52,158,4812,84,74,3156.33,5468.08,0.00
2024-12-08 17:13:52,159,4811,85,74,3107.51,5468.61,0.00
2024-12-08 17:13:52,159,4812,85,74,3228.19,5469.00,0.00
2024-12-08 17:13:52,160,4812,86,74,3208.01,5469.01,0.00
2024-12-08 17:13:52,159,4812,86,73,3222.39,5469.08,0.00
2024-12-08 17:13:52,158,4812,85,73,3235.87,5469.12,0.00
2024-12-08 17:13:52,159,4811,85,74,3205.26,5469.32,0.00
2024-12-08 17:13:52,160,4810,85,75,3185.56,5469.68,0.00
2024-12-08 17:13:52,161,4809,85,76,3168.25,5469.80,0.00
2024-12-08 17:13:52,161,4810,85,76,3230.59,5470.00,0.00
2024-12-08 17:13:52,162,4810,85,77,3210.65,5470.01,0.00
2024-12-08 17:13:52,161,4810,85,76,3222.49,5470.10,0.00
2024-12-08 17:13:52,160,4810,84,76,3227.98,5470.28,0.00
2024-12-08 17:13:52,161,4809,84,77,3174.80,5470.89,0.00
2024-12-08 17:13:52,161,4810,84,77,3307.42,5471.00,0.00
2024-12-08 17:13:52,162,4810,84,78,3287.00,5471.01,0.00
2024-12-08 17:13:52,161,4810,84,77,3298.63,5471.10,0.00
2024-12-08 17:13:52,162,4809,85,77,3250.24,5471.61,0.00
2024-12-08 17:13:52,162,4810,85,77,3306.97,5472.00,0.00
2024-12-08 17:13:52,163,4810,85,78,3286.68,5472.01,0.00
2024-12-08 17:13:52,162,4810,85,77,3297.57,5472.11,0.00
2024-12-08 17:13:52,163,4809,85,78,3243.47,5472.72,0.00
2024-12-08 17:13:52,164,4808,85,79,3230.04,5472.73,0.00
2024-12-08 17:13:53,164,4809,85,79,3302.01,5473.00,0.00
2024-12-08 17:13:53,165,4809,86,79,3282.00,5473.01,0.00
2024-12-08 17:13:53,164,4809,86,78,3292.72,5473.11,0.00
2024-12-08 17:13:53,164,4810,86,78,3336.14,5474.00,0.00
2024-12-08 17:13:53,165,4810,86,79,3315.92,5474.01,0.00
2024-12-08 17:13:53,164,4810,86,78,3326.85,5474.11,0.00
2024-12-08 17:13:53,165,4809,86,79,3288.50,5474.33,0.00
2024-12-08 17:13:53,165,4810,86,79,3289.89,5475.00,0.00
2024-12-08 17:13:53,166,4810,87,79,3270.07,5475.01,0.00
2024-12-08 17:13:53,165,4810,87,78,3280.65,5475.11,0.00
2024-12-08 17:13:53,166,4809,87,79,3227.59,5475.71,0.00
2024-12-08 17:13:53,166,4810,87,79,3278.30,5476.00,0.00
2024-12-08 17:13:53,167,4810,87,80,3258.67,5476.01,0.00
2024-12-08 17:13:53,166,4810,86,80,3261.88,5476.18,0.00
2024-12-08 17:13:53,167,4809,87,80,3230.62,5476.41,0.00
2024-12-08 17:13:53,167,4810,87,80,3288.76,5477.00,0.00
2024-12-08 17:13:53,168,4810,88,80,3269.18,5477.01,0.00
2024-12-08 17:13:53,167,4810,87,80,3284.86,5477.07,0.00
2024-12-08 17:13:53,166,4810,87,79,3303.66,5477.08,0.00
2024-12-08 17:13:53,166,4811,87,79,3304.72,5478.00,0.00
2024-12-08 17:13:53,167,4811,87,80,3284.93,5478.01,0.00
2024-12-08 17:13:53,166,4811,87,79,3292.89,5478.11,0.00
2024-12-08 17:13:53,167,4810,88,79,3263.71,5478.30,0.00
2024-12-08 17:13:53,168,4809,88,80,3241.38,5478.38,0.00
2024-12-08 17:13:53,168,4810,88,80,3248.86,5479.00,0.00
2024-12-08 17:13:53,169,4810,89,80,3229.64,5479.01,0.00
2024-12-08 17:13:53,168,4810,89,79,3239.13,5479.11,0.00
2024-12-08 17:13:53,168,4811,89,79,3280.73,5480.00,0.00
2024-12-08 17:13:53,169,4811,90,79,3261.32,5480.01,0.00
2024-12-08 17:13:53,170,4810,91,79,3240.86,5480.04,0.00
2024-12-08 17:13:53,169,4810,90,79,3276.96,5480.19,0.00
2024-12-08 17:13:53,170,4809,90,80,3232.02,5480.67,0.00
2024-12-08 17:13:53,170,4810,90,80,3253.15,5481.00,0.00
2024-12-08 17:13:53,171,4810,91,80,3234.12,5481.01,0.00
2024-12-08 17:13:53,170,4810,90,80,3251.24,5481.04,0.00
2024-12-08 17:13:53,169,4810,89,80,3267.90,5481.08,0.00
2024-12-08 17:13:53,168,4810,89,79,3280.84,5481.10,0.00
2024-12-08 17:13:53,168,4811,89,79,3320.81,5482.00,0.00
2024-12-08 17:13:53,169,4811,89,80,3301.16,5482.01,0.00
2024-12-08 17:13:53,170,4810,89,81,3246.63,5482.49,0.00
2024-12-08 17:13:53,170,4811,89,81,3258.20,5483.00,0.00
2024-12-08 17:13:53,171,4811,89,82,3239.15,5483.01,0.00
2024-12-08 17:13:53,172,4810,89,83,3188.17,5483.42,0.00
2024-12-08 17:13:53,172,4811,89,83,3229.94,5484.00,0.00
2024-12-08 17:13:53,173,4811,89,84,3211.27,5484.01,0.00
2024-12-08 17:13:53,172,4811,89,83,3218.51,5484.10,0.00
2024-12-08 17:13:53,173,4810,90,83,3197.70,5484.15,0.00
2024-12-08 17:13:53,172,4810,89,83,3242.44,5484.17,0.00
2024-12-08 17:13:53,172,4811,89,83,3248.16,5485.00,0.00
2024-12-08 17:13:53,173,4811,89,84,3229.39,5485.01,0.00
2024-12-08 17:13:54,172,4811,88,84,3225.29,5485.25,0.00
2024-12-08 17:13:54,172,4812,88,84,3238.57,5486.00,0.00
2024-12-08 17:13:54,173,4812,88,85,3219.85,5486.01,0.00
2024-12-08 17:13:54,172,4812,87,85,3234.15,5486.08,0.00
2024-12-08 17:13:54,171,4812,87,84,3251.78,5486.10,0.00
2024-12-08 17:13:54,171,4813,87,84,3215.76,5487.00,0.00
2024-12-08 17:13:54,172,4813,88,84,3197.06,5487.01,0.00
2024-12-08 17:13:54,171,4813,88,83,3208.43,5487.10,0.00
2024-12-08 17:13:54,172,4812,89,83,3155.09,5487.57,0.00
2024-12-08 17:13:54,173,4811,89,84,3136.62,5487.70,0.00
2024-12-08 17:13:54,172,4811,88,84,3149.09,5487.90,0.00
2024-12-08 17:13:54,172,4812,88,84,3175.66,5488.00,0.00
2024-12-08 17:13:54,173,4812,88,85,3157.31,5488.01,0.00
2024-12-08 17:13:54,172,4812,87,85,3171.24,5488.08,0.00
2024-12-08 17:13:54,171,4812,87,84,3186.26,5488.10,0.00
2024-12-08 17:13:54,170,4812,86,84,3199.24,5488.20,0.00
2024-12-08 17:13:54,170,4813,86,84,3243.75,5489.00,0.00
2024-12-08 17:13:54,171,4813,87,84,3224.78,5489.01,0.00
2024-12-08 17:13:54,170,4813,87,83,3235.08,5489.11,0.00
2024-12-08 17:13:54,171,4812,87,84,3211.05,5489.21,0.00
2024-12-08 17:13:54,170,4812,86,84,3228.62,5489.29,0.00
2024-12-08 17:13:54,169,4812,85,84,3245.79,5489.33,0.00
2024-12-08 17:13:54,168,4812,84,84,3255.08,5489.51,0.00
2024-12-08 17:13:54,168,4813,84,84,3254.80,5490.00,0.00
2024-12-08 17:13:54,169,4813,84,85,3235.54,5490.01,0.00
2024-12-08 17:13:54,170,4812,85,85,3216.51,5490.02,0.00
2024-12-08 17:13:54,169,4812,84,85,3232.36,5490.17,0.00
2024-12-08 17:13:54,170,4811,85,85,3194.13,5490.53,0.00
2024-12-08 17:13:54,170,4812,85,85,3239.38,5491.00,0.00
2024-12-08 17:13:54,171,4812,85,86,3220.43,5491.01,0.00
2024-12-08 17:13:54,170,4812,84,86,3234.58,5491.09,0.00
2024-12-08 17:13:54,169,4812,83,86,3243.66,5491.15,0.00
2024-12-08 17:13:54,169,4813,83,86,3273.27,5492.00,0.00
2024-12-08 17:13:54,170,4813,84,86,3254.01,5492.01,0.00
2024-12-08 17:13:54,171,4812,84,87,3229.89,5492.11,0.00
2024-12-08 17:13:54,170,4812,83,87,3209.75,5492.87,0.00
2024-12-08 17:13:54,170,4813,83,87,3228.60,5493.00,0.00
2024-12-08 17:13:54,171,4813,84,87,3209.72,5493.01,0.00
2024-12-08 17:13:54,171,4814,84,87,3207.09,5494.00,0.00
2024-12-08 17:13:54,172,4814,84,88,3188.45,5494.01,0.00
2024-12-08 17:13:54,171,4814,83,88,3181.52,5494.35,0.00
2024-12-08 17:13:54,171,4815,83,88,3172.01,5495.00,0.00
2024-12-08 17:13:54,172,4815,84,88,3153.57,5495.01,0.00
2024-12-08 17:13:54,173,4814,84,89,3133.14,5495.06,0.00
2024-12-08 17:13:54,174,4813,84,90,3115.80,5495.18,0.00
2024-12-08 17:13:54,173,4813,83,90,3117.40,5495.91,0.00
2024-12-08 17:13:54,173,4814,83,90,3144.17,5496.00,0.00
2024-12-08 17:13:54,174,4814,84,90,3126.10,5496.01,0.00
2024-12-08 17:13:54,175,4813,85,90,3063.35,5496.73,0.00
2024-12-08 17:13:55,175,4814,85,90,3144.61,5497.00,0.00
2024-12-08 17:13:55,176,4814,86,90,3126.74,5497.01,0.00
2024-12-08 17:13:55,175,4814,85,90,3139.63,5497.09,0.00
2024-12-08 17:13:55,174,4814,85,89,3152.62,5497.09,0.00
2024-12-08 17:13:55,174,4815,85,89,3160.10,5498.00,0.00
2024-12-08 17:13:55,175,4815,85,90,3142.04,5498.01,0.00
2024-12-08 17:13:55,174,4815,85,89,3148.77,5498.09,0.00
2024-12-08 17:13:55,173,4815,85,88,3166.33,5498.09,0.00
2024-12-08 17:13:55,173,4816,85,88,3148.75,5499.00,0.00
2024-12-08 17:13:55,174,4816,86,88,3130.65,5499.01,0.00
2024-12-08 17:13:55,173,4816,86,87,3141.48,5499.10,0.00
2024-12-08 17:13:55,174,4815,86,88,3114.94,5499.26,0.00
2024-12-08 17:13:55,175,4814,87,88,3094.68,5499.41,0.00
2024-12-08 17:13:55,176,4813,87,89,3079.68,5499.53,0.00
2024-12-08 17:13:55,177,4812,88,89,3064.27,5499.76,0.00
2024-12-08 17:13:55,178,4811,88,90,3051.44,5499.83,0.00
2024-12-08 17:13:55,178,4812,88,90,3078.78,5500.00,0.00
2024-12-08 17:13:55,179,4812,88,91,3061.58,5500.01,0.00
2024-12-08 17:13:55,178,4812,88,90,3071.71,5500.10,0.00
2024-12-08 17:13:55,179,4811,88,91,3049.35,5500.20,0.00
2024-12-08 17:13:55,179,4812,88,91,3208.11,5501.00,0.00
2024-12-08 17:13:55,180,4812,88,92,3190.29,5501.01,0.00
2024-12-08 17:13:55,179,4812,87,92,3186.35,5501.18,0.00
2024-12-08 17:13:55,180,4811,87,93,3149.87,5501.53,0.00
2024-12-08 17:13:55,180,4812,87,93,3199.12,5502.00,0.00
2024-12-08 17:13:55,181,4812,87,94,3181.44,5502.01,0.00
2024-12-08 17:13:55,180,4812,87,93,3194.27,5502.09,0.00
2024-12-08 17:13:55,179,4812,86,93,3185.28,5502.58,0.00
2024-12-08 17:13:55,180,4811,86,94,3165.16,5502.63,0.00
2024-12-08 17:13:55,180,4812,86,94,3210.40,5503.00,0.00
2024-12-08 17:13:55,181,4812,86,95,3192.66,5503.01,0.00
2024-12-08 17:13:55,182,4811,87,95,3121.97,5503.77,0.00
2024-12-08 17:13:55,182,4812,87,95,3170.86,5504.00,0.00
2024-12-08 17:13:55,183,4812,88,95,3153.53,5504.01,0.00
2024-12-08 17:13:55,184,4811,88,96,3085.28,5504.73,0.00
2024-12-08 17:13:55,184,4812,88,96,3138.46,5505.00,0.00
2024-12-08 17:13:55,185,4812,89,96,3121.50,5505.01,0.00
2024-12-08 17:13:55,184,4812,88,96,3135.20,5505.06,0.00
2024-12-08 17:13:55,183,4812,88,95,3149.33,5505.09,0.00
2024-12-08 17:13:55,183,4813,88,95,3153.78,5506.00,0.00
2024-12-08 17:13:55,184,4813,89,95,3136.64,5506.01,0.00
2024-12-08 17:13:55,183,4813,89,94,3148.40,5506.09,0.00
2024-12-08 17:13:55,182,4813,88,94,3159.07,5506.20,0.00
2024-12-08 17:13:55,183,4812,89,94,3139.71,5506.25,0.00
2024-12-08 17:13:55,182,4812,88,94,3161.51,5506.25,0.00
2024-12-08 17:13:55,183,4811,88,95,3133.49,5506.46,0.00
2024-12-08 17:13:55,184,4810,89,95,3108.96,5506.89,0.00
2024-12-08 17:13:55,184,4811,89,95,3135.71,5507.00,0.00
2024-12-08 17:13:55,185,4811,90,95,3118.76,5507.01,0.00
2024-12-08 17:13:55,184,4811,90,94,3129.46,5507.09,0.00
2024-12-08 17:13:55,185,4810,91,94,3085.61,5507.49,0.00
2024-12-08 17:13:55,185,4811,91,94,3197.33,5508.00,0.00
2024-12-08 17:13:55,186,4811,91,95,3180.14,5508.01,0.00
2024-12-08 17:13:55,185,4811,91,94,3189.92,5508.10,0.00
2024-12-08 17:13:55,184,4811,90,94,3191.46,5508.31,0.00
2024-12-08 17:13:55,183,4811,89,94,3193.70,5508.58,0.00
2024-12-08 17:13:55,184,4810,90,94,3176.05,5508.60,0.00
2024-12-08 17:13:56,184,4811,90,94,3226.79,5509.00,0.00
2024-12-08 17:13:56,185,4811,91,94,3209.35,5509.01,0.00
2024-12-08 17:13:56,184,4811,90,94,3222.34,5509.08,0.00
2024-12-08 17:13:56,184,4812,90,94,3220.19,5510.00,0.00
2024-12-08 17:13:56,185,4812,90,95,3202.79,5510.01,0.00
2024-12-08 17:13:56,186,4811,91,95,3159.04,5510.39,0.00
2024-12-08 17:13:56,186,4812,91,95,3160.66,5511.00,0.00
2024-12-08 17:13:56,187,4812,92,95,3143.76,5511.01,0.00
2024-12-08 17:13:56,186,4812,91,95,3156.25,5511.08,0.00
2024-12-08 17:13:56,187,4811,92,95,3086.52,5511.95,0.00
2024-12-08 17:13:56,187,4812,92,95,3138.14,5512.00,0.00
2024-12-08 17:13:56,188,4812,92,96,3121.45,5512.01,0.00
2024-12-08 17:13:56,187,4812,91,96,3133.75,5512.08,0.00
2024-12-08 17:13:56,186,4812,91,95,3144.97,5512.09,0.00
2024-12-08 17:13:56,186,4813,91,95,3148.48,5513.00,0.00
2024-12-08 17:13:56,187,4813,92,95,3131.64,5513.01,0.00
2024-12-08 17:13:56,186,4813,91,95,3142.58,5513.09,0.00
2024-12-08 17:13:56,185,4813,91,94,3157.78,5513.10,0.00
2024-12-08 17:13:56,185,4814,91,94,3138.35,5514.00,0.00
2024-12-08 17:13:56,186,4814,91,95,3121.48,5514.01,0.00
2024-12-08 17:13:56,187,4813,92,95,3104.49,5514.02,0.00
2024-12-08 17:13:56,186,4813,91,95,3133.35,5514.04,0.00
2024-12-08 17:13:56,185,4813,90,95,3147.62,5514.09,0.00
2024-12-08 17:13:56,184,4813,90,94,3162.93,5514.09,0.00
2024-12-08 17:13:56,184,4814,90,94,3137.39,5515.00,0.00
2024-12-08 17:13:56,185,4814,90,95,3120.44,5515.01,0.00
2024-12-08 17:13:56,184,4814,89,95,3133.23,5515.08,0.00
2024-12-08 17:13:56,183,4814,89,94,3148.54,5515.08,0.00
2024-12-08 17:13:56,183,4815,89,94,3152.70,5516.00,0.00
2024-12-08 17:13:56,184,4815,90,94,3135.56,5516.01,0.00
2024-12-08 17:13:56,183,4815,89,94,3148.51,5516.08,0.00
2024-12-08 17:13:56,182,4815,89,93,3161.56,5516.08,0.00
2024-12-08 17:13:56,183,4814,90,93,3114.39,5516.63,0.00
2024-12-08 17:13:56,183,4815,90,93,3129.75,5517.00,0.00
2024-12-08 17:13:56,184,4815,90,94,3112.74,5517.01,0.00
2024-12-08 17:13:56,183,4815,89,94,3113.54,5517.19,0.00
2024-12-08 17:13:56,184,4814,89,95,3081.15,5517.48,0.00
2024-12-08 17:13:56,184,4815,89,95,3122.01,5518.00,0.00
2024-12-08 17:13:56,185,4815,90,95,3105.13,5518.01,0.00
2024-12-08 17:13:56,186,4814,91,95,3051.88,5518.58,0.00
2024-12-08 17:13:56,186,4815,91,95,3094.93,5519.00,0.00
2024-12-08 17:13:56,187,4815,92,95,3078.38,5519.01,0.00
2024-12-08 17:13:56,186,4815,92,94,3084.28,5519.09,0.00
2024-12-08 17:13:56,185,4815,91,94,3095.31,5519.20,0.00
2024-12-08 17:13:56,184,4815,90,94,3101.72,5519.39,0.00
2024-12-08 17:13:56,184,4816,90,94,3122.24,5520.00,0.00
2024-12-08 17:13:56,185,4816,90,95,3105.36,5520.01,0.00
2024-12-08 17:13:56,184,4816,90,94,3115.97,5520.09,0.00
2024-12-08 17:13:57,184,4817,90,94,3090.40,5521.00,0.00
2024-12-08 17:13:57,185,4817,91,94,3073.69,5521.01,0.00
2024-12-08 17:13:57,184,4817,91,93,3083.23,5521.10,0.00
2024-12-08 17:13:57,183,4817,90,93,3094.96,5521.14,0.00
2024-12-08 17:13:57,182,4817,89,93,3108.95,5521.19,0.00
2024-12-08 17:13:57,182,4818,89,93,3095.19,5522.00,0.00
2024-12-08 17:13:57,183,4818,90,93,3078.28,5522.01,0.00
2024-12-08 17:13:57,182,4818,89,93,3090.67,5522.08,0.00
2024-12-08 17:13:57,181,4818,88,93,3081.64,5522.43,0.00
2024-12-08 17:13:57,182,4817,88,94,3045.20,5522.79,0.00
2024-12-08 17:13:57,182,4818,88,94,3070.87,5523.00,0.00
2024-12-08 17:13:57,183,4818,88,95,3054.09,5523.01,0.00
2024-12-08 17:13:57,182,4818,87,95,3066.35,5523.08,0.00
2024-12-08 17:13:57,182,4819,87,95,3064.74,5524.00,0.00
2024-12-08 17:13:57,183,4819,88,95,3048.00,5524.01,0.00
2024-12-08 17:13:57,184,4818,89,95,3016.77,5524.17,0.00
2024-12-08 17:13:57,184,4819,89,95,3007.96,5525.00,0.00
2024-12-08 17:13:57,185,4819,89,96,2991.70,5525.01,0.00
2024-12-08 17:13:57,184,4819,89,95,2997.48,5525.08,0.00
2024-12-08 17:13:57,185,4818,89,96,2974.14,5525.22,0.00
2024-12-08 17:13:57,186,4817,90,96,2979.27,5525.27,0.00
2024-12-08 17:13:57,186,4818,90,96,2999.35,5526.00,0.00
2024-12-08 17:13:57,187,4818,90,97,2983.31,5526.01,0.00
2024-12-08 17:13:57,186,4818,89,97,2955.91,5526.62,0.00
2024-12-08 17:13:57,186,4819,89,97,3018.29,5527.00,0.00
2024-12-08 17:13:57,187,4819,89,98,3002.15,5527.01,0.00
2024-12-08 17:13:57,186,4819,89,97,3010.29,5527.08,0.00
2024-12-08 17:13:57,186,4820,89,97,2983.44,5528.00,0.00
2024-12-08 17:13:57,187,4820,90,97,2967.49,5528.01,0.00
2024-12-08 17:13:57,188,4819,90,98,2951.70,5528.02,0.00
2024-12-08 17:13:57,188,4820,90,98,2926.05,5529.00,0.00
2024-12-08 17:13:57,189,4820,90,99,2910.56,5529.01,0.00
2024-12-08 17:13:57,188,4820,90,98,2919.90,5529.09,0.00
2024-12-08 17:13:57,187,4820,90,97,2934.92,5529.09,0.00
2024-12-08 17:13:57,186,4820,90,96,2950.40,5529.09,0.00
2024-12-08 17:13:57,186,4821,90,96,2953.76,5530.00,0.00
2024-12-08 17:13:57,187,4821,90,97,2937.97,5530.01,0.00
2024-12-08 17:13:57,186,4821,90,96,2942.79,5530.09,0.00
2024-12-08 17:13:57,186,4822,90,96,2916.76,5531.00,0.00
2024-12-08 17:13:57,187,4822,90,97,2901.16,5531.01,0.00
2024-12-08 17:13:57,186,4822,89,97,2913.21,5531.06,0.00
2024-12-08 17:13:57,185,4822,89,96,2925.67,5531.08,0.00
2024-12-08 17:13:57,184,4822,88,96,2938.58,5531.13,0.00
2024-12-08 17:13:57,184,4823,88,96,2914.72,5532.00,0.00
2024-12-08 17:13:57,185,4823,89,96,2898.97,5532.01,0.00
2024-12-08 17:13:57,184,4823,89,95,2904.82,5532.08,0.00
2024-12-08 17:13:58,184,4824,89,95,2878.26,5533.00,0.00
2024-12-08 17:13:58,185,4824,90,95,2862.70,5533.01,0.00
2024-12-08 17:13:58,184,4824,90,94,2867.76,5533.08,0.00
2024-12-08 17:13:58,185,4823,91,94,2840.37,5533.31,0.00
2024-12-08 17:13:58,184,4823,90,94,2869.40,5533.46,0.00
2024-12-08 17:13:58,185,4822,90,95,2836.72,5533.78,0.00
2024-12-08 17:13:58,185,4823,90,95,2854.84,5534.00,0.00
2024-12-08 17:13:58,186,4823,91,95,2839.49,5534.01,0.00
2024-12-08 17:13:58,185,4823,90,95,2853.96,5534.02,0.00
2024-12-08 17:13:58,184,4823,90,94,2865.87,5534.08,0.00
2024-12-08 17:13:58,185,4822,91,94,2847.40,5534.14,0.00
2024-12-08 17:13:58,184,4822,90,94,2881.87,5534.23,0.00
2024-12-08 17:13:58,185,4821,91,94,2853.52,5534.48,0.00
2024-12-08 17:13:58,184,4821,90,94,2870.31,5534.61,0.00
2024-12-08 17:13:58,184,4822,90,94,2939.46,5535.00,0.00
2024-12-08 17:13:58,185,4822,91,94,2923.57,5535.01,0.00
2024-12-08 17:13:58,184,4822,90,94,2936.77,5535.05,0.00
2024-12-08 17:13:58,183,4822,90,93,2945.26,5535.07,0.00
2024-12-08 17:13:58,182,4822,90,92,2960.84,5535.08,0.00
2024-12-08 17:13:58,183,4821,91,92,2909.27,5535.73,0.00
2024-12-08 17:13:58,183,4822,91,92,2988.13,5536.00,0.00
2024-12-08 17:13:58,184,4822,91,93,2971.89,5536.01,0.00
2024-12-08 17:13:58,185,4821,91,94,2939.13,5536.21,0.00
2024-12-08 17:13:58,184,4821,90,94,2978.29,5536.24,0.00
2024-12-08 17:13:58,183,4821,89,94,2994.56,5536.24,0.00
2024-12-08 17:13:58,183,4822,89,94,3007.43,5537.00,0.00
2024-12-08 17:13:58,184,4822,89,95,2991.08,5537.01,0.00
2024-12-08 17:13:58,183,4822,88,95,3005.93,5537.03,0.00
2024-12-08 17:13:58,182,4822,88,94,3017.58,5537.06,0.00
2024-12-08 17:13:58,181,4822,87,94,3033.64,5537.07,0.00
2024-12-08 17:13:58,182,4821,87,95,2991.61,5537.54,0.00
2024-12-08 17:13:58,181,4821,86,95,3019.50,5537.60,0.00
2024-12-08 17:13:58,182,4820,87,95,3000.50,5537.65,0.00
2024-12-08 17:13:58,183,4819,88,95,2984.16,5537.73,0.00
2024-12-08 17:13:58,183,4820,88,95,3033.09,5538.00,0.00
2024-12-08 17:13:58,184,4820,89,95,3016.60,5538.01,0.00
2024-12-08 17:13:58,185,4819,89,96,2980.04,5538.28,0.00
2024-12-08 17:13:58,186,4818,89,97,2958.24,5538.65,0.00
2024-12-08 17:13:58,186,4819,89,97,3068.98,5539.00,0.00
2024-12-08 17:13:58,187,4819,90,97,3052.57,5539.01,0.00
2024-12-08 17:13:58,186,4819,89,97,3067.21,5539.03,0.00
2024-12-08 17:13:58,185,4819,89,96,3079.60,5539.05,0.00
2024-12-08 17:13:58,184,4819,88,96,3095.74,5539.06,0.00
2024-12-08 17:13:58,185,4818,88,97,3066.82,5539.29,0.00
2024-12-08 17:13:58,184,4818,87,97,3085.60,5539.32,0.00
2024-12-08 17:13:58,184,4819,87,97,3138.43,5540.00,0.00
2024-12-08 17:13:58,185,4819,87,98,3121.46,5540.01,0.00
2024-12-08 17:13:58,184,4819,87,97,3135.14,5540.06,0.00
2024-12-08 17:13:58,184,4820,87,97,3137.79,5541.00,0.00
2024-12-08 17:13:58,185,4820,88,97,3120.83,5541.01,0.00
2024-12-08 17:13:58,184,4820,87,97,3134.50,5541.06,0.00
2024-12-08 17:13:58,185,4819,88,97,3107.99,5541.14,0.00
2024-12-08 17:13:58,184,4819,87,97,3125.60,5541.41,0.00
2024-12-08 17:13:58,185,4818,87,98,3103.96,5541.51,0.00
2024-12-08 17:13:58,185,4819,87,98,3116.00,5542.00,0.00
2024-12-08 17:13:58,186,4819,88,98,3099.25,5542.01,0.00
2024-12-08 17:13:58,185,4819,87,98,3113.62,5542.04,0.00
2024-12-08 17:13:58,186,4818,88,98,3064.60,5542.53,0.00
2024-12-08 17:13:58,186,4819,88,98,3133.93,5543.00,0.00
2024-12-08 17:13:58,187,4819,89,98,3117.17,5543.01,0.00
2024-12-08 17:13:58,186,4819,89,97,3126.21,5543.05,0.00
2024-12-08 17:13:58,185,4819,89,96,3142.21,5543.07,0.00
2024-12-08 17:13:58,186,4818,89,97,3115.85,5543.25,0.00
2024-12-08 17:13:59,186,4819,89,97,3148.14,5544.00,0.00
2024-12-08 17:13:59,187,4819,89,98,3131.30,5544.01,0.00
2024-12-08 17:13:59,188,4818,89,99,3089.09,5544.27,0.00
2024-12-08 17:13:59,189,4817,90,99,3079.57,5544.68,0.00
2024-12-08 17:13:59,189,4818,90,99,3138.31,5545.00,0.00
2024-12-08 17:13:59,190,4818,90,100,3121.79,5545.01,0.00
2024-12-08 17:13:59,189,4818,90,99,3134.81,5545.05,0.00
2024-12-08 17:13:59,190,4817,91,99,3096.24,5545.36,0.00
2024-12-08 17:13:59,190,4818,91,99,3167.72,5546.00,0.00
2024-12-08 17:13:59,191,4818,92,99,3151.13,5546.01,0.00
2024-12-08 17:13:59,190,4818,92,98,3162.49,5546.06,0.00
2024-12-08 17:13:59,189,4818,92,97,3178.64,5546.06,0.00
2024-12-08 17:13:59,190,4817,93,97,3159.00,5546.13,0.00
2024-12-08 17:13:59,190,4818,93,97,3182.11,5547.00,0.00
2024-12-08 17:13:59,191,4818,93,98,3165.45,5547.01,0.00
2024-12-08 17:13:59,190,4818,92,98,3178.63,5547.06,0.00
2024-12-08 17:13:59,189,4818,92,97,3194.57,5547.06,0.00
2024-12-08 17:13:59,188,4818,91,97,3203.07,5547.22,0.00
2024-12-08 17:13:59,189,4817,91,98,3148.77,5547.78,0.00
2024-12-08 17:13:59,189,4818,91,98,3201.29,5548.00,0.00
2024-12-08 17:13:59,190,4818,92,98,3184.45,5548.01,0.00
2024-12-08 17:13:59,189,4818,92,97,3188.40,5548.06,0.00
2024-12-08 17:13:59,189,4819,92,97,3190.70,5549.00,0.00
2024-12-08 17:13:59,190,4819,93,97,3173.91,5549.01,0.00
2024-12-08 17:13:59,189,4819,93,96,3186.91,5549.06,0.00
2024-12-08 17:13:59,189,4820,93,96,3150.96,5550.00,0.00
2024-12-08 17:13:59,190,4820,93,97,3134.38,5550.01,0.00
2024-12-08 17:13:59,189,4820,93,96,3148.92,5550.04,0.00
2024-12-08 17:13:59,190,4819,94,96,3079.53,5550.83,0.00
2024-12-08 17:13:59,190,4820,94,96,3092.64,5551.00,0.00
2024-12-08 17:13:59,191,4820,94,97,3076.45,5551.01,0.00
2024-12-08 17:13:59,190,4820,94,96,3088.58,5551.07,0.00
2024-12-08 17:13:59,191,4819,94,97,3025.71,5551.86,0.00
2024-12-08 17:13:59,191,4820,94,97,3069.98,5552.00,0.00
2024-12-08 17:13:59,192,4820,94,98,3053.99,5552.01,0.00
2024-12-08 17:13:59,193,4819,94,99,3022.71,5552.19,0.00
2024-12-08 17:13:59,193,4820,94,99,3026.00,5553.00,0.00
2024-12-08 17:13:59,194,4820,94,100,3010.40,5553.01,0.00
2024-12-08 17:13:59,194,4821,94,100,2996.45,5554.00,0.00
2024-12-08 17:13:59,195,4821,95,100,2981.08,5554.01,0.00
2024-12-08 17:13:59,194,4821,94,100,2984.75,5554.11,0.00
2024-12-08 17:13:59,193,4821,94,99,2999.93,5554.11,0.00
2024-12-08 17:13:59,193,4822,94,99,2969.42,5555.00,0.00
2024-12-08 17:13:59,194,4822,95,99,2954.12,5555.01,0.00
2024-12-08 17:13:59,193,4822,95,98,2956.82,5555.11,0.00
2024-12-08 17:13:59,192,4822,94,98,2966.38,5555.18,0.00
2024-12-08 17:14:00,192,4823,94,98,2943.02,5556.00,0.00
2024-12-08 17:14:00,193,4823,94,99,2927.77,5556.01,0.00
2024-12-08 17:14:00,192,4823,94,98,2935.32,5556.08,0.00
2024-12-08 17:14:00,193,4822,94,99,2915.25,5556.18,0.00
2024-12-08 17:14:00,193,4823,94,99,2896.79,5557.00,0.00
2024-12-08 17:14:00,194,4823,94,100,2881.86,5557.01,0.00
2024-12-08 17:14:00,193,4823,94,99,2888.48,5557.09,0.00
2024-12-08 17:14:00,192,4823,93,99,2891.70,5557.22,0.00
2024-12-08 17:14:00,193,4822,94,99,2840.76,5557.88,0.00
2024-12-08 17:14:00,193,4823,94,99,2895.19,5558.00,0.00
2024-12-08 17:14:00,194,4823,95,99,2880.27,5558.01,0.00
2024-12-08 17:14:00,193,4823,94,99,2894.52,5558.02,0.00
2024-12-08 17:14:00,192,4823,93,99,2908.44,5558.03,0.00
2024-12-08 17:14:00,193,4822,94,99,2892.80,5558.05,0.00
2024-12-08 17:14:00,192,4822,93,99,2913.98,5558.10,0.00
2024-12-08 17:14:00,191,4822,92,99,2919.97,5558.27,0.00
2024-12-08 17:14:00,191,4823,92,99,2931.63,5559.00,0.00
2024-12-08 17:14:00,192,4823,92,100,2916.36,5559.01,0.00
2024-12-08 17:14:00,191,4823,92,99,2920.04,5559.10,0.00
2024-12-08 17:14:00,192,4822,93,99,2897.05,5559.26,0.00
2024-12-08 17:14:00,191,4822,92,99,2909.66,5559.42,0.00
2024-12-08 17:14:00,190,4822,91,99,2924.39,5559.43,0.00
2024-12-08 17:14:00,191,4821,91,100,2890.07,5559.79,0.00
2024-12-08 17:14:00,191,4822,91,100,2936.77,5560.00,0.00
2024-12-08 17:14:00,192,4822,91,101,2921.47,5560.01,0.00
2024-12-08 17:14:00,191,4822,91,100,2930.69,5560.08,0.00
2024-12-08 17:14:00,190,4822,91,99,2944.37,5560.11,0.00
2024-12-08 17:14:00,190,4823,91,99,2977.05,5561.00,0.00
2024-12-08 17:14:00,191,4823,92,99,2961.46,5561.01,0.00
2024-12-08 17:14:00,190,4823,91,99,2965.39,5561.11,0.00
2024-12-08 17:14:00,191,4822,91,100,2899.50,5561.92,0.00
2024-12-08 17:14:00,191,4823,91,100,2926.95,5562.00,0.00
2024-12-08 17:14:00,192,4823,92,100,2911.70,5562.01,0.00
2024-12-08 17:14:00,191,4823,92,99,2916.79,5562.08,0.00
2024-12-08 17:14:00,190,4823,91,99,2930.69,5562.11,0.00
2024-12-08 17:14:00,190,4824,91,99,2933.78,5563.00,0.00
2024-12-08 17:14:00,191,4824,91,100,2918.42,5563.01,0.00
2024-12-08 17:14:00,190,4824,91,99,2922.11,5563.11,0.00
2024-12-08 17:14:00,190,4825,91,99,2894.91,5564.00,0.00
2024-12-08 17:14:00,191,4825,92,99,2879.75,5564.01,0.00
2024-12-08 17:14:00,190,4825,91,99,2882.95,5564.11,0.00
2024-12-08 17:14:00,191,4824,91,100,2839.94,5564.62,0.00
2024-12-08 17:14:00,192,4823,91,101,2849.25,5564.71,0.00
2024-12-08 17:14:00,192,4824,91,101,2854.59,5565.00,0.00
2024-12-08 17:14:00,193,4824,92,101,2839.80,5565.01,0.00
2024-12-08 17:14:00,194,4823,93,101,2814.30,5565.11,0.00
2024-12-08 17:14:00,193,4823,93,100,2778.68,5565.90,0.00
2024-12-08 17:14:00,193,4824,93,100,2853.74,5566.00,0.00
2024-12-08 17:14:00,194,4824,93,101,2839.03,5566.01,0.00
2024-12-08 17:14:00,195,4823,93,102,2824.47,5566.02,0.00
2024-12-08 17:14:00,196,4822,93,103,2818.88,5566.06,0.00
2024-12-08 17:14:00,195,4822,93,102,2830.79,5566.10,0.00
2024-12-08 17:14:00,194,4822,92,102,2804.11,5566.84,0.00
2024-12-08 17:14:01,194,4823,92,102,2847.00,5567.00,0.00
2024-12-08 17:14:01,195,4823,93,102,2832.40,5567.01,0.00
2024-12-08 17:14:01,194,4823,92,102,2845.58,5567.03,0.00
2024-12-08 17:14:01,193,4823,92,101,2851.12,5567.08,0.00
2024-12-08 17:14:01,192,4823,92,100,2864.53,5567.10,0.00
2024-12-08 17:14:01,191,4823,92,99,2879.24,5567.10,0.00
2024-12-08 17:14:01,191,4824,92,99,2911.48,5568.00,0.00
2024-12-08 17:14:01,192,4824,93,99,2896.31,5568.01,0.00
2024-12-08 17:14:01,192,4825,93,99,2858.78,5569.00,0.00
2024-12-08 17:14:01,193,4825,94,99,2843.97,5569.01,0.00
2024-12-08 17:14:01,192,4825,94,98,2847.23,5569.11,0.00
2024-12-08 17:14:01,191,4825,94,97,2861.85,5569.11,0.00
2024-12-08 17:14:01,190,4825,94,96,2876.62,5569.11,0.00
2024-12-08 17:14:01,190,4826,94,96,2850.27,5570.00,0.00
2024-12-08 17:14:01,191,4826,95,96,2835.34,5570.01,0.00
2024-12-08 17:14:01,190,4826,95,95,2844.16,5570.11,0.00
2024-12-08 17:14:01,189,4826,95,94,2858.91,5570.11,0.00
2024-12-08 17:14:01,188,4826,94,94,2872.19,5570.14,0.00
2024-12-08 17:14:01,188,4827,94,94,2848.65,5571.00,0.00
2024-12-08 17:14:01,189,4827,94,95,2833.57,5571.01,0.00
2024-12-08 17:14:01,188,4827,94,94,2842.47,5571.11,0.00
2024-12-08 17:14:01,187,4827,93,94,2845.19,5571.24,0.00
2024-12-08 17:14:01,188,4826,93,95,2827.40,5571.29,0.00
2024-12-08 17:14:01,188,4827,93,95,2826.34,5572.00,0.00
2024-12-08 17:14:01,189,4827,94,95,2811.38,5572.01,0.00
2024-12-08 17:14:01,188,4827,94,94,2820.16,5572.11,0.00
2024-12-08 17:14:01,187,4827,94,93,2834.65,5572.12,0.00
2024-12-08 17:14:01,188,4826,95,93,2783.03,5572.68,0.00
2024-12-08 17:14:01,188,4827,95,93,2830.70,5573.00,0.00
2024-12-08 17:14:01,189,4827,96,93,2815.72,5573.01,0.00
2024-12-08 17:14:01,190,4826,97,93,2798.57,5573.06,0.00
2024-12-08 17:14:01,191,4825,97,94,2758.44,5573.80,0.00
2024-12-08 17:14:01,191,4826,97,94,2806.76,5574.00,0.00
2024-12-08 17:14:01,192,4826,98,94,2792.14,5574.01,0.00
2024-12-08 17:14:01,191,4826,98,93,2799.22,5574.11,0.00
2024-12-08 17:14:01,190,4826,98,92,2813.37,5574.12,0.00
2024-12-08 17:14:01,189,4826,97,92,2801.87,5574.59,0.00
2024-12-08 17:14:01,188,4826,96,92,2810.89,5574.68,0.00
2024-12-08 17:14:01,188,4827,96,92,2876.37,5575.00,0.00
2024-12-08 17:14:01,189,4827,96,93,2861.15,5575.01,0.00
2024-12-08 17:14:01,188,4827,96,92,2872.84,5575.06,0.00
2024-12-08 17:14:01,187,4827,96,91,2879.28,5575.11,0.00
2024-12-08 17:14:01,188,4826,97,91,2835.97,5575.63,0.00
2024-12-08 17:14:01,188,4827,97,91,2848.63,5576.00,0.00
2024-12-08 17:14:01,189,4827,97,92,2833.55,5576.01,0.00
2024-12-08 17:14:01,188,4827,96,92,2829.42,5576.25,0.00
2024-12-08 17:14:01,188,4828,96,92,2839.13,5577.00,0.00
2024-12-08 17:14:01,189,4828,97,92,2824.11,5577.01,0.00
2024-12-08 17:14:01,190,4827,98,92,2806.34,5577.07,0.00
2024-12-08 17:14:01,191,4826,99,92,2809.48,5577.10,0.00
2024-12-08 17:14:01,190,4826,99,91,2834.84,5577.12,0.00
2024-12-08 17:14:01,189,4826,98,91,2831.05,5577.46,0.00
2024-12-08 17:14:01,189,4827,98,91,2822.44,5578.00,0.00
2024-12-08 17:14:02,190,4827,99,91,2807.58,5578.01,0.00
2024-12-08 17:14:02,189,4827,99,90,2810.10,5578.12,0.00
2024-12-08 17:14:02,188,4827,98,90,2822.98,5578.13,0.00
2024-12-08 17:14:02,188,4828,98,90,2862.61,5579.00,0.00
2024-12-08 17:14:02,189,4828,99,90,2847.46,5579.01,0.00
2024-12-08 17:14:02,190,4827,100,90,2817.27,5579.18,0.00
2024-12-08 17:14:02,189,4827,99,90,2844.36,5579.45,0.00
2024-12-08 17:14:02,189,4828,99,90,2837.02,5580.00,0.00
2024-12-08 17:14:02,190,4828,99,91,2822.09,5580.01,0.00
2024-12-08 17:14:02,189,4828,98,91,2836.14,5580.02,0.00
2024-12-08 17:14:02,188,4828,98,90,2839.11,5580.12,0.00
2024-12-08 17:14:02,188,4829,98,90,2844.01,5581.00,0.00
2024-12-08 17:14:02,189,4829,98,91,2828.97,5581.01,0.00
2024-12-08 17:14:02,188,4829,98,90,2837.24,5581.10,0.00
2024-12-08 17:14:02,188,4830,98,90,2811.27,5582.00,0.00
2024-12-08 17:14:02,189,4830,98,91,2796.40,5582.01,0.00
2024-12-08 17:14:02,188,4830,98,90,2792.92,5582.12,0.00
2024-12-08 17:14:02,187,4830,98,89,2807.55,5582.12,0.00
2024-12-08 17:14:02,187,4831,98,89,2788.59,5583.00,0.00
2024-12-08 17:14:02,188,4831,98,90,2773.76,5583.01,0.00
2024-12-08 17:14:02,187,4831,98,89,2778.79,5583.11,0.00
2024-12-08 17:14:02,186,4831,98,88,2793.13,5583.11,0.00
2024-12-08 17:14:02,185,4831,98,87,2807.93,5583.11,0.00
2024-12-08 17:14:02,186,4830,99,87,2759.98,5583.61,0.00
2024-12-08 17:14:02,186,4831,99,87,2781.57,5584.00,0.00
2024-12-08 17:14:02,187,4831,99,88,2766.70,5584.01,0.00
2024-12-08 17:14:02,186,4831,99,87,2775.32,5584.11,0.00
2024-12-08 17:14:02,185,4831,99,86,2789.72,5584.11,0.00
2024-12-08 17:14:02,186,4830,99,87,2770.84,5584.19,0.00
2024-12-08 17:14:02,185,4830,98,87,2791.08,5584.42,0.00
2024-12-08 17:14:02,185,4831,98,87,2819.53,5585.00,0.00
2024-12-08 17:14:02,186,4831,98,88,2804.37,5585.01,0.00
2024-12-08 17:14:02,185,4831,98,87,2812.94,5585.11,0.00
2024-12-08 17:14:02,185,4832,98,87,2817.83,5586.00,0.00
2024-12-08 17:14:02,186,4832,98,88,2802.68,5586.01,0.00
2024-12-08 17:14:02,185,4832,97,88,2796.18,5586.28,0.00
2024-12-08 17:14:02,186,4831,98,88,2773.08,5586.44,0.00
2024-12-08 17:14:02,185,4831,97,88,2799.22,5586.57,0.00
2024-12-08 17:14:02,185,4832,97,88,2799.10,5587.00,0.00
2024-12-08 17:14:02,186,4832,97,89,2784.06,5587.01,0.00
2024-12-08 17:14:02,187,4831,98,89,2765.91,5587.08,0.00
2024-12-08 17:14:02,186,4831,97,89,2804.23,5587.12,0.00
2024-12-08 17:14:02,185,4831,96,89,2803.13,5587.30,0.00
2024-12-08 17:14:02,185,4832,96,89,2818.33,5588.00,0.00
2024-12-08 17:14:02,186,4832,97,89,2803.17,5588.01,0.00
2024-12-08 17:14:02,185,4832,97,88,2805.69,5588.12,0.00
2024-12-08 17:14:02,185,4833,97,88,2811.12,5589.00,0.00
2024-12-08 17:14:02,186,4833,98,88,2796.01,5589.01,0.00
2024-12-08 17:14:02,187,4832,99,88,2760.82,5589.27,0.00
2024-12-08 17:14:02,186,4832,98,88,2782.03,5589.45,0.00
2024-12-08 17:14:02,186,4833,98,88,2775.42,5590.00,0.00
2024-12-08 17:14:02,187,4833,99,88,2760.57,5590.01,0.00
2024-12-08 17:14:02,186,4833,98,88,2773.32,5590.04,0.00
2024-12-08 17:14:02,185,4833,98,87,2781.40,5590.11,0.00
2024-12-08 17:14:02,184,4833,98,86,2795.91,5590.11,0.00
2024-12-08 17:14:02,183,4833,97,86,2810.58,5590.12,0.00
2024-12-08 17:14:03,182,4833,96,86,2797.33,5590.64,0.00
2024-12-08 17:14:03,182,4834,96,86,2832.61,5591.00,0.00
2024-12-08 17:14:03,183,4834,97,86,2817.13,5591.01,0.00
2024-12-08 17:14:03,182,4834,97,85,2819.76,5591.12,0.00
2024-12-08 17:14:03,183,4833,98,85,2767.51,5591.68,0.00
2024-12-08 17:14:03,183,4834,98,85,2790.97,5592.00,0.00
2024-12-08 17:14:03,184,4834,98,86,2775.80,5592.01,0.00
2024-12-08 17:14:03,183,4834,97,86,2778.19,5592.12,0.00
2024-12-08 17:14:03,182,4834,97,85,2793.15,5592.12,0.00
2024-12-08 17:14:03,183,4833,97,86,2773.93,5592.20,0.00
2024-12-08 17:14:03,182,4833,96,86,2811.93,5592.29,0.00
2024-12-08 17:14:03,182,4834,96,86,2827.69,5593.00,0.00
2024-12-08 17:14:03,183,4834,97,86,2812.24,5593.01,0.00
2024-12-08 17:14:03,182,4834,97,85,2820.67,5593.12,0.00
2024-12-08 17:14:03,183,4833,98,85,2788.41,5593.43,0.00
2024-12-08 17:14:03,182,4833,97,85,2821.87,5593.43,0.00
2024-12-08 17:14:03,182,4834,97,85,2845.04,5594.00,0.00
2024-12-08 17:14:03,183,4834,97,86,2829.49,5594.01,0.00
2024-12-08 17:14:03,182,4834,96,86,2837.39,5594.07,0.00
2024-12-08 17:14:03,182,4835,96,86,2839.11,5595.00,0.00
2024-12-08 17:14:03,183,4835,96,87,2823.60,5595.01,0.00
2024-12-08 17:14:03,182,4835,95,87,2838.19,5595.02,0.00
2024-12-08 17:14:03,181,4835,94,87,2831.38,5595.24,0.00
2024-12-08 17:14:03,181,4836,94,87,2816.61,5596.00,0.00
2024-12-08 17:14:03,182,4836,94,88,2801.14,5596.01,0.00
2024-12-08 17:14:03,181,4836,93,88,2812.02,5596.08,0.00
2024-12-08 17:14:03,182,4835,94,88,2796.26,5596.10,0.00
2024-12-08 17:14:03,181,4835,93,88,2832.44,5596.12,0.00
2024-12-08 17:14:03,182,4834,94,88,2811.97,5596.22,0.00
2024-12-08 17:14:03,182,4835,94,88,2791.22,5597.00,0.00
2024-12-08 17:14:03,183,4835,94,89,2775.97,5597.01,0.00
2024-12-08 17:14:03,182,4835,94,88,2786.04,5597.09,0.00
2024-12-08 17:14:03,181,4835,94,87,2796.49,5597.10,0.00
2024-12-08 17:14:03,180,4835,93,87,2811.40,5597.11,0.00
2024-12-08 17:14:03,179,4835,92,87,2817.76,5597.27,0.00
2024-12-08 17:14:03,178,4835,92,86,2817.39,5597.52,0.00
2024-12-08 17:14:03,178,4836,92,86,2860.88,5598.00,0.00
2024-12-08 17:14:03,179,4836,92,87,2844.89,5598.01,0.00
2024-12-08 17:14:03,180,4835,93,87,2825.09,5598.09,0.00
2024-12-08 17:14:03,179,4835,93,86,2862.78,5598.11,0.00
2024-12-08 17:14:03,178,4835,92,86,2868.83,5598.29,0.00
2024-12-08 17:14:03,179,4834,93,86,2840.10,5598.49,0.00
2024-12-08 17:14:03,178,4834,92,86,2829.91,5598.96,0.00
2024-12-08 17:14:03,178,4835,92,86,2852.90,5599.00,0.00
2024-12-08 17:14:03,179,4835,93,86,2836.97,5599.01,0.00
2024-12-08 17:14:03,180,4834,94,86,2821.21,5599.02,0.00
2024-12-08 17:14:03,179,4834,93,86,2835.15,5599.11,0.00
2024-12-08 17:14:03,178,4834,93,85,2850.76,5599.11,0.00
2024-12-08 17:14:03,177,4834,93,84,2866.55,5599.11,0.00
2024-12-08 17:14:03,176,4834,92,84,2867.28,5599.27,0.00
2024-12-08 17:14:03,176,4835,92,84,2917.78,5600.00,0.00
2024-12-08 17:14:03,177,4835,92,85,2901.29,5600.01,0.00
2024-12-08 17:14:03,176,4835,92,84,2905.11,5600.11,0.00
2024-12-08 17:14:03,177,4834,92,85,2839.68,5600.83,0.00
2024-12-08 17:14:03,177,4835,92,85,2893.92,5601.00,0.00
2024-12-08 17:14:03,178,4835,92,86,2877.66,5601.01,0.00
2024-12-08 17:14:03,177,4835,92,85,2881.00,5601.12,0.00
2024-12-08 17:14:03,177,4836,92,85,2880.59,5602.00,0.00
2024-12-08 17:14:03,178,4836,92,86,2864.40,5602.01,0.00
2024-12-08 17:14:03,177,4836,92,85,2874.31,5602.10,0.00
2024-12-08 17:14:03,176,4836,92,84,2889.38,5602.12,0.00
2024-12-08 17:14:03,175,4836,92,83,2905.57,5602.12,0.00
2024-12-08 17:14:04,174,4836,91,83,2903.46,5602.43,0.00
2024-12-08 17:14:04,174,4837,91,83,2892.17,5603.00,0.00
2024-12-08 17:14:04,175,4837,91,84,2875.64,5603.01,0.00
2024-12-08 17:14:04,174,4837,91,83,2879.03,5603.12,0.00
2024-12-08 17:14:04,173,4837,90,83,2895.35,5603.12,0.00
2024-12-08 17:14:04,172,4837,89,83,2905.68,5603.24,0.00
2024-12-08 17:14:04,173,4836,90,83,2861.65,5603.67,0.00
2024-12-08 17:14:04,174,4835,90,84,2854.20,5603.70,0.00
2024-12-08 17:14:04,174,4836,90,84,2878.49,5604.00,0.00
2024-12-08 17:14:04,175,4836,91,84,2862.04,5604.01,0.00
2024-12-08 17:14:04,174,4836,90,84,2858.90,5604.12,0.00
2024-12-08 17:14:04,173,4836,90,83,2875.10,5604.12,0.00
2024-12-08 17:14:04,174,4835,90,84,2835.31,5604.48,0.00
2024-12-08 17:14:04,174,4836,90,84,2916.25,5605.00,0.00
2024-12-08 17:14:04,175,4836,91,84,2899.58,5605.01,0.00
2024-12-08 17:14:04,176,4835,92,84,2879.95,5605.07,0.00
2024-12-08 17:14:04,175,4835,92,83,2896.43,5605.11,0.00
2024-12-08 17:14:04,174,4835,91,83,2881.88,5605.60,0.00
2024-12-08 17:14:04,173,4835,91,82,2886.00,5605.80,0.00
2024-12-08 17:14:04,173,4836,91,82,2939.96,5606.00,0.00
2024-12-08 17:14:04,174,4836,92,82,2923.06,5606.01,0.00
2024-12-08 17:14:04,175,4835,92,83,2906.36,5606.02,0.00
2024-12-08 17:14:04,174,4835,92,82,2911.84,5606.13,0.00
2024-12-08 17:14:04,175,4834,93,82,2859.43,5606.62,0.00
2024-12-08 17:14:04,176,4833,94,82,2847.40,5606.74,0.00
2024-12-08 17:14:04,176,4834,94,82,2905.59,5607.00,0.00
2024-12-08 17:14:04,177,4834,94,83,2889.18,5607.01,0.00
2024-12-08 17:14:04,176,4834,93,83,2861.47,5607.57,0.00
2024-12-08 17:14:04,175,4834,92,83,2870.38,5607.63,0.00
2024-12-08 17:14:04,175,4835,92,83,2978.32,5608.00,0.00
2024-12-08 17:14:04,176,4835,92,84,2961.39,5608.01,0.00
2024-12-08 17:14:04,175,4835,92,83,2964.59,5608.13,0.00
2024-12-08 17:14:04,174,4835,91,83,2981.31,5608.13,0.00
2024-12-08 17:14:04,175,4834,92,83,2938.71,5608.59,0.00
2024-12-08 17:14:04,175,4835,92,83,2955.37,5609.00,0.00
2024-12-08 17:14:04,176,4835,92,84,2938.58,5609.01,0.00
2024-12-08 17:14:04,175,4835,92,83,2926.31,5609.40,0.00
2024-12-08 17:14:04,175,4836,92,83,2950.75,5610.00,0.00
2024-12-08 17:14:04,176,4836,93,83,2933.98,5610.01,0.00
2024-12-08 17:14:04,175,4836,93,82,2944.06,5610.11,0.00
2024-12-08 17:14:04,174,4836,93,81,2959.38,5610.13,0.00
2024-12-08 17:14:04,173,4836,92,81,2976.16,5610.13,0.00
2024-12-08 17:14:04,173,4837,92,81,2953.26,5611.00,0.00
2024-12-08 17:14:04,174,4837,93,81,2936.29,5611.01,0.00
2024-12-08 17:14:04,173,4837,92,81,2945.85,5611.13,0.00
2024-12-08 17:14:04,172,4837,92,80,2961.02,5611.15,0.00
2024-12-08 17:14:04,171,4837,91,80,2968.08,5611.19,0.00
2024-12-08 17:14:04,172,4836,92,80,2909.48,5611.95,0.00
2024-12-08 17:14:04,172,4837,92,80,2940.85,5612.00,0.00
2024-12-08 17:14:04,173,4837,93,80,2923.85,5612.01,0.00
2024-12-08 17:14:04,174,4836,93,81,2903.20,5612.09,0.00
2024-12-08 17:14:04,173,4836,93,80,2927.80,5612.14,0.00
2024-12-08 17:14:04,172,4836,93,79,2942.86,5612.15,0.00
2024-12-08 17:14:04,172,4837,93,79,2954.43,5613.00,0.00
2024-12-08 17:14:04,173,4837,93,80,2937.35,5613.01,0.00
2024-12-08 17:14:04,174,4836,94,80,2920.47,5613.02,0.00
2024-12-08 17:14:04,173,4836,93,80,2932.21,5613.14,0.00
2024-12-08 17:14:04,172,4836,93,79,2947.30,5613.15,0.00
2024-12-08 17:14:04,171,4836,92,79,2932.87,5613.60,0.00
2024-12-08 17:14:04,171,4837,92,79,2976.17,5614.00,0.00
2024-12-08 17:14:04,172,4837,93,79,2958.87,5614.01,0.00
2024-12-08 17:14:04,171,4837,92,79,2975.52,5614.01,0.00
2024-12-08 17:14:04,170,4837,91,79,2992.37,5614.02,0.00
2024-12-08 17:14:04,169,4837,90,79,3003.81,5614.12,0.00
2024-12-08 17:14:04,168,4837,90,78,3020.35,5614.13,0.00
2024-12-08 17:14:05,168,4838,90,78,3031.86,5615.00,0.00
2024-12-08 17:14:05,169,4838,91,78,3013.92,5615.01,0.00
2024-12-08 17:14:05,168,4838,90,78,3029.13,5615.01,0.00
2024-12-08 17:14:05,167,4838,90,77,3039.25,5615.12,0.00
2024-12-08 17:14:05,166,4838,89,77,3051.49,5615.22,0.00
2024-12-08 17:14:05,167,4837,90,77,3022.52,5615.43,0.00
2024-12-08 17:14:05,167,4838,90,77,3032.00,5616.00,0.00
2024-12-08 17:14:05,168,4838,90,78,3013.95,5616.01,0.00
2024-12-08 17:14:05,167,4838,90,77,3030.00,5616.04,0.00
2024-12-08 17:14:05,166,4838,90,76,3041.52,5616.11,0.00
2024-12-08 17:14:05,166,4839,90,76,3053.18,5617.00,0.00
2024-12-08 17:14:05,167,4839,90,77,3034.89,5617.01,0.00
2024-12-08 17:14:05,166,4839,90,76,3044.77,5617.11,0.00
2024-12-08 17:14:05,165,4839,89,76,3055.77,5617.24,0.00
2024-12-08 17:14:05,164,4839,88,76,3057.68,5617.42,0.00
2024-12-08 17:14:05,164,4840,88,76,3059.44,5618.00,0.00
2024-12-08 17:14:05,165,4840,89,76,3040.90,5618.01,0.00
2024-12-08 17:14:05,164,4840,89,75,3050.25,5618.12,0.00
2024-12-08 17:14:05,165,4839,89,76,2991.93,5618.85,0.00
2024-12-08 17:14:05,165,4840,89,76,3015.56,5619.00,0.00
2024-12-08 17:14:05,166,4840,90,76,2997.40,5619.01,0.00
2024-12-08 17:14:05,167,4839,90,77,2976.45,5619.07,0.00
2024-12-08 17:14:05,166,4839,90,76,2995.76,5619.13,0.00
2024-12-08 17:14:05,165,4839,89,76,2998.33,5619.41,0.00
2024-12-08 17:14:05,164,4839,88,76,2998.21,5619.61,0.00
2024-12-08 17:14:05,164,4840,88,76,3045.11,5620.00,0.00
2024-12-08 17:14:05,165,4840,89,76,3026.66,5620.01,0.00
2024-12-08 17:14:05,164,4840,89,75,3029.00,5620.13,0.00
2024-12-08 17:14:05,164,4841,89,75,3049.02,5621.00,0.00
2024-12-08 17:14:05,165,4841,89,76,3030.54,5621.01,0.00
2024-12-08 17:14:05,164,4841,89,75,3039.82,5621.13,0.00
2024-12-08 17:14:05,165,4840,90,75,3003.10,5621.47,0.00
2024-12-08 17:14:05,165,4841,90,75,3005.53,5622.00,0.00
2024-12-08 17:14:05,166,4841,90,76,2987.42,5622.01,0.00
2024-12-08 17:14:05,165,4841,90,75,2988.88,5622.13,0.00
2024-12-08 17:14:05,166,4840,90,76,2934.93,5622.79,0.00
2024-12-08 17:14:05,166,4841,90,76,2997.78,5623.00,0.00
2024-12-08 17:14:05,167,4841,90,77,2979.83,5623.01,0.00
2024-12-08 17:14:05,166,4841,90,76,2987.32,5623.14,0.00
2024-12-08 17:14:05,166,4842,90,76,3000.34,5624.00,0.00
2024-12-08 17:14:05,167,4842,90,77,2982.38,5624.01,0.00
2024-12-08 17:14:05,166,4842,89,77,2991.91,5624.10,0.00
2024-12-08 17:14:05,165,4842,88,77,3009.03,5624.11,0.00
2024-12-08 17:14:05,164,4842,88,76,3019.84,5624.17,0.00
2024-12-08 17:14:05,163,4842,87,76,3033.22,5624.25,0.00
2024-12-08 17:14:05,163,4843,87,76,3026.08,5625.00,0.00
2024-12-08 17:14:05,164,4843,88,76,3007.63,5625.01,0.00
2024-12-08 17:14:05,163,4843,87,76,3024.72,5625.02,0.00
2024-12-08 17:14:05,164,4842,87,77,3005.59,5625.05,0.00
2024-12-08 17:14:05,165,4841,87,78,2991.49,5625.10,0.00
2024-12-08 17:14:05,164,4841,86,78,3032.72,5625.11,0.00
2024-12-08 17:14:05,165,4840,86,79,2994.63,5625.35,0.00
2024-12-08 17:14:05,166,4839,87,79,2986.86,5625.59,0.00
2024-12-08 17:14:05,166,4840,87,79,3011.92,5626.00,0.00
2024-12-08 17:14:05,167,4840,88,79,2993.88,5626.01,0.00
2024-12-08 17:14:05,166,4840,88,78,2998.08,5626.18,0.00
2024-12-08 17:14:06,165,4840,87,78,3012.86,5626.24,0.00
2024-12-08 17:14:06,164,4840,86,78,3030.89,5626.24,0.00
2024-12-08 17:14:06,164,4841,86,78,3153.15,5627.00,0.00
2024-12-08 17:14:06,165,4841,86,79,3134.04,5627.01,0.00
2024-12-08 17:14:06,164,4841,85,79,3147.71,5627.10,0.00
2024-12-08 17:14:06,163,4841,85,78,3159.09,5627.16,0.00
2024-12-08 17:14:06,163,4842,85,78,3139.91,5628.00,0.00
2024-12-08 17:14:06,164,4842,85,79,3120.77,5628.01,0.00
2024-12-08 17:14:06,163,4842,85,78,3134.43,5628.10,0.00
2024-12-08 17:14:06,162,4842,84,78,3134.37,5628.28,0.00
2024-12-08 17:14:06,162,4843,84,78,3128.93,5629.00,0.00
2024-12-08 17:14:06,163,4843,84,79,3109.73,5629.01,0.00
2024-12-08 17:14:06,162,4843,84,78,3123.07,5629.10,0.00
2024-12-08 17:14:06,163,4842,84,79,3098.75,5629.20,0.00
2024-12-08 17:14:06,162,4842,83,79,3128.07,5629.49,0.00
2024-12-08 17:14:06,162,4843,83,79,3134.70,5630.00,0.00
2024-12-08 17:14:06,163,4843,84,79,3115.47,5630.01,0.00
2024-12-08 17:14:06,162,4843,83,79,3110.81,5630.27,0.00
2024-12-08 17:14:06,162,4844,83,79,3139.77,5631.00,0.00
2024-12-08 17:14:06,163,4844,84,79,3120.51,5631.01,0.00
2024-12-08 17:14:06,162,4844,84,78,3126.97,5631.15,0.00
2024-12-08 17:14:06,162,4845,84,78,3107.01,5632.00,0.00
2024-12-08 17:14:06,163,4845,85,78,3087.95,5632.01,0.00
2024-12-08 17:14:06,162,4845,85,77,3095.60,5632.15,0.00
2024-12-08 17:14:06,163,4844,86,77,3024.63,5632.94,0.00
2024-12-08 17:14:06,163,4845,86,77,3057.87,5633.00,0.00
2024-12-08 17:14:06,164,4845,86,78,3039.22,5633.01,0.00
2024-12-08 17:14:06,163,4845,86,77,3050.25,5633.10,0.00
2024-12-08 17:14:06,162,4845,86,76,3063.87,5633.15,0.00
2024-12-08 17:14:06,161,4845,85,76,3078.71,5633.16,0.00
2024-12-08 17:14:06,161,4846,85,76,3100.78,5634.00,0.00
2024-12-08 17:14:06,162,4846,85,77,3081.64,5634.01,0.00
2024-12-08 17:14:06,161,4846,84,77,3086.02,5634.11,0.00
2024-12-08 17:14:06,160,4846,84,76,3097.93,5634.17,0.00
2024-12-08 17:14:06,160,4847,84,76,3086.69,5635.00,0.00
2024-12-08 17:14:06,161,4847,84,77,3067.52,5635.01,0.00
2024-12-08 17:14:06,160,4847,84,76,3073.48,5635.17,0.00
2024-12-08 17:14:06,161,4846,85,76,3044.65,5635.35,0.00
2024-12-08 17:14:06,161,4847,85,76,3066.78,5636.00,0.00
2024-12-08 17:14:06,162,4847,85,77,3047.84,5636.01,0.00
2024-12-08 17:14:06,161,4847,84,77,3061.72,5636.09,0.00
2024-12-08 17:14:06,160,4847,84,76,3079.10,5636.12,0.00
2024-12-08 17:14:06,159,4847,84,75,3092.10,5636.16,0.00
2024-12-08 17:14:06,158,4847,83,75,3093.90,5636.36,0.00
2024-12-08 17:14:06,158,4848,83,75,3129.64,5637.00,0.00
2024-12-08 17:14:06,159,4848,84,75,3109.96,5637.01,0.00
2024-12-08 17:14:06,158,4848,84,74,3122.91,5637.12,0.00
2024-12-08 17:14:06,157,4848,84,73,3135.28,5637.17,0.00
2024-12-08 17:14:06,157,4849,84,73,3117.46,5638.00,0.00
2024-12-08 17:14:06,158,4849,85,73,3097.73,5638.01,0.00
2024-12-08 17:14:06,159,4848,86,73,3076.48,5638.05,0.00
2024-12-08 17:14:06,158,4848,86,72,3097.76,5638.09,0.00
2024-12-08 17:14:06,157,4848,86,71,3107.83,5638.17,0.00
2024-12-08 17:14:06,156,4848,85,71,3125.23,5638.21,0.00
2024-12-08 17:14:06,156,4849,85,71,3110.16,5639.00,0.00
2024-12-08 17:14:06,157,4849,85,72,3090.35,5639.01,0.00
2024-12-08 17:14:06,156,4849,85,71,3099.02,5639.15,0.00
2024-12-08 17:14:07,156,4850,85,71,3103.80,5640.00,0.00
2024-12-08 17:14:07,157,4850,86,71,3084.03,5640.01,0.00
2024-12-08 17:14:07,156,4850,85,71,3101.33,5640.05,0.00
2024-12-08 17:14:07,157,4849,85,72,3059.40,5640.33,0.00
2024-12-08 17:14:07,156,4849,84,72,3107.24,5640.39,0.00
2024-12-08 17:14:07,155,4849,83,72,3113.56,5640.51,0.00
2024-12-08 17:14:07,155,4850,83,72,3105.80,5641.00,0.00
2024-12-08 17:14:07,156,4850,83,73,3085.89,5641.01,0.00
2024-12-08 17:14:07,155,4850,82,73,3101.83,5641.07,0.00
2024-12-08 17:14:07,154,4850,81,73,3119.42,5641.11,0.00
2024-12-08 17:14:07,153,4850,81,72,3137.61,5641.14,0.00
2024-12-08 17:14:07,154,4849,82,72,3076.49,5641.75,0.00
2024-12-08 17:14:07,154,4850,82,72,3105.85,5642.00,0.00
2024-12-08 17:14:07,155,4850,83,72,3085.81,5642.01,0.00
2024-12-08 17:14:07,154,4850,83,71,3094.19,5642.14,0.00
2024-12-08 17:14:07,153,4850,82,71,3111.48,5642.20,0.00
2024-12-08 17:14:07,152,4850,81,71,3094.45,5642.77,0.00
2024-12-08 17:14:07,151,4850,81,70,3097.33,5642.93,0.00
2024-12-08 17:14:07,151,4851,81,70,3168.39,5643.00,0.00
2024-12-08 17:14:07,152,4851,82,70,3147.54,5643.01,0.00
2024-12-08 17:14:07,151,4851,82,69,3156.49,5643.15,0.00
2024-12-08 17:14:07,151,4852,82,69,3138.67,5644.00,0.00
2024-12-08 17:14:07,152,4852,82,70,3118.02,5644.01,0.00
2024-12-08 17:14:07,151,4852,82,69,3124.91,5644.16,0.00
2024-12-08 17:14:07,152,4851,83,69,3083.70,5644.54,0.00
2024-12-08 17:14:07,152,4852,83,69,3111.52,5645.00,0.00
2024-12-08 17:14:07,153,4852,83,70,3091.18,5645.01,0.00
2024-12-08 17:14:07,152,4852,83,69,3097.47,5645.16,0.00
2024-12-08 17:14:07,152,4853,83,69,3117.27,5646.00,0.00
2024-12-08 17:14:07,153,4853,84,69,3096.90,5646.01,0.00
2024-12-08 17:14:07,152,4853,84,68,3103.22,5646.17,0.00
2024-12-08 17:14:07,151,4853,83,68,3121.91,5646.20,0.00
2024-12-08 17:14:07,151,4854,83,68,3107.06,5647.00,0.00
2024-12-08 17:14:07,152,4854,84,68,3086.62,5647.01,0.00
2024-12-08 17:14:07,151,4854,84,67,3092.91,5647.17,0.00
2024-12-08 17:14:07,150,4854,83,67,3110.16,5647.22,0.00
2024-12-08 17:14:07,149,4854,82,67,3105.84,5647.65,0.00
2024-12-08 17:14:07,149,4855,82,67,3123.92,5648.00,0.00
2024-12-08 17:14:07,150,4855,82,68,3103.10,5648.01,0.00
2024-12-08 17:14:07,149,4855,82,67,3109.58,5648.17,0.00
2024-12-08 17:14:07,148,4855,81,67,3101.00,5648.57,0.00
2024-12-08 17:14:07,148,4856,81,67,3115.44,5649.00,0.00
2024-12-08 17:14:07,149,4856,81,68,3094.53,5649.01,0.00
2024-12-08 17:14:07,148,4856,81,67,3100.61,5649.17,0.00
2024-12-08 17:14:07,147,4856,80,67,3109.87,5649.38,0.00
2024-12-08 17:14:07,147,4857,80,67,3106.05,5650.00,0.00
2024-12-08 17:14:07,148,4857,80,68,3085.07,5650.01,0.00
2024-12-08 17:14:07,147,4857,79,68,3100.71,5650.10,0.00
2024-12-08 17:14:07,146,4857,78,68,3119.25,5650.14,0.00
2024-12-08 17:14:07,145,4857,78,67,3133.76,5650.16,0.00
2024-12-08 17:14:07,146,4856,78,68,3078.83,5650.63,0.00
2024-12-08 17:14:07,146,4857,78,68,3111.62,5651.00,0.00
2024-12-08 17:14:07,147,4857,79,68,3090.46,5651.01,0.00
2024-12-08 17:14:07,146,4857,78,68,3101.59,5651.09,0.00
2024-12-08 17:14:08,146,4858,78,68,3119.76,5652.00,0.00
2024-12-08 17:14:08,147,4858,78,69,3098.54,5652.01,0.00
2024-12-08 17:14:08,147,4859,78,69,3065.52,5653.00,0.00
2024-12-08 17:14:08,148,4859,79,69,3044.81,5653.01,0.00
2024-12-08 17:14:08,147,4859,79,68,3051.35,5653.15,0.00
2024-12-08 17:14:08,147,4860,79,68,3034.37,5654.00,0.00
2024-12-08 17:14:08,148,4860,80,68,3013.87,5654.01,0.00
2024-12-08 17:14:08,147,4860,80,67,3020.97,5654.16,0.00
2024-12-08 17:14:08,146,4860,79,67,3038.97,5654.21,0.00
2024-12-08 17:14:08,145,4860,78,67,3059.15,5654.21,0.00
2024-12-08 17:14:08,145,4861,78,67,3046.15,5655.00,0.00
2024-12-08 17:14:08,146,4861,79,67,3025.29,5655.01,0.00
2024-12-08 17:14:08,145,4861,78,67,3022.43,5655.18,0.00
2024-12-08 17:14:08,146,4860,78,68,2962.20,5655.90,0.00
2024-12-08 17:14:08,146,4861,78,68,3000.09,5656.00,0.00
2024-12-08 17:14:08,147,4861,79,68,2979.68,5656.01,0.00
2024-12-08 17:14:08,147,4862,79,68,2985.38,5657.00,0.00
2024-12-08 17:14:08,148,4862,79,69,2965.21,5657.01,0.00
2024-12-08 17:14:08,147,4862,78,69,2981.94,5657.07,0.00
2024-12-08 17:14:08,146,4862,77,69,2999.67,5657.11,0.00
2024-12-08 17:14:08,145,4862,76,69,3005.57,5657.23,0.00
2024-12-08 17:14:08,146,4861,76,70,2969.20,5657.52,0.00
2024-12-08 17:14:08,147,4860,77,70,2953.40,5657.80,0.00
2024-12-08 17:14:08,147,4861,77,70,2981.71,5658.00,0.00
2024-12-08 17:14:08,148,4861,78,70,2961.56,5658.01,0.00
2024-12-08 17:14:08,147,4861,78,69,2971.37,5658.15,0.00
2024-12-08 17:14:08,147,4862,78,69,3031.12,5659.00,0.00
2024-12-08 17:14:08,148,4862,79,69,3010.64,5659.01,0.00
2024-12-08 17:14:08,147,4862,78,69,3027.68,5659.06,0.00
2024-12-08 17:14:08,146,4862,77,69,3044.57,5659.12,0.00
2024-12-08 17:14:08,145,4862,76,69,3046.46,5659.19,0.00
2024-12-08 17:14:08,146,4861,76,70,3012.88,5659.43,0.00
2024-12-08 17:14:08,146,4862,76,70,3041.26,5660.00,0.00
2024-12-08 17:14:08,147,4862,77,70,3020.58,5660.01,0.00
2024-12-08 17:14:08,147,4863,77,70,3026.27,5661.00,0.00
2024-12-08 17:14:08,148,4863,78,70,3005.82,5661.01,0.00
2024-12-08 17:14:08,147,4863,78,69,3017.47,5661.14,0.00
2024-12-08 17:14:08,147,4864,78,69,3000.09,5662.00,0.00
2024-12-08 17:14:08,148,4864,78,70,2979.82,5662.01,0.00
2024-12-08 17:14:08,147,4864,78,69,2988.59,5662.14,0.00
2024-12-08 17:14:08,147,4865,78,69,2971.06,5663.00,0.00
2024-12-08 17:14:08,148,4865,78,70,2950.99,5663.01,0.00
2024-12-08 17:14:08,147,4865,78,69,2951.09,5663.15,0.00
2024-12-08 17:14:08,147,4866,78,69,2941.57,5664.00,0.00
2024-12-08 17:14:08,148,4866,79,69,2921.70,5664.01,0.00
2024-12-08 17:14:08,147,4866,79,68,2928.91,5664.15,0.00
2024-12-08 17:14:08,148,4865,80,68,2876.00,5664.75,0.00
2024-12-08 17:14:09,148,4866,80,68,2903.39,5665.00,0.00
2024-12-08 17:14:09,149,4866,81,68,2883.90,5665.01,0.00
2024-12-08 17:14:09,148,4866,81,67,2890.42,5665.16,0.00
2024-12-08 17:14:09,149,4865,82,67,2864.96,5665.28,0.00
2024-12-08 17:14:09,149,4866,82,67,2920.32,5666.00,0.00
2024-12-08 17:14:09,150,4866,82,68,2900.85,5666.01,0.00
2024-12-08 17:14:09,149,4866,81,68,2919.56,5666.01,0.00
2024-12-08 17:14:09,148,4866,80,68,2933.56,5666.06,0.00
2024-12-08 17:14:09,149,4865,80,69,2913.49,5666.08,0.00
2024-12-08 17:14:09,148,4865,80,68,2966.13,5666.12,0.00
2024-12-08 17:14:09,149,4864,80,69,2903.57,5666.75,0.00
2024-12-08 17:14:09,149,4865,80,69,2976.03,5667.00,0.00
2024-12-08 17:14:09,150,4865,81,69,2956.19,5667.01,0.00
2024-12-08 17:14:09,149,4865,81,68,2962.39,5667.15,0.00
2024-12-08 17:14:09,148,4865,80,68,2960.66,5667.40,0.00
2024-12-08 17:14:09,148,4866,80,68,3041.16,5668.00,0.00
2024-12-08 17:14:09,149,4866,80,69,3020.75,5668.01,0.00
2024-12-08 17:14:09,148,4866,80,68,3024.76,5668.18,0.00
2024-12-08 17:14:09,147,4866,79,68,3027.70,5668.46,0.00
2024-12-08 17:14:09,147,4867,79,68,3035.20,5669.00,0.00
2024-12-08 17:14:09,148,4867,79,69,3014.69,5669.01,0.00
2024-12-08 17:14:09,147,4867,79,68,3018.68,5669.18,0.00
2024-12-08 17:14:09,147,4868,79,68,3002.89,5670.00,0.00
2024-12-08 17:14:09,148,4868,80,68,2982.60,5670.01,0.00
2024-12-08 17:14:09,147,4868,80,67,2985.98,5670.18,0.00
2024-12-08 17:14:09,148,4867,81,67,2965.80,5670.20,0.00
2024-12-08 17:14:09,147,4867,80,67,3016.46,5670.21,0.00
2024-12-08 17:14:09,147,4868,80,67,3003.03,5671.00,0.00
2024-12-08 17:14:09,148,4868,81,67,2982.74,5671.01,0.00
2024-12-08 17:14:09,147,4868,80,67,2999.56,5671.02,0.00
2024-12-08 17:14:09,147,4869,80,67,3013.98,5672.00,0.00
2024-12-08 17:14:09,148,4869,80,68,2993.61,5672.01,0.00
2024-12-08 17:14:09,149,4868,81,68,2968.61,5672.11,0.00
2024-12-08 17:14:09,148,4868,80,68,3000.96,5672.20,0.00
2024-12-08 17:14:09,147,4868,80,67,3020.23,5672.22,0.00
2024-12-08 17:14:09,148,4867,80,68,2957.71,5672.98,0.00
2024-12-08 17:14:09,148,4868,80,68,2988.01,5673.00,0.00
2024-12-08 17:14:09,149,4868,80,69,2967.96,5673.01,0.00
2024-12-08 17:14:09,148,4868,79,69,2987.25,5673.01,0.00
2024-12-08 17:14:09,149,4867,80,69,2944.06,5673.30,0.00
2024-12-08 17:14:09,149,4868,80,69,3030.55,5674.00,0.00
2024-12-08 17:14:09,150,4868,80,70,3010.35,5674.01,0.00
2024-12-08 17:14:09,150,4869,80,70,3015.04,5675.00,0.00
2024-12-08 17:14:09,151,4869,80,71,2995.07,5675.01,0.00
2024-12-08 17:14:09,150,4869,79,71,3012.41,5675.05,0.00
2024-12-08 17:14:09,149,4869,78,71,3021.23,5675.11,0.00
2024-12-08 17:14:09,148,4869,77,71,3039.01,5675.15,0.00
2024-12-08 17:14:09,148,4870,77,71,3021.73,5676.00,0.00
2024-12-08 17:14:09,149,4870,78,71,3001.45,5676.01,0.00
2024-12-08 17:14:09,149,4871,78,71,2968.07,5677.00,0.00
2024-12-08 17:14:09,150,4871,78,72,2948.29,5677.01,0.00
2024-12-08 17:14:09,149,4871,77,72,2949.09,5677.21,0.00
2024-12-08 17:14:09,149,4872,77,72,2934.30,5678.00,0.00
2024-12-08 17:14:09,150,4872,77,73,2914.74,5678.01,0.00
2024-12-08 17:14:09,149,4872,77,72,2931.27,5678.05,0.00
2024-12-08 17:14:09,148,4872,77,71,2943.41,5678.07,0.00
2024-12-08 17:14:09,149,4871,77,72,2919.11,5678.16,0.00
2024-12-08 17:14:09,148,4871,76,72,2961.76,5678.30,0.00
2024-12-08 17:14:09,148,4872,76,72,2959.76,5679.00,0.00
2024-12-08 17:14:09,149,4872,76,73,2939.90,5679.01,0.00
2024-12-08 17:14:09,148,4872,76,72,2950.96,5679.07,0.00
2024-12-08 17:14:10,149,4871,76,73,2898.05,5679.64,0.00
2024-12-08 17:14:10,149,4872,76,73,2960.84,5680.00,0.00
2024-12-08 17:14:10,150,4872,76,74,2941.10,5680.01,0.00
2024-12-08 17:14:10,151,4871,77,74,2921.25,5680.03,0.00
2024-12-08 17:14:10,150,4871,77,73,2971.06,5680.10,0.00
2024-12-08 17:14:10,149,4871,77,72,2983.01,5680.15,0.00
2024-12-08 17:14:10,148,4871,76,72,2981.33,5680.47,0.00
2024-12-08 17:14:10,148,4872,76,72,3028.14,5681.00,0.00
2024-12-08 17:14:10,149,4872,76,73,3007.81,5681.01,0.00
2024-12-08 17:14:10,148,4872,76,72,3020.50,5681.12,0.00
2024-12-08 17:14:10,147,4872,75,72,2998.69,5681.73,0.00
2024-12-08 17:14:10,147,4873,75,72,3060.75,5682.00,0.00
2024-12-08 17:14:10,148,4873,76,72,3040.07,5682.01,0.00
2024-12-08 17:14:10,147,4873,76,71,3055.38,5682.10,0.00
2024-12-08 17:14:10,146,4873,76,70,3075.52,5682.10,0.00
2024-12-08 17:14:10,146,4874,76,70,3053.75,5683.00,0.00
2024-12-08 17:14:10,147,4874,77,70,3032.98,5683.01,0.00
2024-12-08 17:14:10,146,4874,77,69,3042.14,5683.13,0.00
2024-12-08 17:14:10,145,4874,77,68,3044.45,5683.43,0.00
2024-12-08 17:14:10,145,4875,77,68,3043.66,5684.00,0.00
2024-12-08 17:14:10,146,4875,78,68,3022.81,5684.01,0.00
2024-12-08 17:14:10,145,4875,77,68,3040.16,5684.06,0.00
2024-12-08 17:14:10,144,4875,77,67,3053.02,5684.13,0.00
2024-12-08 17:14:10,145,4874,78,67,3007.80,5684.57,0.00
2024-12-08 17:14:10,145,4875,78,67,3021.46,5685.00,0.00
2024-12-08 17:14:10,146,4875,79,67,3000.76,5685.01,0.00
2024-12-08 17:14:10,145,4875,79,66,3010.15,5685.12,0.00
2024-12-08 17:14:10,145,4876,79,66,3030.66,5686.00,0.00
2024-12-08 17:14:10,146,4876,79,67,3009.90,5686.01,0.00
2024-12-08 17:14:10,145,4876,78,67,3025.99,5686.08,0.00
2024-12-08 17:14:10,144,4876,78,66,3039.92,5686.13,0.00
2024-12-08 17:14:10,144,4877,78,66,3021.32,5687.00,0.00
2024-12-08 17:14:10,145,4877,79,66,3000.48,5687.01,0.00
2024-12-08 17:14:10,144,4877,78,66,3011.11,5687.12,0.00
2024-12-08 17:14:10,143,4877,78,65,3027.39,5687.12,0.00
2024-12-08 17:14:10,144,4876,78,66,2992.19,5687.38,0.00
2024-12-08 17:14:10,144,4877,78,66,3022.22,5688.00,0.00
2024-12-08 17:14:10,145,4877,78,67,3001.37,5688.01,0.00
2024-12-08 17:14:10,144,4877,78,66,3009.24,5688.15,0.00
2024-12-08 17:14:10,143,4877,77,66,3024.75,5688.24,0.00
2024-12-08 17:14:10,144,4876,78,66,2971.64,5688.82,0.00
2024-12-08 17:14:10,145,4875,79,66,2953.97,5688.88,0.00
2024-12-08 17:14:10,145,4876,79,66,3022.74,5689.00,0.00
2024-12-08 17:14:10,146,4876,80,66,3002.04,5689.01,0.00
2024-12-08 17:14:10,145,4876,79,66,3017.29,5689.10,0.00
2024-12-08 17:14:10,144,4876,79,65,3031.15,5689.14,0.00
2024-12-08 17:14:10,144,4877,79,65,3089.86,5690.00,0.00
2024-12-08 17:14:10,145,4877,80,65,3068.55,5690.01,0.00
2024-12-08 17:14:10,145,4878,80,65,3032.79,5691.00,0.00
2024-12-08 17:14:10,146,4878,81,65,3012.02,5691.01,0.00
2024-12-08 17:14:10,147,4877,82,65,2973.40,5691.20,0.00
2024-12-08 17:14:10,147,4878,82,65,2969.36,5692.00,0.00
2024-12-08 17:14:10,148,4878,83,65,2949.30,5692.01,0.00
2024-12-08 17:14:10,147,4878,82,65,2949.30,5692.23,0.00
2024-12-08 17:14:10,147,4879,82,65,2972.50,5693.00,0.00
2024-12-08 17:14:10,148,4879,83,65,2952.41,5693.01,0.00
2024-12-08 17:14:10,147,4879,83,64,2957.06,5693.14,0.00
2024-12-08 17:14:11,146,4879,82,64,2937.72,5693.79,0.00
2024-12-08 17:14:11,146,4880,82,64,2957.39,5694.00,0.00
2024-12-08 17:14:11,147,4880,82,65,2937.27,5694.01,0.00
2024-12-08 17:14:11,146,4880,81,65,2935.62,5694.25,0.00
2024-12-08 17:14:11,147,4879,82,65,2892.58,5694.67,0.00
2024-12-08 17:14:11,147,4880,82,65,2916.02,5695.00,0.00
2024-12-08 17:14:11,148,4880,82,66,2896.32,5695.01,0.00
2024-12-08 17:14:11,148,4881,82,66,2900.73,5696.00,0.00
2024-12-08 17:14:11,149,4881,82,67,2881.26,5696.01,0.00
2024-12-08 17:14:11,149,4882,82,67,2848.00,5697.00,0.00
2024-12-08 17:14:11,150,4882,82,68,2829.02,5697.01,0.00
2024-12-08 17:14:11,149,4882,82,67,2839.64,5697.13,0.00
2024-12-08 17:14:11,148,4882,81,67,2824.77,5697.68,0.00
2024-12-08 17:14:11,149,4881,81,68,2801.28,5697.77,0.00
2024-12-08 17:14:11,149,4882,81,68,2835.89,5698.00,0.00
2024-12-08 17:14:11,150,4882,81,69,2816.98,5698.01,0.00
2024-12-08 17:14:11,149,4882,80,69,2829.81,5698.11,0.00
2024-12-08 17:14:11,148,4882,79,69,2848.55,5698.11,0.00
2024-12-08 17:14:11,147,4882,79,68,2866.86,5698.12,0.00
2024-12-08 17:14:11,146,4882,78,68,2886.11,5698.12,0.00
2024-12-08 17:14:11,145,4882,78,67,2903.66,5698.12,0.00
2024-12-08 17:14:11,146,4881,78,68,2878.71,5698.23,0.00
2024-12-08 17:14:11,146,4882,78,68,2934.97,5699.00,0.00
2024-12-08 17:14:11,147,4882,78,69,2915.01,5699.01,0.00
2024-12-08 17:14:11,146,4882,77,69,2928.38,5699.12,0.00
2024-12-08 17:14:11,145,4882,77,68,2945.83,5699.12,0.00
2024-12-08 17:14:11,144,4882,76,68,2960.77,5699.22,0.00
2024-12-08 17:14:11,144,4883,76,68,2988.13,5700.00,0.00
2024-12-08 17:14:11,145,4883,76,69,2967.53,5700.01,0.00
2024-12-08 17:14:11,144,4883,76,68,2977.10,5700.15,0.00
2024-12-08 17:14:11,144,4884,76,68,2959.78,5701.00,0.00
2024-12-08 17:14:11,145,4884,76,69,2939.36,5701.01,0.00
2024-12-08 17:14:11,144,4884,76,68,2948.74,5701.15,0.00
2024-12-08 17:14:11,144,4885,76,68,2930.59,5702.00,0.00
2024-12-08 17:14:11,145,4885,76,69,2910.38,5702.01,0.00
2024-12-08 17:14:11,144,4885,76,68,2919.55,5702.15,0.00
2024-12-08 17:14:11,143,4885,75,68,2904.53,5702.70,0.00
2024-12-08 17:14:11,144,4884,76,68,2875.37,5702.87,0.00
2024-12-08 17:14:11,144,4885,76,68,2910.36,5703.00,0.00
2024-12-08 17:14:11,145,4885,76,69,2890.29,5703.01,0.00
2024-12-08 17:14:11,144,4885,76,68,2898.13,5703.15,0.00
2024-12-08 17:14:11,143,4885,75,68,2894.16,5703.43,0.00
2024-12-08 17:14:11,143,4886,75,68,2938.93,5704.00,0.00
2024-12-08 17:14:11,144,4886,76,68,2918.52,5704.01,0.00
2024-12-08 17:14:11,143,4886,75,68,2932.19,5704.12,0.00
2024-12-08 17:14:11,142,4886,75,67,2943.62,5704.18,0.00
2024-12-08 17:14:11,143,4885,76,67,2882.60,5704.77,0.00
2024-12-08 17:14:11,143,4886,76,67,2915.04,5705.00,0.00
2024-12-08 17:14:11,144,4886,76,68,2894.80,5705.01,0.00
2024-12-08 17:14:11,145,4885,77,68,2870.92,5705.09,0.00
2024-12-08 17:14:11,146,4884,78,68,2875.88,5705.11,0.00
2024-12-08 17:14:11,145,4884,78,67,2898.90,5705.19,0.00
2024-12-08 17:14:11,145,4885,78,67,2920.13,5706.00,0.00
2024-12-08 17:14:11,146,4885,78,68,2900.13,5706.01,0.00
2024-12-08 17:14:11,145,4885,77,68,2913.05,5706.04,0.00
2024-12-08 17:14:11,144,4885,77,67,2928.56,5706.11,0.00
2024-12-08 17:14:11,143,4885,76,67,2948.25,5706.12,0.00
2024-12-08 17:14:11,142,4885,76,66,2960.99,5706.16,0.00
2024-12-08 17:14:11,141,4885,75,66,2977.55,5706.23,0.00
2024-12-08 17:14:11,141,4886,75,66,3051.40,5707.00,0.00
2024-12-08 17:14:11,142,4886,75,67,3029.91,5707.01,0.00
2024-12-08 17:14:11,141,4886,75,66,3036.08,5707.17,0.00
2024-12-08 17:14:11,142,4885,75,67,2987.08,5707.53,0.00
2024-12-08 17:14:12,142,4886,75,67,3001.15,5708.00,0.00
2024-12-08 17:14:12,143,4886,76,67,2980.17,5708.01,0.00
2024-12-08 17:14:12,142,4886,76,66,2985.54,5708.18,0.00
2024-12-08 17:14:12,142,4887,76,66,3007.00,5709.00,0.00
2024-12-08 17:14:12,143,4887,76,67,2985.97,5709.01,0.00
2024-12-08 17:14:12,142,4887,76,66,2992.42,5709.18,0.00
2024-12-08 17:14:12,142,4888,76,66,2973.82,5710.00,0.00
2024-12-08 17:14:12,143,4888,76,67,2953.02,5710.01,0.00
2024-12-08 17:14:12,142,4888,75,67,2908.90,5710.85,0.00
2024-12-08 17:14:12,142,4889,75,67,2940.41,5711.00,0.00
2024-12-08 17:14:12,143,4889,76,67,2919.85,5711.01,0.00
2024-12-08 17:14:12,142,4889,76,66,2929.61,5711.18,0.00
2024-12-08 17:14:12,141,4889,75,66,2947.56,5711.23,0.00
2024-12-08 17:14:12,141,4890,75,66,2936.67,5712.00,0.00
2024-12-08 17:14:12,142,4890,75,67,2915.99,5712.01,0.00
2024-12-08 17:14:12,141,4890,74,67,2935.05,5712.03,0.00
2024-12-08 17:14:12,140,4890,74,66,2941.79,5712.18,0.00
2024-12-08 17:14:12,139,4890,73,66,2960.50,5712.22,0.00
2024-12-08 17:14:12,138,4890,72,66,2981.54,5712.23,0.00
2024-12-08 17:14:12,137,4890,71,66,2985.42,5712.39,0.00
2024-12-08 17:14:12,137,4891,71,66,2992.91,5713.00,0.00
2024-12-08 17:14:12,138,4891,71,67,2971.23,5713.01,0.00
2024-12-08 17:14:12,137,4891,70,67,2992.50,5713.01,0.00
2024-12-08 17:14:12,136,4891,70,66,3007.83,5713.12,0.00
2024-12-08 17:14:12,135,4891,69,66,3029.69,5713.12,0.00
2024-12-08 17:14:12,134,4891,69,65,3044.21,5713.16,0.00
2024-12-08 17:14:12,135,4890,70,65,2996.85,5713.62,0.00
2024-12-08 17:14:12,136,4889,70,66,2989.94,5713.63,0.00
2024-12-08 17:14:12,137,4888,70,67,2964.91,5713.81,0.00
2024-12-08 17:14:12,137,4889,70,67,3003.87,5714.00,0.00
2024-12-08 17:14:12,138,4889,70,68,2982.10,5714.01,0.00
2024-12-08 17:14:12,137,4889,70,67,2988.91,5714.17,0.00
2024-12-08 17:14:12,136,4889,69,67,2998.76,5714.38,0.00
2024-12-08 17:14:12,136,4890,69,67,3123.13,5715.00,0.00
2024-12-08 17:14:12,137,4890,69,68,3100.34,5715.01,0.00
2024-12-08 17:14:12,136,4890,68,68,3116.46,5715.12,0.00
2024-12-08 17:14:12,135,4890,68,67,3130.24,5715.17,0.00
2024-12-08 17:14:12,135,4891,68,67,3117.18,5716.00,0.00
2024-12-08 17:14:12,136,4891,69,67,3094.26,5716.01,0.00
2024-12-08 17:14:12,135,4891,69,66,3110.03,5716.13,0.00
2024-12-08 17:14:12,134,4891,69,65,3125.14,5716.16,0.00
2024-12-08 17:14:12,133,4891,68,65,3137.09,5716.36,0.00
2024-12-08 17:14:12,133,4892,68,65,3132.92,5717.00,0.00
2024-12-08 17:14:12,134,4892,68,66,3109.54,5717.01,0.00
2024-12-08 17:14:12,133,4892,67,66,3123.52,5717.17,0.00
2024-12-08 17:14:12,132,4892,67,65,3138.95,5717.17,0.00
2024-12-08 17:14:12,133,4891,67,66,3103.38,5717.40,0.00
2024-12-08 17:14:12,134,4890,68,66,3079.83,5717.49,0.00
2024-12-08 17:14:12,135,4889,69,66,3050.20,5717.88,0.00
2024-12-08 17:14:12,135,4890,69,66,3090.55,5718.00,0.00
2024-12-08 17:14:12,136,4890,70,66,3067.83,5718.01,0.00
2024-12-08 17:14:12,135,4890,70,65,3072.82,5718.18,0.00
2024-12-08 17:14:12,134,4890,69,65,3095.75,5718.18,0.00
2024-12-08 17:14:12,133,4890,69,64,3060.67,5718.84,0.00
2024-12-08 17:14:12,133,4891,69,64,3223.77,5719.00,0.00
2024-12-08 17:14:12,134,4891,69,65,3199.71,5719.01,0.00
2024-12-08 17:14:12,133,4891,68,65,3211.79,5719.20,0.00
2024-12-08 17:14:12,133,4892,68,65,3201.10,5720.00,0.00
2024-12-08 17:14:12,134,4892,68,66,3177.22,5720.01,0.00
2024-12-08 17:14:12,133,4892,67,66,3193.84,5720.13,0.00
2024-12-08 17:14:12,132,4892,67,65,3212.86,5720.21,0.00
2024-12-08 17:14:12,131,4892,66,65,3236.07,5720.23,0.00
2024-12-08 17:14:12,130,4892,65,65,3254.83,5720.34,0.00
2024-12-08 17:14:12,130,4893,65,65,3261.45,5721.00,0.00
2024-12-08 17:14:12,131,4893,65,66,3236.56,5721.01,0.00
2024-12-08 17:14:12,130,4893,64,66,3258.82,5721.05,0.00
2024-12-08 17:14:12,129,4893,63,66,3261.09,5721.24,0.00
2024-12-08 17:14:12,129,4894,63,66,3262.47,5722.00,0.00
2024-12-08 17:14:12,130,4894,63,67,3237.37,5722.01,0.00
2024-12-08 17:14:13,129,4894,63,66,3249.23,5722.22,0.00
2024-12-08 17:14:13,129,4895,63,66,3240.41,5723.00,0.00
2024-12-08 17:14:13,130,4895,63,67,3215.49,5723.01,0.00
2024-12-08 17:14:13,130,4896,63,67,3185.67,5724.00,0.00
2024-12-08 17:14:13,131,4896,64,67,3161.35,5724.01,0.00
2024-12-08 17:14:13,130,4896,64,66,3178.23,5724.13,0.00
2024-12-08 17:14:13,129,4896,64,65,3197.56,5724.21,0.00
2024-12-08 17:14:13,129,4897,64,65,3188.29,5725.00,0.00
2024-12-08 17:14:13,130,4897,65,65,3163.77,5725.01,0.00
2024-12-08 17:14:13,129,4897,64,65,3186.97,5725.02,0.00
2024-12-08 17:14:13,128,4897,63,65,3209.64,5725.06,0.00
2024-12-08 17:14:13,127,4897,62,65,3230.89,5725.12,0.00
2024-12-08 17:14:13,128,4896,63,65,3164.19,5725.55,0.00
2024-12-08 17:14:13,128,4897,63,65,3201.66,5726.00,0.00
2024-12-08 17:14:13,129,4897,64,65,3176.84,5726.01,0.00
2024-12-08 17:14:13,128,4897,64,64,3194.10,5726.12,0.00
2024-12-08 17:14:13,129,4896,64,65,3143.69,5726.43,0.00
2024-12-08 17:14:13,129,4897,64,65,3223.12,5727.00,0.00
2024-12-08 17:14:13,130,4897,64,66,3198.33,5727.01,0.00
2024-12-08 17:14:13,129,4897,64,65,3212.08,5727.19,0.00
2024-12-08 17:14:13,129,4898,64,65,3245.88,5728.00,0.00
2024-12-08 17:14:13,130,4898,64,66,3220.92,5728.01,0.00
2024-12-08 17:14:13,130,4899,64,66,3191.07,5729.00,0.00
2024-12-08 17:14:13,131,4899,64,67,3166.71,5729.01,0.00
2024-12-08 17:14:13,130,4899,63,67,3189.32,5729.03,0.00
2024-12-08 17:14:13,129,4899,62,67,3201.64,5729.10,0.00
2024-12-08 17:14:13,128,4899,62,66,3222.19,5729.17,0.00
2024-12-08 17:14:13,129,4898,62,67,3183.09,5729.43,0.00
2024-12-08 17:14:13,129,4899,62,67,3201.36,5730.00,0.00
2024-12-08 17:14:13,130,4899,63,67,3176.73,5730.01,0.00
2024-12-08 17:14:13,131,4898,64,67,3144.66,5730.16,0.00
2024-12-08 17:14:13,130,4898,64,66,3190.90,5730.19,0.00
2024-12-08 17:14:13,130,4899,64,66,3223.17,5731.00,0.00
2024-12-08 17:14:13,131,4899,65,66,3198.56,5731.01,0.00
2024-12-08 17:14:13,132,4898,66,66,3154.42,5731.22,0.00
2024-12-08 17:14:13,131,4898,65,66,3197.40,5731.41,0.00
2024-12-08 17:14:13,131,4899,65,66,3251.19,5732.00,0.00
2024-12-08 17:14:13,132,4899,65,67,3226.56,5732.01,0.00
2024-12-08 17:14:13,131,4899,65,66,3241.19,5732.18,0.00
2024-12-08 17:14:13,132,4898,65,67,3195.09,5732.57,0.00
2024-12-08 17:14:13,132,4899,65,67,3266.21,5733.00,0.00
2024-12-08 17:14:13,133,4899,65,68,3241.65,5733.01,0.00
2024-12-08 17:14:13,134,4898,65,69,3217.04,5733.03,0.00
2024-12-08 17:14:13,133,4898,65,68,3277.04,5733.11,0.00
2024-12-08 17:14:13,133,4899,65,68,3295.25,5734.00,0.00
2024-12-08 17:14:13,134,4899,66,68,3270.66,5734.01,0.00
2024-12-08 17:14:13,133,4899,66,67,3284.96,5734.17,0.00
2024-12-08 17:14:13,133,4900,66,67,3315.66,5735.00,0.00
2024-12-08 17:14:13,134,4900,67,67,3290.91,5735.01,0.00
2024-12-08 17:14:13,133,4900,66,67,3313.95,5735.03,0.00
2024-12-08 17:14:13,132,4900,65,67,3319.56,5735.19,0.00
2024-12-08 17:14:13,132,4901,65,67,3317.03,5736.00,0.00
2024-12-08 17:14:13,133,4901,65,68,3292.08,5736.01,0.00
2024-12-08 17:14:13,134,4900,66,68,3264.12,5736.08,0.00
2024-12-08 17:14:13,133,4900,66,67,3301.64,5736.17,0.00
2024-12-08 17:14:13,134,4899,67,67,3259.58,5736.49,0.00
2024-12-08 17:14:13,135,4898,67,68,3229.40,5736.99,0.00
2024-12-08 17:14:13,135,4899,67,68,3263.40,5737.00,0.00
2024-12-08 17:14:13,136,4899,68,68,3239.41,5737.01,0.00
2024-12-08 17:14:13,135,4899,67,68,3245.19,5737.17,0.00
2024-12-08 17:14:14,136,4898,68,68,3180.00,5737.91,0.00
2024-12-08 17:14:14,136,4899,68,68,3354.73,5738.00,0.00
2024-12-08 17:14:14,137,4899,68,69,3330.24,5738.01,0.00
2024-12-08 17:14:14,136,4899,67,69,3349.29,5738.10,0.00
2024-12-08 17:14:14,137,4898,67,70,3305.63,5738.30,0.00
2024-12-08 17:14:14,137,4899,67,70,3358.05,5739.00,0.00
2024-12-08 17:14:14,138,4899,68,70,3333.72,5739.01,0.00
2024-12-08 17:14:14,137,4899,68,69,3352.23,5739.10,0.00
2024-12-08 17:14:14,137,4900,68,69,3368.28,5740.00,0.00
2024-12-08 17:14:14,138,4900,69,69,3343.87,5740.01,0.00
2024-12-08 17:14:14,139,4899,70,69,3314.89,5740.11,0.00
2024-12-08 17:14:14,140,4898,71,69,3265.35,5740.83,0.00
2024-12-08 17:14:14,140,4899,71,69,3293.80,5741.00,0.00
2024-12-08 17:14:14,141,4899,71,70,3270.44,5741.01,0.00
2024-12-08 17:14:14,140,4899,71,69,3281.56,5741.14,0.00
2024-12-08 17:14:14,139,4899,70,69,3304.76,5741.15,0.00
2024-12-08 17:14:14,138,4899,69,69,3328.29,5741.15,0.00
2024-12-08 17:14:14,138,4900,69,69,3396.63,5742.00,0.00
2024-12-08 17:14:14,139,4900,69,70,3372.19,5742.01,0.00
2024-12-08 17:14:14,138,4900,68,70,3390.02,5742.12,0.00
2024-12-08 17:14:14,138,4901,68,70,3364.76,5743.00,0.00
2024-12-08 17:14:14,139,4901,69,70,3340.55,5743.01,0.00
2024-12-08 17:14:14,138,4901,68,70,3344.01,5743.23,0.00
2024-12-08 17:14:14,138,4902,68,70,3333.28,5744.00,0.00
2024-12-08 17:14:14,139,4902,68,71,3309.30,5744.01,0.00
2024-12-08 17:14:14,138,4902,67,71,3329.97,5744.06,0.00
2024-12-08 17:14:14,138,4903,67,71,3301.39,5745.00,0.00
2024-12-08 17:14:14,139,4903,67,72,3277.64,5745.01,0.00
2024-12-08 17:14:14,138,4903,67,71,3288.95,5745.13,0.00
2024-12-08 17:14:14,137,4903,66,71,3312.12,5745.15,0.00
2024-12-08 17:14:14,138,4902,67,71,3265.40,5745.56,0.00
2024-12-08 17:14:14,138,4903,67,71,3284.89,5746.00,0.00
2024-12-08 17:14:14,139,4903,68,71,3261.26,5746.01,0.00
2024-12-08 17:14:14,140,4902,69,71,3235.11,5746.07,0.00
2024-12-08 17:14:14,139,4902,68,71,3260.05,5746.07,0.00
2024-12-08 17:14:14,138,4902,67,71,3281.19,5746.11,0.00
2024-12-08 17:14:14,137,4902,67,70,3297.17,5746.12,0.00
2024-12-08 17:14:14,137,4903,67,70,3331.26,5747.00,0.00
2024-12-08 17:14:14,138,4903,68,70,3307.12,5747.01,0.00
2024-12-08 17:14:14,137,4903,68,69,3317.88,5747.12,0.00
2024-12-08 17:14:14,138,4902,69,69,3241.80,5747.90,0.00
2024-12-08 17:14:14,138,4903,69,69,3323.10,5748.00,0.00
2024-12-08 17:14:14,139,4903,69,70,3299.20,5748.01,0.00
2024-12-08 17:14:14,138,4903,69,69,3308.16,5748.13,0.00
2024-12-08 17:14:14,137,4903,68,69,3321.47,5748.32,0.00
2024-12-08 17:14:14,136,4903,67,69,3324.45,5748.54,0.00
2024-12-08 17:14:14,136,4904,67,69,3383.13,5749.00,0.00
2024-12-08 17:14:14,137,4904,68,69,3358.43,5749.01,0.00
2024-12-08 17:14:14,136,4904,67,69,3372.59,5749.07,0.00
2024-12-08 17:14:14,135,4904,67,68,3386.95,5749.13,0.00
2024-12-08 17:14:14,136,4903,67,69,3346.51,5749.41,0.00
2024-12-08 17:14:14,136,4904,67,69,3377.38,5750.00,0.00
2024-12-08 17:14:14,137,4904,67,70,3352.72,5750.01,0.00
2024-12-08 17:14:14,136,4904,67,69,3363.47,5750.10,0.00
2024-12-08 17:14:14,135,4904,67,68,3379.87,5750.12,0.00
2024-12-08 17:14:15,135,4905,67,68,3414.91,5751.00,0.00
2024-12-08 17:14:15,136,4905,68,68,3389.80,5751.01,0.00
2024-12-08 17:14:15,135,4905,68,67,3400.48,5751.13,0.00
2024-12-08 17:14:15,135,4906,68,67,3384.83,5752.00,0.00
2024-12-08 17:14:15,136,4906,69,67,3359.94,5752.01,0.00
2024-12-08 17:14:15,135,4906,69,66,3369.11,5752.13,0.00
2024-12-08 17:14:15,136,4905,70,66,3296.92,5752.82,0.00
2024-12-08 17:14:15,136,4906,70,66,3335.57,5753.00,0.00
2024-12-08 17:14:15,137,4906,70,67,3311.22,5753.01,0.00
2024-12-08 17:14:15,136,4906,69,67,3330.11,5753.10,0.00
2024-12-08 17:14:15,135,4906,68,67,3342.86,5753.15,0.00
2024-12-08 17:14:15,136,4905,69,67,3301.48,5753.46,0.00
2024-12-08 17:14:15,136,4906,69,67,3375.49,5754.00,0.00
2024-12-08 17:14:15,137,4906,69,68,3350.85,5754.01,0.00
2024-12-08 17:14:15,137,4907,69,68,3361.52,5755.00,0.00
2024-12-08 17:14:15,138,4907,69,69,3337.16,5755.01,0.00
2024-12-08 17:14:15,137,4907,69,68,3347.28,5755.12,0.00
2024-12-08 17:14:15,137,4908,69,68,3331.01,5756.00,0.00
2024-12-08 17:14:15,138,4908,69,69,3306.87,5756.01,0.00
2024-12-08 17:14:15,138,4909,69,69,3274.95,5757.00,0.00
2024-12-08 17:14:15,139,4909,69,70,3251.39,5757.01,0.00
2024-12-08 17:14:15,138,4909,68,70,3215.27,5757.75,0.00
2024-12-08 17:14:15,138,4910,68,70,3242.59,5758.00,0.00
2024-12-08 17:14:15,139,4910,69,70,3219.27,5758.01,0.00
2024-12-08 17:14:15,140,4909,69,71,3193.82,5758.06,0.00
2024-12-08 17:14:15,139,4909,69,70,3250.80,5758.13,0.00
2024-12-08 17:14:15,140,4908,70,70,3217.35,5758.31,0.00
2024-12-08 17:14:15,141,4907,70,71,3191.79,5758.55,0.00
2024-12-08 17:14:15,141,4908,70,71,3231.72,5759.00,0.00
2024-12-08 17:14:15,142,4908,70,72,3208.96,5759.01,0.00
2024-12-08 17:14:15,142,4909,70,72,3296.96,5760.00,0.00
2024-12-08 17:14:15,143,4909,71,72,3273.90,5760.01,0.00
2024-12-08 17:14:15,142,4909,71,71,3286.46,5760.13,0.00
2024-12-08 17:14:15,143,4908,72,71,3219.23,5760.73,0.00
2024-12-08 17:14:15,144,4907,72,72,3191.89,5760.99,0.00
2024-12-08 17:14:15,144,4908,72,72,3231.90,5761.00,0.00
2024-12-08 17:14:15,145,4908,72,73,3209.61,5761.01,0.00
2024-12-08 17:14:15,145,4909,72,73,3253.48,5762.00,0.00
2024-12-08 17:14:15,146,4909,73,73,3231.20,5762.01,0.00
2024-12-08 17:14:15,145,4909,72,73,3234.87,5762.19,0.00
2024-12-08 17:14:15,144,4909,71,73,3246.59,5762.37,0.00
2024-12-08 17:14:15,144,4910,71,73,3247.60,5763.00,0.00
2024-12-08 17:14:15,145,4910,71,74,3225.20,5763.01,0.00
2024-12-08 17:14:15,144,4910,71,73,3236.44,5763.13,0.00
2024-12-08 17:14:15,144,4911,71,73,3215.48,5764.00,0.00
2024-12-08 17:14:15,145,4911,71,74,3193.31,5764.01,0.00
2024-12-08 17:14:15,146,4910,72,74,3167.91,5764.08,0.00
2024-12-08 17:14:15,145,4910,71,74,3191.85,5764.19,0.00
2024-12-08 17:14:15,144,4910,70,74,3213.61,5764.19,0.00
2024-12-08 17:14:15,143,4910,69,74,3226.07,5764.36,0.00
2024-12-08 17:14:15,143,4911,69,74,3218.99,5765.00,0.00
2024-12-08 17:14:15,144,4911,69,75,3196.64,5765.01,0.00
2024-12-08 17:14:15,143,4911,68,75,3213.79,5765.09,0.00
2024-12-08 17:14:15,142,4911,67,75,3236.02,5765.09,0.00
2024-12-08 17:14:16,142,4912,67,75,3245.56,5766.00,0.00
2024-12-08 17:14:16,143,4912,67,76,3222.87,5766.01,0.00
2024-12-08 17:14:16,142,4912,66,76,3244.35,5766.02,0.00
2024-12-08 17:14:16,142,4913,66,76,3209.85,5767.00,0.00
2024-12-08 17:14:16,143,4913,67,76,3187.40,5767.01,0.00
2024-12-08 17:14:16,142,4913,67,75,3202.99,5767.11,0.00
2024-12-08 17:14:16,143,4912,67,76,3167.35,5767.35,0.00
2024-12-08 17:14:16,144,4911,67,77,3132.64,5767.68,0.00
2024-12-08 17:14:16,144,4912,67,77,3158.53,5768.00,0.00
2024-12-08 17:14:16,145,4912,67,78,3136.75,5768.01,0.00
2024-12-08 17:14:16,144,4912,67,77,3148.16,5768.11,0.00
2024-12-08 17:14:16,143,4912,66,77,3161.74,5768.22,0.00
2024-12-08 17:14:16,142,4912,66,76,3160.11,5768.61,0.00
2024-12-08 17:14:16,142,4913,66,76,3259.76,5769.00,0.00
2024-12-08 17:14:16,143,4913,66,77,3236.96,5769.01,0.00
2024-12-08 17:14:16,142,4913,66,76,3254.07,5769.11,0.00
2024-12-08 17:14:16,141,4913,66,75,3272.65,5769.11,0.00
2024-12-08 17:14:16,141,4914,66,75,3253.70,5770.00,0.00
2024-12-08 17:14:16,142,4914,67,75,3230.79,5770.01,0.00
2024-12-08 17:14:16,141,4914,66,75,3248.42,5770.09,0.00
2024-12-08 17:14:16,140,4914,66,74,3267.09,5770.10,0.00
2024-12-08 17:14:16,141,4913,67,74,3206.59,5770.77,0.00
2024-12-08 17:14:16,141,4914,67,74,3234.08,5771.00,0.00
2024-12-08 17:14:16,142,4914,67,75,3211.30,5771.01,0.00
2024-12-08 17:14:16,141,4914,67,74,3226.74,5771.07,0.00
2024-12-08 17:14:16,140,4914,66,74,3244.05,5771.17,0.00
2024-12-08 17:14:16,140,4915,66,74,3269.79,5772.00,0.00
2024-12-08 17:14:16,141,4915,67,74,3246.60,5772.01,0.00
2024-12-08 17:14:16,140,4915,67,73,3259.93,5772.11,0.00
2024-12-08 17:14:16,139,4915,66,73,3280.08,5772.17,0.00
2024-12-08 17:14:16,139,4916,66,73,3264.32,5773.00,0.00
2024-12-08 17:14:16,140,4916,67,73,3241.00,5773.01,0.00
2024-12-08 17:14:16,139,4916,66,73,3227.89,5773.35,0.00
2024-12-08 17:14:16,139,4917,66,73,3230.56,5774.00,0.00
2024-12-08 17:14:16,140,4917,66,74,3207.49,5774.01,0.00
2024-12-08 17:14:16,139,4917,65,74,3224.75,5774.02,0.00
2024-12-08 17:14:16,138,4917,65,73,3239.78,5774.09,0.00
2024-12-08 17:14:16,139,4916,66,73,3207.38,5774.26,0.00
2024-12-08 17:14:16,139,4917,66,73,3233.96,5775.00,0.00
2024-12-08 17:14:16,140,4917,67,73,3210.86,5775.01,0.00
2024-12-08 17:14:16,139,4917,67,72,3223.20,5775.11,0.00
2024-12-08 17:14:16,139,4918,67,72,3244.87,5776.00,0.00
2024-12-08 17:14:16,140,4918,68,72,3221.69,5776.01,0.00
2024-12-08 17:14:16,139,4918,68,71,3234.11,5776.11,0.00
2024-12-08 17:14:16,139,4919,68,71,3212.84,5777.00,0.00
2024-12-08 17:14:16,140,4919,68,72,3189.90,5777.01,0.00
2024-12-08 17:14:16,140,4920,68,72,3153.66,5778.00,0.00
2024-12-08 17:14:16,141,4920,69,72,3131.30,5778.01,0.00
2024-12-08 17:14:16,140,4920,68,72,3152.02,5778.03,0.00
2024-12-08 17:14:16,139,4920,68,71,3168.49,5778.10,0.00
2024-12-08 17:14:16,138,4920,67,71,3164.85,5778.57,0.00
2024-12-08 17:14:16,137,4920,66,71,3181.66,5778.64,0.00
2024-12-08 17:14:16,136,4920,65,71,3191.64,5778.79,0.00
2024-12-08 17:14:16,136,4921,65,71,3221.99,5779.00,0.00
2024-12-08 17:14:16,137,4921,65,72,3198.47,5779.01,0.00
2024-12-08 17:14:16,136,4921,65,71,3207.60,5779.14,0.00
2024-12-08 17:14:17,136,4922,65,71,3188.42,5780.00,0.00
2024-12-08 17:14:17,137,4922,66,71,3165.15,5780.01,0.00
2024-12-08 17:14:17,136,4922,65,71,3188.00,5780.01,0.00
2024-12-08 17:14:17,135,4922,64,71,3207.37,5780.07,0.00
2024-12-08 17:14:17,134,4922,64,70,3212.77,5780.13,0.00
2024-12-08 17:14:17,134,4923,64,70,3201.97,5781.00,0.00
2024-12-08 17:14:17,135,4923,65,70,3178.25,5781.01,0.00
2024-12-08 17:14:17,136,4922,66,70,3149.82,5781.11,0.00
2024-12-08 17:14:17,135,4922,65,70,3206.14,5781.13,0.00
2024-12-08 17:14:17,135,4923,65,70,3186.33,5782.00,0.00
2024-12-08 17:14:17,136,4923,66,70,3162.90,5782.01,0.00
2024-12-08 17:14:17,135,4923,66,69,3136.17,5782.67,0.00
2024-12-08 17:14:17,135,4924,66,69,3194.68,5783.00,0.00
2024-12-08 17:14:17,136,4924,67,69,3171.19,5783.01,0.00
2024-12-08 17:14:17,137,4923,67,70,3144.69,5783.08,0.00
2024-12-08 17:14:17,137,4924,67,70,3140.04,5784.00,0.00
2024-12-08 17:14:17,138,4924,67,71,3117.29,5784.01,0.00
2024-12-08 17:14:17,137,4924,67,70,3131.23,5784.12,0.00
2024-12-08 17:14:17,137,4925,67,70,3156.30,5785.00,0.00
2024-12-08 17:14:17,138,4925,68,70,3133.42,5785.01,0.00
2024-12-08 17:14:17,137,4925,67,70,3151.69,5785.08,0.00
2024-12-08 17:14:17,136,4925,67,69,3167.65,5785.11,0.00
2024-12-08 17:14:17,137,4924,68,69,3141.58,5785.18,0.00
2024-12-08 17:14:17,138,4923,68,70,3108.84,5785.44,0.00
2024-12-08 17:14:17,139,4922,69,70,3085.90,5785.86,0.00
2024-12-08 17:14:17,139,4923,69,70,3117.66,5786.00,0.00
2024-12-08 17:14:17,140,4923,69,71,3095.39,5786.01,0.00
2024-12-08 17:14:17,139,4923,69,70,3106.89,5786.11,0.00
2024-12-08 17:14:17,138,4923,68,70,3115.23,5786.36,0.00
2024-12-08 17:14:17,138,4924,68,70,3237.67,5787.00,0.00
2024-12-08 17:14:17,139,4924,68,71,3214.37,5787.01,0.00
2024-12-08 17:14:17,138,4924,68,70,3226.40,5787.12,0.00
2024-12-08 17:14:17,139,4923,69,70,3163.04,5787.68,0.00
2024-12-08 17:14:17,139,4924,69,70,3199.11,5788.00,0.00
2024-12-08 17:14:17,140,4924,69,71,3176.26,5788.01,0.00
2024-12-08 17:14:17,141,4923,70,71,3151.29,5788.06,0.00
2024-12-08 17:14:17,140,4923,70,70,3189.13,5788.12,0.00
2024-12-08 17:14:17,141,4922,71,70,3122.87,5788.75,0.00
2024-12-08 17:14:17,141,4923,71,70,3200.67,5789.00,0.00
2024-12-08 17:14:17,142,4923,71,71,3178.13,5789.01,0.00
2024-12-08 17:14:17,143,4922,72,71,3154.30,5789.05,0.00
2024-12-08 17:14:17,142,4922,71,71,3209.98,5789.10,0.00
2024-12-08 17:14:17,142,4923,71,71,3264.30,5790.00,0.00
2024-12-08 17:14:17,143,4923,72,71,3241.48,5790.01,0.00
2024-12-08 17:14:17,144,4922,72,72,3194.15,5790.31,0.00
2024-12-08 17:14:17,144,4923,72,72,3254.11,5791.00,0.00
2024-12-08 17:14:17,145,4923,72,73,3231.67,5791.01,0.00
2024-12-08 17:14:17,146,4922,73,73,3209.53,5791.02,0.00
2024-12-08 17:14:17,147,4921,73,74,3160.86,5791.76,0.00
2024-12-08 17:14:17,147,4922,73,74,3226.86,5792.00,0.00
2024-12-08 17:14:17,148,4922,74,74,3205.06,5792.01,0.00
2024-12-08 17:14:17,149,4921,74,75,3164.19,5792.22,0.00
2024-12-08 17:14:17,148,4921,73,75,3207.16,5792.38,0.00
2024-12-08 17:14:17,148,4922,73,75,3280.97,5793.00,0.00
2024-12-08 17:14:17,149,4922,74,75,3258.95,5793.01,0.00
2024-12-08 17:14:17,148,4922,74,74,3269.29,5793.12,0.00
2024-12-08 17:14:18,148,4923,74,74,3289.21,5794.00,0.00
2024-12-08 17:14:18,149,4923,74,75,3267.13,5794.01,0.00
2024-12-08 17:14:18,148,4923,74,74,3276.35,5794.14,0.00
2024-12-08 17:14:18,149,4922,75,74,3252.81,5794.18,0.00
2024-12-08 17:14:18,150,4921,76,74,3240.41,5794.57,0.00
2024-12-08 17:14:18,151,4920,76,75,3226.35,5794.73,0.00
2024-12-08 17:14:18,151,4921,76,75,3251.52,5795.00,0.00
2024-12-08 17:14:18,152,4921,76,76,3230.13,5795.01,0.00
2024-12-08 17:14:18,151,4921,76,75,3238.92,5795.14,0.00
2024-12-08 17:14:18,150,4921,75,75,3255.01,5795.23,0.00
2024-12-08 17:14:18,150,4922,75,75,3357.48,5796.00,0.00
2024-12-08 17:14:18,151,4922,75,76,3335.25,5796.01,0.00
2024-12-08 17:14:18,150,4922,75,75,3344.02,5796.15,0.00
2024-12-08 17:14:18,149,4922,74,75,3354.09,5796.36,0.00
2024-12-08 17:14:18,150,4921,75,75,3323.68,5796.51,0.00
2024-12-08 17:14:18,150,4922,75,75,3352.27,5797.00,0.00
2024-12-08 17:14:18,151,4922,76,75,3330.07,5797.01,0.00
2024-12-08 17:14:18,150,4922,76,74,3338.80,5797.15,0.00
2024-12-08 17:14:18,150,4923,76,74,3359.42,5798.00,0.00
2024-12-08 17:14:18,151,4923,76,75,3337.17,5798.01,0.00
2024-12-08 17:14:18,152,4922,76,76,3312.95,5798.06,0.00
2024-12-08 17:14:18,151,4922,76,75,3335.68,5798.10,0.00
2024-12-08 17:14:18,150,4922,76,74,3348.28,5798.16,0.00
2024-12-08 17:14:18,149,4922,75,74,3361.83,5798.26,0.00
2024-12-08 17:14:18,150,4921,76,74,3324.07,5798.54,0.00
2024-12-08 17:14:18,150,4922,76,74,3353.04,5799.00,0.00
2024-12-08 17:14:18,151,4922,76,75,3330.83,5799.01,0.00
2024-12-08 17:14:18,150,4922,76,74,3338.80,5799.15,0.00
2024-12-08 17:14:18,150,4923,76,74,3398.32,5800.00,0.00
2024-12-08 17:14:18,151,4923,77,74,3375.81,5800.01,0.00
2024-12-08 17:14:18,150,4923,77,73,3392.95,5800.09,0.00
2024-12-08 17:14:18,150,4924,77,73,3363.61,5801.00,0.00
2024-12-08 17:14:18,151,4924,78,73,3341.34,5801.01,0.00
2024-12-08 17:14:18,150,4924,78,72,3358.25,5801.09,0.00
2024-12-08 17:14:18,149,4924,77,72,3357.13,5801.37,0.00
2024-12-08 17:14:18,149,4925,77,72,3351.31,5802.00,0.00
2024-12-08 17:14:18,150,4925,78,72,3328.96,5802.01,0.00
2024-12-08 17:14:18,149,4925,78,71,3345.90,5802.09,0.00
2024-12-08 17:14:18,150,4924,79,71,3296.63,5802.44,0.00
2024-12-08 17:14:18,150,4925,79,71,3316.04,5803.00,0.00
2024-12-08 17:14:18,151,4925,79,72,3294.08,5803.01,0.00
2024-12-08 17:14:18,152,4924,79,73,3265.22,5803.15,0.00
2024-12-08 17:14:18,153,4923,80,73,3243.33,5803.63,0.00
2024-12-08 17:14:18,153,4924,80,73,3292.85,5804.00,0.00
2024-12-08 17:14:18,154,4924,80,74,3271.47,5804.01,0.00
2024-12-08 17:14:18,153,4924,79,74,3272.83,5804.22,0.00
2024-12-08 17:14:18,152,4924,78,74,3262.95,5804.75,0.00
2024-12-08 17:14:18,152,4925,78,74,3363.07,5805.00,0.00
2024-12-08 17:14:18,153,4925,78,75,3341.08,5805.01,0.00
2024-12-08 17:14:18,152,4925,77,75,3362.31,5805.01,0.00
2024-12-08 17:14:18,151,4925,76,75,3379.24,5805.10,0.00
2024-12-08 17:14:18,152,4924,76,76,3312.25,5805.76,0.00
2024-12-08 17:14:18,152,4925,76,76,3336.14,5806.00,0.00
2024-12-08 17:14:18,153,4925,76,77,3314.34,5806.01,0.00
2024-12-08 17:14:18,154,4924,77,77,3272.92,5806.23,0.00
2024-12-08 17:14:18,155,4923,77,78,3276.92,5806.31,0.00
2024-12-08 17:14:18,155,4924,77,78,3332.08,5807.00,0.00
2024-12-08 17:14:18,156,4924,78,78,3310.72,5807.01,0.00
2024-12-08 17:14:18,155,4924,78,77,3326.51,5807.10,0.00
2024-12-08 17:14:18,156,4923,79,77,3260.82,5807.75,0.00
2024-12-08 17:14:18,157,4922,79,78,3246.36,5807.77,0.00
2024-12-08 17:14:18,157,4923,79,78,3343.47,5808.00,0.00
2024-12-08 17:14:19,158,4923,80,78,3322.31,5808.01,0.00
2024-12-08 17:14:19,157,4923,80,77,3331.69,5808.11,0.00
2024-12-08 17:14:19,158,4922,81,77,3269.79,5808.83,0.00
2024-12-08 17:14:19,158,4923,81,77,3367.73,5809.00,0.00
2024-12-08 17:14:19,159,4923,82,77,3346.55,5809.01,0.00
2024-12-08 17:14:19,160,4922,82,78,3325.28,5809.03,0.00
2024-12-08 17:14:19,159,4922,81,78,3359.73,5809.05,0.00
2024-12-08 17:14:19,158,4922,81,77,3374.78,5809.11,0.00
2024-12-08 17:14:19,158,4923,81,77,3397.36,5810.00,0.00
2024-12-08 17:14:19,159,4923,82,77,3376.00,5810.01,0.00
2024-12-08 17:14:19,158,4923,82,76,3387.86,5810.12,0.00
2024-12-08 17:14:19,158,4924,82,76,3403.47,5811.00,0.00
2024-12-08 17:14:19,159,4924,83,76,3382.06,5811.01,0.00
2024-12-08 17:14:19,158,4924,83,75,3392.12,5811.14,0.00
2024-12-08 17:14:19,159,4923,83,76,3341.79,5811.65,0.00
2024-12-08 17:14:19,159,4924,83,76,3376.06,5812.00,0.00
2024-12-08 17:14:19,160,4924,84,76,3354.96,5812.01,0.00
2024-12-08 17:14:19,159,4924,84,75,3370.63,5812.09,0.00
2024-12-08 17:14:19,158,4924,84,74,3384.62,5812.15,0.00
2024-12-08 17:14:19,157,4924,83,74,3403.23,5812.20,0.00
2024-12-08 17:14:19,156,4924,82,74,3415.79,5812.36,0.00
2024-12-08 17:14:19,157,4923,82,75,3376.81,5812.67,0.00
2024-12-08 17:14:19,158,4922,83,75,3342.77,5812.94,0.00
2024-12-08 17:14:19,158,4923,83,75,3414.57,5813.00,0.00
2024-12-08 17:14:19,159,4923,84,75,3393.10,5813.01,0.00
2024-12-08 17:14:19,158,4923,84,74,3401.02,5813.15,0.00
2024-12-08 17:14:19,158,4924,84,74,3455.27,5814.00,0.00
2024-12-08 17:14:19,159,4924,85,74,3433.54,5814.01,0.00
2024-12-08 17:14:19,158,4924,85,73,3449.80,5814.10,0.00
2024-12-08 17:14:19,158,4925,85,73,3419.79,5815.00,0.00
2024-12-08 17:14:19,159,4925,85,74,3398.29,5815.01,0.00
2024-12-08 17:14:19,159,4926,85,74,3362.80,5816.00,0.00
2024-12-08 17:14:19,160,4926,85,75,3341.78,5816.01,0.00
2024-12-08 17:14:19,160,4927,85,75,3305.88,5817.00,0.00
2024-12-08 17:14:19,161,4927,86,75,3285.35,5817.01,0.00
2024-12-08 17:14:19,160,4927,86,74,3300.11,5817.10,0.00
2024-12-08 17:14:19,159,4927,85,74,3320.50,5817.10,0.00
2024-12-08 17:14:19,158,4927,84,74,3330.12,5817.17,0.00
2024-12-08 17:14:19,158,4928,84,74,3310.81,5818.00,0.00
2024-12-08 17:14:19,159,4928,85,74,3289.99,5818.01,0.00
2024-12-08 17:14:19,158,4928,84,74,3304.97,5818.10,0.00
2024-12-08 17:14:19,157,4928,84,73,3320.84,5818.13,0.00
2024-12-08 17:14:19,156,4928,83,73,3295.41,5818.88,0.00
2024-12-08 17:14:19,156,4929,83,73,3325.73,5819.00,0.00
2024-12-08 17:14:19,157,4929,83,74,3304.55,5819.01,0.00
2024-12-08 17:14:19,156,4929,83,73,3319.81,5819.10,0.00
2024-12-08 17:14:19,155,4929,83,72,3335.61,5819.13,0.00
2024-12-08 17:14:19,156,4928,84,72,3303.18,5819.33,0.00
2024-12-08 17:14:19,156,4929,84,72,3318.55,5820.00,0.00
2024-12-08 17:14:19,157,4929,85,72,3297.41,5820.01,0.00
2024-12-08 17:14:19,157,4930,85,72,3299.35,5821.00,0.00
2024-12-08 17:14:19,158,4930,86,72,3278.47,5821.01,0.00
2024-12-08 17:14:19,157,4930,86,71,3293.47,5821.10,0.00
2024-12-08 17:14:19,157,4931,86,71,3263.87,5822.00,0.00
2024-12-08 17:14:19,158,4931,86,72,3243.21,5822.01,0.00
2024-12-08 17:14:19,159,4930,87,72,3180.25,5822.62,0.00
2024-12-08 17:14:20,158,4930,86,72,3202.72,5822.80,0.00
2024-12-08 17:14:20,158,4931,86,72,3220.58,5823.00,0.00
2024-12-08 17:14:20,159,4931,87,72,3200.32,5823.01,0.00
2024-12-08 17:14:20,160,4930,87,73,3156.39,5823.31,0.00
2024-12-08 17:14:20,160,4931,87,73,3192.04,5824.00,0.00
2024-12-08 17:14:20,161,4931,87,74,3172.22,5824.01,0.00
2024-12-08 17:14:20,162,4930,87,75,3151.93,5824.03,0.00
2024-12-08 17:14:20,162,4931,87,75,3181.23,5825.00,0.00
2024-12-08 17:14:20,163,4931,87,76,3161.71,5825.01,0.00
2024-12-08 17:14:20,162,4931,86,76,3178.38,5825.05,0.00
2024-12-08 17:14:20,161,4931,86,75,3193.43,5825.09,0.00
2024-12-08 17:14:20,161,4932,86,75,3206.24,5826.00,0.00
2024-12-08 17:14:20,162,4932,87,75,3186.44,5826.01,0.00
2024-12-08 17:14:20,161,4932,87,74,3193.26,5826.11,0.00
2024-12-08 17:14:20,160,4932,86,74,3187.17,5826.56,0.00
2024-12-08 17:14:20,160,4933,86,74,3190.77,5827.00,0.00
2024-12-08 17:14:20,161,4933,87,74,3170.96,5827.01,0.00
2024-12-08 17:14:20,160,4933,87,73,3184.99,5827.10,0.00
2024-12-08 17:14:20,159,4933,87,72,3202.09,5827.11,0.00
2024-12-08 17:14:20,159,4934,87,72,3180.24,5828.00,0.00
2024-12-08 17:14:20,160,4934,87,73,3160.36,5828.01,0.00
2024-12-08 17:14:20,159,4934,87,72,3171.85,5828.11,0.00
2024-12-08 17:14:20,158,4934,86,72,3170.62,5828.37,0.00
2024-12-08 17:14:20,158,4935,86,72,3171.40,5829.00,0.00
2024-12-08 17:14:20,159,4935,86,73,3151.45,5829.01,0.00
2024-12-08 17:14:20,158,4935,86,72,3162.22,5829.11,0.00
2024-12-08 17:14:20,159,4934,86,73,3132.49,5829.30,0.00
2024-12-08 17:14:20,159,4935,86,73,3136.23,5830.00,0.00
2024-12-08 17:14:20,160,4935,87,73,3116.63,5830.01,0.00
2024-12-08 17:14:20,161,4934,88,73,3094.04,5830.08,0.00
2024-12-08 17:14:20,160,4934,87,73,3137.08,5830.11,0.00
2024-12-08 17:14:20,161,4933,88,73,3069.41,5830.83,0.00
2024-12-08 17:14:20,161,4934,88,73,3131.84,5831.00,0.00
2024-12-08 17:14:20,162,4934,88,74,3112.51,5831.01,0.00
2024-12-08 17:14:20,161,4934,88,73,3119.22,5831.12,0.00
2024-12-08 17:14:20,161,4935,88,73,3169.69,5832.00,0.00
2024-12-08 17:14:20,162,4935,89,73,3150.13,5832.01,0.00
2024-12-08 17:14:20,161,4935,89,72,3163.94,5832.10,0.00
2024-12-08 17:14:20,160,4935,88,72,3166.65,5832.33,0.00
2024-12-08 17:14:20,160,4936,88,72,3164.17,5833.00,0.00
2024-12-08 17:14:20,161,4936,88,73,3144.51,5833.01,0.00
2024-12-08 17:14:20,160,4936,88,72,3155.47,5833.12,0.00
2024-12-08 17:14:20,159,4936,87,72,3172.38,5833.13,0.00
2024-12-08 17:14:20,159,4937,87,72,3158.40,5834.00,0.00
2024-12-08 17:14:20,160,4937,87,73,3138.66,5834.01,0.00
2024-12-08 17:14:20,159,4937,87,72,3150.02,5834.12,0.00
2024-12-08 17:14:20,160,4936,87,73,3103.28,5834.59,0.00
2024-12-08 17:14:20,161,4935,88,73,3094.93,5834.67,0.00
2024-12-08 17:14:20,161,4936,88,73,3117.65,5835.00,0.00
2024-12-08 17:14:20,162,4936,88,74,3098.41,5835.01,0.00
2024-12-08 17:14:20,161,4936,87,74,3110.09,5835.10,0.00
2024-12-08 17:14:20,160,4936,87,73,3125.52,5835.13,0.00
2024-12-08 17:14:20,161,4935,87,74,3070.43,5835.75,0.00
2024-12-08 17:14:20,161,4936,87,74,3174.29,5836.00,0.00
2024-12-08 17:14:20,162,4936,88,74,3154.70,5836.01,0.00
2024-12-08 17:14:20,161,4936,87,74,3171.42,5836.05,0.00
2024-12-08 17:14:20,160,4936,87,73,3184.70,5836.12,0.00
2024-12-08 17:14:21,160,4937,87,73,3198.83,5837.00,0.00
2024-12-08 17:14:21,161,4937,88,73,3178.96,5837.01,0.00
2024-12-08 17:14:21,160,4937,88,72,3189.39,5837.12,0.00
2024-12-08 17:14:21,159,4937,87,72,3207.53,5837.15,0.00
2024-12-08 17:14:21,159,4938,87,72,3187.47,5838.00,0.00
2024-12-08 17:14:21,160,4938,88,72,3167.54,5838.01,0.00
2024-12-08 17:14:21,161,4937,88,73,3146.08,5838.05,0.00
2024-12-08 17:14:21,162,4936,89,73,3138.93,5838.09,0.00
2024-12-08 17:14:21,161,4936,89,72,3168.95,5838.13,0.00
2024-12-08 17:14:21,161,4937,89,72,3147.68,5839.00,0.00
2024-12-08 17:14:21,162,4937,89,73,3128.25,5839.01,0.00
2024-12-08 17:14:21,161,4937,89,72,3136.13,5839.14,0.00
2024-12-08 17:14:21,161,4938,89,72,3188.12,5840.00,0.00
2024-12-08 17:14:21,162,4938,89,73,3168.44,5840.01,0.00
2024-12-08 17:14:21,161,4938,88,73,3183.09,5840.09,0.00
2024-12-08 17:14:21,160,4938,87,73,3201.89,5840.10,0.00
2024-12-08 17:14:21,159,4938,86,73,3221.66,5840.10,0.00
2024-12-08 17:14:21,158,4938,86,72,3236.15,5840.13,0.00
2024-12-08 17:14:21,158,4939,86,72,3215.57,5841.00,0.00
2024-12-08 17:14:21,159,4939,87,72,3195.35,5841.01,0.00
2024-12-08 17:14:21,160,4938,87,73,3123.81,5841.66,0.00
2024-12-08 17:14:21,160,4939,87,73,3153.28,5842.00,0.00
2024-12-08 17:14:21,161,4939,87,74,3133.70,5842.01,0.00
2024-12-08 17:14:21,162,4938,88,74,3114.00,5842.03,0.00
2024-12-08 17:14:21,161,4938,87,74,3143.15,5842.04,0.00
2024-12-08 17:14:21,162,4937,88,74,3070.74,5842.84,0.00
2024-12-08 17:14:21,162,4938,88,74,3139.77,5843.00,0.00
2024-12-08 17:14:21,163,4938,88,75,3120.51,5843.01,0.00
2024-12-08 17:14:21,164,4937,88,76,3060.03,5843.61,0.00
2024-12-08 17:14:21,165,4936,88,77,3053.20,5843.66,0.00
2024-12-08 17:14:21,165,4937,88,77,3144.84,5844.00,0.00
2024-12-08 17:14:21,166,4937,89,77,3125.90,5844.01,0.00
2024-12-08 17:14:21,165,4937,89,76,3131.79,5844.13,0.00
2024-12-08 17:14:21,166,4936,89,77,3105.57,5844.27,0.00
2024-12-08 17:14:21,166,4937,89,77,3188.56,5845.00,0.00
2024-12-08 17:14:21,167,4937,90,77,3169.46,5845.01,0.00
2024-12-08 17:14:21,166,4937,89,77,3183.32,5845.09,0.00
2024-12-08 17:14:21,165,4937,88,77,3201.90,5845.09,0.00
2024-12-08 17:14:21,165,4938,88,77,3213.04,5846.00,0.00
2024-12-08 17:14:21,166,4938,89,77,3193.68,5846.01,0.00
2024-12-08 17:14:21,165,4938,88,77,3207.77,5846.09,0.00
2024-12-08 17:14:21,165,4939,88,77,3176.38,5847.00,0.00
2024-12-08 17:14:21,166,4939,89,77,3157.24,5847.01,0.00
2024-12-08 17:14:21,165,4939,88,77,3171.46,5847.09,0.00
2024-12-08 17:14:21,164,4939,88,76,3184.75,5847.12,0.00
2024-12-08 17:14:21,164,4940,88,76,3162.06,5848.00,0.00
2024-12-08 17:14:21,165,4940,88,77,3142.90,5848.01,0.00
2024-12-08 17:14:21,164,4940,88,76,3152.84,5848.12,0.00
2024-12-08 17:14:21,164,4941,88,76,3130.15,5849.00,0.00
2024-12-08 17:14:21,165,4941,88,77,3111.18,5849.01,0.00
2024-12-08 17:14:21,166,4940,89,77,3067.86,5849.32,0.00
2024-12-08 17:14:21,166,4941,89,77,3087.33,5850.00,0.00
2024-12-08 17:14:21,167,4941,89,78,3068.84,5850.01,0.00
2024-12-08 17:14:21,166,4941,88,78,3044.57,5850.62,0.00
2024-12-08 17:14:22,166,4942,88,78,3086.09,5851.00,0.00
2024-12-08 17:14:22,167,4942,88,79,3067.61,5851.01,0.00
2024-12-08 17:14:22,168,4941,89,79,3031.65,5851.20,0.00
2024-12-08 17:14:22,167,4941,88,79,3077.50,5851.23,0.00
2024-12-08 17:14:22,167,4942,88,79,3061.13,5852.00,0.00
2024-12-08 17:14:22,168,4942,88,80,3042.91,5852.01,0.00
2024-12-08 17:14:22,167,4942,87,80,3055.56,5852.10,0.00
2024-12-08 17:14:22,166,4942,87,79,3066.92,5852.11,0.00
2024-12-08 17:14:22,165,4942,86,79,3078.09,5852.23,0.00
2024-12-08 17:14:22,164,4942,85,79,3058.23,5852.78,0.00
2024-12-08 17:14:22,164,4943,85,79,3116.94,5853.00,0.00
2024-12-08 17:14:22,165,4943,86,79,3098.05,5853.01,0.00
2024-12-08 17:14:22,164,4943,85,79,3113.76,5853.06,0.00
2024-12-08 17:14:22,163,4943,84,79,3130.01,5853.10,0.00
2024-12-08 17:14:22,162,4943,84,78,3147.52,5853.10,0.00
2024-12-08 17:14:22,162,4944,84,78,3124.16,5854.00,0.00
2024-12-08 17:14:22,163,4944,84,79,3105.00,5854.01,0.00
2024-12-08 17:14:22,162,4944,84,78,3116.98,5854.10,0.00
2024-12-08 17:14:22,161,4944,83,78,3113.15,5854.39,0.00
2024-12-08 17:14:22,162,4943,83,79,3083.54,5854.57,0.00
2024-12-08 17:14:22,162,4944,83,79,3101.56,5855.00,0.00
2024-12-08 17:14:22,163,4944,83,80,3082.54,5855.01,0.00
2024-12-08 17:14:22,162,4944,83,79,3093.66,5855.11,0.00
2024-12-08 17:14:22,161,4944,82,79,3106.36,5855.22,0.00
2024-12-08 17:14:22,162,4943,83,79,3083.94,5855.28,0.00
2024-12-08 17:14:22,163,4942,83,80,3089.87,5855.43,0.00
2024-12-08 17:14:22,164,4941,83,81,3058.82,5855.90,0.00
2024-12-08 17:14:22,164,4942,83,81,3128.18,5856.00,0.00
2024-12-08 17:14:22,165,4942,83,82,3109.22,5856.01,0.00
2024-12-08 17:14:22,164,4942,83,81,3121.08,5856.10,0.00
2024-12-08 17:14:22,163,4942,82,81,3138.43,5856.10,0.00
2024-12-08 17:14:22,164,4941,83,81,3114.32,5856.20,0.00
2024-12-08 17:14:22,163,4941,82,81,3162.54,5856.21,0.00
2024-12-08 17:14:22,163,4942,82,81,3260.14,5857.00,0.00
2024-12-08 17:14:22,164,4942,83,81,3240.26,5857.01,0.00
2024-12-08 17:14:22,163,4942,83,80,3252.64,5857.11,0.00
2024-12-08 17:14:22,164,4941,84,80,3221.80,5857.31,0.00
2024-12-08 17:14:22,164,4942,84,80,3262.28,5858.00,0.00
2024-12-08 17:14:22,165,4942,84,81,3242.51,5858.01,0.00
2024-12-08 17:14:22,166,4941,85,81,3221.23,5858.05,0.00
2024-12-08 17:14:22,165,4941,84,81,3265.27,5858.07,0.00
2024-12-08 17:14:22,164,4941,83,81,3283.40,5858.10,0.00
2024-12-08 17:14:22,163,4941,83,80,3301.75,5858.10,0.00
2024-12-08 17:14:22,162,4941,82,80,3316.38,5858.20,0.00
2024-12-08 17:14:22,163,4940,83,80,3285.99,5858.26,0.00
2024-12-08 17:14:22,162,4940,82,80,3322.20,5858.26,0.00
2024-12-08 17:14:22,163,4939,82,81,3276.51,5858.71,0.00
2024-12-08 17:14:22,163,4940,82,81,3339.37,5859.00,0.00
2024-12-08 17:14:22,164,4940,82,82,3319.01,5859.01,0.00
2024-12-08 17:14:22,164,4941,82,82,3386.98,5860.00,0.00
2024-12-08 17:14:22,165,4941,83,82,3366.46,5860.01,0.00
2024-12-08 17:14:22,164,4941,82,82,3374.52,5860.09,0.00
2024-12-08 17:14:22,163,4941,81,82,3389.14,5860.19,0.00
2024-12-08 17:14:22,164,4940,82,82,3330.11,5860.81,0.00
2024-12-08 17:14:22,164,4941,82,82,3353.52,5861.00,0.00
2024-12-08 17:14:22,165,4941,83,82,3333.19,5861.01,0.00
2024-12-08 17:14:22,164,4941,82,82,3335.01,5861.20,0.00
2024-12-08 17:14:22,163,4941,81,82,3332.90,5861.58,0.00
2024-12-08 17:14:22,163,4942,81,82,3370.63,5862.00,0.00
2024-12-08 17:14:22,164,4942,82,82,3350.07,5862.01,0.00
2024-12-08 17:14:22,164,4943,82,82,3310.98,5863.00,0.00
2024-12-08 17:14:22,165,4943,82,83,3290.91,5863.01,0.00
2024-12-08 17:14:22,164,4943,82,82,3303.49,5863.04,0.00
2024-12-08 17:14:22,165,4942,83,82,3247.49,5863.67,0.00
2024-12-08 17:14:22,165,4943,83,82,3265.07,5864.00,0.00
2024-12-08 17:14:22,166,4943,83,83,3245.40,5864.01,0.00
2024-12-08 17:14:22,167,4942,83,84,3222.48,5864.08,0.00
2024-12-08 17:14:23,166,4942,83,83,3254.98,5864.10,0.00
2024-12-08 17:14:23,166,4943,83,83,3263.29,5865.00,0.00
2024-12-08 17:14:23,167,4943,83,84,3243.75,5865.01,0.00
2024-12-08 17:14:23,166,4943,83,83,3257.32,5865.08,0.00
2024-12-08 17:14:23,165,4943,83,82,3276.71,5865.09,0.00
2024-12-08 17:14:23,164,4943,82,82,3286.73,5865.23,0.00
2024-12-08 17:14:23,165,4942,83,82,3251.98,5865.50,0.00
2024-12-08 17:14:23,166,4941,83,83,3227.35,5865.86,0.00
2024-12-08 17:14:23,166,4942,83,83,3293.91,5866.00,0.00
2024-12-08 17:14:23,167,4942,84,83,3274.18,5866.01,0.00
2024-12-08 17:14:23,168,4941,84,84,3208.21,5866.70,0.00
2024-12-08 17:14:23,168,4942,84,84,3318.24,5867.00,0.00
2024-12-08 17:14:23,169,4942,84,85,3298.61,5867.01,0.00
2024-12-08 17:14:23,168,4942,83,85,3315.47,5867.05,0.00
2024-12-08 17:14:23,167,4942,82,85,3325.86,5867.08,0.00
2024-12-08 17:14:23,167,4943,82,85,3328.58,5868.00,0.00
2024-12-08 17:14:23,168,4943,83,85,3308.76,5868.01,0.00
2024-12-08 17:14:23,168,4944,83,85,3263.88,5869.00,0.00
2024-12-08 17:14:23,169,4944,84,85,3244.56,5869.01,0.00
2024-12-08 17:14:23,169,4945,84,85,3200.11,5870.00,0.00
2024-12-08 17:14:23,170,4945,85,85,3181.28,5870.01,0.00
2024-12-08 17:14:23,169,4945,85,84,3195.28,5870.08,0.00
2024-12-08 17:14:23,168,4945,84,84,3212.56,5870.10,0.00
2024-12-08 17:14:23,167,4945,83,84,3225.51,5870.21,0.00
2024-12-08 17:14:23,167,4946,83,84,3200.74,5871.00,0.00
2024-12-08 17:14:23,168,4946,84,84,3181.69,5871.01,0.00
2024-12-08 17:14:23,167,4946,84,83,3189.18,5871.08,0.00
2024-12-08 17:14:23,166,4946,84,82,3206.98,5871.10,0.00
2024-12-08 17:14:23,165,4946,83,82,3220.41,5871.20,0.00
2024-12-08 17:14:23,164,4946,82,82,3200.64,5871.79,0.00
2024-12-08 17:14:23,164,4947,82,82,3215.30,5872.00,0.00
2024-12-08 17:14:23,165,4947,82,83,3195.81,5872.01,0.00
2024-12-08 17:14:23,164,4947,81,83,3184.27,5872.34,0.00
2024-12-08 17:14:23,163,4947,80,83,3198.44,5872.43,0.00
2024-12-08 17:14:23,163,4948,80,83,3194.52,5873.00,0.00
2024-12-08 17:14:23,164,4948,81,83,3175.04,5873.01,0.00
2024-12-08 17:14:23,163,4948,81,82,3186.27,5873.08,0.00
2024-12-08 17:14:23,162,4948,80,82,3198.01,5873.22,0.00
2024-12-08 17:14:23,163,4947,80,83,3171.94,5873.34,0.00
2024-12-08 17:14:23,162,4947,79,83,3190.13,5873.49,0.00
2024-12-08 17:14:23,163,4946,80,83,3141.18,5873.90,0.00
2024-12-08 17:14:23,163,4947,80,83,3173.32,5874.00,0.00
2024-12-08 17:14:23,164,4947,81,83,3153.97,5874.01,0.00
2024-12-08 17:14:23,163,4947,81,82,3164.70,5874.08,0.00
2024-12-08 17:14:23,162,4947,81,81,3183.16,5874.09,0.00
2024-12-08 17:14:23,163,4946,81,82,3157.18,5874.22,0.00
2024-12-08 17:14:23,164,4945,81,83,3131.21,5874.46,0.00
2024-12-08 17:14:23,163,4945,80,83,3159.67,5874.63,0.00
2024-12-08 17:14:23,163,4946,80,83,3243.10,5875.00,0.00
2024-12-08 17:14:23,164,4946,81,83,3223.33,5875.01,0.00
2024-12-08 17:14:23,163,4946,81,82,3236.15,5875.10,0.00
2024-12-08 17:14:23,162,4946,80,82,3237.38,5875.42,0.00
2024-12-08 17:14:23,162,4947,80,82,3302.39,5876.00,0.00
2024-12-08 17:14:23,163,4947,80,83,3282.13,5876.01,0.00
2024-12-08 17:14:23,162,4947,79,83,3296.01,5876.09,0.00
2024-12-08 17:14:23,161,4947,79,82,3315.02,5876.09,0.00
2024-12-08 17:14:23,160,4947,78,82,3313.07,5876.38,0.00
2024-12-08 17:14:23,160,4948,78,82,3310.44,5877.00,0.00
2024-12-08 17:14:23,161,4948,79,82,3289.88,5877.01,0.00
2024-12-08 17:14:23,162,4947,79,83,3224.08,5877.55,0.00
2024-12-08 17:14:24,162,4948,79,83,3245.62,5878.00,0.00
2024-12-08 17:14:24,163,4948,79,84,3225.70,5878.01,0.00
2024-12-08 17:14:24,164,4947,80,84,3191.04,5878.15,0.00
2024-12-08 17:14:24,163,4947,79,84,3214.32,5878.42,0.00
2024-12-08 17:14:24,162,4947,79,83,3197.95,5878.90,0.00
2024-12-08 17:14:24,162,4948,79,83,3264.81,5879.00,0.00
2024-12-08 17:14:24,163,4948,80,83,3244.78,5879.01,0.00
2024-12-08 17:14:24,162,4948,79,83,3222.19,5879.53,0.00
2024-12-08 17:14:24,162,4949,79,83,3267.18,5880.00,0.00
2024-12-08 17:14:24,163,4949,80,83,3247.13,5880.01,0.00
2024-12-08 17:14:24,164,4948,81,83,3224.84,5880.06,0.00
2024-12-08 17:14:24,163,4948,81,82,3256.18,5880.09,0.00
2024-12-08 17:14:24,162,4948,80,82,3265.09,5880.27,0.00
2024-12-08 17:14:24,163,4947,80,83,3236.11,5880.44,0.00
2024-12-08 17:14:24,164,4946,81,83,3222.19,5880.70,0.00
2024-12-08 17:14:24,164,4947,81,83,3243.39,5881.00,0.00
2024-12-08 17:14:24,165,4947,82,83,3223.73,5881.01,0.00
2024-12-08 17:14:24,164,4947,81,83,3241.25,5881.04,0.00
2024-12-08 17:14:24,163,4947,81,82,3248.54,5881.10,0.00
2024-12-08 17:14:24,164,4946,81,83,3221.24,5881.24,0.00
2024-12-08 17:14:24,165,4945,82,83,3223.20,5881.41,0.00
2024-12-08 17:14:24,165,4946,82,83,3351.67,5882.00,0.00
2024-12-08 17:14:24,166,4946,82,84,3331.48,5882.01,0.00
2024-12-08 17:14:24,165,4946,81,84,3330.31,5882.25,0.00
2024-12-08 17:14:24,165,4947,81,84,3384.02,5883.00,0.00
2024-12-08 17:14:24,166,4947,82,84,3363.64,5883.01,0.00
2024-12-08 17:14:24,165,4947,82,83,3378.36,5883.10,0.00
2024-12-08 17:14:24,165,4948,82,83,3342.98,5884.00,0.00
2024-12-08 17:14:24,166,4948,82,84,3322.84,5884.01,0.00
2024-12-08 17:14:24,165,4948,81,84,3312.81,5884.40,0.00
2024-12-08 17:14:24,166,4947,82,84,3290.04,5884.46,0.00
2024-12-08 17:14:24,167,4946,83,84,3265.35,5884.69,0.00
2024-12-08 17:14:24,167,4947,83,84,3280.94,5885.00,0.00
2024-12-08 17:14:24,168,4947,84,84,3261.41,5885.01,0.00
2024-12-08 17:14:24,167,4947,84,83,3270.76,5885.10,0.00
2024-12-08 17:14:24,166,4947,83,83,3239.76,5885.78,0.00
2024-12-08 17:14:24,166,4948,83,83,3331.29,5886.00,0.00
2024-12-08 17:14:24,167,4948,83,84,3311.34,5886.01,0.00
2024-12-08 17:14:24,166,4948,83,83,3325.65,5886.10,0.00
2024-12-08 17:14:24,166,4949,83,83,3293.94,5887.00,0.00
2024-12-08 17:14:24,167,4949,84,83,3274.21,5887.01,0.00
2024-12-08 17:14:24,166,4949,84,82,3281.21,5887.10,0.00
2024-12-08 17:14:24,165,4949,83,82,3282.95,5887.28,0.00
2024-12-08 17:14:24,165,4950,83,82,3270.75,5888.00,0.00
2024-12-08 17:14:24,166,4950,83,83,3251.04,5888.01,0.00
2024-12-08 17:14:24,165,4950,83,82,3264.72,5888.10,0.00
2024-12-08 17:14:24,164,4950,83,81,3283.56,5888.11,0.00
2024-12-08 17:14:24,163,4950,82,81,3295.77,5888.18,0.00
2024-12-08 17:14:24,164,4949,83,81,3248.24,5888.60,0.00
2024-12-08 17:14:24,164,4950,83,81,3272.02,5889.00,0.00
2024-12-08 17:14:24,165,4950,83,82,3252.19,5889.01,0.00
2024-12-08 17:14:24,164,4950,82,82,3270.59,5889.02,0.00
2024-12-08 17:14:24,163,4950,82,81,3284.55,5889.11,0.00
2024-12-08 17:14:24,162,4950,81,81,3301.20,5889.14,0.00
2024-12-08 17:14:24,163,4949,81,82,3273.76,5889.27,0.00
2024-12-08 17:14:24,164,4948,81,83,3255.70,5889.76,0.00
2024-12-08 17:14:24,164,4949,81,83,3321.96,5890.00,0.00
2024-12-08 17:14:24,165,4949,81,84,3301.83,5890.01,0.00
2024-12-08 17:14:24,164,4949,81,83,3315.81,5890.10,0.00
2024-12-08 17:14:24,163,4949,81,82,3335.43,5890.10,0.00
2024-12-08 17:14:24,163,4950,81,82,3378.55,5891.00,0.00
2024-12-08 17:14:24,164,4950,81,83,3357.95,5891.01,0.00
2024-12-08 17:14:24,163,4950,80,83,3378.19,5891.01,0.00
2024-12-08 17:14:25,164,4949,80,84,3339.95,5891.20,0.00
2024-12-08 17:14:25,164,4950,80,84,3320.05,5892.00,0.00
2024-12-08 17:14:25,165,4950,80,85,3299.93,5892.01,0.00
2024-12-08 17:14:25,164,4950,79,85,3286.01,5892.43,0.00
2024-12-08 17:14:25,163,4950,78,85,3297.44,5892.49,0.00
2024-12-08 17:14:25,163,4951,78,85,3337.09,5893.00,0.00
2024-12-08 17:14:25,164,4951,79,85,3316.74,5893.01,0.00
2024-12-08 17:14:25,163,4951,78,85,3323.75,5893.10,0.00
2024-12-08 17:14:25,162,4951,77,85,3329.40,5893.25,0.00
2024-12-08 17:14:25,163,4950,77,86,3284.06,5893.60,0.00
2024-12-08 17:14:25,163,4951,77,86,3297.92,5894.00,0.00
2024-12-08 17:14:25,164,4951,77,87,3277.81,5894.01,0.00
2024-12-08 17:14:25,163,4951,77,86,3284.94,5894.10,0.00
2024-12-08 17:14:25,162,4951,76,86,3304.49,5894.11,0.00
2024-12-08 17:14:25,161,4951,75,86,3288.78,5894.67,0.00
2024-12-08 17:14:25,161,4952,75,86,3335.18,5895.00,0.00
2024-12-08 17:14:25,162,4952,76,86,3314.60,5895.01,0.00
2024-12-08 17:14:25,161,4952,75,86,3331.91,5895.05,0.00
2024-12-08 17:14:25,160,4952,75,85,3345.02,5895.09,0.00
2024-12-08 17:14:25,159,4952,75,84,3365.32,5895.10,0.00
2024-12-08 17:14:25,160,4951,76,84,3343.18,5895.13,0.00
2024-12-08 17:14:25,160,4952,76,84,3333.99,5896.00,0.00
2024-12-08 17:14:25,161,4952,77,84,3313.28,5896.01,0.00
2024-12-08 17:14:25,160,4952,77,83,3320.76,5896.10,0.00
2024-12-08 17:14:25,159,4952,76,83,3341.28,5896.10,0.00
2024-12-08 17:14:25,159,4953,76,83,3355.52,5897.00,0.00
2024-12-08 17:14:25,160,4953,77,83,3334.55,5897.01,0.00
2024-12-08 17:14:25,160,4954,77,83,3297.88,5898.00,0.00
2024-12-08 17:14:25,161,4954,78,83,3277.40,5898.01,0.00
2024-12-08 17:14:25,160,4954,78,82,3286.13,5898.09,0.00
2024-12-08 17:14:25,159,4954,78,81,3306.42,5898.09,0.00
2024-12-08 17:14:25,160,4953,79,81,3270.37,5898.37,0.00
2024-12-08 17:14:25,160,4954,79,81,3284.97,5899.00,0.00
2024-12-08 17:14:25,161,4954,80,81,3264.57,5899.01,0.00
2024-12-08 17:14:25,160,4954,80,80,3271.37,5899.11,0.00
2024-12-08 17:14:25,161,4953,80,81,3224.01,5899.57,0.00
2024-12-08 17:14:25,161,4954,80,81,3287.28,5900.00,0.00
2024-12-08 17:14:25,162,4954,81,81,3266.98,5900.01,0.00
2024-12-08 17:14:25,161,4954,81,80,3255.90,5900.39,0.00
2024-12-08 17:14:25,161,4955,81,80,3285.80,5901.00,0.00
2024-12-08 17:14:25,162,4955,82,80,3265.52,5901.01,0.00
2024-12-08 17:14:25,161,4955,81,80,3243.29,5901.60,0.00
2024-12-08 17:14:25,162,4954,82,80,3220.39,5901.66,0.00
2024-12-08 17:14:25,162,4955,82,80,3241.07,5902.00,0.00
2024-12-08 17:14:25,163,4955,83,80,3221.18,5902.01,0.00
2024-12-08 17:14:25,162,4955,82,80,3227.90,5902.11,0.00
2024-12-08 17:14:25,163,4954,82,81,3201.61,5902.23,0.00
2024-12-08 17:14:25,162,4954,81,81,3221.81,5902.39,0.00
2024-12-08 17:14:25,163,4953,82,81,3187.64,5902.63,0.00
2024-12-08 17:14:25,163,4954,82,81,3234.27,5903.00,0.00
2024-12-08 17:14:25,164,4954,83,81,3214.55,5903.01,0.00
2024-12-08 17:14:25,163,4954,83,80,3224.53,5903.09,0.00
2024-12-08 17:14:25,162,4954,83,79,3243.71,5903.10,0.00
2024-12-08 17:14:25,163,4953,83,80,3205.81,5903.42,0.00
2024-12-08 17:14:25,163,4954,83,80,3294.84,5904.00,0.00
2024-12-08 17:14:25,164,4954,84,80,3274.75,5904.01,0.00
2024-12-08 17:14:25,163,4954,84,79,3288.72,5904.10,0.00
2024-12-08 17:14:25,164,4953,85,79,3229.15,5904.67,0.00
2024-12-08 17:14:25,164,4954,85,79,3279.73,5905.00,0.00
2024-12-08 17:14:25,165,4954,86,79,3259.86,5905.01,0.00
2024-12-08 17:14:26,164,4954,86,78,3273.65,5905.10,0.00
2024-12-08 17:14:26,164,4955,86,78,3264.21,5906.00,0.00
2024-12-08 17:14:26,165,4955,87,78,3244.43,5906.01,0.00
2024-12-08 17:14:26,164,4955,86,78,3262.06,5906.04,0.00
2024-12-08 17:14:26,163,4955,86,77,3270.51,5906.10,0.00
2024-12-08 17:14:26,162,4955,85,77,3261.35,5906.51,0.00
2024-12-08 17:14:26,162,4956,85,77,3242.72,5907.00,0.00
2024-12-08 17:14:26,163,4956,86,77,3222.82,5907.01,0.00
2024-12-08 17:14:26,162,4956,86,76,3231.81,5907.10,0.00
2024-12-08 17:14:26,163,4955,86,77,3191.28,5907.42,0.00
2024-12-08 17:14:26,162,4955,86,76,3192.80,5907.75,0.00
2024-12-08 17:14:26,162,4956,86,76,3195.94,5908.00,0.00
2024-12-08 17:14:26,163,4956,87,76,3176.34,5908.01,0.00
2024-12-08 17:14:26,162,4956,87,75,3181.39,5908.10,0.00
2024-12-08 17:14:26,161,4956,86,75,3200.06,5908.11,0.00
2024-12-08 17:14:26,160,4956,86,74,3173.02,5908.78,0.00
2024-12-08 17:14:26,160,4957,86,74,3233.61,5909.00,0.00
2024-12-08 17:14:26,161,4957,87,74,3213.53,5909.01,0.00
2024-12-08 17:14:26,162,4956,88,74,3155.03,5909.54,0.00
2024-12-08 17:14:26,162,4957,88,74,3169.91,5910.00,0.00
2024-12-08 17:14:26,163,4957,89,74,3150.46,5910.01,0.00
2024-12-08 17:14:26,163,4958,89,74,3149.38,5911.00,0.00
2024-12-08 17:14:26,164,4958,89,75,3130.17,5911.01,0.00
2024-12-08 17:14:26,163,4958,88,75,3145.77,5911.06,0.00
2024-12-08 17:14:26,162,4958,88,74,3161.55,5911.10,0.00
2024-12-08 17:14:26,161,4958,88,73,3180.10,5911.11,0.00
2024-12-08 17:14:26,161,4959,88,73,3156.07,5912.00,0.00
2024-12-08 17:14:26,162,4959,89,73,3136.59,5912.01,0.00
2024-12-08 17:14:26,163,4958,90,73,3114.82,5912.06,0.00
2024-12-08 17:14:26,164,4957,90,74,3115.66,5912.07,0.00
2024-12-08 17:14:26,163,4957,90,73,3155.11,5912.12,0.00
2024-12-08 17:14:26,162,4957,89,73,3173.86,5912.12,0.00
2024-12-08 17:14:26,162,4958,89,73,3149.80,5913.00,0.00
2024-12-08 17:14:26,163,4958,89,74,3130.47,5913.01,0.00
2024-12-08 17:14:26,162,4958,88,74,3135.84,5913.11,0.00
2024-12-08 17:14:26,161,4958,87,74,3145.63,5913.27,0.00
2024-12-08 17:14:26,161,4959,87,74,3204.51,5914.00,0.00
2024-12-08 17:14:26,162,4959,87,75,3184.73,5914.01,0.00
2024-12-08 17:14:26,163,4958,88,75,3137.34,5914.35,0.00
2024-12-08 17:14:26,163,4959,88,75,3159.46,5915.00,0.00
2024-12-08 17:14:26,164,4959,88,76,3140.20,5915.01,0.00
2024-12-08 17:14:26,163,4959,88,75,3149.71,5915.10,0.00
2024-12-08 17:14:26,162,4959,88,74,3168.79,5915.11,0.00
2024-12-08 17:14:26,161,4959,87,74,3165.54,5915.45,0.00
2024-12-08 17:14:26,161,4960,87,74,3206.08,5916.00,0.00
2024-12-08 17:14:26,162,4960,87,75,3186.29,5916.01,0.00
2024-12-08 17:14:26,161,4960,87,74,3199.88,5916.11,0.00
2024-12-08 17:14:26,161,4961,87,74,3174.62,5917.00,0.00
2024-12-08 17:14:26,162,4961,87,75,3155.02,5917.01,0.00
2024-12-08 17:14:26,161,4961,87,74,3167.32,5917.11,0.00
2024-12-08 17:14:26,160,4961,86,74,3166.77,5917.44,0.00
2024-12-08 17:14:27,160,4962,86,74,3162.17,5918.00,0.00
2024-12-08 17:14:27,161,4962,86,75,3142.53,5918.01,0.00
2024-12-08 17:14:27,160,4962,86,74,3152.61,5918.13,0.00
2024-12-08 17:14:27,161,4961,86,75,3096.25,5918.62,0.00
2024-12-08 17:14:27,162,4960,86,76,3085.97,5918.72,0.00
2024-12-08 17:14:27,162,4961,86,76,3116.52,5919.00,0.00
2024-12-08 17:14:27,163,4961,86,77,3097.40,5919.01,0.00
2024-12-08 17:14:27,162,4961,85,77,3113.96,5919.01,0.00
2024-12-08 17:14:27,161,4961,85,76,3108.73,5919.29,0.00
2024-12-08 17:14:27,161,4962,85,76,3176.59,5920.00,0.00
2024-12-08 17:14:27,162,4962,86,76,3156.98,5920.01,0.00
2024-12-08 17:14:27,161,4962,85,76,3171.81,5920.02,0.00
2024-12-08 17:14:27,160,4962,85,75,3184.28,5920.13,0.00
2024-12-08 17:14:27,160,4963,85,75,3168.52,5921.00,0.00
2024-12-08 17:14:27,161,4963,86,75,3148.84,5921.01,0.00
2024-12-08 17:14:27,160,4963,86,74,3156.39,5921.15,0.00
2024-12-08 17:14:27,161,4962,87,74,3132.76,5921.23,0.00
2024-12-08 17:14:27,161,4963,87,74,3145.25,5922.00,0.00
2024-12-08 17:14:27,162,4963,87,75,3125.84,5922.01,0.00
2024-12-08 17:14:27,161,4963,86,75,3138.68,5922.11,0.00
2024-12-08 17:14:27,160,4963,86,74,3157.19,5922.11,0.00
2024-12-08 17:14:27,160,4964,86,74,3168.71,5923.00,0.00
2024-12-08 17:14:27,161,4964,87,74,3149.03,5923.01,0.00
2024-12-08 17:14:27,160,4964,86,74,3166.87,5923.03,0.00
2024-12-08 17:14:27,160,4965,86,74,3128.22,5924.00,0.00
2024-12-08 17:14:27,161,4965,86,75,3108.79,5924.01,0.00
2024-12-08 17:14:27,160,4965,86,74,3119.38,5924.13,0.00
2024-12-08 17:14:27,160,4966,86,74,3092.41,5925.00,0.00
2024-12-08 17:14:27,161,4966,87,74,3073.20,5925.01,0.00
2024-12-08 17:14:27,160,4966,87,73,3086.15,5925.11,0.00
2024-12-08 17:14:27,161,4965,88,73,3049.54,5925.28,0.00
2024-12-08 17:14:27,161,4966,88,73,3034.49,5926.00,0.00
2024-12-08 17:14:27,162,4966,89,73,3015.76,5926.01,0.00
2024-12-08 17:14:27,161,4966,88,73,3028.27,5926.11,0.00
2024-12-08 17:14:27,160,4966,88,72,3039.79,5926.11,0.00
2024-12-08 17:14:27,159,4966,87,72,3051.01,5926.23,0.00
2024-12-08 17:14:27,158,4966,86,72,3038.13,5926.75,0.00
2024-12-08 17:14:27,158,4967,86,72,3086.35,5927.00,0.00
2024-12-08 17:14:27,159,4967,87,72,3066.94,5927.01,0.00
2024-12-08 17:14:27,158,4967,86,72,3080.01,5927.11,0.00
2024-12-08 17:14:27,157,4967,86,71,3096.99,5927.12,0.00
2024-12-08 17:14:27,158,4966,87,71,3050.41,5927.57,0.00
2024-12-08 17:14:27,158,4967,87,71,3065.30,5928.00,0.00
2024-12-08 17:14:27,159,4967,88,71,3046.02,5928.01,0.00
2024-12-08 17:14:27,159,4968,88,71,3037.21,5929.00,0.00
2024-12-08 17:14:27,160,4968,88,72,3018.23,5929.01,0.00
2024-12-08 17:14:27,161,4967,88,73,2951.59,5929.68,0.00
2024-12-08 17:14:27,160,4967,87,73,2966.60,5929.75,0.00
2024-12-08 17:14:27,160,4968,87,73,2981.63,5930.00,0.00
2024-12-08 17:14:27,161,4968,87,74,2963.11,5930.01,0.00
2024-12-08 17:14:27,160,4968,86,74,2975.36,5930.11,0.00
2024-12-08 17:14:27,159,4968,86,73,2990.72,5930.11,0.00
2024-12-08 17:14:27,158,4968,85,73,3004.29,5930.20,0.00
2024-12-08 17:14:27,157,4968,84,73,2995.10,5930.68,0.00
2024-12-08 17:14:27,157,4969,84,73,3044.45,5931.00,0.00
2024-12-08 17:14:27,158,4969,84,74,3025.18,5931.01,0.00
2024-12-08 17:14:27,157,4969,84,73,3036.55,5931.12,0.00
2024-12-08 17:14:27,156,4969,83,73,3023.49,5931.58,0.00
2024-12-08 17:14:28,156,4970,83,73,3036.72,5932.00,0.00
2024-12-08 17:14:28,157,4970,83,74,3017.38,5932.01,0.00
2024-12-08 17:14:28,158,4969,84,74,2996.42,5932.05,0.00
2024-12-08 17:14:28,157,4969,83,74,3016.27,5932.08,0.00
2024-12-08 17:14:28,156,4969,83,73,3032.58,5932.12,0.00
2024-12-08 17:14:28,156,4970,83,73,3018.60,5933.00,0.00
2024-12-08 17:14:28,157,4970,83,74,2999.37,5933.01,0.00
2024-12-08 17:14:28,156,4970,83,73,3003.29,5933.12,0.00
2024-12-08 17:14:28,156,4971,83,73,3026.87,5934.00,0.00
2024-12-08 17:14:28,157,4971,83,74,3007.59,5934.01,0.00
2024-12-08 17:14:28,156,4971,82,74,3026.44,5934.01,0.00
2024-12-08 17:14:28,155,4971,81,74,3042.80,5934.06,0.00
2024-12-08 17:14:28,154,4971,81,73,3059.12,5934.10,0.00
2024-12-08 17:14:28,154,4972,81,73,3036.34,5935.00,0.00
2024-12-08 17:14:28,155,4972,82,73,3016.75,5935.01,0.00
2024-12-08 17:14:28,154,4972,82,72,3030.36,5935.10,0.00
2024-12-08 17:14:28,155,4971,82,73,2958.31,5935.87,0.00
2024-12-08 17:14:28,155,4972,82,73,2994.80,5936.00,0.00
2024-12-08 17:14:28,156,4972,82,74,2975.61,5936.01,0.00
2024-12-08 17:14:28,157,4971,83,74,2956.65,5936.02,0.00
2024-12-08 17:14:28,156,4971,82,74,3008.04,5936.06,0.00
2024-12-08 17:14:28,155,4971,82,73,3022.88,5936.11,0.00
2024-12-08 17:14:28,155,4972,82,73,3038.58,5937.00,0.00
2024-12-08 17:14:28,156,4972,82,74,3019.10,5937.01,0.00
2024-12-08 17:14:28,155,4972,82,73,3030.97,5937.10,0.00
2024-12-08 17:14:28,154,4972,81,73,3041.34,5937.25,0.00
2024-12-08 17:14:28,155,4971,82,73,3000.33,5937.61,0.00
2024-12-08 17:14:28,155,4972,82,73,3069.03,5938.00,0.00
2024-12-08 17:14:28,156,4972,82,74,3049.35,5938.01,0.00
2024-12-08 17:14:28,155,4972,81,74,3058.71,5938.05,0.00
2024-12-08 17:14:28,154,4972,81,73,3073.58,5938.10,0.00
2024-12-08 17:14:28,153,4972,80,73,3075.75,5938.37,0.00
2024-12-08 17:14:28,154,4971,81,73,3025.18,5938.88,0.00
2024-12-08 17:14:28,154,4972,81,73,3100.10,5939.00,0.00
2024-12-08 17:14:28,155,4972,81,74,3080.09,5939.01,0.00
2024-12-08 17:14:28,154,4972,81,73,3080.09,5939.10,0.00
2024-12-08 17:14:28,154,4973,81,73,3101.39,5940.00,0.00
2024-12-08 17:14:28,155,4973,81,74,3081.38,5940.01,0.00
2024-12-08 17:14:28,156,4972,81,75,3059.74,5940.05,0.00
2024-12-08 17:14:28,155,4972,81,74,3106.72,5940.11,0.00
2024-12-08 17:14:28,154,4972,80,74,3125.23,5940.12,0.00
2024-12-08 17:14:28,155,4971,80,75,3061.93,5940.71,0.00
2024-12-08 17:14:28,155,4972,80,75,3102.41,5941.00,0.00
2024-12-08 17:14:28,156,4972,80,76,3082.53,5941.01,0.00
2024-12-08 17:14:28,155,4972,80,75,3095.56,5941.10,0.00
2024-12-08 17:14:28,154,4972,79,75,3095.70,5941.44,0.00
2024-12-08 17:14:28,154,4973,79,75,3168.91,5942.00,0.00
2024-12-08 17:14:28,155,4973,79,76,3148.46,5942.01,0.00
2024-12-08 17:14:28,154,4973,78,76,3163.17,5942.10,0.00
2024-12-08 17:14:28,153,4973,78,75,3180.74,5942.10,0.00
2024-12-08 17:14:28,152,4973,78,74,3170.54,5942.63,0.00
2024-12-08 17:14:28,152,4974,78,74,3179.82,5943.00,0.00
2024-12-08 17:14:28,153,4974,79,74,3159.04,5943.01,0.00
2024-12-08 17:14:28,152,4974,78,74,3175.17,5943.08,0.00
2024-12-08 17:14:28,152,4975,78,74,3144.38,5944.00,0.00
2024-12-08 17:14:28,153,4975,79,74,3123.83,5944.01,0.00
2024-12-08 17:14:28,153,4976,79,74,3087.97,5945.00,0.00
2024-12-08 17:14:28,154,4976,79,75,3067.92,5945.01,0.00
2024-12-08 17:14:28,154,4977,79,75,3031.21,5946.00,0.00
2024-12-08 17:14:29,155,4977,80,75,3011.65,5946.01,0.00
2024-12-08 17:14:29,154,4977,80,74,3018.13,5946.10,0.00
2024-12-08 17:14:29,155,4976,81,74,2979.99,5946.40,0.00
2024-12-08 17:14:29,155,4977,81,74,2999.74,5947.00,0.00
2024-12-08 17:14:29,156,4977,81,75,2980.51,5947.01,0.00
2024-12-08 17:14:29,157,4976,81,76,2935.57,5947.33,0.00
2024-12-08 17:14:29,156,4976,80,76,2963.16,5947.62,0.00
2024-12-08 17:14:29,156,4977,80,76,3009.57,5948.00,0.00
2024-12-08 17:14:29,157,4977,81,76,2990.40,5948.01,0.00
2024-12-08 17:14:29,156,4977,81,75,3000.84,5948.07,0.00
2024-12-08 17:14:29,157,4976,81,76,2952.78,5948.52,0.00
2024-12-08 17:14:29,158,4975,82,76,2933.76,5948.60,0.00
2024-12-08 17:14:29,158,4976,82,76,2994.29,5949.00,0.00
2024-12-08 17:14:29,159,4976,82,77,2975.46,5949.01,0.00
2024-12-08 17:14:29,158,4976,82,76,2988.31,5949.10,0.00
2024-12-08 17:14:29,157,4976,81,76,2996.33,5949.26,0.00
2024-12-08 17:14:29,157,4977,81,76,3057.21,5950.00,0.00
2024-12-08 17:14:29,158,4977,82,76,3037.86,5950.01,0.00
2024-12-08 17:14:29,157,4977,82,75,3051.19,5950.10,0.00
2024-12-08 17:14:29,158,4976,82,76,3016.95,5950.34,0.00
2024-12-08 17:14:29,158,4977,82,76,3018.93,5951.00,0.00
2024-12-08 17:14:29,159,4977,83,76,2999.94,5951.01,0.00
2024-12-08 17:14:29,158,4977,83,75,3012.94,5951.10,0.00
2024-12-08 17:14:29,157,4977,83,74,3027.54,5951.17,0.00
2024-12-08 17:14:29,156,4977,82,74,3042.01,5951.24,0.00
2024-12-08 17:14:29,155,4977,81,74,3056.31,5951.33,0.00
2024-12-08 17:14:29,155,4978,81,74,3085.91,5952.00,0.00
2024-12-08 17:14:29,156,4978,81,75,3066.13,5952.01,0.00
2024-12-08 17:14:29,155,4978,81,74,3071.36,5952.10,0.00
2024-12-08 17:14:29,156,4977,81,75,3003.63,5952.90,0.00
2024-12-08 17:14:29,156,4978,81,75,3039.97,5953.00,0.00
2024-12-08 17:14:29,157,4978,82,75,3020.60,5953.01,0.00
2024-12-08 17:14:29,156,4978,82,74,3033.52,5953.10,0.00
2024-12-08 17:14:29,155,4978,81,74,3045.66,5953.23,0.00
2024-12-08 17:14:29,154,4978,80,74,3064.67,5953.23,0.00
2024-12-08 17:14:29,154,4979,80,74,3093.06,5954.00,0.00
2024-12-08 17:14:29,155,4979,80,75,3073.11,5954.01,0.00
2024-12-08 17:14:29,154,4979,79,75,3082.66,5954.10,0.00
2024-12-08 17:14:29,153,4979,78,75,3075.66,5954.43,0.00
2024-12-08 17:14:29,153,4980,78,75,3075.88,5955.00,0.00
2024-12-08 17:14:29,154,4980,78,76,3055.91,5955.01,0.00
2024-12-08 17:14:29,153,4980,78,75,3062.66,5955.10,0.00
2024-12-08 17:14:29,152,4980,77,75,3082.42,5955.10,0.00
2024-12-08 17:14:29,151,4980,77,74,3102.44,5955.10,0.00
2024-12-08 17:14:29,150,4980,77,73,3122.73,5955.10,0.00
2024-12-08 17:14:29,151,4979,78,73,3095.75,5955.22,0.00
2024-12-08 17:14:29,150,4979,77,73,3134.67,5955.24,0.00
2024-12-08 17:14:29,151,4978,78,73,3071.97,5955.80,0.00
2024-12-08 17:14:29,151,4979,78,73,3104.40,5956.00,0.00
2024-12-08 17:14:29,152,4979,78,74,3083.98,5956.01,0.00
2024-12-08 17:14:29,153,4978,78,75,3061.89,5956.05,0.00
2024-12-08 17:14:29,152,4978,78,74,3084.41,5956.11,0.00
2024-12-08 17:14:29,151,4978,78,73,3102.87,5956.12,0.00
2024-12-08 17:14:29,151,4979,78,73,3158.19,5957.00,0.00
2024-12-08 17:14:29,152,4979,79,73,3137.42,5957.01,0.00
2024-12-08 17:14:29,151,4979,79,72,3140.48,5957.13,0.00
2024-12-08 17:14:29,150,4979,78,72,3145.23,5957.40,0.00
2024-12-08 17:14:29,150,4980,78,72,3187.49,5958.00,0.00
2024-12-08 17:14:29,151,4980,78,73,3166.38,5958.01,0.00
2024-12-08 17:14:29,150,4980,78,72,3181.18,5958.11,0.00
2024-12-08 17:14:29,149,4980,77,72,3190.16,5958.14,0.00
2024-12-08 17:14:29,149,4981,77,72,3178.79,5959.00,0.00
2024-12-08 17:14:29,150,4981,78,72,3157.59,5959.01,0.00
2024-12-08 17:14:29,149,4981,78,71,3163.51,5959.13,0.00
2024-12-08 17:14:30,149,4982,78,71,3144.00,5960.00,0.00
2024-12-08 17:14:30,150,4982,78,72,3123.04,5960.01,0.00
2024-12-08 17:14:30,149,4982,77,72,3143.20,5960.01,0.00
2024-12-08 17:14:30,148,4982,77,71,3147.16,5960.13,0.00
2024-12-08 17:14:30,147,4982,76,71,3163.32,5960.22,0.00
2024-12-08 17:14:30,147,4983,76,71,3156.13,5961.00,0.00
2024-12-08 17:14:30,148,4983,76,72,3134.81,5961.01,0.00
2024-12-08 17:14:30,147,4983,75,72,3152.51,5961.06,0.00
2024-12-08 17:14:30,146,4983,75,71,3167.18,5961.13,0.00
2024-12-08 17:14:30,145,4983,74,71,3185.73,5961.13,0.00
2024-12-08 17:14:30,144,4983,73,71,3207.03,5961.15,0.00
2024-12-08 17:14:30,145,4982,74,71,3178.37,5961.27,0.00
2024-12-08 17:14:30,145,4983,74,71,3202.53,5962.00,0.00
2024-12-08 17:14:30,146,4983,74,72,3180.60,5962.01,0.00
2024-12-08 17:14:30,145,4983,73,72,3201.85,5962.01,0.00
2024-12-08 17:14:30,144,4983,72,72,3218.55,5962.10,0.00
2024-12-08 17:14:30,143,4983,72,71,3235.22,5962.12,0.00
2024-12-08 17:14:30,142,4983,71,71,3239.13,5962.40,0.00
2024-12-08 17:14:30,141,4983,70,71,3251.44,5962.57,0.00
2024-12-08 17:14:30,141,4984,70,71,3300.52,5963.00,0.00
2024-12-08 17:14:30,142,4984,71,71,3277.27,5963.01,0.00
2024-12-08 17:14:30,142,4985,71,71,3239.35,5964.00,0.00
2024-12-08 17:14:30,143,4985,71,72,3216.70,5964.01,0.00
2024-12-08 17:14:30,142,4985,71,71,3232.94,5964.10,0.00
2024-12-08 17:14:30,141,4985,70,71,3218.86,5964.58,0.00
2024-12-08 17:14:30,141,4986,70,71,3223.12,5965.00,0.00
2024-12-08 17:14:30,142,4986,70,72,3200.42,5965.01,0.00
2024-12-08 17:14:30,141,4986,70,71,3216.84,5965.10,0.00
2024-12-08 17:14:30,140,4986,69,71,3193.90,5965.70,0.00
2024-12-08 17:14:30,140,4987,69,71,3210.34,5966.00,0.00
2024-12-08 17:14:30,141,4987,69,72,3187.57,5966.01,0.00
2024-12-08 17:14:30,141,4988,69,72,3153.05,5967.00,0.00
2024-12-08 17:14:30,142,4988,70,72,3130.85,5967.01,0.00
2024-12-08 17:14:30,141,4988,70,71,3143.31,5967.11,0.00
2024-12-08 17:14:30,142,4987,70,72,3108.22,5967.34,0.00
2024-12-08 17:14:30,141,4987,69,72,3162.96,5967.40,0.00
2024-12-08 17:14:30,141,4988,69,72,3160.75,5968.00,0.00
2024-12-08 17:14:30,142,4988,69,73,3138.49,5968.01,0.00
2024-12-08 17:14:30,142,4989,69,73,3145.50,5969.00,0.00
2024-12-08 17:14:30,143,4989,69,74,3123.51,5969.01,0.00
2024-12-08 17:14:30,144,4988,70,74,3100.58,5969.04,0.00
2024-12-08 17:14:30,145,4987,70,75,3017.35,5969.88,0.00
2024-12-08 17:14:30,145,4988,70,75,3065.21,5970.00,0.00
2024-12-08 17:14:30,146,4988,70,76,3044.22,5970.01,0.00
2024-12-08 17:14:30,147,4987,70,77,2983.37,5970.56,0.00
2024-12-08 17:14:30,146,4987,69,77,3024.68,5970.58,0.00
2024-12-08 17:14:30,147,4986,69,78,2996.47,5970.71,0.00
2024-12-08 17:14:30,147,4987,69,78,3113.26,5971.00,0.00
2024-12-08 17:14:30,148,4987,70,78,3092.23,5971.01,0.00
2024-12-08 17:14:30,147,4987,70,77,3100.70,5971.10,0.00
2024-12-08 17:14:30,148,4986,71,77,3065.65,5971.22,0.00
2024-12-08 17:14:30,148,4987,71,77,3143.99,5972.00,0.00
2024-12-08 17:14:30,149,4987,71,78,3122.89,5972.01,0.00
2024-12-08 17:14:30,150,4986,72,78,3097.72,5972.09,0.00
2024-12-08 17:14:30,149,4986,72,77,3145.37,5972.11,0.00
2024-12-08 17:14:30,148,4986,71,77,3160.98,5972.14,0.00
2024-12-08 17:14:30,148,4987,71,77,3190.93,5973.00,0.00
2024-12-08 17:14:30,149,4987,71,78,3169.51,5973.01,0.00
2024-12-08 17:14:30,148,4987,71,77,3183.70,5973.10,0.00
2024-12-08 17:14:30,148,4988,71,77,3203.17,5974.00,0.00
2024-12-08 17:14:30,149,4988,72,77,3181.67,5974.01,0.00
2024-12-08 17:14:30,148,4988,72,76,3195.53,5974.11,0.00
2024-12-08 17:14:30,149,4987,72,77,3143.34,5974.50,0.00
2024-12-08 17:14:31,149,4988,72,77,3173.78,5975.00,0.00
2024-12-08 17:14:31,150,4988,73,77,3152.63,5975.01,0.00
2024-12-08 17:14:31,149,4988,73,76,3165.38,5975.03,0.00
2024-12-08 17:14:31,150,4987,73,77,3121.68,5975.43,0.00
2024-12-08 17:14:31,150,4988,73,77,3183.03,5976.00,0.00
2024-12-08 17:14:31,151,4988,73,78,3161.95,5976.01,0.00
2024-12-08 17:14:31,152,4987,74,78,3097.34,5976.63,0.00
2024-12-08 17:14:31,152,4988,74,78,3160.16,5977.00,0.00
2024-12-08 17:14:31,153,4988,74,79,3139.50,5977.01,0.00
2024-12-08 17:14:31,152,4988,73,79,3154.68,5977.09,0.00
2024-12-08 17:14:31,151,4988,72,79,3155.33,5977.30,0.00
2024-12-08 17:14:31,151,4989,72,79,3185.08,5978.00,0.00
2024-12-08 17:14:31,152,4989,72,80,3164.12,5978.01,0.00
2024-12-08 17:14:31,151,4989,72,79,3179.56,5978.09,0.00
2024-12-08 17:14:31,150,4989,71,79,3184.05,5978.24,0.00
2024-12-08 17:14:31,149,4989,70,79,3205.02,5978.24,0.00
2024-12-08 17:14:31,149,4990,70,79,3191.69,5979.00,0.00
2024-12-08 17:14:31,150,4990,70,80,3170.42,5979.01,0.00
2024-12-08 17:14:31,149,4990,70,79,3182.90,5979.10,0.00
2024-12-08 17:14:31,148,4990,69,79,3164.63,5979.68,0.00
2024-12-08 17:14:31,148,4991,69,79,3185.90,5980.00,0.00
2024-12-08 17:14:31,149,4991,70,79,3164.52,5980.01,0.00
2024-12-08 17:14:31,148,4991,69,79,3181.88,5980.07,0.00
2024-12-08 17:14:31,147,4991,68,79,3201.51,5980.10,0.00
2024-12-08 17:14:31,146,4991,68,78,3221.80,5980.10,0.00
2024-12-08 17:14:31,145,4991,67,78,3242.37,5980.10,0.00
2024-12-08 17:14:31,146,4990,67,79,3198.23,5980.45,0.00
2024-12-08 17:14:31,146,4991,67,79,3210.48,5981.00,0.00
2024-12-08 17:14:31,147,4991,68,79,3188.64,5981.01,0.00
2024-12-08 17:14:31,146,4991,68,78,3203.14,5981.10,0.00
2024-12-08 17:14:31,145,4991,67,78,3222.75,5981.11,0.00
2024-12-08 17:14:31,146,4990,68,78,3169.77,5981.61,0.00
2024-12-08 17:14:31,146,4991,68,78,3243.39,5982.00,0.00
2024-12-08 17:14:31,147,4991,69,78,3221.32,5982.01,0.00
2024-12-08 17:14:31,146,4991,68,78,3240.94,5982.04,0.00
2024-12-08 17:14:31,147,4990,68,79,3216.47,5982.10,0.00
2024-12-08 17:14:31,148,4989,69,79,3206.46,5982.12,0.00
2024-12-08 17:14:31,147,4989,69,78,3229.50,5982.12,0.00
2024-12-08 17:14:31,146,4989,68,78,3245.57,5982.21,0.00
2024-12-08 17:14:31,145,4989,67,78,3267.54,5982.21,0.00
2024-12-08 17:14:31,144,4989,66,78,3281.92,5982.22,0.00
2024-12-08 17:14:31,145,4988,67,78,3242.90,5982.50,0.00
2024-12-08 17:14:31,146,4987,68,78,3221.71,5982.82,0.00
2024-12-08 17:14:31,146,4988,68,78,3298.21,5983.00,0.00
2024-12-08 17:14:31,147,4988,68,79,3275.77,5983.01,0.00
2024-12-08 17:14:31,146,4988,67,79,3294.25,5983.07,0.00
2024-12-08 17:14:31,145,4988,67,78,3311.62,5983.11,0.00
2024-12-08 17:14:31,145,4989,67,78,3456.11,5984.00,0.00
2024-12-08 17:14:31,146,4989,67,79,3432.44,5984.01,0.00
2024-12-08 17:14:31,145,4989,66,79,3450.78,5984.09,0.00
2024-12-08 17:14:31,144,4989,66,78,3471.43,5984.10,0.00
2024-12-08 17:14:31,143,4989,65,78,3457.52,5984.75,0.00
2024-12-08 17:14:31,143,4990,65,78,3483.65,5985.00,0.00
2024-12-08 17:14:31,144,4990,65,79,3459.46,5985.01,0.00
2024-12-08 17:14:31,145,4989,65,80,3434.78,5985.04,0.00
2024-12-08 17:14:31,144,4989,65,79,3474.63,5985.11,0.00
2024-12-08 17:14:31,144,4990,65,79,3454.25,5986.00,0.00
2024-12-08 17:14:31,145,4990,65,80,3430.42,5986.01,0.00
2024-12-08 17:14:31,144,4990,65,79,3445.14,5986.12,0.00
2024-12-08 17:14:31,145,4989,66,79,3379.80,5986.81,0.00
2024-12-08 17:14:31,145,4990,66,79,3449.33,5987.00,0.00
2024-12-08 17:14:31,146,4990,66,80,3425.71,5987.01,0.00
2024-12-08 17:14:31,145,4990,65,80,3436.15,5987.08,0.00
2024-12-08 17:14:31,144,4990,65,79,3455.87,5987.11,0.00
2024-12-08 17:14:31,144,4991,65,79,3485.45,5988.00,0.00
2024-12-08 17:14:31,145,4991,65,80,3461.42,5988.01,0.00
2024-12-08 17:14:32,146,4990,66,80,3368.29,5988.90,0.00
2024-12-08 17:14:32,146,4991,66,80,3406.53,5989.00,0.00
2024-12-08 17:14:32,147,4991,66,81,3383.36,5989.01,0.00
2024-12-08 17:14:32,146,4991,65,81,3404.91,5989.03,0.00
2024-12-08 17:14:32,145,4991,65,80,3422.22,5989.10,0.00
2024-12-08 17:14:32,144,4991,64,80,3423.19,5989.35,0.00
2024-12-08 17:14:32,144,4992,64,80,3467.49,5990.00,0.00
2024-12-08 17:14:32,145,4992,64,81,3443.57,5990.01,0.00
2024-12-08 17:14:32,144,4992,64,80,3462.12,5990.09,0.00
2024-12-08 17:14:32,143,4992,64,79,3477.53,5990.10,0.00
2024-12-08 17:14:32,143,4993,64,79,3457.54,5991.00,0.00
2024-12-08 17:14:32,144,4993,64,80,3433.53,5991.01,0.00
2024-12-08 17:14:32,143,4993,64,79,3452.14,5991.09,0.00
2024-12-08 17:14:32,142,4993,64,78,3471.81,5991.11,0.00
2024-12-08 17:14:32,141,4993,63,78,3493.05,5991.16,0.00
2024-12-08 17:14:32,141,4994,63,78,3477.43,5992.00,0.00
2024-12-08 17:14:32,142,4994,63,79,3452.94,5992.01,0.00
2024-12-08 17:14:32,141,4994,63,78,3458.35,5992.11,0.00
2024-12-08 17:14:32,141,4995,63,78,3447.83,5993.00,0.00
2024-12-08 17:14:32,142,4995,64,78,3423.55,5993.01,0.00
2024-12-08 17:14:32,141,4995,64,77,3434.27,5993.13,0.00
2024-12-08 17:14:32,142,4994,65,77,3393.73,5993.42,0.00
2024-12-08 17:14:32,143,4993,65,78,3384.74,5993.56,0.00
2024-12-08 17:14:32,143,4994,65,78,3408.98,5994.00,0.00
2024-12-08 17:14:32,144,4994,66,78,3385.30,5994.01,0.00
2024-12-08 17:14:32,143,4994,66,77,3393.10,5994.15,0.00
2024-12-08 17:14:32,143,4995,66,77,3459.85,5995.00,0.00
2024-12-08 17:14:32,144,4995,66,78,3435.83,5995.01,0.00
2024-12-08 17:14:32,143,4995,66,77,3443.14,5995.16,0.00
2024-12-08 17:14:32,143,4996,66,77,3426.89,5996.00,0.00
2024-12-08 17:14:32,144,4996,67,77,3403.09,5996.01,0.00
2024-12-08 17:14:32,143,4996,66,77,3426.47,5996.01,0.00
2024-12-08 17:14:32,142,4996,66,76,3434.18,5996.16,0.00
2024-12-08 17:14:32,142,4997,66,76,3417.81,5997.00,0.00
2024-12-08 17:14:32,143,4997,67,76,3393.91,5997.01,0.00
2024-12-08 17:14:32,142,4997,67,75,3400.93,5997.16,0.00
2024-12-08 17:14:32,143,4996,68,75,3344.19,5997.58,0.00
2024-12-08 17:14:32,143,4997,68,75,3379.93,5998.00,0.00
2024-12-08 17:14:32,144,4997,68,76,3356.45,5998.01,0.00
2024-12-08 17:14:32,143,4997,67,76,3378.26,5998.03,0.00
2024-12-08 17:14:32,142,4997,66,76,3374.11,5998.35,0.00
2024-12-08 17:14:32,142,4998,66,76,3411.31,5999.00,0.00
2024-12-08 17:14:32,143,4998,66,77,3387.46,5999.01,0.00
2024-12-08 17:14:32,142,4998,65,77,3407.54,5999.07,0.00
2024-12-08 17:14:32,143,4997,65,78,3356.91,5999.39,0.00
2024-12-08 17:14:32,144,4996,65,79,3327.10,5999.69,0.00
2024-12-08 17:14:32,144,4997,65,79,3378.60,6000.00,0.00
2024-12-08 17:14:32,145,4997,66,79,3355.30,6000.01,0.00
2024-12-08 17:14:32,145,4998,66,79,3403.87,6001.00,0.00
2024-12-08 17:14:32,146,4998,66,80,3380.55,6001.01,0.00
2024-12-08 17:14:32,145,4998,65,80,3402.22,6001.03,0.00
2024-12-08 17:14:32,144,4998,64,80,3424.61,6001.04,0.00
2024-12-08 17:14:32,143,4998,64,79,3436.83,6001.13,0.00
2024-12-08 17:14:32,142,4998,63,79,3458.51,6001.18,0.00
2024-12-08 17:14:32,141,4998,62,79,3482.61,6001.18,0.00
2024-12-08 17:14:32,141,4999,62,79,3467.70,6002.00,0.00
2024-12-08 17:14:32,142,4999,63,79,3443.28,6002.01,0.00
2024-12-08 17:14:32,141,4999,63,78,3453.69,6002.14,0.00
2024-12-08 17:14:33,141,5000,63,78,3436.25,6003.00,0.00
2024-12-08 17:14:33,142,5000,63,79,3412.05,6003.01,0.00
2024-12-08 17:14:33,141,5000,63,78,3421.40,6003.14,0.00
2024-12-08 17:14:33,141,5001,63,78,3404.39,6004.00,0.00
2024-12-08 17:14:33,142,5001,63,79,3380.41,6004.01,0.00
2024-12-08 17:14:33,141,5001,62,79,3399.74,6004.08,0.00
2024-12-08 17:14:33,140,5001,61,79,3422.46,6004.10,0.00
2024-12-08 17:14:33,139,5001,61,78,3439.74,6004.12,0.00
2024-12-08 17:14:33,139,5002,61,78,3422.13,6005.00,0.00
2024-12-08 17:14:33,140,5002,62,78,3397.69,6005.01,0.00
2024-12-08 17:14:33,139,5002,61,78,3417.41,6005.08,0.00
2024-12-08 17:14:33,138,5002,60,78,3440.10,6005.11,0.00
2024-12-08 17:14:33,137,5002,60,77,3459.07,6005.11,0.00
2024-12-08 17:14:33,136,5002,59,77,3471.78,6005.32,0.00
2024-12-08 17:14:33,137,5001,59,78,3428.63,6005.64,0.00
2024-12-08 17:14:33,137,5002,59,78,3456.10,6006.00,0.00
2024-12-08 17:14:33,138,5002,60,78,3431.06,6006.01,0.00
2024-12-08 17:14:33,137,5002,59,78,3438.18,6006.15,0.00
2024-12-08 17:14:33,137,5003,59,78,3474.57,6007.00,0.00
2024-12-08 17:14:33,138,5003,59,79,3449.39,6007.01,0.00
2024-12-08 17:14:33,137,5003,59,78,3464.53,6007.11,0.00
2024-12-08 17:14:33,136,5003,58,78,3477.27,6007.32,0.00
2024-12-08 17:14:33,137,5002,59,78,3451.02,6007.35,0.00
2024-12-08 17:14:33,137,5003,59,78,3471.60,6008.00,0.00
2024-12-08 17:14:33,138,5003,59,79,3446.44,6008.01,0.00
2024-12-08 17:14:33,137,5003,58,79,3466.81,6008.08,0.00
2024-12-08 17:14:33,136,5003,57,79,3472.87,6008.13,0.00
2024-12-08 17:14:33,137,5002,57,80,3404.51,6008.86,0.00
2024-12-08 17:14:33,137,5003,57,80,3492.29,6009.00,0.00
2024-12-08 17:14:33,138,5003,58,80,3466.98,6009.01,0.00
2024-12-08 17:14:33,138,5004,58,80,3477.39,6010.00,0.00
2024-12-08 17:14:33,139,5004,59,80,3452.37,6010.01,0.00
2024-12-08 17:14:33,140,5003,59,81,3424.73,6010.07,0.00
2024-12-08 17:14:33,140,5004,59,81,3421.41,6011.00,0.00
2024-12-08 17:14:33,141,5004,60,81,3397.15,6011.01,0.00
2024-12-08 17:14:33,140,5004,60,80,3413.29,6011.11,0.00
2024-12-08 17:14:33,139,5004,59,80,3423.66,6011.35,0.00
2024-12-08 17:14:33,140,5003,59,81,3370.74,6011.84,0.00
2024-12-08 17:14:33,140,5004,59,81,3445.17,6012.00,0.00
2024-12-08 17:14:33,141,5004,60,81,3420.74,6012.01,0.00
2024-12-08 17:14:33,140,5004,59,81,3444.74,6012.01,0.00
2024-12-08 17:14:33,139,5004,58,81,3468.26,6012.02,0.00
2024-12-08 17:14:33,138,5004,57,81,3481.22,6012.07,0.00
2024-12-08 17:14:33,137,5004,56,81,3506.19,6012.07,0.00
2024-12-08 17:14:33,136,5004,56,80,3522.26,6012.10,0.00
2024-12-08 17:14:33,135,5004,55,80,3546.13,6012.13,0.00
2024-12-08 17:14:33,135,5005,55,80,3583.63,6013.00,0.00
2024-12-08 17:14:33,136,5005,55,81,3557.28,6013.01,0.00
2024-12-08 17:14:33,135,5005,55,80,3570.32,6013.10,0.00
2024-12-08 17:14:33,135,5006,55,80,3552.60,6014.00,0.00
2024-12-08 17:14:33,136,5006,55,81,3526.48,6014.01,0.00
2024-12-08 17:14:33,135,5006,55,80,3538.39,6014.11,0.00
2024-12-08 17:14:33,135,5007,55,80,3521.11,6015.00,0.00
2024-12-08 17:14:33,136,5007,56,80,3495.22,6015.01,0.00
2024-12-08 17:14:33,135,5007,56,79,3506.90,6015.11,0.00
2024-12-08 17:14:33,135,5008,56,79,3488.53,6016.00,0.00
2024-12-08 17:14:33,136,5008,56,80,3462.88,6016.01,0.00
2024-12-08 17:14:33,137,5007,56,81,3431.93,6016.12,0.00
2024-12-08 17:14:33,136,5007,55,81,3458.68,6016.54,0.00
2024-12-08 17:14:33,136,5008,55,81,3473.14,6017.00,0.00
2024-12-08 17:14:33,137,5008,56,81,3447.79,6017.01,0.00
2024-12-08 17:14:33,136,5008,56,80,3449.74,6017.12,0.00
2024-12-08 17:14:33,137,5007,57,80,3395.79,6017.61,0.00
2024-12-08 17:14:34,137,5008,57,80,3474.10,6018.00,0.00
2024-12-08 17:14:34,138,5008,58,80,3448.93,6018.01,0.00
2024-12-08 17:14:34,138,5009,58,80,3458.38,6019.00,0.00
2024-12-08 17:14:34,139,5009,58,81,3433.49,6019.01,0.00
2024-12-08 17:14:34,138,5009,58,80,3454.04,6019.07,0.00
2024-12-08 17:14:34,137,5009,58,79,3469.17,6019.12,0.00
2024-12-08 17:14:34,137,5010,58,79,3451.68,6020.00,0.00
2024-12-08 17:14:34,138,5010,58,80,3426.67,6020.01,0.00
2024-12-08 17:14:34,137,5010,57,80,3447.76,6020.07,0.00
2024-12-08 17:14:34,136,5010,56,80,3468.68,6020.08,0.00
2024-12-08 17:14:34,135,5010,56,79,3484.58,6020.11,0.00
2024-12-08 17:14:34,135,5011,56,79,3476.19,6021.00,0.00
2024-12-08 17:14:34,136,5011,57,79,3450.63,6021.01,0.00
2024-12-08 17:14:34,135,5011,57,78,3453.05,6021.11,0.00
2024-12-08 17:14:34,134,5011,56,78,3475.24,6021.16,0.00
2024-12-08 17:14:34,134,5012,56,78,3470.36,6022.00,0.00
2024-12-08 17:14:34,135,5012,57,78,3444.65,6022.01,0.00
2024-12-08 17:14:34,134,5012,57,77,3466.34,6022.07,0.00
2024-12-08 17:14:34,133,5012,56,77,3467.57,6022.24,0.00
2024-12-08 17:14:34,134,5011,57,77,3418.07,6022.65,0.00
2024-12-08 17:14:34,134,5012,57,77,3457.45,6023.00,0.00
2024-12-08 17:14:34,135,5012,58,77,3431.84,6023.01,0.00
2024-12-08 17:14:34,135,5013,58,77,3444.01,6024.00,0.00
2024-12-08 17:14:34,136,5013,58,78,3418.69,6024.01,0.00
2024-12-08 17:14:34,136,5014,58,78,3386.03,6025.00,0.00
2024-12-08 17:14:34,137,5014,59,78,3361.32,6025.01,0.00
2024-12-08 17:14:34,137,5015,59,78,3328.44,6026.00,0.00
2024-12-08 17:14:34,138,5015,59,79,3304.32,6026.01,0.00
2024-12-08 17:14:34,137,5015,58,79,3310.02,6026.16,0.00
2024-12-08 17:14:34,137,5016,58,79,3295.12,6027.00,0.00
2024-12-08 17:14:34,138,5016,59,79,3271.24,6027.01,0.00
2024-12-08 17:14:34,137,5016,58,79,3231.26,6027.79,0.00
2024-12-08 17:14:34,137,5017,58,79,3262.67,6028.00,0.00
2024-12-08 17:14:34,138,5017,58,80,3239.02,6028.01,0.00
2024-12-08 17:14:34,137,5017,58,79,3257.41,6028.07,0.00
2024-12-08 17:14:34,136,5017,57,79,3274.75,6028.18,0.00
2024-12-08 17:14:34,136,5018,57,79,3261.05,6029.00,0.00
2024-12-08 17:14:34,137,5018,57,80,3237.25,6029.01,0.00
2024-12-08 17:14:34,136,5018,57,79,3251.78,6029.10,0.00
2024-12-08 17:14:34,136,5019,57,79,3233.66,6030.00,0.00
2024-12-08 17:14:34,137,5019,57,80,3210.05,6030.01,0.00
2024-12-08 17:14:34,136,5019,57,79,3213.74,6030.11,0.00
2024-12-08 17:14:34,136,5020,57,79,3204.92,6031.00,0.00
2024-12-08 17:14:34,137,5020,57,80,3181.53,6031.01,0.00
2024-12-08 17:14:34,137,5021,57,80,3148.60,6032.00,0.00
2024-12-08 17:14:34,138,5021,58,80,3125.78,6032.01,0.00
2024-12-08 17:14:34,137,5021,58,79,3134.10,6032.11,0.00
2024-12-08 17:14:34,136,5021,57,79,3122.72,6032.57,0.00
2024-12-08 17:14:34,137,5020,58,79,3095.14,6032.66,0.00
2024-12-08 17:14:34,137,5021,58,79,3135.03,6033.00,0.00
2024-12-08 17:14:34,138,5021,58,80,3112.31,6033.01,0.00
2024-12-08 17:14:34,137,5021,58,79,3130.65,6033.07,0.00
2024-12-08 17:14:34,137,5022,58,79,3145.68,6034.00,0.00
2024-12-08 17:14:34,138,5022,58,80,3122.88,6034.01,0.00
2024-12-08 17:14:35,139,5021,58,81,3063.67,6034.49,0.00
2024-12-08 17:14:35,139,5022,58,81,3074.88,6035.00,0.00
2024-12-08 17:14:35,140,5022,59,81,3052.91,6035.01,0.00
2024-12-08 17:14:35,139,5022,58,81,3045.40,6035.20,0.00
2024-12-08 17:14:35,139,5023,58,81,3084.51,6036.00,0.00
2024-12-08 17:14:35,140,5023,59,81,3062.47,6036.01,0.00
2024-12-08 17:14:35,139,5023,59,80,3079.75,6036.08,0.00
2024-12-08 17:14:35,138,5023,59,79,3099.45,6036.09,0.00
2024-12-08 17:14:35,138,5024,59,79,3080.25,6037.00,0.00
2024-12-08 17:14:35,139,5024,59,80,3058.09,6037.01,0.00
2024-12-08 17:14:35,138,5024,59,79,3070.65,6037.10,0.00
2024-12-08 17:14:35,138,5025,59,79,3051.88,6038.00,0.00
2024-12-08 17:14:35,139,5025,60,79,3029.93,6038.01,0.00
2024-12-08 17:14:35,138,5025,60,78,3041.41,6038.11,0.00
2024-12-08 17:14:35,138,5026,60,78,3023.00,6039.00,0.00
2024-12-08 17:14:35,139,5026,61,78,3001.25,6039.01,0.00
2024-12-08 17:14:35,138,5026,60,78,2993.55,6039.20,0.00
2024-12-08 17:14:35,138,5027,60,78,2989.63,6040.00,0.00
2024-12-08 17:14:35,139,5027,60,79,2968.12,6040.01,0.00
2024-12-08 17:14:35,138,5027,60,78,2984.40,6040.09,0.00
2024-12-08 17:14:35,139,5026,61,78,2951.63,6040.14,0.00
2024-12-08 17:14:35,139,5027,61,78,2955.14,6041.00,0.00
2024-12-08 17:14:35,140,5027,61,79,2934.03,6041.01,0.00
2024-12-08 17:14:35,141,5026,61,80,2865.05,6041.68,0.00
2024-12-08 17:14:35,141,5027,61,80,2938.13,6042.00,0.00
2024-12-08 17:14:35,142,5027,61,81,2917.44,6042.01,0.00
2024-12-08 17:14:35,141,5027,61,80,2933.01,6042.09,0.00
2024-12-08 17:14:35,140,5027,61,79,2950.94,6042.09,0.00
2024-12-08 17:14:35,139,5027,60,79,2950.74,6042.42,0.00
2024-12-08 17:14:35,139,5028,60,79,2994.15,6043.00,0.00
2024-12-08 17:14:35,140,5028,61,79,2972.77,6043.01,0.00
2024-12-08 17:14:35,139,5028,61,78,2985.91,6043.09,0.00
2024-12-08 17:14:35,139,5029,61,78,2961.65,6044.00,0.00
2024-12-08 17:14:35,140,5029,61,79,2940.50,6044.01,0.00
2024-12-08 17:14:35,139,5029,61,78,2952.97,6044.10,0.00
2024-12-08 17:14:35,139,5030,61,78,2926.84,6045.00,0.00
2024-12-08 17:14:35,140,5030,61,79,2905.93,6045.01,0.00
2024-12-08 17:14:35,141,5029,62,79,2884.04,6045.04,0.00
2024-12-08 17:14:35,142,5028,63,79,2867.66,6045.43,0.00
2024-12-08 17:14:35,142,5029,63,79,2888.21,6046.00,0.00
2024-12-08 17:14:35,143,5029,63,80,2868.01,6046.01,0.00
2024-12-08 17:14:35,143,5030,63,80,2916.27,6047.00,0.00
2024-12-08 17:14:35,144,5030,63,81,2896.01,6047.01,0.00
2024-12-08 17:14:36,143,5030,62,81,2913.32,6047.05,0.00
2024-12-08 17:14:36,142,5030,62,80,2931.72,6047.08,0.00
2024-12-08 17:14:36,143,5029,63,80,2898.12,6047.17,0.00
2024-12-08 17:14:36,142,5029,62,80,2952.18,6047.20,0.00
2024-12-08 17:14:36,141,5029,61,80,2946.71,6047.64,0.00
2024-12-08 17:14:36,141,5030,61,80,2959.41,6048.00,0.00
2024-12-08 17:14:36,142,5030,62,80,2938.57,6048.01,0.00
2024-12-08 17:14:36,141,5030,61,80,2956.42,6048.05,0.00
2024-12-08 17:14:36,140,5030,60,80,2910.83,6048.92,0.00
2024-12-08 17:14:36,140,5031,60,80,2992.56,6049.00,0.00
2024-12-08 17:14:36,141,5031,60,81,2971.33,6049.01,0.00
2024-12-08 17:14:36,140,5031,59,81,2991.69,6049.01,0.00
2024-12-08 17:14:36,139,5031,59,80,3009.50,6049.07,0.00
2024-12-08 17:14:36,139,5032,59,80,2985.11,6050.00,0.00
2024-12-08 17:14:36,140,5032,59,81,2963.79,6050.01,0.00
2024-12-08 17:14:36,139,5032,58,81,2981.22,6050.07,0.00
2024-12-08 17:14:36,138,5032,58,80,3001.51,6050.07,0.00
2024-12-08 17:14:36,138,5033,58,80,2976.57,6051.00,0.00
2024-12-08 17:14:36,139,5033,58,81,2955.16,6051.01,0.00
2024-12-08 17:14:36,138,5033,58,80,2971.33,6051.07,0.00
2024-12-08 17:14:36,138,5034,58,80,2947.60,6052.00,0.00
2024-12-08 17:14:36,139,5034,58,81,2926.39,6052.01,0.00
2024-12-08 17:14:36,138,5034,58,80,2942.36,6052.07,0.00
2024-12-08 17:14:36,137,5034,57,80,2953.26,6052.23,0.00
2024-12-08 17:14:36,137,5035,57,80,2938.25,6053.00,0.00
2024-12-08 17:14:36,138,5035,58,80,2916.96,6053.01,0.00
2024-12-08 17:14:36,137,5035,58,79,2932.53,6053.07,0.00
2024-12-08 17:14:36,137,5036,58,79,2906.90,6054.00,0.00
2024-12-08 17:14:36,138,5036,59,79,2885.83,6054.01,0.00
2024-12-08 17:14:36,137,5036,59,78,2892.78,6054.07,0.00
2024-12-08 17:14:36,137,5037,59,78,2877.54,6055.00,0.00
2024-12-08 17:14:36,138,5037,60,78,2856.68,6055.01,0.00
2024-12-08 17:14:36,139,5036,61,78,2835.70,6055.03,0.00
2024-12-08 17:14:36,138,5036,61,77,2887.17,6055.09,0.00
2024-12-08 17:14:36,139,5035,61,78,2852.95,6055.32,0.00
2024-12-08 17:14:36,139,5036,61,78,2872.54,6056.00,0.00
2024-12-08 17:14:36,140,5036,62,78,2852.02,6056.01,0.00
2024-12-08 17:14:36,139,5036,62,77,2866.03,6056.08,0.00
2024-12-08 17:14:36,138,5036,61,77,2878.49,6056.22,0.00
2024-12-08 17:14:36,138,5037,61,77,2949.15,6057.00,0.00
2024-12-08 17:14:36,139,5037,61,78,2927.93,6057.01,0.00
2024-12-08 17:14:36,139,5038,61,78,2891.63,6058.00,0.00
2024-12-08 17:14:36,140,5038,62,78,2870.98,6058.01,0.00
2024-12-08 17:14:36,140,5039,62,78,2836.55,6059.00,0.00
2024-12-08 17:14:36,141,5039,63,78,2816.43,6059.01,0.00
2024-12-08 17:14:36,140,5039,62,78,2819.56,6059.14,0.00
2024-12-08 17:14:36,139,5039,61,78,2837.67,6059.17,0.00
2024-12-08 17:14:36,138,5039,60,78,2849.92,6059.28,0.00
2024-12-08 17:14:36,138,5040,60,78,2850.77,6060.00,0.00
2024-12-08 17:14:36,139,5040,60,79,2830.26,6060.01,0.00
2024-12-08 17:14:36,140,5039,61,79,2750.22,6060.87,0.00
2024-12-08 17:14:36,140,5040,61,79,2783.23,6061.00,0.00
2024-12-08 17:14:36,141,5040,61,80,2763.49,6061.01,0.00
2024-12-08 17:14:36,140,5040,61,79,2775.89,6061.08,0.00
2024-12-08 17:14:36,139,5040,60,79,2795.43,6061.08,0.00
2024-12-08 17:14:37,139,5041,60,79,2818.54,6062.00,0.00
2024-12-08 17:14:37,140,5041,60,80,2798.41,6062.01,0.00
2024-12-08 17:14:37,139,5041,59,80,2816.81,6062.03,0.00
2024-12-08 17:14:37,138,5041,59,79,2834.16,6062.07,0.00
2024-12-08 17:14:37,138,5042,59,79,2813.52,6063.00,0.00
2024-12-08 17:14:37,139,5042,59,80,2793.27,6063.01,0.00
2024-12-08 17:14:37,138,5042,59,79,2808.70,6063.07,0.00
2024-12-08 17:14:37,139,5041,59,80,2776.33,6063.29,0.00
2024-12-08 17:14:37,140,5040,60,80,2778.65,6063.49,0.00
2024-12-08 17:14:37,139,5040,59,80,2813.60,6063.64,0.00
2024-12-08 17:14:37,139,5041,59,80,2824.85,6064.00,0.00
2024-12-08 17:14:37,140,5041,60,80,2804.67,6064.01,0.00
2024-12-08 17:14:37,139,5041,60,79,2820.07,6064.07,0.00
2024-12-08 17:14:37,138,5041,59,79,2821.64,6064.25,0.00
2024-12-08 17:14:37,138,5042,59,79,2878.31,6065.00,0.00
2024-12-08 17:14:37,139,5042,60,79,2857.60,6065.01,0.00
2024-12-08 17:14:37,138,5042,59,79,2877.87,6065.01,0.00
2024-12-08 17:14:37,137,5042,58,79,2894.02,6065.05,0.00
2024-12-08 17:14:37,136,5042,58,78,2906.83,6065.06,0.00
2024-12-08 17:14:37,135,5042,58,77,2854.82,6065.91,0.00
2024-12-08 17:14:37,135,5043,58,77,2894.43,6066.00,0.00
2024-12-08 17:14:37,136,5043,58,78,2873.15,6066.01,0.00
2024-12-08 17:14:37,135,5043,58,77,2889.51,6066.07,0.00
2024-12-08 17:14:37,135,5044,58,77,2861.06,6067.00,0.00
2024-12-08 17:14:37,136,5044,58,78,2840.03,6067.01,0.00
2024-12-08 17:14:37,135,5044,58,77,2857.49,6067.06,0.00
2024-12-08 17:14:37,134,5044,58,76,2877.45,6067.06,0.00
2024-12-08 17:14:37,133,5044,57,76,2873.58,6067.44,0.00
2024-12-08 17:14:37,133,5045,57,76,2868.72,6068.00,0.00
2024-12-08 17:14:37,134,5045,58,76,2847.31,6068.01,0.00
2024-12-08 17:14:37,133,5045,58,75,2864.63,6068.06,0.00
2024-12-08 17:14:37,132,5045,58,74,2832.84,6068.80,0.00
2024-12-08 17:14:37,132,5046,58,74,2857.83,6069.00,0.00
2024-12-08 17:14:37,133,5046,58,75,2836.34,6069.01,0.00
2024-12-08 17:14:37,132,5046,58,74,2853.71,6069.06,0.00
2024-12-08 17:14:37,132,5047,58,74,2827.42,6070.00,0.00
2024-12-08 17:14:37,133,5047,58,75,2806.16,6070.01,0.00
2024-12-08 17:14:37,132,5047,57,75,2826.05,6070.02,0.00
2024-12-08 17:14:37,131,5047,57,74,2845.32,6070.05,0.00
2024-12-08 17:14:37,130,5047,56,74,2836.98,6070.44,0.00
2024-12-08 17:14:37,130,5048,56,74,2840.60,6071.00,0.00
2024-12-08 17:14:37,131,5048,56,75,2818.92,6071.01,0.00
2024-12-08 17:14:37,130,5048,56,74,2830.34,6071.05,0.00
2024-12-08 17:14:37,129,5048,55,74,2851.81,6071.05,0.00
2024-12-08 17:14:37,129,5049,55,74,2826.45,6072.00,0.00
2024-12-08 17:14:37,130,5049,56,74,2804.71,6072.01,0.00
2024-12-08 17:14:37,129,5049,55,74,2785.88,6072.44,0.00
2024-12-08 17:14:37,128,5049,54,74,2795.35,6072.56,0.00
2024-12-08 17:14:37,128,5050,54,74,2816.06,6073.00,0.00
2024-12-08 17:14:37,129,5050,55,74,2794.23,6073.01,0.00
2024-12-08 17:14:37,128,5050,55,73,2807.06,6073.06,0.00
2024-12-08 17:14:37,127,5050,55,72,2828.69,6073.06,0.00
2024-12-08 17:14:37,128,5049,56,72,2801.38,6073.16,0.00
2024-12-08 17:14:37,127,5049,55,72,2830.04,6073.16,0.00
2024-12-08 17:14:37,127,5050,55,72,2817.56,6074.00,0.00
2024-12-08 17:14:37,128,5050,55,73,2795.55,6074.01,0.00
2024-12-08 17:14:37,127,5050,55,72,2814.23,6074.06,0.00
2024-12-08 17:14:37,126,5050,55,71,2815.64,6074.40,0.00
2024-12-08 17:14:37,126,5051,55,71,2866.15,6075.00,0.00
2024-12-08 17:14:37,127,5051,55,72,2843.58,6075.01,0.00
2024-12-08 17:14:37,126,5051,55,71,2862.79,6075.06,0.00
2024-12-08 17:14:37,125,5051,54,71,2861.91,6075.44,0.00
2024-12-08 17:14:37,125,5052,54,71,2867.13,6076.00,0.00
2024-12-08 17:14:37,126,5052,55,71,2844.37,6076.01,0.00
2024-12-08 17:14:37,125,5052,55,70,2863.74,6076.06,0.00
2024-12-08 17:14:37,124,5052,54,70,2886.34,6076.06,0.00
2024-12-08 17:14:37,123,5052,54,69,2901.41,6076.09,0.00
2024-12-08 17:14:38,123,5053,54,69,2886.06,6077.00,0.00
2024-12-08 17:14:38,124,5053,55,69,2862.79,6077.01,0.00
2024-12-08 17:14:38,123,5053,55,68,2882.62,6077.06,0.00
2024-12-08 17:14:38,122,5053,54,68,2883.88,6077.25,0.00
2024-12-08 17:14:38,121,5053,53,68,2896.21,6077.44,0.00
2024-12-08 17:14:38,121,5054,53,68,2902.60,6078.00,0.00
2024-12-08 17:14:38,122,5054,54,68,2878.81,6078.01,0.00
2024-12-08 17:14:38,121,5054,54,67,2899.10,6078.06,0.00
2024-12-08 17:14:38,121,5055,54,67,2872.44,6079.00,0.00
2024-12-08 17:14:38,122,5055,54,68,2848.89,6079.01,0.00
2024-12-08 17:14:38,121,5055,54,67,2868.93,6079.06,0.00
2024-12-08 17:14:38,122,5054,55,67,2811.63,6079.47,0.00
2024-12-08 17:14:38,122,5055,55,67,2867.30,6080.00,0.00
2024-12-08 17:14:38,123,5055,56,67,2843.99,6080.01,0.00
2024-12-08 17:14:38,122,5055,55,67,2865.82,6080.02,0.00
2024-12-08 17:14:38,123,5054,56,67,2842.02,6080.05,0.00
2024-12-08 17:14:38,122,5054,55,67,2907.19,6080.06,0.00
2024-12-08 17:14:38,122,5055,55,67,2930.08,6081.00,0.00
2024-12-08 17:14:38,123,5055,56,67,2906.26,6081.01,0.00
2024-12-08 17:14:38,122,5055,55,67,2927.11,6081.05,0.00
2024-12-08 17:14:38,121,5055,55,66,2944.27,6081.06,0.00
2024-12-08 17:14:38,120,5055,54,66,2957.12,6081.25,0.00
2024-12-08 17:14:38,120,5056,54,66,3003.16,6082.00,0.00
2024-12-08 17:14:38,121,5056,55,66,2978.34,6082.01,0.00
2024-12-08 17:14:38,120,5056,54,66,3001.65,6082.03,0.00
2024-12-08 17:14:38,119,5056,54,65,3024.33,6082.05,0.00
2024-12-08 17:14:38,120,5055,55,65,2993.57,6082.16,0.00
2024-12-08 17:14:38,119,5055,54,65,3057.44,6082.25,0.00
2024-12-08 17:14:38,120,5054,54,66,3010.82,6082.62,0.00
2024-12-08 17:14:38,120,5055,54,66,3047.10,6083.00,0.00
2024-12-08 17:14:38,121,5055,55,66,3021.91,6083.01,0.00
2024-12-08 17:14:38,120,5055,55,65,3043.57,6083.05,0.00
2024-12-08 17:14:38,120,5056,55,65,3128.21,6084.00,0.00
2024-12-08 17:14:38,121,5056,55,66,3102.36,6084.01,0.00
2024-12-08 17:14:38,120,5056,55,65,3124.18,6084.06,0.00
2024-12-08 17:14:38,120,5057,55,65,3107.93,6085.00,0.00
2024-12-08 17:14:38,121,5057,56,65,3082.25,6085.01,0.00
2024-12-08 17:14:38,120,5057,56,64,3103.91,6085.06,0.00
2024-12-08 17:14:38,119,5057,55,64,3109.62,6085.39,0.00
2024-12-08 17:14:38,119,5058,55,64,3113.60,6086.00,0.00
2024-12-08 17:14:38,120,5058,55,65,3087.65,6086.01,0.00
2024-12-08 17:14:38,120,5059,55,65,3058.23,6087.00,0.00
2024-12-08 17:14:38,121,5059,56,65,3032.96,6087.01,0.00
2024-12-08 17:14:38,120,5059,56,64,3047.10,6087.06,0.00
2024-12-08 17:14:38,119,5059,56,63,3068.47,6087.13,0.00
2024-12-08 17:14:38,120,5058,56,64,3037.34,6087.23,0.00
2024-12-08 17:14:38,120,5059,56,64,3043.36,6088.00,0.00
2024-12-08 17:14:38,121,5059,56,65,3018.21,6088.01,0.00
2024-12-08 17:14:38,120,5059,56,64,3039.84,6088.06,0.00
2024-12-08 17:14:38,119,5059,55,64,3064.87,6088.06,0.00
2024-12-08 17:14:38,119,5060,55,64,3100.04,6089.00,0.00
2024-12-08 17:14:38,120,5060,55,65,3074.20,6089.01,0.00
2024-12-08 17:14:38,119,5060,55,64,3096.49,6089.06,0.00
2024-12-08 17:14:38,120,5059,55,65,3045.93,6089.48,0.00
2024-12-08 17:14:38,120,5060,55,65,3079.24,6090.00,0.00
2024-12-08 17:14:38,121,5060,55,66,3053.79,6090.01,0.00
2024-12-08 17:14:38,120,5060,55,65,3075.71,6090.06,0.00
2024-12-08 17:14:38,119,5060,55,64,3100.53,6090.06,0.00
2024-12-08 17:14:38,119,5061,55,64,3134.77,6091.00,0.00
2024-12-08 17:14:38,120,5061,55,65,3108.65,6091.01,0.00
2024-12-08 17:14:38,119,5061,55,64,3130.70,6091.06,0.00
2024-12-08 17:14:38,120,5060,55,65,3077.35,6091.53,0.00
2024-12-08 17:14:38,120,5061,55,65,3103.66,6092.00,0.00
2024-12-08 17:14:38,121,5061,55,66,3078.01,6092.01,0.00
2024-12-08 17:14:38,120,5061,55,65,3083.90,6092.11,0.00
2024-12-08 17:14:38,119,5061,54,65,3103.18,6092.21,0.00
2024-12-08 17:14:38,118,5061,53,65,3120.24,6092.36,0.00
2024-12-08 17:14:38,119,5060,54,65,3064.70,6092.83,0.00
2024-12-08 17:14:38,120,5059,55,65,3065.07,6092.86,0.00
2024-12-08 17:14:39,120,5060,55,65,3173.85,6093.00,0.00
2024-12-08 17:14:39,121,5060,55,66,3147.62,6093.01,0.00
2024-12-08 17:14:39,120,5060,54,66,3169.82,6093.07,0.00
2024-12-08 17:14:39,119,5060,54,65,3190.83,6093.10,0.00
2024-12-08 17:14:39,119,5061,54,65,3279.56,6094.00,0.00
2024-12-08 17:14:39,120,5061,55,65,3252.23,6094.01,0.00
2024-12-08 17:14:39,119,5061,55,64,3270.89,6094.10,0.00
2024-12-08 17:14:39,119,5062,55,64,3257.56,6095.00,0.00
2024-12-08 17:14:39,120,5062,55,65,3230.41,6095.01,0.00
2024-12-08 17:14:39,119,5062,55,64,3249.40,6095.10,0.00
2024-12-08 17:14:39,118,5062,54,64,3242.87,6095.49,0.00
2024-12-08 17:14:39,118,5063,54,64,3263.90,6096.00,0.00
2024-12-08 17:14:39,119,5063,55,64,3236.48,6096.01,0.00
2024-12-08 17:14:39,118,5063,54,64,3252.04,6096.04,0.00
2024-12-08 17:14:39,117,5063,53,64,3277.25,6096.08,0.00
2024-12-08 17:14:39,116,5063,52,64,3305.12,6096.08,0.00
2024-12-08 17:14:39,115,5063,52,63,3330.68,6096.08,0.00
2024-12-08 17:14:39,114,5063,51,63,3344.46,6096.33,0.00
2024-12-08 17:14:39,113,5063,50,63,3373.52,6096.34,0.00
2024-12-08 17:14:39,114,5062,51,63,3319.55,6096.75,0.00
2024-12-08 17:14:39,115,5061,52,63,3308.75,6096.81,0.00
2024-12-08 17:14:39,115,5062,52,63,3358.23,6097.00,0.00
2024-12-08 17:14:39,116,5062,53,63,3329.28,6097.01,0.00
2024-12-08 17:14:39,115,5062,52,63,3356.13,6097.04,0.00
2024-12-08 17:14:39,114,5062,52,62,3379.70,6097.07,0.00
2024-12-08 17:14:39,115,5061,52,63,3314.94,6097.50,0.00
2024-12-08 17:14:39,115,5062,52,63,3476.50,6098.00,0.00
2024-12-08 17:14:39,116,5062,52,64,3446.53,6098.01,0.00
2024-12-08 17:14:39,115,5062,52,63,3469.11,6098.07,0.00
2024-12-08 17:14:39,114,5062,51,63,3484.09,6098.32,0.00
2024-12-08 17:14:39,114,5063,51,63,3539.14,6099.00,0.00
2024-12-08 17:14:39,115,5063,52,63,3508.36,6099.01,0.00
2024-12-08 17:14:39,115,5064,52,63,3480.29,6100.00,0.00
2024-12-08 17:14:39,116,5064,52,64,3450.29,6100.01,0.00
2024-12-08 17:14:39,116,5065,52,64,3421.77,6101.00,0.00
2024-12-08 17:14:39,117,5065,52,65,3392.53,6101.01,0.00
2024-12-08 17:14:39,118,5064,53,65,3298.74,6101.92,0.00
2024-12-08 17:14:39,118,5065,53,65,3338.63,6102.00,0.00
2024-12-08 17:14:39,119,5065,53,66,3310.58,6102.01,0.00
2024-12-08 17:14:39,119,5066,53,66,3332.09,6103.00,0.00
2024-12-08 17:14:39,120,5066,53,67,3304.32,6103.01,0.00
2024-12-08 17:14:39,119,5066,53,66,3325.96,6103.07,0.00
2024-12-08 17:14:39,119,5067,53,66,3309.88,6104.00,0.00
2024-12-08 17:14:39,120,5067,54,66,3282.30,6104.01,0.00
2024-12-08 17:14:39,119,5067,54,65,3304.26,6104.07,0.00
2024-12-08 17:14:39,118,5067,53,65,3319.86,6104.14,0.00
2024-12-08 17:14:39,118,5068,53,65,3319.05,6105.00,0.00
2024-12-08 17:14:39,119,5068,54,65,3291.15,6105.01,0.00
2024-12-08 17:14:39,118,5068,54,64,3313.38,6105.07,0.00
2024-12-08 17:14:39,118,5069,54,64,3297.56,6106.00,0.00
2024-12-08 17:14:39,119,5069,55,64,3269.85,6106.01,0.00
2024-12-08 17:14:39,118,5069,55,63,3290.86,6106.08,0.00
2024-12-08 17:14:39,118,5070,55,63,3250.03,6107.00,0.00
2024-12-08 17:14:39,119,5070,56,63,3222.72,6107.01,0.00
2024-12-08 17:14:39,118,5070,55,63,3244.88,6107.05,0.00
2024-12-08 17:14:39,117,5070,55,62,3268.96,6107.07,0.00
2024-12-08 17:14:39,116,5070,54,62,3226.42,6107.85,0.00
2024-12-08 17:14:39,116,5071,54,62,3269.72,6108.00,0.00
2024-12-08 17:14:39,117,5071,54,63,3241.78,6108.01,0.00
2024-12-08 17:14:39,116,5071,54,62,3262.90,6108.07,0.00
2024-12-08 17:14:39,115,5071,53,62,3285.98,6108.16,0.00
2024-12-08 17:14:39,115,5072,53,62,3274.95,6109.00,0.00
2024-12-08 17:14:39,116,5072,54,62,3246.72,6109.01,0.00
2024-12-08 17:14:39,115,5072,54,61,3266.48,6109.08,0.00
2024-12-08 17:14:39,114,5072,53,61,3237.49,6109.91,0.00
2024-12-08 17:14:40,114,5073,53,61,3285.80,6110.00,0.00
2024-12-08 17:14:40,115,5073,53,62,3257.23,6110.01,0.00
2024-12-08 17:14:40,114,5073,52,62,3282.07,6110.06,0.00
2024-12-08 17:14:40,113,5073,52,61,3306.79,6110.07,0.00
2024-12-08 17:14:40,114,5072,52,62,3227.37,6110.90,0.00
2024-12-08 17:14:40,114,5073,52,62,3270.36,6111.00,0.00
2024-12-08 17:14:40,115,5073,53,62,3241.92,6111.01,0.00
2024-12-08 17:14:40,114,5073,53,61,3261.27,6111.08,0.00
2024-12-08 17:14:40,115,5072,53,62,3196.24,6111.68,0.00
2024-12-08 17:14:40,115,5073,53,62,3287.39,6112.00,0.00
2024-12-08 17:14:40,116,5073,53,63,3259.05,6112.01,0.00
2024-12-08 17:14:40,115,5073,53,62,3278.38,6112.08,0.00
2024-12-08 17:14:40,116,5072,53,63,3208.19,6112.60,0.00
2024-12-08 17:14:40,116,5073,53,63,3317.59,6113.00,0.00
2024-12-08 17:14:40,117,5073,53,64,3289.23,6113.01,0.00
2024-12-08 17:14:40,116,5073,53,63,3304.44,6113.10,0.00
2024-12-08 17:14:40,116,5074,53,63,3344.24,6114.00,0.00
2024-12-08 17:14:40,117,5074,54,63,3315.66,6114.01,0.00
2024-12-08 17:14:40,116,5074,54,62,3340.58,6114.06,0.00
2024-12-08 17:14:40,115,5074,54,61,3359.53,6114.10,0.00
2024-12-08 17:14:40,115,5075,54,61,3346.72,6115.00,0.00
2024-12-08 17:14:40,116,5075,54,62,3317.87,6115.01,0.00
2024-12-08 17:14:40,115,5075,54,61,3333.46,6115.10,0.00
2024-12-08 17:14:40,115,5076,54,61,3320.61,6116.00,0.00
2024-12-08 17:14:40,116,5076,54,62,3291.98,6116.01,0.00
2024-12-08 17:14:40,115,5076,54,61,3307.34,6116.10,0.00
2024-12-08 17:14:40,116,5075,55,61,3268.91,6116.27,0.00
2024-12-08 17:14:40,115,5075,54,61,3332.93,6116.33,0.00
2024-12-08 17:14:40,115,5076,54,61,3334.97,6117.00,0.00
2024-12-08 17:14:40,116,5076,54,62,3306.22,6117.01,0.00
2024-12-08 17:14:40,115,5076,53,62,3331.26,6117.06,0.00
2024-12-08 17:14:40,114,5076,53,61,3355.13,6117.08,0.00
2024-12-08 17:14:40,115,5075,53,62,3267.12,6117.88,0.00
2024-12-08 17:14:40,115,5076,53,62,3371.50,6118.00,0.00
2024-12-08 17:14:40,116,5076,54,62,3342.43,6118.01,0.00
2024-12-08 17:14:40,115,5076,53,62,3366.53,6118.09,0.00
2024-12-08 17:14:40,114,5076,53,61,3387.47,6118.09,0.00
2024-12-08 17:14:40,114,5077,53,61,3427.02,6119.00,0.00
2024-12-08 17:14:40,115,5077,53,62,3397.22,6119.01,0.00
2024-12-08 17:14:40,114,5077,53,61,3413.63,6119.09,0.00
2024-12-08 17:14:40,115,5076,54,61,3357.45,6119.51,0.00
2024-12-08 17:14:40,114,5076,53,61,3399.80,6119.53,0.00
2024-12-08 17:14:40,114,5077,53,61,3413.33,6120.00,0.00
2024-12-08 17:14:40,115,5077,54,61,3383.65,6120.01,0.00
2024-12-08 17:14:40,114,5077,54,60,3400.47,6120.09,0.00
2024-12-08 17:14:40,115,5076,54,61,3318.15,6120.77,0.00
2024-12-08 17:14:40,115,5077,54,61,3419.51,6121.00,0.00
2024-12-08 17:14:40,116,5077,54,62,3390.03,6121.01,0.00
2024-12-08 17:14:40,115,5077,53,62,3415.80,6121.06,0.00
2024-12-08 17:14:40,114,5077,53,61,3439.32,6121.07,0.00
2024-12-08 17:14:40,115,5076,54,61,3407.30,6121.12,0.00
2024-12-08 17:14:40,114,5076,54,60,3480.79,6121.18,0.00
2024-12-08 17:14:40,113,5076,53,60,3501.87,6121.22,0.00
2024-12-08 17:14:40,114,5075,53,61,3461.54,6121.40,0.00
2024-12-08 17:14:40,114,5076,53,61,3528.02,6122.00,0.00
2024-12-08 17:14:40,115,5076,53,62,3497.34,6122.01,0.00
2024-12-08 17:14:40,114,5076,53,61,3515.69,6122.07,0.00
2024-12-08 17:14:40,113,5076,52,61,3520.44,6122.50,0.00
2024-12-08 17:14:40,112,5076,51,61,3486.71,6122.96,0.00
2024-12-08 17:14:40,112,5077,51,61,3648.00,6123.00,0.00
2024-12-08 17:14:40,113,5077,51,62,3615.72,6123.01,0.00
2024-12-08 17:14:40,112,5077,51,61,3622.88,6123.08,0.00
2024-12-08 17:14:40,111,5077,50,61,3653.33,6123.11,0.00
2024-12-08 17:14:40,111,5078,50,61,3650.83,6124.00,0.00
2024-12-08 17:14:40,112,5078,51,61,3618.23,6124.01,0.00
2024-12-08 17:14:40,111,5078,51,60,3625.48,6124.08,0.00
2024-12-08 17:14:40,111,5079,51,60,3620.84,6125.00,0.00
2024-12-08 17:14:40,112,5079,52,60,3588.51,6125.01,0.00
2024-12-08 17:14:41,112,5080,52,60,3554.92,6126.00,0.00
2024-12-08 17:14:41,113,5080,52,61,3523.46,6126.01,0.00
2024-12-08 17:14:41,112,5080,51,61,3535.32,6126.13,0.00
2024-12-08 17:14:41,113,5079,51,62,3501.34,6126.19,0.00
2024-12-08 17:14:41,114,5078,52,62,3481.93,6126.26,0.00
2024-12-08 17:14:41,115,5077,53,62,3473.60,6126.48,0.00
2024-12-08 17:14:41,115,5078,53,62,3502.76,6127.00,0.00
2024-12-08 17:14:41,116,5078,53,63,3472.56,6127.01,0.00
2024-12-08 17:14:41,117,5077,53,64,3438.72,6127.09,0.00
2024-12-08 17:14:41,118,5076,54,64,3413.39,6127.42,0.00
2024-12-08 17:14:41,118,5077,54,64,3574.35,6128.00,0.00
2024-12-08 17:14:41,119,5077,54,65,3544.31,6128.01,0.00
2024-12-08 17:14:41,118,5077,53,65,3557.25,6128.12,0.00
2024-12-08 17:14:41,117,5077,52,65,3576.20,6128.30,0.00
2024-12-08 17:14:41,117,5078,52,65,3673.10,6129.00,0.00
2024-12-08 17:14:41,118,5078,53,65,3641.97,6129.01,0.00
2024-12-08 17:14:41,118,5079,53,65,3601.93,6130.00,0.00
2024-12-08 17:14:41,119,5079,53,66,3571.66,6130.01,0.00
2024-12-08 17:14:41,118,5079,53,65,3537.58,6130.81,0.00
2024-12-08 17:14:41,118,5080,53,65,3543.19,6131.00,0.00
2024-12-08 17:14:41,119,5080,53,66,3513.41,6131.01,0.00
2024-12-08 17:14:41,120,5079,53,67,3410.14,6131.93,0.00
2024-12-08 17:14:41,120,5080,53,67,3438.70,6132.00,0.00
2024-12-08 17:14:41,121,5080,54,67,3410.29,6132.01,0.00
2024-12-08 17:14:41,120,5080,54,66,3435.65,6132.05,0.00
2024-12-08 17:14:41,119,5080,54,65,3455.25,6132.07,0.00
2024-12-08 17:14:41,118,5080,54,64,3483.46,6132.09,0.00
2024-12-08 17:14:41,117,5080,53,64,3456.24,6132.90,0.00
2024-12-08 17:14:41,117,5081,53,64,3539.83,6133.00,0.00
2024-12-08 17:14:41,118,5081,53,65,3509.84,6133.01,0.00
2024-12-08 17:14:41,117,5081,53,64,3530.94,6133.07,0.00
2024-12-08 17:14:41,116,5081,52,64,3545.23,6133.29,0.00
2024-12-08 17:14:41,117,5080,53,64,3499.34,6133.56,0.00
2024-12-08 17:14:41,117,5081,53,64,3517.71,6134.00,0.00
2024-12-08 17:14:41,118,5081,54,64,3487.90,6134.01,0.00
2024-12-08 17:14:41,117,5081,53,64,3476.26,6134.30,0.00
2024-12-08 17:14:41,117,5082,53,64,3510.17,6135.00,0.00
2024-12-08 17:14:41,118,5082,54,64,3480.43,6135.01,0.00
2024-12-08 17:14:41,119,5081,55,64,3451.18,6135.03,0.00
2024-12-08 17:14:41,118,5081,54,64,3502.19,6135.14,0.00
2024-12-08 17:14:41,119,5080,55,64,3440.03,6135.70,0.00
2024-12-08 17:14:41,118,5080,54,64,3472.95,6135.83,0.00
2024-12-08 17:14:41,117,5080,53,64,3496.04,6135.90,0.00
2024-12-08 17:14:41,117,5081,53,64,3526.99,6136.00,0.00
2024-12-08 17:14:41,118,5081,54,64,3497.10,6136.01,0.00
2024-12-08 17:14:41,117,5081,54,63,3519.67,6136.07,0.00
2024-12-08 17:14:41,117,5082,54,63,3600.98,6137.00,0.00
2024-12-08 17:14:41,118,5082,54,64,3570.46,6137.01,0.00
2024-12-08 17:14:41,117,5082,53,64,3519.36,6137.89,0.00
2024-12-08 17:14:41,117,5083,53,64,3562.32,6138.00,0.00
2024-12-08 17:14:41,118,5083,54,64,3532.13,6138.01,0.00
2024-12-08 17:14:41,118,5084,54,64,3498.27,6139.00,0.00
2024-12-08 17:14:41,119,5084,55,64,3468.88,6139.01,0.00
2024-12-08 17:14:41,118,5084,54,64,3480.10,6139.14,0.00
2024-12-08 17:14:41,119,5083,55,64,3434.45,6139.42,0.00
2024-12-08 17:14:41,120,5082,55,65,3414.21,6139.73,0.00
2024-12-08 17:14:41,120,5083,55,65,3442.16,6140.00,0.00
2024-12-08 17:14:41,121,5083,56,65,3413.71,6140.01,0.00
2024-12-08 17:14:41,120,5083,56,64,3436.28,6140.08,0.00
2024-12-08 17:14:41,119,5083,55,64,3462.07,6140.13,0.00
2024-12-08 17:14:41,119,5084,55,64,3540.12,6141.00,0.00
2024-12-08 17:14:41,120,5084,56,64,3510.62,6141.01,0.00
2024-12-08 17:14:41,119,5084,56,63,3529.83,6141.08,0.00
2024-12-08 17:14:41,120,5083,56,64,3423.41,6141.94,0.00
2024-12-08 17:14:42,120,5084,56,64,3473.62,6142.00,0.00
2024-12-08 17:14:42,121,5084,57,64,3444.92,6142.01,0.00
2024-12-08 17:14:42,120,5084,57,63,3463.41,6142.08,0.00
2024-12-08 17:14:42,120,5085,57,63,3484.24,6143.00,0.00
2024-12-08 17:14:42,121,5085,58,63,3455.44,6143.01,0.00
2024-12-08 17:14:42,120,5085,57,63,3464.32,6143.16,0.00
2024-12-08 17:14:42,121,5084,57,64,3375.67,6143.86,0.00
2024-12-08 17:14:42,121,5085,57,64,3417.41,6144.00,0.00
2024-12-08 17:14:42,122,5085,58,64,3389.40,6144.01,0.00
2024-12-08 17:14:42,123,5084,59,64,3325.04,6144.46,0.00
2024-12-08 17:14:42,122,5084,59,63,3335.61,6144.77,0.00
2024-12-08 17:14:42,121,5084,58,63,3352.75,6144.85,0.00
2024-12-08 17:14:42,121,5085,58,63,3435.14,6145.00,0.00
2024-12-08 17:14:42,122,5085,59,63,3406.98,6145.01,0.00
2024-12-08 17:14:42,121,5085,58,63,3434.13,6145.02,0.00
2024-12-08 17:14:42,122,5084,59,63,3375.86,6145.36,0.00
2024-12-08 17:14:42,122,5085,59,63,3430.20,6146.00,0.00
2024-12-08 17:14:42,123,5085,59,64,3402.31,6146.01,0.00
2024-12-08 17:14:42,122,5085,59,63,3413.11,6146.12,0.00
2024-12-08 17:14:42,121,5085,58,63,3439.29,6146.15,0.00
2024-12-08 17:14:42,121,5086,58,63,3478.93,6147.00,0.00
2024-12-08 17:14:42,122,5086,58,64,3450.41,6147.01,0.00
2024-12-08 17:14:42,121,5086,58,63,3464.22,6147.12,0.00
2024-12-08 17:14:42,122,5085,58,64,3395.25,6147.63,0.00
2024-12-08 17:14:42,122,5086,58,64,3426.18,6148.00,0.00
2024-12-08 17:14:42,123,5086,58,65,3398.33,6148.01,0.00
2024-12-08 17:14:42,124,5085,59,65,3355.08,6148.12,0.00
2024-12-08 17:14:42,123,5085,59,64,3413.86,6148.15,0.00
2024-12-08 17:14:42,122,5085,58,64,3432.33,6148.31,0.00
2024-12-08 17:14:42,122,5086,58,64,3490.84,6149.00,0.00
2024-12-08 17:14:42,123,5086,59,64,3462.46,6149.01,0.00
2024-12-08 17:14:42,122,5086,58,64,3487.83,6149.05,0.00
2024-12-08 17:14:42,122,5087,58,64,3488.82,6150.00,0.00
2024-12-08 17:14:42,123,5087,58,65,3460.46,6150.01,0.00
2024-12-08 17:14:42,122,5087,58,64,3485.31,6150.06,0.00
2024-12-08 17:14:42,121,5087,57,64,3434.78,6150.83,0.00
2024-12-08 17:14:42,121,5088,57,64,3464.92,6151.00,0.00
2024-12-08 17:14:42,122,5088,58,64,3436.51,6151.01,0.00
2024-12-08 17:14:42,123,5087,59,64,3347.49,6151.86,0.00
2024-12-08 17:14:42,124,5086,60,64,3323.51,6151.91,0.00
2024-12-08 17:14:42,124,5087,60,64,3361.30,6152.00,0.00
2024-12-08 17:14:42,125,5087,60,65,3334.41,6152.01,0.00
2024-12-08 17:14:42,124,5087,60,64,3348.93,6152.13,0.00
2024-12-08 17:14:42,125,5086,60,65,3271.93,6152.97,0.00
2024-12-08 17:14:42,125,5087,60,65,3428.47,6153.00,0.00
2024-12-08 17:14:42,126,5087,60,66,3401.26,6153.01,0.00
2024-12-08 17:14:42,125,5087,60,65,3412.26,6153.13,0.00
2024-12-08 17:14:42,124,5087,59,65,3438.79,6153.14,0.00
2024-12-08 17:14:42,124,5088,59,65,3475.54,6154.00,0.00
2024-12-08 17:14:42,125,5088,59,66,3447.74,6154.01,0.00
2024-12-08 17:14:42,124,5088,59,65,3457.21,6154.14,0.00
2024-12-08 17:14:42,124,5089,59,65,3444.34,6155.00,0.00
2024-12-08 17:14:42,125,5089,60,65,3416.79,6155.01,0.00
2024-12-08 17:14:42,124,5089,59,65,3440.39,6155.06,0.00
2024-12-08 17:14:42,123,5089,59,64,3453.86,6155.13,0.00
2024-12-08 17:14:42,124,5088,59,65,3365.88,6155.94,0.00
2024-12-08 17:14:42,124,5089,59,65,3414.09,6156.00,0.00
2024-12-08 17:14:42,125,5089,59,66,3386.78,6156.01,0.00
2024-12-08 17:14:42,126,5088,59,67,3315.58,6156.43,0.00
2024-12-08 17:14:43,126,5089,59,67,3410.19,6157.00,0.00
2024-12-08 17:14:43,127,5089,60,67,3383.34,6157.01,0.00
2024-12-08 17:14:43,126,5089,60,66,3406.30,6157.06,0.00
2024-12-08 17:14:43,125,5089,60,65,3427.17,6157.14,0.00
2024-12-08 17:14:43,124,5089,59,65,3438.47,6157.28,0.00
2024-12-08 17:14:43,123,5089,58,65,3462.95,6157.33,0.00
2024-12-08 17:14:43,124,5088,59,65,3415.33,6157.67,0.00
2024-12-08 17:14:43,124,5089,59,65,3504.33,6158.00,0.00
2024-12-08 17:14:43,125,5089,60,65,3476.29,6158.01,0.00
2024-12-08 17:14:43,125,5090,60,65,3493.72,6159.00,0.00
2024-12-08 17:14:43,126,5090,61,65,3465.99,6159.01,0.00
2024-12-08 17:14:43,125,5090,60,65,3491.27,6159.04,0.00
2024-12-08 17:14:43,124,5090,60,64,3509.53,6159.17,0.00
2024-12-08 17:14:43,124,5091,60,64,3498.62,6160.00,0.00
2024-12-08 17:14:43,125,5091,61,64,3470.63,6160.01,0.00
2024-12-08 17:14:43,126,5090,62,64,3441.14,6160.06,0.00
2024-12-08 17:14:43,125,5090,62,63,3501.21,6160.06,0.00
2024-12-08 17:14:43,125,5091,62,63,3473.66,6161.00,0.00
2024-12-08 17:14:43,126,5091,62,64,3446.09,6161.01,0.00
2024-12-08 17:14:43,125,5091,62,63,3459.92,6161.18,0.00
2024-12-08 17:14:43,125,5092,62,63,3479.98,6162.00,0.00
2024-12-08 17:14:43,126,5092,62,64,3452.36,6162.01,0.00
2024-12-08 17:14:43,126,5093,62,64,3402.81,6163.00,0.00
2024-12-08 17:14:43,127,5093,62,65,3376.01,6163.01,0.00
2024-12-08 17:14:43,126,5093,62,64,3401.35,6163.02,0.00
2024-12-08 17:14:43,125,5093,62,63,3426.11,6163.06,0.00
2024-12-08 17:14:43,124,5093,62,62,3453.36,6163.06,0.00
2024-12-08 17:14:43,123,5093,61,62,3397.30,6163.94,0.00
2024-12-08 17:14:43,123,5094,61,62,3443.95,6164.00,0.00
2024-12-08 17:14:43,124,5094,61,63,3416.18,6164.01,0.00
2024-12-08 17:14:43,123,5094,60,63,3440.47,6164.06,0.00
2024-12-08 17:14:43,124,5093,61,63,3391.40,6164.26,0.00
2024-12-08 17:14:43,125,5092,61,64,3323.23,6164.92,0.00
2024-12-08 17:14:43,125,5093,61,64,3371.64,6165.00,0.00
2024-12-08 17:14:43,126,5093,62,64,3344.88,6165.01,0.00
2024-12-08 17:14:43,125,5093,61,64,3362.81,6165.14,0.00
2024-12-08 17:14:43,124,5093,61,63,3379.49,6165.15,0.00
2024-12-08 17:14:43,123,5093,60,63,3357.33,6165.76,0.00
2024-12-08 17:14:43,123,5094,60,63,3493.37,6166.00,0.00
2024-12-08 17:14:43,124,5094,60,64,3465.19,6166.01,0.00
2024-12-08 17:14:43,123,5094,60,63,3489.88,6166.06,0.00
2024-12-08 17:14:43,124,5093,61,63,3410.03,6166.74,0.00
2024-12-08 17:14:43,124,5094,61,63,3454.51,6167.00,0.00
2024-12-08 17:14:43,125,5094,61,64,3426.88,6167.01,0.00
2024-12-08 17:14:43,124,5094,60,64,3447.06,6167.02,0.00
2024-12-08 17:14:43,123,5094,60,63,3470.59,6167.05,0.00
2024-12-08 17:14:43,123,5095,60,63,3512.75,6168.00,0.00
2024-12-08 17:14:43,124,5095,60,64,3484.42,6168.01,0.00
2024-12-08 17:14:43,123,5095,60,63,3505.27,6168.12,0.00
2024-12-08 17:14:43,123,5096,60,63,3491.75,6169.00,0.00
2024-12-08 17:14:43,124,5096,61,63,3463.59,6169.01,0.00
2024-12-08 17:14:43,123,5096,61,62,3474.24,6169.12,0.00
2024-12-08 17:14:43,123,5097,61,62,3460.72,6170.00,0.00
2024-12-08 17:14:43,124,5097,62,62,3432.81,6170.01,0.00
2024-12-08 17:14:43,123,5097,62,61,3443.70,6170.12,0.00
2024-12-08 17:14:43,122,5097,61,61,3450.75,6170.30,0.00
2024-12-08 17:14:43,121,5097,60,61,3466.11,6170.52,0.00
2024-12-08 17:14:43,121,5098,60,61,3487.89,6171.00,0.00
2024-12-08 17:14:43,122,5098,60,62,3459.30,6171.01,0.00
2024-12-08 17:14:43,121,5098,59,62,3481.81,6171.10,0.00
2024-12-08 17:14:43,120,5098,59,61,3498.49,6171.13,0.00
2024-12-08 17:14:43,120,5099,59,61,3485.18,6172.00,0.00
2024-12-08 17:14:43,121,5099,60,61,3456.38,6172.01,0.00
2024-12-08 17:14:43,122,5098,60,62,3415.42,6172.07,0.00
2024-12-08 17:14:43,121,5098,60,61,3467.65,6172.13,0.00
2024-12-08 17:14:43,121,5099,60,61,3463.15,6173.00,0.00
2024-12-08 17:14:43,122,5099,60,62,3434.77,6173.01,0.00
2024-12-08 17:14:44,121,5099,60,61,3445.85,6173.12,0.00
2024-12-08 17:14:44,121,5100,60,61,3480.06,6174.00,0.00
2024-12-08 17:14:44,122,5100,61,61,3451.54,6174.01,0.00
2024-12-08 17:14:44,121,5100,61,60,3452.55,6174.12,0.00
2024-12-08 17:14:44,122,5099,62,60,3396.10,6174.60,0.00
2024-12-08 17:14:44,122,5100,62,60,3427.66,6175.00,0.00
2024-12-08 17:14:44,123,5100,63,60,3399.80,6175.01,0.00
2024-12-08 17:14:44,122,5100,62,60,3376.23,6175.52,0.00
2024-12-08 17:14:44,122,5101,62,60,3440.73,6176.00,0.00
2024-12-08 17:14:44,123,5101,62,61,3412.75,6176.01,0.00
2024-12-08 17:14:44,122,5101,61,61,3435.70,6176.08,0.00
2024-12-08 17:14:44,121,5101,61,60,3451.86,6176.16,0.00
2024-12-08 17:14:44,120,5101,60,60,3469.88,6176.33,0.00
2024-12-08 17:14:44,120,5102,60,60,3460.82,6177.00,0.00
2024-12-08 17:14:44,121,5102,60,61,3432.22,6177.01,0.00
2024-12-08 17:14:44,120,5102,59,61,3419.79,6177.43,0.00
2024-12-08 17:14:44,120,5103,59,61,3425.51,6178.00,0.00
2024-12-08 17:14:44,121,5103,59,62,3397.20,6178.01,0.00
2024-12-08 17:14:44,120,5103,59,61,3415.78,6178.16,0.00
2024-12-08 17:14:44,119,5103,58,61,3440.87,6178.22,0.00
2024-12-08 17:14:44,120,5102,59,61,3402.99,6178.38,0.00
2024-12-08 17:14:44,119,5102,59,60,3416.51,6178.87,0.00
2024-12-08 17:14:44,119,5103,59,60,3460.24,6179.00,0.00
2024-12-08 17:14:44,120,5103,60,60,3431.40,6179.01,0.00
2024-12-08 17:14:44,120,5104,60,60,3453.07,6180.00,0.00
2024-12-08 17:14:44,121,5104,61,60,3424.54,6180.01,0.00
2024-12-08 17:14:44,120,5104,61,59,3433.04,6180.16,0.00
2024-12-08 17:14:44,120,5105,61,59,3422.73,6181.00,0.00
2024-12-08 17:14:44,121,5105,61,60,3394.44,6181.01,0.00
2024-12-08 17:14:44,120,5105,61,59,3402.69,6181.16,0.00
2024-12-08 17:14:44,120,5106,61,59,3392.37,6182.00,0.00
2024-12-08 17:14:44,121,5106,62,59,3364.34,6182.01,0.00
2024-12-08 17:14:44,120,5106,61,59,3391.35,6182.02,0.00
2024-12-08 17:14:44,119,5106,60,59,3411.57,6182.15,0.00
2024-12-08 17:14:44,118,5106,60,58,3429.48,6182.15,0.00
2024-12-08 17:14:44,118,5107,60,58,3419.51,6183.00,0.00
2024-12-08 17:14:44,119,5107,61,58,3390.78,6183.01,0.00
2024-12-08 17:14:44,118,5107,60,58,3414.30,6183.09,0.00
2024-12-08 17:14:44,119,5106,61,58,3383.03,6183.14,0.00
2024-12-08 17:14:44,118,5106,61,57,3445.24,6183.15,0.00
2024-12-08 17:14:44,118,5107,61,57,3435.26,6184.00,0.00
2024-12-08 17:14:44,119,5107,62,57,3406.39,6184.01,0.00
2024-12-08 17:14:44,118,5107,62,56,3430.05,6184.09,0.00
2024-12-08 17:14:44,118,5108,62,56,3457.83,6185.00,0.00
2024-12-08 17:14:44,119,5108,62,57,3428.78,6185.01,0.00
2024-12-08 17:14:44,118,5108,61,57,3448.98,6185.14,0.00
2024-12-08 17:14:44,117,5108,61,56,3475.82,6185.15,0.00
2024-12-08 17:14:44,118,5107,62,56,3426.05,6185.50,0.00
2024-12-08 17:14:44,118,5108,62,56,3459.96,6186.00,0.00
2024-12-08 17:14:44,119,5108,63,56,3430.89,6186.01,0.00
2024-12-08 17:14:45,119,5109,63,56,3453.28,6187.00,0.00
2024-12-08 17:14:45,120,5109,64,56,3424.50,6187.01,0.00
2024-12-08 17:14:45,119,5109,64,55,3442.42,6187.15,0.00
2024-12-08 17:14:45,120,5108,64,56,3372.83,6187.83,0.00
2024-12-08 17:14:45,120,5109,64,56,3411.65,6188.00,0.00
2024-12-08 17:14:45,121,5109,65,56,3383.45,6188.01,0.00
2024-12-08 17:14:45,121,5110,65,56,3404.46,6189.00,0.00
2024-12-08 17:14:45,122,5110,66,56,3376.55,6189.01,0.00
2024-12-08 17:14:45,123,5109,66,57,3313.02,6189.45,0.00
2024-12-08 17:14:45,123,5110,66,57,3326.49,6190.00,0.00
2024-12-08 17:14:45,124,5110,67,57,3299.67,6190.01,0.00
2024-12-08 17:14:45,125,5109,67,58,3272.29,6190.04,0.00
2024-12-08 17:14:45,124,5109,67,57,3336.64,6190.09,0.00
2024-12-08 17:14:45,123,5109,67,56,3357.25,6190.15,0.00
2024-12-08 17:14:45,123,5110,67,56,3395.49,6191.00,0.00
2024-12-08 17:14:45,124,5110,67,57,3368.10,6191.01,0.00
2024-12-08 17:14:45,123,5110,67,56,3376.41,6191.15,0.00
2024-12-08 17:14:45,123,5111,67,56,3414.66,6192.00,0.00
2024-12-08 17:14:45,124,5111,67,57,3387.12,6192.01,0.00
2024-12-08 17:14:45,123,5111,66,57,3410.66,6192.07,0.00
2024-12-08 17:14:45,122,5111,65,57,3424.43,6192.13,0.00
2024-12-08 17:14:45,121,5111,65,56,3441.98,6192.13,0.00
2024-12-08 17:14:45,120,5111,64,56,3446.07,6192.53,0.00
2024-12-08 17:14:45,120,5112,64,56,3469.11,6193.00,0.00
2024-12-08 17:14:45,121,5112,64,57,3440.44,6193.01,0.00
2024-12-08 17:14:45,120,5112,63,57,3456.23,6193.05,0.00
2024-12-08 17:14:45,119,5112,63,56,3470.21,6193.13,0.00
2024-12-08 17:14:45,118,5112,62,56,3484.64,6193.36,0.00
2024-12-08 17:14:45,118,5113,62,56,3498.19,6194.00,0.00
2024-12-08 17:14:45,119,5113,63,56,3468.79,6194.01,0.00
2024-12-08 17:14:45,118,5113,63,55,3480.39,6194.13,0.00
2024-12-08 17:14:45,117,5113,62,55,3490.12,6194.39,0.00
2024-12-08 17:14:45,117,5114,62,55,3505.36,6195.00,0.00
2024-12-08 17:14:45,118,5114,62,56,3475.65,6195.01,0.00
2024-12-08 17:14:45,117,5114,62,55,3500.62,6195.08,0.00
2024-12-08 17:14:45,116,5114,62,54,3516.41,6195.13,0.00
2024-12-08 17:14:45,116,5115,62,54,3505.70,6196.00,0.00
2024-12-08 17:14:45,117,5115,62,55,3475.74,6196.01,0.00
2024-12-08 17:14:45,116,5115,61,55,3499.87,6196.10,0.00
2024-12-08 17:14:45,117,5114,61,56,3410.01,6196.92,0.00
2024-12-08 17:14:45,117,5115,61,56,3451.41,6197.00,0.00
2024-12-08 17:14:45,118,5115,62,56,3422.16,6197.01,0.00
2024-12-08 17:14:45,117,5115,62,55,3444.04,6197.12,0.00
2024-12-08 17:14:45,117,5116,62,55,3485.34,6198.00,0.00
2024-12-08 17:14:45,118,5116,63,55,3455.80,6198.01,0.00
2024-12-08 17:14:45,117,5116,63,54,3467.91,6198.12,0.00
2024-12-08 17:14:45,116,5116,62,54,3486.58,6198.12,0.00
2024-12-08 17:14:45,116,5117,62,54,3486.02,6199.00,0.00
2024-12-08 17:14:45,117,5117,63,54,3456.23,6199.01,0.00
2024-12-08 17:14:45,117,5118,63,54,3400.18,6200.00,0.00
2024-12-08 17:14:45,118,5118,64,54,3371.36,6200.01,0.00
2024-12-08 17:14:45,119,5117,64,55,3340.97,6200.06,0.00
2024-12-08 17:14:45,118,5117,63,55,3388.76,6200.14,0.00
2024-12-08 17:14:45,117,5117,63,54,3417.19,6200.14,0.00
2024-12-08 17:14:45,116,5117,63,53,3370.89,6200.94,0.00
2024-12-08 17:14:45,116,5118,63,53,3409.96,6201.00,0.00
2024-12-08 17:14:45,117,5118,63,54,3380.81,6201.01,0.00
2024-12-08 17:14:45,116,5118,62,54,3405.71,6201.07,0.00
2024-12-08 17:14:45,115,5118,62,53,3420.79,6201.12,0.00
2024-12-08 17:14:45,114,5118,61,53,3433.48,6201.36,0.00
2024-12-08 17:14:45,114,5119,61,53,3501.27,6202.00,0.00
2024-12-08 17:14:45,115,5119,62,53,3470.82,6202.01,0.00
2024-12-08 17:14:45,116,5118,62,54,3418.52,6202.22,0.00
2024-12-08 17:14:45,117,5117,62,55,3425.36,6202.25,0.00
2024-12-08 17:14:45,118,5116,63,55,3420.60,6202.45,0.00
2024-12-08 17:14:45,118,5117,63,55,3473.45,6203.00,0.00
2024-12-08 17:14:45,119,5117,63,56,3444.26,6203.01,0.00
2024-12-08 17:14:45,120,5116,63,57,3388.79,6203.29,0.00
2024-12-08 17:14:46,121,5115,64,57,3314.77,6203.95,0.00
2024-12-08 17:14:46,121,5116,64,57,3517.83,6204.00,0.00
2024-12-08 17:14:46,122,5116,64,58,3489.00,6204.01,0.00
2024-12-08 17:14:46,122,5117,64,58,3559.80,6205.00,0.00
2024-12-08 17:14:46,123,5117,64,59,3530.86,6205.01,0.00
2024-12-08 17:14:46,122,5117,64,58,3546.11,6205.12,0.00
2024-12-08 17:14:46,121,5117,63,58,3574.40,6205.13,0.00
2024-12-08 17:14:46,122,5116,64,58,3518.85,6205.57,0.00
2024-12-08 17:14:46,121,5116,63,58,3553.14,6205.69,0.00
2024-12-08 17:14:46,121,5117,63,58,3585.69,6206.00,0.00
2024-12-08 17:14:46,122,5117,63,59,3556.30,6206.01,0.00
2024-12-08 17:14:46,121,5117,63,58,3571.74,6206.12,0.00
2024-12-08 17:14:46,122,5116,63,59,3519.15,6206.34,0.00
2024-12-08 17:14:46,122,5117,63,59,3610.15,6207.00,0.00
2024-12-08 17:14:46,123,5117,64,59,3580.80,6207.01,0.00
2024-12-08 17:14:46,122,5117,63,59,3604.59,6207.09,0.00
2024-12-08 17:14:46,122,5118,63,59,3630.07,6208.00,0.00
2024-12-08 17:14:46,123,5118,64,59,3600.55,6208.01,0.00
2024-12-08 17:14:46,122,5118,64,58,3621.46,6208.12,0.00
2024-12-08 17:14:46,122,5119,64,58,3607.75,6209.00,0.00
2024-12-08 17:14:46,123,5119,65,58,3578.42,6209.01,0.00
2024-12-08 17:14:46,122,5119,65,57,3591.51,6209.12,0.00
2024-12-08 17:14:46,122,5120,65,57,3577.79,6210.00,0.00
2024-12-08 17:14:46,123,5120,66,57,3548.70,6210.01,0.00
2024-12-08 17:14:46,122,5120,66,56,3562.05,6210.12,0.00
2024-12-08 17:14:46,122,5121,66,56,3548.33,6211.00,0.00
2024-12-08 17:14:46,123,5121,66,57,3519.48,6211.01,0.00
2024-12-08 17:14:46,122,5121,66,56,3532.59,6211.12,0.00
2024-12-08 17:14:46,121,5121,65,56,3548.01,6211.33,0.00
2024-12-08 17:14:46,122,5120,65,57,3498.23,6211.68,0.00
2024-12-08 17:14:46,122,5121,65,57,3553.48,6212.00,0.00
2024-12-08 17:14:46,123,5121,66,57,3524.59,6212.01,0.00
2024-12-08 17:14:46,124,5120,67,57,3431.88,6212.74,0.00
2024-12-08 17:14:46,124,5121,67,57,3527.29,6213.00,0.00
2024-12-08 17:14:46,125,5121,68,57,3499.08,6213.01,0.00
2024-12-08 17:14:46,125,5122,68,57,3517.54,6214.00,0.00
2024-12-08 17:14:46,126,5122,68,58,3489.62,6214.01,0.00
2024-12-08 17:14:46,125,5122,68,57,3509.12,6214.11,0.00
2024-12-08 17:14:46,125,5123,68,57,3494.24,6215.00,0.00
2024-12-08 17:14:46,126,5123,69,57,3466.50,6215.01,0.00
2024-12-08 17:14:46,126,5124,69,57,3434.99,6216.00,0.00
2024-12-08 17:14:46,127,5124,70,57,3407.95,6216.01,0.00
2024-12-08 17:14:46,127,5125,70,57,3375.69,6217.00,0.00
2024-12-08 17:14:46,128,5125,71,57,3349.32,6217.01,0.00
2024-12-08 17:14:46,128,5126,71,57,3316.30,6218.00,0.00
2024-12-08 17:14:46,129,5126,72,57,3290.59,6218.01,0.00
2024-12-08 17:14:46,130,5125,73,57,3242.86,6218.23,0.00
2024-12-08 17:14:46,130,5126,73,57,3277.47,6219.00,0.00
2024-12-08 17:14:46,131,5126,73,58,3252.45,6219.01,0.00
2024-12-08 17:14:46,130,5126,73,57,3271.75,6219.09,0.00
2024-12-08 17:14:46,129,5126,73,56,3294.71,6219.10,0.00
2024-12-08 17:14:46,128,5126,72,56,3317.06,6219.16,0.00
2024-12-08 17:14:46,129,5125,73,56,3268.84,6219.54,0.00
2024-12-08 17:14:46,129,5126,73,56,3356.59,6220.00,0.00
2024-12-08 17:14:46,130,5126,73,57,3330.77,6220.01,0.00
2024-12-08 17:14:46,129,5126,72,57,3336.38,6220.17,0.00
2024-12-08 17:14:46,130,5125,72,58,3265.55,6220.76,0.00
2024-12-08 17:14:47,130,5126,72,58,3353.10,6221.00,0.00
2024-12-08 17:14:47,131,5126,73,58,3327.51,6221.01,0.00
2024-12-08 17:14:47,130,5126,73,57,3345.95,6221.10,0.00
2024-12-08 17:14:47,129,5126,72,57,3356.06,6221.36,0.00
2024-12-08 17:14:47,128,5126,71,57,3365.83,6221.51,0.00
2024-12-08 17:14:47,128,5127,71,57,3431.94,6222.00,0.00
2024-12-08 17:14:47,129,5127,72,57,3405.33,6222.01,0.00
2024-12-08 17:14:47,128,5127,71,57,3424.19,6222.13,0.00
2024-12-08 17:14:47,127,5127,71,56,3443.32,6222.13,0.00
2024-12-08 17:14:47,128,5126,71,57,3361.81,6222.87,0.00
2024-12-08 17:14:47,128,5127,71,57,3408.12,6223.00,0.00
2024-12-08 17:14:47,129,5127,71,58,3381.70,6223.01,0.00
2024-12-08 17:14:47,128,5127,71,57,3402.31,6223.09,0.00
2024-12-08 17:14:47,129,5126,72,57,3361.01,6223.19,0.00
2024-12-08 17:14:47,130,5125,72,58,3363.97,6223.34,0.00
2024-12-08 17:14:47,129,5125,71,58,3411.36,6223.52,0.00
2024-12-08 17:14:47,129,5126,71,58,3478.09,6224.00,0.00
2024-12-08 17:14:47,130,5126,71,59,3451.33,6224.01,0.00
2024-12-08 17:14:47,130,5127,71,59,3513.47,6225.00,0.00
2024-12-08 17:14:47,131,5127,72,59,3486.65,6225.01,0.00
2024-12-08 17:14:47,132,5126,72,60,3426.05,6225.39,0.00
2024-12-08 17:14:47,132,5127,72,60,3453.83,6226.00,0.00
2024-12-08 17:14:47,133,5127,73,60,3427.86,6226.01,0.00
2024-12-08 17:14:47,132,5127,72,60,3450.54,6226.05,0.00
2024-12-08 17:14:47,131,5127,72,59,3464.07,6226.12,0.00
2024-12-08 17:14:47,132,5126,72,60,3414.52,6226.48,0.00
2024-12-08 17:14:47,132,5127,72,60,3489.90,6227.00,0.00
2024-12-08 17:14:47,133,5127,73,60,3463.66,6227.01,0.00
2024-12-08 17:14:47,132,5127,72,60,3487.08,6227.05,0.00
2024-12-08 17:14:47,132,5128,72,60,3501.05,6228.00,0.00
2024-12-08 17:14:47,133,5128,73,60,3474.73,6228.01,0.00
2024-12-08 17:14:47,134,5127,74,60,3392.32,6228.59,0.00
2024-12-08 17:14:47,134,5128,74,60,3430.76,6229.00,0.00
2024-12-08 17:14:47,135,5128,75,60,3405.35,6229.01,0.00
2024-12-08 17:14:47,134,5128,75,59,3416.38,6229.11,0.00
2024-12-08 17:14:47,133,5128,75,58,3435.23,6229.20,0.00
2024-12-08 17:14:47,132,5128,74,58,3434.01,6229.51,0.00
2024-12-08 17:14:47,132,5129,74,58,3498.09,6230.00,0.00
2024-12-08 17:14:47,133,5129,75,58,3471.79,6230.01,0.00
2024-12-08 17:14:47,133,5130,75,58,3438.61,6231.00,0.00
2024-12-08 17:14:47,134,5130,76,58,3412.95,6231.01,0.00
2024-12-08 17:14:47,133,5130,76,57,3430.68,6231.13,0.00
2024-12-08 17:14:47,133,5131,76,57,3413.94,6232.00,0.00
2024-12-08 17:14:47,134,5131,77,57,3388.46,6232.01,0.00
2024-12-08 17:14:47,133,5131,77,56,3398.52,6232.14,0.00
2024-12-08 17:14:47,132,5131,76,56,3402.61,6232.36,0.00
2024-12-08 17:14:47,132,5132,76,56,3410.13,6233.00,0.00
2024-12-08 17:14:47,133,5132,77,56,3384.49,6233.01,0.00
2024-12-08 17:14:47,132,5132,77,55,3405.43,6233.08,0.00
2024-12-08 17:14:47,131,5132,77,54,3420.50,6233.14,0.00
2024-12-08 17:14:47,131,5133,77,54,3405.31,6234.00,0.00
2024-12-08 17:14:47,132,5133,77,55,3379.51,6234.01,0.00
2024-12-08 17:14:47,132,5134,77,55,3346.51,6235.00,0.00
2024-12-08 17:14:47,133,5134,77,56,3321.35,6235.01,0.00
2024-12-08 17:14:47,132,5134,76,56,3346.04,6235.01,0.00
2024-12-08 17:14:47,131,5134,75,56,3366.85,6235.08,0.00
2024-12-08 17:14:47,130,5134,74,56,3392.26,6235.08,0.00
2024-12-08 17:14:47,129,5134,73,56,3401.68,6235.19,0.00
2024-12-08 17:14:47,128,5134,72,56,3417.07,6235.28,0.00
2024-12-08 17:14:47,128,5135,72,56,3415.48,6236.00,0.00
2024-12-08 17:14:47,129,5135,72,57,3389.01,6236.01,0.00
2024-12-08 17:14:48,129,5136,72,57,3355.17,6237.00,0.00
2024-12-08 17:14:48,130,5136,73,57,3329.36,6237.01,0.00
2024-12-08 17:14:48,129,5136,73,56,3343.60,6237.12,0.00
2024-12-08 17:14:48,130,5135,73,57,3317.40,6237.14,0.00
2024-12-08 17:14:48,129,5135,72,57,3377.96,6237.23,0.00
2024-12-08 17:14:48,129,5136,72,57,3377.26,6238.00,0.00
2024-12-08 17:14:48,130,5136,72,58,3351.28,6238.01,0.00
2024-12-08 17:14:48,131,5135,73,58,3320.01,6238.12,0.00
2024-12-08 17:14:48,130,5135,73,57,3370.05,6238.15,0.00
2024-12-08 17:14:48,129,5135,72,57,3393.28,6238.20,0.00
2024-12-08 17:14:48,129,5136,72,57,3428.84,6239.00,0.00
2024-12-08 17:14:48,130,5136,72,58,3402.46,6239.01,0.00
2024-12-08 17:14:48,129,5136,71,58,3424.02,6239.08,0.00
2024-12-08 17:14:48,128,5136,70,58,3441.05,6239.13,0.00
2024-12-08 17:14:48,127,5136,70,57,3460.78,6239.13,0.00
2024-12-08 17:14:48,127,5137,70,57,3497.31,6240.00,0.00
2024-12-08 17:14:48,128,5137,70,58,3469.99,6240.01,0.00
2024-12-08 17:14:48,127,5137,70,57,3482.62,6240.13,0.00
2024-12-08 17:14:48,128,5136,71,57,3388.64,6240.84,0.00
2024-12-08 17:14:48,128,5137,71,57,3433.52,6241.00,0.00
2024-12-08 17:14:48,129,5137,71,58,3406.91,6241.01,0.00
2024-12-08 17:14:48,128,5137,70,58,3433.52,6241.01,0.00
2024-12-08 17:14:48,127,5137,70,57,3446.36,6241.13,0.00
2024-12-08 17:14:48,126,5137,69,57,3451.98,6241.32,0.00
2024-12-08 17:14:48,127,5136,69,58,3419.43,6241.42,0.00
2024-12-08 17:14:48,126,5136,69,57,3423.18,6241.82,0.00
2024-12-08 17:14:48,126,5137,69,57,3509.19,6242.00,0.00
2024-12-08 17:14:48,127,5137,69,58,3481.56,6242.01,0.00
2024-12-08 17:14:48,126,5137,68,58,3504.75,6242.07,0.00
2024-12-08 17:14:48,125,5137,67,58,3506.92,6242.32,0.00
2024-12-08 17:14:48,125,5138,67,58,3552.88,6243.00,0.00
2024-12-08 17:14:48,126,5138,67,59,3524.69,6243.01,0.00
2024-12-08 17:14:48,125,5138,66,59,3550.40,6243.04,0.00
2024-12-08 17:14:48,124,5138,66,58,3573.53,6243.11,0.00
2024-12-08 17:14:48,123,5138,65,58,3588.44,6243.33,0.00
2024-12-08 17:14:48,123,5139,65,58,3566.19,6244.00,0.00
2024-12-08 17:14:48,124,5139,65,59,3537.43,6244.01,0.00
2024-12-08 17:14:48,123,5139,65,58,3548.48,6244.15,0.00
2024-12-08 17:14:48,122,5139,64,58,3575.52,6244.17,0.00
2024-12-08 17:14:48,121,5139,63,58,3597.38,6244.30,0.00
2024-12-08 17:14:48,120,5139,63,57,3557.42,6244.93,0.00
2024-12-08 17:14:48,120,5140,63,57,3604.85,6245.00,0.00
2024-12-08 17:14:48,121,5140,63,58,3575.05,6245.01,0.00
2024-12-08 17:14:48,120,5140,62,58,3600.69,6245.05,0.00
2024-12-08 17:14:48,119,5140,62,57,3615.78,6245.14,0.00
2024-12-08 17:14:48,119,5141,62,57,3613.34,6246.00,0.00
2024-12-08 17:14:48,120,5141,62,58,3583.23,6246.01,0.00
2024-12-08 17:14:48,119,5141,62,57,3595.55,6246.14,0.00
2024-12-08 17:14:48,120,5140,63,57,3552.66,6246.37,0.00
2024-12-08 17:14:48,120,5141,63,57,3562.30,6247.00,0.00
2024-12-08 17:14:48,121,5141,64,57,3532.86,6247.01,0.00
2024-12-08 17:14:48,120,5141,64,56,3550.38,6247.12,0.00
2024-12-08 17:14:48,120,5142,64,56,3587.93,6248.00,0.00
2024-12-08 17:14:48,121,5142,65,56,3558.28,6248.01,0.00
2024-12-08 17:14:48,120,5142,64,56,3586.89,6248.02,0.00
2024-12-08 17:14:48,119,5142,64,55,3612.87,6248.08,0.00
2024-12-08 17:14:48,118,5142,64,54,3631.85,6248.12,0.00
2024-12-08 17:14:48,117,5142,63,54,3635.85,6248.55,0.00
2024-12-08 17:14:48,117,5143,63,54,3648.84,6249.00,0.00
2024-12-08 17:14:48,118,5143,63,55,3617.91,6249.01,0.00
2024-12-08 17:14:48,117,5143,62,55,3620.64,6249.29,0.00
2024-12-08 17:14:48,117,5144,62,55,3617.44,6250.00,0.00
2024-12-08 17:14:48,118,5144,63,55,3586.79,6250.01,0.00
2024-12-08 17:14:48,118,5145,63,55,3554.94,6251.00,0.00
2024-12-08 17:14:48,119,5145,64,55,3525.07,6251.01,0.00
2024-12-08 17:14:48,120,5144,65,55,3495.70,6251.03,0.00
2024-12-08 17:14:49,120,5145,65,55,3495.80,6252.00,0.00
2024-12-08 17:14:49,121,5145,66,55,3466.91,6252.01,0.00
2024-12-08 17:14:49,120,5145,66,54,3481.78,6252.12,0.00
2024-12-08 17:14:49,120,5146,66,54,3519.59,6253.00,0.00
2024-12-08 17:14:49,121,5146,67,54,3490.50,6253.01,0.00
2024-12-08 17:14:49,122,5145,67,55,3457.83,6253.09,0.00
2024-12-08 17:14:49,121,5145,67,54,3473.50,6253.13,0.00
2024-12-08 17:14:49,121,5146,67,54,3470.36,6254.00,0.00
2024-12-08 17:14:49,122,5146,67,55,3441.91,6254.01,0.00
2024-12-08 17:14:49,121,5146,67,54,3455.42,6254.12,0.00
2024-12-08 17:14:49,121,5147,67,54,3493.34,6255.00,0.00
2024-12-08 17:14:49,122,5147,67,55,3464.71,6255.01,0.00
2024-12-08 17:14:49,121,5147,66,55,3464.51,6255.31,0.00
2024-12-08 17:14:49,121,5148,66,55,3462.24,6256.00,0.00
2024-12-08 17:14:49,122,5148,67,55,3433.86,6256.01,0.00
2024-12-08 17:14:49,121,5148,66,55,3460.19,6256.03,0.00
2024-12-08 17:14:49,120,5148,66,54,3485.40,6256.08,0.00
2024-12-08 17:14:49,119,5148,66,53,3506.29,6256.12,0.00
2024-12-08 17:14:49,119,5149,66,53,3492.51,6257.00,0.00
2024-12-08 17:14:49,120,5149,67,53,3463.40,6257.01,0.00
2024-12-08 17:14:49,119,5149,67,52,3476.79,6257.13,0.00
2024-12-08 17:14:49,119,5150,67,52,3461.54,6258.00,0.00
2024-12-08 17:14:49,120,5150,68,52,3432.70,6258.01,0.00
2024-12-08 17:14:49,119,5150,68,51,3435.30,6258.13,0.00
2024-12-08 17:14:49,119,5151,68,51,3428.46,6259.00,0.00
2024-12-08 17:14:49,120,5151,68,52,3399.89,6259.01,0.00
2024-12-08 17:14:49,119,5151,67,52,3422.72,6259.09,0.00
2024-12-08 17:14:49,118,5151,67,51,3439.53,6259.14,0.00
2024-12-08 17:14:49,118,5152,67,51,3389.28,6260.00,0.00
2024-12-08 17:14:49,119,5152,68,51,3360.80,6260.01,0.00
2024-12-08 17:14:49,118,5152,68,50,3369.27,6260.15,0.00
2024-12-08 17:14:49,117,5152,68,49,3309.03,6260.95,0.00
2024-12-08 17:14:49,117,5153,68,49,3359.37,6261.00,0.00
2024-12-08 17:14:49,118,5153,69,49,3330.90,6261.01,0.00
2024-12-08 17:14:49,119,5152,70,49,3235.66,6261.79,0.00
2024-12-08 17:14:49,119,5153,70,49,3271.89,6262.00,0.00
2024-12-08 17:14:49,120,5153,70,50,3244.63,6262.01,0.00
2024-12-08 17:14:49,120,5154,70,50,3250.71,6263.00,0.00
2024-12-08 17:14:49,121,5154,70,51,3223.84,6263.01,0.00
2024-12-08 17:14:49,120,5154,70,50,3240.84,6263.13,0.00
2024-12-08 17:14:49,121,5153,71,50,3200.66,6263.36,0.00
2024-12-08 17:14:49,122,5152,72,50,3189.83,6263.54,0.00
2024-12-08 17:14:49,121,5152,72,49,3230.03,6263.59,0.00
2024-12-08 17:14:49,121,5153,72,49,3241.38,6264.00,0.00
2024-12-08 17:14:49,122,5153,72,50,3214.81,6264.01,0.00
2024-12-08 17:14:49,121,5153,71,50,3239.83,6264.03,0.00
2024-12-08 17:14:49,120,5153,71,49,3252.78,6264.13,0.00
2024-12-08 17:14:49,120,5154,71,49,3338.25,6265.00,0.00
2024-12-08 17:14:49,121,5154,71,50,3310.66,6265.01,0.00
2024-12-08 17:14:49,120,5154,70,50,3333.07,6265.08,0.00
2024-12-08 17:14:49,119,5154,70,49,3347.40,6265.13,0.00
2024-12-08 17:14:49,119,5155,70,49,3330.62,6266.00,0.00
2024-12-08 17:14:49,120,5155,70,50,3302.87,6266.01,0.00
2024-12-08 17:14:49,119,5155,69,50,3322.77,6266.13,0.00
2024-12-08 17:14:49,119,5156,69,50,3295.24,6267.00,0.00
2024-12-08 17:14:49,120,5156,69,51,3267.78,6267.01,0.00
2024-12-08 17:14:49,119,5156,68,51,3287.39,6267.13,0.00
2024-12-08 17:14:49,118,5156,68,50,3309.94,6267.13,0.00
2024-12-08 17:14:49,117,5156,67,50,3307.75,6267.60,0.00
2024-12-08 17:14:49,117,5157,67,50,3322.91,6268.00,0.00
2024-12-08 17:14:49,118,5157,68,50,3294.75,6268.01,0.00
2024-12-08 17:14:49,117,5157,68,49,3279.23,6268.34,0.00
2024-12-08 17:14:50,117,5158,68,49,3288.93,6269.00,0.00
2024-12-08 17:14:50,118,5158,68,50,3261.06,6269.01,0.00
2024-12-08 17:14:50,119,5157,69,50,3168.15,6269.90,0.00
2024-12-08 17:14:50,119,5158,69,50,3206.17,6270.00,0.00
2024-12-08 17:14:50,120,5158,70,50,3179.45,6270.01,0.00
2024-12-08 17:14:50,119,5158,69,50,3200.94,6270.08,0.00
2024-12-08 17:14:50,119,5159,69,50,3224.72,6271.00,0.00
2024-12-08 17:14:50,120,5159,69,51,3197.84,6271.01,0.00
2024-12-08 17:14:50,119,5159,69,50,3211.59,6271.13,0.00
2024-12-08 17:14:50,119,5160,69,50,3195.60,6272.00,0.00
2024-12-08 17:14:50,120,5160,69,51,3168.97,6272.01,0.00
2024-12-08 17:14:50,119,5160,68,51,3190.36,6272.08,0.00
2024-12-08 17:14:50,119,5161,68,51,3160.60,6273.00,0.00
2024-12-08 17:14:50,120,5161,69,51,3134.26,6273.01,0.00
2024-12-08 17:14:50,120,5162,69,51,3098.71,6274.00,0.00
2024-12-08 17:14:50,121,5162,69,52,3073.10,6274.01,0.00
2024-12-08 17:14:50,120,5162,68,52,3093.51,6274.08,0.00
2024-12-08 17:14:50,120,5163,68,52,3061.34,6275.00,0.00
2024-12-08 17:14:50,121,5163,69,52,3036.04,6275.01,0.00
2024-12-08 17:14:50,120,5163,69,51,3048.31,6275.12,0.00
2024-12-08 17:14:50,120,5164,69,51,3027.20,6276.00,0.00
2024-12-08 17:14:50,121,5164,69,52,3002.19,6276.01,0.00
2024-12-08 17:14:50,120,5164,69,51,3012.08,6276.12,0.00
2024-12-08 17:14:50,119,5164,68,51,3021.63,6276.37,0.00
2024-12-08 17:14:50,118,5164,68,50,2993.99,6276.91,0.00
2024-12-08 17:14:50,119,5163,68,51,2967.27,6276.94,0.00
2024-12-08 17:14:50,119,5164,68,51,3019.54,6277.00,0.00
2024-12-08 17:14:50,120,5164,69,51,2994.37,6277.01,0.00
2024-12-08 17:14:50,119,5164,69,50,3004.28,6277.12,0.00
2024-12-08 17:14:50,118,5164,68,50,3027.61,6277.14,0.00
2024-12-08 17:14:50,117,5164,67,50,3040.14,6277.36,0.00
2024-12-08 17:14:50,117,5165,67,50,3096.19,6278.00,0.00
2024-12-08 17:14:50,118,5165,68,50,3069.95,6278.01,0.00
2024-12-08 17:14:50,117,5165,68,49,3079.60,6278.12,0.00
2024-12-08 17:14:50,117,5166,68,49,3067.71,6279.00,0.00
2024-12-08 17:14:50,118,5166,68,50,3041.71,6279.01,0.00
2024-12-08 17:14:50,117,5166,68,49,3051.11,6279.12,0.00
2024-12-08 17:14:50,118,5165,68,50,3019.42,6279.23,0.00
2024-12-08 17:14:50,117,5165,67,50,3077.47,6279.36,0.00
2024-12-08 17:14:50,116,5165,66,50,3102.38,6279.38,0.00
2024-12-08 17:14:50,116,5166,66,50,3107.10,6280.00,0.00
2024-12-08 17:14:50,117,5166,66,51,3080.54,6280.01,0.00
2024-12-08 17:14:50,116,5166,66,50,3090.89,6280.12,0.00
2024-12-08 17:14:50,115,5166,65,50,3117.22,6280.13,0.00
2024-12-08 17:14:50,116,5165,66,50,3061.82,6280.60,0.00
2024-12-08 17:14:50,116,5166,66,50,3176.89,6281.00,0.00
2024-12-08 17:14:50,117,5166,66,51,3149.74,6281.01,0.00
2024-12-08 17:14:50,116,5166,65,51,3165.52,6281.02,0.00
2024-12-08 17:14:50,115,5166,65,50,3175.06,6281.13,0.00
2024-12-08 17:14:50,115,5167,65,50,3229.67,6282.00,0.00
2024-12-08 17:14:50,116,5167,66,50,3201.83,6282.01,0.00
2024-12-08 17:14:50,115,5167,66,49,3211.14,6282.13,0.00
2024-12-08 17:14:50,114,5167,65,49,3238.75,6282.13,0.00
2024-12-08 17:14:50,114,5168,65,49,3228.27,6283.00,0.00
2024-12-08 17:14:50,115,5168,66,49,3200.20,6283.01,0.00
2024-12-08 17:14:50,116,5167,66,50,3171.53,6283.04,0.00
2024-12-08 17:14:50,115,5167,65,50,3232.46,6283.07,0.00
2024-12-08 17:14:50,114,5167,65,49,3245.95,6283.13,0.00
2024-12-08 17:14:50,113,5167,64,49,3270.49,6283.20,0.00
2024-12-08 17:14:50,113,5168,64,49,3263.72,6284.00,0.00
2024-12-08 17:14:50,114,5168,64,50,3235.09,6284.01,0.00
2024-12-08 17:14:50,113,5168,64,49,3245.97,6284.12,0.00
2024-12-08 17:14:50,113,5169,64,49,3291.03,6285.00,0.00
2024-12-08 17:14:50,114,5169,64,50,3262.16,6285.01,0.00
2024-12-08 17:14:51,114,5170,64,50,3233.46,6286.00,0.00
2024-12-08 17:14:51,115,5170,65,50,3205.34,6286.01,0.00
2024-12-08 17:14:51,115,5171,65,50,3176.33,6287.00,0.00
2024-12-08 17:14:51,116,5171,66,50,3148.95,6287.01,0.00
2024-12-08 17:14:51,116,5172,66,50,3119.63,6288.00,0.00
2024-12-08 17:14:51,117,5172,66,51,3092.97,6288.01,0.00
2024-12-08 17:14:51,116,5172,65,51,3113.50,6288.10,0.00
2024-12-08 17:14:51,115,5172,64,51,3131.83,6288.11,0.00
2024-12-08 17:14:51,114,5172,64,50,3150.48,6288.11,0.00
2024-12-08 17:14:51,113,5172,63,50,3175.59,6288.16,0.00
2024-12-08 17:14:51,112,5172,62,50,3190.53,6288.37,0.00
2024-12-08 17:14:51,112,5173,62,50,3207.21,6289.00,0.00
2024-12-08 17:14:51,113,5173,62,51,3178.83,6289.01,0.00
2024-12-08 17:14:51,112,5173,61,51,3201.63,6289.09,0.00
2024-12-08 17:14:51,111,5173,60,51,3208.97,6289.21,0.00
2024-12-08 17:14:51,112,5172,61,51,3171.38,6289.37,0.00
2024-12-08 17:14:51,112,5173,61,51,3221.20,6290.00,0.00
2024-12-08 17:14:51,113,5173,61,52,3192.69,6290.01,0.00
2024-12-08 17:14:51,112,5173,60,52,3215.61,6290.09,0.00
2024-12-08 17:14:51,113,5172,60,53,3152.69,6290.30,0.00
2024-12-08 17:14:51,112,5172,59,53,3204.46,6290.36,0.00
2024-12-08 17:14:51,112,5173,59,53,3276.76,6291.00,0.00
2024-12-08 17:14:51,113,5173,59,54,3247.76,6291.01,0.00
2024-12-08 17:14:51,112,5173,59,53,3257.78,6291.13,0.00
2024-12-08 17:14:51,111,5173,58,53,3283.17,6291.17,0.00
2024-12-08 17:14:51,111,5174,58,53,3344.86,6292.00,0.00
2024-12-08 17:14:51,112,5174,58,54,3315.00,6292.01,0.00
2024-12-08 17:14:51,111,5174,57,54,3314.29,6292.14,0.00
2024-12-08 17:14:51,111,5175,57,54,3316.86,6293.00,0.00
2024-12-08 17:14:51,112,5175,57,55,3287.24,6293.01,0.00
2024-12-08 17:14:51,111,5175,57,54,3307.25,6293.10,0.00
2024-12-08 17:14:51,110,5175,56,54,3319.63,6293.26,0.00
2024-12-08 17:14:51,109,5175,55,54,3345.49,6293.33,0.00
2024-12-08 17:14:51,109,5176,55,54,3360.14,6294.00,0.00
2024-12-08 17:14:51,110,5176,55,55,3329.60,6294.01,0.00
2024-12-08 17:14:51,109,5176,55,54,3347.47,6294.11,0.00
2024-12-08 17:14:51,110,5175,56,54,3266.96,6294.75,0.00
2024-12-08 17:14:51,110,5176,56,54,3319.17,6295.00,0.00
2024-12-08 17:14:51,111,5176,57,54,3289.27,6295.01,0.00
2024-12-08 17:14:51,110,5176,57,53,3306.04,6295.11,0.00
2024-12-08 17:14:51,110,5177,57,53,3350.97,6296.00,0.00
2024-12-08 17:14:51,111,5177,57,54,3320.78,6296.01,0.00
2024-12-08 17:14:51,110,5177,57,53,3334.98,6296.12,0.00
2024-12-08 17:14:51,111,5176,57,54,3295.33,6296.29,0.00
2024-12-08 17:14:51,110,5176,56,54,3300.23,6296.56,0.00
2024-12-08 17:14:51,110,5177,56,54,3326.72,6297.00,0.00
2024-12-08 17:14:51,111,5177,56,55,3296.75,6297.01,0.00
2024-12-08 17:14:51,112,5176,56,56,3267.32,6297.03,0.00
2024-12-08 17:14:51,111,5176,55,56,3309.83,6297.09,0.00
2024-12-08 17:14:51,110,5176,55,55,3329.62,6297.12,0.00
2024-12-08 17:14:51,111,5175,56,55,3278.76,6297.47,0.00
2024-12-08 17:14:51,111,5176,56,55,3383.02,6298.00,0.00
2024-12-08 17:14:51,112,5176,57,55,3352.81,6298.01,0.00
2024-12-08 17:14:51,111,5176,56,55,3374.54,6298.09,0.00
2024-12-08 17:14:51,110,5176,56,54,3394.34,6298.11,0.00
2024-12-08 17:14:51,109,5176,55,54,3425.48,6298.11,0.00
2024-12-08 17:14:51,109,5177,55,54,3539.65,6299.00,0.00
2024-12-08 17:14:51,110,5177,55,55,3507.47,6299.01,0.00
2024-12-08 17:14:51,109,5177,54,55,3535.05,6299.07,0.00
2024-12-08 17:14:51,110,5176,55,55,3474.87,6299.17,0.00
2024-12-08 17:14:51,110,5177,55,55,3521.47,6300.00,0.00
2024-12-08 17:14:51,111,5177,56,55,3489.74,6300.01,0.00
2024-12-08 17:14:51,110,5177,55,55,3499.75,6300.15,0.00
2024-12-08 17:14:51,110,5178,55,55,3558.06,6301.00,0.00
2024-12-08 17:14:51,111,5178,55,56,3526.01,6301.01,0.00
2024-12-08 17:14:51,110,5178,55,55,3525.32,6301.35,0.00
2024-12-08 17:14:52,110,5179,55,55,3528.37,6302.00,0.00
2024-12-08 17:14:52,111,5179,56,55,3496.58,6302.01,0.00
2024-12-08 17:14:52,110,5179,55,55,3527.23,6302.02,0.00
2024-12-08 17:14:52,109,5179,55,54,3553.25,6302.10,0.00
2024-12-08 17:14:52,108,5179,55,53,3559.36,6302.22,0.00
2024-12-08 17:14:52,107,5179,54,53,3575.65,6302.50,0.00
2024-12-08 17:14:52,107,5180,54,53,3590.48,6303.00,0.00
2024-12-08 17:14:52,108,5180,55,53,3557.23,6303.01,0.00
2024-12-08 17:14:52,109,5179,56,53,3523.46,6303.05,0.00
2024-12-08 17:14:52,108,5179,55,53,3592.86,6303.05,0.00
2024-12-08 17:14:52,107,5179,55,52,3612.31,6303.10,0.00
2024-12-08 17:14:52,106,5179,54,52,3644.03,6303.13,0.00
2024-12-08 17:14:52,106,5180,54,52,3637.42,6304.00,0.00
2024-12-08 17:14:52,107,5180,54,53,3603.42,6304.01,0.00
2024-12-08 17:14:52,106,5180,54,52,3621.99,6304.09,0.00
2024-12-08 17:14:52,106,5181,54,52,3672.49,6305.00,0.00
2024-12-08 17:14:52,107,5181,55,52,3638.17,6305.01,0.00
2024-12-08 17:14:52,108,5180,55,53,3557.44,6305.59,0.00
2024-12-08 17:14:52,109,5179,55,54,3542.74,6305.62,0.00
2024-12-08 17:14:52,109,5180,55,54,3582.40,6306.00,0.00
2024-12-08 17:14:52,110,5180,56,54,3549.83,6306.01,0.00
2024-12-08 17:14:52,109,5180,55,54,3551.18,6306.31,0.00
2024-12-08 17:14:52,109,5181,55,54,3670.24,6307.00,0.00
2024-12-08 17:14:52,110,5181,55,55,3636.88,6307.01,0.00
2024-12-08 17:14:52,110,5182,55,55,3609.19,6308.00,0.00
2024-12-08 17:14:52,111,5182,55,56,3576.68,6308.01,0.00
2024-12-08 17:14:52,112,5181,55,57,3480.23,6308.87,0.00
2024-12-08 17:14:52,112,5182,55,57,3522.59,6309.00,0.00
2024-12-08 17:14:52,113,5182,55,58,3491.42,6309.01,0.00
2024-12-08 17:14:52,112,5182,55,57,3510.80,6309.10,0.00
2024-12-08 17:14:52,112,5183,55,57,3553.64,6310.00,0.00
2024-12-08 17:14:52,113,5183,55,58,3522.19,6310.01,0.00
2024-12-08 17:14:52,113,5184,55,58,3491.11,6311.00,0.00
2024-12-08 17:14:52,114,5184,56,58,3460.48,6311.01,0.00
2024-12-08 17:14:52,115,5183,57,58,3404.13,6311.27,0.00
2024-12-08 17:14:52,114,5183,56,58,3469.94,6311.33,0.00
2024-12-08 17:14:52,113,5183,55,58,3499.47,6311.35,0.00
2024-12-08 17:14:52,112,5183,54,58,3512.46,6311.63,0.00
2024-12-08 17:14:52,112,5184,54,58,3543.45,6312.00,0.00
2024-12-08 17:14:52,113,5184,55,58,3512.09,6312.01,0.00
2024-12-08 17:14:52,112,5184,54,58,3538.97,6312.07,0.00
2024-12-08 17:14:52,113,5183,55,58,3485.91,6312.26,0.00
2024-12-08 17:14:52,113,5184,55,58,3577.23,6313.00,0.00
2024-12-08 17:14:52,114,5184,56,58,3545.85,6313.01,0.00
2024-12-08 17:14:52,113,5184,56,57,3562.17,6313.09,0.00
2024-12-08 17:14:52,114,5183,56,58,3514.68,6313.36,0.00
2024-12-08 17:14:52,114,5184,56,58,3626.63,6314.00,0.00
2024-12-08 17:14:52,115,5184,56,59,3595.09,6314.01,0.00
2024-12-08 17:14:52,114,5184,56,58,3615.03,6314.09,0.00
2024-12-08 17:14:52,113,5184,55,58,3638.08,6314.11,0.00
2024-12-08 17:14:52,113,5185,55,58,3693.70,6315.00,0.00
2024-12-08 17:14:52,114,5185,56,58,3661.30,6315.01,0.00
2024-12-08 17:14:52,113,5185,55,58,3685.90,6315.06,0.00
2024-12-08 17:14:52,112,5185,55,57,3710.36,6315.09,0.00
2024-12-08 17:14:52,113,5184,55,58,3654.04,6315.48,0.00
2024-12-08 17:14:52,113,5185,55,58,3682.39,6316.00,0.00
2024-12-08 17:14:52,114,5185,55,59,3650.08,6316.01,0.00
2024-12-08 17:14:52,115,5184,55,60,3618.34,6316.03,0.00
2024-12-08 17:14:52,114,5184,55,59,3642.92,6316.12,0.00
2024-12-08 17:14:52,114,5185,55,59,3687.56,6317.00,0.00
2024-12-08 17:14:52,115,5185,55,60,3655.50,6317.01,0.00
2024-12-08 17:14:52,114,5185,55,59,3669.87,6317.11,0.00
2024-12-08 17:14:52,113,5185,54,59,3690.60,6317.12,0.00
2024-12-08 17:14:52,114,5184,54,60,3646.11,6317.32,0.00
2024-12-08 17:14:52,114,5185,54,60,3740.23,6318.00,0.00
2024-12-08 17:14:52,115,5185,55,60,3707.71,6318.01,0.00
2024-12-08 17:14:52,114,5185,54,60,3736.38,6318.06,0.00
2024-12-08 17:14:52,113,5185,54,59,3754.92,6318.11,0.00
2024-12-08 17:14:53,113,5186,54,59,3799.22,6319.00,0.00
2024-12-08 17:14:53,114,5186,55,59,3765.90,6319.01,0.00
2024-12-08 17:14:53,114,5187,55,59,3735.46,6320.00,0.00
2024-12-08 17:14:53,115,5187,55,60,3702.98,6320.01,0.00
2024-12-08 17:14:53,114,5187,54,60,3732.16,6320.05,0.00
2024-12-08 17:14:53,115,5186,55,60,3638.58,6320.87,0.00
2024-12-08 17:14:53,115,5187,55,60,3680.68,6321.00,0.00
2024-12-08 17:14:53,116,5187,56,60,3648.95,6321.01,0.00
2024-12-08 17:14:53,115,5187,55,60,3677.40,6321.05,0.00
2024-12-08 17:14:53,114,5187,55,59,3706.34,6321.10,0.00
2024-12-08 17:14:53,115,5186,55,60,3633.78,6321.76,0.00
2024-12-08 17:14:53,116,5185,55,61,3610.11,6321.79,0.00
2024-12-08 17:14:53,116,5186,55,61,3697.65,6322.00,0.00
2024-12-08 17:14:53,117,5186,55,62,3666.04,6322.01,0.00
2024-12-08 17:14:53,116,5186,55,61,3681.87,6322.10,0.00
2024-12-08 17:14:53,116,5187,55,61,3771.75,6323.00,0.00
2024-12-08 17:14:53,117,5187,56,61,3739.51,6323.01,0.00
2024-12-08 17:14:53,116,5187,55,61,3769.04,6323.04,0.00
2024-12-08 17:14:53,115,5187,55,60,3788.08,6323.10,0.00
2024-12-08 17:14:53,114,5187,54,60,3798.64,6323.27,0.00
2024-12-08 17:14:53,114,5188,54,60,3802.66,6324.00,0.00
2024-12-08 17:14:53,115,5188,54,61,3769.59,6324.01,0.00
2024-12-08 17:14:53,115,5189,54,61,3734.91,6325.00,0.00
2024-12-08 17:14:53,116,5189,55,61,3702.71,6325.01,0.00
2024-12-08 17:14:53,117,5188,55,62,3667.84,6325.08,0.00
2024-12-08 17:14:53,117,5189,55,62,3687.53,6326.00,0.00
2024-12-08 17:14:53,118,5189,55,63,3656.28,6326.01,0.00
2024-12-08 17:14:53,117,5189,54,63,3684.85,6326.04,0.00
2024-12-08 17:14:53,117,5190,54,63,3675.12,6327.00,0.00
2024-12-08 17:14:53,118,5190,54,64,3643.97,6327.01,0.00
2024-12-08 17:14:53,119,5189,54,65,3612.83,6327.03,0.00
2024-12-08 17:14:53,118,5189,53,65,3648.85,6327.14,0.00
2024-12-08 17:14:53,117,5189,52,65,3643.50,6327.62,0.00
2024-12-08 17:14:53,116,5189,52,64,3640.58,6327.88,0.00
2024-12-08 17:14:53,116,5190,52,64,3684.44,6328.00,0.00
2024-12-08 17:14:53,117,5190,53,64,3652.95,6328.01,0.00
2024-12-08 17:14:53,116,5190,53,63,3676.84,6328.09,0.00
2024-12-08 17:14:53,116,5191,53,63,3714.42,6329.00,0.00
2024-12-08 17:14:53,117,5191,54,63,3682.67,6329.01,0.00
2024-12-08 17:14:53,118,5190,55,63,3650.40,6329.04,0.00
2024-12-08 17:14:53,117,5190,54,63,3676.80,6329.15,0.00
2024-12-08 17:14:53,116,5190,53,63,3700.35,6329.28,0.00
2024-12-08 17:14:53,116,5191,53,63,3696.22,6330.00,0.00
2024-12-08 17:14:53,117,5191,54,63,3664.63,6330.01,0.00
2024-12-08 17:14:53,117,5192,54,63,3687.16,6331.00,0.00
2024-12-08 17:14:53,118,5192,54,64,3655.91,6331.01,0.00
2024-12-08 17:14:53,117,5192,53,64,3659.12,6331.28,0.00
2024-12-08 17:14:53,118,5191,53,65,3601.52,6331.72,0.00
2024-12-08 17:14:53,118,5192,53,65,3638.15,6332.00,0.00
2024-12-08 17:14:53,119,5192,53,66,3607.57,6332.01,0.00
2024-12-08 17:14:53,118,5192,52,66,3634.03,6332.06,0.00
2024-12-08 17:14:53,117,5192,52,65,3655.34,6332.08,0.00
2024-12-08 17:14:53,117,5193,52,65,3694.64,6333.00,0.00
2024-12-08 17:14:53,118,5193,53,65,3663.33,6333.01,0.00
2024-12-08 17:14:53,117,5193,53,64,3683.39,6333.08,0.00
2024-12-08 17:14:53,116,5193,52,64,3711.88,6333.12,0.00
2024-12-08 17:14:53,116,5194,52,64,3700.32,6334.00,0.00
2024-12-08 17:14:53,117,5194,53,64,3668.69,6334.01,0.00
2024-12-08 17:14:53,116,5194,53,63,3688.87,6334.08,0.00
2024-12-08 17:14:53,115,5194,52,63,3709.44,6334.26,0.00
2024-12-08 17:14:54,115,5195,52,63,3706.93,6335.00,0.00
2024-12-08 17:14:54,116,5195,52,64,3674.98,6335.01,0.00
2024-12-08 17:14:54,115,5195,51,64,3702.72,6335.06,0.00
2024-12-08 17:14:54,114,5195,51,63,3727.98,6335.07,0.00
2024-12-08 17:14:54,114,5196,51,63,3713.78,6336.00,0.00
2024-12-08 17:14:54,115,5196,52,63,3681.49,6336.01,0.00
2024-12-08 17:14:54,114,5196,52,62,3701.02,6336.08,0.00
2024-12-08 17:14:54,114,5197,52,62,3687.16,6337.00,0.00
2024-12-08 17:14:54,115,5197,53,62,3655.10,6337.01,0.00
2024-12-08 17:14:54,114,5197,53,61,3672.03,6337.09,0.00
2024-12-08 17:14:54,114,5198,53,61,3657.25,6338.00,0.00
2024-12-08 17:14:54,115,5198,54,61,3625.45,6338.01,0.00
2024-12-08 17:14:54,114,5198,53,61,3650.63,6338.11,0.00
2024-12-08 17:14:54,114,5199,53,61,3625.07,6339.00,0.00
2024-12-08 17:14:54,115,5199,53,62,3593.55,6339.01,0.00
2024-12-08 17:14:54,114,5199,52,62,3596.23,6339.19,0.00
2024-12-08 17:14:54,114,5200,52,62,3597.10,6340.00,0.00
2024-12-08 17:14:54,115,5200,53,62,3565.82,6340.01,0.00
2024-12-08 17:14:54,115,5201,53,62,3529.09,6341.00,0.00
2024-12-08 17:14:54,116,5201,53,63,3498.66,6341.01,0.00
2024-12-08 17:14:54,115,5201,53,62,3513.69,6341.10,0.00
2024-12-08 17:14:54,114,5201,52,62,3544.52,6341.11,0.00
2024-12-08 17:14:54,113,5201,51,62,3575.32,6341.11,0.00
2024-12-08 17:14:54,113,5202,51,62,3553.67,6342.00,0.00
2024-12-08 17:14:54,114,5202,52,62,3522.50,6342.01,0.00
2024-12-08 17:14:54,113,5202,52,61,3535.76,6342.11,0.00
2024-12-08 17:14:54,113,5203,52,61,3515.18,6343.00,0.00
2024-12-08 17:14:54,114,5203,52,62,3484.35,6343.01,0.00
2024-12-08 17:14:54,113,5203,52,61,3497.27,6343.11,0.00
2024-12-08 17:14:54,112,5203,51,61,3527.93,6343.11,0.00
2024-12-08 17:14:54,112,5204,51,61,3512.06,6344.00,0.00
2024-12-08 17:14:54,113,5204,51,62,3480.98,6344.01,0.00
2024-12-08 17:14:54,112,5204,51,61,3493.98,6344.11,0.00
2024-12-08 17:14:54,111,5204,50,61,3506.07,6344.24,0.00
2024-12-08 17:14:54,111,5205,50,61,3510.67,6345.00,0.00
2024-12-08 17:14:54,112,5205,51,61,3479.32,6345.01,0.00
2024-12-08 17:14:54,111,5205,50,61,3479.68,6345.32,0.00
2024-12-08 17:14:54,110,5205,49,61,3493.50,6345.46,0.00
2024-12-08 17:14:54,110,5206,49,61,3511.85,6346.00,0.00
2024-12-08 17:14:54,111,5206,50,61,3480.21,6346.01,0.00
2024-12-08 17:14:54,112,5205,51,61,3446.90,6346.06,0.00
2024-12-08 17:14:54,111,5205,51,60,3516.32,6346.12,0.00
2024-12-08 17:14:54,112,5204,51,61,3457.91,6346.56,0.00
2024-12-08 17:14:54,112,5205,51,61,3479.13,6347.00,0.00
2024-12-08 17:14:54,113,5205,52,61,3448.34,6347.01,0.00
2024-12-08 17:14:54,112,5205,52,60,3461.04,6347.11,0.00
2024-12-08 17:14:54,111,5205,51,60,3467.23,6347.50,0.00
2024-12-08 17:14:54,111,5206,51,60,3591.66,6348.00,0.00
2024-12-08 17:14:54,112,5206,51,61,3559.59,6348.01,0.00
2024-12-08 17:14:54,113,5205,51,62,3490.62,6348.44,0.00
2024-12-08 17:14:54,113,5206,51,62,3519.76,6349.00,0.00
2024-12-08 17:14:54,114,5206,51,63,3488.89,6349.01,0.00
2024-12-08 17:14:54,113,5206,51,62,3509.14,6349.11,0.00
2024-12-08 17:14:54,113,5207,51,62,3539.88,6350.00,0.00
2024-12-08 17:14:54,114,5207,52,62,3508.82,6350.01,0.00
2024-12-08 17:14:54,114,5208,52,62,3462.41,6351.00,0.00
2024-12-08 17:14:54,115,5208,53,62,3432.30,6351.01,0.00
2024-12-08 17:14:54,114,5208,52,62,3457.43,6351.08,0.00
2024-12-08 17:14:54,113,5208,51,62,3457.76,6351.34,0.00
2024-12-08 17:14:54,113,5209,51,62,3455.11,6352.00,0.00
2024-12-08 17:14:54,114,5209,52,62,3424.80,6352.01,0.00
2024-12-08 17:14:54,113,5209,52,61,3447.85,6352.10,0.00
2024-12-08 17:14:55,113,5210,52,61,3418.11,6353.00,0.00
2024-12-08 17:14:55,114,5210,53,61,3388.13,6353.01,0.00
2024-12-08 17:14:55,113,5210,52,61,3415.88,6353.04,0.00
2024-12-08 17:14:55,112,5210,51,61,3428.83,6353.11,0.00
2024-12-08 17:14:55,113,5209,51,62,3376.13,6353.48,0.00
2024-12-08 17:14:55,113,5210,51,62,3410.73,6354.00,0.00
2024-12-08 17:14:55,114,5210,52,62,3380.81,6354.01,0.00
2024-12-08 17:14:55,113,5210,52,61,3406.40,6354.07,0.00
2024-12-08 17:14:55,112,5210,51,61,3376.70,6354.73,0.00
2024-12-08 17:14:55,112,5211,51,61,3445.85,6355.00,0.00
2024-12-08 17:14:55,113,5211,51,62,3415.35,6355.01,0.00
2024-12-08 17:14:55,112,5211,51,61,3429.44,6355.08,0.00
2024-12-08 17:14:55,112,5212,51,61,3399.06,6356.00,0.00
2024-12-08 17:14:55,113,5212,52,61,3368.98,6356.01,0.00
2024-12-08 17:14:55,114,5211,52,62,3312.75,6356.27,0.00
2024-12-08 17:14:55,114,5212,52,62,3334.14,6357.00,0.00
2024-12-08 17:14:55,115,5212,52,63,3305.14,6357.01,0.00
2024-12-08 17:14:55,115,5213,52,63,3321.99,6358.00,0.00
2024-12-08 17:14:55,116,5213,52,64,3293.35,6358.01,0.00
2024-12-08 17:14:55,115,5213,52,63,3313.18,6358.08,0.00
2024-12-08 17:14:55,114,5213,51,63,3340.02,6358.11,0.00
2024-12-08 17:14:55,113,5213,50,63,3346.89,6358.45,0.00
2024-12-08 17:14:55,113,5214,50,63,3351.67,6359.00,0.00
2024-12-08 17:14:55,114,5214,50,64,3322.27,6359.01,0.00
2024-12-08 17:14:55,113,5214,50,63,3336.51,6359.09,0.00
2024-12-08 17:14:55,113,5215,50,63,3319.29,6360.00,0.00
2024-12-08 17:14:55,114,5215,50,64,3290.17,6360.01,0.00
2024-12-08 17:14:55,113,5215,49,64,3315.94,6360.05,0.00
2024-12-08 17:14:55,112,5215,49,63,3320.57,6360.09,0.00
2024-12-08 17:14:55,111,5215,48,63,3322.01,6360.54,0.00
2024-12-08 17:14:55,111,5216,48,63,3346.63,6361.00,0.00
2024-12-08 17:14:55,112,5216,48,64,3316.75,6361.01,0.00
2024-12-08 17:14:55,111,5216,48,63,3319.16,6361.09,0.00
2024-12-08 17:14:55,110,5216,47,63,3333.80,6361.33,0.00
2024-12-08 17:14:55,110,5217,47,63,3345.65,6362.00,0.00
2024-12-08 17:14:55,111,5217,47,64,3315.51,6362.01,0.00
2024-12-08 17:14:55,110,5217,47,63,3329.49,6362.09,0.00
2024-12-08 17:14:55,110,5218,47,63,3314.44,6363.00,0.00
2024-12-08 17:14:55,111,5218,48,63,3284.58,6363.01,0.00
2024-12-08 17:14:55,110,5218,48,62,3298.28,6363.09,0.00
2024-12-08 17:14:55,110,5219,48,62,3251.02,6364.00,0.00
2024-12-08 17:14:55,111,5219,49,62,3221.73,6364.01,0.00
2024-12-08 17:14:55,110,5219,49,61,3233.70,6364.10,0.00
2024-12-08 17:14:55,109,5219,48,61,3176.07,6364.88,0.00
2024-12-08 17:14:55,109,5220,48,61,3226.96,6365.00,0.00
2024-12-08 17:14:55,110,5220,48,62,3197.62,6365.01,0.00
2024-12-08 17:14:55,109,5220,48,61,3208.31,6365.11,0.00
2024-12-08 17:14:55,108,5220,48,60,3208.54,6365.38,0.00
2024-12-08 17:14:55,109,5219,49,60,3176.01,6365.43,0.00
2024-12-08 17:14:55,109,5220,49,60,3222.89,6366.00,0.00
2024-12-08 17:14:55,110,5220,49,61,3193.59,6366.01,0.00
2024-12-08 17:14:55,110,5221,49,61,3194.75,6367.00,0.00
2024-12-08 17:14:55,111,5221,50,61,3165.96,6367.01,0.00
2024-12-08 17:14:55,110,5221,49,61,3188.41,6367.11,0.00
2024-12-08 17:14:55,109,5221,48,61,3217.08,6367.11,0.00
2024-12-08 17:14:55,108,5221,48,60,3244.51,6367.12,0.00
2024-12-08 17:14:55,107,5221,47,60,3209.88,6367.84,0.00
2024-12-08 17:14:55,107,5222,47,60,3247.50,6368.00,0.00
2024-12-08 17:14:55,108,5222,47,61,3217.43,6368.01,0.00
2024-12-08 17:14:55,107,5222,47,60,3228.49,6368.11,0.00
2024-12-08 17:14:55,106,5222,46,60,3234.42,6368.47,0.00
2024-12-08 17:14:55,106,5223,46,60,3248.25,6369.00,0.00
2024-12-08 17:14:55,107,5223,46,61,3217.89,6369.01,0.00
2024-12-08 17:14:55,106,5223,45,61,3216.93,6369.22,0.00
2024-12-08 17:14:56,106,5224,45,61,3225.78,6370.00,0.00
2024-12-08 17:14:56,107,5224,45,62,3195.64,6370.01,0.00
2024-12-08 17:14:56,106,5224,45,61,3217.17,6370.11,0.00
2024-12-08 17:14:56,106,5225,45,61,3207.64,6371.00,0.00
2024-12-08 17:14:56,107,5225,45,62,3177.66,6371.01,0.00
2024-12-08 17:14:56,106,5225,45,61,3187.35,6371.11,0.00
2024-12-08 17:14:56,105,5225,44,61,3175.24,6371.57,0.00
2024-12-08 17:14:56,105,5226,44,61,3208.48,6372.00,0.00
2024-12-08 17:14:56,106,5226,45,61,3178.21,6372.01,0.00
2024-12-08 17:14:56,105,5226,45,60,3188.09,6372.11,0.00
2024-12-08 17:14:56,105,5227,45,60,3145.46,6373.00,0.00
2024-12-08 17:14:56,106,5227,46,60,3115.79,6373.01,0.00
2024-12-08 17:14:56,105,5227,45,60,3140.34,6373.07,0.00
2024-12-08 17:14:56,104,5227,44,60,3105.55,6373.70,0.00
2024-12-08 17:14:56,103,5227,44,59,3106.82,6373.86,0.00
2024-12-08 17:14:56,103,5228,44,59,3160.15,6374.00,0.00
2024-12-08 17:14:56,104,5228,44,60,3129.76,6374.01,0.00
2024-12-08 17:14:56,104,5229,44,60,3103.85,6375.00,0.00
2024-12-08 17:14:56,105,5229,44,61,3074.29,6375.01,0.00
2024-12-08 17:14:56,104,5229,43,61,3083.66,6375.14,0.00
2024-12-08 17:14:56,103,5229,42,61,3098.81,6375.36,0.00
2024-12-08 17:14:56,102,5229,41,61,3108.64,6375.54,0.00
2024-12-08 17:14:56,102,5230,41,61,3142.08,6376.00,0.00
2024-12-08 17:14:56,103,5230,42,61,3111.57,6376.01,0.00
2024-12-08 17:14:56,102,5230,42,60,3137.73,6376.07,0.00
2024-12-08 17:14:56,101,5230,42,59,3153.64,6376.10,0.00
2024-12-08 17:14:56,101,5231,42,59,3147.17,6377.00,0.00
2024-12-08 17:14:56,102,5231,42,60,3116.31,6377.01,0.00
2024-12-08 17:14:56,101,5231,41,60,3142.77,6377.07,0.00
2024-12-08 17:14:56,100,5231,41,59,3162.08,6377.09,0.00
2024-12-08 17:14:56,100,5232,41,59,3155.54,6378.00,0.00
2024-12-08 17:14:56,101,5232,41,60,3124.29,6378.01,0.00
2024-12-08 17:14:56,102,5231,42,60,3091.80,6378.06,0.00
2024-12-08 17:14:56,101,5231,42,59,3134.85,6378.10,0.00
2024-12-08 17:14:56,101,5232,42,59,3128.36,6379.00,0.00
2024-12-08 17:14:56,102,5232,42,60,3097.69,6379.01,0.00
2024-12-08 17:14:56,101,5232,42,59,3111.97,6379.09,0.00
2024-12-08 17:14:56,102,5231,43,59,3048.31,6379.63,0.00
2024-12-08 17:14:56,102,5232,43,59,3159.28,6380.00,0.00
2024-12-08 17:14:56,103,5232,44,59,3128.61,6380.01,0.00
2024-12-08 17:14:56,102,5232,44,58,3143.78,6380.09,0.00
2024-12-08 17:14:56,101,5232,43,58,3173.02,6380.12,0.00
2024-12-08 17:14:56,101,5233,43,58,3230.50,6381.00,0.00
2024-12-08 17:14:56,102,5233,43,59,3198.83,6381.01,0.00
2024-12-08 17:14:56,101,5233,43,58,3214.73,6381.09,0.00
2024-12-08 17:14:56,101,5234,43,58,3206.71,6382.00,0.00
2024-12-08 17:14:56,102,5234,44,58,3175.27,6382.01,0.00
2024-12-08 17:14:56,101,5234,44,57,3168.24,6382.21,0.00
2024-12-08 17:14:56,101,5235,44,57,3180.50,6383.00,0.00
2024-12-08 17:14:56,102,5235,44,58,3149.32,6383.01,0.00
2024-12-08 17:14:56,101,5235,43,58,3176.10,6383.07,0.00
2024-12-08 17:14:56,100,5235,43,57,3203.40,6383.08,0.00
2024-12-08 17:14:56,101,5234,44,57,3138.56,6383.61,0.00
2024-12-08 17:14:56,101,5235,44,57,3227.10,6384.00,0.00
2024-12-08 17:14:56,102,5235,44,58,3195.46,6384.01,0.00
2024-12-08 17:14:56,101,5235,44,57,3222.70,6384.07,0.00
2024-12-08 17:14:56,100,5235,44,56,3244.71,6384.07,0.00
2024-12-08 17:14:56,99,5235,43,56,3264.60,6384.08,0.00
2024-12-08 17:14:56,99,5236,43,56,3335.37,6385.00,0.00
2024-12-08 17:14:56,100,5236,44,56,3302.02,6385.01,0.00
2024-12-08 17:14:56,100,5237,44,56,3275.08,6386.00,0.00
2024-12-08 17:14:56,101,5237,44,57,3242.65,6386.01,0.00
2024-12-08 17:14:56,100,5237,43,57,3256.59,6386.10,0.00
2024-12-08 17:14:56,100,5238,43,57,3245.26,6387.00,0.00
2024-12-08 17:14:56,101,5238,44,57,3213.13,6387.01,0.00
2024-12-08 17:14:57,100,5238,44,56,3203.83,6387.40,0.00
2024-12-08 17:14:57,100,5239,44,56,3213.68,6388.00,0.00
2024-12-08 17:14:57,101,5239,45,56,3181.86,6388.01,0.00
2024-12-08 17:14:57,100,5239,45,55,3209.23,6388.07,0.00
2024-12-08 17:14:57,100,5240,45,55,3193.20,6389.00,0.00
2024-12-08 17:14:57,101,5240,46,55,3161.59,6389.01,0.00
2024-12-08 17:14:57,100,5240,46,54,3178.53,6389.08,0.00
2024-12-08 17:14:57,99,5240,45,54,3206.62,6389.14,0.00
2024-12-08 17:14:57,99,5241,45,54,3195.47,6390.00,0.00
2024-12-08 17:14:57,100,5241,45,55,3163.52,6390.01,0.00
2024-12-08 17:14:57,100,5242,45,55,3132.43,6391.00,0.00
2024-12-08 17:14:57,101,5242,45,56,3101.41,6391.01,0.00
2024-12-08 17:14:57,100,5242,45,55,3120.94,6391.08,0.00
2024-12-08 17:14:57,99,5242,44,55,3123.66,6391.42,0.00
2024-12-08 17:14:57,100,5241,45,55,3087.35,6391.52,0.00
2024-12-08 17:14:57,100,5242,45,55,3122.03,6392.00,0.00
2024-12-08 17:14:57,101,5242,46,55,3091.12,6392.01,0.00
2024-12-08 17:14:57,100,5242,46,54,3108.62,6392.08,0.00
2024-12-08 17:14:57,99,5242,45,54,3136.80,6392.12,0.00
2024-12-08 17:14:57,99,5243,45,54,3195.47,6393.00,0.00
2024-12-08 17:14:57,100,5243,45,55,3163.51,6393.01,0.00
2024-12-08 17:14:57,99,5243,45,54,3168.36,6393.08,0.00
2024-12-08 17:14:57,98,5243,44,54,3198.86,6393.10,0.00
2024-12-08 17:14:57,98,5244,44,54,3206.35,6394.00,0.00
2024-12-08 17:14:57,99,5244,44,55,3173.96,6394.01,0.00
2024-12-08 17:14:57,98,5244,44,54,3192.01,6394.08,0.00
2024-12-08 17:14:57,97,5244,43,54,3207.21,6394.34,0.00
2024-12-08 17:14:57,97,5245,43,54,3218.18,6395.00,0.00
2024-12-08 17:14:57,98,5245,43,55,3185.34,6395.01,0.00
2024-12-08 17:14:57,98,5246,43,55,3161.61,6396.00,0.00
2024-12-08 17:14:57,99,5246,43,56,3129.67,6396.01,0.00
2024-12-08 17:14:57,98,5246,42,56,3160.96,6396.01,0.00
2024-12-08 17:14:57,97,5246,42,55,3168.24,6396.07,0.00
2024-12-08 17:14:57,96,5246,42,54,3186.76,6396.29,0.00
2024-12-08 17:14:57,96,5247,42,54,3205.12,6397.00,0.00
2024-12-08 17:14:57,97,5247,42,55,3172.08,6397.01,0.00
2024-12-08 17:14:57,96,5247,41,55,3201.80,6397.05,0.00
2024-12-08 17:14:57,95,5247,41,54,3207.25,6397.28,0.00
2024-12-08 17:14:57,95,5248,41,54,3209.10,6398.00,0.00
2024-12-08 17:14:57,96,5248,41,55,3175.67,6398.01,0.00
2024-12-08 17:14:57,96,5249,41,55,3142.95,6399.00,0.00
2024-12-08 17:14:57,97,5249,41,56,3110.55,6399.01,0.00
2024-12-08 17:14:57,97,5250,41,56,3074.73,6400.00,0.00
2024-12-08 17:14:57,98,5250,42,56,3043.36,6400.01,0.00
2024-12-08 17:14:57,97,5250,42,55,3066.83,6400.07,0.00
2024-12-08 17:14:57,96,5250,41,55,3028.37,6400.87,0.00
2024-12-08 17:14:57,96,5251,41,55,3086.50,6401.00,0.00
2024-12-08 17:14:57,97,5251,42,55,3054.68,6401.01,0.00
2024-12-08 17:14:57,96,5251,42,54,3079.15,6401.07,0.00
2024-12-08 17:14:57,95,5251,41,54,3087.35,6401.28,0.00
2024-12-08 17:14:57,95,5252,41,54,3090.36,6402.00,0.00
2024-12-08 17:14:57,96,5252,42,54,3058.17,6402.01,0.00
2024-12-08 17:14:57,95,5252,42,53,3076.89,6402.07,0.00
2024-12-08 17:14:57,94,5252,41,53,3082.42,6402.30,0.00
2024-12-08 17:14:57,95,5251,42,53,3044.93,6402.38,0.00
2024-12-08 17:14:57,95,5252,42,53,3084.71,6403.00,0.00
2024-12-08 17:14:57,96,5252,42,54,3052.58,6403.01,0.00
2024-12-08 17:14:57,95,5252,41,54,3081.35,6403.05,0.00
2024-12-08 17:14:57,94,5252,41,53,3104.42,6403.06,0.00
2024-12-08 17:14:57,93,5252,40,53,3061.63,6403.79,0.00
2024-12-08 17:14:57,93,5253,40,53,3162.84,6404.00,0.00
2024-12-08 17:14:57,94,5253,41,53,3129.19,6404.01,0.00
2024-12-08 17:14:57,93,5253,41,52,3150.45,6404.06,0.00
2024-12-08 17:14:57,92,5253,40,52,3136.69,6404.52,0.00
2024-12-08 17:14:57,92,5254,40,52,3151.63,6405.00,0.00
2024-12-08 17:14:57,93,5254,40,53,3117.75,6405.01,0.00
2024-12-08 17:14:57,92,5254,40,52,3139.11,6405.07,0.00
2024-12-08 17:14:58,91,5254,39,52,3144.05,6405.31,0.00
2024-12-08 17:14:58,90,5254,39,51,3156.71,6405.40,0.00
2024-12-08 17:14:58,90,5255,39,51,3176.63,6406.00,0.00
2024-12-08 17:14:58,91,5255,40,51,3141.73,6406.01,0.00
2024-12-08 17:14:58,90,5255,40,50,3149.20,6406.08,0.00
2024-12-08 17:14:58,89,5255,39,50,3180.28,6406.15,0.00
2024-12-08 17:14:58,89,5256,39,50,3173.44,6407.00,0.00
2024-12-08 17:14:58,90,5256,39,51,3138.18,6407.01,0.00
2024-12-08 17:14:58,89,5256,38,51,3172.72,6407.01,0.00
2024-12-08 17:14:58,88,5256,38,50,3193.49,6407.08,0.00
2024-12-08 17:14:58,87,5256,37,50,3218.43,6407.18,0.00
2024-12-08 17:14:58,87,5257,37,50,3215.42,6408.00,0.00
2024-12-08 17:14:58,88,5257,38,50,3178.89,6408.01,0.00
2024-12-08 17:14:58,87,5257,38,49,3200.70,6408.08,0.00
2024-12-08 17:14:58,86,5257,37,49,3231.97,6408.16,0.00
2024-12-08 17:14:58,85,5257,37,48,3257.69,6408.26,0.00
2024-12-08 17:14:58,85,5258,37,48,3258.14,6409.00,0.00
2024-12-08 17:14:58,86,5258,38,48,3220.26,6409.01,0.00
2024-12-08 17:14:58,85,5258,38,47,3235.54,6409.14,0.00
2024-12-08 17:14:58,85,5259,38,47,3228.67,6410.00,0.00
2024-12-08 17:14:58,86,5259,38,48,3191.12,6410.01,0.00
2024-12-08 17:14:58,85,5259,37,48,3225.70,6410.05,0.00
2024-12-08 17:14:58,84,5259,37,47,3245.04,6410.13,0.00
2024-12-08 17:14:58,83,5259,36,47,3254.42,6410.41,0.00
2024-12-08 17:14:58,82,5259,35,47,3254.42,6410.92,0.00
2024-12-08 17:14:58,82,5260,35,47,3327.20,6411.00,0.00
2024-12-08 17:14:58,83,5260,36,47,3287.12,6411.01,0.00
2024-12-08 17:14:58,82,5260,35,47,3269.29,6411.45,0.00
2024-12-08 17:14:58,82,5261,35,47,3308.81,6412.00,0.00
2024-12-08 17:14:58,83,5261,36,47,3268.94,6412.01,0.00
2024-12-08 17:14:58,82,5261,36,46,3297.88,6412.13,0.00
2024-12-08 17:14:58,82,5262,36,46,3299.81,6413.00,0.00
2024-12-08 17:14:58,83,5262,37,46,3260.05,6413.01,0.00
2024-12-08 17:14:58,82,5262,36,46,3291.88,6413.13,0.00
2024-12-08 17:14:58,82,5263,36,46,3277.32,6414.00,0.00
2024-12-08 17:14:58,83,5263,37,46,3237.84,6414.01,0.00
2024-12-08 17:14:58,82,5263,37,45,3264.82,6414.13,0.00
2024-12-08 17:14:58,81,5263,37,44,3289.42,6414.37,0.00
2024-12-08 17:14:58,81,5264,37,44,3307.80,6415.00,0.00
2024-12-08 17:14:58,82,5264,38,44,3267.46,6415.01,0.00
2024-12-08 17:14:58,81,5264,37,44,3304.93,6415.05,0.00
2024-12-08 17:14:58,80,5264,36,44,3316.62,6415.26,0.00
2024-12-08 17:14:58,80,5265,36,44,3328.54,6416.00,0.00
2024-12-08 17:14:58,81,5265,37,44,3287.44,6416.01,0.00
2024-12-08 17:14:58,80,5265,37,43,3316.52,6416.13,0.00
2024-12-08 17:14:58,80,5266,37,43,3316.67,6417.00,0.00
2024-12-08 17:14:58,81,5266,37,44,3275.72,6417.01,0.00
2024-12-08 17:14:58,80,5266,36,44,3306.24,6417.01,0.00
2024-12-08 17:14:58,79,5266,35,44,3316.45,6417.25,0.00
2024-12-08 17:14:58,79,5267,35,44,3342.22,6418.00,0.00
2024-12-08 17:14:58,80,5267,36,44,3300.45,6418.01,0.00
2024-12-08 17:14:58,79,5267,35,44,3341.41,6418.01,0.00
2024-12-08 17:14:58,79,5268,35,44,3322.79,6419.00,0.00
2024-12-08 17:14:58,80,5268,36,44,3281.25,6419.01,0.00
2024-12-08 17:14:58,79,5268,36,43,3299.23,6419.11,0.00
2024-12-08 17:14:58,78,5268,35,43,3305.47,6419.65,0.00
2024-12-08 17:14:58,78,5269,35,43,3348.84,6420.00,0.00
2024-12-08 17:14:58,79,5269,36,43,3306.45,6420.01,0.00
2024-12-08 17:14:58,79,5270,36,43,3292.03,6421.00,0.00
2024-12-08 17:14:58,80,5270,36,44,3250.88,6421.01,0.00
2024-12-08 17:14:58,79,5270,35,44,3290.41,6421.03,0.00
2024-12-08 17:14:58,78,5270,35,43,3324.37,6421.10,0.00
2024-12-08 17:14:58,78,5271,35,43,3333.11,6422.00,0.00
2024-12-08 17:14:58,79,5271,35,44,3290.92,6422.01,0.00
2024-12-08 17:14:58,78,5271,35,43,3331.47,6422.03,0.00
2024-12-08 17:14:58,77,5271,34,43,3342.22,6422.16,0.00
2024-12-08 17:14:58,77,5272,34,43,3371.92,6423.00,0.00
2024-12-08 17:14:58,78,5272,34,44,3328.69,6423.01,0.00
2024-12-08 17:14:58,77,5272,33,44,3370.25,6423.03,0.00
2024-12-08 17:14:58,76,5272,33,43,3404.46,6423.11,0.00
2024-12-08 17:14:59,76,5273,33,43,3415.13,6424.00,0.00
2024-12-08 17:14:59,77,5273,34,43,3370.78,6424.01,0.00
2024-12-08 17:14:59,76,5273,34,42,3413.44,6424.03,0.00
2024-12-08 17:14:59,75,5273,33,42,3427.30,6424.23,0.00
2024-12-08 17:14:59,75,5274,33,42,3463.77,6425.00,0.00
2024-12-08 17:14:59,76,5274,33,43,3418.20,6425.01,0.00
2024-12-08 17:14:59,75,5274,32,43,3462.92,6425.01,0.00
2024-12-08 17:14:59,74,5274,32,42,3508.84,6425.01,0.00
2024-12-08 17:14:59,73,5274,32,41,3549.87,6425.07,0.00
2024-12-08 17:14:59,73,5275,32,41,3560.99,6426.00,0.00
2024-12-08 17:14:59,74,5275,32,42,3512.86,6426.01,0.00
2024-12-08 17:14:59,73,5275,32,41,3560.10,6426.01,0.00
2024-12-08 17:14:59,72,5275,31,41,3608.10,6426.03,0.00
2024-12-08 17:14:59,72,5276,31,41,3599.73,6427.00,0.00
2024-12-08 17:14:59,73,5276,32,41,3550.42,6427.01,0.00
2024-12-08 17:14:59,72,5276,31,41,3597.95,6427.03,0.00
2024-12-08 17:14:59,71,5276,31,40,3638.67,6427.06,0.00
2024-12-08 17:14:59,71,5277,31,40,3651.00,6428.00,0.00
2024-12-08 17:14:59,72,5277,32,40,3600.29,6428.01,0.00
2024-12-08 17:14:59,72,5278,32,40,3591.03,6429.00,0.00
2024-12-08 17:14:59,73,5278,33,40,3541.84,6429.01,0.00
2024-12-08 17:14:59,72,5278,33,39,3581.21,6429.06,0.00
2024-12-08 17:14:59,71,5278,32,39,3567.82,6429.89,0.00
2024-12-08 17:14:59,71,5279,32,39,3651.23,6430.00,0.00
2024-12-08 17:14:59,72,5279,33,39,3600.52,6430.01,0.00
2024-12-08 17:14:59,71,5279,32,39,3645.80,6430.04,0.00
2024-12-08 17:14:59,71,5280,32,39,3657.23,6431.00,0.00
2024-12-08 17:14:59,72,5280,32,40,3606.44,6431.01,0.00
2024-12-08 17:14:59,71,5280,32,39,3649.08,6431.04,0.00
2024-12-08 17:14:59,71,5281,32,39,3660.52,6432.00,0.00
2024-12-08 17:14:59,72,5281,32,40,3609.68,6432.01,0.00
2024-12-08 17:14:59,72,5282,32,40,3600.41,6433.00,0.00
2024-12-08 17:14:59,73,5282,32,41,3551.09,6433.01,0.00
2024-12-08 17:14:59,72,5282,32,40,3593.27,6433.04,0.00
2024-12-08 17:14:59,72,5283,32,40,3603.65,6434.00,0.00
2024-12-08 17:14:59,73,5283,32,41,3554.29,6434.01,0.00
2024-12-08 17:14:59,74,5282,33,41,3458.61,6434.51,0.00
2024-12-08 17:14:59,74,5283,33,41,3534.78,6435.00,0.00
2024-12-08 17:14:59,75,5283,33,42,3487.65,6435.01,0.00
2024-12-08 17:14:59,74,5283,33,41,3527.82,6435.04,0.00
2024-12-08 17:14:59,74,5284,33,41,3623.17,6436.00,0.00
2024-12-08 17:14:59,75,5284,34,41,3574.86,6436.01,0.00
2024-12-08 17:14:59,74,5284,33,41,3593.65,6436.19,0.00
2024-12-08 17:14:59,75,5283,33,42,3502.17,6436.63,0.00
2024-12-08 17:14:59,75,5284,33,42,3588.29,6437.00,0.00
2024-12-08 17:14:59,76,5284,33,43,3541.07,6437.01,0.00
2024-12-08 17:14:59,75,5284,33,42,3582.28,6437.04,0.00
2024-12-08 17:14:59,75,5285,33,42,3675.55,6438.00,0.00
2024-12-08 17:14:59,76,5285,34,42,3627.18,6438.01,0.00
2024-12-08 17:14:59,76,5286,34,42,3615.04,6439.00,0.00
2024-12-08 17:14:59,77,5286,34,43,3568.09,6439.01,0.00
2024-12-08 17:14:59,76,5286,34,42,3607.41,6439.04,0.00
2024-12-08 17:14:59,77,5285,35,42,3530.65,6439.53,0.00
2024-12-08 17:14:59,77,5286,35,42,3547.36,6440.00,0.00
2024-12-08 17:14:59,78,5286,35,43,3501.88,6440.01,0.00
2024-12-08 17:14:59,77,5286,35,42,3447.71,6440.74,0.00
2024-12-08 17:14:59,77,5287,35,42,3598.47,6441.00,0.00
2024-12-08 17:14:59,78,5287,36,42,3552.34,6441.01,0.00
2024-12-08 17:14:59,77,5287,36,41,3591.78,6441.04,0.00
2024-12-08 17:14:59,77,5288,36,41,3597.36,6442.00,0.00
2024-12-08 17:14:59,78,5288,37,41,3551.24,6442.01,0.00
2024-12-08 17:14:59,77,5288,36,41,3596.52,6442.01,0.00
2024-12-08 17:14:59,77,5289,36,41,3583.69,6443.00,0.00
2024-12-08 17:14:59,78,5289,37,41,3537.75,6443.01,0.00
2024-12-08 17:14:59,77,5289,37,40,3577.84,6443.03,0.00
2024-12-08 17:14:59,76,5289,36,40,3613.05,6443.21,0.00
2024-12-08 17:15:00,76,5290,36,40,3630.51,6444.00,0.00
2024-12-08 17:15:00,77,5290,36,41,3583.36,6444.01,0.00
2024-12-08 17:15:00,77,5291,36,41,3569.63,6445.00,0.00
2024-12-08 17:15:00,78,5291,36,42,3523.87,6445.01,0.00
2024-12-08 17:15:00,77,5291,36,41,3564.61,6445.03,0.00
2024-12-08 17:15:00,76,5291,35,41,3589.47,6445.26,0.00
2024-12-08 17:15:00,76,5292,35,41,3627.28,6446.00,0.00
2024-12-08 17:15:00,77,5292,36,41,3580.17,6446.01,0.00
2024-12-08 17:15:00,76,5292,35,41,3592.23,6446.22,0.00
2024-12-08 17:15:00,77,5291,35,42,3545.57,6446.25,0.00
2024-12-08 17:15:00,77,5292,35,42,3613.89,6447.00,0.00
2024-12-08 17:15:00,78,5292,35,43,3567.56,6447.01,0.00
2024-12-08 17:15:00,77,5292,35,42,3602.10,6447.04,0.00
2024-12-08 17:15:00,77,5293,35,42,3691.42,6448.00,0.00
2024-12-08 17:15:00,78,5293,35,43,3644.09,6448.01,0.00
2024-12-08 17:15:00,79,5292,35,44,3509.77,6448.89,0.00
2024-12-08 17:15:00,79,5293,35,44,3607.01,6449.00,0.00
2024-12-08 17:15:00,80,5293,36,44,3561.92,6449.01,0.00
2024-12-08 17:15:00,79,5293,36,43,3606.20,6449.01,0.00
2024-12-08 17:15:00,78,5293,36,42,3644.99,6449.05,0.00
2024-12-08 17:15:00,78,5294,36,42,3733.21,6450.00,0.00
2024-12-08 17:15:00,79,5294,37,42,3685.95,6450.01,0.00
2024-12-08 17:15:00,79,5295,37,42,3671.82,6451.00,0.00
2024-12-08 17:15:00,80,5295,38,42,3625.93,6451.01,0.00
2024-12-08 17:15:00,79,5295,38,41,3665.29,6451.05,0.00
2024-12-08 17:15:00,79,5296,38,41,3669.94,6452.00,0.00
2024-12-08 17:15:00,80,5296,38,42,3624.07,6452.01,0.00
2024-12-08 17:15:00,79,5296,38,41,3669.36,6452.01,0.00
2024-12-08 17:15:00,80,5295,39,41,3594.51,6452.24,0.00
2024-12-08 17:15:00,79,5295,38,41,3673.61,6452.46,0.00
2024-12-08 17:15:00,79,5296,38,41,3720.57,6453.00,0.00
2024-12-08 17:15:00,80,5296,39,41,3674.06,6453.01,0.00
2024-12-08 17:15:00,79,5296,39,40,3714.85,6453.04,0.00
2024-12-08 17:15:00,79,5297,39,40,3800.39,6454.00,0.00
2024-12-08 17:15:00,80,5297,40,40,3752.89,6454.01,0.00
2024-12-08 17:15:00,79,5297,39,40,3799.58,6454.03,0.00
2024-12-08 17:15:00,79,5298,39,40,3786.27,6455.00,0.00
2024-12-08 17:15:00,80,5298,39,41,3738.94,6455.01,0.00
2024-12-08 17:15:00,79,5298,39,40,3782.19,6455.03,0.00
2024-12-08 17:15:00,78,5298,38,40,3806.78,6455.30,0.00
2024-12-08 17:15:00,78,5299,38,40,3844.51,6456.00,0.00
2024-12-08 17:15:00,79,5299,38,41,3795.85,6456.01,0.00
2024-12-08 17:15:00,79,5300,38,41,3781.72,6457.00,0.00
2024-12-08 17:15:00,80,5300,38,42,3734.45,6457.01,0.00
2024-12-08 17:15:00,79,5300,38,41,3777.64,6457.04,0.00
2024-12-08 17:15:00,79,5301,38,41,3781.49,6458.00,0.00
2024-12-08 17:15:00,80,5301,38,42,3734.22,6458.01,0.00
2024-12-08 17:15:00,80,5302,38,42,3719.46,6459.00,0.00
2024-12-08 17:15:00,81,5302,39,42,3673.54,6459.01,0.00
2024-12-08 17:15:00,80,5302,39,41,3713.82,6459.06,0.00
2024-12-08 17:15:00,80,5303,39,41,3718.42,6460.00,0.00
2024-12-08 17:15:00,81,5303,39,42,3672.51,6460.01,0.00
2024-12-08 17:15:00,80,5303,39,41,3703.51,6460.06,0.00
2024-12-08 17:15:00,79,5303,38,41,3739.01,6460.23,0.00
2024-12-08 17:15:00,80,5302,38,42,3655.28,6460.58,0.00
2024-12-08 17:15:00,80,5303,38,42,3731.53,6461.00,0.00
2024-12-08 17:15:00,81,5303,39,42,3685.46,6461.01,0.00
2024-12-08 17:15:00,81,5304,39,42,3749.86,6462.00,0.00
2024-12-08 17:15:00,82,5304,39,43,3704.13,6462.01,0.00
2024-12-08 17:15:00,83,5303,39,44,3622.25,6462.37,0.00
2024-12-08 17:15:01,83,5304,39,44,3696.66,6463.00,0.00
2024-12-08 17:15:01,84,5304,39,45,3652.65,6463.01,0.00
2024-12-08 17:15:01,83,5304,38,45,3634.66,6463.66,0.00
2024-12-08 17:15:01,83,5305,38,45,3768.88,6464.00,0.00
2024-12-08 17:15:01,84,5305,38,46,3724.02,6464.01,0.00
2024-12-08 17:15:01,84,5306,38,46,3706.89,6465.00,0.00
2024-12-08 17:15:01,85,5306,39,46,3663.28,6465.01,0.00
2024-12-08 17:15:01,84,5306,39,45,3701.51,6465.07,0.00
2024-12-08 17:15:01,84,5307,39,45,3703.61,6466.00,0.00
2024-12-08 17:15:01,85,5307,40,45,3660.04,6466.01,0.00
2024-12-08 17:15:01,85,5308,40,45,3642.35,6467.00,0.00
2024-12-08 17:15:01,86,5308,40,46,3599.99,6467.01,0.00
2024-12-08 17:15:01,85,5308,40,45,3634.75,6467.08,0.00
2024-12-08 17:15:01,84,5308,39,45,3653.53,6467.45,0.00
2024-12-08 17:15:01,84,5309,39,45,3680.12,6468.00,0.00
2024-12-08 17:15:01,85,5309,39,46,3636.82,6468.01,0.00
2024-12-08 17:15:01,84,5309,38,46,3675.51,6468.07,0.00
2024-12-08 17:15:01,84,5310,38,46,3662.21,6469.00,0.00
2024-12-08 17:15:01,85,5310,39,46,3619.12,6469.01,0.00
2024-12-08 17:15:01,84,5310,39,45,3656.05,6469.07,0.00
2024-12-08 17:15:01,83,5310,38,45,3673.66,6469.24,0.00
2024-12-08 17:15:01,84,5309,38,46,3605.48,6469.64,0.00
2024-12-08 17:15:01,84,5310,38,46,3678.95,6470.00,0.00
2024-12-08 17:15:01,85,5310,39,46,3635.67,6470.01,0.00
2024-12-08 17:15:01,85,5311,39,46,3694.08,6471.00,0.00
2024-12-08 17:15:01,86,5311,39,47,3651.13,6471.01,0.00
2024-12-08 17:15:01,87,5310,39,48,3555.86,6471.63,0.00
2024-12-08 17:15:01,87,5311,39,48,3611.21,6472.00,0.00
2024-12-08 17:15:01,88,5311,39,49,3570.17,6472.01,0.00
2024-12-08 17:15:01,87,5311,38,49,3610.47,6472.01,0.00
2024-12-08 17:15:01,86,5311,37,49,3648.69,6472.06,0.00
2024-12-08 17:15:01,86,5312,37,49,3708.71,6473.00,0.00
2024-12-08 17:15:01,87,5312,38,49,3666.08,6473.01,0.00
2024-12-08 17:15:01,86,5312,38,48,3690.65,6473.06,0.00
2024-12-08 17:15:01,85,5312,37,48,3676.52,6473.72,0.00
2024-12-08 17:15:01,85,5313,37,48,3734.64,6474.00,0.00
2024-12-08 17:15:01,86,5313,38,48,3691.22,6474.01,0.00
2024-12-08 17:15:01,85,5313,38,47,3715.60,6474.06,0.00
2024-12-08 17:15:01,84,5313,37,47,3749.10,6474.23,0.00
2024-12-08 17:15:01,84,5314,37,47,3761.19,6475.00,0.00
2024-12-08 17:15:01,85,5314,38,47,3716.94,6475.01,0.00
2024-12-08 17:15:01,84,5314,38,46,3741.92,6475.06,0.00
2024-12-08 17:15:01,84,5315,38,46,3743.26,6476.00,0.00
2024-12-08 17:15:01,85,5315,38,47,3699.22,6476.01,0.00
2024-12-08 17:15:01,86,5314,38,48,3629.14,6476.22,0.00
2024-12-08 17:15:01,87,5313,39,48,3610.70,6476.61,0.00
2024-12-08 17:15:01,87,5314,39,48,3666.86,6477.00,0.00
2024-12-08 17:15:01,88,5314,39,49,3625.19,6477.01,0.00
2024-12-08 17:15:01,87,5314,38,49,3666.45,6477.01,0.00
2024-12-08 17:15:01,86,5314,37,49,3667.06,6477.43,0.00
2024-12-08 17:15:01,86,5315,37,49,3841.47,6478.00,0.00
2024-12-08 17:15:01,87,5315,37,50,3797.32,6478.01,0.00
2024-12-08 17:15:01,86,5315,37,49,3826.41,6478.05,0.00
2024-12-08 17:15:01,86,5316,37,49,3782.08,6479.00,0.00
2024-12-08 17:15:01,87,5316,37,50,3738.61,6479.01,0.00
2024-12-08 17:15:01,86,5316,36,50,3781.33,6479.01,0.00
2024-12-08 17:15:01,85,5316,36,49,3809.81,6479.04,0.00
2024-12-08 17:15:01,86,5315,37,49,3760.25,6479.14,0.00
2024-12-08 17:15:01,85,5315,36,49,3829.69,6479.24,0.00
2024-12-08 17:15:01,84,5315,36,48,3782.16,6479.96,0.00
2024-12-08 17:15:01,84,5316,36,48,3857.01,6480.00,0.00
2024-12-08 17:15:01,85,5316,36,49,3811.63,6480.01,0.00
2024-12-08 17:15:01,84,5316,35,49,3856.37,6480.01,0.00
2024-12-08 17:15:01,83,5316,35,48,3887.22,6480.02,0.00
2024-12-08 17:15:01,83,5317,35,48,3965.12,6481.00,0.00
2024-12-08 17:15:01,84,5317,35,49,3917.92,6481.01,0.00
2024-12-08 17:15:01,83,5317,35,48,3949.50,6481.02,0.00
2024-12-08 17:15:01,82,5317,34,48,3996.88,6481.02,0.00
2024-12-08 17:15:01,82,5318,34,48,3997.50,6482.00,0.00
2024-12-08 17:15:01,83,5318,34,49,3949.33,6482.01,0.00
2024-12-08 17:15:02,83,5319,34,49,3889.52,6483.00,0.00
2024-12-08 17:15:02,84,5319,34,50,3843.22,6483.01,0.00
2024-12-08 17:15:02,84,5320,34,50,3826.06,6484.00,0.00
2024-12-08 17:15:02,85,5320,34,51,3781.04,6484.01,0.00
2024-12-08 17:15:02,84,5320,34,50,3825.29,6484.01,0.00
2024-12-08 17:15:02,83,5320,34,49,3858.87,6484.01,0.00
2024-12-08 17:15:02,83,5321,34,49,3857.91,6485.00,0.00
2024-12-08 17:15:02,84,5321,34,50,3811.98,6485.01,0.00
2024-12-08 17:15:02,83,5321,33,50,3857.91,6485.01,0.00
2024-12-08 17:15:02,82,5321,33,49,3888.35,6485.01,0.00
2024-12-08 17:15:02,81,5321,32,49,3903.83,6485.06,0.00
2024-12-08 17:15:02,80,5321,31,49,3946.98,6485.15,0.00
2024-12-08 17:15:02,80,5322,31,49,3957.27,6486.00,0.00
2024-12-08 17:15:02,81,5322,32,49,3908.41,6486.01,0.00
2024-12-08 17:15:02,81,5323,32,49,3893.00,6487.00,0.00
2024-12-08 17:15:02,82,5323,33,49,3845.52,6487.01,0.00
2024-12-08 17:15:02,82,5324,33,49,3829.31,6488.00,0.00
2024-12-08 17:15:02,83,5324,33,50,3783.17,6488.01,0.00
2024-12-08 17:15:02,83,5325,33,50,3765.83,6489.00,0.00
2024-12-08 17:15:02,84,5325,34,50,3721.00,6489.01,0.00
2024-12-08 17:15:02,83,5325,33,50,3747.86,6489.04,0.00
2024-12-08 17:15:02,84,5324,34,50,3696.31,6489.17,0.00
2024-12-08 17:15:02,84,5325,34,50,3750.85,6490.00,0.00
2024-12-08 17:15:02,85,5325,34,51,3706.72,6490.01,0.00
2024-12-08 17:15:02,84,5325,34,50,3742.35,6490.02,0.00
2024-12-08 17:15:02,84,5326,34,50,3816.20,6491.00,0.00
2024-12-08 17:15:02,85,5326,34,51,3771.30,6491.01,0.00
2024-12-08 17:15:02,84,5326,34,50,3799.98,6491.02,0.00
2024-12-08 17:15:02,84,5327,34,50,3795.92,6492.00,0.00
2024-12-08 17:15:02,85,5327,34,51,3751.26,6492.01,0.00
2024-12-08 17:15:02,85,5328,34,51,3730.09,6493.00,0.00
2024-12-08 17:15:02,86,5328,35,51,3686.72,6493.01,0.00
2024-12-08 17:15:02,85,5328,35,50,3723.22,6493.06,0.00
2024-12-08 17:15:02,85,5329,35,50,3720.10,6494.00,0.00
2024-12-08 17:15:02,86,5329,36,50,3676.84,6494.01,0.00
2024-12-08 17:15:02,86,5330,36,50,3654.76,6495.00,0.00
2024-12-08 17:15:02,87,5330,37,50,3612.76,6495.01,0.00
2024-12-08 17:15:02,86,5330,37,49,3645.71,6495.07,0.00
2024-12-08 17:15:02,86,5331,37,49,3642.46,6496.00,0.00
2024-12-08 17:15:02,87,5331,37,50,3600.60,6496.01,0.00
2024-12-08 17:15:02,86,5331,36,50,3640.96,6496.04,0.00
2024-12-08 17:15:02,86,5332,36,50,3620.49,6497.00,0.00
2024-12-08 17:15:02,87,5332,37,50,3578.87,6497.01,0.00
2024-12-08 17:15:02,86,5332,37,49,3609.92,6497.07,0.00
2024-12-08 17:15:02,85,5332,36,49,3619.59,6497.48,0.00
2024-12-08 17:15:02,85,5333,36,49,3662.76,6498.00,0.00
2024-12-08 17:15:02,86,5333,36,50,3620.17,6498.01,0.00
2024-12-08 17:15:02,86,5334,36,50,3597.20,6499.00,0.00
2024-12-08 17:15:02,87,5334,36,51,3555.85,6499.01,0.00
2024-12-08 17:15:02,86,5334,35,51,3594.94,6499.05,0.00
2024-12-08 17:15:02,86,5335,35,51,3573.73,6500.00,0.00
2024-12-08 17:15:02,87,5335,35,52,3532.65,6500.01,0.00
2024-12-08 17:15:02,86,5335,35,51,3538.39,6500.31,0.00
2024-12-08 17:15:02,86,5336,35,51,3551.82,6501.00,0.00
2024-12-08 17:15:02,87,5336,36,51,3511.00,6501.01,0.00
2024-12-08 17:15:02,87,5337,36,51,3488.93,6502.00,0.00
2024-12-08 17:15:02,88,5337,36,52,3449.29,6502.01,0.00
2024-12-08 17:15:02,87,5337,36,51,3479.97,6502.06,0.00
2024-12-08 17:15:03,86,5337,35,51,3490.66,6502.47,0.00
2024-12-08 17:15:03,86,5338,35,51,3516.74,6503.00,0.00
2024-12-08 17:15:03,87,5338,36,51,3476.31,6503.01,0.00
2024-12-08 17:15:03,86,5338,35,51,3513.71,6503.01,0.00
2024-12-08 17:15:03,86,5339,35,51,3506.87,6504.00,0.00
2024-12-08 17:15:03,87,5339,35,52,3466.57,6504.01,0.00
2024-12-08 17:15:03,88,5338,35,53,3376.42,6504.53,0.00
2024-12-08 17:15:03,88,5339,35,53,3399.59,6505.00,0.00
2024-12-08 17:15:03,89,5339,36,53,3361.39,6505.01,0.00
2024-12-08 17:15:03,88,5339,36,52,3383.34,6505.08,0.00
2024-12-08 17:15:03,87,5339,36,51,3369.97,6505.33,0.00
2024-12-08 17:15:03,86,5339,36,50,3352.00,6505.74,0.00
2024-12-08 17:15:03,86,5340,36,50,3471.72,6506.00,0.00
2024-12-08 17:15:03,87,5340,37,50,3431.81,6506.01,0.00
2024-12-08 17:15:03,87,5341,37,50,3409.06,6507.00,0.00
2024-12-08 17:15:03,88,5341,37,51,3370.32,6507.01,0.00
2024-12-08 17:15:03,87,5341,37,50,3400.10,6507.08,0.00
2024-12-08 17:15:03,87,5342,37,50,3396.85,6508.00,0.00
2024-12-08 17:15:03,88,5342,38,50,3358.25,6508.01,0.00
2024-12-08 17:15:03,87,5342,37,50,3326.90,6508.78,0.00
2024-12-08 17:15:03,87,5343,37,50,3387.67,6509.00,0.00
2024-12-08 17:15:03,88,5343,37,51,3349.18,6509.01,0.00
2024-12-08 17:15:03,87,5343,36,51,3383.94,6509.06,0.00
2024-12-08 17:15:03,86,5343,36,50,3418.75,6509.07,0.00
2024-12-08 17:15:03,85,5343,35,50,3445.25,6509.27,0.00
2024-12-08 17:15:03,84,5343,35,49,3482.41,6509.33,0.00
2024-12-08 17:15:03,84,5344,35,49,3501.45,6510.00,0.00
2024-12-08 17:15:03,85,5344,35,50,3460.26,6510.01,0.00
2024-12-08 17:15:03,85,5345,35,50,3442.40,6511.00,0.00
2024-12-08 17:15:03,86,5345,35,51,3402.37,6511.01,0.00
2024-12-08 17:15:03,85,5345,34,51,3439.35,6511.06,0.00
2024-12-08 17:15:03,84,5345,34,50,3477.19,6511.06,0.00
2024-12-08 17:15:03,84,5346,34,50,3478.49,6512.00,0.00
2024-12-08 17:15:03,85,5346,34,51,3437.57,6512.01,0.00
2024-12-08 17:15:03,85,5347,34,51,3419.71,6513.00,0.00
2024-12-08 17:15:03,86,5347,35,51,3379.94,6513.01,0.00
2024-12-08 17:15:03,85,5347,35,50,3413.59,6513.07,0.00
2024-12-08 17:15:03,84,5347,34,50,3424.94,6513.51,0.00
2024-12-08 17:15:03,83,5347,33,50,3460.72,6513.55,0.00
2024-12-08 17:15:03,83,5348,33,50,3510.50,6514.00,0.00
2024-12-08 17:15:03,84,5348,33,51,3468.70,6514.01,0.00
2024-12-08 17:15:03,84,5349,33,51,3451.40,6515.00,0.00
2024-12-08 17:15:03,85,5349,33,52,3410.79,6515.01,0.00
2024-12-08 17:15:03,84,5349,33,51,3445.98,6515.07,0.00
2024-12-08 17:15:03,83,5349,32,51,3450.81,6515.58,0.00
2024-12-08 17:15:03,83,5350,32,51,3502.15,6516.00,0.00
2024-12-08 17:15:03,84,5350,33,51,3460.46,6516.01,0.00
2024-12-08 17:15:03,83,5350,32,51,3500.59,6516.02,0.00
2024-12-08 17:15:03,82,5350,31,51,3495.77,6516.51,0.00
2024-12-08 17:15:03,82,5351,31,51,3527.92,6517.00,0.00
2024-12-08 17:15:03,83,5351,32,51,3485.42,6517.01,0.00
2024-12-08 17:15:03,82,5351,32,50,3523.95,6517.06,0.00
2024-12-08 17:15:03,83,5350,32,51,3456.51,6517.47,0.00
2024-12-08 17:15:03,84,5349,33,51,3430.31,6517.80,0.00
2024-12-08 17:15:03,84,5350,33,51,3491.78,6518.00,0.00
2024-12-08 17:15:03,85,5350,34,51,3450.70,6518.01,0.00
2024-12-08 17:15:03,84,5350,33,51,3487.91,6518.06,0.00
2024-12-08 17:15:03,85,5349,34,51,3388.91,6518.74,0.00
2024-12-08 17:15:03,85,5350,34,51,3616.89,6519.00,0.00
2024-12-08 17:15:03,86,5350,34,52,3574.84,6519.01,0.00
2024-12-08 17:15:03,85,5350,34,51,3613.06,6519.06,0.00
2024-12-08 17:15:03,85,5351,34,51,3690.32,6520.00,0.00
2024-12-08 17:15:03,86,5351,35,51,3647.41,6520.01,0.00
2024-12-08 17:15:03,85,5351,35,50,3671.15,6520.06,0.00
2024-12-08 17:15:03,84,5351,34,50,3713.30,6520.06,0.00
2024-12-08 17:15:03,84,5352,34,50,3730.17,6521.00,0.00
2024-12-08 17:15:04,85,5352,34,51,3686.28,6521.01,0.00
2024-12-08 17:15:04,85,5353,34,51,3668.43,6522.00,0.00
2024-12-08 17:15:04,86,5353,34,52,3625.78,6522.01,0.00
2024-12-08 17:15:04,86,5354,34,52,3607.37,6523.00,0.00
2024-12-08 17:15:04,87,5354,34,53,3565.91,6523.01,0.00
2024-12-08 17:15:04,86,5354,34,52,3605.85,6523.02,0.00
2024-12-08 17:15:04,85,5354,33,52,3646.74,6523.05,0.00
2024-12-08 17:15:04,84,5354,33,51,3682.40,6523.06,0.00
2024-12-08 17:15:04,84,5355,33,51,3683.73,6524.00,0.00
2024-12-08 17:15:04,85,5355,33,52,3640.39,6524.01,0.00
2024-12-08 17:15:04,85,5356,33,52,3622.53,6525.00,0.00
2024-12-08 17:15:04,86,5356,33,53,3580.40,6525.01,0.00
2024-12-08 17:15:04,85,5356,33,52,3618.70,6525.06,0.00
2024-12-08 17:15:04,84,5356,32,52,3627.49,6525.38,0.00
2024-12-08 17:15:04,84,5357,32,52,3665.21,6526.00,0.00
2024-12-08 17:15:04,85,5357,32,53,3622.09,6526.01,0.00
2024-12-08 17:15:04,85,5358,32,53,3589.75,6527.00,0.00
2024-12-08 17:15:04,86,5358,32,54,3548.01,6527.01,0.00
2024-12-08 17:15:04,85,5358,31,54,3586.68,6527.06,0.00
2024-12-08 17:15:04,84,5358,31,53,3599.98,6527.18,0.00
2024-12-08 17:15:04,84,5359,31,53,3609.05,6528.00,0.00
2024-12-08 17:15:04,85,5359,31,54,3566.59,6528.01,0.00
2024-12-08 17:15:04,84,5359,30,54,3607.50,6528.02,0.00
2024-12-08 17:15:04,83,5359,30,53,3642.32,6528.05,0.00
2024-12-08 17:15:04,82,5359,29,53,3659.83,6528.46,0.00
2024-12-08 17:15:04,82,5360,29,53,3688.88,6529.00,0.00
2024-12-08 17:15:04,83,5360,30,53,3644.44,6529.01,0.00
2024-12-08 17:15:04,82,5360,30,52,3670.58,6529.05,0.00
2024-12-08 17:15:04,82,5361,30,52,3672.72,6530.00,0.00
2024-12-08 17:15:04,83,5361,31,52,3628.48,6530.01,0.00
2024-12-08 17:15:04,82,5361,31,51,3655.21,6530.05,0.00
2024-12-08 17:15:04,81,5361,30,51,3699.53,6530.05,0.00
2024-12-08 17:15:04,81,5362,30,51,3702.51,6531.00,0.00
2024-12-08 17:15:04,82,5362,30,52,3657.36,6531.01,0.00
2024-12-08 17:15:04,81,5362,29,52,3661.43,6531.20,0.00
2024-12-08 17:15:04,81,5363,29,52,3690.18,6532.00,0.00
2024-12-08 17:15:04,82,5363,30,52,3645.17,6532.01,0.00
2024-12-08 17:15:04,81,5363,30,51,3682.12,6532.09,0.00
2024-12-08 17:15:04,80,5363,29,51,3705.33,6532.21,0.00
2024-12-08 17:15:04,81,5362,30,51,3630.80,6532.68,0.00
2024-12-08 17:15:04,81,5363,30,51,3725.42,6533.00,0.00
2024-12-08 17:15:04,82,5363,30,52,3679.99,6533.01,0.00
2024-12-08 17:15:04,81,5363,29,52,3721.40,6533.06,0.00
2024-12-08 17:15:04,81,5364,29,52,3789.72,6534.00,0.00
2024-12-08 17:15:04,82,5364,29,53,3743.50,6534.01,0.00
2024-12-08 17:15:04,81,5364,28,53,3788.11,6534.03,0.00
2024-12-08 17:15:04,80,5364,28,52,3829.75,6534.06,0.00
2024-12-08 17:15:04,79,5364,27,52,3855.93,6534.19,0.00
2024-12-08 17:15:04,79,5365,27,52,3886.26,6535.00,0.00
2024-12-08 17:15:04,80,5365,28,52,3837.68,6535.01,0.00
2024-12-08 17:15:04,79,5365,27,52,3883.78,6535.05,0.00
2024-12-08 17:15:04,79,5366,27,52,3871.96,6536.00,0.00
2024-12-08 17:15:04,80,5366,28,52,3823.56,6536.01,0.00
2024-12-08 17:15:04,79,5366,28,51,3867.00,6536.05,0.00
2024-12-08 17:15:04,79,5367,28,51,3871.72,6537.00,0.00
2024-12-08 17:15:04,80,5367,28,52,3823.33,6537.01,0.00
2024-12-08 17:15:04,79,5367,27,52,3794.27,6537.70,0.00
2024-12-08 17:15:04,79,5368,27,52,3857.42,6538.00,0.00
2024-12-08 17:15:04,80,5368,27,53,3809.20,6538.01,0.00
2024-12-08 17:15:04,79,5368,27,52,3852.46,6538.05,0.00
2024-12-08 17:15:04,79,5369,27,52,3857.18,6539.00,0.00
2024-12-08 17:15:04,80,5369,28,52,3808.97,6539.01,0.00
2024-12-08 17:15:04,80,5370,28,52,3794.02,6540.00,0.00
2024-12-08 17:15:04,81,5370,28,53,3747.18,6540.01,0.00
2024-12-08 17:15:04,80,5370,28,52,3789.12,6540.05,0.00
2024-12-08 17:15:05,80,5371,28,52,3792.96,6541.00,0.00
2024-12-08 17:15:05,81,5371,28,53,3746.13,6541.01,0.00
2024-12-08 17:15:05,80,5371,27,53,3791.33,6541.01,0.00
2024-12-08 17:15:05,80,5372,27,53,3792.72,6542.00,0.00
2024-12-08 17:15:05,81,5372,27,54,3745.90,6542.01,0.00
2024-12-08 17:15:05,80,5372,27,53,3790.27,6542.04,0.00
2024-12-08 17:15:05,80,5373,27,53,3793.30,6543.00,0.00
2024-12-08 17:15:05,81,5373,27,54,3746.47,6543.01,0.00
2024-12-08 17:15:05,80,5373,27,53,3774.50,6543.04,0.00
2024-12-08 17:15:05,81,5372,27,54,3663.66,6543.80,0.00
2024-12-08 17:15:05,81,5373,27,54,3743.81,6544.00,0.00
2024-12-08 17:15:05,82,5373,27,55,3698.16,6544.01,0.00
2024-12-08 17:15:05,81,5373,27,54,3725.24,6544.04,0.00
2024-12-08 17:15:05,80,5373,26,54,3715.67,6544.69,0.00
2024-12-08 17:15:05,80,5374,26,54,3859.09,6545.00,0.00
2024-12-08 17:15:05,81,5374,27,54,3811.45,6545.01,0.00
2024-12-08 17:15:05,80,5374,26,54,3856.64,6545.04,0.00
2024-12-08 17:15:05,80,5375,26,54,3841.54,6546.00,0.00
2024-12-08 17:15:05,81,5375,27,54,3794.12,6546.01,0.00
2024-12-08 17:15:05,81,5376,27,54,3777.23,6547.00,0.00
2024-12-08 17:15:05,82,5376,28,54,3731.17,6547.01,0.00
2024-12-08 17:15:05,81,5376,28,53,3761.07,6547.04,0.00
2024-12-08 17:15:05,81,5377,28,53,3763.26,6548.00,0.00
2024-12-08 17:15:05,82,5377,29,53,3717.36,6548.01,0.00
2024-12-08 17:15:05,81,5377,29,52,3744.67,6548.04,0.00
2024-12-08 17:15:05,81,5378,29,52,3746.85,6549.00,0.00
2024-12-08 17:15:05,82,5378,30,52,3701.16,6549.01,0.00
2024-12-08 17:15:05,81,5378,30,51,3728.26,6549.04,0.00
2024-12-08 17:15:05,81,5379,30,51,3730.19,6550.00,0.00
2024-12-08 17:15:05,82,5379,30,52,3684.70,6550.01,0.00
2024-12-08 17:15:05,82,5380,30,52,3668.48,6551.00,0.00
2024-12-08 17:15:05,83,5380,30,53,3624.28,6551.01,0.00
2024-12-08 17:15:05,82,5380,29,53,3666.89,6551.02,0.00
2024-12-08 17:15:05,81,5380,29,52,3708.93,6551.05,0.00
2024-12-08 17:15:05,81,5381,29,52,3711.74,6552.00,0.00
2024-12-08 17:15:05,82,5381,29,53,3666.48,6552.01,0.00
2024-12-08 17:15:05,83,5380,29,54,3619.95,6552.07,0.00
2024-12-08 17:15:05,83,5381,29,54,3662.17,6553.00,0.00
2024-12-08 17:15:05,84,5381,30,54,3618.57,6553.01,0.00
2024-12-08 17:15:05,83,5381,30,53,3647.48,6553.08,0.00
2024-12-08 17:15:05,82,5381,29,53,3665.74,6553.48,0.00
2024-12-08 17:15:05,82,5382,29,53,3791.60,6554.00,0.00
2024-12-08 17:15:05,83,5382,29,54,3745.92,6554.01,0.00
2024-12-08 17:15:05,83,5383,29,54,3726.62,6555.00,0.00
2024-12-08 17:15:05,84,5383,29,55,3682.25,6555.01,0.00
2024-12-08 17:15:05,83,5383,29,54,3717.17,6555.08,0.00
2024-12-08 17:15:05,82,5383,28,54,3753.75,6555.22,0.00
2024-12-08 17:15:05,82,5384,28,54,3783.03,6556.00,0.00
2024-12-08 17:15:05,83,5384,29,54,3737.45,6556.01,0.00
2024-12-08 17:15:05,83,5385,29,54,3720.65,6557.00,0.00
2024-12-08 17:15:05,84,5385,30,54,3676.35,6557.01,0.00
2024-12-08 17:15:05,83,5385,30,53,3710.40,6557.10,0.00
2024-12-08 17:15:05,83,5386,30,53,3714.89,6558.00,0.00
2024-12-08 17:15:05,84,5386,31,53,3670.67,6558.01,0.00
2024-12-08 17:15:05,84,5387,31,53,3653.27,6559.00,0.00
2024-12-08 17:15:05,85,5387,32,53,3610.29,6559.01,0.00
2024-12-08 17:15:05,84,5387,32,52,3641.58,6559.11,0.00
2024-12-08 17:15:05,83,5387,31,52,3661.11,6559.48,0.00
2024-12-08 17:15:06,83,5388,31,52,3690.73,6560.00,0.00
2024-12-08 17:15:06,84,5388,31,53,3646.80,6560.01,0.00
2024-12-08 17:15:06,83,5388,30,53,3612.03,6560.74,0.00
2024-12-08 17:15:06,83,5389,30,53,3673.90,6561.00,0.00
2024-12-08 17:15:06,84,5389,31,53,3630.17,6561.01,0.00
2024-12-08 17:15:06,83,5389,31,52,3660.50,6561.12,0.00
2024-12-08 17:15:06,82,5389,30,52,3697.94,6561.12,0.00
2024-12-08 17:15:06,82,5390,30,52,3720.88,6562.00,0.00
2024-12-08 17:15:06,83,5390,30,53,3676.05,6562.01,0.00
2024-12-08 17:15:06,83,5391,30,53,3659.21,6563.00,0.00
2024-12-08 17:15:06,84,5391,30,54,3615.65,6563.01,0.00
2024-12-08 17:15:06,83,5391,29,54,3649.75,6563.11,0.00
2024-12-08 17:15:06,82,5391,29,53,3687.85,6563.11,0.00
2024-12-08 17:15:06,82,5392,29,53,3710.00,6564.00,0.00
2024-12-08 17:15:06,83,5392,29,54,3665.30,6564.01,0.00
2024-12-08 17:15:06,82,5392,29,53,3705.65,6564.07,0.00
2024-12-08 17:15:06,81,5392,28,53,3723.07,6564.23,0.00
2024-12-08 17:15:06,81,5393,28,53,3738.16,6565.00,0.00
2024-12-08 17:15:06,82,5393,28,54,3692.57,6565.01,0.00
2024-12-08 17:15:06,81,5393,28,53,3723.09,6565.11,0.00
2024-12-08 17:15:06,80,5393,27,53,3759.82,6565.25,0.00
2024-12-08 17:15:06,80,5394,27,53,3776.74,6566.00,0.00
2024-12-08 17:15:06,81,5394,27,54,3730.11,6566.01,0.00
2024-12-08 17:15:06,80,5394,26,54,3740.57,6566.15,0.00
2024-12-08 17:15:06,80,5395,26,54,3767.38,6567.00,0.00
2024-12-08 17:15:06,81,5395,27,54,3720.87,6567.01,0.00
2024-12-08 17:15:06,80,5395,27,53,3750.99,6567.14,0.00
2024-12-08 17:15:06,79,5395,26,53,3776.06,6567.23,0.00
2024-12-08 17:15:06,79,5396,26,53,3809.00,6568.00,0.00
2024-12-08 17:15:06,80,5396,26,54,3761.39,6568.01,0.00
2024-12-08 17:15:06,80,5397,26,54,3746.36,6569.00,0.00
2024-12-08 17:15:06,81,5397,27,54,3700.11,6569.01,0.00
2024-12-08 17:15:06,80,5397,26,54,3745.54,6569.01,0.00
2024-12-08 17:15:06,80,5398,26,54,3730.50,6570.00,0.00
2024-12-08 17:15:06,81,5398,26,55,3684.45,6570.01,0.00
2024-12-08 17:15:06,80,5398,26,54,3715.75,6570.13,0.00
2024-12-08 17:15:06,80,5399,26,54,3724.50,6571.00,0.00
2024-12-08 17:15:06,81,5399,26,55,3678.52,6571.01,0.00
2024-12-08 17:15:06,80,5399,26,54,3722.86,6571.03,0.00
2024-12-08 17:15:06,80,5400,26,54,3708.64,6572.00,0.00
2024-12-08 17:15:06,81,5400,27,54,3662.85,6572.01,0.00
2024-12-08 17:15:06,80,5400,27,53,3695.52,6572.11,0.00
2024-12-08 17:15:06,79,5400,26,53,3736.49,6572.19,0.00
2024-12-08 17:15:06,79,5401,26,53,3750.33,6573.00,0.00
2024-12-08 17:15:06,80,5401,27,53,3703.45,6573.01,0.00
2024-12-08 17:15:06,81,5400,28,53,3652.88,6573.11,0.00
2024-12-08 17:15:06,81,5401,28,53,3724.03,6574.00,0.00
2024-12-08 17:15:06,82,5401,29,53,3678.61,6574.01,0.00
2024-12-08 17:15:06,81,5401,29,52,3722.24,6574.04,0.00
2024-12-08 17:15:06,81,5402,29,52,3789.35,6575.00,0.00
2024-12-08 17:15:06,82,5402,30,52,3743.14,6575.01,0.00
2024-12-08 17:15:06,81,5402,30,51,3781.27,6575.10,0.00
2024-12-08 17:15:06,80,5402,29,51,3815.44,6575.26,0.00
2024-12-08 17:15:06,80,5403,29,51,3849.63,6576.00,0.00
2024-12-08 17:15:06,81,5403,29,52,3802.10,6576.01,0.00
2024-12-08 17:15:06,80,5403,29,51,3847.79,6576.04,0.00
2024-12-08 17:15:06,79,5403,28,51,3888.19,6576.09,0.00
2024-12-08 17:15:06,80,5402,28,52,3771.81,6576.90,0.00
2024-12-08 17:15:06,80,5403,28,52,3853.30,6577.00,0.00
2024-12-08 17:15:06,81,5403,28,53,3805.73,6577.01,0.00
2024-12-08 17:15:07,81,5404,28,53,3871.27,6578.00,0.00
2024-12-08 17:15:07,82,5404,28,54,3824.06,6578.01,0.00
2024-12-08 17:15:07,81,5404,28,53,3855.03,6578.01,0.00
2024-12-08 17:15:07,80,5404,27,53,3869.64,6578.36,0.00
2024-12-08 17:15:07,80,5405,27,53,3910.39,6579.00,0.00
2024-12-08 17:15:07,81,5405,28,53,3862.12,6579.01,0.00
2024-12-08 17:15:07,80,5405,28,52,3903.02,6579.08,0.00
2024-12-08 17:15:07,79,5405,27,52,3926.65,6579.22,0.00
2024-12-08 17:15:07,79,5406,27,52,3958.83,6580.00,0.00
2024-12-08 17:15:07,80,5406,28,52,3909.34,6580.01,0.00
2024-12-08 17:15:07,80,5407,28,52,3894.30,6581.00,0.00
2024-12-08 17:15:07,81,5407,28,53,3846.23,6581.01,0.00
2024-12-08 17:15:07,80,5407,28,52,3886.92,6581.08,0.00
2024-12-08 17:15:07,81,5406,28,53,3815.51,6581.46,0.00
2024-12-08 17:15:07,81,5407,28,53,3877.69,6582.00,0.00
2024-12-08 17:15:07,82,5407,28,54,3830.40,6582.01,0.00
2024-12-08 17:15:07,81,5407,28,53,3867.95,6582.04,0.00
2024-12-08 17:15:07,81,5408,28,53,3951.42,6583.00,0.00
2024-12-08 17:15:07,82,5408,28,54,3903.24,6583.01,0.00
2024-12-08 17:15:07,81,5408,28,53,3949.81,6583.03,0.00
2024-12-08 17:15:07,81,5409,28,53,3934.88,6584.00,0.00
2024-12-08 17:15:07,82,5409,29,53,3886.90,6584.01,0.00
2024-12-08 17:15:07,81,5409,29,52,3931.65,6584.05,0.00
2024-12-08 17:15:07,81,5410,29,52,3934.67,6585.00,0.00
2024-12-08 17:15:07,82,5410,29,53,3886.68,6585.01,0.00
2024-12-08 17:15:07,82,5411,29,53,3870.41,6586.00,0.00
2024-12-08 17:15:07,83,5411,29,54,3823.78,6586.01,0.00
2024-12-08 17:15:07,82,5411,29,53,3866.41,6586.05,0.00
2024-12-08 17:15:07,82,5412,29,53,3868.59,6587.00,0.00
2024-12-08 17:15:07,83,5412,30,53,3821.98,6587.01,0.00
2024-12-08 17:15:07,83,5413,30,53,3805.09,6588.00,0.00
2024-12-08 17:15:07,84,5413,30,54,3759.80,6588.01,0.00
2024-12-08 17:15:07,83,5413,30,53,3801.14,6588.05,0.00
2024-12-08 17:15:07,83,5414,30,53,3802.50,6589.00,0.00
2024-12-08 17:15:07,84,5414,31,53,3757.23,6589.01,0.00
2024-12-08 17:15:07,83,5414,30,53,3754.94,6589.24,0.00
2024-12-08 17:15:07,83,5415,30,53,3784.81,6590.00,0.00
2024-12-08 17:15:07,84,5415,30,54,3739.76,6590.01,0.00
2024-12-08 17:15:07,83,5415,30,53,3781.65,6590.05,0.00
2024-12-08 17:15:07,83,5416,30,53,3783.00,6591.00,0.00
2024-12-08 17:15:07,84,5416,31,53,3737.97,6591.01,0.00
2024-12-08 17:15:07,83,5416,31,52,3763.96,6591.05,0.00
2024-12-08 17:15:07,84,5415,31,53,3669.44,6591.82,0.00
2024-12-08 17:15:07,84,5416,31,53,3731.59,6592.00,0.00
2024-12-08 17:15:07,85,5416,31,54,3687.69,6592.01,0.00
2024-12-08 17:15:07,84,5416,31,53,3712.77,6592.05,0.00
2024-12-08 17:15:07,83,5416,30,53,3745.64,6592.22,0.00
2024-12-08 17:15:07,82,5416,29,53,3790.52,6592.22,0.00
2024-12-08 17:15:07,82,5417,29,53,3882.81,6593.00,0.00
2024-12-08 17:15:07,83,5417,29,54,3836.03,6593.01,0.00
2024-12-08 17:15:08,83,5418,29,54,3819.14,6594.00,0.00
2024-12-08 17:15:08,84,5418,29,55,3773.67,6594.01,0.00
2024-12-08 17:15:08,83,5418,29,54,3815.98,6594.05,0.00
2024-12-08 17:15:08,83,5419,29,54,3817.33,6595.00,0.00
2024-12-08 17:15:08,84,5419,29,55,3771.89,6595.01,0.00
2024-12-08 17:15:08,83,5419,28,55,3814.97,6595.04,0.00
2024-12-08 17:15:08,82,5419,28,54,3844.60,6595.04,0.00
2024-12-08 17:15:08,82,5420,28,54,3845.97,6596.00,0.00
2024-12-08 17:15:08,83,5420,28,55,3799.63,6596.01,0.00
2024-12-08 17:15:08,82,5420,27,55,3817.08,6596.21,0.00
2024-12-08 17:15:08,82,5421,27,55,3828.52,6597.00,0.00
2024-12-08 17:15:08,83,5421,28,55,3782.40,6597.01,0.00
2024-12-08 17:15:08,84,5420,29,55,3737.37,6597.04,0.00
2024-12-08 17:15:08,83,5420,28,55,3815.80,6597.05,0.00
2024-12-08 17:15:08,82,5420,28,54,3859.12,6597.06,0.00
2024-12-08 17:15:08,82,5421,28,54,3861.14,6598.00,0.00
2024-12-08 17:15:08,83,5421,29,54,3814.62,6598.01,0.00
2024-12-08 17:15:08,83,5422,29,54,3877.21,6599.00,0.00
2024-12-08 17:15:08,84,5422,30,54,3831.06,6599.01,0.00
2024-12-08 17:15:08,84,5423,30,54,3813.57,6600.00,0.00
2024-12-08 17:15:08,85,5423,31,54,3768.70,6600.01,0.00
2024-12-08 17:15:08,85,5424,31,54,3750.63,6601.00,0.00
2024-12-08 17:15:08,86,5424,31,55,3707.02,6601.01,0.00
2024-12-08 17:15:08,85,5424,30,55,3703.44,6601.48,0.00
2024-12-08 17:15:08,85,5425,30,55,3731.78,6602.00,0.00
2024-12-08 17:15:08,86,5425,31,55,3688.39,6602.01,0.00
2024-12-08 17:15:08,85,5425,31,54,3719.36,6602.01,0.00
2024-12-08 17:15:09,85,5426,31,54,3716.81,6603.00,0.00
2024-12-08 17:15:09,86,5426,32,54,3673.59,6603.01,0.00
2024-12-08 17:15:09,85,5426,32,53,3700.51,6603.04,0.00
2024-12-08 17:15:09,85,5427,32,53,3699.50,6604.00,0.00
2024-12-08 17:15:09,86,5427,33,53,3656.49,6604.01,0.00
2024-12-08 17:15:09,85,5427,33,52,3683.20,6604.04,0.00
2024-12-08 17:15:09,85,5428,33,52,3682.11,6605.00,0.00
2024-12-08 17:15:09,86,5428,34,52,3639.30,6605.01,0.00
2024-12-08 17:15:09,85,5428,34,51,3665.80,6605.04,0.00
2024-12-08 17:15:09,85,5429,34,51,3664.57,6606.00,0.00
2024-12-08 17:15:09,86,5429,35,51,3621.96,6606.01,0.00
2024-12-08 17:15:09,85,5429,35,50,3648.26,6606.04,0.00
2024-12-08 17:15:09,85,5430,35,50,3647.19,6607.00,0.00
2024-12-08 17:15:09,86,5430,36,50,3604.78,6607.01,0.00
2024-12-08 17:15:09,85,5430,36,49,3637.87,6607.02,0.00
2024-12-08 17:15:09,84,5430,35,49,3666.30,6607.24,0.00
2024-12-08 17:15:09,83,5430,34,49,3694.65,6607.47,0.00
2024-12-08 17:15:09,84,5429,35,49,3623.44,6607.91,0.00
2024-12-08 17:15:09,84,5430,35,49,3749.38,6608.00,0.00
2024-12-08 17:15:09,85,5430,36,49,3705.27,6608.01,0.00
2024-12-08 17:15:09,84,5430,36,48,3734.44,6608.02,0.00
2024-12-08 17:15:09,84,5431,36,48,3812.10,6609.00,0.00
2024-12-08 17:15:09,85,5431,36,49,3767.26,6609.01,0.00
2024-12-08 17:15:09,84,5431,36,48,3797.16,6609.02,0.00
2024-12-08 17:15:09,83,5431,35,48,3828.64,6609.23,0.00
2024-12-08 17:15:09,83,5432,35,48,3841.89,6610.00,0.00
2024-12-08 17:15:09,84,5432,36,48,3796.16,6610.01,0.00
2024-12-08 17:15:09,85,5431,37,48,3685.61,6610.57,0.00
2024-12-08 17:15:09,85,5432,37,48,3748.95,6611.00,0.00
2024-12-08 17:15:09,86,5432,37,49,3705.36,6611.01,0.00
2024-12-08 17:15:09,85,5432,37,48,3738.07,6611.02,0.00
2024-12-08 17:15:09,85,5433,37,48,3813.83,6612.00,0.00
2024-12-08 17:15:09,86,5433,37,49,3769.49,6612.01,0.00
2024-12-08 17:15:09,85,5433,37,48,3799.84,6612.02,0.00
2024-12-08 17:15:09,85,5434,37,48,3797.88,6613.00,0.00
2024-12-08 17:15:09,86,5434,38,48,3753.72,6613.01,0.00
2024-12-08 17:15:09,85,5434,38,47,3766.77,6613.02,0.00
2024-12-08 17:15:09,84,5434,37,47,3796.56,6613.24,0.00
2024-12-08 17:15:09,84,5435,37,47,3825.41,6614.00,0.00
2024-12-08 17:15:09,85,5435,37,48,3780.41,6614.01,0.00
2024-12-08 17:15:09,84,5435,37,47,3808.88,6614.02,0.00
2024-12-08 17:15:09,84,5436,37,47,3807.88,6615.00,0.00
2024-12-08 17:15:09,85,5436,38,47,3763.08,6615.01,0.00
2024-12-08 17:15:09,84,5436,38,46,3791.34,6615.02,0.00
2024-12-08 17:15:09,84,5437,38,46,3790.34,6616.00,0.00
2024-12-08 17:15:09,85,5437,39,46,3745.74,6616.01,0.00
2024-12-08 17:15:09,84,5437,38,46,3788.77,6616.02,0.00
2024-12-08 17:15:09,84,5438,38,46,3772.00,6617.00,0.00
2024-12-08 17:15:09,85,5438,38,47,3727.63,6617.01,0.00
2024-12-08 17:15:09,84,5438,38,46,3770.43,6617.02,0.00
2024-12-08 17:15:09,83,5438,37,46,3803.16,6617.22,0.00
2024-12-08 17:15:09,82,5438,36,46,3848.73,6617.22,0.00
2024-12-08 17:15:10,82,5439,36,46,3861.89,6618.00,0.00
2024-12-08 17:15:10,83,5439,36,47,3815.36,6618.01,0.00
2024-12-08 17:15:10,82,5439,36,46,3844.13,6618.02,0.00
2024-12-08 17:15:10,82,5440,36,46,3842.99,6619.00,0.00
2024-12-08 17:15:10,83,5440,37,46,3796.69,6619.01,0.00
2024-12-08 17:15:10,83,5441,37,46,3778.33,6620.00,0.00
2024-12-08 17:15:10,84,5441,38,46,3733.35,6620.01,0.00
2024-12-08 17:15:10,84,5442,38,46,3715.37,6621.00,0.00
2024-12-08 17:15:10,85,5442,39,46,3671.66,6621.01,0.00
2024-12-08 17:15:10,84,5442,39,45,3698.03,6621.02,0.00
2024-12-08 17:15:10,84,5443,39,45,3697.01,6622.00,0.00
2024-12-08 17:15:10,85,5443,40,45,3653.52,6622.01,0.00
2024-12-08 17:15:10,84,5443,40,44,3683.11,6622.02,0.00
2024-12-08 17:15:10,85,5442,41,44,3577.79,6622.75,0.00
2024-12-08 17:15:10,85,5443,41,44,3654.35,6623.00,0.00
2024-12-08 17:15:10,86,5443,42,44,3611.86,6623.01,0.00
2024-12-08 17:15:10,85,5443,42,43,3637.99,6623.02,0.00
2024-12-08 17:15:10,85,5444,42,43,3714.13,6624.00,0.00
2024-12-08 17:15:10,86,5444,42,44,3670.94,6624.01,0.00
2024-12-08 17:15:10,85,5444,42,43,3697.77,6624.02,0.00
2024-12-08 17:15:10,85,5445,42,43,3695.98,6625.00,0.00
2024-12-08 17:15:10,86,5445,42,44,3653.01,6625.01,0.00
2024-12-08 17:15:10,85,5445,42,43,3680.40,6625.02,0.00
2024-12-08 17:15:10,86,5444,43,43,3597.81,6625.65,0.00
2024-12-08 17:15:10,87,5443,43,44,3591.51,6625.68,0.00
2024-12-08 17:15:10,87,5444,43,44,3650.40,6626.00,0.00
2024-12-08 17:15:10,88,5444,44,44,3608.92,6626.01,0.00
2024-12-08 17:15:10,87,5444,44,43,3635.18,6626.02,0.00
2024-12-08 17:15:10,86,5444,43,43,3677.44,6626.02,0.00
2024-12-08 17:15:10,86,5445,43,43,3829.03,6627.00,0.00
2024-12-08 17:15:10,87,5445,43,44,3785.02,6627.01,0.00
2024-12-08 17:15:10,86,5445,42,44,3828.26,6627.02,0.00
2024-12-08 17:15:10,85,5445,41,44,3812.82,6627.71,0.00
2024-12-08 17:15:10,85,5446,41,44,3855.95,6628.00,0.00
2024-12-08 17:15:10,86,5446,42,44,3811.11,6628.01,0.00
2024-12-08 17:15:10,85,5446,42,43,3852.05,6628.04,0.00
2024-12-08 17:15:10,85,5447,42,43,3851.07,6629.00,0.00
2024-12-08 17:15:10,86,5447,42,44,3806.29,6629.01,0.00
2024-12-08 17:15:10,86,5448,42,44,3787.59,6630.00,0.00
2024-12-08 17:15:10,87,5448,42,45,3744.06,6630.01,0.00
2024-12-08 17:15:10,86,5448,42,44,3784.51,6630.04,0.00
2024-12-08 17:15:10,86,5449,42,44,3782.77,6631.00,0.00
2024-12-08 17:15:10,87,5449,42,45,3739.28,6631.01,0.00
2024-12-08 17:15:10,86,5449,41,45,3705.22,6631.72,0.00
2024-12-08 17:15:10,86,5450,41,45,3764.06,6632.00,0.00
2024-12-08 17:15:10,87,5450,41,46,3720.79,6632.01,0.00
2024-12-08 17:15:10,86,5450,41,45,3761.75,6632.04,0.00
2024-12-08 17:15:10,86,5451,41,45,3760.00,6633.00,0.00
2024-12-08 17:15:10,87,5451,42,45,3716.78,6633.01,0.00
2024-12-08 17:15:10,86,5451,42,44,3745.53,6633.04,0.00
2024-12-08 17:15:11,86,5452,42,44,3743.78,6634.00,0.00
2024-12-08 17:15:11,87,5452,42,45,3700.74,6634.01,0.00
2024-12-08 17:15:11,86,5452,42,44,3726.04,6634.04,0.00
2024-12-08 17:15:11,86,5453,42,44,3724.28,6635.00,0.00
2024-12-08 17:15:11,87,5453,43,44,3681.47,6635.01,0.00
2024-12-08 17:15:11,86,5453,42,44,3709.62,6635.01,0.00
2024-12-08 17:15:11,85,5453,42,43,3736.09,6635.02,0.00
2024-12-08 17:15:11,85,5454,42,43,3749.93,6636.00,0.00
2024-12-08 17:15:11,86,5454,43,43,3706.32,6636.01,0.00
2024-12-08 17:15:11,85,5454,42,43,3739.78,6636.01,0.00
2024-12-08 17:15:11,85,5455,42,43,3737.22,6637.00,0.00
2024-12-08 17:15:11,86,5455,42,44,3693.76,6637.01,0.00
2024-12-08 17:15:11,85,5455,42,43,3732.54,6637.04,0.00
2024-12-08 17:15:11,85,5456,42,43,3731.53,6638.00,0.00
2024-12-08 17:15:11,86,5456,42,44,3688.14,6638.01,0.00
2024-12-08 17:15:11,86,5457,42,44,3621.91,6639.00,0.00
2024-12-08 17:15:11,87,5457,42,45,3580.28,6639.01,0.00
2024-12-08 17:15:11,86,5457,41,45,3621.91,6639.01,0.00
2024-12-08 17:15:11,85,5457,41,44,3660.62,6639.02,0.00
2024-12-08 17:15:11,84,5457,41,43,3626.80,6639.87,0.00
2024-12-08 17:15:11,84,5458,41,43,3681.45,6640.00,0.00
2024-12-08 17:15:11,85,5458,42,43,3638.14,6640.01,0.00
2024-12-08 17:15:11,85,5459,42,43,3619.93,6641.00,0.00
2024-12-08 17:15:11,86,5459,43,43,3577.84,6641.01,0.00
2024-12-08 17:15:11,85,5459,43,42,3616.81,6641.02,0.00
2024-12-08 17:15:11,85,5460,43,42,3615.01,6642.00,0.00
2024-12-08 17:15:11,86,5460,44,42,3572.97,6642.01,0.00
2024-12-08 17:15:11,86,5461,44,42,3554.20,6643.00,0.00
2024-12-08 17:15:11,87,5461,44,43,3513.35,6643.01,0.00
2024-12-08 17:15:11,86,5461,44,42,3551.89,6643.02,0.00
2024-12-08 17:15:11,86,5462,44,42,3549.33,6644.00,0.00
2024-12-08 17:15:11,87,5462,44,43,3508.53,6644.01,0.00
2024-12-08 17:15:11,86,5462,43,43,3500.84,6644.51,0.00
2024-12-08 17:15:11,86,5463,43,43,3530.54,6645.00,0.00
2024-12-08 17:15:11,87,5463,44,43,3489.96,6645.01,0.00
2024-12-08 17:15:11,86,5463,44,42,3529.00,6645.02,0.00
2024-12-08 17:15:11,86,5464,44,42,3526.44,6646.00,0.00
2024-12-08 17:15:11,87,5464,45,42,3485.91,6646.01,0.00
2024-12-08 17:15:11,86,5464,45,41,3509.44,6646.02,0.00
2024-12-08 17:15:11,87,5463,46,41,3441.74,6646.46,0.00
2024-12-08 17:15:11,87,5464,46,41,3482.61,6647.00,0.00
2024-12-08 17:15:11,88,5464,47,41,3443.03,6647.01,0.00
2024-12-08 17:15:11,87,5464,46,41,3433.89,6647.51,0.00
2024-12-08 17:15:11,87,5465,46,41,3538.92,6648.00,0.00
2024-12-08 17:15:11,88,5465,46,42,3498.70,6648.01,0.00
2024-12-08 17:15:11,87,5465,46,41,3531.28,6648.02,0.00
2024-12-08 17:15:11,86,5465,45,41,3556.17,6648.27,0.00
2024-12-08 17:15:11,86,5466,45,41,3569.78,6649.00,0.00
2024-12-08 17:15:11,87,5466,45,42,3528.75,6649.01,0.00
2024-12-08 17:15:11,87,5467,45,42,3509.41,6650.00,0.00
2024-12-08 17:15:11,88,5467,45,43,3469.53,6650.01,0.00
2024-12-08 17:15:11,87,5467,45,42,3507.12,6650.04,0.00
2024-12-08 17:15:11,86,5467,44,42,3540.95,6650.08,0.00
2024-12-08 17:15:11,85,5467,43,42,3570.92,6650.26,0.00
2024-12-08 17:15:11,84,5467,42,42,3596.93,6650.50,0.00
2024-12-08 17:15:11,84,5468,42,42,3643.21,6651.00,0.00
2024-12-08 17:15:11,85,5468,43,42,3600.34,6651.01,0.00
2024-12-08 17:15:11,84,5468,43,41,3625.00,6651.04,0.00
2024-12-08 17:15:11,84,5469,43,41,3624.75,6652.00,0.00
2024-12-08 17:15:11,85,5469,43,42,3582.10,6652.01,0.00
2024-12-08 17:15:11,84,5469,42,42,3622.38,6652.04,0.00
2024-12-08 17:15:12,84,5470,42,42,3606.28,6653.00,0.00
2024-12-08 17:15:12,85,5470,42,43,3563.86,6653.01,0.00
2024-12-08 17:15:12,84,5470,41,43,3603.12,6653.05,0.00
2024-12-08 17:15:12,83,5470,41,42,3642.53,6653.06,0.00
2024-12-08 17:15:12,83,5471,41,42,3644.67,6654.00,0.00
2024-12-08 17:15:12,84,5471,41,43,3601.28,6654.01,0.00
2024-12-08 17:15:12,84,5472,41,43,3582.36,6655.00,0.00
2024-12-08 17:15:12,85,5472,42,43,3540.21,6655.01,0.00
2024-12-08 17:15:12,86,5471,42,44,3498.27,6655.05,0.00
2024-12-08 17:15:12,86,5472,42,44,3545.35,6656.00,0.00
2024-12-08 17:15:12,87,5472,42,45,3504.60,6656.01,0.00
2024-12-08 17:15:12,86,5472,42,44,3530.67,6656.06,0.00
2024-12-08 17:15:12,86,5473,42,44,3604.60,6657.00,0.00
2024-12-08 17:15:12,87,5473,43,44,3563.17,6657.01,0.00
2024-12-08 17:15:12,86,5473,43,43,3585.26,6657.06,0.00
2024-12-08 17:15:12,85,5473,42,43,3583.71,6657.48,0.00
2024-12-08 17:15:12,84,5473,41,43,3607.87,6657.74,0.00
2024-12-08 17:15:12,84,5474,41,43,3669.91,6658.00,0.00
2024-12-08 17:15:12,85,5474,42,43,3626.74,6658.01,0.00
2024-12-08 17:15:12,84,5474,42,42,3650.11,6658.06,0.00
2024-12-08 17:15:12,84,5475,42,42,3649.03,6659.00,0.00
2024-12-08 17:15:12,85,5475,43,42,3606.10,6659.01,0.00
2024-12-08 17:15:12,84,5475,42,42,3648.24,6659.01,0.00
2024-12-08 17:15:12,83,5475,41,42,3687.40,6659.06,0.00
2024-12-08 17:15:12,83,5476,41,42,3688.01,6660.00,0.00
2024-12-08 17:15:12,84,5476,41,43,3644.10,6660.01,0.00
2024-12-08 17:15:12,83,5476,40,43,3685.62,6660.05,0.00
2024-12-08 17:15:12,82,5476,40,42,3728.94,6660.05,0.00
2024-12-08 17:15:12,82,5477,40,42,3730.53,6661.00,0.00
2024-12-08 17:15:12,83,5477,41,42,3685.58,6661.01,0.00
2024-12-08 17:15:12,82,5477,41,41,3711.05,6661.05,0.00
2024-12-08 17:15:12,82,5478,41,41,3713.21,6662.00,0.00
2024-12-08 17:15:12,83,5478,42,41,3668.48,6662.01,0.00
2024-12-08 17:15:12,82,5478,42,40,3693.73,6662.05,0.00
2024-12-08 17:15:12,82,5479,42,40,3695.89,6663.00,0.00
2024-12-08 17:15:12,83,5479,42,41,3651.37,6663.01,0.00
2024-12-08 17:15:12,82,5479,42,40,3676.41,6663.05,0.00
2024-12-08 17:15:12,81,5479,41,40,3720.15,6663.05,0.00
2024-12-08 17:15:12,82,5478,41,41,3665.07,6663.22,0.00
2024-12-08 17:15:12,82,5479,41,41,3757.40,6664.00,0.00
2024-12-08 17:15:12,83,5479,42,41,3712.13,6664.01,0.00
2024-12-08 17:15:12,82,5479,41,41,3723.35,6664.27,0.00
2024-12-08 17:15:12,82,5480,41,41,3821.36,6665.00,0.00
2024-12-08 17:15:12,83,5480,41,42,3775.32,6665.01,0.00
2024-12-08 17:15:12,82,5480,41,41,3818.13,6665.05,0.00
2024-12-08 17:15:12,82,5481,41,41,3820.31,6666.00,0.00
2024-12-08 17:15:12,83,5481,42,41,3774.28,6666.01,0.00
2024-12-08 17:15:12,82,5481,42,40,3800.81,6666.05,0.00
2024-12-08 17:15:12,82,5482,42,40,3803.00,6667.00,0.00
2024-12-08 17:15:12,83,5482,42,41,3757.18,6667.01,0.00
2024-12-08 17:15:12,82,5482,41,41,3774.59,6667.18,0.00
2024-12-08 17:15:12,82,5483,41,41,3785.65,6668.00,0.00
2024-12-08 17:15:12,83,5483,41,42,3740.04,6668.01,0.00
2024-12-08 17:15:12,82,5483,41,41,3782.41,6668.05,0.00
2024-12-08 17:15:12,82,5484,41,41,3783.78,6669.00,0.00
2024-12-08 17:15:12,83,5484,41,42,3738.19,6669.01,0.00
2024-12-08 17:15:12,82,5484,40,42,3761.83,6669.06,0.00
2024-12-08 17:15:13,83,5483,41,42,3664.64,6669.84,0.00
2024-12-08 17:15:13,83,5484,41,42,3744.33,6670.00,0.00
2024-12-08 17:15:13,84,5484,42,42,3699.75,6670.01,0.00
2024-12-08 17:15:13,83,5484,42,41,3725.05,6670.05,0.00
2024-12-08 17:15:13,83,5485,42,41,3804.56,6671.00,0.00
2024-12-08 17:15:13,84,5485,42,42,3759.27,6671.01,0.00
2024-12-08 17:15:13,85,5484,42,43,3715.04,6671.04,0.00
2024-12-08 17:15:13,84,5484,42,42,3784.70,6671.06,0.00
2024-12-08 17:15:13,84,5485,42,42,3783.27,6672.00,0.00
2024-12-08 17:15:13,85,5485,42,43,3738.76,6672.01,0.00
2024-12-08 17:15:13,85,5486,42,43,3795.89,6673.00,0.00
2024-12-08 17:15:13,86,5486,43,43,3751.75,6673.01,0.00
2024-12-08 17:15:13,85,5486,42,43,3794.33,6673.02,0.00
2024-12-08 17:15:13,84,5486,42,42,3837.12,6673.05,0.00
2024-12-08 17:15:13,83,5486,41,42,3866.98,6673.23,0.00
2024-12-08 17:15:13,83,5487,41,42,3880.35,6674.00,0.00
2024-12-08 17:15:13,84,5487,41,43,3834.15,6674.01,0.00
2024-12-08 17:15:13,83,5487,41,42,3861.06,6674.05,0.00
2024-12-08 17:15:13,83,5488,41,42,3858.64,6675.00,0.00
2024-12-08 17:15:13,84,5488,42,42,3812.70,6675.01,0.00
2024-12-08 17:15:13,83,5488,41,42,3857.04,6675.02,0.00
2024-12-08 17:15:13,82,5488,41,41,3893.84,6675.04,0.00
2024-12-08 17:15:13,81,5488,40,41,3925.46,6675.21,0.00
2024-12-08 17:15:13,81,5489,40,41,3939.16,6676.00,0.00
2024-12-08 17:15:13,82,5489,40,42,3891.12,6676.01,0.00
2024-12-08 17:15:13,81,5489,40,41,3920.22,6676.04,0.00
2024-12-08 17:15:13,80,5489,39,41,3941.29,6676.14,0.00
2024-12-08 17:15:13,80,5490,39,41,3967.70,6677.00,0.00
2024-12-08 17:15:13,81,5490,39,42,3918.72,6677.01,0.00
2024-12-08 17:15:13,80,5490,38,42,3965.21,6677.04,0.00
2024-12-08 17:15:13,80,5491,38,42,3951.60,6678.00,0.00
2024-12-08 17:15:13,81,5491,38,43,3902.82,6678.01,0.00
2024-12-08 17:15:13,80,5491,38,42,3944.12,6678.08,0.00
2024-12-08 17:15:13,80,5492,38,42,3949.69,6679.00,0.00
2024-12-08 17:15:13,81,5492,39,42,3900.93,6679.01,0.00
2024-12-08 17:15:13,80,5492,38,42,3892.24,6679.41,0.00
2024-12-08 17:15:13,80,5493,38,42,3936.92,6680.00,0.00
2024-12-08 17:15:13,81,5493,39,42,3888.32,6680.01,0.00
2024-12-08 17:15:13,80,5493,39,41,3925.24,6680.03,0.00
2024-12-08 17:15:13,80,5494,39,41,3927.49,6681.00,0.00
2024-12-08 17:15:13,81,5494,39,42,3879.00,6681.01,0.00
2024-12-08 17:15:13,80,5494,39,41,3914.17,6681.10,0.00
2024-12-08 17:15:13,79,5494,38,41,3940.64,6681.43,0.00
2024-12-08 17:15:13,79,5495,38,41,3970.65,6682.00,0.00
2024-12-08 17:15:13,80,5495,38,42,3921.02,6682.01,0.00
2024-12-08 17:15:13,80,5496,38,42,3904.08,6683.00,0.00
2024-12-08 17:15:13,81,5496,38,43,3855.88,6683.01,0.00
2024-12-08 17:15:13,80,5496,38,42,3890.75,6683.10,0.00
2024-12-08 17:15:13,80,5497,38,42,3897.38,6684.00,0.00
2024-12-08 17:15:13,81,5497,39,42,3849.26,6684.01,0.00
2024-12-08 17:15:13,80,5497,38,42,3805.01,6684.95,0.00
2024-12-08 17:15:13,80,5498,38,42,3885.27,6685.00,0.00
2024-12-08 17:15:13,81,5498,39,42,3837.30,6685.01,0.00
2024-12-08 17:15:13,80,5498,39,41,3872.77,6685.10,0.00
2024-12-08 17:15:13,79,5498,38,41,3911.69,6685.24,0.00
2024-12-08 17:15:13,80,5497,38,42,3823.59,6685.85,0.00
2024-12-08 17:15:13,80,5498,38,42,3891.42,6686.00,0.00
2024-12-08 17:15:13,81,5498,38,43,3843.37,6686.01,0.00
2024-12-08 17:15:13,80,5498,37,43,3841.36,6686.25,0.00
2024-12-08 17:15:13,80,5499,37,43,3958.58,6687.00,0.00
2024-12-08 17:15:13,81,5499,38,43,3909.71,6687.01,0.00
2024-12-08 17:15:13,80,5499,38,42,3946.08,6687.10,0.00
2024-12-08 17:15:14,80,5500,38,42,3952.67,6688.00,0.00
2024-12-08 17:15:14,81,5500,39,42,3903.87,6688.01,0.00
2024-12-08 17:15:14,81,5501,39,42,3886.73,6689.00,0.00
2024-12-08 17:15:14,82,5501,39,43,3839.33,6689.01,0.00
2024-12-08 17:15:14,81,5501,39,42,3871.90,6689.11,0.00
2024-12-08 17:15:14,81,5502,39,42,3877.46,6690.00,0.00
2024-12-08 17:15:14,82,5502,39,43,3830.17,6690.01,0.00
2024-12-08 17:15:14,81,5502,38,43,3827.20,6690.36,0.00
2024-12-08 17:15:14,81,5503,38,43,3865.60,6691.00,0.00
2024-12-08 17:15:14,82,5503,39,43,3818.46,6691.01,0.00
2024-12-08 17:15:14,81,5503,39,42,3842.53,6691.19,0.00
2024-12-08 17:15:14,81,5504,39,42,3852.89,6692.00,0.00
2024-12-08 17:15:14,82,5504,39,43,3805.91,6692.01,0.00
2024-12-08 17:15:14,82,5505,39,43,3787.65,6693.00,0.00
2024-12-08 17:15:14,83,5505,39,44,3742.02,6693.01,0.00
2024-12-08 17:15:14,82,5505,39,43,3765.66,6693.18,0.00
2024-12-08 17:15:14,82,5506,39,43,3775.11,6694.00,0.00
2024-12-08 17:15:14,83,5506,40,43,3729.62,6694.01,0.00
2024-12-08 17:15:14,82,5506,39,43,3766.97,6694.05,0.00
2024-12-08 17:15:14,82,5507,39,43,3767.25,6695.00,0.00
2024-12-08 17:15:14,83,5507,40,43,3721.86,6695.01,0.00
2024-12-08 17:15:14,82,5507,40,42,3747.70,6695.17,0.00
2024-12-08 17:15:14,82,5508,40,42,3755.79,6696.00,0.00
2024-12-08 17:15:14,83,5508,41,42,3710.54,6696.01,0.00
2024-12-08 17:15:14,83,5509,41,42,3690.65,6697.00,0.00
2024-12-08 17:15:14,84,5509,41,43,3646.72,6697.01,0.00
2024-12-08 17:15:14,85,5508,42,43,3603.81,6697.04,0.00
2024-12-08 17:15:14,84,5508,42,42,3645.97,6697.19,0.00
2024-12-08 17:15:14,83,5508,41,42,3660.13,6697.54,0.00
2024-12-08 17:15:14,83,5509,41,42,3709.89,6698.00,0.00
2024-12-08 17:15:14,84,5509,41,43,3665.72,6698.01,0.00
2024-12-08 17:15:14,84,5510,41,43,3724.25,6699.00,0.00
2024-12-08 17:15:14,85,5510,42,43,3680.43,6699.01,0.00
2024-12-08 17:15:14,84,5510,42,42,3703.56,6699.18,0.00
2024-12-08 17:15:14,84,5511,42,42,3709.11,6700.00,0.00
2024-12-08 17:15:14,85,5511,43,42,3665.48,6700.01,0.00
2024-12-08 17:15:14,84,5511,42,42,3703.56,6700.10,0.00
2024-12-08 17:15:14,83,5511,41,42,3702.39,6700.48,0.00
2024-12-08 17:15:14,83,5512,41,42,3731.94,6701.00,0.00
2024-12-08 17:15:14,84,5512,42,42,3687.51,6701.01,0.00
2024-12-08 17:15:14,83,5512,41,42,3726.32,6701.10,0.00
2024-12-08 17:15:14,82,5512,41,41,3758.70,6701.16,0.00
2024-12-08 17:15:14,82,5513,41,41,3762.37,6702.00,0.00
2024-12-08 17:15:14,83,5513,41,42,3717.04,6702.01,0.00
2024-12-08 17:15:14,83,5514,41,42,3695.73,6703.00,0.00
2024-12-08 17:15:14,84,5514,42,42,3651.74,6703.01,0.00
2024-12-08 17:15:14,83,5514,42,41,3678.01,6703.16,0.00
2024-12-08 17:15:14,83,5515,42,41,3681.55,6704.00,0.00
2024-12-08 17:15:14,84,5515,42,42,3637.72,6704.01,0.00
2024-12-08 17:15:14,83,5515,41,42,3647.70,6704.25,0.00
2024-12-08 17:15:14,83,5516,41,42,3673.93,6705.00,0.00
2024-12-08 17:15:14,84,5516,42,42,3630.19,6705.01,0.00
2024-12-08 17:15:15,83,5516,41,42,3669.91,6705.06,0.00
2024-12-08 17:15:15,82,5516,41,41,3699.96,6705.16,0.00
2024-12-08 17:15:15,82,5517,41,41,3704.53,6706.00,0.00
2024-12-08 17:15:15,83,5517,42,41,3659.90,6706.01,0.00
2024-12-08 17:15:15,83,5518,42,41,3637.61,6707.00,0.00
2024-12-08 17:15:15,84,5518,42,42,3594.30,6707.01,0.00
2024-12-08 17:15:15,83,5518,41,42,3633.59,6707.06,0.00
2024-12-08 17:15:15,82,5518,41,41,3663.19,6707.15,0.00
2024-12-08 17:15:15,82,5519,41,41,3666.91,6708.00,0.00
2024-12-08 17:15:15,83,5519,41,42,3622.73,6708.01,0.00
2024-12-08 17:15:15,83,5520,41,42,3600.94,6709.00,0.00
2024-12-08 17:15:15,84,5520,41,43,3558.07,6709.01,0.00
2024-12-08 17:15:15,83,5520,41,42,3584.00,6709.15,0.00
2024-12-08 17:15:15,82,5520,40,42,3616.25,6709.16,0.00
2024-12-08 17:15:15,82,5521,40,42,3637.80,6710.00,0.00
2024-12-08 17:15:15,83,5521,40,43,3593.97,6710.01,0.00
2024-12-08 17:15:15,82,5521,40,42,3594.71,6710.33,0.00
2024-12-08 17:15:15,82,5522,40,42,3614.01,6711.00,0.00
2024-12-08 17:15:15,83,5522,41,42,3570.47,6711.01,0.00
2024-12-08 17:15:15,82,5522,41,41,3597.67,6711.15,0.00
2024-12-08 17:15:15,81,5522,40,41,3611.27,6711.53,0.00
2024-12-08 17:15:15,81,5523,40,41,3662.99,6712.00,0.00
2024-12-08 17:15:15,82,5523,41,41,3618.32,6712.01,0.00
2024-12-08 17:15:15,82,5524,41,41,3593.90,6713.00,0.00
2024-12-08 17:15:15,83,5524,42,41,3550.60,6713.01,0.00
2024-12-08 17:15:15,82,5524,42,40,3575.92,6713.15,0.00
2024-12-08 17:15:15,82,5525,42,40,3581.89,6714.00,0.00
2024-12-08 17:15:15,83,5525,42,41,3538.73,6714.01,0.00
2024-12-08 17:15:15,82,5525,41,41,3531.33,6714.38,0.00
2024-12-08 17:15:15,82,5526,41,41,3569.97,6715.00,0.00
2024-12-08 17:15:15,83,5526,42,41,3526.96,6715.01,0.00
2024-12-08 17:15:15,82,5526,42,40,3552.80,6715.15,0.00
2024-12-08 17:15:15,82,5527,42,40,3550.87,6716.00,0.00
2024-12-08 17:15:15,83,5527,42,41,3508.09,6716.01,0.00
2024-12-08 17:15:15,83,5528,42,41,3484.20,6717.00,0.00
2024-12-08 17:15:15,84,5528,43,41,3442.73,6717.01,0.00
2024-12-08 17:15:15,83,5528,43,40,3463.99,6717.06,0.00
2024-12-08 17:15:15,82,5528,42,40,3501.54,6717.12,0.00
2024-12-08 17:15:15,81,5528,42,39,3530.69,6717.17,0.00
2024-12-08 17:15:15,81,5529,42,39,3556.10,6718.00,0.00
2024-12-08 17:15:15,82,5529,43,39,3512.73,6718.01,0.00
2024-12-08 17:15:15,81,5529,42,39,3523.93,6718.23,0.00
2024-12-08 17:15:15,80,5529,41,39,3556.81,6718.39,0.00
2024-12-08 17:15:15,80,5530,41,39,3583.26,6719.00,0.00
2024-12-08 17:15:15,81,5530,41,40,3539.02,6719.01,0.00
2024-12-08 17:15:15,80,5530,41,39,3562.29,6719.18,0.00
2024-12-08 17:15:15,80,5531,41,39,3574.55,6720.00,0.00
2024-12-08 17:15:15,81,5531,42,39,3530.42,6720.01,0.00
2024-12-08 17:15:15,81,5532,42,39,3514.35,6721.00,0.00
2024-12-08 17:15:15,82,5532,42,40,3471.49,6721.01,0.00
2024-12-08 17:15:15,81,5532,41,40,3510.22,6721.06,0.00
2024-12-08 17:15:15,80,5532,40,40,3544.85,6721.10,0.00
2024-12-08 17:15:15,81,5531,40,41,3498.61,6721.16,0.00
2024-12-08 17:15:15,80,5531,40,40,3586.89,6721.21,0.00
2024-12-08 17:15:15,80,5532,40,40,3601.66,6722.00,0.00
2024-12-08 17:15:15,81,5532,41,40,3557.20,6722.01,0.00
2024-12-08 17:15:15,80,5532,40,40,3598.32,6722.05,0.00
2024-12-08 17:15:15,79,5532,39,40,3643.01,6722.05,0.00
2024-12-08 17:15:15,78,5532,38,40,3688.86,6722.05,0.00
2024-12-08 17:15:15,78,5533,38,40,3763.52,6723.00,0.00
2024-12-08 17:15:15,79,5533,39,40,3715.88,6723.01,0.00
2024-12-08 17:15:15,78,5533,38,40,3760.08,6723.05,0.00
2024-12-08 17:15:15,77,5533,38,39,3784.51,6723.18,0.00
2024-12-08 17:15:16,77,5534,38,39,3799.86,6724.00,0.00
2024-12-08 17:15:16,78,5534,39,39,3751.15,6724.01,0.00
2024-12-08 17:15:16,78,5535,39,39,3737.05,6725.00,0.00
2024-12-08 17:15:16,79,5535,39,40,3689.75,6725.01,0.00
2024-12-08 17:15:16,78,5535,39,39,3707.79,6725.21,0.00
2024-12-08 17:15:16,77,5535,38,39,3740.33,6725.44,0.00
2024-12-08 17:15:16,77,5536,38,39,3773.04,6726.00,0.00
2024-12-08 17:15:16,78,5536,38,40,3724.67,6726.01,0.00
2024-12-08 17:15:16,77,5536,37,40,3769.56,6726.05,0.00
2024-12-08 17:15:16,77,5537,37,40,3758.35,6727.00,0.00
2024-12-08 17:15:16,78,5537,37,41,3710.16,6727.01,0.00
2024-12-08 17:15:16,78,5538,37,41,3695.20,6728.00,0.00
2024-12-08 17:15:16,79,5538,37,42,3648.42,6728.01,0.00
2024-12-08 17:15:16,78,5538,37,41,3684.87,6728.10,0.00
2024-12-08 17:15:16,78,5539,37,41,3692.93,6729.00,0.00
2024-12-08 17:15:16,79,5539,38,41,3646.18,6729.01,0.00
2024-12-08 17:15:16,79,5540,38,41,3629.31,6730.00,0.00
2024-12-08 17:15:16,80,5540,39,41,3583.95,6730.01,0.00
2024-12-08 17:15:16,79,5540,39,40,3617.76,6730.10,0.00
2024-12-08 17:15:16,78,5540,39,39,3662.43,6730.10,0.00
2024-12-08 17:15:16,78,5541,39,39,3670.62,6731.00,0.00
2024-12-08 17:15:16,79,5541,39,40,3624.15,6731.01,0.00
2024-12-08 17:15:16,78,5541,38,40,3661.67,6731.09,0.00
2024-12-08 17:15:16,77,5541,37,40,3683.91,6731.21,0.00
2024-12-08 17:15:16,77,5542,37,40,3700.27,6732.00,0.00
2024-12-08 17:15:16,78,5542,37,41,3652.83,6732.01,0.00
2024-12-08 17:15:16,77,5542,37,40,3678.40,6732.13,0.00
2024-12-08 17:15:16,77,5543,37,40,3690.28,6733.00,0.00
2024-12-08 17:15:16,78,5543,38,40,3642.97,6733.01,0.00
2024-12-08 17:15:16,77,5543,37,40,3684.59,6733.05,0.00
2024-12-08 17:15:16,76,5543,37,39,3717.15,6733.12,0.00
2024-12-08 17:15:16,76,5544,37,39,3729.19,6734.00,0.00
2024-12-08 17:15:16,77,5544,37,40,3680.76,6734.01,0.00
2024-12-08 17:15:16,77,5545,37,40,3667.31,6735.00,0.00
2024-12-08 17:15:16,78,5545,37,41,3620.29,6735.01,0.00
2024-12-08 17:15:16,78,5546,37,41,3606.15,6736.00,0.00
2024-12-08 17:15:16,79,5546,37,42,3560.50,6736.01,0.00
2024-12-08 17:15:16,78,5546,36,42,3589.77,6736.12,0.00
2024-12-08 17:15:16,77,5546,36,41,3625.89,6736.12,0.00
2024-12-08 17:15:16,77,5547,36,41,3654.40,6737.00,0.00
2024-12-08 17:15:16,78,5547,37,41,3607.55,6737.01,0.00
2024-12-08 17:15:16,77,5547,37,40,3636.93,6737.12,0.00
2024-12-08 17:15:16,78,5546,37,41,3543.16,6737.85,0.00
2024-12-08 17:15:16,78,5547,37,41,3629.68,6738.00,0.00
2024-12-08 17:15:16,79,5547,38,41,3583.74,6738.01,0.00
2024-12-08 17:15:16,78,5547,37,41,3595.19,6738.23,0.00
2024-12-08 17:15:16,77,5547,36,41,3609.76,6738.71,0.00
2024-12-08 17:15:16,77,5548,36,41,3765.76,6739.00,0.00
2024-12-08 17:15:16,78,5548,37,41,3717.48,6739.01,0.00
2024-12-08 17:15:16,77,5548,37,40,3749.16,6739.12,0.00
2024-12-08 17:15:16,77,5549,37,40,3760.19,6740.00,0.00
2024-12-08 17:15:16,78,5549,38,40,3711.98,6740.01,0.00
2024-12-08 17:15:17,78,5550,38,40,3697.84,6741.00,0.00
2024-12-08 17:15:17,79,5550,38,41,3651.03,6741.01,0.00
2024-12-08 17:15:17,78,5550,38,40,3681.45,6741.12,0.00
2024-12-08 17:15:17,78,5551,38,40,3691.48,6742.00,0.00
2024-12-08 17:15:17,79,5551,39,40,3644.75,6742.01,0.00
2024-12-08 17:15:17,78,5551,38,40,3611.39,6742.71,0.00
2024-12-08 17:15:17,78,5552,38,40,3678.19,6743.00,0.00
2024-12-08 17:15:17,79,5552,39,40,3631.63,6743.01,0.00
2024-12-08 17:15:17,79,5553,39,40,3616.80,6744.00,0.00
2024-12-08 17:15:17,80,5553,40,40,3571.59,6744.01,0.00
2024-12-08 17:15:17,81,5552,40,41,3520.86,6744.14,0.00
2024-12-08 17:15:17,81,5553,40,41,3595.47,6745.00,0.00
2024-12-08 17:15:17,82,5553,41,41,3551.63,6745.01,0.00
2024-12-08 17:15:17,81,5553,40,41,3563.06,6745.23,0.00
2024-12-08 17:15:17,81,5554,40,41,3661.80,6746.00,0.00
2024-12-08 17:15:17,82,5554,40,42,3617.15,6746.01,0.00
2024-12-08 17:15:17,81,5554,39,42,3659.31,6746.04,0.00
2024-12-08 17:15:17,81,5555,39,42,3644.85,6747.00,0.00
2024-12-08 17:15:17,82,5555,40,42,3600.40,6747.01,0.00
2024-12-08 17:15:17,81,5555,39,42,3642.36,6747.04,0.00
2024-12-08 17:15:17,80,5555,38,42,3656.74,6747.24,0.00
2024-12-08 17:15:17,80,5556,38,42,3673.25,6748.00,0.00
2024-12-08 17:15:17,81,5556,38,43,3627.90,6748.01,0.00
2024-12-08 17:15:17,80,5556,38,42,3653.02,6748.09,0.00
2024-12-08 17:15:17,80,5557,38,42,3659.45,6749.00,0.00
2024-12-08 17:15:17,81,5557,38,43,3614.27,6749.01,0.00
2024-12-08 17:15:17,81,5558,38,43,3598.14,6750.00,0.00
2024-12-08 17:15:17,82,5558,38,44,3554.26,6750.01,0.00
2024-12-08 17:15:17,81,5558,38,43,3590.65,6750.09,0.00
2024-12-08 17:15:17,80,5558,37,43,3596.86,6750.45,0.00
2024-12-08 17:15:17,80,5559,37,43,3644.50,6751.00,0.00
2024-12-08 17:15:17,81,5559,37,44,3599.51,6751.01,0.00
2024-12-08 17:15:17,80,5559,36,44,3617.51,6751.10,0.00
2024-12-08 17:15:17,80,5560,36,44,3641.66,6752.00,0.00
2024-12-08 17:15:17,81,5560,36,45,3596.71,6752.01,0.00
2024-12-08 17:15:17,80,5560,36,44,3634.08,6752.09,0.00
2024-12-08 17:15:17,81,5559,36,45,3525.38,6752.82,0.00
2024-12-08 17:15:17,81,5560,36,45,3608.08,6753.00,0.00
2024-12-08 17:15:17,82,5560,36,46,3564.07,6753.01,0.00
2024-12-08 17:15:17,83,5559,37,46,3518.70,6753.07,0.00
2024-12-08 17:15:17,83,5560,37,46,3664.06,6754.00,0.00
2024-12-08 17:15:17,84,5560,38,46,3620.44,6754.01,0.00
2024-12-08 17:15:17,83,5560,38,45,3650.26,6754.12,0.00
2024-12-08 17:15:17,83,5561,38,45,3737.85,6755.00,0.00
2024-12-08 17:15:17,84,5561,38,46,3693.35,6755.01,0.00
2024-12-08 17:15:17,85,5560,39,46,3647.52,6755.07,0.00
2024-12-08 17:15:18,85,5561,39,46,3633.09,6756.00,0.00
2024-12-08 17:15:18,86,5561,40,46,3590.84,6756.01,0.00
2024-12-08 17:15:18,85,5561,40,45,3620.40,6756.12,0.00
2024-12-08 17:15:18,85,5562,40,45,3703.13,6757.00,0.00
2024-12-08 17:15:18,86,5562,40,46,3660.07,6757.01,0.00
2024-12-08 17:15:18,85,5562,39,46,3702.33,6757.01,0.00
2024-12-08 17:15:18,85,5563,39,46,3683.80,6758.00,0.00
2024-12-08 17:15:18,86,5563,40,46,3640.97,6758.01,0.00
2024-12-08 17:15:18,85,5563,39,46,3680.64,6758.05,0.00
2024-12-08 17:15:18,84,5563,39,45,3716.42,6758.10,0.00
2024-12-08 17:15:18,84,5564,39,45,3720.16,6759.00,0.00
2024-12-08 17:15:18,85,5564,39,46,3676.39,6759.01,0.00
2024-12-08 17:15:18,84,5564,38,46,3657.55,6759.46,0.00
2024-12-08 17:15:18,84,5565,38,46,3702.20,6760.00,0.00
2024-12-08 17:15:18,85,5565,38,47,3658.65,6760.01,0.00
2024-12-08 17:15:18,84,5565,38,46,3691.76,6760.10,0.00
2024-12-08 17:15:18,83,5565,37,46,3712.66,6760.23,0.00
2024-12-08 17:15:18,83,5566,37,46,3742.47,6761.00,0.00
2024-12-08 17:15:18,84,5566,38,46,3697.92,6761.01,0.00
2024-12-08 17:15:18,84,5567,38,46,3679.95,6762.00,0.00
2024-12-08 17:15:18,85,5567,38,47,3636.66,6762.01,0.00
2024-12-08 17:15:18,84,5567,37,47,3676.75,6762.05,0.00
2024-12-08 17:15:18,83,5567,37,46,3714.54,6762.08,0.00
2024-12-08 17:15:18,84,5566,38,46,3665.50,6762.18,0.00
2024-12-08 17:15:18,84,5567,38,46,3744.91,6763.00,0.00
2024-12-08 17:15:18,85,5567,38,47,3700.85,6763.01,0.00
2024-12-08 17:15:18,84,5567,37,47,3744.10,6763.01,0.00
2024-12-08 17:15:18,83,5567,36,47,3755.88,6763.25,0.00
2024-12-08 17:15:18,82,5567,35,47,3798.39,6763.27,0.00
2024-12-08 17:15:18,82,5568,35,47,3914.35,6764.00,0.00
2024-12-08 17:15:18,83,5568,35,48,3867.19,6764.01,0.00
2024-12-08 17:15:18,82,5568,34,48,3906.12,6764.07,0.00
2024-12-08 17:15:18,81,5568,34,47,3949.34,6764.07,0.00
2024-12-08 17:15:18,81,5569,34,47,3970.78,6765.00,0.00
2024-12-08 17:15:18,82,5569,34,48,3922.35,6765.01,0.00
2024-12-08 17:15:18,82,5570,34,48,3905.61,6766.00,0.00
2024-12-08 17:15:18,83,5570,35,48,3858.55,6766.01,0.00
2024-12-08 17:15:18,82,5570,35,47,3894.08,6766.10,0.00
2024-12-08 17:15:18,81,5570,34,47,3894.85,6766.62,0.00
2024-12-08 17:15:18,81,5571,34,47,3952.80,6767.00,0.00
2024-12-08 17:15:18,82,5571,35,47,3904.59,6767.01,0.00
2024-12-08 17:15:18,82,5572,35,47,3886.79,6768.00,0.00
2024-12-08 17:15:18,83,5572,36,47,3839.96,6768.01,0.00
2024-12-08 17:15:18,82,5572,36,46,3876.09,6768.10,0.00
2024-12-08 17:15:18,82,5573,36,46,3880.95,6769.00,0.00
2024-12-08 17:15:18,83,5573,36,47,3834.19,6769.01,0.00
2024-12-08 17:15:18,83,5574,36,47,3816.81,6770.00,0.00
2024-12-08 17:15:18,84,5574,36,48,3771.37,6770.01,0.00
2024-12-08 17:15:18,83,5574,36,47,3802.17,6770.13,0.00
2024-12-08 17:15:18,82,5574,35,47,3827.20,6770.45,0.00
2024-12-08 17:15:19,82,5575,35,47,3856.50,6771.00,0.00
2024-12-08 17:15:19,83,5575,36,47,3810.03,6771.01,0.00
2024-12-08 17:15:19,82,5575,35,47,3823.51,6771.15,0.00
2024-12-08 17:15:19,82,5576,35,47,3848.81,6772.00,0.00
2024-12-08 17:15:19,83,5576,36,47,3802.44,6772.01,0.00
2024-12-08 17:15:19,82,5576,36,46,3818.29,6772.13,0.00
2024-12-08 17:15:19,82,5577,36,46,3842.77,6773.00,0.00
2024-12-08 17:15:19,83,5577,37,46,3796.47,6773.01,0.00
2024-12-08 17:15:19,83,5578,37,46,3779.07,6774.00,0.00
2024-12-08 17:15:19,84,5578,38,46,3734.09,6774.01,0.00
2024-12-08 17:15:19,84,5579,38,46,3716.09,6775.00,0.00
2024-12-08 17:15:19,85,5579,39,46,3672.37,6775.01,0.00
2024-12-08 17:15:19,84,5579,39,45,3710.44,6775.01,0.00
2024-12-08 17:15:19,84,5580,39,45,3708.57,6776.00,0.00
2024-12-08 17:15:19,85,5580,40,45,3664.94,6776.01,0.00
2024-12-08 17:15:19,84,5580,40,44,3706.96,6776.02,0.00
2024-12-08 17:15:19,83,5580,40,43,3748.36,6776.04,0.00
2024-12-08 17:15:19,82,5580,39,43,3789.96,6776.09,0.00
2024-12-08 17:15:19,82,5581,39,43,3794.62,6777.00,0.00
2024-12-08 17:15:19,83,5581,39,44,3748.90,6777.01,0.00
2024-12-08 17:15:19,82,5581,39,43,3792.98,6777.02,0.00
2024-12-08 17:15:19,82,5582,39,43,3793.53,6778.00,0.00
2024-12-08 17:15:19,83,5582,39,44,3747.82,6778.01,0.00
2024-12-08 17:15:19,83,5583,39,44,3730.41,6779.00,0.00
2024-12-08 17:15:19,84,5583,39,45,3686.00,6779.01,0.00
2024-12-08 17:15:19,83,5583,39,44,3721.45,6779.10,0.00
2024-12-08 17:15:19,82,5583,38,44,3742.18,6779.46,0.00
2024-12-08 17:15:19,82,5584,38,44,3772.33,6780.00,0.00
2024-12-08 17:15:19,83,5584,39,44,3726.88,6780.01,0.00
2024-12-08 17:15:19,82,5584,38,44,3729.38,6780.21,0.00
2024-12-08 17:15:19,82,5585,38,44,3758.82,6781.00,0.00
2024-12-08 17:15:19,83,5585,39,44,3713.54,6781.01,0.00
2024-12-08 17:15:19,82,5585,39,43,3749.75,6781.10,0.00
2024-12-08 17:15:19,82,5586,39,43,3755.24,6782.00,0.00
2024-12-08 17:15:19,83,5586,40,43,3710.00,6782.01,0.00
2024-12-08 17:15:19,82,5586,39,43,3721.37,6782.15,0.00
2024-12-08 17:15:19,83,5585,40,43,3642.46,6782.68,0.00
2024-12-08 17:15:19,83,5586,40,43,3723.62,6783.00,0.00
2024-12-08 17:15:19,84,5586,40,44,3679.29,6783.01,0.00
2024-12-08 17:15:19,83,5586,40,43,3713.84,6783.10,0.00
2024-12-08 17:15:19,83,5587,40,43,3800.18,6784.00,0.00
2024-12-08 17:15:19,84,5587,40,44,3754.94,6784.01,0.00
2024-12-08 17:15:19,84,5588,40,44,3736.92,6785.00,0.00
2024-12-08 17:15:19,85,5588,41,44,3692.96,6785.01,0.00
2024-12-08 17:15:19,84,5588,41,43,3728.06,6785.10,0.00
2024-12-08 17:15:19,84,5589,41,43,3731.81,6786.00,0.00
2024-12-08 17:15:19,85,5589,41,44,3687.91,6786.01,0.00
2024-12-08 17:15:19,84,5589,41,43,3726.98,6786.02,0.00
2024-12-08 17:15:19,84,5590,41,43,3725.90,6787.00,0.00
2024-12-08 17:15:19,85,5590,41,44,3682.07,6787.01,0.00
2024-12-08 17:15:19,85,5591,41,44,3663.44,6788.00,0.00
2024-12-08 17:15:19,86,5591,42,44,3620.84,6788.01,0.00
2024-12-08 17:15:19,85,5591,42,43,3657.08,6788.08,0.00
2024-12-08 17:15:19,84,5591,41,43,3631.57,6788.93,0.00
2024-12-08 17:15:19,84,5592,41,43,3707.60,6789.00,0.00
2024-12-08 17:15:19,85,5592,41,44,3663.98,6789.01,0.00
2024-12-08 17:15:19,84,5592,41,43,3689.20,6789.08,0.00
2024-12-08 17:15:20,84,5593,41,43,3692.14,6790.00,0.00
2024-12-08 17:15:20,85,5593,42,43,3648.71,6790.01,0.00
2024-12-08 17:15:20,85,5594,42,43,3630.07,6791.00,0.00
2024-12-08 17:15:20,86,5594,42,44,3587.86,6791.01,0.00
2024-12-08 17:15:20,85,5594,41,44,3628.48,6791.02,0.00
2024-12-08 17:15:20,84,5594,41,43,3663.60,6791.10,0.00
2024-12-08 17:15:20,83,5594,40,43,3698.78,6791.23,0.00
2024-12-08 17:15:20,83,5595,40,43,3712.36,6792.00,0.00
2024-12-08 17:15:20,84,5595,40,44,3668.16,6792.01,0.00
2024-12-08 17:15:20,85,5594,40,45,3624.22,6792.05,0.00
2024-12-08 17:15:20,85,5595,40,45,3631.14,6793.00,0.00
2024-12-08 17:15:20,86,5595,41,45,3588.92,6793.01,0.00
2024-12-08 17:15:20,85,5595,40,45,3627.16,6793.07,0.00
2024-12-08 17:15:20,84,5595,39,45,3669.53,6793.07,0.00
2024-12-08 17:15:20,83,5595,39,44,3710.47,6793.07,0.00
2024-12-08 17:15:20,82,5595,38,44,3745.00,6793.22,0.00
2024-12-08 17:15:20,82,5596,38,44,3841.59,6794.00,0.00
2024-12-08 17:15:20,83,5596,38,45,3795.31,6794.01,0.00
2024-12-08 17:15:20,83,5597,38,45,3777.86,6795.00,0.00
2024-12-08 17:15:20,84,5597,38,46,3732.88,6795.01,0.00
2024-12-08 17:15:20,83,5597,37,46,3775.42,6795.04,0.00
2024-12-08 17:15:20,82,5597,37,45,3815.66,6795.06,0.00
2024-12-08 17:15:20,81,5597,36,45,3852.71,6795.10,0.00
2024-12-08 17:15:20,81,5598,36,45,3875.90,6796.00,0.00
2024-12-08 17:15:20,82,5598,37,45,3828.63,6796.01,0.00
2024-12-08 17:15:20,81,5598,36,45,3839.06,6796.25,0.00
2024-12-08 17:15:20,81,5599,36,45,3872.28,6797.00,0.00
2024-12-08 17:15:20,82,5599,36,46,3825.05,6797.01,0.00
2024-12-08 17:15:20,81,5599,36,45,3864.74,6797.06,0.00
2024-12-08 17:15:20,81,5600,36,45,3868.65,6798.00,0.00
2024-12-08 17:15:20,82,5600,36,46,3821.47,6798.01,0.00
2024-12-08 17:15:20,81,5600,35,46,3818.49,6798.49,0.00
2024-12-08 17:15:20,81,5601,35,46,3851.59,6799.00,0.00
2024-12-08 17:15:20,82,5601,36,46,3804.62,6799.01,0.00
2024-12-08 17:15:20,81,5601,36,45,3845.73,6799.06,0.00
2024-12-08 17:15:20,81,5602,36,45,3849.64,6800.00,0.00
2024-12-08 17:15:20,82,5602,37,45,3802.69,6800.01,0.00
2024-12-08 17:15:20,81,5602,36,45,3847.14,6800.04,0.00
2024-12-08 17:15:20,81,5603,36,45,3832.57,6801.00,0.00
2024-12-08 17:15:20,82,5603,36,46,3785.83,6801.01,0.00
2024-12-08 17:15:20,81,5603,35,46,3830.07,6801.04,0.00
2024-12-08 17:15:20,80,5603,35,45,3872.00,6801.06,0.00
2024-12-08 17:15:20,80,5604,35,45,3876.80,6802.00,0.00
2024-12-08 17:15:20,81,5604,36,45,3828.94,6802.01,0.00
2024-12-08 17:15:20,80,5604,35,45,3874.27,6802.04,0.00
2024-12-08 17:15:20,79,5604,34,45,3876.98,6802.47,0.00
2024-12-08 17:15:20,79,5605,34,45,3910.09,6803.00,0.00
2024-12-08 17:15:20,80,5605,35,45,3861.21,6803.01,0.00
2024-12-08 17:15:20,79,5605,35,44,3904.08,6803.05,0.00
2024-12-08 17:15:20,79,5606,35,44,3908.94,6804.00,0.00
2024-12-08 17:15:20,80,5606,35,45,3860.08,6804.01,0.00
2024-12-08 17:15:20,79,5606,34,45,3860.77,6804.20,0.00
2024-12-08 17:15:20,79,5607,34,45,3893.15,6805.00,0.00
2024-12-08 17:15:20,80,5607,35,45,3844.48,6805.01,0.00
2024-12-08 17:15:20,79,5607,35,44,3888.00,6805.05,0.00
2024-12-08 17:15:20,78,5607,34,44,3921.29,6805.13,0.00
2024-12-08 17:15:20,78,5608,34,44,3949.75,6806.00,0.00
2024-12-08 17:15:20,79,5608,34,45,3899.75,6806.01,0.00
2024-12-08 17:15:20,78,5608,33,45,3920.14,6806.19,0.00
2024-12-08 17:15:20,78,5609,33,45,3935.49,6807.00,0.00
2024-12-08 17:15:20,79,5609,34,45,3885.68,6807.01,0.00
2024-12-08 17:15:20,78,5609,34,44,3931.15,6807.05,0.00
2024-12-08 17:15:20,78,5610,34,44,3936.94,6808.00,0.00
2024-12-08 17:15:20,79,5610,34,45,3887.11,6808.01,0.00
2024-12-08 17:15:21,79,5611,34,45,3872.17,6809.00,0.00
2024-12-08 17:15:21,80,5611,34,46,3823.76,6809.01,0.00
2024-12-08 17:15:21,79,5611,34,45,3867.01,6809.05,0.00
2024-12-08 17:15:21,79,5612,34,45,3871.87,6810.00,0.00
2024-12-08 17:15:21,80,5612,35,45,3823.47,6810.01,0.00
2024-12-08 17:15:21,80,5613,35,45,3807.86,6811.00,0.00
2024-12-08 17:15:21,81,5613,36,45,3760.85,6811.01,0.00
2024-12-08 17:15:21,80,5613,36,44,3803.62,6811.05,0.00
2024-12-08 17:15:21,80,5614,36,44,3807.57,6812.00,0.00
2024-12-08 17:15:21,81,5614,37,44,3760.56,6812.01,0.00
2024-12-08 17:15:21,81,5615,37,44,3744.29,6813.00,0.00
2024-12-08 17:15:21,82,5615,38,44,3698.63,6813.01,0.00
2024-12-08 17:15:21,81,5615,38,43,3740.10,6813.05,0.00
2024-12-08 17:15:21,81,5616,38,43,3743.16,6814.00,0.00
2024-12-08 17:15:21,82,5616,38,44,3697.51,6814.01,0.00
2024-12-08 17:15:21,81,5616,37,44,3676.88,6814.49,0.00
2024-12-08 17:15:21,81,5617,37,44,3726.88,6815.00,0.00
2024-12-08 17:15:21,82,5617,38,44,3681.43,6815.01,0.00
2024-12-08 17:15:21,81,5617,38,43,3723.53,6815.05,0.00
2024-12-08 17:15:21,81,5618,38,43,3726.58,6816.00,0.00
2024-12-08 17:15:21,82,5618,38,44,3681.14,6816.01,0.00
2024-12-08 17:15:21,81,5618,38,43,3706.41,6816.05,0.00
2024-12-08 17:15:21,80,5618,37,43,3736.62,6816.28,0.00
2024-12-08 17:15:21,80,5619,37,43,3755.83,6817.00,0.00
2024-12-08 17:15:21,81,5619,37,44,3709.46,6817.01,0.00
2024-12-08 17:15:21,80,5619,36,44,3736.24,6817.04,0.00
2024-12-08 17:15:21,79,5619,35,44,3736.24,6817.48,0.00
2024-12-08 17:15:21,79,5620,35,44,3787.53,6818.00,0.00
2024-12-08 17:15:21,80,5620,36,44,3740.18,6818.01,0.00
2024-12-08 17:15:21,80,5621,36,44,3724.54,6819.00,0.00
2024-12-08 17:15:21,81,5621,37,44,3678.56,6819.01,0.00
2024-12-08 17:15:21,80,5621,37,43,3712.96,6819.04,0.00
2024-12-08 17:15:21,79,5621,36,43,3747.88,6819.10,0.00
2024-12-08 17:15:21,79,5622,36,43,3773.44,6820.00,0.00
2024-12-08 17:15:21,80,5622,36,44,3726.28,6820.01,0.00
2024-12-08 17:15:21,79,5622,36,43,3770.00,6820.04,0.00
2024-12-08 17:15:21,79,5623,36,43,3774.00,6821.00,0.00
2024-12-08 17:15:21,80,5623,37,43,3726.82,6821.01,0.00
2024-12-08 17:15:21,80,5624,37,43,3711.17,6822.00,0.00
2024-12-08 17:15:21,81,5624,37,44,3665.35,6822.01,0.00
2024-12-08 17:15:21,80,5624,37,43,3705.21,6822.06,0.00
2024-12-08 17:15:21,80,5625,37,43,3710.00,6823.00,0.00
2024-12-08 17:15:21,81,5625,37,44,3664.20,6823.01,0.00
2024-12-08 17:15:21,80,5625,36,44,3708.31,6823.04,0.00
2024-12-08 17:15:21,79,5625,35,44,3754.39,6823.04,0.00
2024-12-08 17:15:21,79,5626,35,44,3741.11,6824.00,0.00
2024-12-08 17:15:21,80,5626,36,44,3694.34,6824.01,0.00
2024-12-08 17:15:21,79,5626,36,43,3736.80,6824.04,0.00
2024-12-08 17:15:21,78,5626,35,43,3752.45,6824.37,0.00
2024-12-08 17:15:21,78,5627,35,43,3797.50,6825.00,0.00
2024-12-08 17:15:21,79,5627,36,43,3749.43,6825.01,0.00
2024-12-08 17:15:21,79,5628,36,43,3734.43,6826.00,0.00
2024-12-08 17:15:21,80,5628,36,44,3687.75,6826.01,0.00
2024-12-08 17:15:21,79,5628,36,43,3730.12,6826.04,0.00
2024-12-08 17:15:21,79,5629,36,43,3734.11,6827.00,0.00
2024-12-08 17:15:21,80,5629,37,43,3687.43,6827.01,0.00
2024-12-08 17:15:22,81,5628,38,43,3607.43,6827.30,0.00
2024-12-08 17:15:22,81,5629,38,43,3693.86,6828.00,0.00
2024-12-08 17:15:22,82,5629,38,44,3648.82,6828.01,0.00
2024-12-08 17:15:22,81,5629,38,43,3690.50,6828.04,0.00
2024-12-08 17:15:22,81,5630,38,43,3777.03,6829.00,0.00
2024-12-08 17:15:22,82,5630,38,44,3730.97,6829.01,0.00
2024-12-08 17:15:22,82,5631,38,44,3714.02,6830.00,0.00
2024-12-08 17:15:22,83,5631,38,45,3669.27,6830.01,0.00
2024-12-08 17:15:22,82,5631,38,44,3711.53,6830.04,0.00
2024-12-08 17:15:22,81,5631,37,44,3711.98,6830.47,0.00
2024-12-08 17:15:22,81,5632,37,44,3760.42,6831.00,0.00
2024-12-08 17:15:22,82,5632,38,44,3714.56,6831.01,0.00
2024-12-08 17:15:22,81,5632,38,43,3741.04,6831.04,0.00
2024-12-08 17:15:22,80,5632,37,43,3748.66,6831.43,0.00
2024-12-08 17:15:22,80,5633,37,43,3795.18,6832.00,0.00
2024-12-08 17:15:22,81,5633,37,44,3748.32,6832.01,0.00
2024-12-08 17:15:22,80,5633,37,43,3775.54,6832.04,0.00
2024-12-08 17:15:22,80,5634,37,43,3778.65,6833.00,0.00
2024-12-08 17:15:22,81,5634,38,43,3732.00,6833.01,0.00
2024-12-08 17:15:22,80,5634,38,42,3759.87,6833.04,0.00
2024-12-08 17:15:22,80,5635,38,42,3762.97,6834.00,0.00
2024-12-08 17:15:22,81,5635,39,42,3716.51,6834.01,0.00
2024-12-08 17:15:22,80,5635,39,41,3744.19,6834.04,0.00
2024-12-08 17:15:22,79,5635,38,41,3770.00,6834.19,0.00
2024-12-08 17:15:22,79,5636,38,41,3801.64,6835.00,0.00
2024-12-08 17:15:22,80,5636,38,42,3754.12,6835.01,0.00
2024-12-08 17:15:22,79,5636,38,41,3780.03,6835.06,0.00
2024-12-08 17:15:22,79,5637,38,41,3785.76,6836.00,0.00
2024-12-08 17:15:22,80,5637,38,42,3738.44,6836.01,0.00
2024-12-08 17:15:22,79,5637,37,42,3766.73,6836.05,0.00
2024-12-08 17:15:22,80,5636,38,42,3700.00,6836.11,0.00
2024-12-08 17:15:22,81,5635,38,43,3698.33,6836.42,0.00
2024-12-08 17:15:22,81,5636,38,43,3781.45,6837.00,0.00
2024-12-08 17:15:22,82,5636,38,44,3735.34,6837.01,0.00
2024-12-08 17:15:22,81,5636,38,43,3777.25,6837.06,0.00
2024-12-08 17:15:22,80,5636,37,43,3780.19,6837.46,0.00
2024-12-08 17:15:22,80,5637,37,43,4000.23,6838.00,0.00
2024-12-08 17:15:22,81,5637,38,43,3950.84,6838.01,0.00
2024-12-08 17:15:22,81,5638,38,43,3934.53,6839.00,0.00
2024-12-08 17:15:22,82,5638,38,44,3886.55,6839.01,0.00
2024-12-08 17:15:22,81,5638,38,43,3930.33,6839.06,0.00
2024-12-08 17:15:22,81,5639,38,43,3934.27,6840.00,0.00
2024-12-08 17:15:22,82,5639,38,44,3886.29,6840.01,0.00
2024-12-08 17:15:22,82,5640,38,44,3869.33,6841.00,0.00
2024-12-08 17:15:22,83,5640,39,44,3822.72,6841.01,0.00
2024-12-08 17:15:22,82,5640,38,44,3836.04,6841.26,0.00
2024-12-08 17:15:22,82,5641,38,44,3852.38,6842.00,0.00
2024-12-08 17:15:22,83,5641,39,44,3805.96,6842.01,0.00
2024-12-08 17:15:22,82,5641,38,44,3787.62,6842.72,0.00
2024-12-08 17:15:22,82,5642,38,44,3835.42,6843.00,0.00
2024-12-08 17:15:22,83,5642,39,44,3789.21,6843.01,0.00
2024-12-08 17:15:22,83,5643,39,44,3771.62,6844.00,0.00
2024-12-08 17:15:22,84,5643,40,44,3726.72,6844.01,0.00
2024-12-08 17:15:22,83,5643,40,43,3757.61,6844.06,0.00
2024-12-08 17:15:22,82,5643,39,43,3735.45,6844.90,0.00
2024-12-08 17:15:22,82,5644,39,43,3812.33,6845.00,0.00
2024-12-08 17:15:22,83,5644,40,43,3766.40,6845.01,0.00
2024-12-08 17:15:22,84,5643,40,44,3720.75,6845.05,0.00
2024-12-08 17:15:22,83,5643,40,43,3791.98,6845.07,0.00
2024-12-08 17:15:22,82,5643,39,43,3825.73,6845.17,0.00
2024-12-08 17:15:23,82,5644,39,43,3852.96,6846.00,0.00
2024-12-08 17:15:23,83,5644,39,44,3806.54,6846.01,0.00
2024-12-08 17:15:23,84,5643,40,44,3758.79,6846.07,0.00
2024-12-08 17:15:23,83,5643,40,43,3840.39,6846.08,0.00
2024-12-08 17:15:23,82,5643,39,43,3843.13,6846.49,0.00
2024-12-08 17:15:23,82,5644,39,43,3975.43,6847.00,0.00
2024-12-08 17:15:23,83,5644,40,43,3927.54,6847.01,0.00
2024-12-08 17:15:23,82,5644,40,42,3956.26,6847.07,0.00
2024-12-08 17:15:23,82,5645,40,42,4043.66,6848.00,0.00
2024-12-08 17:15:23,83,5645,41,42,3994.94,6848.01,0.00
2024-12-08 17:15:23,82,5645,41,41,4024.48,6848.07,0.00
2024-12-08 17:15:23,81,5645,40,41,4072.48,6848.09,0.00
2024-12-08 17:15:23,81,5646,40,41,4095.02,6849.00,0.00
2024-12-08 17:15:23,82,5646,40,42,4045.08,6849.01,0.00
2024-12-08 17:15:23,81,5646,40,41,4055.31,6849.09,0.00
2024-12-08 17:15:23,81,5647,40,41,4077.86,6850.00,0.00
2024-12-08 17:15:23,82,5647,40,42,4028.13,6850.01,0.00
2024-12-08 17:15:23,81,5647,40,41,4055.06,6850.09,0.00
2024-12-08 17:15:23,81,5648,40,41,4060.70,6851.00,0.00
2024-12-08 17:15:23,82,5648,41,41,4011.18,6851.01,0.00
2024-12-08 17:15:23,82,5649,41,41,3994.21,6852.00,0.00
2024-12-08 17:15:23,83,5649,41,42,3946.09,6852.01,0.00
2024-12-08 17:15:23,82,5649,41,41,3982.55,6852.11,0.00
2024-12-08 17:15:23,82,5650,41,41,3988.95,6853.00,0.00
2024-12-08 17:15:23,83,5650,41,42,3940.89,6853.01,0.00
2024-12-08 17:15:23,82,5650,40,42,3986.45,6853.04,0.00
2024-12-08 17:15:23,82,5651,40,42,3971.14,6854.00,0.00
2024-12-08 17:15:23,83,5651,41,42,3923.29,6854.01,0.00
2024-12-08 17:15:23,82,5651,41,41,3961.14,6854.10,0.00
2024-12-08 17:15:23,82,5652,41,41,3966.70,6855.00,0.00
2024-12-08 17:15:23,83,5652,41,42,3918.91,6855.01,0.00
2024-12-08 17:15:23,82,5652,40,42,3965.87,6855.01,0.00
2024-12-08 17:15:23,82,5653,40,42,3948.89,6856.00,0.00
2024-12-08 17:15:23,83,5653,40,43,3901.31,6856.01,0.00
2024-12-08 17:15:23,82,5653,40,42,3940.56,6856.09,0.00
2024-12-08 17:15:23,82,5654,40,42,3945.28,6857.00,0.00
2024-12-08 17:15:23,83,5654,40,43,3897.75,6857.01,0.00
2024-12-08 17:15:23,83,5655,40,43,3880.14,6858.00,0.00
2024-12-08 17:15:23,84,5655,41,43,3833.95,6858.01,0.00
2024-12-08 17:15:23,83,5655,41,42,3868.61,6858.11,0.00
2024-12-08 17:15:23,83,5656,41,42,3874.09,6859.00,0.00
2024-12-08 17:15:23,84,5656,41,43,3827.97,6859.01,0.00
2024-12-08 17:15:23,84,5657,41,43,3808.97,6860.00,0.00
2024-12-08 17:15:23,85,5657,42,43,3764.16,6860.01,0.00
2024-12-08 17:15:23,84,5657,42,42,3798.38,6860.11,0.00
2024-12-08 17:15:23,83,5657,41,42,3804.83,6860.57,0.00
2024-12-08 17:15:23,83,5658,41,42,3858.08,6861.00,0.00
2024-12-08 17:15:23,84,5658,41,43,3812.15,6861.01,0.00
2024-12-08 17:15:23,84,5659,41,43,3791.70,6862.00,0.00
2024-12-08 17:15:23,85,5659,41,44,3747.09,6862.01,0.00
2024-12-08 17:15:23,84,5659,40,44,3789.27,6862.04,0.00
2024-12-08 17:15:23,83,5659,40,43,3826.67,6862.10,0.00
2024-12-08 17:15:23,83,5660,40,43,3828.16,6863.00,0.00
2024-12-08 17:15:23,84,5660,41,43,3782.59,6863.01,0.00
2024-12-08 17:15:23,83,5660,40,43,3790.66,6863.27,0.00
2024-12-08 17:15:24,83,5661,40,43,3806.86,6864.00,0.00
2024-12-08 17:15:24,84,5661,41,43,3761.54,6864.01,0.00
2024-12-08 17:15:24,83,5661,41,42,3797.79,6864.10,0.00
2024-12-08 17:15:24,83,5662,41,42,3798.78,6865.00,0.00
2024-12-08 17:15:24,84,5662,41,43,3753.56,6865.01,0.00
2024-12-08 17:15:24,83,5662,41,42,3787.36,6865.10,0.00
2024-12-08 17:15:24,83,5663,41,42,3792.02,6866.00,0.00
2024-12-08 17:15:24,84,5663,42,42,3746.87,6866.01,0.00
2024-12-08 17:15:24,84,5664,42,42,3725.23,6867.00,0.00
2024-12-08 17:15:24,85,5664,42,43,3681.40,6867.01,0.00
2024-12-08 17:15:24,84,5664,42,42,3714.63,6867.11,0.00
2024-12-08 17:15:24,84,5665,42,42,3711.70,6868.00,0.00
2024-12-08 17:15:24,85,5665,42,43,3668.03,6868.01,0.00
2024-12-08 17:15:24,84,5665,41,43,3678.24,6868.26,0.00
2024-12-08 17:15:24,84,5666,41,43,3680.12,6869.00,0.00
2024-12-08 17:15:24,85,5666,42,43,3636.83,6869.01,0.00
2024-12-08 17:15:24,84,5666,42,42,3670.34,6869.11,0.00
2024-12-08 17:15:24,84,5667,42,42,3661.05,6870.00,0.00
2024-12-08 17:15:24,85,5667,42,43,3617.98,6870.01,0.00
2024-12-08 17:15:24,84,5667,41,43,3625.95,6870.27,0.00
2024-12-08 17:15:24,84,5668,41,43,3634.44,6871.00,0.00
2024-12-08 17:15:24,85,5668,42,43,3591.68,6871.01,0.00
2024-12-08 17:15:24,84,5668,42,42,3623.02,6871.13,0.00
2024-12-08 17:15:24,84,5669,42,42,3625.92,6872.00,0.00
2024-12-08 17:15:24,85,5669,43,42,3583.26,6872.01,0.00
2024-12-08 17:15:24,84,5669,42,42,3622.66,6872.05,0.00
2024-12-08 17:15:24,84,5670,42,42,3603.88,6873.00,0.00
2024-12-08 17:15:24,85,5670,43,42,3561.48,6873.01,0.00
2024-12-08 17:15:24,84,5670,42,42,3596.54,6873.11,0.00
2024-12-08 17:15:24,83,5670,42,41,3637.39,6873.11,0.00
2024-12-08 17:15:24,83,5671,42,41,3642.86,6874.00,0.00
2024-12-08 17:15:24,84,5671,43,41,3599.50,6874.01,0.00
2024-12-08 17:15:24,84,5672,43,41,3579.15,6875.00,0.00
2024-12-08 17:15:24,85,5672,43,42,3537.04,6875.01,0.00
2024-12-08 17:15:24,84,5672,42,42,3575.75,6875.05,0.00
2024-12-08 17:15:24,83,5672,42,41,3613.03,6875.10,0.00
2024-12-08 17:15:24,83,5673,42,41,3614.30,6876.00,0.00
2024-12-08 17:15:24,84,5673,42,42,3571.27,6876.01,0.00
2024-12-08 17:15:24,83,5673,41,42,3609.35,6876.07,0.00
2024-12-08 17:15:24,82,5673,40,42,3609.98,6876.45,0.00
2024-12-08 17:15:24,82,5674,40,42,3639.49,6877.00,0.00
2024-12-08 17:15:24,83,5674,41,42,3595.64,6877.01,0.00
2024-12-08 17:15:24,82,5674,41,41,3632.80,6877.09,0.00
2024-12-08 17:15:24,82,5675,41,41,3637.50,6878.00,0.00
2024-12-08 17:15:24,83,5675,42,41,3593.68,6878.01,0.00
2024-12-08 17:15:24,82,5675,41,41,3629.14,6878.10,0.00
2024-12-08 17:15:24,81,5675,40,41,3645.11,6878.26,0.00
2024-12-08 17:15:24,81,5675,40,41,3679.51,6879.00,0.00
2024-12-08 17:15:24,82,5675,40,42,3634.64,6879.01,0.00
2024-12-08 17:15:24,81,5675,40,41,3671.04,6879.10,0.00
2024-12-08 17:15:24,80,5675,39,41,3705.79,6879.25,0.00
2024-12-08 17:15:24,80,5676,39,41,3717.13,6880.00,0.00
2024-12-08 17:15:24,81,5676,40,41,3671.24,6880.01,0.00
2024-12-08 17:15:24,80,5676,39,41,3677.61,6880.18,0.00
2024-12-08 17:15:24,80,5677,39,41,3698.91,6881.00,0.00
2024-12-08 17:15:24,81,5677,40,41,3653.25,6881.01,0.00
2024-12-08 17:15:24,80,5677,39,41,3695.49,6881.05,0.00
2024-12-08 17:15:24,79,5677,39,40,3735.31,6881.10,0.00
2024-12-08 17:15:25,79,5678,39,40,3733.89,6882.00,0.00
2024-12-08 17:15:25,80,5678,40,40,3687.21,6882.01,0.00
2024-12-08 17:15:25,79,5678,39,40,3730.42,6882.05,0.00
2024-12-08 17:15:25,79,5679,39,40,3709.55,6883.00,0.00
2024-12-08 17:15:25,80,5679,40,40,3663.18,6883.01,0.00
2024-12-08 17:15:25,79,5679,40,39,3700.85,6883.09,0.00
2024-12-08 17:15:25,79,5680,40,39,3702.74,6884.00,0.00
2024-12-08 17:15:25,80,5680,41,39,3656.46,6884.01,0.00
2024-12-08 17:15:25,79,5680,40,39,3669.69,6884.23,0.00
2024-12-08 17:15:25,79,5681,40,39,3680.74,6885.00,0.00
2024-12-08 17:15:25,80,5681,40,40,3634.73,6885.01,0.00
2024-12-08 17:15:25,79,5681,40,39,3672.04,6885.09,0.00
2024-12-08 17:15:25,78,5681,39,39,3686.37,6885.47,0.00
2024-12-08 17:15:25,78,5682,39,39,3721.17,6886.00,0.00
2024-12-08 17:15:25,79,5682,40,39,3674.06,6886.01,0.00
2024-12-08 17:15:25,78,5682,39,39,3689.44,6886.22,0.00
2024-12-08 17:15:25,78,5683,39,39,3702.25,6887.00,0.00
2024-12-08 17:15:25,79,5683,40,39,3655.38,6887.01,0.00
2024-12-08 17:15:25,78,5683,40,38,3694.32,6887.09,0.00
2024-12-08 17:15:25,78,5684,40,38,3701.13,6888.00,0.00
2024-12-08 17:15:25,79,5684,40,39,3654.28,6888.01,0.00
2024-12-08 17:15:25,78,5684,39,39,3668.48,6888.13,0.00
2024-12-08 17:15:25,79,5683,40,39,3617.71,6888.22,0.00
2024-12-08 17:15:25,79,5684,40,39,3714.20,6889.00,0.00
2024-12-08 17:15:25,80,5684,40,40,3667.77,6889.01,0.00
2024-12-08 17:15:25,79,5684,39,40,3701.13,6889.06,0.00
2024-12-08 17:15:25,78,5684,39,39,3740.64,6889.10,0.00
2024-12-08 17:15:25,78,5685,39,39,3852.34,6890.00,0.00
2024-12-08 17:15:25,79,5685,39,40,3803.57,6890.01,0.00
2024-12-08 17:15:25,79,5686,39,40,3782.35,6891.00,0.00
2024-12-08 17:15:25,80,5686,39,41,3735.07,6891.01,0.00
2024-12-08 17:15:25,79,5686,39,40,3769.06,6891.10,0.00
2024-12-08 17:15:25,79,5687,39,40,3767.80,6892.00,0.00
2024-12-08 17:15:25,80,5687,39,41,3720.71,6892.01,0.00
2024-12-08 17:15:25,79,5687,39,40,3764.09,6892.05,0.00
2024-12-08 17:15:25,78,5687,38,40,3773.90,6892.30,0.00
2024-12-08 17:15:25,78,5688,38,40,3789.56,6893.00,0.00
2024-12-08 17:15:25,79,5688,38,41,3741.59,6893.01,0.00
2024-12-08 17:15:25,78,5688,38,40,3779.85,6893.09,0.00
2024-12-08 17:15:25,78,5689,38,40,3775.76,6894.00,0.00
2024-12-08 17:15:25,79,5689,38,41,3727.97,6894.01,0.00
2024-12-08 17:15:25,78,5689,37,41,3737.80,6894.22,0.00
2024-12-08 17:15:25,79,5688,37,42,3618.68,6894.94,0.00
2024-12-08 17:15:25,79,5689,37,42,3739.65,6895.00,0.00
2024-12-08 17:15:25,80,5689,38,42,3692.90,6895.01,0.00
2024-12-08 17:15:25,79,5689,38,41,3729.19,6895.09,0.00
2024-12-08 17:15:25,78,5689,38,40,3759.14,6895.26,0.00
2024-12-08 17:15:25,78,5690,38,40,3864.55,6896.00,0.00
2024-12-08 17:15:25,79,5690,38,41,3815.63,6896.01,0.00
2024-12-08 17:15:25,79,5691,38,41,3798.78,6897.00,0.00
2024-12-08 17:15:25,80,5691,39,41,3751.30,6897.01,0.00
2024-12-08 17:15:25,79,5691,39,40,3788.32,6897.09,0.00
2024-12-08 17:15:25,80,5690,40,40,3670.68,6897.89,0.00
2024-12-08 17:15:25,80,5691,40,40,3754.41,6898.00,0.00
2024-12-08 17:15:25,81,5691,40,41,3708.06,6898.01,0.00
2024-12-08 17:15:25,81,5692,40,41,3776.52,6899.00,0.00
2024-12-08 17:15:25,82,5692,40,42,3730.47,6899.01,0.00
2024-12-08 17:15:25,81,5692,40,41,3767.17,6899.09,0.00
2024-12-08 17:15:25,81,5693,40,41,3771.56,6900.00,0.00
2024-12-08 17:15:25,82,5693,41,41,3725.56,6900.01,0.00
2024-12-08 17:15:26,82,5694,41,41,3705.88,6901.00,0.00
2024-12-08 17:15:26,83,5694,42,41,3661.23,6901.01,0.00
2024-12-08 17:15:26,84,5693,43,41,3553.42,6901.67,0.00
2024-12-08 17:15:26,84,5694,43,41,3616.96,6902.00,0.00
2024-12-08 17:15:26,85,5694,43,42,3574.40,6902.01,0.00
2024-12-08 17:15:26,84,5694,43,41,3596.01,6902.08,0.00
2024-12-08 17:15:26,83,5694,42,41,3628.57,6902.23,0.00
2024-12-08 17:15:26,83,5695,42,41,3725.51,6903.00,0.00
2024-12-08 17:15:26,84,5695,42,42,3681.16,6903.01,0.00
2024-12-08 17:15:26,83,5695,41,42,3722.19,6903.05,0.00
2024-12-08 17:15:26,83,5696,41,42,3699.98,6904.00,0.00
2024-12-08 17:15:26,84,5696,41,43,3655.93,6904.01,0.00
2024-12-08 17:15:26,83,5696,41,42,3690.84,6904.08,0.00
2024-12-08 17:15:26,83,5697,41,42,3689.30,6905.00,0.00
2024-12-08 17:15:26,84,5697,41,43,3645.38,6905.01,0.00
2024-12-08 17:15:26,84,5698,41,43,3623.43,6906.00,0.00
2024-12-08 17:15:26,85,5698,42,43,3580.80,6906.01,0.00
2024-12-08 17:15:26,84,5698,42,42,3615.22,6906.08,0.00
2024-12-08 17:15:26,83,5698,41,42,3627.26,6906.39,0.00
2024-12-08 17:15:26,83,5699,41,42,3665.07,6907.00,0.00
2024-12-08 17:15:26,84,5699,42,42,3621.43,6907.01,0.00
2024-12-08 17:15:26,83,5699,41,42,3631.01,6907.25,0.00
2024-12-08 17:15:26,83,5700,41,42,3642.36,6908.00,0.00
2024-12-08 17:15:26,84,5700,41,43,3599.00,6908.01,0.00
2024-12-08 17:15:26,83,5700,40,43,3640.70,6908.04,0.00
2024-12-08 17:15:26,82,5700,40,42,3680.05,6908.07,0.00
2024-12-08 17:15:26,82,5701,40,42,3679.87,6909.00,0.00
2024-12-08 17:15:26,83,5701,41,42,3635.53,6909.01,0.00
2024-12-08 17:15:26,82,5701,40,42,3647.90,6909.23,0.00
2024-12-08 17:15:26,82,5702,40,42,3655.87,6910.00,0.00
2024-12-08 17:15:26,83,5702,41,42,3611.83,6910.01,0.00
2024-12-08 17:15:26,82,5702,41,41,3648.30,6910.09,0.00
2024-12-08 17:15:26,81,5702,40,41,3655.92,6910.42,0.00
2024-12-08 17:15:26,81,5703,40,41,3692.80,6911.00,0.00
2024-12-08 17:15:26,82,5703,40,42,3647.77,6911.01,0.00
2024-12-08 17:15:26,81,5703,39,42,3690.25,6911.04,0.00
2024-12-08 17:15:26,80,5703,38,42,3720.83,6911.05,0.00
2024-12-08 17:15:26,79,5703,37,42,3767.05,6911.05,0.00
2024-12-08 17:15:26,79,5704,37,42,3764.54,6912.00,0.00
2024-12-08 17:15:26,80,5704,38,42,3717.48,6912.01,0.00
2024-12-08 17:15:26,79,5704,38,41,3758.42,6912.05,0.00
2024-12-08 17:15:26,79,5705,38,41,3755.01,6913.00,0.00
2024-12-08 17:15:26,80,5705,39,41,3708.07,6913.01,0.00
2024-12-08 17:15:26,79,5705,38,41,3752.39,6913.04,0.00
2024-12-08 17:15:26,78,5705,37,41,3767.76,6913.23,0.00
2024-12-08 17:15:26,78,5706,37,41,3793.37,6914.00,0.00
2024-12-08 17:15:26,79,5706,38,41,3745.35,6914.01,0.00
2024-12-08 17:15:26,78,5706,38,40,3788.94,6914.04,0.00
2024-12-08 17:15:26,78,5707,38,40,3780.40,6915.00,0.00
2024-12-08 17:15:26,79,5707,38,41,3732.55,6915.01,0.00
2024-12-08 17:15:26,78,5707,38,40,3697.16,6915.85,0.00
2024-12-08 17:15:26,78,5708,38,40,3757.57,6916.00,0.00
2024-12-08 17:15:26,79,5708,38,41,3710.01,6916.01,0.00
2024-12-08 17:15:26,78,5708,38,40,3754.92,6916.04,0.00
2024-12-08 17:15:26,78,5709,38,40,3757.88,6917.00,0.00
2024-12-08 17:15:26,79,5709,39,40,3710.31,6917.01,0.00
2024-12-08 17:15:26,78,5709,39,39,3737.49,6917.04,0.00
2024-12-08 17:15:26,78,5710,39,39,3739.18,6918.00,0.00
2024-12-08 17:15:26,79,5710,40,39,3691.85,6918.01,0.00
2024-12-08 17:15:26,79,5711,40,39,3669.39,6919.00,0.00
2024-12-08 17:15:26,80,5711,41,39,3623.52,6919.01,0.00
2024-12-08 17:15:27,79,5711,41,38,3665.89,6919.04,0.00
2024-12-08 17:15:27,79,5712,41,38,3658.67,6920.00,0.00
2024-12-08 17:15:27,80,5712,42,38,3612.93,6920.01,0.00
2024-12-08 17:15:27,79,5712,41,38,3607.91,6920.23,0.00
2024-12-08 17:15:27,79,5713,41,38,3626.86,6921.00,0.00
2024-12-08 17:15:27,80,5713,42,38,3581.52,6921.01,0.00
2024-12-08 17:15:27,79,5713,42,37,3621.34,6921.08,0.00
2024-12-08 17:15:27,78,5713,41,37,3642.17,6921.45,0.00
2024-12-08 17:15:27,78,5714,41,37,3656.37,6922.00,0.00
2024-12-08 17:15:27,79,5714,41,38,3610.09,6922.01,0.00
2024-12-08 17:15:27,78,5714,40,38,3655.61,6922.01,0.00
2024-12-08 17:15:27,78,5715,40,38,3619.67,6923.00,0.00
2024-12-08 17:15:27,79,5715,41,38,3573.85,6923.01,0.00
2024-12-08 17:15:27,78,5715,40,38,3617.01,6923.04,0.00
2024-12-08 17:15:27,77,5715,40,37,3659.49,6923.05,0.00
2024-12-08 17:15:27,77,5716,40,37,3640.99,6924.00,0.00
2024-12-08 17:15:27,78,5716,41,37,3594.31,6924.01,0.00
2024-12-08 17:15:27,77,5716,40,37,3638.30,6924.01,0.00
2024-12-08 17:15:27,77,5717,40,37,3612.29,6925.00,0.00
2024-12-08 17:15:27,78,5717,41,37,3565.98,6925.01,0.00
2024-12-08 17:15:27,77,5717,41,36,3605.11,6925.05,0.00
2024-12-08 17:15:27,76,5717,40,36,3599.65,6925.70,0.00
2024-12-08 17:15:27,76,5718,40,36,3651.83,6926.00,0.00
2024-12-08 17:15:27,77,5718,41,36,3604.40,6926.01,0.00
2024-12-08 17:15:27,77,5719,41,36,3583.07,6927.00,0.00
2024-12-08 17:15:27,78,5719,42,36,3537.13,6927.01,0.00
2024-12-08 17:15:27,77,5719,42,35,3576.78,6927.05,0.00
2024-12-08 17:15:27,77,5720,42,35,3573.19,6928.00,0.00
2024-12-08 17:15:27,78,5720,42,36,3527.38,6928.01,0.00
2024-12-08 17:15:27,79,5719,43,36,3427.55,6928.33,0.00
2024-12-08 17:15:27,79,5720,43,36,3481.13,6929.00,0.00
2024-12-08 17:15:27,80,5720,43,37,3437.62,6929.01,0.00
2024-12-08 17:15:27,79,5720,42,37,3475.88,6929.05,0.00
2024-12-08 17:15:27,78,5720,42,36,3516.88,6929.05,0.00
2024-12-08 17:15:27,77,5720,41,36,3550.90,6929.21,0.00
2024-12-08 17:15:27,76,5720,40,36,3561.76,6929.59,0.00
2024-12-08 17:15:27,76,5721,40,36,3715.29,6930.00,0.00
2024-12-08 17:15:27,77,5721,41,36,3667.04,6930.01,0.00
2024-12-08 17:15:27,76,5721,40,36,3641.73,6930.74,0.00
2024-12-08 17:15:27,76,5722,40,36,3686.54,6931.00,0.00
2024-12-08 17:15:27,77,5722,40,37,3638.66,6931.01,0.00
2024-12-08 17:15:27,76,5722,40,36,3681.07,6931.05,0.00
2024-12-08 17:15:27,76,5723,40,36,3665.14,6932.00,0.00
2024-12-08 17:15:27,77,5723,41,36,3617.54,6932.01,0.00
2024-12-08 17:15:27,76,5723,40,36,3538.80,6932.84,0.00
2024-12-08 17:15:27,76,5724,40,36,3618.51,6933.00,0.00
2024-12-08 17:15:27,77,5724,40,37,3571.52,6933.01,0.00
2024-12-08 17:15:27,76,5724,40,36,3613.05,6933.05,0.00
2024-12-08 17:15:27,76,5725,40,36,3614.47,6934.00,0.00
2024-12-08 17:15:27,77,5725,41,36,3567.52,6934.01,0.00
2024-12-08 17:15:27,76,5725,40,36,3579.84,6934.24,0.00
2024-12-08 17:15:27,76,5726,40,36,3590.41,6935.00,0.00
2024-12-08 17:15:27,77,5726,40,37,3543.78,6935.01,0.00
2024-12-08 17:15:27,76,5726,40,36,3584.03,6935.07,0.00
2024-12-08 17:15:27,76,5727,40,36,3581.38,6936.00,0.00
2024-12-08 17:15:27,77,5727,41,36,3534.87,6936.01,0.00
2024-12-08 17:15:27,76,5727,40,36,3549.45,6936.11,0.00
2024-12-08 17:15:27,76,5728,40,36,3569.16,6937.00,0.00
2024-12-08 17:15:27,77,5728,40,37,3522.81,6937.01,0.00
2024-12-08 17:15:27,76,5728,40,36,3562.78,6937.07,0.00
2024-12-08 17:15:27,75,5728,40,35,3577.95,6937.47,0.00
2024-12-08 17:15:27,74,5728,39,35,3620.96,6937.54,0.00
2024-12-08 17:15:28,74,5729,39,35,3660.60,6938.00,0.00
2024-12-08 17:15:28,75,5729,40,35,3611.79,6938.01,0.00
2024-12-08 17:15:28,75,5730,40,35,3589.91,6939.00,0.00
2024-12-08 17:15:28,76,5730,41,35,3542.67,6939.01,0.00
2024-12-08 17:15:28,75,5730,41,34,3583.44,6939.07,0.00
2024-12-08 17:15:28,74,5730,40,34,3608.00,6939.37,0.00
2024-12-08 17:15:28,75,5729,40,35,3499.85,6939.87,0.00
2024-12-08 17:15:28,75,5730,40,35,3592.50,6940.00,0.00
2024-12-08 17:15:28,76,5730,41,35,3545.23,6940.01,0.00
2024-12-08 17:15:28,76,5731,41,35,3619.05,6941.00,0.00
2024-12-08 17:15:28,77,5731,42,35,3572.05,6941.01,0.00
2024-12-08 17:15:28,76,5731,41,35,3618.14,6941.01,0.00
2024-12-08 17:15:28,75,5731,41,34,3661.75,6941.05,0.00
2024-12-08 17:15:28,75,5732,41,34,3669.74,6942.00,0.00
2024-12-08 17:15:28,76,5732,41,35,3621.45,6942.01,0.00
2024-12-08 17:15:28,75,5732,41,34,3664.61,6942.07,0.00
2024-12-08 17:15:28,75,5733,41,34,3674.35,6943.00,0.00
2024-12-08 17:15:28,76,5733,41,35,3626.01,6943.01,0.00
2024-12-08 17:15:28,76,5734,41,35,3612.57,6944.00,0.00
2024-12-08 17:15:28,77,5734,42,35,3565.66,6944.01,0.00
2024-12-08 17:15:28,76,5734,41,35,3611.66,6944.01,0.00
2024-12-08 17:15:28,75,5734,41,34,3653.34,6944.05,0.00
2024-12-08 17:15:28,74,5734,40,34,3690.92,6944.22,0.00
2024-12-08 17:15:28,74,5735,40,34,3707.27,6945.00,0.00
2024-12-08 17:15:28,75,5735,41,34,3657.84,6945.01,0.00
2024-12-08 17:15:28,74,5735,40,34,3673.58,6945.22,0.00
2024-12-08 17:15:28,74,5736,40,34,3680.78,6946.00,0.00
2024-12-08 17:15:28,75,5736,40,35,3631.70,6946.01,0.00
2024-12-08 17:15:28,74,5736,39,35,3679.84,6946.01,0.00
2024-12-08 17:15:28,73,5736,39,34,3725.50,6946.04,0.00
2024-12-08 17:15:28,73,5737,39,34,3719.41,6947.00,0.00
2024-12-08 17:15:28,74,5737,39,35,3669.15,6947.01,0.00
2024-12-08 17:15:28,73,5737,38,35,3649.58,6947.45,0.00
2024-12-08 17:15:28,74,5736,38,36,3589.08,6947.64,0.00
2024-12-08 17:15:28,74,5737,38,36,3733.76,6948.00,0.00
2024-12-08 17:15:28,75,5737,39,36,3683.98,6948.01,0.00
2024-12-08 17:15:28,74,5737,39,35,3729.07,6948.04,0.00
2024-12-08 17:15:28,74,5738,39,35,3819.13,6949.00,0.00
2024-12-08 17:15:28,75,5738,39,36,3768.21,6949.01,0.00
2024-12-08 17:15:28,75,5739,39,36,3737.92,6950.00,0.00
2024-12-08 17:15:28,76,5739,40,36,3688.73,6950.01,0.00
2024-12-08 17:15:28,75,5739,40,35,3723.47,6950.09,0.00
2024-12-08 17:15:28,75,5740,40,35,3721.83,6951.00,0.00
2024-12-08 17:15:28,76,5740,41,35,3672.86,6951.01,0.00
2024-12-08 17:15:28,75,5740,41,34,3716.27,6951.01,0.00
2024-12-08 17:15:28,74,5740,41,33,3674.12,6951.88,0.00
2024-12-08 17:15:28,74,5741,41,33,3759.70,6952.00,0.00
2024-12-08 17:15:28,75,5741,41,34,3709.57,6952.01,0.00
2024-12-08 17:15:28,74,5741,40,34,3758.77,6952.03,0.00
2024-12-08 17:15:28,73,5741,39,34,3797.06,6952.08,0.00
2024-12-08 17:15:28,73,5742,39,34,3797.41,6953.00,0.00
2024-12-08 17:15:28,74,5742,40,34,3746.10,6953.01,0.00
2024-12-08 17:15:28,73,5742,39,34,3796.46,6953.03,0.00
2024-12-08 17:15:28,72,5742,38,34,3848.22,6953.03,0.00
2024-12-08 17:15:28,71,5742,38,33,3890.68,6953.06,0.00
2024-12-08 17:15:28,71,5743,38,33,3875.00,6954.00,0.00
2024-12-08 17:15:28,72,5743,38,34,3821.18,6954.01,0.00
2024-12-08 17:15:28,72,5744,38,34,3761.96,6955.00,0.00
2024-12-08 17:15:28,73,5744,38,35,3710.43,6955.01,0.00
2024-12-08 17:15:28,72,5744,37,35,3747.36,6955.07,0.00
2024-12-08 17:15:28,71,5744,37,34,3789.37,6955.07,0.00
2024-12-08 17:15:28,70,5744,36,34,3833.61,6955.20,0.00
2024-12-08 17:15:28,69,5744,35,34,3856.53,6955.49,0.00
2024-12-08 17:15:28,69,5745,35,34,3918.55,6956.00,0.00
2024-12-08 17:15:28,70,5745,35,35,3862.57,6956.01,0.00
2024-12-08 17:15:29,70,5746,35,35,3847.27,6957.00,0.00
2024-12-08 17:15:29,71,5746,36,35,3793.08,6957.01,0.00
2024-12-08 17:15:29,70,5746,35,35,3841.38,6957.04,0.00
2024-12-08 17:15:29,69,5746,35,34,3881.94,6957.09,0.00
2024-12-08 17:15:29,68,5746,34,34,3885.35,6957.60,0.00
2024-12-08 17:15:29,68,5747,34,34,3960.36,6958.00,0.00
2024-12-08 17:15:29,69,5747,35,34,3902.96,6958.02,0.00
2024-12-08 17:15:29,69,5748,35,34,3888.79,6959.00,0.00
2024-12-08 17:15:29,70,5748,35,35,3833.23,6959.01,0.00
2024-12-08 17:15:29,69,5748,35,34,3869.89,6959.09,0.00
2024-12-08 17:15:29,69,5749,35,34,3883.02,6960.00,0.00
2024-12-08 17:15:29,70,5749,36,34,3827.54,6960.01,0.00
2024-12-08 17:15:29,70,5750,36,34,3811.52,6961.00,0.00
2024-12-08 17:15:29,71,5750,37,34,3757.83,6961.01,0.00
2024-12-08 17:15:29,70,5750,37,33,3794.19,6961.09,0.00
2024-12-08 17:15:29,70,5751,37,33,3805.57,6962.00,0.00
2024-12-08 17:15:29,71,5751,38,33,3751.97,6962.01,0.00
2024-12-08 17:15:29,71,5752,38,33,3735.72,6963.00,0.00
2024-12-08 17:15:29,72,5752,38,34,3683.83,6963.01,0.00
2024-12-08 17:15:29,71,5752,38,33,3720.66,6963.08,0.00
2024-12-08 17:15:29,71,5753,38,33,3731.25,6964.00,0.00
2024-12-08 17:15:29,72,5753,38,34,3679.43,6964.01,0.00
2024-12-08 17:15:29,71,5753,37,34,3730.27,6964.01,0.00
2024-12-08 17:15:29,71,5754,37,34,3715.76,6965.00,0.00
2024-12-08 17:15:29,72,5754,38,34,3664.15,6965.01,0.00
2024-12-08 17:15:29,71,5754,38,33,3703.13,6965.07,0.00
2024-12-08 17:15:29,71,5755,38,33,3713.60,6966.00,0.00
2024-12-08 17:15:29,72,5755,38,34,3662.02,6966.01,0.00
2024-12-08 17:15:29,72,5756,38,34,3647.14,6967.00,0.00
2024-12-08 17:15:29,73,5756,38,35,3597.18,6967.01,0.00
2024-12-08 17:15:29,72,5756,38,34,3635.29,6967.07,0.00
2024-12-08 17:15:29,71,5756,37,34,3662.08,6967.42,0.00
2024-12-08 17:15:29,71,5757,37,34,3696.51,6968.00,0.00
2024-12-08 17:15:29,72,5757,37,35,3645.17,6968.01,0.00
2024-12-08 17:15:29,71,5757,36,35,3642.55,6968.45,0.00
2024-12-08 17:15:29,71,5758,36,35,3680.98,6969.00,0.00
2024-12-08 17:15:29,72,5758,37,35,3629.85,6969.01,0.00
2024-12-08 17:15:29,71,5758,37,34,3670.52,6969.07,0.00
2024-12-08 17:15:29,70,5758,36,34,3712.05,6969.21,0.00
2024-12-08 17:15:29,70,5759,36,34,3699.33,6970.00,0.00
2024-12-08 17:15:29,71,5759,37,34,3647.22,6970.01,0.00
2024-12-08 17:15:29,70,5759,36,34,3686.38,6970.03,0.00
2024-12-08 17:15:29,69,5759,35,34,3671.04,6970.54,0.00
2024-12-08 17:15:29,69,5760,35,34,3737.04,6971.00,0.00
2024-12-08 17:15:29,70,5760,36,34,3683.65,6971.01,0.00
2024-12-08 17:15:29,69,5760,36,33,3727.95,6971.06,0.00
2024-12-08 17:15:29,69,5761,36,33,3740.71,6972.00,0.00
2024-12-08 17:15:29,70,5761,37,33,3687.27,6972.01,0.00
2024-12-08 17:15:29,70,5762,37,33,3676.07,6973.00,0.00
2024-12-08 17:15:29,71,5762,38,33,3624.29,6973.01,0.00
2024-12-08 17:15:29,70,5762,38,32,3666.12,6973.07,0.00
2024-12-08 17:15:29,69,5762,37,32,3670.26,6973.73,0.00
2024-12-08 17:15:29,69,5763,37,32,3732.12,6974.00,0.00
2024-12-08 17:15:29,70,5763,38,32,3678.81,6974.01,0.00
2024-12-08 17:15:29,69,5763,37,32,3698.81,6974.20,0.00
2024-12-08 17:15:29,70,5762,37,33,3625.18,6974.53,0.00
2024-12-08 17:15:29,70,5763,37,33,3728.27,6975.00,0.00
2024-12-08 17:15:29,71,5763,38,33,3675.76,6975.01,0.00
2024-12-08 17:15:29,70,5763,38,32,3719.31,6975.07,0.00
2024-12-08 17:15:30,70,5764,38,32,3828.63,6976.00,0.00
2024-12-08 17:15:30,71,5764,38,33,3774.71,6976.01,0.00
2024-12-08 17:15:30,70,5764,38,32,3828.05,6976.01,0.00
2024-12-08 17:15:30,70,5765,38,32,3814.34,6977.00,0.00
2024-12-08 17:15:30,71,5765,38,33,3760.62,6977.01,0.00
2024-12-08 17:15:30,70,5765,38,32,3803.39,6977.07,0.00
2024-12-08 17:15:30,69,5765,37,32,3818.18,6977.39,0.00
2024-12-08 17:15:30,69,5766,37,32,3872.06,6978.00,0.00
2024-12-08 17:15:30,70,5766,38,32,3816.75,6978.01,0.00
2024-12-08 17:15:30,69,5766,37,32,3835.67,6978.10,0.00
2024-12-08 17:15:30,69,5767,37,32,3869.23,6979.00,0.00
2024-12-08 17:15:30,70,5767,38,32,3813.95,6979.01,0.00
2024-12-08 17:15:30,69,5767,38,31,3859.12,6979.07,0.00
2024-12-08 17:15:30,69,5768,38,31,3869.74,6980.00,0.00
2024-12-08 17:15:30,70,5768,38,32,3814.46,6980.01,0.00
2024-12-08 17:15:30,70,5769,38,32,3799.69,6981.00,0.00
2024-12-08 17:15:30,71,5769,39,32,3746.18,6981.01,0.00
2024-12-08 17:15:30,70,5769,39,31,3790.72,6981.07,0.00
2024-12-08 17:15:30,70,5770,39,31,3799.97,6982.00,0.00
2024-12-08 17:15:30,71,5770,39,32,3746.45,6982.01,0.00
2024-12-08 17:15:30,71,5771,39,32,3731.43,6983.00,0.00
2024-12-08 17:15:30,72,5771,40,32,3679.61,6983.01,0.00
2024-12-08 17:15:30,71,5771,40,31,3721.60,6983.07,0.00
2024-12-08 17:15:30,70,5771,39,31,3741.94,6983.34,0.00
2024-12-08 17:15:30,70,5772,39,31,3791.07,6984.00,0.00
2024-12-08 17:15:30,71,5772,40,31,3737.68,6984.01,0.00
2024-12-08 17:15:30,71,5773,40,31,3723.45,6985.00,0.00
2024-12-08 17:15:30,72,5773,41,31,3671.73,6985.01,0.00
2024-12-08 17:15:30,71,5773,41,30,3712.63,6985.07,0.00
2024-12-08 17:15:30,71,5774,41,30,3721.69,6986.00,0.00
2024-12-08 17:15:30,72,5774,42,30,3670.00,6986.01,0.00
2024-12-08 17:15:30,71,5774,41,30,3720.71,6986.01,0.00
2024-12-08 17:15:30,70,5774,40,30,3700.80,6986.41,0.00
2024-12-08 17:15:30,70,5775,40,30,3759.21,6987.00,0.00
2024-12-08 17:15:30,71,5775,41,30,3706.27,6987.01,0.00
2024-12-08 17:15:30,70,5775,40,30,3758.22,6987.01,0.00
2024-12-08 17:15:30,69,5775,40,29,3799.53,6987.07,0.00
2024-12-08 17:15:30,69,5776,40,29,3808.98,6988.00,0.00
2024-12-08 17:15:30,70,5776,41,29,3754.56,6988.01,0.00
2024-12-08 17:15:30,70,5777,41,29,3737.87,6989.00,0.00
2024-12-08 17:15:30,71,5777,42,29,3685.23,6989.01,0.00
2024-12-08 17:15:30,70,5777,42,28,3725.90,6989.07,0.00
2024-12-08 17:15:30,70,5778,42,28,3732.47,6990.00,0.00
2024-12-08 17:15:30,71,5778,42,29,3679.90,6990.01,0.00
2024-12-08 17:15:30,71,5779,42,29,3661.85,6991.00,0.00
2024-12-08 17:15:30,72,5779,43,29,3610.99,6991.01,0.00
2024-12-08 17:15:30,71,5779,43,28,3643.16,6991.11,0.00
2024-12-08 17:15:30,71,5780,43,28,3651.67,6992.00,0.00
2024-12-08 17:15:30,72,5780,43,29,3600.95,6992.01,0.00
2024-12-08 17:15:30,71,5780,43,28,3611.93,6992.28,0.00
2024-12-08 17:15:30,71,5781,43,28,3639.82,6993.00,0.00
2024-12-08 17:15:30,72,5781,43,29,3589.27,6993.01,0.00
2024-12-08 17:15:30,71,5781,43,28,3608.33,6993.20,0.00
2024-12-08 17:15:30,71,5782,43,28,3630.62,6994.00,0.00
2024-12-08 17:15:30,72,5782,43,29,3580.20,6994.01,0.00
2024-12-08 17:15:30,71,5782,42,29,3626.69,6994.06,0.00
2024-12-08 17:15:30,70,5782,41,29,3625.70,6994.47,0.00
2024-12-08 17:15:30,71,5781,42,29,3562.91,6994.66,0.00
2024-12-08 17:15:31,71,5782,42,29,3719.21,6995.00,0.00
2024-12-08 17:15:31,72,5782,43,29,3667.56,6995.01,0.00
2024-12-08 17:15:31,71,5782,42,29,3689.68,6995.18,0.00
2024-12-08 17:15:31,70,5782,42,28,3723.41,6995.19,0.00
2024-12-08 17:15:31,70,5783,42,28,3866.20,6996.00,0.00
2024-12-08 17:15:31,71,5783,42,29,3811.75,6996.01,0.00
2024-12-08 17:15:31,71,5784,42,29,3800.72,6997.00,0.00
2024-12-08 17:15:31,72,5784,43,29,3747.94,6997.01,0.00
2024-12-08 17:15:31,71,5784,42,29,3799.74,6997.01,0.00
2024-12-08 17:15:31,70,5784,41,29,3851.02,6997.04,0.00
2024-12-08 17:15:31,69,5784,41,28,3879.48,6997.16,0.00
2024-12-08 17:15:31,69,5785,41,28,3900.29,6998.00,0.00
2024-12-08 17:15:31,70,5785,41,29,3844.57,6998.01,0.00
2024-12-08 17:15:31,70,5786,41,29,3835.67,6999.00,0.00
2024-12-08 17:15:31,71,5786,41,30,3781.65,6999.01,0.00
2024-12-08 17:15:31,70,5786,40,30,3833.67,6999.04,0.00
2024-12-08 17:15:31,69,5786,40,29,3862.88,6999.15,0.00
2024-12-08 17:15:31,69,5787,40,29,3883.04,7000.00,0.00
2024-12-08 17:15:31,70,5787,40,30,3827.57,7000.01,0.00
2024-12-08 17:15:31,70,5788,40,30,3818.90,7001.00,0.00
2024-12-08 17:15:31,71,5788,41,30,3765.11,7001.01,0.00
2024-12-08 17:15:31,70,5788,40,30,3817.90,7001.01,0.00
2024-12-08 17:15:31,69,5788,39,30,3826.68,7001.39,0.00
2024-12-08 17:15:31,69,5789,39,30,3865.67,7002.00,0.00
2024-12-08 17:15:31,70,5789,39,31,3810.44,7002.01,0.00
2024-12-08 17:15:31,69,5789,39,30,3852.50,7002.17,0.00
2024-12-08 17:15:31,69,5790,39,30,3874.27,7003.00,0.00
2024-12-08 17:15:31,70,5790,39,31,3818.92,7003.01,0.00
2024-12-08 17:15:31,70,5791,39,31,3810.46,7004.00,0.00
2024-12-08 17:15:31,71,5791,40,31,3756.80,7004.01,0.00
2024-12-08 17:15:31,70,5791,39,31,3766.49,7004.26,0.00
2024-12-08 17:15:31,70,5792,39,31,3815.01,7005.00,0.00
2024-12-08 17:15:31,71,5792,40,31,3761.28,7005.01,0.00
2024-12-08 17:15:31,70,5792,39,31,3812.01,7005.06,0.00
2024-12-08 17:15:31,69,5792,39,30,3857.13,7005.17,0.00
2024-12-08 17:15:31,69,5793,39,30,3880.88,7006.00,0.00
2024-12-08 17:15:31,70,5793,40,30,3825.44,7006.01,0.00
2024-12-08 17:15:31,69,5793,39,30,3877.84,7006.06,0.00
2024-12-08 17:15:31,69,5794,39,30,3868.28,7007.00,0.00
2024-12-08 17:15:31,70,5794,40,30,3813.02,7007.01,0.00
2024-12-08 17:15:31,69,5794,40,29,3836.82,7007.16,0.00
2024-12-08 17:15:31,69,5795,40,29,3857.41,7008.00,0.00
2024-12-08 17:15:31,70,5795,41,29,3802.31,7008.01,0.00
2024-12-08 17:15:31,70,5796,41,29,3789.69,7009.00,0.00
2024-12-08 17:15:31,71,5796,42,29,3736.31,7009.01,0.00
2024-12-08 17:15:31,70,5796,42,28,3756.68,7009.19,0.00
2024-12-08 17:15:31,70,5797,42,28,3776.25,7010.00,0.00
2024-12-08 17:15:31,71,5797,43,28,3723.07,7010.01,0.00
2024-12-08 17:15:31,71,5798,43,28,3712.36,7011.00,0.00
2024-12-08 17:15:31,72,5798,43,29,3660.80,7011.01,0.00
2024-12-08 17:15:31,72,5799,43,29,3647.62,7012.00,0.00
2024-12-08 17:15:31,73,5799,43,30,3597.65,7012.01,0.00
2024-12-08 17:15:31,72,5799,42,30,3646.65,7012.01,0.00
2024-12-08 17:15:31,71,5799,42,29,3685.20,7012.18,0.00
2024-12-08 17:15:31,70,5799,42,28,3718.52,7012.46,0.00
2024-12-08 17:15:31,70,5800,42,28,3760.97,7013.00,0.00
2024-12-08 17:15:31,71,5800,42,29,3708.00,7013.01,0.00
2024-12-08 17:15:31,71,5801,42,29,3698.65,7014.00,0.00
2024-12-08 17:15:31,72,5801,42,30,3647.28,7014.01,0.00
2024-12-08 17:15:31,71,5801,42,29,3666.08,7014.18,0.00
2024-12-08 17:15:31,71,5802,42,29,3688.31,7015.00,0.00
2024-12-08 17:15:31,72,5802,42,30,3637.08,7015.01,0.00
2024-12-08 17:15:31,71,5802,41,30,3624.20,7015.40,0.00
2024-12-08 17:15:32,71,5803,41,30,3680.93,7016.00,0.00
2024-12-08 17:15:32,72,5803,42,30,3629.80,7016.01,0.00
2024-12-08 17:15:32,71,5803,42,29,3649.33,7016.18,0.00
2024-12-08 17:15:32,71,5804,42,29,3671.57,7017.00,0.00
2024-12-08 17:15:32,72,5804,42,30,3620.58,7017.01,0.00
2024-12-08 17:15:32,71,5804,41,30,3637.01,7017.20,0.00
2024-12-08 17:15:32,71,5805,41,30,3680.00,7018.00,0.00
2024-12-08 17:15:32,72,5805,42,30,3628.89,7018.01,0.00
2024-12-08 17:15:32,71,5805,42,29,3649.38,7018.18,0.00
2024-12-08 17:15:32,71,5806,42,29,3671.63,7019.00,0.00
2024-12-08 17:15:32,72,5806,43,29,3620.63,7019.01,0.00
2024-12-08 17:15:32,71,5806,42,29,3670.64,7019.01,0.00
2024-12-08 17:15:32,71,5807,42,29,3661.27,7020.00,0.00
2024-12-08 17:15:32,72,5807,43,29,3610.42,7020.01,0.00
2024-12-08 17:15:32,71,5807,43,28,3630.64,7020.17,0.00
2024-12-08 17:15:32,71,5808,43,28,3651.91,7021.00,0.00
2024-12-08 17:15:32,72,5808,44,28,3601.19,7021.01,0.00
2024-12-08 17:15:32,71,5808,43,28,3646.97,7021.08,0.00
2024-12-08 17:15:32,70,5808,42,28,3691.06,7021.17,0.00
2024-12-08 17:15:32,70,5809,42,28,3713.63,7022.00,0.00
2024-12-08 17:15:32,71,5809,43,28,3661.33,7022.01,0.00
2024-12-08 17:15:32,70,5809,42,28,3708.62,7022.09,0.00
2024-12-08 17:15:32,70,5810,42,28,3705.13,7023.00,0.00
2024-12-08 17:15:32,71,5810,42,29,3652.95,7023.01,0.00
2024-12-08 17:15:32,70,5810,41,29,3704.13,7023.01,0.00
2024-12-08 17:15:32,69,5810,41,28,3747.66,7023.15,0.00
2024-12-08 17:15:32,68,5810,40,28,3783.25,7023.41,0.00
2024-12-08 17:15:32,68,5811,40,28,3824.98,7024.00,0.00
2024-12-08 17:15:32,69,5811,40,29,3769.54,7024.02,0.00
2024-12-08 17:15:32,68,5811,39,29,3819.82,7024.07,0.00
2024-12-08 17:15:32,67,5811,38,29,3805.87,7024.75,0.00
2024-12-08 17:15:32,67,5812,38,29,3893.11,7025.00,0.00
2024-12-08 17:15:32,68,5812,39,29,3835.86,7025.02,0.00
2024-12-08 17:15:32,67,5812,39,28,3863.77,7025.13,0.00
2024-12-08 17:15:32,67,5813,39,28,3887.37,7026.00,0.00
2024-12-08 17:15:32,68,5813,40,28,3830.20,7026.02,0.00
2024-12-08 17:15:32,67,5813,39,28,3879.00,7026.13,0.00
2024-12-08 17:15:32,67,5814,39,28,3902.60,7027.00,0.00
2024-12-08 17:15:32,68,5814,39,29,3845.21,7027.02,0.00
2024-12-08 17:15:32,67,5814,38,29,3901.56,7027.02,0.00
2024-12-08 17:15:32,66,5814,38,28,3931.94,7027.12,0.00
2024-12-08 17:15:32,66,5815,38,28,3955.91,7028.00,0.00
2024-12-08 17:15:32,67,5815,39,28,3896.87,7028.02,0.00
2024-12-08 17:15:32,66,5815,39,27,3954.85,7028.02,0.00
2024-12-08 17:15:32,66,5816,39,27,3950.08,7029.00,0.00
2024-12-08 17:15:32,67,5816,40,27,3891.13,7029.02,0.00
2024-12-08 17:15:32,66,5816,40,26,3949.02,7029.02,0.00
2024-12-08 17:15:32,65,5816,40,25,3983.83,7029.09,0.00
2024-12-08 17:15:32,64,5816,39,25,4043.89,7029.11,0.00
2024-12-08 17:15:32,64,5817,39,25,4069.71,7030.00,0.00
2024-12-08 17:15:32,65,5817,40,25,4007.10,7030.02,0.00
2024-12-08 17:15:32,65,5818,40,25,4003.34,7031.00,0.00
2024-12-08 17:15:32,66,5818,40,26,3942.68,7031.02,0.00
2024-12-08 17:15:32,65,5818,40,25,3978.48,7031.09,0.00
2024-12-08 17:15:32,65,5819,40,25,4001.75,7032.00,0.00
2024-12-08 17:15:32,66,5819,41,25,3941.12,7032.02,0.00
2024-12-08 17:15:32,66,5820,41,25,3936.35,7033.00,0.00
2024-12-08 17:15:32,67,5820,41,26,3877.60,7033.02,0.00
2024-12-08 17:15:32,67,5821,41,26,3871.85,7034.00,0.00
2024-12-08 17:15:32,68,5821,42,26,3814.91,7034.02,0.00
2024-12-08 17:15:32,67,5821,42,25,3858.23,7034.16,0.00
2024-12-08 17:15:33,67,5822,42,25,3883.95,7035.00,0.00
2024-12-08 17:15:33,68,5822,42,26,3826.83,7035.02,0.00
2024-12-08 17:15:33,67,5822,41,26,3873.48,7035.15,0.00
2024-12-08 17:15:33,66,5822,40,26,3905.52,7035.17,0.00
2024-12-08 17:15:33,66,5823,40,26,3954.02,7036.00,0.00
2024-12-08 17:15:33,67,5823,40,27,3895.00,7036.02,0.00
2024-12-08 17:15:33,67,5824,40,27,3889.25,7037.00,0.00
2024-12-08 17:15:33,68,5824,41,27,3832.06,7037.02,0.00
2024-12-08 17:15:33,67,5824,41,26,3878.78,7037.15,0.00
2024-12-08 17:15:33,67,5825,41,26,3903.46,7038.00,0.00
2024-12-08 17:15:33,68,5825,41,27,3846.06,7038.02,0.00
2024-12-08 17:15:33,67,5825,40,27,3833.21,7038.42,0.00
2024-12-08 17:15:33,67,5826,40,27,3897.71,7039.00,0.00
2024-12-08 17:15:33,68,5826,41,27,3840.39,7039.02,0.00
2024-12-08 17:15:33,67,5826,40,27,3896.66,7039.02,0.00
2024-12-08 17:15:33,66,5826,39,27,3946.13,7039.14,0.00
2024-12-08 17:15:33,66,5827,39,27,3971.20,7040.00,0.00
2024-12-08 17:15:33,67,5827,39,28,3911.93,7040.02,0.00
2024-12-08 17:15:33,66,5827,39,27,3940.29,7040.14,0.00
2024-12-08 17:15:33,66,5828,39,27,3986.70,7041.00,0.00
2024-12-08 17:15:33,67,5828,40,27,3927.20,7041.02,0.00
2024-12-08 17:15:33,66,5828,39,27,3982.43,7041.06,0.00
2024-12-08 17:15:33,66,5829,39,27,3980.86,7042.00,0.00
2024-12-08 17:15:33,67,5829,40,27,3921.45,7042.02,0.00
2024-12-08 17:15:33,66,5829,40,26,3949.94,7042.14,0.00
2024-12-08 17:15:33,66,5830,40,26,3975.03,7043.00,0.00
2024-12-08 17:15:33,67,5830,41,26,3915.70,7043.02,0.00
2024-12-08 17:15:33,67,5831,41,26,3909.94,7044.00,0.00
2024-12-08 17:15:33,68,5831,41,27,3852.45,7044.02,0.00
2024-12-08 17:15:33,68,5832,41,27,3845.74,7045.00,0.00
2024-12-08 17:15:33,69,5832,41,28,3790.00,7045.02,0.00
2024-12-08 17:15:33,68,5832,41,27,3825.06,7045.22,0.00
2024-12-08 17:15:33,68,5833,41,27,3853.54,7046.00,0.00
2024-12-08 17:15:33,69,5833,42,27,3797.69,7046.02,0.00
2024-12-08 17:15:33,69,5834,42,27,3790.06,7047.00,0.00
2024-12-08 17:15:33,70,5834,43,27,3735.92,7047.01,0.00
2024-12-08 17:15:33,69,5834,43,26,3789.04,7047.02,0.00
2024-12-08 17:15:33,68,5834,42,26,3835.46,7047.15,0.00
2024-12-08 17:15:33,68,5835,42,26,3838.05,7048.00,0.00
2024-12-08 17:15:33,69,5835,43,26,3782.42,7048.02,0.00
2024-12-08 17:15:33,68,5835,42,26,3837.01,7048.02,0.00
2024-12-08 17:15:33,67,5835,41,26,3883.79,7048.15,0.00
2024-12-08 17:15:33,66,5835,41,25,3935.17,7048.18,0.00
2024-12-08 17:15:33,66,5836,41,25,3963.46,7049.00,0.00
2024-12-08 17:15:33,67,5836,41,26,3904.30,7049.02,0.00
2024-12-08 17:15:33,67,5837,41,26,3898.54,7050.00,0.00
2024-12-08 17:15:33,68,5837,41,27,3841.21,7050.02,0.00
2024-12-08 17:15:33,68,5838,41,27,3834.50,7051.00,0.00
2024-12-08 17:15:33,69,5838,42,27,3778.93,7051.02,0.00
2024-12-08 17:15:33,68,5838,41,27,3833.46,7051.02,0.00
2024-12-08 17:15:33,67,5838,41,26,3877.03,7051.16,0.00
2024-12-08 17:15:33,67,5839,41,26,3902.81,7052.00,0.00
2024-12-08 17:15:33,68,5839,42,26,3845.41,7052.02,0.00
2024-12-08 17:15:33,67,5839,41,26,3864.95,7052.19,0.00
2024-12-08 17:15:33,67,5840,41,26,3913.89,7053.00,0.00
2024-12-08 17:15:33,68,5840,42,26,3856.33,7053.02,0.00
2024-12-08 17:15:33,68,5841,42,26,3849.62,7054.00,0.00
2024-12-08 17:15:33,69,5841,42,27,3793.82,7054.02,0.00
2024-12-08 17:15:33,68,5841,42,26,3838.23,7054.16,0.00
2024-12-08 17:15:34,68,5842,42,26,3862.61,7055.00,0.00
2024-12-08 17:15:34,69,5842,42,27,3806.63,7055.02,0.00
2024-12-08 17:15:34,68,5842,41,27,3859.51,7055.06,0.00
2024-12-08 17:15:34,68,5843,41,27,3855.89,7056.00,0.00
2024-12-08 17:15:34,69,5843,42,27,3800.01,7056.02,0.00
2024-12-08 17:15:34,68,5843,42,26,3823.76,7056.16,0.00
2024-12-08 17:15:34,68,5844,42,26,3848.14,7057.00,0.00
2024-12-08 17:15:34,69,5844,42,27,3792.37,7057.02,0.00
2024-12-08 17:15:34,69,5845,42,27,3784.72,7058.00,0.00
2024-12-08 17:15:34,70,5845,42,28,3730.66,7058.01,0.00
2024-12-08 17:15:34,69,5845,42,27,3753.04,7058.16,0.00
2024-12-08 17:15:34,69,5846,42,27,3776.05,7059.00,0.00
2024-12-08 17:15:34,70,5846,43,27,3722.11,7059.01,0.00
2024-12-08 17:15:34,69,5846,42,27,3769.92,7059.06,0.00
2024-12-08 17:15:34,69,5847,42,27,3785.80,7060.00,0.00
2024-12-08 17:15:34,70,5847,43,27,3731.71,7060.01,0.00
2024-12-08 17:15:34,69,5847,43,26,3756.15,7060.15,0.00
2024-12-08 17:15:34,69,5848,43,26,3778.15,7061.00,0.00
2024-12-08 17:15:34,70,5848,43,27,3724.17,7061.01,0.00
2024-12-08 17:15:34,70,5849,43,27,3715.62,7062.00,0.00
2024-12-08 17:15:34,71,5849,43,28,3663.29,7062.01,0.00
2024-12-08 17:15:34,70,5849,43,27,3687.39,7062.14,0.00
2024-12-08 17:15:34,69,5849,42,27,3740.83,7062.15,0.00
2024-12-08 17:15:34,69,5850,42,27,3783.31,7063.00,0.00
2024-12-08 17:15:34,70,5850,42,28,3729.26,7063.01,0.00
2024-12-08 17:15:34,69,5850,41,28,3773.08,7063.09,0.00
2024-12-08 17:15:34,69,5851,41,28,3791.01,7064.00,0.00
2024-12-08 17:15:34,70,5851,42,28,3736.85,7064.01,0.00
2024-12-08 17:15:34,69,5851,42,27,3742.91,7064.13,0.00
2024-12-08 17:15:34,69,5852,42,27,3784.38,7065.00,0.00
2024-12-08 17:15:34,70,5852,42,28,3730.32,7065.01,0.00
2024-12-08 17:15:34,69,5852,41,28,3779.27,7065.07,0.00
2024-12-08 17:15:34,69,5853,41,28,3775.70,7066.00,0.00
2024-12-08 17:15:34,70,5853,41,29,3721.76,7066.01,0.00
2024-12-08 17:15:34,69,5853,41,28,3750.11,7066.12,0.00
2024-12-08 17:15:34,69,5854,41,28,3770.09,7067.00,0.00
2024-12-08 17:15:34,70,5854,42,28,3716.23,7067.01,0.00
2024-12-08 17:15:34,69,5854,41,28,3700.57,7067.42,0.00
2024-12-08 17:15:34,69,5855,41,28,3762.43,7068.00,0.00
2024-12-08 17:15:34,70,5855,42,28,3708.68,7068.01,0.00
2024-12-08 17:15:34,70,5856,42,28,3698.22,7069.00,0.00
2024-12-08 17:15:34,71,5856,43,28,3646.13,7069.01,0.00
2024-12-08 17:15:34,70,5856,42,28,3693.17,7069.07,0.00
2024-12-08 17:15:34,69,5856,41,28,3739.55,7069.16,0.00
2024-12-08 17:15:34,68,5856,41,27,3790.38,7069.18,0.00
2024-12-08 17:15:34,68,5857,41,27,3812.78,7070.00,0.00
2024-12-08 17:15:34,69,5857,42,27,3757.52,7070.02,0.00
2024-12-08 17:15:34,68,5857,41,27,3780.57,7070.16,0.00
2024-12-08 17:15:34,68,5858,41,27,3802.09,7071.00,0.00
2024-12-08 17:15:34,69,5858,41,28,3746.98,7071.02,0.00
2024-12-08 17:15:34,68,5858,40,28,3800.01,7071.03,0.00
2024-12-08 17:15:34,67,5858,39,28,3853.56,7071.06,0.00
2024-12-08 17:15:34,67,5859,39,28,3848.73,7072.00,0.00
2024-12-08 17:15:34,68,5859,39,29,3792.14,7072.02,0.00
2024-12-08 17:15:34,67,5859,39,28,3839.25,7072.13,0.00
2024-12-08 17:15:34,67,5860,39,28,3862.12,7073.00,0.00
2024-12-08 17:15:34,68,5860,39,29,3805.33,7073.02,0.00
2024-12-08 17:15:34,67,5860,38,29,3860.01,7073.03,0.00
2024-12-08 17:15:34,66,5860,37,29,3850.04,7073.39,0.00
2024-12-08 17:15:34,66,5861,37,29,3914.76,7074.00,0.00
2024-12-08 17:15:34,67,5861,38,29,3856.33,7074.02,0.00
2024-12-08 17:15:34,66,5861,37,29,3913.69,7074.02,0.00
2024-12-08 17:15:34,65,5861,37,28,3945.62,7074.11,0.00
2024-12-08 17:15:34,66,5860,37,29,3884.78,7074.15,0.00
2024-12-08 17:15:35,66,5861,37,29,3973.20,7075.00,0.00
2024-12-08 17:15:35,67,5861,37,30,3913.90,7075.02,0.00
2024-12-08 17:15:35,67,5862,37,30,4013.73,7076.00,0.00
2024-12-08 17:15:35,68,5862,38,30,3954.70,7076.02,0.00
2024-12-08 17:15:35,67,5862,38,29,3987.34,7076.10,0.00
2024-12-08 17:15:35,66,5862,37,29,4045.63,7076.12,0.00
2024-12-08 17:15:35,66,5863,37,29,4069.76,7077.00,0.00
2024-12-08 17:15:35,67,5863,37,30,4009.01,7077.02,0.00
2024-12-08 17:15:35,67,5864,37,30,4003.24,7078.00,0.00
2024-12-08 17:15:35,68,5864,37,31,3944.37,7078.02,0.00
2024-12-08 17:15:35,68,5865,37,31,3937.64,7079.00,0.00
2024-12-08 17:15:35,69,5865,38,31,3880.57,7079.02,0.00
2024-12-08 17:15:35,68,5865,37,31,3884.63,7079.29,0.00
2024-12-08 17:15:35,68,5866,37,31,3939.24,7080.00,0.00
2024-12-08 17:15:35,69,5866,37,32,3882.15,7080.02,0.00
2024-12-08 17:15:35,69,5867,37,32,3874.49,7081.00,0.00
2024-12-08 17:15:35,70,5867,38,32,3819.14,7081.01,0.00
2024-12-08 17:15:35,69,5867,38,31,3853.97,7081.10,0.00
2024-12-08 17:15:35,69,5868,38,31,3872.98,7082.00,0.00
2024-12-08 17:15:35,70,5868,39,31,3817.65,7082.01,0.00
2024-12-08 17:15:35,70,5869,39,31,3809.08,7083.00,0.00
2024-12-08 17:15:35,71,5869,40,31,3755.44,7083.01,0.00
2024-12-08 17:15:35,70,5869,40,30,3787.85,7083.10,0.00
2024-12-08 17:15:35,70,5870,40,30,3805.57,7084.00,0.00
2024-12-08 17:15:35,71,5870,40,31,3751.98,7084.01,0.00
2024-12-08 17:15:35,70,5870,39,31,3804.56,7084.01,0.00
2024-12-08 17:15:35,69,5870,38,31,3833.03,7084.13,0.00
2024-12-08 17:15:35,69,5871,38,31,3854.09,7085.00,0.00
2024-12-08 17:15:35,70,5871,38,32,3799.03,7085.01,0.00
2024-12-08 17:15:35,69,5871,37,32,3853.06,7085.03,0.00
2024-12-08 17:15:35,68,5871,37,31,3861.81,7085.13,0.00
2024-12-08 17:15:35,68,5872,37,31,3905.06,7086.00,0.00
2024-12-08 17:15:35,69,5872,38,31,3848.47,7086.02,0.00
2024-12-08 17:15:35,68,5872,37,31,3854.02,7086.15,0.00
2024-12-08 17:15:35,68,5873,37,31,3898.32,7087.00,0.00
2024-12-08 17:15:35,69,5873,38,31,3841.82,7087.02,0.00
2024-12-08 17:15:35,68,5873,37,31,3895.20,7087.04,0.00
2024-12-08 17:15:35,67,5873,37,30,3929.02,7087.12,0.00
2024-12-08 17:15:35,66,5873,36,30,3970.40,7087.38,0.00
2024-12-08 17:15:35,66,5874,36,30,4012.72,7088.00,0.00
2024-12-08 17:15:35,67,5874,36,31,3952.83,7088.02,0.00
2024-12-08 17:15:35,66,5874,35,31,3944.10,7088.38,0.00
2024-12-08 17:15:35,66,5875,35,31,4007.92,7089.00,0.00
2024-12-08 17:15:35,67,5875,36,31,3948.10,7089.02,0.00
2024-12-08 17:15:35,66,5875,35,31,4005.77,7089.05,0.00
2024-12-08 17:15:35,65,5875,35,30,4042.32,7089.11,0.00
2024-12-08 17:15:35,64,5875,34,30,4083.33,7089.11,0.00
2024-12-08 17:15:35,64,5876,34,30,4131.53,7090.00,0.00
2024-12-08 17:15:35,65,5876,35,30,4067.97,7090.02,0.00
2024-12-08 17:15:35,65,5877,35,30,4064.18,7091.00,0.00
2024-12-08 17:15:35,66,5877,36,30,4002.60,7091.02,0.00
2024-12-08 17:15:35,65,5877,35,30,4024.48,7091.26,0.00
2024-12-08 17:15:35,65,5878,35,30,4059.90,7092.00,0.00
2024-12-08 17:15:35,66,5878,36,30,3998.38,7092.02,0.00
2024-12-08 17:15:35,65,5878,36,29,4049.01,7092.14,0.00
2024-12-08 17:15:35,65,5879,36,29,4075.74,7093.00,0.00
2024-12-08 17:15:35,66,5879,37,29,4013.99,7093.02,0.00
2024-12-08 17:15:35,67,5878,38,29,3914.97,7093.30,0.00
2024-12-08 17:15:35,67,5879,38,29,4001.23,7094.00,0.00
2024-12-08 17:15:35,68,5879,39,29,3942.38,7094.02,0.00
2024-12-08 17:15:35,67,5879,38,29,4000.17,7094.02,0.00
2024-12-08 17:15:36,67,5880,38,29,4100.27,7095.00,0.00
2024-12-08 17:15:36,68,5880,38,30,4039.98,7095.02,0.00
2024-12-08 17:15:36,67,5880,38,29,4090.77,7095.13,0.00
2024-12-08 17:15:36,67,5881,38,29,4114.62,7096.00,0.00
2024-12-08 17:15:36,68,5881,39,29,4054.11,7096.02,0.00
2024-12-08 17:15:36,68,5882,39,29,4047.38,7097.00,0.00
2024-12-08 17:15:36,69,5882,40,29,3988.72,7097.02,0.00
2024-12-08 17:15:36,68,5882,40,28,4018.17,7097.13,0.00
2024-12-08 17:15:36,68,5883,40,28,4040.64,7098.00,0.00
2024-12-08 17:15:36,69,5883,40,29,3982.08,7098.02,0.00
2024-12-08 17:15:36,68,5883,39,29,4038.55,7098.03,0.00
2024-12-08 17:15:36,68,5884,39,29,4032.86,7099.00,0.00
2024-12-08 17:15:36,69,5884,40,29,3974.41,7099.02,0.00
2024-12-08 17:15:36,68,5884,40,28,4003.65,7099.13,0.00
2024-12-08 17:15:36,67,5884,39,28,4062.34,7099.13,0.00
2024-12-08 17:15:36,67,5885,39,28,4086.21,7100.00,0.00
2024-12-08 17:15:36,68,5885,40,28,4026.12,7100.02,0.00
2024-12-08 17:15:36,67,5885,39,28,4085.15,7100.03,0.00
2024-12-08 17:15:36,67,5886,39,28,4080.42,7101.00,0.00
2024-12-08 17:15:36,68,5886,40,28,4020.42,7101.02,0.00
2024-12-08 17:15:36,67,5886,40,27,4051.83,7101.12,0.00
2024-12-08 17:15:36,67,5887,40,27,4074.64,7102.00,0.00
2024-12-08 17:15:36,68,5887,40,28,4014.72,7102.02,0.00
2024-12-08 17:15:36,67,5887,39,28,4064.06,7102.13,0.00
2024-12-08 17:15:36,67,5888,39,28,4087.93,7103.00,0.00
2024-12-08 17:15:36,68,5888,39,29,4027.82,7103.02,0.00
2024-12-08 17:15:36,67,5888,38,29,4085.82,7103.05,0.00
2024-12-08 17:15:36,67,5889,38,29,4082.15,7104.00,0.00
2024-12-08 17:15:36,68,5889,38,30,4022.12,7104.02,0.00
2024-12-08 17:15:36,68,5890,38,30,4015.37,7105.00,0.00
2024-12-08 17:15:36,69,5890,38,31,3957.17,7105.02,0.00
2024-12-08 17:15:36,68,5890,37,31,4014.32,7105.02,0.00
2024-12-08 17:15:36,68,5891,37,31,4007.51,7106.00,0.00
2024-12-08 17:15:36,69,5891,38,31,3949.43,7106.02,0.00
2024-12-08 17:15:36,68,5891,38,30,3992.49,7106.10,0.00
2024-12-08 17:15:36,68,5892,38,30,4012.89,7107.00,0.00
2024-12-08 17:15:36,69,5892,39,30,3954.74,7107.02,0.00
2024-12-08 17:15:36,69,5893,39,30,3946.40,7108.00,0.00
2024-12-08 17:15:36,70,5893,40,30,3890.02,7108.01,0.00
2024-12-08 17:15:36,69,5893,40,29,3920.66,7108.10,0.00
2024-12-08 17:15:36,69,5894,40,29,3939.74,7109.00,0.00
2024-12-08 17:15:36,70,5894,41,29,3883.46,7109.01,0.00
2024-12-08 17:15:36,70,5895,41,29,3873.66,7110.00,0.00
2024-12-08 17:15:36,71,5895,42,29,3819.10,7110.01,0.00
2024-12-08 17:15:36,70,5895,41,29,3846.90,7110.10,0.00
2024-12-08 17:15:36,69,5895,41,28,3882.04,7110.10,0.00
2024-12-08 17:15:36,69,5896,41,28,3921.74,7111.00,0.00
2024-12-08 17:15:36,70,5896,41,29,3865.72,7111.01,0.00
2024-12-08 17:15:36,69,5896,40,29,3891.29,7111.12,0.00
2024-12-08 17:15:36,69,5897,40,29,3932.03,7112.00,0.00
2024-12-08 17:15:36,70,5897,41,29,3875.85,7112.01,0.00
2024-12-08 17:15:36,69,5897,41,28,3904.55,7112.10,0.00
2024-12-08 17:15:36,69,5898,41,28,3923.64,7113.00,0.00
2024-12-08 17:15:36,70,5898,42,28,3867.59,7113.01,0.00
2024-12-08 17:15:36,69,5898,41,28,3916.28,7113.09,0.00
2024-12-08 17:15:36,70,5897,42,28,3790.40,7113.53,0.00
2024-12-08 17:15:36,69,5897,41,28,3864.02,7113.73,0.00
2024-12-08 17:15:36,69,5898,41,28,3947.75,7114.00,0.00
2024-12-08 17:15:36,70,5898,42,28,3891.36,7114.01,0.00
2024-12-08 17:15:37,69,5898,42,27,3918.90,7114.12,0.00
2024-12-08 17:15:37,69,5899,42,27,4042.14,7115.00,0.00
2024-12-08 17:15:37,70,5899,43,27,3984.40,7115.01,0.00
2024-12-08 17:15:37,70,5900,43,27,3975.81,7116.00,0.00
2024-12-08 17:15:37,71,5900,44,27,3919.81,7116.01,0.00
2024-12-08 17:15:37,70,5900,44,26,3948.38,7116.11,0.00
2024-12-08 17:15:37,70,5901,44,26,3966.63,7117.00,0.00
2024-12-08 17:15:37,71,5901,44,27,3910.76,7117.01,0.00
2024-12-08 17:15:37,70,5901,43,27,3961.55,7117.07,0.00
2024-12-08 17:15:37,70,5902,43,27,3955.53,7118.00,0.00
2024-12-08 17:15:37,71,5902,44,27,3899.82,7118.01,0.00
2024-12-08 17:15:37,70,5902,44,26,3928.09,7118.11,0.00
2024-12-08 17:15:37,70,5903,44,26,3943.32,7119.00,0.00
2024-12-08 17:15:37,71,5903,44,27,3887.78,7119.01,0.00
2024-12-08 17:15:37,71,5904,44,27,3873.47,7120.00,0.00
2024-12-08 17:15:37,72,5904,45,27,3819.68,7120.01,0.00
2024-12-08 17:15:37,71,5904,44,27,3872.47,7120.01,0.00
2024-12-08 17:15:37,70,5904,44,26,3902.38,7120.10,0.00
2024-12-08 17:15:37,70,5905,44,26,3914.54,7121.00,0.00
2024-12-08 17:15:37,71,5905,44,27,3859.41,7121.01,0.00
2024-12-08 17:15:37,71,5906,44,27,3843.89,7122.00,0.00
2024-12-08 17:15:37,72,5906,45,27,3790.51,7122.01,0.00
2024-12-08 17:15:37,71,5906,45,26,3815.82,7122.13,0.00
2024-12-08 17:15:37,70,5906,44,26,3832.43,7122.63,0.00
2024-12-08 17:15:37,70,5907,44,26,3884.22,7123.00,0.00
2024-12-08 17:15:37,71,5907,45,26,3829.51,7123.01,0.00
2024-12-08 17:15:37,71,5908,45,26,3816.18,7124.00,0.00
2024-12-08 17:15:37,72,5908,46,26,3763.18,7124.01,0.00
2024-12-08 17:15:37,71,5908,46,25,3789.11,7124.13,0.00
2024-12-08 17:15:37,71,5909,46,25,3803.68,7125.00,0.00
2024-12-08 17:15:37,72,5909,47,25,3750.85,7125.01,0.00
2024-12-08 17:15:37,72,5910,47,25,3736.88,7126.00,0.00
2024-12-08 17:15:37,73,5910,48,25,3685.69,7126.01,0.00
2024-12-08 17:15:37,72,5910,48,24,3711.16,7126.13,0.00
2024-12-08 17:15:37,72,5911,48,24,3724.15,7127.00,0.00
2024-12-08 17:15:37,73,5911,49,24,3673.14,7127.01,0.00
2024-12-08 17:15:37,72,5911,48,24,3661.45,7127.58,0.00
2024-12-08 17:15:37,72,5912,48,24,3711.27,7128.00,0.00
2024-12-08 17:15:37,73,5912,49,24,3660.43,7128.01,0.00
2024-12-08 17:15:37,72,5912,49,23,3682.58,7128.15,0.00
2024-12-08 17:15:37,72,5913,49,23,3701.56,7129.00,0.00
2024-12-08 17:15:37,73,5913,49,24,3650.86,7129.01,0.00
2024-12-08 17:15:37,72,5913,48,24,3700.57,7129.01,0.00
2024-12-08 17:15:37,72,5914,48,24,3689.72,7130.00,0.00
2024-12-08 17:15:37,73,5914,48,25,3639.17,7130.01,0.00
2024-12-08 17:15:37,72,5914,47,25,3659.04,7130.17,0.00
2024-12-08 17:15:37,72,5915,47,25,3679.02,7131.00,0.00
2024-12-08 17:15:37,73,5915,47,26,3628.62,7131.01,0.00
2024-12-08 17:15:37,72,5915,47,25,3678.03,7131.01,0.00
2024-12-08 17:15:37,71,5915,46,25,3704.74,7131.13,0.00
2024-12-08 17:15:37,70,5915,45,25,3756.65,7131.14,0.00
2024-12-08 17:15:37,69,5915,45,24,3810.06,7131.15,0.00
2024-12-08 17:15:37,69,5916,45,24,3852.80,7132.00,0.00
2024-12-08 17:15:37,70,5916,45,25,3797.76,7132.01,0.00
2024-12-08 17:15:37,69,5916,44,25,3850.73,7132.03,0.00
2024-12-08 17:15:37,68,5916,43,25,3837.22,7132.43,0.00
2024-12-08 17:15:37,68,5917,43,25,3901.61,7133.00,0.00
2024-12-08 17:15:37,69,5917,43,26,3845.07,7133.02,0.00
2024-12-08 17:15:37,68,5917,43,25,3872.26,7133.13,0.00
2024-12-08 17:15:37,69,5916,44,25,3766.70,7133.57,0.00
2024-12-08 17:15:38,69,5917,44,25,3869.39,7134.00,0.00
2024-12-08 17:15:38,70,5917,45,25,3814.11,7134.01,0.00
2024-12-08 17:15:38,69,5917,44,25,3868.35,7134.02,0.00
2024-12-08 17:15:38,69,5918,44,25,3964.03,7135.00,0.00
2024-12-08 17:15:38,70,5918,44,26,3907.40,7135.01,0.00
2024-12-08 17:15:38,69,5918,44,25,3937.16,7135.12,0.00
2024-12-08 17:15:38,68,5918,43,25,3995.06,7135.12,0.00
2024-12-08 17:15:38,68,5919,43,25,4016.59,7136.00,0.00
2024-12-08 17:15:38,69,5919,43,26,3958.38,7136.02,0.00
2024-12-08 17:15:38,68,5919,42,26,4014.49,7136.03,0.00
2024-12-08 17:15:38,67,5919,41,26,4044.61,7136.13,0.00
2024-12-08 17:15:38,66,5919,40,26,4099.42,7136.17,0.00
2024-12-08 17:15:38,66,5920,40,26,4148.62,7137.00,0.00
2024-12-08 17:15:38,67,5920,41,26,4086.70,7137.02,0.00
2024-12-08 17:15:38,66,5920,41,25,4122.68,7137.11,0.00
2024-12-08 17:15:38,66,5921,41,25,4145.95,7138.00,0.00
2024-12-08 17:15:38,67,5921,42,25,4084.07,7138.02,0.00
2024-12-08 17:15:38,67,5922,42,25,4078.25,7139.00,0.00
2024-12-08 17:15:38,68,5922,42,26,4018.28,7139.02,0.00
2024-12-08 17:15:38,67,5922,42,25,4053.76,7139.10,0.00
2024-12-08 17:15:38,67,5923,42,25,4075.63,7140.00,0.00
2024-12-08 17:15:38,68,5923,43,25,4015.69,7140.02,0.00
2024-12-08 17:15:38,67,5923,42,25,4074.56,7140.03,0.00
2024-12-08 17:15:38,66,5923,41,25,4135.22,7140.03,0.00
2024-12-08 17:15:38,66,5924,41,25,4131.47,7141.00,0.00
2024-12-08 17:15:38,67,5924,41,26,4069.80,7141.02,0.00
2024-12-08 17:15:38,66,5924,40,26,4101.20,7141.12,0.00
2024-12-08 17:15:38,66,5925,40,26,4125.47,7142.00,0.00
2024-12-08 17:15:38,67,5925,41,26,4063.90,7142.02,0.00
2024-12-08 17:15:38,66,5925,41,25,4103.84,7142.08,0.00
2024-12-08 17:15:38,66,5926,41,25,4123.47,7143.00,0.00
2024-12-08 17:15:38,67,5926,41,26,4061.93,7143.02,0.00
2024-12-08 17:15:38,66,5926,41,25,4101.84,7143.08,0.00
2024-12-08 17:15:38,65,5926,40,25,4163.85,7143.09,0.00
2024-12-08 17:15:38,65,5927,40,25,4185.62,7144.00,0.00
2024-12-08 17:15:38,66,5927,41,25,4122.21,7144.02,0.00
2024-12-08 17:15:38,66,5928,41,25,4116.29,7145.00,0.00
2024-12-08 17:15:38,67,5928,42,25,4054.85,7145.02,0.00
2024-12-08 17:15:38,67,5929,42,25,4047.76,7146.00,0.00
2024-12-08 17:15:38,68,5929,42,26,3988.23,7146.02,0.00
2024-12-08 17:15:38,68,5930,42,26,3979.53,7147.00,0.00
2024-12-08 17:15:38,69,5930,43,26,3921.86,7147.02,0.00
2024-12-08 17:15:38,68,5930,43,25,3968.53,7147.07,0.00
2024-12-08 17:15:38,67,5930,42,25,4022.45,7147.13,0.00
2024-12-08 17:15:38,67,5931,42,25,4043.41,7148.00,0.00
2024-12-08 17:15:38,68,5931,43,25,3983.95,7148.02,0.00
2024-12-08 17:15:38,68,5932,43,25,3971.16,7149.00,0.00
2024-12-08 17:15:38,69,5932,44,25,3913.60,7149.02,0.00
2024-12-08 17:15:38,68,5932,43,25,3968.01,7149.06,0.00
2024-12-08 17:15:38,67,5932,43,24,4009.10,7149.08,0.00
2024-12-08 17:15:38,68,5931,43,25,3945.96,7149.16,0.00
2024-12-08 17:15:38,68,5932,43,25,4066.61,7150.00,0.00
2024-12-08 17:15:38,69,5932,43,26,4007.67,7150.02,0.00
2024-12-08 17:15:38,68,5932,42,26,4001.71,7150.34,0.00
2024-12-08 17:15:38,68,5933,42,26,4155.70,7151.00,0.00
2024-12-08 17:15:38,69,5933,42,27,4095.47,7151.02,0.00
2024-12-08 17:15:38,68,5933,42,26,4135.73,7151.07,0.00
2024-12-08 17:15:39,68,5934,42,26,4143.77,7152.00,0.00
2024-12-08 17:15:39,69,5934,42,27,4083.72,7152.02,0.00
2024-12-08 17:15:39,69,5935,42,27,4066.12,7153.00,0.00
2024-12-08 17:15:39,70,5935,43,27,4008.03,7153.01,0.00
2024-12-08 17:15:39,69,5935,42,27,4065.08,7153.02,0.00
2024-12-08 17:15:39,68,5935,42,26,4103.84,7153.07,0.00
2024-12-08 17:15:39,67,5935,41,26,4146.94,7153.08,0.00
2024-12-08 17:15:39,67,5936,41,26,4176.30,7154.00,0.00
2024-12-08 17:15:39,68,5936,41,27,4114.89,7154.02,0.00
2024-12-08 17:15:39,67,5936,40,27,4168.22,7154.10,0.00
2024-12-08 17:15:39,66,5936,39,27,4210.01,7154.11,0.00
2024-12-08 17:15:39,66,5937,39,27,4221.49,7155.00,0.00
2024-12-08 17:15:39,67,5937,39,28,4158.48,7155.02,0.00
2024-12-08 17:15:39,67,5938,39,28,4138.00,7156.00,0.00
2024-12-08 17:15:39,68,5938,39,29,4077.14,7156.02,0.00
2024-12-08 17:15:39,68,5939,39,29,4054.53,7157.00,0.00
2024-12-08 17:15:39,69,5939,40,29,3995.77,7157.02,0.00
2024-12-08 17:15:39,68,5939,40,28,4041.74,7157.12,0.00
2024-12-08 17:15:39,68,5940,40,28,4049.96,7158.00,0.00
2024-12-08 17:15:39,69,5940,41,28,3991.27,7158.02,0.00
2024-12-08 17:15:39,68,5940,41,27,3992.80,7158.38,0.00
2024-12-08 17:15:39,67,5940,40,27,4051.33,7158.39,0.00
2024-12-08 17:15:39,67,5941,40,27,4084.37,7159.00,0.00
2024-12-08 17:15:39,68,5941,40,28,4024.30,7159.02,0.00
2024-12-08 17:15:39,69,5940,40,29,3961.84,7159.10,0.00
2024-12-08 17:15:39,69,5941,40,29,3976.79,7160.00,0.00
2024-12-08 17:15:39,70,5941,40,30,3919.98,7160.01,0.00
2024-12-08 17:15:39,69,5941,40,29,3954.99,7160.16,0.00
2024-12-08 17:15:39,69,5942,40,29,4066.63,7161.00,0.00
2024-12-08 17:15:39,70,5942,41,29,4008.53,7161.01,0.00
2024-12-08 17:15:39,71,5941,42,29,3908.11,7161.30,0.00
2024-12-08 17:15:39,71,5942,42,29,3976.53,7162.00,0.00
2024-12-08 17:15:39,72,5942,42,30,3921.30,7162.01,0.00
2024-12-08 17:15:39,72,5943,42,30,3993.03,7163.00,0.00
2024-12-08 17:15:39,73,5943,42,31,3938.33,7163.01,0.00
2024-12-08 17:15:39,72,5943,41,31,3941.17,7163.39,0.00
2024-12-08 17:15:39,71,5943,40,31,3970.69,7163.72,0.00
2024-12-08 17:15:39,71,5944,40,31,4024.64,7164.00,0.00
2024-12-08 17:15:39,72,5944,41,31,3968.74,7164.01,0.00
2024-12-08 17:15:39,71,5944,40,31,4023.63,7164.01,0.00
2024-12-08 17:15:39,70,5944,40,30,4058.33,7164.14,0.00
2024-12-08 17:15:39,70,5945,40,30,4068.11,7165.00,0.00
2024-12-08 17:15:39,71,5945,41,30,4010.81,7165.01,0.00
2024-12-08 17:15:39,70,5945,41,29,4067.09,7165.01,0.00
2024-12-08 17:15:39,70,5946,41,29,4033.32,7166.00,0.00
2024-12-08 17:15:39,71,5946,42,29,3976.51,7166.01,0.00
2024-12-08 17:15:39,70,5946,42,28,4005.70,7166.13,0.00
2024-12-08 17:15:39,69,5946,41,28,4061.69,7166.15,0.00
2024-12-08 17:15:39,69,5947,41,28,4058.60,7167.00,0.00
2024-12-08 17:15:39,70,5947,42,28,4000.62,7167.01,0.00
2024-12-08 17:15:39,69,5947,41,28,4057.57,7167.03,0.00
2024-12-08 17:15:39,69,5948,41,28,4021.67,7168.00,0.00
2024-12-08 17:15:39,70,5948,42,28,3964.22,7168.01,0.00
2024-12-08 17:15:39,69,5948,42,27,3983.66,7168.12,0.00
2024-12-08 17:15:39,68,5948,41,27,4024.42,7168.37,0.00
2024-12-08 17:15:39,68,5949,41,27,4030.83,7169.00,0.00
2024-12-08 17:15:39,69,5949,42,27,3972.41,7169.02,0.00
2024-12-08 17:15:40,69,5950,42,27,3900.59,7170.00,0.00
2024-12-08 17:15:40,70,5950,42,28,3844.87,7170.01,0.00
2024-12-08 17:15:40,69,5950,41,28,3888.90,7170.03,0.00
2024-12-08 17:15:40,70,5949,41,29,3779.25,7170.53,0.00
2024-12-08 17:15:40,70,5950,41,29,3843.89,7171.00,0.00
2024-12-08 17:15:40,71,5950,42,29,3789.75,7171.01,0.00
2024-12-08 17:15:40,70,5950,41,29,3842.22,7171.03,0.00
2024-12-08 17:15:40,69,5950,41,28,3889.62,7171.13,0.00
2024-12-08 17:15:40,68,5950,41,27,3876.65,7171.81,0.00
2024-12-08 17:15:40,68,5951,41,27,4052.92,7172.00,0.00
2024-12-08 17:15:40,69,5951,42,27,3994.18,7172.02,0.00
2024-12-08 17:15:40,68,5951,42,26,3944.31,7172.65,0.00
2024-12-08 17:15:40,68,5952,42,26,4024.75,7173.00,0.00
2024-12-08 17:15:40,69,5952,42,27,3966.42,7173.02,0.00
2024-12-08 17:15:40,69,5953,42,27,3952.65,7174.00,0.00
2024-12-08 17:15:40,70,5953,43,27,3896.18,7174.01,0.00
2024-12-08 17:15:40,69,5953,43,26,3931.91,7174.22,0.00
2024-12-08 17:15:40,69,5954,43,26,3954.55,7175.00,0.00
2024-12-08 17:15:40,70,5954,44,26,3898.06,7175.01,0.00
2024-12-08 17:15:40,69,5954,44,25,3952.47,7175.03,0.00
2024-12-08 17:15:40,68,5954,43,25,3942.15,7175.40,0.00
2024-12-08 17:15:40,68,5955,43,25,3999.51,7176.00,0.00
2024-12-08 17:15:40,69,5955,44,25,3941.55,7176.02,0.00
2024-12-08 17:15:40,68,5955,44,24,3939.64,7176.54,0.00
2024-12-08 17:15:40,68,5956,44,24,3989.40,7177.00,0.00
2024-12-08 17:15:40,69,5956,44,25,3931.58,7177.02,0.00
2024-12-08 17:15:40,68,5956,44,24,3969.40,7177.22,0.00
2024-12-08 17:15:40,69,5955,44,25,3892.25,7177.52,0.00
2024-12-08 17:15:40,69,5956,44,25,3972.36,7178.00,0.00
2024-12-08 17:15:40,70,5956,45,25,3915.61,7178.01,0.00
2024-12-08 17:15:40,69,5956,44,25,3886.60,7178.52,0.00
2024-12-08 17:15:40,69,5957,44,25,4060.70,7179.00,0.00
2024-12-08 17:15:40,70,5957,44,26,4002.69,7179.01,0.00
2024-12-08 17:15:40,70,5958,44,26,3994.01,7180.00,0.00
2024-12-08 17:15:40,71,5958,45,26,3937.76,7180.01,0.00
2024-12-08 17:15:40,70,5958,44,26,3990.94,7180.04,0.00
2024-12-08 17:15:40,69,5958,43,26,4037.37,7180.19,0.00
2024-12-08 17:15:40,68,5958,43,25,4072.51,7180.32,0.00
2024-12-08 17:15:40,67,5958,42,25,4104.41,7180.42,0.00
2024-12-08 17:15:40,67,5959,42,25,4170.21,7181.00,0.00
2024-12-08 17:15:40,68,5959,42,26,4108.89,7181.02,0.00
2024-12-08 17:15:40,68,5960,42,26,4102.07,7182.00,0.00
2024-12-08 17:15:40,69,5960,43,26,4042.62,7182.02,0.00
2024-12-08 17:15:40,69,5961,43,26,4034.85,7183.00,0.00
2024-12-08 17:15:40,70,5961,44,26,3977.21,7183.01,0.00
2024-12-08 17:15:40,69,5961,43,26,4033.81,7183.02,0.00
2024-12-08 17:15:40,68,5961,43,25,4057.31,7183.32,0.00
2024-12-08 17:15:40,68,5962,43,25,4093.70,7184.00,0.00
2024-12-08 17:15:40,69,5962,44,25,4034.37,7184.02,0.00
2024-12-08 17:15:40,69,5963,44,25,4026.60,7185.00,0.00
2024-12-08 17:15:40,70,5963,44,26,3969.08,7185.01,0.00
2024-12-08 17:15:40,70,5964,44,26,3959.02,7186.00,0.00
2024-12-08 17:15:40,71,5964,44,27,3903.26,7186.01,0.00
2024-12-08 17:15:40,70,5964,43,27,3945.71,7186.20,0.00
2024-12-08 17:15:40,70,5965,43,27,3944.86,7187.00,0.00
2024-12-08 17:15:40,71,5965,44,27,3889.30,7187.01,0.00
2024-12-08 17:15:40,70,5965,44,26,3926.43,7187.23,0.00
2024-12-08 17:15:40,70,5966,44,26,3944.78,7188.00,0.00
2024-12-08 17:15:40,71,5966,44,27,3889.22,7188.01,0.00
2024-12-08 17:15:40,71,5967,44,27,3869.35,7189.00,0.00
2024-12-08 17:15:40,72,5967,44,28,3815.61,7189.01,0.00
2024-12-08 17:15:40,71,5967,44,27,3852.18,7189.23,0.00
2024-12-08 17:15:41,71,5968,44,27,3867.09,7190.00,0.00
2024-12-08 17:15:41,72,5968,45,27,3813.38,7190.01,0.00
2024-12-08 17:15:41,73,5967,46,27,3716.92,7190.38,0.00
2024-12-08 17:15:41,73,5968,46,27,3795.45,7191.00,0.00
2024-12-08 17:15:41,74,5968,47,27,3744.16,7191.01,0.00
2024-12-08 17:15:41,73,5968,47,26,3760.02,7191.22,0.00
2024-12-08 17:15:41,73,5969,47,26,3871.64,7192.00,0.00
2024-12-08 17:15:41,74,5969,48,26,3819.32,7192.01,0.00
2024-12-08 17:15:41,73,5969,47,26,3767.46,7192.89,0.00
2024-12-08 17:15:41,73,5970,47,26,3858.19,7193.00,0.00
2024-12-08 17:15:41,74,5970,47,27,3806.05,7193.01,0.00
2024-12-08 17:15:41,73,5970,46,27,3850.32,7193.11,0.00
2024-12-08 17:15:41,72,5970,46,26,3876.85,7193.21,0.00
2024-12-08 17:15:41,72,5971,46,26,3892.44,7194.00,0.00
2024-12-08 17:15:41,73,5971,47,26,3839.12,7194.01,0.00
2024-12-08 17:15:41,72,5971,46,26,3886.46,7194.10,0.00
2024-12-08 17:15:41,71,5971,45,26,3907.79,7194.23,0.00
2024-12-08 17:15:41,71,5972,45,26,3946.91,7195.00,0.00
2024-12-08 17:15:41,72,5972,45,27,3892.09,7195.01,0.00
2024-12-08 17:15:41,72,5973,45,27,3875.76,7196.00,0.00
2024-12-08 17:15:41,73,5973,46,27,3822.67,7196.01,0.00
2024-12-08 17:15:41,72,5973,45,27,3868.78,7196.11,0.00
2024-12-08 17:15:41,71,5973,45,26,3916.19,7196.20,0.00
2024-12-08 17:15:41,70,5973,45,25,3958.17,7196.37,0.00
2024-12-08 17:15:41,70,5974,45,25,3995.10,7197.00,0.00
2024-12-08 17:15:41,71,5974,45,26,3938.83,7197.01,0.00
2024-12-08 17:15:41,71,5975,45,26,3928.54,7198.00,0.00
2024-12-08 17:15:41,72,5975,46,26,3873.98,7198.01,0.00
2024-12-08 17:15:41,72,5976,46,26,3862.73,7199.00,0.00
2024-12-08 17:15:41,73,5976,47,26,3809.82,7199.01,0.00
2024-12-08 17:15:41,72,5976,46,26,3861.73,7199.01,0.00
2024-12-08 17:15:41,71,5976,46,25,3901.96,7199.20,0.00
2024-12-08 17:15:41,70,5976,45,25,3943.51,7199.39,0.00
2024-12-08 17:15:41,70,5977,45,25,3981.99,7200.00,0.00
2024-12-08 17:15:41,71,5977,45,26,3925.91,7200.01,0.00
2024-12-08 17:15:41,70,5977,44,26,3943.97,7200.21,0.00
2024-12-08 17:15:41,71,5976,45,26,3870.23,7200.48,0.00
2024-12-08 17:15:41,71,5977,45,26,3970.00,7201.00,0.00
2024-12-08 17:15:41,72,5977,45,27,3914.86,7201.01,0.00
2024-12-08 17:15:41,71,5977,44,27,3968.99,7201.01,0.00
2024-12-08 17:15:41,70,5977,44,26,3971.19,7201.19,0.00
2024-12-08 17:15:41,70,5978,44,26,4117.74,7202.00,0.00
2024-12-08 17:15:41,71,5978,45,26,4059.74,7202.01,0.00
2024-12-08 17:15:41,70,5978,44,26,4070.72,7202.37,0.00
2024-12-08 17:15:41,70,5979,44,26,4108.21,7203.00,0.00
2024-12-08 17:15:41,71,5979,45,26,4050.35,7203.01,0.00
2024-12-08 17:15:41,70,5979,44,26,4101.02,7203.10,0.00
2024-12-08 17:15:41,70,5980,44,26,4098.49,7204.00,0.00
2024-12-08 17:15:41,71,5980,45,26,4040.76,7204.01,0.00
2024-12-08 17:15:41,72,5979,45,27,3945.69,7204.31,0.00
2024-12-08 17:15:41,72,5980,45,27,4024.22,7205.00,0.00
2024-12-08 17:15:41,73,5980,46,27,3969.10,7205.01,0.00
2024-12-08 17:15:41,72,5980,45,27,4018.23,7205.10,0.00
2024-12-08 17:15:41,71,5980,45,26,4057.58,7205.16,0.00
2024-12-08 17:15:41,71,5981,45,26,4179.92,7206.00,0.00
2024-12-08 17:15:41,72,5981,45,27,4121.86,7206.01,0.00
2024-12-08 17:15:41,72,5982,45,27,4111.42,7207.00,0.00
2024-12-08 17:15:41,73,5982,45,28,4055.10,7207.01,0.00
2024-12-08 17:15:42,73,5983,45,28,4043.82,7208.00,0.00
2024-12-08 17:15:42,74,5983,46,28,3989.17,7208.01,0.00
2024-12-08 17:15:42,73,5983,45,28,4042.83,7208.01,0.00
2024-12-08 17:15:42,72,5983,44,28,4087.99,7208.15,0.00
2024-12-08 17:15:42,71,5983,44,27,4141.51,7208.17,0.00
2024-12-08 17:15:42,72,5982,45,27,4073.06,7208.35,0.00
2024-12-08 17:15:42,72,5983,45,27,4133.56,7209.00,0.00
2024-12-08 17:15:42,73,5983,45,28,4076.93,7209.01,0.00
2024-12-08 17:15:42,72,5983,44,28,4132.56,7209.01,0.00
2024-12-08 17:15:42,71,5983,43,28,4188.73,7209.01,0.00
2024-12-08 17:15:42,71,5984,43,28,4300.74,7210.00,0.00
2024-12-08 17:15:42,72,5984,44,28,4241.01,7210.01,0.00
2024-12-08 17:15:42,71,5984,43,28,4293.65,7210.10,0.00
2024-12-08 17:15:42,70,5984,42,28,4333.36,7210.11,0.00
2024-12-08 17:15:42,70,5985,42,28,4352.03,7211.00,0.00
2024-12-08 17:15:42,71,5985,42,29,4290.73,7211.01,0.00
2024-12-08 17:15:42,70,5985,42,28,4343.81,7211.11,0.00
2024-12-08 17:15:42,70,5986,42,28,4362.29,7212.00,0.00
2024-12-08 17:15:42,71,5986,43,28,4300.85,7212.01,0.00
2024-12-08 17:15:42,71,5987,43,28,4290.20,7213.00,0.00
2024-12-08 17:15:42,72,5987,44,28,4230.62,7213.01,0.00
2024-12-08 17:15:42,71,5987,44,27,4262.79,7213.11,0.00
2024-12-08 17:15:42,71,5988,44,27,4279.19,7214.00,0.00
2024-12-08 17:15:42,72,5988,44,28,4219.75,7214.01,0.00
2024-12-08 17:15:42,71,5988,43,28,4277.16,7214.03,0.00
2024-12-08 17:15:42,71,5989,43,28,4266.63,7215.00,0.00
2024-12-08 17:15:42,72,5989,44,28,4207.37,7215.01,0.00
2024-12-08 17:15:42,72,5990,44,28,4194.61,7216.00,0.00
2024-12-08 17:15:42,73,5990,45,28,4137.15,7216.01,0.00
2024-12-08 17:15:42,72,5990,44,28,4192.61,7216.03,0.00
2024-12-08 17:15:42,72,5991,44,28,4180.58,7217.00,0.00
2024-12-08 17:15:42,73,5991,44,29,4123.31,7217.01,0.00
2024-12-08 17:15:42,72,5991,43,29,4151.53,7217.13,0.00
2024-12-08 17:15:42,72,5992,43,29,4166.25,7218.00,0.00
2024-12-08 17:15:42,73,5992,44,29,4109.18,7218.01,0.00
2024-12-08 17:15:42,72,5992,44,28,4153.23,7218.10,0.00
2024-12-08 17:15:42,71,5992,44,27,4211.29,7218.10,0.00
2024-12-08 17:15:42,72,5991,44,28,4103.84,7218.76,0.00
2024-12-08 17:15:42,72,5992,44,28,4202.30,7219.00,0.00
2024-12-08 17:15:42,73,5992,44,29,4144.73,7219.01,0.00
2024-12-08 17:15:42,72,5992,43,29,4190.27,7219.04,0.00
2024-12-08 17:15:42,72,5993,43,29,4298.08,7220.00,0.00
2024-12-08 17:15:42,73,5993,44,29,4239.21,7220.01,0.00
2024-12-08 17:15:42,72,5993,44,28,4273.03,7220.08,0.00
2024-12-08 17:15:42,72,5994,44,28,4282.66,7221.00,0.00
2024-12-08 17:15:42,73,5994,44,29,4223.99,7221.01,0.00
2024-12-08 17:15:42,73,5995,44,29,4206.85,7222.00,0.00
2024-12-08 17:15:42,74,5995,44,30,4150.00,7222.01,0.00
2024-12-08 17:15:42,73,5995,44,29,4183.12,7222.08,0.00
2024-12-08 17:15:42,73,5996,44,29,4189.92,7223.00,0.00
2024-12-08 17:15:42,74,5996,45,29,4133.29,7223.01,0.00
2024-12-08 17:15:43,74,5997,45,29,4114.51,7224.00,0.00
2024-12-08 17:15:43,75,5997,46,29,4059.65,7224.01,0.00
2024-12-08 17:15:43,74,5997,46,28,4090.12,7224.10,0.00
2024-12-08 17:15:43,74,5998,46,28,4096.22,7225.00,0.00
2024-12-08 17:15:43,75,5998,46,29,4041.60,7225.01,0.00
2024-12-08 17:15:43,75,5999,46,29,4020.79,7226.00,0.00
2024-12-08 17:15:43,76,5999,47,29,3967.88,7226.01,0.00
2024-12-08 17:15:43,75,5999,46,29,4018.86,7226.03,0.00
2024-12-08 17:15:43,74,5999,46,28,4051.70,7226.08,0.00
2024-12-08 17:15:43,74,6000,46,28,4051.77,7227.00,0.00
2024-12-08 17:15:43,75,6000,46,29,3997.75,7227.01,0.00
2024-12-08 17:15:43,74,6000,45,29,4039.11,7227.15,0.00
2024-12-08 17:15:43,74,6001,45,29,4038.78,7228.00,0.00
2024-12-08 17:15:43,75,6001,45,30,3984.93,7228.01,0.00
2024-12-08 17:15:43,75,6002,45,30,3952.16,7229.00,0.00
2024-12-08 17:15:43,76,6002,46,30,3900.16,7229.01,0.00
2024-12-08 17:15:43,75,6002,45,30,3935.79,7229.07,0.00
2024-12-08 17:15:43,74,6002,45,29,3982.15,7229.14,0.00
2024-12-08 17:15:43,74,6003,45,29,3999.66,7230.00,0.00
2024-12-08 17:15:43,75,6003,46,29,3946.33,7230.01,0.00
2024-12-08 17:15:43,75,6004,46,29,3920.29,7231.00,0.00
2024-12-08 17:15:43,76,6004,47,29,3868.71,7231.01,0.00
2024-12-08 17:15:43,75,6004,47,28,3892.36,7231.13,0.00
2024-12-08 17:15:43,74,6004,47,27,3909.20,7231.47,0.00
2024-12-08 17:15:43,74,6005,47,27,3945.34,7232.00,0.00
2024-12-08 17:15:43,75,6005,48,27,3892.74,7232.01,0.00
2024-12-08 17:15:43,75,6006,48,27,3869.57,7233.00,0.00
2024-12-08 17:15:43,76,6006,48,28,3818.66,7233.01,0.00
2024-12-08 17:15:43,75,6006,47,28,3867.65,7233.03,0.00
2024-12-08 17:15:43,74,6006,46,28,3917.97,7233.04,0.00
2024-12-08 17:15:43,73,6006,45,28,3965.71,7233.12,0.00
2024-12-08 17:15:43,72,6006,45,27,3999.69,7233.13,0.00
2024-12-08 17:15:43,72,6007,45,27,4009.73,7234.00,0.00
2024-12-08 17:15:43,73,6007,46,27,3954.80,7234.01,0.00
2024-12-08 17:15:43,72,6007,45,27,3931.61,7234.43,0.00
2024-12-08 17:15:43,72,6008,45,27,3988.72,7235.00,0.00
2024-12-08 17:15:43,73,6008,46,27,3934.08,7235.01,0.00
2024-12-08 17:15:43,72,6008,46,26,3916.48,7235.40,0.00
2024-12-08 17:15:43,72,6009,46,26,3972.73,7236.00,0.00
2024-12-08 17:15:43,73,6009,47,26,3918.31,7236.01,0.00
2024-12-08 17:15:43,72,6009,46,26,3963.72,7236.14,0.00
2024-12-08 17:15:43,71,6009,45,26,4018.53,7236.14,0.00
2024-12-08 17:15:43,70,6009,45,25,4073.87,7236.14,0.00
2024-12-08 17:15:43,70,6010,45,25,4094.93,7237.00,0.00
2024-12-08 17:15:43,71,6010,46,25,4037.25,7237.01,0.00
2024-12-08 17:15:43,71,6011,46,25,4027.62,7238.00,0.00
2024-12-08 17:15:43,72,6011,46,26,3971.68,7238.01,0.00
2024-12-08 17:15:43,71,6011,46,25,3998.08,7238.14,0.00
2024-12-08 17:15:43,71,6012,46,25,4017.98,7239.00,0.00
2024-12-08 17:15:43,72,6012,47,25,3962.17,7239.01,0.00
2024-12-08 17:15:43,72,6013,47,25,3951.66,7240.00,0.00
2024-12-08 17:15:43,73,6013,48,25,3897.53,7240.01,0.00
2024-12-08 17:15:43,72,6013,48,24,3921.52,7240.15,0.00
2024-12-08 17:15:43,72,6014,48,24,3941.14,7241.00,0.00
2024-12-08 17:15:43,73,6014,48,25,3887.15,7241.01,0.00
2024-12-08 17:15:44,73,6015,48,25,3875.79,7242.00,0.00
2024-12-08 17:15:44,74,6015,49,25,3823.41,7242.01,0.00
2024-12-08 17:15:44,73,6015,48,25,3875.79,7242.01,0.00
2024-12-08 17:15:44,72,6015,47,25,3913.54,7242.10,0.00
2024-12-08 17:15:44,71,6015,47,24,3945.21,7242.14,0.00
2024-12-08 17:15:44,71,6016,47,24,3985.51,7243.00,0.00
2024-12-08 17:15:44,72,6016,48,24,3930.16,7243.01,0.00
2024-12-08 17:15:44,71,6016,47,24,3946.79,7243.20,0.00
2024-12-08 17:15:44,71,6017,47,24,3991.17,7244.00,0.00
2024-12-08 17:15:44,72,6017,48,24,3935.73,7244.01,0.00
2024-12-08 17:15:44,72,6018,48,24,3925.21,7245.00,0.00
2024-12-08 17:15:44,73,6018,49,24,3871.44,7245.01,0.00
2024-12-08 17:15:44,72,6018,49,23,3913.16,7245.17,0.00
2024-12-08 17:15:44,72,6019,49,23,3933.60,7246.00,0.00
2024-12-08 17:15:44,73,6019,50,23,3879.71,7246.01,0.00
2024-12-08 17:15:44,72,6019,49,23,3931.59,7246.04,0.00
2024-12-08 17:15:44,72,6020,49,23,3921.60,7247.00,0.00
2024-12-08 17:15:44,73,6020,49,24,3867.88,7247.01,0.00
2024-12-08 17:15:44,72,6020,49,23,3891.43,7247.15,0.00
2024-12-08 17:15:44,72,6021,49,23,3908.13,7248.00,0.00
2024-12-08 17:15:44,73,6021,49,24,3854.60,7248.01,0.00
2024-12-08 17:15:44,72,6021,48,24,3905.13,7248.06,0.00
2024-12-08 17:15:44,71,6021,47,24,3959.11,7248.06,0.00
2024-12-08 17:15:44,71,6022,47,24,3947.73,7249.00,0.00
2024-12-08 17:15:44,72,6022,47,25,3892.90,7249.01,0.00
2024-12-08 17:15:44,71,6022,47,24,3919.16,7249.13,0.00
2024-12-08 17:15:44,71,6023,47,24,3931.63,7250.00,0.00
2024-12-08 17:15:44,72,6023,47,25,3877.03,7250.01,0.00
2024-12-08 17:15:44,72,6024,47,25,3858.40,7251.00,0.00
2024-12-08 17:15:44,73,6024,47,26,3805.55,7251.01,0.00
2024-12-08 17:15:44,72,6024,47,25,3831.23,7251.13,0.00
2024-12-08 17:15:44,71,6024,46,25,3861.71,7251.16,0.00
2024-12-08 17:15:44,71,6025,46,25,3893.00,7252.00,0.00
2024-12-08 17:15:44,72,6025,46,26,3838.93,7252.01,0.00
2024-12-08 17:15:44,72,6026,46,26,3815.00,7253.00,0.00
2024-12-08 17:15:44,73,6026,46,27,3762.74,7253.01,0.00
2024-12-08 17:15:44,72,6026,46,26,3761.49,7253.33,0.00
2024-12-08 17:15:44,72,6027,46,26,3794.18,7254.00,0.00
2024-12-08 17:15:44,73,6027,46,27,3742.20,7254.01,0.00
2024-12-08 17:15:44,72,6027,46,26,3778.08,7254.18,0.00
2024-12-08 17:15:44,72,6028,46,26,3799.74,7255.00,0.00
2024-12-08 17:15:44,73,6028,46,27,3747.69,7255.01,0.00
2024-12-08 17:15:44,72,6028,45,27,3788.68,7255.17,0.00
2024-12-08 17:15:44,72,6029,45,27,3787.36,7256.00,0.00
2024-12-08 17:15:44,73,6029,46,27,3735.48,7256.01,0.00
2024-12-08 17:15:44,73,6030,46,27,3722.26,7257.00,0.00
2024-12-08 17:15:44,74,6030,46,28,3671.96,7257.01,0.00
2024-12-08 17:15:44,73,6030,46,27,3705.38,7257.19,0.00
2024-12-08 17:15:44,73,6031,46,27,3726.75,7258.00,0.00
2024-12-08 17:15:44,74,6031,46,28,3676.39,7258.01,0.00
2024-12-08 17:15:44,73,6031,45,28,3721.79,7258.07,0.00
2024-12-08 17:15:44,73,6032,45,28,3714.33,7259.00,0.00
2024-12-08 17:15:44,74,6032,46,28,3664.14,7259.01,0.00
2024-12-08 17:15:45,74,6033,46,28,3651.89,7260.00,0.00
2024-12-08 17:15:45,75,6033,47,28,3603.20,7260.01,0.00
2024-12-08 17:15:45,74,6033,46,28,3637.21,7260.18,0.00
2024-12-08 17:15:45,73,6033,46,27,3685.05,7260.18,0.00
2024-12-08 17:15:45,73,6034,46,27,3705.43,7261.00,0.00
2024-12-08 17:15:45,74,6034,46,28,3655.35,7261.01,0.00
2024-12-08 17:15:45,73,6034,45,28,3699.11,7261.07,0.00
2024-12-08 17:15:45,73,6035,45,28,3691.38,7262.00,0.00
2024-12-08 17:15:45,74,6035,46,28,3641.49,7262.01,0.00
2024-12-08 17:15:45,73,6035,46,27,3660.04,7262.21,0.00
2024-12-08 17:15:45,73,6036,46,27,3682.14,7263.00,0.00
2024-12-08 17:15:45,74,6036,47,27,3632.38,7263.01,0.00
2024-12-08 17:15:45,73,6036,46,27,3678.17,7263.07,0.00
2024-12-08 17:15:45,73,6037,46,27,3670.71,7264.00,0.00
2024-12-08 17:15:45,74,6037,47,27,3621.10,7264.01,0.00
2024-12-08 17:15:45,73,6037,46,27,3599.15,7264.73,0.00
2024-12-08 17:15:45,73,6038,46,27,3659.07,7265.00,0.00
2024-12-08 17:15:45,74,6038,47,27,3609.63,7265.01,0.00
2024-12-08 17:15:45,73,6038,47,26,3642.18,7265.21,0.00
2024-12-08 17:15:45,73,6039,47,26,3663.52,7266.00,0.00
2024-12-08 17:15:45,74,6039,47,27,3614.01,7266.01,0.00
2024-12-08 17:15:45,73,6039,46,27,3660.53,7266.04,0.00
2024-12-08 17:15:45,73,6040,46,27,3651.01,7267.00,0.00
2024-12-08 17:15:45,74,6040,47,27,3601.67,7267.01,0.00
2024-12-08 17:15:45,74,6041,47,27,3588.86,7268.00,0.00
2024-12-08 17:15:45,75,6041,47,28,3541.00,7268.01,0.00
2024-12-08 17:15:45,74,6041,46,28,3586.89,7268.03,0.00
2024-12-08 17:15:45,73,6041,45,28,3632.62,7268.07,0.00
2024-12-08 17:15:45,72,6041,44,28,3675.02,7268.17,0.00
2024-12-08 17:15:45,71,6041,44,27,3723.71,7268.18,0.00
2024-12-08 17:15:45,71,6042,44,27,3745.16,7269.00,0.00
2024-12-08 17:15:45,72,6042,45,27,3693.14,7269.01,0.00
2024-12-08 17:15:45,72,6043,45,27,3680.45,7270.00,0.00
2024-12-08 17:15:45,73,6043,46,27,3630.03,7270.01,0.00
2024-12-08 17:15:45,73,6044,46,27,3616.51,7271.00,0.00
2024-12-08 17:15:45,74,6044,46,28,3567.64,7271.01,0.00
2024-12-08 17:15:45,73,6044,45,28,3613.53,7271.06,0.00
2024-12-08 17:15:45,72,6044,44,28,3655.66,7271.17,0.00
2024-12-08 17:15:45,71,6044,44,27,3706.12,7271.17,0.00
2024-12-08 17:15:45,70,6044,43,27,3735.50,7271.46,0.00
2024-12-08 17:15:45,70,6045,43,27,3779.50,7272.00,0.00
2024-12-08 17:15:45,71,6045,43,28,3726.27,7272.01,0.00
2024-12-08 17:15:45,70,6045,42,28,3737.98,7272.23,0.00
2024-12-08 17:15:45,70,6046,42,28,3784.95,7273.00,0.00
2024-12-08 17:15:45,71,6046,43,28,3731.64,7273.01,0.00
2024-12-08 17:15:45,70,6046,42,28,3781.84,7273.06,0.00
2024-12-08 17:15:45,69,6046,42,27,3806.61,7273.19,0.00
2024-12-08 17:15:45,69,6047,42,27,3830.92,7274.00,0.00
2024-12-08 17:15:45,70,6047,42,28,3776.19,7274.01,0.00
2024-12-08 17:15:45,69,6047,41,28,3828.81,7274.03,0.00
2024-12-08 17:15:45,68,6047,40,28,3872.31,7274.18,0.00
2024-12-08 17:15:45,68,6048,40,28,3896.46,7275.00,0.00
2024-12-08 17:15:45,69,6048,40,29,3839.99,7275.02,0.00
2024-12-08 17:15:45,69,6049,40,29,3829.30,7276.00,0.00
2024-12-08 17:15:45,70,6049,41,29,3774.59,7276.01,0.00
2024-12-08 17:15:45,69,6049,41,28,3815.34,7276.17,0.00
2024-12-08 17:15:45,68,6049,40,28,3853.37,7276.43,0.00
2024-12-08 17:15:45,68,6050,40,28,3894.49,7277.00,0.00
2024-12-08 17:15:45,69,6050,40,29,3838.05,7277.02,0.00
2024-12-08 17:15:45,68,6050,39,29,3885.00,7277.02,0.00
2024-12-08 17:15:45,68,6051,39,29,3896.53,7278.00,0.00
2024-12-08 17:15:45,69,6051,40,29,3840.06,7278.02,0.00
2024-12-08 17:15:45,68,6051,39,29,3889.39,7278.07,0.00
2024-12-08 17:15:45,67,6051,39,28,3918.72,7278.16,0.00
2024-12-08 17:15:46,67,6052,39,28,3964.03,7279.00,0.00
2024-12-08 17:15:46,68,6052,40,28,3905.73,7279.02,0.00
2024-12-08 17:15:46,67,6052,39,28,3962.94,7279.03,0.00
2024-12-08 17:15:46,66,6052,38,28,4021.88,7279.03,0.00
2024-12-08 17:15:46,65,6052,37,28,4050.19,7279.15,0.00
2024-12-08 17:15:46,65,6053,37,28,4098.75,7280.00,0.00
2024-12-08 17:15:46,66,6053,38,28,4036.65,7280.02,0.00
2024-12-08 17:15:46,65,6053,38,27,4067.42,7280.14,0.00
2024-12-08 17:15:46,65,6054,38,27,4093.59,7281.00,0.00
2024-12-08 17:15:46,66,6054,38,28,4031.57,7281.02,0.00
2024-12-08 17:15:46,66,6055,38,28,4026.31,7282.00,0.00
2024-12-08 17:15:46,67,6055,39,28,3966.22,7282.02,0.00
2024-12-08 17:15:46,66,6055,39,27,3995.44,7282.14,0.00
2024-12-08 17:15:46,66,6056,39,27,4021.35,7283.00,0.00
2024-12-08 17:15:46,67,6056,40,27,3961.33,7283.02,0.00
2024-12-08 17:15:46,66,6056,39,27,4020.24,7283.02,0.00
2024-12-08 17:15:46,66,6057,39,27,4015.28,7284.00,0.00
2024-12-08 17:15:46,67,6057,40,27,3955.35,7284.02,0.00
2024-12-08 17:15:46,66,6057,39,27,4013.40,7284.03,0.00
2024-12-08 17:15:46,65,6057,39,26,4048.27,7284.11,0.00
2024-12-08 17:15:46,65,6058,39,26,4073.46,7285.00,0.00
2024-12-08 17:15:46,66,6058,39,27,4011.74,7285.02,0.00
2024-12-08 17:15:46,65,6058,38,27,4071.22,7285.03,0.00
2024-12-08 17:15:46,65,6059,38,27,4068.41,7286.00,0.00
2024-12-08 17:15:46,66,6059,39,27,4006.77,7286.02,0.00
2024-12-08 17:15:46,65,6059,38,27,4042.65,7286.09,0.00
2024-12-08 17:15:46,64,6059,38,26,4081.92,7286.11,0.00
2024-12-08 17:15:46,64,6060,38,26,4131.41,7287.00,0.00
2024-12-08 17:15:46,65,6060,38,27,4067.85,7287.02,0.00
2024-12-08 17:15:46,65,6061,38,27,4063.93,7288.00,0.00
2024-12-08 17:15:46,66,6061,38,28,4002.35,7288.02,0.00
2024-12-08 17:15:46,65,6061,38,27,4033.68,7288.12,0.00
2024-12-08 17:15:46,65,6062,38,27,4058.40,7289.00,0.00
2024-12-08 17:15:46,66,6062,39,27,3996.91,7289.02,0.00
2024-12-08 17:15:46,65,6062,38,27,4025.91,7289.14,0.00
2024-12-08 17:15:46,64,6062,37,27,4053.68,7289.50,0.00
2024-12-08 17:15:46,64,6063,37,27,4123.55,7290.00,0.00
2024-12-08 17:15:46,65,6063,38,27,4060.11,7290.02,0.00
2024-12-08 17:15:46,64,6063,38,26,4093.96,7290.13,0.00
2024-12-08 17:15:46,64,6064,38,26,4107.42,7291.00,0.00
2024-12-08 17:15:46,65,6064,39,26,4044.23,7291.02,0.00
2024-12-08 17:15:46,66,6063,40,26,3851.01,7291.99,0.00
2024-12-08 17:15:46,66,6064,40,26,3983.60,7292.00,0.00
2024-12-08 17:15:46,67,6064,41,26,3924.14,7292.02,0.00
2024-12-08 17:15:46,67,6065,41,26,4002.72,7293.00,0.00
2024-12-08 17:15:46,68,6065,41,27,3943.85,7293.02,0.00
2024-12-08 17:15:46,69,6064,41,28,3884.59,7293.07,0.00
2024-12-08 17:15:46,68,6064,41,27,4040.42,7293.16,0.00
2024-12-08 17:15:46,68,6065,41,27,4045.48,7294.00,0.00
2024-12-08 17:15:46,69,6065,41,28,3986.85,7294.02,0.00
2024-12-08 17:15:46,69,6066,41,28,4068.18,7295.00,0.00
2024-12-08 17:15:46,70,6066,42,28,4010.06,7295.01,0.00
2024-12-08 17:15:46,69,6066,41,28,4053.43,7295.17,0.00
2024-12-08 17:15:46,69,6067,41,28,4068.87,7296.00,0.00
2024-12-08 17:15:46,70,6067,41,29,4010.74,7296.01,0.00
2024-12-08 17:15:46,69,6067,41,28,4054.11,7296.17,0.00
2024-12-08 17:15:46,69,6068,41,28,4075.59,7297.00,0.00
2024-12-08 17:15:46,70,6068,41,29,4017.37,7297.01,0.00
2024-12-08 17:15:46,69,6068,40,29,4018.65,7297.45,0.00
2024-12-08 17:15:46,69,6069,40,29,4080.60,7298.00,0.00
2024-12-08 17:15:46,70,6069,41,29,4022.31,7298.01,0.00
2024-12-08 17:15:47,70,6070,41,29,4007.03,7299.00,0.00
2024-12-08 17:15:47,71,6070,42,29,3950.59,7299.01,0.00
2024-12-08 17:15:47,70,6070,42,28,3990.39,7299.20,0.00
2024-12-08 17:15:47,69,6070,42,27,4009.37,7299.67,0.00
2024-12-08 17:15:47,69,6071,42,27,4065.14,7300.00,0.00
2024-12-08 17:15:47,70,6071,43,27,4007.06,7300.01,0.00
2024-12-08 17:15:47,70,6072,43,27,3991.29,7301.00,0.00
2024-12-08 17:15:47,71,6072,44,27,3935.07,7301.01,0.00
2024-12-08 17:15:47,71,6073,44,27,3917.42,7302.00,0.00
2024-12-08 17:15:47,72,6073,44,28,3863.01,7302.01,0.00
2024-12-08 17:15:47,71,6073,43,28,3903.07,7302.20,0.00
2024-12-08 17:15:47,70,6073,43,27,3949.45,7302.24,0.00
2024-12-08 17:15:47,70,6074,43,27,3970.19,7303.00,0.00
2024-12-08 17:15:47,71,6074,44,27,3914.27,7303.01,0.00
2024-12-08 17:15:47,70,6074,43,27,3899.38,7303.63,0.00
2024-12-08 17:15:47,70,6075,43,27,3956.01,7304.00,0.00
2024-12-08 17:15:47,71,6075,44,27,3900.29,7304.01,0.00
2024-12-08 17:15:47,72,6074,44,28,3846.12,7304.04,0.00
2024-12-08 17:15:47,72,6075,44,28,3924.08,7305.00,0.00
2024-12-08 17:15:47,73,6075,44,29,3870.33,7305.01,0.00
2024-12-08 17:15:47,72,6075,44,28,3903.85,7305.24,0.00
2024-12-08 17:15:47,72,6076,44,28,4031.16,7306.00,0.00
2024-12-08 17:15:47,73,6076,45,28,3975.94,7306.01,0.00
2024-12-08 17:15:47,72,6076,44,28,4015.90,7306.21,0.00
2024-12-08 17:15:47,71,6076,43,28,4071.44,7306.21,0.00
2024-12-08 17:15:47,71,6077,43,28,4074.43,7307.00,0.00
2024-12-08 17:15:47,72,6077,43,29,4017.84,7307.01,0.00
2024-12-08 17:15:47,71,6077,42,29,4068.91,7307.07,0.00
2024-12-08 17:15:47,71,6078,42,29,4056.79,7308.00,0.00
2024-12-08 17:15:47,72,6078,43,29,4000.44,7308.01,0.00
2024-12-08 17:15:47,71,6078,42,29,4054.74,7308.03,0.00
2024-12-08 17:15:47,70,6078,42,28,4099.13,7308.19,0.00
2024-12-08 17:15:47,70,6079,42,28,4118.90,7309.00,0.00
2024-12-08 17:15:47,71,6079,43,28,4060.89,7309.01,0.00
2024-12-08 17:15:47,71,6080,43,28,4048.88,7310.00,0.00
2024-12-08 17:15:47,72,6080,44,28,3992.64,7310.01,0.00
2024-12-08 17:15:47,71,6080,44,27,4014.95,7310.18,0.00
2024-12-08 17:15:47,71,6081,44,27,4035.95,7311.00,0.00
2024-12-08 17:15:47,72,6081,44,28,3979.89,7311.01,0.00
2024-12-08 17:15:47,71,6081,43,28,4030.83,7311.08,0.00
2024-12-08 17:15:47,70,6081,42,28,4075.89,7311.13,0.00
2024-12-08 17:15:47,70,6082,42,28,4092.62,7312.00,0.00
2024-12-08 17:15:47,71,6082,42,29,4034.98,7312.01,0.00
2024-12-08 17:15:47,70,6082,42,28,4061.33,7312.16,0.00
2024-12-08 17:15:47,70,6083,42,28,4079.23,7313.00,0.00
2024-12-08 17:15:47,71,6083,42,29,4021.78,7313.01,0.00
2024-12-08 17:15:47,70,6083,41,29,4076.12,7313.04,0.00
2024-12-08 17:15:47,69,6083,40,29,4133.08,7313.07,0.00
2024-12-08 17:15:47,68,6083,39,29,4156.82,7313.25,0.00
2024-12-08 17:15:47,68,6084,39,29,4188.49,7314.00,0.00
2024-12-08 17:15:47,69,6084,39,30,4127.79,7314.02,0.00
2024-12-08 17:15:47,69,6085,39,30,4119.87,7315.00,0.00
2024-12-08 17:15:47,70,6085,40,30,4061.02,7315.01,0.00
2024-12-08 17:15:47,69,6085,40,29,4107.21,7315.17,0.00
2024-12-08 17:15:47,69,6086,40,29,4132.10,7316.00,0.00
2024-12-08 17:15:47,70,6086,41,29,4073.07,7316.01,0.00
2024-12-08 17:15:47,70,6087,41,29,4064.22,7317.00,0.00
2024-12-08 17:15:47,71,6087,41,30,4006.97,7317.01,0.00
2024-12-08 17:15:47,71,6088,41,30,3997.21,7318.00,0.00
2024-12-08 17:15:47,72,6088,41,31,3941.70,7318.01,0.00
2024-12-08 17:15:47,71,6088,41,30,3971.49,7318.14,0.00
2024-12-08 17:15:48,71,6089,41,30,3991.58,7319.00,0.00
2024-12-08 17:15:48,72,6089,42,30,3936.14,7319.01,0.00
2024-12-08 17:15:48,71,6089,42,29,3961.73,7319.16,0.00
2024-12-08 17:15:48,71,6090,42,29,3982.84,7320.00,0.00
2024-12-08 17:15:48,72,6090,43,29,3927.53,7320.01,0.00
2024-12-08 17:15:48,71,6090,42,29,3950.93,7320.17,0.00
2024-12-08 17:15:48,70,6090,41,29,3991.77,7320.39,0.00
2024-12-08 17:15:48,70,6091,41,29,4030.88,7321.00,0.00
2024-12-08 17:15:48,71,6091,41,30,3974.11,7321.01,0.00
2024-12-08 17:15:48,70,6091,41,29,4010.00,7321.13,0.00
2024-12-08 17:15:48,70,6092,41,29,4030.38,7322.00,0.00
2024-12-08 17:15:48,71,6092,42,29,3973.62,7322.01,0.00
2024-12-08 17:15:48,71,6093,42,29,3963.85,7323.00,0.00
2024-12-08 17:15:48,72,6093,43,29,3908.79,7323.01,0.00
2024-12-08 17:15:48,71,6093,43,28,3943.25,7323.13,0.00
2024-12-08 17:15:48,71,6094,43,28,3962.33,7324.00,0.00
2024-12-08 17:15:48,72,6094,44,28,3907.29,7324.01,0.00
2024-12-08 17:15:48,71,6094,43,28,3959.25,7324.04,0.00
2024-12-08 17:15:48,70,6094,42,28,3987.58,7324.14,0.00
2024-12-08 17:15:48,70,6095,42,28,4009.01,7325.00,0.00
2024-12-08 17:15:48,71,6095,43,28,3952.55,7325.01,0.00
2024-12-08 17:15:48,70,6095,43,27,3987.07,7325.11,0.00
2024-12-08 17:15:48,70,6096,43,27,4006.42,7326.00,0.00
2024-12-08 17:15:48,71,6096,43,28,3949.99,7326.01,0.00
2024-12-08 17:15:48,70,6096,42,28,4003.30,7326.04,0.00
2024-12-08 17:15:48,69,6096,41,28,4016.78,7326.25,0.00
2024-12-08 17:15:48,69,6097,41,28,4068.23,7327.00,0.00
2024-12-08 17:15:48,70,6097,41,29,4010.11,7327.01,0.00
2024-12-08 17:15:48,69,6097,41,28,4045.95,7327.10,0.00
2024-12-08 17:15:48,69,6098,41,28,4065.59,7328.00,0.00
2024-12-08 17:15:48,70,6098,42,28,4007.51,7328.01,0.00
2024-12-08 17:15:48,69,6098,41,28,4052.87,7328.06,0.00
2024-12-08 17:15:48,69,6099,41,28,4069.34,7329.00,0.00
2024-12-08 17:15:48,70,6099,42,28,4011.20,7329.01,0.00
2024-12-08 17:15:48,69,6099,42,27,4042.81,7329.12,0.00
2024-12-08 17:15:48,69,6100,42,27,4063.52,7330.00,0.00
2024-12-08 17:15:48,70,6100,43,27,4005.47,7330.01,0.00
2024-12-08 17:15:48,70,6100,43,27,3996.59,7331.00,0.00
2024-12-08 17:15:48,71,6100,43,28,3940.30,7331.01,0.00
2024-12-08 17:15:48,70,6100,43,27,3969.39,7331.13,0.00
2024-12-08 17:15:48,70,6101,43,27,3989.80,7332.00,0.00
2024-12-08 17:15:48,71,6101,44,27,3933.61,7332.01,0.00
2024-12-08 17:15:48,71,6102,44,27,3923.82,7333.00,0.00
2024-12-08 17:15:48,72,6102,44,28,3869.32,7333.01,0.00
2024-12-08 17:15:48,71,6102,44,27,3893.90,7333.16,0.00
2024-12-08 17:15:48,71,6103,44,27,3915.05,7334.00,0.00
2024-12-08 17:15:48,72,6103,45,27,3860.68,7334.01,0.00
2024-12-08 17:15:48,71,6103,44,27,3911.97,7334.04,0.00
2024-12-08 17:15:48,70,6103,43,27,3945.87,7334.11,0.00
2024-12-08 17:15:48,70,6104,43,27,3965.24,7335.00,0.00
2024-12-08 17:15:48,71,6104,44,27,3909.39,7335.01,0.00
2024-12-08 17:15:48,70,6104,44,26,3938.02,7335.13,0.00
2024-12-08 17:15:48,70,6105,44,26,3958.44,7336.00,0.00
2024-12-08 17:15:48,71,6105,44,27,3902.69,7336.01,0.00
2024-12-08 17:15:48,71,6106,44,27,3892.89,7337.00,0.00
2024-12-08 17:15:48,72,6106,45,27,3838.82,7337.01,0.00
2024-12-08 17:15:48,71,6106,45,26,3866.05,7337.13,0.00
2024-12-08 17:15:48,70,6106,44,26,3899.27,7337.14,0.00
2024-12-08 17:15:48,70,6107,44,26,3941.70,7338.00,0.00
2024-12-08 17:15:48,71,6107,44,27,3886.18,7338.01,0.00
2024-12-08 17:15:49,71,6108,44,27,3876.38,7339.00,0.00
2024-12-08 17:15:49,72,6108,44,28,3822.54,7339.01,0.00
2024-12-08 17:15:49,71,6108,44,27,3850.56,7339.13,0.00
2024-12-08 17:15:49,70,6108,43,27,3882.63,7339.43,0.00
2024-12-08 17:15:49,70,6109,43,27,3924.95,7340.00,0.00
2024-12-08 17:15:49,71,6109,44,27,3869.67,7340.01,0.00
2024-12-08 17:15:49,70,6109,43,27,3921.82,7340.04,0.00
2024-12-08 17:15:49,70,6110,43,27,3915.00,7341.00,0.00
2024-12-08 17:15:49,71,6110,43,28,3859.86,7341.01,0.00
2024-12-08 17:15:49,70,6110,43,27,3884.61,7341.13,0.00
2024-12-08 17:15:49,70,6111,43,27,3905.04,7342.00,0.00
2024-12-08 17:15:49,71,6111,44,27,3850.04,7342.01,0.00
2024-12-08 17:15:49,71,6112,44,27,3840.22,7343.00,0.00
2024-12-08 17:15:49,72,6112,44,28,3786.89,7343.01,0.00
2024-12-08 17:15:49,71,6112,43,28,3814.39,7343.11,0.00
2024-12-08 17:15:49,70,6112,42,28,3868.88,7343.11,0.00
2024-12-08 17:15:49,70,6113,42,28,3888.27,7344.00,0.00
2024-12-08 17:15:49,71,6113,43,28,3833.51,7344.01,0.00
2024-12-08 17:15:49,70,6113,42,28,3885.14,7344.04,0.00
2024-12-08 17:15:49,69,6113,42,27,3932.94,7344.13,0.00
2024-12-08 17:15:49,69,6114,42,27,3954.24,7345.00,0.00
2024-12-08 17:15:49,70,6114,43,27,3897.75,7345.01,0.00
2024-12-08 17:15:49,69,6114,42,27,3950.00,7345.06,0.00
2024-12-08 17:15:49,69,6115,42,27,3939.47,7346.00,0.00
2024-12-08 17:15:49,70,6115,42,28,3883.19,7346.01,0.00
2024-12-08 17:15:49,69,6115,41,28,3898.00,7346.20,0.00
2024-12-08 17:15:49,69,6116,41,28,3941.20,7347.00,0.00
2024-12-08 17:15:49,70,6116,42,28,3884.90,7347.01,0.00
2024-12-08 17:15:49,69,6116,42,27,3931.65,7347.13,0.00
2024-12-08 17:15:49,69,6117,42,27,3951.80,7348.00,0.00
2024-12-08 17:15:49,70,6117,43,27,3895.34,7348.01,0.00
2024-12-08 17:15:49,69,6117,42,27,3948.62,7348.06,0.00
2024-12-08 17:15:49,69,6118,42,27,3943.82,7349.00,0.00
2024-12-08 17:15:49,70,6118,42,28,3887.48,7349.01,0.00
2024-12-08 17:15:49,69,6118,42,27,3915.09,7349.12,0.00
2024-12-08 17:15:49,69,6119,42,27,3935.83,7350.00,0.00
2024-12-08 17:15:49,70,6119,42,28,3879.61,7350.01,0.00
2024-12-08 17:15:49,70,6120,42,28,3870.68,7351.00,0.00
2024-12-08 17:15:49,71,6120,42,29,3816.16,7351.01,0.00
2024-12-08 17:15:49,70,6120,41,29,3867.55,7351.06,0.00
2024-12-08 17:15:49,70,6121,41,29,3861.76,7352.00,0.00
2024-12-08 17:15:49,71,6121,41,30,3807.36,7352.01,0.00
2024-12-08 17:15:49,70,6121,40,30,3853.39,7352.13,0.00
2024-12-08 17:15:49,69,6121,40,29,3906.04,7352.15,0.00
2024-12-08 17:15:49,69,6122,40,29,3928.91,7353.00,0.00
2024-12-08 17:15:49,70,6122,40,30,3872.78,7353.01,0.00
2024-12-08 17:15:49,69,6122,40,29,3903.52,7353.15,0.00
2024-12-08 17:15:49,68,6122,39,29,3944.73,7353.24,0.00
2024-12-08 17:15:49,67,6122,38,29,3969.83,7353.70,0.00
2024-12-08 17:15:49,67,6123,38,29,4057.87,7354.00,0.00
2024-12-08 17:15:49,68,6123,39,29,3998.20,7354.02,0.00
2024-12-08 17:15:49,68,6124,39,29,3991.17,7355.00,0.00
2024-12-08 17:15:49,69,6124,40,29,3933.32,7355.02,0.00
2024-12-08 17:15:49,68,6124,40,28,3959.84,7355.15,0.00
2024-12-08 17:15:49,68,6125,40,28,3984.14,7356.00,0.00
2024-12-08 17:15:49,69,6125,41,28,3926.40,7356.02,0.00
2024-12-08 17:15:49,68,6125,40,28,3974.44,7356.15,0.00
2024-12-08 17:15:49,68,6126,40,28,3998.75,7357.00,0.00
2024-12-08 17:15:49,69,6126,40,29,3940.79,7357.02,0.00
2024-12-08 17:15:49,68,6126,40,28,3967.40,7357.15,0.00
2024-12-08 17:15:49,67,6126,39,28,4006.96,7357.42,0.00
2024-12-08 17:15:49,67,6127,39,28,4052.39,7358.00,0.00
2024-12-08 17:15:50,68,6127,39,29,3992.80,7358.02,0.00
2024-12-08 17:15:50,67,6127,38,29,4018.38,7358.16,0.00
2024-12-08 17:15:50,67,6128,38,29,4067.22,7359.00,0.00
2024-12-08 17:15:50,68,6128,38,30,4007.41,7359.02,0.00
2024-12-08 17:15:50,67,6128,38,29,4036.50,7359.15,0.00
2024-12-08 17:15:50,67,6129,38,29,4062.28,7360.00,0.00
2024-12-08 17:15:50,68,6129,39,29,4002.54,7360.02,0.00
2024-12-08 17:15:50,68,6130,39,29,3995.51,7361.00,0.00
2024-12-08 17:15:50,69,6130,39,30,3937.60,7361.02,0.00
2024-12-08 17:15:50,69,6131,39,30,3929.60,7362.00,0.00
2024-12-08 17:15:50,70,6131,39,31,3873.46,7362.01,0.00
2024-12-08 17:15:50,69,6131,39,30,3917.89,7362.16,0.00
2024-12-08 17:15:50,69,6132,39,30,3941.87,7363.00,0.00
2024-12-08 17:15:50,70,6132,39,31,3885.56,7363.01,0.00
2024-12-08 17:15:50,70,6133,39,31,3876.62,7364.00,0.00
2024-12-08 17:15:50,71,6133,39,32,3822.02,7364.01,0.00
2024-12-08 17:15:50,70,6133,38,32,3873.47,7364.04,0.00
2024-12-08 17:15:50,69,6133,37,32,3929.61,7364.04,0.00
2024-12-08 17:15:50,68,6133,37,31,3956.01,7364.16,0.00
2024-12-08 17:15:50,68,6134,37,31,3981.43,7365.00,0.00
2024-12-08 17:15:50,69,6134,38,31,3923.73,7365.02,0.00
2024-12-08 17:15:50,68,6134,37,31,3971.71,7365.15,0.00
2024-12-08 17:15:50,68,6135,37,31,3974.39,7366.00,0.00
2024-12-08 17:15:50,69,6135,37,32,3916.79,7366.02,0.00
2024-12-08 17:15:50,68,6135,37,31,3943.00,7366.15,0.00
2024-12-08 17:15:50,68,6136,37,31,3967.35,7367.00,0.00
2024-12-08 17:15:50,69,6136,38,31,3909.85,7367.02,0.00
2024-12-08 17:15:50,68,6136,37,31,3944.62,7367.12,0.00
2024-12-08 17:15:50,67,6136,36,31,4002.39,7367.13,0.00
2024-12-08 17:15:50,67,6137,36,31,4027.11,7368.00,0.00
2024-12-08 17:15:50,68,6137,36,32,3967.88,7368.02,0.00
2024-12-08 17:15:50,67,6137,35,32,4001.83,7368.12,0.00
2024-12-08 17:15:50,66,6137,35,31,4040.14,7368.12,0.00
2024-12-08 17:15:50,65,6137,34,31,4101.16,7368.12,0.00
2024-12-08 17:15:50,65,6138,34,31,4150.45,7369.00,0.00
2024-12-08 17:15:50,66,6138,34,32,4087.56,7369.02,0.00
2024-12-08 17:15:50,66,6139,34,32,4082.53,7370.00,0.00
2024-12-08 17:15:50,67,6139,35,32,4021.60,7370.02,0.00
2024-12-08 17:15:50,66,6139,34,32,4074.73,7370.12,0.00
2024-12-08 17:15:50,65,6139,33,32,4113.61,7370.12,0.00
2024-12-08 17:15:50,65,6140,33,32,4140.23,7371.00,0.00
2024-12-08 17:15:50,66,6140,33,33,4077.50,7371.02,0.00
2024-12-08 17:15:50,65,6140,33,32,4131.18,7371.12,0.00
2024-12-08 17:15:50,65,6141,33,32,4157.81,7372.00,0.00
2024-12-08 17:15:50,66,6141,34,32,4094.81,7372.02,0.00
2024-12-08 17:15:50,66,6142,34,32,4089.78,7373.00,0.00
2024-12-08 17:15:50,67,6142,34,33,4028.74,7373.02,0.00
2024-12-08 17:15:50,66,6142,33,33,4083.09,7373.11,0.00
2024-12-08 17:15:50,65,6142,33,32,4123.22,7373.11,0.00
2024-12-08 17:15:50,65,6143,33,32,4148.72,7374.00,0.00
2024-12-08 17:15:50,66,6143,33,33,4085.87,7374.02,0.00
2024-12-08 17:15:50,66,6144,33,33,4080.83,7375.00,0.00
2024-12-08 17:15:50,67,6144,34,33,4019.93,7375.02,0.00
2024-12-08 17:15:50,66,6144,34,32,4052.91,7375.11,0.00
2024-12-08 17:15:50,66,6145,34,32,4076.91,7376.00,0.00
2024-12-08 17:15:50,67,6145,35,32,4016.07,7376.02,0.00
2024-12-08 17:15:50,66,6145,34,32,4024.41,7376.12,0.00
2024-12-08 17:15:50,66,6146,34,32,4071.88,7377.00,0.00
2024-12-08 17:15:50,67,6146,34,33,4011.10,7377.02,0.00
2024-12-08 17:15:50,66,6146,34,32,4045.07,7377.11,0.00
2024-12-08 17:15:50,66,6147,34,32,4069.08,7378.00,0.00
2024-12-08 17:15:50,67,6147,35,32,4008.35,7378.02,0.00
2024-12-08 17:15:51,67,6148,35,32,4002.28,7379.00,0.00
2024-12-08 17:15:51,68,6148,35,33,3943.42,7379.02,0.00
2024-12-08 17:15:51,67,6148,35,32,3974.76,7379.10,0.00
2024-12-08 17:15:51,68,6147,35,33,3856.86,7379.65,0.00
2024-12-08 17:15:51,68,6148,35,33,4030.78,7380.00,0.00
2024-12-08 17:15:51,69,6148,35,34,3972.36,7380.02,0.00
2024-12-08 17:15:51,69,6149,35,34,4071.32,7381.00,0.00
2024-12-08 17:15:51,70,6149,35,35,4013.15,7381.01,0.00
2024-12-08 17:15:51,69,6149,35,34,4045.65,7381.10,0.00
2024-12-08 17:15:51,68,6149,34,34,4104.06,7381.12,0.00
2024-12-08 17:15:51,69,6148,34,35,3998.92,7381.77,0.00
2024-12-08 17:15:51,69,6149,34,35,4147.83,7382.00,0.00
2024-12-08 17:15:51,70,6149,35,35,4088.57,7382.01,0.00
2024-12-08 17:15:51,70,6150,35,35,4185.10,7383.00,0.00
2024-12-08 17:15:51,71,6150,35,36,4126.16,7383.01,0.00
2024-12-08 17:15:51,70,6150,35,35,4157.69,7383.11,0.00
2024-12-08 17:15:51,69,6150,34,35,4184.92,7383.48,0.00
2024-12-08 17:15:51,69,6151,34,35,4253.82,7384.00,0.00
2024-12-08 17:15:51,70,6151,35,35,4193.06,7384.01,0.00
2024-12-08 17:15:51,69,6151,34,35,4250.62,7384.04,0.00
2024-12-08 17:15:51,70,6150,35,35,4102.62,7384.69,0.00
2024-12-08 17:15:51,70,6151,35,35,4206.28,7385.00,0.00
2024-12-08 17:15:51,71,6151,35,36,4147.04,7385.01,0.00
2024-12-08 17:15:51,71,6152,35,36,4241.23,7386.00,0.00
2024-12-08 17:15:51,72,6152,35,37,4182.32,7386.01,0.00
2024-12-08 17:15:51,71,6152,34,37,4238.11,7386.04,0.00
2024-12-08 17:15:51,70,6152,34,36,4290.23,7386.14,0.00
2024-12-08 17:15:51,69,6152,33,36,4329.97,7386.28,0.00
2024-12-08 17:15:51,69,6153,33,36,4384.02,7387.00,0.00
2024-12-08 17:15:51,70,6153,34,36,4321.39,7387.01,0.00
2024-12-08 17:15:51,70,6154,34,36,4312.48,7388.00,0.00
2024-12-08 17:15:51,71,6154,35,36,4251.74,7388.01,0.00
2024-12-08 17:15:51,70,6154,35,35,4281.89,7388.14,0.00
2024-12-08 17:15:51,70,6155,35,35,4303.56,7389.00,0.00
2024-12-08 17:15:51,71,6155,36,35,4242.95,7389.01,0.00
2024-12-08 17:15:51,71,6156,36,35,4233.12,7390.00,0.00
2024-12-08 17:15:51,72,6156,37,35,4174.32,7390.01,0.00
2024-12-08 17:15:51,71,6156,36,35,4228.95,7390.06,0.00
2024-12-08 17:15:51,71,6157,36,35,4222.24,7391.00,0.00
2024-12-08 17:15:51,72,6157,37,35,4163.60,7391.01,0.00
2024-12-08 17:15:51,71,6157,36,35,4219.12,7391.04,0.00
2024-12-08 17:15:51,70,6157,35,35,4272.02,7391.14,0.00
2024-12-08 17:15:51,69,6157,35,34,4332.86,7391.15,0.00
2024-12-08 17:15:51,69,6158,35,34,4355.92,7392.00,0.00
2024-12-08 17:15:51,70,6158,36,34,4293.69,7392.01,0.00
2024-12-08 17:15:51,69,6158,35,34,4328.09,7392.13,0.00
2024-12-08 17:15:51,69,6159,35,34,4350.08,7393.00,0.00
2024-12-08 17:15:51,70,6159,35,35,4287.94,7393.01,0.00
2024-12-08 17:15:51,71,6158,35,36,4227.54,7393.04,0.00
2024-12-08 17:15:51,70,6158,34,36,4380.89,7393.04,0.00
2024-12-08 17:15:51,69,6158,34,35,4415.47,7393.13,0.00
2024-12-08 17:15:51,69,6159,34,35,4437.47,7394.00,0.00
2024-12-08 17:15:51,70,6159,35,35,4374.08,7394.01,0.00
2024-12-08 17:15:51,69,6159,34,35,4428.93,7394.12,0.00
2024-12-08 17:15:51,69,6160,34,35,4535.60,7395.00,0.00
2024-12-08 17:15:51,70,6160,35,35,4470.81,7395.01,0.00
2024-12-08 17:15:51,70,6161,35,35,4461.90,7396.00,0.00
2024-12-08 17:15:51,71,6161,36,35,4399.06,7396.01,0.00
2024-12-08 17:15:51,70,6161,35,35,4454.53,7396.11,0.00
2024-12-08 17:15:51,69,6161,35,34,4518.02,7396.12,0.00
2024-12-08 17:15:51,69,6162,35,34,4538.97,7397.00,0.00
2024-12-08 17:15:51,70,6162,36,34,4474.13,7397.01,0.00
2024-12-08 17:15:52,70,6163,36,34,4465.22,7398.00,0.00
2024-12-08 17:15:52,71,6163,37,34,4402.33,7398.01,0.00
2024-12-08 17:15:52,70,6163,37,33,4435.65,7398.11,0.00
2024-12-08 17:15:52,71,6162,38,33,4331.82,7398.70,0.00
2024-12-08 17:15:52,71,6163,38,33,4412.30,7399.00,0.00
2024-12-08 17:15:52,72,6163,38,34,4351.02,7399.01,0.00
2024-12-08 17:15:52,73,6162,39,34,4235.89,7399.52,0.00
2024-12-08 17:15:52,73,6163,39,34,4413.64,7400.00,0.00
2024-12-08 17:15:52,74,6163,40,34,4354.00,7400.01,0.00
2024-12-08 17:15:52,73,6163,39,34,4412.64,7400.03,0.00
2024-12-08 17:15:52,72,6163,39,33,4448.24,7400.10,0.00
2024-12-08 17:15:52,72,6164,39,33,4567.03,7401.00,0.00
2024-12-08 17:15:52,73,6164,40,33,4504.47,7401.01,0.00
2024-12-08 17:15:52,72,6164,39,33,4540.33,7401.10,0.00
2024-12-08 17:15:52,72,6165,39,33,4556.34,7402.00,0.00
2024-12-08 17:15:52,73,6165,40,33,4493.93,7402.01,0.00
2024-12-08 17:15:52,72,6165,40,32,4529.63,7402.10,0.00
2024-12-08 17:15:52,72,6166,40,32,4545.65,7403.00,0.00
2024-12-08 17:15:52,73,6166,41,32,4483.38,7403.01,0.00
2024-12-08 17:15:52,72,6166,40,32,4544.63,7403.03,0.00
2024-12-08 17:15:52,71,6166,39,32,4583.62,7403.08,0.00
2024-12-08 17:15:52,71,6167,39,32,4599.86,7404.00,0.00
2024-12-08 17:15:52,72,6167,39,33,4535.98,7404.01,0.00
2024-12-08 17:15:52,71,6167,39,32,4573.81,7404.08,0.00
2024-12-08 17:15:52,71,6168,39,32,4590.06,7405.00,0.00
2024-12-08 17:15:52,72,6168,39,33,4526.30,7405.01,0.00
2024-12-08 17:15:52,71,6168,38,33,4587.98,7405.04,0.00
2024-12-08 17:15:52,71,6169,38,33,4580.24,7406.00,0.00
2024-12-08 17:15:52,72,6169,38,34,4516.63,7406.01,0.00
2024-12-08 17:15:52,71,6169,38,33,4552.11,7406.10,0.00
2024-12-08 17:15:52,70,6169,37,33,4571.88,7406.53,0.00
2024-12-08 17:15:52,70,6170,37,33,4643.13,7407.00,0.00
2024-12-08 17:15:52,71,6170,38,33,4577.73,7407.01,0.00
2024-12-08 17:15:52,70,6170,37,33,4635.75,7407.10,0.00
2024-12-08 17:15:52,70,6171,37,33,4654.34,7408.00,0.00
2024-12-08 17:15:52,71,6171,38,33,4588.78,7408.01,0.00
2024-12-08 17:15:52,71,6172,38,33,4578.97,7409.00,0.00
2024-12-08 17:15:52,72,6172,39,33,4515.37,7409.01,0.00
2024-12-08 17:15:52,71,6172,38,33,4575.85,7409.06,0.00
2024-12-08 17:15:52,70,6172,38,32,4638.06,7409.09,0.00
2024-12-08 17:15:52,70,6173,38,32,4655.59,7410.00,0.00
2024-12-08 17:15:52,71,6173,39,32,4590.02,7410.01,0.00
2024-12-08 17:15:52,71,6174,39,32,4580.21,7411.00,0.00
2024-12-08 17:15:52,72,6174,39,33,4516.59,7411.01,0.00
2024-12-08 17:15:52,71,6174,39,32,4554.13,7411.08,0.00
2024-12-08 17:15:52,71,6175,39,32,4570.38,7412.00,0.00
2024-12-08 17:15:52,72,6175,40,32,4506.91,7412.01,0.00
2024-12-08 17:15:52,72,6176,40,32,4496.19,7413.00,0.00
2024-12-08 17:15:52,73,6176,40,33,4434.60,7413.01,0.00
2024-12-08 17:15:52,72,6176,40,32,4471.50,7413.08,0.00
2024-12-08 17:15:52,72,6177,40,32,4486.50,7414.00,0.00
2024-12-08 17:15:52,73,6177,41,32,4425.04,7414.01,0.00
2024-12-08 17:15:52,73,6178,41,32,4413.45,7415.00,0.00
2024-12-08 17:15:52,74,6178,41,33,4353.81,7415.01,0.00
2024-12-08 17:15:52,73,6178,41,32,4390.10,7415.08,0.00
2024-12-08 17:15:52,73,6179,41,32,4403.88,7416.00,0.00
2024-12-08 17:15:52,74,6179,41,33,4344.37,7416.01,0.00
2024-12-08 17:15:52,73,6179,40,33,4391.70,7416.04,0.00
2024-12-08 17:15:53,73,6180,40,33,4402.45,7417.00,0.00
2024-12-08 17:15:53,74,6180,41,33,4342.95,7417.01,0.00
2024-12-08 17:15:53,73,6180,41,32,4381.13,7417.07,0.00
2024-12-08 17:15:53,72,6180,40,32,4431.71,7417.15,0.00
2024-12-08 17:15:53,72,6181,40,32,4472.43,7418.00,0.00
2024-12-08 17:15:53,73,6181,41,32,4411.17,7418.01,0.00
2024-12-08 17:15:53,73,6182,41,32,4399.57,7419.00,0.00
2024-12-08 17:15:53,74,6182,42,32,4340.11,7419.01,0.00
2024-12-08 17:15:53,73,6182,42,31,4373.17,7419.11,0.00
2024-12-08 17:15:53,73,6183,42,31,4388.98,7420.00,0.00
2024-12-08 17:15:53,74,6183,42,32,4329.67,7420.01,0.00
2024-12-08 17:15:53,74,6184,42,32,4317.21,7421.00,0.00
2024-12-08 17:15:53,75,6184,43,32,4259.65,7421.01,0.00
2024-12-08 17:15:53,74,6184,43,31,4290.17,7421.12,0.00
2024-12-08 17:15:53,74,6185,43,31,4305.76,7422.00,0.00
2024-12-08 17:15:53,75,6185,44,31,4248.35,7422.01,0.00
2024-12-08 17:15:53,76,6184,44,32,4105.74,7422.68,0.00
2024-12-08 17:15:53,77,6183,44,33,4054.57,7422.97,0.00
2024-12-08 17:15:53,77,6184,44,33,4151.00,7423.00,0.00
2024-12-08 17:15:53,78,6184,45,33,4097.78,7423.01,0.00
2024-12-08 17:15:53,77,6184,44,33,4148.91,7423.03,0.00
2024-12-08 17:15:53,76,6184,44,32,4179.10,7423.11,0.00
2024-12-08 17:15:53,76,6185,44,32,4386.72,7424.00,0.00
2024-12-08 17:15:53,77,6185,44,33,4329.75,7424.01,0.00
2024-12-08 17:15:53,77,6186,44,33,4314.75,7425.00,0.00
2024-12-08 17:15:53,78,6186,44,34,4259.43,7425.01,0.00
2024-12-08 17:15:53,77,6186,44,33,4290.53,7425.10,0.00
2024-12-08 17:15:53,77,6187,44,33,4301.69,7426.00,0.00
2024-12-08 17:15:53,78,6187,45,33,4246.54,7426.01,0.00
2024-12-08 17:15:53,77,6187,44,33,4299.77,7426.04,0.00
2024-12-08 17:15:53,77,6188,44,33,4286.83,7427.00,0.00
2024-12-08 17:15:53,78,6188,44,34,4231.88,7427.01,0.00
2024-12-08 17:15:53,78,6189,44,34,4216.26,7428.00,0.00
2024-12-08 17:15:53,79,6189,44,35,4162.89,7428.01,0.00
2024-12-08 17:15:53,78,6189,44,34,4194.38,7428.09,0.00
2024-12-08 17:15:53,78,6190,44,34,4203.49,7429.00,0.00
2024-12-08 17:15:53,79,6190,44,35,4150.28,7429.01,0.00
2024-12-08 17:15:53,79,6191,44,35,4133.91,7430.00,0.00
2024-12-08 17:15:53,80,6191,45,35,4082.24,7430.01,0.00
2024-12-08 17:15:53,81,6190,45,36,4031.84,7430.04,0.00
2024-12-08 17:15:53,80,6190,45,35,4097.67,7430.10,0.00
2024-12-08 17:15:53,79,6190,44,35,4115.79,7430.37,0.00
2024-12-08 17:15:53,79,6191,44,35,4163.24,7431.00,0.00
2024-12-08 17:15:53,80,6191,45,35,4111.20,7431.01,0.00
2024-12-08 17:15:53,80,6192,45,35,4187.00,7432.00,0.00
2024-12-08 17:15:53,81,6192,45,36,4135.31,7432.01,0.00
2024-12-08 17:15:53,80,6192,45,35,4166.41,7432.10,0.00
2024-12-08 17:15:53,79,6192,44,35,4213.53,7432.17,0.00
2024-12-08 17:15:53,79,6193,44,35,4226.56,7433.00,0.00
2024-12-08 17:15:53,80,6193,45,35,4173.73,7433.01,0.00
2024-12-08 17:15:53,80,6194,45,35,4154.37,7434.00,0.00
2024-12-08 17:15:53,81,6194,45,36,4103.08,7434.01,0.00
2024-12-08 17:15:53,81,6195,45,36,4081.99,7435.00,0.00
2024-12-08 17:15:53,82,6195,46,36,4032.21,7435.01,0.00
2024-12-08 17:15:53,81,6195,45,36,4030.00,7435.44,0.00
2024-12-08 17:15:54,81,6196,45,36,4059.49,7436.00,0.00
2024-12-08 17:15:54,82,6196,45,37,4009.98,7436.01,0.00
2024-12-08 17:15:54,81,6196,45,36,4046.18,7436.11,0.00
2024-12-08 17:15:54,81,6197,45,36,4050.32,7437.00,0.00
2024-12-08 17:15:54,82,6197,45,37,4000.92,7437.01,0.00
2024-12-08 17:15:54,81,6197,44,37,4043.55,7437.06,0.00
2024-12-08 17:15:54,80,6197,43,37,4082.01,7437.09,0.00
2024-12-08 17:15:54,80,6198,43,37,4084.50,7438.00,0.00
2024-12-08 17:15:54,81,6198,44,37,4034.08,7438.01,0.00
2024-12-08 17:15:54,80,6198,44,36,4064.10,7438.09,0.00
2024-12-08 17:15:54,79,6198,43,36,4103.30,7438.09,0.00
2024-12-08 17:15:54,79,6199,43,36,4125.00,7439.00,0.00
2024-12-08 17:15:54,80,6199,43,37,4073.44,7439.01,0.00
2024-12-08 17:15:54,80,6200,43,37,4046.75,7440.00,0.00
2024-12-08 17:15:54,81,6200,44,37,3996.79,7440.01,0.00
2024-12-08 17:15:54,80,6200,44,36,4025.90,7440.09,0.00
2024-12-08 17:15:54,80,6201,44,36,4027.04,7441.00,0.00
2024-12-08 17:15:54,81,6201,45,36,3977.33,7441.01,0.00
2024-12-08 17:15:54,81,6202,45,36,3948.87,7442.00,0.00
2024-12-08 17:15:54,82,6202,45,37,3900.71,7442.01,0.00
2024-12-08 17:15:54,81,6202,45,36,3928.72,7442.09,0.00
2024-12-08 17:15:54,81,6203,45,36,3927.29,7443.00,0.00
2024-12-08 17:15:54,82,6203,46,36,3879.40,7443.01,0.00
2024-12-08 17:15:54,81,6203,45,36,3835.32,7443.72,0.00
2024-12-08 17:15:54,80,6203,44,36,3880.49,7443.75,0.00
2024-12-08 17:15:54,80,6204,44,36,3946.19,7444.00,0.00
2024-12-08 17:15:54,81,6204,45,36,3897.47,7444.01,0.00
2024-12-08 17:15:54,80,6204,44,36,3941.76,7444.03,0.00
2024-12-08 17:15:54,79,6204,44,35,3977.53,7444.08,0.00
2024-12-08 17:15:54,79,6205,44,35,3974.68,7445.00,0.00
2024-12-08 17:15:54,80,6205,44,36,3924.99,7445.01,0.00
2024-12-08 17:15:54,79,6205,43,36,3920.92,7445.20,0.00
2024-12-08 17:15:54,79,6206,43,36,3946.01,7446.00,0.00
2024-12-08 17:15:54,80,6206,44,36,3896.68,7446.01,0.00
2024-12-08 17:15:54,79,6206,44,35,3924.13,7446.11,0.00
2024-12-08 17:15:54,78,6206,43,35,3954.41,7446.17,0.00
2024-12-08 17:15:54,77,6206,43,34,3954.93,7446.81,0.00
2024-12-08 17:15:54,77,6207,43,34,4037.29,7447.00,0.00
2024-12-08 17:15:54,78,6207,44,34,3985.53,7447.01,0.00
2024-12-08 17:15:54,77,6207,43,34,4023.43,7447.03,0.00
2024-12-08 17:15:54,77,6208,43,34,4028.80,7448.00,0.00
2024-12-08 17:15:54,78,6208,43,35,3977.15,7448.01,0.00
2024-12-08 17:15:54,78,6209,43,35,3961.45,7449.00,0.00
2024-12-08 17:15:54,79,6209,44,35,3911.31,7449.01,0.00
2024-12-08 17:15:54,78,6209,44,34,3945.23,7449.10,0.00
2024-12-08 17:15:54,78,6210,44,34,3955.30,7450.00,0.00
2024-12-08 17:15:54,79,6210,44,35,3905.23,7450.01,0.00
2024-12-08 17:15:54,79,6211,44,35,3888.78,7451.00,0.00
2024-12-08 17:15:54,80,6211,44,36,3840.17,7451.01,0.00
2024-12-08 17:15:54,79,6211,44,35,3872.76,7451.10,0.00
2024-12-08 17:15:54,78,6211,43,35,3880.50,7451.45,0.00
2024-12-08 17:15:54,77,6211,42,35,3928.97,7451.48,0.00
2024-12-08 17:15:54,77,6212,42,35,3987.42,7452.00,0.00
2024-12-08 17:15:54,78,6212,43,35,3936.29,7452.01,0.00
2024-12-08 17:15:54,78,6213,43,35,3920.58,7453.00,0.00
2024-12-08 17:15:54,79,6213,43,36,3870.95,7453.01,0.00
2024-12-08 17:15:54,78,6213,43,35,3905.30,7453.10,0.00
2024-12-08 17:15:54,78,6214,43,35,3915.37,7454.00,0.00
2024-12-08 17:15:54,79,6214,44,35,3865.81,7454.01,0.00
2024-12-08 17:15:54,79,6215,44,35,3849.34,7455.00,0.00
2024-12-08 17:15:54,80,6215,45,35,3801.23,7455.01,0.00
2024-12-08 17:15:54,79,6215,44,35,3847.46,7455.03,0.00
2024-12-08 17:15:55,78,6215,43,35,3893.92,7455.05,0.00
2024-12-08 17:15:55,77,6215,43,34,3935.78,7455.08,0.00
2024-12-08 17:15:55,77,6216,43,34,3945.01,7456.00,0.00
2024-12-08 17:15:55,78,6216,44,34,3894.44,7456.01,0.00
2024-12-08 17:15:55,78,6217,44,34,3878.71,7457.00,0.00
2024-12-08 17:15:55,79,6217,45,34,3829.61,7457.01,0.00
2024-12-08 17:15:55,78,6217,44,34,3875.84,7457.05,0.00
2024-12-08 17:15:55,77,6217,44,33,3918.43,7457.07,0.00
2024-12-08 17:15:55,76,6217,43,33,3934.76,7457.38,0.00
2024-12-08 17:15:55,76,6218,43,33,3987.20,7458.00,0.00
2024-12-08 17:15:55,77,6218,43,34,3935.42,7458.01,0.00
2024-12-08 17:15:55,76,6218,43,33,3985.24,7458.03,0.00
2024-12-08 17:15:55,75,6218,42,33,4002.59,7458.09,0.00
2024-12-08 17:15:55,75,6219,42,33,4034.94,7459.00,0.00
2024-12-08 17:15:55,76,6219,43,33,3981.84,7459.01,0.00
2024-12-08 17:15:55,75,6219,43,32,4025.00,7459.05,0.00
2024-12-08 17:15:55,74,6219,42,32,4069.31,7459.07,0.00
2024-12-08 17:15:55,74,6220,42,32,4101.10,7460.00,0.00
2024-12-08 17:15:55,75,6220,42,33,4046.42,7460.01,0.00
2024-12-08 17:15:55,74,6220,41,33,4062.85,7460.24,0.00
2024-12-08 17:15:55,74,6221,41,33,4087.53,7461.00,0.00
2024-12-08 17:15:55,75,6221,41,34,4033.03,7461.01,0.00
2024-12-08 17:15:55,74,6221,40,34,4085.52,7461.03,0.00
2024-12-08 17:15:55,73,6221,40,33,4134.34,7461.04,0.00
2024-12-08 17:15:55,74,6220,41,33,4074.44,7461.12,0.00
2024-12-08 17:15:55,74,6221,41,33,4157.66,7462.00,0.00
2024-12-08 17:15:55,75,6221,41,34,4102.22,7462.01,0.00
2024-12-08 17:15:55,75,6222,41,34,4188.35,7463.00,0.00
2024-12-08 17:15:55,76,6222,41,35,4133.24,7463.01,0.00
2024-12-08 17:15:55,76,6223,41,35,4119.06,7464.00,0.00
2024-12-08 17:15:55,77,6223,42,35,4065.57,7464.01,0.00
2024-12-08 17:15:55,77,6223,42,35,4050.60,7465.00,0.00
2024-12-08 17:15:55,78,6223,43,35,3998.67,7465.01,0.00
2024-12-08 17:15:55,78,6224,43,35,3982.93,7466.00,0.00
2024-12-08 17:15:55,79,6224,43,36,3932.52,7466.01,0.00
2024-12-08 17:15:55,78,6224,43,35,3961.88,7466.09,0.00
2024-12-08 17:15:55,78,6225,43,35,3971.02,7467.00,0.00
2024-12-08 17:15:55,79,6225,44,35,3920.76,7467.01,0.00
2024-12-08 17:15:55,79,6226,44,35,3904.27,7468.00,0.00
2024-12-08 17:15:55,80,6226,44,36,3855.46,7468.01,0.00
2024-12-08 17:15:55,79,6226,44,35,3892.93,7468.09,0.00
2024-12-08 17:15:55,79,6227,44,35,3900.22,7469.00,0.00
2024-12-08 17:15:55,80,6227,44,36,3851.46,7469.01,0.00
2024-12-08 17:15:55,80,6228,44,36,3833.02,7470.00,0.00
2024-12-08 17:15:55,81,6228,45,36,3785.70,7470.01,0.00
2024-12-08 17:15:55,80,6228,44,36,3831.16,7470.04,0.00
2024-12-08 17:15:55,79,6228,43,36,3869.25,7470.09,0.00
2024-12-08 17:15:55,78,6228,43,35,3906.42,7470.13,0.00
2024-12-08 17:15:55,78,6229,43,35,3937.08,7471.00,0.00
2024-12-08 17:15:55,79,6229,43,36,3887.25,7471.01,0.00
2024-12-08 17:15:55,78,6229,42,36,3935.17,7471.04,0.00
2024-12-08 17:15:55,77,6229,41,36,3985.31,7471.04,0.00
2024-12-08 17:15:55,76,6229,40,36,4021.05,7471.12,0.00
2024-12-08 17:15:55,76,6230,40,36,4034.35,7472.00,0.00
2024-12-08 17:15:55,77,6230,41,36,3981.96,7472.01,0.00
2024-12-08 17:15:55,76,6230,41,35,3992.09,7472.15,0.00
2024-12-08 17:15:55,76,6231,41,35,4027.02,7473.00,0.00
2024-12-08 17:15:55,77,6231,42,35,3974.72,7473.01,0.00
2024-12-08 17:15:55,76,6231,41,35,4025.06,7473.04,0.00
2024-12-08 17:15:55,75,6231,40,35,4047.87,7473.19,0.00
2024-12-08 17:15:56,75,6232,40,35,4067.31,7474.00,0.00
2024-12-08 17:15:56,76,6232,41,35,4013.79,7474.01,0.00
2024-12-08 17:15:56,75,6232,41,34,4046.40,7474.13,0.00
2024-12-08 17:15:56,75,6233,41,34,4061.88,7475.00,0.00
2024-12-08 17:15:56,76,6233,42,34,4008.43,7475.01,0.00
2024-12-08 17:15:56,76,6234,42,34,3994.21,7476.00,0.00
2024-12-08 17:15:56,77,6234,43,34,3942.34,7476.01,0.00
2024-12-08 17:15:56,76,6234,42,34,3992.25,7476.04,0.00
2024-12-08 17:15:56,75,6234,42,33,4028.54,7476.12,0.00
2024-12-08 17:15:56,75,6235,42,33,4043.02,7477.00,0.00
2024-12-08 17:15:56,76,6235,42,34,3989.83,7477.01,0.00
2024-12-08 17:15:56,75,6235,42,33,4041.03,7477.03,0.00
2024-12-08 17:15:56,75,6236,42,33,4028.61,7478.00,0.00
2024-12-08 17:15:56,76,6236,43,33,3975.60,7478.01,0.00
2024-12-08 17:15:56,75,6236,42,33,4027.61,7478.03,0.00
2024-12-08 17:15:56,74,6236,42,32,4061.85,7478.11,0.00
2024-12-08 17:15:56,73,6236,41,32,4099.05,7478.12,0.00
2024-12-08 17:15:56,73,6237,41,32,4135.98,7479.00,0.00
2024-12-08 17:15:56,74,6237,41,33,4080.09,7479.01,0.00
2024-12-08 17:15:56,75,6236,41,34,3994.81,7479.19,0.00
2024-12-08 17:15:56,76,6235,42,34,3999.35,7479.50,0.00
2024-12-08 17:15:56,76,6236,42,34,4097.14,7480.00,0.00
2024-12-08 17:15:56,77,6236,42,35,4043.93,7480.01,0.00
2024-12-08 17:15:56,76,6236,42,34,4076.49,7480.11,0.00
2024-12-08 17:15:56,76,6237,42,34,4285.70,7481.00,0.00
2024-12-08 17:15:56,77,6237,42,35,4230.04,7481.01,0.00
2024-12-08 17:15:56,77,6238,42,35,4214.84,7482.00,0.00
2024-12-08 17:15:56,78,6238,42,36,4160.80,7482.01,0.00
2024-12-08 17:15:56,77,6238,41,36,4209.99,7482.07,0.00
2024-12-08 17:15:56,76,6238,41,35,4249.64,7482.09,0.00
2024-12-08 17:15:56,76,6239,41,35,4260.52,7483.00,0.00
2024-12-08 17:15:56,77,6239,42,35,4205.18,7483.01,0.00
2024-12-08 17:15:56,77,6240,42,35,4189.06,7484.00,0.00
2024-12-08 17:15:56,78,6240,42,36,4135.35,7484.01,0.00
2024-12-08 17:15:56,77,6240,41,36,4185.18,7484.07,0.00
2024-12-08 17:15:56,76,6240,41,35,4226.47,7484.08,0.00
2024-12-08 17:15:56,76,6241,41,35,4234.36,7485.00,0.00
2024-12-08 17:15:56,77,6241,42,35,4179.36,7485.01,0.00
2024-12-08 17:15:56,77,6242,42,35,4159.41,7486.00,0.00
2024-12-08 17:15:56,78,6242,43,35,4106.09,7486.01,0.00
2024-12-08 17:15:56,77,6242,43,34,4137.08,7486.12,0.00
2024-12-08 17:15:56,77,6243,43,34,4142.36,7487.00,0.00
2024-12-08 17:15:56,78,6243,43,35,4089.26,7487.01,0.00
2024-12-08 17:15:56,77,6243,42,35,4105.43,7487.18,0.00
2024-12-08 17:15:56,76,6243,41,35,4135.84,7487.43,0.00
2024-12-08 17:15:56,76,6244,41,35,4172.69,7488.00,0.00
2024-12-08 17:15:56,77,6244,42,35,4118.49,7488.01,0.00
2024-12-08 17:15:56,76,6244,42,34,4149.07,7488.13,0.00
2024-12-08 17:15:56,75,6244,41,34,4169.92,7488.43,0.00
2024-12-08 17:15:56,75,6245,41,34,4207.26,7489.00,0.00
2024-12-08 17:15:56,76,6245,42,34,4151.91,7489.01,0.00
2024-12-08 17:15:56,76,6246,42,34,4124.80,7490.00,0.00
2024-12-08 17:15:56,77,6246,43,34,4071.23,7490.01,0.00
2024-12-08 17:15:56,76,6246,42,34,4124.68,7490.01,0.00
2024-12-08 17:15:56,75,6246,42,33,4158.74,7490.12,0.00
2024-12-08 17:15:56,74,6246,42,32,4207.56,7490.14,0.00
2024-12-08 17:15:56,74,6247,42,32,4221.01,7491.00,0.00
2024-12-08 17:15:56,75,6247,42,33,4164.73,7491.01,0.00
2024-12-08 17:15:56,75,6248,42,33,4150.09,7492.00,0.00
2024-12-08 17:15:56,76,6248,42,34,4095.48,7492.01,0.00
2024-12-08 17:15:56,75,6248,42,33,4129.14,7492.12,0.00
2024-12-08 17:15:57,75,6249,42,33,4139.47,7493.00,0.00
2024-12-08 17:15:57,76,6249,42,34,4085.01,7493.01,0.00
2024-12-08 17:15:57,76,6250,42,34,4062.55,7494.00,0.00
2024-12-08 17:15:57,77,6250,43,34,4009.79,7494.01,0.00
2024-12-08 17:15:57,76,6250,43,33,4040.88,7494.12,0.00
2024-12-08 17:15:57,75,6250,42,33,4075.78,7494.15,0.00
2024-12-08 17:15:57,75,6251,42,33,4098.86,7495.00,0.00
2024-12-08 17:15:57,76,6251,43,33,4044.92,7495.01,0.00
2024-12-08 17:15:57,76,6252,43,33,4014.23,7496.00,0.00
2024-12-08 17:15:57,77,6252,43,34,3962.10,7496.01,0.00
2024-12-08 17:15:57,76,6252,43,33,3993.55,7496.12,0.00
2024-12-08 17:15:57,76,6253,43,33,3992.95,7497.00,0.00
2024-12-08 17:15:57,77,6253,43,34,3941.10,7497.01,0.00
2024-12-08 17:15:57,76,6253,42,34,3945.63,7497.16,0.00
2024-12-08 17:15:57,76,6254,42,34,3967.66,7498.00,0.00
2024-12-08 17:15:57,77,6254,42,35,3916.13,7498.01,0.00
2024-12-08 17:15:57,76,6254,41,35,3966.67,7498.01,0.00
2024-12-08 17:15:57,75,6254,40,35,3996.57,7498.05,0.00
2024-12-08 17:15:57,74,6254,40,34,4030.33,7498.12,0.00
2024-12-08 17:15:57,73,6254,40,33,4066.70,7498.23,0.00
2024-12-08 17:15:57,73,6255,40,33,4106.54,7499.00,0.00
2024-12-08 17:15:57,74,6255,40,34,4051.05,7499.01,0.00
2024-12-08 17:15:57,73,6255,39,34,4104.49,7499.03,0.00
2024-12-08 17:15:57,72,6255,39,33,4156.35,7499.08,0.00
2024-12-08 17:15:57,71,6255,38,33,4173.70,7499.11,0.00
2024-12-08 17:15:57,71,6256,38,33,4201.85,7500.00,0.00
2024-12-08 17:15:57,72,6256,38,34,4143.49,7500.01,0.00
2024-12-08 17:15:57,71,6256,38,33,4179.69,7500.10,0.00
2024-12-08 17:15:57,71,6257,38,33,4180.41,7501.00,0.00
2024-12-08 17:15:57,72,6257,38,34,4122.35,7501.01,0.00
2024-12-08 17:15:57,71,6257,37,34,4175.14,7501.07,0.00
2024-12-08 17:15:57,70,6257,36,34,4186.59,7501.14,0.00
2024-12-08 17:15:57,69,6257,35,34,4189.52,7501.83,0.00
2024-12-08 17:15:57,69,6258,35,34,4278.44,7502.00,0.00
2024-12-08 17:15:57,70,6258,36,34,4217.32,7502.01,0.00
2024-12-08 17:15:57,69,6258,35,34,4263.23,7502.07,0.00
2024-12-08 17:15:57,68,6258,35,33,4309.38,7502.07,0.00
2024-12-08 17:15:57,67,6258,34,33,4350.32,7502.39,0.00
2024-12-08 17:15:57,67,6259,34,33,4408.14,7503.00,0.00
2024-12-08 17:15:57,68,6259,35,33,4343.31,7503.02,0.00
2024-12-08 17:15:57,68,6260,35,33,4328.28,7504.00,0.00
2024-12-08 17:15:57,69,6260,36,33,4265.55,7504.02,0.00
2024-12-08 17:15:57,68,6260,36,32,4308.44,7504.07,0.00
2024-12-08 17:15:57,68,6261,36,32,4322.30,7505.00,0.00
2024-12-08 17:15:57,69,6261,37,32,4259.66,7505.02,0.00
2024-12-08 17:15:57,69,6262,37,32,4246.64,7506.00,0.00
2024-12-08 17:15:57,70,6262,37,33,4185.98,7506.01,0.00
2024-12-08 17:15:57,69,6262,37,32,4226.00,7506.09,0.00
2024-12-08 17:15:57,68,6262,36,32,4265.09,7506.40,0.00
2024-12-08 17:15:57,68,6263,36,32,4302.92,7507.00,0.00
2024-12-08 17:15:57,69,6263,36,33,4240.56,7507.02,0.00
2024-12-08 17:15:57,69,6264,36,33,4225.20,7508.00,0.00
2024-12-08 17:15:57,70,6264,37,33,4164.84,7508.01,0.00
2024-12-08 17:15:57,71,6263,38,33,4104.06,7508.07,0.00
2024-12-08 17:15:57,70,6263,38,32,4168.09,7508.14,0.00
2024-12-08 17:15:57,69,6263,37,32,4209.02,7508.41,0.00
2024-12-08 17:15:57,70,6262,38,32,4086.29,7508.84,0.00
2024-12-08 17:15:57,70,6263,38,32,4193.70,7509.00,0.00
2024-12-08 17:15:57,71,6263,38,33,4134.63,7509.01,0.00
2024-12-08 17:15:57,70,6263,37,33,4191.55,7509.03,0.00
2024-12-08 17:15:57,70,6264,37,33,4379.34,7510.00,0.00
2024-12-08 17:15:57,71,6264,38,33,4317.65,7510.01,0.00
2024-12-08 17:15:57,70,6264,38,32,4351.48,7510.11,0.00
2024-12-08 17:15:57,69,6264,37,32,4392.78,7510.12,0.00
2024-12-08 17:15:57,69,6265,37,32,4407.75,7511.00,0.00
2024-12-08 17:15:57,70,6265,38,32,4344.78,7511.01,0.00
2024-12-08 17:15:58,71,6264,38,33,4152.09,7511.76,0.00
2024-12-08 17:15:58,71,6265,38,33,4303.71,7512.00,0.00
2024-12-08 17:15:58,72,6265,38,34,4243.94,7512.01,0.00
2024-12-08 17:15:58,71,6265,38,33,4276.24,7512.11,0.00
2024-12-08 17:15:58,70,6265,37,33,4269.83,7512.64,0.00
2024-12-08 17:15:58,69,6265,36,33,4323.55,7512.71,0.00
2024-12-08 17:15:58,69,6266,36,33,4519.78,7513.00,0.00
2024-12-08 17:15:58,70,6266,36,34,4455.21,7513.01,0.00
2024-12-08 17:15:58,70,6267,36,34,4446.14,7514.00,0.00
2024-12-08 17:15:58,71,6267,37,34,4383.52,7514.01,0.00
2024-12-08 17:15:58,70,6267,37,33,4419.34,7514.11,0.00
2024-12-08 17:15:58,69,6267,36,33,4462.81,7514.39,0.00
2024-12-08 17:15:58,69,6268,36,33,4504.64,7515.00,0.00
2024-12-08 17:15:58,70,6268,37,33,4440.29,7515.01,0.00
2024-12-08 17:15:58,69,6268,36,33,4473.10,7515.15,0.00
2024-12-08 17:15:58,69,6269,36,33,4496.53,7516.00,0.00
2024-12-08 17:15:58,70,6269,37,33,4432.29,7516.01,0.00
2024-12-08 17:15:58,69,6269,37,32,4468.24,7516.13,0.00
2024-12-08 17:15:58,68,6269,36,32,4515.27,7516.38,0.00
2024-12-08 17:15:58,68,6270,36,32,4557.73,7517.00,0.00
2024-12-08 17:15:58,69,6270,37,32,4491.68,7517.02,0.00
2024-12-08 17:15:58,68,6270,36,32,4519.09,7517.19,0.00
2024-12-08 17:15:58,69,6269,36,33,4447.10,7517.30,0.00
2024-12-08 17:15:58,69,6270,36,33,4556.56,7518.00,0.00
2024-12-08 17:15:58,70,6270,36,34,4491.47,7518.01,0.00
2024-12-08 17:15:58,69,6270,36,33,4521.74,7518.17,0.00
2024-12-08 17:15:58,69,6271,36,33,4656.33,7519.00,0.00
2024-12-08 17:15:58,70,6271,36,34,4589.81,7519.01,0.00
2024-12-08 17:15:58,70,6272,36,34,4580.75,7520.00,0.00
2024-12-08 17:15:58,71,6272,36,35,4516.23,7520.01,0.00
2024-12-08 17:15:58,70,6272,36,34,4546.42,7520.17,0.00
2024-12-08 17:15:58,70,6273,36,34,4570.62,7521.00,0.00
2024-12-08 17:15:58,71,6273,36,35,4506.24,7521.01,0.00
2024-12-08 17:15:58,71,6274,36,35,4496.25,7522.00,0.00
2024-12-08 17:15:58,72,6274,37,35,4433.80,7522.01,0.00
2024-12-08 17:15:58,71,6274,36,35,4495.19,7522.01,0.00
2024-12-08 17:15:58,70,6274,35,35,4557.27,7522.03,0.00
2024-12-08 17:15:58,69,6274,35,34,4592.82,7522.15,0.00
2024-12-08 17:15:58,70,6273,36,34,4474.77,7522.59,0.00
2024-12-08 17:15:58,70,6274,36,34,4565.38,7523.00,0.00
2024-12-08 17:15:58,71,6274,36,35,4501.08,7523.01,0.00
2024-12-08 17:15:58,71,6275,36,35,4597.06,7524.00,0.00
2024-12-08 17:15:58,72,6275,37,35,4533.21,7524.01,0.00
2024-12-08 17:15:58,71,6275,36,35,4593.90,7524.06,0.00
2024-12-08 17:15:58,70,6275,36,34,4633.74,7524.13,0.00
2024-12-08 17:15:58,69,6275,35,34,4698.72,7524.15,0.00
2024-12-08 17:15:58,69,6276,35,34,4744.02,7525.00,0.00
2024-12-08 17:15:58,70,6276,35,35,4676.25,7525.01,0.00
2024-12-08 17:15:58,69,6276,34,35,4687.41,7525.28,0.00
2024-12-08 17:15:58,69,6277,34,35,4739.73,7526.00,0.00
2024-12-08 17:15:58,70,6277,34,36,4672.02,7526.01,0.00
2024-12-08 17:15:58,69,6277,34,35,4711.41,7526.13,0.00
2024-12-08 17:15:58,69,6278,34,35,4727.59,7527.00,0.00
2024-12-08 17:15:58,70,6278,35,35,4660.05,7527.01,0.00
2024-12-08 17:15:58,70,6279,35,35,4643.13,7528.00,0.00
2024-12-08 17:15:58,71,6279,35,36,4577.73,7528.01,0.00
2024-12-08 17:15:58,70,6279,35,35,4614.12,7528.13,0.00
2024-12-08 17:15:58,70,6280,35,35,4626.27,7529.00,0.00
2024-12-08 17:15:58,71,6280,36,35,4561.11,7529.01,0.00
2024-12-08 17:15:58,72,6279,36,36,4443.58,7529.49,0.00
2024-12-08 17:15:58,72,6280,36,36,4511.26,7530.00,0.00
2024-12-08 17:15:58,73,6280,37,36,4449.46,7530.01,0.00
2024-12-08 17:15:59,73,6281,37,36,4525.06,7531.00,0.00
2024-12-08 17:15:59,74,6281,38,36,4463.91,7531.01,0.00
2024-12-08 17:15:59,74,6282,38,36,4438.38,7532.00,0.00
2024-12-08 17:15:59,75,6282,38,37,4379.20,7532.01,0.00
2024-12-08 17:15:59,76,6281,39,37,4319.61,7532.07,0.00
2024-12-08 17:15:59,76,6282,39,37,4355.94,7533.00,0.00
2024-12-08 17:15:59,77,6282,39,38,4299.37,7533.01,0.00
2024-12-08 17:15:59,76,6282,38,38,4352.00,7533.07,0.00
2024-12-08 17:15:59,75,6282,38,37,4402.00,7533.11,0.00
2024-12-08 17:15:59,75,6283,38,37,4514.19,7534.00,0.00
2024-12-08 17:15:59,76,6283,38,38,4454.80,7534.01,0.00
2024-12-08 17:15:59,75,6283,37,38,4469.02,7534.12,0.00
2024-12-08 17:15:59,75,6284,37,38,4503.74,7535.00,0.00
2024-12-08 17:15:59,76,6284,37,39,4444.48,7535.01,0.00
2024-12-08 17:15:59,75,6284,36,39,4498.74,7535.07,0.00
2024-12-08 17:15:59,74,6284,36,38,4542.23,7535.10,0.00
2024-12-08 17:15:59,74,6285,36,38,4556.04,7536.00,0.00
2024-12-08 17:15:59,75,6285,37,38,4495.30,7536.01,0.00
2024-12-08 17:15:59,75,6286,37,38,4481.82,7537.00,0.00
2024-12-08 17:15:59,76,6286,37,39,4422.85,7537.01,0.00
2024-12-08 17:15:59,75,6286,37,38,4460.75,7537.09,0.00
2024-12-08 17:15:59,75,6287,37,38,4473.37,7538.00,0.00
2024-12-08 17:15:59,76,6287,38,38,4414.51,7538.01,0.00
2024-12-08 17:15:59,75,6287,37,38,4471.37,7538.03,0.00
2024-12-08 17:15:59,74,6287,36,38,4462.86,7538.68,0.00
2024-12-08 17:15:59,74,6288,36,38,4520.16,7539.00,0.00
2024-12-08 17:15:59,75,6288,37,38,4459.89,7539.01,0.00
2024-12-08 17:15:59,74,6288,37,37,4492.69,7539.12,0.00
2024-12-08 17:15:59,74,6289,37,37,4508.53,7540.00,0.00
2024-12-08 17:15:59,75,6289,38,37,4448.42,7540.01,0.00
2024-12-08 17:15:59,75,6290,38,37,4433.75,7541.00,0.00
2024-12-08 17:15:59,76,6290,39,37,4375.42,7541.01,0.00
2024-12-08 17:15:59,75,6290,39,36,4406.64,7541.12,0.00
2024-12-08 17:15:59,75,6291,39,36,4417.37,7542.00,0.00
2024-12-08 17:15:59,76,6291,39,37,4359.24,7542.01,0.00
2024-12-08 17:15:59,76,6292,39,37,4340.10,7543.00,0.00
2024-12-08 17:15:59,77,6292,40,37,4283.74,7543.01,0.00
2024-12-08 17:15:59,76,6292,40,36,4315.32,7543.12,0.00
2024-12-08 17:15:59,76,6293,40,36,4322.63,7544.00,0.00
2024-12-08 17:15:59,77,6293,40,37,4266.49,7544.01,0.00
2024-12-08 17:15:59,76,6293,39,37,4319.67,7544.04,0.00
2024-12-08 17:15:59,76,6294,39,37,4301.01,7545.00,0.00
2024-12-08 17:15:59,77,6294,39,38,4245.16,7545.01,0.00
2024-12-08 17:15:59,76,6294,39,37,4277.22,7545.12,0.00
2024-12-08 17:15:59,76,6295,39,37,4284.34,7546.00,0.00
2024-12-08 17:15:59,77,6295,39,38,4228.70,7546.01,0.00
2024-12-08 17:15:59,76,6295,38,38,4252.61,7546.17,0.00
2024-12-08 17:15:59,76,6296,38,38,4264.45,7547.00,0.00
2024-12-08 17:15:59,77,6296,39,38,4209.07,7547.01,0.00
2024-12-08 17:15:59,76,6296,39,37,4241.64,7547.12,0.00
2024-12-08 17:15:59,76,6297,39,37,4251.04,7548.00,0.00
2024-12-08 17:15:59,77,6297,39,38,4195.83,7548.01,0.00
2024-12-08 17:15:59,77,6298,39,38,4177.19,7549.00,0.00
2024-12-08 17:15:59,78,6298,39,39,4123.64,7549.01,0.00
2024-12-08 17:15:59,77,6298,39,38,4155.65,7549.12,0.00
2024-12-08 17:15:59,76,6298,38,38,4141.44,7549.87,0.00
2024-12-08 17:15:59,76,6299,38,38,4230.95,7550.00,0.00
2024-12-08 17:15:59,77,6299,39,38,4176.00,7550.01,0.00
2024-12-08 17:15:59,76,6299,38,38,4209.12,7550.12,0.00
2024-12-08 17:16:00,75,6299,37,38,4241.09,7550.16,0.00
2024-12-08 17:16:00,75,6300,37,38,4277.73,7551.00,0.00
2024-12-08 17:16:00,76,6300,37,39,4221.45,7551.01,0.00
2024-12-08 17:16:00,75,6300,37,38,4255.61,7551.12,0.00
2024-12-08 17:16:00,75,6301,37,38,4270.13,7552.00,0.00
2024-12-08 17:16:00,76,6301,37,39,4213.94,7552.01,0.00
2024-12-08 17:16:00,75,6301,36,39,4265.11,7552.07,0.00
2024-12-08 17:16:00,75,6302,36,39,4251.65,7553.00,0.00
2024-12-08 17:16:00,76,6302,37,39,4195.71,7553.01,0.00
2024-12-08 17:16:00,75,6302,37,38,4228.52,7553.12,0.00
2024-12-08 17:16:00,75,6303,37,38,4232.31,7554.00,0.00
2024-12-08 17:16:00,76,6303,37,39,4176.62,7554.01,0.00
2024-12-08 17:16:00,76,6304,37,39,4148.31,7555.00,0.00
2024-12-08 17:16:00,77,6304,37,40,4094.44,7555.01,0.00
2024-12-08 17:16:00,76,6304,37,39,4123.49,7555.12,0.00
2024-12-08 17:16:00,75,6304,36,39,4155.36,7555.28,0.00
2024-12-08 17:16:00,75,6305,36,39,4186.00,7556.00,0.00
2024-12-08 17:16:00,76,6305,36,40,4130.92,7556.01,0.00
2024-12-08 17:16:00,75,6305,35,40,4182.99,7556.04,0.00
2024-12-08 17:16:00,74,6305,34,40,4236.46,7556.07,0.00
2024-12-08 17:16:00,74,6306,34,40,4214.74,7557.00,0.00
2024-12-08 17:16:00,75,6306,35,40,4158.54,7557.01,0.00
2024-12-08 17:16:00,74,6306,34,40,4211.69,7557.04,0.00
2024-12-08 17:16:00,73,6306,34,39,4249.72,7557.08,0.00
2024-12-08 17:16:00,73,6307,34,39,4254.80,7558.00,0.00
2024-12-08 17:16:00,74,6307,35,39,4197.30,7558.01,0.00
2024-12-08 17:16:00,74,6308,35,39,4177.55,7559.00,0.00
2024-12-08 17:16:00,75,6308,35,40,4121.85,7559.01,0.00
2024-12-08 17:16:00,74,6308,35,39,4157.14,7559.08,0.00
2024-12-08 17:16:00,73,6308,34,39,4205.24,7559.08,0.00
2024-12-08 17:16:00,73,6309,34,39,4233.19,7560.00,0.00
2024-12-08 17:16:00,74,6309,34,40,4175.98,7560.01,0.00
2024-12-08 17:16:00,74,6310,34,40,4157.77,7561.00,0.00
2024-12-08 17:16:00,75,6310,34,41,4102.33,7561.01,0.00
2024-12-08 17:16:00,76,6309,35,41,4045.38,7561.08,0.00
2024-12-08 17:16:00,75,6309,34,41,4129.19,7561.48,0.00
2024-12-08 17:16:00,74,6309,34,40,4172.01,7561.58,0.00
2024-12-08 17:16:00,75,6308,34,41,4103.34,7561.76,0.00
2024-12-08 17:16:00,75,6309,34,41,4204.38,7562.00,0.00
2024-12-08 17:16:00,76,6309,34,42,4149.06,7562.01,0.00
2024-12-08 17:16:00,75,6309,34,41,4196.76,7562.08,0.00
2024-12-08 17:16:00,75,6310,34,41,4405.66,7563.00,0.00
2024-12-08 17:16:00,76,6310,34,42,4347.69,7563.01,0.00
2024-12-08 17:16:00,75,6310,33,42,4375.46,7563.15,0.00
2024-12-08 17:16:00,76,6309,33,43,4271.68,7563.71,0.00
2024-12-08 17:16:00,76,6310,33,43,4329.79,7564.00,0.00
2024-12-08 17:16:00,77,6310,33,44,4273.56,7564.01,0.00
2024-12-08 17:16:00,76,6310,33,43,4310.92,7564.08,0.00
2024-12-08 17:16:00,75,6310,32,43,4362.36,7564.15,0.00
2024-12-08 17:16:00,75,6311,32,43,4468.89,7565.00,0.00
2024-12-08 17:16:00,76,6311,32,44,4410.09,7565.01,0.00
2024-12-08 17:16:00,75,6311,31,44,4417.62,7565.43,0.00
2024-12-08 17:16:00,75,6312,31,44,4440.53,7566.00,0.00
2024-12-08 17:16:00,76,6312,31,45,4382.11,7566.01,0.00
2024-12-08 17:16:00,75,6312,31,44,4422.41,7566.08,0.00
2024-12-08 17:16:00,74,6312,30,44,4414.65,7566.76,0.00
2024-12-08 17:16:00,74,6313,30,44,4489.43,7567.00,0.00
2024-12-08 17:16:00,75,6313,30,45,4429.57,7567.01,0.00
2024-12-08 17:16:00,74,6313,29,45,4443.46,7567.12,0.00
2024-12-08 17:16:00,74,6314,29,45,4455.28,7568.00,0.00
2024-12-08 17:16:00,75,6314,30,45,4395.87,7568.01,0.00
2024-12-08 17:16:00,74,6314,29,45,4421.58,7568.18,0.00
2024-12-08 17:16:00,73,6314,28,45,4444.48,7568.51,0.00
2024-12-08 17:16:01,73,6315,28,45,4475.98,7569.00,0.00
2024-12-08 17:16:01,74,6315,29,45,4415.49,7569.01,0.00
2024-12-08 17:16:01,73,6315,29,44,4459.42,7569.08,0.00
2024-12-08 17:16:01,72,6315,28,44,4517.17,7569.14,0.00
2024-12-08 17:16:01,72,6316,28,44,4523.48,7570.00,0.00
2024-12-08 17:16:01,73,6316,28,45,4461.52,7570.01,0.00
2024-12-08 17:16:01,72,6316,28,44,4506.69,7570.08,0.00
2024-12-08 17:16:01,71,6316,27,44,4544.72,7570.42,0.00
2024-12-08 17:16:01,71,6317,27,44,4576.41,7571.00,0.00
2024-12-08 17:16:01,72,6317,28,44,4512.85,7571.01,0.00
2024-12-08 17:16:01,72,6318,28,44,4493.90,7572.00,0.00
2024-12-08 17:16:01,73,6318,28,45,4432.34,7572.01,0.00
2024-12-08 17:16:01,72,6318,28,44,4478.16,7572.08,0.00
2024-12-08 17:16:01,71,6318,27,44,4535.92,7572.16,0.00
2024-12-08 17:16:01,71,6319,27,44,4551.77,7573.00,0.00
2024-12-08 17:16:01,72,6319,27,45,4488.55,7573.01,0.00
2024-12-08 17:16:01,72,6320,27,45,4473.66,7574.00,0.00
2024-12-08 17:16:01,73,6320,27,46,4412.37,7574.01,0.00
2024-12-08 17:16:01,72,6320,26,46,4470.51,7574.04,0.00
2024-12-08 17:16:01,71,6320,26,45,4517.49,7574.07,0.00
2024-12-08 17:16:01,71,6321,26,45,4530.11,7575.00,0.00
2024-12-08 17:16:01,72,6321,27,45,4467.19,7575.01,0.00
2024-12-08 17:16:01,72,6322,27,45,4449.92,7576.00,0.00
2024-12-08 17:16:01,73,6322,27,46,4388.96,7576.01,0.00
2024-12-08 17:16:01,72,6322,27,45,4433.11,7576.07,0.00
2024-12-08 17:16:01,72,6323,27,45,4437.32,7577.00,0.00
2024-12-08 17:16:01,73,6323,27,46,4376.53,7577.01,0.00
2024-12-08 17:16:01,73,6324,27,46,4353.20,7578.00,0.00
2024-12-08 17:16:01,74,6324,27,47,4294.37,7578.01,0.00
2024-12-08 17:16:01,73,6324,27,46,4335.58,7578.08,0.00
2024-12-08 17:16:01,72,6324,26,46,4382.11,7578.08,0.00
2024-12-08 17:16:01,72,6325,26,46,4406.69,7579.00,0.00
2024-12-08 17:16:01,73,6325,26,47,4346.32,7579.01,0.00
2024-12-08 17:16:01,73,6326,26,47,4324.39,7580.00,0.00
2024-12-08 17:16:01,74,6326,27,47,4265.95,7580.01,0.00
2024-12-08 17:16:01,73,6326,27,46,4306.76,7580.08,0.00
2024-12-08 17:16:01,73,6327,27,46,4313.87,7581.00,0.00
2024-12-08 17:16:01,74,6327,27,47,4255.57,7581.01,0.00
2024-12-08 17:16:01,75,6326,28,47,4098.67,7581.76,0.00
2024-12-08 17:16:01,75,6327,28,47,4198.95,7582.00,0.00
2024-12-08 17:16:01,76,6327,28,48,4143.71,7582.01,0.00
2024-12-08 17:16:01,75,6327,28,47,4182.80,7582.08,0.00
2024-12-08 17:16:01,74,6327,27,47,4222.94,7582.11,0.00
2024-12-08 17:16:01,74,6328,27,47,4355.26,7583.00,0.00
2024-12-08 17:16:01,75,6328,28,47,4297.19,7583.01,0.00
2024-12-08 17:16:01,75,6329,28,47,4276.85,7584.00,0.00
2024-12-08 17:16:01,76,6329,28,48,4220.58,7584.01,0.00
2024-12-08 17:16:01,75,6329,28,47,4261.71,7584.08,0.00
2024-12-08 17:16:01,74,6329,27,47,4308.03,7584.08,0.00
2024-12-08 17:16:01,74,6330,27,47,4332.24,7585.00,0.00
2024-12-08 17:16:01,75,6330,27,48,4274.48,7585.01,0.00
2024-12-08 17:16:01,76,6329,27,49,4148.79,7585.41,0.00
2024-12-08 17:16:01,75,6329,27,48,4200.90,7585.63,0.00
2024-12-08 17:16:01,75,6330,27,48,4274.01,7586.00,0.00
2024-12-08 17:16:01,76,6330,28,48,4217.77,7586.01,0.00
2024-12-08 17:16:01,75,6330,27,48,4269.98,7586.05,0.00
2024-12-08 17:16:01,74,6330,27,47,4313.34,7586.08,0.00
2024-12-08 17:16:01,73,6330,26,47,4354.81,7586.23,0.00
2024-12-08 17:16:01,73,6331,26,47,4504.97,7587.00,0.00
2024-12-08 17:16:01,74,6331,27,47,4444.09,7587.01,0.00
2024-12-08 17:16:02,74,6332,27,47,4431.35,7588.00,0.00
2024-12-08 17:16:02,75,6332,27,48,4372.26,7588.01,0.00
2024-12-08 17:16:02,74,6332,27,47,4414.96,7588.08,0.00
2024-12-08 17:16:02,73,6332,26,47,4456.75,7588.12,0.00
2024-12-08 17:16:02,73,6333,26,47,4494.72,7589.00,0.00
2024-12-08 17:16:02,74,6333,27,47,4433.98,7589.01,0.00
2024-12-08 17:16:02,74,6334,27,47,4421.23,7590.00,0.00
2024-12-08 17:16:02,75,6334,28,47,4362.28,7590.01,0.00
2024-12-08 17:16:02,74,6334,28,46,4405.87,7590.08,0.00
2024-12-08 17:16:02,74,6335,28,46,4418.74,7591.00,0.00
2024-12-08 17:16:02,75,6335,28,47,4359.82,7591.01,0.00
2024-12-08 17:16:02,75,6336,28,47,4346.22,7592.00,0.00
2024-12-08 17:16:02,76,6336,28,48,4289.04,7592.01,0.00
2024-12-08 17:16:02,75,6336,28,47,4332.07,7592.08,0.00
2024-12-08 17:16:02,75,6337,28,47,4343.76,7593.00,0.00
2024-12-08 17:16:02,76,6337,29,47,4286.60,7593.01,0.00
2024-12-08 17:16:02,76,6338,29,47,4272.18,7594.00,0.00
2024-12-08 17:16:02,77,6338,30,47,4216.70,7594.01,0.00
2024-12-08 17:16:02,76,6338,30,46,4259.21,7594.08,0.00
2024-12-08 17:16:02,76,6339,30,46,4269.74,7595.00,0.00
2024-12-08 17:16:02,77,6339,30,47,4214.29,7595.01,0.00
2024-12-08 17:16:02,76,6339,29,47,4228.80,7595.12,0.00
2024-12-08 17:16:02,76,6340,29,47,4262.31,7596.00,0.00
2024-12-08 17:16:02,77,6340,29,48,4206.96,7596.01,0.00
2024-12-08 17:16:02,76,6340,29,47,4249.34,7596.08,0.00
2024-12-08 17:16:02,75,6340,29,46,4299.45,7596.16,0.00
2024-12-08 17:16:02,75,6341,29,46,4317.19,7597.00,0.00
2024-12-08 17:16:02,76,6341,29,47,4260.38,7597.01,0.00
2024-12-08 17:16:02,76,6342,29,47,4245.95,7598.00,0.00
2024-12-08 17:16:02,77,6342,29,48,4190.81,7598.01,0.00
2024-12-08 17:16:02,76,6342,29,47,4232.97,7598.08,0.00
2024-12-08 17:16:02,76,6343,29,47,4243.51,7599.00,0.00
2024-12-08 17:16:02,77,6343,30,47,4188.40,7599.01,0.00
2024-12-08 17:16:02,76,6343,29,47,4193.59,7599.29,0.00
2024-12-08 17:16:02,76,6344,29,47,4240.07,7600.00,0.00
2024-12-08 17:16:02,77,6344,29,48,4185.00,7600.01,0.00
2024-12-08 17:16:02,76,6344,29,47,4228.08,7600.08,0.00
2024-12-08 17:16:02,76,6345,29,47,4238.62,7601.00,0.00
2024-12-08 17:16:02,77,6345,30,47,4183.58,7601.01,0.00
2024-12-08 17:16:02,76,6345,29,47,4187.66,7601.17,0.00
2024-12-08 17:16:02,75,6345,28,47,4243.49,7601.17,0.00
2024-12-08 17:16:02,75,6346,28,47,4282.53,7602.00,0.00
2024-12-08 17:16:02,76,6346,29,47,4226.18,7602.01,0.00
2024-12-08 17:16:02,75,6346,29,46,4270.38,7602.08,0.00
2024-12-08 17:16:02,74,6346,28,46,4321.95,7602.16,0.00
2024-12-08 17:16:02,74,6347,28,46,4340.97,7603.00,0.00
2024-12-08 17:16:02,75,6347,29,46,4283.09,7603.01,0.00
2024-12-08 17:16:02,74,6347,28,46,4286.56,7603.18,0.00
2024-12-08 17:16:02,74,6348,28,46,4324.00,7604.00,0.00
2024-12-08 17:16:02,75,6348,29,46,4266.35,7604.01,0.00
2024-12-08 17:16:02,74,6348,29,45,4306.55,7604.11,0.00
2024-12-08 17:16:02,74,6349,29,45,4313.36,7605.00,0.00
2024-12-08 17:16:02,75,6349,29,46,4255.84,7605.01,0.00
2024-12-08 17:16:02,74,6349,29,45,4252.45,7605.39,0.00
2024-12-08 17:16:02,74,6350,29,45,4288.85,7606.00,0.00
2024-12-08 17:16:02,75,6350,29,46,4231.67,7606.01,0.00
2024-12-08 17:16:02,74,6350,29,45,4271.39,7606.11,0.00
2024-12-08 17:16:02,74,6351,29,45,4279.56,7607.00,0.00
2024-12-08 17:16:02,75,6351,30,45,4222.50,7607.01,0.00
2024-12-08 17:16:02,74,6351,29,45,4262.10,7607.11,0.00
2024-12-08 17:16:02,73,6351,29,44,4280.87,7607.33,0.00
2024-12-08 17:16:03,73,6352,29,44,4334.47,7608.00,0.00
2024-12-08 17:16:03,74,6352,29,45,4275.90,7608.01,0.00
2024-12-08 17:16:03,73,6352,28,45,4333.43,7608.01,0.00
2024-12-08 17:16:03,72,6352,27,45,4390.46,7608.04,0.00
2024-12-08 17:16:03,71,6352,27,44,4438.37,7608.08,0.00
2024-12-08 17:16:03,71,6353,27,44,4455.01,7609.00,0.00
2024-12-08 17:16:03,72,6353,27,45,4393.14,7609.01,0.00
2024-12-08 17:16:03,71,6353,26,45,4403.74,7609.41,0.00
2024-12-08 17:16:03,71,6354,26,45,4444.88,7610.00,0.00
2024-12-08 17:16:03,72,6354,26,46,4383.15,7610.01,0.00
2024-12-08 17:16:03,71,6354,25,46,4440.60,7610.06,0.00
2024-12-08 17:16:03,70,6354,25,45,4485.57,7610.09,0.00
2024-12-08 17:16:03,70,6355,25,45,4503.54,7611.00,0.00
2024-12-08 17:16:03,71,6355,26,45,4440.11,7611.01,0.00
2024-12-08 17:16:03,70,6355,25,45,4441.76,7611.47,0.00
2024-12-08 17:16:03,70,6356,25,45,4510.65,7612.00,0.00
2024-12-08 17:16:03,71,6356,26,45,4447.12,7612.01,0.00
2024-12-08 17:16:03,70,6356,26,44,4490.01,7612.09,0.00
2024-12-08 17:16:03,69,6356,25,44,4530.96,7612.41,0.00
2024-12-08 17:16:03,69,6357,25,44,4573.89,7613.00,0.00
2024-12-08 17:16:03,70,6357,26,44,4508.54,7613.01,0.00
2024-12-08 17:16:03,70,6358,26,44,4497.49,7614.00,0.00
2024-12-08 17:16:03,71,6358,26,45,4434.14,7614.01,0.00
2024-12-08 17:16:03,70,6358,26,44,4477.93,7614.09,0.00
2024-12-08 17:16:03,70,6359,26,44,4492.97,7615.00,0.00
2024-12-08 17:16:03,71,6359,26,45,4429.69,7615.01,0.00
2024-12-08 17:16:03,71,6360,26,45,4416.55,7616.00,0.00
2024-12-08 17:16:03,72,6360,27,45,4355.21,7616.01,0.00
2024-12-08 17:16:03,71,6360,26,45,4413.34,7616.04,0.00
2024-12-08 17:16:03,70,6360,26,44,4459.44,7616.07,0.00
2024-12-08 17:16:03,70,6361,26,44,4473.74,7617.00,0.00
2024-12-08 17:16:03,71,6361,26,45,4410.73,7617.01,0.00
2024-12-08 17:16:03,71,6362,26,45,4399.91,7618.00,0.00
2024-12-08 17:16:03,72,6362,27,45,4338.80,7618.01,0.00
2024-12-08 17:16:03,71,6362,27,44,4382.57,7618.07,0.00
2024-12-08 17:16:03,70,6362,26,44,4436.50,7618.17,0.00
2024-12-08 17:16:03,70,6363,26,44,4460.98,7619.00,0.00
2024-12-08 17:16:03,71,6363,27,44,4398.15,7619.01,0.00
2024-12-08 17:16:03,71,6364,27,44,4387.99,7620.00,0.00
2024-12-08 17:16:03,72,6364,28,44,4327.05,7620.01,0.00
2024-12-08 17:16:03,71,6364,28,43,4370.84,7620.07,0.00
2024-12-08 17:16:03,71,6365,28,43,4386.42,7621.00,0.00
2024-12-08 17:16:03,72,6365,28,44,4325.50,7621.01,0.00
2024-12-08 17:16:03,72,6366,28,44,4314.42,7622.00,0.00
2024-12-08 17:16:03,73,6366,29,44,4255.32,7622.01,0.00
2024-12-08 17:16:03,72,6366,29,43,4290.11,7622.13,0.00
2024-12-08 17:16:03,72,6367,29,43,4308.64,7623.00,0.00
2024-12-08 17:16:03,73,6367,30,43,4249.61,7623.01,0.00
2024-12-08 17:16:03,74,6366,31,43,4187.06,7623.11,0.00
2024-12-08 17:16:03,74,6367,31,43,4252.49,7624.00,0.00
2024-12-08 17:16:03,75,6367,31,44,4195.79,7624.01,0.00
2024-12-08 17:16:03,74,6367,31,43,4226.78,7624.14,0.00
2024-12-08 17:16:03,74,6368,31,43,4346.82,7625.00,0.00
2024-12-08 17:16:03,75,6368,31,44,4288.86,7625.01,0.00
2024-12-08 17:16:03,74,6368,30,44,4279.79,7625.39,0.00
2024-12-08 17:16:03,74,6369,30,44,4336.88,7626.00,0.00
2024-12-08 17:16:03,75,6369,30,45,4279.06,7626.01,0.00
2024-12-08 17:16:03,75,6370,30,45,4264.85,7627.00,0.00
2024-12-08 17:16:03,76,6370,30,46,4208.74,7627.01,0.00
2024-12-08 17:16:04,75,6370,30,45,4237.64,7627.16,0.00
2024-12-08 17:16:04,75,6371,30,45,4255.43,7628.00,0.00
2024-12-08 17:16:04,76,6371,31,45,4199.44,7628.01,0.00
2024-12-08 17:16:04,75,6371,30,45,4215.83,7628.23,0.00
2024-12-08 17:16:04,76,6370,31,45,4146.40,7628.43,0.00
2024-12-08 17:16:04,76,6371,31,45,4246.17,7629.00,0.00
2024-12-08 17:16:04,77,6371,32,45,4191.02,7629.01,0.00
2024-12-08 17:16:04,76,6371,32,44,4244.08,7629.04,0.00
2024-12-08 17:16:04,76,6372,32,44,4352.06,7630.00,0.00
2024-12-08 17:16:04,77,6372,32,45,4295.54,7630.01,0.00
2024-12-08 17:16:04,77,6373,32,45,4279.08,7631.00,0.00
2024-12-08 17:16:04,78,6373,33,45,4224.22,7631.01,0.00
2024-12-08 17:16:04,78,6374,33,45,4207.11,7632.00,0.00
2024-12-08 17:16:04,79,6374,34,45,4153.85,7632.01,0.00
2024-12-08 17:16:04,78,6374,33,45,4206.13,7632.01,0.00
2024-12-08 17:16:04,77,6374,33,44,4245.89,7632.03,0.00
2024-12-08 17:16:04,77,6375,33,44,4250.61,7633.00,0.00
2024-12-08 17:16:04,78,6375,34,44,4196.12,7633.01,0.00
2024-12-08 17:16:04,78,6376,34,44,4179.63,7634.00,0.00
2024-12-08 17:16:04,79,6376,35,44,4126.72,7634.01,0.00
2024-12-08 17:16:04,78,6376,35,43,4175.73,7634.05,0.00
2024-12-08 17:16:04,77,6376,34,43,4199.38,7634.46,0.00
2024-12-08 17:16:04,77,6377,34,43,4237.44,7635.00,0.00
2024-12-08 17:16:04,78,6377,35,43,4183.12,7635.01,0.00
2024-12-08 17:16:04,77,6377,35,42,4213.66,7635.05,0.00
2024-12-08 17:16:04,77,6378,35,42,4221.14,7636.00,0.00
2024-12-08 17:16:04,78,6378,35,43,4167.02,7636.01,0.00
2024-12-08 17:16:04,78,6379,35,43,4150.92,7637.00,0.00
2024-12-08 17:16:04,79,6379,36,43,4098.38,7637.01,0.00
2024-12-08 17:16:04,78,6379,36,42,4141.15,7637.08,0.00
2024-12-08 17:16:04,79,6378,37,42,4026.34,7637.92,0.00
2024-12-08 17:16:04,79,6379,37,42,4103.75,7638.00,0.00
2024-12-08 17:16:04,80,6379,37,43,4052.45,7638.01,0.00
2024-12-08 17:16:04,79,6379,36,43,4100.86,7638.05,0.00
2024-12-08 17:16:04,79,6380,36,43,4183.50,7639.00,0.00
2024-12-08 17:16:04,80,6380,36,44,4131.21,7639.01,0.00
2024-12-08 17:16:04,79,6380,36,43,4174.82,7639.06,0.00
2024-12-08 17:16:04,79,6381,36,43,4180.70,7640.00,0.00
2024-12-08 17:16:04,80,6381,37,43,4128.44,7640.01,0.00
2024-12-08 17:16:04,79,6381,37,42,4172.01,7640.06,0.00
2024-12-08 17:16:04,79,6382,37,42,4177.26,7641.00,0.00
2024-12-08 17:16:04,80,6382,38,42,4125.05,7641.01,0.00
2024-12-08 17:16:04,80,6383,38,42,4105.60,7642.00,0.00
2024-12-08 17:16:04,81,6383,38,43,4054.92,7642.01,0.00
2024-12-08 17:16:04,80,6383,38,42,4097.98,7642.06,0.00
2024-12-08 17:16:04,80,6384,38,42,4100.51,7643.00,0.00
2024-12-08 17:16:04,81,6384,39,42,4049.88,7643.01,0.00
2024-12-08 17:16:04,81,6385,39,42,4027.82,7644.00,0.00
2024-12-08 17:16:04,82,6385,39,43,3978.70,7644.01,0.00
2024-12-08 17:16:04,81,6385,39,42,4021.23,7644.06,0.00
2024-12-08 17:16:04,81,6386,39,42,4020.86,7645.00,0.00
2024-12-08 17:16:04,82,6386,39,43,3971.83,7645.01,0.00
2024-12-08 17:16:04,82,6387,39,43,3947.24,7646.00,0.00
2024-12-08 17:16:04,83,6387,39,44,3899.68,7646.01,0.00
2024-12-08 17:16:05,82,6387,39,43,3941.66,7646.06,0.00
2024-12-08 17:16:05,82,6388,39,43,3938.63,7647.00,0.00
2024-12-08 17:16:05,83,6388,40,43,3891.18,7647.01,0.00
2024-12-08 17:16:05,83,6389,40,43,3864.58,7648.00,0.00
2024-12-08 17:16:05,84,6389,41,43,3818.58,7648.01,0.00
2024-12-08 17:16:05,83,6389,41,42,3858.15,7648.06,0.00
2024-12-08 17:16:05,82,6389,40,42,3891.27,7648.24,0.00
2024-12-08 17:16:05,82,6390,40,42,3900.78,7649.00,0.00
2024-12-08 17:16:05,83,6390,40,43,3853.78,7649.01,0.00
2024-12-08 17:16:05,82,6390,40,42,3896.12,7649.02,0.00
2024-12-08 17:16:05,82,6391,40,42,3869.18,7650.00,0.00
2024-12-08 17:16:05,83,6391,40,43,3822.56,7650.01,0.00
2024-12-08 17:16:05,82,6391,40,42,3863.59,7650.05,0.00
2024-12-08 17:16:05,81,6391,39,42,3897.19,7650.23,0.00
2024-12-08 17:16:05,81,6392,39,42,3905.18,7651.00,0.00
2024-12-08 17:16:05,82,6392,39,43,3857.55,7651.01,0.00
2024-12-08 17:16:05,82,6393,39,43,3829.66,7652.00,0.00
2024-12-08 17:16:05,83,6393,39,44,3783.52,7652.01,0.00
2024-12-08 17:16:05,82,6393,39,43,3825.01,7652.05,0.00
2024-12-08 17:16:05,81,6393,38,43,3810.02,7652.75,0.00
2024-12-08 17:16:05,81,6394,38,43,3866.89,7653.00,0.00
2024-12-08 17:16:05,82,6394,38,44,3819.74,7653.01,0.00
2024-12-08 17:16:05,83,6393,39,44,3749.76,7653.11,0.00
2024-12-08 17:16:05,82,6393,38,44,3796.83,7653.72,0.00
2024-12-08 17:16:05,82,6394,38,44,3868.92,7654.00,0.00
2024-12-08 17:16:05,83,6394,38,45,3822.31,7654.01,0.00
2024-12-08 17:16:05,82,6394,38,44,3865.20,7654.05,0.00
2024-12-08 17:16:05,81,6394,37,44,3880.00,7654.48,0.00
2024-12-08 17:16:05,80,6394,36,44,3916.11,7654.56,0.00
2024-12-08 17:16:05,81,6393,37,44,3849.95,7654.82,0.00
2024-12-08 17:16:05,81,6394,37,44,4038.16,7655.00,0.00
2024-12-08 17:16:05,82,6394,37,45,3988.92,7655.01,0.00
2024-12-08 17:16:05,82,6395,37,45,4063.20,7656.00,0.00
2024-12-08 17:16:05,83,6395,38,45,4014.24,7656.01,0.00
2024-12-08 17:16:05,82,6395,38,44,4059.47,7656.05,0.00
2024-12-08 17:16:05,81,6395,37,44,4064.36,7656.44,0.00
2024-12-08 17:16:05,81,6396,37,44,4116.73,7657.00,0.00
2024-12-08 17:16:05,82,6396,37,45,4066.53,7657.01,0.00
2024-12-08 17:16:05,81,6396,37,44,4094.06,7657.05,0.00
2024-12-08 17:16:05,81,6397,37,44,4097.42,7658.00,0.00
2024-12-08 17:16:05,82,6397,38,44,4047.45,7658.01,0.00
2024-12-08 17:16:05,82,6398,38,44,4028.36,7659.00,0.00
2024-12-08 17:16:05,83,6398,38,45,3979.83,7659.01,0.00
2024-12-08 17:16:05,83,6399,38,45,3960.04,7660.00,0.00
2024-12-08 17:16:05,84,6399,38,46,3912.90,7660.01,0.00
2024-12-08 17:16:05,83,6399,37,46,3936.06,7660.07,0.00
2024-12-08 17:16:05,83,6400,37,46,3939.33,7661.00,0.00
2024-12-08 17:16:05,84,6400,38,46,3892.43,7661.01,0.00
2024-12-08 17:16:05,83,6400,37,46,3938.41,7661.01,0.00
2024-12-08 17:16:05,82,6400,36,46,3984.58,7661.02,0.00
2024-12-08 17:16:05,82,6401,36,46,3966.40,7662.00,0.00
2024-12-08 17:16:05,83,6401,37,46,3918.61,7662.01,0.00
2024-12-08 17:16:05,82,6401,37,45,3954.26,7662.02,0.00
2024-12-08 17:16:05,81,6401,36,45,3983.28,7662.27,0.00
2024-12-08 17:16:05,80,6401,35,45,4016.88,7662.48,0.00
2024-12-08 17:16:05,81,6400,36,45,3932.60,7662.95,0.00
2024-12-08 17:16:05,81,6401,36,45,4008.33,7663.00,0.00
2024-12-08 17:16:05,82,6401,36,46,3959.44,7663.01,0.00
2024-12-08 17:16:05,81,6401,36,45,3991.30,7663.03,0.00
2024-12-08 17:16:05,81,6402,36,45,4087.38,7664.00,0.00
2024-12-08 17:16:05,82,6402,36,46,4037.53,7664.01,0.00
2024-12-08 17:16:05,81,6402,36,45,4069.41,7664.03,0.00
2024-12-08 17:16:06,80,6402,35,45,4100.16,7664.04,0.00
2024-12-08 17:16:06,80,6403,35,45,4122.72,7665.00,0.00
2024-12-08 17:16:06,81,6403,35,46,4071.83,7665.01,0.00
2024-12-08 17:16:06,80,6403,35,45,4104.53,7665.03,0.00
2024-12-08 17:16:06,80,6404,35,45,4106.97,7666.00,0.00
2024-12-08 17:16:06,81,6404,36,45,4056.27,7666.01,0.00
2024-12-08 17:16:06,80,6404,35,45,4046.78,7666.51,0.00
2024-12-08 17:16:06,80,6405,35,45,4105.59,7667.00,0.00
2024-12-08 17:16:06,81,6405,36,45,4054.91,7667.01,0.00
2024-12-08 17:16:06,81,6406,36,45,4036.50,7668.00,0.00
2024-12-08 17:16:06,82,6406,37,45,3987.28,7668.01,0.00
2024-12-08 17:16:06,81,6406,37,44,4013.79,7668.05,0.00
2024-12-08 17:16:06,81,6407,37,44,4017.15,7669.00,0.00
2024-12-08 17:16:06,82,6407,38,44,3968.16,7669.01,0.00
2024-12-08 17:16:06,81,6407,38,43,3994.43,7669.06,0.00
2024-12-08 17:16:06,80,6407,37,43,4042.45,7669.06,0.00
2024-12-08 17:16:06,80,6408,37,43,4066.93,7670.00,0.00
2024-12-08 17:16:06,81,6408,38,43,4016.72,7670.01,0.00
2024-12-08 17:16:06,82,6407,39,43,3964.94,7670.07,0.00
2024-12-08 17:16:06,82,6408,39,43,4026.48,7671.00,0.00
2024-12-08 17:16:06,83,6408,39,44,3977.97,7671.01,0.00
2024-12-08 17:16:06,82,6408,39,43,4016.33,7671.06,0.00
2024-12-08 17:16:06,82,6409,39,43,4111.56,7672.00,0.00
2024-12-08 17:16:06,83,6409,39,44,4062.02,7672.01,0.00
2024-12-08 17:16:06,82,6409,39,43,4079.88,7672.06,0.00
2024-12-08 17:16:06,82,6410,39,43,4077.39,7673.00,0.00
2024-12-08 17:16:06,83,6410,40,43,4028.27,7673.01,0.00
2024-12-08 17:16:06,82,6410,39,43,4033.80,7673.15,0.00
2024-12-08 17:16:06,82,6411,39,43,4050.46,7674.00,0.00
2024-12-08 17:16:06,83,6411,40,43,4001.66,7674.01,0.00
2024-12-08 17:16:06,82,6411,40,42,4038.47,7674.07,0.00
2024-12-08 17:16:06,81,6411,39,42,4041.07,7674.44,0.00
2024-12-08 17:16:06,81,6412,39,42,4073.43,7675.00,0.00
2024-12-08 17:16:06,82,6412,40,42,4023.75,7675.01,0.00
2024-12-08 17:16:06,82,6413,40,42,3969.03,7676.00,0.00
2024-12-08 17:16:06,83,6413,40,43,3921.21,7676.01,0.00
2024-12-08 17:16:06,82,6413,40,42,3958.44,7676.07,0.00
2024-12-08 17:16:06,83,6412,40,43,3857.44,7676.80,0.00
2024-12-08 17:16:06,82,6412,39,43,3888.89,7676.94,0.00
2024-12-08 17:16:06,82,6413,39,43,3959.15,7677.00,0.00
2024-12-08 17:16:06,83,6413,39,44,3911.45,7677.01,0.00
2024-12-08 17:16:06,82,6413,39,43,3930.73,7677.07,0.00
2024-12-08 17:16:06,81,6413,38,43,3975.47,7677.09,0.00
2024-12-08 17:16:06,81,6414,38,43,4095.40,7678.00,0.00
2024-12-08 17:16:06,82,6414,39,43,4045.46,7678.01,0.00
2024-12-08 17:16:06,81,6414,39,42,4067.00,7678.07,0.00
2024-12-08 17:16:06,81,6415,39,42,4072.26,7679.00,0.00
2024-12-08 17:16:06,82,6415,39,43,4022.60,7679.01,0.00
2024-12-08 17:16:06,81,6415,38,43,4011.40,7679.26,0.00
2024-12-08 17:16:06,81,6416,38,43,4049.79,7680.00,0.00
2024-12-08 17:16:06,82,6416,38,44,4000.41,7680.01,0.00
2024-12-08 17:16:06,81,6416,38,43,4040.66,7680.07,0.00
2024-12-08 17:16:06,80,6416,37,43,4064.32,7680.21,0.00
2024-12-08 17:16:06,80,6417,37,43,4100.33,7681.00,0.00
2024-12-08 17:16:06,81,6417,37,44,4049.71,7681.01,0.00
2024-12-08 17:16:06,80,6417,36,44,4079.69,7681.06,0.00
2024-12-08 17:16:06,79,6417,36,43,4124.62,7681.09,0.00
2024-12-08 17:16:06,79,6418,36,43,4152.37,7682.00,0.00
2024-12-08 17:16:06,80,6418,37,43,4100.46,7682.01,0.00
2024-12-08 17:16:07,80,6419,37,43,4078.63,7683.00,0.00
2024-12-08 17:16:07,81,6419,37,44,4028.28,7683.01,0.00
2024-12-08 17:16:07,80,6419,37,43,4063.47,7683.09,0.00
2024-12-08 17:16:07,81,6418,38,43,3951.13,7683.93,0.00
2024-12-08 17:16:07,81,6419,38,43,4027.10,7684.00,0.00
2024-12-08 17:16:07,82,6419,39,43,3977.99,7684.01,0.00
2024-12-08 17:16:07,81,6419,39,42,4025.20,7684.03,0.00
2024-12-08 17:16:07,80,6419,38,42,4067.48,7684.05,0.00
2024-12-08 17:16:07,79,6419,37,42,4114.11,7684.06,0.00
2024-12-08 17:16:07,78,6419,36,42,4138.31,7684.18,0.00
2024-12-08 17:16:07,78,6420,36,42,4271.98,7685.00,0.00
2024-12-08 17:16:07,79,6420,36,43,4217.90,7685.01,0.00
2024-12-08 17:16:07,78,6420,36,42,4270.01,7685.03,0.00
2024-12-08 17:16:07,77,6420,36,41,4311.87,7685.05,0.00
2024-12-08 17:16:07,77,6421,36,41,4314.71,7686.00,0.00
2024-12-08 17:16:07,78,6421,36,42,4259.39,7686.01,0.00
2024-12-08 17:16:07,77,6421,35,42,4311.59,7686.03,0.00
2024-12-08 17:16:07,76,6421,34,42,4337.99,7686.07,0.00
2024-12-08 17:16:07,76,6422,34,42,4356.89,7687.00,0.00
2024-12-08 17:16:07,77,6422,35,42,4300.31,7687.01,0.00
2024-12-08 17:16:07,76,6422,35,41,4351.84,7687.04,0.00
2024-12-08 17:16:07,75,6422,34,41,4403.14,7687.12,0.00
2024-12-08 17:16:07,76,6421,34,42,4280.77,7687.72,0.00
2024-12-08 17:16:07,76,6422,34,42,4380.14,7688.00,0.00
2024-12-08 17:16:07,77,6422,35,42,4323.25,7688.01,0.00
2024-12-08 17:16:07,76,6422,34,42,4330.71,7688.40,0.00
2024-12-08 17:16:07,76,6423,34,42,4466.70,7689.00,0.00
2024-12-08 17:16:07,77,6423,34,43,4408.69,7689.01,0.00
2024-12-08 17:16:07,76,6423,34,42,4462.66,7689.04,0.00
2024-12-08 17:16:07,77,6422,35,42,4367.97,7689.55,0.00
2024-12-08 17:16:07,77,6423,35,42,4439.23,7690.00,0.00
2024-12-08 17:16:07,78,6423,35,43,4382.31,7690.01,0.00
2024-12-08 17:16:07,77,6423,34,43,4405.28,7690.08,0.00
2024-12-08 17:16:07,77,6424,34,43,4534.69,7691.00,0.00
2024-12-08 17:16:07,78,6424,34,44,4476.55,7691.01,0.00
2024-12-08 17:16:07,77,6424,34,43,4528.70,7691.04,0.00
2024-12-08 17:16:07,77,6425,34,43,4535.28,7692.00,0.00
2024-12-08 17:16:07,78,6425,35,43,4477.14,7692.01,0.00
2024-12-08 17:16:07,78,6426,35,43,4460.95,7693.00,0.00
2024-12-08 17:16:07,79,6426,35,44,4404.48,7693.01,0.00
2024-12-08 17:16:07,78,6426,35,43,4456.03,7693.04,0.00
2024-12-08 17:16:07,78,6427,35,43,4461.53,7694.00,0.00
2024-12-08 17:16:07,79,6427,36,43,4405.06,7694.01,0.00
2024-12-08 17:16:07,79,6428,36,43,4388.10,7695.00,0.00
2024-12-08 17:16:07,80,6428,37,43,4333.25,7695.01,0.00
2024-12-08 17:16:07,79,6428,37,42,4383.23,7695.04,0.00
2024-12-08 17:16:07,79,6429,37,42,4387.63,7696.00,0.00
2024-12-08 17:16:07,80,6429,37,43,4332.78,7696.01,0.00
2024-12-08 17:16:07,81,6428,38,43,4196.88,7696.62,0.00
2024-12-08 17:16:07,81,6429,38,43,4288.40,7697.00,0.00
2024-12-08 17:16:07,82,6429,39,43,4236.10,7697.01,0.00
2024-12-08 17:16:07,81,6429,39,42,4281.75,7697.04,0.00
2024-12-08 17:16:07,82,6428,39,43,4178.08,7697.49,0.00
2024-12-08 17:16:07,82,6429,39,43,4345.55,7698.00,0.00
2024-12-08 17:16:07,83,6429,39,44,4293.20,7698.01,0.00
2024-12-08 17:16:07,82,6429,38,44,4303.37,7698.24,0.00
2024-12-08 17:16:07,82,6430,38,44,4433.43,7699.00,0.00
2024-12-08 17:16:07,83,6430,39,44,4380.02,7699.01,0.00
2024-12-08 17:16:07,82,6430,39,43,4424.05,7699.05,0.00
2024-12-08 17:16:07,81,6430,38,43,4458.72,7699.11,0.00
2024-12-08 17:16:07,82,6429,38,44,4387.54,7699.35,0.00
2024-12-08 17:16:07,83,6428,38,45,4391.30,7699.42,0.00
2024-12-08 17:16:07,82,6428,37,45,4453.31,7699.43,0.00
2024-12-08 17:16:07,82,6429,37,45,4503.50,7700.00,0.00
2024-12-08 17:16:07,83,6429,37,46,4449.24,7700.01,0.00
2024-12-08 17:16:07,83,6430,37,46,4614.97,7701.00,0.00
2024-12-08 17:16:07,84,6430,38,46,4560.03,7701.01,0.00
2024-12-08 17:16:07,83,6430,38,45,4606.63,7701.05,0.00
2024-12-08 17:16:08,83,6431,38,45,4607.89,7702.00,0.00
2024-12-08 17:16:08,84,6431,38,46,4553.03,7702.01,0.00
2024-12-08 17:16:08,83,6431,37,46,4576.38,7702.18,0.00
2024-12-08 17:16:08,83,6432,37,46,4585.75,7703.00,0.00
2024-12-08 17:16:08,84,6432,38,46,4531.16,7703.01,0.00
2024-12-08 17:16:08,83,6432,38,45,4578.33,7703.05,0.00
2024-12-08 17:16:08,83,6433,38,45,4574.71,7704.00,0.00
2024-12-08 17:16:08,84,6433,38,46,4520.24,7704.01,0.00
2024-12-08 17:16:08,83,6433,37,46,4572.85,7704.02,0.00
2024-12-08 17:16:08,83,6434,37,46,4545.60,7705.00,0.00
2024-12-08 17:16:08,84,6434,37,47,4491.49,7705.01,0.00
2024-12-08 17:16:08,83,6434,37,46,4530.75,7705.05,0.00
2024-12-08 17:16:08,83,6435,37,46,4521.26,7706.00,0.00
2024-12-08 17:16:08,84,6435,38,46,4467.44,7706.01,0.00
2024-12-08 17:16:08,84,6436,38,46,4432.41,7707.00,0.00
2024-12-08 17:16:08,85,6436,38,47,4380.26,7707.01,0.00
2024-12-08 17:16:08,84,6436,38,46,4418.65,7707.07,0.00
2024-12-08 17:16:08,83,6436,37,46,4460.75,7707.08,0.00
2024-12-08 17:16:08,83,6437,37,46,4466.07,7708.00,0.00
2024-12-08 17:16:08,84,6437,37,47,4412.90,7708.01,0.00
2024-12-08 17:16:08,84,6438,37,47,4372.83,7709.00,0.00
2024-12-08 17:16:08,85,6438,38,47,4321.39,7709.01,0.00
2024-12-08 17:16:08,84,6438,37,47,4371.00,7709.04,0.00
2024-12-08 17:16:08,83,6438,36,47,4420.88,7709.04,0.00
2024-12-08 17:16:08,82,6438,36,46,4463.52,7709.06,0.00
2024-12-08 17:16:08,82,6439,36,46,4465.29,7710.00,0.00
2024-12-08 17:16:08,83,6439,36,47,4411.49,7710.01,0.00
2024-12-08 17:16:08,82,6439,35,47,4410.26,7710.42,0.00
2024-12-08 17:16:08,82,6440,35,47,4425.15,7711.00,0.00
2024-12-08 17:16:08,83,6440,36,47,4371.84,7711.01,0.00
2024-12-08 17:16:08,84,6439,37,47,4216.72,7711.86,0.00
2024-12-08 17:16:08,84,6440,37,47,4289.38,7712.00,0.00
2024-12-08 17:16:08,85,6440,37,48,4238.91,7712.01,0.00
2024-12-08 17:16:08,84,6440,37,47,4282.96,7712.06,0.00
2024-12-08 17:16:08,84,6441,37,47,4353.44,7713.00,0.00
2024-12-08 17:16:08,85,6441,37,48,4302.22,7713.01,0.00
2024-12-08 17:16:08,84,6441,37,47,4266.94,7713.79,0.00
2024-12-08 17:16:08,84,6442,37,47,4324.04,7714.00,0.00
2024-12-08 17:16:08,85,6442,37,48,4273.17,7714.01,0.00
2024-12-08 17:16:08,84,6442,37,47,4308.45,7714.08,0.00
2024-12-08 17:16:08,84,6443,37,47,4306.41,7715.00,0.00
2024-12-08 17:16:08,85,6443,38,47,4255.74,7715.01,0.00
2024-12-08 17:16:08,84,6443,37,47,4267.85,7715.11,0.00
2024-12-08 17:16:08,84,6444,37,47,4286.78,7716.00,0.00
2024-12-08 17:16:08,85,6444,37,48,4236.35,7716.01,0.00
2024-12-08 17:16:08,84,6444,37,47,4272.10,7716.08,0.00
2024-12-08 17:16:08,83,6444,36,47,4313.39,7716.21,0.00
2024-12-08 17:16:08,83,6445,36,47,4323.43,7717.00,0.00
2024-12-08 17:16:08,84,6445,37,47,4271.96,7717.01,0.00
2024-12-08 17:16:08,85,6444,37,48,4189.07,7717.22,0.00
2024-12-08 17:16:08,86,6443,37,49,4149.02,7717.29,0.00
2024-12-08 17:16:08,87,6442,38,49,4137.77,7717.46,0.00
2024-12-08 17:16:08,86,6442,37,49,4189.67,7717.77,0.00
2024-12-08 17:16:08,86,6443,37,49,4261.65,7718.00,0.00
2024-12-08 17:16:08,87,6443,38,49,4212.67,7718.01,0.00
2024-12-08 17:16:08,86,6443,38,48,4248.20,7718.08,0.00
2024-12-08 17:16:08,85,6443,38,47,4286.75,7718.21,0.00
2024-12-08 17:16:09,85,6444,38,47,4571.48,7719.00,0.00
2024-12-08 17:16:09,86,6444,39,47,4518.32,7719.01,0.00
2024-12-08 17:16:09,86,6445,39,47,4495.70,7720.00,0.00
2024-12-08 17:16:09,87,6445,39,48,4444.02,7720.01,0.00
2024-12-08 17:16:09,86,6445,39,47,4481.34,7720.08,0.00
2024-12-08 17:16:09,86,6446,39,47,4480.88,7721.00,0.00
2024-12-08 17:16:09,87,6446,40,47,4429.38,7721.01,0.00
2024-12-08 17:16:09,87,6447,40,47,4403.84,7722.00,0.00
2024-12-08 17:16:09,88,6447,41,47,4353.80,7722.01,0.00
2024-12-08 17:16:09,87,6447,41,46,4390.54,7722.08,0.00
2024-12-08 17:16:09,87,6448,41,46,4387.03,7723.00,0.00
2024-12-08 17:16:09,88,6448,41,47,4337.18,7723.01,0.00
2024-12-08 17:16:09,87,6448,40,47,4386.14,7723.01,0.00
2024-12-08 17:16:09,87,6449,40,47,4358.43,7724.00,0.00
2024-12-08 17:16:09,88,6449,40,48,4308.91,7724.01,0.00
2024-12-08 17:16:09,87,6449,40,47,4357.55,7724.01,0.00
2024-12-08 17:16:09,86,6449,40,46,4397.44,7724.06,0.00
2024-12-08 17:16:09,86,6450,40,46,4390.65,7725.00,0.00
2024-12-08 17:16:09,87,6450,40,47,4340.18,7725.01,0.00
2024-12-08 17:16:09,87,6451,40,47,4310.27,7726.00,0.00
2024-12-08 17:16:09,88,6451,41,47,4261.29,7726.01,0.00
2024-12-08 17:16:09,87,6451,41,46,4300.50,7726.06,0.00
2024-12-08 17:16:09,87,6452,41,46,4290.66,7727.00,0.00
2024-12-08 17:16:09,88,6452,41,47,4241.91,7727.01,0.00
2024-12-08 17:16:09,87,6452,40,47,4282.67,7727.01,0.00
2024-12-08 17:16:09,88,6451,41,47,4212.93,7727.08,0.00
2024-12-08 17:16:09,87,6451,40,47,4275.63,7727.21,0.00
2024-12-08 17:16:09,87,6452,40,47,4293.99,7728.00,0.00
2024-12-08 17:16:09,88,6452,40,48,4245.20,7728.01,0.00
2024-12-08 17:16:09,87,6452,39,48,4281.56,7728.02,0.00
2024-12-08 17:16:09,86,6452,39,47,4325.05,7728.04,0.00
2024-12-08 17:16:09,86,6453,39,47,4420.14,7729.00,0.00
2024-12-08 17:16:09,87,6453,39,48,4369.33,7729.01,0.00
2024-12-08 17:16:09,87,6454,39,48,4335.31,7730.00,0.00
2024-12-08 17:16:09,88,6454,39,49,4286.04,7730.01,0.00
2024-12-08 17:16:09,87,6454,39,48,4328.21,7730.05,0.00
2024-12-08 17:16:09,86,6454,38,48,4307.68,7730.85,0.00
2024-12-08 17:16:09,86,6455,38,48,4368.03,7731.00,0.00
2024-12-08 17:16:09,87,6455,39,48,4317.82,7731.01,0.00
2024-12-08 17:16:09,88,6454,39,49,4178.60,7731.75,0.00
2024-12-08 17:16:09,88,6455,39,49,4264.04,7732.00,0.00
2024-12-08 17:16:09,89,6455,39,50,4216.13,7732.01,0.00
2024-12-08 17:16:09,88,6455,39,49,4257.02,7732.06,0.00
2024-12-08 17:16:09,88,6456,39,49,4342.80,7733.00,0.00
2024-12-08 17:16:09,89,6456,39,50,4294.00,7733.01,0.00
2024-12-08 17:16:09,88,6456,38,50,4272.67,7733.47,0.00
2024-12-08 17:16:09,88,6457,38,50,4319.63,7734.00,0.00
2024-12-08 17:16:09,89,6457,38,51,4271.09,7734.01,0.00
2024-12-08 17:16:09,88,6457,37,51,4287.17,7734.21,0.00
2024-12-08 17:16:09,88,6458,37,51,4296.46,7735.00,0.00
2024-12-08 17:16:09,89,6458,37,52,4248.18,7735.01,0.00
2024-12-08 17:16:09,88,6458,36,52,4234.19,7735.42,0.00
2024-12-08 17:16:09,88,6459,36,52,4277.67,7736.00,0.00
2024-12-08 17:16:09,89,6459,36,53,4229.61,7736.01,0.00
2024-12-08 17:16:09,89,6460,36,53,4205.81,7737.00,0.00
2024-12-08 17:16:09,90,6460,36,54,4159.08,7737.01,0.00
2024-12-08 17:16:10,89,6460,35,54,4204.94,7737.01,0.00
2024-12-08 17:16:10,88,6460,35,53,4249.22,7737.05,0.00
2024-12-08 17:16:10,89,6459,36,53,4137.03,7737.67,0.00
2024-12-08 17:16:10,89,6460,36,53,4203.37,7738.00,0.00
2024-12-08 17:16:10,90,6460,37,53,4156.67,7738.01,0.00
2024-12-08 17:16:10,89,6460,36,53,4150.40,7738.24,0.00
2024-12-08 17:16:10,88,6460,36,52,4194.42,7738.26,0.00
2024-12-08 17:16:10,88,6461,36,52,4313.61,7739.00,0.00
2024-12-08 17:16:10,89,6461,37,52,4265.15,7739.01,0.00
2024-12-08 17:16:10,88,6461,37,51,4310.11,7739.05,0.00
2024-12-08 17:16:10,88,6462,37,51,4306.99,7740.00,0.00
2024-12-08 17:16:10,89,6462,38,51,4258.60,7740.01,0.00
2024-12-08 17:16:10,90,6461,39,51,4210.42,7740.04,0.00
2024-12-08 17:16:10,90,6462,39,51,4186.42,7741.00,0.00
2024-12-08 17:16:10,91,6462,40,51,4140.41,7741.01,0.00
2024-12-08 17:16:10,90,6462,40,50,4175.26,7741.10,0.00
2024-12-08 17:16:10,90,6463,40,50,4235.46,7742.00,0.00
2024-12-08 17:16:10,91,6463,40,51,4188.92,7742.01,0.00
2024-12-08 17:16:10,90,6463,40,50,4234.60,7742.01,0.00
2024-12-08 17:16:10,89,6463,39,50,4280.45,7742.03,0.00
2024-12-08 17:16:10,88,6463,38,50,4328.21,7742.03,0.00
2024-12-08 17:16:10,87,6463,37,50,4365.52,7742.09,0.00
2024-12-08 17:16:10,86,6463,36,50,4306.20,7742.80,0.00
2024-12-08 17:16:10,86,6464,36,50,4381.10,7743.00,0.00
2024-12-08 17:16:10,87,6464,36,51,4330.74,7743.01,0.00
2024-12-08 17:16:10,86,6464,36,50,4366.72,7743.09,0.00
2024-12-08 17:16:10,85,6464,35,50,4392.62,7743.19,0.00
2024-12-08 17:16:10,84,6464,34,50,4403.71,7743.73,0.00
2024-12-08 17:16:10,84,6465,34,50,4474.92,7744.00,0.00
2024-12-08 17:16:10,85,6465,34,51,4422.28,7744.01,0.00
2024-12-08 17:16:10,84,6465,33,51,4455.60,7744.12,0.00
2024-12-08 17:16:10,85,6464,34,51,4328.88,7744.87,0.00
2024-12-08 17:16:10,85,6465,34,51,4418.29,7745.00,0.00
2024-12-08 17:16:10,86,6465,35,51,4366.92,7745.01,0.00
2024-12-08 17:16:10,85,6465,35,50,4396.44,7745.06,0.00
2024-12-08 17:16:10,84,6465,34,50,4433.16,7745.23,0.00
2024-12-08 17:16:10,84,6466,34,50,4558.15,7746.00,0.00
2024-12-08 17:16:10,85,6466,34,51,4504.52,7746.01,0.00
2024-12-08 17:16:10,84,6466,34,50,4522.21,7746.11,0.00
2024-12-08 17:16:10,84,6467,34,50,4545.83,7747.00,0.00
2024-12-08 17:16:10,85,6467,34,51,4492.35,7747.01,0.00
2024-12-08 17:16:10,85,6468,34,51,4471.05,7748.00,0.00
2024-12-08 17:16:10,86,6468,35,51,4419.06,7748.01,0.00
2024-12-08 17:16:10,86,6469,35,51,4397.10,7749.00,0.00
2024-12-08 17:16:10,87,6469,35,52,4346.56,7749.01,0.00
2024-12-08 17:16:10,87,6470,35,52,4323.96,7750.00,0.00
2024-12-08 17:16:10,88,6470,36,52,4274.83,7750.01,0.00
2024-12-08 17:16:10,87,6470,36,51,4309.73,7750.10,0.00
2024-12-08 17:16:10,87,6471,36,51,4312.05,7751.00,0.00
2024-12-08 17:16:10,88,6471,36,52,4263.05,7751.01,0.00
2024-12-08 17:16:10,87,6471,35,52,4302.27,7751.09,0.00
2024-12-08 17:16:10,87,6472,35,52,4303.69,7752.00,0.00
2024-12-08 17:16:10,88,6472,36,52,4254.79,7752.01,0.00
2024-12-08 17:16:10,87,6472,36,51,4292.13,7752.09,0.00
2024-12-08 17:16:10,87,6473,36,51,4293.56,7753.00,0.00
2024-12-08 17:16:10,88,6473,36,52,4244.77,7753.01,0.00
2024-12-08 17:16:10,88,6474,36,52,4221.52,7754.00,0.00
2024-12-08 17:16:10,89,6474,36,53,4174.09,7754.01,0.00
2024-12-08 17:16:10,88,6474,35,53,4219.77,7754.02,0.00
2024-12-08 17:16:10,87,6474,35,52,4258.48,7754.08,0.00
2024-12-08 17:16:10,86,6474,34,52,4296.31,7754.22,0.00
2024-12-08 17:16:11,86,6475,34,52,4326.57,7755.00,0.00
2024-12-08 17:16:11,87,6475,34,53,4276.84,7755.01,0.00
2024-12-08 17:16:11,87,6476,34,53,4254.21,7756.00,0.00
2024-12-08 17:16:11,88,6476,35,53,4205.87,7756.01,0.00
2024-12-08 17:16:11,87,6476,35,52,4244.42,7756.08,0.00
2024-12-08 17:16:11,87,6477,35,52,4244.95,7757.00,0.00
2024-12-08 17:16:11,88,6477,36,52,4196.71,7757.01,0.00
2024-12-08 17:16:11,87,6477,35,52,4241.40,7757.06,0.00
2024-12-08 17:16:11,86,6477,34,52,4280.80,7757.09,0.00
2024-12-08 17:16:11,85,6477,33,52,4302.00,7757.22,0.00
2024-12-08 17:16:11,85,6478,33,52,4333.53,7758.00,0.00
2024-12-08 17:16:11,86,6478,34,52,4283.14,7758.01,0.00
2024-12-08 17:16:11,85,6478,34,51,4319.86,7758.09,0.00
2024-12-08 17:16:11,85,6479,34,51,4323.13,7759.00,0.00
2024-12-08 17:16:11,86,6479,35,51,4272.86,7759.01,0.00
2024-12-08 17:16:11,85,6479,34,51,4244.27,7759.64,0.00
2024-12-08 17:16:11,85,6480,34,51,4307.55,7760.00,0.00
2024-12-08 17:16:11,86,6480,35,51,4257.46,7760.01,0.00
2024-12-08 17:16:11,85,6480,35,50,4294.79,7760.09,0.00
2024-12-08 17:16:11,84,6480,34,50,4311.64,7760.50,0.00
2024-12-08 17:16:11,84,6481,34,50,4347.12,7761.00,0.00
2024-12-08 17:16:11,85,6481,34,51,4295.98,7761.01,0.00
2024-12-08 17:16:11,84,6481,33,51,4330.50,7761.02,0.00
2024-12-08 17:16:11,84,6482,33,51,4321.62,7762.00,0.00
2024-12-08 17:16:11,85,6482,34,51,4270.78,7762.01,0.00
2024-12-08 17:16:11,84,6482,34,50,4308.70,7762.05,0.00
2024-12-08 17:16:11,83,6482,33,50,4346.63,7762.23,0.00
2024-12-08 17:16:11,83,6483,33,50,4345.45,7763.00,0.00
2024-12-08 17:16:11,84,6483,34,50,4293.71,7763.01,0.00
2024-12-08 17:16:11,83,6483,34,49,4343.58,7763.02,0.00
2024-12-08 17:16:11,82,6483,34,48,4388.99,7763.06,0.00
2024-12-08 17:16:11,82,6484,34,48,4362.48,7764.00,0.00
2024-12-08 17:16:11,83,6484,34,49,4309.92,7764.01,0.00
2024-12-08 17:16:11,82,6484,33,49,4295.77,7764.33,0.00
2024-12-08 17:16:11,82,6485,33,49,4297.22,7765.00,0.00
2024-12-08 17:16:11,83,6485,34,49,4245.45,7765.01,0.00
2024-12-08 17:16:11,82,6485,34,48,4287.77,7765.07,0.00
2024-12-08 17:16:11,81,6485,33,48,4286.38,7765.64,0.00
2024-12-08 17:16:11,81,6486,33,48,4317.57,7766.00,0.00
2024-12-08 17:16:11,82,6486,33,49,4264.92,7766.01,0.00
2024-12-08 17:16:11,82,6487,33,49,4219.94,7767.00,0.00
2024-12-08 17:16:11,83,6487,33,50,4169.10,7767.01,0.00
2024-12-08 17:16:11,82,6487,32,50,4218.06,7767.02,0.00
2024-12-08 17:16:11,81,6487,32,49,4263.43,7767.06,0.00
2024-12-08 17:16:11,81,6488,32,49,4234.61,7768.00,0.00
2024-12-08 17:16:11,82,6488,32,50,4182.97,7768.01,0.00
2024-12-08 17:16:11,81,6488,32,49,4142.76,7768.75,0.00
2024-12-08 17:16:11,80,6488,31,49,4178.35,7768.81,0.00
2024-12-08 17:16:11,80,6489,31,49,4261.05,7769.00,0.00
2024-12-08 17:16:11,81,6489,32,49,4208.45,7769.01,0.00
2024-12-08 17:16:11,80,6489,32,48,4254.27,7769.06,0.00
2024-12-08 17:16:11,79,6489,31,48,4252.65,7769.76,0.00
2024-12-08 17:16:11,79,6490,31,48,4312.84,7770.00,0.00
2024-12-08 17:16:11,80,6490,32,48,4258.93,7770.01,0.00
2024-12-08 17:16:11,79,6490,31,48,4274.55,7770.25,0.00
2024-12-08 17:16:11,79,6491,31,48,4295.69,7771.00,0.00
2024-12-08 17:16:11,80,6491,32,48,4241.99,7771.01,0.00
2024-12-08 17:16:11,79,6491,32,47,4288.82,7771.06,0.00
2024-12-08 17:16:11,79,6492,32,47,4287.87,7772.00,0.00
2024-12-08 17:16:11,80,6492,33,47,4234.28,7772.01,0.00
2024-12-08 17:16:12,80,6493,33,47,4202.24,7773.00,0.00
2024-12-08 17:16:12,81,6493,33,48,4150.36,7773.01,0.00
2024-12-08 17:16:12,80,6493,33,47,4193.50,7773.08,0.00
2024-12-08 17:16:12,80,6494,33,47,4180.52,7774.00,0.00
2024-12-08 17:16:12,81,6494,34,47,4128.91,7774.01,0.00
2024-12-08 17:16:12,81,6495,34,47,4087.39,7775.00,0.00
2024-12-08 17:16:12,82,6495,35,47,4037.55,7775.01,0.00
2024-12-08 17:16:12,81,6495,34,47,4082.61,7775.06,0.00
2024-12-08 17:16:12,80,6495,34,46,4128.78,7775.08,0.00
2024-12-08 17:16:12,79,6495,34,45,4104.31,7775.70,0.00
2024-12-08 17:16:12,79,6496,34,45,4179.35,7776.00,0.00
2024-12-08 17:16:12,80,6496,35,45,4127.11,7776.01,0.00
2024-12-08 17:16:12,80,6497,35,45,4109.17,7777.00,0.00
2024-12-08 17:16:12,81,6497,36,45,4058.44,7777.01,0.00
2024-12-08 17:16:12,80,6497,36,44,4089.74,7777.08,0.00
2024-12-08 17:16:12,80,6498,36,44,4096.09,7778.00,0.00
2024-12-08 17:16:12,81,6498,37,44,4045.52,7778.01,0.00
2024-12-08 17:16:12,80,6498,36,44,4052.41,7778.31,0.00
2024-12-08 17:16:12,80,6499,36,44,4077.17,7779.00,0.00
2024-12-08 17:16:12,81,6499,36,45,4026.83,7779.01,0.00
2024-12-08 17:16:12,80,6499,36,44,4071.34,7779.08,0.00
2024-12-08 17:16:12,80,6500,36,44,4077.69,7780.00,0.00
2024-12-08 17:16:12,81,6500,37,44,4027.35,7780.01,0.00
2024-12-08 17:16:12,82,6499,38,44,3974.45,7780.09,0.00
2024-12-08 17:16:12,81,6499,38,43,4083.08,7780.09,0.00
2024-12-08 17:16:12,81,6500,38,43,4089.35,7781.00,0.00
2024-12-08 17:16:12,82,6500,39,43,4039.48,7781.01,0.00
2024-12-08 17:16:12,82,6501,39,43,4114.97,7782.00,0.00
2024-12-08 17:16:12,83,6501,40,43,4065.39,7782.01,0.00
2024-12-08 17:16:12,82,6501,40,42,4109.29,7782.07,0.00
2024-12-08 17:16:12,82,6502,40,42,4113.60,7783.00,0.00
2024-12-08 17:16:12,83,6502,40,43,4064.04,7783.01,0.00
2024-12-08 17:16:12,82,6502,40,42,4111.71,7783.02,0.00
2024-12-08 17:16:12,81,6502,39,42,4161.51,7783.03,0.00
2024-12-08 17:16:12,80,6502,38,42,4210.62,7783.05,0.00
2024-12-08 17:16:12,79,6502,37,42,4203.03,7783.56,0.00
2024-12-08 17:16:12,79,6503,37,42,4267.40,7784.00,0.00
2024-12-08 17:16:12,80,6503,38,42,4214.06,7784.01,0.00
2024-12-08 17:16:12,79,6503,38,41,4263.48,7784.05,0.00
2024-12-08 17:16:12,79,6504,38,41,4268.94,7785.00,0.00
2024-12-08 17:16:12,80,6504,39,41,4215.58,7785.01,0.00
2024-12-08 17:16:12,79,6504,39,40,4245.31,7785.05,0.00
2024-12-08 17:16:12,79,6505,39,40,4250.76,7786.00,0.00
2024-12-08 17:16:12,80,6505,39,41,4197.63,7786.01,0.00
2024-12-08 17:16:12,79,6505,38,41,4227.13,7786.05,0.00
2024-12-08 17:16:12,79,6506,38,41,4232.58,7787.00,0.00
2024-12-08 17:16:12,80,6506,38,42,4179.67,7787.01,0.00
2024-12-08 17:16:12,79,6506,38,41,4228.65,7787.05,0.00
2024-12-08 17:16:12,79,6507,38,41,4234.11,7788.00,0.00
2024-12-08 17:16:12,80,6507,38,42,4181.18,7788.01,0.00
2024-12-08 17:16:12,79,6507,37,42,4232.14,7788.03,0.00
2024-12-08 17:16:12,78,6507,37,41,4264.45,7788.04,0.00
2024-12-08 17:16:12,78,6508,37,41,4269.97,7789.00,0.00
2024-12-08 17:16:12,79,6508,38,41,4215.92,7789.01,0.00
2024-12-08 17:16:12,78,6508,37,41,4244.02,7789.05,0.00
2024-12-08 17:16:12,78,6509,37,41,4270.52,7790.00,0.00
2024-12-08 17:16:12,79,6509,37,42,4216.46,7790.01,0.00
2024-12-08 17:16:12,78,6509,37,41,4267.54,7790.04,0.00
2024-12-08 17:16:12,78,6510,37,41,4273.06,7791.00,0.00
2024-12-08 17:16:12,79,6510,38,41,4218.97,7791.01,0.00
2024-12-08 17:16:13,79,6511,38,41,4201.76,7792.00,0.00
2024-12-08 17:16:13,80,6511,38,42,4149.24,7792.01,0.00
2024-12-08 17:16:13,79,6511,38,41,4198.82,7792.04,0.00
2024-12-08 17:16:13,79,6512,38,41,4203.29,7793.00,0.00
2024-12-08 17:16:13,80,6512,38,42,4150.75,7793.01,0.00
2024-12-08 17:16:13,79,6512,38,41,4180.61,7793.04,0.00
2024-12-08 17:16:13,78,6512,37,41,4226.23,7793.08,0.00
2024-12-08 17:16:13,78,6513,37,41,4254.72,7794.00,0.00
2024-12-08 17:16:13,79,6513,37,42,4200.87,7794.01,0.00
2024-12-08 17:16:13,78,6513,37,41,4231.76,7794.04,0.00
2024-12-08 17:16:13,78,6514,37,41,4237.28,7795.00,0.00
2024-12-08 17:16:13,79,6514,38,41,4183.64,7795.01,0.00
2024-12-08 17:16:13,78,6514,37,41,4234.30,7795.04,0.00
2024-12-08 17:16:13,78,6515,37,41,4239.82,7796.00,0.00
2024-12-08 17:16:13,79,6515,38,41,4186.15,7796.01,0.00
2024-12-08 17:16:13,78,6515,38,40,4236.84,7796.04,0.00
2024-12-08 17:16:13,78,6516,38,40,4242.37,7797.00,0.00
2024-12-08 17:16:13,79,6516,39,40,4188.67,7797.01,0.00
2024-12-08 17:16:13,78,6516,39,39,4219.39,7797.04,0.00
2024-12-08 17:16:13,78,6517,39,39,4224.92,7798.00,0.00
2024-12-08 17:16:13,79,6517,40,39,4171.44,7798.01,0.00
2024-12-08 17:16:13,78,6517,40,38,4202.94,7798.04,0.00
2024-12-08 17:16:13,78,6517,40,38,4208.46,7799.00,0.00
2024-12-08 17:16:13,79,6517,40,39,4155.19,7799.01,0.00
2024-12-08 17:16:13,79,6518,40,39,4137.95,7800.00,0.00
2024-12-08 17:16:13,80,6518,40,40,4086.22,7800.01,0.00
2024-12-08 17:16:13,79,6518,40,39,4135.00,7800.04,0.00
2024-12-08 17:16:13,78,6518,39,39,4169.08,7800.27,0.00
2024-12-08 17:16:13,78,6519,39,39,4192.54,7801.00,0.00
2024-12-08 17:16:13,79,6519,40,39,4139.47,7801.01,0.00
2024-12-08 17:16:13,79,6520,40,39,4122.22,7802.00,0.00
2024-12-08 17:16:13,80,6520,40,40,4070.69,7802.01,0.00
2024-12-08 17:16:13,79,6520,40,39,4117.30,7802.05,0.00
2024-12-08 17:16:13,80,6519,40,40,4033.80,7802.49,0.00
2024-12-08 17:16:13,79,6519,39,40,4123.39,7802.49,0.00
2024-12-08 17:16:13,78,6519,38,40,4152.33,7802.64,0.00
2024-12-08 17:16:13,79,6518,38,41,4087.04,7802.82,0.00
2024-12-08 17:16:13,79,6519,38,41,4185.96,7803.00,0.00
2024-12-08 17:16:13,80,6519,39,41,4133.64,7803.01,0.00
2024-12-08 17:16:13,80,6520,39,41,4310.73,7804.00,0.00
2024-12-08 17:16:13,81,6520,40,41,4257.51,7804.01,0.00
2024-12-08 17:16:13,80,6520,40,40,4306.85,7804.05,0.00
2024-12-08 17:16:13,80,6521,40,40,4311.29,7805.00,0.00
2024-12-08 17:16:13,81,6521,41,40,4258.06,7805.01,0.00
2024-12-08 17:16:13,80,6521,41,39,4287.89,7805.05,0.00
2024-12-08 17:16:13,80,6522,41,39,4292.32,7806.00,0.00
2024-12-08 17:16:13,81,6522,41,40,4239.33,7806.01,0.00
2024-12-08 17:16:13,80,6522,40,40,4288.44,7806.05,0.00
2024-12-08 17:16:13,80,6523,40,40,4273.35,7807.00,0.00
2024-12-08 17:16:13,81,6523,40,41,4220.60,7807.01,0.00
2024-12-08 17:16:13,80,6523,40,40,4267.52,7807.06,0.00
2024-12-08 17:16:13,80,6524,40,40,4272.93,7808.00,0.00
2024-12-08 17:16:13,81,6524,41,40,4220.17,7808.01,0.00
2024-12-08 17:16:13,81,6525,41,40,4201.43,7809.00,0.00
2024-12-08 17:16:13,82,6525,42,40,4150.20,7809.01,0.00
2024-12-08 17:16:13,81,6525,42,39,4180.24,7809.05,0.00
2024-12-08 17:16:13,80,6525,42,38,4231.51,7809.05,0.00
2024-12-08 17:16:13,80,6526,42,38,4235.95,7810.00,0.00
2024-12-08 17:16:13,81,6526,43,38,4183.65,7810.01,0.00
2024-12-08 17:16:13,80,6526,43,37,4212.53,7810.05,0.00
2024-12-08 17:16:13,79,6526,42,37,4212.68,7810.60,0.00
2024-12-08 17:16:14,79,6527,42,37,4280.23,7811.00,0.00
2024-12-08 17:16:14,80,6527,42,38,4226.73,7811.01,0.00
2024-12-08 17:16:14,79,6527,42,37,4256.51,7811.05,0.00
2024-12-08 17:16:14,79,6528,42,37,4261.99,7812.00,0.00
2024-12-08 17:16:14,80,6528,42,38,4208.71,7812.01,0.00
2024-12-08 17:16:14,79,6528,42,37,4238.27,7812.05,0.00
2024-12-08 17:16:14,79,6529,42,37,4243.74,7813.00,0.00
2024-12-08 17:16:14,80,6529,42,38,4190.70,7813.01,0.00
2024-12-08 17:16:14,79,6529,42,37,4220.02,7813.05,0.00
2024-12-08 17:16:14,79,6530,42,37,4225.49,7814.00,0.00
2024-12-08 17:16:14,80,6530,43,37,4172.68,7814.01,0.00
2024-12-08 17:16:14,79,6530,42,37,4160.39,7814.53,0.00
2024-12-08 17:16:14,79,6531,42,37,4223.07,7815.00,0.00
2024-12-08 17:16:14,80,6531,42,38,4170.28,7815.01,0.00
2024-12-08 17:16:14,79,6531,42,37,4210.22,7815.05,0.00
2024-12-08 17:16:14,79,6532,42,37,4215.69,7816.00,0.00
2024-12-08 17:16:14,80,6532,42,38,4163.00,7816.01,0.00
2024-12-08 17:16:14,79,6532,42,37,4192.95,7816.05,0.00
2024-12-08 17:16:14,78,6532,41,37,4193.74,7816.47,0.00
2024-12-08 17:16:14,79,6531,42,37,4139.67,7816.51,0.00
2024-12-08 17:16:14,79,6532,42,37,4238.00,7817.00,0.00
2024-12-08 17:16:14,80,6532,42,38,4185.02,7817.01,0.00
2024-12-08 17:16:14,79,6532,42,37,4215.25,7817.05,0.00
2024-12-08 17:16:14,78,6532,41,37,4241.31,7817.32,0.00
2024-12-08 17:16:14,78,6533,41,37,4389.10,7818.00,0.00
2024-12-08 17:16:14,79,6533,42,37,4333.55,7818.01,0.00
2024-12-08 17:16:14,78,6533,42,36,4366.06,7818.05,0.00
2024-12-08 17:16:14,78,6534,42,36,4372.62,7819.00,0.00
2024-12-08 17:16:14,79,6534,42,37,4317.27,7819.01,0.00
2024-12-08 17:16:14,78,6534,41,37,4369.63,7819.05,0.00
2024-12-08 17:16:14,78,6535,41,37,4356.14,7820.00,0.00
2024-12-08 17:16:14,79,6535,42,37,4301.00,7820.01,0.00
2024-12-08 17:16:14,78,6535,41,37,4351.14,7820.06,0.00
2024-12-08 17:16:14,77,6535,41,36,4399.53,7820.10,0.00
2024-12-08 17:16:14,77,6536,41,36,4411.25,7821.00,0.00
2024-12-08 17:16:14,78,6536,42,36,4354.69,7821.01,0.00
2024-12-08 17:16:14,77,6536,41,36,4408.21,7821.04,0.00
2024-12-08 17:16:14,76,6536,40,36,4464.16,7821.05,0.00
2024-12-08 17:16:14,76,6537,40,36,4452.36,7822.00,0.00
2024-12-08 17:16:14,77,6537,40,37,4394.54,7822.01,0.00
2024-12-08 17:16:14,76,6537,40,36,4441.06,7822.09,0.00
2024-12-08 17:16:14,76,6538,40,36,4452.93,7823.00,0.00
2024-12-08 17:16:14,77,6538,41,36,4395.10,7823.01,0.00
2024-12-08 17:16:14,77,6539,41,36,4379.41,7824.00,0.00
2024-12-08 17:16:14,78,6539,42,36,4323.26,7824.01,0.00
2024-12-08 17:16:14,77,6539,42,35,4364.18,7824.10,0.00
2024-12-08 17:16:14,77,6540,42,35,4375.90,7825.00,0.00
2024-12-08 17:16:14,78,6540,42,36,4319.80,7825.01,0.00
2024-12-08 17:16:14,77,6540,41,36,4333.25,7825.14,0.00
2024-12-08 17:16:14,77,6541,41,36,4368.33,7826.00,0.00
2024-12-08 17:16:14,78,6541,42,36,4312.32,7826.01,0.00
2024-12-08 17:16:14,77,6541,42,35,4353.10,7826.10,0.00
2024-12-08 17:16:15,77,6542,42,35,4363.90,7827.00,0.00
2024-12-08 17:16:15,78,6542,42,36,4307.96,7827.01,0.00
2024-12-08 17:16:15,79,6541,43,36,4207.94,7827.37,0.00
2024-12-08 17:16:15,79,6542,43,36,4283.39,7828.00,0.00
2024-12-08 17:16:15,80,6542,44,36,4229.85,7828.01,0.00
2024-12-08 17:16:15,79,6542,44,35,4269.54,7828.10,0.00
2024-12-08 17:16:15,79,6543,44,35,4376.37,7829.00,0.00
2024-12-08 17:16:15,80,6543,44,36,4321.66,7829.01,0.00
2024-12-08 17:16:15,79,6543,43,36,4337.78,7829.24,0.00
2024-12-08 17:16:15,79,6544,43,36,4356.04,7830.00,0.00
2024-12-08 17:16:15,80,6544,44,36,4301.58,7830.01,0.00
2024-12-08 17:16:15,79,6544,43,36,4349.11,7830.09,0.00
2024-12-08 17:16:15,78,6544,43,35,4398.85,7830.09,0.00
2024-12-08 17:16:15,77,6544,42,35,4444.83,7830.22,0.00
2024-12-08 17:16:15,76,6544,41,35,4424.98,7830.88,0.00
2024-12-08 17:16:15,76,6545,41,35,4518.84,7831.00,0.00
2024-12-08 17:16:15,77,6545,42,35,4460.16,7831.01,0.00
2024-12-08 17:16:15,77,6546,42,35,4417.90,7832.00,0.00
2024-12-08 17:16:15,78,6546,43,35,4361.26,7832.01,0.00
2024-12-08 17:16:15,78,6547,43,35,4312.19,7833.00,0.00
2024-12-08 17:16:15,79,6547,44,35,4257.60,7833.01,0.00
2024-12-08 17:16:15,78,6547,43,35,4275.08,7833.23,0.00
2024-12-08 17:16:15,77,6547,42,35,4297.54,7833.52,0.00
2024-12-08 17:16:15,77,6548,42,35,4331.98,7834.00,0.00
2024-12-08 17:16:15,78,6548,43,35,4276.45,7834.01,0.00
2024-12-08 17:16:15,77,6548,43,34,4312.67,7834.14,0.00
2024-12-08 17:16:15,77,6549,43,34,4315.09,7835.00,0.00
2024-12-08 17:16:15,78,6549,43,35,4259.77,7835.01,0.00
2024-12-08 17:16:15,78,6550,43,35,4228.09,7836.00,0.00
2024-12-08 17:16:15,79,6550,43,36,4174.57,7836.01,0.00
2024-12-08 17:16:15,78,6550,43,35,4209.02,7836.14,0.00
2024-12-08 17:16:15,77,6550,42,35,4253.50,7836.14,0.00
2024-12-08 17:16:15,77,6551,42,35,4270.54,7837.00,0.00
2024-12-08 17:16:15,78,6551,43,35,4215.79,7837.01,0.00
2024-12-08 17:16:15,77,6551,42,35,4182.76,7837.70,0.00
2024-12-08 17:16:15,77,6552,42,35,4231.39,7838.00,0.00
2024-12-08 17:16:15,78,6552,43,35,4177.14,7838.01,0.00
2024-12-08 17:16:15,77,6552,42,35,4225.29,7838.09,0.00
2024-12-08 17:16:15,76,6552,42,34,4268.51,7838.13,0.00
2024-12-08 17:16:15,76,6553,42,34,4270.07,7839.00,0.00
2024-12-08 17:16:15,77,6553,43,34,4214.62,7839.01,0.00
2024-12-08 17:16:15,76,6553,42,34,4266.98,7839.04,0.00
2024-12-08 17:16:15,76,6554,42,34,4238.18,7840.00,0.00
2024-12-08 17:16:15,77,6554,42,35,4183.14,7840.01,0.00
2024-12-08 17:16:15,76,6554,41,35,4237.15,7840.01,0.00
2024-12-08 17:16:15,75,6554,40,35,4288.42,7840.08,0.00
2024-12-08 17:16:15,74,6554,40,34,4336.84,7840.10,0.00
2024-12-08 17:16:15,74,6555,40,34,4333.56,7841.00,0.00
2024-12-08 17:16:15,75,6555,40,35,4275.78,7841.01,0.00
2024-12-08 17:16:15,75,6556,40,35,4243.40,7842.00,0.00
2024-12-08 17:16:15,76,6556,40,36,4187.57,7842.01,0.00
2024-12-08 17:16:15,75,6556,40,35,4241.32,7842.03,0.00
2024-12-08 17:16:15,74,6556,40,34,4286.98,7842.08,0.00
2024-12-08 17:16:15,74,6557,40,34,4273.18,7843.00,0.00
2024-12-08 17:16:15,75,6557,40,35,4216.20,7843.01,0.00
2024-12-08 17:16:15,74,6557,40,34,4271.06,7843.03,0.00
2024-12-08 17:16:15,73,6557,39,34,4188.11,7843.89,0.00
2024-12-08 17:16:15,73,6558,39,34,4287.05,7844.00,0.00
2024-12-08 17:16:15,74,6558,40,34,4229.12,7844.01,0.00
2024-12-08 17:16:15,73,6558,40,33,4270.95,7844.08,0.00
2024-12-08 17:16:15,73,6559,40,33,4269.67,7845.00,0.00
2024-12-08 17:16:15,74,6559,41,33,4211.97,7845.01,0.00
2024-12-08 17:16:15,73,6559,40,33,4267.53,7845.03,0.00
2024-12-08 17:16:15,72,6559,39,33,4277.06,7845.17,0.00
2024-12-08 17:16:16,72,6560,39,33,4321.15,7846.00,0.00
2024-12-08 17:16:16,73,6560,39,34,4261.96,7846.01,0.00
2024-12-08 17:16:16,72,6560,38,34,4293.12,7846.08,0.00
2024-12-08 17:16:16,71,6560,37,34,4302.90,7846.45,0.00
2024-12-08 17:16:16,71,6561,37,34,4348.60,7847.00,0.00
2024-12-08 17:16:16,72,6561,38,34,4288.20,7847.01,0.00
2024-12-08 17:16:16,72,6562,38,34,4276.76,7848.00,0.00
2024-12-08 17:16:16,73,6562,39,34,4218.17,7848.01,0.00
2024-12-08 17:16:16,72,6562,39,33,4249.52,7848.08,0.00
2024-12-08 17:16:16,72,6563,39,33,4265.31,7849.00,0.00
2024-12-08 17:16:16,73,6563,39,34,4206.88,7849.01,0.00
2024-12-08 17:16:16,73,6564,39,34,4194.52,7850.00,0.00
2024-12-08 17:16:16,74,6564,39,35,4137.83,7850.01,0.00
2024-12-08 17:16:16,73,6564,39,34,4170.88,7850.12,0.00
2024-12-08 17:16:16,72,6564,38,34,4211.36,7850.13,0.00
2024-12-08 17:16:16,71,6564,37,34,4267.38,7850.17,0.00
2024-12-08 17:16:16,71,6565,37,34,4313.22,7851.00,0.00
2024-12-08 17:16:16,72,6565,37,35,4253.32,7851.01,0.00
2024-12-08 17:16:16,71,6565,36,35,4296.65,7851.08,0.00
2024-12-08 17:16:16,71,6566,36,35,4313.77,7852.00,0.00
2024-12-08 17:16:16,72,6566,36,36,4253.86,7852.01,0.00
2024-12-08 17:16:16,71,6566,36,35,4289.46,7852.11,0.00
2024-12-08 17:16:16,71,6567,36,35,4308.79,7853.00,0.00
2024-12-08 17:16:16,72,6567,36,36,4248.95,7853.01,0.00
2024-12-08 17:16:16,72,6568,36,36,4237.49,7854.00,0.00
2024-12-08 17:16:16,73,6568,37,36,4179.44,7854.01,0.00
2024-12-08 17:16:16,72,6568,36,36,4141.79,7854.71,0.00
2024-12-08 17:16:16,72,6569,36,36,4228.21,7855.00,0.00
2024-12-08 17:16:16,73,6569,37,36,4170.29,7855.01,0.00
2024-12-08 17:16:16,72,6569,37,35,4211.86,7855.11,0.00
2024-12-08 17:16:16,72,6570,37,35,4229.84,7856.00,0.00
2024-12-08 17:16:16,73,6570,38,35,4171.89,7856.01,0.00
2024-12-08 17:16:16,72,6570,37,35,4180.75,7856.14,0.00
2024-12-08 17:16:16,72,6571,37,35,4222.74,7857.00,0.00
2024-12-08 17:16:16,73,6571,38,35,4164.89,7857.01,0.00
2024-12-08 17:16:16,72,6571,37,35,4218.38,7857.07,0.00
2024-12-08 17:16:16,71,6571,37,34,4262.30,7857.10,0.00
2024-12-08 17:16:16,70,6571,36,34,4315.36,7857.19,0.00
2024-12-08 17:16:16,70,6572,36,34,4341.69,7858.00,0.00
2024-12-08 17:16:16,71,6572,37,34,4280.54,7858.01,0.00
2024-12-08 17:16:16,70,6572,36,34,4339.45,7858.03,0.00
2024-12-08 17:16:16,70,6573,36,34,4331.02,7859.00,0.00
2024-12-08 17:16:16,71,6573,37,34,4270.02,7859.01,0.00
2024-12-08 17:16:16,70,6573,37,33,4311.94,7859.09,0.00
2024-12-08 17:16:16,70,6574,37,33,4330.45,7860.00,0.00
2024-12-08 17:16:16,71,6574,38,33,4269.46,7860.01,0.00
2024-12-08 17:16:16,70,6574,37,33,4328.21,7860.03,0.00
2024-12-08 17:16:16,70,6575,37,33,4319.77,7861.00,0.00
2024-12-08 17:16:16,71,6575,38,33,4258.93,7861.01,0.00
2024-12-08 17:16:16,70,6575,38,32,4301.81,7861.07,0.00
2024-12-08 17:16:16,70,6576,38,32,4319.20,7862.00,0.00
2024-12-08 17:16:16,71,6576,38,33,4258.36,7862.01,0.00
2024-12-08 17:16:16,70,6576,37,33,4316.95,7862.04,0.00
2024-12-08 17:16:16,69,6576,36,33,4325.99,7862.15,0.00
2024-12-08 17:16:16,69,6577,36,33,4373.23,7863.00,0.00
2024-12-08 17:16:16,70,6577,37,33,4310.76,7863.01,0.00
2024-12-08 17:16:16,69,6577,37,32,4357.29,7863.06,0.00
2024-12-08 17:16:16,69,6578,37,32,4374.93,7864.00,0.00
2024-12-08 17:16:16,70,6578,38,32,4312.43,7864.01,0.00
2024-12-08 17:16:16,69,6578,37,32,4339.64,7864.17,0.00
2024-12-08 17:16:17,69,6579,37,32,4389.16,7865.00,0.00
2024-12-08 17:16:17,70,6579,37,33,4326.46,7865.01,0.00
2024-12-08 17:16:17,69,6579,37,32,4374.35,7865.06,0.00
2024-12-08 17:16:17,69,6580,37,32,4392.00,7866.00,0.00
2024-12-08 17:16:17,70,6580,38,32,4329.26,7866.01,0.00
2024-12-08 17:16:17,70,6581,38,32,4319.70,7867.00,0.00
2024-12-08 17:16:17,71,6581,39,32,4258.85,7867.01,0.00
2024-12-08 17:16:17,70,6581,39,31,4299.48,7867.09,0.00
2024-12-08 17:16:17,70,6582,39,31,4317.70,7868.00,0.00
2024-12-08 17:16:17,71,6582,40,31,4256.88,7868.01,0.00
2024-12-08 17:16:17,70,6582,39,31,4280.64,7868.19,0.00
2024-12-08 17:16:17,70,6583,39,31,4306.25,7869.00,0.00
2024-12-08 17:16:17,71,6583,40,31,4245.59,7869.01,0.00
2024-12-08 17:16:17,70,6583,40,30,4287.14,7869.09,0.00
2024-12-08 17:16:17,70,6584,40,30,4304.63,7870.00,0.00
2024-12-08 17:16:17,71,6584,41,30,4244.01,7870.01,0.00
2024-12-08 17:16:17,70,6584,40,30,4259.04,7870.30,0.00
2024-12-08 17:16:17,70,6585,40,30,4293.34,7871.00,0.00
2024-12-08 17:16:17,71,6585,41,30,4232.87,7871.01,0.00
2024-12-08 17:16:17,70,6585,40,30,4291.09,7871.03,0.00
2024-12-08 17:16:17,69,6585,40,29,4336.17,7871.07,0.00
2024-12-08 17:16:17,69,6586,40,29,4354.97,7872.00,0.00
2024-12-08 17:16:17,70,6586,41,29,4292.76,7872.01,0.00
2024-12-08 17:16:17,70,6587,41,29,4272.94,7873.00,0.00
2024-12-08 17:16:17,71,6587,41,30,4212.76,7873.01,0.00
2024-12-08 17:16:17,70,6587,41,29,4257.20,7873.07,0.00
2024-12-08 17:16:17,70,6588,41,29,4256.47,7874.00,0.00
2024-12-08 17:16:17,71,6588,42,29,4196.52,7874.01,0.00
2024-12-08 17:16:17,70,6588,41,29,4197.17,7874.23,0.00
2024-12-08 17:16:17,69,6588,40,29,4242.10,7874.44,0.00
2024-12-08 17:16:17,69,6589,40,29,4289.29,7875.00,0.00
2024-12-08 17:16:17,70,6589,40,30,4228.02,7875.01,0.00
2024-12-08 17:16:17,69,6589,40,29,4275.60,7875.07,0.00
2024-12-08 17:16:17,69,6590,40,29,4294.40,7876.00,0.00
2024-12-08 17:16:17,70,6590,41,29,4233.06,7876.01,0.00
2024-12-08 17:16:17,69,6590,40,29,4292.12,7876.04,0.00
2024-12-08 17:16:17,69,6591,40,29,4285.82,7877.00,0.00
2024-12-08 17:16:17,70,6591,41,29,4224.59,7877.01,0.00
2024-12-08 17:16:17,69,6591,41,28,4269.84,7877.07,0.00
2024-12-08 17:16:17,69,6592,41,28,4288.64,7878.00,0.00
2024-12-08 17:16:17,70,6592,42,28,4227.38,7878.01,0.00
2024-12-08 17:16:17,70,6593,42,28,4217.78,7879.00,0.00
2024-12-08 17:16:17,71,6593,42,29,4158.38,7879.01,0.00
2024-12-08 17:16:17,70,6593,42,28,4203.16,7879.07,0.00
2024-12-08 17:16:17,70,6594,42,28,4220.57,7880.00,0.00
2024-12-08 17:16:17,71,6594,42,29,4161.13,7880.01,0.00
2024-12-08 17:16:17,70,6594,41,29,4219.45,7880.01,0.00
2024-12-08 17:16:17,69,6594,40,29,4187.23,7880.67,0.00
2024-12-08 17:16:17,69,6595,40,29,4275.43,7881.00,0.00
2024-12-08 17:16:17,70,6595,40,30,4214.35,7881.01,0.00
2024-12-08 17:16:17,69,6595,40,29,4257.17,7881.09,0.00
2024-12-08 17:16:17,69,6596,40,29,4275.23,7882.00,0.00
2024-12-08 17:16:17,70,6596,41,29,4214.16,7882.01,0.00
2024-12-08 17:16:17,69,6596,40,29,4274.09,7882.02,0.00
2024-12-08 17:16:17,69,6597,40,29,4260.82,7883.00,0.00
2024-12-08 17:16:17,70,6597,40,30,4199.95,7883.01,0.00
2024-12-08 17:16:17,69,6597,40,29,4244.84,7883.07,0.00
2024-12-08 17:16:18,69,6598,40,29,4259.08,7884.00,0.00
2024-12-08 17:16:18,70,6598,40,30,4198.24,7884.01,0.00
2024-12-08 17:16:18,69,6598,39,30,4221.42,7884.19,0.00
2024-12-08 17:16:18,69,6599,39,30,4245.06,7885.00,0.00
2024-12-08 17:16:18,70,6599,39,31,4184.42,7885.01,0.00
2024-12-08 17:16:18,69,6599,39,30,4230.21,7885.07,0.00
2024-12-08 17:16:18,70,6598,40,30,4114.75,7885.51,0.00
2024-12-08 17:16:18,70,6599,40,30,4226.86,7886.00,0.00
2024-12-08 17:16:18,71,6599,41,30,4167.33,7886.01,0.00
2024-12-08 17:16:18,71,6600,41,30,4265.80,7887.00,0.00
2024-12-08 17:16:18,72,6600,41,31,4206.55,7887.01,0.00
2024-12-08 17:16:18,71,6600,41,30,4251.36,7887.07,0.00
2024-12-08 17:16:18,70,6600,40,30,4279.57,7887.46,0.00
2024-12-08 17:16:18,70,6601,40,30,4346.99,7888.00,0.00
2024-12-08 17:16:18,71,6601,41,30,4285.77,7888.01,0.00
2024-12-08 17:16:18,71,6602,41,30,4272.45,7889.00,0.00
2024-12-08 17:16:18,72,6602,41,31,4213.11,7889.01,0.00
2024-12-08 17:16:18,71,6602,41,30,4259.12,7889.07,0.00
2024-12-08 17:16:18,70,6602,40,30,4309.86,7889.20,0.00
2024-12-08 17:16:18,70,6603,40,30,4335.02,7890.00,0.00
2024-12-08 17:16:18,71,6603,40,31,4273.96,7890.01,0.00
2024-12-08 17:16:18,70,6603,39,31,4330.52,7890.06,0.00
2024-12-08 17:16:18,70,6604,39,31,4322.69,7891.00,0.00
2024-12-08 17:16:18,71,6604,40,31,4261.80,7891.01,0.00
2024-12-08 17:16:18,70,6604,40,30,4311.42,7891.06,0.00
2024-12-08 17:16:18,70,6605,40,30,4327.43,7892.00,0.00
2024-12-08 17:16:18,71,6605,40,31,4266.48,7892.01,0.00
2024-12-08 17:16:18,71,6606,40,31,4255.90,7893.00,0.00
2024-12-08 17:16:18,72,6606,41,31,4196.80,7893.01,0.00
2024-12-08 17:16:18,71,6606,41,30,4244.79,7893.06,0.00
2024-12-08 17:16:18,70,6606,40,30,4281.81,7893.26,0.00
2024-12-08 17:16:18,70,6607,40,30,4336.42,7894.00,0.00
2024-12-08 17:16:18,71,6607,41,30,4275.35,7894.01,0.00
2024-12-08 17:16:18,71,6608,41,30,4263.92,7895.00,0.00
2024-12-08 17:16:18,72,6608,41,31,4204.70,7895.01,0.00
2024-12-08 17:16:18,71,6608,41,30,4250.58,7895.07,0.00
2024-12-08 17:16:18,71,6609,41,30,4262.88,7896.00,0.00
2024-12-08 17:16:18,72,6609,42,30,4203.67,7896.01,0.00
2024-12-08 17:16:18,71,6609,41,30,4261.77,7896.01,0.00
2024-12-08 17:16:18,70,6609,40,30,4273.04,7896.14,0.00
2024-12-08 17:16:18,70,6609,40,30,4312.95,7897.00,0.00
2024-12-08 17:16:18,71,6609,40,31,4252.20,7897.01,0.00
2024-12-08 17:16:18,70,6609,40,30,4298.29,7897.07,0.00
2024-12-08 17:16:18,71,6608,41,30,4215.61,7897.38,0.00
2024-12-08 17:16:18,71,6609,41,30,4318.88,7898.00,0.00
2024-12-08 17:16:18,72,6609,42,30,4258.90,7898.01,0.00
2024-12-08 17:16:18,72,6610,42,30,4353.82,7899.00,0.00
2024-12-08 17:16:18,73,6610,43,30,4294.18,7899.01,0.00
2024-12-08 17:16:18,72,6610,43,29,4338.46,7899.08,0.00
2024-12-08 17:16:19,72,6611,43,29,4354.37,7900.00,0.00
2024-12-08 17:16:19,73,6611,44,29,4294.72,7900.01,0.00
2024-12-08 17:16:19,73,6612,44,29,4282.28,7901.00,0.00
2024-12-08 17:16:19,74,6612,45,29,4224.41,7901.01,0.00
2024-12-08 17:16:19,73,6612,44,29,4280.11,7901.04,0.00
2024-12-08 17:16:19,72,6612,44,28,4326.40,7901.08,0.00
2024-12-08 17:16:19,72,6613,44,28,4342.30,7902.00,0.00
2024-12-08 17:16:19,73,6613,44,29,4282.82,7902.01,0.00
2024-12-08 17:16:19,73,6614,44,29,4270.37,7903.00,0.00
2024-12-08 17:16:19,74,6614,44,30,4212.66,7903.01,0.00
2024-12-08 17:16:19,73,6614,44,29,4249.81,7903.10,0.00
2024-12-08 17:16:19,73,6615,44,29,4265.50,7904.00,0.00
2024-12-08 17:16:19,74,6615,44,30,4207.85,7904.01,0.00
2024-12-08 17:16:19,73,6615,43,30,4264.41,7904.01,0.00
2024-12-08 17:16:19,72,6615,42,30,4322.54,7904.03,0.00
2024-12-08 17:16:19,71,6615,41,30,4331.24,7904.41,0.00
2024-12-08 17:16:19,70,6615,40,30,4351.49,7904.67,0.00
2024-12-08 17:16:19,70,6616,40,30,4438.70,7905.00,0.00
2024-12-08 17:16:19,71,6616,41,30,4376.19,7905.01,0.00
2024-12-08 17:16:19,70,6616,40,30,4435.32,7905.03,0.00
2024-12-08 17:16:19,69,6616,40,29,4483.56,7905.06,0.00
2024-12-08 17:16:19,69,6617,40,29,4524.23,7906.00,0.00
2024-12-08 17:16:19,70,6617,40,30,4459.59,7906.01,0.00
2024-12-08 17:16:19,69,6617,39,30,4489.89,7906.16,0.00
2024-12-08 17:16:19,69,6618,39,30,4515.63,7907.00,0.00
2024-12-08 17:16:19,70,6618,39,31,4451.12,7907.01,0.00
2024-12-08 17:16:19,69,6618,39,30,4493.87,7907.09,0.00
2024-12-08 17:16:19,69,6619,39,30,4513.91,7908.00,0.00
2024-12-08 17:16:19,70,6619,40,30,4449.42,7908.01,0.00
2024-12-08 17:16:19,70,6620,40,30,4439.39,7909.00,0.00
2024-12-08 17:16:19,71,6620,41,30,4376.87,7909.01,0.00
2024-12-08 17:16:19,70,6620,40,30,4438.26,7909.01,0.00
2024-12-08 17:16:19,69,6620,40,29,4483.11,7909.07,0.00
2024-12-08 17:16:19,69,6621,40,29,4500.54,7910.00,0.00
2024-12-08 17:16:19,70,6621,41,29,4436.25,7910.01,0.00
2024-12-08 17:16:19,70,6622,41,29,4424.43,7911.00,0.00
2024-12-08 17:16:19,71,6622,42,29,4362.12,7911.01,0.00
2024-12-08 17:16:19,70,6622,42,28,4406.36,7911.07,0.00
2024-12-08 17:16:19,70,6623,42,28,4421.14,7912.00,0.00
2024-12-08 17:16:19,71,6623,42,29,4358.87,7912.01,0.00
2024-12-08 17:16:19,71,6624,42,29,4344.91,7913.00,0.00
2024-12-08 17:16:19,72,6624,42,30,4284.57,7913.01,0.00
2024-12-08 17:16:19,71,6624,41,30,4343.80,7913.03,0.00
2024-12-08 17:16:19,70,6624,41,29,4391.16,7913.06,0.00
2024-12-08 17:16:19,69,6624,40,29,4441.04,7913.06,0.00
2024-12-08 17:16:19,69,6625,40,29,4479.09,7914.00,0.00
2024-12-08 17:16:19,70,6625,41,29,4415.10,7914.01,0.00
2024-12-08 17:16:19,69,6625,40,29,4463.03,7914.02,0.00
2024-12-08 17:16:19,69,6626,40,29,4475.85,7915.00,0.00
2024-12-08 17:16:19,70,6626,40,30,4411.91,7915.01,0.00
2024-12-08 17:16:19,69,6626,40,29,4459.80,7915.04,0.00
2024-12-08 17:16:19,69,6627,40,29,4474.19,7916.00,0.00
2024-12-08 17:16:19,70,6627,40,30,4410.28,7916.01,0.00
2024-12-08 17:16:19,70,6628,40,30,4397.26,7917.00,0.00
2024-12-08 17:16:19,71,6628,40,31,4335.33,7917.01,0.00
2024-12-08 17:16:19,70,6628,39,31,4343.11,7917.41,0.00
2024-12-08 17:16:19,70,6629,39,31,4384.00,7918.00,0.00
2024-12-08 17:16:19,71,6629,40,31,4322.26,7918.01,0.00
2024-12-08 17:16:19,70,6629,39,31,4384.00,7918.01,0.00
2024-12-08 17:16:19,70,6630,39,31,4370.92,7919.00,0.00
2024-12-08 17:16:19,71,6630,40,31,4309.35,7919.01,0.00
2024-12-08 17:16:19,70,6630,40,30,4360.74,7919.04,0.00
2024-12-08 17:16:19,69,6630,39,30,4415.94,7919.15,0.00
2024-12-08 17:16:20,69,6631,39,30,4437.82,7920.00,0.00
2024-12-08 17:16:20,70,6631,39,31,4374.42,7920.01,0.00
2024-12-08 17:16:20,70,6632,39,31,4362.61,7921.00,0.00
2024-12-08 17:16:20,71,6632,39,32,4301.16,7921.01,0.00
2024-12-08 17:16:20,70,6632,39,31,4349.03,7921.04,0.00
2024-12-08 17:16:20,70,6633,39,31,4362.01,7922.00,0.00
2024-12-08 17:16:20,71,6633,40,31,4300.58,7922.01,0.00
2024-12-08 17:16:20,71,6634,40,31,4282.31,7923.00,0.00
2024-12-08 17:16:20,72,6634,40,32,4222.83,7923.01,0.00
2024-12-08 17:16:20,71,6634,40,31,4270.04,7923.04,0.00
2024-12-08 17:16:20,71,6635,40,31,4262.62,7924.00,0.00
2024-12-08 17:16:20,72,6635,40,32,4203.42,7924.01,0.00
2024-12-08 17:16:20,71,6635,39,32,4213.59,7924.31,0.00
2024-12-08 17:16:20,71,6636,39,32,4209.78,7925.00,0.00
2024-12-08 17:16:20,72,6636,40,32,4151.31,7925.01,0.00
2024-12-08 17:16:20,71,6636,39,32,4166.31,7925.08,0.00
2024-12-08 17:16:20,70,6636,38,32,4197.67,7925.43,0.00
2024-12-08 17:16:20,70,6637,38,32,4154.15,7926.00,0.00
2024-12-08 17:16:20,71,6637,39,32,4095.64,7926.01,0.00
2024-12-08 17:16:20,70,6637,39,31,4132.36,7926.04,0.00
2024-12-08 17:16:20,69,6637,39,30,4072.68,7926.87,0.00
2024-12-08 17:16:20,68,6637,38,30,4117.84,7926.91,0.00
2024-12-08 17:16:20,68,6638,38,30,4160.38,7927.00,0.00
2024-12-08 17:16:20,69,6638,39,30,4100.08,7927.02,0.00
2024-12-08 17:16:20,68,6638,38,30,4158.05,7927.03,0.00
2024-12-08 17:16:20,67,6638,38,29,4100.05,7927.91,0.00
2024-12-08 17:16:20,67,6639,38,29,4187.68,7928.00,0.00
2024-12-08 17:16:20,68,6639,38,30,4126.10,7928.02,0.00
2024-12-08 17:16:20,67,6639,38,29,4179.40,7928.03,0.00
2024-12-08 17:16:20,68,6638,39,29,4117.94,7928.06,0.00
2024-12-08 17:16:20,68,6639,39,29,4242.55,7929.00,0.00
2024-12-08 17:16:20,69,6639,40,29,4181.07,7929.02,0.00
2024-12-08 17:16:20,69,6640,40,29,4277.99,7930.00,0.00
2024-12-08 17:16:20,70,6640,40,30,4216.87,7930.01,0.00
2024-12-08 17:16:20,69,6640,40,29,4256.18,7930.10,0.00
2024-12-08 17:16:20,69,6641,40,29,4251.82,7931.00,0.00
2024-12-08 17:16:20,70,6641,40,30,4191.08,7931.01,0.00
2024-12-08 17:16:20,69,6641,39,30,4196.69,7931.16,0.00
2024-12-08 17:16:20,69,6642,39,30,4198.76,7932.00,0.00
2024-12-08 17:16:20,70,6642,39,31,4138.77,7932.01,0.00
2024-12-08 17:16:20,69,6642,39,30,4174.64,7932.12,0.00
2024-12-08 17:16:20,68,6642,39,29,4111.46,7932.84,0.00
2024-12-08 17:16:20,68,6643,39,29,4214.61,7933.00,0.00
2024-12-08 17:16:20,69,6643,39,30,4153.53,7933.02,0.00
2024-12-08 17:16:20,68,6643,38,30,4194.68,7933.19,0.00
2024-12-08 17:16:20,68,6644,38,30,4222.30,7934.00,0.00
2024-12-08 17:16:20,69,6644,38,31,4161.11,7934.02,0.00
2024-12-08 17:16:20,68,6644,38,30,4185.02,7934.19,0.00
2024-12-08 17:16:20,68,6645,38,30,4209.88,7935.00,0.00
2024-12-08 17:16:20,69,6645,39,30,4148.87,7935.02,0.00
2024-12-08 17:16:20,69,6646,39,30,4123.33,7936.00,0.00
2024-12-08 17:16:20,70,6646,40,30,4064.43,7936.01,0.00
2024-12-08 17:16:20,69,6646,40,29,4088.18,7936.19,0.00
2024-12-08 17:16:20,69,6647,40,29,4074.23,7937.00,0.00
2024-12-08 17:16:20,70,6647,40,30,4016.02,7937.01,0.00
2024-12-08 17:16:20,69,6647,39,30,4070.79,7937.04,0.00
2024-12-08 17:16:20,68,6647,38,30,4049.55,7937.47,0.00
2024-12-08 17:16:20,69,6646,39,30,3949.69,7937.88,0.00
2024-12-08 17:16:20,69,6647,39,30,4046.55,7938.00,0.00
2024-12-08 17:16:20,70,6647,40,30,3988.74,7938.01,0.00
2024-12-08 17:16:20,69,6647,39,30,4045.40,7938.02,0.00
2024-12-08 17:16:20,68,6647,38,30,3921.62,7938.85,0.00
2024-12-08 17:16:20,68,6648,38,30,4082.58,7939.00,0.00
2024-12-08 17:16:20,69,6648,39,30,4023.41,7939.02,0.00
2024-12-08 17:16:20,68,6648,39,29,4067.45,7939.19,0.00
2024-12-08 17:16:21,68,6649,39,29,4029.36,7940.00,0.00
2024-12-08 17:16:21,69,6649,40,29,3970.97,7940.02,0.00
2024-12-08 17:16:21,70,6648,41,29,3844.00,7940.36,0.00
2024-12-08 17:16:21,71,6647,41,30,3820.22,7940.68,0.00
2024-12-08 17:16:21,70,6647,40,30,3865.31,7940.97,0.00
2024-12-08 17:16:21,70,6648,40,30,3976.49,7941.00,0.00
2024-12-08 17:16:21,71,6648,41,30,3920.48,7941.01,0.00
2024-12-08 17:16:21,70,6648,40,30,3971.97,7941.06,0.00
2024-12-08 17:16:21,69,6648,40,29,3997.33,7941.17,0.00
2024-12-08 17:16:21,69,6649,40,29,4240.00,7942.00,0.00
2024-12-08 17:16:21,70,6649,41,29,4179.43,7942.01,0.00
2024-12-08 17:16:21,69,6649,40,29,4218.14,7942.03,0.00
2024-12-08 17:16:21,69,6650,40,29,4216.10,7943.00,0.00
2024-12-08 17:16:21,70,6650,40,30,4155.87,7943.01,0.00
2024-12-08 17:16:21,69,6650,40,29,4182.75,7943.16,0.00
2024-12-08 17:16:21,68,6650,40,28,4201.21,7943.71,0.00
2024-12-08 17:16:21,68,6651,40,28,4265.64,7944.00,0.00
2024-12-08 17:16:21,69,6651,40,29,4203.82,7944.02,0.00
2024-12-08 17:16:21,69,6652,40,29,4187.12,7945.00,0.00
2024-12-08 17:16:21,70,6652,41,29,4127.30,7945.01,0.00
2024-12-08 17:16:21,69,6652,40,29,4184.83,7945.04,0.00
2024-12-08 17:16:21,68,6652,40,28,4216.01,7945.15,0.00
2024-12-08 17:16:21,68,6653,40,28,4234.35,7946.00,0.00
2024-12-08 17:16:21,69,6653,41,28,4172.99,7946.02,0.00
2024-12-08 17:16:21,70,6652,42,28,4113.37,7946.04,0.00
2024-12-08 17:16:21,69,6652,41,28,4190.28,7946.06,0.00
2024-12-08 17:16:21,69,6653,41,28,4177.69,7947.00,0.00
2024-12-08 17:16:21,70,6653,42,28,4118.01,7947.01,0.00
2024-12-08 17:16:21,69,6653,42,27,4147.78,7947.13,0.00
2024-12-08 17:16:21,68,6653,41,27,4207.61,7947.15,0.00
2024-12-08 17:16:21,68,6654,41,27,4345.82,7948.00,0.00
2024-12-08 17:16:21,69,6654,41,28,4282.83,7948.02,0.00
2024-12-08 17:16:21,69,6655,41,28,4271.15,7949.00,0.00
2024-12-08 17:16:21,70,6655,42,28,4210.13,7949.01,0.00
2024-12-08 17:16:21,69,6655,41,28,4266.56,7949.06,0.00
2024-12-08 17:16:21,68,6655,41,27,4304.76,7949.12,0.00
2024-12-08 17:16:21,67,6655,40,27,4367.83,7949.13,0.00
2024-12-08 17:16:21,66,6655,39,27,4390.51,7949.56,0.00
2024-12-08 17:16:21,66,6656,39,27,4452.27,7950.00,0.00
2024-12-08 17:16:21,67,6656,40,27,4385.82,7950.02,0.00
2024-12-08 17:16:21,67,6657,40,27,4379.25,7951.00,0.00
2024-12-08 17:16:21,68,6657,41,27,4314.85,7951.02,0.00
2024-12-08 17:16:21,67,6657,40,27,4373.34,7951.08,0.00
2024-12-08 17:16:21,66,6657,40,26,4416.71,7951.11,0.00
2024-12-08 17:16:21,66,6658,40,26,4442.55,7952.00,0.00
2024-12-08 17:16:21,67,6658,40,27,4376.24,7952.02,0.00
2024-12-08 17:16:21,67,6659,40,27,4369.67,7953.00,0.00
2024-12-08 17:16:21,68,6659,40,28,4305.41,7953.02,0.00
2024-12-08 17:16:21,67,6659,40,27,4342.39,7953.10,0.00
2024-12-08 17:16:21,67,6660,40,27,4366.66,7954.00,0.00
2024-12-08 17:16:21,68,6660,41,27,4302.44,7954.02,0.00
2024-12-08 17:16:21,68,6661,41,27,4294.79,7955.00,0.00
2024-12-08 17:16:21,69,6661,41,28,4232.55,7955.02,0.00
2024-12-08 17:16:21,68,6661,41,27,4269.08,7955.10,0.00
2024-12-08 17:16:21,67,6661,40,27,4329.25,7955.15,0.00
2024-12-08 17:16:21,67,6662,40,27,4357.07,7956.00,0.00
2024-12-08 17:16:21,68,6662,41,27,4292.99,7956.02,0.00
2024-12-08 17:16:21,68,6663,41,27,4285.34,7957.00,0.00
2024-12-08 17:16:21,69,6663,41,28,4223.23,7957.02,0.00
2024-12-08 17:16:21,68,6663,40,28,4279.51,7957.07,0.00
2024-12-08 17:16:21,67,6663,40,27,4322.02,7957.10,0.00
2024-12-08 17:16:21,68,6662,40,28,4210.77,7957.74,0.00
2024-12-08 17:16:22,68,6663,40,28,4325.67,7958.00,0.00
2024-12-08 17:16:22,69,6663,41,28,4262.98,7958.02,0.00
2024-12-08 17:16:22,68,6663,40,28,4273.08,7958.27,0.00
2024-12-08 17:16:22,68,6664,40,28,4449.11,7959.00,0.00
2024-12-08 17:16:22,69,6664,40,29,4384.63,7959.02,0.00
2024-12-08 17:16:22,68,6664,40,28,4421.05,7959.12,0.00
2024-12-08 17:16:22,68,6665,40,28,4444.99,7960.00,0.00
2024-12-08 17:16:22,69,6665,40,29,4380.57,7960.02,0.00
2024-12-08 17:16:22,68,6665,39,29,4442.66,7960.03,0.00
2024-12-08 17:16:22,68,6666,39,29,4436.18,7961.00,0.00
2024-12-08 17:16:22,69,6666,40,29,4371.89,7961.02,0.00
2024-12-08 17:16:22,68,6666,40,28,4408.11,7961.12,0.00
2024-12-08 17:16:22,68,6667,40,28,4432.05,7962.00,0.00
2024-12-08 17:16:22,69,6667,40,29,4367.82,7962.02,0.00
2024-12-08 17:16:22,68,6667,39,29,4420.38,7962.16,0.00
2024-12-08 17:16:22,68,6668,39,29,4424.41,7963.00,0.00
2024-12-08 17:16:22,69,6668,39,30,4360.29,7963.02,0.00
2024-12-08 17:16:22,68,6668,39,29,4389.32,7963.16,0.00
2024-12-08 17:16:22,68,6669,39,29,4416.77,7964.00,0.00
2024-12-08 17:16:22,69,6669,39,30,4352.76,7964.02,0.00
2024-12-08 17:16:22,69,6670,39,30,4344.07,7965.00,0.00
2024-12-08 17:16:22,70,6670,39,31,4282.01,7965.01,0.00
2024-12-08 17:16:22,69,6670,39,30,4310.62,7965.16,0.00
2024-12-08 17:16:22,68,6670,38,30,4330.96,7965.69,0.00
2024-12-08 17:16:22,68,6671,38,30,4400.31,7966.00,0.00
2024-12-08 17:16:22,69,6671,39,30,4336.53,7966.02,0.00
2024-12-08 17:16:22,68,6671,38,30,4376.90,7966.12,0.00
2024-12-08 17:16:22,68,6672,38,30,4400.86,7967.00,0.00
2024-12-08 17:16:22,69,6672,39,30,4337.08,7967.02,0.00
2024-12-08 17:16:22,68,6672,38,30,4398.53,7967.03,0.00
2024-12-08 17:16:22,67,6672,38,29,4434.46,7967.13,0.00
2024-12-08 17:16:22,66,6672,37,29,4485.70,7967.33,0.00
2024-12-08 17:16:22,65,6672,36,29,4554.71,7967.34,0.00
2024-12-08 17:16:22,65,6673,36,29,4593.72,7968.00,0.00
2024-12-08 17:16:22,66,6673,36,30,4524.11,7968.02,0.00
2024-12-08 17:16:22,65,6673,35,30,4576.58,7968.09,0.00
2024-12-08 17:16:22,65,6674,35,30,4584.76,7969.00,0.00
2024-12-08 17:16:22,66,6674,35,31,4515.29,7969.02,0.00
2024-12-08 17:16:22,65,6674,34,31,4562.72,7969.11,0.00
2024-12-08 17:16:22,64,6674,34,30,4611.60,7969.11,0.00
2024-12-08 17:16:22,64,6675,34,30,4636.65,7970.00,0.00
2024-12-08 17:16:22,65,6675,34,31,4565.32,7970.02,0.00
2024-12-08 17:16:22,64,6675,33,31,4634.17,7970.03,0.00
2024-12-08 17:16:22,63,6675,32,31,4691.29,7970.08,0.00
2024-12-08 17:16:22,62,6675,31,31,4738.68,7970.11,0.00
2024-12-08 17:16:22,61,6675,30,31,4761.22,7970.66,0.00
2024-12-08 17:16:22,61,6676,30,31,4864.73,7971.00,0.00
2024-12-08 17:16:22,62,6676,31,31,4786.27,7971.02,0.00
2024-12-08 17:16:22,61,6676,31,30,4837.31,7971.08,0.00
2024-12-08 17:16:22,61,6677,31,30,4863.25,7972.00,0.00
2024-12-08 17:16:22,62,6677,32,30,4784.82,7972.02,0.00
2024-12-08 17:16:22,62,6678,32,30,4781.40,7973.00,0.00
2024-12-08 17:16:22,63,6678,33,30,4705.51,7973.02,0.00
2024-12-08 17:16:22,62,6678,32,30,4776.28,7973.06,0.00
2024-12-08 17:16:22,61,6678,32,29,4824.53,7973.12,0.00
2024-12-08 17:16:22,61,6679,32,29,4859.09,7974.00,0.00
2024-12-08 17:16:22,62,6679,32,30,4780.72,7974.02,0.00
2024-12-08 17:16:22,61,6679,31,30,4774.37,7974.54,0.00
2024-12-08 17:16:22,61,6680,31,30,4868.85,7975.00,0.00
2024-12-08 17:16:22,62,6680,31,31,4790.32,7975.02,0.00
2024-12-08 17:16:22,61,6680,31,30,4830.98,7975.15,0.00
2024-12-08 17:16:22,61,6681,31,30,4868.15,7976.00,0.00
2024-12-08 17:16:22,62,6681,31,31,4789.63,7976.02,0.00
2024-12-08 17:16:22,62,6682,31,31,4786.37,7977.00,0.00
2024-12-08 17:16:23,63,6682,32,31,4710.40,7977.02,0.00
2024-12-08 17:16:23,62,6682,31,31,4767.12,7977.16,0.00
2024-12-08 17:16:23,62,6683,31,31,4786.58,7978.00,0.00
2024-12-08 17:16:23,63,6683,31,32,4710.60,7978.02,0.00
2024-12-08 17:16:23,62,6683,30,32,4784.02,7978.03,0.00
2024-12-08 17:16:23,62,6684,30,32,4748.39,7979.00,0.00
2024-12-08 17:16:23,63,6684,31,32,4673.02,7979.02,0.00
2024-12-08 17:16:23,62,6684,31,31,4630.41,7979.45,0.00
2024-12-08 17:16:23,62,6685,31,31,4710.39,7980.00,0.00
2024-12-08 17:16:23,63,6685,31,32,4635.62,7980.02,0.00
2024-12-08 17:16:23,62,6685,30,32,4707.82,7980.03,0.00
2024-12-08 17:16:23,61,6685,30,31,4753.61,7980.08,0.00
2024-12-08 17:16:23,61,6686,30,31,4801.36,7981.00,0.00
2024-12-08 17:16:23,62,6686,30,32,4723.92,7981.02,0.00
2024-12-08 17:16:23,61,6686,30,31,4789.61,7981.12,0.00
2024-12-08 17:16:23,61,6687,30,31,4813.58,7982.00,0.00
2024-12-08 17:16:23,62,6687,31,31,4735.94,7982.02,0.00
2024-12-08 17:16:23,61,6687,30,31,4784.29,7982.15,0.00
2024-12-08 17:16:23,61,6688,30,31,4821.49,7983.00,0.00
2024-12-08 17:16:23,62,6688,30,32,4743.73,7983.02,0.00
2024-12-08 17:16:23,62,6689,30,32,4734.50,7984.00,0.00
2024-12-08 17:16:23,63,6689,31,32,4659.35,7984.02,0.00
2024-12-08 17:16:23,62,6689,31,31,4711.53,7984.15,0.00
2024-12-08 17:16:23,63,6688,32,31,4548.06,7984.95,0.00
2024-12-08 17:16:23,63,6689,32,31,4674.85,7985.00,0.00
2024-12-08 17:16:23,64,6689,32,32,4601.81,7985.02,0.00
2024-12-08 17:16:23,65,6688,32,33,4526.11,7985.11,0.00
2024-12-08 17:16:23,65,6689,32,33,4759.44,7986.00,0.00
2024-12-08 17:16:23,66,6689,33,33,4687.33,7986.02,0.00
2024-12-08 17:16:23,66,6690,33,33,4799.05,7987.00,0.00
2024-12-08 17:16:23,67,6690,34,33,4727.43,7987.02,0.00
2024-12-08 17:16:23,66,6690,34,32,4778.52,7987.14,0.00
2024-12-08 17:16:23,67,6689,34,33,4695.34,7987.31,0.00
2024-12-08 17:16:23,67,6690,34,33,4788.85,7988.00,0.00
2024-12-08 17:16:23,68,6690,35,33,4718.43,7988.02,0.00
2024-12-08 17:16:23,67,6690,34,33,4731.88,7988.36,0.00
2024-12-08 17:16:23,66,6690,33,33,4742.07,7988.88,0.00
2024-12-08 17:16:23,66,6691,33,33,4974.57,7989.00,0.00
2024-12-08 17:16:23,67,6691,34,33,4900.32,7989.02,0.00
2024-12-08 17:16:23,66,6691,33,33,4973.37,7989.03,0.00
2024-12-08 17:16:23,65,6691,33,32,5037.87,7989.11,0.00
2024-12-08 17:16:23,65,6692,33,32,5038.68,7990.00,0.00
2024-12-08 17:16:23,66,6692,33,33,4962.34,7990.02,0.00
2024-12-08 17:16:23,65,6692,33,32,5027.65,7990.11,0.00
2024-12-08 17:16:23,65,6693,33,32,5055.27,7991.00,0.00
2024-12-08 17:16:23,66,6693,34,32,4978.67,7991.02,0.00
2024-12-08 17:16:23,65,6693,33,32,5054.04,7991.03,0.00
2024-12-08 17:16:23,65,6694,33,32,5050.98,7992.00,0.00
2024-12-08 17:16:23,66,6694,33,33,4974.45,7992.02,0.00
2024-12-08 17:16:23,66,6695,33,33,4969.02,7993.00,0.00
2024-12-08 17:16:23,67,6695,33,34,4894.85,7993.02,0.00
2024-12-08 17:16:23,66,6695,33,33,4961.78,7993.09,0.00
2024-12-08 17:16:23,66,6696,33,33,4986.60,7994.00,0.00
2024-12-08 17:16:23,67,6696,34,33,4912.17,7994.02,0.00
2024-12-08 17:16:23,67,6697,34,33,4905.62,7995.00,0.00
2024-12-08 17:16:23,68,6697,35,33,4833.48,7995.02,0.00
2024-12-08 17:16:23,67,6697,35,32,4888.05,7995.09,0.00
2024-12-08 17:16:23,67,6698,35,32,4911.31,7996.00,0.00
2024-12-08 17:16:23,68,6698,35,33,4839.09,7996.02,0.00
2024-12-08 17:16:23,68,6699,35,33,4831.46,7997.00,0.00
2024-12-08 17:16:23,69,6699,36,33,4761.44,7997.02,0.00
2024-12-08 17:16:23,68,6699,36,32,4798.56,7997.12,0.00
2024-12-08 17:16:23,67,6699,35,32,4841.55,7997.16,0.00
2024-12-08 17:16:24,67,6700,35,32,4894.64,7998.00,0.00
2024-12-08 17:16:24,68,6700,36,32,4822.66,7998.02,0.00
2024-12-08 17:16:24,68,6701,36,32,4815.02,7999.00,0.00
2024-12-08 17:16:24,69,6701,36,33,4745.24,7999.02,0.00
2024-12-08 17:16:24,68,6701,35,33,4804.47,7999.13,0.00
2024-12-08 17:16:24,68,6702,35,33,4806.21,8000.00,0.00
2024-12-08 17:16:24,69,6702,35,34,4736.56,8000.02,0.00
2024-12-08 17:16:24,69,6703,35,34,4727.87,8001.00,0.00
2024-12-08 17:16:24,70,6703,35,35,4660.33,8001.01,0.00
2024-12-08 17:16:24,69,6703,35,34,4704.70,8001.06,0.00
2024-12-08 17:16:24,69,6704,35,34,4722.67,8002.00,0.00
2024-12-08 17:16:24,70,6704,35,35,4655.20,8002.01,0.00
2024-12-08 17:16:24,69,6704,34,35,4627.86,8002.65,0.00
2024-12-08 17:16:24,69,6705,34,35,4716.05,8003.00,0.00
2024-12-08 17:16:24,70,6705,35,35,4648.68,8003.01,0.00
2024-12-08 17:16:24,69,6705,35,34,4701.00,8003.13,0.00
2024-12-08 17:16:24,68,6705,34,34,4768.96,8003.15,0.00
2024-12-08 17:16:24,68,6706,34,34,4795.04,8004.00,0.00
2024-12-08 17:16:24,69,6706,35,34,4725.55,8004.02,0.00
2024-12-08 17:16:24,68,6706,34,34,4722.19,8004.37,0.00
2024-12-08 17:16:24,68,6707,34,34,4789.03,8005.00,0.00
2024-12-08 17:16:24,69,6707,34,35,4719.62,8005.02,0.00
2024-12-08 17:16:24,68,6707,34,34,4754.92,8005.15,0.00
2024-12-08 17:16:24,68,6708,34,34,4780.25,8006.00,0.00
2024-12-08 17:16:24,69,6708,35,34,4710.97,8006.02,0.00
2024-12-08 17:16:24,69,6709,35,34,4700.70,8007.00,0.00
2024-12-08 17:16:24,70,6709,36,34,4633.54,8007.01,0.00
2024-12-08 17:16:24,70,6710,36,34,4621.81,8008.00,0.00
2024-12-08 17:16:24,71,6710,36,35,4556.71,8008.01,0.00
2024-12-08 17:16:24,70,6710,35,35,4618.39,8008.06,0.00
2024-12-08 17:16:24,69,6710,35,34,4677.21,8008.15,0.00
2024-12-08 17:16:24,68,6710,34,34,4742.46,8008.15,0.00
2024-12-08 17:16:24,68,6711,34,34,4789.94,8009.00,0.00
2024-12-08 17:16:24,69,6711,35,34,4720.52,8009.02,0.00
2024-12-08 17:16:24,69,6712,35,34,4709.00,8010.00,0.00
2024-12-08 17:16:24,70,6712,36,34,4641.73,8010.01,0.00
2024-12-08 17:16:24,70,6713,36,34,4629.00,8011.00,0.00
2024-12-08 17:16:24,71,6713,36,35,4563.80,8011.01,0.00
2024-12-08 17:16:24,70,6713,35,35,4626.72,8011.03,0.00
2024-12-08 17:16:24,69,6713,35,34,4680.18,8011.15,0.00
2024-12-08 17:16:24,69,6714,35,34,4701.95,8012.00,0.00
2024-12-08 17:16:24,70,6714,36,34,4634.78,8012.01,0.00
2024-12-08 17:16:24,69,6714,35,34,4696.78,8012.04,0.00
2024-12-08 17:16:24,69,6715,35,34,4687.53,8013.00,0.00
2024-12-08 17:16:24,70,6715,35,35,4620.56,8013.01,0.00
2024-12-08 17:16:24,69,6715,35,34,4653.55,8013.13,0.00
2024-12-08 17:16:24,70,6714,36,34,4538.15,8013.76,0.00
2024-12-08 17:16:24,70,6715,36,34,4630.19,8014.00,0.00
2024-12-08 17:16:24,71,6715,37,34,4564.98,8014.01,0.00
2024-12-08 17:16:24,71,6716,37,34,4667.14,8015.00,0.00
2024-12-08 17:16:24,72,6716,37,35,4602.32,8015.01,0.00
2024-12-08 17:16:24,71,6716,36,35,4658.14,8015.13,0.00
2024-12-08 17:16:24,70,6716,36,34,4706.92,8015.13,0.00
2024-12-08 17:16:24,70,6717,36,34,4729.24,8016.00,0.00
2024-12-08 17:16:24,71,6717,37,34,4662.63,8016.01,0.00
2024-12-08 17:16:24,71,6718,37,34,4651.92,8017.00,0.00
2024-12-08 17:16:24,72,6718,37,35,4587.31,8017.01,0.00
2024-12-08 17:16:24,71,6718,36,35,4642.91,8017.13,0.00
2024-12-08 17:16:24,70,6718,36,34,4685.18,8017.13,0.00
2024-12-08 17:16:24,70,6719,36,34,4707.51,8018.00,0.00
2024-12-08 17:16:24,71,6719,37,34,4641.20,8018.01,0.00
2024-12-08 17:16:25,71,6720,37,34,4630.49,8019.00,0.00
2024-12-08 17:16:25,72,6720,37,35,4566.18,8019.01,0.00
2024-12-08 17:16:25,71,6720,36,35,4627.11,8019.06,0.00
2024-12-08 17:16:25,70,6720,36,34,4666.88,8019.11,0.00
2024-12-08 17:16:25,69,6720,35,34,4734.51,8019.12,0.00
2024-12-08 17:16:25,69,6721,35,34,4757.16,8020.00,0.00
2024-12-08 17:16:25,70,6721,36,34,4689.20,8020.01,0.00
2024-12-08 17:16:25,70,6722,36,34,4679.35,8021.00,0.00
2024-12-08 17:16:25,71,6722,37,34,4613.45,8021.01,0.00
2024-12-08 17:16:25,70,6722,36,34,4675.93,8021.06,0.00
2024-12-08 17:16:25,69,6722,36,33,4718.13,8021.10,0.00
2024-12-08 17:16:25,69,6723,36,33,4736.80,8022.00,0.00
2024-12-08 17:16:25,70,6723,37,33,4669.13,8022.01,0.00
2024-12-08 17:16:25,71,6722,37,34,4526.69,8022.44,0.00
2024-12-08 17:16:25,71,6723,37,34,4631.58,8023.00,0.00
2024-12-08 17:16:25,72,6723,37,35,4567.26,8023.01,0.00
2024-12-08 17:16:25,71,6723,37,34,4604.48,8023.10,0.00
2024-12-08 17:16:25,71,6724,37,34,4725.73,8024.00,0.00
2024-12-08 17:16:25,72,6724,37,35,4660.10,8024.01,0.00
2024-12-08 17:16:25,72,6725,37,35,4631.48,8025.00,0.00
2024-12-08 17:16:25,73,6725,37,36,4568.04,8025.01,0.00
2024-12-08 17:16:25,72,6725,37,35,4604.75,8025.10,0.00
2024-12-08 17:16:25,72,6726,37,35,4602.40,8026.00,0.00
2024-12-08 17:16:25,73,6726,37,36,4539.36,8026.01,0.00
2024-12-08 17:16:25,72,6726,36,36,4557.87,8026.21,0.00
2024-12-08 17:16:25,72,6727,36,36,4589.18,8027.00,0.00
2024-12-08 17:16:25,73,6727,37,36,4526.32,8027.01,0.00
2024-12-08 17:16:25,72,6727,37,35,4563.56,8027.10,0.00
2024-12-08 17:16:25,71,6727,36,35,4625.58,8027.13,0.00
2024-12-08 17:16:25,70,6727,35,35,4614.91,8027.70,0.00
2024-12-08 17:16:25,70,6728,35,35,4705.75,8028.00,0.00
2024-12-08 17:16:25,71,6728,35,36,4639.47,8028.01,0.00
2024-12-08 17:16:25,71,6729,35,36,4625.36,8029.00,0.00
2024-12-08 17:16:25,72,6729,35,37,4561.12,8029.01,0.00
2024-12-08 17:16:25,73,6728,36,37,4497.54,8029.06,0.00
2024-12-08 17:16:25,72,6728,36,36,4608.30,8029.11,0.00
2024-12-08 17:16:25,72,6729,36,36,4623.51,8030.00,0.00
2024-12-08 17:16:25,73,6729,36,37,4560.17,8030.01,0.00
2024-12-08 17:16:25,73,6730,36,37,4654.95,8031.00,0.00
2024-12-08 17:16:25,74,6730,36,38,4592.04,8031.01,0.00
2024-12-08 17:16:25,73,6730,35,38,4649.61,8031.07,0.00
2024-12-08 17:16:25,72,6730,35,37,4696.35,8031.08,0.00
2024-12-08 17:16:25,72,6731,35,37,4710.74,8032.00,0.00
2024-12-08 17:16:25,73,6731,35,38,4646.21,8032.01,0.00
2024-12-08 17:16:25,72,6731,34,38,4626.66,8032.60,0.00
2024-12-08 17:16:25,72,6732,34,38,4706.18,8033.00,0.00
2024-12-08 17:16:25,73,6732,35,38,4641.71,8033.01,0.00
2024-12-08 17:16:25,72,6732,35,37,4681.65,8033.10,0.00
2024-12-08 17:16:25,71,6732,34,37,4745.34,8033.13,0.00
2024-12-08 17:16:25,71,6733,34,37,4766.26,8034.00,0.00
2024-12-08 17:16:25,72,6733,34,38,4700.07,8034.01,0.00
2024-12-08 17:16:25,72,6734,34,38,4688.38,8035.00,0.00
2024-12-08 17:16:25,73,6734,35,38,4624.15,8035.01,0.00
2024-12-08 17:16:25,72,6734,35,37,4664.96,8035.10,0.00
2024-12-08 17:16:25,72,6735,35,37,4682.26,8036.00,0.00
2024-12-08 17:16:25,73,6735,36,37,4618.12,8036.01,0.00
2024-12-08 17:16:25,72,6735,35,37,4678.93,8036.04,0.00
2024-12-08 17:16:25,72,6736,35,37,4669.12,8037.00,0.00
2024-12-08 17:16:25,73,6736,36,37,4605.16,8037.01,0.00
2024-12-08 17:16:25,72,6736,36,36,4647.93,8037.08,0.00
2024-12-08 17:16:25,73,6735,36,37,4579.87,8037.17,0.00
2024-12-08 17:16:26,73,6736,36,37,4705.95,8038.00,0.00
2024-12-08 17:16:26,74,6736,37,37,4642.36,8038.01,0.00
2024-12-08 17:16:26,74,6737,37,37,4735.15,8039.00,0.00
2024-12-08 17:16:26,75,6737,37,38,4672.02,8039.01,0.00
2024-12-08 17:16:26,74,6737,37,37,4711.27,8039.10,0.00
2024-12-08 17:16:26,74,6738,37,37,4725.96,8040.00,0.00
2024-12-08 17:16:26,75,6738,38,37,4662.95,8040.01,0.00
2024-12-08 17:16:26,74,6738,37,37,4626.09,8040.70,0.00
2024-12-08 17:16:26,74,6739,37,37,4711.08,8041.00,0.00
2024-12-08 17:16:26,75,6739,37,38,4648.27,8041.01,0.00
2024-12-08 17:16:26,74,6739,36,38,4707.84,8041.04,0.00
2024-12-08 17:16:26,73,6739,36,37,4752.68,8041.08,0.00
2024-12-08 17:16:26,73,6740,36,37,4767.58,8042.00,0.00
2024-12-08 17:16:26,74,6740,37,37,4703.15,8042.01,0.00
2024-12-08 17:16:26,73,6740,37,36,4752.07,8042.08,0.00
2024-12-08 17:16:26,73,6741,37,36,4766.73,8043.00,0.00
2024-12-08 17:16:26,74,6741,38,36,4702.32,8043.01,0.00
2024-12-08 17:16:26,74,6742,38,36,4688.77,8044.00,0.00
2024-12-08 17:16:26,75,6742,38,37,4626.25,8044.01,0.00
2024-12-08 17:16:26,74,6742,38,36,4665.80,8044.10,0.00
2024-12-08 17:16:26,74,6743,38,36,4680.49,8045.00,0.00
2024-12-08 17:16:26,75,6743,38,37,4618.08,8045.01,0.00
2024-12-08 17:16:26,76,6742,39,37,4472.07,8045.57,0.00
2024-12-08 17:16:26,76,6743,39,37,4597.54,8046.00,0.00
2024-12-08 17:16:26,77,6743,40,37,4537.84,8046.01,0.00
2024-12-08 17:16:26,76,6743,39,37,4596.48,8046.01,0.00
2024-12-08 17:16:26,75,6743,39,36,4631.38,8046.08,0.00
2024-12-08 17:16:26,75,6744,39,36,4751.02,8047.00,0.00
2024-12-08 17:16:26,76,6744,40,36,4688.51,8047.01,0.00
2024-12-08 17:16:26,75,6744,39,36,4747.82,8047.04,0.00
2024-12-08 17:16:26,75,6745,39,36,4733.71,8048.00,0.00
2024-12-08 17:16:26,76,6745,40,36,4671.42,8048.01,0.00
2024-12-08 17:16:26,75,6745,40,35,4713.47,8048.07,0.00
2024-12-08 17:16:26,75,6746,40,35,4722.66,8049.00,0.00
2024-12-08 17:16:26,76,6746,40,36,4660.52,8049.01,0.00
2024-12-08 17:16:26,76,6747,40,36,4643.98,8050.00,0.00
2024-12-08 17:16:26,77,6747,40,37,4583.67,8050.01,0.00
2024-12-08 17:16:26,76,6747,40,36,4623.32,8050.07,0.00
2024-12-08 17:16:26,75,6747,39,36,4662.44,8050.12,0.00
2024-12-08 17:16:26,75,6748,39,36,4699.47,8051.00,0.00
2024-12-08 17:16:26,76,6748,40,36,4637.64,8051.01,0.00
2024-12-08 17:16:26,75,6748,39,36,4697.34,8051.03,0.00
2024-12-08 17:16:26,74,6748,38,36,4708.77,8051.14,0.00
2024-12-08 17:16:26,73,6748,37,36,4752.43,8051.40,0.00
2024-12-08 17:16:26,73,6749,37,36,4814.63,8052.00,0.00
2024-12-08 17:16:26,74,6749,38,36,4749.56,8052.01,0.00
2024-12-08 17:16:26,73,6749,38,35,4791.10,8052.08,0.00
2024-12-08 17:16:26,73,6750,38,35,4806.00,8053.00,0.00
2024-12-08 17:16:26,74,6750,39,35,4741.05,8053.01,0.00
2024-12-08 17:16:26,73,6750,38,35,4750.03,8053.40,0.00
2024-12-08 17:16:26,73,6751,38,35,4790.18,8054.00,0.00
2024-12-08 17:16:26,74,6751,39,35,4725.45,8054.01,0.00
2024-12-08 17:16:26,73,6751,39,34,4767.89,8054.08,0.00
2024-12-08 17:16:26,73,6752,39,34,4781.42,8055.00,0.00
2024-12-08 17:16:26,74,6752,40,34,4716.81,8055.01,0.00
2024-12-08 17:16:26,74,6753,40,34,4697.46,8056.00,0.00
2024-12-08 17:16:26,75,6753,41,34,4634.83,8056.01,0.00
2024-12-08 17:16:26,74,6753,41,33,4674.71,8056.10,0.00
2024-12-08 17:16:26,74,6754,41,33,4686.28,8057.00,0.00
2024-12-08 17:16:27,75,6754,42,33,4623.80,8057.01,0.00
2024-12-08 17:16:27,74,6754,41,33,4662.86,8057.10,0.00
2024-12-08 17:16:27,74,6755,41,33,4674.42,8058.00,0.00
2024-12-08 17:16:27,75,6755,41,34,4612.09,8058.01,0.00
2024-12-08 17:16:27,74,6755,41,33,4653.76,8058.10,0.00
2024-12-08 17:16:27,74,6756,41,33,4665.25,8059.00,0.00
2024-12-08 17:16:27,75,6756,41,34,4603.04,8059.01,0.00
2024-12-08 17:16:27,75,6757,41,34,4584.11,8060.00,0.00
2024-12-08 17:16:27,76,6757,42,34,4523.80,8060.01,0.00
2024-12-08 17:16:27,75,6757,42,33,4565.40,8060.11,0.00
2024-12-08 17:16:27,75,6758,42,33,4578.18,8061.00,0.00
2024-12-08 17:16:27,76,6758,42,34,4517.94,8061.01,0.00
2024-12-08 17:16:27,75,6758,41,34,4533.33,8061.13,0.00
2024-12-08 17:16:27,75,6759,41,34,4571.47,8062.00,0.00
2024-12-08 17:16:27,76,6759,42,34,4511.32,8062.01,0.00
2024-12-08 17:16:27,75,6759,42,33,4554.31,8062.11,0.00
2024-12-08 17:16:27,75,6760,42,33,4568.81,8063.00,0.00
2024-12-08 17:16:27,76,6760,43,33,4508.70,8063.01,0.00
2024-12-08 17:16:27,75,6760,42,33,4515.21,8063.41,0.00
2024-12-08 17:16:27,76,6759,42,34,4455.80,8063.43,0.00
2024-12-08 17:16:27,76,6760,42,34,4537.91,8064.00,0.00
2024-12-08 17:16:27,77,6760,42,35,4478.97,8064.01,0.00
2024-12-08 17:16:27,76,6760,42,34,4509.30,8064.16,0.00
2024-12-08 17:16:27,76,6761,42,34,4632.80,8065.00,0.00
2024-12-08 17:16:27,77,6761,42,35,4572.63,8065.01,0.00
2024-12-08 17:16:27,76,6761,41,35,4607.37,8065.15,0.00
2024-12-08 17:16:27,76,6762,41,35,4623.65,8066.00,0.00
2024-12-08 17:16:27,77,6762,41,36,4563.60,8066.01,0.00
2024-12-08 17:16:27,76,6762,41,35,4597.15,8066.15,0.00
2024-12-08 17:16:27,76,6763,41,35,4613.41,8067.00,0.00
2024-12-08 17:16:27,77,6763,42,35,4553.49,8067.01,0.00
2024-12-08 17:16:27,77,6764,42,35,4537.25,8068.00,0.00
2024-12-08 17:16:27,78,6764,42,36,4479.08,8068.01,0.00
2024-12-08 17:16:27,77,6764,42,35,4512.14,8068.14,0.00
2024-12-08 17:16:27,77,6765,42,35,4527.34,8069.00,0.00
2024-12-08 17:16:27,78,6765,42,36,4469.29,8069.01,0.00
2024-12-08 17:16:27,79,6764,42,37,4373.97,8069.27,0.00
2024-12-08 17:16:27,79,6765,42,37,4440.85,8070.00,0.00
2024-12-08 17:16:27,80,6765,42,38,4385.34,8070.01,0.00
2024-12-08 17:16:27,79,6765,42,37,4417.38,8070.14,0.00
2024-12-08 17:16:27,79,6766,42,37,4532.32,8071.00,0.00
2024-12-08 17:16:27,80,6766,43,37,4475.67,8071.01,0.00
2024-12-08 17:16:27,80,6767,43,37,4457.05,8072.00,0.00
2024-12-08 17:16:27,81,6767,43,38,4402.03,8072.01,0.00
2024-12-08 17:16:27,80,6767,43,37,4431.86,8072.15,0.00
2024-12-08 17:16:27,80,6768,43,37,4438.72,8073.00,0.00
2024-12-08 17:16:27,81,6768,43,38,4383.92,8073.01,0.00
2024-12-08 17:16:27,80,6768,42,38,4436.70,8073.03,0.00
2024-12-08 17:16:27,81,6767,42,39,4348.08,8073.22,0.00
2024-12-08 17:16:27,81,6768,42,39,4356.58,8074.00,0.00
2024-12-08 17:16:27,82,6768,42,40,4303.45,8074.01,0.00
2024-12-08 17:16:27,81,6768,42,39,4330.69,8074.15,0.00
2024-12-08 17:16:27,81,6769,42,39,4420.55,8075.00,0.00
2024-12-08 17:16:27,82,6769,43,39,4366.64,8075.01,0.00
2024-12-08 17:16:27,81,6769,42,39,4414.59,8075.09,0.00
2024-12-08 17:16:27,80,6769,41,39,4450.60,8075.14,0.00
2024-12-08 17:16:27,79,6769,40,39,4483.45,8075.18,0.00
2024-12-08 17:16:28,79,6770,40,39,4490.14,8076.00,0.00
2024-12-08 17:16:28,80,6770,40,40,4434.02,8076.01,0.00
2024-12-08 17:16:28,79,6770,40,39,4463.60,8076.14,0.00
2024-12-08 17:16:28,80,6769,40,40,4352.13,8076.83,0.00
2024-12-08 17:16:28,79,6769,40,39,4386.52,8076.91,0.00
2024-12-08 17:16:28,79,6770,40,39,4461.22,8077.00,0.00
2024-12-08 17:16:28,80,6770,40,40,4405.46,8077.01,0.00
2024-12-08 17:16:28,79,6770,39,40,4427.53,8077.18,0.00
2024-12-08 17:16:28,79,6771,39,40,4542.46,8078.00,0.00
2024-12-08 17:16:28,80,6771,40,40,4485.68,8078.01,0.00
2024-12-08 17:16:28,79,6771,40,39,4515.90,8078.14,0.00
2024-12-08 17:16:28,80,6770,41,39,4408.19,8078.74,0.00
2024-12-08 17:16:28,80,6771,41,39,4484.30,8079.00,0.00
2024-12-08 17:16:28,81,6771,42,39,4428.94,8079.01,0.00
2024-12-08 17:16:28,80,6771,41,39,4430.82,8079.18,0.00
2024-12-08 17:16:28,80,6772,41,39,4550.36,8080.00,0.00
2024-12-08 17:16:28,81,6772,42,39,4494.18,8080.01,0.00
2024-12-08 17:16:28,80,6772,42,38,4523.12,8080.15,0.00
2024-12-08 17:16:28,80,6773,42,38,4510.39,8081.00,0.00
2024-12-08 17:16:28,81,6773,42,39,4454.71,8081.01,0.00
2024-12-08 17:16:28,81,6774,42,39,4398.82,8082.00,0.00
2024-12-08 17:16:28,82,6774,42,40,4345.17,8082.01,0.00
2024-12-08 17:16:28,81,6774,42,39,4367.93,8082.15,0.00
2024-12-08 17:16:28,80,6774,41,39,4396.34,8082.33,0.00
2024-12-08 17:16:28,80,6775,41,39,4391.59,8083.00,0.00
2024-12-08 17:16:28,81,6775,42,39,4337.37,8083.01,0.00
2024-12-08 17:16:28,80,6775,42,38,4281.18,8083.69,0.00
2024-12-08 17:16:28,80,6776,42,38,4316.42,8084.00,0.00
2024-12-08 17:16:28,81,6776,43,38,4263.13,8084.01,0.00
2024-12-08 17:16:28,80,6776,42,38,4313.40,8084.04,0.00
2024-12-08 17:16:28,79,6776,42,37,4339.19,8084.14,0.00
2024-12-08 17:16:28,78,6776,41,37,4333.26,8084.69,0.00
2024-12-08 17:16:28,78,6777,41,37,4361.21,8085.00,0.00
2024-12-08 17:16:28,79,6777,41,38,4306.01,8085.01,0.00
2024-12-08 17:16:28,79,6778,41,38,4245.29,8086.00,0.00
2024-12-08 17:16:28,80,6778,41,39,4192.23,8086.01,0.00
2024-12-08 17:16:28,79,6778,40,39,4177.74,8086.43,0.00
2024-12-08 17:16:28,79,6779,40,39,4186.85,8087.00,0.00
2024-12-08 17:16:28,80,6779,40,40,4134.52,8087.01,0.00
2024-12-08 17:16:28,79,6779,39,40,4182.77,8087.05,0.00
2024-12-08 17:16:28,78,6779,38,40,4117.96,8087.90,0.00
2024-12-08 17:16:28,78,6780,38,40,4192.69,8088.00,0.00
2024-12-08 17:16:28,79,6780,39,40,4139.62,8088.01,0.00
2024-12-08 17:16:28,78,6780,39,39,4162.16,8088.14,0.00
2024-12-08 17:16:28,77,6780,38,39,4110.22,8088.95,0.00
2024-12-08 17:16:28,77,6781,38,39,4211.11,8089.00,0.00
2024-12-08 17:16:28,78,6781,38,40,4157.12,8089.01,0.00
2024-12-08 17:16:28,77,6781,37,40,4141.24,8089.35,0.00
2024-12-08 17:16:28,77,6782,37,40,4167.24,8090.00,0.00
2024-12-08 17:16:28,78,6782,38,40,4113.81,8090.01,0.00
2024-12-08 17:16:28,77,6782,38,39,4142.05,8090.14,0.00
2024-12-08 17:16:28,76,6782,38,38,4114.26,8090.79,0.00
2024-12-08 17:16:28,76,6783,38,38,4199.01,8091.00,0.00
2024-12-08 17:16:28,77,6783,39,38,4144.48,8091.01,0.00
2024-12-08 17:16:28,76,6783,38,38,4194.76,8091.05,0.00
2024-12-08 17:16:28,75,6783,38,37,4174.63,8091.36,0.00
2024-12-08 17:16:28,75,6784,38,37,4216.71,8092.00,0.00
2024-12-08 17:16:28,76,6784,39,37,4161.22,8092.01,0.00
2024-12-08 17:16:28,75,6784,39,36,4193.00,8092.13,0.00
2024-12-08 17:16:29,75,6785,39,36,4184.91,8093.00,0.00
2024-12-08 17:16:29,76,6785,39,37,4129.85,8093.01,0.00
2024-12-08 17:16:29,75,6785,38,37,4183.24,8093.03,0.00
2024-12-08 17:16:29,76,6784,38,38,4084.61,8093.33,0.00
2024-12-08 17:16:29,77,6783,38,39,4086.53,8093.66,0.00
2024-12-08 17:16:29,77,6784,38,39,4139.02,8094.00,0.00
2024-12-08 17:16:29,78,6784,39,39,4085.96,8094.01,0.00
2024-12-08 17:16:29,77,6784,39,38,4118.02,8094.12,0.00
2024-12-08 17:16:29,76,6784,38,38,4097.07,8094.80,0.00
2024-12-08 17:16:29,76,6785,38,38,4379.47,8095.00,0.00
2024-12-08 17:16:29,77,6785,39,38,4322.59,8095.01,0.00
2024-12-08 17:16:29,76,6785,38,38,4317.75,8095.24,0.00
2024-12-08 17:16:29,76,6786,38,38,4348.81,8096.00,0.00
2024-12-08 17:16:29,77,6786,38,39,4292.33,8096.01,0.00
2024-12-08 17:16:29,76,6786,38,38,4345.62,8096.04,0.00
2024-12-08 17:16:29,75,6786,38,37,4386.31,8096.11,0.00
2024-12-08 17:16:29,75,6787,38,37,4385.91,8097.00,0.00
2024-12-08 17:16:29,76,6787,39,37,4328.20,8097.01,0.00
2024-12-08 17:16:29,75,6787,38,37,4382.68,8097.04,0.00
2024-12-08 17:16:29,74,6787,37,37,4383.44,8097.20,0.00
2024-12-08 17:16:29,73,6787,36,37,4442.37,8097.21,0.00
2024-12-08 17:16:29,74,6786,36,38,4341.81,8097.58,0.00
2024-12-08 17:16:29,74,6787,36,38,4418.93,8098.00,0.00
2024-12-08 17:16:29,75,6787,37,38,4360.01,8098.01,0.00
2024-12-08 17:16:29,74,6787,37,37,4395.17,8098.11,0.00
2024-12-08 17:16:29,74,6788,37,37,4503.34,8099.00,0.00
2024-12-08 17:16:29,75,6788,38,37,4443.30,8099.01,0.00
2024-12-08 17:16:29,74,6788,37,37,4498.47,8099.05,0.00
2024-12-08 17:16:29,74,6789,37,37,4466.67,8100.00,0.00
2024-12-08 17:16:29,75,6789,38,37,4407.11,8100.01,0.00
2024-12-08 17:16:29,74,6789,38,36,4449.17,8100.10,0.00
2024-12-08 17:16:29,73,6789,37,36,4475.28,8100.38,0.00
2024-12-08 17:16:29,73,6790,37,36,4514.56,8101.00,0.00
2024-12-08 17:16:29,74,6790,38,36,4453.55,8101.01,0.00
2024-12-08 17:16:29,73,6790,37,36,4509.02,8101.07,0.00
2024-12-08 17:16:29,72,6790,36,36,4534.31,8101.19,0.00
2024-12-08 17:16:29,71,6790,35,36,4592.53,8101.25,0.00
2024-12-08 17:16:29,71,6791,35,36,4623.84,8102.00,0.00
2024-12-08 17:16:29,72,6791,36,36,4559.62,8102.01,0.00
2024-12-08 17:16:29,71,6791,36,35,4606.74,8102.10,0.00
2024-12-08 17:16:29,71,6792,36,35,4625.55,8103.00,0.00
2024-12-08 17:16:29,72,6792,37,35,4561.31,8103.01,0.00
2024-12-08 17:16:29,71,6792,36,35,4622.13,8103.04,0.00
2024-12-08 17:16:29,70,6792,35,35,4651.14,8103.20,0.00
2024-12-08 17:16:29,70,6793,35,35,4678.65,8104.00,0.00
2024-12-08 17:16:29,71,6793,36,35,4612.75,8104.01,0.00
2024-12-08 17:16:29,70,6793,36,34,4663.62,8104.09,0.00
2024-12-08 17:16:29,70,6794,36,34,4676.14,8105.00,0.00
2024-12-08 17:16:29,71,6794,36,35,4610.28,8105.01,0.00
2024-12-08 17:16:29,71,6795,36,35,4585.69,8106.00,0.00
2024-12-08 17:16:29,72,6795,36,36,4522.00,8106.01,0.00
2024-12-08 17:16:29,71,6795,36,35,4572.00,8106.08,0.00
2024-12-08 17:16:29,71,6796,36,35,4565.63,8107.00,0.00
2024-12-08 17:16:29,72,6796,37,35,4502.22,8107.01,0.00
2024-12-08 17:16:29,71,6796,36,35,4461.92,8107.61,0.00
2024-12-08 17:16:29,71,6797,36,35,4520.30,8108.00,0.00
2024-12-08 17:16:29,72,6797,37,35,4457.52,8108.01,0.00
2024-12-08 17:16:29,71,6797,37,34,4506.61,8108.08,0.00
2024-12-08 17:16:29,70,6797,36,34,4561.49,8108.17,0.00
2024-12-08 17:16:29,70,6798,36,34,4565.17,8109.00,0.00
2024-12-08 17:16:29,71,6798,37,34,4500.87,8109.01,0.00
2024-12-08 17:16:29,70,6798,36,34,4559.39,8109.07,0.00
2024-12-08 17:16:29,69,6798,36,33,4608.70,8109.07,0.00
2024-12-08 17:16:29,68,6798,35,33,4657.79,8109.24,0.00
2024-12-08 17:16:29,68,6799,35,33,4676.59,8110.00,0.00
2024-12-08 17:16:29,69,6799,36,33,4608.82,8110.02,0.00
2024-12-08 17:16:30,69,6800,36,33,4579.92,8111.00,0.00
2024-12-08 17:16:30,70,6800,36,34,4514.49,8111.01,0.00
2024-12-08 17:16:30,70,6801,36,34,4481.61,8112.00,0.00
2024-12-08 17:16:30,71,6801,36,35,4418.49,8112.01,0.00
2024-12-08 17:16:30,70,6801,35,35,4426.14,8112.41,0.00
2024-12-08 17:16:30,69,6801,34,35,4460.43,8112.57,0.00
2024-12-08 17:16:30,69,6802,34,35,4519.54,8113.00,0.00
2024-12-08 17:16:30,70,6802,34,36,4454.97,8113.01,0.00
2024-12-08 17:16:30,69,6802,34,35,4490.15,8113.07,0.00
2024-12-08 17:16:30,69,6803,34,35,4509.51,8114.00,0.00
2024-12-08 17:16:30,70,6803,34,36,4445.09,8114.01,0.00
2024-12-08 17:16:30,69,6803,33,36,4448.40,8114.19,0.00
2024-12-08 17:16:30,69,6804,33,36,4500.65,8115.00,0.00
2024-12-08 17:16:30,70,6804,33,37,4436.36,8115.01,0.00
2024-12-08 17:16:30,69,6804,33,36,4483.02,8115.09,0.00
2024-12-08 17:16:30,69,6805,33,36,4503.56,8116.00,0.00
2024-12-08 17:16:30,70,6805,33,37,4439.23,8116.01,0.00
2024-12-08 17:16:30,69,6805,32,37,4423.72,8116.42,0.00
2024-12-08 17:16:30,68,6805,31,37,4467.46,8116.69,0.00
2024-12-08 17:16:30,68,6806,31,37,4562.00,8117.00,0.00
2024-12-08 17:16:30,69,6806,32,37,4495.88,8117.02,0.00
2024-12-08 17:16:30,68,6806,32,36,4545.30,8117.09,0.00
2024-12-08 17:16:30,67,6806,31,36,4601.02,8117.09,0.00
2024-12-08 17:16:30,67,6807,31,36,4648.83,8118.00,0.00
2024-12-08 17:16:30,68,6807,32,36,4580.47,8118.02,0.00
2024-12-08 17:16:30,67,6807,31,36,4641.56,8118.03,0.00
2024-12-08 17:16:30,67,6808,31,36,4660.31,8119.00,0.00
2024-12-08 17:16:30,68,6808,32,36,4591.78,8119.02,0.00
2024-12-08 17:16:30,67,6808,32,35,4642.14,8119.08,0.00
2024-12-08 17:16:30,67,6809,32,35,4664.52,8120.00,0.00
2024-12-08 17:16:30,68,6809,32,36,4595.93,8120.02,0.00
2024-12-08 17:16:30,67,6809,31,36,4625.78,8120.18,0.00
2024-12-08 17:16:30,67,6810,31,36,4656.61,8121.00,0.00
2024-12-08 17:16:30,68,6810,31,37,4588.13,8121.02,0.00
2024-12-08 17:16:30,67,6810,30,37,4652.98,8121.06,0.00
2024-12-08 17:16:30,66,6810,30,36,4711.18,8121.06,0.00
2024-12-08 17:16:30,66,6811,30,36,4733.90,8122.00,0.00
2024-12-08 17:16:30,67,6811,31,36,4663.25,8122.02,0.00
2024-12-08 17:16:30,66,6811,30,36,4717.91,8122.06,0.00
2024-12-08 17:16:30,67,6810,31,36,4578.68,8122.64,0.00
2024-12-08 17:16:30,67,6811,31,36,4700.19,8123.00,0.00
2024-12-08 17:16:30,68,6811,31,37,4631.07,8123.02,0.00
2024-12-08 17:16:30,67,6811,31,36,4673.54,8123.10,0.00
2024-12-08 17:16:30,67,6812,31,36,4819.60,8124.00,0.00
2024-12-08 17:16:30,68,6812,32,36,4748.72,8124.02,0.00
2024-12-08 17:16:30,69,6811,33,36,4619.89,8124.20,0.00
2024-12-08 17:16:30,70,6810,34,36,4557.56,8124.56,0.00
2024-12-08 17:16:30,70,6811,34,36,4672.81,8125.00,0.00
2024-12-08 17:16:30,71,6811,34,37,4607.00,8125.01,0.00
2024-12-08 17:16:30,71,6812,34,37,4825.02,8126.00,0.00
2024-12-08 17:16:30,72,6812,34,38,4758.00,8126.01,0.00
2024-12-08 17:16:30,71,6812,34,37,4814.09,8126.10,0.00
2024-12-08 17:16:30,71,6813,34,37,4832.99,8127.00,0.00
2024-12-08 17:16:30,72,6813,35,37,4765.87,8127.01,0.00
2024-12-08 17:16:30,71,6813,34,37,4829.56,8127.04,0.00
2024-12-08 17:16:30,72,6812,35,37,4678.06,8127.56,0.00
2024-12-08 17:16:30,72,6813,35,37,4759.68,8128.00,0.00
2024-12-08 17:16:30,73,6813,36,37,4694.48,8128.01,0.00
2024-12-08 17:16:30,73,6814,36,37,4791.57,8129.00,0.00
2024-12-08 17:16:30,74,6814,37,37,4726.82,8129.01,0.00
2024-12-08 17:16:30,73,6814,36,37,4790.46,8129.01,0.00
2024-12-08 17:16:30,72,6814,36,36,4842.33,8129.08,0.00
2024-12-08 17:16:30,71,6814,36,35,4897.49,8129.21,0.00
2024-12-08 17:16:30,71,6815,36,35,4925.51,8130.00,0.00
2024-12-08 17:16:30,72,6815,36,36,4857.10,8130.01,0.00
2024-12-08 17:16:31,71,6815,35,36,4827.36,8130.66,0.00
2024-12-08 17:16:31,71,6816,35,36,4914.67,8131.00,0.00
2024-12-08 17:16:31,72,6816,36,36,4846.41,8131.01,0.00
2024-12-08 17:16:31,71,6816,35,36,4907.80,8131.04,0.00
2024-12-08 17:16:31,70,6816,35,35,4959.33,8131.07,0.00
2024-12-08 17:16:31,70,6817,35,35,5000.59,8132.00,0.00
2024-12-08 17:16:31,71,6817,35,36,4930.16,8132.01,0.00
2024-12-08 17:16:31,71,6818,35,36,4919.31,8133.00,0.00
2024-12-08 17:16:31,72,6818,36,36,4850.99,8133.01,0.00
2024-12-08 17:16:31,72,6819,36,36,4839.16,8134.00,0.00
2024-12-08 17:16:31,73,6819,37,36,4772.87,8134.01,0.00
2024-12-08 17:16:31,72,6819,36,36,4838.40,8134.01,0.00
2024-12-08 17:16:31,72,6820,36,36,4826.57,8135.00,0.00
2024-12-08 17:16:31,73,6820,37,36,4760.45,8135.01,0.00
2024-12-08 17:16:31,73,6821,37,36,4746.20,8136.00,0.00
2024-12-08 17:16:31,74,6821,37,37,4682.06,8136.01,0.00
2024-12-08 17:16:31,73,6821,37,36,4731.72,8136.07,0.00
2024-12-08 17:16:31,73,6822,37,36,4741.83,8137.00,0.00
2024-12-08 17:16:31,74,6822,38,36,4677.76,8137.01,0.00
2024-12-08 17:16:31,74,6823,38,36,4658.87,8138.00,0.00
2024-12-08 17:16:31,75,6823,39,36,4596.75,8138.01,0.00
2024-12-08 17:16:31,74,6823,38,36,4657.77,8138.03,0.00
2024-12-08 17:16:31,73,6823,38,35,4705.97,8138.07,0.00
2024-12-08 17:16:31,73,6824,38,35,4716.03,8139.00,0.00
2024-12-08 17:16:31,74,6824,39,35,4652.30,8139.01,0.00
2024-12-08 17:16:31,74,6825,39,35,4638.16,8140.00,0.00
2024-12-08 17:16:31,75,6825,40,35,4576.32,8140.01,0.00
2024-12-08 17:16:31,74,6825,40,34,4622.77,8140.07,0.00
2024-12-08 17:16:31,74,6826,40,34,4634.14,8141.00,0.00
2024-12-08 17:16:31,75,6826,41,34,4572.35,8141.01,0.00
2024-12-08 17:16:31,74,6826,40,34,4632.13,8141.03,0.00
2024-12-08 17:16:31,74,6827,40,34,4606.33,8142.00,0.00
2024-12-08 17:16:31,75,6827,41,34,4544.92,8142.01,0.00
2024-12-08 17:16:31,74,6827,41,33,4593.14,8142.05,0.00
2024-12-08 17:16:31,75,6826,41,34,4474.73,8142.79,0.00
2024-12-08 17:16:31,76,6825,41,35,4406.26,8142.86,0.00
2024-12-08 17:16:31,76,6826,41,35,4501.05,8143.00,0.00
2024-12-08 17:16:31,77,6826,41,36,4442.59,8143.01,0.00
2024-12-08 17:16:31,77,6827,41,36,4575.09,8144.00,0.00
2024-12-08 17:16:31,78,6827,41,37,4516.43,8144.01,0.00
2024-12-08 17:16:31,77,6827,41,36,4562.40,8144.05,0.00
2024-12-08 17:16:31,76,6827,41,35,4497.59,8144.80,0.00
2024-12-08 17:16:31,76,6828,41,35,4571.88,8145.00,0.00
2024-12-08 17:16:31,77,6828,42,35,4512.50,8145.01,0.00
2024-12-08 17:16:31,77,6829,42,35,4488.54,8146.00,0.00
2024-12-08 17:16:31,78,6829,42,36,4430.99,8146.01,0.00
2024-12-08 17:16:31,77,6829,42,35,4476.90,8146.05,0.00
2024-12-08 17:16:31,77,6830,42,35,4483.80,8147.00,0.00
2024-12-08 17:16:31,78,6830,43,35,4426.31,8147.01,0.00
2024-12-08 17:16:31,77,6830,42,35,4480.63,8147.04,0.00
2024-12-08 17:16:31,77,6831,42,35,4463.12,8148.00,0.00
2024-12-08 17:16:31,78,6831,43,35,4405.90,8148.01,0.00
2024-12-08 17:16:31,77,6831,43,34,4451.49,8148.04,0.00
2024-12-08 17:16:31,77,6832,43,34,4453.41,8149.00,0.00
2024-12-08 17:16:31,78,6832,44,34,4396.31,8149.01,0.00
2024-12-08 17:16:31,77,6832,43,34,4400.53,8149.14,0.00
2024-12-08 17:16:31,78,6831,43,35,4296.35,8149.76,0.00
2024-12-08 17:16:32,78,6832,43,35,4414.18,8150.00,0.00
2024-12-08 17:16:32,79,6832,43,36,4358.31,8150.01,0.00
2024-12-08 17:16:32,78,6832,43,35,4404.78,8150.04,0.00
2024-12-08 17:16:32,79,6831,43,36,4285.31,8150.84,0.00
2024-12-08 17:16:32,79,6832,43,36,4464.70,8151.00,0.00
2024-12-08 17:16:32,80,6832,43,37,4408.89,8151.01,0.00
2024-12-08 17:16:32,80,6833,43,37,4482.80,8152.00,0.00
2024-12-08 17:16:32,81,6833,44,37,4427.46,8152.01,0.00
2024-12-08 17:16:32,80,6833,43,37,4481.78,8152.01,0.00
2024-12-08 17:16:32,79,6833,43,36,4531.29,8152.03,0.00
2024-12-08 17:16:32,78,6833,42,36,4582.07,8152.03,0.00
2024-12-08 17:16:32,78,6834,42,36,4591.62,8153.00,0.00
2024-12-08 17:16:32,79,6834,43,36,4533.50,8153.01,0.00
2024-12-08 17:16:32,78,6834,42,36,4561.34,8153.13,0.00
2024-12-08 17:16:32,78,6835,42,36,4553.10,8154.00,0.00
2024-12-08 17:16:32,79,6835,43,36,4495.46,8154.01,0.00
2024-12-08 17:16:32,78,6835,43,35,4543.69,8154.03,0.00
2024-12-08 17:16:32,78,6836,43,35,4525.88,8155.00,0.00
2024-12-08 17:16:32,79,6836,44,35,4468.59,8155.01,0.00
2024-12-08 17:16:32,78,6836,43,35,4464.31,8155.33,0.00
2024-12-08 17:16:32,78,6837,43,35,4497.16,8156.00,0.00
2024-12-08 17:16:32,79,6837,44,35,4440.24,8156.01,0.00
2024-12-08 17:16:32,78,6837,44,34,4486.71,8156.01,0.00
2024-12-08 17:16:32,78,6838,44,34,4480.38,8157.00,0.00
2024-12-08 17:16:32,79,6838,44,35,4423.67,8157.01,0.00
2024-12-08 17:16:32,78,6838,44,34,4474.11,8157.01,0.00
2024-12-08 17:16:32,77,6838,43,34,4519.55,8157.16,0.00
2024-12-08 17:16:32,77,6839,43,34,4532.86,8158.00,0.00
2024-12-08 17:16:32,78,6839,43,35,4474.75,8158.01,0.00
2024-12-08 17:16:32,78,6840,43,35,4455.35,8159.00,0.00
2024-12-08 17:16:32,79,6840,44,35,4398.96,8159.01,0.00
2024-12-08 17:16:32,78,6840,44,34,4448.03,8159.01,0.00
2024-12-08 17:16:32,78,6841,44,34,4449.63,8160.00,0.00
2024-12-08 17:16:32,79,6841,45,34,4393.31,8160.01,0.00
2024-12-08 17:16:32,79,6842,45,34,4373.17,8161.00,0.00
2024-12-08 17:16:32,80,6842,46,34,4318.51,8161.01,0.00
2024-12-08 17:16:32,79,6842,46,33,4366.97,8161.01,0.00
2024-12-08 17:16:32,79,6843,46,33,4367.31,8162.00,0.00
2024-12-08 17:16:32,80,6843,46,34,4312.72,8162.01,0.00
2024-12-08 17:16:32,79,6843,45,34,4333.27,8162.18,0.00
2024-12-08 17:16:32,79,6844,45,34,4346.84,8163.00,0.00
2024-12-08 17:16:32,80,6844,45,35,4292.50,8163.01,0.00
2024-12-08 17:16:32,79,6844,45,34,4341.67,8163.01,0.00
2024-12-08 17:16:32,80,6843,46,34,4267.07,8163.29,0.00
2024-12-08 17:16:32,81,6842,47,34,4236.32,8163.63,0.00
2024-12-08 17:16:32,81,6843,47,34,4313.49,8164.00,0.00
2024-12-08 17:16:32,82,6843,48,34,4260.89,8164.01,0.00
2024-12-08 17:16:32,81,6843,48,33,4206.85,8164.79,0.00
2024-12-08 17:16:32,81,6844,48,33,4492.27,8165.00,0.00
2024-12-08 17:16:32,82,6844,48,34,4437.49,8165.01,0.00
2024-12-08 17:16:32,81,6844,48,33,4487.23,8165.01,0.00
2024-12-08 17:16:32,80,6844,47,33,4530.10,8165.18,0.00
2024-12-08 17:16:32,80,6845,47,33,4542.61,8166.00,0.00
2024-12-08 17:16:32,81,6845,47,34,4486.53,8166.01,0.00
2024-12-08 17:16:32,80,6845,46,34,4535.47,8166.03,0.00
2024-12-08 17:16:32,80,6846,46,34,4535.64,8167.00,0.00
2024-12-08 17:16:32,81,6846,46,35,4479.65,8167.01,0.00
2024-12-08 17:16:32,80,6846,46,34,4527.47,8167.03,0.00
2024-12-08 17:16:32,80,6847,46,34,4527.63,8168.00,0.00
2024-12-08 17:16:32,81,6847,46,35,4471.74,8168.01,0.00
2024-12-08 17:16:33,81,6848,46,35,4449.71,8169.00,0.00
2024-12-08 17:16:33,82,6848,47,35,4395.45,8169.01,0.00
2024-12-08 17:16:33,81,6848,47,34,4443.66,8169.03,0.00
2024-12-08 17:16:33,80,6848,46,34,4464.64,8169.45,0.00
2024-12-08 17:16:33,79,6848,45,34,4515.39,8169.51,0.00
2024-12-08 17:16:33,79,6849,45,34,4558.16,8170.00,0.00
2024-12-08 17:16:33,80,6849,45,35,4501.18,8170.01,0.00
2024-12-08 17:16:33,79,6849,44,35,4557.13,8170.01,0.00
2024-12-08 17:16:33,78,6849,43,35,4554.91,8170.33,0.00
2024-12-08 17:16:33,78,6850,43,35,4604.88,8171.00,0.00
2024-12-08 17:16:33,79,6850,44,35,4546.59,8171.01,0.00
2024-12-08 17:16:33,79,6851,44,35,4526.02,8172.00,0.00
2024-12-08 17:16:33,80,6851,44,36,4469.44,8172.01,0.00
2024-12-08 17:16:33,79,6851,44,35,4512.57,8172.01,0.00
2024-12-08 17:16:33,79,6852,44,35,4510.37,8173.00,0.00
2024-12-08 17:16:33,80,6852,44,36,4453.99,8173.01,0.00
2024-12-08 17:16:33,80,6853,44,36,4429.48,8174.00,0.00
2024-12-08 17:16:33,81,6853,45,36,4374.80,8174.01,0.00
2024-12-08 17:16:33,80,6853,44,36,4428.46,8174.01,0.00
2024-12-08 17:16:33,79,6853,44,35,4481.41,8174.01,0.00
2024-12-08 17:16:33,78,6853,43,35,4532.59,8174.03,0.00
2024-12-08 17:16:33,77,6853,42,35,4567.01,8174.30,0.00
2024-12-08 17:16:33,77,6854,42,35,4613.12,8175.00,0.00
2024-12-08 17:16:33,78,6854,43,35,4553.98,8175.01,0.00
2024-12-08 17:16:33,78,6855,43,35,4534.07,8176.00,0.00
2024-12-08 17:16:33,79,6855,44,35,4476.68,8176.01,0.00
2024-12-08 17:16:33,79,6856,44,35,4456.81,8177.00,0.00
2024-12-08 17:16:33,80,6856,45,35,4401.10,8177.01,0.00
2024-12-08 17:16:33,79,6856,45,34,4445.43,8177.01,0.00
2024-12-08 17:16:33,79,6857,45,34,4447.46,8178.00,0.00
2024-12-08 17:16:33,80,6857,45,35,4391.87,8178.01,0.00
2024-12-08 17:16:33,80,6858,45,35,4372.98,8179.00,0.00
2024-12-08 17:16:33,81,6858,46,35,4319.00,8179.01,0.00
2024-12-08 17:16:33,80,6858,46,34,4361.75,8179.06,0.00
2024-12-08 17:16:33,79,6858,45,34,4406.65,8179.19,0.00
2024-12-08 17:16:33,80,6857,45,35,4291.48,8179.70,0.00
2024-12-08 17:16:33,80,6858,45,35,4391.92,8180.00,0.00
2024-12-08 17:16:33,81,6858,45,36,4337.70,8180.01,0.00
2024-12-08 17:16:33,81,6859,45,36,4416.55,8181.00,0.00
2024-12-08 17:16:33,82,6859,45,37,4362.69,8181.01,0.00
2024-12-08 17:16:33,81,6859,44,37,4415.54,8181.03,0.00
2024-12-08 17:16:33,80,6859,44,36,4462.55,8181.05,0.00
2024-12-08 17:16:33,80,6860,44,36,4460.50,8182.00,0.00
2024-12-08 17:16:33,81,6860,45,36,4405.43,8182.01,0.00
2024-12-08 17:16:33,81,6861,45,36,4378.72,8183.00,0.00
2024-12-08 17:16:33,82,6861,45,37,4325.32,8183.01,0.00
2024-12-08 17:16:33,81,6861,45,36,4364.58,8183.07,0.00
2024-12-08 17:16:33,82,6860,46,36,4254.66,8183.74,0.00
2024-12-08 17:16:33,82,6861,46,36,4372.64,8184.00,0.00
2024-12-08 17:16:33,83,6861,46,37,4319.96,8184.01,0.00
2024-12-08 17:16:33,82,6861,45,37,4370.65,8184.04,0.00
2024-12-08 17:16:33,82,6862,45,37,4451.59,8185.00,0.00
2024-12-08 17:16:33,83,6862,46,37,4397.96,8185.01,0.00
2024-12-08 17:16:33,82,6862,45,37,4416.70,8185.20,0.00
2024-12-08 17:16:33,82,6863,45,37,4431.17,8186.00,0.00
2024-12-08 17:16:33,83,6863,46,37,4377.79,8186.01,0.00
2024-12-08 17:16:33,83,6864,46,37,4356.50,8187.00,0.00
2024-12-08 17:16:33,84,6864,46,38,4304.64,8187.01,0.00
2024-12-08 17:16:33,83,6864,46,37,4335.79,8187.06,0.00
2024-12-08 17:16:33,82,6864,45,37,4372.96,8187.23,0.00
2024-12-08 17:16:34,82,6865,45,37,4390.02,8188.00,0.00
2024-12-08 17:16:34,83,6865,45,38,4337.13,8188.01,0.00
2024-12-08 17:16:34,82,6865,44,38,4330.66,8188.22,0.00
2024-12-08 17:16:34,83,6864,44,39,4229.35,8188.84,0.00
2024-12-08 17:16:34,83,6865,44,39,4326.27,8189.00,0.00
2024-12-08 17:16:34,84,6865,45,39,4274.76,8189.01,0.00
2024-12-08 17:16:34,83,6865,45,38,4317.39,8189.06,0.00
2024-12-08 17:16:34,82,6865,44,38,4345.10,8189.17,0.00
2024-12-08 17:16:34,81,6865,44,37,4398.01,8189.17,0.00
2024-12-08 17:16:34,81,6866,44,37,4525.77,8190.00,0.00
2024-12-08 17:16:34,82,6866,44,38,4470.58,8190.01,0.00
2024-12-08 17:16:34,81,6866,43,38,4521.73,8190.05,0.00
2024-12-08 17:16:34,80,6866,42,38,4546.52,8190.09,0.00
2024-12-08 17:16:34,80,6867,42,38,4553.44,8191.00,0.00
2024-12-08 17:16:34,81,6867,42,39,4497.23,8191.01,0.00
2024-12-08 17:16:34,80,6867,42,38,4542.19,8191.08,0.00
2024-12-08 17:16:34,79,6867,41,38,4492.13,8191.72,0.00
2024-12-08 17:16:34,79,6868,41,38,4573.24,8192.00,0.00
2024-12-08 17:16:34,80,6868,41,39,4516.07,8192.01,0.00
2024-12-08 17:16:34,79,6868,40,39,4559.77,8192.08,0.00
2024-12-08 17:16:34,78,6868,39,39,4521.80,8192.60,0.00
2024-12-08 17:16:34,78,6869,39,39,4594.59,8193.00,0.00
2024-12-08 17:16:34,79,6869,40,39,4536.43,8193.01,0.00
2024-12-08 17:16:34,78,6869,40,38,4580.95,8193.08,0.00
2024-12-08 17:16:34,77,6869,39,38,4628.74,8193.09,0.00
2024-12-08 17:16:34,77,6870,39,38,4660.31,8194.00,0.00
2024-12-08 17:16:34,78,6870,39,39,4600.56,8194.01,0.00
2024-12-08 17:16:34,78,6871,39,39,4570.28,8195.00,0.00
2024-12-08 17:16:34,79,6871,40,39,4512.43,8195.01,0.00
2024-12-08 17:16:34,78,6871,40,38,4557.68,8195.08,0.00
2024-12-08 17:16:34,78,6872,40,38,4543.05,8196.00,0.00
2024-12-08 17:16:34,79,6872,40,39,4485.54,8196.01,0.00
2024-12-08 17:16:34,78,6872,40,38,4500.61,8196.27,0.00
2024-12-08 17:16:34,77,6872,39,38,4545.29,8196.44,0.00
2024-12-08 17:16:34,77,6873,39,38,4552.80,8197.00,0.00
2024-12-08 17:16:34,78,6873,40,38,4494.43,8197.01,0.00
2024-12-08 17:16:34,77,6873,40,37,4540.03,8197.08,0.00
2024-12-08 17:16:34,76,6873,39,37,4531.99,8197.71,0.00
2024-12-08 17:16:34,76,6874,39,37,4594.78,8198.00,0.00
2024-12-08 17:16:34,77,6874,40,37,4535.10,8198.01,0.00
2024-12-08 17:16:34,76,6874,39,37,4558.14,8198.19,0.00
2024-12-08 17:16:34,76,6875,39,37,4578.07,8199.00,0.00
2024-12-08 17:16:34,77,6875,39,38,4518.62,8199.01,0.00
2024-12-08 17:16:34,76,6875,38,38,4577.00,8199.01,0.00
2024-12-08 17:16:34,75,6875,38,37,4615.09,8199.11,0.00
2024-12-08 17:16:34,75,6876,38,37,4629.65,8200.00,0.00
2024-12-08 17:16:34,76,6876,39,37,4568.73,8200.01,0.00
2024-12-08 17:16:34,75,6876,38,37,4603.43,8200.12,0.00
2024-12-08 17:16:34,74,6876,37,37,4639.06,8200.16,0.00
2024-12-08 17:16:34,73,6876,36,37,4681.38,8200.43,0.00
2024-12-08 17:16:34,73,6877,36,37,4746.77,8201.00,0.00
2024-12-08 17:16:34,74,6877,37,37,4682.62,8201.01,0.00
2024-12-08 17:16:34,74,6878,37,37,4668.78,8202.00,0.00
2024-12-08 17:16:34,75,6878,38,37,4606.53,8202.01,0.00
2024-12-08 17:16:34,74,6878,37,37,4667.67,8202.01,0.00
2024-12-08 17:16:34,74,6879,37,37,4650.57,8203.00,0.00
2024-12-08 17:16:34,75,6879,37,38,4588.57,8203.01,0.00
2024-12-08 17:16:34,74,6879,37,37,4641.73,8203.11,0.00
2024-12-08 17:16:34,74,6880,37,37,4649.17,8204.00,0.00
2024-12-08 17:16:34,75,6880,38,37,4587.18,8204.01,0.00
2024-12-08 17:16:34,74,6880,37,37,4590.50,8204.32,0.00
2024-12-08 17:16:34,74,6881,37,37,4628.35,8205.00,0.00
2024-12-08 17:16:34,75,6881,37,38,4566.64,8205.01,0.00
2024-12-08 17:16:34,74,6881,37,37,4594.02,8205.18,0.00
2024-12-08 17:16:35,74,6882,37,37,4583.29,8206.00,0.00
2024-12-08 17:16:35,75,6882,38,37,4522.18,8206.01,0.00
2024-12-08 17:16:35,75,6883,38,37,4463.10,8207.00,0.00
2024-12-08 17:16:35,76,6883,38,38,4404.37,8207.01,0.00
2024-12-08 17:16:35,75,6883,37,38,4462.01,8207.01,0.00
2024-12-08 17:16:35,74,6883,37,37,4490.18,8207.16,0.00
2024-12-08 17:16:35,74,6884,37,37,4455.19,8208.00,0.00
2024-12-08 17:16:35,75,6884,38,37,4395.79,8208.01,0.00
2024-12-08 17:16:35,74,6884,37,37,4423.06,8208.16,0.00
2024-12-08 17:16:35,73,6884,36,37,4426.49,8208.55,0.00
2024-12-08 17:16:35,72,6884,36,36,4458.72,8208.74,0.00
2024-12-08 17:16:35,72,6885,36,36,4551.27,8209.00,0.00
2024-12-08 17:16:35,73,6885,37,36,4488.93,8209.01,0.00
2024-12-08 17:16:35,72,6885,37,35,4518.25,8209.17,0.00
2024-12-08 17:16:35,72,6886,37,35,4541.57,8210.00,0.00
2024-12-08 17:16:35,73,6886,37,36,4479.35,8210.01,0.00
2024-12-08 17:16:35,72,6886,36,36,4503.97,8210.19,0.00
2024-12-08 17:16:35,72,6887,36,36,4529.58,8211.00,0.00
2024-12-08 17:16:35,73,6887,37,36,4467.53,8211.01,0.00
2024-12-08 17:16:35,72,6887,36,36,4498.80,8211.11,0.00
2024-12-08 17:16:35,71,6887,36,35,4533.27,8211.18,0.00
2024-12-08 17:16:35,71,6888,36,35,4582.37,8212.00,0.00
2024-12-08 17:16:35,72,6888,36,36,4518.72,8212.01,0.00
2024-12-08 17:16:35,72,6889,36,36,4506.72,8213.00,0.00
2024-12-08 17:16:35,73,6889,36,37,4444.99,8213.01,0.00
2024-12-08 17:16:35,72,6889,35,37,4499.89,8213.08,0.00
2024-12-08 17:16:35,71,6889,35,36,4535.52,8213.17,0.00
2024-12-08 17:16:35,71,6890,35,36,4558.99,8214.00,0.00
2024-12-08 17:16:35,72,6890,36,36,4495.67,8214.01,0.00
2024-12-08 17:16:35,71,6890,36,35,4557.84,8214.01,0.00
2024-12-08 17:16:35,72,6889,36,36,4383.71,8214.81,0.00
2024-12-08 17:16:35,73,6888,37,36,4338.31,8214.84,0.00
2024-12-08 17:16:35,73,6889,37,36,4473.49,8215.00,0.00
2024-12-08 17:16:35,74,6889,37,37,4413.04,8215.01,0.00
2024-12-08 17:16:35,73,6889,37,36,4472.37,8215.01,0.00
2024-12-08 17:16:35,72,6889,37,35,4504.84,8215.14,0.00
2024-12-08 17:16:35,72,6890,37,35,4754.13,8216.00,0.00
2024-12-08 17:16:35,73,6890,38,35,4689.00,8216.01,0.00
2024-12-08 17:16:35,73,6891,38,35,4676.07,8217.00,0.00
2024-12-08 17:16:35,74,6891,38,36,4612.88,8217.01,0.00
2024-12-08 17:16:35,74,6892,38,36,4599.00,8218.00,0.00
2024-12-08 17:16:35,75,6892,39,36,4537.68,8218.01,0.00
2024-12-08 17:16:35,74,6892,39,35,4593.45,8218.01,0.00
2024-12-08 17:16:35,73,6892,38,35,4654.13,8218.04,0.00
2024-12-08 17:16:35,74,6891,38,36,4517.57,8218.96,0.00
2024-12-08 17:16:35,74,6892,38,36,4606.46,8219.00,0.00
2024-12-08 17:16:35,75,6892,38,37,4545.04,8219.01,0.00
2024-12-08 17:16:35,74,6892,38,36,4597.59,8219.07,0.00
2024-12-08 17:16:35,74,6893,38,36,4712.41,8220.00,0.00
2024-12-08 17:16:35,75,6893,38,37,4649.57,8220.01,0.00
2024-12-08 17:16:35,74,6893,37,37,4687.98,8220.11,0.00
2024-12-08 17:16:35,74,6894,37,37,4679.72,8221.00,0.00
2024-12-08 17:16:35,75,6894,38,37,4617.33,8221.01,0.00
2024-12-08 17:16:35,74,6894,38,36,4651.97,8221.12,0.00
2024-12-08 17:16:35,74,6895,38,36,4633.37,8222.00,0.00
2024-12-08 17:16:35,75,6895,39,36,4571.60,8222.01,0.00
2024-12-08 17:16:35,74,6895,38,36,4573.19,8222.34,0.00
2024-12-08 17:16:35,74,6896,38,36,4583.55,8223.00,0.00
2024-12-08 17:16:35,75,6896,39,36,4522.44,8223.01,0.00
2024-12-08 17:16:35,74,6896,39,35,4556.91,8223.12,0.00
2024-12-08 17:16:35,73,6896,38,35,4613.72,8223.18,0.00
2024-12-08 17:16:35,72,6896,37,35,4642.94,8223.46,0.00
2024-12-08 17:16:35,73,6895,38,35,4563.69,8223.67,0.00
2024-12-08 17:16:35,73,6896,38,35,4637.86,8224.00,0.00
2024-12-08 17:16:35,74,6896,39,35,4575.19,8224.01,0.00
2024-12-08 17:16:36,73,6896,38,35,4568.32,8224.41,0.00
2024-12-08 17:16:36,73,6897,38,35,4712.51,8225.00,0.00
2024-12-08 17:16:36,74,6897,39,35,4648.83,8225.01,0.00
2024-12-08 17:16:36,73,6897,39,34,4680.99,8225.15,0.00
2024-12-08 17:16:36,74,6896,39,35,4548.88,8225.66,0.00
2024-12-08 17:16:36,74,6897,39,35,4627.01,8226.00,0.00
2024-12-08 17:16:36,75,6897,39,36,4565.31,8226.01,0.00
2024-12-08 17:16:36,74,6897,39,35,4573.41,8226.26,0.00
2024-12-08 17:16:36,74,6898,39,35,4693.83,8227.00,0.00
2024-12-08 17:16:36,75,6898,40,35,4631.24,8227.01,0.00
2024-12-08 17:16:36,74,6898,40,34,4663.84,8227.15,0.00
2024-12-08 17:16:36,74,6899,40,34,4660.59,8228.00,0.00
2024-12-08 17:16:36,75,6899,41,34,4598.44,8228.01,0.00
2024-12-08 17:16:36,74,6899,40,34,4656.14,8228.07,0.00
2024-12-08 17:16:36,73,6899,39,34,4718.80,8228.07,0.00
2024-12-08 17:16:36,73,6900,39,34,4683.78,8229.00,0.00
2024-12-08 17:16:36,74,6900,40,34,4620.49,8229.01,0.00
2024-12-08 17:16:36,73,6900,39,34,4682.66,8229.01,0.00
2024-12-08 17:16:36,72,6900,39,33,4719.14,8229.13,0.00
2024-12-08 17:16:36,72,6901,39,33,4707.84,8230.00,0.00
2024-12-08 17:16:36,73,6901,40,33,4643.35,8230.01,0.00
2024-12-08 17:16:36,72,6901,39,33,4663.31,8230.21,0.00
2024-12-08 17:16:36,72,6902,39,33,4677.42,8231.00,0.00
2024-12-08 17:16:36,73,6902,39,34,4613.34,8231.01,0.00
2024-12-08 17:16:36,72,6902,39,33,4650.00,8231.13,0.00
2024-12-08 17:16:36,72,6903,39,33,4625.81,8232.00,0.00
2024-12-08 17:16:36,73,6903,39,34,4562.44,8232.01,0.00
2024-12-08 17:16:36,73,6904,39,34,4498.69,8233.00,0.00
2024-12-08 17:16:36,74,6904,40,34,4437.89,8233.01,0.00
2024-12-08 17:16:36,73,6904,40,33,4472.77,8233.12,0.00
2024-12-08 17:16:36,72,6904,39,33,4497.72,8233.50,0.00
2024-12-08 17:16:36,71,6904,38,33,4501.11,8233.86,0.00
2024-12-08 17:16:36,71,6905,38,33,4582.40,8234.00,0.00
2024-12-08 17:16:36,72,6905,38,34,4518.75,8234.01,0.00
2024-12-08 17:16:36,72,6906,38,34,4482.45,8235.00,0.00
2024-12-08 17:16:36,73,6906,38,35,4421.05,8235.01,0.00
2024-12-08 17:16:36,72,6906,38,34,4457.31,8235.13,0.00
2024-12-08 17:16:36,71,6906,38,33,4440.56,8235.70,0.00
2024-12-08 17:16:36,71,6907,38,33,4531.71,8236.00,0.00
2024-12-08 17:16:36,72,6907,39,33,4468.77,8236.01,0.00
2024-12-08 17:16:36,72,6908,39,33,4455.61,8237.00,0.00
2024-12-08 17:16:36,73,6908,40,33,4394.57,8237.01,0.00
2024-12-08 17:16:36,72,6908,40,32,4431.74,8237.14,0.00
2024-12-08 17:16:36,72,6909,40,32,4450.38,8238.00,0.00
2024-12-08 17:16:36,73,6909,41,32,4389.42,8238.01,0.00
2024-12-08 17:16:36,73,6910,41,32,4374.13,8239.00,0.00
2024-12-08 17:16:36,74,6910,41,33,4315.02,8239.01,0.00
2024-12-08 17:16:36,73,6910,41,32,4347.06,8239.14,0.00
2024-12-08 17:16:36,73,6911,41,32,4362.58,8240.00,0.00
2024-12-08 17:16:36,74,6911,41,33,4303.62,8240.01,0.00
2024-12-08 17:16:36,73,6911,40,33,4349.04,8240.11,0.00
2024-12-08 17:16:36,73,6912,40,33,4360.48,8241.00,0.00
2024-12-08 17:16:36,74,6912,41,33,4301.56,8241.01,0.00
2024-12-08 17:16:36,73,6912,40,33,4358.22,8241.03,0.00
2024-12-08 17:16:36,72,6912,39,33,4415.33,8241.07,0.00
2024-12-08 17:16:36,71,6912,39,32,4454.31,8241.10,0.00
2024-12-08 17:16:36,71,6913,39,32,4469.30,8242.00,0.00
2024-12-08 17:16:36,72,6913,39,33,4407.23,8242.01,0.00
2024-12-08 17:16:36,71,6913,38,33,4466.98,8242.03,0.00
2024-12-08 17:16:36,71,6914,38,33,4448.85,8243.00,0.00
2024-12-08 17:16:36,72,6914,39,33,4387.06,8243.01,0.00
2024-12-08 17:16:36,71,6914,39,32,4422.17,8243.10,0.00
2024-12-08 17:16:36,70,6914,38,32,4483.00,8243.13,0.00
2024-12-08 17:16:37,70,6915,38,32,4511.61,8244.00,0.00
2024-12-08 17:16:37,71,6915,38,33,4448.06,8244.01,0.00
2024-12-08 17:16:37,71,6916,38,33,4416.32,8245.00,0.00
2024-12-08 17:16:37,72,6916,38,34,4354.98,8245.01,0.00
2024-12-08 17:16:37,71,6916,38,33,4390.79,8245.10,0.00
2024-12-08 17:16:37,70,6916,37,33,4448.82,8245.14,0.00
2024-12-08 17:16:37,69,6916,36,33,4470.38,8245.38,0.00
2024-12-08 17:16:37,69,6917,36,33,4516.88,8246.00,0.00
2024-12-08 17:16:37,70,6917,36,34,4452.35,8246.02,0.00
2024-12-08 17:16:37,69,6917,35,34,4515.99,8246.02,0.00
2024-12-08 17:16:37,69,6918,35,34,4482.60,8247.00,0.00
2024-12-08 17:16:37,70,6918,36,34,4418.56,8247.02,0.00
2024-12-08 17:16:37,69,6918,36,33,4458.71,8247.09,0.00
2024-12-08 17:16:37,68,6918,35,33,4501.35,8247.37,0.00
2024-12-08 17:16:37,67,6918,34,33,4555.52,8247.51,0.00
2024-12-08 17:16:37,67,6919,34,33,4613.73,8248.00,0.00
2024-12-08 17:16:37,68,6919,35,33,4545.88,8248.02,0.00
2024-12-08 17:16:37,68,6920,35,33,4537.94,8249.00,0.00
2024-12-08 17:16:37,69,6920,36,33,4472.17,8249.02,0.00
2024-12-08 17:16:37,68,6920,35,33,4533.09,8249.06,0.00
2024-12-08 17:16:37,67,6920,35,32,4581.06,8249.07,0.00
2024-12-08 17:16:37,68,6919,36,32,4495.57,8249.32,0.00
2024-12-08 17:16:37,69,6918,36,33,4477.28,8249.74,0.00
2024-12-08 17:16:37,69,6919,36,33,4668.80,8250.00,0.00
2024-12-08 17:16:37,70,6919,36,34,4602.10,8250.02,0.00
2024-12-08 17:16:37,70,6920,36,34,4827.79,8251.00,0.00
2024-12-08 17:16:37,71,6920,36,35,4759.80,8251.01,0.00
2024-12-08 17:16:37,70,6920,36,34,4799.53,8251.10,0.00
2024-12-08 17:16:37,70,6921,36,34,4820.13,8252.00,0.00
2024-12-08 17:16:37,71,6921,37,34,4752.24,8252.01,0.00
2024-12-08 17:16:37,70,6921,36,34,4818.95,8252.02,0.00
2024-12-08 17:16:37,70,6922,36,34,4832.50,8253.00,0.00
2024-12-08 17:16:37,71,6922,36,35,4764.44,8253.01,0.00
2024-12-08 17:16:37,70,6922,36,34,4804.23,8253.10,0.00
2024-12-08 17:16:37,70,6923,36,34,4823.81,8254.00,0.00
2024-12-08 17:16:37,71,6923,37,34,4755.87,8254.01,0.00
2024-12-08 17:16:37,70,6923,36,34,4790.82,8254.13,0.00
2024-12-08 17:16:37,70,6924,36,34,4803.39,8255.00,0.00
2024-12-08 17:16:37,71,6924,37,34,4735.74,8255.01,0.00
2024-12-08 17:16:37,70,6924,37,33,4776.28,8255.10,0.00
2024-12-08 17:16:37,70,6925,37,33,4768.58,8256.00,0.00
2024-12-08 17:16:37,71,6925,37,34,4701.42,8256.01,0.00
2024-12-08 17:16:37,70,6925,36,34,4735.58,8256.13,0.00
2024-12-08 17:16:37,70,6926,36,34,4711.08,8257.00,0.00
2024-12-08 17:16:37,71,6926,37,34,4644.72,8257.01,0.00
2024-12-08 17:16:37,70,6926,37,33,4685.14,8257.10,0.00
2024-12-08 17:16:37,69,6926,36,33,4725.53,8257.13,0.00
2024-12-08 17:16:37,68,6926,35,33,4737.20,8257.68,0.00
2024-12-08 17:16:37,68,6927,35,33,4803.24,8258.00,0.00
2024-12-08 17:16:37,69,6927,35,34,4733.63,8258.02,0.00
2024-12-08 17:16:37,70,6926,36,34,4629.48,8258.20,0.00
2024-12-08 17:16:37,70,6927,36,34,4632.63,8259.00,0.00
2024-12-08 17:16:37,71,6927,36,35,4567.38,8259.01,0.00
2024-12-08 17:16:37,70,6927,36,34,4606.69,8259.10,0.00
2024-12-08 17:16:37,69,6927,35,34,4626.64,8259.65,0.00
2024-12-08 17:16:37,69,6928,35,34,4812.79,8260.00,0.00
2024-12-08 17:16:37,70,6928,36,34,4744.03,8260.02,0.00
2024-12-08 17:16:37,70,6929,36,34,4733.99,8261.00,0.00
2024-12-08 17:16:37,71,6929,37,34,4667.31,8261.01,0.00
2024-12-08 17:16:37,70,6929,36,34,4731.63,8261.03,0.00
2024-12-08 17:16:37,69,6929,36,33,4776.27,8261.09,0.00
2024-12-08 17:16:37,69,6930,36,33,4793.10,8262.00,0.00
2024-12-08 17:16:37,70,6930,36,34,4724.63,8262.02,0.00
2024-12-08 17:16:38,70,6931,36,34,4701.24,8263.00,0.00
2024-12-08 17:16:38,71,6931,37,34,4635.03,8263.01,0.00
2024-12-08 17:16:38,71,6932,37,34,4603.70,8264.00,0.00
2024-12-08 17:16:38,72,6932,37,35,4539.76,8264.01,0.00
2024-12-08 17:16:38,73,6931,37,36,4387.02,8264.73,0.00
2024-12-08 17:16:38,73,6932,37,36,4455.16,8265.00,0.00
2024-12-08 17:16:38,74,6932,37,37,4394.96,8265.01,0.00
2024-12-08 17:16:38,73,6932,37,36,4437.47,8265.14,0.00
2024-12-08 17:16:38,73,6933,37,36,4555.53,8266.00,0.00
2024-12-08 17:16:38,74,6933,38,36,4493.97,8266.01,0.00
2024-12-08 17:16:38,73,6933,37,36,4538.55,8266.03,0.00
2024-12-08 17:16:38,73,6934,37,36,4535.09,8267.00,0.00
2024-12-08 17:16:38,74,6934,37,37,4473.81,8267.01,0.00
2024-12-08 17:16:38,73,6934,37,36,4502.60,8267.12,0.00
2024-12-08 17:16:38,73,6935,37,36,4516.02,8268.00,0.00
2024-12-08 17:16:38,74,6935,38,36,4455.00,8268.01,0.00
2024-12-08 17:16:38,73,6935,37,36,4448.36,8268.33,0.00
2024-12-08 17:16:38,73,6936,37,36,4504.36,8269.00,0.00
2024-12-08 17:16:38,74,6936,38,36,4443.49,8269.01,0.00
2024-12-08 17:16:38,73,6936,37,36,4499.83,8269.06,0.00
2024-12-08 17:16:38,72,6936,37,35,4529.16,8269.11,0.00
2024-12-08 17:16:38,71,6936,36,35,4592.95,8269.11,0.00
2024-12-08 17:16:38,71,6937,36,35,4610.06,8270.00,0.00
2024-12-08 17:16:38,72,6937,36,36,4546.03,8270.01,0.00
2024-12-08 17:16:38,71,6937,35,36,4483.75,8270.83,0.00
2024-12-08 17:16:38,71,6938,35,36,4585.98,8271.00,0.00
2024-12-08 17:16:38,72,6938,35,37,4522.29,8271.01,0.00
2024-12-08 17:16:38,71,6938,35,36,4539.24,8271.13,0.00
2024-12-08 17:16:38,70,6938,34,36,4602.91,8271.13,0.00
2024-12-08 17:16:38,70,6939,34,36,4649.02,8272.00,0.00
2024-12-08 17:16:38,71,6939,35,36,4583.54,8272.01,0.00
2024-12-08 17:16:38,71,6940,35,36,4554.98,8273.00,0.00
2024-12-08 17:16:38,72,6940,36,36,4491.72,8273.01,0.00
2024-12-08 17:16:38,71,6940,35,36,4547.39,8273.10,0.00
2024-12-08 17:16:38,70,6940,35,35,4587.54,8273.11,0.00
2024-12-08 17:16:38,70,6941,35,35,4609.32,8274.00,0.00
2024-12-08 17:16:38,71,6941,36,35,4544.40,8274.01,0.00
2024-12-08 17:16:38,70,6941,36,34,4586.19,8274.11,0.00
2024-12-08 17:16:38,70,6942,36,34,4607.81,8275.00,0.00
2024-12-08 17:16:38,71,6942,37,34,4542.92,8275.01,0.00
2024-12-08 17:16:38,71,6943,37,34,4531.73,8276.00,0.00
2024-12-08 17:16:38,72,6943,38,34,4468.79,8276.01,0.00
2024-12-08 17:16:38,72,6944,38,34,4456.68,8277.00,0.00
2024-12-08 17:16:38,73,6944,39,34,4395.63,8277.01,0.00
2024-12-08 17:16:38,72,6944,38,34,4446.36,8277.14,0.00
2024-12-08 17:16:38,71,6944,38,33,4504.33,8277.17,0.00
2024-12-08 17:16:38,71,6945,38,33,4529.33,8278.00,0.00
2024-12-08 17:16:38,72,6945,39,33,4466.42,8278.01,0.00
2024-12-08 17:16:38,73,6944,39,34,4320.54,8278.80,0.00
2024-12-08 17:16:38,73,6945,39,34,4490.22,8279.00,0.00
2024-12-08 17:16:38,74,6945,40,34,4429.54,8279.01,0.00
2024-12-08 17:16:38,73,6945,39,34,4489.09,8279.01,0.00
2024-12-08 17:16:39,73,6946,39,34,4588.29,8280.00,0.00
2024-12-08 17:16:39,74,6946,39,35,4526.29,8280.01,0.00
2024-12-08 17:16:39,73,6946,39,34,4574.71,8280.16,0.00
2024-12-08 17:16:39,73,6947,39,34,4594.65,8281.00,0.00
2024-12-08 17:16:39,74,6947,40,34,4532.56,8281.01,0.00
2024-12-08 17:16:39,73,6947,39,34,4590.12,8281.07,0.00
2024-12-08 17:16:39,73,6948,39,34,4577.72,8282.00,0.00
2024-12-08 17:16:39,74,6948,39,35,4515.86,8282.01,0.00
2024-12-08 17:16:39,74,6949,39,35,4493.85,8283.00,0.00
2024-12-08 17:16:39,75,6949,39,36,4433.93,8283.01,0.00
2024-12-08 17:16:39,74,6949,39,35,4474.86,8283.20,0.00
2024-12-08 17:16:39,74,6950,39,35,4486.10,8284.00,0.00
2024-12-08 17:16:39,75,6950,40,35,4426.29,8284.01,0.00
2024-12-08 17:16:39,74,6950,40,34,4484.98,8284.01,0.00
2024-12-08 17:16:39,74,6951,40,34,4452.48,8285.00,0.00
2024-12-08 17:16:39,75,6951,40,35,4393.12,8285.01,0.00
2024-12-08 17:16:39,75,6952,40,35,4354.73,8286.00,0.00
2024-12-08 17:16:39,76,6952,40,36,4297.43,8286.01,0.00
2024-12-08 17:16:39,75,6952,39,36,4341.50,8286.17,0.00
2024-12-08 17:16:39,74,6952,39,35,4399.05,8286.18,0.00
2024-12-08 17:16:39,73,6952,38,35,4457.04,8286.18,0.00
2024-12-08 17:16:39,73,6953,38,35,4482.87,8287.00,0.00
2024-12-08 17:16:39,74,6953,38,36,4422.29,8287.01,0.00
2024-12-08 17:16:39,73,6953,38,35,4481.73,8287.01,0.00
2024-12-08 17:16:39,73,6954,38,35,4449.78,8288.00,0.00
2024-12-08 17:16:39,74,6954,39,35,4389.65,8288.01,0.00
2024-12-08 17:16:39,74,6955,39,35,4350.54,8289.00,0.00
2024-12-08 17:16:39,75,6955,39,36,4292.53,8289.01,0.00
2024-12-08 17:16:39,74,6955,39,35,4331.53,8289.20,0.00
2024-12-08 17:16:39,73,6955,38,35,4317.89,8289.81,0.00
2024-12-08 17:16:39,73,6956,38,35,4384.05,8290.00,0.00
2024-12-08 17:16:39,74,6956,38,36,4324.81,8290.01,0.00
2024-12-08 17:16:39,74,6957,38,36,4288.80,8291.00,0.00
2024-12-08 17:16:39,75,6957,38,37,4231.61,8291.01,0.00
2024-12-08 17:16:39,74,6957,37,37,4279.83,8291.01,0.00
2024-12-08 17:16:39,74,6958,37,37,4263.22,8292.00,0.00
2024-12-08 17:16:39,75,6958,38,37,4206.38,8292.01,0.00
2024-12-08 17:16:39,74,6958,38,36,4257.81,8292.07,0.00
2024-12-08 17:16:39,73,6958,38,35,4305.92,8292.08,0.00
2024-12-08 17:16:39,72,6958,38,34,4324.97,8292.43,0.00
2024-12-08 17:16:39,73,6957,38,35,4252.18,8292.62,0.00
2024-12-08 17:16:39,73,6958,38,35,4336.32,8293.00,0.00
2024-12-08 17:16:39,74,6958,39,35,4277.72,8293.01,0.00
2024-12-08 17:16:39,73,6958,38,35,4305.66,8293.15,0.00
2024-12-08 17:16:39,73,6959,38,35,4436.80,8294.00,0.00
2024-12-08 17:16:39,74,6959,38,36,4376.84,8294.01,0.00
2024-12-08 17:16:39,73,6959,38,35,4435.66,8294.01,0.00
2024-12-08 17:16:39,72,6959,38,34,4465.03,8294.14,0.00
2024-12-08 17:16:39,71,6959,37,34,4508.32,8294.35,0.00
2024-12-08 17:16:39,71,6960,37,34,4545.98,8295.00,0.00
2024-12-08 17:16:39,72,6960,38,34,4482.84,8295.01,0.00
2024-12-08 17:16:39,71,6960,37,34,4544.81,8295.03,0.00
2024-12-08 17:16:39,70,6960,36,34,4578.94,8295.13,0.00
2024-12-08 17:16:39,70,6961,36,34,4596.73,8296.00,0.00
2024-12-08 17:16:39,71,6961,36,35,4531.99,8296.01,0.00
2024-12-08 17:16:39,71,6962,36,35,4513.23,8297.00,0.00
2024-12-08 17:16:39,72,6962,37,35,4450.54,8297.01,0.00
2024-12-08 17:16:39,71,6962,37,34,4496.89,8297.17,0.00
2024-12-08 17:16:40,71,6963,37,34,4512.29,8298.00,0.00
2024-12-08 17:16:40,72,6963,38,34,4449.62,8298.01,0.00
2024-12-08 17:16:40,71,6963,37,34,4456.32,8298.41,0.00
2024-12-08 17:16:40,72,6962,38,34,4362.96,8298.72,0.00
2024-12-08 17:16:40,72,6963,38,34,4515.77,8299.00,0.00
2024-12-08 17:16:40,73,6963,39,34,4453.91,8299.01,0.00
2024-12-08 17:16:40,72,6963,38,34,4513.47,8299.04,0.00
2024-12-08 17:16:40,72,6964,38,34,4601.21,8300.00,0.00
2024-12-08 17:16:40,73,6964,38,35,4538.18,8300.01,0.00
2024-12-08 17:16:40,72,6964,38,34,4588.55,8300.15,0.00
2024-12-08 17:16:40,72,6965,38,34,4590.57,8301.00,0.00
2024-12-08 17:16:40,73,6965,39,34,4527.68,8301.01,0.00
2024-12-08 17:16:40,73,6966,39,34,4490.78,8302.00,0.00
2024-12-08 17:16:40,74,6966,40,34,4430.09,8302.01,0.00
2024-12-08 17:16:40,73,6966,40,33,4454.41,8302.16,0.00
2024-12-08 17:16:40,73,6967,40,33,4449.73,8303.00,0.00
2024-12-08 17:16:40,74,6967,40,34,4389.59,8303.01,0.00
2024-12-08 17:16:40,73,6967,39,34,4447.45,8303.04,0.00
2024-12-08 17:16:40,73,6968,39,34,4407.00,8304.00,0.00
2024-12-08 17:16:40,74,6968,40,34,4347.44,8304.01,0.00
2024-12-08 17:16:40,73,6968,40,33,4396.60,8304.03,0.00
2024-12-08 17:16:40,72,6968,39,33,4457.66,8304.03,0.00
2024-12-08 17:16:40,72,6969,39,33,4458.72,8305.00,0.00
2024-12-08 17:16:40,73,6969,39,34,4397.64,8305.01,0.00
2024-12-08 17:16:40,72,6969,38,34,4457.56,8305.03,0.00
2024-12-08 17:16:40,71,6969,38,33,4477.29,8305.13,0.00
2024-12-08 17:16:40,70,6969,38,32,4486.15,8305.41,0.00
2024-12-08 17:16:40,71,6968,39,32,4409.01,8305.61,0.00
2024-12-08 17:16:40,71,6969,39,32,4537.73,8306.00,0.00
2024-12-08 17:16:40,72,6969,39,33,4474.71,8306.01,0.00
2024-12-08 17:16:40,71,6969,39,32,4513.64,8306.06,0.00
2024-12-08 17:16:40,71,6970,39,32,4591.63,8307.00,0.00
2024-12-08 17:16:40,72,6970,40,32,4527.86,8307.01,0.00
2024-12-08 17:16:40,71,6970,40,31,4561.23,8307.11,0.00
2024-12-08 17:16:40,70,6970,39,31,4624.02,8307.13,0.00
2024-12-08 17:16:40,69,6970,38,31,4670.68,8307.38,0.00
2024-12-08 17:16:40,69,6971,38,31,4679.08,8308.00,0.00
2024-12-08 17:16:40,70,6971,38,32,4612.24,8308.02,0.00
2024-12-08 17:16:40,70,6972,38,32,4561.11,8309.00,0.00
2024-12-08 17:16:40,71,6972,39,32,4496.87,8309.01,0.00
2024-12-08 17:16:40,70,6972,38,32,4559.92,8309.02,0.00
2024-12-08 17:16:40,69,6972,37,32,4626.00,8309.02,0.00
2024-12-08 17:16:40,68,6972,36,32,4662.29,8309.10,0.00
2024-12-08 17:16:40,69,6971,36,33,4579.13,8309.32,0.00
2024-12-08 17:16:40,68,6971,35,33,4695.70,8309.38,0.00
2024-12-08 17:16:40,68,6972,35,33,4692.36,8310.00,0.00
2024-12-08 17:16:40,69,6972,36,33,4624.35,8310.02,0.00
2024-12-08 17:16:40,68,6972,36,32,4667.93,8310.09,0.00
2024-12-08 17:16:40,67,6972,35,32,4662.21,8310.81,0.00
2024-12-08 17:16:40,67,6973,35,32,4835.79,8311.00,0.00
2024-12-08 17:16:40,68,6973,35,33,4764.68,8311.02,0.00
2024-12-08 17:16:40,69,6972,35,34,4649.94,8311.31,0.00
2024-12-08 17:16:40,68,6972,34,34,4629.69,8311.91,0.00
2024-12-08 17:16:40,68,6973,34,34,4744.39,8312.00,0.00
2024-12-08 17:16:40,69,6973,35,34,4675.63,8312.02,0.00
2024-12-08 17:16:40,68,6973,35,33,4715.07,8312.10,0.00
2024-12-08 17:16:40,68,6974,35,33,4832.85,8313.00,0.00
2024-12-08 17:16:40,69,6974,36,33,4762.81,8313.02,0.00
2024-12-08 17:16:40,68,6974,35,33,4805.97,8313.09,0.00
2024-12-08 17:16:40,67,6974,34,33,4851.65,8313.10,0.00
2024-12-08 17:16:40,67,6975,34,33,4862.87,8314.00,0.00
2024-12-08 17:16:40,68,6975,34,34,4791.36,8314.02,0.00
2024-12-08 17:16:40,67,6975,34,33,4835.59,8314.09,0.00
2024-12-08 17:16:41,67,6976,34,33,4812.62,8315.00,0.00
2024-12-08 17:16:41,68,6976,35,33,4741.85,8315.02,0.00
2024-12-08 17:16:41,67,6976,34,33,4755.55,8315.10,0.00
2024-12-08 17:16:41,68,6975,35,33,4677.10,8315.24,0.00
2024-12-08 17:16:41,67,6975,35,32,4755.58,8315.42,0.00
2024-12-08 17:16:41,67,6976,35,32,4816.14,8316.00,0.00
2024-12-08 17:16:41,68,6976,35,33,4745.31,8316.02,0.00
2024-12-08 17:16:41,67,6976,35,32,4787.61,8316.09,0.00
2024-12-08 17:16:41,67,6977,35,32,4870.80,8317.00,0.00
2024-12-08 17:16:41,68,6977,36,32,4799.17,8317.02,0.00
2024-12-08 17:16:41,68,6978,36,32,4723.37,8318.00,0.00
2024-12-08 17:16:41,69,6978,36,33,4654.92,8318.02,0.00
2024-12-08 17:16:41,68,6978,35,33,4643.98,8318.35,0.00
2024-12-08 17:16:41,69,6977,35,34,4558.72,8318.59,0.00
2024-12-08 17:16:41,69,6978,35,34,4611.31,8319.00,0.00
2024-12-08 17:16:41,70,6978,36,34,4545.43,8319.02,0.00
2024-12-08 17:16:41,69,6978,35,34,4608.90,8319.04,0.00
2024-12-08 17:16:41,68,6978,35,33,4651.00,8319.09,0.00
2024-12-08 17:16:41,67,6978,34,33,4695.63,8319.16,0.00
2024-12-08 17:16:41,67,6979,34,33,4807.78,8320.00,0.00
2024-12-08 17:16:41,68,6979,34,34,4737.07,8320.02,0.00
2024-12-08 17:16:41,67,6979,33,34,4675.57,8320.93,0.00
2024-12-08 17:16:41,67,6980,33,34,4768.77,8321.00,0.00
2024-12-08 17:16:41,68,6980,33,35,4698.64,8321.02,0.00
2024-12-08 17:16:41,67,6980,33,34,4740.22,8321.09,0.00
2024-12-08 17:16:41,66,6980,32,34,4810.78,8321.11,0.00
2024-12-08 17:16:41,65,6980,32,33,4819.13,8321.85,0.00
2024-12-08 17:16:41,65,6981,32,33,4908.87,8322.00,0.00
2024-12-08 17:16:41,66,6981,33,33,4834.49,8322.02,0.00
2024-12-08 17:16:41,65,6981,33,32,4879.44,8322.09,0.00
2024-12-08 17:16:41,65,6982,33,32,4906.90,8323.00,0.00
2024-12-08 17:16:41,66,6982,34,32,4832.55,8323.02,0.00
2024-12-08 17:16:41,66,6983,34,32,4826.83,8324.00,0.00
2024-12-08 17:16:41,67,6983,35,32,4754.78,8324.02,0.00
2024-12-08 17:16:41,66,6983,35,31,4795.31,8324.11,0.00
2024-12-08 17:16:41,66,6984,35,31,4822.36,8325.00,0.00
2024-12-08 17:16:41,67,6984,36,31,4750.39,8325.02,0.00
2024-12-08 17:16:41,67,6985,36,31,4743.50,8326.00,0.00
2024-12-08 17:16:41,68,6985,36,32,4673.74,8326.02,0.00
2024-12-08 17:16:41,68,6986,36,32,4665.49,8327.00,0.00
2024-12-08 17:16:41,69,6986,36,33,4597.87,8327.02,0.00
2024-12-08 17:16:41,69,6987,36,33,4588.09,8328.00,0.00
2024-12-08 17:16:41,70,6987,36,34,4522.55,8328.02,0.00
2024-12-08 17:16:41,69,6987,36,33,4574.83,8328.10,0.00
2024-12-08 17:16:41,69,6988,36,33,4595.97,8329.00,0.00
2024-12-08 17:16:41,70,6988,37,33,4530.32,8329.02,0.00
2024-12-08 17:16:41,69,6988,36,33,4594.77,8329.02,0.00
2024-12-08 17:16:41,69,6989,36,33,4584.36,8330.00,0.00
2024-12-08 17:16:41,70,6989,37,33,4518.87,8330.02,0.00
2024-12-08 17:16:41,69,6989,37,32,4577.12,8330.02,0.00
2024-12-08 17:16:41,69,6990,37,32,4590.72,8331.00,0.00
2024-12-08 17:16:41,70,6990,38,32,4525.13,8331.02,0.00
2024-12-08 17:16:41,69,6990,38,31,4568.99,8331.07,0.00
2024-12-08 17:16:41,69,6991,38,31,4587.59,8332.00,0.00
2024-12-08 17:16:41,70,6991,39,31,4522.05,8332.02,0.00
2024-12-08 17:16:41,70,6992,39,31,4510.99,8333.00,0.00
2024-12-08 17:16:41,71,6992,40,31,4447.46,8333.01,0.00
2024-12-08 17:16:41,70,6992,40,30,4488.38,8333.07,0.00
2024-12-08 17:16:42,70,6993,40,30,4505.99,8334.00,0.00
2024-12-08 17:16:42,71,6993,41,30,4442.52,8334.01,0.00
2024-12-08 17:16:42,71,6994,41,30,4430.16,8335.00,0.00
2024-12-08 17:16:42,72,6994,41,31,4368.63,8335.01,0.00
2024-12-08 17:16:42,71,6994,41,30,4405.52,8335.09,0.00
2024-12-08 17:16:42,71,6994,41,30,4420.55,8336.00,0.00
2024-12-08 17:16:42,72,6994,41,31,4359.15,8336.01,0.00
2024-12-08 17:16:42,73,6993,41,32,4298.30,8336.06,0.00
2024-12-08 17:16:42,73,6994,41,32,4387.69,8337.00,0.00
2024-12-08 17:16:42,74,6994,41,33,4328.40,8337.01,0.00
2024-12-08 17:16:42,73,6994,41,32,4364.87,8337.08,0.00
2024-12-08 17:16:42,73,6995,41,32,4487.19,8338.00,0.00
2024-12-08 17:16:42,74,6995,41,33,4426.55,8338.01,0.00
2024-12-08 17:16:42,73,6995,40,33,4477.69,8338.11,0.00
2024-12-08 17:16:42,73,6996,40,33,4469.16,8339.00,0.00
2024-12-08 17:16:42,74,6996,41,33,4408.77,8339.01,0.00
2024-12-08 17:16:42,73,6996,40,33,4388.28,8339.56,0.00
2024-12-08 17:16:42,73,6997,40,33,4463.97,8340.00,0.00
2024-12-08 17:16:42,74,6997,40,34,4403.65,8340.01,0.00
2024-12-08 17:16:42,73,6997,39,34,4453.72,8340.14,0.00
2024-12-08 17:16:42,72,6997,39,33,4514.42,8340.14,0.00
2024-12-08 17:16:42,72,6998,39,33,4534.00,8341.00,0.00
2024-12-08 17:16:42,73,6998,39,34,4471.89,8341.01,0.00
2024-12-08 17:16:42,72,6998,38,34,4532.84,8341.01,0.00
2024-12-08 17:16:42,72,6999,38,34,4518.34,8342.00,0.00
2024-12-08 17:16:42,73,6999,39,34,4456.45,8342.01,0.00
2024-12-08 17:16:42,72,6999,38,34,4494.04,8342.10,0.00
2024-12-08 17:16:42,71,6999,38,33,4530.32,8342.13,0.00
2024-12-08 17:16:42,71,7000,38,33,4572.54,8343.00,0.00
2024-12-08 17:16:42,72,7000,38,34,4509.03,8343.01,0.00
2024-12-08 17:16:42,72,7001,38,34,4493.25,8344.00,0.00
2024-12-08 17:16:42,73,7001,39,34,4431.70,8344.01,0.00
2024-12-08 17:16:42,72,7001,39,33,4460.83,8344.13,0.00
2024-12-08 17:16:42,71,7001,38,33,4449.20,8344.73,0.00
2024-12-08 17:16:42,71,7002,38,33,4544.62,8345.00,0.00
2024-12-08 17:16:42,72,7002,38,34,4481.50,8345.01,0.00
2024-12-08 17:16:42,71,7002,37,34,4511.74,8345.13,0.00
2024-12-08 17:16:42,71,7003,37,34,4533.41,8346.00,0.00
2024-12-08 17:16:42,72,7003,37,35,4470.45,8346.01,0.00
2024-12-08 17:16:42,71,7003,37,34,4500.53,8346.13,0.00
2024-12-08 17:16:42,71,7004,37,34,4521.44,8347.00,0.00
2024-12-08 17:16:42,72,7004,37,35,4458.65,8347.01,0.00
2024-12-08 17:16:42,71,7004,36,35,4418.88,8347.82,0.00
2024-12-08 17:16:42,71,7005,36,35,4521.33,8348.00,0.00
2024-12-08 17:16:42,72,7005,37,35,4458.54,8348.01,0.00
2024-12-08 17:16:42,71,7005,37,34,4489.61,8348.13,0.00
2024-12-08 17:16:42,71,7006,37,34,4506.88,8349.00,0.00
2024-12-08 17:16:42,72,7006,38,34,4444.28,8349.01,0.00
2024-12-08 17:16:42,71,7006,37,34,4503.37,8349.06,0.00
2024-12-08 17:16:42,71,7007,37,34,4490.40,8350.00,0.00
2024-12-08 17:16:42,72,7007,38,34,4428.04,8350.01,0.00
2024-12-08 17:16:42,71,7007,38,33,4461.02,8350.11,0.00
2024-12-08 17:16:42,71,7008,38,33,4475.35,8351.00,0.00
2024-12-08 17:16:42,72,7008,39,33,4413.19,8351.01,0.00
2024-12-08 17:16:43,72,7009,39,33,4393.88,8352.00,0.00
2024-12-08 17:16:43,73,7009,39,34,4333.69,8352.01,0.00
2024-12-08 17:16:43,72,7009,39,33,4363.74,8352.13,0.00
2024-12-08 17:16:43,72,7010,39,33,4374.65,8353.00,0.00
2024-12-08 17:16:43,73,7010,39,34,4314.73,8353.01,0.00
2024-12-08 17:16:43,72,7010,38,34,4371.19,8353.06,0.00
2024-12-08 17:16:43,72,7011,38,34,4353.30,8354.00,0.00
2024-12-08 17:16:43,73,7011,38,35,4293.66,8354.01,0.00
2024-12-08 17:16:43,72,7011,38,34,4325.47,8354.11,0.00
2024-12-08 17:16:43,71,7011,37,34,4382.88,8354.16,0.00
2024-12-08 17:16:43,71,7012,37,34,4398.87,8355.00,0.00
2024-12-08 17:16:43,72,7012,37,35,4337.78,8355.01,0.00
2024-12-08 17:16:43,71,7012,36,35,4396.53,8355.03,0.00
2024-12-08 17:16:43,71,7013,36,35,4380.08,8356.00,0.00
2024-12-08 17:16:43,72,7013,36,36,4319.25,8356.01,0.00
2024-12-08 17:16:43,71,7013,36,35,4354.21,8356.10,0.00
2024-12-08 17:16:43,70,7013,35,35,4412.85,8356.14,0.00
2024-12-08 17:16:43,69,7013,34,35,4429.66,8356.42,0.00
2024-12-08 17:16:43,69,7014,34,35,4498.46,8357.00,0.00
2024-12-08 17:16:43,70,7014,34,36,4434.19,8357.02,0.00
2024-12-08 17:16:43,69,7014,33,36,4460.95,8357.16,0.00
2024-12-08 17:16:43,69,7015,33,36,4484.17,8358.00,0.00
2024-12-08 17:16:43,70,7015,34,36,4420.11,8358.02,0.00
2024-12-08 17:16:43,69,7015,33,36,4401.92,8358.42,0.00
2024-12-08 17:16:43,69,7016,33,36,4471.04,8359.00,0.00
2024-12-08 17:16:43,70,7016,34,36,4407.17,8359.02,0.00
2024-12-08 17:16:43,69,7016,33,36,4467.42,8359.06,0.00
2024-12-08 17:16:43,68,7016,33,35,4506.01,8359.10,0.00
2024-12-08 17:16:43,68,7017,33,35,4526.11,8360.00,0.00
2024-12-08 17:16:43,69,7017,34,35,4460.51,8360.02,0.00
2024-12-08 17:16:43,68,7017,33,35,4490.49,8360.15,0.00
2024-12-08 17:16:43,68,7018,33,35,4514.73,8361.00,0.00
2024-12-08 17:16:43,69,7018,34,35,4449.30,8361.02,0.00
2024-12-08 17:16:43,68,7018,33,35,4512.29,8361.03,0.00
2024-12-08 17:16:43,67,7018,33,34,4557.18,8361.09,0.00
2024-12-08 17:16:43,67,7019,33,34,4578.96,8362.00,0.00
2024-12-08 17:16:43,68,7019,33,35,4511.62,8362.02,0.00
2024-12-08 17:16:43,67,7019,32,35,4566.49,8362.06,0.00
2024-12-08 17:16:43,66,7019,31,35,4605.29,8362.12,0.00
2024-12-08 17:16:43,65,7019,30,35,4674.85,8362.12,0.00
2024-12-08 17:16:43,65,7020,30,35,4729.56,8363.00,0.00
2024-12-08 17:16:43,66,7020,30,36,4657.90,8363.02,0.00
2024-12-08 17:16:43,65,7020,30,35,4706.42,8363.08,0.00
2024-12-08 17:16:43,65,7021,30,35,4732.70,8364.00,0.00
2024-12-08 17:16:43,66,7021,30,36,4660.99,8364.02,0.00
2024-12-08 17:16:43,65,7021,29,36,4696.70,8364.12,0.00
2024-12-08 17:16:43,64,7021,28,36,4745.35,8364.41,0.00
2024-12-08 17:16:43,64,7022,28,36,4800.69,8365.00,0.00
2024-12-08 17:16:43,65,7022,29,36,4726.83,8365.02,0.00
2024-12-08 17:16:43,64,7022,29,35,4773.26,8365.09,0.00
2024-12-08 17:16:43,63,7022,28,35,4802.72,8365.51,0.00
2024-12-08 17:16:43,63,7023,28,35,4894.73,8366.00,0.00
2024-12-08 17:16:43,64,7023,29,35,4818.25,8366.02,0.00
2024-12-08 17:16:43,64,7024,29,35,4814.91,8367.00,0.00
2024-12-08 17:16:43,65,7024,29,36,4740.83,8367.02,0.00
2024-12-08 17:16:43,64,7024,29,35,4786.17,8367.09,0.00
2024-12-08 17:16:43,64,7025,29,35,4815.48,8368.00,0.00
2024-12-08 17:16:43,65,7025,30,35,4741.40,8368.02,0.00
2024-12-08 17:16:43,64,7025,29,35,4780.21,8368.13,0.00
2024-12-08 17:16:43,63,7025,28,35,4849.45,8368.16,0.00
2024-12-08 17:16:43,64,7024,29,35,4739.88,8368.59,0.00
2024-12-08 17:16:43,64,7025,29,35,4870.98,8369.00,0.00
2024-12-08 17:16:43,65,7025,30,35,4796.04,8369.02,0.00
2024-12-08 17:16:43,64,7025,30,34,4842.23,8369.09,0.00
2024-12-08 17:16:44,64,7026,30,34,5002.34,8370.00,0.00
2024-12-08 17:16:44,65,7026,30,35,4925.39,8370.02,0.00
2024-12-08 17:16:44,65,7027,30,35,4920.82,8371.00,0.00
2024-12-08 17:16:44,66,7027,31,35,4846.26,8371.02,0.00
2024-12-08 17:16:44,65,7027,31,34,4893.79,8371.09,0.00
2024-12-08 17:16:44,65,7028,31,34,4921.41,8372.00,0.00
2024-12-08 17:16:44,66,7028,31,35,4846.84,8372.02,0.00
2024-12-08 17:16:44,65,7028,30,35,4884.08,8372.14,0.00
2024-12-08 17:16:44,65,7029,30,35,4915.56,8373.00,0.00
2024-12-08 17:16:44,66,7029,31,35,4841.08,8373.02,0.00
2024-12-08 17:16:44,65,7029,30,35,4912.99,8373.03,0.00
2024-12-08 17:16:44,64,7029,30,34,4964.90,8373.08,0.00
2024-12-08 17:16:44,64,7030,30,34,4992.96,8374.00,0.00
2024-12-08 17:16:44,65,7030,31,34,4916.14,8374.02,0.00
2024-12-08 17:16:44,64,7030,30,34,4958.96,8374.11,0.00
2024-12-08 17:16:44,64,7031,30,34,4989.63,8375.00,0.00
2024-12-08 17:16:44,65,7031,30,35,4912.87,8375.02,0.00
2024-12-08 17:16:44,64,7031,30,34,4983.61,8375.08,0.00
2024-12-08 17:16:44,64,7032,30,34,5011.68,8376.00,0.00
2024-12-08 17:16:44,65,7032,30,35,4934.58,8376.02,0.00
2024-12-08 17:16:44,66,7031,30,36,4799.06,8376.47,0.00
2024-12-08 17:16:44,66,7032,30,36,4865.47,8377.00,0.00
2024-12-08 17:16:44,67,7032,31,36,4792.85,8377.02,0.00
2024-12-08 17:16:44,66,7032,31,35,4841.36,8377.08,0.00
2024-12-08 17:16:44,65,7032,30,35,4854.24,8377.59,0.00
2024-12-08 17:16:44,65,7033,30,35,5077.54,8378.00,0.00
2024-12-08 17:16:44,66,7033,31,35,5000.60,8378.02,0.00
2024-12-08 17:16:44,66,7034,31,35,4994.85,8379.00,0.00
2024-12-08 17:16:44,67,7034,32,35,4920.30,8379.02,0.00
2024-12-08 17:16:44,66,7034,31,35,4991.05,8379.06,0.00
2024-12-08 17:16:44,65,7034,31,34,5047.21,8379.06,0.00
2024-12-08 17:16:44,64,7034,31,33,5122.38,8379.09,0.00
2024-12-08 17:16:44,64,7035,31,33,5150.68,8380.00,0.00
2024-12-08 17:16:44,65,7035,32,33,5071.44,8380.02,0.00
2024-12-08 17:16:44,64,7035,31,33,5117.97,8380.09,0.00
2024-12-08 17:16:44,64,7036,31,33,5142.29,8381.00,0.00
2024-12-08 17:16:44,65,7036,31,34,5063.18,8381.02,0.00
2024-12-08 17:16:44,64,7036,30,34,5139.68,8381.03,0.00
2024-12-08 17:16:44,63,7036,30,33,5198.65,8381.05,0.00
2024-12-08 17:16:44,63,7037,30,33,5219.57,8382.00,0.00
2024-12-08 17:16:44,64,7037,30,34,5138.01,8382.02,0.00
2024-12-08 17:16:44,64,7038,30,34,5128.01,8383.00,0.00
2024-12-08 17:16:44,65,7038,30,35,5049.12,8383.02,0.00
2024-12-08 17:16:44,64,7038,30,34,5104.44,8383.05,0.00
2024-12-08 17:16:44,63,7038,29,34,5156.20,8383.08,0.00
2024-12-08 17:16:44,63,7039,29,34,5205.56,8384.00,0.00
2024-12-08 17:16:44,64,7039,30,34,5124.23,8384.02,0.00
2024-12-08 17:16:44,64,7040,30,34,5112.23,8385.00,0.00
2024-12-08 17:16:44,65,7040,31,34,5033.58,8385.02,0.00
2024-12-08 17:16:44,65,7041,31,34,5017.05,8386.00,0.00
2024-12-08 17:16:44,66,7041,31,35,4941.04,8386.02,0.00
2024-12-08 17:16:44,65,7041,31,34,5009.33,8386.09,0.00
2024-12-08 17:16:44,66,7040,31,35,4875.70,8386.73,0.00
2024-12-08 17:16:44,66,7041,31,35,4998.23,8387.00,0.00
2024-12-08 17:16:44,67,7041,31,36,4923.63,8387.02,0.00
2024-12-08 17:16:44,66,7041,31,35,4977.24,8387.09,0.00
2024-12-08 17:16:44,67,7040,31,36,4838.18,8387.81,0.00
2024-12-08 17:16:45,67,7041,31,36,5061.18,8388.00,0.00
2024-12-08 17:16:45,68,7041,32,36,4986.76,8388.02,0.00
2024-12-08 17:16:45,69,7040,33,36,4845.27,8388.29,0.00
2024-12-08 17:16:45,69,7041,33,36,5036.78,8389.00,0.00
2024-12-08 17:16:45,70,7041,33,37,4964.82,8389.02,0.00
2024-12-08 17:16:45,69,7041,32,37,5027.05,8389.02,0.00
2024-12-08 17:16:45,68,7041,32,36,5071.38,8389.07,0.00
2024-12-08 17:16:45,68,7042,32,36,5236.37,8390.00,0.00
2024-12-08 17:16:45,69,7042,32,37,5160.48,8390.02,0.00
2024-12-08 17:16:45,68,7042,31,37,5215.40,8390.06,0.00
2024-12-08 17:16:45,67,7042,30,37,5290.75,8390.07,0.00
2024-12-08 17:16:45,67,7043,30,37,5307.36,8391.00,0.00
2024-12-08 17:16:45,68,7043,30,38,5229.31,8391.02,0.00
2024-12-08 17:16:45,67,7043,29,38,5217.87,8391.46,0.00
2024-12-08 17:16:45,67,7044,29,38,5295.52,8392.00,0.00
2024-12-08 17:16:45,68,7044,29,39,5217.65,8392.02,0.00
2024-12-08 17:16:45,67,7044,28,39,5294.27,8392.02,0.00
2024-12-08 17:16:45,66,7044,28,38,5363.06,8392.09,0.00
2024-12-08 17:16:45,66,7045,28,38,5382.73,8393.00,0.00
2024-12-08 17:16:45,67,7045,28,39,5302.40,8393.02,0.00
2024-12-08 17:16:45,67,7046,28,39,5286.33,8394.00,0.00
2024-12-08 17:16:45,68,7046,28,40,5208.59,8394.02,0.00
2024-12-08 17:16:45,68,7047,28,40,5189.08,8395.00,0.00
2024-12-08 17:16:45,69,7047,29,40,5113.87,8395.02,0.00
2024-12-08 17:16:45,68,7047,29,39,5179.22,8395.10,0.00
2024-12-08 17:16:45,68,7048,29,39,5189.38,8396.00,0.00
2024-12-08 17:16:45,69,7048,29,40,5114.18,8396.02,0.00
2024-12-08 17:16:45,69,7049,29,40,5088.73,8397.00,0.00
2024-12-08 17:16:45,70,7049,30,40,5016.03,8397.02,0.00
2024-12-08 17:16:45,69,7049,29,40,5051.03,8397.13,0.00
2024-12-08 17:16:45,69,7050,29,40,5081.74,8398.00,0.00
2024-12-08 17:16:45,70,7050,29,41,5009.14,8398.02,0.00
2024-12-08 17:16:45,69,7050,29,40,5047.68,8398.12,0.00
2024-12-08 17:16:45,68,7050,28,40,5098.50,8398.24,0.00
2024-12-08 17:16:45,67,7050,27,40,5164.37,8398.36,0.00
2024-12-08 17:16:45,67,7051,27,40,5221.53,8399.00,0.00
2024-12-08 17:16:45,68,7051,27,41,5144.74,8399.02,0.00
2024-12-08 17:16:45,67,7051,26,41,5198.97,8399.07,0.00
2024-12-08 17:16:45,67,7052,26,41,5207.55,8400.00,0.00
2024-12-08 17:16:45,68,7052,27,41,5130.97,8400.02,0.00
2024-12-08 17:16:45,67,7052,27,40,5173.72,8400.10,0.00
2024-12-08 17:16:45,66,7052,26,40,5183.17,8400.56,0.00
2024-12-08 17:16:45,66,7053,26,40,5266.67,8401.00,0.00
2024-12-08 17:16:45,67,7053,27,40,5188.07,8401.02,0.00
2024-12-08 17:16:45,67,7054,27,40,5172.88,8402.00,0.00
2024-12-08 17:16:45,68,7054,28,40,5096.81,8402.02,0.00
2024-12-08 17:16:45,68,7055,28,40,5079.46,8403.00,0.00
2024-12-08 17:16:45,69,7055,29,40,5005.84,8403.02,0.00
2024-12-08 17:16:45,69,7056,29,40,4986.34,8404.00,0.00
2024-12-08 17:16:45,70,7056,30,40,4915.11,8404.02,0.00
2024-12-08 17:16:45,69,7056,30,39,4963.21,8404.09,0.00
2024-12-08 17:16:45,70,7055,30,40,4805.72,8404.73,0.00
2024-12-08 17:16:45,70,7056,30,40,4923.62,8405.00,0.00
2024-12-08 17:16:45,71,7056,31,40,4854.27,8405.01,0.00
2024-12-08 17:16:45,71,7057,31,40,4948.91,8406.00,0.00
2024-12-08 17:16:45,72,7057,31,41,4880.17,8406.01,0.00
2024-12-08 17:16:45,71,7057,31,40,4931.16,8406.07,0.00
2024-12-08 17:16:45,71,7058,31,40,4934.41,8407.00,0.00
2024-12-08 17:16:45,72,7058,31,41,4865.88,8407.01,0.00
2024-12-08 17:16:45,73,7057,31,42,4744.09,8407.43,0.00
2024-12-08 17:16:46,72,7057,31,41,4839.68,8407.50,0.00
2024-12-08 17:16:46,72,7058,31,41,4890.06,8408.00,0.00
2024-12-08 17:16:46,73,7058,32,41,4823.07,8408.01,0.00
2024-12-08 17:16:46,72,7058,32,40,4884.22,8408.07,0.00
2024-12-08 17:16:46,72,7059,32,40,5015.60,8409.00,0.00
2024-12-08 17:16:46,73,7059,32,41,4946.89,8409.01,0.00
2024-12-08 17:16:46,74,7058,33,41,4772.15,8409.78,0.00
2024-12-08 17:16:46,74,7059,33,41,4883.71,8410.00,0.00
2024-12-08 17:16:46,75,7059,34,41,4818.59,8410.01,0.00
2024-12-08 17:16:46,74,7059,33,41,4881.44,8410.04,0.00
2024-12-08 17:16:46,73,7059,33,40,4929.88,8410.07,0.00
2024-12-08 17:16:46,72,7059,32,40,4980.83,8410.07,0.00
2024-12-08 17:16:46,72,7060,32,40,5136.78,8411.00,0.00
2024-12-08 17:16:46,73,7060,32,41,5066.41,8411.01,0.00
2024-12-08 17:16:46,72,7060,31,41,5133.28,8411.04,0.00
2024-12-08 17:16:46,72,7061,31,41,5123.37,8412.00,0.00
2024-12-08 17:16:46,73,7061,32,41,5053.19,8412.01,0.00
2024-12-08 17:16:46,72,7061,32,40,5103.52,8412.06,0.00
2024-12-08 17:16:46,73,7060,33,40,4978.47,8412.47,0.00
2024-12-08 17:16:46,73,7061,33,40,5087.21,8413.00,0.00
2024-12-08 17:16:46,74,7061,34,40,5018.46,8413.01,0.00
2024-12-08 17:16:46,74,7062,34,40,5117.98,8414.00,0.00
2024-12-08 17:16:46,75,7062,35,40,5049.74,8414.01,0.00
2024-12-08 17:16:46,74,7062,35,39,5099.80,8414.05,0.00
2024-12-08 17:16:46,74,7063,35,39,5111.77,8415.00,0.00
2024-12-08 17:16:46,75,7063,35,40,5043.61,8415.01,0.00
2024-12-08 17:16:46,75,7064,35,40,5027.02,8416.00,0.00
2024-12-08 17:16:46,76,7064,36,40,4960.88,8416.01,0.00
2024-12-08 17:16:46,75,7064,36,39,5010.20,8416.05,0.00
2024-12-08 17:16:46,75,7065,36,39,5017.77,8417.00,0.00
2024-12-08 17:16:46,76,7065,36,40,4951.75,8417.01,0.00
2024-12-08 17:16:46,76,7066,36,40,4931.17,8418.00,0.00
2024-12-08 17:16:46,77,7066,36,41,4867.13,8418.01,0.00
2024-12-08 17:16:46,76,7066,36,40,4909.03,8418.08,0.00
2024-12-08 17:16:46,76,7067,36,40,4914.17,8419.00,0.00
2024-12-08 17:16:46,77,7067,37,40,4850.35,8419.01,0.00
2024-12-08 17:16:46,77,7068,37,40,4825.08,8420.00,0.00
2024-12-08 17:16:46,78,7068,38,40,4763.22,8420.01,0.00
2024-12-08 17:16:46,77,7068,38,39,4823.98,8420.01,0.00
2024-12-08 17:16:46,76,7068,38,38,4867.52,8420.07,0.00
2024-12-08 17:16:46,77,7067,38,39,4801.04,8420.13,0.00
2024-12-08 17:16:46,77,7068,38,39,4873.41,8421.00,0.00
2024-12-08 17:16:46,78,7068,39,39,4810.93,8421.01,0.00
2024-12-08 17:16:46,77,7068,39,38,4872.32,8421.01,0.00
2024-12-08 17:16:46,76,7068,38,38,4904.33,8421.12,0.00
2024-12-08 17:16:46,76,7069,38,38,5018.95,8422.00,0.00
2024-12-08 17:16:46,77,7069,39,38,4953.77,8422.01,0.00
2024-12-08 17:16:46,76,7069,39,37,5001.23,8422.05,0.00
2024-12-08 17:16:47,76,7070,39,37,4998.81,8423.00,0.00
2024-12-08 17:16:47,77,7070,40,37,4933.89,8423.01,0.00
2024-12-08 17:16:47,76,7070,40,36,4928.95,8423.42,0.00
2024-12-08 17:16:47,76,7071,40,36,4969.27,8424.00,0.00
2024-12-08 17:16:47,77,7071,41,36,4904.73,8424.01,0.00
2024-12-08 17:16:47,76,7071,41,35,4952.65,8424.05,0.00
2024-12-08 17:16:47,76,7072,41,35,4962.10,8425.00,0.00
2024-12-08 17:16:47,77,7072,42,35,4897.66,8425.01,0.00
2024-12-08 17:16:47,77,7073,42,35,4880.73,8426.00,0.00
2024-12-08 17:16:47,78,7073,42,36,4818.16,8426.01,0.00
2024-12-08 17:16:47,77,7073,42,35,4865.41,8426.05,0.00
2024-12-08 17:16:47,77,7074,42,35,4873.65,8427.00,0.00
2024-12-08 17:16:47,78,7074,42,36,4811.16,8427.01,0.00
2024-12-08 17:16:47,77,7074,41,36,4841.94,8427.13,0.00
2024-12-08 17:16:47,77,7075,41,36,4856.71,8428.00,0.00
2024-12-08 17:16:47,78,7075,42,36,4794.45,8428.01,0.00
2024-12-08 17:16:47,77,7075,42,35,4834.84,8428.08,0.00
2024-12-08 17:16:47,76,7075,41,35,4847.58,8428.41,0.00
2024-12-08 17:16:47,76,7076,41,35,4909.00,8429.00,0.00
2024-12-08 17:16:47,77,7076,41,36,4845.25,8429.01,0.00
2024-12-08 17:16:47,76,7076,40,36,4876.87,8429.13,0.00
2024-12-08 17:16:47,75,7076,39,36,4922.83,8429.24,0.00
2024-12-08 17:16:47,75,7077,39,36,4971.67,8430.00,0.00
2024-12-08 17:16:47,76,7077,40,36,4906.26,8430.01,0.00
2024-12-08 17:16:47,75,7077,39,36,4970.55,8430.03,0.00
2024-12-08 17:16:47,74,7077,39,35,5018.37,8430.07,0.00
2024-12-08 17:16:47,73,7077,38,35,5082.52,8430.12,0.00
2024-12-08 17:16:47,73,7078,38,35,5101.56,8431.00,0.00
2024-12-08 17:16:47,74,7078,38,36,5032.62,8431.01,0.00
2024-12-08 17:16:47,75,7077,39,36,4847.07,8431.91,0.00
2024-12-08 17:16:47,75,7078,39,36,4982.06,8432.00,0.00
2024-12-08 17:16:47,76,7078,40,36,4916.51,8432.01,0.00
2024-12-08 17:16:47,75,7078,40,35,4962.97,8432.07,0.00
2024-12-08 17:16:47,75,7079,40,35,5085.44,8433.00,0.00
2024-12-08 17:16:47,76,7079,41,35,5018.53,8433.01,0.00
2024-12-08 17:16:47,76,7080,41,35,4999.14,8434.00,0.00
2024-12-08 17:16:47,77,7080,41,36,4934.22,8434.01,0.00
2024-12-08 17:16:47,76,7080,41,35,4978.08,8434.08,0.00
2024-12-08 17:16:47,75,7080,40,35,5021.97,8434.11,0.00
2024-12-08 17:16:47,75,7081,40,35,5056.17,8435.00,0.00
2024-12-08 17:16:47,76,7081,40,36,4989.65,8435.01,0.00
2024-12-08 17:16:47,76,7082,40,36,4971.54,8436.00,0.00
2024-12-08 17:16:47,77,7082,40,37,4906.98,8436.01,0.00
2024-12-08 17:16:47,76,7082,40,36,4948.26,8436.09,0.00
2024-12-08 17:16:47,76,7083,40,36,4960.27,8437.00,0.00
2024-12-08 17:16:47,77,7083,41,36,4895.85,8437.01,0.00
2024-12-08 17:16:47,77,7084,41,36,4878.90,8438.00,0.00
2024-12-08 17:16:47,78,7084,42,36,4816.35,8438.01,0.00
2024-12-08 17:16:47,77,7084,42,35,4855.91,8438.09,0.00
2024-12-08 17:16:47,77,7085,42,35,4867.43,8439.00,0.00
2024-12-08 17:16:47,78,7085,42,36,4805.02,8439.01,0.00
2024-12-08 17:16:47,78,7086,42,36,4787.01,8440.00,0.00
2024-12-08 17:16:47,79,7086,42,37,4726.42,8440.01,0.00
2024-12-08 17:16:47,78,7086,41,37,4741.62,8440.22,0.00
2024-12-08 17:16:47,78,7087,41,37,4784.09,8441.00,0.00
2024-12-08 17:16:47,79,7087,42,37,4723.53,8441.01,0.00
2024-12-08 17:16:47,78,7087,41,37,4780.85,8441.05,0.00
2024-12-08 17:16:48,78,7088,41,37,4766.12,8442.00,0.00
2024-12-08 17:16:48,79,7088,41,38,4705.79,8442.01,0.00
2024-12-08 17:16:48,78,7088,40,38,4765.04,8442.01,0.00
2024-12-08 17:16:48,77,7088,40,37,4805.01,8442.08,0.00
2024-12-08 17:16:48,77,7089,40,37,4815.43,8443.00,0.00
2024-12-08 17:16:48,78,7089,41,37,4753.70,8443.01,0.00
2024-12-08 17:16:48,77,7089,40,37,4732.35,8443.60,0.00
2024-12-08 17:16:48,77,7090,40,37,4808.33,8444.00,0.00
2024-12-08 17:16:48,78,7090,40,38,4746.68,8444.01,0.00
2024-12-08 17:16:48,77,7090,40,37,4788.60,8444.08,0.00
2024-12-08 17:16:48,77,7091,40,37,4799.03,8445.00,0.00
2024-12-08 17:16:48,78,7091,41,37,4737.50,8445.01,0.00
2024-12-08 17:16:48,77,7091,40,37,4773.82,8445.10,0.00
2024-12-08 17:16:48,76,7091,39,37,4811.09,8445.15,0.00
2024-12-08 17:16:48,77,7090,40,37,4723.51,8445.47,0.00
2024-12-08 17:16:48,77,7091,40,37,4829.21,8446.00,0.00
2024-12-08 17:16:48,78,7091,41,37,4767.30,8446.01,0.00
2024-12-08 17:16:48,77,7091,41,36,4804.01,8446.10,0.00
2024-12-08 17:16:48,77,7092,41,36,4926.32,8447.00,0.00
2024-12-08 17:16:48,78,7092,42,36,4863.16,8447.01,0.00
2024-12-08 17:16:48,78,7093,42,36,4845.32,8448.00,0.00
2024-12-08 17:16:48,79,7093,42,37,4783.99,8448.01,0.00
2024-12-08 17:16:48,78,7093,41,37,4842.08,8448.05,0.00
2024-12-08 17:16:48,78,7094,41,37,4827.48,8449.00,0.00
2024-12-08 17:16:48,79,7094,41,38,4766.38,8449.01,0.00
2024-12-08 17:16:48,78,7094,41,37,4801.51,8449.12,0.00
2024-12-08 17:16:48,78,7095,41,37,4813.97,8450.00,0.00
2024-12-08 17:16:48,79,7095,41,38,4753.04,8450.01,0.00
2024-12-08 17:16:48,78,7095,40,38,4812.89,8450.01,0.00
2024-12-08 17:16:48,77,7095,39,38,4809.66,8450.34,0.00
2024-12-08 17:16:48,77,7096,39,38,4863.90,8451.00,0.00
2024-12-08 17:16:48,78,7096,39,39,4801.54,8451.01,0.00
2024-12-08 17:16:48,77,7096,39,38,4829.91,8451.16,0.00
2024-12-08 17:16:48,77,7097,39,38,4846.91,8452.00,0.00
2024-12-08 17:16:48,78,7097,39,39,4784.77,8452.01,0.00
2024-12-08 17:16:48,79,7096,39,40,4618.65,8452.79,0.00
2024-12-08 17:16:48,79,7097,39,40,4724.76,8453.00,0.00
2024-12-08 17:16:48,80,7097,39,41,4665.70,8453.01,0.00
2024-12-08 17:16:48,79,7097,38,41,4721.56,8453.04,0.00
2024-12-08 17:16:48,78,7097,38,40,4765.64,8453.09,0.00
2024-12-08 17:16:48,78,7098,38,40,4884.32,8454.00,0.00
2024-12-08 17:16:48,79,7098,39,40,4822.49,8454.01,0.00
2024-12-08 17:16:48,79,7099,39,40,4803.80,8455.00,0.00
2024-12-08 17:16:48,80,7099,40,40,4743.75,8455.01,0.00
2024-12-08 17:16:48,80,7100,40,40,4724.23,8456.00,0.00
2024-12-08 17:16:48,81,7100,41,40,4665.90,8456.01,0.00
2024-12-08 17:16:48,80,7100,41,39,4718.94,8456.01,0.00
2024-12-08 17:16:48,81,7099,42,39,4648.20,8456.19,0.00
2024-12-08 17:16:48,80,7099,41,39,4745.02,8456.58,0.00
2024-12-08 17:16:48,80,7100,41,39,4815.12,8457.00,0.00
2024-12-08 17:16:48,81,7100,42,39,4755.68,8457.01,0.00
2024-12-08 17:16:48,80,7100,42,38,4790.84,8457.11,0.00
2024-12-08 17:16:48,79,7100,41,38,4838.92,8457.25,0.00
2024-12-08 17:16:48,79,7101,41,38,4957.10,8458.00,0.00
2024-12-08 17:16:48,80,7101,42,38,4895.13,8458.01,0.00
2024-12-08 17:16:48,80,7102,42,38,4855.54,8459.00,0.00
2024-12-08 17:16:48,81,7102,42,39,4795.59,8459.01,0.00
2024-12-08 17:16:48,80,7102,42,38,4845.81,8459.08,0.00
2024-12-08 17:16:48,79,7102,42,37,4876.32,8459.27,0.00
2024-12-08 17:16:48,79,7103,42,37,4900.37,8460.00,0.00
2024-12-08 17:16:48,80,7103,43,37,4839.12,8460.01,0.00
2024-12-08 17:16:49,80,7104,43,37,4819.60,8461.00,0.00
2024-12-08 17:16:49,81,7104,44,37,4760.09,8461.01,0.00
2024-12-08 17:16:49,80,7104,44,36,4799.52,8461.10,0.00
2024-12-08 17:16:49,80,7104,44,36,4808.53,8462.00,0.00
2024-12-08 17:16:49,81,7104,45,36,4749.17,8462.01,0.00
2024-12-08 17:16:49,80,7104,44,36,4728.31,8462.46,0.00
2024-12-08 17:16:49,80,7105,44,36,4786.75,8463.00,0.00
2024-12-08 17:16:49,81,7105,45,36,4727.65,8463.01,0.00
2024-12-08 17:16:49,80,7105,45,35,4767.72,8463.10,0.00
2024-12-08 17:16:49,79,7105,44,35,4819.54,8463.20,0.00
2024-12-08 17:16:49,79,7106,44,35,4835.64,8464.00,0.00
2024-12-08 17:16:49,80,7106,44,36,4775.20,8464.01,0.00
2024-12-08 17:16:49,79,7106,43,36,4734.19,8464.71,0.00
2024-12-08 17:16:49,79,7107,43,36,4814.39,8465.00,0.00
2024-12-08 17:16:49,80,7107,44,36,4754.21,8465.01,0.00
2024-12-08 17:16:49,79,7107,43,36,4813.32,8465.01,0.00
2024-12-08 17:16:49,78,7107,43,35,4864.19,8465.08,0.00
2024-12-08 17:16:49,78,7108,43,35,4872.85,8466.00,0.00
2024-12-08 17:16:49,79,7108,44,35,4811.16,8466.01,0.00
2024-12-08 17:16:49,79,7109,44,35,4791.90,8467.00,0.00
2024-12-08 17:16:49,80,7109,44,36,4732.00,8467.01,0.00
2024-12-08 17:16:49,80,7110,44,36,4712.06,8468.00,0.00
2024-12-08 17:16:49,81,7110,44,37,4653.89,8468.01,0.00
2024-12-08 17:16:49,80,7110,43,37,4706.78,8468.06,0.00
2024-12-08 17:16:49,79,7110,43,36,4764.21,8468.06,0.00
2024-12-08 17:16:49,79,7111,43,36,4771.20,8469.00,0.00
2024-12-08 17:16:49,80,7111,44,36,4711.56,8469.01,0.00
2024-12-08 17:16:49,80,7112,44,36,4691.60,8470.00,0.00
2024-12-08 17:16:49,81,7112,45,36,4633.68,8470.01,0.00
2024-12-08 17:16:49,80,7112,45,35,4678.91,8470.08,0.00
2024-12-08 17:16:49,81,7111,45,36,4585.60,8470.51,0.00
2024-12-08 17:16:49,81,7112,45,36,4665.39,8471.00,0.00
2024-12-08 17:16:49,82,7112,46,36,4608.49,8471.01,0.00
2024-12-08 17:16:49,82,7113,46,36,4683.03,8472.00,0.00
2024-12-08 17:16:49,83,7113,46,37,4626.61,8472.01,0.00
2024-12-08 17:16:49,82,7113,46,36,4669.61,8472.09,0.00
2024-12-08 17:16:49,82,7114,46,36,4663.64,8473.00,0.00
2024-12-08 17:16:49,83,7114,46,37,4607.45,8473.01,0.00
2024-12-08 17:16:49,82,7114,45,37,4627.49,8473.10,0.00
2024-12-08 17:16:49,81,7114,44,37,4679.38,8473.12,0.00
2024-12-08 17:16:49,81,7115,44,37,4702.82,8474.00,0.00
2024-12-08 17:16:49,82,7115,45,37,4645.47,8474.01,0.00
2024-12-08 17:16:49,81,7115,45,36,4690.28,8474.09,0.00
2024-12-08 17:16:49,81,7116,45,36,4688.38,8475.00,0.00
2024-12-08 17:16:49,82,7116,46,36,4631.21,8475.01,0.00
2024-12-08 17:16:49,82,7117,46,36,4600.47,8476.00,0.00
2024-12-08 17:16:49,83,7117,47,36,4545.04,8476.01,0.00
2024-12-08 17:16:49,82,7117,47,35,4583.95,8476.10,0.00
2024-12-08 17:16:49,82,7118,47,35,4580.80,8477.00,0.00
2024-12-08 17:16:49,83,7118,48,35,4525.61,8477.01,0.00
2024-12-08 17:16:49,82,7118,47,35,4574.61,8477.07,0.00
2024-12-08 17:16:49,81,7118,46,35,4522.13,8477.77,0.00
2024-12-08 17:16:49,81,7119,46,35,4607.09,8478.00,0.00
2024-12-08 17:16:49,82,7119,46,36,4550.90,8478.01,0.00
2024-12-08 17:16:49,82,7120,46,36,4529.73,8479.00,0.00
2024-12-08 17:16:49,83,7120,47,36,4475.15,8479.01,0.00
2024-12-08 17:16:49,82,7120,46,36,4527.66,8479.02,0.00
2024-12-08 17:16:50,82,7121,46,36,4507.51,8480.00,0.00
2024-12-08 17:16:50,83,7121,47,36,4453.20,8480.01,0.00
2024-12-08 17:16:50,82,7121,47,35,4496.15,8480.07,0.00
2024-12-08 17:16:50,82,7122,47,35,4500.80,8481.00,0.00
2024-12-08 17:16:50,83,7122,48,35,4446.58,8481.01,0.00
2024-12-08 17:16:50,83,7123,48,35,4424.62,8482.00,0.00
2024-12-08 17:16:50,84,7123,48,36,4371.94,8482.01,0.00
2024-12-08 17:16:50,83,7123,48,35,4422.58,8482.02,0.00
2024-12-08 17:16:50,82,7123,48,34,4467.21,8482.06,0.00
2024-12-08 17:16:50,81,7123,47,34,4505.66,8482.25,0.00
2024-12-08 17:16:50,81,7124,47,34,4526.02,8483.00,0.00
2024-12-08 17:16:50,82,7124,48,34,4470.83,8483.01,0.00
2024-12-08 17:16:50,81,7124,48,33,4523.93,8483.02,0.00
2024-12-08 17:16:50,81,7125,48,33,4504.56,8484.00,0.00
2024-12-08 17:16:50,82,7125,48,34,4449.63,8484.01,0.00
2024-12-08 17:16:50,81,7125,48,33,4494.10,8484.06,0.00
2024-12-08 17:16:50,81,7126,48,33,4498.81,8485.00,0.00
2024-12-08 17:16:50,82,7126,48,34,4443.94,8485.01,0.00
2024-12-08 17:16:50,81,7126,47,34,4436.12,8485.49,0.00
2024-12-08 17:16:50,80,7126,46,34,4458.81,8485.69,0.00
2024-12-08 17:16:50,80,7127,46,34,4538.61,8486.00,0.00
2024-12-08 17:16:50,81,7127,47,34,4482.58,8486.01,0.00
2024-12-08 17:16:50,80,7127,47,33,4525.89,8486.09,0.00
2024-12-08 17:16:50,80,7128,47,33,4533.84,8487.00,0.00
2024-12-08 17:16:50,81,7128,48,33,4477.87,8487.01,0.00
2024-12-08 17:16:50,80,7128,47,33,4529.94,8487.05,0.00
2024-12-08 17:16:50,79,7128,46,33,4548.62,8487.13,0.00
2024-12-08 17:16:50,79,7129,46,33,4581.45,8488.00,0.00
2024-12-08 17:16:50,80,7129,46,34,4524.18,8488.01,0.00
2024-12-08 17:16:50,79,7129,46,33,4564.28,8488.11,0.00
2024-12-08 17:16:50,79,7130,46,33,4573.07,8489.00,0.00
2024-12-08 17:16:50,80,7130,47,33,4515.91,8489.01,0.00
2024-12-08 17:16:50,79,7130,46,33,4533.36,8489.23,0.00
2024-12-08 17:16:50,79,7131,46,33,4551.35,8490.00,0.00
2024-12-08 17:16:50,80,7131,47,33,4494.45,8490.01,0.00
2024-12-08 17:16:50,79,7131,46,33,4545.99,8490.06,0.00
2024-12-08 17:16:50,78,7131,46,32,4592.30,8490.10,0.00
2024-12-08 17:16:50,78,7132,46,32,4599.89,8491.00,0.00
2024-12-08 17:16:50,79,7132,46,33,4541.67,8491.01,0.00
2024-12-08 17:16:50,78,7132,45,33,4565.08,8491.15,0.00
2024-12-08 17:16:50,78,7133,45,33,4569.92,8492.00,0.00
2024-12-08 17:16:50,79,7133,45,34,4512.07,8492.01,0.00
2024-12-08 17:16:50,78,7133,45,33,4554.70,8492.10,0.00
2024-12-08 17:16:50,78,7134,45,33,4546.49,8493.00,0.00
2024-12-08 17:16:50,79,7134,46,33,4488.94,8493.01,0.00
2024-12-08 17:16:50,78,7134,45,33,4504.08,8493.24,0.00
2024-12-08 17:16:50,78,7135,45,33,4501.39,8494.00,0.00
2024-12-08 17:16:50,79,7135,46,33,4444.42,8494.01,0.00
2024-12-08 17:16:50,78,7135,45,33,4493.79,8494.09,0.00
2024-12-08 17:16:50,77,7135,45,32,4542.22,8494.12,0.00
2024-12-08 17:16:50,77,7136,45,32,4519.54,8495.00,0.00
2024-12-08 17:16:50,78,7136,46,32,4461.60,8495.01,0.00
2024-12-08 17:16:50,77,7136,46,31,4384.69,8495.84,0.00
2024-12-08 17:16:50,77,7137,46,31,4473.42,8496.00,0.00
2024-12-08 17:16:50,78,7137,46,32,4416.07,8496.01,0.00
2024-12-08 17:16:50,77,7137,46,31,4451.37,8496.13,0.00
2024-12-08 17:16:50,77,7138,46,31,4446.14,8497.00,0.00
2024-12-08 17:16:50,78,7138,47,31,4389.14,8497.01,0.00
2024-12-08 17:16:51,78,7139,47,31,4343.11,8498.00,0.00
2024-12-08 17:16:51,79,7139,48,31,4288.14,8498.01,0.00
2024-12-08 17:16:51,78,7139,48,30,4322.43,8498.13,0.00
2024-12-08 17:16:51,78,7140,48,30,4302.01,8499.00,0.00
2024-12-08 17:16:51,79,7140,48,31,4247.56,8499.01,0.00
2024-12-08 17:16:51,80,7139,49,31,4089.82,8499.88,0.00
2024-12-08 17:16:51,80,7140,49,31,4218.17,8500.00,0.00
2024-12-08 17:16:51,81,7140,49,32,4166.09,8500.01,0.00
2024-12-08 17:16:51,80,7140,48,32,4211.80,8500.09,0.00
2024-12-08 17:16:51,79,7140,48,31,4252.21,8500.11,0.00
2024-12-08 17:16:51,80,7139,48,32,4141.82,8500.76,0.00
2024-12-08 17:16:51,80,7140,48,32,4261.45,8501.00,0.00
2024-12-08 17:16:51,81,7140,48,33,4208.84,8501.01,0.00
2024-12-08 17:16:51,80,7140,47,33,4258.26,8501.04,0.00
2024-12-08 17:16:51,79,7140,46,33,4287.42,8501.08,0.00
2024-12-08 17:16:51,79,7141,46,33,4316.96,8502.00,0.00
2024-12-08 17:16:51,80,7141,47,33,4263.00,8502.01,0.00
2024-12-08 17:16:51,79,7141,47,32,4298.67,8502.10,0.00
2024-12-08 17:16:51,78,7141,46,32,4344.02,8502.22,0.00
2024-12-08 17:16:51,77,7141,46,31,4317.30,8502.81,0.00
2024-12-08 17:16:51,77,7142,46,31,4352.72,8503.00,0.00
2024-12-08 17:16:51,78,7142,47,31,4296.92,8503.01,0.00
2024-12-08 17:16:51,79,7141,48,31,4235.00,8503.13,0.00
2024-12-08 17:16:51,78,7141,47,31,4271.70,8503.48,0.00
2024-12-08 17:16:51,77,7141,46,31,4265.35,8503.79,0.00
2024-12-08 17:16:51,76,7141,45,31,4302.12,8503.95,0.00
2024-12-08 17:16:51,76,7142,45,31,4409.58,8504.00,0.00
2024-12-08 17:16:51,77,7142,46,31,4352.31,8504.01,0.00
2024-12-08 17:16:51,76,7142,46,30,4387.23,8504.13,0.00
2024-12-08 17:16:51,76,7143,46,30,4512.84,8505.00,0.00
2024-12-08 17:16:51,77,7143,46,31,4454.23,8505.01,0.00
2024-12-08 17:16:51,77,7144,46,31,4433.86,8506.00,0.00
2024-12-08 17:16:51,78,7144,46,32,4377.01,8506.01,0.00
2024-12-08 17:16:51,77,7144,45,32,4428.34,8506.08,0.00
2024-12-08 17:16:51,76,7144,44,32,4449.72,8506.24,0.00
2024-12-08 17:16:51,76,7145,44,32,4471.19,8507.00,0.00
2024-12-08 17:16:51,77,7145,44,33,4413.13,8507.01,0.00
2024-12-08 17:16:51,76,7145,44,32,4455.55,8507.12,0.00
2024-12-08 17:16:51,76,7146,44,32,4466.94,8508.00,0.00
2024-12-08 17:16:51,77,7146,45,32,4408.92,8508.01,0.00
2024-12-08 17:16:51,76,7146,44,32,4426.68,8508.22,0.00
2024-12-08 17:16:51,76,7147,44,32,4447.24,8509.00,0.00
2024-12-08 17:16:51,77,7147,44,33,4389.49,8509.01,0.00
2024-12-08 17:16:51,76,7147,43,33,4443.89,8509.04,0.00
2024-12-08 17:16:51,75,7147,43,32,4488.41,8509.11,0.00
2024-12-08 17:16:51,74,7147,42,32,4513.87,8509.47,0.00
2024-12-08 17:16:51,74,7148,42,32,4584.40,8510.00,0.00
2024-12-08 17:16:51,75,7148,42,33,4523.27,8510.01,0.00
2024-12-08 17:16:51,74,7148,41,33,4578.65,8510.07,0.00
2024-12-08 17:16:51,74,7149,41,33,4566.58,8511.00,0.00
2024-12-08 17:16:51,75,7149,42,33,4505.69,8511.01,0.00
2024-12-08 17:16:51,74,7149,42,32,4547.05,8511.12,0.00
2024-12-08 17:16:51,74,7150,42,32,4562.92,8512.00,0.00
2024-12-08 17:16:51,75,7150,42,33,4502.08,8512.01,0.00
2024-12-08 17:16:51,74,7150,41,33,4561.77,8512.01,0.00
2024-12-08 17:16:51,73,7150,40,33,4621.93,8512.03,0.00
2024-12-08 17:16:51,72,7150,39,33,4684.94,8512.03,0.00
2024-12-08 17:16:51,71,7150,38,33,4695.09,8512.27,0.00
2024-12-08 17:16:52,71,7151,38,33,4750.33,8513.00,0.00
2024-12-08 17:16:52,72,7151,39,33,4684.35,8513.01,0.00
2024-12-08 17:16:52,71,7151,39,32,4734.77,8513.09,0.00
2024-12-08 17:16:52,72,7150,40,32,4577.80,8513.88,0.00
2024-12-08 17:16:52,72,7151,40,32,4693.44,8514.00,0.00
2024-12-08 17:16:52,73,7151,40,33,4629.15,8514.01,0.00
2024-12-08 17:16:52,72,7151,39,33,4611.08,8514.68,0.00
2024-12-08 17:16:52,72,7152,39,33,4792.08,8515.00,0.00
2024-12-08 17:16:52,73,7152,39,34,4726.44,8515.01,0.00
2024-12-08 17:16:52,72,7152,39,33,4776.73,8515.08,0.00
2024-12-08 17:16:52,71,7152,39,32,4827.65,8515.27,0.00
2024-12-08 17:16:52,70,7152,38,32,4855.50,8515.71,0.00
2024-12-08 17:16:52,70,7153,38,32,4947.46,8516.00,0.00
2024-12-08 17:16:52,71,7153,38,33,4877.78,8516.01,0.00
2024-12-08 17:16:52,71,7154,38,33,4860.19,8517.00,0.00
2024-12-08 17:16:52,72,7154,39,33,4792.68,8517.01,0.00
2024-12-08 17:16:52,71,7154,39,32,4844.61,8517.09,0.00
2024-12-08 17:16:52,71,7155,39,32,4857.95,8518.00,0.00
2024-12-08 17:16:52,72,7155,39,33,4790.48,8518.01,0.00
2024-12-08 17:16:52,72,7156,39,33,4774.17,8519.00,0.00
2024-12-08 17:16:52,73,7156,40,33,4708.77,8519.01,0.00
2024-12-08 17:16:52,72,7156,40,32,4755.26,8519.10,0.00
2024-12-08 17:16:52,73,7155,41,32,4681.98,8519.22,0.00
2024-12-08 17:16:52,73,7156,41,32,4805.79,8520.00,0.00
2024-12-08 17:16:52,74,7156,41,33,4740.84,8520.01,0.00
2024-12-08 17:16:52,73,7156,40,33,4730.06,8520.41,0.00
2024-12-08 17:16:52,73,7157,40,33,4911.25,8521.00,0.00
2024-12-08 17:16:52,74,7157,41,33,4844.89,8521.01,0.00
2024-12-08 17:16:52,75,7156,42,33,4779.15,8521.05,0.00
2024-12-08 17:16:52,74,7156,42,32,4848.36,8521.11,0.00
2024-12-08 17:16:52,74,7157,42,32,4862.51,8522.00,0.00
2024-12-08 17:16:52,75,7157,43,32,4797.67,8522.01,0.00
2024-12-08 17:16:52,75,7158,43,32,4892.79,8523.00,0.00
2024-12-08 17:16:52,76,7158,44,32,4828.41,8523.01,0.00
2024-12-08 17:16:52,75,7158,44,31,4876.90,8523.09,0.00
2024-12-08 17:16:52,74,7158,43,31,4895.55,8523.42,0.00
2024-12-08 17:16:52,74,7159,43,31,4957.66,8524.00,0.00
2024-12-08 17:16:52,75,7159,44,31,4891.56,8524.01,0.00
2024-12-08 17:16:52,75,7160,44,31,4870.88,8525.00,0.00
2024-12-08 17:16:52,76,7160,44,32,4806.79,8525.01,0.00
2024-12-08 17:16:52,75,7160,44,31,4856.12,8525.09,0.00
2024-12-08 17:16:52,75,7161,44,31,4863.59,8526.00,0.00
2024-12-08 17:16:52,76,7161,44,32,4799.59,8526.01,0.00
2024-12-08 17:16:52,75,7161,43,32,4857.92,8526.08,0.00
2024-12-08 17:16:52,76,7160,44,32,4754.73,8526.30,0.00
2024-12-08 17:16:52,76,7161,44,32,4839.61,8527.00,0.00
2024-12-08 17:16:52,77,7161,44,33,4776.76,8527.01,0.00
2024-12-08 17:16:52,76,7161,44,32,4827.29,8527.08,0.00
2024-12-08 17:16:52,75,7161,43,32,4880.24,8527.21,0.00
2024-12-08 17:16:52,75,7162,43,32,5009.39,8528.00,0.00
2024-12-08 17:16:52,76,7162,44,32,4943.48,8528.01,0.00
2024-12-08 17:16:52,76,7163,44,32,4917.29,8529.00,0.00
2024-12-08 17:16:52,77,7163,44,33,4853.42,8529.01,0.00
2024-12-08 17:16:52,76,7163,44,32,4907.20,8529.08,0.00
2024-12-08 17:16:52,76,7164,44,32,4908.99,8530.00,0.00
2024-12-08 17:16:52,77,7164,45,32,4845.24,8530.01,0.00
2024-12-08 17:16:52,76,7164,44,32,4867.52,8530.22,0.00
2024-12-08 17:16:52,75,7164,43,32,4885.14,8530.71,0.00
2024-12-08 17:16:52,75,7165,43,32,4974.10,8531.00,0.00
2024-12-08 17:16:52,76,7165,44,32,4908.66,8531.01,0.00
2024-12-08 17:16:52,75,7165,44,31,4965.02,8531.08,0.00
2024-12-08 17:16:53,75,7166,44,31,4976.85,8532.00,0.00
2024-12-08 17:16:53,76,7166,44,32,4911.37,8532.01,0.00
2024-12-08 17:16:53,75,7166,43,32,4973.45,8532.04,0.00
2024-12-08 17:16:53,75,7167,43,32,4959.91,8533.00,0.00
2024-12-08 17:16:53,76,7167,43,33,4894.64,8533.01,0.00
2024-12-08 17:16:53,75,7167,43,32,4934.91,8533.15,0.00
2024-12-08 17:16:53,75,7168,43,32,4952.84,8534.00,0.00
2024-12-08 17:16:53,76,7168,44,32,4887.67,8534.01,0.00
2024-12-08 17:16:53,75,7168,43,32,4947.16,8534.07,0.00
2024-12-08 17:16:53,75,7169,43,32,4935.33,8535.00,0.00
2024-12-08 17:16:53,76,7169,44,32,4870.39,8535.01,0.00
2024-12-08 17:16:53,75,7169,44,31,4909.19,8535.15,0.00
2024-12-08 17:16:53,75,7169,44,31,4926.87,8536.00,0.00
2024-12-08 17:16:53,76,7169,45,31,4862.04,8536.01,0.00
2024-12-08 17:16:53,75,7169,44,31,4897.30,8536.08,0.00
2024-12-08 17:16:53,74,7169,43,31,4912.85,8536.41,0.00
2024-12-08 17:16:53,74,7170,43,31,4976.05,8537.00,0.00
2024-12-08 17:16:53,75,7170,44,31,4909.70,8537.01,0.00
2024-12-08 17:16:53,74,7170,43,31,4976.05,8537.01,0.00
2024-12-08 17:16:53,73,7170,42,31,5041.88,8537.03,0.00
2024-12-08 17:16:53,72,7170,42,30,5090.59,8537.11,0.00
2024-12-08 17:16:53,72,7171,42,30,5104.61,8538.00,0.00
2024-12-08 17:16:53,73,7171,42,31,5034.69,8538.01,0.00
2024-12-08 17:16:53,72,7171,41,31,5102.25,8538.03,0.00
2024-12-08 17:16:53,72,7172,41,31,5078.85,8539.00,0.00
2024-12-08 17:16:53,73,7172,42,31,5009.27,8539.01,0.00
2024-12-08 17:16:53,74,7171,42,32,4880.61,8539.49,0.00
2024-12-08 17:16:53,73,7171,41,32,4972.34,8539.71,0.00
2024-12-08 17:16:53,73,7172,41,32,5057.32,8540.00,0.00
2024-12-08 17:16:53,74,7172,42,32,4988.98,8540.01,0.00
2024-12-08 17:16:53,74,7173,42,32,5073.55,8541.00,0.00
2024-12-08 17:16:53,75,7173,42,33,5005.90,8541.01,0.00
2024-12-08 17:16:53,75,7174,42,33,4970.57,8542.00,0.00
2024-12-08 17:16:53,76,7174,42,34,4905.16,8542.01,0.00
2024-12-08 17:16:53,75,7174,42,33,4958.06,8542.09,0.00
2024-12-08 17:16:53,75,7175,42,33,4950.08,8543.00,0.00
2024-12-08 17:16:53,76,7175,43,33,4884.94,8543.01,0.00
2024-12-08 17:16:53,75,7175,42,33,4925.04,8543.05,0.00
2024-12-08 17:16:53,74,7175,41,33,4990.44,8543.05,0.00
2024-12-08 17:16:53,73,7175,40,33,5014.15,8543.19,0.00
2024-12-08 17:16:53,73,7176,40,33,5052.11,8544.00,0.00
2024-12-08 17:16:53,74,7176,41,33,4983.83,8544.01,0.00
2024-12-08 17:16:53,73,7176,41,32,5035.75,8544.08,0.00
2024-12-08 17:16:53,73,7177,41,32,5042.11,8545.00,0.00
2024-12-08 17:16:53,74,7177,42,32,4973.97,8545.01,0.00
2024-12-08 17:16:53,74,7178,42,32,4949.49,8546.00,0.00
2024-12-08 17:16:53,75,7178,42,33,4883.50,8546.01,0.00
2024-12-08 17:16:53,74,7178,42,32,4934.50,8546.08,0.00
2024-12-08 17:16:53,74,7179,42,32,4937.90,8547.00,0.00
2024-12-08 17:16:53,75,7179,43,32,4872.06,8547.01,0.00
2024-12-08 17:16:53,74,7179,42,32,4885.16,8547.15,0.00
2024-12-08 17:16:53,74,7180,42,32,4914.35,8548.00,0.00
2024-12-08 17:16:53,75,7180,42,33,4848.82,8548.01,0.00
2024-12-08 17:16:53,74,7180,42,32,4891.17,8548.12,0.00
2024-12-08 17:16:53,74,7181,42,32,4892.41,8549.00,0.00
2024-12-08 17:16:53,75,7181,43,32,4827.18,8549.01,0.00
2024-12-08 17:16:53,75,7182,43,32,4791.85,8550.00,0.00
2024-12-08 17:16:53,76,7182,44,32,4728.80,8550.01,0.00
2024-12-08 17:16:53,75,7182,44,31,4762.84,8550.13,0.00
2024-12-08 17:16:54,74,7182,43,31,4824.90,8550.16,0.00
2024-12-08 17:16:54,73,7182,42,31,4808.03,8550.74,0.00
2024-12-08 17:16:54,73,7183,42,31,4894.87,8551.00,0.00
2024-12-08 17:16:54,74,7183,43,31,4828.72,8551.01,0.00
2024-12-08 17:16:54,73,7183,42,31,4863.03,8551.07,0.00
2024-12-08 17:16:54,73,7184,42,31,4864.35,8552.00,0.00
2024-12-08 17:16:54,74,7184,42,32,4798.62,8552.01,0.00
2024-12-08 17:16:54,73,7184,42,31,4835.64,8552.12,0.00
2024-12-08 17:16:54,74,7183,43,31,4700.84,8552.81,0.00
2024-12-08 17:16:54,74,7184,43,31,4792.30,8553.00,0.00
2024-12-08 17:16:54,75,7184,44,31,4728.41,8553.01,0.00
2024-12-08 17:16:54,74,7184,43,31,4758.19,8553.14,0.00
2024-12-08 17:16:54,74,7185,43,31,4880.49,8554.00,0.00
2024-12-08 17:16:54,75,7185,43,32,4815.41,8554.01,0.00
2024-12-08 17:16:54,74,7185,42,32,4872.16,8554.07,0.00
2024-12-08 17:16:54,73,7185,42,31,4913.14,8554.12,0.00
2024-12-08 17:16:54,73,7186,42,31,4920.58,8555.00,0.00
2024-12-08 17:16:54,74,7186,43,31,4854.08,8555.01,0.00
2024-12-08 17:16:54,73,7186,42,31,4834.54,8555.70,0.00
2024-12-08 17:16:54,73,7187,42,31,4902.75,8556.00,0.00
2024-12-08 17:16:54,74,7187,43,31,4836.50,8556.01,0.00
2024-12-08 17:16:54,73,7187,43,30,4871.09,8556.12,0.00
2024-12-08 17:16:54,73,7188,43,30,4888.34,8557.00,0.00
2024-12-08 17:16:54,74,7188,43,31,4822.28,8557.01,0.00
2024-12-08 17:16:54,73,7188,42,31,4882.49,8557.04,0.00
2024-12-08 17:16:54,73,7189,42,31,4868.17,8558.00,0.00
2024-12-08 17:16:54,74,7189,42,32,4802.38,8558.01,0.00
2024-12-08 17:16:54,73,7189,42,31,4834.53,8558.12,0.00
2024-12-08 17:16:54,73,7190,42,31,4848.43,8559.00,0.00
2024-12-08 17:16:54,74,7190,42,32,4782.91,8559.01,0.00
2024-12-08 17:16:54,73,7190,41,32,4814.24,8559.12,0.00
2024-12-08 17:16:54,73,7191,41,32,4825.33,8560.00,0.00
2024-12-08 17:16:54,74,7191,41,33,4760.12,8560.01,0.00
2024-12-08 17:16:54,73,7191,41,32,4791.68,8560.12,0.00
2024-12-08 17:16:54,73,7192,41,32,4801.11,8561.00,0.00
2024-12-08 17:16:54,74,7192,41,33,4736.23,8561.01,0.00
2024-12-08 17:16:54,75,7191,42,33,4557.90,8561.71,0.00
2024-12-08 17:16:54,75,7192,42,33,4671.16,8562.00,0.00
2024-12-08 17:16:54,76,7192,43,33,4609.70,8562.01,0.00
2024-12-08 17:16:54,75,7192,43,32,4640.36,8562.12,0.00
2024-12-08 17:16:54,74,7192,42,32,4699.61,8562.15,0.00
2024-12-08 17:16:54,74,7193,42,32,4846.41,8563.00,0.00
2024-12-08 17:16:54,75,7193,43,32,4781.79,8563.01,0.00
2024-12-08 17:16:54,75,7194,43,32,4758.46,8564.00,0.00
2024-12-08 17:16:54,76,7194,44,32,4695.85,8564.01,0.00
2024-12-08 17:16:54,75,7194,43,32,4733.22,8564.08,0.00
2024-12-08 17:16:54,74,7194,43,31,4775.20,8564.11,0.00
2024-12-08 17:16:54,74,7195,43,31,4809.99,8565.00,0.00
2024-12-08 17:16:54,75,7195,43,32,4745.85,8565.01,0.00
2024-12-08 17:16:54,74,7195,42,32,4806.09,8565.04,0.00
2024-12-08 17:16:54,73,7195,41,32,4820.32,8565.11,0.00
2024-12-08 17:16:54,73,7196,41,32,4857.12,8566.00,0.00
2024-12-08 17:16:54,74,7196,41,33,4791.48,8566.01,0.00
2024-12-08 17:16:54,73,7196,41,32,4830.64,8566.10,0.00
2024-12-08 17:16:54,73,7197,41,32,4843.23,8567.00,0.00
2024-12-08 17:16:54,74,7197,41,33,4777.78,8567.01,0.00
2024-12-08 17:16:54,74,7198,41,33,4758.30,8568.00,0.00
2024-12-08 17:16:54,75,7198,41,34,4694.86,8568.01,0.00
2024-12-08 17:16:54,74,7198,41,33,4727.47,8568.12,0.00
2024-12-08 17:16:54,73,7198,40,33,4788.72,8568.15,0.00
2024-12-08 17:16:54,73,7199,40,33,4829.06,8569.00,0.00
2024-12-08 17:16:55,74,7199,40,34,4763.81,8569.01,0.00
2024-12-08 17:16:55,73,7199,39,34,4801.65,8569.11,0.00
2024-12-08 17:16:55,73,7200,39,34,4814.02,8570.00,0.00
2024-12-08 17:16:55,74,7200,39,35,4748.96,8570.01,0.00
2024-12-08 17:16:55,73,7200,39,34,4785.63,8570.11,0.00
2024-12-08 17:16:55,73,7201,39,34,4797.55,8571.00,0.00
2024-12-08 17:16:55,74,7201,40,34,4732.72,8571.01,0.00
2024-12-08 17:16:55,74,7202,40,34,4710.01,8572.00,0.00
2024-12-08 17:16:55,75,7202,40,35,4647.21,8572.01,0.00
2024-12-08 17:16:55,74,7202,39,35,4708.71,8572.03,0.00
2024-12-08 17:16:55,73,7202,39,34,4748.56,8572.10,0.00
2024-12-08 17:16:55,72,7202,39,33,4791.52,8572.35,0.00
2024-12-08 17:16:55,71,7202,38,33,4851.01,8572.41,0.00
2024-12-08 17:16:55,70,7202,37,33,4882.40,8572.60,0.00
2024-12-08 17:16:55,70,7203,37,33,4970.90,8573.00,0.00
2024-12-08 17:16:55,71,7203,37,34,4900.89,8573.01,0.00
2024-12-08 17:16:55,72,7202,37,35,4830.45,8573.07,0.00
2024-12-08 17:16:55,71,7202,36,35,4938.11,8573.40,0.00
2024-12-08 17:16:55,71,7203,36,35,5001.10,8574.00,0.00
2024-12-08 17:16:55,72,7203,37,35,4931.64,8574.01,0.00
2024-12-08 17:16:55,71,7203,37,34,4974.56,8574.10,0.00
2024-12-08 17:16:55,70,7203,37,33,5043.50,8574.10,0.00
2024-12-08 17:16:55,70,7204,37,33,5176.35,8575.00,0.00
2024-12-08 17:16:55,71,7204,37,34,5103.44,8575.01,0.00
2024-12-08 17:16:55,71,7205,37,34,5079.99,8576.00,0.00
2024-12-08 17:16:55,72,7205,38,34,5009.43,8576.01,0.00
2024-12-08 17:16:55,71,7205,37,34,5077.58,8576.03,0.00
2024-12-08 17:16:55,70,7205,37,33,5124.42,8576.09,0.00
2024-12-08 17:16:55,70,7206,37,33,5131.02,8577.00,0.00
2024-12-08 17:16:55,71,7206,38,33,5058.76,8577.01,0.00
2024-12-08 17:16:55,70,7206,37,33,5093.04,8577.16,0.00
2024-12-08 17:16:55,70,7207,37,33,5105.81,8578.00,0.00
2024-12-08 17:16:55,71,7207,37,34,5033.90,8578.01,0.00
2024-12-08 17:16:55,70,7207,37,33,5074.25,8578.11,0.00
2024-12-08 17:16:55,70,7208,37,33,5082.54,8579.00,0.00
2024-12-08 17:16:55,71,7208,38,33,5010.96,8579.01,0.00
2024-12-08 17:16:55,70,7208,38,32,5023.77,8579.31,0.00
2024-12-08 17:16:55,70,7209,38,32,5063.48,8580.00,0.00
2024-12-08 17:16:55,71,7209,38,33,4992.17,8580.01,0.00
2024-12-08 17:16:55,70,7209,38,32,5031.61,8580.11,0.00
2024-12-08 17:16:55,69,7209,38,31,5090.77,8580.28,0.00
2024-12-08 17:16:55,68,7209,37,31,5158.10,8580.37,0.00
2024-12-08 17:16:55,68,7210,37,31,5205.26,8581.00,0.00
2024-12-08 17:16:55,69,7210,37,32,5129.82,8581.02,0.00
2024-12-08 17:16:55,68,7210,36,32,5161.24,8581.18,0.00
2024-12-08 17:16:55,68,7211,36,32,5192.08,8582.00,0.00
2024-12-08 17:16:55,69,7211,37,32,5116.83,8582.02,0.00
2024-12-08 17:16:55,68,7211,37,31,5163.95,8582.12,0.00
2024-12-08 17:16:55,69,7210,38,31,5070.53,8582.36,0.00
2024-12-08 17:16:55,69,7211,38,31,5140.51,8583.00,0.00
2024-12-08 17:16:55,70,7211,38,32,5067.08,8583.02,0.00
2024-12-08 17:16:55,69,7211,37,32,5084.57,8583.13,0.00
2024-12-08 17:16:55,69,7212,37,32,5254.51,8584.00,0.00
2024-12-08 17:16:55,70,7212,37,33,5179.44,8584.02,0.00
2024-12-08 17:16:55,69,7212,37,32,5227.17,8584.12,0.00
2024-12-08 17:16:55,69,7213,37,32,5242.91,8585.00,0.00
2024-12-08 17:16:55,70,7213,38,32,5168.01,8585.02,0.00
2024-12-08 17:16:55,69,7213,37,32,5159.68,8585.45,0.00
2024-12-08 17:16:56,69,7214,37,32,5237.24,8586.00,0.00
2024-12-08 17:16:56,70,7214,37,33,5162.43,8586.02,0.00
2024-12-08 17:16:56,69,7214,36,33,5233.53,8586.04,0.00
2024-12-08 17:16:56,68,7214,36,32,5286.52,8586.10,0.00
2024-12-08 17:16:56,68,7215,36,32,5290.28,8587.00,0.00
2024-12-08 17:16:56,69,7215,37,32,5213.61,8587.02,0.00
2024-12-08 17:16:56,68,7215,36,32,5258.75,8587.13,0.00
2024-12-08 17:16:56,68,7216,36,32,5259.47,8588.00,0.00
2024-12-08 17:16:56,69,7216,37,32,5183.25,8588.02,0.00
2024-12-08 17:16:56,68,7216,37,31,5225.41,8588.15,0.00
2024-12-08 17:16:56,67,7216,36,31,5279.41,8588.39,0.00
2024-12-08 17:16:56,67,7217,36,31,5329.86,8589.00,0.00
2024-12-08 17:16:56,68,7217,37,31,5251.48,8589.02,0.00
2024-12-08 17:16:56,68,7218,37,31,5243.25,8590.00,0.00
2024-12-08 17:16:56,69,7218,38,31,5167.26,8590.02,0.00
2024-12-08 17:16:56,68,7218,38,30,5205.40,8590.16,0.00
2024-12-08 17:16:56,67,7218,37,30,5232.03,8590.57,0.00
2024-12-08 17:16:56,67,7219,37,30,5323.41,8591.00,0.00
2024-12-08 17:16:56,68,7219,38,30,5245.13,8591.02,0.00
2024-12-08 17:16:56,68,7220,38,30,5235.50,8592.00,0.00
2024-12-08 17:16:56,69,7220,39,30,5159.62,8592.02,0.00
2024-12-08 17:16:56,69,7221,39,30,5148.16,8593.00,0.00
2024-12-08 17:16:56,70,7221,40,30,5074.61,8593.02,0.00
2024-12-08 17:16:56,69,7221,40,29,5134.50,8593.16,0.00
2024-12-08 17:16:56,69,7222,40,29,5162.46,8594.00,0.00
2024-12-08 17:16:56,70,7222,41,29,5088.71,8594.02,0.00
2024-12-08 17:16:56,69,7222,40,29,5158.73,8594.04,0.00
2024-12-08 17:16:56,68,7222,39,29,5155.10,8594.38,0.00
2024-12-08 17:16:56,68,7223,39,29,5228.87,8595.00,0.00
2024-12-08 17:16:56,69,7223,39,30,5153.09,8595.02,0.00
2024-12-08 17:16:56,68,7223,38,30,5216.27,8595.15,0.00
2024-12-08 17:16:56,68,7224,38,30,5219.37,8596.00,0.00
2024-12-08 17:16:56,69,7224,39,30,5143.73,8596.02,0.00
2024-12-08 17:16:56,68,7224,39,29,5184.02,8596.18,0.00
2024-12-08 17:16:56,68,7225,39,29,5214.92,8597.00,0.00
2024-12-08 17:16:56,69,7225,39,30,5139.34,8597.02,0.00
2024-12-08 17:16:56,70,7224,40,30,5035.23,8597.11,0.00
2024-12-08 17:16:56,70,7225,40,30,5150.03,8598.00,0.00
2024-12-08 17:16:56,71,7225,41,30,5077.50,8598.01,0.00
2024-12-08 17:16:56,70,7225,40,30,5121.79,8598.06,0.00
2024-12-08 17:16:56,70,7226,40,30,5262.42,8599.00,0.00
2024-12-08 17:16:56,71,7226,41,30,5188.30,8599.01,0.00
2024-12-08 17:16:56,70,7226,40,30,5258.74,8599.04,0.00
2024-12-08 17:16:56,70,7227,40,30,5274.56,8600.00,0.00
2024-12-08 17:16:56,71,7227,41,30,5200.27,8600.01,0.00
2024-12-08 17:16:56,70,7227,40,30,5235.14,8600.16,0.00
2024-12-08 17:16:56,70,7228,40,30,5261.51,8601.00,0.00
2024-12-08 17:16:56,71,7228,40,31,5187.40,8601.01,0.00
2024-12-08 17:16:56,70,7228,40,30,5248.03,8601.14,0.00
2024-12-08 17:16:56,70,7229,40,30,5273.18,8602.00,0.00
2024-12-08 17:16:56,71,7229,41,30,5198.91,8602.01,0.00
2024-12-08 17:16:56,71,7230,41,30,5187.40,8603.00,0.00
2024-12-08 17:16:56,72,7230,41,31,5115.35,8603.01,0.00
2024-12-08 17:16:56,71,7230,41,30,5153.50,8603.14,0.00
2024-12-08 17:16:56,72,7229,41,31,5015.52,8603.94,0.00
2024-12-08 17:16:56,72,7230,41,31,5135.06,8604.00,0.00
2024-12-08 17:16:56,73,7230,41,32,5064.72,8604.01,0.00
2024-12-08 17:16:56,73,7231,41,32,5169.04,8605.00,0.00
2024-12-08 17:16:56,74,7231,42,32,5099.19,8605.01,0.00
2024-12-08 17:16:56,73,7231,41,32,5163.17,8605.08,0.00
2024-12-08 17:16:56,72,7231,41,31,5209.79,8605.13,0.00
2024-12-08 17:16:57,72,7232,41,31,5230.69,8606.00,0.00
2024-12-08 17:16:57,73,7232,42,31,5159.03,8606.01,0.00
2024-12-08 17:16:57,72,7232,41,31,5223.54,8606.08,0.00
2024-12-08 17:16:57,73,7231,41,32,5046.26,8606.80,0.00
2024-12-08 17:16:57,73,7232,41,32,5185.57,8607.00,0.00
2024-12-08 17:16:57,74,7232,42,32,5115.49,8607.01,0.00
2024-12-08 17:16:57,73,7232,42,31,5151.41,8607.14,0.00
2024-12-08 17:16:57,73,7233,42,31,5289.94,8608.00,0.00
2024-12-08 17:16:57,74,7233,42,32,5218.45,8608.01,0.00
2024-12-08 17:16:57,74,7234,42,32,5201.47,8609.00,0.00
2024-12-08 17:16:57,75,7234,42,33,5132.12,8609.01,0.00
2024-12-08 17:16:57,74,7234,42,32,5166.61,8609.15,0.00
2024-12-08 17:16:57,74,7235,42,32,5175.67,8610.00,0.00
2024-12-08 17:16:57,75,7235,43,32,5106.66,8610.01,0.00
2024-12-08 17:16:57,75,7236,43,32,5071.60,8611.00,0.00
2024-12-08 17:16:57,76,7236,44,32,5004.87,8611.01,0.00
2024-12-08 17:16:57,76,7237,44,32,4959.72,8612.00,0.00
2024-12-08 17:16:57,77,7237,44,33,4895.31,8612.01,0.00
2024-12-08 17:16:57,76,7237,44,32,4946.16,8612.16,0.00
2024-12-08 17:16:57,75,7237,43,32,4939.87,8612.65,0.00
2024-12-08 17:16:57,75,7238,43,32,5002.16,8613.00,0.00
2024-12-08 17:16:57,76,7238,43,33,4936.35,8613.01,0.00
2024-12-08 17:16:57,75,7238,42,33,4998.72,8613.04,0.00
2024-12-08 17:16:57,75,7239,42,33,4985.52,8614.00,0.00
2024-12-08 17:16:57,76,7239,43,33,4919.92,8614.01,0.00
2024-12-08 17:16:57,75,7239,43,32,4948.80,8614.16,0.00
2024-12-08 17:16:57,75,7240,43,32,4968.87,8615.00,0.00
2024-12-08 17:16:57,76,7240,44,32,4903.49,8615.01,0.00
2024-12-08 17:16:57,75,7240,43,32,4932.14,8615.16,0.00
2024-12-08 17:16:57,75,7241,43,32,4952.21,8616.00,0.00
2024-12-08 17:16:57,76,7241,43,33,4887.05,8616.01,0.00
2024-12-08 17:16:57,76,7242,43,33,4870.61,8617.00,0.00
2024-12-08 17:16:57,77,7242,43,34,4807.36,8617.01,0.00
2024-12-08 17:16:57,76,7242,42,34,4865.95,8617.05,0.00
2024-12-08 17:16:57,75,7242,41,34,4930.83,8617.05,0.00
2024-12-08 17:16:57,74,7242,40,34,4996.29,8617.05,0.00
2024-12-08 17:16:57,73,7242,40,33,5056.49,8617.14,0.00
2024-12-08 17:16:57,73,7243,40,33,5076.38,8618.00,0.00
2024-12-08 17:16:57,74,7243,40,34,5007.78,8618.01,0.00
2024-12-08 17:16:57,74,7244,40,34,4991.65,8619.00,0.00
2024-12-08 17:16:57,75,7244,40,35,4925.10,8619.01,0.00
2024-12-08 17:16:57,74,7244,40,34,4961.81,8619.14,0.00
2024-12-08 17:16:57,74,7245,40,34,4978.58,8620.00,0.00
2024-12-08 17:16:57,75,7245,40,35,4912.20,8620.01,0.00
2024-12-08 17:16:57,75,7246,40,35,4893.83,8621.00,0.00
2024-12-08 17:16:57,76,7246,40,36,4829.44,8621.01,0.00
2024-12-08 17:16:57,75,7246,39,36,4892.68,8621.01,0.00
2024-12-08 17:16:57,74,7246,39,35,4927.37,8621.12,0.00
2024-12-08 17:16:57,73,7246,38,35,4945.45,8621.40,0.00
2024-12-08 17:16:57,73,7247,38,35,5012.02,8622.00,0.00
2024-12-08 17:16:57,74,7247,39,35,4944.29,8622.01,0.00
2024-12-08 17:16:57,74,7248,39,35,4926.17,8623.00,0.00
2024-12-08 17:16:57,75,7248,40,35,4860.49,8623.01,0.00
2024-12-08 17:16:57,74,7248,40,34,4895.90,8623.12,0.00
2024-12-08 17:16:57,74,7249,40,34,4910.03,8624.00,0.00
2024-12-08 17:16:57,75,7249,40,35,4844.56,8624.01,0.00
2024-12-08 17:16:57,74,7249,39,35,4907.71,8624.04,0.00
2024-12-08 17:16:57,73,7249,38,35,4973.76,8624.04,0.00
2024-12-08 17:16:58,73,7250,38,35,4958.38,8625.00,0.00
2024-12-08 17:16:58,74,7250,38,36,4891.37,8625.01,0.00
2024-12-08 17:16:58,73,7250,38,35,4931.23,8625.10,0.00
2024-12-08 17:16:58,74,7249,39,35,4806.85,8625.74,0.00
2024-12-08 17:16:58,74,7250,39,35,4922.47,8626.00,0.00
2024-12-08 17:16:58,75,7250,39,36,4856.83,8626.01,0.00
2024-12-08 17:16:58,76,7249,40,36,4786.14,8626.12,0.00
2024-12-08 17:16:58,76,7250,40,36,4987.31,8627.00,0.00
2024-12-08 17:16:58,77,7250,41,36,4922.54,8627.01,0.00
2024-12-08 17:16:58,76,7250,41,35,4952.41,8627.13,0.00
2024-12-08 17:16:58,75,7250,40,35,5006.97,8627.20,0.00
2024-12-08 17:16:58,75,7251,40,35,5164.63,8628.00,0.00
2024-12-08 17:16:58,76,7251,40,36,5096.67,8628.01,0.00
2024-12-08 17:16:58,75,7251,39,36,5162.34,8628.04,0.00
2024-12-08 17:16:58,75,7252,39,36,5143.04,8629.00,0.00
2024-12-08 17:16:58,76,7252,39,37,5075.36,8629.01,0.00
2024-12-08 17:16:58,75,7252,39,36,5111.73,8629.12,0.00
2024-12-08 17:16:58,75,7253,39,36,5125.20,8630.00,0.00
2024-12-08 17:16:58,76,7253,39,37,5057.77,8630.01,0.00
2024-12-08 17:16:58,76,7254,39,37,5038.57,8631.00,0.00
2024-12-08 17:16:58,77,7254,39,38,4973.14,8631.01,0.00
2024-12-08 17:16:58,76,7254,39,37,5010.21,8631.12,0.00
2024-12-08 17:16:58,75,7254,38,37,5065.54,8631.20,0.00
2024-12-08 17:16:58,75,7255,38,37,5111.64,8632.00,0.00
2024-12-08 17:16:58,76,7255,38,38,5044.39,8632.01,0.00
2024-12-08 17:16:58,75,7255,37,38,5109.35,8632.04,0.00
2024-12-08 17:16:58,75,7256,37,38,5096.12,8633.00,0.00
2024-12-08 17:16:58,76,7256,37,39,5029.07,8633.01,0.00
2024-12-08 17:16:58,75,7256,37,38,5046.65,8633.11,0.00
2024-12-08 17:16:58,75,7257,37,38,5085.20,8634.00,0.00
2024-12-08 17:16:58,76,7257,37,39,5018.29,8634.01,0.00
2024-12-08 17:16:58,76,7258,37,39,5001.83,8635.00,0.00
2024-12-08 17:16:58,77,7258,38,39,4936.87,8635.01,0.00
2024-12-08 17:16:58,76,7258,38,38,4976.86,8635.11,0.00
2024-12-08 17:16:58,76,7259,38,38,4991.04,8636.00,0.00
2024-12-08 17:16:58,77,7259,39,38,4926.23,8636.01,0.00
2024-12-08 17:16:58,76,7259,38,38,4986.51,8636.05,0.00
2024-12-08 17:16:58,76,7260,38,38,4973.44,8637.00,0.00
2024-12-08 17:16:58,77,7260,38,39,4908.85,8637.01,0.00
2024-12-08 17:16:58,76,7260,38,38,4950.73,8637.09,0.00
2024-12-08 17:16:58,76,7261,38,38,4963.79,8638.00,0.00
2024-12-08 17:16:58,77,7261,38,39,4899.32,8638.01,0.00
2024-12-08 17:16:58,77,7262,38,39,4881.94,8639.00,0.00
2024-12-08 17:16:58,78,7262,39,39,4819.35,8639.01,0.00
2024-12-08 17:16:58,77,7262,39,38,4859.52,8639.09,0.00
2024-12-08 17:16:58,77,7263,39,38,4871.28,8640.00,0.00
2024-12-08 17:16:58,78,7263,39,39,4808.83,8640.01,0.00
2024-12-08 17:16:58,78,7264,39,39,4790.55,8641.00,0.00
2024-12-08 17:16:58,79,7264,40,39,4729.91,8641.01,0.00
2024-12-08 17:16:58,78,7264,40,38,4769.53,8641.09,0.00
2024-12-08 17:16:58,79,7263,41,38,4640.68,8641.91,0.00
2024-12-08 17:16:58,79,7264,41,38,4728.27,8642.00,0.00
2024-12-08 17:16:58,80,7264,41,39,4669.17,8642.01,0.00
2024-12-08 17:16:58,79,7264,40,39,4691.12,8642.18,0.00
2024-12-08 17:16:58,79,7265,40,39,4817.44,8643.00,0.00
2024-12-08 17:16:58,80,7265,41,39,4757.22,8643.01,0.00
2024-12-08 17:16:58,79,7265,40,39,4811.99,8643.06,0.00
2024-12-08 17:16:58,78,7265,40,38,4860.38,8643.08,0.00
2024-12-08 17:16:58,77,7265,39,38,4910.07,8643.19,0.00
2024-12-08 17:16:58,77,7266,39,38,4953.24,8644.00,0.00
2024-12-08 17:16:58,78,7266,40,38,4889.74,8644.01,0.00
2024-12-08 17:16:58,77,7266,39,38,4940.90,8644.04,0.00
2024-12-08 17:16:59,76,7266,38,38,5003.65,8644.05,0.00
2024-12-08 17:16:59,75,7266,37,38,4992.31,8644.69,0.00
2024-12-08 17:16:59,75,7267,37,38,5081.31,8645.00,0.00
2024-12-08 17:16:59,76,7267,37,39,5014.45,8645.01,0.00
2024-12-08 17:16:59,75,7267,37,38,5065.19,8645.05,0.00
2024-12-08 17:16:59,75,7268,37,38,5076.13,8646.00,0.00
2024-12-08 17:16:59,76,7268,37,39,5009.34,8646.01,0.00
2024-12-08 17:16:59,75,7268,36,39,5057.71,8646.07,0.00
2024-12-08 17:16:59,75,7269,36,39,5069.80,8647.00,0.00
2024-12-08 17:16:59,76,7269,36,40,5003.09,8647.01,0.00
2024-12-08 17:16:59,75,7269,36,39,5051.37,8647.07,0.00
2024-12-08 17:16:59,74,7269,35,39,5038.18,8647.73,0.00
2024-12-08 17:16:59,74,7270,35,39,5131.89,8648.00,0.00
2024-12-08 17:16:59,75,7270,35,40,5063.47,8648.01,0.00
2024-12-08 17:16:59,75,7271,35,40,5047.91,8649.00,0.00
2024-12-08 17:16:59,76,7271,36,40,4981.49,8649.01,0.00
2024-12-08 17:16:59,75,7271,36,39,5029.47,8649.07,0.00
2024-12-08 17:16:59,74,7271,35,39,5089.28,8649.15,0.00
2024-12-08 17:16:59,75,7270,36,39,5007.65,8649.33,0.00
2024-12-08 17:16:59,75,7271,36,39,5096.93,8650.00,0.00
2024-12-08 17:16:59,76,7271,36,40,5029.87,8650.01,0.00
2024-12-08 17:16:59,76,7272,36,40,5127.20,8651.00,0.00
2024-12-08 17:16:59,77,7272,37,40,5060.61,8651.01,0.00
2024-12-08 17:16:59,76,7272,37,39,5110.15,8651.07,0.00
2024-12-08 17:16:59,76,7273,37,39,5120.96,8652.00,0.00
2024-12-08 17:16:59,77,7273,37,40,5054.46,8652.01,0.00
2024-12-08 17:16:59,77,7274,37,40,5037.06,8653.00,0.00
2024-12-08 17:16:59,78,7274,37,41,4972.48,8653.01,0.00
2024-12-08 17:16:59,77,7274,36,41,5035.94,8653.01,0.00
2024-12-08 17:16:59,76,7274,36,40,5085.14,8653.07,0.00
2024-12-08 17:16:59,76,7275,36,40,5095.96,8654.00,0.00
2024-12-08 17:16:59,77,7275,37,40,5029.78,8654.01,0.00
2024-12-08 17:16:59,76,7275,36,40,4989.38,8654.86,0.00
2024-12-08 17:16:59,76,7276,36,40,5090.85,8655.00,0.00
2024-12-08 17:16:59,77,7276,36,41,5024.74,8655.01,0.00
2024-12-08 17:16:59,76,7276,36,40,5074.93,8655.07,0.00
2024-12-08 17:16:59,76,7277,36,40,5085.75,8656.00,0.00
2024-12-08 17:16:59,77,7277,36,41,5019.70,8656.01,0.00
2024-12-08 17:16:59,77,7278,36,41,5002.16,8657.00,0.00
2024-12-08 17:16:59,78,7278,37,41,4938.03,8657.01,0.00
2024-12-08 17:16:59,77,7278,37,40,4986.44,8657.06,0.00
2024-12-08 17:16:59,77,7279,37,40,4995.46,8658.00,0.00
2024-12-08 17:16:59,78,7279,38,40,4931.42,8658.01,0.00
2024-12-08 17:16:59,77,7279,37,40,4965.54,8658.13,0.00
2024-12-08 17:16:59,77,7280,37,40,4979.46,8659.00,0.00
2024-12-08 17:16:59,78,7280,38,40,4915.62,8659.01,0.00
2024-12-08 17:16:59,77,7280,38,39,4948.64,8659.13,0.00
2024-12-08 17:16:59,77,7281,38,39,4962.24,8660.00,0.00
2024-12-08 17:16:59,78,7281,38,40,4898.62,8660.01,0.00
2024-12-08 17:16:59,78,7282,38,40,4875.92,8661.00,0.00
2024-12-08 17:16:59,79,7282,38,41,4814.20,8661.01,0.00
2024-12-08 17:16:59,78,7282,38,40,4843.71,8661.14,0.00
2024-12-08 17:16:59,77,7282,37,40,4880.76,8661.18,0.00
2024-12-08 17:17:00,77,7283,37,40,4920.18,8662.00,0.00
2024-12-08 17:17:00,78,7283,37,41,4857.10,8662.01,0.00
2024-12-08 17:17:00,77,7283,36,41,4853.69,8662.48,0.00
2024-12-08 17:17:00,77,7284,36,41,4895.72,8663.00,0.00
2024-12-08 17:17:00,78,7284,36,42,4832.96,8663.01,0.00
2024-12-08 17:17:00,78,7285,36,42,4807.92,8664.00,0.00
2024-12-08 17:17:00,79,7285,36,43,4747.06,8664.01,0.00
2024-12-08 17:17:00,80,7284,37,43,4630.45,8664.41,0.00
2024-12-08 17:17:00,80,7285,37,43,4713.68,8665.00,0.00
2024-12-08 17:17:00,81,7285,38,43,4655.48,8665.01,0.00
2024-12-08 17:17:00,80,7285,37,43,4667.89,8665.24,0.00
2024-12-08 17:17:00,80,7286,37,43,4794.00,8666.00,0.00
2024-12-08 17:17:00,81,7286,37,44,4734.82,8666.01,0.00
2024-12-08 17:17:00,80,7286,37,43,4772.22,8666.18,0.00
2024-12-08 17:17:00,80,7287,37,43,4785.61,8667.00,0.00
2024-12-08 17:17:00,81,7287,37,44,4726.53,8667.01,0.00
2024-12-08 17:17:00,80,7287,36,44,4762.03,8667.05,0.00
2024-12-08 17:17:00,80,7288,36,44,4766.08,8668.00,0.00
2024-12-08 17:17:00,81,7288,37,44,4707.24,8668.01,0.00
2024-12-08 17:17:00,80,7288,36,44,4761.05,8668.05,0.00
2024-12-08 17:17:00,79,7288,35,44,4796.10,8668.15,0.00
2024-12-08 17:17:00,78,7288,35,43,4839.81,8668.15,0.00
2024-12-08 17:17:00,78,7289,35,43,4878.12,8669.00,0.00
2024-12-08 17:17:00,79,7289,36,43,4816.37,8669.01,0.00
2024-12-08 17:17:00,78,7289,35,43,4791.48,8669.74,0.00
2024-12-08 17:17:00,78,7290,35,43,4880.61,8670.00,0.00
2024-12-08 17:17:00,79,7290,36,43,4818.83,8670.01,0.00
2024-12-08 17:17:00,80,7289,37,43,4755.35,8670.08,0.00
2024-12-08 17:17:00,79,7289,37,42,4901.18,8670.17,0.00
2024-12-08 17:17:00,79,7290,37,42,4917.07,8671.00,0.00
2024-12-08 17:17:00,80,7290,37,43,4855.61,8671.01,0.00
2024-12-08 17:17:00,80,7291,37,43,4943.97,8672.00,0.00
2024-12-08 17:17:00,81,7291,37,44,4882.93,8672.01,0.00
2024-12-08 17:17:00,80,7291,36,44,4939.65,8672.06,0.00
2024-12-08 17:17:00,79,7291,36,43,4981.34,8672.14,0.00
2024-12-08 17:17:00,79,7292,36,43,4995.05,8673.00,0.00
2024-12-08 17:17:00,80,7292,37,43,4932.61,8673.01,0.00
2024-12-08 17:17:00,80,7293,37,43,4912.58,8674.00,0.00
2024-12-08 17:17:00,81,7293,37,44,4851.93,8674.01,0.00
2024-12-08 17:17:00,80,7293,37,43,4887.39,8674.15,0.00
2024-12-08 17:17:00,80,7294,37,43,4900.93,8675.00,0.00
2024-12-08 17:17:00,81,7294,37,44,4840.42,8675.01,0.00
2024-12-08 17:17:00,81,7295,37,44,4819.56,8676.00,0.00
2024-12-08 17:17:00,82,7295,37,45,4760.78,8676.01,0.00
2024-12-08 17:17:00,81,7295,36,45,4816.35,8676.04,0.00
2024-12-08 17:17:00,80,7295,36,44,4852.73,8676.15,0.00
2024-12-08 17:17:00,79,7295,35,44,4907.59,8676.23,0.00
2024-12-08 17:17:00,78,7295,34,44,4950.60,8676.46,0.00
2024-12-08 17:17:00,77,7295,33,44,4980.09,8676.66,0.00
2024-12-08 17:17:00,77,7296,33,44,5063.75,8677.00,0.00
2024-12-08 17:17:00,78,7296,34,44,4998.83,8677.01,0.00
2024-12-08 17:17:00,77,7296,33,44,5034.49,8677.17,0.00
2024-12-08 17:17:00,77,7297,33,44,5053.06,8678.00,0.00
2024-12-08 17:17:00,78,7297,33,45,4988.28,8678.01,0.00
2024-12-08 17:17:00,77,7297,33,44,5021.55,8678.18,0.00
2024-12-08 17:17:00,77,7298,33,44,5041.25,8679.00,0.00
2024-12-08 17:17:00,78,7298,34,44,4976.62,8679.01,0.00
2024-12-08 17:17:01,78,7299,34,44,4958.27,8680.00,0.00
2024-12-08 17:17:01,79,7299,35,44,4895.51,8680.01,0.00
2024-12-08 17:17:01,78,7299,34,44,4949.39,8680.12,0.00
2024-12-08 17:17:01,77,7299,34,43,4993.39,8680.17,0.00
2024-12-08 17:17:01,76,7299,33,43,5041.96,8680.17,0.00
2024-12-08 17:17:01,76,7300,33,43,5084.77,8681.00,0.00
2024-12-08 17:17:01,77,7300,33,44,5018.73,8681.01,0.00
2024-12-08 17:17:01,77,7301,33,44,5001.27,8682.00,0.00
2024-12-08 17:17:01,78,7301,33,45,4937.15,8682.01,0.00
2024-12-08 17:17:01,79,7300,34,45,4766.22,8682.79,0.00
2024-12-08 17:17:01,79,7301,34,45,4897.20,8683.00,0.00
2024-12-08 17:17:01,80,7301,34,46,4835.98,8683.01,0.00
2024-12-08 17:17:01,79,7301,33,46,4809.62,8683.75,0.00
2024-12-08 17:17:01,79,7302,33,46,5007.69,8684.00,0.00
2024-12-08 17:17:01,80,7302,34,46,4945.09,8684.01,0.00
2024-12-08 17:17:01,80,7303,34,46,4925.03,8685.00,0.00
2024-12-08 17:17:01,81,7303,35,46,4864.23,8685.01,0.00
2024-12-08 17:17:01,80,7303,35,45,4896.84,8685.18,0.00
2024-12-08 17:17:01,80,7304,35,45,4912.57,8686.00,0.00
2024-12-08 17:17:01,81,7304,35,46,4851.92,8686.01,0.00
2024-12-08 17:17:01,80,7304,34,46,4908.24,8686.05,0.00
2024-12-08 17:17:01,79,7304,33,46,4954.98,8686.08,0.00
2024-12-08 17:17:01,79,7305,33,46,4963.23,8687.00,0.00
2024-12-08 17:17:01,80,7305,34,46,4901.19,8687.01,0.00
2024-12-08 17:17:01,79,7305,34,45,4937.97,8687.15,0.00
2024-12-08 17:17:01,79,7306,34,45,4952.81,8688.00,0.00
2024-12-08 17:17:01,80,7306,35,45,4890.90,8688.01,0.00
2024-12-08 17:17:01,79,7306,35,44,4923.14,8688.14,0.00
2024-12-08 17:17:01,79,7307,35,44,4936.88,8689.00,0.00
2024-12-08 17:17:01,80,7307,36,44,4875.17,8689.01,0.00
2024-12-08 17:17:01,81,7306,37,44,4813.91,8689.05,0.00
2024-12-08 17:17:01,81,7307,37,44,4892.90,8690.00,0.00
2024-12-08 17:17:01,82,7307,37,45,4833.23,8690.01,0.00
2024-12-08 17:17:01,81,7307,37,44,4871.48,8690.14,0.00
2024-12-08 17:17:01,81,7308,37,44,4968.35,8691.00,0.00
2024-12-08 17:17:01,82,7308,37,45,4907.76,8691.01,0.00
2024-12-08 17:17:01,82,7309,37,45,4852.88,8692.00,0.00
2024-12-08 17:17:01,83,7309,37,46,4794.41,8692.01,0.00
2024-12-08 17:17:01,82,7309,36,46,4843.37,8692.12,0.00
2024-12-08 17:17:01,81,7309,36,45,4893.51,8692.12,0.00
2024-12-08 17:17:01,80,7309,35,45,4948.45,8692.19,0.00
2024-12-08 17:17:01,79,7309,35,44,4955.73,8692.51,0.00
2024-12-08 17:17:01,79,7310,35,44,5023.23,8693.00,0.00
2024-12-08 17:17:01,80,7310,35,45,4960.44,8693.01,0.00
2024-12-08 17:17:01,79,7310,34,45,5018.85,8693.05,0.00
2024-12-08 17:17:01,78,7310,33,45,5008.66,8693.44,0.00
2024-12-08 17:17:01,78,7311,33,45,5071.50,8694.00,0.00
2024-12-08 17:17:01,79,7311,33,46,5007.30,8694.01,0.00
2024-12-08 17:17:01,78,7311,33,45,5031.40,8694.12,0.00
2024-12-08 17:17:01,78,7312,33,45,5066.51,8695.00,0.00
2024-12-08 17:17:01,79,7312,34,45,5002.37,8695.01,0.00
2024-12-08 17:17:01,79,7313,34,45,4983.14,8696.00,0.00
2024-12-08 17:17:01,80,7313,35,45,4920.85,8696.01,0.00
2024-12-08 17:17:01,79,7313,34,45,4971.84,8696.05,0.00
2024-12-08 17:17:01,78,7313,34,44,5021.10,8696.10,0.00
2024-12-08 17:17:01,78,7314,34,44,5032.80,8697.00,0.00
2024-12-08 17:17:02,79,7314,34,45,4969.09,8697.01,0.00
2024-12-08 17:17:02,78,7314,33,45,5031.68,8697.01,0.00
2024-12-08 17:17:02,78,7315,33,45,4993.95,8698.00,0.00
2024-12-08 17:17:02,79,7315,34,45,4930.74,8698.01,0.00
2024-12-08 17:17:02,78,7315,34,44,4946.62,8698.09,0.00
2024-12-08 17:17:02,78,7316,34,44,4957.21,8699.00,0.00
2024-12-08 17:17:02,79,7316,35,44,4894.46,8699.01,0.00
2024-12-08 17:17:02,78,7316,34,44,4913.82,8699.01,0.00
2024-12-08 17:17:02,77,7316,33,44,4918.93,8699.19,0.00
2024-12-08 17:17:02,77,7317,33,44,4962.01,8700.00,0.00
2024-12-08 17:17:02,78,7317,33,45,4898.39,8700.01,0.00
2024-12-08 17:17:02,77,7317,33,44,4947.33,8700.09,0.00
2024-12-08 17:17:02,78,7316,33,45,4818.52,8700.87,0.00
2024-12-08 17:17:02,78,7317,33,45,4905.07,8701.00,0.00
2024-12-08 17:17:02,79,7317,33,46,4842.98,8701.01,0.00
2024-12-08 17:17:02,79,7318,33,46,4927.81,8702.00,0.00
2024-12-08 17:17:02,80,7318,33,47,4866.21,8702.01,0.00
2024-12-08 17:17:02,79,7318,33,46,4913.50,8702.09,0.00
2024-12-08 17:17:02,79,7319,33,46,4917.25,8703.00,0.00
2024-12-08 17:17:02,80,7319,33,47,4855.79,8703.01,0.00
2024-12-08 17:17:02,79,7319,32,47,4915.05,8703.03,0.00
2024-12-08 17:17:02,80,7318,32,48,4792.86,8703.50,0.00
2024-12-08 17:17:02,80,7319,32,48,4869.69,8704.00,0.00
2024-12-08 17:17:02,81,7319,32,49,4809.57,8704.01,0.00
2024-12-08 17:17:02,82,7318,33,49,4747.74,8704.07,0.00
2024-12-08 17:17:02,81,7318,33,48,4899.86,8704.09,0.00
2024-12-08 17:17:02,80,7318,32,48,4914.52,8704.54,0.00
2024-12-08 17:17:02,80,7319,32,48,5083.15,8705.00,0.00
2024-12-08 17:17:02,81,7319,32,49,5020.39,8705.01,0.00
2024-12-08 17:17:02,81,7320,32,49,5085.04,8706.00,0.00
2024-12-08 17:17:02,82,7320,32,50,5023.03,8706.01,0.00
2024-12-08 17:17:02,82,7321,32,50,4962.19,8707.00,0.00
2024-12-08 17:17:02,83,7321,32,51,4902.41,8707.01,0.00
2024-12-08 17:17:02,82,7321,31,51,4959.01,8707.04,0.00
2024-12-08 17:17:02,82,7322,31,51,4879.47,8708.00,0.00
2024-12-08 17:17:02,83,7322,32,51,4820.68,8708.01,0.00
2024-12-08 17:17:02,82,7322,31,51,4773.86,8708.74,0.00
2024-12-08 17:17:02,81,7322,31,50,4794.16,8708.89,0.00
2024-12-08 17:17:02,81,7323,31,50,4870.59,8709.00,0.00
2024-12-08 17:17:02,82,7323,31,51,4811.19,8709.01,0.00
2024-12-08 17:17:02,81,7323,31,50,4851.24,8709.04,0.00
2024-12-08 17:17:02,80,7323,30,50,4815.50,8709.95,0.00
2024-12-08 17:17:03,80,7324,30,50,4920.06,8710.00,0.00
2024-12-08 17:17:03,81,7324,31,50,4859.32,8710.01,0.00
2024-12-08 17:17:03,80,7324,31,49,4893.94,8710.05,0.00
2024-12-08 17:17:03,80,7325,31,49,4898.85,8711.00,0.00
2024-12-08 17:17:03,81,7325,31,50,4838.37,8711.01,0.00
2024-12-08 17:17:03,80,7325,31,49,4872.72,8711.05,0.00
2024-12-08 17:17:03,80,7326,31,49,4877.63,8712.00,0.00
2024-12-08 17:17:03,81,7326,32,49,4817.41,8712.01,0.00
2024-12-08 17:17:03,80,7326,31,49,4856.94,8712.01,0.00
2024-12-08 17:17:03,79,7326,31,48,4893.06,8712.04,0.00
2024-12-08 17:17:03,79,7327,31,48,4920.09,8713.00,0.00
2024-12-08 17:17:03,80,7327,31,49,4858.58,8713.01,0.00
2024-12-08 17:17:03,80,7328,31,49,4838.45,8714.00,0.00
2024-12-08 17:17:03,81,7328,32,49,4778.71,8714.01,0.00
2024-12-08 17:17:03,80,7328,32,48,4827.56,8714.04,0.00
2024-12-08 17:17:03,79,7328,31,48,4873.24,8714.11,0.00
2024-12-08 17:17:03,79,7329,31,48,4906.87,8715.00,0.00
2024-12-08 17:17:03,80,7329,32,48,4845.54,8715.01,0.00
2024-12-08 17:17:03,79,7329,32,47,4882.61,8715.04,0.00
2024-12-08 17:17:03,79,7330,32,47,4887.58,8716.00,0.00
2024-12-08 17:17:03,80,7330,32,48,4826.48,8716.01,0.00
2024-12-08 17:17:03,80,7331,32,48,4806.33,8717.00,0.00
2024-12-08 17:17:03,81,7331,32,49,4747.00,8717.01,0.00
2024-12-08 17:17:03,80,7331,32,48,4803.07,8717.04,0.00
2024-12-08 17:17:03,79,7331,31,48,4846.26,8717.23,0.00
2024-12-08 17:17:03,79,7332,31,48,4863.76,8718.00,0.00
2024-12-08 17:17:03,80,7332,31,49,4802.96,8718.01,0.00
2024-12-08 17:17:03,79,7332,31,48,4838.38,8718.04,0.00
2024-12-08 17:17:03,78,7332,30,48,4898.17,8718.04,0.00
2024-12-08 17:17:03,78,7333,30,48,4910.08,8719.00,0.00
2024-12-08 17:17:03,79,7333,31,48,4847.93,8719.01,0.00
2024-12-08 17:17:03,78,7333,30,48,4881.02,8719.05,0.00
2024-12-08 17:17:03,77,7333,29,48,4931.99,8719.19,0.00
2024-12-08 17:17:03,77,7334,29,48,4944.41,8720.00,0.00
2024-12-08 17:17:03,78,7334,30,48,4881.02,8720.01,0.00
2024-12-08 17:17:03,77,7334,30,47,4941.01,8720.04,0.00
2024-12-08 17:17:03,76,7334,30,46,4971.93,8720.24,0.00
2024-12-08 17:17:03,75,7334,29,46,4976.30,8720.72,0.00
2024-12-08 17:17:03,75,7335,29,46,5045.15,8721.00,0.00
2024-12-08 17:17:03,76,7335,29,47,4978.77,8721.01,0.00
2024-12-08 17:17:03,75,7335,29,46,4990.79,8721.24,0.00
2024-12-08 17:17:03,76,7334,30,46,4845.22,8721.92,0.00
2024-12-08 17:17:03,76,7335,30,46,4960.06,8722.00,0.00
2024-12-08 17:17:03,77,7335,31,46,4895.64,8722.01,0.00
2024-12-08 17:17:03,76,7335,31,45,4956.62,8722.04,0.00
2024-12-08 17:17:03,76,7336,31,45,5080.00,8723.00,0.00
2024-12-08 17:17:03,77,7336,32,45,5014.02,8723.01,0.00
2024-12-08 17:17:03,76,7336,31,45,5075.41,8723.04,0.00
2024-12-08 17:17:03,76,7337,31,45,5083.74,8724.00,0.00
2024-12-08 17:17:03,77,7337,32,45,5017.71,8724.01,0.00
2024-12-08 17:17:03,76,7337,32,44,5079.15,8724.04,0.00
2024-12-08 17:17:03,76,7338,32,44,5087.76,8725.00,0.00
2024-12-08 17:17:03,77,7338,33,44,5021.69,8725.01,0.00
2024-12-08 17:17:03,76,7338,32,44,5086.62,8725.01,0.00
2024-12-08 17:17:03,75,7338,31,44,5153.27,8725.01,0.00
2024-12-08 17:17:03,75,7339,31,44,5137.58,8726.00,0.00
2024-12-08 17:17:03,76,7339,31,45,5069.98,8726.01,0.00
2024-12-08 17:17:03,75,7339,31,44,5136.41,8726.01,0.00
2024-12-08 17:17:03,75,7340,31,44,5143.98,8727.00,0.00
2024-12-08 17:17:03,76,7340,31,45,5076.30,8727.01,0.00
2024-12-08 17:17:03,75,7340,31,44,5119.55,8727.01,0.00
2024-12-08 17:17:03,75,7341,31,44,5127.12,8728.00,0.00
2024-12-08 17:17:04,76,7341,32,44,5059.65,8728.01,0.00
2024-12-08 17:17:04,75,7341,32,43,5102.68,8728.01,0.00
2024-12-08 17:17:04,75,7342,32,43,5109.88,8729.00,0.00
2024-12-08 17:17:04,76,7342,33,43,5042.65,8729.01,0.00
2024-12-08 17:17:04,76,7343,33,43,5026.00,8730.00,0.00
2024-12-08 17:17:04,77,7343,34,43,4960.72,8730.01,0.00
2024-12-08 17:17:04,76,7343,34,42,5024.85,8730.01,0.00
2024-12-08 17:17:04,76,7344,34,42,5031.17,8731.00,0.00
2024-12-08 17:17:04,77,7344,34,43,4965.83,8731.01,0.00
2024-12-08 17:17:04,76,7344,33,43,4977.26,8731.28,0.00
2024-12-08 17:17:04,76,7345,33,43,5029.44,8732.00,0.00
2024-12-08 17:17:04,77,7345,33,44,4964.13,8732.01,0.00
2024-12-08 17:17:04,76,7345,33,43,5028.30,8732.01,0.00
2024-12-08 17:17:04,76,7346,33,43,5034.62,8733.00,0.00
2024-12-08 17:17:04,77,7346,34,43,4969.23,8733.01,0.00
2024-12-08 17:17:04,76,7346,34,42,5010.49,8733.01,0.00
2024-12-08 17:17:04,75,7346,33,42,5074.96,8733.01,0.00
2024-12-08 17:17:04,75,7347,33,42,5105.82,8734.00,0.00
2024-12-08 17:17:04,76,7347,33,43,5038.64,8734.01,0.00
2024-12-08 17:17:04,77,7346,34,43,4878.38,8734.87,0.00
2024-12-08 17:17:04,77,7347,34,43,4991.92,8735.00,0.00
2024-12-08 17:17:04,78,7347,34,44,4927.92,8735.01,0.00
2024-12-08 17:17:04,77,7347,34,43,4989.66,8735.01,0.00
2024-12-08 17:17:04,77,7348,34,43,5108.22,8736.00,0.00
2024-12-08 17:17:04,78,7348,34,44,5042.73,8736.01,0.00
2024-12-08 17:17:04,78,7349,34,44,5024.26,8737.00,0.00
2024-12-08 17:17:04,79,7349,35,44,4960.67,8737.01,0.00
2024-12-08 17:17:04,78,7349,35,43,5018.66,8737.03,0.00
2024-12-08 17:17:04,77,7349,34,43,5064.58,8737.09,0.00
2024-12-08 17:17:04,77,7350,34,43,5099.18,8738.00,0.00
2024-12-08 17:17:04,78,7350,35,43,5033.80,8738.01,0.00
2024-12-08 17:17:04,78,7351,35,43,5015.33,8739.00,0.00
2024-12-08 17:17:04,79,7351,36,43,4951.85,8739.01,0.00
2024-12-08 17:17:04,78,7351,35,43,5014.21,8739.01,0.00
2024-12-08 17:17:04,77,7351,35,42,5075.93,8739.01,0.00
2024-12-08 17:17:04,77,7352,35,42,5080.51,8740.00,0.00
2024-12-08 17:17:04,78,7352,35,43,5015.38,8740.01,0.00
2024-12-08 17:17:04,77,7352,34,43,5041.94,8740.06,0.00
2024-12-08 17:17:04,78,7351,34,44,4959.43,8740.30,0.00
2024-12-08 17:17:04,78,7352,34,44,5068.02,8741.00,0.00
2024-12-08 17:17:04,79,7352,34,45,5003.87,8741.01,0.00
2024-12-08 17:17:04,78,7352,34,44,5065.78,8741.01,0.00
2024-12-08 17:17:04,78,7353,34,44,5179.29,8742.00,0.00
2024-12-08 17:17:04,79,7353,34,45,5113.73,8742.01,0.00
2024-12-08 17:17:04,78,7353,33,45,5139.01,8742.21,0.00
2024-12-08 17:17:04,79,7352,34,45,5070.64,8742.27,0.00
2024-12-08 17:17:04,79,7353,34,45,5093.92,8743.00,0.00
2024-12-08 17:17:04,80,7353,35,45,5030.25,8743.01,0.00
2024-12-08 17:17:04,80,7354,35,45,5116.94,8744.00,0.00
2024-12-08 17:17:04,81,7354,35,46,5053.77,8744.01,0.00
2024-12-08 17:17:04,80,7354,35,45,5093.99,8744.03,0.00
2024-12-08 17:17:04,81,7353,35,46,4973.14,8744.72,0.00
2024-12-08 17:17:04,81,7354,35,46,5042.86,8745.00,0.00
2024-12-08 17:17:04,82,7354,36,46,4981.36,8745.01,0.00
2024-12-08 17:17:04,81,7354,35,46,4981.37,8745.21,0.00
2024-12-08 17:17:04,81,7355,35,46,5127.72,8746.00,0.00
2024-12-08 17:17:04,82,7355,36,46,5065.19,8746.01,0.00
2024-12-08 17:17:04,81,7355,36,45,5124.49,8746.02,0.00
2024-12-08 17:17:04,81,7356,36,45,5126.11,8747.00,0.00
2024-12-08 17:17:04,82,7356,37,45,5063.60,8747.01,0.00
2024-12-08 17:17:05,82,7357,37,45,5041.77,8748.00,0.00
2024-12-08 17:17:05,83,7357,38,45,4981.03,8748.01,0.00
2024-12-08 17:17:05,82,7357,38,44,5035.37,8748.04,0.00
2024-12-08 17:17:05,82,7358,38,44,5037.01,8749.00,0.00
2024-12-08 17:17:05,83,7358,38,45,4976.33,8749.01,0.00
2024-12-08 17:17:05,83,7359,38,45,4953.70,8750.00,0.00
2024-12-08 17:17:05,84,7359,38,46,4894.73,8750.01,0.00
2024-12-08 17:17:05,83,7359,37,46,4951.60,8750.02,0.00
2024-12-08 17:17:05,82,7359,37,45,5008.78,8750.02,0.00
2024-12-08 17:17:05,81,7359,36,45,5036.10,8750.19,0.00
2024-12-08 17:17:05,81,7360,36,45,5073.36,8751.00,0.00
2024-12-08 17:17:05,82,7360,36,46,5011.49,8751.01,0.00
2024-12-08 17:17:05,81,7360,35,46,5069.04,8751.02,0.00
2024-12-08 17:17:05,81,7361,35,46,5070.69,8752.00,0.00
2024-12-08 17:17:05,82,7361,35,47,5008.86,8752.01,0.00
2024-12-08 17:17:05,81,7361,35,46,5066.37,8752.02,0.00
2024-12-08 17:17:05,81,7362,35,46,5068.03,8753.00,0.00
2024-12-08 17:17:05,82,7362,35,47,5006.22,8753.01,0.00
2024-12-08 17:17:05,81,7362,34,47,4968.92,8753.68,0.00
2024-12-08 17:17:05,81,7363,34,47,5049.16,8754.00,0.00
2024-12-08 17:17:05,82,7363,34,48,4987.58,8754.01,0.00
2024-12-08 17:17:05,81,7363,34,47,5043.76,8754.04,0.00
2024-12-08 17:17:05,81,7364,34,47,5046.49,8755.00,0.00
2024-12-08 17:17:05,82,7364,35,47,4984.95,8755.01,0.00
2024-12-08 17:17:05,82,7365,35,47,4963.09,8756.00,0.00
2024-12-08 17:17:05,83,7365,35,48,4903.30,8756.01,0.00
2024-12-08 17:17:05,82,7365,35,47,4957.76,8756.04,0.00
2024-12-08 17:17:05,81,7365,34,47,5003.89,8756.21,0.00
2024-12-08 17:17:05,81,7366,34,47,5020.80,8757.00,0.00
2024-12-08 17:17:05,82,7366,34,48,4959.57,8757.01,0.00
2024-12-08 17:17:05,81,7366,33,48,4981.94,8757.21,0.00
2024-12-08 17:17:05,81,7367,33,48,4992.88,8758.00,0.00
2024-12-08 17:17:05,82,7367,33,49,4931.99,8758.01,0.00
2024-12-08 17:17:05,81,7367,33,48,4984.24,8758.06,0.00
2024-12-08 17:17:05,80,7367,32,48,4985.49,8758.61,0.00
2024-12-08 17:17:05,80,7368,32,48,5045.23,8759.00,0.00
2024-12-08 17:17:05,81,7368,33,48,4982.94,8759.01,0.00
2024-12-08 17:17:05,82,7367,33,49,4888.03,8759.18,0.00
2024-12-08 17:17:05,82,7368,33,49,4949.16,8760.00,0.00
2024-12-08 17:17:05,83,7368,33,50,4889.53,8760.01,0.00
2024-12-08 17:17:05,82,7368,33,49,4941.69,8760.06,0.00
2024-12-08 17:17:05,82,7369,33,49,5025.96,8761.00,0.00
2024-12-08 17:17:05,83,7369,33,50,4965.41,8761.01,0.00
2024-12-08 17:17:05,82,7369,32,50,4890.38,8761.84,0.00
2024-12-08 17:17:05,82,7370,32,50,4983.47,8762.00,0.00
2024-12-08 17:17:05,83,7370,33,50,4923.43,8762.01,0.00
2024-12-08 17:17:05,82,7370,32,50,4982.40,8762.01,0.00
2024-12-08 17:17:05,81,7370,32,49,5038.51,8762.05,0.00
2024-12-08 17:17:05,80,7370,31,49,5060.17,8762.49,0.00
2024-12-08 17:17:05,80,7371,31,49,5103.26,8763.00,0.00
2024-12-08 17:17:05,81,7371,31,50,5040.26,8763.01,0.00
2024-12-08 17:17:05,80,7371,30,50,4990.72,8763.74,0.00
2024-12-08 17:17:05,80,7372,30,50,5077.48,8764.00,0.00
2024-12-08 17:17:05,81,7372,30,51,5014.80,8764.01,0.00
2024-12-08 17:17:05,81,7373,30,51,4981.47,8765.00,0.00
2024-12-08 17:17:05,82,7373,31,51,4920.72,8765.01,0.00
2024-12-08 17:17:05,81,7373,31,50,4975.59,8765.01,0.00
2024-12-08 17:17:05,80,7373,30,50,5035.59,8765.04,0.00
2024-12-08 17:17:06,80,7374,30,50,5008.87,8766.00,0.00
2024-12-08 17:17:06,81,7374,31,50,4947.03,8766.01,0.00
2024-12-08 17:17:06,80,7374,31,49,4988.06,8766.04,0.00
2024-12-08 17:17:06,79,7374,30,49,5002.33,8766.48,0.00
2024-12-08 17:17:06,79,7375,30,49,5046.00,8767.00,0.00
2024-12-08 17:17:06,80,7375,30,50,4982.93,8767.01,0.00
2024-12-08 17:17:06,79,7375,30,49,4993.10,8767.24,0.00
2024-12-08 17:17:06,78,7375,29,49,5020.19,8767.56,0.00
2024-12-08 17:17:06,78,7376,29,49,5094.72,8768.00,0.00
2024-12-08 17:17:06,79,7376,30,49,5030.23,8768.01,0.00
2024-12-08 17:17:06,78,7376,29,49,5089.10,8768.05,0.00
2024-12-08 17:17:06,77,7376,29,48,5151.78,8768.05,0.00
2024-12-08 17:17:06,77,7377,29,48,5183.11,8769.00,0.00
2024-12-08 17:17:06,78,7377,30,48,5116.66,8769.01,0.00
2024-12-08 17:17:06,78,7378,30,48,5098.13,8770.00,0.00
2024-12-08 17:17:06,79,7378,30,49,5033.59,8770.01,0.00
2024-12-08 17:17:06,78,7378,30,48,5092.51,8770.05,0.00
2024-12-08 17:17:06,77,7378,29,48,5143.86,8770.10,0.00
2024-12-08 17:17:06,77,7379,29,48,5179.59,8771.00,0.00
2024-12-08 17:17:06,78,7379,30,48,5113.19,8771.01,0.00
2024-12-08 17:17:06,78,7380,30,48,5094.03,8772.00,0.00
2024-12-08 17:17:06,79,7380,31,48,5029.55,8772.01,0.00
2024-12-08 17:17:06,79,7381,31,48,5009.60,8773.00,0.00
2024-12-08 17:17:06,80,7381,32,48,4946.98,8773.01,0.00
2024-12-08 17:17:06,80,7382,32,48,4924.92,8774.00,0.00
2024-12-08 17:17:06,81,7382,32,49,4864.12,8774.01,0.00
2024-12-08 17:17:06,81,7383,32,49,4839.98,8775.00,0.00
2024-12-08 17:17:06,82,7383,33,49,4780.95,8775.01,0.00
2024-12-08 17:17:06,81,7383,33,48,4831.31,8775.05,0.00
2024-12-08 17:17:06,81,7384,33,48,4832.72,8776.00,0.00
2024-12-08 17:17:06,82,7384,34,48,4773.79,8776.01,0.00
2024-12-08 17:17:06,81,7384,34,47,4809.97,8776.05,0.00
2024-12-08 17:17:06,81,7384,34,47,4810.76,8777.00,0.00
2024-12-08 17:17:06,82,7384,34,48,4752.10,8777.01,0.00
2024-12-08 17:17:06,81,7384,34,47,4788.01,8777.05,0.00
2024-12-08 17:17:06,81,7385,34,47,4787.84,8778.00,0.00
2024-12-08 17:17:06,82,7385,34,48,4729.45,8778.01,0.00
2024-12-08 17:17:06,81,7385,34,47,4762.92,8778.05,0.00
2024-12-08 17:17:06,81,7386,34,47,4759.82,8779.00,0.00
2024-12-08 17:17:06,82,7386,35,47,4701.77,8779.01,0.00
2024-12-08 17:17:06,81,7386,34,47,4758.74,8779.01,0.00
2024-12-08 17:17:06,81,7387,34,47,4728.89,8780.00,0.00
2024-12-08 17:17:06,82,7387,34,48,4671.22,8780.01,0.00
2024-12-08 17:17:06,81,7387,33,48,4727.81,8780.01,0.00
2024-12-08 17:17:06,80,7387,33,47,4784.71,8780.03,0.00
2024-12-08 17:17:06,79,7387,32,47,4823.08,8780.14,0.00
2024-12-08 17:17:06,80,7386,32,48,4748.58,8780.33,0.00
2024-12-08 17:17:06,80,7387,32,48,4865.24,8781.00,0.00
2024-12-08 17:17:06,81,7387,32,49,4805.17,8781.01,0.00
2024-12-08 17:17:06,80,7387,32,48,4841.09,8781.03,0.00
2024-12-08 17:17:06,80,7388,32,48,4946.56,8782.00,0.00
2024-12-08 17:17:06,81,7388,32,49,4885.49,8782.01,0.00
2024-12-08 17:17:06,80,7388,32,48,4922.41,8782.03,0.00
2024-12-08 17:17:06,80,7389,32,48,4920.00,8783.00,0.00
2024-12-08 17:17:06,81,7389,33,48,4859.26,8783.01,0.00
2024-12-08 17:17:06,80,7389,33,47,4895.85,8783.03,0.00
2024-12-08 17:17:06,79,7389,32,47,4932.28,8783.15,0.00
2024-12-08 17:17:07,79,7390,32,47,4967.91,8784.00,0.00
2024-12-08 17:17:07,80,7390,32,48,4905.81,8784.01,0.00
2024-12-08 17:17:07,79,7390,32,47,4944.56,8784.03,0.00
2024-12-08 17:17:07,79,7391,32,47,4947.52,8785.00,0.00
2024-12-08 17:17:07,80,7391,33,47,4885.68,8785.01,0.00
2024-12-08 17:17:07,79,7391,33,46,4924.17,8785.03,0.00
2024-12-08 17:17:07,79,7392,33,46,4927.30,8786.00,0.00
2024-12-08 17:17:07,80,7392,34,46,4865.71,8786.01,0.00
2024-12-08 17:17:07,79,7392,34,45,4903.95,8786.03,0.00
2024-12-08 17:17:07,79,7393,34,45,4907.01,8787.00,0.00
2024-12-08 17:17:07,80,7393,34,46,4845.67,8787.01,0.00
2024-12-08 17:17:07,79,7393,33,46,4905.89,8787.01,0.00
2024-12-08 17:17:07,78,7393,33,45,4945.13,8787.01,0.00
2024-12-08 17:17:07,78,7394,33,45,4948.17,8788.00,0.00
2024-12-08 17:17:07,79,7394,34,45,4885.54,8788.01,0.00
2024-12-08 17:17:07,78,7394,33,45,4947.05,8788.01,0.00
2024-12-08 17:17:07,78,7395,33,45,4949.94,8789.00,0.00
2024-12-08 17:17:07,79,7395,33,46,4887.28,8789.01,0.00
2024-12-08 17:17:07,78,7395,33,45,4949.10,8789.01,0.00
2024-12-08 17:17:07,78,7396,33,45,4952.38,8790.00,0.00
2024-12-08 17:17:07,79,7396,33,46,4889.70,8790.01,0.00
2024-12-08 17:17:07,78,7396,32,46,4925.34,8790.03,0.00
2024-12-08 17:17:07,78,7397,32,46,4952.64,8791.00,0.00
2024-12-08 17:17:07,79,7397,32,47,4889.95,8791.01,0.00
2024-12-08 17:17:07,78,7397,32,46,4951.52,8791.01,0.00
2024-12-08 17:17:07,78,7398,32,46,4955.46,8792.00,0.00
2024-12-08 17:17:07,79,7398,32,47,4892.73,8792.01,0.00
2024-12-08 17:17:07,78,7398,31,47,4918.28,8792.08,0.00
2024-12-08 17:17:07,77,7398,30,47,4925.38,8792.73,0.00
2024-12-08 17:17:07,77,7399,30,47,5015.82,8793.00,0.00
2024-12-08 17:17:07,78,7399,30,48,4951.52,8793.01,0.00
2024-12-08 17:17:07,77,7399,30,47,5014.68,8793.01,0.00
2024-12-08 17:17:07,76,7399,29,47,5066.79,8793.07,0.00
2024-12-08 17:17:07,76,7400,29,47,5100.91,8794.00,0.00
2024-12-08 17:17:07,77,7400,30,47,5034.66,8794.01,0.00
2024-12-08 17:17:07,77,7401,30,47,5016.96,8795.00,0.00
2024-12-08 17:17:07,78,7401,31,47,4952.64,8795.01,0.00
2024-12-08 17:17:07,77,7401,31,46,5013.54,8795.03,0.00
2024-12-08 17:17:07,77,7402,31,46,5019.82,8796.00,0.00
2024-12-08 17:17:07,78,7402,31,47,4955.46,8796.01,0.00
2024-12-08 17:17:07,77,7402,30,47,4957.16,8796.47,0.00
2024-12-08 17:17:07,77,7403,30,47,5002.11,8797.00,0.00
2024-12-08 17:17:07,78,7403,31,47,4937.98,8797.01,0.00
2024-12-08 17:17:07,77,7403,31,46,4999.83,8797.03,0.00
2024-12-08 17:17:07,77,7404,31,46,5006.10,8798.00,0.00
2024-12-08 17:17:07,78,7404,32,46,4941.92,8798.01,0.00
2024-12-08 17:17:07,77,7404,32,45,4980.97,8798.03,0.00
2024-12-08 17:17:07,77,7405,32,45,4987.25,8799.00,0.00
2024-12-08 17:17:07,78,7405,33,45,4923.31,8799.01,0.00
2024-12-08 17:17:07,78,7406,33,45,4904.27,8800.00,0.00
2024-12-08 17:17:07,79,7406,33,46,4842.19,8800.01,0.00
2024-12-08 17:17:07,78,7406,33,45,4900.89,8800.03,0.00
2024-12-08 17:17:07,79,7405,33,46,4767.32,8800.86,0.00
2024-12-08 17:17:07,79,7406,33,46,4856.57,8801.00,0.00
2024-12-08 17:17:07,80,7406,33,47,4795.86,8801.01,0.00
2024-12-08 17:17:07,79,7406,32,47,4818.71,8801.09,0.00
2024-12-08 17:17:08,79,7407,32,47,4961.28,8802.00,0.00
2024-12-08 17:17:08,80,7407,33,47,4899.27,8802.01,0.00
2024-12-08 17:17:08,79,7407,33,46,4951.27,8802.06,0.00
2024-12-08 17:17:08,79,7408,33,46,4953.53,8803.00,0.00
2024-12-08 17:17:08,80,7408,34,46,4891.61,8803.01,0.00
2024-12-08 17:17:08,79,7408,33,46,4890.19,8803.48,0.00
2024-12-08 17:17:08,79,7409,33,46,4927.29,8804.00,0.00
2024-12-08 17:17:08,80,7409,34,46,4865.70,8804.01,0.00
2024-12-08 17:17:08,79,7409,34,45,4918.39,8804.06,0.00
2024-12-08 17:17:08,79,7410,34,45,4918.26,8805.00,0.00
2024-12-08 17:17:08,80,7410,34,46,4856.78,8805.01,0.00
2024-12-08 17:17:08,80,7411,34,46,4833.68,8806.00,0.00
2024-12-08 17:17:08,81,7411,35,46,4774.01,8806.01,0.00
2024-12-08 17:17:08,80,7411,35,45,4822.69,8806.06,0.00
2024-12-08 17:17:08,80,7412,35,45,4827.06,8807.00,0.00
2024-12-08 17:17:08,81,7412,36,45,4767.46,8807.01,0.00
2024-12-08 17:17:08,81,7413,36,45,4744.93,8808.00,0.00
2024-12-08 17:17:08,82,7413,37,45,4687.06,8808.01,0.00
2024-12-08 17:17:08,81,7413,37,44,4735.15,8808.06,0.00
2024-12-08 17:17:08,81,7414,37,44,4739.21,8809.00,0.00
2024-12-08 17:17:08,82,7414,38,44,4681.41,8809.01,0.00
2024-12-08 17:17:08,82,7415,38,44,4659.38,8810.00,0.00
2024-12-08 17:17:08,83,7415,38,45,4603.24,8810.01,0.00
2024-12-08 17:17:08,82,7415,38,44,4648.65,8810.07,0.00
2024-12-08 17:17:08,82,7416,38,44,4653.46,8811.00,0.00
2024-12-08 17:17:08,83,7416,39,44,4597.40,8811.01,0.00
2024-12-08 17:17:08,83,7417,39,44,4569.50,8812.00,0.00
2024-12-08 17:17:08,84,7417,39,45,4515.11,8812.01,0.00
2024-12-08 17:17:08,83,7417,39,44,4559.96,8812.07,0.00
2024-12-08 17:17:08,83,7418,39,44,4542.86,8813.00,0.00
2024-12-08 17:17:08,84,7418,40,44,4488.77,8813.01,0.00
2024-12-08 17:17:08,83,7418,39,44,4537.56,8813.06,0.00
2024-12-08 17:17:08,82,7418,38,44,4545.64,8813.20,0.00
2024-12-08 17:17:08,81,7418,38,43,4579.31,8813.26,0.00
2024-12-08 17:17:08,81,7419,38,43,4622.24,8814.00,0.00
2024-12-08 17:17:08,82,7419,38,44,4565.87,8814.01,0.00
2024-12-08 17:17:08,81,7419,38,43,4614.63,8814.06,0.00
2024-12-08 17:17:08,81,7420,38,43,4615.52,8815.00,0.00
2024-12-08 17:17:08,82,7420,38,44,4559.24,8815.01,0.00
2024-12-08 17:17:08,82,7421,38,44,4530.01,8816.00,0.00
2024-12-08 17:17:08,83,7421,39,44,4475.43,8816.01,0.00
2024-12-08 17:17:08,82,7421,38,44,4523.57,8816.06,0.00
2024-12-08 17:17:08,81,7421,38,43,4571.80,8816.09,0.00
2024-12-08 17:17:08,81,7422,38,43,4593.90,8817.00,0.00
2024-12-08 17:17:08,82,7422,38,44,4537.88,8817.01,0.00
2024-12-08 17:17:08,81,7422,37,44,4555.88,8817.17,0.00
2024-12-08 17:17:08,81,7423,37,44,4567.18,8818.00,0.00
2024-12-08 17:17:08,82,7423,37,45,4511.48,8818.01,0.00
2024-12-08 17:17:08,81,7423,37,44,4557.39,8818.09,0.00
2024-12-08 17:17:08,81,7424,37,44,4560.92,8819.00,0.00
2024-12-08 17:17:08,82,7424,37,45,4505.30,8819.01,0.00
2024-12-08 17:17:08,81,7424,36,45,4513.88,8819.26,0.00
2024-12-08 17:17:08,82,7423,36,46,4423.28,8819.63,0.00
2024-12-08 17:17:08,82,7424,36,46,4508.53,8820.00,0.00
2024-12-08 17:17:08,83,7424,36,47,4454.21,8820.01,0.00
2024-12-08 17:17:08,84,7423,37,47,4395.94,8820.10,0.00
2024-12-08 17:17:08,83,7423,37,46,4531.81,8820.10,0.00
2024-12-08 17:17:08,83,7424,37,46,4633.69,8821.00,0.00
2024-12-08 17:17:08,84,7424,37,47,4578.53,8821.01,0.00
2024-12-08 17:17:08,83,7424,36,47,4632.63,8821.01,0.00
2024-12-08 17:17:08,82,7424,35,47,4688.05,8821.01,0.00
2024-12-08 17:17:09,82,7425,35,47,4760.46,8822.00,0.00
2024-12-08 17:17:09,83,7425,35,48,4703.10,8822.01,0.00
2024-12-08 17:17:09,82,7425,35,47,4755.10,8822.06,0.00
2024-12-08 17:17:09,81,7425,34,47,4811.63,8822.06,0.00
2024-12-08 17:17:09,80,7425,34,46,4847.64,8822.24,0.00
2024-12-08 17:17:09,80,7426,34,46,4889.59,8823.00,0.00
2024-12-08 17:17:09,81,7426,35,46,4829.22,8823.01,0.00
2024-12-08 17:17:09,80,7426,34,46,4869.74,8823.04,0.00
2024-12-08 17:17:09,80,7427,34,46,4871.56,8824.00,0.00
2024-12-08 17:17:09,81,7427,35,46,4811.42,8824.01,0.00
2024-12-08 17:17:09,80,7427,34,46,4870.46,8824.01,0.00
2024-12-08 17:17:09,79,7427,34,45,4928.78,8824.04,0.00
2024-12-08 17:17:09,79,7428,34,45,4927.73,8825.00,0.00
2024-12-08 17:17:09,80,7428,35,45,4866.13,8825.01,0.00
2024-12-08 17:17:09,79,7428,35,44,4900.03,8825.04,0.00
2024-12-08 17:17:09,78,7428,34,44,4947.06,8825.21,0.00
2024-12-08 17:17:09,78,7429,34,44,4986.95,8826.00,0.00
2024-12-08 17:17:09,79,7429,34,45,4923.83,8826.01,0.00
2024-12-08 17:17:09,79,7430,34,45,4900.68,8827.00,0.00
2024-12-08 17:17:09,80,7430,35,45,4839.42,8827.01,0.00
2024-12-08 17:17:09,79,7430,35,44,4893.99,8827.05,0.00
2024-12-08 17:17:09,78,7430,35,43,4954.53,8827.06,0.00
2024-12-08 17:17:09,79,7429,36,43,4857.33,8827.48,0.00
2024-12-08 17:17:09,78,7429,35,43,4920.98,8827.73,0.00
2024-12-08 17:17:09,78,7430,35,43,5010.61,8828.00,0.00
2024-12-08 17:17:09,79,7430,35,44,4947.18,8828.01,0.00
2024-12-08 17:17:09,79,7431,35,44,5028.03,8829.00,0.00
2024-12-08 17:17:09,80,7431,35,45,4965.18,8829.01,0.00
2024-12-08 17:17:09,79,7431,35,44,5022.45,8829.05,0.00
2024-12-08 17:17:09,79,7432,35,44,5014.22,8830.00,0.00
2024-12-08 17:17:09,80,7432,36,44,4951.54,8830.01,0.00
2024-12-08 17:17:09,79,7432,35,44,4975.16,8830.20,0.00
2024-12-08 17:17:09,79,7433,35,44,4977.80,8831.00,0.00
2024-12-08 17:17:09,80,7433,36,44,4915.58,8831.01,0.00
2024-12-08 17:17:09,79,7433,36,43,4971.11,8831.05,0.00
2024-12-08 17:17:09,79,7434,36,43,4957.28,8832.00,0.00
2024-12-08 17:17:09,80,7434,37,43,4895.32,8832.01,0.00
2024-12-08 17:17:09,80,7435,37,43,4849.14,8833.00,0.00
2024-12-08 17:17:09,81,7435,37,44,4789.27,8833.01,0.00
2024-12-08 17:17:09,80,7435,37,43,4843.63,8833.05,0.00
2024-12-08 17:17:09,80,7436,37,43,4812.80,8834.00,0.00
2024-12-08 17:17:09,81,7436,37,44,4753.39,8834.01,0.00
2024-12-08 17:17:09,80,7436,37,43,4695.18,8834.79,0.00
2024-12-08 17:17:09,80,7437,37,43,4771.73,8835.00,0.00
2024-12-08 17:17:09,81,7437,37,44,4712.82,8835.01,0.00
2024-12-08 17:17:09,80,7437,37,43,4766.23,8835.05,0.00
2024-12-08 17:17:09,79,7437,36,43,4789.82,8835.47,0.00
2024-12-08 17:17:09,79,7438,36,43,4814.10,8836.00,0.00
2024-12-08 17:17:09,80,7438,36,44,4753.92,8836.01,0.00
2024-12-08 17:17:09,80,7439,36,44,4712.64,8837.00,0.00
2024-12-08 17:17:09,81,7439,37,44,4654.46,8837.01,0.00
2024-12-08 17:17:09,80,7439,37,43,4708.24,8837.05,0.00
2024-12-08 17:17:09,79,7439,36,43,4751.07,8837.11,0.00
2024-12-08 17:17:09,79,7440,36,43,4763.12,8838.00,0.00
2024-12-08 17:17:09,80,7440,36,44,4703.58,8838.01,0.00
2024-12-08 17:17:09,79,7440,36,43,4736.28,8838.05,0.00
2024-12-08 17:17:09,79,7441,36,43,4716.33,8839.00,0.00
2024-12-08 17:17:10,80,7441,36,44,4657.38,8839.01,0.00
2024-12-08 17:17:10,79,7441,36,43,4689.49,8839.05,0.00
2024-12-08 17:17:10,78,7441,35,43,4711.13,8839.22,0.00
2024-12-08 17:17:10,77,7441,35,42,4706.58,8839.74,0.00
2024-12-08 17:17:10,78,7440,35,43,4634.45,8839.83,0.00
2024-12-08 17:17:10,78,7441,35,43,4746.79,8840.00,0.00
2024-12-08 17:17:10,79,7441,35,44,4686.71,8840.01,0.00
2024-12-08 17:17:10,78,7441,35,43,4719.60,8840.05,0.00
2024-12-08 17:17:10,77,7441,34,43,4755.30,8840.30,0.00
2024-12-08 17:17:10,77,7442,34,43,4891.38,8841.00,0.00
2024-12-08 17:17:10,78,7442,35,43,4828.67,8841.01,0.00
2024-12-08 17:17:10,77,7442,35,42,4864.30,8841.05,0.00
2024-12-08 17:17:10,77,7443,35,42,4862.53,8842.00,0.00
2024-12-08 17:17:10,78,7443,35,43,4800.19,8842.01,0.00
2024-12-08 17:17:10,77,7443,35,42,4838.08,8842.05,0.00
2024-12-08 17:17:10,77,7444,35,42,4837.38,8843.00,0.00
2024-12-08 17:17:10,78,7444,36,42,4775.36,8843.01,0.00
2024-12-08 17:17:10,78,7445,36,42,4746.03,8844.00,0.00
2024-12-08 17:17:10,79,7445,36,43,4685.96,8844.01,0.00
2024-12-08 17:17:10,78,7445,36,42,4738.11,8844.05,0.00
2024-12-08 17:17:10,77,7445,36,41,4763.56,8844.43,0.00
2024-12-08 17:17:10,77,7446,36,41,4800.88,8845.00,0.00
2024-12-08 17:17:10,78,7446,36,42,4739.33,8845.01,0.00
2024-12-08 17:17:10,77,7446,35,42,4753.80,8845.13,0.00
2024-12-08 17:17:10,77,7447,35,42,4789.01,8846.00,0.00
2024-12-08 17:17:10,78,7447,36,42,4727.61,8846.01,0.00
2024-12-08 17:17:10,77,7447,35,42,4785.57,8846.04,0.00
2024-12-08 17:17:10,76,7447,35,41,4841.56,8846.05,0.00
2024-12-08 17:17:10,75,7447,34,41,4897.85,8846.05,0.00
2024-12-08 17:17:10,75,7447,34,41,4931.93,8847.00,0.00
2024-12-08 17:17:10,76,7447,35,41,4867.04,8847.01,0.00
2024-12-08 17:17:10,75,7447,34,41,4845.99,8847.45,0.00
2024-12-08 17:17:10,75,7448,34,41,4915.98,8848.00,0.00
2024-12-08 17:17:10,76,7448,35,41,4851.29,8848.01,0.00
2024-12-08 17:17:10,75,7448,34,41,4912.45,8848.04,0.00
2024-12-08 17:17:10,74,7448,34,40,4969.27,8848.05,0.00
2024-12-08 17:17:10,73,7448,33,40,5027.64,8848.06,0.00
2024-12-08 17:17:10,73,7449,33,40,5065.78,8849.00,0.00
2024-12-08 17:17:10,74,7449,33,41,4997.32,8849.01,0.00
2024-12-08 17:17:10,74,7450,33,41,4982.34,8850.00,0.00
2024-12-08 17:17:10,75,7450,34,41,4915.91,8850.01,0.00
2024-12-08 17:17:10,74,7450,33,41,4981.83,8850.01,0.00
2024-12-08 17:17:10,73,7450,33,40,5037.96,8850.04,0.00
2024-12-08 17:17:10,72,7450,32,40,5084.59,8850.11,0.00
2024-12-08 17:17:10,73,7449,32,41,5010.12,8850.19,0.00
2024-12-08 17:17:10,73,7450,32,41,5096.71,8851.00,0.00
2024-12-08 17:17:10,74,7450,32,42,5027.84,8851.01,0.00
2024-12-08 17:17:10,73,7450,31,42,5091.87,8851.03,0.00
2024-12-08 17:17:10,73,7451,31,42,5223.61,8852.00,0.00
2024-12-08 17:17:10,74,7451,31,43,5153.02,8852.01,0.00
2024-12-08 17:17:10,73,7451,31,42,5213.92,8852.03,0.00
2024-12-08 17:17:10,73,7452,31,42,5222.23,8853.00,0.00
2024-12-08 17:17:10,74,7452,32,42,5151.66,8853.01,0.00
2024-12-08 17:17:10,74,7453,32,42,5132.22,8854.00,0.00
2024-12-08 17:17:10,75,7453,33,42,5063.79,8854.01,0.00
2024-12-08 17:17:10,74,7453,33,41,5122.66,8854.03,0.00
2024-12-08 17:17:11,74,7454,33,41,5128.88,8855.00,0.00
2024-12-08 17:17:11,75,7454,34,41,5060.50,8855.01,0.00
2024-12-08 17:17:11,74,7454,34,40,5112.73,8855.03,0.00
2024-12-08 17:17:11,73,7454,33,40,5117.54,8855.56,0.00
2024-12-08 17:17:11,73,7455,33,40,5200.37,8856.00,0.00
2024-12-08 17:17:11,74,7455,33,41,5130.10,8856.01,0.00
2024-12-08 17:17:11,74,7456,33,41,5115.11,8857.00,0.00
2024-12-08 17:17:11,75,7456,34,41,5046.91,8857.01,0.00
2024-12-08 17:17:11,74,7456,34,40,5107.94,8857.03,0.00
2024-12-08 17:17:11,74,7457,34,40,5118.09,8858.00,0.00
2024-12-08 17:17:11,75,7457,35,40,5049.84,8858.01,0.00
2024-12-08 17:17:11,74,7457,34,40,5078.65,8858.19,0.00
2024-12-08 17:17:11,74,7458,34,40,5103.10,8859.00,0.00
2024-12-08 17:17:11,75,7458,35,40,5035.06,8859.01,0.00
2024-12-08 17:17:11,74,7458,35,39,5097.12,8859.03,0.00
2024-12-08 17:17:11,74,7459,35,39,5106.11,8860.00,0.00
2024-12-08 17:17:11,75,7459,36,39,5038.03,8860.01,0.00
2024-12-08 17:17:11,75,7460,36,39,5020.19,8861.00,0.00
2024-12-08 17:17:11,76,7460,37,39,4954.13,8861.01,0.00
2024-12-08 17:17:11,75,7460,37,38,5014.29,8861.03,0.00
2024-12-08 17:17:11,75,7461,37,38,5020.68,8862.00,0.00
2024-12-08 17:17:11,76,7461,37,39,4954.62,8862.01,0.00
2024-12-08 17:17:11,76,7462,37,39,4936.30,8863.00,0.00
2024-12-08 17:17:11,77,7462,37,40,4872.19,8863.01,0.00
2024-12-08 17:17:11,76,7462,36,40,4898.26,8863.17,0.00
2024-12-08 17:17:11,75,7462,35,40,4961.21,8863.20,0.00
2024-12-08 17:17:11,75,7463,35,40,4984.82,8864.00,0.00
2024-12-08 17:17:11,76,7463,35,41,4919.23,8864.01,0.00
2024-12-08 17:17:11,76,7464,35,41,4902.29,8865.00,0.00
2024-12-08 17:17:11,77,7464,36,41,4838.62,8865.01,0.00
2024-12-08 17:17:11,77,7465,36,41,4820.74,8866.00,0.00
2024-12-08 17:17:11,78,7465,36,42,4758.94,8866.01,0.00
2024-12-08 17:17:11,77,7465,36,41,4810.40,8866.06,0.00
2024-12-08 17:17:11,76,7465,35,41,4813.34,8866.74,0.00
2024-12-08 17:17:11,76,7466,35,41,4883.56,8867.00,0.00
2024-12-08 17:17:11,77,7466,35,42,4820.13,8867.01,0.00
2024-12-08 17:17:11,77,7467,35,42,4802.25,8868.00,0.00
2024-12-08 17:17:11,78,7467,35,43,4740.68,8868.01,0.00
2024-12-08 17:17:11,77,7467,35,42,4794.21,8868.06,0.00
2024-12-08 17:17:11,76,7467,34,42,4823.58,8868.45,0.00
2024-12-08 17:17:11,76,7468,34,42,4868.32,8869.00,0.00
2024-12-08 17:17:11,77,7468,35,42,4805.10,8869.01,0.00
2024-12-08 17:17:12,78,7467,36,42,4656.27,8869.77,0.00
2024-12-08 17:17:12,78,7468,36,42,4747.44,8870.00,0.00
2024-12-08 17:17:12,79,7468,36,43,4687.34,8870.01,0.00
2024-12-08 17:17:12,78,7468,36,42,4740.63,8870.06,0.00
2024-12-08 17:17:12,78,7469,36,42,4862.84,8871.00,0.00
2024-12-08 17:17:12,79,7469,37,42,4801.29,8871.01,0.00
2024-12-08 17:17:12,79,7470,37,42,4781.61,8872.00,0.00
2024-12-08 17:17:12,80,7470,38,42,4721.84,8872.01,0.00
2024-12-08 17:17:12,79,7470,38,41,4776.01,8872.06,0.00
2024-12-08 17:17:12,79,7471,38,41,4783.28,8873.00,0.00
2024-12-08 17:17:12,80,7471,38,42,4723.48,8873.01,0.00
2024-12-08 17:17:12,79,7471,38,41,4755.21,8873.06,0.00
2024-12-08 17:17:12,79,7472,38,41,4762.47,8874.00,0.00
2024-12-08 17:17:12,80,7472,38,42,4702.94,8874.01,0.00
2024-12-08 17:17:12,79,7472,37,42,4653.83,8874.73,0.00
2024-12-08 17:17:12,79,7473,37,42,4742.79,8875.00,0.00
2024-12-08 17:17:12,80,7473,37,43,4683.50,8875.01,0.00
2024-12-08 17:17:12,79,7473,36,43,4737.19,8875.06,0.00
2024-12-08 17:17:12,78,7473,36,42,4795.64,8875.06,0.00
2024-12-08 17:17:12,78,7474,36,42,4826.89,8876.00,0.00
2024-12-08 17:17:12,79,7474,36,43,4765.79,8876.01,0.00
2024-12-08 17:17:12,78,7474,35,43,4775.58,8876.15,0.00
2024-12-08 17:17:12,78,7475,35,43,4814.78,8877.00,0.00
2024-12-08 17:17:12,79,7475,36,43,4753.83,8877.01,0.00
2024-12-08 17:17:12,78,7475,36,42,4799.72,8877.08,0.00
2024-12-08 17:17:12,77,7475,35,42,4837.86,8877.16,0.00
2024-12-08 17:17:12,76,7475,34,42,4896.86,8877.21,0.00
2024-12-08 17:17:12,76,7476,34,42,4944.09,8878.00,0.00
2024-12-08 17:17:12,77,7476,34,43,4879.88,8878.01,0.00
2024-12-08 17:17:12,76,7476,33,43,4874.41,8878.46,0.00
2024-12-08 17:17:12,76,7477,33,43,4920.37,8879.00,0.00
2024-12-08 17:17:12,77,7477,33,44,4856.47,8879.01,0.00
2024-12-08 17:17:12,76,7477,33,43,4901.17,8879.08,0.00
2024-12-08 17:17:12,76,7478,33,43,4913.40,8880.00,0.00
2024-12-08 17:17:12,77,7478,33,44,4849.59,8880.01,0.00
2024-12-08 17:17:12,76,7478,32,44,4853.69,8880.12,0.00
2024-12-08 17:17:12,76,7479,32,44,4892.78,8881.00,0.00
2024-12-08 17:17:12,77,7479,32,45,4829.24,8881.01,0.00
2024-12-08 17:17:12,76,7479,31,45,4872.58,8881.05,0.00
2024-12-08 17:17:12,75,7479,31,44,4928.08,8881.09,0.00
2024-12-08 17:17:12,75,7480,31,44,4942.83,8882.00,0.00
2024-12-08 17:17:12,76,7480,31,45,4877.79,8882.01,0.00
2024-12-08 17:17:12,76,7481,31,45,4860.81,8883.00,0.00
2024-12-08 17:17:12,77,7481,31,46,4797.68,8883.01,0.00
2024-12-08 17:17:12,76,7481,31,45,4844.46,8883.09,0.00
2024-12-08 17:17:12,76,7482,31,45,4857.85,8884.00,0.00
2024-12-08 17:17:12,77,7482,31,46,4794.76,8884.01,0.00
2024-12-08 17:17:12,76,7482,30,46,4853.18,8884.07,0.00
2024-12-08 17:17:12,75,7482,29,46,4881.21,8884.21,0.00
2024-12-08 17:17:12,75,7483,29,46,4906.59,8885.00,0.00
2024-12-08 17:17:12,76,7483,29,47,4842.03,8885.01,0.00
2024-12-08 17:17:12,75,7483,28,47,4904.23,8885.03,0.00
2024-12-08 17:17:12,74,7483,28,46,4957.30,8885.07,0.00
2024-12-08 17:17:12,73,7483,27,46,4998.50,8885.27,0.00
2024-12-08 17:17:12,73,7484,27,46,5056.19,8886.00,0.00
2024-12-08 17:17:12,74,7484,28,46,4987.87,8886.01,0.00
2024-12-08 17:17:12,73,7484,27,46,5041.59,8886.07,0.00
2024-12-08 17:17:13,73,7485,27,46,5056.76,8887.00,0.00
2024-12-08 17:17:13,74,7485,27,47,4988.43,8887.01,0.00
2024-12-08 17:17:13,73,7485,27,46,5054.33,8887.03,0.00
2024-12-08 17:17:13,72,7485,27,45,5112.19,8887.06,0.00
2024-12-08 17:17:13,72,7486,27,45,5127.57,8888.00,0.00
2024-12-08 17:17:13,73,7486,27,46,5057.33,8888.01,0.00
2024-12-08 17:17:13,73,7487,27,46,5043.29,8889.00,0.00
2024-12-08 17:17:13,74,7487,28,46,4975.14,8889.01,0.00
2024-12-08 17:17:13,73,7487,28,45,5031.12,8889.06,0.00
2024-12-08 17:17:13,73,7488,28,45,5042.47,8890.00,0.00
2024-12-08 17:17:13,74,7488,28,46,4974.32,8890.01,0.00
2024-12-08 17:17:13,74,7489,28,46,4954.42,8891.00,0.00
2024-12-08 17:17:13,75,7489,28,47,4888.36,8891.01,0.00
2024-12-08 17:17:13,74,7489,28,46,4937.61,8891.08,0.00
2024-12-08 17:17:13,74,7490,28,46,4945.52,8892.00,0.00
2024-12-08 17:17:13,75,7490,29,46,4879.58,8892.01,0.00
2024-12-08 17:17:13,74,7490,28,46,4897.55,8892.19,0.00
2024-12-08 17:17:13,74,7491,28,46,4922.09,8893.00,0.00
2024-12-08 17:17:13,75,7491,28,47,4856.47,8893.01,0.00
2024-12-08 17:17:13,74,7491,28,46,4904.08,8893.10,0.00
2024-12-08 17:17:13,73,7491,27,46,4963.98,8893.18,0.00
2024-12-08 17:17:13,73,7492,27,46,4988.86,8894.00,0.00
2024-12-08 17:17:13,74,7492,27,47,4921.44,8894.01,0.00
2024-12-08 17:17:13,73,7492,26,47,4974.25,8894.08,0.00
2024-12-08 17:17:13,73,7493,26,47,4990.64,8895.00,0.00
2024-12-08 17:17:13,74,7493,27,47,4923.20,8895.01,0.00
2024-12-08 17:17:13,73,7493,27,46,4974.81,8895.08,0.00
2024-12-08 17:17:13,74,7492,28,46,4840.48,8895.60,0.00
2024-12-08 17:17:13,74,7493,28,46,4983.86,8896.00,0.00
2024-12-08 17:17:13,75,7493,29,46,4917.41,8896.01,0.00
2024-12-08 17:17:13,75,7494,29,46,5019.98,8897.00,0.00
2024-12-08 17:17:13,76,7494,30,46,4953.93,8897.01,0.00
2024-12-08 17:17:13,75,7494,29,46,4952.73,8897.25,0.00
2024-12-08 17:17:13,75,7495,29,46,5005.42,8898.00,0.00
2024-12-08 17:17:13,76,7495,29,47,4939.56,8898.01,0.00
2024-12-08 17:17:13,75,7495,28,47,5003.05,8898.03,0.00
2024-12-08 17:17:13,74,7495,28,46,5063.45,8898.08,0.00
2024-12-08 17:17:13,74,7496,28,46,5078.44,8899.00,0.00
2024-12-08 17:17:13,75,7496,28,47,5010.73,8899.01,0.00
2024-12-08 17:17:13,75,7497,28,47,4994.68,8900.00,0.00
2024-12-08 17:17:13,76,7497,28,48,4928.96,8900.01,0.00
2024-12-08 17:17:13,75,7497,28,47,4976.89,8900.09,0.00
2024-12-08 17:17:13,75,7498,28,47,4991.68,8901.00,0.00
2024-12-08 17:17:13,76,7498,28,48,4926.00,8901.01,0.00
2024-12-08 17:17:13,76,7499,28,48,4908.98,8902.00,0.00
2024-12-08 17:17:13,77,7499,28,49,4845.23,8902.01,0.00
2024-12-08 17:17:13,76,7499,28,48,4892.59,8902.09,0.00
2024-12-08 17:17:13,75,7499,27,48,4865.73,8902.93,0.00
2024-12-08 17:17:13,75,7500,27,48,4978.55,8903.00,0.00
2024-12-08 17:17:13,76,7500,28,48,4913.05,8903.01,0.00
2024-12-08 17:17:13,76,7501,28,48,4896.03,8904.00,0.00
2024-12-08 17:17:13,77,7501,29,48,4832.44,8904.01,0.00
2024-12-08 17:17:13,76,7501,28,48,4893.68,8904.03,0.00
2024-12-08 17:17:13,75,7501,27,48,4955.38,8904.05,0.00
2024-12-08 17:17:13,74,7501,27,47,5009.11,8904.07,0.00
2024-12-08 17:17:13,74,7502,27,47,5022.90,8905.00,0.00
2024-12-08 17:17:13,75,7502,27,48,4955.93,8905.01,0.00
2024-12-08 17:17:14,75,7503,27,48,4939.86,8906.00,0.00
2024-12-08 17:17:14,76,7503,28,48,4874.86,8906.01,0.00
2024-12-08 17:17:14,75,7503,28,47,4924.43,8906.07,0.00
2024-12-08 17:17:14,75,7504,28,47,4936.85,8907.00,0.00
2024-12-08 17:17:14,76,7504,28,48,4871.89,8907.01,0.00
2024-12-08 17:17:14,75,7504,27,48,4846.83,8907.61,0.00
2024-12-08 17:17:14,75,7505,27,48,4931.47,8908.00,0.00
2024-12-08 17:17:14,76,7505,28,48,4866.58,8908.01,0.00
2024-12-08 17:17:14,75,7505,28,47,4917.22,8908.07,0.00
2024-12-08 17:17:14,74,7505,27,47,4970.47,8908.20,0.00
2024-12-08 17:17:14,74,7506,27,47,4996.26,8909.00,0.00
2024-12-08 17:17:14,75,7506,28,47,4929.64,8909.01,0.00
2024-12-08 17:17:14,74,7506,27,47,4981.81,8909.01,0.00
2024-12-08 17:17:14,74,7507,27,47,4990.80,8910.00,0.00
2024-12-08 17:17:14,75,7507,27,48,4924.26,8910.01,0.00
2024-12-08 17:17:14,74,7507,27,47,4978.77,8910.05,0.00
2024-12-08 17:17:14,74,7508,27,47,4991.36,8911.00,0.00
2024-12-08 17:17:14,75,7508,28,47,4924.81,8911.01,0.00
2024-12-08 17:17:14,74,7508,27,47,4951.66,8911.19,0.00
2024-12-08 17:17:14,74,7509,27,47,4976.27,8912.00,0.00
2024-12-08 17:17:14,75,7509,27,48,4909.92,8912.01,0.00
2024-12-08 17:17:14,75,7510,27,48,4893.83,8913.00,0.00
2024-12-08 17:17:14,76,7510,27,49,4829.44,8913.01,0.00
2024-12-08 17:17:14,75,7510,27,48,4880.76,8913.07,0.00
2024-12-08 17:17:14,74,7510,26,48,4921.44,8913.15,0.00
2024-12-08 17:17:14,74,7511,26,48,4966.54,8914.00,0.00
2024-12-08 17:17:14,75,7511,27,48,4900.32,8914.01,0.00
2024-12-08 17:17:14,74,7511,27,47,4961.72,8914.01,0.00
2024-12-08 17:17:14,73,7511,26,47,5011.38,8914.03,0.00
2024-12-08 17:17:14,73,7512,26,47,5047.35,8915.00,0.00
2024-12-08 17:17:14,74,7512,27,47,4979.15,8915.01,0.00
2024-12-08 17:17:14,73,7512,26,47,5005.88,8915.19,0.00
2024-12-08 17:17:14,73,7513,26,47,5027.45,8916.00,0.00
2024-12-08 17:17:14,74,7513,27,47,4959.52,8916.01,0.00
2024-12-08 17:17:14,73,7513,27,46,5017.69,8916.06,0.00
2024-12-08 17:17:14,73,7514,27,46,5030.89,8917.00,0.00
2024-12-08 17:17:14,74,7514,28,46,4962.91,8917.01,0.00
2024-12-08 17:17:14,74,7515,28,46,4947.80,8918.00,0.00
2024-12-08 17:17:14,75,7515,28,47,4881.83,8918.01,0.00
2024-12-08 17:17:14,74,7515,28,46,4946.59,8918.01,0.00
2024-12-08 17:17:14,73,7515,28,45,5013.13,8918.01,0.00
2024-12-08 17:17:14,72,7515,28,44,5080.28,8918.01,0.00
2024-12-08 17:17:14,72,7516,28,44,5092.00,8919.00,0.00
2024-12-08 17:17:14,73,7516,29,44,5022.25,8919.01,0.00
2024-12-08 17:17:14,72,7516,28,44,5053.64,8919.17,0.00
2024-12-08 17:17:14,72,7517,28,44,5078.94,8920.00,0.00
2024-12-08 17:17:14,73,7517,28,45,5009.37,8920.01,0.00
2024-12-08 17:17:14,72,7517,28,44,5070.27,8920.04,0.00
2024-12-08 17:17:14,71,7517,27,44,5131.67,8920.16,0.00
2024-12-08 17:17:14,70,7517,26,44,5203.71,8920.16,0.00
2024-12-08 17:17:14,70,7518,26,44,5230.83,8921.00,0.00
2024-12-08 17:17:14,71,7518,27,44,5157.16,8921.01,0.00
2024-12-08 17:17:14,71,7519,27,44,5143.90,8922.00,0.00
2024-12-08 17:17:14,72,7519,28,44,5072.45,8922.01,0.00
2024-12-08 17:17:15,71,7519,28,43,5136.36,8922.04,0.00
2024-12-08 17:17:15,71,7520,28,43,5141.59,8923.00,0.00
2024-12-08 17:17:15,72,7520,28,44,5070.18,8923.01,0.00
2024-12-08 17:17:15,72,7521,28,44,5016.13,8924.00,0.00
2024-12-08 17:17:15,73,7521,28,45,4947.42,8924.01,0.00
2024-12-08 17:17:15,72,7521,27,45,5014.89,8924.03,0.00
2024-12-08 17:17:15,71,7521,27,44,5077.98,8924.03,0.00
2024-12-08 17:17:15,71,7522,27,44,5009.41,8925.00,0.00
2024-12-08 17:17:15,72,7522,27,45,4939.84,8925.01,0.00
2024-12-08 17:17:15,71,7522,26,45,4957.95,8925.24,0.00
2024-12-08 17:17:15,72,7521,27,45,4864.44,8925.54,0.00
2024-12-08 17:17:15,71,7521,26,45,4934.34,8925.93,0.00
2024-12-08 17:17:15,71,7522,26,45,4999.41,8926.00,0.00
2024-12-08 17:17:15,72,7522,27,45,4929.97,8926.01,0.00
2024-12-08 17:17:15,71,7522,27,44,4875.53,8926.92,0.00
2024-12-08 17:17:15,71,7523,27,44,5094.35,8927.00,0.00
2024-12-08 17:17:15,72,7523,27,45,5023.60,8927.01,0.00
2024-12-08 17:17:15,71,7523,27,44,5089.33,8927.03,0.00
2024-12-08 17:17:15,71,7524,27,44,5103.73,8928.00,0.00
2024-12-08 17:17:15,72,7524,27,45,5032.84,8928.01,0.00
2024-12-08 17:17:15,72,7525,27,45,5019.76,8929.00,0.00
2024-12-08 17:17:15,73,7525,28,45,4951.00,8929.01,0.00
2024-12-08 17:17:15,72,7525,28,44,5014.81,8929.03,0.00
2024-12-08 17:17:15,72,7526,28,44,5027.77,8930.00,0.00
2024-12-08 17:17:15,73,7526,28,45,4958.89,8930.01,0.00
2024-12-08 17:17:15,72,7526,27,45,4986.89,8930.19,0.00
2024-12-08 17:17:15,72,7527,27,45,5014.69,8931.00,0.00
2024-12-08 17:17:15,73,7527,27,46,4945.99,8931.01,0.00
2024-12-08 17:17:15,72,7527,27,45,5010.97,8931.03,0.00
2024-12-08 17:17:15,72,7528,27,45,5023.93,8932.00,0.00
2024-12-08 17:17:15,73,7528,27,46,4955.11,8932.01,0.00
2024-12-08 17:17:15,73,7529,27,46,4940.98,8933.00,0.00
2024-12-08 17:17:15,74,7529,27,47,4874.21,8933.01,0.00
2024-12-08 17:17:15,73,7529,27,46,4933.64,8933.04,0.00
2024-12-08 17:17:15,72,7529,26,46,4995.96,8933.04,0.00
2024-12-08 17:17:15,72,7530,26,46,5034.98,8934.00,0.00
2024-12-08 17:17:15,73,7530,26,47,4966.01,8934.01,0.00
2024-12-08 17:17:15,73,7531,26,47,4951.88,8935.00,0.00
2024-12-08 17:17:15,74,7531,26,48,4884.96,8935.01,0.00
2024-12-08 17:17:15,73,7531,26,47,4938.42,8935.06,0.00
2024-12-08 17:17:15,73,7532,26,47,4952.43,8936.00,0.00
2024-12-08 17:17:15,74,7532,27,47,4885.51,8936.01,0.00
2024-12-08 17:17:15,74,7533,27,47,4870.36,8937.00,0.00
2024-12-08 17:17:15,75,7533,28,47,4805.42,8937.01,0.00
2024-12-08 17:17:15,74,7533,28,46,4858.29,8937.05,0.00
2024-12-08 17:17:15,74,7534,28,46,4870.90,8938.00,0.00
2024-12-08 17:17:15,75,7534,28,47,4805.95,8938.01,0.00
2024-12-08 17:17:15,75,7535,28,47,4789.81,8939.00,0.00
2024-12-08 17:17:15,76,7535,28,48,4726.78,8939.01,0.00
2024-12-08 17:17:15,75,7535,27,48,4769.55,8939.03,0.00
2024-12-08 17:17:16,75,7536,27,48,4778.42,8940.00,0.00
2024-12-08 17:17:16,76,7536,27,49,4715.55,8940.01,0.00
2024-12-08 17:17:16,75,7536,27,48,4762.94,8940.08,0.00
2024-12-08 17:17:16,74,7536,26,48,4810.40,8940.11,0.00
2024-12-08 17:17:16,74,7537,26,48,4852.00,8941.00,0.00
2024-12-08 17:17:16,75,7537,26,49,4787.30,8941.01,0.00
2024-12-08 17:17:16,74,7537,25,49,4804.89,8941.11,0.00
2024-12-08 17:17:16,74,7538,25,49,4846.17,8942.00,0.00
2024-12-08 17:17:16,75,7538,25,50,4781.56,8942.01,0.00
2024-12-08 17:17:16,74,7538,25,49,4844.97,8942.01,0.00
2024-12-08 17:17:16,73,7538,25,48,4897.88,8942.07,0.00
2024-12-08 17:17:16,72,7538,24,48,4884.24,8942.71,0.00
2024-12-08 17:17:16,72,7539,24,48,4982.59,8943.00,0.00
2024-12-08 17:17:16,73,7539,25,48,4914.33,8943.01,0.00
2024-12-08 17:17:16,73,7540,25,48,4900.18,8944.00,0.00
2024-12-08 17:17:16,74,7540,26,48,4833.96,8944.01,0.00
2024-12-08 17:17:16,73,7540,26,47,4897.73,8944.03,0.00
2024-12-08 17:17:16,72,7540,25,47,4901.34,8944.47,0.00
2024-12-08 17:17:16,72,7541,25,47,4953.89,8945.00,0.00
2024-12-08 17:17:16,73,7541,25,48,4886.03,8945.01,0.00
2024-12-08 17:17:16,72,7541,24,48,4863.52,8945.74,0.00
2024-12-08 17:17:16,72,7542,24,48,4939.53,8946.00,0.00
2024-12-08 17:17:16,73,7542,25,48,4871.87,8946.01,0.00
2024-12-08 17:17:16,72,7542,25,47,4910.96,8946.04,0.00
2024-12-08 17:17:16,72,7543,25,47,4925.17,8947.00,0.00
2024-12-08 17:17:16,73,7543,26,47,4857.70,8947.01,0.00
2024-12-08 17:17:16,72,7543,26,46,4917.73,8947.04,0.00
2024-12-08 17:17:16,72,7544,26,46,4931.94,8948.00,0.00
2024-12-08 17:17:16,73,7544,27,46,4864.38,8948.01,0.00
2024-12-08 17:17:16,73,7545,27,46,4850.21,8949.00,0.00
2024-12-08 17:17:16,74,7545,27,47,4784.66,8949.01,0.00
2024-12-08 17:17:16,73,7545,27,46,4841.63,8949.04,0.00
2024-12-08 17:17:16,73,7546,27,46,4851.90,8950.00,0.00
2024-12-08 17:17:16,74,7546,28,46,4786.34,8950.01,0.00
2024-12-08 17:17:16,74,7547,28,46,4762.10,8951.00,0.00
2024-12-08 17:17:16,75,7547,29,46,4698.60,8951.01,0.00
2024-12-08 17:17:16,74,7547,29,45,4754.85,8951.04,0.00
2024-12-08 17:17:16,74,7548,29,45,4755.80,8952.00,0.00
2024-12-08 17:17:16,75,7548,30,45,4692.38,8952.01,0.00
2024-12-08 17:17:16,75,7549,30,45,4666.53,8953.00,0.00
2024-12-08 17:17:16,76,7549,30,46,4605.12,8953.01,0.00
2024-12-08 17:17:16,75,7549,30,45,4660.56,8953.04,0.00
2024-12-08 17:17:16,75,7550,30,45,4663.68,8954.00,0.00
2024-12-08 17:17:16,76,7550,31,45,4602.32,8954.01,0.00
2024-12-08 17:17:16,75,7550,30,45,4588.60,8954.41,0.00
2024-12-08 17:17:16,75,7551,30,45,4651.36,8955.00,0.00
2024-12-08 17:17:16,76,7551,31,45,4590.16,8955.01,0.00
2024-12-08 17:17:16,75,7551,31,44,4646.59,8955.04,0.00
2024-12-08 17:17:16,75,7552,31,44,4651.67,8956.00,0.00
2024-12-08 17:17:16,76,7552,31,45,4590.46,8956.01,0.00
2024-12-08 17:17:16,75,7552,31,44,4645.71,8956.04,0.00
2024-12-08 17:17:16,74,7552,30,44,4647.78,8956.55,0.00
2024-12-08 17:17:16,74,7553,30,44,4729.20,8957.00,0.00
2024-12-08 17:17:16,75,7553,30,45,4666.15,8957.01,0.00
2024-12-08 17:17:16,74,7553,30,44,4723.16,8957.04,0.00
2024-12-08 17:17:17,74,7554,30,44,4725.72,8958.00,0.00
2024-12-08 17:17:17,75,7554,30,45,4662.71,8958.01,0.00
2024-12-08 17:17:17,75,7555,30,45,4635.34,8959.00,0.00
2024-12-08 17:17:17,76,7555,30,46,4574.35,8959.01,0.00
2024-12-08 17:17:17,75,7555,30,45,4630.57,8959.04,0.00
2024-12-08 17:17:17,74,7555,29,45,4650.03,8959.47,0.00
2024-12-08 17:17:17,74,7556,29,45,4700.03,8960.00,0.00
2024-12-08 17:17:17,75,7556,30,45,4637.37,8960.01,0.00
2024-12-08 17:17:17,75,7557,30,45,4620.82,8961.00,0.00
2024-12-08 17:17:17,76,7557,31,45,4560.02,8961.01,0.00
2024-12-08 17:17:17,75,7557,30,45,4619.63,8961.01,0.00
2024-12-08 17:17:17,74,7557,30,44,4679.64,8961.03,0.00
2024-12-08 17:17:17,74,7558,30,44,4689.84,8962.00,0.00
2024-12-08 17:17:17,75,7558,30,45,4627.31,8962.01,0.00
2024-12-08 17:17:17,74,7558,30,44,4663.20,8962.03,0.00
2024-12-08 17:17:17,74,7559,30,44,4673.41,8963.00,0.00
2024-12-08 17:17:17,75,7559,31,44,4611.10,8963.01,0.00
2024-12-08 17:17:17,74,7559,31,43,4646.77,8963.03,0.00
2024-12-08 17:17:17,73,7559,30,43,4655.30,8963.44,0.00
2024-12-08 17:17:17,73,7560,30,43,4728.13,8964.00,0.00
2024-12-08 17:17:17,74,7560,31,43,4664.24,8964.01,0.00
2024-12-08 17:17:17,73,7560,31,42,4701.12,8964.03,0.00
2024-12-08 17:17:17,73,7561,31,42,4712.69,8965.00,0.00
2024-12-08 17:17:17,74,7561,31,43,4649.01,8965.01,0.00
2024-12-08 17:17:17,73,7561,31,42,4685.68,8965.03,0.00
2024-12-08 17:17:17,73,7562,31,42,4697.16,8966.00,0.00
2024-12-08 17:17:17,74,7562,32,42,4633.68,8966.01,0.00
2024-12-08 17:17:17,73,7562,31,42,4694.70,8966.03,0.00
2024-12-08 17:17:17,72,7562,30,42,4694.09,8966.46,0.00
2024-12-08 17:17:17,72,7563,30,42,4770.43,8967.00,0.00
2024-12-08 17:17:17,73,7563,31,42,4705.08,8967.01,0.00
2024-12-08 17:17:17,72,7563,31,41,4767.95,8967.03,0.00
2024-12-08 17:17:17,72,7564,31,41,4778.55,8968.00,0.00
2024-12-08 17:17:17,73,7564,31,42,4713.09,8968.01,0.00
2024-12-08 17:17:17,72,7564,31,41,4751.15,8968.03,0.00
2024-12-08 17:17:17,71,7564,30,41,4815.54,8968.03,0.00
2024-12-08 17:17:17,71,7565,30,41,4851.75,8969.00,0.00
2024-12-08 17:17:17,72,7565,31,41,4784.37,8969.01,0.00
2024-12-08 17:17:17,72,7566,31,41,4765.38,8970.00,0.00
2024-12-08 17:17:17,73,7566,31,42,4700.10,8970.01,0.00
2024-12-08 17:17:17,72,7566,31,41,4762.89,8970.03,0.00
2024-12-08 17:17:17,71,7566,30,41,4809.54,8970.25,0.00
2024-12-08 17:17:17,71,7567,30,41,4829.70,8971.00,0.00
2024-12-08 17:17:17,72,7567,30,42,4762.62,8971.01,0.00
2024-12-08 17:17:17,71,7567,29,42,4795.42,8971.11,0.00
2024-12-08 17:17:17,70,7567,28,42,4821.39,8971.30,0.00
2024-12-08 17:17:17,70,7568,28,42,4861.58,8972.00,0.00
2024-12-08 17:17:17,71,7568,28,43,4793.11,8972.01,0.00
2024-12-08 17:17:17,71,7569,28,43,4781.01,8973.00,0.00
2024-12-08 17:17:17,72,7569,28,44,4714.60,8973.01,0.00
2024-12-08 17:17:17,71,7569,27,44,4753.20,8973.04,0.00
2024-12-08 17:17:17,70,7569,27,43,4794.19,8973.04,0.00
2024-12-08 17:17:17,70,7570,27,43,4837.03,8974.00,0.00
2024-12-08 17:17:17,71,7570,28,43,4768.90,8974.01,0.00
2024-12-08 17:17:17,70,7570,28,42,4807.54,8974.04,0.00
2024-12-08 17:17:17,70,7571,28,42,4824.74,8975.00,0.00
2024-12-08 17:17:17,71,7571,29,42,4756.79,8975.01,0.00
2024-12-08 17:17:17,70,7571,28,42,4823.46,8975.02,0.00
2024-12-08 17:17:17,69,7571,27,42,4890.77,8975.03,0.00
2024-12-08 17:17:17,68,7571,26,42,4961.37,8975.03,0.00
2024-12-08 17:17:17,68,7572,26,42,4954.00,8976.00,0.00
2024-12-08 17:17:17,69,7572,27,42,4882.20,8976.02,0.00
2024-12-08 17:17:17,68,7572,27,41,4948.72,8976.03,0.00
2024-12-08 17:17:18,68,7573,27,41,4967.75,8977.00,0.00
2024-12-08 17:17:18,69,7573,27,42,4895.76,8977.02,0.00
2024-12-08 17:17:18,69,7574,27,42,4885.89,8978.00,0.00
2024-12-08 17:17:18,70,7574,27,43,4816.10,8978.02,0.00
2024-12-08 17:17:18,69,7574,27,42,4881.99,8978.03,0.00
2024-12-08 17:17:18,69,7575,27,42,4899.45,8979.00,0.00
2024-12-08 17:17:18,70,7575,27,43,4829.46,8979.02,0.00
2024-12-08 17:17:18,70,7576,27,43,4818.45,8980.00,0.00
2024-12-08 17:17:18,71,7576,28,43,4750.59,8980.01,0.00
2024-12-08 17:17:18,70,7576,28,42,4810.75,8980.02,0.00
2024-12-08 17:17:18,69,7576,28,41,4879.17,8980.02,0.00
2024-12-08 17:17:18,69,7577,28,41,4895.34,8981.00,0.00
2024-12-08 17:17:18,70,7577,28,42,4825.40,8981.02,0.00
2024-12-08 17:17:18,69,7577,28,41,4868.00,8981.02,0.00
2024-12-08 17:17:18,69,7578,28,41,4884.17,8982.00,0.00
2024-12-08 17:17:18,70,7578,28,42,4814.39,8982.02,0.00
2024-12-08 17:17:18,69,7578,28,41,4856.83,8982.02,0.00
2024-12-08 17:17:18,69,7579,28,41,4872.99,8983.00,0.00
2024-12-08 17:17:18,70,7579,29,41,4803.38,8983.02,0.00
2024-12-08 17:17:18,70,7580,29,41,4792.36,8984.00,0.00
2024-12-08 17:17:18,71,7580,29,42,4724.86,8984.01,0.00
2024-12-08 17:17:18,70,7580,28,42,4791.08,8984.02,0.00
2024-12-08 17:17:18,69,7580,28,41,4857.91,8984.02,0.00
2024-12-08 17:17:18,68,7580,27,41,4867.55,8984.71,0.00
2024-12-08 17:17:18,68,7581,27,41,4947.08,8985.00,0.00
2024-12-08 17:17:18,69,7581,27,42,4875.38,8985.02,0.00
2024-12-08 17:17:18,68,7581,26,42,4841.64,8985.66,0.00
2024-12-08 17:17:18,68,7582,26,42,4943.66,8986.00,0.00
2024-12-08 17:17:18,69,7582,27,42,4872.02,8986.02,0.00
2024-12-08 17:17:18,68,7582,27,41,4941.02,8986.02,0.00
2024-12-08 17:17:18,68,7583,27,41,4958.75,8987.00,0.00
2024-12-08 17:17:18,69,7583,27,42,4886.88,8987.02,0.00
2024-12-08 17:17:18,68,7583,26,42,4905.84,8987.04,0.00
2024-12-08 17:17:18,68,7584,26,42,4948.96,8988.00,0.00
2024-12-08 17:17:18,69,7584,26,43,4877.23,8988.02,0.00
2024-12-08 17:17:18,68,7584,25,43,4947.64,8988.02,0.00
2024-12-08 17:17:18,67,7584,24,43,5005.39,8988.06,0.00
2024-12-08 17:17:18,67,7585,24,43,5020.81,8989.00,0.00
2024-12-08 17:17:18,68,7585,25,43,4946.97,8989.02,0.00
2024-12-08 17:17:18,68,7586,25,43,4929.18,8990.00,0.00
2024-12-08 17:17:18,69,7586,25,44,4857.74,8990.02,0.00
2024-12-08 17:17:18,68,7586,25,43,4927.86,8990.02,0.00
2024-12-08 17:17:18,67,7586,25,42,4994.70,8990.03,0.00
2024-12-08 17:17:18,66,7586,24,42,5062.23,8990.12,0.00
2024-12-08 17:17:18,65,7586,23,42,5100.09,8990.34,0.00
2024-12-08 17:17:18,65,7587,23,42,5171.54,8991.00,0.00
2024-12-08 17:17:18,66,7587,24,42,5093.19,8991.02,0.00
2024-12-08 17:17:18,65,7587,23,42,5085.91,8991.39,0.00
2024-12-08 17:17:18,65,7588,23,42,5164.91,8992.00,0.00
2024-12-08 17:17:18,66,7588,24,42,5086.65,8992.02,0.00
2024-12-08 17:17:18,65,7588,24,41,5145.54,8992.05,0.00
2024-12-08 17:17:18,65,7589,24,41,5168.72,8993.00,0.00
2024-12-08 17:17:18,66,7589,25,41,5090.41,8993.02,0.00
2024-12-08 17:17:18,66,7590,25,41,5084.16,8994.00,0.00
2024-12-08 17:17:18,67,7590,25,42,5008.28,8994.02,0.00
2024-12-08 17:17:18,66,7590,25,41,5066.45,8994.05,0.00
2024-12-08 17:17:18,66,7591,25,41,5089.17,8995.00,0.00
2024-12-08 17:17:18,67,7591,25,42,5013.22,8995.02,0.00
2024-12-08 17:17:18,66,7591,25,41,5064.64,8995.02,0.00
2024-12-08 17:17:18,66,7592,25,41,5083.28,8996.00,0.00
2024-12-08 17:17:18,67,7592,26,41,5007.41,8996.02,0.00
2024-12-08 17:17:18,66,7592,25,41,5019.35,8996.42,0.00
2024-12-08 17:17:19,66,7593,25,41,5075.11,8997.00,0.00
2024-12-08 17:17:19,67,7593,26,41,4999.36,8997.02,0.00
2024-12-08 17:17:19,66,7593,26,40,5061.48,8997.03,0.00
2024-12-08 17:17:19,65,7593,25,40,5125.55,8997.17,0.00
2024-12-08 17:17:19,65,7594,25,40,5161.28,8998.00,0.00
2024-12-08 17:17:19,66,7594,26,40,5083.08,8998.02,0.00
2024-12-08 17:17:19,65,7594,26,39,5159.90,8998.02,0.00
2024-12-08 17:17:19,65,7595,26,39,5154.68,8999.00,0.00
2024-12-08 17:17:19,66,7595,26,40,5076.58,8999.02,0.00
2024-12-08 17:17:19,65,7595,26,39,5139.46,8999.03,0.00
2024-12-08 17:17:19,65,7596,26,39,5161.99,9000.00,0.00
2024-12-08 17:17:19,66,7596,27,39,5083.77,9000.02,0.00
2024-12-08 17:17:19,66,7597,27,39,5076.33,9001.00,0.00
2024-12-08 17:17:19,67,7597,27,40,5000.56,9001.02,0.00
2024-12-08 17:17:19,66,7597,26,40,5020.48,9001.24,0.00
2024-12-08 17:17:19,66,7598,26,40,5088.05,9002.00,0.00
2024-12-08 17:17:19,67,7598,26,41,5012.11,9002.02,0.00
2024-12-08 17:17:19,66,7598,26,40,5074.41,9002.03,0.00
2024-12-08 17:17:19,66,7599,26,40,5094.96,9003.00,0.00
2024-12-08 17:17:19,67,7599,27,40,5018.92,9003.02,0.00
2024-12-08 17:17:19,66,7599,26,40,5050.00,9003.20,0.00
2024-12-08 17:17:19,66,7600,26,40,5109.31,9004.00,0.00
2024-12-08 17:17:19,67,7600,27,40,5033.05,9004.02,0.00
2024-12-08 17:17:19,66,7600,27,39,5097.03,9004.03,0.00
2024-12-08 17:17:19,66,7601,27,39,5110.79,9005.00,0.00
2024-12-08 17:17:19,67,7601,27,40,5034.51,9005.02,0.00
2024-12-08 17:17:19,67,7602,27,40,5016.74,9006.00,0.00
2024-12-08 17:17:19,68,7602,28,40,4942.97,9006.02,0.00
2024-12-08 17:17:19,67,7602,28,39,5014.05,9006.02,0.00
2024-12-08 17:17:19,67,7603,28,39,5024.93,9007.00,0.00
2024-12-08 17:17:19,68,7603,28,40,4951.03,9007.02,0.00
2024-12-08 17:17:19,67,7603,28,39,5016.86,9007.02,0.00
2024-12-08 17:17:19,66,7603,27,39,5071.10,9007.20,0.00
2024-12-08 17:17:19,66,7604,27,39,5129.13,9008.00,0.00
2024-12-08 17:17:19,67,7604,27,40,5052.58,9008.02,0.00
2024-12-08 17:17:19,66,7604,26,40,5073.88,9008.32,0.00
2024-12-08 17:17:19,66,7605,26,40,5118.62,9009.00,0.00
2024-12-08 17:17:19,67,7605,26,41,5042.22,9009.02,0.00
2024-12-08 17:17:19,66,7605,26,40,5111.79,9009.02,0.00
2024-12-08 17:17:19,66,7606,26,40,5132.84,9010.00,0.00
2024-12-08 17:17:19,67,7606,27,40,5056.23,9010.02,0.00
2024-12-08 17:17:19,67,7607,27,40,5048.72,9011.00,0.00
2024-12-08 17:17:19,68,7607,28,40,4974.47,9011.02,0.00
2024-12-08 17:17:19,67,7607,28,39,5043.34,9011.02,0.00
2024-12-08 17:17:19,67,7608,28,39,5062.73,9012.00,0.00
2024-12-08 17:17:19,68,7608,29,39,4988.28,9012.02,0.00
2024-12-08 17:17:19,68,7609,29,39,4970.97,9013.00,0.00
2024-12-08 17:17:19,69,7609,30,39,4898.93,9013.02,0.00
2024-12-08 17:17:19,68,7609,30,38,4957.73,9013.06,0.00
2024-12-08 17:17:19,69,7608,31,38,4855.96,9013.42,0.00
2024-12-08 17:17:19,69,7609,31,38,4942.26,9014.00,0.00
2024-12-08 17:17:19,70,7609,31,39,4871.65,9014.02,0.00
2024-12-08 17:17:19,69,7609,31,38,4840.21,9014.61,0.00
2024-12-08 17:17:19,69,7610,31,38,5040.39,9015.00,0.00
2024-12-08 17:17:19,70,7610,31,39,4968.38,9015.02,0.00
2024-12-08 17:17:19,69,7610,31,38,5012.95,9015.02,0.00
2024-12-08 17:17:19,69,7611,31,38,5029.19,9016.00,0.00
2024-12-08 17:17:19,70,7611,32,38,4957.34,9016.02,0.00
2024-12-08 17:17:19,69,7611,32,37,5020.04,9016.04,0.00
2024-12-08 17:17:19,69,7612,32,37,5038.89,9017.00,0.00
2024-12-08 17:17:19,70,7612,32,38,4966.91,9017.02,0.00
2024-12-08 17:17:20,69,7612,31,38,5038.89,9017.02,0.00
2024-12-08 17:17:20,68,7612,30,38,5007.19,9017.65,0.00
2024-12-08 17:17:20,68,7613,30,38,5108.25,9018.00,0.00
2024-12-08 17:17:20,69,7613,31,38,5034.22,9018.02,0.00
2024-12-08 17:17:20,68,7613,31,37,5080.40,9018.02,0.00
2024-12-08 17:17:20,68,7614,31,37,5098.21,9019.00,0.00
2024-12-08 17:17:20,69,7614,32,37,5024.32,9019.02,0.00
2024-12-08 17:17:20,68,7614,32,36,5094.23,9019.02,0.00
2024-12-08 17:17:20,67,7614,31,36,5110.00,9019.69,0.00
2024-12-08 17:17:20,67,7615,31,36,5189.69,9020.00,0.00
2024-12-08 17:17:20,68,7615,31,37,5113.37,9020.02,0.00
2024-12-08 17:17:20,67,7615,30,37,5122.54,9020.45,0.00
2024-12-08 17:17:20,67,7616,30,37,5180.84,9021.00,0.00
2024-12-08 17:17:20,68,7616,30,38,5104.65,9021.02,0.00
2024-12-08 17:17:20,67,7616,30,37,5178.14,9021.02,0.00
2024-12-08 17:17:20,67,7617,30,37,5197.57,9022.00,0.00
2024-12-08 17:17:20,68,7617,31,37,5121.14,9022.02,0.00
2024-12-08 17:17:20,68,7618,31,37,5112.41,9023.00,0.00
2024-12-08 17:17:20,69,7618,31,38,5038.32,9023.02,0.00
2024-12-08 17:17:20,68,7618,31,37,5108.43,9023.02,0.00
2024-12-08 17:17:20,68,7619,31,37,5126.25,9024.00,0.00
2024-12-08 17:17:20,69,7619,32,37,5051.96,9024.02,0.00
2024-12-08 17:17:20,69,7620,32,37,5042.05,9025.00,0.00
2024-12-08 17:17:20,70,7620,33,37,4970.02,9025.02,0.00
2024-12-08 17:17:20,69,7620,33,36,5034.21,9025.03,0.00
2024-12-08 17:17:20,69,7621,33,36,5051.77,9026.00,0.00
2024-12-08 17:17:20,70,7621,33,37,4979.60,9026.02,0.00
2024-12-08 17:17:20,69,7621,32,37,5040.00,9026.04,0.00
2024-12-08 17:17:20,69,7622,32,37,5058.87,9027.00,0.00
2024-12-08 17:17:20,70,7622,32,38,4986.60,9027.02,0.00
2024-12-08 17:17:20,69,7622,31,38,5057.56,9027.02,0.00
2024-12-08 17:17:20,68,7622,30,38,5125.30,9027.02,0.00
2024-12-08 17:17:20,67,7622,30,37,5192.37,9027.02,0.00
2024-12-08 17:17:20,67,7623,30,37,5238.75,9028.00,0.00
2024-12-08 17:17:20,68,7623,30,38,5161.71,9028.02,0.00
2024-12-08 17:17:20,68,7624,30,38,5152.99,9029.00,0.00
2024-12-08 17:17:20,69,7624,31,38,5078.31,9029.02,0.00
2024-12-08 17:17:20,68,7624,31,37,5141.04,9029.03,0.00
2024-12-08 17:17:20,67,7624,30,37,5145.16,9029.61,0.00
2024-12-08 17:17:20,67,7625,30,37,5245.21,9030.00,0.00
2024-12-08 17:17:20,68,7625,31,37,5168.07,9030.02,0.00
2024-12-08 17:17:20,67,7625,30,37,5204.81,9030.16,0.00
2024-12-08 17:17:20,67,7626,30,37,5235.41,9031.00,0.00
2024-12-08 17:17:20,68,7626,30,38,5158.42,9031.02,0.00
2024-12-08 17:17:20,67,7626,30,37,5224.63,9031.03,0.00
2024-12-08 17:17:20,67,7627,30,37,5241.01,9032.00,0.00
2024-12-08 17:17:20,68,7627,30,38,5163.93,9032.02,0.00
2024-12-08 17:17:20,67,7627,29,38,5143.76,9032.43,0.00
2024-12-08 17:17:20,68,7626,30,38,5061.52,9032.53,0.00
2024-12-08 17:17:20,68,7627,30,38,5194.73,9033.00,0.00
2024-12-08 17:17:20,69,7627,30,39,5119.44,9033.02,0.00
2024-12-08 17:17:20,68,7627,30,38,5185.43,9033.03,0.00
2024-12-08 17:17:20,67,7627,29,38,5222.48,9033.31,0.00
2024-12-08 17:17:20,67,7628,29,38,5424.33,9034.00,0.00
2024-12-08 17:17:20,68,7628,29,39,5344.56,9034.02,0.00
2024-12-08 17:17:20,67,7628,28,39,5422.98,9034.02,0.00
2024-12-08 17:17:20,67,7629,28,39,5436.37,9035.00,0.00
2024-12-08 17:17:20,68,7629,28,40,5356.43,9035.02,0.00
2024-12-08 17:17:20,68,7630,28,40,5341.69,9036.00,0.00
2024-12-08 17:17:20,69,7630,29,40,5264.27,9036.02,0.00
2024-12-08 17:17:20,68,7630,29,39,5331.06,9036.03,0.00
2024-12-08 17:17:20,67,7630,28,39,5398.49,9036.03,0.00
2024-12-08 17:17:20,68,7629,29,39,5311.15,9036.15,0.00
2024-12-08 17:17:21,68,7630,29,39,5391.56,9037.00,0.00
2024-12-08 17:17:21,69,7630,29,40,5313.42,9037.02,0.00
2024-12-08 17:17:21,69,7631,29,40,5430.31,9038.00,0.00
2024-12-08 17:17:21,70,7631,30,40,5352.73,9038.02,0.00
2024-12-08 17:17:21,69,7631,30,39,5418.52,9038.03,0.00
2024-12-08 17:17:21,69,7632,30,39,5433.74,9039.00,0.00
2024-12-08 17:17:21,70,7632,31,39,5356.11,9039.02,0.00
2024-12-08 17:17:21,69,7632,31,38,5432.43,9039.02,0.00
2024-12-08 17:17:21,69,7633,31,38,5418.18,9040.00,0.00
2024-12-08 17:17:21,70,7633,31,39,5340.78,9040.02,0.00
2024-12-08 17:17:21,69,7633,31,38,5403.77,9040.04,0.00
2024-12-08 17:17:21,69,7634,31,38,5411.33,9041.00,0.00
2024-12-08 17:17:21,70,7634,32,38,5334.03,9041.02,0.00
2024-12-08 17:17:21,69,7634,31,38,5368.19,9041.12,0.00
2024-12-08 17:17:21,69,7635,31,38,5393.65,9042.00,0.00
2024-12-08 17:17:21,70,7635,31,39,5316.60,9042.02,0.00
2024-12-08 17:17:21,69,7635,31,38,5379.24,9042.04,0.00
2024-12-08 17:17:21,69,7636,31,38,5398.18,9043.00,0.00
2024-12-08 17:17:21,70,7636,31,39,5321.06,9043.02,0.00
2024-12-08 17:17:21,70,7637,31,39,5310.02,9044.00,0.00
2024-12-08 17:17:21,71,7637,32,39,5235.23,9044.01,0.00
2024-12-08 17:17:21,71,7638,32,39,5223.07,9045.00,0.00
2024-12-08 17:17:21,72,7638,33,39,5150.53,9045.01,0.00
2024-12-08 17:17:21,72,7639,33,39,5137.28,9046.00,0.00
2024-12-08 17:17:21,73,7639,34,39,5066.90,9046.01,0.00
2024-12-08 17:17:21,73,7640,34,39,5052.59,9047.00,0.00
2024-12-08 17:17:21,74,7640,35,39,4984.31,9047.01,0.00
2024-12-08 17:17:21,73,7640,34,39,5052.59,9047.01,0.00
2024-12-08 17:17:21,72,7640,34,38,5107.69,9047.04,0.00
2024-12-08 17:17:21,72,7641,34,38,5122.08,9048.00,0.00
2024-12-08 17:17:21,73,7641,35,38,5051.91,9048.01,0.00
2024-12-08 17:17:21,73,7642,35,38,5037.59,9049.00,0.00
2024-12-08 17:17:21,74,7642,35,39,4969.52,9049.01,0.00
2024-12-08 17:17:21,73,7642,35,38,5028.92,9049.04,0.00
2024-12-08 17:17:21,72,7642,34,38,5091.23,9049.04,0.00
2024-12-08 17:17:21,71,7642,33,38,5148.95,9049.18,0.00
2024-12-08 17:17:21,71,7643,33,38,5203.02,9050.00,0.00
2024-12-08 17:17:21,72,7643,33,39,5130.75,9050.01,0.00
2024-12-08 17:17:21,72,7644,33,39,5117.49,9051.00,0.00
2024-12-08 17:17:21,73,7644,33,40,5047.39,9051.01,0.00
2024-12-08 17:17:21,72,7644,33,39,5104.92,9051.06,0.00
2024-12-08 17:17:21,72,7645,33,39,5120.57,9052.00,0.00
2024-12-08 17:17:21,73,7645,34,39,5050.42,9052.01,0.00
2024-12-08 17:17:21,72,7645,33,39,5079.12,9052.18,0.00
2024-12-08 17:17:21,73,7644,33,40,5005.83,9052.25,0.00
2024-12-08 17:17:21,73,7645,33,40,5129.11,9053.00,0.00
2024-12-08 17:17:21,74,7645,33,41,5059.80,9053.01,0.00
2024-12-08 17:17:21,73,7645,33,40,5117.95,9053.06,0.00
2024-12-08 17:17:21,72,7645,33,39,5182.86,9053.11,0.00
2024-12-08 17:17:21,72,7646,33,39,5329.28,9054.00,0.00
2024-12-08 17:17:21,73,7646,33,40,5256.28,9054.01,0.00
2024-12-08 17:17:22,73,7647,33,40,5241.97,9055.00,0.00
2024-12-08 17:17:22,74,7647,34,40,5171.14,9055.01,0.00
2024-12-08 17:17:22,73,7647,34,39,5232.06,9055.06,0.00
2024-12-08 17:17:22,73,7648,34,39,5246.27,9056.00,0.00
2024-12-08 17:17:22,74,7648,35,39,5175.38,9056.01,0.00
2024-12-08 17:17:22,74,7649,35,39,5160.04,9057.00,0.00
2024-12-08 17:17:22,75,7649,36,39,5091.24,9057.01,0.00
2024-12-08 17:17:22,74,7649,35,39,5157.60,9057.04,0.00
2024-12-08 17:17:22,73,7649,35,38,5222.04,9057.04,0.00
2024-12-08 17:17:22,73,7650,35,38,5235.03,9058.00,0.00
2024-12-08 17:17:22,74,7650,35,39,5164.28,9058.01,0.00
2024-12-08 17:17:22,73,7650,34,39,5194.09,9058.07,0.00
2024-12-08 17:17:22,72,7650,33,39,5206.19,9058.72,0.00
2024-12-08 17:17:22,72,7651,33,39,5307.06,9059.00,0.00
2024-12-08 17:17:22,73,7651,34,39,5234.36,9059.01,0.00
2024-12-08 17:17:22,72,7651,34,38,5299.52,9059.04,0.00
2024-12-08 17:17:22,72,7652,34,38,5313.94,9060.00,0.00
2024-12-08 17:17:22,73,7652,35,38,5241.15,9060.01,0.00
2024-12-08 17:17:22,73,7653,35,38,5226.83,9061.00,0.00
2024-12-08 17:17:22,74,7653,36,38,5156.20,9061.01,0.00
2024-12-08 17:17:22,73,7653,36,37,5219.38,9061.04,0.00
2024-12-08 17:17:22,73,7654,36,37,5232.37,9062.00,0.00
2024-12-08 17:17:22,74,7654,36,38,5161.66,9062.01,0.00
2024-12-08 17:17:22,74,7655,36,38,5146.31,9063.00,0.00
2024-12-08 17:17:22,75,7655,36,39,5077.69,9063.01,0.00
2024-12-08 17:17:22,74,7655,36,38,5136.52,9063.04,0.00
2024-12-08 17:17:22,75,7654,36,39,5052.39,9063.24,0.00
2024-12-08 17:17:22,75,7655,36,39,5145.93,9064.00,0.00
2024-12-08 17:17:22,76,7655,36,40,5078.22,9064.01,0.00
2024-12-08 17:17:22,76,7656,36,40,5180.17,9065.00,0.00
2024-12-08 17:17:22,77,7656,37,40,5112.89,9065.01,0.00
2024-12-08 17:17:22,76,7656,37,39,5170.63,9065.04,0.00
2024-12-08 17:17:22,76,7657,37,39,5179.55,9066.00,0.00
2024-12-08 17:17:22,77,7657,38,39,5112.28,9066.01,0.00
2024-12-08 17:17:22,77,7658,38,39,5094.00,9067.00,0.00
2024-12-08 17:17:22,78,7658,38,40,5028.70,9067.01,0.00
2024-12-08 17:17:22,77,7658,37,40,5092.83,9067.01,0.00
2024-12-08 17:17:22,76,7658,37,39,5149.10,9067.03,0.00
2024-12-08 17:17:22,77,7657,37,40,5023.66,9067.70,0.00
2024-12-08 17:17:22,77,7658,37,40,5139.32,9068.00,0.00
2024-12-08 17:17:22,78,7658,38,40,5073.43,9068.01,0.00
2024-12-08 17:17:22,78,7659,38,40,5170.49,9069.00,0.00
2024-12-08 17:17:22,79,7659,38,41,5105.04,9069.01,0.00
2024-12-08 17:17:22,78,7659,38,40,5161.19,9069.03,0.00
2024-12-08 17:17:22,77,7659,37,40,5211.79,9069.18,0.00
2024-12-08 17:17:22,77,7660,37,40,5255.89,9070.00,0.00
2024-12-08 17:17:22,78,7660,37,41,5188.50,9070.01,0.00
2024-12-08 17:17:22,78,7661,37,41,5169.30,9071.00,0.00
2024-12-08 17:17:22,79,7661,37,42,5103.87,9071.01,0.00
2024-12-08 17:17:22,78,7661,37,41,5168.14,9071.01,0.00
2024-12-08 17:17:22,78,7662,37,41,5148.94,9072.00,0.00
2024-12-08 17:17:22,79,7662,37,42,5083.76,9072.01,0.00
2024-12-08 17:17:22,78,7662,37,41,5122.20,9072.04,0.00
2024-12-08 17:17:22,77,7662,36,41,5126.44,9072.45,0.00
2024-12-08 17:17:22,77,7663,36,41,5195.17,9073.00,0.00
2024-12-08 17:17:22,78,7663,37,41,5128.57,9073.01,0.00
2024-12-08 17:17:22,78,7664,37,41,5109.36,9074.00,0.00
2024-12-08 17:17:22,79,7664,37,42,5044.68,9074.01,0.00
2024-12-08 17:17:22,78,7664,37,41,5096.57,9074.05,0.00
2024-12-08 17:17:23,78,7665,37,41,5104.11,9075.00,0.00
2024-12-08 17:17:23,79,7665,38,41,5039.50,9075.01,0.00
2024-12-08 17:17:23,79,7666,38,41,5019.37,9076.00,0.00
2024-12-08 17:17:23,80,7666,38,42,4956.63,9076.01,0.00
2024-12-08 17:17:23,79,7666,38,41,5007.89,9076.05,0.00
2024-12-08 17:17:23,79,7667,38,41,5014.18,9077.00,0.00
2024-12-08 17:17:23,80,7667,39,41,4951.50,9077.01,0.00
2024-12-08 17:17:23,79,7667,38,41,5014.18,9077.01,0.00
2024-12-08 17:17:23,78,7667,37,41,5015.68,9077.19,0.00
2024-12-08 17:17:23,77,7667,36,41,5058.53,9077.44,0.00
2024-12-08 17:17:23,77,7668,36,41,5125.34,9078.00,0.00
2024-12-08 17:17:23,78,7668,37,41,5059.63,9078.01,0.00
2024-12-08 17:17:23,77,7668,37,40,5112.38,9078.05,0.00
2024-12-08 17:17:23,76,7668,36,40,5165.36,9078.20,0.00
2024-12-08 17:17:23,76,7669,36,40,5186.50,9079.00,0.00
2024-12-08 17:17:23,77,7669,36,41,5119.15,9079.01,0.00
2024-12-08 17:17:23,77,7670,36,41,5097.76,9080.00,0.00
2024-12-08 17:17:23,78,7670,36,42,5032.41,9080.01,0.00
2024-12-08 17:17:23,77,7670,36,41,5083.63,9080.06,0.00
2024-12-08 17:17:23,77,7671,36,41,5089.96,9081.00,0.00
2024-12-08 17:17:23,78,7671,36,42,5024.70,9081.01,0.00
2024-12-08 17:17:23,77,7671,35,42,5088.79,9081.03,0.00
2024-12-08 17:17:23,77,7672,35,42,5068.02,9082.00,0.00
2024-12-08 17:17:23,78,7672,36,42,5003.05,9082.01,0.00
2024-12-08 17:17:23,77,7672,36,41,5053.89,9082.06,0.00
2024-12-08 17:17:23,77,7673,36,41,5060.37,9083.00,0.00
2024-12-08 17:17:23,78,7673,36,42,4995.50,9083.01,0.00
2024-12-08 17:17:23,78,7674,36,42,4973.21,9084.00,0.00
2024-12-08 17:17:23,79,7674,36,43,4910.25,9084.01,0.00
2024-12-08 17:17:23,78,7674,35,43,4970.89,9084.03,0.00
2024-12-08 17:17:23,77,7674,34,43,4955.35,9084.42,0.00
2024-12-08 17:17:23,77,7675,34,43,5018.10,9085.00,0.00
2024-12-08 17:17:23,78,7675,35,43,4953.77,9085.01,0.00
2024-12-08 17:17:23,77,7675,34,43,4953.26,9085.21,0.00
2024-12-08 17:17:23,76,7675,33,43,4996.72,9085.44,0.00
2024-12-08 17:17:23,76,7676,33,43,5065.26,9086.00,0.00
2024-12-08 17:17:23,77,7676,33,44,4999.48,9086.01,0.00
2024-12-08 17:17:23,76,7676,33,43,5046.15,9086.11,0.00
2024-12-08 17:17:23,76,7677,33,43,5060.76,9087.00,0.00
2024-12-08 17:17:23,77,7677,34,43,4995.04,9087.01,0.00
2024-12-08 17:17:23,76,7677,33,43,5051.21,9087.05,0.00
2024-12-08 17:17:23,76,7678,33,43,5061.32,9088.00,0.00
2024-12-08 17:17:23,77,7678,34,43,4995.59,9088.01,0.00
2024-12-08 17:17:23,76,7678,34,42,5044.60,9088.09,0.00
2024-12-08 17:17:23,76,7679,34,42,5058.29,9089.00,0.00
2024-12-08 17:17:23,77,7679,34,43,4992.59,9089.01,0.00
2024-12-08 17:17:23,77,7680,34,43,4974.25,9090.00,0.00
2024-12-08 17:17:23,78,7680,35,43,4910.48,9090.01,0.00
2024-12-08 17:17:23,77,7680,35,42,4957.75,9090.09,0.00
2024-12-08 17:17:23,77,7681,35,42,4970.08,9091.00,0.00
2024-12-08 17:17:23,78,7681,36,42,4906.36,9091.01,0.00
2024-12-08 17:17:23,77,7681,35,42,4950.02,9091.03,0.00
2024-12-08 17:17:23,77,7682,35,42,4956.46,9092.00,0.00
2024-12-08 17:17:23,78,7682,35,43,4892.91,9092.01,0.00
2024-12-08 17:17:23,77,7682,35,42,4938.76,9092.09,0.00
2024-12-08 17:17:23,77,7683,35,42,4951.10,9093.00,0.00
2024-12-08 17:17:23,78,7683,36,42,4887.62,9093.01,0.00
2024-12-08 17:17:23,77,7683,35,42,4948.75,9093.04,0.00
2024-12-08 17:17:24,77,7684,35,42,4932.75,9094.00,0.00
2024-12-08 17:17:24,78,7684,36,42,4869.51,9094.01,0.00
2024-12-08 17:17:24,77,7684,35,42,4930.40,9094.04,0.00
2024-12-08 17:17:24,76,7684,35,41,4983.31,9094.07,0.00
2024-12-08 17:17:24,75,7684,34,41,5038.84,9094.07,0.00
2024-12-08 17:17:24,75,7685,34,41,5075.76,9095.00,0.00
2024-12-08 17:17:24,76,7685,35,41,5008.97,9095.01,0.00
2024-12-08 17:17:24,76,7686,35,41,4991.57,9096.00,0.00
2024-12-08 17:17:24,77,7686,35,42,4926.74,9096.01,0.00
2024-12-08 17:17:24,76,7686,35,41,4977.22,9096.07,0.00
2024-12-08 17:17:24,75,7686,34,41,5009.78,9096.44,0.00
2024-12-08 17:17:24,75,7687,34,41,5056.25,9097.00,0.00
2024-12-08 17:17:24,76,7687,35,41,4989.72,9097.01,0.00
2024-12-08 17:17:24,76,7688,35,41,4972.31,9098.00,0.00
2024-12-08 17:17:24,77,7688,36,41,4907.74,9098.01,0.00
2024-12-08 17:17:24,76,7688,36,40,4955.57,9098.08,0.00
2024-12-08 17:17:24,76,7689,36,40,4968.07,9099.00,0.00
2024-12-08 17:17:24,77,7689,36,41,4903.55,9099.01,0.00
2024-12-08 17:17:24,76,7689,35,41,4878.61,9099.74,0.00
2024-12-08 17:17:24,76,7690,35,41,4950.66,9100.00,0.00
2024-12-08 17:17:24,77,7690,35,42,4886.36,9100.01,0.00
2024-12-08 17:17:24,76,7690,35,41,4935.11,9100.08,0.00
2024-12-08 17:17:24,75,7690,34,41,4988.82,9100.21,0.00
2024-12-08 17:17:24,75,7691,34,41,5014.79,9101.00,0.00
2024-12-08 17:17:24,76,7691,35,41,4948.81,9101.01,0.00
2024-12-08 17:17:24,76,7692,35,41,4931.39,9102.00,0.00
2024-12-08 17:17:24,77,7692,35,42,4867.34,9102.01,0.00
2024-12-08 17:17:24,76,7692,35,41,4917.03,9102.08,0.00
2024-12-08 17:17:24,76,7693,35,41,4929.53,9103.00,0.00
2024-12-08 17:17:24,77,7693,36,41,4865.51,9103.01,0.00
2024-12-08 17:17:24,76,7693,35,41,4912.78,9103.09,0.00
2024-12-08 17:17:24,76,7694,35,41,4926.48,9104.00,0.00
2024-12-08 17:17:24,77,7694,36,41,4862.50,9104.01,0.00
2024-12-08 17:17:24,76,7694,36,40,4909.73,9104.09,0.00
2024-12-08 17:17:24,76,7695,36,40,4923.43,9105.00,0.00
2024-12-08 17:17:24,77,7695,36,41,4859.49,9105.01,0.00
2024-12-08 17:17:24,77,7696,36,41,4841.10,9106.00,0.00
2024-12-08 17:17:24,78,7696,37,41,4779.03,9106.01,0.00
2024-12-08 17:17:24,77,7696,37,40,4825.74,9106.09,0.00
2024-12-08 17:17:24,76,7696,36,40,4843.82,9106.40,0.00
2024-12-08 17:17:24,76,7697,36,40,4908.93,9107.00,0.00
2024-12-08 17:17:24,77,7697,37,40,4845.18,9107.01,0.00
2024-12-08 17:17:24,77,7698,37,40,4826.79,9108.00,0.00
2024-12-08 17:17:24,78,7698,37,41,4764.90,9108.01,0.00
2024-12-08 17:17:24,77,7698,37,40,4812.60,9108.09,0.00
2024-12-08 17:17:24,77,7699,37,40,4824.95,9109.00,0.00
2024-12-08 17:17:24,78,7699,37,41,4763.09,9109.01,0.00
2024-12-08 17:17:24,78,7700,37,41,4743.76,9110.00,0.00
2024-12-08 17:17:24,79,7700,37,42,4683.71,9110.01,0.00
2024-12-08 17:17:24,78,7700,37,41,4728.59,9110.10,0.00
2024-12-08 17:17:24,77,7700,36,41,4772.30,9110.26,0.00
2024-12-08 17:17:24,77,7701,36,41,4823.64,9111.00,0.00
2024-12-08 17:17:25,78,7701,36,42,4761.80,9111.01,0.00
2024-12-08 17:17:25,79,7700,36,43,4666.95,9111.17,0.00
2024-12-08 17:17:25,79,7701,36,43,4785.53,9112.00,0.00
2024-12-08 17:17:25,80,7701,36,44,4725.71,9112.01,0.00
2024-12-08 17:17:25,79,7701,36,43,4768.79,9112.11,0.00
2024-12-08 17:17:25,78,7701,35,43,4808.97,9112.28,0.00
2024-12-08 17:17:25,78,7702,35,43,4977.66,9113.00,0.00
2024-12-08 17:17:25,79,7702,35,44,4914.65,9113.01,0.00
2024-12-08 17:17:25,78,7702,34,44,4974.16,9113.04,0.00
2024-12-08 17:17:25,78,7703,34,44,4952.16,9114.00,0.00
2024-12-08 17:17:25,79,7703,34,45,4889.48,9114.01,0.00
2024-12-08 17:17:25,78,7703,34,44,4932.02,9114.10,0.00
2024-12-08 17:17:25,78,7704,34,44,4944.24,9115.00,0.00
2024-12-08 17:17:25,79,7704,35,44,4881.65,9115.01,0.00
2024-12-08 17:17:25,79,7705,35,44,4858.88,9116.00,0.00
2024-12-08 17:17:25,80,7705,35,45,4798.15,9116.01,0.00
2024-12-08 17:17:25,80,7706,35,45,4777.02,9117.00,0.00
2024-12-08 17:17:25,81,7706,35,46,4718.04,9117.01,0.00
2024-12-08 17:17:25,80,7706,34,46,4770.19,9117.09,0.00
2024-12-08 17:17:25,80,7707,34,46,4755.89,9118.00,0.00
2024-12-08 17:17:25,81,7707,34,47,4697.17,9118.01,0.00
2024-12-08 17:17:25,80,7707,33,47,4688.80,9118.50,0.00
2024-12-08 17:17:25,80,7708,33,47,4734.75,9119.00,0.00
2024-12-08 17:17:25,81,7708,34,47,4676.30,9119.01,0.00
2024-12-08 17:17:25,80,7708,33,47,4731.33,9119.04,0.00
2024-12-08 17:17:25,79,7708,33,46,4772.76,9119.08,0.00
2024-12-08 17:17:25,79,7709,33,46,4781.36,9120.00,0.00
2024-12-08 17:17:25,80,7709,33,47,4721.59,9120.01,0.00
2024-12-08 17:17:25,80,7710,33,47,4700.45,9121.00,0.00
2024-12-08 17:17:25,81,7710,34,47,4642.42,9121.01,0.00
2024-12-08 17:17:25,80,7710,34,46,4691.33,9121.08,0.00
2024-12-08 17:17:25,80,7711,34,46,4698.68,9122.00,0.00
2024-12-08 17:17:25,81,7711,35,46,4640.67,9122.01,0.00
2024-12-08 17:17:25,80,7711,34,46,4607.61,9122.50,0.00
2024-12-08 17:17:25,80,7712,34,46,4675.89,9123.00,0.00
2024-12-08 17:17:25,81,7712,34,47,4618.16,9123.01,0.00
2024-12-08 17:17:25,80,7712,34,46,4673.61,9123.03,0.00
2024-12-08 17:17:25,79,7712,33,46,4718.91,9123.10,0.00
2024-12-08 17:17:25,78,7712,33,45,4771.23,9123.10,0.00
2024-12-08 17:17:25,78,7713,33,45,4805.63,9124.00,0.00
2024-12-08 17:17:25,79,7713,33,46,4744.80,9124.01,0.00
2024-12-08 17:17:25,78,7713,33,45,4801.25,9124.05,0.00
2024-12-08 17:17:25,77,7713,32,45,4813.85,9124.16,0.00
2024-12-08 17:17:25,77,7714,32,45,4855.22,9125.00,0.00
2024-12-08 17:17:25,78,7714,32,46,4792.97,9125.01,0.00
2024-12-08 17:17:25,77,7714,31,46,4852.85,9125.03,0.00
2024-12-08 17:17:25,76,7714,31,45,4904.70,9125.08,0.00
2024-12-08 17:17:25,76,7715,31,45,4917.00,9126.00,0.00
2024-12-08 17:17:25,77,7715,31,46,4853.14,9126.01,0.00
2024-12-08 17:17:25,76,7715,30,46,4912.19,9126.05,0.00
2024-12-08 17:17:25,75,7715,29,46,4925.39,9126.15,0.00
2024-12-08 17:17:25,75,7716,29,46,4969.72,9127.00,0.00
2024-12-08 17:17:25,76,7716,29,47,4904.32,9127.01,0.00
2024-12-08 17:17:25,75,7716,28,47,4966.07,9127.04,0.00
2024-12-08 17:17:25,74,7716,28,46,5025.78,9127.05,0.00
2024-12-08 17:17:25,74,7717,28,46,5038.66,9128.00,0.00
2024-12-08 17:17:25,75,7717,28,47,4971.48,9128.01,0.00
2024-12-08 17:17:25,74,7717,27,47,4950.16,9128.72,0.00
2024-12-08 17:17:25,74,7718,27,47,5023.18,9129.00,0.00
2024-12-08 17:17:25,75,7718,28,47,4956.20,9129.01,0.00
2024-12-08 17:17:25,74,7718,27,47,5020.71,9129.03,0.00
2024-12-08 17:17:25,73,7718,27,46,5083.23,9129.04,0.00
2024-12-08 17:17:26,73,7719,27,46,5096.29,9130.00,0.00
2024-12-08 17:17:26,74,7719,27,47,5027.43,9130.01,0.00
2024-12-08 17:17:26,74,7720,27,47,5011.94,9131.00,0.00
2024-12-08 17:17:26,75,7720,28,47,4945.11,9131.01,0.00
2024-12-08 17:17:26,74,7720,28,46,5003.30,9131.05,0.00
2024-12-08 17:17:26,74,7721,28,46,5016.19,9132.00,0.00
2024-12-08 17:17:26,75,7721,28,47,4949.30,9132.01,0.00
2024-12-08 17:17:26,74,7721,27,47,5014.95,9132.01,0.00
2024-12-08 17:17:26,74,7722,27,47,4999.46,9133.00,0.00
2024-12-08 17:17:26,75,7722,28,47,4932.80,9133.01,0.00
2024-12-08 17:17:26,74,7722,28,46,4996.99,9133.03,0.00
2024-12-08 17:17:26,74,7723,28,46,5007.41,9134.00,0.00
2024-12-08 17:17:26,75,7723,29,46,4940.65,9134.01,0.00
2024-12-08 17:17:26,75,7724,29,46,4924.13,9135.00,0.00
2024-12-08 17:17:26,76,7724,29,47,4859.34,9135.01,0.00
2024-12-08 17:17:26,75,7724,29,46,4918.05,9135.03,0.00
2024-12-08 17:17:26,75,7725,29,46,4927.11,9136.00,0.00
2024-12-08 17:17:26,76,7725,29,47,4862.28,9136.01,0.00
2024-12-08 17:17:26,75,7725,28,47,4837.28,9136.73,0.00
2024-12-08 17:17:26,75,7726,28,47,4910.59,9137.00,0.00
2024-12-08 17:17:26,76,7726,29,47,4845.98,9137.01,0.00
2024-12-08 17:17:26,75,7726,29,46,4900.85,9137.04,0.00
2024-12-08 17:17:26,75,7727,29,46,4911.13,9138.00,0.00
2024-12-08 17:17:26,76,7727,29,47,4846.51,9138.01,0.00
2024-12-08 17:17:26,76,7728,29,47,4829.00,9139.00,0.00
2024-12-08 17:17:26,77,7728,30,47,4766.29,9139.01,0.00
2024-12-08 17:17:26,76,7728,29,47,4826.60,9139.03,0.00
2024-12-08 17:17:26,75,7728,29,46,4884.86,9139.03,0.00
2024-12-08 17:17:26,75,7729,29,46,4893.93,9140.00,0.00
2024-12-08 17:17:26,76,7729,29,47,4829.53,9140.01,0.00
2024-12-08 17:17:26,75,7729,28,47,4850.07,9140.11,0.00
2024-12-08 17:17:26,75,7730,28,47,4890.80,9141.00,0.00
2024-12-08 17:17:26,76,7730,28,48,4826.45,9141.01,0.00
2024-12-08 17:17:26,75,7730,28,47,4883.50,9141.04,0.00
2024-12-08 17:17:26,75,7731,28,47,4893.78,9142.00,0.00
2024-12-08 17:17:26,76,7731,28,48,4829.39,9142.01,0.00
2024-12-08 17:17:26,75,7731,27,48,4884.03,9142.05,0.00
2024-12-08 17:17:26,75,7732,27,48,4895.53,9143.00,0.00
2024-12-08 17:17:26,76,7732,27,49,4831.12,9143.01,0.00
2024-12-08 17:17:26,75,7732,27,48,4885.78,9143.05,0.00
2024-12-08 17:17:26,75,7733,27,48,4897.29,9144.00,0.00
2024-12-08 17:17:26,76,7733,27,49,4832.85,9144.01,0.00
2024-12-08 17:17:26,76,7734,27,49,4815.33,9145.00,0.00
2024-12-08 17:17:26,77,7734,27,50,4752.79,9145.01,0.00
2024-12-08 17:17:26,76,7734,27,49,4808.11,9145.05,0.00
2024-12-08 17:17:26,75,7734,26,49,4847.89,9145.27,0.00
2024-12-08 17:17:26,75,7735,26,49,4903.17,9146.00,0.00
2024-12-08 17:17:26,76,7735,26,50,4838.66,9146.01,0.00
2024-12-08 17:17:26,75,7735,25,50,4900.74,9146.04,0.00
2024-12-08 17:17:26,75,7736,25,50,4884.27,9147.00,0.00
2024-12-08 17:17:26,76,7736,26,50,4820.00,9147.01,0.00
2024-12-08 17:17:26,75,7736,25,50,4883.05,9147.01,0.00
2024-12-08 17:17:26,74,7736,25,49,4944.10,9147.03,0.00
2024-12-08 17:17:26,73,7736,24,49,4984.32,9147.26,0.00
2024-12-08 17:17:26,72,7736,23,49,5035.85,9147.46,0.00
2024-12-08 17:17:26,72,7737,23,49,5108.19,9148.00,0.00
2024-12-08 17:17:26,73,7737,24,49,5038.22,9148.01,0.00
2024-12-08 17:17:26,72,7737,23,49,5038.40,9148.35,0.00
2024-12-08 17:17:26,72,7738,23,49,5097.94,9149.00,0.00
2024-12-08 17:17:26,73,7738,23,50,5028.10,9149.01,0.00
2024-12-08 17:17:26,72,7738,23,49,5094.13,9149.03,0.00
2024-12-08 17:17:27,72,7739,23,49,5095.54,9150.00,0.00
2024-12-08 17:17:27,73,7739,24,49,5025.74,9150.01,0.00
2024-12-08 17:17:27,73,7740,24,49,4996.67,9151.00,0.00
2024-12-08 17:17:27,74,7740,24,50,4929.15,9151.01,0.00
2024-12-08 17:17:27,73,7740,24,49,4994.16,9151.03,0.00
2024-12-08 17:17:27,73,7741,24,49,4989.62,9152.00,0.00
2024-12-08 17:17:27,74,7741,24,50,4922.20,9152.01,0.00
2024-12-08 17:17:27,73,7741,24,49,4962.04,9152.03,0.00
2024-12-08 17:17:27,73,7742,24,49,4956.37,9153.00,0.00
2024-12-08 17:17:27,74,7742,24,50,4889.39,9153.01,0.00
2024-12-08 17:17:27,74,7743,24,50,4856.40,9154.00,0.00
2024-12-08 17:17:27,75,7743,25,50,4791.65,9154.01,0.00
2024-12-08 17:17:27,74,7743,24,50,4855.17,9154.03,0.00
2024-12-08 17:17:27,73,7743,24,49,4920.42,9154.03,0.00
2024-12-08 17:17:27,72,7743,23,49,4926.65,9154.67,0.00
2024-12-08 17:17:27,72,7744,23,49,4998.11,9155.00,0.00
2024-12-08 17:17:27,73,7744,24,49,4929.64,9155.01,0.00
2024-12-08 17:17:27,72,7744,23,49,4995.57,9155.03,0.00
2024-12-08 17:17:27,72,7745,23,49,5005.54,9156.00,0.00
2024-12-08 17:17:27,73,7745,23,50,4936.97,9156.01,0.00
2024-12-08 17:17:27,72,7745,23,49,5002.99,9156.03,0.00
2024-12-08 17:17:27,72,7746,23,49,5012.20,9157.00,0.00
2024-12-08 17:17:27,73,7746,24,49,4943.54,9157.01,0.00
2024-12-08 17:17:27,72,7746,23,49,4944.83,9157.21,0.00
2024-12-08 17:17:27,72,7747,23,49,4995.80,9158.00,0.00
2024-12-08 17:17:27,73,7747,23,50,4927.36,9158.01,0.00
2024-12-08 17:17:27,72,7747,23,49,4991.98,9158.03,0.00
2024-12-08 17:17:27,72,7748,23,49,5001.63,9159.00,0.00
2024-12-08 17:17:27,73,7748,24,49,4933.11,9159.01,0.00
2024-12-08 17:17:27,73,7749,24,49,4915.33,9160.00,0.00
2024-12-08 17:17:27,74,7749,25,49,4848.90,9160.01,0.00
2024-12-08 17:17:27,73,7749,25,48,4912.82,9160.03,0.00
2024-12-08 17:17:27,73,7750,25,48,4921.34,9161.00,0.00
2024-12-08 17:17:27,74,7750,25,49,4854.83,9161.01,0.00
2024-12-08 17:17:27,73,7750,25,48,4893.73,9161.03,0.00
2024-12-08 17:17:27,73,7751,25,48,4901.76,9162.00,0.00
2024-12-08 17:17:27,74,7751,25,49,4835.52,9162.01,0.00
2024-12-08 17:17:27,73,7751,24,49,4856.59,9162.11,0.00
2024-12-08 17:17:27,73,7752,24,49,4897.01,9163.00,0.00
2024-12-08 17:17:27,74,7752,25,49,4830.83,9163.01,0.00
2024-12-08 17:17:27,73,7752,25,48,4895.75,9163.01,0.00
2024-12-08 17:17:27,72,7752,25,47,4954.85,9163.06,0.00
2024-12-08 17:17:27,72,7753,25,47,4966.20,9164.00,0.00
2024-12-08 17:17:27,73,7753,26,47,4898.17,9164.01,0.00
2024-12-08 17:17:27,72,7753,25,47,4920.39,9164.10,0.00
2024-12-08 17:17:27,72,7754,25,47,4960.65,9165.00,0.00
2024-12-08 17:17:27,73,7754,26,47,4892.69,9165.01,0.00
2024-12-08 17:17:27,72,7754,26,46,4949.19,9165.07,0.00
2024-12-08 17:17:27,72,7755,26,46,4961.70,9166.00,0.00
2024-12-08 17:17:27,73,7755,27,46,4893.74,9166.01,0.00
2024-12-08 17:17:27,72,7755,26,46,4959.16,9166.04,0.00
2024-12-08 17:17:27,73,7754,27,46,4835.45,9166.36,0.00
2024-12-08 17:17:27,73,7755,27,46,4937.60,9167.00,0.00
2024-12-08 17:17:27,74,7755,28,46,4870.87,9167.01,0.00
2024-12-08 17:17:27,73,7755,28,45,4926.30,9167.06,0.00
2024-12-08 17:17:28,73,7756,28,45,5062.00,9168.00,0.00
2024-12-08 17:17:28,74,7756,29,45,4993.60,9168.01,0.00
2024-12-08 17:17:28,73,7756,28,45,5059.49,9168.04,0.00
2024-12-08 17:17:28,72,7756,28,44,5076.87,9168.29,0.00
2024-12-08 17:17:28,72,7757,28,44,5113.82,9169.00,0.00
2024-12-08 17:17:28,73,7757,28,45,5043.77,9169.01,0.00
2024-12-08 17:17:28,72,7757,28,44,5099.82,9169.06,0.00
2024-12-08 17:17:28,72,7758,28,44,5114.69,9170.00,0.00
2024-12-08 17:17:28,73,7758,29,44,5044.63,9170.01,0.00
2024-12-08 17:17:28,72,7758,28,44,5100.69,9170.06,0.00
2024-12-08 17:17:28,72,7759,28,44,5115.89,9171.00,0.00
2024-12-08 17:17:28,73,7759,28,45,5045.81,9171.01,0.00
2024-12-08 17:17:28,72,7759,28,44,5100.61,9171.06,0.00
2024-12-08 17:17:28,71,7759,27,44,5113.04,9171.70,0.00
2024-12-08 17:17:28,71,7760,27,44,5189.49,9172.00,0.00
2024-12-08 17:17:28,72,7760,27,45,5117.42,9172.01,0.00
2024-12-08 17:17:28,72,7761,27,45,5103.84,9173.00,0.00
2024-12-08 17:17:28,73,7761,27,46,5033.93,9173.01,0.00
2024-12-08 17:17:28,72,7761,27,45,5089.83,9173.06,0.00
2024-12-08 17:17:28,72,7762,27,45,5105.66,9174.00,0.00
2024-12-08 17:17:28,73,7762,28,45,5035.72,9174.01,0.00
2024-12-08 17:17:28,73,7763,28,45,5021.17,9175.00,0.00
2024-12-08 17:17:28,74,7763,29,45,4953.32,9175.01,0.00
2024-12-08 17:17:28,73,7763,29,44,5006.10,9175.07,0.00
2024-12-08 17:17:28,73,7764,29,44,5021.31,9176.00,0.00
2024-12-08 17:17:28,74,7764,30,44,4953.45,9176.01,0.00
2024-12-08 17:17:28,74,7765,30,44,4937.44,9177.00,0.00
2024-12-08 17:17:28,75,7765,30,45,4871.61,9177.01,0.00
2024-12-08 17:17:28,74,7765,30,44,4918.85,9177.10,0.00
2024-12-08 17:17:28,74,7766,30,44,4934.99,9178.00,0.00
2024-12-08 17:17:28,75,7766,30,45,4869.19,9178.01,0.00
2024-12-08 17:17:28,75,7767,30,45,4852.21,9179.00,0.00
2024-12-08 17:17:28,76,7767,30,46,4788.36,9179.01,0.00
2024-12-08 17:17:28,75,7767,30,45,4832.63,9179.09,0.00
2024-12-08 17:17:28,74,7767,29,45,4885.23,9179.22,0.00
2024-12-08 17:17:28,74,7768,29,45,4913.00,9180.00,0.00
2024-12-08 17:17:28,75,7768,30,45,4847.49,9180.01,0.00
2024-12-08 17:17:28,74,7768,29,45,4827.48,9180.43,0.00
2024-12-08 17:17:28,74,7769,29,45,4899.83,9181.00,0.00
2024-12-08 17:17:28,75,7769,30,45,4834.50,9181.01,0.00
2024-12-08 17:17:28,74,7769,30,44,4881.23,9181.10,0.00
2024-12-08 17:17:28,74,7770,30,44,4897.88,9182.00,0.00
2024-12-08 17:17:28,75,7770,31,44,4832.58,9182.01,0.00
2024-12-08 17:17:28,75,7771,31,44,4815.96,9183.00,0.00
2024-12-08 17:17:28,76,7771,32,44,4752.60,9183.01,0.00
2024-12-08 17:17:28,75,7771,32,43,4814.74,9183.01,0.00
2024-12-08 17:17:28,74,7771,32,42,4863.68,9183.08,0.00
2024-12-08 17:17:28,74,7772,32,42,4879.09,9184.00,0.00
2024-12-08 17:17:28,75,7772,33,42,4814.04,9184.01,0.00
2024-12-08 17:17:28,74,7772,33,41,4877.85,9184.01,0.00
2024-12-08 17:17:28,73,7772,32,41,4942.16,9184.04,0.00
2024-12-08 17:17:28,72,7772,31,41,4944.57,9184.33,0.00
2024-12-08 17:17:28,73,7771,32,41,4870.58,9184.43,0.00
2024-12-08 17:17:28,73,7772,32,41,4996.80,9185.00,0.00
2024-12-08 17:17:28,74,7772,33,41,4929.27,9185.01,0.00
2024-12-08 17:17:28,73,7772,33,40,4984.22,9185.06,0.00
2024-12-08 17:17:28,73,7773,33,40,5124.43,9186.00,0.00
2024-12-08 17:17:28,74,7773,34,40,5055.19,9186.01,0.00
2024-12-08 17:17:28,74,7774,34,40,5039.60,9187.00,0.00
2024-12-08 17:17:28,75,7774,35,40,4972.40,9187.01,0.00
2024-12-08 17:17:28,74,7774,35,39,5031.81,9187.05,0.00
2024-12-08 17:17:29,74,7775,35,39,5044.77,9188.00,0.00
2024-12-08 17:17:29,75,7775,35,40,4977.50,9188.01,0.00
2024-12-08 17:17:29,75,7776,35,40,4960.89,9189.00,0.00
2024-12-08 17:17:29,76,7776,36,40,4895.62,9189.01,0.00
2024-12-08 17:17:29,75,7776,36,39,4952.32,9189.05,0.00
2024-12-08 17:17:29,75,7777,36,39,4963.88,9190.00,0.00
2024-12-08 17:17:29,76,7777,37,39,4898.57,9190.01,0.00
2024-12-08 17:17:29,76,7778,37,39,4880.96,9191.00,0.00
2024-12-08 17:17:29,77,7778,37,40,4817.57,9191.01,0.00
2024-12-08 17:17:29,76,7778,37,39,4873.71,9191.05,0.00
2024-12-08 17:17:29,76,7779,37,39,4883.91,9192.00,0.00
2024-12-08 17:17:29,77,7779,37,40,4820.48,9192.01,0.00
2024-12-08 17:17:29,76,7779,36,40,4840.43,9192.22,0.00
2024-12-08 17:17:29,76,7780,36,40,4866.30,9193.00,0.00
2024-12-08 17:17:29,77,7780,36,41,4803.10,9193.01,0.00
2024-12-08 17:17:29,76,7780,36,40,4860.25,9193.05,0.00
2024-12-08 17:17:29,76,7781,36,40,4870.46,9194.00,0.00
2024-12-08 17:17:29,77,7781,36,41,4807.20,9194.01,0.00
2024-12-08 17:17:29,76,7781,35,41,4869.25,9194.01,0.00
2024-12-08 17:17:29,75,7781,34,41,4891.32,9194.21,0.00
2024-12-08 17:17:29,75,7782,34,41,4917.54,9195.00,0.00
2024-12-08 17:17:29,76,7782,35,41,4852.84,9195.01,0.00
2024-12-08 17:17:29,76,7783,35,41,4835.22,9196.00,0.00
2024-12-08 17:17:29,77,7783,35,42,4772.42,9196.01,0.00
2024-12-08 17:17:29,76,7783,34,42,4743.49,9196.61,0.00
2024-12-08 17:17:29,76,7784,34,42,4827.49,9197.00,0.00
2024-12-08 17:17:29,77,7784,34,43,4764.79,9197.01,0.00
2024-12-08 17:17:29,76,7784,34,42,4812.97,9197.04,0.00
2024-12-08 17:17:29,75,7784,33,42,4814.91,9197.72,0.00
2024-12-08 17:17:29,75,7785,33,42,4884.56,9198.00,0.00
2024-12-08 17:17:29,76,7785,34,42,4820.29,9198.01,0.00
2024-12-08 17:17:29,75,7785,34,41,4856.36,9198.04,0.00
2024-12-08 17:17:29,75,7786,34,41,4861.68,9199.00,0.00
2024-12-08 17:17:29,76,7786,35,41,4797.71,9199.01,0.00
2024-12-08 17:17:29,76,7787,35,41,4773.33,9200.00,0.00
2024-12-08 17:17:29,77,7787,35,42,4711.33,9200.01,0.00
2024-12-08 17:17:29,76,7787,35,41,4769.69,9200.04,0.00
2024-12-08 17:17:29,75,7787,34,41,4794.20,9200.47,0.00
2024-12-08 17:17:29,75,7788,34,41,4835.25,9201.00,0.00
2024-12-08 17:17:29,76,7788,35,41,4771.62,9201.01,0.00
2024-12-08 17:17:29,75,7788,34,41,4834.02,9201.01,0.00
2024-12-08 17:17:29,74,7788,33,41,4896.86,9201.03,0.00
2024-12-08 17:17:29,74,7789,33,41,4872.71,9202.00,0.00
2024-12-08 17:17:29,75,7789,33,42,4807.74,9202.01,0.00
2024-12-08 17:17:29,74,7789,33,41,4865.26,9202.05,0.00
2024-12-08 17:17:29,74,7790,33,41,4869.83,9203.00,0.00
2024-12-08 17:17:29,75,7790,34,41,4804.90,9203.01,0.00
2024-12-08 17:17:29,74,7790,33,41,4758.20,9203.70,0.00
2024-12-08 17:17:29,74,7791,33,41,4848.20,9204.00,0.00
2024-12-08 17:17:29,75,7791,33,42,4783.56,9204.01,0.00
2024-12-08 17:17:29,74,7791,32,42,4846.96,9204.01,0.00
2024-12-08 17:17:29,73,7791,32,41,4908.31,9204.04,0.00
2024-12-08 17:17:29,73,7792,32,41,4915.71,9205.00,0.00
2024-12-08 17:17:29,74,7792,33,41,4849.29,9205.01,0.00
2024-12-08 17:17:29,74,7793,33,41,4830.72,9206.00,0.00
2024-12-08 17:17:29,75,7793,33,42,4766.31,9206.01,0.00
2024-12-08 17:17:29,74,7793,33,41,4827.00,9206.04,0.00
2024-12-08 17:17:29,73,7793,32,41,4815.76,9206.80,0.00
2024-12-08 17:17:30,73,7794,32,41,4923.13,9207.00,0.00
2024-12-08 17:17:30,74,7794,32,42,4856.60,9207.01,0.00
2024-12-08 17:17:30,73,7794,32,41,4894.12,9207.04,0.00
2024-12-08 17:17:30,73,7795,32,41,4906.37,9208.00,0.00
2024-12-08 17:17:30,74,7795,32,42,4840.07,9208.01,0.00
2024-12-08 17:17:30,73,7795,32,41,4877.36,9208.04,0.00
2024-12-08 17:17:30,72,7795,31,41,4928.54,9208.22,0.00
2024-12-08 17:17:30,73,7794,31,42,4815.86,9208.74,0.00
2024-12-08 17:17:30,73,7795,31,42,4960.96,9209.00,0.00
2024-12-08 17:17:30,74,7795,31,43,4893.92,9209.01,0.00
2024-12-08 17:17:30,73,7795,30,43,4916.87,9209.22,0.00
2024-12-08 17:17:30,73,7796,30,43,5071.97,9210.00,0.00
2024-12-08 17:17:30,74,7796,31,43,5003.43,9210.01,0.00
2024-12-08 17:17:30,73,7796,31,42,5068.19,9210.04,0.00
2024-12-08 17:17:30,73,7797,31,42,5077.04,9211.00,0.00
2024-12-08 17:17:30,74,7797,32,42,5008.43,9211.01,0.00
2024-12-08 17:17:30,73,7797,31,42,5010.33,9211.47,0.00
2024-12-08 17:17:30,73,7798,31,42,5046.96,9212.00,0.00
2024-12-08 17:17:30,74,7798,32,42,4978.75,9212.01,0.00
2024-12-08 17:17:30,73,7798,32,41,5043.17,9212.04,0.00
2024-12-08 17:17:30,73,7799,32,41,5031.11,9213.00,0.00
2024-12-08 17:17:30,74,7799,32,42,4963.12,9213.01,0.00
2024-12-08 17:17:30,73,7799,31,42,4913.22,9213.64,0.00
2024-12-08 17:17:30,73,7800,31,42,4986.22,9214.00,0.00
2024-12-08 17:17:30,74,7800,31,43,4918.84,9214.01,0.00
2024-12-08 17:17:30,73,7800,31,42,4981.18,9214.04,0.00
2024-12-08 17:17:30,73,7801,31,42,4973.98,9215.00,0.00
2024-12-08 17:17:30,74,7801,31,43,4906.77,9215.01,0.00
2024-12-08 17:17:30,74,7802,31,43,4876.24,9216.00,0.00
2024-12-08 17:17:30,75,7802,31,44,4811.23,9216.01,0.00
2024-12-08 17:17:30,74,7802,31,43,4872.51,9216.04,0.00
2024-12-08 17:17:30,74,7803,31,43,4875.01,9217.00,0.00
2024-12-08 17:17:30,75,7803,31,44,4810.01,9217.01,0.00
2024-12-08 17:17:30,75,7804,31,44,4791.00,9218.00,0.00
2024-12-08 17:17:30,76,7804,32,44,4727.96,9218.01,0.00
2024-12-08 17:17:30,75,7804,32,43,4787.31,9218.04,0.00
2024-12-08 17:17:30,75,7805,32,43,4793.95,9219.00,0.00
2024-12-08 17:17:30,76,7805,32,44,4730.88,9219.01,0.00
2024-12-08 17:17:30,75,7805,31,44,4710.51,9219.44,0.00
2024-12-08 17:17:30,75,7806,31,44,4775.32,9220.00,0.00
2024-12-08 17:17:30,76,7806,32,44,4712.48,9220.01,0.00
2024-12-08 17:17:30,75,7806,32,43,4770.40,9220.05,0.00
2024-12-08 17:17:30,74,7806,31,43,4801.27,9220.20,0.00
2024-12-08 17:17:30,73,7806,30,43,4817.89,9220.66,0.00
2024-12-08 17:17:30,73,7807,30,43,4912.89,9221.00,0.00
2024-12-08 17:17:30,74,7807,30,44,4846.50,9221.01,0.00
2024-12-08 17:17:30,73,7807,29,44,4866.21,9221.25,0.00
2024-12-08 17:17:30,73,7808,29,44,4898.26,9222.00,0.00
2024-12-08 17:17:30,74,7808,30,44,4832.07,9222.01,0.00
2024-12-08 17:17:30,73,7808,29,44,4897.00,9222.01,0.00
2024-12-08 17:17:30,72,7808,29,43,4964.95,9222.01,0.00
2024-12-08 17:17:30,71,7808,28,43,4966.20,9222.47,0.00
2024-12-08 17:17:30,71,7809,28,43,5017.60,9223.00,0.00
2024-12-08 17:17:30,72,7809,29,43,4947.91,9223.01,0.00
2024-12-08 17:17:30,72,7810,29,43,4928.26,9224.00,0.00
2024-12-08 17:17:30,73,7810,30,43,4860.75,9224.01,0.00
2024-12-08 17:17:30,72,7810,30,42,4925.70,9224.03,0.00
2024-12-08 17:17:30,72,7811,30,42,4930.43,9225.00,0.00
2024-12-08 17:17:30,73,7811,31,42,4862.89,9225.01,0.00
2024-12-08 17:17:30,72,7811,31,41,4906.09,9225.03,0.00
2024-12-08 17:17:30,71,7811,30,41,4910.37,9225.45,0.00
2024-12-08 17:17:31,71,7812,30,41,4980.15,9226.00,0.00
2024-12-08 17:17:31,72,7812,30,42,4910.98,9226.01,0.00
2024-12-08 17:17:31,71,7812,30,41,4955.46,9226.03,0.00
2024-12-08 17:17:31,70,7812,29,41,4985.44,9226.21,0.00
2024-12-08 17:17:31,70,7812,29,41,5034.02,9227.00,0.00
2024-12-08 17:17:31,71,7812,29,42,4963.12,9227.01,0.00
2024-12-08 17:17:31,70,7812,29,41,5008.98,9227.03,0.00
2024-12-08 17:17:31,70,7813,29,41,5012.67,9228.00,0.00
2024-12-08 17:17:31,71,7813,30,41,4942.07,9228.01,0.00
2024-12-08 17:17:31,70,7813,30,40,4987.63,9228.03,0.00
2024-12-08 17:17:31,70,7814,30,40,4992.71,9229.00,0.00
2024-12-08 17:17:31,71,7814,30,41,4922.39,9229.01,0.00
2024-12-08 17:17:31,70,7814,30,40,4967.66,9229.03,0.00
2024-12-08 17:17:31,69,7814,29,40,5004.91,9229.17,0.00
2024-12-08 17:17:31,69,7815,29,40,5051.75,9230.00,0.00
2024-12-08 17:17:31,70,7815,30,40,4979.58,9230.02,0.00
2024-12-08 17:17:31,69,7815,30,39,5023.66,9230.03,0.00
2024-12-08 17:17:31,69,7816,30,39,5029.48,9231.00,0.00
2024-12-08 17:17:31,70,7816,31,39,4957.63,9231.02,0.00
2024-12-08 17:17:31,69,7816,31,38,5000.05,9231.03,0.00
2024-12-08 17:17:31,69,7817,31,38,5005.86,9232.00,0.00
2024-12-08 17:17:31,70,7817,31,39,4934.34,9232.02,0.00
2024-12-08 17:17:31,69,7817,31,38,4976.42,9232.03,0.00
2024-12-08 17:17:31,68,7817,31,37,4980.03,9232.65,0.00
2024-12-08 17:17:31,68,7818,31,37,5056.34,9233.00,0.00
2024-12-08 17:17:31,69,7818,32,37,4983.06,9233.02,0.00
2024-12-08 17:17:31,68,7818,32,36,5026.47,9233.03,0.00
2024-12-08 17:17:31,68,7819,32,36,5046.02,9234.00,0.00
2024-12-08 17:17:31,69,7819,33,36,4972.89,9234.02,0.00
2024-12-08 17:17:31,68,7819,32,36,5043.31,9234.03,0.00
2024-12-08 17:17:31,68,7820,32,36,5035.71,9235.00,0.00
2024-12-08 17:17:31,69,7820,32,37,4962.73,9235.02,0.00
2024-12-08 17:17:31,68,7820,32,36,5031.63,9235.03,0.00
2024-12-08 17:17:31,68,7821,32,36,5051.19,9236.00,0.00
2024-12-08 17:17:31,69,7821,32,37,4977.99,9236.02,0.00
2024-12-08 17:17:31,68,7821,31,37,5047.12,9236.03,0.00
2024-12-08 17:17:31,68,7822,31,37,5066.68,9237.00,0.00
2024-12-08 17:17:31,69,7822,31,38,4993.25,9237.02,0.00
2024-12-08 17:17:31,68,7822,31,37,5062.61,9237.03,0.00
2024-12-08 17:17:31,67,7822,30,37,5120.26,9237.07,0.00
2024-12-08 17:17:31,67,7823,30,37,5173.19,9238.00,0.00
2024-12-08 17:17:31,68,7823,30,38,5097.12,9238.02,0.00
2024-12-08 17:17:31,68,7824,30,38,5088.16,9239.00,0.00
2024-12-08 17:17:31,69,7824,31,38,5014.42,9239.02,0.00
2024-12-08 17:17:31,68,7824,30,38,5086.80,9239.02,0.00
2024-12-08 17:17:31,67,7824,30,37,5158.59,9239.02,0.00
2024-12-08 17:17:31,67,7825,30,37,5178.45,9240.00,0.00
2024-12-08 17:17:31,68,7825,30,38,5102.30,9240.02,0.00
2024-12-08 17:17:31,67,7825,29,38,5141.22,9240.03,0.00
2024-12-08 17:17:31,67,7826,29,38,5190.05,9241.00,0.00
2024-12-08 17:17:31,68,7826,29,39,5113.72,9241.02,0.00
2024-12-08 17:17:31,67,7826,29,38,5187.29,9241.02,0.00
2024-12-08 17:17:31,66,7826,28,38,5253.28,9241.03,0.00
2024-12-08 17:17:31,65,7826,27,38,5322.77,9241.15,0.00
2024-12-08 17:17:31,65,7827,27,38,5387.29,9242.00,0.00
2024-12-08 17:17:31,66,7827,28,38,5305.66,9242.02,0.00
2024-12-08 17:17:31,66,7828,28,38,5299.23,9243.00,0.00
2024-12-08 17:17:31,67,7828,29,38,5220.14,9243.02,0.00
2024-12-08 17:17:31,66,7828,29,37,5288.03,9243.03,0.00
2024-12-08 17:17:31,65,7828,28,37,5358.04,9243.14,0.00
2024-12-08 17:17:31,65,7829,28,37,5392.72,9244.00,0.00
2024-12-08 17:17:31,66,7829,28,38,5311.01,9244.02,0.00
2024-12-08 17:17:31,65,7829,27,38,5351.51,9244.14,0.00
2024-12-08 17:17:31,64,7829,27,37,5406.16,9244.45,0.00
2024-12-08 17:17:31,64,7830,27,37,5471.56,9245.00,0.00
2024-12-08 17:17:31,65,7830,27,38,5387.39,9245.02,0.00
2024-12-08 17:17:31,64,7830,27,37,5460.01,9245.03,0.00
2024-12-08 17:17:32,64,7831,27,37,5486.60,9246.00,0.00
2024-12-08 17:17:32,65,7831,28,37,5402.19,9246.02,0.00
2024-12-08 17:17:32,64,7831,27,37,5447.62,9246.13,0.00
2024-12-08 17:17:32,64,7832,27,37,5482.86,9247.00,0.00
2024-12-08 17:17:32,65,7832,27,38,5398.51,9247.02,0.00
2024-12-08 17:17:32,64,7832,26,38,5481.42,9247.02,0.00
2024-12-08 17:17:32,63,7832,26,37,5559.62,9247.02,0.00
2024-12-08 17:17:32,63,7833,26,37,5586.64,9248.00,0.00
2024-12-08 17:17:32,64,7833,26,38,5499.35,9248.02,0.00
2024-12-08 17:17:32,64,7834,26,38,5495.61,9249.00,0.00
2024-12-08 17:17:32,65,7834,27,38,5411.06,9249.02,0.00
2024-12-08 17:17:32,64,7834,27,37,5488.38,9249.02,0.00
2024-12-08 17:17:32,64,7835,27,37,5513.55,9250.00,0.00
2024-12-08 17:17:32,65,7835,27,38,5428.72,9250.02,0.00
2024-12-08 17:17:32,65,7836,27,38,5423.62,9251.00,0.00
2024-12-08 17:17:32,66,7836,28,38,5341.44,9251.02,0.00
2024-12-08 17:17:32,65,7836,28,37,5412.24,9251.03,0.00
2024-12-08 17:17:32,65,7837,28,37,5437.01,9252.00,0.00
2024-12-08 17:17:32,66,7837,29,37,5354.63,9252.02,0.00
2024-12-08 17:17:32,66,7838,29,37,5348.20,9253.00,0.00
2024-12-08 17:17:32,67,7838,30,37,5268.38,9253.02,0.00
2024-12-08 17:17:32,66,7838,30,36,5338.39,9253.03,0.00
2024-12-08 17:17:32,66,7839,30,36,5361.40,9254.00,0.00
2024-12-08 17:17:32,67,7839,31,36,5281.38,9254.02,0.00
2024-12-08 17:17:32,68,7838,31,37,5130.44,9254.54,0.00
2024-12-08 17:17:32,68,7839,31,37,5266.88,9255.00,0.00
2024-12-08 17:17:32,69,7839,32,37,5190.55,9255.02,0.00
2024-12-08 17:17:32,68,7839,32,36,5258.72,9255.03,0.00
2024-12-08 17:17:32,68,7840,32,36,5414.46,9256.00,0.00
2024-12-08 17:17:32,69,7840,32,37,5335.99,9256.02,0.00
2024-12-08 17:17:32,69,7841,32,37,5325.83,9257.00,0.00
2024-12-08 17:17:32,70,7841,33,37,5249.75,9257.02,0.00
2024-12-08 17:17:32,69,7841,33,36,5307.06,9257.04,0.00
2024-12-08 17:17:32,69,7842,33,36,5325.94,9258.00,0.00
2024-12-08 17:17:32,70,7842,34,36,5249.86,9258.02,0.00
2024-12-08 17:17:32,71,7841,35,36,5078.68,9258.52,0.00
2024-12-08 17:17:32,71,7842,35,36,5234.22,9259.00,0.00
2024-12-08 17:17:32,72,7842,35,37,5161.52,9259.01,0.00
2024-12-08 17:17:32,71,7842,35,36,5213.36,9259.06,0.00
2024-12-08 17:17:32,71,7843,35,36,5360.38,9260.00,0.00
2024-12-08 17:17:32,72,7843,36,36,5285.93,9260.01,0.00
2024-12-08 17:17:32,73,7842,36,37,5148.36,9260.47,0.00
2024-12-08 17:17:32,73,7843,36,37,5207.11,9261.00,0.00
2024-12-08 17:17:32,74,7843,37,37,5136.74,9261.01,0.00
2024-12-08 17:17:32,73,7843,37,36,5188.09,9261.06,0.00
2024-12-08 17:17:32,73,7844,37,36,5329.17,9262.00,0.00
2024-12-08 17:17:32,74,7844,37,37,5257.16,9262.01,0.00
2024-12-08 17:17:32,73,7844,36,37,5290.47,9262.15,0.00
2024-12-08 17:17:32,73,7845,36,37,5313.84,9263.00,0.00
2024-12-08 17:17:32,74,7845,37,37,5242.04,9263.01,0.00
2024-12-08 17:17:32,73,7845,37,36,5296.09,9263.06,0.00
2024-12-08 17:17:32,72,7845,36,36,5282.85,9263.83,0.00
2024-12-08 17:17:32,72,7846,36,36,5396.22,9264.00,0.00
2024-12-08 17:17:32,73,7846,37,36,5322.30,9264.01,0.00
2024-12-08 17:17:32,72,7846,36,36,5330.92,9264.15,0.00
2024-12-08 17:17:32,72,7847,36,36,5381.65,9265.00,0.00
2024-12-08 17:17:32,73,7847,36,37,5307.93,9265.01,0.00
2024-12-08 17:17:32,72,7847,36,36,5368.15,9265.06,0.00
2024-12-08 17:17:32,71,7847,35,36,5432.64,9265.16,0.00
2024-12-08 17:17:33,71,7848,35,36,5459.29,9266.00,0.00
2024-12-08 17:17:33,72,7848,36,36,5383.47,9266.01,0.00
2024-12-08 17:17:33,72,7849,36,36,5369.57,9267.00,0.00
2024-12-08 17:17:33,73,7849,37,36,5296.01,9267.01,0.00
2024-12-08 17:17:33,72,7849,37,35,5352.84,9267.06,0.00
2024-12-08 17:17:33,72,7850,37,35,5368.86,9268.00,0.00
2024-12-08 17:17:33,73,7850,38,35,5295.31,9268.01,0.00
2024-12-08 17:17:33,73,7851,38,35,5280.34,9269.00,0.00
2024-12-08 17:17:33,74,7851,39,35,5208.99,9269.01,0.00
2024-12-08 17:17:33,73,7851,39,34,5264.62,9269.06,0.00
2024-12-08 17:17:33,72,7851,38,34,5235.27,9269.94,0.00
2024-12-08 17:17:33,72,7852,38,34,5357.89,9270.00,0.00
2024-12-08 17:17:33,73,7852,39,34,5284.50,9270.01,0.00
2024-12-08 17:17:33,72,7852,38,34,5338.97,9270.07,0.00
2024-12-08 17:17:33,72,7853,38,34,5354.44,9271.00,0.00
2024-12-08 17:17:33,73,7853,38,35,5281.09,9271.01,0.00
2024-12-08 17:17:33,72,7853,38,34,5335.45,9271.07,0.00
2024-12-08 17:17:33,72,7854,38,34,5348.81,9272.00,0.00
2024-12-08 17:17:33,73,7854,38,35,5275.54,9272.01,0.00
2024-12-08 17:17:33,72,7854,37,35,5306.12,9272.17,0.00
2024-12-08 17:17:33,72,7855,37,35,5351.28,9273.00,0.00
2024-12-08 17:17:33,73,7855,38,35,5277.98,9273.01,0.00
2024-12-08 17:17:33,72,7855,38,34,5330.53,9273.07,0.00
2024-12-08 17:17:33,72,7856,38,34,5338.30,9274.00,0.00
2024-12-08 17:17:33,73,7856,39,34,5265.17,9274.01,0.00
2024-12-08 17:17:33,73,7857,39,34,5236.42,9275.00,0.00
2024-12-08 17:17:33,74,7857,39,35,5165.66,9275.01,0.00
2024-12-08 17:17:33,73,7857,38,35,5235.15,9275.01,0.00
2024-12-08 17:17:33,72,7857,38,34,5286.86,9275.06,0.00
2024-12-08 17:17:33,72,7858,38,34,5291.10,9276.00,0.00
2024-12-08 17:17:33,73,7858,39,34,5218.62,9276.01,0.00
2024-12-08 17:17:33,72,7858,38,34,5284.13,9276.04,0.00
2024-12-08 17:17:33,73,7857,38,35,5168.61,9276.26,0.00
2024-12-08 17:17:33,72,7857,37,35,5200.68,9276.67,0.00
2024-12-08 17:17:33,72,7858,37,35,5286.28,9277.00,0.00
2024-12-08 17:17:33,73,7858,37,36,5213.86,9277.01,0.00
2024-12-08 17:17:33,72,7858,37,35,5267.49,9277.04,0.00
2024-12-08 17:17:33,72,7859,37,35,5397.65,9278.00,0.00
2024-12-08 17:17:33,73,7859,37,36,5323.71,9278.01,0.00
2024-12-08 17:17:33,73,7860,37,36,5292.12,9279.00,0.00
2024-12-08 17:17:33,74,7860,37,37,5220.61,9279.01,0.00
2024-12-08 17:17:33,73,7860,37,36,5275.95,9279.04,0.00
2024-12-08 17:17:33,72,7860,36,36,5310.74,9279.44,0.00
2024-12-08 17:17:33,72,7861,36,36,5346.06,9280.00,0.00
2024-12-08 17:17:33,73,7861,37,36,5272.82,9280.01,0.00
2024-12-08 17:17:33,73,7862,37,36,5236.00,9281.00,0.00
2024-12-08 17:17:33,74,7862,37,37,5165.24,9281.01,0.00
2024-12-08 17:17:33,73,7862,37,36,5220.82,9281.04,0.00
2024-12-08 17:17:33,73,7863,37,36,5209.72,9282.00,0.00
2024-12-08 17:17:33,74,7863,38,36,5139.31,9282.01,0.00
2024-12-08 17:17:33,74,7864,38,36,5095.73,9283.00,0.00
2024-12-08 17:17:33,75,7864,39,36,5027.78,9283.01,0.00
2024-12-08 17:17:33,74,7864,39,35,5076.92,9283.07,0.00
2024-12-08 17:17:33,73,7864,38,35,5063.37,9283.80,0.00
2024-12-08 17:17:33,73,7865,38,35,5146.20,9284.00,0.00
2024-12-08 17:17:33,74,7865,39,35,5076.66,9284.01,0.00
2024-12-08 17:17:33,73,7865,38,35,5137.30,9284.03,0.00
2024-12-08 17:17:33,73,7866,38,35,5133.20,9285.00,0.00
2024-12-08 17:17:33,74,7866,39,35,5063.84,9285.01,0.00
2024-12-08 17:17:33,73,7866,38,35,5132.83,9285.01,0.00
2024-12-08 17:17:34,72,7866,38,34,5201.42,9285.04,0.00
2024-12-08 17:17:34,73,7865,38,35,5090.91,9285.49,0.00
2024-12-08 17:17:34,72,7865,38,34,5168.99,9285.74,0.00
2024-12-08 17:17:34,72,7866,38,34,5247.25,9286.00,0.00
2024-12-08 17:17:34,73,7866,38,35,5175.37,9286.01,0.00
2024-12-08 17:17:34,72,7866,37,35,5198.26,9286.08,0.00
2024-12-08 17:17:34,73,7865,37,36,5075.17,9286.67,0.00
2024-12-08 17:17:34,73,7866,37,36,5330.52,9287.00,0.00
2024-12-08 17:17:34,74,7866,37,37,5258.49,9287.01,0.00
2024-12-08 17:17:34,73,7866,37,36,5291.09,9287.04,0.00
2024-12-08 17:17:34,72,7866,36,36,5328.62,9287.43,0.00
2024-12-08 17:17:34,72,7867,36,36,5534.14,9288.00,0.00
2024-12-08 17:17:34,73,7867,37,36,5458.33,9288.01,0.00
2024-12-08 17:17:34,72,7867,36,36,5527.69,9288.03,0.00
2024-12-08 17:17:34,72,7868,36,36,5540.82,9289.00,0.00
2024-12-08 17:17:34,73,7868,37,36,5464.92,9289.01,0.00
2024-12-08 17:17:34,72,7868,37,35,5529.22,9289.03,0.00
2024-12-08 17:17:34,72,7869,37,35,5540.32,9290.00,0.00
2024-12-08 17:17:34,73,7869,37,36,5464.42,9290.01,0.00
2024-12-08 17:17:34,73,7870,37,36,5445.46,9291.00,0.00
2024-12-08 17:17:34,74,7870,37,37,5371.88,9291.01,0.00
2024-12-08 17:17:34,73,7870,37,36,5435.28,9291.03,0.00
2024-12-08 17:17:34,73,7871,37,36,5442.64,9292.00,0.00
2024-12-08 17:17:34,74,7871,38,36,5369.09,9292.01,0.00
2024-12-08 17:17:34,73,7871,37,36,5403.18,9292.04,0.00
2024-12-08 17:17:34,73,7872,37,36,5437.64,9293.00,0.00
2024-12-08 17:17:34,74,7872,37,37,5364.16,9293.01,0.00
2024-12-08 17:17:34,73,7872,37,36,5427.46,9293.03,0.00
2024-12-08 17:17:34,73,7873,37,36,5436.58,9294.00,0.00
2024-12-08 17:17:34,74,7873,37,37,5363.11,9294.01,0.00
2024-12-08 17:17:34,74,7874,37,37,5346.00,9295.00,0.00
2024-12-08 17:17:34,75,7874,38,37,5274.72,9295.01,0.00
2024-12-08 17:17:34,74,7874,38,36,5335.96,9295.03,0.00
2024-12-08 17:17:34,74,7875,38,36,5346.58,9296.00,0.00
2024-12-08 17:17:34,75,7875,39,36,5275.29,9296.01,0.00
2024-12-08 17:17:34,75,7876,39,36,5258.50,9297.00,0.00
2024-12-08 17:17:34,76,7876,40,36,5189.31,9297.01,0.00
2024-12-08 17:17:34,75,7876,40,35,5239.93,9297.08,0.00
2024-12-08 17:17:34,75,7877,40,35,5249.12,9298.00,0.00
2024-12-08 17:17:34,76,7877,40,36,5180.05,9298.01,0.00
2024-12-08 17:17:34,75,7877,39,36,5239.21,9298.04,0.00
2024-12-08 17:17:34,74,7877,38,36,5246.08,9298.45,0.00
2024-12-08 17:17:34,74,7878,38,36,5297.83,9299.00,0.00
2024-12-08 17:17:34,75,7878,38,37,5227.19,9299.01,0.00
2024-12-08 17:17:34,74,7878,38,36,5256.38,9299.07,0.00
2024-12-08 17:17:34,73,7878,37,36,5227.59,9299.78,0.00
2024-12-08 17:17:34,73,7879,37,36,5334.78,9300.00,0.00
2024-12-08 17:17:34,74,7879,38,36,5262.69,9300.01,0.00
2024-12-08 17:17:34,74,7880,38,36,5246.91,9301.00,0.00
2024-12-08 17:17:34,75,7880,38,37,5176.95,9301.01,0.00
2024-12-08 17:17:34,74,7880,38,36,5229.33,9301.08,0.00
2024-12-08 17:17:34,74,7881,38,36,5244.96,9302.00,0.00
2024-12-08 17:17:34,75,7881,39,36,5175.03,9302.01,0.00
2024-12-08 17:17:34,74,7881,38,36,5227.38,9302.08,0.00
2024-12-08 17:17:34,74,7882,38,36,5243.01,9303.00,0.00
2024-12-08 17:17:34,75,7882,38,37,5173.10,9303.01,0.00
2024-12-08 17:17:34,74,7882,38,36,5222.91,9303.10,0.00
2024-12-08 17:17:34,73,7882,37,36,5284.30,9303.21,0.00
2024-12-08 17:17:34,73,7883,37,36,5312.86,9304.00,0.00
2024-12-08 17:17:34,74,7883,37,37,5241.06,9304.01,0.00
2024-12-08 17:17:35,74,7884,37,37,5225.28,9305.00,0.00
2024-12-08 17:17:35,75,7884,38,37,5155.61,9305.01,0.00
2024-12-08 17:17:35,74,7884,37,37,5195.11,9305.05,0.00
2024-12-08 17:17:35,73,7884,37,36,5247.16,9305.11,0.00
2024-12-08 17:17:35,73,7885,37,36,5292.33,9306.00,0.00
2024-12-08 17:17:35,74,7885,37,37,5220.81,9306.01,0.00
2024-12-08 17:17:35,73,7885,36,37,5279.59,9306.07,0.00
2024-12-08 17:17:35,73,7886,36,37,5295.24,9307.00,0.00
2024-12-08 17:17:35,74,7886,36,38,5223.68,9307.01,0.00
2024-12-08 17:17:35,73,7886,36,37,5274.85,9307.10,0.00
2024-12-08 17:17:35,73,7887,36,37,5290.89,9308.00,0.00
2024-12-08 17:17:35,74,7887,36,38,5219.39,9308.01,0.00
2024-12-08 17:17:35,74,7888,36,38,5199.23,9309.00,0.00
2024-12-08 17:17:35,75,7888,36,39,5129.90,9309.01,0.00
2024-12-08 17:17:35,74,7888,35,39,5195.46,9309.05,0.00
2024-12-08 17:17:35,73,7888,35,38,5252.61,9309.08,0.00
2024-12-08 17:17:35,73,7889,35,38,5263.06,9310.00,0.00
2024-12-08 17:17:35,74,7889,35,39,5191.94,9310.01,0.00
2024-12-08 17:17:35,73,7889,34,39,5261.79,9310.01,0.00
2024-12-08 17:17:35,73,7890,34,39,5237.99,9311.00,0.00
2024-12-08 17:17:35,74,7890,34,40,5167.21,9311.01,0.00
2024-12-08 17:17:35,73,7890,34,39,5222.70,9311.07,0.00
2024-12-08 17:17:35,73,7891,34,39,5227.46,9312.00,0.00
2024-12-08 17:17:35,74,7891,34,40,5156.82,9312.01,0.00
2024-12-08 17:17:35,74,7892,34,40,5128.17,9313.00,0.00
2024-12-08 17:17:35,75,7892,35,40,5059.79,9313.01,0.00
2024-12-08 17:17:35,74,7892,35,39,5113.07,9313.07,0.00
2024-12-08 17:17:35,73,7892,34,39,5097.50,9313.78,0.00
2024-12-08 17:17:35,73,7893,34,39,5204.85,9314.00,0.00
2024-12-08 17:17:35,74,7893,35,39,5134.51,9314.01,0.00
2024-12-08 17:17:35,73,7893,34,39,5134.97,9314.38,0.00
2024-12-08 17:17:35,73,7894,34,39,5180.05,9315.00,0.00
2024-12-08 17:17:35,74,7894,34,40,5110.05,9315.01,0.00
2024-12-08 17:17:35,73,7894,33,40,5176.23,9315.06,0.00
2024-12-08 17:17:35,72,7894,33,39,5239.07,9315.06,0.00
2024-12-08 17:17:35,72,7894,33,39,5255.15,9316.00,0.00
2024-12-08 17:17:35,73,7894,34,39,5183.16,9316.01,0.00
2024-12-08 17:17:35,73,7895,34,39,5168.40,9317.00,0.00
2024-12-08 17:17:35,74,7895,35,39,5098.56,9317.01,0.00
2024-12-08 17:17:35,73,7895,35,38,5153.10,9317.07,0.00
2024-12-08 17:17:35,73,7896,35,38,5168.96,9318.00,0.00
2024-12-08 17:17:35,74,7896,36,38,5099.10,9318.01,0.00
2024-12-08 17:17:35,73,7896,35,38,5166.41,9318.03,0.00
2024-12-08 17:17:35,72,7896,34,38,5196.80,9318.19,0.00
2024-12-08 17:17:35,72,7897,34,38,5225.78,9319.00,0.00
2024-12-08 17:17:35,73,7897,34,39,5154.19,9319.01,0.00
2024-12-08 17:17:35,72,7897,34,38,5212.84,9319.06,0.00
2024-12-08 17:17:35,72,7898,34,38,5228.93,9320.00,0.00
2024-12-08 17:17:35,73,7898,34,39,5157.30,9320.01,0.00
2024-12-08 17:17:35,73,7899,34,39,5142.53,9321.00,0.00
2024-12-08 17:17:35,74,7899,35,39,5073.03,9321.01,0.00
2024-12-08 17:17:35,73,7899,34,39,5099.17,9321.21,0.00
2024-12-08 17:17:35,72,7899,33,39,5122.36,9321.72,0.00
2024-12-08 17:17:35,72,7900,33,39,5200.27,9322.00,0.00
2024-12-08 17:17:35,73,7900,34,39,5129.03,9322.01,0.00
2024-12-08 17:17:35,73,7901,34,39,5114.26,9323.00,0.00
2024-12-08 17:17:35,74,7901,34,40,5045.15,9323.01,0.00
2024-12-08 17:17:35,73,7901,34,39,5106.60,9323.06,0.00
2024-12-08 17:17:35,73,7902,34,39,5121.19,9324.00,0.00
2024-12-08 17:17:35,74,7902,35,39,5051.99,9324.01,0.00
2024-12-08 17:17:35,75,7901,36,39,4947.36,9324.17,0.00
2024-12-08 17:17:36,75,7902,36,39,5053.55,9325.00,0.00
2024-12-08 17:17:36,76,7902,37,39,4987.05,9325.01,0.00
2024-12-08 17:17:36,75,7902,37,38,5044.85,9325.05,0.00
2024-12-08 17:17:36,75,7903,37,38,5180.92,9326.00,0.00
2024-12-08 17:17:36,76,7903,38,38,5112.75,9326.01,0.00
2024-12-08 17:17:36,75,7903,37,38,5142.38,9326.08,0.00
2024-12-08 17:17:36,75,7904,37,38,5181.48,9327.00,0.00
2024-12-08 17:17:36,76,7904,37,39,5113.30,9327.01,0.00
2024-12-08 17:17:36,75,7904,37,38,5171.53,9327.07,0.00
2024-12-08 17:17:36,75,7905,37,38,5184.52,9328.00,0.00
2024-12-08 17:17:36,76,7905,38,38,5116.30,9328.01,0.00
2024-12-08 17:17:36,76,7906,38,38,5098.44,9329.00,0.00
2024-12-08 17:17:36,77,7906,39,38,5032.22,9329.01,0.00
2024-12-08 17:17:36,76,7906,38,38,5093.53,9329.05,0.00
2024-12-08 17:17:36,75,7906,38,37,5152.74,9329.07,0.00
2024-12-08 17:17:36,74,7906,37,37,5184.73,9329.47,0.00
2024-12-08 17:17:36,74,7907,37,37,5236.79,9330.00,0.00
2024-12-08 17:17:36,75,7907,37,38,5166.97,9330.01,0.00
2024-12-08 17:17:36,75,7908,37,38,5150.11,9331.00,0.00
2024-12-08 17:17:36,76,7908,37,39,5082.34,9331.01,0.00
2024-12-08 17:17:36,76,7909,37,39,5064.47,9332.00,0.00
2024-12-08 17:17:36,77,7909,37,40,4998.70,9332.01,0.00
2024-12-08 17:17:36,77,7910,37,40,4979.84,9333.00,0.00
2024-12-08 17:17:36,78,7910,37,41,4915.99,9333.01,0.00
2024-12-08 17:17:36,77,7910,36,41,4977.41,9333.03,0.00
2024-12-08 17:17:36,76,7910,35,41,4975.54,9333.49,0.00
2024-12-08 17:17:36,76,7911,35,41,5026.25,9334.00,0.00
2024-12-08 17:17:36,77,7911,35,42,4960.98,9334.01,0.00
2024-12-08 17:17:36,76,7911,35,41,5007.84,9334.07,0.00
2024-12-08 17:17:36,77,7910,35,42,4882.51,9334.74,0.00
2024-12-08 17:17:36,76,7910,34,42,4944.40,9334.88,0.00
2024-12-08 17:17:36,76,7911,34,42,5056.27,9335.00,0.00
2024-12-08 17:17:36,77,7911,35,42,4990.60,9335.01,0.00
2024-12-08 17:17:36,77,7912,35,42,5092.99,9336.00,0.00
2024-12-08 17:17:36,78,7912,36,42,5027.69,9336.01,0.00
2024-12-08 17:17:36,77,7912,35,42,5091.77,9336.01,0.00
2024-12-08 17:17:36,76,7912,35,41,5148.95,9336.07,0.00
2024-12-08 17:17:36,76,7913,35,41,5160.55,9337.00,0.00
2024-12-08 17:17:36,77,7913,35,42,5093.53,9337.01,0.00
2024-12-08 17:17:36,76,7913,34,42,5151.95,9337.01,0.00
2024-12-08 17:17:36,76,7914,34,42,5158.65,9338.00,0.00
2024-12-08 17:17:36,77,7914,35,42,5091.65,9338.01,0.00
2024-12-08 17:17:36,77,7915,35,42,5072.79,9339.00,0.00
2024-12-08 17:17:36,78,7915,35,43,5007.76,9339.01,0.00
2024-12-08 17:17:36,77,7915,35,42,5059.46,9339.05,0.00
2024-12-08 17:17:36,77,7916,35,42,5068.48,9340.00,0.00
2024-12-08 17:17:36,78,7916,35,43,5003.50,9340.01,0.00
2024-12-08 17:17:36,78,7917,35,43,4983.68,9341.00,0.00
2024-12-08 17:17:36,79,7917,35,44,4920.60,9341.01,0.00
2024-12-08 17:17:36,78,7917,35,43,4976.50,9341.06,0.00
2024-12-08 17:17:36,78,7918,35,43,4985.41,9342.00,0.00
2024-12-08 17:17:36,79,7918,35,44,4922.31,9342.01,0.00
2024-12-08 17:17:36,78,7918,34,44,4966.26,9342.10,0.00
2024-12-08 17:17:36,78,7919,34,44,4978.76,9343.00,0.00
2024-12-08 17:17:36,79,7919,35,44,4915.73,9343.01,0.00
2024-12-08 17:17:36,78,7919,34,44,4972.78,9343.06,0.00
2024-12-08 17:17:36,77,7919,34,43,5024.02,9343.09,0.00
2024-12-08 17:17:37,77,7920,34,43,5036.68,9344.00,0.00
2024-12-08 17:17:37,78,7920,35,43,4972.10,9344.01,0.00
2024-12-08 17:17:37,77,7920,34,43,4973.62,9344.21,0.00
2024-12-08 17:17:37,77,7921,34,43,5021.44,9345.00,0.00
2024-12-08 17:17:37,78,7921,34,44,4957.06,9345.01,0.00
2024-12-08 17:17:37,77,7921,34,43,5004.46,9345.09,0.00
2024-12-08 17:17:37,77,7922,34,43,5017.12,9346.00,0.00
2024-12-08 17:17:37,78,7922,34,44,4952.80,9346.01,0.00
2024-12-08 17:17:37,78,7923,34,44,4932.96,9347.00,0.00
2024-12-08 17:17:37,79,7923,34,45,4870.51,9347.01,0.00
2024-12-08 17:17:37,78,7923,33,45,4917.39,9347.09,0.00
2024-12-08 17:17:37,77,7923,33,44,4969.11,9347.10,0.00
2024-12-08 17:17:37,78,7922,34,44,4861.28,9347.60,0.00
2024-12-08 17:17:37,78,7923,34,44,5004.19,9348.00,0.00
2024-12-08 17:17:37,79,7923,35,44,4940.85,9348.01,0.00
2024-12-08 17:17:37,79,7924,35,44,5038.42,9349.00,0.00
2024-12-08 17:17:37,80,7924,35,45,4975.44,9349.01,0.00
2024-12-08 17:17:37,79,7924,35,44,5019.49,9349.11,0.00
2024-12-08 17:17:37,79,7925,35,44,5031.86,9350.00,0.00
2024-12-08 17:17:37,80,7925,36,44,4968.96,9350.01,0.00
2024-12-08 17:17:37,79,7925,35,44,5015.29,9350.10,0.00
2024-12-08 17:17:37,79,7926,35,44,5026.48,9351.00,0.00
2024-12-08 17:17:37,80,7926,35,45,4963.64,9351.01,0.00
2024-12-08 17:17:37,79,7926,35,44,5009.91,9351.10,0.00
2024-12-08 17:17:37,80,7925,36,44,4922.83,9351.39,0.00
2024-12-08 17:17:37,80,7926,36,44,5014.44,9352.00,0.00
2024-12-08 17:17:37,81,7926,36,45,4952.54,9352.01,0.00
2024-12-08 17:17:37,81,7927,36,45,5045.44,9353.00,0.00
2024-12-08 17:17:37,82,7927,37,45,4983.91,9353.01,0.00
2024-12-08 17:17:37,81,7927,37,44,5030.43,9353.10,0.00
2024-12-08 17:17:37,81,7928,37,44,5039.05,9354.00,0.00
2024-12-08 17:17:37,82,7928,37,45,4977.60,9354.01,0.00
2024-12-08 17:17:37,81,7928,36,45,5037.90,9354.01,0.00
2024-12-08 17:17:37,81,7929,36,45,5015.34,9355.00,0.00
2024-12-08 17:17:37,82,7929,36,46,4954.17,9355.01,0.00
2024-12-08 17:17:37,81,7929,35,46,5014.18,9355.01,0.00
2024-12-08 17:17:37,80,7929,34,46,5072.18,9355.06,0.00
2024-12-08 17:17:37,79,7929,34,45,5130.47,9355.06,0.00
2024-12-08 17:17:37,79,7930,34,45,5138.12,9356.00,0.00
2024-12-08 17:17:37,80,7930,35,45,5073.89,9356.01,0.00
2024-12-08 17:17:37,80,7931,35,45,5052.21,9357.00,0.00
2024-12-08 17:17:37,81,7931,35,46,4989.84,9357.01,0.00
2024-12-08 17:17:37,80,7931,35,45,5041.69,9357.06,0.00
2024-12-08 17:17:37,79,7931,34,45,5065.28,9357.23,0.00
2024-12-08 17:17:37,79,7932,34,45,5111.97,9358.00,0.00
2024-12-08 17:17:37,80,7932,34,46,5048.07,9358.01,0.00
2024-12-08 17:17:37,79,7932,33,46,5110.79,9358.01,0.00
2024-12-08 17:17:37,79,7933,33,46,5090.01,9359.00,0.00
2024-12-08 17:17:37,80,7933,34,46,5026.38,9359.01,0.00
2024-12-08 17:17:37,79,7933,34,45,5074.62,9359.09,0.00
2024-12-08 17:17:37,78,7933,33,45,5082.23,9359.45,0.00
2024-12-08 17:17:37,78,7934,33,45,5151.02,9360.00,0.00
2024-12-08 17:17:37,79,7934,34,45,5085.81,9360.01,0.00
2024-12-08 17:17:37,79,7935,34,45,5065.03,9361.00,0.00
2024-12-08 17:17:37,80,7935,34,46,5001.71,9361.01,0.00
2024-12-08 17:17:37,79,7935,33,46,5063.84,9361.01,0.00
2024-12-08 17:17:37,80,7934,34,46,4998.21,9361.06,0.00
2024-12-08 17:17:37,79,7934,34,45,5168.14,9361.09,0.00
2024-12-08 17:17:37,79,7935,34,45,5178.15,9362.00,0.00
2024-12-08 17:17:37,80,7935,34,46,5113.42,9362.01,0.00
2024-12-08 17:17:38,80,7936,34,46,5208.77,9363.00,0.00
2024-12-08 17:17:38,81,7936,34,47,5144.46,9363.01,0.00
2024-12-08 17:17:38,80,7936,34,46,5198.25,9363.08,0.00
2024-12-08 17:17:38,80,7937,34,46,5205.81,9364.00,0.00
2024-12-08 17:17:38,81,7937,35,46,5141.55,9364.01,0.00
2024-12-08 17:17:38,81,7938,35,46,5118.97,9365.00,0.00
2024-12-08 17:17:38,82,7938,36,46,5056.54,9365.01,0.00
2024-12-08 17:17:38,81,7938,36,45,5109.74,9365.07,0.00
2024-12-08 17:17:38,80,7938,35,45,5114.21,9365.71,0.00
2024-12-08 17:17:38,80,7939,35,45,5181.17,9366.00,0.00
2024-12-08 17:17:38,81,7939,36,45,5117.21,9366.01,0.00
2024-12-08 17:17:38,80,7939,35,45,5180.00,9366.01,0.00
2024-12-08 17:17:38,79,7939,34,45,5236.10,9366.06,0.00
2024-12-08 17:17:38,79,7940,34,45,5243.76,9367.00,0.00
2024-12-08 17:17:38,80,7940,35,45,5178.21,9367.01,0.00
2024-12-08 17:17:38,79,7940,34,45,5242.57,9367.01,0.00
2024-12-08 17:17:38,78,7940,34,44,5301.40,9367.05,0.00
2024-12-08 17:17:38,78,7941,34,44,5309.15,9368.00,0.00
2024-12-08 17:17:38,79,7941,35,44,5241.95,9368.01,0.00
2024-12-08 17:17:38,80,7940,36,44,5139.00,9368.19,0.00
2024-12-08 17:17:38,80,7941,36,44,5230.85,9369.00,0.00
2024-12-08 17:17:38,81,7941,37,44,5166.27,9369.01,0.00
2024-12-08 17:17:38,80,7941,37,43,5223.83,9369.05,0.00
2024-12-08 17:17:38,80,7942,37,43,5346.19,9370.00,0.00
2024-12-08 17:17:38,81,7942,38,43,5280.18,9370.01,0.00
2024-12-08 17:17:38,80,7942,37,43,5309.90,9370.08,0.00
2024-12-08 17:17:38,80,7943,37,43,5340.90,9371.00,0.00
2024-12-08 17:17:38,81,7943,37,44,5274.96,9371.01,0.00
2024-12-08 17:17:38,80,7943,37,43,5333.89,9371.05,0.00
2024-12-08 17:17:38,80,7944,37,43,5339.13,9372.00,0.00
2024-12-08 17:17:38,81,7944,37,44,5273.21,9372.01,0.00
2024-12-08 17:17:38,82,7943,37,45,5164.42,9372.27,0.00
2024-12-08 17:17:38,82,7944,37,45,5230.04,9373.00,0.00
2024-12-08 17:17:38,83,7944,38,45,5167.02,9373.01,0.00
2024-12-08 17:17:38,82,7944,38,44,5224.33,9373.05,0.00
2024-12-08 17:17:38,82,7945,38,44,5341.48,9374.00,0.00
2024-12-08 17:17:38,83,7945,38,45,5277.13,9374.01,0.00
2024-12-08 17:17:38,82,7945,37,45,5229.79,9374.72,0.00
2024-12-08 17:17:38,82,7946,37,45,5318.04,9375.00,0.00
2024-12-08 17:17:38,83,7946,37,46,5253.97,9375.01,0.00
2024-12-08 17:17:38,82,7946,37,45,5310.05,9375.05,0.00
2024-12-08 17:17:38,82,7947,37,45,5312.89,9376.00,0.00
2024-12-08 17:17:38,83,7947,37,46,5248.88,9376.01,0.00
2024-12-08 17:17:38,83,7948,37,46,5224.59,9377.00,0.00
2024-12-08 17:17:38,84,7948,37,47,5162.39,9377.01,0.00
2024-12-08 17:17:38,83,7948,37,46,5217.82,9377.05,0.00
2024-12-08 17:17:38,83,7949,37,46,5219.49,9378.00,0.00
2024-12-08 17:17:38,84,7949,37,47,5157.36,9378.01,0.00
2024-12-08 17:17:38,84,7950,37,47,5132.23,9379.00,0.00
2024-12-08 17:17:38,85,7950,38,47,5071.85,9379.01,0.00
2024-12-08 17:17:38,84,7950,38,46,5125.54,9379.05,0.00
2024-12-08 17:17:38,83,7950,37,46,5146.77,9379.48,0.00
2024-12-08 17:17:38,83,7951,37,46,5188.96,9380.00,0.00
2024-12-08 17:17:38,84,7951,38,46,5127.19,9380.01,0.00
2024-12-08 17:17:38,84,7952,38,46,5102.05,9381.00,0.00
2024-12-08 17:17:38,85,7952,38,47,5042.03,9381.01,0.00
2024-12-08 17:17:38,85,7953,38,47,5016.07,9382.00,0.00
2024-12-08 17:17:38,86,7953,38,48,4957.75,9382.01,0.00
2024-12-08 17:17:39,86,7954,38,48,4931.00,9383.00,0.00
2024-12-08 17:17:39,87,7954,38,49,4874.32,9383.01,0.00
2024-12-08 17:17:39,86,7954,37,49,4928.83,9383.02,0.00
2024-12-08 17:17:39,85,7954,36,49,4985.71,9383.04,0.00
2024-12-08 17:17:39,84,7954,36,48,5035.01,9383.04,0.00
2024-12-08 17:17:39,83,7954,35,48,5076.52,9383.24,0.00
2024-12-08 17:17:39,83,7955,35,48,5096.21,9384.00,0.00
2024-12-08 17:17:39,84,7955,35,49,5035.54,9384.01,0.00
2024-12-08 17:17:39,84,7956,35,49,5010.38,9385.00,0.00
2024-12-08 17:17:39,85,7956,36,49,4951.43,9385.01,0.00
2024-12-08 17:17:39,84,7956,35,49,5008.69,9385.02,0.00
2024-12-08 17:17:39,84,7957,35,49,4984.63,9386.00,0.00
2024-12-08 17:17:39,85,7957,35,50,4925.99,9386.01,0.00
2024-12-08 17:17:39,85,7958,35,50,4900.01,9387.00,0.00
2024-12-08 17:17:39,86,7958,35,51,4843.04,9387.01,0.00
2024-12-08 17:17:39,86,7959,35,51,4816.26,9388.00,0.00
2024-12-08 17:17:39,87,7959,36,51,4760.90,9388.01,0.00
2024-12-08 17:17:39,86,7959,36,50,4814.08,9388.02,0.00
2024-12-08 17:17:39,86,7960,36,50,4810.22,9389.00,0.00
2024-12-08 17:17:39,87,7960,36,51,4754.93,9389.01,0.00
2024-12-08 17:17:39,86,7960,36,50,4788.40,9389.04,0.00
2024-12-08 17:17:39,85,7960,35,50,4823.80,9389.26,0.00
2024-12-08 17:17:39,84,7960,34,50,4880.11,9389.26,0.00
2024-12-08 17:17:39,85,7959,34,51,4763.26,9389.68,0.00
2024-12-08 17:17:39,85,7960,34,51,4871.75,9390.00,0.00
2024-12-08 17:17:39,86,7960,34,52,4815.10,9390.01,0.00
2024-12-08 17:17:39,85,7960,34,51,4849.67,9390.04,0.00
2024-12-08 17:17:39,85,7961,34,51,4958.45,9391.00,0.00
2024-12-08 17:17:39,86,7961,35,51,4900.79,9391.01,0.00
2024-12-08 17:17:39,85,7961,35,50,4936.36,9391.04,0.00
2024-12-08 17:17:39,86,7960,36,50,4874.60,9391.10,0.00
2024-12-08 17:17:39,85,7960,35,50,5014.85,9391.20,0.00
2024-12-08 17:17:39,84,7960,34,50,5045.61,9391.50,0.00
2024-12-08 17:17:39,85,7959,35,50,4962.10,9391.78,0.00
2024-12-08 17:17:39,85,7960,35,50,5071.68,9392.00,0.00
2024-12-08 17:17:39,86,7960,35,51,5012.70,9392.01,0.00
2024-12-08 17:17:39,85,7960,35,50,5049.59,9392.04,0.00
2024-12-08 17:17:39,85,7961,35,50,5268.92,9393.00,0.00
2024-12-08 17:17:39,86,7961,35,51,5207.65,9393.01,0.00
2024-12-08 17:17:39,85,7961,35,50,5246.83,9393.04,0.00
2024-12-08 17:17:39,85,7962,35,50,5245.17,9394.00,0.00
2024-12-08 17:17:39,86,7962,35,51,5184.18,9394.01,0.00
2024-12-08 17:17:39,85,7962,35,50,5223.07,9394.04,0.00
2024-12-08 17:17:39,85,7963,35,50,5221.41,9395.00,0.00
2024-12-08 17:17:39,86,7963,35,51,5160.69,9395.01,0.00
2024-12-08 17:17:39,85,7963,35,50,5199.31,9395.04,0.00
2024-12-08 17:17:39,84,7963,34,50,5253.40,9395.08,0.00
2024-12-08 17:17:39,84,7964,34,50,5279.66,9396.00,0.00
2024-12-08 17:17:39,85,7964,35,50,5217.54,9396.01,0.00
2024-12-08 17:17:39,84,7964,35,49,5252.84,9396.06,0.00
2024-12-08 17:17:39,84,7965,35,49,5254.49,9397.00,0.00
2024-12-08 17:17:39,85,7965,36,49,5192.67,9397.01,0.00
2024-12-08 17:17:39,84,7965,35,49,5188.55,9397.24,0.00
2024-12-08 17:17:39,84,7966,35,49,5229.31,9398.00,0.00
2024-12-08 17:17:39,85,7966,36,49,5167.79,9398.01,0.00
2024-12-08 17:17:39,84,7966,36,48,5221.51,9398.07,0.00
2024-12-08 17:17:39,83,7966,35,48,5271.97,9398.11,0.00
2024-12-08 17:17:39,83,7967,35,48,5301.94,9399.00,0.00
2024-12-08 17:17:39,84,7967,36,48,5238.82,9399.01,0.00
2024-12-08 17:17:39,83,7967,35,48,5269.13,9399.08,0.00
2024-12-08 17:17:39,83,7968,35,48,5296.84,9400.00,0.00
2024-12-08 17:17:39,84,7968,36,48,5233.78,9400.01,0.00
2024-12-08 17:17:39,83,7968,36,47,5290.08,9400.07,0.00
2024-12-08 17:17:40,83,7969,36,47,5294.01,9401.00,0.00
2024-12-08 17:17:40,84,7969,37,47,5230.98,9401.01,0.00
2024-12-08 17:17:40,84,7970,37,47,5205.79,9402.00,0.00
2024-12-08 17:17:40,85,7970,38,47,5144.55,9402.01,0.00
2024-12-08 17:17:40,84,7970,38,46,5197.99,9402.07,0.00
2024-12-08 17:17:40,84,7971,38,46,5200.75,9403.00,0.00
2024-12-08 17:17:40,85,7971,39,46,5139.57,9403.01,0.00
2024-12-08 17:17:40,84,7971,38,46,5190.70,9403.07,0.00
2024-12-08 17:17:40,83,7971,37,46,5214.77,9403.23,0.00
2024-12-08 17:17:40,83,7972,37,46,5256.04,9404.00,0.00
2024-12-08 17:17:40,84,7972,37,47,5193.47,9404.01,0.00
2024-12-08 17:17:40,83,7972,37,46,5245.87,9404.07,0.00
2024-12-08 17:17:40,83,7973,37,46,5249.80,9405.00,0.00
2024-12-08 17:17:40,84,7973,37,47,5187.30,9405.01,0.00
2024-12-08 17:17:40,83,7973,36,47,5247.54,9405.02,0.00
2024-12-08 17:17:40,83,7974,36,47,5224.29,9406.00,0.00
2024-12-08 17:17:40,84,7974,37,47,5162.10,9406.01,0.00
2024-12-08 17:17:40,83,7974,37,46,5214.12,9406.06,0.00
2024-12-08 17:17:40,82,7974,36,46,5252.54,9406.27,0.00
2024-12-08 17:17:40,82,7975,36,46,5298.89,9407.00,0.00
2024-12-08 17:17:40,83,7975,36,47,5235.05,9407.01,0.00
2024-12-08 17:17:40,82,7975,35,47,5271.38,9407.05,0.00
2024-12-08 17:17:40,82,7976,35,47,5274.21,9408.00,0.00
2024-12-08 17:17:40,83,7976,36,47,5210.67,9408.01,0.00
2024-12-08 17:17:40,82,7976,36,46,5243.26,9408.05,0.00
2024-12-08 17:17:40,82,7977,36,46,5269.04,9409.00,0.00
2024-12-08 17:17:40,83,7977,37,46,5205.56,9409.01,0.00
2024-12-08 17:17:40,83,7978,37,46,5181.11,9410.00,0.00
2024-12-08 17:17:40,84,7978,37,47,5119.43,9410.01,0.00
2024-12-08 17:17:40,83,7978,37,46,5172.06,9410.06,0.00
2024-12-08 17:17:40,83,7979,37,46,5174.86,9411.00,0.00
2024-12-08 17:17:40,84,7979,38,46,5113.25,9411.01,0.00
2024-12-08 17:17:40,83,7979,37,46,5109.26,9411.47,0.00
2024-12-08 17:17:40,83,7980,37,46,5150.46,9412.00,0.00
2024-12-08 17:17:40,84,7980,38,46,5089.14,9412.01,0.00
2024-12-08 17:17:40,83,7980,38,45,5142.54,9412.06,0.00
2024-12-08 17:17:40,83,7981,38,45,5145.33,9413.00,0.00
2024-12-08 17:17:40,84,7981,38,46,5084.08,9413.01,0.00
2024-12-08 17:17:40,83,7981,37,46,5060.51,9413.58,0.00
2024-12-08 17:17:40,83,7982,37,46,5134.54,9414.00,0.00
2024-12-08 17:17:40,84,7982,38,46,5073.42,9414.01,0.00
2024-12-08 17:17:40,83,7982,38,45,5100.53,9414.08,0.00
2024-12-08 17:17:40,83,7983,38,45,5128.28,9415.00,0.00
2024-12-08 17:17:40,84,7983,39,45,5067.23,9415.01,0.00
2024-12-08 17:17:40,84,7984,39,45,5041.98,9416.00,0.00
2024-12-08 17:17:40,85,7984,40,45,4982.67,9416.01,0.00
2024-12-08 17:17:40,84,7984,39,45,5013.97,9416.07,0.00
2024-12-08 17:17:40,83,7984,39,44,5069.85,9416.07,0.00
2024-12-08 17:17:40,84,7983,39,45,4962.62,9416.60,0.00
2024-12-08 17:17:40,84,7984,39,45,5071.67,9417.00,0.00
2024-12-08 17:17:40,85,7984,40,45,5012.00,9417.01,0.00
2024-12-08 17:17:40,85,7985,40,45,5096.74,9418.00,0.00
2024-12-08 17:17:40,86,7985,41,45,5037.48,9418.01,0.00
2024-12-08 17:17:40,87,7984,41,46,4976.33,9418.07,0.00
2024-12-08 17:17:40,86,7984,41,45,5122.92,9418.08,0.00
2024-12-08 17:17:40,86,7985,41,45,5124.53,9419.00,0.00
2024-12-08 17:17:40,87,7985,42,45,5065.63,9419.01,0.00
2024-12-08 17:17:41,87,7986,42,45,5146.29,9420.00,0.00
2024-12-08 17:17:41,88,7986,43,45,5087.81,9420.01,0.00
2024-12-08 17:17:41,87,7986,43,44,5138.73,9420.07,0.00
2024-12-08 17:17:41,87,7987,43,44,5138.18,9421.00,0.00
2024-12-08 17:17:41,88,7987,44,44,5079.79,9421.01,0.00
2024-12-08 17:17:41,87,7987,43,44,5137.09,9421.01,0.00
2024-12-08 17:17:41,86,7987,42,44,5123.56,9421.41,0.00
2024-12-08 17:17:41,86,7988,42,44,5177.66,9422.00,0.00
2024-12-08 17:17:41,87,7988,42,45,5118.15,9422.01,0.00
2024-12-08 17:17:41,86,7988,42,44,5172.20,9422.06,0.00
2024-12-08 17:17:41,86,7989,42,44,5171.63,9423.00,0.00
2024-12-08 17:17:41,87,7989,42,45,5112.19,9423.01,0.00
2024-12-08 17:17:41,88,7988,42,46,5050.90,9423.07,0.00
2024-12-08 17:17:41,87,7988,41,46,5146.85,9423.23,0.00
2024-12-08 17:17:41,87,7989,41,46,5183.08,9424.00,0.00
2024-12-08 17:17:41,88,7989,42,46,5124.18,9424.01,0.00
2024-12-08 17:17:41,87,7989,42,45,5176.61,9424.06,0.00
2024-12-08 17:17:41,87,7990,42,45,5280.90,9425.00,0.00
2024-12-08 17:17:41,88,7990,43,45,5220.89,9425.01,0.00
2024-12-08 17:17:41,87,7990,42,45,5207.55,9425.25,0.00
2024-12-08 17:17:41,87,7991,42,45,5245.94,9426.00,0.00
2024-12-08 17:17:41,88,7991,42,46,5186.33,9426.01,0.00
2024-12-08 17:17:41,87,7991,42,45,5227.23,9426.06,0.00
2024-12-08 17:17:41,86,7991,41,45,5268.15,9426.24,0.00
2024-12-08 17:17:41,85,7991,40,45,5310.26,9426.46,0.00
2024-12-08 17:17:41,85,7992,40,45,5345.60,9427.00,0.00
2024-12-08 17:17:41,86,7992,40,46,5283.44,9427.01,0.00
2024-12-08 17:17:41,85,7992,40,45,5292.40,9427.06,0.00
2024-12-08 17:17:41,84,7992,39,45,5336.90,9427.24,0.00
2024-12-08 17:17:41,84,7993,39,45,5344.41,9428.00,0.00
2024-12-08 17:17:41,85,7993,39,46,5281.54,9428.01,0.00
2024-12-08 17:17:41,84,7993,38,46,5299.91,9428.07,0.00
2024-12-08 17:17:41,83,7993,37,46,5322.65,9428.25,0.00
2024-12-08 17:17:41,83,7994,37,46,5344.03,9429.00,0.00
2024-12-08 17:17:41,84,7994,38,46,5280.41,9429.01,0.00
2024-12-08 17:17:41,83,7994,38,45,5322.48,9429.04,0.00
2024-12-08 17:17:41,82,7994,38,44,5383.95,9429.06,0.00
2024-12-08 17:17:41,81,7994,37,44,5354.08,9429.65,0.00
2024-12-08 17:17:41,81,7995,37,44,5405.19,9430.00,0.00
2024-12-08 17:17:41,82,7995,37,45,5339.27,9430.01,0.00
2024-12-08 17:17:41,81,7995,37,44,5398.22,9430.06,0.00
2024-12-08 17:17:41,80,7995,37,43,5334.31,9430.85,0.00
2024-12-08 17:17:41,80,7996,37,43,5438.18,9431.00,0.00
2024-12-08 17:17:41,81,7996,38,43,5371.04,9431.01,0.00
2024-12-08 17:17:41,80,7996,37,43,5437.00,9431.01,0.00
2024-12-08 17:17:41,80,7997,37,43,5415.17,9432.00,0.00
2024-12-08 17:17:41,81,7997,38,43,5348.32,9432.01,0.00
2024-12-08 17:17:41,80,7997,38,42,5410.48,9432.05,0.00
2024-12-08 17:17:41,79,7997,37,42,5440.92,9432.46,0.00
2024-12-08 17:17:41,79,7998,37,42,5485.50,9433.00,0.00
2024-12-08 17:17:41,80,7998,38,42,5416.93,9433.01,0.00
2024-12-08 17:17:41,80,7999,38,42,5393.44,9434.00,0.00
2024-12-08 17:17:41,81,7999,39,42,5326.85,9434.01,0.00
2024-12-08 17:17:41,80,7999,39,41,5388.74,9434.05,0.00
2024-12-08 17:17:41,80,8000,39,41,5390.48,9435.00,0.00
2024-12-08 17:17:41,81,8000,39,42,5323.93,9435.01,0.00
2024-12-08 17:17:41,80,8000,39,41,5362.19,9435.05,0.00
2024-12-08 17:17:41,79,8000,38,41,5398.17,9435.17,0.00
2024-12-08 17:17:41,79,8001,38,41,5439.30,9436.00,0.00
2024-12-08 17:17:41,80,8001,39,41,5371.31,9436.01,0.00
2024-12-08 17:17:41,79,8001,39,40,5429.90,9436.06,0.00
2024-12-08 17:17:41,79,8002,39,40,5437.62,9437.00,0.00
2024-12-08 17:17:41,80,8002,39,41,5369.65,9437.01,0.00
2024-12-08 17:17:42,80,8003,39,41,5342.67,9438.00,0.00
2024-12-08 17:17:42,81,8003,39,42,5276.71,9438.01,0.00
2024-12-08 17:17:42,80,8003,39,41,5336.79,9438.06,0.00
2024-12-08 17:17:42,79,8003,38,41,5401.95,9438.06,0.00
2024-12-08 17:17:42,79,8004,38,41,5429.22,9439.00,0.00
2024-12-08 17:17:42,80,8004,38,42,5361.35,9439.01,0.00
2024-12-08 17:17:42,80,8005,38,42,5336.31,9440.00,0.00
2024-12-08 17:17:42,81,8005,38,43,5270.43,9440.01,0.00
2024-12-08 17:17:42,80,8005,38,42,5329.25,9440.06,0.00
2024-12-08 17:17:42,80,8006,38,42,5326.95,9441.00,0.00
2024-12-08 17:17:42,81,8006,38,43,5261.18,9441.01,0.00
2024-12-08 17:17:42,80,8006,37,43,5321.06,9441.06,0.00
2024-12-08 17:17:42,80,8007,37,43,5286.50,9442.00,0.00
2024-12-08 17:17:42,81,8007,37,44,5221.23,9442.01,0.00
2024-12-08 17:17:42,80,8007,37,43,5280.61,9442.06,0.00
2024-12-08 17:17:42,80,8008,37,43,5267.82,9443.00,0.00
2024-12-08 17:17:42,81,8008,37,44,5202.78,9443.01,0.00
2024-12-08 17:17:42,80,8008,36,44,5190.07,9443.41,0.00
2024-12-08 17:17:42,80,8009,36,44,5232.20,9444.00,0.00
2024-12-08 17:17:42,81,8009,36,45,5167.60,9444.01,0.00
2024-12-08 17:17:42,81,8010,36,45,5131.70,9445.00,0.00
2024-12-08 17:17:42,82,8010,37,45,5069.12,9445.01,0.00
2024-12-08 17:17:42,81,8010,37,44,5121.22,9445.06,0.00
2024-12-08 17:17:42,81,8011,37,44,5119.73,9446.00,0.00
2024-12-08 17:17:42,82,8011,37,45,5057.29,9446.01,0.00
2024-12-08 17:17:42,82,8012,37,45,5026.93,9447.00,0.00
2024-12-08 17:17:42,83,8012,37,46,4966.36,9447.01,0.00
2024-12-08 17:17:42,82,8012,36,46,5023.48,9447.04,0.00
2024-12-08 17:17:42,81,8012,36,45,5076.18,9447.07,0.00
2024-12-08 17:17:42,80,8012,35,45,5040.40,9447.88,0.00
2024-12-08 17:17:42,80,8013,35,45,5146.80,9448.00,0.00
2024-12-08 17:17:42,81,8013,36,45,5083.25,9448.01,0.00
2024-12-08 17:17:42,80,8013,35,45,5044.33,9448.68,0.00
2024-12-08 17:17:42,80,8014,35,45,5131.99,9449.00,0.00
2024-12-08 17:17:42,81,8014,35,46,5068.63,9449.01,0.00
2024-12-08 17:17:42,80,8014,35,45,5121.37,9449.08,0.00
2024-12-08 17:17:42,81,8013,35,46,5044.20,9449.25,0.00
2024-12-08 17:17:42,81,8014,35,46,5138.00,9450.00,0.00
2024-12-08 17:17:42,82,8014,36,46,5075.34,9450.01,0.00
2024-12-08 17:17:42,82,8015,36,46,5166.93,9451.00,0.00
2024-12-08 17:17:42,83,8015,37,46,5104.68,9451.01,0.00
2024-12-08 17:17:42,82,8015,37,45,5155.42,9451.09,0.00
2024-12-08 17:17:42,82,8016,37,45,5161.71,9452.00,0.00
2024-12-08 17:17:42,83,8016,38,45,5099.52,9452.01,0.00
2024-12-08 17:17:42,83,8017,38,45,5075.00,9453.00,0.00
2024-12-08 17:17:42,84,8017,39,45,5014.59,9453.01,0.00
2024-12-08 17:17:42,83,8017,39,44,5064.77,9453.08,0.00
2024-12-08 17:17:42,83,8018,39,44,5066.67,9454.00,0.00
2024-12-08 17:17:42,84,8018,39,45,5006.36,9454.01,0.00
2024-12-08 17:17:42,84,8019,39,45,4975.26,9455.00,0.00
2024-12-08 17:17:42,85,8019,39,46,4916.73,9455.01,0.00
2024-12-08 17:17:42,84,8019,39,45,4964.02,9455.10,0.00
2024-12-08 17:17:43,84,8020,39,45,4967.15,9456.00,0.00
2024-12-08 17:17:43,85,8020,39,46,4908.72,9456.01,0.00
2024-12-08 17:17:43,84,8020,38,46,4963.79,9456.04,0.00
2024-12-08 17:17:43,84,8021,38,46,4940.66,9457.00,0.00
2024-12-08 17:17:43,85,8021,39,46,4882.53,9457.01,0.00
2024-12-08 17:17:43,84,8021,39,45,4931.67,9457.08,0.00
2024-12-08 17:17:43,84,8022,39,45,4935.55,9458.00,0.00
2024-12-08 17:17:43,85,8022,40,45,4877.49,9458.01,0.00
2024-12-08 17:17:43,85,8023,40,45,4851.29,9459.00,0.00
2024-12-08 17:17:43,86,8023,40,46,4794.88,9459.01,0.00
2024-12-08 17:17:43,85,8023,39,46,4843.52,9459.08,0.00
2024-12-08 17:17:43,84,8023,39,45,4897.81,9459.08,0.00
2024-12-08 17:17:43,84,8024,39,45,4901.68,9460.00,0.00
2024-12-08 17:17:43,85,8024,40,45,4844.02,9460.01,0.00
2024-12-08 17:17:43,84,8024,39,45,4853.34,9460.29,0.00
2024-12-08 17:17:43,84,8025,39,45,4876.30,9461.00,0.00
2024-12-08 17:17:43,85,8025,40,45,4818.93,9461.01,0.00
2024-12-08 17:17:43,84,8025,40,44,4867.30,9461.08,0.00
2024-12-08 17:17:43,84,8026,40,44,4871.18,9462.00,0.00
2024-12-08 17:17:43,85,8026,40,45,4813.87,9462.01,0.00
2024-12-08 17:17:43,84,8026,39,45,4822.82,9462.29,0.00
2024-12-08 17:17:43,84,8027,39,45,4845.78,9463.00,0.00
2024-12-08 17:17:43,85,8027,39,46,4788.77,9463.01,0.00
2024-12-08 17:17:43,84,8027,39,45,4837.91,9463.08,0.00
2024-12-08 17:17:43,84,8028,39,45,4841.79,9464.00,0.00
2024-12-08 17:17:43,85,8028,39,46,4784.83,9464.01,0.00
2024-12-08 17:17:43,84,8028,38,46,4738.49,9464.81,0.00
2024-12-08 17:17:43,84,8029,38,46,4833.29,9465.00,0.00
2024-12-08 17:17:43,85,8029,38,47,4776.43,9465.01,0.00
2024-12-08 17:17:43,84,8029,38,46,4823.17,9465.10,0.00
2024-12-08 17:17:43,84,8030,38,46,4824.89,9466.00,0.00
2024-12-08 17:17:43,85,8030,39,46,4768.13,9466.01,0.00
2024-12-08 17:17:43,85,8031,39,46,4735.18,9467.00,0.00
2024-12-08 17:17:43,86,8031,40,46,4680.12,9467.01,0.00
2024-12-08 17:17:43,85,8031,39,46,4731.84,9467.04,0.00
2024-12-08 17:17:43,84,8031,39,45,4778.05,9467.11,0.00
2024-12-08 17:17:43,84,8032,39,45,4777.38,9468.00,0.00
2024-12-08 17:17:43,85,8032,40,45,4721.18,9468.01,0.00
2024-12-08 17:17:43,85,8033,40,45,4691.29,9469.00,0.00
2024-12-08 17:17:43,86,8033,40,46,4636.74,9469.01,0.00
2024-12-08 17:17:43,85,8033,39,46,4687.96,9469.04,0.00
2024-12-08 17:17:43,84,8033,39,45,4737.02,9469.10,0.00
2024-12-08 17:17:43,84,8034,39,45,4742.00,9470.00,0.00
2024-12-08 17:17:43,85,8034,40,45,4686.22,9470.01,0.00
2024-12-08 17:17:43,84,8034,40,44,4710.46,9470.10,0.00
2024-12-08 17:17:43,84,8035,40,44,4715.44,9471.00,0.00
2024-12-08 17:17:43,85,8035,40,45,4659.97,9471.01,0.00
2024-12-08 17:17:43,85,8036,40,45,4632.96,9472.00,0.00
2024-12-08 17:17:43,86,8036,41,45,4579.09,9472.01,0.00
2024-12-08 17:17:43,85,8036,40,45,4631.84,9472.01,0.00
2024-12-08 17:17:43,84,8036,40,44,4676.87,9472.11,0.00
2024-12-08 17:17:43,84,8037,40,44,4680.78,9473.00,0.00
2024-12-08 17:17:43,85,8037,40,45,4625.72,9473.01,0.00
2024-12-08 17:17:43,84,8037,40,44,4648.11,9473.11,0.00
2024-12-08 17:17:43,84,8038,40,44,4651.17,9474.00,0.00
2024-12-08 17:17:43,85,8038,40,45,4596.45,9474.01,0.00
2024-12-08 17:17:43,84,8038,40,44,4618.49,9474.11,0.00
2024-12-08 17:17:43,83,8038,39,44,4593.16,9474.84,0.00
2024-12-08 17:17:44,83,8039,39,44,4692.61,9475.00,0.00
2024-12-08 17:17:44,84,8039,40,44,4636.74,9475.01,0.00
2024-12-08 17:17:44,83,8039,39,44,4648.10,9475.07,0.00
2024-12-08 17:17:44,82,8039,38,44,4682.89,9475.29,0.00
2024-12-08 17:17:44,82,8040,38,44,4728.84,9476.00,0.00
2024-12-08 17:17:44,83,8040,38,45,4671.86,9476.01,0.00
2024-12-08 17:17:44,82,8040,38,44,4725.38,9476.04,0.00
2024-12-08 17:17:44,81,8040,38,43,4759.15,9476.04,0.00
2024-12-08 17:17:44,81,8041,38,43,4760.36,9477.00,0.00
2024-12-08 17:17:44,82,8041,38,44,4702.30,9477.01,0.00
2024-12-08 17:17:44,81,8041,38,43,4732.30,9477.07,0.00
2024-12-08 17:17:44,80,8041,37,43,4790.26,9477.08,0.00
2024-12-08 17:17:44,79,8041,36,43,4844.91,9477.09,0.00
2024-12-08 17:17:44,79,8042,36,43,4878.44,9478.00,0.00
2024-12-08 17:17:44,80,8042,36,44,4817.46,9478.01,0.00
2024-12-08 17:17:44,79,8042,35,44,4806.52,9478.27,0.00
2024-12-08 17:17:44,79,8043,35,44,4857.36,9479.00,0.00
2024-12-08 17:17:44,80,8043,35,45,4796.64,9479.01,0.00
2024-12-08 17:17:44,79,8043,35,44,4841.79,9479.10,0.00
2024-12-08 17:17:44,78,8043,34,44,4885.64,9479.15,0.00
2024-12-08 17:17:44,77,8043,33,44,4940.50,9479.25,0.00
2024-12-08 17:17:44,77,8044,33,44,4992.67,9480.00,0.00
2024-12-08 17:17:44,78,8044,33,45,4928.66,9480.01,0.00
2024-12-08 17:17:44,77,8044,32,45,4949.60,9480.12,0.00
2024-12-08 17:17:44,77,8045,32,45,4989.18,9481.00,0.00
2024-12-08 17:17:44,78,8045,32,46,4925.22,9481.01,0.00
2024-12-08 17:17:44,77,8045,32,45,4974.43,9481.10,0.00
2024-12-08 17:17:44,77,8046,32,45,4988.19,9482.00,0.00
2024-12-08 17:17:44,78,8046,32,46,4924.24,9482.01,0.00
2024-12-08 17:17:44,77,8046,31,46,4938.96,9482.14,0.00
2024-12-08 17:17:44,77,8047,31,46,4981.33,9483.00,0.00
2024-12-08 17:17:44,78,8047,31,47,4917.46,9483.01,0.00
2024-12-08 17:17:44,79,8046,32,47,4855.22,9483.04,0.00
2024-12-08 17:17:44,78,8046,32,46,4975.85,9483.12,0.00
2024-12-08 17:17:44,79,8045,32,47,4905.68,9483.22,0.00
2024-12-08 17:17:44,79,8046,32,47,5006.99,9484.00,0.00
2024-12-08 17:17:44,80,8046,32,48,4944.40,9484.01,0.00
2024-12-08 17:17:44,80,8047,32,48,5159.52,9485.00,0.00
2024-12-08 17:17:44,81,8047,33,48,5095.83,9485.01,0.00
2024-12-08 17:17:44,81,8048,33,48,5072.94,9486.00,0.00
2024-12-08 17:17:44,82,8048,33,49,5011.08,9486.01,0.00
2024-12-08 17:17:44,83,8047,33,50,4925.56,9486.06,0.00
2024-12-08 17:17:44,83,8048,33,50,4969.51,9487.00,0.00
2024-12-08 17:17:44,84,8048,34,50,4910.35,9487.01,0.00
2024-12-08 17:17:44,83,8048,33,50,4932.45,9487.16,0.00
2024-12-08 17:17:44,83,8049,33,50,5058.69,9488.00,0.00
2024-12-08 17:17:44,84,8049,33,51,4998.46,9488.01,0.00
2024-12-08 17:17:44,83,8049,33,50,5040.40,9488.01,0.00
2024-12-08 17:17:44,83,8050,33,50,5038.64,9489.00,0.00
2024-12-08 17:17:44,84,8050,33,51,4978.66,9489.01,0.00
2024-12-08 17:17:44,84,8051,33,51,4953.20,9490.00,0.00
2024-12-08 17:17:44,85,8051,34,51,4894.93,9490.01,0.00
2024-12-08 17:17:44,84,8051,34,50,4944.18,9490.10,0.00
2024-12-08 17:17:44,83,8051,33,50,4987.75,9490.15,0.00
2024-12-08 17:17:44,83,8052,33,50,5021.41,9491.00,0.00
2024-12-08 17:17:44,84,8052,34,50,4961.63,9491.01,0.00
2024-12-08 17:17:44,83,8052,34,49,5020.26,9491.01,0.00
2024-12-08 17:17:44,82,8052,33,49,5079.18,9491.02,0.00
2024-12-08 17:17:44,81,8052,32,49,5140.72,9491.02,0.00
2024-12-08 17:17:44,80,8052,31,49,5162.42,9491.48,0.00
2024-12-08 17:17:44,80,8053,31,49,5207.89,9492.00,0.00
2024-12-08 17:17:44,81,8053,32,49,5143.59,9492.01,0.00
2024-12-08 17:17:44,80,8053,31,49,5201.97,9492.06,0.00
2024-12-08 17:17:44,79,8053,30,49,5227.02,9492.24,0.00
2024-12-08 17:17:45,79,8054,30,49,5251.53,9493.00,0.00
2024-12-08 17:17:45,80,8054,30,50,5185.89,9493.01,0.00
2024-12-08 17:17:45,79,8054,30,49,5245.54,9493.06,0.00
2024-12-08 17:17:45,78,8054,29,49,5297.02,9493.23,0.00
2024-12-08 17:17:45,79,8053,29,50,5170.26,9493.89,0.00
2024-12-08 17:17:45,79,8054,29,50,5265.31,9494.00,0.00
2024-12-08 17:17:45,80,8054,29,51,5199.49,9494.01,0.00
2024-12-08 17:17:45,80,8055,29,51,5296.17,9495.00,0.00
2024-12-08 17:17:45,81,8055,29,52,5230.79,9495.01,0.00
2024-12-08 17:17:45,80,8055,29,51,5278.40,9495.10,0.00
2024-12-08 17:17:45,80,8056,29,51,5288.42,9496.00,0.00
2024-12-08 17:17:45,81,8056,30,51,5223.13,9496.01,0.00
2024-12-08 17:17:45,80,8056,29,51,5243.35,9496.13,0.00
2024-12-08 17:17:45,80,8057,29,51,5279.48,9497.00,0.00
2024-12-08 17:17:45,81,8057,30,51,5214.30,9497.01,0.00
2024-12-08 17:17:45,80,8057,30,50,5262.89,9497.10,0.00
2024-12-08 17:17:45,80,8058,30,50,5272.92,9498.00,0.00
2024-12-08 17:17:45,81,8058,30,51,5207.82,9498.01,0.00
2024-12-08 17:17:45,82,8057,31,51,5144.31,9498.04,0.00
2024-12-08 17:17:45,81,8057,30,51,5219.56,9498.04,0.00
2024-12-08 17:17:45,81,8058,30,51,5197.50,9499.00,0.00
2024-12-08 17:17:45,82,8058,31,51,5134.11,9499.01,0.00
2024-12-08 17:17:45,81,8058,30,51,5129.35,9499.46,0.00
2024-12-08 17:17:45,81,8059,30,51,5289.24,9500.00,0.00
2024-12-08 17:17:45,82,8059,30,52,5224.73,9500.01,0.00
2024-12-08 17:17:45,82,8060,30,52,5197.30,9501.00,0.00
2024-12-08 17:17:45,83,8060,30,53,5134.68,9501.01,0.00
2024-12-08 17:17:45,82,8060,29,53,5164.23,9501.07,0.00
2024-12-08 17:17:45,82,8061,29,53,5169.40,9502.00,0.00
2024-12-08 17:17:45,83,8061,29,54,5107.12,9502.01,0.00
2024-12-08 17:17:45,82,8061,28,54,5143.91,9502.02,0.00
2024-12-08 17:17:45,81,8061,27,54,5202.97,9502.04,0.00
2024-12-08 17:17:45,80,8061,26,54,5230.14,9502.44,0.00
2024-12-08 17:17:45,80,8062,26,54,5272.13,9503.00,0.00
2024-12-08 17:17:45,81,8062,26,55,5207.04,9503.01,0.00
2024-12-08 17:17:45,80,8062,26,54,5253.12,9503.01,0.00
2024-12-08 17:17:45,80,8062,26,54,5254.86,9504.00,0.00
2024-12-08 17:17:45,81,8062,27,54,5189.99,9504.01,0.00
2024-12-08 17:17:45,80,8062,26,54,5123.50,9504.95,0.00
2024-12-08 17:17:45,80,8063,26,54,5237.59,9505.00,0.00
2024-12-08 17:17:45,81,8063,26,55,5172.93,9505.01,0.00
2024-12-08 17:17:45,81,8064,26,55,5150.00,9506.00,0.00
2024-12-08 17:17:45,82,8064,27,55,5087.20,9506.01,0.00
2024-12-08 17:17:45,81,8064,26,55,5123.02,9506.05,0.00
2024-12-08 17:17:45,80,8064,26,54,5185.87,9506.05,0.00
2024-12-08 17:17:46,80,8065,26,54,5191.16,9507.00,0.00
2024-12-08 17:17:46,81,8065,27,54,5127.07,9507.01,0.00
2024-12-08 17:17:46,80,8065,27,53,5169.77,9507.03,0.00
2024-12-08 17:17:46,80,8066,27,53,5172.69,9508.00,0.00
2024-12-08 17:17:46,81,8066,27,54,5108.83,9508.01,0.00
2024-12-08 17:17:46,80,8066,26,54,5171.50,9508.01,0.00
2024-12-08 17:17:46,79,8066,26,53,5211.69,9508.03,0.00
2024-12-08 17:17:46,79,8067,26,53,5215.85,9509.00,0.00
2024-12-08 17:17:46,80,8067,27,53,5150.65,9509.01,0.00
2024-12-08 17:17:46,79,8067,27,52,5190.57,9509.03,0.00
2024-12-08 17:17:46,78,8067,26,52,5255.90,9509.03,0.00
2024-12-08 17:17:46,77,8067,25,52,5299.52,9509.25,0.00
2024-12-08 17:17:46,77,8068,25,52,5351.89,9510.00,0.00
2024-12-08 17:17:46,78,8068,25,53,5283.27,9510.01,0.00
2024-12-08 17:17:46,77,8068,25,52,5324.72,9510.03,0.00
2024-12-08 17:17:46,77,8069,25,52,5331.45,9511.00,0.00
2024-12-08 17:17:46,78,8069,25,53,5263.10,9511.01,0.00
2024-12-08 17:17:46,78,8070,25,53,5242.92,9512.00,0.00
2024-12-08 17:17:46,79,8070,25,54,5176.56,9512.01,0.00
2024-12-08 17:17:46,78,8070,25,53,5234.39,9512.05,0.00
2024-12-08 17:17:46,78,8071,25,53,5241.59,9513.00,0.00
2024-12-08 17:17:46,79,8071,26,53,5175.24,9513.01,0.00
2024-12-08 17:17:46,80,8070,26,54,5027.16,9513.65,0.00
2024-12-08 17:17:46,80,8071,26,54,5120.19,9514.00,0.00
2024-12-08 17:17:46,81,8071,27,54,5056.98,9514.01,0.00
2024-12-08 17:17:46,80,8071,26,54,5119.01,9514.03,0.00
2024-12-08 17:17:46,79,8071,25,54,5182.60,9514.03,0.00
2024-12-08 17:17:46,78,8071,25,53,5244.16,9514.03,0.00
2024-12-08 17:17:46,78,8072,25,53,5368.98,9515.00,0.00
2024-12-08 17:17:46,79,8072,26,53,5301.02,9515.01,0.00
2024-12-08 17:17:46,78,8072,26,52,5358.00,9515.01,0.00
2024-12-08 17:17:46,78,8073,26,52,5358.93,9516.00,0.00
2024-12-08 17:17:46,79,8073,27,52,5291.10,9516.01,0.00
2024-12-08 17:17:46,79,8074,27,52,5265.80,9517.00,0.00
2024-12-08 17:17:46,80,8074,27,53,5199.98,9517.01,0.00
2024-12-08 17:17:46,79,8074,27,52,5263.39,9517.01,0.00
2024-12-08 17:17:46,80,8073,27,53,5121.57,9517.78,0.00
2024-12-08 17:17:46,80,8074,27,53,5240.74,9518.00,0.00
2024-12-08 17:17:46,81,8074,28,53,5176.03,9518.01,0.00
2024-12-08 17:17:46,80,8074,27,53,5122.24,9518.73,0.00
2024-12-08 17:17:46,80,8075,27,53,5334.25,9519.00,0.00
2024-12-08 17:17:46,81,8075,28,53,5268.40,9519.01,0.00
2024-12-08 17:17:46,80,8075,28,52,5333.06,9519.01,0.00
2024-12-08 17:17:46,81,8074,28,53,5192.79,9519.79,0.00
2024-12-08 17:17:47,81,8075,28,53,5284.64,9520.00,0.00
2024-12-08 17:17:47,82,8075,28,54,5220.19,9520.01,0.00
2024-12-08 17:17:47,81,8075,28,53,5259.96,9520.01,0.00
