Timestamp,NAnimals,NResources,NFemales,NMales,MeanLifeSuccess,MeanAge,%MatingAccept
2024-12-10 17:35:19,100,0,51,49,0.00,0.00,0.00
2024-12-10 17:35:19,100,0,51,49,0.00,0.00,0.00
2024-12-10 17:35:19,100,1,51,49,0.73,1.00,0.00
2024-12-10 17:35:19,101,1,52,49,0.73,1.01,0.00
2024-12-10 17:35:19,100,1,51,49,0.73,1.01,1.00
2024-12-10 17:35:19,99,1,51,48,0.74,1.06,1.00
2024-12-10 17:35:19,98,1,51,47,0.74,1.06,1.00
2024-12-10 17:35:19,97,1,50,47,0.76,1.08,1.00
2024-12-10 17:35:19,96,1,50,46,0.76,1.09,1.00
2024-12-10 17:35:19,95,1,49,46,0.77,1.09,1.00
2024-12-10 17:35:19,94,1,48,46,0.78,1.12,1.00
2024-12-10 17:35:19,93,1,48,45,0.79,1.13,1.00
2024-12-10 17:35:19,92,1,48,44,0.80,1.13,1.00
2024-12-10 17:35:19,91,1,48,43,0.88,1.25,1.00
2024-12-10 17:35:19,90,1,48,42,0.88,1.26,1.00
2024-12-10 17:35:19,89,1,47,42,0.91,1.28,1.00
2024-12-10 17:35:19,88,1,46,42,0.92,1.28,1.00
2024-12-10 17:35:19,87,1,45,42,0.98,1.38,1.00
2024-12-10 17:35:19,86,1,44,42,1.00,1.41,1.00
2024-12-10 17:35:19,85,1,43,42,1.01,1.41,1.00
2024-12-10 17:35:19,84,1,43,41,1.03,1.43,1.00
2024-12-10 17:35:19,83,1,43,40,1.07,1.48,1.00
2024-12-10 17:35:19,82,1,43,39,1.08,1.50,1.00
2024-12-10 17:35:19,81,1,42,39,1.10,1.52,1.00
2024-12-10 17:35:19,80,1,42,38,1.13,1.58,1.00
2024-12-10 17:35:19,79,1,42,37,1.18,1.67,1.00
2024-12-10 17:35:19,78,1,42,36,1.21,1.72,1.00
2024-12-10 17:35:19,77,1,42,35,1.24,1.77,1.00
2024-12-10 17:35:19,76,1,41,35,1.27,1.82,1.00
2024-12-10 17:35:20,76,2,41,35,1.35,2.00,1.00
2024-12-10 17:35:20,77,2,42,35,1.33,2.01,1.00
2024-12-10 17:35:20,76,2,41,35,1.35,2.03,1.00
2024-12-10 17:35:20,75,2,40,35,1.35,2.05,1.00
2024-12-10 17:35:20,74,2,40,34,1.40,2.08,1.00
2024-12-10 17:35:20,73,2,39,34,1.43,2.14,1.00
2024-12-10 17:35:20,72,2,38,34,1.47,2.17,1.00
2024-12-10 17:35:20,71,2,38,33,1.63,2.38,1.00
2024-12-10 17:35:20,70,2,37,33,1.69,2.46,1.00
2024-12-10 17:35:20,69,2,36,33,1.74,2.51,1.00
2024-12-10 17:35:20,68,2,35,33,1.78,2.56,1.00
2024-12-10 17:35:20,67,2,34,33,1.80,2.57,1.00
2024-12-10 17:35:20,66,2,33,33,1.82,2.58,1.00
2024-12-10 17:35:20,65,2,32,33,1.92,2.66,1.00
2024-12-10 17:35:20,64,2,31,33,1.96,2.75,1.00
2024-12-10 17:35:20,63,2,31,32,2.01,2.78,1.00
2024-12-10 17:35:20,62,2,30,32,2.10,2.87,1.00
2024-12-10 17:35:20,61,2,29,32,2.14,2.90,1.00
2024-12-10 17:35:20,60,2,28,32,2.17,2.92,1.00
2024-12-10 17:35:20,60,3,28,32,2.20,3.00,1.00
2024-12-10 17:35:20,61,3,28,33,2.16,3.02,1.00
2024-12-10 17:35:20,60,3,28,32,2.19,3.03,1.00
2024-12-10 17:35:20,59,3,27,32,2.26,3.08,1.00
2024-12-10 17:35:20,58,3,26,32,2.34,3.19,1.00
2024-12-10 17:35:20,57,3,25,32,2.68,3.75,1.00
2024-12-10 17:35:20,56,3,24,32,2.84,3.96,1.00
2024-12-10 17:35:20,55,3,23,32,2.88,3.98,1.00
2024-12-10 17:35:20,55,4,23,32,2.93,4.00,1.00
2024-12-10 17:35:20,56,4,24,32,2.87,4.02,1.00
2024-12-10 17:35:20,55,4,24,31,2.96,4.13,1.00
2024-12-10 17:35:20,54,4,24,30,3.15,4.43,1.00
2024-12-10 17:35:20,53,4,24,29,3.29,4.55,1.00
2024-12-10 17:35:20,52,4,24,28,3.46,4.73,1.00
2024-12-10 17:35:20,51,4,24,27,3.64,4.96,1.00
2024-12-10 17:35:20,51,5,24,27,3.69,5.00,1.00
2024-12-10 17:35:20,52,5,24,28,3.62,5.02,1.00
2024-12-10 17:35:20,51,5,24,27,3.82,5.31,1.00
2024-12-10 17:35:20,50,5,24,26,3.93,5.38,1.00
2024-12-10 17:35:20,49,5,24,25,4.01,5.39,1.00
2024-12-10 17:35:20,48,5,24,24,4.19,5.54,1.00
2024-12-10 17:35:20,47,5,24,23,4.48,5.83,1.00
2024-12-10 17:35:20,46,5,23,23,4.65,5.96,1.00
2024-12-10 17:35:20,46,6,23,23,4.76,6.00,1.00
2024-12-10 17:35:20,47,6,24,23,4.66,6.02,1.00
2024-12-10 17:35:20,46,6,24,22,4.74,6.04,1.00
2024-12-10 17:35:20,46,7,24,22,5.41,7.00,1.00
2024-12-10 17:35:20,47,7,25,22,5.30,7.02,1.00
2024-12-10 17:35:20,46,7,25,21,5.47,7.22,1.00
2024-12-10 17:35:20,46,8,25,21,6.05,8.00,1.00
2024-12-10 17:35:20,47,8,25,22,5.92,8.02,0.00
2024-12-10 17:35:20,46,8,24,22,6.03,8.11,0.00
2024-12-10 17:35:20,46,9,24,22,6.70,9.00,0.00
2024-12-10 17:35:20,47,9,25,22,6.56,9.02,0.00
2024-12-10 17:35:20,46,9,24,22,6.68,9.02,0.00
2024-12-10 17:35:20,45,9,24,21,6.90,9.20,0.00
2024-12-10 17:35:20,44,9,24,20,7.25,9.66,0.00
2024-12-10 17:35:20,44,10,24,20,7.69,10.00,0.00
2024-12-10 17:35:20,45,10,24,21,7.52,10.02,0.00
2024-12-10 17:35:20,45,11,24,21,8.19,11.00,0.00
2024-12-10 17:35:20,46,11,24,22,8.01,11.02,0.00
2024-12-10 17:35:20,46,12,24,22,8.65,12.00,0.00
2024-12-10 17:35:20,47,12,25,22,8.46,12.02,0.00
2024-12-10 17:35:20,46,12,25,21,8.77,12.28,0.00
2024-12-10 17:35:20,46,13,25,21,9.34,13.00,0.00
2024-12-10 17:35:20,47,13,25,22,9.15,13.02,0.00
2024-12-10 17:35:20,46,13,25,21,9.46,13.33,0.00
2024-12-10 17:35:20,46,14,25,21,10.05,14.00,0.00
2024-12-10 17:35:20,47,14,25,22,9.83,14.02,0.00
2024-12-10 17:35:20,46,14,24,22,10.24,14.50,0.00
2024-12-10 17:35:20,46,15,24,22,10.70,15.00,0.00
2024-12-10 17:35:20,47,15,24,23,10.47,15.02,0.00
2024-12-10 17:35:20,47,16,24,23,11.02,16.00,0.00
2024-12-10 17:35:20,48,16,24,24,10.79,16.02,0.00
2024-12-10 17:35:20,47,16,23,24,11.12,16.68,0.00
2024-12-10 17:35:20,47,17,23,24,11.62,17.00,0.00
2024-12-10 17:35:20,48,17,23,25,11.38,17.02,0.00
2024-12-10 17:35:20,47,17,22,25,11.65,17.53,0.00
2024-12-10 17:35:20,46,17,21,25,11.91,17.63,0.00
2024-12-10 17:35:20,46,18,21,25,12.49,18.00,0.00
2024-12-10 17:35:20,47,18,22,25,12.22,18.02,0.00
2024-12-10 17:35:20,47,19,22,25,12.85,19.00,0.00
2024-12-10 17:35:21,48,19,23,25,12.59,19.02,0.00
2024-12-10 17:35:21,47,19,23,24,12.96,19.23,0.00
2024-12-10 17:35:21,46,19,23,23,13.26,19.28,0.00
2024-12-10 17:35:21,46,20,23,23,13.73,20.00,0.00
2024-12-10 17:35:21,47,20,23,24,13.44,20.02,0.00
2024-12-10 17:35:21,46,20,23,23,13.82,20.37,0.00
2024-12-10 17:35:21,46,21,23,23,14.31,21.00,0.00
2024-12-10 17:35:21,47,21,24,23,14.01,21.02,0.00
2024-12-10 17:35:21,47,22,24,23,14.70,22.00,0.00
2024-12-10 17:35:21,48,22,24,24,14.39,22.02,0.00
2024-12-10 17:35:21,47,22,23,24,14.83,22.40,0.00
2024-12-10 17:35:21,47,23,23,24,15.35,23.00,0.00
2024-12-10 17:35:21,48,23,23,25,15.03,23.02,0.00
2024-12-10 17:35:21,48,24,23,25,15.59,24.00,0.00
2024-12-10 17:35:21,49,24,24,25,15.27,24.02,0.00
2024-12-10 17:35:21,48,24,23,25,15.73,24.35,0.00
2024-12-10 17:35:21,47,24,23,24,16.04,24.57,0.00
2024-12-10 17:35:21,46,24,22,24,16.35,24.96,0.00
2024-12-10 17:35:21,46,25,22,24,16.90,25.00,0.00
2024-12-10 17:35:21,47,25,23,24,16.54,25.02,0.00
2024-12-10 17:35:21,47,26,23,24,17.28,26.00,0.00
2024-12-10 17:35:21,48,26,23,25,16.92,26.02,0.00
2024-12-10 17:35:21,47,26,22,25,17.28,26.02,0.00
2024-12-10 17:35:21,46,26,21,25,17.78,26.74,0.00
2024-12-10 17:35:21,46,27,21,25,18.36,27.00,0.00
2024-12-10 17:35:21,47,27,21,26,17.97,27.02,0.00
2024-12-10 17:35:21,47,28,21,26,18.59,28.00,0.00
2024-12-10 17:35:21,48,28,22,26,18.20,28.02,0.00
2024-12-10 17:35:21,47,28,22,25,18.67,28.57,0.00
2024-12-10 17:35:21,46,28,21,25,19.05,28.96,0.00
2024-12-10 17:35:21,46,29,21,25,19.69,29.00,0.00
2024-12-10 17:35:21,47,29,21,26,19.27,29.02,0.00
2024-12-10 17:35:21,47,30,21,26,20.07,30.00,0.00
2024-12-10 17:35:21,48,30,21,27,19.65,30.02,0.00
2024-12-10 17:35:21,47,30,20,27,20.22,30.51,0.00
2024-12-10 17:35:21,47,31,20,27,20.78,31.00,0.00
2024-12-10 17:35:21,48,31,21,27,20.34,31.02,0.00
2024-12-10 17:35:21,47,31,20,27,20.80,31.62,0.00
2024-12-10 17:35:21,47,32,20,27,21.66,32.00,0.00
2024-12-10 17:35:21,48,32,20,28,21.21,32.02,0.00
2024-12-10 17:35:21,47,32,20,27,21.71,32.60,0.00
2024-12-10 17:35:21,47,33,20,27,22.30,33.00,0.00
2024-12-10 17:35:21,48,33,20,28,21.84,33.02,0.00
2024-12-10 17:35:21,48,34,20,28,22.61,34.00,0.00
2024-12-10 17:35:21,49,34,20,29,22.15,34.02,0.00
2024-12-10 17:35:21,48,34,19,29,22.74,34.52,0.00
2024-12-10 17:35:21,48,35,19,29,23.26,35.00,0.00
2024-12-10 17:35:21,49,35,20,29,22.79,35.02,0.00
2024-12-10 17:35:21,48,35,19,29,23.22,35.94,0.00
2024-12-10 17:35:21,48,36,19,29,23.99,36.00,0.00
2024-12-10 17:35:21,49,36,20,29,23.50,36.02,0.00
2024-12-10 17:35:21,48,36,20,28,24.00,36.56,0.00
2024-12-10 17:35:21,48,37,20,28,24.57,37.00,0.00
2024-12-10 17:35:21,49,37,21,28,24.07,37.02,0.00
2024-12-10 17:35:21,49,38,21,28,24.81,38.00,0.00
2024-12-10 17:35:21,50,38,21,29,24.32,38.02,0.00
2024-12-10 17:35:21,50,39,21,29,24.96,39.00,0.00
2024-12-10 17:35:21,51,39,22,29,24.47,39.02,0.00
2024-12-10 17:35:21,50,39,21,29,24.80,39.66,0.00
2024-12-10 17:35:21,50,40,21,29,25.73,40.00,0.00
2024-12-10 17:35:21,51,40,21,30,25.23,40.02,0.00
2024-12-10 17:35:21,50,40,21,29,25.64,40.64,0.00
2024-12-10 17:35:21,50,41,21,29,26.27,41.00,0.00
2024-12-10 17:35:21,51,41,22,29,25.76,41.02,0.00
2024-12-10 17:35:21,51,42,22,29,26.50,42.00,0.00
2024-12-10 17:35:21,52,42,22,30,25.99,42.02,0.00
2024-12-10 17:35:21,52,43,22,30,26.64,43.00,0.00
2024-12-10 17:35:21,53,43,22,31,26.14,43.02,0.00
2024-12-10 17:35:21,52,43,21,31,26.49,43.62,0.00
2024-12-10 17:35:21,52,44,21,31,27.29,44.00,0.00
2024-12-10 17:35:21,53,44,21,32,26.78,44.02,0.00
2024-12-10 17:35:21,52,44,21,31,27.18,44.62,0.00
2024-12-10 17:35:21,52,45,21,31,27.83,45.00,0.00
2024-12-10 17:35:21,53,45,21,32,27.31,45.02,0.00
2024-12-10 17:35:21,53,46,21,32,28.00,46.00,0.00
2024-12-10 17:35:21,54,46,21,33,27.48,46.02,0.00
2024-12-10 17:35:21,54,47,21,33,28.01,47.00,0.00
2024-12-10 17:35:21,55,47,21,34,27.50,47.02,0.00
2024-12-10 17:35:21,55,48,21,34,27.93,48.00,0.00
2024-12-10 17:35:21,56,48,21,35,27.43,48.02,0.00
2024-12-10 17:35:21,55,48,21,34,27.89,48.49,0.00
2024-12-10 17:35:21,54,48,20,34,28.42,48.80,0.00
2024-12-10 17:35:21,54,49,20,34,29.39,49.00,0.00
2024-12-10 17:35:21,55,49,21,34,28.85,49.02,0.00
2024-12-10 17:35:21,54,49,21,33,29.37,49.56,0.00
2024-12-10 17:35:21,54,50,21,33,30.11,50.00,0.00
2024-12-10 17:35:21,55,50,21,34,29.57,50.02,0.00
2024-12-10 17:35:21,55,51,21,34,30.17,51.00,0.00
2024-12-10 17:35:21,56,51,22,34,29.63,51.02,0.00
2024-12-10 17:35:21,56,52,22,34,30.07,52.00,0.00
2024-12-10 17:35:21,57,52,23,34,29.54,52.02,0.00
2024-12-10 17:35:21,56,52,23,33,29.93,52.54,0.00
2024-12-10 17:35:21,56,53,23,33,30.59,53.00,0.00
2024-12-10 17:35:21,57,53,23,34,30.05,53.02,0.00
2024-12-10 17:35:21,57,54,23,34,30.73,54.00,0.00
2024-12-10 17:35:21,58,54,24,34,30.20,54.02,0.00
2024-12-10 17:35:21,58,55,24,34,30.74,55.00,0.00
2024-12-10 17:35:21,59,55,25,34,30.22,55.02,0.00
2024-12-10 17:35:21,59,56,25,34,30.60,56.00,0.00
2024-12-10 17:35:21,60,56,25,35,30.09,56.02,0.00
2024-12-10 17:35:21,59,56,25,34,30.44,56.51,0.00
2024-12-10 17:35:21,58,56,24,34,30.85,56.95,0.00
2024-12-10 17:35:21,58,57,24,34,31.83,57.00,0.00
2024-12-10 17:35:21,59,57,25,34,31.29,57.02,0.00
2024-12-10 17:35:22,59,58,25,34,31.94,58.00,0.00
2024-12-10 17:35:22,60,58,25,35,31.40,58.02,0.00
2024-12-10 17:35:22,60,59,25,35,31.92,59.00,0.00
2024-12-10 17:35:22,61,59,25,36,31.39,59.02,0.00
2024-12-10 17:35:22,61,60,25,36,31.73,60.00,0.00
2024-12-10 17:35:22,62,60,25,37,31.22,60.02,0.00
2024-12-10 17:35:22,61,60,25,36,31.54,60.51,0.00
2024-12-10 17:35:22,60,60,24,36,31.77,60.97,0.00
2024-12-10 17:35:22,60,61,24,36,32.79,61.00,0.00
2024-12-10 17:35:22,61,61,24,37,32.25,61.02,0.00
2024-12-10 17:35:22,61,62,24,37,32.84,62.00,0.00
2024-12-10 17:35:22,62,62,24,38,32.31,62.02,0.00
2024-12-10 17:35:22,61,62,23,38,32.75,62.30,0.00
2024-12-10 17:35:22,61,63,23,38,33.31,63.00,0.00
2024-12-10 17:35:22,62,63,23,39,32.77,63.02,0.00
2024-12-10 17:35:22,61,63,22,39,32.92,63.51,0.00
2024-12-10 17:35:22,61,64,22,39,34.01,64.00,0.00
2024-12-10 17:35:22,62,64,23,39,33.46,64.02,0.00
2024-12-10 17:35:22,61,64,23,38,33.83,64.49,0.00
2024-12-10 17:35:22,61,65,23,38,34.50,65.00,0.00
2024-12-10 17:35:22,62,65,24,38,33.95,65.02,0.00
2024-12-10 17:35:22,62,66,24,38,34.52,66.00,0.00
2024-12-10 17:35:22,63,66,25,38,33.98,66.02,0.00
2024-12-10 17:35:22,63,67,25,38,34.41,67.00,0.00
2024-12-10 17:35:22,64,67,25,39,33.88,67.02,0.00
2024-12-10 17:35:22,63,67,24,39,34.28,67.38,0.00
2024-12-10 17:35:22,63,68,24,39,34.70,68.00,0.00
2024-12-10 17:35:22,64,68,24,40,34.15,68.02,0.00
2024-12-10 17:35:22,63,68,24,39,34.51,68.46,0.00
2024-12-10 17:35:22,63,69,24,39,35.16,69.00,0.00
2024-12-10 17:35:22,64,69,25,39,34.61,69.02,0.00
2024-12-10 17:35:22,64,70,25,39,35.15,70.00,0.00
2024-12-10 17:35:22,65,70,25,40,34.61,70.02,0.00
2024-12-10 17:35:22,64,70,24,40,35.13,70.03,0.00
2024-12-10 17:35:22,64,71,24,40,35.54,71.00,0.00
2024-12-10 17:35:22,65,71,24,41,34.99,71.02,0.00
2024-12-10 17:35:22,64,71,24,40,35.14,71.44,0.00
2024-12-10 17:35:22,63,71,23,40,35.49,71.94,0.00
2024-12-10 17:35:22,63,72,23,40,36.63,72.00,0.00
2024-12-10 17:35:22,64,72,23,41,36.06,72.02,0.00
2024-12-10 17:35:22,63,72,22,41,36.08,72.49,0.00
2024-12-10 17:35:22,63,73,22,41,37.23,73.00,0.00
2024-12-10 17:35:22,64,73,22,42,36.65,73.02,0.00
2024-12-10 17:35:22,64,74,22,42,37.03,74.00,0.00
2024-12-10 17:35:22,65,74,22,43,36.46,74.02,0.00
2024-12-10 17:35:22,64,74,22,42,36.61,74.44,0.00
2024-12-10 17:35:22,64,75,22,42,37.27,75.00,0.00
2024-12-10 17:35:22,65,75,23,42,36.70,75.02,0.00
2024-12-10 17:35:22,65,76,23,42,37.20,76.00,0.00
2024-12-10 17:35:22,66,76,23,43,36.63,76.02,0.00
2024-12-10 17:35:22,65,76,22,43,37.18,76.02,0.00
2024-12-10 17:35:22,65,77,22,43,37.54,77.00,0.00
2024-12-10 17:35:22,66,77,22,44,36.97,77.02,0.00
2024-12-10 17:35:22,65,77,22,43,37.13,77.42,0.00
2024-12-10 17:35:22,65,78,22,43,37.76,78.00,0.00
2024-12-10 17:35:22,66,78,23,43,37.19,78.02,0.00
2024-12-10 17:35:22,66,79,23,43,37.63,79.00,0.00
2024-12-10 17:35:22,67,79,23,44,37.07,79.01,0.00
2024-12-10 17:35:22,66,79,22,44,37.14,79.48,0.00
2024-12-10 17:35:22,66,80,22,44,37.93,80.00,0.00
2024-12-10 17:35:22,67,80,22,45,37.36,80.01,0.00
2024-12-10 17:35:22,66,80,22,44,37.51,80.41,0.00
2024-12-10 17:35:22,66,81,22,44,38.12,81.00,0.00
2024-12-10 17:35:22,67,81,23,44,37.55,81.01,0.00
2024-12-10 17:35:22,67,82,23,44,37.97,82.00,0.00
2024-12-10 17:35:22,68,82,24,44,37.41,82.01,0.00
2024-12-10 17:35:22,68,83,24,44,37.68,83.00,0.00
2024-12-10 17:35:22,69,83,24,45,37.14,83.01,0.00
2024-12-10 17:35:22,68,83,24,44,37.22,83.41,0.00
2024-12-10 17:35:22,68,84,24,44,37.86,84.00,0.00
2024-12-10 17:35:22,69,84,25,44,37.31,84.01,0.00
2024-12-10 17:35:22,68,84,24,44,37.51,84.41,0.00
2024-12-10 17:35:22,67,84,23,44,37.78,84.54,0.00
2024-12-10 17:35:22,67,85,23,44,38.96,85.00,0.00
2024-12-10 17:35:22,68,85,24,44,38.39,85.01,0.00
2024-12-10 17:35:22,67,85,24,43,38.79,85.07,0.00
2024-12-10 17:35:22,66,85,23,43,38.81,85.73,0.00
2024-12-10 17:35:22,66,86,23,43,39.74,86.00,0.00
2024-12-10 17:35:22,67,86,23,44,39.15,86.01,0.00
2024-12-10 17:35:22,66,86,23,43,39.27,86.41,0.00
2024-12-10 17:35:22,66,87,23,43,39.95,87.00,0.00
2024-12-10 17:35:22,67,87,24,43,39.35,87.01,0.00
2024-12-10 17:35:22,66,87,23,43,39.11,87.74,0.00
2024-12-10 17:35:22,66,88,23,43,40.40,88.00,0.00
2024-12-10 17:35:22,67,88,24,43,39.80,88.01,0.00
2024-12-10 17:35:22,67,89,24,43,40.08,89.00,0.00
2024-12-10 17:35:22,68,89,24,44,39.49,89.01,0.00
2024-12-10 17:35:22,67,89,24,43,39.60,89.40,0.00
2024-12-10 17:35:22,67,90,24,43,40.28,90.00,0.00
2024-12-10 17:35:22,68,90,25,43,39.69,90.01,0.00
2024-12-10 17:35:22,68,91,25,43,40.10,91.00,0.00
2024-12-10 17:35:22,69,91,25,44,39.52,91.01,0.00
2024-12-10 17:35:22,69,92,25,44,39.76,92.00,0.00
2024-12-10 17:35:22,70,92,26,44,39.19,92.01,0.00
2024-12-10 17:35:22,69,92,26,43,39.29,92.39,0.00
2024-12-10 17:35:22,68,92,25,43,39.49,92.96,0.00
2024-12-10 17:35:22,68,93,25,43,40.85,93.00,0.00
2024-12-10 17:35:22,69,93,25,44,40.25,93.01,0.00
2024-12-10 17:35:23,69,94,25,44,40.62,94.00,0.00
2024-12-10 17:35:23,70,94,25,45,40.04,94.01,0.00
2024-12-10 17:35:23,70,95,25,45,40.23,95.00,0.00
2024-12-10 17:35:23,71,95,25,46,39.66,95.01,0.00
2024-12-10 17:35:23,70,95,24,46,39.96,95.30,0.00
2024-12-10 17:35:23,69,95,24,45,40.35,95.38,0.00
2024-12-10 17:35:23,68,95,23,45,40.40,95.91,0.00
2024-12-10 17:35:23,68,96,23,45,41.80,96.00,0.00
2024-12-10 17:35:23,69,96,24,45,41.20,96.01,0.00
2024-12-10 17:35:23,68,96,23,45,40.79,96.78,0.00
2024-12-10 17:35:23,68,97,23,45,42.18,97.00,0.00
2024-12-10 17:35:23,69,97,24,45,41.56,97.01,0.00
2024-12-10 17:35:23,68,97,24,44,42.12,97.07,0.00
2024-12-10 17:35:23,68,98,24,44,42.38,98.00,0.00
2024-12-10 17:35:23,69,98,25,44,41.77,98.01,0.00
2024-12-10 17:35:23,68,98,25,43,41.93,98.37,0.00
2024-12-10 17:35:23,68,99,25,43,42.60,99.00,0.00
2024-12-10 17:35:23,69,99,26,43,41.98,99.01,0.00
2024-12-10 17:35:23,68,99,26,42,42.58,99.01,0.00
2024-12-10 17:35:23,67,99,26,41,43.20,99.01,0.00
2024-12-10 17:35:23,66,99,25,41,43.84,99.02,0.00
2024-12-10 17:35:23,65,99,25,40,44.50,99.02,0.00
2024-12-10 17:35:23,64,99,25,39,45.18,99.02,0.00
2024-12-10 17:35:23,63,99,25,38,45.88,99.02,0.00
2024-12-10 17:35:23,62,99,24,38,46.61,99.02,0.00
2024-12-10 17:35:23,61,99,23,38,47.36,99.02,0.00
2024-12-10 17:35:23,60,99,22,38,48.13,99.02,0.00
2024-12-10 17:35:23,59,99,21,38,48.93,99.02,0.00
2024-12-10 17:35:23,58,99,20,38,49.76,99.02,0.00
2024-12-10 17:35:23,57,99,20,37,50.61,99.02,0.00
2024-12-10 17:35:23,56,99,20,36,51.50,99.02,0.00
2024-12-10 17:35:23,55,99,20,35,52.42,99.02,0.00
2024-12-10 17:35:23,54,99,19,35,53.37,99.02,0.00
2024-12-10 17:35:23,53,99,18,35,54.36,99.02,0.00
2024-12-10 17:35:23,52,99,18,34,55.38,99.02,0.00
2024-12-10 17:35:23,51,99,18,33,56.45,99.02,0.00
2024-12-10 17:35:23,50,99,17,33,57.56,99.02,0.00
2024-12-10 17:35:23,50,100,17,33,58.41,100.00,0.00
2024-12-10 17:35:23,51,100,17,34,57.27,100.02,0.00
2024-12-10 17:35:23,51,101,17,34,57.64,101.00,0.00
2024-12-10 17:35:23,52,101,18,34,56.53,101.02,0.00
2024-12-10 17:35:23,51,101,18,33,57.44,101.12,0.00
2024-12-10 17:35:23,50,101,17,33,58.06,101.92,0.00
2024-12-10 17:35:23,50,102,17,33,60.07,102.00,0.00
2024-12-10 17:35:23,51,102,17,34,58.90,102.02,0.00
2024-12-10 17:35:23,50,102,16,34,59.21,102.56,0.00
2024-12-10 17:35:23,50,103,16,34,61.15,103.00,0.00
2024-12-10 17:35:23,51,103,17,34,59.95,103.02,0.00
2024-12-10 17:35:23,51,104,17,34,60.33,104.00,0.00
2024-12-10 17:35:23,52,104,17,35,59.17,104.02,0.00
2024-12-10 17:35:23,51,104,17,34,60.16,104.12,0.00
2024-12-10 17:35:23,51,105,17,34,61.03,105.00,0.00
2024-12-10 17:35:23,52,105,17,35,59.86,105.02,0.00
2024-12-10 17:35:23,52,106,17,35,60.44,106.00,0.00
2024-12-10 17:35:23,53,106,17,36,59.30,106.02,0.00
2024-12-10 17:35:23,52,106,16,36,59.11,106.85,0.00
2024-12-10 17:35:23,52,107,16,36,61.12,107.00,0.00
2024-12-10 17:35:23,53,107,16,37,59.96,107.02,0.00
2024-12-10 17:35:23,52,107,16,36,61.10,107.02,0.00
2024-12-10 17:35:23,51,107,16,35,62.18,107.10,0.00
2024-12-10 17:35:23,51,108,16,35,63.05,108.00,0.00
2024-12-10 17:35:23,52,108,16,36,61.84,108.02,0.00
2024-12-10 17:35:23,51,108,15,36,62.93,108.06,0.00
2024-12-10 17:35:23,51,109,15,36,64.19,109.00,0.00
2024-12-10 17:35:23,52,109,15,37,62.96,109.02,0.00
2024-12-10 17:35:23,52,110,15,37,63.30,110.00,0.00
2024-12-10 17:35:23,53,110,16,37,62.11,110.02,0.00
2024-12-10 17:35:23,52,110,15,37,63.22,110.10,0.00
2024-12-10 17:35:23,51,110,15,36,64.37,110.10,0.00
2024-12-10 17:35:23,50,110,14,36,65.21,110.28,0.00
2024-12-10 17:35:23,50,111,14,36,67.13,111.00,0.00
2024-12-10 17:35:23,51,111,14,37,65.82,111.02,0.00
2024-12-10 17:35:23,51,112,14,37,66.43,112.00,0.00
2024-12-10 17:35:23,52,112,15,37,65.15,112.02,0.00
2024-12-10 17:35:23,51,112,14,37,66.04,112.10,0.00
2024-12-10 17:35:23,51,113,14,37,67.38,113.00,0.00
2024-12-10 17:35:23,52,113,15,37,66.08,113.02,0.00
2024-12-10 17:35:23,51,113,15,36,66.93,113.08,0.00
2024-12-10 17:35:23,51,114,15,36,67.81,114.00,0.00
2024-12-10 17:35:23,52,114,15,37,66.51,114.02,0.00
2024-12-10 17:35:23,51,114,15,36,67.79,114.02,0.00
2024-12-10 17:35:23,50,114,15,35,69.01,114.08,0.00
2024-12-10 17:35:23,50,115,15,35,69.93,115.00,0.00
2024-12-10 17:35:23,51,115,16,35,68.56,115.02,0.00
2024-12-10 17:35:23,50,115,16,34,69.91,115.02,0.00
2024-12-10 17:35:23,49,115,15,34,71.29,115.04,0.00
2024-12-10 17:35:23,49,116,15,34,71.97,116.00,0.00
2024-12-10 17:35:23,50,116,15,35,70.53,116.02,0.00
2024-12-10 17:35:23,50,117,15,35,70.92,117.00,0.00
2024-12-10 17:35:23,51,117,15,36,69.53,117.02,0.00
2024-12-10 17:35:23,50,117,15,35,70.85,117.04,0.00
2024-12-10 17:35:23,50,118,15,35,71.74,118.00,0.00
2024-12-10 17:35:23,51,118,16,35,70.34,118.02,0.00
2024-12-10 17:35:23,50,118,15,35,71.02,118.36,0.00
2024-12-10 17:35:23,49,118,14,35,72.32,118.61,0.00
2024-12-10 17:35:23,49,119,14,35,73.77,119.00,0.00
2024-12-10 17:35:23,50,119,14,36,72.30,119.02,0.00
2024-12-10 17:35:23,49,119,14,35,73.24,119.04,0.00
2024-12-10 17:35:23,49,120,14,35,74.17,120.00,0.00
2024-12-10 17:35:23,50,120,15,35,72.69,120.02,0.00
2024-12-10 17:35:23,50,121,15,35,73.20,121.00,0.00
2024-12-10 17:35:23,51,121,15,36,71.76,121.02,0.00
2024-12-10 17:35:23,50,121,15,35,72.69,121.04,0.00
2024-12-10 17:35:23,50,122,15,35,73.58,122.00,0.00
2024-12-10 17:35:23,51,122,15,36,72.14,122.02,0.00
2024-12-10 17:35:23,51,123,15,36,72.62,123.00,0.00
2024-12-10 17:35:23,52,123,15,37,71.22,123.02,0.00
2024-12-10 17:35:23,51,123,14,37,72.62,123.02,0.00
2024-12-10 17:35:23,50,123,14,36,73.60,123.02,0.00
2024-12-10 17:35:23,49,123,13,36,73.94,123.96,0.00
2024-12-10 17:35:23,49,124,13,36,76.44,124.00,0.00
2024-12-10 17:35:23,50,124,14,36,74.91,124.02,0.00
2024-12-10 17:35:23,49,124,13,36,74.86,124.92,0.00
2024-12-10 17:35:23,49,125,13,36,77.36,125.00,0.00
2024-12-10 17:35:23,50,125,14,36,75.82,125.02,0.00
2024-12-10 17:35:23,49,125,14,35,76.91,125.02,0.00
2024-12-10 17:35:23,49,126,14,35,77.83,126.00,0.00
2024-12-10 17:35:23,50,126,15,35,76.27,126.02,0.00
2024-12-10 17:35:23,50,127,15,35,76.71,127.00,0.00
2024-12-10 17:35:23,51,127,15,36,75.21,127.02,0.00
2024-12-10 17:35:23,50,127,15,35,76.28,127.02,0.00
2024-12-10 17:35:24,50,128,15,35,77.16,128.00,0.00
2024-12-10 17:35:24,51,128,15,36,75.65,128.02,0.00
2024-12-10 17:35:24,50,128,14,36,75.47,128.48,0.00
2024-12-10 17:35:24,50,129,14,36,77.74,129.00,0.00
2024-12-10 17:35:24,51,129,14,37,76.21,129.02,0.00
2024-12-10 17:35:24,50,129,14,36,77.25,129.02,0.00
2024-12-10 17:35:24,50,130,14,36,78.13,130.00,0.00
2024-12-10 17:35:24,51,130,15,36,76.60,130.02,0.00
2024-12-10 17:35:24,50,130,14,36,76.33,130.52,0.00
2024-12-10 17:35:24,50,131,14,36,78.66,131.00,0.00
2024-12-10 17:35:24,51,131,14,37,77.11,131.02,0.00
2024-12-10 17:35:24,50,131,14,36,78.18,131.02,0.00
2024-12-10 17:35:24,50,132,14,36,79.07,132.00,0.00
2024-12-10 17:35:24,51,132,14,37,77.52,132.02,0.00
2024-12-10 17:35:24,50,132,13,37,78.02,132.66,0.00
2024-12-10 17:35:24,50,133,13,37,79.55,133.00,0.00
2024-12-10 17:35:24,51,133,14,37,77.99,133.02,0.00
2024-12-10 17:35:24,50,133,14,36,79.07,133.02,0.00
2024-12-10 17:35:24,49,133,13,36,79.37,133.96,0.00
2024-12-10 17:35:24,49,134,13,36,82.07,134.00,0.00
2024-12-10 17:35:24,50,134,14,36,80.43,134.02,0.00
2024-12-10 17:35:24,50,135,14,36,80.88,135.00,0.00
2024-12-10 17:35:24,51,135,14,37,79.30,135.02,0.00
2024-12-10 17:35:24,50,135,14,36,80.42,135.02,0.00
2024-12-10 17:35:24,49,135,13,36,81.51,135.67,0.00
2024-12-10 17:35:24,49,136,13,36,82.98,136.00,0.00
2024-12-10 17:35:24,50,136,14,36,81.32,136.02,0.00
2024-12-10 17:35:24,50,137,14,36,81.72,137.00,0.00
2024-12-10 17:35:24,51,137,14,37,80.12,137.02,0.00
2024-12-10 17:35:24,50,137,14,36,81.28,137.02,0.00
2024-12-10 17:35:24,50,138,14,36,82.14,138.00,0.00
2024-12-10 17:35:24,51,138,14,37,80.53,138.02,0.00
2024-12-10 17:35:24,51,139,14,37,80.87,139.00,0.00
2024-12-10 17:35:24,52,139,15,37,79.32,139.02,0.00
2024-12-10 17:35:24,51,139,15,36,80.46,139.02,0.00
2024-12-10 17:35:24,50,139,14,36,80.74,139.96,0.00
2024-12-10 17:35:24,50,140,14,36,83.50,140.00,0.00
2024-12-10 17:35:24,51,140,14,37,81.87,140.02,0.00
2024-12-10 17:35:24,51,141,14,37,82.23,141.00,0.00
2024-12-10 17:35:24,52,141,14,38,80.65,141.02,0.00
2024-12-10 17:35:24,51,141,14,37,81.85,141.02,0.00
2024-12-10 17:35:24,51,142,14,37,82.71,142.00,0.00
2024-12-10 17:35:24,52,142,14,38,81.12,142.02,0.00
2024-12-10 17:35:24,51,142,13,38,80.80,142.96,0.00
2024-12-10 17:35:24,51,143,13,38,83.56,143.00,0.00
2024-12-10 17:35:24,52,143,13,39,81.96,143.02,0.00
2024-12-10 17:35:24,51,143,13,38,83.17,143.02,0.00
2024-12-10 17:35:24,50,143,12,38,83.64,143.86,0.00
2024-12-10 17:35:24,51,142,12,39,81.95,143.98,0.00
2024-12-10 17:35:24,51,143,12,39,84.79,144.00,0.00
2024-12-10 17:35:24,52,143,13,39,83.16,144.02,0.00
2024-12-10 17:35:24,52,144,13,39,86.30,145.00,0.00
2024-12-10 17:35:24,53,144,14,39,84.67,145.02,0.00
2024-12-10 17:35:24,52,144,14,38,85.94,145.02,0.00
2024-12-10 17:35:24,52,145,14,38,86.78,146.00,0.00
2024-12-10 17:35:24,53,145,15,38,85.15,146.02,0.00
2024-12-10 17:35:24,52,145,14,38,86.08,146.12,0.00
2024-12-10 17:35:24,51,145,13,38,86.83,146.80,0.00
2024-12-10 17:35:24,51,146,13,38,89.59,147.00,0.00
2024-12-10 17:35:24,52,146,14,38,87.86,147.02,0.00
2024-12-10 17:35:24,51,146,14,37,89.21,147.02,0.00
2024-12-10 17:35:24,50,146,13,37,90.56,147.44,0.00
2024-12-10 17:35:24,50,147,13,37,91.92,148.00,0.00
2024-12-10 17:35:24,51,147,14,37,90.12,148.02,0.00
2024-12-10 17:35:24,50,147,13,37,90.72,148.64,0.00
2024-12-10 17:35:24,50,148,13,37,92.26,149.00,0.00
2024-12-10 17:35:24,51,148,14,37,90.46,149.02,0.00
2024-12-10 17:35:24,50,148,14,36,91.91,149.02,0.00
2024-12-10 17:35:24,50,149,14,36,92.85,150.00,0.00
2024-12-10 17:35:24,51,149,15,36,91.03,150.02,0.00
2024-12-10 17:35:24,50,149,14,36,91.86,150.02,0.00
2024-12-10 17:35:24,50,150,14,36,93.41,151.00,0.00
2024-12-10 17:35:24,51,150,14,37,91.58,151.02,0.00
2024-12-10 17:35:24,50,150,14,36,93.02,151.02,0.00
2024-12-10 17:35:24,50,151,14,36,93.97,152.00,0.00
2024-12-10 17:35:24,51,151,14,37,92.13,152.02,0.00
2024-12-10 17:35:24,50,151,13,37,93.75,152.02,0.00
2024-12-10 17:35:24,50,152,13,37,95.31,153.00,0.00
2024-12-10 17:35:24,51,152,13,38,93.44,153.02,0.00
2024-12-10 17:35:24,50,152,13,37,94.89,153.02,0.00
2024-12-10 17:35:24,49,152,12,37,95.61,153.04,0.00
2024-12-10 17:35:24,49,153,12,37,97.89,154.00,0.00
2024-12-10 17:35:24,50,153,13,37,95.94,154.02,0.00
2024-12-10 17:35:24,49,153,12,37,95.99,154.06,0.00
2024-12-10 17:35:24,49,154,12,37,98.31,155.00,0.00
2024-12-10 17:35:24,50,154,13,37,96.34,155.02,0.00
2024-12-10 17:35:24,49,154,13,36,97.83,155.02,0.00
2024-12-10 17:35:24,49,155,13,36,98.85,156.00,0.00
2024-12-10 17:35:24,50,155,14,36,96.87,156.02,0.00
2024-12-10 17:35:24,50,156,14,36,97.21,157.00,0.00
2024-12-10 17:35:24,51,156,14,37,95.30,157.02,0.00
2024-12-10 17:35:24,50,156,14,36,96.74,157.02,0.00
2024-12-10 17:35:24,50,157,14,36,97.70,158.00,0.00
2024-12-10 17:35:24,51,157,15,36,95.79,158.02,0.00
2024-12-10 17:35:24,51,158,15,36,96.08,159.00,0.00
2024-12-10 17:35:24,52,158,16,36,94.23,159.02,0.00
2024-12-10 17:35:24,51,158,16,35,95.61,159.02,0.00
2024-12-10 17:35:24,51,159,16,35,96.53,160.00,0.00
2024-12-10 17:35:24,52,159,16,36,94.67,160.02,0.00
2024-12-10 17:35:24,51,159,15,36,94.55,160.90,0.00
2024-12-10 17:35:24,51,160,15,36,97.60,161.00,0.00
2024-12-10 17:35:24,52,160,15,37,95.73,161.02,0.00
2024-12-10 17:35:24,51,160,15,36,97.16,161.02,0.00
2024-12-10 17:35:24,51,161,15,36,98.08,162.00,0.00
2024-12-10 17:35:24,52,161,16,36,96.20,162.02,0.00
2024-12-10 17:35:24,52,162,16,36,96.45,163.00,0.00
2024-12-10 17:35:24,53,162,17,36,94.63,163.02,0.00
2024-12-10 17:35:24,52,162,17,35,96.04,163.02,0.00
2024-12-10 17:35:24,52,163,17,35,96.91,164.00,0.00
2024-12-10 17:35:24,53,163,18,35,95.08,164.02,0.00
2024-12-10 17:35:24,53,164,18,35,95.39,165.00,0.00
2024-12-10 17:35:24,54,164,18,36,93.62,165.02,0.00
2024-12-10 17:35:24,53,164,18,35,94.89,165.02,0.00
2024-12-10 17:35:24,52,164,17,35,96.71,165.02,0.00
2024-12-10 17:35:25,52,165,17,35,97.58,166.00,0.00
2024-12-10 17:35:25,53,165,18,35,95.74,166.02,0.00
2024-12-10 17:35:25,53,166,18,35,96.05,167.00,0.00
2024-12-10 17:35:25,54,166,19,35,94.27,167.02,0.00
2024-12-10 17:35:25,53,166,19,34,95.55,167.02,0.00
2024-12-10 17:35:25,52,166,18,34,96.64,167.65,0.00
2024-12-10 17:35:25,52,167,18,34,98.23,168.00,0.00
2024-12-10 17:35:25,53,167,18,35,96.37,168.02,0.00
2024-12-10 17:35:25,52,167,17,35,95.72,168.60,0.00
2024-12-10 17:35:25,52,168,17,35,98.55,169.00,0.00
2024-12-10 17:35:25,53,168,17,36,96.69,169.02,0.00
2024-12-10 17:35:25,52,168,17,35,98.03,169.02,0.00
2024-12-10 17:35:25,52,169,17,35,98.90,170.00,0.00
2024-12-10 17:35:25,53,169,18,35,97.04,170.02,0.00
2024-12-10 17:35:25,53,170,18,35,97.34,171.00,0.00
2024-12-10 17:35:25,54,170,19,35,95.54,171.02,0.00
2024-12-10 17:35:25,53,170,19,34,96.86,171.02,0.00
2024-12-10 17:35:25,52,170,18,34,97.03,171.92,0.00
2024-12-10 17:35:25,52,171,18,34,100.27,172.00,0.00
2024-12-10 17:35:25,53,171,18,35,98.37,172.02,0.00
2024-12-10 17:35:25,52,171,17,35,98.89,172.60,0.00
2024-12-10 17:35:25,52,172,17,35,100.58,173.00,0.00
2024-12-10 17:35:25,53,172,18,35,98.68,173.02,0.00
2024-12-10 17:35:25,52,172,18,34,100.11,173.02,0.00
2024-12-10 17:35:25,51,172,17,34,100.02,173.59,0.00
2024-12-10 17:35:25,51,173,17,34,103.00,174.00,0.00
2024-12-10 17:35:25,52,173,18,34,101.01,174.02,0.00
2024-12-10 17:35:25,51,173,17,34,100.51,174.57,0.00
2024-12-10 17:35:25,51,174,17,34,103.48,175.00,0.00
2024-12-10 17:35:25,52,174,17,35,101.49,175.02,0.00
2024-12-10 17:35:25,51,174,17,34,103.04,175.02,0.00
2024-12-10 17:35:25,51,175,17,34,103.97,176.00,0.00
2024-12-10 17:35:25,52,175,17,35,101.97,176.02,0.00
2024-12-10 17:35:25,51,175,16,35,102.67,176.24,0.00
2024-12-10 17:35:25,50,175,15,35,104.29,176.62,0.00
2024-12-10 17:35:25,50,176,15,35,107.43,177.00,0.00
2024-12-10 17:35:25,51,176,15,36,105.33,177.02,0.00
2024-12-10 17:35:25,50,176,15,35,106.94,177.04,0.00
2024-12-10 17:35:25,49,176,14,35,106.97,177.61,0.00
2024-12-10 17:35:25,49,177,14,35,110.21,178.00,0.00
2024-12-10 17:35:25,50,177,14,36,108.00,178.02,0.00
2024-12-10 17:35:25,49,177,13,36,108.87,178.22,0.00
2024-12-10 17:35:25,49,178,13,36,111.67,179.00,0.00
2024-12-10 17:35:25,50,178,14,36,109.43,179.02,0.00
2024-12-10 17:35:25,50,179,14,36,110.12,180.00,0.00
2024-12-10 17:35:25,51,179,14,37,107.96,180.02,0.00
2024-12-10 17:35:25,51,180,14,37,108.21,181.00,0.00
2024-12-10 17:35:25,52,180,14,38,106.12,181.02,0.00
2024-12-10 17:35:25,51,180,14,37,107.60,181.24,0.00
2024-12-10 17:35:25,51,181,14,37,108.87,182.00,0.00
2024-12-10 17:35:25,52,181,14,38,106.78,182.02,0.00
2024-12-10 17:35:25,52,182,14,38,107.40,183.00,0.00
2024-12-10 17:35:25,53,182,15,38,105.37,183.02,0.00
2024-12-10 17:35:25,53,183,15,38,105.53,184.00,0.00
2024-12-10 17:35:25,54,183,16,38,103.58,184.02,0.00
2024-12-10 17:35:25,53,183,16,37,105.00,184.23,0.00
2024-12-10 17:35:25,53,184,16,37,106.17,185.00,0.00
2024-12-10 17:35:25,54,184,17,37,104.21,185.02,0.00
2024-12-10 17:35:25,54,185,17,37,104.77,186.00,0.00
2024-12-10 17:35:25,55,185,18,37,102.87,186.02,0.00
2024-12-10 17:35:25,54,185,17,37,101.78,186.96,0.00
2024-12-10 17:35:25,54,186,17,37,105.19,187.00,0.00
2024-12-10 17:35:25,55,186,18,37,103.28,187.02,0.00
2024-12-10 17:35:25,54,186,18,36,104.70,187.22,0.00
2024-12-10 17:35:25,54,187,18,36,105.83,188.00,0.00
2024-12-10 17:35:25,55,187,18,37,103.90,188.02,0.00
2024-12-10 17:35:25,55,188,18,37,104.40,189.00,0.00
2024-12-10 17:35:25,56,188,18,38,102.54,189.02,0.00
2024-12-10 17:35:25,55,188,17,38,102.57,189.60,0.00
2024-12-10 17:35:25,55,189,17,38,105.56,190.00,0.00
2024-12-10 17:35:25,56,189,17,39,103.68,190.02,0.00
2024-12-10 17:35:25,55,189,17,38,105.13,190.22,0.00
2024-12-10 17:35:25,55,190,17,38,106.22,191.00,0.00
2024-12-10 17:35:25,56,190,18,38,104.32,191.02,0.00
2024-12-10 17:35:25,55,190,17,38,104.09,191.82,0.00
2024-12-10 17:35:25,55,191,17,38,107.37,192.00,0.00
2024-12-10 17:35:25,56,191,17,39,105.45,192.02,0.00
2024-12-10 17:35:25,56,192,17,39,105.48,193.00,0.00
2024-12-10 17:35:25,57,192,17,40,103.63,193.02,0.00
2024-12-10 17:35:25,56,192,17,39,105.05,193.21,0.00
2024-12-10 17:35:25,56,193,17,39,106.10,194.00,0.00
2024-12-10 17:35:25,57,193,17,40,104.24,194.02,0.00
2024-12-10 17:35:25,57,194,17,40,104.68,195.00,0.00
2024-12-10 17:35:25,58,194,18,40,102.88,195.02,0.00
2024-12-10 17:35:25,57,194,17,40,101.91,195.86,0.00
2024-12-10 17:35:25,57,195,17,40,105.18,196.00,0.00
2024-12-10 17:35:25,58,195,17,41,103.36,196.02,0.00
2024-12-10 17:35:25,57,195,17,40,105.01,196.09,0.00
2024-12-10 17:35:25,56,195,17,39,106.64,196.20,0.00
2024-12-10 17:35:25,56,196,17,39,107.67,197.00,0.00
2024-12-10 17:35:25,57,196,17,40,105.78,197.02,0.00
2024-12-10 17:35:25,56,196,16,40,105.87,197.59,0.00
2024-12-10 17:35:25,56,197,16,40,108.90,198.00,0.00
2024-12-10 17:35:25,57,197,17,40,106.99,198.02,0.00
2024-12-10 17:35:25,56,197,17,39,107.83,198.20,0.00
2024-12-10 17:35:25,56,198,17,39,108.88,199.00,0.00
2024-12-10 17:35:25,57,198,17,40,106.97,199.02,0.00
2024-12-10 17:35:25,56,198,16,40,106.44,199.88,0.00
2024-12-10 17:35:25,56,199,16,40,109.85,200.00,0.00
2024-12-10 17:35:25,57,199,16,41,107.93,200.02,0.00
2024-12-10 17:35:25,56,199,16,40,108.78,200.20,0.00
2024-12-10 17:35:25,56,200,16,40,109.83,201.00,0.00
2024-12-10 17:35:25,57,200,16,41,107.90,201.02,0.00
2024-12-10 17:35:25,57,201,16,41,108.33,202.00,0.00
2024-12-10 17:35:25,58,201,17,41,106.46,202.02,0.00
2024-12-10 17:35:25,57,201,16,41,105.43,202.49,0.00
2024-12-10 17:35:26,57,202,16,41,108.33,203.00,0.00
2024-12-10 17:35:26,58,202,17,41,106.47,203.02,0.00
2024-12-10 17:35:26,57,202,17,40,107.97,203.19,0.00
2024-12-10 17:35:26,57,203,17,40,108.97,204.00,0.00
2024-12-10 17:35:26,58,203,18,40,107.10,204.02,0.00
2024-12-10 17:35:26,57,203,17,40,107.12,204.70,0.00
2024-12-10 17:35:26,57,204,17,40,109.31,205.00,0.00
2024-12-10 17:35:26,58,204,17,41,107.43,205.02,0.00
2024-12-10 17:35:26,57,204,17,40,108.33,205.19,0.00
2024-12-10 17:35:26,57,205,17,40,109.34,206.00,0.00
2024-12-10 17:35:26,58,205,17,41,107.46,206.02,0.00
2024-12-10 17:35:26,58,206,17,41,107.76,207.00,0.00
2024-12-10 17:35:26,59,206,17,42,105.93,207.02,0.00
2024-12-10 17:35:26,58,206,17,41,106.81,207.19,0.00
2024-12-10 17:35:26,57,206,16,41,107.88,207.68,0.00
2024-12-10 17:35:26,56,206,15,41,108.94,207.80,0.00
2024-12-10 17:35:26,56,207,15,41,112.40,208.00,0.00
2024-12-10 17:35:26,57,207,16,41,110.43,208.02,0.00
2024-12-10 17:35:26,56,207,16,40,112.37,208.02,0.00
2024-12-10 17:35:26,55,207,16,39,114.38,208.02,0.00
2024-12-10 17:35:26,55,208,16,39,114.74,209.00,0.00
2024-12-10 17:35:26,56,208,17,39,112.69,209.02,0.00
2024-12-10 17:35:26,55,208,17,38,113.88,209.16,0.00
2024-12-10 17:35:26,55,209,17,38,114.95,210.00,0.00
2024-12-10 17:35:26,56,209,18,38,112.90,210.02,0.00
2024-12-10 17:35:26,55,209,17,38,113.35,210.27,0.00
2024-12-10 17:35:26,55,210,17,38,116.15,211.00,0.00
2024-12-10 17:35:26,56,210,18,38,114.07,211.02,0.00
2024-12-10 17:35:26,55,210,17,38,115.82,211.18,0.00
2024-12-10 17:35:26,54,210,17,37,117.14,211.19,0.00
2024-12-10 17:35:26,54,211,17,37,118.31,212.00,0.00
2024-12-10 17:35:26,55,211,17,38,116.16,212.02,0.00
2024-12-10 17:35:26,55,212,17,38,116.61,213.00,0.00
2024-12-10 17:35:26,56,212,18,38,114.53,213.02,0.00
2024-12-10 17:35:26,55,212,17,38,116.57,213.02,0.00
2024-12-10 17:35:26,55,213,17,38,117.01,214.00,0.00
2024-12-10 17:35:26,56,213,17,39,114.92,214.02,0.00
2024-12-10 17:35:26,55,213,17,38,116.98,214.02,0.00
2024-12-10 17:35:26,54,213,17,37,118.13,214.15,0.00
2024-12-10 17:35:26,54,214,17,37,119.23,215.00,0.00
2024-12-10 17:35:26,55,214,17,38,117.06,215.02,0.00
2024-12-10 17:35:26,54,214,17,37,118.20,215.15,0.00
2024-12-10 17:35:26,53,214,16,37,119.43,215.25,0.00
2024-12-10 17:35:26,53,215,16,37,122.39,216.00,0.00
2024-12-10 17:35:26,54,215,16,38,120.12,216.02,0.00
2024-12-10 17:35:26,53,215,15,38,120.87,216.23,0.00
2024-12-10 17:35:26,53,216,15,38,123.81,217.00,0.00
2024-12-10 17:35:26,54,216,15,39,121.52,217.02,0.00
2024-12-10 17:35:26,53,216,15,38,123.77,217.02,0.00
2024-12-10 17:35:26,52,216,14,38,125.95,217.12,0.00
2024-12-10 17:35:26,51,216,14,37,127.52,217.12,0.00
2024-12-10 17:35:26,51,217,14,37,128.75,218.00,0.00
2024-12-10 17:35:26,52,217,15,37,126.27,218.02,0.00
2024-12-10 17:35:26,51,217,14,37,125.49,218.86,0.00
2024-12-10 17:35:26,51,218,14,37,129.59,219.00,0.00
2024-12-10 17:35:26,52,218,15,37,127.10,219.02,0.00
2024-12-10 17:35:26,51,218,15,36,129.55,219.02,0.00
2024-12-10 17:35:26,50,218,14,36,131.92,219.10,0.00
2024-12-10 17:35:26,50,219,14,36,132.30,220.00,0.00
2024-12-10 17:35:26,51,219,14,37,129.71,220.02,0.00
2024-12-10 17:35:26,50,219,14,36,132.08,220.10,0.00
2024-12-10 17:35:26,50,220,14,36,133.34,221.00,0.00
2024-12-10 17:35:26,51,220,14,37,130.73,221.02,0.00
2024-12-10 17:35:26,50,220,14,36,133.30,221.02,0.00
2024-12-10 17:35:26,50,221,14,36,133.81,222.00,0.00
2024-12-10 17:35:26,51,221,15,36,131.19,222.02,0.00
2024-12-10 17:35:26,50,221,15,35,133.77,222.02,0.00
2024-12-10 17:35:26,49,221,15,34,135.50,222.06,0.00
2024-12-10 17:35:26,48,221,14,34,136.22,222.83,0.00
2024-12-10 17:35:26,48,222,14,34,140.62,223.00,0.00
2024-12-10 17:35:26,49,222,14,35,137.75,223.02,0.00
2024-12-10 17:35:26,48,222,14,34,140.58,223.02,0.00
2024-12-10 17:35:26,48,223,14,34,141.15,224.00,0.00
2024-12-10 17:35:26,49,223,15,34,138.27,224.02,0.00
2024-12-10 17:35:26,48,223,14,34,139.24,224.15,0.00
2024-12-10 17:35:26,48,224,14,34,142.59,225.00,0.00
2024-12-10 17:35:26,49,224,15,34,139.68,225.02,0.00
2024-12-10 17:35:26,48,224,15,33,142.49,225.04,0.00
2024-12-10 17:35:26,48,225,15,33,143.78,226.00,0.00
2024-12-10 17:35:26,49,225,15,34,140.85,226.02,0.00
2024-12-10 17:35:26,49,226,15,34,141.32,227.00,0.00
2024-12-10 17:35:26,50,226,16,34,138.50,227.02,0.00
2024-12-10 17:35:26,49,226,16,33,141.28,227.02,0.00
2024-12-10 17:35:26,49,227,16,33,141.53,228.00,0.00
2024-12-10 17:35:26,50,227,16,34,138.70,228.02,0.00
2024-12-10 17:35:26,49,227,16,33,141.48,228.02,0.00
2024-12-10 17:35:26,48,227,15,33,143.40,228.56,0.00
2024-12-10 17:35:26,48,228,15,33,147.51,229.00,0.00
2024-12-10 17:35:26,49,228,16,33,144.50,229.02,0.00
2024-12-10 17:35:26,48,228,15,33,145.44,229.54,0.00
2024-12-10 17:35:26,48,229,15,33,149.53,230.00,0.00
2024-12-10 17:35:26,49,229,15,34,146.48,230.02,0.00
2024-12-10 17:35:26,48,229,15,33,148.57,230.02,0.00
2024-12-10 17:35:26,48,230,15,33,149.84,231.00,0.00
2024-12-10 17:35:26,49,230,15,34,146.78,231.02,0.00
2024-12-10 17:35:26,49,231,15,34,147.12,232.00,0.00
2024-12-10 17:35:26,50,231,15,35,144.17,232.02,0.00
2024-12-10 17:35:26,49,231,15,34,146.08,232.04,0.00
2024-12-10 17:35:26,49,232,15,34,147.32,233.00,0.00
2024-12-10 17:35:26,50,232,15,35,144.38,233.02,0.00
2024-12-10 17:35:26,50,233,15,35,144.78,234.00,0.00
2024-12-10 17:35:26,51,233,16,35,141.95,234.02,0.00
2024-12-10 17:35:26,50,233,15,35,144.67,234.02,0.00
2024-12-10 17:35:26,50,234,15,35,146.74,235.00,0.00
2024-12-10 17:35:26,51,234,16,35,143.87,235.02,0.00
2024-12-10 17:35:26,50,234,15,35,146.74,235.02,0.00
2024-12-10 17:35:26,49,234,15,34,149.69,235.02,0.00
2024-12-10 17:35:26,49,235,15,34,150.90,236.00,0.00
2024-12-10 17:35:26,50,235,16,34,147.89,236.02,0.00
2024-12-10 17:35:26,50,236,16,34,148.31,237.00,0.00
2024-12-10 17:35:26,51,236,17,34,145.41,237.02,0.00
2024-12-10 17:35:26,51,237,17,34,145.55,238.00,0.00
2024-12-10 17:35:26,52,237,17,35,142.75,238.02,0.00
2024-12-10 17:35:26,51,237,17,34,145.30,238.08,0.00
2024-12-10 17:35:26,51,238,17,34,146.49,239.00,0.00
2024-12-10 17:35:26,52,238,18,34,143.67,239.02,0.00
2024-12-10 17:35:27,52,239,18,34,144.03,240.00,0.00
2024-12-10 17:35:27,53,239,18,35,141.31,240.02,0.00
2024-12-10 17:35:27,52,239,17,35,142.42,240.37,0.00
2024-12-10 17:35:27,52,240,17,35,145.96,241.00,0.00
2024-12-10 17:35:27,53,240,18,35,143.21,241.02,0.00
2024-12-10 17:35:27,52,240,18,34,145.80,241.08,0.00
2024-12-10 17:35:27,52,241,18,34,146.94,242.00,0.00
2024-12-10 17:35:27,53,241,18,35,144.17,242.02,0.00
2024-12-10 17:35:27,52,241,17,35,144.01,242.40,0.00
2024-12-10 17:35:27,52,242,17,35,147.64,243.00,0.00
2024-12-10 17:35:27,53,242,17,36,144.86,243.02,0.00
2024-12-10 17:35:27,52,242,17,35,146.59,243.08,0.00
2024-12-10 17:35:27,52,243,17,35,147.73,244.00,0.00
2024-12-10 17:35:27,53,243,18,35,144.95,244.02,0.00
2024-12-10 17:35:27,52,243,17,35,147.29,244.08,0.00
2024-12-10 17:35:27,52,244,17,35,149.38,245.00,0.00
2024-12-10 17:35:27,53,244,18,35,146.57,245.02,0.00
2024-12-10 17:35:27,53,245,18,35,146.57,246.00,0.00
2024-12-10 17:35:27,54,245,18,36,143.86,246.02,0.00
2024-12-10 17:35:27,53,245,18,35,146.31,246.08,0.00
2024-12-10 17:35:27,53,246,18,35,147.30,247.00,0.00
2024-12-10 17:35:27,54,246,19,35,144.57,247.02,0.00
2024-12-10 17:35:27,53,246,18,35,144.99,247.60,0.00
2024-12-10 17:35:27,53,247,18,35,147.40,248.00,0.00
2024-12-10 17:35:27,54,247,19,35,144.67,248.02,0.00
2024-12-10 17:35:27,54,248,19,35,144.33,249.00,0.00
2024-12-10 17:35:27,55,248,19,36,141.71,249.02,0.00
2024-12-10 17:35:27,54,248,19,35,144.17,249.07,0.00
2024-12-10 17:35:27,54,249,19,35,144.77,250.00,0.00
2024-12-10 17:35:27,55,249,20,35,142.14,250.02,0.00
2024-12-10 17:35:27,54,249,19,35,141.37,250.72,0.00
2024-12-10 17:35:27,54,250,19,35,145.50,251.00,0.00
2024-12-10 17:35:27,55,250,20,35,142.85,251.02,0.00
2024-12-10 17:35:27,54,250,20,34,144.44,251.07,0.00
2024-12-10 17:35:27,53,250,19,34,144.04,251.55,0.00
2024-12-10 17:35:27,53,251,19,34,147.97,252.00,0.00
2024-12-10 17:35:27,54,251,20,34,145.23,252.02,0.00
2024-12-10 17:35:27,53,251,19,34,144.18,252.32,0.00
2024-12-10 17:35:27,53,252,19,34,147.68,253.00,0.00
2024-12-10 17:35:27,54,252,19,35,144.95,253.02,0.00
2024-12-10 17:35:27,53,252,19,34,146.60,253.08,0.00
2024-12-10 17:35:27,52,252,18,34,148.68,253.15,0.00
2024-12-10 17:35:27,52,253,18,34,151.96,254.00,0.00
2024-12-10 17:35:27,53,253,19,34,149.09,254.02,0.00
2024-12-10 17:35:27,53,254,19,34,149.30,255.00,0.00
2024-12-10 17:35:27,54,254,20,34,146.54,255.02,0.00
2024-12-10 17:35:27,53,254,20,33,148.26,255.08,0.00
2024-12-10 17:35:27,53,255,20,33,149.36,256.00,0.00
2024-12-10 17:35:27,54,255,21,33,146.59,256.02,0.00
2024-12-10 17:35:27,54,256,21,33,146.79,257.00,0.00
2024-12-10 17:35:27,55,256,21,34,144.12,257.02,0.00
2024-12-10 17:35:27,54,256,21,33,145.80,257.07,0.00
2024-12-10 17:35:27,53,256,20,33,146.26,257.83,0.00
2024-12-10 17:35:27,53,257,20,33,150.82,258.00,0.00
2024-12-10 17:35:27,54,257,20,34,148.02,258.02,0.00
2024-12-10 17:35:27,54,258,20,34,148.24,259.00,0.00
2024-12-10 17:35:27,55,258,20,35,145.55,259.02,0.00
2024-12-10 17:35:27,54,258,20,34,147.24,259.07,0.00
2024-12-10 17:35:27,53,258,19,34,147.98,259.77,0.00
2024-12-10 17:35:27,53,259,19,34,152.48,260.00,0.00
2024-12-10 17:35:27,54,259,20,34,149.65,260.02,0.00
2024-12-10 17:35:27,54,260,20,34,149.85,261.00,0.00
2024-12-10 17:35:27,55,260,20,35,147.13,261.02,0.00
2024-12-10 17:35:27,54,260,20,34,148.89,261.07,0.00
2024-12-10 17:35:27,54,261,20,34,149.94,262.00,0.00
2024-12-10 17:35:27,55,261,20,35,147.21,262.02,0.00
2024-12-10 17:35:27,55,262,20,35,147.42,263.00,0.00
2024-12-10 17:35:27,56,262,21,35,144.79,263.02,0.00
2024-12-10 17:35:27,55,262,21,34,146.47,263.07,0.00
2024-12-10 17:35:27,54,262,20,34,148.04,263.57,0.00
2024-12-10 17:35:27,54,263,20,34,152.11,264.00,0.00
2024-12-10 17:35:27,55,263,20,35,149.35,264.02,0.00
2024-12-10 17:35:27,55,264,20,35,149.52,265.00,0.00
2024-12-10 17:35:27,56,264,21,35,146.85,265.02,0.00
2024-12-10 17:35:27,55,264,21,34,148.61,265.07,0.00
2024-12-10 17:35:27,54,264,20,34,150.06,265.61,0.00
2024-12-10 17:35:27,54,265,20,34,154.25,266.00,0.00
2024-12-10 17:35:27,55,265,21,34,151.44,266.02,0.00
2024-12-10 17:35:27,54,265,20,34,151.15,266.43,0.00
2024-12-10 17:35:27,54,266,20,34,154.98,267.00,0.00
2024-12-10 17:35:27,55,266,21,34,152.16,267.02,0.00
2024-12-10 17:35:27,54,266,21,33,154.09,267.07,0.00
2024-12-10 17:35:27,54,267,21,33,155.16,268.00,0.00
2024-12-10 17:35:27,55,267,22,33,152.34,268.02,0.00
2024-12-10 17:35:27,55,268,22,33,152.55,269.00,0.00
2024-12-10 17:35:27,56,268,22,34,149.83,269.02,0.00
2024-12-10 17:35:27,55,268,22,33,151.58,269.07,0.00
2024-12-10 17:35:27,54,268,21,33,153.23,269.59,0.00
2024-12-10 17:35:27,54,269,21,33,155.45,270.00,0.00
2024-12-10 17:35:27,55,269,22,33,152.62,270.02,0.00
2024-12-10 17:35:27,55,270,22,33,152.80,271.00,0.00
2024-12-10 17:35:27,56,270,22,34,150.07,271.02,0.00
2024-12-10 17:35:27,55,270,22,33,151.87,271.07,0.00
2024-12-10 17:35:27,55,271,22,33,152.87,272.00,0.00
2024-12-10 17:35:27,56,271,23,33,150.14,272.02,0.00
2024-12-10 17:35:27,56,272,23,33,150.26,273.00,0.00
2024-12-10 17:35:27,57,272,24,33,147.62,273.02,0.00
2024-12-10 17:35:27,56,272,24,32,149.38,273.07,0.00
2024-12-10 17:35:27,56,273,24,32,150.32,274.00,0.00
2024-12-10 17:35:27,57,273,25,32,147.68,274.02,0.00
2024-12-10 17:35:28,57,274,25,32,147.90,275.00,0.00
2024-12-10 17:35:28,58,274,25,33,145.35,275.02,0.00
2024-12-10 17:35:28,57,274,24,33,147.75,275.07,0.00
2024-12-10 17:35:28,56,274,24,32,149.51,275.07,0.00
2024-12-10 17:35:28,56,275,24,32,150.44,276.00,0.00
2024-12-10 17:35:28,57,275,24,33,147.80,276.02,0.00
2024-12-10 17:35:28,56,275,24,32,150.39,276.02,0.00
2024-12-10 17:35:28,57,274,25,32,145.70,276.51,0.00
2024-12-10 17:35:28,57,275,25,32,149.49,277.00,0.00
2024-12-10 17:35:28,58,275,26,32,146.91,277.02,0.00
2024-12-10 17:35:28,57,275,26,31,149.44,277.02,0.00
2024-12-10 17:35:28,56,275,26,30,151.17,277.04,0.00
2024-12-10 17:35:28,55,275,25,30,150.53,277.95,0.00
2024-12-10 17:35:28,55,276,25,30,160.51,278.00,0.00
2024-12-10 17:35:28,56,276,25,31,157.64,278.02,0.00
2024-12-10 17:35:28,55,276,25,30,160.46,278.02,0.00
2024-12-10 17:35:28,54,276,24,30,161.33,278.15,0.00
2024-12-10 17:35:28,54,277,24,30,164.67,279.00,0.00
2024-12-10 17:35:28,55,277,25,30,161.67,279.02,0.00
2024-12-10 17:35:28,54,277,25,29,163.79,279.02,0.00
2024-12-10 17:35:28,53,277,24,29,166.79,279.06,0.00
2024-12-10 17:35:28,52,277,23,29,169.94,279.06,0.00
2024-12-10 17:35:28,52,278,23,29,173.28,280.00,0.00
2024-12-10 17:35:28,53,278,24,29,170.01,280.02,0.00
2024-12-10 17:35:28,53,279,24,29,170.08,281.00,0.00
2024-12-10 17:35:28,54,279,25,29,166.93,281.02,0.00
2024-12-10 17:35:28,53,279,25,28,169.23,281.02,0.00
2024-12-10 17:35:28,53,280,25,28,170.26,282.00,0.00
2024-12-10 17:35:28,54,280,25,29,167.11,282.02,0.00
2024-12-10 17:35:28,54,281,25,29,167.11,283.00,0.00
2024-12-10 17:35:28,55,281,25,30,164.07,283.02,0.00
2024-12-10 17:35:28,54,281,25,29,166.32,283.02,0.00
2024-12-10 17:35:28,54,282,25,29,167.28,284.00,0.00
2024-12-10 17:35:28,55,282,25,30,164.24,284.02,0.00
2024-12-10 17:35:28,55,283,25,30,164.30,285.00,0.00
2024-12-10 17:35:28,56,283,26,30,161.36,285.02,0.00
2024-12-10 17:35:28,55,283,26,29,163.47,285.02,0.00
2024-12-10 17:35:28,54,283,25,29,163.28,285.94,0.00
2024-12-10 17:35:28,54,284,25,29,168.46,286.00,0.00
2024-12-10 17:35:28,55,284,25,30,165.39,286.02,0.00
2024-12-10 17:35:28,55,285,25,30,165.44,287.00,0.00
2024-12-10 17:35:28,56,285,26,30,162.49,287.02,0.00
2024-12-10 17:35:28,55,285,26,29,164.66,287.02,0.00
2024-12-10 17:35:28,55,286,26,29,165.55,288.00,0.00
2024-12-10 17:35:28,56,286,27,29,162.59,288.02,0.00
2024-12-10 17:35:28,56,287,27,29,162.65,289.00,0.00
2024-12-10 17:35:28,57,287,28,29,159.80,289.02,0.00
2024-12-10 17:35:28,56,287,28,28,161.88,289.02,0.00
2024-12-10 17:35:28,55,287,27,28,162.05,289.44,0.00
2024-12-10 17:35:28,55,288,27,28,166.06,290.00,0.00
2024-12-10 17:35:28,56,288,28,28,163.10,290.02,0.00
2024-12-10 17:35:28,56,289,28,28,163.22,291.00,0.00
2024-12-10 17:35:28,57,289,29,28,160.36,291.02,0.00
2024-12-10 17:35:28,56,289,29,27,162.39,291.02,0.00
2024-12-10 17:35:28,56,290,29,27,163.21,292.00,0.00
2024-12-10 17:35:28,57,290,29,28,160.34,292.02,0.00
2024-12-10 17:35:28,57,291,29,28,160.47,293.00,0.00
2024-12-10 17:35:28,58,291,29,29,157.70,293.02,0.00
2024-12-10 17:35:28,57,291,29,28,159.60,293.04,0.00
2024-12-10 17:35:28,56,291,28,28,158.90,293.96,0.00
2024-12-10 17:35:28,56,292,28,28,164.06,294.00,0.00
2024-12-10 17:35:28,57,292,28,29,161.18,294.02,0.00
2024-12-10 17:35:28,56,292,27,29,164.02,294.02,0.00
2024-12-10 17:35:28,56,293,27,29,164.22,295.00,0.00
2024-12-10 17:35:28,57,293,28,29,161.34,295.02,0.00
2024-12-10 17:35:28,56,293,28,28,163.38,295.02,0.00
2024-12-10 17:35:28,55,293,27,28,165.07,295.53,0.00
2024-12-10 17:35:28,55,294,27,28,169.38,296.00,0.00
2024-12-10 17:35:28,56,294,28,28,166.35,296.02,0.00
2024-12-10 17:35:28,55,294,27,28,167.79,296.13,0.00
2024-12-10 17:35:28,55,295,27,28,171.14,297.00,0.00
2024-12-10 17:35:28,56,295,28,28,168.08,297.02,0.00
2024-12-10 17:35:28,55,295,28,27,170.33,297.02,0.00
2024-12-10 17:35:28,54,295,27,27,173.34,297.07,0.00
2024-12-10 17:35:28,53,295,26,27,175.44,297.55,0.00
2024-12-10 17:35:28,53,296,26,27,177.79,298.00,0.00
2024-12-10 17:35:28,54,296,27,27,174.50,298.02,0.00
2024-12-10 17:35:28,54,297,27,27,174.54,299.00,0.00
2024-12-10 17:35:28,55,297,27,28,171.37,299.02,0.00
2024-12-10 17:35:28,54,297,27,27,173.77,299.02,0.00
2024-12-10 17:35:28,53,297,26,27,175.65,299.21,0.00
2024-12-10 17:35:28,52,297,25,27,178.19,299.54,0.00
2024-12-10 17:35:28,52,298,25,27,182.91,300.00,0.00
2024-12-10 17:35:28,53,298,26,27,179.46,300.02,0.00
2024-12-10 17:35:28,53,299,26,27,179.47,301.00,0.00
2024-12-10 17:35:28,54,299,26,28,176.14,301.02,0.00
2024-12-10 17:35:28,53,299,26,27,178.73,301.02,0.00
2024-12-10 17:35:28,52,299,25,27,180.67,301.60,0.00
2024-12-10 17:35:28,52,300,25,27,183.25,302.00,0.00
2024-12-10 17:35:28,53,300,26,27,179.79,302.02,0.00
2024-12-10 17:35:28,52,300,25,27,180.90,302.19,0.00
2024-12-10 17:35:28,51,300,24,27,183.34,302.63,0.00
2024-12-10 17:35:28,51,301,24,27,188.45,303.00,0.00
2024-12-10 17:35:28,52,301,24,28,184.83,303.02,0.00
2024-12-10 17:35:28,51,301,24,27,187.45,303.04,0.00
2024-12-10 17:35:28,51,302,24,27,188.72,304.00,0.00
2024-12-10 17:35:28,52,302,24,28,185.09,304.02,0.00
2024-12-10 17:35:28,52,303,24,28,185.14,305.00,0.00
2024-12-10 17:35:28,53,303,25,28,181.65,305.02,0.00
2024-12-10 17:35:28,52,303,25,27,184.15,305.04,0.00
2024-12-10 17:35:28,51,303,24,27,185.37,305.39,0.00
2024-12-10 17:35:28,51,304,24,27,189.96,306.00,0.00
2024-12-10 17:35:28,52,304,24,28,186.30,306.02,0.00
2024-12-10 17:35:28,51,304,23,28,186.39,306.39,0.00
2024-12-10 17:35:28,51,305,23,28,191.00,307.00,0.00
2024-12-10 17:35:28,52,305,24,28,187.33,307.02,0.00
2024-12-10 17:35:28,51,305,24,27,189.98,307.04,0.00
2024-12-10 17:35:28,51,306,24,27,191.26,308.00,0.00
2024-12-10 17:35:28,52,306,25,27,187.58,308.02,0.00
2024-12-10 17:35:28,52,307,25,27,187.61,309.00,0.00
2024-12-10 17:35:28,53,307,26,27,184.07,309.02,0.00
2024-12-10 17:35:28,52,307,26,26,186.67,309.04,0.00
2024-12-10 17:35:28,51,307,25,26,190.28,309.06,0.00
2024-12-10 17:35:28,51,308,25,26,191.61,310.00,0.00
2024-12-10 17:35:28,52,308,26,26,187.92,310.02,0.00
2024-12-10 17:35:29,52,309,26,26,189.31,311.00,0.00
2024-12-10 17:35:29,53,309,26,27,185.74,311.02,0.00
2024-12-10 17:35:29,53,310,26,27,186.17,312.00,0.00
2024-12-10 17:35:29,54,310,27,27,182.72,312.02,0.00
2024-12-10 17:35:29,53,310,26,27,182.66,312.83,0.00
2024-12-10 17:35:29,53,311,26,27,188.17,313.00,0.00
2024-12-10 17:35:29,54,311,27,27,184.68,313.02,0.00
2024-12-10 17:35:29,53,311,27,26,187.88,313.04,0.00
2024-12-10 17:35:29,53,312,27,26,189.01,314.00,0.00
2024-12-10 17:35:29,54,312,28,26,185.51,314.02,0.00
2024-12-10 17:35:29,54,313,28,26,185.46,315.00,0.00
2024-12-10 17:35:29,55,313,28,27,182.08,315.02,0.00
2024-12-10 17:35:29,54,313,28,26,184.53,315.04,0.00
2024-12-10 17:35:29,53,313,27,26,187.90,315.08,0.00
2024-12-10 17:35:29,52,313,26,26,189.30,315.75,0.00
2024-12-10 17:35:29,52,314,26,26,194.78,316.00,0.00
2024-12-10 17:35:29,53,314,26,27,191.10,316.02,0.00
2024-12-10 17:35:29,53,315,26,27,191.12,317.00,0.00
2024-12-10 17:35:29,54,315,26,28,187.58,317.02,0.00
2024-12-10 17:35:29,53,315,26,27,190.00,317.06,0.00
2024-12-10 17:35:29,52,315,25,27,193.58,317.06,0.00
2024-12-10 17:35:29,52,316,25,27,197.30,318.00,0.00
2024-12-10 17:35:29,53,316,25,28,193.57,318.02,0.00
2024-12-10 17:35:29,53,317,25,28,193.69,319.00,0.00
2024-12-10 17:35:29,54,317,25,29,190.10,319.02,0.00
2024-12-10 17:35:29,53,317,25,28,192.44,319.06,0.00
2024-12-10 17:35:29,52,317,24,28,192.19,319.60,0.00
2024-12-10 17:35:29,52,318,24,28,197.37,320.00,0.00
2024-12-10 17:35:29,53,318,24,29,193.64,320.02,0.00
2024-12-10 17:35:29,52,318,23,29,196.38,320.02,0.00
2024-12-10 17:35:29,52,319,23,29,198.79,321.00,0.00
2024-12-10 17:35:29,53,319,23,30,195.04,321.02,0.00
2024-12-10 17:35:29,52,319,23,29,197.62,321.04,0.00
2024-12-10 17:35:29,51,319,22,29,201.44,321.06,0.00
2024-12-10 17:35:29,50,319,21,29,201.82,321.56,0.00
2024-12-10 17:35:29,50,320,21,29,207.19,322.00,0.00
2024-12-10 17:35:29,51,320,22,29,203.13,322.02,0.00
2024-12-10 17:35:29,51,321,22,29,203.13,323.00,0.00
2024-12-10 17:35:29,52,321,22,30,199.22,323.02,0.00
2024-12-10 17:35:29,51,321,22,29,201.99,323.04,0.00
2024-12-10 17:35:29,51,322,22,29,203.31,324.00,0.00
2024-12-10 17:35:29,52,322,22,30,199.40,324.02,0.00
2024-12-10 17:35:29,52,323,22,30,199.44,325.00,0.00
2024-12-10 17:35:29,53,323,23,30,195.68,325.02,0.00
2024-12-10 17:35:29,52,323,23,29,198.32,325.04,0.00
2024-12-10 17:35:29,51,323,22,29,200.36,325.63,0.00
2024-12-10 17:35:29,51,324,22,29,205.83,326.00,0.00
2024-12-10 17:35:29,52,324,22,30,201.87,326.02,0.00
2024-12-10 17:35:29,52,325,22,30,201.87,327.00,0.00
2024-12-10 17:35:29,53,325,22,31,198.06,327.02,0.00
2024-12-10 17:35:29,52,325,22,30,200.80,327.04,0.00
2024-12-10 17:35:29,52,326,22,30,202.04,328.00,0.00
2024-12-10 17:35:29,53,326,23,30,198.23,328.02,0.00
2024-12-10 17:35:29,53,327,23,30,198.28,329.00,0.00
2024-12-10 17:35:29,54,327,24,30,194.61,329.02,0.00
2024-12-10 17:35:29,53,327,24,29,197.17,329.06,0.00
2024-12-10 17:35:29,52,327,23,29,200.28,329.12,0.00
2024-12-10 17:35:29,52,328,23,29,204.29,330.00,0.00
2024-12-10 17:35:29,53,328,24,29,200.43,330.02,0.00
2024-12-10 17:35:29,53,329,24,29,200.62,331.00,0.00
2024-12-10 17:35:29,54,329,24,30,196.91,331.02,0.00
2024-12-10 17:35:29,53,329,24,29,199.26,331.08,0.00
2024-12-10 17:35:29,53,330,24,29,200.54,332.00,0.00
2024-12-10 17:35:29,54,330,24,30,196.83,332.02,0.00
2024-12-10 17:35:29,53,330,23,30,198.48,332.04,0.00
2024-12-10 17:35:29,52,330,22,30,202.29,332.04,0.00
2024-12-10 17:35:29,51,330,21,30,203.41,332.59,0.00
2024-12-10 17:35:29,51,331,21,30,208.89,333.00,0.00
2024-12-10 17:35:29,52,331,21,31,204.87,333.02,0.00
2024-12-10 17:35:29,51,331,21,30,207.59,333.04,0.00
2024-12-10 17:35:29,51,332,21,30,208.93,334.00,0.00
2024-12-10 17:35:29,52,332,22,30,204.91,334.02,0.00
2024-12-10 17:35:29,52,333,22,30,205.18,335.00,0.00
2024-12-10 17:35:29,53,333,23,30,201.30,335.02,0.00
2024-12-10 17:35:29,52,333,23,29,203.76,335.04,0.00
2024-12-10 17:35:29,52,334,23,29,205.01,336.00,0.00
2024-12-10 17:35:29,53,334,23,30,201.15,336.02,0.00
2024-12-10 17:35:29,53,335,23,30,201.38,337.00,0.00
2024-12-10 17:35:29,54,335,24,30,197.65,337.02,0.00
2024-12-10 17:35:29,53,335,24,29,200.05,337.04,0.00
2024-12-10 17:35:29,52,335,23,29,203.89,337.04,0.00
2024-12-10 17:35:29,51,335,22,29,206.33,337.18,0.00
2024-12-10 17:35:29,51,336,22,29,210.74,338.00,0.00
2024-12-10 17:35:29,52,336,23,29,206.68,338.02,0.00
2024-12-10 17:35:29,51,336,22,29,208.15,338.14,0.00
2024-12-10 17:35:29,51,337,22,29,212.45,339.00,0.00
2024-12-10 17:35:29,52,337,22,30,208.36,339.02,0.00
2024-12-10 17:35:29,51,337,22,29,211.06,339.04,0.00
2024-12-10 17:35:29,51,338,22,29,212.41,340.00,0.00
2024-12-10 17:35:29,52,338,22,30,208.33,340.02,0.00
2024-12-10 17:35:29,51,338,21,30,212.22,340.04,0.00
2024-12-10 17:35:29,51,339,21,30,214.92,341.00,0.00
2024-12-10 17:35:29,52,339,22,30,210.78,341.02,0.00
2024-12-10 17:35:29,52,340,22,30,210.68,342.00,0.00
2024-12-10 17:35:29,53,340,22,31,206.70,342.02,0.00
2024-12-10 17:35:29,52,340,22,30,210.55,342.04,0.00
2024-12-10 17:35:29,52,341,22,30,211.82,343.00,0.00
2024-12-10 17:35:29,53,341,23,30,207.83,343.02,0.00
2024-12-10 17:35:29,52,341,22,30,208.78,343.62,0.00
2024-12-10 17:35:29,52,342,22,30,212.05,344.00,0.00
2024-12-10 17:35:29,53,342,23,30,208.05,344.02,0.00
2024-12-10 17:35:29,52,342,23,29,210.66,344.04,0.00
2024-12-10 17:35:29,52,343,23,29,211.94,345.00,0.00
2024-12-10 17:35:29,53,343,24,29,207.94,345.02,0.00
2024-12-10 17:35:29,53,344,24,29,208.03,346.00,0.00
2024-12-10 17:35:29,54,344,25,29,204.18,346.02,0.00
2024-12-10 17:35:29,53,344,25,28,206.72,346.04,0.00
2024-12-10 17:35:30,53,345,25,28,207.91,347.00,0.00
2024-12-10 17:35:30,54,345,26,28,204.06,347.02,0.00
2024-12-10 17:35:30,55,344,27,28,197.83,347.47,0.00
2024-12-10 17:35:30,54,344,26,28,200.98,347.91,0.00
2024-12-10 17:35:30,54,345,26,28,207.16,348.00,0.00
2024-12-10 17:35:30,55,345,27,28,203.39,348.02,0.00
2024-12-10 17:35:30,54,345,27,27,205.87,348.04,0.00
2024-12-10 17:35:30,54,346,27,27,213.44,349.00,0.00
2024-12-10 17:35:30,55,346,27,28,209.56,349.02,0.00
2024-12-10 17:35:30,55,347,27,28,209.74,350.00,0.00
2024-12-10 17:35:30,56,347,28,28,206.00,350.02,0.00
2024-12-10 17:35:30,55,347,27,28,209.68,350.02,0.00
2024-12-10 17:35:30,55,348,27,28,209.39,351.00,0.00
2024-12-10 17:35:30,56,348,28,28,205.65,351.02,0.00
2024-12-10 17:35:30,55,348,27,28,209.21,351.05,0.00
2024-12-10 17:35:30,54,348,27,27,212.95,351.06,0.00
2024-12-10 17:35:30,54,349,27,27,214.13,352.00,0.00
2024-12-10 17:35:30,55,349,28,27,210.24,352.02,0.00
2024-12-10 17:35:30,55,350,28,27,210.30,353.00,0.00
2024-12-10 17:35:30,56,350,28,28,206.55,353.02,0.00
2024-12-10 17:35:30,55,350,28,27,208.84,353.05,0.00
2024-12-10 17:35:30,55,351,28,27,209.93,354.00,0.00
2024-12-10 17:35:30,56,351,29,27,206.18,354.02,0.00
2024-12-10 17:35:30,56,352,29,27,206.20,355.00,0.00
2024-12-10 17:35:30,57,352,30,27,202.59,355.02,0.00
2024-12-10 17:35:30,56,352,29,27,206.19,355.02,0.00
2024-12-10 17:35:30,55,352,29,26,208.59,355.04,0.00
2024-12-10 17:35:30,55,353,29,26,212.22,356.00,0.00
2024-12-10 17:35:30,56,353,30,26,208.43,356.02,0.00
2024-12-10 17:35:30,56,354,30,26,208.61,357.00,0.00
2024-12-10 17:35:30,57,354,30,27,204.95,357.02,0.00
2024-12-10 17:35:30,56,354,29,27,207.82,357.05,0.00
2024-12-10 17:35:30,55,354,28,27,208.87,357.51,0.00
2024-12-10 17:35:30,55,355,28,27,213.96,358.00,0.00
2024-12-10 17:35:30,56,355,29,27,210.14,358.02,0.00
2024-12-10 17:35:30,55,355,29,26,213.72,358.05,0.00
2024-12-10 17:35:30,54,355,28,26,215.82,358.65,0.00
2024-12-10 17:35:30,54,356,28,26,218.80,359.00,0.00
2024-12-10 17:35:30,55,356,28,27,214.82,359.02,0.00
2024-12-10 17:35:30,55,357,28,27,214.90,360.00,0.00
2024-12-10 17:35:30,56,357,29,27,211.06,360.02,0.00
2024-12-10 17:35:30,55,357,28,27,212.32,360.13,0.00
2024-12-10 17:35:30,55,358,28,27,216.28,361.00,0.00
2024-12-10 17:35:30,56,358,29,27,212.42,361.02,0.00
2024-12-10 17:35:30,55,358,29,26,216.10,361.05,0.00
2024-12-10 17:35:30,55,359,29,26,217.21,362.00,0.00
2024-12-10 17:35:30,56,359,30,26,213.33,362.02,0.00
2024-12-10 17:35:30,55,359,29,26,212.61,362.45,0.00
2024-12-10 17:35:30,55,360,29,26,217.61,363.00,0.00
2024-12-10 17:35:30,56,360,29,27,213.73,363.02,0.00
2024-12-10 17:35:30,55,360,29,26,216.11,363.05,0.00
2024-12-10 17:35:30,55,361,29,26,217.22,364.00,0.00
2024-12-10 17:35:30,56,361,29,27,213.34,364.02,0.00
2024-12-10 17:35:30,55,361,28,27,212.96,364.36,0.00
2024-12-10 17:35:30,55,362,28,27,217.70,365.00,0.00
2024-12-10 17:35:30,56,362,28,28,213.82,365.02,0.00
2024-12-10 17:35:30,55,362,28,27,216.26,365.05,0.00
2024-12-10 17:35:30,55,363,28,27,217.37,366.00,0.00
2024-12-10 17:35:30,56,363,29,27,213.49,366.02,0.00
2024-12-10 17:35:30,56,364,29,27,213.52,367.00,0.00
2024-12-10 17:35:30,57,364,29,28,209.78,367.02,0.00
2024-12-10 17:35:30,56,364,29,27,212.09,367.05,0.00
2024-12-10 17:35:30,56,365,29,27,213.12,368.00,0.00
2024-12-10 17:35:30,57,365,30,27,209.38,368.02,0.00
2024-12-10 17:35:30,56,365,29,27,211.09,368.04,0.00
2024-12-10 17:35:30,56,366,29,27,213.37,369.00,0.00
2024-12-10 17:35:30,57,366,30,27,209.63,369.02,0.00
2024-12-10 17:35:30,56,366,29,27,213.31,369.04,0.00
2024-12-10 17:35:30,56,367,29,27,212.96,370.00,0.00
2024-12-10 17:35:30,57,367,30,27,209.22,370.02,0.00
2024-12-10 17:35:30,56,367,30,26,212.70,370.05,0.00
2024-12-10 17:35:30,56,368,30,26,213.73,371.00,0.00
2024-12-10 17:35:30,57,368,31,26,209.98,371.02,0.00
2024-12-10 17:35:30,57,369,31,26,210.23,372.00,0.00
2024-12-10 17:35:30,58,369,31,27,206.60,372.02,0.00
2024-12-10 17:35:30,58,370,31,27,206.06,373.00,0.00
2024-12-10 17:35:30,59,370,32,27,202.57,373.02,0.00
2024-12-10 17:35:30,58,370,31,27,205.94,373.05,0.00
2024-12-10 17:35:30,57,370,31,26,209.24,373.09,0.00
2024-12-10 17:35:30,56,370,30,26,211.20,373.64,0.00
2024-12-10 17:35:30,56,371,30,26,214.13,374.00,0.00
2024-12-10 17:35:30,57,371,30,27,210.37,374.02,0.00
2024-12-10 17:35:30,57,372,30,27,211.74,375.00,0.00
2024-12-10 17:35:30,58,372,31,27,208.09,375.02,0.00
2024-12-10 17:35:30,58,373,31,27,208.71,376.00,0.00
2024-12-10 17:35:30,59,373,31,28,205.17,376.02,0.00
2024-12-10 17:35:30,58,373,30,28,204.32,376.74,0.00
2024-12-10 17:35:30,58,374,30,28,210.03,377.00,0.00
2024-12-10 17:35:30,59,374,30,29,206.47,377.02,0.00
2024-12-10 17:35:30,58,374,30,28,209.07,377.09,0.00
2024-12-10 17:35:30,58,375,30,28,210.06,378.00,0.00
2024-12-10 17:35:30,59,375,31,28,206.50,378.02,0.00
2024-12-10 17:35:30,58,375,30,28,206.82,378.59,0.00
2024-12-10 17:35:30,58,376,30,28,210.06,379.00,0.00
2024-12-10 17:35:30,59,376,31,28,206.50,379.02,0.00
2024-12-10 17:35:30,58,376,31,27,208.58,379.09,0.00
2024-12-10 17:35:30,58,377,31,27,209.57,380.00,0.00
2024-12-10 17:35:30,59,377,31,28,206.02,380.02,0.00
2024-12-10 17:35:30,58,377,30,28,208.91,380.02,0.00
2024-12-10 17:35:30,58,378,30,28,210.97,381.00,0.00
2024-12-10 17:35:30,59,378,30,29,207.40,381.02,0.00
2024-12-10 17:35:30,58,378,30,28,209.61,381.07,0.00
2024-12-10 17:35:30,58,379,30,28,210.54,382.00,0.00
2024-12-10 17:35:30,59,379,30,29,206.97,382.02,0.00
2024-12-10 17:35:30,58,379,29,29,208.70,382.02,0.00
2024-12-10 17:35:31,58,380,29,29,210.76,383.00,0.00
2024-12-10 17:35:31,59,380,30,29,207.19,383.02,0.00
2024-12-10 17:35:31,58,380,29,29,208.59,383.03,0.00
2024-12-10 17:35:31,57,380,29,28,211.10,383.04,0.00
2024-12-10 17:35:31,57,381,29,28,214.68,384.00,0.00
2024-12-10 17:35:31,58,381,30,28,210.98,384.02,0.00
2024-12-10 17:35:31,58,382,30,28,210.85,385.00,0.00
2024-12-10 17:35:31,59,382,30,29,207.28,385.02,0.00
2024-12-10 17:35:31,58,382,30,28,209.73,385.03,0.00
2024-12-10 17:35:31,58,383,30,28,210.53,386.00,0.00
2024-12-10 17:35:31,59,383,30,29,206.96,386.02,0.00
2024-12-10 17:35:31,59,384,30,29,206.77,387.00,0.00
2024-12-10 17:35:31,60,384,31,29,203.33,387.02,0.00
2024-12-10 17:35:31,59,384,31,28,205.73,387.03,0.00
2024-12-10 17:35:31,58,384,30,28,206.46,387.69,0.00
2024-12-10 17:35:31,58,385,30,28,212.16,388.00,0.00
2024-12-10 17:35:31,59,385,31,28,208.56,388.02,0.00
2024-12-10 17:35:31,59,386,31,28,208.39,389.00,0.00
2024-12-10 17:35:31,60,386,32,28,204.92,389.02,0.00
2024-12-10 17:35:31,59,386,32,27,207.34,389.03,0.00
2024-12-10 17:35:31,59,387,32,27,208.07,390.00,0.00
2024-12-10 17:35:31,60,387,33,27,204.60,390.02,0.00
2024-12-10 17:35:31,59,387,32,27,206.22,390.08,0.00
2024-12-10 17:35:31,59,388,32,27,209.77,391.00,0.00
2024-12-10 17:35:31,60,388,33,27,206.28,391.02,0.00
2024-12-10 17:35:31,59,388,33,26,208.78,391.03,0.00
2024-12-10 17:35:31,58,388,32,26,210.11,391.67,0.00
2024-12-10 17:35:31,58,389,32,26,213.13,392.00,0.00
2024-12-10 17:35:31,59,389,33,26,209.51,392.02,0.00
2024-12-10 17:35:31,59,390,33,26,209.29,393.00,0.00
2024-12-10 17:35:31,60,390,33,27,205.80,393.02,0.00
2024-12-10 17:35:31,59,390,33,26,208.29,393.03,0.00
2024-12-10 17:35:31,59,391,33,26,209.02,394.00,0.00
2024-12-10 17:35:31,60,391,33,27,205.54,394.02,0.00
2024-12-10 17:35:31,60,392,33,27,205.27,395.00,0.00
2024-12-10 17:35:31,61,392,34,27,201.91,395.02,0.00
2024-12-10 17:35:31,60,392,34,26,204.35,395.03,0.00
2024-12-10 17:35:31,59,392,33,26,207.63,395.08,0.00
2024-12-10 17:35:31,59,393,33,26,208.54,396.00,0.00
2024-12-10 17:35:31,60,393,33,27,205.06,396.02,0.00
2024-12-10 17:35:31,60,394,33,27,204.90,397.00,0.00
2024-12-10 17:35:31,61,394,33,28,201.54,397.02,0.00
2024-12-10 17:35:31,60,394,33,27,203.85,397.03,0.00
2024-12-10 17:35:31,59,394,32,27,204.25,397.69,0.00
2024-12-10 17:35:31,59,395,32,27,210.00,398.00,0.00
2024-12-10 17:35:31,60,395,33,27,206.50,398.02,0.00
2024-12-10 17:35:31,59,395,32,27,204.57,398.85,0.00
2024-12-10 17:35:31,59,396,32,27,210.82,399.00,0.00
2024-12-10 17:35:31,60,396,33,27,207.31,399.02,0.00
2024-12-10 17:35:31,59,396,33,26,209.81,399.03,0.00
2024-12-10 17:35:31,59,397,33,26,210.54,400.00,0.00
2024-12-10 17:35:31,60,397,34,26,207.03,400.02,0.00
2024-12-10 17:35:31,60,398,34,26,206.80,401.00,0.00
2024-12-10 17:35:31,61,398,34,27,203.41,401.02,0.00
2024-12-10 17:35:31,60,398,34,26,205.87,401.03,0.00
2024-12-10 17:35:31,59,398,33,26,207.57,401.53,0.00
2024-12-10 17:35:31,59,399,33,26,210.08,402.00,0.00
2024-12-10 17:35:31,60,399,33,27,206.57,402.02,0.00
2024-12-10 17:35:31,59,399,32,27,207.60,402.20,0.00
2024-12-10 17:35:31,59,400,32,27,211.69,403.00,0.00
2024-12-10 17:35:31,60,400,32,28,208.16,403.02,0.00
2024-12-10 17:35:31,59,400,32,27,210.60,403.05,0.00
2024-12-10 17:35:31,58,400,31,27,211.80,403.05,0.00
2024-12-10 17:35:31,58,401,31,27,215.46,404.00,0.00
2024-12-10 17:35:31,59,401,32,27,211.81,404.02,0.00
2024-12-10 17:35:31,58,401,31,27,213.74,404.10,0.00
2024-12-10 17:35:31,58,402,31,27,215.41,405.00,0.00
2024-12-10 17:35:31,59,402,31,28,211.76,405.02,0.00
2024-12-10 17:35:31,58,402,31,27,214.23,405.05,0.00
2024-12-10 17:35:31,57,402,30,27,215.12,405.33,0.00
2024-12-10 17:35:31,57,403,30,27,219.97,406.00,0.00
2024-12-10 17:35:31,58,403,30,28,216.17,406.02,0.00
2024-12-10 17:35:31,57,403,29,28,218.20,406.11,0.00
2024-12-10 17:35:31,57,404,29,28,219.91,407.00,0.00
2024-12-10 17:35:31,58,404,30,28,216.12,407.02,0.00
2024-12-10 17:35:31,57,404,30,27,218.77,407.05,0.00
2024-12-10 17:35:31,57,405,30,27,219.73,408.00,0.00
2024-12-10 17:35:31,58,405,30,28,215.95,408.02,0.00
2024-12-10 17:35:31,57,405,29,28,216.73,408.44,0.00
2024-12-10 17:35:31,56,405,28,28,217.11,408.95,0.00
2024-12-10 17:35:31,56,406,28,28,224.23,409.00,0.00
2024-12-10 17:35:31,57,406,29,28,220.30,409.02,0.00
2024-12-10 17:35:31,56,406,29,27,223.07,409.05,0.00
2024-12-10 17:35:31,55,406,28,27,227.11,409.05,0.00
2024-12-10 17:35:31,55,407,28,27,228.26,410.00,0.00
2024-12-10 17:35:31,56,407,28,28,224.18,410.02,0.00
2024-12-10 17:35:31,56,408,28,28,224.33,411.00,0.00
2024-12-10 17:35:31,57,408,29,28,220.39,411.02,0.00
2024-12-10 17:35:31,56,408,29,27,222.59,411.11,0.00
2024-12-10 17:35:31,55,408,28,27,226.64,411.11,0.00
2024-12-10 17:35:31,54,408,27,27,227.05,411.80,0.00
2024-12-10 17:35:31,54,409,27,27,234.00,412.00,0.00
2024-12-10 17:35:31,55,409,28,27,229.74,412.02,0.00
2024-12-10 17:35:31,54,409,27,27,231.81,412.13,0.00
2024-12-10 17:35:31,54,410,27,27,236.40,413.00,0.00
2024-12-10 17:35:31,55,410,28,27,232.10,413.02,0.00
2024-12-10 17:35:31,54,410,27,27,236.33,413.02,0.00
2024-12-10 17:35:31,53,410,27,26,238.86,413.09,0.00
2024-12-10 17:35:32,53,411,27,26,240.35,414.00,0.00
2024-12-10 17:35:32,54,411,28,26,235.90,414.02,0.00
2024-12-10 17:35:32,53,411,27,26,239.76,414.11,0.00
2024-12-10 17:35:32,53,412,27,26,242.89,415.00,0.00
2024-12-10 17:35:32,54,412,27,27,238.39,415.02,0.00
2024-12-10 17:35:32,54,413,27,27,237.97,416.00,0.00
2024-12-10 17:35:32,55,413,28,27,233.64,416.02,0.00
2024-12-10 17:35:32,54,413,28,26,237.45,416.11,0.00
2024-12-10 17:35:32,54,414,28,26,238.92,417.00,0.00
2024-12-10 17:35:32,55,414,28,27,234.58,417.02,0.00
2024-12-10 17:35:32,54,414,27,27,233.15,417.54,0.00
2024-12-10 17:35:32,54,415,27,27,239.28,418.00,0.00
2024-12-10 17:35:32,55,415,28,27,234.93,418.02,0.00
2024-12-10 17:35:32,54,415,27,27,233.89,418.37,0.00
2024-12-10 17:35:32,54,416,27,27,239.45,419.00,0.00
2024-12-10 17:35:32,55,416,28,27,235.09,419.02,0.00
2024-12-10 17:35:32,54,416,28,26,238.94,419.13,0.00
2024-12-10 17:35:32,54,417,28,26,240.48,420.00,0.00
2024-12-10 17:35:32,55,417,29,26,236.11,420.02,0.00
2024-12-10 17:35:32,54,417,28,26,239.82,420.13,0.00
2024-12-10 17:35:32,54,418,28,26,242.93,421.00,0.00
2024-12-10 17:35:32,55,418,28,27,238.51,421.02,0.00
2024-12-10 17:35:32,55,419,28,27,238.00,422.00,0.00
2024-12-10 17:35:32,56,419,29,27,233.75,422.02,0.00
2024-12-10 17:35:32,55,419,29,26,237.42,422.13,0.00
2024-12-10 17:35:32,55,420,29,26,238.88,423.00,0.00
2024-12-10 17:35:32,56,420,29,27,234.61,423.02,0.00
2024-12-10 17:35:32,55,420,28,27,233.52,423.45,0.00
2024-12-10 17:35:32,55,421,28,27,239.29,424.00,0.00
2024-12-10 17:35:32,56,421,28,28,235.01,424.02,0.00
2024-12-10 17:35:32,55,421,28,27,237.23,424.13,0.00
2024-12-10 17:35:32,55,422,28,27,238.69,425.00,0.00
2024-12-10 17:35:32,56,422,29,27,234.43,425.02,0.00
2024-12-10 17:35:32,55,422,28,27,233.44,425.44,0.00
2024-12-10 17:35:32,55,423,28,27,239.18,426.00,0.00
2024-12-10 17:35:32,56,423,29,27,234.90,426.02,0.00
2024-12-10 17:35:32,55,423,29,26,237.19,426.13,0.00
2024-12-10 17:35:32,54,423,28,26,241.50,426.13,0.00
2024-12-10 17:35:32,54,424,28,26,243.07,427.00,0.00
2024-12-10 17:35:32,55,424,28,27,238.65,427.02,0.00
2024-12-10 17:35:32,55,425,28,27,238.84,428.00,0.00
2024-12-10 17:35:32,56,425,29,27,234.57,428.02,0.00
2024-12-10 17:35:32,55,425,29,26,236.83,428.13,0.00
2024-12-10 17:35:32,55,426,29,26,238.30,429.00,0.00
2024-12-10 17:35:32,56,426,30,26,234.05,429.02,0.00
2024-12-10 17:35:32,56,427,30,26,234.41,430.00,0.00
2024-12-10 17:35:32,57,427,30,27,230.30,430.02,0.00
2024-12-10 17:35:32,57,428,30,27,229.62,431.00,0.00
2024-12-10 17:35:32,58,428,31,27,225.66,431.02,0.00
2024-12-10 17:35:32,57,428,31,26,228.97,431.14,0.00
2024-12-10 17:35:32,57,429,31,26,230.31,432.00,0.00
2024-12-10 17:35:32,58,429,31,27,226.34,432.02,0.00
2024-12-10 17:35:32,58,430,31,27,226.61,433.00,0.00
2024-12-10 17:35:32,59,430,31,28,222.77,433.02,0.00
2024-12-10 17:35:32,59,431,31,28,221.97,434.00,0.00
2024-12-10 17:35:32,60,431,32,28,218.27,434.02,0.00
2024-12-10 17:35:32,59,431,32,27,221.40,434.14,0.00
2024-12-10 17:35:32,58,431,31,27,223.09,434.67,0.00
2024-12-10 17:35:32,57,431,30,27,223.99,434.91,0.00
2024-12-10 17:35:32,57,432,30,27,231.30,435.00,0.00
2024-12-10 17:35:32,58,432,30,28,227.31,435.02,0.00
2024-12-10 17:35:32,57,432,29,28,231.22,435.02,0.00
2024-12-10 17:35:32,57,433,29,28,231.53,436.00,0.00
2024-12-10 17:35:32,58,433,30,28,227.54,436.02,0.00
2024-12-10 17:35:32,57,433,30,27,229.41,436.14,0.00
2024-12-10 17:35:32,57,434,30,27,230.76,437.00,0.00
2024-12-10 17:35:32,58,434,31,27,226.78,437.02,0.00
2024-12-10 17:35:32,57,434,30,27,225.76,437.42,0.00
2024-12-10 17:35:32,57,435,30,27,231.29,438.00,0.00
2024-12-10 17:35:32,58,435,30,28,227.30,438.02,0.00
2024-12-10 17:35:32,57,435,30,27,229.23,438.14,0.00
2024-12-10 17:35:32,56,435,29,27,230.52,438.34,0.00
2024-12-10 17:35:32,56,436,29,27,235.89,439.00,0.00
2024-12-10 17:35:32,57,436,30,27,231.75,439.02,0.00
2024-12-10 17:35:32,56,436,29,27,231.59,439.27,0.00
2024-12-10 17:35:32,56,437,29,27,236.69,440.00,0.00
2024-12-10 17:35:32,57,437,30,27,232.54,440.02,0.00
2024-12-10 17:35:32,56,437,30,26,234.51,440.14,0.00
2024-12-10 17:35:32,55,437,29,26,236.65,440.67,0.00
2024-12-10 17:35:32,55,438,29,26,240.26,441.00,0.00
2024-12-10 17:35:32,56,438,30,26,235.97,441.02,0.00
2024-12-10 17:35:32,55,438,29,26,234.87,441.80,0.00
2024-12-10 17:35:32,55,439,29,26,242.17,442.00,0.00
2024-12-10 17:35:32,56,439,30,26,237.85,442.02,0.00
2024-12-10 17:35:32,55,439,30,25,240.02,442.15,0.00
2024-12-10 17:35:32,55,440,30,25,241.59,443.00,0.00
2024-12-10 17:35:32,56,440,31,25,237.28,443.02,0.00
2024-12-10 17:35:32,55,440,30,25,235.50,443.55,0.00
2024-12-10 17:35:32,55,441,30,25,241.88,444.00,0.00
2024-12-10 17:35:32,56,441,31,25,237.57,444.02,0.00
2024-12-10 17:35:32,55,441,31,24,239.80,444.15,0.00
2024-12-10 17:35:32,55,442,31,24,241.38,445.00,0.00
2024-12-10 17:35:32,56,442,32,24,237.07,445.02,0.00
2024-12-10 17:35:32,55,442,31,24,240.89,445.13,0.00
2024-12-10 17:35:32,54,442,30,24,245.28,445.15,0.00
2024-12-10 17:35:32,54,443,30,24,246.29,446.00,0.00
2024-12-10 17:35:32,55,443,30,25,241.81,446.02,0.00
2024-12-10 17:35:32,54,443,29,25,246.21,446.02,0.00
2024-12-10 17:35:32,53,443,29,24,248.68,446.13,0.00
2024-12-10 17:35:32,53,444,29,24,250.40,447.00,0.00
2024-12-10 17:35:32,54,444,29,25,245.77,447.02,0.00
2024-12-10 17:35:32,53,444,28,25,250.32,447.02,0.00
2024-12-10 17:35:32,52,444,27,25,252.82,447.08,0.00
2024-12-10 17:35:32,52,445,27,25,256.14,448.00,0.00
2024-12-10 17:35:32,53,445,27,26,251.30,448.02,0.00
2024-12-10 17:35:32,52,445,26,26,256.05,448.02,0.00
2024-12-10 17:35:32,51,445,26,25,259.15,448.08,0.00
2024-12-10 17:35:32,50,445,25,25,259.98,448.38,0.00
2024-12-10 17:35:32,50,446,25,25,266.61,449.00,0.00
2024-12-10 17:35:32,51,446,26,25,261.38,449.02,0.00
2024-12-10 17:35:33,51,447,26,25,262.00,450.00,0.00
2024-12-10 17:35:33,52,447,27,25,256.96,450.02,0.00
2024-12-10 17:35:33,52,448,27,25,256.58,451.00,0.00
2024-12-10 17:35:33,53,448,27,26,251.74,451.02,0.00
2024-12-10 17:35:33,52,448,27,25,255.98,451.10,0.00
2024-12-10 17:35:33,52,449,27,25,257.67,452.00,0.00
2024-12-10 17:35:33,53,449,28,25,252.81,452.02,0.00
2024-12-10 17:35:33,53,450,28,25,253.25,453.00,0.00
2024-12-10 17:35:33,54,450,29,25,248.56,453.02,0.00
2024-12-10 17:35:33,53,450,28,25,253.01,453.08,0.00
2024-12-10 17:35:33,53,451,28,25,252.79,454.00,0.00
2024-12-10 17:35:33,54,451,29,25,248.10,454.02,0.00
2024-12-10 17:35:33,53,451,29,24,252.45,454.08,0.00
2024-12-10 17:35:33,52,451,28,24,251.46,454.94,0.00
2024-12-10 17:35:33,52,452,28,24,259.99,455.00,0.00
2024-12-10 17:35:33,53,452,28,25,255.08,455.02,0.00
2024-12-10 17:35:33,52,452,27,25,259.90,455.02,0.00
2024-12-10 17:35:33,52,453,27,25,260.38,456.00,0.00
2024-12-10 17:35:33,53,453,27,26,255.46,456.02,0.00
2024-12-10 17:35:33,52,453,27,25,258.36,456.06,0.00
2024-12-10 17:35:33,52,454,27,25,259.89,457.00,0.00
2024-12-10 17:35:33,53,454,27,26,254.99,457.02,0.00
2024-12-10 17:35:33,52,454,26,26,254.75,457.63,0.00
2024-12-10 17:35:33,52,455,26,26,262.14,458.00,0.00
2024-12-10 17:35:33,53,455,26,27,257.20,458.02,0.00
2024-12-10 17:35:33,52,455,25,27,262.06,458.02,0.00
2024-12-10 17:35:33,51,455,25,26,265.31,458.04,0.00
2024-12-10 17:35:33,50,455,24,26,267.53,458.32,0.00
2024-12-10 17:35:33,50,456,24,26,274.05,459.00,0.00
2024-12-10 17:35:33,51,456,24,27,268.68,459.02,0.00
2024-12-10 17:35:33,51,457,24,27,269.14,460.00,0.00
2024-12-10 17:35:33,52,457,24,28,263.97,460.02,0.00
2024-12-10 17:35:33,51,457,23,28,263.05,460.75,0.00
2024-12-10 17:35:33,51,458,23,28,271.11,461.00,0.00
2024-12-10 17:35:33,52,458,24,28,265.90,461.02,0.00
2024-12-10 17:35:33,51,458,24,27,270.85,461.06,0.00
2024-12-10 17:35:33,51,459,24,27,272.52,462.00,0.00
2024-12-10 17:35:33,52,459,25,27,267.28,462.02,0.00
2024-12-10 17:35:33,51,459,24,27,269.65,462.14,0.00
2024-12-10 17:35:33,51,460,24,27,275.29,463.00,0.00
2024-12-10 17:35:33,52,460,24,28,269.99,463.02,0.00
2024-12-10 17:35:33,52,461,24,28,269.59,464.00,0.00
2024-12-10 17:35:33,53,461,24,29,264.51,464.02,0.00
2024-12-10 17:35:33,52,461,24,28,268.91,464.12,0.00
2024-12-10 17:35:33,52,462,24,28,270.71,465.00,0.00
2024-12-10 17:35:33,53,462,25,28,265.60,465.02,0.00
2024-12-10 17:35:33,52,462,24,28,263.48,465.96,0.00
2024-12-10 17:35:33,52,463,24,28,272.28,466.00,0.00
2024-12-10 17:35:33,53,463,25,28,267.14,466.02,0.00
2024-12-10 17:35:33,53,464,25,28,266.66,467.00,0.00
2024-12-10 17:35:33,54,464,25,29,261.72,467.02,0.00
2024-12-10 17:35:33,53,464,25,28,266.07,467.11,0.00
2024-12-10 17:35:33,53,465,25,28,267.76,468.00,0.00
2024-12-10 17:35:33,54,465,26,28,262.80,468.02,0.00
2024-12-10 17:35:33,53,465,25,28,264.13,468.45,0.00
2024-12-10 17:35:33,53,466,25,28,268.22,469.00,0.00
2024-12-10 17:35:33,54,466,25,29,263.25,469.02,0.00
2024-12-10 17:35:33,53,466,24,29,263.57,469.68,0.00
2024-12-10 17:35:33,53,467,24,29,267.64,470.00,0.00
2024-12-10 17:35:33,54,467,24,30,262.68,470.02,0.00
2024-12-10 17:35:33,53,467,24,29,267.04,470.13,0.00
2024-12-10 17:35:33,53,468,24,29,268.83,471.00,0.00
2024-12-10 17:35:33,54,468,24,30,263.85,471.02,0.00
2024-12-10 17:35:33,53,468,23,30,268.67,471.04,0.00
2024-12-10 17:35:33,53,469,23,30,269.36,472.00,0.00
2024-12-10 17:35:33,54,469,23,31,264.37,472.02,0.00
2024-12-10 17:35:33,53,469,22,31,265.44,472.15,0.00
2024-12-10 17:35:33,53,470,22,31,270.88,473.00,0.00
2024-12-10 17:35:33,54,470,22,32,265.87,473.02,0.00
2024-12-10 17:35:33,53,470,21,32,269.90,473.02,0.00
2024-12-10 17:35:33,52,470,20,32,274.75,473.10,0.00
2024-12-10 17:35:33,51,470,20,31,279.86,473.10,0.00
2024-12-10 17:35:33,51,471,20,31,285.45,474.00,0.00
2024-12-10 17:35:33,52,471,21,31,279.96,474.02,0.00
2024-12-10 17:35:33,52,472,21,31,280.38,475.00,0.00
2024-12-10 17:35:33,53,472,22,31,275.09,475.02,0.00
2024-12-10 17:35:33,53,473,22,31,274.59,476.00,0.00
2024-12-10 17:35:33,54,473,22,32,269.50,476.02,0.00
2024-12-10 17:35:33,53,473,22,31,274.07,476.09,0.00
2024-12-10 17:35:33,53,474,22,31,275.70,477.00,0.00
2024-12-10 17:35:33,54,474,22,32,270.60,477.02,0.00
2024-12-10 17:35:33,53,474,21,32,269.32,477.85,0.00
2024-12-10 17:35:33,53,475,21,32,277.72,478.00,0.00
2024-12-10 17:35:33,54,475,22,32,272.58,478.02,0.00
2024-12-10 17:35:33,53,475,21,32,270.38,478.57,0.00
2024-12-10 17:35:33,53,476,21,32,277.67,479.00,0.00
2024-12-10 17:35:33,54,476,22,32,272.53,479.02,0.00
2024-12-10 17:35:33,53,476,22,31,276.98,479.11,0.00
2024-12-10 17:35:33,53,477,22,31,278.71,480.00,0.00
2024-12-10 17:35:33,54,477,23,31,273.54,480.02,0.00
2024-12-10 17:35:33,54,478,23,31,273.91,481.00,0.00
2024-12-10 17:35:33,55,478,23,32,268.93,481.02,0.00
2024-12-10 17:35:33,55,479,23,32,268.26,482.00,0.00
2024-12-10 17:35:33,56,479,24,32,263.47,482.02,0.00
2024-12-10 17:35:33,55,479,24,31,267.59,482.13,0.00
2024-12-10 17:35:33,55,480,24,31,269.17,483.00,0.00
2024-12-10 17:35:33,56,480,25,31,264.36,483.02,0.00
2024-12-10 17:35:33,56,481,25,31,264.59,484.00,0.00
2024-12-10 17:35:33,57,481,25,32,259.95,484.02,0.00
2024-12-10 17:35:33,56,481,25,31,262.28,484.13,0.00
2024-12-10 17:35:33,56,482,25,31,263.75,485.00,0.00
2024-12-10 17:35:33,57,482,26,31,259.13,485.02,0.00
2024-12-10 17:35:33,56,482,25,31,262.72,485.11,0.00
2024-12-10 17:35:34,55,482,24,31,263.20,485.67,0.00
2024-12-10 17:35:34,55,483,24,31,270.68,486.00,0.00
2024-12-10 17:35:34,56,483,25,31,265.85,486.02,0.00
2024-12-10 17:35:34,55,483,24,31,270.26,486.11,0.00
2024-12-10 17:35:34,54,483,23,31,272.27,486.37,0.00
2024-12-10 17:35:34,54,484,23,31,275.07,487.00,0.00
2024-12-10 17:35:34,55,484,24,31,270.06,487.02,0.00
2024-12-10 17:35:34,54,484,24,30,274.46,487.13,0.00
2024-12-10 17:35:34,54,485,24,30,276.17,488.00,0.00
2024-12-10 17:35:34,55,485,25,30,271.15,488.02,0.00
2024-12-10 17:35:34,55,486,25,30,271.38,489.00,0.00
2024-12-10 17:35:34,56,486,26,30,266.54,489.02,0.00
2024-12-10 17:35:34,56,487,26,30,265.77,490.00,0.00
2024-12-10 17:35:34,57,487,26,31,261.11,490.02,0.00
2024-12-10 17:35:34,56,487,26,30,265.18,490.13,0.00
2024-12-10 17:35:34,56,488,26,30,266.66,491.00,0.00
2024-12-10 17:35:34,57,488,27,30,261.99,491.02,0.00
2024-12-10 17:35:34,57,489,27,30,262.15,492.00,0.00
2024-12-10 17:35:34,58,489,27,31,257.63,492.02,0.00
2024-12-10 17:35:34,57,489,27,30,259.75,492.14,0.00
2024-12-10 17:35:34,57,490,27,30,261.22,493.00,0.00
2024-12-10 17:35:34,58,490,28,30,256.71,493.02,0.00
2024-12-10 17:35:34,58,491,28,30,256.82,494.00,0.00
2024-12-10 17:35:34,59,491,29,30,252.47,494.02,0.00
2024-12-10 17:35:34,58,491,29,29,254.54,494.14,0.00
2024-12-10 17:35:34,58,492,29,29,255.89,495.00,0.00
2024-12-10 17:35:34,59,492,29,30,251.56,495.02,0.00
2024-12-10 17:35:34,58,492,28,30,254.76,495.12,0.00
2024-12-10 17:35:34,58,493,28,30,257.75,496.00,0.00
2024-12-10 17:35:34,59,493,28,31,253.38,496.02,0.00
2024-12-10 17:35:34,58,493,28,30,255.53,496.12,0.00
2024-12-10 17:35:34,58,494,28,30,256.81,497.00,0.00
2024-12-10 17:35:34,59,494,28,31,252.46,497.02,0.00
2024-12-10 17:35:34,58,494,27,31,256.33,497.10,0.00
2024-12-10 17:35:34,58,495,27,31,257.01,498.00,0.00
2024-12-10 17:35:34,59,495,27,32,252.65,498.02,0.00
2024-12-10 17:35:34,58,495,27,31,254.70,498.12,0.00
2024-12-10 17:35:34,57,495,26,31,254.50,498.42,0.00
2024-12-10 17:35:34,57,496,26,31,260.73,499.00,0.00
2024-12-10 17:35:34,58,496,26,32,256.23,499.02,0.00
2024-12-10 17:35:34,58,497,26,32,256.81,500.00,0.00
2024-12-10 17:35:34,59,497,26,33,252.46,500.02,0.00
2024-12-10 17:35:34,58,497,25,33,255.03,500.10,0.00
2024-12-10 17:35:34,57,497,24,33,259.50,500.11,0.00
2024-12-10 17:35:34,56,497,23,33,259.77,500.66,0.00
2024-12-10 17:35:34,56,498,23,33,267.25,501.00,0.00
2024-12-10 17:35:34,57,498,24,33,262.56,501.02,0.00
2024-12-10 17:35:34,56,498,24,32,265.93,501.18,0.00
2024-12-10 17:35:34,56,499,24,32,267.70,502.00,0.00
2024-12-10 17:35:34,57,499,25,32,263.00,502.02,0.00
2024-12-10 17:35:34,56,499,25,31,267.61,502.02,0.00
2024-12-10 17:35:34,55,499,24,31,272.03,502.11,0.00
2024-12-10 17:35:34,56,498,24,32,261.44,502.54,0.00
2024-12-10 17:35:34,56,499,24,32,274.40,503.00,0.00
2024-12-10 17:35:34,57,499,25,32,269.59,503.02,0.00
2024-12-10 17:35:34,56,499,25,31,274.31,503.02,0.00
2024-12-10 17:35:34,56,500,25,31,282.62,504.00,0.00
2024-12-10 17:35:34,57,500,26,31,277.67,504.02,0.00
2024-12-10 17:35:34,56,500,25,31,282.19,504.11,0.00
2024-12-10 17:35:34,55,500,25,30,286.96,504.11,0.00
2024-12-10 17:35:34,55,501,25,30,288.52,505.00,0.00
2024-12-10 17:35:34,56,501,25,31,283.37,505.02,0.00
2024-12-10 17:35:34,55,501,25,30,288.43,505.02,0.00
2024-12-10 17:35:34,55,502,25,30,288.76,506.00,0.00
2024-12-10 17:35:34,56,502,25,31,283.60,506.02,0.00
2024-12-10 17:35:34,55,502,24,31,279.96,506.96,0.00
2024-12-10 17:35:34,55,503,24,31,289.02,507.00,0.00
2024-12-10 17:35:34,56,503,24,32,283.85,507.02,0.00
2024-12-10 17:35:34,55,503,24,31,288.48,507.09,0.00
2024-12-10 17:35:34,54,503,23,31,292.16,507.44,0.00
2024-12-10 17:35:34,54,504,23,31,295.35,508.00,0.00
2024-12-10 17:35:34,55,504,23,32,289.98,508.02,0.00
2024-12-10 17:35:34,54,504,22,32,287.73,508.65,0.00
2024-12-10 17:35:34,54,505,22,32,295.63,509.00,0.00
2024-12-10 17:35:34,55,505,23,32,290.25,509.02,0.00
2024-12-10 17:35:34,54,505,22,32,295.53,509.02,0.00
2024-12-10 17:35:34,53,505,21,32,297.11,509.11,0.00
2024-12-10 17:35:34,53,506,21,32,302.78,510.00,0.00
2024-12-10 17:35:34,54,506,21,33,297.17,510.02,0.00
2024-12-10 17:35:34,53,506,21,32,302.31,510.08,0.00
2024-12-10 17:35:34,53,507,21,32,303.95,511.00,0.00
2024-12-10 17:35:34,54,507,21,33,298.32,511.02,0.00
2024-12-10 17:35:34,53,507,20,33,300.96,511.04,0.00
2024-12-10 17:35:34,53,508,20,33,304.35,512.00,0.00
2024-12-10 17:35:34,54,508,21,33,298.71,512.02,0.00
2024-12-10 17:35:34,53,508,20,33,300.47,512.43,0.00
2024-12-10 17:35:34,53,509,20,33,303.77,513.00,0.00
2024-12-10 17:35:34,54,509,21,33,298.14,513.02,0.00
2024-12-10 17:35:34,53,509,21,32,303.20,513.08,0.00
2024-12-10 17:35:34,53,510,21,32,304.84,514.00,0.00
2024-12-10 17:35:34,54,510,21,33,299.20,514.02,0.00
2024-12-10 17:35:34,53,510,20,33,304.26,514.02,0.00
2024-12-10 17:35:34,53,511,20,33,307.57,515.00,0.00
2024-12-10 17:35:34,54,511,20,34,301.88,515.02,0.00
2024-12-10 17:35:34,53,511,19,34,299.11,515.60,0.00
2024-12-10 17:35:34,53,512,19,34,307.10,516.00,0.00
2024-12-10 17:35:34,54,512,19,35,301.41,516.02,0.00
2024-12-10 17:35:34,53,512,19,34,306.82,516.06,0.00
2024-12-10 17:35:34,53,513,19,34,308.38,517.00,0.00
2024-12-10 17:35:34,54,513,19,35,302.67,517.02,0.00
2024-12-10 17:35:35,54,514,19,35,302.70,518.00,0.00
2024-12-10 17:35:35,55,514,20,35,297.20,518.02,0.00
2024-12-10 17:35:35,54,514,20,34,300.60,518.06,0.00
2024-12-10 17:35:35,54,515,20,34,302.03,519.00,0.00
2024-12-10 17:35:35,55,515,20,35,296.54,519.02,0.00
2024-12-10 17:35:35,56,514,21,35,291.07,519.09,0.00
2024-12-10 17:35:35,56,515,21,35,298.77,520.00,0.00
2024-12-10 17:35:35,57,515,22,35,293.53,520.02,0.00
2024-12-10 17:35:35,57,516,22,35,304.69,521.00,0.00
2024-12-10 17:35:35,58,516,23,35,299.44,521.02,0.00
2024-12-10 17:35:35,58,517,23,35,301.05,522.00,0.00
2024-12-10 17:35:35,59,517,23,36,295.95,522.02,0.00
2024-12-10 17:35:35,59,518,23,36,296.77,523.00,0.00
2024-12-10 17:35:35,60,518,24,36,291.83,523.02,0.00
2024-12-10 17:35:35,60,519,24,36,291.32,524.00,0.00
2024-12-10 17:35:35,61,519,24,37,286.55,524.02,0.00
2024-12-10 17:35:35,60,519,24,36,289.76,524.05,0.00
2024-12-10 17:35:35,59,519,23,36,291.89,524.63,0.00
2024-12-10 17:35:35,58,519,22,36,292.53,524.95,0.00
2024-12-10 17:35:35,58,520,22,36,301.35,525.00,0.00
2024-12-10 17:35:35,59,520,23,36,296.24,525.02,0.00
2024-12-10 17:35:35,59,521,23,36,295.65,526.00,0.00
2024-12-10 17:35:35,60,521,24,36,290.73,526.02,0.00
2024-12-10 17:35:35,59,521,24,35,294.23,526.05,0.00
2024-12-10 17:35:35,59,522,24,35,295.14,527.00,0.00
2024-12-10 17:35:35,60,522,25,35,290.22,527.02,0.00
2024-12-10 17:35:35,60,523,25,35,289.57,528.00,0.00
2024-12-10 17:35:35,61,523,26,35,284.83,528.02,0.00
2024-12-10 17:35:35,60,523,26,34,288.26,528.05,0.00
2024-12-10 17:35:35,60,524,26,34,289.06,529.00,0.00
2024-12-10 17:35:35,61,524,26,35,284.32,529.02,0.00
2024-12-10 17:35:35,60,524,25,35,288.91,529.03,0.00
2024-12-10 17:35:35,59,524,24,35,285.83,529.68,0.00
2024-12-10 17:35:35,59,525,24,35,293.35,530.00,0.00
2024-12-10 17:35:35,60,525,25,35,288.46,530.02,0.00
2024-12-10 17:35:35,59,525,25,34,292.01,530.03,0.00
2024-12-10 17:35:35,58,525,24,34,296.61,530.05,0.00
2024-12-10 17:35:35,57,525,23,34,301.28,530.16,0.00
2024-12-10 17:35:35,57,526,23,34,306.64,531.00,0.00
2024-12-10 17:35:35,58,526,23,35,301.36,531.02,0.00
2024-12-10 17:35:35,58,527,23,35,300.65,532.00,0.00
2024-12-10 17:35:35,59,527,23,36,295.56,532.02,0.00
2024-12-10 17:35:35,58,527,23,35,299.37,532.03,0.00
2024-12-10 17:35:35,58,528,23,35,300.30,533.00,0.00
2024-12-10 17:35:35,59,528,24,35,295.21,533.02,0.00
2024-12-10 17:35:35,58,528,23,35,291.99,533.97,0.00
2024-12-10 17:35:35,58,529,23,35,301.03,534.00,0.00
2024-12-10 17:35:35,59,529,23,36,295.93,534.02,0.00
2024-12-10 17:35:35,58,529,23,35,299.65,534.03,0.00
2024-12-10 17:35:35,58,530,23,35,300.58,535.00,0.00
2024-12-10 17:35:35,59,530,23,36,295.49,535.02,0.00
2024-12-10 17:35:35,58,530,22,36,296.59,535.24,0.00
2024-12-10 17:35:35,58,531,22,36,302.25,536.00,0.00
2024-12-10 17:35:35,59,531,22,37,297.13,536.02,0.00
2024-12-10 17:35:35,58,531,22,36,300.87,536.03,0.00
2024-12-10 17:35:35,57,531,21,36,302.86,536.33,0.00
2024-12-10 17:35:35,57,532,21,36,309.17,537.00,0.00
2024-12-10 17:35:35,58,532,21,37,303.83,537.02,0.00
2024-12-10 17:35:35,57,532,20,37,306.47,537.14,0.00
2024-12-10 17:35:35,57,533,20,37,311.82,538.00,0.00
2024-12-10 17:35:35,58,533,21,37,306.44,538.02,0.00
2024-12-10 17:35:35,57,533,21,36,310.50,538.04,0.00
2024-12-10 17:35:35,56,533,20,36,314.36,538.20,0.00
2024-12-10 17:35:35,56,534,20,36,320.19,539.00,0.00
2024-12-10 17:35:35,57,534,21,36,314.57,539.02,0.00
2024-12-10 17:35:35,56,534,20,36,316.20,539.21,0.00
2024-12-10 17:35:35,56,535,20,36,322.13,540.00,0.00
2024-12-10 17:35:35,57,535,20,37,316.48,540.02,0.00
2024-12-10 17:35:35,56,535,20,36,320.88,540.04,0.00
2024-12-10 17:35:35,56,536,20,36,322.05,541.00,0.00
2024-12-10 17:35:35,57,536,20,37,316.40,541.02,0.00
2024-12-10 17:35:35,57,537,20,37,315.47,542.00,0.00
2024-12-10 17:35:35,58,537,20,38,310.03,542.02,0.00
2024-12-10 17:35:35,57,537,19,38,315.37,542.02,0.00
2024-12-10 17:35:35,56,537,19,37,319.94,542.02,0.00
2024-12-10 17:35:35,55,537,18,37,320.17,542.51,0.00
2024-12-10 17:35:35,55,538,18,37,327.74,543.00,0.00
2024-12-10 17:35:35,56,538,19,37,321.89,543.02,0.00
2024-12-10 17:35:35,57,537,20,37,313.52,543.21,0.00
2024-12-10 17:35:35,57,538,20,37,324.17,544.00,0.00
2024-12-10 17:35:35,58,538,21,37,318.58,544.02,0.00
2024-12-10 17:35:35,57,538,21,36,323.22,544.02,0.00
2024-12-10 17:35:35,56,538,20,36,328.62,544.09,0.00
2024-12-10 17:35:35,56,539,20,36,339.81,545.00,0.00
2024-12-10 17:35:35,57,539,20,37,333.85,545.02,0.00
2024-12-10 17:35:35,57,540,20,37,332.93,546.00,0.00
2024-12-10 17:35:35,58,540,21,37,327.19,546.02,0.00
2024-12-10 17:35:35,57,540,21,36,331.88,546.02,0.00
2024-12-10 17:35:35,56,540,20,36,331.20,546.61,0.00
2024-12-10 17:35:35,56,541,20,36,339.11,547.00,0.00
2024-12-10 17:35:35,57,541,21,36,333.16,547.02,0.00
2024-12-10 17:35:35,56,541,20,36,333.93,547.27,0.00
2024-12-10 17:35:35,56,542,20,36,340.21,548.00,0.00
2024-12-10 17:35:35,57,542,20,37,334.24,548.02,0.00
2024-12-10 17:35:35,56,542,20,36,339.23,548.02,0.00
2024-12-10 17:35:35,56,543,20,36,340.34,549.00,0.00
2024-12-10 17:35:35,57,543,21,36,334.37,549.02,0.00
2024-12-10 17:35:35,56,543,20,36,337.76,549.04,0.00
2024-12-10 17:35:35,56,544,20,36,342.89,550.00,0.00
2024-12-10 17:35:35,57,544,20,37,336.88,550.02,0.00
2024-12-10 17:35:35,56,544,20,36,341.71,550.02,0.00
2024-12-10 17:35:35,56,545,20,36,342.83,551.00,0.00
2024-12-10 17:35:35,57,545,21,36,336.81,551.02,0.00
2024-12-10 17:35:36,57,546,21,36,335.87,552.00,0.00
2024-12-10 17:35:36,58,546,21,37,330.08,552.02,0.00
2024-12-10 17:35:36,57,546,21,36,334.61,552.02,0.00
2024-12-10 17:35:36,57,547,21,36,335.61,553.00,0.00
2024-12-10 17:35:36,58,547,22,36,329.82,553.02,0.00
2024-12-10 17:35:36,57,547,21,36,329.33,553.75,0.00
2024-12-10 17:35:36,57,548,21,36,337.87,554.00,0.00
2024-12-10 17:35:36,58,548,21,37,332.04,554.02,0.00
2024-12-10 17:35:36,57,548,21,36,336.12,554.04,0.00
2024-12-10 17:35:36,57,549,21,36,337.21,555.00,0.00
2024-12-10 17:35:36,58,549,22,36,331.40,555.02,0.00
2024-12-10 17:35:36,58,550,22,36,330.52,556.00,0.00
2024-12-10 17:35:36,59,550,23,36,324.91,556.02,0.00
2024-12-10 17:35:36,58,550,23,35,328.71,556.05,0.00
2024-12-10 17:35:36,58,551,23,35,329.77,557.00,0.00
2024-12-10 17:35:36,59,551,23,36,324.18,557.02,0.00
2024-12-10 17:35:36,59,552,23,36,323.39,558.00,0.00
2024-12-10 17:35:36,60,552,24,36,318.00,558.02,0.00
2024-12-10 17:35:36,59,552,24,35,321.51,558.05,0.00
2024-12-10 17:35:36,59,553,24,35,322.45,559.00,0.00
2024-12-10 17:35:36,60,553,25,35,317.07,559.02,0.00
2024-12-10 17:35:36,60,554,25,35,316.41,560.00,0.00
2024-12-10 17:35:36,61,554,25,36,311.22,560.02,0.00
2024-12-10 17:35:36,60,554,25,35,314.47,560.07,0.00
2024-12-10 17:35:36,60,555,25,35,315.38,561.00,0.00
2024-12-10 17:35:36,61,555,25,36,310.21,561.02,0.00
2024-12-10 17:35:36,60,555,24,36,308.33,561.45,0.00
2024-12-10 17:35:36,60,556,24,36,314.98,562.00,0.00
2024-12-10 17:35:36,61,556,25,36,309.81,562.02,0.00
2024-12-10 17:35:36,60,556,25,35,313.13,562.07,0.00
2024-12-10 17:35:36,59,556,24,35,314.30,562.42,0.00
2024-12-10 17:35:36,59,557,24,35,320.98,563.00,0.00
2024-12-10 17:35:36,60,557,25,35,315.63,563.02,0.00
2024-12-10 17:35:36,59,557,24,35,314.56,563.42,0.00
2024-12-10 17:35:36,59,558,24,35,321.26,564.00,0.00
2024-12-10 17:35:36,60,558,25,35,315.91,564.02,0.00
2024-12-10 17:35:36,59,558,25,34,319.47,564.07,0.00
2024-12-10 17:35:36,59,559,25,34,320.49,565.00,0.00
2024-12-10 17:35:36,60,559,25,35,315.15,565.02,0.00
2024-12-10 17:35:36,60,560,25,35,314.36,566.00,0.00
2024-12-10 17:35:36,61,560,26,35,309.21,566.02,0.00
2024-12-10 17:35:36,60,560,26,34,312.68,566.07,0.00
2024-12-10 17:35:36,60,561,26,34,313.59,567.00,0.00
2024-12-10 17:35:36,61,561,26,35,308.45,567.02,0.00
2024-12-10 17:35:36,60,561,25,35,308.40,567.28,0.00
2024-12-10 17:35:36,60,562,25,35,314.24,568.00,0.00
2024-12-10 17:35:36,61,562,26,35,309.09,568.02,0.00
2024-12-10 17:35:36,60,562,26,34,312.56,568.07,0.00
2024-12-10 17:35:36,60,563,26,34,313.47,569.00,0.00
2024-12-10 17:35:36,61,563,27,34,308.33,569.02,0.00
2024-12-10 17:35:36,60,563,26,34,308.00,569.68,0.00
2024-12-10 17:35:36,60,564,26,34,312.79,570.00,0.00
2024-12-10 17:35:36,61,564,27,34,307.66,570.02,0.00
2024-12-10 17:35:36,60,564,27,33,310.92,570.08,0.00
2024-12-10 17:35:36,60,565,27,33,311.91,571.00,0.00
2024-12-10 17:35:36,61,565,27,34,306.80,571.02,0.00
2024-12-10 17:35:36,61,566,27,34,306.09,572.00,0.00
2024-12-10 17:35:36,62,566,28,34,301.15,572.02,0.00
2024-12-10 17:35:36,61,566,28,33,304.17,572.08,0.00
2024-12-10 17:35:36,61,567,28,33,305.06,573.00,0.00
2024-12-10 17:35:36,62,567,28,34,300.14,573.02,0.00
2024-12-10 17:35:36,61,567,27,34,302.11,573.15,0.00
2024-12-10 17:35:36,60,567,26,34,302.49,573.78,0.00
2024-12-10 17:35:36,60,568,26,34,310.97,574.00,0.00
2024-12-10 17:35:36,61,568,27,34,305.88,574.02,0.00
2024-12-10 17:35:36,60,568,27,33,308.75,574.08,0.00
2024-12-10 17:35:36,60,569,27,33,309.75,575.00,0.00
2024-12-10 17:35:36,61,569,27,34,304.67,575.02,0.00
2024-12-10 17:35:36,60,569,26,34,305.99,575.22,0.00
2024-12-10 17:35:36,60,570,26,34,308.35,576.00,0.00
2024-12-10 17:35:36,61,570,26,35,303.30,576.02,0.00
2024-12-10 17:35:36,60,570,26,34,307.93,576.05,0.00
2024-12-10 17:35:36,59,570,26,33,311.79,576.07,0.00
2024-12-10 17:35:36,59,571,26,33,312.80,577.00,0.00
2024-12-10 17:35:36,60,571,27,33,307.59,577.02,0.00
2024-12-10 17:35:36,59,571,26,33,303.81,577.93,0.00
2024-12-10 17:35:36,59,572,26,33,313.27,578.00,0.00
2024-12-10 17:35:36,60,572,27,33,308.04,578.02,0.00
2024-12-10 17:35:36,59,572,27,32,311.71,578.07,0.00
2024-12-10 17:35:36,59,573,27,32,312.73,579.00,0.00
2024-12-10 17:35:36,60,573,28,32,307.52,579.02,0.00
2024-12-10 17:35:36,60,574,28,32,306.77,580.00,0.00
2024-12-10 17:35:36,61,574,29,32,301.74,580.02,0.00
2024-12-10 17:35:36,60,574,29,31,305.34,580.07,0.00
2024-12-10 17:35:36,59,574,28,31,307.63,580.59,0.00
2024-12-10 17:35:36,59,575,28,31,311.46,581.00,0.00
2024-12-10 17:35:36,60,575,28,32,306.27,581.02,0.00
2024-12-10 17:35:36,59,575,27,32,308.65,581.15,0.00
2024-12-10 17:35:36,59,576,27,32,310.79,582.00,0.00
2024-12-10 17:35:36,60,576,28,32,305.61,582.02,0.00
2024-12-10 17:35:36,59,576,28,31,309.23,582.07,0.00
2024-12-10 17:35:36,59,577,28,31,310.24,583.00,0.00
2024-12-10 17:35:36,60,577,28,32,305.07,583.02,0.00
2024-12-10 17:35:36,60,578,28,32,304.40,584.00,0.00
2024-12-10 17:35:36,61,578,28,33,299.41,584.02,0.00
2024-12-10 17:35:36,60,578,28,32,302.95,584.07,0.00
2024-12-10 17:35:36,59,578,27,32,304.79,584.68,0.00
2024-12-10 17:35:36,59,579,27,32,309.09,585.00,0.00
2024-12-10 17:35:36,60,579,28,32,303.94,585.02,0.00
2024-12-10 17:35:37,59,579,27,32,303.80,585.61,0.00
2024-12-10 17:35:37,58,579,26,32,308.60,585.66,0.00
2024-12-10 17:35:37,58,580,26,32,316.93,586.00,0.00
2024-12-10 17:35:37,59,580,26,33,311.56,586.02,0.00
2024-12-10 17:35:37,58,580,26,32,315.53,586.07,0.00
2024-12-10 17:35:37,58,581,26,32,316.66,587.00,0.00
2024-12-10 17:35:37,59,581,26,33,311.30,587.02,0.00
2024-12-10 17:35:37,58,581,25,33,316.56,587.02,0.00
2024-12-10 17:35:37,58,582,25,33,315.81,588.00,0.00
2024-12-10 17:35:37,59,582,25,34,310.46,588.02,0.00
2024-12-10 17:35:37,58,582,25,33,314.61,588.05,0.00
2024-12-10 17:35:37,57,582,24,33,314.44,588.54,0.00
2024-12-10 17:35:37,57,583,24,33,322.41,589.00,0.00
2024-12-10 17:35:37,58,583,24,34,316.86,589.02,0.00
2024-12-10 17:35:37,57,583,23,34,316.19,589.40,0.00
2024-12-10 17:35:37,57,584,23,34,323.42,590.00,0.00
2024-12-10 17:35:37,58,584,23,35,317.84,590.02,0.00
2024-12-10 17:35:37,57,584,23,34,322.19,590.05,0.00
2024-12-10 17:35:37,57,585,23,34,323.35,591.00,0.00
2024-12-10 17:35:37,58,585,23,35,317.77,591.02,0.00
2024-12-10 17:35:37,57,585,22,35,317.68,591.63,0.00
2024-12-10 17:35:37,57,586,22,35,326.15,592.00,0.00
2024-12-10 17:35:37,58,586,22,36,320.53,592.02,0.00
2024-12-10 17:35:37,57,586,22,35,324.81,592.05,0.00
2024-12-10 17:35:37,56,586,21,35,324.49,592.84,0.00
2024-12-10 17:35:37,56,587,21,35,334.26,593.00,0.00
2024-12-10 17:35:37,57,587,22,35,328.40,593.02,0.00
2024-12-10 17:35:37,57,588,22,35,327.70,594.00,0.00
2024-12-10 17:35:37,58,588,23,35,322.05,594.02,0.00
2024-12-10 17:35:37,57,588,23,34,326.35,594.05,0.00
2024-12-10 17:35:37,56,588,22,34,332.10,594.05,0.00
2024-12-10 17:35:37,55,588,21,34,337.83,594.11,0.00
2024-12-10 17:35:37,55,589,21,34,339.56,595.00,0.00
2024-12-10 17:35:37,56,589,21,35,333.50,595.02,0.00
2024-12-10 17:35:37,55,589,20,35,334.20,595.58,0.00
2024-12-10 17:35:37,55,590,20,35,339.08,596.00,0.00
2024-12-10 17:35:37,56,590,21,35,333.03,596.02,0.00
2024-12-10 17:35:37,55,590,21,34,337.36,596.05,0.00
2024-12-10 17:35:37,55,591,21,34,338.78,597.00,0.00
2024-12-10 17:35:37,56,591,22,34,332.73,597.02,0.00
2024-12-10 17:35:37,55,591,21,34,331.73,597.73,0.00
2024-12-10 17:35:37,55,592,21,34,341.18,598.00,0.00
2024-12-10 17:35:37,56,592,21,35,335.09,598.02,0.00
2024-12-10 17:35:37,55,592,21,34,338.92,598.09,0.00
2024-12-10 17:35:37,55,593,21,34,340.56,599.00,0.00
2024-12-10 17:35:37,56,593,21,35,334.48,599.02,0.00
2024-12-10 17:35:37,55,593,20,35,335.85,599.29,0.00
2024-12-10 17:35:37,55,594,20,35,342.98,600.00,0.00
2024-12-10 17:35:37,56,594,20,36,336.86,600.02,0.00
2024-12-10 17:35:37,55,594,20,35,340.82,600.09,0.00
2024-12-10 17:35:37,55,595,20,35,342.46,601.00,0.00
2024-12-10 17:35:37,56,595,20,36,336.34,601.02,0.00
2024-12-10 17:35:37,56,596,20,36,335.91,602.00,0.00
2024-12-10 17:35:37,57,596,21,36,330.02,602.02,0.00
2024-12-10 17:35:37,57,597,21,36,329.24,603.00,0.00
2024-12-10 17:35:37,58,597,22,36,323.56,603.02,0.00
2024-12-10 17:35:37,57,597,21,36,320.43,603.89,0.00
2024-12-10 17:35:37,57,598,21,36,330.48,604.00,0.00
2024-12-10 17:35:37,58,598,21,37,324.78,604.02,0.00
2024-12-10 17:35:37,57,598,20,37,330.27,604.04,0.00
2024-12-10 17:35:37,56,598,20,36,335.31,604.04,0.00
2024-12-10 17:35:37,55,598,19,36,340.67,604.16,0.00
2024-12-10 17:35:37,54,598,18,36,346.76,604.19,0.00
2024-12-10 17:35:37,54,599,18,36,349.08,605.00,0.00
2024-12-10 17:35:37,55,599,19,36,342.73,605.02,0.00
2024-12-10 17:35:37,54,599,19,35,348.08,605.04,0.00
2024-12-10 17:35:37,54,600,19,35,349.54,606.00,0.00
2024-12-10 17:35:37,55,600,19,36,343.19,606.02,0.00
2024-12-10 17:35:37,54,600,19,35,348.20,606.04,0.00
2024-12-10 17:35:37,53,600,18,35,347.93,606.57,0.00
2024-12-10 17:35:37,53,601,18,35,357.07,607.00,0.00
2024-12-10 17:35:37,54,601,18,36,350.46,607.02,0.00
2024-12-10 17:35:37,53,601,17,36,350.89,607.06,0.00
2024-12-10 17:35:37,53,602,17,36,357.20,608.00,0.00
2024-12-10 17:35:37,54,602,18,36,350.58,608.02,0.00
2024-12-10 17:35:37,53,602,18,35,355.94,608.04,0.00
2024-12-10 17:35:37,53,603,18,35,357.56,609.00,0.00
2024-12-10 17:35:37,54,603,18,36,350.93,609.02,0.00
2024-12-10 17:35:37,53,603,17,36,349.26,609.49,0.00
2024-12-10 17:35:37,52,603,16,36,355.44,609.58,0.00
2024-12-10 17:35:37,52,604,16,36,364.91,610.00,0.00
2024-12-10 17:35:37,53,604,16,37,358.03,610.02,0.00
2024-12-10 17:35:37,52,604,16,36,363.51,610.04,0.00
2024-12-10 17:35:37,51,604,15,36,364.62,610.49,0.00
2024-12-10 17:35:37,51,605,15,36,373.88,611.00,0.00
2024-12-10 17:35:37,52,605,16,36,366.69,611.02,0.00
2024-12-10 17:35:37,52,606,16,36,365.99,612.00,0.00
2024-12-10 17:35:37,53,606,16,37,359.09,612.02,0.00
2024-12-10 17:35:37,52,606,16,36,364.70,612.04,0.00
2024-12-10 17:35:37,51,606,15,36,371.29,612.14,0.00
2024-12-10 17:35:37,51,607,15,36,373.78,613.00,0.00
2024-12-10 17:35:37,52,607,15,37,366.59,613.02,0.00
2024-12-10 17:35:37,52,608,15,37,365.89,614.00,0.00
2024-12-10 17:35:37,53,608,15,38,358.99,614.02,0.00
2024-12-10 17:35:37,52,608,15,37,364.71,614.04,0.00
2024-12-10 17:35:37,51,608,14,37,364.61,614.96,0.00
2024-12-10 17:35:37,51,609,14,37,376.44,615.00,0.00
2024-12-10 17:35:37,52,609,15,37,369.21,615.02,0.00
2024-12-10 17:35:37,51,609,14,37,373.11,615.16,0.00
2024-12-10 17:35:37,51,610,14,37,380.56,616.00,0.00
2024-12-10 17:35:37,52,610,14,38,373.24,616.02,0.00
2024-12-10 17:35:37,51,610,14,37,379.12,616.06,0.00
2024-12-10 17:35:37,51,611,14,37,381.18,617.00,0.00
2024-12-10 17:35:37,52,611,14,38,373.85,617.02,0.00
2024-12-10 17:35:37,52,612,14,38,373.15,618.00,0.00
2024-12-10 17:35:37,53,612,15,38,366.11,618.02,0.00
2024-12-10 17:35:37,52,612,15,37,371.61,618.06,0.00
2024-12-10 17:35:37,52,613,15,37,373.51,619.00,0.00
2024-12-10 17:35:37,53,613,15,38,366.46,619.02,0.00
2024-12-10 17:35:37,52,613,14,38,370.42,619.04,0.00
2024-12-10 17:35:38,52,614,14,38,374.59,620.00,0.00
2024-12-10 17:35:38,53,614,14,39,367.52,620.02,0.00
2024-12-10 17:35:38,52,614,13,39,371.73,620.02,0.00
2024-12-10 17:35:38,51,614,13,38,377.68,620.02,0.00
2024-12-10 17:35:38,51,615,13,38,384.38,621.00,0.00
2024-12-10 17:35:38,52,615,13,39,376.99,621.02,0.00
2024-12-10 17:35:38,52,616,13,39,376.28,622.00,0.00
2024-12-10 17:35:38,53,616,13,40,369.18,622.02,0.00
2024-12-10 17:35:38,52,616,13,39,374.96,622.02,0.00
2024-12-10 17:35:38,52,617,13,39,376.64,623.00,0.00
2024-12-10 17:35:38,53,617,13,40,369.54,623.02,0.00
2024-12-10 17:35:38,52,617,12,40,371.57,623.23,0.00
2024-12-10 17:35:38,52,618,12,40,379.29,624.00,0.00
2024-12-10 17:35:38,53,618,12,41,372.13,624.02,0.00
2024-12-10 17:35:38,52,618,12,40,377.97,624.02,0.00
2024-12-10 17:35:38,51,618,11,40,380.02,624.08,0.00
2024-12-10 17:35:38,51,619,11,40,387.10,625.00,0.00
2024-12-10 17:35:38,52,619,12,40,379.66,625.02,0.00
2024-12-10 17:35:38,52,620,12,40,378.94,626.00,0.00
2024-12-10 17:35:38,53,620,12,41,371.79,626.02,0.00
2024-12-10 17:35:38,52,620,12,40,377.49,626.02,0.00
2024-12-10 17:35:38,52,621,12,40,379.18,627.00,0.00
2024-12-10 17:35:38,53,621,13,40,372.03,627.02,0.00
2024-12-10 17:35:38,53,622,13,40,371.33,628.00,0.00
2024-12-10 17:35:38,54,622,14,40,364.46,628.02,0.00
2024-12-10 17:35:38,53,622,14,39,369.79,628.02,0.00
2024-12-10 17:35:38,52,622,13,39,373.12,628.65,0.00
2024-12-10 17:35:38,52,623,13,39,378.47,629.00,0.00
2024-12-10 17:35:38,53,623,13,40,371.33,629.02,0.00
2024-12-10 17:35:38,52,623,12,40,375.21,629.10,0.00
2024-12-10 17:35:38,52,624,12,40,382.21,630.00,0.00
2024-12-10 17:35:38,53,624,13,40,375.00,630.02,0.00
2024-12-10 17:35:38,52,624,13,39,380.75,630.02,0.00
2024-12-10 17:35:38,51,624,12,39,387.77,630.04,0.00
2024-12-10 17:35:38,51,625,12,39,394.68,631.00,0.00
2024-12-10 17:35:38,52,625,12,40,387.09,631.02,0.00
2024-12-10 17:35:38,52,626,12,40,386.37,632.00,0.00
2024-12-10 17:35:38,53,626,12,41,379.08,632.02,0.00
2024-12-10 17:35:38,52,626,12,40,384.67,632.02,0.00
2024-12-10 17:35:38,52,627,12,40,386.37,633.00,0.00
2024-12-10 17:35:38,53,627,13,40,379.08,633.02,0.00
2024-12-10 17:35:38,52,627,12,40,379.69,633.31,0.00
2024-12-10 17:35:38,52,628,12,40,387.96,634.00,0.00
2024-12-10 17:35:38,53,628,13,40,380.64,634.02,0.00
2024-12-10 17:35:38,52,628,13,39,386.25,634.02,0.00
2024-12-10 17:35:38,52,629,13,39,387.96,635.00,0.00
2024-12-10 17:35:38,53,629,14,39,380.64,635.02,0.00
2024-12-10 17:35:38,53,630,14,39,380.03,636.00,0.00
2024-12-10 17:35:38,54,630,15,39,372.99,636.02,0.00
2024-12-10 17:35:38,53,630,15,38,378.11,636.02,0.00
2024-12-10 17:35:38,52,630,14,38,377.53,636.96,0.00
2024-12-10 17:35:38,52,631,14,38,389.55,637.00,0.00
2024-12-10 17:35:38,53,631,14,39,382.20,637.02,0.00
2024-12-10 17:35:38,52,631,13,39,380.27,637.90,0.00
2024-12-10 17:35:38,52,632,13,39,392.00,638.00,0.00
2024-12-10 17:35:38,53,632,13,40,384.61,638.02,0.00
2024-12-10 17:35:38,52,632,13,39,390.04,638.02,0.00
2024-12-10 17:35:38,51,632,12,39,393.78,638.67,0.00
2024-12-10 17:35:38,51,633,12,39,399.44,639.00,0.00
2024-12-10 17:35:38,52,633,12,40,391.76,639.02,0.00
2024-12-10 17:35:38,52,634,12,40,391.04,640.00,0.00
2024-12-10 17:35:38,53,634,13,40,383.66,640.02,0.00
2024-12-10 17:35:38,52,634,13,39,389.07,640.02,0.00
2024-12-10 17:35:38,51,634,12,39,391.10,640.80,0.00
2024-12-10 17:35:38,51,635,12,39,402.57,641.00,0.00
2024-12-10 17:35:38,52,635,12,40,394.83,641.02,0.00
2024-12-10 17:35:38,52,636,12,40,394.09,642.00,0.00
2024-12-10 17:35:38,53,636,13,40,386.65,642.02,0.00
2024-12-10 17:35:38,52,636,13,39,392.24,642.02,0.00
2024-12-10 17:35:38,52,637,13,39,393.96,643.00,0.00
2024-12-10 17:35:38,53,637,14,39,386.53,643.02,0.00
2024-12-10 17:35:38,52,637,13,39,388.85,643.21,0.00
2024-12-10 17:35:38,52,638,13,39,396.68,644.00,0.00
2024-12-10 17:35:38,53,638,14,39,389.19,644.02,0.00
2024-12-10 17:35:38,52,638,14,38,394.45,644.02,0.00
2024-12-10 17:35:38,52,639,14,38,396.18,645.00,0.00
2024-12-10 17:35:38,53,639,14,39,388.70,645.02,0.00
2024-12-10 17:35:38,53,640,14,39,388.21,646.00,0.00
2024-12-10 17:35:38,54,640,14,40,381.02,646.02,0.00
2024-12-10 17:35:38,53,640,14,39,386.01,646.02,0.00
2024-12-10 17:35:38,53,641,14,39,387.59,647.00,0.00
2024-12-10 17:35:38,54,641,15,39,380.41,647.02,0.00
2024-12-10 17:35:38,54,642,15,39,379.89,648.00,0.00
2024-12-10 17:35:38,55,642,15,40,372.98,648.02,0.00
2024-12-10 17:35:38,54,642,15,39,377.85,648.02,0.00
2024-12-10 17:35:38,54,643,15,39,379.27,649.00,0.00
2024-12-10 17:35:38,55,643,16,39,372.37,649.02,0.00
2024-12-10 17:35:38,54,643,15,39,369.21,649.93,0.00
2024-12-10 17:35:38,54,644,15,39,380.82,650.00,0.00
2024-12-10 17:35:38,55,644,16,39,373.89,650.02,0.00
2024-12-10 17:35:38,54,644,16,38,378.77,650.02,0.00
2024-12-10 17:35:38,54,645,16,38,380.20,651.00,0.00
2024-12-10 17:35:38,55,645,16,39,373.29,651.02,0.00
2024-12-10 17:35:38,55,646,16,39,372.75,652.00,0.00
2024-12-10 17:35:38,56,646,16,40,366.09,652.02,0.00
2024-12-10 17:35:38,55,646,16,39,370.85,652.02,0.00
2024-12-10 17:35:38,54,646,15,39,370.62,652.87,0.00
2024-12-10 17:35:38,54,647,15,39,381.97,653.00,0.00
2024-12-10 17:35:38,55,647,16,39,375.03,653.02,0.00
2024-12-10 17:35:38,54,647,15,39,374.28,653.43,0.00
2024-12-10 17:35:38,54,648,15,39,383.04,654.00,0.00
2024-12-10 17:35:38,55,648,15,40,376.08,654.02,0.00
2024-12-10 17:35:38,54,648,15,39,381.22,654.02,0.00
2024-12-10 17:35:38,54,649,15,39,382.66,655.00,0.00
2024-12-10 17:35:38,55,649,15,40,375.70,655.02,0.00
2024-12-10 17:35:39,55,650,15,40,375.02,656.00,0.00
2024-12-10 17:35:39,56,650,16,40,368.33,656.02,0.00
2024-12-10 17:35:39,55,650,16,39,373.35,656.02,0.00
2024-12-10 17:35:39,54,650,15,39,372.00,656.96,0.00
2024-12-10 17:35:39,54,651,15,39,383.95,657.00,0.00
2024-12-10 17:35:39,55,651,15,40,376.96,657.02,0.00
2024-12-10 17:35:39,54,651,14,40,380.93,657.09,0.00
2024-12-10 17:35:39,54,652,14,40,383.23,658.00,0.00
2024-12-10 17:35:39,55,652,14,41,376.26,658.02,0.00
2024-12-10 17:35:39,54,652,14,40,381.64,658.02,0.00
2024-12-10 17:35:39,53,652,13,40,385.08,658.62,0.00
2024-12-10 17:35:39,53,653,13,40,390.34,659.00,0.00
2024-12-10 17:35:39,54,653,14,40,383.11,659.02,0.00
2024-12-10 17:35:39,54,654,14,40,382.28,660.00,0.00
2024-12-10 17:35:39,55,654,15,40,375.33,660.02,0.00
2024-12-10 17:35:39,54,654,15,39,380.81,660.02,0.00
2024-12-10 17:35:39,53,654,14,39,383.74,660.70,0.00
2024-12-10 17:35:39,53,655,14,39,389.46,661.00,0.00
2024-12-10 17:35:39,54,655,14,40,382.24,661.02,0.00
2024-12-10 17:35:39,54,656,14,40,381.32,662.00,0.00
2024-12-10 17:35:39,55,656,15,40,374.39,662.02,0.00
2024-12-10 17:35:39,54,656,15,39,379.97,662.02,0.00
2024-12-10 17:35:39,54,657,15,39,381.40,663.00,0.00
2024-12-10 17:35:39,55,657,15,40,374.47,663.02,0.00
2024-12-10 17:35:39,54,657,14,40,378.36,663.11,0.00
2024-12-10 17:35:39,53,657,13,40,380.54,663.45,0.00
2024-12-10 17:35:39,53,658,13,40,389.81,664.00,0.00
2024-12-10 17:35:39,54,658,14,40,382.59,664.02,0.00
2024-12-10 17:35:39,53,658,14,39,388.31,664.02,0.00
2024-12-10 17:35:39,52,658,13,39,395.29,664.10,0.00
2024-12-10 17:35:39,52,659,13,39,402.64,665.00,0.00
2024-12-10 17:35:39,53,659,14,39,395.04,665.02,0.00
2024-12-10 17:35:39,52,659,13,39,394.39,665.44,0.00
2024-12-10 17:35:39,52,660,13,39,403.89,666.00,0.00
2024-12-10 17:35:39,53,660,14,39,396.26,666.02,0.00
2024-12-10 17:35:39,52,660,14,38,402.22,666.02,0.00
2024-12-10 17:35:39,52,661,14,38,403.98,667.00,0.00
2024-12-10 17:35:39,53,661,14,39,396.36,667.02,0.00
2024-12-10 17:35:39,53,662,14,39,395.44,668.00,0.00
2024-12-10 17:35:39,54,662,14,40,388.12,668.02,0.00
2024-12-10 17:35:39,53,662,14,39,393.93,668.02,0.00
2024-12-10 17:35:39,52,662,13,39,393.57,668.58,0.00
2024-12-10 17:35:39,52,663,13,39,403.90,669.00,0.00
2024-12-10 17:35:39,53,663,13,40,396.28,669.02,0.00
2024-12-10 17:35:39,52,663,12,40,394.63,669.85,0.00
2024-12-10 17:35:39,52,664,12,40,406.60,670.00,0.00
2024-12-10 17:35:39,53,664,12,41,398.93,670.02,0.00
2024-12-10 17:35:39,52,664,12,40,405.18,670.02,0.00
2024-12-10 17:35:39,52,665,12,40,406.95,671.00,0.00
2024-12-10 17:35:39,53,665,13,40,399.27,671.02,0.00
2024-12-10 17:35:39,52,665,12,40,395.34,671.63,0.00
2024-12-10 17:35:39,52,666,12,40,406.08,672.00,0.00
2024-12-10 17:35:39,53,666,12,41,398.42,672.02,0.00
2024-12-10 17:35:39,52,666,12,40,404.79,672.02,0.00
2024-12-10 17:35:39,52,667,12,40,406.56,673.00,0.00
2024-12-10 17:35:39,53,667,12,41,398.89,673.02,0.00
2024-12-10 17:35:39,52,667,11,41,399.57,673.04,0.00
2024-12-10 17:35:39,52,668,11,41,406.64,674.00,0.00
2024-12-10 17:35:39,53,668,11,42,398.97,674.02,0.00
2024-12-10 17:35:39,52,668,11,41,405.22,674.02,0.00
2024-12-10 17:35:39,51,668,10,41,409.58,674.59,0.00
2024-12-10 17:35:39,51,669,10,41,415.06,675.00,0.00
2024-12-10 17:35:39,52,669,10,42,407.08,675.02,0.00
2024-12-10 17:35:39,52,670,10,42,406.25,676.00,0.00
2024-12-10 17:35:39,53,670,11,42,398.58,676.02,0.00
2024-12-10 17:35:39,52,670,11,41,404.82,676.02,0.00
2024-12-10 17:35:39,52,671,11,41,406.59,677.00,0.00
2024-12-10 17:35:39,53,671,12,41,398.92,677.02,0.00
2024-12-10 17:35:39,53,672,12,41,397.97,678.00,0.00
2024-12-10 17:35:39,54,672,12,42,390.60,678.02,0.00
2024-12-10 17:35:39,53,672,12,41,396.69,678.02,0.00
2024-12-10 17:35:39,52,672,11,41,398.59,678.77,0.00
2024-12-10 17:35:39,52,673,11,41,410.27,679.00,0.00
2024-12-10 17:35:39,53,673,11,42,402.53,679.02,0.00
2024-12-10 17:35:39,53,674,11,42,401.58,680.00,0.00
2024-12-10 17:35:39,54,674,11,43,394.15,680.02,0.00
2024-12-10 17:35:39,53,674,11,42,400.30,680.02,0.00
2024-12-10 17:35:39,52,674,10,42,404.00,680.65,0.00
2024-12-10 17:35:39,52,675,10,42,409.78,681.00,0.00
2024-12-10 17:35:39,53,675,10,43,402.05,681.02,0.00
2024-12-10 17:35:39,52,675,9,43,399.19,681.94,0.00
2024-12-10 17:35:39,52,676,9,43,411.95,682.00,0.00
2024-12-10 17:35:39,53,676,9,44,404.18,682.02,0.00
2024-12-10 17:35:39,52,676,9,43,410.77,682.02,0.00
2024-12-10 17:35:39,52,677,9,43,412.56,683.00,0.00
2024-12-10 17:35:39,53,677,10,43,404.77,683.02,0.00
2024-12-10 17:35:39,53,678,10,43,403.82,684.00,0.00
2024-12-10 17:35:39,54,678,10,44,396.34,684.02,0.00
2024-12-10 17:35:39,54,679,10,44,395.27,685.00,0.00
2024-12-10 17:35:39,55,679,10,45,388.08,685.02,0.00
2024-12-10 17:35:39,54,679,10,44,394.26,685.02,0.00
2024-12-10 17:35:39,54,680,10,44,395.72,686.00,0.00
2024-12-10 17:35:39,55,680,10,45,388.53,686.02,0.00
2024-12-10 17:35:39,54,680,10,44,394.70,686.02,0.00
2024-12-10 17:35:39,53,680,9,44,397.93,686.66,0.00
2024-12-10 17:35:39,52,680,8,44,401.48,686.96,0.00
2024-12-10 17:35:39,52,681,8,44,414.45,687.00,0.00
2024-12-10 17:35:39,53,681,9,44,406.63,687.02,0.00
2024-12-10 17:35:39,52,681,8,44,404.50,687.54,0.00
2024-12-10 17:35:39,52,682,8,44,414.92,688.00,0.00
2024-12-10 17:35:39,53,682,8,45,407.09,688.02,0.00
2024-12-10 17:35:39,52,682,8,44,413.60,688.04,0.00
2024-12-10 17:35:39,52,683,8,44,415.52,689.00,0.00
2024-12-10 17:35:39,53,683,8,45,407.68,689.02,0.00
2024-12-10 17:35:39,53,684,8,45,406.71,690.00,0.00
2024-12-10 17:35:39,54,684,9,45,399.18,690.02,0.00
2024-12-10 17:35:39,53,684,9,44,405.54,690.04,0.00
2024-12-10 17:35:39,53,685,9,44,407.30,691.00,0.00
2024-12-10 17:35:39,54,685,10,44,399.76,691.02,0.00
2024-12-10 17:35:40,54,686,10,44,398.67,692.00,0.00
2024-12-10 17:35:40,55,686,11,44,391.42,692.02,0.00
2024-12-10 17:35:40,54,686,11,43,397.27,692.06,0.00
2024-12-10 17:35:40,53,686,10,43,397.18,692.92,0.00
2024-12-10 17:35:40,53,687,10,43,409.79,693.00,0.00
2024-12-10 17:35:40,54,687,11,43,402.20,693.02,0.00
2024-12-10 17:35:40,54,688,11,43,401.11,694.00,0.00
2024-12-10 17:35:40,55,688,11,44,393.81,694.02,0.00
2024-12-10 17:35:40,54,688,11,43,399.83,694.06,0.00
2024-12-10 17:35:40,54,689,11,43,401.56,695.00,0.00
2024-12-10 17:35:40,55,689,11,44,394.25,695.02,0.00
2024-12-10 17:35:40,54,689,10,44,397.74,695.19,0.00
2024-12-10 17:35:40,54,690,10,44,400.33,696.00,0.00
2024-12-10 17:35:40,55,690,10,45,393.05,696.02,0.00
2024-12-10 17:35:40,54,690,10,44,399.18,696.06,0.00
2024-12-10 17:35:40,53,690,9,44,402.45,696.70,0.00
2024-12-10 17:35:40,53,691,9,44,408.47,697.00,0.00
2024-12-10 17:35:40,54,691,9,45,400.90,697.02,0.00
2024-12-10 17:35:40,53,691,8,45,402.51,697.30,0.00
2024-12-10 17:35:40,53,692,8,45,411.29,698.00,0.00
2024-12-10 17:35:40,54,692,9,45,403.68,698.02,0.00
2024-12-10 17:35:40,53,692,9,44,410.25,698.06,0.00
2024-12-10 17:35:40,52,692,8,44,410.20,698.58,0.00
2024-12-10 17:35:40,52,693,8,44,421.01,699.00,0.00
2024-12-10 17:35:40,53,693,8,45,413.07,699.02,0.00
2024-12-10 17:35:40,52,693,7,45,412.31,699.15,0.00
2024-12-10 17:35:40,52,694,7,45,420.40,700.00,0.00
2024-12-10 17:35:40,53,694,8,45,412.47,700.02,0.00
2024-12-10 17:35:40,52,694,8,44,419.07,700.08,0.00
2024-12-10 17:35:40,51,694,7,44,421.42,700.45,0.00
2024-12-10 17:35:40,51,695,7,44,431.73,701.00,0.00
2024-12-10 17:35:40,52,695,7,45,423.43,701.02,0.00
2024-12-10 17:35:40,51,695,6,45,422.56,701.80,0.00
2024-12-10 17:35:40,51,696,6,45,435.10,702.00,0.00
2024-12-10 17:35:40,52,696,6,46,426.73,702.02,0.00
2024-12-10 17:35:40,51,696,6,45,433.60,702.08,0.00
2024-12-10 17:35:40,51,697,6,45,436.00,703.00,0.00
2024-12-10 17:35:40,52,697,7,45,427.61,703.02,0.00
2024-12-10 17:35:40,52,698,7,45,426.73,704.00,0.00
2024-12-10 17:35:40,53,698,8,45,418.68,704.02,0.00
2024-12-10 17:35:40,52,698,8,44,425.25,704.08,0.00
2024-12-10 17:35:40,52,699,8,44,427.47,705.00,0.00
2024-12-10 17:35:40,53,699,9,44,419.41,705.02,0.00
2024-12-10 17:35:40,53,700,9,44,418.40,706.00,0.00
2024-12-10 17:35:40,54,700,9,45,410.66,706.02,0.00
2024-12-10 17:35:40,53,700,9,44,417.08,706.08,0.00
2024-12-10 17:35:40,52,700,8,44,416.97,706.96,0.00
2024-12-10 17:35:40,52,701,8,44,430.32,707.00,0.00
2024-12-10 17:35:40,53,701,8,45,422.20,707.02,0.00
2024-12-10 17:35:40,53,702,8,45,421.19,708.00,0.00
2024-12-10 17:35:40,54,702,9,45,413.39,708.02,0.00
2024-12-10 17:35:40,53,702,9,44,419.46,708.08,0.00
2024-12-10 17:35:40,53,703,9,44,421.52,709.00,0.00
2024-12-10 17:35:40,54,703,10,44,413.71,709.02,0.00
2024-12-10 17:35:40,53,703,9,44,410.56,709.94,0.00
2024-12-10 17:35:40,53,704,9,44,423.59,710.00,0.00
2024-12-10 17:35:40,54,704,9,45,415.74,710.02,0.00
2024-12-10 17:35:40,53,704,9,44,421.99,710.08,0.00
2024-12-10 17:35:40,53,705,9,44,424.05,711.00,0.00
2024-12-10 17:35:40,54,705,9,45,416.20,711.02,0.00
2024-12-10 17:35:40,53,705,8,45,415.09,711.81,0.00
2024-12-10 17:35:40,53,706,8,45,427.33,712.00,0.00
2024-12-10 17:35:40,54,706,9,45,419.42,712.02,0.00
2024-12-10 17:35:40,53,706,9,44,425.86,712.08,0.00
2024-12-10 17:35:40,52,706,8,44,429.88,712.69,0.00
2024-12-10 17:35:40,52,707,8,44,436.16,713.00,0.00
2024-12-10 17:35:40,53,707,8,45,427.93,713.02,0.00
2024-12-10 17:35:40,53,708,8,45,426.92,714.00,0.00
2024-12-10 17:35:40,54,708,8,46,419.01,714.02,0.00
2024-12-10 17:35:40,53,708,8,45,426.78,714.02,0.00
2024-12-10 17:35:40,52,708,8,44,433.62,714.06,0.00
2024-12-10 17:35:40,51,708,7,44,435.47,714.84,0.00
2024-12-10 17:35:40,51,709,7,44,448.49,715.00,0.00
2024-12-10 17:35:40,52,709,8,44,439.86,715.02,0.00
2024-12-10 17:35:40,51,709,8,43,446.95,715.04,0.00
2024-12-10 17:35:40,51,710,8,43,449.11,716.00,0.00
2024-12-10 17:35:40,52,710,8,44,440.48,716.02,0.00
2024-12-10 17:35:40,52,711,8,44,439.58,717.00,0.00
2024-12-10 17:35:40,53,711,9,44,431.28,717.02,0.00
2024-12-10 17:35:40,52,711,9,43,438.20,717.04,0.00
2024-12-10 17:35:40,51,711,8,43,437.68,717.63,0.00
2024-12-10 17:35:40,51,712,8,43,449.38,718.00,0.00
2024-12-10 17:35:40,52,712,8,44,440.74,718.02,0.00
2024-12-10 17:35:40,52,713,8,44,439.83,719.00,0.00
2024-12-10 17:35:40,53,713,9,44,431.54,719.02,0.00
2024-12-10 17:35:40,52,713,9,43,439.70,719.02,0.00
2024-12-10 17:35:40,51,713,9,42,447.19,719.02,0.00
2024-12-10 17:35:40,51,714,9,42,449.22,720.00,0.00
2024-12-10 17:35:40,52,714,9,43,440.58,720.02,0.00
2024-12-10 17:35:40,52,715,9,43,439.67,721.00,0.00
2024-12-10 17:35:40,53,715,10,43,431.38,721.02,0.00
2024-12-10 17:35:40,52,715,10,42,438.56,721.02,0.00
2024-12-10 17:35:40,52,716,10,42,440.42,722.00,0.00
2024-12-10 17:35:40,53,716,11,42,432.11,722.02,0.00
2024-12-10 17:35:40,52,716,10,42,436.57,722.15,0.00
2024-12-10 17:35:40,52,717,10,42,439.36,723.00,0.00
2024-12-10 17:35:40,53,717,10,43,431.07,723.02,0.00
2024-12-10 17:35:40,52,717,10,42,438.11,723.02,0.00
2024-12-10 17:35:40,51,717,9,42,439.29,723.51,0.00
2024-12-10 17:35:40,51,718,9,42,450.30,724.00,0.00
2024-12-10 17:35:40,52,718,10,42,441.64,724.02,0.00
2024-12-10 17:35:40,52,719,10,42,440.72,725.00,0.00
2024-12-10 17:35:40,53,719,11,42,432.40,725.02,0.00
2024-12-10 17:35:40,52,719,11,41,439.60,725.02,0.00
2024-12-10 17:35:41,52,720,11,41,441.46,726.00,0.00
2024-12-10 17:35:41,53,720,12,41,433.13,726.02,0.00
2024-12-10 17:35:41,53,721,12,41,432.08,727.00,0.00
2024-12-10 17:35:41,54,721,12,42,424.08,727.02,0.00
2024-12-10 17:35:41,53,721,12,41,430.99,727.02,0.00
2024-12-10 17:35:41,53,722,12,41,432.68,728.00,0.00
2024-12-10 17:35:41,54,722,12,42,424.67,728.02,0.00
2024-12-10 17:35:41,54,723,12,42,423.49,729.00,0.00
2024-12-10 17:35:41,55,723,12,43,415.79,729.02,0.00
2024-12-10 17:35:41,54,723,12,42,422.55,729.02,0.00
2024-12-10 17:35:41,53,723,11,42,426.18,729.64,0.00
2024-12-10 17:35:41,52,723,10,42,429.84,729.96,0.00
2024-12-10 17:35:41,52,724,10,42,443.62,730.00,0.00
2024-12-10 17:35:41,53,724,11,42,435.25,730.02,0.00
2024-12-10 17:35:41,53,725,11,42,434.19,731.00,0.00
2024-12-10 17:35:41,54,725,12,42,426.15,731.02,0.00
2024-12-10 17:35:41,53,725,12,41,433.22,731.02,0.00
2024-12-10 17:35:41,53,726,12,41,434.92,732.00,0.00
2024-12-10 17:35:41,54,726,12,42,426.86,732.02,0.00
2024-12-10 17:35:41,54,727,12,42,425.68,733.00,0.00
2024-12-10 17:35:41,55,727,12,43,417.94,733.02,0.00
2024-12-10 17:35:41,54,727,12,42,424.87,733.02,0.00
2024-12-10 17:35:41,53,727,11,42,424.04,733.96,0.00
2024-12-10 17:35:41,53,728,11,42,437.63,734.00,0.00
2024-12-10 17:35:41,54,728,12,42,429.53,734.02,0.00
2024-12-10 17:35:41,54,729,12,42,428.34,735.00,0.00
2024-12-10 17:35:41,55,729,12,43,420.55,735.02,0.00
2024-12-10 17:35:41,54,729,12,42,427.39,735.02,0.00
2024-12-10 17:35:41,54,730,12,42,428.92,736.00,0.00
2024-12-10 17:35:41,55,730,12,43,421.13,736.02,0.00
2024-12-10 17:35:41,55,731,12,43,419.82,737.00,0.00
2024-12-10 17:35:41,56,731,13,43,412.33,737.02,0.00
2024-12-10 17:35:41,55,731,13,42,418.88,737.02,0.00
2024-12-10 17:35:41,54,731,12,42,416.47,737.69,0.00
2024-12-10 17:35:41,54,732,12,42,428.04,738.00,0.00
2024-12-10 17:35:41,55,732,12,43,420.26,738.02,0.00
2024-12-10 17:35:41,54,732,11,43,415.78,738.65,0.00
2024-12-10 17:35:41,54,733,11,43,427.11,739.00,0.00
2024-12-10 17:35:41,55,733,11,44,419.35,739.02,0.00
2024-12-10 17:35:41,54,733,11,43,425.88,739.02,0.00
2024-12-10 17:35:41,53,733,10,43,429.24,739.68,0.00
2024-12-10 17:35:41,53,734,10,43,435.48,740.00,0.00
2024-12-10 17:35:41,54,734,11,43,427.42,740.02,0.00
2024-12-10 17:35:41,54,735,11,43,426.21,741.00,0.00
2024-12-10 17:35:41,55,735,12,43,418.46,741.02,0.00
2024-12-10 17:35:41,54,735,12,42,425.11,741.02,0.00
2024-12-10 17:35:41,54,736,12,42,426.65,742.00,0.00
2024-12-10 17:35:41,55,736,12,43,418.89,742.02,0.00
2024-12-10 17:35:41,55,737,12,43,417.57,743.00,0.00
2024-12-10 17:35:41,56,737,12,44,410.11,743.02,0.00
2024-12-10 17:35:41,55,737,12,43,416.62,743.02,0.00
2024-12-10 17:35:41,54,737,11,43,419.31,743.70,0.00
2024-12-10 17:35:41,54,738,11,43,431.11,744.00,0.00
2024-12-10 17:35:41,55,738,11,44,423.27,744.02,0.00
2024-12-10 17:35:41,55,739,11,44,421.94,745.00,0.00
2024-12-10 17:35:41,56,739,11,45,414.41,745.02,0.00
2024-12-10 17:35:41,55,739,11,44,421.13,745.02,0.00
2024-12-10 17:35:41,54,739,10,44,424.14,745.69,0.00
2024-12-10 17:35:41,54,740,10,44,435.86,746.00,0.00
2024-12-10 17:35:41,55,740,11,44,427.93,746.02,0.00
2024-12-10 17:35:41,54,740,10,44,427.23,746.74,0.00
2024-12-10 17:35:41,54,741,10,44,439.35,747.00,0.00
2024-12-10 17:35:41,55,741,11,44,431.36,747.02,0.00
2024-12-10 17:35:41,54,741,11,43,438.52,747.02,0.00
2024-12-10 17:35:41,54,742,11,43,440.07,748.00,0.00
2024-12-10 17:35:41,55,742,12,43,432.07,748.02,0.00
2024-12-10 17:35:41,55,743,12,43,430.74,749.00,0.00
2024-12-10 17:35:41,56,743,12,44,423.05,749.02,0.00
2024-12-10 17:35:41,55,743,12,43,430.06,749.02,0.00
2024-12-10 17:35:41,55,744,12,43,431.45,750.00,0.00
2024-12-10 17:35:41,56,744,12,44,423.75,750.02,0.00
2024-12-10 17:35:41,55,744,11,44,425.02,750.33,0.00
2024-12-10 17:35:41,55,745,11,44,434.08,751.00,0.00
2024-12-10 17:35:41,56,745,11,45,426.33,751.02,0.00
2024-12-10 17:35:41,55,745,11,44,433.53,751.02,0.00
2024-12-10 17:35:41,55,746,11,44,434.93,752.00,0.00
2024-12-10 17:35:41,56,746,12,44,427.16,752.02,0.00
2024-12-10 17:35:41,56,747,12,44,425.71,753.00,0.00
2024-12-10 17:35:41,57,747,13,44,418.25,753.02,0.00
2024-12-10 17:35:41,56,747,13,43,425.31,753.02,0.00
2024-12-10 17:35:41,56,748,13,43,426.55,754.00,0.00
2024-12-10 17:35:41,57,748,14,43,419.07,754.02,0.00
2024-12-10 17:35:41,57,749,14,43,417.50,755.00,0.00
2024-12-10 17:35:41,58,749,14,44,410.30,755.02,0.00
2024-12-10 17:35:41,57,749,14,43,416.97,755.02,0.00
2024-12-10 17:35:41,57,750,14,43,418.05,756.00,0.00
2024-12-10 17:35:41,58,750,15,43,410.85,756.02,0.00
2024-12-10 17:35:41,58,751,15,43,409.17,757.00,0.00
2024-12-10 17:35:41,59,751,16,43,402.24,757.02,0.00
2024-12-10 17:35:41,58,751,16,42,408.78,757.02,0.00
2024-12-10 17:35:41,57,751,15,42,411.30,757.37,0.00
2024-12-10 17:35:41,57,752,15,42,420.22,758.00,0.00
2024-12-10 17:35:41,58,752,15,43,412.98,758.02,0.00
2024-12-10 17:35:41,58,753,15,43,411.30,759.00,0.00
2024-12-10 17:35:41,59,753,16,43,404.33,759.02,0.00
2024-12-10 17:35:41,58,753,16,42,411.04,759.02,0.00
2024-12-10 17:35:41,57,753,15,42,409.68,759.93,0.00
2024-12-10 17:35:41,57,754,15,42,422.53,760.00,0.00
2024-12-10 17:35:41,58,754,15,43,415.25,760.02,0.00
2024-12-10 17:35:41,58,755,15,43,413.56,761.00,0.00
2024-12-10 17:35:41,59,755,16,43,406.55,761.02,0.00
2024-12-10 17:35:41,58,755,16,42,413.43,761.02,0.00
2024-12-10 17:35:41,57,755,15,42,414.26,761.79,0.00
2024-12-10 17:35:41,57,756,15,42,426.19,762.00,0.00
2024-12-10 17:35:41,58,756,15,43,418.84,762.02,0.00
2024-12-10 17:35:41,57,756,15,42,423.38,762.02,0.00
2024-12-10 17:35:42,57,757,15,42,424.47,763.00,0.00
2024-12-10 17:35:42,58,757,16,42,417.15,763.02,0.00
2024-12-10 17:35:42,58,758,16,42,415.46,764.00,0.00
2024-12-10 17:35:42,59,758,17,42,408.42,764.02,0.00
2024-12-10 17:35:42,58,758,17,41,415.33,764.02,0.00
2024-12-10 17:35:42,58,759,17,41,416.27,765.00,0.00
2024-12-10 17:35:42,59,759,18,41,409.21,765.02,0.00
2024-12-10 17:35:42,58,759,18,40,413.50,765.02,0.00
2024-12-10 17:35:42,57,759,17,40,412.37,765.91,0.00
2024-12-10 17:35:42,57,760,17,40,425.20,766.00,0.00
2024-12-10 17:35:42,58,760,18,40,417.87,766.02,0.00
2024-12-10 17:35:42,57,760,18,39,422.37,766.02,0.00
2024-12-10 17:35:42,57,761,18,39,423.46,767.00,0.00
2024-12-10 17:35:42,58,761,18,40,416.16,767.02,0.00
2024-12-10 17:35:42,57,761,17,40,413.56,767.49,0.00
2024-12-10 17:35:42,56,761,16,40,419.57,767.70,0.00
2024-12-10 17:35:42,56,762,16,40,431.18,768.00,0.00
2024-12-10 17:35:42,57,762,16,41,423.61,768.02,0.00
2024-12-10 17:35:42,56,762,16,40,431.04,768.02,0.00
2024-12-10 17:35:42,55,762,15,40,434.25,768.36,0.00
2024-12-10 17:35:42,54,762,14,40,439.93,768.69,0.00
2024-12-10 17:35:42,54,763,14,40,452.00,769.00,0.00
2024-12-10 17:35:42,55,763,14,41,443.78,769.02,0.00
2024-12-10 17:35:42,54,763,14,40,449.01,769.02,0.00
2024-12-10 17:35:42,53,763,13,40,456.23,769.19,0.00
2024-12-10 17:35:42,53,764,13,40,459.24,770.00,0.00
2024-12-10 17:35:42,54,764,14,40,450.73,770.02,0.00
2024-12-10 17:35:42,53,764,13,40,447.71,770.57,0.00
2024-12-10 17:35:42,53,765,13,40,459.25,771.00,0.00
2024-12-10 17:35:42,54,765,13,41,450.75,771.02,0.00
2024-12-10 17:35:42,53,765,13,40,458.67,771.02,0.00
2024-12-10 17:35:42,53,766,13,40,460.43,772.00,0.00
2024-12-10 17:35:42,54,766,13,41,451.91,772.02,0.00
2024-12-10 17:35:42,53,766,12,41,453.97,772.30,0.00
2024-12-10 17:35:42,53,767,12,41,463.65,773.00,0.00
2024-12-10 17:35:42,54,767,12,42,455.07,773.02,0.00
2024-12-10 17:35:42,53,767,12,41,463.22,773.02,0.00
2024-12-10 17:35:42,53,768,12,41,464.98,774.00,0.00
2024-12-10 17:35:42,54,768,12,42,456.37,774.02,0.00
2024-12-10 17:35:42,53,768,11,42,454.67,774.49,0.00
2024-12-10 17:35:42,53,769,11,42,465.73,775.00,0.00
2024-12-10 17:35:42,54,769,12,42,457.11,775.02,0.00
2024-12-10 17:35:42,54,770,12,42,455.83,776.00,0.00
2024-12-10 17:35:42,55,770,12,43,447.54,776.02,0.00
2024-12-10 17:35:42,54,770,12,42,455.68,776.02,0.00
2024-12-10 17:35:42,53,770,12,41,463.99,776.02,0.00
2024-12-10 17:35:42,53,771,12,41,465.76,777.00,0.00
2024-12-10 17:35:42,54,771,12,42,457.13,777.02,0.00
2024-12-10 17:35:42,53,771,11,42,453.42,777.58,0.00
2024-12-10 17:35:42,53,772,11,42,465.19,778.00,0.00
2024-12-10 17:35:42,54,772,11,43,456.57,778.02,0.00
2024-12-10 17:35:42,53,772,11,42,464.89,778.02,0.00
2024-12-10 17:35:42,53,773,11,42,466.66,779.00,0.00
2024-12-10 17:35:42,54,773,12,42,458.02,779.02,0.00
2024-12-10 17:35:42,53,773,11,42,454.57,779.57,0.00
2024-12-10 17:35:42,53,774,11,42,466.23,780.00,0.00
2024-12-10 17:35:42,54,774,12,42,457.60,780.02,0.00
2024-12-10 17:35:42,53,774,12,41,465.94,780.02,0.00
2024-12-10 17:35:42,53,775,12,41,467.72,781.00,0.00
2024-12-10 17:35:42,54,775,12,42,459.05,781.02,0.00
2024-12-10 17:35:42,54,776,12,42,457.76,782.00,0.00
2024-12-10 17:35:42,55,776,12,43,449.44,782.02,0.00
2024-12-10 17:35:42,54,776,12,42,457.61,782.02,0.00
2024-12-10 17:35:42,53,776,11,42,457.90,782.89,0.00
2024-12-10 17:35:42,53,777,11,42,471.87,783.00,0.00
2024-12-10 17:35:42,54,777,11,43,463.13,783.02,0.00
2024-12-10 17:35:42,53,777,10,43,459.71,783.57,0.00
2024-12-10 17:35:42,53,778,10,43,471.44,784.00,0.00
2024-12-10 17:35:42,54,778,10,44,462.70,784.02,0.00
2024-12-10 17:35:42,53,778,10,43,470.99,784.02,0.00
2024-12-10 17:35:42,53,779,10,43,472.78,785.00,0.00
2024-12-10 17:35:42,54,779,10,44,464.02,785.02,0.00
2024-12-10 17:35:42,54,780,10,44,462.72,786.00,0.00
2024-12-10 17:35:42,55,780,10,45,454.31,786.02,0.00
2024-12-10 17:35:42,54,780,10,44,462.43,786.02,0.00
2024-12-10 17:35:42,53,780,9,44,462.75,786.89,0.00
2024-12-10 17:35:42,53,781,9,44,476.80,787.00,0.00
2024-12-10 17:35:42,54,781,9,45,467.97,787.02,0.00
2024-12-10 17:35:42,53,781,8,45,465.73,787.51,0.00
2024-12-10 17:35:42,53,782,8,45,477.11,788.00,0.00
2024-12-10 17:35:42,54,782,9,45,468.28,788.02,0.00
2024-12-10 17:35:42,53,782,9,44,476.67,788.02,0.00
2024-12-10 17:35:42,53,783,9,44,478.46,789.00,0.00
2024-12-10 17:35:42,54,783,9,45,469.60,789.02,0.00
2024-12-10 17:35:42,54,784,9,45,468.29,790.00,0.00
2024-12-10 17:35:42,55,784,9,46,459.78,790.02,0.00
2024-12-10 17:35:42,54,784,9,45,468.00,790.02,0.00
2024-12-10 17:35:42,53,784,8,45,467.54,790.57,0.00
2024-12-10 17:35:42,53,785,8,45,479.38,791.00,0.00
2024-12-10 17:35:42,54,785,9,45,470.50,791.02,0.00
2024-12-10 17:35:42,53,785,8,45,465.65,791.66,0.00
2024-12-10 17:35:42,53,786,8,45,478.19,792.00,0.00
2024-12-10 17:35:42,54,786,9,45,469.33,792.02,0.00
2024-12-10 17:35:42,53,786,9,44,477.89,792.02,0.00
2024-12-10 17:35:42,53,787,9,44,479.69,793.00,0.00
2024-12-10 17:35:42,54,787,9,45,470.81,793.02,0.00
2024-12-10 17:35:42,54,788,9,45,469.49,794.00,0.00
2024-12-10 17:35:42,55,788,10,45,460.95,794.02,0.00
2024-12-10 17:35:42,54,788,10,44,469.34,794.02,0.00
2024-12-10 17:35:42,54,789,10,44,470.96,795.00,0.00
2024-12-10 17:35:42,55,789,10,45,462.40,795.02,0.00
2024-12-10 17:35:42,55,790,10,45,460.96,796.00,0.00
2024-12-10 17:35:42,56,790,10,46,452.72,796.02,0.00
2024-12-10 17:35:42,55,790,10,45,460.81,796.02,0.00
2024-12-10 17:35:42,55,791,10,45,462.26,797.00,0.00
2024-12-10 17:35:42,56,791,11,45,454.01,797.02,0.00
2024-12-10 17:35:42,55,791,10,45,457.82,797.20,0.00
2024-12-10 17:35:43,55,792,10,45,466.47,798.00,0.00
2024-12-10 17:35:43,56,792,11,45,458.14,798.02,0.00
2024-12-10 17:35:43,55,792,11,44,466.32,798.02,0.00
2024-12-10 17:35:43,55,793,11,44,467.78,799.00,0.00
2024-12-10 17:35:43,56,793,11,45,459.42,799.02,0.00
2024-12-10 17:35:43,56,794,11,45,457.86,800.00,0.00
2024-12-10 17:35:43,57,794,11,46,449.82,800.02,0.00
2024-12-10 17:35:43,56,794,11,45,457.71,800.02,0.00
2024-12-10 17:35:43,55,794,10,45,461.12,800.65,0.00
2024-12-10 17:35:43,55,795,10,45,467.35,801.00,0.00
2024-12-10 17:35:43,56,795,10,46,459.00,801.02,0.00
2024-12-10 17:35:43,55,795,9,46,454.79,801.96,0.00
2024-12-10 17:35:43,55,796,9,46,469.10,802.00,0.00
2024-12-10 17:35:43,56,796,9,47,460.72,802.02,0.00
2024-12-10 17:35:43,55,796,9,46,468.81,802.02,0.00
2024-12-10 17:35:43,55,797,9,46,470.27,803.00,0.00
2024-12-10 17:35:43,56,797,10,46,461.87,803.02,0.00
2024-12-10 17:35:43,56,798,10,46,460.29,804.00,0.00
2024-12-10 17:35:43,57,798,10,47,452.21,804.02,0.00
2024-12-10 17:35:43,56,798,10,46,459.72,804.02,0.00
2024-12-10 17:35:43,56,799,10,46,461.01,805.00,0.00
2024-12-10 17:35:43,57,799,10,47,452.92,805.02,0.00
2024-12-10 17:35:43,57,800,10,47,451.22,806.00,0.00
2024-12-10 17:35:43,58,800,11,47,443.44,806.02,0.00
2024-12-10 17:35:43,57,800,11,46,450.79,806.02,0.00
2024-12-10 17:35:43,56,800,10,46,451.50,806.82,0.00
2024-12-10 17:35:43,56,801,10,46,464.60,807.00,0.00
2024-12-10 17:35:43,57,801,11,46,456.45,807.02,0.00
2024-12-10 17:35:43,57,802,11,46,454.75,808.00,0.00
2024-12-10 17:35:43,58,802,11,47,446.91,808.02,0.00
2024-12-10 17:35:43,57,802,11,46,454.46,808.02,0.00
2024-12-10 17:35:43,57,803,11,46,455.59,809.00,0.00
2024-12-10 17:35:43,58,803,12,46,447.74,809.02,0.00
2024-12-10 17:35:43,58,804,12,46,445.92,810.00,0.00
2024-12-10 17:35:43,59,804,12,47,438.36,810.02,0.00
2024-12-10 17:35:43,58,804,12,46,445.50,810.02,0.00
2024-12-10 17:35:43,58,805,12,46,446.47,811.00,0.00
2024-12-10 17:35:43,59,805,12,47,438.90,811.02,0.00
2024-12-10 17:35:43,58,805,11,47,438.28,811.71,0.00
2024-12-10 17:35:43,58,806,11,47,444.50,812.00,0.00
2024-12-10 17:35:43,59,806,11,48,436.97,812.02,0.00
2024-12-10 17:35:43,58,806,11,47,444.22,812.02,0.00
2024-12-10 17:35:43,57,806,10,47,442.28,812.96,0.00
2024-12-10 17:35:43,57,807,10,47,456.28,813.00,0.00
2024-12-10 17:35:43,58,807,11,47,448.41,813.02,0.00
2024-12-10 17:35:43,58,808,11,47,446.58,814.00,0.00
2024-12-10 17:35:43,59,808,12,47,439.01,814.02,0.00
2024-12-10 17:35:43,58,808,12,46,446.30,814.02,0.00
2024-12-10 17:35:43,58,809,12,46,447.27,815.00,0.00
2024-12-10 17:35:43,59,809,13,46,439.69,815.02,0.00
2024-12-10 17:35:43,58,809,12,46,441.71,815.24,0.00
2024-12-10 17:35:43,58,810,12,46,450.07,816.00,0.00
2024-12-10 17:35:43,59,810,12,47,442.44,816.02,0.00
2024-12-10 17:35:43,58,810,12,46,449.93,816.02,0.00
2024-12-10 17:35:43,58,811,12,46,450.90,817.00,0.00
2024-12-10 17:35:43,59,811,12,47,443.26,817.02,0.00
2024-12-10 17:35:43,59,812,12,47,441.30,818.00,0.00
2024-12-10 17:35:43,60,812,12,48,433.95,818.02,0.00
2024-12-10 17:35:43,59,812,12,47,441.17,818.02,0.00
2024-12-10 17:35:43,58,812,11,47,443.60,818.69,0.00
2024-12-10 17:35:43,57,812,10,47,449.18,818.82,0.00
2024-12-10 17:35:43,57,813,10,47,462.23,819.00,0.00
2024-12-10 17:35:43,58,813,10,48,454.26,819.02,0.00
2024-12-10 17:35:43,57,813,10,47,459.21,819.02,0.00
2024-12-10 17:35:43,57,814,10,47,460.35,820.00,0.00
2024-12-10 17:35:43,58,814,11,47,452.41,820.02,0.00
2024-12-10 17:35:43,58,815,11,47,450.56,821.00,0.00
2024-12-10 17:35:43,59,815,11,48,442.92,821.02,0.00
2024-12-10 17:35:43,58,815,11,47,450.28,821.02,0.00
2024-12-10 17:35:43,58,816,11,47,451.25,822.00,0.00
2024-12-10 17:35:43,59,816,11,48,443.60,822.02,0.00
2024-12-10 17:35:43,59,817,11,48,441.63,823.00,0.00
2024-12-10 17:35:43,60,817,12,48,434.27,823.02,0.00
2024-12-10 17:35:43,59,817,12,47,441.49,823.02,0.00
2024-12-10 17:35:43,58,817,11,47,439.26,823.97,0.00
2024-12-10 17:35:43,58,818,11,47,453.20,824.00,0.00
2024-12-10 17:35:43,59,818,11,48,445.52,824.02,0.00
2024-12-10 17:35:43,58,818,11,47,450.22,824.02,0.00
2024-12-10 17:35:43,57,818,10,47,457.00,824.16,0.00
2024-12-10 17:35:43,56,818,9,47,461.04,824.70,0.00
2024-12-10 17:35:43,56,819,9,47,467.60,825.00,0.00
2024-12-10 17:35:43,57,819,10,47,459.39,825.02,0.00
2024-12-10 17:35:43,56,819,10,46,464.50,825.02,0.00
2024-12-10 17:35:43,56,820,10,46,465.80,826.00,0.00
2024-12-10 17:35:43,57,820,10,47,457.63,826.02,0.00
2024-12-10 17:35:43,56,820,9,47,461.85,826.14,0.00
2024-12-10 17:35:43,56,821,9,47,464.15,827.00,0.00
2024-12-10 17:35:43,57,821,10,47,456.01,827.02,0.00
2024-12-10 17:35:43,57,822,10,47,454.24,828.00,0.00
2024-12-10 17:35:43,58,822,10,48,446.41,828.02,0.00
2024-12-10 17:35:43,57,822,10,47,453.95,828.02,0.00
2024-12-10 17:35:43,56,822,9,47,456.91,828.68,0.00
2024-12-10 17:35:43,56,823,9,47,463.35,829.00,0.00
2024-12-10 17:35:43,57,823,10,47,455.22,829.02,0.00
2024-12-10 17:35:43,56,823,10,46,463.06,829.02,0.00
2024-12-10 17:35:43,55,823,9,46,464.48,829.78,0.00
2024-12-10 17:35:43,55,824,9,46,477.93,830.00,0.00
2024-12-10 17:35:43,56,824,10,46,469.39,830.02,0.00
2024-12-10 17:35:43,55,824,9,46,467.71,830.49,0.00
2024-12-10 17:35:43,55,825,9,46,478.96,831.00,0.00
2024-12-10 17:35:43,56,825,10,46,470.41,831.02,0.00
2024-12-10 17:35:43,55,825,10,45,475.78,831.02,0.00
2024-12-10 17:35:43,54,825,9,45,478.35,831.74,0.00
2024-12-10 17:35:43,54,826,9,45,491.80,832.00,0.00
2024-12-10 17:35:43,55,826,10,45,482.86,832.02,0.00
2024-12-10 17:35:43,54,826,10,44,491.19,832.02,0.00
2024-12-10 17:35:44,54,827,10,44,492.86,833.00,0.00
2024-12-10 17:35:44,55,827,11,44,483.90,833.02,0.00
2024-12-10 17:35:44,54,827,10,44,484.08,833.07,0.00
2024-12-10 17:35:44,54,828,10,44,492.37,834.00,0.00
2024-12-10 17:35:44,55,828,11,44,483.42,834.02,0.00
2024-12-10 17:35:44,54,828,11,43,491.60,834.02,0.00
2024-12-10 17:35:44,53,828,10,43,495.71,834.68,0.00
2024-12-10 17:35:44,53,829,10,43,502.73,835.00,0.00
2024-12-10 17:35:44,54,829,10,44,493.42,835.02,0.00
2024-12-10 17:35:44,53,829,9,44,494.52,835.38,0.00
2024-12-10 17:35:44,53,830,9,44,505.54,836.00,0.00
2024-12-10 17:35:44,54,830,10,44,496.18,836.02,0.00
2024-12-10 17:35:44,53,830,10,43,504.75,836.02,0.00
2024-12-10 17:35:44,53,831,10,43,506.62,837.00,0.00
2024-12-10 17:35:44,54,831,10,44,497.24,837.02,0.00
2024-12-10 17:35:44,54,832,10,44,495.82,838.00,0.00
2024-12-10 17:35:44,55,832,11,44,486.80,838.02,0.00
2024-12-10 17:35:44,54,832,11,43,495.04,838.02,0.00
2024-12-10 17:35:44,54,833,11,43,496.72,839.00,0.00
2024-12-10 17:35:44,55,833,12,43,487.69,839.02,0.00
2024-12-10 17:35:44,55,834,12,43,486.13,840.00,0.00
2024-12-10 17:35:44,56,834,12,44,477.45,840.02,0.00
2024-12-10 17:35:44,55,834,12,43,484.91,840.02,0.00
2024-12-10 17:35:44,55,835,12,43,486.40,841.00,0.00
2024-12-10 17:35:44,56,835,12,44,477.72,841.02,0.00
2024-12-10 17:35:44,56,836,12,44,476.03,842.00,0.00
2024-12-10 17:35:44,57,836,12,45,467.68,842.02,0.00
2024-12-10 17:35:44,56,836,12,44,474.98,842.02,0.00
2024-12-10 17:35:44,55,836,11,44,473.44,842.96,0.00
2024-12-10 17:35:44,55,837,11,44,488.48,843.00,0.00
2024-12-10 17:35:44,56,837,12,44,479.76,843.02,0.00
2024-12-10 17:35:44,55,837,11,44,479.92,843.67,0.00
2024-12-10 17:35:44,55,838,11,44,486.60,844.00,0.00
2024-12-10 17:35:44,56,838,12,44,477.91,844.02,0.00
2024-12-10 17:35:44,55,838,12,43,485.68,844.02,0.00
2024-12-10 17:35:44,55,839,12,43,486.85,845.00,0.00
2024-12-10 17:35:44,56,839,13,43,478.16,845.02,0.00
2024-12-10 17:35:44,56,840,13,43,476.00,846.00,0.00
2024-12-10 17:35:44,57,840,14,43,467.64,846.02,0.00
2024-12-10 17:35:44,56,840,14,42,475.09,846.02,0.00
2024-12-10 17:35:44,56,841,14,42,475.81,847.00,0.00
2024-12-10 17:35:44,57,841,15,42,467.46,847.02,0.00
2024-12-10 17:35:44,56,841,14,42,465.79,847.73,0.00
2024-12-10 17:35:44,56,842,14,42,478.84,848.00,0.00
2024-12-10 17:35:44,57,842,14,43,470.44,848.02,0.00
2024-12-10 17:35:44,56,842,14,42,478.09,848.02,0.00
2024-12-10 17:35:44,56,843,14,42,478.63,849.00,0.00
2024-12-10 17:35:44,57,843,14,43,470.24,849.02,0.00
2024-12-10 17:35:44,57,844,14,43,467.56,850.00,0.00
2024-12-10 17:35:44,58,844,14,44,459.49,850.02,0.00
2024-12-10 17:35:44,57,844,14,43,466.96,850.02,0.00
2024-12-10 17:35:44,57,845,14,43,467.25,851.00,0.00
2024-12-10 17:35:44,58,845,15,43,459.19,851.02,0.00
2024-12-10 17:35:44,58,846,15,43,456.35,852.00,0.00
2024-12-10 17:35:44,59,846,15,44,448.62,852.02,0.00
2024-12-10 17:35:44,58,846,15,43,455.91,852.02,0.00
2024-12-10 17:35:44,58,847,15,43,455.99,853.00,0.00
2024-12-10 17:35:44,59,847,16,43,448.26,853.02,0.00
2024-12-10 17:35:44,58,847,15,43,445.77,853.74,0.00
2024-12-10 17:35:44,58,848,15,43,458.47,854.00,0.00
2024-12-10 17:35:44,59,848,16,43,450.70,854.02,0.00
2024-12-10 17:35:44,58,848,16,42,458.03,854.02,0.00
2024-12-10 17:35:44,57,848,15,42,459.51,854.70,0.00
2024-12-10 17:35:44,57,849,15,42,466.19,855.00,0.00
2024-12-10 17:35:44,58,849,15,43,458.15,855.02,0.00
2024-12-10 17:35:44,57,849,15,42,458.71,855.44,0.00
2024-12-10 17:35:44,57,850,15,42,463.29,856.00,0.00
2024-12-10 17:35:44,58,850,16,42,455.30,856.02,0.00
2024-12-10 17:35:44,57,850,16,41,462.99,856.02,0.00
2024-12-10 17:35:44,56,850,15,41,461.28,856.61,0.00
2024-12-10 17:35:44,56,851,15,41,473.49,857.00,0.00
2024-12-10 17:35:44,57,851,15,42,465.19,857.02,0.00
2024-12-10 17:35:44,57,852,15,42,463.32,858.00,0.00
2024-12-10 17:35:44,58,852,15,43,455.33,858.02,0.00
2024-12-10 17:35:44,57,852,15,42,463.17,858.02,0.00
2024-12-10 17:35:44,57,853,15,42,464.31,859.00,0.00
2024-12-10 17:35:44,58,853,16,42,456.31,859.02,0.00
2024-12-10 17:35:44,58,854,16,42,454.32,860.00,0.00
2024-12-10 17:35:44,59,854,17,42,446.62,860.02,0.00
2024-12-10 17:35:44,58,854,17,41,454.02,860.02,0.00
2024-12-10 17:35:44,58,855,17,41,454.99,861.00,0.00
2024-12-10 17:35:44,59,855,18,41,447.28,861.02,0.00
2024-12-10 17:35:44,59,856,18,41,445.17,862.00,0.00
2024-12-10 17:35:44,60,856,19,41,437.75,862.02,0.00
2024-12-10 17:35:44,59,856,19,40,445.03,862.02,0.00
2024-12-10 17:35:44,59,857,19,40,445.83,863.00,0.00
2024-12-10 17:35:44,60,857,19,41,438.40,863.02,0.00
2024-12-10 17:35:44,59,857,19,40,442.76,863.02,0.00
2024-12-10 17:35:44,58,857,18,40,442.03,863.84,0.00
2024-12-10 17:35:44,58,858,18,40,455.69,864.00,0.00
2024-12-10 17:35:44,59,858,18,41,447.96,864.02,0.00
2024-12-10 17:35:44,58,858,18,40,452.56,864.02,0.00
2024-12-10 17:35:44,58,859,18,40,453.53,865.00,0.00
2024-12-10 17:35:44,59,859,18,41,445.84,865.02,0.00
2024-12-10 17:35:44,58,859,18,40,450.40,865.02,0.00
2024-12-10 17:35:44,57,859,17,40,451.19,865.46,0.00
2024-12-10 17:35:44,57,860,17,40,462.02,866.00,0.00
2024-12-10 17:35:44,58,860,17,41,454.05,866.02,0.00
2024-12-10 17:35:44,57,860,17,40,458.83,866.02,0.00
2024-12-10 17:35:44,56,860,16,40,456.17,866.63,0.00
2024-12-10 17:35:44,56,861,16,40,468.64,867.00,0.00
2024-12-10 17:35:44,57,861,17,40,460.42,867.02,0.00
2024-12-10 17:35:44,56,861,17,39,465.39,867.02,0.00
2024-12-10 17:35:45,55,861,16,39,464.53,867.89,0.00
2024-12-10 17:35:45,55,862,16,39,479.45,868.00,0.00
2024-12-10 17:35:45,56,862,16,40,470.89,868.02,0.00
2024-12-10 17:35:45,55,862,15,40,470.91,868.67,0.00
2024-12-10 17:35:45,55,863,15,40,477.79,869.00,0.00
2024-12-10 17:35:45,56,863,16,40,469.26,869.02,0.00
2024-12-10 17:35:45,55,863,16,39,477.63,869.02,0.00
2024-12-10 17:35:45,54,863,15,39,477.89,869.85,0.00
2024-12-10 17:35:45,54,864,15,39,492.84,870.00,0.00
2024-12-10 17:35:45,55,864,16,39,483.88,870.02,0.00
2024-12-10 17:35:45,54,864,16,38,489.46,870.02,0.00
2024-12-10 17:35:45,54,865,16,38,491.15,871.00,0.00
2024-12-10 17:35:45,55,865,17,38,482.22,871.02,0.00
2024-12-10 17:35:45,55,866,17,38,480.55,872.00,0.00
2024-12-10 17:35:45,56,866,18,38,471.97,872.02,0.00
2024-12-10 17:35:45,55,866,18,37,480.23,872.02,0.00
2024-12-10 17:35:45,55,867,18,37,481.74,873.00,0.00
2024-12-10 17:35:45,56,867,19,37,473.13,873.02,0.00
2024-12-10 17:35:45,56,868,19,37,471.34,874.00,0.00
2024-12-10 17:35:45,57,868,20,37,463.07,874.02,0.00
2024-12-10 17:35:45,56,868,20,36,471.02,874.02,0.00
2024-12-10 17:35:45,56,869,20,36,472.34,875.00,0.00
2024-12-10 17:35:45,57,869,21,36,464.06,875.02,0.00
2024-12-10 17:35:45,56,869,20,36,460.21,875.54,0.00
2024-12-10 17:35:45,56,870,20,36,472.10,876.00,0.00
2024-12-10 17:35:45,57,870,20,37,463.82,876.02,0.00
2024-12-10 17:35:45,56,870,20,36,471.94,876.02,0.00
2024-12-10 17:35:45,55,870,19,36,474.78,876.69,0.00
2024-12-10 17:35:45,55,871,19,36,481.87,877.00,0.00
2024-12-10 17:35:45,56,871,19,37,473.27,877.02,0.00
2024-12-10 17:35:45,55,871,18,37,468.09,877.62,0.00
2024-12-10 17:35:45,55,872,18,37,480.98,878.00,0.00
2024-12-10 17:35:45,56,872,19,37,472.40,878.02,0.00
2024-12-10 17:35:45,55,872,19,36,480.66,878.02,0.00
2024-12-10 17:35:45,55,873,19,36,482.17,879.00,0.00
2024-12-10 17:35:45,56,873,20,36,473.56,879.02,0.00
2024-12-10 17:35:45,55,873,19,36,475.54,879.29,0.00
2024-12-10 17:35:45,55,874,19,36,485.76,880.00,0.00
2024-12-10 17:35:45,56,874,20,36,477.09,880.02,0.00
2024-12-10 17:35:45,55,874,20,35,485.60,880.02,0.00
2024-12-10 17:35:45,55,875,20,35,487.11,881.00,0.00
2024-12-10 17:35:45,56,875,20,36,478.41,881.02,0.00
2024-12-10 17:35:45,55,875,20,35,483.75,881.02,0.00
2024-12-10 17:35:45,55,876,20,35,485.26,882.00,0.00
2024-12-10 17:35:45,56,876,20,36,476.59,882.02,0.00
2024-12-10 17:35:45,55,876,20,35,481.89,882.02,0.00
2024-12-10 17:35:45,55,877,20,35,483.40,883.00,0.00
2024-12-10 17:35:45,56,877,21,35,474.77,883.02,0.00
2024-12-10 17:35:45,56,878,21,35,472.94,884.00,0.00
2024-12-10 17:35:45,57,878,21,36,464.64,884.02,0.00
2024-12-10 17:35:45,56,878,21,35,472.78,884.02,0.00
2024-12-10 17:35:45,55,878,20,35,470.94,884.95,0.00
2024-12-10 17:35:45,55,879,20,35,486.59,885.00,0.00
2024-12-10 17:35:45,56,879,20,36,477.90,885.02,0.00
2024-12-10 17:35:45,55,879,20,35,483.21,885.02,0.00
2024-12-10 17:35:45,55,880,20,35,484.72,886.00,0.00
2024-12-10 17:35:45,56,880,21,35,476.07,886.02,0.00
2024-12-10 17:35:45,56,881,21,35,474.23,887.00,0.00
2024-12-10 17:35:45,57,881,21,36,465.91,887.02,0.00
2024-12-10 17:35:45,56,881,21,35,473.91,887.02,0.00
2024-12-10 17:35:45,56,882,21,35,475.24,888.00,0.00
2024-12-10 17:35:45,57,882,22,35,466.90,888.02,0.00
2024-12-10 17:35:45,56,882,21,35,462.97,888.88,0.00
2024-12-10 17:35:45,56,883,21,35,477.84,889.00,0.00
2024-12-10 17:35:45,57,883,22,35,469.45,889.02,0.00
2024-12-10 17:35:45,56,883,22,34,477.52,889.02,0.00
2024-12-10 17:35:45,56,884,22,34,478.85,890.00,0.00
2024-12-10 17:35:45,57,884,23,34,470.45,890.02,0.00
2024-12-10 17:35:45,57,885,23,34,468.48,891.00,0.00
2024-12-10 17:35:45,58,885,23,35,460.40,891.02,0.00
2024-12-10 17:35:45,57,885,23,34,468.32,891.02,0.00
2024-12-10 17:35:45,57,886,23,34,469.47,892.00,0.00
2024-12-10 17:35:45,58,886,24,34,461.38,892.02,0.00
2024-12-10 17:35:45,57,886,24,33,466.19,892.02,0.00
2024-12-10 17:35:45,56,886,23,33,472.97,892.18,0.00
2024-12-10 17:35:45,55,886,22,33,472.45,892.95,0.00
2024-12-10 17:35:45,55,887,22,33,488.23,893.00,0.00
2024-12-10 17:35:45,56,887,22,34,479.51,893.02,0.00
2024-12-10 17:35:45,56,888,22,34,477.65,894.00,0.00
2024-12-10 17:35:45,57,888,23,34,469.27,894.02,0.00
2024-12-10 17:35:45,56,888,23,33,477.01,894.02,0.00
2024-12-10 17:35:45,55,888,22,33,484.43,894.16,0.00
2024-12-10 17:35:45,54,888,21,33,489.04,894.69,0.00
2024-12-10 17:35:45,54,889,21,33,496.39,895.00,0.00
2024-12-10 17:35:45,55,889,22,33,487.37,895.02,0.00
2024-12-10 17:35:45,55,890,22,33,485.63,896.00,0.00
2024-12-10 17:35:45,56,890,22,34,476.96,896.02,0.00
2024-12-10 17:35:45,55,890,22,33,485.14,896.02,0.00
2024-12-10 17:35:45,55,891,22,33,486.66,897.00,0.00
2024-12-10 17:35:45,56,891,22,34,477.97,897.02,0.00
2024-12-10 17:35:45,56,892,22,34,476.10,898.00,0.00
2024-12-10 17:35:45,57,892,23,34,467.75,898.02,0.00
2024-12-10 17:35:45,56,892,23,33,475.78,898.02,0.00
2024-12-10 17:35:45,55,892,22,33,478.39,898.71,0.00
2024-12-10 17:35:45,54,892,21,33,482.60,898.94,0.00
2024-12-10 17:35:45,54,893,21,33,498.78,899.00,0.00
2024-12-10 17:35:45,55,893,22,33,489.71,899.02,0.00
2024-12-10 17:35:45,55,894,22,33,487.96,900.00,0.00
2024-12-10 17:35:45,56,894,23,33,479.25,900.02,0.00
2024-12-10 17:35:45,55,894,23,32,487.64,900.02,0.00
2024-12-10 17:35:45,54,894,22,32,486.32,900.93,0.00
2024-12-10 17:35:46,54,895,22,32,502.39,901.00,0.00
2024-12-10 17:35:46,55,895,23,32,493.26,901.02,0.00
2024-12-10 17:35:46,55,896,23,32,491.51,902.00,0.00
2024-12-10 17:35:46,56,896,24,32,482.73,902.02,0.00
2024-12-10 17:35:46,55,896,24,31,491.34,902.02,0.00
2024-12-10 17:35:46,55,897,24,31,492.87,903.00,0.00
2024-12-10 17:35:46,56,897,25,31,484.07,903.02,0.00
2024-12-10 17:35:46,56,898,25,31,482.19,904.00,0.00
2024-12-10 17:35:46,57,898,25,32,473.73,904.02,0.00
2024-12-10 17:35:46,56,898,25,31,482.03,904.02,0.00
2024-12-10 17:35:46,56,899,25,31,483.37,905.00,0.00
2024-12-10 17:35:46,57,899,25,32,474.89,905.02,0.00
2024-12-10 17:35:46,56,899,24,32,470.18,905.59,0.00
2024-12-10 17:35:46,56,900,24,32,482.93,906.00,0.00
2024-12-10 17:35:46,57,900,24,33,474.46,906.02,0.00
2024-12-10 17:35:46,56,900,24,32,482.77,906.02,0.00
2024-12-10 17:35:46,55,900,23,32,490.27,906.16,0.00
2024-12-10 17:35:46,55,901,23,32,493.08,907.00,0.00
2024-12-10 17:35:46,56,901,23,33,484.27,907.02,0.00
2024-12-10 17:35:46,56,902,23,33,482.37,908.00,0.00
2024-12-10 17:35:46,57,902,23,34,473.91,908.02,0.00
2024-12-10 17:35:46,56,902,23,33,482.21,908.02,0.00
2024-12-10 17:35:46,56,903,23,33,483.56,909.00,0.00
2024-12-10 17:35:46,57,903,23,34,475.07,909.02,0.00
2024-12-10 17:35:46,56,903,22,34,475.37,909.32,0.00
2024-12-10 17:35:46,55,903,21,34,480.76,909.69,0.00
2024-12-10 17:35:46,55,904,21,34,494.71,910.00,0.00
2024-12-10 17:35:46,56,904,21,35,485.87,910.02,0.00
2024-12-10 17:35:46,55,904,21,34,493.55,910.04,0.00
2024-12-10 17:35:46,55,905,21,34,495.25,911.00,0.00
2024-12-10 17:35:46,56,905,22,34,486.41,911.02,0.00
2024-12-10 17:35:46,55,905,21,34,486.98,911.05,0.00
2024-12-10 17:35:46,55,906,21,34,495.46,912.00,0.00
2024-12-10 17:35:46,56,906,21,35,486.62,912.02,0.00
2024-12-10 17:35:46,55,906,21,34,494.31,912.04,0.00
2024-12-10 17:35:46,54,906,20,34,497.68,912.69,0.00
2024-12-10 17:35:46,54,907,20,34,505.19,913.00,0.00
2024-12-10 17:35:46,55,907,20,35,496.01,913.02,0.00
2024-12-10 17:35:46,54,907,19,35,493.57,913.80,0.00
2024-12-10 17:35:46,54,908,19,35,508.79,914.00,0.00
2024-12-10 17:35:46,55,908,20,35,499.54,914.02,0.00
2024-12-10 17:35:46,54,908,20,34,507.44,914.04,0.00
2024-12-10 17:35:46,53,908,19,34,515.68,914.17,0.00
2024-12-10 17:35:46,53,909,19,34,518.96,915.00,0.00
2024-12-10 17:35:46,54,909,20,34,509.35,915.02,0.00
2024-12-10 17:35:46,54,910,20,34,507.70,916.00,0.00
2024-12-10 17:35:46,55,910,20,35,498.47,916.02,0.00
2024-12-10 17:35:46,54,910,20,34,506.52,916.04,0.00
2024-12-10 17:35:46,54,911,20,34,508.43,917.00,0.00
2024-12-10 17:35:46,55,911,20,35,499.18,917.02,0.00
2024-12-10 17:35:46,55,912,20,35,497.39,918.00,0.00
2024-12-10 17:35:46,56,912,20,36,488.51,918.02,0.00
2024-12-10 17:35:46,55,912,20,35,496.39,918.04,0.00
2024-12-10 17:35:46,55,913,20,35,498.10,919.00,0.00
2024-12-10 17:35:46,56,913,20,36,489.20,919.02,0.00
2024-12-10 17:35:46,56,914,20,36,487.93,920.00,0.00
2024-12-10 17:35:46,57,914,20,37,479.37,920.02,0.00
2024-12-10 17:35:46,56,914,20,36,486.13,920.05,0.00
2024-12-10 17:35:46,55,914,19,36,486.75,920.45,0.00
2024-12-10 17:35:46,54,914,18,36,494.18,920.65,0.00
2024-12-10 17:35:46,53,914,17,36,503.33,920.66,0.00
2024-12-10 17:35:46,53,915,17,36,517.85,921.00,0.00
2024-12-10 17:35:46,54,915,18,36,508.26,921.02,0.00
2024-12-10 17:35:46,53,915,17,36,512.85,921.17,0.00
2024-12-10 17:35:46,52,915,16,36,519.40,921.33,0.00
2024-12-10 17:35:46,52,916,16,36,531.39,922.00,0.00
2024-12-10 17:35:46,53,916,16,37,521.36,922.02,0.00
2024-12-10 17:35:46,52,916,16,36,529.62,922.06,0.00
2024-12-10 17:35:46,52,917,16,36,532.14,923.00,0.00
2024-12-10 17:35:46,53,917,17,36,522.10,923.02,0.00
2024-12-10 17:35:46,52,917,16,36,517.13,923.60,0.00
2024-12-10 17:35:46,52,918,16,36,531.48,924.00,0.00
2024-12-10 17:35:46,53,918,16,37,521.45,924.02,0.00
2024-12-10 17:35:46,52,918,16,36,529.88,924.06,0.00
2024-12-10 17:35:46,52,919,16,36,532.41,925.00,0.00
2024-12-10 17:35:46,53,919,17,36,522.36,925.02,0.00
2024-12-10 17:35:46,52,919,16,36,516.82,925.60,0.00
2024-12-10 17:35:46,52,920,16,36,531.20,926.00,0.00
2024-12-10 17:35:46,53,920,17,36,521.18,926.02,0.00
2024-12-10 17:35:46,52,920,17,35,529.61,926.06,0.00
2024-12-10 17:35:46,52,921,17,35,532.13,927.00,0.00
2024-12-10 17:35:46,53,921,17,36,522.09,927.02,0.00
2024-12-10 17:35:46,52,921,16,36,526.83,927.19,0.00
2024-12-10 17:35:46,51,921,15,36,530.55,927.45,0.00
2024-12-10 17:35:46,51,922,15,36,544.06,928.00,0.00
2024-12-10 17:35:46,52,922,15,37,533.60,928.02,0.00
2024-12-10 17:35:46,51,922,15,36,542.25,928.06,0.00
2024-12-10 17:35:46,51,923,15,36,545.01,929.00,0.00
2024-12-10 17:35:46,52,923,16,36,534.53,929.02,0.00
2024-12-10 17:35:46,52,924,16,36,532.98,930.00,0.00
2024-12-10 17:35:46,53,924,16,37,522.92,930.02,0.00
2024-12-10 17:35:46,52,924,16,36,530.30,930.08,0.00
2024-12-10 17:35:46,51,924,15,36,539.83,930.18,0.00
2024-12-10 17:35:46,51,925,15,36,543.65,931.00,0.00
2024-12-10 17:35:46,52,925,16,36,533.19,931.02,0.00
2024-12-10 17:35:46,51,925,15,36,543.47,931.02,0.00
2024-12-10 17:35:46,51,926,15,36,549.21,932.00,0.00
2024-12-10 17:35:46,52,926,15,37,538.64,932.02,0.00
2024-12-10 17:35:46,51,926,15,36,548.97,932.04,0.00
2024-12-10 17:35:46,51,927,15,36,551.57,933.00,0.00
2024-12-10 17:35:46,52,927,16,36,540.96,933.02,0.00
2024-12-10 17:35:46,52,928,16,36,539.17,934.00,0.00
2024-12-10 17:35:47,53,928,16,37,529.00,934.02,0.00
2024-12-10 17:35:47,52,928,16,36,537.20,934.04,0.00
2024-12-10 17:35:47,51,928,15,36,546.49,934.16,0.00
2024-12-10 17:35:47,51,929,15,36,549.13,935.00,0.00
2024-12-10 17:35:47,52,929,16,36,538.57,935.02,0.00
2024-12-10 17:35:47,52,930,16,36,535.98,936.00,0.00
2024-12-10 17:35:47,53,930,16,37,525.87,936.02,0.00
2024-12-10 17:35:47,52,930,16,36,534.19,936.04,0.00
2024-12-10 17:35:47,52,931,16,36,536.41,937.00,0.00
2024-12-10 17:35:47,53,931,17,36,526.29,937.02,0.00
2024-12-10 17:35:47,53,932,17,36,524.73,938.00,0.00
2024-12-10 17:35:47,54,932,18,36,515.01,938.02,0.00
2024-12-10 17:35:47,53,932,18,35,523.14,938.04,0.00
2024-12-10 17:35:47,53,933,18,35,525.29,939.00,0.00
2024-12-10 17:35:47,54,933,18,36,515.56,939.02,0.00
2024-12-10 17:35:47,53,933,17,36,518.45,939.23,0.00
2024-12-10 17:35:47,53,934,17,36,529.33,940.00,0.00
2024-12-10 17:35:47,54,934,18,36,519.53,940.02,0.00
2024-12-10 17:35:47,53,934,18,35,527.91,940.04,0.00
2024-12-10 17:35:47,53,935,18,35,529.45,941.00,0.00
2024-12-10 17:35:47,54,935,19,35,519.65,941.02,0.00
2024-12-10 17:35:47,53,935,18,35,520.22,941.06,0.00
2024-12-10 17:35:47,52,935,17,35,524.94,941.63,0.00
2024-12-10 17:35:47,52,936,17,35,539.41,942.00,0.00
2024-12-10 17:35:47,53,936,18,35,529.23,942.02,0.00
2024-12-10 17:35:47,52,936,18,34,537.96,942.04,0.00
2024-12-10 17:35:47,52,937,18,34,540.35,943.00,0.00
2024-12-10 17:35:47,53,937,19,34,530.15,943.02,0.00
2024-12-10 17:35:47,53,938,19,34,529.22,944.00,0.00
2024-12-10 17:35:47,54,938,20,34,519.42,944.02,0.00
2024-12-10 17:35:47,53,938,20,33,526.61,944.06,0.00
2024-12-10 17:35:47,52,938,19,33,531.78,944.62,0.00
2024-12-10 17:35:47,51,938,18,33,539.57,944.73,0.00
2024-12-10 17:35:47,51,939,18,33,555.69,945.00,0.00
2024-12-10 17:35:47,52,939,19,33,545.00,945.02,0.00
2024-12-10 17:35:47,52,940,19,33,543.95,946.00,0.00
2024-12-10 17:35:47,53,940,19,34,533.68,946.02,0.00
2024-12-10 17:35:47,52,940,18,34,543.76,946.02,0.00
2024-12-10 17:35:47,51,940,18,33,552.02,946.04,0.00
2024-12-10 17:35:47,51,941,18,33,554.64,947.00,0.00
2024-12-10 17:35:47,52,941,18,34,543.98,947.02,0.00
2024-12-10 17:35:47,51,941,17,34,541.66,947.45,0.00
2024-12-10 17:35:47,51,942,17,34,555.41,948.00,0.00
2024-12-10 17:35:47,52,942,18,34,544.73,948.02,0.00
2024-12-10 17:35:47,51,942,18,33,552.63,948.04,0.00
2024-12-10 17:35:47,51,943,18,33,555.25,949.00,0.00
2024-12-10 17:35:47,52,943,19,33,544.58,949.02,0.00
2024-12-10 17:35:47,51,943,18,33,543.16,949.41,0.00
2024-12-10 17:35:47,50,943,17,33,552.60,949.58,0.00
2024-12-10 17:35:47,50,944,17,33,567.90,950.00,0.00
2024-12-10 17:35:47,51,944,17,34,556.76,950.02,0.00
2024-12-10 17:35:47,50,944,17,33,565.24,950.04,0.00
2024-12-10 17:35:47,50,945,17,33,568.12,951.00,0.00
2024-12-10 17:35:47,51,945,18,33,556.98,951.02,0.00
2024-12-10 17:35:47,51,946,18,33,556.02,952.00,0.00
2024-12-10 17:35:47,52,946,19,33,545.33,952.02,0.00
2024-12-10 17:35:47,51,946,19,32,553.41,952.04,0.00
2024-12-10 17:35:47,52,945,19,33,541.20,952.25,0.00
2024-12-10 17:35:47,52,946,19,33,553.78,953.00,0.00
2024-12-10 17:35:47,53,946,20,33,543.33,953.02,0.00
2024-12-10 17:35:47,52,946,19,33,544.57,953.62,0.00
2024-12-10 17:35:47,52,947,19,33,571.13,954.00,0.00
2024-12-10 17:35:47,53,947,20,33,560.36,954.02,0.00
2024-12-10 17:35:47,52,947,20,32,568.75,954.04,0.00
2024-12-10 17:35:47,52,948,20,32,571.18,955.00,0.00
2024-12-10 17:35:47,53,948,21,32,560.40,955.02,0.00
2024-12-10 17:35:47,52,948,20,32,561.23,955.65,0.00
2024-12-10 17:35:47,52,949,20,32,576.56,956.00,0.00
2024-12-10 17:35:47,53,949,20,33,565.68,956.02,0.00
2024-12-10 17:35:47,52,949,20,32,574.17,956.04,0.00
2024-12-10 17:35:47,51,949,19,32,580.31,956.61,0.00
2024-12-10 17:35:47,51,950,19,32,588.10,957.00,0.00
2024-12-10 17:35:47,52,950,19,33,576.79,957.02,0.00
2024-12-10 17:35:47,51,950,18,33,575.62,957.76,0.00
2024-12-10 17:35:47,51,951,18,33,592.33,958.00,0.00
2024-12-10 17:35:47,52,951,18,34,580.94,958.02,0.00
2024-12-10 17:35:47,51,951,18,33,589.52,958.04,0.00
2024-12-10 17:35:47,51,952,18,33,592.20,959.00,0.00
2024-12-10 17:35:47,52,952,19,33,580.81,959.02,0.00
2024-12-10 17:35:47,52,953,19,33,579.43,960.00,0.00
2024-12-10 17:35:47,53,953,19,34,568.49,960.02,0.00
2024-12-10 17:35:47,52,953,19,33,576.66,960.04,0.00
2024-12-10 17:35:47,52,954,19,33,579.11,961.00,0.00
2024-12-10 17:35:47,53,954,19,34,568.18,961.02,0.00
2024-12-10 17:35:47,53,955,19,34,566.95,962.00,0.00
2024-12-10 17:35:47,54,955,19,35,556.45,962.02,0.00
2024-12-10 17:35:47,53,955,19,34,564.05,962.04,0.00
2024-12-10 17:35:47,54,954,19,35,547.06,962.80,0.00
2024-12-10 17:35:47,54,955,19,35,564.88,963.00,0.00
2024-12-10 17:35:47,55,955,20,35,554.61,963.02,0.00
2024-12-10 17:35:47,55,956,20,35,570.93,964.00,0.00
2024-12-10 17:35:47,56,956,21,35,560.73,964.02,0.00
2024-12-10 17:35:47,55,956,21,34,568.30,964.04,0.00
2024-12-10 17:35:47,55,957,21,34,570.12,965.00,0.00
2024-12-10 17:35:47,56,957,21,35,559.94,965.02,0.00
2024-12-10 17:35:47,56,958,21,35,559.19,966.00,0.00
2024-12-10 17:35:47,57,958,22,35,549.38,966.02,0.00
2024-12-10 17:35:47,56,958,22,34,555.57,966.05,0.00
2024-12-10 17:35:47,55,958,21,34,560.90,966.56,0.00
2024-12-10 17:35:47,54,958,20,34,568.43,966.67,0.00
2024-12-10 17:35:47,54,959,20,34,583.37,967.00,0.00
2024-12-10 17:35:47,55,959,21,34,572.77,967.02,0.00
2024-12-10 17:35:47,55,960,21,34,571.32,968.00,0.00
2024-12-10 17:35:47,56,960,22,34,561.11,968.02,0.00
2024-12-10 17:35:47,55,960,22,33,567.80,968.05,0.00
2024-12-10 17:35:48,55,961,22,33,569.51,969.00,0.00
2024-12-10 17:35:48,56,961,22,34,559.34,969.02,0.00
2024-12-10 17:35:48,56,962,22,34,562.11,970.00,0.00
2024-12-10 17:35:48,57,962,23,34,552.25,970.02,0.00
2024-12-10 17:35:48,57,963,23,34,553.26,971.00,0.00
2024-12-10 17:35:48,58,963,24,34,543.72,971.02,0.00
2024-12-10 17:35:48,58,964,24,34,541.93,972.00,0.00
2024-12-10 17:35:48,59,964,25,34,532.74,972.02,0.00
2024-12-10 17:35:48,58,964,24,34,541.76,972.02,0.00
2024-12-10 17:35:48,57,964,24,33,547.52,972.04,0.00
2024-12-10 17:35:48,56,964,23,33,556.63,972.11,0.00
2024-12-10 17:35:48,55,964,22,33,562.14,972.56,0.00
2024-12-10 17:35:48,55,965,22,33,568.82,973.00,0.00
2024-12-10 17:35:48,56,965,23,33,558.67,973.02,0.00
2024-12-10 17:35:48,56,966,23,33,557.07,974.00,0.00
2024-12-10 17:35:48,57,966,23,34,547.30,974.02,0.00
2024-12-10 17:35:48,56,966,23,33,554.47,974.04,0.00
2024-12-10 17:35:48,56,967,23,33,556.08,975.00,0.00
2024-12-10 17:35:48,57,967,23,34,546.32,975.02,0.00
2024-12-10 17:35:48,57,968,23,34,544.62,976.00,0.00
2024-12-10 17:35:48,58,968,23,35,535.23,976.02,0.00
2024-12-10 17:35:48,57,968,23,34,542.22,976.04,0.00
2024-12-10 17:35:48,56,968,22,34,545.81,976.61,0.00
2024-12-10 17:35:48,56,969,22,34,552.72,977.00,0.00
2024-12-10 17:35:48,57,969,22,35,543.02,977.02,0.00
2024-12-10 17:35:48,57,970,22,35,540.91,978.00,0.00
2024-12-10 17:35:48,58,970,23,35,531.58,978.02,0.00
2024-12-10 17:35:48,57,970,23,34,538.68,978.04,0.00
2024-12-10 17:35:48,56,970,22,34,539.22,978.45,0.00
2024-12-10 17:35:48,56,971,22,34,551.66,979.00,0.00
2024-12-10 17:35:48,57,971,22,35,541.98,979.02,0.00
2024-12-10 17:35:48,57,972,22,35,540.30,980.00,0.00
2024-12-10 17:35:48,58,972,22,36,530.99,980.02,0.00
2024-12-10 17:35:48,57,972,22,35,538.24,980.04,0.00
2024-12-10 17:35:48,56,972,21,35,536.70,980.54,0.00
2024-12-10 17:35:48,56,973,21,35,549.99,981.00,0.00
2024-12-10 17:35:48,57,973,22,35,540.34,981.02,0.00
2024-12-10 17:35:48,56,973,21,35,539.23,981.39,0.00
2024-12-10 17:35:48,56,974,21,35,551.21,982.00,0.00
2024-12-10 17:35:48,57,974,21,36,541.54,982.02,0.00
2024-12-10 17:35:48,56,974,21,35,549.11,982.04,0.00
2024-12-10 17:35:48,56,975,21,35,550.72,983.00,0.00
2024-12-10 17:35:48,57,975,21,36,541.06,983.02,0.00
2024-12-10 17:35:48,56,975,20,36,547.21,983.02,0.00
2024-12-10 17:35:48,56,976,20,36,552.16,984.00,0.00
2024-12-10 17:35:48,57,976,20,37,542.47,984.02,0.00
2024-12-10 17:35:48,56,976,20,36,550.40,984.02,0.00
2024-12-10 17:35:48,55,976,20,35,558.26,984.24,0.00
2024-12-10 17:35:48,55,977,20,35,561.98,985.00,0.00
2024-12-10 17:35:48,56,977,20,36,551.94,985.02,0.00
2024-12-10 17:35:48,55,977,19,36,557.00,985.15,0.00
2024-12-10 17:35:48,55,978,19,36,567.03,986.00,0.00
2024-12-10 17:35:48,56,978,20,36,556.90,986.02,0.00
2024-12-10 17:35:48,55,978,20,35,565.06,986.02,0.00
2024-12-10 17:35:48,54,978,19,35,570.05,986.59,0.00
2024-12-10 17:35:48,53,978,18,35,573.55,986.60,0.00
2024-12-10 17:35:48,53,979,18,35,588.55,987.00,0.00
2024-12-10 17:35:48,54,979,19,35,577.65,987.02,0.00
2024-12-10 17:35:48,54,980,19,35,575.86,988.00,0.00
2024-12-10 17:35:48,55,980,20,35,565.39,988.02,0.00
2024-12-10 17:35:48,54,980,20,34,574.03,988.02,0.00
2024-12-10 17:35:48,54,981,20,34,575.89,989.00,0.00
2024-12-10 17:35:48,55,981,21,34,565.42,989.02,0.00
2024-12-10 17:35:48,54,981,20,34,562.17,989.48,0.00
2024-12-10 17:35:48,54,982,20,34,575.74,990.00,0.00
2024-12-10 17:35:48,55,982,21,34,565.27,990.02,0.00
2024-12-10 17:35:48,54,982,21,33,574.09,990.02,0.00
2024-12-10 17:35:48,54,983,21,33,575.96,991.00,0.00
2024-12-10 17:35:48,55,983,22,33,565.48,991.02,0.00
2024-12-10 17:35:48,55,984,22,33,563.53,992.00,0.00
2024-12-10 17:35:48,56,984,23,33,553.47,992.02,0.00
2024-12-10 17:35:48,55,984,23,32,562.09,992.02,0.00
2024-12-10 17:35:48,54,984,22,32,571.43,992.13,0.00
2024-12-10 17:35:48,53,984,21,32,569.75,992.64,0.00
2024-12-10 17:35:48,53,985,21,32,585.20,993.00,0.00
2024-12-10 17:35:48,54,985,21,33,574.36,993.02,0.00
2024-12-10 17:35:48,53,985,20,33,574.82,993.32,0.00
2024-12-10 17:35:48,53,986,20,33,587.29,994.00,0.00
2024-12-10 17:35:48,54,986,21,33,576.41,994.02,0.00
2024-12-10 17:35:48,53,986,21,32,585.97,994.02,0.00
2024-12-10 17:35:48,53,987,21,32,588.07,995.00,0.00
2024-12-10 17:35:48,54,987,22,32,577.18,995.02,0.00
2024-12-10 17:35:48,54,988,22,32,575.36,996.00,0.00
2024-12-10 17:35:48,55,988,23,32,564.90,996.02,0.00
2024-12-10 17:35:48,54,988,23,31,574.07,996.02,0.00
2024-12-10 17:35:48,54,989,23,31,575.94,997.00,0.00
2024-12-10 17:35:48,55,989,24,31,565.46,997.02,0.00
2024-12-10 17:35:48,54,989,23,31,559.48,997.57,0.00
2024-12-10 17:35:48,54,990,23,31,574.03,998.00,0.00
2024-12-10 17:35:48,55,990,23,32,563.59,998.02,0.00
2024-12-10 17:35:48,54,990,23,31,572.73,998.02,0.00
2024-12-10 17:35:48,55,989,24,31,558.50,998.45,0.00
2024-12-10 17:35:48,55,990,24,31,570.15,999.00,0.00
2024-12-10 17:35:48,56,990,25,31,559.97,999.02,0.00
2024-12-10 17:35:48,55,990,24,31,555.66,999.53,0.00
2024-12-10 17:35:48,55,991,24,31,587.63,1000.00,0.00
2024-12-10 17:35:48,56,991,25,31,577.13,1000.02,0.00
2024-12-10 17:35:48,55,991,25,30,586.17,1000.02,0.00
2024-12-10 17:35:48,54,991,24,30,595.77,1000.13,0.00
2024-12-10 17:35:48,54,992,24,30,598.74,1001.00,0.00
2024-12-10 17:35:48,55,992,25,30,587.85,1001.02,0.00
2024-12-10 17:35:48,55,993,25,30,585.89,1002.00,0.00
2024-12-10 17:35:48,56,993,25,31,575.43,1002.02,0.00
2024-12-10 17:35:48,55,993,25,30,584.61,1002.02,0.00
2024-12-10 17:35:49,55,994,25,30,586.29,1003.00,0.00
2024-12-10 17:35:49,56,994,25,31,575.82,1003.02,0.00
2024-12-10 17:35:49,56,995,25,31,573.71,1004.00,0.00
2024-12-10 17:35:49,57,995,25,32,563.64,1004.02,0.00
2024-12-10 17:35:49,56,995,25,31,572.45,1004.02,0.00
2024-12-10 17:35:49,55,995,24,31,571.34,1004.93,0.00
2024-12-10 17:35:49,55,996,24,31,588.92,1005.00,0.00
2024-12-10 17:35:49,56,996,24,32,578.41,1005.02,0.00
2024-12-10 17:35:49,55,996,23,32,574.17,1005.53,0.00
2024-12-10 17:35:49,55,997,23,32,588.04,1006.00,0.00
2024-12-10 17:35:49,56,997,24,32,577.54,1006.02,0.00
2024-12-10 17:35:49,55,997,24,31,586.40,1006.02,0.00
2024-12-10 17:35:49,55,998,24,31,588.08,1007.00,0.00
2024-12-10 17:35:49,56,998,24,32,577.58,1007.02,0.00
2024-12-10 17:35:49,55,998,23,32,572.95,1007.55,0.00
2024-12-10 17:35:49,55,999,23,32,587.01,1008.00,0.00
2024-12-10 17:35:49,56,999,24,32,576.53,1008.02,0.00
2024-12-10 17:35:49,55,999,24,31,585.36,1008.02,0.00
2024-12-10 17:35:49,55,1000,24,31,587.05,1009.00,0.00
2024-12-10 17:35:49,56,1000,24,32,576.56,1009.02,0.00
2024-12-10 17:35:49,55,1000,23,32,582.89,1009.06,0.00
2024-12-10 17:35:49,54,1000,22,32,591.48,1009.15,0.00
2024-12-10 17:35:49,54,1001,22,32,602.10,1010.00,0.00
2024-12-10 17:35:49,55,1001,22,33,591.16,1010.02,0.00
2024-12-10 17:35:49,54,1001,22,32,600.05,1010.04,0.00
2024-12-10 17:35:49,54,1002,22,32,602.08,1011.00,0.00
2024-12-10 17:35:49,55,1002,23,32,591.13,1011.02,0.00
2024-12-10 17:35:49,55,1003,23,32,589.63,1012.00,0.00
2024-12-10 17:35:49,56,1003,24,32,579.10,1012.02,0.00
2024-12-10 17:35:49,55,1003,24,31,586.69,1012.04,0.00
2024-12-10 17:35:49,54,1003,23,31,592.35,1012.57,0.00
2024-12-10 17:35:49,54,1004,23,31,607.04,1013.00,0.00
2024-12-10 17:35:49,55,1004,23,32,596.00,1013.02,0.00
2024-12-10 17:35:49,54,1004,22,32,600.86,1013.07,0.00
2024-12-10 17:35:49,54,1005,22,32,610.83,1014.00,0.00
2024-12-10 17:35:49,55,1005,22,33,599.73,1014.02,0.00
2024-12-10 17:35:49,54,1005,22,32,608.02,1014.04,0.00
2024-12-10 17:35:49,54,1006,22,32,610.12,1015.00,0.00
2024-12-10 17:35:49,55,1006,23,32,599.03,1015.02,0.00
2024-12-10 17:35:49,54,1006,22,32,595.33,1015.52,0.00
2024-12-10 17:35:49,54,1007,22,32,609.59,1016.00,0.00
2024-12-10 17:35:49,55,1007,23,32,598.51,1016.02,0.00
2024-12-10 17:35:49,54,1007,23,31,606.59,1016.04,0.00
2024-12-10 17:35:49,53,1007,22,31,612.40,1016.62,0.00
2024-12-10 17:35:49,53,1008,22,31,620.36,1017.00,0.00
2024-12-10 17:35:49,54,1008,22,32,608.87,1017.02,0.00
2024-12-10 17:35:49,53,1008,21,32,616.14,1017.02,0.00
2024-12-10 17:35:49,53,1009,21,32,622.12,1018.00,0.00
2024-12-10 17:35:49,54,1009,22,32,610.60,1018.02,0.00
2024-12-10 17:35:49,53,1009,22,31,619.24,1018.02,0.00
2024-12-10 17:35:49,52,1009,21,31,624.38,1018.25,0.00
2024-12-10 17:35:49,51,1009,20,31,633.25,1018.61,0.00
2024-12-10 17:35:49,51,1010,20,31,649.54,1019.00,0.00
2024-12-10 17:35:49,52,1010,21,31,637.04,1019.02,0.00
2024-12-10 17:35:49,52,1011,21,31,635.73,1020.00,0.00
2024-12-10 17:35:49,53,1011,21,32,623.73,1020.02,0.00
2024-12-10 17:35:49,52,1011,21,31,632.01,1020.04,0.00
2024-12-10 17:35:49,52,1012,21,31,634.58,1021.00,0.00
2024-12-10 17:35:49,53,1012,21,32,622.61,1021.02,0.00
2024-12-10 17:35:49,53,1013,21,32,621.20,1022.00,0.00
2024-12-10 17:35:49,54,1013,21,33,609.70,1022.02,0.00
2024-12-10 17:35:49,53,1013,21,32,617.74,1022.04,0.00
2024-12-10 17:35:49,53,1014,21,32,620.07,1023.00,0.00
2024-12-10 17:35:49,54,1014,22,32,608.59,1023.02,0.00
2024-12-10 17:35:49,53,1014,21,32,607.13,1023.42,0.00
2024-12-10 17:35:49,53,1015,21,32,620.87,1024.00,0.00
2024-12-10 17:35:49,54,1015,21,33,609.38,1024.02,0.00
2024-12-10 17:35:49,53,1015,21,32,617.40,1024.04,0.00
2024-12-10 17:35:49,53,1016,21,32,619.74,1025.00,0.00
2024-12-10 17:35:49,54,1016,22,32,608.26,1025.02,0.00
2024-12-10 17:35:49,54,1017,22,32,606.89,1026.00,0.00
2024-12-10 17:35:49,55,1017,22,33,595.86,1026.02,0.00
2024-12-10 17:35:49,54,1017,22,32,603.67,1026.04,0.00
2024-12-10 17:35:49,54,1018,22,32,605.77,1027.00,0.00
2024-12-10 17:35:49,55,1018,22,33,594.76,1027.02,0.00
2024-12-10 17:35:49,55,1019,22,33,592.72,1028.00,0.00
2024-12-10 17:35:49,56,1019,22,34,582.14,1028.02,0.00
2024-12-10 17:35:49,55,1019,22,33,591.04,1028.02,0.00
2024-12-10 17:35:49,54,1019,21,33,601.25,1028.09,0.00
2024-12-10 17:35:49,54,1020,21,33,603.90,1029.00,0.00
2024-12-10 17:35:49,55,1020,22,33,592.92,1029.02,0.00
2024-12-10 17:35:49,54,1020,21,33,594.11,1029.59,0.00
2024-12-10 17:35:49,54,1021,21,33,602.14,1030.00,0.00
2024-12-10 17:35:49,55,1021,21,34,591.19,1030.02,0.00
2024-12-10 17:35:49,54,1021,21,33,599.66,1030.02,0.00
2024-12-10 17:35:49,54,1022,21,33,601.14,1031.00,0.00
2024-12-10 17:35:49,55,1022,21,34,590.21,1031.02,0.00
2024-12-10 17:35:49,54,1022,20,34,590.89,1031.59,0.00
2024-12-10 17:35:49,54,1023,20,34,598.71,1032.00,0.00
2024-12-10 17:35:49,55,1023,20,35,587.82,1032.02,0.00
2024-12-10 17:35:49,54,1023,20,34,596.61,1032.02,0.00
2024-12-10 17:35:49,54,1024,20,34,597.88,1033.00,0.00
2024-12-10 17:35:49,55,1024,21,34,587.01,1033.02,0.00
2024-12-10 17:35:49,54,1024,20,34,584.73,1033.61,0.00
2024-12-10 17:35:49,54,1025,20,34,600.13,1034.00,0.00
2024-12-10 17:35:49,55,1025,20,35,589.22,1034.02,0.00
2024-12-10 17:35:49,54,1025,19,35,584.16,1034.61,0.00
2024-12-10 17:35:49,54,1026,19,35,599.59,1035.00,0.00
2024-12-10 17:35:49,55,1026,19,36,588.69,1035.02,0.00
2024-12-10 17:35:49,54,1026,18,36,587.05,1035.43,0.00
2024-12-10 17:35:49,54,1027,18,36,600.69,1036.00,0.00
2024-12-10 17:35:49,55,1027,18,37,589.77,1036.02,0.00
2024-12-10 17:35:49,54,1027,18,36,600.12,1036.02,0.00
2024-12-10 17:35:50,53,1027,17,36,605.38,1036.02,0.00
2024-12-10 17:35:50,53,1028,17,36,615.07,1037.00,0.00
2024-12-10 17:35:50,54,1028,17,37,603.68,1037.02,0.00
2024-12-10 17:35:50,53,1028,16,37,602.70,1037.40,0.00
2024-12-10 17:35:50,53,1029,16,37,616.45,1038.00,0.00
2024-12-10 17:35:50,54,1029,16,38,605.03,1038.02,0.00
2024-12-10 17:35:50,53,1029,16,37,613.90,1038.04,0.00
2024-12-10 17:35:50,52,1029,15,37,618.63,1038.35,0.00
2024-12-10 17:35:50,51,1029,14,37,627.89,1038.63,0.00
2024-12-10 17:35:50,51,1030,14,37,644.68,1039.00,0.00
2024-12-10 17:35:50,52,1030,14,38,632.29,1039.02,0.00
2024-12-10 17:35:50,52,1031,14,38,630.96,1040.00,0.00
2024-12-10 17:35:50,53,1031,14,39,619.06,1040.02,0.00
2024-12-10 17:35:50,52,1031,14,38,627.76,1040.04,0.00
2024-12-10 17:35:50,51,1031,13,38,634.17,1040.61,0.00
2024-12-10 17:35:50,51,1032,13,38,650.82,1041.00,0.00
2024-12-10 17:35:50,52,1032,14,38,638.31,1041.02,0.00
2024-12-10 17:35:50,51,1032,13,38,640.93,1041.31,0.00
2024-12-10 17:35:50,51,1033,13,38,654.72,1042.00,0.00
2024-12-10 17:35:50,52,1033,13,39,642.13,1042.02,0.00
2024-12-10 17:35:50,51,1033,12,39,654.68,1042.02,0.00
2024-12-10 17:35:50,50,1033,12,38,664.86,1042.02,0.00
2024-12-10 17:35:50,50,1034,12,38,667.79,1043.00,0.00
2024-12-10 17:35:50,51,1034,12,39,654.69,1043.02,0.00
2024-12-10 17:35:50,51,1035,12,39,653.28,1044.00,0.00
2024-12-10 17:35:50,52,1035,13,39,640.71,1044.02,0.00
2024-12-10 17:35:50,51,1035,13,38,650.61,1044.02,0.00
2024-12-10 17:35:50,50,1035,12,38,650.66,1044.96,0.00
2024-12-10 17:35:50,50,1036,12,38,671.16,1045.00,0.00
2024-12-10 17:35:50,51,1036,12,39,658.00,1045.02,0.00
2024-12-10 17:35:50,51,1037,12,39,656.58,1046.00,0.00
2024-12-10 17:35:50,52,1037,13,39,643.95,1046.02,0.00
2024-12-10 17:35:50,51,1037,13,38,654.12,1046.02,0.00
2024-12-10 17:35:50,51,1038,13,38,656.79,1047.00,0.00
2024-12-10 17:35:50,52,1038,13,39,644.16,1047.02,0.00
2024-12-10 17:35:50,52,1039,13,39,642.56,1048.00,0.00
2024-12-10 17:35:50,53,1039,14,39,630.44,1048.02,0.00
2024-12-10 17:35:50,52,1039,14,38,640.14,1048.02,0.00
2024-12-10 17:35:50,52,1040,14,38,642.57,1049.00,0.00
2024-12-10 17:35:50,53,1040,14,39,630.45,1049.02,0.00
2024-12-10 17:35:50,53,1041,14,39,628.67,1050.00,0.00
2024-12-10 17:35:50,54,1041,15,39,617.03,1050.02,0.00
2024-12-10 17:35:50,53,1041,15,38,626.49,1050.02,0.00
2024-12-10 17:35:50,54,1040,16,38,613.01,1050.24,0.00
2024-12-10 17:35:50,53,1040,15,38,631.72,1050.57,0.00
2024-12-10 17:35:50,53,1041,15,38,647.31,1051.00,0.00
2024-12-10 17:35:50,54,1041,16,38,635.33,1051.02,0.00
2024-12-10 17:35:50,53,1041,15,38,634.45,1051.11,0.00
2024-12-10 17:35:50,53,1042,15,38,665.40,1052.00,0.00
2024-12-10 17:35:50,54,1042,15,39,653.08,1052.02,0.00
2024-12-10 17:35:50,53,1042,15,38,663.21,1052.02,0.00
2024-12-10 17:35:50,53,1043,15,38,665.43,1053.00,0.00
2024-12-10 17:35:50,54,1043,16,38,653.11,1053.02,0.00
2024-12-10 17:35:50,53,1043,15,38,654.12,1053.08,0.00
2024-12-10 17:35:50,53,1044,15,38,664.87,1054.00,0.00
2024-12-10 17:35:50,54,1044,16,38,652.56,1054.02,0.00
2024-12-10 17:35:50,53,1044,16,37,662.88,1054.02,0.00
2024-12-10 17:35:50,53,1045,16,37,665.11,1055.00,0.00
2024-12-10 17:35:50,54,1045,17,37,652.79,1055.02,0.00
2024-12-10 17:35:50,53,1045,16,37,653.90,1055.32,0.00
2024-12-10 17:35:50,53,1046,16,37,667.13,1056.00,0.00
2024-12-10 17:35:50,54,1046,16,38,654.78,1056.02,0.00
2024-12-10 17:35:50,53,1046,16,37,665.34,1056.02,0.00
2024-12-10 17:35:50,53,1047,16,37,667.56,1057.00,0.00
2024-12-10 17:35:50,54,1047,16,38,655.20,1057.02,0.00
2024-12-10 17:35:50,54,1048,16,38,653.27,1058.00,0.00
2024-12-10 17:35:50,55,1048,17,38,641.40,1058.02,0.00
2024-12-10 17:35:50,54,1048,17,37,651.71,1058.02,0.00
2024-12-10 17:35:50,53,1048,16,37,651.79,1058.93,0.00
2024-12-10 17:35:50,53,1049,16,37,671.02,1059.00,0.00
2024-12-10 17:35:50,54,1049,16,38,658.60,1059.02,0.00
2024-12-10 17:35:50,54,1050,16,38,656.67,1060.00,0.00
2024-12-10 17:35:50,55,1050,17,38,644.73,1060.02,0.00
2024-12-10 17:35:50,54,1050,17,37,653.53,1060.06,0.00
2024-12-10 17:35:50,53,1050,16,37,654.02,1060.93,0.00
2024-12-10 17:35:50,53,1051,16,37,673.29,1061.00,0.00
2024-12-10 17:35:50,54,1051,17,37,660.82,1061.02,0.00
2024-12-10 17:35:50,54,1052,17,37,659.83,1062.00,0.00
2024-12-10 17:35:50,55,1052,17,38,647.83,1062.02,0.00
2024-12-10 17:35:50,54,1052,17,37,654.94,1062.09,0.00
2024-12-10 17:35:50,54,1053,17,37,657.69,1063.00,0.00
2024-12-10 17:35:50,55,1053,18,37,645.73,1063.02,0.00
2024-12-10 17:35:50,54,1053,17,37,646.65,1063.69,0.00
2024-12-10 17:35:50,54,1054,17,37,663.24,1064.00,0.00
2024-12-10 17:35:50,55,1054,18,37,651.18,1064.02,0.00
2024-12-10 17:35:50,54,1054,18,36,658.54,1064.09,0.00
2024-12-10 17:35:50,54,1055,18,36,661.30,1065.00,0.00
2024-12-10 17:35:50,55,1055,19,36,649.27,1065.02,0.00
2024-12-10 17:35:50,55,1056,19,36,647.83,1066.00,0.00
2024-12-10 17:35:50,56,1056,20,36,636.26,1066.02,0.00
2024-12-10 17:35:50,55,1056,20,35,643.40,1066.09,0.00
2024-12-10 17:35:50,54,1056,19,35,649.33,1066.67,0.00
2024-12-10 17:35:50,54,1057,19,35,657.88,1067.00,0.00
2024-12-10 17:35:50,55,1057,19,36,645.92,1067.02,0.00
2024-12-10 17:35:50,55,1058,19,36,644.41,1068.00,0.00
2024-12-10 17:35:50,56,1058,20,36,632.90,1068.02,0.00
2024-12-10 17:35:50,55,1058,19,36,644.35,1068.02,0.00
2024-12-10 17:35:50,54,1058,19,35,652.16,1068.07,0.00
2024-12-10 17:35:50,53,1058,18,35,656.35,1068.74,0.00
2024-12-10 17:35:50,53,1059,18,35,673.91,1069.00,0.00
2024-12-10 17:35:50,54,1059,18,36,661.43,1069.02,0.00
2024-12-10 17:35:50,54,1060,18,36,659.81,1070.00,0.00
2024-12-10 17:35:50,55,1060,19,36,647.81,1070.02,0.00
2024-12-10 17:35:50,54,1060,19,35,655.67,1070.07,0.00
2024-12-10 17:35:51,53,1060,18,35,661.30,1070.34,0.00
2024-12-10 17:35:51,53,1061,18,35,674.91,1071.00,0.00
2024-12-10 17:35:51,54,1061,18,36,662.41,1071.02,0.00
2024-12-10 17:35:51,53,1061,17,36,670.46,1071.02,0.00
2024-12-10 17:35:51,53,1062,17,36,676.75,1072.00,0.00
2024-12-10 17:35:51,54,1062,18,36,664.22,1072.02,0.00
2024-12-10 17:35:51,53,1062,18,35,672.72,1072.06,0.00
2024-12-10 17:35:51,53,1063,18,35,675.36,1073.00,0.00
2024-12-10 17:35:51,54,1063,19,35,662.85,1073.02,0.00
2024-12-10 17:35:51,54,1064,19,35,660.94,1074.00,0.00
2024-12-10 17:35:51,55,1064,20,35,648.92,1074.02,0.00
2024-12-10 17:35:51,54,1064,20,34,657.18,1074.06,0.00
2024-12-10 17:35:51,53,1064,19,34,663.73,1074.62,0.00
2024-12-10 17:35:51,53,1065,19,34,672.12,1075.00,0.00
2024-12-10 17:35:51,54,1065,20,34,659.68,1075.02,0.00
2024-12-10 17:35:51,54,1066,20,34,657.92,1076.00,0.00
2024-12-10 17:35:51,55,1066,20,35,645.96,1076.02,0.00
2024-12-10 17:35:51,54,1066,20,34,653.95,1076.06,0.00
2024-12-10 17:35:51,54,1067,20,34,656.34,1077.00,0.00
2024-12-10 17:35:51,55,1067,20,35,644.40,1077.02,0.00
2024-12-10 17:35:51,55,1068,20,35,642.51,1078.00,0.00
2024-12-10 17:35:51,56,1068,20,36,631.04,1078.02,0.00
2024-12-10 17:35:51,55,1068,20,35,638.80,1078.06,0.00
2024-12-10 17:35:51,54,1068,19,35,650.57,1078.06,0.00
2024-12-10 17:35:51,54,1069,19,35,660.95,1079.00,0.00
2024-12-10 17:35:51,55,1069,20,35,648.93,1079.02,0.00
2024-12-10 17:35:51,55,1070,20,35,647.25,1080.00,0.00
2024-12-10 17:35:51,56,1070,21,35,635.70,1080.02,0.00
2024-12-10 17:35:51,55,1070,21,34,643.34,1080.06,0.00
2024-12-10 17:35:51,55,1071,21,34,645.49,1081.00,0.00
2024-12-10 17:35:51,56,1071,22,34,633.97,1081.02,0.00
2024-12-10 17:35:51,56,1072,22,34,632.46,1082.00,0.00
2024-12-10 17:35:51,57,1072,23,34,621.36,1082.02,0.00
2024-12-10 17:35:51,56,1072,23,33,628.42,1082.05,0.00
2024-12-10 17:35:51,56,1073,23,33,630.34,1083.00,0.00
2024-12-10 17:35:51,57,1073,24,33,619.28,1083.02,0.00
2024-12-10 17:35:51,56,1073,23,33,614.35,1083.88,0.00
2024-12-10 17:35:51,56,1074,23,33,632.44,1084.00,0.00
2024-12-10 17:35:51,57,1074,23,34,621.34,1084.02,0.00
2024-12-10 17:35:51,56,1074,23,33,628.58,1084.05,0.00
2024-12-10 17:35:51,55,1074,22,33,639.82,1084.07,0.00
2024-12-10 17:35:51,55,1075,22,33,642.16,1085.00,0.00
2024-12-10 17:35:51,56,1075,22,34,630.70,1085.02,0.00
2024-12-10 17:35:51,55,1075,21,34,624.91,1085.60,0.00
2024-12-10 17:35:51,55,1076,21,34,640.58,1086.00,0.00
2024-12-10 17:35:51,56,1076,21,35,629.14,1086.02,0.00
2024-12-10 17:35:51,55,1076,21,34,636.84,1086.06,0.00
2024-12-10 17:35:51,54,1076,20,34,635.27,1086.61,0.00
2024-12-10 17:35:51,54,1077,20,34,651.44,1087.00,0.00
2024-12-10 17:35:51,55,1077,20,35,639.59,1087.02,0.00
2024-12-10 17:35:51,54,1077,19,35,640.84,1087.65,0.00
2024-12-10 17:35:51,54,1078,19,35,649.84,1088.00,0.00
2024-12-10 17:35:51,55,1078,19,36,638.03,1088.02,0.00
2024-12-10 17:35:51,54,1078,19,35,646.03,1088.06,0.00
2024-12-10 17:35:51,53,1078,18,35,650.93,1088.66,0.00
2024-12-10 17:35:51,53,1079,18,35,668.04,1089.00,0.00
2024-12-10 17:35:51,54,1079,19,35,655.67,1089.02,0.00
2024-12-10 17:35:51,54,1080,19,35,653.82,1090.00,0.00
2024-12-10 17:35:51,55,1080,20,35,641.93,1090.02,0.00
2024-12-10 17:35:51,54,1080,20,34,650.00,1090.06,0.00
2024-12-10 17:35:51,54,1081,20,34,652.40,1091.00,0.00
2024-12-10 17:35:51,55,1081,21,34,640.54,1091.02,0.00
2024-12-10 17:35:51,55,1082,21,34,638.72,1092.00,0.00
2024-12-10 17:35:51,56,1082,22,34,627.32,1092.02,0.00
2024-12-10 17:35:51,55,1082,22,33,635.16,1092.06,0.00
2024-12-10 17:35:51,55,1083,22,33,637.32,1093.00,0.00
2024-12-10 17:35:51,56,1083,22,34,625.94,1093.02,0.00
2024-12-10 17:35:51,55,1083,21,34,625.09,1093.69,0.00
2024-12-10 17:35:51,55,1084,21,34,641.83,1094.00,0.00
2024-12-10 17:35:51,56,1084,21,35,630.36,1094.02,0.00
2024-12-10 17:35:51,55,1084,21,34,638.46,1094.06,0.00
2024-12-10 17:35:51,55,1085,21,34,640.62,1095.00,0.00
2024-12-10 17:35:51,56,1085,22,34,629.18,1095.02,0.00
2024-12-10 17:35:51,56,1086,22,34,627.27,1096.00,0.00
2024-12-10 17:35:51,57,1086,23,34,616.27,1096.02,0.00
2024-12-10 17:35:51,56,1086,23,33,623.95,1096.05,0.00
2024-12-10 17:35:51,56,1087,23,33,625.89,1097.00,0.00
2024-12-10 17:35:51,57,1087,23,34,614.91,1097.02,0.00
2024-12-10 17:35:51,57,1088,23,34,612.91,1098.00,0.00
2024-12-10 17:35:51,58,1088,24,34,602.34,1098.02,0.00
2024-12-10 17:35:51,57,1088,24,33,612.72,1098.02,0.00
2024-12-10 17:35:51,56,1088,24,32,620.73,1098.04,0.00
2024-12-10 17:35:51,56,1089,24,32,622.46,1099.00,0.00
2024-12-10 17:35:51,57,1089,25,32,611.54,1099.02,0.00
2024-12-10 17:35:51,57,1090,25,32,609.51,1100.00,0.00
2024-12-10 17:35:51,58,1090,26,32,599.00,1100.02,0.00
2024-12-10 17:35:51,57,1090,26,31,606.81,1100.04,0.00
2024-12-10 17:35:51,57,1091,26,31,608.32,1101.00,0.00
2024-12-10 17:35:51,58,1091,26,32,597.83,1101.02,0.00
2024-12-10 17:35:51,58,1092,26,32,595.78,1102.00,0.00
2024-12-10 17:35:51,59,1092,27,32,585.68,1102.02,0.00
2024-12-10 17:35:51,58,1092,26,32,589.52,1102.03,0.00
2024-12-10 17:35:51,57,1092,26,31,597.35,1102.04,0.00
2024-12-10 17:35:51,57,1093,26,31,606.59,1103.00,0.00
2024-12-10 17:35:51,58,1093,26,32,596.13,1103.02,0.00
2024-12-10 17:35:51,58,1094,26,32,594.17,1104.00,0.00
2024-12-10 17:35:51,59,1094,26,33,584.10,1104.02,0.00
2024-12-10 17:35:51,58,1094,26,32,591.70,1104.03,0.00
2024-12-10 17:35:51,57,1094,25,32,595.42,1104.65,0.00
2024-12-10 17:35:52,57,1095,25,32,603.42,1105.00,0.00
2024-12-10 17:35:52,58,1095,26,32,593.02,1105.02,0.00
2024-12-10 17:35:52,57,1095,25,32,593.17,1105.61,0.00
2024-12-10 17:35:52,56,1095,24,32,603.62,1105.63,0.00
2024-12-10 17:35:52,56,1096,24,32,619.48,1106.00,0.00
2024-12-10 17:35:52,57,1096,24,33,608.61,1106.02,0.00
2024-12-10 17:35:52,56,1096,24,32,617.12,1106.04,0.00
2024-12-10 17:35:52,56,1097,24,32,618.86,1107.00,0.00
2024-12-10 17:35:52,57,1097,24,33,608.00,1107.02,0.00
2024-12-10 17:35:52,56,1097,23,33,607.32,1107.38,0.00
2024-12-10 17:35:52,56,1098,23,33,620.58,1108.00,0.00
2024-12-10 17:35:52,57,1098,24,33,609.70,1108.02,0.00
2024-12-10 17:35:52,56,1098,24,32,618.42,1108.04,0.00
2024-12-10 17:35:52,56,1099,24,32,620.15,1109.00,0.00
2024-12-10 17:35:52,57,1099,24,33,609.27,1109.02,0.00
2024-12-10 17:35:52,57,1100,24,33,606.75,1110.00,0.00
2024-12-10 17:35:52,58,1100,24,34,596.29,1110.02,0.00
2024-12-10 17:35:52,57,1100,24,33,604.81,1110.04,0.00
2024-12-10 17:35:52,56,1100,23,33,609.12,1110.64,0.00
2024-12-10 17:35:52,56,1101,23,33,625.24,1111.00,0.00
2024-12-10 17:35:52,57,1101,24,33,614.27,1111.02,0.00
2024-12-10 17:35:52,57,1102,24,33,611.70,1112.00,0.00
2024-12-10 17:35:52,58,1102,25,33,601.16,1112.02,0.00
2024-12-10 17:35:52,57,1102,25,32,609.95,1112.04,0.00
2024-12-10 17:35:52,57,1103,25,32,611.47,1113.00,0.00
2024-12-10 17:35:52,58,1103,26,32,600.93,1113.02,0.00
2024-12-10 17:35:52,57,1103,25,32,606.28,1113.12,0.00
2024-12-10 17:35:52,58,1102,26,32,591.23,1113.59,0.00
2024-12-10 17:35:52,58,1103,26,32,603.37,1114.00,0.00
2024-12-10 17:35:52,59,1103,26,33,593.14,1114.02,0.00
2024-12-10 17:35:52,58,1103,26,32,601.84,1114.03,0.00
2024-12-10 17:35:52,58,1104,26,32,622.36,1115.00,0.00
2024-12-10 17:35:52,59,1104,27,32,611.82,1115.02,0.00
2024-12-10 17:35:52,59,1105,27,32,608.96,1116.00,0.00
2024-12-10 17:35:52,60,1105,27,33,598.81,1116.02,0.00
2024-12-10 17:35:52,59,1105,27,32,607.45,1116.03,0.00
2024-12-10 17:35:52,59,1106,27,32,608.56,1117.00,0.00
2024-12-10 17:35:52,60,1106,27,33,598.42,1117.02,0.00
2024-12-10 17:35:52,60,1107,27,33,595.61,1118.00,0.00
2024-12-10 17:35:52,61,1107,28,33,585.84,1118.02,0.00
2024-12-10 17:35:52,60,1107,28,32,594.31,1118.03,0.00
2024-12-10 17:35:52,61,1106,28,33,577.19,1118.75,0.00
2024-12-10 17:35:52,60,1106,27,33,584.88,1118.92,0.00
2024-12-10 17:35:52,60,1107,27,33,602.67,1119.00,0.00
2024-12-10 17:35:52,61,1107,27,34,592.79,1119.02,0.00
2024-12-10 17:35:52,61,1108,27,34,608.50,1120.00,0.00
2024-12-10 17:35:52,62,1108,28,34,598.69,1120.02,0.00
2024-12-10 17:35:52,61,1108,28,33,607.22,1120.03,0.00
2024-12-10 17:35:52,60,1108,27,33,613.73,1120.22,0.00
2024-12-10 17:35:52,59,1108,26,33,619.60,1120.64,0.00
2024-12-10 17:35:52,59,1109,26,33,634.88,1121.00,0.00
2024-12-10 17:35:52,60,1109,27,33,624.30,1121.02,0.00
2024-12-10 17:35:52,60,1110,27,33,621.46,1122.00,0.00
2024-12-10 17:35:52,61,1110,27,34,611.27,1122.02,0.00
2024-12-10 17:35:52,60,1110,27,33,620.15,1122.03,0.00
2024-12-10 17:35:52,59,1110,26,33,624.33,1122.61,0.00
2024-12-10 17:35:52,59,1111,26,33,631.67,1123.00,0.00
2024-12-10 17:35:52,60,1111,26,34,621.14,1123.02,0.00
2024-12-10 17:35:52,59,1111,25,34,622.16,1123.05,0.00
2024-12-10 17:35:52,59,1112,25,34,631.09,1124.00,0.00
2024-12-10 17:35:52,60,1112,26,34,620.57,1124.02,0.00
2024-12-10 17:35:52,59,1112,26,33,629.76,1124.03,0.00
2024-12-10 17:35:52,59,1113,26,33,630.89,1125.00,0.00
2024-12-10 17:35:52,60,1113,26,34,620.38,1125.02,0.00
2024-12-10 17:35:52,60,1114,26,34,617.74,1126.00,0.00
2024-12-10 17:35:52,61,1114,26,35,607.61,1126.02,0.00
2024-12-10 17:35:52,60,1114,26,34,616.24,1126.03,0.00
2024-12-10 17:35:52,59,1114,25,34,620.47,1126.59,0.00
2024-12-10 17:35:52,59,1115,25,34,627.65,1127.00,0.00
2024-12-10 17:35:52,60,1115,25,35,617.19,1127.02,0.00
2024-12-10 17:35:52,60,1116,25,35,614.86,1128.00,0.00
2024-12-10 17:35:52,61,1116,25,36,604.78,1128.02,0.00
2024-12-10 17:35:52,60,1116,25,35,612.80,1128.05,0.00
2024-12-10 17:35:52,59,1116,24,35,616.32,1128.10,0.00
2024-12-10 17:35:52,59,1117,24,35,625.83,1129.00,0.00
2024-12-10 17:35:52,60,1117,24,36,615.40,1129.02,0.00
2024-12-10 17:35:52,59,1117,23,36,615.70,1129.07,0.00
2024-12-10 17:35:52,59,1118,23,36,624.86,1130.00,0.00
2024-12-10 17:35:52,60,1118,23,37,614.44,1130.02,0.00
2024-12-10 17:35:52,59,1118,22,37,619.88,1130.03,0.00
2024-12-10 17:35:52,58,1118,22,36,629.01,1130.03,0.00
2024-12-10 17:35:52,58,1119,22,36,638.14,1131.00,0.00
2024-12-10 17:35:52,59,1119,22,37,627.33,1131.02,0.00
2024-12-10 17:35:52,59,1120,22,37,625.05,1132.00,0.00
2024-12-10 17:35:52,60,1120,23,37,614.64,1132.02,0.00
2024-12-10 17:35:52,59,1120,23,36,623.33,1132.03,0.00
2024-12-10 17:35:52,58,1120,22,36,632.93,1132.12,0.00
2024-12-10 17:35:52,57,1120,21,36,638.54,1132.63,0.00
2024-12-10 17:35:52,57,1121,21,36,646.56,1133.00,0.00
2024-12-10 17:35:52,58,1121,22,36,635.42,1133.02,0.00
2024-12-10 17:35:52,57,1121,21,36,641.75,1133.09,0.00
2024-12-10 17:35:52,57,1122,21,36,644.55,1134.00,0.00
2024-12-10 17:35:52,58,1122,21,37,633.44,1134.02,0.00
2024-12-10 17:35:52,57,1122,21,36,642.56,1134.04,0.00
2024-12-10 17:35:52,56,1122,20,36,653.45,1134.09,0.00
2024-12-10 17:35:52,56,1123,20,36,655.83,1135.00,0.00
2024-12-10 17:35:52,57,1123,21,36,644.32,1135.02,0.00
2024-12-10 17:35:52,56,1123,20,36,640.41,1135.48,0.00
2024-12-10 17:35:52,56,1124,20,36,655.19,1136.00,0.00
2024-12-10 17:35:52,57,1124,20,37,643.69,1136.02,0.00
2024-12-10 17:35:52,56,1124,20,36,652.55,1136.04,0.00
2024-12-10 17:35:52,55,1124,19,36,658.47,1136.58,0.00
2024-12-10 17:35:53,55,1125,19,36,666.44,1137.00,0.00
2024-12-10 17:35:53,56,1125,19,37,654.54,1137.02,0.00
2024-12-10 17:35:53,55,1125,18,37,654.19,1137.36,0.00
2024-12-10 17:35:53,55,1126,18,37,668.10,1138.00,0.00
2024-12-10 17:35:53,56,1126,18,38,656.16,1138.02,0.00
2024-12-10 17:35:53,55,1126,18,37,665.41,1138.04,0.00
2024-12-10 17:35:53,55,1127,18,37,667.44,1139.00,0.00
2024-12-10 17:35:53,56,1127,18,38,655.52,1139.02,0.00
2024-12-10 17:35:53,55,1127,17,38,664.95,1139.02,0.00
2024-12-10 17:35:53,54,1127,17,37,660.46,1139.20,0.00
2024-12-10 17:35:53,54,1128,17,37,673.01,1140.00,0.00
2024-12-10 17:35:53,55,1128,17,38,660.77,1140.02,0.00
2024-12-10 17:35:53,54,1128,17,37,670.47,1140.02,0.00
2024-12-10 17:35:53,53,1128,16,37,682.50,1140.08,0.00
2024-12-10 17:35:53,53,1129,16,37,694.06,1141.00,0.00
2024-12-10 17:35:53,54,1129,16,38,681.20,1141.02,0.00
2024-12-10 17:35:53,53,1129,15,38,685.23,1141.17,0.00
2024-12-10 17:35:53,52,1129,14,38,693.17,1141.64,0.00
2024-12-10 17:35:53,52,1130,14,38,711.25,1142.00,0.00
2024-12-10 17:35:53,53,1130,15,38,697.83,1142.02,0.00
2024-12-10 17:35:53,52,1130,15,37,707.96,1142.02,0.00
2024-12-10 17:35:53,51,1130,14,37,716.00,1142.55,0.00
2024-12-10 17:35:53,51,1131,14,37,724.65,1143.00,0.00
2024-12-10 17:35:53,52,1131,15,37,710.71,1143.02,0.00
2024-12-10 17:35:53,52,1132,15,37,708.99,1144.00,0.00
2024-12-10 17:35:53,53,1132,15,38,695.62,1144.02,0.00
2024-12-10 17:35:53,52,1132,15,37,705.91,1144.02,0.00
2024-12-10 17:35:53,52,1133,15,37,708.51,1145.00,0.00
2024-12-10 17:35:53,53,1133,16,37,695.14,1145.02,0.00
2024-12-10 17:35:53,53,1134,16,37,693.39,1146.00,0.00
2024-12-10 17:35:53,54,1134,17,37,680.55,1146.02,0.00
2024-12-10 17:35:53,53,1134,17,36,690.58,1146.02,0.00
2024-12-10 17:35:53,53,1135,17,36,692.91,1147.00,0.00
2024-12-10 17:35:53,54,1135,17,37,680.08,1147.02,0.00
2024-12-10 17:35:53,54,1136,17,37,679.00,1148.00,0.00
2024-12-10 17:35:53,55,1136,17,38,666.66,1148.02,0.00
2024-12-10 17:35:53,54,1136,17,37,675.18,1148.04,0.00
2024-12-10 17:35:53,53,1136,16,37,676.58,1148.42,0.00
2024-12-10 17:35:53,53,1137,16,37,691.96,1149.00,0.00
2024-12-10 17:35:53,54,1137,17,37,679.14,1149.02,0.00
2024-12-10 17:35:53,54,1138,17,37,678.01,1150.00,0.00
2024-12-10 17:35:53,55,1138,18,37,665.69,1150.02,0.00
2024-12-10 17:35:53,54,1138,18,36,674.40,1150.04,0.00
2024-12-10 17:35:53,54,1139,18,36,676.68,1151.00,0.00
2024-12-10 17:35:53,55,1139,19,36,664.38,1151.02,0.00
2024-12-10 17:35:53,54,1139,18,36,659.65,1151.52,0.00
2024-12-10 17:35:53,54,1140,18,36,675.78,1152.00,0.00
2024-12-10 17:35:53,55,1140,18,37,663.49,1152.02,0.00
2024-12-10 17:35:53,54,1140,18,36,672.37,1152.04,0.00
2024-12-10 17:35:53,53,1140,17,36,684.85,1152.06,0.00
2024-12-10 17:35:53,53,1141,17,36,687.60,1153.00,0.00
2024-12-10 17:35:53,54,1141,17,37,674.87,1153.02,0.00
2024-12-10 17:35:53,53,1141,16,37,682.83,1153.06,0.00
2024-12-10 17:35:53,53,1142,16,37,690.29,1154.00,0.00
2024-12-10 17:35:53,54,1142,16,38,677.50,1154.02,0.00
2024-12-10 17:35:53,53,1142,15,38,679.28,1154.62,0.00
2024-12-10 17:35:53,53,1143,15,38,689.17,1155.00,0.00
2024-12-10 17:35:53,54,1143,15,39,676.41,1155.02,0.00
2024-12-10 17:35:53,53,1143,15,38,684.82,1155.04,0.00
2024-12-10 17:35:53,52,1143,14,38,685.19,1155.94,0.00
2024-12-10 17:35:53,52,1144,14,38,706.79,1156.00,0.00
2024-12-10 17:35:53,53,1144,14,39,693.45,1156.02,0.00
2024-12-10 17:35:53,52,1144,13,39,701.23,1156.02,0.00
2024-12-10 17:35:53,51,1144,12,39,710.00,1156.06,0.00
2024-12-10 17:35:53,50,1144,11,39,717.97,1156.62,0.00
2024-12-10 17:35:53,50,1145,11,39,735.19,1157.00,0.00
2024-12-10 17:35:53,51,1145,12,39,720.78,1157.02,0.00
2024-12-10 17:35:53,50,1145,12,38,731.26,1157.02,0.00
2024-12-10 17:35:53,50,1146,12,38,734.44,1158.00,0.00
2024-12-10 17:35:53,51,1146,13,38,720.04,1158.02,0.00
2024-12-10 17:35:53,50,1146,12,38,717.80,1158.86,0.00
2024-12-10 17:35:53,51,1145,13,38,703.10,1158.94,0.00
2024-12-10 17:35:53,51,1146,13,38,725.89,1159.00,0.00
2024-12-10 17:35:53,52,1146,13,39,711.93,1159.02,0.00
2024-12-10 17:35:53,51,1146,13,38,722.25,1159.02,0.00
2024-12-10 17:35:53,51,1147,13,38,747.89,1160.00,0.00
2024-12-10 17:35:53,52,1147,13,39,733.51,1160.02,0.00
2024-12-10 17:35:53,52,1148,13,39,731.37,1161.00,0.00
2024-12-10 17:35:53,53,1148,13,40,717.57,1161.02,0.00
2024-12-10 17:35:53,52,1148,13,39,727.57,1161.02,0.00
2024-12-10 17:35:53,52,1149,13,39,730.21,1162.00,0.00
2024-12-10 17:35:53,53,1149,13,40,716.43,1162.02,0.00
2024-12-10 17:35:53,53,1150,13,40,715.33,1163.00,0.00
2024-12-10 17:35:53,54,1150,14,40,702.08,1163.02,0.00
2024-12-10 17:35:53,53,1150,14,39,710.94,1163.04,0.00
2024-12-10 17:35:53,52,1150,13,39,715.67,1163.69,0.00
2024-12-10 17:35:53,52,1151,13,39,734.72,1164.00,0.00
2024-12-10 17:35:53,53,1151,13,40,720.86,1164.02,0.00
2024-12-10 17:35:53,52,1151,12,40,734.56,1164.02,0.00
2024-12-10 17:35:53,52,1152,12,40,733.84,1165.00,0.00
2024-12-10 17:35:53,53,1152,12,41,720.00,1165.02,0.00
2024-12-10 17:35:53,52,1152,12,40,729.15,1165.04,0.00
2024-12-10 17:35:53,51,1152,11,40,736.91,1165.63,0.00
2024-12-10 17:35:53,51,1153,11,40,755.71,1166.00,0.00
2024-12-10 17:35:53,52,1153,12,40,741.18,1166.02,0.00
2024-12-10 17:35:53,51,1153,11,40,743.50,1166.65,0.00
2024-12-10 17:35:53,51,1154,11,40,762.55,1167.00,0.00
2024-12-10 17:35:53,52,1154,11,41,747.89,1167.02,0.00
2024-12-10 17:35:53,51,1154,11,40,757.76,1167.04,0.00
2024-12-10 17:35:53,51,1155,11,40,758.59,1168.00,0.00
2024-12-10 17:35:53,52,1155,12,40,744.00,1168.02,0.00
2024-12-10 17:35:53,52,1156,12,40,740.15,1169.00,0.00
2024-12-10 17:35:53,53,1156,12,41,726.19,1169.02,0.00
2024-12-10 17:35:54,52,1156,12,40,735.67,1169.04,0.00
2024-12-10 17:35:54,52,1157,12,40,737.04,1170.00,0.00
2024-12-10 17:35:54,53,1157,12,41,723.13,1170.02,0.00
2024-12-10 17:35:54,53,1158,12,41,721.32,1171.00,0.00
2024-12-10 17:35:54,54,1158,12,42,707.96,1171.02,0.00
2024-12-10 17:35:54,53,1158,12,41,716.69,1171.06,0.00
2024-12-10 17:35:54,52,1158,11,41,717.25,1171.54,0.00
2024-12-10 17:35:54,52,1159,11,41,734.74,1172.00,0.00
2024-12-10 17:35:54,53,1159,12,41,720.88,1172.02,0.00
2024-12-10 17:35:54,52,1159,11,41,729.20,1172.08,0.00
2024-12-10 17:35:54,52,1160,11,41,741.48,1173.00,0.00
2024-12-10 17:35:54,53,1160,12,41,727.49,1173.02,0.00
2024-12-10 17:35:54,52,1160,11,41,741.05,1173.04,0.00
2024-12-10 17:35:54,51,1160,11,40,751.44,1173.04,0.00
2024-12-10 17:35:54,51,1161,11,40,754.61,1174.00,0.00
2024-12-10 17:35:54,52,1161,11,41,740.09,1174.02,0.00
2024-12-10 17:35:54,52,1162,11,41,738.51,1175.00,0.00
2024-12-10 17:35:54,53,1162,11,42,724.58,1175.02,0.00
2024-12-10 17:35:54,52,1162,11,41,733.77,1175.04,0.00
2024-12-10 17:35:54,52,1163,11,41,736.65,1176.00,0.00
2024-12-10 17:35:54,53,1163,12,41,722.75,1176.02,0.00
2024-12-10 17:35:54,53,1164,12,41,721.47,1177.00,0.00
2024-12-10 17:35:54,54,1164,13,41,708.11,1177.02,0.00
2024-12-10 17:35:54,53,1164,13,40,716.82,1177.04,0.00
2024-12-10 17:35:54,53,1165,13,40,719.42,1178.00,0.00
2024-12-10 17:35:54,54,1165,13,41,706.10,1178.02,0.00
2024-12-10 17:35:54,54,1166,13,41,704.79,1179.00,0.00
2024-12-10 17:35:54,55,1166,13,42,691.97,1179.02,0.00
2024-12-10 17:35:54,54,1166,13,41,700.43,1179.04,0.00
2024-12-10 17:35:54,54,1167,13,41,702.76,1180.00,0.00
2024-12-10 17:35:54,55,1167,14,41,689.99,1180.02,0.00
2024-12-10 17:35:54,54,1167,13,41,697.46,1180.07,0.00
2024-12-10 17:35:54,54,1168,13,41,708.97,1181.00,0.00
2024-12-10 17:35:54,55,1168,13,42,696.08,1181.02,0.00
2024-12-10 17:35:54,55,1169,13,42,694.44,1182.00,0.00
2024-12-10 17:35:54,56,1169,14,42,682.04,1182.02,0.00
2024-12-10 17:35:54,55,1169,14,41,690.78,1182.02,0.00
2024-12-10 17:35:54,54,1169,13,41,693.94,1182.67,0.00
2024-12-10 17:35:54,54,1170,13,41,712.14,1183.00,0.00
2024-12-10 17:35:54,55,1170,14,41,699.19,1183.02,0.00
2024-12-10 17:35:54,55,1171,14,41,697.30,1184.00,0.00
2024-12-10 17:35:54,56,1171,14,42,684.85,1184.02,0.00
2024-12-10 17:35:54,55,1171,14,41,694.07,1184.02,0.00
2024-12-10 17:35:54,55,1172,14,41,695.95,1185.00,0.00
2024-12-10 17:35:54,56,1172,14,42,683.52,1185.02,0.00
2024-12-10 17:35:54,55,1172,14,41,692.72,1185.02,0.00
2024-12-10 17:35:54,55,1173,14,41,694.60,1186.00,0.00
2024-12-10 17:35:54,56,1173,15,41,682.19,1186.02,0.00
2024-12-10 17:35:54,56,1174,15,41,680.51,1187.00,0.00
2024-12-10 17:35:54,57,1174,15,42,668.57,1187.02,0.00
2024-12-10 17:35:54,56,1174,15,41,677.12,1187.02,0.00
2024-12-10 17:35:54,56,1175,15,41,678.75,1188.00,0.00
2024-12-10 17:35:54,57,1175,15,42,666.84,1188.02,0.00
2024-12-10 17:35:54,57,1176,15,42,665.01,1189.00,0.00
2024-12-10 17:35:54,58,1176,16,42,653.54,1189.02,0.00
2024-12-10 17:35:54,57,1176,16,41,661.88,1189.02,0.00
2024-12-10 17:35:54,56,1176,15,41,663.98,1189.71,0.00
2024-12-10 17:35:54,56,1177,15,41,682.02,1190.00,0.00
2024-12-10 17:35:54,57,1177,16,41,670.05,1190.02,0.00
2024-12-10 17:35:54,56,1177,16,40,675.29,1190.23,0.00
2024-12-10 17:35:54,55,1177,15,40,675.57,1190.64,0.00
2024-12-10 17:35:54,55,1178,15,40,693.15,1191.00,0.00
2024-12-10 17:35:54,56,1178,16,40,680.77,1191.02,0.00
2024-12-10 17:35:54,55,1178,16,39,689.47,1191.04,0.00
2024-12-10 17:35:54,55,1179,16,39,691.56,1192.00,0.00
2024-12-10 17:35:54,56,1179,17,39,679.21,1192.02,0.00
2024-12-10 17:35:54,55,1179,16,39,673.20,1192.58,0.00
2024-12-10 17:35:54,55,1180,16,39,690.19,1193.00,0.00
2024-12-10 17:35:54,56,1180,17,39,677.86,1193.02,0.00
2024-12-10 17:35:54,55,1180,17,38,686.72,1193.04,0.00
2024-12-10 17:35:54,55,1181,17,38,688.81,1194.00,0.00
2024-12-10 17:35:54,56,1181,18,38,676.51,1194.02,0.00
2024-12-10 17:35:54,56,1182,18,38,674.51,1195.00,0.00
2024-12-10 17:35:54,57,1182,19,38,662.68,1195.02,0.00
2024-12-10 17:35:54,56,1182,19,37,671.32,1195.04,0.00
2024-12-10 17:35:54,56,1183,19,37,673.16,1196.00,0.00
2024-12-10 17:35:54,57,1183,19,38,661.35,1196.02,0.00
2024-12-10 17:35:54,56,1183,18,38,667.95,1196.09,0.00
2024-12-10 17:35:54,56,1184,18,38,671.04,1197.00,0.00
2024-12-10 17:35:54,57,1184,19,38,659.26,1197.02,0.00
2024-12-10 17:35:54,56,1184,19,37,668.05,1197.04,0.00
2024-12-10 17:35:54,56,1185,19,37,669.88,1198.00,0.00
2024-12-10 17:35:54,57,1185,20,37,658.13,1198.02,0.00
2024-12-10 17:35:54,57,1186,20,37,655.32,1199.00,0.00
2024-12-10 17:35:54,58,1186,21,37,644.02,1199.02,0.00
2024-12-10 17:35:54,57,1186,21,36,653.84,1199.02,0.00
2024-12-10 17:35:54,57,1187,21,36,655.23,1200.00,0.00
2024-12-10 17:35:54,58,1187,22,36,643.93,1200.02,0.00
2024-12-10 17:35:54,58,1188,22,36,641.40,1201.00,0.00
2024-12-10 17:35:54,59,1188,23,36,630.53,1201.02,0.00
2024-12-10 17:35:54,58,1188,23,35,639.33,1201.02,0.00
2024-12-10 17:35:54,58,1189,23,35,640.48,1202.00,0.00
2024-12-10 17:35:54,59,1189,24,35,629.63,1202.02,0.00
2024-12-10 17:35:54,58,1189,23,35,629.71,1202.59,0.00
2024-12-10 17:35:55,58,1190,23,35,637.86,1203.00,0.00
2024-12-10 17:35:55,59,1190,23,36,627.05,1203.02,0.00
2024-12-10 17:35:55,58,1190,23,35,635.99,1203.02,0.00
2024-12-10 17:35:55,57,1190,22,35,635.32,1203.83,0.00
2024-12-10 17:35:55,57,1191,22,35,654.44,1204.00,0.00
2024-12-10 17:35:55,58,1191,22,36,643.15,1204.02,0.00
2024-12-10 17:35:55,57,1191,21,36,635.50,1204.61,0.00
2024-12-10 17:35:55,57,1192,21,36,652.23,1205.00,0.00
2024-12-10 17:35:55,58,1192,22,36,640.99,1205.02,0.00
2024-12-10 17:35:55,57,1192,22,35,650.12,1205.02,0.00
2024-12-10 17:35:55,56,1192,21,35,648.63,1205.55,0.00
2024-12-10 17:35:55,55,1192,20,35,659.71,1205.62,0.00
2024-12-10 17:35:55,55,1193,20,35,677.28,1206.00,0.00
2024-12-10 17:35:55,56,1193,21,35,665.19,1206.02,0.00
2024-12-10 17:35:55,56,1194,21,35,662.74,1207.00,0.00
2024-12-10 17:35:55,57,1194,21,36,651.12,1207.02,0.00
2024-12-10 17:35:55,56,1194,21,35,660.59,1207.02,0.00
2024-12-10 17:35:55,55,1194,20,35,665.24,1207.66,0.00
2024-12-10 17:35:55,55,1195,20,35,674.47,1208.00,0.00
2024-12-10 17:35:55,56,1195,21,35,662.43,1208.02,0.00
2024-12-10 17:35:55,56,1196,21,35,659.84,1209.00,0.00
2024-12-10 17:35:55,57,1196,22,35,648.26,1209.02,0.00
2024-12-10 17:35:55,56,1196,22,34,657.90,1209.02,0.00
2024-12-10 17:35:55,55,1196,21,34,654.89,1209.96,0.00
2024-12-10 17:35:55,55,1197,21,34,676.47,1210.00,0.00
2024-12-10 17:35:55,56,1197,21,35,664.39,1210.02,0.00
2024-12-10 17:35:55,56,1198,21,35,661.78,1211.00,0.00
2024-12-10 17:35:55,57,1198,21,36,650.17,1211.02,0.00
2024-12-10 17:35:55,56,1198,21,35,660.05,1211.02,0.00
2024-12-10 17:35:55,56,1199,21,35,661.67,1212.00,0.00
2024-12-10 17:35:55,57,1199,21,36,650.07,1212.02,0.00
2024-12-10 17:35:55,56,1199,20,36,653.30,1212.23,0.00
2024-12-10 17:35:55,56,1200,20,36,666.12,1213.00,0.00
2024-12-10 17:35:55,57,1200,21,36,654.43,1213.02,0.00
2024-12-10 17:35:55,56,1200,21,35,664.39,1213.02,0.00
2024-12-10 17:35:55,55,1200,20,35,673.23,1213.20,0.00
2024-12-10 17:35:55,55,1201,20,35,686.07,1214.00,0.00
2024-12-10 17:35:55,56,1201,21,35,673.82,1214.02,0.00
2024-12-10 17:35:55,56,1202,21,35,671.12,1215.00,0.00
2024-12-10 17:35:55,57,1202,21,36,659.35,1215.02,0.00
2024-12-10 17:35:55,56,1202,21,35,669.60,1215.02,0.00
2024-12-10 17:35:55,55,1202,20,35,667.48,1215.58,0.00
2024-12-10 17:35:55,55,1203,20,35,684.77,1216.00,0.00
2024-12-10 17:35:55,56,1203,21,35,672.54,1216.02,0.00
2024-12-10 17:35:55,55,1203,20,35,672.27,1216.66,0.00
2024-12-10 17:35:55,55,1204,20,35,690.45,1217.00,0.00
2024-12-10 17:35:55,56,1204,21,35,678.12,1217.02,0.00
2024-12-10 17:35:55,55,1204,21,34,688.68,1217.02,0.00
2024-12-10 17:35:55,55,1205,21,34,690.57,1218.00,0.00
2024-12-10 17:35:55,56,1205,21,35,678.24,1218.02,0.00
2024-12-10 17:35:55,56,1206,21,35,675.67,1219.00,0.00
2024-12-10 17:35:55,57,1206,21,36,663.81,1219.02,0.00
2024-12-10 17:35:55,56,1206,21,35,673.71,1219.02,0.00
2024-12-10 17:35:55,56,1207,21,35,675.35,1220.00,0.00
2024-12-10 17:35:55,57,1207,21,36,663.50,1220.02,0.00
2024-12-10 17:35:55,56,1207,20,36,663.63,1220.64,0.00
2024-12-10 17:35:55,55,1207,19,36,669.75,1220.89,0.00
2024-12-10 17:35:55,55,1208,19,36,690.70,1221.00,0.00
2024-12-10 17:35:55,56,1208,19,37,678.36,1221.02,0.00
2024-12-10 17:35:55,55,1208,19,36,688.92,1221.02,0.00
2024-12-10 17:35:55,55,1209,19,36,690.82,1222.00,0.00
2024-12-10 17:35:55,56,1209,19,37,678.48,1222.02,0.00
2024-12-10 17:35:55,55,1209,18,37,673.93,1222.53,0.00
2024-12-10 17:35:55,55,1210,18,37,690.72,1223.00,0.00
2024-12-10 17:35:55,56,1210,18,38,678.38,1223.02,0.00
2024-12-10 17:35:55,55,1210,18,37,688.33,1223.04,0.00
2024-12-10 17:35:55,55,1211,18,37,690.45,1224.00,0.00
2024-12-10 17:35:55,56,1211,18,38,678.12,1224.02,0.00
2024-12-10 17:35:55,55,1211,17,38,684.77,1224.11,0.00
2024-12-10 17:35:55,56,1210,17,39,671.69,1224.21,0.00
2024-12-10 17:35:55,56,1211,17,39,697.35,1225.00,0.00
2024-12-10 17:35:55,57,1211,17,40,685.11,1225.02,0.00
2024-12-10 17:35:55,56,1211,17,39,695.16,1225.04,0.00
2024-12-10 17:35:55,56,1212,17,39,718.93,1226.00,0.00
2024-12-10 17:35:55,57,1212,18,39,706.32,1226.02,0.00
2024-12-10 17:35:55,56,1212,17,39,703.59,1226.46,0.00
2024-12-10 17:35:55,56,1213,17,39,719.30,1227.00,0.00
2024-12-10 17:35:55,57,1213,17,40,706.68,1227.02,0.00
2024-12-10 17:35:55,56,1213,17,39,716.45,1227.04,0.00
2024-12-10 17:35:55,56,1214,17,39,718.35,1228.00,0.00
2024-12-10 17:35:55,57,1214,17,40,705.75,1228.02,0.00
2024-12-10 17:35:55,57,1215,17,40,702.87,1229.00,0.00
2024-12-10 17:35:55,58,1215,18,40,690.75,1229.02,0.00
2024-12-10 17:35:55,57,1215,18,39,701.15,1229.04,0.00
2024-12-10 17:35:55,56,1215,17,39,704.07,1229.73,0.00
2024-12-10 17:35:55,56,1216,17,39,722.96,1230.00,0.00
2024-12-10 17:35:55,57,1216,17,40,710.28,1230.02,0.00
2024-12-10 17:35:55,56,1216,16,40,718.35,1230.02,0.00
2024-12-10 17:35:55,55,1216,15,40,719.05,1230.66,0.00
2024-12-10 17:35:55,55,1217,15,40,737.46,1231.00,0.00
2024-12-10 17:35:55,56,1217,15,41,724.29,1231.02,0.00
2024-12-10 17:35:55,55,1217,15,40,736.12,1231.02,0.00
2024-12-10 17:35:55,54,1217,14,40,734.57,1231.59,0.00
2024-12-10 17:35:55,54,1218,14,40,752.69,1232.00,0.00
2024-12-10 17:35:55,55,1218,15,40,739.01,1232.02,0.00
2024-12-10 17:35:55,54,1218,14,40,745.23,1232.20,0.00
2024-12-10 17:35:55,54,1219,14,40,749.65,1233.00,0.00
2024-12-10 17:35:55,55,1219,14,41,736.02,1233.02,0.00
2024-12-10 17:35:55,54,1219,14,40,747.60,1233.04,0.00
2024-12-10 17:35:55,53,1219,13,40,749.12,1233.51,0.00
2024-12-10 17:35:55,53,1220,13,40,766.74,1234.00,0.00
2024-12-10 17:35:55,54,1220,13,41,752.54,1234.02,0.00
2024-12-10 17:35:55,54,1221,13,41,750.18,1235.00,0.00
2024-12-10 17:35:55,55,1221,14,41,736.54,1235.02,0.00
2024-12-10 17:35:55,54,1221,14,40,748.35,1235.04,0.00
2024-12-10 17:35:55,54,1222,14,40,750.79,1236.00,0.00
2024-12-10 17:35:55,55,1222,14,41,737.14,1236.02,0.00
2024-12-10 17:35:56,55,1223,14,41,734.58,1237.00,0.00
2024-12-10 17:35:56,56,1223,14,42,721.47,1237.02,0.00
2024-12-10 17:35:56,55,1223,14,41,733.01,1237.04,0.00
2024-12-10 17:35:56,54,1223,13,41,739.77,1237.61,0.00
2024-12-10 17:35:56,54,1224,13,41,758.19,1238.00,0.00
2024-12-10 17:35:56,55,1224,13,42,744.41,1238.02,0.00
2024-12-10 17:35:56,55,1225,13,42,748.57,1239.00,0.00
2024-12-10 17:35:56,56,1225,14,42,735.21,1239.02,0.00
2024-12-10 17:35:56,56,1226,14,42,737.77,1240.00,0.00
2024-12-10 17:35:56,57,1226,14,43,724.82,1240.02,0.00
2024-12-10 17:35:56,57,1227,14,43,724.16,1241.00,0.00
2024-12-10 17:35:56,58,1227,14,44,711.67,1241.02,0.00
2024-12-10 17:35:56,58,1228,14,44,708.61,1242.00,0.00
2024-12-10 17:35:56,59,1228,14,45,696.60,1242.02,0.00
2024-12-10 17:35:56,58,1228,14,44,707.75,1242.03,0.00
2024-12-10 17:35:56,57,1228,13,44,703.01,1242.97,0.00
2024-12-10 17:35:56,57,1229,13,44,724.40,1243.00,0.00
2024-12-10 17:35:56,58,1229,13,45,711.91,1243.02,0.00
2024-12-10 17:35:56,58,1230,13,45,708.83,1244.00,0.00
2024-12-10 17:35:56,59,1230,13,46,696.82,1244.02,0.00
2024-12-10 17:35:56,58,1230,13,45,708.19,1244.03,0.00
2024-12-10 17:35:56,57,1230,12,45,707.08,1244.54,0.00
2024-12-10 17:35:56,57,1231,12,45,723.60,1245.00,0.00
2024-12-10 17:35:56,58,1231,13,45,711.12,1245.02,0.00
2024-12-10 17:35:56,57,1231,12,45,713.63,1245.30,0.00
2024-12-10 17:35:56,57,1232,12,45,727.24,1246.00,0.00
2024-12-10 17:35:56,58,1232,12,46,714.70,1246.02,0.00
2024-12-10 17:35:56,57,1232,12,45,726.59,1246.04,0.00
2024-12-10 17:35:56,57,1233,12,45,728.26,1247.00,0.00
2024-12-10 17:35:56,58,1233,12,46,715.70,1247.02,0.00
2024-12-10 17:35:56,58,1234,12,46,712.62,1248.00,0.00
2024-12-10 17:35:56,59,1234,13,46,700.54,1248.02,0.00
2024-12-10 17:35:56,58,1234,13,45,711.98,1248.03,0.00
2024-12-10 17:35:56,57,1234,12,45,710.49,1248.81,0.00
2024-12-10 17:35:56,57,1235,12,45,730.15,1249.00,0.00
2024-12-10 17:35:56,58,1235,13,45,717.56,1249.02,0.00
2024-12-10 17:35:56,59,1234,14,45,693.62,1249.68,0.00
2024-12-10 17:35:56,59,1235,14,45,707.02,1250.00,0.00
2024-12-10 17:35:56,60,1235,15,45,695.24,1250.02,0.00
2024-12-10 17:35:56,59,1235,15,44,706.60,1250.03,0.00
2024-12-10 17:35:56,59,1236,15,44,729.00,1251.00,0.00
2024-12-10 17:35:56,60,1236,16,44,716.85,1251.02,0.00
2024-12-10 17:35:56,59,1236,16,43,724.34,1251.03,0.00
2024-12-10 17:35:56,59,1237,16,43,725.55,1252.00,0.00
2024-12-10 17:35:56,60,1237,16,44,713.46,1252.02,0.00
2024-12-10 17:35:56,59,1237,15,44,712.93,1252.70,0.00
2024-12-10 17:35:56,59,1238,15,44,722.10,1253.00,0.00
2024-12-10 17:35:56,60,1238,16,44,710.06,1253.02,0.00
2024-12-10 17:35:56,59,1238,16,43,721.46,1253.03,0.00
2024-12-10 17:35:56,59,1239,16,43,722.67,1254.00,0.00
2024-12-10 17:35:56,60,1239,17,43,710.63,1254.02,0.00
2024-12-10 17:35:56,60,1240,17,43,707.22,1255.00,0.00
2024-12-10 17:35:56,61,1240,18,43,695.63,1255.02,0.00
2024-12-10 17:35:56,60,1240,18,42,706.80,1255.03,0.00
2024-12-10 17:35:56,60,1241,18,42,707.78,1256.00,0.00
2024-12-10 17:35:56,61,1241,19,42,696.18,1256.02,0.00
2024-12-10 17:35:56,60,1241,18,42,701.54,1256.17,0.00
2024-12-10 17:35:56,60,1242,18,42,704.16,1257.00,0.00
2024-12-10 17:35:56,61,1242,19,42,692.62,1257.02,0.00
2024-12-10 17:35:56,60,1242,19,41,703.53,1257.03,0.00
2024-12-10 17:35:56,59,1242,18,41,700.45,1257.97,0.00
2024-12-10 17:35:56,59,1243,18,41,721.36,1258.00,0.00
2024-12-10 17:35:56,60,1243,18,42,709.34,1258.02,0.00
2024-12-10 17:35:56,60,1244,18,42,705.91,1259.00,0.00
2024-12-10 17:35:56,61,1244,18,43,694.34,1259.02,0.00
2024-12-10 17:35:56,60,1244,18,42,705.70,1259.02,0.00
2024-12-10 17:35:56,59,1244,18,41,717.45,1259.02,0.00
2024-12-10 17:35:56,59,1245,18,41,718.45,1260.00,0.00
2024-12-10 17:35:56,60,1245,18,42,706.47,1260.02,0.00
2024-12-10 17:35:56,59,1245,17,42,712.67,1260.14,0.00
2024-12-10 17:35:56,59,1246,17,42,715.14,1261.00,0.00
2024-12-10 17:35:56,60,1246,17,43,703.22,1261.02,0.00
2024-12-10 17:35:56,59,1246,17,42,714.92,1261.02,0.00
2024-12-10 17:35:56,58,1246,16,42,725.76,1261.14,0.00
2024-12-10 17:35:56,57,1246,15,42,735.87,1261.21,0.00
2024-12-10 17:35:56,57,1247,15,42,748.56,1262.00,0.00
2024-12-10 17:35:56,58,1247,15,43,735.66,1262.02,0.00
2024-12-10 17:35:56,57,1247,14,43,743.69,1262.02,0.00
2024-12-10 17:35:56,57,1248,14,43,749.60,1263.00,0.00
2024-12-10 17:35:56,58,1248,15,43,736.68,1263.02,0.00
2024-12-10 17:35:56,57,1248,14,43,733.43,1263.83,0.00
2024-12-10 17:35:56,57,1249,14,43,753.52,1264.00,0.00
2024-12-10 17:35:56,58,1249,15,43,740.53,1264.02,0.00
2024-12-10 17:35:56,57,1249,15,42,753.30,1264.02,0.00
2024-12-10 17:35:56,56,1249,15,41,766.30,1264.02,0.00
2024-12-10 17:35:56,56,1250,15,41,768.04,1265.00,0.00
2024-12-10 17:35:56,57,1250,15,42,754.56,1265.02,0.00
2024-12-10 17:35:56,56,1250,14,42,754.27,1265.09,0.00
2024-12-10 17:35:56,56,1251,14,42,765.93,1266.00,0.00
2024-12-10 17:35:56,57,1251,15,42,752.49,1266.02,0.00
2024-12-10 17:35:56,56,1251,15,41,765.48,1266.02,0.00
2024-12-10 17:35:56,55,1251,14,41,762.48,1266.66,0.00
2024-12-10 17:35:56,55,1252,14,41,781.39,1267.00,0.00
2024-12-10 17:35:56,56,1252,15,41,767.44,1267.02,0.00
2024-12-10 17:35:56,55,1252,14,41,766.60,1267.42,0.00
2024-12-10 17:35:56,55,1253,14,41,782.70,1268.00,0.00
2024-12-10 17:35:56,56,1253,15,41,768.72,1268.02,0.00
2024-12-10 17:35:56,55,1253,15,40,782.47,1268.02,0.00
2024-12-10 17:35:56,54,1253,14,40,788.87,1268.67,0.00
2024-12-10 17:35:56,54,1254,14,40,799.00,1269.00,0.00
2024-12-10 17:35:56,55,1254,14,41,784.47,1269.02,0.00
2024-12-10 17:35:56,54,1254,13,41,783.67,1269.76,0.00
2024-12-10 17:35:56,54,1255,13,41,804.33,1270.00,0.00
2024-12-10 17:35:56,55,1255,13,42,789.71,1270.02,0.00
2024-12-10 17:35:56,54,1255,13,41,802.69,1270.02,0.00
2024-12-10 17:35:57,54,1256,13,41,804.97,1271.00,0.00
2024-12-10 17:35:57,55,1256,14,41,790.33,1271.02,0.00
2024-12-10 17:35:57,55,1257,14,41,787.71,1272.00,0.00
2024-12-10 17:35:57,56,1257,15,41,773.65,1272.02,0.00
2024-12-10 17:35:57,55,1257,15,40,784.71,1272.04,0.00
2024-12-10 17:35:57,55,1258,15,40,786.94,1273.00,0.00
2024-12-10 17:35:57,56,1258,16,40,772.89,1273.02,0.00
2024-12-10 17:35:57,56,1259,16,40,770.09,1274.00,0.00
2024-12-10 17:35:57,57,1259,17,40,756.58,1274.02,0.00
2024-12-10 17:35:57,56,1259,17,39,767.36,1274.04,0.00
2024-12-10 17:35:57,56,1260,17,39,769.33,1275.00,0.00
2024-12-10 17:35:57,57,1260,17,40,755.83,1275.02,0.00
2024-12-10 17:35:57,56,1260,16,40,763.63,1275.02,0.00
2024-12-10 17:35:57,56,1261,16,40,769.93,1276.00,0.00
2024-12-10 17:35:57,57,1261,16,41,756.42,1276.02,0.00
2024-12-10 17:35:57,56,1261,16,40,767.19,1276.02,0.00
2024-12-10 17:35:57,56,1262,16,40,755.61,1277.00,0.00
2024-12-10 17:35:57,57,1262,16,41,742.36,1277.02,0.00
2024-12-10 17:35:57,56,1262,15,41,745.90,1277.25,0.00
2024-12-10 17:35:57,55,1262,14,41,752.32,1277.56,0.00
2024-12-10 17:35:57,55,1263,14,41,770.29,1278.00,0.00
2024-12-10 17:35:57,56,1263,15,41,756.53,1278.02,0.00
2024-12-10 17:35:57,55,1263,15,40,767.26,1278.02,0.00
2024-12-10 17:35:57,55,1264,15,40,769.26,1279.00,0.00
2024-12-10 17:35:57,56,1264,15,41,755.52,1279.02,0.00
2024-12-10 17:35:57,55,1264,14,41,752.50,1279.82,0.00
2024-12-10 17:35:57,55,1265,14,41,773.59,1280.00,0.00
2024-12-10 17:35:57,56,1265,14,42,759.77,1280.02,0.00
2024-12-10 17:35:57,55,1265,14,41,770.79,1280.02,0.00
2024-12-10 17:35:57,55,1266,14,41,772.79,1281.00,0.00
2024-12-10 17:35:57,56,1266,14,42,758.99,1281.02,0.00
2024-12-10 17:35:57,56,1267,14,42,756.15,1282.00,0.00
2024-12-10 17:35:57,57,1267,14,43,742.88,1282.02,0.00
2024-12-10 17:35:57,56,1267,14,42,753.63,1282.02,0.00
2024-12-10 17:35:57,55,1267,13,42,757.25,1282.75,0.00
2024-12-10 17:35:57,55,1268,13,42,777.50,1283.00,0.00
2024-12-10 17:35:57,56,1268,14,42,763.61,1283.02,0.00
2024-12-10 17:35:57,56,1269,14,42,760.77,1284.00,0.00
2024-12-10 17:35:57,57,1269,14,43,747.42,1284.02,0.00
2024-12-10 17:35:57,56,1269,14,42,758.02,1284.02,0.00
2024-12-10 17:35:57,56,1270,14,42,759.76,1285.00,0.00
2024-12-10 17:35:57,57,1270,14,43,746.43,1285.02,0.00
2024-12-10 17:35:57,57,1271,14,43,743.45,1286.00,0.00
2024-12-10 17:35:57,58,1271,15,43,730.63,1286.02,0.00
2024-12-10 17:35:57,57,1271,15,42,740.07,1286.04,0.00
2024-12-10 17:35:57,57,1272,15,42,741.77,1287.00,0.00
2024-12-10 17:35:57,58,1272,16,42,728.98,1287.02,0.00
2024-12-10 17:35:57,57,1272,15,42,724.38,1287.51,0.00
2024-12-10 17:35:57,57,1273,15,42,740.99,1288.00,0.00
2024-12-10 17:35:57,58,1273,15,43,728.21,1288.02,0.00
2024-12-10 17:35:57,57,1273,15,42,737.83,1288.04,0.00
2024-12-10 17:35:57,57,1274,15,42,739.53,1289.00,0.00
2024-12-10 17:35:57,58,1274,15,43,726.78,1289.02,0.00
2024-12-10 17:35:57,58,1275,15,43,723.80,1290.00,0.00
2024-12-10 17:35:57,59,1275,16,43,711.53,1290.02,0.00
2024-12-10 17:35:57,58,1275,16,42,720.91,1290.03,0.00
2024-12-10 17:35:57,58,1276,16,42,722.35,1291.00,0.00
2024-12-10 17:35:57,59,1276,17,42,710.11,1291.02,0.00
2024-12-10 17:35:57,58,1276,16,42,702.16,1291.62,0.00
2024-12-10 17:35:57,58,1277,16,42,719.79,1292.00,0.00
2024-12-10 17:35:57,59,1277,17,42,707.59,1292.02,0.00
2024-12-10 17:35:57,58,1277,17,41,716.68,1292.05,0.00
2024-12-10 17:35:57,58,1278,17,41,718.34,1293.00,0.00
2024-12-10 17:35:57,59,1278,18,41,706.17,1293.02,0.00
2024-12-10 17:35:57,58,1278,17,41,705.89,1293.66,0.00
2024-12-10 17:35:57,58,1279,17,41,715.57,1294.00,0.00
2024-12-10 17:35:57,59,1279,18,41,703.44,1294.02,0.00
2024-12-10 17:35:57,58,1279,18,40,712.68,1294.05,0.00
2024-12-10 17:35:57,58,1280,18,40,714.34,1295.00,0.00
2024-12-10 17:35:57,59,1280,18,41,702.23,1295.02,0.00
2024-12-10 17:35:57,59,1281,18,41,698.82,1296.00,0.00
2024-12-10 17:35:57,60,1281,19,41,687.17,1296.02,0.00
2024-12-10 17:35:57,59,1281,19,40,696.41,1296.05,0.00
2024-12-10 17:35:57,58,1281,18,40,696.33,1296.52,0.00
2024-12-10 17:35:57,58,1282,18,40,712.76,1297.00,0.00
2024-12-10 17:35:57,59,1282,19,40,700.68,1297.02,0.00
2024-12-10 17:35:57,59,1283,19,40,697.29,1298.00,0.00
2024-12-10 17:35:57,60,1283,19,41,685.66,1298.02,0.00
2024-12-10 17:35:57,59,1283,19,40,695.09,1298.05,0.00
2024-12-10 17:35:57,59,1284,19,40,696.50,1299.00,0.00
2024-12-10 17:35:57,60,1284,19,41,684.89,1299.02,0.00
2024-12-10 17:35:57,60,1285,19,41,685.35,1300.00,0.00
2024-12-10 17:35:57,61,1285,19,42,674.12,1300.02,0.00
2024-12-10 17:35:57,60,1285,18,42,662.89,1300.90,0.00
2024-12-10 17:35:57,60,1286,18,42,683.35,1301.00,0.00
2024-12-10 17:35:57,61,1286,19,42,672.14,1301.02,0.00
2024-12-10 17:35:57,60,1286,19,41,680.97,1301.05,0.00
2024-12-10 17:35:57,60,1287,19,41,682.14,1302.00,0.00
2024-12-10 17:35:57,61,1287,19,42,670.95,1302.02,0.00
2024-12-10 17:35:57,60,1287,18,42,668.54,1302.72,0.00
2024-12-10 17:35:57,60,1288,18,42,686.76,1303.00,0.00
2024-12-10 17:35:57,61,1288,19,42,675.50,1303.02,0.00
2024-12-10 17:35:57,60,1288,19,41,685.02,1303.05,0.00
2024-12-10 17:35:57,59,1288,18,41,686.63,1303.46,0.00
2024-12-10 17:35:57,59,1289,18,41,702.03,1304.00,0.00
2024-12-10 17:35:57,60,1289,19,41,690.33,1304.02,0.00
2024-12-10 17:35:58,60,1290,19,41,686.94,1305.00,0.00
2024-12-10 17:35:58,61,1290,20,41,675.68,1305.02,0.00
2024-12-10 17:35:58,60,1290,20,40,685.21,1305.05,0.00
2024-12-10 17:35:58,60,1291,20,40,686.38,1306.00,0.00
2024-12-10 17:35:58,61,1291,20,41,675.13,1306.02,0.00
2024-12-10 17:35:58,61,1292,20,41,671.71,1307.00,0.00
2024-12-10 17:35:58,62,1292,20,42,660.88,1307.02,0.00
2024-12-10 17:35:58,61,1292,20,41,670.22,1307.05,0.00
2024-12-10 17:35:58,61,1293,20,41,671.15,1308.00,0.00
2024-12-10 17:35:58,62,1293,21,41,660.33,1308.02,0.00
2024-12-10 17:35:58,61,1293,20,41,660.93,1308.31,0.00
2024-12-10 17:35:58,60,1293,19,41,667.57,1308.67,0.00
2024-12-10 17:35:58,60,1294,19,41,685.25,1309.00,0.00
2024-12-10 17:35:58,61,1294,20,41,674.02,1309.02,0.00
2024-12-10 17:35:58,60,1294,20,40,683.73,1309.05,0.00
2024-12-10 17:35:58,60,1295,20,40,684.90,1310.00,0.00
2024-12-10 17:35:58,61,1295,21,40,673.67,1310.02,0.00
2024-12-10 17:35:58,60,1295,20,40,677.75,1310.23,0.00
2024-12-10 17:35:58,60,1296,20,40,681.47,1311.00,0.00
2024-12-10 17:35:58,61,1296,20,41,670.30,1311.02,0.00
2024-12-10 17:35:58,60,1296,20,40,680.16,1311.05,0.00
2024-12-10 17:35:58,59,1296,19,40,689.52,1311.22,0.00
2024-12-10 17:35:58,59,1297,19,40,693.11,1312.00,0.00
2024-12-10 17:35:58,60,1297,20,40,681.55,1312.02,0.00
2024-12-10 17:35:58,60,1298,20,40,677.92,1313.00,0.00
2024-12-10 17:35:58,61,1298,20,41,666.80,1313.02,0.00
2024-12-10 17:35:58,60,1298,20,40,676.61,1313.05,0.00
2024-12-10 17:35:58,60,1299,20,40,677.78,1314.00,0.00
2024-12-10 17:35:58,61,1299,20,41,666.66,1314.02,0.00
2024-12-10 17:35:58,61,1300,20,41,663.00,1315.00,0.00
2024-12-10 17:35:58,62,1300,21,41,652.31,1315.02,0.00
2024-12-10 17:35:58,61,1300,21,40,661.92,1315.05,0.00
2024-12-10 17:35:58,60,1300,20,40,671.02,1315.20,0.00
2024-12-10 17:35:58,60,1301,20,40,674.12,1316.00,0.00
2024-12-10 17:35:58,61,1301,20,41,663.07,1316.02,0.00
2024-12-10 17:35:58,60,1301,19,41,661.02,1316.68,0.00
2024-12-10 17:35:58,60,1302,19,41,670.27,1317.00,0.00
2024-12-10 17:35:58,61,1302,20,41,659.29,1317.02,0.00
2024-12-10 17:35:58,60,1302,20,40,669.40,1317.05,0.00
2024-12-10 17:35:58,60,1303,20,40,670.56,1318.00,0.00
2024-12-10 17:35:58,61,1303,20,41,659.57,1318.02,0.00
2024-12-10 17:35:58,60,1303,20,40,670.34,1318.02,0.00
2024-12-10 17:35:58,60,1304,20,40,666.75,1319.00,0.00
2024-12-10 17:35:58,61,1304,21,40,655.82,1319.02,0.00
2024-12-10 17:35:58,60,1304,21,39,666.09,1319.03,0.00
2024-12-10 17:35:58,60,1305,21,39,667.04,1320.00,0.00
2024-12-10 17:35:58,61,1305,22,39,656.10,1320.02,0.00
2024-12-10 17:35:58,60,1305,22,38,666.38,1320.02,0.00
2024-12-10 17:35:58,59,1305,21,38,662.47,1320.59,0.00
2024-12-10 17:35:58,59,1306,21,38,679.75,1321.00,0.00
2024-12-10 17:35:58,60,1306,21,39,668.42,1321.02,0.00
2024-12-10 17:35:58,59,1306,21,38,675.05,1321.02,0.00
2024-12-10 17:35:58,59,1307,21,38,676.01,1322.00,0.00
2024-12-10 17:35:58,60,1307,22,38,664.74,1322.02,0.00
2024-12-10 17:35:58,59,1307,22,37,671.30,1322.02,0.00
2024-12-10 17:35:58,59,1308,22,37,672.26,1323.00,0.00
2024-12-10 17:35:58,60,1308,22,38,661.05,1323.02,0.00
2024-12-10 17:35:58,59,1308,21,38,653.81,1323.88,0.00
2024-12-10 17:35:58,59,1309,21,38,674.75,1324.00,0.00
2024-12-10 17:35:58,60,1309,22,38,663.51,1324.02,0.00
2024-12-10 17:35:58,59,1309,22,37,674.31,1324.03,0.00
2024-12-10 17:35:58,59,1310,22,37,675.49,1325.00,0.00
2024-12-10 17:35:58,60,1310,22,38,664.23,1325.02,0.00
2024-12-10 17:35:58,59,1310,21,38,658.86,1325.81,0.00
2024-12-10 17:35:58,59,1311,21,38,679.00,1326.00,0.00
2024-12-10 17:35:58,60,1311,22,38,667.68,1326.02,0.00
2024-12-10 17:35:58,59,1311,22,37,678.55,1326.03,0.00
2024-12-10 17:35:58,59,1312,22,37,679.74,1327.00,0.00
2024-12-10 17:35:58,60,1312,23,37,668.41,1327.02,0.00
2024-12-10 17:35:58,59,1312,23,36,674.79,1327.03,0.00
2024-12-10 17:35:58,58,1312,22,36,668.68,1327.67,0.00
2024-12-10 17:35:58,58,1313,22,36,687.46,1328.00,0.00
2024-12-10 17:35:58,59,1313,22,37,675.81,1328.02,0.00
2024-12-10 17:35:58,58,1313,21,37,668.95,1328.53,0.00
2024-12-10 17:35:58,58,1314,21,37,685.99,1329.00,0.00
2024-12-10 17:35:58,59,1314,22,37,674.37,1329.02,0.00
2024-12-10 17:35:58,58,1314,22,36,684.85,1329.03,0.00
2024-12-10 17:35:58,57,1314,21,36,693.18,1329.21,0.00
2024-12-10 17:35:58,56,1314,20,36,699.45,1329.68,0.00
2024-12-10 17:35:58,56,1315,20,36,719.17,1330.00,0.00
2024-12-10 17:35:58,57,1315,21,36,706.55,1330.02,0.00
2024-12-10 17:35:58,58,1314,22,36,671.62,1330.81,0.00
2024-12-10 17:35:58,58,1315,22,36,694.74,1331.00,0.00
2024-12-10 17:35:58,59,1315,22,37,682.96,1331.02,0.00
2024-12-10 17:35:58,58,1315,22,36,692.67,1331.03,0.00
2024-12-10 17:35:58,57,1315,21,36,696.15,1331.65,0.00
2024-12-10 17:35:58,57,1316,21,36,738.47,1332.00,0.00
2024-12-10 17:35:58,58,1316,22,36,725.74,1332.02,0.00
2024-12-10 17:35:58,57,1316,21,36,731.97,1332.16,0.00
2024-12-10 17:35:58,57,1317,21,36,735.90,1333.00,0.00
2024-12-10 17:35:58,58,1317,22,36,723.21,1333.02,0.00
2024-12-10 17:35:58,57,1317,22,35,734.03,1333.04,0.00
2024-12-10 17:35:58,57,1318,22,35,735.75,1334.00,0.00
2024-12-10 17:35:58,58,1318,22,36,723.06,1334.02,0.00
2024-12-10 17:35:58,57,1318,21,36,729.46,1334.14,0.00
2024-12-10 17:35:58,57,1319,21,36,732.88,1335.00,0.00
2024-12-10 17:35:58,58,1319,21,37,720.24,1335.02,0.00
2024-12-10 17:35:58,57,1319,21,36,731.24,1335.04,0.00
2024-12-10 17:35:58,57,1320,21,36,732.96,1336.00,0.00
2024-12-10 17:35:58,58,1320,21,37,720.32,1336.02,0.00
2024-12-10 17:35:58,57,1320,20,37,717.71,1336.72,0.00
2024-12-10 17:35:58,57,1321,20,37,737.63,1337.00,0.00
2024-12-10 17:35:58,58,1321,21,37,724.92,1337.02,0.00
2024-12-10 17:35:58,57,1321,21,36,736.23,1337.04,0.00
2024-12-10 17:35:58,56,1321,20,36,747.27,1337.16,0.00
2024-12-10 17:35:58,56,1322,20,36,760.45,1338.00,0.00
2024-12-10 17:35:58,57,1322,20,37,747.11,1338.02,0.00
2024-12-10 17:35:59,56,1322,19,37,748.61,1338.32,0.00
2024-12-10 17:35:59,55,1322,18,37,758.17,1338.64,0.00
2024-12-10 17:35:59,55,1323,18,37,777.94,1339.00,0.00
2024-12-10 17:35:59,56,1323,18,38,764.04,1339.02,0.00
2024-12-10 17:35:59,55,1323,18,37,775.75,1339.06,0.00
2024-12-10 17:35:59,55,1324,18,37,778.27,1340.00,0.00
2024-12-10 17:35:59,56,1324,18,38,764.38,1340.02,0.00
2024-12-10 17:35:59,56,1325,18,38,761.61,1341.00,0.00
2024-12-10 17:35:59,57,1325,19,38,748.24,1341.02,0.00
2024-12-10 17:35:59,57,1326,19,38,745.04,1342.00,0.00
2024-12-10 17:35:59,58,1326,20,38,732.19,1342.02,0.00
2024-12-10 17:35:59,57,1326,20,37,744.56,1342.04,0.00
2024-12-10 17:35:59,57,1327,20,37,746.30,1343.00,0.00
2024-12-10 17:35:59,58,1327,20,38,733.43,1343.02,0.00
2024-12-10 17:35:59,57,1327,20,37,746.06,1343.02,0.00
2024-12-10 17:35:59,56,1327,20,36,757.71,1343.02,0.00
2024-12-10 17:35:59,55,1327,19,36,763.69,1343.62,0.00
2024-12-10 17:35:59,55,1328,19,36,773.52,1344.00,0.00
2024-12-10 17:35:59,56,1328,19,37,759.71,1344.02,0.00
2024-12-10 17:35:59,56,1329,19,37,756.67,1345.00,0.00
2024-12-10 17:35:59,57,1329,19,38,743.40,1345.02,0.00
2024-12-10 17:35:59,56,1329,19,37,755.23,1345.02,0.00
2024-12-10 17:35:59,56,1330,19,37,756.99,1346.00,0.00
2024-12-10 17:35:59,57,1330,19,38,743.71,1346.02,0.00
2024-12-10 17:35:59,56,1330,18,38,743.82,1346.64,0.00
2024-12-10 17:35:59,56,1331,18,38,754.44,1347.00,0.00
2024-12-10 17:35:59,57,1331,18,39,741.20,1347.02,0.00
2024-12-10 17:35:59,56,1331,18,38,752.28,1347.02,0.00
2024-12-10 17:35:59,56,1332,18,38,754.04,1348.00,0.00
2024-12-10 17:35:59,57,1332,18,39,740.81,1348.02,0.00
2024-12-10 17:35:59,56,1332,17,39,747.34,1348.16,0.00
2024-12-10 17:35:59,55,1332,16,39,760.33,1348.20,0.00
2024-12-10 17:35:59,54,1332,15,39,763.27,1348.82,0.00
2024-12-10 17:35:59,54,1333,15,39,785.91,1349.00,0.00
2024-12-10 17:35:59,55,1333,16,39,771.62,1349.02,0.00
2024-12-10 17:35:59,54,1333,16,38,783.91,1349.02,0.00
2024-12-10 17:35:59,53,1333,15,38,784.40,1349.51,0.00
2024-12-10 17:35:59,53,1334,15,38,803.62,1350.00,0.00
2024-12-10 17:35:59,54,1334,15,39,788.74,1350.02,0.00
2024-12-10 17:35:59,54,1335,15,39,786.07,1351.00,0.00
2024-12-10 17:35:59,55,1335,15,40,771.78,1351.02,0.00
2024-12-10 17:35:59,54,1335,15,39,784.32,1351.02,0.00
2024-12-10 17:35:59,53,1335,15,38,783.39,1351.25,0.00
2024-12-10 17:35:59,52,1335,14,38,795.60,1351.25,0.00
2024-12-10 17:35:59,52,1336,14,38,811.97,1352.00,0.00
2024-12-10 17:35:59,53,1336,14,39,796.65,1352.02,0.00
2024-12-10 17:35:59,53,1337,14,39,794.17,1353.00,0.00
2024-12-10 17:35:59,54,1337,14,40,779.47,1353.02,0.00
2024-12-10 17:35:59,53,1337,14,39,792.39,1353.02,0.00
2024-12-10 17:35:59,52,1337,13,39,793.25,1353.48,0.00
2024-12-10 17:35:59,51,1337,12,39,807.03,1353.63,0.00
2024-12-10 17:35:59,51,1338,12,39,828.85,1354.00,0.00
2024-12-10 17:35:59,52,1338,13,39,812.91,1354.02,0.00
2024-12-10 17:35:59,52,1339,13,39,810.64,1355.00,0.00
2024-12-10 17:35:59,53,1339,13,40,795.35,1355.02,0.00
2024-12-10 17:35:59,52,1339,13,39,809.08,1355.02,0.00
2024-12-10 17:35:59,51,1339,12,39,823.30,1355.14,0.00
2024-12-10 17:35:59,51,1340,12,39,828.13,1356.00,0.00
2024-12-10 17:35:59,52,1340,12,40,812.20,1356.02,0.00
2024-12-10 17:35:59,51,1340,11,40,817.56,1356.24,0.00
2024-12-10 17:35:59,51,1341,11,40,834.33,1357.00,0.00
2024-12-10 17:35:59,52,1341,11,41,818.28,1357.02,0.00
2024-12-10 17:35:59,51,1341,11,40,833.00,1357.02,0.00
2024-12-10 17:35:59,50,1341,10,40,842.68,1357.26,0.00
2024-12-10 17:35:59,50,1342,10,40,860.33,1358.00,0.00
2024-12-10 17:35:59,51,1342,11,40,843.46,1358.02,0.00
2024-12-10 17:35:59,50,1342,10,40,839.20,1358.48,0.00
2024-12-10 17:35:59,50,1343,10,40,859.72,1359.00,0.00
2024-12-10 17:35:59,51,1343,11,40,842.86,1359.02,0.00
2024-12-10 17:35:59,50,1343,11,39,858.63,1359.02,0.00
2024-12-10 17:35:59,50,1343,11,39,862.25,1360.00,0.00
2024-12-10 17:35:59,51,1343,11,40,845.35,1360.02,0.00
2024-12-10 17:35:59,50,1343,10,40,853.60,1360.18,0.00
2024-12-10 17:35:59,50,1344,10,40,870.24,1361.00,0.00
2024-12-10 17:35:59,51,1344,10,41,853.17,1361.02,0.00
2024-12-10 17:35:59,50,1344,10,40,869.15,1361.02,0.00
2024-12-10 17:35:59,50,1345,10,40,872.78,1362.00,0.00
2024-12-10 17:35:59,51,1345,11,40,855.67,1362.02,0.00
2024-12-10 17:35:59,51,1346,11,40,853.63,1363.00,0.00
2024-12-10 17:35:59,52,1346,11,41,837.21,1363.02,0.00
2024-12-10 17:35:59,51,1346,11,40,852.82,1363.02,0.00
2024-12-10 17:35:59,50,1346,10,40,855.90,1363.44,0.00
2024-12-10 17:35:59,50,1347,10,40,875.97,1364.00,0.00
2024-12-10 17:35:59,51,1347,10,41,858.80,1364.02,0.00
2024-12-10 17:35:59,51,1348,10,41,856.75,1365.00,0.00
2024-12-10 17:35:59,52,1348,11,41,840.28,1365.02,0.00
2024-12-10 17:35:59,51,1348,11,40,855.68,1365.02,0.00
2024-12-10 17:35:59,51,1349,11,40,858.99,1366.00,0.00
2024-12-10 17:35:59,52,1349,12,40,842.47,1366.02,0.00
2024-12-10 17:35:59,52,1350,12,40,840.19,1367.00,0.00
2024-12-10 17:35:59,53,1350,12,41,824.34,1367.02,0.00
2024-12-10 17:35:59,52,1350,12,40,839.40,1367.02,0.00
2024-12-10 17:35:59,52,1351,12,40,842.39,1368.00,0.00
2024-12-10 17:35:59,53,1351,13,40,826.49,1368.02,0.00
2024-12-10 17:35:59,52,1351,12,40,827.26,1368.33,0.00
2024-12-10 17:35:59,52,1352,12,40,844.84,1369.00,0.00
2024-12-10 17:35:59,53,1352,13,40,828.90,1369.02,0.00
2024-12-10 17:35:59,52,1352,13,39,843.00,1369.02,0.00
2024-12-10 17:35:59,52,1353,13,39,845.99,1370.00,0.00
2024-12-10 17:35:59,53,1353,13,40,830.03,1370.02,0.00
2024-12-10 17:35:59,53,1354,13,40,827.53,1371.00,0.00
2024-12-10 17:35:59,54,1354,13,41,812.20,1371.02,0.00
2024-12-10 17:35:59,53,1354,13,40,825.46,1371.02,0.00
2024-12-10 17:35:59,52,1354,12,40,824.25,1371.96,0.00
2024-12-10 17:35:59,52,1355,12,40,850.13,1372.00,0.00
2024-12-10 17:35:59,53,1355,13,40,834.09,1372.02,0.00
2024-12-10 17:36:00,53,1356,13,40,831.58,1373.00,0.00
2024-12-10 17:36:00,54,1356,14,40,816.18,1373.02,0.00
2024-12-10 17:36:00,53,1356,14,39,829.77,1373.02,0.00
2024-12-10 17:36:00,53,1357,14,39,832.45,1374.00,0.00
2024-12-10 17:36:00,54,1357,15,39,817.03,1374.02,0.00
2024-12-10 17:36:00,54,1358,15,39,814.32,1375.00,0.00
2024-12-10 17:36:00,55,1358,15,40,799.51,1375.02,0.00
2024-12-10 17:36:00,54,1358,15,39,812.28,1375.02,0.00
2024-12-10 17:36:00,54,1359,15,39,814.66,1376.00,0.00
2024-12-10 17:36:00,55,1359,15,40,799.84,1376.02,0.00
2024-12-10 17:36:00,54,1359,14,40,799.24,1376.72,0.00
2024-12-10 17:36:00,54,1360,14,40,821.11,1377.00,0.00
2024-12-10 17:36:00,55,1360,14,41,806.18,1377.02,0.00
2024-12-10 17:36:00,54,1360,14,40,818.56,1377.02,0.00
2024-12-10 17:36:00,54,1361,14,40,820.94,1378.00,0.00
2024-12-10 17:36:00,55,1361,15,40,806.02,1378.02,0.00
2024-12-10 17:36:00,54,1361,14,40,805.01,1378.74,0.00
2024-12-10 17:36:00,54,1362,14,40,827.16,1379.00,0.00
2024-12-10 17:36:00,55,1362,15,40,812.12,1379.02,0.00
2024-12-10 17:36:00,54,1362,15,39,824.86,1379.02,0.00
2024-12-10 17:36:00,54,1363,15,39,827.25,1380.00,0.00
2024-12-10 17:36:00,55,1363,15,40,812.21,1380.02,0.00
2024-12-10 17:36:00,54,1363,14,40,816.57,1380.20,0.00
2024-12-10 17:36:00,54,1364,14,40,831.67,1381.00,0.00
2024-12-10 17:36:00,55,1364,14,41,816.55,1381.02,0.00
2024-12-10 17:36:00,54,1364,14,40,828.86,1381.02,0.00
2024-12-10 17:36:00,53,1364,13,40,831.91,1381.79,0.00
2024-12-10 17:36:00,53,1365,13,40,855.27,1382.00,0.00
2024-12-10 17:36:00,54,1365,14,40,839.44,1382.02,0.00
2024-12-10 17:36:00,54,1366,14,40,836.71,1383.00,0.00
2024-12-10 17:36:00,55,1366,14,41,821.50,1383.02,0.00
2024-12-10 17:36:00,54,1366,14,40,833.90,1383.02,0.00
2024-12-10 17:36:00,54,1367,14,40,836.29,1384.00,0.00
2024-12-10 17:36:00,55,1367,14,41,821.09,1384.02,0.00
2024-12-10 17:36:00,55,1368,14,41,818.16,1385.00,0.00
2024-12-10 17:36:00,56,1368,15,41,803.55,1385.02,0.00
2024-12-10 17:36:00,55,1368,15,40,815.64,1385.02,0.00
2024-12-10 17:36:00,54,1368,14,40,811.35,1385.69,0.00
2024-12-10 17:36:00,54,1369,14,40,832.88,1386.00,0.00
2024-12-10 17:36:00,55,1369,15,40,817.74,1386.02,0.00
2024-12-10 17:36:00,54,1369,14,40,816.13,1386.43,0.00
2024-12-10 17:36:00,54,1370,14,40,834.25,1387.00,0.00
2024-12-10 17:36:00,55,1370,14,41,819.09,1387.02,0.00
2024-12-10 17:36:00,54,1370,14,40,831.69,1387.02,0.00
2024-12-10 17:36:00,53,1370,13,40,838.82,1387.66,0.00
2024-12-10 17:36:00,53,1371,13,40,850.08,1388.00,0.00
2024-12-10 17:36:00,54,1371,14,40,834.34,1388.02,0.00
2024-12-10 17:36:00,54,1372,14,40,832.93,1389.00,0.00
2024-12-10 17:36:00,55,1372,14,41,817.79,1389.02,0.00
2024-12-10 17:36:00,55,1373,14,41,814.84,1390.00,0.00
2024-12-10 17:36:00,56,1373,15,41,800.29,1390.02,0.00
2024-12-10 17:36:00,55,1373,15,40,814.59,1390.02,0.00
2024-12-10 17:36:00,55,1374,15,40,816.69,1391.00,0.00
2024-12-10 17:36:00,56,1374,16,40,802.10,1391.02,0.00
2024-12-10 17:36:00,56,1375,16,40,798.95,1392.00,0.00
2024-12-10 17:36:00,57,1375,16,41,784.94,1392.02,0.00
2024-12-10 17:36:00,56,1375,16,40,796.47,1392.02,0.00
2024-12-10 17:36:00,56,1376,16,40,798.28,1393.00,0.00
2024-12-10 17:36:00,57,1376,17,40,784.28,1393.02,0.00
2024-12-10 17:36:00,56,1376,16,40,792.77,1393.05,0.00
2024-12-10 17:36:00,55,1376,15,40,799.39,1393.64,0.00
2024-12-10 17:36:00,55,1377,15,40,809.94,1394.00,0.00
2024-12-10 17:36:00,56,1377,16,40,795.47,1394.02,0.00
2024-12-10 17:36:00,55,1377,16,39,807.40,1394.02,0.00
2024-12-10 17:36:00,55,1378,16,39,809.50,1395.00,0.00
2024-12-10 17:36:00,56,1378,16,40,795.05,1395.02,0.00
2024-12-10 17:36:00,56,1379,16,40,791.88,1396.00,0.00
2024-12-10 17:36:00,57,1379,16,41,777.99,1396.02,0.00
2024-12-10 17:36:00,56,1379,16,40,789.39,1396.02,0.00
2024-12-10 17:36:00,55,1379,15,40,791.96,1396.76,0.00
2024-12-10 17:36:00,55,1380,15,40,814.22,1397.00,0.00
2024-12-10 17:36:00,56,1380,16,40,799.68,1397.02,0.00
2024-12-10 17:36:00,55,1380,15,40,794.87,1397.85,0.00
2024-12-10 17:36:00,55,1381,15,40,818.36,1398.00,0.00
2024-12-10 17:36:00,56,1381,15,41,803.75,1398.02,0.00
2024-12-10 17:36:00,55,1381,15,40,815.56,1398.02,0.00
2024-12-10 17:36:00,55,1382,15,40,817.67,1399.00,0.00
2024-12-10 17:36:00,56,1382,16,40,803.07,1399.02,0.00
2024-12-10 17:36:00,55,1382,15,40,801.82,1399.44,0.00
2024-12-10 17:36:00,55,1383,15,40,819.79,1400.00,0.00
2024-12-10 17:36:00,56,1383,16,40,805.15,1400.02,0.00
2024-12-10 17:36:00,55,1383,16,39,816.73,1400.02,0.00
2024-12-10 17:36:00,55,1384,16,39,818.84,1401.00,0.00
2024-12-10 17:36:00,56,1384,16,40,804.22,1401.02,0.00
2024-12-10 17:36:00,55,1384,15,40,805.73,1401.35,0.00
2024-12-10 17:36:00,55,1385,15,40,822.49,1402.00,0.00
2024-12-10 17:36:00,56,1385,15,41,807.80,1402.02,0.00
2024-12-10 17:36:00,55,1385,15,40,819.17,1402.02,0.00
2024-12-10 17:36:00,54,1385,14,40,833.08,1402.11,0.00
2024-12-10 17:36:00,53,1385,13,40,837.95,1402.11,0.00
2024-12-10 17:36:00,53,1386,13,40,852.54,1403.00,0.00
2024-12-10 17:36:00,54,1386,13,41,836.76,1403.02,0.00
2024-12-10 17:36:00,54,1387,13,41,833.97,1404.00,0.00
2024-12-10 17:36:01,55,1387,13,42,818.81,1404.02,0.00
2024-12-10 17:36:01,54,1387,13,41,830.85,1404.02,0.00
2024-12-10 17:36:01,53,1387,12,41,833.20,1404.81,0.00
2024-12-10 17:36:01,53,1388,12,41,857.21,1405.00,0.00
2024-12-10 17:36:01,54,1388,12,42,841.33,1405.02,0.00
2024-12-10 17:36:01,53,1388,11,42,842.04,1405.70,0.00
2024-12-10 17:36:01,53,1389,11,42,864.56,1406.00,0.00
2024-12-10 17:36:01,54,1389,12,42,848.55,1406.02,0.00
2024-12-10 17:36:01,53,1389,12,41,861.64,1406.02,0.00
2024-12-10 17:36:01,53,1390,12,41,864.38,1407.00,0.00
2024-12-10 17:36:01,54,1390,13,41,848.37,1407.02,0.00
2024-12-10 17:36:01,54,1391,13,41,845.58,1408.00,0.00
2024-12-10 17:36:01,55,1391,14,41,830.21,1408.02,0.00
2024-12-10 17:36:01,54,1391,14,40,842.71,1408.02,0.00
2024-12-10 17:36:01,54,1392,14,40,845.14,1409.00,0.00
2024-12-10 17:36:01,55,1392,14,41,829.77,1409.02,0.00
2024-12-10 17:36:01,55,1393,14,41,826.77,1410.00,0.00
2024-12-10 17:36:01,56,1393,15,41,812.01,1410.02,0.00
2024-12-10 17:36:01,55,1393,15,40,824.21,1410.02,0.00
2024-12-10 17:36:01,55,1394,15,40,826.33,1411.00,0.00
2024-12-10 17:36:01,56,1394,15,41,811.58,1411.02,0.00
2024-12-10 17:36:01,55,1394,14,41,808.28,1411.80,0.00
2024-12-10 17:36:01,55,1395,14,41,831.28,1412.00,0.00
2024-12-10 17:36:01,56,1395,15,41,816.44,1412.02,0.00
2024-12-10 17:36:01,55,1395,15,40,828.97,1412.02,0.00
2024-12-10 17:36:01,54,1395,14,40,835.51,1412.67,0.00
2024-12-10 17:36:01,54,1396,14,40,846.75,1413.00,0.00
2024-12-10 17:36:01,55,1396,15,40,831.36,1413.02,0.00
2024-12-10 17:36:01,55,1397,15,40,828.35,1414.00,0.00
2024-12-10 17:36:01,56,1397,15,41,813.55,1414.02,0.00
2024-12-10 17:36:01,55,1397,15,40,825.78,1414.02,0.00
2024-12-10 17:36:01,55,1398,15,40,827.90,1415.00,0.00
2024-12-10 17:36:01,56,1398,15,41,813.12,1415.02,0.00
2024-12-10 17:36:01,55,1398,14,41,807.30,1415.89,0.00
2024-12-10 17:36:01,55,1399,14,41,831.58,1416.00,0.00
2024-12-10 17:36:01,56,1399,14,42,816.73,1416.02,0.00
2024-12-10 17:36:01,55,1399,14,41,829.26,1416.02,0.00
2024-12-10 17:36:01,55,1400,14,41,831.39,1417.00,0.00
2024-12-10 17:36:01,56,1400,14,42,816.55,1417.02,0.00
2024-12-10 17:36:01,55,1400,13,42,807.99,1417.64,0.00
2024-12-10 17:36:01,55,1401,13,42,828.88,1418.00,0.00
2024-12-10 17:36:01,56,1401,14,42,814.08,1418.02,0.00
2024-12-10 17:36:01,55,1401,14,41,826.82,1418.02,0.00
2024-12-10 17:36:01,54,1401,13,41,833.27,1418.67,0.00
2024-12-10 17:36:01,54,1402,13,41,844.57,1419.00,0.00
2024-12-10 17:36:01,55,1402,14,41,829.21,1419.02,0.00
2024-12-10 17:36:01,55,1403,14,41,826.18,1420.00,0.00
2024-12-10 17:36:01,56,1403,15,41,811.43,1420.02,0.00
2024-12-10 17:36:01,55,1403,15,40,824.37,1420.02,0.00
2024-12-10 17:36:01,55,1404,15,40,826.50,1421.00,0.00
2024-12-10 17:36:01,56,1404,16,40,811.75,1421.02,0.00
2024-12-10 17:36:01,56,1405,16,40,808.51,1422.00,0.00
2024-12-10 17:36:01,57,1405,17,40,794.32,1422.02,0.00
2024-12-10 17:36:01,56,1405,17,39,806.98,1422.02,0.00
2024-12-10 17:36:01,56,1406,17,39,808.82,1423.00,0.00
2024-12-10 17:36:01,57,1406,17,40,794.63,1423.02,0.00
2024-12-10 17:36:01,57,1407,17,40,791.19,1424.00,0.00
2024-12-10 17:36:01,58,1407,18,40,777.55,1424.02,0.00
2024-12-10 17:36:01,57,1407,18,39,789.94,1424.02,0.00
2024-12-10 17:36:01,56,1407,17,39,787.52,1424.93,0.00
2024-12-10 17:36:01,56,1408,17,39,812.00,1425.00,0.00
2024-12-10 17:36:01,57,1408,17,40,797.75,1425.02,0.00
2024-12-10 17:36:01,57,1409,17,40,794.31,1426.00,0.00
2024-12-10 17:36:01,58,1409,18,40,780.61,1426.02,0.00
2024-12-10 17:36:01,57,1409,18,39,793.06,1426.02,0.00
2024-12-10 17:36:01,56,1409,17,39,797.61,1426.70,0.00
2024-12-10 17:36:01,56,1410,17,39,819.00,1427.00,0.00
2024-12-10 17:36:01,57,1410,18,39,804.63,1427.02,0.00
2024-12-10 17:36:01,57,1411,18,39,801.18,1428.00,0.00
2024-12-10 17:36:01,58,1411,19,39,787.37,1428.02,0.00
2024-12-10 17:36:01,57,1411,19,38,800.18,1428.02,0.00
2024-12-10 17:36:01,57,1412,19,38,801.74,1429.00,0.00
2024-12-10 17:36:01,58,1412,19,39,787.92,1429.02,0.00
2024-12-10 17:36:01,57,1412,18,39,792.04,1429.25,0.00
2024-12-10 17:36:01,57,1413,18,39,806.82,1430.00,0.00
2024-12-10 17:36:01,58,1413,18,40,792.91,1430.02,0.00
2024-12-10 17:36:01,57,1413,18,39,806.07,1430.02,0.00
2024-12-10 17:36:01,57,1414,18,39,807.64,1431.00,0.00
2024-12-10 17:36:01,58,1414,19,39,793.71,1431.02,0.00
2024-12-10 17:36:01,57,1414,18,39,799.16,1431.21,0.00
2024-12-10 17:36:01,57,1415,18,39,813.48,1432.00,0.00
2024-12-10 17:36:01,58,1415,19,39,799.45,1432.02,0.00
2024-12-10 17:36:01,58,1416,19,39,795.64,1433.00,0.00
2024-12-10 17:36:01,59,1416,20,39,782.16,1433.02,0.00
2024-12-10 17:36:01,58,1416,20,38,795.56,1433.02,0.00
2024-12-10 17:36:01,57,1416,20,37,808.76,1433.02,0.00
2024-12-10 17:36:01,57,1417,20,37,810.34,1434.00,0.00
2024-12-10 17:36:01,58,1417,21,37,796.36,1434.02,0.00
2024-12-10 17:36:01,57,1417,20,37,801.09,1434.23,0.00
2024-12-10 17:36:01,57,1418,20,37,815.68,1435.00,0.00
2024-12-10 17:36:01,58,1418,20,38,801.62,1435.02,0.00
2024-12-10 17:36:01,57,1418,20,37,815.18,1435.02,0.00
2024-12-10 17:36:01,57,1419,20,37,816.76,1436.00,0.00
2024-12-10 17:36:01,58,1419,20,38,802.67,1436.02,0.00
2024-12-10 17:36:01,57,1419,19,38,799.54,1436.44,0.00
2024-12-10 17:36:02,57,1420,19,38,817.07,1437.00,0.00
2024-12-10 17:36:02,58,1420,19,39,802.99,1437.02,0.00
2024-12-10 17:36:02,57,1420,19,38,816.82,1437.02,0.00
2024-12-10 17:36:02,56,1420,18,38,816.49,1437.52,0.00
2024-12-10 17:36:02,56,1421,18,38,835.58,1438.00,0.00
2024-12-10 17:36:02,57,1421,19,38,820.92,1438.02,0.00
2024-12-10 17:36:02,57,1422,19,38,817.45,1439.00,0.00
2024-12-10 17:36:02,58,1422,20,38,803.36,1439.02,0.00
2024-12-10 17:36:02,57,1422,20,37,816.95,1439.02,0.00
2024-12-10 17:36:02,57,1423,20,37,818.53,1440.00,0.00
2024-12-10 17:36:02,58,1423,20,38,804.41,1440.02,0.00
2024-12-10 17:36:02,57,1423,19,38,806.50,1440.32,0.00
2024-12-10 17:36:02,57,1424,19,38,822.38,1441.00,0.00
2024-12-10 17:36:02,58,1424,19,39,808.20,1441.02,0.00
2024-12-10 17:36:02,57,1424,19,38,822.13,1441.02,0.00
2024-12-10 17:36:02,57,1425,19,38,823.71,1442.00,0.00
2024-12-10 17:36:02,58,1425,19,39,809.51,1442.02,0.00
2024-12-10 17:36:02,57,1425,18,39,803.45,1442.53,0.00
2024-12-10 17:36:02,56,1425,17,39,816.32,1442.64,0.00
2024-12-10 17:36:02,56,1426,17,39,837.20,1443.00,0.00
2024-12-10 17:36:02,57,1426,17,40,822.51,1443.02,0.00
2024-12-10 17:36:02,56,1426,17,39,836.94,1443.02,0.00
2024-12-10 17:36:02,55,1426,16,39,838.45,1443.47,0.00
2024-12-10 17:36:02,55,1427,16,39,857.47,1444.00,0.00
2024-12-10 17:36:02,56,1427,16,40,842.16,1444.02,0.00
2024-12-10 17:36:02,55,1427,16,39,851.96,1444.02,0.00
2024-12-10 17:36:02,55,1428,16,39,854.13,1445.00,0.00
2024-12-10 17:36:02,56,1428,17,39,838.87,1445.02,0.00
2024-12-10 17:36:02,55,1428,16,39,845.78,1445.22,0.00
2024-12-10 17:36:02,55,1429,16,39,850.77,1446.00,0.00
2024-12-10 17:36:02,56,1429,16,40,835.58,1446.02,0.00
2024-12-10 17:36:02,55,1429,16,39,850.25,1446.02,0.00
2024-12-10 17:36:02,55,1430,16,39,852.41,1447.00,0.00
2024-12-10 17:36:02,56,1430,16,40,837.19,1447.02,0.00
2024-12-10 17:36:02,55,1430,15,40,830.83,1447.55,0.00
2024-12-10 17:36:02,55,1431,15,40,850.90,1448.00,0.00
2024-12-10 17:36:02,56,1431,15,41,835.70,1448.02,0.00
2024-12-10 17:36:02,55,1431,15,40,850.11,1448.02,0.00
2024-12-10 17:36:02,55,1432,15,40,852.27,1449.00,0.00
2024-12-10 17:36:02,56,1432,16,40,837.06,1449.02,0.00
2024-12-10 17:36:02,55,1432,15,40,835.05,1449.42,0.00
2024-12-10 17:36:02,55,1433,15,40,853.39,1450.00,0.00
2024-12-10 17:36:02,56,1433,15,41,838.15,1450.02,0.00
2024-12-10 17:36:02,55,1433,15,40,852.86,1450.02,0.00
2024-12-10 17:36:02,55,1434,15,40,855.03,1451.00,0.00
2024-12-10 17:36:02,56,1434,16,40,839.77,1451.02,0.00
2024-12-10 17:36:02,55,1434,15,40,840.57,1451.66,0.00
2024-12-10 17:36:02,55,1435,15,40,851.66,1452.00,0.00
2024-12-10 17:36:02,56,1435,16,40,836.46,1452.02,0.00
2024-12-10 17:36:02,55,1435,16,39,850.61,1452.02,0.00
2024-12-10 17:36:02,55,1436,16,39,852.78,1453.00,0.00
2024-12-10 17:36:02,56,1436,16,40,837.55,1453.02,0.00
2024-12-10 17:36:02,56,1437,16,40,834.23,1454.00,0.00
2024-12-10 17:36:02,57,1437,16,41,819.60,1454.02,0.00
2024-12-10 17:36:02,56,1437,16,40,833.45,1454.02,0.00
2024-12-10 17:36:02,55,1437,15,40,839.40,1454.66,0.00
2024-12-10 17:36:02,55,1438,15,40,861.10,1455.00,0.00
2024-12-10 17:36:02,56,1438,15,41,845.72,1455.02,0.00
2024-12-10 17:36:02,55,1438,14,41,848.93,1455.04,0.00
2024-12-10 17:36:02,55,1439,14,41,861.95,1456.00,0.00
2024-12-10 17:36:02,56,1439,15,41,846.56,1456.02,0.00
2024-12-10 17:36:02,56,1440,15,41,843.24,1457.00,0.00
2024-12-10 17:36:02,57,1440,15,42,828.44,1457.02,0.00
2024-12-10 17:36:02,56,1440,15,41,842.98,1457.02,0.00
2024-12-10 17:36:02,55,1440,15,40,857.25,1457.02,0.00
2024-12-10 17:36:02,55,1441,15,40,859.42,1458.00,0.00
2024-12-10 17:36:02,56,1441,15,41,844.08,1458.02,0.00
2024-12-10 17:36:02,56,1442,15,41,840.75,1459.00,0.00
2024-12-10 17:36:02,57,1442,15,42,826.00,1459.02,0.00
2024-12-10 17:36:02,56,1442,15,41,839.97,1459.02,0.00
2024-12-10 17:36:02,55,1442,14,41,846.52,1459.64,0.00
2024-12-10 17:36:02,54,1442,13,41,855.63,1459.87,0.00
2024-12-10 17:36:02,54,1443,13,41,880.87,1460.00,0.00
2024-12-10 17:36:02,55,1443,14,41,864.85,1460.02,0.00
2024-12-10 17:36:02,55,1444,14,41,861.72,1461.00,0.00
2024-12-10 17:36:02,56,1444,14,42,846.34,1461.02,0.00
2024-12-10 17:36:02,55,1444,14,41,860.93,1461.02,0.00
2024-12-10 17:36:02,55,1445,14,41,863.11,1462.00,0.00
2024-12-10 17:36:02,56,1445,15,41,847.70,1462.02,0.00
2024-12-10 17:36:02,55,1445,14,41,848.62,1462.35,0.00
2024-12-10 17:36:02,55,1446,14,41,866.10,1463.00,0.00
2024-12-10 17:36:02,56,1446,14,42,850.63,1463.02,0.00
2024-12-10 17:36:02,55,1446,14,41,864.50,1463.04,0.00
2024-12-10 17:36:02,55,1447,14,41,866.95,1464.00,0.00
2024-12-10 17:36:02,56,1447,14,42,851.47,1464.02,0.00
2024-12-10 17:36:02,56,1448,14,42,848.13,1465.00,0.00
2024-12-10 17:36:02,57,1448,14,43,833.25,1465.02,0.00
2024-12-10 17:36:02,56,1448,14,42,846.56,1465.04,0.00
2024-12-10 17:36:02,55,1448,13,42,847.24,1465.85,0.00
2024-12-10 17:36:02,55,1449,13,42,871.87,1466.00,0.00
2024-12-10 17:36:02,56,1449,13,43,856.30,1466.02,0.00
2024-12-10 17:36:02,56,1450,13,43,852.96,1467.00,0.00
2024-12-10 17:36:02,57,1450,14,43,837.99,1467.02,0.00
2024-12-10 17:36:02,56,1450,14,42,851.12,1467.04,0.00
2024-12-10 17:36:02,55,1450,13,42,858.70,1467.29,0.00
2024-12-10 17:36:02,56,1449,14,42,838.83,1467.64,0.00
2024-12-10 17:36:02,56,1450,14,42,865.86,1468.00,0.00
2024-12-10 17:36:02,57,1450,15,42,850.67,1468.02,0.00
2024-12-10 17:36:02,56,1450,15,41,861.40,1468.02,0.00
2024-12-10 17:36:02,56,1451,15,41,889.53,1469.00,0.00
2024-12-10 17:36:02,57,1451,15,42,873.93,1469.02,0.00
2024-12-10 17:36:02,57,1452,15,42,870.39,1470.00,0.00
2024-12-10 17:36:03,58,1452,15,43,855.39,1470.02,0.00
2024-12-10 17:36:03,57,1452,15,42,868.85,1470.02,0.00
2024-12-10 17:36:03,56,1452,14,42,869.86,1470.48,0.00
2024-12-10 17:36:03,56,1453,14,42,888.90,1471.00,0.00
2024-12-10 17:36:03,57,1453,15,42,873.31,1471.02,0.00
2024-12-10 17:36:03,57,1454,15,42,869.77,1472.00,0.00
2024-12-10 17:36:03,58,1454,16,42,854.77,1472.02,0.00
2024-12-10 17:36:03,57,1454,16,41,868.48,1472.02,0.00
2024-12-10 17:36:03,57,1455,16,41,870.10,1473.00,0.00
2024-12-10 17:36:03,58,1455,17,41,855.10,1473.02,0.00
2024-12-10 17:36:03,57,1455,16,41,846.87,1473.61,0.00
2024-12-10 17:36:03,57,1456,16,41,867.33,1474.00,0.00
2024-12-10 17:36:03,58,1456,16,42,852.38,1474.02,0.00
2024-12-10 17:36:03,57,1456,16,41,866.04,1474.02,0.00
2024-12-10 17:36:03,57,1457,16,41,867.66,1475.00,0.00
2024-12-10 17:36:03,58,1457,16,42,852.70,1475.02,0.00
2024-12-10 17:36:03,58,1458,16,42,848.95,1476.00,0.00
2024-12-10 17:36:03,59,1458,17,42,834.56,1476.02,0.00
2024-12-10 17:36:03,58,1458,17,41,847.43,1476.02,0.00
2024-12-10 17:36:03,57,1458,16,41,852.82,1476.35,0.00
2024-12-10 17:36:03,57,1459,16,41,869.62,1477.00,0.00
2024-12-10 17:36:03,58,1459,17,41,854.62,1477.02,0.00
2024-12-10 17:36:03,58,1460,17,41,850.87,1478.00,0.00
2024-12-10 17:36:03,59,1460,17,42,836.45,1478.02,0.00
2024-12-10 17:36:03,58,1460,17,41,849.59,1478.02,0.00
2024-12-10 17:36:03,58,1461,17,41,850.93,1479.00,0.00
2024-12-10 17:36:03,59,1461,17,42,836.51,1479.02,0.00
2024-12-10 17:36:03,59,1462,17,42,832.56,1480.00,0.00
2024-12-10 17:36:03,60,1462,18,42,818.69,1480.02,0.00
2024-12-10 17:36:03,59,1462,18,41,831.56,1480.02,0.00
2024-12-10 17:36:03,59,1463,18,41,832.62,1481.00,0.00
2024-12-10 17:36:03,60,1463,18,42,818.75,1481.02,0.00
2024-12-10 17:36:03,59,1463,17,42,818.62,1481.64,0.00
2024-12-10 17:36:03,59,1464,17,42,828.66,1482.00,0.00
2024-12-10 17:36:03,60,1464,18,42,814.85,1482.02,0.00
2024-12-10 17:36:03,59,1464,18,41,827.91,1482.02,0.00
2024-12-10 17:36:03,59,1465,18,41,828.97,1483.00,0.00
2024-12-10 17:36:03,60,1465,18,42,815.16,1483.02,0.00
2024-12-10 17:36:03,60,1466,18,42,811.01,1484.00,0.00
2024-12-10 17:36:03,61,1466,18,43,797.71,1484.02,0.00
2024-12-10 17:36:03,60,1466,18,42,810.51,1484.02,0.00
2024-12-10 17:36:03,59,1466,17,42,822.27,1484.14,0.00
2024-12-10 17:36:03,59,1467,17,42,825.06,1485.00,0.00
2024-12-10 17:36:03,60,1467,17,43,811.30,1485.02,0.00
2024-12-10 17:36:03,60,1468,17,43,807.15,1486.00,0.00
2024-12-10 17:36:03,61,1468,17,44,793.91,1486.02,0.00
2024-12-10 17:36:03,60,1468,17,43,806.15,1486.02,0.00
2024-12-10 17:36:03,60,1469,17,43,806.94,1487.00,0.00
2024-12-10 17:36:03,61,1469,17,44,793.72,1487.02,0.00
2024-12-10 17:36:03,60,1469,16,44,800.29,1487.13,0.00
2024-12-10 17:36:03,59,1469,15,44,806.08,1487.66,0.00
2024-12-10 17:36:03,59,1470,15,44,816.55,1488.00,0.00
2024-12-10 17:36:03,60,1470,15,45,802.94,1488.02,0.00
2024-12-10 17:36:03,59,1470,15,44,815.54,1488.02,0.00
2024-12-10 17:36:03,58,1470,14,44,828.09,1488.12,0.00
2024-12-10 17:36:03,57,1470,13,44,832.88,1488.72,0.00
2024-12-10 17:36:03,57,1471,13,44,855.00,1489.00,0.00
2024-12-10 17:36:03,58,1471,14,44,840.26,1489.02,0.00
2024-12-10 17:36:03,57,1471,13,44,837.67,1489.42,0.00
2024-12-10 17:36:03,57,1472,13,44,855.57,1490.00,0.00
2024-12-10 17:36:03,58,1472,14,44,840.82,1490.02,0.00
2024-12-10 17:36:03,57,1472,14,43,854.27,1490.02,0.00
2024-12-10 17:36:03,57,1473,14,43,855.89,1491.00,0.00
2024-12-10 17:36:03,58,1473,15,43,841.13,1491.02,0.00
2024-12-10 17:36:03,58,1474,15,43,837.32,1492.00,0.00
2024-12-10 17:36:03,59,1474,15,44,823.13,1492.02,0.00
2024-12-10 17:36:03,58,1474,15,43,836.29,1492.02,0.00
2024-12-10 17:36:03,57,1474,14,43,841.36,1492.67,0.00
2024-12-10 17:36:03,56,1474,13,43,847.53,1492.96,0.00
2024-12-10 17:36:03,56,1475,13,43,873.67,1493.00,0.00
2024-12-10 17:36:03,57,1475,14,43,858.34,1493.02,0.00
2024-12-10 17:36:03,56,1475,13,43,866.51,1493.14,0.00
2024-12-10 17:36:03,56,1476,13,43,870.25,1494.00,0.00
2024-12-10 17:36:03,57,1476,13,44,854.99,1494.02,0.00
2024-12-10 17:36:03,56,1476,13,43,869.45,1494.02,0.00
2024-12-10 17:36:03,56,1477,13,43,871.37,1495.00,0.00
2024-12-10 17:36:03,57,1477,14,43,856.08,1495.02,0.00
2024-12-10 17:36:03,57,1478,14,43,852.46,1496.00,0.00
2024-12-10 17:36:03,58,1478,15,43,837.76,1496.02,0.00
2024-12-10 17:36:03,57,1478,15,42,851.93,1496.02,0.00
2024-12-10 17:36:03,56,1478,14,42,857.34,1496.68,0.00
2024-12-10 17:36:03,56,1479,14,42,868.79,1497.00,0.00
2024-12-10 17:36:03,57,1479,14,43,853.55,1497.02,0.00
2024-12-10 17:36:03,56,1479,13,43,844.77,1497.63,0.00
2024-12-10 17:36:03,55,1479,12,43,859.34,1497.67,0.00
2024-12-10 17:36:03,55,1480,12,43,881.91,1498.00,0.00
2024-12-10 17:36:03,56,1480,12,44,866.16,1498.02,0.00
2024-12-10 17:36:03,55,1480,12,43,880.28,1498.02,0.00
2024-12-10 17:36:03,55,1481,12,43,882.50,1499.00,0.00
2024-12-10 17:36:03,56,1481,13,43,866.74,1499.02,0.00
2024-12-10 17:36:03,55,1481,12,43,868.60,1499.04,0.00
2024-12-10 17:36:03,55,1482,12,43,882.00,1500.00,0.00
2024-12-10 17:36:03,56,1482,12,44,866.25,1500.02,0.00
2024-12-10 17:36:03,55,1482,12,43,880.36,1500.02,0.00
2024-12-10 17:36:03,54,1482,11,43,887.01,1500.67,0.00
2024-12-10 17:36:03,54,1483,11,43,898.93,1501.00,0.00
2024-12-10 17:36:03,55,1483,12,43,882.59,1501.02,0.00
2024-12-10 17:36:03,54,1483,11,43,878.56,1501.83,0.00
2024-12-10 17:36:04,54,1484,11,43,903.98,1502.00,0.00
2024-12-10 17:36:04,55,1484,11,44,887.54,1502.02,0.00
2024-12-10 17:36:04,54,1484,11,43,901.76,1502.02,0.00
2024-12-10 17:36:04,54,1485,11,43,904.30,1503.00,0.00
2024-12-10 17:36:04,55,1485,11,44,887.86,1503.02,0.00
2024-12-10 17:36:04,55,1486,11,44,884.62,1504.00,0.00
2024-12-10 17:36:04,56,1486,11,45,868.83,1504.02,0.00
2024-12-10 17:36:04,55,1486,11,44,882.71,1504.02,0.00
2024-12-10 17:36:04,56,1485,12,44,861.74,1504.41,0.00
2024-12-10 17:36:04,55,1485,11,44,886.84,1504.96,0.00
2024-12-10 17:36:04,55,1486,11,44,913.67,1505.00,0.00
2024-12-10 17:36:04,56,1486,12,44,897.36,1505.02,0.00
2024-12-10 17:36:04,56,1486,12,44,920.81,1506.00,0.00
2024-12-10 17:36:04,57,1486,13,44,904.66,1506.02,0.00
2024-12-10 17:36:04,56,1486,13,43,918.12,1506.02,0.00
2024-12-10 17:36:04,55,1486,12,43,921.89,1506.47,0.00
2024-12-10 17:36:04,55,1487,12,43,941.74,1507.00,0.00
2024-12-10 17:36:04,56,1487,12,44,924.92,1507.02,0.00
2024-12-10 17:36:04,56,1488,12,44,921.50,1508.00,0.00
2024-12-10 17:36:04,57,1488,12,45,905.33,1508.02,0.00
2024-12-10 17:36:04,56,1488,12,44,919.07,1508.02,0.00
2024-12-10 17:36:04,56,1489,12,44,921.03,1509.00,0.00
2024-12-10 17:36:04,57,1489,13,44,904.87,1509.02,0.00
2024-12-10 17:36:04,56,1489,12,44,905.23,1509.70,0.00
2024-12-10 17:36:04,56,1490,12,44,927.84,1510.00,0.00
2024-12-10 17:36:04,57,1490,12,45,911.56,1510.02,0.00
2024-12-10 17:36:04,56,1490,12,44,925.68,1510.02,0.00
2024-12-10 17:36:04,56,1491,12,44,927.65,1511.00,0.00
2024-12-10 17:36:04,57,1491,13,44,911.37,1511.02,0.00
2024-12-10 17:36:04,57,1492,13,44,907.73,1512.00,0.00
2024-12-10 17:36:04,58,1492,14,44,892.08,1512.02,0.00
2024-12-10 17:36:04,57,1492,14,43,905.34,1512.02,0.00
2024-12-10 17:36:04,57,1493,14,43,907.00,1513.00,0.00
2024-12-10 17:36:04,58,1493,15,43,891.37,1513.02,0.00
2024-12-10 17:36:04,57,1493,14,43,891.95,1513.67,0.00
2024-12-10 17:36:04,57,1494,14,43,903.09,1514.00,0.00
2024-12-10 17:36:04,58,1494,15,43,887.52,1514.02,0.00
2024-12-10 17:36:04,57,1494,15,42,900.96,1514.02,0.00
2024-12-10 17:36:04,56,1494,14,42,898.43,1514.96,0.00
2024-12-10 17:36:04,56,1495,14,42,924.96,1515.00,0.00
2024-12-10 17:36:04,57,1495,15,42,908.73,1515.02,0.00
2024-12-10 17:36:04,57,1496,15,42,905.08,1516.00,0.00
2024-12-10 17:36:04,58,1496,16,42,889.47,1516.02,0.00
2024-12-10 17:36:04,57,1496,16,41,903.22,1516.02,0.00
2024-12-10 17:36:04,56,1496,15,41,909.93,1516.66,0.00
2024-12-10 17:36:04,56,1497,15,41,921.31,1517.00,0.00
2024-12-10 17:36:04,57,1497,15,42,905.14,1517.02,0.00
2024-12-10 17:36:04,56,1497,14,42,899.61,1517.89,0.00
2024-12-10 17:36:04,56,1498,14,42,925.17,1518.00,0.00
2024-12-10 17:36:04,57,1498,15,42,908.94,1518.02,0.00
2024-12-10 17:36:04,56,1498,15,41,923.54,1518.02,0.00
2024-12-10 17:36:04,56,1499,15,41,925.50,1519.00,0.00
2024-12-10 17:36:04,57,1499,15,42,909.27,1519.02,0.00
2024-12-10 17:36:04,56,1499,14,42,912.88,1519.34,0.00
2024-12-10 17:36:04,56,1500,14,42,930.46,1520.00,0.00
2024-12-10 17:36:04,57,1500,15,42,914.13,1520.02,0.00
2024-12-10 17:36:04,56,1500,14,42,923.13,1520.04,0.00
2024-12-10 17:36:04,56,1501,14,42,930.80,1521.00,0.00
2024-12-10 17:36:04,57,1501,15,42,914.47,1521.02,0.00
2024-12-10 17:36:04,56,1501,15,41,928.90,1521.04,0.00
2024-12-10 17:36:04,56,1502,15,41,931.14,1522.00,0.00
2024-12-10 17:36:04,57,1502,16,41,914.80,1522.02,0.00
2024-12-10 17:36:04,57,1503,16,41,911.13,1523.00,0.00
2024-12-10 17:36:04,58,1503,17,41,895.42,1523.02,0.00
2024-12-10 17:36:04,57,1503,17,40,909.53,1523.04,0.00
2024-12-10 17:36:04,57,1504,17,40,911.46,1524.00,0.00
2024-12-10 17:36:04,58,1504,18,40,895.74,1524.02,0.00
2024-12-10 17:36:04,58,1505,18,40,891.86,1525.00,0.00
2024-12-10 17:36:04,59,1505,19,40,876.75,1525.02,0.00
2024-12-10 17:36:04,58,1505,19,39,890.55,1525.03,0.00
2024-12-10 17:36:04,57,1505,18,39,892.96,1525.79,0.00
2024-12-10 17:36:04,57,1506,18,39,916.67,1526.00,0.00
2024-12-10 17:36:04,58,1506,18,40,900.87,1526.02,0.00
2024-12-10 17:36:04,58,1507,18,40,896.98,1527.00,0.00
2024-12-10 17:36:04,59,1507,18,41,881.78,1527.02,0.00
2024-12-10 17:36:04,58,1507,18,40,895.67,1527.03,0.00
2024-12-10 17:36:04,58,1508,18,40,897.30,1528.00,0.00
2024-12-10 17:36:04,59,1508,19,40,882.10,1528.02,0.00
2024-12-10 17:36:04,59,1509,19,40,878.01,1529.00,0.00
2024-12-10 17:36:04,60,1509,19,41,863.37,1529.02,0.00
2024-12-10 17:36:04,59,1509,19,40,875.43,1529.07,0.00
2024-12-10 17:36:04,58,1509,18,40,871.60,1529.67,0.00
2024-12-10 17:36:04,58,1510,18,40,893.20,1530.00,0.00
2024-12-10 17:36:04,59,1510,19,40,878.06,1530.02,0.00
2024-12-10 17:36:04,59,1511,19,40,873.81,1531.00,0.00
2024-12-10 17:36:04,60,1511,20,40,859.24,1531.02,0.00
2024-12-10 17:36:04,59,1511,20,39,870.88,1531.07,0.00
2024-12-10 17:36:04,58,1511,19,39,871.03,1531.86,0.00
2024-12-10 17:36:04,58,1512,19,39,895.45,1532.00,0.00
2024-12-10 17:36:04,59,1512,19,40,880.27,1532.02,0.00
2024-12-10 17:36:04,59,1513,19,40,875.69,1533.00,0.00
2024-12-10 17:36:04,60,1513,20,40,861.10,1533.02,0.00
2024-12-10 17:36:04,59,1513,20,39,872.76,1533.07,0.00
2024-12-10 17:36:04,59,1514,20,39,874.42,1534.00,0.00
2024-12-10 17:36:04,60,1514,21,39,859.84,1534.02,0.00
2024-12-10 17:36:04,60,1515,21,39,854.36,1535.00,0.00
2024-12-10 17:36:04,61,1515,21,40,840.35,1535.02,0.00
2024-12-10 17:36:04,60,1515,21,39,851.56,1535.07,0.00
2024-12-10 17:36:04,59,1515,20,39,856.44,1535.70,0.00
2024-12-10 17:36:04,59,1516,20,39,866.79,1536.00,0.00
2024-12-10 17:36:04,60,1516,21,39,852.34,1536.02,0.00
2024-12-10 17:36:04,59,1516,21,38,866.70,1536.02,0.00
2024-12-10 17:36:05,59,1517,21,38,861.57,1537.00,0.00
2024-12-10 17:36:05,60,1517,22,38,847.21,1537.02,0.00
2024-12-10 17:36:05,59,1517,22,37,859.75,1537.05,0.00
2024-12-10 17:36:05,59,1518,22,37,860.13,1538.00,0.00
2024-12-10 17:36:05,60,1518,22,38,845.79,1538.02,0.00
2024-12-10 17:36:05,60,1519,22,38,840.12,1539.00,0.00
2024-12-10 17:36:05,61,1519,22,39,826.35,1539.02,0.00
2024-12-10 17:36:05,60,1519,22,38,838.09,1539.07,0.00
2024-12-10 17:36:05,60,1520,22,38,838.13,1540.00,0.00
2024-12-10 17:36:05,61,1520,23,38,824.39,1540.02,0.00
2024-12-10 17:36:05,61,1521,23,38,818.47,1541.00,0.00
2024-12-10 17:36:05,62,1521,23,39,805.27,1541.02,0.00
2024-12-10 17:36:05,61,1521,23,38,816.72,1541.07,0.00
2024-12-10 17:36:05,60,1521,22,38,819.29,1541.70,0.00
2024-12-10 17:36:05,60,1522,22,38,830.29,1542.00,0.00
2024-12-10 17:36:05,61,1522,22,39,816.68,1542.02,0.00
2024-12-10 17:36:05,60,1522,21,39,809.14,1542.83,0.00
2024-12-10 17:36:05,60,1523,21,39,832.41,1543.00,0.00
2024-12-10 17:36:05,61,1523,21,40,818.77,1543.02,0.00
2024-12-10 17:36:05,60,1523,21,39,830.88,1543.07,0.00
2024-12-10 17:36:05,60,1524,21,39,831.31,1544.00,0.00
2024-12-10 17:36:05,61,1524,21,40,817.68,1544.02,0.00
2024-12-10 17:36:05,60,1524,20,40,813.35,1544.20,0.00
2024-12-10 17:36:05,60,1525,20,40,826.21,1545.00,0.00
2024-12-10 17:36:05,61,1525,21,40,812.67,1545.02,0.00
2024-12-10 17:36:05,60,1525,21,39,824.94,1545.07,0.00
2024-12-10 17:36:05,59,1525,20,39,830.40,1545.37,0.00
2024-12-10 17:36:05,59,1526,20,39,846.32,1546.00,0.00
2024-12-10 17:36:05,60,1526,20,40,832.21,1546.02,0.00
2024-12-10 17:36:05,60,1527,20,40,826.83,1547.00,0.00
2024-12-10 17:36:05,61,1527,21,40,813.27,1547.02,0.00
2024-12-10 17:36:05,60,1527,21,39,825.29,1547.07,0.00
2024-12-10 17:36:05,59,1527,20,39,826.84,1547.75,0.00
2024-12-10 17:36:05,59,1528,20,39,849.34,1548.00,0.00
2024-12-10 17:36:05,60,1528,21,39,835.19,1548.02,0.00
2024-12-10 17:36:05,59,1528,20,39,821.37,1548.71,0.00
2024-12-10 17:36:05,59,1529,20,39,843.39,1549.00,0.00
2024-12-10 17:36:05,60,1529,21,39,829.33,1549.02,0.00
2024-12-10 17:36:05,59,1529,21,38,842.09,1549.07,0.00
2024-12-10 17:36:05,58,1529,21,37,847.92,1549.59,0.00
2024-12-10 17:36:05,58,1530,21,37,857.84,1550.00,0.00
2024-12-10 17:36:05,59,1530,21,38,843.30,1550.02,0.00
2024-12-10 17:36:05,59,1531,21,38,839.12,1551.00,0.00
2024-12-10 17:36:05,60,1531,21,39,825.13,1551.02,0.00
2024-12-10 17:36:05,59,1531,21,38,837.29,1551.07,0.00
2024-12-10 17:36:05,58,1531,20,38,840.81,1551.72,0.00
2024-12-10 17:36:05,58,1532,20,38,863.50,1552.00,0.00
2024-12-10 17:36:05,59,1532,21,38,848.86,1552.02,0.00
2024-12-10 17:36:05,59,1533,21,38,844.67,1553.00,0.00
2024-12-10 17:36:05,60,1533,21,39,830.60,1553.02,0.00
2024-12-10 17:36:05,59,1533,21,38,844.41,1553.02,0.00
2024-12-10 17:36:05,58,1533,21,37,857.64,1553.05,0.00
2024-12-10 17:36:05,58,1534,21,37,859.52,1554.00,0.00
2024-12-10 17:36:05,59,1534,21,38,844.95,1554.02,0.00
2024-12-10 17:36:05,58,1534,21,37,859.25,1554.02,0.00
2024-12-10 17:36:05,58,1535,21,37,855.25,1555.00,0.00
2024-12-10 17:36:05,59,1535,21,38,840.75,1555.02,0.00
2024-12-10 17:36:05,58,1535,21,37,853.92,1555.03,0.00
2024-12-10 17:36:05,57,1535,20,37,852.17,1555.90,0.00
2024-12-10 17:36:05,57,1536,20,37,877.91,1556.00,0.00
2024-12-10 17:36:05,58,1536,20,38,862.77,1556.02,0.00
2024-12-10 17:36:05,58,1537,20,38,858.72,1557.00,0.00
2024-12-10 17:36:05,59,1537,20,39,844.16,1557.02,0.00
2024-12-10 17:36:05,58,1537,20,38,857.65,1557.03,0.00
2024-12-10 17:36:05,58,1538,20,38,858.88,1558.00,0.00
2024-12-10 17:36:05,59,1538,21,38,844.33,1558.02,0.00
2024-12-10 17:36:05,58,1538,20,38,837.06,1558.86,0.00
2024-12-10 17:36:05,58,1539,20,38,861.90,1559.00,0.00
2024-12-10 17:36:05,59,1539,21,38,847.30,1559.02,0.00
2024-12-10 17:36:05,58,1539,21,37,860.84,1559.03,0.00
2024-12-10 17:36:05,58,1540,21,37,861.87,1560.00,0.00
2024-12-10 17:36:05,59,1540,21,38,847.26,1560.02,0.00
2024-12-10 17:36:05,59,1541,21,38,842.31,1561.00,0.00
2024-12-10 17:36:05,60,1541,22,38,828.27,1561.02,0.00
2024-12-10 17:36:05,59,1541,22,37,841.26,1561.03,0.00
2024-12-10 17:36:05,58,1541,21,37,835.99,1561.97,0.00
2024-12-10 17:36:05,58,1542,21,37,862.40,1562.00,0.00
2024-12-10 17:36:05,59,1542,21,38,847.79,1562.02,0.00
2024-12-10 17:36:05,59,1543,21,38,842.54,1563.00,0.00
2024-12-10 17:36:05,60,1543,21,39,828.50,1563.02,0.00
2024-12-10 17:36:05,59,1543,21,38,841.75,1563.03,0.00
2024-12-10 17:36:05,59,1544,21,38,841.92,1564.00,0.00
2024-12-10 17:36:05,60,1544,21,39,827.89,1564.02,0.00
2024-12-10 17:36:05,60,1545,21,39,822.28,1565.00,0.00
2024-12-10 17:36:05,61,1545,21,40,808.80,1565.02,0.00
2024-12-10 17:36:05,60,1545,21,39,821.77,1565.03,0.00
2024-12-10 17:36:05,59,1545,20,39,817.17,1565.59,0.00
2024-12-10 17:36:05,58,1545,19,39,829.18,1565.72,0.00
2024-12-10 17:36:05,58,1546,19,39,852.08,1566.00,0.00
2024-12-10 17:36:05,59,1546,19,40,837.64,1566.02,0.00
2024-12-10 17:36:05,58,1546,19,39,846.15,1566.03,0.00
2024-12-10 17:36:05,57,1546,18,39,842.84,1566.58,0.00
2024-12-10 17:36:05,57,1547,18,39,864.06,1567.00,0.00
2024-12-10 17:36:05,58,1547,18,40,849.17,1567.02,0.00
2024-12-10 17:36:05,59,1546,19,40,834.77,1567.05,0.00
2024-12-10 17:36:05,58,1546,19,39,860.26,1567.05,0.00
2024-12-10 17:36:05,57,1546,19,38,871.81,1567.21,0.00
2024-12-10 17:36:05,56,1546,18,38,883.51,1567.32,0.00
2024-12-10 17:36:06,56,1547,18,38,901.32,1568.00,0.00
2024-12-10 17:36:06,57,1547,19,38,885.51,1568.02,0.00
2024-12-10 17:36:06,56,1547,19,37,895.18,1568.04,0.00
2024-12-10 17:36:06,56,1548,19,37,925.43,1569.00,0.00
2024-12-10 17:36:06,57,1548,20,37,909.19,1569.02,0.00
2024-12-10 17:36:06,57,1549,20,37,905.37,1570.00,0.00
2024-12-10 17:36:06,58,1549,20,38,889.76,1570.02,0.00
2024-12-10 17:36:06,57,1549,20,37,904.28,1570.04,0.00
2024-12-10 17:36:06,57,1550,20,37,906.22,1571.00,0.00
2024-12-10 17:36:06,58,1550,20,38,890.59,1571.02,0.00
2024-12-10 17:36:06,57,1550,19,38,893.01,1571.05,0.00
2024-12-10 17:36:06,57,1551,19,38,906.24,1572.00,0.00
2024-12-10 17:36:06,58,1551,19,39,890.62,1572.02,0.00
2024-12-10 17:36:06,57,1551,19,38,905.16,1572.04,0.00
2024-12-10 17:36:06,57,1552,19,38,907.10,1573.00,0.00
2024-12-10 17:36:06,58,1552,20,38,891.46,1573.02,0.00
2024-12-10 17:36:06,58,1553,20,38,887.41,1574.00,0.00
2024-12-10 17:36:06,59,1553,20,39,872.37,1574.02,0.00
2024-12-10 17:36:06,58,1553,20,38,886.07,1574.03,0.00
2024-12-10 17:36:06,57,1553,19,38,894.50,1574.30,0.00
2024-12-10 17:36:06,57,1554,19,38,911.57,1575.00,0.00
2024-12-10 17:36:06,58,1554,20,38,895.85,1575.02,0.00
2024-12-10 17:36:06,57,1554,19,38,895.10,1575.39,0.00
2024-12-10 17:36:06,57,1555,19,38,913.53,1576.00,0.00
2024-12-10 17:36:06,58,1555,19,39,897.78,1576.02,0.00
2024-12-10 17:36:06,57,1555,19,38,912.44,1576.04,0.00
2024-12-10 17:36:06,56,1555,18,38,925.96,1576.20,0.00
2024-12-10 17:36:06,56,1556,18,38,930.71,1577.00,0.00
2024-12-10 17:36:06,57,1556,18,39,914.38,1577.02,0.00
2024-12-10 17:36:06,57,1557,18,39,910.53,1578.00,0.00
2024-12-10 17:36:06,58,1557,19,39,894.83,1578.02,0.00
2024-12-10 17:36:06,57,1557,19,38,909.44,1578.04,0.00
2024-12-10 17:36:06,56,1557,18,38,922.91,1578.20,0.00
2024-12-10 17:36:06,55,1557,17,38,924.37,1578.55,0.00
2024-12-10 17:36:06,55,1558,17,38,946.25,1579.00,0.00
2024-12-10 17:36:06,56,1558,17,39,929.35,1579.02,0.00
2024-12-10 17:36:06,55,1558,16,39,935.98,1579.22,0.00
2024-12-10 17:36:06,54,1558,15,39,946.83,1579.63,0.00
2024-12-10 17:36:06,54,1559,15,39,970.53,1580.00,0.00
2024-12-10 17:36:06,55,1559,15,40,952.88,1580.02,0.00
2024-12-10 17:36:06,54,1559,15,39,969.37,1580.04,0.00
2024-12-10 17:36:06,55,1558,16,39,948.92,1580.26,0.00
2024-12-10 17:36:06,54,1558,15,39,974.18,1580.37,0.00
2024-12-10 17:36:06,54,1559,15,39,993.98,1581.00,0.00
2024-12-10 17:36:06,55,1559,16,39,975.91,1581.02,0.00
2024-12-10 17:36:06,54,1559,15,39,976.45,1581.15,0.00
2024-12-10 17:36:06,53,1559,14,39,994.59,1581.17,0.00
2024-12-10 17:36:06,53,1560,14,39,1041.73,1582.00,0.00
2024-12-10 17:36:06,54,1560,14,40,1022.44,1582.02,0.00
2024-12-10 17:36:06,53,1560,14,39,1040.85,1582.04,0.00
2024-12-10 17:36:06,53,1561,14,39,1044.18,1583.00,0.00
2024-12-10 17:36:06,54,1561,14,40,1024.85,1583.02,0.00
2024-12-10 17:36:06,54,1562,14,40,1021.68,1584.00,0.00
2024-12-10 17:36:06,55,1562,14,41,1003.10,1584.02,0.00
2024-12-10 17:36:06,54,1562,14,40,1019.65,1584.07,0.00
2024-12-10 17:36:06,53,1562,13,40,1027.92,1584.70,0.00
2024-12-10 17:36:06,53,1563,13,40,1053.28,1585.00,0.00
2024-12-10 17:36:06,54,1563,13,41,1033.77,1585.02,0.00
2024-12-10 17:36:06,53,1563,12,41,1045.24,1585.13,0.00
2024-12-10 17:36:06,53,1564,12,41,1050.05,1586.00,0.00
2024-12-10 17:36:06,54,1564,12,42,1030.61,1586.02,0.00
2024-12-10 17:36:06,53,1564,12,41,1048.28,1586.08,0.00
2024-12-10 17:36:06,52,1564,11,41,1058.14,1586.67,0.00
2024-12-10 17:36:06,52,1565,11,41,1083.74,1587.00,0.00
2024-12-10 17:36:06,53,1565,12,41,1063.29,1587.02,0.00
2024-12-10 17:36:06,53,1566,12,41,1060.36,1588.00,0.00
2024-12-10 17:36:06,54,1566,13,41,1040.73,1588.02,0.00
2024-12-10 17:36:06,53,1566,13,40,1058.59,1588.08,0.00
2024-12-10 17:36:06,53,1567,13,40,1062.53,1589.00,0.00
2024-12-10 17:36:06,54,1567,14,40,1042.85,1589.02,0.00
2024-12-10 17:36:06,54,1568,14,40,1039.68,1590.00,0.00
2024-12-10 17:36:06,55,1568,14,41,1020.78,1590.02,0.00
2024-12-10 17:36:06,54,1568,14,40,1036.46,1590.07,0.00
2024-12-10 17:36:06,54,1569,14,40,1040.04,1591.00,0.00
2024-12-10 17:36:06,55,1569,14,41,1021.13,1591.02,0.00
2024-12-10 17:36:06,55,1570,14,41,1026.52,1592.00,0.00
2024-12-10 17:36:06,56,1570,14,42,1008.19,1592.02,0.00
2024-12-10 17:36:06,56,1571,14,42,1011.35,1593.00,0.00
2024-12-10 17:36:06,57,1571,14,43,993.61,1593.02,0.00
2024-12-10 17:36:06,57,1572,14,43,991.97,1594.00,0.00
2024-12-10 17:36:06,58,1572,14,44,974.86,1594.02,0.00
2024-12-10 17:36:06,57,1572,13,44,952.63,1594.77,0.00
2024-12-10 17:36:06,57,1573,13,44,977.13,1595.00,0.00
2024-12-10 17:36:06,58,1573,14,44,960.29,1595.02,0.00
2024-12-10 17:36:06,57,1573,14,43,960.81,1595.42,0.00
2024-12-10 17:36:06,57,1574,14,43,968.80,1596.00,0.00
2024-12-10 17:36:06,58,1574,15,43,952.10,1596.02,0.00
2024-12-10 17:36:06,57,1574,15,42,964.34,1596.09,0.00
2024-12-10 17:36:06,57,1575,15,42,967.17,1597.00,0.00
2024-12-10 17:36:06,58,1575,16,42,950.49,1597.02,0.00
2024-12-10 17:36:06,57,1575,15,42,964.10,1597.05,0.00
2024-12-10 17:36:06,57,1576,15,42,971.98,1598.00,0.00
2024-12-10 17:36:06,58,1576,15,43,955.22,1598.02,0.00
2024-12-10 17:36:06,57,1576,15,42,967.63,1598.07,0.00
2024-12-10 17:36:06,57,1577,15,42,955.89,1599.00,0.00
2024-12-10 17:36:06,58,1577,16,42,939.41,1599.02,0.00
2024-12-10 17:36:06,57,1577,15,42,938.81,1599.70,0.00
2024-12-10 17:36:06,56,1577,14,42,937.73,1599.96,0.00
2024-12-10 17:36:06,56,1578,14,42,965.74,1600.00,0.00
2024-12-10 17:36:06,57,1578,15,42,948.80,1600.02,0.00
2024-12-10 17:36:06,56,1578,15,41,965.12,1600.05,0.00
2024-12-10 17:36:06,55,1578,15,40,978.89,1600.06,0.00
2024-12-10 17:36:06,55,1579,15,40,980.45,1601.00,0.00
2024-12-10 17:36:06,56,1579,16,40,962.94,1601.02,0.00
2024-12-10 17:36:07,56,1580,16,40,957.60,1602.00,0.00
2024-12-10 17:36:07,57,1580,17,40,940.80,1602.02,0.00
2024-12-10 17:36:07,56,1580,17,39,953.03,1602.05,0.00
2024-12-10 17:36:07,55,1580,16,39,949.40,1602.96,0.00
2024-12-10 17:36:07,55,1581,16,39,977.98,1603.00,0.00
2024-12-10 17:36:07,56,1581,17,39,960.51,1603.02,0.00
2024-12-10 17:36:07,56,1582,17,39,954.57,1604.00,0.00
2024-12-10 17:36:07,57,1582,18,39,937.82,1604.02,0.00
2024-12-10 17:36:07,56,1582,17,39,954.00,1604.04,0.00
2024-12-10 17:36:07,55,1582,17,38,966.97,1604.04,0.00
2024-12-10 17:36:07,55,1583,17,38,967.06,1605.00,0.00
2024-12-10 17:36:07,56,1583,17,39,949.79,1605.02,0.00
2024-12-10 17:36:07,56,1584,17,39,943.18,1606.00,0.00
2024-12-10 17:36:07,57,1584,17,40,926.64,1606.02,0.00
2024-12-10 17:36:07,56,1584,17,39,938.89,1606.04,0.00
2024-12-10 17:36:07,55,1584,16,39,932.89,1606.96,0.00
2024-12-10 17:36:07,55,1585,16,39,961.54,1607.00,0.00
2024-12-10 17:36:07,56,1585,17,39,944.37,1607.02,0.00
2024-12-10 17:36:07,55,1585,16,39,942.00,1607.13,0.00
2024-12-10 17:36:07,55,1586,16,39,954.66,1608.00,0.00
2024-12-10 17:36:07,56,1586,16,40,937.61,1608.02,0.00
2024-12-10 17:36:07,55,1586,16,39,950.29,1608.04,0.00
2024-12-10 17:36:07,55,1587,16,39,949.83,1609.00,0.00
2024-12-10 17:36:07,56,1587,17,39,932.87,1609.02,0.00
2024-12-10 17:36:07,55,1587,16,39,928.99,1609.47,0.00
2024-12-10 17:36:07,54,1587,16,38,939.31,1609.74,0.00
2024-12-10 17:36:07,54,1588,16,38,965.14,1610.00,0.00
2024-12-10 17:36:07,55,1588,16,39,947.60,1610.02,0.00
2024-12-10 17:36:07,54,1588,16,38,960.98,1610.04,0.00
2024-12-10 17:36:07,54,1589,16,38,963.95,1611.00,0.00
2024-12-10 17:36:07,55,1589,17,38,946.43,1611.02,0.00
2024-12-10 17:36:07,55,1590,17,38,942.91,1612.00,0.00
2024-12-10 17:36:07,56,1590,17,39,926.07,1612.02,0.00
2024-12-10 17:36:07,55,1590,17,38,939.11,1612.04,0.00
2024-12-10 17:36:07,55,1591,17,38,941.74,1613.00,0.00
2024-12-10 17:36:07,56,1591,17,39,924.92,1613.02,0.00
2024-12-10 17:36:07,55,1591,16,39,930.37,1613.20,0.00
2024-12-10 17:36:07,55,1592,16,39,947.31,1614.00,0.00
2024-12-10 17:36:07,56,1592,16,40,930.39,1614.02,0.00
2024-12-10 17:36:07,55,1592,16,39,943.80,1614.04,0.00
2024-12-10 17:36:07,55,1593,16,39,946.43,1615.00,0.00
2024-12-10 17:36:07,56,1593,16,40,929.53,1615.02,0.00
2024-12-10 17:36:07,56,1594,16,40,925.77,1616.00,0.00
2024-12-10 17:36:07,57,1594,17,40,909.53,1616.02,0.00
2024-12-10 17:36:07,56,1594,17,39,922.32,1616.04,0.00
2024-12-10 17:36:07,55,1594,16,39,928.86,1616.69,0.00
2024-12-10 17:36:07,55,1595,16,39,941.72,1617.00,0.00
2024-12-10 17:36:07,56,1595,17,39,924.90,1617.02,0.00
2024-12-10 17:36:07,56,1596,17,39,921.61,1618.00,0.00
2024-12-10 17:36:07,57,1596,17,40,905.44,1618.02,0.00
2024-12-10 17:36:07,56,1596,17,39,917.57,1618.04,0.00
2024-12-10 17:36:07,55,1596,16,39,924.49,1618.33,0.00
2024-12-10 17:36:07,54,1596,15,39,936.42,1618.67,0.00
2024-12-10 17:36:07,54,1597,15,39,961.24,1619.00,0.00
2024-12-10 17:36:07,55,1597,16,39,943.77,1619.02,0.00
2024-12-10 17:36:07,54,1597,15,39,938.03,1619.87,0.00
2024-12-10 17:36:07,54,1598,15,39,966.04,1620.00,0.00
2024-12-10 17:36:07,55,1598,16,39,948.47,1620.02,0.00
2024-12-10 17:36:07,54,1598,16,38,962.15,1620.04,0.00
2024-12-10 17:36:07,54,1599,16,38,965.11,1621.00,0.00
2024-12-10 17:36:07,55,1599,17,38,947.56,1621.02,0.00
2024-12-10 17:36:07,54,1599,16,38,936.03,1621.69,0.00
2024-12-10 17:36:07,54,1600,16,38,961.21,1622.00,0.00
2024-12-10 17:36:07,55,1600,16,39,943.74,1622.02,0.00
2024-12-10 17:36:07,54,1600,16,38,957.32,1622.04,0.00
2024-12-10 17:36:07,54,1601,16,38,959.67,1623.00,0.00
2024-12-10 17:36:07,55,1601,16,39,942.22,1623.02,0.00
2024-12-10 17:36:07,55,1602,16,39,937.69,1624.00,0.00
2024-12-10 17:36:07,56,1602,17,39,920.94,1624.02,0.00
2024-12-10 17:36:07,55,1602,17,38,934.15,1624.04,0.00
2024-12-10 17:36:07,54,1602,16,38,928.81,1624.65,0.00
2024-12-10 17:36:07,54,1603,16,38,953.45,1625.00,0.00
2024-12-10 17:36:07,55,1603,16,39,936.12,1625.02,0.00
2024-12-10 17:36:07,55,1604,16,39,931.05,1626.00,0.00
2024-12-10 17:36:07,56,1604,16,40,914.42,1626.02,0.00
2024-12-10 17:36:07,55,1604,16,39,927.80,1626.04,0.00
2024-12-10 17:36:07,55,1604,16,39,928.80,1627.00,0.00
2024-12-10 17:36:07,56,1604,17,39,912.22,1627.02,0.00
2024-12-10 17:36:07,55,1604,16,39,901.03,1627.96,0.00
2024-12-10 17:36:07,55,1605,16,39,930.06,1628.00,0.00
2024-12-10 17:36:07,56,1605,16,40,913.45,1628.02,0.00
2024-12-10 17:36:07,55,1605,16,39,926.52,1628.06,0.00
2024-12-10 17:36:07,55,1606,16,39,927.84,1629.00,0.00
2024-12-10 17:36:07,56,1606,16,40,911.27,1629.02,0.00
2024-12-10 17:36:07,55,1606,15,40,914.62,1629.29,0.00
2024-12-10 17:36:07,55,1607,15,40,931.68,1630.00,0.00
2024-12-10 17:36:07,56,1607,15,41,915.04,1630.02,0.00
2024-12-10 17:36:07,55,1607,15,40,927.24,1630.06,0.00
2024-12-10 17:36:07,55,1608,15,40,928.84,1631.00,0.00
2024-12-10 17:36:07,56,1608,16,40,912.26,1631.02,0.00
2024-12-10 17:36:07,56,1609,16,40,908.15,1632.00,0.00
2024-12-10 17:36:07,57,1609,17,40,892.22,1632.02,0.00
2024-12-10 17:36:07,56,1609,17,39,903.51,1632.07,0.00
2024-12-10 17:36:07,56,1610,17,39,905.44,1633.00,0.00
2024-12-10 17:36:07,57,1610,17,40,889.55,1633.02,0.00
2024-12-10 17:36:07,56,1610,16,40,887.68,1633.13,0.00
2024-12-10 17:36:07,56,1611,16,40,902.20,1634.00,0.00
2024-12-10 17:36:07,57,1611,16,41,886.37,1634.02,0.00
2024-12-10 17:36:07,56,1611,16,40,897.26,1634.09,0.00
2024-12-10 17:36:07,56,1612,16,40,899.44,1635.00,0.00
2024-12-10 17:36:08,57,1612,17,40,883.66,1635.02,0.00
2024-12-10 17:36:08,56,1612,16,40,884.09,1635.36,0.00
2024-12-10 17:36:08,55,1612,16,39,897.98,1635.44,0.00
2024-12-10 17:36:08,55,1613,16,39,918.89,1636.00,0.00
2024-12-10 17:36:08,56,1613,16,40,902.48,1636.02,0.00
2024-12-10 17:36:08,55,1613,16,39,914.15,1636.09,0.00
2024-12-10 17:36:08,55,1614,16,39,917.67,1637.00,0.00
2024-12-10 17:36:08,56,1614,17,39,901.28,1637.02,0.00
2024-12-10 17:36:08,56,1615,17,39,898.78,1638.00,0.00
2024-12-10 17:36:08,57,1615,17,40,883.01,1638.02,0.00
2024-12-10 17:36:08,56,1615,17,39,893.83,1638.09,0.00
2024-12-10 17:36:08,56,1616,17,39,896.99,1639.00,0.00
2024-12-10 17:36:08,57,1616,17,40,881.25,1639.02,0.00
2024-12-10 17:36:08,56,1616,16,40,873.72,1639.88,0.00
2024-12-10 17:36:08,56,1617,16,40,901.05,1640.00,0.00
2024-12-10 17:36:08,57,1617,17,40,885.24,1640.02,0.00
2024-12-10 17:36:08,56,1617,17,39,896.38,1640.09,0.00
2024-12-10 17:36:08,56,1618,17,39,899.55,1641.00,0.00
2024-12-10 17:36:08,57,1618,17,40,883.77,1641.02,0.00
2024-12-10 17:36:08,57,1619,17,40,865.02,1642.00,0.00
2024-12-10 17:36:08,58,1619,18,40,850.10,1642.02,0.00
2024-12-10 17:36:08,57,1619,18,39,860.71,1642.09,0.00
2024-12-10 17:36:08,56,1619,17,39,866.66,1642.68,0.00
2024-12-10 17:36:08,55,1619,17,38,870.41,1642.82,0.00
2024-12-10 17:36:08,55,1620,17,38,885.48,1643.00,0.00
2024-12-10 17:36:08,56,1620,17,39,869.67,1643.02,0.00
2024-12-10 17:36:08,56,1621,17,39,867.30,1644.00,0.00
2024-12-10 17:36:08,57,1621,17,40,852.08,1644.02,0.00
2024-12-10 17:36:08,56,1621,17,39,862.91,1644.09,0.00
2024-12-10 17:36:08,55,1621,16,39,858.77,1644.60,0.00
2024-12-10 17:36:08,55,1622,16,39,882.37,1645.00,0.00
2024-12-10 17:36:08,56,1622,16,40,866.62,1645.02,0.00
2024-12-10 17:36:08,55,1622,15,40,866.31,1645.64,0.00
2024-12-10 17:36:08,55,1623,15,40,880.28,1646.00,0.00
2024-12-10 17:36:08,56,1623,15,41,864.56,1646.02,0.00
2024-12-10 17:36:08,55,1623,15,40,875.80,1646.09,0.00
2024-12-10 17:36:08,54,1623,14,40,877.49,1646.76,0.00
2024-12-10 17:36:08,54,1624,14,40,904.21,1647.00,0.00
2024-12-10 17:36:08,55,1624,15,40,887.77,1647.02,0.00
2024-12-10 17:36:08,54,1624,14,40,878.52,1647.61,0.00
2024-12-10 17:36:08,54,1625,14,40,902.93,1648.00,0.00
2024-12-10 17:36:08,55,1625,15,40,886.51,1648.02,0.00
2024-12-10 17:36:08,54,1625,15,39,897.75,1648.11,0.00
2024-12-10 17:36:08,53,1625,14,39,912.87,1648.23,0.00
2024-12-10 17:36:08,53,1626,14,39,919.28,1649.00,0.00
2024-12-10 17:36:08,54,1626,14,40,902.25,1649.02,0.00
2024-12-10 17:36:08,53,1626,13,40,901.04,1649.40,0.00
2024-12-10 17:36:08,53,1627,13,40,922.64,1650.00,0.00
2024-12-10 17:36:08,54,1627,13,41,905.55,1650.02,0.00
2024-12-10 17:36:08,53,1627,13,40,917.67,1650.11,0.00
2024-12-10 17:36:08,52,1627,12,40,933.76,1650.21,0.00
2024-12-10 17:36:08,52,1628,12,40,940.31,1651.00,0.00
2024-12-10 17:36:08,53,1628,12,41,922.57,1651.02,0.00
2024-12-10 17:36:08,52,1628,11,41,922.02,1651.39,0.00
2024-12-10 17:36:08,52,1629,11,41,944.06,1652.00,0.00
2024-12-10 17:36:08,53,1629,12,41,926.25,1652.02,0.00
2024-12-10 17:36:08,52,1629,12,40,938.99,1652.12,0.00
2024-12-10 17:36:08,52,1630,12,40,944.00,1653.00,0.00
2024-12-10 17:36:08,53,1630,12,41,926.18,1653.02,0.00
2024-12-10 17:36:08,53,1631,12,41,923.82,1654.00,0.00
2024-12-10 17:36:08,54,1631,12,42,906.71,1654.02,0.00
2024-12-10 17:36:08,53,1631,12,41,919.15,1654.11,0.00
2024-12-10 17:36:08,53,1632,12,41,923.76,1655.00,0.00
2024-12-10 17:36:08,54,1632,12,42,906.65,1655.02,0.00
2024-12-10 17:36:08,53,1632,11,42,910.92,1655.25,0.00
2024-12-10 17:36:08,53,1633,11,42,930.16,1656.00,0.00
2024-12-10 17:36:08,54,1633,12,42,912.94,1656.02,0.00
2024-12-10 17:36:08,53,1633,12,41,929.54,1656.04,0.00
2024-12-10 17:36:08,52,1633,12,40,943.60,1656.10,0.00
2024-12-10 17:36:08,51,1633,11,40,949.23,1656.71,0.00
2024-12-10 17:36:08,51,1634,11,40,977.08,1657.00,0.00
2024-12-10 17:36:08,52,1634,11,41,958.29,1657.02,0.00
2024-12-10 17:36:08,52,1635,11,41,955.38,1658.00,0.00
2024-12-10 17:36:08,53,1635,11,42,937.35,1658.02,0.00
2024-12-10 17:36:08,52,1635,11,41,951.56,1658.10,0.00
2024-12-10 17:36:08,52,1636,11,41,956.27,1659.00,0.00
2024-12-10 17:36:08,53,1636,12,41,938.23,1659.02,0.00
2024-12-10 17:36:08,53,1637,12,41,935.19,1660.00,0.00
2024-12-10 17:36:08,54,1637,13,41,917.87,1660.02,0.00
2024-12-10 17:36:08,53,1637,13,40,931.75,1660.09,0.00
2024-12-10 17:36:08,52,1637,12,40,941.42,1660.60,0.00
2024-12-10 17:36:08,52,1638,12,40,954.18,1661.00,0.00
2024-12-10 17:36:08,53,1638,12,41,936.18,1661.02,0.00
2024-12-10 17:36:08,52,1638,11,41,926.31,1661.92,0.00
2024-12-10 17:36:08,52,1639,11,41,957.04,1662.00,0.00
2024-12-10 17:36:08,53,1639,12,41,938.99,1662.02,0.00
2024-12-10 17:36:08,52,1639,12,40,950.97,1662.08,0.00
2024-12-10 17:36:08,51,1639,11,40,957.91,1662.33,0.00
2024-12-10 17:36:08,51,1640,11,40,979.90,1663.00,0.00
2024-12-10 17:36:08,52,1640,12,40,961.06,1663.02,0.00
2024-12-10 17:36:08,51,1640,12,39,979.25,1663.04,0.00
2024-12-10 17:36:08,51,1641,12,39,982.55,1664.00,0.00
2024-12-10 17:36:08,52,1641,13,39,963.66,1664.02,0.00
2024-12-10 17:36:08,51,1641,13,38,979.62,1664.06,0.00
2024-12-10 17:36:08,51,1642,13,38,984.12,1665.00,0.00
2024-12-10 17:36:08,52,1642,14,38,965.20,1665.02,0.00
2024-12-10 17:36:08,51,1642,14,37,983.47,1665.04,0.00
2024-12-10 17:36:08,50,1642,13,37,982.17,1665.10,0.00
2024-12-10 17:36:08,50,1643,13,37,1001.07,1666.00,0.00
2024-12-10 17:36:08,51,1643,13,38,981.44,1666.02,0.00
2024-12-10 17:36:08,50,1643,13,37,998.86,1666.06,0.00
2024-12-10 17:36:08,50,1644,13,37,1003.79,1667.00,0.00
2024-12-10 17:36:08,51,1644,14,37,984.11,1667.02,0.00
2024-12-10 17:36:08,50,1644,13,37,1003.46,1667.02,0.00
2024-12-10 17:36:09,50,1645,13,37,1001.06,1668.00,0.00
2024-12-10 17:36:09,51,1645,13,38,981.43,1668.02,0.00
2024-12-10 17:36:09,50,1645,13,37,998.63,1668.02,0.00
2024-12-10 17:36:09,50,1646,13,37,1002.90,1669.00,0.00
2024-12-10 17:36:09,51,1646,14,37,983.23,1669.02,0.00
2024-12-10 17:36:09,50,1646,14,36,999.56,1669.02,0.00
2024-12-10 17:36:09,50,1647,14,36,1003.76,1670.00,0.00
2024-12-10 17:36:09,51,1647,14,37,984.08,1670.02,0.00
2024-12-10 17:36:09,50,1647,13,37,975.93,1670.96,0.00
2024-12-10 17:36:09,50,1648,13,37,1008.03,1671.00,0.00
2024-12-10 17:36:09,51,1648,13,38,988.27,1671.02,0.00
2024-12-10 17:36:09,50,1648,13,37,1003.02,1671.02,0.00
2024-12-10 17:36:09,50,1649,13,37,1007.00,1672.00,0.00
2024-12-10 17:36:09,51,1649,13,38,987.26,1672.02,0.00
2024-12-10 17:36:09,51,1650,13,38,983.82,1673.00,0.00
2024-12-10 17:36:09,52,1650,14,38,964.90,1673.02,0.00
2024-12-10 17:36:09,51,1650,14,37,979.23,1673.02,0.00
2024-12-10 17:36:09,50,1650,13,37,975.57,1673.94,0.00
2024-12-10 17:36:09,50,1651,13,37,1008.08,1674.00,0.00
2024-12-10 17:36:09,51,1651,14,37,988.32,1674.02,0.00
2024-12-10 17:36:09,50,1651,13,37,980.89,1674.56,0.00
2024-12-10 17:36:09,50,1652,13,37,1005.22,1675.00,0.00
2024-12-10 17:36:09,51,1652,13,38,985.51,1675.02,0.00
2024-12-10 17:36:09,50,1652,13,37,1000.53,1675.02,0.00
2024-12-10 17:36:09,50,1653,13,37,1001.57,1676.00,0.00
2024-12-10 17:36:09,51,1653,13,38,981.93,1676.02,0.00
2024-12-10 17:36:09,50,1653,12,38,975.99,1676.52,0.00
2024-12-10 17:36:09,50,1654,12,38,1001.47,1677.00,0.00
2024-12-10 17:36:09,51,1654,13,38,981.83,1677.02,0.00
2024-12-10 17:36:09,50,1654,13,37,996.77,1677.02,0.00
2024-12-10 17:36:09,49,1654,12,37,1005.94,1677.31,0.00
2024-12-10 17:36:09,49,1655,12,37,1029.02,1678.00,0.00
2024-12-10 17:36:09,50,1655,12,38,1008.44,1678.02,0.00
2024-12-10 17:36:09,50,1656,12,38,1006.31,1679.00,0.00
2024-12-10 17:36:09,51,1656,13,38,986.58,1679.02,0.00
2024-12-10 17:36:09,50,1656,13,37,1001.61,1679.02,0.00
2024-12-10 17:36:09,50,1657,13,37,1005.90,1680.00,0.00
2024-12-10 17:36:09,51,1657,13,38,986.18,1680.02,0.00
2024-12-10 17:36:09,50,1657,12,38,989.10,1680.64,0.00
2024-12-10 17:36:09,50,1658,12,38,1004.12,1681.00,0.00
2024-12-10 17:36:09,51,1658,13,38,984.43,1681.02,0.00
2024-12-10 17:36:09,50,1658,13,37,999.75,1681.02,0.00
2024-12-10 17:36:09,49,1658,12,37,1008.19,1681.67,0.00
2024-12-10 17:36:09,49,1659,12,37,1037.26,1682.00,0.00
2024-12-10 17:36:09,50,1659,12,38,1016.52,1682.02,0.00
2024-12-10 17:36:09,50,1660,12,38,1014.21,1683.00,0.00
2024-12-10 17:36:09,51,1660,12,39,994.32,1683.02,0.00
2024-12-10 17:36:09,50,1660,12,38,1009.50,1683.04,0.00
2024-12-10 17:36:09,50,1661,12,38,1014.13,1684.00,0.00
2024-12-10 17:36:09,51,1661,12,39,994.25,1684.02,0.00
2024-12-10 17:36:09,50,1661,11,39,987.27,1684.92,0.00
2024-12-10 17:36:09,50,1662,11,39,1019.68,1685.00,0.00
2024-12-10 17:36:09,51,1662,11,40,999.68,1685.02,0.00
2024-12-10 17:36:09,50,1662,11,39,1014.63,1685.04,0.00
2024-12-10 17:36:09,49,1662,10,39,1010.91,1685.67,0.00
2024-12-10 17:36:09,49,1663,10,39,1040.07,1686.00,0.00
2024-12-10 17:36:09,50,1663,11,39,1019.27,1686.02,0.00
2024-12-10 17:36:09,50,1664,11,39,1017.69,1687.00,0.00
2024-12-10 17:36:09,51,1664,11,40,997.74,1687.02,0.00
2024-12-10 17:36:09,50,1664,11,39,1011.96,1687.04,0.00
2024-12-10 17:36:09,50,1665,11,39,1016.61,1688.00,0.00
2024-12-10 17:36:09,51,1665,12,39,996.68,1688.02,0.00
2024-12-10 17:36:09,50,1665,11,39,1008.53,1688.10,0.00
2024-12-10 17:36:09,50,1666,11,39,1027.68,1689.00,0.00
2024-12-10 17:36:09,51,1666,12,39,1007.53,1689.02,0.00
2024-12-10 17:36:09,51,1667,12,39,1004.82,1690.00,0.00
2024-12-10 17:36:09,52,1667,12,40,985.49,1690.02,0.00
2024-12-10 17:36:09,51,1667,12,39,1003.16,1690.02,0.00
2024-12-10 17:36:09,51,1668,12,39,1007.07,1691.00,0.00
2024-12-10 17:36:09,52,1668,12,40,987.70,1691.02,0.00
2024-12-10 17:36:09,51,1668,12,39,1002.76,1691.02,0.00
2024-12-10 17:36:09,51,1669,12,39,1006.67,1692.00,0.00
2024-12-10 17:36:09,52,1669,13,39,987.31,1692.02,0.00
2024-12-10 17:36:09,51,1669,12,39,992.98,1692.22,0.00
2024-12-10 17:36:09,51,1670,12,39,1013.41,1693.00,0.00
2024-12-10 17:36:09,52,1670,13,39,993.92,1693.02,0.00
2024-12-10 17:36:09,51,1670,13,38,1009.09,1693.02,0.00
2024-12-10 17:36:09,51,1671,13,38,1013.01,1694.00,0.00
2024-12-10 17:36:09,52,1671,14,38,993.53,1694.02,0.00
2024-12-10 17:36:09,51,1671,13,38,994.88,1694.33,0.00
2024-12-10 17:36:09,51,1672,13,38,1017.26,1695.00,0.00
2024-12-10 17:36:09,52,1672,13,39,997.70,1695.02,0.00
2024-12-10 17:36:09,51,1672,13,38,1013.28,1695.02,0.00
2024-12-10 17:36:09,50,1672,12,38,1023.70,1695.62,0.00
2024-12-10 17:36:09,50,1673,12,38,1037.88,1696.00,0.00
2024-12-10 17:36:09,51,1673,13,38,1017.53,1696.02,0.00
2024-12-10 17:36:09,51,1674,13,38,1014.80,1697.00,0.00
2024-12-10 17:36:09,52,1674,14,38,995.29,1697.02,0.00
2024-12-10 17:36:09,51,1674,14,37,1010.81,1697.02,0.00
2024-12-10 17:36:09,50,1674,13,37,1009.54,1697.96,0.00
2024-12-10 17:36:09,50,1675,13,37,1042.84,1698.00,0.00
2024-12-10 17:36:09,51,1675,14,37,1022.39,1698.02,0.00
2024-12-10 17:36:09,51,1676,14,37,1019.67,1699.00,0.00
2024-12-10 17:36:09,52,1676,15,37,1000.06,1699.02,0.00
2024-12-10 17:36:09,51,1676,15,36,1016.00,1699.02,0.00
2024-12-10 17:36:09,50,1676,14,36,1021.14,1699.78,0.00
2024-12-10 17:36:09,50,1677,14,36,1051.55,1700.00,0.00
2024-12-10 17:36:09,51,1677,14,37,1030.93,1700.02,0.00
2024-12-10 17:36:09,51,1678,14,37,1028.20,1701.00,0.00
2024-12-10 17:36:09,52,1678,14,38,1008.43,1701.02,0.00
2024-12-10 17:36:09,51,1678,14,37,1023.87,1701.02,0.00
2024-12-10 17:36:09,50,1678,13,37,1024.53,1701.54,0.00
2024-12-10 17:36:09,50,1679,13,37,1051.09,1702.00,0.00
2024-12-10 17:36:09,51,1679,13,38,1030.48,1702.02,0.00
2024-12-10 17:36:10,51,1680,13,38,1027.74,1703.00,0.00
2024-12-10 17:36:10,52,1680,13,39,1007.98,1703.02,0.00
2024-12-10 17:36:10,51,1680,13,38,1023.74,1703.02,0.00
2024-12-10 17:36:10,50,1680,12,38,1027.63,1703.82,0.00
2024-12-10 17:36:10,50,1681,12,38,1058.80,1704.00,0.00
2024-12-10 17:36:10,51,1681,13,38,1038.04,1704.02,0.00
2024-12-10 17:36:10,51,1682,13,38,1035.30,1705.00,0.00
2024-12-10 17:36:10,52,1682,13,39,1015.39,1705.02,0.00
2024-12-10 17:36:10,51,1682,13,38,1031.29,1705.02,0.00
2024-12-10 17:36:10,50,1682,12,38,1032.05,1705.54,0.00
2024-12-10 17:36:10,50,1683,12,38,1058.67,1706.00,0.00
2024-12-10 17:36:10,51,1683,12,39,1037.92,1706.02,0.00
2024-12-10 17:36:10,51,1684,12,39,1035.18,1707.00,0.00
2024-12-10 17:36:10,52,1684,13,39,1015.27,1707.02,0.00
2024-12-10 17:36:10,51,1684,13,38,1031.16,1707.02,0.00
2024-12-10 17:36:10,51,1685,13,38,1035.11,1708.00,0.00
2024-12-10 17:36:10,52,1685,13,39,1015.21,1708.02,0.00
2024-12-10 17:36:10,53,1684,14,39,964.53,1708.79,0.00
2024-12-10 17:36:10,54,1683,15,39,948.97,1708.89,0.00
2024-12-10 17:36:10,54,1684,15,39,980.71,1709.00,0.00
2024-12-10 17:36:10,55,1684,16,39,962.88,1709.02,0.00
2024-12-10 17:36:10,54,1684,16,38,977.23,1709.02,0.00
2024-12-10 17:36:10,53,1684,15,38,984.82,1709.64,0.00
2024-12-10 17:36:10,53,1685,15,38,1062.83,1710.00,0.00
2024-12-10 17:36:10,54,1685,15,39,1043.15,1710.02,0.00
2024-12-10 17:36:10,53,1685,14,39,1042.37,1710.68,0.00
2024-12-10 17:36:10,53,1686,14,39,1069.43,1711.00,0.00
2024-12-10 17:36:10,54,1686,14,40,1049.63,1711.02,0.00
2024-12-10 17:36:10,53,1686,14,39,1065.88,1711.02,0.00
2024-12-10 17:36:10,53,1687,14,39,1066.95,1712.00,0.00
2024-12-10 17:36:10,54,1687,14,40,1047.20,1712.02,0.00
2024-12-10 17:36:10,54,1688,14,40,1042.09,1713.00,0.00
2024-12-10 17:36:10,55,1688,15,40,1023.14,1713.02,0.00
2024-12-10 17:36:10,54,1688,15,39,1038.60,1713.02,0.00
2024-12-10 17:36:10,54,1689,15,39,1041.43,1714.00,0.00
2024-12-10 17:36:10,55,1689,16,39,1022.49,1714.02,0.00
2024-12-10 17:36:10,54,1689,15,39,1015.16,1714.26,0.00
2024-12-10 17:36:10,54,1690,15,39,1022.03,1715.00,0.00
2024-12-10 17:36:10,55,1690,16,39,1003.44,1715.02,0.00
2024-12-10 17:36:10,54,1690,16,38,1018.85,1715.02,0.00
2024-12-10 17:36:10,55,1689,17,38,986.46,1715.89,0.00
2024-12-10 17:36:10,55,1690,17,38,1005.28,1716.00,0.00
2024-12-10 17:36:10,56,1690,17,39,987.32,1716.02,0.00
2024-12-10 17:36:10,55,1690,16,39,994.15,1716.20,0.00
2024-12-10 17:36:10,55,1691,16,39,1043.37,1717.00,0.00
2024-12-10 17:36:10,56,1691,17,39,1024.74,1717.02,0.00
2024-12-10 17:36:10,55,1691,17,38,1040.56,1717.02,0.00
2024-12-10 17:36:10,55,1692,17,38,1042.70,1718.00,0.00
2024-12-10 17:36:10,56,1692,17,39,1024.08,1718.02,0.00
2024-12-10 17:36:10,56,1693,17,39,1020.07,1719.00,0.00
2024-12-10 17:36:10,57,1693,17,40,1002.18,1719.02,0.00
2024-12-10 17:36:10,56,1693,17,39,1017.62,1719.02,0.00
2024-12-10 17:36:10,56,1694,17,39,1019.74,1720.00,0.00
2024-12-10 17:36:10,57,1694,17,40,1001.85,1720.02,0.00
2024-12-10 17:36:10,57,1695,17,40,997.67,1721.00,0.00
2024-12-10 17:36:10,58,1695,18,40,980.47,1721.02,0.00
2024-12-10 17:36:10,57,1695,18,39,994.95,1721.02,0.00
2024-12-10 17:36:10,57,1696,18,39,996.74,1722.00,0.00
2024-12-10 17:36:10,58,1696,19,39,979.55,1722.02,0.00
2024-12-10 17:36:10,57,1696,18,39,979.24,1722.65,0.00
2024-12-10 17:36:10,57,1697,18,39,1003.67,1723.00,0.00
2024-12-10 17:36:10,58,1697,19,39,986.36,1723.02,0.00
2024-12-10 17:36:10,57,1697,19,38,1001.25,1723.02,0.00
2024-12-10 17:36:10,57,1698,19,38,1003.04,1724.00,0.00
2024-12-10 17:36:10,58,1698,20,38,985.74,1724.02,0.00
2024-12-10 17:36:10,58,1699,20,38,981.26,1725.00,0.00
2024-12-10 17:36:10,59,1699,20,39,964.63,1725.02,0.00
2024-12-10 17:36:10,58,1699,20,38,979.18,1725.02,0.00
2024-12-10 17:36:10,58,1700,20,38,980.64,1726.00,0.00
2024-12-10 17:36:10,59,1700,20,39,964.02,1726.02,0.00
2024-12-10 17:36:10,58,1700,19,39,961.94,1726.71,0.00
2024-12-10 17:36:10,58,1701,19,39,986.86,1727.00,0.00
2024-12-10 17:36:10,59,1701,20,39,970.14,1727.02,0.00
2024-12-10 17:36:10,58,1701,20,38,984.78,1727.02,0.00
2024-12-10 17:36:10,57,1701,19,38,989.06,1727.11,0.00
2024-12-10 17:36:10,57,1702,19,38,1004.46,1728.00,0.00
2024-12-10 17:36:10,58,1702,20,38,987.14,1728.02,0.00
2024-12-10 17:36:10,57,1702,19,38,988.32,1728.61,0.00
2024-12-10 17:36:10,56,1702,18,38,1005.36,1728.64,0.00
2024-12-10 17:36:10,56,1703,18,38,1017.98,1729.00,0.00
2024-12-10 17:36:10,57,1703,19,38,1000.12,1729.02,0.00
2024-12-10 17:36:10,56,1703,19,37,1016.13,1729.02,0.00
2024-12-10 17:36:10,56,1704,19,37,1018.26,1730.00,0.00
2024-12-10 17:36:10,57,1704,20,37,1000.39,1730.02,0.00
2024-12-10 17:36:10,57,1705,20,37,996.11,1731.00,0.00
2024-12-10 17:36:10,58,1705,21,37,978.94,1731.02,0.00
2024-12-10 17:36:10,57,1705,21,36,994.59,1731.02,0.00
2024-12-10 17:36:10,56,1705,20,36,994.59,1731.86,0.00
2024-12-10 17:36:10,56,1706,20,36,1023.15,1732.00,0.00
2024-12-10 17:36:10,57,1706,20,37,1005.20,1732.02,0.00
2024-12-10 17:36:10,57,1707,20,37,1000.91,1733.00,0.00
2024-12-10 17:36:10,58,1707,21,37,983.66,1733.02,0.00
2024-12-10 17:36:10,57,1707,21,36,999.39,1733.02,0.00
2024-12-10 17:36:10,57,1708,21,36,1001.19,1734.00,0.00
2024-12-10 17:36:10,58,1708,21,37,983.92,1734.02,0.00
2024-12-10 17:36:10,58,1709,21,37,979.41,1735.00,0.00
2024-12-10 17:36:10,59,1709,22,37,962.81,1735.02,0.00
2024-12-10 17:36:11,58,1709,22,36,978.21,1735.02,0.00
2024-12-10 17:36:11,57,1709,21,36,984.14,1735.67,0.00
2024-12-10 17:36:11,57,1710,21,36,996.86,1736.00,0.00
2024-12-10 17:36:11,58,1710,21,37,979.67,1736.02,0.00
2024-12-10 17:36:11,58,1711,21,37,975.14,1737.00,0.00
2024-12-10 17:36:11,59,1711,22,37,958.62,1737.02,0.00
2024-12-10 17:36:11,58,1711,22,36,973.65,1737.02,0.00
2024-12-10 17:36:11,57,1711,21,36,969.93,1737.95,0.00
2024-12-10 17:36:11,57,1712,21,36,999.53,1738.00,0.00
2024-12-10 17:36:11,58,1712,21,37,982.30,1738.02,0.00
2024-12-10 17:36:11,57,1712,21,36,993.01,1738.04,0.00
2024-12-10 17:36:11,57,1713,21,36,995.10,1739.00,0.00
2024-12-10 17:36:11,58,1713,21,37,977.95,1739.02,0.00
2024-12-10 17:36:11,57,1713,21,36,992.66,1739.02,0.00
2024-12-10 17:36:11,56,1713,20,36,990.44,1739.52,0.00
2024-12-10 17:36:11,56,1714,20,36,1013.46,1740.00,0.00
2024-12-10 17:36:11,57,1714,21,36,995.68,1740.02,0.00
2024-12-10 17:36:11,57,1715,21,36,991.36,1741.00,0.00
2024-12-10 17:36:11,58,1715,21,37,974.27,1741.02,0.00
2024-12-10 17:36:11,57,1715,21,36,988.31,1741.02,0.00
2024-12-10 17:36:11,57,1716,21,36,990.10,1742.00,0.00
2024-12-10 17:36:11,58,1716,22,36,973.03,1742.02,0.00
2024-12-10 17:36:11,57,1716,21,36,964.07,1742.58,0.00
2024-12-10 17:36:11,57,1717,21,36,987.61,1743.00,0.00
2024-12-10 17:36:11,58,1717,22,36,970.58,1743.02,0.00
2024-12-10 17:36:11,57,1717,22,35,984.86,1743.02,0.00
2024-12-10 17:36:11,57,1718,22,35,986.65,1744.00,0.00
2024-12-10 17:36:11,58,1718,22,36,969.63,1744.02,0.00
2024-12-10 17:36:11,57,1718,22,35,983.54,1744.02,0.00
2024-12-10 17:36:11,56,1718,21,35,999.71,1744.09,0.00
2024-12-10 17:36:11,56,1719,21,35,1003.06,1745.00,0.00
2024-12-10 17:36:11,57,1719,21,36,985.47,1745.02,0.00
2024-12-10 17:36:11,57,1720,21,36,981.13,1746.00,0.00
2024-12-10 17:36:11,58,1720,21,37,964.21,1746.02,0.00
2024-12-10 17:36:11,57,1720,21,36,978.07,1746.02,0.00
2024-12-10 17:36:11,56,1720,20,36,974.31,1746.61,0.00
2024-12-10 17:36:11,56,1721,20,36,998.91,1747.00,0.00
2024-12-10 17:36:11,57,1721,21,36,981.38,1747.02,0.00
2024-12-10 17:36:11,57,1722,21,36,977.04,1748.00,0.00
2024-12-10 17:36:11,58,1722,21,37,960.19,1748.02,0.00
2024-12-10 17:36:11,57,1722,21,36,974.28,1748.02,0.00
2024-12-10 17:36:11,57,1723,21,36,976.07,1749.00,0.00
2024-12-10 17:36:11,58,1723,21,37,959.24,1749.02,0.00
2024-12-10 17:36:11,57,1723,20,37,967.82,1749.14,0.00
2024-12-10 17:36:11,56,1723,19,37,977.94,1749.20,0.00
2024-12-10 17:36:11,55,1723,18,37,988.03,1749.66,0.00
2024-12-10 17:36:11,55,1724,18,37,1014.05,1750.00,0.00
2024-12-10 17:36:11,56,1724,18,38,995.94,1750.02,0.00
2024-12-10 17:36:11,55,1724,18,37,1011.18,1750.02,0.00
2024-12-10 17:36:11,55,1725,18,37,1013.67,1751.00,0.00
2024-12-10 17:36:11,56,1725,18,38,995.57,1751.02,0.00
2024-12-10 17:36:11,55,1725,17,38,983.10,1751.67,0.00
2024-12-10 17:36:11,55,1726,17,38,1009.47,1752.00,0.00
2024-12-10 17:36:11,56,1726,18,38,991.44,1752.02,0.00
2024-12-10 17:36:11,55,1726,18,37,1006.60,1752.02,0.00
2024-12-10 17:36:11,54,1726,17,37,1019.47,1752.20,0.00
2024-12-10 17:36:11,54,1727,17,37,1038.49,1753.00,0.00
2024-12-10 17:36:11,55,1727,18,37,1019.61,1753.02,0.00
2024-12-10 17:36:11,54,1727,17,37,1018.85,1753.39,0.00
2024-12-10 17:36:11,54,1728,17,37,1041.03,1754.00,0.00
2024-12-10 17:36:11,55,1728,18,37,1022.10,1754.02,0.00
2024-12-10 17:36:11,54,1728,18,36,1038.11,1754.02,0.00
2024-12-10 17:36:11,54,1729,18,36,1040.97,1755.00,0.00
2024-12-10 17:36:11,55,1729,19,36,1022.05,1755.02,0.00
2024-12-10 17:36:11,54,1729,18,36,1021.95,1755.37,0.00
2024-12-10 17:36:11,54,1730,18,36,1043.84,1756.00,0.00
2024-12-10 17:36:11,55,1730,19,36,1024.87,1756.02,0.00
2024-12-10 17:36:11,54,1730,19,35,1041.24,1756.02,0.00
2024-12-10 17:36:11,54,1731,19,35,1044.11,1757.00,0.00
2024-12-10 17:36:11,55,1731,19,36,1025.13,1757.02,0.00
2024-12-10 17:36:11,55,1732,19,36,1021.24,1758.00,0.00
2024-12-10 17:36:11,56,1732,20,36,1003.00,1758.02,0.00
2024-12-10 17:36:11,55,1732,20,35,1019.00,1758.02,0.00
2024-12-10 17:36:11,54,1732,19,35,1017.24,1758.93,0.00
2024-12-10 17:36:11,54,1733,19,35,1048.56,1759.00,0.00
2024-12-10 17:36:11,55,1733,19,36,1029.49,1759.02,0.00
2024-12-10 17:36:11,54,1733,18,36,1030.13,1759.35,0.00
2024-12-10 17:36:11,54,1734,18,36,1051.66,1760.00,0.00
2024-12-10 17:36:11,55,1734,18,37,1032.54,1760.02,0.00
2024-12-10 17:36:11,54,1734,18,36,1049.71,1760.02,0.00
2024-12-10 17:36:11,54,1735,18,36,1052.12,1761.00,0.00
2024-12-10 17:36:11,55,1735,18,37,1032.99,1761.02,0.00
2024-12-10 17:36:11,54,1735,17,37,1031.60,1761.11,0.00
2024-12-10 17:36:11,53,1735,16,37,1042.06,1761.64,0.00
2024-12-10 17:36:11,53,1736,16,37,1068.61,1762.00,0.00
2024-12-10 17:36:11,54,1736,17,37,1048.82,1762.02,0.00
2024-12-10 17:36:11,53,1736,17,36,1066.61,1762.02,0.00
2024-12-10 17:36:11,53,1737,17,36,1069.10,1763.00,0.00
2024-12-10 17:36:11,54,1737,18,36,1049.30,1763.02,0.00
2024-12-10 17:36:11,54,1738,18,36,1044.76,1764.00,0.00
2024-12-10 17:36:11,55,1738,19,36,1025.76,1764.02,0.00
2024-12-10 17:36:11,55,1739,19,36,1020.73,1765.00,0.00
2024-12-10 17:36:11,56,1739,19,37,1002.50,1765.02,0.00
2024-12-10 17:36:11,55,1739,19,36,1018.81,1765.02,0.00
2024-12-10 17:36:11,55,1740,19,36,1019.66,1766.00,0.00
2024-12-10 17:36:11,56,1740,19,37,1001.45,1766.02,0.00
2024-12-10 17:36:11,55,1740,19,36,1017.73,1766.02,0.00
2024-12-10 17:36:11,55,1741,19,36,1018.31,1767.00,0.00
2024-12-10 17:36:11,56,1741,20,36,1000.12,1767.02,0.00
2024-12-10 17:36:11,56,1742,20,36,995.40,1768.00,0.00
2024-12-10 17:36:11,57,1742,20,37,977.94,1768.02,0.00
2024-12-10 17:36:11,56,1742,20,36,992.87,1768.02,0.00
2024-12-10 17:36:12,56,1743,20,36,995.02,1769.00,0.00
2024-12-10 17:36:12,57,1743,20,37,977.56,1769.02,0.00
2024-12-10 17:36:12,57,1744,20,37,975.31,1770.00,0.00
2024-12-10 17:36:12,58,1744,21,37,958.49,1770.02,0.00
2024-12-10 17:36:12,57,1744,21,36,968.80,1770.05,0.00
2024-12-10 17:36:12,56,1744,20,36,977.55,1770.54,0.00
2024-12-10 17:36:12,56,1745,20,36,1001.26,1771.00,0.00
2024-12-10 17:36:12,57,1745,20,37,983.70,1771.02,0.00
2024-12-10 17:36:12,57,1746,20,37,979.84,1772.00,0.00
2024-12-10 17:36:12,58,1746,21,37,962.95,1772.02,0.00
2024-12-10 17:36:12,57,1746,21,36,975.81,1772.05,0.00
2024-12-10 17:36:12,56,1746,20,36,981.60,1772.68,0.00
2024-12-10 17:36:12,56,1747,20,36,1007.78,1773.00,0.00
2024-12-10 17:36:12,57,1747,20,37,990.10,1773.02,0.00
2024-12-10 17:36:12,56,1747,19,37,999.86,1773.02,0.00
2024-12-10 17:36:12,56,1748,19,37,1008.35,1774.00,0.00
2024-12-10 17:36:12,57,1748,20,37,990.66,1774.02,0.00
2024-12-10 17:36:12,56,1748,20,36,1004.87,1774.04,0.00
2024-12-10 17:36:12,55,1748,19,36,1010.89,1774.69,0.00
2024-12-10 17:36:12,55,1749,19,36,1037.91,1775.00,0.00
2024-12-10 17:36:12,56,1749,19,37,1019.37,1775.02,0.00
2024-12-10 17:36:12,56,1750,19,37,1015.21,1776.00,0.00
2024-12-10 17:36:12,57,1750,19,38,997.39,1776.02,0.00
2024-12-10 17:36:12,56,1750,19,37,1011.72,1776.04,0.00
2024-12-10 17:36:12,55,1750,18,37,1021.15,1776.29,0.00
2024-12-10 17:36:12,55,1751,18,37,1041.34,1777.00,0.00
2024-12-10 17:36:12,56,1751,19,37,1022.74,1777.02,0.00
2024-12-10 17:36:12,57,1750,19,38,990.95,1777.49,0.00
2024-12-10 17:36:12,57,1751,19,38,1010.98,1778.00,0.00
2024-12-10 17:36:12,58,1751,19,39,993.55,1778.02,0.00
2024-12-10 17:36:12,57,1751,19,38,1007.87,1778.04,0.00
2024-12-10 17:36:12,57,1752,19,38,1041.20,1779.00,0.00
2024-12-10 17:36:12,58,1752,20,38,1023.25,1779.02,0.00
2024-12-10 17:36:12,57,1752,19,38,1024.45,1779.32,0.00
2024-12-10 17:36:12,57,1753,19,38,1043.97,1780.00,0.00
2024-12-10 17:36:12,58,1753,20,38,1025.97,1780.02,0.00
2024-12-10 17:36:12,57,1753,20,37,1040.85,1780.04,0.00
2024-12-10 17:36:12,57,1754,20,37,1043.00,1781.00,0.00
2024-12-10 17:36:12,58,1754,20,38,1025.01,1781.02,0.00
2024-12-10 17:36:12,58,1755,20,38,1020.51,1782.00,0.00
2024-12-10 17:36:12,59,1755,21,38,1003.21,1782.02,0.00
2024-12-10 17:36:12,58,1755,21,37,1017.44,1782.03,0.00
2024-12-10 17:36:12,57,1755,20,37,1032.68,1782.14,0.00
2024-12-10 17:36:12,57,1756,20,37,1049.17,1783.00,0.00
2024-12-10 17:36:12,58,1756,21,37,1031.08,1783.02,0.00
2024-12-10 17:36:12,57,1756,20,37,1031.65,1783.65,0.00
2024-12-10 17:36:12,56,1756,19,37,1043.21,1783.84,0.00
2024-12-10 17:36:12,56,1757,19,37,1072.33,1784.00,0.00
2024-12-10 17:36:12,57,1757,20,37,1053.52,1784.02,0.00
2024-12-10 17:36:12,56,1757,20,36,1069.46,1784.04,0.00
2024-12-10 17:36:12,56,1758,20,36,1071.97,1785.00,0.00
2024-12-10 17:36:12,57,1758,20,37,1053.17,1785.02,0.00
2024-12-10 17:36:12,56,1758,19,37,1063.71,1785.13,0.00
2024-12-10 17:36:12,55,1758,18,37,1066.37,1785.51,0.00
2024-12-10 17:36:12,55,1759,18,37,1090.45,1786.00,0.00
2024-12-10 17:36:12,56,1759,18,38,1070.98,1786.02,0.00
2024-12-10 17:36:12,55,1759,18,37,1087.86,1786.04,0.00
2024-12-10 17:36:12,55,1760,18,37,1090.74,1787.00,0.00
2024-12-10 17:36:12,56,1760,18,38,1071.26,1787.02,0.00
2024-12-10 17:36:12,56,1761,18,38,1067.07,1788.00,0.00
2024-12-10 17:36:12,57,1761,18,39,1048.35,1788.02,0.00
2024-12-10 17:36:12,56,1761,18,38,1063.88,1788.04,0.00
2024-12-10 17:36:12,55,1761,17,38,1081.63,1788.13,0.00
2024-12-10 17:36:12,54,1761,16,38,1082.64,1788.93,0.00
2024-12-10 17:36:12,54,1762,16,38,1114.50,1789.00,0.00
2024-12-10 17:36:12,55,1762,17,38,1094.24,1789.02,0.00
2024-12-10 17:36:12,56,1761,18,38,1062.37,1789.39,0.00
2024-12-10 17:36:12,55,1761,17,38,1083.39,1789.49,0.00
2024-12-10 17:36:12,55,1762,17,38,1107.21,1790.00,0.00
2024-12-10 17:36:12,56,1762,17,39,1087.44,1790.02,0.00
2024-12-10 17:36:12,55,1762,17,38,1103.96,1790.04,0.00
2024-12-10 17:36:12,55,1763,17,38,1139.42,1791.00,0.00
2024-12-10 17:36:12,56,1763,17,39,1119.07,1791.02,0.00
2024-12-10 17:36:12,56,1764,17,39,1114.90,1792.00,0.00
2024-12-10 17:36:12,57,1764,17,40,1095.34,1792.02,0.00
2024-12-10 17:36:12,56,1764,17,39,1112.02,1792.04,0.00
2024-12-10 17:36:12,55,1764,16,39,1110.66,1792.95,0.00
2024-12-10 17:36:12,55,1765,16,39,1142.32,1793.00,0.00
2024-12-10 17:36:12,56,1765,17,39,1121.92,1793.02,0.00
2024-12-10 17:36:12,55,1765,16,39,1125.81,1793.31,0.00
2024-12-10 17:36:12,55,1766,16,39,1131.91,1794.00,0.00
2024-12-10 17:36:12,56,1766,16,40,1111.70,1794.02,0.00
2024-12-10 17:36:12,55,1766,16,39,1129.30,1794.04,0.00
2024-12-10 17:36:12,54,1766,16,38,1140.36,1794.35,0.00
2024-12-10 17:36:12,54,1767,16,38,1149.15,1795.00,0.00
2024-12-10 17:36:12,55,1767,17,38,1128.26,1795.02,0.00
2024-12-10 17:36:13,55,1768,17,38,1124.31,1796.00,0.00
2024-12-10 17:36:13,56,1768,17,39,1104.24,1796.02,0.00
2024-12-10 17:36:13,55,1768,17,38,1120.72,1796.04,0.00
2024-12-10 17:36:13,55,1769,17,38,1123.39,1797.00,0.00
2024-12-10 17:36:13,56,1769,17,39,1103.33,1797.02,0.00
2024-12-10 17:36:13,55,1769,16,39,1105.10,1797.06,0.00
2024-12-10 17:36:13,55,1770,16,39,1120.86,1798.00,0.00
2024-12-10 17:36:13,56,1770,17,39,1100.84,1798.02,0.00
2024-12-10 17:36:13,55,1770,17,38,1117.59,1798.04,0.00
2024-12-10 17:36:13,55,1771,17,38,1119.82,1799.00,0.00
2024-12-10 17:36:13,56,1771,17,39,1099.82,1799.02,0.00
2024-12-10 17:36:13,55,1771,16,39,1098.82,1799.73,0.00
2024-12-10 17:36:13,55,1772,16,39,1126.86,1800.00,0.00
2024-12-10 17:36:13,56,1772,17,39,1106.74,1800.02,0.00
2024-12-10 17:36:13,55,1772,17,38,1126.53,1800.02,0.00
2024-12-10 17:36:13,54,1772,17,37,1143.06,1800.02,0.00
2024-12-10 17:36:13,53,1772,16,37,1138.94,1800.66,0.00
2024-12-10 17:36:13,53,1773,16,37,1167.08,1801.00,0.00
2024-12-10 17:36:13,54,1773,17,37,1145.46,1801.02,0.00
2024-12-10 17:36:13,54,1774,17,37,1140.58,1802.00,0.00
2024-12-10 17:36:13,55,1774,18,37,1119.84,1802.02,0.00
2024-12-10 17:36:13,54,1774,18,36,1136.24,1802.02,0.00
2024-12-10 17:36:13,53,1774,17,36,1155.01,1802.11,0.00
2024-12-10 17:36:13,53,1775,17,36,1160.04,1803.00,0.00
2024-12-10 17:36:13,54,1775,18,36,1138.56,1803.02,0.00
2024-12-10 17:36:13,54,1776,18,36,1134.85,1804.00,0.00
2024-12-10 17:36:13,55,1776,19,36,1114.22,1804.02,0.00
2024-12-10 17:36:13,54,1776,19,35,1130.51,1804.02,0.00
2024-12-10 17:36:13,54,1777,19,35,1133.47,1805.00,0.00
2024-12-10 17:36:13,55,1777,20,35,1112.86,1805.02,0.00
2024-12-10 17:36:13,54,1777,19,35,1122.44,1805.02,0.00
2024-12-10 17:36:13,54,1778,19,35,1132.09,1806.00,0.00
2024-12-10 17:36:13,55,1778,20,35,1111.51,1806.02,0.00
2024-12-10 17:36:13,54,1778,20,34,1127.75,1806.02,0.00
2024-12-10 17:36:13,54,1779,20,34,1130.71,1807.00,0.00
2024-12-10 17:36:13,55,1779,21,34,1110.15,1807.02,0.00
2024-12-10 17:36:13,55,1780,21,34,1106.17,1808.00,0.00
2024-12-10 17:36:13,56,1780,22,34,1086.41,1808.02,0.00
2024-12-10 17:36:13,55,1780,22,33,1101.24,1808.04,0.00
2024-12-10 17:36:13,55,1781,22,33,1104.15,1809.00,0.00
2024-12-10 17:36:13,56,1781,22,34,1084.43,1809.02,0.00
2024-12-10 17:36:13,56,1782,22,34,1088.30,1810.00,0.00
2024-12-10 17:36:13,57,1782,22,35,1069.21,1810.02,0.00
2024-12-10 17:36:13,57,1783,22,35,1068.43,1811.00,0.00
2024-12-10 17:36:13,58,1783,23,35,1050.00,1811.02,0.00
2024-12-10 17:36:13,57,1783,22,35,1042.63,1811.91,0.00
2024-12-10 17:36:13,57,1784,22,35,1072.89,1812.00,0.00
2024-12-10 17:36:13,58,1784,22,36,1054.40,1812.02,0.00
2024-12-10 17:36:13,57,1784,22,35,1070.67,1812.04,0.00
2024-12-10 17:36:13,57,1785,22,35,1072.85,1813.00,0.00
2024-12-10 17:36:13,58,1785,23,35,1054.35,1813.02,0.00
2024-12-10 17:36:13,57,1785,22,35,1054.43,1813.68,0.00
2024-12-10 17:36:13,57,1786,22,35,1080.76,1814.00,0.00
2024-12-10 17:36:13,58,1786,22,36,1062.13,1814.02,0.00
2024-12-10 17:36:13,58,1787,22,36,1057.39,1815.00,0.00
2024-12-10 17:36:13,59,1787,22,37,1039.47,1815.02,0.00
2024-12-10 17:36:13,58,1787,22,36,1055.83,1815.02,0.00
2024-12-10 17:36:13,57,1787,21,36,1072.79,1815.11,0.00
2024-12-10 17:36:13,57,1788,21,36,1076.22,1816.00,0.00
2024-12-10 17:36:13,58,1788,22,36,1057.66,1816.02,0.00
2024-12-10 17:36:13,57,1788,22,35,1073.03,1816.02,0.00
2024-12-10 17:36:13,56,1788,21,35,1069.74,1816.96,0.00
2024-12-10 17:36:13,56,1789,21,35,1101.56,1817.00,0.00
2024-12-10 17:36:13,57,1789,21,36,1082.23,1817.02,0.00
2024-12-10 17:36:13,57,1790,21,36,1077.72,1818.00,0.00
2024-12-10 17:36:13,58,1790,22,36,1059.14,1818.02,0.00
2024-12-10 17:36:13,57,1790,22,35,1074.85,1818.02,0.00
2024-12-10 17:36:13,57,1791,22,35,1076.72,1819.00,0.00
2024-12-10 17:36:13,58,1791,22,36,1058.16,1819.02,0.00
2024-12-10 17:36:13,58,1792,22,36,1061.75,1820.00,0.00
2024-12-10 17:36:13,59,1792,22,37,1043.75,1820.02,0.00
2024-12-10 17:36:13,59,1793,22,37,1043.21,1821.00,0.00
2024-12-10 17:36:13,60,1793,23,37,1025.82,1821.02,0.00
2024-12-10 17:36:13,60,1794,23,37,1020.61,1822.00,0.00
2024-12-10 17:36:13,61,1794,23,38,1003.88,1822.02,0.00
2024-12-10 17:36:13,60,1794,23,37,1018.18,1822.02,0.00
2024-12-10 17:36:13,59,1794,22,37,1022.82,1822.71,0.00
2024-12-10 17:36:13,58,1794,21,37,1038.91,1822.74,0.00
2024-12-10 17:36:13,58,1795,21,37,1065.83,1823.00,0.00
2024-12-10 17:36:13,59,1795,21,38,1047.76,1823.02,0.00
2024-12-10 17:36:13,59,1796,21,38,1042.77,1824.00,0.00
2024-12-10 17:36:13,60,1796,22,38,1025.39,1824.02,0.00
2024-12-10 17:36:13,59,1796,22,37,1040.92,1824.02,0.00
2024-12-10 17:36:13,58,1796,21,37,1048.91,1824.33,0.00
2024-12-10 17:36:13,58,1797,21,37,1068.57,1825.00,0.00
2024-12-10 17:36:13,59,1797,21,38,1050.46,1825.02,0.00
2024-12-10 17:36:13,58,1797,20,38,1060.42,1825.12,0.00
2024-12-10 17:36:13,58,1798,20,38,1063.80,1826.00,0.00
2024-12-10 17:36:13,59,1798,20,39,1045.77,1826.02,0.00
2024-12-10 17:36:13,58,1798,20,38,1062.23,1826.02,0.00
2024-12-10 17:36:13,58,1799,20,38,1063.75,1827.00,0.00
2024-12-10 17:36:13,59,1799,20,39,1045.72,1827.02,0.00
2024-12-10 17:36:13,58,1799,19,39,1035.01,1827.97,0.00
2024-12-10 17:36:13,58,1800,19,39,1065.91,1828.00,0.00
2024-12-10 17:36:13,59,1800,20,39,1047.85,1828.02,0.00
2024-12-10 17:36:13,58,1800,20,38,1062.76,1828.02,0.00
2024-12-10 17:36:13,57,1800,19,38,1079.52,1828.12,0.00
2024-12-10 17:36:13,57,1801,19,38,1096.12,1829.00,0.00
2024-12-10 17:36:13,58,1801,20,38,1077.22,1829.02,0.00
2024-12-10 17:36:14,58,1802,20,38,1072.44,1830.00,0.00
2024-12-10 17:36:14,59,1802,21,38,1054.27,1830.02,0.00
2024-12-10 17:36:14,58,1802,21,37,1069.29,1830.02,0.00
2024-12-10 17:36:14,57,1802,20,37,1085.52,1830.14,0.00
2024-12-10 17:36:14,57,1803,20,37,1089.61,1831.00,0.00
2024-12-10 17:36:14,58,1803,21,37,1070.82,1831.02,0.00
2024-12-10 17:36:14,58,1804,21,37,1065.94,1832.00,0.00
2024-12-10 17:36:14,59,1804,22,37,1047.87,1832.02,0.00
2024-12-10 17:36:14,58,1804,22,36,1063.10,1832.02,0.00
2024-12-10 17:36:14,58,1805,22,36,1064.62,1833.00,0.00
2024-12-10 17:36:14,59,1805,22,37,1046.58,1833.02,0.00
2024-12-10 17:36:14,58,1805,21,37,1043.49,1833.14,0.00
2024-12-10 17:36:14,58,1806,21,37,1059.83,1834.00,0.00
2024-12-10 17:36:14,59,1806,21,38,1041.87,1834.02,0.00
2024-12-10 17:36:14,58,1806,21,37,1057.30,1834.02,0.00
2024-12-10 17:36:14,57,1806,20,37,1066.52,1834.02,0.00
2024-12-10 17:36:14,57,1807,20,37,1081.26,1835.00,0.00
2024-12-10 17:36:14,58,1807,21,37,1062.62,1835.02,0.00
2024-12-10 17:36:14,58,1808,21,37,1057.82,1836.00,0.00
2024-12-10 17:36:14,59,1808,21,38,1039.89,1836.02,0.00
2024-12-10 17:36:14,58,1808,21,37,1054.03,1836.03,0.00
2024-12-10 17:36:14,57,1808,20,37,1060.61,1836.68,0.00
2024-12-10 17:36:14,56,1808,19,37,1070.23,1836.93,0.00
2024-12-10 17:36:14,56,1809,19,37,1101.77,1837.00,0.00
2024-12-10 17:36:14,57,1809,19,38,1082.44,1837.02,0.00
2024-12-10 17:36:14,57,1810,19,38,1077.87,1838.00,0.00
2024-12-10 17:36:14,58,1810,20,38,1059.29,1838.02,0.00
2024-12-10 17:36:14,57,1810,20,37,1074.01,1838.04,0.00
2024-12-10 17:36:14,57,1811,20,37,1076.20,1839.00,0.00
2024-12-10 17:36:14,58,1811,21,37,1057.65,1839.02,0.00
2024-12-10 17:36:14,57,1811,20,37,1048.72,1839.60,0.00
2024-12-10 17:36:14,57,1812,20,37,1073.88,1840.00,0.00
2024-12-10 17:36:14,58,1812,21,37,1055.37,1840.02,0.00
2024-12-10 17:36:14,57,1812,21,36,1070.33,1840.04,0.00
2024-12-10 17:36:14,57,1813,21,36,1072.53,1841.00,0.00
2024-12-10 17:36:14,58,1813,22,36,1054.03,1841.02,0.00
2024-12-10 17:36:14,57,1813,21,36,1045.26,1841.91,0.00
2024-12-10 17:36:14,57,1814,21,36,1076.02,1842.00,0.00
2024-12-10 17:36:14,58,1814,22,36,1057.47,1842.02,0.00
2024-12-10 17:36:14,57,1814,22,35,1071.50,1842.05,0.00
2024-12-10 17:36:14,57,1815,22,35,1074.02,1843.00,0.00
2024-12-10 17:36:14,58,1815,23,35,1055.50,1843.02,0.00
2024-12-10 17:36:14,57,1815,22,35,1053.81,1843.44,0.00
2024-12-10 17:36:14,57,1816,22,35,1076.22,1844.00,0.00
2024-12-10 17:36:14,58,1816,22,36,1057.66,1844.02,0.00
2024-12-10 17:36:14,57,1816,22,35,1071.69,1844.05,0.00
2024-12-10 17:36:14,56,1816,21,35,1077.68,1844.11,0.00
2024-12-10 17:36:14,56,1817,21,35,1094.71,1845.00,0.00
2024-12-10 17:36:14,57,1817,22,35,1075.50,1845.02,0.00
2024-12-10 17:36:14,57,1818,22,35,1070.91,1846.00,0.00
2024-12-10 17:36:14,58,1818,22,36,1052.44,1846.02,0.00
2024-12-10 17:36:14,57,1818,22,35,1066.70,1846.05,0.00
2024-12-10 17:36:14,57,1819,22,35,1069.22,1847.00,0.00
2024-12-10 17:36:14,58,1819,22,36,1050.78,1847.02,0.00
2024-12-10 17:36:14,58,1820,22,36,1045.94,1848.00,0.00
2024-12-10 17:36:14,59,1820,22,37,1028.21,1848.02,0.00
2024-12-10 17:36:14,58,1820,22,36,1042.12,1848.05,0.00
2024-12-10 17:36:14,58,1821,22,36,1044.27,1849.00,0.00
2024-12-10 17:36:14,59,1821,22,37,1026.57,1849.02,0.00
2024-12-10 17:36:14,58,1821,21,37,1034.75,1849.17,0.00
2024-12-10 17:36:14,57,1821,20,37,1030.81,1849.68,0.00
2024-12-10 17:36:14,57,1822,20,37,1057.65,1850.00,0.00
2024-12-10 17:36:14,58,1822,20,38,1039.41,1850.02,0.00
2024-12-10 17:36:14,57,1822,20,37,1054.08,1850.05,0.00
2024-12-10 17:36:14,56,1822,19,37,1061.02,1850.07,0.00
2024-12-10 17:36:14,56,1823,19,37,1077.45,1851.00,0.00
2024-12-10 17:36:14,57,1823,19,38,1058.54,1851.02,0.00
2024-12-10 17:36:14,56,1823,18,38,1050.91,1851.55,0.00
2024-12-10 17:36:14,56,1824,18,38,1076.04,1852.00,0.00
2024-12-10 17:36:14,57,1824,18,39,1057.17,1852.02,0.00
2024-12-10 17:36:14,56,1824,18,38,1072.08,1852.05,0.00
2024-12-10 17:36:14,56,1825,18,38,1074.97,1853.00,0.00
2024-12-10 17:36:14,57,1825,18,39,1056.11,1853.02,0.00
2024-12-10 17:36:14,57,1826,18,39,1051.55,1854.00,0.00
2024-12-10 17:36:14,58,1826,18,40,1033.42,1854.02,0.00
2024-12-10 17:36:14,57,1826,18,39,1047.01,1854.05,0.00
2024-12-10 17:36:14,56,1826,17,39,1029.44,1854.79,0.00
2024-12-10 17:36:14,56,1827,17,39,1058.76,1855.00,0.00
2024-12-10 17:36:14,57,1827,17,40,1040.19,1855.02,0.00
2024-12-10 17:36:14,56,1827,17,39,1019.06,1855.68,0.00
2024-12-10 17:36:14,56,1828,17,39,1046.47,1856.00,0.00
2024-12-10 17:36:14,57,1828,17,40,1028.11,1856.02,0.00
2024-12-10 17:36:14,56,1828,17,39,1042.17,1856.05,0.00
2024-12-10 17:36:14,55,1828,16,39,1037.11,1856.64,0.00
2024-12-10 17:36:14,55,1829,16,39,1064.39,1857.00,0.00
2024-12-10 17:36:14,56,1829,17,39,1045.38,1857.02,0.00
2024-12-10 17:36:14,56,1830,17,39,1041.76,1858.00,0.00
2024-12-10 17:36:14,57,1830,18,39,1023.48,1858.02,0.00
2024-12-10 17:36:14,56,1830,18,38,1037.78,1858.05,0.00
2024-12-10 17:36:14,55,1830,17,38,1054.86,1858.15,0.00
2024-12-10 17:36:14,55,1831,17,38,1059.79,1859.00,0.00
2024-12-10 17:36:14,56,1831,18,38,1040.87,1859.02,0.00
2024-12-10 17:36:14,56,1832,18,38,1037.10,1860.00,0.00
2024-12-10 17:36:14,57,1832,19,38,1018.90,1860.02,0.00
2024-12-10 17:36:14,56,1832,19,37,1033.45,1860.05,0.00
2024-12-10 17:36:14,55,1832,18,37,1040.71,1860.67,0.00
2024-12-10 17:36:14,55,1833,18,37,1055.17,1861.00,0.00
2024-12-10 17:36:14,56,1833,18,38,1036.33,1861.02,0.00
2024-12-10 17:36:14,55,1833,17,38,1045.07,1861.20,0.00
2024-12-10 17:36:14,55,1834,17,38,1051.45,1862.00,0.00
2024-12-10 17:36:14,56,1834,17,39,1032.67,1862.02,0.00
2024-12-10 17:36:14,55,1834,17,38,1047.73,1862.06,0.00
2024-12-10 17:36:15,55,1835,17,38,1051.00,1863.00,0.00
2024-12-10 17:36:15,56,1835,17,39,1032.23,1863.02,0.00
2024-12-10 17:36:15,55,1835,16,39,1032.53,1863.64,0.00
2024-12-10 17:36:15,55,1836,16,39,1059.92,1864.00,0.00
2024-12-10 17:36:15,56,1836,17,39,1040.99,1864.02,0.00
2024-12-10 17:36:15,55,1836,17,38,1056.53,1864.06,0.00
2024-12-10 17:36:15,54,1836,16,38,1064.32,1864.67,0.00
2024-12-10 17:36:15,54,1837,16,38,1092.91,1865.00,0.00
2024-12-10 17:36:15,55,1837,17,38,1073.04,1865.02,0.00
2024-12-10 17:36:15,54,1837,17,37,1092.56,1865.02,0.00
2024-12-10 17:36:15,54,1838,17,37,1088.65,1866.00,0.00
2024-12-10 17:36:15,55,1838,18,37,1068.86,1866.02,0.00
2024-12-10 17:36:15,54,1838,18,36,1085.89,1866.04,0.00
2024-12-10 17:36:15,53,1838,17,36,1103.95,1866.15,0.00
2024-12-10 17:36:15,53,1839,17,36,1109.79,1867.00,0.00
2024-12-10 17:36:15,54,1839,18,36,1089.24,1867.02,0.00
2024-12-10 17:36:15,53,1839,17,36,1085.87,1867.15,0.00
2024-12-10 17:36:15,53,1840,17,36,1105.80,1868.00,0.00
2024-12-10 17:36:15,54,1840,17,37,1085.32,1868.02,0.00
2024-12-10 17:36:15,53,1840,17,36,1102.98,1868.04,0.00
2024-12-10 17:36:15,54,1839,17,37,1075.13,1868.48,0.00
2024-12-10 17:36:15,54,1840,17,37,1098.37,1869.00,0.00
2024-12-10 17:36:15,55,1840,17,38,1078.39,1869.02,0.00
2024-12-10 17:36:15,55,1841,17,38,1108.21,1870.00,0.00
2024-12-10 17:36:15,56,1841,17,39,1088.42,1870.02,0.00
2024-12-10 17:36:15,55,1841,17,38,1105.49,1870.04,0.00
2024-12-10 17:36:15,55,1842,17,38,1108.46,1871.00,0.00
2024-12-10 17:36:15,56,1842,18,38,1088.67,1871.02,0.00
2024-12-10 17:36:15,55,1842,18,37,1108.12,1871.02,0.00
2024-12-10 17:36:15,55,1843,18,37,1103.95,1872.00,0.00
2024-12-10 17:36:15,56,1843,18,38,1084.24,1872.02,0.00
2024-12-10 17:36:15,55,1843,18,37,1101.91,1872.02,0.00
2024-12-10 17:36:15,55,1844,18,37,1104.54,1873.00,0.00
2024-12-10 17:36:15,56,1844,18,38,1084.82,1873.02,0.00
2024-12-10 17:36:15,56,1845,18,38,1080.38,1874.00,0.00
2024-12-10 17:36:15,57,1845,18,39,1061.42,1874.02,0.00
2024-12-10 17:36:15,56,1845,18,38,1078.04,1874.04,0.00
2024-12-10 17:36:15,55,1845,17,38,1078.65,1874.82,0.00
2024-12-10 17:36:15,55,1846,17,38,1109.47,1875.00,0.00
2024-12-10 17:36:15,56,1846,17,39,1089.66,1875.02,0.00
2024-12-10 17:36:15,55,1846,16,39,1089.52,1875.33,0.00
2024-12-10 17:36:15,55,1847,16,39,1111.48,1876.00,0.00
2024-12-10 17:36:15,56,1847,17,39,1091.63,1876.02,0.00
2024-12-10 17:36:15,55,1847,16,39,1096.98,1876.18,0.00
2024-12-10 17:36:15,55,1848,16,39,1116.29,1877.00,0.00
2024-12-10 17:36:15,56,1848,17,39,1096.36,1877.02,0.00
2024-12-10 17:36:15,55,1848,17,38,1111.20,1877.13,0.00
2024-12-10 17:36:15,54,1848,17,37,1125.18,1877.13,0.00
2024-12-10 17:36:15,54,1849,17,37,1130.27,1878.00,0.00
2024-12-10 17:36:15,55,1849,18,37,1109.72,1878.02,0.00
2024-12-10 17:36:15,55,1850,18,37,1107.37,1879.00,0.00
2024-12-10 17:36:15,56,1850,19,37,1087.59,1879.02,0.00
2024-12-10 17:36:15,55,1850,19,36,1098.85,1879.13,0.00
2024-12-10 17:36:15,54,1850,18,36,1095.94,1879.96,0.00
2024-12-10 17:36:15,54,1851,18,36,1130.08,1880.00,0.00
2024-12-10 17:36:15,55,1851,18,37,1109.53,1880.02,0.00
2024-12-10 17:36:15,54,1851,17,37,1123.46,1880.02,0.00
2024-12-10 17:36:15,53,1851,16,37,1125.48,1880.66,0.00
2024-12-10 17:36:15,53,1852,16,37,1154.85,1881.00,0.00
2024-12-10 17:36:15,54,1852,17,37,1133.47,1881.02,0.00
2024-12-10 17:36:15,53,1852,17,36,1146.36,1881.11,0.00
2024-12-10 17:36:15,53,1853,17,36,1151.56,1882.00,0.00
2024-12-10 17:36:15,54,1853,18,36,1130.24,1882.02,0.00
2024-12-10 17:36:15,54,1854,18,36,1127.76,1883.00,0.00
2024-12-10 17:36:15,55,1854,18,37,1107.26,1883.02,0.00
2024-12-10 17:36:15,54,1854,18,36,1119.76,1883.11,0.00
2024-12-10 17:36:15,54,1855,18,36,1124.52,1884.00,0.00
2024-12-10 17:36:15,55,1855,19,36,1104.08,1884.02,0.00
2024-12-10 17:36:15,54,1855,18,36,1105.09,1884.32,0.00
2024-12-10 17:36:15,54,1856,18,36,1127.56,1885.00,0.00
2024-12-10 17:36:15,55,1856,19,36,1107.06,1885.02,0.00
2024-12-10 17:36:15,54,1856,19,35,1119.55,1885.11,0.00
2024-12-10 17:36:15,54,1857,19,35,1124.32,1886.00,0.00
2024-12-10 17:36:15,55,1857,20,35,1103.88,1886.02,0.00
2024-12-10 17:36:15,54,1857,19,35,1095.58,1886.56,0.00
2024-12-10 17:36:15,54,1858,19,35,1122.47,1887.00,0.00
2024-12-10 17:36:15,55,1858,19,36,1102.06,1887.02,0.00
2024-12-10 17:36:15,54,1858,19,35,1120.04,1887.07,0.00
2024-12-10 17:36:15,53,1858,18,35,1133.06,1887.26,0.00
2024-12-10 17:36:15,53,1859,18,35,1155.30,1888.00,0.00
2024-12-10 17:36:15,54,1859,18,36,1133.90,1888.02,0.00
2024-12-10 17:36:15,53,1859,18,35,1148.19,1888.09,0.00
2024-12-10 17:36:15,53,1860,18,35,1153.06,1889.00,0.00
2024-12-10 17:36:15,54,1860,18,36,1131.71,1889.02,0.00
2024-12-10 17:36:15,54,1861,18,36,1128.58,1890.00,0.00
2024-12-10 17:36:15,55,1861,18,37,1108.06,1890.02,0.00
2024-12-10 17:36:15,54,1861,18,36,1121.59,1890.09,0.00
2024-12-10 17:36:15,54,1862,18,36,1126.03,1891.00,0.00
2024-12-10 17:36:15,55,1862,19,36,1105.55,1891.02,0.00
2024-12-10 17:36:15,55,1863,19,36,1102.51,1892.00,0.00
2024-12-10 17:36:15,56,1863,20,36,1082.82,1892.02,0.00
2024-12-10 17:36:15,55,1863,20,35,1095.98,1892.09,0.00
2024-12-10 17:36:15,54,1863,19,35,1107.82,1892.54,0.00
2024-12-10 17:36:15,53,1863,18,35,1128.66,1892.55,0.00
2024-12-10 17:36:15,54,1862,19,35,1106.07,1892.67,0.00
2024-12-10 17:36:15,54,1863,19,35,1127.73,1893.00,0.00
2024-12-10 17:36:15,55,1863,20,35,1107.22,1893.02,0.00
2024-12-10 17:36:15,54,1863,19,35,1081.20,1893.87,0.00
2024-12-10 17:36:15,54,1864,19,35,1148.98,1894.00,0.00
2024-12-10 17:36:15,55,1864,19,36,1128.09,1894.02,0.00
2024-12-10 17:36:15,54,1864,19,35,1142.68,1894.09,0.00
2024-12-10 17:36:15,53,1864,19,34,1148.43,1894.55,0.00
2024-12-10 17:36:16,53,1865,19,34,1161.66,1895.00,0.00
2024-12-10 17:36:16,54,1865,19,35,1140.15,1895.02,0.00
2024-12-10 17:36:16,53,1865,18,35,1134.35,1895.51,0.00
2024-12-10 17:36:16,53,1866,18,35,1161.20,1896.00,0.00
2024-12-10 17:36:16,54,1866,19,35,1139.70,1896.02,0.00
2024-12-10 17:36:16,53,1866,19,34,1151.57,1896.13,0.00
2024-12-10 17:36:16,53,1867,19,34,1157.16,1897.00,0.00
2024-12-10 17:36:16,54,1867,20,34,1135.73,1897.02,0.00
2024-12-10 17:36:16,54,1868,20,34,1134.03,1898.00,0.00
2024-12-10 17:36:16,55,1868,20,35,1113.41,1898.02,0.00
2024-12-10 17:36:16,54,1868,20,34,1124.92,1898.13,0.00
2024-12-10 17:36:16,54,1869,20,34,1130.06,1899.00,0.00
2024-12-10 17:36:16,55,1869,21,34,1109.51,1899.02,0.00
2024-12-10 17:36:16,55,1870,21,34,1109.17,1900.00,0.00
2024-12-10 17:36:16,56,1870,22,34,1089.36,1900.02,0.00
2024-12-10 17:36:16,56,1871,22,34,1084.84,1901.00,0.00
2024-12-10 17:36:16,57,1871,22,35,1065.81,1901.02,0.00
2024-12-10 17:36:16,56,1871,22,34,1081.13,1901.14,0.00
2024-12-10 17:36:16,56,1872,22,34,1085.75,1902.00,0.00
2024-12-10 17:36:16,57,1872,22,35,1066.70,1902.02,0.00
2024-12-10 17:36:16,57,1873,22,35,1066.01,1903.00,0.00
2024-12-10 17:36:16,58,1873,23,35,1047.63,1903.02,0.00
2024-12-10 17:36:16,57,1873,22,35,1065.68,1903.02,0.00
2024-12-10 17:36:16,56,1873,21,35,1052.72,1903.64,0.00
2024-12-10 17:36:16,56,1874,21,35,1080.18,1904.00,0.00
2024-12-10 17:36:16,57,1874,22,35,1061.23,1904.02,0.00
2024-12-10 17:36:16,56,1874,22,34,1077.14,1904.13,0.00
2024-12-10 17:36:16,55,1874,21,34,1084.10,1904.62,0.00
2024-12-10 17:36:16,55,1875,21,34,1111.74,1905.00,0.00
2024-12-10 17:36:16,56,1875,21,35,1091.89,1905.02,0.00
2024-12-10 17:36:16,55,1875,20,35,1101.70,1905.07,0.00
2024-12-10 17:36:16,54,1875,19,35,1121.60,1905.09,0.00
2024-12-10 17:36:16,54,1876,19,35,1133.11,1906.00,0.00
2024-12-10 17:36:16,55,1876,20,35,1112.51,1906.02,0.00
2024-12-10 17:36:16,54,1876,19,35,1132.05,1906.02,0.00
2024-12-10 17:36:16,54,1877,19,35,1142.18,1907.00,0.00
2024-12-10 17:36:16,55,1877,19,36,1121.42,1907.02,0.00
2024-12-10 17:36:16,54,1877,19,35,1140.78,1907.07,0.00
2024-12-10 17:36:16,54,1878,19,35,1144.90,1908.00,0.00
2024-12-10 17:36:16,55,1878,19,36,1124.09,1908.02,0.00
2024-12-10 17:36:16,55,1879,19,36,1122.09,1909.00,0.00
2024-12-10 17:36:16,56,1879,19,37,1102.06,1909.02,0.00
2024-12-10 17:36:16,55,1879,19,36,1121.75,1909.02,0.00
2024-12-10 17:36:16,54,1879,19,35,1134.75,1909.06,0.00
2024-12-10 17:36:16,53,1879,18,35,1130.59,1909.96,0.00
2024-12-10 17:36:16,53,1880,18,35,1165.92,1910.00,0.00
2024-12-10 17:36:16,54,1880,18,36,1144.33,1910.02,0.00
2024-12-10 17:36:16,54,1881,18,36,1142.10,1911.00,0.00
2024-12-10 17:36:16,55,1881,19,36,1121.33,1911.02,0.00
2024-12-10 17:36:16,54,1881,19,35,1134.68,1911.06,0.00
2024-12-10 17:36:16,53,1881,18,35,1136.34,1911.83,0.00
2024-12-10 17:36:16,53,1882,18,35,1169.31,1912.00,0.00
2024-12-10 17:36:16,54,1882,19,35,1147.66,1912.02,0.00
2024-12-10 17:36:16,53,1882,19,34,1168.95,1912.02,0.00
2024-12-10 17:36:16,52,1882,18,34,1178.99,1912.17,0.00
2024-12-10 17:36:16,52,1883,18,34,1200.51,1913.00,0.00
2024-12-10 17:36:16,53,1883,18,35,1177.86,1913.02,0.00
2024-12-10 17:36:16,52,1883,18,34,1193.53,1913.04,0.00
2024-12-10 17:36:16,52,1884,18,34,1197.83,1914.00,0.00
2024-12-10 17:36:16,53,1884,19,34,1175.23,1914.02,0.00
2024-12-10 17:36:16,53,1885,19,34,1172.04,1915.00,0.00
2024-12-10 17:36:16,54,1885,20,34,1150.33,1915.02,0.00
2024-12-10 17:36:16,53,1885,20,33,1165.54,1915.04,0.00
2024-12-10 17:36:16,53,1886,20,33,1169.40,1916.00,0.00
2024-12-10 17:36:16,54,1886,21,33,1147.74,1916.02,0.00
2024-12-10 17:36:16,53,1886,20,33,1151.78,1916.26,0.00
2024-12-10 17:36:16,53,1887,20,33,1174.35,1917.00,0.00
2024-12-10 17:36:16,54,1887,20,34,1152.60,1917.02,0.00
2024-12-10 17:36:16,53,1887,20,33,1168.21,1917.04,0.00
2024-12-10 17:36:16,53,1888,20,33,1172.07,1918.00,0.00
2024-12-10 17:36:16,54,1888,20,34,1150.36,1918.02,0.00
2024-12-10 17:36:16,53,1888,19,34,1141.24,1918.59,0.00
2024-12-10 17:36:16,53,1889,19,34,1169.78,1919.00,0.00
2024-12-10 17:36:16,54,1889,20,34,1148.12,1919.02,0.00
2024-12-10 17:36:16,53,1889,20,33,1164.00,1919.04,0.00
2024-12-10 17:36:16,52,1889,19,33,1171.46,1919.64,0.00
2024-12-10 17:36:16,52,1890,19,33,1201.64,1920.00,0.00
2024-12-10 17:36:16,53,1890,20,33,1178.97,1920.02,0.00
2024-12-10 17:36:16,52,1890,19,33,1192.45,1920.10,0.00
2024-12-10 17:36:16,52,1891,19,33,1197.85,1921.00,0.00
2024-12-10 17:36:16,53,1891,20,33,1175.24,1921.02,0.00
2024-12-10 17:36:16,52,1891,20,32,1192.31,1921.04,0.00
2024-12-10 17:36:16,52,1892,20,32,1196.62,1922.00,0.00
2024-12-10 17:36:16,53,1892,20,33,1174.04,1922.02,0.00
2024-12-10 17:36:16,53,1893,20,33,1170.30,1923.00,0.00
2024-12-10 17:36:16,54,1893,20,34,1148.63,1923.02,0.00
2024-12-10 17:36:16,53,1893,20,33,1165.23,1923.04,0.00
2024-12-10 17:36:16,52,1893,19,33,1168.16,1923.85,0.00
2024-12-10 17:36:16,52,1894,19,33,1202.31,1924.00,0.00
2024-12-10 17:36:16,53,1894,19,34,1179.62,1924.02,0.00
2024-12-10 17:36:16,53,1895,19,34,1175.88,1925.00,0.00
2024-12-10 17:36:16,54,1895,20,34,1154.10,1925.02,0.00
2024-12-10 17:36:16,53,1895,20,33,1171.16,1925.04,0.00
2024-12-10 17:36:16,53,1896,20,33,1175.03,1926.00,0.00
2024-12-10 17:36:16,54,1896,20,34,1153.27,1926.02,0.00
2024-12-10 17:36:16,53,1896,19,34,1150.52,1926.43,0.00
2024-12-10 17:36:16,53,1897,19,34,1176.37,1927.00,0.00
2024-12-10 17:36:16,54,1897,20,34,1154.59,1927.02,0.00
2024-12-10 17:36:16,53,1897,20,33,1170.56,1927.04,0.00
2024-12-10 17:36:16,53,1898,20,33,1174.43,1928.00,0.00
2024-12-10 17:36:16,54,1898,21,33,1152.69,1928.02,0.00
2024-12-10 17:36:17,54,1899,21,33,1148.74,1929.00,0.00
2024-12-10 17:36:17,55,1899,22,33,1127.86,1929.02,0.00
2024-12-10 17:36:17,54,1899,22,32,1143.39,1929.04,0.00
2024-12-10 17:36:17,54,1900,22,32,1146.84,1930.00,0.00
2024-12-10 17:36:17,55,1900,23,32,1125.99,1930.02,0.00
2024-12-10 17:36:17,55,1901,23,32,1121.77,1931.00,0.00
2024-12-10 17:36:17,56,1901,24,32,1101.73,1931.02,0.00
2024-12-10 17:36:17,55,1901,24,31,1116.86,1931.04,0.00
2024-12-10 17:36:17,55,1902,24,31,1119.89,1932.00,0.00
2024-12-10 17:36:17,56,1902,24,32,1099.89,1932.02,0.00
2024-12-10 17:36:17,56,1903,24,32,1096.79,1933.00,0.00
2024-12-10 17:36:17,57,1903,24,33,1077.55,1933.02,0.00
2024-12-10 17:36:17,56,1903,24,32,1090.93,1933.04,0.00
2024-12-10 17:36:17,55,1903,23,32,1104.02,1933.18,0.00
2024-12-10 17:36:17,55,1904,23,32,1123.86,1934.00,0.00
2024-12-10 17:36:17,56,1904,24,32,1103.79,1934.02,0.00
2024-12-10 17:36:17,55,1904,23,32,1109.17,1934.22,0.00
2024-12-10 17:36:17,55,1905,23,32,1129.72,1935.00,0.00
2024-12-10 17:36:17,56,1905,23,33,1109.54,1935.02,0.00
2024-12-10 17:36:17,55,1905,23,32,1124.09,1935.04,0.00
2024-12-10 17:36:17,55,1906,23,32,1127.13,1936.00,0.00
2024-12-10 17:36:17,56,1906,23,33,1107.01,1936.02,0.00
2024-12-10 17:36:17,55,1906,22,33,1104.43,1936.40,0.00
2024-12-10 17:36:17,55,1907,22,33,1128.42,1937.00,0.00
2024-12-10 17:36:17,56,1907,23,33,1108.27,1937.02,0.00
2024-12-10 17:36:17,55,1907,23,32,1123.14,1937.04,0.00
2024-12-10 17:36:17,55,1908,23,32,1126.18,1938.00,0.00
2024-12-10 17:36:17,56,1908,23,33,1106.07,1938.02,0.00
2024-12-10 17:36:17,56,1909,23,33,1107.85,1939.00,0.00
2024-12-10 17:36:17,57,1909,23,34,1088.41,1939.02,0.00
2024-12-10 17:36:17,56,1909,22,34,1093.17,1939.11,0.00
2024-12-10 17:36:17,55,1909,21,34,1102.41,1939.66,0.00
2024-12-10 17:36:17,55,1910,21,34,1131.23,1940.00,0.00
2024-12-10 17:36:17,56,1910,21,35,1111.03,1940.02,0.00
2024-12-10 17:36:17,55,1910,21,34,1126.29,1940.04,0.00
2024-12-10 17:36:17,54,1910,20,34,1132.08,1940.09,0.00
2024-12-10 17:36:17,54,1911,20,34,1150.97,1941.00,0.00
2024-12-10 17:36:17,55,1911,20,35,1130.04,1941.02,0.00
2024-12-10 17:36:17,54,1911,19,35,1131.51,1941.65,0.00
2024-12-10 17:36:17,54,1912,19,35,1147.15,1942.00,0.00
2024-12-10 17:36:17,55,1912,20,35,1126.30,1942.02,0.00
2024-12-10 17:36:17,54,1912,20,34,1142.48,1942.04,0.00
2024-12-10 17:36:17,54,1913,20,34,1145.95,1943.00,0.00
2024-12-10 17:36:17,55,1913,20,35,1125.11,1943.02,0.00
2024-12-10 17:36:17,54,1913,19,35,1116.33,1943.56,0.00
2024-12-10 17:36:17,54,1914,19,35,1144.02,1944.00,0.00
2024-12-10 17:36:17,55,1914,20,35,1123.22,1944.02,0.00
2024-12-10 17:36:17,54,1914,20,34,1139.70,1944.04,0.00
2024-12-10 17:36:17,54,1915,20,34,1143.16,1945.00,0.00
2024-12-10 17:36:17,55,1915,20,35,1122.38,1945.02,0.00
2024-12-10 17:36:17,54,1915,19,35,1134.18,1945.09,0.00
2024-12-10 17:36:17,53,1915,18,35,1148.30,1945.25,0.00
2024-12-10 17:36:17,53,1916,18,35,1170.84,1946.00,0.00
2024-12-10 17:36:17,54,1916,19,35,1149.16,1946.02,0.00
2024-12-10 17:36:17,53,1916,19,34,1164.61,1946.06,0.00
2024-12-10 17:36:17,52,1916,18,34,1176.33,1946.62,0.00
2024-12-10 17:36:17,52,1917,18,34,1191.60,1947.00,0.00
2024-12-10 17:36:17,53,1917,18,35,1169.12,1947.02,0.00
2024-12-10 17:36:17,53,1918,18,35,1166.18,1948.00,0.00
2024-12-10 17:36:17,54,1918,19,35,1144.58,1948.02,0.00
2024-12-10 17:36:17,53,1918,19,34,1159.57,1948.06,0.00
2024-12-10 17:36:17,52,1918,18,34,1170.96,1948.27,0.00
2024-12-10 17:36:17,52,1919,18,34,1194.70,1949.00,0.00
2024-12-10 17:36:17,53,1919,19,34,1172.16,1949.02,0.00
2024-12-10 17:36:17,53,1920,19,34,1169.91,1950.00,0.00
2024-12-10 17:36:17,54,1920,20,34,1148.25,1950.02,0.00
2024-12-10 17:36:17,53,1920,20,33,1162.56,1950.06,0.00
2024-12-10 17:36:17,53,1921,20,33,1166.83,1951.00,0.00
2024-12-10 17:36:17,54,1921,21,33,1145.22,1951.02,0.00
2024-12-10 17:36:17,54,1922,21,33,1142.66,1952.00,0.00
2024-12-10 17:36:17,55,1922,22,33,1121.88,1952.02,0.00
2024-12-10 17:36:17,54,1922,22,32,1135.80,1952.06,0.00
2024-12-10 17:36:17,53,1922,21,32,1156.14,1952.09,0.00
2024-12-10 17:36:17,53,1923,21,32,1161.13,1953.00,0.00
2024-12-10 17:36:17,54,1923,22,32,1139.63,1953.02,0.00
2024-12-10 17:36:17,53,1923,21,32,1135.41,1953.43,0.00
2024-12-10 17:36:17,53,1924,21,32,1161.62,1954.00,0.00
2024-12-10 17:36:17,54,1924,22,32,1140.10,1954.02,0.00
2024-12-10 17:36:17,53,1924,22,31,1156.08,1954.02,0.00
2024-12-10 17:36:17,52,1924,22,30,1171.93,1954.04,0.00
2024-12-10 17:36:17,52,1925,22,30,1176.29,1955.00,0.00
2024-12-10 17:36:17,53,1925,22,31,1154.09,1955.02,0.00
2024-12-10 17:36:17,52,1925,21,31,1158.77,1955.54,0.00
2024-12-10 17:36:17,52,1926,21,31,1187.69,1956.00,0.00
2024-12-10 17:36:17,53,1926,22,31,1165.28,1956.02,0.00
2024-12-10 17:36:17,52,1926,22,30,1181.68,1956.04,0.00
2024-12-10 17:36:17,52,1927,22,30,1186.04,1957.00,0.00
2024-12-10 17:36:17,53,1927,23,30,1163.66,1957.02,0.00
2024-12-10 17:36:17,53,1928,23,30,1161.13,1958.00,0.00
2024-12-10 17:36:17,54,1928,24,30,1139.62,1958.02,0.00
2024-12-10 17:36:17,53,1928,24,29,1154.12,1958.06,0.00
2024-12-10 17:36:17,53,1929,24,29,1158.39,1959.00,0.00
2024-12-10 17:36:17,54,1929,24,30,1136.94,1959.02,0.00
2024-12-10 17:36:17,53,1929,23,30,1139.56,1959.60,0.00
2024-12-10 17:36:17,53,1930,23,30,1155.61,1960.00,0.00
2024-12-10 17:36:17,54,1930,24,30,1134.21,1960.02,0.00
2024-12-10 17:36:17,53,1930,24,29,1148.96,1960.06,0.00
2024-12-10 17:36:17,54,1929,24,30,1125.20,1960.22,0.00
2024-12-10 17:36:17,54,1930,24,30,1150.40,1961.00,0.00
2024-12-10 17:36:17,55,1930,24,31,1129.48,1961.02,0.00
2024-12-10 17:36:18,55,1931,24,31,1162.72,1962.00,0.00
2024-12-10 17:36:18,56,1931,24,32,1141.96,1962.02,0.00
2024-12-10 17:36:18,55,1931,24,31,1155.95,1962.06,0.00
2024-12-10 17:36:18,55,1932,24,31,1159.39,1963.00,0.00
2024-12-10 17:36:18,56,1932,25,31,1138.68,1963.02,0.00
2024-12-10 17:36:18,56,1933,25,31,1136.23,1964.00,0.00
2024-12-10 17:36:18,57,1933,26,31,1116.30,1964.02,0.00
2024-12-10 17:36:18,56,1933,26,30,1129.22,1964.05,0.00
2024-12-10 17:36:18,55,1933,25,30,1131.08,1964.76,0.00
2024-12-10 17:36:18,55,1934,25,30,1162.36,1965.00,0.00
2024-12-10 17:36:18,56,1934,25,31,1141.60,1965.02,0.00
2024-12-10 17:36:18,56,1935,25,31,1139.01,1966.00,0.00
2024-12-10 17:36:18,57,1935,26,31,1119.02,1966.02,0.00
2024-12-10 17:36:18,56,1935,26,30,1132.34,1966.05,0.00
2024-12-10 17:36:18,55,1935,25,30,1151.16,1966.06,0.00
2024-12-10 17:36:18,55,1936,25,30,1168.90,1967.00,0.00
2024-12-10 17:36:18,56,1936,26,30,1148.03,1967.02,0.00
2024-12-10 17:36:18,56,1937,26,30,1145.72,1968.00,0.00
2024-12-10 17:36:18,57,1937,26,31,1125.62,1968.02,0.00
2024-12-10 17:36:18,56,1937,26,30,1138.70,1968.05,0.00
2024-12-10 17:36:18,55,1937,25,30,1149.79,1968.55,0.00
2024-12-10 17:36:18,55,1938,25,30,1162.65,1969.00,0.00
2024-12-10 17:36:18,56,1938,26,30,1141.89,1969.02,0.00
2024-12-10 17:36:18,55,1938,25,30,1140.92,1969.67,0.00
2024-12-10 17:36:18,55,1939,25,30,1170.55,1970.00,0.00
2024-12-10 17:36:18,56,1939,25,31,1149.64,1970.02,0.00
2024-12-10 17:36:18,55,1939,25,30,1163.39,1970.06,0.00
2024-12-10 17:36:18,55,1940,25,30,1166.84,1971.00,0.00
2024-12-10 17:36:18,56,1940,25,31,1146.00,1971.02,0.00
2024-12-10 17:36:18,55,1940,24,31,1156.84,1971.13,0.00
2024-12-10 17:36:18,55,1941,24,31,1176.04,1972.00,0.00
2024-12-10 17:36:18,56,1941,24,32,1155.04,1972.02,0.00
2024-12-10 17:36:18,55,1941,24,31,1167.82,1972.09,0.00
2024-12-10 17:36:18,55,1942,24,31,1171.97,1973.00,0.00
2024-12-10 17:36:18,56,1942,24,32,1151.04,1973.02,0.00
2024-12-10 17:36:18,55,1942,23,32,1170.39,1973.09,0.00
2024-12-10 17:36:18,55,1943,23,32,1181.73,1974.00,0.00
2024-12-10 17:36:18,56,1943,23,33,1160.62,1974.02,0.00
2024-12-10 17:36:18,55,1943,23,32,1173.14,1974.09,0.00
2024-12-10 17:36:18,54,1943,22,32,1186.52,1974.24,0.00
2024-12-10 17:36:18,54,1944,22,32,1208.61,1975.00,0.00
2024-12-10 17:36:18,55,1944,23,32,1186.63,1975.02,0.00
2024-12-10 17:36:18,54,1944,23,31,1208.24,1975.02,0.00
2024-12-10 17:36:18,53,1944,22,31,1229.57,1975.08,0.00
2024-12-10 17:36:18,53,1945,22,31,1229.62,1976.00,0.00
2024-12-10 17:36:18,54,1945,23,31,1206.84,1976.02,0.00
2024-12-10 17:36:18,54,1946,23,31,1202.70,1977.00,0.00
2024-12-10 17:36:18,55,1946,24,31,1180.83,1977.02,0.00
2024-12-10 17:36:18,54,1946,24,30,1201.26,1977.07,0.00
2024-12-10 17:36:18,53,1946,23,30,1215.37,1977.51,0.00
2024-12-10 17:36:18,53,1947,23,30,1228.43,1978.00,0.00
2024-12-10 17:36:18,54,1947,24,30,1205.68,1978.02,0.00
2024-12-10 17:36:18,54,1948,24,30,1202.97,1979.00,0.00
2024-12-10 17:36:18,55,1948,25,30,1181.10,1979.02,0.00
2024-12-10 17:36:18,54,1948,25,29,1194.56,1979.07,0.00
2024-12-10 17:36:18,54,1949,25,29,1198.81,1980.00,0.00
2024-12-10 17:36:18,55,1949,25,30,1177.01,1980.02,0.00
2024-12-10 17:36:18,54,1949,24,30,1181.67,1980.24,0.00
2024-12-10 17:36:18,54,1950,24,30,1203.82,1981.00,0.00
2024-12-10 17:36:18,55,1950,24,31,1181.93,1981.02,0.00
2024-12-10 17:36:18,54,1950,23,31,1174.85,1981.46,0.00
2024-12-10 17:36:18,54,1951,23,31,1201.30,1982.00,0.00
2024-12-10 17:36:18,55,1951,24,31,1179.46,1982.02,0.00
2024-12-10 17:36:18,54,1951,24,30,1199.85,1982.07,0.00
2024-12-10 17:36:18,54,1952,24,30,1204.11,1983.00,0.00
2024-12-10 17:36:18,55,1952,24,31,1182.22,1983.02,0.00
2024-12-10 17:36:18,54,1952,23,31,1191.67,1983.15,0.00
2024-12-10 17:36:18,54,1953,23,31,1212.06,1984.00,0.00
2024-12-10 17:36:18,55,1953,23,32,1190.03,1984.02,0.00
2024-12-10 17:36:18,54,1953,23,31,1203.63,1984.07,0.00
2024-12-10 17:36:18,54,1954,23,31,1207.90,1985.00,0.00
2024-12-10 17:36:18,55,1954,24,31,1185.93,1985.02,0.00
2024-12-10 17:36:18,55,1955,24,31,1183.08,1986.00,0.00
2024-12-10 17:36:18,56,1955,25,31,1161.95,1986.02,0.00
2024-12-10 17:36:18,55,1955,25,30,1175.15,1986.07,0.00
2024-12-10 17:36:18,55,1956,25,30,1178.97,1987.00,0.00
2024-12-10 17:36:18,56,1956,25,31,1157.92,1987.02,0.00
2024-12-10 17:36:18,56,1957,25,31,1155.08,1988.00,0.00
2024-12-10 17:36:18,57,1957,25,32,1134.81,1988.02,0.00
2024-12-10 17:36:18,56,1957,25,31,1147.29,1988.07,0.00
2024-12-10 17:36:18,55,1957,24,31,1166.21,1988.07,0.00
2024-12-10 17:36:18,55,1958,24,31,1184.50,1989.00,0.00
2024-12-10 17:36:18,56,1958,25,31,1163.35,1989.02,0.00
2024-12-10 17:36:18,56,1959,25,31,1161.71,1990.00,0.00
2024-12-10 17:36:18,57,1959,26,31,1141.33,1990.02,0.00
2024-12-10 17:36:18,57,1960,26,31,1136.31,1991.00,0.00
2024-12-10 17:36:18,58,1960,27,31,1116.72,1991.02,0.00
2024-12-10 17:36:18,57,1960,26,31,1134.93,1991.07,0.00
2024-12-10 17:36:18,56,1960,26,30,1154.49,1991.07,0.00
2024-12-10 17:36:18,56,1961,26,30,1157.90,1992.00,0.00
2024-12-10 17:36:18,57,1961,27,30,1137.58,1992.02,0.00
2024-12-10 17:36:18,56,1961,26,30,1157.54,1992.02,0.00
2024-12-10 17:36:18,55,1961,25,30,1146.55,1992.96,0.00
2024-12-10 17:36:18,55,1962,25,30,1182.08,1993.00,0.00
2024-12-10 17:36:18,56,1962,26,30,1160.97,1993.02,0.00
2024-12-10 17:36:18,55,1962,26,29,1173.76,1993.06,0.00
2024-12-10 17:36:18,55,1963,26,29,1177.23,1994.00,0.00
2024-12-10 17:36:18,56,1963,26,30,1156.21,1994.02,0.00
2024-12-10 17:36:18,56,1964,26,30,1153.97,1995.00,0.00
2024-12-10 17:36:18,57,1964,27,30,1133.73,1995.02,0.00
2024-12-10 17:36:18,56,1964,27,29,1145.79,1995.05,0.00
2024-12-10 17:36:19,55,1964,26,29,1143.60,1995.51,0.00
2024-12-10 17:36:19,55,1965,26,29,1170.43,1996.00,0.00
2024-12-10 17:36:19,56,1965,27,29,1149.53,1996.02,0.00
2024-12-10 17:36:19,56,1966,27,29,1147.27,1997.00,0.00
2024-12-10 17:36:19,57,1966,28,29,1127.15,1997.02,0.00
2024-12-10 17:36:19,56,1966,28,28,1139.44,1997.05,0.00
2024-12-10 17:36:19,55,1966,27,28,1141.62,1997.76,0.00
2024-12-10 17:36:19,56,1965,28,28,1119.87,1997.86,0.00
2024-12-10 17:36:19,56,1966,28,28,1156.03,1998.00,0.00
2024-12-10 17:36:19,57,1966,28,29,1135.75,1998.02,0.00
2024-12-10 17:36:19,57,1967,28,29,1168.77,1999.00,0.00
2024-12-10 17:36:19,58,1967,28,30,1148.62,1999.02,0.00
2024-12-10 17:36:19,57,1967,28,29,1161.07,1999.05,0.00
2024-12-10 17:36:19,57,1968,28,29,1163.74,2000.00,0.00
2024-12-10 17:36:19,58,1968,28,30,1143.67,2000.02,0.00
2024-12-10 17:36:19,58,1969,28,30,1141.00,2001.00,0.00
2024-12-10 17:36:19,59,1969,28,31,1121.66,2001.02,0.00
2024-12-10 17:36:19,58,1969,28,30,1133.76,2001.05,0.00
2024-12-10 17:36:19,58,1970,28,30,1136.05,2002.00,0.00
2024-12-10 17:36:19,59,1970,29,30,1116.79,2002.02,0.00
2024-12-10 17:36:19,59,1971,29,30,1114.01,2003.00,0.00
2024-12-10 17:36:19,60,1971,29,31,1095.45,2003.02,0.00
2024-12-10 17:36:19,59,1971,29,30,1107.23,2003.05,0.00
2024-12-10 17:36:19,58,1971,28,30,1105.93,2003.79,0.00
2024-12-10 17:36:19,58,1972,28,30,1136.49,2004.00,0.00
2024-12-10 17:36:19,59,1972,28,31,1117.23,2004.02,0.00
2024-12-10 17:36:19,58,1972,27,31,1122.25,2004.19,0.00
2024-12-10 17:36:19,58,1973,27,31,1141.08,2005.00,0.00
2024-12-10 17:36:19,59,1973,27,32,1121.74,2005.02,0.00
2024-12-10 17:36:19,58,1973,27,31,1134.52,2005.05,0.00
2024-12-10 17:36:19,57,1973,26,31,1152.33,2005.07,0.00
2024-12-10 17:36:19,57,1974,26,31,1155.35,2006.00,0.00
2024-12-10 17:36:19,58,1974,27,31,1135.43,2006.02,0.00
2024-12-10 17:36:19,57,1974,26,31,1131.02,2006.37,0.00
2024-12-10 17:36:19,57,1975,26,31,1153.98,2007.00,0.00
2024-12-10 17:36:19,58,1975,27,31,1134.08,2007.02,0.00
2024-12-10 17:36:19,57,1975,27,30,1151.83,2007.05,0.00
2024-12-10 17:36:19,57,1976,27,30,1151.86,2008.00,0.00
2024-12-10 17:36:19,58,1976,27,31,1132.00,2008.02,0.00
2024-12-10 17:36:19,57,1976,27,30,1151.50,2008.02,0.00
2024-12-10 17:36:19,57,1977,27,30,1145.15,2009.00,0.00
2024-12-10 17:36:19,58,1977,28,30,1125.40,2009.02,0.00
2024-12-10 17:36:19,57,1977,28,29,1138.81,2009.04,0.00
2024-12-10 17:36:19,58,1976,29,29,1118.83,2009.09,0.00
2024-12-10 17:36:19,58,1977,29,29,1138.62,2010.00,0.00
2024-12-10 17:36:19,59,1977,29,30,1119.32,2010.02,0.00
2024-12-10 17:36:19,59,1978,29,30,1154.58,2011.00,0.00
2024-12-10 17:36:19,60,1978,30,30,1135.34,2011.02,0.00
2024-12-10 17:36:19,59,1978,29,30,1154.16,2011.03,0.00
2024-12-10 17:36:19,59,1979,29,30,1154.74,2012.00,0.00
2024-12-10 17:36:19,60,1979,30,30,1135.50,2012.02,0.00
2024-12-10 17:36:19,60,1980,30,30,1133.26,2013.00,0.00
2024-12-10 17:36:19,61,1980,31,30,1114.68,2013.02,0.00
2024-12-10 17:36:19,61,1981,31,30,1107.84,2014.00,0.00
2024-12-10 17:36:19,62,1981,32,30,1089.98,2014.02,0.00
2024-12-10 17:36:19,61,1981,32,29,1102.24,2014.03,0.00
2024-12-10 17:36:19,60,1981,31,29,1091.74,2014.93,0.00
2024-12-10 17:36:19,60,1982,31,29,1124.03,2015.00,0.00
2024-12-10 17:36:19,61,1982,32,29,1105.60,2015.02,0.00
2024-12-10 17:36:19,60,1982,31,29,1089.22,2015.87,0.00
2024-12-10 17:36:19,60,1983,31,29,1119.33,2016.00,0.00
2024-12-10 17:36:19,61,1983,32,29,1100.98,2016.02,0.00
2024-12-10 17:36:19,60,1983,31,29,1118.98,2016.03,0.00
2024-12-10 17:36:19,59,1983,31,28,1130.78,2016.05,0.00
2024-12-10 17:36:19,59,1984,31,28,1131.72,2017.00,0.00
2024-12-10 17:36:19,60,1984,32,28,1112.86,2017.02,0.00
2024-12-10 17:36:19,59,1984,31,28,1119.18,2017.12,0.00
2024-12-10 17:36:19,59,1985,31,28,1134.84,2018.00,0.00
2024-12-10 17:36:19,60,1985,32,28,1115.93,2018.02,0.00
2024-12-10 17:36:19,60,1986,32,28,1108.39,2019.00,0.00
2024-12-10 17:36:19,61,1986,33,28,1090.22,2019.02,0.00
2024-12-10 17:36:19,60,1986,33,27,1106.39,2019.10,0.00
2024-12-10 17:36:19,60,1987,33,27,1106.79,2020.00,0.00
2024-12-10 17:36:19,61,1987,33,28,1088.64,2020.02,0.00
2024-12-10 17:36:19,60,1987,32,28,1105.81,2020.05,0.00
2024-12-10 17:36:19,59,1987,31,28,1107.79,2020.54,0.00
2024-12-10 17:36:19,58,1987,30,28,1122.52,2020.62,0.00
2024-12-10 17:36:19,58,1988,30,28,1147.54,2021.00,0.00
2024-12-10 17:36:19,59,1988,30,29,1128.09,2021.02,0.00
2024-12-10 17:36:19,58,1988,30,28,1138.50,2021.10,0.00
2024-12-10 17:36:19,58,1989,30,28,1139.03,2022.00,0.00
2024-12-10 17:36:19,59,1989,30,29,1119.73,2022.02,0.00
2024-12-10 17:36:19,58,1989,29,29,1121.63,2022.53,0.00
2024-12-10 17:36:19,58,1990,29,29,1134.01,2023.00,0.00
2024-12-10 17:36:19,59,1990,29,30,1114.79,2023.02,0.00
2024-12-10 17:36:19,58,1990,29,29,1125.32,2023.10,0.00
2024-12-10 17:36:19,57,1990,28,29,1130.83,2023.74,0.00
2024-12-10 17:36:19,56,1990,27,29,1139.57,2023.89,0.00
2024-12-10 17:36:19,56,1991,27,29,1173.62,2024.00,0.00
2024-12-10 17:36:19,57,1991,28,29,1153.03,2024.02,0.00
2024-12-10 17:36:19,57,1992,28,29,1151.33,2025.00,0.00
2024-12-10 17:36:19,58,1992,29,29,1131.48,2025.02,0.00
2024-12-10 17:36:19,57,1992,29,28,1141.42,2025.14,0.00
2024-12-10 17:36:19,57,1993,29,28,1145.86,2026.00,0.00
2024-12-10 17:36:19,58,1993,29,29,1126.10,2026.02,0.00
2024-12-10 17:36:19,57,1993,28,29,1144.89,2026.05,0.00
2024-12-10 17:36:19,56,1993,27,29,1154.88,2026.14,0.00
2024-12-10 17:36:19,56,1994,27,29,1174.23,2027.00,0.00
2024-12-10 17:36:19,57,1994,28,29,1153.63,2027.02,0.00
2024-12-10 17:36:19,56,1994,27,29,1158.74,2027.25,0.00
2024-12-10 17:36:20,56,1995,27,29,1180.24,2028.00,0.00
2024-12-10 17:36:20,57,1995,28,29,1159.53,2028.02,0.00
2024-12-10 17:36:20,57,1996,28,29,1154.41,2029.00,0.00
2024-12-10 17:36:20,58,1996,29,29,1134.51,2029.02,0.00
2024-12-10 17:36:20,57,1996,29,28,1151.24,2029.14,0.00
2024-12-10 17:36:20,57,1997,29,28,1155.69,2030.00,0.00
2024-12-10 17:36:20,58,1997,29,29,1135.76,2030.02,0.00
2024-12-10 17:36:20,57,1997,29,28,1146.82,2030.12,0.00
2024-12-10 17:36:20,57,1998,29,28,1150.92,2031.00,0.00
2024-12-10 17:36:20,58,1998,30,28,1131.07,2031.02,0.00
2024-12-10 17:36:20,57,1998,29,28,1126.49,2031.44,0.00
2024-12-10 17:36:20,57,1999,29,28,1151.13,2032.00,0.00
2024-12-10 17:36:20,58,1999,29,29,1131.28,2032.02,0.00
2024-12-10 17:36:20,57,1999,29,28,1141.89,2032.12,0.00
2024-12-10 17:36:20,57,2000,29,28,1145.98,2033.00,0.00
2024-12-10 17:36:20,58,2000,29,29,1126.23,2033.02,0.00
2024-12-10 17:36:20,58,2001,29,29,1124.01,2034.00,0.00
2024-12-10 17:36:20,59,2001,30,29,1104.96,2034.02,0.00
2024-12-10 17:36:20,58,2001,30,28,1115.27,2034.12,0.00
2024-12-10 17:36:20,58,2002,30,28,1118.95,2035.00,0.00
2024-12-10 17:36:20,59,2002,30,29,1099.99,2035.02,0.00
2024-12-10 17:36:20,59,2003,30,29,1097.63,2036.00,0.00
2024-12-10 17:36:20,60,2003,30,30,1079.33,2036.02,0.00
2024-12-10 17:36:20,59,2003,30,29,1089.37,2036.12,0.00
2024-12-10 17:36:20,58,2003,29,29,1107.81,2036.14,0.00
2024-12-10 17:36:20,58,2004,29,29,1111.83,2037.00,0.00
2024-12-10 17:36:20,59,2004,30,29,1092.99,2037.02,0.00
2024-12-10 17:36:20,58,2004,29,29,1091.41,2037.67,0.00
2024-12-10 17:36:20,57,2004,28,29,1095.19,2037.97,0.00
2024-12-10 17:36:20,57,2005,28,29,1130.25,2038.00,0.00
2024-12-10 17:36:20,58,2005,28,30,1110.76,2038.02,0.00
2024-12-10 17:36:20,58,2006,28,30,1108.07,2039.00,0.00
2024-12-10 17:36:20,59,2006,28,31,1089.29,2039.02,0.00
2024-12-10 17:36:20,58,2006,28,30,1100.36,2039.12,0.00
2024-12-10 17:36:20,57,2006,27,30,1119.31,2039.14,0.00
2024-12-10 17:36:20,57,2007,27,30,1123.77,2040.00,0.00
2024-12-10 17:36:20,58,2007,27,31,1104.39,2040.02,0.00
2024-12-10 17:36:20,57,2007,27,30,1113.42,2040.16,0.00
2024-12-10 17:36:20,56,2007,26,30,1108.01,2040.96,0.00
2024-12-10 17:36:20,56,2008,26,30,1143.74,2041.00,0.00
2024-12-10 17:36:20,57,2008,26,31,1123.68,2041.02,0.00
2024-12-10 17:36:20,56,2008,25,31,1139.97,2041.14,0.00
2024-12-10 17:36:20,55,2008,24,31,1145.08,2041.55,0.00
2024-12-10 17:36:20,55,2009,24,31,1173.26,2042.00,0.00
2024-12-10 17:36:20,56,2009,24,32,1152.31,2042.02,0.00
2024-12-10 17:36:20,55,2009,23,32,1166.21,2042.06,0.00
2024-12-10 17:36:20,54,2009,23,31,1178.75,2042.13,0.00
2024-12-10 17:36:20,54,2010,23,31,1199.36,2043.00,0.00
2024-12-10 17:36:20,55,2010,24,31,1177.55,2043.02,0.00
2024-12-10 17:36:20,54,2010,23,31,1194.82,2043.04,0.00
2024-12-10 17:36:20,54,2011,23,31,1206.00,2044.00,0.00
2024-12-10 17:36:20,55,2011,23,32,1184.07,2044.02,0.00
2024-12-10 17:36:20,54,2011,23,31,1196.56,2044.11,0.00
2024-12-10 17:36:20,54,2012,23,31,1201.67,2045.00,0.00
2024-12-10 17:36:20,55,2012,23,32,1179.82,2045.02,0.00
2024-12-10 17:36:20,55,2013,23,32,1177.78,2046.00,0.00
2024-12-10 17:36:20,56,2013,24,32,1156.75,2046.02,0.00
2024-12-10 17:36:20,55,2013,24,31,1168.87,2046.11,0.00
2024-12-10 17:36:20,54,2013,23,31,1190.52,2046.11,0.00
2024-12-10 17:36:20,53,2013,22,31,1186.51,2046.96,0.00
2024-12-10 17:36:20,53,2014,22,31,1224.38,2047.00,0.00
2024-12-10 17:36:20,54,2014,22,32,1201.70,2047.02,0.00
2024-12-10 17:36:20,54,2015,22,32,1202.79,2048.00,0.00
2024-12-10 17:36:20,55,2015,23,32,1180.92,2048.02,0.00
2024-12-10 17:36:20,54,2015,22,32,1181.86,2048.22,0.00
2024-12-10 17:36:20,54,2016,22,32,1204.40,2049.00,0.00
2024-12-10 17:36:20,55,2016,23,32,1182.50,2049.02,0.00
2024-12-10 17:36:20,54,2016,23,31,1198.73,2049.13,0.00
2024-12-10 17:36:20,54,2017,23,31,1204.23,2050.00,0.00
2024-12-10 17:36:20,55,2017,24,31,1182.33,2050.02,0.00
2024-12-10 17:36:20,55,2018,24,31,1180.12,2051.00,0.00
2024-12-10 17:36:20,56,2018,25,31,1159.05,2051.02,0.00
2024-12-10 17:36:20,55,2018,25,30,1171.19,2051.13,0.00
2024-12-10 17:36:20,55,2019,25,30,1176.22,2052.00,0.00
2024-12-10 17:36:20,56,2019,26,30,1155.21,2052.02,0.00
2024-12-10 17:36:20,56,2020,26,30,1154.04,2053.00,0.00
2024-12-10 17:36:20,57,2020,27,30,1133.79,2053.02,0.00
2024-12-10 17:36:20,57,2021,27,30,1128.58,2054.00,0.00
2024-12-10 17:36:20,58,2021,28,30,1109.12,2054.02,0.00
2024-12-10 17:36:20,57,2021,28,29,1125.72,2054.14,0.00
2024-12-10 17:36:20,57,2022,28,29,1130.21,2055.00,0.00
2024-12-10 17:36:20,58,2022,28,30,1110.72,2055.02,0.00
2024-12-10 17:36:20,57,2022,27,30,1102.60,2055.54,0.00
2024-12-10 17:36:20,57,2023,27,30,1129.61,2056.00,0.00
2024-12-10 17:36:20,58,2023,28,30,1110.14,2056.02,0.00
2024-12-10 17:36:20,57,2023,27,30,1126.75,2056.14,0.00
2024-12-10 17:36:20,56,2023,26,30,1130.76,2056.21,0.00
2024-12-10 17:36:20,56,2024,26,30,1151.84,2057.00,0.00
2024-12-10 17:36:20,57,2024,27,30,1131.63,2057.02,0.00
2024-12-10 17:36:20,56,2024,27,29,1148.55,2057.14,0.00
2024-12-10 17:36:20,56,2025,27,29,1153.50,2058.00,0.00
2024-12-10 17:36:20,57,2025,28,29,1133.27,2058.02,0.00
2024-12-10 17:36:20,56,2025,27,29,1132.90,2058.27,0.00
2024-12-10 17:36:20,56,2026,27,29,1155.07,2059.00,0.00
2024-12-10 17:36:20,57,2026,27,30,1134.81,2059.02,0.00
2024-12-10 17:36:20,56,2026,27,29,1144.79,2059.14,0.00
2024-12-10 17:36:20,56,2027,27,29,1149.75,2060.00,0.00
2024-12-10 17:36:20,57,2027,27,30,1129.58,2060.02,0.00
2024-12-10 17:36:20,56,2027,27,29,1149.38,2060.02,0.00
2024-12-10 17:36:20,55,2027,27,28,1169.90,2060.02,0.00
2024-12-10 17:36:21,55,2028,27,28,1168.99,2061.00,0.00
2024-12-10 17:36:21,56,2028,27,29,1148.12,2061.02,0.00
2024-12-10 17:36:21,55,2028,27,28,1159.64,2061.11,0.00
2024-12-10 17:36:21,54,2028,26,28,1154.87,2061.93,0.00
2024-12-10 17:36:21,54,2029,26,28,1191.58,2062.00,0.00
2024-12-10 17:36:21,55,2029,26,29,1169.91,2062.02,0.00
2024-12-10 17:36:21,54,2029,25,29,1184.71,2062.06,0.00
2024-12-10 17:36:21,54,2030,25,29,1196.36,2063.00,0.00
2024-12-10 17:36:21,55,2030,25,30,1174.61,2063.02,0.00
2024-12-10 17:36:21,54,2030,24,30,1195.98,2063.02,0.00
2024-12-10 17:36:21,53,2030,24,29,1209.99,2063.08,0.00
2024-12-10 17:36:21,53,2031,24,29,1214.85,2064.00,0.00
2024-12-10 17:36:21,54,2031,24,30,1192.35,2064.02,0.00
2024-12-10 17:36:21,53,2031,23,30,1214.46,2064.02,0.00
2024-12-10 17:36:21,53,2032,23,30,1212.95,2065.00,0.00
2024-12-10 17:36:21,54,2032,24,30,1190.49,2065.02,0.00
2024-12-10 17:36:21,53,2032,24,29,1204.78,2065.06,0.00
2024-12-10 17:36:21,53,2033,24,29,1209.25,2066.00,0.00
2024-12-10 17:36:21,54,2033,25,29,1186.86,2066.02,0.00
2024-12-10 17:36:21,53,2033,24,29,1201.07,2066.02,0.00
2024-12-10 17:36:21,53,2034,24,29,1212.57,2067.00,0.00
2024-12-10 17:36:21,54,2034,24,30,1190.11,2067.02,0.00
2024-12-10 17:36:21,53,2034,24,29,1205.16,2067.04,0.00
2024-12-10 17:36:21,53,2035,24,29,1209.25,2068.00,0.00
2024-12-10 17:36:21,54,2035,24,30,1186.86,2068.02,0.00
2024-12-10 17:36:21,53,2035,23,30,1195.64,2068.15,0.00
2024-12-10 17:36:21,53,2036,23,30,1217.65,2069.00,0.00
2024-12-10 17:36:21,54,2036,24,30,1195.10,2069.02,0.00
2024-12-10 17:36:21,53,2036,24,29,1210.62,2069.04,0.00
2024-12-10 17:36:21,53,2037,24,29,1214.72,2070.00,0.00
2024-12-10 17:36:21,54,2037,25,29,1192.22,2070.02,0.00
2024-12-10 17:36:21,54,2038,25,29,1190.29,2071.00,0.00
2024-12-10 17:36:21,55,2038,25,30,1168.65,2071.02,0.00
2024-12-10 17:36:21,54,2038,25,29,1183.01,2071.04,0.00
2024-12-10 17:36:21,54,2039,25,29,1186.64,2072.00,0.00
2024-12-10 17:36:21,55,2039,26,29,1165.07,2072.02,0.00
2024-12-10 17:36:21,54,2039,25,29,1153.10,2072.67,0.00
2024-12-10 17:36:21,54,2040,25,29,1184.82,2073.00,0.00
2024-12-10 17:36:21,55,2040,25,30,1163.28,2073.02,0.00
2024-12-10 17:36:21,54,2040,25,29,1177.53,2073.04,0.00
2024-12-10 17:36:21,53,2040,24,29,1183.52,2073.32,0.00
2024-12-10 17:36:21,53,2041,24,29,1208.88,2074.00,0.00
2024-12-10 17:36:21,54,2041,24,30,1186.49,2074.02,0.00
2024-12-10 17:36:21,53,2041,23,30,1207.33,2074.08,0.00
2024-12-10 17:36:21,53,2042,23,30,1209.27,2075.00,0.00
2024-12-10 17:36:21,54,2042,23,31,1186.87,2075.02,0.00
2024-12-10 17:36:21,54,2043,23,31,1182.43,2076.00,0.00
2024-12-10 17:36:21,55,2043,24,31,1160.93,2076.02,0.00
2024-12-10 17:36:21,54,2043,24,30,1178.61,2076.11,0.00
2024-12-10 17:36:21,53,2043,23,30,1172.35,2076.94,0.00
2024-12-10 17:36:21,53,2044,23,30,1210.40,2077.00,0.00
2024-12-10 17:36:21,54,2044,24,30,1187.98,2077.02,0.00
2024-12-10 17:36:21,54,2045,24,30,1187.89,2078.00,0.00
2024-12-10 17:36:21,55,2045,25,30,1166.29,2078.02,0.00
2024-12-10 17:36:21,55,2046,25,30,1161.56,2079.00,0.00
2024-12-10 17:36:21,56,2046,25,31,1140.82,2079.02,0.00
2024-12-10 17:36:21,55,2046,25,30,1158.56,2079.11,0.00
2024-12-10 17:36:21,55,2047,25,30,1163.25,2080.00,0.00
2024-12-10 17:36:21,56,2047,26,30,1142.48,2080.02,0.00
2024-12-10 17:36:21,56,2048,26,30,1141.79,2081.00,0.00
2024-12-10 17:36:21,57,2048,27,30,1121.76,2081.02,0.00
2024-12-10 17:36:21,56,2048,26,30,1122.90,2081.57,0.00
2024-12-10 17:36:21,56,2049,26,30,1136.59,2082.00,0.00
2024-12-10 17:36:21,57,2049,26,31,1116.65,2082.02,0.00
2024-12-10 17:36:21,56,2049,26,30,1134.39,2082.11,0.00
2024-12-10 17:36:21,56,2050,26,30,1138.63,2083.00,0.00
2024-12-10 17:36:21,57,2050,27,30,1118.65,2083.02,0.00
2024-12-10 17:36:21,57,2051,27,30,1117.35,2084.00,0.00
2024-12-10 17:36:21,58,2051,28,30,1098.09,2084.02,0.00
2024-12-10 17:36:21,57,2051,28,29,1108.23,2084.11,0.00
2024-12-10 17:36:21,56,2051,27,29,1121.51,2084.41,0.00
2024-12-10 17:36:21,55,2051,26,29,1139.07,2084.55,0.00
2024-12-10 17:36:21,54,2051,25,29,1143.08,2084.91,0.00
2024-12-10 17:36:21,54,2052,25,29,1179.81,2085.00,0.00
2024-12-10 17:36:21,55,2052,25,30,1158.36,2085.02,0.00
2024-12-10 17:36:21,55,2053,25,30,1157.51,2086.00,0.00
2024-12-10 17:36:21,56,2053,25,31,1136.84,2086.02,0.00
2024-12-10 17:36:21,55,2053,24,31,1155.14,2086.07,0.00
2024-12-10 17:36:21,54,2053,24,30,1167.66,2086.11,0.00
2024-12-10 17:36:21,54,2054,24,30,1188.29,2087.00,0.00
2024-12-10 17:36:21,55,2054,25,30,1166.68,2087.02,0.00
2024-12-10 17:36:21,54,2054,24,30,1184.45,2087.15,0.00
2024-12-10 17:36:21,54,2055,24,30,1198.14,2088.00,0.00
2024-12-10 17:36:21,55,2055,25,30,1176.35,2088.02,0.00
2024-12-10 17:36:21,54,2055,24,30,1196.23,2088.11,0.00
2024-12-10 17:36:21,54,2056,24,30,1193.68,2089.00,0.00
2024-12-10 17:36:21,55,2056,25,30,1171.98,2089.02,0.00
2024-12-10 17:36:21,54,2056,24,30,1191.77,2089.11,0.00
2024-12-10 17:36:21,53,2056,24,29,1213.47,2089.11,0.00
2024-12-10 17:36:21,53,2057,24,29,1219.15,2090.00,0.00
2024-12-10 17:36:21,54,2057,25,29,1196.58,2090.02,0.00
2024-12-10 17:36:21,53,2057,24,29,1218.76,2090.02,0.00
2024-12-10 17:36:21,52,2057,23,29,1232.95,2090.02,0.00
2024-12-10 17:36:21,52,2058,23,29,1245.20,2091.00,0.00
2024-12-10 17:36:21,53,2058,23,30,1221.71,2091.02,0.00
2024-12-10 17:36:21,52,2058,22,30,1233.14,2091.04,0.00
2024-12-10 17:36:21,52,2059,22,30,1245.80,2092.00,0.00
2024-12-10 17:36:21,53,2059,22,31,1222.29,2092.02,0.00
2024-12-10 17:36:21,52,2059,22,30,1244.60,2092.06,0.00
2024-12-10 17:36:21,52,2060,22,30,1249.61,2093.00,0.00
2024-12-10 17:36:21,53,2060,23,30,1226.04,2093.02,0.00
2024-12-10 17:36:21,52,2060,22,30,1236.34,2093.04,0.00
2024-12-10 17:36:22,52,2061,22,30,1249.00,2094.00,0.00
2024-12-10 17:36:22,53,2061,22,31,1225.44,2094.02,0.00
2024-12-10 17:36:22,52,2061,22,30,1240.55,2094.04,0.00
2024-12-10 17:36:22,52,2062,22,30,1245.17,2095.00,0.00
2024-12-10 17:36:22,53,2062,22,31,1221.67,2095.02,0.00
2024-12-10 17:36:22,53,2063,22,31,1220.09,2096.00,0.00
2024-12-10 17:36:22,54,2063,22,32,1197.50,2096.02,0.00
2024-12-10 17:36:22,53,2063,22,31,1211.79,2096.04,0.00
2024-12-10 17:36:22,52,2063,21,31,1206.00,2096.65,0.00
2024-12-10 17:36:22,52,2064,21,31,1239.31,2097.00,0.00
2024-12-10 17:36:22,53,2064,21,32,1215.93,2097.02,0.00
2024-12-10 17:36:22,53,2065,21,32,1214.38,2098.00,0.00
2024-12-10 17:36:22,54,2065,22,32,1191.90,2098.02,0.00
2024-12-10 17:36:22,53,2065,22,31,1206.47,2098.04,0.00
2024-12-10 17:36:22,52,2065,21,31,1212.00,2098.69,0.00
2024-12-10 17:36:22,52,2066,21,31,1246.14,2099.00,0.00
2024-12-10 17:36:22,53,2066,21,32,1222.63,2099.02,0.00
2024-12-10 17:36:22,53,2067,21,32,1221.17,2100.00,0.00
2024-12-10 17:36:22,54,2067,22,32,1198.56,2100.02,0.00
2024-12-10 17:36:22,53,2067,22,31,1213.25,2100.04,0.00
2024-12-10 17:36:22,53,2068,22,31,1217.39,2101.00,0.00
2024-12-10 17:36:22,54,2068,22,32,1194.85,2101.02,0.00
2024-12-10 17:36:22,54,2069,22,32,1193.48,2102.00,0.00
2024-12-10 17:36:22,55,2069,23,32,1171.78,2102.02,0.00
2024-12-10 17:36:22,54,2069,23,31,1185.31,2102.06,0.00
2024-12-10 17:36:22,53,2069,22,31,1198.50,2102.49,0.00
2024-12-10 17:36:22,53,2070,22,31,1211.95,2103.00,0.00
2024-12-10 17:36:22,54,2070,22,32,1189.50,2103.02,0.00
2024-12-10 17:36:22,55,2069,23,32,1153.09,2103.40,0.00
2024-12-10 17:36:22,55,2070,23,32,1181.19,2104.00,0.00
2024-12-10 17:36:22,56,2070,24,32,1160.10,2104.02,0.00
2024-12-10 17:36:22,55,2070,24,31,1173.55,2104.05,0.00
2024-12-10 17:36:22,54,2070,23,31,1172.15,2104.54,0.00
2024-12-10 17:36:22,54,2071,23,31,1240.67,2105.00,0.00
2024-12-10 17:36:22,55,2071,23,32,1218.11,2105.02,0.00
2024-12-10 17:36:22,55,2072,23,32,1215.79,2106.00,0.00
2024-12-10 17:36:22,56,2072,23,33,1194.08,2106.02,0.00
2024-12-10 17:36:22,55,2072,23,32,1208.52,2106.05,0.00
2024-12-10 17:36:22,54,2072,22,32,1214.88,2106.59,0.00
2024-12-10 17:36:22,54,2073,22,32,1245.61,2107.00,0.00
2024-12-10 17:36:22,55,2073,23,32,1222.97,2107.02,0.00
2024-12-10 17:36:22,55,2074,23,32,1220.72,2108.00,0.00
2024-12-10 17:36:22,56,2074,24,32,1198.92,2108.02,0.00
2024-12-10 17:36:22,55,2074,24,31,1213.45,2108.05,0.00
2024-12-10 17:36:22,55,2075,24,31,1217.08,2109.00,0.00
2024-12-10 17:36:22,56,2075,25,31,1195.35,2109.02,0.00
2024-12-10 17:36:22,55,2075,24,31,1207.90,2109.09,0.00
2024-12-10 17:36:22,54,2075,23,31,1229.87,2109.09,0.00
2024-12-10 17:36:22,54,2076,23,31,1237.42,2110.00,0.00
2024-12-10 17:36:22,55,2076,23,32,1214.92,2110.02,0.00
2024-12-10 17:36:22,54,2076,23,31,1230.39,2110.06,0.00
2024-12-10 17:36:22,54,2077,23,31,1234.49,2111.00,0.00
2024-12-10 17:36:22,55,2077,23,32,1212.04,2111.02,0.00
2024-12-10 17:36:22,54,2077,22,32,1225.50,2111.07,0.00
2024-12-10 17:36:22,54,2078,22,32,1245.63,2112.00,0.00
2024-12-10 17:36:22,55,2078,22,33,1222.98,2112.02,0.00
2024-12-10 17:36:22,54,2078,22,32,1238.60,2112.06,0.00
2024-12-10 17:36:22,53,2078,21,32,1246.03,2112.06,0.00
2024-12-10 17:36:22,53,2079,21,32,1266.54,2113.00,0.00
2024-12-10 17:36:22,54,2079,22,32,1243.09,2113.02,0.00
2024-12-10 17:36:22,53,2079,21,32,1266.15,2113.02,0.00
2024-12-10 17:36:22,53,2080,21,32,1265.55,2114.00,0.00
2024-12-10 17:36:22,54,2080,21,33,1242.11,2114.02,0.00
2024-12-10 17:36:22,54,2081,21,33,1237.61,2115.00,0.00
2024-12-10 17:36:22,55,2081,21,34,1215.11,2115.02,0.00
2024-12-10 17:36:22,54,2081,21,33,1236.44,2115.06,0.00
2024-12-10 17:36:22,54,2082,21,33,1240.54,2116.00,0.00
2024-12-10 17:36:22,55,2082,21,34,1217.99,2116.02,0.00
2024-12-10 17:36:22,55,2083,21,34,1217.29,2117.00,0.00
2024-12-10 17:36:22,56,2083,22,34,1195.55,2117.02,0.00
2024-12-10 17:36:22,55,2083,21,34,1195.56,2117.26,0.00
2024-12-10 17:36:22,56,2082,22,34,1171.26,2117.43,0.00
2024-12-10 17:36:22,56,2083,22,34,1209.09,2118.00,0.00
2024-12-10 17:36:22,57,2083,22,35,1187.88,2118.02,0.00
2024-12-10 17:36:22,56,2083,22,34,1207.21,2118.07,0.00
2024-12-10 17:36:22,56,2084,22,34,1248.64,2119.00,0.00
2024-12-10 17:36:22,57,2084,22,35,1226.73,2119.02,0.00
2024-12-10 17:36:22,56,2084,21,35,1247.89,2119.05,0.00
2024-12-10 17:36:22,55,2084,20,35,1239.78,2119.89,0.00
2024-12-10 17:36:22,55,2085,20,35,1276.09,2120.00,0.00
2024-12-10 17:36:22,56,2085,21,35,1253.30,2120.02,0.00
2024-12-10 17:36:22,55,2085,21,34,1267.23,2120.05,0.00
2024-12-10 17:36:22,54,2085,20,34,1283.16,2120.13,0.00
2024-12-10 17:36:22,53,2085,19,34,1299.75,2120.49,0.00
2024-12-10 17:36:22,53,2086,19,34,1329.34,2121.00,0.00
2024-12-10 17:36:22,54,2086,20,34,1304.72,2121.02,0.00
2024-12-10 17:36:22,54,2087,20,34,1302.37,2122.00,0.00
2024-12-10 17:36:22,55,2087,20,35,1278.69,2122.02,0.00
2024-12-10 17:36:22,54,2087,20,34,1293.73,2122.06,0.00
2024-12-10 17:36:22,53,2087,19,34,1299.39,2122.74,0.00
2024-12-10 17:36:22,53,2088,19,34,1334.06,2123.00,0.00
2024-12-10 17:36:22,54,2088,19,35,1309.36,2123.02,0.00
2024-12-10 17:36:22,54,2089,19,35,1306.27,2124.00,0.00
2024-12-10 17:36:22,55,2089,19,36,1282.52,2124.02,0.00
2024-12-10 17:36:22,54,2089,19,35,1298.83,2124.06,0.00
2024-12-10 17:36:22,54,2090,19,35,1302.91,2125.00,0.00
2024-12-10 17:36:22,55,2090,19,36,1279.22,2125.02,0.00
2024-12-10 17:36:22,54,2090,18,36,1284.33,2125.52,0.00
2024-12-10 17:36:22,53,2090,17,36,1305.53,2125.62,0.00
2024-12-10 17:36:22,53,2091,17,36,1337.88,2126.00,0.00
2024-12-10 17:36:22,54,2091,17,37,1313.10,2126.02,0.00
2024-12-10 17:36:22,53,2091,17,36,1329.86,2126.06,0.00
2024-12-10 17:36:22,52,2091,16,36,1341.49,2126.62,0.00
2024-12-10 17:36:23,52,2092,16,36,1374.53,2127.00,0.00
2024-12-10 17:36:23,53,2092,17,36,1348.60,2127.02,0.00
2024-12-10 17:36:23,53,2093,17,36,1355.07,2128.00,0.00
2024-12-10 17:36:23,54,2093,18,36,1329.98,2128.02,0.00
2024-12-10 17:36:23,54,2094,18,36,1331.52,2129.00,0.00
2024-12-10 17:36:23,55,2094,19,36,1307.31,2129.02,0.00
2024-12-10 17:36:23,54,2094,18,36,1313.21,2129.52,0.00
2024-12-10 17:36:23,54,2095,18,36,1327.39,2130.00,0.00
2024-12-10 17:36:23,55,2095,19,36,1303.25,2130.02,0.00
2024-12-10 17:36:23,54,2095,19,35,1321.08,2130.06,0.00
2024-12-10 17:36:23,53,2095,18,35,1313.53,2130.96,0.00
2024-12-10 17:36:23,53,2096,18,35,1352.95,2131.00,0.00
2024-12-10 17:36:23,54,2096,18,36,1327.90,2131.02,0.00
2024-12-10 17:36:23,53,2096,17,36,1336.93,2131.21,0.00
2024-12-10 17:36:23,53,2097,17,36,1360.83,2132.00,0.00
2024-12-10 17:36:23,54,2097,18,36,1335.63,2132.02,0.00
2024-12-10 17:36:23,53,2097,18,35,1353.20,2132.08,0.00
2024-12-10 17:36:23,53,2098,18,35,1358.25,2133.00,0.00
2024-12-10 17:36:23,54,2098,18,36,1333.09,2133.02,0.00
2024-12-10 17:36:23,53,2098,17,36,1323.51,2133.59,0.00
2024-12-10 17:36:23,53,2099,17,36,1355.26,2134.00,0.00
2024-12-10 17:36:23,54,2099,18,36,1330.16,2134.02,0.00
2024-12-10 17:36:23,53,2099,18,35,1348.02,2134.08,0.00
2024-12-10 17:36:23,52,2099,17,35,1364.71,2134.19,0.00
2024-12-10 17:36:23,52,2100,17,35,1389.10,2135.00,0.00
2024-12-10 17:36:23,53,2100,17,36,1362.89,2135.02,0.00
2024-12-10 17:36:23,53,2101,17,36,1358.69,2136.00,0.00
2024-12-10 17:36:23,54,2101,17,37,1333.53,2136.02,0.00
2024-12-10 17:36:23,53,2101,17,36,1351.05,2136.08,0.00
2024-12-10 17:36:23,53,2102,17,36,1356.10,2137.00,0.00
2024-12-10 17:36:23,54,2102,17,37,1330.99,2137.02,0.00
2024-12-10 17:36:23,54,2103,17,37,1327.00,2138.00,0.00
2024-12-10 17:36:23,55,2103,17,38,1302.87,2138.02,0.00
2024-12-10 17:36:23,54,2103,17,37,1319.48,2138.07,0.00
2024-12-10 17:36:23,53,2103,16,37,1335.03,2138.25,0.00
2024-12-10 17:36:23,53,2104,16,37,1359.79,2139.00,0.00
2024-12-10 17:36:23,54,2104,16,38,1334.61,2139.02,0.00
2024-12-10 17:36:23,53,2104,16,37,1359.39,2139.02,0.00
2024-12-10 17:36:23,53,2105,16,37,1355.54,2140.00,0.00
2024-12-10 17:36:23,54,2105,17,37,1330.43,2140.02,0.00
2024-12-10 17:36:23,53,2105,17,36,1348.68,2140.06,0.00
2024-12-10 17:36:23,52,2105,16,36,1358.35,2140.37,0.00
2024-12-10 17:36:23,52,2106,16,36,1386.42,2141.00,0.00
2024-12-10 17:36:23,53,2106,17,36,1360.26,2141.02,0.00
2024-12-10 17:36:23,52,2106,16,36,1351.70,2141.56,0.00
2024-12-10 17:36:23,52,2107,16,36,1383.77,2142.00,0.00
2024-12-10 17:36:23,53,2107,16,37,1357.66,2142.02,0.00
2024-12-10 17:36:23,52,2107,16,36,1377.18,2142.06,0.00
2024-12-10 17:36:23,52,2108,16,36,1382.35,2143.00,0.00
2024-12-10 17:36:23,53,2108,16,37,1356.27,2143.02,0.00
2024-12-10 17:36:23,53,2109,16,37,1352.17,2144.00,0.00
2024-12-10 17:36:23,54,2109,17,37,1327.13,2144.02,0.00
2024-12-10 17:36:23,53,2109,17,36,1344.89,2144.06,0.00
2024-12-10 17:36:23,52,2109,16,36,1353.47,2144.39,0.00
2024-12-10 17:36:23,52,2110,16,36,1381.99,2145.00,0.00
2024-12-10 17:36:23,53,2110,16,37,1355.92,2145.02,0.00
2024-12-10 17:36:23,53,2111,16,37,1352.27,2146.00,0.00
2024-12-10 17:36:23,54,2111,17,37,1327.23,2146.02,0.00
2024-12-10 17:36:23,53,2111,17,36,1344.59,2146.06,0.00
2024-12-10 17:36:23,53,2112,17,36,1349.26,2147.00,0.00
2024-12-10 17:36:23,54,2112,18,36,1324.27,2147.02,0.00
2024-12-10 17:36:23,54,2113,18,36,1329.67,2148.00,0.00
2024-12-10 17:36:23,55,2113,18,37,1305.49,2148.02,0.00
2024-12-10 17:36:23,54,2113,17,37,1320.14,2148.09,0.00
2024-12-10 17:36:23,54,2114,17,37,1330.01,2149.00,0.00
2024-12-10 17:36:23,55,2114,18,37,1305.82,2149.02,0.00
2024-12-10 17:36:23,54,2114,17,37,1320.47,2149.09,0.00
2024-12-10 17:36:23,53,2114,16,37,1327.60,2149.43,0.00
2024-12-10 17:36:23,53,2115,16,37,1356.42,2150.00,0.00
2024-12-10 17:36:23,54,2115,17,37,1331.30,2150.02,0.00
2024-12-10 17:36:23,53,2115,17,36,1352.36,2150.06,0.00
2024-12-10 17:36:23,53,2116,17,36,1357.05,2151.00,0.00
2024-12-10 17:36:23,54,2116,17,37,1331.92,2151.02,0.00
2024-12-10 17:36:23,53,2116,16,37,1331.89,2151.08,0.00
2024-12-10 17:36:23,53,2117,16,37,1353.21,2152.00,0.00
2024-12-10 17:36:23,54,2117,16,38,1328.15,2152.02,0.00
2024-12-10 17:36:23,53,2117,16,37,1346.31,2152.06,0.00
2024-12-10 17:36:23,52,2117,15,37,1359.72,2152.64,0.00
2024-12-10 17:36:23,52,2118,15,37,1376.98,2153.00,0.00
2024-12-10 17:36:23,53,2118,15,38,1351.00,2153.02,0.00
2024-12-10 17:36:23,52,2118,14,38,1376.56,2153.02,0.00
2024-12-10 17:36:23,52,2119,14,38,1389.22,2154.00,0.00
2024-12-10 17:36:23,53,2119,15,38,1363.00,2154.02,0.00
2024-12-10 17:36:23,52,2119,15,37,1381.35,2154.04,0.00
2024-12-10 17:36:23,52,2120,15,37,1386.13,2155.00,0.00
2024-12-10 17:36:23,53,2120,16,37,1359.98,2155.02,0.00
2024-12-10 17:36:23,53,2121,16,37,1355.73,2156.00,0.00
2024-12-10 17:36:23,54,2121,16,38,1330.62,2156.02,0.00
2024-12-10 17:36:23,53,2121,16,37,1348.41,2156.04,0.00
2024-12-10 17:36:23,53,2122,16,37,1352.69,2157.00,0.00
2024-12-10 17:36:23,54,2122,17,37,1327.64,2157.02,0.00
2024-12-10 17:36:23,54,2123,17,37,1323.34,2158.00,0.00
2024-12-10 17:36:23,55,2123,17,38,1299.28,2158.02,0.00
2024-12-10 17:36:23,54,2123,17,37,1316.15,2158.04,0.00
2024-12-10 17:36:23,54,2124,17,37,1319.96,2159.00,0.00
2024-12-10 17:36:23,55,2124,18,37,1295.96,2159.02,0.00
2024-12-10 17:36:23,54,2124,17,37,1296.97,2159.67,0.00
2024-12-10 17:36:23,54,2125,17,37,1329.99,2160.00,0.00
2024-12-10 17:36:23,55,2125,17,38,1305.81,2160.02,0.00
2024-12-10 17:36:23,54,2125,17,37,1323.20,2160.04,0.00
2024-12-10 17:36:24,54,2126,17,37,1327.01,2161.00,0.00
2024-12-10 17:36:24,55,2126,18,37,1302.88,2161.02,0.00
2024-12-10 17:36:24,54,2126,17,37,1294.06,2161.91,0.00
2024-12-10 17:36:24,54,2127,17,37,1332.15,2162.00,0.00
2024-12-10 17:36:24,55,2127,17,38,1307.93,2162.02,0.00
2024-12-10 17:36:24,54,2127,17,37,1325.74,2162.04,0.00
2024-12-10 17:36:24,53,2127,16,37,1338.05,2162.64,0.00
2024-12-10 17:36:24,53,2128,16,37,1355.05,2163.00,0.00
2024-12-10 17:36:24,54,2128,17,37,1329.96,2163.02,0.00
2024-12-10 17:36:24,55,2127,18,37,1278.81,2163.96,0.00
2024-12-10 17:36:24,55,2128,18,37,1302.45,2164.00,0.00
2024-12-10 17:36:24,56,2128,19,37,1279.19,2164.02,0.00
2024-12-10 17:36:24,55,2128,19,36,1296.55,2164.04,0.00
2024-12-10 17:36:24,55,2129,19,36,1339.26,2165.00,0.00
2024-12-10 17:36:24,56,2129,19,37,1315.35,2165.02,0.00
2024-12-10 17:36:24,56,2130,19,37,1310.15,2166.00,0.00
2024-12-10 17:36:24,57,2130,19,38,1287.17,2166.02,0.00
2024-12-10 17:36:24,56,2130,18,38,1309.77,2166.02,0.00
2024-12-10 17:36:24,55,2130,18,37,1328.07,2166.02,0.00
2024-12-10 17:36:24,56,2129,19,37,1285.19,2166.96,0.00
2024-12-10 17:36:24,56,2130,19,37,1339.40,2167.00,0.00
2024-12-10 17:36:24,57,2130,20,37,1315.90,2167.02,0.00
2024-12-10 17:36:24,57,2131,20,37,1348.45,2168.00,0.00
2024-12-10 17:36:24,58,2131,20,38,1325.20,2168.02,0.00
2024-12-10 17:36:24,57,2131,20,37,1343.13,2168.02,0.00
2024-12-10 17:36:24,57,2132,20,37,1345.27,2169.00,0.00
2024-12-10 17:36:24,58,2132,21,37,1322.08,2169.02,0.00
2024-12-10 17:36:24,58,2133,21,37,1316.33,2170.00,0.00
2024-12-10 17:36:24,59,2133,22,37,1294.01,2170.02,0.00
2024-12-10 17:36:24,58,2133,22,36,1311.09,2170.02,0.00
2024-12-10 17:36:24,58,2134,22,36,1312.76,2171.00,0.00
2024-12-10 17:36:24,59,2134,23,36,1290.51,2171.02,0.00
2024-12-10 17:36:24,59,2135,23,36,1284.43,2172.00,0.00
2024-12-10 17:36:24,60,2135,24,36,1263.02,2172.02,0.00
2024-12-10 17:36:24,59,2135,24,35,1279.28,2172.02,0.00
2024-12-10 17:36:24,59,2136,24,35,1280.57,2173.00,0.00
2024-12-10 17:36:24,60,2136,24,36,1259.23,2173.02,0.00
2024-12-10 17:36:24,60,2137,24,36,1252.92,2174.00,0.00
2024-12-10 17:36:24,61,2137,24,37,1232.38,2174.02,0.00
2024-12-10 17:36:24,60,2137,24,36,1248.21,2174.02,0.00
2024-12-10 17:36:24,60,2138,24,36,1249.15,2175.00,0.00
2024-12-10 17:36:24,61,2138,24,37,1228.67,2175.02,0.00
2024-12-10 17:36:24,60,2138,23,37,1227.55,2175.35,0.00
2024-12-10 17:36:24,60,2139,23,37,1250.09,2176.00,0.00
2024-12-10 17:36:24,61,2139,23,38,1229.59,2176.02,0.00
2024-12-10 17:36:24,60,2139,23,37,1244.65,2176.02,0.00
2024-12-10 17:36:24,60,2140,23,37,1245.58,2177.00,0.00
2024-12-10 17:36:24,61,2140,23,38,1225.16,2177.02,0.00
2024-12-10 17:36:24,60,2140,22,38,1218.94,2177.45,0.00
2024-12-10 17:36:24,60,2141,22,38,1243.61,2178.00,0.00
2024-12-10 17:36:24,61,2141,23,38,1223.23,2178.02,0.00
2024-12-10 17:36:24,60,2141,23,37,1238.53,2178.02,0.00
2024-12-10 17:36:24,60,2142,23,37,1239.46,2179.00,0.00
2024-12-10 17:36:24,61,2142,23,38,1219.14,2179.02,0.00
2024-12-10 17:36:24,61,2143,23,38,1213.71,2180.00,0.00
2024-12-10 17:36:24,62,2143,23,39,1194.14,2180.02,0.00
2024-12-10 17:36:24,61,2143,23,38,1209.07,2180.02,0.00
2024-12-10 17:36:24,61,2144,23,38,1209.62,2181.00,0.00
2024-12-10 17:36:24,62,2144,23,39,1190.11,2181.02,0.00
2024-12-10 17:36:24,61,2144,22,39,1191.22,2181.10,0.00
2024-12-10 17:36:24,60,2144,21,39,1199.00,2181.65,0.00
2024-12-10 17:36:24,60,2145,21,39,1227.97,2182.00,0.00
2024-12-10 17:36:24,61,2145,21,40,1207.84,2182.02,0.00
2024-12-10 17:36:24,60,2145,21,39,1223.24,2182.02,0.00
2024-12-10 17:36:24,60,2146,21,39,1224.16,2183.00,0.00
2024-12-10 17:36:24,61,2146,21,40,1204.09,2183.02,0.00
2024-12-10 17:36:24,60,2146,20,40,1209.68,2183.22,0.00
2024-12-10 17:36:24,60,2147,20,40,1229.46,2184.00,0.00
2024-12-10 17:36:24,61,2147,21,40,1209.30,2184.02,0.00
2024-12-10 17:36:24,60,2147,21,39,1225.09,2184.02,0.00
2024-12-10 17:36:24,59,2147,20,39,1223.87,2184.51,0.00
2024-12-10 17:36:24,59,2148,20,39,1250.50,2185.00,0.00
2024-12-10 17:36:24,60,2148,21,39,1229.65,2185.02,0.00
2024-12-10 17:36:24,59,2148,20,39,1227.15,2185.71,0.00
2024-12-10 17:36:24,59,2149,20,39,1258.11,2186.00,0.00
2024-12-10 17:36:24,60,2149,20,40,1237.14,2186.02,0.00
2024-12-10 17:36:24,59,2149,20,39,1254.03,2186.02,0.00
2024-12-10 17:36:24,59,2150,20,39,1255.35,2187.00,0.00
2024-12-10 17:36:24,60,2150,21,39,1234.43,2187.02,0.00
2024-12-10 17:36:24,60,2151,21,39,1228.74,2188.00,0.00
2024-12-10 17:36:24,61,2151,22,39,1208.60,2188.02,0.00
2024-12-10 17:36:24,60,2151,22,38,1224.73,2188.02,0.00
2024-12-10 17:36:24,60,2152,22,38,1225.66,2189.00,0.00
2024-12-10 17:36:24,61,2152,22,39,1205.56,2189.02,0.00
2024-12-10 17:36:24,61,2153,22,39,1199.58,2190.00,0.00
2024-12-10 17:36:24,62,2153,22,40,1180.24,2190.02,0.00
2024-12-10 17:36:24,61,2153,22,39,1196.00,2190.02,0.00
2024-12-10 17:36:24,60,2153,21,39,1202.01,2190.67,0.00
2024-12-10 17:36:24,59,2153,20,39,1208.93,2190.97,0.00
2024-12-10 17:36:24,59,2154,20,39,1245.34,2191.00,0.00
2024-12-10 17:36:24,60,2154,21,39,1224.58,2191.02,0.00
2024-12-10 17:36:24,59,2154,20,39,1233.83,2191.02,0.00
2024-12-10 17:36:24,59,2155,20,39,1242.56,2192.00,0.00
2024-12-10 17:36:24,60,2155,20,40,1221.86,2192.02,0.00
2024-12-10 17:36:24,59,2155,20,39,1238.48,2192.02,0.00
2024-12-10 17:36:24,58,2155,19,39,1258.25,2192.09,0.00
2024-12-10 17:36:24,57,2155,18,39,1267.17,2192.68,0.00
2024-12-10 17:36:24,57,2156,18,39,1283.58,2193.00,0.00
2024-12-10 17:36:24,58,2156,18,40,1261.45,2193.02,0.00
2024-12-10 17:36:24,57,2156,17,40,1260.13,2193.09,0.00
2024-12-10 17:36:25,57,2157,17,40,1279.16,2194.00,0.00
2024-12-10 17:36:25,58,2157,17,41,1257.11,2194.02,0.00
2024-12-10 17:36:25,57,2157,17,40,1275.55,2194.02,0.00
2024-12-10 17:36:25,57,2158,17,40,1277.67,2195.00,0.00
2024-12-10 17:36:25,58,2158,18,40,1255.64,2195.02,0.00
2024-12-10 17:36:25,58,2159,18,40,1249.78,2196.00,0.00
2024-12-10 17:36:25,59,2159,18,41,1228.59,2196.02,0.00
2024-12-10 17:36:25,58,2159,18,40,1246.37,2196.02,0.00
2024-12-10 17:36:25,58,2160,18,40,1248.07,2197.00,0.00
2024-12-10 17:36:25,59,2160,19,40,1226.92,2197.02,0.00
2024-12-10 17:36:25,59,2161,19,40,1220.77,2198.00,0.00
2024-12-10 17:36:25,60,2161,20,40,1200.43,2198.02,0.00
2024-12-10 17:36:25,59,2161,20,39,1217.79,2198.02,0.00
2024-12-10 17:36:25,58,2161,19,39,1211.66,2198.97,0.00
2024-12-10 17:36:25,58,2162,19,39,1248.83,2199.00,0.00
2024-12-10 17:36:25,59,2162,20,39,1227.66,2199.02,0.00
2024-12-10 17:36:25,59,2163,20,39,1221.51,2200.00,0.00
2024-12-10 17:36:25,60,2163,20,40,1201.15,2200.02,0.00
2024-12-10 17:36:25,59,2163,20,39,1218.90,2200.02,0.00
2024-12-10 17:36:25,59,2164,20,39,1220.20,2201.00,0.00
2024-12-10 17:36:25,60,2164,20,40,1199.86,2201.02,0.00
2024-12-10 17:36:25,59,2164,19,40,1206.83,2201.19,0.00
2024-12-10 17:36:25,59,2165,19,40,1226.73,2202.00,0.00
2024-12-10 17:36:25,60,2165,19,41,1206.28,2202.02,0.00
2024-12-10 17:36:25,59,2165,19,40,1222.99,2202.02,0.00
2024-12-10 17:36:25,60,2164,19,41,1193.60,2202.47,0.00
2024-12-10 17:36:25,60,2165,19,41,1217.48,2203.00,0.00
2024-12-10 17:36:25,61,2165,19,42,1197.52,2203.02,0.00
2024-12-10 17:36:25,60,2165,18,42,1189.61,2203.82,0.00
2024-12-10 17:36:25,60,2166,18,42,1259.17,2204.00,0.00
2024-12-10 17:36:25,61,2166,18,43,1238.53,2204.02,0.00
2024-12-10 17:36:25,60,2166,18,42,1255.50,2204.02,0.00
2024-12-10 17:36:25,59,2166,17,42,1255.69,2204.51,0.00
2024-12-10 17:36:25,59,2167,17,42,1282.59,2205.00,0.00
2024-12-10 17:36:25,60,2167,17,43,1261.21,2205.02,0.00
2024-12-10 17:36:25,60,2168,17,43,1255.37,2206.00,0.00
2024-12-10 17:36:25,61,2168,18,43,1234.79,2206.02,0.00
2024-12-10 17:36:25,60,2168,18,42,1251.70,2206.02,0.00
2024-12-10 17:36:25,60,2169,18,42,1252.63,2207.00,0.00
2024-12-10 17:36:25,61,2169,19,42,1232.10,2207.02,0.00
2024-12-10 17:36:25,60,2169,18,42,1230.67,2207.68,0.00
2024-12-10 17:36:25,59,2169,17,42,1243.05,2207.87,0.00
2024-12-10 17:36:25,59,2170,17,42,1277.60,2208.00,0.00
2024-12-10 17:36:25,60,2170,17,43,1256.30,2208.02,0.00
2024-12-10 17:36:25,59,2170,17,42,1274.23,2208.02,0.00
2024-12-10 17:36:25,58,2170,16,42,1280.92,2208.71,0.00
2024-12-10 17:36:25,58,2171,16,42,1297.55,2209.00,0.00
2024-12-10 17:36:25,59,2171,17,42,1275.55,2209.02,0.00
2024-12-10 17:36:25,58,2171,16,42,1261.33,2209.67,0.00
2024-12-10 17:36:25,58,2172,16,42,1292.47,2210.00,0.00
2024-12-10 17:36:25,59,2172,17,42,1270.56,2210.02,0.00
2024-12-10 17:36:25,58,2172,17,41,1289.42,2210.02,0.00
2024-12-10 17:36:25,57,2172,16,41,1309.37,2210.14,0.00
2024-12-10 17:36:25,57,2173,16,41,1314.19,2211.00,0.00
2024-12-10 17:36:25,58,2173,17,41,1291.53,2211.02,0.00
2024-12-10 17:36:25,57,2173,16,41,1303.75,2211.14,0.00
2024-12-10 17:36:25,57,2174,16,41,1308.57,2212.00,0.00
2024-12-10 17:36:25,58,2174,16,42,1286.01,2212.02,0.00
2024-12-10 17:36:25,57,2174,16,41,1305.86,2212.02,0.00
2024-12-10 17:36:25,57,2175,16,41,1308.00,2213.00,0.00
2024-12-10 17:36:25,58,2175,17,41,1285.45,2213.02,0.00
2024-12-10 17:36:25,57,2175,16,41,1273.60,2213.95,0.00
2024-12-10 17:36:25,57,2176,16,41,1311.31,2214.00,0.00
2024-12-10 17:36:25,58,2176,16,42,1288.70,2214.02,0.00
2024-12-10 17:36:25,57,2176,16,41,1308.98,2214.02,0.00
2024-12-10 17:36:25,57,2177,16,41,1311.12,2215.00,0.00
2024-12-10 17:36:25,58,2177,17,41,1288.52,2215.02,0.00
2024-12-10 17:36:25,58,2178,17,41,1282.61,2216.00,0.00
2024-12-10 17:36:25,59,2178,17,42,1260.87,2216.02,0.00
2024-12-10 17:36:25,58,2178,17,41,1279.93,2216.02,0.00
2024-12-10 17:36:25,58,2179,17,41,1281.65,2217.00,0.00
2024-12-10 17:36:25,59,2179,17,42,1259.93,2217.02,0.00
2024-12-10 17:36:25,59,2180,17,42,1253.73,2218.00,0.00
2024-12-10 17:36:25,60,2180,17,43,1232.84,2218.02,0.00
2024-12-10 17:36:25,59,2180,17,42,1251.48,2218.02,0.00
2024-12-10 17:36:25,58,2180,16,42,1270.42,2218.14,0.00
2024-12-10 17:36:25,57,2180,15,42,1274.44,2218.82,0.00
2024-12-10 17:36:25,57,2181,15,42,1309.60,2219.00,0.00
2024-12-10 17:36:25,58,2181,15,43,1287.02,2219.02,0.00
2024-12-10 17:36:25,58,2182,15,43,1281.09,2220.00,0.00
2024-12-10 17:36:25,59,2182,16,43,1259.38,2220.02,0.00
2024-12-10 17:36:25,58,2182,16,42,1278.80,2220.02,0.00
2024-12-10 17:36:25,57,2182,15,42,1298.54,2220.14,0.00
2024-12-10 17:36:25,56,2182,14,42,1300.00,2220.89,0.00
2024-12-10 17:36:25,56,2183,14,42,1337.36,2221.00,0.00
2024-12-10 17:36:25,57,2183,14,43,1313.90,2221.02,0.00
2024-12-10 17:36:25,56,2183,13,43,1326.65,2221.02,0.00
2024-12-10 17:36:25,56,2184,13,43,1337.17,2222.00,0.00
2024-12-10 17:36:25,57,2184,13,44,1313.71,2222.02,0.00
2024-12-10 17:36:25,57,2185,13,44,1308.07,2223.00,0.00
2024-12-10 17:36:25,58,2185,14,44,1285.52,2223.02,0.00
2024-12-10 17:36:25,57,2185,14,43,1302.62,2223.07,0.00
2024-12-10 17:36:25,56,2185,13,43,1303.32,2223.88,0.00
2024-12-10 17:36:25,56,2186,13,43,1340.36,2224.00,0.00
2024-12-10 17:36:25,57,2186,14,43,1316.84,2224.02,0.00
2024-12-10 17:36:25,56,2186,13,43,1329.67,2224.14,0.00
2024-12-10 17:36:25,55,2186,12,43,1336.06,2224.82,0.00
2024-12-10 17:36:25,55,2187,12,43,1372.62,2225.00,0.00
2024-12-10 17:36:25,56,2187,12,44,1348.11,2225.02,0.00
2024-12-10 17:36:25,55,2187,12,43,1366.56,2225.07,0.00
2024-12-10 17:36:25,55,2188,12,43,1370.81,2226.00,0.00
2024-12-10 17:36:25,56,2188,12,44,1346.33,2226.02,0.00
2024-12-10 17:36:26,56,2189,12,44,1340.97,2227.00,0.00
2024-12-10 17:36:26,57,2189,12,45,1317.45,2227.02,0.00
2024-12-10 17:36:26,56,2189,12,44,1335.02,2227.07,0.00
2024-12-10 17:36:26,56,2190,12,44,1338.79,2228.00,0.00
2024-12-10 17:36:26,57,2190,13,44,1315.30,2228.02,0.00
2024-12-10 17:36:26,57,2191,13,44,1310.84,2229.00,0.00
2024-12-10 17:36:26,58,2191,14,44,1288.24,2229.02,0.00
2024-12-10 17:36:26,57,2191,14,43,1303.80,2229.07,0.00
2024-12-10 17:36:26,57,2192,14,43,1307.12,2230.00,0.00
2024-12-10 17:36:26,58,2192,14,44,1284.58,2230.02,0.00
2024-12-10 17:36:26,57,2192,13,44,1296.18,2230.16,0.00
2024-12-10 17:36:26,56,2192,12,44,1318.54,2230.18,0.00
2024-12-10 17:36:26,55,2192,11,44,1330.66,2230.71,0.00
2024-12-10 17:36:26,55,2193,11,44,1364.97,2231.00,0.00
2024-12-10 17:36:26,56,2193,12,44,1340.59,2231.02,0.00
2024-12-10 17:36:26,55,2193,12,43,1358.89,2231.07,0.00
2024-12-10 17:36:26,54,2193,11,43,1369.60,2231.09,0.00
2024-12-10 17:36:26,54,2194,11,43,1391.28,2232.00,0.00
2024-12-10 17:36:26,55,2194,12,43,1365.98,2232.02,0.00
2024-12-10 17:36:26,54,2194,12,42,1390.05,2232.06,0.00
2024-12-10 17:36:26,54,2195,12,42,1396.67,2233.00,0.00
2024-12-10 17:36:26,55,2195,12,43,1371.27,2233.02,0.00
2024-12-10 17:36:26,55,2196,12,43,1370.61,2234.00,0.00
2024-12-10 17:36:26,56,2196,13,43,1346.14,2234.02,0.00
2024-12-10 17:36:26,56,2197,13,43,1340.75,2235.00,0.00
2024-12-10 17:36:26,57,2197,13,44,1317.23,2235.02,0.00
2024-12-10 17:36:26,56,2197,13,43,1336.37,2235.07,0.00
2024-12-10 17:36:26,56,2198,13,43,1340.15,2236.00,0.00
2024-12-10 17:36:26,57,2198,13,44,1316.64,2236.02,0.00
2024-12-10 17:36:26,57,2199,13,44,1310.95,2237.00,0.00
2024-12-10 17:36:26,58,2199,13,45,1288.35,2237.02,0.00
2024-12-10 17:36:26,57,2199,13,44,1305.86,2237.07,0.00
2024-12-10 17:36:26,56,2199,12,44,1302.57,2237.96,0.00
2024-12-10 17:36:26,56,2200,12,44,1341.75,2238.00,0.00
2024-12-10 17:36:26,57,2200,13,44,1318.21,2238.02,0.00
2024-12-10 17:36:26,57,2201,13,44,1312.52,2239.00,0.00
2024-12-10 17:36:26,58,2201,14,44,1289.89,2239.02,0.00
2024-12-10 17:36:26,57,2201,14,43,1307.42,2239.07,0.00
2024-12-10 17:36:26,56,2201,13,43,1328.80,2239.16,0.00
2024-12-10 17:36:26,56,2202,13,43,1334.55,2240.00,0.00
2024-12-10 17:36:26,57,2202,14,43,1311.14,2240.02,0.00
2024-12-10 17:36:26,57,2203,14,43,1305.46,2241.00,0.00
2024-12-10 17:36:26,58,2203,15,43,1282.95,2241.02,0.00
2024-12-10 17:36:26,57,2203,15,42,1299.18,2241.07,0.00
2024-12-10 17:36:26,56,2203,14,42,1309.47,2241.66,0.00
2024-12-10 17:36:26,56,2204,14,42,1326.13,2242.00,0.00
2024-12-10 17:36:26,57,2204,14,43,1302.87,2242.02,0.00
2024-12-10 17:36:26,57,2205,14,43,1297.15,2243.00,0.00
2024-12-10 17:36:26,58,2205,14,44,1274.79,2243.02,0.00
2024-12-10 17:36:26,57,2205,14,43,1291.26,2243.07,0.00
2024-12-10 17:36:26,57,2206,14,43,1294.58,2244.00,0.00
2024-12-10 17:36:26,58,2206,14,44,1272.26,2244.02,0.00
2024-12-10 17:36:26,58,2207,14,44,1266.42,2245.00,0.00
2024-12-10 17:36:26,59,2207,15,44,1244.95,2245.02,0.00
2024-12-10 17:36:26,58,2207,15,43,1261.00,2245.07,0.00
2024-12-10 17:36:26,57,2207,14,43,1265.03,2245.47,0.00
2024-12-10 17:36:26,57,2208,14,43,1292.98,2246.00,0.00
2024-12-10 17:36:26,58,2208,15,43,1270.69,2246.02,0.00
2024-12-10 17:36:26,57,2208,14,43,1258.81,2246.93,0.00
2024-12-10 17:36:26,57,2209,14,43,1296.71,2247.00,0.00
2024-12-10 17:36:26,58,2209,14,44,1274.35,2247.02,0.00
2024-12-10 17:36:26,57,2209,14,43,1294.34,2247.04,0.00
2024-12-10 17:36:26,57,2210,14,43,1296.89,2248.00,0.00
2024-12-10 17:36:26,58,2210,15,43,1274.53,2248.02,0.00
2024-12-10 17:36:26,57,2210,15,42,1296.50,2248.02,0.00
2024-12-10 17:36:26,56,2210,15,41,1315.64,2248.04,0.00
2024-12-10 17:36:26,56,2211,15,41,1318.63,2249.00,0.00
2024-12-10 17:36:26,57,2211,15,42,1295.49,2249.02,0.00
2024-12-10 17:36:26,57,2212,15,42,1289.75,2250.00,0.00
2024-12-10 17:36:26,58,2212,15,43,1267.52,2250.02,0.00
2024-12-10 17:36:26,57,2212,15,42,1286.20,2250.04,0.00
2024-12-10 17:36:26,56,2212,14,42,1283.17,2250.93,0.00
2024-12-10 17:36:26,56,2213,14,42,1321.81,2251.00,0.00
2024-12-10 17:36:26,57,2213,14,43,1298.62,2251.02,0.00
2024-12-10 17:36:26,57,2214,14,43,1292.88,2252.00,0.00
2024-12-10 17:36:26,58,2214,15,43,1270.59,2252.02,0.00
2024-12-10 17:36:26,57,2214,15,42,1289.32,2252.04,0.00
2024-12-10 17:36:26,57,2215,15,42,1291.87,2253.00,0.00
2024-12-10 17:36:26,58,2215,16,42,1269.60,2253.02,0.00
2024-12-10 17:36:26,58,2216,16,42,1263.55,2254.00,0.00
2024-12-10 17:36:26,59,2216,16,43,1242.14,2254.02,0.00
2024-12-10 17:36:26,58,2216,16,42,1260.45,2254.03,0.00
2024-12-10 17:36:26,58,2217,16,42,1262.56,2255.00,0.00
2024-12-10 17:36:26,59,2217,16,43,1241.16,2255.02,0.00
2024-12-10 17:36:26,58,2217,15,43,1248.63,2255.22,0.00
2024-12-10 17:36:26,58,2218,15,43,1270.51,2256.00,0.00
2024-12-10 17:36:26,59,2218,16,43,1248.97,2256.02,0.00
2024-12-10 17:36:26,58,2218,16,42,1267.79,2256.03,0.00
2024-12-10 17:36:26,58,2219,16,42,1269.90,2257.00,0.00
2024-12-10 17:36:26,59,2219,17,42,1248.38,2257.02,0.00
2024-12-10 17:36:26,58,2219,16,42,1257.89,2257.19,0.00
2024-12-10 17:36:26,58,2220,16,42,1279.03,2258.00,0.00
2024-12-10 17:36:26,59,2220,16,43,1257.35,2258.02,0.00
2024-12-10 17:36:26,58,2220,16,42,1276.70,2258.03,0.00
2024-12-10 17:36:26,58,2221,16,42,1278.82,2259.00,0.00
2024-12-10 17:36:26,59,2221,16,43,1257.14,2259.02,0.00
2024-12-10 17:36:26,59,2222,16,43,1250.81,2260.00,0.00
2024-12-10 17:36:26,60,2222,17,43,1229.96,2260.02,0.00
2024-12-10 17:36:26,59,2222,17,42,1248.89,2260.03,0.00
2024-12-10 17:36:26,59,2223,17,42,1250.59,2261.00,0.00
2024-12-10 17:36:26,60,2223,17,43,1229.75,2261.02,0.00
2024-12-10 17:36:27,60,2224,17,43,1223.13,2262.00,0.00
2024-12-10 17:36:27,61,2224,18,43,1203.08,2262.02,0.00
2024-12-10 17:36:27,60,2224,18,42,1220.87,2262.03,0.00
2024-12-10 17:36:27,59,2224,17,42,1213.11,2262.66,0.00
2024-12-10 17:36:27,59,2225,17,42,1244.03,2263.00,0.00
2024-12-10 17:36:27,60,2225,18,42,1223.29,2263.02,0.00
2024-12-10 17:36:27,59,2225,17,42,1223.99,2263.56,0.00
2024-12-10 17:36:27,59,2226,17,42,1237.34,2264.00,0.00
2024-12-10 17:36:27,60,2226,18,42,1216.72,2264.02,0.00
2024-12-10 17:36:27,59,2226,18,41,1234.65,2264.03,0.00
2024-12-10 17:36:27,59,2227,18,41,1236.35,2265.00,0.00
2024-12-10 17:36:27,60,2227,18,42,1215.75,2265.02,0.00
2024-12-10 17:36:27,60,2228,18,42,1209.11,2266.00,0.00
2024-12-10 17:36:27,61,2228,19,42,1189.28,2266.02,0.00
2024-12-10 17:36:27,60,2228,18,42,1208.73,2266.02,0.00
2024-12-10 17:36:27,59,2228,18,41,1227.29,2266.02,0.00
2024-12-10 17:36:27,58,2228,17,41,1233.75,2266.36,0.00
2024-12-10 17:36:27,58,2229,17,41,1258.78,2267.00,0.00
2024-12-10 17:36:27,59,2229,17,42,1237.44,2267.02,0.00
2024-12-10 17:36:27,59,2230,17,42,1231.07,2268.00,0.00
2024-12-10 17:36:27,60,2230,18,42,1210.55,2268.02,0.00
2024-12-10 17:36:27,59,2230,18,41,1229.15,2268.02,0.00
2024-12-10 17:36:27,58,2230,17,41,1225.17,2268.57,0.00
2024-12-10 17:36:27,57,2230,16,41,1244.34,2268.67,0.00
2024-12-10 17:36:27,57,2231,16,41,1276.82,2269.00,0.00
2024-12-10 17:36:27,58,2231,16,42,1254.80,2269.02,0.00
2024-12-10 17:36:27,57,2231,15,42,1248.55,2269.79,0.00
2024-12-10 17:36:27,57,2232,15,42,1283.75,2270.00,0.00
2024-12-10 17:36:27,58,2232,16,42,1261.62,2270.02,0.00
2024-12-10 17:36:27,57,2232,16,41,1282.16,2270.02,0.00
2024-12-10 17:36:27,56,2232,15,41,1284.78,2270.79,0.00
2024-12-10 17:36:27,56,2233,15,41,1320.63,2271.00,0.00
2024-12-10 17:36:27,57,2233,16,41,1297.46,2271.02,0.00
2024-12-10 17:36:27,57,2234,16,41,1291.66,2272.00,0.00
2024-12-10 17:36:27,58,2234,17,41,1269.39,2272.02,0.00
2024-12-10 17:36:27,57,2234,17,40,1290.46,2272.02,0.00
2024-12-10 17:36:27,57,2235,17,40,1292.63,2273.00,0.00
2024-12-10 17:36:27,58,2235,18,40,1270.34,2273.02,0.00
2024-12-10 17:36:27,58,2236,18,40,1264.23,2274.00,0.00
2024-12-10 17:36:27,59,2236,19,40,1242.81,2274.02,0.00
2024-12-10 17:36:27,58,2236,19,39,1263.06,2274.02,0.00
2024-12-10 17:36:27,57,2236,18,39,1277.16,2274.37,0.00
2024-12-10 17:36:27,57,2237,18,39,1287.17,2275.00,0.00
2024-12-10 17:36:27,58,2237,18,40,1264.98,2275.02,0.00
2024-12-10 17:36:27,57,2237,17,40,1249.16,2275.67,0.00
2024-12-10 17:36:27,57,2238,17,40,1281.75,2276.00,0.00
2024-12-10 17:36:27,58,2238,18,40,1259.65,2276.02,0.00
2024-12-10 17:36:27,57,2238,18,39,1279.75,2276.02,0.00
2024-12-10 17:36:27,56,2238,17,39,1273.64,2276.64,0.00
2024-12-10 17:36:27,56,2239,17,39,1306.43,2277.00,0.00
2024-12-10 17:36:27,57,2239,18,39,1283.51,2277.02,0.00
2024-12-10 17:36:27,57,2240,18,39,1277.68,2278.00,0.00
2024-12-10 17:36:27,58,2240,18,40,1255.65,2278.02,0.00
2024-12-10 17:36:27,57,2240,18,39,1276.08,2278.02,0.00
2024-12-10 17:36:27,57,2241,18,39,1278.24,2279.00,0.00
2024-12-10 17:36:27,58,2241,18,40,1256.20,2279.02,0.00
2024-12-10 17:36:27,58,2242,18,40,1250.07,2280.00,0.00
2024-12-10 17:36:27,59,2242,19,40,1228.88,2280.02,0.00
2024-12-10 17:36:27,58,2242,19,39,1248.89,2280.02,0.00
2024-12-10 17:36:27,57,2242,18,39,1247.24,2280.86,0.00
2024-12-10 17:36:27,57,2243,18,39,1284.16,2281.00,0.00
2024-12-10 17:36:27,58,2243,18,40,1262.02,2281.02,0.00
2024-12-10 17:36:27,58,2244,18,40,1255.89,2282.00,0.00
2024-12-10 17:36:27,59,2244,19,40,1234.60,2282.02,0.00
2024-12-10 17:36:27,58,2244,19,39,1255.49,2282.02,0.00
2024-12-10 17:36:27,57,2244,18,39,1268.00,2282.30,0.00
2024-12-10 17:36:27,57,2245,18,39,1292.50,2283.00,0.00
2024-12-10 17:36:27,58,2245,18,40,1270.21,2283.02,0.00
2024-12-10 17:36:27,57,2245,18,39,1284.09,2283.02,0.00
2024-12-10 17:36:27,57,2246,18,39,1286.25,2284.00,0.00
2024-12-10 17:36:27,58,2246,19,39,1264.08,2284.02,0.00
2024-12-10 17:36:27,57,2246,19,38,1277.84,2284.02,0.00
2024-12-10 17:36:27,57,2247,19,38,1280.00,2285.00,0.00
2024-12-10 17:36:27,58,2247,19,39,1257.93,2285.02,0.00
2024-12-10 17:36:27,57,2247,19,38,1271.58,2285.02,0.00
2024-12-10 17:36:27,56,2247,18,38,1290.67,2285.18,0.00
2024-12-10 17:36:27,56,2248,18,38,1313.23,2286.00,0.00
2024-12-10 17:36:27,57,2248,18,39,1290.19,2286.02,0.00
2024-12-10 17:36:27,56,2248,17,39,1292.52,2286.34,0.00
2024-12-10 17:36:27,56,2249,17,39,1318.70,2287.00,0.00
2024-12-10 17:36:27,57,2249,17,40,1295.57,2287.02,0.00
2024-12-10 17:36:27,56,2249,17,39,1317.88,2287.02,0.00
2024-12-10 17:36:27,55,2249,16,39,1314.26,2287.58,0.00
2024-12-10 17:36:27,55,2250,16,39,1346.59,2288.00,0.00
2024-12-10 17:36:27,56,2250,17,39,1322.55,2288.02,0.00
2024-12-10 17:36:27,55,2250,16,39,1313.78,2288.87,0.00
2024-12-10 17:36:27,55,2251,16,39,1352.59,2289.00,0.00
2024-12-10 17:36:27,56,2251,16,40,1328.44,2289.02,0.00
2024-12-10 17:36:27,55,2251,16,39,1350.93,2289.02,0.00
2024-12-10 17:36:27,55,2252,16,39,1354.01,2290.00,0.00
2024-12-10 17:36:27,56,2252,16,40,1329.84,2290.02,0.00
2024-12-10 17:36:27,56,2253,16,40,1324.28,2291.00,0.00
2024-12-10 17:36:27,57,2253,17,40,1301.05,2291.02,0.00
2024-12-10 17:36:27,56,2253,17,39,1322.64,2291.02,0.00
2024-12-10 17:36:27,55,2253,16,39,1318.09,2291.96,0.00
2024-12-10 17:36:27,55,2254,16,39,1358.95,2292.00,0.00
2024-12-10 17:36:27,56,2254,16,40,1334.68,2292.02,0.00
2024-12-10 17:36:27,55,2254,15,40,1322.96,2292.60,0.00
2024-12-10 17:36:28,55,2255,15,40,1355.79,2293.00,0.00
2024-12-10 17:36:28,56,2255,15,41,1331.58,2293.02,0.00
2024-12-10 17:36:28,55,2255,15,40,1354.12,2293.02,0.00
2024-12-10 17:36:28,55,2256,15,40,1357.21,2294.00,0.00
2024-12-10 17:36:28,56,2256,16,40,1332.98,2294.02,0.00
2024-12-10 17:36:28,56,2257,16,40,1327.38,2295.00,0.00
2024-12-10 17:36:28,57,2257,17,40,1304.10,2295.02,0.00
2024-12-10 17:36:28,56,2257,17,39,1326.15,2295.02,0.00
2024-12-10 17:36:28,56,2258,17,39,1328.65,2296.00,0.00
2024-12-10 17:36:28,57,2258,17,40,1305.34,2296.02,0.00
2024-12-10 17:36:28,57,2259,17,40,1299.18,2297.00,0.00
2024-12-10 17:36:28,58,2259,17,41,1276.78,2297.02,0.00
2024-12-10 17:36:28,57,2259,17,40,1298.38,2297.02,0.00
2024-12-10 17:36:28,57,2260,17,40,1299.61,2298.00,0.00
2024-12-10 17:36:28,58,2260,17,41,1277.21,2298.02,0.00
2024-12-10 17:36:28,58,2261,17,41,1269.44,2299.00,0.00
2024-12-10 17:36:28,59,2261,17,42,1247.93,2299.02,0.00
2024-12-10 17:36:28,58,2261,17,41,1269.04,2299.02,0.00
2024-12-10 17:36:28,58,2262,17,41,1268.81,2300.00,0.00
2024-12-10 17:36:28,59,2262,17,42,1247.31,2300.02,0.00
2024-12-10 17:36:28,59,2263,17,42,1238.50,2301.00,0.00
2024-12-10 17:36:28,60,2263,17,43,1217.86,2301.02,0.00
2024-12-10 17:36:28,59,2263,17,42,1237.33,2301.03,0.00
2024-12-10 17:36:28,58,2263,16,42,1238.74,2301.74,0.00
2024-12-10 17:36:28,58,2264,16,42,1272.67,2302.00,0.00
2024-12-10 17:36:28,59,2264,17,42,1251.10,2302.02,0.00
2024-12-10 17:36:28,58,2264,16,42,1251.23,2302.53,0.00
2024-12-10 17:36:28,57,2264,15,42,1259.70,2302.90,0.00
2024-12-10 17:36:28,57,2265,15,42,1297.76,2303.00,0.00
2024-12-10 17:36:28,58,2265,15,43,1275.39,2303.02,0.00
2024-12-10 17:36:28,57,2265,15,42,1296.15,2303.04,0.00
2024-12-10 17:36:28,57,2266,15,42,1298.73,2304.00,0.00
2024-12-10 17:36:28,58,2266,15,43,1276.34,2304.02,0.00
2024-12-10 17:36:28,58,2267,15,43,1270.13,2305.00,0.00
2024-12-10 17:36:28,59,2267,15,44,1248.61,2305.02,0.00
2024-12-10 17:36:28,58,2267,15,43,1268.94,2305.03,0.00
2024-12-10 17:36:28,57,2267,14,43,1263.02,2305.97,0.00
2024-12-10 17:36:28,57,2268,14,43,1302.69,2306.00,0.00
2024-12-10 17:36:28,58,2268,14,44,1280.23,2306.02,0.00
2024-12-10 17:36:28,57,2268,13,44,1282.87,2306.07,0.00
2024-12-10 17:36:28,56,2268,12,44,1302.53,2306.20,0.00
2024-12-10 17:36:28,56,2269,12,44,1325.70,2307.00,0.00
2024-12-10 17:36:28,57,2269,13,44,1302.44,2307.02,0.00
2024-12-10 17:36:28,56,2269,13,43,1324.88,2307.04,0.00
2024-12-10 17:36:28,56,2270,13,43,1327.92,2308.00,0.00
2024-12-10 17:36:28,57,2270,14,43,1304.63,2308.02,0.00
2024-12-10 17:36:28,57,2271,14,43,1298.71,2309.00,0.00
2024-12-10 17:36:28,58,2271,15,43,1276.32,2309.02,0.00
2024-12-10 17:36:28,57,2271,15,42,1297.50,2309.04,0.00
2024-12-10 17:36:28,57,2272,15,42,1300.08,2310.00,0.00
2024-12-10 17:36:28,58,2272,16,42,1277.67,2310.02,0.00
2024-12-10 17:36:28,58,2273,16,42,1271.45,2311.00,0.00
2024-12-10 17:36:28,59,2273,16,43,1249.90,2311.02,0.00
2024-12-10 17:36:28,58,2273,16,42,1269.86,2311.03,0.00
2024-12-10 17:36:28,57,2273,15,42,1276.64,2311.70,0.00
2024-12-10 17:36:28,57,2274,15,42,1294.31,2312.00,0.00
2024-12-10 17:36:28,58,2274,15,43,1272.00,2312.02,0.00
2024-12-10 17:36:28,58,2275,15,43,1265.77,2313.00,0.00
2024-12-10 17:36:28,59,2275,15,44,1244.32,2313.02,0.00
2024-12-10 17:36:28,58,2275,15,43,1264.18,2313.03,0.00
2024-12-10 17:36:28,57,2275,14,43,1258.07,2313.97,0.00
2024-12-10 17:36:28,57,2276,14,43,1297.87,2314.00,0.00
2024-12-10 17:36:28,58,2276,14,44,1275.49,2314.02,0.00
2024-12-10 17:36:28,57,2276,13,44,1265.59,2314.56,0.00
2024-12-10 17:36:28,57,2277,13,44,1296.39,2315.00,0.00
2024-12-10 17:36:28,58,2277,14,44,1274.03,2315.02,0.00
2024-12-10 17:36:28,57,2277,14,43,1295.17,2315.04,0.00
2024-12-10 17:36:28,56,2277,13,43,1286.43,2315.70,0.00
2024-12-10 17:36:28,56,2278,13,43,1321.00,2316.00,0.00
2024-12-10 17:36:28,57,2278,13,44,1297.83,2316.02,0.00
2024-12-10 17:36:28,57,2279,13,44,1291.16,2317.00,0.00
2024-12-10 17:36:28,58,2279,13,45,1268.90,2317.02,0.00
2024-12-10 17:36:28,57,2279,13,44,1290.35,2317.04,0.00
2024-12-10 17:36:28,57,2280,13,44,1291.81,2318.00,0.00
2024-12-10 17:36:28,58,2280,13,45,1269.54,2318.02,0.00
2024-12-10 17:36:28,57,2280,12,45,1263.97,2318.46,0.00
2024-12-10 17:36:28,57,2281,12,45,1292.44,2319.00,0.00
2024-12-10 17:36:28,58,2281,12,46,1270.16,2319.02,0.00
2024-12-10 17:36:28,57,2281,12,45,1290.41,2319.04,0.00
2024-12-10 17:36:28,56,2281,11,45,1302.78,2319.32,0.00
2024-12-10 17:36:28,55,2281,10,45,1323.21,2319.36,0.00
2024-12-10 17:36:28,55,2282,10,45,1351.08,2320.00,0.00
2024-12-10 17:36:28,56,2282,10,46,1326.96,2320.02,0.00
2024-12-10 17:36:28,56,2283,10,46,1321.31,2321.00,0.00
2024-12-10 17:36:29,57,2283,10,47,1298.13,2321.02,0.00
2024-12-10 17:36:29,56,2283,10,46,1320.90,2321.02,0.00
2024-12-10 17:36:29,55,2283,10,45,1343.65,2321.02,0.00
2024-12-10 17:36:29,54,2283,9,45,1353.61,2321.37,0.00
2024-12-10 17:36:29,54,2284,9,45,1382.45,2322.00,0.00
2024-12-10 17:36:29,55,2284,9,46,1357.31,2322.02,0.00
2024-12-10 17:36:29,54,2284,8,46,1353.26,2322.19,0.00
2024-12-10 17:36:29,54,2285,8,46,1377.88,2323.00,0.00
2024-12-10 17:36:29,55,2285,8,47,1352.83,2323.02,0.00
2024-12-10 17:36:29,54,2285,8,46,1375.31,2323.04,0.00
2024-12-10 17:36:29,54,2286,8,46,1379.34,2324.00,0.00
2024-12-10 17:36:29,55,2286,9,46,1354.26,2324.02,0.00
2024-12-10 17:36:29,54,2286,9,45,1370.30,2324.02,0.00
2024-12-10 17:36:29,53,2286,8,45,1392.69,2324.17,0.00
2024-12-10 17:36:29,52,2286,7,45,1419.03,2324.17,0.00
2024-12-10 17:36:29,51,2286,6,45,1440.05,2324.26,0.00
2024-12-10 17:36:29,51,2287,6,45,1468.85,2325.00,0.00
2024-12-10 17:36:29,52,2287,7,45,1440.61,2325.02,0.00
2024-12-10 17:36:29,52,2288,7,45,1436.30,2326.00,0.00
2024-12-10 17:36:29,53,2288,7,46,1409.20,2326.02,0.00
2024-12-10 17:36:29,52,2288,7,45,1434.52,2326.02,0.00
2024-12-10 17:36:29,53,2287,7,46,1400.55,2326.36,0.00
2024-12-10 17:36:29,53,2288,7,46,1430.01,2327.00,0.00
2024-12-10 17:36:29,54,2288,8,46,1403.53,2327.02,0.00
2024-12-10 17:36:29,54,2289,8,46,1441.64,2328.00,0.00
2024-12-10 17:36:29,55,2289,9,46,1415.42,2328.02,0.00
2024-12-10 17:36:29,54,2289,9,45,1440.34,2328.02,0.00
2024-12-10 17:36:29,54,2290,9,45,1443.98,2329.00,0.00
2024-12-10 17:36:29,55,2290,10,45,1417.73,2329.02,0.00
2024-12-10 17:36:29,55,2291,10,45,1412.40,2330.00,0.00
2024-12-10 17:36:29,56,2291,11,45,1387.18,2330.02,0.00
2024-12-10 17:36:29,55,2291,11,44,1411.56,2330.02,0.00
2024-12-10 17:36:29,54,2291,10,44,1408.51,2330.96,0.00
2024-12-10 17:36:29,54,2292,10,44,1450.83,2331.00,0.00
2024-12-10 17:36:29,55,2292,10,45,1424.45,2331.02,0.00
2024-12-10 17:36:29,55,2293,10,45,1419.13,2332.00,0.00
2024-12-10 17:36:29,56,2293,11,45,1393.79,2332.02,0.00
2024-12-10 17:36:29,55,2293,11,44,1417.86,2332.02,0.00
2024-12-10 17:36:29,55,2294,11,44,1421.01,2333.00,0.00
2024-12-10 17:36:29,56,2294,11,45,1395.63,2333.02,0.00
2024-12-10 17:36:29,55,2294,10,45,1392.62,2333.15,0.00
2024-12-10 17:36:29,55,2295,10,45,1415.68,2334.00,0.00
2024-12-10 17:36:29,56,2295,10,46,1390.40,2334.02,0.00
2024-12-10 17:36:29,55,2295,10,45,1414.83,2334.02,0.00
2024-12-10 17:36:29,55,2296,10,45,1417.98,2335.00,0.00
2024-12-10 17:36:29,56,2296,10,46,1392.66,2335.02,0.00
2024-12-10 17:36:29,55,2296,9,46,1377.56,2335.66,0.00
2024-12-10 17:36:29,55,2297,9,46,1412.22,2336.00,0.00
2024-12-10 17:36:29,56,2297,10,46,1387.00,2336.02,0.00
2024-12-10 17:36:29,55,2297,10,45,1410.10,2336.04,0.00
2024-12-10 17:36:29,54,2297,9,45,1409.66,2336.56,0.00
2024-12-10 17:36:29,54,2298,9,45,1442.88,2337.00,0.00
2024-12-10 17:36:29,55,2298,9,46,1416.65,2337.02,0.00
2024-12-10 17:36:29,55,2299,9,46,1411.30,2338.00,0.00
2024-12-10 17:36:29,56,2299,9,47,1386.10,2338.02,0.00
2024-12-10 17:36:29,55,2299,9,46,1410.88,2338.02,0.00
2024-12-10 17:36:29,55,2300,9,46,1414.03,2339.00,0.00
2024-12-10 17:36:29,56,2300,10,46,1388.78,2339.02,0.00
2024-12-10 17:36:29,55,2300,9,46,1385.54,2339.76,0.00
2024-12-10 17:36:29,55,2301,9,46,1422.72,2340.00,0.00
2024-12-10 17:36:29,56,2301,10,46,1397.31,2340.02,0.00
2024-12-10 17:36:29,55,2301,10,45,1421.87,2340.02,0.00
2024-12-10 17:36:29,55,2302,10,45,1425.03,2341.00,0.00
2024-12-10 17:36:29,56,2302,10,46,1399.58,2341.02,0.00
2024-12-10 17:36:29,56,2303,10,46,1393.91,2342.00,0.00
2024-12-10 17:36:29,57,2303,10,47,1369.45,2342.02,0.00
2024-12-10 17:36:29,56,2303,10,46,1392.24,2342.02,0.00
2024-12-10 17:36:29,55,2303,9,46,1388.32,2342.96,0.00
2024-12-10 17:36:29,55,2304,9,46,1430.08,2343.00,0.00
2024-12-10 17:36:29,56,2304,10,46,1404.54,2343.02,0.00
2024-12-10 17:36:29,56,2305,10,46,1398.87,2344.00,0.00
2024-12-10 17:36:29,57,2305,11,46,1374.32,2344.02,0.00
2024-12-10 17:36:29,56,2305,11,45,1397.19,2344.02,0.00
2024-12-10 17:36:29,56,2306,11,45,1399.88,2345.00,0.00
2024-12-10 17:36:29,57,2306,11,46,1375.32,2345.02,0.00
2024-12-10 17:36:29,56,2306,10,46,1366.87,2345.88,0.00
2024-12-10 17:36:29,56,2307,10,46,1405.92,2346.00,0.00
2024-12-10 17:36:29,57,2307,11,46,1381.26,2346.02,0.00
2024-12-10 17:36:29,56,2307,11,45,1404.25,2346.02,0.00
2024-12-10 17:36:29,56,2308,11,45,1406.94,2347.00,0.00
2024-12-10 17:36:29,57,2308,12,45,1382.26,2347.02,0.00
2024-12-10 17:36:29,57,2309,12,45,1376.26,2348.00,0.00
2024-12-10 17:36:29,58,2309,13,45,1352.53,2348.02,0.00
2024-12-10 17:36:29,57,2309,13,44,1372.96,2348.02,0.00
2024-12-10 17:36:29,57,2310,13,44,1375.19,2349.00,0.00
2024-12-10 17:36:29,58,2310,14,44,1351.48,2349.02,0.00
2024-12-10 17:36:29,57,2310,13,44,1350.82,2349.70,0.00
2024-12-10 17:36:29,57,2311,13,44,1368.77,2350.00,0.00
2024-12-10 17:36:29,58,2311,13,45,1345.17,2350.02,0.00
2024-12-10 17:36:29,57,2311,13,44,1365.06,2350.02,0.00
2024-12-10 17:36:29,56,2311,12,44,1365.98,2350.84,0.00
2024-12-10 17:36:29,56,2312,12,44,1404.30,2351.00,0.00
2024-12-10 17:36:29,57,2312,12,45,1379.67,2351.02,0.00
2024-12-10 17:36:29,57,2313,12,45,1373.65,2352.00,0.00
2024-12-10 17:36:29,58,2313,13,45,1349.97,2352.02,0.00
2024-12-10 17:36:29,57,2313,13,44,1370.35,2352.02,0.00
2024-12-10 17:36:29,57,2314,13,44,1372.58,2353.00,0.00
2024-12-10 17:36:29,58,2314,14,44,1348.92,2353.02,0.00
2024-12-10 17:36:29,58,2315,14,44,1342.59,2354.00,0.00
2024-12-10 17:36:29,59,2315,14,45,1319.84,2354.02,0.00
2024-12-10 17:36:29,58,2315,14,44,1338.13,2354.03,0.00
2024-12-10 17:36:30,58,2316,14,44,1340.32,2355.00,0.00
2024-12-10 17:36:30,59,2316,14,45,1317.60,2355.02,0.00
2024-12-10 17:36:30,59,2317,14,45,1322.18,2356.00,0.00
2024-12-10 17:36:30,60,2317,14,46,1300.14,2356.02,0.00
2024-12-10 17:36:30,60,2318,14,46,1299.73,2357.00,0.00
2024-12-10 17:36:30,61,2318,15,46,1278.42,2357.02,0.00
2024-12-10 17:36:30,60,2318,14,46,1269.63,2357.78,0.00
2024-12-10 17:36:30,60,2319,14,46,1303.97,2358.00,0.00
2024-12-10 17:36:30,61,2319,15,46,1282.60,2358.02,0.00
2024-12-10 17:36:30,60,2319,15,45,1300.05,2358.03,0.00
2024-12-10 17:36:30,60,2320,15,45,1301.38,2359.00,0.00
2024-12-10 17:36:30,61,2320,15,46,1280.05,2359.02,0.00
2024-12-10 17:36:30,60,2320,14,46,1269.97,2359.85,0.00
2024-12-10 17:36:30,60,2321,14,46,1305.87,2360.00,0.00
2024-12-10 17:36:30,61,2321,14,47,1284.46,2360.02,0.00
2024-12-10 17:36:30,60,2321,14,46,1302.72,2360.03,0.00
2024-12-10 17:36:30,60,2322,14,46,1304.06,2361.00,0.00
2024-12-10 17:36:30,61,2322,15,46,1282.68,2361.02,0.00
2024-12-10 17:36:30,60,2322,14,46,1271.06,2361.88,0.00
2024-12-10 17:36:30,60,2323,14,46,1307.76,2362.00,0.00
2024-12-10 17:36:30,61,2323,14,47,1286.32,2362.02,0.00
2024-12-10 17:36:30,60,2323,14,46,1305.01,2362.03,0.00
2024-12-10 17:36:30,60,2324,14,46,1306.34,2363.00,0.00
2024-12-10 17:36:30,61,2324,14,47,1284.93,2363.02,0.00
2024-12-10 17:36:30,60,2324,13,47,1289.89,2363.28,0.00
2024-12-10 17:36:30,60,2325,13,47,1312.81,2364.00,0.00
2024-12-10 17:36:30,61,2325,13,48,1291.29,2364.02,0.00
2024-12-10 17:36:30,60,2325,13,47,1310.05,2364.03,0.00
2024-12-10 17:36:30,60,2326,13,47,1311.39,2365.00,0.00
2024-12-10 17:36:30,61,2326,13,48,1289.89,2365.02,0.00
2024-12-10 17:36:30,60,2326,12,48,1278.34,2365.88,0.00
2024-12-10 17:36:30,60,2327,12,48,1315.10,2366.00,0.00
2024-12-10 17:36:30,61,2327,13,48,1293.54,2366.02,0.00
2024-12-10 17:36:30,60,2327,13,47,1312.74,2366.03,0.00
2024-12-10 17:36:30,60,2328,13,47,1314.08,2367.00,0.00
2024-12-10 17:36:30,61,2328,14,47,1292.54,2367.02,0.00
2024-12-10 17:36:30,60,2328,13,47,1275.71,2367.68,0.00
2024-12-10 17:36:30,60,2329,13,47,1307.93,2368.00,0.00
2024-12-10 17:36:30,61,2329,14,47,1286.48,2368.02,0.00
2024-12-10 17:36:30,60,2329,14,46,1305.56,2368.03,0.00
2024-12-10 17:36:30,59,2329,13,46,1323.33,2368.22,0.00
2024-12-10 17:36:30,59,2330,13,46,1329.45,2369.00,0.00
2024-12-10 17:36:30,60,2330,14,46,1307.29,2369.02,0.00
2024-12-10 17:36:30,60,2331,14,46,1300.34,2370.00,0.00
2024-12-10 17:36:30,61,2331,14,47,1279.02,2370.02,0.00
2024-12-10 17:36:30,60,2331,14,46,1298.37,2370.03,0.00
2024-12-10 17:36:30,60,2332,14,46,1299.70,2371.00,0.00
2024-12-10 17:36:30,61,2332,14,47,1278.40,2371.02,0.00
2024-12-10 17:36:30,61,2333,14,47,1271.16,2372.00,0.00
2024-12-10 17:36:30,62,2333,14,48,1250.66,2372.02,0.00
2024-12-10 17:36:30,61,2333,14,47,1268.83,2372.03,0.00
2024-12-10 17:36:30,60,2333,13,47,1273.69,2372.72,0.00
2024-12-10 17:36:30,60,2334,13,47,1306.73,2373.00,0.00
2024-12-10 17:36:30,61,2334,14,47,1285.31,2373.02,0.00
2024-12-10 17:36:30,61,2335,14,47,1278.07,2374.00,0.00
2024-12-10 17:36:30,62,2335,14,48,1257.45,2374.02,0.00
2024-12-10 17:36:30,61,2335,14,47,1276.12,2374.03,0.00
2024-12-10 17:36:30,61,2336,14,47,1277.05,2375.00,0.00
2024-12-10 17:36:30,62,2336,15,47,1256.45,2375.02,0.00
2024-12-10 17:36:30,62,2337,15,47,1248.93,2376.00,0.00
2024-12-10 17:36:30,63,2337,16,47,1229.11,2376.02,0.00
2024-12-10 17:36:30,62,2337,16,46,1247.40,2376.03,0.00
2024-12-10 17:36:30,63,2336,16,47,1212.43,2376.71,0.00
2024-12-10 17:36:30,63,2337,16,47,1235.66,2377.00,0.00
2024-12-10 17:36:30,64,2337,17,47,1216.36,2377.02,0.00
2024-12-10 17:36:30,64,2338,17,47,1245.48,2378.00,0.00
2024-12-10 17:36:30,65,2338,17,48,1226.32,2378.02,0.00
2024-12-10 17:36:30,64,2338,17,47,1244.36,2378.03,0.00
2024-12-10 17:36:30,63,2338,16,47,1235.92,2378.95,0.00
2024-12-10 17:36:30,63,2339,16,47,1272.58,2379.00,0.00
2024-12-10 17:36:30,64,2339,17,47,1252.69,2379.02,0.00
2024-12-10 17:36:30,63,2339,17,46,1271.44,2379.02,0.00
2024-12-10 17:36:30,63,2340,17,46,1271.22,2380.00,0.00
2024-12-10 17:36:30,64,2340,18,46,1251.36,2380.02,0.00
2024-12-10 17:36:30,63,2340,18,45,1263.29,2380.02,0.00
2024-12-10 17:36:30,63,2341,18,45,1263.06,2381.00,0.00
2024-12-10 17:36:30,64,2341,19,45,1243.33,2381.02,0.00
2024-12-10 17:36:30,63,2341,19,44,1255.13,2381.02,0.00
2024-12-10 17:36:30,63,2342,19,44,1254.90,2382.00,0.00
2024-12-10 17:36:30,64,2342,20,44,1235.29,2382.02,0.00
2024-12-10 17:36:30,63,2342,19,44,1231.75,2382.68,0.00
2024-12-10 17:36:30,63,2343,19,44,1247.10,2383.00,0.00
2024-12-10 17:36:30,64,2343,19,45,1227.62,2383.02,0.00
2024-12-10 17:36:30,63,2343,19,44,1246.72,2383.02,0.00
2024-12-10 17:36:30,63,2344,19,44,1246.49,2384.00,0.00
2024-12-10 17:36:30,64,2344,19,45,1227.01,2384.02,0.00
2024-12-10 17:36:30,63,2344,19,44,1238.54,2384.02,0.00
2024-12-10 17:36:30,63,2345,19,44,1238.31,2385.00,0.00
2024-12-10 17:36:30,64,2345,20,44,1218.96,2385.02,0.00
2024-12-10 17:36:30,63,2345,20,43,1230.36,2385.02,0.00
2024-12-10 17:36:30,62,2345,19,43,1245.27,2385.23,0.00
2024-12-10 17:36:30,61,2345,18,43,1243.96,2385.59,0.00
2024-12-10 17:36:30,62,2344,19,43,1217.90,2385.87,0.00
2024-12-10 17:36:30,62,2345,19,43,1256.50,2386.00,0.00
2024-12-10 17:36:30,63,2345,19,44,1236.55,2386.02,0.00
2024-12-10 17:36:30,62,2345,19,43,1248.42,2386.02,0.00
2024-12-10 17:36:30,61,2345,18,43,1253.15,2386.67,0.00
2024-12-10 17:36:31,61,2346,18,43,1308.15,2387.00,0.00
2024-12-10 17:36:31,62,2346,19,43,1287.05,2387.02,0.00
2024-12-10 17:36:31,61,2346,18,43,1284.58,2387.67,0.00
2024-12-10 17:36:31,61,2347,18,43,1300.48,2388.00,0.00
2024-12-10 17:36:31,62,2347,18,44,1279.51,2388.02,0.00
2024-12-10 17:36:31,61,2347,18,43,1298.92,2388.02,0.00
2024-12-10 17:36:31,60,2347,17,43,1315.06,2388.23,0.00
2024-12-10 17:36:31,61,2346,17,44,1289.27,2388.44,0.00
2024-12-10 17:36:31,60,2346,16,44,1321.67,2388.67,0.00
2024-12-10 17:36:31,60,2347,16,44,1337.84,2389.00,0.00
2024-12-10 17:36:31,61,2347,16,45,1315.91,2389.02,0.00
2024-12-10 17:36:31,61,2348,16,45,1347.81,2390.00,0.00
2024-12-10 17:36:31,62,2348,16,46,1326.07,2390.02,0.00
2024-12-10 17:36:31,61,2348,16,45,1346.63,2390.02,0.00
2024-12-10 17:36:31,60,2348,15,45,1363.95,2390.22,0.00
2024-12-10 17:36:31,59,2348,14,45,1362.84,2390.95,0.00
2024-12-10 17:36:31,59,2349,14,45,1402.18,2391.00,0.00
2024-12-10 17:36:31,60,2349,14,46,1378.81,2391.02,0.00
2024-12-10 17:36:31,60,2350,14,46,1371.81,2392.00,0.00
2024-12-10 17:36:31,61,2350,14,47,1349.33,2392.02,0.00
2024-12-10 17:36:31,60,2350,14,46,1371.02,2392.02,0.00
2024-12-10 17:36:31,59,2350,13,46,1373.16,2392.78,0.00
2024-12-10 17:36:31,59,2351,13,46,1408.63,2393.00,0.00
2024-12-10 17:36:31,60,2351,14,46,1385.15,2393.02,0.00
2024-12-10 17:36:31,59,2351,13,46,1395.70,2393.22,0.00
2024-12-10 17:36:31,59,2352,13,46,1401.91,2394.00,0.00
2024-12-10 17:36:31,60,2352,14,46,1378.54,2394.02,0.00
2024-12-10 17:36:31,59,2352,14,45,1401.50,2394.02,0.00
2024-12-10 17:36:31,59,2353,14,45,1402.90,2395.00,0.00
2024-12-10 17:36:31,60,2353,15,45,1379.52,2395.02,0.00
2024-12-10 17:36:31,60,2354,15,45,1372.51,2396.00,0.00
2024-12-10 17:36:31,61,2354,16,45,1350.01,2396.02,0.00
2024-12-10 17:36:31,60,2354,16,44,1372.11,2396.02,0.00
2024-12-10 17:36:31,60,2355,16,44,1373.08,2397.00,0.00
2024-12-10 17:36:31,61,2355,17,44,1350.57,2397.02,0.00
2024-12-10 17:36:31,60,2355,17,43,1364.69,2397.02,0.00
2024-12-10 17:36:31,59,2355,16,43,1373.09,2397.64,0.00
2024-12-10 17:36:31,59,2356,16,43,1389.21,2398.00,0.00
2024-12-10 17:36:31,60,2356,16,44,1366.06,2398.02,0.00
2024-12-10 17:36:31,59,2356,16,43,1380.68,2398.02,0.00
2024-12-10 17:36:31,59,2357,16,43,1382.07,2399.00,0.00
2024-12-10 17:36:31,60,2357,17,43,1359.03,2399.02,0.00
2024-12-10 17:36:31,59,2357,16,43,1362.65,2399.32,0.00
2024-12-10 17:36:31,59,2358,16,43,1387.53,2400.00,0.00
2024-12-10 17:36:31,60,2358,17,43,1364.40,2400.02,0.00
2024-12-10 17:36:31,59,2358,17,42,1386.71,2400.03,0.00
2024-12-10 17:36:31,59,2359,17,42,1388.51,2401.00,0.00
2024-12-10 17:36:31,60,2359,18,42,1365.37,2401.02,0.00
2024-12-10 17:36:31,59,2359,18,41,1379.56,2401.03,0.00
2024-12-10 17:36:31,59,2360,18,41,1381.35,2402.00,0.00
2024-12-10 17:36:31,60,2360,18,42,1358.33,2402.02,0.00
2024-12-10 17:36:31,59,2360,18,41,1372.40,2402.03,0.00
2024-12-10 17:36:31,59,2361,18,41,1374.19,2403.00,0.00
2024-12-10 17:36:31,60,2361,19,41,1351.29,2403.02,0.00
2024-12-10 17:36:31,59,2361,19,40,1365.23,2403.03,0.00
2024-12-10 17:36:31,59,2362,19,40,1367.02,2404.00,0.00
2024-12-10 17:36:31,60,2362,19,41,1344.24,2404.02,0.00
2024-12-10 17:36:31,60,2363,19,41,1337.18,2405.00,0.00
2024-12-10 17:36:31,61,2363,20,41,1315.26,2405.02,0.00
2024-12-10 17:36:31,60,2363,20,40,1335.98,2405.03,0.00
2024-12-10 17:36:31,60,2364,20,40,1337.33,2406.00,0.00
2024-12-10 17:36:31,61,2364,20,41,1315.41,2406.02,0.00
2024-12-10 17:36:31,60,2364,20,40,1328.52,2406.03,0.00
2024-12-10 17:36:31,60,2365,20,40,1329.87,2407.00,0.00
2024-12-10 17:36:31,61,2365,20,41,1308.07,2407.02,0.00
2024-12-10 17:36:31,61,2366,20,41,1300.71,2408.00,0.00
2024-12-10 17:36:31,62,2366,20,42,1279.74,2408.02,0.00
2024-12-10 17:36:31,61,2366,20,41,1298.74,2408.03,0.00
2024-12-10 17:36:31,60,2366,19,41,1316.82,2408.17,0.00
2024-12-10 17:36:31,59,2366,18,41,1339.14,2408.17,0.00
2024-12-10 17:36:31,59,2367,18,41,1344.14,2409.00,0.00
2024-12-10 17:36:31,60,2367,18,42,1321.74,2409.02,0.00
2024-12-10 17:36:31,60,2368,18,42,1314.65,2410.00,0.00
2024-12-10 17:36:31,61,2368,18,43,1293.10,2410.02,0.00
2024-12-10 17:36:31,60,2368,18,42,1312.65,2410.03,0.00
2024-12-10 17:36:31,60,2369,18,42,1313.99,2411.00,0.00
2024-12-10 17:36:31,61,2369,19,42,1292.45,2411.02,0.00
2024-12-10 17:36:31,60,2369,18,42,1280.28,2411.88,0.00
2024-12-10 17:36:31,60,2370,18,42,1317.76,2412.00,0.00
2024-12-10 17:36:31,61,2370,18,43,1296.15,2412.02,0.00
2024-12-10 17:36:31,60,2370,18,42,1316.15,2412.03,0.00
2024-12-10 17:36:31,60,2371,18,42,1317.50,2413.00,0.00
2024-12-10 17:36:31,61,2371,19,42,1295.90,2413.02,0.00
2024-12-10 17:36:31,60,2371,18,42,1292.90,2413.70,0.00
2024-12-10 17:36:31,60,2372,18,42,1310.00,2414.00,0.00
2024-12-10 17:36:31,61,2372,19,42,1288.52,2414.02,0.00
2024-12-10 17:36:31,60,2372,19,41,1308.79,2414.03,0.00
2024-12-10 17:36:31,60,2373,19,41,1310.14,2415.00,0.00
2024-12-10 17:36:31,61,2373,19,42,1288.66,2415.02,0.00
2024-12-10 17:36:31,61,2374,19,42,1281.27,2416.00,0.00
2024-12-10 17:36:31,62,2374,20,42,1260.61,2416.02,0.00
2024-12-10 17:36:31,61,2374,20,41,1280.08,2416.03,0.00
2024-12-10 17:36:31,60,2374,19,41,1273.72,2416.93,0.00
2024-12-10 17:36:31,60,2375,19,41,1312.43,2417.00,0.00
2024-12-10 17:36:31,61,2375,20,41,1290.92,2417.02,0.00
2024-12-10 17:36:31,61,2376,20,41,1283.52,2418.00,0.00
2024-12-10 17:36:31,62,2376,20,42,1262.82,2418.02,0.00
2024-12-10 17:36:31,61,2376,20,41,1282.73,2418.03,0.00
2024-12-10 17:36:32,61,2377,20,41,1283.66,2419.00,0.00
2024-12-10 17:36:32,62,2377,20,42,1262.95,2419.02,0.00
2024-12-10 17:36:32,61,2377,20,41,1283.26,2419.02,0.00
2024-12-10 17:36:32,60,2377,19,41,1278.59,2419.40,0.00
2024-12-10 17:36:32,59,2377,18,41,1292.66,2419.71,0.00
2024-12-10 17:36:32,59,2378,18,41,1326.90,2420.00,0.00
2024-12-10 17:36:32,60,2378,19,41,1304.78,2420.02,0.00
2024-12-10 17:36:32,59,2378,19,40,1326.08,2420.02,0.00
2024-12-10 17:36:32,58,2378,18,40,1332.17,2420.71,0.00
2024-12-10 17:36:32,58,2379,18,40,1350.33,2421.00,0.00
2024-12-10 17:36:32,59,2379,19,40,1327.45,2421.02,0.00
2024-12-10 17:36:32,58,2379,18,40,1332.88,2421.24,0.00
2024-12-10 17:36:32,58,2380,18,40,1356.74,2422.00,0.00
2024-12-10 17:36:32,59,2380,19,40,1333.74,2422.02,0.00
2024-12-10 17:36:32,58,2380,19,39,1356.32,2422.02,0.00
2024-12-10 17:36:32,58,2381,19,39,1358.13,2423.00,0.00
2024-12-10 17:36:32,59,2381,19,40,1335.11,2423.02,0.00
2024-12-10 17:36:32,59,2382,19,40,1328.27,2424.00,0.00
2024-12-10 17:36:32,60,2382,20,40,1306.13,2424.02,0.00
2024-12-10 17:36:32,59,2382,20,39,1327.45,2424.02,0.00
2024-12-10 17:36:32,58,2382,19,39,1324.47,2424.88,0.00
2024-12-10 17:36:32,58,2383,19,39,1363.44,2425.00,0.00
2024-12-10 17:36:32,59,2383,20,39,1340.33,2425.02,0.00
2024-12-10 17:36:32,59,2384,20,39,1333.48,2426.00,0.00
2024-12-10 17:36:32,60,2384,20,40,1311.25,2426.02,0.00
2024-12-10 17:36:32,59,2384,20,39,1331.42,2426.02,0.00
2024-12-10 17:36:32,58,2384,19,39,1338.38,2426.69,0.00
2024-12-10 17:36:32,58,2385,19,39,1356.19,2427.00,0.00
2024-12-10 17:36:32,59,2385,20,39,1333.20,2427.02,0.00
2024-12-10 17:36:32,59,2386,20,39,1326.35,2428.00,0.00
2024-12-10 17:36:32,60,2386,20,40,1304.24,2428.02,0.00
2024-12-10 17:36:32,59,2386,20,39,1324.70,2428.02,0.00
2024-12-10 17:36:32,59,2387,20,39,1326.07,2429.00,0.00
2024-12-10 17:36:32,60,2387,21,39,1303.97,2429.02,0.00
2024-12-10 17:36:32,59,2387,20,39,1310.90,2429.22,0.00
2024-12-10 17:36:32,59,2388,20,39,1333.62,2430.00,0.00
2024-12-10 17:36:32,60,2388,21,39,1311.39,2430.02,0.00
2024-12-10 17:36:32,59,2388,21,38,1331.56,2430.02,0.00
2024-12-10 17:36:32,59,2389,21,38,1332.93,2431.00,0.00
2024-12-10 17:36:32,60,2389,21,39,1310.71,2431.02,0.00
2024-12-10 17:36:32,59,2389,20,39,1313.25,2431.29,0.00
2024-12-10 17:36:32,59,2390,20,39,1337.60,2432.00,0.00
2024-12-10 17:36:32,60,2390,21,39,1315.31,2432.02,0.00
2024-12-10 17:36:32,59,2390,21,38,1335.95,2432.02,0.00
2024-12-10 17:36:32,58,2390,20,38,1345.68,2432.33,0.00
2024-12-10 17:36:32,58,2391,20,38,1371.71,2433.00,0.00
2024-12-10 17:36:32,59,2391,21,38,1348.46,2433.02,0.00
2024-12-10 17:36:32,59,2392,21,38,1346.27,2434.00,0.00
2024-12-10 17:36:32,60,2392,21,39,1323.83,2434.02,0.00
2024-12-10 17:36:32,60,2393,21,39,1316.66,2435.00,0.00
2024-12-10 17:36:32,61,2393,22,39,1295.08,2435.02,0.00
2024-12-10 17:36:32,60,2393,22,38,1315.85,2435.02,0.00
2024-12-10 17:36:32,60,2394,22,38,1316.80,2436.00,0.00
2024-12-10 17:36:32,61,2394,23,38,1295.21,2436.02,0.00
2024-12-10 17:36:32,60,2394,22,38,1303.45,2436.20,0.00
2024-12-10 17:36:32,60,2395,22,38,1325.05,2437.00,0.00
2024-12-10 17:36:32,61,2395,22,39,1303.33,2437.02,0.00
2024-12-10 17:36:32,60,2395,22,38,1323.83,2437.02,0.00
2024-12-10 17:36:32,59,2395,21,38,1330.07,2437.68,0.00
2024-12-10 17:36:32,59,2396,21,38,1347.24,2438.00,0.00
2024-12-10 17:36:32,60,2396,21,39,1324.78,2438.02,0.00
2024-12-10 17:36:32,60,2397,21,39,1317.60,2439.00,0.00
2024-12-10 17:36:32,61,2397,22,39,1296.00,2439.02,0.00
2024-12-10 17:36:32,60,2397,22,38,1316.79,2439.02,0.00
2024-12-10 17:36:32,59,2397,21,38,1309.04,2439.97,0.00
2024-12-10 17:36:32,59,2398,21,38,1349.58,2440.00,0.00
2024-12-10 17:36:32,60,2398,21,39,1327.09,2440.02,0.00
2024-12-10 17:36:32,60,2399,21,39,1319.91,2441.00,0.00
2024-12-10 17:36:32,61,2399,21,40,1298.27,2441.02,0.00
2024-12-10 17:36:32,60,2399,21,39,1319.09,2441.02,0.00
2024-12-10 17:36:32,59,2399,20,39,1318.28,2441.83,0.00
2024-12-10 17:36:32,59,2400,20,39,1355.66,2442.00,0.00
2024-12-10 17:36:32,60,2400,21,39,1333.06,2442.02,0.00
2024-12-10 17:36:33,60,2401,21,39,1325.87,2443.00,0.00
2024-12-10 17:36:33,61,2401,21,40,1304.14,2443.02,0.00
2024-12-10 17:36:33,60,2401,21,39,1325.47,2443.02,0.00
2024-12-10 17:36:33,60,2402,21,39,1326.42,2444.00,0.00
2024-12-10 17:36:33,61,2402,22,39,1304.67,2444.02,0.00
2024-12-10 17:36:33,60,2402,22,38,1317.86,2444.02,0.00
2024-12-10 17:36:33,60,2403,22,38,1318.81,2445.00,0.00
2024-12-10 17:36:33,61,2403,22,39,1297.19,2445.02,0.00
2024-12-10 17:36:33,60,2403,22,38,1310.25,2445.02,0.00
2024-12-10 17:36:33,59,2403,21,38,1315.38,2445.71,0.00
2024-12-10 17:36:33,59,2404,21,38,1333.42,2446.00,0.00
2024-12-10 17:36:33,60,2404,21,39,1311.19,2446.02,0.00
2024-12-10 17:36:33,59,2404,20,39,1321.44,2446.17,0.00
2024-12-10 17:36:33,58,2404,19,39,1322.90,2446.55,0.00
2024-12-10 17:36:33,58,2405,19,39,1354.43,2447.00,0.00
2024-12-10 17:36:33,59,2405,20,39,1331.47,2447.02,0.00
2024-12-10 17:36:33,58,2405,20,38,1352.74,2447.02,0.00
2024-12-10 17:36:33,58,2406,20,38,1354.56,2448.00,0.00
2024-12-10 17:36:33,59,2406,20,39,1331.60,2448.02,0.00
2024-12-10 17:36:33,58,2406,19,39,1313.09,2448.69,0.00
2024-12-10 17:36:33,58,2407,19,39,1347.94,2449.00,0.00
2024-12-10 17:36:33,59,2407,20,39,1325.09,2449.02,0.00
2024-12-10 17:36:33,58,2407,20,38,1346.67,2449.02,0.00
2024-12-10 17:36:33,58,2408,20,38,1348.49,2450.00,0.00
2024-12-10 17:36:33,59,2408,20,39,1325.63,2450.02,0.00
2024-12-10 17:36:33,59,2409,20,39,1318.70,2451.00,0.00
2024-12-10 17:36:33,60,2409,21,39,1296.72,2451.02,0.00
2024-12-10 17:36:33,59,2409,21,38,1317.86,2451.02,0.00
2024-12-10 17:36:33,59,2410,21,38,1319.23,2452.00,0.00
2024-12-10 17:36:33,60,2410,21,39,1297.25,2452.02,0.00
2024-12-10 17:36:33,60,2411,21,39,1290.01,2453.00,0.00
2024-12-10 17:36:33,61,2411,21,40,1268.86,2453.02,0.00
2024-12-10 17:36:33,60,2411,21,39,1289.19,2453.02,0.00
2024-12-10 17:36:33,59,2411,20,39,1298.22,2453.54,0.00
2024-12-10 17:36:33,58,2411,19,39,1316.90,2453.69,0.00
2024-12-10 17:36:33,58,2412,19,39,1334.89,2454.00,0.00
2024-12-10 17:36:33,59,2412,19,40,1312.27,2454.02,0.00
2024-12-10 17:36:33,59,2413,19,40,1307.19,2455.00,0.00
2024-12-10 17:36:33,60,2413,19,41,1285.41,2455.02,0.00
2024-12-10 17:36:33,59,2413,19,40,1302.62,2455.02,0.00
2024-12-10 17:36:33,59,2414,19,40,1303.98,2456.00,0.00
2024-12-10 17:36:33,60,2414,19,41,1282.25,2456.02,0.00
2024-12-10 17:36:33,59,2414,18,41,1290.72,2456.22,0.00
2024-12-10 17:36:33,58,2414,17,41,1309.18,2456.28,0.00
2024-12-10 17:36:33,58,2415,17,41,1334.20,2457.00,0.00
2024-12-10 17:36:33,59,2415,18,41,1311.59,2457.02,0.00
2024-12-10 17:36:33,58,2415,18,40,1333.36,2457.02,0.00
2024-12-10 17:36:33,57,2415,17,40,1345.97,2457.02,0.00
2024-12-10 17:36:33,56,2415,16,40,1365.68,2457.20,0.00
2024-12-10 17:36:33,55,2415,15,40,1380.66,2457.60,0.00
2024-12-10 17:36:33,55,2416,15,40,1415.81,2458.00,0.00
2024-12-10 17:36:33,56,2416,15,41,1390.53,2458.02,0.00
2024-12-10 17:36:33,55,2416,14,41,1385.79,2458.76,0.00
2024-12-10 17:36:33,55,2417,14,41,1424.88,2459.00,0.00
2024-12-10 17:36:33,56,2417,15,41,1399.43,2459.02,0.00
2024-12-10 17:36:33,55,2417,15,40,1422.64,2459.02,0.00
2024-12-10 17:36:33,55,2418,15,40,1425.91,2460.00,0.00
2024-12-10 17:36:33,56,2418,16,40,1400.44,2460.02,0.00
2024-12-10 17:36:33,56,2419,16,40,1394.42,2461.00,0.00
2024-12-10 17:36:33,57,2419,17,40,1369.96,2461.02,0.00
2024-12-10 17:36:33,56,2419,17,39,1392.66,2461.02,0.00
2024-12-10 17:36:33,56,2420,17,39,1395.43,2462.00,0.00
2024-12-10 17:36:33,57,2420,17,40,1370.94,2462.02,0.00
2024-12-10 17:36:33,56,2420,16,40,1373.56,2462.34,0.00
2024-12-10 17:36:33,56,2421,16,40,1401.71,2463.00,0.00
2024-12-10 17:36:33,57,2421,16,41,1377.12,2463.02,0.00
2024-12-10 17:36:33,56,2421,16,40,1399.95,2463.02,0.00
2024-12-10 17:36:33,55,2421,15,40,1410.04,2463.66,0.00
2024-12-10 17:36:33,54,2421,14,40,1421.78,2463.94,0.00
2024-12-10 17:36:34,54,2422,14,40,1466.08,2464.00,0.00
2024-12-10 17:36:34,55,2422,15,40,1439.42,2464.02,0.00
2024-12-10 17:36:34,54,2422,14,40,1438.28,2464.15,0.00
2024-12-10 17:36:34,55,2421,15,40,1402.91,2464.56,0.00
2024-12-10 17:36:34,55,2422,15,40,1467.79,2465.00,0.00
2024-12-10 17:36:34,56,2422,15,41,1441.58,2465.02,0.00
2024-12-10 17:36:34,55,2422,15,40,1466.00,2465.02,0.00
2024-12-10 17:36:34,55,2423,15,40,1514.12,2466.00,0.00
2024-12-10 17:36:34,56,2423,16,40,1487.09,2466.02,0.00
2024-12-10 17:36:34,56,2424,16,40,1481.08,2467.00,0.00
2024-12-10 17:36:34,57,2424,17,40,1455.10,2467.02,0.00
2024-12-10 17:36:34,56,2424,17,39,1480.20,2467.02,0.00
2024-12-10 17:36:34,55,2424,16,39,1490.21,2467.38,0.00
2024-12-10 17:36:34,55,2425,16,39,1520.29,2468.00,0.00
2024-12-10 17:36:34,56,2425,16,40,1493.14,2468.02,0.00
2024-12-10 17:36:34,56,2426,16,40,1487.13,2469.00,0.00
2024-12-10 17:36:34,57,2426,17,40,1461.04,2469.02,0.00
2024-12-10 17:36:34,56,2426,17,39,1486.69,2469.02,0.00
2024-12-10 17:36:34,55,2426,16,39,1497.88,2469.66,0.00
2024-12-10 17:36:34,54,2426,15,39,1512.57,2469.91,0.00
2024-12-10 17:36:34,54,2427,15,39,1556.10,2470.00,0.00
2024-12-10 17:36:34,55,2427,15,40,1527.81,2470.02,0.00
2024-12-10 17:36:34,54,2427,15,39,1546.49,2470.02,0.00
2024-12-10 17:36:34,54,2428,15,39,1550.32,2471.00,0.00
2024-12-10 17:36:34,55,2428,15,40,1522.14,2471.02,0.00
2024-12-10 17:36:34,54,2428,15,39,1540.71,2471.02,0.00
2024-12-10 17:36:34,54,2429,15,39,1544.54,2472.00,0.00
2024-12-10 17:36:34,55,2429,16,39,1516.46,2472.02,0.00
2024-12-10 17:36:34,54,2429,16,38,1534.93,2472.02,0.00
2024-12-10 17:36:34,53,2429,15,38,1553.16,2472.02,0.00
2024-12-10 17:36:34,53,2430,15,38,1576.19,2473.00,0.00
2024-12-10 17:36:34,54,2430,16,38,1547.00,2473.02,0.00
2024-12-10 17:36:34,54,2431,16,38,1541.67,2474.00,0.00
2024-12-10 17:36:34,55,2431,17,38,1513.64,2474.02,0.00
2024-12-10 17:36:34,54,2431,17,37,1539.38,2474.02,0.00
2024-12-10 17:36:34,54,2432,17,37,1543.21,2475.00,0.00
2024-12-10 17:36:34,55,2432,18,37,1515.15,2475.02,0.00
2024-12-10 17:36:34,55,2433,18,37,1509.46,2476.00,0.00
2024-12-10 17:36:34,56,2433,18,38,1482.50,2476.02,0.00
2024-12-10 17:36:34,55,2433,18,37,1506.31,2476.02,0.00
2024-12-10 17:36:34,55,2434,18,37,1509.62,2477.00,0.00
2024-12-10 17:36:34,56,2434,19,37,1482.66,2477.02,0.00
2024-12-10 17:36:34,56,2435,19,37,1476.62,2478.00,0.00
2024-12-10 17:36:34,57,2435,20,37,1450.72,2478.02,0.00
2024-12-10 17:36:34,56,2435,20,36,1473.52,2478.02,0.00
2024-12-10 17:36:34,56,2436,20,36,1476.33,2479.00,0.00
2024-12-10 17:36:34,57,2436,21,36,1450.43,2479.02,0.00
2024-12-10 17:36:34,56,2436,20,36,1457.40,2479.32,0.00
2024-12-10 17:36:34,56,2437,20,36,1485.34,2480.00,0.00
2024-12-10 17:36:34,57,2437,20,37,1459.28,2480.02,0.00
2024-12-10 17:36:34,56,2437,20,36,1482.24,2480.02,0.00
2024-12-10 17:36:34,55,2437,19,36,1505.18,2480.16,0.00
2024-12-10 17:36:34,55,2438,19,36,1512.06,2481.00,0.00
2024-12-10 17:36:34,56,2438,19,37,1485.06,2481.02,0.00
2024-12-10 17:36:34,56,2439,19,37,1479.01,2482.00,0.00
2024-12-10 17:36:34,57,2439,19,38,1453.06,2482.02,0.00
2024-12-10 17:36:34,56,2439,19,37,1476.35,2482.02,0.00
2024-12-10 17:36:34,55,2439,18,37,1478.57,2482.47,0.00
2024-12-10 17:36:34,55,2440,18,37,1511.02,2483.00,0.00
2024-12-10 17:36:34,56,2440,18,38,1484.04,2483.02,0.00
2024-12-10 17:36:34,56,2441,18,38,1477.98,2484.00,0.00
2024-12-10 17:36:34,57,2441,18,39,1452.05,2484.02,0.00
2024-12-10 17:36:34,56,2441,18,38,1475.76,2484.02,0.00
2024-12-10 17:36:34,55,2441,17,38,1477.77,2484.84,0.00
2024-12-10 17:36:34,55,2442,17,38,1519.01,2485.00,0.00
2024-12-10 17:36:34,56,2442,18,38,1491.89,2485.02,0.00
2024-12-10 17:36:34,56,2443,18,38,1485.83,2486.00,0.00
2024-12-10 17:36:34,57,2443,19,38,1459.76,2486.02,0.00
2024-12-10 17:36:34,56,2443,19,37,1484.05,2486.02,0.00
2024-12-10 17:36:34,56,2444,19,37,1486.87,2487.00,0.00
2024-12-10 17:36:34,57,2444,19,38,1460.78,2487.02,0.00
2024-12-10 17:36:34,57,2445,19,38,1454.39,2488.00,0.00
2024-12-10 17:36:34,58,2445,20,38,1429.31,2488.02,0.00
2024-12-10 17:36:34,57,2445,20,37,1453.08,2488.02,0.00
2024-12-10 17:36:34,56,2445,19,37,1446.48,2488.64,0.00
2024-12-10 17:36:34,56,2446,19,37,1482.29,2489.00,0.00
2024-12-10 17:36:34,57,2446,19,38,1456.28,2489.02,0.00
2024-12-10 17:36:34,56,2446,18,38,1456.52,2489.09,0.00
2024-12-10 17:36:34,55,2446,17,38,1468.40,2489.67,0.00
2024-12-10 17:36:34,55,2447,17,38,1505.77,2490.00,0.00
2024-12-10 17:36:34,56,2447,18,38,1478.88,2490.02,0.00
2024-12-10 17:36:34,55,2447,18,37,1504.41,2490.02,0.00
2024-12-10 17:36:34,54,2447,17,37,1529.08,2490.13,0.00
2024-12-10 17:36:34,54,2448,17,37,1535.66,2491.00,0.00
2024-12-10 17:36:34,55,2448,17,38,1507.73,2491.02,0.00
2024-12-10 17:36:34,54,2448,16,38,1494.91,2491.61,0.00
2024-12-10 17:36:34,54,2449,16,38,1531.66,2492.00,0.00
2024-12-10 17:36:34,55,2449,16,39,1503.81,2492.02,0.00
2024-12-10 17:36:34,54,2449,16,38,1529.81,2492.02,0.00
2024-12-10 17:36:35,54,2450,16,38,1533.66,2493.00,0.00
2024-12-10 17:36:35,55,2450,16,39,1505.77,2493.02,0.00
2024-12-10 17:36:35,55,2451,16,39,1500.03,2494.00,0.00
2024-12-10 17:36:35,56,2451,17,39,1473.24,2494.02,0.00
2024-12-10 17:36:35,55,2451,17,38,1497.76,2494.02,0.00
2024-12-10 17:36:35,54,2451,16,38,1508.76,2494.67,0.00
2024-12-10 17:36:35,54,2452,16,38,1546.90,2495.00,0.00
2024-12-10 17:36:35,55,2452,17,38,1518.77,2495.02,0.00
2024-12-10 17:36:35,55,2453,17,38,1513.03,2496.00,0.00
2024-12-10 17:36:35,56,2453,18,38,1486.01,2496.02,0.00
2024-12-10 17:36:35,55,2453,18,37,1511.21,2496.02,0.00
2024-12-10 17:36:35,55,2454,18,37,1514.54,2497.00,0.00
2024-12-10 17:36:35,56,2454,18,38,1487.50,2497.02,0.00
2024-12-10 17:36:35,56,2455,18,38,1481.40,2498.00,0.00
2024-12-10 17:36:35,57,2455,19,38,1455.41,2498.02,0.00
2024-12-10 17:36:35,56,2455,19,37,1478.73,2498.02,0.00
2024-12-10 17:36:35,56,2456,19,37,1481.55,2499.00,0.00
2024-12-10 17:36:35,57,2456,19,38,1455.56,2499.02,0.00
2024-12-10 17:36:35,56,2456,18,38,1469.53,2499.13,0.00
2024-12-10 17:36:35,56,2457,18,38,1492.86,2500.00,0.00
2024-12-10 17:36:35,57,2457,18,39,1466.67,2500.02,0.00
2024-12-10 17:36:35,56,2457,18,38,1489.73,2500.02,0.00
2024-12-10 17:36:35,55,2457,17,38,1488.01,2500.56,0.00
2024-12-10 17:36:35,55,2458,17,38,1522.88,2501.00,0.00
2024-12-10 17:36:35,56,2458,17,39,1495.69,2501.02,0.00
2024-12-10 17:36:35,56,2459,17,39,1489.58,2502.00,0.00
2024-12-10 17:36:35,57,2459,17,40,1463.45,2502.02,0.00
2024-12-10 17:36:35,56,2459,17,39,1486.46,2502.02,0.00
2024-12-10 17:36:35,55,2459,16,39,1506.72,2502.18,0.00
2024-12-10 17:36:35,55,2460,16,39,1518.54,2503.00,0.00
2024-12-10 17:36:35,56,2460,16,40,1491.42,2503.02,0.00
2024-12-10 17:36:35,55,2460,15,40,1491.00,2503.31,0.00
2024-12-10 17:36:35,55,2461,15,40,1501.49,2504.00,0.00
2024-12-10 17:36:35,56,2461,16,40,1474.68,2504.02,0.00
2024-12-10 17:36:35,55,2461,16,39,1497.85,2504.02,0.00
2024-12-10 17:36:35,54,2461,15,39,1497.55,2504.52,0.00
2024-12-10 17:36:35,54,2462,15,39,1532.22,2505.00,0.00
2024-12-10 17:36:35,55,2462,16,39,1504.37,2505.02,0.00
2024-12-10 17:36:35,55,2463,16,39,1498.59,2506.00,0.00
2024-12-10 17:36:35,56,2463,16,40,1471.83,2506.02,0.00
2024-12-10 17:36:35,55,2463,16,39,1494.49,2506.02,0.00
2024-12-10 17:36:35,54,2463,15,39,1507.16,2506.63,0.00
2024-12-10 17:36:35,54,2464,15,39,1526.02,2507.00,0.00
2024-12-10 17:36:35,55,2464,15,40,1498.27,2507.02,0.00
2024-12-10 17:36:35,55,2465,15,40,1492.49,2508.00,0.00
2024-12-10 17:36:35,56,2465,15,41,1465.84,2508.02,0.00
2024-12-10 17:36:35,55,2465,15,40,1487.93,2508.02,0.00
2024-12-10 17:36:35,55,2466,15,40,1491.26,2509.00,0.00
2024-12-10 17:36:35,56,2466,16,40,1464.63,2509.02,0.00
2024-12-10 17:36:35,55,2466,15,40,1466.75,2509.35,0.00
2024-12-10 17:36:35,55,2467,15,40,1496.42,2510.00,0.00
2024-12-10 17:36:35,56,2467,16,40,1469.69,2510.02,0.00
2024-12-10 17:36:35,55,2467,16,39,1492.31,2510.02,0.00
2024-12-10 17:36:35,55,2468,16,39,1495.64,2511.00,0.00
2024-12-10 17:36:35,56,2468,17,39,1468.93,2511.02,0.00
2024-12-10 17:36:35,56,2469,17,39,1462.79,2512.00,0.00
2024-12-10 17:36:35,57,2469,18,39,1437.13,2512.02,0.00
2024-12-10 17:36:35,56,2469,18,38,1458.75,2512.02,0.00
2024-12-10 17:36:35,56,2470,18,38,1461.58,2513.00,0.00
2024-12-10 17:36:35,57,2470,19,38,1435.94,2513.02,0.00
2024-12-10 17:36:35,57,2471,19,38,1429.45,2514.00,0.00
2024-12-10 17:36:35,58,2471,19,39,1404.81,2514.02,0.00
2024-12-10 17:36:35,57,2471,19,38,1425.92,2514.02,0.00
2024-12-10 17:36:35,56,2471,18,38,1435.10,2514.66,0.00
2024-12-10 17:36:35,55,2471,17,38,1445.88,2514.96,0.00
2024-12-10 17:36:35,55,2472,17,38,1490.71,2515.00,0.00
2024-12-10 17:36:35,56,2472,17,39,1464.09,2515.02,0.00
2024-12-10 17:36:35,56,2473,17,39,1457.93,2516.00,0.00
2024-12-10 17:36:35,57,2473,17,40,1432.35,2516.02,0.00
2024-12-10 17:36:36,56,2473,17,39,1454.34,2516.02,0.00
2024-12-10 17:36:36,55,2473,16,39,1461.26,2516.38,0.00
2024-12-10 17:36:36,55,2474,16,39,1491.89,2517.00,0.00
2024-12-10 17:36:36,56,2474,16,40,1465.25,2517.02,0.00
2024-12-10 17:36:36,55,2474,15,40,1458.93,2517.82,0.00
2024-12-10 17:36:36,55,2475,15,40,1500.27,2518.00,0.00
2024-12-10 17:36:36,56,2475,16,40,1473.48,2518.02,0.00
2024-12-10 17:36:36,55,2475,16,39,1496.61,2518.02,0.00
2024-12-10 17:36:36,55,2476,16,39,1499.95,2519.00,0.00
2024-12-10 17:36:36,56,2476,16,40,1473.16,2519.02,0.00
2024-12-10 17:36:36,55,2476,15,40,1472.60,2519.36,0.00
2024-12-10 17:36:36,55,2477,15,40,1502.84,2520.00,0.00
2024-12-10 17:36:36,56,2477,16,40,1476.00,2520.02,0.00
2024-12-10 17:36:36,55,2477,16,39,1499.63,2520.02,0.00
2024-12-10 17:36:36,54,2477,15,39,1523.25,2520.17,0.00
2024-12-10 17:36:36,54,2478,15,39,1530.81,2521.00,0.00
2024-12-10 17:36:36,55,2478,16,39,1502.97,2521.02,0.00
2024-12-10 17:36:36,55,2479,16,39,1497.15,2522.00,0.00
2024-12-10 17:36:36,56,2479,16,40,1470.42,2522.02,0.00
2024-12-10 17:36:36,55,2479,16,39,1493.94,2522.02,0.00
2024-12-10 17:36:36,55,2480,16,39,1497.29,2523.00,0.00
2024-12-10 17:36:36,56,2480,16,40,1470.55,2523.02,0.00
2024-12-10 17:36:36,56,2481,16,40,1464.37,2524.00,0.00
2024-12-10 17:36:36,57,2481,17,40,1438.68,2524.02,0.00
2024-12-10 17:36:36,56,2481,17,39,1461.22,2524.02,0.00
2024-12-10 17:36:36,55,2481,16,39,1456.22,2524.96,0.00
2024-12-10 17:36:36,55,2482,16,39,1501.23,2525.00,0.00
2024-12-10 17:36:36,56,2482,17,39,1474.42,2525.02,0.00
2024-12-10 17:36:36,56,2483,17,39,1468.24,2526.00,0.00
2024-12-10 17:36:36,57,2483,18,39,1442.48,2526.02,0.00
2024-12-10 17:36:36,56,2483,18,38,1465.08,2526.02,0.00
2024-12-10 17:36:36,56,2484,18,38,1467.92,2527.00,0.00
2024-12-10 17:36:36,57,2484,18,39,1442.16,2527.02,0.00
2024-12-10 17:36:36,57,2485,18,39,1435.64,2528.00,0.00
2024-12-10 17:36:36,58,2485,19,39,1410.89,2528.02,0.00
2024-12-10 17:36:36,57,2485,19,38,1432.98,2528.02,0.00
2024-12-10 17:36:36,57,2486,19,38,1435.32,2529.00,0.00
2024-12-10 17:36:36,58,2486,20,38,1410.57,2529.02,0.00
2024-12-10 17:36:36,57,2486,19,38,1395.24,2529.63,0.00
2024-12-10 17:36:36,57,2487,19,38,1430.56,2530.00,0.00
2024-12-10 17:36:36,58,2487,19,39,1405.89,2530.02,0.00
2024-12-10 17:36:36,57,2487,19,38,1428.34,2530.02,0.00
2024-12-10 17:36:36,57,2488,19,38,1430.68,2531.00,0.00
2024-12-10 17:36:36,58,2488,19,39,1406.01,2531.02,0.00
2024-12-10 17:36:36,58,2489,19,39,1399.15,2532.00,0.00
2024-12-10 17:36:36,59,2489,20,39,1375.43,2532.02,0.00
2024-12-10 17:36:36,58,2489,20,38,1397.40,2532.02,0.00
2024-12-10 17:36:36,57,2489,19,38,1390.47,2532.97,0.00
2024-12-10 17:36:36,57,2490,19,38,1434.03,2533.00,0.00
2024-12-10 17:36:36,58,2490,20,38,1409.31,2533.02,0.00
2024-12-10 17:36:36,57,2490,19,38,1407.70,2533.70,0.00
2024-12-10 17:36:36,57,2491,19,38,1427.04,2534.00,0.00
2024-12-10 17:36:36,58,2491,19,39,1402.44,2534.02,0.00
2024-12-10 17:36:36,57,2491,19,38,1425.71,2534.02,0.00
2024-12-10 17:36:36,57,2492,19,38,1428.05,2535.00,0.00
2024-12-10 17:36:36,58,2492,20,38,1403.43,2535.02,0.00
2024-12-10 17:36:36,57,2492,19,38,1406.70,2535.04,0.00
2024-12-10 17:36:36,57,2493,19,38,1427.28,2536.00,0.00
2024-12-10 17:36:36,58,2493,19,39,1402.67,2536.02,0.00
2024-12-10 17:36:36,57,2493,19,38,1425.94,2536.02,0.00
2024-12-10 17:36:36,57,2494,19,38,1428.29,2537.00,0.00
2024-12-10 17:36:36,58,2494,19,39,1403.66,2537.02,0.00
2024-12-10 17:36:36,58,2495,19,39,1396.77,2538.00,0.00
2024-12-10 17:36:36,59,2495,20,39,1373.10,2538.02,0.00
2024-12-10 17:36:36,58,2495,20,38,1394.59,2538.02,0.00
2024-12-10 17:36:36,57,2495,19,38,1387.52,2538.97,0.00
2024-12-10 17:36:36,57,2496,19,38,1431.19,2539.00,0.00
2024-12-10 17:36:36,58,2496,19,39,1406.52,2539.02,0.00
2024-12-10 17:36:36,58,2497,19,39,1399.63,2540.00,0.00
2024-12-10 17:36:36,59,2497,19,40,1375.90,2540.02,0.00
2024-12-10 17:36:36,58,2497,19,39,1397.88,2540.02,0.00
2024-12-10 17:36:36,58,2498,19,39,1399.74,2541.00,0.00
2024-12-10 17:36:36,59,2498,20,39,1376.02,2541.02,0.00
2024-12-10 17:36:36,58,2498,19,39,1375.22,2541.09,0.00
2024-12-10 17:36:36,58,2499,19,39,1396.35,2542.00,0.00
2024-12-10 17:36:36,59,2499,20,39,1372.68,2542.02,0.00
2024-12-10 17:36:36,58,2499,20,38,1394.59,2542.02,0.00
2024-12-10 17:36:36,58,2500,20,38,1396.46,2543.00,0.00
2024-12-10 17:36:36,59,2500,21,38,1372.79,2543.02,0.00
2024-12-10 17:36:36,58,2500,20,38,1368.31,2543.74,0.00
2024-12-10 17:36:36,58,2501,20,38,1405.78,2544.00,0.00
2024-12-10 17:36:36,59,2501,21,38,1381.95,2544.02,0.00
2024-12-10 17:36:36,58,2501,21,37,1403.59,2544.02,0.00
2024-12-10 17:36:36,58,2502,21,37,1405.45,2545.00,0.00
2024-12-10 17:36:36,59,2502,22,37,1381.63,2545.02,0.00
2024-12-10 17:36:36,59,2503,22,37,1374.41,2546.00,0.00
2024-12-10 17:36:36,60,2503,22,38,1351.50,2546.02,0.00
2024-12-10 17:36:36,59,2503,22,37,1372.25,2546.02,0.00
2024-12-10 17:36:37,59,2504,22,37,1373.65,2547.00,0.00
2024-12-10 17:36:37,60,2504,23,37,1350.76,2547.02,0.00
2024-12-10 17:36:37,60,2505,23,37,1343.22,2548.00,0.00
2024-12-10 17:36:37,61,2505,24,37,1321.20,2548.02,0.00
2024-12-10 17:36:37,60,2505,24,36,1341.52,2548.02,0.00
2024-12-10 17:36:37,59,2505,23,36,1335.36,2548.92,0.00
2024-12-10 17:36:37,59,2506,23,36,1376.46,2549.00,0.00
2024-12-10 17:36:37,60,2506,23,37,1353.52,2549.02,0.00
2024-12-10 17:36:37,59,2506,22,37,1340.83,2549.58,0.00
2024-12-10 17:36:37,59,2507,22,37,1373.54,2550.00,0.00
2024-12-10 17:36:37,60,2507,22,38,1350.65,2550.02,0.00
2024-12-10 17:36:37,59,2507,22,37,1370.52,2550.02,0.00
2024-12-10 17:36:37,59,2508,22,37,1371.92,2551.00,0.00
2024-12-10 17:36:37,60,2508,22,38,1349.05,2551.02,0.00
2024-12-10 17:36:37,59,2508,21,38,1359.43,2551.17,0.00
2024-12-10 17:36:37,58,2508,20,38,1363.42,2551.81,0.00
2024-12-10 17:36:37,58,2509,20,38,1402.72,2552.00,0.00
2024-12-10 17:36:37,59,2509,21,38,1378.94,2552.02,0.00
2024-12-10 17:36:37,58,2509,21,37,1398.76,2552.02,0.00
2024-12-10 17:36:37,58,2510,21,37,1400.63,2553.00,0.00
2024-12-10 17:36:37,59,2510,22,37,1376.89,2553.02,0.00
2024-12-10 17:36:37,59,2511,22,37,1370.05,2554.00,0.00
2024-12-10 17:36:37,60,2511,23,37,1347.22,2554.02,0.00
2024-12-10 17:36:37,59,2511,23,36,1366.59,2554.02,0.00
2024-12-10 17:36:37,58,2511,22,36,1372.42,2554.71,0.00
2024-12-10 17:36:37,58,2512,22,36,1391.59,2555.00,0.00
2024-12-10 17:36:37,59,2512,22,37,1368.01,2555.02,0.00
2024-12-10 17:36:37,59,2513,22,37,1361.04,2556.00,0.00
2024-12-10 17:36:37,60,2513,23,37,1338.36,2556.02,0.00
2024-12-10 17:36:37,59,2513,23,36,1358.01,2556.02,0.00
2024-12-10 17:36:37,58,2513,22,36,1377.51,2556.17,0.00
2024-12-10 17:36:37,57,2513,21,36,1401.22,2556.18,0.00
2024-12-10 17:36:37,57,2514,21,36,1407.55,2557.00,0.00
2024-12-10 17:36:37,58,2514,21,37,1383.28,2557.02,0.00
2024-12-10 17:36:37,58,2515,21,37,1376.33,2558.00,0.00
2024-12-10 17:36:37,59,2515,22,37,1353.00,2558.02,0.00
2024-12-10 17:36:37,58,2515,22,36,1373.68,2558.02,0.00
2024-12-10 17:36:37,57,2515,21,36,1366.56,2558.95,0.00
2024-12-10 17:36:37,57,2516,21,36,1410.14,2559.00,0.00
2024-12-10 17:36:37,58,2516,22,36,1385.83,2559.02,0.00
2024-12-10 17:36:37,58,2517,22,36,1378.87,2560.00,0.00
2024-12-10 17:36:37,59,2517,23,36,1355.50,2560.02,0.00
2024-12-10 17:36:37,58,2517,23,35,1376.66,2560.02,0.00
2024-12-10 17:36:37,58,2518,23,35,1378.52,2561.00,0.00
2024-12-10 17:36:37,59,2518,24,35,1355.16,2561.02,0.00
2024-12-10 17:36:37,58,2518,23,35,1356.45,2561.05,0.00
2024-12-10 17:36:37,58,2519,23,35,1376.85,2562.00,0.00
2024-12-10 17:36:37,59,2519,23,36,1353.52,2562.02,0.00
2024-12-10 17:36:37,58,2519,23,35,1373.77,2562.03,0.00
2024-12-10 17:36:37,58,2520,23,35,1376.07,2563.00,0.00
2024-12-10 17:36:37,59,2520,23,36,1352.74,2563.02,0.00
2024-12-10 17:36:37,58,2520,22,36,1348.69,2563.12,0.00
2024-12-10 17:36:37,58,2520,22,36,1370.86,2564.00,0.00
2024-12-10 17:36:37,59,2520,22,37,1347.62,2564.02,0.00
2024-12-10 17:36:37,58,2520,22,36,1367.76,2564.03,0.00
2024-12-10 17:36:37,58,2521,22,36,1370.06,2565.00,0.00
2024-12-10 17:36:37,59,2521,22,37,1346.84,2565.02,0.00
2024-12-10 17:36:37,58,2521,21,37,1330.30,2565.95,0.00
2024-12-10 17:36:37,58,2522,21,37,1373.25,2566.00,0.00
2024-12-10 17:36:37,59,2522,22,37,1349.98,2566.02,0.00
2024-12-10 17:36:37,58,2522,21,37,1363.96,2566.02,0.00
2024-12-10 17:36:37,57,2522,21,36,1385.19,2566.02,0.00
2024-12-10 17:36:37,57,2523,21,36,1405.54,2567.00,0.00
2024-12-10 17:36:37,58,2523,22,36,1381.31,2567.02,0.00
2024-12-10 17:36:37,58,2524,22,36,1374.32,2568.00,0.00
2024-12-10 17:36:37,59,2524,22,37,1351.03,2568.02,0.00
2024-12-10 17:36:37,58,2524,22,36,1372.11,2568.02,0.00
2024-12-10 17:36:37,58,2525,22,36,1373.97,2569.00,0.00
2024-12-10 17:36:37,59,2525,22,37,1350.68,2569.02,0.00
2024-12-10 17:36:37,59,2526,22,37,1343.37,2570.00,0.00
2024-12-10 17:36:37,60,2526,23,37,1320.98,2570.02,0.00
2024-12-10 17:36:37,59,2526,23,36,1341.63,2570.02,0.00
2024-12-10 17:36:37,58,2526,22,36,1360.82,2570.17,0.00
2024-12-10 17:36:37,57,2526,21,36,1357.64,2570.95,0.00
2024-12-10 17:36:37,57,2527,21,36,1401.42,2571.00,0.00
2024-12-10 17:36:37,58,2527,22,36,1377.26,2571.02,0.00
2024-12-10 17:36:37,57,2527,21,36,1388.39,2571.18,0.00
2024-12-10 17:36:37,57,2528,21,36,1395.05,2572.00,0.00
2024-12-10 17:36:37,58,2528,21,37,1371.00,2572.02,0.00
2024-12-10 17:36:37,57,2528,21,36,1392.34,2572.02,0.00
2024-12-10 17:36:37,57,2529,21,36,1394.69,2573.00,0.00
2024-12-10 17:36:37,58,2529,22,36,1370.64,2573.02,0.00
2024-12-10 17:36:37,57,2529,21,36,1371.32,2573.33,0.00
2024-12-10 17:36:37,56,2529,20,36,1385.92,2573.71,0.00
2024-12-10 17:36:37,56,2530,20,36,1424.74,2574.00,0.00
2024-12-10 17:36:37,57,2530,20,37,1399.75,2574.02,0.00
2024-12-10 17:36:37,56,2530,20,36,1421.98,2574.02,0.00
2024-12-10 17:36:37,56,2531,20,36,1424.84,2575.00,0.00
2024-12-10 17:36:37,57,2531,20,37,1399.84,2575.02,0.00
2024-12-10 17:36:37,57,2532,20,37,1393.15,2576.00,0.00
2024-12-10 17:36:37,58,2532,20,38,1369.13,2576.02,0.00
2024-12-10 17:36:37,57,2532,20,37,1390.89,2576.02,0.00
2024-12-10 17:36:37,57,2533,20,37,1393.24,2577.00,0.00
2024-12-10 17:36:37,58,2533,21,37,1369.22,2577.02,0.00
2024-12-10 17:36:37,58,2534,21,37,1362.19,2578.00,0.00
2024-12-10 17:36:37,59,2534,21,38,1339.11,2578.02,0.00
2024-12-10 17:36:37,58,2534,21,37,1360.42,2578.02,0.00
2024-12-10 17:36:37,58,2535,21,37,1362.28,2579.00,0.00
2024-12-10 17:36:37,59,2535,21,38,1339.19,2579.02,0.00
2024-12-10 17:36:38,59,2536,21,38,1331.84,2580.00,0.00
2024-12-10 17:36:38,60,2536,22,38,1309.64,2580.02,0.00
2024-12-10 17:36:38,59,2536,22,37,1330.53,2580.02,0.00
2024-12-10 17:36:38,58,2536,21,37,1348.63,2580.19,0.00
2024-12-10 17:36:38,57,2536,20,37,1358.96,2580.70,0.00
2024-12-10 17:36:38,57,2537,20,37,1378.65,2581.00,0.00
2024-12-10 17:36:38,58,2537,21,37,1354.88,2581.02,0.00
2024-12-10 17:36:38,57,2537,20,37,1356.56,2581.32,0.00
2024-12-10 17:36:38,57,2538,20,37,1384.62,2582.00,0.00
2024-12-10 17:36:38,58,2538,21,37,1360.75,2582.02,0.00
2024-12-10 17:36:38,57,2538,21,36,1383.71,2582.02,0.00
2024-12-10 17:36:38,57,2539,21,36,1386.06,2583.00,0.00
2024-12-10 17:36:38,58,2539,21,37,1362.16,2583.02,0.00
2024-12-10 17:36:38,58,2540,21,37,1355.12,2584.00,0.00
2024-12-10 17:36:38,59,2540,22,37,1332.15,2584.02,0.00
2024-12-10 17:36:38,58,2540,22,36,1353.78,2584.02,0.00
2024-12-10 17:36:38,57,2540,21,36,1372.60,2584.19,0.00
2024-12-10 17:36:38,56,2540,20,36,1375.12,2584.54,0.00
2024-12-10 17:36:38,56,2541,20,36,1409.60,2585.00,0.00
2024-12-10 17:36:38,57,2541,20,37,1384.87,2585.02,0.00
2024-12-10 17:36:38,57,2542,20,37,1378.14,2586.00,0.00
2024-12-10 17:36:38,58,2542,21,37,1354.38,2586.02,0.00
2024-12-10 17:36:38,57,2542,21,36,1377.24,2586.02,0.00
2024-12-10 17:36:38,57,2543,21,36,1379.59,2587.00,0.00
2024-12-10 17:36:38,58,2543,22,36,1355.80,2587.02,0.00
2024-12-10 17:36:38,57,2543,21,36,1358.25,2587.04,0.00
2024-12-10 17:36:38,57,2544,21,36,1379.21,2588.00,0.00
2024-12-10 17:36:38,58,2544,22,36,1355.43,2588.02,0.00
2024-12-10 17:36:38,57,2544,22,35,1378.76,2588.02,0.00
2024-12-10 17:36:38,57,2545,22,35,1381.11,2589.00,0.00
2024-12-10 17:36:38,58,2545,22,36,1357.29,2589.02,0.00
2024-12-10 17:36:38,57,2545,21,36,1357.59,2589.32,0.00
2024-12-10 17:36:38,57,2546,21,36,1385.73,2590.00,0.00
2024-12-10 17:36:38,58,2546,21,37,1361.84,2590.02,0.00
2024-12-10 17:36:38,57,2546,21,36,1383.46,2590.02,0.00
2024-12-10 17:36:38,56,2546,20,36,1384.95,2590.79,0.00
2024-12-10 17:36:38,56,2547,20,36,1425.82,2591.00,0.00
2024-12-10 17:36:38,57,2547,20,37,1400.81,2591.02,0.00
2024-12-10 17:36:38,56,2547,19,37,1387.88,2591.89,0.00
2024-12-10 17:36:38,56,2548,19,37,1431.47,2592.00,0.00
2024-12-10 17:36:38,57,2548,19,38,1406.35,2592.02,0.00
2024-12-10 17:36:38,56,2548,19,37,1429.61,2592.02,0.00
2024-12-10 17:36:38,56,2549,19,37,1432.48,2593.00,0.00
2024-12-10 17:36:38,57,2549,20,37,1407.35,2593.02,0.00
2024-12-10 17:36:38,56,2549,19,37,1405.47,2593.70,0.00
2024-12-10 17:36:38,56,2550,19,37,1425.62,2594.00,0.00
2024-12-10 17:36:38,57,2550,19,38,1400.61,2594.02,0.00
2024-12-10 17:36:38,56,2550,19,37,1424.23,2594.02,0.00
2024-12-10 17:36:38,56,2551,19,37,1427.10,2595.00,0.00
2024-12-10 17:36:38,57,2551,20,37,1402.06,2595.02,0.00
2024-12-10 17:36:38,57,2552,20,37,1395.32,2596.00,0.00
2024-12-10 17:36:38,58,2552,20,38,1371.26,2596.02,0.00
2024-12-10 17:36:38,57,2552,20,37,1394.40,2596.02,0.00
2024-12-10 17:36:38,57,2553,20,37,1396.76,2597.00,0.00
2024-12-10 17:36:38,58,2553,20,38,1372.68,2597.02,0.00
2024-12-10 17:36:38,58,2554,20,38,1365.60,2598.00,0.00
2024-12-10 17:36:38,59,2554,21,38,1342.45,2598.02,0.00
2024-12-10 17:36:38,58,2554,21,37,1364.70,2598.02,0.00
2024-12-10 17:36:38,57,2554,20,37,1358.13,2598.93,0.00
2024-12-10 17:36:38,57,2555,20,37,1401.94,2599.00,0.00
2024-12-10 17:36:38,58,2555,21,37,1377.77,2599.02,0.00
2024-12-10 17:36:38,57,2555,20,37,1373.36,2599.42,0.00
2024-12-10 17:36:38,57,2556,20,37,1404.31,2600.00,0.00
2024-12-10 17:36:38,58,2556,20,38,1380.10,2600.02,0.00
2024-12-10 17:36:38,57,2556,20,37,1402.94,2600.02,0.00
2024-12-10 17:36:38,57,2557,20,37,1405.30,2601.00,0.00
2024-12-10 17:36:38,58,2557,21,37,1381.07,2601.02,0.00
2024-12-10 17:36:38,58,2558,21,37,1373.98,2602.00,0.00
2024-12-10 17:36:38,59,2558,22,37,1350.69,2602.02,0.00
2024-12-10 17:36:38,58,2558,22,36,1373.08,2602.02,0.00
2024-12-10 17:36:38,57,2558,21,36,1393.11,2602.18,0.00
2024-12-10 17:36:38,56,2558,20,36,1405.24,2602.68,0.00
2024-12-10 17:36:38,56,2559,20,36,1424.99,2603.00,0.00
2024-12-10 17:36:38,57,2559,21,36,1399.99,2603.02,0.00
2024-12-10 17:36:38,57,2560,21,36,1393.22,2604.00,0.00
2024-12-10 17:36:38,58,2560,22,36,1369.20,2604.02,0.00
2024-12-10 17:36:38,57,2560,22,35,1391.39,2604.02,0.00
2024-12-10 17:36:38,56,2560,21,35,1412.10,2604.16,0.00
2024-12-10 17:36:38,56,2561,21,35,1418.64,2605.00,0.00
2024-12-10 17:36:38,57,2561,21,36,1393.75,2605.02,0.00
2024-12-10 17:36:38,57,2562,21,36,1386.97,2606.00,0.00
2024-12-10 17:36:38,58,2562,21,37,1363.06,2606.02,0.00
2024-12-10 17:36:38,57,2562,21,36,1384.23,2606.04,0.00
2024-12-10 17:36:38,56,2562,20,36,1406.19,2606.14,0.00
2024-12-10 17:36:38,55,2562,19,36,1402.15,2606.62,0.00
2024-12-10 17:36:38,54,2562,18,36,1426.70,2606.67,0.00
2024-12-10 17:36:38,54,2563,18,36,1466.52,2607.00,0.00
2024-12-10 17:36:38,55,2563,18,37,1439.86,2607.02,0.00
2024-12-10 17:36:38,54,2563,17,37,1433.54,2607.46,0.00
2024-12-10 17:36:38,54,2564,17,37,1468.21,2608.00,0.00
2024-12-10 17:36:38,55,2564,18,37,1441.51,2608.02,0.00
2024-12-10 17:36:38,54,2564,18,36,1465.80,2608.04,0.00
2024-12-10 17:36:38,54,2565,18,36,1470.22,2609.00,0.00
2024-12-10 17:36:38,55,2565,18,37,1443.49,2609.02,0.00
2024-12-10 17:36:38,54,2565,17,37,1448.09,2609.30,0.00
2024-12-10 17:36:39,54,2566,17,37,1478.52,2610.00,0.00
2024-12-10 17:36:39,55,2566,17,38,1451.63,2610.02,0.00
2024-12-10 17:36:39,54,2566,17,37,1475.62,2610.04,0.00
2024-12-10 17:36:39,54,2567,17,37,1480.05,2611.00,0.00
2024-12-10 17:36:39,55,2567,17,38,1453.14,2611.02,0.00
2024-12-10 17:36:39,55,2568,17,38,1447.05,2612.00,0.00
2024-12-10 17:36:39,56,2568,17,39,1421.21,2612.02,0.00
2024-12-10 17:36:39,55,2568,17,38,1444.20,2612.04,0.00
2024-12-10 17:36:39,54,2568,16,38,1449.07,2612.76,0.00
2024-12-10 17:36:39,54,2569,16,38,1491.35,2613.00,0.00
2024-12-10 17:36:39,55,2569,16,39,1464.23,2613.02,0.00
2024-12-10 17:36:39,55,2570,16,39,1458.14,2614.00,0.00
2024-12-10 17:36:39,56,2570,17,39,1432.10,2614.02,0.00
2024-12-10 17:36:39,55,2570,17,38,1455.76,2614.04,0.00
2024-12-10 17:36:39,55,2571,17,38,1459.65,2615.00,0.00
2024-12-10 17:36:39,56,2571,17,39,1433.58,2615.02,0.00
2024-12-10 17:36:39,56,2572,17,39,1427.12,2616.00,0.00
2024-12-10 17:36:39,57,2572,17,40,1402.08,2616.02,0.00
2024-12-10 17:36:39,56,2572,17,39,1423.86,2616.05,0.00
2024-12-10 17:36:39,55,2572,16,39,1445.98,2616.18,0.00
2024-12-10 17:36:39,55,2573,16,39,1453.62,2617.00,0.00
2024-12-10 17:36:39,56,2573,17,39,1427.67,2617.02,0.00
2024-12-10 17:36:39,55,2573,16,39,1427.94,2617.07,0.00
2024-12-10 17:36:39,55,2574,16,39,1451.80,2618.00,0.00
2024-12-10 17:36:39,56,2574,16,40,1425.87,2618.02,0.00
2024-12-10 17:36:39,55,2574,16,39,1446.57,2618.05,0.00
2024-12-10 17:36:39,55,2575,16,39,1450.93,2619.00,0.00
2024-12-10 17:36:39,56,2575,17,39,1425.02,2619.02,0.00
2024-12-10 17:36:39,55,2575,16,39,1424.56,2619.66,0.00
2024-12-10 17:36:39,54,2575,15,39,1436.59,2619.93,0.00
2024-12-10 17:36:39,54,2576,15,39,1483.21,2620.00,0.00
2024-12-10 17:36:39,55,2576,16,39,1456.24,2620.02,0.00
2024-12-10 17:36:39,54,2576,16,38,1476.91,2620.07,0.00
2024-12-10 17:36:39,54,2577,16,38,1482.32,2621.00,0.00
2024-12-10 17:36:39,55,2577,17,38,1455.37,2621.02,0.00
2024-12-10 17:36:39,54,2577,16,38,1463.94,2621.22,0.00
2024-12-10 17:36:39,54,2578,16,38,1492.60,2622.00,0.00
2024-12-10 17:36:39,55,2578,16,39,1465.46,2622.02,0.00
2024-12-10 17:36:39,54,2578,16,38,1486.78,2622.07,0.00
2024-12-10 17:36:39,54,2579,16,38,1492.19,2623.00,0.00
2024-12-10 17:36:39,55,2579,17,38,1465.06,2623.02,0.00
2024-12-10 17:36:39,55,2580,17,38,1458.94,2624.00,0.00
2024-12-10 17:36:39,56,2580,18,38,1432.89,2624.02,0.00
2024-12-10 17:36:39,55,2580,18,37,1453.70,2624.07,0.00
2024-12-10 17:36:39,55,2581,18,37,1458.55,2625.00,0.00
2024-12-10 17:36:39,56,2581,18,38,1432.50,2625.02,0.00
2024-12-10 17:36:39,56,2582,18,38,1426.90,2626.00,0.00
2024-12-10 17:36:39,57,2582,19,38,1401.87,2626.02,0.00
2024-12-10 17:36:39,56,2582,19,37,1420.81,2626.07,0.00
2024-12-10 17:36:39,55,2582,18,37,1427.21,2626.40,0.00
2024-12-10 17:36:39,55,2583,18,37,1459.61,2627.00,0.00
2024-12-10 17:36:39,56,2583,18,38,1433.54,2627.02,0.00
2024-12-10 17:36:39,55,2583,17,38,1417.39,2627.58,0.00
2024-12-10 17:36:39,55,2584,17,38,1454.48,2628.00,0.00
2024-12-10 17:36:39,56,2584,18,38,1428.51,2628.02,0.00
2024-12-10 17:36:39,55,2584,17,38,1454.00,2628.02,0.00
2024-12-10 17:36:39,54,2584,17,37,1475.09,2628.06,0.00
2024-12-10 17:36:39,53,2584,16,37,1486.87,2628.66,0.00
2024-12-10 17:36:39,53,2585,16,37,1507.95,2629.00,0.00
2024-12-10 17:36:39,54,2585,17,37,1480.03,2629.02,0.00
2024-12-10 17:36:39,54,2586,17,37,1475.39,2630.00,0.00
2024-12-10 17:36:39,55,2586,17,38,1448.57,2630.02,0.00
2024-12-10 17:36:39,54,2586,17,37,1468.09,2630.06,0.00
2024-12-10 17:36:39,54,2587,17,37,1473.03,2631.00,0.00
2024-12-10 17:36:39,55,2587,17,38,1446.25,2631.02,0.00
2024-12-10 17:36:39,55,2588,17,38,1441.57,2632.00,0.00
2024-12-10 17:36:39,56,2588,18,38,1415.82,2632.02,0.00
2024-12-10 17:36:39,55,2588,18,37,1434.87,2632.05,0.00
2024-12-10 17:36:39,54,2588,17,37,1459.52,2632.13,0.00
2024-12-10 17:36:39,53,2588,16,37,1465.05,2632.77,0.00
2024-12-10 17:36:39,53,2589,16,37,1508.92,2633.00,0.00
2024-12-10 17:36:39,54,2589,17,37,1480.98,2633.02,0.00
2024-12-10 17:36:39,54,2590,17,37,1475.88,2634.00,0.00
2024-12-10 17:36:39,55,2590,18,37,1449.05,2634.02,0.00
2024-12-10 17:36:39,54,2590,18,36,1472.96,2634.02,0.00
2024-12-10 17:36:39,54,2591,18,36,1476.93,2635.00,0.00
2024-12-10 17:36:39,55,2591,18,37,1450.08,2635.02,0.00
2024-12-10 17:36:39,54,2591,18,36,1471.57,2635.04,0.00
2024-12-10 17:36:39,54,2592,18,36,1476.03,2636.00,0.00
2024-12-10 17:36:39,55,2592,18,37,1449.19,2636.02,0.00
2024-12-10 17:36:39,55,2593,18,37,1443.40,2637.00,0.00
2024-12-10 17:36:39,56,2593,19,37,1417.62,2637.02,0.00
2024-12-10 17:36:39,55,2593,19,36,1438.60,2637.04,0.00
2024-12-10 17:36:39,54,2593,18,36,1433.15,2637.94,0.00
2024-12-10 17:36:39,54,2594,18,36,1480.57,2638.00,0.00
2024-12-10 17:36:39,55,2594,18,37,1453.65,2638.02,0.00
2024-12-10 17:36:39,55,2595,18,37,1448.49,2639.00,0.00
2024-12-10 17:36:39,56,2595,19,37,1422.63,2639.02,0.00
2024-12-10 17:36:39,55,2595,19,36,1443.22,2639.04,0.00
2024-12-10 17:36:39,55,2596,19,36,1447.12,2640.00,0.00
2024-12-10 17:36:39,56,2596,20,36,1421.28,2640.02,0.00
2024-12-10 17:36:39,55,2596,19,36,1403.42,2640.96,0.00
2024-12-10 17:36:39,55,2597,19,36,1450.50,2641.00,0.00
2024-12-10 17:36:39,56,2597,20,36,1424.60,2641.02,0.00
2024-12-10 17:36:39,55,2597,20,35,1445.70,2641.04,0.00
2024-12-10 17:36:39,55,2598,20,35,1449.61,2642.00,0.00
2024-12-10 17:36:39,56,2598,21,35,1423.72,2642.02,0.00
2024-12-10 17:36:39,56,2599,21,35,1418.73,2643.00,0.00
2024-12-10 17:36:39,57,2599,22,35,1393.84,2643.02,0.00
2024-12-10 17:36:39,56,2599,22,34,1413.54,2643.04,0.00
2024-12-10 17:36:40,56,2600,22,34,1416.91,2644.00,0.00
2024-12-10 17:36:40,57,2600,22,35,1392.05,2644.02,0.00
2024-12-10 17:36:40,56,2600,21,35,1387.19,2644.13,0.00
2024-12-10 17:36:40,55,2600,20,35,1399.04,2644.64,0.00
2024-12-10 17:36:40,55,2601,20,35,1437.77,2645.00,0.00
2024-12-10 17:36:40,56,2601,20,36,1412.09,2645.02,0.00
2024-12-10 17:36:40,55,2601,20,35,1432.48,2645.04,0.00
2024-12-10 17:36:40,55,2602,20,35,1436.38,2646.00,0.00
2024-12-10 17:36:40,56,2602,20,36,1410.73,2646.02,0.00
2024-12-10 17:36:40,55,2602,19,36,1408.59,2646.36,0.00
2024-12-10 17:36:40,55,2603,19,36,1440.30,2647.00,0.00
2024-12-10 17:36:40,56,2603,20,36,1414.58,2647.02,0.00
2024-12-10 17:36:40,55,2603,20,35,1435.48,2647.04,0.00
2024-12-10 17:36:40,54,2603,19,35,1445.99,2647.33,0.00
2024-12-10 17:36:40,54,2604,19,35,1477.82,2648.00,0.00
2024-12-10 17:36:40,55,2604,20,35,1450.95,2648.02,0.00
2024-12-10 17:36:40,54,2604,19,35,1477.33,2648.02,0.00
2024-12-10 17:36:40,53,2604,18,35,1492.74,2648.11,0.00
2024-12-10 17:36:40,52,2604,17,35,1514.87,2648.21,0.00
2024-12-10 17:36:40,52,2605,17,35,1545.43,2649.00,0.00
2024-12-10 17:36:40,53,2605,17,36,1516.27,2649.02,0.00
2024-12-10 17:36:40,52,2605,17,35,1541.35,2649.02,0.00
2024-12-10 17:36:40,52,2606,17,35,1546.52,2650.00,0.00
2024-12-10 17:36:40,53,2606,17,36,1517.34,2650.02,0.00
2024-12-10 17:36:40,52,2606,16,36,1524.19,2650.25,0.00
2024-12-10 17:36:40,52,2607,16,36,1555.77,2651.00,0.00
2024-12-10 17:36:40,53,2607,17,36,1526.42,2651.02,0.00
2024-12-10 17:36:40,52,2607,17,35,1551.69,2651.02,0.00
2024-12-10 17:36:40,51,2607,16,35,1566.10,2651.63,0.00
2024-12-10 17:36:40,51,2608,16,35,1587.70,2652.00,0.00
2024-12-10 17:36:40,52,2608,16,36,1557.17,2652.02,0.00
2024-12-10 17:36:40,51,2608,15,36,1544.57,2652.94,0.00
2024-12-10 17:36:40,51,2609,15,36,1595.07,2653.00,0.00
2024-12-10 17:36:40,52,2609,15,37,1564.39,2653.02,0.00
2024-12-10 17:36:40,51,2609,15,36,1591.42,2653.02,0.00
2024-12-10 17:36:40,51,2610,15,36,1597.23,2654.00,0.00
2024-12-10 17:36:40,52,2610,16,36,1566.51,2654.02,0.00
2024-12-10 17:36:40,51,2610,15,36,1558.94,2654.49,0.00
2024-12-10 17:36:40,51,2611,15,36,1597.83,2655.00,0.00
2024-12-10 17:36:40,52,2611,16,36,1567.10,2655.02,0.00
2024-12-10 17:36:40,51,2611,16,35,1593.14,2655.02,0.00
2024-12-10 17:36:40,51,2612,16,35,1598.95,2656.00,0.00
2024-12-10 17:36:40,52,2612,17,35,1568.20,2656.02,0.00
2024-12-10 17:36:40,52,2613,17,35,1563.17,2657.00,0.00
2024-12-10 17:36:40,53,2613,18,35,1533.68,2657.02,0.00
2024-12-10 17:36:40,52,2613,18,34,1558.57,2657.02,0.00
2024-12-10 17:36:40,52,2614,18,34,1563.76,2658.00,0.00
2024-12-10 17:36:40,53,2614,19,34,1534.26,2658.02,0.00
2024-12-10 17:36:40,53,2615,19,34,1528.81,2659.00,0.00
2024-12-10 17:36:40,54,2615,19,35,1500.50,2659.02,0.00
2024-12-10 17:36:40,53,2615,19,34,1523.30,2659.02,0.00
2024-12-10 17:36:40,53,2616,19,34,1527.88,2660.00,0.00
2024-12-10 17:36:40,54,2616,20,34,1499.59,2660.02,0.00
2024-12-10 17:36:40,54,2617,20,34,1493.75,2661.00,0.00
2024-12-10 17:36:40,55,2617,20,35,1466.59,2661.02,0.00
2024-12-10 17:36:40,54,2617,20,34,1488.82,2661.02,0.00
2024-12-10 17:36:40,53,2617,19,34,1483.31,2661.96,0.00
2024-12-10 17:36:40,53,2618,19,34,1532.55,2662.00,0.00
2024-12-10 17:36:40,54,2618,20,34,1504.17,2662.02,0.00
2024-12-10 17:36:40,53,2618,19,34,1501.06,2662.40,0.00
2024-12-10 17:36:40,53,2619,19,34,1535.64,2663.00,0.00
2024-12-10 17:36:40,54,2619,20,34,1507.20,2663.02,0.00
2024-12-10 17:36:40,53,2619,20,33,1531.11,2663.02,0.00
2024-12-10 17:36:40,53,2620,20,33,1535.71,2664.00,0.00
2024-12-10 17:36:40,54,2620,20,34,1507.27,2664.02,0.00
2024-12-10 17:36:40,54,2621,20,34,1501.42,2665.00,0.00
2024-12-10 17:36:40,55,2621,21,34,1474.12,2665.02,0.00
2024-12-10 17:36:40,54,2621,21,33,1497.47,2665.02,0.00
2024-12-10 17:36:40,53,2621,20,33,1492.08,2665.96,0.00
2024-12-10 17:36:40,53,2622,20,33,1541.39,2666.00,0.00
2024-12-10 17:36:40,54,2622,21,33,1512.85,2666.02,0.00
2024-12-10 17:36:40,54,2623,21,33,1506.99,2667.00,0.00
2024-12-10 17:36:40,55,2623,22,33,1479.59,2667.02,0.00
2024-12-10 17:36:40,54,2623,22,32,1503.04,2667.02,0.00
2024-12-10 17:36:40,53,2623,21,32,1505.43,2667.47,0.00
2024-12-10 17:36:40,53,2624,21,32,1542.04,2668.00,0.00
2024-12-10 17:36:40,54,2624,22,32,1513.49,2668.02,0.00
2024-12-10 17:36:40,54,2625,22,32,1507.63,2669.00,0.00
2024-12-10 17:36:40,55,2625,23,32,1480.22,2669.02,0.00
2024-12-10 17:36:40,54,2625,23,31,1503.67,2669.02,0.00
2024-12-10 17:36:40,54,2626,23,31,1507.70,2670.00,0.00
2024-12-10 17:36:40,55,2626,23,32,1480.29,2670.02,0.00
2024-12-10 17:36:40,55,2627,23,32,1474.04,2671.00,0.00
2024-12-10 17:36:40,56,2627,24,32,1447.72,2671.02,0.00
2024-12-10 17:36:40,55,2627,24,31,1470.64,2671.02,0.00
2024-12-10 17:36:40,54,2627,23,31,1479.91,2671.69,0.00
2024-12-10 17:36:40,54,2628,23,31,1501.41,2672.00,0.00
2024-12-10 17:36:40,55,2628,23,32,1474.11,2672.02,0.00
2024-12-10 17:36:40,55,2629,23,32,1468.22,2673.00,0.00
2024-12-10 17:36:40,56,2629,24,32,1442.00,2673.02,0.00
2024-12-10 17:36:40,55,2629,24,31,1464.33,2673.02,0.00
2024-12-10 17:36:40,55,2630,24,31,1467.79,2674.00,0.00
2024-12-10 17:36:40,56,2630,24,32,1441.58,2674.02,0.00
2024-12-10 17:36:41,56,2631,24,32,1437.09,2675.00,0.00
2024-12-10 17:36:41,57,2631,25,32,1411.87,2675.02,0.00
2024-12-10 17:36:41,56,2631,25,31,1431.83,2675.02,0.00
2024-12-10 17:36:41,55,2631,24,31,1431.55,2675.46,0.00
2024-12-10 17:36:41,55,2632,24,31,1465.97,2676.00,0.00
2024-12-10 17:36:41,56,2632,25,31,1439.79,2676.02,0.00
2024-12-10 17:36:41,55,2632,24,31,1428.44,2676.85,0.00
2024-12-10 17:36:41,55,2633,24,31,1473.33,2677.00,0.00
2024-12-10 17:36:41,56,2633,25,31,1447.02,2677.02,0.00
2024-12-10 17:36:41,55,2633,25,30,1468.47,2677.02,0.00
2024-12-10 17:36:41,54,2633,24,30,1478.12,2677.69,0.00
2024-12-10 17:36:41,54,2634,24,30,1499.69,2678.00,0.00
2024-12-10 17:36:41,55,2634,25,30,1472.42,2678.02,0.00
2024-12-10 17:36:41,54,2634,24,30,1485.85,2678.17,0.00
2024-12-10 17:36:41,54,2635,24,30,1494.93,2679.00,0.00
2024-12-10 17:36:41,55,2635,25,30,1467.75,2679.02,0.00
2024-12-10 17:36:41,54,2635,25,29,1490.47,2679.02,0.00
2024-12-10 17:36:41,53,2635,24,29,1493.34,2679.45,0.00
2024-12-10 17:36:41,53,2636,24,29,1529.63,2680.00,0.00
2024-12-10 17:36:41,54,2636,25,29,1501.31,2680.02,0.00
2024-12-10 17:36:41,53,2636,24,29,1501.24,2680.68,0.00
2024-12-10 17:36:41,53,2637,24,29,1543.49,2681.00,0.00
2024-12-10 17:36:41,54,2637,24,30,1514.90,2681.02,0.00
2024-12-10 17:36:41,53,2637,24,29,1538.93,2681.02,0.00
2024-12-10 17:36:41,52,2637,23,29,1564.96,2681.15,0.00
2024-12-10 17:36:41,52,2638,23,29,1573.76,2682.00,0.00
2024-12-10 17:36:41,53,2638,24,29,1544.06,2682.02,0.00
2024-12-10 17:36:41,53,2639,24,29,1538.56,2683.00,0.00
2024-12-10 17:36:41,54,2639,24,30,1510.07,2683.02,0.00
2024-12-10 17:36:41,53,2639,24,29,1534.51,2683.02,0.00
2024-12-10 17:36:41,53,2640,24,29,1539.14,2684.00,0.00
2024-12-10 17:36:41,54,2640,24,30,1510.63,2684.02,0.00
2024-12-10 17:36:41,54,2641,24,30,1504.73,2685.00,0.00
2024-12-10 17:36:41,55,2641,25,30,1477.37,2685.02,0.00
2024-12-10 17:36:41,54,2641,25,29,1501.25,2685.02,0.00
2024-12-10 17:36:41,54,2642,25,29,1505.29,2686.00,0.00
2024-12-10 17:36:41,55,2642,25,30,1477.92,2686.02,0.00
2024-12-10 17:36:41,54,2642,24,30,1457.94,2686.67,0.00
2024-12-10 17:36:41,54,2643,24,30,1498.99,2687.00,0.00
2024-12-10 17:36:41,55,2643,25,30,1471.74,2687.02,0.00
2024-12-10 17:36:41,54,2643,25,29,1496.01,2687.02,0.00
2024-12-10 17:36:41,53,2643,24,29,1521.23,2687.13,0.00
2024-12-10 17:36:41,52,2643,23,29,1545.24,2687.21,0.00
2024-12-10 17:36:41,52,2644,23,29,1576.24,2688.00,0.00
2024-12-10 17:36:41,53,2644,23,30,1546.50,2688.02,0.00
2024-12-10 17:36:41,52,2644,22,30,1539.73,2688.48,0.00
2024-12-10 17:36:41,52,2645,22,30,1577.86,2689.00,0.00
2024-12-10 17:36:41,53,2645,23,30,1548.09,2689.02,0.00
2024-12-10 17:36:41,52,2645,23,29,1575.28,2689.02,0.00
2024-12-10 17:36:41,52,2646,23,29,1580.52,2690.00,0.00
2024-12-10 17:36:41,53,2646,23,30,1550.70,2690.02,0.00
2024-12-10 17:36:41,53,2647,23,30,1545.18,2691.00,0.00
2024-12-10 17:36:41,54,2647,23,31,1516.57,2691.02,0.00
2024-12-10 17:36:41,53,2647,23,30,1542.64,2691.02,0.00
2024-12-10 17:36:41,53,2648,23,30,1547.28,2692.00,0.00
2024-12-10 17:36:41,54,2648,23,31,1518.63,2692.02,0.00
2024-12-10 17:36:41,54,2649,23,31,1512.71,2693.00,0.00
2024-12-10 17:36:41,55,2649,23,32,1485.20,2693.02,0.00
2024-12-10 17:36:41,54,2649,23,31,1510.71,2693.02,0.00
2024-12-10 17:36:41,53,2649,22,31,1508.73,2693.53,0.00
2024-12-10 17:36:41,53,2650,22,31,1547.18,2694.00,0.00
2024-12-10 17:36:41,54,2650,22,32,1518.53,2694.02,0.00
2024-12-10 17:36:41,54,2651,22,32,1512.98,2695.00,0.00
2024-12-10 17:36:41,55,2651,23,32,1485.47,2695.02,0.00
2024-12-10 17:36:41,54,2651,23,31,1508.49,2695.04,0.00
2024-12-10 17:36:41,53,2651,22,31,1503.76,2695.57,0.00
2024-12-10 17:36:41,53,2652,22,31,1543.25,2696.00,0.00
2024-12-10 17:36:41,54,2652,22,32,1514.67,2696.02,0.00
2024-12-10 17:36:41,53,2652,21,32,1512.06,2696.72,0.00
2024-12-10 17:36:41,53,2653,21,32,1555.52,2697.00,0.00
2024-12-10 17:36:41,54,2653,21,33,1526.72,2697.02,0.00
2024-12-10 17:36:41,53,2653,21,32,1550.44,2697.04,0.00
2024-12-10 17:36:41,53,2654,21,32,1555.59,2698.00,0.00
2024-12-10 17:36:41,54,2654,22,32,1526.78,2698.02,0.00
2024-12-10 17:36:41,53,2654,21,32,1524.37,2698.72,0.00
2024-12-10 17:36:41,53,2655,21,32,1567.88,2699.00,0.00
2024-12-10 17:36:41,54,2655,21,33,1538.85,2699.02,0.00
2024-12-10 17:36:41,53,2655,21,32,1562.79,2699.04,0.00
2024-12-10 17:36:41,53,2656,21,32,1567.95,2700.00,0.00
2024-12-10 17:36:41,54,2656,21,33,1538.92,2700.02,0.00
2024-12-10 17:36:41,53,2656,20,33,1554.23,2700.15,0.00
2024-12-10 17:36:41,52,2656,19,33,1581.38,2700.15,0.00
2024-12-10 17:36:41,52,2657,19,33,1611.02,2701.00,0.00
2024-12-10 17:36:41,53,2657,20,33,1580.62,2701.02,0.00
2024-12-10 17:36:41,53,2658,20,33,1575.37,2702.00,0.00
2024-12-10 17:36:41,54,2658,21,33,1546.20,2702.02,0.00
2024-12-10 17:36:41,53,2658,21,32,1568.75,2702.08,0.00
2024-12-10 17:36:41,53,2659,21,32,1574.88,2703.00,0.00
2024-12-10 17:36:41,54,2659,21,33,1545.72,2703.02,0.00
2024-12-10 17:36:41,53,2659,20,33,1561.27,2703.13,0.00
2024-12-10 17:36:41,53,2660,20,33,1570.59,2704.00,0.00
2024-12-10 17:36:41,54,2660,21,33,1541.50,2704.02,0.00
2024-12-10 17:36:41,53,2660,21,32,1561.17,2704.08,0.00
2024-12-10 17:36:41,53,2661,21,32,1567.16,2705.00,0.00
2024-12-10 17:36:41,54,2661,21,33,1538.14,2705.02,0.00
2024-12-10 17:36:41,53,2661,21,32,1565.47,2705.06,0.00
2024-12-10 17:36:41,53,2662,21,32,1561.01,2706.00,0.00
2024-12-10 17:36:41,54,2662,21,33,1532.10,2706.02,0.00
2024-12-10 17:36:41,53,2662,21,32,1554.38,2706.06,0.00
2024-12-10 17:36:41,52,2662,20,32,1556.50,2706.46,0.00
2024-12-10 17:36:41,52,2663,20,32,1592.42,2707.00,0.00
2024-12-10 17:36:41,53,2663,21,32,1562.37,2707.02,0.00
2024-12-10 17:36:41,52,2663,21,31,1586.17,2707.02,0.00
2024-12-10 17:36:41,51,2663,20,31,1607.26,2707.22,0.00
2024-12-10 17:36:42,50,2663,19,31,1628.27,2707.62,0.00
2024-12-10 17:36:42,50,2664,19,31,1670.05,2708.00,0.00
2024-12-10 17:36:42,51,2664,19,32,1637.30,2708.02,0.00
2024-12-10 17:36:42,51,2665,19,32,1630.10,2709.00,0.00
2024-12-10 17:36:42,52,2665,20,32,1598.76,2709.02,0.00
2024-12-10 17:36:42,51,2665,20,31,1624.26,2709.04,0.00
2024-12-10 17:36:42,51,2666,20,31,1627.96,2710.00,0.00
2024-12-10 17:36:42,52,2666,21,31,1596.66,2710.02,0.00
2024-12-10 17:36:42,52,2667,21,31,1589.97,2711.00,0.00
2024-12-10 17:36:42,53,2667,21,32,1559.97,2711.02,0.00
2024-12-10 17:36:42,52,2667,21,31,1582.15,2711.04,0.00
2024-12-10 17:36:42,52,2668,21,31,1585.00,2712.00,0.00
2024-12-10 17:36:42,53,2668,22,31,1555.09,2712.02,0.00
2024-12-10 17:36:42,53,2669,22,31,1547.61,2713.00,0.00
2024-12-10 17:36:42,54,2669,23,31,1518.95,2713.02,0.00
2024-12-10 17:36:42,53,2669,23,30,1540.45,2713.04,0.00
2024-12-10 17:36:42,53,2670,23,30,1541.33,2714.00,0.00
2024-12-10 17:36:42,54,2670,23,31,1512.78,2714.02,0.00
2024-12-10 17:36:42,53,2670,22,31,1512.66,2714.06,0.00
2024-12-10 17:36:42,53,2671,22,31,1533.65,2715.00,0.00
2024-12-10 17:36:42,54,2671,23,31,1505.25,2715.02,0.00
2024-12-10 17:36:42,55,2670,23,32,1477.39,2715.07,0.00
2024-12-10 17:36:42,55,2671,23,32,1512.79,2716.00,0.00
2024-12-10 17:36:42,56,2671,23,33,1485.78,2716.02,0.00
2024-12-10 17:36:42,55,2671,23,32,1504.91,2716.05,0.00
2024-12-10 17:36:42,54,2671,22,32,1491.30,2716.93,0.00
2024-12-10 17:36:42,54,2672,22,32,1589.96,2717.00,0.00
2024-12-10 17:36:42,55,2672,22,33,1561.05,2717.02,0.00
2024-12-10 17:36:42,54,2672,22,32,1561.28,2717.70,0.00
2024-12-10 17:36:42,54,2673,22,32,1585.90,2718.00,0.00
2024-12-10 17:36:42,55,2673,23,32,1557.06,2718.02,0.00
2024-12-10 17:36:42,54,2673,23,31,1578.37,2718.06,0.00
2024-12-10 17:36:42,53,2673,22,31,1606.85,2718.09,0.00
2024-12-10 17:36:42,52,2673,21,31,1608.16,2718.87,0.00
2024-12-10 17:36:42,52,2674,21,31,1656.90,2719.00,0.00
2024-12-10 17:36:42,53,2674,21,32,1625.63,2719.02,0.00
2024-12-10 17:36:42,52,2674,20,32,1611.30,2719.60,0.00
2024-12-10 17:36:42,52,2675,20,32,1652.92,2720.00,0.00
2024-12-10 17:36:42,53,2675,20,33,1621.73,2720.02,0.00
2024-12-10 17:36:42,52,2675,20,32,1645.09,2720.06,0.00
2024-12-10 17:36:42,51,2675,19,32,1663.87,2720.24,0.00
2024-12-10 17:36:42,51,2676,19,32,1696.94,2721.00,0.00
2024-12-10 17:36:42,52,2676,19,33,1664.30,2721.02,0.00
2024-12-10 17:36:42,51,2676,18,33,1670.37,2721.61,0.00
2024-12-10 17:36:42,51,2677,18,33,1692.31,2722.00,0.00
2024-12-10 17:36:42,52,2677,18,34,1659.76,2722.02,0.00
2024-12-10 17:36:42,51,2677,18,33,1684.86,2722.06,0.00
2024-12-10 17:36:42,51,2678,18,33,1691.86,2723.00,0.00
2024-12-10 17:36:42,52,2678,19,33,1659.33,2723.02,0.00
2024-12-10 17:36:42,51,2678,18,33,1664.66,2723.63,0.00
2024-12-10 17:36:42,51,2679,18,33,1688.80,2724.00,0.00
2024-12-10 17:36:42,52,2679,19,33,1656.32,2724.02,0.00
2024-12-10 17:36:42,51,2679,19,32,1679.20,2724.06,0.00
2024-12-10 17:36:42,50,2679,18,32,1696.75,2724.64,0.00
2024-12-10 17:36:42,50,2680,18,32,1719.94,2725.00,0.00
2024-12-10 17:36:42,51,2680,19,32,1686.21,2725.02,0.00
2024-12-10 17:36:42,51,2681,19,32,1682.19,2726.00,0.00
2024-12-10 17:36:42,52,2681,20,32,1649.84,2726.02,0.00
2024-12-10 17:36:42,51,2681,20,31,1672.59,2726.06,0.00
2024-12-10 17:36:42,50,2681,19,31,1671.55,2726.96,0.00
2024-12-10 17:36:42,50,2682,19,31,1725.02,2727.00,0.00
2024-12-10 17:36:42,51,2682,20,31,1691.19,2727.02,0.00
2024-12-10 17:36:42,51,2683,20,31,1687.73,2728.00,0.00
2024-12-10 17:36:42,52,2683,20,32,1655.27,2728.02,0.00
2024-12-10 17:36:42,51,2683,19,32,1687.20,2728.02,0.00
2024-12-10 17:36:42,50,2683,19,31,1710.60,2728.06,0.00
2024-12-10 17:36:42,50,2684,19,31,1718.30,2729.00,0.00
2024-12-10 17:36:42,51,2684,19,32,1684.60,2729.02,0.00
2024-12-10 17:36:42,50,2684,18,32,1698.66,2729.04,0.00
2024-12-10 17:36:42,49,2684,17,32,1733.33,2729.04,0.00
2024-12-10 17:36:42,49,2685,17,32,1752.33,2730.00,0.00
2024-12-10 17:36:42,50,2685,17,33,1717.29,2730.02,0.00
2024-12-10 17:36:42,49,2685,17,32,1739.54,2730.06,0.00
2024-12-10 17:36:42,49,2686,17,32,1747.96,2731.00,0.00
2024-12-10 17:36:42,50,2686,18,32,1713.00,2731.02,0.00
2024-12-10 17:36:42,50,2687,18,32,1710.84,2732.00,0.00
2024-12-10 17:36:42,51,2687,19,32,1677.29,2732.02,0.00
2024-12-10 17:36:42,50,2687,19,31,1698.29,2732.06,0.00
2024-12-10 17:36:42,50,2688,19,31,1706.00,2733.00,0.00
2024-12-10 17:36:42,51,2688,20,31,1672.55,2733.02,0.00
2024-12-10 17:36:42,50,2688,19,31,1691.27,2733.08,0.00
2024-12-10 17:36:42,50,2689,19,31,1721.39,2734.00,0.00
2024-12-10 17:36:42,51,2689,19,32,1687.63,2734.02,0.00
2024-12-10 17:36:42,50,2689,19,31,1708.83,2734.06,0.00
2024-12-10 17:36:42,50,2690,19,31,1716.55,2735.00,0.00
2024-12-10 17:36:42,51,2690,20,31,1682.89,2735.02,0.00
2024-12-10 17:36:42,51,2691,20,31,1682.73,2736.00,0.00
2024-12-10 17:36:42,52,2691,20,32,1650.37,2736.02,0.00
2024-12-10 17:36:42,51,2691,19,32,1645.97,2736.69,0.00
2024-12-10 17:36:42,51,2692,19,32,1691.29,2737.00,0.00
2024-12-10 17:36:42,52,2692,19,33,1658.77,2737.02,0.00
2024-12-10 17:36:42,51,2692,19,32,1685.97,2737.12,0.00
2024-12-10 17:36:42,51,2693,19,32,1694.59,2738.00,0.00
2024-12-10 17:36:42,52,2693,19,33,1662.00,2738.02,0.00
2024-12-10 17:36:42,52,2694,19,33,1661.42,2739.00,0.00
2024-12-10 17:36:42,53,2694,20,33,1630.07,2739.02,0.00
2024-12-10 17:36:42,52,2694,19,33,1622.99,2739.75,0.00
2024-12-10 17:36:42,52,2695,19,33,1669.01,2740.00,0.00
2024-12-10 17:36:42,53,2695,20,33,1637.52,2740.02,0.00
2024-12-10 17:36:42,52,2695,20,32,1664.31,2740.12,0.00
2024-12-10 17:36:42,52,2696,20,32,1672.26,2741.00,0.00
2024-12-10 17:36:42,53,2696,21,32,1640.71,2741.02,0.00
2024-12-10 17:36:42,52,2696,20,32,1632.74,2741.48,0.00
2024-12-10 17:36:43,52,2697,20,32,1671.62,2742.00,0.00
2024-12-10 17:36:43,53,2697,20,33,1640.08,2742.02,0.00
2024-12-10 17:36:43,53,2698,20,33,1634.47,2743.00,0.00
2024-12-10 17:36:43,54,2698,21,33,1604.20,2743.02,0.00
2024-12-10 17:36:43,53,2698,21,32,1630.89,2743.11,0.00
2024-12-10 17:36:43,53,2699,21,32,1638.17,2744.00,0.00
2024-12-10 17:36:43,54,2699,21,33,1607.84,2744.02,0.00
2024-12-10 17:36:43,53,2699,20,33,1620.62,2744.17,0.00
2024-12-10 17:36:43,53,2700,20,33,1650.16,2745.00,0.00
2024-12-10 17:36:43,54,2700,20,34,1619.60,2745.02,0.00
2024-12-10 17:36:43,53,2700,19,34,1622.83,2745.32,0.00
2024-12-10 17:36:43,53,2701,19,34,1656.46,2746.00,0.00
2024-12-10 17:36:43,54,2701,20,34,1625.79,2746.02,0.00
2024-12-10 17:36:43,53,2701,19,34,1653.91,2746.11,0.00
2024-12-10 17:36:43,52,2701,19,33,1685.19,2746.12,0.00
2024-12-10 17:36:43,52,2702,19,33,1693.16,2747.00,0.00
2024-12-10 17:36:43,53,2702,20,33,1661.21,2747.02,0.00
2024-12-10 17:36:43,53,2703,20,33,1658.41,2748.00,0.00
2024-12-10 17:36:43,54,2703,20,34,1627.70,2748.02,0.00
2024-12-10 17:36:43,53,2703,20,33,1644.97,2748.11,0.00
2024-12-10 17:36:43,53,2704,20,33,1652.27,2749.00,0.00
2024-12-10 17:36:43,54,2704,20,34,1621.68,2749.02,0.00
2024-12-10 17:36:43,53,2704,19,34,1640.88,2749.04,0.00
2024-12-10 17:36:43,54,2703,20,34,1591.79,2749.39,0.00
2024-12-10 17:36:43,54,2704,20,34,1644.16,2750.00,0.00
2024-12-10 17:36:43,55,2704,20,35,1614.27,2750.02,0.00
2024-12-10 17:36:43,54,2704,20,34,1631.46,2750.09,0.00
2024-12-10 17:36:43,53,2704,19,34,1628.83,2750.55,0.00
2024-12-10 17:36:43,53,2705,19,34,1720.49,2751.00,0.00
2024-12-10 17:36:43,54,2705,19,35,1688.63,2751.02,0.00
2024-12-10 17:36:43,53,2705,18,35,1678.71,2751.53,0.00
2024-12-10 17:36:43,54,2704,18,36,1646.63,2751.59,0.00
2024-12-10 17:36:43,54,2705,18,36,1697.40,2752.00,0.00
2024-12-10 17:36:43,55,2705,19,36,1666.53,2752.02,0.00
2024-12-10 17:36:43,54,2705,19,35,1685.19,2752.09,0.00
2024-12-10 17:36:43,54,2706,19,35,1742.37,2753.00,0.00
2024-12-10 17:36:43,55,2706,20,35,1710.69,2753.02,0.00
2024-12-10 17:36:43,55,2707,20,35,1706.07,2754.00,0.00
2024-12-10 17:36:43,56,2707,21,35,1675.60,2754.02,0.00
2024-12-10 17:36:43,55,2707,21,34,1694.57,2754.09,0.00
2024-12-10 17:36:43,54,2707,20,34,1700.60,2754.78,0.00
2024-12-10 17:36:43,54,2708,20,34,1745.67,2755.00,0.00
2024-12-10 17:36:43,55,2708,20,35,1713.93,2755.02,0.00
2024-12-10 17:36:43,54,2708,19,35,1706.11,2755.48,0.00
2024-12-10 17:36:43,54,2709,19,35,1743.24,2756.00,0.00
2024-12-10 17:36:43,55,2709,20,35,1711.55,2756.02,0.00
2024-12-10 17:36:43,54,2709,20,34,1732.04,2756.09,0.00
2024-12-10 17:36:43,54,2710,20,34,1738.26,2757.00,0.00
2024-12-10 17:36:43,55,2710,20,35,1706.66,2757.02,0.00
2024-12-10 17:36:43,54,2710,19,35,1727.04,2757.04,0.00
2024-12-10 17:36:43,54,2711,19,35,1741.96,2758.00,0.00
2024-12-10 17:36:43,55,2711,19,36,1710.28,2758.02,0.00
2024-12-10 17:36:43,54,2711,19,35,1731.76,2758.07,0.00
2024-12-10 17:36:43,53,2711,18,35,1740.39,2758.77,0.00
2024-12-10 17:36:43,53,2712,18,35,1786.40,2759.00,0.00
2024-12-10 17:36:43,54,2712,18,36,1753.32,2759.02,0.00
2024-12-10 17:36:43,54,2713,18,36,1748.07,2760.00,0.00
2024-12-10 17:36:43,55,2713,18,37,1716.29,2760.02,0.00
2024-12-10 17:36:43,54,2713,18,36,1737.87,2760.07,0.00
2024-12-10 17:36:43,53,2713,17,36,1741.47,2760.49,0.00
2024-12-10 17:36:43,53,2714,17,36,1779.88,2761.00,0.00
2024-12-10 17:36:43,54,2714,18,36,1746.92,2761.02,0.00
2024-12-10 17:36:43,53,2714,17,36,1733.31,2761.60,0.00
2024-12-10 17:36:43,52,2714,16,36,1765.60,2761.64,0.00
2024-12-10 17:36:43,52,2715,16,36,1808.92,2762.00,0.00
2024-12-10 17:36:43,53,2715,16,37,1774.79,2762.02,0.00
2024-12-10 17:36:43,52,2715,16,36,1798.85,2762.08,0.00
2024-12-10 17:36:43,52,2716,16,36,1805.86,2763.00,0.00
2024-12-10 17:36:43,53,2716,17,36,1771.79,2763.02,0.00
2024-12-10 17:36:43,54,2715,17,37,1722.18,2763.30,0.00
2024-12-10 17:36:43,54,2716,17,37,1758.03,2764.00,0.00
2024-12-10 17:36:43,55,2716,18,37,1726.07,2764.02,0.00
2024-12-10 17:36:43,54,2716,18,36,1748.32,2764.07,0.00
2024-12-10 17:36:43,54,2717,18,36,1805.26,2765.00,0.00
2024-12-10 17:36:43,55,2717,19,36,1772.44,2765.02,0.00
2024-12-10 17:36:43,55,2718,19,36,1766.89,2766.00,0.00
2024-12-10 17:36:43,56,2718,20,36,1735.34,2766.02,0.00
2024-12-10 17:36:43,55,2718,20,35,1756.35,2766.07,0.00
2024-12-10 17:36:43,55,2719,20,35,1761.50,2767.00,0.00
2024-12-10 17:36:43,56,2719,20,36,1730.04,2767.02,0.00
2024-12-10 17:36:43,56,2720,20,36,1724.55,2768.00,0.00
2024-12-10 17:36:43,57,2720,21,36,1694.30,2768.02,0.00
2024-12-10 17:36:43,56,2720,21,35,1714.18,2768.07,0.00
2024-12-10 17:36:43,56,2721,21,35,1718.75,2769.00,0.00
2024-12-10 17:36:43,57,2721,22,35,1688.59,2769.02,0.00
2024-12-10 17:36:43,56,2721,21,35,1712.33,2769.05,0.00
2024-12-10 17:36:43,56,2722,21,35,1726.29,2770.00,0.00
2024-12-10 17:36:43,57,2722,21,36,1696.01,2770.02,0.00
2024-12-10 17:36:43,56,2722,21,35,1716.90,2770.05,0.00
2024-12-10 17:36:43,56,2723,21,35,1720.98,2771.00,0.00
2024-12-10 17:36:43,57,2723,22,35,1690.79,2771.02,0.00
2024-12-10 17:36:43,56,2723,21,35,1719.89,2771.05,0.00
2024-12-10 17:36:43,56,2724,21,35,1715.68,2772.00,0.00
2024-12-10 17:36:43,57,2724,21,36,1685.58,2772.02,0.00
2024-12-10 17:36:43,56,2724,21,35,1706.28,2772.05,0.00
2024-12-10 17:36:43,55,2724,20,35,1724.74,2772.51,0.00
2024-12-10 17:36:43,54,2724,19,35,1737.83,2772.89,0.00
2024-12-10 17:36:43,54,2725,19,35,1786.19,2773.00,0.00
2024-12-10 17:36:43,55,2725,19,36,1753.71,2773.02,0.00
2024-12-10 17:36:43,55,2726,19,36,1747.93,2774.00,0.00
2024-12-10 17:36:43,56,2726,20,36,1716.72,2774.02,0.00
2024-12-10 17:36:43,55,2726,20,35,1737.85,2774.05,0.00
2024-12-10 17:36:43,55,2727,20,35,1742.51,2775.00,0.00
2024-12-10 17:36:43,56,2727,20,36,1711.39,2775.02,0.00
2024-12-10 17:36:43,55,2727,19,36,1716.27,2775.60,0.00
2024-12-10 17:36:44,55,2728,19,36,1737.68,2776.00,0.00
2024-12-10 17:36:44,56,2728,20,36,1706.65,2776.02,0.00
2024-12-10 17:36:44,55,2728,20,35,1726.60,2776.07,0.00
2024-12-10 17:36:44,54,2728,19,35,1735.42,2776.74,0.00
2024-12-10 17:36:44,54,2729,19,35,1779.84,2777.00,0.00
2024-12-10 17:36:44,55,2729,20,35,1747.48,2777.02,0.00
2024-12-10 17:36:44,55,2730,20,35,1742.31,2778.00,0.00
2024-12-10 17:36:44,56,2730,21,35,1711.19,2778.02,0.00
2024-12-10 17:36:44,55,2730,20,35,1741.30,2778.04,0.00
2024-12-10 17:36:44,54,2730,20,34,1762.26,2778.09,0.00
2024-12-10 17:36:44,54,2731,20,34,1768.52,2779.00,0.00
2024-12-10 17:36:44,55,2731,20,35,1736.36,2779.02,0.00
2024-12-10 17:36:44,54,2731,19,35,1734.32,2779.76,0.00
2024-12-10 17:36:44,54,2732,19,35,1779.31,2780.00,0.00
2024-12-10 17:36:44,55,2732,19,36,1746.95,2780.02,0.00
2024-12-10 17:36:44,54,2732,19,35,1768.01,2780.09,0.00
2024-12-10 17:36:44,54,2733,19,35,1774.28,2781.00,0.00
2024-12-10 17:36:44,55,2733,20,35,1742.02,2781.02,0.00
2024-12-10 17:36:44,54,2733,19,35,1744.56,2781.35,0.00
2024-12-10 17:36:44,54,2734,19,35,1778.52,2782.00,0.00
2024-12-10 17:36:44,55,2734,20,35,1746.19,2782.02,0.00
2024-12-10 17:36:44,54,2734,20,34,1767.22,2782.09,0.00
2024-12-10 17:36:44,54,2735,20,34,1773.50,2783.00,0.00
2024-12-10 17:36:44,55,2735,21,34,1741.25,2783.02,0.00
2024-12-10 17:36:44,55,2736,21,34,1734.83,2784.00,0.00
2024-12-10 17:36:44,56,2736,22,34,1703.85,2784.02,0.00
2024-12-10 17:36:44,55,2736,22,33,1724.23,2784.09,0.00
2024-12-10 17:36:44,55,2737,22,33,1729.88,2785.00,0.00
2024-12-10 17:36:44,56,2737,23,33,1698.99,2785.02,0.00
2024-12-10 17:36:44,56,2738,23,33,1692.15,2786.00,0.00
2024-12-10 17:36:44,57,2738,24,33,1662.47,2786.02,0.00
2024-12-10 17:36:44,56,2738,24,32,1682.23,2786.09,0.00
2024-12-10 17:36:44,56,2739,24,32,1687.29,2787.00,0.00
2024-12-10 17:36:44,57,2739,25,32,1657.69,2787.02,0.00
2024-12-10 17:36:44,57,2740,25,32,1650.77,2788.00,0.00
2024-12-10 17:36:44,58,2740,26,32,1622.31,2788.02,0.00
2024-12-10 17:36:44,57,2740,26,31,1641.50,2788.09,0.00
2024-12-10 17:36:44,57,2741,26,31,1645.98,2789.00,0.00
2024-12-10 17:36:44,58,2741,27,31,1617.60,2789.02,0.00
2024-12-10 17:36:44,57,2741,26,31,1602.17,2789.95,0.00
2024-12-10 17:36:44,57,2742,26,31,1649.68,2790.00,0.00
2024-12-10 17:36:44,58,2742,27,31,1621.24,2790.02,0.00
2024-12-10 17:36:44,57,2742,27,30,1638.45,2790.09,0.00
2024-12-10 17:36:44,56,2742,26,30,1646.09,2790.41,0.00
2024-12-10 17:36:44,56,2743,26,30,1679.89,2791.00,0.00
2024-12-10 17:36:44,57,2743,27,30,1650.42,2791.02,0.00
2024-12-10 17:36:44,56,2743,26,30,1666.47,2791.13,0.00
2024-12-10 17:36:44,56,2744,26,30,1682.88,2792.00,0.00
2024-12-10 17:36:44,57,2744,27,30,1653.35,2792.02,0.00
2024-12-10 17:36:44,57,2745,27,30,1647.50,2793.00,0.00
2024-12-10 17:36:44,58,2745,28,30,1619.10,2793.02,0.00
2024-12-10 17:36:44,57,2745,28,29,1636.26,2793.09,0.00
2024-12-10 17:36:44,57,2746,28,29,1640.07,2794.00,0.00
2024-12-10 17:36:44,58,2746,28,30,1611.79,2794.02,0.00
2024-12-10 17:36:44,57,2746,27,30,1627.84,2794.11,0.00
2024-12-10 17:36:44,57,2747,27,30,1633.16,2795.00,0.00
2024-12-10 17:36:44,58,2747,28,30,1605.00,2795.02,0.00
2024-12-10 17:36:44,57,2747,28,29,1623.37,2795.09,0.00
2024-12-10 17:36:44,56,2747,27,29,1633.38,2795.34,0.00
2024-12-10 17:36:44,56,2748,27,29,1665.27,2796.00,0.00
2024-12-10 17:36:44,57,2748,28,29,1636.06,2796.02,0.00
2024-12-10 17:36:44,56,2748,27,29,1627.97,2796.46,0.00
2024-12-10 17:36:44,56,2749,27,29,1663.31,2797.00,0.00
2024-12-10 17:36:44,57,2749,27,30,1634.13,2797.02,0.00
2024-12-10 17:36:44,56,2749,27,29,1652.35,2797.09,0.00
2024-12-10 17:36:44,56,2750,27,29,1656.31,2798.00,0.00
2024-12-10 17:36:44,57,2750,27,30,1627.26,2798.02,0.00
2024-12-10 17:36:44,57,2751,27,30,1620.56,2799.00,0.00
2024-12-10 17:36:44,58,2751,27,31,1592.62,2799.02,0.00
2024-12-10 17:36:44,57,2751,27,30,1607.97,2799.11,0.00
2024-12-10 17:36:44,56,2751,26,30,1616.74,2799.71,0.00
2024-12-10 17:36:44,56,2752,26,30,1658.94,2800.00,0.00
2024-12-10 17:36:44,57,2752,27,30,1629.84,2800.02,0.00
2024-12-10 17:36:44,57,2753,27,30,1622.82,2801.00,0.00
2024-12-10 17:36:44,58,2753,28,30,1594.84,2801.02,0.00
2024-12-10 17:36:44,57,2753,28,29,1610.59,2801.11,0.00
2024-12-10 17:36:44,57,2754,28,29,1615.57,2802.00,0.00
2024-12-10 17:36:44,58,2754,28,30,1587.71,2802.02,0.00
2024-12-10 17:36:44,57,2754,27,30,1583.84,2802.68,0.00
2024-12-10 17:36:44,57,2755,27,30,1624.39,2803.00,0.00
2024-12-10 17:36:44,58,2755,28,30,1596.38,2803.02,0.00
2024-12-10 17:36:44,57,2755,28,29,1612.89,2803.11,0.00
2024-12-10 17:36:44,57,2756,28,29,1617.87,2804.00,0.00
2024-12-10 17:36:44,58,2756,29,29,1589.98,2804.02,0.00
2024-12-10 17:36:44,57,2756,28,29,1582.10,2804.46,0.00
2024-12-10 17:36:44,56,2756,27,29,1604.98,2804.66,0.00
2024-12-10 17:36:44,56,2757,27,29,1645.80,2805.00,0.00
2024-12-10 17:36:44,57,2757,27,30,1616.93,2805.02,0.00
2024-12-10 17:36:44,56,2757,26,30,1642.89,2805.09,0.00
2024-12-10 17:36:44,55,2757,26,29,1663.58,2805.09,0.00
2024-12-10 17:36:44,55,2758,26,29,1669.26,2806.00,0.00
2024-12-10 17:36:44,56,2758,27,29,1639.45,2806.02,0.00
2024-12-10 17:36:44,55,2758,26,29,1646.87,2806.26,0.00
2024-12-10 17:36:44,55,2759,26,29,1677.49,2807.00,0.00
2024-12-10 17:36:44,56,2759,26,30,1647.54,2807.02,0.00
2024-12-10 17:36:44,55,2759,26,29,1666.28,2807.09,0.00
2024-12-10 17:36:44,55,2760,26,29,1671.96,2808.00,0.00
2024-12-10 17:36:44,56,2760,26,30,1642.11,2808.02,0.00
2024-12-10 17:36:44,56,2761,26,30,1636.72,2809.00,0.00
2024-12-10 17:36:44,57,2761,27,30,1608.00,2809.02,0.00
2024-12-10 17:36:44,56,2761,27,29,1626.19,2809.09,0.00
2024-12-10 17:36:44,55,2761,26,29,1634.12,2809.69,0.00
2024-12-10 17:36:45,55,2762,26,29,1676.75,2810.00,0.00
2024-12-10 17:36:45,56,2762,27,29,1646.81,2810.02,0.00
2024-12-10 17:36:45,56,2763,27,29,1642.05,2811.00,0.00
2024-12-10 17:36:45,57,2763,28,29,1613.24,2811.02,0.00
2024-12-10 17:36:45,56,2763,28,28,1631.02,2811.09,0.00
2024-12-10 17:36:45,55,2763,27,28,1636.02,2811.58,0.00
2024-12-10 17:36:45,55,2764,27,28,1675.70,2812.00,0.00
2024-12-10 17:36:45,56,2764,28,28,1645.78,2812.02,0.00
2024-12-10 17:36:45,55,2764,27,28,1674.93,2812.04,0.00
2024-12-10 17:36:45,55,2765,27,28,1671.00,2813.00,0.00
2024-12-10 17:36:45,56,2765,28,28,1641.16,2813.02,0.00
2024-12-10 17:36:45,55,2765,28,27,1660.78,2813.07,0.00
2024-12-10 17:36:45,55,2766,28,27,1665.97,2814.00,0.00
2024-12-10 17:36:45,56,2766,29,27,1636.22,2814.02,0.00
2024-12-10 17:36:45,56,2767,29,27,1630.59,2815.00,0.00
2024-12-10 17:36:45,57,2767,29,28,1601.98,2815.02,0.00
2024-12-10 17:36:45,56,2767,29,27,1630.08,2815.02,0.00
2024-12-10 17:36:45,55,2767,28,27,1659.21,2815.02,0.00
2024-12-10 17:36:45,54,2767,28,26,1680.57,2815.06,0.00
2024-12-10 17:36:45,53,2767,27,26,1678.73,2815.55,0.00
2024-12-10 17:36:45,53,2768,27,26,1719.44,2816.00,0.00
2024-12-10 17:36:45,54,2768,28,26,1687.60,2816.02,0.00
2024-12-10 17:36:45,54,2769,28,26,1681.41,2817.00,0.00
2024-12-10 17:36:45,55,2769,29,26,1650.84,2817.02,0.00
2024-12-10 17:36:45,54,2769,29,25,1672.56,2817.06,0.00
2024-12-10 17:36:45,54,2770,29,25,1677.83,2818.00,0.00
2024-12-10 17:36:45,55,2770,30,25,1647.33,2818.02,0.00
2024-12-10 17:36:45,55,2771,30,25,1640.74,2819.00,0.00
2024-12-10 17:36:45,56,2771,30,26,1611.44,2819.02,0.00
2024-12-10 17:36:45,55,2771,30,25,1633.06,2819.05,0.00
2024-12-10 17:36:45,55,2772,30,25,1637.73,2820.00,0.00
2024-12-10 17:36:45,56,2772,31,25,1608.49,2820.02,0.00
2024-12-10 17:36:45,57,2771,32,25,1554.81,2820.61,0.00
2024-12-10 17:36:45,57,2772,32,25,1585.44,2821.00,0.00
2024-12-10 17:36:45,58,2772,32,26,1558.10,2821.02,0.00
2024-12-10 17:36:45,57,2772,32,25,1577.04,2821.05,0.00
2024-12-10 17:36:45,57,2773,32,25,1630.06,2822.00,0.00
2024-12-10 17:36:45,58,2773,33,25,1601.96,2822.02,0.00
2024-12-10 17:36:45,58,2774,33,25,1595.75,2823.00,0.00
2024-12-10 17:36:45,59,2774,33,26,1568.70,2823.02,0.00
2024-12-10 17:36:45,58,2774,33,25,1587.48,2823.05,0.00
2024-12-10 17:36:45,58,2775,33,25,1590.47,2824.00,0.00
2024-12-10 17:36:45,59,2775,34,25,1563.51,2824.02,0.00
2024-12-10 17:36:45,59,2776,34,25,1557.31,2825.00,0.00
2024-12-10 17:36:45,60,2776,34,26,1531.36,2825.02,0.00
2024-12-10 17:36:45,59,2776,34,25,1549.66,2825.05,0.00
2024-12-10 17:36:45,58,2776,33,25,1540.42,2825.97,0.00
2024-12-10 17:36:45,58,2777,33,25,1588.18,2826.00,0.00
2024-12-10 17:36:45,59,2777,34,25,1561.26,2826.02,0.00
2024-12-10 17:36:45,59,2778,34,25,1555.03,2827.00,0.00
2024-12-10 17:36:45,60,2778,34,26,1529.11,2827.02,0.00
2024-12-10 17:36:45,59,2778,34,25,1547.85,2827.05,0.00
2024-12-10 17:36:45,58,2778,33,25,1541.22,2827.57,0.00
2024-12-10 17:36:45,58,2779,33,25,1578.09,2828.00,0.00
2024-12-10 17:36:45,59,2779,34,25,1551.35,2828.02,0.00
2024-12-10 17:36:45,58,2779,33,25,1533.30,2828.64,0.00
2024-12-10 17:36:45,58,2780,33,25,1572.10,2829.00,0.00
2024-12-10 17:36:45,59,2780,34,25,1545.45,2829.02,0.00
2024-12-10 17:36:45,58,2780,34,24,1565.28,2829.05,0.00
2024-12-10 17:36:45,58,2781,34,24,1568.26,2830.00,0.00
2024-12-10 17:36:45,59,2781,35,24,1541.68,2830.02,0.00
2024-12-10 17:36:45,59,2782,35,24,1535.51,2831.00,0.00
2024-12-10 17:36:45,60,2782,36,24,1509.92,2831.02,0.00
2024-12-10 17:36:45,59,2782,36,23,1528.80,2831.05,0.00
2024-12-10 17:36:45,58,2782,35,23,1523.15,2831.55,0.00
2024-12-10 17:36:45,58,2783,35,23,1559.60,2832.00,0.00
2024-12-10 17:36:45,59,2783,35,24,1533.17,2832.02,0.00
2024-12-10 17:36:45,59,2784,35,24,1528.39,2833.00,0.00
2024-12-10 17:36:45,60,2784,35,25,1502.92,2833.02,0.00
2024-12-10 17:36:45,59,2784,35,24,1519.29,2833.09,0.00
2024-12-10 17:36:45,58,2784,34,24,1544.05,2833.09,0.00
2024-12-10 17:36:45,58,2785,34,24,1567.55,2834.00,0.00
2024-12-10 17:36:45,59,2785,34,25,1540.98,2834.02,0.00
2024-12-10 17:36:45,59,2786,34,25,1536.65,2835.00,0.00
2024-12-10 17:36:45,60,2786,35,25,1511.04,2835.02,0.00
2024-12-10 17:36:45,59,2786,35,24,1527.05,2835.09,0.00
2024-12-10 17:36:45,58,2786,34,24,1553.35,2835.09,0.00
2024-12-10 17:36:45,58,2787,34,24,1557.30,2836.00,0.00
2024-12-10 17:36:45,59,2787,34,25,1530.91,2836.02,0.00
2024-12-10 17:36:45,58,2787,33,25,1527.10,2836.38,0.00
2024-12-10 17:36:45,58,2788,33,25,1558.83,2837.00,0.00
2024-12-10 17:36:45,59,2788,34,25,1532.41,2837.02,0.00
2024-12-10 17:36:45,58,2788,33,25,1542.70,2837.07,0.00
2024-12-10 17:36:45,57,2788,33,24,1561.80,2837.07,0.00
2024-12-10 17:36:45,57,2789,33,24,1585.74,2838.00,0.00
2024-12-10 17:36:45,58,2789,33,25,1558.40,2838.02,0.00
2024-12-10 17:36:45,57,2789,32,25,1572.33,2838.14,0.00
2024-12-10 17:36:45,56,2789,31,25,1589.51,2838.52,0.00
2024-12-10 17:36:45,56,2790,31,25,1610.34,2839.00,0.00
2024-12-10 17:36:45,57,2790,32,25,1582.09,2839.02,0.00
2024-12-10 17:36:45,56,2790,32,24,1601.23,2839.07,0.00
2024-12-10 17:36:45,56,2791,32,24,1605.84,2840.00,0.00
2024-12-10 17:36:45,57,2791,32,25,1577.66,2840.02,0.00
2024-12-10 17:36:45,57,2792,32,25,1573.67,2841.00,0.00
2024-12-10 17:36:45,58,2792,32,26,1546.54,2841.02,0.00
2024-12-10 17:36:45,57,2792,32,25,1564.21,2841.09,0.00
2024-12-10 17:36:45,57,2793,32,25,1568.74,2842.00,0.00
2024-12-10 17:36:45,58,2793,33,25,1541.69,2842.02,0.00
2024-12-10 17:36:45,58,2794,33,25,1538.47,2843.00,0.00
2024-12-10 17:36:45,59,2794,33,26,1512.40,2843.02,0.00
2024-12-10 17:36:45,58,2794,33,25,1527.22,2843.12,0.00
2024-12-10 17:36:45,58,2795,33,25,1532.15,2844.00,0.00
2024-12-10 17:36:46,59,2795,33,26,1506.18,2844.02,0.00
2024-12-10 17:36:46,59,2796,33,26,1502.58,2845.00,0.00
2024-12-10 17:36:46,60,2796,34,26,1477.54,2845.02,0.00
2024-12-10 17:36:46,59,2796,34,25,1492.00,2845.12,0.00
2024-12-10 17:36:46,58,2796,33,25,1480.70,2845.97,0.00
2024-12-10 17:36:46,58,2797,33,25,1528.81,2846.00,0.00
2024-12-10 17:36:46,59,2797,33,26,1502.90,2846.02,0.00
2024-12-10 17:36:46,59,2798,33,26,1503.21,2847.00,0.00
2024-12-10 17:36:46,60,2798,34,26,1478.16,2847.02,0.00
2024-12-10 17:36:46,59,2798,33,26,1497.64,2847.09,0.00
2024-12-10 17:36:46,59,2799,33,26,1510.71,2848.00,0.00
2024-12-10 17:36:46,60,2799,34,26,1485.53,2848.02,0.00
2024-12-10 17:36:46,59,2799,33,26,1507.89,2848.10,0.00
2024-12-10 17:36:46,58,2799,32,26,1533.88,2848.10,0.00
2024-12-10 17:36:46,57,2799,32,25,1555.32,2848.18,0.00
2024-12-10 17:36:46,56,2799,31,25,1572.38,2848.55,0.00
2024-12-10 17:36:46,56,2800,31,25,1590.53,2849.00,0.00
2024-12-10 17:36:46,57,2800,31,26,1562.63,2849.02,0.00
2024-12-10 17:36:46,56,2800,30,26,1589.51,2849.04,0.00
2024-12-10 17:36:46,56,2801,30,26,1596.81,2850.00,0.00
2024-12-10 17:36:46,57,2801,31,26,1568.80,2850.02,0.00
2024-12-10 17:36:46,57,2802,31,26,1569.98,2851.00,0.00
2024-12-10 17:36:46,58,2802,31,27,1542.91,2851.02,0.00
2024-12-10 17:36:46,58,2803,31,27,1536.94,2852.00,0.00
2024-12-10 17:36:46,59,2803,31,28,1510.89,2852.02,0.00
2024-12-10 17:36:46,58,2803,31,27,1528.13,2852.17,0.00
2024-12-10 17:36:46,58,2804,31,27,1534.53,2853.00,0.00
2024-12-10 17:36:46,59,2804,31,28,1508.52,2853.02,0.00
2024-12-10 17:36:46,58,2804,30,28,1531.60,2853.12,0.00
2024-12-10 17:36:46,57,2804,29,28,1557.97,2853.12,0.00
2024-12-10 17:36:46,57,2805,29,28,1561.21,2854.00,0.00
2024-12-10 17:36:46,58,2805,30,28,1534.29,2854.02,0.00
2024-12-10 17:36:46,57,2805,29,28,1530.18,2854.58,0.00
2024-12-10 17:36:46,57,2806,29,28,1568.56,2855.00,0.00
2024-12-10 17:36:46,58,2806,30,28,1541.51,2855.02,0.00
2024-12-10 17:36:46,57,2806,30,27,1563.08,2855.14,0.00
2024-12-10 17:36:46,57,2807,30,27,1569.11,2856.00,0.00
2024-12-10 17:36:46,58,2807,31,27,1542.05,2856.02,0.00
2024-12-10 17:36:46,57,2807,31,26,1565.10,2856.02,0.00
2024-12-10 17:36:46,57,2808,31,26,1564.26,2857.00,0.00
2024-12-10 17:36:46,58,2808,31,27,1537.29,2857.02,0.00
2024-12-10 17:36:46,58,2809,31,27,1529.45,2858.00,0.00
2024-12-10 17:36:46,59,2809,31,28,1503.53,2858.02,0.00
2024-12-10 17:36:46,58,2809,31,27,1525.53,2858.12,0.00
2024-12-10 17:36:46,57,2809,30,27,1539.52,2858.56,0.00
2024-12-10 17:36:46,56,2809,29,27,1540.14,2858.96,0.00
2024-12-10 17:36:46,56,2810,29,27,1590.19,2859.00,0.00
2024-12-10 17:36:46,57,2810,29,28,1562.30,2859.02,0.00
2024-12-10 17:36:46,57,2811,29,28,1561.20,2860.00,0.00
2024-12-10 17:36:46,58,2811,30,28,1534.28,2860.02,0.00
2024-12-10 17:36:46,57,2811,29,28,1517.84,2860.49,0.00
2024-12-10 17:36:46,57,2812,29,28,1553.85,2861.00,0.00
2024-12-10 17:36:46,58,2812,29,29,1527.06,2861.02,0.00
2024-12-10 17:36:46,57,2812,28,29,1550.86,2861.12,0.00
2024-12-10 17:36:46,56,2812,28,28,1577.53,2861.13,0.00
2024-12-10 17:36:46,56,2813,28,28,1583.69,2862.00,0.00
2024-12-10 17:36:46,57,2813,28,29,1555.90,2862.02,0.00
2024-12-10 17:36:46,57,2814,28,29,1554.76,2863.00,0.00
2024-12-10 17:36:46,58,2814,28,30,1527.95,2863.02,0.00
2024-12-10 17:36:46,57,2814,28,29,1554.25,2863.02,0.00
2024-12-10 17:36:46,56,2814,27,29,1543.25,2863.80,0.00
2024-12-10 17:36:46,56,2815,27,29,1588.93,2864.00,0.00
2024-12-10 17:36:46,57,2815,28,29,1561.05,2864.02,0.00
2024-12-10 17:36:46,56,2815,28,28,1584.85,2864.13,0.00
2024-12-10 17:36:46,55,2815,27,28,1587.70,2864.58,0.00
2024-12-10 17:36:46,55,2816,27,28,1628.14,2865.00,0.00
2024-12-10 17:36:46,56,2816,28,28,1599.06,2865.02,0.00
2024-12-10 17:36:46,55,2816,27,28,1610.62,2865.11,0.00
2024-12-10 17:36:46,55,2817,27,28,1626.64,2866.00,0.00
2024-12-10 17:36:46,56,2817,28,28,1597.59,2866.02,0.00
2024-12-10 17:36:46,56,2818,28,28,1589.67,2867.00,0.00
2024-12-10 17:36:46,57,2818,28,29,1561.78,2867.02,0.00
2024-12-10 17:36:46,56,2818,27,29,1587.46,2867.09,0.00
2024-12-10 17:36:46,55,2818,27,28,1615.80,2867.09,0.00
2024-12-10 17:36:46,55,2819,27,28,1620.48,2868.00,0.00
2024-12-10 17:36:46,56,2819,28,28,1591.55,2868.02,0.00
2024-12-10 17:36:46,55,2819,27,28,1597.59,2868.26,0.00
2024-12-10 17:36:46,55,2820,27,28,1627.62,2869.00,0.00
2024-12-10 17:36:46,56,2820,28,28,1598.55,2869.02,0.00
2024-12-10 17:36:46,55,2820,28,27,1615.11,2869.09,0.00
2024-12-10 17:36:46,55,2821,28,27,1619.53,2870.00,0.00
2024-12-10 17:36:46,56,2821,28,28,1590.61,2870.02,0.00
2024-12-10 17:36:46,56,2822,28,28,1588.99,2871.00,0.00
2024-12-10 17:36:46,57,2822,28,29,1561.12,2871.02,0.00
2024-12-10 17:36:46,56,2822,27,29,1554.79,2871.63,0.00
2024-12-10 17:36:46,56,2823,27,29,1595.59,2872.00,0.00
2024-12-10 17:36:46,57,2823,27,30,1567.60,2872.02,0.00
2024-12-10 17:36:46,56,2823,26,30,1589.97,2872.16,0.00
2024-12-10 17:36:46,55,2823,26,29,1616.79,2872.16,0.00
2024-12-10 17:36:46,55,2824,26,29,1644.04,2873.00,0.00
2024-12-10 17:36:46,56,2824,26,30,1614.68,2873.02,0.00
2024-12-10 17:36:46,55,2824,25,30,1627.17,2873.13,0.00
2024-12-10 17:36:46,55,2825,25,30,1642.94,2874.00,0.00
2024-12-10 17:36:46,56,2825,25,31,1613.60,2874.02,0.00
2024-12-10 17:36:46,55,2825,24,31,1642.42,2874.02,0.00
2024-12-10 17:36:46,54,2825,23,31,1666.09,2874.07,0.00
2024-12-10 17:36:46,54,2826,23,31,1680.98,2875.00,0.00
2024-12-10 17:36:46,55,2826,24,31,1650.42,2875.02,0.00
2024-12-10 17:36:46,54,2826,24,30,1674.62,2875.15,0.00
2024-12-10 17:36:46,54,2827,24,30,1680.19,2876.00,0.00
2024-12-10 17:36:46,55,2827,25,30,1649.64,2876.02,0.00
2024-12-10 17:36:47,54,2827,24,30,1678.52,2876.07,0.00
2024-12-10 17:36:47,54,2828,24,30,1677.39,2877.00,0.00
2024-12-10 17:36:47,55,2828,25,30,1646.89,2877.02,0.00
2024-12-10 17:36:47,54,2828,24,30,1675.27,2877.09,0.00
2024-12-10 17:36:47,53,2828,23,30,1660.18,2877.81,0.00
2024-12-10 17:36:47,53,2829,23,30,1709.21,2878.00,0.00
2024-12-10 17:36:47,54,2829,23,31,1677.55,2878.02,0.00
2024-12-10 17:36:47,53,2829,22,31,1708.66,2878.02,0.00
2024-12-10 17:36:47,52,2829,22,30,1736.56,2878.12,0.00
2024-12-10 17:36:47,51,2829,22,29,1764.97,2878.18,0.00
2024-12-10 17:36:47,51,2830,22,29,1775.70,2879.00,0.00
2024-12-10 17:36:47,52,2830,23,29,1741.55,2879.02,0.00
2024-12-10 17:36:47,52,2831,23,29,1740.79,2880.00,0.00
2024-12-10 17:36:47,53,2831,24,29,1707.95,2880.02,0.00
2024-12-10 17:36:47,53,2832,24,29,1702.02,2881.00,0.00
2024-12-10 17:36:47,54,2832,25,29,1670.50,2881.02,0.00
2024-12-10 17:36:47,53,2832,24,29,1699.86,2881.09,0.00
2024-12-10 17:36:47,52,2832,24,28,1730.89,2881.10,0.00
2024-12-10 17:36:47,52,2833,24,28,1738.68,2882.00,0.00
2024-12-10 17:36:47,53,2833,24,29,1705.87,2882.02,0.00
2024-12-10 17:36:47,53,2834,24,29,1704.49,2883.00,0.00
2024-12-10 17:36:47,54,2834,24,30,1672.93,2883.02,0.00
2024-12-10 17:36:47,53,2834,23,30,1655.85,2883.91,0.00
2024-12-10 17:36:47,53,2835,23,30,1707.60,2884.00,0.00
2024-12-10 17:36:47,54,2835,24,30,1675.98,2884.02,0.00
2024-12-10 17:36:47,53,2835,24,29,1703.81,2884.11,0.00
2024-12-10 17:36:47,53,2836,24,29,1711.46,2885.00,0.00
2024-12-10 17:36:47,54,2836,24,30,1679.76,2885.02,0.00
2024-12-10 17:36:47,53,2836,23,30,1681.31,2885.68,0.00
2024-12-10 17:36:47,53,2837,23,30,1726.75,2886.00,0.00
2024-12-10 17:36:47,54,2837,23,31,1694.78,2886.02,0.00
2024-12-10 17:36:47,53,2837,22,31,1710.42,2886.06,0.00
2024-12-10 17:36:47,53,2838,22,31,1727.35,2887.00,0.00
2024-12-10 17:36:47,54,2838,22,32,1695.36,2887.02,0.00
2024-12-10 17:36:47,53,2838,22,31,1720.84,2887.13,0.00
2024-12-10 17:36:47,52,2838,21,31,1743.11,2887.17,0.00
2024-12-10 17:36:47,52,2839,21,31,1775.32,2888.00,0.00
2024-12-10 17:36:47,53,2839,21,32,1741.83,2888.02,0.00
2024-12-10 17:36:47,52,2839,20,32,1774.77,2888.02,0.00
2024-12-10 17:36:47,52,2840,20,32,1774.34,2889.00,0.00
2024-12-10 17:36:47,53,2840,21,32,1740.86,2889.02,0.00
2024-12-10 17:36:47,52,2840,20,32,1729.17,2889.83,0.00
2024-12-10 17:36:47,52,2841,20,32,1779.89,2890.00,0.00
2024-12-10 17:36:47,53,2841,20,33,1746.30,2890.02,0.00
2024-12-10 17:36:47,52,2841,19,33,1779.33,2890.02,0.00
2024-12-10 17:36:47,51,2841,19,32,1809.71,2890.10,0.00
2024-12-10 17:36:47,51,2842,19,32,1818.25,2891.00,0.00
2024-12-10 17:36:47,52,2842,20,32,1783.28,2891.02,0.00
2024-12-10 17:36:47,52,2843,20,32,1780.88,2892.00,0.00
2024-12-10 17:36:47,53,2843,21,32,1747.27,2892.02,0.00
2024-12-10 17:36:47,53,2844,21,32,1741.33,2893.00,0.00
2024-12-10 17:36:47,54,2844,22,32,1709.08,2893.02,0.00
2024-12-10 17:36:47,53,2844,22,31,1738.07,2893.09,0.00
2024-12-10 17:36:47,53,2845,22,31,1745.21,2894.00,0.00
2024-12-10 17:36:47,54,2845,22,32,1712.89,2894.02,0.00
2024-12-10 17:36:47,54,2846,22,32,1709.96,2895.00,0.00
2024-12-10 17:36:47,55,2846,22,33,1678.87,2895.02,0.00
2024-12-10 17:36:47,54,2846,21,33,1668.00,2895.76,0.00
2024-12-10 17:36:47,54,2847,21,33,1714.84,2896.00,0.00
2024-12-10 17:36:47,55,2847,22,33,1683.66,2896.02,0.00
2024-12-10 17:36:47,54,2847,22,32,1712.18,2896.09,0.00
2024-12-10 17:36:47,54,2848,22,32,1718.65,2897.00,0.00
2024-12-10 17:36:47,55,2848,22,33,1687.41,2897.02,0.00
2024-12-10 17:36:47,54,2848,21,33,1683.42,2897.43,0.00
2024-12-10 17:36:47,54,2849,21,33,1720.86,2898.00,0.00
2024-12-10 17:36:47,55,2849,22,33,1689.57,2898.02,0.00
2024-12-10 17:36:47,54,2849,21,33,1692.00,2898.33,0.00
2024-12-10 17:36:47,54,2850,21,33,1726.82,2899.00,0.00
2024-12-10 17:36:47,55,2850,21,34,1695.42,2899.02,0.00
2024-12-10 17:36:47,54,2850,21,33,1722.55,2899.13,0.00
2024-12-10 17:36:47,54,2851,21,33,1730.10,2900.00,0.00
2024-12-10 17:36:47,55,2851,22,33,1698.64,2900.02,0.00
2024-12-10 17:36:47,54,2851,21,33,1728.33,2900.07,0.00
2024-12-10 17:36:47,54,2852,21,33,1727.20,2901.00,0.00
2024-12-10 17:36:47,55,2852,22,33,1695.80,2901.02,0.00
2024-12-10 17:36:47,54,2852,22,32,1713.26,2901.11,0.00
2024-12-10 17:36:47,54,2853,22,32,1720.09,2902.00,0.00
2024-12-10 17:36:47,55,2853,23,32,1688.82,2902.02,0.00
2024-12-10 17:36:47,55,2854,23,32,1683.47,2903.00,0.00
2024-12-10 17:36:47,56,2854,24,32,1653.41,2903.02,0.00
2024-12-10 17:36:47,55,2854,24,31,1669.77,2903.11,0.00
2024-12-10 17:36:47,55,2855,24,31,1673.20,2904.00,0.00
2024-12-10 17:36:47,56,2855,25,31,1643.33,2904.02,0.00
2024-12-10 17:36:47,56,2856,25,31,1636.66,2905.00,0.00
2024-12-10 17:36:47,57,2856,25,32,1607.94,2905.02,0.00
2024-12-10 17:36:47,56,2856,25,31,1623.71,2905.11,0.00
2024-12-10 17:36:47,56,2857,25,31,1628.51,2906.00,0.00
2024-12-10 17:36:47,57,2857,26,31,1599.93,2906.02,0.00
2024-12-10 17:36:47,56,2857,25,31,1586.39,2906.54,0.00
2024-12-10 17:36:47,56,2858,25,31,1625.12,2907.00,0.00
2024-12-10 17:36:47,57,2858,26,31,1596.60,2907.02,0.00
2024-12-10 17:36:47,56,2858,26,30,1611.64,2907.13,0.00
2024-12-10 17:36:47,56,2859,26,30,1616.67,2908.00,0.00
2024-12-10 17:36:47,57,2859,26,31,1588.31,2908.02,0.00
2024-12-10 17:36:47,56,2859,25,31,1604.61,2908.09,0.00
2024-12-10 17:36:47,56,2860,25,31,1619.10,2909.00,0.00
2024-12-10 17:36:47,57,2860,26,31,1590.70,2909.02,0.00
2024-12-10 17:36:47,56,2860,26,30,1605.10,2909.13,0.00
2024-12-10 17:36:47,55,2860,25,30,1619.96,2909.31,0.00
2024-12-10 17:36:47,55,2861,25,30,1653.21,2910.00,0.00
2024-12-10 17:36:47,56,2861,25,31,1623.69,2910.02,0.00
2024-12-10 17:36:47,55,2861,24,31,1611.01,2910.67,0.00
2024-12-10 17:36:48,55,2862,24,31,1654.64,2911.00,0.00
2024-12-10 17:36:48,56,2862,25,31,1625.10,2911.02,0.00
2024-12-10 17:36:48,55,2862,25,30,1644.70,2911.13,0.00
2024-12-10 17:36:48,55,2863,25,30,1651.60,2912.00,0.00
2024-12-10 17:36:48,56,2863,25,31,1622.10,2912.02,0.00
2024-12-10 17:36:48,55,2863,24,31,1612.60,2912.47,0.00
2024-12-10 17:36:48,55,2864,24,31,1650.57,2913.00,0.00
2024-12-10 17:36:48,56,2864,25,31,1621.10,2913.02,0.00
2024-12-10 17:36:48,55,2864,25,30,1636.82,2913.13,0.00
2024-12-10 17:36:48,55,2865,25,30,1643.65,2914.00,0.00
2024-12-10 17:36:48,56,2865,26,30,1614.30,2914.02,0.00
2024-12-10 17:36:48,56,2866,26,30,1611.00,2915.00,0.00
2024-12-10 17:36:48,57,2866,26,31,1582.73,2915.02,0.00
2024-12-10 17:36:48,56,2866,25,31,1607.97,2915.11,0.00
2024-12-10 17:36:48,55,2866,25,30,1627.14,2915.11,0.00
2024-12-10 17:36:48,55,2867,25,30,1632.10,2916.00,0.00
2024-12-10 17:36:48,56,2867,26,30,1602.95,2916.02,0.00
2024-12-10 17:36:48,56,2868,26,30,1599.51,2917.00,0.00
2024-12-10 17:36:48,57,2868,26,31,1571.45,2917.02,0.00
2024-12-10 17:36:48,56,2868,25,31,1598.99,2917.02,0.00
2024-12-10 17:36:48,55,2868,25,30,1614.29,2917.11,0.00
2024-12-10 17:36:48,55,2869,25,30,1618.80,2918.00,0.00
2024-12-10 17:36:48,56,2869,26,30,1589.89,2918.02,0.00
2024-12-10 17:36:48,55,2869,25,30,1611.57,2918.09,0.00
2024-12-10 17:36:48,55,2870,25,30,1626.26,2919.00,0.00
2024-12-10 17:36:48,56,2870,26,30,1597.22,2919.02,0.00
2024-12-10 17:36:48,55,2870,26,29,1613.53,2919.09,0.00
2024-12-10 17:36:48,55,2871,26,29,1617.70,2920.00,0.00
2024-12-10 17:36:48,56,2871,27,29,1588.82,2920.02,0.00
2024-12-10 17:36:48,56,2872,27,29,1585.02,2921.00,0.00
2024-12-10 17:36:48,57,2872,27,30,1557.21,2921.02,0.00
2024-12-10 17:36:48,56,2872,27,29,1573.03,2921.09,0.00
2024-12-10 17:36:48,56,2873,27,29,1576.80,2922.00,0.00
2024-12-10 17:36:48,57,2873,27,30,1549.13,2922.02,0.00
2024-12-10 17:36:48,56,2873,26,30,1526.39,2922.91,0.00
2024-12-10 17:36:48,56,2874,26,30,1576.03,2923.00,0.00
2024-12-10 17:36:48,57,2874,27,30,1548.39,2923.02,0.00
2024-12-10 17:36:48,56,2874,27,29,1564.04,2923.09,0.00
2024-12-10 17:36:48,55,2874,26,29,1575.04,2923.58,0.00
2024-12-10 17:36:48,55,2875,26,29,1616.27,2924.00,0.00
2024-12-10 17:36:48,56,2875,26,30,1587.41,2924.02,0.00
2024-12-10 17:36:48,55,2875,25,30,1615.74,2924.02,0.00
2024-12-10 17:36:48,54,2875,24,30,1621.38,2924.48,0.00
2024-12-10 17:36:48,54,2876,24,30,1644.18,2925.00,0.00
2024-12-10 17:36:48,55,2876,25,30,1614.28,2925.02,0.00
2024-12-10 17:36:48,54,2876,25,29,1632.81,2925.07,0.00
2024-12-10 17:36:48,53,2876,24,29,1650.35,2925.51,0.00
2024-12-10 17:36:48,53,2877,24,29,1691.55,2926.00,0.00
2024-12-10 17:36:48,54,2877,24,30,1660.23,2926.02,0.00
2024-12-10 17:36:48,54,2878,24,30,1657.40,2927.00,0.00
2024-12-10 17:36:48,55,2878,24,31,1627.26,2927.02,0.00
2024-12-10 17:36:48,54,2878,24,30,1646.56,2927.07,0.00
2024-12-10 17:36:48,54,2879,24,30,1652.54,2928.00,0.00
2024-12-10 17:36:48,55,2879,24,31,1622.49,2928.02,0.00
2024-12-10 17:36:48,55,2880,24,31,1620.51,2929.00,0.00
2024-12-10 17:36:48,56,2880,25,31,1591.57,2929.02,0.00
2024-12-10 17:36:48,55,2880,24,31,1619.98,2929.02,0.00
2024-12-10 17:36:48,54,2880,24,30,1638.59,2929.06,0.00
2024-12-10 17:36:48,53,2880,23,30,1669.51,2929.06,0.00
2024-12-10 17:36:48,53,2881,23,30,1675.60,2930.00,0.00
2024-12-10 17:36:48,54,2881,23,31,1644.57,2930.02,0.00
2024-12-10 17:36:48,53,2881,22,31,1656.85,2930.17,0.00
2024-12-10 17:36:48,53,2882,22,31,1688.34,2931.00,0.00
2024-12-10 17:36:48,54,2882,22,32,1657.07,2931.02,0.00
2024-12-10 17:36:48,53,2882,22,31,1675.63,2931.08,0.00
2024-12-10 17:36:48,52,2882,21,31,1695.22,2931.50,0.00
2024-12-10 17:36:48,52,2883,21,31,1714.76,2932.00,0.00
2024-12-10 17:36:48,53,2883,21,32,1682.40,2932.02,0.00
2024-12-10 17:36:48,53,2884,21,32,1680.50,2933.00,0.00
2024-12-10 17:36:48,54,2884,21,33,1649.38,2933.02,0.00
2024-12-10 17:36:48,53,2884,21,32,1668.33,2933.08,0.00
2024-12-10 17:36:48,53,2885,21,32,1674.98,2934.00,0.00
2024-12-10 17:36:48,54,2885,22,32,1643.96,2934.02,0.00
2024-12-10 17:36:48,54,2886,22,32,1641.80,2935.00,0.00
2024-12-10 17:36:48,55,2886,23,32,1611.95,2935.02,0.00
2024-12-10 17:36:48,54,2886,22,32,1639.09,2935.06,0.00
2024-12-10 17:36:48,53,2886,22,31,1660.05,2935.06,0.00
2024-12-10 17:36:48,53,2887,22,31,1688.31,2936.00,0.00
2024-12-10 17:36:48,54,2887,23,31,1657.05,2936.02,0.00
2024-12-10 17:36:48,53,2887,22,31,1649.14,2936.43,0.00
2024-12-10 17:36:48,53,2888,22,31,1688.33,2937.00,0.00
2024-12-10 17:36:48,54,2888,23,31,1657.07,2937.02,0.00
2024-12-10 17:36:48,53,2888,23,30,1677.81,2937.06,0.00
2024-12-10 17:36:48,52,2888,22,30,1698.26,2937.46,0.00
2024-12-10 17:36:48,52,2889,22,30,1716.73,2938.00,0.00
2024-12-10 17:36:48,53,2889,23,30,1684.34,2938.02,0.00
2024-12-10 17:36:48,52,2889,23,29,1716.17,2938.02,0.00
2024-12-10 17:36:48,52,2890,23,29,1713.76,2939.00,0.00
2024-12-10 17:36:48,53,2890,23,30,1681.42,2939.02,0.00
2024-12-10 17:36:48,52,2890,23,29,1704.15,2939.04,0.00
2024-12-10 17:36:48,52,2891,23,29,1710.38,2940.00,0.00
2024-12-10 17:36:48,53,2891,24,29,1678.11,2940.02,0.00
2024-12-10 17:36:48,53,2892,24,29,1675.58,2941.00,0.00
2024-12-10 17:36:48,54,2892,24,30,1644.55,2941.02,0.00
2024-12-10 17:36:48,53,2892,24,29,1665.04,2941.04,0.00
2024-12-10 17:36:48,53,2893,24,29,1670.52,2942.00,0.00
2024-12-10 17:36:48,54,2893,24,30,1639.59,2942.02,0.00
2024-12-10 17:36:49,54,2894,24,30,1638.09,2943.00,0.00
2024-12-10 17:36:49,55,2894,24,31,1608.30,2943.02,0.00
2024-12-10 17:36:49,54,2894,24,30,1626.64,2943.04,0.00
2024-12-10 17:36:49,53,2894,23,30,1650.55,2943.06,0.00
2024-12-10 17:36:49,53,2895,23,30,1678.88,2944.00,0.00
2024-12-10 17:36:49,54,2895,23,31,1647.79,2944.02,0.00
2024-12-10 17:36:49,53,2895,22,31,1641.97,2944.34,0.00
2024-12-10 17:36:49,53,2896,22,31,1678.44,2945.00,0.00
2024-12-10 17:36:49,54,2896,22,32,1647.36,2945.02,0.00
2024-12-10 17:36:49,53,2896,21,32,1677.89,2945.02,0.00
2024-12-10 17:36:49,52,2896,21,31,1699.39,2945.02,0.00
2024-12-10 17:36:49,52,2897,21,31,1705.07,2946.00,0.00
2024-12-10 17:36:49,53,2897,22,31,1672.90,2946.02,0.00
2024-12-10 17:36:49,53,2898,22,31,1670.21,2947.00,0.00
2024-12-10 17:36:49,54,2898,23,31,1639.28,2947.02,0.00
2024-12-10 17:36:49,53,2898,23,30,1659.64,2947.02,0.00
2024-12-10 17:36:49,53,2899,23,30,1664.66,2948.00,0.00
2024-12-10 17:36:49,54,2899,24,30,1633.83,2948.02,0.00
2024-12-10 17:36:49,54,2900,24,30,1632.02,2949.00,0.00
2024-12-10 17:36:49,55,2900,24,31,1602.35,2949.02,0.00
2024-12-10 17:36:49,54,2900,24,30,1622.19,2949.02,0.00
2024-12-10 17:36:49,53,2900,23,30,1641.79,2949.36,0.00
2024-12-10 17:36:49,53,2901,23,30,1678.95,2950.00,0.00
2024-12-10 17:36:49,54,2901,23,31,1647.85,2950.02,0.00
2024-12-10 17:36:49,53,2901,22,31,1666.71,2950.06,0.00
2024-12-10 17:36:49,52,2901,21,31,1678.32,2950.62,0.00
2024-12-10 17:36:49,52,2902,21,31,1724.00,2951.00,0.00
2024-12-10 17:36:49,53,2902,22,31,1691.47,2951.02,0.00
2024-12-10 17:36:49,52,2902,22,30,1714.35,2951.02,0.00
2024-12-10 17:36:49,53,2901,23,30,1659.05,2951.85,0.00
2024-12-10 17:36:49,53,2902,23,30,1692.60,2952.00,0.00
2024-12-10 17:36:49,54,2902,24,30,1661.26,2952.02,0.00
2024-12-10 17:36:49,53,2902,23,30,1666.79,2952.51,0.00
2024-12-10 17:36:49,53,2903,23,30,1745.69,2953.00,0.00
2024-12-10 17:36:49,54,2903,23,31,1713.36,2953.02,0.00
2024-12-10 17:36:49,53,2903,23,30,1736.78,2953.02,0.00
2024-12-10 17:36:49,52,2903,22,30,1769.62,2953.04,0.00
2024-12-10 17:36:49,52,2904,22,30,1775.89,2954.00,0.00
2024-12-10 17:36:49,53,2904,23,30,1742.38,2954.02,0.00
2024-12-10 17:36:49,53,2905,23,30,1738.32,2955.00,0.00
2024-12-10 17:36:49,54,2905,24,30,1706.13,2955.02,0.00
2024-12-10 17:36:49,53,2905,24,29,1729.40,2955.02,0.00
2024-12-10 17:36:49,53,2906,24,29,1734.44,2956.00,0.00
2024-12-10 17:36:49,54,2906,25,29,1702.32,2956.02,0.00
2024-12-10 17:36:49,54,2907,25,29,1699.32,2957.00,0.00
2024-12-10 17:36:49,55,2907,26,29,1668.42,2957.02,0.00
2024-12-10 17:36:49,54,2907,26,28,1689.46,2957.02,0.00
2024-12-10 17:36:49,54,2908,26,28,1693.87,2958.00,0.00
2024-12-10 17:36:49,55,2908,27,28,1663.07,2958.02,0.00
2024-12-10 17:36:49,55,2909,27,28,1659.84,2959.00,0.00
2024-12-10 17:36:49,56,2909,28,28,1630.20,2959.02,0.00
2024-12-10 17:36:49,55,2909,28,27,1650.69,2959.02,0.00
2024-12-10 17:36:49,55,2910,28,27,1654.48,2960.00,0.00
2024-12-10 17:36:49,56,2910,28,28,1624.94,2960.02,0.00
2024-12-10 17:36:49,56,2911,28,28,1621.62,2961.00,0.00
2024-12-10 17:36:49,57,2911,29,28,1593.17,2961.02,0.00
2024-12-10 17:36:49,56,2911,29,27,1612.63,2961.02,0.00
2024-12-10 17:36:49,55,2911,28,27,1641.42,2961.04,0.00
2024-12-10 17:36:49,54,2911,27,27,1646.33,2961.33,0.00
2024-12-10 17:36:49,53,2911,26,27,1669.74,2961.60,0.00
2024-12-10 17:36:49,53,2912,26,27,1714.16,2962.00,0.00
2024-12-10 17:36:49,54,2912,27,27,1682.42,2962.02,0.00
2024-12-10 17:36:49,53,2912,26,27,1697.28,2962.04,0.00
2024-12-10 17:36:49,53,2913,26,27,1725.24,2963.00,0.00
2024-12-10 17:36:49,54,2913,26,28,1693.29,2963.02,0.00
2024-12-10 17:36:49,53,2913,26,27,1715.74,2963.02,0.00
2024-12-10 17:36:49,52,2913,25,27,1748.73,2963.02,0.00
2024-12-10 17:36:49,52,2914,25,27,1754.45,2964.00,0.00
2024-12-10 17:36:49,53,2914,25,28,1721.35,2964.02,0.00
2024-12-10 17:36:49,53,2915,25,28,1719.32,2965.00,0.00
2024-12-10 17:36:49,54,2915,26,28,1687.48,2965.02,0.00
2024-12-10 17:36:49,53,2915,26,27,1707.57,2965.02,0.00
2024-12-10 17:36:49,52,2915,25,27,1707.59,2965.81,0.00
2024-12-10 17:36:49,52,2916,25,27,1759.06,2966.00,0.00
2024-12-10 17:36:49,53,2916,26,27,1725.87,2966.02,0.00
2024-12-10 17:36:49,53,2917,26,27,1724.47,2967.00,0.00
2024-12-10 17:36:49,54,2917,26,28,1692.53,2967.02,0.00
2024-12-10 17:36:49,54,2918,26,28,1685.96,2968.00,0.00
2024-12-10 17:36:49,55,2918,26,29,1655.30,2968.02,0.00
2024-12-10 17:36:49,54,2918,26,28,1685.41,2968.02,0.00
2024-12-10 17:36:49,54,2919,26,28,1689.82,2969.00,0.00
2024-12-10 17:36:49,55,2919,26,29,1659.10,2969.02,0.00
2024-12-10 17:36:49,55,2920,26,29,1656.46,2970.00,0.00
2024-12-10 17:36:49,56,2920,26,30,1626.88,2970.02,0.00
2024-12-10 17:36:49,55,2920,26,29,1645.78,2970.04,0.00
2024-12-10 17:36:49,54,2920,25,29,1644.71,2970.80,0.00
2024-12-10 17:36:49,54,2921,25,29,1693.83,2971.00,0.00
2024-12-10 17:36:49,55,2921,26,29,1663.04,2971.02,0.00
2024-12-10 17:36:49,54,2921,25,29,1665.69,2971.59,0.00
2024-12-10 17:36:49,54,2922,25,29,1692.40,2972.00,0.00
2024-12-10 17:36:49,55,2922,25,30,1661.63,2972.02,0.00
2024-12-10 17:36:49,54,2922,25,29,1679.76,2972.06,0.00
2024-12-10 17:36:49,54,2923,25,29,1685.26,2973.00,0.00
2024-12-10 17:36:49,55,2923,25,30,1654.62,2973.02,0.00
2024-12-10 17:36:49,55,2924,25,30,1653.55,2974.00,0.00
2024-12-10 17:36:49,56,2924,25,31,1624.02,2974.02,0.00
2024-12-10 17:36:49,55,2924,24,31,1625.14,2974.55,0.00
2024-12-10 17:36:50,55,2925,24,31,1666.01,2975.00,0.00
2024-12-10 17:36:50,56,2925,25,31,1636.26,2975.02,0.00
2024-12-10 17:36:50,55,2925,24,31,1664.94,2975.05,0.00
2024-12-10 17:36:50,54,2925,24,30,1695.22,2975.06,0.00
2024-12-10 17:36:50,54,2926,24,30,1700.74,2976.00,0.00
2024-12-10 17:36:50,55,2926,24,31,1669.82,2976.02,0.00
2024-12-10 17:36:50,54,2926,23,31,1684.16,2976.11,0.00
2024-12-10 17:36:50,54,2927,23,31,1713.37,2977.00,0.00
2024-12-10 17:36:50,55,2927,23,32,1682.22,2977.02,0.00
2024-12-10 17:36:50,54,2927,23,31,1700.70,2977.06,0.00
2024-12-10 17:36:50,54,2928,23,31,1706.17,2978.00,0.00
2024-12-10 17:36:50,55,2928,23,32,1675.15,2978.02,0.00
2024-12-10 17:36:50,55,2929,23,32,1674.22,2979.00,0.00
2024-12-10 17:36:50,56,2929,23,33,1644.32,2979.02,0.00
2024-12-10 17:36:50,55,2929,22,33,1673.14,2979.05,0.00
2024-12-10 17:36:50,54,2929,21,33,1678.19,2979.56,0.00
2024-12-10 17:36:50,53,2929,20,33,1697.42,2979.70,0.00
2024-12-10 17:36:50,53,2930,20,33,1744.89,2980.00,0.00
2024-12-10 17:36:50,54,2930,20,34,1712.58,2980.02,0.00
2024-12-10 17:36:50,53,2930,20,33,1742.01,2980.08,0.00
2024-12-10 17:36:50,53,2931,20,33,1748.76,2981.00,0.00
2024-12-10 17:36:50,54,2931,20,34,1716.38,2981.02,0.00
2024-12-10 17:36:50,53,2931,19,34,1718.14,2981.66,0.00
2024-12-10 17:36:50,53,2932,19,34,1764.54,2982.00,0.00
2024-12-10 17:36:50,54,2932,20,34,1731.87,2982.02,0.00
2024-12-10 17:36:50,53,2932,19,34,1742.57,2982.06,0.00
2024-12-10 17:36:50,52,2932,19,33,1764.03,2982.06,0.00
2024-12-10 17:36:50,52,2933,19,33,1793.87,2983.00,0.00
2024-12-10 17:36:50,53,2933,20,33,1760.02,2983.02,0.00
2024-12-10 17:36:50,53,2934,20,33,1758.35,2984.00,0.00
2024-12-10 17:36:50,54,2934,21,33,1725.79,2984.02,0.00
2024-12-10 17:36:50,53,2934,21,32,1745.41,2984.06,0.00
2024-12-10 17:36:50,53,2935,21,32,1751.62,2985.00,0.00
2024-12-10 17:36:50,54,2935,21,33,1719.18,2985.02,0.00
2024-12-10 17:36:50,54,2936,21,33,1717.42,2986.00,0.00
2024-12-10 17:36:50,55,2936,21,34,1686.20,2986.02,0.00
2024-12-10 17:36:50,54,2936,21,33,1704.71,2986.06,0.00
2024-12-10 17:36:50,53,2936,20,33,1719.13,2986.64,0.00
2024-12-10 17:36:50,53,2937,20,33,1742.52,2987.00,0.00
2024-12-10 17:36:50,54,2937,20,34,1710.25,2987.02,0.00
2024-12-10 17:36:50,54,2938,20,34,1708.19,2988.00,0.00
2024-12-10 17:36:50,55,2938,20,35,1677.13,2988.02,0.00
2024-12-10 17:36:50,54,2938,20,34,1696.02,2988.06,0.00
2024-12-10 17:36:50,53,2938,19,34,1697.78,2988.70,0.00
2024-12-10 17:36:50,53,2939,19,34,1745.39,2989.00,0.00
2024-12-10 17:36:50,54,2939,20,34,1713.07,2989.02,0.00
2024-12-10 17:36:50,54,2940,20,34,1710.80,2990.00,0.00
2024-12-10 17:36:50,55,2940,21,34,1679.70,2990.02,0.00
2024-12-10 17:36:50,54,2940,21,33,1699.18,2990.06,0.00
2024-12-10 17:36:50,53,2940,20,33,1717.89,2990.51,0.00
2024-12-10 17:36:50,53,2941,20,33,1737.11,2991.00,0.00
2024-12-10 17:36:50,54,2941,20,34,1704.94,2991.02,0.00
2024-12-10 17:36:50,53,2941,19,34,1715.71,2991.21,0.00
2024-12-10 17:36:50,53,2942,19,34,1748.13,2992.00,0.00
2024-12-10 17:36:50,54,2942,19,35,1715.75,2992.02,0.00
2024-12-10 17:36:50,53,2942,19,34,1736.28,2992.06,0.00
2024-12-10 17:36:50,52,2942,18,34,1761.82,2992.14,0.00
2024-12-10 17:36:50,52,2943,18,34,1792.57,2993.00,0.00
2024-12-10 17:36:50,53,2943,18,35,1758.74,2993.02,0.00
2024-12-10 17:36:50,53,2944,18,35,1753.88,2994.00,0.00
2024-12-10 17:36:50,54,2944,18,36,1721.41,2994.02,0.00
2024-12-10 17:36:50,53,2944,18,35,1742.59,2994.06,0.00
2024-12-10 17:36:50,52,2944,17,35,1768.09,2994.14,0.00
2024-12-10 17:36:50,52,2945,17,35,1797.62,2995.00,0.00
2024-12-10 17:36:50,53,2945,18,35,1763.70,2995.02,0.00
2024-12-10 17:36:50,53,2946,18,35,1757.88,2996.00,0.00
2024-12-10 17:36:50,54,2946,18,36,1725.33,2996.02,0.00
2024-12-10 17:36:50,53,2946,18,35,1747.14,2996.06,0.00
2024-12-10 17:36:50,53,2947,18,35,1750.62,2997.00,0.00
2024-12-10 17:36:50,54,2947,19,35,1718.20,2997.02,0.00
2024-12-10 17:36:50,53,2947,18,35,1737.06,2997.09,0.00
2024-12-10 17:36:50,53,2948,18,35,1745.30,2998.00,0.00
2024-12-10 17:36:50,54,2948,19,35,1712.98,2998.02,0.00
2024-12-10 17:36:50,53,2948,19,34,1735.12,2998.06,0.00
2024-12-10 17:36:50,52,2948,18,34,1725.43,2998.96,0.00
2024-12-10 17:36:50,52,2949,18,34,1781.97,2999.00,0.00
2024-12-10 17:36:50,53,2949,18,35,1748.34,2999.02,0.00
2024-12-10 17:36:50,52,2949,17,35,1779.97,2999.06,0.00
2024-12-10 17:36:50,52,2950,17,35,1795.93,3000.00,0.00
2024-12-10 17:36:50,53,2950,18,35,1762.04,3000.02,0.00
2024-12-10 17:36:50,52,2950,18,34,1783.24,3000.06,0.00
2024-12-10 17:36:50,52,2951,18,34,1787.70,3001.00,0.00
2024-12-10 17:36:50,53,2951,18,35,1753.97,3001.02,0.00
2024-12-10 17:36:50,53,2952,18,35,1749.70,3002.00,0.00
2024-12-10 17:36:50,54,2952,18,36,1717.30,3002.02,0.00
2024-12-10 17:36:50,53,2952,18,35,1737.24,3002.06,0.00
2024-12-10 17:36:50,53,2953,18,35,1740.61,3003.00,0.00
2024-12-10 17:36:50,54,2953,19,35,1708.38,3003.02,0.00
2024-12-10 17:36:50,53,2953,18,35,1713.79,3003.21,0.00
2024-12-10 17:36:50,52,2953,17,35,1737.73,3003.50,0.00
2024-12-10 17:36:50,52,2954,17,35,1777.67,3004.00,0.00
2024-12-10 17:36:50,53,2954,18,35,1744.13,3004.02,0.00
2024-12-10 17:36:50,53,2955,18,35,1734.51,3005.00,0.00
2024-12-10 17:36:50,54,2955,18,36,1702.39,3005.02,0.00
2024-12-10 17:36:50,53,2955,18,35,1729.41,3005.06,0.00
2024-12-10 17:36:50,53,2956,18,35,1732.26,3006.00,0.00
2024-12-10 17:36:50,54,2956,18,36,1700.18,3006.02,0.00
2024-12-10 17:36:50,54,2957,18,36,1694.27,3007.00,0.00
2024-12-10 17:36:50,55,2957,18,37,1663.47,3007.02,0.00
2024-12-10 17:36:50,54,2957,18,36,1683.69,3007.06,0.00
2024-12-10 17:36:50,53,2957,17,36,1698.74,3007.57,0.00
2024-12-10 17:36:50,52,2957,16,36,1705.67,3007.96,0.00
2024-12-10 17:36:50,52,2958,16,36,1762.38,3008.00,0.00
2024-12-10 17:36:50,53,2958,17,36,1729.13,3008.02,0.00
2024-12-10 17:36:50,52,2958,16,36,1743.89,3008.10,0.00
2024-12-10 17:36:51,52,2959,16,36,1775.13,3009.00,0.00
2024-12-10 17:36:51,53,2959,16,37,1741.63,3009.02,0.00
2024-12-10 17:36:51,52,2959,15,37,1774.55,3009.02,0.00
2024-12-10 17:36:51,51,2959,15,36,1799.31,3009.04,0.00
2024-12-10 17:36:51,51,2960,15,36,1806.40,3010.00,0.00
2024-12-10 17:36:51,52,2960,15,37,1771.67,3010.02,0.00
2024-12-10 17:36:51,52,2961,15,37,1767.82,3011.00,0.00
2024-12-10 17:36:51,53,2961,15,38,1734.46,3011.02,0.00
2024-12-10 17:36:51,52,2961,14,38,1767.24,3011.02,0.00
2024-12-10 17:36:51,51,2961,14,37,1793.04,3011.02,0.00
2024-12-10 17:36:51,50,2961,13,37,1788.32,3011.96,0.00
2024-12-10 17:36:51,50,2962,13,37,1847.37,3012.00,0.00
2024-12-10 17:36:51,51,2962,14,37,1811.15,3012.02,0.00
2024-12-10 17:36:51,51,2963,14,37,1808.06,3013.00,0.00
2024-12-10 17:36:51,52,2963,15,37,1773.29,3013.02,0.00
2024-12-10 17:36:51,51,2963,15,36,1798.02,3013.02,0.00
2024-12-10 17:36:51,50,2963,14,36,1819.21,3013.50,0.00
2024-12-10 17:36:51,50,2964,14,36,1840.69,3014.00,0.00
2024-12-10 17:36:51,51,2964,14,37,1804.60,3014.02,0.00
2024-12-10 17:36:51,51,2965,14,37,1801.12,3015.00,0.00
2024-12-10 17:36:51,52,2965,15,37,1766.49,3015.02,0.00
2024-12-10 17:36:51,51,2965,15,36,1791.67,3015.02,0.00
2024-12-10 17:36:51,51,2966,15,36,1798.17,3016.00,0.00
2024-12-10 17:36:51,52,2966,16,36,1763.59,3016.02,0.00
2024-12-10 17:36:51,51,2966,15,36,1783.99,3016.08,0.00
2024-12-10 17:36:51,51,2967,15,36,1815.93,3017.00,0.00
2024-12-10 17:36:51,52,2967,16,36,1781.00,3017.02,0.00
2024-12-10 17:36:51,51,2967,16,35,1805.28,3017.04,0.00
2024-12-10 17:36:51,51,2968,16,35,1812.39,3018.00,0.00
2024-12-10 17:36:51,52,2968,17,35,1777.53,3018.02,0.00
2024-12-10 17:36:51,52,2969,17,35,1776.40,3019.00,0.00
2024-12-10 17:36:51,53,2969,18,35,1742.88,3019.02,0.00
2024-12-10 17:36:51,52,2969,17,35,1775.38,3019.04,0.00
2024-12-10 17:36:51,52,2970,17,35,1770.16,3020.00,0.00
2024-12-10 17:36:51,53,2970,17,36,1736.76,3020.02,0.00
2024-12-10 17:36:51,52,2970,16,36,1770.14,3020.02,0.00
2024-12-10 17:36:51,51,2970,16,35,1803.66,3020.04,0.00
2024-12-10 17:36:51,51,2971,16,35,1810.78,3021.00,0.00
2024-12-10 17:36:51,52,2971,16,36,1775.95,3021.02,0.00
2024-12-10 17:36:51,51,2971,15,36,1794.20,3021.08,0.00
2024-12-10 17:36:51,51,2972,15,36,1826.19,3022.00,0.00
2024-12-10 17:36:51,52,2972,15,37,1791.07,3022.02,0.00
2024-12-10 17:36:51,52,2973,15,37,1785.27,3023.00,0.00
2024-12-10 17:36:51,53,2973,16,37,1751.58,3023.02,0.00
2024-12-10 17:36:51,52,2973,16,36,1784.11,3023.04,0.00
2024-12-10 17:36:51,52,2974,16,36,1790.51,3024.00,0.00
2024-12-10 17:36:51,53,2974,17,36,1756.73,3024.02,0.00
2024-12-10 17:36:51,52,2974,16,36,1789.96,3024.02,0.00
2024-12-10 17:36:51,52,2975,16,36,1788.05,3025.00,0.00
2024-12-10 17:36:51,53,2975,17,36,1754.31,3025.02,0.00
2024-12-10 17:36:51,52,2975,17,35,1776.41,3025.02,0.00
2024-12-10 17:36:51,51,2975,16,35,1781.95,3025.37,0.00
2024-12-10 17:36:51,50,2975,15,35,1813.52,3025.50,0.00
2024-12-10 17:36:51,50,2976,15,35,1859.24,3026.00,0.00
2024-12-10 17:36:51,51,2976,16,35,1822.79,3026.02,0.00
2024-12-10 17:36:51,51,2977,16,35,1820.47,3027.00,0.00
2024-12-10 17:36:51,52,2977,17,35,1785.46,3027.02,0.00
2024-12-10 17:36:51,51,2977,17,34,1808.01,3027.02,0.00
2024-12-10 17:36:51,51,2978,17,34,1814.54,3028.00,0.00
2024-12-10 17:36:51,52,2978,17,35,1779.64,3028.02,0.00
2024-12-10 17:36:51,52,2979,17,35,1777.38,3029.00,0.00
2024-12-10 17:36:51,53,2979,18,35,1743.84,3029.02,0.00
2024-12-10 17:36:51,52,2979,18,34,1765.73,3029.02,0.00
2024-12-10 17:36:51,51,2979,17,34,1784.55,3029.55,0.00
2024-12-10 17:36:51,51,2980,17,34,1806.84,3030.00,0.00
2024-12-10 17:36:51,52,2980,17,35,1772.09,3030.02,0.00
2024-12-10 17:36:51,51,2980,16,35,1770.91,3030.69,0.00
2024-12-10 17:36:51,51,2981,16,35,1821.04,3031.00,0.00
2024-12-10 17:36:51,52,2981,17,35,1786.02,3031.02,0.00
2024-12-10 17:36:51,51,2981,17,34,1809.74,3031.02,0.00
2024-12-10 17:36:51,51,2982,17,34,1816.29,3032.00,0.00
2024-12-10 17:36:51,52,2982,18,34,1781.36,3032.02,0.00
2024-12-10 17:36:51,52,2983,18,34,1777.79,3033.00,0.00
2024-12-10 17:36:51,53,2983,18,35,1744.24,3033.02,0.00
2024-12-10 17:36:51,52,2983,18,34,1767.29,3033.02,0.00
2024-12-10 17:36:51,52,2984,18,34,1773.12,3034.00,0.00
2024-12-10 17:36:51,53,2984,19,34,1739.67,3034.02,0.00
2024-12-10 17:36:51,53,2985,19,34,1736.04,3035.00,0.00
2024-12-10 17:36:51,54,2985,20,34,1703.89,3035.02,0.00
2024-12-10 17:36:51,53,2985,20,33,1725.73,3035.02,0.00
2024-12-10 17:36:51,52,2985,19,33,1740.00,3035.64,0.00
2024-12-10 17:36:51,52,2986,19,33,1764.17,3036.00,0.00
2024-12-10 17:36:51,53,2986,19,34,1730.89,3036.02,0.00
2024-12-10 17:36:51,54,2985,19,35,1654.72,3036.48,0.00
2024-12-10 17:36:51,54,2986,19,35,1714.12,3037.00,0.00
2024-12-10 17:36:51,55,2986,19,36,1682.96,3037.02,0.00
2024-12-10 17:36:51,54,2986,19,35,1704.56,3037.02,0.00
2024-12-10 17:36:51,53,2986,18,35,1719.52,3037.25,0.00
2024-12-10 17:36:51,53,2987,18,35,1811.70,3038.00,0.00
2024-12-10 17:36:51,54,2987,19,35,1778.15,3038.02,0.00
2024-12-10 17:36:51,53,2987,18,35,1764.40,3038.55,0.00
2024-12-10 17:36:51,53,2988,18,35,1808.28,3039.00,0.00
2024-12-10 17:36:51,54,2988,19,35,1774.80,3039.02,0.00
2024-12-10 17:36:51,53,2988,19,34,1799.11,3039.02,0.00
2024-12-10 17:36:51,53,2989,19,34,1804.29,3040.00,0.00
2024-12-10 17:36:51,54,2989,19,35,1770.88,3040.02,0.00
2024-12-10 17:36:51,54,2990,19,35,1766.24,3041.00,0.00
2024-12-10 17:36:51,55,2990,20,35,1734.12,3041.02,0.00
2024-12-10 17:36:51,54,2990,20,34,1757.23,3041.02,0.00
2024-12-10 17:36:51,53,2990,19,34,1771.90,3041.59,0.00
2024-12-10 17:36:51,53,2991,19,34,1816.96,3042.00,0.00
2024-12-10 17:36:51,54,2991,19,35,1783.31,3042.02,0.00
2024-12-10 17:36:51,53,2991,18,35,1767.87,3042.57,0.00
2024-12-10 17:36:51,53,2992,18,35,1812.39,3043.00,0.00
2024-12-10 17:36:51,54,2992,18,36,1778.82,3043.02,0.00
2024-12-10 17:36:51,53,2992,18,35,1803.78,3043.02,0.00
2024-12-10 17:36:52,53,2993,18,35,1808.96,3044.00,0.00
2024-12-10 17:36:52,54,2993,18,36,1775.46,3044.02,0.00
2024-12-10 17:36:52,53,2993,17,36,1795.20,3044.09,0.00
2024-12-10 17:36:52,53,2994,17,36,1804.19,3045.00,0.00
2024-12-10 17:36:52,54,2994,18,36,1770.78,3045.02,0.00
2024-12-10 17:36:52,53,2994,18,35,1796.14,3045.02,0.00
2024-12-10 17:36:52,52,2994,17,35,1791.62,3045.94,0.00
2024-12-10 17:36:52,52,2995,17,35,1848.48,3046.00,0.00
2024-12-10 17:36:52,53,2995,17,36,1813.60,3046.02,0.00
2024-12-10 17:36:52,53,2996,17,36,1807.78,3047.00,0.00
2024-12-10 17:36:52,54,2996,18,36,1774.30,3047.02,0.00
2024-12-10 17:36:52,53,2996,18,35,1800.30,3047.02,0.00
2024-12-10 17:36:52,53,2997,18,35,1805.50,3048.00,0.00
2024-12-10 17:36:52,54,2997,19,35,1772.06,3048.02,0.00
2024-12-10 17:36:52,54,2998,19,35,1766.13,3049.00,0.00
2024-12-10 17:36:52,55,2998,20,35,1734.02,3049.02,0.00
2024-12-10 17:36:52,54,2998,20,34,1759.35,3049.02,0.00
2024-12-10 17:36:52,53,2998,19,34,1776.32,3049.55,0.00
2024-12-10 17:36:52,53,2999,19,34,1797.36,3050.00,0.00
2024-12-10 17:36:52,54,2999,20,34,1764.07,3050.02,0.00
2024-12-10 17:36:52,53,2999,19,34,1746.42,3050.96,0.00
2024-12-10 17:36:52,53,3000,19,34,1802.86,3051.00,0.00
2024-12-10 17:36:52,54,3000,20,34,1769.47,3051.02,0.00
2024-12-10 17:36:52,53,3000,20,33,1796.52,3051.02,0.00
2024-12-10 17:36:52,53,3001,20,33,1801.72,3052.00,0.00
2024-12-10 17:36:52,54,3001,21,33,1768.35,3052.02,0.00
2024-12-10 17:36:52,53,3001,20,33,1772.56,3052.57,0.00
2024-12-10 17:36:52,53,3002,20,33,1817.23,3053.00,0.00
2024-12-10 17:36:52,54,3002,20,34,1783.58,3053.02,0.00
2024-12-10 17:36:52,53,3002,20,33,1809.74,3053.02,0.00
2024-12-10 17:36:52,53,3003,20,33,1814.94,3054.00,0.00
2024-12-10 17:36:52,54,3003,21,33,1781.33,3054.02,0.00
2024-12-10 17:36:52,54,3004,21,33,1774.58,3055.00,0.00
2024-12-10 17:36:52,55,3004,21,34,1742.32,3055.02,0.00
2024-12-10 17:36:52,54,3004,21,33,1767.79,3055.02,0.00
2024-12-10 17:36:52,53,3004,20,33,1762.49,3055.96,0.00
2024-12-10 17:36:52,53,3005,20,33,1819.02,3056.00,0.00
2024-12-10 17:36:52,54,3005,20,34,1785.33,3056.02,0.00
2024-12-10 17:36:52,54,3006,20,34,1778.55,3057.00,0.00
2024-12-10 17:36:52,55,3006,21,34,1746.22,3057.02,0.00
2024-12-10 17:36:52,54,3006,21,33,1772.33,3057.02,0.00
2024-12-10 17:36:52,54,3007,21,33,1776.87,3058.00,0.00
2024-12-10 17:36:52,55,3007,21,34,1744.56,3058.02,0.00
2024-12-10 17:36:52,55,3008,21,34,1737.94,3059.00,0.00
2024-12-10 17:36:52,56,3008,21,35,1706.91,3059.02,0.00
2024-12-10 17:36:52,55,3008,21,34,1732.38,3059.02,0.00
2024-12-10 17:36:52,54,3008,20,34,1761.66,3059.11,0.00
2024-12-10 17:36:52,53,3008,19,34,1758.18,3059.60,0.00
2024-12-10 17:36:52,52,3008,18,34,1789.10,3059.69,0.00
2024-12-10 17:36:52,52,3009,18,34,1838.77,3060.00,0.00
2024-12-10 17:36:52,53,3009,19,34,1804.08,3060.02,0.00
2024-12-10 17:36:52,53,3010,19,34,1797.92,3061.00,0.00
2024-12-10 17:36:52,54,3010,20,34,1764.63,3061.02,0.00
2024-12-10 17:36:52,53,3010,19,34,1782.75,3061.13,0.00
2024-12-10 17:36:52,53,3011,19,34,1792.00,3062.00,0.00
2024-12-10 17:36:52,54,3011,20,34,1758.82,3062.02,0.00
2024-12-10 17:36:52,53,3011,20,33,1786.23,3062.02,0.00
2024-12-10 17:36:52,54,3010,20,34,1736.40,3062.61,0.00
2024-12-10 17:36:52,54,3011,20,34,1773.00,3063.00,0.00
2024-12-10 17:36:52,55,3011,20,35,1740.77,3063.02,0.00
2024-12-10 17:36:52,54,3011,20,34,1767.33,3063.02,0.00
2024-12-10 17:36:52,53,3011,19,34,1761.90,3063.94,0.00
2024-12-10 17:36:52,53,3012,19,34,1875.81,3064.00,0.00
2024-12-10 17:36:52,54,3012,19,35,1841.07,3064.02,0.00
2024-12-10 17:36:52,54,3013,19,35,1834.29,3065.00,0.00
2024-12-10 17:36:52,55,3013,19,36,1800.94,3065.02,0.00
2024-12-10 17:36:52,54,3013,19,35,1829.18,3065.02,0.00
2024-12-10 17:36:52,54,3014,19,35,1833.76,3066.00,0.00
2024-12-10 17:36:52,55,3014,20,35,1800.41,3066.02,0.00
2024-12-10 17:36:52,54,3014,19,35,1802.38,3066.67,0.00
2024-12-10 17:36:52,54,3015,19,35,1826.49,3067.00,0.00
2024-12-10 17:36:52,55,3015,20,35,1793.28,3067.02,0.00
2024-12-10 17:36:52,54,3015,20,34,1821.95,3067.02,0.00
2024-12-10 17:36:52,54,3016,20,34,1826.52,3068.00,0.00
2024-12-10 17:36:52,55,3016,21,34,1793.31,3068.02,0.00
2024-12-10 17:36:52,54,3016,20,34,1781.56,3068.87,0.00
2024-12-10 17:36:52,54,3017,20,34,1834.50,3069.00,0.00
2024-12-10 17:36:52,55,3017,21,34,1801.15,3069.02,0.00
2024-12-10 17:36:52,54,3017,21,33,1829.96,3069.02,0.00
2024-12-10 17:36:52,54,3018,21,33,1834.53,3070.00,0.00
2024-12-10 17:36:52,55,3018,21,34,1801.18,3070.02,0.00
2024-12-10 17:36:52,55,3019,21,34,1793.95,3071.00,0.00
2024-12-10 17:36:52,56,3019,21,35,1761.91,3071.02,0.00
2024-12-10 17:36:52,55,3019,21,34,1788.92,3071.02,0.00
2024-12-10 17:36:52,55,3020,21,34,1792.86,3072.00,0.00
2024-12-10 17:36:52,56,3020,21,35,1760.84,3072.02,0.00
2024-12-10 17:36:52,55,3020,20,35,1743.14,3072.96,0.00
2024-12-10 17:36:52,55,3021,20,35,1797.91,3073.00,0.00
2024-12-10 17:36:52,56,3021,21,35,1765.80,3073.02,0.00
2024-12-10 17:36:52,55,3021,21,34,1792.88,3073.02,0.00
2024-12-10 17:36:52,55,3022,21,34,1796.82,3074.00,0.00
2024-12-10 17:36:52,56,3022,22,34,1764.73,3074.02,0.00
2024-12-10 17:36:52,56,3023,22,34,1757.86,3075.00,0.00
2024-12-10 17:36:52,57,3023,22,35,1727.02,3075.02,0.00
2024-12-10 17:36:52,56,3023,22,34,1751.28,3075.04,0.00
2024-12-10 17:36:52,56,3024,22,34,1755.13,3076.00,0.00
2024-12-10 17:36:52,57,3024,22,35,1724.34,3076.02,0.00
2024-12-10 17:36:53,57,3025,22,35,1717.35,3077.00,0.00
2024-12-10 17:36:53,58,3025,23,35,1687.74,3077.02,0.00
2024-12-10 17:36:53,57,3025,23,34,1711.43,3077.04,0.00
2024-12-10 17:36:53,56,3025,22,34,1739.27,3077.13,0.00
2024-12-10 17:36:53,55,3025,21,34,1734.46,3077.96,0.00
2024-12-10 17:36:53,55,3026,21,34,1789.33,3078.00,0.00
2024-12-10 17:36:53,56,3026,22,34,1757.37,3078.02,0.00
2024-12-10 17:36:53,57,3025,22,35,1689.75,3078.91,0.00
2024-12-10 17:36:53,57,3026,22,35,1723.09,3079.00,0.00
2024-12-10 17:36:53,58,3026,23,35,1693.39,3079.02,0.00
2024-12-10 17:36:53,58,3027,23,35,1749.63,3080.00,0.00
2024-12-10 17:36:53,59,3027,23,36,1719.98,3080.02,0.00
2024-12-10 17:36:53,59,3028,23,36,1714.68,3081.00,0.00
2024-12-10 17:36:53,60,3028,23,37,1686.11,3081.02,0.00
2024-12-10 17:36:53,59,3028,23,36,1706.33,3081.02,0.00
2024-12-10 17:36:53,59,3029,23,36,1707.93,3082.00,0.00
2024-12-10 17:36:53,60,3029,24,36,1679.46,3082.02,0.00
2024-12-10 17:36:53,59,3029,24,35,1704.79,3082.02,0.00
2024-12-10 17:36:53,59,3030,24,35,1706.39,3083.00,0.00
2024-12-10 17:36:53,60,3030,25,35,1677.95,3083.02,0.00
2024-12-10 17:36:53,59,3030,24,35,1669.67,3083.78,0.00
2024-12-10 17:36:53,59,3031,24,35,1715.31,3084.00,0.00
2024-12-10 17:36:53,60,3031,25,35,1686.72,3084.02,0.00
2024-12-10 17:36:53,59,3031,25,34,1712.17,3084.02,0.00
2024-12-10 17:36:53,58,3031,24,34,1738.01,3084.14,0.00
2024-12-10 17:36:53,58,3032,24,34,1743.85,3085.00,0.00
2024-12-10 17:36:53,59,3032,25,34,1714.30,3085.02,0.00
2024-12-10 17:36:53,60,3031,25,35,1650.68,3085.87,0.00
2024-12-10 17:36:53,60,3032,25,35,1701.41,3086.00,0.00
2024-12-10 17:36:53,61,3032,25,36,1673.51,3086.02,0.00
2024-12-10 17:36:53,60,3032,25,35,1698.83,3086.02,0.00
2024-12-10 17:36:53,60,3033,25,35,1751.35,3087.00,0.00
2024-12-10 17:36:53,61,3033,25,36,1722.64,3087.02,0.00
2024-12-10 17:36:53,60,3033,24,36,1737.49,3087.13,0.00
2024-12-10 17:36:53,59,3033,23,36,1745.54,3087.83,0.00
2024-12-10 17:36:53,59,3034,23,36,1771.83,3088.00,0.00
2024-12-10 17:36:53,60,3034,23,37,1742.30,3088.02,0.00
2024-12-10 17:36:53,59,3034,23,36,1769.74,3088.02,0.00
2024-12-10 17:36:53,59,3035,23,36,1771.36,3089.00,0.00
2024-12-10 17:36:53,60,3035,24,36,1741.84,3089.02,0.00
2024-12-10 17:36:53,59,3035,23,36,1738.92,3089.10,0.00
2024-12-10 17:36:53,59,3036,23,36,1764.08,3090.00,0.00
2024-12-10 17:36:53,60,3036,24,36,1734.68,3090.02,0.00
2024-12-10 17:36:53,59,3036,24,35,1761.46,3090.02,0.00
2024-12-10 17:36:53,59,3037,24,35,1763.08,3091.00,0.00
2024-12-10 17:36:53,60,3037,25,35,1733.69,3091.02,0.00
2024-12-10 17:36:53,59,3037,24,35,1749.77,3091.10,0.00
2024-12-10 17:36:53,58,3037,23,35,1760.87,3091.38,0.00
2024-12-10 17:36:53,58,3038,23,35,1795.42,3092.00,0.00
2024-12-10 17:36:53,59,3038,24,35,1764.99,3092.02,0.00
2024-12-10 17:36:53,58,3038,24,34,1790.09,3092.03,0.00
2024-12-10 17:36:53,58,3039,24,34,1792.80,3093.00,0.00
2024-12-10 17:36:53,59,3039,25,34,1762.42,3093.02,0.00
2024-12-10 17:36:53,58,3039,24,34,1778.96,3093.12,0.00
2024-12-10 17:36:53,57,3039,23,34,1804.24,3093.21,0.00
2024-12-10 17:36:53,57,3040,23,34,1834.62,3094.00,0.00
2024-12-10 17:36:53,58,3040,24,34,1802.98,3094.02,0.00
2024-12-10 17:36:53,57,3040,24,33,1829.73,3094.04,0.00
2024-12-10 17:36:53,57,3041,24,33,1833.04,3095.00,0.00
2024-12-10 17:36:53,58,3041,24,34,1801.43,3095.02,0.00
2024-12-10 17:36:53,57,3041,23,34,1819.55,3095.09,0.00
2024-12-10 17:36:53,57,3042,23,34,1824.47,3096.00,0.00
2024-12-10 17:36:53,58,3042,24,34,1793.01,3096.02,0.00
2024-12-10 17:36:53,57,3042,24,33,1820.13,3096.04,0.00
2024-12-10 17:36:53,57,3043,24,33,1823.43,3097.00,0.00
2024-12-10 17:36:53,58,3043,25,33,1791.99,3097.02,0.00
2024-12-10 17:36:53,58,3044,25,33,1783.49,3098.00,0.00
2024-12-10 17:36:53,59,3044,26,33,1753.26,3098.02,0.00
2024-12-10 17:36:53,58,3044,26,32,1777.08,3098.03,0.00
2024-12-10 17:36:53,58,3045,26,32,1779.79,3099.00,0.00
2024-12-10 17:36:53,59,3045,27,32,1749.62,3099.02,0.00
2024-12-10 17:36:53,59,3046,27,32,1740.73,3100.00,0.00
2024-12-10 17:36:53,60,3046,28,32,1711.72,3100.02,0.00
2024-12-10 17:36:53,59,3046,28,31,1734.43,3100.03,0.00
2024-12-10 17:36:53,59,3047,28,31,1736.56,3101.00,0.00
2024-12-10 17:36:53,60,3047,28,32,1707.62,3101.02,0.00
2024-12-10 17:36:53,59,3047,27,32,1707.78,3101.32,0.00
2024-12-10 17:36:53,59,3048,27,32,1739.75,3102.00,0.00
2024-12-10 17:36:53,60,3048,28,32,1710.75,3102.02,0.00
2024-12-10 17:36:53,59,3048,28,31,1732.92,3102.03,0.00
2024-12-10 17:36:53,59,3049,28,31,1735.05,3103.00,0.00
2024-12-10 17:36:53,60,3049,29,31,1706.13,3103.02,0.00
2024-12-10 17:36:53,60,3050,29,31,1698.61,3104.00,0.00
2024-12-10 17:36:53,61,3050,30,31,1670.76,3104.02,0.00
2024-12-10 17:36:53,60,3050,30,30,1690.86,3104.05,0.00
2024-12-10 17:36:53,59,3050,29,30,1700.37,3104.66,0.00
2024-12-10 17:36:53,59,3051,29,30,1721.64,3105.00,0.00
2024-12-10 17:36:53,60,3051,29,31,1692.95,3105.02,0.00
2024-12-10 17:36:53,60,3052,29,31,1695.26,3106.00,0.00
2024-12-10 17:36:53,61,3052,29,32,1667.47,3106.02,0.00
2024-12-10 17:36:53,60,3052,28,32,1659.58,3106.57,0.00
2024-12-10 17:36:53,60,3053,28,32,1698.18,3107.00,0.00
2024-12-10 17:36:53,61,3053,29,32,1670.34,3107.02,0.00
2024-12-10 17:36:53,60,3053,29,31,1688.86,3107.05,0.00
2024-12-10 17:36:53,59,3053,28,31,1690.30,3107.48,0.00
2024-12-10 17:36:53,59,3054,28,31,1726.99,3108.00,0.00
2024-12-10 17:36:53,60,3054,28,32,1698.21,3108.02,0.00
2024-12-10 17:36:53,61,3053,28,33,1646.11,3108.51,0.00
2024-12-10 17:36:53,60,3053,27,33,1677.14,3108.77,0.00
2024-12-10 17:36:53,60,3054,27,33,1721.87,3109.00,0.00
2024-12-10 17:36:53,61,3054,28,33,1693.64,3109.02,0.00
2024-12-10 17:36:53,60,3054,28,32,1716.17,3109.05,0.00
2024-12-10 17:36:53,60,3055,28,32,1770.11,3110.00,0.00
2024-12-10 17:36:53,61,3055,28,33,1741.09,3110.02,0.00
2024-12-10 17:36:54,61,3056,28,33,1732.28,3111.00,0.00
2024-12-10 17:36:54,62,3056,28,34,1704.34,3111.02,0.00
2024-12-10 17:36:54,61,3056,28,33,1726.17,3111.05,0.00
2024-12-10 17:36:54,60,3056,27,33,1752.04,3111.13,0.00
2024-12-10 17:36:54,60,3057,27,33,1777.47,3112.00,0.00
2024-12-10 17:36:54,61,3057,27,34,1748.33,3112.02,0.00
2024-12-10 17:36:54,62,3056,28,34,1697.71,3112.45,0.00
2024-12-10 17:36:54,62,3057,28,34,1713.63,3113.00,0.00
2024-12-10 17:36:54,63,3057,29,34,1686.43,3113.02,0.00
2024-12-10 17:36:54,62,3057,29,33,1707.61,3113.05,0.00
2024-12-10 17:36:54,61,3057,28,33,1717.04,3113.64,0.00
2024-12-10 17:36:54,61,3058,28,33,1808.16,3114.00,0.00
2024-12-10 17:36:54,62,3058,29,33,1779.00,3114.02,0.00
2024-12-10 17:36:54,61,3058,28,33,1777.84,3114.66,0.00
2024-12-10 17:36:54,61,3059,28,33,1798.66,3115.00,0.00
2024-12-10 17:36:54,62,3059,28,34,1769.65,3115.02,0.00
2024-12-10 17:36:54,61,3059,28,33,1793.04,3115.05,0.00
2024-12-10 17:36:54,61,3060,28,33,1794.64,3116.00,0.00
2024-12-10 17:36:54,62,3060,29,33,1765.69,3116.02,0.00
2024-12-10 17:36:54,62,3061,29,33,1755.70,3117.00,0.00
2024-12-10 17:36:54,63,3061,29,34,1727.83,3117.02,0.00
2024-12-10 17:36:54,62,3061,28,34,1755.20,3117.02,0.00
2024-12-10 17:36:54,61,3061,28,33,1779.38,3117.03,0.00
2024-12-10 17:36:54,61,3062,28,33,1780.46,3118.00,0.00
2024-12-10 17:36:54,62,3062,29,33,1751.74,3118.02,0.00
2024-12-10 17:36:54,61,3062,28,33,1753.37,3118.05,0.00
2024-12-10 17:36:54,61,3063,28,33,1775.40,3119.00,0.00
2024-12-10 17:36:54,62,3063,29,33,1746.77,3119.02,0.00
2024-12-10 17:36:54,61,3063,29,32,1770.80,3119.03,0.00
2024-12-10 17:36:54,60,3063,28,32,1780.86,3119.65,0.00
2024-12-10 17:36:54,60,3064,28,32,1801.41,3120.00,0.00
2024-12-10 17:36:54,61,3064,28,33,1771.88,3120.02,0.00
2024-12-10 17:36:54,60,3064,27,33,1793.61,3120.02,0.00
2024-12-10 17:36:54,60,3065,27,33,1805.11,3121.00,0.00
2024-12-10 17:36:54,61,3065,28,33,1775.52,3121.02,0.00
2024-12-10 17:36:54,60,3065,28,32,1797.83,3121.03,0.00
2024-12-10 17:36:54,60,3066,28,32,1799.44,3122.00,0.00
2024-12-10 17:36:54,61,3066,29,32,1769.94,3122.02,0.00
2024-12-10 17:36:54,61,3067,29,32,1761.59,3123.00,0.00
2024-12-10 17:36:54,62,3067,30,32,1733.18,3123.02,0.00
2024-12-10 17:36:54,61,3067,30,31,1753.92,3123.05,0.00
2024-12-10 17:36:54,60,3067,29,31,1781.61,3123.10,0.00
2024-12-10 17:36:54,59,3067,28,31,1782.81,3123.83,0.00
2024-12-10 17:36:54,59,3068,28,31,1830.59,3124.00,0.00
2024-12-10 17:36:54,60,3068,29,31,1800.08,3124.02,0.00
2024-12-10 17:36:54,60,3069,29,31,1791.31,3125.00,0.00
2024-12-10 17:36:54,61,3069,29,32,1761.95,3125.02,0.00
2024-12-10 17:36:54,60,3069,29,31,1784.03,3125.05,0.00
2024-12-10 17:36:54,60,3070,29,31,1786.15,3126.00,0.00
2024-12-10 17:36:54,61,3070,29,32,1756.87,3126.02,0.00
2024-12-10 17:36:54,62,3069,30,32,1710.98,3126.29,0.00
2024-12-10 17:36:54,62,3070,30,32,1760.93,3127.00,0.00
2024-12-10 17:36:54,63,3070,31,32,1732.98,3127.02,0.00
2024-12-10 17:36:54,62,3070,31,31,1753.88,3127.05,0.00
2024-12-10 17:36:54,61,3070,30,31,1780.10,3127.13,0.00
2024-12-10 17:36:54,60,3070,29,31,1774.25,3127.95,0.00
2024-12-10 17:36:54,60,3071,29,31,1876.97,3128.00,0.00
2024-12-10 17:36:54,61,3071,30,31,1846.20,3128.02,0.00
2024-12-10 17:36:54,61,3072,30,31,1836.53,3129.00,0.00
2024-12-10 17:36:54,62,3072,30,32,1806.91,3129.02,0.00
2024-12-10 17:36:54,61,3072,30,31,1829.87,3129.05,0.00
2024-12-10 17:36:54,61,3073,30,31,1831.47,3130.00,0.00
2024-12-10 17:36:54,62,3073,30,32,1801.93,3130.02,0.00
2024-12-10 17:36:54,62,3074,30,32,1792.37,3131.00,0.00
2024-12-10 17:36:54,63,3074,30,33,1763.92,3131.02,0.00
2024-12-10 17:36:54,62,3074,30,32,1785.30,3131.05,0.00
2024-12-10 17:36:54,61,3074,29,32,1777.92,3131.61,0.00
2024-12-10 17:36:54,61,3075,29,32,1817.24,3132.00,0.00
2024-12-10 17:36:54,62,3075,29,33,1787.93,3132.02,0.00
2024-12-10 17:36:54,61,3075,28,33,1785.94,3132.10,0.00
2024-12-10 17:36:54,61,3076,28,33,1809.60,3133.00,0.00
2024-12-10 17:36:54,62,3076,28,34,1780.41,3133.02,0.00
2024-12-10 17:36:54,61,3076,28,33,1802.93,3133.05,0.00
2024-12-10 17:36:54,61,3077,28,33,1804.53,3134.00,0.00
2024-12-10 17:36:54,62,3077,28,34,1775.42,3134.02,0.00
2024-12-10 17:36:54,61,3077,27,34,1782.01,3134.25,0.00
2024-12-10 17:36:54,61,3078,27,34,1810.24,3135.00,0.00
2024-12-10 17:36:54,62,3078,27,35,1781.04,3135.02,0.00
2024-12-10 17:36:54,61,3078,27,34,1804.08,3135.05,0.00
2024-12-10 17:36:54,60,3078,26,34,1822.74,3135.23,0.00
2024-12-10 17:36:54,60,3079,26,34,1851.45,3136.00,0.00
2024-12-10 17:36:54,61,3079,27,34,1821.10,3136.02,0.00
2024-12-10 17:36:54,60,3079,26,34,1812.44,3136.47,0.00
2024-12-10 17:36:54,60,3080,26,34,1848.38,3137.00,0.00
2024-12-10 17:36:54,61,3080,27,34,1818.08,3137.02,0.00
2024-12-10 17:36:54,60,3080,27,33,1842.64,3137.05,0.00
2024-12-10 17:36:54,60,3081,27,33,1844.79,3138.00,0.00
2024-12-10 17:36:54,61,3081,28,33,1814.55,3138.02,0.00
2024-12-10 17:36:54,61,3082,28,33,1805.68,3139.00,0.00
2024-12-10 17:36:54,62,3082,28,34,1776.55,3139.02,0.00
2024-12-10 17:36:54,61,3082,28,33,1798.48,3139.05,0.00
2024-12-10 17:36:54,61,3083,28,33,1800.07,3140.00,0.00
2024-12-10 17:36:54,62,3083,28,34,1771.04,3140.02,0.00
2024-12-10 17:36:54,62,3084,28,34,1764.67,3141.00,0.00
2024-12-10 17:36:54,63,3084,29,34,1736.66,3141.02,0.00
2024-12-10 17:36:54,62,3084,29,33,1754.54,3141.05,0.00
2024-12-10 17:36:54,61,3084,28,33,1744.01,3141.93,0.00
2024-12-10 17:36:54,61,3085,28,33,1793.49,3142.00,0.00
2024-12-10 17:36:54,62,3085,29,33,1764.57,3142.02,0.00
2024-12-10 17:36:54,62,3086,29,33,1755.61,3143.00,0.00
2024-12-10 17:36:54,63,3086,29,34,1727.74,3143.02,0.00
2024-12-10 17:36:54,62,3086,29,33,1749.53,3143.05,0.00
2024-12-10 17:36:54,61,3086,28,33,1775.16,3143.15,0.00
2024-12-10 17:36:54,61,3087,28,33,1779.80,3144.00,0.00
2024-12-10 17:36:54,62,3087,29,33,1751.09,3144.02,0.00
2024-12-10 17:36:55,62,3088,29,33,1742.37,3145.00,0.00
2024-12-10 17:36:55,63,3088,30,33,1714.71,3145.02,0.00
2024-12-10 17:36:55,62,3088,30,32,1735.78,3145.05,0.00
2024-12-10 17:36:55,62,3089,30,32,1736.84,3146.00,0.00
2024-12-10 17:36:55,63,3089,31,32,1709.27,3146.02,0.00
2024-12-10 17:36:55,63,3090,31,32,1711.92,3147.00,0.00
2024-12-10 17:36:55,64,3090,32,32,1685.17,3147.02,0.00
2024-12-10 17:36:55,64,3091,32,32,1681.60,3148.00,0.00
2024-12-10 17:36:55,65,3091,33,32,1655.73,3148.02,0.00
2024-12-10 17:36:55,65,3092,33,32,1644.86,3149.00,0.00
2024-12-10 17:36:55,66,3092,34,32,1619.93,3149.02,0.00
2024-12-10 17:36:55,65,3092,34,31,1641.95,3149.05,0.00
2024-12-10 17:36:55,65,3093,34,31,1641.50,3150.00,0.00
2024-12-10 17:36:55,66,3093,35,31,1616.63,3150.02,0.00
2024-12-10 17:36:55,65,3093,34,31,1627.01,3150.17,0.00
2024-12-10 17:36:55,64,3093,33,31,1636.46,3150.66,0.00
2024-12-10 17:36:55,64,3094,33,31,1675.10,3151.00,0.00
2024-12-10 17:36:55,65,3094,34,31,1649.33,3151.02,0.00
2024-12-10 17:36:55,64,3094,33,31,1674.61,3151.02,0.00
2024-12-10 17:36:55,63,3094,33,30,1696.20,3151.05,0.00
2024-12-10 17:36:55,63,3095,33,30,1696.73,3152.00,0.00
2024-12-10 17:36:55,64,3095,33,31,1670.22,3152.02,0.00
2024-12-10 17:36:55,64,3096,33,31,1660.26,3153.00,0.00
2024-12-10 17:36:55,65,3096,33,32,1634.72,3153.02,0.00
2024-12-10 17:36:55,64,3096,33,31,1655.34,3153.05,0.00
2024-12-10 17:36:55,63,3096,32,31,1678.65,3153.14,0.00
2024-12-10 17:36:55,62,3096,31,31,1676.27,3153.87,0.00
2024-12-10 17:36:55,62,3097,31,31,1723.15,3154.00,0.00
2024-12-10 17:36:55,63,3097,31,32,1695.80,3154.02,0.00
2024-12-10 17:36:55,62,3097,30,32,1722.64,3154.02,0.00
2024-12-10 17:36:55,62,3098,30,32,1712.80,3155.00,0.00
2024-12-10 17:36:55,63,3098,31,32,1685.61,3155.02,0.00
2024-12-10 17:36:55,62,3098,31,31,1708.74,3155.03,0.00
2024-12-10 17:36:55,62,3099,31,31,1709.27,3156.00,0.00
2024-12-10 17:36:55,63,3099,31,32,1682.14,3156.02,0.00
2024-12-10 17:36:55,63,3100,31,32,1672.96,3157.00,0.00
2024-12-10 17:36:55,64,3100,31,33,1646.82,3157.02,0.00
2024-12-10 17:36:55,63,3100,31,32,1667.96,3157.03,0.00
2024-12-10 17:36:55,62,3100,30,32,1688.98,3157.15,0.00
2024-12-10 17:36:55,62,3101,30,32,1713.41,3158.00,0.00
2024-12-10 17:36:55,63,3101,31,32,1686.21,3158.02,0.00
2024-12-10 17:36:55,62,3101,30,32,1699.70,3158.13,0.00
2024-12-10 17:36:55,62,3102,30,32,1704.47,3159.00,0.00
2024-12-10 17:36:55,63,3102,31,32,1677.42,3159.02,0.00
2024-12-10 17:36:55,62,3102,31,31,1699.90,3159.03,0.00
2024-12-10 17:36:55,61,3102,30,31,1707.54,3159.67,0.00
2024-12-10 17:36:55,61,3103,30,31,1728.49,3160.00,0.00
2024-12-10 17:36:55,62,3103,31,31,1700.61,3160.02,0.00
2024-12-10 17:36:55,62,3104,31,31,1690.87,3161.00,0.00
2024-12-10 17:36:55,63,3104,31,32,1664.03,3161.02,0.00
2024-12-10 17:36:55,62,3104,31,31,1686.80,3161.03,0.00
2024-12-10 17:36:55,61,3104,30,31,1674.92,3161.66,0.00
2024-12-10 17:36:55,61,3105,30,31,1716.11,3162.00,0.00
2024-12-10 17:36:55,62,3105,31,31,1688.43,3162.02,0.00
2024-12-10 17:36:55,61,3105,30,31,1689.68,3162.05,0.00
2024-12-10 17:36:55,61,3106,30,31,1711.98,3163.00,0.00
2024-12-10 17:36:55,62,3106,30,32,1684.37,3163.02,0.00
2024-12-10 17:36:55,61,3106,30,31,1708.36,3163.03,0.00
2024-12-10 17:36:55,60,3106,29,31,1716.58,3163.68,0.00
2024-12-10 17:36:55,59,3106,28,31,1731.65,3163.88,0.00
2024-12-10 17:36:55,59,3107,28,31,1781.63,3164.00,0.00
2024-12-10 17:36:55,60,3107,28,32,1751.93,3164.02,0.00
2024-12-10 17:36:55,59,3107,27,32,1768.21,3164.10,0.00
2024-12-10 17:36:55,59,3108,27,32,1774.08,3165.00,0.00
2024-12-10 17:36:55,60,3108,28,32,1744.52,3165.02,0.00
2024-12-10 17:36:55,59,3108,28,31,1767.66,3165.03,0.00
2024-12-10 17:36:55,58,3108,27,31,1780.67,3165.03,0.00
2024-12-10 17:36:55,57,3108,26,31,1810.81,3165.07,0.00
2024-12-10 17:36:55,57,3109,26,31,1837.47,3166.00,0.00
2024-12-10 17:36:55,58,3109,26,32,1805.79,3166.02,0.00
2024-12-10 17:36:55,57,3109,25,32,1817.48,3166.04,0.00
2024-12-10 17:36:55,57,3110,25,32,1831.94,3167.00,0.00
2024-12-10 17:36:55,58,3110,26,32,1800.35,3167.02,0.00
2024-12-10 17:36:55,57,3110,26,31,1823.06,3167.04,0.00
2024-12-10 17:36:55,56,3110,25,31,1832.01,3167.41,0.00
2024-12-10 17:36:55,56,3111,25,31,1870.33,3168.00,0.00
2024-12-10 17:36:55,57,3111,26,31,1837.52,3168.02,0.00
2024-12-10 17:36:55,57,3112,26,31,1832.47,3169.00,0.00
2024-12-10 17:36:55,58,3112,26,32,1800.88,3169.02,0.00
2024-12-10 17:36:55,57,3112,26,31,1821.37,3169.05,0.00
2024-12-10 17:36:55,57,3113,26,31,1825.27,3170.00,0.00
2024-12-10 17:36:55,58,3113,26,32,1793.80,3170.02,0.00
2024-12-10 17:36:55,58,3114,26,32,1788.78,3171.00,0.00
2024-12-10 17:36:55,59,3114,27,32,1758.46,3171.02,0.00
2024-12-10 17:36:55,58,3114,27,31,1777.86,3171.05,0.00
2024-12-10 17:36:55,57,3114,26,31,1794.20,3171.25,0.00
2024-12-10 17:36:55,57,3115,26,31,1826.42,3172.00,0.00
2024-12-10 17:36:55,58,3115,26,32,1794.93,3172.02,0.00
2024-12-10 17:36:55,58,3116,26,32,1789.35,3173.00,0.00
2024-12-10 17:36:55,59,3116,26,33,1759.03,3173.02,0.00
2024-12-10 17:36:55,58,3116,26,32,1779.52,3173.05,0.00
2024-12-10 17:36:55,57,3116,25,32,1795.34,3173.26,0.00
2024-12-10 17:36:55,57,3117,25,32,1828.13,3174.00,0.00
2024-12-10 17:36:55,58,3117,25,33,1796.61,3174.02,0.00
2024-12-10 17:36:55,57,3117,24,33,1812.99,3174.12,0.00
2024-12-10 17:36:55,58,3116,25,33,1774.69,3174.38,0.00
2024-12-10 17:36:55,58,3117,25,33,1833.17,3175.00,0.00
2024-12-10 17:36:55,59,3117,25,34,1802.09,3175.02,0.00
2024-12-10 17:36:55,58,3117,25,33,1822.78,3175.07,0.00
2024-12-10 17:36:55,57,3117,24,33,1853.66,3175.11,0.00
2024-12-10 17:36:55,56,3117,23,33,1885.07,3175.13,0.00
2024-12-10 17:36:55,56,3118,23,33,1971.26,3176.00,0.00
2024-12-10 17:36:55,57,3118,23,34,1936.68,3176.02,0.00
2024-12-10 17:36:55,57,3119,23,34,1929.30,3177.00,0.00
2024-12-10 17:36:55,58,3119,23,35,1896.04,3177.02,0.00
2024-12-10 17:36:55,57,3119,23,34,1919.29,3177.07,0.00
2024-12-10 17:36:55,57,3120,23,34,1923.78,3178.00,0.00
2024-12-10 17:36:55,58,3120,23,35,1890.61,3178.02,0.00
2024-12-10 17:36:55,57,3120,22,35,1883.66,3178.77,0.00
2024-12-10 17:36:56,57,3121,22,35,1932.37,3179.00,0.00
2024-12-10 17:36:56,58,3121,22,36,1899.05,3179.02,0.00
2024-12-10 17:36:56,57,3121,22,35,1922.91,3179.07,0.00
2024-12-10 17:36:56,56,3121,21,35,1956.12,3179.11,0.00
2024-12-10 17:36:56,56,3122,21,35,1962.39,3180.00,0.00
2024-12-10 17:36:56,57,3122,21,36,1927.96,3180.02,0.00
2024-12-10 17:36:56,57,3123,21,36,1920.50,3181.00,0.00
2024-12-10 17:36:56,58,3123,21,37,1887.39,3181.02,0.00
2024-12-10 17:36:56,57,3123,21,36,1910.47,3181.07,0.00
2024-12-10 17:36:56,56,3123,20,36,1914.03,3181.82,0.00
2024-12-10 17:36:56,56,3124,20,36,1965.32,3182.00,0.00
2024-12-10 17:36:56,57,3124,20,37,1930.84,3182.02,0.00
2024-12-10 17:36:56,56,3124,19,37,1948.29,3182.05,0.00
2024-12-10 17:36:56,56,3125,19,37,1964.24,3183.00,0.00
2024-12-10 17:36:56,57,3125,20,37,1929.78,3183.02,0.00
2024-12-10 17:36:56,56,3125,20,36,1954.59,3183.05,0.00
2024-12-10 17:36:56,55,3125,19,36,1968.86,3183.33,0.00
2024-12-10 17:36:56,55,3126,19,36,2005.81,3184.00,0.00
2024-12-10 17:36:56,56,3126,19,37,1969.99,3184.02,0.00
2024-12-10 17:36:56,55,3126,18,37,1961.58,3184.36,0.00
2024-12-10 17:36:56,55,3127,18,37,1999.69,3185.00,0.00
2024-12-10 17:36:56,56,3127,18,38,1963.99,3185.02,0.00
2024-12-10 17:36:56,55,3127,18,37,1989.28,3185.05,0.00
2024-12-10 17:36:56,54,3127,17,37,2010.66,3185.07,0.00
2024-12-10 17:36:56,54,3128,17,37,2040.78,3186.00,0.00
2024-12-10 17:36:56,55,3128,17,38,2003.67,3186.02,0.00
2024-12-10 17:36:56,54,3128,16,38,2024.29,3186.11,0.00
2024-12-10 17:36:56,54,3129,16,38,2055.58,3187.00,0.00
2024-12-10 17:36:56,55,3129,16,39,2018.21,3187.02,0.00
2024-12-10 17:36:56,54,3129,16,38,2042.61,3187.07,0.00
2024-12-10 17:36:56,54,3130,16,38,2049.14,3188.00,0.00
2024-12-10 17:36:56,55,3130,17,38,2011.89,3188.02,0.00
2024-12-10 17:36:56,55,3131,17,38,2005.50,3189.00,0.00
2024-12-10 17:36:56,56,3131,17,39,1969.68,3189.02,0.00
2024-12-10 17:36:56,55,3131,17,38,1993.33,3189.07,0.00
2024-12-10 17:36:56,54,3131,16,38,1994.52,3189.54,0.00
2024-12-10 17:36:56,54,3132,16,38,2039.20,3190.00,0.00
2024-12-10 17:36:56,55,3132,17,38,2002.13,3190.02,0.00
2024-12-10 17:36:56,55,3133,17,38,1996.49,3191.00,0.00
2024-12-10 17:36:56,56,3133,17,39,1960.84,3191.02,0.00
2024-12-10 17:36:56,55,3133,17,38,1983.74,3191.07,0.00
2024-12-10 17:36:56,56,3132,18,38,1935.97,3191.50,0.00
2024-12-10 17:36:56,56,3133,18,38,1971.72,3192.00,0.00
2024-12-10 17:36:56,57,3133,18,39,1937.12,3192.02,0.00
2024-12-10 17:36:56,57,3134,18,39,1987.31,3193.00,0.00
2024-12-10 17:36:56,58,3134,18,40,1953.04,3193.02,0.00
2024-12-10 17:36:56,57,3134,18,39,1975.56,3193.07,0.00
2024-12-10 17:36:56,56,3134,17,39,1981.63,3193.43,0.00
2024-12-10 17:36:56,56,3135,17,39,2020.86,3194.00,0.00
2024-12-10 17:36:56,57,3135,17,40,1985.41,3194.02,0.00
2024-12-10 17:36:56,57,3136,17,40,1990.96,3195.00,0.00
2024-12-10 17:36:56,58,3136,18,40,1956.63,3195.02,0.00
2024-12-10 17:36:56,58,3137,18,40,1956.49,3196.00,0.00
2024-12-10 17:36:56,59,3137,18,41,1923.33,3196.02,0.00
2024-12-10 17:36:56,59,3138,18,41,1915.42,3197.00,0.00
2024-12-10 17:36:56,60,3138,19,41,1883.49,3197.02,0.00
2024-12-10 17:36:56,59,3138,19,40,1904.05,3197.07,0.00
2024-12-10 17:36:56,58,3138,18,40,1913.67,3197.60,0.00
2024-12-10 17:36:56,58,3139,18,40,1956.45,3198.00,0.00
2024-12-10 17:36:56,59,3139,18,41,1923.29,3198.02,0.00
2024-12-10 17:36:56,59,3140,18,41,1914.68,3199.00,0.00
2024-12-10 17:36:56,60,3140,19,41,1882.76,3199.02,0.00
2024-12-10 17:36:56,59,3140,19,40,1905.47,3199.07,0.00
2024-12-10 17:36:56,59,3141,19,40,1908.01,3200.00,0.00
2024-12-10 17:36:56,60,3141,20,40,1876.21,3200.02,0.00
2024-12-10 17:36:56,60,3142,20,40,1867.54,3201.00,0.00
2024-12-10 17:36:56,61,3142,20,41,1836.92,3201.02,0.00
2024-12-10 17:36:56,60,3142,20,40,1859.01,3201.07,0.00
2024-12-10 17:36:56,60,3143,20,40,1861.17,3202.00,0.00
2024-12-10 17:36:56,61,3143,20,41,1830.66,3202.02,0.00
2024-12-10 17:36:56,60,3143,19,41,1818.18,3202.83,0.00
2024-12-10 17:36:56,60,3144,19,41,1866.35,3203.00,0.00
2024-12-10 17:36:56,61,3144,19,42,1835.76,3203.02,0.00
2024-12-10 17:36:56,60,3144,19,41,1858.35,3203.07,0.00
2024-12-10 17:36:56,60,3145,19,41,1861.06,3204.00,0.00
2024-12-10 17:36:56,61,3145,20,41,1830.55,3204.02,0.00
2024-12-10 17:36:56,60,3145,19,41,1811.34,3204.93,0.00
2024-12-10 17:36:56,60,3146,19,41,1862.66,3205.00,0.00
2024-12-10 17:36:56,61,3146,19,42,1832.13,3205.02,0.00
2024-12-10 17:36:56,60,3146,19,41,1861.60,3205.03,0.00
2024-12-10 17:36:56,59,3146,19,40,1886.64,3205.05,0.00
2024-12-10 17:36:56,59,3147,19,40,1889.39,3206.00,0.00
2024-12-10 17:36:56,60,3147,20,40,1857.90,3206.02,0.00
2024-12-10 17:36:56,59,3147,19,40,1875.51,3206.10,0.00
2024-12-10 17:36:56,59,3148,19,40,1881.49,3207.00,0.00
2024-12-10 17:36:56,60,3148,20,40,1850.13,3207.02,0.00
2024-12-10 17:36:56,59,3148,20,39,1873.34,3207.05,0.00
2024-12-10 17:36:56,59,3149,20,39,1876.09,3208.00,0.00
2024-12-10 17:36:56,60,3149,21,39,1844.83,3208.02,0.00
2024-12-10 17:36:56,59,3149,20,39,1862.80,3208.09,0.00
2024-12-10 17:36:56,58,3149,19,39,1892.16,3208.12,0.00
2024-12-10 17:36:56,58,3150,19,39,1919.84,3209.00,0.00
2024-12-10 17:36:56,59,3150,20,39,1887.30,3209.02,0.00
2024-12-10 17:36:56,58,3150,20,38,1912.10,3209.05,0.00
2024-12-10 17:36:56,57,3150,19,38,1945.09,3209.07,0.00
2024-12-10 17:36:56,57,3151,19,38,1949.62,3210.00,0.00
2024-12-10 17:36:56,58,3151,19,39,1916.01,3210.02,0.00
2024-12-10 17:36:56,58,3152,19,39,1907.19,3211.00,0.00
2024-12-10 17:36:56,59,3152,20,39,1874.87,3211.02,0.00
2024-12-10 17:36:56,58,3152,20,38,1898.89,3211.05,0.00
2024-12-10 17:36:56,57,3152,19,38,1893.34,3211.97,0.00
2024-12-10 17:36:56,57,3153,19,38,1948.58,3212.00,0.00
2024-12-10 17:36:56,58,3153,19,39,1914.99,3212.02,0.00
2024-12-10 17:36:56,57,3153,18,39,1925.03,3212.18,0.00
2024-12-10 17:36:56,57,3154,18,39,1955.46,3213.00,0.00
2024-12-10 17:36:56,58,3154,19,39,1921.74,3213.02,0.00
2024-12-10 17:36:56,57,3154,18,39,1947.56,3213.02,0.00
2024-12-10 17:36:56,56,3154,18,38,1969.16,3213.07,0.00
2024-12-10 17:36:57,56,3155,18,38,1997.31,3214.00,0.00
2024-12-10 17:36:57,57,3155,19,38,1962.27,3214.02,0.00
2024-12-10 17:36:57,57,3156,19,38,1955.69,3215.00,0.00
2024-12-10 17:36:57,58,3156,20,38,1921.97,3215.02,0.00
2024-12-10 17:36:57,57,3156,20,37,1943.29,3215.07,0.00
2024-12-10 17:36:57,57,3157,20,37,1947.83,3216.00,0.00
2024-12-10 17:36:57,58,3157,20,38,1914.25,3216.02,0.00
2024-12-10 17:36:57,58,3158,20,38,1907.25,3217.00,0.00
2024-12-10 17:36:57,59,3158,21,38,1874.92,3217.02,0.00
2024-12-10 17:36:57,58,3158,21,37,1895.61,3217.07,0.00
2024-12-10 17:36:57,57,3158,20,37,1888.62,3217.97,0.00
2024-12-10 17:36:57,57,3159,20,37,1943.96,3218.00,0.00
2024-12-10 17:36:57,58,3159,21,37,1910.44,3218.02,0.00
2024-12-10 17:36:57,57,3159,20,37,1925.33,3218.04,0.00
2024-12-10 17:36:57,57,3160,20,37,1940.05,3219.00,0.00
2024-12-10 17:36:57,58,3160,20,38,1906.60,3219.02,0.00
2024-12-10 17:36:57,57,3160,20,37,1928.76,3219.05,0.00
2024-12-10 17:36:57,57,3161,20,37,1932.74,3220.00,0.00
2024-12-10 17:36:57,58,3161,21,37,1899.42,3220.02,0.00
2024-12-10 17:36:57,58,3162,21,37,1895.10,3221.00,0.00
2024-12-10 17:36:57,59,3162,21,38,1862.98,3221.02,0.00
2024-12-10 17:36:57,58,3162,20,38,1894.55,3221.02,0.00
2024-12-10 17:36:57,58,3163,20,38,1885.69,3222.00,0.00
2024-12-10 17:36:57,59,3163,20,39,1853.73,3222.02,0.00
2024-12-10 17:36:57,58,3163,20,38,1882.39,3222.09,0.00
2024-12-10 17:36:57,58,3164,20,38,1886.83,3223.00,0.00
2024-12-10 17:36:57,59,3164,20,39,1854.85,3223.02,0.00
2024-12-10 17:36:57,59,3165,20,39,1849.72,3224.00,0.00
2024-12-10 17:36:57,60,3165,21,39,1818.89,3224.02,0.00
2024-12-10 17:36:57,59,3165,21,38,1836.08,3224.09,0.00
2024-12-10 17:36:57,58,3165,20,38,1843.66,3224.36,0.00
2024-12-10 17:36:57,58,3166,20,38,1879.11,3225.00,0.00
2024-12-10 17:36:57,59,3166,21,38,1847.26,3225.02,0.00
2024-12-10 17:36:57,58,3166,20,38,1839.70,3225.43,0.00
2024-12-10 17:36:57,58,3167,20,38,1877.35,3226.00,0.00
2024-12-10 17:36:57,59,3167,20,39,1845.53,3226.02,0.00
2024-12-10 17:36:57,58,3167,20,38,1863.47,3226.09,0.00
2024-12-10 17:36:57,58,3168,20,38,1867.92,3227.00,0.00
2024-12-10 17:36:57,59,3168,21,38,1836.26,3227.02,0.00
2024-12-10 17:36:57,58,3168,20,38,1865.16,3227.09,0.00
2024-12-10 17:36:57,57,3168,19,38,1896.75,3227.09,0.00
2024-12-10 17:36:57,56,3168,18,38,1900.99,3227.64,0.00
2024-12-10 17:36:57,56,3169,18,38,1947.36,3228.00,0.00
2024-12-10 17:36:57,57,3169,18,39,1913.19,3228.02,0.00
2024-12-10 17:36:57,57,3170,18,39,1904.72,3229.00,0.00
2024-12-10 17:36:57,58,3170,18,40,1871.88,3229.02,0.00
2024-12-10 17:36:57,57,3170,18,39,1901.91,3229.09,0.00
2024-12-10 17:36:57,57,3171,18,39,1907.01,3230.00,0.00
2024-12-10 17:36:57,58,3171,19,39,1874.13,3230.02,0.00
2024-12-10 17:36:57,58,3172,19,39,1868.52,3231.00,0.00
2024-12-10 17:36:57,59,3172,19,40,1836.85,3231.02,0.00
2024-12-10 17:36:57,58,3172,19,39,1855.18,3231.09,0.00
2024-12-10 17:36:57,58,3173,19,39,1859.63,3232.00,0.00
2024-12-10 17:36:57,59,3173,20,39,1828.11,3232.02,0.00
2024-12-10 17:36:57,58,3173,19,39,1826.90,3232.36,0.00
2024-12-10 17:36:57,58,3174,19,39,1862.44,3233.00,0.00
2024-12-10 17:36:57,59,3174,20,39,1830.87,3233.02,0.00
2024-12-10 17:36:57,58,3174,20,38,1856.95,3233.10,0.00
2024-12-10 17:36:57,58,3175,20,38,1861.95,3234.00,0.00
2024-12-10 17:36:57,59,3175,21,38,1830.39,3234.02,0.00
2024-12-10 17:36:57,59,3176,21,38,1825.21,3235.00,0.00
2024-12-10 17:36:57,60,3176,21,39,1794.79,3235.02,0.00
2024-12-10 17:36:57,60,3177,21,39,1785.10,3236.00,0.00
2024-12-10 17:36:57,61,3177,22,39,1755.84,3236.02,0.00
2024-12-10 17:36:57,60,3177,22,38,1780.26,3236.07,0.00
2024-12-10 17:36:57,60,3178,22,38,1782.96,3237.00,0.00
2024-12-10 17:36:57,61,3178,23,38,1753.73,3237.02,0.00
2024-12-10 17:36:57,60,3178,22,38,1732.22,3237.97,0.00
2024-12-10 17:36:57,60,3179,22,38,1785.13,3238.00,0.00
2024-12-10 17:36:57,61,3179,22,39,1755.86,3238.02,0.00
2024-12-10 17:36:57,60,3179,22,38,1773.81,3238.08,0.00
2024-12-10 17:36:57,60,3180,22,38,1777.04,3239.00,0.00
2024-12-10 17:36:57,61,3180,23,38,1747.91,3239.02,0.00
2024-12-10 17:36:57,60,3180,23,37,1765.72,3239.08,0.00
2024-12-10 17:36:57,60,3181,23,37,1768.95,3240.00,0.00
2024-12-10 17:36:57,61,3181,24,37,1739.95,3240.02,0.00
2024-12-10 17:36:57,60,3181,23,37,1717.82,3240.70,0.00
2024-12-10 17:36:57,60,3182,23,37,1762.32,3241.00,0.00
2024-12-10 17:36:57,61,3182,24,37,1733.43,3241.02,0.00
2024-12-10 17:36:57,60,3182,24,36,1751.53,3241.08,0.00
2024-12-10 17:36:57,60,3183,24,36,1754.76,3242.00,0.00
2024-12-10 17:36:57,61,3183,24,37,1725.99,3242.02,0.00
2024-12-10 17:36:57,61,3184,24,37,1719.10,3243.00,0.00
2024-12-10 17:36:57,62,3184,25,37,1691.37,3243.02,0.00
2024-12-10 17:36:57,61,3184,25,36,1709.01,3243.08,0.00
2024-12-10 17:36:57,60,3184,24,36,1706.51,3243.82,0.00
2024-12-10 17:36:57,60,3185,24,36,1754.76,3244.00,0.00
2024-12-10 17:36:57,61,3185,25,36,1725.99,3244.02,0.00
2024-12-10 17:36:57,60,3185,25,35,1746.65,3244.03,0.00
2024-12-10 17:36:57,59,3185,24,35,1738.04,3244.63,0.00
2024-12-10 17:36:57,59,3186,24,35,1781.20,3245.00,0.00
2024-12-10 17:36:57,60,3186,25,35,1751.51,3245.02,0.00
2024-12-10 17:36:57,60,3187,25,35,1744.29,3246.00,0.00
2024-12-10 17:36:57,61,3187,26,35,1715.69,3246.02,0.00
2024-12-10 17:36:57,60,3187,26,34,1735.64,3246.07,0.00
2024-12-10 17:36:57,60,3188,26,34,1738.33,3247.00,0.00
2024-12-10 17:36:57,61,3188,26,35,1709.83,3247.02,0.00
2024-12-10 17:36:57,60,3188,25,35,1704.56,3247.72,0.00
2024-12-10 17:36:57,60,3189,25,35,1730.55,3248.00,0.00
2024-12-10 17:36:57,61,3189,25,36,1702.18,3248.02,0.00
2024-12-10 17:36:57,60,3189,25,35,1722.44,3248.07,0.00
2024-12-10 17:36:58,60,3190,25,35,1725.13,3249.00,0.00
2024-12-10 17:36:58,61,3190,26,35,1696.85,3249.02,0.00
2024-12-10 17:36:58,61,3191,26,35,1689.01,3250.00,0.00
2024-12-10 17:36:58,62,3191,26,36,1661.76,3250.02,0.00
2024-12-10 17:36:58,61,3191,26,35,1681.56,3250.07,0.00
2024-12-10 17:36:58,62,3190,26,36,1634.80,3250.71,0.00
2024-12-10 17:36:58,62,3191,26,36,1667.52,3251.00,0.00
2024-12-10 17:36:58,63,3191,26,37,1641.05,3251.02,0.00
2024-12-10 17:36:58,62,3191,25,37,1667.00,3251.02,0.00
2024-12-10 17:36:58,61,3191,24,37,1651.20,3251.80,0.00
2024-12-10 17:36:58,61,3192,24,37,1751.55,3252.00,0.00
2024-12-10 17:36:58,62,3192,24,38,1723.29,3252.02,0.00
2024-12-10 17:36:58,61,3192,24,37,1745.16,3252.05,0.00
2024-12-10 17:36:58,61,3193,24,37,1746.75,3253.00,0.00
2024-12-10 17:36:58,62,3193,24,38,1718.58,3253.02,0.00
2024-12-10 17:36:58,62,3194,24,38,1709.65,3254.00,0.00
2024-12-10 17:36:58,63,3194,25,38,1682.51,3254.02,0.00
2024-12-10 17:36:58,62,3194,25,37,1703.89,3254.05,0.00
2024-12-10 17:36:58,61,3194,24,37,1697.73,3254.82,0.00
2024-12-10 17:36:58,61,3195,24,37,1745.35,3255.00,0.00
2024-12-10 17:36:58,62,3195,25,37,1717.20,3255.02,0.00
2024-12-10 17:36:58,62,3196,25,37,1708.61,3256.00,0.00
2024-12-10 17:36:58,63,3196,25,38,1681.49,3256.02,0.00
2024-12-10 17:36:58,62,3196,25,37,1702.84,3256.05,0.00
2024-12-10 17:36:58,62,3197,25,37,1703.88,3257.00,0.00
2024-12-10 17:36:58,63,3197,26,37,1676.84,3257.02,0.00
2024-12-10 17:36:58,62,3197,25,37,1670.56,3257.71,0.00
2024-12-10 17:36:58,62,3198,25,37,1694.97,3258.00,0.00
2024-12-10 17:36:58,63,3198,26,37,1668.07,3258.02,0.00
2024-12-10 17:36:58,62,3198,26,36,1689.73,3258.05,0.00
2024-12-10 17:36:58,61,3198,25,36,1676.23,3258.97,0.00
2024-12-10 17:36:58,61,3199,25,36,1728.61,3259.00,0.00
2024-12-10 17:36:58,62,3199,25,37,1700.72,3259.02,0.00
2024-12-10 17:36:58,61,3199,24,37,1686.06,3259.56,0.00
2024-12-10 17:36:58,61,3199,24,37,1725.39,3260.00,0.00
2024-12-10 17:36:58,62,3199,24,38,1697.57,3260.02,0.00
2024-12-10 17:36:58,61,3199,24,37,1720.59,3260.05,0.00
2024-12-10 17:36:58,60,3199,23,37,1728.60,3260.40,0.00
2024-12-10 17:36:58,60,3200,23,37,1763.79,3261.00,0.00
2024-12-10 17:36:58,61,3200,23,38,1734.88,3261.02,0.00
2024-12-10 17:36:58,60,3200,22,38,1746.46,3261.22,0.00
2024-12-10 17:36:58,60,3201,22,38,1755.14,3262.00,0.00
2024-12-10 17:36:58,61,3201,23,38,1726.37,3262.02,0.00
2024-12-10 17:36:58,60,3201,23,37,1750.80,3262.05,0.00
2024-12-10 17:36:58,59,3201,22,37,1744.15,3262.59,0.00
2024-12-10 17:36:58,59,3202,22,37,1786.49,3263.00,0.00
2024-12-10 17:36:58,60,3202,23,37,1756.72,3263.02,0.00
2024-12-10 17:36:58,60,3203,23,37,1747.88,3264.00,0.00
2024-12-10 17:36:58,61,3203,23,38,1719.23,3264.02,0.00
2024-12-10 17:36:58,60,3203,23,37,1743.53,3264.05,0.00
2024-12-10 17:36:58,60,3204,23,37,1745.69,3265.00,0.00
2024-12-10 17:36:58,61,3204,23,38,1717.08,3265.02,0.00
2024-12-10 17:36:58,60,3204,23,37,1740.80,3265.03,0.00
2024-12-10 17:36:58,59,3204,22,37,1752.33,3265.34,0.00
2024-12-10 17:36:58,59,3205,22,37,1786.54,3266.00,0.00
2024-12-10 17:36:58,60,3205,22,38,1756.76,3266.02,0.00
2024-12-10 17:36:58,59,3205,21,38,1754.71,3266.66,0.00
2024-12-10 17:36:58,59,3206,21,38,1777.45,3267.00,0.00
2024-12-10 17:36:58,60,3206,22,38,1747.83,3267.02,0.00
2024-12-10 17:36:58,59,3206,22,37,1774.13,3267.03,0.00
2024-12-10 17:36:58,58,3206,21,37,1798.58,3267.22,0.00
2024-12-10 17:36:58,58,3207,21,37,1807.52,3268.00,0.00
2024-12-10 17:36:58,59,3207,21,38,1776.89,3268.02,0.00
2024-12-10 17:36:58,58,3207,20,38,1766.57,3268.50,0.00
2024-12-10 17:36:58,58,3208,20,38,1806.95,3269.00,0.00
2024-12-10 17:36:58,59,3208,21,38,1776.32,3269.02,0.00
2024-12-10 17:36:58,58,3208,21,37,1804.13,3269.03,0.00
2024-12-10 17:36:58,58,3209,21,37,1806.94,3270.00,0.00
2024-12-10 17:36:58,59,3209,22,37,1776.31,3270.02,0.00
2024-12-10 17:36:58,59,3210,22,37,1766.88,3271.00,0.00
2024-12-10 17:36:58,60,3210,23,37,1737.43,3271.02,0.00
2024-12-10 17:36:58,59,3210,23,36,1764.66,3271.03,0.00
2024-12-10 17:36:58,59,3211,23,36,1766.86,3272.00,0.00
2024-12-10 17:36:58,60,3211,24,36,1737.41,3272.02,0.00
2024-12-10 17:36:58,59,3211,23,36,1741.35,3272.05,0.00
2024-12-10 17:36:58,60,3210,24,36,1697.24,3272.55,0.00
2024-12-10 17:36:58,60,3211,24,36,1753.22,3273.00,0.00
2024-12-10 17:36:58,61,3211,24,37,1724.48,3273.02,0.00
2024-12-10 17:36:58,60,3211,24,36,1751.58,3273.03,0.00
2024-12-10 17:36:58,60,3212,24,36,1807.77,3274.00,0.00
2024-12-10 17:36:58,61,3212,25,36,1778.14,3274.02,0.00
2024-12-10 17:36:58,60,3212,24,36,1782.68,3274.05,0.00
2024-12-10 17:36:58,60,3213,24,36,1806.69,3275.00,0.00
2024-12-10 17:36:58,61,3213,25,36,1777.07,3275.02,0.00
2024-12-10 17:36:58,60,3213,25,35,1805.05,3275.03,0.00
2024-12-10 17:36:58,59,3213,24,35,1832.61,3275.12,0.00
2024-12-10 17:36:58,59,3214,24,35,1837.58,3276.00,0.00
2024-12-10 17:36:58,60,3214,24,36,1806.96,3276.02,0.00
2024-12-10 17:36:58,59,3214,23,36,1822.77,3276.12,0.00
2024-12-10 17:36:58,58,3214,22,36,1851.28,3276.14,0.00
2024-12-10 17:36:58,58,3215,22,36,1879.63,3277.00,0.00
2024-12-10 17:36:58,59,3215,22,37,1847.78,3277.02,0.00
2024-12-10 17:36:58,58,3215,22,36,1877.94,3277.03,0.00
2024-12-10 17:36:58,57,3215,21,36,1885.73,3277.39,0.00
2024-12-10 17:36:58,57,3216,21,36,1923.53,3278.00,0.00
2024-12-10 17:36:58,58,3216,22,36,1890.37,3278.02,0.00
2024-12-10 17:36:58,58,3217,22,36,1881.01,3279.00,0.00
2024-12-10 17:36:58,59,3217,23,36,1849.13,3279.02,0.00
2024-12-10 17:36:58,58,3217,23,35,1878.75,3279.03,0.00
2024-12-10 17:36:58,57,3217,22,35,1887.68,3279.37,0.00
2024-12-10 17:36:58,56,3217,21,35,1913.01,3279.63,0.00
2024-12-10 17:36:58,56,3218,21,35,1959.56,3280.00,0.00
2024-12-10 17:36:58,57,3218,21,36,1925.19,3280.02,0.00
2024-12-10 17:36:58,57,3219,21,36,1916.56,3281.00,0.00
2024-12-10 17:36:58,58,3219,22,36,1883.52,3281.02,0.00
2024-12-10 17:36:58,57,3219,22,35,1914.84,3281.04,0.00
2024-12-10 17:36:58,57,3220,22,35,1918.30,3282.00,0.00
2024-12-10 17:36:58,58,3220,22,36,1885.22,3282.02,0.00
2024-12-10 17:36:58,57,3220,21,36,1895.38,3282.21,0.00
2024-12-10 17:36:59,57,3221,21,36,1927.58,3283.00,0.00
2024-12-10 17:36:59,58,3221,21,37,1894.35,3283.02,0.00
2024-12-10 17:36:59,57,3221,21,36,1926.43,3283.04,0.00
2024-12-10 17:36:59,57,3222,21,36,1929.90,3284.00,0.00
2024-12-10 17:36:59,58,3222,22,36,1896.63,3284.02,0.00
2024-12-10 17:36:59,57,3222,21,36,1879.73,3284.93,0.00
2024-12-10 17:36:59,57,3223,21,36,1935.10,3285.00,0.00
2024-12-10 17:36:59,58,3223,22,36,1901.73,3285.02,0.00
2024-12-10 17:36:59,57,3223,22,35,1933.95,3285.04,0.00
2024-12-10 17:36:59,57,3224,22,35,1937.42,3286.00,0.00
2024-12-10 17:36:59,58,3224,22,36,1904.01,3286.02,0.00
2024-12-10 17:36:59,57,3224,21,36,1933.96,3286.02,0.00
2024-12-10 17:36:59,57,3225,21,36,1948.39,3287.00,0.00
2024-12-10 17:36:59,58,3225,22,36,1914.79,3287.02,0.00
2024-12-10 17:36:59,57,3225,22,35,1946.08,3287.02,0.00
2024-12-10 17:36:59,57,3226,22,35,1948.98,3288.00,0.00
2024-12-10 17:36:59,58,3226,22,36,1915.38,3288.02,0.00
2024-12-10 17:36:59,58,3227,22,36,1906.32,3289.00,0.00
2024-12-10 17:36:59,59,3227,22,37,1874.01,3289.02,0.00
2024-12-10 17:36:59,58,3227,22,36,1904.05,3289.02,0.00
2024-12-10 17:36:59,58,3228,22,36,1906.33,3290.00,0.00
2024-12-10 17:36:59,59,3228,23,36,1874.02,3290.02,0.00
2024-12-10 17:36:59,58,3228,22,36,1878.54,3290.03,0.00
2024-12-10 17:36:59,58,3229,22,36,1904.07,3291.00,0.00
2024-12-10 17:36:59,59,3229,22,37,1871.80,3291.02,0.00
2024-12-10 17:36:59,58,3229,22,36,1900.67,3291.02,0.00
2024-12-10 17:36:59,58,3230,22,36,1902.95,3292.00,0.00
2024-12-10 17:36:59,59,3230,22,37,1870.70,3292.02,0.00
2024-12-10 17:36:59,58,3230,21,37,1857.98,3292.52,0.00
2024-12-10 17:36:59,58,3231,21,37,1899.19,3293.00,0.00
2024-12-10 17:36:59,59,3231,22,37,1867.00,3293.02,0.00
2024-12-10 17:36:59,58,3231,22,36,1895.22,3293.02,0.00
2024-12-10 17:36:59,57,3231,21,36,1900.92,3293.42,0.00
2024-12-10 17:36:59,57,3232,21,36,1940.03,3294.00,0.00
2024-12-10 17:36:59,58,3232,22,36,1906.58,3294.02,0.00
2024-12-10 17:36:59,57,3232,21,36,1891.99,3294.90,0.00
2024-12-10 17:36:59,57,3233,21,36,1946.40,3295.00,0.00
2024-12-10 17:36:59,58,3233,21,37,1912.84,3295.02,0.00
2024-12-10 17:36:59,57,3233,21,36,1942.36,3295.02,0.00
2024-12-10 17:36:59,57,3234,21,36,1945.26,3296.00,0.00
2024-12-10 17:36:59,58,3234,22,36,1911.72,3296.02,0.00
2024-12-10 17:36:59,57,3234,21,36,1929.11,3296.14,0.00
2024-12-10 17:36:59,57,3235,21,36,1936.02,3297.00,0.00
2024-12-10 17:36:59,58,3235,21,37,1902.64,3297.02,0.00
2024-12-10 17:36:59,57,3235,21,36,1932.54,3297.02,0.00
2024-12-10 17:36:59,57,3236,21,36,1935.45,3298.00,0.00
2024-12-10 17:36:59,58,3236,22,36,1902.08,3298.02,0.00
2024-12-10 17:36:59,58,3237,22,36,1892.98,3299.00,0.00
2024-12-10 17:36:59,59,3237,23,36,1860.90,3299.02,0.00
2024-12-10 17:36:59,58,3237,23,35,1890.14,3299.02,0.00
2024-12-10 17:36:59,57,3237,22,35,1904.32,3299.32,0.00
2024-12-10 17:36:59,57,3238,22,35,1940.09,3300.00,0.00
2024-12-10 17:36:59,58,3238,23,35,1906.64,3300.02,0.00
2024-12-10 17:36:59,58,3239,23,35,1897.55,3301.00,0.00
2024-12-10 17:36:59,59,3239,24,35,1865.38,3301.02,0.00
2024-12-10 17:36:59,58,3239,24,34,1894.13,3301.02,0.00
2024-12-10 17:36:59,58,3240,24,34,1896.41,3302.00,0.00
2024-12-10 17:36:59,59,3240,25,34,1864.27,3302.02,0.00
2024-12-10 17:36:59,58,3240,24,34,1851.09,3302.52,0.00
2024-12-10 17:36:59,57,3240,23,34,1879.02,3302.67,0.00
2024-12-10 17:36:59,57,3241,23,34,1926.21,3303.00,0.00
2024-12-10 17:36:59,58,3241,24,34,1893.00,3303.02,0.00
2024-12-10 17:36:59,57,3241,24,33,1922.73,3303.02,0.00
2024-12-10 17:36:59,57,3242,24,33,1925.63,3304.00,0.00
2024-12-10 17:36:59,58,3242,24,34,1892.43,3304.02,0.00
2024-12-10 17:36:59,58,3243,24,34,1890.04,3305.00,0.00
2024-12-10 17:36:59,59,3243,24,35,1858.01,3305.02,0.00
2024-12-10 17:36:59,58,3243,23,35,1844.38,3305.76,0.00
2024-12-10 17:36:59,58,3244,23,35,1893.58,3306.00,0.00
2024-12-10 17:36:59,59,3244,24,35,1861.48,3306.02,0.00
2024-12-10 17:36:59,58,3244,24,34,1890.73,3306.02,0.00
2024-12-10 17:36:59,57,3244,23,34,1890.48,3306.53,0.00
2024-12-10 17:36:59,57,3245,23,34,1933.18,3307.00,0.00
2024-12-10 17:36:59,58,3245,23,35,1899.85,3307.02,0.00
2024-12-10 17:37:00,58,3246,23,35,1890.73,3308.00,0.00
2024-12-10 17:37:00,59,3246,24,35,1858.69,3308.02,0.00
2024-12-10 17:37:00,58,3246,24,34,1888.45,3308.02,0.00
2024-12-10 17:37:00,57,3246,23,34,1892.16,3308.47,0.00
2024-12-10 17:37:00,57,3247,23,34,1933.19,3309.00,0.00
2024-12-10 17:37:00,58,3247,24,34,1899.86,3309.02,0.00
2024-12-10 17:37:00,58,3248,24,34,1890.73,3310.00,0.00
2024-12-10 17:37:00,59,3248,24,35,1858.69,3310.02,0.00
2024-12-10 17:37:00,58,3248,24,34,1887.31,3310.02,0.00
2024-12-10 17:37:00,57,3248,23,34,1916.97,3310.12,0.00
2024-12-10 17:37:00,58,3247,24,34,1859.81,3310.90,0.00
2024-12-10 17:37:00,58,3248,24,34,1894.16,3311.00,0.00
2024-12-10 17:37:00,59,3248,25,34,1862.06,3311.02,0.00
2024-12-10 17:37:00,58,3248,24,34,1880.87,3311.07,0.00
2024-12-10 17:37:00,57,3248,23,34,1890.77,3311.40,0.00
2024-12-10 17:37:00,57,3249,23,34,1987.64,3312.00,0.00
2024-12-10 17:37:00,58,3249,23,35,1953.37,3312.02,0.00
2024-12-10 17:37:00,57,3249,23,34,1983.58,3312.02,0.00
2024-12-10 17:37:00,57,3250,23,34,1986.50,3313.00,0.00
2024-12-10 17:37:00,58,3250,24,34,1952.25,3313.02,0.00
2024-12-10 17:37:00,58,3251,24,34,1955.00,3314.00,0.00
2024-12-10 17:37:00,59,3251,25,34,1921.86,3314.02,0.00
2024-12-10 17:37:00,59,3252,25,34,1915.55,3315.00,0.00
2024-12-10 17:37:00,60,3252,26,34,1883.62,3315.02,0.00
2024-12-10 17:37:00,59,3252,26,33,1905.44,3315.02,0.00
2024-12-10 17:37:00,59,3253,26,33,1907.14,3316.00,0.00
2024-12-10 17:37:00,60,3253,27,33,1875.35,3316.02,0.00
2024-12-10 17:37:00,59,3253,26,33,1876.90,3316.34,0.00
2024-12-10 17:37:00,59,3254,26,33,1911.65,3317.00,0.00
2024-12-10 17:37:00,60,3254,27,33,1879.78,3317.02,0.00
2024-12-10 17:37:00,59,3254,27,32,1904.90,3317.03,0.00
2024-12-10 17:37:00,59,3255,27,32,1907.16,3318.00,0.00
2024-12-10 17:37:00,60,3255,28,32,1875.37,3318.02,0.00
2024-12-10 17:37:00,60,3256,28,32,1865.56,3319.00,0.00
2024-12-10 17:37:00,61,3256,29,32,1834.97,3319.02,0.00
2024-12-10 17:37:00,60,3256,29,31,1859.47,3319.03,0.00
2024-12-10 17:37:00,61,3255,29,32,1820.37,3319.33,0.00
2024-12-10 17:37:00,61,3256,29,32,1855.66,3320.00,0.00
2024-12-10 17:37:00,62,3256,29,33,1825.73,3320.02,0.00
2024-12-10 17:37:00,62,3257,29,33,1870.00,3321.00,0.00
2024-12-10 17:37:00,63,3257,29,34,1840.31,3321.02,0.00
2024-12-10 17:37:00,62,3257,29,33,1864.11,3321.03,0.00
2024-12-10 17:37:00,61,3257,28,33,1873.22,3321.34,0.00
2024-12-10 17:37:00,61,3258,28,33,1906.34,3322.00,0.00
2024-12-10 17:37:00,62,3258,28,34,1875.59,3322.02,0.00
2024-12-10 17:37:00,62,3259,28,34,1865.10,3323.00,0.00
2024-12-10 17:37:00,63,3259,29,34,1835.50,3323.02,0.00
2024-12-10 17:37:00,62,3259,29,33,1860.28,3323.03,0.00
2024-12-10 17:37:00,61,3259,28,33,1875.40,3323.28,0.00
2024-12-10 17:37:00,61,3260,28,33,1906.40,3324.00,0.00
2024-12-10 17:37:00,62,3260,28,34,1875.65,3324.02,0.00
2024-12-10 17:37:00,61,3260,27,34,1890.76,3324.15,0.00
2024-12-10 17:37:00,61,3261,27,34,1895.75,3325.00,0.00
2024-12-10 17:37:00,62,3261,27,35,1865.17,3325.02,0.00
2024-12-10 17:37:00,61,3261,27,34,1891.39,3325.03,0.00
2024-12-10 17:37:00,61,3262,27,34,1892.50,3326.00,0.00
2024-12-10 17:37:00,62,3262,27,35,1861.98,3326.02,0.00
2024-12-10 17:37:00,61,3262,26,35,1848.64,3326.84,0.00
2024-12-10 17:37:00,61,3263,26,35,1897.86,3327.00,0.00
2024-12-10 17:37:00,62,3263,26,36,1867.25,3327.02,0.00
2024-12-10 17:37:00,61,3263,26,35,1894.04,3327.03,0.00
2024-12-10 17:37:00,60,3263,25,35,1920.66,3327.17,0.00
2024-12-10 17:37:00,61,3262,26,35,1888.09,3327.23,0.00
2024-12-10 17:37:00,60,3262,25,35,1906.55,3327.70,0.00
2024-12-10 17:37:00,60,3263,25,35,1952.26,3328.00,0.00
2024-12-10 17:37:00,61,3263,25,36,1920.25,3328.02,0.00
2024-12-10 17:37:00,61,3264,25,36,1964.49,3329.00,0.00
2024-12-10 17:37:00,62,3264,26,36,1932.80,3329.02,0.00
2024-12-10 17:37:00,61,3264,26,35,1961.22,3329.03,0.00
2024-12-10 17:37:00,60,3264,25,35,1988.95,3329.17,0.00
2024-12-10 17:37:00,59,3264,24,35,1998.32,3329.73,0.00
2024-12-10 17:37:00,59,3265,24,35,2045.95,3330.00,0.00
2024-12-10 17:37:00,60,3265,24,36,2011.85,3330.02,0.00
2024-12-10 17:37:00,60,3266,24,36,2001.91,3331.00,0.00
2024-12-10 17:37:00,61,3266,25,36,1969.09,3331.02,0.00
2024-12-10 17:37:00,60,3266,25,35,1998.02,3331.03,0.00
2024-12-10 17:37:00,59,3266,24,35,2007.77,3331.37,0.00
2024-12-10 17:37:00,59,3267,24,35,2043.79,3332.00,0.00
2024-12-10 17:37:00,60,3267,25,35,2009.73,3332.02,0.00
2024-12-10 17:37:00,59,3267,24,35,1988.66,3332.66,0.00
2024-12-10 17:37:00,59,3268,24,35,2034.13,3333.00,0.00
2024-12-10 17:37:00,60,3268,25,35,2000.23,3333.02,0.00
2024-12-10 17:37:00,59,3268,25,34,2029.61,3333.03,0.00
2024-12-10 17:37:00,59,3269,25,34,2031.92,3334.00,0.00
2024-12-10 17:37:00,60,3269,26,34,1998.05,3334.02,0.00
2024-12-10 17:37:00,60,3270,26,34,1988.09,3335.00,0.00
2024-12-10 17:37:00,61,3270,26,35,1955.50,3335.02,0.00
2024-12-10 17:37:00,60,3270,26,34,1984.20,3335.03,0.00
2024-12-10 17:37:00,60,3271,26,34,1985.91,3336.00,0.00
2024-12-10 17:37:00,61,3271,26,35,1953.35,3336.02,0.00
2024-12-10 17:37:00,60,3271,25,35,1947.16,3336.43,0.00
2024-12-10 17:37:00,60,3272,25,35,1984.28,3337.00,0.00
2024-12-10 17:37:01,61,3272,25,36,1951.75,3337.02,0.00
2024-12-10 17:37:01,60,3272,25,35,1980.94,3337.03,0.00
2024-12-10 17:37:01,59,3272,24,35,1977.15,3337.92,0.00
2024-12-10 17:37:01,59,3273,24,35,2030.96,3338.00,0.00
2024-12-10 17:37:01,60,3273,25,35,1997.11,3338.02,0.00
2024-12-10 17:37:01,59,3273,24,35,1992.65,3338.42,0.00
2024-12-10 17:37:01,59,3274,24,35,2030.44,3339.00,0.00
2024-12-10 17:37:01,60,3274,25,35,1996.60,3339.02,0.00
2024-12-10 17:37:01,59,3274,25,34,2026.48,3339.03,0.00
2024-12-10 17:37:01,59,3275,25,34,2028.78,3340.00,0.00
2024-12-10 17:37:01,60,3275,25,35,1994.97,3340.02,0.00
2024-12-10 17:37:01,60,3276,25,35,1984.99,3341.00,0.00
2024-12-10 17:37:01,61,3276,26,35,1952.44,3341.02,0.00
2024-12-10 17:37:01,60,3276,26,34,1980.54,3341.05,0.00
2024-12-10 17:37:01,60,3277,26,34,1982.79,3342.00,0.00
2024-12-10 17:37:01,61,3277,26,35,1950.29,3342.02,0.00
2024-12-10 17:37:01,61,3278,26,35,1939.91,3343.00,0.00
2024-12-10 17:37:01,62,3278,26,36,1908.62,3343.02,0.00
2024-12-10 17:37:01,61,3278,25,36,1938.82,3343.02,0.00
2024-12-10 17:37:01,60,3278,25,35,1967.23,3343.03,0.00
2024-12-10 17:37:01,60,3279,25,35,1991.23,3344.00,0.00
2024-12-10 17:37:01,61,3279,25,36,1958.58,3344.02,0.00
2024-12-10 17:37:01,61,3280,25,36,1964.45,3345.00,0.00
2024-12-10 17:37:01,62,3280,25,37,1932.77,3345.02,0.00
2024-12-10 17:37:01,61,3280,24,37,1949.69,3345.13,0.00
2024-12-10 17:37:01,61,3281,24,37,1966.80,3346.00,0.00
2024-12-10 17:37:01,62,3281,24,38,1935.08,3346.02,0.00
2024-12-10 17:37:01,62,3282,24,38,1928.73,3347.00,0.00
2024-12-10 17:37:01,63,3282,25,38,1898.11,3347.02,0.00
2024-12-10 17:37:01,62,3282,25,37,1916.86,3347.03,0.00
2024-12-10 17:37:01,61,3282,24,37,1930.28,3347.31,0.00
2024-12-10 17:37:01,61,3283,24,37,1962.58,3348.00,0.00
2024-12-10 17:37:01,62,3283,24,38,1930.93,3348.02,0.00
2024-12-10 17:37:01,61,3283,23,38,1939.05,3348.25,0.00
2024-12-10 17:37:01,62,3282,23,39,1892.40,3348.74,0.00
2024-12-10 17:37:01,62,3283,23,39,1947.17,3349.00,0.00
2024-12-10 17:37:01,63,3283,23,40,1916.26,3349.02,0.00
2024-12-10 17:37:01,62,3283,23,39,1942.31,3349.03,0.00
2024-12-10 17:37:01,61,3283,22,39,1951.66,3349.10,0.00
2024-12-10 17:37:01,61,3284,22,39,2031.85,3350.00,0.00
2024-12-10 17:37:01,62,3284,22,40,1999.08,3350.02,0.00
2024-12-10 17:37:01,62,3285,22,40,1988.33,3351.00,0.00
2024-12-10 17:37:01,63,3285,22,41,1956.76,3351.02,0.00
2024-12-10 17:37:01,62,3285,22,40,1984.00,3351.03,0.00
2024-12-10 17:37:01,61,3285,21,40,2006.15,3351.21,0.00
2024-12-10 17:37:01,62,3284,22,40,1949.96,3351.97,0.00
2024-12-10 17:37:01,62,3285,22,40,2004.06,3352.00,0.00
2024-12-10 17:37:01,63,3285,22,41,1972.25,3352.02,0.00
2024-12-10 17:37:01,62,3285,21,41,1986.80,3352.16,0.00
2024-12-10 17:37:01,62,3286,21,41,2067.39,3353.00,0.00
2024-12-10 17:37:01,63,3286,21,42,2034.57,3353.02,0.00
2024-12-10 17:37:01,63,3287,21,42,2023.47,3354.00,0.00
2024-12-10 17:37:01,64,3287,21,43,1991.85,3354.02,0.00
2024-12-10 17:37:01,63,3287,21,42,2019.21,3354.03,0.00
2024-12-10 17:37:01,62,3287,20,42,2043.71,3354.18,0.00
2024-12-10 17:37:01,61,3287,19,42,2060.99,3354.66,0.00
2024-12-10 17:37:01,61,3288,19,42,2104.73,3355.00,0.00
2024-12-10 17:37:01,62,3288,20,42,2070.79,3355.02,0.00
2024-12-10 17:37:01,61,3288,20,41,2099.79,3355.03,0.00
2024-12-10 17:37:01,62,3287,21,41,2052.04,3355.48,0.00
2024-12-10 17:37:01,62,3288,21,41,2116.32,3356.00,0.00
2024-12-10 17:37:01,63,3288,22,41,2082.73,3356.02,0.00
2024-12-10 17:37:01,62,3288,21,41,2082.03,3356.68,0.00
2024-12-10 17:37:01,62,3289,21,41,2179.76,3357.00,0.00
2024-12-10 17:37:01,63,3289,21,42,2145.16,3357.02,0.00
2024-12-10 17:37:01,62,3289,21,41,2173.27,3357.05,0.00
2024-12-10 17:37:01,62,3290,21,41,2174.45,3358.00,0.00
2024-12-10 17:37:01,63,3290,22,41,2139.94,3358.02,0.00
2024-12-10 17:37:01,63,3291,22,41,2128.85,3359.00,0.00
2024-12-10 17:37:01,64,3291,22,42,2095.58,3359.02,0.00
2024-12-10 17:37:01,63,3291,22,41,2122.45,3359.05,0.00
2024-12-10 17:37:01,62,3291,21,41,2147.50,3359.13,0.00
2024-12-10 17:37:01,62,3292,21,41,2173.04,3360.00,0.00
2024-12-10 17:37:01,63,3292,22,41,2138.55,3360.02,0.00
2024-12-10 17:37:01,64,3291,22,42,2105.13,3360.05,0.00
2024-12-10 17:37:01,64,3292,22,42,2144.09,3361.00,0.00
2024-12-10 17:37:01,65,3292,23,42,2111.11,3361.02,0.00
2024-12-10 17:37:01,65,3293,23,42,2151.05,3362.00,0.00
2024-12-10 17:37:01,66,3293,23,43,2118.45,3362.02,0.00
2024-12-10 17:37:01,65,3293,23,42,2149.51,3362.03,0.00
2024-12-10 17:37:01,65,3294,23,42,2148.58,3363.00,0.00
2024-12-10 17:37:01,66,3294,24,42,2116.03,3363.02,0.00
2024-12-10 17:37:01,65,3294,24,41,2144.46,3363.03,0.00
2024-12-10 17:37:01,65,3295,24,41,2143.53,3364.00,0.00
2024-12-10 17:37:01,66,3295,25,41,2111.05,3364.02,0.00
2024-12-10 17:37:01,66,3296,25,41,2098.93,3365.00,0.00
2024-12-10 17:37:01,67,3296,25,42,2067.60,3365.02,0.00
2024-12-10 17:37:01,66,3296,25,41,2094.87,3365.03,0.00
2024-12-10 17:37:01,67,3295,26,41,2055.65,3365.30,0.00
2024-12-10 17:37:01,67,3296,26,41,2085.30,3366.00,0.00
2024-12-10 17:37:01,68,3296,27,41,2054.63,3366.02,0.00
2024-12-10 17:37:01,67,3296,26,41,2071.77,3366.10,0.00
2024-12-10 17:37:01,67,3297,26,41,2122.60,3367.00,0.00
2024-12-10 17:37:01,68,3297,26,42,2091.39,3367.02,0.00
2024-12-10 17:37:01,67,3297,26,41,2119.10,3367.03,0.00
2024-12-10 17:37:01,67,3298,26,41,2117.20,3368.00,0.00
2024-12-10 17:37:01,68,3298,26,42,2086.07,3368.02,0.00
2024-12-10 17:37:01,68,3299,26,42,2073.31,3369.00,0.00
2024-12-10 17:37:01,69,3299,27,42,2043.26,3369.01,0.00
2024-12-10 17:37:01,68,3299,27,41,2069.36,3369.03,0.00
2024-12-10 17:37:02,67,3299,26,41,2071.03,3369.79,0.00
2024-12-10 17:37:02,67,3300,26,41,2114.44,3370.00,0.00
2024-12-10 17:37:02,68,3300,27,41,2083.34,3370.02,0.00
2024-12-10 17:37:02,68,3301,27,41,2070.57,3371.00,0.00
2024-12-10 17:37:02,69,3301,27,42,2040.57,3371.01,0.00
2024-12-10 17:37:02,68,3301,27,41,2066.62,3371.03,0.00
2024-12-10 17:37:02,67,3301,26,41,2068.23,3371.79,0.00
2024-12-10 17:37:02,67,3302,26,41,2111.66,3372.00,0.00
2024-12-10 17:37:02,68,3302,27,41,2080.61,3372.02,0.00
2024-12-10 17:37:02,68,3303,27,41,2067.83,3373.00,0.00
2024-12-10 17:37:02,69,3303,28,41,2037.87,3373.01,0.00
2024-12-10 17:37:02,68,3303,28,40,2061.40,3373.03,0.00
2024-12-10 17:37:02,68,3304,28,40,2059.02,3374.00,0.00
2024-12-10 17:37:02,69,3304,28,41,2029.18,3374.01,0.00
2024-12-10 17:37:02,69,3305,28,41,2016.09,3375.00,0.00
2024-12-10 17:37:02,70,3305,29,41,1987.28,3375.01,0.00
2024-12-10 17:37:02,69,3305,29,40,2010.23,3375.03,0.00
2024-12-10 17:37:02,68,3305,28,40,2037.33,3375.10,0.00
2024-12-10 17:37:02,67,3305,27,40,2043.11,3375.22,0.00
2024-12-10 17:37:02,67,3306,27,40,2067.81,3376.00,0.00
2024-12-10 17:37:02,68,3306,28,40,2037.40,3376.02,0.00
2024-12-10 17:37:02,67,3306,27,40,2049.80,3376.05,0.00
2024-12-10 17:37:02,67,3307,27,40,2068.54,3377.00,0.00
2024-12-10 17:37:02,68,3307,27,41,2038.12,3377.02,0.00
2024-12-10 17:37:02,67,3307,27,40,2062.50,3377.03,0.00
2024-12-10 17:37:02,67,3308,27,40,2060.58,3378.00,0.00
2024-12-10 17:37:02,68,3308,27,41,2030.28,3378.02,0.00
2024-12-10 17:37:02,67,3308,26,41,2047.00,3378.10,0.00
2024-12-10 17:37:02,67,3309,26,41,2067.75,3379.00,0.00
2024-12-10 17:37:02,68,3309,26,42,2037.34,3379.02,0.00
2024-12-10 17:37:02,67,3309,26,41,2061.20,3379.03,0.00
2024-12-10 17:37:02,67,3310,26,41,2059.28,3380.00,0.00
2024-12-10 17:37:02,68,3310,26,42,2028.99,3380.02,0.00
2024-12-10 17:37:02,67,3310,25,42,2036.18,3380.25,0.00
2024-12-10 17:37:02,66,3310,24,42,2052.44,3380.68,0.00
2024-12-10 17:37:02,66,3311,24,42,2093.15,3381.00,0.00
2024-12-10 17:37:02,67,3311,25,42,2061.90,3381.02,0.00
2024-12-10 17:37:02,66,3311,25,41,2085.99,3381.05,0.00
2024-12-10 17:37:02,65,3311,24,41,2098.32,3381.06,0.00
2024-12-10 17:37:02,65,3312,24,41,2119.21,3382.00,0.00
2024-12-10 17:37:02,66,3312,25,41,2087.10,3382.02,0.00
2024-12-10 17:37:02,66,3313,25,41,2090.24,3383.00,0.00
2024-12-10 17:37:02,67,3313,25,42,2059.04,3383.02,0.00
2024-12-10 17:37:02,67,3314,25,42,2057.49,3384.00,0.00
2024-12-10 17:37:02,68,3314,25,43,2027.23,3384.02,0.00
2024-12-10 17:37:02,68,3315,25,43,2016.48,3385.00,0.00
2024-12-10 17:37:02,69,3315,25,44,1987.25,3385.01,0.00
2024-12-10 17:37:02,68,3315,25,43,2004.06,3385.07,0.00
2024-12-10 17:37:02,68,3316,25,43,2003.13,3386.00,0.00
2024-12-10 17:37:02,69,3316,25,44,1974.10,3386.01,0.00
2024-12-10 17:37:02,68,3316,24,44,1987.21,3386.04,0.00
2024-12-10 17:37:02,68,3317,24,44,1995.25,3387.00,0.00
2024-12-10 17:37:02,69,3317,25,44,1966.34,3387.01,0.00
2024-12-10 17:37:02,68,3317,25,43,1986.81,3387.06,0.00
2024-12-10 17:37:02,68,3318,25,43,1985.38,3388.00,0.00
2024-12-10 17:37:02,69,3318,25,44,1956.61,3388.01,0.00
2024-12-10 17:37:02,68,3318,24,44,1944.58,3388.93,0.00
2024-12-10 17:37:02,68,3319,24,44,1972.62,3389.00,0.00
2024-12-10 17:37:02,69,3319,24,45,1944.03,3389.01,0.00
2024-12-10 17:37:02,68,3319,24,44,1964.67,3389.06,0.00
2024-12-10 17:37:02,68,3320,24,44,1963.23,3390.00,0.00
2024-12-10 17:37:02,69,3320,25,44,1934.78,3390.01,0.00
2024-12-10 17:37:02,68,3320,24,44,1923.10,3390.53,0.00
2024-12-10 17:37:02,68,3321,24,44,1957.33,3391.00,0.00
2024-12-10 17:37:02,69,3321,24,45,1928.96,3391.01,0.00
2024-12-10 17:37:02,68,3321,24,44,1949.87,3391.06,0.00
2024-12-10 17:37:02,68,3322,24,44,1948.43,3392.00,0.00
2024-12-10 17:37:02,69,3322,24,45,1920.19,3392.01,0.00
2024-12-10 17:37:02,68,3322,23,45,1899.00,3392.94,0.00
2024-12-10 17:37:02,68,3323,23,45,1946.94,3393.00,0.00
2024-12-10 17:37:02,69,3323,24,45,1918.72,3393.01,0.00
2024-12-10 17:37:02,68,3323,23,45,1932.48,3393.04,0.00
2024-12-10 17:37:02,67,3323,23,44,1955.24,3393.05,0.00
2024-12-10 17:37:02,66,3323,22,44,1981.82,3393.14,0.00
2024-12-10 17:37:02,66,3324,22,44,2004.47,3394.00,0.00
2024-12-10 17:37:02,67,3324,23,44,1974.55,3394.02,0.00
2024-12-10 17:37:02,67,3325,23,44,1961.96,3395.00,0.00
2024-12-10 17:37:02,68,3325,23,45,1933.11,3395.02,0.00
2024-12-10 17:37:02,67,3325,23,44,1955.38,3395.05,0.00
2024-12-10 17:37:02,67,3326,23,44,1953.92,3396.00,0.00
2024-12-10 17:37:02,68,3326,24,44,1925.19,3396.02,0.00
2024-12-10 17:37:02,68,3327,24,44,1912.26,3397.00,0.00
2024-12-10 17:37:02,69,3327,24,45,1884.55,3397.01,0.00
2024-12-10 17:37:02,68,3327,24,44,1906.28,3397.04,0.00
2024-12-10 17:37:02,69,3326,25,44,1856.34,3397.74,0.00
2024-12-10 17:37:02,69,3327,25,44,1925.98,3398.00,0.00
2024-12-10 17:37:02,70,3327,25,45,1898.47,3398.01,0.00
2024-12-10 17:37:03,70,3328,25,45,1933.50,3399.00,0.00
2024-12-10 17:37:03,71,3328,25,46,1906.27,3399.01,0.00
2024-12-10 17:37:03,70,3328,25,45,1928.17,3399.04,0.00
2024-12-10 17:37:03,69,3328,24,45,1916.74,3399.96,0.00
2024-12-10 17:37:03,69,3329,24,45,1964.56,3400.00,0.00
2024-12-10 17:37:03,70,3329,24,46,1936.50,3400.01,0.00
2024-12-10 17:37:03,70,3330,24,46,1922.98,3401.00,0.00
2024-12-10 17:37:03,71,3330,24,47,1895.89,3401.01,0.00
2024-12-10 17:37:03,70,3330,24,46,1917.65,3401.06,0.00
2024-12-10 17:37:03,69,3330,23,46,1909.93,3401.91,0.00
2024-12-10 17:37:03,69,3331,23,46,1956.35,3402.00,0.00
2024-12-10 17:37:03,70,3331,23,47,1928.40,3402.01,0.00
2024-12-10 17:37:03,69,3331,22,47,1930.84,3402.33,0.00
2024-12-10 17:37:03,69,3332,22,47,1957.91,3403.00,0.00
2024-12-10 17:37:03,70,3332,23,47,1929.94,3403.01,0.00
2024-12-10 17:37:03,69,3332,22,47,1923.92,3403.16,0.00
2024-12-10 17:37:03,69,3333,22,47,1945.17,3404.00,0.00
2024-12-10 17:37:03,70,3333,22,48,1917.38,3404.01,0.00
2024-12-10 17:37:03,69,3333,22,47,1941.23,3404.06,0.00
2024-12-10 17:37:03,69,3334,22,47,1939.32,3405.00,0.00
2024-12-10 17:37:03,70,3334,23,47,1911.62,3405.01,0.00
2024-12-10 17:37:03,70,3335,23,47,1898.19,3406.00,0.00
2024-12-10 17:37:03,71,3335,23,48,1871.46,3406.01,0.00
2024-12-10 17:37:03,70,3335,23,47,1891.39,3406.07,0.00
2024-12-10 17:37:03,70,3336,23,47,1889.50,3407.00,0.00
2024-12-10 17:37:03,71,3336,23,48,1862.89,3407.01,0.00
2024-12-10 17:37:03,70,3336,22,48,1860.80,3407.10,0.00
2024-12-10 17:37:03,70,3337,22,48,1879.34,3408.00,0.00
2024-12-10 17:37:03,71,3337,22,49,1852.87,3408.01,0.00
2024-12-10 17:37:03,70,3337,22,48,1873.03,3408.07,0.00
2024-12-10 17:37:03,69,3337,21,48,1878.10,3408.45,0.00
2024-12-10 17:37:03,69,3338,21,48,1909.12,3409.00,0.00
2024-12-10 17:37:03,70,3338,21,49,1881.84,3409.01,0.00
2024-12-10 17:37:03,69,3338,20,49,1895.29,3409.06,0.00
2024-12-10 17:37:03,69,3339,20,49,1903.25,3410.00,0.00
2024-12-10 17:37:03,70,3339,21,49,1876.06,3410.01,0.00
2024-12-10 17:37:03,69,3339,20,49,1902.27,3410.03,0.00
2024-12-10 17:37:03,68,3339,20,48,1925.73,3410.04,0.00
2024-12-10 17:37:03,68,3340,20,48,1923.78,3411.00,0.00
2024-12-10 17:37:03,69,3340,20,49,1895.90,3411.01,0.00
2024-12-10 17:37:03,68,3340,19,49,1875.62,3411.93,0.00
2024-12-10 17:37:03,68,3341,19,49,1923.34,3412.00,0.00
2024-12-10 17:37:03,69,3341,19,50,1895.47,3412.01,0.00
2024-12-10 17:37:03,68,3341,19,49,1917.83,3412.04,0.00
2024-12-10 17:37:03,68,3342,19,49,1915.87,3413.00,0.00
2024-12-10 17:37:03,69,3342,19,50,1888.11,3413.01,0.00
2024-12-10 17:37:03,68,3342,18,50,1860.92,3413.75,0.00
2024-12-10 17:37:03,68,3343,18,50,1902.79,3414.00,0.00
2024-12-10 17:37:03,69,3343,19,50,1875.21,3414.01,0.00
2024-12-10 17:37:03,68,3343,19,49,1897.27,3414.04,0.00
2024-12-10 17:37:03,67,3343,18,49,1898.35,3414.51,0.00
2024-12-10 17:37:03,67,3344,18,49,1932.87,3415.00,0.00
2024-12-10 17:37:03,68,3344,18,50,1904.44,3415.02,0.00
2024-12-10 17:37:03,67,3344,17,50,1906.47,3415.34,0.00
2024-12-10 17:37:03,67,3345,17,50,1935.47,3416.00,0.00
2024-12-10 17:37:03,68,3345,17,51,1907.01,3416.02,0.00
2024-12-10 17:37:03,67,3345,16,51,1905.92,3416.10,0.00
2024-12-10 17:37:03,67,3346,16,51,1926.59,3417.00,0.00
2024-12-10 17:37:03,68,3346,17,51,1898.26,3417.02,0.00
2024-12-10 17:37:03,67,3346,17,50,1920.99,3417.06,0.00
2024-12-10 17:37:03,66,3346,16,50,1931.58,3417.39,0.00
2024-12-10 17:37:03,66,3347,16,50,1961.26,3418.00,0.00
2024-12-10 17:37:03,67,3347,16,51,1931.99,3418.02,0.00
2024-12-10 17:37:03,67,3348,16,51,1916.77,3419.00,0.00
2024-12-10 17:37:03,68,3348,17,51,1888.58,3419.02,0.00
2024-12-10 17:37:03,67,3348,17,50,1911.67,3419.06,0.00
2024-12-10 17:37:03,67,3349,17,50,1907.29,3420.00,0.00
2024-12-10 17:37:03,68,3349,17,51,1879.25,3420.02,0.00
2024-12-10 17:37:03,67,3349,16,51,1854.39,3420.93,0.00
2024-12-10 17:37:03,67,3350,16,51,1902.95,3421.00,0.00
2024-12-10 17:37:03,68,3350,17,51,1874.97,3421.02,0.00
2024-12-10 17:37:03,67,3350,17,50,1898.37,3421.06,0.00
2024-12-10 17:37:03,67,3351,17,50,1894.64,3422.00,0.00
2024-12-10 17:37:03,68,3351,18,50,1866.77,3422.02,0.00
2024-12-10 17:37:03,67,3351,17,50,1876.82,3422.24,0.00
2024-12-10 17:37:03,66,3351,16,50,1895.46,3422.36,0.00
2024-12-10 17:37:03,66,3352,16,50,1925.85,3423.00,0.00
2024-12-10 17:37:03,67,3352,16,51,1897.11,3423.02,0.00
2024-12-10 17:37:03,66,3352,16,50,1924.30,3423.05,0.00
2024-12-10 17:37:03,65,3352,16,49,1950.75,3423.05,0.00
2024-12-10 17:37:03,65,3353,16,49,1950.26,3424.00,0.00
2024-12-10 17:37:03,66,3353,17,49,1920.71,3424.02,0.00
2024-12-10 17:37:03,65,3353,16,49,1915.71,3424.72,0.00
2024-12-10 17:37:03,65,3354,16,49,1937.66,3425.00,0.00
2024-12-10 17:37:03,66,3354,16,50,1908.30,3425.02,0.00
2024-12-10 17:37:03,65,3354,16,49,1932.92,3425.05,0.00
2024-12-10 17:37:03,65,3355,16,49,1932.42,3426.00,0.00
2024-12-10 17:37:03,66,3355,17,49,1903.14,3426.02,0.00
2024-12-10 17:37:03,66,3356,17,49,1888.70,3427.00,0.00
2024-12-10 17:37:03,67,3356,18,49,1860.51,3427.02,0.00
2024-12-10 17:37:03,66,3356,17,49,1887.67,3427.03,0.00
2024-12-10 17:37:03,65,3356,17,48,1915.13,3427.03,0.00
2024-12-10 17:37:03,64,3356,16,48,1899.77,3427.94,0.00
2024-12-10 17:37:03,64,3357,16,48,1951.23,3428.00,0.00
2024-12-10 17:37:03,65,3357,16,49,1921.21,3428.02,0.00
2024-12-10 17:37:03,65,3358,16,49,1908.74,3429.00,0.00
2024-12-10 17:37:03,66,3358,17,49,1879.82,3429.02,0.00
2024-12-10 17:37:03,65,3358,17,48,1907.17,3429.03,0.00
2024-12-10 17:37:03,64,3358,16,48,1917.81,3429.39,0.00
2024-12-10 17:37:04,64,3359,16,48,1950.92,3430.00,0.00
2024-12-10 17:37:04,65,3359,17,48,1920.91,3430.02,0.00
2024-12-10 17:37:04,65,3360,17,48,1908.80,3431.00,0.00
2024-12-10 17:37:04,66,3360,18,48,1879.88,3431.02,0.00
2024-12-10 17:37:04,65,3360,18,47,1907.75,3431.03,0.00
2024-12-10 17:37:04,64,3360,17,47,1914.30,3431.72,0.00
2024-12-10 17:37:04,64,3361,17,47,1937.05,3432.00,0.00
2024-12-10 17:37:04,65,3361,18,47,1907.25,3432.02,0.00
2024-12-10 17:37:04,64,3361,18,46,1925.25,3432.03,0.00
2024-12-10 17:37:04,63,3361,17,46,1928.63,3432.22,0.00
2024-12-10 17:37:04,63,3362,17,46,1956.92,3433.00,0.00
2024-12-10 17:37:04,64,3362,17,47,1926.35,3433.02,0.00
2024-12-10 17:37:04,63,3362,17,46,1944.94,3433.03,0.00
2024-12-10 17:37:04,63,3363,17,46,1944.96,3434.00,0.00
2024-12-10 17:37:04,64,3363,17,47,1914.57,3434.02,0.00
2024-12-10 17:37:04,63,3363,17,46,1932.97,3434.03,0.00
2024-12-10 17:37:04,63,3364,17,46,1932.98,3435.00,0.00
2024-12-10 17:37:04,64,3364,17,47,1902.78,3435.02,0.00
2024-12-10 17:37:04,63,3364,16,47,1894.32,3435.21,0.00
2024-12-10 17:37:04,63,3365,16,47,1922.09,3436.00,0.00
2024-12-10 17:37:04,64,3365,17,47,1892.06,3436.02,0.00
2024-12-10 17:37:04,63,3365,17,46,1919.92,3436.05,0.00
2024-12-10 17:37:04,63,3366,17,46,1920.47,3437.00,0.00
2024-12-10 17:37:04,64,3366,18,46,1890.46,3437.02,0.00
2024-12-10 17:37:04,64,3367,18,46,1878.66,3438.00,0.00
2024-12-10 17:37:04,65,3367,19,46,1849.75,3438.02,0.00
2024-12-10 17:37:04,64,3367,19,45,1876.51,3438.05,0.00
2024-12-10 17:37:04,65,3366,19,46,1839.27,3438.32,0.00
2024-12-10 17:37:04,64,3366,18,46,1874.24,3438.83,0.00
2024-12-10 17:37:04,64,3367,18,46,1922.19,3439.00,0.00
2024-12-10 17:37:04,65,3367,18,47,1892.62,3439.02,0.00
2024-12-10 17:37:04,64,3367,17,47,1879.61,3439.81,0.00
2024-12-10 17:37:04,64,3368,17,47,1980.80,3440.00,0.00
2024-12-10 17:37:04,65,3368,18,47,1950.33,3440.02,0.00
2024-12-10 17:37:04,64,3368,18,46,1977.58,3440.06,0.00
2024-12-10 17:37:04,64,3369,18,46,1978.15,3441.00,0.00
2024-12-10 17:37:04,65,3369,18,47,1947.72,3441.02,0.00
2024-12-10 17:37:04,65,3370,18,47,1935.57,3442.00,0.00
2024-12-10 17:37:04,66,3370,18,48,1906.25,3442.02,0.00
2024-12-10 17:37:04,65,3370,18,47,1931.35,3442.08,0.00
2024-12-10 17:37:04,64,3370,17,47,1922.55,3442.66,0.00
2024-12-10 17:37:04,64,3371,17,47,1964.77,3443.00,0.00
2024-12-10 17:37:04,65,3371,17,48,1934.55,3443.02,0.00
2024-12-10 17:37:04,65,3372,17,48,1922.39,3444.00,0.00
2024-12-10 17:37:04,66,3372,17,49,1893.26,3444.02,0.00
2024-12-10 17:37:04,65,3372,17,48,1917.63,3444.09,0.00
2024-12-10 17:37:04,64,3372,16,48,1925.86,3444.72,0.00
2024-12-10 17:37:04,64,3373,16,48,1970.22,3445.00,0.00
2024-12-10 17:37:04,65,3373,16,49,1939.91,3445.02,0.00
2024-12-10 17:37:04,64,3373,15,49,1963.76,3445.03,0.00
2024-12-10 17:37:04,64,3374,15,49,1974.02,3446.00,0.00
2024-12-10 17:37:04,65,3374,15,50,1943.65,3446.02,0.00
2024-12-10 17:37:04,64,3374,15,49,1970.26,3446.08,0.00
2024-12-10 17:37:04,64,3375,15,49,1971.36,3447.00,0.00
2024-12-10 17:37:04,65,3375,15,50,1941.04,3447.02,0.00
2024-12-10 17:37:04,65,3376,15,50,1928.87,3448.00,0.00
2024-12-10 17:37:04,66,3376,15,51,1899.64,3448.02,0.00
2024-12-10 17:37:04,65,3376,15,50,1924.63,3448.08,0.00
2024-12-10 17:37:04,64,3376,14,50,1917.26,3448.64,0.00
2024-12-10 17:37:04,64,3377,14,50,1959.04,3449.00,0.00
2024-12-10 17:37:04,65,3377,15,50,1928.90,3449.02,0.00
2024-12-10 17:37:04,64,3377,14,50,1911.32,3449.61,0.00
2024-12-10 17:37:04,64,3378,14,50,1952.06,3450.00,0.00
2024-12-10 17:37:04,65,3378,14,51,1922.03,3450.02,0.00
2024-12-10 17:37:04,64,3378,14,50,1947.21,3450.08,0.00
2024-12-10 17:37:04,65,3377,15,50,1901.54,3450.57,0.00
2024-12-10 17:37:04,65,3378,15,50,1936.92,3451.00,0.00
2024-12-10 17:37:04,66,3378,15,51,1907.57,3451.02,0.00
2024-12-10 17:37:04,65,3378,14,51,1897.34,3451.25,0.00
2024-12-10 17:37:04,65,3379,14,51,1978.02,3452.00,0.00
2024-12-10 17:37:04,66,3379,14,52,1948.05,3452.02,0.00
2024-12-10 17:37:04,65,3379,13,52,1973.07,3452.08,0.00
2024-12-10 17:37:04,64,3379,13,51,2000.66,3452.08,0.00
2024-12-10 17:37:04,64,3380,13,51,2023.17,3453.00,0.00
2024-12-10 17:37:04,65,3380,13,52,1992.05,3453.02,0.00
2024-12-10 17:37:04,65,3381,13,52,1978.04,3454.00,0.00
2024-12-10 17:37:04,66,3381,13,53,1948.06,3454.02,0.00
2024-12-10 17:37:04,65,3381,13,52,1973.26,3454.08,0.00
2024-12-10 17:37:04,64,3381,13,51,1989.39,3454.42,0.00
2024-12-10 17:37:04,63,3381,12,51,1993.67,3454.62,0.00
2024-12-10 17:37:04,63,3382,12,51,2035.66,3455.00,0.00
2024-12-10 17:37:04,64,3382,13,51,2003.85,3455.02,0.00
2024-12-10 17:37:04,63,3382,12,51,2033.52,3455.06,0.00
2024-12-10 17:37:04,62,3382,11,51,2016.98,3455.60,0.00
2024-12-10 17:37:04,62,3383,11,51,2059.11,3456.00,0.00
2024-12-10 17:37:04,63,3383,12,51,2026.42,3456.02,0.00
2024-12-10 17:37:04,62,3383,12,50,2055.21,3456.06,0.00
2024-12-10 17:37:04,62,3384,12,50,2056.91,3457.00,0.00
2024-12-10 17:37:04,63,3384,13,50,2024.26,3457.02,0.00
2024-12-10 17:37:04,63,3385,13,50,2012.77,3458.00,0.00
2024-12-10 17:37:04,64,3385,14,50,1981.33,3458.02,0.00
2024-12-10 17:37:04,63,3385,14,49,2009.48,3458.06,0.00
2024-12-10 17:37:04,63,3386,14,49,2010.61,3459.00,0.00
2024-12-10 17:37:04,64,3386,15,49,1979.20,3459.02,0.00
2024-12-10 17:37:04,64,3387,15,49,1983.13,3460.00,0.00
2024-12-10 17:37:04,65,3387,16,49,1952.62,3460.02,0.00
2024-12-10 17:37:04,64,3387,16,48,1982.58,3460.02,0.00
2024-12-10 17:37:04,63,3387,16,47,2013.50,3460.02,0.00
2024-12-10 17:37:04,63,3388,16,47,2013.95,3461.00,0.00
2024-12-10 17:37:04,64,3388,17,47,1982.48,3461.02,0.00
2024-12-10 17:37:04,64,3389,17,47,1970.61,3462.00,0.00
2024-12-10 17:37:04,65,3389,17,48,1940.29,3462.02,0.00
2024-12-10 17:37:04,64,3389,17,47,1967.91,3462.05,0.00
2024-12-10 17:37:04,64,3390,17,47,1967.93,3463.00,0.00
2024-12-10 17:37:04,65,3390,17,48,1937.66,3463.02,0.00
2024-12-10 17:37:05,64,3390,16,48,1967.39,3463.02,0.00
2024-12-10 17:37:05,64,3391,16,48,1957.60,3464.00,0.00
2024-12-10 17:37:05,65,3391,16,49,1927.48,3464.02,0.00
2024-12-10 17:37:05,64,3391,16,48,1948.94,3464.03,0.00
2024-12-10 17:37:05,63,3391,15,48,1937.05,3464.95,0.00
2024-12-10 17:37:05,63,3392,15,48,1990.42,3465.00,0.00
2024-12-10 17:37:05,64,3392,16,48,1959.32,3465.02,0.00
2024-12-10 17:37:05,63,3392,15,48,1956.90,3465.14,0.00
2024-12-10 17:37:05,63,3393,15,48,1982.75,3466.00,0.00
2024-12-10 17:37:05,64,3393,16,48,1951.77,3466.02,0.00
2024-12-10 17:37:05,63,3393,16,47,1981.65,3466.03,0.00
2024-12-10 17:37:05,63,3394,16,47,1981.67,3467.00,0.00
2024-12-10 17:37:05,64,3394,16,48,1950.70,3467.02,0.00
2024-12-10 17:37:05,64,3395,16,48,1938.80,3468.00,0.00
2024-12-10 17:37:05,65,3395,17,48,1908.97,3468.02,0.00
2024-12-10 17:37:05,64,3395,17,47,1937.72,3468.03,0.00
2024-12-10 17:37:05,63,3395,16,47,1943.31,3468.41,0.00
2024-12-10 17:37:05,63,3396,16,47,1978.40,3469.00,0.00
2024-12-10 17:37:05,64,3396,16,48,1947.49,3469.02,0.00
2024-12-10 17:37:05,63,3396,16,47,1966.29,3469.03,0.00
2024-12-10 17:37:05,63,3397,16,47,1966.31,3470.00,0.00
2024-12-10 17:37:05,64,3397,16,48,1935.58,3470.02,0.00
2024-12-10 17:37:05,65,3396,17,48,1871.97,3470.72,0.00
2024-12-10 17:37:05,65,3397,17,48,1904.75,3471.00,0.00
2024-12-10 17:37:05,66,3397,17,49,1875.89,3471.02,0.00
2024-12-10 17:37:05,65,3397,17,48,1903.69,3471.03,0.00
2024-12-10 17:37:05,64,3397,16,48,1899.70,3471.84,0.00
2024-12-10 17:37:05,64,3398,16,48,2002.88,3472.00,0.00
2024-12-10 17:37:05,65,3398,17,48,1972.07,3472.02,0.00
2024-12-10 17:37:05,64,3398,17,47,1990.95,3472.03,0.00
2024-12-10 17:37:05,64,3399,17,47,1990.44,3473.00,0.00
2024-12-10 17:37:05,65,3399,18,47,1959.82,3473.02,0.00
2024-12-10 17:37:05,65,3400,18,47,1947.55,3474.00,0.00
2024-12-10 17:37:05,66,3400,18,48,1918.04,3474.02,0.00
2024-12-10 17:37:05,65,3400,18,47,1945.95,3474.03,0.00
2024-12-10 17:37:05,65,3401,18,47,1944.91,3475.00,0.00
2024-12-10 17:37:05,66,3401,18,48,1915.44,3475.02,0.00
2024-12-10 17:37:05,67,3400,19,48,1886.85,3475.05,0.00
2024-12-10 17:37:05,68,3399,19,49,1888.81,3475.27,0.00
2024-12-10 17:37:05,68,3400,19,49,1906.66,3476.00,0.00
2024-12-10 17:37:05,69,3400,20,49,1879.03,3476.01,0.00
2024-12-10 17:37:05,69,3401,20,49,1982.45,3477.00,0.00
2024-12-10 17:37:05,70,3401,21,49,1954.12,3477.01,0.00
2024-12-10 17:37:05,69,3401,21,48,1971.37,3477.03,0.00
2024-12-10 17:37:05,68,3401,20,48,1977.68,3477.69,0.00
2024-12-10 17:37:05,68,3402,20,48,2012.60,3478.00,0.00
2024-12-10 17:37:05,69,3402,21,48,1983.43,3478.01,0.00
2024-12-10 17:37:05,68,3402,20,48,1979.18,3478.69,0.00
2024-12-10 17:37:05,68,3403,20,48,2009.95,3479.00,0.00
2024-12-10 17:37:05,69,3403,21,48,1980.82,3479.01,0.00
2024-12-10 17:37:05,69,3404,21,48,1969.88,3480.00,0.00
2024-12-10 17:37:05,70,3404,22,48,1941.74,3480.01,0.00
2024-12-10 17:37:05,69,3404,22,47,1961.82,3480.01,0.00
2024-12-10 17:37:05,69,3405,22,47,1958.34,3481.00,0.00
2024-12-10 17:37:05,70,3405,22,48,1930.37,3481.01,0.00
2024-12-10 17:37:05,69,3405,22,47,1949.26,3481.01,0.00
2024-12-10 17:37:05,70,3404,22,48,1869.72,3481.97,0.00
2024-12-10 17:37:05,70,3405,22,48,1936.79,3482.00,0.00
2024-12-10 17:37:05,71,3405,22,49,1909.51,3482.01,0.00
2024-12-10 17:37:05,70,3405,22,48,1927.84,3482.01,0.00
2024-12-10 17:37:05,69,3405,21,48,1921.40,3482.84,0.00
2024-12-10 17:37:05,69,3406,21,48,2016.91,3483.00,0.00
2024-12-10 17:37:05,70,3406,21,49,1988.10,3483.01,0.00
2024-12-10 17:37:05,69,3406,21,48,2007.83,3483.01,0.00
2024-12-10 17:37:05,68,3406,20,48,2009.04,3483.75,0.00
2024-12-10 17:37:05,68,3407,20,48,2051.77,3484.00,0.00
2024-12-10 17:37:05,69,3407,20,49,2022.04,3484.01,0.00
2024-12-10 17:37:05,68,3407,20,48,2042.55,3484.02,0.00
2024-12-10 17:37:05,68,3408,20,48,2039.55,3485.00,0.00
2024-12-10 17:37:05,69,3408,20,49,2009.99,3485.01,0.00
2024-12-10 17:37:05,68,3408,20,48,2030.33,3485.02,0.00
2024-12-10 17:37:05,67,3408,19,48,2049.26,3485.22,0.00
2024-12-10 17:37:05,67,3409,19,48,2074.75,3486.00,0.00
2024-12-10 17:37:05,68,3409,20,48,2044.24,3486.02,0.00
2024-12-10 17:37:05,67,3409,20,47,2064.86,3486.02,0.00
2024-12-10 17:37:05,67,3410,20,47,2062.33,3487.00,0.00
2024-12-10 17:37:05,68,3410,21,47,2032.00,3487.02,0.00
2024-12-10 17:37:05,67,3410,21,46,2050.88,3487.03,0.00
2024-12-10 17:37:05,67,3411,21,46,2048.87,3488.00,0.00
2024-12-10 17:37:05,68,3411,22,46,2018.74,3488.02,0.00
2024-12-10 17:37:05,67,3411,22,45,2037.42,3488.03,0.00
2024-12-10 17:37:05,67,3412,22,45,2035.39,3489.00,0.00
2024-12-10 17:37:05,68,3412,23,45,2005.46,3489.02,0.00
2024-12-10 17:37:05,68,3413,23,45,1992.18,3490.00,0.00
2024-12-10 17:37:05,69,3413,23,46,1963.31,3490.01,0.00
2024-12-10 17:37:05,68,3413,23,45,1990.64,3490.03,0.00
2024-12-10 17:37:05,67,3413,22,45,1979.74,3490.96,0.00
2024-12-10 17:37:05,67,3414,22,45,2030.31,3491.00,0.00
2024-12-10 17:37:05,68,3414,22,46,2000.45,3491.02,0.00
2024-12-10 17:37:05,68,3415,22,46,1987.16,3492.00,0.00
2024-12-10 17:37:05,69,3415,22,47,1958.36,3492.01,0.00
2024-12-10 17:37:05,68,3415,22,46,1986.13,3492.03,0.00
2024-12-10 17:37:05,68,3416,22,46,1983.62,3493.00,0.00
2024-12-10 17:37:05,69,3416,23,46,1954.87,3493.01,0.00
2024-12-10 17:37:05,68,3416,23,45,1972.32,3493.03,0.00
2024-12-10 17:37:05,68,3417,23,45,1969.80,3494.00,0.00
2024-12-10 17:37:05,69,3417,23,46,1941.25,3494.01,0.00
2024-12-10 17:37:05,69,3418,23,46,1942.72,3495.00,0.00
2024-12-10 17:37:05,70,3418,24,46,1914.96,3495.01,0.00
2024-12-10 17:37:05,70,3419,24,46,1912.86,3496.00,0.00
2024-12-10 17:37:05,71,3419,24,47,1885.91,3496.01,0.00
2024-12-10 17:37:06,71,3420,24,47,1876.59,3497.00,0.00
2024-12-10 17:37:06,72,3420,25,47,1850.53,3497.01,0.00
2024-12-10 17:37:06,71,3420,25,46,1866.74,3497.03,0.00
2024-12-10 17:37:06,70,3420,24,46,1887.96,3497.17,0.00
2024-12-10 17:37:06,71,3419,25,46,1847.26,3497.61,0.00
2024-12-10 17:37:06,71,3420,25,46,1876.14,3498.00,0.00
2024-12-10 17:37:06,72,3420,26,46,1850.08,3498.01,0.00
2024-12-10 17:37:06,71,3420,26,45,1866.29,3498.03,0.00
2024-12-10 17:37:06,71,3421,26,45,1911.67,3499.00,0.00
2024-12-10 17:37:06,72,3421,26,46,1885.12,3499.01,0.00
2024-12-10 17:37:06,71,3421,26,45,1901.32,3499.03,0.00
2024-12-10 17:37:06,70,3421,25,45,1924.52,3499.14,0.00
2024-12-10 17:37:06,69,3421,24,45,1946.79,3499.30,0.00
2024-12-10 17:37:06,69,3422,24,45,1953.33,3500.00,0.00
2024-12-10 17:37:06,70,3422,24,46,1925.43,3500.01,0.00
2024-12-10 17:37:06,69,3422,24,45,1942.17,3500.03,0.00
2024-12-10 17:37:06,69,3423,24,45,1939.17,3501.00,0.00
2024-12-10 17:37:06,70,3423,25,45,1911.47,3501.01,0.00
2024-12-10 17:37:06,69,3423,24,45,1903.70,3501.16,0.00
2024-12-10 17:37:06,68,3423,23,45,1923.17,3501.40,0.00
2024-12-10 17:37:06,68,3424,23,45,1953.97,3502.00,0.00
2024-12-10 17:37:06,69,3424,24,45,1925.65,3502.01,0.00
2024-12-10 17:37:06,68,3424,24,44,1952.42,3502.03,0.00
2024-12-10 17:37:06,68,3425,24,44,1949.89,3503.00,0.00
2024-12-10 17:37:06,69,3425,25,44,1921.63,3503.01,0.00
2024-12-10 17:37:06,68,3425,24,44,1909.08,3503.79,0.00
2024-12-10 17:37:06,68,3426,24,44,1953.54,3504.00,0.00
2024-12-10 17:37:06,69,3426,25,44,1925.22,3504.01,0.00
2024-12-10 17:37:06,68,3426,25,43,1951.99,3504.03,0.00
2024-12-10 17:37:06,68,3427,25,43,1949.45,3505.00,0.00
2024-12-10 17:37:06,69,3427,25,44,1921.20,3505.01,0.00
2024-12-10 17:37:06,69,3428,25,44,1907.52,3506.00,0.00
2024-12-10 17:37:06,70,3428,26,44,1880.27,3506.01,0.00
2024-12-10 17:37:06,71,3427,26,45,1853.79,3506.04,0.00
2024-12-10 17:37:06,70,3427,26,44,1928.37,3506.04,0.00
2024-12-10 17:37:06,69,3427,25,44,1926.53,3506.51,0.00
2024-12-10 17:37:06,69,3428,25,44,1960.42,3507.00,0.00
2024-12-10 17:37:06,70,3428,25,45,1932.41,3507.01,0.00
2024-12-10 17:37:06,69,3428,24,45,1932.99,3507.07,0.00
2024-12-10 17:37:06,69,3429,24,45,2002.67,3508.00,0.00
2024-12-10 17:37:06,70,3429,24,46,1974.06,3508.01,0.00
2024-12-10 17:37:06,69,3429,24,45,1999.12,3508.03,0.00
2024-12-10 17:37:06,68,3429,23,45,2015.20,3508.29,0.00
2024-12-10 17:37:06,68,3430,23,45,2042.50,3509.00,0.00
2024-12-10 17:37:06,69,3430,24,45,2012.90,3509.01,0.00
2024-12-10 17:37:06,69,3431,24,45,1999.23,3510.00,0.00
2024-12-10 17:37:06,70,3431,24,46,1970.67,3510.01,0.00
2024-12-10 17:37:06,69,3431,24,45,1996.19,3510.03,0.00
2024-12-10 17:37:06,69,3432,24,45,1993.18,3511.00,0.00
2024-12-10 17:37:06,70,3432,24,46,1964.71,3511.01,0.00
2024-12-10 17:37:06,70,3433,24,46,1950.72,3512.00,0.00
2024-12-10 17:37:06,71,3433,24,47,1923.24,3512.01,0.00
2024-12-10 17:37:06,70,3433,24,46,1948.22,3512.03,0.00
2024-12-10 17:37:06,69,3433,23,46,1941.26,3512.87,0.00
2024-12-10 17:37:06,69,3434,23,46,1987.70,3513.00,0.00
2024-12-10 17:37:06,70,3434,23,47,1959.30,3513.01,0.00
2024-12-10 17:37:06,70,3435,23,47,1945.30,3514.00,0.00
2024-12-10 17:37:06,71,3435,23,48,1917.91,3514.01,0.00
2024-12-10 17:37:06,70,3435,23,47,1942.31,3514.03,0.00
2024-12-10 17:37:06,70,3436,23,47,1938.83,3515.00,0.00
2024-12-10 17:37:06,71,3436,24,47,1911.52,3515.01,0.00
2024-12-10 17:37:06,72,3435,24,48,1859.28,3515.50,0.00
2024-12-10 17:37:06,72,3436,24,48,1887.46,3516.00,0.00
2024-12-10 17:37:06,73,3436,24,49,1861.61,3516.01,0.00
2024-12-10 17:37:06,72,3436,24,48,1885.03,3516.03,0.00
2024-12-10 17:37:06,72,3437,24,48,1929.52,3517.00,0.00
2024-12-10 17:37:06,73,3437,24,49,1903.09,3517.01,0.00
2024-12-10 17:37:06,72,3437,23,49,1879.50,3517.65,0.00
2024-12-10 17:37:06,71,3437,22,49,1904.01,3517.70,0.00
2024-12-10 17:37:06,71,3438,22,49,1943.38,3518.00,0.00
2024-12-10 17:37:06,72,3438,23,49,1916.39,3518.01,0.00
2024-12-10 17:37:06,71,3438,23,48,1940.91,3518.03,0.00
2024-12-10 17:37:06,70,3438,22,48,1951.34,3518.14,0.00
2024-12-10 17:37:06,69,3438,21,48,1977.09,3518.20,0.00
2024-12-10 17:37:06,68,3438,20,48,1988.32,3518.71,0.00
2024-12-10 17:37:06,68,3439,20,48,2029.96,3519.00,0.00
2024-12-10 17:37:06,69,3439,20,49,2000.54,3519.01,0.00
2024-12-10 17:37:06,69,3440,20,49,1986.83,3520.00,0.00
2024-12-10 17:37:06,70,3440,21,49,1958.44,3520.01,0.00
2024-12-10 17:37:06,69,3440,21,48,1984.80,3520.03,0.00
2024-12-10 17:37:06,69,3441,21,48,1981.78,3521.00,0.00
2024-12-10 17:37:06,70,3441,21,49,1953.47,3521.01,0.00
2024-12-10 17:37:06,69,3441,20,49,1939.14,3521.55,0.00
2024-12-10 17:37:06,69,3442,20,49,1974.68,3522.00,0.00
2024-12-10 17:37:06,70,3442,21,49,1946.47,3522.01,0.00
2024-12-10 17:37:06,69,3442,21,48,1973.16,3522.03,0.00
2024-12-10 17:37:06,68,3442,20,48,1978.14,3522.71,0.00
2024-12-10 17:37:06,68,3443,20,48,1999.11,3523.00,0.00
2024-12-10 17:37:06,69,3443,21,48,1970.14,3523.01,0.00
2024-12-10 17:37:06,69,3444,21,48,1956.40,3524.00,0.00
2024-12-10 17:37:06,70,3444,22,48,1928.45,3524.01,0.00
2024-12-10 17:37:06,69,3444,22,47,1955.39,3524.03,0.00
2024-12-10 17:37:06,69,3445,22,47,1952.35,3525.00,0.00
2024-12-10 17:37:06,70,3445,22,48,1924.46,3525.01,0.00
2024-12-10 17:37:06,69,3445,22,47,1941.13,3525.03,0.00
2024-12-10 17:37:06,68,3445,21,47,1949.71,3525.59,0.00
2024-12-10 17:37:06,67,3445,20,47,1955.18,3525.67,0.00
2024-12-10 17:37:06,67,3446,20,47,1996.48,3526.00,0.00
2024-12-10 17:37:06,68,3446,21,47,1967.12,3526.02,0.00
2024-12-10 17:37:06,67,3446,21,46,1984.92,3526.03,0.00
2024-12-10 17:37:06,66,3446,20,46,2009.69,3526.18,0.00
2024-12-10 17:37:06,65,3446,19,46,2040.07,3526.19,0.00
2024-12-10 17:37:06,65,3447,19,46,2066.09,3527.00,0.00
2024-12-10 17:37:06,66,3447,20,46,2034.79,3527.02,0.00
2024-12-10 17:37:06,65,3447,20,45,2054.17,3527.03,0.00
2024-12-10 17:37:06,65,3448,20,45,2053.11,3528.00,0.00
2024-12-10 17:37:06,66,3448,20,46,2022.00,3528.02,0.00
2024-12-10 17:37:06,65,3448,20,45,2041.18,3528.03,0.00
2024-12-10 17:37:06,64,3448,19,45,2064.81,3528.27,0.00
2024-12-10 17:37:07,64,3449,19,45,2072.46,3529.00,0.00
2024-12-10 17:37:07,65,3449,19,46,2040.58,3529.02,0.00
2024-12-10 17:37:07,65,3450,19,46,2028.13,3530.00,0.00
2024-12-10 17:37:07,66,3450,20,46,1997.40,3530.02,0.00
2024-12-10 17:37:07,65,3450,20,45,2027.05,3530.03,0.00
2024-12-10 17:37:07,65,3451,20,45,2025.98,3531.00,0.00
2024-12-10 17:37:07,66,3451,20,46,1995.29,3531.02,0.00
2024-12-10 17:37:07,65,3451,20,45,2014.04,3531.03,0.00
2024-12-10 17:37:07,65,3452,20,45,2012.97,3532.00,0.00
2024-12-10 17:37:07,66,3452,20,46,1982.47,3532.02,0.00
2024-12-10 17:37:07,65,3452,20,45,2001.03,3532.03,0.00
2024-12-10 17:37:07,64,3452,19,45,1993.91,3532.58,0.00
2024-12-10 17:37:07,64,3453,19,45,2034.52,3533.00,0.00
2024-12-10 17:37:07,65,3453,20,45,2003.21,3533.02,0.00
2024-12-10 17:37:07,65,3454,20,45,1990.73,3534.00,0.00
2024-12-10 17:37:07,66,3454,21,45,1960.57,3534.02,0.00
2024-12-10 17:37:07,65,3454,21,44,1989.12,3534.05,0.00
2024-12-10 17:37:07,65,3455,21,44,1988.58,3535.00,0.00
2024-12-10 17:37:07,66,3455,22,44,1958.45,3535.02,0.00
2024-12-10 17:37:07,66,3456,22,44,1945.79,3536.00,0.00
2024-12-10 17:37:07,67,3456,22,45,1916.75,3536.02,0.00
2024-12-10 17:37:07,66,3456,22,44,1940.98,3536.05,0.00
2024-12-10 17:37:07,65,3456,21,44,1948.67,3536.68,0.00
2024-12-10 17:37:07,65,3457,21,44,1991.88,3537.00,0.00
2024-12-10 17:37:07,66,3457,21,45,1961.70,3537.02,0.00
2024-12-10 17:37:07,65,3457,20,45,1953.97,3537.46,0.00
2024-12-10 17:37:07,65,3458,20,45,1989.72,3538.00,0.00
2024-12-10 17:37:07,66,3458,21,45,1959.57,3538.02,0.00
2024-12-10 17:37:07,65,3458,21,44,1985.38,3538.05,0.00
2024-12-10 17:37:07,64,3458,20,44,1992.97,3538.70,0.00
2024-12-10 17:37:07,64,3459,20,44,2015.85,3539.00,0.00
2024-12-10 17:37:07,65,3459,20,45,1984.84,3539.02,0.00
2024-12-10 17:37:07,66,3458,21,45,1926.56,3539.55,0.00
2024-12-10 17:37:07,65,3458,20,45,1966.14,3539.72,0.00
2024-12-10 17:37:07,65,3459,20,45,2011.00,3540.00,0.00
2024-12-10 17:37:07,66,3459,20,46,1980.53,3540.02,0.00
2024-12-10 17:37:07,65,3459,20,45,2007.20,3540.05,0.00
2024-12-10 17:37:07,64,3459,19,45,2032.54,3540.22,0.00
2024-12-10 17:37:07,64,3460,19,45,2093.90,3541.00,0.00
2024-12-10 17:37:07,65,3460,20,45,2061.68,3541.02,0.00
2024-12-10 17:37:07,64,3460,19,45,2053.35,3541.77,0.00
2024-12-10 17:37:07,64,3461,19,45,2100.58,3542.00,0.00
2024-12-10 17:37:07,65,3461,19,46,2068.26,3542.02,0.00
2024-12-10 17:37:07,64,3461,19,45,2096.16,3542.05,0.00
2024-12-10 17:37:07,63,3461,18,45,2106.16,3542.70,0.00
2024-12-10 17:37:07,63,3462,18,45,2129.46,3543.00,0.00
2024-12-10 17:37:07,64,3462,19,45,2096.19,3543.02,0.00
2024-12-10 17:37:07,64,3463,19,45,2084.04,3544.00,0.00
2024-12-10 17:37:07,65,3463,20,45,2051.98,3544.02,0.00
2024-12-10 17:37:07,64,3463,20,44,2077.96,3544.03,0.00
2024-12-10 17:37:07,64,3464,20,44,2077.43,3545.00,0.00
2024-12-10 17:37:07,65,3464,20,45,2045.47,3545.02,0.00
2024-12-10 17:37:07,64,3464,20,44,2074.12,3545.03,0.00
2024-12-10 17:37:07,64,3465,20,44,2073.58,3546.00,0.00
2024-12-10 17:37:07,65,3465,20,45,2041.68,3546.02,0.00
2024-12-10 17:37:07,64,3465,19,45,2058.38,3546.13,0.00
2024-12-10 17:37:07,63,3465,18,45,2066.64,3546.75,0.00
2024-12-10 17:37:07,63,3466,18,45,2114.12,3547.00,0.00
2024-12-10 17:37:07,64,3466,18,46,2081.09,3547.02,0.00
2024-12-10 17:37:07,63,3466,18,45,2109.64,3547.06,0.00
2024-12-10 17:37:07,63,3467,18,45,2110.78,3548.00,0.00
2024-12-10 17:37:07,64,3467,19,45,2077.80,3548.02,0.00
2024-12-10 17:37:07,63,3467,18,45,2058.37,3548.94,0.00
2024-12-10 17:37:07,63,3468,18,45,2112.50,3549.00,0.00
2024-12-10 17:37:07,64,3468,19,45,2079.49,3549.02,0.00
2024-12-10 17:37:07,63,3468,19,44,2107.45,3549.06,0.00
2024-12-10 17:37:07,63,3469,19,44,2108.59,3550.00,0.00
2024-12-10 17:37:07,64,3469,20,44,2075.64,3550.02,0.00
2024-12-10 17:37:07,64,3470,20,44,2063.46,3551.00,0.00
2024-12-10 17:37:07,65,3470,21,44,2031.72,3551.02,0.00
2024-12-10 17:37:07,64,3470,21,43,2059.04,3551.06,0.00
2024-12-10 17:37:07,64,3471,21,43,2059.60,3552.00,0.00
2024-12-10 17:37:07,65,3471,22,43,2027.92,3552.02,0.00
2024-12-10 17:37:07,65,3472,22,43,2015.37,3553.00,0.00
2024-12-10 17:37:07,66,3472,23,43,1984.83,3553.02,0.00
2024-12-10 17:37:07,65,3472,23,42,2012.11,3553.06,0.00
2024-12-10 17:37:07,65,3473,23,42,2012.11,3554.00,0.00
2024-12-10 17:37:07,66,3473,24,42,1981.62,3554.02,0.00
2024-12-10 17:37:07,66,3474,24,42,1968.72,3555.00,0.00
2024-12-10 17:37:07,67,3474,25,42,1939.33,3555.02,0.00
2024-12-10 17:37:07,66,3474,25,41,1961.75,3555.11,0.00
2024-12-10 17:37:07,65,3474,24,41,1954.12,3555.94,0.00
2024-12-10 17:37:07,65,3475,24,41,2006.68,3556.00,0.00
2024-12-10 17:37:07,66,3475,24,42,1976.27,3556.02,0.00
2024-12-10 17:37:07,65,3475,23,42,1993.02,3556.06,0.00
2024-12-10 17:37:07,65,3476,23,42,2003.96,3557.00,0.00
2024-12-10 17:37:07,66,3476,24,42,1973.60,3557.02,0.00
2024-12-10 17:37:07,65,3476,24,41,1976.62,3557.09,0.00
2024-12-10 17:37:07,65,3477,24,41,1999.59,3558.00,0.00
2024-12-10 17:37:07,66,3477,24,42,1969.30,3558.02,0.00
2024-12-10 17:37:07,65,3477,23,42,1963.27,3558.72,0.00
2024-12-10 17:37:07,65,3478,23,42,1986.47,3559.00,0.00
2024-12-10 17:37:07,66,3478,24,42,1956.37,3559.02,0.00
2024-12-10 17:37:07,65,3478,23,42,1961.30,3559.08,0.00
2024-12-10 17:37:07,65,3479,23,42,1983.74,3560.00,0.00
2024-12-10 17:37:07,66,3479,24,42,1953.68,3560.02,0.00
2024-12-10 17:37:07,65,3479,24,41,1973.34,3560.03,0.00
2024-12-10 17:37:07,65,3480,24,41,1972.25,3561.00,0.00
2024-12-10 17:37:07,66,3480,25,41,1942.36,3561.02,0.00
2024-12-10 17:37:07,65,3480,25,40,1969.52,3561.06,0.00
2024-12-10 17:37:07,64,3480,24,40,1976.16,3561.73,0.00
2024-12-10 17:37:07,64,3481,24,40,2000.28,3562.00,0.00
2024-12-10 17:37:07,65,3481,24,41,1969.51,3562.02,0.00
2024-12-10 17:37:07,64,3481,23,41,1981.42,3562.23,0.00
2024-12-10 17:37:08,64,3482,23,41,1988.04,3563.00,0.00
2024-12-10 17:37:08,65,3482,24,41,1957.46,3563.02,0.00
2024-12-10 17:37:08,64,3482,24,40,1985.82,3563.06,0.00
2024-12-10 17:37:08,64,3483,24,40,1986.37,3564.00,0.00
2024-12-10 17:37:08,65,3483,25,40,1955.81,3564.02,0.00
2024-12-10 17:37:08,64,3483,25,39,1973.02,3564.06,0.00
2024-12-10 17:37:08,64,3484,25,39,1973.56,3565.00,0.00
2024-12-10 17:37:08,65,3484,25,40,1943.20,3565.02,0.00
2024-12-10 17:37:08,64,3484,25,39,1960.20,3565.06,0.00
2024-12-10 17:37:08,64,3485,25,39,1960.74,3566.00,0.00
2024-12-10 17:37:08,65,3485,26,39,1930.58,3566.02,0.00
2024-12-10 17:37:08,64,3485,25,39,1946.26,3566.06,0.00
2024-12-10 17:37:08,64,3486,25,39,1957.95,3567.00,0.00
2024-12-10 17:37:08,65,3486,26,39,1927.83,3567.02,0.00
2024-12-10 17:37:08,64,3486,26,38,1954.05,3567.06,0.00
2024-12-10 17:37:08,64,3487,26,38,1954.59,3568.00,0.00
2024-12-10 17:37:08,65,3487,27,38,1924.52,3568.02,0.00
2024-12-10 17:37:08,65,3488,27,38,1911.89,3569.00,0.00
2024-12-10 17:37:08,66,3488,27,39,1882.92,3569.02,0.00
2024-12-10 17:37:08,65,3488,27,38,1908.60,3569.06,0.00
2024-12-10 17:37:08,65,3489,27,38,1908.58,3570.00,0.00
2024-12-10 17:37:08,66,3489,27,39,1879.66,3570.02,0.00
2024-12-10 17:37:08,65,3489,26,39,1907.48,3570.03,0.00
2024-12-10 17:37:08,65,3490,26,39,1895.38,3571.00,0.00
2024-12-10 17:37:08,66,3490,26,40,1866.66,3571.02,0.00
2024-12-10 17:37:08,65,3490,26,39,1893.18,3571.05,0.00
2024-12-10 17:37:08,64,3490,25,39,1899.09,3571.70,0.00
2024-12-10 17:37:08,63,3490,24,39,1910.15,3571.97,0.00
2024-12-10 17:37:08,63,3491,24,39,1965.73,3572.00,0.00
2024-12-10 17:37:08,64,3491,25,39,1935.02,3572.02,0.00
2024-12-10 17:37:08,64,3492,25,39,1922.72,3573.00,0.00
2024-12-10 17:37:08,65,3492,26,39,1893.14,3573.02,0.00
2024-12-10 17:37:08,64,3492,26,38,1920.49,3573.05,0.00
2024-12-10 17:37:08,63,3492,25,38,1928.03,3573.70,0.00
2024-12-10 17:37:08,63,3493,25,38,1951.52,3574.00,0.00
2024-12-10 17:37:08,64,3493,26,38,1921.02,3574.02,0.00
2024-12-10 17:37:08,63,3493,25,38,1914.96,3574.71,0.00
2024-12-10 17:37:08,63,3494,25,38,1939.01,3575.00,0.00
2024-12-10 17:37:08,64,3494,25,39,1908.71,3575.02,0.00
2024-12-10 17:37:08,63,3494,24,39,1937.88,3575.03,0.00
2024-12-10 17:37:08,62,3494,24,38,1967.98,3575.03,0.00
2024-12-10 17:37:08,62,3495,24,38,1968.53,3576.00,0.00
2024-12-10 17:37:08,63,3495,24,39,1937.28,3576.02,0.00
2024-12-10 17:37:08,63,3496,24,39,1925.24,3577.00,0.00
2024-12-10 17:37:08,64,3496,25,39,1895.15,3577.02,0.00
2024-12-10 17:37:08,63,3496,25,38,1922.97,3577.03,0.00
2024-12-10 17:37:08,62,3496,24,38,1910.33,3577.66,0.00
2024-12-10 17:37:08,62,3497,24,38,1956.17,3578.00,0.00
2024-12-10 17:37:08,63,3497,25,38,1925.12,3578.02,0.00
2024-12-10 17:37:08,63,3498,25,38,1913.16,3579.00,0.00
2024-12-10 17:37:08,64,3498,25,39,1883.27,3579.02,0.00
2024-12-10 17:37:08,63,3498,25,38,1911.46,3579.03,0.00
2024-12-10 17:37:08,63,3499,25,38,1911.42,3580.00,0.00
2024-12-10 17:37:08,64,3499,25,39,1881.55,3580.02,0.00
2024-12-10 17:37:08,63,3499,24,39,1862.80,3580.60,0.00
2024-12-10 17:37:08,63,3500,24,39,1905.70,3581.00,0.00
2024-12-10 17:37:08,64,3500,25,39,1875.93,3581.02,0.00
2024-12-10 17:37:08,63,3500,25,38,1902.30,3581.03,0.00
2024-12-10 17:37:08,63,3501,25,38,1902.25,3582.00,0.00
2024-12-10 17:37:08,64,3501,26,38,1872.53,3582.02,0.00
2024-12-10 17:37:08,64,3502,26,38,1873.44,3583.00,0.00
2024-12-10 17:37:08,65,3502,26,39,1844.62,3583.02,0.00
2024-12-10 17:37:08,65,3503,26,39,1836.74,3584.00,0.00
2024-12-10 17:37:08,66,3503,27,39,1808.91,3584.02,0.00
2024-12-10 17:37:08,65,3503,27,38,1826.82,3584.05,0.00
2024-12-10 17:37:08,65,3504,27,38,1826.22,3585.00,0.00
2024-12-10 17:37:08,66,3504,27,39,1798.55,3585.02,0.00
2024-12-10 17:37:08,65,3504,26,39,1799.76,3585.06,0.00
2024-12-10 17:37:08,65,3505,26,39,1821.77,3586.00,0.00
2024-12-10 17:37:08,66,3505,27,39,1794.17,3586.02,0.00
2024-12-10 17:37:08,65,3505,27,38,1819.02,3586.05,0.00
2024-12-10 17:37:08,64,3505,26,38,1839.10,3586.25,0.00
2024-12-10 17:37:08,64,3506,26,38,1868.68,3587.00,0.00
2024-12-10 17:37:08,65,3506,27,38,1839.94,3587.02,0.00
2024-12-10 17:37:08,65,3507,27,38,1827.20,3588.00,0.00
2024-12-10 17:37:08,66,3507,27,39,1799.52,3588.02,0.00
2024-12-10 17:37:08,65,3507,27,38,1824.45,3588.05,0.00
2024-12-10 17:37:08,65,3508,27,38,1823.84,3589.00,0.00
2024-12-10 17:37:08,66,3508,28,38,1796.21,3589.02,0.00
2024-12-10 17:37:08,65,3508,27,38,1787.44,3589.19,0.00
2024-12-10 17:37:08,65,3509,27,38,1813.86,3590.00,0.00
2024-12-10 17:37:08,66,3509,28,38,1786.38,3590.02,0.00
2024-12-10 17:37:08,65,3509,28,37,1811.65,3590.05,0.00
2024-12-10 17:37:08,65,3510,28,37,1811.05,3591.00,0.00
2024-12-10 17:37:08,66,3510,29,37,1783.61,3591.02,0.00
2024-12-10 17:37:08,66,3511,29,37,1770.50,3592.00,0.00
2024-12-10 17:37:08,67,3511,30,37,1744.07,3592.02,0.00
2024-12-10 17:37:08,66,3511,30,36,1768.87,3592.05,0.00
2024-12-10 17:37:08,65,3511,29,36,1772.06,3592.71,0.00
2024-12-10 17:37:08,65,3512,29,36,1817.03,3593.00,0.00
2024-12-10 17:37:08,66,3512,30,36,1789.50,3593.02,0.00
2024-12-10 17:37:08,65,3512,30,35,1804.32,3593.05,0.00
2024-12-10 17:37:08,64,3512,29,35,1825.27,3593.23,0.00
2024-12-10 17:37:08,63,3512,28,35,1829.28,3593.51,0.00
2024-12-10 17:37:08,63,3513,28,35,1868.96,3594.00,0.00
2024-12-10 17:37:08,64,3513,28,36,1839.76,3594.02,0.00
2024-12-10 17:37:08,63,3513,28,35,1855.85,3594.05,0.00
2024-12-10 17:37:08,62,3513,27,35,1878.87,3594.23,0.00
2024-12-10 17:37:08,61,3513,26,35,1894.00,3594.67,0.00
2024-12-10 17:37:08,61,3514,26,35,1917.81,3595.00,0.00
2024-12-10 17:37:08,62,3514,26,36,1886.88,3595.02,0.00
2024-12-10 17:37:08,61,3514,25,36,1859.16,3595.67,0.00
2024-12-10 17:37:08,62,3513,26,36,1824.62,3595.82,0.00
2024-12-10 17:37:09,62,3514,26,36,1882.76,3596.00,0.00
2024-12-10 17:37:09,63,3514,26,37,1852.88,3596.02,0.00
2024-12-10 17:37:09,62,3514,26,36,1880.45,3596.06,0.00
2024-12-10 17:37:09,62,3515,26,36,1940.14,3597.00,0.00
2024-12-10 17:37:09,63,3515,26,37,1909.35,3597.02,0.00
2024-12-10 17:37:09,62,3515,26,36,1926.23,3597.06,0.00
2024-12-10 17:37:09,62,3516,26,36,1927.92,3598.00,0.00
2024-12-10 17:37:09,63,3516,27,36,1897.31,3598.02,0.00
2024-12-10 17:37:09,63,3517,27,36,1885.27,3599.00,0.00
2024-12-10 17:37:09,64,3517,28,36,1855.82,3599.02,0.00
2024-12-10 17:37:09,63,3517,28,35,1882.99,3599.06,0.00
2024-12-10 17:37:09,62,3517,27,35,1892.16,3599.66,0.00
2024-12-10 17:37:09,63,3516,27,36,1857.64,3599.81,0.00
2024-12-10 17:37:09,63,3517,27,36,1914.37,3600.00,0.00
2024-12-10 17:37:09,64,3517,27,37,1884.46,3600.02,0.00
2024-12-10 17:37:09,64,3518,27,37,1928.31,3601.00,0.00
2024-12-10 17:37:09,65,3518,27,38,1898.64,3601.02,0.00
2024-12-10 17:37:09,64,3518,27,37,1926.06,3601.06,0.00
2024-12-10 17:37:09,63,3518,26,37,1924.81,3601.52,0.00
2024-12-10 17:37:09,63,3519,26,37,1965.17,3602.00,0.00
2024-12-10 17:37:09,64,3519,26,38,1934.47,3602.02,0.00
2024-12-10 17:37:09,64,3520,26,38,1922.21,3603.00,0.00
2024-12-10 17:37:09,65,3520,27,38,1892.64,3603.02,0.00
2024-12-10 17:37:09,64,3520,27,37,1918.27,3603.08,0.00
2024-12-10 17:37:09,64,3521,27,37,1919.36,3604.00,0.00
2024-12-10 17:37:09,65,3521,28,37,1889.83,3604.02,0.00
2024-12-10 17:37:09,65,3522,28,37,1878.24,3605.00,0.00
2024-12-10 17:37:09,66,3522,28,38,1849.79,3605.02,0.00
2024-12-10 17:37:09,65,3522,28,37,1873.81,3605.08,0.00
2024-12-10 17:37:09,65,3523,28,37,1874.33,3606.00,0.00
2024-12-10 17:37:09,66,3523,28,38,1845.93,3606.02,0.00
2024-12-10 17:37:09,65,3523,28,37,1873.77,3606.02,0.00
2024-12-10 17:37:09,64,3523,28,36,1902.49,3606.02,0.00
2024-12-10 17:37:09,64,3524,28,36,1891.67,3607.00,0.00
2024-12-10 17:37:09,65,3524,29,36,1862.56,3607.02,0.00
2024-12-10 17:37:09,64,3524,29,35,1888.85,3607.05,0.00
2024-12-10 17:37:09,63,3524,28,35,1898.39,3607.62,0.00
2024-12-10 17:37:09,63,3525,28,35,1919.27,3608.00,0.00
2024-12-10 17:37:09,64,3525,28,36,1889.29,3608.02,0.00
2024-12-10 17:37:09,63,3525,27,36,1885.60,3608.38,0.00
2024-12-10 17:37:09,63,3526,27,36,1920.95,3609.00,0.00
2024-12-10 17:37:09,64,3526,27,37,1890.94,3609.02,0.00
2024-12-10 17:37:09,63,3526,27,36,1918.09,3609.05,0.00
2024-12-10 17:37:09,63,3527,27,36,1918.62,3610.00,0.00
2024-12-10 17:37:09,64,3527,28,36,1888.64,3610.02,0.00
2024-12-10 17:37:09,63,3527,27,36,1899.19,3610.24,0.00
2024-12-10 17:37:09,62,3527,26,36,1915.48,3610.65,0.00
2024-12-10 17:37:09,62,3528,26,36,1961.17,3611.00,0.00
2024-12-10 17:37:09,63,3528,26,37,1930.04,3611.02,0.00
2024-12-10 17:37:09,62,3528,26,36,1958.84,3611.05,0.00
2024-12-10 17:37:09,61,3528,25,36,1972.94,3611.54,0.00
2024-12-10 17:37:09,61,3529,25,36,1992.22,3612.00,0.00
2024-12-10 17:37:09,62,3529,25,37,1960.09,3612.02,0.00
2024-12-10 17:37:09,61,3529,24,37,1939.75,3612.57,0.00
2024-12-10 17:37:09,61,3530,24,37,1983.89,3613.00,0.00
2024-12-10 17:37:09,62,3530,24,38,1951.89,3613.02,0.00
2024-12-10 17:37:09,61,3530,23,38,1927.47,3613.64,0.00
2024-12-10 17:37:09,61,3531,23,38,1973.95,3614.00,0.00
2024-12-10 17:37:09,62,3531,24,38,1942.11,3614.02,0.00
2024-12-10 17:37:09,61,3531,23,38,1939.84,3614.64,0.00
2024-12-10 17:37:09,60,3531,22,38,1963.29,3614.75,0.00
2024-12-10 17:37:09,60,3532,22,38,2014.72,3615.00,0.00
2024-12-10 17:37:09,61,3532,22,39,1981.69,3615.02,0.00
2024-12-10 17:37:09,60,3532,22,38,2014.31,3615.02,0.00
2024-12-10 17:37:09,59,3532,22,37,2044.78,3615.07,0.00
2024-12-10 17:37:09,59,3533,22,37,2048.40,3616.00,0.00
2024-12-10 17:37:09,60,3533,22,38,2014.26,3616.02,0.00
2024-12-10 17:37:09,59,3533,22,37,2046.57,3616.05,0.00
2024-12-10 17:37:09,58,3533,22,36,2079.36,3616.05,0.00
2024-12-10 17:37:09,57,3533,21,36,2104.12,3616.25,0.00
2024-12-10 17:37:09,57,3534,21,36,2140.81,3617.00,0.00
2024-12-10 17:37:09,58,3534,22,36,2103.90,3617.02,0.00
2024-12-10 17:37:09,58,3535,22,36,2093.88,3618.00,0.00
2024-12-10 17:37:09,59,3535,22,37,2058.39,3618.02,0.00
2024-12-10 17:37:09,58,3535,22,36,2090.14,3618.07,0.00
2024-12-10 17:37:09,58,3536,22,36,2094.46,3619.00,0.00
2024-12-10 17:37:09,59,3536,23,36,2058.96,3619.02,0.00
2024-12-10 17:37:09,58,3536,22,36,2069.56,3619.26,0.00
2024-12-10 17:37:09,58,3537,22,36,2105.65,3620.00,0.00
2024-12-10 17:37:09,59,3537,22,37,2069.96,3620.02,0.00
2024-12-10 17:37:09,58,3537,22,36,2101.90,3620.07,0.00
2024-12-10 17:37:09,58,3538,22,36,2106.23,3621.00,0.00
2024-12-10 17:37:09,59,3538,23,36,2070.53,3621.02,0.00
2024-12-10 17:37:09,58,3538,22,36,2089.37,3621.07,0.00
2024-12-10 17:37:09,58,3539,22,36,2106.18,3622.00,0.00
2024-12-10 17:37:09,59,3539,23,36,2070.49,3622.02,0.00
2024-12-10 17:37:09,58,3539,23,35,2101.82,3622.07,0.00
2024-12-10 17:37:09,58,3540,23,35,2106.14,3623.00,0.00
2024-12-10 17:37:09,59,3540,24,35,2070.44,3623.02,0.00
2024-12-10 17:37:09,58,3540,23,35,2104.46,3623.05,0.00
2024-12-10 17:37:09,58,3541,23,35,2095.67,3624.00,0.00
2024-12-10 17:37:09,59,3541,24,35,2060.15,3624.02,0.00
2024-12-10 17:37:09,58,3541,23,35,2095.05,3624.02,0.00
2024-12-10 17:37:09,57,3541,23,34,2129.26,3624.04,0.00
2024-12-10 17:37:09,57,3542,23,34,2133.03,3625.00,0.00
2024-12-10 17:37:09,58,3542,24,34,2096.25,3625.02,0.00
2024-12-10 17:37:09,58,3543,24,34,2086.20,3626.00,0.00
2024-12-10 17:37:09,59,3543,25,34,2050.84,3626.02,0.00
2024-12-10 17:37:09,58,3543,25,33,2084.33,3626.03,0.00
2024-12-10 17:37:09,58,3544,25,33,2087.40,3627.00,0.00
2024-12-10 17:37:09,59,3544,26,33,2052.02,3627.02,0.00
2024-12-10 17:37:09,58,3544,25,33,2053.64,3627.07,0.00
2024-12-10 17:37:09,57,3544,24,33,2087.15,3627.14,0.00
2024-12-10 17:37:09,56,3544,23,33,2105.30,3627.66,0.00
2024-12-10 17:37:09,56,3545,23,33,2158.01,3628.00,0.00
2024-12-10 17:37:09,57,3545,23,34,2120.15,3628.02,0.00
2024-12-10 17:37:09,56,3545,23,33,2150.89,3628.05,0.00
2024-12-10 17:37:10,56,3546,23,33,2156.01,3629.00,0.00
2024-12-10 17:37:10,57,3546,23,34,2118.19,3629.02,0.00
2024-12-10 17:37:10,56,3546,22,34,2137.87,3629.04,0.00
2024-12-10 17:37:10,56,3547,22,34,2155.31,3630.00,0.00
2024-12-10 17:37:10,57,3547,23,34,2117.50,3630.02,0.00
2024-12-10 17:37:10,56,3547,23,33,2148.83,3630.04,0.00
2024-12-10 17:37:10,55,3547,22,33,2166.78,3630.04,0.00
2024-12-10 17:37:10,55,3548,22,33,2198.40,3631.00,0.00
2024-12-10 17:37:10,56,3548,22,34,2159.15,3631.02,0.00
2024-12-10 17:37:10,56,3549,22,34,2150.01,3632.00,0.00
2024-12-10 17:37:10,57,3549,22,35,2112.29,3632.02,0.00
2024-12-10 17:37:10,56,3549,22,34,2142.23,3632.04,0.00
2024-12-10 17:37:10,55,3549,21,34,2168.69,3632.20,0.00
2024-12-10 17:37:10,55,3550,21,34,2206.22,3633.00,0.00
2024-12-10 17:37:10,56,3550,21,35,2166.82,3633.02,0.00
2024-12-10 17:37:10,56,3551,21,35,2157.69,3634.00,0.00
2024-12-10 17:37:10,57,3551,21,36,2119.83,3634.02,0.00
2024-12-10 17:37:10,56,3551,21,35,2149.25,3634.04,0.00
2024-12-10 17:37:10,55,3551,20,35,2159.01,3634.75,0.00
2024-12-10 17:37:10,55,3552,20,35,2216.03,3635.00,0.00
2024-12-10 17:37:10,56,3552,21,35,2176.46,3635.02,0.00
2024-12-10 17:37:10,55,3552,20,35,2215.37,3635.02,0.00
2024-12-10 17:37:10,55,3553,20,35,2207.20,3636.00,0.00
2024-12-10 17:37:10,56,3553,21,35,2167.79,3636.02,0.00
2024-12-10 17:37:10,55,3553,21,34,2197.95,3636.02,0.00
2024-12-10 17:37:10,55,3554,21,34,2202.52,3637.00,0.00
2024-12-10 17:37:10,56,3554,21,35,2163.19,3637.02,0.00
2024-12-10 17:37:10,55,3554,20,35,2186.01,3637.09,0.00
2024-12-10 17:37:10,56,3553,20,36,2144.41,3637.20,0.00
2024-12-10 17:37:10,56,3554,20,36,2178.72,3638.00,0.00
2024-12-10 17:37:10,57,3554,21,36,2140.50,3638.02,0.00
2024-12-10 17:37:10,56,3554,21,35,2170.28,3638.02,0.00
2024-12-10 17:37:10,56,3555,21,35,2239.11,3639.00,0.00
2024-12-10 17:37:10,57,3555,22,35,2199.82,3639.02,0.00
2024-12-10 17:37:10,56,3555,21,35,2181.19,3639.95,0.00
2024-12-10 17:37:10,56,3556,21,35,2244.27,3640.00,0.00
2024-12-10 17:37:10,57,3556,22,35,2204.90,3640.02,0.00
2024-12-10 17:37:10,56,3556,22,34,2236.47,3640.02,0.00
2024-12-10 17:37:10,56,3557,22,34,2240.34,3641.00,0.00
2024-12-10 17:37:10,57,3557,22,35,2201.03,3641.02,0.00
2024-12-10 17:37:10,58,3556,23,35,2146.80,3641.16,0.00
2024-12-10 17:37:10,57,3556,22,35,2169.86,3641.30,0.00
2024-12-10 17:37:10,57,3557,22,35,2208.67,3642.00,0.00
2024-12-10 17:37:10,58,3557,22,36,2170.59,3642.02,0.00
2024-12-10 17:37:10,57,3557,22,35,2199.72,3642.02,0.00
2024-12-10 17:37:10,57,3558,22,35,2266.79,3643.00,0.00
2024-12-10 17:37:10,58,3558,23,35,2227.71,3643.02,0.00
2024-12-10 17:37:10,57,3558,22,35,2230.70,3643.65,0.00
2024-12-10 17:37:10,57,3559,22,35,2256.55,3644.00,0.00
2024-12-10 17:37:10,58,3559,22,36,2217.64,3644.02,0.00
2024-12-10 17:37:10,57,3559,22,35,2248.24,3644.02,0.00
2024-12-10 17:37:10,57,3560,22,35,2251.41,3645.00,0.00
2024-12-10 17:37:10,58,3560,23,35,2212.60,3645.02,0.00
2024-12-10 17:37:10,57,3560,22,35,2198.60,3645.54,0.00
2024-12-10 17:37:10,57,3561,22,35,2246.27,3646.00,0.00
2024-12-10 17:37:10,58,3561,23,35,2207.54,3646.02,0.00
2024-12-10 17:37:10,57,3561,23,34,2237.32,3646.02,0.00
2024-12-10 17:37:10,56,3561,22,34,2255.46,3646.63,0.00
2024-12-10 17:37:10,56,3562,22,34,2281.15,3647.00,0.00
2024-12-10 17:37:10,57,3562,22,35,2241.13,3647.02,0.00
2024-12-10 17:37:10,57,3563,22,35,2231.51,3648.00,0.00
2024-12-10 17:37:10,58,3563,22,36,2193.03,3648.02,0.00
2024-12-10 17:37:10,57,3563,22,35,2223.19,3648.02,0.00
2024-12-10 17:37:10,57,3564,22,35,2226.36,3649.00,0.00
2024-12-10 17:37:10,58,3564,22,36,2187.97,3649.02,0.00
2024-12-10 17:37:10,58,3565,22,36,2184.17,3650.00,0.00
2024-12-10 17:37:10,59,3565,23,36,2147.15,3650.02,0.00
2024-12-10 17:37:10,58,3565,22,36,2156.53,3650.16,0.00
2024-12-10 17:37:10,57,3565,21,36,2176.06,3650.65,0.00
2024-12-10 17:37:10,57,3566,21,36,2227.58,3651.00,0.00
2024-12-10 17:37:10,58,3566,21,37,2189.17,3651.02,0.00
2024-12-10 17:37:10,57,3566,21,36,2224.37,3651.02,0.00
2024-12-10 17:37:10,56,3566,20,36,2261.69,3651.07,0.00
2024-12-10 17:37:10,56,3567,20,36,2267.50,3652.00,0.00
2024-12-10 17:37:10,57,3567,20,37,2227.72,3652.02,0.00
2024-12-10 17:37:10,57,3568,20,37,2218.26,3653.00,0.00
2024-12-10 17:37:10,58,3568,20,38,2180.01,3653.02,0.00
2024-12-10 17:37:10,57,3568,20,37,2181.09,3653.05,0.00
2024-12-10 17:37:10,57,3569,20,37,2210.71,3654.00,0.00
2024-12-10 17:37:10,58,3569,21,37,2172.60,3654.02,0.00
2024-12-10 17:37:10,58,3570,21,37,2164.76,3655.00,0.00
2024-12-10 17:37:10,59,3570,21,38,2128.06,3655.02,0.00
2024-12-10 17:37:10,58,3570,21,37,2149.02,3655.09,0.00
2024-12-10 17:37:10,58,3571,21,37,2151.20,3656.00,0.00
2024-12-10 17:37:10,59,3571,22,37,2114.74,3656.02,0.00
2024-12-10 17:37:10,59,3572,22,37,2105.12,3657.00,0.00
2024-12-10 17:37:10,60,3572,22,38,2070.04,3657.02,0.00
2024-12-10 17:37:10,59,3572,22,37,2090.26,3657.09,0.00
2024-12-10 17:37:10,58,3572,21,37,2114.09,3657.35,0.00
2024-12-10 17:37:10,57,3572,20,37,2113.00,3657.97,0.00
2024-12-10 17:37:10,57,3573,20,37,2175.91,3658.00,0.00
2024-12-10 17:37:10,58,3573,21,37,2138.40,3658.02,0.00
2024-12-10 17:37:10,57,3573,20,37,2125.45,3658.81,0.00
2024-12-10 17:37:10,57,3574,20,37,2182.74,3659.00,0.00
2024-12-10 17:37:10,58,3574,21,37,2145.11,3659.02,0.00
2024-12-10 17:37:10,57,3574,21,36,2167.99,3659.09,0.00
2024-12-10 17:37:10,57,3575,21,36,2173.71,3660.00,0.00
2024-12-10 17:37:10,58,3575,22,36,2136.23,3660.02,0.00
2024-12-10 17:37:11,58,3576,22,36,2130.26,3661.00,0.00
2024-12-10 17:37:11,59,3576,23,36,2094.15,3661.02,0.00
2024-12-10 17:37:11,58,3576,23,35,2115.75,3661.09,0.00
2024-12-10 17:37:11,58,3577,23,35,2120.74,3662.00,0.00
2024-12-10 17:37:11,59,3577,24,35,2084.79,3662.02,0.00
2024-12-10 17:37:11,58,3577,23,35,2119.93,3662.03,0.00
2024-12-10 17:37:11,58,3578,23,35,2114.75,3663.00,0.00
2024-12-10 17:37:11,59,3578,23,36,2078.91,3663.02,0.00
2024-12-10 17:37:11,58,3578,23,35,2101.50,3663.07,0.00
2024-12-10 17:37:11,57,3578,22,35,2136.45,3663.11,0.00
2024-12-10 17:37:11,57,3579,22,35,2142.80,3664.00,0.00
2024-12-10 17:37:11,58,3579,23,35,2105.85,3664.02,0.00
2024-12-10 17:37:11,58,3580,23,35,2099.06,3665.00,0.00
2024-12-10 17:37:11,59,3580,23,36,2063.48,3665.02,0.00
2024-12-10 17:37:11,58,3580,23,35,2086.44,3665.07,0.00
2024-12-10 17:37:11,57,3580,22,35,2075.77,3665.97,0.00
2024-12-10 17:37:11,57,3581,22,35,2138.82,3666.00,0.00
2024-12-10 17:37:11,58,3581,22,36,2101.94,3666.02,0.00
2024-12-10 17:37:11,57,3581,21,36,2105.07,3666.58,0.00
2024-12-10 17:37:11,57,3582,21,36,2131.87,3667.00,0.00
2024-12-10 17:37:11,58,3582,22,36,2095.11,3667.02,0.00
2024-12-10 17:37:11,57,3582,22,35,2119.66,3667.07,0.00
2024-12-10 17:37:11,57,3583,22,35,2124.73,3668.00,0.00
2024-12-10 17:37:11,58,3583,23,35,2088.09,3668.02,0.00
2024-12-10 17:37:11,58,3584,23,35,2081.72,3669.00,0.00
2024-12-10 17:37:11,59,3584,23,36,2046.44,3669.02,0.00
2024-12-10 17:37:11,58,3584,23,35,2068.45,3669.09,0.00
2024-12-10 17:37:11,58,3585,23,35,2073.43,3670.00,0.00
2024-12-10 17:37:11,59,3585,23,36,2038.28,3670.02,0.00
2024-12-10 17:37:11,58,3585,22,36,2018.01,3670.60,0.00
2024-12-10 17:37:11,58,3586,22,36,2067.03,3671.00,0.00
2024-12-10 17:37:11,59,3586,22,37,2032.00,3671.02,0.00
2024-12-10 17:37:11,58,3586,22,36,2054.39,3671.09,0.00
2024-12-10 17:37:11,57,3586,21,36,2089.15,3671.12,0.00
2024-12-10 17:37:11,56,3586,20,36,2087.18,3671.27,0.00
2024-12-10 17:37:11,55,3586,19,36,2083.99,3671.67,0.00
2024-12-10 17:37:11,55,3587,19,36,2138.98,3672.00,0.00
2024-12-10 17:37:11,56,3587,19,37,2100.78,3672.02,0.00
2024-12-10 17:37:11,55,3587,18,37,2110.35,3672.26,0.00
2024-12-10 17:37:11,55,3588,18,37,2150.24,3673.00,0.00
2024-12-10 17:37:11,56,3588,19,37,2111.85,3673.02,0.00
2024-12-10 17:37:11,55,3588,18,37,2106.99,3673.42,0.00
2024-12-10 17:37:11,55,3589,18,37,2152.83,3674.00,0.00
2024-12-10 17:37:11,56,3589,18,38,2114.39,3674.02,0.00
2024-12-10 17:37:11,55,3589,18,37,2138.82,3674.11,0.00
2024-12-10 17:37:11,55,3590,18,37,2146.74,3675.00,0.00
2024-12-10 17:37:11,56,3590,19,37,2108.40,3675.02,0.00
2024-12-10 17:37:11,55,3590,18,37,2124.70,3675.07,0.00
2024-12-10 17:37:11,55,3591,18,37,2144.65,3676.00,0.00
2024-12-10 17:37:11,56,3591,19,37,2106.35,3676.02,0.00
2024-12-10 17:37:11,55,3591,19,36,2129.96,3676.11,0.00
2024-12-10 17:37:11,55,3592,19,36,2137.88,3677.00,0.00
2024-12-10 17:37:11,56,3592,19,37,2099.70,3677.02,0.00
2024-12-10 17:37:11,55,3592,18,37,2112.52,3677.20,0.00
2024-12-10 17:37:11,55,3593,18,37,2150.50,3678.00,0.00
2024-12-10 17:37:11,56,3593,18,38,2112.10,3678.02,0.00
2024-12-10 17:37:11,55,3593,18,37,2131.14,3678.16,0.00
2024-12-10 17:37:11,55,3594,18,37,2141.05,3679.00,0.00
2024-12-10 17:37:11,56,3594,19,37,2102.81,3679.02,0.00
2024-12-10 17:37:11,56,3595,19,37,2099.65,3680.00,0.00
2024-12-10 17:37:11,57,3595,19,38,2062.82,3680.02,0.00
2024-12-10 17:37:11,56,3595,19,37,2080.63,3680.16,0.00
2024-12-10 17:37:11,55,3595,18,37,2090.91,3680.36,0.00
2024-12-10 17:37:11,55,3596,18,37,2134.85,3681.00,0.00
2024-12-10 17:37:11,56,3596,19,37,2096.73,3681.02,0.00
2024-12-10 17:37:11,56,3597,19,37,2089.82,3682.00,0.00
2024-12-10 17:37:11,57,3597,19,38,2053.16,3682.02,0.00
2024-12-10 17:37:11,56,3597,19,37,2078.65,3682.11,0.00
2024-12-10 17:37:11,55,3597,18,37,2071.42,3682.60,0.00
2024-12-10 17:37:11,55,3598,18,37,2123.96,3683.00,0.00
2024-12-10 17:37:11,56,3598,19,37,2086.03,3683.02,0.00
2024-12-10 17:37:11,55,3598,18,37,2115.28,3683.16,0.00
2024-12-10 17:37:11,54,3598,17,37,2126.68,3683.56,0.00
2024-12-10 17:37:11,54,3599,17,37,2178.87,3684.00,0.00
2024-12-10 17:37:11,55,3599,17,38,2139.25,3684.02,0.00
2024-12-10 17:37:11,54,3599,17,37,2170.00,3684.06,0.00
2024-12-10 17:37:11,55,3598,18,37,2114.67,3684.53,0.00
2024-12-10 17:37:11,55,3599,18,37,2157.93,3685.00,0.00
2024-12-10 17:37:11,56,3599,18,38,2119.39,3685.02,0.00
2024-12-10 17:37:11,55,3599,18,37,2157.26,3685.02,0.00
2024-12-10 17:37:11,55,3600,18,37,2228.88,3686.00,0.00
2024-12-10 17:37:11,56,3600,19,37,2189.08,3686.02,0.00
2024-12-10 17:37:11,56,3601,19,37,2179.80,3687.00,0.00
2024-12-10 17:37:11,57,3601,20,37,2141.55,3687.02,0.00
2024-12-10 17:37:11,57,3602,20,37,2131.78,3688.00,0.00
2024-12-10 17:37:11,58,3602,20,38,2095.03,3688.02,0.00
2024-12-10 17:37:11,57,3602,20,37,2130.49,3688.04,0.00
2024-12-10 17:37:11,56,3602,20,36,2162.61,3688.05,0.00
2024-12-10 17:37:11,56,3603,20,36,2167.80,3689.00,0.00
2024-12-10 17:37:11,57,3603,20,37,2129.77,3689.02,0.00
2024-12-10 17:37:11,56,3603,20,36,2161.22,3689.05,0.00
2024-12-10 17:37:11,56,3604,20,36,2166.41,3690.00,0.00
2024-12-10 17:37:11,57,3604,21,36,2128.41,3690.02,0.00
2024-12-10 17:37:11,56,3604,21,35,2151.93,3690.07,0.00
2024-12-10 17:37:11,55,3604,20,35,2174.40,3690.53,0.00
2024-12-10 17:37:11,55,3605,20,35,2197.56,3691.00,0.00
2024-12-10 17:37:11,56,3605,20,36,2158.32,3691.02,0.00
2024-12-10 17:37:11,55,3605,19,36,2196.89,3691.02,0.00
2024-12-10 17:37:11,55,3606,19,36,2193.20,3692.00,0.00
2024-12-10 17:37:11,56,3606,20,36,2154.04,3692.02,0.00
2024-12-10 17:37:11,55,3606,20,35,2176.44,3692.09,0.00
2024-12-10 17:37:11,54,3606,19,35,2204.05,3692.17,0.00
2024-12-10 17:37:11,54,3607,19,35,2242.21,3693.00,0.00
2024-12-10 17:37:11,55,3607,20,35,2201.44,3693.02,0.00
2024-12-10 17:37:11,54,3607,20,34,2229.21,3693.02,0.00
2024-12-10 17:37:11,54,3608,20,34,2234.60,3694.00,0.00
2024-12-10 17:37:11,55,3608,21,34,2193.97,3694.02,0.00
2024-12-10 17:37:12,55,3609,21,34,2186.42,3695.00,0.00
2024-12-10 17:37:12,56,3609,22,34,2147.37,3695.02,0.00
2024-12-10 17:37:12,55,3609,22,33,2175.67,3695.04,0.00
2024-12-10 17:37:12,55,3610,22,33,2180.96,3696.00,0.00
2024-12-10 17:37:12,56,3610,23,33,2142.01,3696.02,0.00
2024-12-10 17:37:12,55,3610,22,33,2121.12,3696.95,0.00
2024-12-10 17:37:12,55,3611,22,33,2186.35,3697.00,0.00
2024-12-10 17:37:12,56,3611,22,34,2147.30,3697.02,0.00
2024-12-10 17:37:12,55,3611,22,33,2175.60,3697.04,0.00
2024-12-10 17:37:12,55,3612,22,33,2180.89,3698.00,0.00
2024-12-10 17:37:12,56,3612,22,34,2141.94,3698.02,0.00
2024-12-10 17:37:12,56,3613,22,34,2134.68,3699.00,0.00
2024-12-10 17:37:12,57,3613,22,35,2097.23,3699.02,0.00
2024-12-10 17:37:12,56,3613,22,34,2124.11,3699.04,0.00
2024-12-10 17:37:12,56,3614,22,34,2128.65,3700.00,0.00
2024-12-10 17:37:12,57,3614,22,35,2091.30,3700.02,0.00
2024-12-10 17:37:12,56,3614,21,35,2090.57,3700.64,0.00
2024-12-10 17:37:12,56,3615,21,35,2143.68,3701.00,0.00
2024-12-10 17:37:12,57,3615,21,36,2106.07,3701.02,0.00
2024-12-10 17:37:12,56,3615,21,35,2133.77,3701.04,0.00
2024-12-10 17:37:12,55,3615,20,35,2132.44,3701.53,0.00
2024-12-10 17:37:12,55,3616,20,35,2182.57,3702.00,0.00
2024-12-10 17:37:12,56,3616,21,35,2143.60,3702.02,0.00
2024-12-10 17:37:12,56,3617,21,35,2136.86,3703.00,0.00
2024-12-10 17:37:12,57,3617,22,35,2099.37,3703.02,0.00
2024-12-10 17:37:12,56,3617,22,34,2126.28,3703.04,0.00
2024-12-10 17:37:12,56,3618,22,34,2130.82,3704.00,0.00
2024-12-10 17:37:12,57,3618,23,34,2093.44,3704.02,0.00
2024-12-10 17:37:12,56,3618,22,34,2070.70,3704.64,0.00
2024-12-10 17:37:12,56,3619,22,34,2123.88,3705.00,0.00
2024-12-10 17:37:12,57,3619,22,35,2086.62,3705.02,0.00
2024-12-10 17:37:12,56,3619,22,34,2114.62,3705.04,0.00
2024-12-10 17:37:12,55,3619,21,34,2129.17,3705.31,0.00
2024-12-10 17:37:12,55,3620,21,34,2171.41,3706.00,0.00
2024-12-10 17:37:12,56,3620,22,34,2132.64,3706.02,0.00
2024-12-10 17:37:12,55,3620,21,34,2153.91,3706.11,0.00
2024-12-10 17:37:12,54,3620,20,34,2172.83,3706.67,0.00
2024-12-10 17:37:12,54,3621,20,34,2229.38,3707.00,0.00
2024-12-10 17:37:12,55,3621,21,34,2188.85,3707.02,0.00
2024-12-10 17:37:12,54,3621,21,33,2218.40,3707.04,0.00
2024-12-10 17:37:12,54,3622,21,33,2224.49,3708.00,0.00
2024-12-10 17:37:12,55,3622,22,33,2184.04,3708.02,0.00
2024-12-10 17:37:12,54,3622,21,33,2223.38,3708.04,0.00
2024-12-10 17:37:12,54,3623,21,33,2216.69,3709.00,0.00
2024-12-10 17:37:12,55,3623,22,33,2176.39,3709.02,0.00
2024-12-10 17:37:12,54,3623,22,32,2206.39,3709.04,0.00
2024-12-10 17:37:12,53,3623,21,32,2200.74,3709.96,0.00
2024-12-10 17:37:12,53,3624,21,32,2269.35,3710.00,0.00
2024-12-10 17:37:12,54,3624,21,33,2227.33,3710.02,0.00
2024-12-10 17:37:12,54,3625,21,33,2219.18,3711.00,0.00
2024-12-10 17:37:12,55,3625,22,33,2178.83,3711.02,0.00
2024-12-10 17:37:12,54,3625,22,32,2208.87,3711.04,0.00
2024-12-10 17:37:12,53,3625,21,32,2217.64,3711.43,0.00
2024-12-10 17:37:12,53,3626,21,32,2267.08,3712.00,0.00
2024-12-10 17:37:12,54,3626,21,33,2225.09,3712.02,0.00
2024-12-10 17:37:12,54,3627,21,33,2217.88,3713.00,0.00
2024-12-10 17:37:12,55,3627,22,33,2177.55,3713.02,0.00
2024-12-10 17:37:12,54,3627,22,32,2206.88,3713.04,0.00
2024-12-10 17:37:12,53,3627,21,32,2222.49,3713.68,0.00
2024-12-10 17:37:12,53,3628,21,32,2280.91,3714.00,0.00
2024-12-10 17:37:12,54,3628,22,32,2238.67,3714.02,0.00
2024-12-10 17:37:12,54,3629,22,32,2231.04,3715.00,0.00
2024-12-10 17:37:12,55,3629,23,32,2190.48,3715.02,0.00
2024-12-10 17:37:12,54,3629,23,31,2220.73,3715.04,0.00
2024-12-10 17:37:12,54,3630,23,31,2226.83,3716.00,0.00
2024-12-10 17:37:12,55,3630,23,32,2186.34,3716.02,0.00
2024-12-10 17:37:12,56,3629,23,33,2104.61,3716.86,0.00
2024-12-10 17:37:12,56,3630,23,33,2145.16,3717.00,0.00
2024-12-10 17:37:12,57,3630,23,34,2107.53,3717.02,0.00
2024-12-10 17:37:12,56,3630,23,33,2135.87,3717.04,0.00
2024-12-10 17:37:12,56,3631,23,33,2206.82,3718.00,0.00
2024-12-10 17:37:12,57,3631,23,34,2168.10,3718.02,0.00
2024-12-10 17:37:12,56,3631,22,34,2152.26,3718.88,0.00
2024-12-10 17:37:12,56,3632,22,34,2214.11,3719.00,0.00
2024-12-10 17:37:12,57,3632,23,34,2175.27,3719.02,0.00
2024-12-10 17:37:12,56,3632,23,33,2204.82,3719.04,0.00
2024-12-10 17:37:12,55,3632,22,33,2214.51,3719.11,0.00
2024-12-10 17:37:12,55,3633,22,33,2249.56,3720.00,0.00
2024-12-10 17:37:12,56,3633,22,34,2209.39,3720.02,0.00
2024-12-10 17:37:12,55,3633,21,34,2232.01,3720.11,0.00
2024-12-10 17:37:12,55,3634,21,34,2267.08,3721.00,0.00
2024-12-10 17:37:12,56,3634,22,34,2226.60,3721.02,0.00
2024-12-10 17:37:12,55,3634,22,33,2258.29,3721.04,0.00
2024-12-10 17:37:12,55,3635,22,33,2263.63,3722.00,0.00
2024-12-10 17:37:12,56,3635,23,33,2223.21,3722.02,0.00
2024-12-10 17:37:12,56,3636,23,33,2228.58,3723.00,0.00
2024-12-10 17:37:12,57,3636,24,33,2189.48,3723.02,0.00
2024-12-10 17:37:12,57,3637,24,33,2184.73,3724.00,0.00
2024-12-10 17:37:12,58,3637,25,33,2147.06,3724.02,0.00
2024-12-10 17:37:12,57,3637,25,32,2170.36,3724.04,0.00
2024-12-10 17:37:12,57,3638,25,32,2174.21,3725.00,0.00
2024-12-10 17:37:12,58,3638,25,33,2136.72,3725.02,0.00
2024-12-10 17:37:12,58,3639,25,33,2127.13,3726.00,0.00
2024-12-10 17:37:12,59,3639,26,33,2091.07,3726.02,0.00
2024-12-10 17:37:12,58,3639,25,33,2126.48,3726.02,0.00
2024-12-10 17:37:12,57,3639,25,32,2157.25,3726.02,0.00
2024-12-10 17:37:12,57,3640,25,32,2160.45,3727.00,0.00
2024-12-10 17:37:12,58,3640,25,33,2123.20,3727.02,0.00
2024-12-10 17:37:12,57,3640,24,33,2135.61,3727.33,0.00
2024-12-10 17:37:12,57,3641,24,33,2151.56,3728.00,0.00
2024-12-10 17:37:12,58,3641,24,34,2114.46,3728.02,0.00
2024-12-10 17:37:12,57,3641,24,33,2145.02,3728.02,0.00
2024-12-10 17:37:12,57,3642,24,33,2148.21,3729.00,0.00
2024-12-10 17:37:12,58,3642,24,34,2111.17,3729.02,0.00
2024-12-10 17:37:12,57,3642,23,34,2131.26,3729.07,0.00
2024-12-10 17:37:13,57,3643,23,34,2162.57,3730.00,0.00
2024-12-10 17:37:13,58,3643,23,35,2125.29,3730.02,0.00
2024-12-10 17:37:13,57,3643,23,34,2153.41,3730.02,0.00
2024-12-10 17:37:13,56,3643,22,34,2150.82,3730.54,0.00
2024-12-10 17:37:13,56,3644,22,34,2200.45,3731.00,0.00
2024-12-10 17:37:13,57,3644,22,35,2161.84,3731.02,0.00
2024-12-10 17:37:13,56,3644,21,35,2140.36,3731.63,0.00
2024-12-10 17:37:13,56,3645,21,35,2193.28,3732.00,0.00
2024-12-10 17:37:13,57,3645,21,36,2154.80,3732.02,0.00
2024-12-10 17:37:13,56,3645,21,35,2183.95,3732.02,0.00
2024-12-10 17:37:13,55,3645,20,35,2180.78,3732.53,0.00
2024-12-10 17:37:13,55,3646,20,35,2231.36,3733.00,0.00
2024-12-10 17:37:13,56,3646,20,36,2191.51,3733.02,0.00
2024-12-10 17:37:13,55,3646,19,36,2192.67,3733.04,0.00
2024-12-10 17:37:13,55,3647,19,36,2225.17,3734.00,0.00
2024-12-10 17:37:13,56,3647,19,37,2185.43,3734.02,0.00
2024-12-10 17:37:13,56,3648,19,37,2178.78,3735.00,0.00
2024-12-10 17:37:13,57,3648,19,38,2140.56,3735.02,0.00
2024-12-10 17:37:13,56,3648,19,37,2168.11,3735.04,0.00
2024-12-10 17:37:13,55,3648,18,37,2162.84,3735.55,0.00
2024-12-10 17:37:13,55,3649,18,37,2214.13,3736.00,0.00
2024-12-10 17:37:13,56,3649,19,37,2174.59,3736.02,0.00
2024-12-10 17:37:13,55,3649,18,37,2197.17,3736.11,0.00
2024-12-10 17:37:13,54,3649,17,37,2231.66,3736.17,0.00
2024-12-10 17:37:13,54,3650,17,37,2270.27,3737.00,0.00
2024-12-10 17:37:13,55,3650,17,38,2228.99,3737.02,0.00
2024-12-10 17:37:13,54,3650,17,37,2259.89,3737.04,0.00
2024-12-10 17:37:13,54,3651,17,37,2266.03,3738.00,0.00
2024-12-10 17:37:13,55,3651,17,38,2224.83,3738.02,0.00
2024-12-10 17:37:13,55,3652,17,38,2216.86,3739.00,0.00
2024-12-10 17:37:13,56,3652,17,39,2177.27,3739.02,0.00
2024-12-10 17:37:13,55,3652,17,38,2211.42,3739.02,0.00
2024-12-10 17:37:13,54,3652,16,38,2217.69,3739.78,0.00
2024-12-10 17:37:13,54,3653,16,38,2278.81,3740.00,0.00
2024-12-10 17:37:13,55,3653,17,38,2237.38,3740.02,0.00
2024-12-10 17:37:13,54,3653,17,37,2270.50,3740.02,0.00
2024-12-10 17:37:13,53,3653,16,37,2266.35,3740.94,0.00
2024-12-10 17:37:13,53,3654,16,37,2334.85,3741.00,0.00
2024-12-10 17:37:13,54,3654,16,38,2291.62,3741.02,0.00
2024-12-10 17:37:13,54,3655,16,38,2283.22,3742.00,0.00
2024-12-10 17:37:13,55,3655,17,38,2241.71,3742.02,0.00
2024-12-10 17:37:13,54,3655,17,37,2275.60,3742.02,0.00
2024-12-10 17:37:13,53,3655,16,37,2278.47,3742.43,0.00
2024-12-10 17:37:13,53,3656,16,37,2328.33,3743.00,0.00
2024-12-10 17:37:13,54,3656,17,37,2285.22,3743.02,0.00
2024-12-10 17:37:13,53,3656,16,37,2294.53,3743.28,0.00
2024-12-10 17:37:13,53,3657,16,37,2338.84,3744.00,0.00
2024-12-10 17:37:13,54,3657,16,38,2295.53,3744.02,0.00
2024-12-10 17:37:13,53,3657,16,37,2331.07,3744.02,0.00
2024-12-10 17:37:13,53,3658,16,37,2337.35,3745.00,0.00
2024-12-10 17:37:13,54,3658,17,37,2294.07,3745.02,0.00
2024-12-10 17:37:13,54,3659,17,37,2285.66,3746.00,0.00
2024-12-10 17:37:13,55,3659,17,38,2244.10,3746.02,0.00
2024-12-10 17:37:13,54,3659,17,37,2277.34,3746.02,0.00
2024-12-10 17:37:13,54,3660,17,37,2282.80,3747.00,0.00
2024-12-10 17:37:13,55,3660,18,37,2241.30,3747.02,0.00
2024-12-10 17:37:13,55,3661,18,37,2232.35,3748.00,0.00
2024-12-10 17:37:13,56,3661,19,37,2192.49,3748.02,0.00
2024-12-10 17:37:13,55,3661,19,36,2224.86,3748.02,0.00
2024-12-10 17:37:13,54,3661,18,36,2263.31,3748.09,0.00
2024-12-10 17:37:13,54,3662,18,36,2271.52,3749.00,0.00
2024-12-10 17:37:13,55,3662,19,36,2230.22,3749.02,0.00
2024-12-10 17:37:13,55,3663,19,36,2221.27,3750.00,0.00
2024-12-10 17:37:13,56,3663,20,36,2181.61,3750.02,0.00
2024-12-10 17:37:13,55,3663,20,35,2213.77,3750.02,0.00
2024-12-10 17:37:13,54,3663,19,35,2235.00,3750.54,0.00
2024-12-10 17:37:13,54,3664,19,35,2259.65,3751.00,0.00
2024-12-10 17:37:13,55,3664,20,35,2218.57,3751.02,0.00
2024-12-10 17:37:13,55,3665,20,35,2209.61,3752.00,0.00
2024-12-10 17:37:13,56,3665,21,35,2170.15,3752.02,0.00
2024-12-10 17:37:13,55,3665,21,34,2202.11,3752.02,0.00
2024-12-10 17:37:13,55,3666,21,34,2206.79,3753.00,0.00
2024-12-10 17:37:13,56,3666,21,35,2167.38,3753.02,0.00
2024-12-10 17:37:13,55,3666,20,35,2164.50,3753.09,0.00
2024-12-10 17:37:13,55,3667,20,35,2199.18,3754.00,0.00
2024-12-10 17:37:13,56,3667,20,36,2159.91,3754.02,0.00
2024-12-10 17:37:13,56,3668,20,36,2150.72,3755.00,0.00
2024-12-10 17:37:13,57,3668,21,36,2112.99,3755.02,0.00
2024-12-10 17:37:13,56,3668,21,35,2142.68,3755.04,0.00
2024-12-10 17:37:13,55,3668,20,35,2145.35,3755.47,0.00
2024-12-10 17:37:13,55,3669,20,35,2194.21,3756.00,0.00
2024-12-10 17:37:13,56,3669,21,35,2155.03,3756.02,0.00
2024-12-10 17:37:13,56,3670,21,35,2146.78,3757.00,0.00
2024-12-10 17:37:13,57,3670,21,36,2109.12,3757.02,0.00
2024-12-10 17:37:13,56,3670,21,35,2138.06,3757.04,0.00
2024-12-10 17:37:13,56,3671,21,35,2142.65,3758.00,0.00
2024-12-10 17:37:13,57,3671,21,36,2105.06,3758.02,0.00
2024-12-10 17:37:13,57,3672,21,36,2097.25,3759.00,0.00
2024-12-10 17:37:13,58,3672,22,36,2061.09,3759.02,0.00
2024-12-10 17:37:13,57,3672,22,35,2087.36,3759.05,0.00
2024-12-10 17:37:13,56,3672,21,35,2085.94,3759.84,0.00
2024-12-10 17:37:13,56,3673,21,35,2147.15,3760.00,0.00
2024-12-10 17:37:13,57,3673,21,36,2109.48,3760.02,0.00
2024-12-10 17:37:13,56,3673,20,36,2114.33,3760.27,0.00
2024-12-10 17:37:13,56,3674,20,36,2154.44,3761.00,0.00
2024-12-10 17:37:13,57,3674,20,37,2116.64,3761.02,0.00
2024-12-10 17:37:13,56,3674,20,36,2140.35,3761.09,0.00
2024-12-10 17:37:13,56,3675,20,36,2146.95,3762.00,0.00
2024-12-10 17:37:13,57,3675,21,36,2109.28,3762.02,0.00
2024-12-10 17:37:13,57,3676,21,36,2103.55,3763.00,0.00
2024-12-10 17:37:13,58,3676,22,36,2067.28,3763.02,0.00
2024-12-10 17:37:13,57,3676,22,35,2090.36,3763.09,0.00
2024-12-10 17:37:13,57,3677,22,35,2096.18,3764.00,0.00
2024-12-10 17:37:13,58,3677,23,35,2060.04,3764.02,0.00
2024-12-10 17:37:13,57,3677,23,34,2095.52,3764.02,0.00
2024-12-10 17:37:13,56,3677,22,34,2114.83,3764.13,0.00
2024-12-10 17:37:13,55,3677,21,34,2133.73,3764.66,0.00
2024-12-10 17:37:14,55,3678,21,34,2166.55,3765.00,0.00
2024-12-10 17:37:14,56,3678,21,35,2127.86,3765.02,0.00
2024-12-10 17:37:14,55,3678,21,34,2154.24,3765.07,0.00
2024-12-10 17:37:14,54,3678,20,34,2171.45,3765.67,0.00
2024-12-10 17:37:14,54,3679,20,34,2200.98,3766.00,0.00
2024-12-10 17:37:14,55,3679,21,34,2160.96,3766.02,0.00
2024-12-10 17:37:14,56,3678,21,35,2105.58,3766.14,0.00
2024-12-10 17:37:14,55,3678,20,35,2139.18,3766.95,0.00
2024-12-10 17:37:14,55,3679,20,35,2205.65,3767.00,0.00
2024-12-10 17:37:14,56,3679,21,35,2166.26,3767.02,0.00
2024-12-10 17:37:14,55,3679,21,34,2194.02,3767.07,0.00
2024-12-10 17:37:14,55,3680,21,34,2269.26,3768.00,0.00
2024-12-10 17:37:14,56,3680,22,34,2228.74,3768.02,0.00
2024-12-10 17:37:14,55,3680,21,34,2209.95,3768.60,0.00
2024-12-10 17:37:14,55,3681,21,34,2263.70,3769.00,0.00
2024-12-10 17:37:14,56,3681,22,34,2223.27,3769.02,0.00
2024-12-10 17:37:14,55,3681,22,33,2249.31,3769.02,0.00
2024-12-10 17:37:14,56,3680,22,34,2154.35,3769.80,0.00
2024-12-10 17:37:14,56,3681,22,34,2221.84,3770.00,0.00
2024-12-10 17:37:14,57,3681,22,35,2182.86,3770.02,0.00
2024-12-10 17:37:14,56,3681,22,34,2212.43,3770.05,0.00
2024-12-10 17:37:14,56,3682,22,34,2285.06,3771.00,0.00
2024-12-10 17:37:14,57,3682,22,35,2244.97,3771.02,0.00
2024-12-10 17:37:14,57,3683,22,35,2255.80,3772.00,0.00
2024-12-10 17:37:14,58,3683,22,36,2216.90,3772.02,0.00
2024-12-10 17:37:14,58,3684,22,36,2224.31,3773.00,0.00
2024-12-10 17:37:14,59,3684,22,37,2186.61,3773.02,0.00
2024-12-10 17:37:14,59,3685,22,37,2186.63,3774.00,0.00
2024-12-10 17:37:14,60,3685,22,38,2150.18,3774.02,0.00
2024-12-10 17:37:14,59,3685,21,38,2160.43,3774.25,0.00
2024-12-10 17:37:14,58,3685,20,38,2183.67,3774.62,0.00
2024-12-10 17:37:14,58,3686,20,38,2234.73,3775.00,0.00
2024-12-10 17:37:14,59,3686,20,39,2196.86,3775.02,0.00
2024-12-10 17:37:14,58,3686,19,39,2218.46,3775.10,0.00
2024-12-10 17:37:14,57,3686,18,39,2256.71,3775.11,0.00
2024-12-10 17:37:14,56,3686,17,39,2290.98,3775.18,0.00
2024-12-10 17:37:14,56,3687,17,39,2327.95,3776.00,0.00
2024-12-10 17:37:14,57,3687,18,39,2287.10,3776.02,0.00
2024-12-10 17:37:14,56,3687,18,38,2315.82,3776.07,0.00
2024-12-10 17:37:14,55,3687,17,38,2314.93,3776.56,0.00
2024-12-10 17:37:14,55,3688,17,38,2367.47,3777.00,0.00
2024-12-10 17:37:14,56,3688,18,38,2325.19,3777.02,0.00
2024-12-10 17:37:14,55,3688,17,38,2355.79,3777.02,0.00
2024-12-10 17:37:14,55,3689,17,38,2374.28,3778.00,0.00
2024-12-10 17:37:14,56,3689,17,39,2331.88,3778.02,0.00
2024-12-10 17:37:14,55,3689,17,38,2362.60,3778.05,0.00
2024-12-10 17:37:14,55,3690,17,38,2368.72,3779.00,0.00
2024-12-10 17:37:14,56,3690,18,38,2326.42,3779.02,0.00
2024-12-10 17:37:14,55,3690,17,38,2307.85,3779.58,0.00
2024-12-10 17:37:14,55,3691,17,38,2361.10,3780.00,0.00
2024-12-10 17:37:14,56,3691,18,38,2318.94,3780.02,0.00
2024-12-10 17:37:14,55,3691,18,37,2348.05,3780.05,0.00
2024-12-10 17:37:14,55,3692,18,37,2354.16,3781.00,0.00
2024-12-10 17:37:14,56,3692,18,38,2312.12,3781.02,0.00
2024-12-10 17:37:14,55,3692,18,37,2349.35,3781.04,0.00
2024-12-10 17:37:14,55,3693,18,37,2354.78,3782.00,0.00
2024-12-10 17:37:14,56,3693,19,37,2312.73,3782.02,0.00
2024-12-10 17:37:14,56,3694,19,37,2303.21,3783.00,0.00
2024-12-10 17:37:14,57,3694,19,38,2262.81,3783.02,0.00
2024-12-10 17:37:14,56,3694,19,37,2293.08,3783.04,0.00
2024-12-10 17:37:14,56,3695,19,37,2297.74,3784.00,0.00
2024-12-10 17:37:14,57,3695,19,38,2257.43,3784.02,0.00
2024-12-10 17:37:14,57,3696,19,38,2247.40,3785.00,0.00
2024-12-10 17:37:14,58,3696,19,39,2208.65,3785.02,0.00
2024-12-10 17:37:14,57,3696,19,38,2238.11,3785.04,0.00
2024-12-10 17:37:14,56,3696,18,38,2250.71,3785.70,0.00
2024-12-10 17:37:14,56,3697,18,38,2307.07,3786.00,0.00
2024-12-10 17:37:14,57,3697,19,38,2266.59,3786.02,0.00
2024-12-10 17:37:14,57,3698,19,38,2256.56,3787.00,0.00
2024-12-10 17:37:14,58,3698,19,39,2217.66,3787.02,0.00
2024-12-10 17:37:14,57,3698,19,38,2247.93,3787.04,0.00
2024-12-10 17:37:14,57,3699,19,38,2251.84,3788.00,0.00
2024-12-10 17:37:14,58,3699,19,39,2213.02,3788.02,0.00
2024-12-10 17:37:14,57,3699,18,39,2203.51,3788.46,0.00
2024-12-10 17:37:14,57,3700,18,39,2249.78,3789.00,0.00
2024-12-10 17:37:14,58,3700,18,40,2210.99,3789.02,0.00
2024-12-10 17:37:14,57,3700,18,39,2241.14,3789.04,0.00
2024-12-10 17:37:14,56,3700,17,39,2258.83,3789.04,0.00
2024-12-10 17:37:14,56,3701,17,39,2290.56,3790.00,0.00
2024-12-10 17:37:14,57,3701,18,39,2250.37,3790.02,0.00
2024-12-10 17:37:14,58,3700,18,40,2181.71,3790.50,0.00
2024-12-10 17:37:14,58,3701,18,40,2222.30,3791.00,0.00
2024-12-10 17:37:14,59,3701,19,40,2184.64,3791.02,0.00
2024-12-10 17:37:14,58,3701,19,39,2211.85,3791.03,0.00
2024-12-10 17:37:14,58,3702,19,39,2280.42,3792.00,0.00
2024-12-10 17:37:14,59,3702,19,40,2241.77,3792.02,0.00
2024-12-10 17:37:14,59,3703,19,40,2232.57,3793.00,0.00
2024-12-10 17:37:14,60,3703,20,40,2195.36,3793.02,0.00
2024-12-10 17:37:14,59,3703,20,39,2222.29,3793.03,0.00
2024-12-10 17:37:14,58,3703,19,39,2212.91,3793.95,0.00
2024-12-10 17:37:14,58,3704,19,39,2276.39,3794.00,0.00
2024-12-10 17:37:14,59,3704,19,40,2237.81,3794.02,0.00
2024-12-10 17:37:14,59,3705,19,40,2228.48,3795.00,0.00
2024-12-10 17:37:14,60,3705,19,41,2191.34,3795.02,0.00
2024-12-10 17:37:14,59,3705,18,41,2227.84,3795.02,0.00
2024-12-10 17:37:14,58,3705,18,40,2257.09,3795.02,0.00
2024-12-10 17:37:14,58,3706,18,40,2259.65,3796.00,0.00
2024-12-10 17:37:14,59,3706,19,40,2221.35,3796.02,0.00
2024-12-10 17:37:14,58,3706,18,40,2212.71,3796.43,0.00
2024-12-10 17:37:14,58,3707,18,40,2256.97,3797.00,0.00
2024-12-10 17:37:14,59,3707,19,40,2218.71,3797.02,0.00
2024-12-10 17:37:14,58,3707,19,39,2248.46,3797.02,0.00
2024-12-10 17:37:14,58,3708,19,39,2251.01,3798.00,0.00
2024-12-10 17:37:14,59,3708,19,40,2212.86,3798.02,0.00
2024-12-10 17:37:15,59,3709,19,40,2202.67,3799.00,0.00
2024-12-10 17:37:15,60,3709,20,40,2165.96,3799.02,0.00
2024-12-10 17:37:15,59,3709,20,39,2194.95,3799.02,0.00
2024-12-10 17:37:15,59,3710,20,39,2196.81,3800.00,0.00
2024-12-10 17:37:15,60,3710,21,39,2160.20,3800.02,0.00
2024-12-10 17:37:15,60,3711,21,39,2149.91,3801.00,0.00
2024-12-10 17:37:15,61,3711,21,40,2114.66,3801.02,0.00
2024-12-10 17:37:15,60,3711,21,39,2142.94,3801.02,0.00
2024-12-10 17:37:15,59,3711,20,39,2155.39,3801.64,0.00
2024-12-10 17:37:15,59,3712,20,39,2180.78,3802.00,0.00
2024-12-10 17:37:15,60,3712,20,40,2144.44,3802.02,0.00
2024-12-10 17:37:15,60,3712,20,40,2133.67,3803.00,0.00
2024-12-10 17:37:15,61,3712,21,40,2098.69,3803.02,0.00
2024-12-10 17:37:15,60,3712,21,39,2127.33,3803.02,0.00
2024-12-10 17:37:15,60,3713,21,39,2128.52,3804.00,0.00
2024-12-10 17:37:15,61,3713,22,39,2093.63,3804.02,0.00
2024-12-10 17:37:15,62,3712,23,39,2039.06,3804.27,0.00
2024-12-10 17:37:15,61,3712,22,39,2067.86,3804.93,0.00
2024-12-10 17:37:15,61,3713,22,39,2127.79,3805.00,0.00
2024-12-10 17:37:15,62,3713,23,39,2093.47,3805.02,0.00
2024-12-10 17:37:15,61,3713,23,38,2122.17,3805.02,0.00
2024-12-10 17:37:15,61,3714,23,38,2185.12,3806.00,0.00
2024-12-10 17:37:15,62,3714,24,38,2149.88,3806.02,0.00
2024-12-10 17:37:15,62,3715,24,38,2137.82,3807.00,0.00
2024-12-10 17:37:15,63,3715,25,38,2103.88,3807.02,0.00
2024-12-10 17:37:15,62,3715,25,37,2132.90,3807.02,0.00
2024-12-10 17:37:15,62,3716,25,37,2132.85,3808.00,0.00
2024-12-10 17:37:15,63,3716,25,38,2099.00,3808.02,0.00
2024-12-10 17:37:15,62,3716,24,38,2115.69,3808.15,0.00
2024-12-10 17:37:15,61,3716,23,38,2149.75,3808.15,0.00
2024-12-10 17:37:15,61,3717,23,38,2155.70,3809.00,0.00
2024-12-10 17:37:15,62,3717,23,39,2120.93,3809.02,0.00
2024-12-10 17:37:15,61,3717,23,38,2151.33,3809.02,0.00
2024-12-10 17:37:15,60,3717,22,38,2139.68,3809.97,0.00
2024-12-10 17:37:15,60,3718,22,38,2201.93,3810.00,0.00
2024-12-10 17:37:15,61,3718,22,39,2165.83,3810.02,0.00
2024-12-10 17:37:15,61,3719,22,39,2153.90,3811.00,0.00
2024-12-10 17:37:15,62,3719,23,39,2119.16,3811.02,0.00
2024-12-10 17:37:15,61,3719,23,38,2149.53,3811.02,0.00
2024-12-10 17:37:15,60,3719,22,38,2151.90,3811.47,0.00
2024-12-10 17:37:15,60,3720,22,38,2195.46,3812.00,0.00
2024-12-10 17:37:15,61,3720,23,38,2159.47,3812.02,0.00
2024-12-10 17:37:15,61,3721,23,38,2147.53,3813.00,0.00
2024-12-10 17:37:15,62,3721,24,38,2112.90,3813.02,0.00
2024-12-10 17:37:15,61,3721,24,37,2143.78,3813.02,0.00
2024-12-10 17:37:15,61,3722,24,37,2144.34,3814.00,0.00
2024-12-10 17:37:15,62,3722,25,37,2109.76,3814.02,0.00
2024-12-10 17:37:15,62,3723,25,37,2097.39,3815.00,0.00
2024-12-10 17:37:15,63,3723,26,37,2064.10,3815.02,0.00
2024-12-10 17:37:15,62,3723,26,36,2094.31,3815.02,0.00
2024-12-10 17:37:15,62,3724,26,36,2094.25,3816.00,0.00
2024-12-10 17:37:15,63,3724,26,37,2061.00,3816.02,0.00
2024-12-10 17:37:15,62,3724,25,37,2047.67,3816.48,0.00
2024-12-10 17:37:15,61,3724,24,37,2074.73,3816.66,0.00
2024-12-10 17:37:15,61,3725,24,37,2124.39,3817.00,0.00
2024-12-10 17:37:15,62,3725,24,38,2090.13,3817.02,0.00
2024-12-10 17:37:15,61,3725,24,37,2120.64,3817.03,0.00
2024-12-10 17:37:15,60,3725,23,37,2154.43,3817.07,0.00
2024-12-10 17:37:15,60,3726,23,37,2157.53,3818.00,0.00
2024-12-10 17:37:15,61,3726,23,38,2122.16,3818.02,0.00
2024-12-10 17:37:15,61,3727,23,38,2110.19,3819.00,0.00
2024-12-10 17:37:15,62,3727,23,39,2076.16,3819.02,0.00
2024-12-10 17:37:15,61,3727,23,38,2105.81,3819.03,0.00
2024-12-10 17:37:15,60,3727,22,38,2137.13,3819.12,0.00
2024-12-10 17:37:15,59,3727,21,38,2152.73,3819.66,0.00
2024-12-10 17:37:15,59,3728,21,38,2178.88,3820.00,0.00
2024-12-10 17:37:15,60,3728,22,38,2142.57,3820.02,0.00
2024-12-10 17:37:15,59,3728,21,38,2124.10,3820.58,0.00
2024-12-10 17:37:15,59,3729,21,38,2172.98,3821.00,0.00
2024-12-10 17:37:15,60,3729,22,38,2136.76,3821.02,0.00
2024-12-10 17:37:15,59,3729,22,37,2168.45,3821.03,0.00
2024-12-10 17:37:15,60,3728,22,38,2132.30,3821.07,0.00
2024-12-10 17:37:15,59,3728,21,38,2189.48,3821.66,0.00
2024-12-10 17:37:15,59,3729,21,38,2215.65,3822.00,0.00
2024-12-10 17:37:15,60,3729,22,38,2178.72,3822.02,0.00
2024-12-10 17:37:15,60,3730,22,38,2251.30,3823.00,0.00
2024-12-10 17:37:15,61,3730,22,39,2214.39,3823.02,0.00
2024-12-10 17:37:15,60,3730,21,39,2213.39,3823.67,0.00
2024-12-10 17:37:15,60,3731,21,39,2257.34,3824.00,0.00
2024-12-10 17:37:15,61,3731,21,40,2220.33,3824.02,0.00
2024-12-10 17:37:15,61,3732,21,40,2220.89,3825.00,0.00
2024-12-10 17:37:15,62,3732,21,41,2185.06,3825.02,0.00
2024-12-10 17:37:15,62,3733,21,41,2175.96,3826.00,0.00
2024-12-10 17:37:15,63,3733,21,42,2141.42,3826.02,0.00
2024-12-10 17:37:15,62,3733,21,41,2165.47,3826.03,0.00
2024-12-10 17:37:15,61,3733,20,41,2197.34,3826.12,0.00
2024-12-10 17:37:15,60,3733,19,41,2182.91,3826.95,0.00
2024-12-10 17:37:15,60,3734,19,41,2244.81,3827.00,0.00
2024-12-10 17:37:15,61,3734,20,41,2208.01,3827.02,0.00
2024-12-10 17:37:15,60,3734,19,41,2227.64,3827.13,0.00
2024-12-10 17:37:15,60,3735,19,41,2251.46,3828.00,0.00
2024-12-10 17:37:15,61,3735,20,41,2214.55,3828.02,0.00
2024-12-10 17:37:15,61,3736,20,41,2214.73,3829.00,0.00
2024-12-10 17:37:15,62,3736,20,42,2179.01,3829.02,0.00
2024-12-10 17:37:15,61,3736,19,42,2195.95,3829.16,0.00
2024-12-10 17:37:15,61,3737,19,42,2204.99,3830.00,0.00
2024-12-10 17:37:15,62,3737,20,42,2169.42,3830.02,0.00
2024-12-10 17:37:15,61,3737,20,41,2194.94,3830.03,0.00
2024-12-10 17:37:16,61,3738,20,41,2196.14,3831.00,0.00
2024-12-10 17:37:16,62,3738,20,42,2160.72,3831.02,0.00
2024-12-10 17:37:16,61,3738,19,42,2166.45,3831.30,0.00
2024-12-10 17:37:16,61,3739,19,42,2202.73,3832.00,0.00
2024-12-10 17:37:16,62,3739,19,43,2167.20,3832.02,0.00
2024-12-10 17:37:16,61,3739,19,42,2190.79,3832.03,0.00
2024-12-10 17:37:16,61,3740,19,42,2191.99,3833.00,0.00
2024-12-10 17:37:16,62,3740,20,42,2156.64,3833.02,0.00
2024-12-10 17:37:16,61,3740,19,42,2191.99,3833.02,0.00
2024-12-10 17:37:16,60,3740,18,42,2204.32,3833.23,0.00
2024-12-10 17:37:16,60,3741,18,42,2239.32,3834.00,0.00
2024-12-10 17:37:16,61,3741,19,42,2202.61,3834.02,0.00
2024-12-10 17:37:16,60,3741,19,41,2236.13,3834.02,0.00
2024-12-10 17:37:16,60,3742,19,41,2237.35,3835.00,0.00
2024-12-10 17:37:16,61,3742,19,42,2200.67,3835.02,0.00
2024-12-10 17:37:16,61,3743,19,42,2200.56,3836.00,0.00
2024-12-10 17:37:16,62,3743,19,43,2165.07,3836.02,0.00
2024-12-10 17:37:16,62,3744,19,43,2154.56,3837.00,0.00
2024-12-10 17:37:16,63,3744,19,44,2120.36,3837.02,0.00
2024-12-10 17:37:16,62,3744,19,43,2145.90,3837.02,0.00
2024-12-10 17:37:16,61,3744,18,43,2119.96,3837.97,0.00
2024-12-10 17:37:16,61,3745,18,43,2181.63,3838.00,0.00
2024-12-10 17:37:16,62,3745,18,44,2146.45,3838.02,0.00
2024-12-10 17:37:16,62,3746,18,44,2134.00,3839.00,0.00
2024-12-10 17:37:16,63,3746,19,44,2100.13,3839.02,0.00
2024-12-10 17:37:16,62,3746,19,43,2132.14,3839.02,0.00
2024-12-10 17:37:16,61,3746,18,43,2122.92,3839.93,0.00
2024-12-10 17:37:16,61,3747,18,43,2183.40,3840.00,0.00
2024-12-10 17:37:16,62,3747,19,43,2148.18,3840.02,0.00
2024-12-10 17:37:16,61,3747,18,43,2151.93,3840.05,0.00
2024-12-10 17:37:16,61,3748,18,43,2178.93,3841.00,0.00
2024-12-10 17:37:16,62,3748,18,44,2143.79,3841.02,0.00
2024-12-10 17:37:16,61,3748,18,43,2175.78,3841.02,0.00
2024-12-10 17:37:16,62,3747,18,44,2131.48,3841.29,0.00
2024-12-10 17:37:16,62,3748,18,44,2174.09,3842.00,0.00
2024-12-10 17:37:16,63,3748,19,44,2139.58,3842.02,0.00
2024-12-10 17:37:16,62,3748,18,44,2126.62,3842.44,0.00
2024-12-10 17:37:16,62,3749,18,44,2229.28,3843.00,0.00
2024-12-10 17:37:16,63,3749,19,44,2193.90,3843.02,0.00
2024-12-10 17:37:16,62,3749,19,43,2226.81,3843.02,0.00
2024-12-10 17:37:16,62,3750,19,43,2226.76,3844.00,0.00
2024-12-10 17:37:16,63,3750,20,43,2191.42,3844.02,0.00
2024-12-10 17:37:16,62,3750,19,43,2186.61,3844.40,0.00
2024-12-10 17:37:16,62,3751,19,43,2226.10,3845.00,0.00
2024-12-10 17:37:16,63,3751,19,44,2190.77,3845.02,0.00
2024-12-10 17:37:16,62,3751,19,43,2221.77,3845.03,0.00
2024-12-10 17:37:16,62,3752,19,43,2222.34,3846.00,0.00
2024-12-10 17:37:16,63,3752,19,44,2187.07,3846.02,0.00
2024-12-10 17:37:16,63,3753,19,44,2174.20,3847.00,0.00
2024-12-10 17:37:16,64,3753,20,44,2140.23,3847.02,0.00
2024-12-10 17:37:16,63,3753,20,43,2170.54,3847.03,0.00
2024-12-10 17:37:16,62,3753,19,43,2200.01,3847.18,0.00
2024-12-10 17:37:16,62,3754,19,43,2206.12,3848.00,0.00
2024-12-10 17:37:16,63,3754,20,43,2171.10,3848.02,0.00
2024-12-10 17:37:16,63,3755,20,43,2158.22,3849.00,0.00
2024-12-10 17:37:16,64,3755,21,43,2124.50,3849.02,0.00
2024-12-10 17:37:16,63,3755,21,42,2155.17,3849.03,0.00
2024-12-10 17:37:16,63,3756,21,42,2155.12,3850.00,0.00
2024-12-10 17:37:16,64,3756,21,43,2121.44,3850.02,0.00
2024-12-10 17:37:16,63,3756,20,43,2115.37,3850.68,0.00
2024-12-10 17:37:16,63,3757,20,43,2164.51,3851.00,0.00
2024-12-10 17:37:16,64,3757,20,44,2130.69,3851.02,0.00
2024-12-10 17:37:16,63,3757,20,43,2162.06,3851.03,0.00
2024-12-10 17:37:16,63,3758,20,43,2162.01,3852.00,0.00
2024-12-10 17:37:16,64,3758,20,44,2128.23,3852.02,0.00
2024-12-10 17:37:16,64,3759,20,44,2114.93,3853.00,0.00
2024-12-10 17:37:16,65,3759,21,44,2082.40,3853.02,0.00
2024-12-10 17:37:16,64,3759,21,43,2113.13,3853.03,0.00
2024-12-10 17:37:16,63,3759,20,43,2099.27,3853.67,0.00
2024-12-10 17:37:16,63,3760,20,43,2147.84,3854.00,0.00
2024-12-10 17:37:16,64,3760,20,44,2114.28,3854.02,0.00
2024-12-10 17:37:16,64,3761,20,44,2100.97,3855.00,0.00
2024-12-10 17:37:16,65,3761,21,44,2068.65,3855.02,0.00
2024-12-10 17:37:16,64,3761,21,43,2099.77,3855.03,0.00
2024-12-10 17:37:16,63,3761,20,43,2107.53,3855.40,0.00
2024-12-10 17:37:16,63,3762,20,43,2145.89,3856.00,0.00
2024-12-10 17:37:16,64,3762,20,44,2112.36,3856.02,0.00
2024-12-10 17:37:16,64,3763,20,44,2099.05,3857.00,0.00
2024-12-10 17:37:16,65,3763,20,45,2066.76,3857.02,0.00
2024-12-10 17:37:16,64,3763,20,44,2097.24,3857.03,0.00
2024-12-10 17:37:16,63,3763,19,44,2123.86,3857.21,0.00
2024-12-10 17:37:16,63,3764,19,44,2130.47,3858.00,0.00
2024-12-10 17:37:16,64,3764,20,44,2097.18,3858.02,0.00
2024-12-10 17:37:16,63,3764,19,44,2085.52,3858.78,0.00
2024-12-10 17:37:16,63,3765,19,44,2138.38,3859.00,0.00
2024-12-10 17:37:16,64,3765,20,44,2104.96,3859.02,0.00
2024-12-10 17:37:16,63,3765,20,43,2135.93,3859.03,0.00
2024-12-10 17:37:16,62,3765,19,43,2144.56,3859.69,0.00
2024-12-10 17:37:16,62,3766,19,43,2170.32,3860.00,0.00
2024-12-10 17:37:16,63,3766,20,43,2135.87,3860.02,0.00
2024-12-10 17:37:16,63,3767,20,43,2122.94,3861.00,0.00
2024-12-10 17:37:16,64,3767,20,44,2089.77,3861.02,0.00
2024-12-10 17:37:16,63,3767,20,43,2117.42,3861.02,0.00
2024-12-10 17:37:16,63,3768,20,43,2116.74,3862.00,0.00
2024-12-10 17:37:16,64,3768,20,44,2083.67,3862.02,0.00
2024-12-10 17:37:16,63,3768,20,43,2115.52,3862.02,0.00
2024-12-10 17:37:16,63,3769,20,43,2114.84,3863.00,0.00
2024-12-10 17:37:16,64,3769,20,44,2081.79,3863.02,0.00
2024-12-10 17:37:16,64,3770,20,44,2068.45,3864.00,0.00
2024-12-10 17:37:16,65,3770,20,45,2036.62,3864.02,0.00
2024-12-10 17:37:16,64,3770,20,44,2067.84,3864.02,0.00
2024-12-10 17:37:16,63,3770,19,44,2069.12,3864.76,0.00
2024-12-10 17:37:16,63,3771,19,44,2121.45,3865.00,0.00
2024-12-10 17:37:16,64,3771,20,44,2088.31,3865.02,0.00
2024-12-10 17:37:16,63,3771,20,43,2108.57,3865.02,0.00
2024-12-10 17:37:17,62,3771,19,43,2118.40,3865.39,0.00
2024-12-10 17:37:17,62,3772,19,43,2157.48,3866.00,0.00
2024-12-10 17:37:17,63,3772,19,44,2123.23,3866.02,0.00
2024-12-10 17:37:17,62,3772,18,44,2130.74,3866.27,0.00
2024-12-10 17:37:17,63,3771,18,45,2092.68,3866.41,0.00
2024-12-10 17:37:17,63,3772,18,45,2158.77,3867.00,0.00
2024-12-10 17:37:17,64,3772,18,46,2125.04,3867.02,0.00
2024-12-10 17:37:17,63,3772,18,45,2158.15,3867.02,0.00
2024-12-10 17:37:17,62,3772,17,45,2186.16,3867.18,0.00
2024-12-10 17:37:17,62,3773,17,45,2254.67,3868.00,0.00
2024-12-10 17:37:17,63,3773,17,46,2218.88,3868.02,0.00
2024-12-10 17:37:17,63,3774,17,46,2222.85,3869.00,0.00
2024-12-10 17:37:17,64,3774,18,46,2188.12,3869.02,0.00
2024-12-10 17:37:17,65,3773,18,47,2097.40,3869.88,0.00
2024-12-10 17:37:17,65,3774,18,47,2156.46,3870.00,0.00
2024-12-10 17:37:17,66,3774,19,47,2123.79,3870.02,0.00
2024-12-10 17:37:17,65,3774,18,47,2106.27,3870.80,0.00
2024-12-10 17:37:17,65,3775,18,47,2217.78,3871.00,0.00
2024-12-10 17:37:17,66,3775,19,47,2184.18,3871.02,0.00
2024-12-10 17:37:17,65,3775,19,46,2211.23,3871.02,0.00
2024-12-10 17:37:17,65,3776,19,46,2209.42,3872.00,0.00
2024-12-10 17:37:17,66,3776,20,46,2175.95,3872.02,0.00
2024-12-10 17:37:17,65,3776,20,45,2198.70,3872.02,0.00
2024-12-10 17:37:17,64,3776,19,45,2226.45,3872.19,0.00
2024-12-10 17:37:17,64,3777,19,45,2231.82,3873.00,0.00
2024-12-10 17:37:17,65,3777,20,45,2197.48,3873.02,0.00
2024-12-10 17:37:17,64,3777,20,44,2220.92,3873.02,0.00
2024-12-10 17:37:17,63,3777,19,44,2220.72,3873.49,0.00
2024-12-10 17:37:17,63,3778,19,44,2262.91,3874.00,0.00
2024-12-10 17:37:17,64,3778,19,45,2227.55,3874.02,0.00
2024-12-10 17:37:17,63,3778,19,44,2251.22,3874.02,0.00
2024-12-10 17:37:17,62,3778,18,44,2273.24,3874.26,0.00
2024-12-10 17:37:17,62,3779,18,44,2307.50,3875.00,0.00
2024-12-10 17:37:17,63,3779,18,45,2270.87,3875.02,0.00
2024-12-10 17:37:17,62,3779,18,44,2295.00,3875.02,0.00
2024-12-10 17:37:17,62,3780,18,44,2294.97,3876.00,0.00
2024-12-10 17:37:17,63,3780,19,44,2258.54,3876.02,0.00
2024-12-10 17:37:17,62,3780,19,43,2282.46,3876.02,0.00
2024-12-10 17:37:17,61,3780,18,43,2270.00,3876.66,0.00
2024-12-10 17:37:17,61,3781,18,43,2320.48,3877.00,0.00
2024-12-10 17:37:17,62,3781,19,43,2283.05,3877.02,0.00
2024-12-10 17:37:17,61,3781,18,43,2279.20,3877.13,0.00
2024-12-10 17:37:17,61,3781,18,43,2309.63,3878.00,0.00
2024-12-10 17:37:17,62,3781,18,44,2272.38,3878.02,0.00
2024-12-10 17:37:17,61,3781,18,43,2309.00,3878.02,0.00
2024-12-10 17:37:17,61,3782,18,43,2309.59,3879.00,0.00
2024-12-10 17:37:17,62,3782,18,44,2272.34,3879.02,0.00
2024-12-10 17:37:17,61,3782,17,44,2263.36,3879.46,0.00
2024-12-10 17:37:17,61,3783,17,44,2306.37,3880.00,0.00
2024-12-10 17:37:17,62,3783,18,44,2269.17,3880.02,0.00
2024-12-10 17:37:17,61,3783,18,43,2305.10,3880.02,0.00
2024-12-10 17:37:17,60,3783,17,43,2318.61,3880.65,0.00
2024-12-10 17:37:17,60,3784,17,43,2344.12,3881.00,0.00
2024-12-10 17:37:17,61,3784,17,44,2305.69,3881.02,0.00
2024-12-10 17:37:17,60,3784,16,44,2284.52,3881.95,0.00
2024-12-10 17:37:17,60,3785,16,44,2347.31,3882.00,0.00
2024-12-10 17:37:17,61,3785,17,44,2308.83,3882.02,0.00
2024-12-10 17:37:17,60,3785,17,43,2346.67,3882.02,0.00
2024-12-10 17:37:17,59,3785,16,43,2361.46,3882.09,0.00
2024-12-10 17:37:17,59,3786,16,43,2392.32,3883.00,0.00
2024-12-10 17:37:17,60,3786,17,43,2352.45,3883.02,0.00
2024-12-10 17:37:17,60,3787,17,43,2340.76,3884.00,0.00
2024-12-10 17:37:17,61,3787,17,44,2302.38,3884.02,0.00
2024-12-10 17:37:17,60,3787,17,43,2334.29,3884.07,0.00
2024-12-10 17:37:17,60,3788,17,43,2337.47,3885.00,0.00
2024-12-10 17:37:17,61,3788,18,43,2299.16,3885.02,0.00
2024-12-10 17:37:17,62,3787,19,43,2219.88,3885.82,0.00
2024-12-10 17:37:17,62,3788,19,43,2259.23,3886.00,0.00
2024-12-10 17:37:17,63,3788,19,44,2223.37,3886.02,0.00
2024-12-10 17:37:17,62,3788,19,43,2247.97,3886.10,0.00
2024-12-10 17:37:17,62,3789,19,43,2313.73,3887.00,0.00
2024-12-10 17:37:17,63,3789,20,43,2277.01,3887.02,0.00
2024-12-10 17:37:17,62,3789,19,43,2293.73,3887.19,0.00
2024-12-10 17:37:17,62,3790,19,43,2301.41,3888.00,0.00
2024-12-10 17:37:17,63,3790,20,43,2264.88,3888.02,0.00
2024-12-10 17:37:17,62,3790,20,42,2290.77,3888.10,0.00
2024-12-10 17:37:17,62,3791,20,42,2293.85,3889.00,0.00
2024-12-10 17:37:17,63,3791,20,43,2257.44,3889.02,0.00
2024-12-10 17:37:17,62,3791,19,43,2235.79,3889.60,0.00
2024-12-10 17:37:17,63,3790,19,44,2195.46,3889.75,0.00
2024-12-10 17:37:17,63,3791,19,44,2249.38,3890.00,0.00
2024-12-10 17:37:17,64,3791,20,44,2214.23,3890.02,0.00
2024-12-10 17:37:17,64,3792,20,44,2278.86,3891.00,0.00
2024-12-10 17:37:17,65,3792,20,45,2243.80,3891.02,0.00
2024-12-10 17:37:17,65,3793,20,45,2241.25,3892.00,0.00
2024-12-10 17:37:17,66,3793,21,45,2207.30,3892.02,0.00
2024-12-10 17:37:17,65,3793,21,44,2235.28,3892.08,0.00
2024-12-10 17:37:17,64,3793,20,44,2241.38,3892.75,0.00
2024-12-10 17:37:17,64,3794,20,44,2292.67,3893.00,0.00
2024-12-10 17:37:17,65,3794,20,45,2257.40,3893.02,0.00
2024-12-10 17:37:17,64,3794,20,44,2282.33,3893.03,0.00
2024-12-10 17:37:17,64,3795,20,44,2281.70,3894.00,0.00
2024-12-10 17:37:17,65,3795,20,45,2246.60,3894.02,0.00
2024-12-10 17:37:17,64,3795,20,44,2271.36,3894.03,0.00
2024-12-10 17:37:17,64,3796,20,44,2270.73,3895.00,0.00
2024-12-10 17:37:17,65,3796,21,44,2235.79,3895.02,0.00
2024-12-10 17:37:17,64,3796,20,44,2211.03,3895.97,0.00
2024-12-10 17:37:17,64,3797,20,44,2270.70,3896.00,0.00
2024-12-10 17:37:17,65,3797,20,45,2235.77,3896.02,0.00
2024-12-10 17:37:17,64,3797,20,44,2269.48,3896.03,0.00
2024-12-10 17:37:17,64,3798,20,44,2268.85,3897.00,0.00
2024-12-10 17:37:17,65,3798,21,44,2233.94,3897.02,0.00
2024-12-10 17:37:17,65,3799,21,44,2220.12,3898.00,0.00
2024-12-10 17:37:17,66,3799,21,45,2186.48,3898.02,0.00
2024-12-10 17:37:17,65,3799,21,44,2214.13,3898.03,0.00
2024-12-10 17:37:17,64,3799,20,44,2199.55,3898.77,0.00
2024-12-10 17:37:18,64,3800,20,44,2251.51,3899.00,0.00
2024-12-10 17:37:18,65,3800,21,44,2216.87,3899.02,0.00
2024-12-10 17:37:18,64,3800,20,44,2228.43,3899.23,0.00
2024-12-10 17:37:18,64,3801,20,44,2260.01,3900.00,0.00
2024-12-10 17:37:18,65,3801,21,44,2225.24,3900.02,0.00
2024-12-10 17:37:18,64,3801,21,43,2256.96,3900.03,0.00
2024-12-10 17:37:18,64,3802,21,43,2256.32,3901.00,0.00
2024-12-10 17:37:18,65,3802,21,44,2221.61,3901.02,0.00
2024-12-10 17:37:18,65,3803,21,44,2207.77,3902.00,0.00
2024-12-10 17:37:18,66,3803,22,44,2174.32,3902.02,0.00
2024-12-10 17:37:18,65,3803,22,43,2205.37,3902.03,0.00
2024-12-10 17:37:18,64,3803,21,43,2192.82,3902.97,0.00
2024-12-10 17:37:18,64,3804,21,43,2252.60,3903.00,0.00
2024-12-10 17:37:18,65,3804,22,43,2217.94,3903.02,0.00
2024-12-10 17:37:18,64,3804,21,43,2228.88,3903.23,0.00
2024-12-10 17:37:18,64,3805,21,43,2260.50,3904.00,0.00
2024-12-10 17:37:18,65,3805,21,44,2225.72,3904.02,0.00
2024-12-10 17:37:18,64,3805,21,43,2258.67,3904.03,0.00
2024-12-10 17:37:18,64,3806,21,43,2258.03,3905.00,0.00
2024-12-10 17:37:18,65,3806,22,43,2223.29,3905.02,0.00
2024-12-10 17:37:18,64,3806,21,43,2257.42,3905.02,0.00
2024-12-10 17:37:18,64,3807,21,43,2243.96,3906.00,0.00
2024-12-10 17:37:18,65,3807,21,44,2209.43,3906.02,0.00
2024-12-10 17:37:18,64,3807,21,43,2243.35,3906.02,0.00
2024-12-10 17:37:18,64,3808,21,43,2242.09,3907.00,0.00
2024-12-10 17:37:18,65,3808,21,44,2207.59,3907.02,0.00
2024-12-10 17:37:18,65,3809,21,44,2193.73,3908.00,0.00
2024-12-10 17:37:18,66,3809,21,45,2160.49,3908.02,0.00
2024-12-10 17:37:18,65,3809,21,44,2192.53,3908.02,0.00
2024-12-10 17:37:18,65,3810,21,44,2190.68,3909.00,0.00
2024-12-10 17:37:18,66,3810,22,44,2157.49,3909.02,0.00
2024-12-10 17:37:18,65,3810,21,44,2172.08,3909.17,0.00
2024-12-10 17:37:18,64,3810,20,44,2165.35,3909.64,0.00
2024-12-10 17:37:18,64,3811,20,44,2212.65,3910.00,0.00
2024-12-10 17:37:18,65,3811,20,45,2178.61,3910.02,0.00
2024-12-10 17:37:18,64,3811,20,44,2211.43,3910.02,0.00
2024-12-10 17:37:18,64,3812,20,44,2210.16,3911.00,0.00
2024-12-10 17:37:18,65,3812,21,44,2176.16,3911.02,0.00
2024-12-10 17:37:18,64,3812,20,44,2164.81,3911.48,0.00
2024-12-10 17:37:18,64,3813,20,44,2206.12,3912.00,0.00
2024-12-10 17:37:18,65,3813,20,45,2172.18,3912.02,0.00
2024-12-10 17:37:18,64,3813,20,44,2203.06,3912.03,0.00
2024-12-10 17:37:18,64,3814,20,44,2202.40,3913.00,0.00
2024-12-10 17:37:18,65,3814,20,45,2168.52,3913.02,0.00
2024-12-10 17:37:18,64,3814,19,45,2182.88,3913.19,0.00
2024-12-10 17:37:18,64,3815,19,45,2188.29,3914.00,0.00
2024-12-10 17:37:18,65,3815,19,46,2154.62,3914.02,0.00
2024-12-10 17:37:18,64,3815,19,45,2185.84,3914.03,0.00
2024-12-10 17:37:18,63,3815,18,45,2173.24,3914.97,0.00
2024-12-10 17:37:18,63,3816,18,45,2234.15,3915.00,0.00
2024-12-10 17:37:18,64,3816,18,46,2199.25,3915.02,0.00
2024-12-10 17:37:18,64,3817,18,46,2185.73,3916.00,0.00
2024-12-10 17:37:18,65,3817,19,46,2152.11,3916.02,0.00
2024-12-10 17:37:18,64,3817,19,45,2183.90,3916.03,0.00
2024-12-10 17:37:18,63,3817,18,45,2175.55,3916.92,0.00
2024-12-10 17:37:18,63,3818,18,45,2234.67,3917.00,0.00
2024-12-10 17:37:18,64,3818,18,46,2199.76,3917.02,0.00
2024-12-10 17:37:18,64,3819,18,46,2186.24,3918.00,0.00
2024-12-10 17:37:18,65,3819,18,47,2152.60,3918.02,0.00
2024-12-10 17:37:18,64,3819,18,46,2185.02,3918.03,0.00
2024-12-10 17:37:18,65,3818,19,46,2137.68,3918.42,0.00
2024-12-10 17:37:18,66,3817,20,46,2117.24,3918.56,0.00
2024-12-10 17:37:18,66,3818,20,46,2154.97,3919.00,0.00
2024-12-10 17:37:18,67,3818,20,47,2122.81,3919.02,0.00
2024-12-10 17:37:18,67,3819,20,47,2225.15,3920.00,0.00
2024-12-10 17:37:18,68,3819,20,48,2192.43,3920.02,0.00
2024-12-10 17:37:18,67,3819,20,47,2223.40,3920.03,0.00
2024-12-10 17:37:18,66,3819,19,47,2219.90,3920.55,0.00
2024-12-10 17:37:18,67,3818,19,48,2177.56,3920.81,0.00
2024-12-10 17:37:18,67,3819,19,48,2236.25,3921.00,0.00
2024-12-10 17:37:18,68,3819,20,48,2203.37,3921.02,0.00
2024-12-10 17:37:18,67,3819,20,47,2223.38,3921.03,0.00
2024-12-10 17:37:18,67,3820,20,47,2279.56,3922.00,0.00
2024-12-10 17:37:18,68,3820,21,47,2246.03,3922.02,0.00
2024-12-10 17:37:18,68,3821,21,47,2231.03,3923.00,0.00
2024-12-10 17:37:18,69,3821,22,47,2198.69,3923.01,0.00
2024-12-10 17:37:18,68,3821,22,46,2228.72,3923.03,0.00
2024-12-10 17:37:18,68,3822,22,46,2225.83,3924.00,0.00
2024-12-10 17:37:18,69,3822,23,46,2193.57,3924.01,0.00
2024-12-10 17:37:18,68,3822,22,46,2188.92,3924.13,0.00
2024-12-10 17:37:18,67,3822,21,46,2200.21,3924.69,0.00
2024-12-10 17:37:18,67,3823,21,46,2246.74,3925.00,0.00
2024-12-10 17:37:18,68,3823,21,47,2213.70,3925.02,0.00
2024-12-10 17:37:18,67,3823,21,46,2244.98,3925.03,0.00
2024-12-10 17:37:18,68,3822,22,46,2211.96,3925.06,0.00
2024-12-10 17:37:18,68,3823,22,46,2252.94,3926.00,0.00
2024-12-10 17:37:18,69,3823,22,47,2220.29,3926.01,0.00
2024-12-10 17:37:18,70,3822,22,48,2152.43,3926.69,0.00
2024-12-10 17:37:18,70,3823,22,48,2281.75,3927.00,0.00
2024-12-10 17:37:18,71,3823,23,48,2249.61,3927.01,0.00
2024-12-10 17:37:18,71,3824,23,48,2304.74,3928.00,0.00
2024-12-10 17:37:18,72,3824,23,49,2272.73,3928.01,0.00
2024-12-10 17:37:18,72,3825,23,49,2267.36,3929.00,0.00
2024-12-10 17:37:18,73,3825,23,50,2236.30,3929.01,0.00
2024-12-10 17:37:18,73,3826,23,50,2222.80,3930.00,0.00
2024-12-10 17:37:18,74,3826,23,51,2192.77,3930.01,0.00
2024-12-10 17:37:18,73,3826,23,50,2213.65,3930.03,0.00
2024-12-10 17:37:18,73,3827,23,50,2208.29,3931.00,0.00
2024-12-10 17:37:18,74,3827,24,50,2178.45,3931.01,0.00
2024-12-10 17:37:18,73,3827,24,49,2196.45,3931.03,0.00
2024-12-10 17:37:18,72,3827,23,49,2219.37,3931.22,0.00
2024-12-10 17:37:18,71,3827,22,49,2220.67,3931.96,0.00
2024-12-10 17:37:18,71,3828,22,49,2274.41,3932.00,0.00
2024-12-10 17:37:18,72,3828,22,50,2242.82,3932.01,0.00
2024-12-10 17:37:18,71,3828,22,49,2273.86,3932.01,0.00
2024-12-10 17:37:18,70,3828,22,48,2294.55,3932.01,0.00
2024-12-10 17:37:19,70,3829,22,48,2290.07,3933.00,0.00
2024-12-10 17:37:19,71,3829,22,49,2257.82,3933.01,0.00
2024-12-10 17:37:19,70,3829,21,49,2242.59,3933.41,0.00
2024-12-10 17:37:19,70,3830,21,49,2276.17,3934.00,0.00
2024-12-10 17:37:19,71,3830,22,49,2244.11,3934.01,0.00
2024-12-10 17:37:19,70,3830,22,48,2275.60,3934.01,0.00
2024-12-10 17:37:19,69,3830,21,48,2274.01,3934.51,0.00
2024-12-10 17:37:19,69,3831,21,48,2312.02,3935.00,0.00
2024-12-10 17:37:19,70,3831,22,48,2278.99,3935.01,0.00
2024-12-10 17:37:19,69,3831,21,48,2273.57,3935.68,0.00
2024-12-10 17:37:19,69,3832,21,48,2318.31,3936.00,0.00
2024-12-10 17:37:19,70,3832,22,48,2285.20,3936.01,0.00
2024-12-10 17:37:19,69,3832,22,47,2317.74,3936.01,0.00
2024-12-10 17:37:19,69,3833,22,47,2313.77,3937.00,0.00
2024-12-10 17:37:19,70,3833,22,48,2280.71,3937.01,0.00
2024-12-10 17:37:19,69,3833,22,47,2301.79,3937.01,0.00
2024-12-10 17:37:19,69,3834,22,47,2297.81,3938.00,0.00
2024-12-10 17:37:19,70,3834,23,47,2264.98,3938.01,0.00
2024-12-10 17:37:19,69,3834,22,47,2260.29,3938.42,0.00
2024-12-10 17:37:19,69,3835,22,47,2294.96,3939.00,0.00
2024-12-10 17:37:19,70,3835,22,48,2262.18,3939.01,0.00
2024-12-10 17:37:19,69,3835,22,47,2292.11,3939.03,0.00
2024-12-10 17:37:19,70,3834,23,47,2228.84,3939.84,0.00
2024-12-10 17:37:19,70,3835,23,47,2263.32,3940.00,0.00
2024-12-10 17:37:19,71,3835,23,48,2231.44,3940.01,0.00
2024-12-10 17:37:19,72,3834,24,48,2179.18,3940.31,0.00
2024-12-10 17:37:19,72,3835,24,48,2251.36,3941.00,0.00
2024-12-10 17:37:19,73,3835,24,49,2220.52,3941.01,0.00
2024-12-10 17:37:19,72,3835,24,48,2249.18,3941.03,0.00
2024-12-10 17:37:19,71,3835,23,48,2257.12,3941.39,0.00
2024-12-10 17:37:19,71,3836,23,48,2344.72,3942.00,0.00
2024-12-10 17:37:19,72,3836,24,48,2312.16,3942.01,0.00
2024-12-10 17:37:19,71,3836,23,48,2325.68,3942.21,0.00
2024-12-10 17:37:19,70,3836,22,48,2357.78,3942.23,0.00
2024-12-10 17:37:19,69,3836,21,48,2386.84,3942.28,0.00
2024-12-10 17:37:19,69,3837,21,48,2415.92,3943.00,0.00
2024-12-10 17:37:19,70,3837,22,48,2381.41,3943.01,0.00
2024-12-10 17:37:19,69,3837,22,47,2414.21,3943.03,0.00
2024-12-10 17:37:19,69,3838,22,47,2410.82,3944.00,0.00
2024-12-10 17:37:19,70,3838,22,48,2376.38,3944.01,0.00
2024-12-10 17:37:19,71,3837,23,48,2329.59,3944.10,0.00
2024-12-10 17:37:19,71,3838,23,48,2369.62,3945.00,0.00
2024-12-10 17:37:19,72,3838,24,48,2336.71,3945.01,0.00
2024-12-10 17:37:19,71,3838,24,47,2367.95,3945.03,0.00
2024-12-10 17:37:19,71,3839,24,47,2419.13,3946.00,0.00
2024-12-10 17:37:19,72,3839,24,48,2385.53,3946.01,0.00
2024-12-10 17:37:19,71,3839,24,47,2406.90,3946.03,0.00
2024-12-10 17:37:19,70,3839,23,47,2404.60,3946.67,0.00
2024-12-10 17:37:19,70,3840,23,47,2448.27,3947.00,0.00
2024-12-10 17:37:19,71,3840,23,48,2413.78,3947.01,0.00
2024-12-10 17:37:19,70,3840,23,47,2435.86,3947.03,0.00
2024-12-10 17:37:19,70,3841,23,47,2431.97,3948.00,0.00
2024-12-10 17:37:19,71,3841,24,47,2397.71,3948.01,0.00
2024-12-10 17:37:19,71,3842,24,47,2399.19,3949.00,0.00
2024-12-10 17:37:19,72,3842,24,48,2365.87,3949.01,0.00
2024-12-10 17:37:19,72,3843,24,48,2364.61,3950.00,0.00
2024-12-10 17:37:19,73,3843,24,49,2332.22,3950.01,0.00
2024-12-10 17:37:19,73,3844,24,49,2324.64,3951.00,0.00
2024-12-10 17:37:19,74,3844,25,49,2293.22,3951.01,0.00
2024-12-10 17:37:19,74,3845,25,49,2277.07,3952.00,0.00
2024-12-10 17:37:19,75,3845,26,49,2246.71,3952.01,0.00
2024-12-10 17:37:19,74,3845,26,48,2265.86,3952.05,0.00
2024-12-10 17:37:19,74,3846,26,48,2261.08,3953.00,0.00
2024-12-10 17:37:19,75,3846,27,48,2230.94,3953.01,0.00
2024-12-10 17:37:19,74,3846,27,47,2254.14,3953.03,0.00
2024-12-10 17:37:19,74,3847,27,47,2248.30,3954.00,0.00
2024-12-10 17:37:19,75,3847,27,48,2218.32,3954.01,0.00
2024-12-10 17:37:19,74,3847,27,47,2234.95,3954.07,0.00
2024-12-10 17:37:19,75,3846,27,48,2188.49,3954.52,0.00
2024-12-10 17:37:19,74,3846,26,48,2228.35,3954.70,0.00
2024-12-10 17:37:19,73,3846,25,48,2254.56,3954.75,0.00
2024-12-10 17:37:19,73,3847,25,48,2299.18,3955.00,0.00
2024-12-10 17:37:19,74,3847,26,48,2268.11,3955.01,0.00
2024-12-10 17:37:19,73,3847,26,47,2285.65,3955.07,0.00
2024-12-10 17:37:19,72,3847,25,47,2292.47,3955.69,0.00
2024-12-10 17:37:19,72,3848,25,47,2368.51,3956.00,0.00
2024-12-10 17:37:19,73,3848,26,47,2336.07,3956.01,0.00
2024-12-10 17:37:19,72,3848,25,47,2322.60,3956.53,0.00
2024-12-10 17:37:19,72,3849,25,47,2359.22,3957.00,0.00
2024-12-10 17:37:19,73,3849,25,48,2326.90,3957.01,0.00
2024-12-10 17:37:19,72,3849,25,47,2355.93,3957.07,0.00
2024-12-10 17:37:19,72,3850,25,47,2352.67,3958.00,0.00
2024-12-10 17:37:19,73,3850,26,47,2320.44,3958.01,0.00
2024-12-10 17:37:19,73,3851,26,47,2303.67,3959.00,0.00
2024-12-10 17:37:19,74,3851,27,47,2272.54,3959.01,0.00
2024-12-10 17:37:19,73,3851,27,46,2300.97,3959.07,0.00
2024-12-10 17:37:19,73,3852,27,46,2297.20,3960.00,0.00
2024-12-10 17:37:19,74,3852,28,46,2266.16,3960.01,0.00
2024-12-10 17:37:19,75,3851,29,46,2193.61,3960.85,0.00
2024-12-10 17:37:19,74,3851,28,46,2215.86,3960.96,0.00
2024-12-10 17:37:19,74,3852,28,46,2267.80,3961.00,0.00
2024-12-10 17:37:19,75,3852,28,47,2237.56,3961.01,0.00
2024-12-10 17:37:19,74,3852,28,46,2265.14,3961.07,0.00
2024-12-10 17:37:19,74,3853,28,46,2314.42,3962.00,0.00
2024-12-10 17:37:19,75,3853,28,47,2283.56,3962.01,0.00
2024-12-10 17:37:19,75,3854,28,47,2266.17,3963.00,0.00
2024-12-10 17:37:19,76,3854,29,47,2236.35,3963.01,0.00
2024-12-10 17:37:19,75,3854,29,46,2263.01,3963.07,0.00
2024-12-10 17:37:19,75,3855,29,46,2258.29,3964.00,0.00
2024-12-10 17:37:19,76,3855,29,47,2228.57,3964.01,0.00
2024-12-10 17:37:19,76,3856,29,47,2210.87,3965.00,0.00
2024-12-10 17:37:19,77,3856,29,48,2182.16,3965.01,0.00
2024-12-10 17:37:19,76,3856,29,47,2207.24,3965.08,0.00
2024-12-10 17:37:19,75,3856,28,47,2199.91,3965.59,0.00
2024-12-10 17:37:20,75,3857,28,47,2236.69,3966.00,0.00
2024-12-10 17:37:20,76,3857,29,47,2207.26,3966.01,0.00
2024-12-10 17:37:20,75,3857,28,47,2198.43,3966.72,0.00
2024-12-10 17:37:20,75,3858,28,47,2219.27,3967.00,0.00
2024-12-10 17:37:20,76,3858,28,48,2190.07,3967.01,0.00
2024-12-10 17:37:20,75,3858,28,47,2215.05,3967.08,0.00
2024-12-10 17:37:20,76,3857,29,47,2165.29,3967.63,0.00
2024-12-10 17:37:20,76,3858,29,47,2195.84,3968.00,0.00
2024-12-10 17:37:20,77,3858,29,48,2167.32,3968.01,0.00
2024-12-10 17:37:20,76,3858,29,47,2194.80,3968.01,0.00
2024-12-10 17:37:20,76,3859,29,47,2239.74,3969.00,0.00
2024-12-10 17:37:20,77,3859,29,48,2210.65,3969.01,0.00
2024-12-10 17:37:20,76,3859,28,48,2239.22,3969.01,0.00
2024-12-10 17:37:20,75,3859,28,47,2235.21,3969.05,0.00
2024-12-10 17:37:20,75,3860,28,47,2251.12,3970.00,0.00
2024-12-10 17:37:20,76,3860,29,47,2221.50,3970.01,0.00
2024-12-10 17:37:20,76,3861,29,47,2203.77,3971.00,0.00
2024-12-10 17:37:20,77,3861,29,48,2175.15,3971.01,0.00
2024-12-10 17:37:20,76,3861,28,48,2203.25,3971.01,0.00
2024-12-10 17:37:20,75,3861,28,47,2231.05,3971.04,0.00
2024-12-10 17:37:20,74,3861,27,47,2229.39,3971.78,0.00
2024-12-10 17:37:20,74,3862,27,47,2274.64,3972.00,0.00
2024-12-10 17:37:20,75,3862,28,47,2244.31,3972.01,0.00
2024-12-10 17:37:20,76,3861,28,48,2183.65,3972.57,0.00
2024-12-10 17:37:20,76,3862,28,48,2200.17,3973.00,0.00
2024-12-10 17:37:20,77,3862,29,48,2171.60,3973.01,0.00
2024-12-10 17:37:20,76,3862,29,47,2198.62,3973.04,0.00
2024-12-10 17:37:20,76,3863,29,47,2244.65,3974.00,0.00
2024-12-10 17:37:20,77,3863,29,48,2215.50,3974.01,0.00
2024-12-10 17:37:20,77,3864,29,48,2197.47,3975.00,0.00
2024-12-10 17:37:20,78,3864,29,49,2169.30,3975.01,0.00
2024-12-10 17:37:20,77,3864,29,48,2194.90,3975.05,0.00
2024-12-10 17:37:20,76,3864,28,48,2200.96,3975.63,0.00
2024-12-10 17:37:20,76,3865,28,48,2217.96,3976.00,0.00
2024-12-10 17:37:20,77,3865,28,49,2189.16,3976.01,0.00
2024-12-10 17:37:20,77,3866,28,49,2171.12,3977.00,0.00
2024-12-10 17:37:20,78,3866,29,49,2143.28,3977.01,0.00
2024-12-10 17:37:20,77,3866,29,48,2168.54,3977.05,0.00
2024-12-10 17:37:20,77,3867,29,48,2162.36,3978.00,0.00
2024-12-10 17:37:20,78,3867,30,48,2134.64,3978.01,0.00
2024-12-10 17:37:20,78,3868,30,48,2116.30,3979.00,0.00
2024-12-10 17:37:20,79,3868,31,48,2089.51,3979.01,0.00
2024-12-10 17:37:20,78,3868,31,47,2113.25,3979.05,0.00
2024-12-10 17:37:20,77,3868,30,47,2134.03,3979.22,0.00
2024-12-10 17:37:20,77,3869,30,47,2134.50,3980.00,0.00
2024-12-10 17:37:20,78,3869,30,48,2107.14,3980.01,0.00
2024-12-10 17:37:20,77,3869,29,48,2092.84,3980.51,0.00
2024-12-10 17:37:20,77,3870,29,48,2125.22,3981.00,0.00
2024-12-10 17:37:20,78,3870,30,48,2097.97,3981.01,0.00
2024-12-10 17:37:20,77,3870,30,47,2121.09,3981.07,0.00
2024-12-10 17:37:20,77,3871,30,47,2115.41,3982.00,0.00
2024-12-10 17:37:20,78,3871,31,47,2088.29,3982.01,0.00
2024-12-10 17:37:20,77,3871,30,47,2110.76,3982.07,0.00
2024-12-10 17:37:20,77,3872,30,47,2115.42,3983.00,0.00
2024-12-10 17:37:20,78,3872,31,47,2088.30,3983.01,0.00
2024-12-10 17:37:20,77,3872,31,46,2104.05,3983.07,0.00
2024-12-10 17:37:20,77,3873,31,46,2098.36,3984.00,0.00
2024-12-10 17:37:20,78,3873,31,47,2071.46,3984.01,0.00
2024-12-10 17:37:20,78,3874,31,47,2053.08,3985.00,0.00
2024-12-10 17:37:20,79,3874,32,47,2027.09,3985.01,0.00
2024-12-10 17:37:20,78,3874,32,46,2049.51,3985.06,0.00
2024-12-10 17:37:20,77,3874,31,46,2068.94,3985.25,0.00
2024-12-10 17:37:20,76,3874,30,46,2062.47,3985.92,0.00
2024-12-10 17:37:20,76,3875,30,46,2111.83,3986.00,0.00
2024-12-10 17:37:20,77,3875,31,46,2084.40,3986.01,0.00
2024-12-10 17:37:20,78,3874,31,47,2022.69,3986.67,0.00
2024-12-10 17:37:20,78,3875,31,47,2053.08,3987.00,0.00
2024-12-10 17:37:20,79,3875,31,48,2027.09,3987.01,0.00
2024-12-10 17:37:20,78,3875,31,47,2050.02,3987.06,0.00
2024-12-10 17:37:20,79,3874,31,48,2011.08,3987.42,0.00
2024-12-10 17:37:20,78,3874,30,48,2048.81,3987.72,0.00
2024-12-10 17:37:20,78,3875,30,48,2119.55,3988.00,0.00
2024-12-10 17:37:20,79,3875,31,48,2092.72,3988.01,0.00
2024-12-10 17:37:20,79,3876,31,48,2124.73,3989.00,0.00
2024-12-10 17:37:20,80,3876,31,49,2098.17,3989.01,0.00
2024-12-10 17:37:20,80,3877,31,49,2079.25,3990.00,0.00
2024-12-10 17:37:20,81,3877,32,49,2053.58,3990.01,0.00
2024-12-10 17:37:20,80,3877,32,48,2076.76,3990.06,0.00
2024-12-10 17:37:20,79,3877,31,48,2076.09,3990.73,0.00
2024-12-10 17:37:20,79,3878,31,48,2095.99,3991.00,0.00
2024-12-10 17:37:20,80,3878,32,48,2069.79,3991.01,0.00
2024-12-10 17:37:20,79,3878,32,47,2092.97,3991.06,0.00
2024-12-10 17:37:20,78,3878,31,47,2110.66,3991.28,0.00
2024-12-10 17:37:20,77,3878,30,47,2101.71,3991.97,0.00
2024-12-10 17:37:20,77,3879,30,47,2152.53,3992.00,0.00
2024-12-10 17:37:20,78,3879,30,48,2124.93,3992.01,0.00
2024-12-10 17:37:20,78,3880,30,48,2106.10,3993.00,0.00
2024-12-10 17:37:20,79,3880,30,49,2079.44,3993.01,0.00
2024-12-10 17:37:20,78,3880,30,48,2104.48,3993.04,0.00
2024-12-10 17:37:20,77,3880,30,47,2130.77,3993.05,0.00
2024-12-10 17:37:20,76,3880,29,47,2130.77,3993.75,0.00
2024-12-10 17:37:20,76,3881,29,47,2152.51,3994.00,0.00
2024-12-10 17:37:20,77,3881,30,47,2124.56,3994.01,0.00
2024-12-10 17:37:20,76,3881,30,46,2139.91,3994.05,0.00
2024-12-10 17:37:20,75,3881,29,46,2122.62,3994.97,0.00
2024-12-10 17:37:20,75,3882,29,46,2174.83,3995.00,0.00
2024-12-10 17:37:20,76,3882,30,46,2146.22,3995.01,0.00
2024-12-10 17:37:20,75,3882,30,45,2162.05,3995.05,0.00
2024-12-10 17:37:20,75,3883,30,45,2156.73,3996.00,0.00
2024-12-10 17:37:20,76,3883,31,45,2128.35,3996.01,0.00
2024-12-10 17:37:20,76,3884,31,45,2110.48,3997.00,0.00
2024-12-10 17:37:20,77,3884,32,45,2083.07,3997.01,0.00
2024-12-10 17:37:20,76,3884,32,44,2108.38,3997.05,0.00
2024-12-10 17:37:21,76,3885,32,44,2102.59,3998.00,0.00
2024-12-10 17:37:21,77,3885,33,44,2075.28,3998.01,0.00
2024-12-10 17:37:21,76,3885,33,43,2089.97,3998.05,0.00
2024-12-10 17:37:21,76,3886,33,43,2084.17,3999.00,0.00
2024-12-10 17:37:21,77,3886,34,43,2057.11,3999.01,0.00
2024-12-10 17:37:21,76,3886,34,42,2071.02,3999.07,0.00
2024-12-10 17:37:21,75,3886,33,42,2086.28,3999.31,0.00
2024-12-10 17:37:21,75,3887,33,42,2112.30,4000.00,0.00
2024-12-10 17:37:21,76,3887,34,42,2084.51,4000.01,0.00
2024-12-10 17:37:21,75,3887,33,42,2111.24,4000.03,0.00
2024-12-10 17:37:21,74,3887,33,41,2127.34,4000.05,0.00
2024-12-10 17:37:21,73,3887,32,41,2120.00,4000.59,0.00
2024-12-10 17:37:21,73,3888,32,41,2158.66,4001.00,0.00
2024-12-10 17:37:21,74,3888,32,42,2129.49,4001.01,0.00
2024-12-10 17:37:21,74,3889,32,42,2123.30,4002.00,0.00
2024-12-10 17:37:21,75,3889,33,42,2094.99,4002.01,0.00
2024-12-10 17:37:21,74,3889,32,42,2122.22,4002.03,0.00
2024-12-10 17:37:21,74,3890,32,42,2108.24,4003.00,0.00
2024-12-10 17:37:21,75,3890,33,42,2080.13,4003.01,0.00
2024-12-10 17:37:21,74,3890,33,41,2100.67,4003.04,0.00
2024-12-10 17:37:21,73,3890,32,41,2104.96,4003.23,0.00
2024-12-10 17:37:21,73,3891,32,41,2129.56,4004.00,0.00
2024-12-10 17:37:21,74,3891,32,42,2100.78,4004.01,0.00
2024-12-10 17:37:21,74,3892,32,42,2083.45,4005.00,0.00
2024-12-10 17:37:21,75,3892,32,43,2055.67,4005.01,0.00
2024-12-10 17:37:21,74,3892,32,42,2080.75,4005.07,0.00
2024-12-10 17:37:21,75,3891,32,43,2044.01,4005.32,0.00
2024-12-10 17:37:21,74,3891,31,43,2068.57,4005.66,0.00
2024-12-10 17:37:21,74,3892,31,43,2109.41,4006.00,0.00
2024-12-10 17:37:21,75,3892,31,44,2081.29,4006.01,0.00
2024-12-10 17:37:21,74,3892,31,43,2095.89,4006.07,0.00
2024-12-10 17:37:21,74,3893,31,43,2145.68,4007.00,0.00
2024-12-10 17:37:21,75,3893,32,43,2117.07,4007.01,0.00
2024-12-10 17:37:21,75,3894,32,43,2102.57,4008.00,0.00
2024-12-10 17:37:21,76,3894,32,44,2074.90,4008.01,0.00
2024-12-10 17:37:21,75,3894,32,43,2094.02,4008.07,0.00
2024-12-10 17:37:21,75,3895,32,43,2089.19,4009.00,0.00
2024-12-10 17:37:21,76,3895,32,44,2061.70,4009.01,0.00
2024-12-10 17:37:21,75,3895,32,43,2076.37,4009.07,0.00
2024-12-10 17:37:21,74,3895,31,43,2060.27,4009.68,0.00
2024-12-10 17:37:21,74,3896,31,43,2101.70,4010.00,0.00
2024-12-10 17:37:21,75,3896,31,44,2073.68,4010.01,0.00
2024-12-10 17:37:21,74,3896,31,43,2088.70,4010.07,0.00
2024-12-10 17:37:21,73,3896,30,43,2072.58,4010.64,0.00
2024-12-10 17:37:21,73,3897,30,43,2113.50,4011.00,0.00
2024-12-10 17:37:21,74,3897,30,44,2084.94,4011.01,0.00
2024-12-10 17:37:21,73,3897,30,43,2100.32,4011.07,0.00
2024-12-10 17:37:21,72,3897,29,43,2090.73,4011.61,0.00
2024-12-10 17:37:21,72,3898,29,43,2131.13,4012.00,0.00
2024-12-10 17:37:21,73,3898,29,44,2101.94,4012.01,0.00
2024-12-10 17:37:21,72,3898,29,43,2117.21,4012.07,0.00
2024-12-10 17:37:21,71,3898,28,43,2140.31,4012.24,0.00
2024-12-10 17:37:21,70,3898,27,43,2170.31,4012.24,0.00
2024-12-10 17:37:21,69,3898,26,43,2166.48,4012.62,0.00
2024-12-10 17:37:21,69,3899,26,43,2209.81,4013.00,0.00
2024-12-10 17:37:21,70,3899,26,44,2178.24,4013.01,0.00
2024-12-10 17:37:21,69,3899,26,43,2195.27,4013.07,0.00
2024-12-10 17:37:21,69,3900,26,43,2193.36,4014.00,0.00
2024-12-10 17:37:21,70,3900,27,43,2162.03,4014.01,0.00
2024-12-10 17:37:21,70,3901,27,43,2145.39,4015.00,0.00
2024-12-10 17:37:21,71,3901,28,43,2115.17,4015.01,0.00
2024-12-10 17:37:21,70,3901,28,42,2141.37,4015.07,0.00
2024-12-10 17:37:21,70,3902,28,42,2138.04,4016.00,0.00
2024-12-10 17:37:21,71,3902,29,42,2107.93,4016.01,0.00
2024-12-10 17:37:21,70,3902,28,42,2087.96,4016.70,0.00
2024-12-10 17:37:21,70,3903,28,42,2133.52,4017.00,0.00
2024-12-10 17:37:21,71,3903,29,42,2103.47,4017.01,0.00
2024-12-10 17:37:21,71,3904,29,42,2090.05,4018.00,0.00
2024-12-10 17:37:21,72,3904,30,42,2061.03,4018.01,0.00
2024-12-10 17:37:21,71,3904,29,42,2089.49,4018.01,0.00
2024-12-10 17:37:21,70,3904,28,42,2118.76,4018.01,0.00
2024-12-10 17:37:21,69,3904,28,41,2138.41,4018.07,0.00
2024-12-10 17:37:21,69,3905,28,41,2134.24,4019.00,0.00
2024-12-10 17:37:21,70,3905,29,41,2103.75,4019.01,0.00
2024-12-10 17:37:21,69,3905,28,41,2113.92,4019.23,0.00
2024-12-10 17:37:21,68,3905,27,41,2104.66,4019.65,0.00
2024-12-10 17:37:21,68,3906,27,41,2149.84,4020.00,0.00
2024-12-10 17:37:21,69,3906,28,41,2118.69,4020.01,0.00
2024-12-10 17:37:21,68,3906,28,40,2146.30,4020.07,0.00
2024-12-10 17:37:21,67,3906,27,40,2129.41,4020.66,0.00
2024-12-10 17:37:21,67,3907,27,40,2175.89,4021.00,0.00
2024-12-10 17:37:21,68,3907,28,40,2143.89,4021.02,0.00
2024-12-10 17:37:21,67,3907,27,40,2175.29,4021.02,0.00
2024-12-10 17:37:21,66,3907,26,40,2195.46,4021.05,0.00
2024-12-10 17:37:21,65,3907,25,40,2210.11,4021.22,0.00
2024-12-10 17:37:21,65,3908,25,40,2237.90,4022.00,0.00
2024-12-10 17:37:21,66,3908,26,40,2203.99,4022.02,0.00
2024-12-10 17:37:21,65,3908,26,39,2234.80,4022.05,0.00
2024-12-10 17:37:21,65,3909,26,39,2231.36,4023.00,0.00
2024-12-10 17:37:21,66,3909,27,39,2197.55,4023.02,0.00
2024-12-10 17:37:21,65,3909,26,39,2230.74,4023.02,0.00
2024-12-10 17:37:21,65,3910,26,39,2214.45,4024.00,0.00
2024-12-10 17:37:21,66,3910,27,39,2180.89,4024.02,0.00
2024-12-10 17:37:21,65,3910,27,38,2211.35,4024.05,0.00
2024-12-10 17:37:21,64,3910,26,38,2239.06,4024.22,0.00
2024-12-10 17:37:21,64,3911,26,38,2245.40,4025.00,0.00
2024-12-10 17:37:21,65,3911,26,39,2210.85,4025.02,0.00
2024-12-10 17:37:21,64,3911,25,39,2205.30,4025.42,0.00
2024-12-10 17:37:21,65,3910,25,40,2168.32,4025.52,0.00
2024-12-10 17:37:21,65,3911,25,40,2254.52,4026.00,0.00
2024-12-10 17:37:21,66,3911,26,40,2220.36,4026.02,0.00
2024-12-10 17:37:21,65,3911,26,39,2252.05,4026.05,0.00
2024-12-10 17:37:21,64,3911,25,39,2272.87,4026.30,0.00
2024-12-10 17:37:21,64,3912,25,39,2370.86,4027.00,0.00
2024-12-10 17:37:21,65,3912,26,39,2334.39,4027.02,0.00
2024-12-10 17:37:21,64,3912,25,39,2364.21,4027.03,0.00
2024-12-10 17:37:21,64,3913,25,39,2376.13,4028.00,0.00
2024-12-10 17:37:21,65,3913,26,39,2339.57,4028.02,0.00
2024-12-10 17:37:21,64,3913,26,38,2367.32,4028.03,0.00
2024-12-10 17:37:21,63,3913,25,38,2387.64,4028.05,0.00
2024-12-10 17:37:21,63,3914,25,38,2413.80,4029.00,0.00
2024-12-10 17:37:22,64,3914,26,38,2376.09,4029.02,0.00
2024-12-10 17:37:22,63,3914,26,37,2406.77,4029.02,0.00
2024-12-10 17:37:22,63,3915,26,37,2406.05,4030.00,0.00
2024-12-10 17:37:22,64,3915,26,38,2368.45,4030.02,0.00
2024-12-10 17:37:22,64,3916,26,38,2371.51,4031.00,0.00
2024-12-10 17:37:22,65,3916,27,38,2335.02,4031.02,0.00
2024-12-10 17:37:22,65,3917,27,38,2329.71,4032.00,0.00
2024-12-10 17:37:22,66,3917,27,39,2294.42,4032.02,0.00
2024-12-10 17:37:22,66,3918,27,39,2277.91,4033.00,0.00
2024-12-10 17:37:22,67,3918,28,39,2243.91,4033.02,0.00
2024-12-10 17:37:22,66,3918,28,38,2269.96,4033.02,0.00
2024-12-10 17:37:22,66,3919,28,38,2265.30,4034.00,0.00
2024-12-10 17:37:22,67,3919,29,38,2231.49,4034.02,0.00
2024-12-10 17:37:22,66,3919,29,37,2252.46,4034.02,0.00
2024-12-10 17:37:22,67,3918,30,37,2191.13,4034.70,0.00
2024-12-10 17:37:22,67,3919,30,37,2250.97,4035.00,0.00
2024-12-10 17:37:22,68,3919,30,38,2217.86,4035.02,0.00
2024-12-10 17:37:22,67,3919,30,37,2238.92,4035.02,0.00
2024-12-10 17:37:22,67,3920,30,37,2296.07,4036.00,0.00
2024-12-10 17:37:22,68,3920,31,37,2262.31,4036.02,0.00
2024-12-10 17:37:22,67,3920,30,37,2268.96,4036.03,0.00
2024-12-10 17:37:22,67,3921,30,37,2290.62,4037.00,0.00
2024-12-10 17:37:22,68,3921,30,38,2256.93,4037.02,0.00
2024-12-10 17:37:22,67,3921,30,37,2290.01,4037.02,0.00
2024-12-10 17:37:22,67,3922,30,37,2286.96,4038.00,0.00
2024-12-10 17:37:22,68,3922,30,38,2253.33,4038.02,0.00
2024-12-10 17:37:22,68,3923,30,38,2237.85,4039.00,0.00
2024-12-10 17:37:22,69,3923,30,39,2205.42,4039.01,0.00
2024-12-10 17:37:22,68,3923,30,38,2235.48,4039.03,0.00
2024-12-10 17:37:22,67,3923,29,38,2220.04,4039.97,0.00
2024-12-10 17:37:22,67,3924,29,38,2279.15,4040.00,0.00
2024-12-10 17:37:22,68,3924,30,38,2245.63,4040.02,0.00
2024-12-10 17:37:22,68,3925,30,38,2227.67,4041.00,0.00
2024-12-10 17:37:22,69,3925,30,39,2195.38,4041.01,0.00
2024-12-10 17:37:22,68,3925,30,38,2225.89,4041.03,0.00
2024-12-10 17:37:22,68,3926,30,38,2218.57,4042.00,0.00
2024-12-10 17:37:22,69,3926,31,38,2186.42,4042.01,0.00
2024-12-10 17:37:22,68,3926,30,38,2174.26,4042.69,0.00
2024-12-10 17:37:22,69,3925,31,38,2142.75,4042.71,0.00
2024-12-10 17:37:22,69,3926,31,38,2177.54,4043.00,0.00
2024-12-10 17:37:22,70,3926,32,38,2146.43,4043.01,0.00
2024-12-10 17:37:22,69,3926,32,37,2175.78,4043.03,0.00
2024-12-10 17:37:22,69,3927,32,37,2224.64,4044.00,0.00
2024-12-10 17:37:22,70,3927,32,38,2192.86,4044.01,0.00
2024-12-10 17:37:22,69,3927,31,38,2180.64,4044.68,0.00
2024-12-10 17:37:22,69,3928,31,38,2202.15,4045.00,0.00
2024-12-10 17:37:22,70,3928,31,39,2170.69,4045.01,0.00
2024-12-10 17:37:22,69,3928,31,38,2200.98,4045.03,0.00
2024-12-10 17:37:22,68,3928,30,38,2177.45,4045.96,0.00
2024-12-10 17:37:22,68,3929,30,38,2235.19,4046.00,0.00
2024-12-10 17:37:22,69,3929,30,39,2202.80,4046.01,0.00
2024-12-10 17:37:22,69,3930,30,39,2177.00,4047.00,0.00
2024-12-10 17:37:22,70,3930,31,39,2145.90,4047.01,0.00
2024-12-10 17:37:22,69,3930,31,38,2175.83,4047.03,0.00
2024-12-10 17:37:22,68,3930,30,38,2197.35,4047.24,0.00
2024-12-10 17:37:22,67,3930,29,38,2206.07,4047.70,0.00
2024-12-10 17:37:22,67,3931,29,38,2230.46,4048.00,0.00
2024-12-10 17:37:22,68,3931,29,39,2197.66,4048.02,0.00
2024-12-10 17:37:22,68,3932,29,39,2175.23,4049.00,0.00
2024-12-10 17:37:22,69,3932,29,40,2143.71,4049.01,0.00
2024-12-10 17:37:22,68,3932,29,39,2173.45,4049.04,0.00
2024-12-10 17:37:22,67,3932,28,39,2186.04,4049.33,0.00
2024-12-10 17:37:22,67,3933,28,39,2211.78,4050.00,0.00
2024-12-10 17:37:22,68,3933,29,39,2179.25,4050.02,0.00
2024-12-10 17:37:22,67,3933,28,39,2138.97,4050.70,0.00
2024-12-10 17:37:22,67,3934,28,39,2187.57,4051.00,0.00
2024-12-10 17:37:22,68,3934,28,40,2155.40,4051.02,0.00
2024-12-10 17:37:22,67,3934,28,39,2185.76,4051.05,0.00
2024-12-10 17:37:22,66,3934,28,38,2186.79,4051.65,0.00
2024-12-10 17:37:22,66,3935,28,38,2209.77,4052.00,0.00
2024-12-10 17:37:22,67,3935,28,39,2176.78,4052.02,0.00
2024-12-10 17:37:22,66,3935,28,38,2195.65,4052.05,0.00
2024-12-10 17:37:22,65,3935,27,38,2193.48,4052.54,0.00
2024-12-10 17:37:22,65,3936,27,38,2237.46,4053.00,0.00
2024-12-10 17:37:22,66,3936,28,38,2203.56,4053.02,0.00
2024-12-10 17:37:22,65,3936,27,38,2198.44,4053.68,0.00
2024-12-10 17:37:22,64,3936,26,38,2230.28,4053.72,0.00
2024-12-10 17:37:22,64,3937,26,38,2282.45,4054.00,0.00
2024-12-10 17:37:22,65,3937,27,38,2247.33,4054.02,0.00
2024-12-10 17:37:22,64,3937,27,37,2280.56,4054.05,0.00
2024-12-10 17:37:22,65,3936,27,38,2217.74,4054.77,0.00
2024-12-10 17:37:22,66,3935,28,38,2189.76,4054.88,0.00
2024-12-10 17:37:22,66,3936,28,38,2226.73,4055.00,0.00
2024-12-10 17:37:23,67,3936,29,38,2193.50,4055.02,0.00
2024-12-10 17:37:23,66,3936,29,37,2212.61,4055.05,0.00
2024-12-10 17:37:23,66,3937,29,37,2334.21,4056.00,0.00
2024-12-10 17:37:23,67,3937,30,37,2299.37,4056.02,0.00
2024-12-10 17:37:23,66,3937,30,36,2320.08,4056.05,0.00
2024-12-10 17:37:23,65,3937,29,36,2352.85,4056.05,0.00
2024-12-10 17:37:23,65,3938,29,36,2377.15,4057.00,0.00
2024-12-10 17:37:23,66,3938,29,37,2341.13,4057.02,0.00
2024-12-10 17:37:23,65,3938,28,37,2358.46,4057.17,0.00
2024-12-10 17:37:23,65,3939,28,37,2362.75,4058.00,0.00
2024-12-10 17:37:23,66,3939,28,38,2326.95,4058.02,0.00
2024-12-10 17:37:23,65,3939,28,37,2355.26,4058.03,0.00
2024-12-10 17:37:23,65,3940,28,37,2353.96,4059.00,0.00
2024-12-10 17:37:23,66,3940,29,37,2318.30,4059.02,0.00
2024-12-10 17:37:23,65,3940,29,36,2352.09,4059.03,0.00
2024-12-10 17:37:23,64,3940,28,36,2383.18,4059.16,0.00
2024-12-10 17:37:23,65,3939,28,37,2296.91,4059.80,0.00
2024-12-10 17:37:23,65,3940,28,37,2383.28,4060.00,0.00
2024-12-10 17:37:23,66,3940,28,38,2347.17,4060.02,0.00
2024-12-10 17:37:23,66,3941,28,38,2393.89,4061.00,0.00
2024-12-10 17:37:23,67,3941,29,38,2358.16,4061.02,0.00
2024-12-10 17:37:23,66,3941,29,37,2388.98,4061.05,0.00
2024-12-10 17:37:23,66,3942,29,37,2387.71,4062.00,0.00
2024-12-10 17:37:23,67,3942,30,37,2352.07,4062.02,0.00
2024-12-10 17:37:23,67,3943,30,37,2336.89,4063.00,0.00
2024-12-10 17:37:23,68,3943,31,37,2302.52,4063.02,0.00
2024-12-10 17:37:23,67,3943,31,36,2335.07,4063.03,0.00
2024-12-10 17:37:23,67,3944,31,36,2332.61,4064.00,0.00
2024-12-10 17:37:23,68,3944,31,37,2298.31,4064.02,0.00
2024-12-10 17:37:23,68,3945,31,37,2282.73,4065.00,0.00
2024-12-10 17:37:23,69,3945,31,38,2249.65,4065.01,0.00
2024-12-10 17:37:23,68,3945,31,37,2280.34,4065.03,0.00
2024-12-10 17:37:23,68,3946,31,37,2277.31,4066.00,0.00
2024-12-10 17:37:23,69,3946,32,37,2244.31,4066.01,0.00
2024-12-10 17:37:23,69,3947,32,37,2228.36,4067.00,0.00
2024-12-10 17:37:23,70,3947,32,38,2196.52,4067.01,0.00
2024-12-10 17:37:23,69,3947,32,37,2225.41,4067.04,0.00
2024-12-10 17:37:23,69,3948,32,37,2222.42,4068.00,0.00
2024-12-10 17:37:23,70,3948,33,37,2190.67,4068.01,0.00
2024-12-10 17:37:23,69,3948,32,37,2203.60,4068.19,0.00
2024-12-10 17:37:23,69,3949,32,37,2206.45,4069.00,0.00
2024-12-10 17:37:23,70,3949,32,38,2174.93,4069.01,0.00
2024-12-10 17:37:23,69,3949,32,37,2202.92,4069.04,0.00
2024-12-10 17:37:23,69,3950,32,37,2199.92,4070.00,0.00
2024-12-10 17:37:23,70,3950,32,38,2168.49,4070.01,0.00
2024-12-10 17:37:23,69,3950,31,38,2169.25,4070.06,0.00
2024-12-10 17:37:23,70,3949,32,38,2137.68,4070.10,0.00
2024-12-10 17:37:23,70,3950,32,38,2199.26,4071.00,0.00
2024-12-10 17:37:23,71,3950,32,39,2168.29,4071.01,0.00
2024-12-10 17:37:23,70,3950,32,38,2188.80,4071.03,0.00
2024-12-10 17:37:23,69,3950,31,38,2195.45,4071.65,0.00
2024-12-10 17:37:23,69,3951,31,38,2275.95,4072.00,0.00
2024-12-10 17:37:23,70,3951,31,39,2243.43,4072.01,0.00
2024-12-10 17:37:23,69,3951,31,38,2274.18,4072.03,0.00
2024-12-10 17:37:23,68,3951,30,38,2287.97,4072.32,0.00
2024-12-10 17:37:23,68,3952,30,38,2320.77,4073.00,0.00
2024-12-10 17:37:23,69,3952,30,39,2287.13,4073.01,0.00
2024-12-10 17:37:23,70,3951,30,40,2238.20,4073.16,0.00
2024-12-10 17:37:23,70,3952,30,40,2295.21,4074.00,0.00
2024-12-10 17:37:23,71,3952,31,40,2262.89,4074.01,0.00
2024-12-10 17:37:23,71,3953,31,40,2320.04,4075.00,0.00
2024-12-10 17:37:23,72,3953,31,41,2287.82,4075.01,0.00
2024-12-10 17:37:23,71,3953,30,41,2299.46,4075.23,0.00
2024-12-10 17:37:23,72,3952,30,42,2255.21,4075.56,0.00
2024-12-10 17:37:23,72,3953,30,42,2298.51,4076.00,0.00
2024-12-10 17:37:23,73,3953,31,42,2267.03,4076.01,0.00
2024-12-10 17:37:23,72,3953,30,42,2242.62,4076.90,0.00
2024-12-10 17:37:23,72,3954,30,42,2351.97,4077.00,0.00
2024-12-10 17:37:23,73,3954,31,42,2319.75,4077.01,0.00
2024-12-10 17:37:23,72,3954,31,41,2342.91,4077.04,0.00
2024-12-10 17:37:23,72,3955,31,41,2338.39,4078.00,0.00
2024-12-10 17:37:23,73,3955,31,42,2306.35,4078.01,0.00
2024-12-10 17:37:23,72,3955,30,42,2292.89,4078.78,0.00
2024-12-10 17:37:23,72,3956,30,42,2340.66,4079.00,0.00
2024-12-10 17:37:23,73,3956,31,42,2308.60,4079.01,0.00
2024-12-10 17:37:23,72,3956,31,41,2335.57,4079.06,0.00
2024-12-10 17:37:23,72,3957,31,41,2331.60,4080.00,0.00
2024-12-10 17:37:23,73,3957,32,41,2299.66,4080.01,0.00
2024-12-10 17:37:23,73,3958,32,41,2282.34,4081.00,0.00
2024-12-10 17:37:23,74,3958,33,41,2251.49,4081.01,0.00
2024-12-10 17:37:23,73,3958,33,40,2277.87,4081.06,0.00
2024-12-10 17:37:23,72,3958,32,40,2302.76,4081.22,0.00
2024-12-10 17:37:23,72,3959,32,40,2305.53,4082.00,0.00
2024-12-10 17:37:23,73,3959,33,40,2273.95,4082.01,0.00
2024-12-10 17:37:23,72,3959,32,40,2302.70,4082.01,0.00
2024-12-10 17:37:23,72,3960,32,40,2308.36,4083.00,0.00
2024-12-10 17:37:23,73,3960,32,41,2276.74,4083.01,0.00
2024-12-10 17:37:23,72,3960,32,40,2305.53,4083.04,0.00
2024-12-10 17:37:23,71,3960,31,40,2311.31,4083.70,0.00
2024-12-10 17:37:23,71,3961,31,40,2333.97,4084.00,0.00
2024-12-10 17:37:23,72,3961,31,41,2301.55,4084.01,0.00
2024-12-10 17:37:23,72,3962,31,41,2284.53,4085.00,0.00
2024-12-10 17:37:23,73,3962,31,42,2253.24,4085.01,0.00
2024-12-10 17:37:23,72,3962,31,41,2282.27,4085.04,0.00
2024-12-10 17:37:23,71,3962,30,41,2310.02,4085.14,0.00
2024-12-10 17:37:23,71,3963,30,41,2309.97,4086.00,0.00
2024-12-10 17:37:23,72,3963,30,42,2277.89,4086.01,0.00
2024-12-10 17:37:23,71,3963,29,42,2286.49,4086.20,0.00
2024-12-10 17:37:23,72,3962,29,43,2244.64,4086.47,0.00
2024-12-10 17:37:23,72,3963,29,43,2300.64,4087.00,0.00
2024-12-10 17:37:23,73,3963,30,43,2269.12,4087.01,0.00
2024-12-10 17:37:23,73,3964,30,43,2322.19,4088.00,0.00
2024-12-10 17:37:24,74,3964,30,44,2290.81,4088.01,0.00
2024-12-10 17:37:24,74,3965,30,44,2280.27,4089.00,0.00
2024-12-10 17:37:24,75,3965,31,44,2249.86,4089.01,0.00
2024-12-10 17:37:24,76,3964,31,45,2179.21,4089.79,0.00
2024-12-10 17:37:24,76,3965,31,45,2210.58,4090.00,0.00
2024-12-10 17:37:24,77,3965,31,46,2181.87,4090.01,0.00
2024-12-10 17:37:24,78,3964,32,46,2152.85,4090.06,0.00
2024-12-10 17:37:24,78,3965,32,46,2240.44,4091.00,0.00
2024-12-10 17:37:24,79,3965,32,47,2212.08,4091.01,0.00
2024-12-10 17:37:24,80,3964,32,48,2158.99,4091.41,0.00
2024-12-10 17:37:24,80,3964,32,48,2253.98,4092.00,0.00
2024-12-10 17:37:24,81,3964,33,48,2226.15,4092.01,0.00
2024-12-10 17:37:24,82,3963,33,49,2161.89,4092.71,0.00
2024-12-10 17:37:24,82,3964,33,49,2250.98,4093.00,0.00
2024-12-10 17:37:24,83,3964,34,49,2223.86,4093.01,0.00
2024-12-10 17:37:24,83,3965,34,49,2258.55,4094.00,0.00
2024-12-10 17:37:24,84,3965,35,49,2231.67,4094.01,0.00
2024-12-10 17:37:24,83,3965,35,48,2247.70,4094.04,0.00
2024-12-10 17:37:24,82,3965,34,48,2267.67,4094.21,0.00
2024-12-10 17:37:24,82,3966,34,48,2265.68,4095.00,0.00
2024-12-10 17:37:24,83,3966,35,48,2238.38,4095.01,0.00
2024-12-10 17:37:24,82,3966,35,47,2257.19,4095.04,0.00
2024-12-10 17:37:24,81,3966,34,47,2252.57,4095.77,0.00
2024-12-10 17:37:24,81,3967,34,47,2293.71,4096.00,0.00
2024-12-10 17:37:24,82,3967,35,47,2265.73,4096.01,0.00
2024-12-10 17:37:24,81,3967,35,46,2285.11,4096.04,0.00
2024-12-10 17:37:24,81,3968,35,46,2276.56,4097.00,0.00
2024-12-10 17:37:24,82,3968,36,46,2248.80,4097.01,0.00
2024-12-10 17:37:24,81,3968,36,45,2267.97,4097.04,0.00
2024-12-10 17:37:24,80,3968,35,45,2290.70,4097.10,0.00
2024-12-10 17:37:24,80,3969,35,45,2305.52,4098.00,0.00
2024-12-10 17:37:24,81,3969,35,46,2277.06,4098.01,0.00
2024-12-10 17:37:24,80,3969,35,45,2296.82,4098.04,0.00
2024-12-10 17:37:24,79,3969,34,45,2306.18,4098.05,0.00
2024-12-10 17:37:24,79,3970,34,45,2319.41,4099.00,0.00
2024-12-10 17:37:24,80,3970,35,45,2290.42,4099.01,0.00
2024-12-10 17:37:24,79,3970,34,45,2318.37,4099.01,0.00
2024-12-10 17:37:24,78,3970,34,44,2339.69,4099.03,0.00
2024-12-10 17:37:24,77,3970,33,44,2341.68,4099.70,0.00
2024-12-10 17:37:24,77,3971,33,44,2382.90,4100.00,0.00
2024-12-10 17:37:24,78,3971,33,45,2352.35,4100.01,0.00
2024-12-10 17:37:24,77,3971,32,45,2365.37,4100.17,0.00
2024-12-10 17:37:24,77,3972,32,45,2384.37,4101.00,0.00
2024-12-10 17:37:24,78,3972,32,46,2353.80,4101.01,0.00
2024-12-10 17:37:24,77,3972,32,45,2380.11,4101.05,0.00
2024-12-10 17:37:24,76,3972,31,45,2384.09,4101.45,0.00
2024-12-10 17:37:24,76,3973,31,45,2414.75,4102.00,0.00
2024-12-10 17:37:24,77,3973,32,45,2383.39,4102.01,0.00
2024-12-10 17:37:24,76,3973,31,45,2396.98,4102.17,0.00
2024-12-10 17:37:24,76,3974,31,45,2394.53,4103.00,0.00
2024-12-10 17:37:24,77,3974,32,45,2363.43,4103.01,0.00
2024-12-10 17:37:24,76,3974,31,45,2393.99,4103.01,0.00
2024-12-10 17:37:24,75,3974,31,44,2419.90,4103.05,0.00
2024-12-10 17:37:24,74,3974,30,44,2426.32,4103.66,0.00
2024-12-10 17:37:24,75,3973,31,44,2386.44,4103.87,0.00
2024-12-10 17:37:24,75,3974,31,44,2419.39,4104.00,0.00
2024-12-10 17:37:24,76,3974,32,44,2387.56,4104.01,0.00
2024-12-10 17:37:24,76,3975,32,44,2421.51,4105.00,0.00
2024-12-10 17:37:24,77,3975,33,44,2390.06,4105.01,0.00
2024-12-10 17:37:24,76,3975,33,43,2415.57,4105.05,0.00
2024-12-10 17:37:24,76,3976,33,43,2407.89,4106.00,0.00
2024-12-10 17:37:24,77,3976,34,43,2376.62,4106.01,0.00
2024-12-10 17:37:24,76,3976,33,43,2378.35,4106.42,0.00
2024-12-10 17:37:24,76,3977,33,43,2387.41,4107.00,0.00
2024-12-10 17:37:24,77,3977,33,44,2356.40,4107.01,0.00
2024-12-10 17:37:24,76,3977,33,43,2380.39,4107.07,0.00
2024-12-10 17:37:24,76,3978,33,43,2375.01,4108.00,0.00
2024-12-10 17:37:24,77,3978,33,44,2344.17,4108.01,0.00
2024-12-10 17:37:24,77,3979,33,44,2325.38,4109.00,0.00
2024-12-10 17:37:24,78,3979,33,45,2295.57,4109.01,0.00
2024-12-10 17:37:24,77,3979,33,44,2318.45,4109.07,0.00
2024-12-10 17:37:24,77,3980,33,44,2311.98,4110.00,0.00
2024-12-10 17:37:24,78,3980,34,44,2282.34,4110.01,0.00
2024-12-10 17:37:24,77,3980,33,44,2261.72,4110.86,0.00
2024-12-10 17:37:24,77,3981,33,44,2309.34,4111.00,0.00
2024-12-10 17:37:24,78,3981,34,44,2279.74,4111.01,0.00
2024-12-10 17:37:24,78,3982,34,44,2260.78,4112.00,0.00
2024-12-10 17:37:24,79,3982,34,45,2232.17,4112.01,0.00
2024-12-10 17:37:24,78,3982,34,44,2257.10,4112.06,0.00
2024-12-10 17:37:24,78,3983,34,44,2250.79,4113.00,0.00
2024-12-10 17:37:24,79,3983,35,44,2222.30,4113.01,0.00
2024-12-10 17:37:24,79,3984,35,44,2203.05,4114.00,0.00
2024-12-10 17:37:24,80,3984,35,45,2175.51,4114.01,0.00
2024-12-10 17:37:24,79,3984,35,44,2197.84,4114.06,0.00
2024-12-10 17:37:24,78,3984,34,44,2220.81,4114.19,0.00
2024-12-10 17:37:24,77,3984,33,44,2248.05,4114.22,0.00
2024-12-10 17:37:24,77,3985,33,44,2248.53,4115.00,0.00
2024-12-10 17:37:24,78,3985,33,45,2219.70,4115.01,0.00
2024-12-10 17:37:24,77,3985,32,45,2207.45,4115.22,0.00
2024-12-10 17:37:24,77,3986,32,45,2229.30,4116.00,0.00
2024-12-10 17:37:24,78,3986,32,46,2200.72,4116.01,0.00
2024-12-10 17:37:24,77,3986,32,45,2223.95,4116.07,0.00
2024-12-10 17:37:24,77,3987,32,45,2218.07,4117.00,0.00
2024-12-10 17:37:24,78,3987,32,46,2189.64,4117.01,0.00
2024-12-10 17:37:24,77,3987,31,46,2201.50,4117.07,0.00
2024-12-10 17:37:24,77,3988,31,46,2206.31,4118.00,0.00
2024-12-10 17:37:24,78,3988,32,46,2178.03,4118.01,0.00
2024-12-10 17:37:24,77,3988,31,46,2205.78,4118.01,0.00
2024-12-10 17:37:24,76,3988,31,45,2229.39,4118.05,0.00
2024-12-10 17:37:24,75,3988,30,45,2243.29,4118.29,0.00
2024-12-10 17:37:24,75,3989,30,45,2269.54,4119.00,0.00
2024-12-10 17:37:24,76,3989,31,45,2239.68,4119.01,0.00
2024-12-10 17:37:24,75,3989,30,45,2268.99,4119.01,0.00
2024-12-10 17:37:24,74,3989,29,45,2298.67,4119.03,0.00
2024-12-10 17:37:24,74,3990,29,45,2284.61,4120.00,0.00
2024-12-10 17:37:24,75,3990,29,46,2254.15,4120.01,0.00
2024-12-10 17:37:24,74,3990,29,45,2275.70,4120.03,0.00
2024-12-10 17:37:24,73,3990,28,45,2286.84,4120.51,0.00
2024-12-10 17:37:25,73,3991,28,45,2300.72,4121.00,0.00
2024-12-10 17:37:25,74,3991,28,46,2269.63,4121.01,0.00
2024-12-10 17:37:25,74,3992,28,46,2262.90,4122.00,0.00
2024-12-10 17:37:25,75,3992,28,47,2232.73,4122.01,0.00
2024-12-10 17:37:25,74,3992,27,47,2240.66,4122.04,0.00
2024-12-10 17:37:25,75,3991,27,48,2201.53,4122.29,0.00
2024-12-10 17:37:25,75,3992,27,48,2255.29,4123.00,0.00
2024-12-10 17:37:25,76,3992,27,49,2225.62,4123.01,0.00
2024-12-10 17:37:25,75,3992,27,48,2247.60,4123.03,0.00
2024-12-10 17:37:25,74,3992,26,48,2257.94,4123.08,0.00
2024-12-10 17:37:25,75,3991,26,49,2222.93,4123.23,0.00
2024-12-10 17:37:25,75,3992,26,49,2332.51,4124.00,0.00
2024-12-10 17:37:25,76,3992,26,50,2301.82,4124.01,0.00
2024-12-10 17:37:25,76,3993,26,50,2351.92,4125.00,0.00
2024-12-10 17:37:25,77,3993,26,51,2321.37,4125.01,0.00
2024-12-10 17:37:25,77,3994,26,51,2309.62,4126.00,0.00
2024-12-10 17:37:25,78,3994,27,51,2280.01,4126.01,0.00
2024-12-10 17:37:25,77,3994,26,51,2275.29,4126.29,0.00
2024-12-10 17:37:25,77,3995,26,51,2299.84,4127.00,0.00
2024-12-10 17:37:25,78,3995,27,51,2270.36,4127.01,0.00
2024-12-10 17:37:25,77,3995,27,50,2296.63,4127.03,0.00
2024-12-10 17:37:25,78,3994,28,50,2263.51,4127.14,0.00
2024-12-10 17:37:25,78,3995,28,50,2295.66,4128.00,0.00
2024-12-10 17:37:25,79,3995,29,50,2266.60,4128.01,0.00
2024-12-10 17:37:25,78,3995,28,50,2295.13,4128.01,0.00
2024-12-10 17:37:25,79,3994,29,50,2249.41,4128.19,0.00
2024-12-10 17:37:25,79,3995,29,50,2311.71,4129.00,0.00
2024-12-10 17:37:25,80,3995,30,50,2282.82,4129.01,0.00
2024-12-10 17:37:25,80,3996,30,50,2314.31,4130.00,0.00
2024-12-10 17:37:25,81,3996,31,50,2285.74,4130.01,0.00
2024-12-10 17:37:25,80,3996,31,49,2305.54,4130.01,0.00
2024-12-10 17:37:25,81,3995,32,49,2262.94,4130.38,0.00
2024-12-10 17:37:25,82,3994,33,49,2226.63,4130.99,0.00
2024-12-10 17:37:25,82,3995,33,49,2256.87,4131.00,0.00
2024-12-10 17:37:25,83,3995,33,50,2229.68,4131.01,0.00
2024-12-10 17:37:25,82,3995,32,50,2232.19,4131.05,0.00
2024-12-10 17:37:25,81,3995,31,50,2233.04,4131.69,0.00
2024-12-10 17:37:25,81,3996,31,50,2365.10,4132.00,0.00
2024-12-10 17:37:25,82,3996,32,50,2336.26,4132.01,0.00
2024-12-10 17:37:25,81,3996,32,49,2354.90,4132.01,0.00
2024-12-10 17:37:25,80,3996,32,48,2383.82,4132.01,0.00
2024-12-10 17:37:25,80,3997,32,48,2364.68,4133.00,0.00
2024-12-10 17:37:25,81,3997,33,48,2335.48,4133.01,0.00
2024-12-10 17:37:25,81,3998,33,48,2304.86,4134.00,0.00
2024-12-10 17:37:25,82,3998,33,49,2276.75,4134.01,0.00
2024-12-10 17:37:25,81,3998,33,48,2304.35,4134.01,0.00
2024-12-10 17:37:25,80,3998,32,48,2306.07,4134.68,0.00
2024-12-10 17:37:25,79,3998,32,47,2326.09,4134.82,0.00
2024-12-10 17:37:25,79,3999,32,47,2350.31,4135.00,0.00
2024-12-10 17:37:25,80,3999,33,47,2320.93,4135.01,0.00
2024-12-10 17:37:25,80,4000,33,47,2301.33,4136.00,0.00
2024-12-10 17:37:25,81,4000,34,47,2272.91,4136.01,0.00
2024-12-10 17:37:25,80,4000,34,46,2300.29,4136.01,0.00
2024-12-10 17:37:25,80,4001,34,46,2291.02,4137.00,0.00
2024-12-10 17:37:25,81,4001,34,47,2262.74,4137.01,0.00
2024-12-10 17:37:25,80,4001,33,47,2273.00,4137.20,0.00
2024-12-10 17:37:25,79,4001,32,47,2301.25,4137.20,0.00
2024-12-10 17:37:25,79,4002,32,47,2300.16,4138.00,0.00
2024-12-10 17:37:25,80,4002,32,48,2271.40,4138.01,0.00
2024-12-10 17:37:25,79,4002,32,47,2297.03,4138.05,0.00
2024-12-10 17:37:25,78,4002,31,47,2310.96,4138.42,0.00
2024-12-10 17:37:25,79,4001,32,47,2265.72,4138.84,0.00
2024-12-10 17:37:25,79,4002,32,47,2295.71,4139.00,0.00
2024-12-10 17:37:25,80,4002,33,47,2267.01,4139.01,0.00
2024-12-10 17:37:25,81,4001,33,48,2213.12,4139.42,0.00
2024-12-10 17:37:25,81,4002,33,48,2293.74,4140.00,0.00
2024-12-10 17:37:25,82,4002,34,48,2265.77,4140.01,0.00
2024-12-10 17:37:25,83,4001,35,48,2237.97,4140.05,0.00
2024-12-10 17:37:25,82,4001,35,47,2268.31,4140.06,0.00
2024-12-10 17:37:25,82,4002,35,47,2310.76,4141.00,0.00
2024-12-10 17:37:25,83,4002,36,47,2282.92,4141.01,0.00
2024-12-10 17:37:25,82,4002,35,47,2293.15,4141.18,0.00
2024-12-10 17:37:25,82,4003,35,47,2340.61,4142.00,0.00
2024-12-10 17:37:25,83,4003,36,47,2312.41,4142.01,0.00
2024-12-10 17:37:25,82,4003,36,46,2337.09,4142.05,0.00
2024-12-10 17:37:25,82,4004,36,46,2328.55,4143.00,0.00
2024-12-10 17:37:25,83,4004,37,46,2300.49,4143.01,0.00
2024-12-10 17:37:25,84,4003,38,46,2220.98,4143.95,0.00
2024-12-10 17:37:25,84,4004,38,46,2269.87,4144.00,0.00
2024-12-10 17:37:25,85,4004,39,46,2243.16,4144.01,0.00
2024-12-10 17:37:25,85,4005,39,46,2283.42,4145.00,0.00
2024-12-10 17:37:25,86,4005,40,46,2256.87,4145.01,0.00
2024-12-10 17:37:25,86,4006,40,46,2241.75,4146.00,0.00
2024-12-10 17:37:25,87,4006,41,46,2215.99,4146.01,0.00
2024-12-10 17:37:25,87,4007,41,46,2194.16,4147.00,0.00
2024-12-10 17:37:25,88,4007,41,47,2169.23,4147.01,0.00
2024-12-10 17:37:25,87,4007,41,46,2192.22,4147.05,0.00
2024-12-10 17:37:25,88,4006,42,46,2156.10,4147.34,0.00
2024-12-10 17:37:25,88,4007,42,46,2159.90,4148.00,0.00
2024-12-10 17:37:25,89,4007,42,47,2135.63,4148.01,0.00
2024-12-10 17:37:25,88,4007,41,47,2110.75,4148.56,0.00
2024-12-10 17:37:25,88,4008,41,47,2184.63,4149.00,0.00
2024-12-10 17:37:25,89,4008,41,48,2160.09,4149.01,0.00
2024-12-10 17:37:25,88,4008,41,47,2182.76,4149.05,0.00
2024-12-10 17:37:25,87,4008,40,47,2172.29,4149.55,0.00
2024-12-10 17:37:25,87,4009,40,47,2197.90,4150.00,0.00
2024-12-10 17:37:25,88,4009,40,48,2172.92,4150.01,0.00
2024-12-10 17:37:25,87,4009,40,47,2186.46,4150.05,0.00
2024-12-10 17:37:25,86,4009,39,47,2205.67,4150.20,0.00
2024-12-10 17:37:25,85,4009,38,47,2210.86,4150.69,0.00
2024-12-10 17:37:25,85,4010,38,47,2222.03,4151.00,0.00
2024-12-10 17:37:25,86,4010,39,47,2196.19,4151.01,0.00
2024-12-10 17:37:25,86,4011,39,47,2181.05,4152.00,0.00
2024-12-10 17:37:25,87,4011,39,48,2155.99,4152.01,0.00
2024-12-10 17:37:25,88,4010,39,49,2111.75,4152.28,0.00
2024-12-10 17:37:26,87,4010,38,49,2128.79,4152.72,0.00
2024-12-10 17:37:26,87,4011,38,49,2158.96,4153.00,0.00
2024-12-10 17:37:26,88,4011,38,50,2134.43,4153.01,0.00
2024-12-10 17:37:26,88,4012,38,50,2153.98,4154.00,0.00
2024-12-10 17:37:26,89,4012,38,51,2129.78,4154.01,0.00
2024-12-10 17:37:26,88,4012,38,50,2148.32,4154.05,0.00
2024-12-10 17:37:26,87,4012,37,50,2164.02,4154.26,0.00
2024-12-10 17:37:26,86,4012,36,50,2139.58,4154.88,0.00
2024-12-10 17:37:26,86,4013,36,50,2160.43,4155.00,0.00
2024-12-10 17:37:26,87,4013,37,50,2135.60,4155.01,0.00
2024-12-10 17:37:26,86,4013,36,50,2128.51,4155.36,0.00
2024-12-10 17:37:26,86,4014,36,50,2127.79,4156.00,0.00
2024-12-10 17:37:26,87,4014,36,51,2103.33,4156.01,0.00
2024-12-10 17:37:26,86,4014,36,50,2117.65,4156.06,0.00
2024-12-10 17:37:26,85,4014,35,50,2133.35,4156.27,0.00
2024-12-10 17:37:26,84,4014,34,50,2144.67,4156.61,0.00
2024-12-10 17:37:26,83,4014,33,50,2167.30,4156.65,0.00
2024-12-10 17:37:26,83,4015,33,50,2178.92,4157.00,0.00
2024-12-10 17:37:26,84,4015,34,50,2152.98,4157.01,0.00
2024-12-10 17:37:26,83,4015,34,49,2168.41,4157.06,0.00
2024-12-10 17:37:26,82,4015,33,49,2184.15,4157.23,0.00
2024-12-10 17:37:26,81,4015,32,49,2209.59,4157.26,0.00
2024-12-10 17:37:26,81,4016,32,49,2225.34,4158.00,0.00
2024-12-10 17:37:26,82,4016,32,50,2198.21,4158.01,0.00
2024-12-10 17:37:26,81,4016,32,49,2224.83,4158.01,0.00
2024-12-10 17:37:26,80,4016,32,48,2241.74,4158.05,0.00
2024-12-10 17:37:26,80,4017,32,48,2221.81,4159.00,0.00
2024-12-10 17:37:26,81,4017,33,48,2194.38,4159.01,0.00
2024-12-10 17:37:26,80,4017,33,47,2220.78,4159.03,0.00
2024-12-10 17:37:26,79,4017,33,46,2237.31,4159.05,0.00
2024-12-10 17:37:26,80,4016,34,46,2192.36,4159.49,0.00
2024-12-10 17:37:26,79,4016,33,46,2219.13,4159.58,0.00
2024-12-10 17:37:26,79,4017,33,46,2235.83,4160.00,0.00
2024-12-10 17:37:26,80,4017,34,46,2207.89,4160.01,0.00
2024-12-10 17:37:26,79,4017,33,46,2176.91,4160.68,0.00
2024-12-10 17:37:26,78,4017,32,46,2187.42,4160.80,0.00
2024-12-10 17:37:26,78,4018,32,46,2284.18,4161.00,0.00
2024-12-10 17:37:26,79,4018,32,47,2255.27,4161.01,0.00
2024-12-10 17:37:26,78,4018,32,46,2280.99,4161.05,0.00
2024-12-10 17:37:26,77,4018,31,46,2277.47,4161.78,0.00
2024-12-10 17:37:26,77,4019,31,46,2299.69,4162.00,0.00
2024-12-10 17:37:26,78,4019,32,46,2270.21,4162.01,0.00
2024-12-10 17:37:26,78,4020,32,46,2248.45,4163.00,0.00
2024-12-10 17:37:26,79,4020,33,46,2219.99,4163.01,0.00
2024-12-10 17:37:26,78,4020,33,45,2245.79,4163.05,0.00
2024-12-10 17:37:26,77,4020,32,45,2267.46,4163.23,0.00
2024-12-10 17:37:26,77,4021,32,45,2265.03,4164.00,0.00
2024-12-10 17:37:26,78,4021,33,45,2235.99,4164.01,0.00
2024-12-10 17:37:26,77,4021,33,44,2259.63,4164.03,0.00
2024-12-10 17:37:26,76,4021,32,44,2285.01,4164.12,0.00
2024-12-10 17:37:26,75,4021,31,44,2311.36,4164.21,0.00
2024-12-10 17:37:26,74,4021,30,44,2335.30,4164.30,0.00
2024-12-10 17:37:26,75,4020,31,44,2300.33,4164.41,0.00
2024-12-10 17:37:26,76,4019,31,45,2270.30,4164.84,0.00
2024-12-10 17:37:26,76,4020,31,45,2324.68,4165.00,0.00
2024-12-10 17:37:26,77,4020,31,46,2294.49,4165.01,0.00
2024-12-10 17:37:26,76,4020,31,45,2318.11,4165.03,0.00
2024-12-10 17:37:26,75,4020,30,45,2341.87,4165.20,0.00
2024-12-10 17:37:26,74,4020,30,44,2342.72,4165.70,0.00
2024-12-10 17:37:26,74,4021,30,44,2476.92,4166.00,0.00
2024-12-10 17:37:26,75,4021,30,45,2443.89,4166.01,0.00
2024-12-10 17:37:26,74,4021,30,44,2465.10,4166.03,0.00
2024-12-10 17:37:26,74,4022,30,44,2445.04,4167.00,0.00
2024-12-10 17:37:26,75,4022,30,45,2412.44,4167.01,0.00
2024-12-10 17:37:26,74,4022,30,44,2433.22,4167.03,0.00
2024-12-10 17:37:26,73,4022,29,44,2459.77,4167.19,0.00
2024-12-10 17:37:26,72,4022,28,44,2473.21,4167.65,0.00
2024-12-10 17:37:26,71,4022,27,44,2488.28,4167.92,0.00
2024-12-10 17:37:26,71,4023,27,44,2543.53,4168.00,0.00
2024-12-10 17:37:26,72,4023,27,45,2508.20,4168.01,0.00
2024-12-10 17:37:26,73,4022,28,45,2439.30,4168.60,0.00
2024-12-10 17:37:26,73,4023,28,45,2483.55,4169.00,0.00
2024-12-10 17:37:26,74,4023,29,45,2449.98,4169.01,0.00
2024-12-10 17:37:26,73,4023,28,45,2424.03,4169.78,0.00
2024-12-10 17:37:26,73,4024,28,45,2529.30,4170.00,0.00
2024-12-10 17:37:26,74,4024,29,45,2495.12,4170.01,0.00
2024-12-10 17:37:26,73,4024,29,44,2516.74,4170.03,0.00
2024-12-10 17:37:26,73,4025,29,44,2511.05,4171.00,0.00
2024-12-10 17:37:26,74,4025,29,45,2477.12,4171.01,0.00
2024-12-10 17:37:26,73,4025,29,44,2500.20,4171.03,0.00
2024-12-10 17:37:26,73,4026,29,44,2494.51,4172.00,0.00
2024-12-10 17:37:26,74,4026,30,44,2460.80,4172.01,0.00
2024-12-10 17:37:26,73,4026,30,43,2483.66,4172.03,0.00
2024-12-10 17:37:26,72,4026,29,43,2487.90,4172.68,0.00
2024-12-10 17:37:26,72,4027,29,43,2532.78,4173.00,0.00
2024-12-10 17:37:26,73,4027,29,44,2498.08,4173.01,0.00
2024-12-10 17:37:26,72,4027,29,43,2521.78,4173.03,0.00
2024-12-10 17:37:26,73,4026,29,44,2458.46,4173.75,0.00
2024-12-10 17:37:26,73,4027,29,44,2536.99,4174.00,0.00
2024-12-10 17:37:26,74,4027,29,45,2502.71,4174.01,0.00
2024-12-10 17:37:26,73,4027,29,44,2525.57,4174.04,0.00
2024-12-10 17:37:26,73,4028,29,44,2577.63,4175.00,0.00
2024-12-10 17:37:26,74,4028,29,45,2542.80,4175.01,0.00
2024-12-10 17:37:26,74,4029,29,45,2524.79,4176.00,0.00
2024-12-10 17:37:26,75,4029,29,46,2491.12,4176.01,0.00
2024-12-10 17:37:26,74,4029,29,45,2520.87,4176.07,0.00
2024-12-10 17:37:26,74,4030,29,45,2516.36,4177.00,0.00
2024-12-10 17:37:26,75,4030,29,46,2482.81,4177.01,0.00
2024-12-10 17:37:26,76,4029,29,47,2425.54,4177.37,0.00
2024-12-10 17:37:26,76,4030,29,47,2457.87,4178.00,0.00
2024-12-10 17:37:26,77,4030,30,47,2425.95,4178.01,0.00
2024-12-10 17:37:26,76,4030,30,46,2452.96,4178.08,0.00
2024-12-10 17:37:26,76,4031,30,46,2503.00,4179.00,0.00
2024-12-10 17:37:26,77,4031,31,46,2470.49,4179.01,0.00
2024-12-10 17:37:26,76,4031,30,46,2459.23,4179.50,0.00
2024-12-10 17:37:26,77,4030,30,47,2424.09,4179.60,0.00
2024-12-10 17:37:26,78,4029,31,47,2400.62,4179.77,0.00
2024-12-10 17:37:26,78,4030,31,47,2473.70,4180.00,0.00
2024-12-10 17:37:26,79,4030,31,48,2442.39,4180.01,0.00
2024-12-10 17:37:26,78,4030,31,47,2466.23,4180.09,0.00
2024-12-10 17:37:26,78,4031,31,47,2568.10,4181.00,0.00
2024-12-10 17:37:26,79,4031,31,48,2535.59,4181.01,0.00
2024-12-10 17:37:26,78,4031,30,48,2536.61,4181.35,0.00
2024-12-10 17:37:26,78,4032,30,48,2563.35,4182.00,0.00
2024-12-10 17:37:27,79,4032,30,49,2530.90,4182.01,0.00
2024-12-10 17:37:27,78,4032,30,48,2556.41,4182.09,0.00
2024-12-10 17:37:27,78,4033,30,48,2551.09,4183.00,0.00
2024-12-10 17:37:27,79,4033,30,49,2518.80,4183.01,0.00
2024-12-10 17:37:27,78,4033,29,49,2512.82,4183.67,0.00
2024-12-10 17:37:27,78,4034,29,49,2531.32,4184.00,0.00
2024-12-10 17:37:27,79,4034,30,49,2499.28,4184.01,0.00
2024-12-10 17:37:27,78,4034,30,48,2524.91,4184.09,0.00
2024-12-10 17:37:27,77,4034,29,48,2533.56,4184.66,0.00
2024-12-10 17:37:27,76,4034,28,48,2548.92,4184.91,0.00
2024-12-10 17:37:27,76,4035,28,48,2600.21,4185.00,0.00
2024-12-10 17:37:27,77,4035,28,49,2566.44,4185.01,0.00
2024-12-10 17:37:27,77,4036,28,49,2547.48,4186.00,0.00
2024-12-10 17:37:27,78,4036,29,49,2514.82,4186.01,0.00
2024-12-10 17:37:27,77,4036,29,48,2540.44,4186.09,0.00
2024-12-10 17:37:27,77,4037,29,48,2535.58,4187.00,0.00
2024-12-10 17:37:27,78,4037,29,49,2503.07,4187.01,0.00
2024-12-10 17:37:27,77,4037,28,49,2515.54,4187.23,0.00
2024-12-10 17:37:27,76,4037,27,49,2548.09,4187.24,0.00
2024-12-10 17:37:27,75,4037,26,49,2541.82,4187.97,0.00
2024-12-10 17:37:27,75,4038,26,49,2596.56,4188.00,0.00
2024-12-10 17:37:27,76,4038,26,50,2562.39,4188.01,0.00
2024-12-10 17:37:27,75,4038,26,49,2589.33,4188.09,0.00
2024-12-10 17:37:27,75,4039,26,49,2585.45,4189.00,0.00
2024-12-10 17:37:27,76,4039,26,50,2551.43,4189.01,0.00
2024-12-10 17:37:27,76,4040,26,50,2532.74,4190.00,0.00
2024-12-10 17:37:27,77,4040,27,50,2499.85,4190.01,0.00
2024-12-10 17:37:27,78,4039,27,51,2467.80,4190.04,0.00
2024-12-10 17:37:27,77,4039,27,50,2520.56,4190.10,0.00
2024-12-10 17:37:27,78,4038,27,51,2478.67,4190.36,0.00
2024-12-10 17:37:27,78,4039,27,51,2511.91,4191.00,0.00
2024-12-10 17:37:27,79,4039,28,51,2480.12,4191.01,0.00
2024-12-10 17:37:27,78,4039,28,50,2510.85,4191.03,0.00
2024-12-10 17:37:27,77,4039,27,50,2502.72,4191.22,0.00
2024-12-10 17:37:27,77,4040,27,50,2633.88,4192.00,0.00
2024-12-10 17:37:27,78,4040,27,51,2600.11,4192.01,0.00
2024-12-10 17:37:27,77,4040,27,50,2627.38,4192.05,0.00
2024-12-10 17:37:27,77,4041,27,50,2620.90,4193.00,0.00
2024-12-10 17:37:27,78,4041,27,51,2587.29,4193.01,0.00
2024-12-10 17:37:27,77,4041,27,50,2616.57,4193.07,0.00
2024-12-10 17:37:27,77,4042,27,50,2610.63,4194.00,0.00
2024-12-10 17:37:27,78,4042,28,50,2577.16,4194.01,0.00
2024-12-10 17:37:27,78,4043,28,50,2557.87,4195.00,0.00
2024-12-10 17:37:27,79,4043,29,50,2525.50,4195.01,0.00
2024-12-10 17:37:27,78,4043,29,49,2554.14,4195.06,0.00
2024-12-10 17:37:27,79,4042,29,50,2500.82,4195.60,0.00
2024-12-10 17:37:27,79,4043,29,50,2530.35,4196.00,0.00
2024-12-10 17:37:27,80,4043,30,50,2498.72,4196.01,0.00
2024-12-10 17:37:27,81,4042,30,51,2466.85,4196.06,0.00
2024-12-10 17:37:27,80,4042,29,51,2506.15,4196.21,0.00
2024-12-10 17:37:27,80,4043,29,51,2557.55,4197.00,0.00
2024-12-10 17:37:27,81,4043,29,52,2525.97,4197.01,0.00
2024-12-10 17:37:27,80,4043,29,51,2553.38,4197.06,0.00
2024-12-10 17:37:27,80,4044,29,51,2598.56,4198.00,0.00
2024-12-10 17:37:27,81,4044,30,51,2566.48,4198.01,0.00
2024-12-10 17:37:27,80,4044,29,51,2567.32,4198.49,0.00
2024-12-10 17:37:27,81,4043,30,51,2532.56,4198.58,0.00
2024-12-10 17:37:27,81,4044,30,51,2602.34,4199.00,0.00
2024-12-10 17:37:27,82,4044,30,52,2570.61,4199.01,0.00
2024-12-10 17:37:27,81,4044,30,51,2598.74,4199.06,0.00
2024-12-10 17:37:27,82,4043,31,51,2554.90,4199.38,0.00
2024-12-10 17:37:27,82,4044,31,51,2634.22,4200.00,0.00
2024-12-10 17:37:27,83,4044,31,52,2602.48,4200.01,0.00
2024-12-10 17:37:27,83,4045,31,52,2643.60,4201.00,0.00
2024-12-10 17:37:27,84,4045,32,52,2612.13,4201.01,0.00
2024-12-10 17:37:27,84,4046,32,52,2594.45,4202.00,0.00
2024-12-10 17:37:27,85,4046,33,52,2563.93,4202.01,0.00
2024-12-10 17:37:27,86,4045,34,52,2519.51,4202.15,0.00
2024-12-10 17:37:27,85,4045,33,52,2556.13,4202.26,0.00
2024-12-10 17:37:27,85,4046,33,52,2555.15,4203.00,0.00
2024-12-10 17:37:27,86,4046,34,52,2525.44,4203.01,0.00
2024-12-10 17:37:27,85,4046,34,51,2552.21,4203.06,0.00
2024-12-10 17:37:27,85,4047,34,51,2592.35,4204.00,0.00
2024-12-10 17:37:27,86,4047,35,51,2562.21,4204.01,0.00
2024-12-10 17:37:27,86,4048,35,51,2522.48,4205.00,0.00
2024-12-10 17:37:27,87,4048,36,51,2493.49,4205.01,0.00
2024-12-10 17:37:27,86,4048,35,51,2520.55,4205.05,0.00
2024-12-10 17:37:27,85,4048,34,51,2479.93,4205.98,0.00
2024-12-10 17:37:27,85,4049,34,51,2509.65,4206.00,0.00
2024-12-10 17:37:27,86,4049,35,51,2480.47,4206.01,0.00
2024-12-10 17:37:27,85,4049,35,50,2501.26,4206.05,0.00
2024-12-10 17:37:27,85,4050,35,50,2491.44,4207.00,0.00
2024-12-10 17:37:27,86,4050,36,50,2462.47,4207.01,0.00
2024-12-10 17:37:27,85,4050,36,49,2481.56,4207.05,0.00
2024-12-10 17:37:27,84,4050,35,49,2484.41,4207.69,0.00
2024-12-10 17:37:27,83,4050,34,49,2506.65,4207.88,0.00
2024-12-10 17:37:27,83,4051,34,49,2532.08,4208.00,0.00
2024-12-10 17:37:27,84,4051,34,50,2501.94,4208.01,0.00
2024-12-10 17:37:27,85,4050,34,51,2471.53,4208.06,0.00
2024-12-10 17:37:27,84,4050,34,50,2497.96,4208.06,0.00
2024-12-10 17:37:27,83,4050,33,50,2511.83,4208.07,0.00
2024-12-10 17:37:27,83,4051,33,50,2503.78,4209.00,0.00
2024-12-10 17:37:27,84,4051,34,50,2473.97,4209.01,0.00
2024-12-10 17:37:27,83,4051,34,49,2493.66,4209.05,0.00
2024-12-10 17:37:27,83,4052,34,49,2535.32,4210.00,0.00
2024-12-10 17:37:27,84,4052,35,49,2505.13,4210.01,0.00
2024-12-10 17:37:27,83,4052,34,49,2508.47,4210.08,0.00
2024-12-10 17:37:27,83,4053,34,49,2521.20,4211.00,0.00
2024-12-10 17:37:27,84,4053,35,49,2491.19,4211.01,0.00
2024-12-10 17:37:27,83,4053,35,48,2518.70,4211.06,0.00
2024-12-10 17:37:27,82,4053,34,48,2521.54,4211.72,0.00
2024-12-10 17:37:27,82,4054,34,48,2540.74,4212.00,0.00
2024-12-10 17:37:27,83,4054,35,48,2510.13,4212.01,0.00
2024-12-10 17:37:27,84,4053,36,48,2444.97,4212.64,0.00
2024-12-10 17:37:27,84,4054,36,48,2473.32,4213.00,0.00
2024-12-10 17:37:27,85,4054,36,49,2444.22,4213.01,0.00
2024-12-10 17:37:27,84,4054,36,48,2470.34,4213.06,0.00
2024-12-10 17:37:27,85,4053,36,49,2429.01,4213.38,0.00
2024-12-10 17:37:28,85,4054,36,49,2490.88,4214.00,0.00
2024-12-10 17:37:28,86,4054,37,49,2461.91,4214.01,0.00
2024-12-10 17:37:28,86,4055,37,49,2489.16,4215.00,0.00
2024-12-10 17:37:28,87,4055,38,49,2460.55,4215.01,0.00
2024-12-10 17:37:28,86,4055,38,48,2485.76,4215.06,0.00
2024-12-10 17:37:28,86,4056,38,48,2475.50,4216.00,0.00
2024-12-10 17:37:28,87,4056,39,48,2447.04,4216.01,0.00
2024-12-10 17:37:28,87,4057,39,48,2432.64,4217.00,0.00
2024-12-10 17:37:28,88,4057,39,49,2405.00,4217.01,0.00
2024-12-10 17:37:28,89,4056,40,49,2364.28,4217.14,0.00
2024-12-10 17:37:28,89,4057,40,49,2391.31,4218.00,0.00
2024-12-10 17:37:28,90,4057,40,50,2364.74,4218.01,0.00
2024-12-10 17:37:28,89,4057,40,49,2383.29,4218.08,0.00
2024-12-10 17:37:28,89,4058,40,49,2420.09,4219.00,0.00
2024-12-10 17:37:28,90,4058,40,50,2393.20,4219.01,0.00
2024-12-10 17:37:28,89,4058,39,50,2365.19,4219.66,0.00
2024-12-10 17:37:28,89,4059,39,50,2398.61,4220.00,0.00
2024-12-10 17:37:28,90,4059,39,51,2371.96,4220.01,0.00
2024-12-10 17:37:28,89,4059,39,50,2387.73,4220.06,0.00
2024-12-10 17:37:28,89,4060,39,50,2376.43,4221.00,0.00
2024-12-10 17:37:28,90,4060,39,51,2350.03,4221.01,0.00
2024-12-10 17:37:28,89,4060,39,50,2368.42,4221.11,0.00
2024-12-10 17:37:28,88,4060,38,50,2390.11,4221.24,0.00
2024-12-10 17:37:28,87,4060,37,50,2382.66,4221.66,0.00
2024-12-10 17:37:28,87,4061,37,50,2416.86,4222.00,0.00
2024-12-10 17:37:28,88,4061,37,51,2389.40,4222.01,0.00
2024-12-10 17:37:28,87,4061,36,51,2365.24,4222.63,0.00
2024-12-10 17:37:28,87,4062,36,51,2398.50,4223.00,0.00
2024-12-10 17:37:28,88,4062,36,52,2371.25,4223.01,0.00
2024-12-10 17:37:28,87,4062,35,52,2387.38,4223.07,0.00
2024-12-10 17:37:28,86,4062,34,52,2378.14,4223.72,0.00
2024-12-10 17:37:28,86,4063,34,52,2415.67,4224.00,0.00
2024-12-10 17:37:28,87,4063,34,53,2387.90,4224.01,0.00
2024-12-10 17:37:28,86,4063,34,52,2407.86,4224.12,0.00
2024-12-10 17:37:28,85,4063,33,52,2414.86,4224.20,0.00
2024-12-10 17:37:28,85,4064,33,52,2431.25,4225.00,0.00
2024-12-10 17:37:28,86,4064,34,52,2402.98,4225.01,0.00
2024-12-10 17:37:28,86,4065,34,52,2390.59,4226.00,0.00
2024-12-10 17:37:28,87,4065,35,52,2363.11,4226.01,0.00
2024-12-10 17:37:28,88,4064,35,53,2335.79,4226.05,0.00
2024-12-10 17:37:28,88,4065,35,53,2352.25,4227.00,0.00
2024-12-10 17:37:28,89,4065,35,54,2325.82,4227.01,0.00
2024-12-10 17:37:28,88,4065,35,53,2341.74,4227.11,0.00
2024-12-10 17:37:28,87,4065,34,53,2344.62,4227.69,0.00
2024-12-10 17:37:28,87,4066,34,53,2409.47,4228.00,0.00
2024-12-10 17:37:28,88,4066,35,53,2382.09,4228.01,0.00
2024-12-10 17:37:28,88,4067,35,53,2373.19,4229.00,0.00
2024-12-10 17:37:28,89,4067,36,53,2346.52,4229.01,0.00
2024-12-10 17:37:28,88,4067,36,52,2368.92,4229.10,0.00
2024-12-10 17:37:28,89,4066,37,52,2290.75,4229.87,0.00
2024-12-10 17:37:28,89,4067,37,52,2337.92,4230.00,0.00
2024-12-10 17:37:28,90,4067,37,53,2311.95,4230.01,0.00
2024-12-10 17:37:28,90,4068,37,53,2337.69,4231.00,0.00
2024-12-10 17:37:28,91,4068,37,54,2312.00,4231.01,0.00
2024-12-10 17:37:28,90,4068,37,53,2329.29,4231.11,0.00
2024-12-10 17:37:28,89,4068,36,53,2330.07,4231.72,0.00
2024-12-10 17:37:28,89,4069,36,53,2346.92,4232.00,0.00
2024-12-10 17:37:28,90,4069,36,54,2320.85,4232.01,0.00
2024-12-10 17:37:28,90,4070,36,54,2298.35,4233.00,0.00
2024-12-10 17:37:28,91,4070,37,54,2273.09,4233.01,0.00
2024-12-10 17:37:28,90,4070,37,53,2293.23,4233.11,0.00
2024-12-10 17:37:28,89,4070,36,53,2318.05,4233.12,0.00
2024-12-10 17:37:28,88,4070,35,53,2338.66,4233.26,0.00
2024-12-10 17:37:28,87,4070,34,53,2330.81,4233.90,0.00
2024-12-10 17:37:28,87,4071,34,53,2375.18,4234.00,0.00
2024-12-10 17:37:28,88,4071,34,54,2348.19,4234.01,0.00
2024-12-10 17:37:28,87,4071,33,54,2359.02,4234.14,0.00
2024-12-10 17:37:28,87,4072,33,54,2371.09,4235.00,0.00
2024-12-10 17:37:28,88,4072,34,54,2344.15,4235.01,0.00
2024-12-10 17:37:28,87,4072,34,53,2365.79,4235.12,0.00
2024-12-10 17:37:28,86,4072,33,53,2388.89,4235.22,0.00
2024-12-10 17:37:28,86,4073,33,53,2384.28,4236.00,0.00
2024-12-10 17:37:28,87,4073,34,53,2356.88,4236.01,0.00
2024-12-10 17:37:28,88,4072,35,53,2315.23,4236.16,0.00
2024-12-10 17:37:28,88,4073,35,53,2340.61,4237.00,0.00
2024-12-10 17:37:28,89,4073,36,53,2314.31,4237.01,0.00
2024-12-10 17:37:28,88,4073,36,52,2332.96,4237.10,0.00
2024-12-10 17:37:28,89,4072,36,53,2292.60,4237.46,0.00
2024-12-10 17:37:28,88,4072,35,53,2326.20,4237.55,0.00
2024-12-10 17:37:28,88,4073,35,53,2399.79,4238.00,0.00
2024-12-10 17:37:28,89,4073,35,54,2372.83,4238.01,0.00
2024-12-10 17:37:28,88,4073,35,53,2385.87,4238.10,0.00
2024-12-10 17:37:28,87,4073,34,53,2387.69,4238.71,0.00
2024-12-10 17:37:28,87,4074,34,53,2449.02,4239.00,0.00
2024-12-10 17:37:28,88,4074,35,53,2421.19,4239.01,0.00
2024-12-10 17:37:28,88,4075,35,53,2393.90,4240.00,0.00
2024-12-10 17:37:28,89,4075,35,54,2367.01,4240.01,0.00
2024-12-10 17:37:28,88,4075,34,54,2391.05,4240.07,0.00
2024-12-10 17:37:28,87,4075,34,53,2416.59,4240.09,0.00
2024-12-10 17:37:28,86,4075,33,53,2437.36,4240.27,0.00
2024-12-10 17:37:28,86,4076,33,53,2430.56,4241.00,0.00
2024-12-10 17:37:28,87,4076,34,53,2402.62,4241.01,0.00
2024-12-10 17:37:28,87,4077,34,53,2390.42,4242.00,0.00
2024-12-10 17:37:28,88,4077,35,53,2363.26,4242.01,0.00
2024-12-10 17:37:28,88,4078,35,53,2349.09,4243.00,0.00
2024-12-10 17:37:28,89,4078,35,54,2322.70,4243.01,0.00
2024-12-10 17:37:28,89,4079,35,54,2304.43,4244.00,0.00
2024-12-10 17:37:28,90,4079,36,54,2278.82,4244.01,0.00
2024-12-10 17:37:28,89,4079,36,53,2259.43,4244.83,0.00
2024-12-10 17:37:29,89,4080,36,53,2283.46,4245.00,0.00
2024-12-10 17:37:29,90,4080,36,54,2258.09,4245.01,0.00
2024-12-10 17:37:29,91,4079,36,55,2232.82,4245.04,0.00
2024-12-10 17:37:29,90,4079,36,54,2258.14,4245.10,0.00
2024-12-10 17:37:29,89,4079,35,54,2281.55,4245.15,0.00
2024-12-10 17:37:29,88,4079,34,54,2291.32,4245.52,0.00
2024-12-10 17:37:29,88,4080,34,54,2300.34,4246.00,0.00
2024-12-10 17:37:29,89,4080,35,54,2274.49,4246.01,0.00
2024-12-10 17:37:29,88,4080,35,53,2287.35,4246.09,0.00
2024-12-10 17:37:29,87,4080,34,53,2290.61,4246.24,0.00
2024-12-10 17:37:29,87,4081,34,53,2356.47,4247.00,0.00
2024-12-10 17:37:29,88,4081,34,54,2329.70,4247.01,0.00
2024-12-10 17:37:29,89,4080,35,54,2301.64,4247.08,0.00
2024-12-10 17:37:29,88,4080,34,54,2353.87,4247.09,0.00
2024-12-10 17:37:29,87,4080,34,53,2371.17,4247.09,0.00
2024-12-10 17:37:29,88,4079,35,53,2330.92,4247.41,0.00
2024-12-10 17:37:29,89,4078,36,53,2328.13,4247.44,0.00
2024-12-10 17:37:29,88,4078,35,53,2376.88,4247.60,0.00
2024-12-10 17:37:29,87,4078,34,53,2389.42,4247.94,0.00
2024-12-10 17:37:29,87,4079,34,53,2435.85,4248.00,0.00
2024-12-10 17:37:29,88,4079,35,53,2408.17,4248.01,0.00
2024-12-10 17:37:29,88,4080,35,53,2539.48,4249.00,0.00
2024-12-10 17:37:29,89,4080,36,53,2510.94,4249.01,0.00
2024-12-10 17:37:29,90,4079,37,53,2466.70,4249.18,0.00
2024-12-10 17:37:29,89,4079,36,53,2501.60,4249.74,0.00
2024-12-10 17:37:29,90,4078,37,53,2473.80,4249.76,0.00
2024-12-10 17:37:29,90,4079,37,53,2504.20,4250.00,0.00
2024-12-10 17:37:29,91,4079,38,53,2476.69,4250.01,0.00
2024-12-10 17:37:29,90,4079,37,53,2481.67,4250.30,0.00
2024-12-10 17:37:29,90,4080,37,53,2567.25,4251.00,0.00
2024-12-10 17:37:29,91,4080,37,54,2539.04,4251.01,0.00
2024-12-10 17:37:29,90,4080,37,53,2563.04,4251.08,0.00
2024-12-10 17:37:29,90,4081,37,53,2539.86,4252.00,0.00
2024-12-10 17:37:29,91,4081,38,53,2511.95,4252.01,0.00
2024-12-10 17:37:29,90,4081,38,52,2529.04,4252.08,0.00
2024-12-10 17:37:29,91,4080,38,53,2501.24,4252.10,0.00
2024-12-10 17:37:29,90,4080,37,53,2528.14,4252.69,0.00
2024-12-10 17:37:29,90,4081,37,53,2535.48,4253.00,0.00
2024-12-10 17:37:29,91,4081,38,53,2507.62,4253.01,0.00
2024-12-10 17:37:29,90,4081,38,52,2522.06,4253.09,0.00
2024-12-10 17:37:29,89,4081,37,52,2497.96,4253.66,0.00
2024-12-10 17:37:29,89,4082,37,52,2567.37,4254.00,0.00
2024-12-10 17:37:29,90,4082,37,53,2538.84,4254.01,0.00
2024-12-10 17:37:29,89,4082,37,52,2552.53,4254.09,0.00
2024-12-10 17:37:29,88,4082,36,52,2530.24,4254.73,0.00
2024-12-10 17:37:29,88,4083,36,52,2560.23,4255.00,0.00
2024-12-10 17:37:29,89,4083,36,53,2531.46,4255.01,0.00
2024-12-10 17:37:29,88,4083,36,52,2545.40,4255.09,0.00
2024-12-10 17:37:29,88,4084,36,52,2519.74,4256.00,0.00
2024-12-10 17:37:29,89,4084,37,52,2491.43,4256.01,0.00
2024-12-10 17:37:29,88,4084,37,51,2504.44,4256.09,0.00
2024-12-10 17:37:29,88,4085,37,51,2477.00,4257.00,0.00
2024-12-10 17:37:29,89,4085,38,51,2449.17,4257.01,0.00
2024-12-10 17:37:29,88,4085,38,50,2436.22,4257.64,0.00
2024-12-10 17:37:29,88,4086,38,50,2454.19,4258.00,0.00
2024-12-10 17:37:29,89,4086,38,51,2426.62,4258.01,0.00
2024-12-10 17:37:29,88,4086,37,51,2403.16,4258.90,0.00
2024-12-10 17:37:29,88,4087,37,51,2437.38,4259.00,0.00
2024-12-10 17:37:29,89,4087,38,51,2409.99,4259.01,0.00
2024-12-10 17:37:29,89,4088,38,51,2386.58,4260.00,0.00
2024-12-10 17:37:29,90,4088,39,51,2360.07,4260.01,0.00
2024-12-10 17:37:29,91,4087,39,52,2332.74,4260.07,0.00
2024-12-10 17:37:29,92,4086,39,53,2313.86,4260.27,0.00
2024-12-10 17:37:29,92,4087,39,53,2313.99,4261.00,0.00
2024-12-10 17:37:29,93,4087,40,53,2289.11,4261.01,0.00
2024-12-10 17:37:29,92,4087,40,52,2303.19,4261.09,0.00
2024-12-10 17:37:29,92,4088,40,52,2375.98,4262.00,0.00
2024-12-10 17:37:29,93,4088,41,52,2350.44,4262.01,0.00
2024-12-10 17:37:29,92,4088,41,51,2360.62,4262.10,0.00
2024-12-10 17:37:29,93,4087,41,52,2327.51,4262.30,0.00
2024-12-10 17:37:29,92,4087,40,52,2358.39,4262.33,0.00
2024-12-10 17:37:29,92,4088,40,52,2333.55,4263.00,0.00
2024-12-10 17:37:29,93,4088,40,53,2308.46,4263.01,0.00
2024-12-10 17:37:29,92,4088,40,52,2299.29,4263.10,0.00
2024-12-10 17:37:29,91,4088,40,51,2291.04,4263.86,0.00
2024-12-10 17:37:29,91,4089,40,51,2362.63,4264.00,0.00
2024-12-10 17:37:29,92,4089,41,51,2336.95,4264.01,0.00
2024-12-10 17:37:29,91,4089,41,50,2347.35,4264.09,0.00
2024-12-10 17:37:29,90,4089,40,50,2357.89,4264.37,0.00
2024-12-10 17:37:29,89,4089,40,49,2344.36,4264.94,0.00
2024-12-10 17:37:29,89,4090,40,49,2389.93,4265.00,0.00
2024-12-10 17:37:29,90,4090,40,50,2363.38,4265.01,0.00
2024-12-10 17:37:29,89,4090,39,50,2384.74,4265.08,0.00
2024-12-10 17:37:29,88,4090,39,49,2404.57,4265.08,0.00
2024-12-10 17:37:29,87,4090,38,49,2402.97,4265.52,0.00
2024-12-10 17:37:29,87,4091,38,49,2431.76,4266.00,0.00
2024-12-10 17:37:29,88,4091,38,50,2404.13,4266.01,0.00
2024-12-10 17:37:29,87,4091,38,49,2421.50,4266.08,0.00
2024-12-10 17:37:29,86,4091,37,49,2440.81,4266.29,0.00
2024-12-10 17:37:29,86,4092,37,49,2440.77,4267.00,0.00
2024-12-10 17:37:29,87,4092,37,50,2412.71,4267.01,0.00
2024-12-10 17:37:29,86,4092,37,49,2430.38,4267.08,0.00
2024-12-10 17:37:29,85,4092,36,49,2445.51,4267.33,0.00
2024-12-10 17:37:29,85,4093,36,49,2467.55,4268.00,0.00
2024-12-10 17:37:29,86,4093,37,49,2438.86,4268.01,0.00
2024-12-10 17:37:29,85,4093,37,48,2457.04,4268.08,0.00
2024-12-10 17:37:29,85,4094,37,48,2448.54,4269.00,0.00
2024-12-10 17:37:29,86,4094,37,49,2420.07,4269.01,0.00
2024-12-10 17:37:29,85,4094,37,48,2438.03,4269.08,0.00
2024-12-10 17:37:29,84,4094,36,48,2457.48,4269.30,0.00
2024-12-10 17:37:29,85,4093,37,48,2412.23,4269.71,0.00
2024-12-10 17:37:29,85,4094,37,48,2440.58,4270.00,0.00
2024-12-10 17:37:29,86,4094,38,48,2412.20,4270.01,0.00
2024-12-10 17:37:29,86,4095,38,48,2444.82,4271.00,0.00
2024-12-10 17:37:29,87,4095,38,49,2416.72,4271.01,0.00
2024-12-10 17:37:29,87,4096,38,49,2394.70,4272.00,0.00
2024-12-10 17:37:29,88,4096,39,49,2367.49,4272.01,0.00
2024-12-10 17:37:29,87,4096,39,48,2391.30,4272.08,0.00
2024-12-10 17:37:29,88,4095,40,48,2334.39,4272.81,0.00
2024-12-10 17:37:30,88,4096,40,48,2368.46,4273.00,0.00
2024-12-10 17:37:30,89,4096,40,49,2341.85,4273.01,0.00
2024-12-10 17:37:30,88,4096,40,48,2358.30,4273.08,0.00
2024-12-10 17:37:30,87,4096,39,48,2372.92,4273.26,0.00
2024-12-10 17:37:30,88,4095,39,49,2336.35,4273.51,0.00
2024-12-10 17:37:30,88,4096,39,49,2429.94,4274.00,0.00
2024-12-10 17:37:30,89,4096,40,49,2402.64,4274.01,0.00
2024-12-10 17:37:30,88,4096,40,48,2419.77,4274.08,0.00
2024-12-10 17:37:30,87,4096,39,48,2402.89,4274.94,0.00
2024-12-10 17:37:30,87,4097,39,48,2498.74,4275.00,0.00
2024-12-10 17:37:30,88,4097,39,49,2470.35,4275.01,0.00
2024-12-10 17:37:30,87,4097,38,49,2498.34,4275.01,0.00
2024-12-10 17:37:30,86,4097,38,48,2516.49,4275.08,0.00
2024-12-10 17:37:30,85,4097,37,48,2504.64,4275.65,0.00
2024-12-10 17:37:30,85,4098,37,48,2540.12,4276.00,0.00
2024-12-10 17:37:30,86,4098,37,49,2510.58,4276.01,0.00
2024-12-10 17:37:30,86,4099,37,49,2503.68,4277.00,0.00
2024-12-10 17:37:30,87,4099,38,49,2474.90,4277.01,0.00
2024-12-10 17:37:30,88,4098,39,49,2388.88,4277.99,0.00
2024-12-10 17:37:30,88,4099,39,49,2437.51,4278.00,0.00
2024-12-10 17:37:30,89,4099,39,50,2410.12,4278.01,0.00
2024-12-10 17:37:30,89,4100,39,50,2440.63,4279.00,0.00
2024-12-10 17:37:30,90,4100,40,50,2413.51,4279.01,0.00
2024-12-10 17:37:30,89,4100,39,50,2409.09,4279.47,0.00
2024-12-10 17:37:30,89,4101,39,50,2434.96,4280.00,0.00
2024-12-10 17:37:30,90,4101,39,51,2407.90,4280.01,0.00
2024-12-10 17:37:30,89,4101,39,50,2431.62,4280.08,0.00
2024-12-10 17:37:30,89,4102,39,50,2421.58,4281.00,0.00
2024-12-10 17:37:30,90,4102,39,51,2394.67,4281.01,0.00
2024-12-10 17:37:30,89,4102,39,50,2412.95,4281.08,0.00
2024-12-10 17:37:30,88,4102,38,50,2417.06,4281.23,0.00
2024-12-10 17:37:30,88,4103,38,50,2433.12,4282.00,0.00
2024-12-10 17:37:30,89,4103,39,50,2405.79,4282.01,0.00
2024-12-10 17:37:30,88,4103,39,49,2424.39,4282.08,0.00
2024-12-10 17:37:30,87,4103,38,49,2404.34,4282.74,0.00
2024-12-10 17:37:30,87,4104,38,49,2442.47,4283.00,0.00
2024-12-10 17:37:30,88,4104,38,50,2414.71,4283.01,0.00
2024-12-10 17:37:30,89,4103,39,50,2386.15,4283.07,0.00
2024-12-10 17:37:30,88,4103,39,49,2423.02,4283.09,0.00
2024-12-10 17:37:30,88,4104,39,49,2413.81,4284.00,0.00
2024-12-10 17:37:30,89,4104,39,50,2386.69,4284.01,0.00
2024-12-10 17:37:30,89,4105,39,50,2424.15,4285.00,0.00
2024-12-10 17:37:30,90,4105,40,50,2397.22,4285.01,0.00
2024-12-10 17:37:30,90,4106,40,50,2379.44,4286.00,0.00
2024-12-10 17:37:30,91,4106,41,50,2353.30,4286.01,0.00
2024-12-10 17:37:30,90,4106,40,50,2331.52,4286.62,0.00
2024-12-10 17:37:30,90,4107,40,50,2363.26,4287.00,0.00
2024-12-10 17:37:30,91,4107,41,50,2337.29,4287.01,0.00
2024-12-10 17:37:30,90,4107,41,49,2359.95,4287.08,0.00
2024-12-10 17:37:30,90,4108,41,49,2349.51,4288.00,0.00
2024-12-10 17:37:30,91,4108,41,50,2323.70,4288.01,0.00
2024-12-10 17:37:30,92,4107,41,51,2298.44,4288.03,0.00
2024-12-10 17:37:30,91,4107,41,50,2334.57,4288.11,0.00
2024-12-10 17:37:30,90,4107,40,50,2350.03,4288.13,0.00
2024-12-10 17:37:30,91,4106,40,51,2314.38,4288.39,0.00
2024-12-10 17:37:30,91,4107,40,51,2342.15,4289.00,0.00
2024-12-10 17:37:30,92,4107,41,51,2316.69,4289.01,0.00
2024-12-10 17:37:30,91,4107,41,50,2339.35,4289.07,0.00
2024-12-10 17:37:30,90,4107,41,49,2358.67,4289.09,0.00
2024-12-10 17:37:30,91,4106,41,50,2294.76,4289.56,0.00
2024-12-10 17:37:30,91,4107,41,50,2433.68,4290.00,0.00
2024-12-10 17:37:30,92,4107,42,50,2407.23,4290.01,0.00
2024-12-10 17:37:30,91,4107,42,49,2420.99,4290.10,0.00
2024-12-10 17:37:30,90,4107,41,49,2418.50,4290.52,0.00
2024-12-10 17:37:30,90,4108,41,49,2493.71,4291.00,0.00
2024-12-10 17:37:30,91,4108,42,49,2466.31,4291.01,0.00
2024-12-10 17:37:30,90,4108,42,48,2481.35,4291.10,0.00
2024-12-10 17:37:30,90,4109,42,48,2471.88,4292.00,0.00
2024-12-10 17:37:30,91,4109,43,48,2444.72,4292.01,0.00
2024-12-10 17:37:30,91,4110,43,48,2421.70,4293.00,0.00
2024-12-10 17:37:30,92,4110,44,48,2395.38,4293.01,0.00
2024-12-10 17:37:30,91,4110,44,47,2417.49,4293.10,0.00
2024-12-10 17:37:30,90,4110,43,47,2437.71,4293.25,0.00
2024-12-10 17:37:30,90,4111,43,47,2434.39,4294.00,0.00
2024-12-10 17:37:30,91,4111,43,48,2407.64,4294.01,0.00
2024-12-10 17:37:30,90,4111,43,47,2421.06,4294.10,0.00
2024-12-10 17:37:30,90,4112,43,47,2411.57,4295.00,0.00
2024-12-10 17:37:30,91,4112,44,47,2385.07,4295.01,0.00
2024-12-10 17:37:30,90,4112,43,47,2398.71,4295.06,0.00
2024-12-10 17:37:30,90,4113,43,47,2396.86,4296.00,0.00
2024-12-10 17:37:30,91,4113,44,47,2370.52,4296.01,0.00
2024-12-10 17:37:30,90,4113,44,46,2392.59,4296.09,0.00
2024-12-10 17:37:30,89,4113,43,46,2412.76,4296.24,0.00
2024-12-10 17:37:30,90,4112,44,46,2383.12,4296.32,0.00
2024-12-10 17:37:30,91,4111,44,47,2372.15,4296.55,0.00
2024-12-10 17:37:30,92,4110,44,48,2348.47,4296.89,0.00
2024-12-10 17:37:30,92,4111,44,48,2375.19,4297.00,0.00
2024-12-10 17:37:30,93,4111,45,48,2349.65,4297.01,0.00
2024-12-10 17:37:30,92,4111,45,47,2372.88,4297.05,0.00
2024-12-10 17:37:30,92,4112,45,47,2491.60,4298.00,0.00
2024-12-10 17:37:30,93,4112,45,48,2464.81,4298.01,0.00
2024-12-10 17:37:30,92,4112,45,47,2487.89,4298.09,0.00
2024-12-10 17:37:30,91,4112,44,47,2478.63,4298.59,0.00
2024-12-10 17:37:30,91,4113,44,47,2508.70,4299.00,0.00
2024-12-10 17:37:30,92,4113,45,47,2481.43,4299.01,0.00
2024-12-10 17:37:30,91,4113,45,46,2495.50,4299.09,0.00
2024-12-10 17:37:30,92,4112,46,46,2452.64,4299.48,0.00
2024-12-10 17:37:30,91,4112,45,46,2492.48,4299.65,0.00
2024-12-10 17:37:30,91,4113,45,46,2524.88,4300.00,0.00
2024-12-10 17:37:30,92,4113,46,46,2497.44,4300.01,0.00
2024-12-10 17:37:30,92,4114,46,46,2520.92,4301.00,0.00
2024-12-10 17:37:30,93,4114,46,47,2493.82,4301.01,0.00
2024-12-10 17:37:30,92,4114,46,46,2516.74,4301.10,0.00
2024-12-10 17:37:30,93,4113,47,46,2485.55,4301.22,0.00
2024-12-10 17:37:30,94,4112,48,46,2445.63,4301.68,0.00
2024-12-10 17:37:30,94,4113,48,46,2469.69,4302.00,0.00
2024-12-10 17:37:30,95,4113,48,47,2443.69,4302.01,0.00
2024-12-10 17:37:31,94,4113,48,46,2456.45,4302.10,0.00
2024-12-10 17:37:31,94,4114,48,46,2537.10,4303.00,0.00
2024-12-10 17:37:31,95,4114,49,46,2510.39,4303.01,0.00
2024-12-10 17:37:31,94,4114,48,46,2534.37,4303.06,0.00
2024-12-10 17:37:31,93,4114,48,45,2550.99,4303.09,0.00
2024-12-10 17:37:31,93,4115,48,45,2539.98,4304.00,0.00
2024-12-10 17:37:31,94,4115,49,45,2512.96,4304.01,0.00
2024-12-10 17:37:31,93,4115,49,44,2527.05,4304.09,0.00
2024-12-10 17:37:31,92,4115,48,44,2525.24,4304.50,0.00
2024-12-10 17:37:31,92,4116,48,44,2550.88,4305.00,0.00
2024-12-10 17:37:31,93,4116,48,45,2523.45,4305.01,0.00
2024-12-10 17:37:31,92,4116,47,45,2520.50,4305.14,0.00
2024-12-10 17:37:31,92,4117,47,45,2530.87,4306.00,0.00
2024-12-10 17:37:31,93,4117,48,45,2503.66,4306.01,0.00
2024-12-10 17:37:31,92,4117,48,44,2526.22,4306.10,0.00
2024-12-10 17:37:31,91,4117,47,44,2548.36,4306.22,0.00
2024-12-10 17:37:31,92,4116,47,45,2519.73,4306.26,0.00
2024-12-10 17:37:31,92,4117,47,45,2533.34,4307.00,0.00
2024-12-10 17:37:31,93,4117,48,45,2506.10,4307.01,0.00
2024-12-10 17:37:31,92,4117,47,45,2508.63,4307.30,0.00
2024-12-10 17:37:31,92,4118,47,45,2572.79,4308.00,0.00
2024-12-10 17:37:31,93,4118,47,46,2545.12,4308.01,0.00
2024-12-10 17:37:31,92,4118,46,46,2571.86,4308.02,0.00
2024-12-10 17:37:31,91,4118,46,45,2594.93,4308.09,0.00
2024-12-10 17:37:31,91,4119,46,45,2584.62,4309.00,0.00
2024-12-10 17:37:31,92,4119,46,46,2556.52,4309.01,0.00
2024-12-10 17:37:31,92,4120,46,46,2533.23,4310.00,0.00
2024-12-10 17:37:31,93,4120,46,47,2505.99,4310.01,0.00
2024-12-10 17:37:31,92,4120,46,46,2527.63,4310.09,0.00
2024-12-10 17:37:31,93,4119,47,46,2473.91,4310.73,0.00
2024-12-10 17:37:31,93,4120,47,46,2498.69,4311.00,0.00
2024-12-10 17:37:31,94,4120,48,46,2472.11,4311.01,0.00
2024-12-10 17:37:31,93,4120,47,46,2479.30,4311.25,0.00
2024-12-10 17:37:31,94,4119,48,46,2450.66,4311.32,0.00
2024-12-10 17:37:31,94,4120,48,46,2550.56,4312.00,0.00
2024-12-10 17:37:31,95,4120,49,46,2523.71,4312.01,0.00
2024-12-10 17:37:31,95,4121,49,46,2556.82,4313.00,0.00
2024-12-10 17:37:31,96,4121,50,46,2530.19,4313.01,0.00
2024-12-10 17:37:31,96,4122,50,46,2512.02,4314.00,0.00
2024-12-10 17:37:31,97,4122,51,46,2486.13,4314.01,0.00
2024-12-10 17:37:31,97,4123,51,46,2461.79,4315.00,0.00
2024-12-10 17:37:31,98,4123,51,47,2436.67,4315.01,0.00
2024-12-10 17:37:31,97,4123,51,46,2455.14,4315.09,0.00
2024-12-10 17:37:31,97,4124,51,46,2443.23,4316.00,0.00
2024-12-10 17:37:31,98,4124,52,46,2418.30,4316.01,0.00
2024-12-10 17:37:31,98,4125,52,46,2393.75,4317.00,0.00
2024-12-10 17:37:31,99,4125,52,47,2369.57,4317.01,0.00
2024-12-10 17:37:31,98,4125,52,46,2389.36,4317.09,0.00
2024-12-10 17:37:31,97,4125,51,46,2394.87,4317.12,0.00
2024-12-10 17:37:31,96,4125,50,46,2416.66,4317.20,0.00
2024-12-10 17:37:31,97,4124,50,47,2382.52,4317.43,0.00
2024-12-10 17:37:31,97,4125,50,47,2420.30,4318.00,0.00
2024-12-10 17:37:31,98,4125,51,47,2395.60,4318.01,0.00
2024-12-10 17:37:31,99,4124,52,47,2346.26,4318.41,0.00
2024-12-10 17:37:31,99,4125,52,47,2410.34,4319.00,0.00
2024-12-10 17:37:31,100,4125,53,47,2386.24,4319.01,0.00
2024-12-10 17:37:31,101,4124,54,47,2362.62,4319.03,0.00
2024-12-10 17:37:31,100,4124,54,46,2395.33,4319.10,0.00
2024-12-10 17:37:31,99,4124,53,46,2415.98,4319.18,0.00
2024-12-10 17:37:31,100,4123,53,47,2382.44,4319.42,0.00
2024-12-10 17:37:31,101,4122,53,48,2375.13,4319.48,0.00
2024-12-10 17:37:31,100,4122,52,48,2401.51,4319.53,0.00
2024-12-10 17:37:31,99,4122,51,48,2417.17,4319.73,0.00
2024-12-10 17:37:31,99,4123,51,48,2492.86,4320.00,0.00
2024-12-10 17:37:31,100,4123,52,48,2467.93,4320.01,0.00
2024-12-10 17:37:31,99,4123,52,47,2481.53,4320.06,0.00
2024-12-10 17:37:31,99,4124,52,47,2612.43,4321.00,0.00
2024-12-10 17:37:31,100,4124,53,47,2586.31,4321.01,0.00
2024-12-10 17:37:31,99,4124,52,47,2603.27,4321.02,0.00
2024-12-10 17:37:31,99,4125,52,47,2599.89,4322.00,0.00
2024-12-10 17:37:31,100,4125,52,48,2573.89,4322.01,0.00
2024-12-10 17:37:31,99,4125,51,48,2589.86,4322.03,0.00
2024-12-10 17:37:31,100,4124,51,49,2525.17,4322.96,0.00
2024-12-10 17:37:31,100,4125,51,49,2562.08,4323.00,0.00
2024-12-10 17:37:31,101,4125,51,50,2536.71,4323.01,0.00
2024-12-10 17:37:31,101,4126,51,50,2556.57,4324.00,0.00
2024-12-10 17:37:31,102,4126,52,50,2531.51,4324.01,0.00
2024-12-10 17:37:31,101,4126,52,49,2549.72,4324.01,0.00
2024-12-10 17:37:31,100,4126,51,49,2564.92,4324.24,0.00
2024-12-10 17:37:31,100,4127,51,49,2558.51,4325.00,0.00
2024-12-10 17:37:31,101,4127,52,49,2533.18,4325.01,0.00
2024-12-10 17:37:31,100,4127,52,48,2548.14,4325.06,0.00
2024-12-10 17:37:31,100,4128,52,48,2534.01,4326.00,0.00
2024-12-10 17:37:31,101,4128,53,48,2508.92,4326.01,0.00
2024-12-10 17:37:31,100,4128,53,47,2532.72,4326.03,0.00
2024-12-10 17:37:31,99,4128,53,46,2548.69,4326.05,0.00
2024-12-10 17:37:31,100,4127,53,47,2505.24,4326.49,0.00
2024-12-10 17:37:31,99,4127,52,47,2518.90,4326.72,0.00
2024-12-10 17:37:31,99,4128,52,47,2550.59,4327.00,0.00
2024-12-10 17:37:31,100,4128,53,47,2525.08,4327.01,0.00
2024-12-10 17:37:31,99,4128,53,46,2539.23,4327.06,0.00
2024-12-10 17:37:31,98,4128,52,46,2555.00,4327.08,0.00
2024-12-10 17:37:31,99,4127,52,47,2527.02,4327.15,0.00
2024-12-10 17:37:31,99,4128,52,47,2584.84,4328.00,0.00
2024-12-10 17:37:31,100,4128,53,47,2558.99,4328.01,0.00
2024-12-10 17:37:31,99,4128,52,47,2558.74,4328.31,0.00
2024-12-10 17:37:31,99,4129,52,47,2616.92,4329.00,0.00
2024-12-10 17:37:31,100,4129,53,47,2590.75,4329.01,0.00
2024-12-10 17:37:31,99,4129,52,47,2616.05,4329.02,0.00
2024-12-10 17:37:31,98,4129,52,46,2639.22,4329.07,0.00
2024-12-10 17:37:31,98,4130,52,46,2626.12,4330.00,0.00
2024-12-10 17:37:31,99,4130,52,47,2599.59,4330.01,0.00
2024-12-10 17:37:31,98,4130,51,47,2625.13,4330.03,0.00
2024-12-10 17:37:32,98,4131,51,47,2610.25,4331.00,0.00
2024-12-10 17:37:32,99,4131,51,48,2583.88,4331.01,0.00
2024-12-10 17:37:32,99,4132,51,48,2561.00,4332.00,0.00
2024-12-10 17:37:32,100,4132,51,49,2535.39,4332.01,0.00
2024-12-10 17:37:32,99,4132,51,48,2550.95,4332.06,0.00
2024-12-10 17:37:32,98,4132,50,48,2547.93,4332.59,0.00
2024-12-10 17:37:32,98,4133,50,48,2574.77,4333.00,0.00
2024-12-10 17:37:32,99,4133,50,49,2548.76,4333.01,0.00
2024-12-10 17:37:32,98,4133,49,49,2573.00,4333.02,0.00
2024-12-10 17:37:32,98,4134,49,49,2566.52,4334.00,0.00
2024-12-10 17:37:32,99,4134,50,49,2540.59,4334.01,0.00
2024-12-10 17:37:32,99,4135,50,49,2515.78,4335.00,0.00
2024-12-10 17:37:32,100,4135,50,50,2490.62,4335.01,0.00
2024-12-10 17:37:32,99,4135,50,49,2513.61,4335.05,0.00
2024-12-10 17:37:32,98,4135,50,48,2537.05,4335.06,0.00
2024-12-10 17:37:32,99,4134,51,48,2502.75,4335.28,0.00
2024-12-10 17:37:32,99,4135,51,48,2481.97,4336.00,0.00
2024-12-10 17:37:32,100,4135,52,48,2457.15,4336.01,0.00
2024-12-10 17:37:32,99,4135,51,48,2461.05,4336.25,0.00
2024-12-10 17:37:32,98,4135,51,47,2440.78,4336.91,0.00
2024-12-10 17:37:32,98,4136,51,47,2525.36,4337.00,0.00
2024-12-10 17:37:32,99,4136,51,48,2499.86,4337.01,0.00
2024-12-10 17:37:32,98,4136,51,47,2506.58,4337.08,0.00
2024-12-10 17:37:32,97,4136,50,47,2525.78,4337.23,0.00
2024-12-10 17:37:32,96,4136,49,47,2530.08,4337.50,0.00
2024-12-10 17:37:32,95,4136,48,47,2531.71,4337.68,0.00
2024-12-10 17:37:32,96,4135,48,48,2495.58,4337.93,0.00
2024-12-10 17:37:32,96,4136,48,48,2540.38,4338.00,0.00
2024-12-10 17:37:32,97,4136,49,48,2514.19,4338.01,0.00
2024-12-10 17:37:32,97,4137,49,48,2520.63,4339.00,0.00
2024-12-10 17:37:32,98,4137,50,48,2494.91,4339.01,0.00
2024-12-10 17:37:32,97,4137,49,48,2518.39,4339.01,0.00
2024-12-10 17:37:32,96,4137,48,48,2530.81,4339.05,0.00
2024-12-10 17:37:32,95,4137,48,47,2553.82,4339.08,0.00
2024-12-10 17:37:32,95,4138,48,47,2560.32,4340.00,0.00
2024-12-10 17:37:32,96,4138,48,48,2533.65,4340.01,0.00
2024-12-10 17:37:32,95,4138,47,48,2514.88,4340.56,0.00
2024-12-10 17:37:32,95,4139,47,48,2541.72,4341.00,0.00
2024-12-10 17:37:32,96,4139,47,49,2515.24,4341.01,0.00
2024-12-10 17:37:32,96,4140,47,49,2490.94,4342.00,0.00
2024-12-10 17:37:32,97,4140,48,49,2465.26,4342.01,0.00
2024-12-10 17:37:32,96,4140,48,48,2485.09,4342.09,0.00
2024-12-10 17:37:32,97,4139,48,49,2431.60,4342.76,0.00
2024-12-10 17:37:32,97,4140,48,49,2456.88,4343.00,0.00
2024-12-10 17:37:32,98,4140,49,49,2431.80,4343.01,0.00
2024-12-10 17:37:32,97,4140,49,48,2445.26,4343.07,0.00
2024-12-10 17:37:32,97,4141,49,48,2477.15,4344.00,0.00
2024-12-10 17:37:32,98,4141,49,49,2451.87,4344.01,0.00
2024-12-10 17:37:32,97,4141,48,49,2441.94,4344.44,0.00
2024-12-10 17:37:32,98,4140,48,50,2410.46,4344.61,0.00
2024-12-10 17:37:32,98,4141,48,50,2450.15,4345.00,0.00
2024-12-10 17:37:32,99,4141,49,50,2425.40,4345.01,0.00
2024-12-10 17:37:32,98,4141,49,49,2449.70,4345.01,0.00
2024-12-10 17:37:32,97,4141,49,48,2472.29,4345.06,0.00
2024-12-10 17:37:32,96,4141,49,47,2496.68,4345.06,0.00
2024-12-10 17:37:32,96,4142,49,47,2512.45,4346.00,0.00
2024-12-10 17:37:32,97,4142,50,47,2486.55,4346.01,0.00
2024-12-10 17:37:32,98,4141,51,47,2447.91,4346.13,0.00
2024-12-10 17:37:32,97,4141,51,46,2466.45,4346.38,0.00
2024-12-10 17:37:32,97,4142,51,46,2464.11,4347.00,0.00
2024-12-10 17:37:32,98,4142,52,46,2438.96,4347.01,0.00
2024-12-10 17:37:32,97,4142,51,46,2463.66,4347.01,0.00
2024-12-10 17:37:32,96,4142,51,45,2486.17,4347.05,0.00
2024-12-10 17:37:32,95,4142,50,45,2506.01,4347.20,0.00
2024-12-10 17:37:32,94,4142,49,45,2515.64,4347.42,0.00
2024-12-10 17:37:32,93,4142,48,45,2532.54,4347.66,0.00
2024-12-10 17:37:32,92,4142,47,45,2554.20,4347.74,0.00
2024-12-10 17:37:32,92,4143,47,45,2635.83,4348.00,0.00
2024-12-10 17:37:32,93,4143,47,46,2607.49,4348.01,0.00
2024-12-10 17:37:32,92,4143,46,46,2612.22,4348.07,0.00
2024-12-10 17:37:32,92,4144,46,46,2614.79,4349.00,0.00
2024-12-10 17:37:32,93,4144,46,47,2586.67,4349.01,0.00
2024-12-10 17:37:32,92,4144,46,46,2611.50,4349.05,0.00
2024-12-10 17:37:32,92,4145,46,46,2594.10,4350.00,0.00
2024-12-10 17:37:32,93,4145,46,47,2566.20,4350.01,0.00
2024-12-10 17:37:32,93,4146,46,47,2535.95,4351.00,0.00
2024-12-10 17:37:32,94,4146,46,48,2508.97,4351.01,0.00
2024-12-10 17:37:32,93,4146,45,48,2525.20,4351.02,0.00
2024-12-10 17:37:32,92,4146,45,47,2549.82,4351.05,0.00
2024-12-10 17:37:32,91,4146,44,47,2570.28,4351.23,0.00
2024-12-10 17:37:32,91,4147,44,47,2541.03,4352.00,0.00
2024-12-10 17:37:32,92,4147,45,47,2513.41,4352.01,0.00
2024-12-10 17:37:32,91,4147,44,47,2495.87,4352.55,0.00
2024-12-10 17:37:32,92,4146,45,47,2457.59,4352.74,0.00
2024-12-10 17:37:32,92,4147,45,47,2495.67,4353.00,0.00
2024-12-10 17:37:32,93,4147,46,47,2468.84,4353.01,0.00
2024-12-10 17:37:32,92,4147,45,47,2476.37,4353.24,0.00
2024-12-10 17:37:32,91,4147,44,47,2503.10,4353.24,0.00
2024-12-10 17:37:32,91,4147,44,47,2552.71,4354.00,0.00
2024-12-10 17:37:32,92,4147,44,48,2524.96,4354.01,0.00
2024-12-10 17:37:32,92,4148,44,48,2500.64,4355.00,0.00
2024-12-10 17:37:32,93,4148,44,49,2473.75,4355.01,0.00
2024-12-10 17:37:32,94,4147,44,50,2435.41,4355.10,0.00
2024-12-10 17:37:32,94,4148,44,50,2431.78,4356.00,0.00
2024-12-10 17:37:32,95,4148,45,50,2406.18,4356.01,0.00
2024-12-10 17:37:32,94,4148,45,49,2424.84,4356.05,0.00
2024-12-10 17:37:32,93,4148,44,49,2443.03,4356.24,0.00
2024-12-10 17:37:32,92,4148,43,49,2419.27,4356.95,0.00
2024-12-10 17:37:32,92,4149,43,49,2511.65,4357.00,0.00
2024-12-10 17:37:32,93,4149,43,50,2484.64,4357.01,0.00
2024-12-10 17:37:32,92,4149,43,49,2468.77,4357.55,0.00
2024-12-10 17:37:32,93,4148,43,50,2433.92,4357.76,0.00
2024-12-10 17:37:32,93,4149,43,50,2474.04,4358.00,0.00
2024-12-10 17:37:32,94,4149,43,51,2447.72,4358.01,0.00
2024-12-10 17:37:32,93,4149,42,51,2455.52,4358.13,0.00
2024-12-10 17:37:33,92,4149,42,50,2452.35,4358.79,0.00
2024-12-10 17:37:33,92,4150,42,50,2538.27,4359.00,0.00
2024-12-10 17:37:33,93,4150,43,50,2510.97,4359.01,0.00
2024-12-10 17:37:33,92,4150,43,49,2527.39,4359.05,0.00
2024-12-10 17:37:33,91,4150,42,49,2517.09,4359.60,0.00
2024-12-10 17:37:33,91,4151,42,49,2548.06,4360.00,0.00
2024-12-10 17:37:33,92,4151,42,50,2520.37,4360.01,0.00
2024-12-10 17:37:33,92,4152,42,50,2511.83,4361.00,0.00
2024-12-10 17:37:33,93,4152,43,50,2484.82,4361.01,0.00
2024-12-10 17:37:33,93,4153,43,50,2474.17,4362.00,0.00
2024-12-10 17:37:33,94,4153,44,50,2447.84,4362.01,0.00
2024-12-10 17:37:33,95,4152,45,50,2399.68,4362.34,0.00
2024-12-10 17:37:33,95,4153,45,50,2432.47,4363.00,0.00
2024-12-10 17:37:33,96,4153,46,50,2407.13,4363.01,0.00
2024-12-10 17:37:33,96,4154,46,50,2429.94,4364.00,0.00
2024-12-10 17:37:33,97,4154,46,51,2404.89,4364.01,0.00
2024-12-10 17:37:33,96,4154,46,50,2422.68,4364.05,0.00
2024-12-10 17:37:33,95,4154,45,50,2390.18,4364.97,0.00
2024-12-10 17:37:33,95,4155,45,50,2434.77,4365.00,0.00
2024-12-10 17:37:33,96,4155,45,51,2409.41,4365.01,0.00
2024-12-10 17:37:33,97,4154,45,52,2368.42,4365.20,0.00
2024-12-10 17:37:33,96,4154,44,52,2420.92,4365.42,0.00
2024-12-10 17:37:33,96,4155,44,52,2441.34,4366.00,0.00
2024-12-10 17:37:33,97,4155,44,53,2416.17,4366.01,0.00
2024-12-10 17:37:33,96,4155,44,52,2432.26,4366.05,0.00
2024-12-10 17:37:33,97,4154,44,53,2398.69,4366.27,0.00
2024-12-10 17:37:33,96,4154,43,53,2435.51,4366.76,0.00
2024-12-10 17:37:33,96,4155,43,53,2498.02,4367.00,0.00
2024-12-10 17:37:33,97,4155,44,53,2472.27,4367.01,0.00
2024-12-10 17:37:33,97,4156,44,53,2504.40,4368.00,0.00
2024-12-10 17:37:33,98,4156,45,53,2478.85,4368.01,0.00
2024-12-10 17:37:33,98,4157,45,53,2460.14,4369.00,0.00
2024-12-10 17:37:33,99,4157,45,54,2435.29,4369.01,0.00
2024-12-10 17:37:33,100,4156,46,54,2374.94,4369.66,0.00
2024-12-10 17:37:33,100,4157,46,54,2399.25,4370.00,0.00
2024-12-10 17:37:33,101,4157,47,54,2375.50,4370.01,0.00
2024-12-10 17:37:33,100,4157,47,53,2394.89,4370.05,0.00
2024-12-10 17:37:33,101,4156,48,53,2351.88,4370.52,0.00
2024-12-10 17:37:33,101,4157,48,53,2418.89,4371.00,0.00
2024-12-10 17:37:33,102,4157,49,53,2395.17,4371.01,0.00
2024-12-10 17:37:33,101,4157,49,52,2410.67,4371.07,0.00
2024-12-10 17:37:33,100,4157,48,52,2426.91,4371.08,0.00
2024-12-10 17:37:33,100,4158,48,52,2474.68,4372.00,0.00
2024-12-10 17:37:33,101,4158,49,52,2450.17,4372.01,0.00
2024-12-10 17:37:33,100,4158,48,52,2472.93,4372.04,0.00
2024-12-10 17:37:33,99,4158,48,51,2491.29,4372.06,0.00
2024-12-10 17:37:33,99,4159,48,51,2477.27,4373.00,0.00
2024-12-10 17:37:33,100,4159,49,51,2452.50,4373.01,0.00
2024-12-10 17:37:33,100,4160,49,51,2427.26,4374.00,0.00
2024-12-10 17:37:33,101,4160,49,52,2403.22,4374.01,0.00
2024-12-10 17:37:33,100,4160,49,51,2423.77,4374.06,0.00
2024-12-10 17:37:33,99,4160,48,51,2421.82,4374.28,0.00
2024-12-10 17:37:33,98,4160,47,51,2446.09,4374.30,0.00
2024-12-10 17:37:33,98,4161,47,51,2442.54,4375.00,0.00
2024-12-10 17:37:33,99,4161,48,51,2417.87,4375.01,0.00
2024-12-10 17:37:33,98,4161,48,50,2434.06,4375.06,0.00
2024-12-10 17:37:33,99,4160,49,50,2372.54,4375.53,0.00
2024-12-10 17:37:33,99,4161,49,50,2419.70,4376.00,0.00
2024-12-10 17:37:33,100,4161,50,50,2395.50,4376.01,0.00
2024-12-10 17:37:33,99,4161,50,49,2411.75,4376.06,0.00
2024-12-10 17:37:33,99,4162,50,49,2441.91,4377.00,0.00
2024-12-10 17:37:33,100,4162,50,50,2417.50,4377.01,0.00
2024-12-10 17:37:33,99,4162,50,49,2433.53,4377.07,0.00
2024-12-10 17:37:33,98,4162,49,49,2415.77,4377.68,0.00
2024-12-10 17:37:33,98,4163,49,49,2446.85,4378.00,0.00
2024-12-10 17:37:33,99,4163,50,49,2422.13,4378.01,0.00
2024-12-10 17:37:33,98,4163,50,48,2436.14,4378.08,0.00
2024-12-10 17:37:33,98,4164,50,48,2423.28,4379.00,0.00
2024-12-10 17:37:33,99,4164,51,48,2398.80,4379.01,0.00
2024-12-10 17:37:33,98,4164,51,47,2393.35,4379.10,0.00
2024-12-10 17:37:33,98,4165,51,47,2399.25,4380.00,0.00
2024-12-10 17:37:33,99,4165,52,47,2375.01,4380.01,0.00
2024-12-10 17:37:33,98,4165,51,47,2387.19,4380.10,0.00
2024-12-10 17:37:33,97,4165,51,46,2403.23,4380.10,0.00
2024-12-10 17:37:33,97,4166,51,46,2409.63,4381.00,0.00
2024-12-10 17:37:33,98,4166,51,47,2385.04,4381.01,0.00
2024-12-10 17:37:33,97,4166,51,46,2407.83,4381.04,0.00
2024-12-10 17:37:33,96,4166,51,45,2421.05,4381.09,0.00
2024-12-10 17:37:33,95,4166,50,45,2414.47,4381.57,0.00
2024-12-10 17:37:33,95,4167,50,45,2442.01,4382.00,0.00
2024-12-10 17:37:33,96,4167,51,45,2416.57,4382.01,0.00
2024-12-10 17:37:33,95,4167,50,45,2440.17,4382.04,0.00
2024-12-10 17:37:33,95,4168,50,45,2430.76,4383.00,0.00
2024-12-10 17:37:33,96,4168,50,46,2405.44,4383.01,0.00
2024-12-10 17:37:33,96,4169,50,46,2391.39,4384.00,0.00
2024-12-10 17:37:33,97,4169,50,47,2366.73,4384.01,0.00
2024-12-10 17:37:33,96,4169,49,47,2368.63,4384.31,0.00
2024-12-10 17:37:33,96,4170,49,47,2370.73,4385.00,0.00
2024-12-10 17:37:33,97,4170,50,47,2346.29,4385.01,0.00
2024-12-10 17:37:33,96,4170,50,46,2356.60,4385.12,0.00
2024-12-10 17:37:33,96,4171,50,46,2345.69,4386.00,0.00
2024-12-10 17:37:33,97,4171,51,46,2321.51,4386.01,0.00
2024-12-10 17:37:33,96,4171,50,46,2343.87,4386.04,0.00
2024-12-10 17:37:33,95,4171,50,45,2357.94,4386.11,0.00
2024-12-10 17:37:33,94,4171,49,45,2380.58,4386.16,0.00
2024-12-10 17:37:33,94,4172,49,45,2372.22,4387.00,0.00
2024-12-10 17:37:33,95,4172,49,46,2347.25,4387.01,0.00
2024-12-10 17:37:33,94,4172,48,46,2352.29,4387.25,0.00
2024-12-10 17:37:33,95,4171,49,46,2312.93,4387.60,0.00
2024-12-10 17:37:33,95,4172,49,46,2337.71,4388.00,0.00
2024-12-10 17:37:33,96,4172,49,47,2313.35,4388.01,0.00
2024-12-10 17:37:33,95,4172,49,46,2333.11,4388.11,0.00
2024-12-10 17:37:34,94,4172,48,46,2329.32,4388.76,0.00
2024-12-10 17:37:34,94,4173,48,46,2393.46,4389.00,0.00
2024-12-10 17:37:34,95,4173,49,46,2368.27,4389.01,0.00
2024-12-10 17:37:34,94,4173,49,45,2379.47,4389.11,0.00
2024-12-10 17:37:34,93,4173,48,45,2360.24,4389.96,0.00
2024-12-10 17:37:34,93,4174,48,45,2405.59,4390.00,0.00
2024-12-10 17:37:34,94,4174,49,45,2380.00,4390.01,0.00
2024-12-10 17:37:34,93,4174,49,44,2391.45,4390.11,0.00
2024-12-10 17:37:34,93,4175,49,44,2381.11,4391.00,0.00
2024-12-10 17:37:34,94,4175,49,45,2355.78,4391.01,0.00
2024-12-10 17:37:34,94,4176,49,45,2341.01,4392.00,0.00
2024-12-10 17:37:34,95,4176,50,45,2316.37,4392.01,0.00
2024-12-10 17:37:34,94,4176,49,45,2332.96,4392.04,0.00
2024-12-10 17:37:34,94,4177,49,45,2328.81,4393.00,0.00
2024-12-10 17:37:34,95,4177,49,46,2304.30,4393.01,0.00
2024-12-10 17:37:34,94,4177,49,45,2318.55,4393.12,0.00
2024-12-10 17:37:34,94,4178,49,45,2308.31,4394.00,0.00
2024-12-10 17:37:34,95,4178,50,45,2284.01,4394.01,0.00
2024-12-10 17:37:34,94,4178,49,45,2296.63,4394.10,0.00
2024-12-10 17:37:34,94,4179,49,45,2294.81,4395.00,0.00
2024-12-10 17:37:34,95,4179,49,46,2270.65,4395.01,0.00
2024-12-10 17:37:34,94,4179,49,45,2289.21,4395.11,0.00
2024-12-10 17:37:34,93,4179,48,45,2306.32,4395.28,0.00
2024-12-10 17:37:34,92,4179,47,45,2305.65,4395.87,0.00
2024-12-10 17:37:34,92,4180,47,45,2328.69,4396.00,0.00
2024-12-10 17:37:34,93,4180,47,46,2303.65,4396.01,0.00
2024-12-10 17:37:34,92,4180,46,46,2327.26,4396.03,0.00
2024-12-10 17:37:34,91,4180,45,46,2352.35,4396.03,0.00
2024-12-10 17:37:34,90,4180,44,46,2378.00,4396.03,0.00
2024-12-10 17:37:34,91,4179,44,47,2351.87,4396.06,0.00
2024-12-10 17:37:34,90,4179,43,47,2387.29,4396.07,0.00
2024-12-10 17:37:34,91,4178,44,47,2343.71,4396.26,0.00
2024-12-10 17:37:34,90,4178,43,47,2398.60,4396.29,0.00
2024-12-10 17:37:34,90,4179,43,47,2416.64,4397.00,0.00
2024-12-10 17:37:34,91,4179,43,48,2390.09,4397.01,0.00
2024-12-10 17:37:34,90,4179,42,48,2414.38,4397.06,0.00
2024-12-10 17:37:34,89,4179,42,47,2441.02,4397.06,0.00
2024-12-10 17:37:34,89,4180,42,47,2528.53,4398.00,0.00
2024-12-10 17:37:34,90,4180,42,48,2500.44,4398.01,0.00
2024-12-10 17:37:34,89,4180,41,48,2526.15,4398.06,0.00
2024-12-10 17:37:34,88,4180,40,48,2510.12,4398.56,0.00
2024-12-10 17:37:34,89,4179,40,49,2475.57,4398.72,0.00
2024-12-10 17:37:34,89,4180,40,49,2524.24,4399.00,0.00
2024-12-10 17:37:34,90,4180,40,50,2496.20,4399.01,0.00
2024-12-10 17:37:34,89,4180,39,50,2523.26,4399.02,0.00
2024-12-10 17:37:34,88,4180,39,49,2549.45,4399.07,0.00
2024-12-10 17:37:34,88,4181,39,49,2589.01,4400.00,0.00
2024-12-10 17:37:34,89,4181,40,49,2559.92,4400.01,0.00
2024-12-10 17:37:34,88,4181,40,48,2556.52,4400.07,0.00
2024-12-10 17:37:34,89,4180,41,48,2491.21,4400.93,0.00
2024-12-10 17:37:34,89,4181,41,48,2539.24,4401.00,0.00
2024-12-10 17:37:34,90,4181,41,49,2511.02,4401.01,0.00
2024-12-10 17:37:34,89,4181,40,49,2526.39,4401.06,0.00
2024-12-10 17:37:34,90,4180,40,50,2482.72,4401.21,0.00
2024-12-10 17:37:34,90,4181,40,50,2577.14,4402.00,0.00
2024-12-10 17:37:34,91,4181,40,51,2548.82,4402.01,0.00
2024-12-10 17:37:34,90,4181,40,50,2575.68,4402.03,0.00
2024-12-10 17:37:34,89,4181,40,49,2602.64,4402.06,0.00
2024-12-10 17:37:34,90,4180,41,49,2517.96,4402.91,0.00
2024-12-10 17:37:34,90,4181,41,49,2614.41,4403.00,0.00
2024-12-10 17:37:34,91,4181,42,49,2585.68,4403.01,0.00
2024-12-10 17:37:34,90,4181,41,49,2594.94,4403.23,0.00
2024-12-10 17:37:34,91,4180,41,50,2554.46,4403.53,0.00
2024-12-10 17:37:34,91,4181,41,50,2640.98,4404.00,0.00
2024-12-10 17:37:34,92,4181,41,51,2612.27,4404.01,0.00
2024-12-10 17:37:34,91,4181,40,51,2598.64,4404.59,0.00
2024-12-10 17:37:34,91,4182,40,51,2677.86,4405.00,0.00
2024-12-10 17:37:34,92,4182,41,51,2648.76,4405.01,0.00
2024-12-10 17:37:34,91,4182,40,51,2631.64,4405.56,0.00
2024-12-10 17:37:34,92,4181,40,52,2601.14,4405.62,0.00
2024-12-10 17:37:34,92,4182,40,52,2646.48,4406.00,0.00
2024-12-10 17:37:34,93,4182,40,53,2618.03,4406.01,0.00
2024-12-10 17:37:34,92,4182,39,53,2646.00,4406.01,0.00
2024-12-10 17:37:34,91,4182,39,52,2670.25,4406.07,0.00
2024-12-10 17:37:34,91,4183,39,52,2707.17,4407.00,0.00
2024-12-10 17:37:34,92,4183,39,53,2677.74,4407.01,0.00
2024-12-10 17:37:34,93,4182,39,54,2585.88,4407.83,0.00
2024-12-10 17:37:34,93,4183,39,54,2627.75,4408.00,0.00
2024-12-10 17:37:34,94,4183,39,55,2599.79,4408.01,0.00
2024-12-10 17:37:34,93,4183,39,54,2620.17,4408.08,0.00
2024-12-10 17:37:34,94,4182,39,55,2572.82,4408.54,0.00
2024-12-10 17:37:34,93,4182,38,55,2604.44,4408.76,0.00
2024-12-10 17:37:34,93,4183,38,55,2689.02,4409.00,0.00
2024-12-10 17:37:34,94,4183,38,56,2660.42,4409.01,0.00
2024-12-10 17:37:34,93,4183,37,56,2688.36,4409.02,0.00
2024-12-10 17:37:34,92,4183,36,56,2685.15,4409.39,0.00
2024-12-10 17:37:34,92,4184,36,56,2754.62,4410.00,0.00
2024-12-10 17:37:34,93,4184,36,57,2725.00,4410.01,0.00
2024-12-10 17:37:34,92,4184,36,56,2751.28,4410.07,0.00
2024-12-10 17:37:34,91,4184,35,56,2749.34,4410.45,0.00
2024-12-10 17:37:34,91,4185,35,56,2774.01,4411.00,0.00
2024-12-10 17:37:34,92,4185,35,57,2743.85,4411.01,0.00
2024-12-10 17:37:34,92,4186,35,57,2722.43,4412.00,0.00
2024-12-10 17:37:34,93,4186,35,58,2693.16,4412.01,0.00
2024-12-10 17:37:34,92,4186,34,58,2717.62,4412.01,0.00
2024-12-10 17:37:34,91,4186,34,57,2735.37,4412.06,0.00
2024-12-10 17:37:34,91,4187,34,57,2742.77,4413.00,0.00
2024-12-10 17:37:34,92,4187,35,57,2712.96,4413.01,0.00
2024-12-10 17:37:34,92,4188,35,57,2703.03,4414.00,0.00
2024-12-10 17:37:34,93,4188,35,58,2673.97,4414.01,0.00
2024-12-10 17:37:34,93,4189,35,58,2660.16,4415.00,0.00
2024-12-10 17:37:34,94,4189,35,59,2631.86,4415.01,0.00
2024-12-10 17:37:34,94,4190,35,59,2586.04,4416.00,0.00
2024-12-10 17:37:34,95,4190,36,59,2558.82,4416.01,0.00
2024-12-10 17:37:34,94,4190,36,58,2574.30,4416.05,0.00
2024-12-10 17:37:34,93,4190,35,58,2580.32,4416.28,0.00
2024-12-10 17:37:34,92,4190,34,58,2594.34,4416.41,0.00
2024-12-10 17:37:34,92,4191,34,58,2597.65,4417.00,0.00
2024-12-10 17:37:34,93,4191,35,58,2569.72,4417.01,0.00
2024-12-10 17:37:35,94,4190,35,59,2500.26,4417.67,0.00
2024-12-10 17:37:35,94,4191,35,59,2542.84,4418.00,0.00
2024-12-10 17:37:35,95,4191,35,60,2516.07,4418.01,0.00
2024-12-10 17:37:35,96,4190,36,60,2458.32,4418.54,0.00
2024-12-10 17:37:35,96,4191,36,60,2538.73,4419.00,0.00
2024-12-10 17:37:35,97,4191,37,60,2512.55,4419.01,0.00
2024-12-10 17:37:35,97,4192,37,60,2538.01,4420.00,0.00
2024-12-10 17:37:35,98,4192,38,60,2512.11,4420.01,0.00
2024-12-10 17:37:35,97,4192,37,60,2500.72,4420.54,0.00
2024-12-10 17:37:35,97,4193,37,60,2526.15,4421.00,0.00
2024-12-10 17:37:35,98,4193,38,60,2500.37,4421.01,0.00
2024-12-10 17:37:35,97,4193,38,59,2522.96,4421.07,0.00
2024-12-10 17:37:35,97,4194,38,59,2509.85,4422.00,0.00
2024-12-10 17:37:35,98,4194,39,59,2484.24,4422.01,0.00
2024-12-10 17:37:35,97,4194,39,58,2509.39,4422.01,0.00
2024-12-10 17:37:35,96,4194,39,57,2525.87,4422.06,0.00
2024-12-10 17:37:35,95,4194,38,57,2497.22,4422.90,0.00
2024-12-10 17:37:35,95,4195,38,57,2539.21,4423.00,0.00
2024-12-10 17:37:35,96,4195,39,57,2512.76,4423.01,0.00
2024-12-10 17:37:35,95,4195,39,56,2527.59,4423.08,0.00
2024-12-10 17:37:35,94,4195,38,56,2521.73,4423.54,0.00
2024-12-10 17:37:35,94,4196,38,56,2548.92,4424.00,0.00
2024-12-10 17:37:35,95,4196,38,57,2522.09,4424.01,0.00
2024-12-10 17:37:35,94,4196,38,56,2537.17,4424.09,0.00
2024-12-10 17:37:35,93,4196,37,56,2554.94,4424.09,0.00
2024-12-10 17:37:35,93,4197,37,56,2562.64,4425.00,0.00
2024-12-10 17:37:35,94,4197,38,56,2535.37,4425.01,0.00
2024-12-10 17:37:35,93,4197,37,56,2562.16,4425.01,0.00
2024-12-10 17:37:35,92,4197,37,55,2577.04,4425.09,0.00
2024-12-10 17:37:35,92,4198,37,55,2566.06,4426.00,0.00
2024-12-10 17:37:35,93,4198,38,55,2538.47,4426.01,0.00
2024-12-10 17:37:35,92,4198,37,55,2565.58,4426.01,0.00
2024-12-10 17:37:35,91,4198,36,55,2579.68,4426.09,0.00
2024-12-10 17:37:35,92,4197,36,56,2513.97,4426.75,0.00
2024-12-10 17:37:35,92,4198,36,56,2560.86,4427.00,0.00
2024-12-10 17:37:35,93,4198,36,57,2533.33,4427.01,0.00
2024-12-10 17:37:35,92,4198,36,56,2556.55,4427.09,0.00
2024-12-10 17:37:35,93,4197,37,56,2501.77,4427.73,0.00
2024-12-10 17:37:35,94,4196,37,57,2470.08,4427.86,0.00
2024-12-10 17:37:35,94,4197,37,57,2544.16,4428.00,0.00
2024-12-10 17:37:35,95,4197,37,58,2517.38,4428.01,0.00
2024-12-10 17:37:35,95,4198,37,58,2586.01,4429.00,0.00
2024-12-10 17:37:35,96,4198,37,59,2559.07,4429.01,0.00
2024-12-10 17:37:35,95,4198,36,59,2585.55,4429.01,0.00
2024-12-10 17:37:35,94,4198,36,58,2599.87,4429.08,0.00
2024-12-10 17:37:35,93,4198,35,58,2581.20,4429.95,0.00
2024-12-10 17:37:35,93,4199,35,58,2626.50,4430.00,0.00
2024-12-10 17:37:35,94,4199,36,58,2598.56,4430.01,0.00
2024-12-10 17:37:35,93,4199,35,58,2616.03,4430.04,0.00
2024-12-10 17:37:35,92,4199,34,58,2630.99,4430.09,0.00
2024-12-10 17:37:35,91,4199,33,58,2642.43,4430.25,0.00
2024-12-10 17:37:35,91,4200,33,58,2658.54,4431.00,0.00
2024-12-10 17:37:35,92,4200,34,58,2629.64,4431.01,0.00
2024-12-10 17:37:35,91,4200,34,57,2653.20,4431.09,0.00
2024-12-10 17:37:35,90,4200,33,57,2675.35,4431.25,0.00
2024-12-10 17:37:35,90,4201,33,57,2671.94,4432.00,0.00
2024-12-10 17:37:35,91,4201,34,57,2642.58,4432.01,0.00
2024-12-10 17:37:35,91,4202,34,57,2627.29,4433.00,0.00
2024-12-10 17:37:35,92,4202,34,58,2598.73,4433.01,0.00
2024-12-10 17:37:35,92,4203,34,58,2576.14,4434.00,0.00
2024-12-10 17:37:35,93,4203,34,59,2548.44,4434.01,0.00
2024-12-10 17:37:35,92,4203,34,58,2566.03,4434.09,0.00
2024-12-10 17:37:35,92,4204,34,58,2555.03,4435.00,0.00
2024-12-10 17:37:35,93,4204,35,58,2527.56,4435.01,0.00
2024-12-10 17:37:35,92,4204,35,57,2554.55,4435.01,0.00
2024-12-10 17:37:35,91,4204,35,56,2569.47,4435.08,0.00
2024-12-10 17:37:35,90,4204,34,56,2590.69,4435.23,0.00
2024-12-10 17:37:35,89,4204,33,56,2616.32,4435.27,0.00
2024-12-10 17:37:35,89,4205,33,56,2634.27,4436.00,0.00
2024-12-10 17:37:35,90,4205,34,56,2605.00,4436.01,0.00
2024-12-10 17:37:35,89,4205,33,56,2607.87,4436.11,0.00
2024-12-10 17:37:35,90,4204,34,56,2574.01,4436.25,0.00
2024-12-10 17:37:35,89,4204,33,56,2617.40,4436.25,0.00
2024-12-10 17:37:35,89,4205,33,56,2634.37,4437.00,0.00
2024-12-10 17:37:35,90,4205,33,57,2605.10,4437.01,0.00
2024-12-10 17:37:35,89,4205,33,56,2630.89,4437.08,0.00
2024-12-10 17:37:35,89,4206,33,56,2670.37,4438.00,0.00
2024-12-10 17:37:35,90,4206,34,56,2640.70,4438.01,0.00
2024-12-10 17:37:35,89,4206,33,56,2659.90,4438.02,0.00
2024-12-10 17:37:35,88,4206,32,56,2689.20,4438.03,0.00
2024-12-10 17:37:35,87,4206,32,55,2708.89,4438.06,0.00
2024-12-10 17:37:35,87,4207,32,55,2718.67,4439.00,0.00
2024-12-10 17:37:35,88,4207,32,56,2687.78,4439.01,0.00
2024-12-10 17:37:35,87,4207,32,55,2706.44,4439.06,0.00
2024-12-10 17:37:35,87,4208,32,55,2695.81,4440.00,0.00
2024-12-10 17:37:35,88,4208,32,56,2665.18,4440.01,0.00
2024-12-10 17:37:35,87,4208,32,55,2683.06,4440.06,0.00
2024-12-10 17:37:35,88,4207,33,55,2637.10,4440.43,0.00
2024-12-10 17:37:35,88,4208,33,55,2662.24,4441.00,0.00
2024-12-10 17:37:35,89,4208,33,56,2632.33,4441.01,0.00
2024-12-10 17:37:35,89,4209,33,56,2658.88,4442.00,0.00
2024-12-10 17:37:35,90,4209,33,57,2629.33,4442.01,0.00
2024-12-10 17:37:35,89,4209,33,56,2654.89,4442.07,0.00
2024-12-10 17:37:35,88,4209,32,56,2655.16,4442.74,0.00
2024-12-10 17:37:35,88,4210,32,56,2694.24,4443.00,0.00
2024-12-10 17:37:35,89,4210,32,57,2663.97,4443.01,0.00
2024-12-10 17:37:35,88,4210,31,57,2677.58,4443.01,0.00
2024-12-10 17:37:35,89,4209,31,58,2604.97,4443.78,0.00
2024-12-10 17:37:35,89,4210,31,58,2653.08,4444.00,0.00
2024-12-10 17:37:35,90,4210,32,58,2623.60,4444.01,0.00
2024-12-10 17:37:35,89,4210,32,57,2652.58,4444.01,0.00
2024-12-10 17:37:35,88,4210,32,56,2680.21,4444.05,0.00
2024-12-10 17:37:35,88,4211,32,56,2719.19,4445.00,0.00
2024-12-10 17:37:35,89,4211,33,56,2688.64,4445.01,0.00
2024-12-10 17:37:35,88,4211,33,55,2707.07,4445.05,0.00
2024-12-10 17:37:35,89,4210,34,55,2662.33,4445.39,0.00
2024-12-10 17:37:35,89,4211,34,55,2687.25,4446.00,0.00
2024-12-10 17:37:35,90,4211,34,56,2657.39,4446.01,0.00
2024-12-10 17:37:35,89,4211,34,55,2675.26,4446.05,0.00
2024-12-10 17:37:36,89,4212,34,55,2713.34,4447.00,0.00
2024-12-10 17:37:36,90,4212,34,56,2683.19,4447.01,0.00
2024-12-10 17:37:36,91,4211,35,56,2652.73,4447.06,0.00
2024-12-10 17:37:36,91,4212,35,56,2680.41,4448.00,0.00
2024-12-10 17:37:36,92,4212,35,57,2651.28,4448.01,0.00
2024-12-10 17:37:36,91,4212,34,57,2638.00,4448.64,0.00
2024-12-10 17:37:36,91,4213,34,57,2719.92,4449.00,0.00
2024-12-10 17:37:36,92,4213,35,57,2690.35,4449.01,0.00
2024-12-10 17:37:36,91,4213,35,56,2711.13,4449.04,0.00
2024-12-10 17:37:36,91,4214,35,56,2698.53,4450.00,0.00
2024-12-10 17:37:36,92,4214,35,57,2669.19,4450.01,0.00
2024-12-10 17:37:36,91,4214,35,56,2698.04,4450.01,0.00
2024-12-10 17:37:36,90,4214,35,55,2717.15,4450.03,0.00
2024-12-10 17:37:36,90,4215,35,55,2704.39,4451.00,0.00
2024-12-10 17:37:36,91,4215,35,56,2674.68,4451.01,0.00
2024-12-10 17:37:36,90,4215,35,55,2703.90,4451.01,0.00
2024-12-10 17:37:36,89,4215,34,55,2699.95,4451.39,0.00
2024-12-10 17:37:36,89,4216,34,55,2723.39,4452.00,0.00
2024-12-10 17:37:36,90,4216,35,55,2693.13,4452.01,0.00
2024-12-10 17:37:36,90,4217,35,55,2669.49,4453.00,0.00
2024-12-10 17:37:36,91,4217,35,56,2640.16,4453.01,0.00
2024-12-10 17:37:36,90,4217,35,55,2665.55,4453.03,0.00
2024-12-10 17:37:36,89,4217,34,55,2689.54,4453.17,0.00
2024-12-10 17:37:36,88,4217,33,55,2707.03,4453.34,0.00
2024-12-10 17:37:36,88,4218,33,55,2728.75,4454.00,0.00
2024-12-10 17:37:36,89,4218,34,55,2698.09,4454.01,0.00
2024-12-10 17:37:36,89,4219,34,55,2674.67,4455.00,0.00
2024-12-10 17:37:36,90,4219,34,56,2644.95,4455.01,0.00
2024-12-10 17:37:36,89,4219,34,55,2671.68,4455.05,0.00
2024-12-10 17:37:36,88,4219,33,55,2673.06,4455.69,0.00
2024-12-10 17:37:36,88,4220,33,55,2690.01,4456.00,0.00
2024-12-10 17:37:36,89,4220,34,55,2659.79,4456.01,0.00
2024-12-10 17:37:36,88,4220,33,55,2688.51,4456.03,0.00
2024-12-10 17:37:36,89,4219,33,56,2638.86,4456.27,0.00
2024-12-10 17:37:36,88,4219,32,56,2635.70,4456.73,0.00
2024-12-10 17:37:36,88,4220,32,56,2674.41,4457.00,0.00
2024-12-10 17:37:36,89,4220,33,56,2644.36,4457.01,0.00
2024-12-10 17:37:36,88,4220,33,55,2667.35,4457.08,0.00
2024-12-10 17:37:36,87,4220,32,55,2664.94,4457.54,0.00
2024-12-10 17:37:36,87,4221,32,55,2747.26,4458.00,0.00
2024-12-10 17:37:36,88,4221,33,55,2716.04,4458.01,0.00
2024-12-10 17:37:36,87,4221,32,55,2715.53,4458.12,0.00
2024-12-10 17:37:36,87,4222,32,55,2727.89,4459.00,0.00
2024-12-10 17:37:36,88,4222,33,55,2696.89,4459.01,0.00
2024-12-10 17:37:36,87,4222,33,54,2720.23,4459.08,0.00
2024-12-10 17:37:36,87,4223,33,54,2710.56,4460.00,0.00
2024-12-10 17:37:36,88,4223,33,55,2679.76,4460.01,0.00
2024-12-10 17:37:36,88,4224,33,55,2632.09,4461.00,0.00
2024-12-10 17:37:36,89,4224,34,55,2602.51,4461.01,0.00
2024-12-10 17:37:36,88,4224,34,54,2624.62,4461.07,0.00
2024-12-10 17:37:36,87,4224,34,53,2650.17,4461.08,0.00
2024-12-10 17:37:36,87,4225,34,53,2640.49,4462.00,0.00
2024-12-10 17:37:36,88,4225,34,54,2610.48,4462.01,0.00
2024-12-10 17:37:36,88,4226,34,54,2587.23,4463.00,0.00
2024-12-10 17:37:36,89,4226,34,55,2558.16,4463.01,0.00
2024-12-10 17:37:36,88,4226,34,54,2579.65,4463.08,0.00
2024-12-10 17:37:36,88,4227,34,54,2569.55,4464.00,0.00
2024-12-10 17:37:36,89,4227,35,54,2540.68,4464.01,0.00
2024-12-10 17:37:36,90,4226,35,55,2451.79,4464.73,0.00
2024-12-10 17:37:36,90,4227,35,55,2499.61,4465.00,0.00
2024-12-10 17:37:36,91,4227,35,56,2472.15,4465.01,0.00
2024-12-10 17:37:36,90,4227,34,56,2497.14,4465.02,0.00
2024-12-10 17:37:36,89,4227,34,55,2518.69,4465.07,0.00
2024-12-10 17:37:36,88,4227,33,55,2518.23,4465.73,0.00
2024-12-10 17:37:36,87,4227,32,55,2546.66,4465.74,0.00
2024-12-10 17:37:36,87,4228,32,55,2637.72,4466.00,0.00
2024-12-10 17:37:36,88,4228,33,55,2607.75,4466.01,0.00
2024-12-10 17:37:36,89,4227,34,55,2558.95,4466.25,0.00
2024-12-10 17:37:36,90,4226,35,55,2554.91,4466.41,0.00
2024-12-10 17:37:36,90,4227,35,55,2585.11,4467.00,0.00
2024-12-10 17:37:36,91,4227,36,55,2556.70,4467.01,0.00
2024-12-10 17:37:36,91,4228,36,55,2631.42,4468.00,0.00
2024-12-10 17:37:36,92,4228,37,55,2602.82,4468.01,0.00
2024-12-10 17:37:36,91,4228,37,54,2624.07,4468.07,0.00
2024-12-10 17:37:36,90,4228,36,54,2628.64,4468.58,0.00
2024-12-10 17:37:36,90,4229,36,54,2659.76,4469.00,0.00
2024-12-10 17:37:36,91,4229,36,55,2630.53,4469.01,0.00
2024-12-10 17:37:36,90,4229,35,55,2627.53,4469.16,0.00
2024-12-10 17:37:36,90,4230,35,55,2639.99,4470.00,0.00
2024-12-10 17:37:36,91,4230,36,55,2610.98,4470.01,0.00
2024-12-10 17:37:36,92,4229,36,56,2567.08,4470.16,0.00
2024-12-10 17:37:36,92,4230,36,56,2565.68,4471.00,0.00
2024-12-10 17:37:36,93,4230,37,56,2538.09,4471.01,0.00
2024-12-10 17:37:36,92,4230,37,55,2559.86,4471.08,0.00
2024-12-10 17:37:36,92,4231,37,55,2596.88,4472.00,0.00
2024-12-10 17:37:36,93,4231,38,55,2568.96,4472.01,0.00
2024-12-10 17:37:36,94,4230,38,56,2497.78,4472.81,0.00
2024-12-10 17:37:36,94,4231,38,56,2524.59,4473.00,0.00
2024-12-10 17:37:36,95,4231,39,56,2498.01,4473.01,0.00
2024-12-10 17:37:36,94,4231,39,55,2517.94,4473.10,0.00
2024-12-10 17:37:36,94,4232,39,55,2554.19,4474.00,0.00
2024-12-10 17:37:36,95,4232,39,56,2527.30,4474.01,0.00
2024-12-10 17:37:36,95,4233,39,56,2502.43,4475.00,0.00
2024-12-10 17:37:36,96,4233,39,57,2476.36,4475.01,0.00
2024-12-10 17:37:36,95,4233,39,56,2496.79,4475.10,0.00
2024-12-10 17:37:36,94,4233,38,56,2478.44,4475.70,0.00
2024-12-10 17:37:36,94,4234,38,56,2512.95,4476.00,0.00
2024-12-10 17:37:36,95,4234,38,57,2486.50,4476.01,0.00
2024-12-10 17:37:36,94,4234,37,57,2458.65,4476.89,0.00
2024-12-10 17:37:37,94,4235,37,57,2501.60,4477.00,0.00
2024-12-10 17:37:37,95,4235,37,58,2475.27,4477.01,0.00
2024-12-10 17:37:37,94,4235,37,57,2488.28,4477.09,0.00
2024-12-10 17:37:37,94,4236,37,57,2476.44,4478.00,0.00
2024-12-10 17:37:37,95,4236,38,57,2450.37,4478.01,0.00
2024-12-10 17:37:37,94,4236,38,56,2472.16,4478.09,0.00
2024-12-10 17:37:37,93,4236,37,56,2489.20,4478.30,0.00
2024-12-10 17:37:37,93,4237,37,56,2487.25,4479.00,0.00
2024-12-10 17:37:37,94,4237,38,56,2460.79,4479.01,0.00
2024-12-10 17:37:37,93,4237,37,56,2486.29,4479.02,0.00
2024-12-10 17:37:37,92,4237,36,56,2464.01,4479.75,0.00
2024-12-10 17:37:37,92,4238,36,56,2501.71,4480.00,0.00
2024-12-10 17:37:37,93,4238,37,56,2474.81,4480.01,0.00
2024-12-10 17:37:37,92,4238,36,56,2500.74,4480.02,0.00
2024-12-10 17:37:37,91,4238,36,55,2526.74,4480.04,0.00
2024-12-10 17:37:37,92,4237,37,55,2480.36,4480.27,0.00
2024-12-10 17:37:37,92,4238,37,55,2515.04,4481.00,0.00
2024-12-10 17:37:37,93,4238,38,55,2488.00,4481.01,0.00
2024-12-10 17:37:37,92,4238,38,54,2514.08,4481.02,0.00
2024-12-10 17:37:37,92,4239,38,54,2538.99,4482.00,0.00
2024-12-10 17:37:37,93,4239,39,54,2511.69,4482.01,0.00
2024-12-10 17:37:37,92,4239,39,53,2535.11,4482.05,0.00
2024-12-10 17:37:37,92,4240,39,53,2522.50,4483.00,0.00
2024-12-10 17:37:37,93,4240,40,53,2495.38,4483.01,0.00
2024-12-10 17:37:37,92,4240,40,52,2511.31,4483.05,0.00
2024-12-10 17:37:37,92,4241,40,52,2498.69,4484.00,0.00
2024-12-10 17:37:37,93,4241,40,53,2471.83,4484.01,0.00
2024-12-10 17:37:37,92,4241,40,52,2487.50,4484.05,0.00
2024-12-10 17:37:37,91,4241,39,52,2461.01,4484.95,0.00
2024-12-10 17:37:37,91,4242,39,52,2507.87,4485.00,0.00
2024-12-10 17:37:37,92,4242,40,52,2480.61,4485.01,0.00
2024-12-10 17:37:37,91,4242,39,52,2484.81,4485.30,0.00
2024-12-10 17:37:37,91,4243,39,52,2498.03,4486.00,0.00
2024-12-10 17:37:37,92,4243,40,52,2470.88,4486.01,0.00
2024-12-10 17:37:37,92,4244,40,52,2458.08,4487.00,0.00
2024-12-10 17:37:37,93,4244,41,52,2431.65,4487.01,0.00
2024-12-10 17:37:37,92,4244,40,52,2457.11,4487.02,0.00
2024-12-10 17:37:37,93,4243,40,53,2430.21,4487.05,0.00
2024-12-10 17:37:37,92,4243,39,53,2423.32,4487.76,0.00
2024-12-10 17:37:37,92,4244,39,53,2446.61,4488.00,0.00
2024-12-10 17:37:37,93,4244,39,54,2420.31,4488.01,0.00
2024-12-10 17:37:37,92,4244,39,53,2435.41,4488.05,0.00
2024-12-10 17:37:37,92,4245,39,53,2471.56,4489.00,0.00
2024-12-10 17:37:37,93,4245,40,53,2444.98,4489.01,0.00
2024-12-10 17:37:37,93,4246,40,53,2424.35,4490.00,0.00
2024-12-10 17:37:37,94,4246,41,53,2398.56,4490.01,0.00
2024-12-10 17:37:37,93,4246,41,52,2413.26,4490.06,0.00
2024-12-10 17:37:37,93,4247,41,52,2400.74,4491.00,0.00
2024-12-10 17:37:37,94,4247,41,53,2375.20,4491.01,0.00
2024-12-10 17:37:37,93,4247,41,52,2389.66,4491.08,0.00
2024-12-10 17:37:37,92,4247,40,52,2404.97,4491.32,0.00
2024-12-10 17:37:37,91,4247,39,52,2408.82,4491.56,0.00
2024-12-10 17:37:37,91,4248,39,52,2438.75,4492.00,0.00
2024-12-10 17:37:37,92,4248,39,53,2412.24,4492.01,0.00
2024-12-10 17:37:37,91,4248,38,53,2437.27,4492.04,0.00
2024-12-10 17:37:37,90,4248,38,52,2455.37,4492.07,0.00
2024-12-10 17:37:37,90,4249,38,52,2443.91,4493.00,0.00
2024-12-10 17:37:37,91,4249,39,52,2417.06,4493.01,0.00
2024-12-10 17:37:37,90,4249,39,51,2433.45,4493.07,0.00
2024-12-10 17:37:37,89,4249,38,51,2412.63,4493.72,0.00
2024-12-10 17:37:37,89,4250,38,51,2450.71,4494.00,0.00
2024-12-10 17:37:37,90,4250,39,51,2423.48,4494.01,0.00
2024-12-10 17:37:37,89,4250,39,50,2440.64,4494.07,0.00
2024-12-10 17:37:37,89,4251,39,50,2429.54,4495.00,0.00
2024-12-10 17:37:37,90,4251,40,50,2402.55,4495.01,0.00
2024-12-10 17:37:37,89,4251,40,49,2419.46,4495.07,0.00
2024-12-10 17:37:37,89,4252,40,49,2408.36,4496.00,0.00
2024-12-10 17:37:37,90,4252,41,49,2381.60,4496.01,0.00
2024-12-10 17:37:37,89,4252,41,48,2398.28,4496.07,0.00
2024-12-10 17:37:37,88,4252,40,48,2418.87,4496.22,0.00
2024-12-10 17:37:37,88,4253,40,48,2414.74,4497.00,0.00
2024-12-10 17:37:37,89,4253,41,48,2387.61,4497.01,0.00
2024-12-10 17:37:37,88,4253,41,47,2404.54,4497.07,0.00
2024-12-10 17:37:37,88,4254,41,47,2393.81,4498.00,0.00
2024-12-10 17:37:37,89,4254,41,48,2366.91,4498.01,0.00
2024-12-10 17:37:37,88,4254,41,47,2383.60,4498.07,0.00
2024-12-10 17:37:37,88,4255,41,47,2372.87,4499.00,0.00
2024-12-10 17:37:37,89,4255,42,47,2346.20,4499.01,0.00
2024-12-10 17:37:37,88,4255,42,46,2362.15,4499.07,0.00
2024-12-10 17:37:37,87,4255,41,46,2346.80,4499.90,0.00
2024-12-10 17:37:37,87,4256,41,46,2393.95,4500.00,0.00
2024-12-10 17:37:37,88,4256,41,47,2366.75,4500.01,0.00
2024-12-10 17:37:37,88,4257,41,47,2358.75,4501.00,0.00
2024-12-10 17:37:37,89,4257,42,47,2332.25,4501.01,0.00
2024-12-10 17:37:37,89,4258,42,47,2320.98,4502.00,0.00
2024-12-10 17:37:37,90,4258,43,47,2295.20,4502.01,0.00
2024-12-10 17:37:37,90,4259,43,47,2276.72,4503.00,0.00
2024-12-10 17:37:37,91,4259,44,47,2251.70,4503.01,0.00
2024-12-10 17:37:37,90,4259,44,46,2265.23,4503.07,0.00
2024-12-10 17:37:37,90,4260,44,46,2253.71,4504.00,0.00
2024-12-10 17:37:37,91,4260,44,47,2228.94,4504.01,0.00
2024-12-10 17:37:37,90,4260,44,46,2251.72,4504.04,0.00
2024-12-10 17:37:37,89,4260,44,45,2268.93,4504.07,0.00
2024-12-10 17:37:37,90,4259,44,46,2240.23,4504.17,0.00
2024-12-10 17:37:37,90,4260,44,46,2271.23,4505.00,0.00
2024-12-10 17:37:37,91,4260,44,47,2246.27,4505.01,0.00
2024-12-10 17:37:37,90,4260,44,46,2261.74,4505.07,0.00
2024-12-10 17:37:37,90,4261,44,46,2300.27,4506.00,0.00
2024-12-10 17:37:37,91,4261,45,46,2274.99,4506.01,0.00
2024-12-10 17:37:37,90,4261,45,45,2298.28,4506.04,0.00
2024-12-10 17:37:37,90,4262,45,45,2281.21,4507.00,0.00
2024-12-10 17:37:38,91,4262,46,45,2256.14,4507.01,0.00
2024-12-10 17:37:38,90,4262,45,45,2280.21,4507.02,0.00
2024-12-10 17:37:38,91,4261,46,45,2255.16,4507.04,0.00
2024-12-10 17:37:38,90,4261,46,44,2278.74,4507.10,0.00
2024-12-10 17:37:38,89,4261,45,44,2293.78,4507.33,0.00
2024-12-10 17:37:38,89,4262,45,44,2294.19,4508.00,0.00
2024-12-10 17:37:38,90,4262,45,45,2268.69,4508.01,0.00
2024-12-10 17:37:38,89,4262,44,45,2247.23,4508.75,0.00
2024-12-10 17:37:38,89,4263,44,45,2337.59,4509.00,0.00
2024-12-10 17:37:38,90,4263,44,46,2311.61,4509.01,0.00
2024-12-10 17:37:38,89,4263,43,46,2321.73,4509.14,0.00
2024-12-10 17:37:38,89,4264,43,46,2328.61,4510.00,0.00
2024-12-10 17:37:38,90,4264,43,47,2302.73,4510.01,0.00
2024-12-10 17:37:38,90,4265,43,47,2290.01,4511.00,0.00
2024-12-10 17:37:38,91,4265,43,48,2264.84,4511.01,0.00
2024-12-10 17:37:38,90,4265,42,48,2246.18,4511.66,0.00
2024-12-10 17:37:38,90,4266,42,48,2281.02,4512.00,0.00
2024-12-10 17:37:38,91,4266,43,48,2255.95,4512.01,0.00
2024-12-10 17:37:38,90,4266,43,47,2250.46,4512.10,0.00
2024-12-10 17:37:38,90,4267,43,47,2260.46,4513.00,0.00
2024-12-10 17:37:38,91,4267,44,47,2235.62,4513.01,0.00
2024-12-10 17:37:38,90,4267,44,46,2244.94,4513.12,0.00
2024-12-10 17:37:38,89,4267,43,46,2243.85,4513.29,0.00
2024-12-10 17:37:38,89,4268,43,46,2263.04,4514.00,0.00
2024-12-10 17:37:38,90,4268,43,47,2237.89,4514.01,0.00
2024-12-10 17:37:38,89,4268,43,46,2247.34,4514.12,0.00
2024-12-10 17:37:38,89,4269,43,46,2238.68,4515.00,0.00
2024-12-10 17:37:38,90,4269,44,46,2213.81,4515.01,0.00
2024-12-10 17:37:38,89,4269,43,46,2234.13,4515.06,0.00
2024-12-10 17:37:38,88,4269,43,45,2253.88,4515.07,0.00
2024-12-10 17:37:38,88,4270,43,45,2263.60,4516.00,0.00
2024-12-10 17:37:38,89,4270,44,45,2238.16,4516.01,0.00
2024-12-10 17:37:38,88,4270,43,45,2239.55,4516.31,0.00
2024-12-10 17:37:38,87,4270,42,45,2227.09,4516.72,0.00
2024-12-10 17:37:38,87,4271,42,45,2266.76,4517.00,0.00
2024-12-10 17:37:38,88,4271,42,46,2241.00,4517.01,0.00
2024-12-10 17:37:38,87,4271,42,45,2258.48,4517.15,0.00
2024-12-10 17:37:38,87,4272,42,45,2251.68,4518.00,0.00
2024-12-10 17:37:38,88,4272,43,45,2226.09,4518.01,0.00
2024-12-10 17:37:38,87,4272,42,45,2249.62,4518.05,0.00
2024-12-10 17:37:38,87,4273,42,45,2228.73,4519.00,0.00
2024-12-10 17:37:38,88,4273,42,46,2203.41,4519.01,0.00
2024-12-10 17:37:38,87,4273,42,45,2220.97,4519.15,0.00
2024-12-10 17:37:38,86,4273,41,45,2240.01,4519.30,0.00
2024-12-10 17:37:38,85,4273,40,45,2225.91,4519.98,0.00
2024-12-10 17:37:38,85,4274,40,45,2278.03,4520.00,0.00
2024-12-10 17:37:38,86,4274,41,45,2251.54,4520.01,0.00
2024-12-10 17:37:38,85,4274,40,45,2238.82,4520.48,0.00
2024-12-10 17:37:38,85,4275,40,45,2268.96,4521.00,0.00
2024-12-10 17:37:38,86,4275,40,46,2242.58,4521.01,0.00
2024-12-10 17:37:38,85,4275,40,45,2261.54,4521.15,0.00
2024-12-10 17:37:38,86,4274,40,46,2230.02,4521.29,0.00
2024-12-10 17:37:38,85,4274,39,46,2282.97,4521.45,0.00
2024-12-10 17:37:38,85,4275,39,46,2290.26,4522.00,0.00
2024-12-10 17:37:38,86,4275,40,46,2263.63,4522.01,0.00
2024-12-10 17:37:38,86,4276,40,46,2293.20,4523.00,0.00
2024-12-10 17:37:38,87,4276,40,47,2266.84,4523.01,0.00
2024-12-10 17:37:38,86,4276,39,47,2291.11,4523.05,0.00
2024-12-10 17:37:38,85,4276,39,46,2312.76,4523.15,0.00
2024-12-10 17:37:38,85,4277,39,46,2306.85,4524.00,0.00
2024-12-10 17:37:38,86,4277,40,46,2280.03,4524.01,0.00
2024-12-10 17:37:38,87,4276,40,47,2222.77,4524.49,0.00
2024-12-10 17:37:38,86,4276,39,47,2252.15,4524.57,0.00
2024-12-10 17:37:38,86,4277,39,47,2285.60,4525.00,0.00
2024-12-10 17:37:38,87,4277,40,47,2259.33,4525.01,0.00
2024-12-10 17:37:38,86,4277,40,46,2277.73,4525.16,0.00
2024-12-10 17:37:38,86,4278,40,46,2324.52,4526.00,0.00
2024-12-10 17:37:38,87,4278,41,46,2297.80,4526.01,0.00
2024-12-10 17:37:38,86,4278,40,46,2322.96,4526.04,0.00
2024-12-10 17:37:38,85,4278,40,45,2341.77,4526.08,0.00
2024-12-10 17:37:38,86,4277,41,45,2308.78,4526.23,0.00
2024-12-10 17:37:38,85,4277,40,45,2312.02,4526.33,0.00
2024-12-10 17:37:38,86,4276,40,46,2276.28,4526.55,0.00
2024-12-10 17:37:38,86,4277,40,46,2328.72,4527.00,0.00
2024-12-10 17:37:38,87,4277,40,47,2301.96,4527.01,0.00
2024-12-10 17:37:38,86,4277,40,46,2327.15,4527.04,0.00
2024-12-10 17:37:38,85,4277,40,45,2339.10,4527.13,0.00
2024-12-10 17:37:38,86,4276,40,46,2263.80,4527.76,0.00
2024-12-10 17:37:38,86,4277,40,46,2420.36,4528.00,0.00
2024-12-10 17:37:38,87,4277,41,46,2392.54,4528.01,0.00
2024-12-10 17:37:38,86,4277,41,45,2418.79,4528.04,0.00
2024-12-10 17:37:38,85,4277,41,44,2432.34,4528.12,0.00
2024-12-10 17:37:38,85,4278,41,44,2478.15,4529.00,0.00
2024-12-10 17:37:38,86,4278,41,45,2449.33,4529.01,0.00
2024-12-10 17:37:38,85,4278,41,44,2455.24,4529.04,0.00
2024-12-10 17:37:38,84,4278,40,44,2454.63,4529.45,0.00
2024-12-10 17:37:38,85,4277,41,44,2415.22,4529.71,0.00
2024-12-10 17:37:38,85,4278,41,44,2466.64,4530.00,0.00
2024-12-10 17:37:38,86,4278,41,45,2437.95,4530.01,0.00
2024-12-10 17:37:38,85,4278,40,45,2445.85,4530.02,0.00
2024-12-10 17:37:38,84,4278,40,44,2471.20,4530.10,0.00
2024-12-10 17:37:38,84,4279,40,44,2538.62,4531.00,0.00
2024-12-10 17:37:38,85,4279,40,45,2508.76,4531.01,0.00
2024-12-10 17:37:38,85,4280,40,45,2488.94,4532.00,0.00
2024-12-10 17:37:38,86,4280,41,45,2460.00,4532.01,0.00
2024-12-10 17:37:38,85,4280,41,44,2479.35,4532.07,0.00
2024-12-10 17:37:38,84,4280,40,44,2508.85,4532.07,0.00
2024-12-10 17:37:38,83,4280,39,44,2536.37,4532.12,0.00
2024-12-10 17:37:38,82,4280,38,44,2539.91,4532.43,0.00
2024-12-10 17:37:38,82,4281,38,44,2569.62,4533.00,0.00
2024-12-10 17:37:38,83,4281,38,45,2538.66,4533.01,0.00
2024-12-10 17:37:38,84,4280,38,46,2474.10,4533.56,0.00
2024-12-10 17:37:38,84,4281,38,46,2524.64,4534.00,0.00
2024-12-10 17:37:38,85,4281,39,46,2494.94,4534.01,0.00
2024-12-10 17:37:38,84,4281,39,45,2519.79,4534.10,0.00
2024-12-10 17:37:38,85,4280,39,46,2475.36,4534.45,0.00
2024-12-10 17:37:38,84,4280,38,46,2529.87,4534.76,0.00
2024-12-10 17:37:38,84,4281,38,46,2627.24,4535.00,0.00
2024-12-10 17:37:38,85,4281,38,47,2596.33,4535.01,0.00
2024-12-10 17:37:38,85,4282,38,47,2643.09,4536.00,0.00
2024-12-10 17:37:38,86,4282,39,47,2612.36,4536.01,0.00
2024-12-10 17:37:38,85,4282,38,47,2642.02,4536.02,0.00
2024-12-10 17:37:39,85,4283,38,47,2633.58,4537.00,0.00
2024-12-10 17:37:39,86,4283,39,47,2602.95,4537.01,0.00
2024-12-10 17:37:39,85,4283,39,46,2630.91,4537.04,0.00
2024-12-10 17:37:39,86,4282,39,47,2551.02,4537.69,0.00
2024-12-10 17:37:39,87,4281,40,47,2529.58,4537.77,0.00
2024-12-10 17:37:39,87,4282,40,47,2578.30,4538.00,0.00
2024-12-10 17:37:39,88,4282,41,47,2549.00,4538.01,0.00
2024-12-10 17:37:39,87,4282,40,47,2577.25,4538.02,0.00
2024-12-10 17:37:39,87,4283,40,47,2666.72,4539.00,0.00
2024-12-10 17:37:39,88,4283,41,47,2636.41,4539.01,0.00
2024-12-10 17:37:39,88,4284,41,47,2612.75,4540.00,0.00
2024-12-10 17:37:39,89,4284,41,48,2583.39,4540.01,0.00
2024-12-10 17:37:39,88,4284,40,48,2611.72,4540.02,0.00
2024-12-10 17:37:39,87,4284,40,47,2637.05,4540.05,0.00
2024-12-10 17:37:39,87,4285,40,47,2625.57,4541.00,0.00
2024-12-10 17:37:39,88,4285,40,48,2595.73,4541.01,0.00
2024-12-10 17:37:39,87,4285,40,47,2613.56,4541.05,0.00
2024-12-10 17:37:39,86,4285,39,47,2632.87,4541.05,0.00
2024-12-10 17:37:39,85,4285,38,47,2654.34,4541.25,0.00
2024-12-10 17:37:39,85,4286,38,47,2674.10,4542.00,0.00
2024-12-10 17:37:39,86,4286,39,47,2643.00,4542.01,0.00
2024-12-10 17:37:39,85,4286,39,46,2661.27,4542.05,0.00
2024-12-10 17:37:39,84,4286,38,46,2670.36,4542.36,0.00
2024-12-10 17:37:39,85,4285,38,47,2626.30,4542.66,0.00
2024-12-10 17:37:39,86,4284,38,48,2575.64,4542.83,0.00
2024-12-10 17:37:39,86,4285,38,48,2626.50,4543.00,0.00
2024-12-10 17:37:39,87,4285,39,48,2596.31,4543.01,0.00
2024-12-10 17:37:39,86,4285,39,47,2613.83,4543.05,0.00
2024-12-10 17:37:39,85,4285,38,47,2594.85,4543.69,0.00
2024-12-10 17:37:39,85,4286,38,47,2720.18,4544.00,0.00
2024-12-10 17:37:39,86,4286,38,48,2688.55,4544.01,0.00
2024-12-10 17:37:39,85,4286,38,47,2706.82,4544.06,0.00
2024-12-10 17:37:39,84,4286,37,47,2720.17,4544.32,0.00
2024-12-10 17:37:39,85,4285,37,48,2661.86,4544.93,0.00
2024-12-10 17:37:39,85,4286,37,48,2735.71,4545.00,0.00
2024-12-10 17:37:39,86,4286,37,49,2703.90,4545.01,0.00
2024-12-10 17:37:39,85,4286,36,49,2723.41,4545.05,0.00
2024-12-10 17:37:39,84,4286,36,48,2744.47,4545.05,0.00
2024-12-10 17:37:39,84,4287,36,48,2810.02,4546.00,0.00
2024-12-10 17:37:39,85,4287,36,49,2776.96,4546.01,0.00
2024-12-10 17:37:39,86,4286,37,49,2674.85,4546.88,0.00
2024-12-10 17:37:39,86,4287,37,49,2726.24,4547.00,0.00
2024-12-10 17:37:39,87,4287,38,49,2694.90,4547.01,0.00
2024-12-10 17:37:39,86,4287,37,49,2725.71,4547.01,0.00
2024-12-10 17:37:39,85,4287,37,48,2754.04,4547.06,0.00
2024-12-10 17:37:39,85,4288,37,48,2797.44,4548.00,0.00
2024-12-10 17:37:39,86,4288,38,48,2764.91,4548.01,0.00
2024-12-10 17:37:39,87,4287,38,49,2715.40,4548.20,0.00
2024-12-10 17:37:39,88,4286,38,50,2667.26,4548.88,0.00
2024-12-10 17:37:39,88,4287,38,50,2717.00,4549.00,0.00
2024-12-10 17:37:39,89,4287,39,50,2686.48,4549.01,0.00
2024-12-10 17:37:39,88,4287,39,49,2713.91,4549.06,0.00
2024-12-10 17:37:39,88,4288,39,49,2805.39,4550.00,0.00
2024-12-10 17:37:39,89,4288,39,50,2773.87,4550.01,0.00
2024-12-10 17:37:39,89,4289,39,50,2748.73,4551.00,0.00
2024-12-10 17:37:39,90,4289,40,50,2718.19,4551.01,0.00
2024-12-10 17:37:39,89,4289,40,49,2748.22,4551.01,0.00
2024-12-10 17:37:39,88,4289,40,48,2772.74,4551.09,0.00
2024-12-10 17:37:39,89,4288,41,48,2727.58,4551.38,0.00
2024-12-10 17:37:39,89,4289,41,48,2742.36,4552.00,0.00
2024-12-10 17:37:39,90,4289,42,48,2711.89,4552.01,0.00
2024-12-10 17:37:39,89,4289,41,48,2711.18,4552.10,0.00
2024-12-10 17:37:39,88,4289,40,48,2713.86,4552.66,0.00
2024-12-10 17:37:39,88,4290,40,48,2802.07,4553.00,0.00
2024-12-10 17:37:39,89,4290,41,48,2770.59,4553.01,0.00
2024-12-10 17:37:39,88,4290,41,47,2801.55,4553.01,0.00
2024-12-10 17:37:39,87,4290,41,46,2828.01,4553.08,0.00
2024-12-10 17:37:39,86,4290,40,46,2848.93,4553.31,0.00
2024-12-10 17:37:39,87,4289,40,47,2794.53,4553.82,0.00
2024-12-10 17:37:39,87,4290,40,47,2822.97,4554.00,0.00
2024-12-10 17:37:39,88,4290,40,48,2790.89,4554.01,0.00
2024-12-10 17:37:39,87,4290,39,48,2804.14,4554.09,0.00
2024-12-10 17:37:39,86,4290,38,48,2800.53,4554.65,0.00
2024-12-10 17:37:39,86,4291,38,48,2890.84,4555.00,0.00
2024-12-10 17:37:39,87,4291,39,48,2857.62,4555.01,0.00
2024-12-10 17:37:39,86,4291,38,48,2873.91,4555.08,0.00
2024-12-10 17:37:39,85,4291,38,47,2901.83,4555.09,0.00
2024-12-10 17:37:39,86,4290,39,47,2852.39,4555.47,0.00
2024-12-10 17:37:39,86,4291,39,47,2919.56,4556.00,0.00
2024-12-10 17:37:39,87,4291,39,48,2886.00,4556.01,0.00
2024-12-10 17:37:39,87,4292,39,48,2927.56,4557.00,0.00
2024-12-10 17:37:39,88,4292,40,48,2894.29,4557.01,0.00
2024-12-10 17:37:39,87,4292,39,48,2872.19,4557.66,0.00
2024-12-10 17:37:39,87,4293,39,48,2909.16,4558.00,0.00
2024-12-10 17:37:39,88,4293,40,48,2876.10,4558.01,0.00
2024-12-10 17:37:39,87,4293,39,48,2859.77,4558.56,0.00
2024-12-10 17:37:39,87,4294,39,48,2892.62,4559.00,0.00
2024-12-10 17:37:39,88,4294,40,48,2859.75,4559.01,0.00
2024-12-10 17:37:39,87,4294,40,47,2884.77,4559.09,0.00
2024-12-10 17:37:39,87,4295,40,47,2875.43,4560.00,0.00
2024-12-10 17:37:39,88,4295,40,48,2842.75,4560.01,0.00
2024-12-10 17:37:39,87,4295,39,48,2840.35,4560.14,0.00
2024-12-10 17:37:39,87,4296,39,48,2854.04,4561.00,0.00
2024-12-10 17:37:39,88,4296,39,49,2821.61,4561.01,0.00
2024-12-10 17:37:39,87,4296,39,48,2825.22,4561.09,0.00
2024-12-10 17:37:39,87,4297,39,48,2836.84,4562.00,0.00
2024-12-10 17:37:39,88,4297,40,48,2804.60,4562.01,0.00
2024-12-10 17:37:39,89,4296,41,48,2734.45,4562.66,0.00
2024-12-10 17:37:39,89,4297,41,48,2756.78,4563.00,0.00
2024-12-10 17:37:39,90,4297,42,48,2726.15,4563.01,0.00
2024-12-10 17:37:39,89,4297,42,47,2748.59,4563.09,0.00
2024-12-10 17:37:39,90,4296,42,48,2697.00,4563.58,0.00
2024-12-10 17:37:39,90,4297,42,48,2772.89,4564.00,0.00
2024-12-10 17:37:39,91,4297,43,48,2742.42,4564.01,0.00
2024-12-10 17:37:39,90,4297,42,48,2752.15,4564.21,0.00
2024-12-10 17:37:39,90,4298,42,48,2818.13,4565.00,0.00
2024-12-10 17:37:39,91,4298,42,49,2787.17,4565.01,0.00
2024-12-10 17:37:39,90,4298,42,48,2810.54,4565.09,0.00
2024-12-10 17:37:39,91,4297,42,49,2767.24,4565.39,0.00
2024-12-10 17:37:40,91,4298,42,49,2783.26,4566.00,0.00
2024-12-10 17:37:40,92,4298,42,50,2753.01,4566.01,0.00
2024-12-10 17:37:40,91,4298,41,50,2782.76,4566.01,0.00
2024-12-10 17:37:40,92,4297,41,51,2725.38,4566.41,0.00
2024-12-10 17:37:40,92,4298,41,51,2809.97,4567.00,0.00
2024-12-10 17:37:40,93,4298,41,52,2779.76,4567.01,0.00
2024-12-10 17:37:40,92,4298,41,51,2800.55,4567.09,0.00
2024-12-10 17:37:40,91,4298,40,51,2787.89,4567.63,0.00
2024-12-10 17:37:40,91,4299,40,51,2871.51,4568.00,0.00
2024-12-10 17:37:40,92,4299,40,52,2840.29,4568.01,0.00
2024-12-10 17:37:40,91,4299,39,52,2871.00,4568.01,0.00
2024-12-10 17:37:40,91,4300,39,52,2846.53,4569.00,0.00
2024-12-10 17:37:40,92,4300,40,52,2815.59,4569.01,0.00
2024-12-10 17:37:40,91,4300,40,51,2837.00,4569.09,0.00
2024-12-10 17:37:40,92,4299,40,52,2755.91,4569.78,0.00
2024-12-10 17:37:40,92,4300,40,52,2803.29,4570.00,0.00
2024-12-10 17:37:40,93,4300,41,52,2773.14,4570.01,0.00
2024-12-10 17:37:40,92,4300,40,52,2799.86,4570.08,0.00
2024-12-10 17:37:40,92,4301,40,52,2829.04,4571.00,0.00
2024-12-10 17:37:40,93,4301,40,53,2798.62,4571.01,0.00
2024-12-10 17:37:40,92,4301,40,52,2817.63,4571.11,0.00
2024-12-10 17:37:40,93,4300,40,53,2779.07,4571.31,0.00
2024-12-10 17:37:40,94,4299,41,53,2744.75,4571.49,0.00
2024-12-10 17:37:40,93,4299,40,53,2812.08,4571.72,0.00
2024-12-10 17:37:40,93,4300,40,53,2829.02,4572.00,0.00
2024-12-10 17:37:40,94,4300,41,53,2798.93,4572.01,0.00
2024-12-10 17:37:40,93,4300,40,53,2828.53,4572.01,0.00
2024-12-10 17:37:40,92,4300,40,52,2858.78,4572.01,0.00
2024-12-10 17:37:40,92,4301,40,52,2933.51,4573.00,0.00
2024-12-10 17:37:40,93,4301,41,52,2901.96,4573.01,0.00
2024-12-10 17:37:40,92,4301,40,52,2931.50,4573.05,0.00
2024-12-10 17:37:40,91,4301,40,51,2956.69,4573.08,0.00
2024-12-10 17:37:40,90,4301,39,51,2986.48,4573.15,0.00
2024-12-10 17:37:40,90,4302,39,51,2978.44,4574.00,0.00
2024-12-10 17:37:40,91,4302,40,51,2945.71,4574.01,0.00
2024-12-10 17:37:40,90,4302,40,50,2977.93,4574.01,0.00
2024-12-10 17:37:40,89,4302,39,50,2995.51,4574.14,0.00
2024-12-10 17:37:40,89,4303,39,50,2987.38,4575.00,0.00
2024-12-10 17:37:40,90,4303,39,51,2954.19,4575.01,0.00
2024-12-10 17:37:40,89,4303,39,50,2986.86,4575.01,0.00
2024-12-10 17:37:40,88,4303,39,49,3013.03,4575.06,0.00
2024-12-10 17:37:40,89,4302,39,50,2979.17,4575.08,0.00
2024-12-10 17:37:40,89,4303,39,50,2991.63,4576.00,0.00
2024-12-10 17:37:40,90,4303,40,50,2958.39,4576.01,0.00
2024-12-10 17:37:40,91,4302,41,50,2888.60,4576.48,0.00
2024-12-10 17:37:40,91,4303,41,50,2977.00,4577.00,0.00
2024-12-10 17:37:40,92,4303,42,50,2944.64,4577.01,0.00
2024-12-10 17:37:40,93,4302,43,50,2895.34,4577.20,0.00
2024-12-10 17:37:40,93,4303,43,50,2954.71,4578.00,0.00
2024-12-10 17:37:40,94,4303,43,51,2923.27,4578.01,0.00
2024-12-10 17:37:40,93,4303,42,51,2938.51,4578.14,0.00
2024-12-10 17:37:40,93,4304,42,51,2978.49,4579.00,0.00
2024-12-10 17:37:40,94,4304,43,51,2946.81,4579.01,0.00
2024-12-10 17:37:40,93,4304,43,50,2969.66,4579.06,0.00
2024-12-10 17:37:40,93,4305,43,50,2956.98,4580.00,0.00
2024-12-10 17:37:40,94,4305,43,51,2925.52,4580.01,0.00
2024-12-10 17:37:40,94,4306,43,51,2900.33,4581.00,0.00
2024-12-10 17:37:40,95,4306,43,52,2869.80,4581.01,0.00
2024-12-10 17:37:40,94,4306,43,51,2893.54,4581.06,0.00
2024-12-10 17:37:40,95,4305,44,51,2851.63,4581.34,0.00
2024-12-10 17:37:40,94,4305,43,51,2859.94,4581.88,0.00
2024-12-10 17:37:40,94,4306,43,51,2903.40,4582.00,0.00
2024-12-10 17:37:40,95,4306,44,51,2872.84,4582.01,0.00
2024-12-10 17:37:40,96,4305,44,52,2841.02,4582.07,0.00
2024-12-10 17:37:40,96,4306,44,52,2868.84,4583.00,0.00
2024-12-10 17:37:40,97,4306,44,53,2839.26,4583.01,0.00
2024-12-10 17:37:40,96,4306,44,52,2862.66,4583.06,0.00
2024-12-10 17:37:40,97,4305,44,53,2823.33,4583.30,0.00
2024-12-10 17:37:40,97,4306,44,53,2890.45,4584.00,0.00
2024-12-10 17:37:40,98,4306,44,54,2860.95,4584.01,0.00
2024-12-10 17:37:40,99,4305,44,55,2831.14,4584.05,0.00
2024-12-10 17:37:40,99,4306,44,55,2882.52,4585.00,0.00
2024-12-10 17:37:40,100,4306,44,56,2853.69,4585.01,0.00
2024-12-10 17:37:40,99,4306,44,55,2876.99,4585.06,0.00
2024-12-10 17:37:40,98,4306,43,55,2902.65,4585.14,0.00
2024-12-10 17:37:40,99,4305,44,55,2846.37,4585.76,0.00
2024-12-10 17:37:40,99,4306,44,55,2935.03,4586.00,0.00
2024-12-10 17:37:40,100,4306,45,55,2905.68,4586.01,0.00
2024-12-10 17:37:40,100,4307,45,55,2925.12,4587.00,0.00
2024-12-10 17:37:40,101,4307,46,55,2896.16,4587.01,0.00
2024-12-10 17:37:40,100,4307,46,54,2916.90,4587.08,0.00
2024-12-10 17:37:40,99,4307,45,54,2914.33,4587.75,0.00
2024-12-10 17:37:40,100,4306,45,55,2884.74,4587.77,0.00
2024-12-10 17:37:40,100,4307,45,55,2927.13,4588.00,0.00
2024-12-10 17:37:40,101,4307,46,55,2898.15,4588.01,0.00
2024-12-10 17:37:40,101,4308,46,55,2916.96,4589.00,0.00
2024-12-10 17:37:40,102,4308,47,55,2888.36,4589.01,0.00
2024-12-10 17:37:40,101,4308,47,54,2908.81,4589.08,0.00
2024-12-10 17:37:40,102,4307,48,54,2870.96,4589.30,0.00
2024-12-10 17:37:40,103,4306,49,54,2837.64,4589.85,0.00
2024-12-10 17:37:40,103,4307,49,54,2861.83,4590.00,0.00
2024-12-10 17:37:40,104,4307,49,55,2834.32,4590.01,0.00
2024-12-10 17:37:40,104,4308,49,55,2895.41,4591.00,0.00
2024-12-10 17:37:40,105,4308,50,55,2867.84,4591.01,0.00
2024-12-10 17:37:40,104,4308,50,54,2887.50,4591.08,0.00
2024-12-10 17:37:40,104,4309,50,54,2872.20,4592.00,0.00
2024-12-10 17:37:40,105,4309,51,54,2844.84,4592.01,0.00
2024-12-10 17:37:40,106,4308,52,54,2770.06,4592.62,0.00
2024-12-10 17:37:40,107,4307,53,54,2743.94,4592.89,0.00
2024-12-10 17:37:40,107,4308,53,54,2784.81,4593.00,0.00
2024-12-10 17:37:40,108,4308,53,55,2759.03,4593.01,0.00
2024-12-10 17:37:40,109,4307,53,56,2714.03,4593.28,0.00
2024-12-10 17:37:40,110,4306,53,57,2647.56,4593.87,0.00
2024-12-10 17:37:40,110,4307,53,57,2770.43,4594.00,0.00
2024-12-10 17:37:40,111,4307,54,57,2745.47,4594.01,0.00
2024-12-10 17:37:41,110,4307,54,56,2763.78,4594.07,0.00
2024-12-10 17:37:41,111,4306,55,56,2722.51,4594.45,0.00
2024-12-10 17:37:41,110,4306,54,56,2752.91,4594.55,0.00
2024-12-10 17:37:41,110,4307,54,56,2857.66,4595.00,0.00
2024-12-10 17:37:41,111,4307,54,57,2831.92,4595.01,0.00
2024-12-10 17:37:41,111,4308,54,57,2856.16,4596.00,0.00
2024-12-10 17:37:41,112,4308,54,58,2830.66,4596.01,0.00
2024-12-10 17:37:41,112,4309,54,58,2808.69,4597.00,0.00
2024-12-10 17:37:41,113,4309,54,59,2783.84,4597.01,0.00
2024-12-10 17:37:41,112,4309,53,59,2769.49,4597.47,0.00
2024-12-10 17:37:41,111,4309,52,59,2783.82,4597.70,0.00
2024-12-10 17:37:41,110,4309,51,59,2808.71,4597.71,0.00
2024-12-10 17:37:41,110,4310,51,59,2837.38,4598.00,0.00
2024-12-10 17:37:41,111,4310,51,60,2811.81,4598.01,0.00
2024-12-10 17:37:41,110,4310,51,59,2828.21,4598.08,0.00
2024-12-10 17:37:41,110,4311,51,59,2811.65,4599.00,0.00
2024-12-10 17:37:41,111,4311,52,59,2786.32,4599.01,0.00
2024-12-10 17:37:41,110,4311,51,59,2773.82,4599.47,0.00
2024-12-10 17:37:41,110,4312,51,59,2791.77,4600.00,0.00
2024-12-10 17:37:41,111,4312,52,59,2766.62,4600.01,0.00
2024-12-10 17:37:41,112,4311,52,60,2741.10,4600.04,0.00
2024-12-10 17:37:41,111,4311,52,59,2765.84,4600.12,0.00
2024-12-10 17:37:41,111,4312,52,59,2750.64,4601.00,0.00
2024-12-10 17:37:41,112,4312,52,60,2726.08,4601.01,0.00
2024-12-10 17:37:41,112,4313,52,60,2738.59,4602.00,0.00
2024-12-10 17:37:41,113,4313,52,61,2714.36,4602.01,0.00
2024-12-10 17:37:41,112,4313,52,60,2731.65,4602.11,0.00
2024-12-10 17:37:41,112,4314,52,60,2715.76,4603.00,0.00
2024-12-10 17:37:41,113,4314,53,60,2691.73,4603.01,0.00
2024-12-10 17:37:41,112,4314,52,60,2714.13,4603.04,0.00
2024-12-10 17:37:41,111,4314,51,60,2720.84,4603.24,0.00
2024-12-10 17:37:41,111,4315,51,60,2711.33,4604.00,0.00
2024-12-10 17:37:41,112,4315,52,60,2687.12,4604.01,0.00
2024-12-10 17:37:41,111,4315,52,59,2705.56,4604.10,0.00
2024-12-10 17:37:41,111,4316,52,59,2689.15,4605.00,0.00
2024-12-10 17:37:41,112,4316,53,59,2665.14,4605.01,0.00
2024-12-10 17:37:41,112,4317,53,59,2635.87,4606.00,0.00
2024-12-10 17:37:41,113,4317,54,59,2612.54,4606.01,0.00
2024-12-10 17:37:41,112,4317,54,58,2629.74,4606.11,0.00
2024-12-10 17:37:41,111,4317,53,58,2633.65,4606.42,0.00
2024-12-10 17:37:41,110,4317,52,58,2641.39,4606.75,0.00
2024-12-10 17:37:41,110,4318,52,58,2671.75,4607.00,0.00
2024-12-10 17:37:41,111,4318,52,59,2647.68,4607.01,0.00
2024-12-10 17:37:41,111,4319,52,59,2619.84,4608.00,0.00
2024-12-10 17:37:41,112,4319,53,59,2596.45,4608.01,0.00
2024-12-10 17:37:41,111,4319,52,59,2619.42,4608.01,0.00
2024-12-10 17:37:41,110,4319,52,58,2632.80,4608.10,0.00
2024-12-10 17:37:41,109,4319,51,58,2648.16,4608.28,0.00
2024-12-10 17:37:41,109,4320,51,58,2639.86,4609.00,0.00
2024-12-10 17:37:41,110,4320,52,58,2615.86,4609.01,0.00
2024-12-10 17:37:41,110,4321,52,58,2586.35,4610.00,0.00
2024-12-10 17:37:41,111,4321,52,59,2563.05,4610.01,0.00
2024-12-10 17:37:41,110,4321,52,58,2577.57,4610.06,0.00
2024-12-10 17:37:41,111,4320,53,58,2553.94,4610.09,0.00
2024-12-10 17:37:41,111,4321,53,58,2554.19,4611.00,0.00
2024-12-10 17:37:41,112,4321,53,59,2531.38,4611.01,0.00
2024-12-10 17:37:41,111,4321,53,58,2550.07,4611.09,0.00
2024-12-10 17:37:41,110,4321,52,58,2563.28,4611.30,0.00
2024-12-10 17:37:41,110,4322,52,58,2597.36,4612.00,0.00
2024-12-10 17:37:41,111,4322,53,58,2573.96,4612.01,0.00
2024-12-10 17:37:41,111,4323,53,58,2544.25,4613.00,0.00
2024-12-10 17:37:41,112,4323,54,58,2521.53,4613.01,0.00
2024-12-10 17:37:41,113,4322,54,59,2499.22,4613.03,0.00
2024-12-10 17:37:41,112,4322,54,58,2549.99,4613.10,0.00
2024-12-10 17:37:41,111,4322,53,58,2563.90,4613.30,0.00
2024-12-10 17:37:41,110,4322,52,58,2586.79,4613.30,0.00
2024-12-10 17:37:41,110,4323,52,58,2578.74,4614.00,0.00
2024-12-10 17:37:41,111,4323,53,58,2555.51,4614.01,0.00
2024-12-10 17:37:41,110,4323,53,57,2560.31,4614.04,0.00
2024-12-10 17:37:41,109,4323,53,56,2572.39,4614.09,0.00
2024-12-10 17:37:41,110,4322,53,57,2545.68,4614.18,0.00
2024-12-10 17:37:41,111,4321,54,57,2535.25,4614.26,0.00
2024-12-10 17:37:41,110,4321,53,57,2559.86,4614.79,0.00
2024-12-10 17:37:41,110,4322,53,57,2634.27,4615.00,0.00
2024-12-10 17:37:41,111,4322,54,57,2610.53,4615.01,0.00
2024-12-10 17:37:41,111,4323,54,57,2674.94,4616.00,0.00
2024-12-10 17:37:41,112,4323,54,58,2651.06,4616.01,0.00
2024-12-10 17:37:41,113,4322,54,59,2625.98,4616.06,0.00
2024-12-10 17:37:41,113,4323,54,59,2619.25,4617.00,0.00
2024-12-10 17:37:41,114,4323,54,60,2596.28,4617.01,0.00
2024-12-10 17:37:41,115,4322,55,60,2546.98,4617.44,0.00
2024-12-10 17:37:41,115,4323,55,60,2604.38,4618.00,0.00
2024-12-10 17:37:41,116,4323,56,60,2581.92,4618.01,0.00
2024-12-10 17:37:41,115,4323,56,59,2599.20,4618.09,0.00
2024-12-10 17:37:41,114,4323,55,59,2570.14,4618.97,0.00
2024-12-10 17:37:41,114,4324,55,59,2649.58,4619.00,0.00
2024-12-10 17:37:41,115,4324,55,60,2626.54,4619.01,0.00
2024-12-10 17:37:41,114,4324,54,60,2640.68,4619.04,0.00
2024-12-10 17:37:41,113,4324,54,59,2653.86,4619.09,0.00
2024-12-10 17:37:41,114,4323,55,59,2622.94,4619.27,0.00
2024-12-10 17:37:41,114,4324,55,59,2655.82,4620.00,0.00
2024-12-10 17:37:41,115,4324,55,60,2632.73,4620.01,0.00
2024-12-10 17:37:41,116,4323,55,61,2573.68,4620.65,0.00
2024-12-10 17:37:41,116,4324,55,61,2637.28,4621.00,0.00
2024-12-10 17:37:41,117,4324,55,62,2614.74,4621.01,0.00
2024-12-10 17:37:41,118,4323,56,62,2530.75,4621.86,0.00
2024-12-10 17:37:41,118,4324,56,62,2606.85,4622.00,0.00
2024-12-10 17:37:41,119,4324,57,62,2584.95,4622.01,0.00
2024-12-10 17:37:41,118,4324,57,61,2601.81,4622.11,0.00
2024-12-10 17:37:41,119,4323,57,62,2570.31,4622.34,0.00
2024-12-10 17:37:42,118,4323,56,62,2596.61,4622.70,0.00
2024-12-10 17:37:42,118,4324,56,62,2661.10,4623.00,0.00
2024-12-10 17:37:42,119,4324,56,63,2638.73,4623.01,0.00
2024-12-10 17:37:42,118,4324,56,62,2633.32,4623.11,0.00
2024-12-10 17:37:42,117,4324,55,62,2648.39,4623.27,0.00
2024-12-10 17:37:42,117,4325,55,62,2694.30,4624.00,0.00
2024-12-10 17:37:42,118,4325,56,62,2671.47,4624.01,0.00
2024-12-10 17:37:42,119,4324,56,63,2644.79,4624.12,0.00
2024-12-10 17:37:42,119,4325,56,63,2662.68,4625.00,0.00
2024-12-10 17:37:42,120,4325,56,64,2640.49,4625.01,0.00
2024-12-10 17:37:42,119,4325,55,64,2660.75,4625.04,0.00
2024-12-10 17:37:42,120,4324,55,65,2625.90,4625.17,0.00
2024-12-10 17:37:42,119,4324,54,65,2672.90,4625.29,0.00
2024-12-10 17:37:42,119,4325,54,65,2712.65,4626.00,0.00
2024-12-10 17:37:42,120,4325,55,65,2690.05,4626.01,0.00
2024-12-10 17:37:42,119,4325,54,65,2693.13,4626.26,0.00
2024-12-10 17:37:42,119,4326,54,65,2726.91,4627.00,0.00
2024-12-10 17:37:42,120,4326,54,66,2704.19,4627.01,0.00
2024-12-10 17:37:42,121,4325,54,67,2648.07,4627.60,0.00
2024-12-10 17:37:42,122,4324,54,68,2637.40,4627.65,0.00
2024-12-10 17:37:42,122,4325,54,68,2655.88,4628.00,0.00
2024-12-10 17:37:42,123,4325,54,69,2634.29,4628.01,0.00
2024-12-10 17:37:42,122,4325,53,69,2653.63,4628.05,0.00
2024-12-10 17:37:42,121,4325,53,68,2670.99,4628.09,0.00
2024-12-10 17:37:42,122,4324,53,69,2649.10,4628.11,0.00
2024-12-10 17:37:42,123,4323,53,70,2645.01,4628.44,0.00
2024-12-10 17:37:42,123,4324,53,70,2734.59,4629.00,0.00
2024-12-10 17:37:42,124,4324,53,71,2712.54,4629.01,0.00
2024-12-10 17:37:42,123,4324,52,71,2695.36,4629.69,0.00
2024-12-10 17:37:42,123,4325,52,71,2794.22,4630.00,0.00
2024-12-10 17:37:42,124,4325,52,72,2771.69,4630.01,0.00
2024-12-10 17:37:42,124,4326,52,72,2751.73,4631.00,0.00
2024-12-10 17:37:42,125,4326,53,72,2729.72,4631.01,0.00
2024-12-10 17:37:42,124,4326,52,72,2734.63,4631.16,0.00
2024-12-10 17:37:42,125,4325,52,73,2687.11,4631.74,0.00
2024-12-10 17:37:42,125,4326,52,73,2719.21,4632.00,0.00
2024-12-10 17:37:42,126,4326,52,74,2697.62,4632.01,0.00
2024-12-10 17:37:42,126,4327,52,74,2705.77,4633.00,0.00
2024-12-10 17:37:42,127,4327,52,75,2684.47,4633.01,0.00
2024-12-10 17:37:42,126,4327,52,74,2696.25,4633.09,0.00
2024-12-10 17:37:42,125,4327,51,74,2707.16,4633.31,0.00
2024-12-10 17:37:42,125,4328,51,74,2697.98,4634.00,0.00
2024-12-10 17:37:42,126,4328,51,75,2676.57,4634.01,0.00
2024-12-10 17:37:42,125,4328,51,74,2690.24,4634.09,0.00
2024-12-10 17:37:42,125,4329,51,74,2670.75,4635.00,0.00
2024-12-10 17:37:42,126,4329,52,74,2649.56,4635.01,0.00
2024-12-10 17:37:42,125,4329,52,73,2663.38,4635.09,0.00
2024-12-10 17:37:42,124,4329,51,73,2660.26,4635.30,0.00
2024-12-10 17:37:42,125,4328,51,74,2633.84,4635.42,0.00
2024-12-10 17:37:42,125,4328,51,74,2659.83,4636.00,0.00
2024-12-10 17:37:42,126,4328,51,75,2638.72,4636.01,0.00
2024-12-10 17:37:42,125,4328,50,75,2645.74,4636.01,0.00
2024-12-10 17:37:42,126,4327,51,75,2622.19,4636.08,0.00
2024-12-10 17:37:42,125,4327,51,74,2660.00,4636.09,0.00
2024-12-10 17:37:42,126,4326,52,74,2631.95,4636.25,0.00
2024-12-10 17:37:42,126,4327,52,74,2696.09,4637.00,0.00
2024-12-10 17:37:42,127,4327,53,74,2674.87,4637.01,0.00
2024-12-10 17:37:42,126,4327,52,74,2693.54,4637.06,0.00
2024-12-10 17:37:42,125,4327,52,73,2710.65,4637.07,0.00
2024-12-10 17:37:42,124,4327,51,73,2728.03,4637.08,0.00
2024-12-10 17:37:42,125,4326,51,74,2671.39,4637.86,0.00
2024-12-10 17:37:42,125,4327,51,74,2809.53,4638.00,0.00
2024-12-10 17:37:42,126,4327,52,74,2787.23,4638.01,0.00
2024-12-10 17:37:42,127,4326,52,75,2721.57,4638.72,0.00
2024-12-10 17:37:42,127,4327,52,75,2789.02,4639.00,0.00
2024-12-10 17:37:42,128,4327,53,75,2767.23,4639.01,0.00
2024-12-10 17:37:42,129,4326,54,75,2730.39,4639.20,0.00
2024-12-10 17:37:42,129,4327,54,75,2783.60,4640.00,0.00
2024-12-10 17:37:42,130,4327,55,75,2762.19,4640.01,0.00
2024-12-10 17:37:42,131,4326,56,75,2712.27,4640.50,0.00
2024-12-10 17:37:42,131,4327,56,75,2751.38,4641.00,0.00
2024-12-10 17:37:42,132,4327,56,76,2730.53,4641.01,0.00
2024-12-10 17:37:42,131,4327,56,75,2743.26,4641.08,0.00
2024-12-10 17:37:42,131,4328,56,75,2757.64,4642.00,0.00
2024-12-10 17:37:42,132,4328,57,75,2736.75,4642.01,0.00
2024-12-10 17:37:42,131,4328,56,75,2756.93,4642.02,0.00
2024-12-10 17:37:42,130,4328,56,74,2758.89,4642.07,0.00
2024-12-10 17:37:42,130,4329,56,74,2751.95,4643.00,0.00
2024-12-10 17:37:42,131,4329,56,75,2730.94,4643.01,0.00
2024-12-10 17:37:42,130,4329,56,74,2746.27,4643.07,0.00
2024-12-10 17:37:42,129,4329,55,74,2757.56,4643.29,0.00
2024-12-10 17:37:42,128,4329,54,74,2754.23,4643.59,0.00
2024-12-10 17:37:42,128,4330,54,74,2771.97,4644.00,0.00
2024-12-10 17:37:42,129,4330,55,74,2750.48,4644.01,0.00
2024-12-10 17:37:42,129,4331,55,74,2724.50,4645.00,0.00
2024-12-10 17:37:42,130,4331,56,74,2703.54,4645.01,0.00
2024-12-10 17:37:42,130,4332,56,74,2672.38,4646.00,0.00
2024-12-10 17:37:42,131,4332,56,75,2651.98,4646.01,0.00
2024-12-10 17:37:42,130,4332,56,74,2666.33,4646.07,0.00
2024-12-10 17:37:42,131,4331,57,74,2630.15,4646.43,0.00
2024-12-10 17:37:42,131,4332,57,74,2643.68,4647.00,0.00
2024-12-10 17:37:42,132,4332,57,75,2623.65,4647.01,0.00
2024-12-10 17:37:42,131,4332,57,74,2638.04,4647.07,0.00
2024-12-10 17:37:42,131,4333,57,74,2652.05,4648.00,0.00
2024-12-10 17:37:42,132,4333,57,75,2631.96,4648.01,0.00
2024-12-10 17:37:42,131,4333,57,74,2645.35,4648.08,0.00
2024-12-10 17:37:42,130,4333,56,74,2655.06,4648.32,0.00
2024-12-10 17:37:42,131,4332,57,74,2628.82,4648.46,0.00
2024-12-10 17:37:43,131,4333,57,74,2660.43,4649.00,0.00
2024-12-10 17:37:43,132,4333,57,75,2640.28,4649.01,0.00
2024-12-10 17:37:43,131,4333,57,74,2651.95,4649.09,0.00
2024-12-10 17:37:43,130,4333,56,74,2667.22,4649.20,0.00
2024-12-10 17:37:43,129,4333,55,74,2682.89,4649.31,0.00
2024-12-10 17:37:43,128,4333,54,74,2703.49,4649.31,0.00
2024-12-10 17:37:43,128,4334,54,74,2730.10,4650.00,0.00
2024-12-10 17:37:43,129,4334,55,74,2708.94,4650.01,0.00
2024-12-10 17:37:43,128,4334,55,73,2721.06,4650.09,0.00
2024-12-10 17:37:43,129,4333,56,73,2696.40,4650.19,0.00
2024-12-10 17:37:43,130,4332,57,73,2678.71,4650.59,0.00
2024-12-10 17:37:43,130,4333,57,73,2699.77,4651.00,0.00
2024-12-10 17:37:43,131,4333,58,73,2679.16,4651.01,0.00
2024-12-10 17:37:43,130,4333,58,72,2691.74,4651.09,0.00
2024-12-10 17:37:43,129,4333,57,72,2701.89,4651.32,0.00
2024-12-10 17:37:43,130,4332,57,73,2678.27,4651.39,0.00
2024-12-10 17:37:43,130,4333,57,73,2762.42,4652.00,0.00
2024-12-10 17:37:43,131,4333,58,73,2741.33,4652.01,0.00
2024-12-10 17:37:43,131,4334,58,73,2754.76,4653.00,0.00
2024-12-10 17:37:43,132,4334,58,74,2733.89,4653.01,0.00
2024-12-10 17:37:43,133,4333,59,74,2701.13,4653.14,0.00
2024-12-10 17:37:43,132,4333,58,74,2697.56,4653.64,0.00
2024-12-10 17:37:43,132,4334,58,74,2716.53,4654.00,0.00
2024-12-10 17:37:43,133,4334,59,74,2696.10,4654.01,0.00
2024-12-10 17:37:43,133,4335,59,74,2699.48,4655.00,0.00
2024-12-10 17:37:43,134,4335,60,74,2679.34,4655.01,0.00
2024-12-10 17:37:43,133,4335,59,74,2696.01,4655.08,0.00
2024-12-10 17:37:43,132,4335,59,73,2713.27,4655.08,0.00
2024-12-10 17:37:43,132,4336,59,73,2692.30,4656.00,0.00
2024-12-10 17:37:43,133,4336,60,73,2672.06,4656.01,0.00
2024-12-10 17:37:43,132,4336,60,72,2684.92,4656.08,0.00
2024-12-10 17:37:43,132,4337,60,72,2663.95,4657.00,0.00
2024-12-10 17:37:43,133,4337,61,72,2643.92,4657.01,0.00
2024-12-10 17:37:43,134,4336,61,73,2605.86,4657.27,0.00
2024-12-10 17:37:43,133,4336,60,73,2625.78,4657.71,0.00
2024-12-10 17:37:43,133,4337,60,73,2647.38,4658.00,0.00
2024-12-10 17:37:43,134,4337,60,74,2627.62,4658.01,0.00
2024-12-10 17:37:43,134,4338,60,74,2638.75,4659.00,0.00
2024-12-10 17:37:43,135,4338,60,75,2619.21,4659.01,0.00
2024-12-10 17:37:43,135,4339,60,75,2590.35,4660.00,0.00
2024-12-10 17:37:43,136,4339,61,75,2571.30,4660.01,0.00
2024-12-10 17:37:43,135,4339,61,74,2586.92,4660.07,0.00
2024-12-10 17:37:43,134,4339,61,73,2599.27,4660.08,0.00
2024-12-10 17:37:43,133,4339,60,73,2605.61,4660.35,0.00
2024-12-10 17:37:43,134,4338,61,73,2575.50,4660.60,0.00
2024-12-10 17:37:43,134,4339,61,73,2590.07,4661.00,0.00
2024-12-10 17:37:43,135,4339,61,74,2570.88,4661.01,0.00
2024-12-10 17:37:43,135,4340,61,74,2584.41,4662.00,0.00
2024-12-10 17:37:43,136,4340,61,75,2565.40,4662.01,0.00
2024-12-10 17:37:43,136,4341,61,75,2542.86,4663.00,0.00
2024-12-10 17:37:43,137,4341,62,75,2524.30,4663.01,0.00
2024-12-10 17:37:43,138,4340,62,76,2505.00,4663.04,0.00
2024-12-10 17:37:43,138,4341,62,76,2507.13,4664.00,0.00
2024-12-10 17:37:43,139,4341,62,77,2489.09,4664.01,0.00
2024-12-10 17:37:43,138,4341,61,77,2483.93,4664.36,0.00
2024-12-10 17:37:43,137,4341,60,77,2501.72,4664.37,0.00
2024-12-10 17:37:43,137,4342,60,77,2528.11,4665.00,0.00
2024-12-10 17:37:43,138,4342,60,78,2509.79,4665.01,0.00
2024-12-10 17:37:43,137,4342,60,77,2521.67,4665.08,0.00
2024-12-10 17:37:43,138,4341,60,78,2485.62,4665.48,0.00
2024-12-10 17:37:43,138,4342,60,78,2497.82,4666.00,0.00
2024-12-10 17:37:43,139,4342,61,78,2479.85,4666.01,0.00
2024-12-10 17:37:43,139,4343,61,78,2487.49,4667.00,0.00
2024-12-10 17:37:43,140,4343,61,79,2469.73,4667.01,0.00
2024-12-10 17:37:43,139,4343,61,78,2484.16,4667.07,0.00
2024-12-10 17:37:43,140,4342,61,79,2426.75,4667.80,0.00
2024-12-10 17:37:43,141,4341,61,80,2408.02,4667.98,0.00
2024-12-10 17:37:43,141,4342,61,80,2429.02,4668.00,0.00
2024-12-10 17:37:43,142,4342,62,80,2411.92,4668.01,0.00
2024-12-10 17:37:43,141,4342,62,79,2422.43,4668.08,0.00
2024-12-10 17:37:43,140,4342,61,79,2426.81,4668.35,0.00
2024-12-10 17:37:43,141,4341,62,79,2400.11,4668.57,0.00
2024-12-10 17:37:43,141,4342,62,79,2479.54,4669.00,0.00
2024-12-10 17:37:43,142,4342,62,80,2462.08,4669.01,0.00
2024-12-10 17:37:43,141,4342,62,79,2475.27,4669.08,0.00
2024-12-10 17:37:43,140,4342,61,79,2477.70,4669.37,0.00
2024-12-10 17:37:43,140,4343,61,79,2515.47,4670.00,0.00
2024-12-10 17:37:43,141,4343,62,79,2497.63,4670.01,0.00
2024-12-10 17:37:43,140,4343,61,79,2514.47,4670.02,0.00
2024-12-10 17:37:43,139,4343,61,78,2524.19,4670.07,0.00
2024-12-10 17:37:43,138,4343,60,78,2530.37,4670.33,0.00
2024-12-10 17:37:43,137,4343,59,78,2510.92,4670.86,0.00
2024-12-10 17:37:43,137,4344,59,78,2538.65,4671.00,0.00
2024-12-10 17:37:43,138,4344,59,79,2520.26,4671.01,0.00
2024-12-10 17:37:43,137,4344,58,79,2537.30,4671.03,0.00
2024-12-10 17:37:43,138,4343,58,80,2518.58,4671.05,0.00
2024-12-10 17:37:43,137,4343,58,79,2549.60,4671.08,0.00
2024-12-10 17:37:43,137,4344,58,79,2527.60,4672.00,0.00
2024-12-10 17:37:43,138,4344,59,79,2509.29,4672.01,0.00
2024-12-10 17:37:43,137,4344,59,78,2523.20,4672.07,0.00
2024-12-10 17:37:43,136,4344,58,78,2530.79,4672.18,0.00
2024-12-10 17:37:43,137,4343,59,78,2478.14,4672.66,0.00
2024-12-10 17:37:43,137,4344,59,78,2541.49,4673.00,0.00
2024-12-10 17:37:43,138,4344,59,79,2523.07,4673.01,0.00
2024-12-10 17:37:43,139,4343,59,80,2501.59,4673.09,0.00
2024-12-10 17:37:43,138,4343,58,80,2519.76,4673.34,0.00
2024-12-10 17:37:43,138,4344,58,80,2557.10,4674.00,0.00
2024-12-10 17:37:43,139,4344,59,80,2538.71,4674.01,0.00
2024-12-10 17:37:43,138,4344,58,80,2540.23,4674.17,0.00
2024-12-10 17:37:44,138,4345,58,80,2569.85,4675.00,0.00
2024-12-10 17:37:44,139,4345,59,80,2551.36,4675.01,0.00
2024-12-10 17:37:44,139,4346,59,80,2527.34,4676.00,0.00
2024-12-10 17:37:44,140,4346,60,80,2509.29,4676.01,0.00
2024-12-10 17:37:44,139,4346,59,80,2524.01,4676.07,0.00
2024-12-10 17:37:44,139,4347,59,80,2498.76,4677.00,0.00
2024-12-10 17:37:44,140,4347,60,80,2480.92,4677.01,0.00
2024-12-10 17:37:44,140,4348,60,80,2448.37,4678.00,0.00
2024-12-10 17:37:44,141,4348,60,81,2431.00,4678.01,0.00
2024-12-10 17:37:44,140,4348,60,80,2445.05,4678.07,0.00
2024-12-10 17:37:44,140,4349,60,80,2422.15,4679.00,0.00
2024-12-10 17:37:44,141,4349,61,80,2404.97,4679.01,0.00
2024-12-10 17:37:44,140,4349,61,79,2418.17,4679.08,0.00
2024-12-10 17:37:44,139,4349,60,79,2408.72,4679.36,0.00
2024-12-10 17:37:44,138,4349,59,79,2415.84,4679.58,0.00
2024-12-10 17:37:44,138,4350,59,79,2430.37,4680.00,0.00
2024-12-10 17:37:44,139,4350,60,79,2412.89,4680.01,0.00
2024-12-10 17:37:44,138,4350,60,78,2425.31,4680.09,0.00
2024-12-10 17:37:44,137,4350,59,78,2426.32,4680.26,0.00
2024-12-10 17:37:44,137,4351,59,78,2426.08,4681.00,0.00
2024-12-10 17:37:44,138,4351,60,78,2408.50,4681.01,0.00
2024-12-10 17:37:44,137,4351,60,77,2422.35,4681.08,0.00
2024-12-10 17:37:44,136,4351,60,76,2438.79,4681.09,0.00
2024-12-10 17:37:44,136,4352,60,76,2417.25,4682.00,0.00
2024-12-10 17:37:44,137,4352,61,76,2399.60,4682.01,0.00
2024-12-10 17:37:44,136,4352,61,75,2412.80,4682.09,0.00
2024-12-10 17:37:44,135,4352,60,75,2414.65,4682.28,0.00
2024-12-10 17:37:44,136,4351,60,76,2380.54,4682.65,0.00
2024-12-10 17:37:44,136,4352,60,76,2389.75,4683.00,0.00
2024-12-10 17:37:44,137,4352,61,76,2372.30,4683.01,0.00
2024-12-10 17:37:44,138,4351,62,76,2352.76,4683.07,0.00
2024-12-10 17:37:44,137,4351,62,75,2398.66,4683.10,0.00
2024-12-10 17:37:44,136,4351,61,75,2410.46,4683.15,0.00
2024-12-10 17:37:44,137,4350,62,75,2391.50,4683.19,0.00
2024-12-10 17:37:44,137,4351,62,75,2451.79,4684.00,0.00
2024-12-10 17:37:44,138,4351,63,75,2434.02,4684.01,0.00
2024-12-10 17:37:44,138,4352,63,75,2476.31,4685.00,0.00
2024-12-10 17:37:44,139,4352,63,76,2458.49,4685.01,0.00
2024-12-10 17:37:44,138,4352,62,76,2474.29,4685.04,0.00
2024-12-10 17:37:44,137,4352,62,75,2483.13,4685.09,0.00
2024-12-10 17:37:44,136,4352,61,75,2501.05,4685.09,0.00
2024-12-10 17:37:44,136,4353,61,75,2467.33,4686.00,0.00
2024-12-10 17:37:44,137,4353,62,75,2449.32,4686.01,0.00
2024-12-10 17:37:44,138,4352,62,76,2430.89,4686.04,0.00
2024-12-10 17:37:44,137,4352,62,75,2450.38,4686.09,0.00
2024-12-10 17:37:44,137,4353,62,75,2415.17,4687.00,0.00
2024-12-10 17:37:44,138,4353,63,75,2397.67,4687.01,0.00
2024-12-10 17:37:44,137,4353,62,75,2403.92,4687.10,0.00
2024-12-10 17:37:44,136,4353,61,75,2390.30,4687.74,0.00
2024-12-10 17:37:44,135,4353,60,75,2400.65,4687.86,0.00
2024-12-10 17:37:44,135,4354,60,75,2459.51,4688.00,0.00
2024-12-10 17:37:44,136,4354,61,75,2441.43,4688.01,0.00
2024-12-10 17:37:44,136,4355,61,75,2413.20,4689.00,0.00
2024-12-10 17:37:44,137,4355,62,75,2395.58,4689.01,0.00
2024-12-10 17:37:44,136,4355,61,75,2410.12,4689.07,0.00
2024-12-10 17:37:44,136,4356,61,75,2378.65,4690.00,0.00
2024-12-10 17:37:44,137,4356,61,76,2361.28,4690.01,0.00
2024-12-10 17:37:44,136,4356,61,75,2372.82,4690.07,0.00
2024-12-10 17:37:44,135,4356,61,74,2390.05,4690.07,0.00
2024-12-10 17:37:44,135,4357,61,74,2363.64,4691.00,0.00
2024-12-10 17:37:44,136,4357,61,75,2346.26,4691.01,0.00
2024-12-10 17:37:44,135,4357,60,75,2311.17,4691.76,0.00
2024-12-10 17:37:44,135,4358,60,75,2334.64,4692.00,0.00
2024-12-10 17:37:44,136,4358,61,75,2317.47,4692.01,0.00
2024-12-10 17:37:44,135,4358,60,75,2324.24,4692.07,0.00
2024-12-10 17:37:44,136,4357,60,76,2267.45,4692.83,0.00
2024-12-10 17:37:44,136,4358,60,76,2297.79,4693.00,0.00
2024-12-10 17:37:44,137,4358,60,77,2281.02,4693.01,0.00
2024-12-10 17:37:44,136,4358,60,76,2287.12,4693.08,0.00
2024-12-10 17:37:44,135,4358,60,75,2303.72,4693.08,0.00
2024-12-10 17:37:44,134,4358,60,74,2288.92,4693.70,0.00
2024-12-10 17:37:44,134,4359,60,74,2341.55,4694.00,0.00
2024-12-10 17:37:44,135,4359,61,74,2324.20,4694.01,0.00
2024-12-10 17:37:44,136,4358,62,74,2263.61,4694.81,0.00
2024-12-10 17:37:44,136,4359,62,74,2283.54,4695.00,0.00
2024-12-10 17:37:44,137,4359,63,74,2266.87,4695.01,0.00
2024-12-10 17:37:44,137,4360,63,74,2271.50,4696.00,0.00
2024-12-10 17:37:44,138,4360,63,75,2255.04,4696.01,0.00
2024-12-10 17:37:44,137,4360,63,74,2267.04,4696.02,0.00
2024-12-10 17:37:44,138,4359,64,74,2239.80,4696.27,0.00
2024-12-10 17:37:44,137,4359,63,74,2273.69,4696.42,0.00
2024-12-10 17:37:44,136,4359,62,74,2271.97,4696.82,0.00
2024-12-10 17:37:44,136,4360,62,74,2284.20,4697.00,0.00
2024-12-10 17:37:44,137,4360,62,75,2267.53,4697.01,0.00
2024-12-10 17:37:44,137,4361,62,75,2271.72,4698.00,0.00
2024-12-10 17:37:44,138,4361,62,76,2255.25,4698.01,0.00
2024-12-10 17:37:44,137,4361,62,75,2265.91,4698.07,0.00
2024-12-10 17:37:44,136,4361,62,74,2281.20,4698.09,0.00
2024-12-10 17:37:44,135,4361,61,74,2281.21,4698.40,0.00
2024-12-10 17:37:44,136,4360,62,74,2244.63,4698.84,0.00
2024-12-10 17:37:44,136,4361,62,74,2276.89,4699.00,0.00
2024-12-10 17:37:44,137,4361,63,74,2260.27,4699.01,0.00
2024-12-10 17:37:44,137,4362,63,74,2266.13,4700.00,0.00
2024-12-10 17:37:44,138,4362,63,75,2249.71,4700.01,0.00
2024-12-10 17:37:44,137,4362,62,75,2265.79,4700.01,0.00
2024-12-10 17:37:44,136,4362,62,74,2272.80,4700.06,0.00
2024-12-10 17:37:44,135,4362,62,73,2288.25,4700.08,0.00
2024-12-10 17:37:44,134,4362,61,73,2286.42,4700.43,0.00
2024-12-10 17:37:45,134,4363,61,73,2281.30,4701.00,0.00
2024-12-10 17:37:45,135,4363,61,74,2264.40,4701.01,0.00
2024-12-10 17:37:45,134,4363,61,73,2270.45,4701.08,0.00
2024-12-10 17:37:45,133,4363,60,73,2269.40,4701.41,0.00
2024-12-10 17:37:45,133,4364,60,73,2274.37,4702.00,0.00
2024-12-10 17:37:45,134,4364,60,74,2257.40,4702.01,0.00
2024-12-10 17:37:45,133,4364,60,73,2263.44,4702.08,0.00
2024-12-10 17:37:45,133,4365,60,73,2248.62,4703.00,0.00
2024-12-10 17:37:45,134,4365,60,74,2231.83,4703.01,0.00
2024-12-10 17:37:45,135,4364,61,74,2193.57,4703.28,0.00
2024-12-10 17:37:45,135,4365,61,74,2198.28,4704.00,0.00
2024-12-10 17:37:45,136,4365,62,74,2182.12,4704.01,0.00
2024-12-10 17:37:45,135,4365,62,73,2188.89,4704.06,0.00
2024-12-10 17:37:45,134,4365,61,73,2165.42,4704.72,0.00
2024-12-10 17:37:45,134,4366,61,73,2222.85,4705.00,0.00
2024-12-10 17:37:45,135,4366,61,74,2206.38,4705.01,0.00
2024-12-10 17:37:45,134,4366,60,74,2194.44,4705.42,0.00
2024-12-10 17:37:45,135,4365,61,74,2158.47,4705.70,0.00
2024-12-10 17:37:45,136,4364,61,75,2141.08,4705.99,0.00
2024-12-10 17:37:45,136,4365,61,75,2175.35,4706.00,0.00
2024-12-10 17:37:45,137,4365,62,75,2159.47,4706.01,0.00
2024-12-10 17:37:45,136,4365,61,75,2147.92,4706.41,0.00
2024-12-10 17:37:45,137,4364,62,75,2126.45,4706.55,0.00
2024-12-10 17:37:45,138,4363,63,75,2108.31,4706.73,0.00
2024-12-10 17:37:45,138,4364,63,75,2207.09,4707.00,0.00
2024-12-10 17:37:45,139,4364,63,76,2191.21,4707.01,0.00
2024-12-10 17:37:45,138,4364,63,75,2203.01,4707.06,0.00
2024-12-10 17:37:45,137,4364,63,74,2218.40,4707.07,0.00
2024-12-10 17:37:45,136,4364,62,74,2203.42,4707.64,0.00
2024-12-10 17:37:45,137,4363,63,74,2186.66,4707.66,0.00
2024-12-10 17:37:45,137,4364,63,74,2274.54,4708.00,0.00
2024-12-10 17:37:45,138,4364,64,74,2258.06,4708.01,0.00
2024-12-10 17:37:45,137,4364,64,73,2270.78,4708.07,0.00
2024-12-10 17:37:45,136,4364,63,73,2264.31,4708.33,0.00
2024-12-10 17:37:45,136,4365,63,73,2302.46,4709.00,0.00
2024-12-10 17:37:45,137,4365,63,74,2285.65,4709.01,0.00
2024-12-10 17:37:45,136,4365,62,74,2290.05,4709.12,0.00
2024-12-10 17:37:45,135,4365,61,74,2300.74,4709.16,0.00
2024-12-10 17:37:45,134,4365,60,74,2290.44,4709.74,0.00
2024-12-10 17:37:45,134,4366,60,74,2313.49,4710.00,0.00
2024-12-10 17:37:45,135,4366,60,75,2296.35,4710.01,0.00
2024-12-10 17:37:45,134,4366,59,75,2310.81,4710.06,0.00
2024-12-10 17:37:45,133,4366,59,74,2327.12,4710.07,0.00
2024-12-10 17:37:45,132,4366,58,74,2334.38,4710.29,0.00
2024-12-10 17:37:45,131,4366,57,74,2331.75,4710.41,0.00
2024-12-10 17:37:45,130,4366,56,74,2347.55,4710.45,0.00
2024-12-10 17:37:45,130,4367,56,74,2358.44,4711.00,0.00
2024-12-10 17:37:45,131,4367,56,75,2340.43,4711.01,0.00
2024-12-10 17:37:45,130,4367,55,75,2355.61,4711.06,0.00
2024-12-10 17:37:45,129,4367,55,74,2372.05,4711.07,0.00
2024-12-10 17:37:45,128,4367,54,74,2375.51,4711.18,0.00
2024-12-10 17:37:45,129,4366,55,74,2334.29,4711.68,0.00
2024-12-10 17:37:45,130,4365,56,74,2314.62,4711.82,0.00
2024-12-10 17:37:45,130,4366,56,74,2348.12,4712.00,0.00
2024-12-10 17:37:45,131,4366,57,74,2330.20,4712.01,0.00
2024-12-10 17:37:45,130,4366,57,73,2343.43,4712.07,0.00
2024-12-10 17:37:45,129,4366,56,73,2358.31,4712.09,0.00
2024-12-10 17:37:45,129,4367,56,73,2425.28,4713.00,0.00
2024-12-10 17:37:45,130,4367,56,74,2406.63,4713.01,0.00
2024-12-10 17:37:45,129,4367,55,74,2423.82,4713.01,0.00
2024-12-10 17:37:45,128,4367,55,73,2440.20,4713.06,0.00
2024-12-10 17:37:45,127,4367,55,72,2457.93,4713.06,0.00
2024-12-10 17:37:45,126,4367,54,72,2461.81,4713.39,0.00
2024-12-10 17:37:45,126,4368,54,72,2470.84,4714.00,0.00
2024-12-10 17:37:45,127,4368,55,72,2451.38,4714.01,0.00
2024-12-10 17:37:45,128,4367,55,73,2376.72,4714.82,0.00
2024-12-10 17:37:45,128,4368,55,73,2410.77,4715.00,0.00
2024-12-10 17:37:45,129,4368,56,73,2392.08,4715.01,0.00
2024-12-10 17:37:45,128,4368,56,72,2402.68,4715.06,0.00
2024-12-10 17:37:45,127,4368,55,72,2406.09,4715.39,0.00
2024-12-10 17:37:45,127,4369,55,72,2436.95,4716.00,0.00
2024-12-10 17:37:45,128,4369,55,73,2417.92,4716.01,0.00
2024-12-10 17:37:45,127,4369,55,72,2432.51,4716.06,0.00
2024-12-10 17:37:45,126,4369,54,72,2436.18,4716.39,0.00
2024-12-10 17:37:45,125,4369,53,72,2428.27,4716.68,0.00
2024-12-10 17:37:45,125,4370,53,72,2451.17,4717.00,0.00
2024-12-10 17:37:45,126,4370,54,72,2431.71,4717.01,0.00
2024-12-10 17:37:45,125,4370,54,71,2447.03,4717.06,0.00
2024-12-10 17:37:45,125,4371,54,71,2426.02,4718.00,0.00
2024-12-10 17:37:45,126,4371,54,72,2406.77,4718.01,0.00
2024-12-10 17:37:45,125,4371,54,71,2421.88,4718.06,0.00
2024-12-10 17:37:45,124,4371,53,71,2439.51,4718.06,0.00
2024-12-10 17:37:45,125,4370,54,71,2402.36,4718.46,0.00
2024-12-10 17:37:45,125,4371,54,71,2434.65,4719.00,0.00
2024-12-10 17:37:45,126,4371,54,72,2415.33,4719.01,0.00
2024-12-10 17:37:45,125,4371,53,72,2433.52,4719.02,0.00
2024-12-10 17:37:45,124,4371,53,71,2451.63,4719.05,0.00
2024-12-10 17:37:45,124,4372,53,71,2471.63,4720.00,0.00
2024-12-10 17:37:45,125,4372,54,71,2451.86,4720.01,0.00
2024-12-10 17:37:45,126,4371,55,71,2393.70,4720.69,0.00
2024-12-10 17:37:45,126,4372,55,71,2420.11,4721.00,0.00
2024-12-10 17:37:45,127,4372,55,72,2401.05,4721.01,0.00
2024-12-10 17:37:45,127,4373,55,72,2410.68,4722.00,0.00
2024-12-10 17:37:45,128,4373,56,72,2391.85,4722.01,0.00
2024-12-10 17:37:45,127,4373,56,71,2403.25,4722.05,0.00
2024-12-10 17:37:45,127,4374,56,71,2381.07,4723.00,0.00
2024-12-10 17:37:45,128,4374,57,71,2362.47,4723.01,0.00
2024-12-10 17:37:45,127,4374,57,70,2378.85,4723.05,0.00
2024-12-10 17:37:45,126,4374,56,70,2379.39,4723.25,0.00
2024-12-10 17:37:45,125,4374,55,70,2378.94,4723.66,0.00
2024-12-10 17:37:45,125,4375,55,70,2401.12,4724.00,0.00
2024-12-10 17:37:45,126,4375,56,70,2382.07,4724.01,0.00
2024-12-10 17:37:45,126,4376,56,70,2354.98,4725.00,0.00
2024-12-10 17:37:45,127,4376,56,71,2336.43,4725.01,0.00
2024-12-10 17:37:45,126,4376,55,71,2351.24,4725.03,0.00
2024-12-10 17:37:45,125,4376,55,70,2363.62,4725.04,0.00
2024-12-10 17:37:45,124,4376,55,69,2382.30,4725.04,0.00
2024-12-10 17:37:45,123,4376,55,68,2401.29,4725.04,0.00
2024-12-10 17:37:45,122,4376,54,68,2394.54,4725.60,0.00
2024-12-10 17:37:46,122,4377,54,68,2414.61,4726.00,0.00
2024-12-10 17:37:46,123,4377,55,68,2394.98,4726.01,0.00
2024-12-10 17:37:46,122,4377,55,67,2412.29,4726.04,0.00
2024-12-10 17:37:46,121,4377,54,67,2424.97,4726.19,0.00
2024-12-10 17:37:46,121,4378,54,67,2410.61,4727.00,0.00
2024-12-10 17:37:46,122,4378,54,68,2390.85,4727.01,0.00
2024-12-10 17:37:46,121,4378,54,67,2408.67,4727.04,0.00
2024-12-10 17:37:46,120,4378,53,67,2402.79,4727.31,0.00
2024-12-10 17:37:46,120,4379,53,67,2409.94,4728.00,0.00
2024-12-10 17:37:46,121,4379,53,68,2390.02,4728.01,0.00
2024-12-10 17:37:46,120,4379,52,68,2408.37,4728.03,0.00
2024-12-10 17:37:46,119,4379,52,67,2419.87,4728.04,0.00
2024-12-10 17:37:46,118,4379,52,66,2439.98,4728.04,0.00
2024-12-10 17:37:46,117,4379,52,65,2460.43,4728.04,0.00
2024-12-10 17:37:46,117,4380,52,65,2451.66,4729.00,0.00
2024-12-10 17:37:46,118,4380,53,65,2430.88,4729.01,0.00
2024-12-10 17:37:46,117,4380,53,64,2441.57,4729.04,0.00
2024-12-10 17:37:46,118,4379,54,64,2370.12,4729.99,0.00
2024-12-10 17:37:46,118,4380,54,64,2410.21,4730.00,0.00
2024-12-10 17:37:46,119,4380,55,64,2389.96,4730.01,0.00
2024-12-10 17:37:46,118,4380,55,63,2400.20,4730.04,0.00
2024-12-10 17:37:46,117,4380,54,63,2413.79,4730.19,0.00
2024-12-10 17:37:46,117,4381,54,63,2444.21,4731.00,0.00
2024-12-10 17:37:46,118,4381,54,64,2423.49,4731.01,0.00
2024-12-10 17:37:46,117,4381,54,63,2437.74,4731.03,0.00
2024-12-10 17:37:46,116,4381,54,62,2458.35,4731.04,0.00
2024-12-10 17:37:46,116,4382,54,62,2437.65,4732.00,0.00
2024-12-10 17:37:46,117,4382,54,63,2416.82,4732.01,0.00
2024-12-10 17:37:46,116,4382,54,62,2436.03,4732.04,0.00
2024-12-10 17:37:46,117,4381,55,62,2399.92,4732.38,0.00
2024-12-10 17:37:46,117,4382,55,62,2410.05,4733.00,0.00
2024-12-10 17:37:46,118,4382,55,63,2389.62,4733.01,0.00
2024-12-10 17:37:46,117,4382,55,62,2408.44,4733.03,0.00
2024-12-10 17:37:46,116,4382,54,62,2408.49,4733.41,0.00
2024-12-10 17:37:46,116,4383,54,62,2462.35,4734.00,0.00
2024-12-10 17:37:46,117,4383,54,63,2441.31,4734.01,0.00
2024-12-10 17:37:46,116,4383,54,62,2460.73,4734.04,0.00
2024-12-10 17:37:46,115,4383,54,61,2481.30,4734.04,0.00
2024-12-10 17:37:46,115,4384,54,61,2460.82,4735.00,0.00
2024-12-10 17:37:46,116,4384,54,62,2439.60,4735.01,0.00
2024-12-10 17:37:46,115,4384,54,61,2458.77,4735.04,0.00
2024-12-10 17:37:46,114,4384,53,61,2463.72,4735.05,0.00
2024-12-10 17:37:46,115,4383,54,61,2439.43,4735.13,0.00
2024-12-10 17:37:46,115,4384,54,61,2474.93,4736.00,0.00
2024-12-10 17:37:46,116,4384,54,62,2453.59,4736.01,0.00
2024-12-10 17:37:46,115,4384,53,62,2474.52,4736.01,0.00
2024-12-10 17:37:46,114,4384,53,61,2494.57,4736.03,0.00
2024-12-10 17:37:46,113,4384,52,61,2511.21,4736.14,0.00
2024-12-10 17:37:46,113,4385,52,61,2538.12,4737.00,0.00
2024-12-10 17:37:46,114,4385,52,62,2515.85,4737.01,0.00
2024-12-10 17:37:46,113,4385,52,61,2536.45,4737.03,0.00
2024-12-10 17:37:46,113,4386,52,61,2516.01,4738.00,0.00
2024-12-10 17:37:46,114,4386,52,62,2493.94,4738.01,0.00
2024-12-10 17:37:46,113,4386,52,61,2510.15,4738.05,0.00
2024-12-10 17:37:46,112,4386,51,61,2520.38,4738.31,0.00
2024-12-10 17:37:46,111,4386,50,61,2517.62,4738.60,0.00
2024-12-10 17:37:46,111,4387,50,61,2541.82,4739.00,0.00
2024-12-10 17:37:46,112,4387,50,62,2519.13,4739.01,0.00
2024-12-10 17:37:46,111,4387,49,62,2540.55,4739.03,0.00
2024-12-10 17:37:46,111,4388,49,62,2517.86,4740.00,0.00
2024-12-10 17:37:46,112,4388,49,63,2495.38,4740.01,0.00
2024-12-10 17:37:46,111,4388,48,63,2498.79,4740.23,0.00
2024-12-10 17:37:46,110,4388,47,63,2511.80,4740.31,0.00
2024-12-10 17:37:46,111,4387,47,64,2481.97,4740.48,0.00
2024-12-10 17:37:46,111,4388,47,64,2518.65,4741.00,0.00
2024-12-10 17:37:46,112,4388,47,65,2496.16,4741.01,0.00
2024-12-10 17:37:46,111,4388,47,64,2517.37,4741.03,0.00
2024-12-10 17:37:46,110,4388,47,63,2535.95,4741.05,0.00
2024-12-10 17:37:46,111,4387,48,63,2506.52,4741.19,0.00
2024-12-10 17:37:46,110,4387,47,63,2515.49,4741.50,0.00
2024-12-10 17:37:46,110,4388,47,63,2578.35,4742.00,0.00
2024-12-10 17:37:46,111,4388,48,63,2555.12,4742.01,0.00
2024-12-10 17:37:46,110,4388,48,62,2576.63,4742.04,0.00
2024-12-10 17:37:46,110,4389,48,62,2604.27,4743.00,0.00
2024-12-10 17:37:46,111,4389,48,63,2580.80,4743.01,0.00
2024-12-10 17:37:46,110,4389,48,62,2602.98,4743.03,0.00
2024-12-10 17:37:46,111,4388,48,63,2527.48,4743.94,0.00
2024-12-10 17:37:46,111,4389,48,63,2564.20,4744.00,0.00
2024-12-10 17:37:46,112,4389,49,63,2541.31,4744.01,0.00
2024-12-10 17:37:46,112,4390,49,63,2559.93,4745.00,0.00
2024-12-10 17:37:46,113,4390,50,63,2537.27,4745.01,0.00
2024-12-10 17:37:46,112,4390,50,62,2542.00,4745.14,0.00
2024-12-10 17:37:46,111,4390,49,62,2556.18,4745.32,0.00
2024-12-10 17:37:46,111,4391,49,62,2552.19,4746.00,0.00
2024-12-10 17:37:46,112,4391,49,63,2529.40,4746.01,0.00
2024-12-10 17:37:46,111,4391,49,62,2546.64,4746.04,0.00
2024-12-10 17:37:46,111,4392,49,62,2527.07,4747.00,0.00
2024-12-10 17:37:46,112,4392,49,63,2504.51,4747.01,0.00
2024-12-10 17:37:46,111,4392,49,62,2522.80,4747.05,0.00
2024-12-10 17:37:46,112,4391,50,62,2488.48,4747.32,0.00
2024-12-10 17:37:46,112,4392,50,62,2507.58,4748.00,0.00
2024-12-10 17:37:46,113,4392,50,63,2485.39,4748.01,0.00
2024-12-10 17:37:46,112,4392,49,63,2506.31,4748.03,0.00
2024-12-10 17:37:46,111,4392,49,62,2525.47,4748.05,0.00
2024-12-10 17:37:46,110,4392,48,62,2540.51,4748.21,0.00
2024-12-10 17:37:46,109,4392,47,62,2561.03,4748.27,0.00
2024-12-10 17:37:46,108,4392,46,62,2575.74,4748.29,0.00
2024-12-10 17:37:46,108,4393,46,62,2630.28,4749.00,0.00
2024-12-10 17:37:46,109,4393,47,62,2606.15,4749.01,0.00
2024-12-10 17:37:46,110,4392,47,63,2539.09,4749.60,0.00
2024-12-10 17:37:46,110,4393,47,63,2595.53,4750.00,0.00
2024-12-10 17:37:46,111,4393,47,64,2572.15,4750.01,0.00
2024-12-10 17:37:46,110,4393,46,64,2594.24,4750.03,0.00
2024-12-10 17:37:46,110,4394,46,64,2612.51,4751.00,0.00
2024-12-10 17:37:46,111,4394,46,65,2588.98,4751.01,0.00
2024-12-10 17:37:46,110,4394,45,65,2611.22,4751.03,0.00
2024-12-10 17:37:46,109,4394,45,64,2628.20,4751.03,0.00
2024-12-10 17:37:46,108,4394,44,64,2623.55,4751.64,0.00
2024-12-10 17:37:46,109,4393,45,64,2594.75,4751.75,0.00
2024-12-10 17:37:46,109,4394,45,64,2635.50,4752.00,0.00
2024-12-10 17:37:46,110,4394,45,65,2611.54,4752.01,0.00
2024-12-10 17:37:46,109,4394,45,64,2631.58,4752.03,0.00
2024-12-10 17:37:46,108,4394,44,64,2644.15,4752.27,0.00
2024-12-10 17:37:47,108,4395,44,64,2680.27,4753.00,0.00
2024-12-10 17:37:47,109,4395,44,65,2655.68,4753.01,0.00
2024-12-10 17:37:47,108,4395,44,64,2676.31,4753.03,0.00
2024-12-10 17:37:47,109,4394,44,65,2634.03,4753.42,0.00
2024-12-10 17:37:47,109,4395,44,65,2653.62,4754.00,0.00
2024-12-10 17:37:47,110,4395,45,65,2629.50,4754.01,0.00
2024-12-10 17:37:47,109,4395,45,64,2647.52,4754.05,0.00
2024-12-10 17:37:47,109,4396,45,64,2672.50,4755.00,0.00
2024-12-10 17:37:47,110,4396,46,64,2648.20,4755.01,0.00
2024-12-10 17:37:47,110,4397,46,64,2632.14,4756.00,0.00
2024-12-10 17:37:47,111,4397,46,65,2608.42,4756.01,0.00
2024-12-10 17:37:47,111,4398,46,65,2589.80,4757.00,0.00
2024-12-10 17:37:47,112,4398,46,66,2566.68,4757.01,0.00
2024-12-10 17:37:47,113,4397,47,66,2525.91,4757.23,0.00
2024-12-10 17:37:47,114,4396,48,66,2486.57,4757.68,0.00
2024-12-10 17:37:47,115,4395,48,67,2484.53,4757.87,0.00
2024-12-10 17:37:47,115,4396,48,67,2529.98,4758.00,0.00
2024-12-10 17:37:47,116,4396,49,67,2508.17,4758.01,0.00
2024-12-10 17:37:47,117,4395,50,67,2447.99,4758.67,0.00
2024-12-10 17:37:47,117,4396,50,67,2581.52,4759.00,0.00
2024-12-10 17:37:47,118,4396,51,67,2559.64,4759.01,0.00
2024-12-10 17:37:47,117,4396,51,66,2578.27,4759.05,0.00
2024-12-10 17:37:47,118,4395,51,67,2543.21,4759.35,0.00
2024-12-10 17:37:47,118,4396,51,67,2610.40,4760.00,0.00
2024-12-10 17:37:47,119,4396,52,67,2588.47,4760.01,0.00
2024-12-10 17:37:47,118,4396,51,67,2609.20,4760.03,0.00
2024-12-10 17:37:47,117,4396,51,66,2627.43,4760.04,0.00
2024-12-10 17:37:47,116,4396,50,66,2649.24,4760.06,0.00
2024-12-10 17:37:47,116,4397,50,66,2669.91,4761.00,0.00
2024-12-10 17:37:47,117,4397,51,66,2647.09,4761.01,0.00
2024-12-10 17:37:47,116,4397,51,65,2668.68,4761.03,0.00
2024-12-10 17:37:47,115,4397,51,64,2685.26,4761.07,0.00
2024-12-10 17:37:47,114,4397,50,64,2671.38,4761.75,0.00
2024-12-10 17:37:47,114,4398,50,64,2701.66,4762.00,0.00
2024-12-10 17:37:47,115,4398,50,65,2678.16,4762.01,0.00
2024-12-10 17:37:47,115,4399,50,65,2656.28,4763.00,0.00
2024-12-10 17:37:47,116,4399,51,65,2633.38,4763.01,0.00
2024-12-10 17:37:47,116,4400,51,65,2605.56,4764.00,0.00
2024-12-10 17:37:47,117,4400,51,66,2583.29,4764.01,0.00
2024-12-10 17:37:47,118,4399,51,67,2514.23,4764.73,0.00
2024-12-10 17:37:47,118,4400,51,67,2535.85,4765.00,0.00
2024-12-10 17:37:47,119,4400,51,68,2514.54,4765.01,0.00
2024-12-10 17:37:47,118,4400,51,67,2529.40,4765.08,0.00
2024-12-10 17:37:47,117,4400,51,66,2531.66,4765.42,0.00
2024-12-10 17:37:47,117,4401,51,66,2569.53,4766.00,0.00
2024-12-10 17:37:47,118,4401,51,67,2547.76,4766.01,0.00
2024-12-10 17:37:47,117,4401,51,66,2563.02,4766.08,0.00
2024-12-10 17:37:47,116,4401,50,66,2573.70,4766.31,0.00
2024-12-10 17:37:47,115,4401,49,66,2595.26,4766.32,0.00
2024-12-10 17:37:47,114,4401,48,66,2593.45,4766.55,0.00
2024-12-10 17:37:47,114,4402,48,66,2614.18,4767.00,0.00
2024-12-10 17:37:47,115,4402,49,66,2591.45,4767.01,0.00
2024-12-10 17:37:47,114,4402,49,65,2612.93,4767.03,0.00
2024-12-10 17:37:47,113,4402,49,64,2635.63,4767.03,0.00
2024-12-10 17:37:47,112,4402,49,63,2658.74,4767.03,0.00
2024-12-10 17:37:47,113,4401,49,64,2622.57,4767.13,0.00
2024-12-10 17:37:47,112,4401,48,64,2636.21,4767.17,0.00
2024-12-10 17:37:47,113,4400,49,64,2610.79,4767.23,0.00
2024-12-10 17:37:47,113,4401,49,64,2638.32,4768.00,0.00
2024-12-10 17:37:47,114,4401,49,65,2615.18,4768.01,0.00
2024-12-10 17:37:47,113,4401,49,64,2628.20,4768.05,0.00
2024-12-10 17:37:47,113,4402,49,64,2692.79,4769.00,0.00
2024-12-10 17:37:47,114,4402,50,64,2669.17,4769.01,0.00
2024-12-10 17:37:47,113,4402,50,63,2691.53,4769.03,0.00
2024-12-10 17:37:47,112,4402,49,63,2707.05,4769.07,0.00
2024-12-10 17:37:47,111,4402,49,62,2723.71,4769.08,0.00
2024-12-10 17:37:47,112,4401,50,62,2680.40,4769.50,0.00
2024-12-10 17:37:47,113,4400,50,63,2661.50,4769.77,0.00
2024-12-10 17:37:47,113,4401,50,63,2699.54,4770.00,0.00
2024-12-10 17:37:47,114,4401,50,64,2675.86,4770.01,0.00
2024-12-10 17:37:47,113,4401,50,63,2691.53,4770.06,0.00
2024-12-10 17:37:47,114,4400,51,63,2632.61,4770.82,0.00
2024-12-10 17:37:47,114,4401,51,63,2737.80,4771.00,0.00
2024-12-10 17:37:47,115,4401,51,64,2714.00,4771.01,0.00
2024-12-10 17:37:47,114,4401,50,64,2737.39,4771.01,0.00
2024-12-10 17:37:47,113,4401,50,63,2760.77,4771.02,0.00
2024-12-10 17:37:47,112,4401,49,63,2740.94,4771.77,0.00
2024-12-10 17:37:47,112,4402,49,63,2811.41,4772.00,0.00
2024-12-10 17:37:47,113,4402,50,63,2786.53,4772.01,0.00
2024-12-10 17:37:47,112,4402,49,63,2788.51,4772.30,0.00
2024-12-10 17:37:47,113,4401,49,64,2739.09,4772.84,0.00
2024-12-10 17:37:47,113,4402,49,64,2773.67,4773.00,0.00
2024-12-10 17:37:47,114,4402,49,65,2749.34,4773.01,0.00
2024-12-10 17:37:47,114,4403,49,65,2768.71,4774.00,0.00
2024-12-10 17:37:47,115,4403,49,66,2744.64,4774.01,0.00
2024-12-10 17:37:47,116,4402,50,66,2691.66,4774.47,0.00
2024-12-10 17:37:47,117,4401,50,67,2666.33,4774.66,0.00
2024-12-10 17:37:47,117,4402,50,67,2703.15,4775.00,0.00
2024-12-10 17:37:47,118,4402,51,67,2680.24,4775.01,0.00
2024-12-10 17:37:47,117,4402,51,66,2695.81,4775.05,0.00
2024-12-10 17:37:47,116,4402,50,66,2669.35,4775.94,0.00
2024-12-10 17:37:47,116,4403,50,66,2790.02,4776.00,0.00
2024-12-10 17:37:47,117,4403,50,67,2766.18,4776.01,0.00
2024-12-10 17:37:47,116,4403,50,66,2781.79,4776.05,0.00
2024-12-10 17:37:47,115,4403,49,66,2784.86,4776.22,0.00
2024-12-10 17:37:47,116,4402,50,66,2733.44,4776.79,0.00
2024-12-10 17:37:47,117,4401,50,67,2713.01,4776.87,0.00
2024-12-10 17:37:47,118,4400,50,68,2725.24,4776.89,0.00
2024-12-10 17:37:47,118,4401,50,68,2763.81,4777.00,0.00
2024-12-10 17:37:47,119,4401,50,69,2740.58,4777.01,0.00
2024-12-10 17:37:47,118,4401,50,68,2754.91,4777.06,0.00
2024-12-10 17:37:47,119,4400,51,68,2683.59,4777.70,0.00
2024-12-10 17:37:47,119,4401,51,68,2837.67,4778.00,0.00
2024-12-10 17:37:47,120,4401,52,68,2814.03,4778.01,0.00
2024-12-10 17:37:47,119,4401,52,67,2830.05,4778.05,0.00
2024-12-10 17:37:47,118,4401,51,67,2823.89,4778.60,0.00
2024-12-10 17:37:47,118,4402,51,67,2869.41,4779.00,0.00
2024-12-10 17:37:47,119,4402,52,67,2845.30,4779.01,0.00
2024-12-10 17:37:47,118,4402,51,67,2837.77,4779.42,0.00
2024-12-10 17:37:47,119,4401,51,68,2789.35,4779.66,0.00
2024-12-10 17:37:48,119,4402,51,68,2822.68,4780.00,0.00
2024-12-10 17:37:48,120,4402,51,69,2799.15,4780.01,0.00
2024-12-10 17:37:48,119,4402,51,68,2812.24,4780.05,0.00
2024-12-10 17:37:48,119,4403,51,68,2826.07,4781.00,0.00
2024-12-10 17:37:48,120,4403,52,68,2802.52,4781.01,0.00
2024-12-10 17:37:48,119,4403,51,68,2824.87,4781.03,0.00
2024-12-10 17:37:48,119,4404,51,68,2797.41,4782.00,0.00
2024-12-10 17:37:48,120,4404,52,68,2774.10,4782.01,0.00
2024-12-10 17:37:48,119,4404,52,67,2771.61,4782.34,0.00
2024-12-10 17:37:48,119,4405,52,67,2766.44,4783.00,0.00
2024-12-10 17:37:48,120,4405,53,67,2743.39,4783.01,0.00
2024-12-10 17:37:48,119,4405,52,67,2766.04,4783.01,0.00
2024-12-10 17:37:48,118,4405,51,67,2788.27,4783.03,0.00
2024-12-10 17:37:48,117,4405,51,66,2804.33,4783.03,0.00
2024-12-10 17:37:48,116,4405,50,66,2814.20,4783.30,0.00
2024-12-10 17:37:48,116,4406,50,66,2804.81,4784.00,0.00
2024-12-10 17:37:48,117,4406,50,67,2780.84,4784.01,0.00
2024-12-10 17:37:48,116,4406,50,66,2796.57,4784.05,0.00
2024-12-10 17:37:48,115,4406,49,66,2771.98,4784.70,0.00
2024-12-10 17:37:48,116,4405,49,67,2744.83,4784.78,0.00
2024-12-10 17:37:48,117,4404,50,67,2717.82,4784.92,0.00
2024-12-10 17:37:48,117,4405,50,67,2757.97,4785.00,0.00
2024-12-10 17:37:48,118,4405,51,67,2734.60,4785.01,0.00
2024-12-10 17:37:48,117,4405,50,67,2751.84,4785.03,0.00
2024-12-10 17:37:48,116,4405,50,66,2768.14,4785.05,0.00
2024-12-10 17:37:48,116,4406,50,66,2844.36,4786.00,0.00
2024-12-10 17:37:48,117,4406,50,67,2820.05,4786.01,0.00
2024-12-10 17:37:48,116,4406,49,67,2835.28,4786.01,0.00
2024-12-10 17:37:48,115,4406,49,66,2851.62,4786.04,0.00
2024-12-10 17:37:48,114,4406,48,66,2864.81,4786.27,0.00
2024-12-10 17:37:48,114,4407,48,66,2869.66,4787.00,0.00
2024-12-10 17:37:48,115,4407,48,67,2844.71,4787.01,0.00
2024-12-10 17:37:48,114,4407,48,66,2861.27,4787.04,0.00
2024-12-10 17:37:48,113,4407,47,66,2878.13,4787.06,0.00
2024-12-10 17:37:48,112,4407,46,66,2871.14,4787.66,0.00
2024-12-10 17:37:48,112,4408,46,66,2897.93,4788.00,0.00
2024-12-10 17:37:48,113,4408,47,66,2872.29,4788.01,0.00
2024-12-10 17:37:48,112,4408,46,66,2897.77,4788.01,0.00
2024-12-10 17:37:48,111,4408,46,65,2914.82,4788.04,0.00
2024-12-10 17:37:48,110,4408,45,65,2935.69,4788.16,0.00
2024-12-10 17:37:48,109,4408,44,65,2944.19,4788.22,0.00
2024-12-10 17:37:48,108,4408,43,65,2959.12,4788.42,0.00
2024-12-10 17:37:48,108,4409,43,65,2972.98,4789.00,0.00
2024-12-10 17:37:48,109,4409,43,66,2945.71,4789.01,0.00
2024-12-10 17:37:48,108,4409,43,65,2963.69,4789.05,0.00
2024-12-10 17:37:48,108,4410,43,65,2942.00,4790.00,0.00
2024-12-10 17:37:48,109,4410,44,65,2915.01,4790.01,0.00
2024-12-10 17:37:48,108,4410,43,65,2923.39,4790.06,0.00
2024-12-10 17:37:48,109,4409,43,66,2876.96,4790.49,0.00
2024-12-10 17:37:48,110,4408,43,67,2853.61,4790.56,0.00
2024-12-10 17:37:48,110,4409,43,67,2884.46,4791.00,0.00
2024-12-10 17:37:48,111,4409,44,67,2858.47,4791.01,0.00
2024-12-10 17:37:48,110,4409,44,66,2848.00,4791.52,0.00
2024-12-10 17:37:48,111,4408,44,67,2814.69,4791.69,0.00
2024-12-10 17:37:48,111,4409,44,67,2933.46,4792.00,0.00
2024-12-10 17:37:48,112,4409,44,68,2907.27,4792.01,0.00
2024-12-10 17:37:48,111,4409,43,68,2907.88,4792.36,0.00
2024-12-10 17:37:48,111,4410,43,68,2946.79,4793.00,0.00
2024-12-10 17:37:48,112,4410,44,68,2920.48,4793.01,0.00
2024-12-10 17:37:48,111,4410,44,67,2944.64,4793.05,0.00
2024-12-10 17:37:48,111,4411,44,67,2925.38,4794.00,0.00
2024-12-10 17:37:48,112,4411,44,68,2899.26,4794.01,0.00
2024-12-10 17:37:48,111,4411,43,68,2925.38,4794.01,0.00
2024-12-10 17:37:48,110,4411,43,67,2944.57,4794.04,0.00
2024-12-10 17:37:48,109,4411,42,67,2935.17,4794.55,0.00
2024-12-10 17:37:48,109,4412,42,67,2957.96,4795.00,0.00
2024-12-10 17:37:48,110,4412,42,68,2931.07,4795.01,0.00
2024-12-10 17:37:48,109,4412,42,67,2948.74,4795.06,0.00
2024-12-10 17:37:48,109,4413,42,67,2929.94,4796.00,0.00
2024-12-10 17:37:48,110,4413,43,67,2903.30,4796.01,0.00
2024-12-10 17:37:48,111,4412,43,68,2876.71,4796.04,0.00
2024-12-10 17:37:48,110,4412,43,67,2903.76,4796.10,0.00
2024-12-10 17:37:48,111,4411,43,68,2873.00,4796.21,0.00
2024-12-10 17:37:48,111,4412,43,68,2877.87,4797.00,0.00
2024-12-10 17:37:48,112,4412,44,68,2852.18,4797.01,0.00
2024-12-10 17:37:48,111,4412,44,67,2877.44,4797.01,0.00
2024-12-10 17:37:48,110,4412,44,66,2891.41,4797.08,0.00
2024-12-10 17:37:48,109,4412,43,66,2916.78,4797.10,0.00
2024-12-10 17:37:48,108,4412,42,66,2930.03,4797.13,0.00
2024-12-10 17:37:48,108,4413,42,66,3022.02,4798.00,0.00
2024-12-10 17:37:48,109,4413,42,67,2994.29,4798.01,0.00
2024-12-10 17:37:48,108,4413,42,66,3008.71,4798.09,0.00
2024-12-10 17:37:48,108,4414,42,66,2992.30,4799.00,0.00
2024-12-10 17:37:48,109,4414,42,67,2964.85,4799.01,0.00
2024-12-10 17:37:48,108,4414,42,66,2979.00,4799.09,0.00
2024-12-10 17:37:48,108,4415,42,66,2962.55,4800.00,0.00
2024-12-10 17:37:48,109,4415,42,67,2935.37,4800.01,0.00
2024-12-10 17:37:48,110,4414,43,67,2862.81,4800.81,0.00
2024-12-10 17:37:48,110,4415,43,67,2886.54,4801.00,0.00
2024-12-10 17:37:48,111,4415,43,68,2860.54,4801.01,0.00
2024-12-10 17:37:48,110,4415,43,67,2881.77,4801.10,0.00
2024-12-10 17:37:48,111,4414,44,67,2839.96,4801.45,0.00
2024-12-10 17:37:48,111,4415,44,67,2918.67,4802.00,0.00
2024-12-10 17:37:48,112,4415,44,68,2892.61,4802.01,0.00
2024-12-10 17:37:48,111,4415,43,68,2890.49,4802.27,0.00
2024-12-10 17:37:48,112,4414,43,69,2851.56,4802.56,0.00
2024-12-10 17:37:48,113,4413,44,69,2839.51,4802.58,0.00
2024-12-10 17:37:48,113,4414,44,69,2917.61,4803.00,0.00
2024-12-10 17:37:48,114,4414,45,69,2892.02,4803.01,0.00
2024-12-10 17:37:48,113,4414,44,69,2895.12,4803.28,0.00
2024-12-10 17:37:48,114,4413,44,70,2865.56,4803.39,0.00
2024-12-10 17:37:48,114,4414,44,70,2967.99,4804.00,0.00
2024-12-10 17:37:48,115,4414,45,70,2942.18,4804.01,0.00
2024-12-10 17:37:48,115,4415,45,70,2956.89,4805.00,0.00
2024-12-10 17:37:48,116,4415,46,70,2931.40,4805.01,0.00
2024-12-10 17:37:48,117,4414,46,71,2892.82,4805.14,0.00
2024-12-10 17:37:48,118,4413,47,71,2861.45,4805.55,0.00
2024-12-10 17:37:48,118,4414,47,71,2865.38,4806.00,0.00
2024-12-10 17:37:48,119,4414,47,72,2841.30,4806.01,0.00
2024-12-10 17:37:48,118,4414,47,71,2859.29,4806.10,0.00
2024-12-10 17:37:49,118,4415,47,71,2921.95,4807.00,0.00
2024-12-10 17:37:49,119,4415,47,72,2897.40,4807.01,0.00
2024-12-10 17:37:49,119,4416,47,72,2865.42,4808.00,0.00
2024-12-10 17:37:49,120,4416,47,73,2841.54,4808.01,0.00
2024-12-10 17:37:49,119,4416,46,73,2864.22,4808.03,0.00
2024-12-10 17:37:49,118,4416,46,72,2882.81,4808.11,0.00
2024-12-10 17:37:49,117,4416,45,72,2880.07,4808.44,0.00
2024-12-10 17:37:49,116,4416,44,72,2889.23,4808.73,0.00
2024-12-10 17:37:49,117,4415,44,73,2860.49,4808.83,0.00
2024-12-10 17:37:49,117,4416,44,73,2898.05,4809.00,0.00
2024-12-10 17:37:49,118,4416,44,74,2873.49,4809.01,0.00
2024-12-10 17:37:49,117,4416,44,73,2896.82,4809.03,0.00
2024-12-10 17:37:49,116,4416,44,72,2918.90,4809.08,0.00
2024-12-10 17:37:49,115,4416,43,72,2905.04,4809.61,0.00
2024-12-10 17:37:49,115,4417,43,72,2970.17,4810.00,0.00
2024-12-10 17:37:49,116,4417,43,73,2944.56,4810.01,0.00
2024-12-10 17:37:49,117,4416,44,73,2869.33,4810.52,0.00
2024-12-10 17:37:49,118,4415,44,74,2859.69,4810.53,0.00
2024-12-10 17:37:49,118,4416,44,74,2891.56,4811.00,0.00
2024-12-10 17:37:49,119,4416,45,74,2867.26,4811.01,0.00
2024-12-10 17:37:49,118,4416,45,73,2890.35,4811.03,0.00
2024-12-10 17:37:49,117,4416,44,73,2914.64,4811.03,0.00
2024-12-10 17:37:49,116,4416,43,73,2939.35,4811.03,0.00
2024-12-10 17:37:49,115,4416,43,72,2942.76,4811.10,0.00
2024-12-10 17:37:49,114,4416,42,72,2934.54,4811.72,0.00
2024-12-10 17:37:49,114,4417,42,72,3047.88,4812.00,0.00
2024-12-10 17:37:49,115,4417,43,72,3021.38,4812.01,0.00
2024-12-10 17:37:49,116,4416,43,73,2992.86,4812.08,0.00
2024-12-10 17:37:49,115,4416,42,73,3020.12,4812.10,0.00
2024-12-10 17:37:49,115,4417,42,73,3010.45,4813.00,0.00
2024-12-10 17:37:49,116,4417,42,74,2984.50,4813.01,0.00
2024-12-10 17:37:49,115,4417,42,73,3001.28,4813.10,0.00
2024-12-10 17:37:49,116,4416,42,74,2961.40,4813.40,0.00
2024-12-10 17:37:49,116,4417,42,74,3010.83,4814.00,0.00
2024-12-10 17:37:49,117,4417,43,74,2985.09,4814.01,0.00
2024-12-10 17:37:49,117,4418,43,74,2994.42,4815.00,0.00
2024-12-10 17:37:49,118,4418,44,74,2969.04,4815.01,0.00
2024-12-10 17:37:49,117,4418,44,73,2986.63,4815.12,0.00
2024-12-10 17:37:49,117,4419,44,73,2968.28,4816.00,0.00
2024-12-10 17:37:49,118,4419,44,74,2943.12,4816.01,0.00
2024-12-10 17:37:49,117,4419,43,74,2965.82,4816.05,0.00
2024-12-10 17:37:49,116,4419,42,74,2946.21,4816.57,0.00
2024-12-10 17:37:49,116,4420,42,74,2967.31,4817.00,0.00
2024-12-10 17:37:49,117,4420,43,74,2941.95,4817.01,0.00
2024-12-10 17:37:49,116,4420,42,74,2965.66,4817.04,0.00
2024-12-10 17:37:49,115,4420,41,74,2989.78,4817.04,0.00
2024-12-10 17:37:49,114,4420,41,73,3011.37,4817.10,0.00
2024-12-10 17:37:49,114,4421,41,73,3010.01,4818.00,0.00
2024-12-10 17:37:49,115,4421,42,73,2983.84,4818.01,0.00
2024-12-10 17:37:49,114,4421,41,73,2973.75,4818.24,0.00
2024-12-10 17:37:49,115,4420,41,74,2925.06,4818.71,0.00
2024-12-10 17:37:49,115,4421,41,74,2962.18,4819.00,0.00
2024-12-10 17:37:49,116,4421,42,74,2936.64,4819.01,0.00
2024-12-10 17:37:49,115,4421,42,73,2955.51,4819.10,0.00
2024-12-10 17:37:49,115,4422,42,73,2979.41,4820.00,0.00
2024-12-10 17:37:49,116,4422,43,73,2953.73,4820.01,0.00
2024-12-10 17:37:49,116,4423,43,73,2922.48,4821.00,0.00
2024-12-10 17:37:49,117,4423,44,73,2897.50,4821.01,0.00
2024-12-10 17:37:49,116,4423,44,72,2916.69,4821.10,0.00
2024-12-10 17:37:49,115,4423,43,72,2911.58,4821.52,0.00
2024-12-10 17:37:49,115,4424,43,72,2930.81,4822.00,0.00
2024-12-10 17:37:49,116,4424,44,72,2905.54,4822.01,0.00
2024-12-10 17:37:49,117,4423,45,72,2857.07,4822.32,0.00
2024-12-10 17:37:49,117,4424,45,72,2871.57,4823.00,0.00
2024-12-10 17:37:49,118,4424,46,72,2847.23,4823.01,0.00
2024-12-10 17:37:49,117,4424,46,71,2864.17,4823.06,0.00
2024-12-10 17:37:49,117,4425,46,71,2883.75,4824.00,0.00
2024-12-10 17:37:49,118,4425,47,71,2859.32,4824.01,0.00
2024-12-10 17:37:49,117,4425,47,70,2874.70,4824.07,0.00
2024-12-10 17:37:49,117,4426,47,70,2853.14,4825.00,0.00
2024-12-10 17:37:49,118,4426,48,70,2828.96,4825.01,0.00
2024-12-10 17:37:49,118,4427,48,70,2797.96,4826.00,0.00
2024-12-10 17:37:49,119,4427,49,70,2774.45,4826.01,0.00
2024-12-10 17:37:49,118,4427,49,69,2786.94,4826.08,0.00
2024-12-10 17:37:49,117,4427,49,68,2804.36,4826.19,0.00
2024-12-10 17:37:49,118,4426,50,68,2754.33,4826.75,0.00
2024-12-10 17:37:49,117,4426,49,68,2782.43,4826.98,0.00
2024-12-10 17:37:49,117,4427,49,68,2822.87,4827.00,0.00
2024-12-10 17:37:49,118,4427,50,68,2798.95,4827.01,0.00
2024-12-10 17:37:49,117,4427,50,67,2818.76,4827.09,0.00
2024-12-10 17:37:49,118,4426,51,67,2766.96,4827.69,0.00
2024-12-10 17:37:49,118,4427,51,67,2827.76,4828.00,0.00
2024-12-10 17:37:49,119,4427,51,68,2803.99,4828.01,0.00
2024-12-10 17:37:49,118,4427,51,67,2815.50,4828.09,0.00
2024-12-10 17:37:49,118,4428,51,67,2837.35,4829.00,0.00
2024-12-10 17:37:49,119,4428,51,68,2813.50,4829.01,0.00
2024-12-10 17:37:49,118,4428,50,68,2827.94,4829.03,0.00
2024-12-10 17:37:49,117,4428,50,67,2840.98,4829.08,0.00
2024-12-10 17:37:49,116,4428,49,67,2856.39,4829.26,0.00
2024-12-10 17:37:49,117,4427,49,68,2808.34,4829.77,0.00
2024-12-10 17:37:49,117,4428,49,68,2846.92,4830.00,0.00
2024-12-10 17:37:49,118,4428,49,69,2822.79,4830.01,0.00
2024-12-10 17:37:49,117,4428,49,68,2834.96,4830.08,0.00
2024-12-10 17:37:49,117,4429,49,68,2857.00,4831.00,0.00
2024-12-10 17:37:49,118,4429,49,69,2832.79,4831.01,0.00
2024-12-10 17:37:49,117,4429,49,68,2845.04,4831.08,0.00
2024-12-10 17:37:49,117,4430,49,68,2825.79,4832.00,0.00
2024-12-10 17:37:49,118,4430,50,68,2801.85,4832.01,0.00
2024-12-10 17:37:49,117,4430,50,67,2824.16,4832.03,0.00
2024-12-10 17:37:49,117,4431,50,67,2794.57,4833.00,0.00
2024-12-10 17:37:49,118,4431,51,67,2770.89,4833.01,0.00
2024-12-10 17:37:49,117,4431,51,66,2792.93,4833.03,0.00
2024-12-10 17:37:49,116,4431,51,65,2806.70,4833.07,0.00
2024-12-10 17:37:49,115,4431,51,64,2830.69,4833.07,0.00
2024-12-10 17:37:50,116,4430,52,64,2800.91,4833.20,0.00
2024-12-10 17:37:50,116,4431,52,64,2791.84,4834.00,0.00
2024-12-10 17:37:50,117,4431,53,64,2767.98,4834.01,0.00
2024-12-10 17:37:50,116,4431,53,63,2780.42,4834.07,0.00
2024-12-10 17:37:50,117,4430,54,63,2699.71,4834.93,0.00
2024-12-10 17:37:50,117,4431,54,63,2781.59,4835.00,0.00
2024-12-10 17:37:50,118,4431,55,63,2758.01,4835.01,0.00
2024-12-10 17:37:50,119,4430,56,63,2682.08,4835.66,0.00
2024-12-10 17:37:50,119,4431,56,63,2758.73,4836.00,0.00
2024-12-10 17:37:50,120,4431,56,64,2735.74,4836.01,0.00
2024-12-10 17:37:50,119,4431,56,63,2757.12,4836.03,0.00
2024-12-10 17:37:50,118,4431,56,62,2772.41,4836.07,0.00
2024-12-10 17:37:50,117,4431,55,62,2794.59,4836.09,0.00
2024-12-10 17:37:50,117,4432,55,62,2833.78,4837.00,0.00
2024-12-10 17:37:50,118,4432,55,63,2809.77,4837.01,0.00
2024-12-10 17:37:50,117,4432,54,63,2823.87,4837.02,0.00
2024-12-10 17:37:50,118,4431,55,63,2762.44,4837.64,0.00
2024-12-10 17:37:50,118,4432,55,63,2798.80,4838.00,0.00
2024-12-10 17:37:50,119,4432,56,63,2775.28,4838.01,0.00
2024-12-10 17:37:50,118,4432,56,62,2788.99,4838.09,0.00
2024-12-10 17:37:50,117,4432,55,62,2790.98,4838.22,0.00
2024-12-10 17:37:50,117,4433,55,62,2835.75,4839.00,0.00
2024-12-10 17:37:50,118,4433,55,63,2811.72,4839.01,0.00
2024-12-10 17:37:50,117,4433,55,62,2834.52,4839.03,0.00
2024-12-10 17:37:50,118,4432,56,62,2788.34,4839.31,0.00
2024-12-10 17:37:50,117,4432,55,62,2814.92,4839.76,0.00
2024-12-10 17:37:50,117,4433,55,62,2828.35,4840.00,0.00
2024-12-10 17:37:50,118,4433,56,62,2804.38,4840.01,0.00
2024-12-10 17:37:50,117,4433,56,61,2825.34,4840.03,0.00
2024-12-10 17:37:50,116,4433,56,60,2846.38,4840.07,0.00
2024-12-10 17:37:50,116,4434,56,60,2866.97,4841.00,0.00
2024-12-10 17:37:50,117,4434,57,60,2842.47,4841.01,0.00
2024-12-10 17:37:50,116,4434,56,60,2811.24,4841.67,0.00
2024-12-10 17:37:50,116,4435,56,60,2837.37,4842.00,0.00
2024-12-10 17:37:50,117,4435,56,61,2813.12,4842.01,0.00
2024-12-10 17:37:50,116,4435,56,60,2833.22,4842.07,0.00
2024-12-10 17:37:50,115,4435,55,60,2849.44,4842.22,0.00
2024-12-10 17:37:50,115,4436,55,60,2837.30,4843.00,0.00
2024-12-10 17:37:50,116,4436,56,60,2812.84,4843.01,0.00
2024-12-10 17:37:50,115,4436,55,60,2776.20,4843.76,0.00
2024-12-10 17:37:50,115,4437,55,60,2806.72,4844.00,0.00
2024-12-10 17:37:50,116,4437,55,61,2782.52,4844.01,0.00
2024-12-10 17:37:50,115,4437,55,60,2803.37,4844.07,0.00
2024-12-10 17:37:50,115,4438,55,60,2784.12,4845.00,0.00
2024-12-10 17:37:50,116,4438,55,61,2760.12,4845.01,0.00
2024-12-10 17:37:50,115,4438,55,60,2772.35,4845.07,0.00
2024-12-10 17:37:50,114,4438,54,60,2785.01,4845.30,0.00
2024-12-10 17:37:50,114,4439,54,60,2776.96,4846.00,0.00
2024-12-10 17:37:50,115,4439,54,61,2752.81,4846.01,0.00
2024-12-10 17:37:50,114,4439,54,60,2765.08,4846.07,0.00
2024-12-10 17:37:50,113,4439,53,60,2771.96,4846.36,0.00
2024-12-10 17:37:50,113,4440,53,60,2784.40,4847.00,0.00
2024-12-10 17:37:50,114,4440,54,60,2759.97,4847.01,0.00
2024-12-10 17:37:50,115,4439,55,60,2707.90,4847.44,0.00
2024-12-10 17:37:50,115,4440,55,60,2739.06,4848.00,0.00
2024-12-10 17:37:50,116,4440,55,61,2715.45,4848.01,0.00
2024-12-10 17:37:50,117,4439,55,62,2661.36,4848.50,0.00
2024-12-10 17:37:50,117,4440,55,62,2745.17,4849.00,0.00
2024-12-10 17:37:50,118,4440,55,63,2721.90,4849.01,0.00
2024-12-10 17:37:50,117,4440,54,63,2725.08,4849.25,0.00
2024-12-10 17:37:50,117,4441,54,63,2745.82,4850.00,0.00
2024-12-10 17:37:50,118,4441,54,64,2722.55,4850.01,0.00
2024-12-10 17:37:50,117,4441,54,63,2692.04,4850.66,0.00
2024-12-10 17:37:50,116,4441,53,63,2705.21,4850.69,0.00
2024-12-10 17:37:50,116,4442,53,63,2732.21,4851.00,0.00
2024-12-10 17:37:50,117,4442,53,64,2708.85,4851.01,0.00
2024-12-10 17:37:50,116,4442,53,63,2728.05,4851.07,0.00
2024-12-10 17:37:50,115,4442,52,63,2732.42,4851.22,0.00
2024-12-10 17:37:50,115,4443,52,63,2737.13,4852.00,0.00
2024-12-10 17:37:50,116,4443,53,63,2713.53,4852.01,0.00
2024-12-10 17:37:50,115,4443,53,62,2726.60,4852.08,0.00
2024-12-10 17:37:50,116,4442,53,63,2663.58,4852.57,0.00
2024-12-10 17:37:50,117,4441,54,63,2657.82,4852.58,0.00
2024-12-10 17:37:50,117,4442,54,63,2696.28,4853.00,0.00
2024-12-10 17:37:50,118,4442,54,64,2673.43,4853.01,0.00
2024-12-10 17:37:50,119,4441,55,64,2650.56,4853.03,0.00
2024-12-10 17:37:50,119,4442,55,64,2725.07,4854.00,0.00
2024-12-10 17:37:50,120,4442,56,64,2702.36,4854.01,0.00
2024-12-10 17:37:50,121,4441,57,64,2680.02,4854.03,0.00
2024-12-10 17:37:50,120,4441,56,64,2710.06,4854.03,0.00
2024-12-10 17:37:50,121,4440,57,64,2671.66,4854.22,0.00
2024-12-10 17:37:50,121,4441,57,64,2719.90,4855.00,0.00
2024-12-10 17:37:50,122,4441,57,65,2697.60,4855.01,0.00
2024-12-10 17:37:50,121,4441,57,64,2713.51,4855.07,0.00
2024-12-10 17:37:50,121,4442,57,64,2773.43,4856.00,0.00
2024-12-10 17:37:50,122,4442,58,64,2750.70,4856.01,0.00
2024-12-10 17:37:50,121,4442,57,64,2772.52,4856.03,0.00
2024-12-10 17:37:50,120,4442,57,63,2787.54,4856.07,0.00
2024-12-10 17:37:50,121,4441,58,63,2754.14,4856.30,0.00
2024-12-10 17:37:50,121,4442,58,63,2768.66,4857.00,0.00
2024-12-10 17:37:50,122,4442,58,64,2745.96,4857.01,0.00
2024-12-10 17:37:50,121,4442,57,64,2745.49,4857.31,0.00
2024-12-10 17:37:50,122,4441,57,65,2722.59,4857.34,0.00
2024-12-10 17:37:51,122,4442,57,65,2763.97,4858.00,0.00
2024-12-10 17:37:51,123,4442,57,66,2741.50,4858.01,0.00
2024-12-10 17:37:51,122,4442,56,66,2762.40,4858.03,0.00
2024-12-10 17:37:51,123,4441,56,67,2719.87,4858.30,0.00
2024-12-10 17:37:51,122,4441,55,67,2728.27,4858.76,0.00
2024-12-10 17:37:51,122,4442,55,67,2796.56,4859.00,0.00
2024-12-10 17:37:51,123,4442,55,68,2773.83,4859.01,0.00
2024-12-10 17:37:51,122,4442,55,67,2791.41,4859.06,0.00
2024-12-10 17:37:51,121,4442,54,67,2806.74,4859.22,0.00
2024-12-10 17:37:51,120,4442,53,67,2815.16,4859.41,0.00
2024-12-10 17:37:51,120,4443,53,67,2867.82,4860.00,0.00
2024-12-10 17:37:51,121,4443,54,67,2844.12,4860.01,0.00
2024-12-10 17:37:51,120,4443,54,66,2859.74,4860.07,0.00
2024-12-10 17:37:51,119,4443,53,66,2847.66,4860.59,0.00
2024-12-10 17:37:51,120,4442,53,67,2817.55,4860.73,0.00
2024-12-10 17:37:51,120,4443,53,67,2854.23,4861.00,0.00
2024-12-10 17:37:51,121,4443,54,67,2830.64,4861.01,0.00
2024-12-10 17:37:51,120,4443,53,67,2852.63,4861.03,0.00
2024-12-10 17:37:51,120,4444,53,67,2868.71,4862.00,0.00
2024-12-10 17:37:51,121,4444,53,68,2845.00,4862.01,0.00
2024-12-10 17:37:51,122,4443,53,69,2771.33,4862.90,0.00
2024-12-10 17:37:51,122,4444,53,69,2793.35,4863.00,0.00
2024-12-10 17:37:51,123,4444,54,69,2770.64,4863.01,0.00
2024-12-10 17:37:51,122,4444,54,68,2787.79,4863.06,0.00
2024-12-10 17:37:51,123,4443,55,68,2723.52,4863.93,0.00
2024-12-10 17:37:51,123,4444,55,68,2785.27,4864.00,0.00
2024-12-10 17:37:51,124,4444,55,69,2762.81,4864.01,0.00
2024-12-10 17:37:51,125,4443,55,70,2714.01,4864.42,0.00
2024-12-10 17:37:51,125,4444,55,70,2773.50,4865.00,0.00
2024-12-10 17:37:51,126,4444,55,71,2751.49,4865.01,0.00
2024-12-10 17:37:51,125,4444,54,71,2749.49,4865.34,0.00
2024-12-10 17:37:51,126,4443,55,71,2688.59,4865.82,0.00
2024-12-10 17:37:51,127,4442,55,72,2669.39,4865.88,0.00
2024-12-10 17:37:51,127,4443,55,72,2743.43,4866.00,0.00
2024-12-10 17:37:51,128,4443,56,72,2722.00,4866.01,0.00
2024-12-10 17:37:51,127,4443,56,71,2739.24,4866.06,0.00
2024-12-10 17:37:51,128,4442,56,72,2714.06,4866.15,0.00
2024-12-10 17:37:51,127,4442,55,72,2738.21,4866.60,0.00
2024-12-10 17:37:51,127,4443,55,72,2831.82,4867.00,0.00
2024-12-10 17:37:51,128,4443,56,72,2809.70,4867.01,0.00
2024-12-10 17:37:51,127,4443,55,72,2820.73,4867.04,0.00
2024-12-10 17:37:51,126,4443,55,71,2839.64,4867.05,0.00
2024-12-10 17:37:51,127,4442,56,71,2787.11,4867.63,0.00
2024-12-10 17:37:51,127,4443,56,71,2857.17,4868.00,0.00
2024-12-10 17:37:51,128,4443,57,71,2834.84,4868.01,0.00
2024-12-10 17:37:51,127,4443,57,70,2851.44,4868.06,0.00
2024-12-10 17:37:51,126,4443,56,70,2866.77,4868.20,0.00
2024-12-10 17:37:51,125,4443,55,70,2868.43,4868.49,0.00
2024-12-10 17:37:51,126,4442,56,70,2832.90,4868.70,0.00
2024-12-10 17:37:51,126,4443,56,70,2903.49,4869.00,0.00
2024-12-10 17:37:51,127,4443,56,71,2880.63,4869.01,0.00
2024-12-10 17:37:51,126,4443,56,70,2898.10,4869.06,0.00
2024-12-10 17:37:51,126,4444,56,70,2910.87,4870.00,0.00
2024-12-10 17:37:51,127,4444,57,70,2887.95,4870.01,0.00
2024-12-10 17:37:51,128,4443,57,71,2865.39,4870.02,0.00
2024-12-10 17:37:51,127,4443,57,70,2886.05,4870.06,0.00
2024-12-10 17:37:51,128,4442,58,70,2858.96,4870.17,0.00
2024-12-10 17:37:51,128,4443,58,70,2867.84,4871.00,0.00
2024-12-10 17:37:51,129,4443,59,70,2845.61,4871.01,0.00
2024-12-10 17:37:51,128,4443,59,69,2862.91,4871.06,0.00
2024-12-10 17:37:51,129,4442,60,69,2840.72,4871.07,0.00
2024-12-10 17:37:51,129,4443,60,69,2925.72,4872.00,0.00
2024-12-10 17:37:51,130,4443,60,70,2903.22,4872.01,0.00
2024-12-10 17:37:51,129,4443,59,70,2923.85,4872.04,0.00
2024-12-10 17:37:51,130,4442,60,70,2900.99,4872.06,0.00
2024-12-10 17:37:51,129,4442,59,70,2891.44,4872.54,0.00
2024-12-10 17:37:51,129,4443,59,70,2939.74,4873.00,0.00
2024-12-10 17:37:51,130,4443,60,70,2917.13,4873.01,0.00
2024-12-10 17:37:51,131,4442,61,70,2854.29,4873.71,0.00
2024-12-10 17:37:51,131,4443,61,70,2913.52,4874.00,0.00
2024-12-10 17:37:51,132,4443,62,70,2891.44,4874.01,0.00
2024-12-10 17:37:51,132,4444,62,70,2896.08,4875.00,0.00
2024-12-10 17:37:51,133,4444,63,70,2874.30,4875.01,0.00
2024-12-10 17:37:51,132,4444,62,70,2894.25,4875.04,0.00
2024-12-10 17:37:51,131,4444,62,69,2908.54,4875.05,0.00
2024-12-10 17:37:51,130,4444,61,69,2916.04,4875.35,0.00
2024-12-10 17:37:51,131,4443,62,69,2874.65,4875.76,0.00
2024-12-10 17:37:51,132,4442,62,70,2857.70,4875.80,0.00
2024-12-10 17:37:51,132,4443,62,70,2872.53,4876.00,0.00
2024-12-10 17:37:51,133,4443,63,70,2850.94,4876.01,0.00
2024-12-10 17:37:51,132,4443,63,69,2868.87,4876.05,0.00
2024-12-10 17:37:51,132,4444,63,69,2915.83,4877.00,0.00
2024-12-10 17:37:51,133,4444,63,70,2893.91,4877.01,0.00
2024-12-10 17:37:51,132,4444,62,70,2886.98,4877.36,0.00
2024-12-10 17:37:51,132,4445,62,70,2890.15,4878.00,0.00
2024-12-10 17:37:51,133,4445,63,70,2868.42,4878.01,0.00
2024-12-10 17:37:51,134,4444,64,70,2799.26,4878.73,0.00
2024-12-10 17:37:51,134,4445,64,70,2821.74,4879.00,0.00
2024-12-10 17:37:51,135,4445,64,71,2800.84,4879.01,0.00
2024-12-10 17:37:51,134,4445,64,70,2817.75,4879.05,0.00
2024-12-10 17:37:51,133,4445,63,70,2813.97,4879.44,0.00
2024-12-10 17:37:51,133,4446,63,70,2859.42,4880.00,0.00
2024-12-10 17:37:51,134,4446,63,71,2838.09,4880.01,0.00
2024-12-10 17:37:51,134,4447,63,71,2808.41,4881.00,0.00
2024-12-10 17:37:51,135,4447,64,71,2787.61,4881.01,0.00
2024-12-10 17:37:51,134,4447,63,71,2800.52,4881.02,0.00
2024-12-10 17:37:51,135,4446,64,71,2771.11,4881.06,0.00
2024-12-10 17:37:51,134,4446,63,71,2793.03,4881.74,0.00
2024-12-10 17:37:51,134,4447,63,71,2816.93,4882.00,0.00
2024-12-10 17:37:51,135,4447,63,72,2796.07,4882.01,0.00
2024-12-10 17:37:51,134,4447,63,71,2813.67,4882.04,0.00
2024-12-10 17:37:51,135,4446,64,71,2764.29,4882.64,0.00
2024-12-10 17:37:52,135,4447,64,71,2828.96,4883.00,0.00
2024-12-10 17:37:52,136,4447,64,72,2808.16,4883.01,0.00
2024-12-10 17:37:52,135,4447,64,71,2825.73,4883.04,0.00
2024-12-10 17:37:52,135,4448,64,71,2835.64,4884.00,0.00
2024-12-10 17:37:52,136,4448,64,72,2814.79,4884.01,0.00
2024-12-10 17:37:52,135,4448,64,71,2832.41,4884.04,0.00
2024-12-10 17:37:52,134,4448,63,71,2831.43,4884.41,0.00
2024-12-10 17:37:52,135,4447,64,71,2797.95,4884.68,0.00
2024-12-10 17:37:52,135,4448,64,71,2825.03,4885.00,0.00
2024-12-10 17:37:52,136,4448,65,71,2804.26,4885.01,0.00
2024-12-10 17:37:52,135,4448,65,70,2821.44,4885.04,0.00
2024-12-10 17:37:52,134,4448,64,70,2812.77,4885.34,0.00
2024-12-10 17:37:52,133,4448,63,70,2819.75,4885.62,0.00
2024-12-10 17:37:52,134,4447,64,70,2798.34,4885.64,0.00
2024-12-10 17:37:52,134,4448,64,70,2859.55,4886.00,0.00
2024-12-10 17:37:52,135,4448,64,71,2838.37,4886.01,0.00
2024-12-10 17:37:52,134,4448,64,70,2855.93,4886.05,0.00
2024-12-10 17:37:52,135,4447,65,70,2787.87,4886.71,0.00
2024-12-10 17:37:52,135,4448,65,70,2852.52,4887.00,0.00
2024-12-10 17:37:52,136,4448,66,70,2831.54,4887.01,0.00
2024-12-10 17:37:52,135,4448,66,69,2849.28,4887.04,0.00
2024-12-10 17:37:52,136,4447,67,69,2815.51,4887.30,0.00
2024-12-10 17:37:52,137,4446,67,70,2813.56,4887.42,0.00
2024-12-10 17:37:52,137,4446,67,70,2851.99,4888.00,0.00
2024-12-10 17:37:52,138,4446,67,71,2831.32,4888.01,0.00
2024-12-10 17:37:52,138,4447,67,71,2877.59,4889.00,0.00
2024-12-10 17:37:52,139,4447,68,71,2856.88,4889.01,0.00
2024-12-10 17:37:52,140,4446,69,71,2822.56,4889.16,0.00
2024-12-10 17:37:52,141,4445,69,72,2776.51,4889.85,0.00
2024-12-10 17:37:52,141,4446,69,72,2808.55,4890.00,0.00
2024-12-10 17:37:52,142,4446,70,72,2788.77,4890.01,0.00
2024-12-10 17:37:52,143,4445,70,73,2728.74,4890.69,0.00
2024-12-10 17:37:52,144,4444,71,73,2710.60,4890.85,0.00
2024-12-10 17:37:52,144,4445,71,73,2798.87,4891.00,0.00
2024-12-10 17:37:52,145,4445,72,73,2779.56,4891.01,0.00
2024-12-10 17:37:52,144,4445,72,72,2790.40,4891.04,0.00
2024-12-10 17:37:52,144,4446,72,72,2830.98,4892.00,0.00
2024-12-10 17:37:52,145,4446,72,73,2811.46,4892.01,0.00
2024-12-10 17:37:52,144,4446,72,72,2828.96,4892.04,0.00
2024-12-10 17:37:52,143,4446,71,72,2823.45,4892.54,0.00
2024-12-10 17:37:52,143,4447,71,72,2821.33,4893.00,0.00
2024-12-10 17:37:52,144,4447,72,72,2801.74,4893.01,0.00
2024-12-10 17:37:52,143,4447,72,71,2818.95,4893.04,0.00
2024-12-10 17:37:52,143,4448,72,71,2792.13,4894.00,0.00
2024-12-10 17:37:52,144,4448,73,71,2772.74,4894.01,0.00
2024-12-10 17:37:52,145,4447,73,72,2734.92,4894.26,0.00
2024-12-10 17:37:52,145,4448,73,72,2729.58,4895.00,0.00
2024-12-10 17:37:52,146,4448,73,73,2710.88,4895.01,0.00
2024-12-10 17:37:52,147,4447,73,74,2660.67,4895.54,0.00
2024-12-10 17:37:52,147,4448,73,74,2708.43,4896.00,0.00
2024-12-10 17:37:52,148,4448,74,74,2690.13,4896.01,0.00
2024-12-10 17:37:52,147,4448,73,74,2689.42,4896.26,0.00
2024-12-10 17:37:52,146,4448,73,73,2690.61,4896.61,0.00
2024-12-10 17:37:52,146,4449,73,73,2725.46,4897.00,0.00
2024-12-10 17:37:52,147,4449,73,74,2706.92,4897.01,0.00
2024-12-10 17:37:52,146,4449,73,73,2722.80,4897.05,0.00
2024-12-10 17:37:52,146,4450,73,73,2696.39,4898.00,0.00
2024-12-10 17:37:52,147,4450,73,74,2678.04,4898.01,0.00
2024-12-10 17:37:52,146,4450,73,73,2693.72,4898.06,0.00
2024-12-10 17:37:52,147,4449,74,73,2665.42,4898.14,0.00
2024-12-10 17:37:52,147,4450,74,73,2673.79,4899.00,0.00
2024-12-10 17:37:52,148,4450,74,74,2655.73,4899.01,0.00
2024-12-10 17:37:52,148,4451,74,74,2655.16,4900.00,0.00
2024-12-10 17:37:52,149,4451,75,74,2637.34,4900.01,0.00
2024-12-10 17:37:52,148,4451,75,73,2646.71,4900.05,0.00
2024-12-10 17:37:52,147,4451,75,72,2664.38,4900.05,0.00
2024-12-10 17:37:52,146,4451,74,72,2682.30,4900.06,0.00
2024-12-10 17:37:52,147,4450,74,73,2648.71,4900.33,0.00
2024-12-10 17:37:52,146,4450,73,73,2667.23,4900.40,0.00
2024-12-10 17:37:52,146,4451,73,73,2671.66,4901.00,0.00
2024-12-10 17:37:52,147,4451,74,73,2653.49,4901.01,0.00
2024-12-10 17:37:52,148,4450,74,74,2634.24,4901.05,0.00
2024-12-10 17:37:52,147,4450,74,73,2657.51,4901.06,0.00
2024-12-10 17:37:52,146,4450,74,72,2669.59,4901.14,0.00
2024-12-10 17:37:52,145,4450,73,72,2678.93,4901.33,0.00
2024-12-10 17:37:52,146,4449,74,72,2654.93,4901.46,0.00
2024-12-10 17:37:52,145,4449,73,72,2663.19,4901.61,0.00
2024-12-10 17:37:52,146,4448,73,73,2637.34,4901.77,0.00
2024-12-10 17:37:52,146,4449,73,73,2699.97,4902.00,0.00
2024-12-10 17:37:52,147,4449,73,74,2681.60,4902.01,0.00
2024-12-10 17:37:52,146,4449,73,73,2696.97,4902.06,0.00
2024-12-10 17:37:52,145,4449,73,72,2715.23,4902.06,0.00
2024-12-10 17:37:52,144,4449,72,72,2733.75,4902.06,0.00
2024-12-10 17:37:52,143,4449,71,72,2732.69,4902.25,0.00
2024-12-10 17:37:52,142,4449,70,72,2749.54,4902.30,0.00
2024-12-10 17:37:52,142,4450,70,72,2853.94,4903.00,0.00
2024-12-10 17:37:52,143,4450,71,72,2833.98,4903.01,0.00
2024-12-10 17:37:52,142,4450,70,72,2853.25,4903.01,0.00
2024-12-10 17:37:52,141,4450,70,71,2870.73,4903.06,0.00
2024-12-10 17:37:53,142,4449,71,71,2801.85,4903.80,0.00
2024-12-10 17:37:53,142,4450,71,71,2832.07,4904.00,0.00
2024-12-10 17:37:53,143,4450,71,72,2812.27,4904.01,0.00
2024-12-10 17:37:53,142,4450,70,72,2811.09,4904.30,0.00
2024-12-10 17:37:53,143,4449,71,72,2788.72,4904.36,0.00
2024-12-10 17:37:53,143,4450,71,72,2831.61,4905.00,0.00
2024-12-10 17:37:53,144,4450,72,72,2811.95,4905.01,0.00
2024-12-10 17:37:53,145,4449,72,73,2792.22,4905.03,0.00
2024-12-10 17:37:53,144,4449,72,72,2836.51,4905.08,0.00
2024-12-10 17:37:53,145,4448,73,72,2804.50,4905.35,0.00
2024-12-10 17:37:53,144,4448,72,72,2822.17,4905.57,0.00
2024-12-10 17:37:53,144,4449,72,72,2869.51,4906.00,0.00
2024-12-10 17:37:53,145,4449,73,72,2849.72,4906.01,0.00
2024-12-10 17:37:53,144,4449,73,71,2866.14,4906.07,0.00
2024-12-10 17:37:53,145,4448,73,72,2828.25,4906.46,0.00
2024-12-10 17:37:53,145,4449,73,72,2900.05,4907.00,0.00
2024-12-10 17:37:53,146,4449,74,72,2880.18,4907.01,0.00
2024-12-10 17:37:53,147,4448,74,73,2859.93,4907.03,0.00
2024-12-10 17:37:53,146,4448,74,72,2888.83,4907.08,0.00
2024-12-10 17:37:53,146,4449,74,72,2897.78,4908.00,0.00
2024-12-10 17:37:53,147,4449,75,72,2878.06,4908.01,0.00
2024-12-10 17:37:53,146,4449,75,71,2892.43,4908.04,0.00
2024-12-10 17:37:53,145,4449,75,70,2911.03,4908.06,0.00
2024-12-10 17:37:53,144,4449,75,69,2929.89,4908.07,0.00
2024-12-10 17:37:53,144,4450,75,69,2939.30,4909.00,0.00
2024-12-10 17:37:53,145,4450,76,69,2919.03,4909.01,0.00
2024-12-10 17:37:53,144,4450,76,68,2929.46,4909.06,0.00
2024-12-10 17:37:53,144,4451,76,68,2904.43,4910.00,0.00
2024-12-10 17:37:53,145,4451,77,68,2884.40,4910.01,0.00
2024-12-10 17:37:53,144,4451,76,68,2893.56,4910.08,0.00
2024-12-10 17:37:53,144,4452,76,68,2882.85,4911.00,0.00
2024-12-10 17:37:53,145,4452,76,69,2862.97,4911.01,0.00
2024-12-10 17:37:53,146,4451,76,70,2800.00,4911.77,0.00
2024-12-10 17:37:53,146,4452,76,70,2816.01,4912.00,0.00
2024-12-10 17:37:53,147,4452,77,70,2796.86,4912.01,0.00
2024-12-10 17:37:53,146,4452,77,69,2813.01,4912.03,0.00
2024-12-10 17:37:53,145,4452,76,69,2831.07,4912.06,0.00
2024-12-10 17:37:53,144,4452,76,68,2850.05,4912.06,0.00
2024-12-10 17:37:53,144,4453,76,68,2859.12,4913.00,0.00
2024-12-10 17:37:53,145,4453,76,69,2839.40,4913.01,0.00
2024-12-10 17:37:53,146,4452,77,69,2818.63,4913.05,0.00
2024-12-10 17:37:53,145,4452,77,68,2858.76,4913.07,0.00
2024-12-10 17:37:53,144,4452,77,67,2878.27,4913.07,0.00
2024-12-10 17:37:53,143,4452,76,67,2888.50,4913.27,0.00
2024-12-10 17:37:53,144,4451,77,67,2823.05,4913.99,0.00
2024-12-10 17:37:53,144,4452,77,67,2857.18,4914.00,0.00
2024-12-10 17:37:53,145,4452,77,68,2837.48,4914.01,0.00
2024-12-10 17:37:53,144,4452,77,67,2848.35,4914.06,0.00
2024-12-10 17:37:53,143,4452,76,67,2846.53,4914.38,0.00
2024-12-10 17:37:53,143,4453,76,67,2919.47,4915.00,0.00
2024-12-10 17:37:53,144,4453,77,67,2899.19,4915.01,0.00
2024-12-10 17:37:53,143,4453,76,67,2916.76,4915.06,0.00
2024-12-10 17:37:53,142,4453,76,66,2936.61,4915.06,0.00
2024-12-10 17:37:53,141,4453,75,66,2935.28,4915.42,0.00
2024-12-10 17:37:53,142,4452,75,67,2893.76,4915.86,0.00
2024-12-10 17:37:53,142,4453,75,67,2925.39,4916.00,0.00
2024-12-10 17:37:53,143,4453,75,68,2904.93,4916.01,0.00
2024-12-10 17:37:53,142,4453,75,67,2916.79,4916.09,0.00
2024-12-10 17:37:53,143,4452,75,68,2885.48,4916.33,0.00
2024-12-10 17:37:53,143,4453,75,68,2918.59,4917.00,0.00
2024-12-10 17:37:53,144,4453,75,69,2898.32,4917.01,0.00
2024-12-10 17:37:53,143,4453,75,68,2910.04,4917.09,0.00
2024-12-10 17:37:53,143,4454,75,68,2920.90,4918.00,0.00
2024-12-10 17:37:53,144,4454,75,69,2900.62,4918.01,0.00
2024-12-10 17:37:53,145,4453,75,70,2880.28,4918.03,0.00
2024-12-10 17:37:53,144,4453,75,69,2896.91,4918.10,0.00
2024-12-10 17:37:53,143,4453,74,69,2895.99,4918.43,0.00
2024-12-10 17:37:53,143,4454,74,69,2902.92,4919.00,0.00
2024-12-10 17:37:53,144,4454,75,69,2882.76,4919.01,0.00
2024-12-10 17:37:53,143,4454,75,68,2894.71,4919.09,0.00
2024-12-10 17:37:53,144,4453,76,68,2839.62,4919.54,0.00
2024-12-10 17:37:53,144,4454,76,68,2891.55,4920.00,0.00
2024-12-10 17:37:53,145,4454,76,69,2871.61,4920.01,0.00
2024-12-10 17:37:53,144,4454,75,69,2888.52,4920.06,0.00
2024-12-10 17:37:53,145,4453,75,70,2867.92,4920.09,0.00
2024-12-10 17:37:53,144,4453,75,69,2912.79,4920.09,0.00
2024-12-10 17:37:53,143,4453,74,69,2900.80,4920.75,0.00
2024-12-10 17:37:53,143,4454,74,69,2943.68,4921.00,0.00
2024-12-10 17:37:53,144,4454,75,69,2923.24,4921.01,0.00
2024-12-10 17:37:53,143,4454,75,68,2933.75,4921.10,0.00
2024-12-10 17:37:53,143,4455,75,68,2944.96,4922.00,0.00
2024-12-10 17:37:53,144,4455,76,68,2924.51,4922.01,0.00
2024-12-10 17:37:53,143,4455,75,68,2897.76,4922.63,0.00
2024-12-10 17:37:53,144,4454,75,69,2877.30,4922.65,0.00
2024-12-10 17:37:53,144,4455,75,69,2897.76,4923.00,0.00
2024-12-10 17:37:53,145,4455,76,69,2877.77,4923.01,0.00
2024-12-10 17:37:53,144,4455,75,69,2879.98,4923.23,0.00
2024-12-10 17:37:53,145,4454,75,70,2846.33,4923.52,0.00
2024-12-10 17:37:53,145,4455,75,70,2891.17,4924.00,0.00
2024-12-10 17:37:53,146,4455,75,71,2871.36,4924.01,0.00
2024-12-10 17:37:53,145,4455,74,71,2888.15,4924.06,0.00
2024-12-10 17:37:53,144,4455,74,70,2905.48,4924.09,0.00
2024-12-10 17:37:53,145,4454,75,70,2884.77,4924.12,0.00
2024-12-10 17:37:53,145,4455,75,70,2924.70,4925.00,0.00
2024-12-10 17:37:53,146,4455,75,71,2904.67,4925.01,0.00
2024-12-10 17:37:53,145,4455,75,70,2915.24,4925.10,0.00
2024-12-10 17:37:53,145,4456,75,70,2925.63,4926.00,0.00
2024-12-10 17:37:53,146,4456,75,71,2905.59,4926.01,0.00
2024-12-10 17:37:53,145,4456,75,70,2915.16,4926.10,0.00
2024-12-10 17:37:54,145,4457,75,70,2891.91,4927.00,0.00
2024-12-10 17:37:54,146,4457,75,71,2872.10,4927.01,0.00
2024-12-10 17:37:54,145,4457,74,71,2888.89,4927.06,0.00
2024-12-10 17:37:54,144,4457,74,70,2900.41,4927.10,0.00
2024-12-10 17:37:54,144,4458,74,70,2877.33,4928.00,0.00
2024-12-10 17:37:54,145,4458,74,71,2857.49,4928.01,0.00
2024-12-10 17:37:54,144,4458,74,70,2866.09,4928.10,0.00
2024-12-10 17:37:54,143,4458,73,70,2875.54,4928.31,0.00
2024-12-10 17:37:54,142,4458,72,70,2859.06,4928.96,0.00
2024-12-10 17:37:54,142,4459,72,70,2891.72,4929.00,0.00
2024-12-10 17:37:54,143,4459,72,71,2871.50,4929.01,0.00
2024-12-10 17:37:54,144,4458,73,71,2849.53,4929.06,0.00
2024-12-10 17:37:54,143,4458,72,71,2863.63,4929.11,0.00
2024-12-10 17:37:54,142,4458,72,70,2876.85,4929.11,0.00
2024-12-10 17:37:54,142,4459,72,70,2868.35,4930.00,0.00
2024-12-10 17:37:54,143,4459,73,70,2848.29,4930.01,0.00
2024-12-10 17:37:54,142,4459,73,69,2856.95,4930.11,0.00
2024-12-10 17:37:54,143,4458,74,69,2826.72,4930.33,0.00
2024-12-10 17:37:54,144,4457,75,69,2806.64,4930.76,0.00
2024-12-10 17:37:54,143,4457,74,69,2832.50,4930.79,0.00
2024-12-10 17:37:54,143,4458,74,69,2891.28,4931.00,0.00
2024-12-10 17:37:54,144,4458,74,70,2871.21,4931.01,0.00
2024-12-10 17:37:54,144,4459,74,70,2914.42,4932.00,0.00
2024-12-10 17:37:54,145,4459,75,70,2894.32,4932.01,0.00
2024-12-10 17:37:54,144,4459,74,70,2897.61,4932.21,0.00
2024-12-10 17:37:54,144,4460,74,70,2885.30,4933.00,0.00
2024-12-10 17:37:54,145,4460,75,70,2865.40,4933.01,0.00
2024-12-10 17:37:54,144,4460,74,70,2862.09,4933.33,0.00
2024-12-10 17:37:54,143,4460,73,70,2868.34,4933.48,0.00
2024-12-10 17:37:54,144,4459,74,70,2831.85,4933.83,0.00
2024-12-10 17:37:54,144,4460,74,70,2863.52,4934.00,0.00
2024-12-10 17:37:54,145,4460,74,71,2843.77,4934.01,0.00
2024-12-10 17:37:54,144,4460,73,71,2860.14,4934.07,0.00
2024-12-10 17:37:54,143,4460,73,70,2874.63,4934.10,0.00
2024-12-10 17:37:54,143,4461,73,70,2885.86,4935.00,0.00
2024-12-10 17:37:54,144,4461,73,71,2865.81,4935.01,0.00
2024-12-10 17:37:54,143,4461,72,71,2882.45,4935.07,0.00
2024-12-10 17:37:54,142,4461,72,70,2896.15,4935.09,0.00
2024-12-10 17:37:54,143,4460,72,71,2874.87,4935.13,0.00
2024-12-10 17:37:54,142,4460,71,71,2907.02,4935.32,0.00
2024-12-10 17:37:54,142,4461,71,71,2894.60,4936.00,0.00
2024-12-10 17:37:54,143,4461,71,72,2874.36,4936.01,0.00
2024-12-10 17:37:54,143,4462,71,72,2882.85,4937.00,0.00
2024-12-10 17:37:54,144,4462,71,73,2862.83,4937.01,0.00
2024-12-10 17:37:54,144,4463,71,73,2831.26,4938.00,0.00
2024-12-10 17:37:54,145,4463,72,73,2811.73,4938.01,0.00
2024-12-10 17:37:54,144,4463,71,73,2804.96,4938.35,0.00
2024-12-10 17:37:54,143,4463,70,73,2799.43,4938.67,0.00
2024-12-10 17:37:54,143,4464,70,73,2817.99,4939.00,0.00
2024-12-10 17:37:54,144,4464,71,73,2798.43,4939.01,0.00
2024-12-10 17:37:54,143,4464,71,72,2811.83,4939.09,0.00
2024-12-10 17:37:54,143,4465,71,72,2785.96,4940.00,0.00
2024-12-10 17:37:54,144,4465,71,73,2766.61,4940.01,0.00
2024-12-10 17:37:54,143,4465,70,73,2758.59,4940.23,0.00
2024-12-10 17:37:54,143,4466,70,73,2753.63,4941.00,0.00
2024-12-10 17:37:54,144,4466,70,74,2734.51,4941.01,0.00
2024-12-10 17:37:54,143,4466,70,73,2749.32,4941.09,0.00
2024-12-10 17:37:54,142,4466,69,73,2755.85,4941.19,0.00
2024-12-10 17:37:54,142,4467,69,73,2748.96,4942.00,0.00
2024-12-10 17:37:54,143,4467,69,74,2729.73,4942.01,0.00
2024-12-10 17:37:54,142,4467,68,74,2723.79,4942.34,0.00
2024-12-10 17:37:54,142,4468,68,74,2723.32,4943.00,0.00
2024-12-10 17:37:54,143,4468,68,75,2704.28,4943.01,0.00
2024-12-10 17:37:54,142,4468,67,75,2670.94,4943.81,0.00
2024-12-10 17:37:54,142,4469,67,75,2695.65,4944.00,0.00
2024-12-10 17:37:54,143,4469,67,76,2676.80,4944.01,0.00
2024-12-10 17:37:54,142,4469,67,75,2691.52,4944.08,0.00
2024-12-10 17:37:54,141,4469,66,75,2687.31,4944.37,0.00
2024-12-10 17:37:54,141,4470,66,75,2682.19,4945.00,0.00
2024-12-10 17:37:54,142,4470,67,75,2663.30,4945.01,0.00
2024-12-10 17:37:54,141,4470,66,75,2658.39,4945.31,0.00
2024-12-10 17:37:54,140,4470,65,75,2643.62,4945.76,0.00
2024-12-10 17:37:54,141,4469,65,76,2615.55,4945.96,0.00
2024-12-10 17:37:54,141,4470,65,76,2648.24,4946.00,0.00
2024-12-10 17:37:54,142,4470,66,76,2629.59,4946.01,0.00
2024-12-10 17:37:54,143,4469,66,77,2609.84,4946.05,0.00
2024-12-10 17:37:54,142,4469,66,76,2633.47,4946.10,0.00
2024-12-10 17:37:54,141,4469,65,76,2638.37,4946.36,0.00
2024-12-10 17:37:54,142,4468,66,76,2609.08,4946.59,0.00
2024-12-10 17:37:54,142,4469,66,76,2656.22,4947.00,0.00
2024-12-10 17:37:54,143,4469,67,76,2637.65,4947.01,0.00
2024-12-10 17:37:54,142,4469,67,75,2648.26,4947.11,0.00
2024-12-10 17:37:54,143,4468,67,76,2622.86,4947.26,0.00
2024-12-10 17:37:54,142,4468,66,76,2661.42,4947.37,0.00
2024-12-10 17:37:54,142,4469,66,76,2718.00,4948.00,0.00
2024-12-10 17:37:54,143,4469,66,77,2698.99,4948.01,0.00
2024-12-10 17:37:54,144,4468,67,77,2651.56,4948.47,0.00
2024-12-10 17:37:54,144,4469,67,77,2697.18,4949.00,0.00
2024-12-10 17:37:54,145,4469,67,78,2678.58,4949.01,0.00
2024-12-10 17:37:54,144,4469,67,77,2686.23,4949.11,0.00
2024-12-10 17:37:54,143,4469,66,77,2691.61,4949.38,0.00
2024-12-10 17:37:54,142,4469,65,77,2679.04,4949.90,0.00
2024-12-10 17:37:55,142,4470,65,77,2740.91,4950.00,0.00
2024-12-10 17:37:55,143,4470,65,78,2721.74,4950.01,0.00
2024-12-10 17:37:55,142,4470,65,77,2732.94,4950.11,0.00
2024-12-10 17:37:55,141,4470,64,77,2729.64,4950.49,0.00
2024-12-10 17:37:55,141,4471,64,77,2737.96,4951.00,0.00
2024-12-10 17:37:55,142,4471,65,77,2718.67,4951.01,0.00
2024-12-10 17:37:55,141,4471,64,77,2704.94,4951.42,0.00
2024-12-10 17:37:55,141,4472,64,77,2710.00,4952.00,0.00
2024-12-10 17:37:55,142,4472,65,77,2690.92,4952.01,0.00
2024-12-10 17:37:55,141,4472,64,77,2705.83,4952.09,0.00
2024-12-10 17:37:55,140,4472,64,76,2721.63,4952.11,0.00
2024-12-10 17:37:55,141,4471,65,76,2677.94,4952.62,0.00
2024-12-10 17:37:55,142,4470,66,76,2660.65,4952.87,0.00
2024-12-10 17:37:55,142,4471,66,76,2678.40,4953.00,0.00
2024-12-10 17:37:55,143,4471,66,77,2659.67,4953.01,0.00
2024-12-10 17:37:55,142,4471,65,77,2669.17,4953.08,0.00
2024-12-10 17:37:55,143,4470,65,78,2634.27,4953.29,0.00
2024-12-10 17:37:55,143,4471,65,78,2712.44,4954.00,0.00
2024-12-10 17:37:55,144,4471,65,79,2693.61,4954.01,0.00
2024-12-10 17:37:55,143,4471,64,79,2711.61,4954.01,0.00
2024-12-10 17:37:55,143,4472,64,79,2722.39,4955.00,0.00
2024-12-10 17:37:55,144,4472,64,80,2703.49,4955.01,0.00
2024-12-10 17:37:55,143,4472,64,79,2672.36,4955.85,0.00
2024-12-10 17:37:55,143,4473,64,79,2686.00,4956.00,0.00
2024-12-10 17:37:55,144,4473,64,80,2667.35,4956.01,0.00
2024-12-10 17:37:55,143,4473,64,79,2681.54,4956.09,0.00
2024-12-10 17:37:55,143,4474,64,79,2657.75,4957.00,0.00
2024-12-10 17:37:55,144,4474,65,79,2639.30,4957.01,0.00
2024-12-10 17:37:55,143,4474,65,78,2652.60,4957.09,0.00
2024-12-10 17:37:55,142,4474,64,78,2656.12,4957.40,0.00
2024-12-10 17:37:55,142,4475,64,78,2661.41,4958.00,0.00
2024-12-10 17:37:55,143,4475,65,78,2642.79,4958.01,0.00
2024-12-10 17:37:55,144,4474,65,79,2563.19,4958.97,0.00
2024-12-10 17:37:55,144,4475,65,79,2597.32,4959.00,0.00
2024-12-10 17:37:55,145,4475,65,80,2579.41,4959.01,0.00
2024-12-10 17:37:55,144,4475,64,80,2562.09,4959.32,0.00
2024-12-10 17:37:55,143,4475,63,80,2576.23,4959.40,0.00
2024-12-10 17:37:55,143,4476,63,80,2616.16,4960.00,0.00
2024-12-10 17:37:55,144,4476,63,81,2598.00,4960.01,0.00
2024-12-10 17:37:55,145,4475,63,82,2580.08,4960.02,0.00
2024-12-10 17:37:55,144,4475,63,81,2605.96,4960.10,0.00
2024-12-10 17:37:55,143,4475,62,81,2616.61,4960.18,0.00
2024-12-10 17:37:55,142,4475,61,81,2633.52,4960.20,0.00
2024-12-10 17:37:55,143,4474,61,82,2580.46,4960.92,0.00
2024-12-10 17:37:55,143,4475,61,82,2641.59,4961.00,0.00
2024-12-10 17:37:55,144,4475,62,82,2623.24,4961.01,0.00
2024-12-10 17:37:55,143,4475,61,82,2638.85,4961.06,0.00
2024-12-10 17:37:55,142,4475,61,81,2655.69,4961.08,0.00
2024-12-10 17:37:55,141,4475,60,81,2631.87,4961.72,0.00
2024-12-10 17:37:55,141,4476,60,81,2723.94,4962.00,0.00
2024-12-10 17:37:55,142,4476,60,82,2704.76,4962.01,0.00
2024-12-10 17:37:55,141,4476,60,81,2719.76,4962.09,0.00
2024-12-10 17:37:55,142,4475,60,82,2675.29,4962.61,0.00
2024-12-10 17:37:55,142,4476,60,82,2691.67,4963.00,0.00
2024-12-10 17:37:55,143,4476,60,83,2672.85,4963.01,0.00
2024-12-10 17:37:55,142,4476,59,83,2657.85,4963.26,0.00
2024-12-10 17:37:55,143,4475,60,83,2634.09,4963.38,0.00
2024-12-10 17:37:55,144,4474,60,84,2611.31,4963.91,0.00
2024-12-10 17:37:55,144,4475,60,84,2678.95,4964.00,0.00
2024-12-10 17:37:55,145,4475,61,84,2660.48,4964.01,0.00
2024-12-10 17:37:55,144,4475,61,83,2674.17,4964.08,0.00
2024-12-10 17:37:55,143,4475,60,83,2663.69,4964.39,0.00
2024-12-10 17:37:55,142,4475,59,83,2681.76,4964.40,0.00
2024-12-10 17:37:55,142,4476,59,83,2757.22,4965.00,0.00
2024-12-10 17:37:55,143,4476,60,83,2737.94,4965.01,0.00
2024-12-10 17:37:55,142,4476,60,82,2753.06,4965.08,0.00
2024-12-10 17:37:55,141,4476,59,82,2772.24,4965.09,0.00
2024-12-10 17:37:55,142,4475,60,82,2727.40,4965.61,0.00
2024-12-10 17:37:55,142,4476,60,82,2742.92,4966.00,0.00
2024-12-10 17:37:55,143,4476,60,83,2723.73,4966.01,0.00
2024-12-10 17:37:55,142,4476,60,82,2731.41,4966.09,0.00
2024-12-10 17:37:55,141,4476,59,82,2705.39,4966.72,0.00
2024-12-10 17:37:55,141,4477,59,82,2761.78,4967.00,0.00
2024-12-10 17:37:55,142,4477,60,82,2742.33,4967.01,0.00
2024-12-10 17:37:55,141,4477,60,81,2756.54,4967.09,0.00
2024-12-10 17:37:55,140,4477,59,81,2759.19,4967.41,0.00
2024-12-10 17:37:55,140,4478,59,81,2765.34,4968.00,0.00
2024-12-10 17:37:55,141,4478,60,81,2745.72,4968.01,0.00
2024-12-10 17:37:55,140,4478,59,81,2761.12,4968.09,0.00
2024-12-10 17:37:55,139,4478,59,80,2780.26,4968.09,0.00
2024-12-10 17:37:55,139,4479,59,80,2769.84,4969.00,0.00
2024-12-10 17:37:55,140,4479,59,81,2750.06,4969.01,0.00
2024-12-10 17:37:55,139,4479,59,80,2765.23,4969.09,0.00
2024-12-10 17:37:55,140,4478,59,81,2738.85,4969.21,0.00
2024-12-10 17:37:55,140,4479,59,81,2750.42,4970.00,0.00
2024-12-10 17:37:55,141,4479,60,81,2730.91,4970.01,0.00
2024-12-10 17:37:55,140,4479,59,81,2746.20,4970.09,0.00
2024-12-10 17:37:55,139,4479,59,80,2764.88,4970.09,0.00
2024-12-10 17:37:55,140,4478,60,80,2717.39,4970.63,0.00
2024-12-10 17:37:55,141,4477,61,80,2705.61,4970.76,0.00
2024-12-10 17:37:55,141,4478,61,80,2771.69,4971.00,0.00
2024-12-10 17:37:55,142,4478,61,81,2752.18,4971.01,0.00
2024-12-10 17:37:55,141,4478,61,80,2758.08,4971.11,0.00
2024-12-10 17:37:55,142,4477,61,81,2724.75,4971.40,0.00
2024-12-10 17:37:55,143,4476,62,81,2690.74,4971.83,0.00
2024-12-10 17:37:55,144,4475,63,81,2676.56,4971.85,0.00
2024-12-10 17:37:55,144,4476,63,81,2776.82,4972.00,0.00
2024-12-10 17:37:55,145,4476,64,81,2757.67,4972.01,0.00
2024-12-10 17:37:55,144,4476,64,80,2767.36,4972.11,0.00
2024-12-10 17:37:55,144,4477,64,80,2846.72,4973.00,0.00
2024-12-10 17:37:55,145,4477,64,81,2827.09,4973.01,0.00
2024-12-10 17:37:55,144,4477,63,81,2836.86,4973.08,0.00
2024-12-10 17:37:55,143,4477,62,81,2853.50,4973.08,0.00
2024-12-10 17:37:56,142,4477,62,80,2870.44,4973.10,0.00
2024-12-10 17:37:56,141,4477,61,80,2876.30,4973.38,0.00
2024-12-10 17:37:56,141,4478,61,80,2879.78,4974.00,0.00
2024-12-10 17:37:56,142,4478,62,80,2859.50,4974.01,0.00
2024-12-10 17:37:56,141,4478,62,79,2856.09,4974.10,0.00
2024-12-10 17:37:56,141,4479,62,79,2844.99,4975.00,0.00
2024-12-10 17:37:56,142,4479,62,80,2824.95,4975.01,0.00
2024-12-10 17:37:56,141,4479,61,80,2838.21,4975.09,0.00
2024-12-10 17:37:56,140,4479,61,79,2853.87,4975.11,0.00
2024-12-10 17:37:56,140,4480,61,79,2828.65,4976.00,0.00
2024-12-10 17:37:56,141,4480,61,80,2808.59,4976.01,0.00
2024-12-10 17:37:56,140,4480,60,80,2821.91,4976.09,0.00
2024-12-10 17:37:56,139,4480,60,79,2837.92,4976.11,0.00
2024-12-10 17:37:56,139,4481,60,79,2811.35,4977.00,0.00
2024-12-10 17:37:56,140,4481,61,79,2791.27,4977.01,0.00
2024-12-10 17:37:56,139,4481,61,78,2800.00,4977.12,0.00
2024-12-10 17:37:56,138,4481,60,78,2793.98,4977.36,0.00
2024-12-10 17:37:56,138,4482,60,78,2794.49,4978.00,0.00
2024-12-10 17:37:56,139,4482,61,78,2774.39,4978.01,0.00
2024-12-10 17:37:56,140,4481,61,79,2754.57,4978.02,0.00
2024-12-10 17:37:56,139,4481,60,79,2775.62,4978.09,0.00
2024-12-10 17:37:56,138,4481,60,78,2790.70,4978.12,0.00
2024-12-10 17:37:56,139,4480,61,78,2765.98,4978.22,0.00
2024-12-10 17:37:56,138,4480,60,78,2783.94,4978.62,0.00
2024-12-10 17:37:56,138,4481,60,78,2797.03,4979.00,0.00
2024-12-10 17:37:56,139,4481,61,78,2776.91,4979.01,0.00
2024-12-10 17:37:56,138,4481,61,77,2773.97,4979.11,0.00
2024-12-10 17:37:56,138,4482,61,77,2834.23,4980.00,0.00
2024-12-10 17:37:56,139,4482,61,78,2813.84,4980.01,0.00
2024-12-10 17:37:56,138,4482,60,78,2831.37,4980.06,0.00
2024-12-10 17:37:56,137,4482,60,77,2846.23,4980.10,0.00
2024-12-10 17:37:56,137,4483,60,77,2820.65,4981.00,0.00
2024-12-10 17:37:56,138,4483,60,78,2800.21,4981.01,0.00
2024-12-10 17:37:56,137,4483,60,77,2812.32,4981.10,0.00
2024-12-10 17:37:56,136,4483,59,77,2818.45,4981.39,0.00
2024-12-10 17:37:56,137,4482,59,78,2790.32,4981.56,0.00
2024-12-10 17:37:56,137,4483,59,78,2801.42,4982.00,0.00
2024-12-10 17:37:56,138,4483,60,78,2781.12,4982.01,0.00
2024-12-10 17:37:56,137,4483,60,77,2797.44,4982.08,0.00
2024-12-10 17:37:56,136,4483,60,76,2812.53,4982.11,0.00
2024-12-10 17:37:56,135,4483,60,75,2828.19,4982.12,0.00
2024-12-10 17:37:56,136,4482,61,75,2799.04,4982.30,0.00
2024-12-10 17:37:56,135,4482,60,75,2823.38,4982.66,0.00
2024-12-10 17:37:56,135,4483,60,75,2865.06,4983.00,0.00
2024-12-10 17:37:56,136,4483,60,76,2843.99,4983.01,0.00
2024-12-10 17:37:56,135,4483,59,76,2861.03,4983.08,0.00
2024-12-10 17:37:56,134,4483,59,75,2876.06,4983.11,0.00
2024-12-10 17:37:56,135,4482,60,75,2816.95,4983.59,0.00
2024-12-10 17:37:56,135,4483,60,75,2881.54,4984.00,0.00
2024-12-10 17:37:56,136,4483,61,75,2860.35,4984.01,0.00
2024-12-10 17:37:56,137,4482,62,75,2837.67,4984.06,0.00
2024-12-10 17:37:56,138,4481,62,76,2805.04,4984.57,0.00
2024-12-10 17:37:56,138,4482,62,76,2858.05,4985.00,0.00
2024-12-10 17:37:56,139,4482,63,76,2837.49,4985.01,0.00
2024-12-10 17:37:56,140,4481,63,77,2817.23,4985.02,0.00
2024-12-10 17:37:56,140,4482,63,77,2856.13,4986.00,0.00
2024-12-10 17:37:56,141,4482,64,77,2835.87,4986.01,0.00
2024-12-10 17:37:56,140,4482,63,77,2812.83,4986.57,0.00
2024-12-10 17:37:56,140,4483,63,77,2861.06,4987.00,0.00
2024-12-10 17:37:56,141,4483,64,77,2840.77,4987.01,0.00
2024-12-10 17:37:56,140,4483,64,76,2855.39,4987.11,0.00
2024-12-10 17:37:56,139,4483,63,76,2841.80,4987.76,0.00
2024-12-10 17:37:56,139,4484,63,76,2849.98,4988.00,0.00
2024-12-10 17:37:56,140,4484,63,77,2829.62,4988.01,0.00
2024-12-10 17:37:56,139,4484,63,76,2841.40,4988.11,0.00
2024-12-10 17:37:56,138,4484,62,76,2828.18,4988.76,0.00
2024-12-10 17:37:56,138,4485,62,76,2836.67,4989.00,0.00
2024-12-10 17:37:56,139,4485,63,76,2816.26,4989.01,0.00
2024-12-10 17:37:56,138,4485,62,76,2834.87,4989.04,0.00
2024-12-10 17:37:56,137,4485,62,75,2848.67,4989.10,0.00
2024-12-10 17:37:56,138,4484,62,76,2823.72,4989.20,0.00
2024-12-10 17:37:56,138,4485,62,76,2832.84,4990.00,0.00
2024-12-10 17:37:56,139,4485,63,76,2812.46,4990.01,0.00
2024-12-10 17:37:56,138,4485,63,75,2824.55,4990.10,0.00
2024-12-10 17:37:56,137,4485,62,75,2830.71,4990.39,0.00
2024-12-10 17:37:56,136,4485,61,75,2850.80,4990.40,0.00
2024-12-10 17:37:56,136,4486,61,75,2875.99,4991.00,0.00
2024-12-10 17:37:56,137,4486,61,76,2854.99,4991.01,0.00
2024-12-10 17:37:56,136,4486,60,76,2868.15,4991.09,0.00
2024-12-10 17:37:56,137,4485,60,77,2820.78,4991.49,0.00
2024-12-10 17:37:56,137,4486,60,77,2843.63,4992.00,0.00
2024-12-10 17:37:56,138,4486,60,78,2823.02,4992.01,0.00
2024-12-10 17:37:56,139,4485,60,79,2793.93,4992.09,0.00
2024-12-10 17:37:56,139,4486,60,79,2832.89,4993.00,0.00
2024-12-10 17:37:56,140,4486,60,80,2812.66,4993.01,0.00
2024-12-10 17:37:56,139,4486,59,80,2825.01,4993.07,0.00
2024-12-10 17:37:56,138,4486,58,80,2844.76,4993.08,0.00
2024-12-10 17:37:56,139,4485,59,80,2799.64,4993.45,0.00
2024-12-10 17:37:56,139,4486,59,80,2856.13,4994.00,0.00
2024-12-10 17:37:56,140,4486,60,80,2835.73,4994.01,0.00
2024-12-10 17:37:56,139,4486,59,80,2853.99,4994.04,0.00
2024-12-10 17:37:56,140,4485,60,80,2803.54,4994.51,0.00
2024-12-10 17:37:56,140,4486,60,80,2847.66,4995.00,0.00
2024-12-10 17:37:56,141,4486,60,81,2827.47,4995.01,0.00
2024-12-10 17:37:56,142,4485,60,82,2807.21,4995.03,0.00
2024-12-10 17:37:56,141,4485,60,81,2854.07,4995.08,0.00
2024-12-10 17:37:56,142,4484,61,81,2809.22,4995.59,0.00
2024-12-10 17:37:56,142,4485,61,81,2854.26,4996.00,0.00
2024-12-10 17:37:56,143,4485,62,81,2834.30,4996.01,0.00
2024-12-10 17:37:56,143,4486,62,81,2875.83,4997.00,0.00
2024-12-10 17:37:57,144,4486,62,82,2855.86,4997.01,0.00
2024-12-10 17:37:57,144,4487,62,82,2823.44,4998.00,0.00
2024-12-10 17:37:57,145,4487,63,82,2803.96,4998.01,0.00
2024-12-10 17:37:57,146,4486,64,82,2768.74,4998.21,0.00
2024-12-10 17:37:57,146,4487,64,82,2776.85,4999.00,0.00
2024-12-10 17:37:57,147,4487,64,83,2757.96,4999.01,0.00
2024-12-10 17:37:57,146,4487,64,82,2772.09,4999.07,0.00
2024-12-10 17:37:57,145,4487,63,82,2760.92,4999.68,0.00
2024-12-10 17:37:57,145,4488,63,82,2800.13,5000.00,0.00
2024-12-10 17:37:57,146,4488,63,83,2780.95,5000.01,0.00
2024-12-10 17:37:57,145,4488,63,82,2796.03,5000.08,0.00
2024-12-10 17:37:57,145,4489,63,82,2771.03,5001.00,0.00
2024-12-10 17:37:57,146,4489,64,82,2752.05,5001.01,0.00
2024-12-10 17:37:57,145,4489,63,82,2770.01,5001.02,0.00
2024-12-10 17:37:57,144,4489,62,82,2787.86,5001.04,0.00
2024-12-10 17:37:57,143,4489,61,82,2806.32,5001.06,0.00
2024-12-10 17:37:57,144,4488,62,82,2743.92,5001.61,0.00
2024-12-10 17:37:57,144,4489,62,82,2772.00,5002.00,0.00
2024-12-10 17:37:57,145,4489,63,82,2752.88,5002.01,0.00
2024-12-10 17:37:57,144,4489,63,81,2769.25,5002.06,0.00
2024-12-10 17:37:57,143,4489,62,81,2779.93,5002.08,0.00
2024-12-10 17:37:57,143,4490,62,81,2789.47,5003.00,0.00
2024-12-10 17:37:57,144,4490,62,82,2770.10,5003.01,0.00
2024-12-10 17:37:57,143,4490,62,81,2785.31,5003.06,0.00
2024-12-10 17:37:57,143,4491,62,81,2757.17,5004.00,0.00
2024-12-10 17:37:57,144,4491,63,81,2738.02,5004.01,0.00
2024-12-10 17:37:57,143,4491,63,80,2753.35,5004.07,0.00
2024-12-10 17:37:57,142,4491,62,80,2761.50,5004.18,0.00
2024-12-10 17:37:57,142,4492,62,80,2752.93,5005.00,0.00
2024-12-10 17:37:57,143,4492,62,81,2733.68,5005.01,0.00
2024-12-10 17:37:57,142,4492,61,81,2749.79,5005.06,0.00
2024-12-10 17:37:57,143,4491,62,81,2661.55,5005.99,0.00
2024-12-10 17:37:57,143,4492,62,81,2710.57,5006.00,0.00
2024-12-10 17:37:57,144,4492,63,81,2691.75,5006.01,0.00
2024-12-10 17:37:57,143,4492,63,80,2706.05,5006.06,0.00
2024-12-10 17:37:57,144,4491,64,80,2687.26,5006.08,0.00
2024-12-10 17:37:57,143,4491,63,80,2696.70,5006.37,0.00
2024-12-10 17:37:57,142,4491,62,80,2707.29,5006.42,0.00
2024-12-10 17:37:57,142,4492,62,80,2747.49,5007.00,0.00
2024-12-10 17:37:57,143,4492,62,81,2728.28,5007.01,0.00
2024-12-10 17:37:57,143,4493,62,81,2737.66,5008.00,0.00
2024-12-10 17:37:57,144,4493,63,81,2718.65,5008.01,0.00
2024-12-10 17:37:57,143,4493,62,81,2727.19,5008.07,0.00
2024-12-10 17:37:57,143,4494,62,81,2711.40,5009.00,0.00
2024-12-10 17:37:57,144,4494,63,81,2692.57,5009.01,0.00
2024-12-10 17:37:57,143,4494,62,81,2700.92,5009.07,0.00
2024-12-10 17:37:57,142,4494,61,81,2697.69,5009.51,0.00
2024-12-10 17:37:57,141,4494,60,81,2706.05,5009.72,0.00
2024-12-10 17:37:57,141,4495,60,81,2721.76,5010.00,0.00
2024-12-10 17:37:57,142,4495,60,82,2702.59,5010.01,0.00
2024-12-10 17:37:57,142,4496,60,82,2670.26,5011.00,0.00
2024-12-10 17:37:57,143,4496,61,82,2651.59,5011.01,0.00
2024-12-10 17:37:57,142,4496,61,81,2661.82,5011.06,0.00
2024-12-10 17:37:57,141,4496,61,80,2680.35,5011.06,0.00
2024-12-10 17:37:57,140,4496,61,79,2685.15,5011.35,0.00
2024-12-10 17:37:57,140,4497,61,79,2674.14,5012.00,0.00
2024-12-10 17:37:57,141,4497,61,80,2655.18,5012.01,0.00
2024-12-10 17:37:57,140,4497,60,80,2657.72,5012.07,0.00
2024-12-10 17:37:57,139,4497,59,80,2662.15,5012.37,0.00
2024-12-10 17:37:57,140,4496,59,81,2641.71,5012.41,0.00
2024-12-10 17:37:57,140,4497,59,81,2661.88,5013.00,0.00
2024-12-10 17:37:57,141,4497,60,81,2643.00,5013.01,0.00
2024-12-10 17:37:57,142,4496,61,81,2592.38,5013.31,0.00
2024-12-10 17:37:57,143,4495,62,81,2575.69,5013.76,0.00
2024-12-10 17:37:57,143,4496,62,81,2642.14,5014.00,0.00
2024-12-10 17:37:57,144,4496,62,82,2623.80,5014.01,0.00
2024-12-10 17:37:57,143,4496,62,81,2633.05,5014.06,0.00
2024-12-10 17:37:57,144,4495,62,82,2597.13,5014.43,0.00
2024-12-10 17:37:57,144,4496,62,82,2676.75,5015.00,0.00
2024-12-10 17:37:57,145,4496,62,83,2658.29,5015.01,0.00
2024-12-10 17:37:57,144,4496,61,83,2673.99,5015.06,0.00
2024-12-10 17:37:57,143,4496,61,82,2684.28,5015.08,0.00
2024-12-10 17:37:57,143,4497,61,82,2696.49,5016.00,0.00
2024-12-10 17:37:57,144,4497,62,82,2677.76,5016.01,0.00
2024-12-10 17:37:57,143,4497,62,81,2688.09,5016.06,0.00
2024-12-10 17:37:57,142,4497,61,81,2706.74,5016.06,0.00
2024-12-10 17:37:57,141,4497,61,80,2725.24,5016.06,0.00
2024-12-10 17:37:57,140,4497,60,80,2729.49,5016.32,0.00
2024-12-10 17:37:57,140,4498,60,80,2729.88,5017.00,0.00
2024-12-10 17:37:57,141,4498,61,80,2710.52,5017.01,0.00
2024-12-10 17:37:57,140,4498,61,79,2719.16,5017.07,0.00
2024-12-10 17:37:57,141,4497,62,79,2673.40,5017.62,0.00
2024-12-10 17:37:57,141,4498,62,79,2696.75,5018.00,0.00
2024-12-10 17:37:57,142,4498,62,80,2677.76,5018.01,0.00
2024-12-10 17:37:57,141,4498,62,79,2686.10,5018.07,0.00
2024-12-10 17:37:57,140,4498,62,78,2704.93,5018.07,0.00
2024-12-10 17:37:57,140,4499,62,78,2722.31,5019.00,0.00
2024-12-10 17:37:57,141,4499,62,79,2703.00,5019.01,0.00
2024-12-10 17:37:57,141,4500,62,79,2668.64,5020.00,0.00
2024-12-10 17:37:57,142,4500,63,79,2649.85,5020.01,0.00
2024-12-10 17:37:57,141,4500,63,78,2659.40,5020.06,0.00
2024-12-10 17:37:57,140,4500,63,77,2677.68,5020.06,0.00
2024-12-10 17:37:57,140,4501,63,77,2649.44,5021.00,0.00
2024-12-10 17:37:57,141,4501,64,77,2630.65,5021.01,0.00
2024-12-10 17:37:57,140,4501,64,76,2642.29,5021.06,0.00
2024-12-10 17:37:57,141,4500,64,77,2603.40,5021.48,0.00
2024-12-10 17:37:58,141,4501,64,77,2612.65,5022.00,0.00
2024-12-10 17:37:58,142,4501,65,77,2594.25,5022.01,0.00
2024-12-10 17:37:58,141,4501,65,76,2609.47,5022.06,0.00
2024-12-10 17:37:58,140,4501,64,76,2600.28,5022.59,0.00
2024-12-10 17:37:58,140,4502,64,76,2637.52,5023.00,0.00
2024-12-10 17:37:58,141,4502,65,76,2618.81,5023.01,0.00
2024-12-10 17:37:58,140,4502,65,75,2634.31,5023.06,0.00
2024-12-10 17:37:58,141,4501,65,76,2606.77,5023.26,0.00
2024-12-10 17:37:58,141,4502,65,76,2617.55,5024.00,0.00
2024-12-10 17:37:58,142,4502,66,76,2599.12,5024.01,0.00
2024-12-10 17:37:58,141,4502,65,76,2615.79,5024.04,0.00
2024-12-10 17:37:58,140,4502,65,75,2633.04,5024.06,0.00
2024-12-10 17:37:58,140,4503,65,75,2643.59,5025.00,0.00
2024-12-10 17:37:58,141,4503,65,76,2624.85,5025.01,0.00
2024-12-10 17:37:58,140,4503,65,75,2640.39,5025.06,0.00
2024-12-10 17:37:58,140,4504,65,75,2615.40,5026.00,0.00
2024-12-10 17:37:58,141,4504,65,76,2596.85,5026.01,0.00
2024-12-10 17:37:58,140,4504,65,75,2612.19,5026.06,0.00
2024-12-10 17:37:58,139,4504,64,75,2629.20,5026.09,0.00
2024-12-10 17:37:58,138,4504,63,75,2622.56,5026.51,0.00
2024-12-10 17:37:58,138,4505,63,75,2634.55,5027.00,0.00
2024-12-10 17:37:58,139,4505,63,76,2615.59,5027.01,0.00
2024-12-10 17:37:58,138,4505,63,75,2631.29,5027.07,0.00
2024-12-10 17:37:58,138,4506,63,75,2606.65,5028.00,0.00
2024-12-10 17:37:58,139,4506,63,76,2587.90,5028.01,0.00
2024-12-10 17:37:58,138,4506,63,75,2603.39,5028.07,0.00
2024-12-10 17:37:58,137,4506,62,75,2594.31,5028.52,0.00
2024-12-10 17:37:58,137,4507,62,75,2607.11,5029.00,0.00
2024-12-10 17:37:58,138,4507,62,76,2588.22,5029.01,0.00
2024-12-10 17:37:58,137,4507,62,75,2603.83,5029.07,0.00
2024-12-10 17:37:58,136,4507,61,75,2622.61,5029.07,0.00
2024-12-10 17:37:58,136,4508,61,75,2598.01,5030.00,0.00
2024-12-10 17:37:58,137,4508,61,76,2579.05,5030.01,0.00
2024-12-10 17:37:58,138,4507,61,77,2500.24,5030.87,0.00
2024-12-10 17:37:58,138,4508,61,77,2535.71,5031.00,0.00
2024-12-10 17:37:58,139,4508,61,78,2517.47,5031.01,0.00
2024-12-10 17:37:58,138,4508,61,77,2525.52,5031.07,0.00
2024-12-10 17:37:58,137,4508,60,77,2524.04,5031.37,0.00
2024-12-10 17:37:58,136,4508,59,77,2541.49,5031.39,0.00
2024-12-10 17:37:58,135,4508,58,77,2559.95,5031.39,0.00
2024-12-10 17:37:58,135,4509,58,77,2603.59,5032.00,0.00
2024-12-10 17:37:58,136,4509,59,77,2584.45,5032.01,0.00
2024-12-10 17:37:58,135,4509,59,76,2598.76,5032.08,0.00
2024-12-10 17:37:58,134,4509,58,76,2593.09,5032.33,0.00
2024-12-10 17:37:58,133,4509,57,76,2609.58,5032.38,0.00
2024-12-10 17:37:58,134,4508,57,77,2586.38,5032.47,0.00
2024-12-10 17:37:58,133,4508,56,77,2590.99,5032.87,0.00
2024-12-10 17:37:58,133,4509,56,77,2622.13,5033.00,0.00
2024-12-10 17:37:58,134,4509,56,78,2602.56,5033.01,0.00
2024-12-10 17:37:58,133,4509,55,78,2618.74,5033.07,0.00
2024-12-10 17:37:58,132,4509,54,78,2638.20,5033.07,0.00
2024-12-10 17:37:58,131,4509,54,77,2657.19,5033.07,0.00
2024-12-10 17:37:58,131,4510,54,77,2672.15,5034.00,0.00
2024-12-10 17:37:58,132,4510,55,77,2651.91,5034.01,0.00
2024-12-10 17:37:58,131,4510,55,76,2668.33,5034.07,0.00
2024-12-10 17:37:58,130,4510,54,76,2652.79,5034.79,0.00
2024-12-10 17:37:58,130,4511,54,76,2665.74,5035.00,0.00
2024-12-10 17:37:58,131,4511,55,76,2645.39,5035.01,0.00
2024-12-10 17:37:58,132,4510,56,76,2624.60,5035.04,0.00
2024-12-10 17:37:58,131,4510,56,75,2669.63,5035.08,0.00
2024-12-10 17:37:58,130,4510,55,75,2681.70,5035.14,0.00
2024-12-10 17:37:58,130,4511,55,75,2677.53,5036.00,0.00
2024-12-10 17:37:58,131,4511,55,76,2657.10,5036.01,0.00
2024-12-10 17:37:58,130,4511,55,75,2673.69,5036.07,0.00
2024-12-10 17:37:58,131,4510,56,75,2617.64,5036.78,0.00
2024-12-10 17:37:58,131,4511,56,75,2676.64,5037.00,0.00
2024-12-10 17:37:58,132,4511,56,76,2656.36,5037.01,0.00
2024-12-10 17:37:58,133,4510,57,76,2592.14,5037.50,0.00
2024-12-10 17:37:58,133,4511,57,76,2651.94,5038.00,0.00
2024-12-10 17:37:58,134,4511,57,77,2632.15,5038.01,0.00
2024-12-10 17:37:58,133,4511,57,76,2643.11,5038.07,0.00
2024-12-10 17:37:58,132,4511,56,76,2639.60,5038.27,0.00
2024-12-10 17:37:58,131,4511,55,76,2654.79,5038.36,0.00
2024-12-10 17:37:58,131,4512,55,76,2697.83,5039.00,0.00
2024-12-10 17:37:58,132,4512,56,76,2677.39,5039.01,0.00
2024-12-10 17:37:58,133,4511,56,77,2656.14,5039.05,0.00
2024-12-10 17:37:58,134,4510,56,78,2642.01,5039.20,0.00
2024-12-10 17:37:58,134,4511,56,78,2654.35,5040.00,0.00
2024-12-10 17:37:58,135,4511,57,78,2634.69,5040.01,0.00
2024-12-10 17:37:58,135,4511,57,78,2674.38,5041.00,0.00
2024-12-10 17:37:58,136,4511,58,78,2654.72,5041.01,0.00
2024-12-10 17:37:58,135,4511,58,77,2666.56,5041.07,0.00
2024-12-10 17:37:58,134,4511,57,77,2663.80,5041.51,0.00
2024-12-10 17:37:58,134,4512,57,77,2675.01,5042.00,0.00
2024-12-10 17:37:58,135,4512,58,77,2655.19,5042.01,0.00
2024-12-10 17:37:58,134,4512,57,77,2648.43,5042.38,0.00
2024-12-10 17:37:58,134,4513,57,77,2649.45,5043.00,0.00
2024-12-10 17:37:58,135,4513,58,77,2629.82,5043.01,0.00
2024-12-10 17:37:58,135,4514,58,77,2601.40,5044.00,0.00
2024-12-10 17:37:58,136,4514,58,78,2582.27,5044.01,0.00
2024-12-10 17:37:58,135,4514,58,77,2590.21,5044.07,0.00
2024-12-10 17:37:58,134,4514,57,77,2573.72,5044.79,0.00
2024-12-10 17:37:58,133,4514,56,77,2592.32,5044.81,0.00
2024-12-10 17:37:58,133,4515,56,77,2606.35,5045.00,0.00
2024-12-10 17:37:58,134,4515,57,77,2586.90,5045.01,0.00
2024-12-10 17:37:58,133,4515,57,76,2599.92,5045.07,0.00
2024-12-10 17:37:59,133,4516,57,76,2574.75,5046.00,0.00
2024-12-10 17:37:59,134,4516,58,76,2555.54,5046.01,0.00
2024-12-10 17:37:59,133,4516,57,76,2563.40,5046.08,0.00
2024-12-10 17:37:59,133,4517,57,76,2544.17,5047.00,0.00
2024-12-10 17:37:59,134,4517,58,76,2525.19,5047.01,0.00
2024-12-10 17:37:59,133,4517,57,76,2542.23,5047.05,0.00
2024-12-10 17:37:59,132,4517,56,76,2535.74,5047.39,0.00
2024-12-10 17:37:59,133,4516,56,77,2490.80,5047.93,0.00
2024-12-10 17:37:59,133,4517,56,77,2525.03,5048.00,0.00
2024-12-10 17:37:59,134,4517,57,77,2506.18,5048.01,0.00
2024-12-10 17:37:59,133,4517,57,76,2520.87,5048.06,0.00
2024-12-10 17:37:59,133,4518,57,76,2530.20,5049.00,0.00
2024-12-10 17:37:59,134,4518,58,76,2511.32,5049.01,0.00
2024-12-10 17:37:59,134,4519,58,76,2478.49,5050.00,0.00
2024-12-10 17:37:59,135,4519,59,76,2460.13,5050.01,0.00
2024-12-10 17:37:59,134,4519,59,75,2470.22,5050.06,0.00
2024-12-10 17:37:59,133,4519,59,74,2487.67,5050.08,0.00
2024-12-10 17:37:59,132,4519,58,74,2489.45,5050.39,0.00
2024-12-10 17:37:59,132,4520,58,74,2481.10,5051.00,0.00
2024-12-10 17:37:59,133,4520,58,75,2462.45,5051.01,0.00
2024-12-10 17:37:59,133,4521,58,75,2437.49,5052.00,0.00
2024-12-10 17:37:59,134,4521,59,75,2419.30,5052.01,0.00
2024-12-10 17:37:59,134,4522,59,75,2391.61,5053.00,0.00
2024-12-10 17:37:59,135,4522,59,76,2373.89,5053.01,0.00
2024-12-10 17:37:59,134,4522,58,76,2389.74,5053.04,0.00
2024-12-10 17:37:59,133,4522,57,76,2383.59,5053.35,0.00
2024-12-10 17:37:59,134,4521,58,76,2353.46,5053.60,0.00
2024-12-10 17:37:59,134,4522,58,76,2374.36,5054.00,0.00
2024-12-10 17:37:59,135,4522,58,77,2356.77,5054.01,0.00
2024-12-10 17:37:59,134,4522,58,76,2368.34,5054.05,0.00
2024-12-10 17:37:59,133,4522,58,75,2384.63,5054.08,0.00
2024-12-10 17:37:59,133,4523,58,75,2395.48,5055.00,0.00
2024-12-10 17:37:59,134,4523,59,75,2377.61,5055.01,0.00
2024-12-10 17:37:59,133,4523,58,75,2367.85,5055.41,0.00
2024-12-10 17:37:59,132,4523,57,75,2377.10,5055.46,0.00
2024-12-10 17:37:59,132,4524,57,75,2382.45,5056.00,0.00
2024-12-10 17:37:59,133,4524,58,75,2364.54,5056.01,0.00
2024-12-10 17:37:59,132,4524,58,74,2372.89,5056.05,0.00
2024-12-10 17:37:59,131,4524,58,73,2389.47,5056.08,0.00
2024-12-10 17:37:59,131,4525,58,73,2359.40,5057.00,0.00
2024-12-10 17:37:59,132,4525,58,74,2341.53,5057.01,0.00
2024-12-10 17:37:59,131,4525,58,73,2356.33,5057.05,0.00
2024-12-10 17:37:59,130,4525,57,73,2373.30,5057.07,0.00
2024-12-10 17:37:59,129,4525,56,73,2361.26,5057.56,0.00
2024-12-10 17:37:59,129,4526,56,73,2369.97,5058.00,0.00
2024-12-10 17:37:59,130,4526,56,74,2351.74,5058.01,0.00
2024-12-10 17:37:59,131,4525,57,74,2333.41,5058.03,0.00
2024-12-10 17:37:59,130,4525,57,73,2371.61,5058.06,0.00
2024-12-10 17:37:59,129,4525,57,72,2388.83,5058.08,0.00
2024-12-10 17:37:59,130,4524,57,73,2353.42,5058.43,0.00
2024-12-10 17:37:59,130,4525,57,73,2363.29,5059.00,0.00
2024-12-10 17:37:59,131,4525,58,73,2345.25,5059.01,0.00
2024-12-10 17:37:59,130,4525,57,73,2335.00,5059.42,0.00
2024-12-10 17:37:59,129,4525,57,72,2329.70,5059.80,0.00
2024-12-10 17:37:59,130,4524,57,73,2298.72,5059.93,0.00
2024-12-10 17:37:59,130,4525,57,73,2442.01,5060.00,0.00
2024-12-10 17:37:59,131,4525,57,74,2423.37,5060.01,0.00
2024-12-10 17:37:59,130,4525,57,73,2429.98,5060.08,0.00
2024-12-10 17:37:59,129,4525,57,72,2448.42,5060.09,0.00
2024-12-10 17:37:59,129,4526,57,72,2467.06,5061.00,0.00
2024-12-10 17:37:59,130,4526,57,73,2448.08,5061.01,0.00
2024-12-10 17:37:59,129,4526,57,72,2460.02,5061.05,0.00
2024-12-10 17:37:59,128,4526,56,72,2477.67,5061.08,0.00
2024-12-10 17:37:59,129,4525,56,73,2443.62,5061.39,0.00
2024-12-10 17:37:59,128,4525,55,73,2496.74,5061.42,0.00
2024-12-10 17:37:59,128,4526,55,73,2489.29,5062.00,0.00
2024-12-10 17:37:59,129,4526,55,74,2469.99,5062.01,0.00
2024-12-10 17:37:59,128,4526,55,73,2487.33,5062.04,0.00
2024-12-10 17:37:59,127,4526,55,72,2485.12,5062.07,0.00
2024-12-10 17:37:59,126,4526,55,71,2504.44,5062.07,0.00
2024-12-10 17:37:59,126,4527,55,71,2536.99,5063.00,0.00
2024-12-10 17:37:59,127,4527,56,71,2517.01,5063.01,0.00
2024-12-10 17:37:59,126,4527,56,70,2513.30,5063.06,0.00
2024-12-10 17:37:59,125,4527,56,69,2532.60,5063.06,0.00
2024-12-10 17:37:59,124,4527,56,68,2552.62,5063.06,0.00
2024-12-10 17:37:59,125,4526,57,68,2529.77,5063.13,0.00
2024-12-10 17:37:59,125,4527,57,68,2542.81,5064.00,0.00
2024-12-10 17:37:59,126,4527,57,69,2522.63,5064.01,0.00
2024-12-10 17:37:59,127,4526,58,69,2459.59,5064.73,0.00
2024-12-10 17:37:59,127,4527,58,69,2539.41,5065.00,0.00
2024-12-10 17:37:59,128,4527,59,69,2519.57,5065.01,0.00
2024-12-10 17:37:59,127,4527,58,69,2537.44,5065.04,0.00
2024-12-10 17:37:59,126,4527,57,69,2548.33,5065.06,0.00
2024-12-10 17:37:59,125,4527,56,69,2553.00,5065.36,0.00
2024-12-10 17:37:59,125,4528,56,69,2588.40,5066.00,0.00
2024-12-10 17:37:59,126,4528,56,70,2567.86,5066.01,0.00
2024-12-10 17:37:59,125,4528,56,69,2582.75,5066.05,0.00
2024-12-10 17:37:59,124,4528,56,68,2603.17,5066.05,0.00
2024-12-10 17:37:59,123,4528,55,68,2591.68,5066.67,0.00
2024-12-10 17:37:59,123,4529,55,68,2599.76,5067.00,0.00
2024-12-10 17:37:59,124,4529,55,69,2578.79,5067.01,0.00
2024-12-10 17:37:59,123,4529,55,68,2596.48,5067.05,0.00
2024-12-10 17:37:59,124,4528,56,68,2557.25,5067.43,0.00
2024-12-10 17:37:59,124,4529,56,68,2557.42,5068.00,0.00
2024-12-10 17:37:59,125,4529,56,69,2536.96,5068.01,0.00
2024-12-10 17:37:59,124,4529,56,68,2554.58,5068.05,0.00
2024-12-10 17:37:59,125,4528,57,68,2526.47,5068.22,0.00
2024-12-10 17:37:59,125,4529,57,68,2564.16,5069.00,0.00
2024-12-10 17:37:59,126,4529,58,68,2543.81,5069.01,0.00
2024-12-10 17:37:59,125,4529,58,67,2560.53,5069.06,0.00
2024-12-10 17:37:59,124,4529,57,67,2555.69,5069.38,0.00
2024-12-10 17:37:59,123,4529,56,67,2558.41,5069.74,0.00
2024-12-10 17:37:59,123,4530,56,67,2627.42,5070.00,0.00
2024-12-10 17:37:59,124,4530,57,67,2606.23,5070.01,0.00
2024-12-10 17:38:00,123,4530,56,67,2625.67,5070.04,0.00
2024-12-10 17:38:00,122,4530,55,67,2646.77,5070.04,0.00
2024-12-10 17:38:00,122,4531,55,67,2626.86,5071.00,0.00
2024-12-10 17:38:00,123,4531,55,68,2605.50,5071.01,0.00
2024-12-10 17:38:00,123,4532,55,68,2581.06,5072.00,0.00
2024-12-10 17:38:00,124,4532,55,69,2560.24,5072.01,0.00
2024-12-10 17:38:00,123,4532,54,69,2565.84,5072.14,0.00
2024-12-10 17:38:00,122,4532,53,69,2544.52,5072.90,0.00
2024-12-10 17:38:00,122,4533,53,69,2573.28,5073.00,0.00
2024-12-10 17:38:00,123,4533,53,70,2552.36,5073.01,0.00
2024-12-10 17:38:00,122,4533,53,69,2562.49,5073.05,0.00
2024-12-10 17:38:00,122,4534,53,69,2537.25,5074.00,0.00
2024-12-10 17:38:00,123,4534,54,69,2516.62,5074.01,0.00
2024-12-10 17:38:00,122,4534,54,68,2531.44,5074.04,0.00
2024-12-10 17:38:00,121,4534,53,68,2551.94,5074.04,0.00
2024-12-10 17:38:00,122,4533,53,69,2520.26,5074.27,0.00
2024-12-10 17:38:00,121,4533,52,69,2516.45,5074.98,0.00
2024-12-10 17:38:00,121,4534,52,69,2557.15,5075.00,0.00
2024-12-10 17:38:00,122,4534,52,70,2536.19,5075.01,0.00
2024-12-10 17:38:00,121,4534,52,69,2555.07,5075.04,0.00
2024-12-10 17:38:00,120,4534,51,69,2564.11,5075.15,0.00
2024-12-10 17:38:00,119,4534,50,69,2563.45,5075.58,0.00
2024-12-10 17:38:00,119,4535,50,69,2621.67,5076.00,0.00
2024-12-10 17:38:00,120,4535,50,70,2599.82,5076.01,0.00
2024-12-10 17:38:00,119,4535,50,69,2619.55,5076.04,0.00
2024-12-10 17:38:00,118,4535,50,68,2640.03,5076.05,0.00
2024-12-10 17:38:00,117,4535,49,68,2617.53,5076.66,0.00
2024-12-10 17:38:00,116,4535,49,67,2633.90,5076.69,0.00
2024-12-10 17:38:00,116,4536,49,67,2660.48,5077.00,0.00
2024-12-10 17:38:00,117,4536,49,68,2637.74,5077.01,0.00
2024-12-10 17:38:00,116,4536,48,68,2658.31,5077.04,0.00
2024-12-10 17:38:00,115,4536,48,67,2679.22,5077.05,0.00
2024-12-10 17:38:00,116,4535,49,67,2646.98,5077.25,0.00
2024-12-10 17:38:00,115,4535,48,67,2699.66,5077.31,0.00
2024-12-10 17:38:00,114,4535,47,67,2718.93,5077.40,0.00
2024-12-10 17:38:00,114,4536,47,67,2712.82,5078.00,0.00
2024-12-10 17:38:00,115,4536,47,68,2689.23,5078.01,0.00
2024-12-10 17:38:00,114,4536,46,68,2710.61,5078.04,0.00
2024-12-10 17:38:00,113,4536,46,67,2731.00,5078.06,0.00
2024-12-10 17:38:00,114,4535,46,68,2700.83,5078.20,0.00
2024-12-10 17:38:00,115,4534,47,68,2667.62,5078.53,0.00
2024-12-10 17:38:00,114,4534,46,68,2696.87,5078.61,0.00
2024-12-10 17:38:00,114,4535,46,68,2764.38,5079.00,0.00
2024-12-10 17:38:00,115,4535,46,69,2740.34,5079.01,0.00
2024-12-10 17:38:00,116,4534,46,70,2698.81,5079.21,0.00
2024-12-10 17:38:00,116,4535,46,70,2787.59,5080.00,0.00
2024-12-10 17:38:00,117,4535,46,71,2763.76,5080.01,0.00
2024-12-10 17:38:00,117,4536,46,71,2775.12,5081.00,0.00
2024-12-10 17:38:00,118,4536,46,72,2751.60,5081.01,0.00
2024-12-10 17:38:00,119,4535,47,72,2728.06,5081.03,0.00
2024-12-10 17:38:00,118,4535,47,71,2759.37,5081.05,0.00
2024-12-10 17:38:00,117,4535,47,70,2777.75,5081.05,0.00
2024-12-10 17:38:00,118,4534,48,70,2737.99,5081.34,0.00
2024-12-10 17:38:00,118,4535,48,70,2751.89,5082.00,0.00
2024-12-10 17:38:00,119,4535,49,70,2728.77,5082.01,0.00
2024-12-10 17:38:00,118,4535,49,69,2748.90,5082.04,0.00
2024-12-10 17:38:00,117,4535,48,69,2742.75,5082.56,0.00
2024-12-10 17:38:00,116,4535,47,69,2752.39,5082.60,0.00
2024-12-10 17:38:00,116,4536,47,69,2863.34,5083.00,0.00
2024-12-10 17:38:00,117,4536,47,70,2838.87,5083.01,0.00
2024-12-10 17:38:00,116,4536,47,69,2860.30,5083.04,0.00
2024-12-10 17:38:00,116,4537,47,69,2833.99,5084.00,0.00
2024-12-10 17:38:00,117,4537,48,69,2809.77,5084.01,0.00
2024-12-10 17:38:00,116,4537,48,68,2812.09,5084.05,0.00
2024-12-10 17:38:00,115,4537,48,67,2825.61,5084.25,0.00
2024-12-10 17:38:00,115,4538,48,67,2830.86,5085.00,0.00
2024-12-10 17:38:00,116,4538,48,68,2806.45,5085.01,0.00
2024-12-10 17:38:00,115,4538,47,68,2830.41,5085.01,0.00
2024-12-10 17:38:00,116,4537,48,68,2780.70,5085.35,0.00
2024-12-10 17:38:00,115,4537,47,68,2801.50,5085.92,0.00
2024-12-10 17:38:00,115,4538,47,68,2837.22,5086.00,0.00
2024-12-10 17:38:00,116,4538,48,68,2812.76,5086.01,0.00
2024-12-10 17:38:00,117,4537,48,69,2777.87,5086.07,0.00
2024-12-10 17:38:00,116,4537,47,69,2835.59,5086.13,0.00
2024-12-10 17:38:00,116,4538,47,69,2875.72,5087.00,0.00
2024-12-10 17:38:00,117,4538,48,69,2851.14,5087.01,0.00
2024-12-10 17:38:00,116,4538,47,69,2873.98,5087.04,0.00
2024-12-10 17:38:00,116,4539,47,69,2888.66,5088.00,0.00
2024-12-10 17:38:00,117,4539,47,70,2863.97,5088.01,0.00
2024-12-10 17:38:01,116,4539,47,69,2878.14,5088.04,0.00
2024-12-10 17:38:01,115,4539,46,69,2895.08,5088.19,0.00
2024-12-10 17:38:01,115,4540,46,69,2878.78,5089.00,0.00
2024-12-10 17:38:01,116,4540,46,70,2853.96,5089.01,0.00
2024-12-10 17:38:01,115,4540,46,69,2875.70,5089.04,0.00
2024-12-10 17:38:01,115,4541,46,69,2852.17,5090.00,0.00
2024-12-10 17:38:01,116,4541,47,69,2827.58,5090.01,0.00
2024-12-10 17:38:01,115,4541,47,68,2849.09,5090.04,0.00
2024-12-10 17:38:01,114,4541,46,68,2844.29,5090.63,0.00
2024-12-10 17:38:01,114,4542,46,68,2851.00,5091.00,0.00
2024-12-10 17:38:01,115,4542,47,68,2826.21,5091.01,0.00
2024-12-10 17:38:01,116,4541,47,69,2801.84,5091.03,0.00
2024-12-10 17:38:01,115,4541,47,68,2828.00,5091.05,0.00
2024-12-10 17:38:01,115,4542,47,68,2804.75,5092.00,0.00
2024-12-10 17:38:01,116,4542,47,69,2780.57,5092.01,0.00
2024-12-10 17:38:01,115,4542,47,68,2782.18,5092.07,0.00
2024-12-10 17:38:01,115,4543,47,68,2818.15,5093.00,0.00
2024-12-10 17:38:01,116,4543,48,68,2793.86,5093.01,0.00
2024-12-10 17:38:01,115,4543,48,67,2815.95,5093.04,0.00
2024-12-10 17:38:01,116,4542,49,67,2773.30,5093.25,0.00
2024-12-10 17:38:01,115,4542,48,67,2826.44,5093.37,0.00
2024-12-10 17:38:01,115,4543,48,67,2827.05,5094.00,0.00
2024-12-10 17:38:01,116,4543,48,68,2802.67,5094.01,0.00
2024-12-10 17:38:01,115,4543,47,68,2824.85,5094.04,0.00
2024-12-10 17:38:01,115,4544,47,68,2841.99,5095.00,0.00
2024-12-10 17:38:01,116,4544,48,68,2817.49,5095.01,0.00
2024-12-10 17:38:01,115,4544,48,67,2839.79,5095.04,0.00
2024-12-10 17:38:01,116,4543,48,68,2733.03,5095.99,0.00
2024-12-10 17:38:01,116,4544,48,68,2776.97,5096.00,0.00
2024-12-10 17:38:01,117,4544,48,69,2753.23,5096.01,0.00
2024-12-10 17:38:01,117,4545,48,69,2762.56,5097.00,0.00
2024-12-10 17:38:01,118,4545,49,69,2739.15,5097.01,0.00
2024-12-10 17:38:01,118,4546,49,69,2707.21,5098.00,0.00
2024-12-10 17:38:01,119,4546,50,69,2684.46,5098.01,0.00
2024-12-10 17:38:01,119,4547,50,69,2649.68,5099.00,0.00
2024-12-10 17:38:01,120,4547,51,69,2627.59,5099.01,0.00
2024-12-10 17:38:01,119,4547,50,69,2648.40,5099.03,0.00
2024-12-10 17:38:01,118,4547,49,69,2658.44,5099.03,0.00
2024-12-10 17:38:01,117,4547,49,68,2672.01,5099.03,0.00
2024-12-10 17:38:01,116,4547,48,68,2666.78,5099.53,0.00
2024-12-10 17:38:01,117,4546,48,69,2631.29,5099.76,0.00
2024-12-10 17:38:01,117,4547,48,69,2671.59,5100.00,0.00
2024-12-10 17:38:01,118,4547,49,69,2648.95,5100.01,0.00
2024-12-10 17:38:01,117,4547,49,68,2663.76,5100.03,0.00
2024-12-10 17:38:01,116,4547,49,67,2686.28,5100.04,0.00
2024-12-10 17:38:01,115,4547,48,67,2707.14,5100.08,0.00
2024-12-10 17:38:01,115,4548,48,67,2729.57,5101.00,0.00
2024-12-10 17:38:01,116,4548,49,67,2706.04,5101.01,0.00
2024-12-10 17:38:01,115,4548,49,66,2708.74,5101.04,0.00
2024-12-10 17:38:01,116,4547,49,67,2681.45,5101.14,0.00
2024-12-10 17:38:01,116,4548,49,67,2684.44,5102.00,0.00
2024-12-10 17:38:01,117,4548,50,67,2661.49,5102.01,0.00
2024-12-10 17:38:01,116,4548,50,66,2680.50,5102.05,0.00
2024-12-10 17:38:01,115,4548,49,66,2671.64,5102.57,0.00
2024-12-10 17:38:01,115,4549,49,66,2720.24,5103.00,0.00
2024-12-10 17:38:01,116,4549,49,67,2696.79,5103.01,0.00
2024-12-10 17:38:01,115,4549,48,67,2717.59,5103.04,0.00
2024-12-10 17:38:01,114,4549,48,66,2738.75,5103.05,0.00
2024-12-10 17:38:01,115,4548,48,67,2682.22,5103.71,0.00
2024-12-10 17:38:01,115,4549,48,67,2721.88,5104.00,0.00
2024-12-10 17:38:01,116,4549,49,67,2698.41,5104.01,0.00
2024-12-10 17:38:01,116,4550,49,67,2717.79,5105.00,0.00
2024-12-10 17:38:01,117,4550,49,68,2694.56,5105.01,0.00
2024-12-10 17:38:01,116,4550,48,68,2715.61,5105.04,0.00
2024-12-10 17:38:01,117,4549,49,68,2678.46,5105.16,0.00
2024-12-10 17:38:01,116,4549,48,68,2699.86,5105.35,0.00
2024-12-10 17:38:01,115,4549,47,68,2697.58,5105.53,0.00
2024-12-10 17:38:01,115,4550,47,68,2718.36,5106.00,0.00
2024-12-10 17:38:01,116,4550,47,69,2694.93,5106.01,0.00
2024-12-10 17:38:01,115,4550,46,69,2686.53,5106.40,0.00
2024-12-10 17:38:01,114,4550,45,69,2687.62,5106.84,0.00
2024-12-10 17:38:01,114,4551,45,69,2769.29,5107.00,0.00
2024-12-10 17:38:01,115,4551,45,70,2745.21,5107.01,0.00
2024-12-10 17:38:01,114,4551,45,69,2767.07,5107.04,0.00
2024-12-10 17:38:01,113,4551,44,69,2775.82,5107.35,0.00
2024-12-10 17:38:01,113,4552,44,69,2769.50,5108.00,0.00
2024-12-10 17:38:01,114,4552,45,69,2745.20,5108.01,0.00
2024-12-10 17:38:01,113,4552,45,68,2765.44,5108.04,0.00
2024-12-10 17:38:01,112,4552,45,67,2765.91,5108.47,0.00
2024-12-10 17:38:01,112,4553,45,67,2765.51,5109.00,0.00
2024-12-10 17:38:01,113,4553,45,68,2741.03,5109.01,0.00
2024-12-10 17:38:01,112,4553,45,67,2760.05,5109.06,0.00
2024-12-10 17:38:01,112,4554,45,67,2733.98,5110.00,0.00
2024-12-10 17:38:01,113,4554,46,67,2709.79,5110.01,0.00
2024-12-10 17:38:01,112,4554,46,66,2698.34,5110.47,0.00
2024-12-10 17:38:01,113,4553,46,67,2650.70,5110.85,0.00
2024-12-10 17:38:01,113,4554,46,67,2694.25,5111.00,0.00
2024-12-10 17:38:01,114,4554,46,68,2670.62,5111.01,0.00
2024-12-10 17:38:01,113,4554,45,68,2678.78,5111.11,0.00
2024-12-10 17:38:01,113,4555,45,68,2717.16,5112.00,0.00
2024-12-10 17:38:01,114,4555,46,68,2693.33,5112.01,0.00
2024-12-10 17:38:01,113,4555,45,68,2717.16,5112.01,0.00
2024-12-10 17:38:01,113,4556,45,68,2691.92,5113.00,0.00
2024-12-10 17:38:01,114,4556,45,69,2668.30,5113.01,0.00
2024-12-10 17:38:01,113,4556,44,69,2689.67,5113.04,0.00
2024-12-10 17:38:02,113,4557,44,69,2658.75,5114.00,0.00
2024-12-10 17:38:02,114,4557,45,69,2635.42,5114.01,0.00
2024-12-10 17:38:02,113,4557,45,68,2653.33,5114.04,0.00
2024-12-10 17:38:02,113,4558,45,68,2629.27,5115.00,0.00
2024-12-10 17:38:02,114,4558,45,69,2606.20,5115.01,0.00
2024-12-10 17:38:02,113,4558,45,68,2627.02,5115.04,0.00
2024-12-10 17:38:02,112,4558,45,67,2648.19,5115.05,0.00
2024-12-10 17:38:02,111,4558,44,67,2656.90,5115.33,0.00
2024-12-10 17:38:02,110,4558,43,67,2677.10,5115.41,0.00
2024-12-10 17:38:02,110,4559,43,67,2687.00,5116.00,0.00
2024-12-10 17:38:02,111,4559,43,68,2662.79,5116.01,0.00
2024-12-10 17:38:02,110,4559,42,68,2675.39,5116.05,0.00
2024-12-10 17:38:02,111,4558,43,68,2642.57,5116.23,0.00
2024-12-10 17:38:02,111,4559,43,68,2675.12,5117.00,0.00
2024-12-10 17:38:02,112,4559,44,68,2651.24,5117.01,0.00
2024-12-10 17:38:02,111,4559,43,68,2626.43,5117.60,0.00
2024-12-10 17:38:02,110,4559,42,68,2648.04,5117.65,0.00
2024-12-10 17:38:02,110,4560,42,68,2723.21,5118.00,0.00
2024-12-10 17:38:02,111,4560,42,69,2698.68,5118.01,0.00
2024-12-10 17:38:02,112,4559,42,70,2639.89,5118.48,0.00
2024-12-10 17:38:02,112,4560,42,70,2661.30,5119.00,0.00
2024-12-10 17:38:02,113,4560,42,71,2637.75,5119.01,0.00
2024-12-10 17:38:02,112,4560,42,70,2657.19,5119.02,0.00
2024-12-10 17:38:02,113,4559,43,70,2618.35,5119.34,0.00
2024-12-10 17:38:02,112,4559,42,70,2663.57,5119.41,0.00
2024-12-10 17:38:02,112,4560,42,70,2705.46,5120.00,0.00
2024-12-10 17:38:02,113,4560,43,70,2681.51,5120.01,0.00
2024-12-10 17:38:02,113,4561,43,70,2704.78,5121.00,0.00
2024-12-10 17:38:02,114,4561,44,70,2681.06,5121.01,0.00
2024-12-10 17:38:02,113,4561,43,70,2693.46,5121.04,0.00
2024-12-10 17:38:02,114,4560,43,71,2658.21,5121.29,0.00
2024-12-10 17:38:02,115,4559,44,71,2654.76,5121.45,0.00
2024-12-10 17:38:02,115,4560,44,71,2658.53,5122.00,0.00
2024-12-10 17:38:02,116,4560,45,71,2635.62,5122.01,0.00
2024-12-10 17:38:02,115,4560,44,71,2646.97,5122.05,0.00
2024-12-10 17:38:02,115,4561,44,71,2711.73,5123.00,0.00
2024-12-10 17:38:02,116,4561,45,71,2688.35,5123.01,0.00
2024-12-10 17:38:02,115,4561,45,70,2707.90,5123.04,0.00
2024-12-10 17:38:02,114,4561,45,69,2730.76,5123.04,0.00
2024-12-10 17:38:02,114,4562,45,69,2702.80,5124.00,0.00
2024-12-10 17:38:02,115,4562,46,69,2679.30,5124.01,0.00
2024-12-10 17:38:02,114,4562,45,69,2672.99,5124.41,0.00
2024-12-10 17:38:02,114,4563,45,69,2680.66,5125.00,0.00
2024-12-10 17:38:02,115,4563,46,69,2657.35,5125.01,0.00
2024-12-10 17:38:02,114,4563,46,68,2669.43,5125.04,0.00
2024-12-10 17:38:02,114,4564,46,68,2658.93,5126.00,0.00
2024-12-10 17:38:02,115,4564,47,68,2635.81,5126.01,0.00
2024-12-10 17:38:02,114,4564,47,67,2647.70,5126.04,0.00
2024-12-10 17:38:02,113,4564,46,67,2663.88,5126.19,0.00
2024-12-10 17:38:02,113,4565,46,67,2654.89,5127.00,0.00
2024-12-10 17:38:02,114,4565,47,67,2631.60,5127.01,0.00
2024-12-10 17:38:02,113,4565,47,66,2644.91,5127.04,0.00
2024-12-10 17:38:02,112,4565,47,65,2668.07,5127.04,0.00
2024-12-10 17:38:02,113,4564,48,65,2637.22,5127.20,0.00
2024-12-10 17:38:02,114,4563,48,66,2623.62,5127.66,0.00
2024-12-10 17:38:02,114,4564,48,66,2646.36,5128.00,0.00
2024-12-10 17:38:02,115,4564,48,67,2623.35,5128.01,0.00
2024-12-10 17:38:02,114,4564,47,67,2641.42,5128.03,0.00
2024-12-10 17:38:02,113,4564,47,66,2664.34,5128.03,0.00
2024-12-10 17:38:02,112,4564,47,65,2687.22,5128.03,0.00
2024-12-10 17:38:02,112,4565,47,65,2774.49,5129.00,0.00
2024-12-10 17:38:02,113,4565,47,66,2749.94,5129.01,0.00
2024-12-10 17:38:02,112,4565,47,65,2772.66,5129.03,0.00
2024-12-10 17:38:02,111,4565,46,65,2764.46,5129.31,0.00
2024-12-10 17:38:02,112,4564,46,66,2719.80,5129.70,0.00
2024-12-10 17:38:02,112,4565,46,66,2761.71,5130.00,0.00
2024-12-10 17:38:02,113,4565,47,66,2737.27,5130.01,0.00
2024-12-10 17:38:02,112,4565,47,65,2760.34,5130.03,0.00
2024-12-10 17:38:02,113,4564,47,66,2732.75,5130.11,0.00
2024-12-10 17:38:02,112,4564,46,66,2733.53,5130.43,0.00
2024-12-10 17:38:02,113,4563,47,66,2703.95,5130.54,0.00
2024-12-10 17:38:02,113,4564,47,66,2788.67,5131.00,0.00
2024-12-10 17:38:02,114,4564,48,66,2764.21,5131.01,0.00
2024-12-10 17:38:02,113,4564,48,65,2787.31,5131.03,0.00
2024-12-10 17:38:02,113,4565,48,65,2851.38,5132.00,0.00
2024-12-10 17:38:02,114,4565,48,66,2826.37,5132.01,0.00
2024-12-10 17:38:02,114,4566,48,66,2794.02,5133.00,0.00
2024-12-10 17:38:02,115,4566,48,67,2769.72,5133.01,0.00
2024-12-10 17:38:02,114,4566,48,66,2783.22,5133.04,0.00
2024-12-10 17:38:02,113,4566,48,65,2781.63,5133.43,0.00
2024-12-10 17:38:02,112,4566,47,65,2771.67,5133.87,0.00
2024-12-10 17:38:02,112,4567,47,65,2810.29,5134.00,0.00
2024-12-10 17:38:02,113,4567,48,65,2785.42,5134.01,0.00
2024-12-10 17:38:02,112,4567,48,64,2807.09,5134.03,0.00
2024-12-10 17:38:02,111,4567,47,64,2831.92,5134.03,0.00
2024-12-10 17:38:02,112,4566,48,64,2796.60,5134.24,0.00
2024-12-10 17:38:02,111,4566,48,63,2842.56,5134.39,0.00
2024-12-10 17:38:02,111,4567,48,63,2836.76,5135.00,0.00
2024-12-10 17:38:02,112,4567,48,64,2811.43,5135.01,0.00
2024-12-10 17:38:02,111,4567,47,64,2836.30,5135.01,0.00
2024-12-10 17:38:02,110,4567,47,63,2860.69,5135.02,0.00
2024-12-10 17:38:02,110,4568,47,63,2882.08,5136.00,0.00
2024-12-10 17:38:02,111,4568,47,64,2856.11,5136.01,0.00
2024-12-10 17:38:02,110,4568,46,64,2881.15,5136.02,0.00
2024-12-10 17:38:02,111,4567,47,64,2820.01,5136.50,0.00
2024-12-10 17:38:02,112,4566,48,64,2805.88,5136.63,0.00
2024-12-10 17:38:02,112,4567,48,64,2828.16,5137.00,0.00
2024-12-10 17:38:02,113,4567,48,65,2803.13,5137.01,0.00
2024-12-10 17:38:02,112,4567,48,64,2824.04,5137.02,0.00
2024-12-10 17:38:02,111,4567,47,64,2795.92,5137.63,0.00
2024-12-10 17:38:02,110,4567,46,64,2819.38,5137.67,0.00
2024-12-10 17:38:02,111,4566,47,64,2793.53,5137.69,0.00
2024-12-10 17:38:02,112,4565,47,65,2767.84,5137.92,0.00
2024-12-10 17:38:02,112,4566,47,65,2905.62,5138.00,0.00
2024-12-10 17:38:02,113,4566,48,65,2879.91,5138.01,0.00
2024-12-10 17:38:02,112,4566,48,64,2902.50,5138.04,0.00
2024-12-10 17:38:03,112,4567,48,64,2963.79,5139.00,0.00
2024-12-10 17:38:03,113,4567,49,64,2937.56,5139.01,0.00
2024-12-10 17:38:03,112,4567,48,64,2960.78,5139.03,0.00
2024-12-10 17:38:03,111,4567,48,63,2986.99,5139.03,0.00
2024-12-10 17:38:03,111,4568,48,63,2955.71,5140.00,0.00
2024-12-10 17:38:03,112,4568,49,63,2929.32,5140.01,0.00
2024-12-10 17:38:03,111,4568,49,62,2949.71,5140.03,0.00
2024-12-10 17:38:03,110,4568,48,62,2956.89,5140.33,0.00
2024-12-10 17:38:03,110,4569,48,62,2964.12,5141.00,0.00
2024-12-10 17:38:03,111,4569,49,62,2937.41,5141.01,0.00
2024-12-10 17:38:03,110,4569,49,61,2953.37,5141.05,0.00
2024-12-10 17:38:03,109,4569,48,61,2944.59,5141.67,0.00
2024-12-10 17:38:03,109,4570,48,61,2955.05,5142.00,0.00
2024-12-10 17:38:03,110,4570,48,62,2928.19,5142.01,0.00
2024-12-10 17:38:03,109,4570,48,61,2941.95,5142.06,0.00
2024-12-10 17:38:03,108,4570,47,61,2961.58,5142.07,0.00
2024-12-10 17:38:03,109,4569,47,62,2900.50,5142.68,0.00
2024-12-10 17:38:03,109,4570,47,62,2941.06,5143.00,0.00
2024-12-10 17:38:03,110,4570,48,62,2914.32,5143.01,0.00
2024-12-10 17:38:03,109,4570,47,62,2938.80,5143.01,0.00
2024-12-10 17:38:03,109,4571,47,62,2959.41,5144.00,0.00
2024-12-10 17:38:03,110,4571,48,62,2932.51,5144.01,0.00
2024-12-10 17:38:03,110,4572,48,62,2897.50,5145.00,0.00
2024-12-10 17:38:03,111,4572,49,62,2871.40,5145.01,0.00
2024-12-10 17:38:03,110,4572,48,62,2841.20,5145.68,0.00
2024-12-10 17:38:03,110,4573,48,62,2854.04,5146.00,0.00
2024-12-10 17:38:03,111,4573,49,62,2828.32,5146.01,0.00
2024-12-10 17:38:03,110,4573,49,61,2845.16,5146.06,0.00
2024-12-10 17:38:03,109,4573,49,60,2858.51,5146.24,0.00
2024-12-10 17:38:03,109,4574,49,60,2839.60,5147.00,0.00
2024-12-10 17:38:03,110,4574,49,61,2813.79,5147.01,0.00
2024-12-10 17:38:03,109,4574,48,61,2838.67,5147.02,0.00
2024-12-10 17:38:03,108,4574,48,60,2857.81,5147.05,0.00
2024-12-10 17:38:03,107,4574,47,60,2854.76,5147.26,0.00
2024-12-10 17:38:03,106,4574,46,60,2869.89,5147.48,0.00
2024-12-10 17:38:03,106,4575,46,60,2889.02,5148.00,0.00
2024-12-10 17:38:03,107,4575,46,61,2862.02,5148.01,0.00
2024-12-10 17:38:03,106,4575,46,60,2881.75,5148.05,0.00
2024-12-10 17:38:03,106,4576,46,60,2858.04,5149.00,0.00
2024-12-10 17:38:03,107,4576,46,61,2831.33,5149.01,0.00
2024-12-10 17:38:03,106,4576,46,60,2850.77,5149.05,0.00
2024-12-10 17:38:03,106,4577,46,60,2826.38,5150.00,0.00
2024-12-10 17:38:03,107,4577,46,61,2799.96,5150.01,0.00
2024-12-10 17:38:03,106,4577,45,61,2825.41,5150.02,0.00
2024-12-10 17:38:03,105,4577,45,60,2845.95,5150.04,0.00
2024-12-10 17:38:03,106,4576,45,61,2802.20,5150.39,0.00
2024-12-10 17:38:03,107,4575,45,62,2800.08,5150.40,0.00
2024-12-10 17:38:03,106,4575,44,62,2848.76,5150.43,0.00
2024-12-10 17:38:03,107,4574,44,63,2794.57,5150.92,0.00
2024-12-10 17:38:03,107,4575,44,63,2842.30,5151.00,0.00
2024-12-10 17:38:03,108,4575,44,64,2815.98,5151.01,0.00
2024-12-10 17:38:03,107,4575,44,63,2835.58,5151.04,0.00
2024-12-10 17:38:03,106,4575,43,63,2850.06,5151.26,0.00
2024-12-10 17:38:03,106,4576,43,63,2982.59,5152.00,0.00
2024-12-10 17:38:03,107,4576,43,64,2954.72,5152.01,0.00
2024-12-10 17:38:03,108,4575,44,64,2927.36,5152.03,0.00
2024-12-10 17:38:03,107,4575,44,63,2959.06,5152.05,0.00
2024-12-10 17:38:03,108,4574,44,64,2916.49,5152.33,0.00
2024-12-10 17:38:03,109,4573,44,65,2901.17,5152.50,0.00
2024-12-10 17:38:03,109,4574,44,65,2916.98,5153.00,0.00
2024-12-10 17:38:03,110,4574,45,65,2890.46,5153.01,0.00
2024-12-10 17:38:03,110,4575,45,65,3006.62,5154.00,0.00
2024-12-10 17:38:03,111,4575,45,66,2979.53,5154.01,0.00
2024-12-10 17:38:03,110,4575,45,65,3005.23,5154.03,0.00
2024-12-10 17:38:03,111,4574,46,65,2938.64,5154.44,0.00
2024-12-10 17:38:03,111,4575,46,65,2988.67,5155.00,0.00
2024-12-10 17:38:03,112,4575,46,66,2961.99,5155.01,0.00
2024-12-10 17:38:03,111,4575,45,66,2969.69,5155.17,0.00
2024-12-10 17:38:03,111,4576,45,66,3000.45,5156.00,0.00
2024-12-10 17:38:03,112,4576,46,66,2973.66,5156.01,0.00
2024-12-10 17:38:03,111,4576,46,65,2990.71,5156.03,0.00
2024-12-10 17:38:03,110,4576,45,65,2994.21,5156.28,0.00
2024-12-10 17:38:03,110,4577,45,65,3000.74,5157.00,0.00
2024-12-10 17:38:03,111,4577,46,65,2973.70,5157.01,0.00
2024-12-10 17:38:03,110,4577,46,64,2994.66,5157.03,0.00
2024-12-10 17:38:03,109,4577,45,64,2997.10,5157.20,0.00
2024-12-10 17:38:03,108,4577,45,63,3024.39,5157.20,0.00
2024-12-10 17:38:03,109,4576,46,63,2956.32,5157.91,0.00
2024-12-10 17:38:03,109,4577,46,63,3001.84,5158.00,0.00
2024-12-10 17:38:03,110,4577,46,64,2974.55,5158.01,0.00
2024-12-10 17:38:03,109,4577,46,63,2995.70,5158.03,0.00
2024-12-10 17:38:03,108,4577,45,63,3010.32,5158.25,0.00
2024-12-10 17:38:03,108,4578,45,63,3044.70,5159.00,0.00
2024-12-10 17:38:03,109,4578,46,63,3016.77,5159.01,0.00
2024-12-10 17:38:03,108,4578,46,62,3036.12,5159.05,0.00
2024-12-10 17:38:03,108,4579,46,62,3009.58,5160.00,0.00
2024-12-10 17:38:03,109,4579,47,62,2981.97,5160.01,0.00
2024-12-10 17:38:03,108,4579,46,62,2955.08,5160.74,0.00
2024-12-10 17:38:03,108,4580,46,62,2981.33,5161.00,0.00
2024-12-10 17:38:03,109,4580,46,63,2953.98,5161.01,0.00
2024-12-10 17:38:03,110,4579,46,64,2912.61,5161.13,0.00
2024-12-10 17:38:03,111,4578,47,64,2898.22,5161.42,0.00
2024-12-10 17:38:03,111,4579,47,64,2917.14,5162.00,0.00
2024-12-10 17:38:03,112,4579,47,65,2891.10,5162.01,0.00
2024-12-10 17:38:03,111,4579,47,64,2906.00,5162.05,0.00
2024-12-10 17:38:03,112,4578,47,65,2860.51,5162.38,0.00
2024-12-10 17:38:03,113,4577,47,66,2825.57,5162.62,0.00
2024-12-10 17:38:03,114,4576,47,67,2823.79,5162.66,0.00
2024-12-10 17:38:03,113,4576,47,66,2857.20,5162.70,0.00
2024-12-10 17:38:03,113,4577,47,66,2960.50,5163.00,0.00
2024-12-10 17:38:03,114,4577,48,66,2934.53,5163.01,0.00
2024-12-10 17:38:03,113,4577,48,65,2953.20,5163.04,0.00
2024-12-10 17:38:03,112,4577,47,65,2971.28,5163.07,0.00
2024-12-10 17:38:03,112,4578,47,65,3101.45,5164.00,0.00
2024-12-10 17:38:03,113,4578,48,65,3074.00,5164.01,0.00
2024-12-10 17:38:03,112,4578,48,64,3093.17,5164.05,0.00
2024-12-10 17:38:03,113,4577,48,65,2995.83,5164.95,0.00
2024-12-10 17:38:03,113,4578,48,65,3039.74,5165.00,0.00
2024-12-10 17:38:04,114,4578,48,66,3013.08,5165.01,0.00
2024-12-10 17:38:04,113,4578,48,65,3031.53,5165.05,0.00
2024-12-10 17:38:04,112,4578,47,65,3016.56,5165.71,0.00
2024-12-10 17:38:04,112,4579,47,65,3092.66,5166.00,0.00
2024-12-10 17:38:04,113,4579,48,65,3065.29,5166.01,0.00
2024-12-10 17:38:04,112,4579,48,64,3084.37,5166.05,0.00
2024-12-10 17:38:04,111,4579,47,64,3098.84,5166.25,0.00
2024-12-10 17:38:04,110,4579,46,64,3121.92,5166.35,0.00
2024-12-10 17:38:04,110,4580,46,64,3108.96,5167.00,0.00
2024-12-10 17:38:04,111,4580,46,65,3080.95,5167.01,0.00
2024-12-10 17:38:04,111,4581,46,65,3050.57,5168.00,0.00
2024-12-10 17:38:04,112,4581,46,66,3023.34,5168.01,0.00
2024-12-10 17:38:04,111,4581,45,66,3049.19,5168.03,0.00
2024-12-10 17:38:04,112,4580,46,66,2997.79,5168.29,0.00
2024-12-10 17:38:04,112,4581,46,66,2997.77,5169.00,0.00
2024-12-10 17:38:04,113,4581,46,67,2971.24,5169.01,0.00
2024-12-10 17:38:04,114,4580,46,68,2928.43,5169.18,0.00
2024-12-10 17:38:04,115,4579,46,69,2870.99,5169.74,0.00
2024-12-10 17:38:04,115,4580,46,69,2941.27,5170.00,0.00
2024-12-10 17:38:04,116,4580,46,70,2915.92,5170.01,0.00
2024-12-10 17:38:04,115,4580,46,69,2939.49,5170.03,0.00
2024-12-10 17:38:04,116,4579,47,69,2913.70,5170.05,0.00
2024-12-10 17:38:04,116,4580,47,69,3002.67,5171.00,0.00
2024-12-10 17:38:04,117,4580,47,70,2977.01,5171.01,0.00
2024-12-10 17:38:04,116,4580,46,70,2983.99,5171.16,0.00
2024-12-10 17:38:04,117,4579,47,70,2954.11,5171.26,0.00
2024-12-10 17:38:04,116,4579,46,70,2970.21,5171.39,0.00
2024-12-10 17:38:04,117,4578,47,70,2927.10,5171.68,0.00
2024-12-10 17:38:04,117,4579,47,70,3004.22,5172.00,0.00
2024-12-10 17:38:04,118,4579,47,71,2978.76,5172.01,0.00
2024-12-10 17:38:04,119,4578,48,71,2901.73,5172.76,0.00
2024-12-10 17:38:04,119,4579,48,71,3021.55,5173.00,0.00
2024-12-10 17:38:04,120,4579,48,72,2996.37,5173.01,0.00
2024-12-10 17:38:04,119,4579,47,72,2993.29,5173.36,0.00
2024-12-10 17:38:04,119,4580,47,72,3033.02,5174.00,0.00
2024-12-10 17:38:04,120,4580,47,73,3007.75,5174.01,0.00
2024-12-10 17:38:04,119,4580,46,73,2990.35,5174.55,0.00
2024-12-10 17:38:04,119,4581,46,73,2993.40,5175.00,0.00
2024-12-10 17:38:04,120,4581,47,73,2968.46,5175.01,0.00
2024-12-10 17:38:04,119,4581,47,72,2992.11,5175.03,0.00
2024-12-10 17:38:04,118,4581,47,71,3010.45,5175.03,0.00
2024-12-10 17:38:04,119,4580,48,71,2955.14,5175.53,0.00
2024-12-10 17:38:04,118,4580,47,71,2962.11,5175.94,0.00
2024-12-10 17:38:04,118,4581,47,71,3002.96,5176.00,0.00
2024-12-10 17:38:04,119,4581,47,72,2977.72,5176.01,0.00
2024-12-10 17:38:04,118,4581,47,71,3000.33,5176.03,0.00
2024-12-10 17:38:04,119,4580,47,72,2965.61,5176.23,0.00
2024-12-10 17:38:04,120,4579,48,72,2941.34,5176.27,0.00
2024-12-10 17:38:04,121,4578,48,73,2900.47,5176.79,0.00
2024-12-10 17:38:04,121,4579,48,73,2959.71,5177.00,0.00
2024-12-10 17:38:04,122,4579,48,74,2935.45,5177.01,0.00
2024-12-10 17:38:04,121,4579,48,73,2957.15,5177.03,0.00
2024-12-10 17:38:04,122,4578,48,74,2913.92,5177.40,0.00
2024-12-10 17:38:04,123,4577,48,75,2881.48,5177.54,0.00
2024-12-10 17:38:04,122,4577,47,75,2908.94,5177.71,0.00
2024-12-10 17:38:04,122,4578,47,75,3060.31,5178.00,0.00
2024-12-10 17:38:04,123,4578,48,75,3035.43,5178.01,0.00
2024-12-10 17:38:04,122,4578,48,74,3056.93,5178.02,0.00
2024-12-10 17:38:04,121,4578,47,74,3081.19,5178.03,0.00
2024-12-10 17:38:04,122,4577,48,74,3047.50,5178.21,0.00
2024-12-10 17:38:04,121,4577,47,74,3095.35,5178.31,0.00
2024-12-10 17:38:04,121,4578,47,74,3177.61,5179.00,0.00
2024-12-10 17:38:04,122,4578,47,75,3151.57,5179.01,0.00
2024-12-10 17:38:04,121,4578,47,74,3173.34,5179.03,0.00
2024-12-10 17:38:04,120,4578,46,74,3198.17,5179.05,0.00
2024-12-10 17:38:04,119,4578,45,74,3214.26,5179.25,0.00
2024-12-10 17:38:04,118,4578,45,73,3234.52,5179.38,0.00
2024-12-10 17:38:04,118,4579,45,73,3268.37,5180.00,0.00
2024-12-10 17:38:04,119,4579,45,74,3240.91,5180.01,0.00
2024-12-10 17:38:04,118,4579,45,73,3263.55,5180.03,0.00
2024-12-10 17:38:04,119,4578,45,74,3228.78,5180.19,0.00
2024-12-10 17:38:04,118,4578,44,74,3282.87,5180.25,0.00
2024-12-10 17:38:04,117,4578,43,74,3306.95,5180.27,0.00
2024-12-10 17:38:04,117,4579,43,74,3310.31,5181.00,0.00
2024-12-10 17:38:04,118,4579,44,74,3282.26,5181.01,0.00
2024-12-10 17:38:04,117,4579,44,73,3305.93,5181.03,0.00
2024-12-10 17:38:04,116,4579,43,73,3301.05,5181.33,0.00
2024-12-10 17:38:04,117,4578,43,74,3251.33,5181.71,0.00
2024-12-10 17:38:04,117,4579,43,74,3357.84,5182.00,0.00
2024-12-10 17:38:04,118,4579,44,74,3329.38,5182.01,0.00
2024-12-10 17:38:04,117,4579,44,73,3356.64,5182.03,0.00
2024-12-10 17:38:04,117,4580,44,73,3374.19,5183.00,0.00
2024-12-10 17:38:04,118,4580,45,73,3345.59,5183.01,0.00
2024-12-10 17:38:04,117,4580,45,72,3367.99,5183.03,0.00
2024-12-10 17:38:04,116,4580,44,72,3387.22,5183.06,0.00
2024-12-10 17:38:04,117,4579,44,73,3353.87,5183.16,0.00
2024-12-10 17:38:04,117,4580,44,73,3353.40,5184.00,0.00
2024-12-10 17:38:04,118,4580,45,73,3324.98,5184.01,0.00
2024-12-10 17:38:04,119,4579,46,73,3254.03,5184.45,0.00
2024-12-10 17:38:04,120,4578,47,73,3229.26,5184.66,0.00
2024-12-10 17:38:04,119,4578,46,73,3263.39,5184.70,0.00
2024-12-10 17:38:04,119,4579,46,73,3334.37,5185.00,0.00
2024-12-10 17:38:04,120,4579,47,73,3306.58,5185.01,0.00
2024-12-10 17:38:04,120,4580,47,73,3354.40,5186.00,0.00
2024-12-10 17:38:04,121,4580,48,73,3326.68,5186.01,0.00
2024-12-10 17:38:04,120,4580,48,72,3348.41,5186.03,0.00
2024-12-10 17:38:04,119,4580,47,72,3366.54,5186.23,0.00
2024-12-10 17:38:04,119,4581,47,72,3347.65,5187.00,0.00
2024-12-10 17:38:04,120,4581,48,72,3319.76,5187.01,0.00
2024-12-10 17:38:04,119,4581,47,72,3310.16,5187.54,0.00
2024-12-10 17:38:04,119,4582,47,72,3320.02,5188.00,0.00
2024-12-10 17:38:04,120,4582,48,72,3292.35,5188.01,0.00
2024-12-10 17:38:04,120,4583,48,72,3260.04,5189.00,0.00
2024-12-10 17:38:04,121,4583,48,73,3233.09,5189.01,0.00
2024-12-10 17:38:04,120,4583,47,73,3221.44,5189.58,0.00
2024-12-10 17:38:05,120,4584,47,73,3225.55,5190.00,0.00
2024-12-10 17:38:05,121,4584,48,73,3198.89,5190.01,0.00
2024-12-10 17:38:05,120,4584,48,72,3223.40,5190.04,0.00
2024-12-10 17:38:05,120,4585,48,72,3199.18,5191.00,0.00
2024-12-10 17:38:05,121,4585,49,72,3172.74,5191.01,0.00
2024-12-10 17:38:05,120,4585,49,71,3192.27,5191.05,0.00
2024-12-10 17:38:05,121,4584,49,72,3161.64,5191.15,0.00
2024-12-10 17:38:05,121,4585,49,72,3147.95,5192.00,0.00
2024-12-10 17:38:05,122,4585,50,72,3122.14,5192.01,0.00
2024-12-10 17:38:05,121,4585,50,71,3140.67,5192.05,0.00
2024-12-10 17:38:05,120,4585,49,71,3156.55,5192.25,0.00
2024-12-10 17:38:05,121,4584,50,71,3127.05,5192.33,0.00
2024-12-10 17:38:05,121,4585,50,71,3164.88,5193.00,0.00
2024-12-10 17:38:05,122,4585,51,71,3138.94,5193.01,0.00
2024-12-10 17:38:05,122,4586,51,71,3143.98,5194.00,0.00
2024-12-10 17:38:05,123,4586,51,72,3118.42,5194.01,0.00
2024-12-10 17:38:05,122,4586,51,71,3135.05,5194.05,0.00
2024-12-10 17:38:05,123,4585,51,72,3099.09,5194.27,0.00
2024-12-10 17:38:05,123,4586,51,72,3122.43,5195.00,0.00
2024-12-10 17:38:05,124,4586,52,72,3097.25,5195.01,0.00
2024-12-10 17:38:05,123,4586,51,72,3121.17,5195.02,0.00
2024-12-10 17:38:05,124,4585,51,73,3081.81,5195.15,0.00
2024-12-10 17:38:05,125,4584,51,74,3060.74,5195.46,0.00
2024-12-10 17:38:05,126,4583,52,74,3052.55,5195.49,0.00
2024-12-10 17:38:05,125,4583,51,74,3084.25,5195.50,0.00
2024-12-10 17:38:05,125,4584,51,74,3138.60,5196.00,0.00
2024-12-10 17:38:05,126,4584,52,74,3113.69,5196.01,0.00
2024-12-10 17:38:05,125,4584,52,73,3128.23,5196.04,0.00
2024-12-10 17:38:05,124,4584,51,73,3141.82,5196.26,0.00
2024-12-10 17:38:05,125,4583,51,74,3101.24,5196.50,0.00
2024-12-10 17:38:05,125,4584,51,74,3236.58,5197.00,0.00
2024-12-10 17:38:05,126,4584,51,75,3210.89,5197.01,0.00
2024-12-10 17:38:05,125,4584,51,74,3230.77,5197.04,0.00
2024-12-10 17:38:05,125,4585,51,74,3241.03,5198.00,0.00
2024-12-10 17:38:05,126,4585,51,75,3215.31,5198.01,0.00
2024-12-10 17:38:05,125,4585,51,74,3234.23,5198.05,0.00
2024-12-10 17:38:05,126,4584,51,75,3204.07,5198.15,0.00
2024-12-10 17:38:05,125,4584,50,75,3213.71,5198.67,0.00
2024-12-10 17:38:05,125,4585,50,75,3236.35,5199.00,0.00
2024-12-10 17:38:05,126,4585,50,76,3210.67,5199.01,0.00
2024-12-10 17:38:05,126,4586,50,76,3221.65,5200.00,0.00
2024-12-10 17:38:05,127,4586,51,76,3196.29,5200.01,0.00
2024-12-10 17:38:05,127,4587,51,76,3163.05,5201.00,0.00
2024-12-10 17:38:05,128,4587,51,77,3138.34,5201.01,0.00
2024-12-10 17:38:05,127,4587,50,77,3161.42,5201.03,0.00
2024-12-10 17:38:05,126,4587,49,77,3167.75,5201.23,0.00
2024-12-10 17:38:05,125,4587,48,77,3157.37,5201.72,0.00
2024-12-10 17:38:05,125,4588,48,77,3183.43,5202.00,0.00
2024-12-10 17:38:05,126,4588,49,77,3158.16,5202.01,0.00
2024-12-10 17:38:05,125,4588,49,76,3157.88,5202.34,0.00
2024-12-10 17:38:05,125,4589,49,76,3142.97,5203.00,0.00
2024-12-10 17:38:05,126,4589,49,77,3118.03,5203.01,0.00
2024-12-10 17:38:05,125,4589,49,76,3140.08,5203.06,0.00
2024-12-10 17:38:05,126,4588,50,76,3079.76,5203.64,0.00
2024-12-10 17:38:05,126,4589,50,76,3097.06,5204.00,0.00
2024-12-10 17:38:05,127,4589,51,76,3072.67,5204.01,0.00
2024-12-10 17:38:05,127,4590,51,76,3080.50,5205.00,0.00
2024-12-10 17:38:05,128,4590,51,77,3056.44,5205.01,0.00
2024-12-10 17:38:05,128,4591,51,77,3016.84,5206.00,0.00
2024-12-10 17:38:05,129,4591,52,77,2993.45,5206.01,0.00
2024-12-10 17:38:05,128,4591,52,76,3007.50,5206.06,0.00
2024-12-10 17:38:05,127,4591,51,76,3024.26,5206.18,0.00
2024-12-10 17:38:05,127,4592,51,76,3000.37,5207.00,0.00
2024-12-10 17:38:05,128,4592,52,76,2976.93,5207.01,0.00
2024-12-10 17:38:05,127,4592,52,75,2998.74,5207.03,0.00
2024-12-10 17:38:05,128,4591,53,75,2960.71,5207.17,0.00
2024-12-10 17:38:05,129,4590,53,76,2923.30,5207.48,0.00
2024-12-10 17:38:05,129,4591,53,76,2951.01,5208.00,0.00
2024-12-10 17:38:05,130,4591,53,77,2928.31,5208.01,0.00
2024-12-10 17:38:05,129,4591,52,77,2899.44,5208.77,0.00
2024-12-10 17:38:05,129,4592,52,77,2993.47,5209.00,0.00
2024-12-10 17:38:05,130,4592,52,78,2970.45,5209.01,0.00
2024-12-10 17:38:05,129,4592,52,77,2985.83,5209.05,0.00
2024-12-10 17:38:05,129,4593,52,77,2957.62,5210.00,0.00
2024-12-10 17:38:05,130,4593,53,77,2934.87,5210.01,0.00
2024-12-10 17:38:05,129,4593,52,77,2933.38,5210.24,0.00
2024-12-10 17:38:05,130,4592,53,77,2906.05,5210.35,0.00
2024-12-10 17:38:05,129,4592,52,77,2940.50,5210.54,0.00
2024-12-10 17:38:05,129,4593,52,77,2955.32,5211.00,0.00
2024-12-10 17:38:05,130,4593,52,78,2932.58,5211.01,0.00
2024-12-10 17:38:05,131,4592,53,78,2866.24,5211.60,0.00
2024-12-10 17:38:05,132,4591,54,78,2856.39,5211.64,0.00
2024-12-10 17:38:05,132,4592,54,78,2948.48,5212.00,0.00
2024-12-10 17:38:05,133,4592,55,78,2926.31,5212.01,0.00
2024-12-10 17:38:05,134,4591,55,79,2875.12,5212.22,0.00
2024-12-10 17:38:05,133,4591,55,78,2913.27,5212.41,0.00
2024-12-10 17:38:05,133,4592,55,78,2998.19,5213.00,0.00
2024-12-10 17:38:05,134,4592,55,79,2975.82,5213.01,0.00
2024-12-10 17:38:05,133,4592,54,79,2973.29,5213.09,0.00
2024-12-10 17:38:05,132,4592,53,79,2990.25,5213.20,0.00
2024-12-10 17:38:05,132,4593,53,79,3025.75,5214.00,0.00
2024-12-10 17:38:05,133,4593,53,80,3003.00,5214.01,0.00
2024-12-10 17:38:05,132,4593,53,79,3021.83,5214.07,0.00
2024-12-10 17:38:05,132,4594,53,79,2996.42,5215.00,0.00
2024-12-10 17:38:05,133,4594,53,80,2973.89,5215.01,0.00
2024-12-10 17:38:06,132,4594,53,79,2986.97,5215.09,0.00
2024-12-10 17:38:06,132,4595,53,79,2963.65,5216.00,0.00
2024-12-10 17:38:06,133,4595,53,80,2941.37,5216.01,0.00
2024-12-10 17:38:06,132,4595,53,79,2960.90,5216.05,0.00
2024-12-10 17:38:06,131,4595,53,78,2976.74,5216.08,0.00
2024-12-10 17:38:06,130,4595,52,78,2950.69,5216.73,0.00
2024-12-10 17:38:06,130,4596,52,78,2976.99,5217.00,0.00
2024-12-10 17:38:06,131,4596,53,78,2954.26,5217.01,0.00
2024-12-10 17:38:06,130,4596,53,77,2967.78,5217.08,0.00
2024-12-10 17:38:06,130,4597,53,77,2944.64,5218.00,0.00
2024-12-10 17:38:06,131,4597,54,77,2922.17,5218.01,0.00
2024-12-10 17:38:06,130,4597,54,76,2941.85,5218.05,0.00
2024-12-10 17:38:06,129,4597,54,75,2958.59,5218.08,0.00
2024-12-10 17:38:06,128,4597,53,75,2966.25,5218.36,0.00
2024-12-10 17:38:06,127,4597,52,75,2968.37,5218.58,0.00
2024-12-10 17:38:06,127,4598,52,75,2987.76,5219.00,0.00
2024-12-10 17:38:06,128,4598,53,75,2964.42,5219.01,0.00
2024-12-10 17:38:06,127,4598,53,74,2984.90,5219.06,0.00
2024-12-10 17:38:06,128,4597,53,75,2948.57,5219.16,0.00
2024-12-10 17:38:06,128,4598,53,75,2954.82,5220.00,0.00
2024-12-10 17:38:06,129,4598,53,76,2931.91,5220.01,0.00
2024-12-10 17:38:06,129,4599,53,76,2942.74,5221.00,0.00
2024-12-10 17:38:06,130,4599,53,77,2920.10,5221.01,0.00
2024-12-10 17:38:06,129,4599,52,77,2941.93,5221.02,0.00
2024-12-10 17:38:06,128,4599,52,76,2962.89,5221.05,0.00
2024-12-10 17:38:06,128,4600,52,76,2928.68,5222.00,0.00
2024-12-10 17:38:06,129,4600,53,76,2905.98,5222.01,0.00
2024-12-10 17:38:06,129,4601,53,76,2864.23,5223.00,0.00
2024-12-10 17:38:06,130,4601,54,76,2842.20,5223.01,0.00
2024-12-10 17:38:06,129,4601,54,75,2859.39,5223.06,0.00
2024-12-10 17:38:06,128,4601,53,75,2877.97,5223.13,0.00
2024-12-10 17:38:06,127,4601,53,74,2886.93,5223.35,0.00
2024-12-10 17:38:06,127,4602,53,74,2874.35,5224.00,0.00
2024-12-10 17:38:06,128,4602,53,75,2851.89,5224.01,0.00
2024-12-10 17:38:06,127,4602,53,74,2867.78,5224.06,0.00
2024-12-10 17:38:06,126,4602,52,74,2873.74,5224.25,0.00
2024-12-10 17:38:06,125,4602,52,73,2880.18,5224.53,0.00
2024-12-10 17:38:06,125,4603,52,73,2894.57,5225.00,0.00
2024-12-10 17:38:06,126,4603,52,74,2871.60,5225.01,0.00
2024-12-10 17:38:06,125,4603,52,73,2886.65,5225.07,0.00
2024-12-10 17:38:06,125,4604,52,73,2859.51,5226.00,0.00
2024-12-10 17:38:06,126,4604,52,74,2836.82,5226.01,0.00
2024-12-10 17:38:06,125,4604,52,73,2850.76,5226.08,0.00
2024-12-10 17:38:06,124,4604,51,73,2844.35,5226.31,0.00
2024-12-10 17:38:06,124,4605,51,73,2847.08,5227.00,0.00
2024-12-10 17:38:06,125,4605,51,74,2824.30,5227.01,0.00
2024-12-10 17:38:06,124,4605,50,74,2844.56,5227.05,0.00
2024-12-10 17:38:06,123,4605,49,74,2814.62,5227.79,0.00
2024-12-10 17:38:06,123,4606,49,74,2846.24,5228.00,0.00
2024-12-10 17:38:06,124,4606,49,75,2823.28,5228.01,0.00
2024-12-10 17:38:06,123,4606,48,75,2819.41,5228.26,0.00
2024-12-10 17:38:06,122,4606,47,75,2823.17,5228.55,0.00
2024-12-10 17:38:06,122,4607,47,75,2841.13,5229.00,0.00
2024-12-10 17:38:06,123,4607,48,75,2818.03,5229.01,0.00
2024-12-10 17:38:06,122,4607,47,75,2805.34,5229.50,0.00
2024-12-10 17:38:06,123,4606,48,75,2775.23,5229.65,0.00
2024-12-10 17:38:06,123,4607,48,75,2798.15,5230.00,0.00
2024-12-10 17:38:06,124,4607,48,76,2775.58,5230.01,0.00
2024-12-10 17:38:06,123,4607,47,76,2787.11,5230.05,0.00
2024-12-10 17:38:06,123,4608,47,76,2809.55,5231.00,0.00
2024-12-10 17:38:06,124,4608,47,77,2786.89,5231.01,0.00
2024-12-10 17:38:06,123,4608,47,76,2801.04,5231.02,0.00
2024-12-10 17:38:06,124,4607,47,77,2772.59,5231.15,0.00
2024-12-10 17:38:06,124,4608,47,77,2786.87,5232.00,0.00
2024-12-10 17:38:06,125,4608,48,77,2764.57,5232.01,0.00
2024-12-10 17:38:06,126,4607,48,78,2724.43,5232.21,0.00
2024-12-10 17:38:06,126,4608,48,78,2771.90,5233.00,0.00
2024-12-10 17:38:06,127,4608,49,78,2750.08,5233.01,0.00
2024-12-10 17:38:06,126,4608,48,78,2727.97,5233.68,0.00
2024-12-10 17:38:06,125,4608,47,78,2734.04,5233.96,0.00
2024-12-10 17:38:06,125,4609,47,78,2815.71,5234.00,0.00
2024-12-10 17:38:06,126,4609,47,79,2793.37,5234.01,0.00
2024-12-10 17:38:06,125,4609,47,78,2811.95,5234.02,0.00
2024-12-10 17:38:06,126,4608,48,78,2768.61,5234.44,0.00
2024-12-10 17:38:06,127,4607,49,78,2732.34,5234.90,0.00
2024-12-10 17:38:06,127,4608,49,78,2772.83,5235.00,0.00
2024-12-10 17:38:06,128,4608,50,78,2751.17,5235.01,0.00
2024-12-10 17:38:06,127,4608,50,77,2768.35,5235.04,0.00
2024-12-10 17:38:06,128,4607,50,78,2718.44,5235.58,0.00
2024-12-10 17:38:06,128,4608,50,78,2835.32,5236.00,0.00
2024-12-10 17:38:06,129,4608,51,78,2813.34,5236.01,0.00
2024-12-10 17:38:06,130,4607,52,78,2770.05,5236.29,0.00
2024-12-10 17:38:06,129,4607,51,78,2808.50,5236.47,0.00
2024-12-10 17:38:07,129,4608,51,78,2857.57,5237.00,0.00
2024-12-10 17:38:07,130,4608,51,79,2835.58,5237.01,0.00
2024-12-10 17:38:07,130,4609,51,79,2850.16,5238.00,0.00
2024-12-10 17:38:07,131,4609,51,80,2828.40,5238.01,0.00
2024-12-10 17:38:07,130,4609,50,80,2847.76,5238.05,0.00
2024-12-10 17:38:07,131,4608,50,81,2779.79,5238.79,0.00
2024-12-10 17:38:07,131,4609,50,81,2836.40,5239.00,0.00
2024-12-10 17:38:07,132,4609,51,81,2814.91,5239.01,0.00
2024-12-10 17:38:07,131,4609,51,80,2825.62,5239.05,0.00
2024-12-10 17:38:07,130,4609,50,80,2807.56,5239.79,0.00
2024-12-10 17:38:07,130,4610,50,80,2861.33,5240.00,0.00
2024-12-10 17:38:07,131,4610,51,80,2839.49,5240.01,0.00
2024-12-10 17:38:07,131,4611,51,80,2807.39,5241.00,0.00
2024-12-10 17:38:07,132,4611,52,80,2786.13,5241.01,0.00
2024-12-10 17:38:07,131,4611,51,80,2770.17,5241.44,0.00
2024-12-10 17:38:07,131,4612,51,80,2779.22,5242.00,0.00
2024-12-10 17:38:07,132,4612,52,80,2758.17,5242.01,0.00
2024-12-10 17:38:07,131,4612,51,80,2779.15,5242.01,0.00
2024-12-10 17:38:07,130,4612,51,79,2796.91,5242.05,0.00
2024-12-10 17:38:07,130,4613,51,79,2771.33,5243.00,0.00
2024-12-10 17:38:07,131,4613,52,79,2750.17,5243.01,0.00
2024-12-10 17:38:07,132,4612,52,80,2728.15,5243.05,0.00
2024-12-10 17:38:07,131,4612,52,79,2765.80,5243.06,0.00
2024-12-10 17:38:07,131,4613,52,79,2741.09,5244.00,0.00
2024-12-10 17:38:07,132,4613,52,80,2720.32,5244.01,0.00
2024-12-10 17:38:07,131,4613,52,79,2736.30,5244.05,0.00
2024-12-10 17:38:07,130,4613,51,79,2746.08,5244.15,0.00
2024-12-10 17:38:07,130,4614,51,79,2782.47,5245.00,0.00
2024-12-10 17:38:07,131,4614,51,80,2761.23,5245.01,0.00
2024-12-10 17:38:07,132,4613,52,80,2702.74,5245.52,0.00
2024-12-10 17:38:07,133,4612,52,81,2688.88,5245.77,0.00
2024-12-10 17:38:07,133,4613,52,81,2736.39,5246.00,0.00
2024-12-10 17:38:07,134,4613,52,82,2715.97,5246.01,0.00
2024-12-10 17:38:07,133,4613,51,82,2734.04,5246.05,0.00
2024-12-10 17:38:07,134,4612,51,83,2671.61,5246.61,0.00
2024-12-10 17:38:07,134,4613,51,83,2789.51,5247.00,0.00
2024-12-10 17:38:07,135,4613,51,84,2768.85,5247.01,0.00
2024-12-10 17:38:07,134,4613,50,84,2751.61,5247.41,0.00
2024-12-10 17:38:07,135,4612,51,84,2722.37,5247.59,0.00
2024-12-10 17:38:07,135,4613,51,84,2793.82,5248.00,0.00
2024-12-10 17:38:07,136,4613,51,85,2773.28,5248.01,0.00
2024-12-10 17:38:07,137,4612,51,86,2734.71,5248.23,0.00
2024-12-10 17:38:07,138,4611,51,87,2730.72,5248.54,0.00
2024-12-10 17:38:07,138,4612,51,87,2799.80,5249.00,0.00
2024-12-10 17:38:07,139,4612,51,88,2779.65,5249.01,0.00
2024-12-10 17:38:07,138,4612,51,87,2796.39,5249.05,0.00
2024-12-10 17:38:07,137,4612,50,87,2772.48,5249.80,0.00
2024-12-10 17:38:07,138,4611,51,87,2748.65,5249.88,0.00
2024-12-10 17:38:07,138,4612,51,87,2859.13,5250.00,0.00
2024-12-10 17:38:07,139,4612,51,88,2838.57,5250.01,0.00
2024-12-10 17:38:07,138,4612,51,87,2856.87,5250.04,0.00
2024-12-10 17:38:07,137,4612,51,86,2875.48,5250.04,0.00
2024-12-10 17:38:07,136,4612,50,86,2869.12,5250.36,0.00
2024-12-10 17:38:07,136,4613,50,86,2910.51,5251.00,0.00
2024-12-10 17:38:07,137,4613,51,86,2889.27,5251.01,0.00
2024-12-10 17:38:07,136,4613,51,85,2908.21,5251.04,0.00
2024-12-10 17:38:07,135,4613,51,84,2928.97,5251.04,0.00
2024-12-10 17:38:07,136,4612,51,85,2882.68,5251.49,0.00
2024-12-10 17:38:07,136,4613,51,85,2895.92,5252.00,0.00
2024-12-10 17:38:07,137,4613,51,86,2874.78,5252.01,0.00
2024-12-10 17:38:07,136,4613,50,86,2893.61,5252.04,0.00
2024-12-10 17:38:07,135,4613,50,85,2906.49,5252.05,0.00
2024-12-10 17:38:07,134,4613,49,85,2910.22,5252.34,0.00
2024-12-10 17:38:07,133,4613,48,85,2930.53,5252.36,0.00
2024-12-10 17:38:08,133,4614,48,85,2959.02,5253.00,0.00
2024-12-10 17:38:08,134,4614,48,86,2936.94,5253.01,0.00
2024-12-10 17:38:08,133,4614,47,86,2929.45,5253.36,0.00
2024-12-10 17:38:08,132,4614,46,86,2905.42,5253.80,0.00
2024-12-10 17:38:08,132,4615,46,86,2934.39,5254.00,0.00
2024-12-10 17:38:08,133,4615,46,87,2912.33,5254.01,0.00
2024-12-10 17:38:08,132,4615,46,86,2931.62,5254.05,0.00
2024-12-10 17:38:08,131,4615,46,85,2953.20,5254.05,0.00
2024-12-10 17:38:08,130,4615,45,85,2923.28,5254.74,0.00
2024-12-10 17:38:08,131,4614,46,85,2887.63,5254.99,0.00
2024-12-10 17:38:08,131,4615,46,85,2927.75,5255.00,0.00
2024-12-10 17:38:08,132,4615,46,86,2905.57,5255.01,0.00
2024-12-10 17:38:08,133,4614,47,86,2882.94,5255.04,0.00
2024-12-10 17:38:08,133,4615,47,86,2911.32,5256.00,0.00
2024-12-10 17:38:08,134,4615,48,86,2889.59,5256.01,0.00
2024-12-10 17:38:08,134,4616,48,86,2888.70,5257.00,0.00
2024-12-10 17:38:08,135,4616,49,86,2867.30,5257.01,0.00
2024-12-10 17:38:08,134,4616,49,85,2851.07,5257.45,0.00
2024-12-10 17:38:08,134,4617,49,85,2844.05,5258.00,0.00
2024-12-10 17:38:08,135,4617,49,86,2822.99,5258.01,0.00
2024-12-10 17:38:08,134,4617,49,85,2835.84,5258.05,0.00
2024-12-10 17:38:08,133,4617,49,84,2856.76,5258.05,0.00
2024-12-10 17:38:08,133,4618,49,84,2821.44,5259.00,0.00
2024-12-10 17:38:08,134,4618,50,84,2800.38,5259.01,0.00
2024-12-10 17:38:08,133,4618,49,84,2789.09,5259.29,0.00
2024-12-10 17:38:08,134,4617,49,85,2726.07,5259.90,0.00
2024-12-10 17:38:08,134,4618,49,85,2763.84,5260.00,0.00
2024-12-10 17:38:08,135,4618,50,85,2743.37,5260.01,0.00
2024-12-10 17:38:08,134,4618,50,84,2754.83,5260.05,0.00
2024-12-10 17:38:08,134,4619,50,84,2756.30,5261.00,0.00
2024-12-10 17:38:08,135,4619,50,85,2735.88,5261.01,0.00
2024-12-10 17:38:08,134,4619,50,84,2747.68,5261.05,0.00
2024-12-10 17:38:08,133,4619,49,84,2751.00,5261.35,0.00
2024-12-10 17:38:08,134,4618,50,84,2721.72,5261.49,0.00
2024-12-10 17:38:08,133,4618,49,84,2756.04,5261.51,0.00
2024-12-10 17:38:08,132,4618,49,83,2772.16,5261.61,0.00
2024-12-10 17:38:08,132,4619,49,83,2790.14,5262.00,0.00
2024-12-10 17:38:08,133,4619,49,84,2769.16,5262.01,0.00
2024-12-10 17:38:08,132,4619,49,83,2779.00,5262.06,0.00
2024-12-10 17:38:08,131,4619,49,82,2799.81,5262.06,0.00
2024-12-10 17:38:08,130,4619,48,82,2820.11,5262.08,0.00
2024-12-10 17:38:08,131,4618,49,82,2786.59,5262.33,0.00
2024-12-10 17:38:08,131,4619,49,82,2839.15,5263.00,0.00
2024-12-10 17:38:08,132,4619,50,82,2817.64,5263.01,0.00
2024-12-10 17:38:08,131,4619,50,81,2835.95,5263.05,0.00
2024-12-10 17:38:08,130,4619,49,81,2814.16,5263.66,0.00
2024-12-10 17:38:08,130,4620,49,81,2876.80,5264.00,0.00
2024-12-10 17:38:08,131,4620,50,81,2854.84,5264.01,0.00
2024-12-10 17:38:08,132,4619,50,82,2793.01,5264.58,0.00
2024-12-10 17:38:08,132,4620,50,82,2815.31,5265.00,0.00
2024-12-10 17:38:08,133,4620,50,83,2794.14,5265.01,0.00
2024-12-10 17:38:08,132,4620,50,82,2804.16,5265.06,0.00
2024-12-10 17:38:08,131,4620,49,82,2808.77,5265.38,0.00
2024-12-10 17:38:08,131,4621,49,82,2837.77,5266.00,0.00
2024-12-10 17:38:08,132,4621,50,82,2816.27,5266.01,0.00
2024-12-10 17:38:08,131,4621,50,81,2834.57,5266.05,0.00
2024-12-10 17:38:08,131,4622,50,81,2806.04,5267.00,0.00
2024-12-10 17:38:08,132,4622,50,82,2784.78,5267.01,0.00
2024-12-10 17:38:08,131,4622,50,81,2803.24,5267.05,0.00
2024-12-10 17:38:08,130,4622,49,81,2805.75,5267.42,0.00
2024-12-10 17:38:08,130,4623,49,81,2799.68,5268.00,0.00
2024-12-10 17:38:08,131,4623,49,82,2778.31,5268.01,0.00
2024-12-10 17:38:08,131,4624,49,82,2753.50,5269.00,0.00
2024-12-10 17:38:08,132,4624,50,82,2732.64,5269.01,0.00
2024-12-10 17:38:08,131,4624,50,81,2742.26,5269.06,0.00
2024-12-10 17:38:08,132,4623,50,82,2687.03,5269.74,0.00
2024-12-10 17:38:08,132,4624,50,82,2713.37,5270.00,0.00
2024-12-10 17:38:08,133,4624,51,82,2692.97,5270.01,0.00
2024-12-10 17:38:08,132,4624,51,81,2701.81,5270.07,0.00
2024-12-10 17:38:08,133,4623,52,81,2643.01,5270.82,0.00
2024-12-10 17:38:08,133,4624,52,81,2704.64,5271.00,0.00
2024-12-10 17:38:08,134,4624,52,82,2684.45,5271.01,0.00
2024-12-10 17:38:08,133,4624,52,81,2699.90,5271.05,0.00
2024-12-10 17:38:08,132,4624,52,80,2719.56,5271.06,0.00
2024-12-10 17:38:08,131,4624,51,80,2739.91,5271.06,0.00
2024-12-10 17:38:08,130,4624,50,80,2742.84,5271.40,0.00
2024-12-10 17:38:08,130,4625,50,80,2776.10,5272.00,0.00
2024-12-10 17:38:08,131,4625,51,80,2754.91,5272.01,0.00
2024-12-10 17:38:08,130,4625,51,79,2774.09,5272.04,0.00
2024-12-10 17:38:08,129,4625,51,78,2794.37,5272.05,0.00
2024-12-10 17:38:08,128,4625,50,78,2815.79,5272.06,0.00
2024-12-10 17:38:08,129,4624,51,78,2783.79,5272.26,0.00
2024-12-10 17:38:08,129,4625,51,78,2799.36,5273.00,0.00
2024-12-10 17:38:08,130,4625,52,78,2777.83,5273.01,0.00
2024-12-10 17:38:08,129,4625,52,77,2796.51,5273.05,0.00
2024-12-10 17:38:08,129,4626,52,77,2810.71,5274.00,0.00
2024-12-10 17:38:08,130,4626,53,77,2789.09,5274.01,0.00
2024-12-10 17:38:08,129,4626,53,76,2807.86,5274.05,0.00
2024-12-10 17:38:08,129,4627,53,76,2780.63,5275.00,0.00
2024-12-10 17:38:08,130,4627,53,77,2759.24,5275.01,0.00
2024-12-10 17:38:08,129,4627,53,76,2776.97,5275.06,0.00
2024-12-10 17:38:08,130,4626,54,76,2749.13,5275.20,0.00
2024-12-10 17:38:09,130,4627,54,76,2762.96,5276.00,0.00
2024-12-10 17:38:09,131,4627,54,77,2741.87,5276.01,0.00
2024-12-10 17:38:09,130,4627,53,77,2762.56,5276.01,0.00
2024-12-10 17:38:09,129,4627,53,76,2781.13,5276.05,0.00
2024-12-10 17:38:09,128,4627,53,75,2802.03,5276.06,0.00
2024-12-10 17:38:09,129,4626,54,75,2729.09,5276.74,0.00
2024-12-10 17:38:09,129,4627,54,75,2796.66,5277.00,0.00
2024-12-10 17:38:09,130,4627,55,75,2775.15,5277.01,0.00
2024-12-10 17:38:09,129,4627,54,75,2779.90,5277.05,0.00
2024-12-10 17:38:09,128,4627,54,74,2801.21,5277.06,0.00
2024-12-10 17:38:09,127,4627,54,73,2822.85,5277.06,0.00
2024-12-10 17:38:09,126,4627,54,72,2844.84,5277.06,0.00
2024-12-10 17:38:09,126,4628,54,72,2876.01,5278.00,0.00
2024-12-10 17:38:09,127,4628,55,72,2853.37,5278.01,0.00
2024-12-10 17:38:09,126,4628,55,71,2872.26,5278.06,0.00
2024-12-10 17:38:09,127,4627,56,71,2822.02,5278.60,0.00
2024-12-10 17:38:09,126,4627,55,71,2832.63,5278.90,0.00
2024-12-10 17:38:09,126,4628,55,71,2869.17,5279.00,0.00
2024-12-10 17:38:09,127,4628,55,72,2846.58,5279.01,0.00
2024-12-10 17:38:09,126,4628,55,71,2865.38,5279.06,0.00
2024-12-10 17:38:09,125,4628,54,71,2861.27,5279.29,0.00
2024-12-10 17:38:09,125,4629,54,71,2905.52,5280.00,0.00
2024-12-10 17:38:09,126,4629,54,72,2882.46,5280.01,0.00
2024-12-10 17:38:09,125,4629,54,71,2901.92,5280.06,0.00
2024-12-10 17:38:09,124,4629,53,71,2897.84,5280.19,0.00
2024-12-10 17:38:09,125,4628,53,72,2847.88,5280.72,0.00
2024-12-10 17:38:09,125,4629,53,72,2883.13,5281.00,0.00
2024-12-10 17:38:09,126,4629,54,72,2860.24,5281.01,0.00
2024-12-10 17:38:09,125,4629,54,71,2878.29,5281.06,0.00
2024-12-10 17:38:09,124,4629,53,71,2861.79,5281.56,0.00
2024-12-10 17:38:09,124,4630,53,71,2921.42,5282.00,0.00
2024-12-10 17:38:09,125,4630,54,71,2898.05,5282.01,0.00
2024-12-10 17:38:09,124,4630,54,70,2913.64,5282.07,0.00
2024-12-10 17:38:09,124,4631,54,70,2884.13,5283.00,0.00
2024-12-10 17:38:09,125,4631,54,71,2861.06,5283.01,0.00
2024-12-10 17:38:09,124,4631,54,70,2881.63,5283.04,0.00
2024-12-10 17:38:09,123,4631,53,70,2903.42,5283.07,0.00
2024-12-10 17:38:09,122,4631,53,69,2923.32,5283.07,0.00
2024-12-10 17:38:09,122,4632,53,69,2892.21,5284.00,0.00
2024-12-10 17:38:09,123,4632,53,70,2868.70,5284.01,0.00
2024-12-10 17:38:09,122,4632,52,70,2889.20,5284.06,0.00
2024-12-10 17:38:09,121,4632,51,70,2859.75,5284.77,0.00
2024-12-10 17:38:09,121,4633,51,70,2887.64,5285.00,0.00
2024-12-10 17:38:09,122,4633,52,70,2863.97,5285.01,0.00
2024-12-10 17:38:09,121,4633,52,69,2867.52,5285.12,0.00
2024-12-10 17:38:09,122,4632,52,70,2830.28,5285.38,0.00
2024-12-10 17:38:09,121,4632,51,70,2854.25,5285.78,0.00
2024-12-10 17:38:09,121,4633,51,70,2880.88,5286.00,0.00
2024-12-10 17:38:09,122,4633,52,70,2857.27,5286.01,0.00
2024-12-10 17:38:09,122,4634,52,70,2863.66,5287.00,0.00
2024-12-10 17:38:09,123,4634,52,71,2840.38,5287.01,0.00
2024-12-10 17:38:09,124,4633,52,72,2816.62,5287.04,0.00
2024-12-10 17:38:09,123,4633,52,71,2844.31,5287.09,0.00
2024-12-10 17:38:09,123,4634,52,71,2818.54,5288.00,0.00
2024-12-10 17:38:09,124,4634,53,71,2795.81,5288.01,0.00
2024-12-10 17:38:09,123,4634,53,70,2812.11,5288.07,0.00
2024-12-10 17:38:09,122,4634,53,69,2833.34,5288.10,0.00
2024-12-10 17:38:09,123,4633,53,70,2790.66,5288.49,0.00
2024-12-10 17:38:09,124,4632,54,70,2786.08,5288.52,0.00
2024-12-10 17:38:09,124,4633,54,70,2833.18,5289.00,0.00
2024-12-10 17:38:09,125,4633,54,71,2810.51,5289.01,0.00
2024-12-10 17:38:09,124,4633,54,70,2816.79,5289.15,0.00
2024-12-10 17:38:09,125,4632,55,70,2745.88,5289.78,0.00
2024-12-10 17:38:09,125,4633,55,70,2869.20,5290.00,0.00
2024-12-10 17:38:09,126,4633,56,70,2846.43,5290.01,0.00
2024-12-10 17:38:09,125,4633,56,69,2857.37,5290.07,0.00
2024-12-10 17:38:09,126,4632,57,69,2831.36,5290.15,0.00
2024-12-10 17:38:09,125,4632,56,69,2880.31,5290.31,0.00
2024-12-10 17:38:09,126,4631,57,69,2806.50,5290.89,0.00
2024-12-10 17:38:09,126,4632,57,69,2888.48,5291.00,0.00
2024-12-10 17:38:09,127,4632,58,69,2865.74,5291.01,0.00
2024-12-10 17:38:09,126,4632,57,69,2888.06,5291.01,0.00
2024-12-10 17:38:09,127,4631,58,69,2849.12,5291.17,0.00
2024-12-10 17:38:09,126,4631,58,68,2867.46,5291.47,0.00
2024-12-10 17:38:09,126,4632,58,68,2961.05,5292.00,0.00
2024-12-10 17:38:09,127,4632,58,69,2937.73,5292.01,0.00
2024-12-10 17:38:09,128,4631,59,69,2902.40,5292.10,0.00
2024-12-10 17:38:09,129,4630,59,70,2873.94,5292.54,0.00
2024-12-10 17:38:09,130,4629,60,70,2858.90,5292.72,0.00
2024-12-10 17:38:09,130,4630,60,70,2927.98,5293.00,0.00
2024-12-10 17:38:09,131,4630,60,71,2905.63,5293.01,0.00
2024-12-10 17:38:09,132,4629,60,72,2851.32,5293.49,0.00
2024-12-10 17:38:09,132,4630,60,72,2995.60,5294.00,0.00
2024-12-10 17:38:09,133,4630,61,72,2973.08,5294.01,0.00
2024-12-10 17:38:09,132,4630,60,72,2994.03,5294.03,0.00
2024-12-10 17:38:09,131,4630,60,71,3016.08,5294.04,0.00
2024-12-10 17:38:09,130,4630,60,70,3030.73,5294.05,0.00
2024-12-10 17:38:10,130,4630,60,70,3045.50,5295.00,0.00
2024-12-10 17:38:10,131,4630,60,71,3022.25,5295.01,0.00
2024-12-10 17:38:10,130,4630,60,70,3041.45,5295.05,0.00
2024-12-10 17:38:10,131,4629,60,71,2974.79,5295.59,0.00
2024-12-10 17:38:10,131,4630,60,71,3007.01,5296.00,0.00
2024-12-10 17:38:10,132,4630,61,71,2984.23,5296.01,0.00
2024-12-10 17:38:10,133,4629,61,72,2943.54,5296.22,0.00
2024-12-10 17:38:10,132,4629,60,72,2980.33,5296.32,0.00
2024-12-10 17:38:10,132,4630,60,72,3021.41,5297.00,0.00
2024-12-10 17:38:10,133,4630,61,72,2998.69,5297.01,0.00
2024-12-10 17:38:10,133,4631,61,72,3013.45,5298.00,0.00
2024-12-10 17:38:10,134,4631,61,73,2990.96,5298.01,0.00
2024-12-10 17:38:10,134,4632,61,73,2962.29,5299.00,0.00
2024-12-10 17:38:10,135,4632,62,73,2940.35,5299.01,0.00
2024-12-10 17:38:10,136,4631,62,74,2908.23,5299.07,0.00
2024-12-10 17:38:10,136,4632,62,74,2923.27,5300.00,0.00
2024-12-10 17:38:10,137,4632,62,75,2901.93,5300.01,0.00
2024-12-10 17:38:10,136,4632,62,74,2915.88,5300.05,0.00
2024-12-10 17:38:10,135,4632,61,74,2922.66,5300.33,0.00
2024-12-10 17:38:10,134,4632,60,74,2902.67,5300.90,0.00
2024-12-10 17:38:10,134,4633,60,74,2976.72,5301.00,0.00
2024-12-10 17:38:10,135,4633,61,74,2954.68,5301.01,0.00
2024-12-10 17:38:10,134,4633,60,74,2975.56,5301.02,0.00
2024-12-10 17:38:10,134,4634,60,74,2952.25,5302.00,0.00
2024-12-10 17:38:10,135,4634,61,74,2930.38,5302.01,0.00
2024-12-10 17:38:10,136,4633,61,75,2908.45,5302.03,0.00
2024-12-10 17:38:10,135,4633,60,75,2912.02,5302.33,0.00
2024-12-10 17:38:10,135,4634,60,75,2911.18,5303.00,0.00
2024-12-10 17:38:10,136,4634,61,75,2889.78,5303.01,0.00
2024-12-10 17:38:10,135,4634,60,75,2900.60,5303.05,0.00
2024-12-10 17:38:10,134,4634,59,75,2907.68,5303.32,0.00
2024-12-10 17:38:10,134,4635,59,75,2942.51,5304.00,0.00
2024-12-10 17:38:10,135,4635,60,75,2920.71,5304.01,0.00
2024-12-10 17:38:10,136,4634,61,75,2851.02,5304.72,0.00
2024-12-10 17:38:10,136,4635,61,75,2867.43,5305.00,0.00
2024-12-10 17:38:10,137,4635,62,75,2846.50,5305.01,0.00
2024-12-10 17:38:10,138,4634,62,76,2825.87,5305.02,0.00
2024-12-10 17:38:10,137,4634,62,75,2858.14,5305.05,0.00
2024-12-10 17:38:10,136,4634,62,74,2878.76,5305.05,0.00
2024-12-10 17:38:10,135,4634,61,74,2875.19,5305.47,0.00
2024-12-10 17:38:10,134,4634,60,74,2877.26,5305.84,0.00
2024-12-10 17:38:10,134,4635,60,74,2932.04,5306.00,0.00
2024-12-10 17:38:10,135,4635,61,74,2910.32,5306.01,0.00
2024-12-10 17:38:10,134,4635,60,74,2929.68,5306.05,0.00
2024-12-10 17:38:10,135,4634,60,75,2849.93,5306.94,0.00
2024-12-10 17:38:10,135,4635,60,75,2927.41,5307.00,0.00
2024-12-10 17:38:10,136,4635,61,75,2905.89,5307.01,0.00
2024-12-10 17:38:10,135,4635,60,75,2901.58,5307.34,0.00
2024-12-10 17:38:10,134,4635,59,75,2896.62,5307.73,0.00
2024-12-10 17:38:10,134,4636,59,75,2961.80,5308.00,0.00
2024-12-10 17:38:10,135,4636,60,75,2939.86,5308.01,0.00
2024-12-10 17:38:10,134,4636,60,74,2959.05,5308.05,0.00
2024-12-10 17:38:10,134,4637,60,74,2929.95,5309.00,0.00
2024-12-10 17:38:10,135,4637,60,75,2908.25,5309.01,0.00
2024-12-10 17:38:10,134,4637,60,74,2927.21,5309.05,0.00
2024-12-10 17:38:10,133,4637,59,74,2920.76,5309.44,0.00
2024-12-10 17:38:10,134,4636,60,74,2877.71,5309.83,0.00
2024-12-10 17:38:10,134,4637,60,74,2898.46,5310.00,0.00
2024-12-10 17:38:10,135,4637,60,75,2876.99,5310.01,0.00
2024-12-10 17:38:10,134,4637,59,75,2895.71,5310.05,0.00
2024-12-10 17:38:10,133,4637,59,74,2916.69,5310.05,0.00
2024-12-10 17:38:10,132,4637,58,74,2874.95,5310.98,0.00
2024-12-10 17:38:10,132,4638,58,74,2954.22,5311.00,0.00
2024-12-10 17:38:10,133,4638,59,74,2932.01,5311.01,0.00
2024-12-10 17:38:10,132,4638,59,73,2950.23,5311.06,0.00
2024-12-10 17:38:10,133,4637,60,73,2893.82,5311.42,0.00
2024-12-10 17:38:10,133,4638,60,73,2922.05,5312.00,0.00
2024-12-10 17:38:10,134,4638,61,73,2900.24,5312.01,0.00
2024-12-10 17:38:10,133,4638,60,73,2912.08,5312.02,0.00
2024-12-10 17:38:10,132,4638,60,72,2932.54,5312.05,0.00
2024-12-10 17:38:10,131,4638,60,71,2953.71,5312.05,0.00
2024-12-10 17:38:10,130,4638,59,71,2958.68,5312.38,0.00
2024-12-10 17:38:10,130,4639,59,71,3004.51,5313.00,0.00
2024-12-10 17:38:10,131,4639,60,71,2981.58,5313.01,0.00
2024-12-10 17:38:10,130,4639,60,70,3001.27,5313.05,0.00
2024-12-10 17:38:10,129,4639,60,69,3012.43,5313.27,0.00
2024-12-10 17:38:10,128,4639,59,69,3016.48,5313.44,0.00
2024-12-10 17:38:10,128,4640,59,69,3026.10,5314.00,0.00
2024-12-10 17:38:10,129,4640,60,69,3002.64,5314.01,0.00
2024-12-10 17:38:10,128,4640,60,68,3020.31,5314.07,0.00
2024-12-10 17:38:10,128,4641,60,68,2994.25,5315.00,0.00
2024-12-10 17:38:10,129,4641,61,68,2971.04,5315.01,0.00
2024-12-10 17:38:10,128,4641,61,67,2988.46,5315.07,0.00
2024-12-10 17:38:10,127,4641,60,67,3007.40,5315.09,0.00
2024-12-10 17:38:10,127,4642,60,67,2997.83,5316.00,0.00
2024-12-10 17:38:10,128,4642,60,68,2974.41,5316.01,0.00
2024-12-10 17:38:10,127,4642,60,67,2995.34,5316.05,0.00
2024-12-10 17:38:10,126,4642,60,66,3015.74,5316.06,0.00
2024-12-10 17:38:10,126,4643,60,66,2987.55,5317.00,0.00
2024-12-10 17:38:10,127,4643,60,67,2964.03,5317.01,0.00
2024-12-10 17:38:10,126,4643,60,66,2979.57,5317.08,0.00
2024-12-10 17:38:10,125,4643,59,66,2977.10,5317.29,0.00
2024-12-10 17:38:11,125,4644,59,66,2977.92,5318.00,0.00
2024-12-10 17:38:11,126,4644,60,66,2954.28,5318.01,0.00
2024-12-10 17:38:11,125,4644,59,66,2974.96,5318.06,0.00
2024-12-10 17:38:11,126,4643,60,66,2888.59,5318.87,0.00
2024-12-10 17:38:11,126,4644,60,66,2929.66,5319.00,0.00
2024-12-10 17:38:11,127,4644,61,66,2906.59,5319.01,0.00
2024-12-10 17:38:11,126,4644,60,66,2897.64,5319.45,0.00
2024-12-10 17:38:11,126,4645,60,66,2935.03,5320.00,0.00
2024-12-10 17:38:11,127,4645,60,67,2911.92,5320.01,0.00
2024-12-10 17:38:11,126,4645,59,67,2909.39,5320.33,0.00
2024-12-10 17:38:11,126,4646,59,67,2891.95,5321.00,0.00
2024-12-10 17:38:11,127,4646,60,67,2869.18,5321.01,0.00
2024-12-10 17:38:11,126,4646,60,66,2885.65,5321.09,0.00
2024-12-10 17:38:11,125,4646,59,66,2894.35,5321.35,0.00
2024-12-10 17:38:11,126,4645,59,67,2838.07,5321.88,0.00
2024-12-10 17:38:11,126,4646,59,67,2862.25,5322.00,0.00
2024-12-10 17:38:11,127,4646,60,67,2839.71,5322.01,0.00
2024-12-10 17:38:11,126,4646,60,66,2853.84,5322.09,0.00
2024-12-10 17:38:11,125,4646,60,65,2853.35,5322.51,0.00
2024-12-10 17:38:11,125,4647,60,65,2892.56,5323.00,0.00
2024-12-10 17:38:11,126,4647,60,66,2869.60,5323.01,0.00
2024-12-10 17:38:11,125,4647,60,65,2884.50,5323.09,0.00
2024-12-10 17:38:11,125,4648,60,65,2857.51,5324.00,0.00
2024-12-10 17:38:11,126,4648,61,65,2834.83,5324.01,0.00
2024-12-10 17:38:11,125,4648,61,64,2832.41,5324.09,0.00
2024-12-10 17:38:11,125,4649,61,64,2819.80,5325.00,0.00
2024-12-10 17:38:11,126,4649,61,65,2797.42,5325.01,0.00
2024-12-10 17:38:11,125,4649,61,64,2811.31,5325.09,0.00
2024-12-10 17:38:11,125,4650,61,64,2781.67,5326.00,0.00
2024-12-10 17:38:11,126,4650,62,64,2759.60,5326.01,0.00
2024-12-10 17:38:11,125,4650,62,63,2772.33,5326.10,0.00
2024-12-10 17:38:11,124,4650,61,63,2778.40,5326.22,0.00
2024-12-10 17:38:11,125,4649,62,63,2728.68,5326.71,0.00
2024-12-10 17:38:11,125,4650,62,63,2762.69,5327.00,0.00
2024-12-10 17:38:11,126,4650,62,64,2740.77,5327.01,0.00
2024-12-10 17:38:11,125,4650,62,63,2758.88,5327.07,0.00
2024-12-10 17:38:11,124,4650,62,62,2775.12,5327.10,0.00
2024-12-10 17:38:11,123,4650,62,61,2756.18,5327.52,0.00
2024-12-10 17:38:11,123,4651,62,61,2810.76,5328.00,0.00
2024-12-10 17:38:11,124,4651,63,61,2788.10,5328.01,0.00
2024-12-10 17:38:11,123,4651,63,60,2806.89,5328.07,0.00
2024-12-10 17:38:11,122,4651,63,59,2824.22,5328.09,0.00
2024-12-10 17:38:11,122,4652,63,59,2794.63,5329.00,0.00
2024-12-10 17:38:11,123,4652,63,60,2771.90,5329.01,0.00
2024-12-10 17:38:11,122,4652,62,60,2788.09,5329.05,0.00
2024-12-10 17:38:11,121,4652,62,59,2804.97,5329.08,0.00
2024-12-10 17:38:11,122,4651,63,59,2750.63,5329.66,0.00
2024-12-10 17:38:11,122,4652,63,59,2783.57,5330.00,0.00
2024-12-10 17:38:11,123,4652,64,59,2760.94,5330.01,0.00
2024-12-10 17:38:11,122,4652,63,59,2730.37,5330.71,0.00
2024-12-10 17:38:11,122,4653,63,59,2795.27,5331.00,0.00
2024-12-10 17:38:11,123,4653,63,60,2772.55,5331.01,0.00
2024-12-10 17:38:11,122,4653,62,60,2771.57,5331.29,0.00
2024-12-10 17:38:11,121,4653,61,60,2793.16,5331.31,0.00
2024-12-10 17:38:11,121,4654,61,60,2784.45,5332.00,0.00
2024-12-10 17:38:11,122,4654,61,61,2761.63,5332.01,0.00
2024-12-10 17:38:11,121,4654,61,60,2772.14,5332.10,0.00
2024-12-10 17:38:11,122,4653,62,60,2714.93,5332.69,0.00
2024-12-10 17:38:11,122,4654,62,60,2751.05,5333.00,0.00
2024-12-10 17:38:11,123,4654,62,61,2728.68,5333.01,0.00
2024-12-10 17:38:11,122,4654,62,60,2741.02,5333.10,0.00
2024-12-10 17:38:11,121,4654,61,60,2734.65,5333.31,0.00
2024-12-10 17:38:11,121,4655,61,60,2780.33,5334.00,0.00
2024-12-10 17:38:11,122,4655,62,60,2757.54,5334.01,0.00
2024-12-10 17:38:11,121,4655,61,60,2776.82,5334.07,0.00
2024-12-10 17:38:11,120,4655,60,60,2782.58,5334.23,0.00
2024-12-10 17:38:11,120,4656,60,60,2765.50,5335.00,0.00
2024-12-10 17:38:11,121,4656,60,61,2742.64,5335.01,0.00
2024-12-10 17:38:11,120,4656,59,61,2764.17,5335.03,0.00
2024-12-10 17:38:11,119,4656,58,61,2785.17,5335.06,0.00
2024-12-10 17:38:11,118,4656,58,60,2759.35,5335.63,0.00
2024-12-10 17:38:11,119,4655,59,60,2727.31,5335.81,0.00
2024-12-10 17:38:11,119,4656,59,60,2752.50,5336.00,0.00
2024-12-10 17:38:11,120,4656,59,61,2729.56,5336.01,0.00
2024-12-10 17:38:11,119,4656,59,60,2747.59,5336.08,0.00
2024-12-10 17:38:11,119,4657,59,60,2764.87,5337.00,0.00
2024-12-10 17:38:11,120,4657,59,61,2741.83,5337.01,0.00
2024-12-10 17:38:11,119,4657,58,61,2756.37,5337.06,0.00
2024-12-10 17:38:11,118,4657,58,60,2753.02,5337.39,0.00
2024-12-10 17:38:11,117,4657,57,60,2762.37,5337.54,0.00
2024-12-10 17:38:11,117,4658,57,60,2783.69,5338.00,0.00
2024-12-10 17:38:11,118,4658,57,61,2760.10,5338.01,0.00
2024-12-10 17:38:11,119,4657,58,61,2705.64,5338.45,0.00
2024-12-10 17:38:11,119,4658,58,61,2745.16,5339.00,0.00
2024-12-10 17:38:11,120,4658,59,61,2722.28,5339.01,0.00
2024-12-10 17:38:11,119,4658,59,60,2737.55,5339.07,0.00
2024-12-10 17:38:11,118,4658,58,60,2721.63,5339.79,0.00
2024-12-10 17:38:11,118,4659,58,60,2782.89,5340.00,0.00
2024-12-10 17:38:11,119,4659,58,61,2759.50,5340.01,0.00
2024-12-10 17:38:11,118,4659,58,60,2776.12,5340.07,0.00
2024-12-10 17:38:11,119,4658,58,61,2742.07,5340.29,0.00
2024-12-10 17:38:11,119,4659,58,61,2758.84,5341.00,0.00
2024-12-10 17:38:11,120,4659,59,61,2735.85,5341.01,0.00
2024-12-10 17:38:11,121,4658,60,61,2711.49,5341.06,0.00
2024-12-10 17:38:11,120,4658,60,60,2749.23,5341.08,0.00
2024-12-10 17:38:11,119,4658,59,60,2757.07,5341.35,0.00
2024-12-10 17:38:11,120,4657,59,61,2721.44,5341.59,0.00
2024-12-10 17:38:11,120,4658,59,61,2787.37,5342.00,0.00
2024-12-10 17:38:11,121,4658,59,62,2764.34,5342.01,0.00
2024-12-10 17:38:11,120,4658,58,62,2784.28,5342.06,0.00
2024-12-10 17:38:11,119,4658,58,61,2804.09,5342.07,0.00
2024-12-10 17:38:12,118,4658,57,61,2813.90,5342.32,0.00
2024-12-10 17:38:12,117,4658,56,61,2811.64,5342.56,0.00
2024-12-10 17:38:12,117,4659,56,61,2923.89,5343.00,0.00
2024-12-10 17:38:12,118,4659,57,61,2899.12,5343.01,0.00
2024-12-10 17:38:12,117,4659,56,61,2913.39,5343.01,0.00
2024-12-10 17:38:12,116,4659,56,60,2927.94,5343.06,0.00
2024-12-10 17:38:12,116,4660,56,60,2921.20,5344.00,0.00
2024-12-10 17:38:12,117,4660,57,60,2896.23,5344.01,0.00
2024-12-10 17:38:12,116,4660,57,59,2914.31,5344.07,0.00
2024-12-10 17:38:12,115,4660,56,59,2916.75,5344.48,0.00
2024-12-10 17:38:12,116,4659,57,59,2849.04,5344.87,0.00
2024-12-10 17:38:12,116,4660,57,59,2892.93,5345.00,0.00
2024-12-10 17:38:12,117,4660,58,59,2868.20,5345.01,0.00
2024-12-10 17:38:12,116,4660,57,59,2892.01,5345.02,0.00
2024-12-10 17:38:12,115,4660,56,59,2878.66,5345.27,0.00
2024-12-10 17:38:12,115,4661,56,59,2924.55,5346.00,0.00
2024-12-10 17:38:12,116,4661,56,60,2899.34,5346.01,0.00
2024-12-10 17:38:12,115,4661,56,59,2916.67,5346.06,0.00
2024-12-10 17:38:12,115,4662,56,59,2884.59,5347.00,0.00
2024-12-10 17:38:12,116,4662,57,59,2859.73,5347.01,0.00
2024-12-10 17:38:12,115,4662,57,58,2878.57,5347.06,0.00
2024-12-10 17:38:12,115,4663,57,58,2844.47,5348.00,0.00
2024-12-10 17:38:12,116,4663,58,58,2819.95,5348.01,0.00
2024-12-10 17:38:12,115,4663,58,57,2838.45,5348.06,0.00
2024-12-10 17:38:12,115,4664,58,57,2802.30,5349.00,0.00
2024-12-10 17:38:12,116,4664,58,58,2778.14,5349.01,0.00
2024-12-10 17:38:12,115,4664,58,57,2796.27,5349.06,0.00
2024-12-10 17:38:12,115,4665,58,57,2757.23,5350.00,0.00
2024-12-10 17:38:12,116,4665,59,57,2733.46,5350.01,0.00
2024-12-10 17:38:12,115,4665,59,56,2754.46,5350.05,0.00
2024-12-10 17:38:12,114,4665,59,55,2770.82,5350.06,0.00
2024-12-10 17:38:12,113,4665,58,55,2789.01,5350.18,0.00
2024-12-10 17:38:12,112,4665,58,54,2807.59,5350.28,0.00
2024-12-10 17:38:12,111,4665,57,54,2830.97,5350.31,0.00
2024-12-10 17:38:12,110,4665,56,54,2855.74,5350.32,0.00
2024-12-10 17:38:12,109,4665,55,54,2852.90,5350.69,0.00
2024-12-10 17:38:12,108,4665,54,54,2874.79,5350.71,0.00
2024-12-10 17:38:12,108,4666,54,54,2909.19,5351.00,0.00
2024-12-10 17:38:12,109,4666,55,54,2882.50,5351.01,0.00
2024-12-10 17:38:12,110,4665,56,54,2831.47,5351.20,0.00
2024-12-10 17:38:12,109,4665,55,54,2881.02,5351.20,0.00
2024-12-10 17:38:12,108,4665,55,53,2882.55,5351.65,0.00
2024-12-10 17:38:12,108,4666,55,53,2913.54,5352.00,0.00
2024-12-10 17:38:12,109,4666,56,53,2886.81,5352.01,0.00
2024-12-10 17:38:12,109,4667,56,53,2896.38,5353.00,0.00
2024-12-10 17:38:12,110,4667,56,54,2870.05,5353.01,0.00
2024-12-10 17:38:12,109,4667,56,53,2888.99,5353.06,0.00
2024-12-10 17:38:12,108,4667,55,53,2906.41,5353.23,0.00
2024-12-10 17:38:12,108,4668,55,53,2895.48,5354.00,0.00
2024-12-10 17:38:12,109,4668,55,54,2868.92,5354.01,0.00
2024-12-10 17:38:12,108,4668,55,53,2888.00,5354.07,0.00
2024-12-10 17:38:12,108,4669,55,53,2868.18,5355.00,0.00
2024-12-10 17:38:12,109,4669,55,54,2841.87,5355.01,0.00
2024-12-10 17:38:12,108,4669,55,53,2861.26,5355.07,0.00
2024-12-10 17:38:12,107,4669,54,53,2850.91,5355.75,0.00
2024-12-10 17:38:12,107,4670,54,53,2867.62,5356.00,0.00
2024-12-10 17:38:12,108,4670,54,54,2841.07,5356.01,0.00
2024-12-10 17:38:12,107,4670,54,53,2858.27,5356.08,0.00
2024-12-10 17:38:12,106,4670,53,53,2878.88,5356.12,0.00
2024-12-10 17:38:12,106,4671,53,53,2882.09,5357.00,0.00
2024-12-10 17:38:12,107,4671,53,54,2855.16,5357.01,0.00
2024-12-10 17:38:12,106,4671,53,53,2871.59,5357.08,0.00
2024-12-10 17:38:12,106,4672,53,53,2851.85,5358.00,0.00
2024-12-10 17:38:12,107,4672,53,54,2825.20,5358.01,0.00
2024-12-10 17:38:12,106,4672,52,54,2834.67,5358.02,0.00
2024-12-10 17:38:12,105,4672,51,54,2859.91,5358.05,0.00
2024-12-10 17:38:12,104,4672,51,53,2881.23,5358.06,0.00
2024-12-10 17:38:12,105,4671,51,54,2811.63,5358.87,0.00
2024-12-10 17:38:12,105,4672,51,54,2882.68,5359.00,0.00
2024-12-10 17:38:12,106,4672,52,54,2855.49,5359.01,0.00
2024-12-10 17:38:12,105,4672,51,54,2854.72,5359.33,0.00
2024-12-10 17:38:12,104,4672,50,54,2853.23,5359.54,0.00
2024-12-10 17:38:12,105,4671,50,55,2813.96,5359.78,0.00
2024-12-10 17:38:12,105,4672,50,55,2913.67,5360.00,0.00
2024-12-10 17:38:12,106,4672,50,56,2886.19,5360.01,0.00
2024-12-10 17:38:12,105,4672,50,55,2904.50,5360.06,0.00
2024-12-10 17:38:12,105,4673,50,55,2934.76,5361.00,0.00
2024-12-10 17:38:12,106,4673,50,56,2907.08,5361.01,0.00
2024-12-10 17:38:12,105,4673,50,55,2926.10,5361.07,0.00
2024-12-10 17:38:12,106,4672,50,56,2897.00,5361.11,0.00
2024-12-10 17:38:12,105,4672,49,56,2957.78,5361.11,0.00
2024-12-10 17:38:12,104,4672,48,56,2958.81,5361.63,0.00
2024-12-10 17:38:12,104,4673,48,56,2990.55,5362.00,0.00
2024-12-10 17:38:12,105,4673,49,56,2962.07,5362.01,0.00
2024-12-10 17:38:12,104,4673,48,56,2957.05,5362.34,0.00
2024-12-10 17:38:12,104,4674,48,56,3025.03,5363.00,0.00
2024-12-10 17:38:12,105,4674,49,56,2996.22,5363.01,0.00
2024-12-10 17:38:12,105,4675,49,56,2975.05,5364.00,0.00
2024-12-10 17:38:12,106,4675,50,56,2946.98,5364.01,0.00
2024-12-10 17:38:12,105,4675,50,55,2973.53,5364.03,0.00
2024-12-10 17:38:12,104,4675,50,54,3001.09,5364.04,0.00
2024-12-10 17:38:12,105,4674,51,54,2956.71,5364.16,0.00
2024-12-10 17:38:12,105,4675,51,54,2979.56,5365.00,0.00
2024-12-10 17:38:12,106,4675,51,55,2951.45,5365.01,0.00
2024-12-10 17:38:12,105,4675,51,54,2968.84,5365.06,0.00
2024-12-10 17:38:12,104,4675,50,54,2983.04,5365.32,0.00
2024-12-10 17:38:12,104,4676,50,54,3028.39,5366.00,0.00
2024-12-10 17:38:12,105,4676,50,55,2999.55,5366.01,0.00
2024-12-10 17:38:12,105,4677,50,55,2979.17,5367.00,0.00
2024-12-10 17:38:12,106,4677,50,56,2951.06,5367.01,0.00
2024-12-10 17:38:12,106,4678,50,56,2925.89,5368.00,0.00
2024-12-10 17:38:12,107,4678,51,56,2898.55,5368.01,0.00
2024-12-10 17:38:12,106,4678,50,56,2886.94,5368.39,0.00
2024-12-10 17:38:13,106,4679,50,56,2903.47,5369.00,0.00
2024-12-10 17:38:13,107,4679,51,56,2876.34,5369.01,0.00
2024-12-10 17:38:13,106,4679,51,55,2892.25,5369.06,0.00
2024-12-10 17:38:13,107,4678,51,56,2864.22,5369.09,0.00
2024-12-10 17:38:13,107,4679,51,56,2877.49,5370.00,0.00
2024-12-10 17:38:13,108,4679,52,56,2850.84,5370.01,0.00
2024-12-10 17:38:13,107,4679,52,55,2869.48,5370.07,0.00
2024-12-10 17:38:13,108,4678,52,56,2837.47,5370.19,0.00
2024-12-10 17:38:13,108,4679,52,56,2909.63,5371.00,0.00
2024-12-10 17:38:13,109,4679,53,56,2882.94,5371.01,0.00
2024-12-10 17:38:13,109,4680,53,56,2910.76,5372.00,0.00
2024-12-10 17:38:13,110,4680,53,57,2884.30,5372.01,0.00
2024-12-10 17:38:13,110,4681,53,57,2863.17,5373.00,0.00
2024-12-10 17:38:13,111,4681,54,57,2837.38,5373.01,0.00
2024-12-10 17:38:13,110,4681,53,57,2827.10,5373.48,0.00
2024-12-10 17:38:13,110,4682,53,57,2839.98,5374.00,0.00
2024-12-10 17:38:13,111,4682,54,57,2814.39,5374.01,0.00
2024-12-10 17:38:13,110,4682,53,57,2837.55,5374.05,0.00
2024-12-10 17:38:13,110,4683,53,57,2807.76,5375.00,0.00
2024-12-10 17:38:13,111,4683,53,58,2782.46,5375.01,0.00
2024-12-10 17:38:13,110,4683,53,57,2798.00,5375.06,0.00
2024-12-10 17:38:13,111,4682,53,58,2768.45,5375.15,0.00
2024-12-10 17:38:13,110,4682,53,57,2830.45,5375.18,0.00
2024-12-10 17:38:13,111,4681,54,57,2791.96,5375.44,0.00
2024-12-10 17:38:13,111,4682,54,57,2815.20,5376.00,0.00
2024-12-10 17:38:13,112,4682,55,57,2790.06,5376.01,0.00
2024-12-10 17:38:13,111,4682,55,56,2808.92,5376.05,0.00
2024-12-10 17:38:13,110,4682,54,56,2808.62,5376.25,0.00
2024-12-10 17:38:13,109,4682,53,56,2829.98,5376.34,0.00
2024-12-10 17:38:13,109,4683,53,56,2937.50,5377.00,0.00
2024-12-10 17:38:13,110,4683,53,57,2910.79,5377.01,0.00
2024-12-10 17:38:13,109,4683,53,56,2930.61,5377.06,0.00
2024-12-10 17:38:13,109,4684,53,56,2902.24,5378.00,0.00
2024-12-10 17:38:13,110,4684,53,57,2875.85,5378.01,0.00
2024-12-10 17:38:13,109,4684,53,56,2894.85,5378.06,0.00
2024-12-10 17:38:13,108,4684,52,56,2912.26,5378.22,0.00
2024-12-10 17:38:13,108,4685,52,56,2891.82,5379.00,0.00
2024-12-10 17:38:13,109,4685,53,56,2865.29,5379.01,0.00
2024-12-10 17:38:13,108,4685,53,55,2882.88,5379.07,0.00
2024-12-10 17:38:13,107,4685,52,55,2864.41,5379.61,0.00
2024-12-10 17:38:13,107,4686,52,55,2886.09,5380.00,0.00
2024-12-10 17:38:13,108,4686,52,56,2859.37,5380.01,0.00
2024-12-10 17:38:13,107,4686,51,56,2812.70,5380.75,0.00
2024-12-10 17:38:13,107,4687,51,56,2843.74,5381.00,0.00
2024-12-10 17:38:13,108,4687,51,57,2817.41,5381.01,0.00
2024-12-10 17:38:13,107,4687,51,56,2832.73,5381.13,0.00
2024-12-10 17:38:13,106,4687,50,56,2809.56,5381.59,0.00
2024-12-10 17:38:13,107,4686,51,56,2783.30,5381.61,0.00
2024-12-10 17:38:13,107,4687,51,56,2822.30,5382.00,0.00
2024-12-10 17:38:13,108,4687,52,56,2796.16,5382.01,0.00
2024-12-10 17:38:13,107,4687,52,55,2808.76,5382.13,0.00
2024-12-10 17:38:13,106,4687,51,55,2808.38,5382.26,0.00
2024-12-10 17:38:13,107,4686,51,56,2748.93,5382.79,0.00
2024-12-10 17:38:13,107,4687,51,56,2838.69,5383.00,0.00
2024-12-10 17:38:13,108,4687,51,57,2812.40,5383.01,0.00
2024-12-10 17:38:13,107,4687,51,56,2825.65,5383.13,0.00
2024-12-10 17:38:13,106,4687,51,55,2841.44,5383.20,0.00
2024-12-10 17:38:13,105,4687,50,55,2825.36,5383.61,0.00
2024-12-10 17:38:13,105,4688,50,55,2895.07,5384.00,0.00
2024-12-10 17:38:13,106,4688,50,56,2867.76,5384.01,0.00
2024-12-10 17:38:13,105,4688,49,56,2885.33,5384.01,0.00
2024-12-10 17:38:13,106,4687,50,56,2790.67,5384.88,0.00
2024-12-10 17:38:13,106,4688,50,56,2854.11,5385.00,0.00
2024-12-10 17:38:13,107,4688,50,57,2827.44,5385.01,0.00
2024-12-10 17:38:13,106,4688,49,57,2827.87,5385.16,0.00
2024-12-10 17:38:13,105,4688,48,57,2818.00,5385.73,0.00
2024-12-10 17:38:13,105,4689,48,57,2896.57,5386.00,0.00
2024-12-10 17:38:13,106,4689,49,57,2869.24,5386.01,0.00
2024-12-10 17:38:13,105,4689,49,56,2888.40,5386.12,0.00
2024-12-10 17:38:13,104,4689,48,56,2845.38,5386.88,0.00
2024-12-10 17:38:13,104,4690,48,56,2890.55,5387.00,0.00
2024-12-10 17:38:13,105,4690,49,56,2863.02,5387.01,0.00
2024-12-10 17:38:13,104,4690,49,55,2877.64,5387.14,0.00
2024-12-10 17:38:13,103,4690,48,55,2878.95,5387.28,0.00
2024-12-10 17:38:13,102,4690,48,54,2904.10,5387.28,0.00
2024-12-10 17:38:13,101,4690,47,54,2906.38,5387.76,0.00
2024-12-10 17:38:13,101,4691,47,54,2947.09,5388.00,0.00
2024-12-10 17:38:13,102,4691,48,54,2918.20,5388.01,0.00
2024-12-10 17:38:13,101,4691,47,54,2944.44,5388.05,0.00
2024-12-10 17:38:13,100,4691,47,53,2959.36,5388.13,0.00
2024-12-10 17:38:13,100,4692,47,53,2945.32,5389.00,0.00
2024-12-10 17:38:13,101,4692,48,53,2916.16,5389.01,0.00
2024-12-10 17:38:13,100,4692,47,53,2943.71,5389.03,0.00
2024-12-10 17:38:13,99,4692,46,53,2971.83,5389.05,0.00
2024-12-10 17:38:13,99,4693,46,53,2952.40,5390.00,0.00
2024-12-10 17:38:13,100,4693,47,53,2922.87,5390.01,0.00
2024-12-10 17:38:13,99,4693,46,53,2949.70,5390.05,0.00
2024-12-10 17:38:13,98,4693,45,53,2959.35,5390.18,0.00
2024-12-10 17:38:13,98,4694,45,53,2967.58,5391.00,0.00
2024-12-10 17:38:13,99,4694,45,54,2937.60,5391.01,0.00
2024-12-10 17:38:13,98,4694,44,54,2964.84,5391.05,0.00
2024-12-10 17:38:13,97,4694,44,53,2987.09,5391.09,0.00
2024-12-10 17:38:13,98,4693,45,53,2938.80,5391.39,0.00
2024-12-10 17:38:13,98,4694,45,53,2987.85,5392.00,0.00
2024-12-10 17:38:13,99,4694,46,53,2957.67,5392.01,0.00
2024-12-10 17:38:13,98,4694,45,53,2984.03,5392.07,0.00
2024-12-10 17:38:13,97,4694,45,52,3006.46,5392.08,0.00
2024-12-10 17:38:13,96,4694,44,52,2989.40,5392.74,0.00
2024-12-10 17:38:13,96,4695,44,52,3087.92,5393.00,0.00
2024-12-10 17:38:13,97,4695,45,52,3056.09,5393.01,0.00
2024-12-10 17:38:13,96,4695,45,51,3086.80,5393.02,0.00
2024-12-10 17:38:13,95,4695,45,50,3106.28,5393.08,0.00
2024-12-10 17:38:13,95,4696,45,50,3084.10,5394.00,0.00
2024-12-10 17:38:13,96,4696,45,51,3051.98,5394.01,0.00
2024-12-10 17:38:13,95,4696,45,50,3069.95,5394.10,0.00
2024-12-10 17:38:13,95,4697,45,50,3050.16,5395.00,0.00
2024-12-10 17:38:13,96,4697,45,51,3018.39,5395.01,0.00
2024-12-10 17:38:14,95,4697,45,50,3021.72,5395.26,0.00
2024-12-10 17:38:14,94,4697,44,50,3053.29,5395.27,0.00
2024-12-10 17:38:14,93,4697,43,50,3078.73,5395.39,0.00
2024-12-10 17:38:14,93,4698,43,50,3104.10,5396.00,0.00
2024-12-10 17:38:14,94,4698,43,51,3071.08,5396.01,0.00
2024-12-10 17:38:14,93,4698,43,50,3086.74,5396.12,0.00
2024-12-10 17:38:14,92,4698,42,50,3098.58,5396.17,0.00
2024-12-10 17:38:14,92,4699,42,50,3110.31,5397.00,0.00
2024-12-10 17:38:14,93,4699,42,51,3076.87,5397.01,0.00
2024-12-10 17:38:14,94,4698,43,51,2990.59,5397.37,0.00
2024-12-10 17:38:14,94,4699,43,51,3041.18,5398.00,0.00
2024-12-10 17:38:14,95,4699,44,51,3009.16,5398.01,0.00
2024-12-10 17:38:14,94,4699,43,51,3033.01,5398.02,0.00
2024-12-10 17:38:14,93,4699,43,50,3056.96,5398.14,0.00
2024-12-10 17:38:14,92,4699,42,50,3083.18,5398.26,0.00
2024-12-10 17:38:14,93,4698,42,51,3028.24,5398.66,0.00
2024-12-10 17:38:14,93,4699,42,51,3158.11,5399.00,0.00
2024-12-10 17:38:14,94,4699,42,52,3124.51,5399.01,0.00
2024-12-10 17:38:14,94,4700,42,52,3164.16,5400.00,0.00
2024-12-10 17:38:14,95,4700,42,53,3130.85,5400.01,0.00
2024-12-10 17:38:14,94,4700,41,53,3147.75,5400.10,0.00
2024-12-10 17:38:14,94,4701,41,53,3154.25,5401.00,0.00
2024-12-10 17:38:14,95,4701,41,54,3121.05,5401.01,0.00
2024-12-10 17:38:14,94,4701,40,54,3123.91,5401.32,0.00
2024-12-10 17:38:14,94,4702,40,54,3141.70,5402.00,0.00
2024-12-10 17:38:14,95,4702,40,55,3108.63,5402.01,0.00
2024-12-10 17:38:14,94,4702,40,54,3133.11,5402.13,0.00
2024-12-10 17:38:14,94,4703,40,54,3116.44,5403.00,0.00
2024-12-10 17:38:14,95,4703,41,54,3083.63,5403.01,0.00
2024-12-10 17:38:14,94,4703,41,53,3101.63,5403.13,0.00
2024-12-10 17:38:14,93,4703,40,53,3117.16,5403.36,0.00
2024-12-10 17:38:14,94,4702,40,54,3073.75,5403.56,0.00
2024-12-10 17:38:14,94,4703,40,54,3127.66,5404.00,0.00
2024-12-10 17:38:14,95,4703,41,54,3094.74,5404.01,0.00
2024-12-10 17:38:14,95,4704,41,54,3116.26,5405.00,0.00
2024-12-10 17:38:14,96,4704,41,55,3083.80,5405.01,0.00
2024-12-10 17:38:14,95,4704,41,54,3104.91,5405.15,0.00
2024-12-10 17:38:14,96,4703,41,55,3052.48,5405.54,0.00
2024-12-10 17:38:14,96,4704,41,55,3056.56,5406.00,0.00
2024-12-10 17:38:14,97,4704,41,56,3025.05,5406.01,0.00
2024-12-10 17:38:14,96,4704,40,56,3041.94,5406.12,0.00
2024-12-10 17:38:14,97,4703,41,56,2957.58,5406.77,0.00
2024-12-10 17:38:14,97,4704,41,56,3064.57,5407.00,0.00
2024-12-10 17:38:14,98,4704,41,57,3033.29,5407.01,0.00
2024-12-10 17:38:14,97,4704,41,56,3054.56,5407.13,0.00
2024-12-10 17:38:14,97,4705,41,56,3087.05,5408.00,0.00
2024-12-10 17:38:14,98,4705,42,56,3055.55,5408.01,0.00
2024-12-10 17:38:14,98,4706,42,56,3017.63,5409.00,0.00
2024-12-10 17:38:14,99,4706,42,57,2987.15,5409.01,0.00
2024-12-10 17:38:14,98,4706,41,57,3013.79,5409.07,0.00
2024-12-10 17:38:14,97,4706,41,56,3032.60,5409.13,0.00
2024-12-10 17:38:14,96,4706,40,56,3047.54,5409.42,0.00
2024-12-10 17:38:14,96,4707,40,56,3061.07,5410.00,0.00
2024-12-10 17:38:14,97,4707,41,56,3029.52,5410.01,0.00
2024-12-10 17:38:14,96,4707,41,55,3056.88,5410.08,0.00
2024-12-10 17:38:14,96,4708,41,55,3014.94,5411.00,0.00
2024-12-10 17:38:14,97,4708,41,56,2983.86,5411.01,0.00
2024-12-10 17:38:14,96,4708,40,56,3011.01,5411.07,0.00
2024-12-10 17:38:14,95,4708,40,55,3037.02,5411.12,0.00
2024-12-10 17:38:14,95,4709,40,55,3005.94,5412.00,0.00
2024-12-10 17:38:14,96,4709,41,55,2974.63,5412.01,0.00
2024-12-10 17:38:14,95,4709,41,54,2944.02,5412.66,0.00
2024-12-10 17:38:14,95,4710,41,54,2960.06,5413.00,0.00
2024-12-10 17:38:14,96,4710,41,55,2929.23,5413.01,0.00
2024-12-10 17:38:14,95,4710,41,54,2951.54,5413.12,0.00
2024-12-10 17:38:14,94,4710,40,54,2970.48,5413.26,0.00
2024-12-10 17:38:14,93,4710,40,53,2987.37,5413.47,0.00
2024-12-10 17:38:14,92,4710,39,53,2982.93,5413.73,0.00
2024-12-10 17:38:14,92,4711,39,53,3026.73,5414.00,0.00
2024-12-10 17:38:14,93,4711,40,53,2994.19,5414.01,0.00
2024-12-10 17:38:14,92,4711,39,53,2985.45,5414.16,0.00
2024-12-10 17:38:14,91,4711,38,53,3013.69,5414.24,0.00
2024-12-10 17:38:14,91,4712,38,53,3028.98,5415.00,0.00
2024-12-10 17:38:14,92,4712,38,54,2996.06,5415.01,0.00
2024-12-10 17:38:14,91,4712,38,53,3020.68,5415.12,0.00
2024-12-10 17:38:14,92,4711,39,53,2963.37,5415.46,0.00
2024-12-10 17:38:14,92,4712,39,53,2988.00,5416.00,0.00
2024-12-10 17:38:14,93,4712,40,53,2955.87,5416.01,0.00
2024-12-10 17:38:14,92,4712,40,52,2977.41,5416.04,0.00
2024-12-10 17:38:14,91,4712,39,52,2998.87,5416.19,0.00
2024-12-10 17:38:14,92,4711,39,53,2927.28,5416.87,0.00
2024-12-10 17:38:14,92,4712,39,53,3026.38,5417.00,0.00
2024-12-10 17:38:14,93,4712,40,53,2993.84,5417.01,0.00
2024-12-10 17:38:14,93,4713,40,53,3015.32,5418.00,0.00
2024-12-10 17:38:14,94,4713,40,54,2983.24,5418.01,0.00
2024-12-10 17:38:14,93,4713,39,54,3011.84,5418.06,0.00
2024-12-10 17:38:14,92,4713,39,53,3036.54,5418.11,0.00
2024-12-10 17:38:14,92,4714,39,53,3019.83,5419.00,0.00
2024-12-10 17:38:14,93,4714,40,53,2987.36,5419.01,0.00
2024-12-10 17:38:14,93,4715,40,53,2953.60,5420.00,0.00
2024-12-10 17:38:14,94,4715,41,53,2922.18,5420.01,0.00
2024-12-10 17:38:14,93,4715,40,53,2947.40,5420.10,0.00
2024-12-10 17:38:14,92,4715,40,52,2967.66,5420.10,0.00
2024-12-10 17:38:14,92,4716,40,52,2948.61,5421.00,0.00
2024-12-10 17:38:14,93,4716,40,53,2916.90,5421.01,0.00
2024-12-10 17:38:14,92,4716,39,53,2945.67,5421.05,0.00
2024-12-10 17:38:14,91,4716,39,52,2963.15,5421.10,0.00
2024-12-10 17:38:14,92,4715,40,52,2908.42,5421.47,0.00
2024-12-10 17:38:14,92,4716,40,52,2935.84,5422.00,0.00
2024-12-10 17:38:14,93,4716,40,53,2904.27,5422.01,0.00
2024-12-10 17:38:14,94,4715,41,53,2831.02,5422.54,0.00
2024-12-10 17:38:14,94,4716,41,53,2932.60,5423.00,0.00
2024-12-10 17:38:14,95,4716,41,54,2901.73,5423.01,0.00
2024-12-10 17:38:14,96,4715,41,55,2870.94,5423.04,0.00
2024-12-10 17:38:15,96,4716,41,55,2954.38,5424.00,0.00
2024-12-10 17:38:15,97,4716,42,55,2923.92,5424.01,0.00
2024-12-10 17:38:15,98,4715,43,55,2867.61,5424.32,0.00
2024-12-10 17:38:15,97,4715,42,55,2900.39,5424.71,0.00
2024-12-10 17:38:15,97,4716,42,55,2995.92,5425.00,0.00
2024-12-10 17:38:15,98,4716,43,55,2965.35,5425.01,0.00
2024-12-10 17:38:15,97,4716,43,54,2984.20,5425.09,0.00
2024-12-10 17:38:15,97,4717,43,54,3014.36,5426.00,0.00
2024-12-10 17:38:15,98,4717,44,54,2983.60,5426.01,0.00
2024-12-10 17:38:15,97,4717,43,54,3012.13,5426.04,0.00
2024-12-10 17:38:15,97,4718,43,54,2982.83,5427.00,0.00
2024-12-10 17:38:15,98,4718,43,55,2952.39,5427.01,0.00
2024-12-10 17:38:15,97,4718,42,55,2930.56,5427.55,0.00
2024-12-10 17:38:15,97,4719,42,55,2940.94,5428.00,0.00
2024-12-10 17:38:15,98,4719,42,56,2910.93,5428.01,0.00
2024-12-10 17:38:15,99,4718,42,57,2879.35,5428.07,0.00
2024-12-10 17:38:15,98,4718,42,56,2954.63,5428.09,0.00
2024-12-10 17:38:15,97,4718,41,56,2930.15,5428.72,0.00
2024-12-10 17:38:15,97,4719,41,56,2969.39,5429.00,0.00
2024-12-10 17:38:15,98,4719,41,57,2939.09,5429.01,0.00
2024-12-10 17:38:15,97,4719,41,56,2967.17,5429.04,0.00
2024-12-10 17:38:15,96,4719,40,56,2995.26,5429.05,0.00
2024-12-10 17:38:15,95,4719,40,55,3013.65,5429.07,0.00
2024-12-10 17:38:15,96,4718,40,56,2973.25,5429.26,0.00
2024-12-10 17:38:15,96,4719,40,56,3066.37,5430.00,0.00
2024-12-10 17:38:15,97,4719,41,56,3034.76,5430.01,0.00
2024-12-10 17:38:15,96,4719,40,56,3045.08,5430.19,0.00
2024-12-10 17:38:15,95,4719,39,56,3069.64,5430.25,0.00
2024-12-10 17:38:15,96,4718,40,56,3021.98,5430.56,0.00
2024-12-10 17:38:15,96,4719,40,56,3133.44,5431.00,0.00
2024-12-10 17:38:15,97,4719,40,57,3101.13,5431.01,0.00
2024-12-10 17:38:15,96,4719,40,56,3128.37,5431.07,0.00
2024-12-10 17:38:15,97,4718,41,56,3080.11,5431.33,0.00
2024-12-10 17:38:15,97,4719,41,56,3155.73,5432.00,0.00
2024-12-10 17:38:15,98,4719,42,56,3123.53,5432.01,0.00
2024-12-10 17:38:15,98,4720,42,56,3138.25,5433.00,0.00
2024-12-10 17:38:15,99,4720,42,57,3106.55,5433.01,0.00
2024-12-10 17:38:15,98,4720,42,56,3133.84,5433.07,0.00
2024-12-10 17:38:15,99,4719,43,56,3059.96,5433.79,0.00
2024-12-10 17:38:15,99,4720,43,56,3104.70,5434.00,0.00
2024-12-10 17:38:15,100,4720,44,56,3073.65,5434.01,0.00
2024-12-10 17:38:15,100,4721,44,56,3085.45,5435.00,0.00
2024-12-10 17:38:15,101,4721,44,57,3054.90,5435.01,0.00
2024-12-10 17:38:15,100,4721,44,56,3081.67,5435.07,0.00
2024-12-10 17:38:15,99,4721,43,56,3061.74,5435.63,0.00
2024-12-10 17:38:15,98,4721,42,56,3090.24,5435.68,0.00
2024-12-10 17:38:15,98,4721,42,56,3120.24,5436.00,0.00
2024-12-10 17:38:15,99,4721,43,56,3088.72,5436.01,0.00
2024-12-10 17:38:15,98,4721,43,55,3105.29,5436.07,0.00
2024-12-10 17:38:15,99,4720,43,56,3023.45,5436.58,0.00
2024-12-10 17:38:15,99,4721,43,56,3064.73,5437.00,0.00
2024-12-10 17:38:15,100,4721,44,56,3034.08,5437.01,0.00
2024-12-10 17:38:15,99,4721,44,55,3027.96,5437.07,0.00
2024-12-10 17:38:15,99,4722,44,55,3074.34,5438.00,0.00
2024-12-10 17:38:15,100,4722,45,55,3043.60,5438.01,0.00
2024-12-10 17:38:15,101,4721,45,56,3011.33,5438.07,0.00
2024-12-10 17:38:15,100,4721,45,55,3081.15,5438.09,0.00
2024-12-10 17:38:15,101,4720,46,55,3046.35,5438.19,0.00
2024-12-10 17:38:15,100,4720,45,55,3069.35,5438.73,0.00
2024-12-10 17:38:15,100,4721,45,55,3101.17,5439.00,0.00
2024-12-10 17:38:15,101,4721,45,56,3070.47,5439.01,0.00
2024-12-10 17:38:15,100,4721,45,55,3085.97,5439.08,0.00
2024-12-10 17:38:15,100,4722,45,55,3158.82,5440.00,0.00
2024-12-10 17:38:15,101,4722,46,55,3127.55,5440.01,0.00
2024-12-10 17:38:15,100,4722,46,54,3143.62,5440.08,0.00
2024-12-10 17:38:15,100,4723,46,54,3105.81,5441.00,0.00
2024-12-10 17:38:15,101,4723,46,55,3075.06,5441.01,0.00
2024-12-10 17:38:15,100,4723,45,55,3105.27,5441.01,0.00
2024-12-10 17:38:15,99,4723,45,54,3099.84,5441.07,0.00
2024-12-10 17:38:15,98,4723,44,54,3119.62,5441.26,0.00
2024-12-10 17:38:15,99,4722,45,54,3086.47,5441.30,0.00
2024-12-10 17:38:15,99,4723,45,54,3111.89,5442.00,0.00
2024-12-10 17:38:15,100,4723,45,55,3080.77,5442.01,0.00
2024-12-10 17:38:15,99,4723,45,54,3097.62,5442.07,0.00
2024-12-10 17:38:15,98,4723,44,54,3128.68,5442.07,0.00
2024-12-10 17:38:15,97,4723,43,54,3156.43,5442.13,0.00
2024-12-10 17:38:15,96,4723,42,54,3183.68,5442.23,0.00
2024-12-10 17:38:15,95,4723,41,54,3198.38,5442.40,0.00
2024-12-10 17:38:15,94,4723,41,53,3204.28,5442.67,0.00
2024-12-10 17:38:15,94,4724,41,53,3285.66,5443.00,0.00
2024-12-10 17:38:15,95,4724,42,53,3251.07,5443.01,0.00
2024-12-10 17:38:15,94,4724,41,53,3285.08,5443.01,0.00
2024-12-10 17:38:15,93,4724,40,53,3279.65,5443.16,0.00
2024-12-10 17:38:15,93,4725,40,53,3266.73,5444.00,0.00
2024-12-10 17:38:15,94,4725,41,53,3231.97,5444.01,0.00
2024-12-10 17:38:15,93,4725,41,52,3262.65,5444.06,0.00
2024-12-10 17:38:15,92,4725,41,51,3253.27,5444.75,0.00
2024-12-10 17:38:15,92,4726,41,51,3272.60,5445.00,0.00
2024-12-10 17:38:15,93,4726,41,52,3237.41,5445.01,0.00
2024-12-10 17:38:15,92,4726,41,51,3224.71,5445.59,0.00
2024-12-10 17:38:15,91,4726,40,51,3240.40,5445.59,0.00
2024-12-10 17:38:15,92,4725,41,51,3200.51,5445.70,0.00
2024-12-10 17:38:15,92,4726,41,51,3280.50,5446.00,0.00
2024-12-10 17:38:15,93,4726,42,51,3245.23,5446.01,0.00
2024-12-10 17:38:15,92,4726,42,50,3275.79,5446.08,0.00
2024-12-10 17:38:15,92,4727,42,50,3313.29,5447.00,0.00
2024-12-10 17:38:15,93,4727,42,51,3277.66,5447.01,0.00
2024-12-10 17:38:15,92,4727,41,51,3287.64,5447.25,0.00
2024-12-10 17:38:15,93,4726,41,52,3191.74,5447.86,0.00
2024-12-10 17:38:15,93,4727,41,52,3247.74,5448.00,0.00
2024-12-10 17:38:15,94,4727,41,53,3213.19,5448.01,0.00
2024-12-10 17:38:15,93,4727,40,53,3245.42,5448.04,0.00
2024-12-10 17:38:15,94,4726,41,53,3209.73,5448.09,0.00
2024-12-10 17:38:15,93,4726,41,52,3259.65,5448.09,0.00
2024-12-10 17:38:15,92,4726,40,52,3275.61,5448.24,0.00
2024-12-10 17:38:15,92,4727,40,52,3345.95,5449.00,0.00
2024-12-10 17:38:15,93,4727,41,52,3309.97,5449.01,0.00
2024-12-10 17:38:15,94,4726,41,53,3189.33,5449.81,0.00
2024-12-10 17:38:16,94,4727,41,53,3319.04,5450.00,0.00
2024-12-10 17:38:16,95,4727,42,53,3284.10,5450.01,0.00
2024-12-10 17:38:16,96,4726,42,54,3245.80,5450.09,0.00
2024-12-10 17:38:16,95,4726,42,53,3301.87,5450.11,0.00
2024-12-10 17:38:16,95,4727,42,53,3332.30,5451.00,0.00
2024-12-10 17:38:16,96,4727,43,53,3297.58,5451.01,0.00
2024-12-10 17:38:16,95,4727,42,53,3306.94,5451.22,0.00
2024-12-10 17:38:16,94,4727,41,53,3310.48,5451.66,0.00
2024-12-10 17:38:16,94,4728,41,53,3400.25,5452.00,0.00
2024-12-10 17:38:16,95,4728,42,53,3364.46,5452.01,0.00
2024-12-10 17:38:16,94,4728,42,52,3384.49,5452.11,0.00
2024-12-10 17:38:16,94,4729,42,52,3349.88,5453.00,0.00
2024-12-10 17:38:16,95,4729,43,52,3314.62,5453.01,0.00
2024-12-10 17:38:16,94,4729,43,51,3347.11,5453.04,0.00
2024-12-10 17:38:16,93,4729,43,50,3381.59,5453.04,0.00
2024-12-10 17:38:16,92,4729,43,49,3381.02,5453.33,0.00
2024-12-10 17:38:16,92,4730,43,49,3374.16,5454.00,0.00
2024-12-10 17:38:16,93,4730,43,50,3337.88,5454.01,0.00
2024-12-10 17:38:16,93,4731,43,50,3276.28,5455.00,0.00
2024-12-10 17:38:16,94,4731,44,50,3241.43,5455.01,0.00
2024-12-10 17:38:16,94,4732,44,50,3165.08,5456.00,0.00
2024-12-10 17:38:16,95,4732,44,51,3131.77,5456.01,0.00
2024-12-10 17:38:16,94,4732,44,50,3145.30,5456.09,0.00
2024-12-10 17:38:16,93,4732,43,50,3063.63,5456.98,0.00
2024-12-10 17:38:16,93,4733,43,50,3121.14,5457.00,0.00
2024-12-10 17:38:16,94,4733,43,51,3087.94,5457.01,0.00
2024-12-10 17:38:16,93,4733,43,50,3042.18,5457.60,0.00
2024-12-10 17:38:16,93,4734,43,50,3043.34,5458.00,0.00
2024-12-10 17:38:16,94,4734,43,51,3010.97,5458.01,0.00
2024-12-10 17:38:16,93,4734,43,50,3032.25,5458.12,0.00
2024-12-10 17:38:16,92,4734,43,49,3041.67,5458.47,0.00
2024-12-10 17:38:16,93,4733,43,50,2978.23,5458.70,0.00
2024-12-10 17:38:16,92,4733,42,50,3008.42,5458.95,0.00
2024-12-10 17:38:16,92,4734,42,50,3064.83,5459.00,0.00
2024-12-10 17:38:16,93,4734,42,51,3031.88,5459.01,0.00
2024-12-10 17:38:16,92,4734,41,51,3017.78,5459.37,0.00
2024-12-10 17:38:16,92,4735,41,51,3072.88,5460.00,0.00
2024-12-10 17:38:16,93,4735,41,52,3039.84,5460.01,0.00
2024-12-10 17:38:16,92,4735,41,51,3059.82,5460.12,0.00
2024-12-10 17:38:16,91,4735,40,51,3063.36,5460.53,0.00
2024-12-10 17:38:16,91,4736,40,51,3052.93,5461.00,0.00
2024-12-10 17:38:16,92,4736,41,51,3019.74,5461.01,0.00
2024-12-10 17:38:16,91,4736,40,51,3046.48,5461.07,0.00
2024-12-10 17:38:16,90,4736,39,51,3011.35,5461.59,0.00
2024-12-10 17:38:16,91,4735,39,52,2964.98,5461.78,0.00
2024-12-10 17:38:16,90,4735,38,52,3006.85,5461.80,0.00
2024-12-10 17:38:16,90,4736,38,52,3046.82,5462.00,0.00
2024-12-10 17:38:16,91,4736,39,52,3013.34,5462.01,0.00
2024-12-10 17:38:16,90,4736,38,52,3043.80,5462.04,0.00
2024-12-10 17:38:16,89,4736,38,51,3069.25,5462.10,0.00
2024-12-10 17:38:16,89,4737,38,51,3095.19,5463.00,0.00
2024-12-10 17:38:16,90,4737,39,51,3060.80,5463.01,0.00
2024-12-10 17:38:16,91,4736,39,52,3025.38,5463.07,0.00
2024-12-10 17:38:16,90,4736,38,52,3029.02,5463.49,0.00
2024-12-10 17:38:16,90,4737,38,52,3014.85,5464.00,0.00
2024-12-10 17:38:16,91,4737,38,53,2981.72,5464.01,0.00
2024-12-10 17:38:16,90,4737,38,52,3003.36,5464.13,0.00
2024-12-10 17:38:16,91,4736,39,52,2954.86,5464.44,0.00
2024-12-10 17:38:16,90,4736,38,52,2984.88,5464.58,0.00
2024-12-10 17:38:16,90,4737,38,52,3063.83,5465.00,0.00
2024-12-10 17:38:16,91,4737,39,52,3030.16,5465.01,0.00
2024-12-10 17:38:16,90,4737,38,52,3038.41,5465.26,0.00
2024-12-10 17:38:16,91,4736,39,52,2994.91,5465.46,0.00
2024-12-10 17:38:16,90,4736,39,51,3075.05,5465.48,0.00
2024-12-10 17:38:16,90,4737,39,51,3127.72,5466.00,0.00
2024-12-10 17:38:16,91,4737,39,52,3093.35,5466.01,0.00
2024-12-10 17:38:16,90,4737,39,51,3113.80,5466.16,0.00
2024-12-10 17:38:16,90,4738,39,51,3146.69,5467.00,0.00
2024-12-10 17:38:16,91,4738,39,52,3112.11,5467.01,0.00
2024-12-10 17:38:16,91,4739,39,52,3061.16,5468.00,0.00
2024-12-10 17:38:16,92,4739,39,53,3027.88,5468.01,0.00
2024-12-10 17:38:16,91,4739,39,52,3046.78,5468.17,0.00
2024-12-10 17:38:16,90,4739,38,52,3053.53,5468.37,0.00
2024-12-10 17:38:16,91,4738,38,53,3013.52,5468.50,0.00
2024-12-10 17:38:16,91,4739,38,53,3070.72,5469.00,0.00
2024-12-10 17:38:16,92,4739,38,54,3037.34,5469.01,0.00
2024-12-10 17:38:16,91,4739,38,53,3051.61,5469.18,0.00
2024-12-10 17:38:16,90,4739,37,53,3073.42,5469.32,0.00
2024-12-10 17:38:16,89,4739,37,52,3088.84,5469.52,0.00
2024-12-10 17:38:16,89,4740,37,52,3169.30,5470.00,0.00
2024-12-10 17:38:16,90,4740,38,52,3134.09,5470.01,0.00
2024-12-10 17:38:16,89,4740,37,52,3160.10,5470.07,0.00
2024-12-10 17:38:16,90,4739,38,52,3123.18,5470.12,0.00
2024-12-10 17:38:16,89,4739,37,52,3138.32,5470.70,0.00
2024-12-10 17:38:16,90,4738,38,52,3099.85,5470.78,0.00
2024-12-10 17:38:16,90,4739,38,52,3160.74,5471.00,0.00
2024-12-10 17:38:16,91,4739,38,53,3126.01,5471.01,0.00
2024-12-10 17:38:16,90,4739,38,52,3144.39,5471.19,0.00
2024-12-10 17:38:16,90,4740,38,52,3238.21,5472.00,0.00
2024-12-10 17:38:16,91,4740,39,52,3202.62,5472.01,0.00
2024-12-10 17:38:16,90,4740,38,52,3145.55,5472.83,0.00
2024-12-10 17:38:16,90,4741,38,52,3193.99,5473.00,0.00
2024-12-10 17:38:16,91,4741,38,53,3158.89,5473.01,0.00
2024-12-10 17:38:16,92,4740,39,53,3122.78,5473.07,0.00
2024-12-10 17:38:16,92,4741,39,53,3071.48,5474.00,0.00
2024-12-10 17:38:16,93,4741,39,54,3038.45,5474.01,0.00
2024-12-10 17:38:16,92,4741,39,53,2993.34,5474.73,0.00
2024-12-10 17:38:16,92,4742,39,53,3081.16,5475.00,0.00
2024-12-10 17:38:16,93,4742,40,53,3048.03,5475.01,0.00
2024-12-10 17:38:16,92,4742,40,52,3080.57,5475.01,0.00
2024-12-10 17:38:16,91,4742,40,51,3100.00,5475.04,0.00
2024-12-10 17:38:16,90,4742,40,50,3095.54,5475.63,0.00
2024-12-10 17:38:16,90,4743,40,50,3108.28,5476.00,0.00
2024-12-10 17:38:16,91,4743,40,51,3074.13,5476.01,0.00
2024-12-10 17:38:16,90,4743,40,50,3085.83,5476.19,0.00
2024-12-10 17:38:16,90,4744,40,50,3068.27,5477.00,0.00
2024-12-10 17:38:16,91,4744,41,50,3034.55,5477.01,0.00
2024-12-10 17:38:16,90,4744,40,50,3015.44,5477.69,0.00
2024-12-10 17:38:17,90,4745,40,50,3029.05,5478.00,0.00
2024-12-10 17:38:17,91,4745,41,50,2995.76,5478.01,0.00
2024-12-10 17:38:17,90,4745,41,49,3018.10,5478.03,0.00
2024-12-10 17:38:17,90,4746,41,49,2988.95,5479.00,0.00
2024-12-10 17:38:17,91,4746,41,50,2956.10,5479.01,0.00
2024-12-10 17:38:17,90,4746,41,49,2974.36,5479.10,0.00
2024-12-10 17:38:17,90,4747,41,49,2948.57,5480.00,0.00
2024-12-10 17:38:17,91,4747,41,50,2916.17,5480.01,0.00
2024-12-10 17:38:17,90,4747,40,50,2910.74,5480.47,0.00
2024-12-10 17:38:17,89,4747,39,50,2912.46,5480.64,0.00
2024-12-10 17:38:17,89,4748,39,50,2942.02,5481.00,0.00
2024-12-10 17:38:17,90,4748,40,50,2909.33,5481.01,0.00
2024-12-10 17:38:17,89,4748,40,49,2939.56,5481.05,0.00
2024-12-10 17:38:17,88,4748,40,48,2963.03,5481.16,0.00
2024-12-10 17:38:17,88,4749,40,48,2934.15,5482.00,0.00
2024-12-10 17:38:17,89,4749,40,49,2901.18,5482.01,0.00
2024-12-10 17:38:17,88,4749,39,49,2825.38,5482.86,0.00
2024-12-10 17:38:17,88,4750,39,49,2879.70,5483.00,0.00
2024-12-10 17:38:17,89,4750,39,50,2847.34,5483.01,0.00
2024-12-10 17:38:17,88,4750,39,49,2868.52,5483.16,0.00
2024-12-10 17:38:17,87,4750,38,49,2865.90,5483.71,0.00
2024-12-10 17:38:17,87,4751,38,49,2898.74,5484.00,0.00
2024-12-10 17:38:17,88,4751,39,49,2865.80,5484.01,0.00
2024-12-10 17:38:17,87,4751,38,49,2896.23,5484.05,0.00
2024-12-10 17:38:17,86,4751,38,48,2842.38,5484.80,0.00
2024-12-10 17:38:17,86,4752,38,48,2893.51,5485.00,0.00
2024-12-10 17:38:17,87,4752,38,49,2860.25,5485.01,0.00
2024-12-10 17:38:17,86,4752,38,48,2882.71,5485.15,0.00
2024-12-10 17:38:17,85,4752,37,48,2894.02,5485.39,0.00
2024-12-10 17:38:17,85,4753,37,48,2910.61,5486.00,0.00
2024-12-10 17:38:17,86,4753,37,49,2876.77,5486.01,0.00
2024-12-10 17:38:17,86,4754,37,49,2820.32,5487.00,0.00
2024-12-10 17:38:17,87,4754,37,50,2787.90,5487.01,0.00
2024-12-10 17:38:17,86,4754,37,49,2809.51,5487.15,0.00
2024-12-10 17:38:17,87,4753,38,49,2771.57,5487.28,0.00
2024-12-10 17:38:17,86,4753,38,48,2799.17,5487.56,0.00
2024-12-10 17:38:17,85,4753,38,47,2817.59,5487.68,0.00
2024-12-10 17:38:17,84,4753,37,47,2839.24,5487.79,0.00
2024-12-10 17:38:17,84,4754,37,47,2886.55,5488.00,0.00
2024-12-10 17:38:17,85,4754,37,48,2852.59,5488.01,0.00
2024-12-10 17:38:17,85,4755,37,48,2881.33,5489.00,0.00
2024-12-10 17:38:17,86,4755,38,48,2847.82,5489.01,0.00
2024-12-10 17:38:17,85,4755,37,48,2878.12,5489.06,0.00
2024-12-10 17:38:17,84,4755,37,47,2903.90,5489.16,0.00
2024-12-10 17:38:17,83,4755,36,47,2918.61,5489.37,0.00
2024-12-10 17:38:17,84,4754,36,48,2872.22,5489.61,0.00
2024-12-10 17:38:17,84,4755,36,48,2955.92,5490.00,0.00
2024-12-10 17:38:17,85,4755,36,49,2921.15,5490.01,0.00
2024-12-10 17:38:17,84,4755,35,49,2900.89,5490.31,0.00
2024-12-10 17:38:17,84,4756,35,49,2981.89,5491.00,0.00
2024-12-10 17:38:17,85,4756,36,49,2946.81,5491.01,0.00
2024-12-10 17:38:17,84,4756,36,48,2970.81,5491.16,0.00
2024-12-10 17:38:17,83,4756,35,48,2999.06,5491.28,0.00
2024-12-10 17:38:17,83,4757,35,48,3013.09,5492.00,0.00
2024-12-10 17:38:17,84,4757,35,49,2977.22,5492.01,0.00
2024-12-10 17:38:17,85,4756,35,50,2906.80,5492.45,0.00
2024-12-10 17:38:17,85,4757,35,50,2928.42,5493.00,0.00
2024-12-10 17:38:17,86,4757,36,50,2894.37,5493.01,0.00
2024-12-10 17:38:17,87,4756,36,51,2859.22,5493.07,0.00
2024-12-10 17:38:17,86,4756,35,51,2905.89,5493.07,0.00
2024-12-10 17:38:17,85,4756,35,50,2931.04,5493.17,0.00
2024-12-10 17:38:17,84,4756,34,50,2941.61,5493.43,0.00
2024-12-10 17:38:17,84,4757,34,50,3017.88,5494.00,0.00
2024-12-10 17:38:17,85,4757,35,50,2982.37,5494.01,0.00
2024-12-10 17:38:17,84,4757,35,49,3013.32,5494.06,0.00
2024-12-10 17:38:17,83,4757,34,49,2990.43,5494.59,0.00
2024-12-10 17:38:17,83,4758,34,49,3088.12,5495.00,0.00
2024-12-10 17:38:17,84,4758,34,50,3051.35,5495.01,0.00
2024-12-10 17:38:17,83,4758,33,50,3061.65,5495.06,0.00
2024-12-10 17:38:17,82,4758,32,50,3036.11,5495.74,0.00
2024-12-10 17:38:17,82,4759,32,50,3086.75,5496.00,0.00
2024-12-10 17:38:17,83,4759,33,50,3049.56,5496.01,0.00
2024-12-10 17:38:17,82,4759,33,49,3073.38,5496.16,0.00
2024-12-10 17:38:17,82,4760,33,49,3055.99,5497.00,0.00
2024-12-10 17:38:17,83,4760,33,50,3019.17,5497.01,0.00
2024-12-10 17:38:17,82,4760,32,50,2987.68,5497.52,0.00
2024-12-10 17:38:17,82,4761,32,50,3018.98,5498.00,0.00
2024-12-10 17:38:17,83,4761,33,50,2982.61,5498.01,0.00
2024-12-10 17:38:17,82,4761,32,50,3017.64,5498.02,0.00
2024-12-10 17:38:17,81,4761,32,49,3044.07,5498.15,0.00
2024-12-10 17:38:17,80,4761,31,49,3057.77,5498.41,0.00
2024-12-10 17:38:17,80,4762,31,49,3081.66,5499.00,0.00
2024-12-10 17:38:17,81,4762,31,50,3043.62,5499.01,0.00
2024-12-10 17:38:17,80,4762,31,49,3078.93,5499.05,0.00
2024-12-10 17:38:17,80,4763,31,49,3042.09,5500.00,0.00
2024-12-10 17:38:17,81,4763,31,50,3004.54,5500.01,0.00
2024-12-10 17:38:17,80,4763,31,49,3039.36,5500.05,0.00
2024-12-10 17:38:17,79,4763,31,48,3066.02,5500.15,0.00
2024-12-10 17:38:17,78,4763,30,48,3099.02,5500.26,0.00
2024-12-10 17:38:17,77,4763,29,48,3111.64,5500.65,0.00
2024-12-10 17:38:17,77,4764,29,48,3130.74,5501.00,0.00
2024-12-10 17:38:17,78,4764,29,49,3090.60,5501.01,0.00
2024-12-10 17:38:17,78,4765,29,49,3056.31,5502.00,0.00
2024-12-10 17:38:17,79,4765,29,50,3017.62,5502.01,0.00
2024-12-10 17:38:17,78,4765,29,49,3053.51,5502.05,0.00
2024-12-10 17:38:17,77,4765,28,49,3073.88,5502.10,0.00
2024-12-10 17:38:17,76,4765,28,48,3109.10,5502.13,0.00
2024-12-10 17:38:17,76,4766,28,48,3125.84,5503.00,0.00
2024-12-10 17:38:17,77,4766,28,49,3085.24,5503.01,0.00
2024-12-10 17:38:17,76,4766,28,48,3085.77,5503.40,0.00
2024-12-10 17:38:17,76,4767,28,48,3094.98,5504.00,0.00
2024-12-10 17:38:17,77,4767,28,49,3054.79,5504.01,0.00
2024-12-10 17:38:17,76,4767,28,48,3082.50,5504.13,0.00
2024-12-10 17:38:17,75,4767,27,48,3117.03,5504.25,0.00
2024-12-10 17:38:17,74,4767,26,48,3105.90,5504.65,0.00
2024-12-10 17:38:17,74,4768,26,48,3161.24,5505.00,0.00
2024-12-10 17:38:17,75,4768,27,48,3119.09,5505.01,0.00
2024-12-10 17:38:17,74,4768,27,47,3157.57,5505.05,0.00
2024-12-10 17:38:17,73,4768,26,47,3150.69,5505.56,0.00
2024-12-10 17:38:18,73,4769,26,47,3202.32,5506.00,0.00
2024-12-10 17:38:18,74,4769,27,47,3159.04,5506.01,0.00
2024-12-10 17:38:18,73,4769,26,47,3184.97,5506.01,0.00
2024-12-10 17:38:18,73,4770,26,47,3187.37,5507.00,0.00
2024-12-10 17:38:18,74,4770,27,47,3144.29,5507.01,0.00
2024-12-10 17:38:18,73,4770,27,46,3175.45,5507.11,0.00
2024-12-10 17:38:18,73,4771,27,46,3168.71,5508.00,0.00
2024-12-10 17:38:18,74,4771,28,46,3125.89,5508.01,0.00
2024-12-10 17:38:18,73,4771,27,46,3142.85,5508.11,0.00
2024-12-10 17:38:18,73,4772,27,46,3149.57,5509.00,0.00
2024-12-10 17:38:18,74,4772,28,46,3107.01,5509.01,0.00
2024-12-10 17:38:18,73,4772,28,45,3138.42,5509.11,0.00
2024-12-10 17:38:18,74,4771,28,46,3088.62,5509.27,0.00
2024-12-10 17:38:18,74,4772,28,46,3161.09,5510.00,0.00
2024-12-10 17:38:18,75,4772,28,47,3118.95,5510.01,0.00
2024-12-10 17:38:18,75,4773,28,47,3160.71,5511.00,0.00
2024-12-10 17:38:18,76,4773,28,48,3119.12,5511.01,0.00
2024-12-10 17:38:18,75,4773,28,47,3148.98,5511.12,0.00
2024-12-10 17:38:18,74,4773,27,47,3126.56,5511.64,0.00
2024-12-10 17:38:18,74,4774,27,47,3179.72,5512.00,0.00
2024-12-10 17:38:18,75,4774,28,47,3137.33,5512.01,0.00
2024-12-10 17:38:18,74,4774,27,47,3177.50,5512.04,0.00
2024-12-10 17:38:18,74,4775,27,47,3140.48,5513.00,0.00
2024-12-10 17:38:18,75,4775,28,47,3098.61,5513.01,0.00
2024-12-10 17:38:18,74,4775,28,46,3130.08,5513.11,0.00
2024-12-10 17:38:18,73,4775,28,45,3149.31,5513.43,0.00
2024-12-10 17:38:18,73,4776,28,45,3151.34,5514.00,0.00
2024-12-10 17:38:18,74,4776,29,45,3108.75,5514.01,0.00
2024-12-10 17:38:18,74,4777,29,45,3063.23,5515.00,0.00
2024-12-10 17:38:18,75,4777,29,46,3022.39,5515.01,0.00
2024-12-10 17:38:18,74,4777,29,45,3052.82,5515.11,0.00
2024-12-10 17:38:18,73,4777,28,45,3064.94,5515.47,0.00
2024-12-10 17:38:18,72,4777,27,45,3081.51,5515.53,0.00
2024-12-10 17:38:18,72,4778,27,45,3118.40,5516.00,0.00
2024-12-10 17:38:18,73,4778,27,46,3075.68,5516.01,0.00
2024-12-10 17:38:18,72,4778,26,46,3116.11,5516.04,0.00
2024-12-10 17:38:18,72,4779,26,46,3100.97,5517.00,0.00
2024-12-10 17:38:18,73,4779,26,47,3058.49,5517.01,0.00
2024-12-10 17:38:18,72,4779,25,47,3093.97,5517.10,0.00
2024-12-10 17:38:18,71,4779,25,46,3132.88,5517.10,0.00
2024-12-10 17:38:18,70,4779,24,46,3139.98,5517.64,0.00
2024-12-10 17:38:18,70,4780,24,46,3151.44,5518.00,0.00
2024-12-10 17:38:18,71,4780,25,46,3107.06,5518.01,0.00
2024-12-10 17:38:18,70,4780,24,46,3125.44,5518.06,0.00
2024-12-10 17:38:18,71,4779,24,47,3017.63,5518.82,0.00
2024-12-10 17:38:18,70,4779,23,47,3070.18,5518.83,0.00
2024-12-10 17:38:18,70,4780,23,47,3131.49,5519.00,0.00
2024-12-10 17:38:18,71,4780,23,48,3087.39,5519.01,0.00
2024-12-10 17:38:18,70,4780,23,47,3118.91,5519.11,0.00
2024-12-10 17:38:18,70,4781,23,47,3179.07,5520.00,0.00
2024-12-10 17:38:18,71,4781,23,48,3134.29,5520.01,0.00
2024-12-10 17:38:18,71,4782,23,48,3093.08,5521.00,0.00
2024-12-10 17:38:18,72,4782,24,48,3050.12,5521.01,0.00
2024-12-10 17:38:18,71,4782,24,47,3092.30,5521.01,0.00
2024-12-10 17:38:18,70,4782,23,47,3115.61,5521.01,0.00
2024-12-10 17:38:18,69,4782,22,47,3159.96,5521.02,0.00
2024-12-10 17:38:18,68,4782,22,46,3201.35,5521.07,0.00
2024-12-10 17:38:18,69,4781,22,47,3143.83,5521.30,0.00
2024-12-10 17:38:18,68,4781,22,46,3227.39,5521.37,0.00
2024-12-10 17:38:18,68,4782,22,46,3255.68,5522.00,0.00
2024-12-10 17:38:18,69,4782,23,46,3208.50,5522.02,0.00
2024-12-10 17:38:18,70,4781,24,46,3157.24,5522.11,0.00
2024-12-10 17:38:18,69,4781,23,46,3178.73,5522.75,0.00
2024-12-10 17:38:18,69,4782,23,46,3324.21,5523.00,0.00
2024-12-10 17:38:18,70,4782,23,47,3276.72,5523.01,0.00
2024-12-10 17:38:18,69,4782,23,46,3277.61,5523.41,0.00
2024-12-10 17:38:18,70,4781,24,46,3213.09,5523.73,0.00
2024-12-10 17:38:18,70,4782,24,46,3378.59,5524.00,0.00
2024-12-10 17:38:18,71,4782,25,46,3331.00,5524.01,0.00
2024-12-10 17:38:18,71,4783,25,46,3390.69,5525.00,0.00
2024-12-10 17:38:18,72,4783,25,47,3343.60,5525.01,0.00
2024-12-10 17:38:18,71,4783,24,47,3389.91,5525.01,0.00
2024-12-10 17:38:18,71,4784,24,47,3362.76,5526.00,0.00
2024-12-10 17:38:18,72,4784,24,48,3316.05,5526.01,0.00
2024-12-10 17:38:18,71,4784,24,47,3352.83,5526.04,0.00
2024-12-10 17:38:18,71,4785,24,47,3343.12,5527.00,0.00
2024-12-10 17:38:18,72,4785,25,47,3296.69,5527.01,0.00
2024-12-10 17:38:18,71,4785,24,47,3340.10,5527.01,0.00
2024-12-10 17:38:18,71,4786,24,47,3331.51,5528.00,0.00
2024-12-10 17:38:18,72,4786,25,47,3285.24,5528.01,0.00
2024-12-10 17:38:18,71,4786,24,47,3307.53,5528.16,0.00
2024-12-10 17:38:18,71,4787,24,47,3311.68,5529.00,0.00
2024-12-10 17:38:18,72,4787,24,48,3265.69,5529.01,0.00
2024-12-10 17:38:18,71,4787,24,47,3277.13,5529.34,0.00
2024-12-10 17:38:18,71,4788,24,47,3297.64,5530.00,0.00
2024-12-10 17:38:18,72,4788,25,47,3251.84,5530.01,0.00
2024-12-10 17:38:18,71,4788,24,47,3205.46,5530.87,0.00
2024-12-10 17:38:18,71,4789,24,47,3274.99,5531.00,0.00
2024-12-10 17:38:18,72,4789,24,48,3229.51,5531.01,0.00
2024-12-10 17:38:18,71,4789,24,47,3264.10,5531.04,0.00
2024-12-10 17:38:18,72,4788,25,47,3211.13,5531.21,0.00
2024-12-10 17:38:18,72,4789,25,47,3255.74,5532.00,0.00
2024-12-10 17:38:18,73,4789,25,48,3211.14,5532.01,0.00
2024-12-10 17:38:18,72,4789,24,48,3218.33,5532.22,0.00
2024-12-10 17:38:18,72,4790,24,48,3324.90,5533.00,0.00
2024-12-10 17:38:18,73,4790,25,48,3279.36,5533.01,0.00
2024-12-10 17:38:18,73,4791,25,48,3252.92,5534.00,0.00
2024-12-10 17:38:18,74,4791,26,48,3208.97,5534.01,0.00
2024-12-10 17:38:18,73,4791,26,47,3251.30,5534.04,0.00
2024-12-10 17:38:18,72,4791,26,46,3288.78,5534.08,0.00
2024-12-10 17:38:18,72,4792,26,46,3282.31,5535.00,0.00
2024-12-10 17:38:18,73,4792,27,46,3237.34,5535.01,0.00
2024-12-10 17:38:18,72,4792,26,46,3261.55,5535.01,0.00
2024-12-10 17:38:19,72,4793,26,46,3267.57,5536.00,0.00
2024-12-10 17:38:19,73,4793,27,46,3222.81,5536.01,0.00
2024-12-10 17:38:19,72,4793,27,45,3259.90,5536.07,0.00
2024-12-10 17:38:19,72,4794,27,45,3255.09,5537.00,0.00
2024-12-10 17:38:19,73,4794,28,45,3210.50,5537.01,0.00
2024-12-10 17:38:19,73,4795,28,45,3186.80,5538.00,0.00
2024-12-10 17:38:19,74,4795,29,45,3143.73,5538.01,0.00
2024-12-10 17:38:19,73,4795,29,44,3178.47,5538.07,0.00
2024-12-10 17:38:19,73,4796,29,44,3172.69,5539.00,0.00
2024-12-10 17:38:19,74,4796,29,45,3129.82,5539.01,0.00
2024-12-10 17:38:19,74,4797,29,45,3104.93,5540.00,0.00
2024-12-10 17:38:19,75,4797,29,46,3063.53,5540.01,0.00
2024-12-10 17:38:19,74,4797,29,45,3095.96,5540.08,0.00
2024-12-10 17:38:19,74,4798,29,45,3085.90,5541.00,0.00
2024-12-10 17:38:19,75,4798,29,46,3044.75,5541.01,0.00
2024-12-10 17:38:19,75,4799,29,46,3040.43,5542.00,0.00
2024-12-10 17:38:19,76,4799,29,47,3000.43,5542.01,0.00
2024-12-10 17:38:19,75,4799,28,47,2966.30,5542.96,0.00
2024-12-10 17:38:19,75,4800,28,47,3038.02,5543.00,0.00
2024-12-10 17:38:19,76,4800,28,48,2998.04,5543.01,0.00
2024-12-10 17:38:19,75,4800,27,48,3017.03,5543.12,0.00
2024-12-10 17:38:19,75,4801,27,48,3023.86,5544.00,0.00
2024-12-10 17:38:19,76,4801,28,48,2984.08,5544.01,0.00
2024-12-10 17:38:19,75,4801,27,48,2962.80,5544.75,0.00
2024-12-10 17:38:19,75,4802,27,48,2992.17,5545.00,0.00
2024-12-10 17:38:19,76,4802,28,48,2952.80,5545.01,0.00
2024-12-10 17:38:19,75,4802,28,47,2982.58,5545.09,0.00
2024-12-10 17:38:19,75,4803,28,47,2968.50,5546.00,0.00
2024-12-10 17:38:19,76,4803,28,48,2929.44,5546.01,0.00
2024-12-10 17:38:19,75,4803,27,48,2929.68,5546.31,0.00
2024-12-10 17:38:19,75,4804,27,48,2961.75,5547.00,0.00
2024-12-10 17:38:19,76,4804,28,48,2922.78,5547.01,0.00
2024-12-10 17:38:19,75,4804,28,47,2949.94,5547.12,0.00
2024-12-10 17:38:19,74,4804,27,47,2948.76,5547.51,0.00
2024-12-10 17:38:19,74,4805,27,47,2993.70,5548.00,0.00
2024-12-10 17:38:19,75,4805,28,47,2953.78,5548.01,0.00
2024-12-10 17:38:19,75,4806,28,47,2927.09,5549.00,0.00
2024-12-10 17:38:19,76,4806,29,47,2888.58,5549.01,0.00
2024-12-10 17:38:19,75,4806,28,47,2924.02,5549.07,0.00
2024-12-10 17:38:19,74,4806,28,46,2947.81,5549.15,0.00
2024-12-10 17:38:19,74,4807,28,46,2934.93,5550.00,0.00
2024-12-10 17:38:19,75,4807,29,46,2895.80,5550.01,0.00
2024-12-10 17:38:19,75,4808,29,46,2869.44,5551.00,0.00
2024-12-10 17:38:19,76,4808,30,46,2831.69,5551.01,0.00
2024-12-10 17:38:19,75,4808,30,45,2863.53,5551.03,0.00
2024-12-10 17:38:19,74,4808,30,44,2889.55,5551.18,0.00
2024-12-10 17:38:19,73,4808,29,44,2927.62,5551.19,0.00
2024-12-10 17:38:19,72,4808,28,44,2930.70,5551.75,0.00
2024-12-10 17:38:19,72,4809,28,44,2963.27,5552.00,0.00
2024-12-10 17:38:19,73,4809,28,45,2922.68,5552.01,0.00
2024-12-10 17:38:19,72,4809,28,44,2957.11,5552.03,0.00
2024-12-10 17:38:19,72,4810,28,44,2943.75,5553.00,0.00
2024-12-10 17:38:19,73,4810,29,44,2903.42,5553.01,0.00
2024-12-10 17:38:19,73,4811,29,44,2871.03,5554.00,0.00
2024-12-10 17:38:19,74,4811,29,45,2832.23,5554.01,0.00
2024-12-10 17:38:19,73,4811,29,44,2862.68,5554.08,0.00
2024-12-10 17:38:19,73,4812,29,44,2849.42,5555.00,0.00
2024-12-10 17:38:19,74,4812,30,44,2810.92,5555.01,0.00
2024-12-10 17:38:19,75,4811,31,44,2720.29,5555.64,0.00
2024-12-10 17:38:19,74,4811,30,44,2760.78,5555.96,0.00
2024-12-10 17:38:19,74,4812,30,44,2833.63,5556.00,0.00
2024-12-10 17:38:19,75,4812,30,45,2795.85,5556.01,0.00
2024-12-10 17:38:19,74,4812,30,44,2826.14,5556.08,0.00
2024-12-10 17:38:19,74,4813,30,44,2892.79,5557.00,0.00
2024-12-10 17:38:19,75,4813,30,45,2854.22,5557.01,0.00
2024-12-10 17:38:19,74,4813,30,44,2889.74,5557.07,0.00
2024-12-10 17:38:19,73,4813,30,43,2918.68,5557.10,0.00
2024-12-10 17:38:19,72,4813,29,43,2946.90,5557.18,0.00
2024-12-10 17:38:19,72,4814,29,43,2975.10,5558.00,0.00
2024-12-10 17:38:19,73,4814,30,43,2934.35,5558.01,0.00
2024-12-10 17:38:19,72,4814,30,42,2932.32,5558.46,0.00
2024-12-10 17:38:19,71,4814,29,42,2932.73,5558.68,0.00
2024-12-10 17:38:19,71,4815,29,42,2993.25,5559.00,0.00
2024-12-10 17:38:19,72,4815,30,42,2951.68,5559.01,0.00
2024-12-10 17:38:19,71,4815,30,41,2991.69,5559.03,0.00
2024-12-10 17:38:19,72,4814,31,41,2922.55,5559.56,0.00
2024-12-10 17:38:19,72,4815,31,41,2979.92,5560.00,0.00
2024-12-10 17:38:19,73,4815,32,41,2939.10,5560.01,0.00
2024-12-10 17:38:19,72,4815,32,40,2972.98,5560.03,0.00
2024-12-10 17:38:19,71,4815,31,40,2951.71,5560.66,0.00
2024-12-10 17:38:19,71,4816,31,40,3089.80,5561.00,0.00
2024-12-10 17:38:19,72,4816,32,40,3046.88,5561.01,0.00
2024-12-10 17:38:19,72,4817,32,40,3021.72,5562.00,0.00
2024-12-10 17:38:19,73,4817,33,40,2980.33,5562.01,0.00
2024-12-10 17:38:19,72,4817,33,39,3019.42,5562.04,0.00
2024-12-10 17:38:19,72,4818,33,39,3007.31,5563.00,0.00
2024-12-10 17:38:19,73,4818,34,39,2966.12,5563.01,0.00
2024-12-10 17:38:19,73,4819,34,39,2934.56,5564.00,0.00
2024-12-10 17:38:19,74,4819,34,40,2894.90,5564.01,0.00
2024-12-10 17:38:19,73,4819,34,39,2930.00,5564.04,0.00
2024-12-10 17:38:19,74,4818,34,40,2865.76,5564.51,0.00
2024-12-10 17:38:19,74,4819,34,40,2917.72,5565.00,0.00
2024-12-10 17:38:19,75,4819,34,41,2878.82,5565.01,0.00
2024-12-10 17:38:19,74,4819,34,40,2910.97,5565.05,0.00
2024-12-10 17:38:19,74,4820,34,40,2968.31,5566.00,0.00
2024-12-10 17:38:19,75,4820,35,40,2928.74,5566.01,0.00
2024-12-10 17:38:19,75,4821,35,40,2892.41,5567.00,0.00
2024-12-10 17:38:19,76,4821,35,41,2854.35,5567.01,0.00
2024-12-10 17:38:20,75,4821,35,40,2885.75,5567.05,0.00
2024-12-10 17:38:20,75,4822,35,40,2865.95,5568.00,0.00
2024-12-10 17:38:20,76,4822,36,40,2828.24,5568.01,0.00
2024-12-10 17:38:20,75,4822,36,39,2856.72,5568.05,0.00
2024-12-10 17:38:20,74,4822,36,38,2825.61,5568.53,0.00
2024-12-10 17:38:20,74,4823,36,38,2874.83,5569.00,0.00
2024-12-10 17:38:20,75,4823,36,39,2836.50,5569.01,0.00
2024-12-10 17:38:20,75,4824,36,39,2805.05,5570.00,0.00
2024-12-10 17:38:20,76,4824,36,40,2768.14,5570.01,0.00
2024-12-10 17:38:20,75,4824,35,40,2804.69,5570.01,0.00
2024-12-10 17:38:20,74,4824,35,39,2838.08,5570.04,0.00
2024-12-10 17:38:20,73,4824,34,39,2868.45,5570.19,0.00
2024-12-10 17:38:20,73,4825,34,39,2892.92,5571.00,0.00
2024-12-10 17:38:20,74,4825,34,40,2853.83,5571.01,0.00
2024-12-10 17:38:20,73,4825,33,40,2855.61,5571.30,0.00
2024-12-10 17:38:20,74,4824,34,40,2804.95,5571.50,0.00
2024-12-10 17:38:20,74,4825,34,40,2879.31,5572.00,0.00
2024-12-10 17:38:20,75,4825,34,41,2840.92,5572.01,0.00
2024-12-10 17:38:20,74,4825,34,40,2874.80,5572.04,0.00
2024-12-10 17:38:20,74,4826,34,40,2939.07,5573.00,0.00
2024-12-10 17:38:20,75,4826,34,41,2899.88,5573.01,0.00
2024-12-10 17:38:20,74,4826,33,41,2925.52,5573.03,0.00
2024-12-10 17:38:20,74,4827,33,41,2926.92,5574.00,0.00
2024-12-10 17:38:20,75,4827,34,41,2887.89,5574.01,0.00
2024-12-10 17:38:20,74,4827,34,40,2923.16,5574.03,0.00
2024-12-10 17:38:20,73,4827,33,40,2930.40,5574.14,0.00
2024-12-10 17:38:20,72,4827,32,40,2968.79,5574.18,0.00
2024-12-10 17:38:20,71,4827,31,40,2985.40,5574.47,0.00
2024-12-10 17:38:20,70,4827,30,40,3015.22,5574.66,0.00
2024-12-10 17:38:20,70,4828,30,40,3076.00,5575.00,0.00
2024-12-10 17:38:20,71,4828,31,40,3032.67,5575.01,0.00
2024-12-10 17:38:20,71,4829,31,40,2994.21,5576.00,0.00
2024-12-10 17:38:20,72,4829,32,40,2952.62,5576.01,0.00
2024-12-10 17:38:20,71,4829,32,39,2989.51,5576.04,0.00
2024-12-10 17:38:20,70,4829,32,38,3009.93,5576.34,0.00
2024-12-10 17:38:20,71,4828,32,39,2944.32,5576.75,0.00
2024-12-10 17:38:20,70,4828,31,39,2984.87,5576.86,0.00
2024-12-10 17:38:20,70,4829,31,39,3056.70,5577.00,0.00
2024-12-10 17:38:20,71,4829,32,39,3013.65,5577.01,0.00
2024-12-10 17:38:20,70,4829,31,39,3026.80,5577.26,0.00
2024-12-10 17:38:20,69,4829,30,39,3051.07,5577.38,0.00
2024-12-10 17:38:20,69,4830,30,39,3176.46,5578.00,0.00
2024-12-10 17:38:20,70,4830,31,39,3131.08,5578.01,0.00
2024-12-10 17:38:20,69,4830,31,38,3172.43,5578.04,0.00
2024-12-10 17:38:20,70,4829,32,38,3109.17,5578.37,0.00
2024-12-10 17:38:20,69,4829,31,38,3164.83,5578.49,0.00
2024-12-10 17:38:20,69,4830,31,38,3216.19,5579.00,0.00
2024-12-10 17:38:20,70,4830,32,38,3170.25,5579.01,0.00
2024-12-10 17:38:20,69,4830,31,38,3199.22,5579.03,0.00
2024-12-10 17:38:20,68,4830,30,38,3194.65,5579.65,0.00
2024-12-10 17:38:20,69,4829,31,38,3146.75,5579.70,0.00
2024-12-10 17:38:20,69,4830,31,38,3336.77,5580.00,0.00
2024-12-10 17:38:20,70,4830,31,39,3289.10,5580.01,0.00
2024-12-10 17:38:20,69,4830,31,38,3334.35,5580.03,0.00
2024-12-10 17:38:20,69,4831,31,38,3405.60,5581.00,0.00
2024-12-10 17:38:20,70,4831,31,39,3356.95,5581.01,0.00
2024-12-10 17:38:20,70,4832,31,39,3327.91,5582.00,0.00
2024-12-10 17:38:20,71,4832,32,39,3281.04,5582.01,0.00
2024-12-10 17:38:20,70,4832,32,38,3326.32,5582.03,0.00
2024-12-10 17:38:20,69,4832,31,38,3369.66,5582.12,0.00
2024-12-10 17:38:20,69,4833,31,38,3361.80,5583.00,0.00
2024-12-10 17:38:20,70,4833,31,39,3313.77,5583.01,0.00
2024-12-10 17:38:20,69,4833,31,38,3344.00,5583.03,0.00
2024-12-10 17:38:20,68,4833,30,38,3344.94,5583.49,0.00
2024-12-10 17:38:20,68,4834,30,38,3390.91,5584.00,0.00
2024-12-10 17:38:20,69,4834,31,38,3341.76,5584.02,0.00
2024-12-10 17:38:20,68,4834,31,37,3372.84,5584.03,0.00
2024-12-10 17:38:20,67,4834,30,37,3370.07,5584.51,0.00
2024-12-10 17:38:20,67,4835,30,37,3417.41,5585.00,0.00
2024-12-10 17:38:20,68,4835,31,37,3367.15,5585.02,0.00
2024-12-10 17:38:20,67,4835,30,37,3338.53,5585.81,0.00
2024-12-10 17:38:20,67,4836,30,37,3411.22,5586.00,0.00
2024-12-10 17:38:20,68,4836,30,38,3361.06,5586.02,0.00
2024-12-10 17:38:20,67,4836,30,37,3406.23,5586.05,0.00
2024-12-10 17:38:20,67,4837,30,37,3391.18,5587.00,0.00
2024-12-10 17:38:20,68,4837,30,38,3341.31,5587.02,0.00
2024-12-10 17:38:20,67,4837,30,37,3289.58,5587.72,0.00
2024-12-10 17:38:20,67,4838,30,37,3355.44,5588.00,0.00
2024-12-10 17:38:20,68,4838,30,38,3306.10,5588.02,0.00
2024-12-10 17:38:20,67,4838,30,37,3350.58,5588.05,0.00
2024-12-10 17:38:20,66,4838,29,37,3381.05,5588.27,0.00
2024-12-10 17:38:20,66,4839,29,37,3422.12,5589.00,0.00
2024-12-10 17:38:20,67,4839,29,38,3371.04,5589.02,0.00
2024-12-10 17:38:20,67,4840,29,38,3340.46,5590.00,0.00
2024-12-10 17:38:20,68,4840,30,38,3291.34,5590.02,0.00
2024-12-10 17:38:20,67,4840,30,37,3335.68,5590.05,0.00
2024-12-10 17:38:20,67,4841,30,37,3324.70,5591.00,0.00
2024-12-10 17:38:20,68,4841,30,38,3275.80,5591.02,0.00
2024-12-10 17:38:20,67,4841,29,38,3270.55,5591.39,0.00
2024-12-10 17:38:20,66,4841,28,38,3295.36,5591.68,0.00
2024-12-10 17:38:20,66,4842,28,38,3361.31,5592.00,0.00
2024-12-10 17:38:20,67,4842,29,38,3311.15,5592.02,0.00
2024-12-10 17:38:20,66,4842,28,38,3360.26,5592.03,0.00
2024-12-10 17:38:20,65,4842,28,37,3408.52,5592.03,0.00
2024-12-10 17:38:20,66,4841,28,38,3350.96,5592.17,0.00
2024-12-10 17:38:20,65,4841,27,38,3428.24,5592.39,0.00
2024-12-10 17:38:20,66,4840,27,39,3335.13,5592.94,0.00
2024-12-10 17:38:20,66,4841,27,39,3419.94,5593.00,0.00
2024-12-10 17:38:20,67,4841,27,40,3368.89,5593.02,0.00
2024-12-10 17:38:20,66,4841,26,40,3395.70,5593.11,0.00
2024-12-10 17:38:20,66,4842,26,40,3584.47,5594.00,0.00
2024-12-10 17:38:20,67,4842,26,41,3530.97,5594.02,0.00
2024-12-10 17:38:20,66,4842,26,40,3581.08,5594.03,0.00
2024-12-10 17:38:20,65,4842,25,40,3597.25,5594.15,0.00
2024-12-10 17:38:20,65,4843,25,40,3612.91,5595.00,0.00
2024-12-10 17:38:20,66,4843,25,41,3558.17,5595.02,0.00
2024-12-10 17:38:20,65,4843,24,41,3556.84,5595.14,0.00
2024-12-10 17:38:20,64,4843,24,40,3574.31,5595.58,0.00
2024-12-10 17:38:20,64,4844,24,40,3633.37,5596.00,0.00
2024-12-10 17:38:20,65,4844,25,40,3577.48,5596.02,0.00
2024-12-10 17:38:20,64,4844,25,39,3616.92,5596.05,0.00
2024-12-10 17:38:20,64,4845,25,39,3605.40,5597.00,0.00
2024-12-10 17:38:20,65,4845,25,40,3549.93,5597.02,0.00
2024-12-10 17:38:20,64,4845,25,39,3603.66,5597.03,0.00
2024-12-10 17:38:21,64,4846,25,39,3559.50,5598.00,0.00
2024-12-10 17:38:21,65,4846,26,39,3504.74,5598.02,0.00
2024-12-10 17:38:21,64,4846,26,38,3556.01,5598.03,0.00
2024-12-10 17:38:21,63,4846,25,38,3539.68,5598.78,0.00
2024-12-10 17:38:21,63,4847,25,38,3601.28,5599.00,0.00
2024-12-10 17:38:21,64,4847,26,38,3545.01,5599.02,0.00
2024-12-10 17:38:21,65,4846,27,38,3370.78,5599.80,0.00
2024-12-10 17:38:21,65,4847,27,38,3437.88,5600.00,0.00
2024-12-10 17:38:21,66,4847,27,39,3385.79,5600.02,0.00
2024-12-10 17:38:21,65,4847,27,38,3435.29,5600.03,0.00
2024-12-10 17:38:21,64,4847,26,38,3446.79,5600.39,0.00
2024-12-10 17:38:21,65,4846,27,38,3389.50,5600.49,0.00
2024-12-10 17:38:21,64,4846,27,37,3453.92,5600.53,0.00
2024-12-10 17:38:21,63,4846,26,37,3500.19,5600.64,0.00
2024-12-10 17:38:21,63,4847,26,37,3634.64,5601.00,0.00
2024-12-10 17:38:21,64,4847,27,37,3577.85,5601.02,0.00
2024-12-10 17:38:21,63,4847,27,36,3617.37,5601.03,0.00
2024-12-10 17:38:21,63,4848,27,36,3675.46,5602.00,0.00
2024-12-10 17:38:21,64,4848,28,36,3618.03,5602.02,0.00
2024-12-10 17:38:21,65,4847,28,37,3496.47,5602.52,0.00
2024-12-10 17:38:21,65,4848,28,37,3543.03,5603.00,0.00
2024-12-10 17:38:21,66,4848,29,37,3489.34,5603.02,0.00
2024-12-10 17:38:21,66,4849,29,37,3510.41,5604.00,0.00
2024-12-10 17:38:21,67,4849,30,37,3458.02,5604.02,0.00
2024-12-10 17:38:21,66,4849,30,36,3490.90,5604.05,0.00
2024-12-10 17:38:21,66,4850,30,36,3433.84,5605.00,0.00
2024-12-10 17:38:21,67,4850,31,36,3382.59,5605.02,0.00
2024-12-10 17:38:21,66,4850,30,36,3393.73,5605.17,0.00
2024-12-10 17:38:21,66,4851,30,36,3368.49,5606.00,0.00
2024-12-10 17:38:21,67,4851,30,37,3318.21,5606.02,0.00
2024-12-10 17:38:21,66,4851,30,36,3263.04,5606.65,0.00
2024-12-10 17:38:21,65,4851,29,36,3294.04,5606.82,0.00
2024-12-10 17:38:21,65,4852,29,36,3345.78,5607.00,0.00
2024-12-10 17:38:21,66,4852,30,36,3295.08,5607.02,0.00
2024-12-10 17:38:21,65,4852,29,36,3317.03,5607.03,0.00
2024-12-10 17:38:21,64,4852,28,36,3338.07,5607.22,0.00
2024-12-10 17:38:21,63,4852,27,36,3325.08,5607.86,0.00
2024-12-10 17:38:21,63,4853,27,36,3406.20,5608.00,0.00
2024-12-10 17:38:21,64,4853,28,36,3352.98,5608.02,0.00
2024-12-10 17:38:21,63,4853,28,35,3402.99,5608.03,0.00
2024-12-10 17:38:21,63,4854,28,35,3382.67,5609.00,0.00
2024-12-10 17:38:21,64,4854,28,36,3329.81,5609.02,0.00
2024-12-10 17:38:21,65,4853,29,36,3225.48,5609.52,0.00
2024-12-10 17:38:21,65,4854,29,36,3283.30,5610.00,0.00
2024-12-10 17:38:21,66,4854,30,36,3233.55,5610.02,0.00
2024-12-10 17:38:21,65,4854,30,35,3265.99,5610.03,0.00
2024-12-10 17:38:21,65,4855,30,35,3332.53,5611.00,0.00
2024-12-10 17:38:21,66,4855,31,35,3282.04,5611.02,0.00
2024-12-10 17:38:21,65,4855,30,35,3276.46,5611.14,0.00
2024-12-10 17:38:21,65,4856,30,35,3292.60,5612.00,0.00
2024-12-10 17:38:21,66,4856,30,36,3242.71,5612.02,0.00
2024-12-10 17:38:21,65,4856,30,35,3283.97,5612.05,0.00
2024-12-10 17:38:21,64,4856,30,34,3313.88,5612.28,0.00
2024-12-10 17:38:21,64,4857,30,34,3311.81,5613.00,0.00
2024-12-10 17:38:21,65,4857,31,34,3260.86,5613.02,0.00
2024-12-10 17:38:21,65,4858,31,34,3223.18,5614.00,0.00
2024-12-10 17:38:21,66,4858,32,34,3174.35,5614.02,0.00
2024-12-10 17:38:21,65,4858,32,33,3215.41,5614.05,0.00
2024-12-10 17:38:21,64,4858,31,33,3215.78,5614.72,0.00
2024-12-10 17:38:21,64,4859,31,33,3244.23,5615.00,0.00
2024-12-10 17:38:21,65,4859,32,33,3194.32,5615.02,0.00
2024-12-10 17:38:21,66,4858,33,33,3119.59,5615.21,0.00
2024-12-10 17:38:21,65,4858,32,33,3213.64,5615.79,0.00
2024-12-10 17:38:21,65,4859,32,33,3250.56,5616.00,0.00
2024-12-10 17:38:21,66,4859,33,33,3201.31,5616.02,0.00
2024-12-10 17:38:21,65,4859,33,32,3241.92,5616.06,0.00
2024-12-10 17:38:21,65,4860,33,32,3317.40,5617.00,0.00
2024-12-10 17:38:21,66,4860,33,33,3267.14,5617.02,0.00
2024-12-10 17:38:21,65,4860,32,33,3233.85,5617.55,0.00
2024-12-10 17:38:21,65,4861,32,33,3291.84,5618.00,0.00
2024-12-10 17:38:21,66,4861,32,34,3241.96,5618.02,0.00
2024-12-10 17:38:21,65,4861,32,33,3284.06,5618.06,0.00
2024-12-10 17:38:21,64,4861,31,33,3300.95,5618.36,0.00
2024-12-10 17:38:21,64,4862,31,33,3350.06,5619.00,0.00
2024-12-10 17:38:21,65,4862,31,34,3298.52,5619.02,0.00
2024-12-10 17:38:21,64,4862,30,34,3266.80,5619.88,0.00
2024-12-10 17:38:21,64,4863,30,34,3346.84,5620.00,0.00
2024-12-10 17:38:21,65,4863,30,35,3295.35,5620.02,0.00
2024-12-10 17:38:21,64,4863,29,35,3322.28,5620.14,0.00
2024-12-10 17:38:21,64,4864,29,35,3316.96,5621.00,0.00
2024-12-10 17:38:21,65,4864,29,36,3265.93,5621.02,0.00
2024-12-10 17:38:21,64,4864,29,35,3316.08,5621.02,0.00
2024-12-10 17:38:21,63,4864,29,34,3366.94,5621.03,0.00
2024-12-10 17:38:21,64,4863,29,35,3300.20,5621.27,0.00
2024-12-10 17:38:21,63,4863,28,35,3375.81,5621.37,0.00
2024-12-10 17:38:21,62,4863,28,34,3421.16,5621.53,0.00
2024-12-10 17:38:21,62,4864,28,34,3482.93,5622.00,0.00
2024-12-10 17:38:21,63,4864,29,34,3427.64,5622.02,0.00
2024-12-10 17:38:21,62,4864,29,33,3477.49,5622.03,0.00
2024-12-10 17:38:21,61,4864,28,33,3529.01,5622.13,0.00
2024-12-10 17:38:21,60,4864,27,33,3536.18,5622.83,0.00
2024-12-10 17:38:21,60,4865,27,33,3714.36,5623.00,0.00
2024-12-10 17:38:21,61,4865,27,34,3653.47,5623.02,0.00
2024-12-10 17:38:21,61,4866,27,34,3635.40,5624.00,0.00
2024-12-10 17:38:21,62,4866,27,35,3576.77,5624.02,0.00
2024-12-10 17:38:21,61,4866,27,34,3626.18,5624.03,0.00
2024-12-10 17:38:21,60,4866,26,34,3681.97,5624.12,0.00
2024-12-10 17:38:21,59,4866,25,34,3701.54,5624.22,0.00
2024-12-10 17:38:21,60,4865,25,35,3632.42,5624.38,0.00
2024-12-10 17:38:21,61,4864,26,35,3597.92,5624.61,0.00
2024-12-10 17:38:21,61,4865,26,35,3696.42,5625.00,0.00
2024-12-10 17:38:21,62,4865,26,36,3636.80,5625.02,0.00
2024-12-10 17:38:21,62,4866,26,36,3799.21,5626.00,0.00
2024-12-10 17:38:21,63,4866,26,37,3738.90,5626.02,0.00
2024-12-10 17:38:21,62,4866,26,36,3790.14,5626.03,0.00
2024-12-10 17:38:21,61,4866,25,36,3832.99,5626.20,0.00
2024-12-10 17:38:21,61,4867,25,36,3878.21,5627.00,0.00
2024-12-10 17:38:21,62,4867,25,37,3815.66,5627.02,0.00
2024-12-10 17:38:21,62,4868,25,37,3790.77,5628.00,0.00
2024-12-10 17:38:21,63,4868,25,38,3730.60,5628.02,0.00
2024-12-10 17:38:21,62,4868,25,37,3781.69,5628.03,0.00
2024-12-10 17:38:22,61,4868,24,37,3781.42,5628.52,0.00
2024-12-10 17:38:22,61,4869,24,37,3841.16,5629.00,0.00
2024-12-10 17:38:22,62,4869,24,38,3779.20,5629.02,0.00
2024-12-10 17:38:22,62,4870,24,38,3749.23,5630.00,0.00
2024-12-10 17:38:22,63,4870,24,39,3689.72,5630.02,0.00
2024-12-10 17:38:22,62,4870,24,38,3741.06,5630.03,0.00
2024-12-10 17:38:22,62,4871,24,38,3733.88,5631.00,0.00
2024-12-10 17:38:22,63,4871,24,39,3674.61,5631.02,0.00
2024-12-10 17:38:22,64,4870,25,39,3558.28,5631.64,0.00
2024-12-10 17:38:22,65,4869,26,39,3474.17,5631.98,0.00
2024-12-10 17:38:22,65,4870,26,39,3560.83,5632.00,0.00
2024-12-10 17:38:22,66,4870,26,40,3506.88,5632.02,0.00
2024-12-10 17:38:22,65,4870,26,39,3546.99,5632.06,0.00
2024-12-10 17:38:22,66,4869,26,40,3478.20,5632.29,0.00
2024-12-10 17:38:22,65,4869,25,40,3513.50,5632.62,0.00
2024-12-10 17:38:22,65,4870,25,40,3750.92,5633.00,0.00
2024-12-10 17:38:22,66,4870,25,41,3694.09,5633.02,0.00
2024-12-10 17:38:22,66,4871,25,41,3747.37,5634.00,0.00
2024-12-10 17:38:22,67,4871,25,42,3691.44,5634.02,0.00
2024-12-10 17:38:22,66,4871,25,41,3729.95,5634.08,0.00
2024-12-10 17:38:22,66,4872,25,41,3714.78,5635.00,0.00
2024-12-10 17:38:22,67,4872,26,41,3659.33,5635.02,0.00
2024-12-10 17:38:22,66,4872,25,41,3631.75,5635.61,0.00
2024-12-10 17:38:22,66,4873,25,41,3688.86,5636.00,0.00
2024-12-10 17:38:22,67,4873,26,41,3633.80,5636.02,0.00
2024-12-10 17:38:22,66,4873,25,41,3688.01,5636.02,0.00
2024-12-10 17:38:22,66,4874,25,41,3652.23,5637.00,0.00
2024-12-10 17:38:22,67,4874,25,42,3597.72,5637.02,0.00
2024-12-10 17:38:22,68,4873,25,43,3456.78,5637.82,0.00
2024-12-10 17:38:22,68,4874,25,43,3508.43,5638.00,0.00
2024-12-10 17:38:22,69,4874,26,43,3457.58,5638.02,0.00
2024-12-10 17:38:22,69,4875,26,43,3504.98,5639.00,0.00
2024-12-10 17:38:22,70,4875,27,43,3454.91,5639.01,0.00
2024-12-10 17:38:22,69,4875,27,42,3490.31,5639.07,0.00
2024-12-10 17:38:22,70,4874,28,42,3416.67,5639.44,0.00
2024-12-10 17:38:22,69,4874,27,42,3460.68,5639.94,0.00
2024-12-10 17:38:22,69,4875,27,42,3539.19,5640.00,0.00
2024-12-10 17:38:22,70,4875,28,42,3488.63,5640.01,0.00
2024-12-10 17:38:22,70,4876,28,42,3509.32,5641.00,0.00
2024-12-10 17:38:22,71,4876,29,42,3459.90,5641.01,0.00
2024-12-10 17:38:22,70,4876,28,42,3500.00,5641.01,0.00
2024-12-10 17:38:22,69,4876,28,41,3543.21,5641.07,0.00
2024-12-10 17:38:22,69,4877,28,41,3508.40,5642.00,0.00
2024-12-10 17:38:22,70,4877,29,41,3458.28,5642.01,0.00
2024-12-10 17:38:22,69,4877,28,41,3505.08,5642.07,0.00
2024-12-10 17:38:22,68,4877,27,41,3509.85,5642.12,0.00
2024-12-10 17:38:22,67,4877,27,40,3555.84,5642.22,0.00
2024-12-10 17:38:22,66,4877,26,40,3577.31,5642.46,0.00
2024-12-10 17:38:22,66,4878,26,40,3620.40,5643.00,0.00
2024-12-10 17:38:22,67,4878,27,40,3566.36,5643.02,0.00
2024-12-10 17:38:22,66,4878,27,39,3595.42,5643.09,0.00
2024-12-10 17:38:22,66,4879,27,39,3577.74,5644.00,0.00
2024-12-10 17:38:22,67,4879,28,39,3524.34,5644.02,0.00
2024-12-10 17:38:22,66,4879,27,39,3572.32,5644.08,0.00
2024-12-10 17:38:22,65,4879,26,39,3607.31,5644.11,0.00
2024-12-10 17:38:22,66,4878,26,40,3507.72,5644.65,0.00
2024-12-10 17:38:22,66,4879,26,40,3568.85,5645.00,0.00
2024-12-10 17:38:22,67,4879,27,40,3515.59,5645.02,0.00
2024-12-10 17:38:22,66,4879,27,39,3550.91,5645.08,0.00
2024-12-10 17:38:22,66,4880,27,39,3609.16,5646.00,0.00
2024-12-10 17:38:22,67,4880,27,40,3555.29,5646.02,0.00
2024-12-10 17:38:22,66,4880,26,40,3562.93,5646.42,0.00
2024-12-10 17:38:22,66,4881,26,40,3569.94,5647.00,0.00
2024-12-10 17:38:22,67,4881,27,40,3516.66,5647.02,0.00
2024-12-10 17:38:22,66,4881,27,39,3562.25,5647.06,0.00
2024-12-10 17:38:22,66,4882,27,39,3545.38,5648.00,0.00
2024-12-10 17:38:22,67,4882,28,39,3492.47,5648.02,0.00
2024-12-10 17:38:22,67,4883,28,39,3458.45,5649.00,0.00
2024-12-10 17:38:22,68,4883,28,40,3407.59,5649.02,0.00
2024-12-10 17:38:22,67,4883,28,39,3443.28,5649.06,0.00
2024-12-10 17:38:22,67,4884,28,39,3429.35,5650.00,0.00
2024-12-10 17:38:22,68,4884,28,40,3378.92,5650.02,0.00
2024-12-10 17:38:22,67,4884,27,40,3390.39,5650.25,0.00
2024-12-10 17:38:22,66,4884,26,40,3438.29,5650.30,0.00
2024-12-10 17:38:22,66,4885,26,40,3469.46,5651.00,0.00
2024-12-10 17:38:22,67,4885,26,41,3417.67,5651.02,0.00
2024-12-10 17:38:22,66,4885,25,41,3405.56,5651.67,0.00
2024-12-10 17:38:22,66,4886,25,41,3449.09,5652.00,0.00
2024-12-10 17:38:22,67,4886,26,41,3397.61,5652.02,0.00
2024-12-10 17:38:22,66,4886,25,41,3418.55,5652.23,0.00
2024-12-10 17:38:22,65,4886,24,41,3398.06,5652.88,0.00
2024-12-10 17:38:22,65,4887,24,41,3472.27,5653.00,0.00
2024-12-10 17:38:22,66,4887,25,41,3419.66,5653.02,0.00
2024-12-10 17:38:22,65,4887,25,40,3452.28,5653.06,0.00
2024-12-10 17:38:22,65,4888,25,40,3425.20,5654.00,0.00
2024-12-10 17:38:22,66,4888,26,40,3373.31,5654.02,0.00
2024-12-10 17:38:22,66,4889,26,40,3321.77,5655.00,0.00
2024-12-10 17:38:22,67,4889,27,40,3272.19,5655.02,0.00
2024-12-10 17:38:22,66,4889,27,39,3307.22,5655.06,0.00
2024-12-10 17:38:22,65,4889,26,39,3342.53,5655.26,0.00
2024-12-10 17:38:22,65,4890,26,39,3327.90,5656.00,0.00
2024-12-10 17:38:22,66,4890,26,40,3277.48,5656.02,0.00
2024-12-10 17:38:22,65,4890,25,40,3277.10,5656.29,0.00
2024-12-10 17:38:22,65,4890,25,40,3295.66,5657.00,0.00
2024-12-10 17:38:22,66,4890,26,40,3245.73,5657.02,0.00
2024-12-10 17:38:22,65,4890,26,39,3275.67,5657.11,0.00
2024-12-10 17:38:22,64,4890,25,39,3240.78,5657.70,0.00
2024-12-10 17:38:22,64,4891,25,39,3307.86,5658.00,0.00
2024-12-10 17:38:22,65,4891,26,39,3256.97,5658.02,0.00
2024-12-10 17:38:23,66,4890,26,40,3108.33,5658.73,0.00
2024-12-10 17:38:23,66,4891,26,40,3196.55,5659.00,0.00
2024-12-10 17:38:23,67,4891,27,40,3148.84,5659.02,0.00
2024-12-10 17:38:23,66,4891,27,39,3177.50,5659.11,0.00
2024-12-10 17:38:23,65,4891,26,39,3182.35,5659.37,0.00
2024-12-10 17:38:23,64,4891,25,39,3227.29,5659.42,0.00
2024-12-10 17:38:23,64,4892,25,39,3363.53,5660.00,0.00
2024-12-10 17:38:23,65,4892,26,39,3311.78,5660.02,0.00
2024-12-10 17:38:23,65,4893,26,39,3276.28,5661.00,0.00
2024-12-10 17:38:23,66,4893,26,40,3226.64,5661.02,0.00
2024-12-10 17:38:23,65,4893,26,39,3235.04,5661.35,0.00
2024-12-10 17:38:23,65,4894,26,39,3237.64,5662.00,0.00
2024-12-10 17:38:23,66,4894,26,40,3188.58,5662.02,0.00
2024-12-10 17:38:23,65,4894,26,39,3224.52,5662.08,0.00
2024-12-10 17:38:23,65,4895,26,39,3208.15,5663.00,0.00
2024-12-10 17:38:23,66,4895,26,40,3159.54,5663.02,0.00
2024-12-10 17:38:23,65,4895,26,39,3190.77,5663.09,0.00
2024-12-10 17:38:23,64,4895,25,39,3192.65,5663.69,0.00
2024-12-10 17:38:23,63,4895,24,39,3204.95,5663.97,0.00
2024-12-10 17:38:23,63,4896,24,39,3293.07,5664.00,0.00
2024-12-10 17:38:23,64,4896,25,39,3241.62,5664.02,0.00
2024-12-10 17:38:23,63,4896,25,38,3175.39,5664.73,0.00
2024-12-10 17:38:23,63,4897,25,38,3246.40,5665.00,0.00
2024-12-10 17:38:23,64,4897,26,38,3195.68,5665.02,0.00
2024-12-10 17:38:23,63,4897,26,37,3244.61,5665.03,0.00
2024-12-10 17:38:23,62,4897,26,36,3277.92,5665.08,0.00
2024-12-10 17:38:23,62,4898,26,36,3256.96,5666.00,0.00
2024-12-10 17:38:23,63,4898,26,37,3205.27,5666.02,0.00
2024-12-10 17:38:23,63,4899,26,37,3155.13,5667.00,0.00
2024-12-10 17:38:23,64,4899,26,38,3105.83,5667.02,0.00
2024-12-10 17:38:23,63,4899,26,37,3148.71,5667.05,0.00
2024-12-10 17:38:23,63,4900,26,37,3098.95,5668.00,0.00
2024-12-10 17:38:23,64,4900,26,38,3050.53,5668.02,0.00
2024-12-10 17:38:23,63,4900,26,37,3085.59,5668.14,0.00
2024-12-10 17:38:23,62,4900,26,36,3121.97,5668.36,0.00
2024-12-10 17:38:23,61,4900,25,36,3154.79,5668.43,0.00
2024-12-10 17:38:23,61,4901,25,36,3191.16,5669.00,0.00
2024-12-10 17:38:23,62,4901,25,37,3139.69,5669.02,0.00
2024-12-10 17:38:23,62,4902,25,37,3102.78,5670.00,0.00
2024-12-10 17:38:23,63,4902,26,37,3053.53,5670.02,0.00
2024-12-10 17:38:23,62,4902,26,36,3077.20,5670.15,0.00
2024-12-10 17:38:23,61,4902,25,36,3055.87,5670.75,0.00
2024-12-10 17:38:23,61,4903,25,36,3131.53,5671.00,0.00
2024-12-10 17:38:23,62,4903,26,36,3081.02,5671.02,0.00
2024-12-10 17:38:23,61,4903,25,36,3099.03,5671.16,0.00
2024-12-10 17:38:23,61,4904,25,36,3115.07,5672.00,0.00
2024-12-10 17:38:23,62,4904,26,36,3064.83,5672.02,0.00
2024-12-10 17:38:23,61,4904,26,35,3088.01,5672.15,0.00
2024-12-10 17:38:23,60,4904,25,35,3100.80,5672.63,0.00
2024-12-10 17:38:23,59,4904,24,35,3141.47,5672.70,0.00
2024-12-10 17:38:23,59,4905,24,35,3178.02,5673.00,0.00
2024-12-10 17:38:23,60,4905,25,35,3125.05,5673.02,0.00
2024-12-10 17:38:23,59,4905,24,35,3160.18,5673.03,0.00
2024-12-10 17:38:23,59,4906,24,35,3159.24,5674.00,0.00
2024-12-10 17:38:23,60,4906,24,36,3106.59,5674.02,0.00
2024-12-10 17:38:23,59,4906,24,35,3146.75,5674.09,0.00
2024-12-10 17:38:23,59,4907,24,35,3130.64,5675.00,0.00
2024-12-10 17:38:23,60,4907,24,36,3078.47,5675.02,0.00
2024-12-10 17:38:23,59,4907,24,35,3059.95,5675.63,0.00
2024-12-10 17:38:23,59,4908,24,35,3090.95,5676.00,0.00
2024-12-10 17:38:23,60,4908,24,36,3039.44,5676.02,0.00
2024-12-10 17:38:23,59,4908,24,35,3082.06,5676.12,0.00
2024-12-10 17:38:23,58,4908,23,35,3051.56,5676.97,0.00
2024-12-10 17:38:23,58,4909,23,35,3147.50,5677.00,0.00
2024-12-10 17:38:23,59,4909,24,35,3094.16,5677.02,0.00
2024-12-10 17:38:23,58,4909,23,35,3091.86,5677.48,0.00
2024-12-10 17:38:23,58,4910,23,35,3119.35,5678.00,0.00
2024-12-10 17:38:23,59,4910,23,36,3066.48,5678.02,0.00
2024-12-10 17:38:23,58,4910,23,35,3091.40,5678.12,0.00
2024-12-10 17:38:23,58,4911,23,35,3086.48,5679.00,0.00
2024-12-10 17:38:23,59,4911,24,35,3034.17,5679.02,0.00
2024-12-10 17:38:23,58,4911,23,35,3085.51,5679.02,0.00
2024-12-10 17:38:23,59,4910,23,36,3002.57,5679.22,0.00
2024-12-10 17:38:23,58,4910,22,36,3089.70,5679.50,0.00
2024-12-10 17:38:23,58,4911,22,36,3117.90,5680.00,0.00
2024-12-10 17:38:23,59,4911,23,36,3065.05,5680.02,0.00
2024-12-10 17:38:23,58,4911,23,35,3091.22,5680.10,0.00
2024-12-10 17:38:23,57,4911,23,34,3113.60,5680.65,0.00
2024-12-10 17:38:23,57,4912,23,34,3246.69,5681.00,0.00
2024-12-10 17:38:23,58,4912,24,34,3190.71,5681.02,0.00
2024-12-10 17:38:23,57,4912,23,34,3234.73,5681.02,0.00
2024-12-10 17:38:23,57,4913,23,34,3247.73,5682.00,0.00
2024-12-10 17:38:23,58,4913,23,35,3191.74,5682.02,0.00
2024-12-10 17:38:23,57,4913,23,34,3221.92,5682.09,0.00
2024-12-10 17:38:23,57,4914,23,34,3217.59,5683.00,0.00
2024-12-10 17:38:23,58,4914,24,34,3162.12,5683.02,0.00
2024-12-10 17:38:23,58,4915,24,34,3159.44,5684.00,0.00
2024-12-10 17:38:23,59,4915,25,34,3105.89,5684.02,0.00
2024-12-10 17:38:23,60,4914,25,35,2989.80,5684.73,0.00
2024-12-10 17:38:23,60,4915,25,35,3060.60,5685.00,0.00
2024-12-10 17:38:23,61,4915,26,35,3010.43,5685.02,0.00
2024-12-10 17:38:23,61,4916,26,35,3083.04,5686.00,0.00
2024-12-10 17:38:23,62,4916,27,35,3033.31,5686.02,0.00
2024-12-10 17:38:23,61,4916,27,34,3016.92,5686.72,0.00
2024-12-10 17:38:23,61,4917,27,34,3063.09,5687.00,0.00
2024-12-10 17:38:23,62,4917,27,35,3013.68,5687.02,0.00
2024-12-10 17:38:23,61,4917,26,35,3061.04,5687.05,0.00
2024-12-10 17:38:23,60,4917,26,34,3095.97,5687.12,0.00
2024-12-10 17:38:24,60,4917,26,34,3098.23,5688.00,0.00
2024-12-10 17:38:24,61,4917,27,34,3047.44,5688.02,0.00
2024-12-10 17:38:24,60,4917,26,34,3055.86,5688.40,0.00
2024-12-10 17:38:24,60,4918,26,34,3086.60,5689.00,0.00
2024-12-10 17:38:24,61,4918,26,35,3036.00,5689.02,0.00
2024-12-10 17:38:24,61,4919,26,35,3021.46,5690.00,0.00
2024-12-10 17:38:24,62,4919,26,36,2972.73,5690.02,0.00
2024-12-10 17:38:24,61,4919,26,35,3004.68,5690.08,0.00
2024-12-10 17:38:24,61,4920,26,35,3001.31,5691.00,0.00
2024-12-10 17:38:24,62,4920,26,36,2952.90,5691.02,0.00
2024-12-10 17:38:24,61,4920,25,36,2961.57,5691.34,0.00
2024-12-10 17:38:24,60,4920,24,36,2940.40,5691.97,0.00
2024-12-10 17:38:24,60,4921,24,36,3033.39,5692.00,0.00
2024-12-10 17:38:24,61,4921,24,37,2983.66,5692.02,0.00
2024-12-10 17:38:24,60,4921,24,36,3017.27,5692.08,0.00
2024-12-10 17:38:24,59,4921,23,36,3054.77,5692.32,0.00
2024-12-10 17:38:24,59,4922,23,36,3058.89,5693.00,0.00
2024-12-10 17:38:24,60,4922,24,36,3007.91,5693.02,0.00
2024-12-10 17:38:24,59,4922,24,35,3042.49,5693.09,0.00
2024-12-10 17:38:24,58,4922,24,34,3074.03,5693.31,0.00
2024-12-10 17:38:24,57,4922,23,34,3077.09,5693.91,0.00
2024-12-10 17:38:24,57,4923,23,34,3172.06,5694.00,0.00
2024-12-10 17:38:24,58,4923,23,35,3117.37,5694.02,0.00
2024-12-10 17:38:24,57,4923,22,35,3162.56,5694.05,0.00
2024-12-10 17:38:24,57,4924,22,35,3185.43,5695.00,0.00
2024-12-10 17:38:24,58,4924,23,35,3130.51,5695.02,0.00
2024-12-10 17:38:24,58,4925,23,35,3116.98,5696.00,0.00
2024-12-10 17:38:24,59,4925,24,35,3064.15,5696.02,0.00
2024-12-10 17:38:24,58,4925,24,34,3095.60,5696.10,0.00
2024-12-10 17:38:24,58,4926,24,34,3099.54,5697.00,0.00
2024-12-10 17:38:24,59,4926,24,35,3047.01,5697.02,0.00
2024-12-10 17:38:24,59,4927,24,35,3029.18,5698.00,0.00
2024-12-10 17:38:24,60,4927,25,35,2978.70,5698.02,0.00
2024-12-10 17:38:24,59,4927,25,34,3008.20,5698.10,0.00
2024-12-10 17:38:24,59,4928,25,34,3010.39,5699.00,0.00
2024-12-10 17:38:24,60,4928,25,35,2960.21,5699.02,0.00
2024-12-10 17:38:24,59,4928,24,35,3009.42,5699.02,0.00
2024-12-10 17:38:24,60,4927,25,35,2923.16,5699.25,0.00
2024-12-10 17:38:24,60,4928,25,35,3031.96,5700.00,0.00
2024-12-10 17:38:24,61,4928,25,36,2982.26,5700.02,0.00
2024-12-10 17:38:24,60,4928,25,35,3031.01,5700.02,0.00
2024-12-10 17:38:24,59,4928,25,34,3058.82,5700.09,0.00
2024-12-10 17:38:24,58,4928,24,34,3076.35,5700.50,0.00
2024-12-10 17:38:24,58,4929,24,34,3244.75,5701.00,0.00
2024-12-10 17:38:24,59,4929,25,34,3189.76,5701.02,0.00
2024-12-10 17:38:24,58,4929,25,33,3234.90,5701.05,0.00
2024-12-10 17:38:24,59,4928,26,33,3155.93,5701.17,0.00
2024-12-10 17:38:24,59,4929,26,33,3226.21,5702.00,0.00
2024-12-10 17:38:24,60,4929,27,33,3172.44,5702.02,0.00
2024-12-10 17:38:24,59,4929,27,32,3212.69,5702.07,0.00
2024-12-10 17:38:24,59,4930,27,32,3310.52,5703.00,0.00
2024-12-10 17:38:24,60,4930,27,33,3255.34,5703.02,0.00
2024-12-10 17:38:24,60,4931,27,33,3236.17,5704.00,0.00
2024-12-10 17:38:24,61,4931,27,34,3183.12,5704.02,0.00
2024-12-10 17:38:24,60,4931,27,33,3223.82,5704.07,0.00
2024-12-10 17:38:24,59,4931,26,33,3208.57,5704.59,0.00
2024-12-10 17:38:24,59,4932,26,33,3281.73,5705.00,0.00
2024-12-10 17:38:24,60,4932,26,34,3227.04,5705.02,0.00
2024-12-10 17:38:24,59,4932,25,34,3227.15,5705.46,0.00
2024-12-10 17:38:24,59,4933,25,34,3293.30,5706.00,0.00
2024-12-10 17:38:24,60,4933,26,34,3238.41,5706.02,0.00
2024-12-10 17:38:24,59,4933,26,33,3291.36,5706.03,0.00
2024-12-10 17:38:24,58,4933,25,33,3290.12,5706.76,0.00
2024-12-10 17:38:24,58,4934,25,33,3374.93,5707.00,0.00
2024-12-10 17:38:24,59,4934,25,34,3317.73,5707.02,0.00
2024-12-10 17:38:24,58,4934,25,33,3365.10,5707.05,0.00
2024-12-10 17:38:24,58,4935,25,33,3361.33,5708.00,0.00
2024-12-10 17:38:24,59,4935,26,33,3304.36,5708.02,0.00
2024-12-10 17:38:24,59,4936,26,33,3300.43,5709.00,0.00
2024-12-10 17:38:24,60,4936,27,33,3245.42,5709.02,0.00
2024-12-10 17:38:24,60,4937,27,33,3229.13,5710.00,0.00
2024-12-10 17:38:24,61,4937,28,33,3176.19,5710.02,0.00
2024-12-10 17:38:24,60,4937,28,32,3178.87,5710.38,0.00
2024-12-10 17:38:24,60,4938,28,32,3212.78,5711.00,0.00
2024-12-10 17:38:24,61,4938,28,33,3160.11,5711.02,0.00
2024-12-10 17:38:24,60,4938,27,33,3187.95,5711.12,0.00
2024-12-10 17:38:24,61,4937,27,34,3131.97,5711.21,0.00
2024-12-10 17:38:24,61,4938,27,34,3190.30,5712.00,0.00
2024-12-10 17:38:24,62,4938,28,34,3138.84,5712.02,0.00
2024-12-10 17:38:24,61,4938,28,33,3178.13,5712.07,0.00
2024-12-10 17:38:24,61,4939,28,33,3265.25,5713.00,0.00
2024-12-10 17:38:24,62,4939,29,33,3212.59,5713.02,0.00
2024-12-10 17:38:24,61,4939,29,32,3249.42,5713.07,0.00
2024-12-10 17:38:24,60,4939,28,32,3260.87,5713.40,0.00
2024-12-10 17:38:24,60,4940,28,32,3309.88,5714.00,0.00
2024-12-10 17:38:24,61,4940,29,32,3255.62,5714.02,0.00
2024-12-10 17:38:24,61,4941,29,32,3226.84,5715.00,0.00
2024-12-10 17:38:24,62,4941,29,33,3174.80,5715.02,0.00
2024-12-10 17:38:24,61,4941,29,32,3209.06,5715.08,0.00
2024-12-10 17:38:24,61,4942,29,32,3191.78,5716.00,0.00
2024-12-10 17:38:24,62,4942,29,33,3140.30,5716.02,0.00
2024-12-10 17:38:24,61,4942,29,32,3124.36,5716.69,0.00
2024-12-10 17:38:24,61,4943,29,32,3165.96,5717.00,0.00
2024-12-10 17:38:24,62,4943,29,33,3114.90,5717.02,0.00
2024-12-10 17:38:24,61,4943,29,32,3148.17,5717.08,0.00
2024-12-10 17:38:24,60,4943,29,31,3187.99,5717.28,0.00
2024-12-10 17:38:24,60,4944,29,31,3199.78,5718.00,0.00
2024-12-10 17:38:24,61,4944,29,32,3147.33,5718.02,0.00
2024-12-10 17:38:24,60,4944,28,32,3172.19,5718.15,0.00
2024-12-10 17:38:24,60,4945,28,32,3205.70,5719.00,0.00
2024-12-10 17:38:24,61,4945,28,33,3153.15,5719.02,0.00
2024-12-10 17:38:24,60,4945,27,33,3155.99,5719.35,0.00
2024-12-10 17:38:24,60,4946,27,33,3208.67,5720.00,0.00
2024-12-10 17:38:24,61,4946,28,33,3156.07,5720.02,0.00
2024-12-10 17:38:24,60,4946,27,33,3179.38,5720.15,0.00
2024-12-10 17:38:25,60,4947,27,33,3218.75,5721.00,0.00
2024-12-10 17:38:25,61,4947,28,33,3165.98,5721.02,0.00
2024-12-10 17:38:25,60,4947,28,32,3217.79,5721.02,0.00
2024-12-10 17:38:25,59,4947,27,32,3222.28,5721.54,0.00
2024-12-10 17:38:25,60,4946,27,33,3145.02,5721.80,0.00
2024-12-10 17:38:25,60,4947,27,33,3226.06,5722.00,0.00
2024-12-10 17:38:25,61,4947,27,34,3173.18,5722.02,0.00
2024-12-10 17:38:25,60,4947,27,33,3211.78,5722.10,0.00
2024-12-10 17:38:25,60,4948,27,33,3301.15,5723.00,0.00
2024-12-10 17:38:25,61,4948,27,34,3247.03,5723.02,0.00
2024-12-10 17:38:25,61,4949,27,34,3222.24,5724.00,0.00
2024-12-10 17:38:25,62,4949,28,34,3170.27,5724.02,0.00
2024-12-10 17:38:25,61,4949,28,33,3199.74,5724.12,0.00
2024-12-10 17:38:25,60,4949,27,33,3221.34,5724.58,0.00
2024-12-10 17:38:25,60,4950,27,33,3277.39,5725.00,0.00
2024-12-10 17:38:25,61,4950,27,34,3223.67,5725.02,0.00
2024-12-10 17:38:25,60,4950,26,34,3250.71,5725.15,0.00
2024-12-10 17:38:25,59,4950,25,34,3273.16,5725.58,0.00
2024-12-10 17:38:25,59,4951,25,34,3305.42,5726.00,0.00
2024-12-10 17:38:25,60,4951,26,34,3250.33,5726.02,0.00
2024-12-10 17:38:25,59,4951,26,33,3283.12,5726.12,0.00
2024-12-10 17:38:25,58,4951,25,33,3259.17,5726.91,0.00
2024-12-10 17:38:25,58,4952,25,33,3353.04,5727.00,0.00
2024-12-10 17:38:25,59,4952,25,34,3296.21,5727.02,0.00
2024-12-10 17:38:25,58,4952,24,34,3351.11,5727.04,0.00
2024-12-10 17:38:25,57,4952,23,34,3361.46,5727.53,0.00
2024-12-10 17:38:25,57,4953,23,34,3385.33,5728.00,0.00
2024-12-10 17:38:25,58,4953,23,35,3326.96,5728.02,0.00
2024-12-10 17:38:25,57,4953,23,34,3364.25,5728.11,0.00
2024-12-10 17:38:25,57,4954,23,34,3354.59,5729.00,0.00
2024-12-10 17:38:25,58,4954,23,35,3296.75,5729.02,0.00
2024-12-10 17:38:25,58,4955,23,35,3263.60,5730.00,0.00
2024-12-10 17:38:25,59,4955,24,35,3208.29,5730.02,0.00
2024-12-10 17:38:25,58,4955,24,34,3240.91,5730.12,0.00
2024-12-10 17:38:25,58,4956,24,34,3222.52,5731.00,0.00
2024-12-10 17:38:25,59,4956,24,35,3167.90,5731.02,0.00
2024-12-10 17:38:25,58,4956,24,34,3221.53,5731.02,0.00
2024-12-10 17:38:25,57,4956,23,34,3225.15,5731.56,0.00
2024-12-10 17:38:25,56,4956,22,34,3276.85,5731.59,0.00
2024-12-10 17:38:25,56,4957,22,34,3334.46,5732.00,0.00
2024-12-10 17:38:25,57,4957,23,34,3275.96,5732.02,0.00
2024-12-10 17:38:25,56,4957,22,34,3329.37,5732.11,0.00
2024-12-10 17:38:25,56,4958,22,34,3292.44,5733.00,0.00
2024-12-10 17:38:25,57,4958,23,34,3234.68,5733.02,0.00
2024-12-10 17:38:25,56,4958,23,33,3285.30,5733.11,0.00
2024-12-10 17:38:25,56,4959,23,33,3262.70,5734.00,0.00
2024-12-10 17:38:25,57,4959,23,34,3205.46,5734.02,0.00
2024-12-10 17:38:25,56,4959,22,34,3193.62,5734.57,0.00
2024-12-10 17:38:25,56,4960,22,34,3216.84,5735.00,0.00
2024-12-10 17:38:25,57,4960,22,35,3160.40,5735.02,0.00
2024-12-10 17:38:25,56,4960,22,34,3190.23,5735.11,0.00
2024-12-10 17:38:25,57,4959,22,35,3133.26,5735.16,0.00
2024-12-10 17:38:25,56,4959,21,35,3204.22,5735.55,0.00
2024-12-10 17:38:25,55,4959,20,35,3234.89,5735.64,0.00
2024-12-10 17:38:25,55,4960,20,35,3304.48,5736.00,0.00
2024-12-10 17:38:25,56,4960,20,36,3245.47,5736.02,0.00
2024-12-10 17:38:25,55,4960,20,35,3251.78,5736.55,0.00
2024-12-10 17:38:25,56,4959,21,35,3175.83,5736.73,0.00
2024-12-10 17:38:25,56,4960,21,35,3377.64,5737.00,0.00
2024-12-10 17:38:25,57,4960,21,36,3318.39,5737.02,0.00
2024-12-10 17:38:25,56,4960,21,35,3352.05,5737.11,0.00
2024-12-10 17:38:25,55,4960,20,35,3330.37,5737.85,0.00
2024-12-10 17:38:25,55,4961,20,35,3524.52,5738.00,0.00
2024-12-10 17:38:25,56,4961,20,36,3461.58,5738.02,0.00
2024-12-10 17:38:25,56,4962,20,36,3456.14,5739.00,0.00
2024-12-10 17:38:25,57,4962,20,37,3395.50,5739.02,0.00
2024-12-10 17:38:25,56,4962,19,37,3453.45,5739.05,0.00
2024-12-10 17:38:25,56,4963,19,37,3457.99,5740.00,0.00
2024-12-10 17:38:25,57,4963,20,37,3397.32,5740.02,0.00
2024-12-10 17:38:25,57,4964,20,37,3376.16,5741.00,0.00
2024-12-10 17:38:25,58,4964,20,38,3317.95,5741.02,0.00
2024-12-10 17:38:25,57,4964,19,38,3343.90,5741.18,0.00
2024-12-10 17:38:25,56,4964,19,37,3375.31,5741.55,0.00
2024-12-10 17:38:25,56,4965,19,37,3435.05,5742.00,0.00
2024-12-10 17:38:25,57,4965,19,38,3374.79,5742.02,0.00
2024-12-10 17:38:25,56,4965,19,37,3416.61,5742.09,0.00
2024-12-10 17:38:25,55,4965,18,37,3477.69,5742.11,0.00
2024-12-10 17:38:25,55,4966,18,37,3470.09,5743.00,0.00
2024-12-10 17:38:25,56,4966,19,37,3408.12,5743.02,0.00
2024-12-10 17:38:25,55,4966,18,37,3431.17,5743.16,0.00
2024-12-10 17:38:25,55,4967,18,37,3465.52,5744.00,0.00
2024-12-10 17:38:25,56,4967,18,38,3403.63,5744.02,0.00
2024-12-10 17:38:25,55,4967,18,37,3444.64,5744.09,0.00
2024-12-10 17:38:25,54,4967,18,36,3468.91,5744.57,0.00
2024-12-10 17:38:25,54,4968,18,36,3506.44,5745.00,0.00
2024-12-10 17:38:25,55,4968,19,36,3442.69,5745.02,0.00
2024-12-10 17:38:25,55,4969,19,36,3433.62,5746.00,0.00
2024-12-10 17:38:25,56,4969,20,36,3372.30,5746.02,0.00
2024-12-10 17:38:25,56,4970,20,36,3353.58,5747.00,0.00
2024-12-10 17:38:25,57,4970,21,36,3294.75,5747.02,0.00
2024-12-10 17:38:25,56,4970,21,35,3345.40,5747.14,0.00
2024-12-10 17:38:25,56,4971,21,35,3350.52,5748.00,0.00
2024-12-10 17:38:25,57,4971,21,36,3291.74,5748.02,0.00
2024-12-10 17:38:25,57,4972,21,36,3273.78,5749.00,0.00
2024-12-10 17:38:25,58,4972,22,36,3217.34,5749.02,0.00
2024-12-10 17:38:25,59,4971,22,37,3156.98,5749.15,0.00
2024-12-10 17:38:25,58,4971,22,36,3257.84,5749.16,0.00
2024-12-10 17:38:25,58,4972,22,36,3257.07,5750.00,0.00
2024-12-10 17:38:25,59,4972,23,36,3201.87,5750.02,0.00
2024-12-10 17:38:25,59,4973,23,36,3278.67,5751.00,0.00
2024-12-10 17:38:25,60,4973,24,36,3224.03,5751.02,0.00
2024-12-10 17:38:25,59,4973,24,35,3252.39,5751.14,0.00
2024-12-10 17:38:25,59,4974,24,35,3250.46,5752.00,0.00
2024-12-10 17:38:25,60,4974,25,35,3196.29,5752.02,0.00
2024-12-10 17:38:25,59,4974,24,35,3200.23,5752.54,0.00
2024-12-10 17:38:26,59,4975,24,35,3231.59,5753.00,0.00
2024-12-10 17:38:26,60,4975,24,36,3177.73,5753.02,0.00
2024-12-10 17:38:26,59,4975,23,36,3229.64,5753.03,0.00
2024-12-10 17:38:26,58,4975,23,35,3261.55,5753.12,0.00
2024-12-10 17:38:26,58,4976,23,35,3262.77,5754.00,0.00
2024-12-10 17:38:26,59,4976,24,35,3207.47,5754.02,0.00
2024-12-10 17:38:26,58,4976,23,35,3202.05,5754.59,0.00
2024-12-10 17:38:26,57,4976,23,34,3245.08,5754.72,0.00
2024-12-10 17:38:26,57,4977,23,34,3330.08,5755.00,0.00
2024-12-10 17:38:26,58,4977,23,35,3272.67,5755.02,0.00
2024-12-10 17:38:26,57,4977,23,34,3305.88,5755.12,0.00
2024-12-10 17:38:26,57,4978,23,34,3316.52,5756.00,0.00
2024-12-10 17:38:26,58,4978,24,34,3259.34,5756.02,0.00
2024-12-10 17:38:26,57,4978,23,34,3258.04,5756.58,0.00
2024-12-10 17:38:26,57,4979,23,34,3335.09,5757.00,0.00
2024-12-10 17:38:26,58,4979,23,35,3277.59,5757.02,0.00
2024-12-10 17:38:26,57,4979,22,35,3333.08,5757.04,0.00
2024-12-10 17:38:26,56,4979,22,34,3370.00,5757.11,0.00
2024-12-10 17:38:26,56,4980,22,34,3380.84,5758.00,0.00
2024-12-10 17:38:26,57,4980,23,34,3321.53,5758.02,0.00
2024-12-10 17:38:26,57,4981,23,34,3311.64,5759.00,0.00
2024-12-10 17:38:26,58,4981,24,34,3254.54,5759.02,0.00
2024-12-10 17:38:26,57,4981,24,33,3286.41,5759.12,0.00
2024-12-10 17:38:26,57,4982,24,33,3297.05,5760.00,0.00
2024-12-10 17:38:26,58,4982,24,34,3240.21,5760.02,0.00
2024-12-10 17:38:26,58,4983,24,34,3231.92,5761.00,0.00
2024-12-10 17:38:26,59,4983,25,34,3177.14,5761.02,0.00
2024-12-10 17:38:26,58,4983,25,33,3205.13,5761.14,0.00
2024-12-10 17:38:26,57,4983,24,33,3214.31,5761.72,0.00
2024-12-10 17:38:26,57,4984,24,33,3299.42,5762.00,0.00
2024-12-10 17:38:26,58,4984,25,33,3242.53,5762.02,0.00
2024-12-10 17:38:26,57,4984,24,33,3293.75,5762.11,0.00
2024-12-10 17:38:26,56,4984,23,33,3295.64,5762.34,0.00
2024-12-10 17:38:26,56,4985,23,33,3358.53,5763.00,0.00
2024-12-10 17:38:26,57,4985,24,33,3299.61,5763.02,0.00
2024-12-10 17:38:26,56,4985,24,32,3329.75,5763.14,0.00
2024-12-10 17:38:26,56,4986,24,32,3338.70,5764.00,0.00
2024-12-10 17:38:26,57,4986,24,33,3280.12,5764.02,0.00
2024-12-10 17:38:26,57,4987,24,33,3266.84,5765.00,0.00
2024-12-10 17:38:26,58,4987,25,33,3210.52,5765.02,0.00
2024-12-10 17:38:26,57,4987,24,33,3264.82,5765.04,0.00
2024-12-10 17:38:26,56,4987,24,32,3297.42,5765.13,0.00
2024-12-10 17:38:26,56,4988,24,32,3302.17,5766.00,0.00
2024-12-10 17:38:26,57,4988,24,33,3244.24,5766.02,0.00
2024-12-10 17:38:26,57,4989,24,33,3227.19,5767.00,0.00
2024-12-10 17:38:26,58,4989,25,33,3171.55,5767.02,0.00
2024-12-10 17:38:26,57,4989,25,32,3201.93,5767.12,0.00
2024-12-10 17:38:26,57,4990,25,32,3203.57,5768.00,0.00
2024-12-10 17:38:26,58,4990,26,32,3148.33,5768.02,0.00
2024-12-10 17:38:26,58,4991,26,32,3132.00,5769.00,0.00
2024-12-10 17:38:26,59,4991,27,32,3078.92,5769.02,0.00
2024-12-10 17:38:26,58,4991,27,31,3104.32,5769.12,0.00
2024-12-10 17:38:26,58,4992,27,31,3106.26,5770.00,0.00
2024-12-10 17:38:26,59,4992,28,31,3053.61,5770.02,0.00
2024-12-10 17:38:26,58,4992,27,31,3045.62,5770.55,0.00
2024-12-10 17:38:26,57,4992,26,31,3058.19,5770.90,0.00
2024-12-10 17:38:26,57,4993,26,31,3153.42,5771.00,0.00
2024-12-10 17:38:26,58,4993,27,31,3099.05,5771.02,0.00
2024-12-10 17:38:26,57,4993,27,30,3126.11,5771.12,0.00
2024-12-10 17:38:26,56,4993,27,29,3160.22,5771.41,0.00
2024-12-10 17:38:26,56,4994,27,29,3188.43,5772.00,0.00
2024-12-10 17:38:26,57,4994,28,29,3132.49,5772.02,0.00
2024-12-10 17:38:26,56,4994,27,29,3185.40,5772.05,0.00
2024-12-10 17:38:26,55,4994,26,29,3228.93,5772.13,0.00
2024-12-10 17:38:26,55,4995,26,29,3263.04,5773.00,0.00
2024-12-10 17:38:26,56,4995,26,30,3204.77,5773.02,0.00
2024-12-10 17:38:26,56,4996,26,30,3184.34,5774.00,0.00
2024-12-10 17:38:26,57,4996,26,31,3128.47,5774.02,0.00
2024-12-10 17:38:26,56,4996,26,30,3170.94,5774.13,0.00
2024-12-10 17:38:26,56,4997,26,30,3182.80,5775.00,0.00
2024-12-10 17:38:26,57,4997,27,30,3126.96,5775.02,0.00
2024-12-10 17:38:26,56,4997,26,30,3147.39,5775.09,0.00
2024-12-10 17:38:26,56,4998,26,30,3177.83,5776.00,0.00
2024-12-10 17:38:26,57,4998,26,31,3122.08,5776.02,0.00
2024-12-10 17:38:26,57,4999,26,31,3106.32,5777.00,0.00
2024-12-10 17:38:26,58,4999,27,31,3052.77,5777.02,0.00
2024-12-10 17:38:26,57,4999,27,30,3100.26,5777.11,0.00
2024-12-10 17:38:26,57,5000,27,30,3109.90,5778.00,0.00
2024-12-10 17:38:26,58,5000,28,30,3056.28,5778.02,0.00
2024-12-10 17:38:26,58,5001,28,30,3050.84,5779.00,0.00
2024-12-10 17:38:26,59,5001,29,30,2999.13,5779.02,0.00
2024-12-10 17:38:26,58,5001,29,29,3025.95,5779.10,0.00
2024-12-10 17:38:26,58,5002,29,29,3034.43,5780.00,0.00
2024-12-10 17:38:26,59,5002,30,29,2983.00,5780.02,0.00
2024-12-10 17:38:26,59,5003,30,29,2975.62,5781.00,0.00
2024-12-10 17:38:26,60,5003,30,30,2926.03,5781.02,0.00
2024-12-10 17:38:26,59,5003,30,29,2952.12,5781.10,0.00
2024-12-10 17:38:26,59,5004,30,29,2956.54,5782.00,0.00
2024-12-10 17:38:26,60,5004,30,30,2907.27,5782.02,0.00
2024-12-10 17:38:26,59,5004,30,29,2954.58,5782.03,0.00
2024-12-10 17:38:26,59,5005,30,29,2946.51,5783.00,0.00
2024-12-10 17:38:26,60,5005,31,29,2897.40,5783.02,0.00
2024-12-10 17:38:26,59,5005,31,28,2922.74,5783.09,0.00
2024-12-10 17:38:26,58,5005,30,28,2920.96,5783.67,0.00
2024-12-10 17:38:26,58,5006,30,28,3001.94,5784.00,0.00
2024-12-10 17:38:26,59,5006,31,28,2951.06,5784.02,0.00
2024-12-10 17:38:26,59,5007,31,28,2938.12,5785.00,0.00
2024-12-10 17:38:26,60,5007,31,29,2889.15,5785.02,0.00
2024-12-10 17:38:26,59,5007,31,28,2914.36,5785.09,0.00
2024-12-10 17:38:26,59,5008,31,28,2913.13,5786.00,0.00
2024-12-10 17:38:26,60,5008,31,29,2864.57,5786.02,0.00
2024-12-10 17:38:26,59,5008,30,29,2912.15,5786.02,0.00
2024-12-10 17:38:26,58,5008,29,29,2880.78,5786.78,0.00
2024-12-10 17:38:27,58,5009,29,29,2967.74,5787.00,0.00
2024-12-10 17:38:27,59,5009,30,29,2917.44,5787.02,0.00
2024-12-10 17:38:27,59,5010,30,29,2901.81,5788.00,0.00
2024-12-10 17:38:27,60,5010,30,30,2853.45,5788.02,0.00
2024-12-10 17:38:27,59,5010,29,30,2863.31,5788.22,0.00
2024-12-10 17:38:27,59,5011,29,30,2869.20,5789.00,0.00
2024-12-10 17:38:27,60,5011,30,30,2821.38,5789.02,0.00
2024-12-10 17:38:27,59,5011,30,29,2858.29,5789.14,0.00
2024-12-10 17:38:27,59,5012,30,29,2855.55,5790.00,0.00
2024-12-10 17:38:27,60,5012,31,29,2807.95,5790.02,0.00
2024-12-10 17:38:27,61,5011,32,29,2700.99,5790.59,0.00
2024-12-10 17:38:27,61,5012,32,29,2824.87,5791.00,0.00
2024-12-10 17:38:27,62,5012,32,30,2779.30,5791.02,0.00
2024-12-10 17:38:27,61,5012,32,29,2794.38,5791.13,0.00
2024-12-10 17:38:27,61,5013,32,29,2877.50,5792.00,0.00
2024-12-10 17:38:27,62,5013,32,30,2831.09,5792.02,0.00
2024-12-10 17:38:27,62,5014,32,30,2800.83,5793.00,0.00
2024-12-10 17:38:27,63,5014,32,31,2756.37,5793.02,0.00
2024-12-10 17:38:27,62,5014,31,31,2729.02,5793.56,0.00
2024-12-10 17:38:27,61,5014,30,31,2729.97,5793.77,0.00
2024-12-10 17:38:27,61,5015,30,31,2805.37,5794.00,0.00
2024-12-10 17:38:27,62,5015,30,32,2760.12,5794.02,0.00
2024-12-10 17:38:27,61,5015,30,31,2792.56,5794.13,0.00
2024-12-10 17:38:27,61,5016,30,31,2773.36,5795.00,0.00
2024-12-10 17:38:27,62,5016,31,31,2728.62,5795.02,0.00
2024-12-10 17:38:27,61,5016,31,30,2773.28,5795.02,0.00
2024-12-10 17:38:27,60,5016,31,29,2793.44,5795.12,0.00
2024-12-10 17:38:27,59,5016,30,29,2827.48,5795.34,0.00
2024-12-10 17:38:27,58,5016,30,28,2857.07,5795.48,0.00
2024-12-10 17:38:27,57,5016,29,28,2871.95,5795.56,0.00
2024-12-10 17:38:27,56,5016,28,28,2917.09,5795.66,0.00
2024-12-10 17:38:27,56,5017,28,28,2996.73,5796.00,0.00
2024-12-10 17:38:27,57,5017,28,29,2944.16,5796.02,0.00
2024-12-10 17:38:27,56,5017,27,29,2993.92,5796.05,0.00
2024-12-10 17:38:27,55,5017,26,29,3015.72,5796.16,0.00
2024-12-10 17:38:27,54,5017,25,29,3037.12,5796.54,0.00
2024-12-10 17:38:27,54,5018,25,29,3114.38,5797.00,0.00
2024-12-10 17:38:27,55,5018,26,29,3057.75,5797.02,0.00
2024-12-10 17:38:27,54,5018,25,29,3112.23,5797.02,0.00
2024-12-10 17:38:27,53,5018,25,28,3144.72,5797.09,0.00
2024-12-10 17:38:27,53,5019,25,28,3183.85,5798.00,0.00
2024-12-10 17:38:27,54,5019,26,28,3124.89,5798.02,0.00
2024-12-10 17:38:27,53,5019,25,28,3088.24,5798.79,0.00
2024-12-10 17:38:27,53,5020,25,28,3180.67,5799.00,0.00
2024-12-10 17:38:27,54,5020,26,28,3121.77,5799.02,0.00
2024-12-10 17:38:27,53,5020,26,27,3155.52,5799.09,0.00
2024-12-10 17:38:27,52,5020,25,27,3188.19,5799.44,0.00
2024-12-10 17:38:27,52,5021,25,27,3218.45,5800.00,0.00
2024-12-10 17:38:27,53,5021,26,27,3157.72,5800.02,0.00
2024-12-10 17:38:27,53,5022,26,27,3150.39,5801.00,0.00
2024-12-10 17:38:27,54,5022,27,27,3092.05,5801.02,0.00
2024-12-10 17:38:27,53,5022,27,26,3125.23,5801.09,0.00
2024-12-10 17:38:27,53,5023,27,26,3132.31,5802.00,0.00
2024-12-10 17:38:27,54,5023,27,27,3074.30,5802.02,0.00
2024-12-10 17:38:27,54,5024,27,27,3066.54,5803.00,0.00
2024-12-10 17:38:27,55,5024,28,27,3010.78,5803.02,0.00
2024-12-10 17:38:27,54,5024,28,26,3041.83,5803.09,0.00
2024-12-10 17:38:27,53,5024,27,26,3005.92,5803.91,0.00
2024-12-10 17:38:27,53,5025,27,26,3110.01,5804.00,0.00
2024-12-10 17:38:27,54,5025,27,27,3052.42,5804.02,0.00
2024-12-10 17:38:27,55,5024,28,27,2899.88,5804.67,0.00
2024-12-10 17:38:27,55,5025,28,27,3042.27,5805.00,0.00
2024-12-10 17:38:27,56,5025,29,27,2987.94,5805.02,0.00
2024-12-10 17:38:27,55,5025,29,26,3040.16,5805.04,0.00
2024-12-10 17:38:27,54,5025,29,25,3091.08,5805.06,0.00
2024-12-10 17:38:27,53,5025,28,25,3073.19,5805.60,0.00
2024-12-10 17:38:27,53,5026,28,25,3265.42,5806.00,0.00
2024-12-10 17:38:27,54,5026,28,26,3204.94,5806.02,0.00
2024-12-10 17:38:27,54,5027,28,26,3197.37,5807.00,0.00
2024-12-10 17:38:27,55,5027,28,27,3139.24,5807.02,0.00
2024-12-10 17:38:27,54,5027,28,26,3178.02,5807.06,0.00
2024-12-10 17:38:27,53,5027,27,26,3236.89,5807.08,0.00
2024-12-10 17:38:27,52,5027,26,26,3261.53,5807.69,0.00
2024-12-10 17:38:27,51,5027,25,26,3290.89,5807.86,0.00
2024-12-10 17:38:27,51,5028,25,26,3396.92,5808.00,0.00
2024-12-10 17:38:27,52,5028,25,27,3331.59,5808.02,0.00
2024-12-10 17:38:27,52,5029,25,27,3327.70,5809.00,0.00
2024-12-10 17:38:27,53,5029,25,28,3264.92,5809.02,0.00
2024-12-10 17:38:27,52,5029,25,27,3307.60,5809.06,0.00
2024-12-10 17:38:27,51,5029,24,27,3365.61,5809.06,0.00
2024-12-10 17:38:27,51,5030,24,27,3425.43,5810.00,0.00
2024-12-10 17:38:27,52,5030,24,28,3359.56,5810.02,0.00
2024-12-10 17:38:27,52,5031,24,28,3357.05,5811.00,0.00
2024-12-10 17:38:27,53,5031,24,29,3293.71,5811.02,0.00
2024-12-10 17:38:27,52,5031,24,28,3334.70,5811.06,0.00
2024-12-10 17:38:27,51,5031,23,28,3391.84,5811.06,0.00
2024-12-10 17:38:27,50,5031,22,28,3458.52,5811.08,0.00
2024-12-10 17:38:27,50,5032,22,28,3521.88,5812.00,0.00
2024-12-10 17:38:27,51,5032,23,28,3452.82,5812.02,0.00
2024-12-10 17:38:27,50,5032,22,28,3520.71,5812.02,0.00
2024-12-10 17:38:27,49,5032,21,28,3589.02,5812.06,0.00
2024-12-10 17:38:27,49,5033,21,28,3629.96,5813.00,0.00
2024-12-10 17:38:27,50,5033,21,29,3557.36,5813.02,0.00
2024-12-10 17:38:27,49,5033,21,28,3602.68,5813.06,0.00
2024-12-10 17:38:27,49,5034,21,28,3619.90,5814.00,0.00
2024-12-10 17:38:27,50,5034,21,29,3547.51,5814.02,0.00
2024-12-10 17:38:27,50,5035,21,29,3546.22,5815.00,0.00
2024-12-10 17:38:27,51,5035,21,30,3476.69,5815.02,0.00
2024-12-10 17:38:27,50,5035,20,30,3543.90,5815.06,0.00
2024-12-10 17:38:27,49,5035,20,29,3591.31,5815.06,0.00
2024-12-10 17:38:27,50,5034,20,30,3510.23,5815.26,0.00
2024-12-10 17:38:27,50,5035,20,30,3587.54,5816.00,0.00
2024-12-10 17:38:27,51,5035,21,30,3517.20,5816.02,0.00
2024-12-10 17:38:27,50,5035,20,30,3584.06,5816.06,0.00
2024-12-10 17:38:27,50,5036,20,30,3739.40,5817.00,0.00
2024-12-10 17:38:27,51,5036,20,31,3666.08,5817.02,0.00
2024-12-10 17:38:27,50,5036,20,30,3726.60,5817.02,0.00
2024-12-10 17:38:27,50,5037,20,30,3740.04,5818.00,0.00
2024-12-10 17:38:27,51,5037,20,31,3666.71,5818.02,0.00
2024-12-10 17:38:27,50,5037,20,30,3715.61,5818.04,0.00
2024-12-10 17:38:27,49,5037,19,30,3767.46,5818.45,0.00
2024-12-10 17:38:28,49,5038,19,30,3807.09,5819.00,0.00
2024-12-10 17:38:28,50,5038,20,30,3730.95,5819.02,0.00
2024-12-10 17:38:28,49,5038,19,30,3805.91,5819.04,0.00
2024-12-10 17:38:28,48,5038,18,30,3821.05,5819.27,0.00
2024-12-10 17:38:28,48,5039,18,30,3900.41,5820.00,0.00
2024-12-10 17:38:28,49,5039,19,30,3820.81,5820.02,0.00
2024-12-10 17:38:28,49,5040,19,30,3811.96,5821.00,0.00
2024-12-10 17:38:28,50,5040,20,30,3735.72,5821.02,0.00
2024-12-10 17:38:28,49,5040,20,29,3804.85,5821.06,0.00
2024-12-10 17:38:28,49,5041,20,29,3822.12,5822.00,0.00
2024-12-10 17:38:28,50,5041,20,30,3745.68,5822.02,0.00
2024-12-10 17:38:28,49,5041,19,30,3766.37,5822.23,0.00
2024-12-10 17:38:28,49,5042,19,30,3840.60,5823.00,0.00
2024-12-10 17:38:28,50,5042,20,30,3763.79,5823.02,0.00
2024-12-10 17:38:28,50,5043,20,30,3753.95,5824.00,0.00
2024-12-10 17:38:28,51,5043,21,30,3680.35,5824.02,0.00
2024-12-10 17:38:28,50,5043,21,29,3748.14,5824.06,0.00
2024-12-10 17:38:28,49,5043,20,29,3817.50,5824.06,0.00
2024-12-10 17:38:28,49,5044,20,29,3882.34,5825.00,0.00
2024-12-10 17:38:28,50,5044,21,29,3804.69,5825.02,0.00
2024-12-10 17:38:28,50,5045,21,29,3803.46,5826.00,0.00
2024-12-10 17:38:28,51,5045,22,29,3728.88,5826.02,0.00
2024-12-10 17:38:28,51,5046,22,29,3718.09,5827.00,0.00
2024-12-10 17:38:28,52,5046,23,29,3646.59,5827.02,0.00
2024-12-10 17:38:28,51,5046,23,28,3705.56,5827.10,0.00
2024-12-10 17:38:28,50,5046,22,28,3769.00,5827.28,0.00
2024-12-10 17:38:28,50,5047,22,28,3797.49,5828.00,0.00
2024-12-10 17:38:28,51,5047,22,29,3723.03,5828.02,0.00
2024-12-10 17:38:28,51,5048,22,29,3718.72,5829.00,0.00
2024-12-10 17:38:28,52,5048,23,29,3647.21,5829.02,0.00
2024-12-10 17:38:28,51,5048,22,29,3616.82,5829.94,0.00
2024-12-10 17:38:28,51,5049,22,29,3727.73,5830.00,0.00
2024-12-10 17:38:28,52,5049,23,29,3656.05,5830.02,0.00
2024-12-10 17:38:28,51,5049,23,28,3717.47,5830.10,0.00
2024-12-10 17:38:28,51,5050,23,28,3734.09,5831.00,0.00
2024-12-10 17:38:28,52,5050,23,29,3662.28,5831.02,0.00
2024-12-10 17:38:28,51,5050,22,29,3731.81,5831.06,0.00
2024-12-10 17:38:28,51,5051,22,29,3730.10,5832.00,0.00
2024-12-10 17:38:28,52,5051,22,30,3658.36,5832.02,0.00
2024-12-10 17:38:28,51,5051,21,30,3689.02,5832.10,0.00
2024-12-10 17:38:28,51,5052,21,30,3750.83,5833.00,0.00
2024-12-10 17:38:28,52,5052,22,30,3678.70,5833.02,0.00
2024-12-10 17:38:28,52,5053,22,30,3673.09,5834.00,0.00
2024-12-10 17:38:28,53,5053,23,30,3603.79,5834.02,0.00
2024-12-10 17:38:28,53,5054,23,30,3584.98,5835.00,0.00
2024-12-10 17:38:28,54,5054,24,30,3518.59,5835.02,0.00
2024-12-10 17:38:28,53,5054,24,29,3567.45,5835.09,0.00
2024-12-10 17:38:28,53,5055,24,29,3579.87,5836.00,0.00
2024-12-10 17:38:28,54,5055,24,30,3513.57,5836.02,0.00
2024-12-10 17:38:28,53,5055,24,29,3574.56,5836.02,0.00
2024-12-10 17:38:28,52,5055,24,28,3639.96,5836.06,0.00
2024-12-10 17:38:28,52,5055,24,28,3640.99,5837.00,0.00
2024-12-10 17:38:28,53,5055,25,28,3572.29,5837.02,0.00
2024-12-10 17:38:28,53,5056,25,28,3559.68,5838.00,0.00
2024-12-10 17:38:28,54,5056,26,28,3493.76,5838.02,0.00
2024-12-10 17:38:28,53,5056,26,27,3551.99,5838.06,0.00
2024-12-10 17:38:28,53,5057,26,27,3563.60,5839.00,0.00
2024-12-10 17:38:28,54,5057,26,28,3497.60,5839.02,0.00
2024-12-10 17:38:28,54,5058,26,28,3494.00,5840.00,0.00
2024-12-10 17:38:28,55,5058,26,29,3430.48,5840.02,0.00
2024-12-10 17:38:28,54,5058,25,29,3454.96,5840.06,0.00
2024-12-10 17:38:28,54,5059,25,29,3486.91,5841.00,0.00
2024-12-10 17:38:28,55,5059,26,29,3423.51,5841.02,0.00
2024-12-10 17:38:28,54,5059,25,29,3421.07,5841.33,0.00
2024-12-10 17:38:28,55,5058,25,30,3343.12,5841.64,0.00
2024-12-10 17:38:28,55,5059,25,30,3493.13,5842.00,0.00
2024-12-10 17:38:28,56,5059,26,30,3430.76,5842.02,0.00
2024-12-10 17:38:28,56,5060,26,30,3520.03,5843.00,0.00
2024-12-10 17:38:28,57,5060,26,31,3458.28,5843.02,0.00
2024-12-10 17:38:28,56,5060,26,30,3512.74,5843.07,0.00
2024-12-10 17:38:28,56,5061,26,30,3521.68,5844.00,0.00
2024-12-10 17:38:28,57,5061,27,30,3459.90,5844.02,0.00
2024-12-10 17:38:28,56,5061,26,30,3474.79,5844.20,0.00
2024-12-10 17:38:28,56,5062,26,30,3532.72,5845.00,0.00
2024-12-10 17:38:28,57,5062,26,31,3470.74,5845.02,0.00
2024-12-10 17:38:28,56,5062,26,30,3529.60,5845.05,0.00
2024-12-10 17:38:28,56,5063,26,30,3516.62,5846.00,0.00
2024-12-10 17:38:28,57,5063,27,30,3454.92,5846.02,0.00
2024-12-10 17:38:28,56,5063,27,29,3511.41,5846.05,0.00
2024-12-10 17:38:28,56,5064,27,29,3517.43,5847.00,0.00
2024-12-10 17:38:28,57,5064,28,29,3455.72,5847.02,0.00
2024-12-10 17:38:28,56,5064,27,29,3448.70,5847.38,0.00
2024-12-10 17:38:28,57,5063,27,30,3383.12,5847.49,0.00
2024-12-10 17:38:28,57,5064,27,30,3480.81,5848.00,0.00
2024-12-10 17:38:28,58,5064,27,31,3420.79,5848.02,0.00
2024-12-10 17:38:28,58,5065,27,31,3501.32,5849.00,0.00
2024-12-10 17:38:28,59,5065,27,32,3441.98,5849.02,0.00
2024-12-10 17:38:28,58,5065,27,31,3496.29,5849.05,0.00
2024-12-10 17:38:28,58,5066,27,31,3496.99,5850.00,0.00
2024-12-10 17:38:28,59,5066,28,31,3437.72,5850.02,0.00
2024-12-10 17:38:28,58,5066,27,31,3486.90,5850.02,0.00
2024-12-10 17:38:28,57,5066,26,31,3490.94,5850.63,0.00
2024-12-10 17:38:28,57,5067,26,31,3566.38,5851.00,0.00
2024-12-10 17:38:28,58,5067,27,31,3504.89,5851.02,0.00
2024-12-10 17:38:28,58,5068,27,31,3481.97,5852.00,0.00
2024-12-10 17:38:28,59,5068,27,32,3422.96,5852.02,0.00
2024-12-10 17:38:28,58,5068,27,31,3479.97,5852.04,0.00
2024-12-10 17:38:29,58,5069,27,31,3478.00,5853.00,0.00
2024-12-10 17:38:29,59,5069,28,31,3419.05,5853.02,0.00
2024-12-10 17:38:29,59,5070,28,31,3401.97,5854.00,0.00
2024-12-10 17:38:29,60,5070,29,31,3345.27,5854.02,0.00
2024-12-10 17:38:29,59,5070,29,30,3381.15,5854.03,0.00
2024-12-10 17:38:29,59,5071,29,30,3378.69,5855.00,0.00
2024-12-10 17:38:29,60,5071,30,30,3322.38,5855.02,0.00
2024-12-10 17:38:29,60,5072,30,30,3306.16,5856.00,0.00
2024-12-10 17:38:29,61,5072,31,30,3251.97,5856.02,0.00
2024-12-10 17:38:29,60,5072,31,29,3286.65,5856.03,0.00
2024-12-10 17:38:29,59,5072,30,29,3312.26,5856.54,0.00
2024-12-10 17:38:29,59,5073,30,29,3339.74,5857.00,0.00
2024-12-10 17:38:29,60,5073,30,30,3284.08,5857.02,0.00
2024-12-10 17:38:29,59,5073,29,30,3261.55,5857.49,0.00
2024-12-10 17:38:29,59,5074,29,30,3325.07,5858.00,0.00
2024-12-10 17:38:29,60,5074,30,30,3269.65,5858.02,0.00
2024-12-10 17:38:29,59,5074,30,29,3304.23,5858.05,0.00
2024-12-10 17:38:29,59,5075,30,29,3299.13,5859.00,0.00
2024-12-10 17:38:29,60,5075,31,29,3244.14,5859.02,0.00
2024-12-10 17:38:29,61,5074,31,30,3160.31,5859.25,0.00
2024-12-10 17:38:29,60,5074,31,29,3238.78,5859.52,0.00
2024-12-10 17:38:29,60,5075,31,29,3280.84,5860.00,0.00
2024-12-10 17:38:29,61,5075,31,30,3227.06,5860.02,0.00
2024-12-10 17:38:29,60,5075,30,30,3235.04,5860.45,0.00
2024-12-10 17:38:29,60,5076,30,30,3359.43,5861.00,0.00
2024-12-10 17:38:29,61,5076,31,30,3304.36,5861.02,0.00
2024-12-10 17:38:29,60,5076,31,29,3353.60,5861.08,0.00
2024-12-10 17:38:29,59,5076,30,29,3377.41,5861.63,0.00
2024-12-10 17:38:29,59,5077,30,29,3415.41,5862.00,0.00
2024-12-10 17:38:29,60,5077,31,29,3358.49,5862.02,0.00
2024-12-10 17:38:29,60,5078,31,29,3349.02,5863.00,0.00
2024-12-10 17:38:29,61,5078,31,30,3294.11,5863.02,0.00
2024-12-10 17:38:29,61,5079,31,30,3273.58,5864.00,0.00
2024-12-10 17:38:29,62,5079,31,31,3220.78,5864.02,0.00
2024-12-10 17:38:29,61,5079,31,30,3267.85,5864.10,0.00
2024-12-10 17:38:29,60,5079,30,30,3301.29,5864.33,0.00
2024-12-10 17:38:29,59,5079,29,30,3335.15,5864.64,0.00
2024-12-10 17:38:29,59,5080,29,30,3413.91,5865.00,0.00
2024-12-10 17:38:29,60,5080,29,31,3357.02,5865.02,0.00
2024-12-10 17:38:29,60,5081,29,31,3343.76,5866.00,0.00
2024-12-10 17:38:29,61,5081,30,31,3288.94,5866.02,0.00
2024-12-10 17:38:29,60,5081,29,31,3335.90,5866.07,0.00
2024-12-10 17:38:29,59,5081,29,30,3369.59,5866.10,0.00
2024-12-10 17:38:29,59,5082,29,30,3412.02,5867.00,0.00
2024-12-10 17:38:29,60,5082,29,31,3355.16,5867.02,0.00
2024-12-10 17:38:29,59,5082,28,31,3351.25,5867.64,0.00
2024-12-10 17:38:29,59,5083,28,31,3398.94,5868.00,0.00
2024-12-10 17:38:29,60,5083,29,31,3342.29,5868.02,0.00
2024-12-10 17:38:29,59,5083,29,30,3374.10,5868.10,0.00
2024-12-10 17:38:29,59,5084,29,30,3379.60,5869.00,0.00
2024-12-10 17:38:29,60,5084,30,30,3323.27,5869.02,0.00
2024-12-10 17:38:29,59,5084,29,30,3275.85,5869.97,0.00
2024-12-10 17:38:29,59,5085,29,30,3373.37,5870.00,0.00
2024-12-10 17:38:29,60,5085,29,31,3317.15,5870.02,0.00
2024-12-10 17:38:29,59,5085,29,30,3349.52,5870.10,0.00
2024-12-10 17:38:29,59,5086,29,30,3354.60,5871.00,0.00
2024-12-10 17:38:29,60,5086,30,30,3298.69,5871.02,0.00
2024-12-10 17:38:29,59,5086,29,30,3319.84,5871.27,0.00
2024-12-10 17:38:29,59,5087,29,30,3340.51,5872.00,0.00
2024-12-10 17:38:29,60,5087,29,31,3284.83,5872.02,0.00
2024-12-10 17:38:29,59,5087,29,30,3317.65,5872.10,0.00
2024-12-10 17:38:29,59,5088,29,30,3318.69,5873.00,0.00
2024-12-10 17:38:29,60,5088,29,31,3263.38,5873.02,0.00
2024-12-10 17:38:29,61,5087,29,32,3179.15,5873.25,0.00
2024-12-10 17:38:29,61,5088,29,32,3241.20,5874.00,0.00
2024-12-10 17:38:29,62,5088,29,33,3188.93,5874.02,0.00
2024-12-10 17:38:29,61,5088,28,33,3207.96,5874.25,0.00
2024-12-10 17:38:29,61,5089,28,33,3343.00,5875.00,0.00
2024-12-10 17:38:29,62,5089,29,33,3289.09,5875.02,0.00
2024-12-10 17:38:29,61,5089,28,33,3278.39,5875.59,0.00
2024-12-10 17:38:29,60,5089,27,33,3328.16,5875.67,0.00
2024-12-10 17:38:29,60,5090,27,33,3406.76,5876.00,0.00
2024-12-10 17:38:29,61,5090,28,33,3350.91,5876.02,0.00
2024-12-10 17:38:29,61,5091,28,33,3332.21,5877.00,0.00
2024-12-10 17:38:29,62,5091,29,33,3278.47,5877.02,0.00
2024-12-10 17:38:29,61,5091,29,32,3324.53,5877.10,0.00
2024-12-10 17:38:29,60,5091,28,32,3375.07,5877.18,0.00
2024-12-10 17:38:29,60,5092,28,32,3386.37,5878.00,0.00
2024-12-10 17:38:29,61,5092,28,33,3330.85,5878.02,0.00
2024-12-10 17:38:29,61,5093,28,33,3315.30,5879.00,0.00
2024-12-10 17:38:29,62,5093,28,34,3261.83,5879.02,0.00
2024-12-10 17:38:29,61,5093,27,34,3315.04,5879.02,0.00
2024-12-10 17:38:29,60,5093,27,33,3353.65,5879.08,0.00
2024-12-10 17:38:29,59,5093,26,33,3375.91,5879.66,0.00
2024-12-10 17:38:29,59,5094,26,33,3455.90,5880.00,0.00
2024-12-10 17:38:29,60,5094,26,34,3398.30,5880.02,0.00
2024-12-10 17:38:29,59,5094,25,34,3429.99,5880.05,0.00
2024-12-10 17:38:29,59,5095,25,34,3454.49,5881.00,0.00
2024-12-10 17:38:29,60,5095,25,35,3396.92,5881.02,0.00
2024-12-10 17:38:29,59,5095,25,34,3438.55,5881.07,0.00
2024-12-10 17:38:29,59,5096,25,34,3444.12,5882.00,0.00
2024-12-10 17:38:29,60,5096,25,35,3386.71,5882.02,0.00
2024-12-10 17:38:29,60,5097,25,35,3371.01,5883.00,0.00
2024-12-10 17:38:29,61,5097,26,35,3315.75,5883.02,0.00
2024-12-10 17:38:29,60,5097,26,34,3356.31,5883.07,0.00
2024-12-10 17:38:29,59,5097,25,34,3387.73,5883.49,0.00
2024-12-10 17:38:29,59,5098,25,34,3418.01,5884.00,0.00
2024-12-10 17:38:29,60,5098,26,34,3361.04,5884.02,0.00
2024-12-10 17:38:29,60,5099,26,34,3344.84,5885.00,0.00
2024-12-10 17:38:29,61,5099,26,35,3290.01,5885.02,0.00
2024-12-10 17:38:29,60,5099,26,34,3331.12,5885.07,0.00
2024-12-10 17:38:30,60,5100,26,34,3335.60,5886.00,0.00
2024-12-10 17:38:30,61,5100,26,35,3280.92,5886.02,0.00
2024-12-10 17:38:30,60,5100,25,35,3271.87,5886.13,0.00
2024-12-10 17:38:30,60,5101,25,35,3319.49,5887.00,0.00
2024-12-10 17:38:30,61,5101,26,35,3265.07,5887.02,0.00
2024-12-10 17:38:30,60,5101,26,34,3307.72,5887.07,0.00
2024-12-10 17:38:30,60,5102,26,34,3312.20,5888.00,0.00
2024-12-10 17:38:30,61,5102,26,35,3257.90,5888.02,0.00
2024-12-10 17:38:30,60,5102,25,35,3299.44,5888.03,0.00
2024-12-10 17:38:30,60,5103,25,35,3321.59,5889.00,0.00
2024-12-10 17:38:30,61,5103,26,35,3267.14,5889.02,0.00
2024-12-10 17:38:30,60,5103,26,34,3308.85,5889.07,0.00
2024-12-10 17:38:30,59,5103,25,34,3298.64,5889.92,0.00
2024-12-10 17:38:30,59,5104,25,34,3393.54,5890.00,0.00
2024-12-10 17:38:30,60,5104,26,34,3336.98,5890.02,0.00
2024-12-10 17:38:30,60,5105,26,34,3322.71,5891.00,0.00
2024-12-10 17:38:30,61,5105,27,34,3268.24,5891.02,0.00
2024-12-10 17:38:30,60,5105,27,33,3308.00,5891.07,0.00
2024-12-10 17:38:30,60,5106,27,33,3312.48,5892.00,0.00
2024-12-10 17:38:30,61,5106,28,33,3258.17,5892.02,0.00
2024-12-10 17:38:30,60,5106,27,33,3304.26,5892.07,0.00
2024-12-10 17:38:30,60,5107,27,33,3328.38,5893.00,0.00
2024-12-10 17:38:30,61,5107,27,34,3273.82,5893.02,0.00
2024-12-10 17:38:30,60,5107,27,33,3309.74,5893.07,0.00
2024-12-10 17:38:30,60,5108,27,33,3314.21,5894.00,0.00
2024-12-10 17:38:30,61,5108,27,34,3259.88,5894.02,0.00
2024-12-10 17:38:30,60,5108,26,34,3310.30,5894.08,0.00
2024-12-10 17:38:30,60,5109,26,34,3307.41,5895.00,0.00
2024-12-10 17:38:30,61,5109,26,35,3253.19,5895.02,0.00
2024-12-10 17:38:30,60,5109,25,35,3306.43,5895.02,0.00
2024-12-10 17:38:30,59,5109,24,35,3359.49,5895.07,0.00
2024-12-10 17:38:30,58,5109,23,35,3378.29,5895.12,0.00
2024-12-10 17:38:30,57,5109,22,35,3403.73,5895.68,0.00
2024-12-10 17:38:30,57,5110,22,35,3488.79,5896.00,0.00
2024-12-10 17:38:30,58,5110,23,35,3428.64,5896.02,0.00
2024-12-10 17:38:30,57,5110,23,34,3483.65,5896.09,0.00
2024-12-10 17:38:30,57,5111,23,34,3492.49,5897.00,0.00
2024-12-10 17:38:30,58,5111,23,35,3432.27,5897.02,0.00
2024-12-10 17:38:30,57,5111,22,35,3487.34,5897.09,0.00
2024-12-10 17:38:30,57,5112,22,35,3516.88,5898.00,0.00
2024-12-10 17:38:30,58,5112,22,36,3456.24,5898.02,0.00
2024-12-10 17:38:30,58,5113,22,36,3439.54,5899.00,0.00
2024-12-10 17:38:30,59,5113,22,37,3381.24,5899.02,0.00
2024-12-10 17:38:30,58,5113,22,36,3430.43,5899.12,0.00
2024-12-10 17:38:30,58,5114,22,36,3440.12,5900.00,0.00
2024-12-10 17:38:30,59,5114,22,37,3381.82,5900.02,0.00
2024-12-10 17:38:30,58,5114,21,37,3353.06,5900.64,0.00
2024-12-10 17:38:30,59,5113,22,37,3296.23,5900.66,0.00
2024-12-10 17:38:30,59,5114,22,37,3397.52,5901.00,0.00
2024-12-10 17:38:30,60,5114,22,38,3340.89,5901.02,0.00
2024-12-10 17:38:30,59,5114,21,38,3379.03,5901.12,0.00
2024-12-10 17:38:30,59,5115,21,38,3507.60,5902.00,0.00
2024-12-10 17:38:30,60,5115,22,38,3449.14,5902.02,0.00
2024-12-10 17:38:30,60,5116,22,38,3441.05,5903.00,0.00
2024-12-10 17:38:30,61,5116,22,39,3384.64,5903.02,0.00
2024-12-10 17:38:30,60,5116,22,38,3434.20,5903.12,0.00
2024-12-10 17:38:30,60,5117,22,38,3421.95,5904.00,0.00
2024-12-10 17:38:30,61,5117,23,38,3365.86,5904.02,0.00
2024-12-10 17:38:30,60,5117,23,37,3414.12,5904.12,0.00
2024-12-10 17:38:30,60,5118,23,37,3421.55,5905.00,0.00
2024-12-10 17:38:30,61,5118,23,38,3365.46,5905.02,0.00
2024-12-10 17:38:30,60,5118,22,38,3420.57,5905.02,0.00
2024-12-10 17:38:30,60,5119,22,38,3413.38,5906.00,0.00
2024-12-10 17:38:30,61,5119,22,39,3357.42,5906.02,0.00
2024-12-10 17:38:30,61,5120,22,39,3338.62,5907.00,0.00
2024-12-10 17:38:30,62,5120,23,39,3284.77,5907.02,0.00
2024-12-10 17:38:30,61,5120,23,38,3329.95,5907.13,0.00
2024-12-10 17:38:30,62,5119,23,39,3256.38,5907.50,0.00
2024-12-10 17:38:30,61,5119,22,39,3331.20,5907.67,0.00
2024-12-10 17:38:30,60,5119,21,39,3341.54,5907.97,0.00
2024-12-10 17:38:30,60,5120,21,39,3438.06,5908.00,0.00
2024-12-10 17:38:30,61,5120,22,39,3381.70,5908.02,0.00
2024-12-10 17:38:30,61,5121,22,39,3469.16,5909.00,0.00
2024-12-10 17:38:30,62,5121,23,39,3413.21,5909.02,0.00
2024-12-10 17:38:30,61,5121,23,38,3442.08,5909.13,0.00
2024-12-10 17:38:30,61,5122,23,38,3449.40,5910.00,0.00
2024-12-10 17:38:30,62,5122,24,38,3393.77,5910.02,0.00
2024-12-10 17:38:30,61,5122,23,38,3418.44,5910.15,0.00
2024-12-10 17:38:30,61,5123,23,38,3465.49,5911.00,0.00
2024-12-10 17:38:30,62,5123,24,38,3409.60,5911.02,0.00
2024-12-10 17:38:30,61,5123,23,38,3408.63,5911.66,0.00
2024-12-10 17:38:30,61,5124,23,38,3446.69,5912.00,0.00
2024-12-10 17:38:30,62,5124,23,39,3391.10,5912.02,0.00
2024-12-10 17:38:30,61,5124,23,38,3438.98,5912.13,0.00
2024-12-10 17:38:30,61,5125,23,38,3446.31,5913.00,0.00
2024-12-10 17:38:30,62,5125,24,38,3390.72,5913.02,0.00
2024-12-10 17:38:30,61,5125,23,38,3385.41,5913.33,0.00
2024-12-10 17:38:30,61,5126,23,38,3443.07,5914.00,0.00
2024-12-10 17:38:30,62,5126,23,39,3387.54,5914.02,0.00
2024-12-10 17:38:30,62,5126,23,39,3368.08,5915.00,0.00
2024-12-10 17:38:30,63,5126,24,39,3314.62,5915.02,0.00
2024-12-10 17:38:30,62,5126,24,38,3356.67,5915.16,0.00
2024-12-10 17:38:30,62,5127,24,38,3364.83,5916.00,0.00
2024-12-10 17:38:30,63,5127,24,39,3311.42,5916.02,0.00
2024-12-10 17:38:30,63,5128,24,39,3302.40,5917.00,0.00
2024-12-10 17:38:30,64,5128,24,40,3250.80,5917.02,0.00
2024-12-10 17:38:31,64,5129,24,40,3230.09,5918.00,0.00
2024-12-10 17:38:31,65,5129,24,41,3180.39,5918.02,0.00
2024-12-10 17:38:31,64,5129,24,40,3219.03,5918.17,0.00
2024-12-10 17:38:31,63,5129,23,40,3223.66,5918.73,0.00
2024-12-10 17:38:31,63,5130,23,40,3301.83,5919.00,0.00
2024-12-10 17:38:31,64,5130,24,40,3250.24,5919.02,0.00
2024-12-10 17:38:31,64,5131,24,40,3240.07,5920.00,0.00
2024-12-10 17:38:31,65,5131,25,40,3190.23,5920.02,0.00
2024-12-10 17:38:31,64,5131,25,39,3211.44,5920.17,0.00
2024-12-10 17:38:31,64,5132,25,39,3218.42,5921.00,0.00
2024-12-10 17:38:31,65,5132,26,39,3168.90,5921.02,0.00
2024-12-10 17:38:31,64,5132,25,39,3208.28,5921.17,0.00
2024-12-10 17:38:31,64,5133,25,39,3208.88,5922.00,0.00
2024-12-10 17:38:31,65,5133,26,39,3159.51,5922.02,0.00
2024-12-10 17:38:31,64,5133,25,39,3201.88,5922.13,0.00
2024-12-10 17:38:31,63,5133,24,39,3161.81,5922.70,0.00
2024-12-10 17:38:31,63,5134,24,39,3238.18,5923.00,0.00
2024-12-10 17:38:31,64,5134,25,39,3187.59,5923.02,0.00
2024-12-10 17:38:31,63,5134,25,38,3227.88,5923.18,0.00
2024-12-10 17:38:31,64,5133,26,38,3134.38,5923.94,0.00
2024-12-10 17:38:31,64,5134,26,38,3189.98,5924.00,0.00
2024-12-10 17:38:31,65,5134,26,39,3140.90,5924.02,0.00
2024-12-10 17:38:31,65,5135,26,39,3221.74,5925.00,0.00
2024-12-10 17:38:31,66,5135,26,40,3172.93,5925.02,0.00
2024-12-10 17:38:31,65,5135,26,39,3194.42,5925.17,0.00
2024-12-10 17:38:31,65,5136,26,39,3200.40,5926.00,0.00
2024-12-10 17:38:31,66,5136,26,40,3151.91,5926.02,0.00
2024-12-10 17:38:31,65,5136,25,40,3191.42,5926.15,0.00
2024-12-10 17:38:31,64,5136,24,40,3177.74,5926.80,0.00
2024-12-10 17:38:31,64,5137,24,40,3258.47,5927.00,0.00
2024-12-10 17:38:31,65,5137,25,40,3208.34,5927.02,0.00
2024-12-10 17:38:31,64,5137,25,39,3232.57,5927.16,0.00
2024-12-10 17:38:31,63,5137,24,39,3276.36,5927.21,0.00
2024-12-10 17:38:31,63,5138,24,39,3323.92,5928.00,0.00
2024-12-10 17:38:31,64,5138,25,39,3271.99,5928.02,0.00
2024-12-10 17:38:31,64,5139,25,39,3260.35,5929.00,0.00
2024-12-10 17:38:31,65,5139,26,39,3210.20,5929.02,0.00
2024-12-10 17:38:31,64,5139,26,38,3234.44,5929.16,0.00
2024-12-10 17:38:31,65,5138,27,38,3155.76,5929.68,0.00
2024-12-10 17:38:31,65,5139,27,38,3210.74,5930.00,0.00
2024-12-10 17:38:31,66,5139,27,39,3162.09,5930.02,0.00
2024-12-10 17:38:31,65,5139,27,38,3188.85,5930.11,0.00
2024-12-10 17:38:31,64,5139,26,38,3236.84,5930.14,0.00
2024-12-10 17:38:31,63,5139,25,38,3268.52,5930.48,0.00
2024-12-10 17:38:31,62,5139,24,38,3308.94,5930.68,0.00
2024-12-10 17:38:31,62,5140,24,38,3443.09,5931.00,0.00
2024-12-10 17:38:31,63,5140,25,38,3388.44,5931.02,0.00
2024-12-10 17:38:31,63,5141,25,38,3375.61,5932.00,0.00
2024-12-10 17:38:31,64,5141,26,38,3322.86,5932.02,0.00
2024-12-10 17:38:31,63,5141,26,37,3373.73,5932.03,0.00
2024-12-10 17:38:31,62,5141,26,36,3404.24,5932.13,0.00
2024-12-10 17:38:31,62,5142,26,36,3406.53,5933.00,0.00
2024-12-10 17:38:31,63,5142,26,37,3352.46,5933.02,0.00
2024-12-10 17:38:31,63,5143,26,37,3335.39,5934.00,0.00
2024-12-10 17:38:31,64,5143,26,38,3283.27,5934.02,0.00
2024-12-10 17:38:31,63,5143,26,37,3310.92,5934.13,0.00
2024-12-10 17:38:31,62,5143,25,37,3289.61,5934.97,0.00
2024-12-10 17:38:31,62,5144,25,37,3383.44,5935.00,0.00
2024-12-10 17:38:31,63,5144,25,38,3329.74,5935.02,0.00
2024-12-10 17:38:31,62,5144,24,38,3381.53,5935.03,0.00
2024-12-10 17:38:31,62,5145,24,38,3370.55,5936.00,0.00
2024-12-10 17:38:31,63,5145,25,38,3317.05,5936.02,0.00
2024-12-10 17:38:31,62,5145,25,37,3347.58,5936.11,0.00
2024-12-10 17:38:31,62,5146,25,37,3352.92,5937.00,0.00
2024-12-10 17:38:31,63,5146,25,38,3299.70,5937.02,0.00
2024-12-10 17:38:31,62,5146,24,38,3280.56,5937.73,0.00
2024-12-10 17:38:31,62,5147,24,38,3360.25,5938.00,0.00
2024-12-10 17:38:31,63,5147,24,39,3306.91,5938.02,0.00
2024-12-10 17:38:31,62,5147,24,38,3337.29,5938.13,0.00
2024-12-10 17:38:31,62,5148,24,38,3343.57,5939.00,0.00
2024-12-10 17:38:31,63,5148,24,39,3290.50,5939.02,0.00
2024-12-10 17:38:31,62,5148,24,38,3341.66,5939.03,0.00
2024-12-10 17:38:31,62,5149,24,38,3343.10,5940.00,0.00
2024-12-10 17:38:31,63,5149,24,39,3290.03,5940.02,0.00
2024-12-10 17:38:31,62,5149,24,38,3341.19,5940.03,0.00
2024-12-10 17:38:31,61,5149,23,38,3342.82,5940.52,0.00
2024-12-10 17:38:31,61,5150,23,38,3380.77,5941.00,0.00
2024-12-10 17:38:31,62,5150,24,38,3326.24,5941.02,0.00
2024-12-10 17:38:31,61,5150,24,37,3355.47,5941.12,0.00
2024-12-10 17:38:31,60,5150,23,37,3359.97,5941.53,0.00
2024-12-10 17:38:31,60,5151,23,37,3430.54,5942.00,0.00
2024-12-10 17:38:31,61,5151,23,38,3374.30,5942.02,0.00
2024-12-10 17:38:31,61,5152,23,38,3361.17,5943.00,0.00
2024-12-10 17:38:31,62,5152,23,39,3306.95,5943.02,0.00
2024-12-10 17:38:31,61,5152,23,38,3338.78,5943.12,0.00
2024-12-10 17:38:31,60,5152,22,38,3342.78,5943.47,0.00
2024-12-10 17:38:31,60,5153,22,38,3410.20,5944.00,0.00
2024-12-10 17:38:31,61,5153,22,39,3354.30,5944.02,0.00
2024-12-10 17:38:31,61,5154,22,39,3338.43,5945.00,0.00
2024-12-10 17:38:31,62,5154,23,39,3284.59,5945.02,0.00
2024-12-10 17:38:31,61,5154,23,38,3317.01,5945.12,0.00
2024-12-10 17:38:31,60,5154,22,38,3342.55,5945.58,0.00
2024-12-10 17:38:31,60,5155,22,38,3415.78,5946.00,0.00
2024-12-10 17:38:31,61,5155,22,39,3359.79,5946.02,0.00
2024-12-10 17:38:31,60,5155,21,39,3413.81,5946.03,0.00
2024-12-10 17:38:31,59,5155,20,39,3467.95,5946.09,0.00
2024-12-10 17:38:31,60,5154,20,40,3370.65,5946.45,0.00
2024-12-10 17:38:31,60,5155,20,40,3451.06,5947.00,0.00
2024-12-10 17:38:31,61,5155,20,41,3394.49,5947.02,0.00
2024-12-10 17:38:31,62,5154,21,41,3339.74,5947.05,0.00
2024-12-10 17:38:31,61,5154,21,40,3448.14,5947.10,0.00
2024-12-10 17:38:31,61,5155,21,40,3547.36,5948.00,0.00
2024-12-10 17:38:31,62,5155,21,41,3490.15,5948.02,0.00
2024-12-10 17:38:31,62,5156,21,41,3592.62,5949.00,0.00
2024-12-10 17:38:31,63,5156,21,42,3535.59,5949.02,0.00
2024-12-10 17:38:32,63,5157,21,42,3537.89,5950.00,0.00
2024-12-10 17:38:32,64,5157,22,42,3482.61,5950.02,0.00
2024-12-10 17:38:32,64,5158,22,42,3473.42,5951.00,0.00
2024-12-10 17:38:32,65,5158,23,42,3419.99,5951.02,0.00
2024-12-10 17:38:32,65,5159,23,42,3395.77,5952.00,0.00
2024-12-10 17:38:32,66,5159,23,43,3344.32,5952.02,0.00
2024-12-10 17:38:32,65,5159,23,42,3381.12,5952.02,0.00
2024-12-10 17:38:32,66,5158,24,42,3287.71,5952.59,0.00
2024-12-10 17:38:32,66,5159,24,42,3340.33,5953.00,0.00
2024-12-10 17:38:32,67,5159,24,43,3290.48,5953.02,0.00
2024-12-10 17:38:32,66,5159,23,43,3316.73,5953.08,0.00
2024-12-10 17:38:32,65,5159,22,43,3363.21,5953.15,0.00
2024-12-10 17:38:32,65,5160,22,43,3486.03,5954.00,0.00
2024-12-10 17:38:32,66,5160,23,43,3433.22,5954.02,0.00
2024-12-10 17:38:32,65,5160,23,42,3475.05,5954.06,0.00
2024-12-10 17:38:32,64,5160,22,42,3493.08,5954.11,0.00
2024-12-10 17:38:32,63,5160,22,41,3526.86,5954.40,0.00
2024-12-10 17:38:32,63,5161,22,41,3584.99,5955.00,0.00
2024-12-10 17:38:32,64,5161,23,41,3528.97,5955.02,0.00
2024-12-10 17:38:32,64,5162,23,41,3522.14,5956.00,0.00
2024-12-10 17:38:32,65,5162,23,42,3467.95,5956.02,0.00
2024-12-10 17:38:32,64,5162,22,42,3521.21,5956.02,0.00
2024-12-10 17:38:32,63,5162,21,42,3533.58,5956.43,0.00
2024-12-10 17:38:32,62,5162,20,42,3539.97,5956.86,0.00
2024-12-10 17:38:32,62,5163,20,42,3627.51,5957.00,0.00
2024-12-10 17:38:32,63,5163,21,42,3569.93,5957.02,0.00
2024-12-10 17:38:32,62,5163,21,41,3615.98,5957.03,0.00
2024-12-10 17:38:32,61,5163,20,41,3632.88,5957.64,0.00
2024-12-10 17:38:32,61,5164,20,41,3670.29,5958.00,0.00
2024-12-10 17:38:32,62,5164,21,41,3611.09,5958.02,0.00
2024-12-10 17:38:32,61,5164,20,41,3669.31,5958.02,0.00
2024-12-10 17:38:32,61,5165,20,41,3647.92,5959.00,0.00
2024-12-10 17:38:32,62,5165,21,41,3589.09,5959.02,0.00
2024-12-10 17:38:32,61,5165,21,40,3641.09,5959.02,0.00
2024-12-10 17:38:32,61,5166,21,40,3641.70,5960.00,0.00
2024-12-10 17:38:32,62,5166,22,40,3582.96,5960.02,0.00
2024-12-10 17:38:32,62,5167,22,40,3563.37,5961.00,0.00
2024-12-10 17:38:32,63,5167,23,40,3506.81,5961.02,0.00
2024-12-10 17:38:32,62,5167,23,39,3557.60,5961.02,0.00
2024-12-10 17:38:32,62,5168,23,39,3557.24,5962.00,0.00
2024-12-10 17:38:32,63,5168,24,39,3500.77,5962.02,0.00
2024-12-10 17:38:32,63,5169,24,39,3480.54,5963.00,0.00
2024-12-10 17:38:32,64,5169,24,40,3426.15,5963.02,0.00
2024-12-10 17:38:32,63,5169,24,39,3474.86,5963.02,0.00
2024-12-10 17:38:32,63,5170,24,39,3473.55,5964.00,0.00
2024-12-10 17:38:32,64,5170,25,39,3419.27,5964.02,0.00
2024-12-10 17:38:32,63,5170,24,39,3447.04,5964.02,0.00
2024-12-10 17:38:32,63,5171,24,39,3464.66,5965.00,0.00
2024-12-10 17:38:32,64,5171,25,39,3410.53,5965.02,0.00
2024-12-10 17:38:32,63,5171,25,38,3456.14,5965.02,0.00
2024-12-10 17:38:32,62,5171,24,38,3489.33,5965.39,0.00
2024-12-10 17:38:32,62,5172,24,38,3510.92,5966.00,0.00
2024-12-10 17:38:32,63,5172,25,38,3455.19,5966.02,0.00
2024-12-10 17:38:32,64,5171,25,39,3348.35,5966.63,0.00
2024-12-10 17:38:32,64,5172,25,39,3402.71,5967.00,0.00
2024-12-10 17:38:32,65,5172,26,39,3350.36,5967.02,0.00
2024-12-10 17:38:32,64,5172,26,38,3395.25,5967.02,0.00
2024-12-10 17:38:32,64,5173,26,38,3485.90,5968.00,0.00
2024-12-10 17:38:32,65,5173,27,38,3432.27,5968.02,0.00
2024-12-10 17:38:32,64,5173,26,38,3396.91,5968.94,0.00
2024-12-10 17:38:32,64,5174,26,38,3486.48,5969.00,0.00
2024-12-10 17:38:32,65,5174,27,38,3432.84,5969.02,0.00
2024-12-10 17:38:32,64,5174,27,37,3479.95,5969.02,0.00
2024-12-10 17:38:32,64,5175,27,37,3477.74,5970.00,0.00
2024-12-10 17:38:32,65,5175,27,38,3424.23,5970.02,0.00
2024-12-10 17:38:32,64,5175,27,37,3460.51,5970.02,0.00
2024-12-10 17:38:32,63,5175,26,37,3465.04,5970.24,0.00
2024-12-10 17:38:32,63,5176,26,37,3514.81,5971.00,0.00
2024-12-10 17:38:32,64,5176,27,37,3459.90,5971.02,0.00
2024-12-10 17:38:32,63,5176,27,36,3498.96,5971.02,0.00
2024-12-10 17:38:32,63,5177,27,36,3495.41,5972.00,0.00
2024-12-10 17:38:32,64,5177,28,36,3440.79,5972.02,0.00
2024-12-10 17:38:32,63,5177,27,36,3416.25,5972.49,0.00
2024-12-10 17:38:32,63,5178,27,36,3481.07,5973.00,0.00
2024-12-10 17:38:32,64,5178,28,36,3426.68,5973.02,0.00
2024-12-10 17:38:32,63,5178,28,35,3474.44,5973.02,0.00
2024-12-10 17:38:32,63,5179,28,35,3469.34,5974.00,0.00
2024-12-10 17:38:32,64,5179,29,35,3415.13,5974.02,0.00
2024-12-10 17:38:32,63,5179,28,35,3428.56,5974.21,0.00
2024-12-10 17:38:32,63,5180,28,35,3475.27,5975.00,0.00
2024-12-10 17:38:32,64,5180,29,35,3420.96,5975.02,0.00
2024-12-10 17:38:32,63,5180,29,34,3469.58,5975.02,0.00
2024-12-10 17:38:32,63,5181,29,34,3466.63,5976.00,0.00
2024-12-10 17:38:32,64,5181,29,35,3412.46,5976.02,0.00
2024-12-10 17:38:32,64,5182,29,35,3389.72,5977.00,0.00
2024-12-10 17:38:32,65,5182,30,35,3337.57,5977.02,0.00
2024-12-10 17:38:32,64,5182,30,34,3385.05,5977.02,0.00
2024-12-10 17:38:32,63,5182,29,34,3403.20,5977.57,0.00
2024-12-10 17:38:32,64,5181,29,35,3350.02,5977.59,0.00
2024-12-10 17:38:32,63,5181,28,35,3388.28,5977.97,0.00
2024-12-10 17:38:32,63,5182,28,35,3481.29,5978.00,0.00
2024-12-10 17:38:32,64,5182,29,35,3426.89,5978.02,0.00
2024-12-10 17:38:32,63,5182,28,35,3417.41,5978.70,0.00
2024-12-10 17:38:32,63,5183,28,35,3589.40,5979.00,0.00
2024-12-10 17:38:32,64,5183,29,35,3533.31,5979.02,0.00
2024-12-10 17:38:32,63,5183,29,34,3584.65,5979.02,0.00
2024-12-10 17:38:32,63,5184,29,34,3579.05,5980.00,0.00
2024-12-10 17:38:32,64,5184,30,34,3523.13,5980.02,0.00
2024-12-10 17:38:32,64,5185,30,34,3498.98,5981.00,0.00
2024-12-10 17:38:32,65,5185,31,34,3445.15,5981.02,0.00
2024-12-10 17:38:32,64,5185,31,33,3494.30,5981.02,0.00
2024-12-10 17:38:33,64,5186,31,33,3489.48,5982.00,0.00
2024-12-10 17:38:33,65,5186,31,34,3435.80,5982.02,0.00
2024-12-10 17:38:33,64,5186,31,33,3464.09,5982.11,0.00
2024-12-10 17:38:33,64,5187,31,33,3467.45,5983.00,0.00
2024-12-10 17:38:33,65,5187,31,34,3414.10,5983.02,0.00
2024-12-10 17:38:33,64,5187,31,33,3463.71,5983.02,0.00
2024-12-10 17:38:33,64,5188,31,33,3461.48,5984.00,0.00
2024-12-10 17:38:33,65,5188,32,33,3408.23,5984.02,0.00
2024-12-10 17:38:33,65,5189,32,33,3386.70,5985.00,0.00
2024-12-10 17:38:33,66,5189,33,33,3335.39,5985.02,0.00
2024-12-10 17:38:33,65,5189,33,32,3377.50,5985.05,0.00
2024-12-10 17:38:33,65,5190,33,32,3376.21,5986.00,0.00
2024-12-10 17:38:33,66,5190,33,33,3325.06,5986.02,0.00
2024-12-10 17:38:33,66,5191,33,33,3302.94,5987.00,0.00
2024-12-10 17:38:33,67,5191,34,33,3253.64,5987.02,0.00
2024-12-10 17:38:33,66,5191,34,32,3293.88,5987.05,0.00
2024-12-10 17:38:33,65,5191,33,32,3307.11,5987.68,0.00
2024-12-10 17:38:33,65,5192,33,32,3380.10,5988.00,0.00
2024-12-10 17:38:33,66,5192,34,32,3328.89,5988.02,0.00
2024-12-10 17:38:33,65,5192,33,32,3324.85,5988.08,0.00
2024-12-10 17:38:33,65,5193,33,32,3362.24,5989.00,0.00
2024-12-10 17:38:33,66,5193,33,33,3311.30,5989.02,0.00
2024-12-10 17:38:33,65,5193,33,32,3345.67,5989.06,0.00
2024-12-10 17:38:33,64,5193,32,32,3395.16,5989.11,0.00
2024-12-10 17:38:33,64,5194,32,32,3398.50,5990.00,0.00
2024-12-10 17:38:33,65,5194,33,32,3346.22,5990.02,0.00
2024-12-10 17:38:33,64,5194,32,32,3373.27,5990.13,0.00
2024-12-10 17:38:33,64,5195,32,32,3380.27,5991.00,0.00
2024-12-10 17:38:33,65,5195,32,33,3328.26,5991.02,0.00
2024-12-10 17:38:33,64,5195,32,32,3364.37,5991.06,0.00
2024-12-10 17:38:33,65,5194,32,33,3295.24,5991.39,0.00
2024-12-10 17:38:33,64,5194,31,33,3369.43,5991.66,0.00
2024-12-10 17:38:33,64,5195,31,33,3442.42,5992.00,0.00
2024-12-10 17:38:33,65,5195,32,33,3389.45,5992.02,0.00
2024-12-10 17:38:33,64,5195,31,33,3353.78,5992.63,0.00
2024-12-10 17:38:33,64,5196,31,33,3516.04,5993.00,0.00
2024-12-10 17:38:33,65,5196,32,33,3461.95,5993.02,0.00
2024-12-10 17:38:33,66,5195,32,34,3407.69,5993.08,0.00
2024-12-10 17:38:33,65,5195,32,33,3519.14,5993.08,0.00
2024-12-10 17:38:33,65,5196,32,33,3518.09,5994.00,0.00
2024-12-10 17:38:33,66,5196,32,34,3464.79,5994.02,0.00
2024-12-10 17:38:33,66,5197,32,34,3552.11,5995.00,0.00
2024-12-10 17:38:33,67,5197,32,35,3499.09,5995.02,0.00
2024-12-10 17:38:33,67,5198,32,35,3480.36,5996.00,0.00
2024-12-10 17:38:33,68,5198,33,35,3429.18,5996.02,0.00
2024-12-10 17:38:33,67,5198,33,34,3462.48,5996.06,0.00
2024-12-10 17:38:33,66,5198,32,34,3491.13,5996.38,0.00
2024-12-10 17:38:33,66,5199,32,34,3545.14,5997.00,0.00
2024-12-10 17:38:33,67,5199,33,34,3492.23,5997.02,0.00
2024-12-10 17:38:33,67,5200,33,34,3468.52,5998.00,0.00
2024-12-10 17:38:33,68,5200,33,35,3417.52,5998.02,0.00
2024-12-10 17:38:33,67,5200,33,34,3453.33,5998.08,0.00
2024-12-10 17:38:33,66,5200,32,34,3464.30,5998.42,0.00
2024-12-10 17:38:33,65,5200,31,34,3502.06,5998.68,0.00
2024-12-10 17:38:33,65,5201,31,34,3575.21,5999.00,0.00
2024-12-10 17:38:33,66,5201,32,34,3521.04,5999.02,0.00
2024-12-10 17:38:33,65,5201,31,34,3540.17,5999.08,0.00
2024-12-10 17:38:33,65,5202,31,34,3558.04,6000.00,0.00
2024-12-10 17:38:33,66,5202,31,35,3504.13,6000.02,0.00
2024-12-10 17:38:33,65,5202,31,34,3541.45,6000.08,0.00
2024-12-10 17:38:33,65,5203,31,34,3540.81,6001.00,0.00
2024-12-10 17:38:33,66,5203,32,34,3487.16,6001.02,0.00
2024-12-10 17:38:33,66,5204,32,34,3466.77,6002.00,0.00
2024-12-10 17:38:33,67,5204,33,34,3415.03,6002.02,0.00
2024-12-10 17:38:33,66,5204,33,33,3451.34,6002.08,0.00
2024-12-10 17:38:33,66,5205,33,33,3450.98,6003.00,0.00
2024-12-10 17:38:33,67,5205,33,34,3399.47,6003.02,0.00
2024-12-10 17:38:33,66,5205,32,34,3402.91,6003.33,0.00
2024-12-10 17:38:33,66,5206,32,34,3454.28,6004.00,0.00
2024-12-10 17:38:33,67,5206,33,34,3402.72,6004.02,0.00
2024-12-10 17:38:33,66,5206,32,34,3447.92,6004.03,0.00
2024-12-10 17:38:33,65,5206,32,33,3488.05,6004.06,0.00
2024-12-10 17:38:33,65,5207,32,33,3524.64,6005.00,0.00
2024-12-10 17:38:33,66,5207,33,33,3471.23,6005.02,0.00
2024-12-10 17:38:33,65,5207,32,33,3450.02,6005.51,0.00
2024-12-10 17:38:33,65,5208,32,33,3513.21,6006.00,0.00
2024-12-10 17:38:33,66,5208,33,33,3459.98,6006.02,0.00
2024-12-10 17:38:33,65,5208,33,32,3499.37,6006.06,0.00
2024-12-10 17:38:33,65,5209,33,32,3499.01,6007.00,0.00
2024-12-10 17:38:33,66,5209,33,33,3446.00,6007.02,0.00
2024-12-10 17:38:33,65,5209,32,33,3408.73,6007.63,0.00
2024-12-10 17:38:33,65,5210,32,33,3479.26,6008.00,0.00
2024-12-10 17:38:33,66,5210,33,33,3426.54,6008.02,0.00
2024-12-10 17:38:33,65,5210,33,32,3466.34,6008.06,0.00
2024-12-10 17:38:33,64,5210,32,32,3494.32,6008.31,0.00
2024-12-10 17:38:33,64,5211,32,32,3547.35,6009.00,0.00
2024-12-10 17:38:33,65,5211,32,33,3492.78,6009.02,0.00
2024-12-10 17:38:33,64,5211,31,33,3479.94,6009.45,0.00
2024-12-10 17:38:33,64,5212,31,33,3541.37,6010.00,0.00
2024-12-10 17:38:33,65,5212,31,34,3486.89,6010.02,0.00
2024-12-10 17:38:33,64,5212,31,33,3529.18,6010.06,0.00
2024-12-10 17:38:33,64,5213,31,33,3529.75,6011.00,0.00
2024-12-10 17:38:33,65,5213,31,34,3475.45,6011.02,0.00
2024-12-10 17:38:33,64,5213,30,34,3481.03,6011.33,0.00
2024-12-10 17:38:34,64,5214,30,34,3535.03,6012.00,0.00
2024-12-10 17:38:34,65,5214,31,34,3480.65,6012.02,0.00
2024-12-10 17:38:34,64,5214,31,33,3523.78,6012.06,0.00
2024-12-10 17:38:34,63,5214,30,33,3528.37,6012.48,0.00
2024-12-10 17:38:34,63,5215,30,33,3592.70,6013.00,0.00
2024-12-10 17:38:34,64,5215,30,34,3536.56,6013.02,0.00
2024-12-10 17:38:34,64,5216,30,34,3530.91,6014.00,0.00
2024-12-10 17:38:34,65,5216,31,34,3476.59,6014.02,0.00
2024-12-10 17:38:34,64,5216,30,34,3481.90,6014.47,0.00
2024-12-10 17:38:34,64,5217,30,34,3544.32,6015.00,0.00
2024-12-10 17:38:34,65,5217,31,34,3489.79,6015.02,0.00
2024-12-10 17:38:34,64,5217,31,33,3529.30,6015.08,0.00
2024-12-10 17:38:34,64,5218,31,33,3530.81,6016.00,0.00
2024-12-10 17:38:34,65,5218,31,34,3476.49,6016.02,0.00
2024-12-10 17:38:34,66,5217,32,34,3396.52,6016.20,0.00
2024-12-10 17:38:34,65,5217,31,34,3507.12,6016.25,0.00
2024-12-10 17:38:34,65,5218,31,34,3517.79,6017.00,0.00
2024-12-10 17:38:34,66,5218,32,34,3464.49,6017.02,0.00
2024-12-10 17:38:34,66,5219,32,34,3533.18,6018.00,0.00
2024-12-10 17:38:34,67,5219,33,34,3480.44,6018.02,0.00
2024-12-10 17:38:34,66,5219,33,33,3524.97,6018.02,0.00
2024-12-10 17:38:34,66,5220,33,33,3521.00,6019.00,0.00
2024-12-10 17:38:34,67,5220,34,33,3468.45,6019.02,0.00
2024-12-10 17:38:34,66,5220,34,32,3512.80,6019.06,0.00
2024-12-10 17:38:34,65,5220,33,32,3526.51,6019.69,0.00
2024-12-10 17:38:34,65,5221,33,32,3600.82,6020.00,0.00
2024-12-10 17:38:34,66,5221,33,33,3546.26,6020.02,0.00
2024-12-10 17:38:34,66,5222,33,33,3524.04,6021.00,0.00
2024-12-10 17:38:34,67,5222,34,33,3471.45,6021.02,0.00
2024-12-10 17:38:34,66,5222,34,32,3514.94,6021.08,0.00
2024-12-10 17:38:34,65,5222,33,32,3561.66,6021.20,0.00
2024-12-10 17:38:34,64,5222,32,32,3580.73,6021.42,0.00
2024-12-10 17:38:34,64,5223,32,32,3640.42,6022.00,0.00
2024-12-10 17:38:34,65,5223,33,32,3584.41,6022.02,0.00
2024-12-10 17:38:34,65,5224,33,32,3562.46,6023.00,0.00
2024-12-10 17:38:34,66,5224,33,33,3508.48,6023.02,0.00
2024-12-10 17:38:34,65,5224,33,32,3555.06,6023.08,0.00
2024-12-10 17:38:34,64,5224,32,32,3546.76,6023.91,0.00
2024-12-10 17:38:34,64,5225,32,32,3635.31,6024.00,0.00
2024-12-10 17:38:34,65,5225,33,32,3579.38,6024.02,0.00
2024-12-10 17:38:34,65,5226,33,32,3557.73,6025.00,0.00
2024-12-10 17:38:34,66,5226,34,32,3503.83,6025.02,0.00
2024-12-10 17:38:34,65,5226,34,31,3551.26,6025.08,0.00
2024-12-10 17:38:34,65,5227,34,31,3551.83,6026.00,0.00
2024-12-10 17:38:34,66,5227,35,31,3498.02,6026.02,0.00
2024-12-10 17:38:34,66,5228,35,31,3498.47,6027.00,0.00
2024-12-10 17:38:34,67,5228,35,32,3446.25,6027.02,0.00
2024-12-10 17:38:34,67,5229,35,32,3432.72,6028.00,0.00
2024-12-10 17:38:34,68,5229,35,33,3382.24,6028.02,0.00
2024-12-10 17:38:34,68,5230,35,33,3358.87,6029.00,0.00
2024-12-10 17:38:34,69,5230,36,33,3310.19,6029.02,0.00
2024-12-10 17:38:34,68,5230,35,33,3357.10,6029.03,0.00
2024-12-10 17:38:34,67,5230,35,32,3402.71,6029.06,0.00
2024-12-10 17:38:34,66,5230,34,32,3372.87,6029.97,0.00
2024-12-10 17:38:34,66,5231,34,32,3462.42,6030.00,0.00
2024-12-10 17:38:34,67,5231,35,32,3410.74,6030.02,0.00
2024-12-10 17:38:34,67,5232,35,32,3413.35,6031.00,0.00
2024-12-10 17:38:34,68,5232,35,33,3363.15,6031.02,0.00
2024-12-10 17:38:34,68,5233,35,33,3359.41,6032.00,0.00
2024-12-10 17:38:34,69,5233,35,34,3310.73,6032.02,0.00
2024-12-10 17:38:34,69,5234,35,34,3293.48,6033.00,0.00
2024-12-10 17:38:34,70,5234,35,35,3246.43,6033.01,0.00
2024-12-10 17:38:34,69,5234,35,34,3292.15,6033.03,0.00
2024-12-10 17:38:34,69,5235,35,34,3265.08,6034.00,0.00
2024-12-10 17:38:34,70,5235,35,35,3218.44,6034.01,0.00
2024-12-10 17:38:34,69,5235,35,34,3260.72,6034.04,0.00
2024-12-10 17:38:34,68,5235,34,34,3236.15,6034.96,0.00
2024-12-10 17:38:34,68,5236,34,34,3322.27,6035.00,0.00
2024-12-10 17:38:34,69,5236,34,35,3274.12,6035.02,0.00
2024-12-10 17:38:34,68,5236,34,34,3268.14,6035.06,0.00
2024-12-10 17:38:34,68,5237,34,34,3294.86,6036.00,0.00
2024-12-10 17:38:34,69,5237,34,35,3247.11,6036.02,0.00
2024-12-10 17:38:34,68,5237,34,34,3276.23,6036.06,0.00
2024-12-10 17:38:34,68,5238,34,34,3267.68,6037.00,0.00
2024-12-10 17:38:34,69,5238,35,34,3220.33,6037.02,0.00
2024-12-10 17:38:34,68,5238,35,33,3247.27,6037.06,0.00
2024-12-10 17:38:34,68,5239,35,33,3239.03,6038.00,0.00
2024-12-10 17:38:34,69,5239,35,34,3192.09,6038.02,0.00
2024-12-10 17:38:34,69,5240,35,34,3163.73,6039.00,0.00
2024-12-10 17:38:34,70,5240,35,35,3118.54,6039.01,0.00
2024-12-10 17:38:34,69,5240,35,34,3155.87,6039.07,0.00
2024-12-10 17:38:34,68,5240,34,34,3137.23,6039.65,0.00
2024-12-10 17:38:34,68,5241,34,34,3201.85,6040.00,0.00
2024-12-10 17:38:34,69,5241,34,35,3155.44,6040.02,0.00
2024-12-10 17:38:34,68,5241,33,35,3114.17,6040.66,0.00
2024-12-10 17:38:34,68,5242,33,35,3180.21,6041.00,0.00
2024-12-10 17:38:34,69,5242,33,36,3134.12,6041.02,0.00
2024-12-10 17:38:34,68,5242,33,35,3170.45,6041.09,0.00
2024-12-10 17:38:34,67,5242,32,35,3174.53,6041.19,0.00
2024-12-10 17:38:34,67,5243,32,35,3214.27,6042.00,0.00
2024-12-10 17:38:34,68,5243,32,36,3167.00,6042.02,0.00
2024-12-10 17:38:34,67,5243,31,36,3162.89,6042.12,0.00
2024-12-10 17:38:34,68,5242,31,37,3078.24,6042.75,0.00
2024-12-10 17:38:34,68,5242,31,37,3177.14,6043.00,0.00
2024-12-10 17:38:34,69,5242,31,38,3131.09,6043.02,0.00
2024-12-10 17:38:35,68,5242,31,37,3168.17,6043.10,0.00
2024-12-10 17:38:35,67,5242,30,37,3202.51,6043.22,0.00
2024-12-10 17:38:35,67,5243,30,37,3334.62,6044.00,0.00
2024-12-10 17:38:35,68,5243,31,37,3285.58,6044.02,0.00
2024-12-10 17:38:35,67,5243,30,37,3278.71,6044.13,0.00
2024-12-10 17:38:35,67,5244,30,37,3315.03,6045.00,0.00
2024-12-10 17:38:35,68,5244,30,38,3266.28,6045.02,0.00
2024-12-10 17:38:35,67,5244,29,38,3313.22,6045.03,0.00
2024-12-10 17:38:35,66,5244,29,37,3347.87,6045.11,0.00
2024-12-10 17:38:35,66,5245,29,37,3347.38,6046.00,0.00
2024-12-10 17:38:35,67,5245,30,37,3297.42,6046.02,0.00
2024-12-10 17:38:35,66,5245,29,37,3331.02,6046.03,0.00
2024-12-10 17:38:35,66,5246,29,37,3344.42,6047.00,0.00
2024-12-10 17:38:35,67,5246,29,38,3294.51,6047.02,0.00
2024-12-10 17:38:35,66,5246,29,37,3329.78,6047.09,0.00
2024-12-10 17:38:35,66,5247,29,37,3328.90,6048.00,0.00
2024-12-10 17:38:35,67,5247,29,38,3279.21,6048.02,0.00
2024-12-10 17:38:35,66,5247,28,38,3272.20,6048.39,0.00
2024-12-10 17:38:35,66,5248,28,38,3325.98,6049.00,0.00
2024-12-10 17:38:35,67,5248,29,38,3276.34,6049.02,0.00
2024-12-10 17:38:35,66,5248,29,37,3308.58,6049.09,0.00
2024-12-10 17:38:35,65,5248,28,37,3324.22,6049.40,0.00
2024-12-10 17:38:35,65,5249,28,37,3378.05,6050.00,0.00
2024-12-10 17:38:35,66,5249,28,38,3326.87,6050.02,0.00
2024-12-10 17:38:35,66,5250,28,38,3307.21,6051.00,0.00
2024-12-10 17:38:35,67,5250,29,38,3257.85,6051.02,0.00
2024-12-10 17:38:35,66,5250,29,37,3285.87,6051.11,0.00
2024-12-10 17:38:35,65,5250,28,37,3331.96,6051.11,0.00
2024-12-10 17:38:35,65,5251,28,37,3365.31,6052.00,0.00
2024-12-10 17:38:35,66,5251,28,38,3314.32,6052.02,0.00
2024-12-10 17:38:35,67,5250,29,38,3216.55,6052.51,0.00
2024-12-10 17:38:35,66,5250,28,38,3331.05,6052.52,0.00
2024-12-10 17:38:35,66,5251,28,38,3359.66,6053.00,0.00
2024-12-10 17:38:35,67,5251,29,38,3309.51,6053.02,0.00
2024-12-10 17:38:35,66,5251,28,38,3358.74,6053.02,0.00
2024-12-10 17:38:35,65,5251,28,37,3386.44,6053.09,0.00
2024-12-10 17:38:35,64,5251,27,37,3436.54,6053.14,0.00
2024-12-10 17:38:35,64,5252,27,37,3530.92,6054.00,0.00
2024-12-10 17:38:35,65,5252,27,38,3476.60,6054.02,0.00
2024-12-10 17:38:35,64,5252,27,37,3514.80,6054.08,0.00
2024-12-10 17:38:35,64,5253,27,37,3511.42,6055.00,0.00
2024-12-10 17:38:35,65,5253,28,37,3457.40,6055.02,0.00
2024-12-10 17:38:35,65,5254,28,37,3431.52,6056.00,0.00
2024-12-10 17:38:35,66,5254,29,37,3379.52,6056.02,0.00
2024-12-10 17:38:35,65,5254,29,36,3411.96,6056.09,0.00
2024-12-10 17:38:35,64,5254,28,36,3460.56,6056.11,0.00
2024-12-10 17:38:35,64,5255,28,36,3491.16,6057.00,0.00
2024-12-10 17:38:35,65,5255,29,36,3437.45,6057.02,0.00
2024-12-10 17:38:35,64,5255,28,36,3461.86,6057.17,0.00
2024-12-10 17:38:35,64,5256,28,36,3462.10,6058.00,0.00
2024-12-10 17:38:35,65,5256,28,37,3408.84,6058.02,0.00
2024-12-10 17:38:35,64,5256,28,36,3444.13,6058.09,0.00
2024-12-10 17:38:35,64,5257,28,36,3434.75,6059.00,0.00
2024-12-10 17:38:35,65,5257,28,37,3381.90,6059.02,0.00
2024-12-10 17:38:35,65,5258,28,37,3351.78,6060.00,0.00
2024-12-10 17:38:35,66,5258,28,38,3300.99,6060.02,0.00
2024-12-10 17:38:35,65,5258,28,37,3334.07,6060.09,0.00
2024-12-10 17:38:35,64,5258,27,37,3327.15,6060.52,0.00
2024-12-10 17:38:35,63,5258,27,36,3365.59,6060.67,0.00
2024-12-10 17:38:35,63,5259,27,36,3435.81,6061.00,0.00
2024-12-10 17:38:35,64,5259,28,36,3382.13,6061.02,0.00
2024-12-10 17:38:35,63,5259,27,36,3434.85,6061.02,0.00
2024-12-10 17:38:35,63,5260,27,36,3412.12,6062.00,0.00
2024-12-10 17:38:35,64,5260,28,36,3358.80,6062.02,0.00
2024-12-10 17:38:35,63,5260,28,35,3395.77,6062.08,0.00
2024-12-10 17:38:35,62,5260,27,35,3446.65,6062.15,0.00
2024-12-10 17:38:35,61,5260,26,35,3502.16,6062.15,0.00
2024-12-10 17:38:35,61,5261,26,35,3542.72,6063.00,0.00
2024-12-10 17:38:35,62,5261,27,35,3485.58,6063.02,0.00
2024-12-10 17:38:35,62,5262,27,35,3459.03,6064.00,0.00
2024-12-10 17:38:35,63,5262,28,35,3404.12,6064.02,0.00
2024-12-10 17:38:35,62,5262,28,34,3443.39,6064.08,0.00
2024-12-10 17:38:35,62,5263,28,34,3437.18,6065.00,0.00
2024-12-10 17:38:35,63,5263,28,35,3382.63,6065.02,0.00
2024-12-10 17:38:35,62,5263,27,35,3436.21,6065.02,0.00
2024-12-10 17:38:35,62,5264,27,35,3410.21,6066.00,0.00
2024-12-10 17:38:35,63,5264,28,35,3356.08,6066.02,0.00
2024-12-10 17:38:35,62,5264,28,34,3393.58,6066.08,0.00
2024-12-10 17:38:35,61,5264,27,34,3447.24,6066.12,0.00
2024-12-10 17:38:35,61,5265,27,34,3442.70,6067.00,0.00
2024-12-10 17:38:35,62,5265,27,35,3387.17,6067.02,0.00
2024-12-10 17:38:35,61,5265,27,34,3381.97,6067.56,0.00
2024-12-10 17:38:35,61,5266,27,34,3419.30,6068.00,0.00
2024-12-10 17:38:35,62,5266,27,35,3364.15,6068.02,0.00
2024-12-10 17:38:35,61,5266,27,34,3402.40,6068.08,0.00
2024-12-10 17:38:35,61,5267,27,34,3406.93,6069.00,0.00
2024-12-10 17:38:35,62,5267,28,34,3351.98,6069.02,0.00
2024-12-10 17:38:35,61,5267,27,34,3405.94,6069.02,0.00
2024-12-10 17:38:35,60,5267,26,34,3408.18,6069.32,0.00
2024-12-10 17:38:35,60,5268,26,34,3468.33,6070.00,0.00
2024-12-10 17:38:35,61,5268,26,35,3411.47,6070.02,0.00
2024-12-10 17:38:35,60,5268,25,35,3467.74,6070.02,0.00
2024-12-10 17:38:35,59,5268,25,34,3510.06,6070.05,0.00
2024-12-10 17:38:35,60,5267,25,35,3414.45,6070.70,0.00
2024-12-10 17:38:35,60,5268,25,35,3474.38,6071.00,0.00
2024-12-10 17:38:35,61,5268,25,36,3417.42,6071.02,0.00
2024-12-10 17:38:35,61,5269,25,36,3503.37,6072.00,0.00
2024-12-10 17:38:35,62,5269,25,37,3446.87,6072.02,0.00
2024-12-10 17:38:35,61,5269,25,36,3485.46,6072.05,0.00
2024-12-10 17:38:35,60,5269,24,36,3465.37,6072.95,0.00
2024-12-10 17:38:35,60,5270,24,36,3563.58,6073.00,0.00
2024-12-10 17:38:35,61,5270,25,36,3505.16,6073.02,0.00
2024-12-10 17:38:35,61,5271,25,36,3490.72,6074.00,0.00
2024-12-10 17:38:35,62,5271,26,36,3434.42,6074.02,0.00
2024-12-10 17:38:35,61,5271,26,35,3471.81,6074.07,0.00
2024-12-10 17:38:35,61,5272,26,35,3475.36,6075.00,0.00
2024-12-10 17:38:36,62,5272,26,36,3419.31,6075.02,0.00
2024-12-10 17:38:36,61,5272,25,36,3413.93,6075.61,0.00
2024-12-10 17:38:36,61,5273,25,36,3489.91,6076.00,0.00
2024-12-10 17:38:36,62,5273,26,36,3433.62,6076.02,0.00
2024-12-10 17:38:36,61,5273,26,35,3471.99,6076.07,0.00
2024-12-10 17:38:36,60,5273,25,35,3516.73,6076.18,0.00
2024-12-10 17:38:36,60,5274,25,35,3568.92,6077.00,0.00
2024-12-10 17:38:36,61,5274,26,35,3510.41,6077.02,0.00
2024-12-10 17:38:36,60,5274,25,35,3504.40,6077.13,0.00
2024-12-10 17:38:36,60,5275,25,35,3553.58,6078.00,0.00
2024-12-10 17:38:36,61,5275,26,35,3495.32,6078.02,0.00
2024-12-10 17:38:36,60,5275,26,34,3536.37,6078.07,0.00
2024-12-10 17:38:36,59,5275,25,34,3563.70,6078.59,0.00
2024-12-10 17:38:36,59,5276,25,34,3601.09,6079.00,0.00
2024-12-10 17:38:36,60,5276,25,35,3541.08,6079.02,0.00
2024-12-10 17:38:36,59,5276,24,35,3575.82,6079.09,0.00
2024-12-10 17:38:36,59,5277,24,35,3585.25,6080.00,0.00
2024-12-10 17:38:36,60,5277,24,36,3525.50,6080.02,0.00
2024-12-10 17:38:36,59,5277,24,35,3567.90,6080.07,0.00
2024-12-10 17:38:36,58,5277,23,35,3569.26,6080.50,0.00
2024-12-10 17:38:36,58,5278,23,35,3644.06,6081.00,0.00
2024-12-10 17:38:36,59,5278,23,36,3582.30,6081.02,0.00
2024-12-10 17:38:36,59,5279,23,36,3567.26,6082.00,0.00
2024-12-10 17:38:36,60,5279,23,37,3507.81,6082.02,0.00
2024-12-10 17:38:36,59,5279,23,36,3548.71,6082.07,0.00
2024-12-10 17:38:36,58,5279,22,36,3598.56,6082.14,0.00
2024-12-10 17:38:36,58,5280,22,36,3651.56,6083.00,0.00
2024-12-10 17:38:36,59,5280,22,37,3589.66,6083.02,0.00
2024-12-10 17:38:36,59,5281,22,37,3574.46,6084.00,0.00
2024-12-10 17:38:36,60,5281,22,38,3514.89,6084.02,0.00
2024-12-10 17:38:36,59,5281,22,37,3552.81,6084.09,0.00
2024-12-10 17:38:36,59,5282,22,37,3555.99,6085.00,0.00
2024-12-10 17:38:36,60,5282,22,38,3496.73,6085.02,0.00
2024-12-10 17:38:36,59,5282,21,38,3552.83,6085.07,0.00
2024-12-10 17:38:36,59,5283,21,38,3542.79,6086.00,0.00
2024-12-10 17:38:36,60,5283,21,39,3483.74,6086.02,0.00
2024-12-10 17:38:36,59,5283,20,39,3511.27,6086.07,0.00
2024-12-10 17:38:36,58,5283,19,39,3518.95,6086.59,0.00
2024-12-10 17:38:36,58,5284,19,39,3592.66,6087.00,0.00
2024-12-10 17:38:36,59,5284,20,39,3531.77,6087.02,0.00
2024-12-10 17:38:36,58,5284,19,39,3508.92,6087.52,0.00
2024-12-10 17:38:36,58,5285,19,39,3578.07,6088.00,0.00
2024-12-10 17:38:36,59,5285,20,39,3517.43,6088.02,0.00
2024-12-10 17:38:36,58,5285,20,38,3552.89,6088.09,0.00
2024-12-10 17:38:36,57,5285,20,37,3614.15,6088.09,0.00
2024-12-10 17:38:36,57,5286,20,37,3617.28,6089.00,0.00
2024-12-10 17:38:36,58,5286,21,37,3554.92,6089.02,0.00
2024-12-10 17:38:36,57,5286,20,37,3529.22,6089.58,0.00
2024-12-10 17:38:36,57,5287,20,37,3605.04,6090.00,0.00
2024-12-10 17:38:36,58,5287,20,38,3542.89,6090.02,0.00
2024-12-10 17:38:36,57,5287,19,38,3603.97,6090.02,0.00
2024-12-10 17:38:36,57,5288,19,38,3578.85,6091.00,0.00
2024-12-10 17:38:36,58,5288,20,38,3517.15,6091.02,0.00
2024-12-10 17:38:36,57,5288,20,37,3573.77,6091.09,0.00
2024-12-10 17:38:36,57,5289,20,37,3572.11,6092.00,0.00
2024-12-10 17:38:36,58,5289,21,37,3510.52,6092.02,0.00
2024-12-10 17:38:36,57,5289,20,37,3495.80,6092.39,0.00
2024-12-10 17:38:36,57,5290,20,37,3553.24,6093.00,0.00
2024-12-10 17:38:36,58,5290,21,37,3491.97,6093.02,0.00
2024-12-10 17:38:36,57,5290,21,36,3539.34,6093.05,0.00
2024-12-10 17:38:36,57,5291,21,36,3532.87,6094.00,0.00
2024-12-10 17:38:36,58,5291,22,36,3471.96,6094.02,0.00
2024-12-10 17:38:36,59,5290,22,37,3315.02,6094.75,0.00
2024-12-10 17:38:36,59,5291,22,37,3410.53,6095.00,0.00
2024-12-10 17:38:36,60,5291,23,37,3353.69,6095.02,0.00
2024-12-10 17:38:36,59,5291,23,36,3385.75,6095.09,0.00
2024-12-10 17:38:36,58,5291,22,36,3376.86,6095.50,0.00
2024-12-10 17:38:36,58,5292,22,36,3546.49,6096.00,0.00
2024-12-10 17:38:36,59,5292,23,36,3486.38,6096.02,0.00
2024-12-10 17:38:36,58,5292,22,36,3545.44,6096.02,0.00
2024-12-10 17:38:36,57,5292,21,36,3593.74,6096.02,0.00
2024-12-10 17:38:36,56,5292,21,35,3584.31,6096.71,0.00
2024-12-10 17:38:36,56,5293,21,35,3675.99,6097.00,0.00
2024-12-10 17:38:36,57,5293,22,35,3611.50,6097.02,0.00
2024-12-10 17:38:36,57,5294,22,35,3587.82,6098.00,0.00
2024-12-10 17:38:36,58,5294,22,36,3525.96,6098.02,0.00
2024-12-10 17:38:36,57,5294,22,35,3572.84,6098.02,0.00
2024-12-10 17:38:36,57,5295,22,35,3566.83,6099.00,0.00
2024-12-10 17:38:36,58,5295,22,36,3505.33,6099.02,0.00
2024-12-10 17:38:36,57,5295,22,35,3545.21,6099.05,0.00
2024-12-10 17:38:36,57,5296,22,35,3537.32,6100.00,0.00
2024-12-10 17:38:36,58,5296,23,35,3476.33,6100.02,0.00
2024-12-10 17:38:37,58,5297,23,35,3445.30,6101.00,0.00
2024-12-10 17:38:37,59,5297,23,36,3386.91,6101.02,0.00
2024-12-10 17:38:37,58,5297,23,35,3422.58,6101.07,0.00
2024-12-10 17:38:37,58,5298,23,35,3406.08,6102.00,0.00
2024-12-10 17:38:37,59,5298,23,36,3348.35,6102.02,0.00
2024-12-10 17:38:37,58,5298,22,36,3276.92,6102.78,0.00
2024-12-10 17:38:37,58,5299,22,36,3368.62,6103.00,0.00
2024-12-10 17:38:37,59,5299,23,36,3311.53,6103.02,0.00
2024-12-10 17:38:37,58,5299,22,36,3366.41,6103.05,0.00
2024-12-10 17:38:37,57,5299,22,35,3407.27,6103.05,0.00
2024-12-10 17:38:37,56,5299,22,34,3439.35,6103.45,0.00
2024-12-10 17:38:37,56,5300,22,34,3460.45,6104.00,0.00
2024-12-10 17:38:37,57,5300,22,35,3399.74,6104.02,0.00
2024-12-10 17:38:37,56,5300,21,35,3429.39,6104.11,0.00
2024-12-10 17:38:37,56,5301,21,35,3473.49,6105.00,0.00
2024-12-10 17:38:37,57,5301,21,36,3412.55,6105.02,0.00
2024-12-10 17:38:37,56,5301,21,35,3401.63,6105.57,0.00
2024-12-10 17:38:37,56,5302,21,35,3451.09,6106.00,0.00
2024-12-10 17:38:37,57,5302,21,36,3390.55,6106.02,0.00
2024-12-10 17:38:37,56,5302,21,35,3418.39,6106.11,0.00
2024-12-10 17:38:37,56,5303,21,35,3429.83,6107.00,0.00
2024-12-10 17:38:37,57,5303,21,36,3369.66,6107.02,0.00
2024-12-10 17:38:37,56,5303,20,36,3422.46,6107.11,0.00
2024-12-10 17:38:37,56,5304,20,36,3422.90,6108.00,0.00
2024-12-10 17:38:37,57,5304,21,36,3362.85,6108.02,0.00
2024-12-10 17:38:37,56,5304,21,35,3395.00,6108.11,0.00
2024-12-10 17:38:37,55,5304,20,35,3391.69,6108.82,0.00
2024-12-10 17:38:37,55,5305,20,35,3491.80,6109.00,0.00
2024-12-10 17:38:37,56,5305,21,35,3429.45,6109.02,0.00
2024-12-10 17:38:37,55,5305,20,35,3402.22,6109.80,0.00
2024-12-10 17:38:37,55,5306,20,35,3501.25,6110.00,0.00
2024-12-10 17:38:37,56,5306,21,35,3438.73,6110.02,0.00
2024-12-10 17:38:37,55,5306,21,34,3499.84,6110.02,0.00
2024-12-10 17:38:37,54,5306,21,33,3538.65,6110.09,0.00
2024-12-10 17:38:37,54,5307,21,33,3551.66,6111.00,0.00
2024-12-10 17:38:37,55,5307,21,34,3487.08,6111.02,0.00
2024-12-10 17:38:37,55,5308,21,34,3480.54,6112.00,0.00
2024-12-10 17:38:37,56,5308,21,35,3418.39,6112.02,0.00
2024-12-10 17:38:37,55,5308,21,34,3455.00,6112.09,0.00
2024-12-10 17:38:37,54,5308,20,34,3503.60,6112.13,0.00
2024-12-10 17:38:37,54,5309,20,34,3564.14,6113.00,0.00
2024-12-10 17:38:37,55,5309,20,35,3499.34,6113.02,0.00
2024-12-10 17:38:37,55,5310,20,35,3506.53,6114.00,0.00
2024-12-10 17:38:37,56,5310,21,35,3443.92,6114.02,0.00
2024-12-10 17:38:37,55,5310,20,35,3463.83,6114.35,0.00
2024-12-10 17:38:37,55,5311,20,35,3535.44,6115.00,0.00
2024-12-10 17:38:37,56,5311,20,36,3472.30,6115.02,0.00
2024-12-10 17:38:37,55,5311,20,35,3513.22,6115.09,0.00
2024-12-10 17:38:37,55,5312,20,35,3524.89,6116.00,0.00
2024-12-10 17:38:37,56,5312,21,35,3461.95,6116.02,0.00
2024-12-10 17:38:37,56,5313,21,35,3438.95,6117.00,0.00
2024-12-10 17:38:37,57,5313,22,35,3378.62,6117.02,0.00
2024-12-10 17:38:37,56,5313,22,34,3424.20,6117.09,0.00
2024-12-10 17:38:37,56,5314,22,34,3424.58,6118.00,0.00
2024-12-10 17:38:37,57,5314,22,35,3364.50,6118.02,0.00
2024-12-10 17:38:37,58,5313,23,35,3304.39,6118.09,0.00
2024-12-10 17:38:37,58,5314,23,35,3395.68,6119.00,0.00
2024-12-10 17:38:37,59,5314,24,35,3338.13,6119.02,0.00
2024-12-10 17:38:37,59,5315,24,35,3453.68,6120.00,0.00
2024-12-10 17:38:37,60,5315,24,36,3396.12,6120.02,0.00
2024-12-10 17:38:37,59,5315,23,36,3401.80,6120.53,0.00
2024-12-10 17:38:37,59,5316,23,36,3464.34,6121.00,0.00
2024-12-10 17:38:37,60,5316,23,37,3406.60,6121.02,0.00
2024-12-10 17:38:37,59,5316,22,37,3414.30,6121.49,0.00
2024-12-10 17:38:37,60,5315,22,38,3331.04,6121.93,0.00
2024-12-10 17:38:37,60,5316,22,38,3413.27,6122.00,0.00
2024-12-10 17:38:37,61,5316,22,39,3357.32,6122.02,0.00
2024-12-10 17:38:37,60,5316,21,39,3371.79,6122.35,0.00
2024-12-10 17:38:37,60,5317,21,39,3502.30,6123.00,0.00
2024-12-10 17:38:37,61,5317,21,40,3444.88,6123.02,0.00
2024-12-10 17:38:37,60,5317,21,39,3483.93,6123.05,0.00
2024-12-10 17:38:37,60,5318,21,39,3487.02,6124.00,0.00
2024-12-10 17:38:37,61,5318,21,40,3429.86,6124.02,0.00
2024-12-10 17:38:37,60,5318,21,39,3467.64,6124.08,0.00
2024-12-10 17:38:37,59,5318,20,39,3523.31,6124.14,0.00
2024-12-10 17:38:37,59,5319,20,39,3530.36,6125.00,0.00
2024-12-10 17:38:37,60,5319,21,39,3471.52,6125.02,0.00
2024-12-10 17:38:37,59,5319,21,38,3518.94,6125.02,0.00
2024-12-10 17:38:37,58,5319,20,38,3573.80,6125.10,0.00
2024-12-10 17:38:37,58,5320,20,38,3573.17,6126.00,0.00
2024-12-10 17:38:37,59,5320,20,39,3512.61,6126.02,0.00
2024-12-10 17:38:37,59,5321,20,39,3498.39,6127.00,0.00
2024-12-10 17:38:37,60,5321,20,40,3440.08,6127.02,0.00
2024-12-10 17:38:37,59,5321,20,39,3473.48,6127.10,0.00
2024-12-10 17:38:37,58,5321,19,39,3478.49,6127.41,0.00
2024-12-10 17:38:37,58,5322,19,39,3543.98,6128.00,0.00
2024-12-10 17:38:37,59,5322,19,40,3483.91,6128.02,0.00
2024-12-10 17:38:37,58,5322,18,40,3469.58,6128.64,0.00
2024-12-10 17:38:37,58,5323,18,40,3515.02,6129.00,0.00
2024-12-10 17:38:37,59,5323,18,41,3455.44,6129.02,0.00
2024-12-10 17:38:37,58,5323,18,40,3489.68,6129.10,0.00
2024-12-10 17:38:37,57,5323,18,39,3501.74,6129.58,0.00
2024-12-10 17:38:37,56,5323,17,39,3552.46,6129.63,0.00
2024-12-10 17:38:37,56,5324,17,39,3633.33,6130.00,0.00
2024-12-10 17:38:37,57,5324,17,40,3569.58,6130.02,0.00
2024-12-10 17:38:37,57,5325,17,40,3552.53,6131.00,0.00
2024-12-10 17:38:37,58,5325,17,41,3491.28,6131.02,0.00
2024-12-10 17:38:37,57,5325,17,40,3527.81,6131.11,0.00
2024-12-10 17:38:37,56,5325,16,40,3572.18,6131.20,0.00
2024-12-10 17:38:38,56,5326,16,40,3624.76,6132.00,0.00
2024-12-10 17:38:38,57,5326,16,41,3561.17,6132.02,0.00
2024-12-10 17:38:38,57,5327,16,41,3544.43,6133.00,0.00
2024-12-10 17:38:38,58,5327,17,41,3483.32,6133.02,0.00
2024-12-10 17:38:38,57,5327,17,40,3519.70,6133.11,0.00
2024-12-10 17:38:38,57,5328,17,40,3523.96,6134.00,0.00
2024-12-10 17:38:38,58,5328,17,41,3463.20,6134.02,0.00
2024-12-10 17:38:38,58,5329,17,41,3447.41,6135.00,0.00
2024-12-10 17:38:38,59,5329,18,41,3388.98,6135.02,0.00
2024-12-10 17:38:38,58,5329,18,40,3424.15,6135.10,0.00
2024-12-10 17:38:38,58,5330,18,40,3424.22,6136.00,0.00
2024-12-10 17:38:38,59,5330,19,40,3366.18,6136.02,0.00
2024-12-10 17:38:38,58,5330,18,40,3306.02,6136.97,0.00
2024-12-10 17:38:38,58,5331,18,40,3409.73,6137.00,0.00
2024-12-10 17:38:38,59,5331,18,41,3351.94,6137.02,0.00
2024-12-10 17:38:38,58,5331,18,40,3387.52,6137.10,0.00
2024-12-10 17:38:38,57,5331,17,40,3420.77,6137.53,0.00
2024-12-10 17:38:38,56,5331,17,39,3462.38,6137.61,0.00
2024-12-10 17:38:38,56,5332,17,39,3504.34,6138.00,0.00
2024-12-10 17:38:38,57,5332,18,39,3442.86,6138.02,0.00
2024-12-10 17:38:38,56,5332,17,39,3474.77,6138.14,0.00
2024-12-10 17:38:38,56,5333,17,39,3494.17,6139.00,0.00
2024-12-10 17:38:38,57,5333,18,39,3432.87,6139.02,0.00
2024-12-10 17:38:38,56,5333,18,38,3468.97,6139.13,0.00
2024-12-10 17:38:38,56,5334,18,38,3476.99,6140.00,0.00
2024-12-10 17:38:38,57,5334,19,38,3415.99,6140.02,0.00
2024-12-10 17:38:38,56,5334,18,38,3371.25,6140.93,0.00
2024-12-10 17:38:38,56,5335,18,38,3476.57,6141.00,0.00
2024-12-10 17:38:38,57,5335,19,38,3415.58,6141.02,0.00
2024-12-10 17:38:38,56,5335,19,37,3475.20,6141.04,0.00
2024-12-10 17:38:38,55,5335,19,36,3510.48,6141.11,0.00
2024-12-10 17:38:38,55,5336,19,36,3520.27,6142.00,0.00
2024-12-10 17:38:38,56,5336,19,37,3457.41,6142.02,0.00
2024-12-10 17:38:38,55,5336,19,36,3519.16,6142.02,0.00
2024-12-10 17:38:38,55,5337,19,36,3512.53,6143.00,0.00
2024-12-10 17:38:38,56,5337,20,36,3449.81,6143.02,0.00
2024-12-10 17:38:38,55,5337,20,35,3485.74,6143.09,0.00
2024-12-10 17:38:38,55,5338,20,35,3492.94,6144.00,0.00
2024-12-10 17:38:38,56,5338,21,35,3430.56,6144.02,0.00
2024-12-10 17:38:38,56,5339,21,35,3416.54,6145.00,0.00
2024-12-10 17:38:38,57,5339,21,36,3356.60,6145.02,0.00
2024-12-10 17:38:38,56,5339,21,35,3391.31,6145.09,0.00
2024-12-10 17:38:38,56,5340,21,35,3393.64,6146.00,0.00
2024-12-10 17:38:38,57,5340,22,35,3334.10,6146.02,0.00
2024-12-10 17:38:38,56,5340,21,35,3282.86,6146.93,0.00
2024-12-10 17:38:38,56,5341,21,35,3388.28,6147.00,0.00
2024-12-10 17:38:38,57,5341,22,35,3328.84,6147.02,0.00
2024-12-10 17:38:38,56,5341,22,34,3364.14,6147.09,0.00
2024-12-10 17:38:38,56,5342,22,34,3370.72,6148.00,0.00
2024-12-10 17:38:38,57,5342,22,35,3311.59,6148.02,0.00
2024-12-10 17:38:38,56,5342,21,35,3342.20,6148.13,0.00
2024-12-10 17:38:38,56,5343,21,35,3362.68,6149.00,0.00
2024-12-10 17:38:38,57,5343,22,35,3303.69,6149.02,0.00
2024-12-10 17:38:38,56,5343,22,34,3337.45,6149.11,0.00
2024-12-10 17:38:38,56,5344,22,34,3347.26,6150.00,0.00
2024-12-10 17:38:38,57,5344,22,35,3288.54,6150.02,0.00
2024-12-10 17:38:38,56,5344,21,35,3315.43,6150.13,0.00
2024-12-10 17:38:38,56,5345,21,35,3371.12,6151.00,0.00
2024-12-10 17:38:38,57,5345,21,36,3311.97,6151.02,0.00
2024-12-10 17:38:38,56,5345,20,36,3318.25,6151.27,0.00
2024-12-10 17:38:38,56,5346,20,36,3383.53,6152.00,0.00
2024-12-10 17:38:38,57,5346,21,36,3324.17,6152.02,0.00
2024-12-10 17:38:38,57,5347,21,36,3306.47,6153.00,0.00
2024-12-10 17:38:38,58,5347,21,37,3249.47,6153.02,0.00
2024-12-10 17:38:38,57,5347,21,36,3296.78,6153.14,0.00
2024-12-10 17:38:38,56,5347,20,36,3318.40,6153.36,0.00
2024-12-10 17:38:38,56,5348,20,36,3387.55,6154.00,0.00
2024-12-10 17:38:38,57,5348,20,37,3328.12,6154.02,0.00
2024-12-10 17:38:38,56,5348,19,37,3297.57,6154.79,0.00
2024-12-10 17:38:38,56,5349,19,37,3394.47,6155.00,0.00
2024-12-10 17:38:38,57,5349,19,38,3334.91,6155.02,0.00
2024-12-10 17:38:38,56,5349,18,38,3336.42,6155.55,0.00
2024-12-10 17:38:38,56,5350,18,38,3376.04,6156.00,0.00
2024-12-10 17:38:38,57,5350,19,38,3316.81,6156.02,0.00
2024-12-10 17:38:38,56,5350,18,38,3374.94,6156.02,0.00
2024-12-10 17:38:38,55,5350,18,37,3422.91,6156.16,0.00
2024-12-10 17:38:38,54,5350,17,37,3448.15,6156.72,0.00
2024-12-10 17:38:38,54,5351,17,37,3545.28,6157.00,0.00
2024-12-10 17:38:38,55,5351,18,37,3480.82,6157.02,0.00
2024-12-10 17:38:38,54,5351,17,37,3531.63,6157.17,0.00
2024-12-10 17:38:38,53,5351,16,37,3558.79,6157.40,0.00
2024-12-10 17:38:38,53,5352,16,37,3638.24,6158.00,0.00
2024-12-10 17:38:38,54,5352,17,37,3570.87,6158.02,0.00
2024-12-10 17:38:38,53,5352,17,36,3619.93,6158.09,0.00
2024-12-10 17:38:38,52,5352,16,36,3643.37,6158.12,0.00
2024-12-10 17:38:38,52,5353,16,36,3707.90,6159.00,0.00
2024-12-10 17:38:38,53,5353,16,37,3637.94,6159.02,0.00
2024-12-10 17:38:38,52,5353,16,36,3706.72,6159.02,0.00
2024-12-10 17:38:38,52,5354,16,36,3702.30,6160.00,0.00
2024-12-10 17:38:38,53,5354,16,37,3632.45,6160.02,0.00
2024-12-10 17:38:38,52,5354,16,36,3701.12,6160.02,0.00
2024-12-10 17:38:38,51,5354,16,35,3747.13,6160.08,0.00
2024-12-10 17:38:38,51,5355,16,35,3763.43,6161.00,0.00
2024-12-10 17:38:38,52,5355,17,35,3691.05,6161.02,0.00
2024-12-10 17:38:38,51,5355,17,34,3734.45,6161.08,0.00
2024-12-10 17:38:38,51,5356,17,34,3750.75,6162.00,0.00
2024-12-10 17:38:38,52,5356,18,34,3678.62,6162.02,0.00
2024-12-10 17:38:38,52,5357,18,34,3673.35,6163.00,0.00
2024-12-10 17:38:38,53,5357,19,34,3604.04,6163.02,0.00
2024-12-10 17:38:38,52,5357,19,33,3646.10,6163.08,0.00
2024-12-10 17:38:39,52,5358,19,33,3660.91,6164.00,0.00
2024-12-10 17:38:39,53,5358,19,34,3591.83,6164.02,0.00
2024-12-10 17:38:39,52,5358,18,34,3556.91,6164.90,0.00
2024-12-10 17:38:39,52,5359,18,34,3669.60,6165.00,0.00
2024-12-10 17:38:39,53,5359,19,34,3600.37,6165.02,0.00
2024-12-10 17:38:39,52,5359,18,34,3657.75,6165.02,0.00
2024-12-10 17:38:39,52,5360,18,34,3690.18,6166.00,0.00
2024-12-10 17:38:39,53,5360,19,34,3620.56,6166.02,0.00
2024-12-10 17:38:39,53,5361,19,34,3603.05,6167.00,0.00
2024-12-10 17:38:39,54,5361,20,34,3536.33,6167.02,0.00
2024-12-10 17:38:39,53,5361,20,33,3591.44,6167.11,0.00
2024-12-10 17:38:39,53,5362,20,33,3603.33,6168.00,0.00
2024-12-10 17:38:39,54,5362,21,33,3536.60,6168.02,0.00
2024-12-10 17:38:39,53,5362,20,33,3571.90,6168.15,0.00
2024-12-10 17:38:39,53,5363,20,33,3598.57,6169.00,0.00
2024-12-10 17:38:39,54,5363,20,34,3531.93,6169.02,0.00
2024-12-10 17:38:39,54,5364,20,34,3515.21,6170.00,0.00
2024-12-10 17:38:39,55,5364,21,34,3451.30,6170.02,0.00
2024-12-10 17:38:39,54,5364,21,33,3506.10,6170.11,0.00
2024-12-10 17:38:39,53,5364,20,33,3485.88,6170.96,0.00
2024-12-10 17:38:39,53,5365,20,33,3600.01,6171.00,0.00
2024-12-10 17:38:39,54,5365,20,34,3533.34,6171.02,0.00
2024-12-10 17:38:39,53,5365,19,34,3532.43,6171.13,0.00
2024-12-10 17:38:39,52,5365,18,34,3599.08,6171.15,0.00
2024-12-10 17:38:39,52,5366,18,34,3666.09,6172.00,0.00
2024-12-10 17:38:39,53,5366,18,35,3596.92,6172.02,0.00
2024-12-10 17:38:39,53,5367,18,35,3583.53,6173.00,0.00
2024-12-10 17:38:39,54,5367,18,36,3517.17,6173.02,0.00
2024-12-10 17:38:39,53,5367,18,35,3576.56,6173.11,0.00
2024-12-10 17:38:39,52,5367,17,35,3589.38,6173.83,0.00
2024-12-10 17:38:39,52,5368,17,35,3697.56,6174.00,0.00
2024-12-10 17:38:39,53,5368,18,35,3627.79,6174.02,0.00
2024-12-10 17:38:39,52,5368,17,35,3671.44,6174.04,0.00
2024-12-10 17:38:39,52,5369,17,35,3704.44,6175.00,0.00
2024-12-10 17:38:39,53,5369,17,36,3634.55,6175.02,0.00
2024-12-10 17:38:39,52,5369,17,35,3691.38,6175.02,0.00
2024-12-10 17:38:39,51,5369,17,34,3751.77,6175.14,0.00
2024-12-10 17:38:39,51,5370,17,34,3766.66,6176.00,0.00
2024-12-10 17:38:39,52,5370,17,35,3694.22,6176.02,0.00
2024-12-10 17:38:39,53,5369,17,36,3594.26,6176.17,0.00
2024-12-10 17:38:39,53,5370,17,36,3669.69,6177.00,0.00
2024-12-10 17:38:39,54,5370,18,36,3601.74,6177.02,0.00
2024-12-10 17:38:39,53,5370,18,35,3663.88,6177.08,0.00
2024-12-10 17:38:39,53,5371,18,35,3789.15,6178.00,0.00
2024-12-10 17:38:39,54,5371,19,35,3718.98,6178.02,0.00
2024-12-10 17:38:39,54,5372,19,35,3708.91,6179.00,0.00
2024-12-10 17:38:39,55,5372,20,35,3641.48,6179.02,0.00
2024-12-10 17:38:39,54,5372,19,35,3620.99,6179.76,0.00
2024-12-10 17:38:39,54,5373,19,35,3720.74,6180.00,0.00
2024-12-10 17:38:39,55,5373,20,35,3653.09,6180.02,0.00
2024-12-10 17:38:39,54,5373,20,34,3716.17,6180.07,0.00
2024-12-10 17:38:39,54,5374,20,34,3723.70,6181.00,0.00
2024-12-10 17:38:39,55,5374,20,35,3656.00,6181.02,0.00
2024-12-10 17:38:39,55,5375,20,35,3642.55,6182.00,0.00
2024-12-10 17:38:39,56,5375,20,36,3577.51,6182.02,0.00
2024-12-10 17:38:39,55,5375,20,35,3616.71,6182.07,0.00
2024-12-10 17:38:39,55,5376,20,35,3620.68,6183.00,0.00
2024-12-10 17:38:39,56,5376,20,36,3556.02,6183.02,0.00
2024-12-10 17:38:39,56,5377,20,36,3568.09,6184.00,0.00
2024-12-10 17:38:39,57,5377,21,36,3505.49,6184.02,0.00
2024-12-10 17:38:39,56,5377,21,35,3566.98,6184.02,0.00
2024-12-10 17:38:39,56,5378,21,35,3576.66,6185.00,0.00
2024-12-10 17:38:39,57,5378,22,35,3513.91,6185.02,0.00
2024-12-10 17:38:39,57,5379,22,35,3510.08,6186.00,0.00
2024-12-10 17:38:39,58,5379,22,36,3449.57,6186.02,0.00
2024-12-10 17:38:39,58,5380,22,36,3427.87,6187.00,0.00
2024-12-10 17:38:39,59,5380,23,36,3369.77,6187.02,0.00
2024-12-10 17:38:39,58,5380,23,35,3415.07,6187.05,0.00
2024-12-10 17:38:39,58,5381,23,35,3418.40,6188.00,0.00
2024-12-10 17:38:39,59,5381,23,36,3360.46,6188.02,0.00
2024-12-10 17:38:39,58,5381,23,35,3362.19,6188.47,0.00
2024-12-10 17:38:39,57,5381,22,35,3375.41,6188.88,0.00
2024-12-10 17:38:39,57,5382,22,35,3476.47,6189.00,0.00
2024-12-10 17:38:39,58,5382,23,35,3416.53,6189.02,0.00
2024-12-10 17:38:39,58,5383,23,35,3408.42,6190.00,0.00
2024-12-10 17:38:39,59,5383,23,36,3350.65,6190.02,0.00
2024-12-10 17:38:39,60,5382,24,36,3294.80,6190.05,0.00
2024-12-10 17:38:39,59,5382,24,35,3412.59,6190.14,0.00
2024-12-10 17:38:39,59,5383,24,35,3422.21,6191.00,0.00
2024-12-10 17:38:39,60,5383,25,35,3365.17,6191.02,0.00
2024-12-10 17:38:39,60,5384,25,35,3481.33,6192.00,0.00
2024-12-10 17:38:39,61,5384,25,36,3424.26,6192.02,0.00
2024-12-10 17:38:39,61,5385,25,36,3431.22,6193.00,0.00
2024-12-10 17:38:39,62,5385,25,37,3375.88,6193.02,0.00
2024-12-10 17:38:39,62,5386,25,37,3373.16,6194.00,0.00
2024-12-10 17:38:39,63,5386,25,38,3319.62,6194.02,0.00
2024-12-10 17:38:39,62,5386,24,38,3311.52,6194.68,0.00
2024-12-10 17:38:39,62,5387,24,38,3355.99,6195.00,0.00
2024-12-10 17:38:39,63,5387,24,39,3302.72,6195.02,0.00
2024-12-10 17:38:39,62,5387,24,38,3340.00,6195.02,0.00
2024-12-10 17:38:39,61,5387,23,38,3297.24,6195.94,0.00
2024-12-10 17:38:39,61,5388,23,38,3394.80,6196.00,0.00
2024-12-10 17:38:39,62,5388,24,38,3340.04,6196.02,0.00
2024-12-10 17:38:39,61,5388,24,37,3385.66,6196.03,0.00
2024-12-10 17:38:39,61,5389,24,37,3387.22,6197.00,0.00
2024-12-10 17:38:39,62,5389,25,37,3332.59,6197.02,0.00
2024-12-10 17:38:40,62,5390,25,37,3315.12,6198.00,0.00
2024-12-10 17:38:40,63,5390,25,38,3262.50,6198.02,0.00
2024-12-10 17:38:40,62,5390,25,37,3304.13,6198.05,0.00
2024-12-10 17:38:40,62,5391,25,37,3305.65,6199.00,0.00
2024-12-10 17:38:40,63,5391,25,38,3253.18,6199.02,0.00
2024-12-10 17:38:40,62,5391,24,38,3274.70,6199.18,0.00
2024-12-10 17:38:40,62,5392,24,38,3287.10,6200.00,0.00
2024-12-10 17:38:40,63,5392,24,39,3234.92,6200.02,0.00
2024-12-10 17:38:40,62,5392,24,38,3277.10,6200.05,0.00
2024-12-10 17:38:40,61,5392,23,38,3253.16,6200.97,0.00
2024-12-10 17:38:40,61,5393,23,38,3352.80,6201.00,0.00
2024-12-10 17:38:40,62,5393,24,38,3298.72,6201.02,0.00
2024-12-10 17:38:40,62,5394,24,38,3279.57,6202.00,0.00
2024-12-10 17:38:40,63,5394,24,39,3227.51,6202.02,0.00
2024-12-10 17:38:40,62,5394,24,38,3269.57,6202.05,0.00
2024-12-10 17:38:40,61,5394,23,38,3286.04,6202.36,0.00
2024-12-10 17:38:40,61,5395,23,38,3343.99,6203.00,0.00
2024-12-10 17:38:40,62,5395,24,38,3290.05,6203.02,0.00
2024-12-10 17:38:40,62,5396,24,38,3263.01,6204.00,0.00
2024-12-10 17:38:40,63,5396,24,39,3211.21,6204.02,0.00
2024-12-10 17:38:40,62,5396,24,38,3254.00,6204.05,0.00
2024-12-10 17:38:40,62,5397,24,38,3242.49,6205.00,0.00
2024-12-10 17:38:40,63,5397,24,39,3191.02,6205.02,0.00
2024-12-10 17:38:40,62,5397,23,39,3216.60,6205.10,0.00
2024-12-10 17:38:40,61,5397,22,39,3266.30,6205.15,0.00
2024-12-10 17:38:40,61,5398,22,39,3262.02,6206.00,0.00
2024-12-10 17:38:40,62,5398,22,40,3209.41,6206.02,0.00
2024-12-10 17:38:40,61,5398,22,39,3259.99,6206.02,0.00
2024-12-10 17:38:40,60,5398,21,39,3298.86,6206.20,0.00
2024-12-10 17:38:40,59,5398,21,38,3320.28,6206.51,0.00
2024-12-10 17:38:40,59,5399,21,38,3395.31,6207.00,0.00
2024-12-10 17:38:40,60,5399,21,39,3338.72,6207.02,0.00
2024-12-10 17:38:40,59,5399,21,38,3389.00,6207.03,0.00
2024-12-10 17:38:40,58,5399,20,38,3441.04,6207.14,0.00
2024-12-10 17:38:40,57,5399,19,38,3469.64,6207.65,0.00
2024-12-10 17:38:40,56,5399,18,38,3491.84,6207.95,0.00
2024-12-10 17:38:40,56,5400,18,38,3599.41,6208.00,0.00
2024-12-10 17:38:40,57,5400,19,38,3536.26,6208.02,0.00
2024-12-10 17:38:40,56,5400,18,38,3506.99,6208.55,0.00
2024-12-10 17:38:40,56,5401,18,38,3590.48,6209.00,0.00
2024-12-10 17:38:40,57,5401,18,39,3527.48,6209.02,0.00
2024-12-10 17:38:40,56,5401,18,38,3584.93,6209.04,0.00
2024-12-10 17:38:40,56,5402,18,38,3592.16,6210.00,0.00
2024-12-10 17:38:40,57,5402,19,38,3529.14,6210.02,0.00
2024-12-10 17:38:40,56,5402,18,38,3484.91,6210.68,0.00
2024-12-10 17:38:40,56,5403,18,38,3576.10,6211.00,0.00
2024-12-10 17:38:40,57,5403,19,38,3513.37,6211.02,0.00
2024-12-10 17:38:40,56,5403,19,37,3570.56,6211.04,0.00
2024-12-10 17:38:40,56,5404,19,37,3577.79,6212.00,0.00
2024-12-10 17:38:40,57,5404,20,37,3515.02,6212.02,0.00
2024-12-10 17:38:40,57,5405,20,37,3498.15,6213.00,0.00
2024-12-10 17:38:40,58,5405,20,38,3437.83,6213.02,0.00
2024-12-10 17:38:40,57,5405,20,37,3491.61,6213.04,0.00
2024-12-10 17:38:40,57,5406,20,37,3497.62,6214.00,0.00
2024-12-10 17:38:40,58,5406,20,38,3437.32,6214.02,0.00
2024-12-10 17:38:40,57,5406,19,38,3440.93,6214.05,0.00
2024-12-10 17:38:40,57,5407,19,38,3491.64,6215.00,0.00
2024-12-10 17:38:40,58,5407,20,38,3431.44,6215.02,0.00
2024-12-10 17:38:40,57,5407,20,37,3481.83,6215.04,0.00
2024-12-10 17:38:40,57,5407,20,37,3487.84,6216.00,0.00
2024-12-10 17:38:40,58,5407,21,37,3427.71,6216.02,0.00
2024-12-10 17:38:40,58,5408,21,37,3411.31,6217.00,0.00
2024-12-10 17:38:40,59,5408,22,37,3353.49,6217.02,0.00
2024-12-10 17:38:40,58,5408,22,36,3400.59,6217.04,0.00
2024-12-10 17:38:40,58,5409,22,36,3405.43,6218.00,0.00
2024-12-10 17:38:40,59,5409,23,36,3347.71,6218.02,0.00
2024-12-10 17:38:40,58,5409,22,36,3375.45,6218.16,0.00
2024-12-10 17:38:40,58,5410,22,36,3430.64,6219.00,0.00
2024-12-10 17:38:40,59,5410,23,36,3372.49,6219.02,0.00
2024-12-10 17:38:40,58,5410,23,35,3412.42,6219.09,0.00
2024-12-10 17:38:40,58,5411,23,35,3420.46,6220.00,0.00
2024-12-10 17:38:40,59,5411,24,35,3362.49,6220.02,0.00
2024-12-10 17:38:40,58,5411,23,35,3389.37,6220.04,0.00
2024-12-10 17:38:40,58,5412,23,35,3415.65,6221.00,0.00
2024-12-10 17:38:40,59,5412,23,36,3357.76,6221.02,0.00
2024-12-10 17:38:40,58,5412,23,35,3396.36,6221.09,0.00
2024-12-10 17:38:40,58,5413,23,35,3404.40,6222.00,0.00
2024-12-10 17:38:40,59,5413,24,35,3346.70,6222.02,0.00
2024-12-10 17:38:40,58,5413,23,35,3318.80,6222.85,0.00
2024-12-10 17:38:40,58,5414,23,35,3416.54,6223.00,0.00
2024-12-10 17:38:40,59,5414,24,35,3358.64,6223.02,0.00
2024-12-10 17:38:40,58,5414,24,34,3398.32,6223.09,0.00
2024-12-10 17:38:40,58,5415,24,34,3406.36,6224.00,0.00
2024-12-10 17:38:40,59,5415,25,34,3348.63,6224.02,0.00
2024-12-10 17:38:40,58,5415,25,33,3405.29,6224.02,0.00
2024-12-10 17:38:40,57,5415,24,33,3395.18,6224.49,0.00
2024-12-10 17:38:40,57,5416,24,33,3473.08,6225.00,0.00
2024-12-10 17:38:40,58,5416,25,33,3413.20,6225.02,0.00
2024-12-10 17:38:40,58,5417,25,33,3395.49,6226.00,0.00
2024-12-10 17:38:40,59,5417,26,33,3337.94,6226.02,0.00
2024-12-10 17:38:40,58,5417,26,32,3380.50,6226.19,0.00
2024-12-10 17:38:40,58,5418,26,32,3394.67,6227.00,0.00
2024-12-10 17:38:40,59,5418,27,32,3337.14,6227.02,0.00
2024-12-10 17:38:40,58,5418,26,32,3386.12,6227.16,0.00
2024-12-10 17:38:40,58,5419,26,32,3391.53,6228.00,0.00
2024-12-10 17:38:41,59,5419,26,33,3334.05,6228.02,0.00
2024-12-10 17:38:41,58,5419,25,33,3386.13,6228.10,0.00
2024-12-10 17:38:41,57,5419,24,33,3442.27,6228.14,0.00
2024-12-10 17:38:41,57,5420,24,33,3432.60,6229.00,0.00
2024-12-10 17:38:41,58,5420,25,33,3373.42,6229.02,0.00
2024-12-10 17:38:41,57,5420,25,32,3420.62,6229.16,0.00
2024-12-10 17:38:41,57,5421,25,32,3434.24,6230.00,0.00
2024-12-10 17:38:41,58,5421,25,33,3375.03,6230.02,0.00
2024-12-10 17:38:41,58,5421,25,33,3365.37,6231.00,0.00
2024-12-10 17:38:41,59,5421,25,34,3308.33,6231.02,0.00
2024-12-10 17:38:41,58,5421,25,33,3336.91,6231.16,0.00
2024-12-10 17:38:41,58,5422,25,33,3346.27,6232.00,0.00
2024-12-10 17:38:41,59,5422,26,33,3289.55,6232.02,0.00
2024-12-10 17:38:41,58,5422,25,33,3247.83,6232.93,0.00
2024-12-10 17:38:41,58,5423,25,33,3349.91,6233.00,0.00
2024-12-10 17:38:41,59,5423,25,34,3293.13,6233.02,0.00
2024-12-10 17:38:41,58,5423,25,33,3318.77,6233.16,0.00
2024-12-10 17:38:41,58,5424,25,33,3329.53,6234.00,0.00
2024-12-10 17:38:41,59,5424,25,34,3273.09,6234.02,0.00
2024-12-10 17:38:41,59,5425,25,34,3267.56,6235.00,0.00
2024-12-10 17:38:41,60,5425,26,34,3213.10,6235.02,0.00
2024-12-10 17:38:41,59,5425,25,34,3217.59,6235.19,0.00
2024-12-10 17:38:41,59,5426,25,34,3273.03,6236.00,0.00
2024-12-10 17:38:41,60,5426,26,34,3218.48,6236.02,0.00
2024-12-10 17:38:41,59,5426,26,33,3261.29,6236.15,0.00
2024-12-10 17:38:41,59,5427,26,33,3272.36,6237.00,0.00
2024-12-10 17:38:41,60,5427,27,33,3217.82,6237.02,0.00
2024-12-10 17:38:41,59,5427,26,33,3248.68,6237.14,0.00
2024-12-10 17:38:41,59,5428,26,33,3279.13,6238.00,0.00
2024-12-10 17:38:41,60,5428,27,33,3224.48,6238.02,0.00
2024-12-10 17:38:41,59,5428,27,32,3248.75,6238.14,0.00
2024-12-10 17:38:41,59,5429,27,32,3256.86,6239.00,0.00
2024-12-10 17:38:41,60,5429,28,32,3202.58,6239.02,0.00
2024-12-10 17:38:41,60,5430,28,32,3186.17,6240.00,0.00
2024-12-10 17:38:41,61,5430,29,32,3133.94,6240.02,0.00
2024-12-10 17:38:41,60,5430,28,32,3175.67,6240.13,0.00
2024-12-10 17:38:41,59,5430,28,31,3214.47,6240.14,0.00
2024-12-10 17:38:41,59,5431,28,31,3220.93,6241.00,0.00
2024-12-10 17:38:41,60,5431,29,31,3167.25,6241.02,0.00
2024-12-10 17:38:41,59,5431,29,30,3214.12,6241.07,0.00
2024-12-10 17:38:41,58,5431,28,30,3199.83,6241.74,0.00
2024-12-10 17:38:41,58,5432,28,30,3287.34,6242.00,0.00
2024-12-10 17:38:41,59,5432,28,31,3231.63,6242.02,0.00
2024-12-10 17:38:41,58,5432,28,30,3258.30,6242.12,0.00
2024-12-10 17:38:41,57,5432,27,30,3293.11,6242.47,0.00
2024-12-10 17:38:41,57,5433,27,30,3319.64,6243.00,0.00
2024-12-10 17:38:41,58,5433,28,30,3262.40,6243.02,0.00
2024-12-10 17:38:41,57,5433,27,30,3273.28,6243.18,0.00
2024-12-10 17:38:41,57,5434,27,30,3325.91,6244.00,0.00
2024-12-10 17:38:41,58,5434,28,30,3268.57,6244.02,0.00
2024-12-10 17:38:41,57,5434,28,29,3317.15,6244.04,0.00
2024-12-10 17:38:41,56,5434,27,29,3344.14,6244.27,0.00
2024-12-10 17:38:41,56,5435,27,29,3405.70,6245.00,0.00
2024-12-10 17:38:41,57,5435,27,30,3345.95,6245.02,0.00
2024-12-10 17:38:41,56,5435,27,29,3378.94,6245.11,0.00
2024-12-10 17:38:41,56,5436,27,29,3388.64,6246.00,0.00
2024-12-10 17:38:41,57,5436,27,30,3329.19,6246.02,0.00
2024-12-10 17:38:41,57,5437,27,30,3323.63,6247.00,0.00
2024-12-10 17:38:41,58,5437,28,30,3266.33,6247.02,0.00
2024-12-10 17:38:41,57,5437,28,29,3295.15,6247.12,0.00
2024-12-10 17:38:41,56,5437,27,29,3296.68,6247.75,0.00
2024-12-10 17:38:41,56,5438,27,29,3392.81,6248.00,0.00
2024-12-10 17:38:41,57,5438,28,29,3333.29,6248.02,0.00
2024-12-10 17:38:41,56,5438,28,28,3391.70,6248.02,0.00
2024-12-10 17:38:41,56,5439,28,28,3387.82,6249.00,0.00
2024-12-10 17:38:41,57,5439,29,28,3328.38,6249.02,0.00
2024-12-10 17:38:41,56,5439,29,27,3359.93,6249.11,0.00
2024-12-10 17:38:41,56,5440,29,27,3371.62,6250.00,0.00
2024-12-10 17:38:41,57,5440,30,27,3312.47,6250.02,0.00
2024-12-10 17:38:41,56,5440,29,27,3291.44,6250.46,0.00
2024-12-10 17:38:41,56,5441,29,27,3369.92,6251.00,0.00
2024-12-10 17:38:41,57,5441,29,28,3310.80,6251.02,0.00
2024-12-10 17:38:41,56,5441,29,27,3342.03,6251.11,0.00
2024-12-10 17:38:41,56,5442,29,27,3353.72,6252.00,0.00
2024-12-10 17:38:41,57,5442,30,27,3294.88,6252.02,0.00
2024-12-10 17:38:41,56,5442,29,27,3352.60,6252.02,0.00
2024-12-10 17:38:41,57,5441,30,27,3266.37,6252.14,0.00
2024-12-10 17:38:41,57,5442,30,27,3355.25,6253.00,0.00
2024-12-10 17:38:41,58,5442,30,28,3297.40,6253.02,0.00
2024-12-10 17:38:41,57,5442,30,27,3328.93,6253.09,0.00
2024-12-10 17:38:41,56,5442,29,27,3335.59,6253.68,0.00
2024-12-10 17:38:41,56,5443,29,27,3539.06,6254.00,0.00
2024-12-10 17:38:41,57,5443,29,28,3476.97,6254.02,0.00
2024-12-10 17:38:41,57,5444,29,28,3494.84,6255.00,0.00
2024-12-10 17:38:41,58,5444,30,28,3434.58,6255.02,0.00
2024-12-10 17:38:41,58,5445,30,28,3445.94,6256.00,0.00
2024-12-10 17:38:41,59,5445,30,29,3387.54,6256.02,0.00
2024-12-10 17:38:41,59,5446,30,29,3388.38,6257.00,0.00
2024-12-10 17:38:41,60,5446,31,29,3331.91,6257.02,0.00
2024-12-10 17:38:41,60,5447,31,29,3315.43,6258.00,0.00
2024-12-10 17:38:41,61,5447,32,29,3261.08,6258.02,0.00
2024-12-10 17:38:41,60,5447,32,28,3295.62,6258.08,0.00
2024-12-10 17:38:41,59,5447,31,28,3315.17,6258.54,0.00
2024-12-10 17:38:41,59,5448,31,28,3350.50,6259.00,0.00
2024-12-10 17:38:41,60,5448,32,28,3294.66,6259.02,0.00
2024-12-10 17:38:41,59,5448,31,28,3264.11,6259.70,0.00
2024-12-10 17:38:41,59,5449,31,28,3351.34,6260.00,0.00
2024-12-10 17:38:41,60,5449,32,28,3295.49,6260.02,0.00
2024-12-10 17:38:41,59,5449,32,27,3350.28,6260.02,0.00
2024-12-10 17:38:41,58,5449,32,26,3386.46,6260.09,0.00
2024-12-10 17:38:42,58,5450,32,26,3385.08,6261.00,0.00
2024-12-10 17:38:42,59,5450,33,26,3327.71,6261.02,0.00
2024-12-10 17:38:42,58,5450,32,26,3382.52,6261.05,0.00
2024-12-10 17:38:42,58,5451,32,26,3367.06,6262.00,0.00
2024-12-10 17:38:42,59,5451,33,26,3309.99,6262.02,0.00
2024-12-10 17:38:42,58,5451,33,25,3345.47,6262.07,0.00
2024-12-10 17:38:42,57,5451,33,24,3395.94,6262.18,0.00
2024-12-10 17:38:42,56,5451,32,24,3447.04,6262.32,0.00
2024-12-10 17:38:42,56,5452,32,24,3472.09,6263.00,0.00
2024-12-10 17:38:42,57,5452,33,24,3411.17,6263.02,0.00
2024-12-10 17:38:42,56,5452,32,24,3470.97,6263.02,0.00
2024-12-10 17:38:42,56,5453,32,24,3462.75,6264.00,0.00
2024-12-10 17:38:42,57,5453,32,25,3402.00,6264.02,0.00
2024-12-10 17:38:42,56,5453,32,24,3461.63,6264.02,0.00
2024-12-10 17:38:42,55,5453,32,23,3505.22,6264.04,0.00
2024-12-10 17:38:42,55,5454,32,23,3513.29,6265.00,0.00
2024-12-10 17:38:42,56,5454,33,23,3450.55,6265.02,0.00
2024-12-10 17:38:42,55,5454,32,23,3438.79,6265.84,0.00
2024-12-10 17:38:42,55,5455,32,23,3503.32,6266.00,0.00
2024-12-10 17:38:42,56,5455,32,24,3440.76,6266.02,0.00
2024-12-10 17:38:42,55,5455,32,23,3485.09,6266.04,0.00
2024-12-10 17:38:42,55,5456,32,23,3493.62,6267.00,0.00
2024-12-10 17:38:42,56,5456,33,23,3431.23,6267.02,0.00
2024-12-10 17:38:42,55,5456,32,23,3452.60,6267.04,0.00
2024-12-10 17:38:42,55,5457,32,23,3483.92,6268.00,0.00
2024-12-10 17:38:42,56,5457,33,23,3421.71,6268.02,0.00
2024-12-10 17:38:42,55,5457,33,22,3465.69,6268.04,0.00
2024-12-10 17:38:42,55,5458,33,22,3472.43,6269.00,0.00
2024-12-10 17:38:42,56,5458,34,22,3410.42,6269.02,0.00
2024-12-10 17:38:42,55,5458,33,22,3422.35,6269.24,0.00
2024-12-10 17:38:42,55,5459,33,22,3487.46,6270.00,0.00
2024-12-10 17:38:42,56,5459,33,23,3425.18,6270.02,0.00
2024-12-10 17:38:42,55,5459,33,22,3469.22,6270.04,0.00
2024-12-10 17:38:42,55,5460,33,22,3477.50,6271.00,0.00
2024-12-10 17:38:42,56,5460,34,22,3415.40,6271.02,0.00
2024-12-10 17:38:42,55,5460,33,22,3450.15,6271.09,0.00
2024-12-10 17:38:42,55,5461,33,22,3467.80,6272.00,0.00
2024-12-10 17:38:42,56,5461,34,22,3405.88,6272.02,0.00
2024-12-10 17:38:42,55,5461,34,21,3450.70,6272.04,0.00
2024-12-10 17:38:42,54,5461,33,21,3512.29,6272.07,0.00
2024-12-10 17:38:42,54,5462,33,21,3524.45,6273.00,0.00
2024-12-10 17:38:42,55,5462,34,21,3460.37,6273.02,0.00
2024-12-10 17:38:42,55,5463,34,21,3448.77,6274.00,0.00
2024-12-10 17:38:42,56,5463,34,22,3387.18,6274.02,0.00
2024-12-10 17:38:42,55,5463,34,21,3431.66,6274.04,0.00
2024-12-10 17:38:42,55,5464,34,21,3439.02,6275.00,0.00
2024-12-10 17:38:42,56,5464,35,21,3377.61,6275.02,0.00
2024-12-10 17:38:42,55,5464,34,21,3336.20,6275.91,0.00
2024-12-10 17:38:42,55,5465,34,21,3444.66,6276.00,0.00
2024-12-10 17:38:42,56,5465,35,21,3383.15,6276.02,0.00
2024-12-10 17:38:42,55,5465,35,20,3427.55,6276.04,0.00
2024-12-10 17:38:42,55,5466,35,20,3434.35,6277.00,0.00
2024-12-10 17:38:42,56,5466,35,21,3373.02,6277.02,0.00
2024-12-10 17:38:42,56,5467,35,21,3360.87,6278.00,0.00
2024-12-10 17:38:42,57,5467,36,21,3301.91,6278.02,0.00
2024-12-10 17:38:42,56,5467,36,20,3341.82,6278.04,0.00
2024-12-10 17:38:42,56,5468,36,20,3344.51,6279.00,0.00
2024-12-10 17:38:42,57,5468,36,21,3285.84,6279.02,0.00
2024-12-10 17:38:42,57,5469,36,21,3273.74,6280.00,0.00
2024-12-10 17:38:42,58,5469,36,22,3217.30,6280.02,0.00
2024-12-10 17:38:42,57,5469,36,21,3256.12,6280.04,0.00
2024-12-10 17:38:42,57,5470,36,21,3259.97,6281.00,0.00
2024-12-10 17:38:42,58,5470,37,21,3203.76,6281.02,0.00
2024-12-10 17:38:42,57,5470,36,21,3164.29,6281.68,0.00
2024-12-10 17:38:42,57,5471,36,21,3254.87,6282.00,0.00
2024-12-10 17:38:42,58,5471,36,22,3198.75,6282.02,0.00
2024-12-10 17:38:42,57,5471,36,21,3228.44,6282.09,0.00
2024-12-10 17:38:42,57,5472,36,21,3237.75,6283.00,0.00
2024-12-10 17:38:42,58,5472,36,22,3181.93,6283.02,0.00
2024-12-10 17:38:42,57,5472,35,22,3233.36,6283.09,0.00
2024-12-10 17:38:42,56,5472,34,22,3218.29,6283.46,0.00
2024-12-10 17:38:42,56,5473,34,22,3297.18,6284.00,0.00
2024-12-10 17:38:42,57,5473,35,22,3239.33,6284.02,0.00
2024-12-10 17:38:42,57,5474,35,22,3222.75,6285.00,0.00
2024-12-10 17:38:42,58,5474,36,22,3167.19,6285.02,0.00
2024-12-10 17:38:42,57,5474,36,21,3210.66,6285.14,0.00
2024-12-10 17:38:42,56,5474,35,21,3252.21,6285.39,0.00
2024-12-10 17:38:42,56,5475,35,21,3281.77,6286.00,0.00
2024-12-10 17:38:42,57,5475,35,22,3224.20,6286.02,0.00
2024-12-10 17:38:42,56,5475,35,21,3266.21,6286.14,0.00
2024-12-10 17:38:42,56,5476,35,21,3280.17,6287.00,0.00
2024-12-10 17:38:42,57,5476,36,21,3222.62,6287.02,0.00
2024-12-10 17:38:42,56,5476,35,21,3274.88,6287.09,0.00
2024-12-10 17:38:42,57,5475,35,22,3173.46,6287.47,0.00
2024-12-10 17:38:42,57,5476,35,22,3260.22,6288.00,0.00
2024-12-10 17:38:42,58,5476,35,23,3204.01,6288.02,0.00
2024-12-10 17:38:42,58,5477,35,23,3295.53,6289.00,0.00
2024-12-10 17:38:42,59,5477,35,24,3239.67,6289.02,0.00
2024-12-10 17:38:42,58,5477,35,23,3285.80,6289.12,0.00
2024-12-10 17:38:42,58,5478,35,23,3296.05,6290.00,0.00
2024-12-10 17:38:42,59,5478,35,24,3240.19,6290.02,0.00
2024-12-10 17:38:42,60,5477,36,24,3137.10,6290.50,0.00
2024-12-10 17:38:42,60,5478,36,24,3216.82,6291.00,0.00
2024-12-10 17:38:42,61,5478,36,25,3164.08,6291.02,0.00
2024-12-10 17:38:42,60,5478,35,25,3112.67,6291.87,0.00
2024-12-10 17:38:42,60,5479,35,25,3314.08,6292.00,0.00
2024-12-10 17:38:42,61,5479,35,26,3259.76,6292.02,0.00
2024-12-10 17:38:42,60,5479,35,25,3305.72,6292.12,0.00
2024-12-10 17:38:42,59,5479,34,25,3295.05,6292.90,0.00
2024-12-10 17:38:42,59,5480,34,25,3395.40,6293.00,0.00
2024-12-10 17:38:42,60,5480,35,25,3338.81,6293.02,0.00
2024-12-10 17:38:43,60,5481,35,25,3332.86,6294.00,0.00
2024-12-10 17:38:43,61,5481,35,26,3278.23,6294.02,0.00
2024-12-10 17:38:43,60,5481,35,25,3331.81,6294.02,0.00
2024-12-10 17:38:43,59,5481,35,24,3360.57,6294.10,0.00
2024-12-10 17:38:43,59,5482,35,24,3368.78,6295.00,0.00
2024-12-10 17:38:43,60,5482,35,25,3312.63,6295.02,0.00
2024-12-10 17:38:43,60,5483,35,25,3311.04,6296.00,0.00
2024-12-10 17:38:43,61,5483,35,26,3256.77,6296.02,0.00
2024-12-10 17:38:43,60,5483,34,26,3298.49,6296.08,0.00
2024-12-10 17:38:43,59,5483,33,26,3310.61,6296.44,0.00
2024-12-10 17:38:43,58,5483,32,26,3360.59,6296.55,0.00
2024-12-10 17:38:43,58,5484,32,26,3440.45,6297.00,0.00
2024-12-10 17:38:43,59,5484,32,27,3382.14,6297.02,0.00
2024-12-10 17:38:43,58,5484,32,26,3424.20,6297.17,0.00
2024-12-10 17:38:43,58,5485,32,26,3435.38,6298.00,0.00
2024-12-10 17:38:43,59,5485,33,26,3377.15,6298.02,0.00
2024-12-10 17:38:43,58,5485,32,26,3429.97,6298.10,0.00
2024-12-10 17:38:43,58,5486,32,26,3432.24,6299.00,0.00
2024-12-10 17:38:43,59,5486,32,27,3374.07,6299.02,0.00
2024-12-10 17:38:43,59,5487,32,27,3354.58,6300.00,0.00
2024-12-10 17:38:43,60,5487,32,28,3298.68,6300.02,0.00
2024-12-10 17:38:43,59,5487,31,28,3347.77,6300.12,0.00
2024-12-10 17:38:43,58,5487,31,27,3395.72,6300.17,0.00
2024-12-10 17:38:43,58,5487,31,27,3404.30,6301.00,0.00
2024-12-10 17:38:43,59,5487,32,27,3346.60,6301.02,0.00
2024-12-10 17:38:43,58,5487,31,27,3316.25,6301.72,0.00
2024-12-10 17:38:43,58,5488,31,27,3401.87,6302.00,0.00
2024-12-10 17:38:43,59,5488,32,27,3344.21,6302.02,0.00
2024-12-10 17:38:43,59,5489,32,27,3321.35,6303.00,0.00
2024-12-10 17:38:43,60,5489,32,28,3265.99,6303.02,0.00
2024-12-10 17:38:43,59,5489,32,27,3307.49,6303.17,0.00
2024-12-10 17:38:43,58,5489,31,27,3338.67,6303.57,0.00
2024-12-10 17:38:43,58,5490,31,27,3371.01,6304.00,0.00
2024-12-10 17:38:43,59,5490,31,28,3313.87,6304.02,0.00
2024-12-10 17:38:43,58,5490,30,28,3363.42,6304.14,0.00
2024-12-10 17:38:43,58,5491,30,28,3366.29,6305.00,0.00
2024-12-10 17:38:43,59,5491,30,29,3309.24,6305.02,0.00
2024-12-10 17:38:43,59,5492,30,29,3290.26,6306.00,0.00
2024-12-10 17:38:43,60,5492,31,29,3235.43,6306.02,0.00
2024-12-10 17:38:43,59,5492,31,28,3273.20,6306.19,0.00
2024-12-10 17:38:43,58,5492,30,28,3292.97,6306.55,0.00
2024-12-10 17:38:43,58,5493,30,28,3372.92,6307.00,0.00
2024-12-10 17:38:43,59,5493,30,29,3315.75,6307.02,0.00
2024-12-10 17:38:43,59,5494,30,29,3328.69,6308.00,0.00
2024-12-10 17:38:43,60,5494,30,30,3273.21,6308.02,0.00
2024-12-10 17:38:43,59,5494,29,30,3319.09,6308.15,0.00
2024-12-10 17:38:43,59,5495,29,30,3351.67,6309.00,0.00
2024-12-10 17:38:43,60,5495,30,30,3295.81,6309.02,0.00
2024-12-10 17:38:43,59,5495,29,30,3301.93,6309.36,0.00
2024-12-10 17:38:43,59,5496,29,30,3368.67,6310.00,0.00
2024-12-10 17:38:43,60,5496,29,31,3312.52,6310.02,0.00
2024-12-10 17:38:43,61,5495,29,32,3184.15,6310.90,0.00
2024-12-10 17:38:43,61,5496,29,32,3248.70,6311.00,0.00
2024-12-10 17:38:43,62,5496,29,33,3196.30,6311.02,0.00
2024-12-10 17:38:43,61,5496,29,32,3232.19,6311.21,0.00
2024-12-10 17:38:43,61,5497,29,32,3348.55,6312.00,0.00
2024-12-10 17:38:43,62,5497,29,33,3294.54,6312.02,0.00
2024-12-10 17:38:43,61,5497,28,33,3284.49,6312.38,0.00
2024-12-10 17:38:43,61,5498,28,33,3349.08,6313.00,0.00
2024-12-10 17:38:43,62,5498,28,34,3295.07,6313.02,0.00
2024-12-10 17:38:43,62,5499,28,34,3275.16,6314.00,0.00
2024-12-10 17:38:43,63,5499,28,35,3223.17,6314.02,0.00
2024-12-10 17:38:43,62,5499,28,34,3259.91,6314.21,0.00
2024-12-10 17:38:43,61,5499,27,34,3281.82,6314.36,0.00
2024-12-10 17:38:43,61,5500,27,34,3341.36,6315.00,0.00
2024-12-10 17:38:43,62,5500,28,34,3287.47,6315.02,0.00
2024-12-10 17:38:43,61,5500,27,34,3340.33,6315.02,0.00
2024-12-10 17:38:43,60,5500,26,34,3365.35,6315.25,0.00
2024-12-10 17:38:43,60,5501,26,34,3400.74,6316.00,0.00
2024-12-10 17:38:43,61,5501,27,34,3344.99,6316.02,0.00
2024-12-10 17:38:43,61,5502,27,34,3328.18,6317.00,0.00
2024-12-10 17:38:43,62,5502,27,35,3274.50,6317.02,0.00
2024-12-10 17:38:43,61,5502,26,35,3327.14,6317.02,0.00
2024-12-10 17:38:43,60,5502,25,35,3378.02,6317.08,0.00
2024-12-10 17:38:43,59,5502,24,35,3428.87,6317.17,0.00
2024-12-10 17:38:43,58,5502,24,34,3476.03,6317.22,0.00
2024-12-10 17:38:43,58,5503,24,34,3491.57,6318.00,0.00
2024-12-10 17:38:43,59,5503,24,35,3432.39,6318.02,0.00
2024-12-10 17:38:43,58,5503,23,35,3490.62,6318.02,0.00
2024-12-10 17:38:43,58,5504,23,35,3489.85,6319.00,0.00
2024-12-10 17:38:43,59,5504,24,35,3430.70,6319.02,0.00
2024-12-10 17:38:43,59,5505,24,35,3415.35,6320.00,0.00
2024-12-10 17:38:43,60,5505,25,35,3358.43,6320.02,0.00
2024-12-10 17:38:43,59,5505,24,35,3405.74,6320.17,0.00
2024-12-10 17:38:43,58,5505,24,34,3455.74,6320.19,0.00
2024-12-10 17:38:43,58,5506,24,34,3470.36,6321.00,0.00
2024-12-10 17:38:43,59,5506,25,34,3411.54,6321.02,0.00
2024-12-10 17:38:43,58,5506,24,34,3466.50,6321.07,0.00
2024-12-10 17:38:43,57,5506,23,34,3512.93,6321.18,0.00
2024-12-10 17:38:43,56,5506,22,34,3526.30,6321.59,0.00
2024-12-10 17:38:43,56,5507,22,34,3613.24,6322.00,0.00
2024-12-10 17:38:43,57,5507,23,34,3549.85,6322.02,0.00
2024-12-10 17:38:43,57,5508,23,34,3534.83,6323.00,0.00
2024-12-10 17:38:43,58,5508,23,35,3473.88,6323.02,0.00
2024-12-10 17:38:43,57,5508,23,34,3516.00,6323.18,0.00
2024-12-10 17:38:43,57,5509,23,34,3530.95,6324.00,0.00
2024-12-10 17:38:43,58,5509,23,35,3470.07,6324.02,0.00
2024-12-10 17:38:43,57,5509,22,35,3509.89,6324.18,0.00
2024-12-10 17:38:43,57,5510,22,35,3547.04,6325.00,0.00
2024-12-10 17:38:43,58,5510,22,36,3485.89,6325.02,0.00
2024-12-10 17:38:43,57,5510,21,36,3545.93,6325.02,0.00
2024-12-10 17:38:43,56,5510,20,36,3604.94,6325.07,0.00
2024-12-10 17:38:43,55,5510,19,36,3652.11,6325.16,0.00
2024-12-10 17:38:43,55,5511,19,36,3691.76,6326.00,0.00
2024-12-10 17:38:43,56,5511,20,36,3625.83,6326.02,0.00
2024-12-10 17:38:43,55,5511,20,35,3668.79,6326.16,0.00
2024-12-10 17:38:44,55,5512,20,35,3685.44,6327.00,0.00
2024-12-10 17:38:44,56,5512,20,36,3619.63,6327.02,0.00
2024-12-10 17:38:44,55,5512,19,36,3678.37,6327.13,0.00
2024-12-10 17:38:44,55,5513,19,36,3688.76,6328.00,0.00
2024-12-10 17:38:44,56,5513,19,37,3622.88,6328.02,0.00
2024-12-10 17:38:44,55,5513,18,37,3572.07,6328.89,0.00
2024-12-10 17:38:44,55,5514,18,37,3680.32,6329.00,0.00
2024-12-10 17:38:44,56,5514,19,37,3614.60,6329.02,0.00
2024-12-10 17:38:44,55,5514,19,36,3659.10,6329.15,0.00
2024-12-10 17:38:44,55,5515,19,36,3674.61,6330.00,0.00
2024-12-10 17:38:44,56,5515,19,37,3608.99,6330.02,0.00
2024-12-10 17:38:44,55,5515,18,37,3628.37,6330.16,0.00
2024-12-10 17:38:44,55,5516,18,37,3690.21,6331.00,0.00
2024-12-10 17:38:44,56,5516,19,37,3624.31,6331.02,0.00
2024-12-10 17:38:44,56,5517,19,37,3607.28,6332.00,0.00
2024-12-10 17:38:44,57,5517,19,38,3543.99,6332.02,0.00
2024-12-10 17:38:44,56,5517,19,37,3584.67,6332.09,0.00
2024-12-10 17:38:44,55,5517,18,37,3614.56,6332.60,0.00
2024-12-10 17:38:44,55,5518,18,37,3704.67,6333.00,0.00
2024-12-10 17:38:44,56,5518,18,38,3638.51,6333.02,0.00
2024-12-10 17:38:44,55,5518,17,38,3700.20,6333.07,0.00
2024-12-10 17:38:44,54,5518,17,37,3757.01,6333.11,0.00
2024-12-10 17:38:44,54,5519,17,37,3766.94,6334.00,0.00
2024-12-10 17:38:44,55,5519,17,38,3698.45,6334.02,0.00
2024-12-10 17:38:44,54,5519,16,38,3680.83,6334.80,0.00
2024-12-10 17:38:44,54,5520,16,38,3785.40,6335.00,0.00
2024-12-10 17:38:44,55,5520,16,39,3716.57,6335.02,0.00
2024-12-10 17:38:44,55,5521,16,39,3696.84,6336.00,0.00
2024-12-10 17:38:44,56,5521,17,39,3630.83,6336.02,0.00
2024-12-10 17:38:44,55,5521,16,39,3695.69,6336.02,0.00
2024-12-10 17:38:44,54,5521,16,38,3751.24,6336.09,0.00
2024-12-10 17:38:44,53,5521,15,38,3755.67,6336.83,0.00
2024-12-10 17:38:44,53,5522,15,38,3864.61,6337.00,0.00
2024-12-10 17:38:44,54,5522,16,38,3793.05,6337.02,0.00
2024-12-10 17:38:44,53,5522,16,37,3830.01,6337.17,0.00
2024-12-10 17:38:44,52,5522,15,37,3857.48,6337.40,0.00
2024-12-10 17:38:44,52,5523,15,37,3942.02,6338.00,0.00
2024-12-10 17:38:44,53,5523,16,37,3867.64,6338.02,0.00
2024-12-10 17:38:44,52,5523,15,37,3940.80,6338.02,0.00
2024-12-10 17:38:44,52,5524,15,37,3928.01,6339.00,0.00
2024-12-10 17:38:44,53,5524,16,37,3853.90,6339.02,0.00
2024-12-10 17:38:44,52,5524,16,36,3918.28,6339.08,0.00
2024-12-10 17:38:44,52,5525,16,36,3933.51,6340.00,0.00
2024-12-10 17:38:44,53,5525,16,37,3859.29,6340.02,0.00
2024-12-10 17:38:44,52,5525,15,37,3828.02,6340.96,0.00
2024-12-10 17:38:44,52,5526,15,37,3947.54,6341.00,0.00
2024-12-10 17:38:44,53,5526,15,38,3873.06,6341.02,0.00
2024-12-10 17:38:44,53,5527,15,38,3859.31,6342.00,0.00
2024-12-10 17:38:44,54,5527,15,39,3787.84,6342.02,0.00
2024-12-10 17:38:44,53,5527,15,38,3849.75,6342.08,0.00
2024-12-10 17:38:44,53,5528,15,38,3863.51,6343.00,0.00
2024-12-10 17:38:44,54,5528,15,39,3791.96,6343.02,0.00
2024-12-10 17:38:44,54,5529,15,39,3787.46,6344.00,0.00
2024-12-10 17:38:44,55,5529,16,39,3718.60,6344.02,0.00
2024-12-10 17:38:44,54,5529,15,39,3727.03,6344.57,0.00
2024-12-10 17:38:44,54,5530,15,39,3817.83,6345.00,0.00
2024-12-10 17:38:44,55,5530,15,40,3748.42,6345.02,0.00
2024-12-10 17:38:44,54,5530,15,39,3810.80,6345.07,0.00
2024-12-10 17:38:44,55,5529,16,39,3709.47,6345.62,0.00
2024-12-10 17:38:44,55,5530,16,39,3829.78,6346.00,0.00
2024-12-10 17:38:44,56,5530,16,40,3761.39,6346.02,0.00
2024-12-10 17:38:44,55,5530,15,40,3736.83,6346.87,0.00
2024-12-10 17:38:44,55,5531,15,40,3959.63,6347.00,0.00
2024-12-10 17:38:44,56,5531,15,41,3888.92,6347.02,0.00
2024-12-10 17:38:44,55,5531,15,40,3932.09,6347.07,0.00
2024-12-10 17:38:44,55,5532,15,40,3943.08,6348.00,0.00
2024-12-10 17:38:44,56,5532,16,40,3872.67,6348.02,0.00
2024-12-10 17:38:44,56,5533,16,40,3863.58,6349.00,0.00
2024-12-10 17:38:44,57,5533,17,40,3795.79,6349.02,0.00
2024-12-10 17:38:44,56,5533,16,40,3862.44,6349.02,0.00
2024-12-10 17:38:44,56,5534,16,40,3846.04,6350.00,0.00
2024-12-10 17:38:44,57,5534,17,40,3778.57,6350.02,0.00
2024-12-10 17:38:44,56,5534,17,39,3842.65,6350.05,0.00
2024-12-10 17:38:44,56,5535,17,39,3851.18,6351.00,0.00
2024-12-10 17:38:44,57,5535,18,39,3783.62,6351.02,0.00
2024-12-10 17:38:44,56,5535,17,39,3763.79,6351.79,0.00
2024-12-10 17:38:44,56,5536,17,39,3863.77,6352.00,0.00
2024-12-10 17:38:44,57,5536,18,39,3795.98,6352.02,0.00
2024-12-10 17:38:44,58,5535,19,39,3729.45,6352.07,0.00
2024-12-10 17:38:44,57,5535,19,38,3859.90,6352.09,0.00
2024-12-10 17:38:44,57,5536,19,38,3869.39,6353.00,0.00
2024-12-10 17:38:44,58,5536,19,39,3802.68,6353.02,0.00
2024-12-10 17:38:44,58,5537,19,39,3928.64,6354.00,0.00
2024-12-10 17:38:44,59,5537,20,39,3862.05,6354.02,0.00
2024-12-10 17:38:44,58,5537,19,39,3902.14,6354.09,0.00
2024-12-10 17:38:44,58,5538,19,39,3939.07,6355.00,0.00
2024-12-10 17:38:44,59,5538,20,39,3872.31,6355.02,0.00
2024-12-10 17:38:44,59,5539,20,39,3868.00,6356.00,0.00
2024-12-10 17:38:44,60,5539,21,39,3803.54,6356.02,0.00
2024-12-10 17:38:44,60,5540,21,39,3779.46,6357.00,0.00
2024-12-10 17:38:44,61,5540,21,40,3717.50,6357.02,0.00
2024-12-10 17:38:44,60,5540,21,39,3761.45,6357.03,0.00
2024-12-10 17:38:44,60,5541,21,39,3760.30,6358.00,0.00
2024-12-10 17:38:44,61,5541,22,39,3698.66,6358.02,0.00
2024-12-10 17:38:44,62,5540,22,40,3611.35,6358.16,0.00
2024-12-10 17:38:44,62,5541,22,40,3709.83,6359.00,0.00
2024-12-10 17:38:44,63,5541,23,40,3650.94,6359.02,0.00
2024-12-10 17:38:44,62,5541,23,39,3693.43,6359.05,0.00
2024-12-10 17:38:44,62,5542,23,39,3796.77,6360.00,0.00
2024-12-10 17:38:44,63,5542,24,39,3736.50,6360.02,0.00
2024-12-10 17:38:45,63,5543,24,39,3717.04,6361.00,0.00
2024-12-10 17:38:45,64,5543,24,40,3658.96,6361.02,0.00
2024-12-10 17:38:45,63,5543,24,39,3698.88,6361.06,0.00
2024-12-10 17:38:45,63,5544,24,39,3700.28,6362.00,0.00
2024-12-10 17:38:45,64,5544,25,39,3642.47,6362.02,0.00
2024-12-10 17:38:45,64,5545,25,39,3617.71,6363.00,0.00
2024-12-10 17:38:45,65,5545,26,39,3562.05,6363.02,0.00
2024-12-10 17:38:45,64,5545,26,38,3600.82,6363.06,0.00
2024-12-10 17:38:45,63,5545,25,38,3649.83,6363.11,0.00
2024-12-10 17:38:45,63,5546,25,38,3654.40,6364.00,0.00
2024-12-10 17:38:45,64,5546,26,38,3597.30,6364.02,0.00
2024-12-10 17:38:45,64,5547,26,38,3570.29,6365.00,0.00
2024-12-10 17:38:45,65,5547,26,39,3515.36,6365.02,0.00
2024-12-10 17:38:45,64,5547,26,38,3554.39,6365.06,0.00
2024-12-10 17:38:45,64,5548,26,38,3548.36,6366.00,0.00
2024-12-10 17:38:45,65,5548,26,39,3493.77,6366.02,0.00
2024-12-10 17:38:45,64,5548,25,39,3518.77,6366.14,0.00
2024-12-10 17:38:45,64,5549,25,39,3550.26,6367.00,0.00
2024-12-10 17:38:45,65,5549,25,40,3495.64,6367.02,0.00
2024-12-10 17:38:45,65,5550,25,40,3482.06,6368.00,0.00
2024-12-10 17:38:45,66,5550,26,40,3429.30,6368.02,0.00
2024-12-10 17:38:45,65,5550,25,40,3378.74,6368.92,0.00
2024-12-10 17:38:45,65,5551,25,40,3471.88,6369.00,0.00
2024-12-10 17:38:45,66,5551,26,40,3419.27,6369.02,0.00
2024-12-10 17:38:45,65,5551,26,39,3460.03,6369.06,0.00
2024-12-10 17:38:45,65,5552,26,39,3453.60,6370.00,0.00
2024-12-10 17:38:45,66,5552,26,40,3401.27,6370.02,0.00
2024-12-10 17:38:45,65,5552,25,40,3391.52,6370.66,0.00
2024-12-10 17:38:45,65,5553,25,40,3424.99,6371.00,0.00
2024-12-10 17:38:45,66,5553,26,40,3373.10,6371.02,0.00
2024-12-10 17:38:45,65,5553,26,39,3417.03,6371.06,0.00
2024-12-10 17:38:45,64,5553,25,39,3411.11,6371.81,0.00
2024-12-10 17:38:45,64,5554,25,39,3498.01,6372.00,0.00
2024-12-10 17:38:45,65,5554,26,39,3444.19,6372.02,0.00
2024-12-10 17:38:45,65,5555,26,39,3427.75,6373.00,0.00
2024-12-10 17:38:45,66,5555,26,40,3375.82,6373.02,0.00
2024-12-10 17:38:45,65,5555,26,39,3407.17,6373.06,0.00
2024-12-10 17:38:45,66,5554,26,40,3344.02,6373.27,0.00
2024-12-10 17:38:45,66,5555,26,40,3413.23,6374.00,0.00
2024-12-10 17:38:45,67,5555,27,40,3362.28,6374.02,0.00
2024-12-10 17:38:45,67,5556,27,40,3436.50,6375.00,0.00
2024-12-10 17:38:45,68,5556,27,41,3385.97,6375.02,0.00
2024-12-10 17:38:45,67,5556,27,40,3424.14,6375.06,0.00
2024-12-10 17:38:45,66,5556,26,40,3435.92,6375.38,0.00
2024-12-10 17:38:45,66,5557,26,40,3492.75,6376.00,0.00
2024-12-10 17:38:45,67,5557,26,41,3440.62,6376.02,0.00
2024-12-10 17:38:45,67,5558,26,41,3414.37,6377.00,0.00
2024-12-10 17:38:45,68,5558,26,42,3364.16,6377.02,0.00
2024-12-10 17:38:45,67,5558,26,41,3402.95,6377.06,0.00
2024-12-10 17:38:45,67,5559,26,41,3399.97,6378.00,0.00
2024-12-10 17:38:45,68,5559,27,41,3349.97,6378.02,0.00
2024-12-10 17:38:45,67,5559,26,41,3338.98,6378.22,0.00
2024-12-10 17:38:45,67,5560,26,41,3384.73,6379.00,0.00
2024-12-10 17:38:45,68,5560,27,41,3334.96,6379.02,0.00
2024-12-10 17:38:45,67,5560,27,40,3373.31,6379.06,0.00
2024-12-10 17:38:45,67,5561,27,40,3370.60,6380.00,0.00
2024-12-10 17:38:45,68,5561,28,40,3321.03,6380.02,0.00
2024-12-10 17:38:45,67,5561,27,40,3299.36,6380.46,0.00
2024-12-10 17:38:45,67,5562,27,40,3360.27,6381.00,0.00
2024-12-10 17:38:45,68,5562,27,41,3310.85,6381.02,0.00
2024-12-10 17:38:45,67,5562,27,40,3349.80,6381.06,0.00
2024-12-10 17:38:45,66,5562,26,40,3394.40,6381.15,0.00
2024-12-10 17:38:45,66,5563,26,40,3398.57,6382.00,0.00
2024-12-10 17:38:45,67,5563,27,40,3347.84,6382.02,0.00
2024-12-10 17:38:45,66,5563,26,40,3335.76,6382.68,0.00
2024-12-10 17:38:45,66,5564,26,40,3376.47,6383.00,0.00
2024-12-10 17:38:45,67,5564,27,40,3326.08,6383.02,0.00
2024-12-10 17:38:45,66,5564,27,39,3365.84,6383.06,0.00
2024-12-10 17:38:45,65,5564,26,39,3410.39,6383.17,0.00
2024-12-10 17:38:45,65,5565,26,39,3416.03,6384.00,0.00
2024-12-10 17:38:45,66,5565,26,40,3364.27,6384.02,0.00
2024-12-10 17:38:45,65,5565,25,40,3327.71,6384.52,0.00
2024-12-10 17:38:45,65,5566,25,40,3395.35,6385.00,0.00
2024-12-10 17:38:45,66,5566,26,40,3343.91,6385.02,0.00
2024-12-10 17:38:45,65,5566,26,39,3386.51,6385.06,0.00
2024-12-10 17:38:45,64,5566,25,39,3384.76,6385.50,0.00
2024-12-10 17:38:45,64,5567,25,39,3452.94,6386.00,0.00
2024-12-10 17:38:45,65,5567,25,40,3399.81,6386.02,0.00
2024-12-10 17:38:45,65,5568,25,40,3376.59,6387.00,0.00
2024-12-10 17:38:45,66,5568,25,41,3325.43,6387.02,0.00
2024-12-10 17:38:45,65,5568,25,40,3368.73,6387.06,0.00
2024-12-10 17:38:45,64,5568,24,40,3348.57,6387.94,0.00
2024-12-10 17:38:45,64,5569,24,40,3444.43,6388.00,0.00
2024-12-10 17:38:45,65,5569,25,40,3391.44,6388.02,0.00
2024-12-10 17:38:45,64,5569,24,40,3362.11,6388.81,0.00
2024-12-10 17:38:45,64,5570,24,40,3450.10,6389.00,0.00
2024-12-10 17:38:45,65,5570,25,40,3397.03,6389.02,0.00
2024-12-10 17:38:45,64,5570,25,39,3441.12,6389.08,0.00
2024-12-10 17:38:45,64,5571,25,39,3438.23,6390.00,0.00
2024-12-10 17:38:45,65,5571,26,39,3385.34,6390.02,0.00
2024-12-10 17:38:45,64,5571,25,39,3437.24,6390.02,0.00
2024-12-10 17:38:45,63,5571,24,39,3490.78,6390.02,0.00
2024-12-10 17:38:45,62,5571,23,39,3516.21,6390.18,0.00
2024-12-10 17:38:45,62,5572,23,39,3521.88,6391.00,0.00
2024-12-10 17:38:45,63,5572,23,40,3465.98,6391.02,0.00
2024-12-10 17:38:45,62,5572,23,39,3515.70,6391.05,0.00
2024-12-10 17:38:45,62,5573,23,39,3513.99,6392.00,0.00
2024-12-10 17:38:45,63,5573,23,40,3458.22,6392.02,0.00
2024-12-10 17:38:46,63,5574,23,40,3434.46,6393.00,0.00
2024-12-10 17:38:46,64,5574,24,40,3380.80,6393.02,0.00
2024-12-10 17:38:46,63,5574,24,39,3427.36,6393.05,0.00
2024-12-10 17:38:46,62,5574,23,39,3457.28,6393.44,0.00
2024-12-10 17:38:46,61,5574,22,39,3480.34,6393.82,0.00
2024-12-10 17:38:46,61,5575,22,39,3573.78,6394.00,0.00
2024-12-10 17:38:46,62,5575,22,40,3516.13,6394.02,0.00
2024-12-10 17:38:46,61,5575,22,39,3572.73,6394.02,0.00
2024-12-10 17:38:46,61,5576,22,39,3582.10,6395.00,0.00
2024-12-10 17:38:46,62,5576,22,40,3524.32,6395.02,0.00
2024-12-10 17:38:46,61,5576,21,40,3504.80,6395.61,0.00
2024-12-10 17:38:46,61,5577,21,40,3584.78,6396.00,0.00
2024-12-10 17:38:46,62,5577,21,41,3526.96,6396.02,0.00
2024-12-10 17:38:46,61,5577,20,41,3550.13,6396.21,0.00
2024-12-10 17:38:46,61,5578,20,41,3603.05,6397.00,0.00
2024-12-10 17:38:46,62,5578,21,41,3544.94,6397.02,0.00
2024-12-10 17:38:46,61,5578,21,40,3593.04,6397.05,0.00
2024-12-10 17:38:46,61,5579,21,40,3592.98,6398.00,0.00
2024-12-10 17:38:46,62,5579,22,40,3535.03,6398.02,0.00
2024-12-10 17:38:46,62,5580,22,40,3510.59,6399.00,0.00
2024-12-10 17:38:46,63,5580,22,41,3454.86,6399.02,0.00
2024-12-10 17:38:46,62,5580,22,40,3500.70,6399.05,0.00
2024-12-10 17:38:46,61,5580,21,40,3527.77,6399.33,0.00
2024-12-10 17:38:46,61,5581,21,40,3587.54,6400.00,0.00
2024-12-10 17:38:46,62,5581,22,40,3529.67,6400.02,0.00
2024-12-10 17:38:46,63,5580,22,41,3441.77,6400.18,0.00
2024-12-10 17:38:46,62,5580,21,41,3552.02,6400.37,0.00
2024-12-10 17:38:46,62,5581,21,41,3573.20,6401.00,0.00
2024-12-10 17:38:46,63,5581,21,42,3516.48,6401.02,0.00
2024-12-10 17:38:46,62,5581,21,41,3563.47,6401.05,0.00
2024-12-10 17:38:46,61,5581,20,41,3582.45,6401.66,0.00
2024-12-10 17:38:46,61,5582,20,41,3726.71,6402.00,0.00
2024-12-10 17:38:46,62,5582,21,41,3666.60,6402.02,0.00
2024-12-10 17:38:46,62,5583,21,41,3641.59,6403.00,0.00
2024-12-10 17:38:46,63,5583,22,41,3583.78,6403.02,0.00
2024-12-10 17:38:46,62,5583,22,40,3630.26,6403.05,0.00
2024-12-10 17:38:46,62,5584,22,40,3631.25,6404.00,0.00
2024-12-10 17:38:46,63,5584,22,41,3573.61,6404.02,0.00
2024-12-10 17:38:46,63,5585,22,41,3546.01,6405.00,0.00
2024-12-10 17:38:46,64,5585,22,42,3490.60,6405.02,0.00
2024-12-10 17:38:46,63,5585,22,41,3535.78,6405.05,0.00
2024-12-10 17:38:46,62,5585,21,41,3512.77,6405.97,0.00
2024-12-10 17:38:46,62,5586,21,41,3614.04,6406.00,0.00
2024-12-10 17:38:46,63,5586,22,41,3556.68,6406.02,0.00
2024-12-10 17:38:46,62,5586,21,41,3536.45,6406.76,0.00
2024-12-10 17:38:46,62,5587,21,41,3624.38,6407.00,0.00
2024-12-10 17:38:46,63,5587,21,42,3566.85,6407.02,0.00
2024-12-10 17:38:46,62,5587,21,41,3622.59,6407.03,0.00
2024-12-10 17:38:46,61,5587,21,40,3677.77,6407.03,0.00
2024-12-10 17:38:46,61,5588,21,40,3677.09,6408.00,0.00
2024-12-10 17:38:46,62,5588,22,40,3617.79,6408.02,0.00
2024-12-10 17:38:46,62,5589,22,40,3595.98,6409.00,0.00
2024-12-10 17:38:46,63,5589,23,40,3538.90,6409.02,0.00
2024-12-10 17:38:46,62,5589,23,39,3588.75,6409.05,0.00
2024-12-10 17:38:46,61,5589,22,39,3606.65,6409.69,0.00
2024-12-10 17:38:46,61,5590,22,39,3649.47,6410.00,0.00
2024-12-10 17:38:46,62,5590,22,40,3590.61,6410.02,0.00
2024-12-10 17:38:46,61,5590,21,40,3615.91,6410.21,0.00
2024-12-10 17:38:46,61,5591,21,40,3661.13,6411.00,0.00
2024-12-10 17:38:46,62,5591,21,41,3602.07,6411.02,0.00
2024-12-10 17:38:46,62,5592,21,41,3604.85,6412.00,0.00
2024-12-10 17:38:46,63,5592,22,41,3547.63,6412.02,0.00
2024-12-10 17:38:46,62,5592,22,40,3603.82,6412.02,0.00
2024-12-10 17:38:46,62,5593,22,40,3594.23,6413.00,0.00
2024-12-10 17:38:46,63,5593,23,40,3537.18,6413.02,0.00
2024-12-10 17:38:46,63,5594,23,40,3512.53,6414.00,0.00
2024-12-10 17:38:46,64,5594,24,40,3457.64,6414.02,0.00
2024-12-10 17:38:46,63,5594,24,39,3504.38,6414.03,0.00
2024-12-10 17:38:46,62,5594,23,39,3510.64,6414.79,0.00
2024-12-10 17:38:46,62,5595,23,39,3559.42,6415.00,0.00
2024-12-10 17:38:46,63,5595,24,39,3502.93,6415.02,0.00
2024-12-10 17:38:46,62,5595,24,38,3536.66,6415.03,0.00
2024-12-10 17:38:46,62,5596,24,38,3531.97,6416.00,0.00
2024-12-10 17:38:46,63,5596,24,39,3475.91,6416.02,0.00
2024-12-10 17:38:46,63,5597,24,39,3442.92,6417.00,0.00
2024-12-10 17:38:46,64,5597,24,40,3389.12,6417.02,0.00
2024-12-10 17:38:46,63,5597,24,39,3437.83,6417.03,0.00
2024-12-10 17:38:46,62,5597,23,39,3437.76,6417.37,0.00
2024-12-10 17:38:46,62,5598,23,39,3501.33,6418.00,0.00
2024-12-10 17:38:46,63,5598,24,39,3445.76,6418.02,0.00
2024-12-10 17:38:46,63,5599,24,39,3403.00,6419.00,0.00
2024-12-10 17:38:46,64,5599,24,40,3349.83,6419.02,0.00
2024-12-10 17:38:46,63,5599,24,39,3398.93,6419.03,0.00
2024-12-10 17:38:46,62,5599,23,39,3443.78,6419.13,0.00
2024-12-10 17:38:46,61,5599,22,39,3477.25,6419.31,0.00
2024-12-10 17:38:46,61,5600,22,39,3495.18,6420.00,0.00
2024-12-10 17:38:46,62,5600,22,40,3438.80,6420.02,0.00
2024-12-10 17:38:46,61,5600,21,40,3449.56,6420.25,0.00
2024-12-10 17:38:46,61,5601,21,40,3506.88,6421.00,0.00
2024-12-10 17:38:46,62,5601,22,40,3450.32,6421.02,0.00
2024-12-10 17:38:46,61,5601,22,39,3503.73,6421.03,0.00
2024-12-10 17:38:46,60,5601,22,38,3549.31,6421.17,0.00
2024-12-10 17:38:46,60,5602,22,38,3560.53,6422.00,0.00
2024-12-10 17:38:46,61,5602,23,38,3502.16,6422.02,0.00
2024-12-10 17:38:46,61,5603,23,38,3474.74,6423.00,0.00
2024-12-10 17:38:46,62,5603,23,39,3418.69,6423.02,0.00
2024-12-10 17:38:46,61,5603,23,38,3469.48,6423.05,0.00
2024-12-10 17:38:46,61,5604,23,38,3467.65,6424.00,0.00
2024-12-10 17:38:46,62,5604,23,39,3411.72,6424.02,0.00
2024-12-10 17:38:46,62,5605,23,39,3386.24,6425.00,0.00
2024-12-10 17:38:46,63,5605,24,39,3332.49,6425.02,0.00
2024-12-10 17:38:47,62,5605,24,38,3381.06,6425.06,0.00
2024-12-10 17:38:47,62,5606,24,38,3379.13,6426.00,0.00
2024-12-10 17:38:47,63,5606,25,38,3325.50,6426.02,0.00
2024-12-10 17:38:47,62,5606,24,38,3350.48,6426.10,0.00
2024-12-10 17:38:47,61,5606,23,38,3366.17,6426.69,0.00
2024-12-10 17:38:47,60,5606,22,38,3390.32,6426.93,0.00
2024-12-10 17:38:47,60,5607,22,38,3493.19,6427.00,0.00
2024-12-10 17:38:47,61,5607,22,39,3435.93,6427.02,0.00
2024-12-10 17:38:47,60,5607,22,38,3488.91,6427.07,0.00
2024-12-10 17:38:47,60,5608,22,38,3489.65,6428.00,0.00
2024-12-10 17:38:47,61,5608,22,39,3432.44,6428.02,0.00
2024-12-10 17:38:47,60,5608,21,39,3468.23,6428.05,0.00
2024-12-10 17:38:47,59,5608,21,38,3526.51,6428.05,0.00
2024-12-10 17:38:47,59,5609,21,38,3548.20,6429.00,0.00
2024-12-10 17:38:47,60,5609,21,39,3489.06,6429.02,0.00
2024-12-10 17:38:47,59,5609,21,38,3529.69,6429.09,0.00
2024-12-10 17:38:47,59,5610,21,38,3533.63,6430.00,0.00
2024-12-10 17:38:47,60,5610,21,39,3474.74,6430.02,0.00
2024-12-10 17:38:47,59,5610,20,39,3478.15,6430.31,0.00
2024-12-10 17:38:47,59,5611,20,39,3542.90,6431.00,0.00
2024-12-10 17:38:47,60,5611,20,40,3483.85,6431.02,0.00
2024-12-10 17:38:47,59,5611,20,39,3521.12,6431.10,0.00
2024-12-10 17:38:47,59,5612,20,39,3529.28,6432.00,0.00
2024-12-10 17:38:47,60,5612,20,40,3470.46,6432.02,0.00
2024-12-10 17:38:47,59,5612,20,39,3528.19,6432.02,0.00
2024-12-10 17:38:47,58,5612,19,39,3558.00,6432.14,0.00
2024-12-10 17:38:47,58,5613,19,39,3610.09,6433.00,0.00
2024-12-10 17:38:47,59,5613,19,40,3548.90,6433.02,0.00
2024-12-10 17:38:47,58,5613,19,39,3587.93,6433.10,0.00
2024-12-10 17:38:47,57,5613,18,39,3608.42,6433.67,0.00
2024-12-10 17:38:47,57,5614,18,39,3654.96,6434.00,0.00
2024-12-10 17:38:47,58,5614,18,40,3591.94,6434.02,0.00
2024-12-10 17:38:47,57,5614,17,40,3573.20,6434.46,0.00
2024-12-10 17:38:47,57,5615,17,40,3651.49,6435.00,0.00
2024-12-10 17:38:47,58,5615,17,41,3588.53,6435.02,0.00
2024-12-10 17:38:47,57,5615,16,41,3615.37,6435.07,0.00
2024-12-10 17:38:47,57,5616,16,41,3645.52,6436.00,0.00
2024-12-10 17:38:47,58,5616,17,41,3582.67,6436.02,0.00
2024-12-10 17:38:47,57,5616,16,41,3616.17,6436.05,0.00
2024-12-10 17:38:47,56,5616,16,40,3662.36,6436.07,0.00
2024-12-10 17:38:47,56,5617,16,40,3716.47,6437.00,0.00
2024-12-10 17:38:47,57,5617,16,41,3651.27,6437.02,0.00
2024-12-10 17:38:47,57,5618,16,41,3638.26,6438.00,0.00
2024-12-10 17:38:47,58,5618,16,42,3575.53,6438.02,0.00
2024-12-10 17:38:47,57,5618,16,41,3616.81,6438.07,0.00
2024-12-10 17:38:47,57,5619,16,41,3621.75,6439.00,0.00
2024-12-10 17:38:47,58,5619,16,42,3559.30,6439.02,0.00
2024-12-10 17:38:47,57,5619,15,42,3590.14,6439.14,0.00
2024-12-10 17:38:47,57,5620,15,42,3607.39,6440.00,0.00
2024-12-10 17:38:47,58,5620,16,42,3545.19,6440.02,0.00
2024-12-10 17:38:47,57,5620,15,42,3515.58,6440.75,0.00
2024-12-10 17:38:47,57,5621,15,42,3612.96,6441.00,0.00
2024-12-10 17:38:47,58,5621,15,43,3550.67,6441.02,0.00
2024-12-10 17:38:47,57,5621,15,42,3601.28,6441.07,0.00
2024-12-10 17:38:47,57,5622,15,42,3605.10,6442.00,0.00
2024-12-10 17:38:47,58,5622,16,42,3542.95,6442.02,0.00
2024-12-10 17:38:47,57,5622,16,41,3584.27,6442.07,0.00
2024-12-10 17:38:47,57,5623,16,41,3590.40,6443.00,0.00
2024-12-10 17:38:47,58,5623,16,42,3528.50,6443.02,0.00
2024-12-10 17:38:47,57,5623,16,41,3589.27,6443.02,0.00
2024-12-10 17:38:47,56,5623,16,40,3651.12,6443.04,0.00
2024-12-10 17:38:47,55,5623,15,40,3658.77,6443.55,0.00
2024-12-10 17:38:47,55,5623,15,40,3706.81,6444.00,0.00
2024-12-10 17:38:47,56,5623,16,40,3640.61,6444.02,0.00
2024-12-10 17:38:47,55,5623,16,39,3690.41,6444.04,0.00
2024-12-10 17:38:47,55,5624,16,39,3698.47,6445.00,0.00
2024-12-10 17:38:47,56,5624,17,39,3632.42,6445.02,0.00
2024-12-10 17:38:47,55,5624,16,39,3669.19,6445.09,0.00
2024-12-10 17:38:47,55,5625,16,39,3686.04,6446.00,0.00
2024-12-10 17:38:47,56,5625,16,40,3620.22,6446.02,0.00
2024-12-10 17:38:47,55,5625,16,39,3670.81,6446.04,0.00
2024-12-10 17:38:47,55,5626,16,39,3679.58,6447.00,0.00
2024-12-10 17:38:47,56,5626,17,39,3613.88,6447.02,0.00
2024-12-10 17:38:47,55,5626,16,39,3616.56,6447.64,0.00
2024-12-10 17:38:47,55,5627,16,39,3672.35,6448.00,0.00
2024-12-10 17:38:47,56,5627,16,40,3606.77,6448.02,0.00
2024-12-10 17:38:47,55,5627,16,39,3650.08,6448.06,0.00
2024-12-10 17:38:47,55,5628,16,39,3660.02,6449.00,0.00
2024-12-10 17:38:47,56,5628,17,39,3594.66,6449.02,0.00
2024-12-10 17:38:47,56,5629,17,39,3590.31,6450.00,0.00
2024-12-10 17:38:47,57,5629,17,40,3527.32,6450.02,0.00
2024-12-10 17:38:47,57,5630,17,40,3508.59,6451.00,0.00
2024-12-10 17:38:47,58,5630,18,40,3448.10,6451.02,0.00
2024-12-10 17:38:47,57,5630,18,39,3501.82,6451.11,0.00
2024-12-10 17:38:47,57,5631,18,39,3512.53,6452.00,0.00
2024-12-10 17:38:47,58,5631,19,39,3451.97,6452.02,0.00
2024-12-10 17:38:47,57,5631,19,38,3506.40,6452.02,0.00
2024-12-10 17:38:47,56,5631,18,38,3487.26,6452.96,0.00
2024-12-10 17:38:47,56,5632,18,38,3600.20,6453.00,0.00
2024-12-10 17:38:47,57,5632,18,39,3537.04,6453.02,0.00
2024-12-10 17:38:47,56,5632,17,39,3570.26,6453.11,0.00
2024-12-10 17:38:47,56,5633,17,39,3626.43,6454.00,0.00
2024-12-10 17:38:47,57,5633,17,40,3562.81,6454.02,0.00
2024-12-10 17:38:47,56,5633,17,39,3599.95,6454.09,0.00
2024-12-10 17:38:47,55,5633,16,39,3605.72,6454.49,0.00
2024-12-10 17:38:47,55,5634,16,39,3687.56,6455.00,0.00
2024-12-10 17:38:47,56,5634,17,39,3621.71,6455.02,0.00
2024-12-10 17:38:47,56,5635,17,39,3608.50,6456.00,0.00
2024-12-10 17:38:47,57,5635,18,39,3545.20,6456.02,0.00
2024-12-10 17:38:47,56,5635,18,38,3608.21,6456.02,0.00
2024-12-10 17:38:47,55,5635,18,37,3659.92,6456.07,0.00
2024-12-10 17:38:47,54,5635,17,37,3651.23,6456.87,0.00
2024-12-10 17:38:48,54,5636,17,37,3762.54,6457.00,0.00
2024-12-10 17:38:48,55,5636,17,38,3694.13,6457.02,0.00
2024-12-10 17:38:48,54,5636,17,37,3741.77,6457.07,0.00
2024-12-10 17:38:48,54,5637,17,37,3750.29,6458.00,0.00
2024-12-10 17:38:48,55,5637,17,38,3682.10,6458.02,0.00
2024-12-10 17:38:48,54,5637,16,38,3721.61,6458.09,0.00
2024-12-10 17:38:48,53,5637,15,38,3769.95,6458.23,0.00
2024-12-10 17:38:48,53,5638,15,38,3838.07,6459.00,0.00
2024-12-10 17:38:48,54,5638,16,38,3767.00,6459.02,0.00
2024-12-10 17:38:48,53,5638,16,37,3812.49,6459.08,0.00
2024-12-10 17:38:48,52,5638,15,37,3813.63,6459.79,0.00
2024-12-10 17:38:48,52,5639,15,37,3924.36,6460.00,0.00
2024-12-10 17:38:48,53,5639,15,38,3850.32,6460.02,0.00
2024-12-10 17:38:48,52,5639,14,38,3837.33,6460.73,0.00
2024-12-10 17:38:48,52,5640,14,38,3944.41,6461.00,0.00
2024-12-10 17:38:48,53,5640,14,39,3869.99,6461.02,0.00
2024-12-10 17:38:48,52,5640,14,38,3917.09,6461.08,0.00
2024-12-10 17:38:48,52,5641,14,38,3927.52,6462.00,0.00
2024-12-10 17:38:48,53,5641,15,38,3853.42,6462.02,0.00
2024-12-10 17:38:48,53,5642,15,38,3839.36,6463.00,0.00
2024-12-10 17:38:48,54,5642,16,38,3768.26,6463.02,0.00
2024-12-10 17:38:48,53,5642,16,37,3813.76,6463.08,0.00
2024-12-10 17:38:48,52,5642,15,37,3879.42,6463.10,0.00
2024-12-10 17:38:48,52,5643,15,37,3940.59,6464.00,0.00
2024-12-10 17:38:48,53,5643,15,38,3866.24,6464.02,0.00
2024-12-10 17:38:48,52,5643,14,38,3894.75,6464.15,0.00
2024-12-10 17:38:48,52,5644,14,38,3959.62,6465.00,0.00
2024-12-10 17:38:48,53,5644,15,38,3884.91,6465.02,0.00
2024-12-10 17:38:48,52,5644,15,37,3934.76,6465.08,0.00
2024-12-10 17:38:48,52,5645,15,37,3945.00,6466.00,0.00
2024-12-10 17:38:48,53,5645,15,38,3870.57,6466.02,0.00
2024-12-10 17:38:48,53,5646,15,38,3856.70,6467.00,0.00
2024-12-10 17:38:48,54,5646,16,38,3785.28,6467.02,0.00
2024-12-10 17:38:48,53,5646,16,37,3831.09,6467.08,0.00
2024-12-10 17:38:48,53,5647,16,37,3840.12,6468.00,0.00
2024-12-10 17:38:48,54,5647,16,38,3769.01,6468.02,0.00
2024-12-10 17:38:48,53,5647,15,38,3728.12,6468.92,0.00
2024-12-10 17:38:48,53,5648,15,38,3845.35,6469.00,0.00
2024-12-10 17:38:48,54,5648,15,39,3774.14,6469.02,0.00
2024-12-10 17:38:48,53,5648,15,38,3820.95,6469.08,0.00
2024-12-10 17:38:48,53,5649,15,38,3830.33,6470.00,0.00
2024-12-10 17:38:48,54,5649,16,38,3759.39,6470.02,0.00
2024-12-10 17:38:48,53,5649,16,37,3732.97,6470.45,0.00
2024-12-10 17:38:48,53,5650,16,37,3820.06,6471.00,0.00
2024-12-10 17:38:48,54,5650,16,38,3749.32,6471.02,0.00
2024-12-10 17:38:48,53,5650,16,37,3795.65,6471.08,0.00
2024-12-10 17:38:48,53,5651,16,37,3809.66,6472.00,0.00
2024-12-10 17:38:48,54,5651,17,37,3739.11,6472.02,0.00
2024-12-10 17:38:48,54,5652,17,37,3731.56,6473.00,0.00
2024-12-10 17:38:48,55,5652,17,38,3663.72,6473.02,0.00
2024-12-10 17:38:48,54,5652,17,37,3706.40,6473.07,0.00
2024-12-10 17:38:48,54,5653,17,37,3718.95,6474.00,0.00
2024-12-10 17:38:48,55,5653,18,37,3651.33,6474.02,0.00
2024-12-10 17:38:48,54,5653,17,37,3690.19,6474.09,0.00
2024-12-10 17:38:48,54,5654,17,37,3711.51,6475.00,0.00
2024-12-10 17:38:48,55,5654,17,38,3644.03,6475.02,0.00
2024-12-10 17:38:48,54,5654,17,37,3687.54,6475.07,0.00
2024-12-10 17:38:48,54,5655,17,37,3700.09,6476.00,0.00
2024-12-10 17:38:48,55,5655,17,38,3632.82,6476.02,0.00
2024-12-10 17:38:48,54,5655,16,38,3665.33,6476.13,0.00
2024-12-10 17:38:48,54,5656,16,38,3729.45,6477.00,0.00
2024-12-10 17:38:48,55,5656,16,39,3661.64,6477.02,0.00
2024-12-10 17:38:48,54,5656,16,38,3700.67,6477.09,0.00
2024-12-10 17:38:48,53,5656,15,38,3721.31,6477.34,0.00
2024-12-10 17:38:48,53,5657,15,38,3801.20,6478.00,0.00
2024-12-10 17:38:48,54,5657,15,39,3730.81,6478.02,0.00
2024-12-10 17:38:48,54,5658,15,39,3723.78,6479.00,0.00
2024-12-10 17:38:48,55,5658,15,40,3656.07,6479.02,0.00
2024-12-10 17:38:48,54,5658,15,39,3696.19,6479.09,0.00
2024-12-10 17:38:48,54,5659,15,39,3709.95,6480.00,0.00
2024-12-10 17:38:48,55,5659,15,40,3642.50,6480.02,0.00
2024-12-10 17:38:48,54,5659,14,40,3706.00,6480.07,0.00
2024-12-10 17:38:48,53,5659,13,40,3716.70,6480.57,0.00
2024-12-10 17:38:48,53,5660,13,40,3811.16,6481.00,0.00
2024-12-10 17:38:48,54,5660,13,41,3740.59,6481.02,0.00
2024-12-10 17:38:48,53,5660,13,40,3784.26,6481.08,0.00
2024-12-10 17:38:48,52,5660,12,40,3781.27,6481.56,0.00
2024-12-10 17:38:48,52,5661,12,40,3877.58,6482.00,0.00
2024-12-10 17:38:48,53,5661,12,41,3804.41,6482.02,0.00
2024-12-10 17:38:48,52,5661,11,41,3807.90,6482.35,0.00
2024-12-10 17:38:48,52,5662,11,41,3890.64,6483.00,0.00
2024-12-10 17:38:48,53,5662,11,42,3817.23,6483.02,0.00
2024-12-10 17:38:48,52,5662,10,42,3879.42,6483.06,0.00
2024-12-10 17:38:48,51,5662,10,41,3932.61,6483.06,0.00
2024-12-10 17:38:48,51,5663,10,41,3999.32,6484.00,0.00
2024-12-10 17:38:48,52,5663,10,42,3922.41,6484.02,0.00
2024-12-10 17:38:48,53,5662,11,42,3741.37,6484.74,0.00
2024-12-10 17:38:48,53,5663,11,42,3863.94,6485.00,0.00
2024-12-10 17:38:48,54,5663,12,42,3792.38,6485.02,0.00
2024-12-10 17:38:48,54,5664,12,42,3897.47,6486.00,0.00
2024-12-10 17:38:48,55,5664,12,43,3826.60,6486.02,0.00
2024-12-10 17:38:48,54,5664,12,42,3896.27,6486.02,0.00
2024-12-10 17:38:48,53,5664,12,41,3961.24,6486.09,0.00
2024-12-10 17:38:48,53,5665,12,41,3976.51,6487.00,0.00
2024-12-10 17:38:48,54,5665,13,41,3902.87,6487.02,0.00
2024-12-10 17:38:48,53,5665,13,40,3975.29,6487.02,0.00
2024-12-10 17:38:48,53,5666,13,40,3970.49,6488.00,0.00
2024-12-10 17:38:48,54,5666,13,41,3896.96,6488.02,0.00
2024-12-10 17:38:48,54,5667,13,41,3883.77,6489.00,0.00
2024-12-10 17:38:48,55,5667,14,41,3813.16,6489.02,0.00
2024-12-10 17:38:48,54,5667,14,40,3863.35,6489.04,0.00
2024-12-10 17:38:48,54,5668,14,40,3868.60,6490.00,0.00
2024-12-10 17:38:49,55,5668,14,41,3798.26,6490.02,0.00
2024-12-10 17:38:49,55,5669,14,41,3785.35,6491.00,0.00
2024-12-10 17:38:49,56,5669,15,41,3717.76,6491.02,0.00
2024-12-10 17:38:49,55,5669,15,40,3764.12,6491.04,0.00
2024-12-10 17:38:49,55,5670,15,40,3772.95,6492.00,0.00
2024-12-10 17:38:49,56,5670,16,40,3705.58,6492.02,0.00
2024-12-10 17:38:49,55,5670,16,39,3750.53,6492.04,0.00
2024-12-10 17:38:49,54,5670,15,39,3739.86,6492.93,0.00
2024-12-10 17:38:49,54,5671,15,39,3855.33,6493.00,0.00
2024-12-10 17:38:49,55,5671,15,40,3785.23,6493.02,0.00
2024-12-10 17:38:49,54,5671,14,40,3744.95,6493.94,0.00
2024-12-10 17:38:49,54,5672,14,40,3861.64,6494.00,0.00
2024-12-10 17:38:49,55,5672,15,40,3791.43,6494.02,0.00
2024-12-10 17:38:49,54,5672,15,39,3837.60,6494.06,0.00
2024-12-10 17:38:49,54,5673,15,39,3847.77,6495.00,0.00
2024-12-10 17:38:49,55,5673,15,40,3777.81,6495.02,0.00
2024-12-10 17:38:49,55,5674,15,40,3766.47,6496.00,0.00
2024-12-10 17:38:49,56,5674,16,40,3699.21,6496.02,0.00
2024-12-10 17:38:49,55,5674,16,39,3747.58,6496.04,0.00
2024-12-10 17:38:49,54,5674,15,39,3786.78,6496.50,0.00
2024-12-10 17:38:49,54,5675,15,39,3826.84,6497.00,0.00
2024-12-10 17:38:49,55,5675,15,40,3757.26,6497.02,0.00
2024-12-10 17:38:49,54,5675,14,40,3715.62,6497.96,0.00
2024-12-10 17:38:49,54,5676,14,40,3833.56,6498.00,0.00
2024-12-10 17:38:49,55,5676,14,41,3763.86,6498.02,0.00
2024-12-10 17:38:49,54,5676,14,40,3814.31,6498.04,0.00
2024-12-10 17:38:49,54,5677,14,40,3824.52,6499.00,0.00
2024-12-10 17:38:49,55,5677,14,41,3754.99,6499.02,0.00
2024-12-10 17:38:49,54,5677,13,41,3765.42,6499.56,0.00
2024-12-10 17:38:49,54,5678,13,41,3812.78,6500.00,0.00
2024-12-10 17:38:49,55,5678,14,41,3743.46,6500.02,0.00
2024-12-10 17:38:49,54,5678,14,40,3794.73,6500.04,0.00
2024-12-10 17:38:49,53,5678,13,40,3794.36,6500.87,0.00
2024-12-10 17:38:49,53,5679,13,40,3908.54,6501.00,0.00
2024-12-10 17:38:49,54,5679,13,41,3836.16,6501.02,0.00
2024-12-10 17:38:49,54,5680,13,41,3825.36,6502.00,0.00
2024-12-10 17:38:49,55,5680,13,42,3755.80,6502.02,0.00
2024-12-10 17:38:49,54,5680,13,41,3803.69,6502.06,0.00
2024-12-10 17:38:49,54,5681,13,41,3815.11,6503.00,0.00
2024-12-10 17:38:49,55,5681,13,42,3745.74,6503.02,0.00
2024-12-10 17:38:49,54,5681,12,42,3722.16,6503.83,0.00
2024-12-10 17:38:49,54,5682,12,42,3831.90,6504.00,0.00
2024-12-10 17:38:49,55,5682,12,43,3762.23,6504.02,0.00
2024-12-10 17:38:49,54,5682,12,42,3811.44,6504.06,0.00
2024-12-10 17:38:49,53,5682,11,42,3878.46,6504.11,0.00
2024-12-10 17:38:49,52,5682,10,42,3912.12,6504.73,0.00
2024-12-10 17:38:49,52,5683,10,42,3969.89,6505.00,0.00
2024-12-10 17:38:49,53,5683,10,43,3894.98,6505.02,0.00
2024-12-10 17:38:49,52,5683,9,43,3887.19,6505.39,0.00
2024-12-10 17:38:49,52,5684,9,43,3972.72,6506.00,0.00
2024-12-10 17:38:49,53,5684,9,44,3897.76,6506.02,0.00
2024-12-10 17:38:49,52,5684,9,43,3952.71,6506.06,0.00
2024-12-10 17:38:49,51,5684,8,43,3998.42,6506.27,0.00
2024-12-10 17:38:49,51,5685,8,43,4079.31,6507.00,0.00
2024-12-10 17:38:49,52,5685,8,44,4000.86,6507.02,0.00
2024-12-10 17:38:49,52,5686,8,44,3987.71,6508.00,0.00
2024-12-10 17:38:49,53,5686,8,45,3912.47,6508.02,0.00
2024-12-10 17:38:49,52,5686,8,44,3966.63,6508.06,0.00
2024-12-10 17:38:49,51,5686,7,44,3975.99,6508.86,0.00
2024-12-10 17:38:49,51,5687,7,44,4094.80,6509.00,0.00
2024-12-10 17:38:49,52,5687,7,45,4016.05,6509.02,0.00
2024-12-10 17:38:49,52,5688,7,45,3997.87,6510.00,0.00
2024-12-10 17:38:49,53,5688,8,45,3922.44,6510.02,0.00
2024-12-10 17:38:49,52,5688,8,44,3965.16,6510.06,0.00
2024-12-10 17:38:49,51,5688,7,44,4036.55,6510.12,0.00
2024-12-10 17:38:49,51,5689,7,44,4107.36,6511.00,0.00
2024-12-10 17:38:49,52,5689,7,45,4028.38,6511.02,0.00
2024-12-10 17:38:49,51,5689,7,44,4095.78,6511.04,0.00
2024-12-10 17:38:49,51,5690,7,44,4085.51,6512.00,0.00
2024-12-10 17:38:49,52,5690,8,44,4006.94,6512.02,0.00
2024-12-10 17:38:49,51,5690,8,43,4065.08,6512.04,0.00
2024-12-10 17:38:49,51,5691,8,43,4079.75,6513.00,0.00
2024-12-10 17:38:49,52,5691,8,44,4001.30,6513.02,0.00
2024-12-10 17:38:49,51,5691,7,44,3999.31,6513.08,0.00
2024-12-10 17:38:49,51,5692,7,44,4067.61,6514.00,0.00
2024-12-10 17:38:49,52,5692,8,44,3989.38,6514.02,0.00
2024-12-10 17:38:49,51,5692,7,44,4002.57,6514.29,0.00
2024-12-10 17:38:49,51,5693,7,44,4084.84,6515.00,0.00
2024-12-10 17:38:49,52,5693,8,44,4006.28,6515.02,0.00
2024-12-10 17:38:49,51,5693,8,43,4061.85,6515.06,0.00
2024-12-10 17:38:49,51,5694,8,43,4077.80,6516.00,0.00
2024-12-10 17:38:49,52,5694,9,43,3999.38,6516.02,0.00
2024-12-10 17:38:49,52,5695,9,43,3993.75,6517.00,0.00
2024-12-10 17:38:49,53,5695,10,43,3918.40,6517.02,0.00
2024-12-10 17:38:49,53,5696,10,43,3904.24,6518.00,0.00
2024-12-10 17:38:49,54,5696,11,43,3831.94,6518.02,0.00
2024-12-10 17:38:49,53,5696,11,42,3896.89,6518.11,0.00
2024-12-10 17:38:49,53,5697,11,42,3913.45,6519.00,0.00
2024-12-10 17:38:49,54,5697,12,42,3840.98,6519.02,0.00
2024-12-10 17:38:49,53,5697,11,42,3819.89,6519.85,0.00
2024-12-10 17:38:49,53,5698,11,42,3933.16,6520.00,0.00
2024-12-10 17:38:49,54,5698,11,43,3860.33,6520.02,0.00
2024-12-10 17:38:49,53,5698,11,42,3920.86,6520.04,0.00
2024-12-10 17:38:49,53,5699,11,42,3932.54,6521.00,0.00
2024-12-10 17:38:49,54,5699,11,43,3859.71,6521.02,0.00
2024-12-10 17:38:49,54,5700,11,43,3846.19,6522.00,0.00
2024-12-10 17:38:49,55,5700,11,44,3776.26,6522.02,0.00
2024-12-10 17:38:49,54,5700,11,43,3824.00,6522.07,0.00
2024-12-10 17:38:49,53,5700,10,43,3814.34,6522.96,0.00
2024-12-10 17:38:49,53,5701,10,43,3934.21,6523.00,0.00
2024-12-10 17:38:49,54,5701,10,44,3861.35,6523.02,0.00
2024-12-10 17:38:49,53,5701,10,43,3932.98,6523.02,0.00
2024-12-10 17:38:49,52,5701,10,42,3983.54,6523.06,0.00
2024-12-10 17:38:49,51,5701,9,42,4036.13,6523.22,0.00
2024-12-10 17:38:49,52,5700,10,42,3946.08,6523.44,0.00
2024-12-10 17:38:50,52,5701,10,42,4080.50,6524.00,0.00
2024-12-10 17:38:50,53,5701,10,43,4003.51,6524.02,0.00
2024-12-10 17:38:50,52,5701,9,43,4043.40,6524.08,0.00
2024-12-10 17:38:50,52,5702,9,43,4232.52,6525.00,0.00
2024-12-10 17:38:50,53,5702,9,44,4152.66,6525.02,0.00
2024-12-10 17:38:50,52,5702,9,43,4208.69,6525.06,0.00
2024-12-10 17:38:50,52,5703,9,43,4217.29,6526.00,0.00
2024-12-10 17:38:50,53,5703,9,44,4137.72,6526.02,0.00
2024-12-10 17:38:50,53,5704,9,44,4118.55,6527.00,0.00
2024-12-10 17:38:50,54,5704,9,45,4042.28,6527.02,0.00
2024-12-10 17:38:50,53,5704,9,44,4093.93,6527.06,0.00
2024-12-10 17:38:50,53,5705,9,44,4102.81,6528.00,0.00
2024-12-10 17:38:50,54,5705,10,44,4026.83,6528.02,0.00
2024-12-10 17:38:50,53,5705,9,44,4021.95,6528.76,0.00
2024-12-10 17:38:50,53,5706,9,44,4124.59,6529.00,0.00
2024-12-10 17:38:50,54,5706,9,45,4048.21,6529.02,0.00
2024-12-10 17:38:50,53,5706,9,44,4099.97,6529.06,0.00
2024-12-10 17:38:50,53,5707,9,44,4107.11,6530.00,0.00
2024-12-10 17:38:50,54,5707,10,44,4031.06,6530.02,0.00
2024-12-10 17:38:50,54,5708,10,44,4013.07,6531.00,0.00
2024-12-10 17:38:50,55,5708,10,45,3940.11,6531.02,0.00
2024-12-10 17:38:50,54,5708,10,44,3988.89,6531.06,0.00
2024-12-10 17:38:50,54,5709,10,44,3997.42,6532.00,0.00
2024-12-10 17:38:50,55,5709,11,44,3924.74,6532.02,0.00
2024-12-10 17:38:50,55,5710,11,44,3919.37,6533.00,0.00
2024-12-10 17:38:50,56,5710,12,44,3849.38,6533.02,0.00
2024-12-10 17:38:50,56,5711,12,44,3822.62,6534.00,0.00
2024-12-10 17:38:50,57,5711,12,45,3755.55,6534.02,0.00
2024-12-10 17:38:50,56,5711,12,44,3807.46,6534.05,0.00
2024-12-10 17:38:50,56,5712,12,44,3809.06,6535.00,0.00
2024-12-10 17:38:50,57,5712,13,44,3742.24,6535.02,0.00
2024-12-10 17:38:50,57,5713,13,44,3723.11,6536.00,0.00
2024-12-10 17:38:50,58,5713,13,45,3658.91,6536.02,0.00
2024-12-10 17:38:50,57,5713,13,44,3702.47,6536.05,0.00
2024-12-10 17:38:50,57,5714,13,44,3704.96,6537.00,0.00
2024-12-10 17:38:50,58,5714,14,44,3641.08,6537.02,0.00
2024-12-10 17:38:50,57,5714,13,44,3638.77,6537.67,0.00
2024-12-10 17:38:50,57,5715,13,44,3726.75,6538.00,0.00
2024-12-10 17:38:50,58,5715,13,45,3662.49,6538.02,0.00
2024-12-10 17:38:50,57,5715,13,44,3706.11,6538.05,0.00
2024-12-10 17:38:50,57,5716,13,44,3708.99,6539.00,0.00
2024-12-10 17:38:50,58,5716,14,44,3645.04,6539.02,0.00
2024-12-10 17:38:50,58,5717,14,44,3627.13,6540.00,0.00
2024-12-10 17:38:50,59,5717,14,45,3565.66,6540.02,0.00
2024-12-10 17:38:50,58,5717,14,44,3606.84,6540.05,0.00
2024-12-10 17:38:50,58,5718,14,44,3604.31,6541.00,0.00
2024-12-10 17:38:50,59,5718,15,44,3543.22,6541.02,0.00
2024-12-10 17:38:50,59,5719,15,44,3519.47,6542.00,0.00
2024-12-10 17:38:50,60,5719,16,44,3460.81,6542.02,0.00
2024-12-10 17:38:50,59,5719,16,43,3496.20,6542.09,0.00
2024-12-10 17:38:50,58,5719,15,43,3519.31,6542.59,0.00
2024-12-10 17:38:50,57,5719,15,42,3574.41,6542.65,0.00
2024-12-10 17:38:50,57,5720,15,42,3666.48,6543.00,0.00
2024-12-10 17:38:50,58,5720,15,43,3603.26,6543.02,0.00
2024-12-10 17:38:50,58,5721,15,43,3586.69,6544.00,0.00
2024-12-10 17:38:50,59,5721,16,43,3525.90,6544.02,0.00
2024-12-10 17:38:50,58,5721,16,42,3569.77,6544.05,0.00
2024-12-10 17:38:50,58,5722,16,42,3574.19,6545.00,0.00
2024-12-10 17:38:50,59,5722,16,43,3513.61,6545.02,0.00
2024-12-10 17:38:50,58,5722,16,42,3556.04,6545.05,0.00
2024-12-10 17:38:50,58,5723,16,42,3561.25,6546.00,0.00
2024-12-10 17:38:50,59,5723,17,42,3500.89,6546.02,0.00
2024-12-10 17:38:50,59,5724,17,42,3487.23,6547.00,0.00
2024-12-10 17:38:50,60,5724,17,43,3429.11,6547.02,0.00
2024-12-10 17:38:50,59,5724,17,42,3470.59,6547.05,0.00
2024-12-10 17:38:50,59,5725,17,42,3474.57,6548.00,0.00
2024-12-10 17:38:50,60,5725,18,42,3416.66,6548.02,0.00
2024-12-10 17:38:50,60,5726,18,42,3397.34,6549.00,0.00
2024-12-10 17:38:50,61,5726,19,42,3341.64,6549.02,0.00
2024-12-10 17:38:50,60,5726,19,41,3382.06,6549.05,0.00
2024-12-10 17:38:50,59,5726,18,41,3344.57,6549.97,0.00
2024-12-10 17:38:50,59,5727,18,41,3453.38,6550.00,0.00
2024-12-10 17:38:50,60,5727,19,41,3395.82,6550.02,0.00
2024-12-10 17:38:50,59,5727,18,41,3336.99,6550.93,0.00
2024-12-10 17:38:50,59,5728,18,41,3443.63,6551.00,0.00
2024-12-10 17:38:50,60,5728,19,41,3386.23,6551.02,0.00
2024-12-10 17:38:50,59,5728,19,40,3429.20,6551.05,0.00
2024-12-10 17:38:50,59,5729,19,40,3419.27,6552.00,0.00
2024-12-10 17:38:50,60,5729,20,40,3362.28,6552.02,0.00
2024-12-10 17:38:50,59,5729,19,40,3339.41,6552.64,0.00
2024-12-10 17:38:50,58,5729,18,40,3392.49,6552.71,0.00
2024-12-10 17:38:50,58,5730,18,40,3447.75,6553.00,0.00
2024-12-10 17:38:50,59,5730,18,41,3389.31,6553.02,0.00
2024-12-10 17:38:50,58,5730,18,40,3446.62,6553.02,0.00
2024-12-10 17:38:50,57,5730,18,39,3494.44,6553.04,0.00
2024-12-10 17:38:50,56,5730,17,39,3524.42,6553.46,0.00
2024-12-10 17:38:50,56,5731,17,39,3559.89,6554.00,0.00
2024-12-10 17:38:50,57,5731,18,39,3497.43,6554.02,0.00
2024-12-10 17:38:50,56,5731,18,38,3558.72,6554.02,0.00
2024-12-10 17:38:50,56,5732,18,38,3544.11,6555.00,0.00
2024-12-10 17:38:50,57,5732,18,39,3481.93,6555.02,0.00
2024-12-10 17:38:50,56,5732,18,38,3533.57,6555.02,0.00
2024-12-10 17:38:50,56,5733,18,38,3539.97,6556.00,0.00
2024-12-10 17:38:50,57,5733,19,38,3477.86,6556.02,0.00
2024-12-10 17:38:50,56,5733,18,38,3467.59,6556.61,0.00
2024-12-10 17:38:51,56,5734,18,38,3559.17,6557.00,0.00
2024-12-10 17:38:51,57,5734,19,38,3496.73,6557.02,0.00
2024-12-10 17:38:51,56,5734,19,37,3549.80,6557.02,0.00
2024-12-10 17:38:51,55,5734,18,37,3607.23,6557.13,0.00
2024-12-10 17:38:51,55,5735,18,37,3622.05,6558.00,0.00
2024-12-10 17:38:51,56,5735,18,38,3557.37,6558.02,0.00
2024-12-10 17:38:51,56,5736,18,38,3540.34,6559.00,0.00
2024-12-10 17:38:51,57,5736,19,38,3478.23,6559.02,0.00
2024-12-10 17:38:51,56,5736,19,37,3529.81,6559.04,0.00
2024-12-10 17:38:51,55,5736,18,37,3516.73,6559.58,0.00
2024-12-10 17:38:51,55,5737,18,37,3608.84,6560.00,0.00
2024-12-10 17:38:51,56,5737,18,38,3544.40,6560.02,0.00
2024-12-10 17:38:51,56,5738,18,38,3527.87,6561.00,0.00
2024-12-10 17:38:51,57,5738,19,38,3465.98,6561.02,0.00
2024-12-10 17:38:51,56,5738,19,37,3517.33,6561.04,0.00
2024-12-10 17:38:51,55,5738,18,37,3508.45,6561.89,0.00
2024-12-10 17:38:51,55,5739,18,37,3620.68,6562.00,0.00
2024-12-10 17:38:51,56,5739,18,38,3556.02,6562.02,0.00
2024-12-10 17:38:51,56,5740,18,38,3540.24,6563.00,0.00
2024-12-10 17:38:51,57,5740,18,39,3478.13,6563.02,0.00
2024-12-10 17:38:51,56,5740,18,38,3529.69,6563.04,0.00
2024-12-10 17:38:51,55,5740,17,38,3556.95,6563.60,0.00
2024-12-10 17:38:51,55,5741,17,38,3602.58,6564.00,0.00
2024-12-10 17:38:51,56,5741,17,39,3538.24,6564.02,0.00
2024-12-10 17:38:51,55,5741,16,39,3494.41,6564.96,0.00
2024-12-10 17:38:51,55,5742,16,39,3611.40,6565.00,0.00
2024-12-10 17:38:51,56,5742,17,39,3546.91,6565.02,0.00
2024-12-10 17:38:51,55,5742,17,38,3599.47,6565.04,0.00
2024-12-10 17:38:51,55,5743,17,38,3608.37,6566.00,0.00
2024-12-10 17:38:51,56,5743,18,38,3543.93,6566.02,0.00
2024-12-10 17:38:51,55,5743,17,38,3520.72,6566.78,0.00
2024-12-10 17:38:51,55,5744,17,38,3623.05,6567.00,0.00
2024-12-10 17:38:51,56,5744,17,39,3558.36,6567.02,0.00
2024-12-10 17:38:51,55,5744,17,38,3611.12,6567.04,0.00
2024-12-10 17:38:51,54,5744,16,38,3637.92,6567.65,0.00
2024-12-10 17:38:51,54,5745,16,38,3682.89,6568.00,0.00
2024-12-10 17:38:51,55,5745,17,38,3615.92,6568.02,0.00
2024-12-10 17:38:51,55,5746,17,38,3593.54,6569.00,0.00
2024-12-10 17:38:51,56,5746,17,39,3529.37,6569.02,0.00
2024-12-10 17:38:51,55,5746,17,38,3581.60,6569.04,0.00
2024-12-10 17:38:51,54,5746,16,38,3555.02,6569.96,0.00
2024-12-10 17:38:51,54,5747,16,38,3674.27,6570.00,0.00
2024-12-10 17:38:51,55,5747,17,38,3607.47,6570.02,0.00
2024-12-10 17:38:51,56,5746,17,39,3463.94,6570.86,0.00
2024-12-10 17:38:51,56,5747,17,39,3551.64,6571.00,0.00
2024-12-10 17:38:51,57,5747,17,40,3489.33,6571.02,0.00
2024-12-10 17:38:51,56,5747,17,39,3541.08,6571.04,0.00
2024-12-10 17:38:51,56,5748,17,39,3653.19,6572.00,0.00
2024-12-10 17:38:51,57,5748,17,40,3589.10,6572.02,0.00
2024-12-10 17:38:51,57,5749,17,40,3562.30,6573.00,0.00
2024-12-10 17:38:51,58,5749,17,41,3500.88,6573.02,0.00
2024-12-10 17:38:51,57,5749,17,40,3549.62,6573.05,0.00
2024-12-10 17:38:51,56,5749,16,40,3525.57,6573.91,0.00
2024-12-10 17:38:51,56,5750,16,40,3636.73,6574.00,0.00
2024-12-10 17:38:51,57,5750,16,41,3572.93,6574.02,0.00
2024-12-10 17:38:51,57,5751,16,41,3547.61,6575.00,0.00
2024-12-10 17:38:51,58,5751,17,41,3486.44,6575.02,0.00
2024-12-10 17:38:51,57,5751,17,40,3536.08,6575.05,0.00
2024-12-10 17:38:51,56,5751,16,40,3553.95,6575.66,0.00
2024-12-10 17:38:51,55,5751,15,40,3576.72,6575.91,0.00
2024-12-10 17:38:51,55,5752,15,40,3690.38,6576.00,0.00
2024-12-10 17:38:51,56,5752,15,41,3624.48,6576.02,0.00
2024-12-10 17:38:51,56,5753,15,41,3600.12,6577.00,0.00
2024-12-10 17:38:51,57,5753,16,41,3536.96,6577.02,0.00
2024-12-10 17:38:51,56,5753,16,40,3589.55,6577.05,0.00
2024-12-10 17:38:51,56,5754,16,40,3593.79,6578.00,0.00
2024-12-10 17:38:51,57,5754,17,40,3530.74,6578.02,0.00
2024-12-10 17:38:51,56,5754,17,39,3563.38,6578.11,0.00
2024-12-10 17:38:51,56,5755,17,39,3575.71,6579.00,0.00
2024-12-10 17:38:51,57,5755,18,39,3512.97,6579.02,0.00
2024-12-10 17:38:51,56,5755,18,38,3566.31,6579.05,0.00
2024-12-10 17:38:51,55,5755,17,38,3625.17,6579.15,0.00
2024-12-10 17:38:51,54,5755,16,38,3690.98,6579.17,0.00
2024-12-10 17:38:51,54,5756,16,38,3709.37,6580.00,0.00
2024-12-10 17:38:51,55,5756,16,39,3641.93,6580.02,0.00
2024-12-10 17:38:51,54,5756,15,39,3633.97,6580.43,0.00
2024-12-10 17:38:51,54,5757,15,39,3717.96,6581.00,0.00
2024-12-10 17:38:51,55,5757,16,39,3650.36,6581.02,0.00
2024-12-10 17:38:51,54,5757,16,38,3709.43,6581.06,0.00
2024-12-10 17:38:51,54,5758,16,38,3719.59,6582.00,0.00
2024-12-10 17:38:51,55,5758,17,38,3651.97,6582.02,0.00
2024-12-10 17:38:51,55,5759,17,38,3633.61,6583.00,0.00
2024-12-10 17:38:51,56,5759,18,38,3568.73,6583.02,0.00
2024-12-10 17:38:51,55,5759,18,37,3626.44,6583.06,0.00
2024-12-10 17:38:51,55,5760,18,37,3633.71,6584.00,0.00
2024-12-10 17:38:51,56,5760,19,37,3568.82,6584.02,0.00
2024-12-10 17:38:51,56,5761,19,37,3546.96,6585.00,0.00
2024-12-10 17:38:51,57,5761,20,37,3484.73,6585.02,0.00
2024-12-10 17:38:51,56,5761,19,37,3546.60,6585.02,0.00
2024-12-10 17:38:51,55,5761,19,36,3605.10,6585.04,0.00
2024-12-10 17:38:51,55,5762,19,36,3606.65,6586.00,0.00
2024-12-10 17:38:51,56,5762,19,37,3542.25,6586.02,0.00
2024-12-10 17:38:51,55,5762,18,37,3533.29,6586.67,0.00
2024-12-10 17:38:51,55,5763,18,37,3577.30,6587.00,0.00
2024-12-10 17:38:51,56,5763,18,38,3513.42,6587.02,0.00
2024-12-10 17:38:51,55,5763,18,37,3572.51,6587.04,0.00
2024-12-10 17:38:51,54,5763,17,37,3547.79,6587.91,0.00
2024-12-10 17:38:51,54,5764,17,37,3663.75,6588.00,0.00
2024-12-10 17:38:51,55,5764,17,38,3597.13,6588.02,0.00
2024-12-10 17:38:51,55,5765,17,38,3564.88,6589.00,0.00
2024-12-10 17:38:51,56,5765,18,38,3501.22,6589.02,0.00
2024-12-10 17:38:51,55,5765,18,37,3560.09,6589.04,0.00
2024-12-10 17:38:52,55,5766,18,37,3552.86,6590.00,0.00
2024-12-10 17:38:52,56,5766,19,37,3489.42,6590.02,0.00
2024-12-10 17:38:52,55,5766,19,36,3520.62,6590.07,0.00
2024-12-10 17:38:52,55,5767,19,36,3522.86,6591.00,0.00
2024-12-10 17:38:52,56,5767,20,36,3459.95,6591.02,0.00
2024-12-10 17:38:52,55,5767,20,35,3518.07,6591.04,0.00
2024-12-10 17:38:52,54,5767,19,35,3539.40,6591.37,0.00
2024-12-10 17:38:52,54,5768,19,35,3612.49,6592.00,0.00
2024-12-10 17:38:52,55,5768,19,36,3546.81,6592.02,0.00
2024-12-10 17:38:52,54,5768,18,36,3524.64,6592.76,0.00
2024-12-10 17:38:52,54,5769,18,36,3631.03,6593.00,0.00
2024-12-10 17:38:52,55,5769,19,36,3565.01,6593.02,0.00
2024-12-10 17:38:52,54,5769,19,35,3620.05,6593.04,0.00
2024-12-10 17:38:52,54,5770,19,35,3627.59,6594.00,0.00
2024-12-10 17:38:52,55,5770,19,36,3561.63,6594.02,0.00
2024-12-10 17:38:52,54,5770,18,36,3537.09,6594.82,0.00
2024-12-10 17:38:52,54,5771,18,36,3647.16,6595.00,0.00
2024-12-10 17:38:52,55,5771,19,36,3580.85,6595.02,0.00
2024-12-10 17:38:52,54,5771,19,35,3634.95,6595.04,0.00
2024-12-10 17:38:52,54,5772,19,35,3642.41,6596.00,0.00
2024-12-10 17:38:52,55,5772,19,36,3576.19,6596.02,0.00
2024-12-10 17:38:52,54,5772,18,36,3607.03,6596.19,0.00
2024-12-10 17:38:52,54,5773,18,36,3627.71,6597.00,0.00
2024-12-10 17:38:52,55,5773,19,36,3561.75,6597.02,0.00
2024-12-10 17:38:52,54,5773,19,35,3615.50,6597.06,0.00
2024-12-10 17:38:52,54,5774,19,35,3625.43,6598.00,0.00
2024-12-10 17:38:52,55,5774,20,35,3559.52,6598.02,0.00
2024-12-10 17:38:52,55,5775,20,35,3545.74,6599.00,0.00
2024-12-10 17:38:52,56,5775,20,36,3482.42,6599.02,0.00
2024-12-10 17:38:52,55,5775,20,35,3544.54,6599.02,0.00
2024-12-10 17:38:52,54,5775,20,34,3600.40,6599.04,0.00
2024-12-10 17:38:52,53,5775,19,34,3625.07,6599.68,0.00
2024-12-10 17:38:52,53,5776,19,34,3678.85,6600.00,0.00
2024-12-10 17:38:52,54,5776,19,35,3610.72,6600.02,0.00
2024-12-10 17:38:52,54,5777,19,35,3595.38,6601.00,0.00
2024-12-10 17:38:52,55,5777,20,35,3530.01,6601.02,0.00
2024-12-10 17:38:52,54,5777,20,34,3586.83,6601.04,0.00
2024-12-10 17:38:52,53,5777,19,34,3644.58,6601.17,0.00
2024-12-10 17:38:52,52,5777,19,33,3692.80,6601.50,0.00
2024-12-10 17:38:52,51,5777,18,33,3715.34,6601.90,0.00
2024-12-10 17:38:52,51,5778,18,33,3838.38,6602.00,0.00
2024-12-10 17:38:52,52,5778,19,33,3764.56,6602.02,0.00
2024-12-10 17:38:52,52,5779,19,33,3747.83,6603.00,0.00
2024-12-10 17:38:52,53,5779,19,34,3677.11,6603.02,0.00
2024-12-10 17:38:52,52,5779,19,33,3740.21,6603.04,0.00
2024-12-10 17:38:52,52,5780,19,33,3750.89,6604.00,0.00
2024-12-10 17:38:52,53,5780,20,33,3680.12,6604.02,0.00
2024-12-10 17:38:52,52,5780,19,33,3659.10,6604.35,0.00
2024-12-10 17:38:52,52,5781,19,33,3741.15,6605.00,0.00
2024-12-10 17:38:52,53,5781,19,34,3670.56,6605.02,0.00
2024-12-10 17:38:52,52,5781,19,33,3729.73,6605.06,0.00
2024-12-10 17:38:52,52,5782,19,33,3741.18,6606.00,0.00
2024-12-10 17:38:52,53,5782,19,34,3670.60,6606.02,0.00
2024-12-10 17:38:52,52,5782,18,34,3684.86,6606.27,0.00
2024-12-10 17:38:52,52,5783,18,34,3763.38,6607.00,0.00
2024-12-10 17:38:52,53,5783,19,34,3692.38,6607.02,0.00
2024-12-10 17:38:52,53,5784,19,34,3680.10,6608.00,0.00
2024-12-10 17:38:52,54,5784,20,34,3611.95,6608.02,0.00
2024-12-10 17:38:52,54,5785,20,34,3596.58,6609.00,0.00
2024-12-10 17:38:52,55,5785,21,34,3531.19,6609.02,0.00
2024-12-10 17:38:52,54,5785,21,33,3594.14,6609.04,0.00
2024-12-10 17:38:52,53,5785,20,33,3619.86,6609.66,0.00
2024-12-10 17:38:52,53,5786,20,33,3672.48,6610.00,0.00
2024-12-10 17:38:52,54,5786,20,34,3604.47,6610.02,0.00
2024-12-10 17:38:52,54,5787,20,34,3589.10,6611.00,0.00
2024-12-10 17:38:52,55,5787,21,34,3523.85,6611.02,0.00
2024-12-10 17:38:52,54,5787,21,33,3579.31,6611.06,0.00
2024-12-10 17:38:52,53,5787,20,33,3639.39,6611.17,0.00
2024-12-10 17:38:52,52,5787,19,33,3634.87,6611.96,0.00
2024-12-10 17:38:52,52,5788,19,33,3759.50,6612.00,0.00
2024-12-10 17:38:52,53,5788,19,34,3688.56,6612.02,0.00
2024-12-10 17:38:52,52,5788,19,33,3748.06,6612.06,0.00
2024-12-10 17:38:52,52,5789,19,33,3762.61,6613.00,0.00
2024-12-10 17:38:52,53,5789,19,34,3691.62,6613.02,0.00
2024-12-10 17:38:52,52,5789,18,34,3658.82,6613.92,0.00
2024-12-10 17:38:52,52,5790,18,34,3780.98,6614.00,0.00
2024-12-10 17:38:52,53,5790,18,35,3709.65,6614.02,0.00
2024-12-10 17:38:52,52,5790,18,34,3778.44,6614.04,0.00
2024-12-10 17:38:52,51,5790,18,33,3843.45,6614.04,0.00
2024-12-10 17:38:52,50,5790,17,33,3855.00,6614.82,0.00
2024-12-10 17:38:52,50,5791,17,33,3975.54,6615.00,0.00
2024-12-10 17:38:52,51,5791,18,33,3897.59,6615.02,0.00
2024-12-10 17:38:52,50,5791,17,33,3897.50,6615.10,0.00
2024-12-10 17:38:52,50,5792,17,33,3970.85,6616.00,0.00
2024-12-10 17:38:52,51,5792,17,34,3892.99,6616.02,0.00
2024-12-10 17:38:52,50,5792,17,33,3958.94,6616.04,0.00
2024-12-10 17:38:52,50,5793,17,33,3975.42,6617.00,0.00
2024-12-10 17:38:52,51,5793,18,33,3897.47,6617.02,0.00
2024-12-10 17:38:52,51,5794,18,33,3885.08,6618.00,0.00
2024-12-10 17:38:52,52,5794,18,34,3810.37,6618.02,0.00
2024-12-10 17:38:52,51,5794,18,33,3880.02,6618.04,0.00
2024-12-10 17:38:52,51,5795,18,33,3894.89,6619.00,0.00
2024-12-10 17:38:52,52,5795,18,34,3819.99,6619.02,0.00
2024-12-10 17:38:52,52,5796,18,34,3806.56,6620.00,0.00
2024-12-10 17:38:52,53,5796,18,35,3734.74,6620.02,0.00
2024-12-10 17:38:52,52,5796,18,34,3795.10,6620.04,0.00
2024-12-10 17:38:52,51,5796,17,34,3790.85,6620.92,0.00
2024-12-10 17:38:52,51,5797,17,34,3915.54,6621.00,0.00
2024-12-10 17:38:52,52,5797,17,35,3840.24,6621.02,0.00
2024-12-10 17:38:52,52,5798,17,35,3828.61,6622.00,0.00
2024-12-10 17:38:52,53,5798,17,36,3756.37,6622.02,0.00
2024-12-10 17:38:52,52,5798,17,35,3812.05,6622.04,0.00
2024-12-10 17:38:52,51,5798,16,35,3829.28,6622.41,0.00
2024-12-10 17:38:53,51,5799,16,35,3920.62,6623.00,0.00
2024-12-10 17:38:53,52,5799,16,36,3845.22,6623.02,0.00
2024-12-10 17:38:53,51,5799,15,36,3919.32,6623.02,0.00
2024-12-10 17:38:53,51,5800,15,36,3909.39,6624.00,0.00
2024-12-10 17:38:53,52,5800,16,36,3834.21,6624.02,0.00
2024-12-10 17:38:53,51,5800,16,35,3893.81,6624.02,0.00
2024-12-10 17:38:53,51,5801,16,35,3907.38,6625.00,0.00
2024-12-10 17:38:53,52,5801,16,36,3832.24,6625.02,0.00
2024-12-10 17:38:53,52,5802,16,36,3822.19,6626.00,0.00
2024-12-10 17:38:53,53,5802,17,36,3750.07,6626.02,0.00
2024-12-10 17:38:53,52,5802,17,35,3804.35,6626.04,0.00
2024-12-10 17:38:53,51,5802,16,35,3862.56,6626.27,0.00
2024-12-10 17:38:53,51,5803,16,35,3892.92,6627.00,0.00
2024-12-10 17:38:53,52,5803,16,36,3818.06,6627.02,0.00
2024-12-10 17:38:53,51,5803,15,36,3824.16,6627.31,0.00
2024-12-10 17:38:53,51,5804,15,36,3909.10,6628.00,0.00
2024-12-10 17:38:53,52,5804,16,36,3833.93,6628.02,0.00
2024-12-10 17:38:53,51,5804,16,35,3890.91,6628.04,0.00
2024-12-10 17:38:53,50,5804,15,35,3902.99,6628.80,0.00
2024-12-10 17:38:53,50,5805,15,35,4022.49,6629.00,0.00
2024-12-10 17:38:53,51,5805,15,36,3943.61,6629.02,0.00
2024-12-10 17:38:53,51,5806,15,36,3933.06,6630.00,0.00
2024-12-10 17:38:53,52,5806,16,36,3857.42,6630.02,0.00
2024-12-10 17:38:53,51,5806,16,35,3914.87,6630.04,0.00
2024-12-10 17:38:53,51,5807,16,35,3929.57,6631.00,0.00
2024-12-10 17:38:53,52,5807,17,35,3854.00,6631.02,0.00
2024-12-10 17:38:53,52,5808,17,35,3842.35,6632.00,0.00
2024-12-10 17:38:53,53,5808,17,36,3769.86,6632.02,0.00
2024-12-10 17:38:53,52,5808,17,35,3825.78,6632.04,0.00
2024-12-10 17:38:53,52,5809,17,35,3837.59,6633.00,0.00
2024-12-10 17:38:53,53,5809,17,36,3765.18,6633.02,0.00
2024-12-10 17:38:53,53,5810,17,36,3751.93,6634.00,0.00
2024-12-10 17:38:53,54,5810,18,36,3682.45,6634.02,0.00
2024-12-10 17:38:53,53,5810,18,35,3736.91,6634.04,0.00
2024-12-10 17:38:53,52,5810,17,35,3768.86,6634.62,0.00
2024-12-10 17:38:53,52,5811,17,35,3820.19,6635.00,0.00
2024-12-10 17:38:53,53,5811,17,36,3748.11,6635.02,0.00
2024-12-10 17:38:53,53,5812,17,36,3737.71,6636.00,0.00
2024-12-10 17:38:53,54,5812,17,37,3668.50,6636.02,0.00
2024-12-10 17:38:53,53,5812,17,36,3721.44,6636.04,0.00
2024-12-10 17:38:53,52,5812,16,36,3782.52,6636.14,0.00
2024-12-10 17:38:53,52,5813,16,36,3853.25,6637.00,0.00
2024-12-10 17:38:53,53,5813,17,36,3780.55,6637.02,0.00
2024-12-10 17:38:53,52,5813,16,36,3750.37,6637.89,0.00
2024-12-10 17:38:53,52,5814,16,36,3870.44,6638.00,0.00
2024-12-10 17:38:53,53,5814,16,37,3797.41,6638.02,0.00
2024-12-10 17:38:53,52,5814,16,36,3853.85,6638.04,0.00
2024-12-10 17:38:53,51,5814,15,36,3852.43,6638.88,0.00
2024-12-10 17:38:53,51,5815,15,36,3974.89,6639.00,0.00
2024-12-10 17:38:53,52,5815,15,37,3898.45,6639.02,0.00
2024-12-10 17:38:53,52,5816,15,37,3887.63,6640.00,0.00
2024-12-10 17:38:53,53,5816,15,38,3814.28,6640.02,0.00
2024-12-10 17:38:53,52,5816,15,37,3871.03,6640.04,0.00
2024-12-10 17:38:53,52,5817,15,37,3884.38,6641.00,0.00
2024-12-10 17:38:53,53,5817,16,37,3811.09,6641.02,0.00
2024-12-10 17:38:53,52,5817,15,37,3781.33,6641.89,0.00
2024-12-10 17:38:53,52,5818,15,37,3901.49,6642.00,0.00
2024-12-10 17:38:53,53,5818,15,38,3827.88,6642.02,0.00
2024-12-10 17:38:53,52,5818,15,37,3886.16,6642.04,0.00
2024-12-10 17:38:53,52,5819,15,37,3899.52,6643.00,0.00
2024-12-10 17:38:53,53,5819,15,38,3825.95,6643.02,0.00
2024-12-10 17:38:53,52,5819,14,38,3867.61,6643.12,0.00
2024-12-10 17:38:53,52,5820,14,38,3888.07,6644.00,0.00
2024-12-10 17:38:53,53,5820,15,38,3814.71,6644.02,0.00
2024-12-10 17:38:53,52,5820,15,37,3874.01,6644.04,0.00
2024-12-10 17:38:53,52,5821,15,37,3887.37,6645.00,0.00
2024-12-10 17:38:53,53,5821,16,37,3814.03,6645.02,0.00
2024-12-10 17:38:53,53,5822,16,37,3800.64,6646.00,0.00
2024-12-10 17:38:53,54,5822,16,38,3730.26,6646.02,0.00
2024-12-10 17:38:53,53,5822,16,37,3788.11,6646.04,0.00
2024-12-10 17:38:53,53,5823,16,37,3799.96,6647.00,0.00
2024-12-10 17:38:53,54,5823,17,37,3729.59,6647.02,0.00
2024-12-10 17:38:53,53,5823,16,37,3724.53,6647.72,0.00
2024-12-10 17:38:53,53,5824,16,37,3831.36,6648.00,0.00
2024-12-10 17:38:53,54,5824,16,38,3760.41,6648.02,0.00
2024-12-10 17:38:53,53,5824,16,37,3829.07,6648.04,0.00
2024-12-10 17:38:53,53,5825,16,37,3840.93,6649.00,0.00
2024-12-10 17:38:53,54,5825,17,37,3769.80,6649.02,0.00
2024-12-10 17:38:53,53,5825,16,37,3780.80,6649.30,0.00
2024-12-10 17:38:53,53,5826,16,37,3860.33,6650.00,0.00
2024-12-10 17:38:53,54,5826,16,38,3788.84,6650.02,0.00
2024-12-10 17:38:53,53,5826,16,37,3845.27,6650.04,0.00
2024-12-10 17:38:53,53,5827,16,37,3857.15,6651.00,0.00
2024-12-10 17:38:53,54,5827,17,37,3785.72,6651.02,0.00
2024-12-10 17:38:53,53,5827,16,37,3808.26,6651.23,0.00
2024-12-10 17:38:53,53,5828,16,37,3882.83,6652.00,0.00
2024-12-10 17:38:53,54,5828,16,38,3810.92,6652.02,0.00
2024-12-10 17:38:53,53,5828,16,37,3862.75,6652.04,0.00
2024-12-10 17:38:53,53,5829,16,37,3874.62,6653.00,0.00
2024-12-10 17:38:53,54,5829,17,37,3802.87,6653.02,0.00
2024-12-10 17:38:53,53,5829,16,37,3840.76,6653.13,0.00
2024-12-10 17:38:53,52,5829,15,37,3902.85,6653.17,0.00
2024-12-10 17:38:53,52,5830,15,37,3976.33,6654.00,0.00
2024-12-10 17:38:53,53,5830,15,38,3901.30,6654.02,0.00
2024-12-10 17:38:53,52,5830,15,37,3957.14,6654.04,0.00
2024-12-10 17:38:53,52,5831,15,37,3970.53,6655.00,0.00
2024-12-10 17:38:53,53,5831,16,37,3895.61,6655.02,0.00
2024-12-10 17:38:53,53,5832,16,37,3882.08,6656.00,0.00
2024-12-10 17:38:53,54,5832,16,38,3810.19,6656.02,0.00
2024-12-10 17:38:53,53,5832,16,37,3864.50,6656.04,0.00
2024-12-10 17:38:54,53,5833,16,37,3876.39,6657.00,0.00
2024-12-10 17:38:54,54,5833,17,37,3804.60,6657.02,0.00
2024-12-10 17:38:54,53,5833,16,37,3875.13,6657.02,0.00
2024-12-10 17:38:54,52,5833,15,37,3880.12,6657.64,0.00
2024-12-10 17:38:54,52,5834,15,37,3984.08,6658.00,0.00
2024-12-10 17:38:54,53,5834,15,38,3908.91,6658.02,0.00
2024-12-10 17:38:54,52,5834,15,37,3962.33,6658.06,0.00
2024-12-10 17:38:54,52,5835,15,37,3974.88,6659.00,0.00
2024-12-10 17:38:54,53,5835,15,38,3899.88,6659.02,0.00
2024-12-10 17:38:54,53,5836,15,38,3881.63,6660.00,0.00
2024-12-10 17:38:54,54,5836,15,39,3809.75,6660.02,0.00
2024-12-10 17:38:54,53,5836,15,38,3860.28,6660.06,0.00
2024-12-10 17:38:54,52,5836,14,38,3850.87,6660.89,0.00
2024-12-10 17:38:54,52,5837,14,38,3971.36,6661.00,0.00
2024-12-10 17:38:54,53,5837,14,39,3896.43,6661.02,0.00
2024-12-10 17:38:54,53,5838,14,39,3874.51,6662.00,0.00
2024-12-10 17:38:54,54,5838,15,39,3802.76,6662.02,0.00
2024-12-10 17:38:54,53,5838,15,38,3853.15,6662.06,0.00
2024-12-10 17:38:54,52,5838,14,38,3888.03,6662.64,0.00
2024-12-10 17:38:54,52,5839,14,38,3930.03,6663.00,0.00
2024-12-10 17:38:54,53,5839,14,39,3855.88,6663.02,0.00
2024-12-10 17:38:54,53,5840,14,39,3835.46,6664.00,0.00
2024-12-10 17:38:54,54,5840,15,39,3764.43,6664.02,0.00
2024-12-10 17:38:54,53,5840,15,38,3812.84,6664.06,0.00
2024-12-10 17:38:54,52,5840,14,38,3836.05,6664.71,0.00
2024-12-10 17:38:54,51,5840,13,38,3891.63,6664.78,0.00
2024-12-10 17:38:54,51,5841,13,38,4008.11,6665.00,0.00
2024-12-10 17:38:54,52,5841,13,39,3931.03,6665.02,0.00
2024-12-10 17:38:54,51,5841,12,39,3976.76,6665.10,0.00
2024-12-10 17:38:54,51,5842,12,39,3999.16,6666.00,0.00
2024-12-10 17:38:54,52,5842,12,40,3922.25,6666.02,0.00
2024-12-10 17:38:54,51,5842,12,39,3976.95,6666.06,0.00
2024-12-10 17:38:54,51,5843,12,39,3993.22,6667.00,0.00
2024-12-10 17:38:54,52,5843,13,39,3916.43,6667.02,0.00
2024-12-10 17:38:54,51,5843,12,39,3926.60,6667.63,0.00
2024-12-10 17:38:54,50,5843,11,39,3996.16,6667.70,0.00
2024-12-10 17:38:54,50,5844,11,39,4109.74,6668.00,0.00
2024-12-10 17:38:54,51,5844,12,39,4029.16,6668.02,0.00
2024-12-10 17:38:54,50,5844,12,38,4085.75,6668.06,0.00
2024-12-10 17:38:54,50,5845,12,38,4103.69,6669.00,0.00
2024-12-10 17:38:54,51,5845,12,39,4023.23,6669.02,0.00
2024-12-10 17:38:54,51,5846,12,39,4012.33,6670.00,0.00
2024-12-10 17:38:54,52,5846,12,40,3935.17,6670.02,0.00
2024-12-10 17:38:54,51,5846,12,39,3986.19,6670.08,0.00
2024-12-10 17:38:54,50,5846,11,39,4023.08,6670.36,0.00
2024-12-10 17:38:54,50,5847,11,39,4114.26,6671.00,0.00
2024-12-10 17:38:54,51,5847,11,40,4033.59,6671.02,0.00
2024-12-10 17:38:54,51,5848,11,40,4025.49,6672.00,0.00
2024-12-10 17:38:54,52,5848,12,40,3948.08,6672.02,0.00
2024-12-10 17:38:54,51,5848,11,40,4019.82,6672.08,0.00
2024-12-10 17:38:54,50,5848,11,39,4074.86,6672.08,0.00
2024-12-10 17:38:54,50,5849,11,39,4147.53,6673.00,0.00
2024-12-10 17:38:54,51,5849,12,39,4066.20,6673.02,0.00
2024-12-10 17:38:54,51,5850,12,39,4058.14,6674.00,0.00
2024-12-10 17:38:54,52,5850,12,40,3980.10,6674.02,0.00
2024-12-10 17:38:54,51,5850,12,39,4029.36,6674.08,0.00
2024-12-10 17:38:54,51,5851,12,39,4046.67,6675.00,0.00
2024-12-10 17:38:54,52,5851,12,40,3968.85,6675.02,0.00
2024-12-10 17:38:54,52,5852,12,40,3960.08,6676.00,0.00
2024-12-10 17:38:54,53,5852,13,40,3885.36,6676.02,0.00
2024-12-10 17:38:54,52,5852,13,39,3933.13,6676.08,0.00
2024-12-10 17:38:54,51,5852,12,39,3922.89,6676.96,0.00
2024-12-10 17:38:54,51,5853,12,39,4051.21,6677.00,0.00
2024-12-10 17:38:54,52,5853,12,40,3973.31,6677.02,0.00
2024-12-10 17:38:54,52,5854,12,40,3964.46,6678.00,0.00
2024-12-10 17:38:54,53,5854,12,41,3889.66,6678.02,0.00
2024-12-10 17:38:54,52,5854,12,40,3937.31,6678.08,0.00
2024-12-10 17:38:54,52,5855,12,40,3953.31,6679.00,0.00
2024-12-10 17:38:54,53,5855,12,41,3878.72,6679.02,0.00
2024-12-10 17:38:54,52,5855,11,41,3937.89,6679.02,0.00
2024-12-10 17:38:54,52,5856,11,41,3972.85,6680.00,0.00
2024-12-10 17:38:54,53,5856,11,42,3897.89,6680.02,0.00
2024-12-10 17:38:54,52,5856,10,42,3957.43,6680.02,0.00
2024-12-10 17:38:54,51,5856,10,41,4007.24,6680.04,0.00
2024-12-10 17:38:54,51,5857,10,41,4074.65,6681.00,0.00
2024-12-10 17:38:54,52,5857,11,41,3996.29,6681.02,0.00
2024-12-10 17:38:54,51,5857,10,41,3958.04,6681.57,0.00
2024-12-10 17:38:54,51,5858,10,41,4060.55,6682.00,0.00
2024-12-10 17:38:54,52,5858,11,41,3982.47,6682.02,0.00
2024-12-10 17:38:54,51,5858,11,40,4030.02,6682.04,0.00
2024-12-10 17:38:54,51,5859,11,40,4045.03,6683.00,0.00
2024-12-10 17:38:54,52,5859,12,40,3967.24,6683.02,0.00
2024-12-10 17:38:54,51,5859,12,39,4036.33,6683.02,0.00
2024-12-10 17:38:54,51,5860,12,39,4028.43,6684.00,0.00
2024-12-10 17:38:54,52,5860,12,40,3950.96,6684.02,0.00
2024-12-10 17:38:54,51,5860,12,39,4007.46,6684.02,0.00
2024-12-10 17:38:54,51,5861,12,39,4021.17,6685.00,0.00
2024-12-10 17:38:54,52,5861,12,40,3943.84,6685.02,0.00
2024-12-10 17:38:54,52,5862,12,40,3933.00,6686.00,0.00
2024-12-10 17:38:54,53,5862,13,40,3858.79,6686.02,0.00
2024-12-10 17:38:54,52,5862,13,39,3913.71,6686.02,0.00
2024-12-10 17:38:54,51,5862,12,39,3901.72,6686.96,0.00
2024-12-10 17:38:54,51,5863,12,39,4030.24,6687.00,0.00
2024-12-10 17:38:54,52,5863,13,39,3952.73,6687.02,0.00
2024-12-10 17:38:54,51,5863,12,39,3950.27,6687.08,0.00
2024-12-10 17:38:54,50,5863,11,39,3993.87,6687.60,0.00
2024-12-10 17:38:54,50,5864,11,39,4101.17,6688.00,0.00
2024-12-10 17:38:54,51,5864,12,39,4020.75,6688.02,0.00
2024-12-10 17:38:54,50,5864,12,38,4082.44,6688.02,0.00
2024-12-10 17:38:54,50,5865,12,38,4097.77,6689.00,0.00
2024-12-10 17:38:54,51,5865,13,38,4017.42,6689.02,0.00
2024-12-10 17:38:55,51,5866,13,38,4004.90,6690.00,0.00
2024-12-10 17:38:55,52,5866,14,38,3927.88,6690.02,0.00
2024-12-10 17:38:55,51,5866,14,37,3987.85,6690.02,0.00
2024-12-10 17:38:55,50,5866,13,37,3981.21,6690.96,0.00
2024-12-10 17:38:55,50,5867,13,37,4112.37,6691.00,0.00
2024-12-10 17:38:55,51,5867,13,38,4031.74,6691.02,0.00
2024-12-10 17:38:55,50,5867,12,38,4046.60,6691.60,0.00
2024-12-10 17:38:55,50,5868,12,38,4100.44,6692.00,0.00
2024-12-10 17:38:55,51,5868,12,39,4020.04,6692.02,0.00
2024-12-10 17:38:55,50,5868,12,38,4084.38,6692.02,0.00
2024-12-10 17:38:55,50,5869,12,38,4099.72,6693.00,0.00
2024-12-10 17:38:55,51,5869,12,39,4019.33,6693.02,0.00
2024-12-10 17:38:55,50,5869,11,39,4018.22,6693.38,0.00
2024-12-10 17:38:55,50,5870,11,39,4111.04,6694.00,0.00
2024-12-10 17:38:55,51,5870,12,39,4030.43,6694.02,0.00
2024-12-10 17:38:55,50,5870,12,38,4094.97,6694.02,0.00
2024-12-10 17:38:55,50,5871,12,38,4110.31,6695.00,0.00
2024-12-10 17:38:55,51,5871,13,38,4029.72,6695.02,0.00
2024-12-10 17:38:55,51,5872,13,38,4017.19,6696.00,0.00
2024-12-10 17:38:55,52,5872,14,38,3939.94,6696.02,0.00
2024-12-10 17:38:55,51,5872,14,37,4001.44,6696.02,0.00
2024-12-10 17:38:55,51,5873,14,37,4015.17,6697.00,0.00
2024-12-10 17:38:55,52,5873,14,38,3937.95,6697.02,0.00
2024-12-10 17:38:55,52,5874,14,38,3924.37,6698.00,0.00
2024-12-10 17:38:55,53,5874,15,38,3850.32,6698.02,0.00
2024-12-10 17:38:55,52,5874,15,37,3908.91,6698.02,0.00
2024-12-10 17:38:55,51,5874,14,37,3912.49,6698.86,0.00
2024-12-10 17:38:55,51,5875,14,37,4034.75,6699.00,0.00
2024-12-10 17:38:55,52,5875,15,37,3957.16,6699.02,0.00
2024-12-10 17:38:55,52,5876,15,37,3944.41,6700.00,0.00
2024-12-10 17:38:55,53,5876,15,38,3869.98,6700.02,0.00
2024-12-10 17:38:55,52,5876,15,37,3927.66,6700.02,0.00
2024-12-10 17:38:55,51,5876,14,37,3964.43,6700.61,0.00
2024-12-10 17:38:55,51,5877,14,37,4017.27,6701.00,0.00
2024-12-10 17:38:55,52,5877,14,38,3940.01,6701.02,0.00
2024-12-10 17:38:55,52,5878,14,38,3926.42,6702.00,0.00
2024-12-10 17:38:55,53,5878,14,39,3852.34,6702.02,0.00
2024-12-10 17:38:55,52,5878,14,38,3910.96,6702.02,0.00
2024-12-10 17:38:55,51,5878,13,38,3901.47,6702.96,0.00
2024-12-10 17:38:55,51,5879,13,38,4030.30,6703.00,0.00
2024-12-10 17:38:55,52,5879,13,39,3952.79,6703.02,0.00
2024-12-10 17:38:55,51,5879,12,39,3990.91,6703.16,0.00
2024-12-10 17:38:55,51,5880,12,39,4066.39,6704.00,0.00
2024-12-10 17:38:55,52,5880,12,40,3988.19,6704.02,0.00
2024-12-10 17:38:55,52,5881,12,40,3974.60,6705.00,0.00
2024-12-10 17:38:55,53,5881,13,40,3899.61,6705.02,0.00
2024-12-10 17:38:55,52,5881,13,39,3957.84,6705.04,0.00
2024-12-10 17:38:55,51,5881,12,39,3981.94,6705.75,0.00
2024-12-10 17:38:55,51,5882,12,39,4096.53,6706.00,0.00
2024-12-10 17:38:55,52,5882,13,39,4017.75,6706.02,0.00
2024-12-10 17:38:55,51,5882,12,39,3994.94,6706.88,0.00
2024-12-10 17:38:55,51,5883,12,39,4118.65,6707.00,0.00
2024-12-10 17:38:55,52,5883,12,40,4039.45,6707.02,0.00
2024-12-10 17:38:55,51,5883,12,39,4098.94,6707.06,0.00
2024-12-10 17:38:55,51,5884,12,39,4115.32,6708.00,0.00
2024-12-10 17:38:55,52,5884,13,39,4036.18,6708.02,0.00
2024-12-10 17:38:55,52,5885,13,39,4022.59,6709.00,0.00
2024-12-10 17:38:55,53,5885,14,39,3946.69,6709.02,0.00
2024-12-10 17:38:55,53,5886,14,39,3932.09,6710.00,0.00
2024-12-10 17:38:55,54,5886,15,39,3859.27,6710.02,0.00
2024-12-10 17:38:55,53,5886,15,38,3924.49,6710.02,0.00
2024-12-10 17:38:55,53,5887,15,38,3935.08,6711.00,0.00
2024-12-10 17:38:55,54,5887,16,38,3862.21,6711.02,0.00
2024-12-10 17:38:55,53,5887,16,37,3924.95,6711.02,0.00
2024-12-10 17:38:55,53,5888,16,37,3934.98,6712.00,0.00
2024-12-10 17:38:55,54,5888,16,38,3862.11,6712.02,0.00
2024-12-10 17:38:55,53,5888,16,37,3923.59,6712.02,0.00
2024-12-10 17:38:55,53,5889,16,37,3933.83,6713.00,0.00
2024-12-10 17:38:55,54,5889,17,37,3860.98,6713.02,0.00
2024-12-10 17:38:55,54,5890,17,37,3845.39,6714.00,0.00
2024-12-10 17:38:55,55,5890,17,38,3775.48,6714.02,0.00
2024-12-10 17:38:55,54,5890,17,37,3834.20,6714.02,0.00
2024-12-10 17:38:55,54,5891,17,37,3843.48,6715.00,0.00
2024-12-10 17:38:55,55,5891,18,37,3773.60,6715.02,0.00
2024-12-10 17:38:55,55,5892,18,37,3757.07,6716.00,0.00
2024-12-10 17:38:55,56,5892,18,38,3689.98,6716.02,0.00
2024-12-10 17:38:55,55,5892,18,37,3747.30,6716.02,0.00
2024-12-10 17:38:55,55,5893,18,37,3755.18,6717.00,0.00
2024-12-10 17:38:55,56,5893,19,37,3688.13,6717.02,0.00
2024-12-10 17:38:55,55,5893,18,37,3660.38,6717.85,0.00
2024-12-10 17:38:55,55,5894,18,37,3772.84,6718.00,0.00
2024-12-10 17:38:55,56,5894,18,38,3705.47,6718.02,0.00
2024-12-10 17:38:55,55,5894,18,37,3761.85,6718.02,0.00
2024-12-10 17:38:55,56,5893,19,37,3663.69,6718.52,0.00
2024-12-10 17:38:55,56,5894,19,37,3743.22,6719.00,0.00
2024-12-10 17:38:55,57,5894,20,37,3677.55,6719.02,0.00
2024-12-10 17:38:55,57,5895,20,37,3777.12,6720.00,0.00
2024-12-10 17:38:55,58,5895,20,38,3712.00,6720.02,0.00
2024-12-10 17:38:55,57,5895,20,37,3768.51,6720.02,0.00
2024-12-10 17:38:55,57,5896,20,37,3773.79,6721.00,0.00
2024-12-10 17:38:55,58,5896,21,37,3708.72,6721.02,0.00
2024-12-10 17:38:55,58,5897,21,37,3689.91,6722.00,0.00
2024-12-10 17:38:55,59,5897,21,38,3627.37,6722.02,0.00
2024-12-10 17:38:55,58,5897,21,37,3679.48,6722.02,0.00
2024-12-10 17:38:55,57,5897,20,37,3722.54,6722.21,0.00
2024-12-10 17:38:55,57,5898,20,37,3787.89,6723.00,0.00
2024-12-10 17:38:55,58,5898,21,37,3722.58,6723.02,0.00
2024-12-10 17:38:55,58,5899,21,37,3704.37,6724.00,0.00
2024-12-10 17:38:55,59,5899,21,38,3641.58,6724.02,0.00
2024-12-10 17:38:55,58,5899,21,37,3693.94,6724.02,0.00
2024-12-10 17:38:56,58,5900,21,37,3697.96,6725.00,0.00
2024-12-10 17:38:56,59,5900,22,37,3635.29,6725.02,0.00
2024-12-10 17:38:56,58,5900,21,37,3629.88,6725.67,0.00
2024-12-10 17:38:56,58,5901,21,37,3679.30,6726.00,0.00
2024-12-10 17:38:56,59,5901,21,38,3616.94,6726.02,0.00
2024-12-10 17:38:56,58,5901,21,37,3668.86,6726.02,0.00
2024-12-10 17:38:56,58,5902,21,37,3672.89,6727.00,0.00
2024-12-10 17:38:56,59,5902,21,38,3610.63,6727.02,0.00
2024-12-10 17:38:56,59,5903,21,38,3592.43,6728.00,0.00
2024-12-10 17:38:56,60,5903,21,39,3532.55,6728.02,0.00
2024-12-10 17:38:56,59,5903,21,38,3582.16,6728.02,0.00
2024-12-10 17:38:56,58,5903,20,38,3566.23,6728.90,0.00
2024-12-10 17:38:56,58,5904,20,38,3675.35,6729.00,0.00
2024-12-10 17:38:56,59,5904,20,39,3613.06,6729.02,0.00
2024-12-10 17:38:56,58,5904,19,39,3616.30,6729.33,0.00
2024-12-10 17:38:56,57,5904,18,39,3656.33,6729.67,0.00
2024-12-10 17:38:56,57,5905,18,39,3752.20,6730.00,0.00
2024-12-10 17:38:56,58,5905,19,39,3687.50,6730.02,0.00
2024-12-10 17:38:56,57,5905,19,38,3741.57,6730.02,0.00
2024-12-10 17:38:56,56,5905,18,38,3760.46,6730.39,0.00
2024-12-10 17:38:56,56,5906,18,38,3840.20,6731.00,0.00
2024-12-10 17:38:56,57,5906,19,38,3772.83,6731.02,0.00
2024-12-10 17:38:56,57,5907,19,38,3754.49,6732.00,0.00
2024-12-10 17:38:56,58,5907,20,38,3689.76,6732.02,0.00
2024-12-10 17:38:56,57,5907,20,37,3745.04,6732.02,0.00
2024-12-10 17:38:56,56,5907,19,37,3799.95,6732.18,0.00
2024-12-10 17:38:56,56,5908,19,37,3817.29,6733.00,0.00
2024-12-10 17:38:56,57,5908,19,38,3750.32,6733.02,0.00
2024-12-10 17:38:56,57,5909,19,38,3731.90,6734.00,0.00
2024-12-10 17:38:56,58,5909,20,38,3667.56,6734.02,0.00
2024-12-10 17:38:56,57,5909,20,37,3723.63,6734.02,0.00
2024-12-10 17:38:56,57,5910,20,37,3726.86,6735.00,0.00
2024-12-10 17:38:56,58,5910,20,38,3662.60,6735.02,0.00
2024-12-10 17:38:56,58,5911,20,38,3639.50,6736.00,0.00
2024-12-10 17:38:56,59,5911,21,38,3577.81,6736.02,0.00
2024-12-10 17:38:56,58,5911,21,37,3632.53,6736.02,0.00
2024-12-10 17:38:56,58,5912,21,37,3631.22,6737.00,0.00
2024-12-10 17:38:56,59,5912,21,38,3569.67,6737.02,0.00
2024-12-10 17:38:56,58,5912,20,38,3537.85,6737.81,0.00
2024-12-10 17:38:56,58,5913,20,38,3641.39,6738.00,0.00
2024-12-10 17:38:56,59,5913,20,39,3579.67,6738.02,0.00
2024-12-10 17:38:56,58,5913,20,38,3633.26,6738.04,0.00
2024-12-10 17:38:56,57,5913,19,38,3651.23,6738.70,0.00
2024-12-10 17:38:56,56,5913,18,38,3677.17,6738.91,0.00
2024-12-10 17:38:56,56,5914,18,38,3791.56,6739.00,0.00
2024-12-10 17:38:56,57,5914,19,38,3725.04,6739.02,0.00
2024-12-10 17:38:56,57,5915,19,38,3697.48,6740.00,0.00
2024-12-10 17:38:56,58,5915,19,39,3633.73,6740.02,0.00
2024-12-10 17:38:56,57,5915,19,38,3689.21,6740.04,0.00
2024-12-10 17:38:56,57,5916,19,38,3685.65,6741.00,0.00
2024-12-10 17:38:56,58,5916,19,39,3622.10,6741.02,0.00
2024-12-10 17:38:56,57,5916,18,39,3573.31,6741.68,0.00
2024-12-10 17:38:56,57,5917,18,39,3670.53,6742.00,0.00
2024-12-10 17:38:56,58,5917,18,40,3607.25,6742.02,0.00
2024-12-10 17:38:56,57,5917,18,39,3653.99,6742.09,0.00
2024-12-10 17:38:56,56,5917,17,39,3684.06,6742.32,0.00
2024-12-10 17:38:56,56,5918,17,39,3759.15,6743.00,0.00
2024-12-10 17:38:56,57,5918,18,39,3693.20,6743.02,0.00
2024-12-10 17:38:56,57,5919,18,39,3678.87,6744.00,0.00
2024-12-10 17:38:56,58,5919,19,39,3615.45,6744.02,0.00
2024-12-10 17:38:56,57,5919,19,38,3661.14,6744.09,0.00
2024-12-10 17:38:56,57,5920,19,38,3671.14,6745.00,0.00
2024-12-10 17:38:56,58,5920,19,39,3607.84,6745.02,0.00
2024-12-10 17:38:56,57,5920,18,39,3603.46,6745.67,0.00
2024-12-10 17:38:56,57,5921,18,39,3657.03,6746.00,0.00
2024-12-10 17:38:56,58,5921,18,40,3593.98,6746.02,0.00
2024-12-10 17:38:56,57,5921,18,39,3640.47,6746.09,0.00
2024-12-10 17:38:56,56,5921,17,39,3700.08,6746.16,0.00
2024-12-10 17:38:56,55,5921,16,39,3704.65,6746.84,0.00
2024-12-10 17:38:56,55,5922,16,39,3816.41,6747.00,0.00
2024-12-10 17:38:56,56,5922,16,40,3748.26,6747.02,0.00
2024-12-10 17:38:56,55,5922,15,40,3713.75,6747.87,0.00
2024-12-10 17:38:56,55,5923,15,40,3827.96,6748.00,0.00
2024-12-10 17:38:56,56,5923,15,41,3759.60,6748.02,0.00
2024-12-10 17:38:56,55,5923,15,40,3810.79,6748.09,0.00
2024-12-10 17:38:56,55,5924,15,40,3823.61,6749.00,0.00
2024-12-10 17:38:56,56,5924,16,40,3755.34,6749.02,0.00
2024-12-10 17:38:56,56,5925,16,40,3739.47,6750.00,0.00
2024-12-10 17:38:56,57,5925,16,41,3673.87,6750.02,0.00
2024-12-10 17:38:56,56,5925,16,40,3723.81,6750.09,0.00
2024-12-10 17:38:56,56,5926,16,40,3735.20,6751.00,0.00
2024-12-10 17:38:56,57,5926,16,41,3669.67,6751.02,0.00
2024-12-10 17:38:56,57,5927,16,41,3653.55,6752.00,0.00
2024-12-10 17:38:56,58,5927,16,42,3590.56,6752.02,0.00
2024-12-10 17:38:56,57,5927,16,41,3639.34,6752.09,0.00
2024-12-10 17:38:56,56,5927,15,41,3661.31,6752.70,0.00
2024-12-10 17:38:56,56,5928,15,41,3761.63,6753.00,0.00
2024-12-10 17:38:56,57,5928,15,42,3695.64,6753.02,0.00
2024-12-10 17:38:56,57,5929,15,42,3679.00,6754.00,0.00
2024-12-10 17:38:56,58,5929,15,43,3615.57,6754.02,0.00
2024-12-10 17:38:56,57,5929,15,42,3665.98,6754.09,0.00
2024-12-10 17:38:56,56,5929,14,42,3654.13,6754.93,0.00
2024-12-10 17:38:56,56,5930,14,42,3769.99,6755.00,0.00
2024-12-10 17:38:56,57,5930,14,43,3703.84,6755.02,0.00
2024-12-10 17:38:56,57,5931,14,43,3714.72,6756.00,0.00
2024-12-10 17:38:56,58,5931,14,44,3650.68,6756.02,0.00
2024-12-10 17:38:56,57,5931,13,44,3665.30,6756.12,0.00
2024-12-10 17:38:56,56,5931,12,44,3727.15,6756.18,0.00
2024-12-10 17:38:56,56,5932,12,44,3792.82,6757.00,0.00
2024-12-10 17:38:56,57,5932,12,45,3726.28,6757.02,0.00
2024-12-10 17:38:56,56,5932,11,45,3737.40,6757.30,0.00
2024-12-10 17:38:56,56,5933,11,45,3811.48,6758.00,0.00
2024-12-10 17:38:57,57,5933,11,46,3744.62,6758.02,0.00
2024-12-10 17:38:57,56,5933,11,45,3805.46,6758.09,0.00
2024-12-10 17:38:57,56,5934,11,45,3816.87,6759.00,0.00
2024-12-10 17:38:57,57,5934,11,46,3749.91,6759.02,0.00
2024-12-10 17:38:57,56,5934,10,46,3735.89,6759.75,0.00
2024-12-10 17:38:57,56,5935,10,46,3839.92,6760.00,0.00
2024-12-10 17:38:57,57,5935,11,46,3772.55,6760.02,0.00
2024-12-10 17:38:57,56,5935,11,45,3827.85,6760.09,0.00
2024-12-10 17:38:57,55,5935,10,45,3826.38,6760.58,0.00
2024-12-10 17:38:57,55,5936,10,45,3921.38,6761.00,0.00
2024-12-10 17:38:57,56,5936,11,45,3851.35,6761.02,0.00
2024-12-10 17:38:57,55,5936,10,45,3853.88,6761.38,0.00
2024-12-10 17:38:57,55,5937,10,45,3935.48,6762.00,0.00
2024-12-10 17:38:57,56,5937,10,46,3865.21,6762.02,0.00
2024-12-10 17:38:57,55,5937,9,46,3934.25,6762.02,0.00
2024-12-10 17:38:57,54,5937,9,45,3990.83,6762.07,0.00
2024-12-10 17:38:57,54,5938,9,45,4003.48,6763.00,0.00
2024-12-10 17:38:57,55,5938,9,46,3930.69,6763.02,0.00
2024-12-10 17:38:57,55,5939,9,46,3914.78,6764.00,0.00
2024-12-10 17:38:57,56,5939,9,47,3844.87,6764.02,0.00
2024-12-10 17:38:57,55,5939,9,46,3900.02,6764.07,0.00
2024-12-10 17:38:57,54,5939,8,46,3889.39,6764.96,0.00
2024-12-10 17:38:57,54,5940,8,46,4012.19,6765.00,0.00
2024-12-10 17:38:57,55,5940,9,46,3939.24,6765.02,0.00
2024-12-10 17:38:57,55,5941,9,46,3926.24,6766.00,0.00
2024-12-10 17:38:57,56,5941,9,47,3856.13,6766.02,0.00
2024-12-10 17:38:57,55,5941,9,46,3925.01,6766.02,0.00
2024-12-10 17:38:57,54,5941,9,45,3977.66,6766.09,0.00
2024-12-10 17:38:57,54,5942,9,45,3992.02,6767.00,0.00
2024-12-10 17:38:57,55,5942,10,45,3919.44,6767.02,0.00
2024-12-10 17:38:57,56,5941,10,46,3765.37,6767.95,0.00
2024-12-10 17:38:57,56,5942,10,46,3841.70,6768.00,0.00
2024-12-10 17:38:57,57,5942,11,46,3774.30,6768.02,0.00
2024-12-10 17:38:57,56,5942,11,45,3821.17,6768.09,0.00
2024-12-10 17:38:57,56,5943,11,45,3953.47,6769.00,0.00
2024-12-10 17:38:57,57,5943,11,46,3884.12,6769.02,0.00
2024-12-10 17:38:57,56,5943,11,45,3952.27,6769.02,0.00
2024-12-10 17:38:57,56,5944,11,45,3938.64,6770.00,0.00
2024-12-10 17:38:57,57,5944,11,46,3869.54,6770.02,0.00
2024-12-10 17:38:57,56,5944,11,45,3937.43,6770.02,0.00
2024-12-10 17:38:57,55,5944,11,44,3991.79,6770.06,0.00
2024-12-10 17:38:57,55,5945,11,44,4002.22,6771.00,0.00
2024-12-10 17:38:57,56,5945,11,45,3930.75,6771.02,0.00
2024-12-10 17:38:57,55,5945,10,45,3970.24,6771.13,0.00
2024-12-10 17:38:57,54,5945,9,45,3961.24,6771.96,0.00
2024-12-10 17:38:57,54,5946,9,45,4084.16,6772.00,0.00
2024-12-10 17:38:57,55,5946,10,45,4009.90,6772.02,0.00
2024-12-10 17:38:57,54,5946,10,44,4067.87,6772.06,0.00
2024-12-10 17:38:57,54,5947,10,44,4079.75,6773.00,0.00
2024-12-10 17:38:57,55,5947,11,44,4005.57,6773.02,0.00
2024-12-10 17:38:57,55,5948,11,44,3989.51,6774.00,0.00
2024-12-10 17:38:57,56,5948,12,44,3918.27,6774.02,0.00
2024-12-10 17:38:57,55,5948,12,43,3972.28,6774.07,0.00
2024-12-10 17:38:57,54,5948,11,43,4042.10,6774.13,0.00
2024-12-10 17:38:57,54,5949,11,43,4058.97,6775.00,0.00
2024-12-10 17:38:57,55,5949,12,43,3985.17,6775.02,0.00
2024-12-10 17:38:57,54,5949,11,43,3961.44,6775.83,0.00
2024-12-10 17:38:57,54,5950,11,43,4075.74,6776.00,0.00
2024-12-10 17:38:57,55,5950,12,43,4001.63,6776.02,0.00
2024-12-10 17:38:57,54,5950,12,42,4056.93,6776.07,0.00
2024-12-10 17:38:57,54,5951,12,42,4070.06,6777.00,0.00
2024-12-10 17:38:57,55,5951,13,42,3996.06,6777.02,0.00
2024-12-10 17:38:57,55,5952,13,42,3982.89,6778.00,0.00
2024-12-10 17:38:57,56,5952,14,42,3911.77,6778.02,0.00
2024-12-10 17:38:57,55,5952,14,41,3959.49,6778.09,0.00
2024-12-10 17:38:57,54,5952,13,41,4030.32,6778.13,0.00
2024-12-10 17:38:57,54,5953,13,41,4047.20,6779.00,0.00
2024-12-10 17:38:57,55,5953,13,42,3973.62,6779.02,0.00
2024-12-10 17:38:57,54,5953,12,42,4023.35,6779.04,0.00
2024-12-10 17:38:57,54,5954,12,42,4059.10,6780.00,0.00
2024-12-10 17:38:57,55,5954,12,43,3985.30,6780.02,0.00
2024-12-10 17:38:57,54,5954,11,43,4016.42,6780.06,0.00
2024-12-10 17:38:57,53,5954,11,42,4073.01,6780.06,0.00
2024-12-10 17:38:57,53,5955,11,42,4137.58,6781.00,0.00
2024-12-10 17:38:57,54,5955,11,43,4060.96,6781.02,0.00
2024-12-10 17:38:57,54,5956,11,43,4046.70,6782.00,0.00
2024-12-10 17:38:57,55,5956,12,43,3973.12,6782.02,0.00
2024-12-10 17:38:57,54,5956,12,42,4025.35,6782.06,0.00
2024-12-10 17:38:57,54,5957,12,42,4037.25,6783.00,0.00
2024-12-10 17:38:57,55,5957,13,42,3963.84,6783.02,0.00
2024-12-10 17:38:57,55,5958,13,42,3950.55,6784.00,0.00
2024-12-10 17:38:57,56,5958,14,42,3880.00,6784.02,0.00
2024-12-10 17:38:57,55,5958,14,41,3929.58,6784.06,0.00
2024-12-10 17:38:57,55,5959,14,41,3940.03,6785.00,0.00
2024-12-10 17:38:57,56,5959,15,41,3869.67,6785.02,0.00
2024-12-10 17:38:57,55,5959,14,41,3866.38,6785.69,0.00
2024-12-10 17:38:57,55,5960,14,41,3968.99,6786.00,0.00
2024-12-10 17:38:57,56,5960,14,42,3898.11,6786.02,0.00
2024-12-10 17:38:57,55,5960,14,41,3948.47,6786.06,0.00
2024-12-10 17:38:57,55,5961,14,41,3958.92,6787.00,0.00
2024-12-10 17:38:57,56,5961,15,41,3888.22,6787.02,0.00
2024-12-10 17:38:57,56,5962,15,41,3874.87,6788.00,0.00
2024-12-10 17:38:57,57,5962,16,41,3806.89,6788.02,0.00
2024-12-10 17:38:57,56,5962,16,40,3852.36,6788.05,0.00
2024-12-10 17:38:57,56,5963,16,40,3861.41,6789.00,0.00
2024-12-10 17:38:57,57,5963,16,41,3793.66,6789.02,0.00
2024-12-10 17:38:57,56,5963,16,40,3857.26,6789.02,0.00
2024-12-10 17:38:57,55,5963,15,40,3886.70,6789.15,0.00
2024-12-10 17:38:57,55,5964,15,40,3952.66,6790.00,0.00
2024-12-10 17:38:57,56,5964,15,41,3882.08,6790.02,0.00
2024-12-10 17:38:57,56,5965,15,41,3869.57,6791.00,0.00
2024-12-10 17:38:57,57,5965,16,41,3801.69,6791.02,0.00
2024-12-10 17:38:57,56,5965,16,40,3845.64,6791.05,0.00
2024-12-10 17:38:58,55,5965,15,40,3829.25,6791.95,0.00
2024-12-10 17:38:58,55,5966,15,40,3949.08,6792.00,0.00
2024-12-10 17:38:58,56,5966,16,40,3878.56,6792.02,0.00
2024-12-10 17:38:58,56,5967,16,40,3862.82,6793.00,0.00
2024-12-10 17:38:58,57,5967,16,41,3795.05,6793.02,0.00
2024-12-10 17:38:58,56,5967,16,40,3841.28,6793.04,0.00
2024-12-10 17:38:58,55,5967,15,40,3868.87,6793.66,0.00
2024-12-10 17:38:58,55,5968,15,40,3919.74,6794.00,0.00
2024-12-10 17:38:58,56,5968,16,40,3849.75,6794.02,0.00
2024-12-10 17:38:58,55,5968,16,39,3919.74,6794.02,0.00
2024-12-10 17:38:58,55,5969,16,39,3905.77,6795.00,0.00
2024-12-10 17:38:58,56,5969,16,40,3836.03,6795.02,0.00
2024-12-10 17:38:58,55,5969,16,39,3889.71,6795.02,0.00
2024-12-10 17:38:58,54,5969,15,39,3872.67,6795.96,0.00
2024-12-10 17:38:58,54,5970,15,39,3996.02,6796.00,0.00
2024-12-10 17:38:58,55,5970,15,40,3923.36,6796.02,0.00
2024-12-10 17:38:58,54,5970,15,39,3979.66,6796.02,0.00
2024-12-10 17:38:58,54,5971,15,39,3989.05,6797.00,0.00
2024-12-10 17:38:58,55,5971,16,39,3916.53,6797.02,0.00
2024-12-10 17:38:58,55,5972,16,39,3899.82,6798.00,0.00
2024-12-10 17:38:58,56,5972,16,40,3830.18,6798.02,0.00
2024-12-10 17:38:58,55,5972,16,39,3884.99,6798.02,0.00
2024-12-10 17:38:58,54,5972,15,39,3870.35,6798.61,0.00
2024-12-10 17:38:58,54,5973,15,39,3970.08,6799.00,0.00
2024-12-10 17:38:58,55,5973,15,40,3897.90,6799.02,0.00
2024-12-10 17:38:58,55,5974,15,40,3884.14,6800.00,0.00
2024-12-10 17:38:58,56,5974,16,40,3814.78,6800.02,0.00
2024-12-10 17:38:58,55,5974,16,39,3866.83,6800.02,0.00
2024-12-10 17:38:58,54,5974,15,39,3896.25,6800.63,0.00
2024-12-10 17:38:58,53,5974,14,39,3969.55,6800.64,0.00
2024-12-10 17:38:58,52,5974,13,39,4006.31,6800.90,0.00
2024-12-10 17:38:58,52,5975,13,39,4130.64,6801.00,0.00
2024-12-10 17:38:58,53,5975,14,39,4052.70,6801.02,0.00
2024-12-10 17:38:58,52,5975,13,39,4086.84,6801.14,0.00
2024-12-10 17:38:58,52,5976,13,39,4159.35,6802.00,0.00
2024-12-10 17:38:58,53,5976,13,40,4080.87,6802.02,0.00
2024-12-10 17:38:58,52,5976,13,39,4141.03,6802.02,0.00
2024-12-10 17:38:58,52,5977,13,39,4153.42,6803.00,0.00
2024-12-10 17:38:58,53,5977,13,40,4075.05,6803.02,0.00
2024-12-10 17:38:58,53,5978,13,40,4060.25,6804.00,0.00
2024-12-10 17:38:58,54,5978,13,41,3985.06,6804.02,0.00
2024-12-10 17:38:58,53,5978,13,40,4042.27,6804.02,0.00
2024-12-10 17:38:58,53,5979,13,40,4053.14,6805.00,0.00
2024-12-10 17:38:58,54,5979,14,40,3978.08,6805.02,0.00
2024-12-10 17:38:58,53,5979,13,40,3945.82,6805.92,0.00
2024-12-10 17:38:58,53,5980,13,40,4069.14,6806.00,0.00
2024-12-10 17:38:58,54,5980,14,40,3993.79,6806.02,0.00
2024-12-10 17:38:58,53,5980,14,39,4052.45,6806.02,0.00
2024-12-10 17:38:58,53,5981,14,39,4063.32,6807.00,0.00
2024-12-10 17:38:58,54,5981,15,39,3988.07,6807.02,0.00
2024-12-10 17:38:58,54,5982,15,39,3972.27,6808.00,0.00
2024-12-10 17:38:58,55,5982,16,39,3900.05,6808.02,0.00
2024-12-10 17:38:58,54,5982,16,38,3955.88,6808.02,0.00
2024-12-10 17:38:58,54,5983,16,38,3965.29,6809.00,0.00
2024-12-10 17:38:58,55,5983,16,39,3893.19,6809.02,0.00
2024-12-10 17:38:58,55,5984,16,39,3876.43,6810.00,0.00
2024-12-10 17:38:58,56,5984,17,39,3807.21,6810.02,0.00
2024-12-10 17:38:58,55,5984,17,38,3861.57,6810.02,0.00
2024-12-10 17:38:58,54,5984,16,38,3861.66,6810.85,0.00
2024-12-10 17:38:58,54,5985,16,38,3977.80,6811.00,0.00
2024-12-10 17:38:58,55,5985,17,38,3905.48,6811.02,0.00
2024-12-10 17:38:58,55,5986,17,38,3888.71,6812.00,0.00
2024-12-10 17:38:58,56,5986,17,39,3819.27,6812.02,0.00
2024-12-10 17:38:58,55,5986,17,38,3875.09,6812.02,0.00
2024-12-10 17:38:58,55,5987,17,38,3883.09,6813.00,0.00
2024-12-10 17:38:58,56,5987,17,39,3813.75,6813.02,0.00
2024-12-10 17:38:58,56,5988,17,39,3797.45,6814.00,0.00
2024-12-10 17:38:58,57,5988,18,39,3730.83,6814.02,0.00
2024-12-10 17:38:58,56,5988,18,38,3782.85,6814.02,0.00
2024-12-10 17:38:58,56,5989,18,38,3789.49,6815.00,0.00
2024-12-10 17:38:58,57,5989,19,38,3723.00,6815.02,0.00
2024-12-10 17:38:58,57,5990,19,38,3706.84,6816.00,0.00
2024-12-10 17:38:58,58,5990,19,39,3642.93,6816.02,0.00
2024-12-10 17:38:58,57,5990,19,38,3693.69,6816.02,0.00
2024-12-10 17:38:58,56,5990,18,38,3678.32,6816.59,0.00
2024-12-10 17:38:58,56,5991,18,38,3772.34,6817.00,0.00
2024-12-10 17:38:58,57,5991,19,38,3706.16,6817.02,0.00
2024-12-10 17:38:58,57,5992,19,38,3690.08,6818.00,0.00
2024-12-10 17:38:58,58,5992,20,38,3626.45,6818.02,0.00
2024-12-10 17:38:58,57,5992,20,37,3678.12,6818.02,0.00
2024-12-10 17:38:58,57,5993,20,37,3683.44,6819.00,0.00
2024-12-10 17:38:58,58,5993,20,38,3619.93,6819.02,0.00
2024-12-10 17:38:58,58,5994,20,38,3602.81,6820.00,0.00
2024-12-10 17:38:58,59,5994,21,38,3541.75,6820.02,0.00
2024-12-10 17:38:58,58,5994,21,37,3592.23,6820.02,0.00
2024-12-10 17:38:58,58,5995,21,37,3596.28,6821.00,0.00
2024-12-10 17:38:58,59,5995,22,37,3535.33,6821.02,0.00
2024-12-10 17:38:58,59,5996,22,37,3519.28,6822.00,0.00
2024-12-10 17:38:58,60,5996,22,38,3460.63,6822.02,0.00
2024-12-10 17:38:58,59,5996,22,37,3508.87,6822.02,0.00
2024-12-10 17:38:58,59,5997,22,37,3511.70,6823.00,0.00
2024-12-10 17:38:58,60,5997,22,38,3453.17,6823.02,0.00
2024-12-10 17:38:58,59,5997,21,38,3477.10,6823.17,0.00
2024-12-10 17:38:58,59,5998,21,38,3494.49,6824.00,0.00
2024-12-10 17:38:58,60,5998,22,38,3436.25,6824.02,0.00
2024-12-10 17:38:58,59,5998,22,37,3485.23,6824.02,0.00
2024-12-10 17:38:58,59,5999,22,37,3488.06,6825.00,0.00
2024-12-10 17:38:58,60,5999,22,38,3429.92,6825.02,0.00
2024-12-10 17:38:58,59,5999,21,38,3418.96,6825.68,0.00
2024-12-10 17:38:59,59,6000,21,38,3470.32,6826.00,0.00
2024-12-10 17:38:59,60,6000,22,38,3412.48,6826.02,0.00
2024-12-10 17:38:59,59,6000,22,37,3462.22,6826.02,0.00
2024-12-10 17:38:59,59,6001,22,37,3465.04,6827.00,0.00
2024-12-10 17:38:59,60,6001,23,37,3407.29,6827.02,0.00
2024-12-10 17:38:59,59,6001,22,37,3353.01,6827.97,0.00
2024-12-10 17:38:59,59,6002,22,37,3466.45,6828.00,0.00
2024-12-10 17:38:59,60,6002,23,37,3408.67,6828.02,0.00
2024-12-10 17:38:59,59,6002,23,36,3459.50,6828.02,0.00
2024-12-10 17:38:59,59,6003,23,36,3462.32,6829.00,0.00
2024-12-10 17:38:59,60,6003,24,36,3404.62,6829.02,0.00
2024-12-10 17:38:59,59,6003,23,36,3394.33,6829.66,0.00
2024-12-10 17:38:59,59,6004,23,36,3444.14,6830.00,0.00
2024-12-10 17:38:59,60,6004,24,36,3386.74,6830.02,0.00
2024-12-10 17:38:59,59,6004,24,35,3438.36,6830.02,0.00
2024-12-10 17:38:59,58,6004,23,35,3454.18,6830.66,0.00
2024-12-10 17:38:59,58,6005,23,35,3501.52,6831.00,0.00
2024-12-10 17:38:59,59,6005,23,36,3442.17,6831.02,0.00
2024-12-10 17:38:59,59,6006,23,36,3423.67,6832.00,0.00
2024-12-10 17:38:59,60,6006,23,37,3366.61,6832.02,0.00
2024-12-10 17:38:59,59,6006,23,36,3419.04,6832.02,0.00
2024-12-10 17:38:59,58,6006,22,36,3453.80,6832.26,0.00
2024-12-10 17:38:59,58,6007,22,36,3521.39,6833.00,0.00
2024-12-10 17:38:59,59,6007,23,36,3461.71,6833.02,0.00
2024-12-10 17:38:59,58,6007,22,36,3432.21,6833.83,0.00
2024-12-10 17:38:59,58,6008,22,36,3538.40,6834.00,0.00
2024-12-10 17:38:59,59,6008,23,36,3478.43,6834.02,0.00
2024-12-10 17:38:59,58,6008,23,35,3534.87,6834.02,0.00
2024-12-10 17:38:59,58,6009,23,35,3538.92,6835.00,0.00
2024-12-10 17:38:59,59,6009,23,36,3478.94,6835.02,0.00
2024-12-10 17:38:59,58,6009,22,36,3462.51,6835.41,0.00
2024-12-10 17:38:59,58,6010,22,36,3540.68,6836.00,0.00
2024-12-10 17:38:59,59,6010,22,37,3480.67,6836.02,0.00
2024-12-10 17:38:59,58,6010,22,36,3538.32,6836.02,0.00
2024-12-10 17:38:59,57,6010,21,36,3587.46,6836.19,0.00
2024-12-10 17:38:59,56,6010,20,36,3651.52,6836.20,0.00
2024-12-10 17:38:59,56,6011,20,36,3670.31,6837.00,0.00
2024-12-10 17:38:59,57,6011,21,36,3605.92,6837.02,0.00
2024-12-10 17:38:59,57,6012,21,36,3587.26,6838.00,0.00
2024-12-10 17:38:59,58,6012,21,37,3525.41,6838.02,0.00
2024-12-10 17:38:59,57,6012,21,36,3586.06,6838.02,0.00
2024-12-10 17:38:59,57,6013,21,36,3591.38,6839.00,0.00
2024-12-10 17:38:59,58,6013,22,36,3529.46,6839.02,0.00
2024-12-10 17:38:59,57,6013,22,35,3566.18,6839.02,0.00
2024-12-10 17:38:59,57,6014,22,35,3571.50,6840.00,0.00
2024-12-10 17:38:59,58,6014,22,36,3509.93,6840.02,0.00
2024-12-10 17:38:59,57,6014,21,36,3523.58,6840.26,0.00
2024-12-10 17:38:59,57,6015,21,36,3593.63,6841.00,0.00
2024-12-10 17:38:59,58,6015,22,36,3531.67,6841.02,0.00
2024-12-10 17:38:59,57,6015,22,35,3591.23,6841.02,0.00
2024-12-10 17:38:59,57,6016,22,35,3596.56,6842.00,0.00
2024-12-10 17:38:59,58,6016,22,36,3534.55,6842.02,0.00
2024-12-10 17:38:59,57,6016,21,36,3530.02,6842.63,0.00
2024-12-10 17:38:59,57,6017,21,36,3579.45,6843.00,0.00
2024-12-10 17:38:59,58,6017,21,37,3517.74,6843.02,0.00
2024-12-10 17:38:59,57,6017,21,36,3573.45,6843.02,0.00
2024-12-10 17:38:59,56,6017,20,36,3593.72,6843.64,0.00
2024-12-10 17:38:59,56,6018,20,36,3642.87,6844.00,0.00
2024-12-10 17:38:59,57,6018,21,36,3578.96,6844.02,0.00
2024-12-10 17:38:59,56,6018,21,35,3617.21,6844.02,0.00
2024-12-10 17:38:59,55,6018,20,35,3671.82,6844.18,0.00
2024-12-10 17:38:59,54,6018,19,35,3661.77,6844.96,0.00
2024-12-10 17:38:59,54,6019,19,35,3786.01,6845.00,0.00
2024-12-10 17:38:59,55,6019,20,35,3717.17,6845.02,0.00
2024-12-10 17:38:59,54,6019,19,35,3724.00,6845.32,0.00
2024-12-10 17:38:59,54,6020,19,35,3804.31,6846.00,0.00
2024-12-10 17:38:59,55,6020,19,36,3735.14,6846.02,0.00
2024-12-10 17:38:59,54,6020,19,35,3803.05,6846.02,0.00
2024-12-10 17:38:59,54,6021,19,35,3812.48,6847.00,0.00
2024-12-10 17:38:59,55,6021,20,35,3743.16,6847.02,0.00
2024-12-10 17:38:59,54,6021,20,34,3785.85,6847.02,0.00
2024-12-10 17:38:59,54,6022,20,34,3795.28,6848.00,0.00
2024-12-10 17:38:59,55,6022,21,34,3726.27,6848.02,0.00
2024-12-10 17:38:59,55,6023,21,34,3709.38,6849.00,0.00
2024-12-10 17:38:59,56,6023,22,34,3643.15,6849.02,0.00
2024-12-10 17:38:59,55,6023,22,33,3708.14,6849.02,0.00
2024-12-10 17:38:59,55,6024,22,33,3716.15,6850.00,0.00
2024-12-10 17:38:59,56,6024,22,34,3649.79,6850.02,0.00
2024-12-10 17:38:59,55,6024,22,33,3690.00,6850.02,0.00
2024-12-10 17:38:59,55,6025,22,33,3698.01,6851.00,0.00
2024-12-10 17:38:59,56,6025,23,33,3631.98,6851.02,0.00
2024-12-10 17:38:59,55,6025,23,32,3671.85,6851.02,0.00
2024-12-10 17:38:59,54,6025,22,32,3652.82,6851.96,0.00
2024-12-10 17:38:59,54,6026,22,32,3777.19,6852.00,0.00
2024-12-10 17:38:59,55,6026,23,32,3708.52,6852.02,0.00
2024-12-10 17:38:59,54,6026,22,32,3708.69,6852.07,0.00
2024-12-10 17:38:59,54,6027,22,32,3772.67,6853.00,0.00
2024-12-10 17:38:59,55,6027,23,32,3704.07,6853.02,0.00
2024-12-10 17:38:59,54,6027,23,31,3763.79,6853.02,0.00
2024-12-10 17:38:59,54,6028,23,31,3773.22,6854.00,0.00
2024-12-10 17:38:59,55,6028,23,32,3704.62,6854.02,0.00
2024-12-10 17:38:59,54,6028,22,32,3701.18,6854.69,0.00
2024-12-10 17:38:59,54,6029,22,32,3756.44,6855.00,0.00
2024-12-10 17:38:59,55,6029,23,32,3688.15,6855.02,0.00
2024-12-10 17:38:59,54,6029,23,31,3748.83,6855.02,0.00
2024-12-10 17:38:59,54,6030,23,31,3758.26,6856.00,0.00
2024-12-10 17:38:59,55,6030,24,31,3689.93,6856.02,0.00
2024-12-10 17:38:59,54,6030,23,31,3664.73,6856.83,0.00
2024-12-10 17:38:59,54,6031,23,31,3780.40,6857.00,0.00
2024-12-10 17:38:59,55,6031,24,31,3711.66,6857.02,0.00
2024-12-10 17:38:59,54,6031,24,30,3774.05,6857.02,0.00
2024-12-10 17:38:59,54,6032,24,30,3783.49,6858.00,0.00
2024-12-10 17:38:59,55,6032,25,30,3714.70,6858.02,0.00
2024-12-10 17:39:00,55,6033,25,30,3699.35,6859.00,0.00
2024-12-10 17:39:00,56,6033,26,30,3633.29,6859.02,0.00
2024-12-10 17:39:00,55,6033,26,29,3688.13,6859.04,0.00
2024-12-10 17:39:00,55,6034,26,29,3697.39,6860.00,0.00
2024-12-10 17:39:00,56,6034,26,30,3631.37,6860.02,0.00
2024-12-10 17:39:00,56,6035,26,30,3617.77,6861.00,0.00
2024-12-10 17:39:00,57,6035,27,30,3554.30,6861.02,0.00
2024-12-10 17:39:00,56,6035,27,29,3605.52,6861.04,0.00
2024-12-10 17:39:00,55,6035,26,29,3605.78,6861.46,0.00
2024-12-10 17:39:00,55,6036,26,29,3693.48,6862.00,0.00
2024-12-10 17:39:00,56,6036,26,30,3627.53,6862.02,0.00
2024-12-10 17:39:00,55,6036,25,30,3625.36,6862.33,0.00
2024-12-10 17:39:00,55,6037,25,30,3704.41,6863.00,0.00
2024-12-10 17:39:00,56,6037,26,30,3638.26,6863.02,0.00
2024-12-10 17:39:00,55,6037,26,29,3693.18,6863.04,0.00
2024-12-10 17:39:00,54,6037,25,29,3746.38,6863.19,0.00
2024-12-10 17:39:00,54,6038,25,29,3818.05,6864.00,0.00
2024-12-10 17:39:00,55,6038,25,30,3748.63,6864.02,0.00
2024-12-10 17:39:00,54,6038,24,30,3754.59,6864.32,0.00
2024-12-10 17:39:00,54,6039,24,30,3835.13,6865.00,0.00
2024-12-10 17:39:00,55,6039,24,31,3765.40,6865.02,0.00
2024-12-10 17:39:00,54,6039,24,30,3822.42,6865.04,0.00
2024-12-10 17:39:00,53,6039,23,30,3863.40,6865.26,0.00
2024-12-10 17:39:00,53,6040,23,30,3942.91,6866.00,0.00
2024-12-10 17:39:00,54,6040,24,30,3869.89,6866.02,0.00
2024-12-10 17:39:00,53,6040,23,30,3898.92,6866.19,0.00
2024-12-10 17:39:00,53,6041,23,30,3973.28,6867.00,0.00
2024-12-10 17:39:00,54,6041,23,31,3899.70,6867.02,0.00
2024-12-10 17:39:00,53,6041,23,30,3960.33,6867.04,0.00
2024-12-10 17:39:00,53,6042,23,30,3972.57,6868.00,0.00
2024-12-10 17:39:00,54,6042,24,30,3899.00,6868.02,0.00
2024-12-10 17:39:00,54,6042,24,30,3883.27,6869.00,0.00
2024-12-10 17:39:00,55,6042,24,31,3812.66,6869.02,0.00
2024-12-10 17:39:00,54,6042,24,30,3871.82,6869.04,0.00
2024-12-10 17:39:00,53,6042,23,30,3858.34,6869.96,0.00
2024-12-10 17:39:00,53,6043,23,30,3985.39,6870.00,0.00
2024-12-10 17:39:00,54,6043,23,31,3911.59,6870.02,0.00
2024-12-10 17:39:00,54,6044,23,31,3896.37,6871.00,0.00
2024-12-10 17:39:00,55,6044,23,32,3825.53,6871.02,0.00
2024-12-10 17:39:00,54,6044,23,31,3884.92,6871.04,0.00
2024-12-10 17:39:00,53,6044,22,31,3917.98,6871.62,0.00
2024-12-10 17:39:00,53,6045,22,31,3970.13,6872.00,0.00
2024-12-10 17:39:00,54,6045,22,32,3896.61,6872.02,0.00
2024-12-10 17:39:00,53,6045,21,32,3936.45,6872.13,0.00
2024-12-10 17:39:00,52,6045,20,32,3924.95,6872.64,0.00
2024-12-10 17:39:00,52,6046,20,32,4032.29,6873.00,0.00
2024-12-10 17:39:00,53,6046,20,33,3956.21,6873.02,0.00
2024-12-10 17:39:00,52,6046,20,32,4021.72,6873.04,0.00
2024-12-10 17:39:00,51,6046,19,32,4057.01,6873.31,0.00
2024-12-10 17:39:00,51,6047,19,32,4145.09,6874.00,0.00
2024-12-10 17:39:00,52,6047,19,33,4065.38,6874.02,0.00
2024-12-10 17:39:00,51,6047,18,33,4058.99,6874.41,0.00
2024-12-10 17:39:00,50,6047,17,33,4126.06,6874.62,0.00
2024-12-10 17:39:00,50,6048,17,33,4237.75,6875.00,0.00
2024-12-10 17:39:00,51,6048,18,33,4154.65,6875.02,0.00
2024-12-10 17:39:00,50,6048,18,32,4225.38,6875.04,0.00
2024-12-10 17:39:00,49,6048,17,32,4264.03,6875.35,0.00
2024-12-10 17:39:00,49,6048,17,32,4359.94,6876.00,0.00
2024-12-10 17:39:00,50,6048,17,33,4272.74,6876.02,0.00
2024-12-10 17:39:00,50,6049,17,33,4260.50,6877.00,0.00
2024-12-10 17:39:00,51,6049,17,34,4176.97,6877.02,0.00
2024-12-10 17:39:00,50,6049,17,33,4249.50,6877.04,0.00
2024-12-10 17:39:00,50,6050,17,33,4265.45,6878.00,0.00
2024-12-10 17:39:00,51,6050,17,34,4181.82,6878.02,0.00
2024-12-10 17:39:00,51,6051,17,34,4167.18,6879.00,0.00
2024-12-10 17:39:00,52,6051,17,35,4087.04,6879.02,0.00
2024-12-10 17:39:00,51,6051,17,34,4157.73,6879.04,0.00
2024-12-10 17:39:00,50,6051,16,34,4217.56,6879.20,0.00
2024-12-10 17:39:00,50,6052,16,34,4300.61,6880.00,0.00
2024-12-10 17:39:00,51,6052,16,35,4216.28,6880.02,0.00
2024-12-10 17:39:00,50,6052,15,35,4293.73,6880.02,0.00
2024-12-10 17:39:00,50,6053,15,35,4337.01,6881.00,0.00
2024-12-10 17:39:00,51,6053,15,36,4251.98,6881.02,0.00
2024-12-10 17:39:00,50,6053,15,35,4324.63,6881.02,0.00
2024-12-10 17:39:00,50,6054,15,35,4340.40,6882.00,0.00
2024-12-10 17:39:00,51,6054,15,36,4255.29,6882.02,0.00
2024-12-10 17:39:00,50,6054,14,36,4290.90,6882.18,0.00
2024-12-10 17:39:00,50,6055,14,36,4372.69,6883.00,0.00
2024-12-10 17:39:00,51,6055,15,36,4286.95,6883.02,0.00
2024-12-10 17:39:00,50,6055,14,36,4289.10,6883.72,0.00
2024-12-10 17:39:00,50,6056,14,36,4407.75,6884.00,0.00
2024-12-10 17:39:00,51,6056,15,36,4321.32,6884.02,0.00
2024-12-10 17:39:00,50,6056,15,35,4392.60,6884.04,0.00
2024-12-10 17:39:00,50,6057,15,35,4409.76,6885.00,0.00
2024-12-10 17:39:00,51,6057,16,35,4323.30,6885.02,0.00
2024-12-10 17:39:00,51,6058,16,35,4310.42,6886.00,0.00
2024-12-10 17:39:00,52,6058,16,36,4227.53,6886.02,0.00
2024-12-10 17:39:00,51,6058,16,35,4300.97,6886.02,0.00
2024-12-10 17:39:00,51,6059,16,35,4315.10,6887.00,0.00
2024-12-10 17:39:00,52,6059,16,36,4232.12,6887.02,0.00
2024-12-10 17:39:00,51,6059,16,35,4301.60,6887.02,0.00
2024-12-10 17:39:01,51,6060,16,35,4315.73,6888.00,0.00
2024-12-10 17:39:01,52,6060,17,35,4232.73,6888.02,0.00
2024-12-10 17:39:01,51,6060,16,35,4281.98,6888.10,0.00
2024-12-10 17:39:01,51,6061,16,35,4301.49,6889.00,0.00
2024-12-10 17:39:01,52,6061,17,35,4218.77,6889.02,0.00
2024-12-10 17:39:01,51,6061,17,34,4286.63,6889.02,0.00
2024-12-10 17:39:01,50,6061,16,34,4291.64,6889.90,0.00
2024-12-10 17:39:01,50,6062,16,34,4422.61,6890.00,0.00
2024-12-10 17:39:01,51,6062,16,35,4335.89,6890.02,0.00
2024-12-10 17:39:01,52,6061,16,36,4190.49,6890.58,0.00
2024-12-10 17:39:01,52,6062,16,36,4274.33,6891.00,0.00
2024-12-10 17:39:01,53,6062,16,37,4193.68,6891.02,0.00
2024-12-10 17:39:01,52,6062,16,36,4258.43,6891.02,0.00
2024-12-10 17:39:01,52,6063,16,36,4403.51,6892.00,0.00
2024-12-10 17:39:01,53,6063,17,36,4320.43,6892.02,0.00
2024-12-10 17:39:01,53,6064,17,36,4305.45,6893.00,0.00
2024-12-10 17:39:01,54,6064,18,36,4225.72,6893.02,0.00
2024-12-10 17:39:01,53,6064,18,35,4291.14,6893.02,0.00
2024-12-10 17:39:01,53,6065,18,35,4302.17,6894.00,0.00
2024-12-10 17:39:01,54,6065,18,36,4222.50,6894.02,0.00
2024-12-10 17:39:01,54,6066,18,36,4206.51,6895.00,0.00
2024-12-10 17:39:01,55,6066,18,37,4130.03,6895.02,0.00
2024-12-10 17:39:01,54,6066,18,36,4192.47,6895.02,0.00
2024-12-10 17:39:01,53,6066,17,36,4258.60,6895.11,0.00
2024-12-10 17:39:01,52,6066,16,36,4303.67,6895.64,0.00
2024-12-10 17:39:01,52,6067,16,36,4411.37,6896.00,0.00
2024-12-10 17:39:01,53,6067,16,37,4328.14,6896.02,0.00
2024-12-10 17:39:01,52,6067,15,37,4346.48,6896.25,0.00
2024-12-10 17:39:01,52,6068,15,37,4427.93,6897.00,0.00
2024-12-10 17:39:01,53,6068,16,37,4344.38,6897.02,0.00
2024-12-10 17:39:01,52,6068,16,36,4408.03,6897.02,0.00
2024-12-10 17:39:01,51,6068,15,36,4449.95,6897.27,0.00
2024-12-10 17:39:01,51,6069,15,36,4535.69,6898.00,0.00
2024-12-10 17:39:01,52,6069,15,37,4448.47,6898.02,0.00
2024-12-10 17:39:01,52,6070,15,37,4434.52,6899.00,0.00
2024-12-10 17:39:01,53,6070,16,37,4350.85,6899.02,0.00
2024-12-10 17:39:01,52,6070,16,36,4415.95,6899.02,0.00
2024-12-10 17:39:01,51,6070,15,36,4458.00,6899.27,0.00
2024-12-10 17:39:01,51,6071,15,36,4543.77,6900.00,0.00
2024-12-10 17:39:01,52,6071,15,37,4456.39,6900.02,0.00
2024-12-10 17:39:01,52,6072,15,37,4442.44,6901.00,0.00
2024-12-10 17:39:01,53,6072,16,37,4358.62,6901.02,0.00
2024-12-10 17:39:01,52,6072,16,36,4422.53,6901.02,0.00
2024-12-10 17:39:01,52,6073,16,36,4435.12,6902.00,0.00
2024-12-10 17:39:01,53,6073,16,37,4351.44,6902.02,0.00
2024-12-10 17:39:01,52,6073,15,37,4358.27,6902.33,0.00
2024-12-10 17:39:01,52,6074,15,37,4445.06,6903.00,0.00
2024-12-10 17:39:01,53,6074,15,38,4361.19,6903.02,0.00
2024-12-10 17:39:01,52,6074,15,37,4426.47,6903.02,0.00
2024-12-10 17:39:01,52,6075,15,37,4439.06,6904.00,0.00
2024-12-10 17:39:01,53,6075,15,38,4355.31,6904.02,0.00
2024-12-10 17:39:01,53,6076,15,38,4340.30,6905.00,0.00
2024-12-10 17:39:01,54,6076,16,38,4259.93,6905.02,0.00
2024-12-10 17:39:01,53,6076,16,37,4322.06,6905.02,0.00
2024-12-10 17:39:01,52,6076,15,37,4401.22,6905.08,0.00
2024-12-10 17:39:01,51,6076,14,37,4462.60,6905.20,0.00
2024-12-10 17:39:01,50,6076,13,37,4523.12,6905.60,0.00
2024-12-10 17:39:01,50,6077,13,37,4633.92,6906.00,0.00
2024-12-10 17:39:01,51,6077,14,37,4543.06,6906.02,0.00
2024-12-10 17:39:01,51,6078,14,37,4530.18,6907.00,0.00
2024-12-10 17:39:01,52,6078,15,37,4443.06,6907.02,0.00
2024-12-10 17:39:01,51,6078,15,36,4511.22,6907.02,0.00
2024-12-10 17:39:01,50,6078,14,36,4595.94,6907.08,0.00
2024-12-10 17:39:01,50,6079,14,36,4615.92,6908.00,0.00
2024-12-10 17:39:01,51,6079,14,37,4525.41,6908.02,0.00
2024-12-10 17:39:01,51,6080,14,37,4512.52,6909.00,0.00
2024-12-10 17:39:01,52,6080,14,38,4425.74,6909.02,0.00
2024-12-10 17:39:01,51,6080,14,37,4493.56,6909.02,0.00
2024-12-10 17:39:01,51,6081,14,37,4507.76,6910.00,0.00
2024-12-10 17:39:01,52,6081,15,37,4421.07,6910.02,0.00
2024-12-10 17:39:01,51,6081,14,37,4418.80,6910.77,0.00
2024-12-10 17:39:01,51,6082,14,37,4538.22,6911.00,0.00
2024-12-10 17:39:01,52,6082,14,38,4450.95,6911.02,0.00
2024-12-10 17:39:01,51,6082,14,37,4520.60,6911.02,0.00
2024-12-10 17:39:01,51,6083,14,37,4534.81,6912.00,0.00
2024-12-10 17:39:01,52,6083,14,38,4447.60,6912.02,0.00
2024-12-10 17:39:01,52,6084,14,38,4433.62,6913.00,0.00
2024-12-10 17:39:01,53,6084,14,39,4349.97,6913.02,0.00
2024-12-10 17:39:01,52,6084,14,38,4415.01,6913.02,0.00
2024-12-10 17:39:01,51,6084,13,38,4412.74,6913.96,0.00
2024-12-10 17:39:01,51,6085,13,38,4545.61,6914.00,0.00
2024-12-10 17:39:01,52,6085,14,38,4458.20,6914.02,0.00
2024-12-10 17:39:02,52,6086,14,38,4444.21,6915.00,0.00
2024-12-10 17:39:02,53,6086,15,38,4360.36,6915.02,0.00
2024-12-10 17:39:02,52,6086,15,37,4422.94,6915.02,0.00
2024-12-10 17:39:02,52,6087,15,37,4435.55,6916.00,0.00
2024-12-10 17:39:02,53,6087,15,38,4351.86,6916.02,0.00
2024-12-10 17:39:02,52,6087,14,38,4354.42,6916.04,0.00
2024-12-10 17:39:02,52,6088,14,38,4421.56,6917.00,0.00
2024-12-10 17:39:02,53,6088,15,38,4338.13,6917.02,0.00
2024-12-10 17:39:02,53,6089,15,38,4328.54,6918.00,0.00
2024-12-10 17:39:02,54,6089,15,39,4248.38,6918.02,0.00
2024-12-10 17:39:02,53,6089,14,39,4211.15,6918.59,0.00
2024-12-10 17:39:02,53,6090,14,39,4313.28,6919.00,0.00
2024-12-10 17:39:02,54,6090,15,39,4233.40,6919.02,0.00
2024-12-10 17:39:02,53,6090,15,38,4308.06,6919.06,0.00
2024-12-10 17:39:02,52,6090,14,38,4348.69,6919.65,0.00
2024-12-10 17:39:02,52,6091,14,38,4404.84,6920.00,0.00
2024-12-10 17:39:02,53,6091,14,39,4321.73,6920.02,0.00
2024-12-10 17:39:02,53,6092,14,39,4310.43,6921.00,0.00
2024-12-10 17:39:02,54,6092,15,39,4230.61,6921.02,0.00
2024-12-10 17:39:02,53,6092,14,39,4211.58,6921.47,0.00
2024-12-10 17:39:02,53,6093,14,39,4306.00,6922.00,0.00
2024-12-10 17:39:02,54,6093,15,39,4226.26,6922.02,0.00
2024-12-10 17:39:02,53,6093,15,38,4300.80,6922.08,0.00
2024-12-10 17:39:02,53,6094,15,38,4315.77,6923.00,0.00
2024-12-10 17:39:02,54,6094,16,38,4235.85,6923.02,0.00
2024-12-10 17:39:02,54,6095,16,38,4251.27,6924.00,0.00
2024-12-10 17:39:02,55,6095,17,38,4173.98,6924.02,0.00
2024-12-10 17:39:02,54,6095,17,37,4237.17,6924.02,0.00
2024-12-10 17:39:02,54,6096,17,37,4246.76,6925.00,0.00
2024-12-10 17:39:02,55,6096,17,38,4169.54,6925.02,0.00
2024-12-10 17:39:02,55,6097,17,38,4162.29,6926.00,0.00
2024-12-10 17:39:02,56,6097,17,39,4087.96,6926.02,0.00
2024-12-10 17:39:02,56,6098,17,39,4070.00,6927.00,0.00
2024-12-10 17:39:02,57,6098,17,40,3998.59,6927.02,0.00
2024-12-10 17:39:02,56,6098,17,39,4062.59,6927.05,0.00
2024-12-10 17:39:02,55,6098,16,39,4044.09,6927.95,0.00
2024-12-10 17:39:02,55,6099,16,39,4166.31,6928.00,0.00
2024-12-10 17:39:02,56,6099,16,40,4091.91,6928.02,0.00
2024-12-10 17:39:02,56,6100,16,40,4076.90,6929.00,0.00
2024-12-10 17:39:02,57,6100,16,41,4005.37,6929.02,0.00
2024-12-10 17:39:02,56,6100,16,40,4053.40,6929.05,0.00
2024-12-10 17:39:02,55,6100,15,40,4108.88,6929.31,0.00
2024-12-10 17:39:02,55,6101,15,40,4137.07,6930.00,0.00
2024-12-10 17:39:02,56,6101,16,40,4063.19,6930.02,0.00
2024-12-10 17:39:02,56,6102,16,40,4048.61,6931.00,0.00
2024-12-10 17:39:02,57,6102,16,41,3977.59,6931.02,0.00
2024-12-10 17:39:02,56,6102,16,40,4025.11,6931.05,0.00
2024-12-10 17:39:02,56,6103,16,40,4034.34,6932.00,0.00
2024-12-10 17:39:02,57,6103,16,41,3963.57,6932.02,0.00
2024-12-10 17:39:02,56,6103,15,41,3957.76,6932.39,0.00
2024-12-10 17:39:02,56,6104,15,41,4039.88,6933.00,0.00
2024-12-10 17:39:02,57,6104,16,41,3969.00,6933.02,0.00
2024-12-10 17:39:02,56,6104,16,40,4016.36,6933.05,0.00
2024-12-10 17:39:02,56,6105,16,40,4025.60,6934.00,0.00
2024-12-10 17:39:02,57,6105,16,41,3954.98,6934.02,0.00
2024-12-10 17:39:02,56,6105,15,41,3935.42,6934.46,0.00
2024-12-10 17:39:02,56,6106,15,41,4022.47,6935.00,0.00
2024-12-10 17:39:02,57,6106,15,42,3951.90,6935.02,0.00
2024-12-10 17:39:02,56,6106,14,42,3993.98,6935.02,0.00
2024-12-10 17:39:02,55,6106,14,41,4045.17,6935.04,0.00
2024-12-10 17:39:02,55,6107,14,41,4105.02,6936.00,0.00
2024-12-10 17:39:02,56,6107,15,41,4031.72,6936.02,0.00
2024-12-10 17:39:02,56,6108,15,41,4017.32,6937.00,0.00
2024-12-10 17:39:02,57,6108,15,42,3946.84,6937.02,0.00
2024-12-10 17:39:02,56,6108,15,41,3997.51,6937.04,0.00
2024-12-10 17:39:02,56,6109,15,41,4005.51,6938.00,0.00
2024-12-10 17:39:02,57,6109,16,41,3935.24,6938.02,0.00
2024-12-10 17:39:02,57,6110,16,41,3920.42,6939.00,0.00
2024-12-10 17:39:02,58,6110,16,42,3852.82,6939.02,0.00
2024-12-10 17:39:02,57,6110,16,41,3902.16,6939.04,0.00
2024-12-10 17:39:02,57,6111,16,41,3908.81,6940.00,0.00
2024-12-10 17:39:02,58,6111,17,41,3841.42,6940.02,0.00
2024-12-10 17:39:02,57,6111,16,41,3882.02,6940.02,0.00
2024-12-10 17:39:02,57,6112,16,41,3911.81,6941.00,0.00
2024-12-10 17:39:02,58,6112,16,42,3844.36,6941.02,0.00
2024-12-10 17:39:02,57,6112,16,41,3895.98,6941.02,0.00
2024-12-10 17:39:02,57,6113,16,41,3901.41,6942.00,0.00
2024-12-10 17:39:03,58,6113,17,41,3834.14,6942.02,0.00
2024-12-10 17:39:03,57,6113,16,41,3817.65,6942.40,0.00
2024-12-10 17:39:03,56,6113,15,41,3870.58,6942.63,0.00
2024-12-10 17:39:03,56,6114,15,41,3968.80,6943.00,0.00
2024-12-10 17:39:03,57,6114,16,41,3899.17,6943.02,0.00
2024-12-10 17:39:03,56,6114,16,40,3953.92,6943.02,0.00
2024-12-10 17:39:03,56,6115,16,40,3960.69,6944.00,0.00
2024-12-10 17:39:03,57,6115,17,40,3891.20,6944.02,0.00
2024-12-10 17:39:03,56,6115,16,40,3915.18,6944.18,0.00
2024-12-10 17:39:03,56,6116,16,40,3982.66,6945.00,0.00
2024-12-10 17:39:03,57,6116,16,41,3912.79,6945.02,0.00
2024-12-10 17:39:03,56,6116,16,40,3967.77,6945.02,0.00
2024-12-10 17:39:03,56,6117,16,40,3974.55,6946.00,0.00
2024-12-10 17:39:03,57,6117,16,41,3904.82,6946.02,0.00
2024-12-10 17:39:03,57,6118,16,41,3886.97,6947.00,0.00
2024-12-10 17:39:03,58,6118,17,41,3819.96,6947.02,0.00
2024-12-10 17:39:03,57,6118,17,40,3873.57,6947.02,0.00
2024-12-10 17:39:03,56,6118,16,40,3854.08,6947.96,0.00
2024-12-10 17:39:03,56,6119,16,40,3975.69,6948.00,0.00
2024-12-10 17:39:03,57,6119,17,40,3905.94,6948.02,0.00
2024-12-10 17:39:03,57,6120,17,40,3887.97,6949.00,0.00
2024-12-10 17:39:03,58,6120,17,41,3820.93,6949.02,0.00
2024-12-10 17:39:03,57,6120,17,40,3875.77,6949.02,0.00
2024-12-10 17:39:03,56,6120,16,40,3870.01,6949.88,0.00
2024-12-10 17:39:03,56,6121,16,40,3985.52,6950.00,0.00
2024-12-10 17:39:03,57,6121,16,41,3915.60,6950.02,0.00
2024-12-10 17:39:03,56,6121,15,41,3912.64,6950.70,0.00
2024-12-10 17:39:03,56,6122,15,41,3966.94,6951.00,0.00
2024-12-10 17:39:03,57,6122,16,41,3897.34,6951.02,0.00
2024-12-10 17:39:03,56,6122,16,40,3955.77,6951.02,0.00
2024-12-10 17:39:03,56,6123,16,40,3962.54,6952.00,0.00
2024-12-10 17:39:03,57,6123,16,41,3893.03,6952.02,0.00
2024-12-10 17:39:03,57,6124,16,41,3874.07,6953.00,0.00
2024-12-10 17:39:03,58,6124,17,41,3807.27,6953.02,0.00
2024-12-10 17:39:03,57,6124,17,40,3864.31,6953.02,0.00
2024-12-10 17:39:03,57,6125,17,40,3869.75,6954.00,0.00
2024-12-10 17:39:03,58,6125,18,40,3803.03,6954.02,0.00
2024-12-10 17:39:03,58,6126,18,40,3783.68,6955.00,0.00
2024-12-10 17:39:03,59,6126,19,40,3719.55,6955.02,0.00
2024-12-10 17:39:03,58,6126,19,39,3775.29,6955.02,0.00
2024-12-10 17:39:03,57,6126,18,39,3772.89,6955.51,0.00
2024-12-10 17:39:03,57,6127,18,39,3861.10,6956.00,0.00
2024-12-10 17:39:03,58,6127,19,39,3794.52,6956.02,0.00
2024-12-10 17:39:03,58,6128,19,39,3775.13,6957.00,0.00
2024-12-10 17:39:03,59,6128,20,39,3711.15,6957.02,0.00
2024-12-10 17:39:03,58,6128,20,38,3767.94,6957.02,0.00
2024-12-10 17:39:03,57,6128,19,38,3791.16,6957.63,0.00
2024-12-10 17:39:03,57,6129,19,38,3839.03,6958.00,0.00
2024-12-10 17:39:03,58,6129,19,39,3772.84,6958.02,0.00
2024-12-10 17:39:03,58,6130,19,39,3754.39,6959.00,0.00
2024-12-10 17:39:03,59,6130,20,39,3690.76,6959.02,0.00
2024-12-10 17:39:03,58,6130,20,38,3744.79,6959.02,0.00
2024-12-10 17:39:03,58,6131,20,38,3748.93,6960.00,0.00
2024-12-10 17:39:03,59,6131,21,38,3685.39,6960.02,0.00
2024-12-10 17:39:03,59,6132,21,38,3666.67,6961.00,0.00
2024-12-10 17:39:03,60,6132,22,38,3605.56,6961.02,0.00
2024-12-10 17:39:03,59,6132,22,37,3658.42,6961.02,0.00
2024-12-10 17:39:03,59,6133,22,37,3661.30,6962.00,0.00
2024-12-10 17:39:03,60,6133,22,38,3600.28,6962.02,0.00
2024-12-10 17:39:03,60,6134,22,38,3582.92,6963.00,0.00
2024-12-10 17:39:03,61,6134,22,39,3524.19,6963.02,0.00
2024-12-10 17:39:03,60,6134,22,38,3573.64,6963.02,0.00
2024-12-10 17:39:03,60,6135,22,38,3575.31,6964.00,0.00
2024-12-10 17:39:03,61,6135,23,38,3516.70,6964.02,0.00
2024-12-10 17:39:03,61,6136,23,38,3498.13,6965.00,0.00
2024-12-10 17:39:03,62,6136,24,38,3441.71,6965.02,0.00
2024-12-10 17:39:03,61,6136,24,37,3491.28,6965.02,0.00
2024-12-10 17:39:03,61,6137,24,37,3491.78,6966.00,0.00
2024-12-10 17:39:03,62,6137,24,38,3435.46,6966.02,0.00
2024-12-10 17:39:03,62,6138,24,38,3416.92,6967.00,0.00
2024-12-10 17:39:03,63,6138,24,39,3362.68,6967.02,0.00
2024-12-10 17:39:03,62,6138,24,38,3411.30,6967.02,0.00
2024-12-10 17:39:03,61,6138,23,38,3458.13,6967.15,0.00
2024-12-10 17:39:03,60,6138,22,38,3483.41,6967.62,0.00
2024-12-10 17:39:03,59,6138,21,38,3500.58,6967.92,0.00
2024-12-10 17:39:03,59,6139,21,38,3612.84,6968.00,0.00
2024-12-10 17:39:03,60,6139,21,39,3552.63,6968.02,0.00
2024-12-10 17:39:03,59,6139,20,39,3579.81,6968.15,0.00
2024-12-10 17:39:03,60,6138,20,40,3494.77,6968.55,0.00
2024-12-10 17:39:03,59,6138,19,40,3620.27,6968.75,0.00
2024-12-10 17:39:03,59,6139,19,40,3720.85,6969.00,0.00
2024-12-10 17:39:03,60,6139,20,40,3658.83,6969.02,0.00
2024-12-10 17:39:03,59,6139,20,39,3713.76,6969.02,0.00
2024-12-10 17:39:03,58,6139,19,39,3731.77,6969.67,0.00
2024-12-10 17:39:03,58,6140,19,39,3901.43,6970.00,0.00
2024-12-10 17:39:03,59,6140,19,40,3835.31,6970.02,0.00
2024-12-10 17:39:03,59,6141,19,40,3814.88,6971.00,0.00
2024-12-10 17:39:03,60,6141,20,40,3751.29,6971.02,0.00
2024-12-10 17:39:03,59,6141,20,39,3808.97,6971.02,0.00
2024-12-10 17:39:03,58,6141,19,39,3831.31,6971.64,0.00
2024-12-10 17:39:03,58,6142,19,39,3878.45,6972.00,0.00
2024-12-10 17:39:03,59,6142,19,40,3812.71,6972.02,0.00
2024-12-10 17:39:03,58,6142,18,40,3766.89,6972.97,0.00
2024-12-10 17:39:03,58,6143,18,40,3884.72,6973.00,0.00
2024-12-10 17:39:03,59,6143,19,40,3818.88,6973.02,0.00
2024-12-10 17:39:03,58,6143,19,39,3879.91,6973.02,0.00
2024-12-10 17:39:03,58,6144,19,39,3884.08,6974.00,0.00
2024-12-10 17:39:03,59,6144,20,39,3818.24,6974.02,0.00
2024-12-10 17:39:04,59,6145,20,39,3797.51,6975.00,0.00
2024-12-10 17:39:04,60,6145,21,39,3734.22,6975.02,0.00
2024-12-10 17:39:04,59,6145,21,38,3792.78,6975.02,0.00
2024-12-10 17:39:04,58,6145,20,38,3847.40,6975.17,0.00
2024-12-10 17:39:04,57,6145,19,38,3913.68,6975.18,0.00
2024-12-10 17:39:04,57,6146,19,38,3930.10,6976.00,0.00
2024-12-10 17:39:04,58,6146,19,39,3862.34,6976.02,0.00
2024-12-10 17:39:04,58,6147,19,39,3842.44,6977.00,0.00
2024-12-10 17:39:04,59,6147,19,40,3777.32,6977.02,0.00
2024-12-10 17:39:04,58,6147,19,39,3837.63,6977.02,0.00
2024-12-10 17:39:04,58,6148,19,39,3841.79,6978.00,0.00
2024-12-10 17:39:04,59,6148,20,39,3776.67,6978.02,0.00
2024-12-10 17:39:04,58,6148,19,39,3806.94,6978.17,0.00
2024-12-10 17:39:04,58,6149,19,39,3821.88,6979.00,0.00
2024-12-10 17:39:04,59,6149,20,39,3757.11,6979.02,0.00
2024-12-10 17:39:04,58,6149,20,38,3817.07,6979.02,0.00
2024-12-10 17:39:04,57,6149,19,38,3821.79,6979.47,0.00
2024-12-10 17:39:04,56,6149,18,38,3878.70,6979.64,0.00
2024-12-10 17:39:04,56,6150,18,38,3978.68,6980.00,0.00
2024-12-10 17:39:04,57,6150,19,38,3908.88,6980.02,0.00
2024-12-10 17:39:04,57,6151,19,38,3889.84,6981.00,0.00
2024-12-10 17:39:04,58,6151,19,39,3822.77,6981.02,0.00
2024-12-10 17:39:04,57,6151,19,38,3886.17,6981.02,0.00
2024-12-10 17:39:04,56,6151,18,38,3911.36,6981.64,0.00
2024-12-10 17:39:04,56,6152,18,38,3961.51,6982.00,0.00
2024-12-10 17:39:04,57,6152,18,39,3892.01,6982.02,0.00
2024-12-10 17:39:04,56,6152,17,39,3925.39,6982.18,0.00
2024-12-10 17:39:04,56,6153,17,39,3943.37,6983.00,0.00
2024-12-10 17:39:04,57,6153,17,40,3874.19,6983.02,0.00
2024-12-10 17:39:04,56,6153,17,39,3940.88,6983.02,0.00
2024-12-10 17:39:04,55,6153,16,39,3982.18,6983.35,0.00
2024-12-10 17:39:04,55,6154,16,39,4063.89,6984.00,0.00
2024-12-10 17:39:04,56,6154,17,39,3991.32,6984.02,0.00
2024-12-10 17:39:04,55,6154,16,39,3965.31,6984.85,0.00
2024-12-10 17:39:04,55,6155,16,39,4082.26,6985.00,0.00
2024-12-10 17:39:04,56,6155,17,39,4009.36,6985.02,0.00
2024-12-10 17:39:04,55,6155,17,38,4077.18,6985.02,0.00
2024-12-10 17:39:04,55,6156,17,38,4085.38,6986.00,0.00
2024-12-10 17:39:04,56,6156,17,39,4012.43,6986.02,0.00
2024-12-10 17:39:04,56,6157,17,39,3994.29,6987.00,0.00
2024-12-10 17:39:04,57,6157,18,39,3924.21,6987.02,0.00
2024-12-10 17:39:04,56,6157,18,38,3990.54,6987.02,0.00
2024-12-10 17:39:04,55,6157,17,38,3974.72,6987.96,0.00
2024-12-10 17:39:04,55,6158,17,38,4099.26,6988.00,0.00
2024-12-10 17:39:04,56,6158,18,38,4026.06,6988.02,0.00
2024-12-10 17:39:04,56,6159,18,38,4007.91,6989.00,0.00
2024-12-10 17:39:04,57,6159,18,39,3937.60,6989.02,0.00
2024-12-10 17:39:04,56,6159,18,38,4004.17,6989.02,0.00
2024-12-10 17:39:04,56,6160,18,38,4010.98,6990.00,0.00
2024-12-10 17:39:04,57,6160,18,39,3940.61,6990.02,0.00
2024-12-10 17:39:04,56,6160,17,39,3897.93,6990.96,0.00
2024-12-10 17:39:04,56,6161,17,39,4020.29,6991.00,0.00
2024-12-10 17:39:04,57,6161,17,40,3949.76,6991.02,0.00
2024-12-10 17:39:04,56,6161,17,39,4017.80,6991.02,0.00
2024-12-10 17:39:04,56,6162,17,39,4024.61,6992.00,0.00
2024-12-10 17:39:04,57,6162,17,40,3954.01,6992.02,0.00
2024-12-10 17:39:04,57,6163,17,40,3934.94,6993.00,0.00
2024-12-10 17:39:04,58,6163,17,41,3867.10,6993.02,0.00
2024-12-10 17:39:04,57,6163,17,40,3933.72,6993.02,0.00
2024-12-10 17:39:04,56,6163,16,40,3938.20,6993.82,0.00
2024-12-10 17:39:04,56,6164,16,40,4050.74,6994.00,0.00
2024-12-10 17:39:04,57,6164,16,41,3979.68,6994.02,0.00
2024-12-10 17:39:04,56,6164,15,41,3983.31,6994.07,0.00
2024-12-10 17:39:04,56,6165,15,41,4043.83,6995.00,0.00
2024-12-10 17:39:04,57,6165,16,41,3972.88,6995.02,0.00
2024-12-10 17:39:04,57,6166,16,41,3953.81,6996.00,0.00
2024-12-10 17:39:04,58,6166,16,42,3885.64,6996.02,0.00
2024-12-10 17:39:04,57,6166,16,41,3952.59,6996.02,0.00
2024-12-10 17:39:04,56,6166,16,40,4019.42,6996.02,0.00
2024-12-10 17:39:04,56,6167,16,40,4026.24,6997.00,0.00
2024-12-10 17:39:04,57,6167,17,40,3955.61,6997.02,0.00
2024-12-10 17:39:04,56,6167,16,40,3950.94,6997.39,0.00
2024-12-10 17:39:04,56,6168,16,40,4033.84,6998.00,0.00
2024-12-10 17:39:04,57,6168,17,40,3963.08,6998.02,0.00
2024-12-10 17:39:04,56,6168,17,39,4030.10,6998.02,0.00
2024-12-10 17:39:04,56,6169,17,39,4036.92,6999.00,0.00
2024-12-10 17:39:04,57,6169,18,39,3966.10,6999.02,0.00
2024-12-10 17:39:04,57,6170,18,39,3947.02,7000.00,0.00
2024-12-10 17:39:04,58,6170,18,40,3878.96,7000.02,0.00
2024-12-10 17:39:04,57,6170,18,39,3939.65,7000.02,0.00
2024-12-10 17:39:04,57,6171,18,39,3945.12,7001.00,0.00
2024-12-10 17:39:04,58,6171,19,39,3877.10,7001.02,0.00
2024-12-10 17:39:04,58,6172,19,39,3857.13,7002.00,0.00
2024-12-10 17:39:04,59,6172,19,40,3791.76,7002.02,0.00
2024-12-10 17:39:04,58,6172,19,39,3851.10,7002.02,0.00
2024-12-10 17:39:04,58,6173,19,39,3855.27,7003.00,0.00
2024-12-10 17:39:04,59,6173,19,40,3789.93,7003.02,0.00
2024-12-10 17:39:04,59,6174,19,40,3769.10,7004.00,0.00
2024-12-10 17:39:04,60,6174,19,41,3706.28,7004.02,0.00
2024-12-10 17:39:04,59,6174,19,40,3764.35,7004.02,0.00
2024-12-10 17:39:04,58,6174,18,40,3741.62,7004.97,0.00
2024-12-10 17:39:04,58,6175,18,40,3859.99,7005.00,0.00
2024-12-10 17:39:04,59,6175,18,41,3794.57,7005.02,0.00
2024-12-10 17:39:04,58,6175,17,41,3782.83,7005.41,0.00
2024-12-10 17:39:04,58,6176,17,41,3862.96,7006.00,0.00
2024-12-10 17:39:04,59,6176,17,42,3797.49,7006.02,0.00
2024-12-10 17:39:04,58,6176,17,41,3859.34,7006.02,0.00
2024-12-10 17:39:04,57,6176,16,41,3878.01,7006.39,0.00
2024-12-10 17:39:04,57,6177,16,41,3958.34,7007.00,0.00
2024-12-10 17:39:04,58,6177,16,42,3890.09,7007.02,0.00
2024-12-10 17:39:04,59,6176,17,42,3768.52,7007.51,0.00
2024-12-10 17:39:04,58,6176,16,42,3832.57,7007.90,0.00
2024-12-10 17:39:04,58,6177,16,42,3946.23,7008.00,0.00
2024-12-10 17:39:04,59,6177,16,43,3879.34,7008.02,0.00
2024-12-10 17:39:04,58,6177,16,42,3943.81,7008.02,0.00
2024-12-10 17:39:05,58,6178,16,42,4068.84,7009.00,0.00
2024-12-10 17:39:05,59,6178,16,43,3999.88,7009.02,0.00
2024-12-10 17:39:05,59,6179,16,43,3979.06,7010.00,0.00
2024-12-10 17:39:05,60,6179,16,44,3912.75,7010.02,0.00
2024-12-10 17:39:05,59,6179,16,43,3976.69,7010.02,0.00
2024-12-10 17:39:05,58,6179,15,43,3977.99,7010.83,0.00
2024-12-10 17:39:05,58,6180,15,43,4086.93,7011.00,0.00
2024-12-10 17:39:05,59,6180,16,43,4017.66,7011.02,0.00
2024-12-10 17:39:05,58,6180,15,43,4024.08,7011.09,0.00
2024-12-10 17:39:05,58,6181,15,43,4081.47,7012.00,0.00
2024-12-10 17:39:05,59,6181,16,43,4012.29,7012.02,0.00
2024-12-10 17:39:05,58,6181,16,42,4080.26,7012.02,0.00
2024-12-10 17:39:05,58,6182,16,42,4084.47,7013.00,0.00
2024-12-10 17:39:05,59,6182,16,43,4015.24,7013.02,0.00
2024-12-10 17:39:05,58,6182,15,43,4047.03,7013.19,0.00
2024-12-10 17:39:05,57,6182,14,43,4073.86,7013.44,0.00
2024-12-10 17:39:05,57,6183,14,43,4157.95,7014.00,0.00
2024-12-10 17:39:05,58,6183,15,43,4086.26,7014.02,0.00
2024-12-10 17:39:05,57,6183,15,42,4156.72,7014.02,0.00
2024-12-10 17:39:05,56,6183,14,42,4218.46,7014.18,0.00
2024-12-10 17:39:05,55,6183,13,42,4222.70,7014.58,0.00
2024-12-10 17:39:05,55,6184,13,42,4321.24,7015.00,0.00
2024-12-10 17:39:05,56,6184,14,42,4244.07,7015.02,0.00
2024-12-10 17:39:05,55,6184,14,41,4294.45,7015.02,0.00
2024-12-10 17:39:05,55,6185,14,41,4302.72,7016.00,0.00
2024-12-10 17:39:05,56,6185,14,42,4225.88,7016.02,0.00
2024-12-10 17:39:05,56,6186,14,42,4207.69,7017.00,0.00
2024-12-10 17:39:05,57,6186,15,42,4133.87,7017.02,0.00
2024-12-10 17:39:05,56,6186,15,41,4206.44,7017.02,0.00
2024-12-10 17:39:05,55,6186,14,41,4274.03,7017.15,0.00
2024-12-10 17:39:05,54,6186,13,41,4306.53,7017.41,0.00
2024-12-10 17:39:05,54,6187,13,41,4395.35,7018.00,0.00
2024-12-10 17:39:05,55,6187,14,41,4315.43,7018.02,0.00
2024-12-10 17:39:05,55,6188,14,41,4298.18,7019.00,0.00
2024-12-10 17:39:05,56,6188,14,42,4221.43,7019.02,0.00
2024-12-10 17:39:05,55,6188,14,41,4296.90,7019.02,0.00
2024-12-10 17:39:05,55,6189,14,41,4305.17,7020.00,0.00
2024-12-10 17:39:05,56,6189,15,41,4228.29,7020.02,0.00
2024-12-10 17:39:05,56,6190,15,41,4210.09,7021.00,0.00
2024-12-10 17:39:05,57,6190,15,42,4136.23,7021.02,0.00
2024-12-10 17:39:05,56,6190,15,41,4208.84,7021.02,0.00
2024-12-10 17:39:05,56,6191,15,41,4215.71,7022.00,0.00
2024-12-10 17:39:05,57,6191,16,41,4141.75,7022.02,0.00
2024-12-10 17:39:05,57,6192,16,41,4122.62,7023.00,0.00
2024-12-10 17:39:05,58,6192,16,42,4051.54,7023.02,0.00
2024-12-10 17:39:05,57,6192,16,41,4118.93,7023.02,0.00
2024-12-10 17:39:05,57,6193,16,41,4124.44,7024.00,0.00
2024-12-10 17:39:05,58,6193,16,42,4053.33,7024.02,0.00
2024-12-10 17:39:05,58,6194,16,42,4033.32,7025.00,0.00
2024-12-10 17:39:05,59,6194,17,42,3964.96,7025.02,0.00
2024-12-10 17:39:05,58,6194,17,41,4030.89,7025.02,0.00
2024-12-10 17:39:05,57,6194,16,41,4013.43,7025.97,0.00
2024-12-10 17:39:05,57,6195,16,41,4134.24,7026.00,0.00
2024-12-10 17:39:05,58,6195,16,42,4062.96,7026.02,0.00
2024-12-10 17:39:05,57,6195,15,42,4087.47,7026.23,0.00
2024-12-10 17:39:05,57,6196,15,42,4157.02,7027.00,0.00
2024-12-10 17:39:05,58,6196,16,42,4085.35,7027.02,0.00
2024-12-10 17:39:05,57,6196,16,41,4153.32,7027.02,0.00
2024-12-10 17:39:05,57,6197,16,41,4158.85,7028.00,0.00
2024-12-10 17:39:05,58,6197,16,42,4087.14,7028.02,0.00
2024-12-10 17:39:05,58,6198,16,42,4067.12,7029.00,0.00
2024-12-10 17:39:05,59,6198,17,42,3998.19,7029.02,0.00
2024-12-10 17:39:05,58,6198,17,41,4064.70,7029.02,0.00
2024-12-10 17:39:05,58,6199,17,41,4068.91,7030.00,0.00
2024-12-10 17:39:05,59,6199,17,42,3999.95,7030.02,0.00
2024-12-10 17:39:05,58,6199,16,42,3956.53,7030.97,0.00
2024-12-10 17:39:05,58,6200,16,42,4075.35,7031.00,0.00
2024-12-10 17:39:05,59,6200,17,42,4006.28,7031.02,0.00
2024-12-10 17:39:05,58,6200,17,41,4072.92,7031.02,0.00
2024-12-10 17:39:05,58,6201,17,41,4074.52,7032.00,0.00
2024-12-10 17:39:05,59,6201,18,41,4005.46,7032.02,0.00
2024-12-10 17:39:05,58,6201,17,41,4013.90,7032.04,0.00
2024-12-10 17:39:05,57,6201,16,41,4032.74,7032.68,0.00
2024-12-10 17:39:05,57,6202,16,41,4134.14,7033.00,0.00
2024-12-10 17:39:05,58,6202,17,41,4062.86,7033.02,0.00
2024-12-10 17:39:05,57,6202,17,40,4126.74,7033.02,0.00
2024-12-10 17:39:05,57,6203,17,40,4116.24,7034.00,0.00
2024-12-10 17:39:05,58,6203,18,40,4045.27,7034.02,0.00
2024-12-10 17:39:05,58,6204,18,40,3999.36,7035.00,0.00
2024-12-10 17:39:05,59,6204,19,40,3931.58,7035.02,0.00
2024-12-10 17:39:05,58,6204,19,39,3989.66,7035.02,0.00
2024-12-10 17:39:05,58,6205,19,39,3969.66,7036.00,0.00
2024-12-10 17:39:05,59,6205,19,40,3902.38,7036.02,0.00
2024-12-10 17:39:05,58,6205,18,40,3894.32,7036.57,0.00
2024-12-10 17:39:05,58,6206,18,40,3937.08,7037.00,0.00
2024-12-10 17:39:05,59,6206,19,40,3870.35,7037.02,0.00
2024-12-10 17:39:05,58,6206,19,39,3928.59,7037.02,0.00
2024-12-10 17:39:05,57,6206,18,39,3909.16,7037.97,0.00
2024-12-10 17:39:05,57,6207,18,39,4030.18,7038.00,0.00
2024-12-10 17:39:05,58,6207,19,39,3960.69,7038.02,0.00
2024-12-10 17:39:05,58,6208,19,39,3940.62,7039.00,0.00
2024-12-10 17:39:05,59,6208,20,39,3873.83,7039.02,0.00
2024-12-10 17:39:05,58,6208,20,38,3930.91,7039.02,0.00
2024-12-10 17:39:05,58,6209,20,38,3935.12,7040.00,0.00
2024-12-10 17:39:05,59,6209,20,39,3868.42,7040.02,0.00
2024-12-10 17:39:05,58,6209,19,39,3901.17,7040.16,0.00
2024-12-10 17:39:05,58,6210,19,39,3915.04,7041.00,0.00
2024-12-10 17:39:05,59,6210,20,39,3848.68,7041.02,0.00
2024-12-10 17:39:05,58,6210,20,38,3906.54,7041.02,0.00
2024-12-10 17:39:06,57,6210,19,38,3926.37,7041.70,0.00
2024-12-10 17:39:06,57,6211,19,38,3979.71,7042.00,0.00
2024-12-10 17:39:06,58,6211,20,38,3911.09,7042.02,0.00
2024-12-10 17:39:06,58,6212,20,38,3889.23,7043.00,0.00
2024-12-10 17:39:06,59,6212,20,39,3823.31,7043.02,0.00
2024-12-10 17:39:06,58,6212,20,38,3881.94,7043.02,0.00
2024-12-10 17:39:06,58,6213,20,38,3883.59,7044.00,0.00
2024-12-10 17:39:06,59,6213,20,39,3817.77,7044.02,0.00
2024-12-10 17:39:06,59,6214,20,39,3793.41,7045.00,0.00
2024-12-10 17:39:06,60,6214,20,40,3730.18,7045.02,0.00
2024-12-10 17:39:06,59,6214,20,39,3788.63,7045.02,0.00
2024-12-10 17:39:06,58,6214,19,39,3838.69,7045.16,0.00
2024-12-10 17:39:06,58,6215,19,39,3901.14,7046.00,0.00
2024-12-10 17:39:06,59,6215,20,39,3835.02,7046.02,0.00
2024-12-10 17:39:06,58,6215,19,39,3816.25,7046.74,0.00
2024-12-10 17:39:06,58,6216,19,39,3919.70,7047.00,0.00
2024-12-10 17:39:06,59,6216,20,39,3853.27,7047.02,0.00
2024-12-10 17:39:06,58,6216,20,38,3914.84,7047.02,0.00
2024-12-10 17:39:06,58,6217,20,38,3913.06,7048.00,0.00
2024-12-10 17:39:06,59,6217,21,38,3846.74,7048.02,0.00
2024-12-10 17:39:06,58,6217,20,38,3849.36,7048.04,0.00
2024-12-10 17:39:06,58,6218,20,38,3903.38,7049.00,0.00
2024-12-10 17:39:06,59,6218,20,39,3837.22,7049.02,0.00
2024-12-10 17:39:06,58,6218,20,38,3886.67,7049.02,0.00
2024-12-10 17:39:06,58,6219,20,38,3890.87,7050.00,0.00
2024-12-10 17:39:06,59,6219,21,38,3824.92,7050.02,0.00
2024-12-10 17:39:06,59,6220,21,38,3797.20,7051.00,0.00
2024-12-10 17:39:06,60,6220,21,39,3733.91,7051.02,0.00
2024-12-10 17:39:06,59,6220,21,38,3790.03,7051.02,0.00
2024-12-10 17:39:06,59,6221,21,38,3786.37,7052.00,0.00
2024-12-10 17:39:06,60,6221,22,38,3723.27,7052.02,0.00
2024-12-10 17:39:06,60,6222,22,38,3695.29,7053.00,0.00
2024-12-10 17:39:06,61,6222,23,38,3634.71,7053.02,0.00
2024-12-10 17:39:06,60,6222,23,37,3689.41,7053.02,0.00
2024-12-10 17:39:06,59,6222,22,37,3703.24,7053.70,0.00
2024-12-10 17:39:06,59,6223,22,37,3748.21,7054.00,0.00
2024-12-10 17:39:06,60,6223,22,38,3685.74,7054.02,0.00
2024-12-10 17:39:06,59,6223,21,38,3662.30,7054.49,0.00
2024-12-10 17:39:06,59,6224,21,38,3741.71,7055.00,0.00
2024-12-10 17:39:06,60,6224,21,39,3679.35,7055.02,0.00
2024-12-10 17:39:06,59,6224,21,38,3733.34,7055.02,0.00
2024-12-10 17:39:06,59,6225,21,38,3732.45,7056.00,0.00
2024-12-10 17:39:06,60,6225,22,38,3670.24,7056.02,0.00
2024-12-10 17:39:06,59,6225,21,38,3697.82,7056.17,0.00
2024-12-10 17:39:06,58,6225,20,38,3688.37,7056.91,0.00
2024-12-10 17:39:06,58,6226,20,38,3804.02,7057.00,0.00
2024-12-10 17:39:06,59,6226,21,38,3739.54,7057.02,0.00
2024-12-10 17:39:06,58,6226,21,37,3796.72,7057.02,0.00
2024-12-10 17:39:06,58,6227,21,37,3798.46,7058.00,0.00
2024-12-10 17:39:06,59,6227,21,38,3734.08,7058.02,0.00
2024-12-10 17:39:06,58,6227,20,38,3763.22,7058.17,0.00
2024-12-10 17:39:06,58,6228,20,38,3776.39,7059.00,0.00
2024-12-10 17:39:06,59,6228,21,38,3712.39,7059.02,0.00
2024-12-10 17:39:06,58,6228,21,37,3770.31,7059.02,0.00
2024-12-10 17:39:06,58,6229,21,37,3772.79,7060.00,0.00
2024-12-10 17:39:06,59,6229,21,38,3708.85,7060.02,0.00
2024-12-10 17:39:06,59,6230,21,38,3686.30,7061.00,0.00
2024-12-10 17:39:06,60,6230,22,38,3624.86,7061.02,0.00
2024-12-10 17:39:06,59,6230,22,37,3679.12,7061.02,0.00
2024-12-10 17:39:06,58,6230,21,37,3657.77,7061.93,0.00
2024-12-10 17:39:06,58,6231,21,37,3774.69,7062.00,0.00
2024-12-10 17:39:06,59,6231,22,37,3710.72,7062.02,0.00
2024-12-10 17:39:06,59,6232,22,37,3689.82,7063.00,0.00
2024-12-10 17:39:06,60,6232,23,37,3628.32,7063.02,0.00
2024-12-10 17:39:06,59,6232,23,36,3681.44,7063.02,0.00
2024-12-10 17:39:06,59,6233,23,36,3684.35,7064.00,0.00
2024-12-10 17:39:06,60,6233,23,37,3622.95,7064.02,0.00
2024-12-10 17:39:06,60,6234,23,37,3601.79,7065.00,0.00
2024-12-10 17:39:06,61,6234,23,38,3542.74,7065.02,0.00
2024-12-10 17:39:06,60,6234,23,37,3594.72,7065.02,0.00
2024-12-10 17:39:06,60,6235,23,37,3596.41,7066.00,0.00
2024-12-10 17:39:06,61,6235,24,37,3537.45,7066.02,0.00
2024-12-10 17:39:06,60,6235,23,37,3539.98,7066.32,0.00
2024-12-10 17:39:06,60,6236,23,37,3609.88,7067.00,0.00
2024-12-10 17:39:06,61,6236,23,38,3550.70,7067.02,0.00
2024-12-10 17:39:06,60,6236,23,37,3603.99,7067.02,0.00
2024-12-10 17:39:06,60,6237,23,37,3605.67,7068.00,0.00
2024-12-10 17:39:06,61,6237,24,37,3546.56,7068.02,0.00
2024-12-10 17:39:06,61,6238,24,37,3525.16,7069.00,0.00
2024-12-10 17:39:06,62,6238,24,38,3468.30,7069.02,0.00
2024-12-10 17:39:06,61,6238,24,37,3520.52,7069.02,0.00
2024-12-10 17:39:06,61,6239,24,37,3521.02,7070.00,0.00
2024-12-10 17:39:06,62,6239,24,38,3464.23,7070.02,0.00
2024-12-10 17:39:06,62,6240,24,38,3442.06,7071.00,0.00
2024-12-10 17:39:06,63,6240,24,39,3387.43,7071.02,0.00
2024-12-10 17:39:06,62,6240,24,38,3438.64,7071.02,0.00
2024-12-10 17:39:06,61,6240,23,38,3406.07,7071.97,0.00
2024-12-10 17:39:06,61,6241,23,38,3519.70,7072.00,0.00
2024-12-10 17:39:06,62,6241,24,38,3462.93,7072.02,0.00
2024-12-10 17:39:06,62,6242,24,38,3440.87,7073.00,0.00
2024-12-10 17:39:06,63,6242,25,38,3386.25,7073.02,0.00
2024-12-10 17:39:06,62,6242,25,37,3438.59,7073.02,0.00
2024-12-10 17:39:06,61,6242,24,37,3482.26,7073.20,0.00
2024-12-10 17:39:07,61,6243,24,37,3495.45,7074.00,0.00
2024-12-10 17:39:07,62,6243,24,38,3439.08,7074.02,0.00
2024-12-10 17:39:07,61,6243,23,38,3450.29,7074.25,0.00
2024-12-10 17:39:07,61,6244,23,38,3513.35,7075.00,0.00
2024-12-10 17:39:07,62,6244,23,39,3456.68,7075.02,0.00
2024-12-10 17:39:07,61,6244,23,38,3511.03,7075.02,0.00
2024-12-10 17:39:07,60,6244,22,38,3556.63,7075.20,0.00
2024-12-10 17:39:07,60,6245,22,38,3571.23,7076.00,0.00
2024-12-10 17:39:07,61,6245,23,38,3512.68,7076.02,0.00
2024-12-10 17:39:07,61,6246,23,38,3491.85,7077.00,0.00
2024-12-10 17:39:07,62,6246,24,38,3435.53,7077.02,0.00
2024-12-10 17:39:07,61,6246,24,37,3487.21,7077.02,0.00
2024-12-10 17:39:07,60,6246,23,37,3496.07,7077.70,0.00
2024-12-10 17:39:07,60,6247,23,37,3545.83,7078.00,0.00
2024-12-10 17:39:07,61,6247,23,38,3487.70,7078.02,0.00
2024-12-10 17:39:07,61,6248,23,38,3467.34,7079.00,0.00
2024-12-10 17:39:07,62,6248,23,39,3411.41,7079.02,0.00
2024-12-10 17:39:07,61,6248,23,38,3462.69,7079.02,0.00
2024-12-10 17:39:07,61,6249,23,38,3463.18,7080.00,0.00
2024-12-10 17:39:07,62,6249,24,38,3407.33,7080.02,0.00
2024-12-10 17:39:07,61,6249,23,38,3349.86,7080.97,0.00
2024-12-10 17:39:07,61,6250,23,38,3463.64,7081.00,0.00
2024-12-10 17:39:07,62,6250,23,39,3407.78,7081.02,0.00
2024-12-10 17:39:07,61,6250,23,38,3460.16,7081.02,0.00
2024-12-10 17:39:07,61,6251,23,38,3460.65,7082.00,0.00
2024-12-10 17:39:07,62,6251,24,38,3404.83,7082.02,0.00
2024-12-10 17:39:07,62,6252,24,38,3383.53,7083.00,0.00
2024-12-10 17:39:07,63,6252,24,39,3329.82,7083.02,0.00
2024-12-10 17:39:07,62,6252,24,38,3381.24,7083.02,0.00
2024-12-10 17:39:07,61,6252,23,38,3388.18,7083.71,0.00
2024-12-10 17:39:07,60,6252,22,38,3403.60,7083.97,0.00
2024-12-10 17:39:07,60,6253,22,38,3519.32,7084.00,0.00
2024-12-10 17:39:07,61,6253,22,39,3461.62,7084.02,0.00
2024-12-10 17:39:07,60,6253,21,39,3445.68,7084.72,0.00
2024-12-10 17:39:07,60,6254,21,39,3498.01,7085.00,0.00
2024-12-10 17:39:07,61,6254,22,39,3440.66,7085.02,0.00
2024-12-10 17:39:07,60,6254,22,38,3496.83,7085.02,0.00
2024-12-10 17:39:07,60,6255,22,38,3498.50,7086.00,0.00
2024-12-10 17:39:07,61,6255,23,38,3441.15,7086.02,0.00
2024-12-10 17:39:07,60,6255,23,37,3473.70,7086.02,0.00
2024-12-10 17:39:07,60,6256,23,37,3476.25,7087.00,0.00
2024-12-10 17:39:07,61,6256,24,37,3419.26,7087.02,0.00
2024-12-10 17:39:07,60,6256,24,36,3451.44,7087.02,0.00
2024-12-10 17:39:07,59,6256,23,36,3498.44,7087.17,0.00
2024-12-10 17:39:07,59,6257,23,36,3514.00,7088.00,0.00
2024-12-10 17:39:07,60,6257,24,36,3455.43,7088.02,0.00
2024-12-10 17:39:07,59,6257,24,35,3488.77,7088.02,0.00
2024-12-10 17:39:07,59,6258,24,35,3493.38,7089.00,0.00
2024-12-10 17:39:07,60,6258,25,35,3435.16,7089.02,0.00
2024-12-10 17:39:07,59,6258,25,34,3468.15,7089.02,0.00
2024-12-10 17:39:07,59,6259,25,34,3472.84,7090.00,0.00
2024-12-10 17:39:07,60,6259,26,34,3414.96,7090.02,0.00
2024-12-10 17:39:07,59,6259,26,33,3447.60,7090.02,0.00
2024-12-10 17:39:07,59,6260,26,33,3452.36,7091.00,0.00
2024-12-10 17:39:07,60,6260,27,33,3394.82,7091.02,0.00
2024-12-10 17:39:07,60,6261,27,33,3376.36,7092.00,0.00
2024-12-10 17:39:07,61,6261,28,33,3321.01,7092.02,0.00
2024-12-10 17:39:07,60,6261,28,32,3373.99,7092.02,0.00
2024-12-10 17:39:07,59,6261,27,32,3420.72,7092.15,0.00
2024-12-10 17:39:07,59,6262,27,32,3433.18,7093.00,0.00
2024-12-10 17:39:07,60,6262,28,32,3375.96,7093.02,0.00
2024-12-10 17:39:07,59,6262,27,32,3399.55,7093.15,0.00
2024-12-10 17:39:07,58,6262,26,32,3439.86,7093.26,0.00
2024-12-10 17:39:07,58,6263,26,32,3509.99,7094.00,0.00
2024-12-10 17:39:07,59,6263,26,33,3450.50,7094.02,0.00
2024-12-10 17:39:07,58,6263,26,32,3506.32,7094.02,0.00
2024-12-10 17:39:07,58,6264,26,32,3510.48,7095.00,0.00
2024-12-10 17:39:07,59,6264,26,33,3450.98,7095.02,0.00
2024-12-10 17:39:07,59,6265,26,33,3434.01,7096.00,0.00
2024-12-10 17:39:07,60,6265,27,33,3376.78,7096.02,0.00
2024-12-10 17:39:07,59,6265,27,32,3429.20,7096.02,0.00
2024-12-10 17:39:07,58,6265,26,32,3481.01,7096.12,0.00
2024-12-10 17:39:07,57,6265,25,32,3471.58,7096.84,0.00
2024-12-10 17:39:07,57,6266,25,32,3584.99,7097.00,0.00
2024-12-10 17:39:07,58,6266,26,32,3523.18,7097.02,0.00
2024-12-10 17:39:07,59,6265,27,32,3431.02,7097.17,0.00
2024-12-10 17:39:07,58,6265,26,32,3541.63,7097.29,0.00
2024-12-10 17:39:07,58,6266,26,32,3614.24,7098.00,0.00
2024-12-10 17:39:07,59,6266,27,32,3552.98,7098.02,0.00
2024-12-10 17:39:07,58,6266,27,31,3609.34,7098.02,0.00
2024-12-10 17:39:07,59,6265,28,31,3529.01,7098.32,0.00
2024-12-10 17:39:07,58,6265,27,31,3671.32,7098.67,0.00
2024-12-10 17:39:07,58,6266,27,31,3844.13,7099.00,0.00
2024-12-10 17:39:07,59,6266,28,31,3778.97,7099.02,0.00
2024-12-10 17:39:07,58,6266,27,31,3811.12,7099.14,0.00
2024-12-10 17:39:07,58,6267,27,31,3948.08,7100.00,0.00
2024-12-10 17:39:07,59,6267,28,31,3881.17,7100.02,0.00
2024-12-10 17:39:07,58,6267,28,30,3943.19,7100.02,0.00
2024-12-10 17:39:07,58,6268,28,30,3947.42,7101.00,0.00
2024-12-10 17:39:07,59,6268,29,30,3880.51,7101.02,0.00
2024-12-10 17:39:07,59,6269,29,30,3859.39,7102.00,0.00
2024-12-10 17:39:07,60,6269,30,30,3795.07,7102.02,0.00
2024-12-10 17:39:07,59,6269,30,29,3855.78,7102.02,0.00
2024-12-10 17:39:08,59,6270,30,29,3858.73,7103.00,0.00
2024-12-10 17:39:08,60,6270,31,29,3794.42,7103.02,0.00
2024-12-10 17:39:08,59,6270,30,29,3826.27,7103.14,0.00
2024-12-10 17:39:08,59,6271,30,29,3837.67,7104.00,0.00
2024-12-10 17:39:08,60,6271,30,30,3773.71,7104.02,0.00
2024-12-10 17:39:08,59,6271,30,29,3834.06,7104.02,0.00
2024-12-10 17:39:08,58,6271,29,29,3856.31,7104.62,0.00
2024-12-10 17:39:08,58,6272,29,29,3903.12,7105.00,0.00
2024-12-10 17:39:08,59,6272,30,29,3836.97,7105.02,0.00
2024-12-10 17:39:08,59,6273,30,29,3814.85,7106.00,0.00
2024-12-10 17:39:08,60,6273,31,29,3751.27,7106.02,0.00
2024-12-10 17:39:08,59,6273,31,28,3811.23,7106.02,0.00
2024-12-10 17:39:08,58,6273,30,28,3863.89,7106.17,0.00
2024-12-10 17:39:08,58,6274,30,28,3879.08,7107.00,0.00
2024-12-10 17:39:08,59,6274,30,29,3813.33,7107.02,0.00
2024-12-10 17:39:08,58,6274,29,29,3843.59,7107.16,0.00
2024-12-10 17:39:08,57,6274,28,29,3847.82,7107.84,0.00
2024-12-10 17:39:08,57,6275,28,29,3961.40,7108.00,0.00
2024-12-10 17:39:08,58,6275,29,29,3893.10,7108.02,0.00
2024-12-10 17:39:08,57,6275,29,28,3957.66,7108.02,0.00
2024-12-10 17:39:08,57,6276,29,28,3963.21,7109.00,0.00
2024-12-10 17:39:08,58,6276,30,28,3894.88,7109.02,0.00
2024-12-10 17:39:08,58,6277,30,28,3875.57,7110.00,0.00
2024-12-10 17:39:08,59,6277,31,28,3809.88,7110.02,0.00
2024-12-10 17:39:08,58,6277,31,27,3866.99,7110.02,0.00
2024-12-10 17:39:08,58,6278,31,27,3871.21,7111.00,0.00
2024-12-10 17:39:08,59,6278,31,28,3805.60,7111.02,0.00
2024-12-10 17:39:08,59,6279,31,28,3788.00,7112.00,0.00
2024-12-10 17:39:08,60,6279,32,28,3724.87,7112.02,0.00
2024-12-10 17:39:08,59,6279,32,27,3774.76,7112.05,0.00
2024-12-10 17:39:08,58,6279,31,27,3797.78,7112.60,0.00
2024-12-10 17:39:08,58,6280,31,27,3892.47,7113.00,0.00
2024-12-10 17:39:08,59,6280,31,28,3826.50,7113.02,0.00
2024-12-10 17:39:08,58,6280,30,28,3859.41,7113.14,0.00
2024-12-10 17:39:08,58,6281,30,28,3877.07,7114.00,0.00
2024-12-10 17:39:08,59,6281,30,29,3811.36,7114.02,0.00
2024-12-10 17:39:08,58,6281,30,28,3862.37,7114.05,0.00
2024-12-10 17:39:08,58,6282,30,28,3869.03,7115.00,0.00
2024-12-10 17:39:08,59,6282,30,29,3803.46,7115.02,0.00
2024-12-10 17:39:08,58,6282,29,29,3837.07,7115.12,0.00
2024-12-10 17:39:08,58,6283,29,29,3852.88,7116.00,0.00
2024-12-10 17:39:08,59,6283,30,29,3787.58,7116.02,0.00
2024-12-10 17:39:08,58,6283,30,28,3839.40,7116.05,0.00
2024-12-10 17:39:08,57,6283,29,28,3819.01,7116.58,0.00
2024-12-10 17:39:08,57,6284,29,28,3914.18,7117.00,0.00
2024-12-10 17:39:08,58,6284,29,29,3846.69,7117.02,0.00
2024-12-10 17:39:08,58,6285,29,29,3829.37,7118.00,0.00
2024-12-10 17:39:08,59,6285,29,30,3764.46,7118.02,0.00
2024-12-10 17:39:08,58,6285,29,29,3817.11,7118.05,0.00
2024-12-10 17:39:08,57,6285,28,29,3843.04,7118.63,0.00
2024-12-10 17:39:08,57,6286,28,29,3892.00,7119.00,0.00
2024-12-10 17:39:08,58,6286,28,30,3824.89,7119.02,0.00
2024-12-10 17:39:08,58,6287,28,30,3840.80,7120.00,0.00
2024-12-10 17:39:08,59,6287,29,30,3775.70,7120.02,0.00
2024-12-10 17:39:08,58,6287,28,30,3746.34,7120.67,0.00
2024-12-10 17:39:08,58,6288,28,30,3845.89,7121.00,0.00
2024-12-10 17:39:08,59,6288,28,31,3780.70,7121.02,0.00
2024-12-10 17:39:08,59,6289,28,31,3764.56,7122.00,0.00
2024-12-10 17:39:08,60,6289,29,31,3701.82,7122.02,0.00
2024-12-10 17:39:08,59,6289,29,30,3746.39,7122.05,0.00
2024-12-10 17:39:08,58,6289,28,30,3804.89,7122.12,0.00
2024-12-10 17:39:08,57,6289,27,30,3869.42,7122.14,0.00
2024-12-10 17:39:08,57,6290,27,30,3878.49,7123.00,0.00
2024-12-10 17:39:08,58,6290,28,30,3811.61,7123.02,0.00
2024-12-10 17:39:08,57,6290,27,30,3783.71,7123.49,0.00
2024-12-10 17:39:08,57,6291,27,30,3864.86,7124.00,0.00
2024-12-10 17:39:08,58,6291,28,30,3798.22,7124.02,0.00
2024-12-10 17:39:08,57,6291,28,29,3852.37,7124.05,0.00
2024-12-10 17:39:08,57,6292,28,29,3851.45,7125.00,0.00
2024-12-10 17:39:08,58,6292,28,30,3785.05,7125.02,0.00
2024-12-10 17:39:08,57,6292,27,30,3757.89,7125.47,0.00
2024-12-10 17:39:08,57,6293,27,30,3835.75,7126.00,0.00
2024-12-10 17:39:08,58,6293,27,31,3769.62,7126.02,0.00
2024-12-10 17:39:08,57,6293,27,30,3822.01,7126.05,0.00
2024-12-10 17:39:08,56,6293,26,30,3818.95,7126.91,0.00
2024-12-10 17:39:08,56,6294,26,30,3885.64,7127.00,0.00
2024-12-10 17:39:08,57,6294,26,31,3817.47,7127.02,0.00
2024-12-10 17:39:08,56,6294,25,31,3784.29,7127.52,0.00
2024-12-10 17:39:08,56,6295,25,31,3873.17,7128.00,0.00
2024-12-10 17:39:08,57,6295,25,32,3805.22,7128.02,0.00
2024-12-10 17:39:08,56,6295,25,31,3860.46,7128.05,0.00
2024-12-10 17:39:08,55,6295,24,31,3925.19,7128.13,0.00
2024-12-10 17:39:08,55,6296,24,31,3936.20,7129.00,0.00
2024-12-10 17:39:08,56,6296,24,32,3865.91,7129.02,0.00
2024-12-10 17:39:08,55,6296,23,32,3821.09,7129.60,0.00
2024-12-10 17:39:08,55,6297,23,32,3917.15,7130.00,0.00
2024-12-10 17:39:08,56,6297,24,32,3847.20,7130.02,0.00
2024-12-10 17:39:08,55,6297,24,31,3902.90,7130.06,0.00
2024-12-10 17:39:08,55,6298,24,31,3908.39,7131.00,0.00
2024-12-10 17:39:08,56,6298,25,31,3838.59,7131.02,0.00
2024-12-10 17:39:08,55,6298,24,31,3818.71,7131.76,0.00
2024-12-10 17:39:08,55,6299,24,31,3926.52,7132.00,0.00
2024-12-10 17:39:08,56,6299,25,31,3856.40,7132.02,0.00
2024-12-10 17:39:08,55,6299,25,30,3912.27,7132.06,0.00
2024-12-10 17:39:08,54,6299,24,30,3944.02,7132.61,0.00
2024-12-10 17:39:08,54,6300,24,30,3991.15,7133.00,0.00
2024-12-10 17:39:08,55,6300,25,30,3918.58,7133.02,0.00
2024-12-10 17:39:08,54,6300,24,30,3954.21,7133.17,0.00
2024-12-10 17:39:08,54,6301,24,30,3974.67,7134.00,0.00
2024-12-10 17:39:08,55,6301,24,31,3902.40,7134.02,0.00
2024-12-10 17:39:08,54,6301,24,30,3957.50,7134.06,0.00
2024-12-10 17:39:08,53,6301,23,30,3936.24,7134.96,0.00
2024-12-10 17:39:09,53,6302,23,30,4068.19,7135.00,0.00
2024-12-10 17:39:09,54,6302,24,30,3992.85,7135.02,0.00
2024-12-10 17:39:09,54,6303,24,30,3975.70,7136.00,0.00
2024-12-10 17:39:09,55,6303,24,31,3903.41,7136.02,0.00
2024-12-10 17:39:09,54,6303,24,30,3959.85,7136.06,0.00
2024-12-10 17:39:09,54,6304,24,30,3969.80,7137.00,0.00
2024-12-10 17:39:09,55,6304,25,30,3897.62,7137.02,0.00
2024-12-10 17:39:09,55,6305,25,30,3881.01,7138.00,0.00
2024-12-10 17:39:09,56,6305,26,30,3811.70,7138.02,0.00
2024-12-10 17:39:09,55,6305,26,29,3865.45,7138.06,0.00
2024-12-10 17:39:09,55,6306,26,29,3874.74,7139.00,0.00
2024-12-10 17:39:09,56,6306,27,29,3805.55,7139.02,0.00
2024-12-10 17:39:09,55,6306,26,29,3872.16,7139.04,0.00
2024-12-10 17:39:09,55,6307,26,29,3859.14,7140.00,0.00
2024-12-10 17:39:09,56,6307,26,30,3790.23,7140.02,0.00
2024-12-10 17:39:09,55,6307,26,29,3844.87,7140.04,0.00
2024-12-10 17:39:09,55,6308,26,29,3852.95,7141.00,0.00
2024-12-10 17:39:09,56,6308,26,30,3784.15,7141.02,0.00
2024-12-10 17:39:09,56,6309,26,30,3767.07,7142.00,0.00
2024-12-10 17:39:09,57,6309,26,31,3700.98,7142.02,0.00
2024-12-10 17:39:09,56,6309,26,30,3754.32,7142.04,0.00
2024-12-10 17:39:09,55,6309,25,30,3729.02,7142.96,0.00
2024-12-10 17:39:09,55,6310,25,30,3856.31,7143.00,0.00
2024-12-10 17:39:09,56,6310,26,30,3787.45,7143.02,0.00
2024-12-10 17:39:09,56,6311,26,30,3771.14,7144.00,0.00
2024-12-10 17:39:09,57,6311,27,30,3704.97,7144.02,0.00
2024-12-10 17:39:09,56,6311,27,29,3759.66,7144.04,0.00
2024-12-10 17:39:09,55,6311,26,29,3782.52,7144.67,0.00
2024-12-10 17:39:09,54,6311,25,29,3807.70,7144.93,0.00
2024-12-10 17:39:09,54,6312,25,29,3934.78,7145.00,0.00
2024-12-10 17:39:09,55,6312,26,29,3863.24,7145.02,0.00
2024-12-10 17:39:09,55,6313,26,29,3848.85,7146.00,0.00
2024-12-10 17:39:09,56,6313,26,30,3780.12,7146.02,0.00
2024-12-10 17:39:09,55,6313,26,29,3834.57,7146.06,0.00
2024-12-10 17:39:09,55,6314,26,29,3842.64,7147.00,0.00
2024-12-10 17:39:09,56,6314,26,30,3774.02,7147.02,0.00
2024-12-10 17:39:09,56,6315,26,30,3748.97,7148.00,0.00
2024-12-10 17:39:09,57,6315,26,31,3683.20,7148.02,0.00
2024-12-10 17:39:09,56,6315,26,30,3736.22,7148.05,0.00
2024-12-10 17:39:09,55,6315,25,30,3692.29,7148.96,0.00
2024-12-10 17:39:09,55,6316,25,30,3819.69,7149.00,0.00
2024-12-10 17:39:09,56,6316,26,30,3751.48,7149.02,0.00
2024-12-10 17:39:09,55,6316,25,30,3782.72,7149.16,0.00
2024-12-10 17:39:09,54,6316,24,30,3827.70,7149.28,0.00
2024-12-10 17:39:09,53,6316,24,29,3877.71,7149.59,0.00
2024-12-10 17:39:09,53,6317,24,29,3983.24,7150.00,0.00
2024-12-10 17:39:09,54,6317,25,29,3909.48,7150.02,0.00
2024-12-10 17:39:09,53,6317,25,28,3968.42,7150.06,0.00
2024-12-10 17:39:09,52,6317,24,28,4037.21,7150.15,0.00
2024-12-10 17:39:09,52,6318,24,28,4056.35,7151.00,0.00
2024-12-10 17:39:09,53,6318,25,28,3979.82,7151.02,0.00
2024-12-10 17:39:09,53,6319,25,28,3961.31,7152.00,0.00
2024-12-10 17:39:09,54,6319,25,29,3887.95,7152.02,0.00
2024-12-10 17:39:09,53,6319,25,28,3947.82,7152.06,0.00
2024-12-10 17:39:09,53,6320,25,28,3957.88,7153.00,0.00
2024-12-10 17:39:09,54,6320,25,29,3884.59,7153.02,0.00
2024-12-10 17:39:09,53,6320,24,29,3913.64,7153.21,0.00
2024-12-10 17:39:09,53,6321,24,29,3940.32,7154.00,0.00
2024-12-10 17:39:09,54,6321,24,30,3867.35,7154.02,0.00
2024-12-10 17:39:09,53,6321,24,29,3926.83,7154.06,0.00
2024-12-10 17:39:09,52,6321,23,29,3911.51,7154.96,0.00
2024-12-10 17:39:09,52,6322,23,29,4046.38,7155.00,0.00
2024-12-10 17:39:09,53,6322,24,29,3970.03,7155.02,0.00
2024-12-10 17:39:09,53,6323,24,29,3955.34,7156.00,0.00
2024-12-10 17:39:09,54,6323,24,30,3882.10,7156.02,0.00
2024-12-10 17:39:09,53,6323,24,29,3941.85,7156.06,0.00
2024-12-10 17:39:09,53,6324,24,29,3955.90,7157.00,0.00
2024-12-10 17:39:09,54,6324,24,30,3882.64,7157.02,0.00
2024-12-10 17:39:09,53,6324,23,30,3885.69,7157.08,0.00
2024-12-10 17:39:09,53,6325,23,30,3955.10,7158.00,0.00
2024-12-10 17:39:09,54,6325,24,30,3881.85,7158.02,0.00
2024-12-10 17:39:09,53,6325,24,29,3942.95,7158.06,0.00
2024-12-10 17:39:09,52,6325,23,29,4012.51,7158.12,0.00
2024-12-10 17:39:09,51,6325,22,29,4053.03,7158.65,0.00
2024-12-10 17:39:09,51,6326,22,29,4168.40,7159.00,0.00
2024-12-10 17:39:09,52,6326,23,29,4088.24,7159.02,0.00
2024-12-10 17:39:09,53,6325,24,29,4009.76,7159.08,0.00
2024-12-10 17:39:09,53,6326,24,29,4118.93,7160.00,0.00
2024-12-10 17:39:09,54,6326,24,30,4042.66,7160.02,0.00
2024-12-10 17:39:09,53,6326,24,29,4094.65,7160.08,0.00
2024-12-10 17:39:09,53,6327,24,29,4245.16,7161.00,0.00
2024-12-10 17:39:09,54,6327,24,30,4166.55,7161.02,0.00
2024-12-10 17:39:09,53,6327,23,30,4206.03,7161.13,0.00
2024-12-10 17:39:09,53,6328,23,30,4279.54,7162.00,0.00
2024-12-10 17:39:09,54,6328,24,30,4200.29,7162.02,0.00
2024-12-10 17:39:09,53,6328,24,29,4256.60,7162.08,0.00
2024-12-10 17:39:09,52,6328,23,29,4327.46,7162.14,0.00
2024-12-10 17:39:09,52,6329,23,29,4403.77,7163.00,0.00
2024-12-10 17:39:09,53,6329,23,30,4320.68,7163.02,0.00
2024-12-10 17:39:09,53,6330,23,30,4313.64,7164.00,0.00
2024-12-10 17:39:09,54,6330,24,30,4233.76,7164.02,0.00
2024-12-10 17:39:09,53,6330,24,29,4278.54,7164.11,0.00
2024-12-10 17:39:09,53,6331,24,29,4296.67,7165.00,0.00
2024-12-10 17:39:09,54,6331,24,30,4217.10,7165.02,0.00
2024-12-10 17:39:10,54,6332,24,30,4211.55,7166.00,0.00
2024-12-10 17:39:10,55,6332,25,30,4134.98,7166.02,0.00
2024-12-10 17:39:10,54,6332,24,30,4110.39,7166.44,0.00
2024-12-10 17:39:10,54,6333,24,30,4203.68,7167.00,0.00
2024-12-10 17:39:10,55,6333,24,31,4127.25,7167.02,0.00
2024-12-10 17:39:10,54,6333,24,30,4195.76,7167.11,0.00
2024-12-10 17:39:10,54,6334,24,30,4212.23,7168.00,0.00
2024-12-10 17:39:10,55,6334,25,30,4135.65,7168.02,0.00
2024-12-10 17:39:10,54,6334,24,30,4179.07,7168.06,0.00
2024-12-10 17:39:10,54,6335,24,30,4218.13,7169.00,0.00
2024-12-10 17:39:10,55,6335,24,31,4141.44,7169.02,0.00
2024-12-10 17:39:10,55,6336,24,31,4123.77,7170.00,0.00
2024-12-10 17:39:10,56,6336,24,32,4050.13,7170.02,0.00
2024-12-10 17:39:10,55,6336,23,32,4118.58,7170.09,0.00
2024-12-10 17:39:10,54,6336,23,31,4190.87,7170.11,0.00
2024-12-10 17:39:10,54,6337,23,31,4207.36,7171.00,0.00
2024-12-10 17:39:10,55,6337,24,31,4130.86,7171.02,0.00
2024-12-10 17:39:10,55,6338,24,31,4125.46,7172.00,0.00
2024-12-10 17:39:10,56,6338,24,32,4051.79,7172.02,0.00
2024-12-10 17:39:10,55,6338,23,32,4056.07,7172.62,0.00
2024-12-10 17:39:10,55,6339,23,32,4107.21,7173.00,0.00
2024-12-10 17:39:10,56,6339,23,33,4033.86,7173.02,0.00
2024-12-10 17:39:10,55,6339,23,32,4098.11,7173.13,0.00
2024-12-10 17:39:10,55,6340,23,32,4114.30,7174.00,0.00
2024-12-10 17:39:10,56,6340,23,33,4040.83,7174.02,0.00
2024-12-10 17:39:10,55,6340,22,33,3997.45,7174.96,0.00
2024-12-10 17:39:10,55,6341,22,33,4125.31,7175.00,0.00
2024-12-10 17:39:10,56,6341,22,34,4051.64,7175.02,0.00
2024-12-10 17:39:10,55,6341,21,34,4119.59,7175.09,0.00
2024-12-10 17:39:10,54,6341,21,33,4167.99,7175.11,0.00
2024-12-10 17:39:10,54,6342,21,33,4184.48,7176.00,0.00
2024-12-10 17:39:10,55,6342,21,34,4108.40,7176.02,0.00
2024-12-10 17:39:10,54,6342,20,34,4132.72,7176.20,0.00
2024-12-10 17:39:10,54,6343,20,34,4208.98,7177.00,0.00
2024-12-10 17:39:10,55,6343,20,35,4132.46,7177.02,0.00
2024-12-10 17:39:10,54,6343,20,34,4177.12,7177.11,0.00
2024-12-10 17:39:10,55,6342,21,34,4097.28,7177.20,0.00
2024-12-10 17:39:10,54,6342,20,34,4215.97,7177.32,0.00
2024-12-10 17:39:10,54,6343,20,34,4300.17,7178.00,0.00
2024-12-10 17:39:10,55,6343,21,34,4221.98,7178.02,0.00
2024-12-10 17:39:10,56,6342,21,35,4112.02,7178.18,0.00
2024-12-10 17:39:10,56,6343,21,35,4342.70,7179.00,0.00
2024-12-10 17:39:10,57,6343,22,35,4266.51,7179.02,0.00
2024-12-10 17:39:10,56,6343,22,34,4311.97,7179.11,0.00
2024-12-10 17:39:10,56,6344,22,34,4451.52,7180.00,0.00
2024-12-10 17:39:10,57,6344,22,35,4373.42,7180.02,0.00
2024-12-10 17:39:10,56,6344,21,35,4371.14,7180.61,0.00
2024-12-10 17:39:10,56,6345,21,35,4471.45,7181.00,0.00
2024-12-10 17:39:10,57,6345,21,36,4393.00,7181.02,0.00
2024-12-10 17:39:10,56,6345,21,35,4441.98,7181.11,0.00
2024-12-10 17:39:10,56,6346,21,35,4449.52,7182.00,0.00
2024-12-10 17:39:10,57,6346,22,35,4371.46,7182.02,0.00
2024-12-10 17:39:10,57,6347,22,35,4383.52,7183.00,0.00
2024-12-10 17:39:10,58,6347,22,36,4307.94,7183.02,0.00
2024-12-10 17:39:10,58,6348,22,36,4311.74,7184.00,0.00
2024-12-10 17:39:10,59,6348,22,37,4238.66,7184.02,0.00
2024-12-10 17:39:10,59,6349,22,37,4227.81,7185.00,0.00
2024-12-10 17:39:10,60,6349,22,38,4157.34,7185.02,0.00
2024-12-10 17:39:10,60,6350,22,38,4128.34,7186.00,0.00
2024-12-10 17:39:10,61,6350,23,38,4060.66,7186.02,0.00
2024-12-10 17:39:10,60,6350,23,37,4106.81,7186.10,0.00
2024-12-10 17:39:10,59,6350,22,37,4076.32,7186.95,0.00
2024-12-10 17:39:10,59,6351,22,37,4194.51,7187.00,0.00
2024-12-10 17:39:10,60,6351,22,38,4124.61,7187.02,0.00
2024-12-10 17:39:10,61,6350,22,39,4051.12,7187.13,0.00
2024-12-10 17:39:10,61,6351,22,39,4113.00,7188.00,0.00
2024-12-10 17:39:10,62,6351,23,39,4046.66,7188.02,0.00
2024-12-10 17:39:10,61,6351,23,38,4075.66,7188.12,0.00
2024-12-10 17:39:10,60,6351,22,38,4102.77,7188.30,0.00
2024-12-10 17:39:10,59,6351,21,38,4145.34,7188.66,0.00
2024-12-10 17:39:10,59,6352,21,38,4355.31,7189.00,0.00
2024-12-10 17:39:10,60,6352,21,39,4282.72,7189.02,0.00
2024-12-10 17:39:10,59,6352,20,39,4283.64,7189.56,0.00
2024-12-10 17:39:10,59,6353,20,39,4321.65,7190.00,0.00
2024-12-10 17:39:10,60,6353,21,39,4249.62,7190.02,0.00
2024-12-10 17:39:10,59,6353,21,38,4286.66,7190.12,0.00
2024-12-10 17:39:10,58,6353,20,38,4291.61,7190.83,0.00
2024-12-10 17:39:10,58,6354,20,38,4394.00,7191.00,0.00
2024-12-10 17:39:10,59,6354,20,39,4319.53,7191.02,0.00
2024-12-10 17:39:10,59,6355,20,39,4287.80,7192.00,0.00
2024-12-10 17:39:10,60,6355,21,39,4216.33,7192.02,0.00
2024-12-10 17:39:10,59,6355,21,38,4256.48,7192.12,0.00
2024-12-10 17:39:10,59,6356,21,38,4258.71,7193.00,0.00
2024-12-10 17:39:10,60,6356,22,38,4187.73,7193.02,0.00
2024-12-10 17:39:10,60,6357,22,38,4156.35,7194.00,0.00
2024-12-10 17:39:10,61,6357,23,38,4088.21,7194.02,0.00
2024-12-10 17:39:10,60,6357,23,37,4125.43,7194.12,0.00
2024-12-10 17:39:10,59,6357,22,37,4165.78,7194.53,0.00
2024-12-10 17:39:10,59,6358,22,37,4192.60,7195.00,0.00
2024-12-10 17:39:10,60,6358,22,38,4122.72,7195.02,0.00
2024-12-10 17:39:10,60,6359,22,38,4083.39,7196.00,0.00
2024-12-10 17:39:10,61,6359,22,39,4016.45,7196.02,0.00
2024-12-10 17:39:10,60,6359,22,38,4051.21,7196.12,0.00
2024-12-10 17:39:10,59,6359,21,38,4069.66,7196.71,0.00
2024-12-10 17:39:10,60,6358,22,38,3975.99,7196.87,0.00
2024-12-10 17:39:10,60,6359,22,38,4136.76,7197.00,0.00
2024-12-10 17:39:10,61,6359,23,38,4068.94,7197.02,0.00
2024-12-10 17:39:10,60,6359,22,38,4135.56,7197.02,0.00
2024-12-10 17:39:10,60,6360,22,38,4212.54,7198.00,0.00
2024-12-10 17:39:10,61,6360,22,39,4143.48,7198.02,0.00
2024-12-10 17:39:10,60,6360,22,38,4174.15,7198.12,0.00
2024-12-10 17:39:11,59,6360,21,38,4243.68,7198.14,0.00
2024-12-10 17:39:11,59,6361,21,38,4231.26,7199.00,0.00
2024-12-10 17:39:11,60,6361,21,39,4160.74,7199.02,0.00
2024-12-10 17:39:11,60,6362,21,39,4107.54,7200.00,0.00
2024-12-10 17:39:11,61,6362,21,40,4040.20,7200.02,0.00
2024-12-10 17:39:11,60,6362,20,40,4099.32,7200.08,0.00
2024-12-10 17:39:11,59,6362,19,40,4168.61,7200.09,0.00
2024-12-10 17:39:11,58,6362,19,39,4219.38,7200.09,0.00
2024-12-10 17:39:11,57,6362,18,39,4169.38,7200.97,0.00
2024-12-10 17:39:11,57,6363,18,39,4293.21,7201.00,0.00
2024-12-10 17:39:11,58,6363,19,39,4219.18,7201.02,0.00
2024-12-10 17:39:11,57,6363,18,39,4290.69,7201.04,0.00
2024-12-10 17:39:11,56,6363,17,39,4237.83,7201.79,0.00
2024-12-10 17:39:11,56,6364,17,39,4351.17,7202.00,0.00
2024-12-10 17:39:11,57,6364,17,40,4274.84,7202.02,0.00
2024-12-10 17:39:11,56,6364,16,40,4348.61,7202.04,0.00
2024-12-10 17:39:11,55,6364,16,39,4401.49,7202.06,0.00
2024-12-10 17:39:11,54,6364,16,38,4417.71,7202.67,0.00
2024-12-10 17:39:11,53,6364,16,37,4497.08,7202.70,0.00
2024-12-10 17:39:11,53,6365,16,37,4554.58,7203.00,0.00
2024-12-10 17:39:11,54,6365,17,37,4470.24,7203.02,0.00
2024-12-10 17:39:11,54,6366,17,37,4450.14,7204.00,0.00
2024-12-10 17:39:11,55,6366,17,38,4369.23,7204.02,0.00
2024-12-10 17:39:11,54,6366,17,37,4423.47,7204.06,0.00
2024-12-10 17:39:11,54,6367,17,37,4428.78,7205.00,0.00
2024-12-10 17:39:11,55,6367,18,37,4348.26,7205.02,0.00
2024-12-10 17:39:11,55,6368,18,37,4326.38,7206.00,0.00
2024-12-10 17:39:11,56,6368,18,38,4249.12,7206.02,0.00
2024-12-10 17:39:11,55,6368,18,37,4301.50,7206.06,0.00
2024-12-10 17:39:11,55,6369,18,37,4304.47,7207.00,0.00
2024-12-10 17:39:11,56,6369,18,38,4227.61,7207.02,0.00
2024-12-10 17:39:11,56,6370,18,38,4208.59,7208.00,0.00
2024-12-10 17:39:11,57,6370,19,38,4134.75,7208.02,0.00
2024-12-10 17:39:11,56,6370,19,37,4180.29,7208.07,0.00
2024-12-10 17:39:11,55,6370,18,37,4222.29,7208.24,0.00
2024-12-10 17:39:11,55,6371,18,37,4290.79,7209.00,0.00
2024-12-10 17:39:11,56,6371,18,38,4214.16,7209.02,0.00
2024-12-10 17:39:11,56,6372,18,38,4195.65,7210.00,0.00
2024-12-10 17:39:11,57,6372,18,39,4122.04,7210.02,0.00
2024-12-10 17:39:11,56,6372,18,38,4168.63,7210.07,0.00
2024-12-10 17:39:11,55,6372,17,38,4243.12,7210.09,0.00
2024-12-10 17:39:11,55,6373,17,38,4249.95,7211.00,0.00
2024-12-10 17:39:11,56,6373,17,39,4174.06,7211.02,0.00
2024-12-10 17:39:11,55,6373,16,39,4118.23,7211.96,0.00
2024-12-10 17:39:11,55,6374,16,39,4246.75,7212.00,0.00
2024-12-10 17:39:11,56,6374,17,39,4170.92,7212.02,0.00
2024-12-10 17:39:11,55,6374,16,39,4244.14,7212.04,0.00
2024-12-10 17:39:11,54,6374,16,38,4298.70,7212.06,0.00
2024-12-10 17:39:11,53,6374,15,38,4370.31,7212.11,0.00
2024-12-10 17:39:11,53,6375,15,38,4436.40,7213.00,0.00
2024-12-10 17:39:11,54,6375,15,39,4354.24,7213.02,0.00
2024-12-10 17:39:11,54,6376,15,39,4335.65,7214.00,0.00
2024-12-10 17:39:11,55,6376,16,39,4256.82,7214.02,0.00
2024-12-10 17:39:11,54,6376,16,38,4307.61,7214.06,0.00
2024-12-10 17:39:11,54,6377,16,38,4311.48,7215.00,0.00
2024-12-10 17:39:11,55,6377,17,38,4233.09,7215.02,0.00
2024-12-10 17:39:11,54,6377,16,38,4177.74,7215.96,0.00
2024-12-10 17:39:11,54,6378,16,38,4308.72,7216.00,0.00
2024-12-10 17:39:11,55,6378,17,38,4230.38,7216.02,0.00
2024-12-10 17:39:11,54,6378,17,37,4282.01,7216.06,0.00
2024-12-10 17:39:11,53,6378,16,37,4321.13,7216.62,0.00
2024-12-10 17:39:11,52,6378,15,37,4403.22,7216.64,0.00
2024-12-10 17:39:11,51,6378,14,37,4475.52,7216.69,0.00
2024-12-10 17:39:11,51,6379,14,37,4538.04,7217.00,0.00
2024-12-10 17:39:11,52,6379,15,37,4450.77,7217.02,0.00
2024-12-10 17:39:11,52,6380,15,37,4436.09,7218.00,0.00
2024-12-10 17:39:11,53,6380,15,38,4352.39,7218.02,0.00
2024-12-10 17:39:11,52,6380,15,37,4409.73,7218.06,0.00
2024-12-10 17:39:11,52,6381,15,37,4425.35,7219.00,0.00
2024-12-10 17:39:11,53,6381,16,37,4341.86,7219.02,0.00
2024-12-10 17:39:11,53,6382,16,37,4326.71,7220.00,0.00
2024-12-10 17:39:11,54,6382,17,37,4246.59,7220.02,0.00
2024-12-10 17:39:11,53,6382,17,36,4300.84,7220.06,0.00
2024-12-10 17:39:11,52,6382,16,36,4374.94,7220.17,0.00
2024-12-10 17:39:11,51,6382,15,36,4378.11,7220.96,0.00
2024-12-10 17:39:11,51,6383,15,36,4516.89,7221.00,0.00
2024-12-10 17:39:11,52,6383,15,37,4430.02,7221.02,0.00
2024-12-10 17:39:11,52,6384,15,37,4415.36,7222.00,0.00
2024-12-10 17:39:11,53,6384,15,38,4332.05,7222.02,0.00
2024-12-10 17:39:11,52,6384,15,37,4390.37,7222.06,0.00
2024-12-10 17:39:11,51,6384,14,37,4396.26,7222.90,0.00
2024-12-10 17:39:11,51,6385,14,37,4530.88,7223.00,0.00
2024-12-10 17:39:11,52,6385,15,37,4443.75,7223.02,0.00
2024-12-10 17:39:11,52,6386,15,37,4429.09,7224.00,0.00
2024-12-10 17:39:11,53,6386,15,38,4345.52,7224.02,0.00
2024-12-10 17:39:11,52,6386,15,37,4401.32,7224.08,0.00
2024-12-10 17:39:11,51,6386,14,37,4438.41,7224.73,0.00
2024-12-10 17:39:11,51,6387,14,37,4560.47,7225.00,0.00
2024-12-10 17:39:11,52,6387,14,38,4472.77,7225.02,0.00
2024-12-10 17:39:11,52,6388,14,38,4458.10,7226.00,0.00
2024-12-10 17:39:11,53,6388,15,38,4373.99,7226.02,0.00
2024-12-10 17:39:11,52,6388,15,37,4431.72,7226.08,0.00
2024-12-10 17:39:11,52,6389,15,37,4448.99,7227.00,0.00
2024-12-10 17:39:11,53,6389,15,38,4365.05,7227.02,0.00
2024-12-10 17:39:11,53,6390,15,38,4349.53,7228.00,0.00
2024-12-10 17:39:11,54,6390,15,39,4268.98,7228.02,0.00
2024-12-10 17:39:11,53,6390,15,38,4323.63,7228.08,0.00
2024-12-10 17:39:11,53,6391,15,38,4337.09,7229.00,0.00
2024-12-10 17:39:11,54,6391,15,39,4256.78,7229.02,0.00
2024-12-10 17:39:11,53,6391,14,39,4212.70,7229.96,0.00
2024-12-10 17:39:11,53,6392,14,39,4346.41,7230.00,0.00
2024-12-10 17:39:11,54,6392,15,39,4265.92,7230.02,0.00
2024-12-10 17:39:11,53,6392,15,38,4320.50,7230.08,0.00
2024-12-10 17:39:11,53,6393,15,38,4330.47,7231.00,0.00
2024-12-10 17:39:11,54,6393,16,38,4250.28,7231.02,0.00
2024-12-10 17:39:12,53,6393,15,38,4233.13,7231.77,0.00
2024-12-10 17:39:12,53,6394,15,38,4353.40,7232.00,0.00
2024-12-10 17:39:12,54,6394,16,38,4272.78,7232.02,0.00
2024-12-10 17:39:12,54,6395,16,38,4249.99,7233.00,0.00
2024-12-10 17:39:12,55,6395,16,39,4172.72,7233.02,0.00
2024-12-10 17:39:12,54,6395,16,38,4225.89,7233.07,0.00
2024-12-10 17:39:12,54,6396,16,38,4229.93,7234.00,0.00
2024-12-10 17:39:12,55,6396,17,38,4153.02,7234.02,0.00
2024-12-10 17:39:12,54,6396,17,37,4204.49,7234.07,0.00
2024-12-10 17:39:12,54,6397,17,37,4207.63,7235.00,0.00
2024-12-10 17:39:12,55,6397,17,38,4131.13,7235.02,0.00
2024-12-10 17:39:12,55,6398,17,38,4106.82,7236.00,0.00
2024-12-10 17:39:12,56,6398,17,39,4033.48,7236.02,0.00
2024-12-10 17:39:12,55,6398,17,38,4083.15,7236.07,0.00
2024-12-10 17:39:12,55,6399,17,38,4083.05,7237.00,0.00
2024-12-10 17:39:12,56,6399,17,39,4010.13,7237.02,0.00
2024-12-10 17:39:12,55,6399,17,38,4029.64,7237.31,0.00
2024-12-10 17:39:12,55,6400,17,38,4066.73,7238.00,0.00
2024-12-10 17:39:12,56,6400,17,39,3994.11,7238.02,0.00
2024-12-10 17:39:12,55,6400,17,38,4043.05,7238.07,0.00
2024-12-10 17:39:12,54,6400,16,38,4030.15,7238.91,0.00
2024-12-10 17:39:12,54,6401,16,38,4157.57,7239.00,0.00
2024-12-10 17:39:12,55,6401,16,39,4081.98,7239.02,0.00
2024-12-10 17:39:12,54,6401,15,39,4048.22,7239.87,0.00
2024-12-10 17:39:12,54,6402,15,39,4173.00,7240.00,0.00
2024-12-10 17:39:12,55,6402,16,39,4097.13,7240.02,0.00
2024-12-10 17:39:12,54,6402,16,38,4150.22,7240.07,0.00
2024-12-10 17:39:12,54,6403,16,38,4164.19,7241.00,0.00
2024-12-10 17:39:12,55,6403,16,39,4088.48,7241.02,0.00
2024-12-10 17:39:12,55,6404,16,39,4075.50,7242.00,0.00
2024-12-10 17:39:12,56,6404,17,39,4002.73,7242.02,0.00
2024-12-10 17:39:12,55,6404,17,38,4054.44,7242.07,0.00
2024-12-10 17:39:12,55,6405,17,38,4066.85,7243.00,0.00
2024-12-10 17:39:12,56,6405,18,38,3994.22,7243.02,0.00
2024-12-10 17:39:12,56,6406,18,38,3980.79,7244.00,0.00
2024-12-10 17:39:12,57,6406,18,39,3910.95,7244.02,0.00
2024-12-10 17:39:12,56,6406,17,39,3978.21,7244.04,0.00
2024-12-10 17:39:12,55,6406,17,38,4033.42,7244.06,0.00
2024-12-10 17:39:12,55,6407,17,38,4044.51,7245.00,0.00
2024-12-10 17:39:12,56,6407,17,39,3972.28,7245.02,0.00
2024-12-10 17:39:12,55,6407,16,39,3983.52,7245.27,0.00
2024-12-10 17:39:12,55,6408,16,39,4063.04,7246.00,0.00
2024-12-10 17:39:12,56,6408,17,39,3990.49,7246.02,0.00
2024-12-10 17:39:12,55,6408,17,38,4045.92,7246.06,0.00
2024-12-10 17:39:12,55,6409,17,38,4057.01,7247.00,0.00
2024-12-10 17:39:12,56,6409,18,38,3984.57,7247.02,0.00
2024-12-10 17:39:12,55,6409,17,38,3987.29,7247.35,0.00
2024-12-10 17:39:12,55,6410,17,38,4072.07,7248.00,0.00
2024-12-10 17:39:12,56,6410,18,38,3999.35,7248.02,0.00
2024-12-10 17:39:12,55,6410,18,37,4056.26,7248.06,0.00
2024-12-10 17:39:12,55,6411,18,37,4067.36,7249.00,0.00
2024-12-10 17:39:12,56,6411,18,38,3994.73,7249.02,0.00
2024-12-10 17:39:12,55,6411,17,38,3981.72,7249.15,0.00
2024-12-10 17:39:12,55,6412,17,38,4052.10,7250.00,0.00
2024-12-10 17:39:12,56,6412,18,38,3979.74,7250.02,0.00
2024-12-10 17:39:12,55,6412,18,37,4044.41,7250.07,0.00
2024-12-10 17:39:12,54,6412,17,37,4111.28,7250.17,0.00
2024-12-10 17:39:12,54,6413,17,37,4131.95,7251.00,0.00
2024-12-10 17:39:12,55,6413,18,37,4056.82,7251.02,0.00
2024-12-10 17:39:12,55,6414,18,37,4040.85,7252.00,0.00
2024-12-10 17:39:12,56,6414,19,37,3968.69,7252.02,0.00
2024-12-10 17:39:12,55,6414,19,36,4025.03,7252.07,0.00
2024-12-10 17:39:12,55,6415,19,36,4037.45,7253.00,0.00
2024-12-10 17:39:12,56,6415,19,37,3965.35,7253.02,0.00
2024-12-10 17:39:12,56,6416,19,37,3948.18,7254.00,0.00
2024-12-10 17:39:12,57,6416,19,38,3878.91,7254.02,0.00
2024-12-10 17:39:12,56,6416,19,37,3933.75,7254.07,0.00
2024-12-10 17:39:12,55,6416,18,37,3965.58,7254.62,0.00
2024-12-10 17:39:12,55,6417,18,37,4016.42,7255.00,0.00
2024-12-10 17:39:12,56,6417,19,37,3944.70,7255.02,0.00
2024-12-10 17:39:12,55,6417,18,37,3924.48,7255.75,0.00
2024-12-10 17:39:12,55,6418,18,37,4036.23,7256.00,0.00
2024-12-10 17:39:12,56,6418,19,37,3964.16,7256.02,0.00
2024-12-10 17:39:12,55,6418,19,36,4020.39,7256.07,0.00
2024-12-10 17:39:12,55,6419,19,36,4027.52,7257.00,0.00
2024-12-10 17:39:12,56,6419,19,37,3955.60,7257.02,0.00
2024-12-10 17:39:12,56,6420,19,37,3933.16,7258.00,0.00
2024-12-10 17:39:12,57,6420,19,38,3864.16,7258.02,0.00
2024-12-10 17:39:12,56,6420,19,37,3916.31,7258.07,0.00
2024-12-10 17:39:12,55,6420,18,37,3903.17,7258.89,0.00
2024-12-10 17:39:12,55,6421,18,37,4021.98,7259.00,0.00
2024-12-10 17:39:12,56,6421,18,38,3950.15,7259.02,0.00
2024-12-10 17:39:12,55,6421,17,38,4020.66,7259.02,0.00
2024-12-10 17:39:12,54,6421,16,38,4093.77,7259.02,0.00
2024-12-10 17:39:12,53,6421,15,38,4102.54,7259.59,0.00
2024-12-10 17:39:12,53,6422,15,38,4150.10,7260.00,0.00
2024-12-10 17:39:12,54,6422,15,39,4073.24,7260.02,0.00
2024-12-10 17:39:12,53,6422,15,38,4135.03,7260.04,0.00
2024-12-10 17:39:12,53,6423,15,38,4140.70,7261.00,0.00
2024-12-10 17:39:12,54,6423,15,39,4064.02,7261.02,0.00
2024-12-10 17:39:13,54,6424,15,39,4041.14,7262.00,0.00
2024-12-10 17:39:13,55,6424,15,40,3967.67,7262.02,0.00
2024-12-10 17:39:13,54,6424,15,39,4026.35,7262.04,0.00
2024-12-10 17:39:13,53,6424,14,39,4042.30,7262.74,0.00
2024-12-10 17:39:13,53,6425,14,39,4155.03,7263.00,0.00
2024-12-10 17:39:13,54,6425,15,39,4078.09,7263.02,0.00
2024-12-10 17:39:13,54,6426,15,39,4054.36,7264.00,0.00
2024-12-10 17:39:13,55,6426,15,40,3980.64,7264.02,0.00
2024-12-10 17:39:13,54,6426,15,39,4036.88,7264.04,0.00
2024-12-10 17:39:13,54,6427,15,39,4033.38,7265.00,0.00
2024-12-10 17:39:13,55,6427,16,39,3960.05,7265.02,0.00
2024-12-10 17:39:13,55,6428,16,39,3933.81,7266.00,0.00
2024-12-10 17:39:13,56,6428,17,39,3863.56,7266.02,0.00
2024-12-10 17:39:13,55,6428,17,38,3917.96,7266.04,0.00
2024-12-10 17:39:13,54,6428,16,38,3946.99,7266.63,0.00
2024-12-10 17:39:13,54,6429,16,38,3984.21,7267.00,0.00
2024-12-10 17:39:13,55,6429,16,39,3911.77,7267.02,0.00
2024-12-10 17:39:13,54,6429,15,39,3904.70,7267.69,0.00
2024-12-10 17:39:13,54,6430,15,39,3999.58,7268.00,0.00
2024-12-10 17:39:13,55,6430,15,40,3926.86,7268.02,0.00
2024-12-10 17:39:13,54,6430,15,39,3983.43,7268.04,0.00
2024-12-10 17:39:13,53,6430,14,39,3958.80,7268.66,0.00
2024-12-10 17:39:13,52,6430,14,38,4015.14,7268.73,0.00
2024-12-10 17:39:13,52,6431,14,38,4135.56,7269.00,0.00
2024-12-10 17:39:13,53,6431,14,39,4057.53,7269.02,0.00
2024-12-10 17:39:13,52,6431,13,39,4053.10,7269.10,0.00
2024-12-10 17:39:13,52,6432,13,39,4127.74,7270.00,0.00
2024-12-10 17:39:13,53,6432,13,40,4049.85,7270.02,0.00
2024-12-10 17:39:13,52,6432,13,39,4112.36,7270.04,0.00
2024-12-10 17:39:13,51,6432,12,39,4151.76,7270.33,0.00
2024-12-10 17:39:13,51,6433,12,39,4246.32,7271.00,0.00
2024-12-10 17:39:13,52,6433,13,39,4164.66,7271.02,0.00
2024-12-10 17:39:13,51,6433,12,39,4163.89,7271.67,0.00
2024-12-10 17:39:13,51,6434,12,39,4282.49,7272.00,0.00
2024-12-10 17:39:13,52,6434,13,39,4200.14,7272.02,0.00
2024-12-10 17:39:13,51,6434,13,38,4268.23,7272.04,0.00
2024-12-10 17:39:13,51,6435,13,38,4284.51,7273.00,0.00
2024-12-10 17:39:13,52,6435,13,39,4202.11,7273.02,0.00
2024-12-10 17:39:13,52,6436,13,39,4187.30,7274.00,0.00
2024-12-10 17:39:13,53,6436,13,40,4108.30,7274.02,0.00
2024-12-10 17:39:13,52,6436,13,39,4173.31,7274.04,0.00
2024-12-10 17:39:13,52,6437,13,39,4187.88,7275.00,0.00
2024-12-10 17:39:13,53,6437,14,39,4108.86,7275.02,0.00
2024-12-10 17:39:13,52,6437,13,39,4148.75,7275.17,0.00
2024-12-10 17:39:13,51,6437,12,39,4150.71,7275.94,0.00
2024-12-10 17:39:13,51,6438,12,39,4289.13,7276.00,0.00
2024-12-10 17:39:13,52,6438,12,40,4206.64,7276.02,0.00
2024-12-10 17:39:13,51,6438,11,40,4288.36,7276.02,0.00
2024-12-10 17:39:13,50,6438,11,39,4361.03,7276.02,0.00
2024-12-10 17:39:13,50,6439,11,39,4377.64,7277.00,0.00
2024-12-10 17:39:13,51,6439,12,39,4291.81,7277.02,0.00
2024-12-10 17:39:13,51,6440,12,39,4278.13,7278.00,0.00
2024-12-10 17:39:13,52,6440,13,39,4195.86,7278.02,0.00
2024-12-10 17:39:13,51,6440,13,38,4265.28,7278.02,0.00
2024-12-10 17:39:13,50,6440,12,38,4256.54,7278.96,0.00
2024-12-10 17:39:13,50,6441,12,38,4399.23,7279.00,0.00
2024-12-10 17:39:13,51,6441,12,39,4312.97,7279.02,0.00
2024-12-10 17:39:13,50,6441,11,39,4359.96,7279.14,0.00
2024-12-10 17:39:13,50,6442,11,39,4385.27,7280.00,0.00
2024-12-10 17:39:13,51,6442,11,40,4299.29,7280.02,0.00
2024-12-10 17:39:13,50,6442,11,39,4373.62,7280.02,0.00
2024-12-10 17:39:13,49,6442,10,39,4454.00,7280.12,0.00
2024-12-10 17:39:13,49,6443,10,39,4539.28,7281.00,0.00
2024-12-10 17:39:13,50,6443,11,39,4448.49,7281.02,0.00
2024-12-10 17:39:13,50,6444,11,39,4436.00,7282.00,0.00
2024-12-10 17:39:13,51,6444,11,40,4349.02,7282.02,0.00
2024-12-10 17:39:13,50,6444,11,39,4424.34,7282.02,0.00
2024-12-10 17:39:13,50,6445,11,39,4440.97,7283.00,0.00
2024-12-10 17:39:13,51,6445,11,40,4353.90,7283.02,0.00
2024-12-10 17:39:13,51,6446,11,40,4340.21,7284.00,0.00
2024-12-10 17:39:13,52,6446,11,41,4256.75,7284.02,0.00
2024-12-10 17:39:13,51,6446,11,40,4330.21,7284.02,0.00
2024-12-10 17:39:13,50,6446,10,40,4322.70,7284.96,0.00
2024-12-10 17:39:13,50,6447,10,40,4465.50,7285.00,0.00
2024-12-10 17:39:13,51,6447,10,41,4377.95,7285.02,0.00
2024-12-10 17:39:13,50,6447,9,41,4354.99,7285.50,0.00
2024-12-10 17:39:13,50,6448,9,41,4464.66,7286.00,0.00
2024-12-10 17:39:13,51,6448,9,42,4377.12,7286.02,0.00
2024-12-10 17:39:13,50,6448,9,41,4455.92,7286.02,0.00
2024-12-10 17:39:13,50,6449,9,41,4470.97,7287.00,0.00
2024-12-10 17:39:13,51,6449,10,41,4383.30,7287.02,0.00
2024-12-10 17:39:13,50,6449,9,41,4364.91,7287.46,0.00
2024-12-10 17:39:13,49,6449,8,41,4444.27,7287.59,0.00
2024-12-10 17:39:13,49,6450,8,41,4563.58,7288.00,0.00
2024-12-10 17:39:13,50,6450,8,42,4472.31,7288.02,0.00
2024-12-10 17:39:13,49,6450,8,41,4554.66,7288.02,0.00
2024-12-10 17:39:13,49,6451,8,41,4568.96,7289.00,0.00
2024-12-10 17:39:13,50,6451,8,42,4477.58,7289.02,0.00
2024-12-10 17:39:13,50,6452,8,42,4460.20,7290.00,0.00
2024-12-10 17:39:13,51,6452,9,42,4372.74,7290.02,0.00
2024-12-10 17:39:13,50,6452,9,41,4447.07,7290.02,0.00
2024-12-10 17:39:13,49,6452,8,41,4437.48,7290.96,0.00
2024-12-10 17:39:13,49,6453,8,41,4583.32,7291.00,0.00
2024-12-10 17:39:13,50,6453,9,41,4491.66,7291.02,0.00
2024-12-10 17:39:13,50,6454,9,41,4473.45,7292.00,0.00
2024-12-10 17:39:13,51,6454,9,42,4385.73,7292.02,0.00
2024-12-10 17:39:13,50,6454,9,41,4458.86,7292.02,0.00
2024-12-10 17:39:13,50,6455,9,41,4470.00,7293.00,0.00
2024-12-10 17:39:13,51,6455,10,41,4382.36,7293.02,0.00
2024-12-10 17:39:13,51,6456,10,41,4364.52,7294.00,0.00
2024-12-10 17:39:13,52,6456,10,42,4280.58,7294.02,0.00
2024-12-10 17:39:13,51,6456,10,41,4351.64,7294.02,0.00
2024-12-10 17:39:13,51,6457,10,41,4364.50,7295.00,0.00
2024-12-10 17:39:13,52,6457,10,42,4280.57,7295.02,0.00
2024-12-10 17:39:14,52,6458,10,42,4265.73,7296.00,0.00
2024-12-10 17:39:14,53,6458,11,42,4185.24,7296.02,0.00
2024-12-10 17:39:14,52,6458,11,41,4253.10,7296.02,0.00
2024-12-10 17:39:14,52,6459,11,41,4266.31,7297.00,0.00
2024-12-10 17:39:14,53,6459,12,41,4185.81,7297.02,0.00
2024-12-10 17:39:14,52,6459,11,41,4214.46,7297.23,0.00
2024-12-10 17:39:14,52,6460,11,41,4299.17,7298.00,0.00
2024-12-10 17:39:14,53,6460,12,41,4218.06,7298.02,0.00
2024-12-10 17:39:14,52,6460,12,40,4287.95,7298.02,0.00
2024-12-10 17:39:14,51,6460,11,40,4323.71,7298.67,0.00
2024-12-10 17:39:14,51,6461,11,40,4385.50,7299.00,0.00
2024-12-10 17:39:14,52,6461,12,40,4301.17,7299.02,0.00
2024-12-10 17:39:14,51,6461,11,40,4277.22,7299.86,0.00
2024-12-10 17:39:14,51,6462,11,40,4410.44,7300.00,0.00
2024-12-10 17:39:14,52,6462,12,40,4325.62,7300.02,0.00
2024-12-10 17:39:14,51,6462,12,39,4398.99,7300.02,0.00
2024-12-10 17:39:14,51,6463,12,39,4413.90,7301.00,0.00
2024-12-10 17:39:14,52,6463,12,40,4329.02,7301.02,0.00
2024-12-10 17:39:14,52,6464,12,40,4314.17,7302.00,0.00
2024-12-10 17:39:14,53,6464,12,41,4232.77,7302.02,0.00
2024-12-10 17:39:14,52,6464,12,40,4304.34,7302.02,0.00
2024-12-10 17:39:14,51,6464,11,40,4300.51,7302.92,0.00
2024-12-10 17:39:14,51,6465,11,40,4438.02,7303.00,0.00
2024-12-10 17:39:14,52,6465,11,41,4352.68,7303.02,0.00
2024-12-10 17:39:14,52,6466,11,41,4337.82,7304.00,0.00
2024-12-10 17:39:14,53,6466,11,42,4255.98,7304.02,0.00
2024-12-10 17:39:14,52,6466,11,41,4329.40,7304.02,0.00
2024-12-10 17:39:14,52,6467,11,41,4342.63,7305.00,0.00
2024-12-10 17:39:14,53,6467,12,41,4260.70,7305.02,0.00
2024-12-10 17:39:14,53,6468,12,41,4244.74,7306.00,0.00
2024-12-10 17:39:14,54,6468,13,41,4166.13,7306.02,0.00
2024-12-10 17:39:14,53,6468,13,40,4233.71,7306.02,0.00
2024-12-10 17:39:14,53,6469,13,40,4245.32,7307.00,0.00
2024-12-10 17:39:14,54,6469,14,40,4166.70,7307.02,0.00
2024-12-10 17:39:14,53,6469,14,39,4206.39,7307.17,0.00
2024-12-10 17:39:14,52,6469,13,39,4216.07,7307.89,0.00
2024-12-10 17:39:14,52,6470,13,39,4348.26,7308.00,0.00
2024-12-10 17:39:14,53,6470,14,39,4266.21,7308.02,0.00
2024-12-10 17:39:14,52,6470,14,38,4337.01,7308.02,0.00
2024-12-10 17:39:14,52,6471,14,38,4350.26,7309.00,0.00
2024-12-10 17:39:14,53,6471,14,39,4268.18,7309.02,0.00
2024-12-10 17:39:14,53,6472,14,39,4252.21,7310.00,0.00
2024-12-10 17:39:14,54,6472,14,40,4173.47,7310.02,0.00
2024-12-10 17:39:14,53,6472,14,39,4242.56,7310.02,0.00
2024-12-10 17:39:14,53,6473,14,39,4254.17,7311.00,0.00
2024-12-10 17:39:14,54,6473,15,39,4175.39,7311.02,0.00
2024-12-10 17:39:14,54,6474,15,39,4158.36,7312.00,0.00
2024-12-10 17:39:14,55,6474,15,40,4082.75,7312.02,0.00
2024-12-10 17:39:14,54,6474,15,39,4150.24,7312.02,0.00
2024-12-10 17:39:14,54,6475,15,39,4160.28,7313.00,0.00
2024-12-10 17:39:14,55,6475,15,40,4084.64,7313.02,0.00
2024-12-10 17:39:14,54,6475,14,40,4071.29,7313.76,0.00
2024-12-10 17:39:14,54,6476,14,40,4189.29,7314.00,0.00
2024-12-10 17:39:14,55,6476,15,40,4113.13,7314.02,0.00
2024-12-10 17:39:14,54,6476,15,39,4182.52,7314.02,0.00
2024-12-10 17:39:14,54,6477,15,39,4192.58,7315.00,0.00
2024-12-10 17:39:14,55,6477,15,40,4116.35,7315.02,0.00
2024-12-10 17:39:14,54,6477,14,40,4083.33,7315.89,0.00
2024-12-10 17:39:14,54,6478,14,40,4210.76,7316.00,0.00
2024-12-10 17:39:14,55,6478,14,41,4134.20,7316.02,0.00
2024-12-10 17:39:14,54,6478,14,40,4205.34,7316.02,0.00
2024-12-10 17:39:14,54,6479,14,40,4215.40,7317.00,0.00
2024-12-10 17:39:14,55,6479,15,40,4138.76,7317.02,0.00
2024-12-10 17:39:14,55,6480,15,40,4120.70,7318.00,0.00
2024-12-10 17:39:14,56,6480,16,40,4047.11,7318.02,0.00
2024-12-10 17:39:14,55,6480,16,39,4115.37,7318.02,0.00
2024-12-10 17:39:14,55,6481,16,39,4123.92,7319.00,0.00
2024-12-10 17:39:14,56,6481,16,40,4050.28,7319.02,0.00
2024-12-10 17:39:14,55,6481,15,40,4027.19,7319.82,0.00
2024-12-10 17:39:14,55,6482,15,40,4147.11,7320.00,0.00
2024-12-10 17:39:14,56,6482,15,41,4073.06,7320.02,0.00
2024-12-10 17:39:14,55,6482,15,40,4140.46,7320.02,0.00
2024-12-10 17:39:14,54,6482,14,40,4114.44,7320.69,0.00
2024-12-10 17:39:14,54,6483,14,40,4227.20,7321.00,0.00
2024-12-10 17:39:14,55,6483,15,40,4150.34,7321.02,0.00
2024-12-10 17:39:14,55,6484,15,40,4132.27,7322.00,0.00
2024-12-10 17:39:14,56,6484,16,40,4058.48,7322.02,0.00
2024-12-10 17:39:14,55,6484,16,39,4126.94,7322.02,0.00
2024-12-10 17:39:14,55,6485,16,39,4135.50,7323.00,0.00
2024-12-10 17:39:14,56,6485,16,40,4061.65,7323.02,0.00
2024-12-10 17:39:14,56,6486,16,40,4046.48,7324.00,0.00
2024-12-10 17:39:14,57,6486,16,41,3975.49,7324.02,0.00
2024-12-10 17:39:14,56,6486,16,40,4030.79,7324.04,0.00
2024-12-10 17:39:14,56,6487,16,40,4039.18,7325.00,0.00
2024-12-10 17:39:14,57,6487,16,41,3968.32,7325.02,0.00
2024-12-10 17:39:14,56,6487,15,41,3924.36,7325.61,0.00
2024-12-10 17:39:14,56,6488,15,41,4026.68,7326.00,0.00
2024-12-10 17:39:14,57,6488,15,42,3956.04,7326.02,0.00
2024-12-10 17:39:14,56,6488,15,41,4009.68,7326.04,0.00
2024-12-10 17:39:14,55,6488,14,41,4074.63,7326.15,0.00
2024-12-10 17:39:14,54,6488,13,41,4148.73,7326.15,0.00
2024-12-10 17:39:14,53,6488,12,41,4134.66,7326.66,0.00
2024-12-10 17:39:14,53,6489,12,41,4248.27,7327.00,0.00
2024-12-10 17:39:14,54,6489,12,42,4169.60,7327.02,0.00
2024-12-10 17:39:14,53,6489,11,42,4184.78,7327.30,0.00
2024-12-10 17:39:14,53,6490,11,42,4272.36,7328.00,0.00
2024-12-10 17:39:14,54,6490,11,43,4193.24,7328.02,0.00
2024-12-10 17:39:14,53,6490,11,42,4255.77,7328.04,0.00
2024-12-10 17:39:14,52,6490,10,42,4256.36,7328.89,0.00
2024-12-10 17:39:14,52,6491,10,42,4388.94,7329.00,0.00
2024-12-10 17:39:15,53,6491,10,43,4306.13,7329.02,0.00
2024-12-10 17:39:15,53,6492,10,43,4290.12,7330.00,0.00
2024-12-10 17:39:15,54,6492,10,44,4210.68,7330.02,0.00
2024-12-10 17:39:15,53,6492,10,43,4274.91,7330.04,0.00
2024-12-10 17:39:15,53,6493,10,43,4287.94,7331.00,0.00
2024-12-10 17:39:15,54,6493,10,44,4208.54,7331.02,0.00
2024-12-10 17:39:15,53,6493,9,44,4183.26,7331.85,0.00
2024-12-10 17:39:15,53,6493,9,44,4310.66,7332.00,0.00
2024-12-10 17:39:15,54,6493,10,44,4230.83,7332.02,0.00
2024-12-10 17:39:15,53,6493,10,43,4296.83,7332.04,0.00
2024-12-10 17:39:15,52,6493,9,43,4278.24,7332.65,0.00
2024-12-10 17:39:15,52,6494,9,43,4394.16,7333.00,0.00
2024-12-10 17:39:15,53,6494,10,43,4311.25,7333.02,0.00
2024-12-10 17:39:15,52,6494,9,43,4354.72,7333.17,0.00
2024-12-10 17:39:15,52,6495,9,43,4435.66,7334.00,0.00
2024-12-10 17:39:15,53,6495,10,43,4351.97,7334.02,0.00
2024-12-10 17:39:15,52,6495,10,42,4422.97,7334.04,0.00
2024-12-10 17:39:15,52,6496,10,42,4437.67,7335.00,0.00
2024-12-10 17:39:15,53,6496,10,43,4353.94,7335.02,0.00
2024-12-10 17:39:15,53,6497,10,43,4337.93,7336.00,0.00
2024-12-10 17:39:15,54,6497,10,44,4257.60,7336.02,0.00
2024-12-10 17:39:15,53,6497,10,43,4326.86,7336.04,0.00
2024-12-10 17:39:15,53,6498,10,43,4339.90,7337.00,0.00
2024-12-10 17:39:15,54,6498,10,44,4259.53,7337.02,0.00
2024-12-10 17:39:15,54,6499,10,44,4242.45,7338.00,0.00
2024-12-10 17:39:15,55,6499,10,45,4165.31,7338.02,0.00
2024-12-10 17:39:15,54,6499,10,44,4231.58,7338.04,0.00
2024-12-10 17:39:15,53,6499,9,44,4266.04,7338.66,0.00
2024-12-10 17:39:15,53,6500,9,44,4379.86,7339.00,0.00
2024-12-10 17:39:15,54,6500,9,45,4298.75,7339.02,0.00
2024-12-10 17:39:15,54,6501,9,45,4281.66,7340.00,0.00
2024-12-10 17:39:15,55,6501,9,46,4203.82,7340.02,0.00
2024-12-10 17:39:15,54,6501,9,45,4269.43,7340.04,0.00
2024-12-10 17:39:15,53,6501,8,45,4266.01,7340.91,0.00
2024-12-10 17:39:15,53,6502,8,45,4397.67,7341.00,0.00
2024-12-10 17:39:15,54,6502,9,45,4316.23,7341.02,0.00
2024-12-10 17:39:15,53,6502,8,45,4288.74,7341.89,0.00
2024-12-10 17:39:15,53,6503,8,45,4419.05,7342.00,0.00
2024-12-10 17:39:15,54,6503,8,46,4337.22,7342.02,0.00
2024-12-10 17:39:15,53,6503,8,45,4407.97,7342.04,0.00
2024-12-10 17:39:15,53,6504,8,45,4421.04,7343.00,0.00
2024-12-10 17:39:15,54,6504,9,45,4339.17,7343.02,0.00
2024-12-10 17:39:15,54,6505,9,45,4322.08,7344.00,0.00
2024-12-10 17:39:15,55,6505,10,45,4243.49,7344.02,0.00
2024-12-10 17:39:15,54,6505,10,44,4312.56,7344.04,0.00
2024-12-10 17:39:15,54,6506,10,44,4324.03,7345.00,0.00
2024-12-10 17:39:15,55,6506,10,45,4245.41,7345.02,0.00
2024-12-10 17:39:15,55,6507,10,45,4227.29,7346.00,0.00
2024-12-10 17:39:15,56,6507,11,45,4151.80,7346.02,0.00
2024-12-10 17:39:15,55,6507,11,44,4219.27,7346.04,0.00
2024-12-10 17:39:15,55,6508,11,44,4229.20,7347.00,0.00
2024-12-10 17:39:15,56,6508,11,45,4153.68,7347.02,0.00
2024-12-10 17:39:15,56,6509,11,45,4134.56,7348.00,0.00
2024-12-10 17:39:15,57,6509,11,46,4062.02,7348.02,0.00
2024-12-10 17:39:15,56,6509,11,45,4125.37,7348.04,0.00
2024-12-10 17:39:15,56,6510,11,45,4133.81,7349.00,0.00
2024-12-10 17:39:15,57,6510,12,45,4061.29,7349.02,0.00
2024-12-10 17:39:15,57,6511,12,45,4041.21,7350.00,0.00
2024-12-10 17:39:15,58,6511,13,45,3971.53,7350.02,0.00
2024-12-10 17:39:15,57,6511,12,45,4039.92,7350.02,0.00
2024-12-10 17:39:15,56,6511,12,44,4105.50,7350.02,0.00
2024-12-10 17:39:15,55,6511,11,44,4097.77,7350.89,0.00
2024-12-10 17:39:15,55,6512,11,44,4223.48,7351.00,0.00
2024-12-10 17:39:15,56,6512,11,45,4148.06,7351.02,0.00
2024-12-10 17:39:15,55,6512,10,45,4183.44,7351.20,0.00
2024-12-10 17:39:15,55,6513,10,45,4205.34,7352.00,0.00
2024-12-10 17:39:15,56,6513,10,46,4130.25,7352.02,0.00
2024-12-10 17:39:15,55,6513,10,45,4198.66,7352.02,0.00
2024-12-10 17:39:15,54,6513,9,45,4225.03,7352.70,0.00
2024-12-10 17:39:15,54,6514,9,45,4285.16,7353.00,0.00
2024-12-10 17:39:15,55,6514,9,46,4207.25,7353.02,0.00
2024-12-10 17:39:15,54,6514,8,46,4243.01,7353.20,0.00
2024-12-10 17:39:15,54,6515,8,46,4321.15,7354.00,0.00
2024-12-10 17:39:15,55,6515,9,46,4242.59,7354.02,0.00
2024-12-10 17:39:15,54,6515,9,45,4312.98,7354.02,0.00
2024-12-10 17:39:15,54,6516,9,45,4323.10,7355.00,0.00
2024-12-10 17:39:15,55,6516,9,46,4244.50,7355.02,0.00
2024-12-10 17:39:15,55,6517,9,46,4226.35,7356.00,0.00
2024-12-10 17:39:15,56,6517,9,47,4150.88,7356.02,0.00
2024-12-10 17:39:15,55,6517,9,46,4219.67,7356.02,0.00
2024-12-10 17:39:15,55,6518,9,46,4228.27,7357.00,0.00
2024-12-10 17:39:15,56,6518,10,46,4152.76,7357.02,0.00
2024-12-10 17:39:15,55,6518,9,46,4108.42,7357.96,0.00
2024-12-10 17:39:15,55,6519,9,46,4239.54,7358.00,0.00
2024-12-10 17:39:15,56,6519,9,47,4163.84,7358.02,0.00
2024-12-10 17:39:15,55,6519,9,46,4232.85,7358.02,0.00
2024-12-10 17:39:15,55,6520,9,46,4241.46,7359.00,0.00
2024-12-10 17:39:15,56,6520,9,47,4165.72,7359.02,0.00
2024-12-10 17:39:15,56,6521,9,47,4146.57,7360.00,0.00
2024-12-10 17:39:15,57,6521,9,48,4073.82,7360.02,0.00
2024-12-10 17:39:15,56,6521,9,47,4141.31,7360.02,0.00
2024-12-10 17:39:15,55,6521,8,47,4123.48,7360.96,0.00
2024-12-10 17:39:15,55,6522,8,47,4254.66,7361.00,0.00
2024-12-10 17:39:15,56,6522,9,47,4178.68,7361.02,0.00
2024-12-10 17:39:15,55,6522,8,47,4177.16,7361.38,0.00
2024-12-10 17:39:15,54,6522,7,47,4230.20,7361.70,0.00
2024-12-10 17:39:15,54,6523,7,47,4344.94,7362.00,0.00
2024-12-10 17:39:15,55,6523,8,47,4265.94,7362.02,0.00
2024-12-10 17:39:15,54,6523,8,46,4340.85,7362.02,0.00
2024-12-10 17:39:15,54,6524,8,46,4350.99,7363.00,0.00
2024-12-10 17:39:15,55,6524,8,47,4271.88,7363.02,0.00
2024-12-10 17:39:16,55,6525,8,47,4253.71,7364.00,0.00
2024-12-10 17:39:16,56,6525,9,47,4177.75,7364.02,0.00
2024-12-10 17:39:16,55,6525,9,46,4251.03,7364.02,0.00
2024-12-10 17:39:16,54,6525,8,46,4279.64,7364.69,0.00
2024-12-10 17:39:16,54,6526,8,46,4338.53,7365.00,0.00
2024-12-10 17:39:16,55,6526,8,47,4259.65,7365.02,0.00
2024-12-10 17:39:16,55,6527,8,47,4241.47,7366.00,0.00
2024-12-10 17:39:16,56,6527,8,48,4165.73,7366.02,0.00
2024-12-10 17:39:16,55,6527,8,47,4240.13,7366.02,0.00
2024-12-10 17:39:16,54,6527,7,47,4305.07,7366.19,0.00
2024-12-10 17:39:16,53,6527,6,47,4368.26,7366.26,0.00
2024-12-10 17:39:16,53,6528,6,47,4453.56,7367.00,0.00
2024-12-10 17:39:16,54,6528,6,48,4371.08,7367.02,0.00
2024-12-10 17:39:16,54,6529,6,48,4353.94,7368.00,0.00
2024-12-10 17:39:16,55,6529,7,48,4274.78,7368.02,0.00
2024-12-10 17:39:16,54,6529,7,47,4352.57,7368.02,0.00
2024-12-10 17:39:16,53,6529,6,47,4351.80,7368.89,0.00
2024-12-10 17:39:16,53,6530,6,47,4482.57,7369.00,0.00
2024-12-10 17:39:16,54,6530,6,48,4399.56,7369.02,0.00
2024-12-10 17:39:16,53,6530,6,47,4453.38,7369.02,0.00
2024-12-10 17:39:16,53,6531,6,47,4465.10,7370.00,0.00
2024-12-10 17:39:16,54,6531,7,47,4382.42,7370.02,0.00
2024-12-10 17:39:16,53,6531,6,47,4386.20,7370.70,0.00
2024-12-10 17:39:16,53,6532,6,47,4447.63,7371.00,0.00
2024-12-10 17:39:16,54,6532,6,48,4365.27,7371.02,0.00
2024-12-10 17:39:16,53,6532,6,47,4444.85,7371.02,0.00
2024-12-10 17:39:16,53,6533,6,47,4456.58,7372.00,0.00
2024-12-10 17:39:16,54,6533,7,47,4374.05,7372.02,0.00
2024-12-10 17:39:16,54,6534,7,47,4356.89,7373.00,0.00
2024-12-10 17:39:16,55,6534,8,47,4277.68,7373.02,0.00
2024-12-10 17:39:16,54,6534,8,46,4354.16,7373.02,0.00
2024-12-10 17:39:16,53,6534,7,46,4358.89,7373.85,0.00
2024-12-10 17:39:16,53,6535,7,46,4487.01,7374.00,0.00
2024-12-10 17:39:16,54,6535,8,46,4403.91,7374.02,0.00
2024-12-10 17:39:16,54,6536,8,46,4386.76,7375.00,0.00
2024-12-10 17:39:16,55,6536,8,47,4307.00,7375.02,0.00
2024-12-10 17:39:16,54,6536,8,46,4385.39,7375.02,0.00
2024-12-10 17:39:16,53,6536,7,46,4383.52,7375.57,0.00
2024-12-10 17:39:16,53,6537,7,46,4491.01,7376.00,0.00
2024-12-10 17:39:16,54,6537,7,47,4407.84,7376.02,0.00
2024-12-10 17:39:16,53,6537,6,47,4398.18,7376.77,0.00
2024-12-10 17:39:16,53,6538,6,47,4520.85,7377.00,0.00
2024-12-10 17:39:16,54,6538,6,48,4437.13,7377.02,0.00
2024-12-10 17:39:16,53,6538,6,47,4513.89,7377.02,0.00
2024-12-10 17:39:16,53,6539,6,47,4525.63,7378.00,0.00
2024-12-10 17:39:16,54,6539,6,48,4441.83,7378.02,0.00
2024-12-10 17:39:16,54,6540,6,48,4424.67,7379.00,0.00
2024-12-10 17:39:16,55,6540,6,49,4344.22,7379.02,0.00
2024-12-10 17:39:16,54,6540,6,48,4419.20,7379.02,0.00
2024-12-10 17:39:16,53,6540,5,48,4416.78,7379.91,0.00
2024-12-10 17:39:16,53,6541,5,48,4549.14,7380.00,0.00
2024-12-10 17:39:16,54,6541,6,48,4464.90,7380.02,0.00
2024-12-10 17:39:16,54,6542,6,48,4447.73,7381.00,0.00
2024-12-10 17:39:16,55,6542,6,49,4366.87,7381.02,0.00
2024-12-10 17:39:16,54,6542,6,48,4443.63,7381.02,0.00
2024-12-10 17:39:16,54,6543,6,48,4453.80,7382.00,0.00
2024-12-10 17:39:16,55,6543,7,48,4372.83,7382.02,0.00
2024-12-10 17:39:16,55,6544,7,48,4354.63,7383.00,0.00
2024-12-10 17:39:16,56,6544,8,48,4276.86,7383.02,0.00
2024-12-10 17:39:16,55,6544,8,47,4351.94,7383.02,0.00
2024-12-10 17:39:16,55,6545,8,47,4360.58,7384.00,0.00
2024-12-10 17:39:16,56,6545,9,47,4282.72,7384.02,0.00
2024-12-10 17:39:16,56,6546,9,47,4263.52,7385.00,0.00
2024-12-10 17:39:16,57,6546,10,47,4188.72,7385.02,0.00
2024-12-10 17:39:16,56,6546,10,46,4256.92,7385.02,0.00
2024-12-10 17:39:16,56,6547,10,46,4264.09,7386.00,0.00
2024-12-10 17:39:16,57,6547,10,47,4189.29,7386.02,0.00
2024-12-10 17:39:16,57,6548,10,47,4169.12,7387.00,0.00
2024-12-10 17:39:16,58,6548,11,47,4097.24,7387.02,0.00
2024-12-10 17:39:16,57,6548,11,46,4163.93,7387.02,0.00
2024-12-10 17:39:16,57,6549,11,46,4169.68,7388.00,0.00
2024-12-10 17:39:16,58,6549,11,47,4097.79,7388.02,0.00
2024-12-10 17:39:16,57,6549,10,47,4053.54,7388.95,0.00
2024-12-10 17:39:16,57,6550,10,47,4179.32,7389.00,0.00
2024-12-10 17:39:16,58,6550,10,48,4107.26,7389.02,0.00
2024-12-10 17:39:16,57,6550,10,47,4174.13,7389.02,0.00
2024-12-10 17:39:16,57,6551,10,47,4179.89,7390.00,0.00
2024-12-10 17:39:16,58,6551,10,48,4107.82,7390.02,0.00
2024-12-10 17:39:16,58,6552,10,48,4086.71,7391.00,0.00
2024-12-10 17:39:16,59,6552,11,48,4017.44,7391.02,0.00
2024-12-10 17:39:16,58,6552,11,47,4082.89,7391.02,0.00
2024-12-10 17:39:16,57,6552,10,47,4064.27,7391.95,0.00
2024-12-10 17:39:16,57,6553,10,47,4190.09,7392.00,0.00
2024-12-10 17:39:16,58,6553,10,48,4117.85,7392.02,0.00
2024-12-10 17:39:16,57,6553,9,48,4111.33,7392.72,0.00
2024-12-10 17:39:16,57,6554,9,48,4168.61,7393.00,0.00
2024-12-10 17:39:16,58,6554,9,49,4096.74,7393.02,0.00
2024-12-10 17:39:16,57,6554,9,48,4164.72,7393.02,0.00
2024-12-10 17:39:16,56,6554,8,48,4161.66,7393.88,0.00
2024-12-10 17:39:16,56,6555,8,48,4284.56,7394.00,0.00
2024-12-10 17:39:16,57,6555,9,48,4209.39,7394.02,0.00
2024-12-10 17:39:16,56,6555,8,48,4184.66,7394.86,0.00
2024-12-10 17:39:16,56,6556,8,48,4306.26,7395.00,0.00
2024-12-10 17:39:16,57,6556,8,49,4230.72,7395.02,0.00
2024-12-10 17:39:16,56,6556,8,48,4303.62,7395.02,0.00
2024-12-10 17:39:17,56,6557,8,48,4310.81,7396.00,0.00
2024-12-10 17:39:17,57,6557,8,49,4235.18,7396.02,0.00
2024-12-10 17:39:17,57,6558,8,49,4214.99,7397.00,0.00
2024-12-10 17:39:17,58,6558,9,49,4142.32,7397.02,0.00
2024-12-10 17:39:17,57,6558,9,48,4211.10,7397.02,0.00
2024-12-10 17:39:17,56,6558,8,48,4193.06,7397.96,0.00
2024-12-10 17:39:17,56,6559,8,48,4322.54,7398.00,0.00
2024-12-10 17:39:17,57,6559,9,48,4246.71,7398.02,0.00
2024-12-10 17:39:17,56,6559,8,48,4206.57,7398.64,0.00
2024-12-10 17:39:17,56,6560,8,48,4312.56,7399.00,0.00
2024-12-10 17:39:17,57,6560,9,48,4236.90,7399.02,0.00
2024-12-10 17:39:17,56,6560,9,47,4309.92,7399.02,0.00
2024-12-10 17:39:17,56,6561,9,47,4317.11,7400.00,0.00
2024-12-10 17:39:17,57,6561,10,47,4241.37,7400.02,0.00
2024-12-10 17:39:17,57,6562,10,47,4221.16,7401.00,0.00
2024-12-10 17:39:17,58,6562,11,47,4148.39,7401.02,0.00
2024-12-10 17:39:17,57,6562,11,46,4217.27,7401.02,0.00
2024-12-10 17:39:17,57,6563,11,46,4223.03,7402.00,0.00
2024-12-10 17:39:17,58,6563,12,46,4150.22,7402.02,0.00
2024-12-10 17:39:17,58,6564,12,46,4129.08,7403.00,0.00
2024-12-10 17:39:17,59,6564,13,46,4059.10,7403.02,0.00
2024-12-10 17:39:17,58,6564,13,45,4126.53,7403.02,0.00
2024-12-10 17:39:17,58,6565,13,45,4130.92,7404.00,0.00
2024-12-10 17:39:17,59,6565,14,45,4060.90,7404.02,0.00
2024-12-10 17:39:17,58,6565,13,45,4023.93,7404.59,0.00
2024-12-10 17:39:17,58,6566,13,45,4121.26,7405.00,0.00
2024-12-10 17:39:17,59,6566,13,46,4051.41,7405.02,0.00
2024-12-10 17:39:17,58,6566,13,45,4119.99,7405.02,0.00
2024-12-10 17:39:17,58,6567,13,45,4124.37,7406.00,0.00
2024-12-10 17:39:17,59,6567,14,45,4054.47,7406.02,0.00
2024-12-10 17:39:17,58,6567,14,44,4097.56,7406.02,0.00
2024-12-10 17:39:17,58,6568,14,44,4101.94,7407.00,0.00
2024-12-10 17:39:17,59,6568,14,45,4032.42,7407.02,0.00
2024-12-10 17:39:17,58,6568,14,44,4075.13,7407.02,0.00
2024-12-10 17:39:17,57,6568,13,44,4061.35,7407.91,0.00
2024-12-10 17:39:17,57,6569,13,44,4184.87,7408.00,0.00
2024-12-10 17:39:17,58,6569,13,45,4112.72,7408.02,0.00
2024-12-10 17:39:17,57,6569,13,44,4157.58,7408.02,0.00
2024-12-10 17:39:17,57,6570,13,44,4163.34,7409.00,0.00
2024-12-10 17:39:17,58,6570,13,45,4091.55,7409.02,0.00
2024-12-10 17:39:17,57,6570,13,44,4136.04,7409.02,0.00
2024-12-10 17:39:17,56,6570,12,44,4121.76,7409.93,0.00
2024-12-10 17:39:17,56,6571,12,44,4248.84,7410.00,0.00
2024-12-10 17:39:17,57,6571,12,45,4174.30,7410.02,0.00
2024-12-10 17:39:17,56,6571,12,44,4221.05,7410.02,0.00
2024-12-10 17:39:17,56,6572,12,44,4228.24,7411.00,0.00
2024-12-10 17:39:17,57,6572,13,44,4154.06,7411.02,0.00
2024-12-10 17:39:17,56,6572,13,43,4200.45,7411.02,0.00
2024-12-10 17:39:17,55,6572,12,43,4197.78,7411.87,0.00
2024-12-10 17:39:17,55,6573,12,43,4323.22,7412.00,0.00
2024-12-10 17:39:17,56,6573,13,43,4246.02,7412.02,0.00
2024-12-10 17:39:17,56,6574,13,43,4226.73,7413.00,0.00
2024-12-10 17:39:17,57,6574,14,43,4152.58,7413.02,0.00
2024-12-10 17:39:17,56,6574,14,42,4222.76,7413.02,0.00
2024-12-10 17:39:17,56,6575,14,42,4229.95,7414.00,0.00
2024-12-10 17:39:17,57,6575,15,42,4155.74,7414.02,0.00
2024-12-10 17:39:17,57,6576,15,42,4135.49,7415.00,0.00
2024-12-10 17:39:17,58,6576,15,43,4064.18,7415.02,0.00
2024-12-10 17:39:17,57,6576,15,42,4132.88,7415.02,0.00
2024-12-10 17:39:17,57,6577,15,42,4138.65,7416.00,0.00
2024-12-10 17:39:17,58,6577,16,42,4067.29,7416.02,0.00
2024-12-10 17:39:17,58,6578,16,42,4046.10,7417.00,0.00
2024-12-10 17:39:17,59,6578,16,43,3977.52,7417.02,0.00
2024-12-10 17:39:17,58,6578,16,42,4044.82,7417.02,0.00
2024-12-10 17:39:17,58,6579,16,42,4049.20,7418.00,0.00
2024-12-10 17:39:17,59,6579,16,43,3980.57,7418.02,0.00
2024-12-10 17:39:17,58,6579,16,42,4022.34,7418.02,0.00
2024-12-10 17:39:17,58,6580,16,42,4026.72,7419.00,0.00
2024-12-10 17:39:17,59,6580,17,42,3958.47,7419.02,0.00
2024-12-10 17:39:17,58,6580,17,41,3999.86,7419.02,0.00
2024-12-10 17:39:17,58,6581,17,41,4004.24,7420.00,0.00
2024-12-10 17:39:17,59,6581,18,41,3936.37,7420.02,0.00
2024-12-10 17:39:17,58,6581,18,40,3977.37,7420.02,0.00
2024-12-10 17:39:17,58,6582,18,40,3981.75,7421.00,0.00
2024-12-10 17:39:17,59,6582,19,40,3914.26,7421.02,0.00
2024-12-10 17:39:17,58,6582,18,40,3905.30,7421.71,0.00
2024-12-10 17:39:17,58,6583,18,40,3960.53,7422.00,0.00
2024-12-10 17:39:17,59,6583,19,40,3893.40,7422.02,0.00
2024-12-10 17:39:17,58,6583,19,39,3959.25,7422.02,0.00
2024-12-10 17:39:17,58,6584,19,39,3963.62,7423.00,0.00
2024-12-10 17:39:17,59,6584,20,39,3896.44,7423.02,0.00
2024-12-10 17:39:17,58,6584,19,39,3887.14,7423.69,0.00
2024-12-10 17:39:17,58,6585,19,39,3941.12,7424.00,0.00
2024-12-10 17:39:17,59,6585,20,39,3874.32,7424.02,0.00
2024-12-10 17:39:17,58,6585,20,38,3938.56,7424.02,0.00
2024-12-10 17:39:17,58,6586,20,38,3942.93,7425.00,0.00
2024-12-10 17:39:17,59,6586,20,39,3876.10,7425.02,0.00
2024-12-10 17:39:17,59,6587,20,39,3853.97,7426.00,0.00
2024-12-10 17:39:17,60,6587,21,39,3789.73,7426.02,0.00
2024-12-10 17:39:17,59,6587,21,38,3851.45,7426.02,0.00
2024-12-10 17:39:17,58,6587,20,38,3855.48,7426.76,0.00
2024-12-10 17:39:17,58,6588,20,38,3965.76,7427.00,0.00
2024-12-10 17:39:17,59,6588,21,38,3898.54,7427.02,0.00
2024-12-10 17:39:17,59,6589,21,38,3876.41,7428.00,0.00
2024-12-10 17:39:17,60,6589,21,39,3811.80,7428.02,0.00
2024-12-10 17:39:17,59,6589,21,38,3875.15,7428.02,0.00
2024-12-10 17:39:18,59,6590,21,38,3878.19,7429.00,0.00
2024-12-10 17:39:18,60,6590,22,38,3813.55,7429.02,0.00
2024-12-10 17:39:18,59,6590,21,38,3851.75,7429.02,0.00
2024-12-10 17:39:18,58,6590,20,38,3877.23,7429.22,0.00
2024-12-10 17:39:18,58,6591,20,38,3948.15,7430.00,0.00
2024-12-10 17:39:18,59,6591,20,39,3881.23,7430.02,0.00
2024-12-10 17:39:18,58,6591,20,38,3945.58,7430.02,0.00
2024-12-10 17:39:18,58,6592,20,38,3949.96,7431.00,0.00
2024-12-10 17:39:18,59,6592,20,39,3883.01,7431.02,0.00
2024-12-10 17:39:18,59,6593,20,39,3860.86,7432.00,0.00
2024-12-10 17:39:18,60,6593,20,40,3796.51,7432.02,0.00
2024-12-10 17:39:18,59,6593,20,39,3859.60,7432.02,0.00
2024-12-10 17:39:18,58,6593,19,39,3833.10,7432.97,0.00
2024-12-10 17:39:18,58,6594,19,39,3958.71,7433.00,0.00
2024-12-10 17:39:18,59,6594,20,39,3891.62,7433.02,0.00
2024-12-10 17:39:18,58,6594,20,38,3931.80,7433.02,0.00
2024-12-10 17:39:18,57,6594,19,38,3929.27,7433.53,0.00
2024-12-10 17:39:18,57,6595,19,38,4024.79,7434.00,0.00
2024-12-10 17:39:18,58,6595,20,38,3955.40,7434.02,0.00
2024-12-10 17:39:18,58,6596,20,38,3934.14,7435.00,0.00
2024-12-10 17:39:18,59,6596,20,39,3867.46,7435.02,0.00
2024-12-10 17:39:18,58,6596,20,38,3932.86,7435.02,0.00
2024-12-10 17:39:18,58,6597,20,38,3937.23,7436.00,0.00
2024-12-10 17:39:18,59,6597,20,39,3870.50,7436.02,0.00
2024-12-10 17:39:18,58,6597,20,38,3910.31,7436.02,0.00
2024-12-10 17:39:18,57,6597,19,38,3928.33,7436.68,0.00
2024-12-10 17:39:18,57,6598,19,38,4035.55,7437.00,0.00
2024-12-10 17:39:18,58,6598,20,38,3965.97,7437.02,0.00
2024-12-10 17:39:18,57,6598,19,38,3948.30,7437.47,0.00
2024-12-10 17:39:18,57,6599,19,38,4040.01,7438.00,0.00
2024-12-10 17:39:18,58,6599,20,38,3970.35,7438.02,0.00
2024-12-10 17:39:18,57,6599,20,37,4038.70,7438.02,0.00
2024-12-10 17:39:18,57,6600,20,37,4044.46,7439.00,0.00
2024-12-10 17:39:18,58,6600,21,37,3974.73,7439.02,0.00
2024-12-10 17:39:18,57,6600,21,36,4017.06,7439.02,0.00
2024-12-10 17:39:18,57,6601,21,36,4022.82,7440.00,0.00
2024-12-10 17:39:18,58,6601,21,37,3953.46,7440.02,0.00
2024-12-10 17:39:18,57,6601,21,36,3995.41,7440.02,0.00
2024-12-10 17:39:18,57,6602,21,36,4001.17,7441.00,0.00
2024-12-10 17:39:18,58,6602,22,36,3932.18,7441.02,0.00
2024-12-10 17:39:18,57,6602,21,36,3960.75,7441.21,0.00
2024-12-10 17:39:18,57,6603,21,36,3980.82,7442.00,0.00
2024-12-10 17:39:18,58,6603,22,36,3912.18,7442.02,0.00
2024-12-10 17:39:18,57,6603,22,35,3978.20,7442.02,0.00
2024-12-10 17:39:18,56,6603,21,35,4001.70,7442.66,0.00
2024-12-10 17:39:18,56,6604,21,35,4056.43,7443.00,0.00
2024-12-10 17:39:18,57,6604,22,35,3985.27,7443.02,0.00
2024-12-10 17:39:18,56,6604,21,35,3943.94,7443.91,0.00
2024-12-10 17:39:18,56,6605,21,35,4070.27,7444.00,0.00
2024-12-10 17:39:18,57,6605,21,36,3998.86,7444.02,0.00
2024-12-10 17:39:18,56,6605,21,35,4067.61,7444.02,0.00
2024-12-10 17:39:18,56,6606,21,35,4074.81,7445.00,0.00
2024-12-10 17:39:18,57,6606,22,35,4003.32,7445.02,0.00
2024-12-10 17:39:18,57,6607,22,35,3982.96,7446.00,0.00
2024-12-10 17:39:18,58,6607,23,35,3914.28,7446.02,0.00
2024-12-10 17:39:18,57,6607,23,34,3981.65,7446.02,0.00
2024-12-10 17:39:18,56,6607,22,34,3958.86,7446.96,0.00
2024-12-10 17:39:18,56,6608,22,34,4089.20,7447.00,0.00
2024-12-10 17:39:18,57,6608,23,34,4017.46,7447.02,0.00
2024-12-10 17:39:18,56,6608,23,33,4061.27,7447.02,0.00
2024-12-10 17:39:18,56,6609,23,33,4068.47,7448.00,0.00
2024-12-10 17:39:18,57,6609,23,34,3997.09,7448.02,0.00
2024-12-10 17:39:18,57,6610,23,34,3976.72,7449.00,0.00
2024-12-10 17:39:18,58,6610,24,34,3908.16,7449.02,0.00
2024-12-10 17:39:18,57,6610,24,33,3975.41,7449.02,0.00
2024-12-10 17:39:18,56,6610,23,33,4009.26,7449.32,0.00
2024-12-10 17:39:18,56,6611,23,33,4092.18,7450.00,0.00
2024-12-10 17:39:18,57,6611,23,34,4020.38,7450.02,0.00
2024-12-10 17:39:18,56,6611,22,34,3986.18,7450.88,0.00
2024-12-10 17:39:18,56,6612,22,34,4110.02,7451.00,0.00
2024-12-10 17:39:18,57,6612,23,34,4037.92,7451.02,0.00
2024-12-10 17:39:18,56,6612,23,33,4108.69,7451.02,0.00
2024-12-10 17:39:18,55,6612,22,33,4167.20,7451.22,0.00
2024-12-10 17:39:18,55,6613,22,33,4190.73,7452.00,0.00
2024-12-10 17:39:18,56,6613,22,34,4115.90,7452.02,0.00
2024-12-10 17:39:18,55,6613,21,34,4104.16,7452.42,0.00
2024-12-10 17:39:18,55,6614,21,34,4196.71,7453.00,0.00
2024-12-10 17:39:18,56,6614,22,34,4121.77,7453.02,0.00
2024-12-10 17:39:18,55,6614,22,33,4192.65,7453.02,0.00
2024-12-10 17:39:18,54,6614,21,33,4189.08,7453.54,0.00
2024-12-10 17:39:18,54,6615,21,33,4292.95,7454.00,0.00
2024-12-10 17:39:18,55,6615,21,34,4214.90,7454.02,0.00
2024-12-10 17:39:18,54,6615,20,34,4203.59,7454.76,0.00
2024-12-10 17:39:18,54,6616,20,34,4323.90,7455.00,0.00
2024-12-10 17:39:18,55,6616,21,34,4245.28,7455.02,0.00
2024-12-10 17:39:18,54,6616,21,33,4321.14,7455.02,0.00
2024-12-10 17:39:18,54,6617,21,33,4331.38,7456.00,0.00
2024-12-10 17:39:18,55,6617,21,34,4252.63,7456.02,0.00
2024-12-10 17:39:18,55,6618,21,34,4234.22,7457.00,0.00
2024-12-10 17:39:18,56,6618,22,34,4158.61,7457.02,0.00
2024-12-10 17:39:18,55,6618,22,33,4232.86,7457.02,0.00
2024-12-10 17:39:18,55,6619,22,33,4241.57,7458.00,0.00
2024-12-10 17:39:18,56,6619,22,34,4165.82,7458.02,0.00
2024-12-10 17:39:18,55,6619,22,33,4213.09,7458.02,0.00
2024-12-10 17:39:18,55,6620,22,33,4221.79,7459.00,0.00
2024-12-10 17:39:18,56,6620,22,34,4146.40,7459.02,0.00
2024-12-10 17:39:18,55,6620,22,33,4193.31,7459.02,0.00
2024-12-10 17:39:18,54,6620,21,33,4178.69,7459.61,0.00
2024-12-10 17:39:18,54,6621,21,33,4288.12,7460.00,0.00
2024-12-10 17:39:18,55,6621,21,34,4210.15,7460.02,0.00
2024-12-10 17:39:18,55,6622,21,34,4191.72,7461.00,0.00
2024-12-10 17:39:18,56,6622,21,35,4116.87,7461.02,0.00
2024-12-10 17:39:18,55,6622,21,34,4180.88,7461.06,0.00
2024-12-10 17:39:18,55,6623,21,34,4192.29,7462.00,0.00
2024-12-10 17:39:19,56,6623,21,35,4117.42,7462.02,0.00
2024-12-10 17:39:19,56,6624,21,35,4097.98,7463.00,0.00
2024-12-10 17:39:19,57,6624,22,35,4026.09,7463.02,0.00
2024-12-10 17:39:19,56,6624,22,34,4087.33,7463.05,0.00
2024-12-10 17:39:19,56,6625,22,34,4097.20,7464.00,0.00
2024-12-10 17:39:19,57,6625,22,35,4025.32,7464.02,0.00
2024-12-10 17:39:19,57,6626,22,35,4005.94,7465.00,0.00
2024-12-10 17:39:19,58,6626,22,36,3936.87,7465.02,0.00
2024-12-10 17:39:19,57,6626,22,35,3996.78,7465.05,0.00
2024-12-10 17:39:19,56,6626,21,35,4021.77,7465.66,0.00
2024-12-10 17:39:19,56,6627,21,35,4076.69,7466.00,0.00
2024-12-10 17:39:19,57,6627,22,35,4005.17,7466.02,0.00
2024-12-10 17:39:19,56,6627,21,35,3987.70,7466.75,0.00
2024-12-10 17:39:19,56,6628,21,35,4102.57,7467.00,0.00
2024-12-10 17:39:19,57,6628,21,36,4030.59,7467.02,0.00
2024-12-10 17:39:19,56,6628,21,35,4094.57,7467.05,0.00
2024-12-10 17:39:19,55,6628,20,35,4162.26,7467.15,0.00
2024-12-10 17:39:19,55,6629,20,35,4180.44,7468.00,0.00
2024-12-10 17:39:19,56,6629,21,35,4105.78,7468.02,0.00
2024-12-10 17:39:19,56,6630,21,35,4086.33,7469.00,0.00
2024-12-10 17:39:19,57,6630,22,35,4014.64,7469.02,0.00
2024-12-10 17:39:19,56,6630,22,34,4078.33,7469.05,0.00
2024-12-10 17:39:19,55,6630,21,34,4073.93,7469.55,0.00
2024-12-10 17:39:19,55,6631,21,34,4176.12,7470.00,0.00
2024-12-10 17:39:19,56,6631,22,34,4101.55,7470.02,0.00
2024-12-10 17:39:19,56,6632,22,34,4082.09,7471.00,0.00
2024-12-10 17:39:19,57,6632,22,35,4010.47,7471.02,0.00
2024-12-10 17:39:19,56,6632,22,34,4075.42,7471.05,0.00
2024-12-10 17:39:19,56,6633,22,34,4085.30,7472.00,0.00
2024-12-10 17:39:19,57,6633,23,34,4013.63,7472.02,0.00
2024-12-10 17:39:19,56,6633,22,34,3978.76,7472.54,0.00
2024-12-10 17:39:19,56,6634,22,34,4077.84,7473.00,0.00
2024-12-10 17:39:19,57,6634,22,35,4006.30,7473.02,0.00
2024-12-10 17:39:19,56,6634,22,34,4071.17,7473.05,0.00
2024-12-10 17:39:19,55,6634,21,34,4137.08,7473.16,0.00
2024-12-10 17:39:19,55,6635,21,34,4156.62,7474.00,0.00
2024-12-10 17:39:19,56,6635,22,34,4082.39,7474.02,0.00
2024-12-10 17:39:19,56,6636,22,34,4062.91,7475.00,0.00
2024-12-10 17:39:19,57,6636,22,35,3991.64,7475.02,0.00
2024-12-10 17:39:19,56,6636,22,34,4057.58,7475.05,0.00
2024-12-10 17:39:19,55,6636,21,34,4039.45,7475.96,0.00
2024-12-10 17:39:19,55,6637,21,34,4172.68,7476.00,0.00
2024-12-10 17:39:19,56,6637,21,35,4098.17,7476.02,0.00
2024-12-10 17:39:19,56,6638,21,35,4081.87,7477.00,0.00
2024-12-10 17:39:19,57,6638,21,36,4010.25,7477.02,0.00
2024-12-10 17:39:19,56,6638,21,35,4067.18,7477.05,0.00
2024-12-10 17:39:19,55,6638,20,35,4122.99,7477.20,0.00
2024-12-10 17:39:19,55,6639,20,35,4199.63,7478.00,0.00
2024-12-10 17:39:19,56,6639,20,36,4124.64,7478.02,0.00
2024-12-10 17:39:19,56,6640,20,36,4108.70,7479.00,0.00
2024-12-10 17:39:19,57,6640,21,36,4036.62,7479.02,0.00
2024-12-10 17:39:19,56,6640,21,35,4094.01,7479.05,0.00
2024-12-10 17:39:19,55,6640,20,35,4139.07,7479.25,0.00
2024-12-10 17:39:19,55,6641,20,35,4219.79,7480.00,0.00
2024-12-10 17:39:19,56,6641,21,35,4144.44,7480.02,0.00
2024-12-10 17:39:19,56,6642,21,35,4128.03,7481.00,0.00
2024-12-10 17:39:19,57,6642,21,36,4055.61,7481.02,0.00
2024-12-10 17:39:19,56,6642,21,35,4126.69,7481.02,0.00
2024-12-10 17:39:19,55,6642,21,34,4189.48,7481.04,0.00
2024-12-10 17:39:19,54,6642,20,34,4258.79,7481.15,0.00
2024-12-10 17:39:19,54,6643,20,34,4278.72,7482.00,0.00
2024-12-10 17:39:19,55,6643,21,34,4200.92,7482.02,0.00
2024-12-10 17:39:19,55,6644,21,34,4182.44,7483.00,0.00
2024-12-10 17:39:19,56,6644,22,34,4107.75,7483.02,0.00
2024-12-10 17:39:19,55,6644,22,33,4171.55,7483.04,0.00
2024-12-10 17:39:19,55,6645,22,33,4181.64,7484.00,0.00
2024-12-10 17:39:19,56,6645,23,33,4106.96,7484.02,0.00
2024-12-10 17:39:19,55,6645,22,33,4051.94,7484.66,0.00
2024-12-10 17:39:19,55,6646,22,33,4162.41,7485.00,0.00
2024-12-10 17:39:19,56,6646,23,33,4088.08,7485.02,0.00
2024-12-10 17:39:19,55,6646,22,33,4161.05,7485.02,0.00
2024-12-10 17:39:19,54,6646,22,32,4229.79,7485.02,0.00
2024-12-10 17:39:19,53,6646,21,32,4302.21,7485.11,0.00
2024-12-10 17:39:19,53,6647,21,32,4321.12,7486.00,0.00
2024-12-10 17:39:19,54,6647,21,33,4241.09,7486.02,0.00
2024-12-10 17:39:19,53,6647,20,33,4243.76,7486.66,0.00
2024-12-10 17:39:19,53,6648,20,33,4303.49,7487.00,0.00
2024-12-10 17:39:19,54,6648,20,34,4223.80,7487.02,0.00
2024-12-10 17:39:19,53,6648,20,33,4289.37,7487.04,0.00
2024-12-10 17:39:19,52,6648,19,33,4288.24,7487.87,0.00
2024-12-10 17:39:19,52,6649,19,33,4422.24,7488.00,0.00
2024-12-10 17:39:19,53,6649,19,34,4338.80,7488.02,0.00
2024-12-10 17:39:19,52,6649,18,34,4386.26,7488.12,0.00
2024-12-10 17:39:19,52,6650,18,34,4406.99,7489.00,0.00
2024-12-10 17:39:19,53,6650,19,34,4323.83,7489.02,0.00
2024-12-10 17:39:19,52,6650,19,33,4392.59,7489.04,0.00
2024-12-10 17:39:19,51,6650,18,33,4433.52,7489.65,0.00
2024-12-10 17:39:19,51,6651,18,33,4554.21,7490.00,0.00
2024-12-10 17:39:19,52,6651,18,34,4466.63,7490.02,0.00
2024-12-10 17:39:19,52,6652,18,34,4451.38,7491.00,0.00
2024-12-10 17:39:19,53,6652,18,35,4367.39,7491.02,0.00
2024-12-10 17:39:19,52,6652,18,34,4438.42,7491.04,0.00
2024-12-10 17:39:19,52,6653,18,34,4453.42,7492.00,0.00
2024-12-10 17:39:19,53,6653,19,34,4369.39,7492.02,0.00
2024-12-10 17:39:19,53,6654,19,34,4355.50,7493.00,0.00
2024-12-10 17:39:19,54,6654,19,35,4274.85,7493.02,0.00
2024-12-10 17:39:19,53,6654,19,34,4334.31,7493.06,0.00
2024-12-10 17:39:19,53,6655,19,34,4349.02,7494.00,0.00
2024-12-10 17:39:19,54,6655,20,34,4268.48,7494.02,0.00
2024-12-10 17:39:19,54,6656,20,34,4255.56,7495.00,0.00
2024-12-10 17:39:19,55,6656,20,35,4178.19,7495.02,0.00
2024-12-10 17:39:19,54,6656,20,34,4233.37,7495.06,0.00
2024-12-10 17:39:19,53,6656,19,34,4309.02,7495.11,0.00
2024-12-10 17:39:20,52,6656,18,34,4298.31,7495.96,0.00
2024-12-10 17:39:20,52,6657,18,34,4439.60,7496.00,0.00
2024-12-10 17:39:20,53,6657,18,35,4355.83,7496.02,0.00
2024-12-10 17:39:20,52,6657,17,35,4399.24,7496.04,0.00
2024-12-10 17:39:20,52,6658,17,35,4443.08,7497.00,0.00
2024-12-10 17:39:20,53,6658,18,35,4359.24,7497.02,0.00
2024-12-10 17:39:20,52,6658,18,34,4421.45,7497.04,0.00
2024-12-10 17:39:20,52,6659,18,34,4436.46,7498.00,0.00
2024-12-10 17:39:20,53,6659,19,34,4352.75,7498.02,0.00
2024-12-10 17:39:20,53,6660,19,34,4338.62,7499.00,0.00
2024-12-10 17:39:20,54,6660,19,35,4258.28,7499.02,0.00
2024-12-10 17:39:20,53,6660,19,34,4318.82,7499.04,0.00
2024-12-10 17:39:20,53,6661,19,34,4332.13,7500.00,0.00
2024-12-10 17:39:20,54,6661,19,35,4251.90,7500.02,0.00
2024-12-10 17:39:20,53,6661,18,35,4254.63,7500.66,0.00
2024-12-10 17:39:20,53,6662,18,35,4316.35,7501.00,0.00
2024-12-10 17:39:20,54,6662,19,35,4236.42,7501.02,0.00
2024-12-10 17:39:20,53,6662,19,34,4297.95,7501.04,0.00
2024-12-10 17:39:20,52,6662,18,34,4284.43,7501.94,0.00
2024-12-10 17:39:20,52,6663,18,34,4424.40,7502.00,0.00
2024-12-10 17:39:20,53,6663,18,35,4340.92,7502.02,0.00
2024-12-10 17:39:20,53,6664,18,35,4326.30,7503.00,0.00
2024-12-10 17:39:20,54,6664,19,35,4246.19,7503.02,0.00
2024-12-10 17:39:20,53,6664,19,34,4306.48,7503.04,0.00
2024-12-10 17:39:20,52,6664,18,34,4377.40,7503.10,0.00
2024-12-10 17:39:20,52,6665,18,34,4454.44,7504.00,0.00
2024-12-10 17:39:20,53,6665,18,35,4370.39,7504.02,0.00
2024-12-10 17:39:20,53,6666,18,35,4355.08,7505.00,0.00
2024-12-10 17:39:20,54,6666,19,35,4274.43,7505.02,0.00
2024-12-10 17:39:20,53,6666,19,34,4336.67,7505.04,0.00
2024-12-10 17:39:20,53,6667,19,34,4350.00,7506.00,0.00
2024-12-10 17:39:20,54,6667,19,35,4269.44,7506.02,0.00
2024-12-10 17:39:20,54,6668,19,35,4257.00,7507.00,0.00
2024-12-10 17:39:20,55,6668,19,36,4179.60,7507.02,0.00
2024-12-10 17:39:20,54,6668,19,35,4236.15,7507.04,0.00
2024-12-10 17:39:20,53,6668,18,35,4238.88,7507.47,0.00
2024-12-10 17:39:20,53,6669,18,35,4341.24,7508.00,0.00
2024-12-10 17:39:20,54,6669,18,36,4260.85,7508.02,0.00
2024-12-10 17:39:20,53,6669,17,36,4310.08,7508.06,0.00
2024-12-10 17:39:20,52,6669,16,36,4342.77,7508.69,0.00
2024-12-10 17:39:20,52,6670,16,36,4464.30,7509.00,0.00
2024-12-10 17:39:20,53,6670,16,37,4380.07,7509.02,0.00
2024-12-10 17:39:20,52,6670,16,36,4439.76,7509.04,0.00
2024-12-10 17:39:20,52,6671,16,36,4454.79,7510.00,0.00
2024-12-10 17:39:20,53,6671,16,37,4370.74,7510.02,0.00
2024-12-10 17:39:20,52,6671,15,37,4368.28,7510.39,0.00
2024-12-10 17:39:20,52,6672,15,37,4466.94,7511.00,0.00
2024-12-10 17:39:20,53,6672,16,37,4382.65,7511.02,0.00
2024-12-10 17:39:20,52,6672,16,36,4439.49,7511.04,0.00
2024-12-10 17:39:20,51,6672,15,36,4469.11,7511.04,0.00
2024-12-10 17:39:20,51,6673,15,36,4544.82,7512.00,0.00
2024-12-10 17:39:20,52,6673,15,37,4457.42,7512.02,0.00
2024-12-10 17:39:20,52,6674,15,37,4449.83,7513.00,0.00
2024-12-10 17:39:20,53,6674,16,37,4365.87,7513.02,0.00
2024-12-10 17:39:20,52,6674,16,36,4422.38,7513.04,0.00
2024-12-10 17:39:20,51,6674,15,36,4455.67,7513.31,0.00
2024-12-10 17:39:20,51,6675,15,36,4551.92,7514.00,0.00
2024-12-10 17:39:20,52,6675,15,37,4464.38,7514.02,0.00
2024-12-10 17:39:20,51,6675,14,37,4550.45,7514.02,0.00
2024-12-10 17:39:20,50,6675,13,37,4530.80,7514.46,0.00
2024-12-10 17:39:20,50,6676,13,37,4640.92,7515.00,0.00
2024-12-10 17:39:20,51,6676,14,37,4549.93,7515.02,0.00
2024-12-10 17:39:20,50,6676,14,36,4613.87,7515.02,0.00
2024-12-10 17:39:20,49,6676,13,36,4634.60,7515.43,0.00
2024-12-10 17:39:20,49,6677,13,36,4745.47,7516.00,0.00
2024-12-10 17:39:20,50,6677,13,37,4650.56,7516.02,0.00
2024-12-10 17:39:20,49,6677,12,37,4711.74,7516.06,0.00
2024-12-10 17:39:20,49,6678,12,37,4739.28,7517.00,0.00
2024-12-10 17:39:20,50,6678,12,38,4644.49,7517.02,0.00
2024-12-10 17:39:20,49,6678,12,37,4710.14,7517.04,0.00
2024-12-10 17:39:20,48,6678,11,37,4805.14,7517.06,0.00
2024-12-10 17:39:20,48,6679,11,37,4829.26,7518.00,0.00
2024-12-10 17:39:20,49,6679,11,38,4730.70,7518.02,0.00
2024-12-10 17:39:20,49,6680,11,38,4721.50,7519.00,0.00
2024-12-10 17:39:20,50,6680,11,39,4627.07,7519.02,0.00
2024-12-10 17:39:20,49,6680,11,38,4692.35,7519.04,0.00
2024-12-10 17:39:20,49,6680,11,38,4712.92,7520.00,0.00
2024-12-10 17:39:20,50,6680,12,38,4618.66,7520.02,0.00
2024-12-10 17:39:20,49,6680,11,38,4591.34,7520.88,0.00
2024-12-10 17:39:20,49,6681,11,38,4735.72,7521.00,0.00
2024-12-10 17:39:20,50,6681,12,38,4641.01,7521.02,0.00
2024-12-10 17:39:20,49,6681,12,37,4706.57,7521.04,0.00
2024-12-10 17:39:20,49,6682,12,37,4727.14,7522.00,0.00
2024-12-10 17:39:20,50,6682,12,38,4632.60,7522.02,0.00
2024-12-10 17:39:20,50,6683,12,38,4623.10,7523.00,0.00
2024-12-10 17:39:20,51,6683,12,39,4532.45,7523.02,0.00
2024-12-10 17:39:20,50,6683,12,38,4596.02,7523.04,0.00
2024-12-10 17:39:20,50,6684,12,38,4614.68,7524.00,0.00
2024-12-10 17:39:20,51,6684,12,39,4524.20,7524.02,0.00
2024-12-10 17:39:20,50,6684,11,39,4538.60,7524.62,0.00
2024-12-10 17:39:20,50,6685,11,39,4605.00,7525.00,0.00
2024-12-10 17:39:20,51,6685,12,39,4514.70,7525.02,0.00
2024-12-10 17:39:20,50,6685,12,38,4579.42,7525.04,0.00
2024-12-10 17:39:20,49,6685,11,38,4578.33,7525.92,0.00
2024-12-10 17:39:20,49,6686,11,38,4725.82,7526.00,0.00
2024-12-10 17:39:20,50,6686,11,39,4631.30,7526.02,0.00
2024-12-10 17:39:20,50,6687,11,39,4619.66,7527.00,0.00
2024-12-10 17:39:20,51,6687,11,40,4529.08,7527.02,0.00
2024-12-10 17:39:20,50,6687,11,39,4595.58,7527.04,0.00
2024-12-10 17:39:20,49,6687,10,39,4645.75,7527.61,0.00
2024-12-10 17:39:20,49,6688,10,39,4709.05,7528.00,0.00
2024-12-10 17:39:20,50,6688,11,39,4614.86,7528.02,0.00
2024-12-10 17:39:20,49,6688,10,39,4579.26,7528.96,0.00
2024-12-10 17:39:20,49,6689,10,39,4729.86,7529.00,0.00
2024-12-10 17:39:21,50,6689,10,40,4635.27,7529.02,0.00
2024-12-10 17:39:21,49,6689,10,39,4706.82,7529.04,0.00
2024-12-10 17:39:21,49,6690,10,39,4727.42,7530.00,0.00
2024-12-10 17:39:21,50,6690,10,40,4632.87,7530.02,0.00
2024-12-10 17:39:21,50,6691,10,40,4619.93,7531.00,0.00
2024-12-10 17:39:21,51,6691,10,41,4529.34,7531.02,0.00
2024-12-10 17:39:21,50,6691,10,40,4597.34,7531.04,0.00
2024-12-10 17:39:21,49,6691,9,40,4594.92,7531.96,0.00
2024-12-10 17:39:21,49,6692,9,40,4745.58,7532.00,0.00
2024-12-10 17:39:21,50,6692,10,40,4650.67,7532.02,0.00
2024-12-10 17:39:21,49,6692,9,40,4634.96,7532.84,0.00
2024-12-10 17:39:21,49,6693,9,40,4776.54,7533.00,0.00
2024-12-10 17:39:21,50,6693,9,41,4681.00,7533.02,0.00
2024-12-10 17:39:21,50,6694,9,41,4668.06,7534.00,0.00
2024-12-10 17:39:21,51,6694,9,42,4576.53,7534.02,0.00
2024-12-10 17:39:21,50,6694,9,41,4648.48,7534.04,0.00
2024-12-10 17:39:21,50,6695,9,41,4667.18,7535.00,0.00
2024-12-10 17:39:21,51,6695,9,42,4575.66,7535.02,0.00
2024-12-10 17:39:21,50,6695,9,41,4646.08,7535.04,0.00
2024-12-10 17:39:21,49,6695,8,41,4644.61,7535.96,0.00
2024-12-10 17:39:21,49,6696,8,41,4795.35,7536.00,0.00
2024-12-10 17:39:21,50,6696,9,41,4699.45,7536.02,0.00
2024-12-10 17:39:21,50,6697,9,41,4687.93,7537.00,0.00
2024-12-10 17:39:21,51,6697,9,42,4596.01,7537.02,0.00
2024-12-10 17:39:21,51,6698,9,42,4587.95,7538.00,0.00
2024-12-10 17:39:21,52,6698,10,42,4499.72,7538.02,0.00
2024-12-10 17:39:21,51,6698,10,41,4553.98,7538.10,0.00
2024-12-10 17:39:21,51,6699,10,41,4575.26,7539.00,0.00
2024-12-10 17:39:21,52,6699,10,42,4487.27,7539.02,0.00
2024-12-10 17:39:21,51,6699,9,42,4497.01,7539.65,0.00
2024-12-10 17:39:21,51,6700,9,42,4618.54,7540.00,0.00
2024-12-10 17:39:21,52,6700,10,42,4529.72,7540.02,0.00
2024-12-10 17:39:21,51,6700,10,41,4586.03,7540.10,0.00
2024-12-10 17:39:21,51,6701,10,41,4607.32,7541.00,0.00
2024-12-10 17:39:21,52,6701,10,42,4518.72,7541.02,0.00
2024-12-10 17:39:21,51,6701,9,42,4562.99,7541.14,0.00
2024-12-10 17:39:21,51,6702,9,42,4646.38,7542.00,0.00
2024-12-10 17:39:21,52,6702,10,42,4557.03,7542.02,0.00
2024-12-10 17:39:21,52,6703,10,42,4545.45,7543.00,0.00
2024-12-10 17:39:21,53,6703,10,43,4459.68,7543.02,0.00
2024-12-10 17:39:21,52,6703,10,42,4530.94,7543.04,0.00
2024-12-10 17:39:21,52,6704,10,42,4546.05,7544.00,0.00
2024-12-10 17:39:21,53,6704,11,42,4460.28,7544.02,0.00
2024-12-10 17:39:21,52,6704,11,41,4519.95,7544.08,0.00
2024-12-10 17:39:21,52,6704,11,41,4537.95,7545.00,0.00
2024-12-10 17:39:21,53,6704,12,41,4452.33,7545.02,0.00
2024-12-10 17:39:21,53,6705,12,41,4439.71,7546.00,0.00
2024-12-10 17:39:21,54,6705,12,42,4357.49,7546.02,0.00
2024-12-10 17:39:21,53,6705,12,41,4426.89,7546.04,0.00
2024-12-10 17:39:21,53,6706,12,41,4440.30,7547.00,0.00
2024-12-10 17:39:21,54,6706,12,42,4358.07,7547.02,0.00
2024-12-10 17:39:21,53,6706,11,42,4338.21,7547.81,0.00
2024-12-10 17:39:21,53,6707,11,42,4466.52,7548.00,0.00
2024-12-10 17:39:21,54,6707,12,42,4383.81,7548.02,0.00
2024-12-10 17:39:21,53,6707,12,41,4453.70,7548.04,0.00
2024-12-10 17:39:21,52,6707,11,41,4471.40,7548.46,0.00
2024-12-10 17:39:21,52,6708,11,41,4576.32,7549.00,0.00
2024-12-10 17:39:21,53,6708,12,41,4489.98,7549.02,0.00
2024-12-10 17:39:21,52,6708,12,40,4556.00,7549.04,0.00
2024-12-10 17:39:21,52,6709,12,40,4571.12,7550.00,0.00
2024-12-10 17:39:21,53,6709,13,40,4484.88,7550.02,0.00
2024-12-10 17:39:21,53,6710,13,40,4473.51,7551.00,0.00
2024-12-10 17:39:21,54,6710,13,41,4390.67,7551.02,0.00
2024-12-10 17:39:21,53,6710,13,40,4447.87,7551.06,0.00
2024-12-10 17:39:21,53,6711,13,40,4462.71,7552.00,0.00
2024-12-10 17:39:21,54,6711,14,40,4380.06,7552.02,0.00
2024-12-10 17:39:21,54,6712,14,40,4368.38,7553.00,0.00
2024-12-10 17:39:21,55,6712,15,40,4288.96,7553.02,0.00
2024-12-10 17:39:21,54,6712,14,40,4366.98,7553.02,0.00
2024-12-10 17:39:21,53,6712,14,39,4426.58,7553.04,0.00
2024-12-10 17:39:21,52,6712,13,39,4410.25,7553.96,0.00
2024-12-10 17:39:21,52,6713,13,39,4552.64,7554.00,0.00
2024-12-10 17:39:21,53,6713,14,39,4466.74,7554.02,0.00
2024-12-10 17:39:21,52,6713,13,39,4459.00,7554.73,0.00
2024-12-10 17:39:21,52,6714,13,39,4584.15,7555.00,0.00
2024-12-10 17:39:21,53,6714,14,39,4497.66,7555.02,0.00
2024-12-10 17:39:21,52,6714,14,38,4562.37,7555.04,0.00
2024-12-10 17:39:21,51,6714,13,38,4647.40,7555.10,0.00
2024-12-10 17:39:21,51,6715,13,38,4668.73,7556.00,0.00
2024-12-10 17:39:21,52,6715,14,38,4578.95,7556.02,0.00
2024-12-10 17:39:21,52,6716,14,38,4563.97,7557.00,0.00
2024-12-10 17:39:21,53,6716,15,38,4477.86,7557.02,0.00
2024-12-10 17:39:21,52,6716,15,37,4542.18,7557.04,0.00
2024-12-10 17:39:21,51,6716,14,37,4535.09,7557.96,0.00
2024-12-10 17:39:21,51,6717,14,37,4680.34,7558.00,0.00
2024-12-10 17:39:21,52,6717,14,38,4590.33,7558.02,0.00
2024-12-10 17:39:21,52,6718,14,38,4574.95,7559.00,0.00
2024-12-10 17:39:21,53,6718,15,38,4488.63,7559.02,0.00
2024-12-10 17:39:21,52,6718,15,37,4554.60,7559.04,0.00
2024-12-10 17:39:21,51,6718,14,37,4639.48,7559.10,0.00
2024-12-10 17:39:21,51,6719,14,37,4660.83,7560.00,0.00
2024-12-10 17:39:21,52,6719,14,38,4571.19,7560.02,0.00
2024-12-10 17:39:21,52,6720,14,38,4555.80,7561.00,0.00
2024-12-10 17:39:21,53,6720,14,39,4469.85,7561.02,0.00
2024-12-10 17:39:21,52,6720,14,38,4535.45,7561.04,0.00
2024-12-10 17:39:21,52,6721,14,38,4550.59,7562.00,0.00
2024-12-10 17:39:21,53,6721,15,38,4464.73,7562.02,0.00
2024-12-10 17:39:21,52,6721,14,38,4443.45,7562.85,0.00
2024-12-10 17:39:21,52,6722,14,38,4577.37,7563.00,0.00
2024-12-10 17:39:21,53,6722,14,39,4491.01,7563.02,0.00
2024-12-10 17:39:21,52,6722,14,38,4557.02,7563.04,0.00
2024-12-10 17:39:21,51,6722,13,38,4601.31,7563.63,0.00
2024-12-10 17:39:22,51,6723,13,38,4662.40,7564.00,0.00
2024-12-10 17:39:22,52,6723,14,38,4572.74,7564.02,0.00
2024-12-10 17:39:22,52,6724,14,38,4557.34,7565.00,0.00
2024-12-10 17:39:22,53,6724,15,38,4471.35,7565.02,0.00
2024-12-10 17:39:22,52,6724,15,37,4538.43,7565.04,0.00
2024-12-10 17:39:22,52,6725,15,37,4553.58,7566.00,0.00
2024-12-10 17:39:22,53,6725,16,37,4467.66,7566.02,0.00
2024-12-10 17:39:22,52,6725,15,37,4467.74,7566.08,0.00
2024-12-10 17:39:22,51,6725,14,37,4514.68,7566.61,0.00
2024-12-10 17:39:22,51,6726,14,37,4633.67,7567.00,0.00
2024-12-10 17:39:22,52,6726,15,37,4544.56,7567.02,0.00
2024-12-10 17:39:22,51,6726,15,36,4612.90,7567.04,0.00
2024-12-10 17:39:22,51,6727,15,36,4629.83,7568.00,0.00
2024-12-10 17:39:22,52,6727,16,36,4540.80,7568.02,0.00
2024-12-10 17:39:22,52,6728,16,36,4525.39,7569.00,0.00
2024-12-10 17:39:22,53,6728,16,37,4440.00,7569.02,0.00
2024-12-10 17:39:22,52,6728,16,36,4506.47,7569.04,0.00
2024-12-10 17:39:22,52,6729,16,36,4521.62,7570.00,0.00
2024-12-10 17:39:22,53,6729,17,36,4436.30,7570.02,0.00
2024-12-10 17:39:22,53,6730,17,36,4419.75,7571.00,0.00
2024-12-10 17:39:22,54,6730,18,36,4337.90,7571.02,0.00
2024-12-10 17:39:22,53,6730,18,35,4401.18,7571.04,0.00
2024-12-10 17:39:22,53,6731,18,35,4414.62,7572.00,0.00
2024-12-10 17:39:22,54,6731,18,36,4332.86,7572.02,0.00
2024-12-10 17:39:22,53,6731,17,36,4323.58,7572.74,0.00
2024-12-10 17:39:22,53,6732,17,36,4446.63,7573.00,0.00
2024-12-10 17:39:22,54,6732,18,36,4364.29,7573.02,0.00
2024-12-10 17:39:22,53,6732,18,35,4428.06,7573.04,0.00
2024-12-10 17:39:22,53,6733,18,35,4441.51,7574.00,0.00
2024-12-10 17:39:22,54,6733,19,35,4359.25,7574.02,0.00
2024-12-10 17:39:22,54,6734,19,35,4341.60,7575.00,0.00
2024-12-10 17:39:22,55,6734,20,35,4262.66,7575.02,0.00
2024-12-10 17:39:22,54,6734,20,34,4323.36,7575.04,0.00
2024-12-10 17:39:22,53,6734,19,34,4356.68,7575.66,0.00
2024-12-10 17:39:22,53,6735,19,34,4416.95,7576.00,0.00
2024-12-10 17:39:22,54,6735,20,34,4335.15,7576.02,0.00
2024-12-10 17:39:22,54,6736,20,34,4317.49,7577.00,0.00
2024-12-10 17:39:22,55,6736,20,35,4238.99,7577.02,0.00
2024-12-10 17:39:22,54,6736,20,34,4300.65,7577.04,0.00
2024-12-10 17:39:22,54,6737,20,34,4312.44,7578.00,0.00
2024-12-10 17:39:22,55,6737,21,34,4234.03,7578.02,0.00
2024-12-10 17:39:22,55,6738,21,34,4215.30,7579.00,0.00
2024-12-10 17:39:22,56,6738,22,34,4140.03,7579.02,0.00
2024-12-10 17:39:22,55,6738,22,33,4200.14,7579.04,0.00
2024-12-10 17:39:22,55,6739,22,33,4210.34,7580.00,0.00
2024-12-10 17:39:22,56,6739,23,33,4135.16,7580.02,0.00
2024-12-10 17:39:22,56,6740,23,33,4115.40,7581.00,0.00
2024-12-10 17:39:22,57,6740,24,33,4043.20,7581.02,0.00
2024-12-10 17:39:22,56,6740,24,32,4101.86,7581.04,0.00
2024-12-10 17:39:22,56,6741,24,32,4110.53,7582.00,0.00
2024-12-10 17:39:22,57,6741,24,33,4038.41,7582.02,0.00
2024-12-10 17:39:22,56,6741,23,33,4033.68,7582.66,0.00
2024-12-10 17:39:22,56,6742,23,33,4089.40,7583.00,0.00
2024-12-10 17:39:22,57,6742,23,34,4017.66,7583.02,0.00
2024-12-10 17:39:22,56,6742,23,33,4077.21,7583.04,0.00
2024-12-10 17:39:22,55,6742,22,33,4067.71,7583.89,0.00
2024-12-10 17:39:22,55,6743,22,33,4197.40,7584.00,0.00
2024-12-10 17:39:22,56,6743,23,33,4122.44,7584.02,0.00
2024-12-10 17:39:22,56,6744,23,33,4102.67,7585.00,0.00
2024-12-10 17:39:22,57,6744,23,34,4030.69,7585.02,0.00
2024-12-10 17:39:22,56,6744,22,34,4101.32,7585.02,0.00
2024-12-10 17:39:22,55,6744,22,33,4164.85,7585.02,0.00
2024-12-10 17:39:22,55,6745,22,33,4173.68,7586.00,0.00
2024-12-10 17:39:22,56,6745,23,33,4099.15,7586.02,0.00
2024-12-10 17:39:22,56,6746,23,33,4079.37,7587.00,0.00
2024-12-10 17:39:22,57,6746,24,33,4007.80,7587.02,0.00
2024-12-10 17:39:22,56,6746,24,32,4068.53,7587.02,0.00
2024-12-10 17:39:22,56,6747,24,32,4075.84,7588.00,0.00
2024-12-10 17:39:22,57,6747,25,32,4004.33,7588.02,0.00
2024-12-10 17:39:22,57,6748,25,32,3983.56,7589.00,0.00
2024-12-10 17:39:22,58,6748,25,33,3914.88,7589.02,0.00
2024-12-10 17:39:22,57,6748,25,32,3972.91,7589.02,0.00
2024-12-10 17:39:22,57,6749,25,32,3978.76,7590.00,0.00
2024-12-10 17:39:22,58,6749,25,33,3910.16,7590.02,0.00
2024-12-10 17:39:22,57,6749,24,33,3877.94,7590.83,0.00
2024-12-10 17:39:22,57,6750,24,33,3997.93,7591.00,0.00
2024-12-10 17:39:22,58,6750,25,33,3929.00,7591.02,0.00
2024-12-10 17:39:22,57,6750,25,32,3988.60,7591.02,0.00
2024-12-10 17:39:22,57,6751,25,32,3994.46,7592.00,0.00
2024-12-10 17:39:22,58,6751,26,32,3925.59,7592.02,0.00
2024-12-10 17:39:22,58,6752,26,32,3903.85,7593.00,0.00
2024-12-10 17:39:22,59,6752,27,32,3837.68,7593.02,0.00
2024-12-10 17:39:22,58,6752,27,31,3895.99,7593.02,0.00
2024-12-10 17:39:23,58,6753,27,31,3900.43,7594.00,0.00
2024-12-10 17:39:23,59,6753,27,32,3834.32,7594.02,0.00
2024-12-10 17:39:23,59,6754,27,32,3812.19,7595.00,0.00
2024-12-10 17:39:23,60,6754,28,32,3748.65,7595.02,0.00
2024-12-10 17:39:23,59,6754,28,31,3805.75,7595.02,0.00
2024-12-10 17:39:23,58,6754,27,31,3775.50,7595.64,0.00
2024-12-10 17:39:23,57,6754,26,31,3839.10,7595.68,0.00
2024-12-10 17:39:23,57,6755,26,31,3948.59,7596.00,0.00
2024-12-10 17:39:23,58,6755,26,32,3880.51,7596.02,0.00
2024-12-10 17:39:23,58,6756,26,32,3860.06,7597.00,0.00
2024-12-10 17:39:23,59,6756,26,33,3794.64,7597.02,0.00
2024-12-10 17:39:23,58,6756,26,32,3852.21,7597.02,0.00
2024-12-10 17:39:23,57,6756,25,32,3838.88,7597.86,0.00
2024-12-10 17:39:23,57,6757,25,32,3961.62,7598.00,0.00
2024-12-10 17:39:23,58,6757,26,32,3893.32,7598.02,0.00
2024-12-10 17:39:23,57,6757,25,32,3881.93,7598.70,0.00
2024-12-10 17:39:23,57,6758,25,32,3940.81,7599.00,0.00
2024-12-10 17:39:23,58,6758,25,33,3872.86,7599.02,0.00
2024-12-10 17:39:23,57,6758,25,32,3934.14,7599.02,0.00
2024-12-10 17:39:23,57,6759,25,32,3939.99,7600.00,0.00
2024-12-10 17:39:23,58,6759,26,32,3872.06,7600.02,0.00
2024-12-10 17:39:23,58,6760,26,32,3851.09,7601.00,0.00
2024-12-10 17:39:23,59,6760,27,32,3785.81,7601.02,0.00
2024-12-10 17:39:23,58,6760,27,31,3845.84,7601.02,0.00
2024-12-10 17:39:23,57,6760,26,31,3852.81,7601.74,0.00
2024-12-10 17:39:23,57,6761,26,31,3966.37,7602.00,0.00
2024-12-10 17:39:23,58,6761,26,32,3897.98,7602.02,0.00
2024-12-10 17:39:23,58,6762,26,32,3877.70,7603.00,0.00
2024-12-10 17:39:23,59,6762,27,32,3811.98,7603.02,0.00
2024-12-10 17:39:23,58,6762,27,31,3872.46,7603.02,0.00
2024-12-10 17:39:23,58,6763,27,31,3876.90,7604.00,0.00
2024-12-10 17:39:23,59,6763,27,32,3811.19,7604.02,0.00
2024-12-10 17:39:23,58,6763,26,32,3780.23,7604.79,0.00
2024-12-10 17:39:23,58,6764,26,32,3895.78,7605.00,0.00
2024-12-10 17:39:23,59,6764,26,33,3829.75,7605.02,0.00
2024-12-10 17:39:23,58,6764,26,32,3891.84,7605.02,0.00
2024-12-10 17:39:23,57,6764,25,32,3865.68,7605.95,0.00
2024-12-10 17:39:23,57,6765,25,32,3995.15,7606.00,0.00
2024-12-10 17:39:23,58,6765,26,32,3926.27,7606.02,0.00
2024-12-10 17:39:23,58,6766,26,32,3905.51,7607.00,0.00
2024-12-10 17:39:23,59,6766,27,32,3839.32,7607.02,0.00
2024-12-10 17:39:23,58,6766,27,31,3901.58,7607.02,0.00
2024-12-10 17:39:23,58,6767,27,31,3906.02,7608.00,0.00
2024-12-10 17:39:23,59,6767,28,31,3839.82,7608.02,0.00
2024-12-10 17:39:23,59,6768,28,31,3818.96,7609.00,0.00
2024-12-10 17:39:23,60,6768,29,31,3755.31,7609.02,0.00
2024-12-10 17:39:23,59,6768,29,30,3816.38,7609.02,0.00
2024-12-10 17:39:23,58,6768,28,30,3863.88,7609.24,0.00
2024-12-10 17:39:23,58,6769,28,30,3885.31,7610.00,0.00
2024-12-10 17:39:23,59,6769,29,30,3819.46,7610.02,0.00
2024-12-10 17:39:23,58,6769,28,30,3796.24,7610.48,0.00
2024-12-10 17:39:23,58,6770,28,30,3888.45,7611.00,0.00
2024-12-10 17:39:23,59,6770,28,31,3822.54,7611.02,0.00
2024-12-10 17:39:23,58,6770,28,30,3887.14,7611.02,0.00
2024-12-10 17:39:23,58,6771,28,30,3891.59,7612.00,0.00
2024-12-10 17:39:23,59,6771,28,31,3825.63,7612.02,0.00
2024-12-10 17:39:23,59,6772,28,31,3804.11,7613.00,0.00
2024-12-10 17:39:23,60,6772,28,32,3740.71,7613.02,0.00
2024-12-10 17:39:23,59,6772,28,31,3802.82,7613.02,0.00
2024-12-10 17:39:23,59,6773,28,31,3805.90,7614.00,0.00
2024-12-10 17:39:23,60,6773,28,32,3742.47,7614.02,0.00
2024-12-10 17:39:23,59,6773,28,31,3778.80,7614.02,0.00
2024-12-10 17:39:23,59,6774,28,31,3783.62,7615.00,0.00
2024-12-10 17:39:23,60,6774,28,32,3720.56,7615.02,0.00
2024-12-10 17:39:23,59,6774,28,31,3756.52,7615.02,0.00
2024-12-10 17:39:23,58,6774,27,31,3724.36,7615.64,0.00
2024-12-10 17:39:23,58,6775,27,31,3828.35,7616.00,0.00
2024-12-10 17:39:23,59,6775,28,31,3763.46,7616.02,0.00
2024-12-10 17:39:23,58,6775,27,31,3758.77,7616.09,0.00
2024-12-10 17:39:23,57,6775,26,31,3815.39,7616.19,0.00
2024-12-10 17:39:23,56,6775,25,31,3847.32,7616.66,0.00
2024-12-10 17:39:23,56,6776,25,31,3957.74,7617.00,0.00
2024-12-10 17:39:23,57,6776,25,32,3888.30,7617.02,0.00
2024-12-10 17:39:23,56,6776,25,31,3956.38,7617.02,0.00
2024-12-10 17:39:23,56,6777,25,31,3963.70,7618.00,0.00
2024-12-10 17:39:23,57,6777,26,31,3894.16,7618.02,0.00
2024-12-10 17:39:23,57,6778,26,31,3874.15,7619.00,0.00
2024-12-10 17:39:23,58,6778,27,31,3807.35,7619.02,0.00
2024-12-10 17:39:23,57,6778,27,30,3872.81,7619.02,0.00
2024-12-10 17:39:23,56,6778,26,30,3928.41,7619.18,0.00
2024-12-10 17:39:23,55,6778,25,30,3932.57,7619.53,0.00
2024-12-10 17:39:23,55,6779,25,30,4035.44,7620.00,0.00
2024-12-10 17:39:23,56,6779,26,30,3963.38,7620.02,0.00
2024-12-10 17:39:23,56,6780,26,30,3943.90,7621.00,0.00
2024-12-10 17:39:23,57,6780,26,31,3874.71,7621.02,0.00
2024-12-10 17:39:23,56,6780,26,30,3942.54,7621.02,0.00
2024-12-10 17:39:23,56,6781,26,30,3949.86,7622.00,0.00
2024-12-10 17:39:23,57,6781,27,30,3880.56,7622.02,0.00
2024-12-10 17:39:23,57,6782,27,30,3861.56,7623.00,0.00
2024-12-10 17:39:23,58,6782,28,30,3794.98,7623.02,0.00
2024-12-10 17:39:23,57,6782,28,29,3860.22,7623.02,0.00
2024-12-10 17:39:23,56,6782,27,29,3831.07,7623.96,0.00
2024-12-10 17:39:23,56,6783,27,29,3964.51,7624.00,0.00
2024-12-10 17:39:23,57,6783,27,30,3894.96,7624.02,0.00
2024-12-10 17:39:23,57,6784,27,30,3877.36,7625.00,0.00
2024-12-10 17:39:23,58,6784,27,31,3810.51,7625.02,0.00
2024-12-10 17:39:23,57,6784,27,30,3873.35,7625.04,0.00
2024-12-10 17:39:23,56,6784,26,30,3931.67,7625.18,0.00
2024-12-10 17:39:23,55,6784,25,30,3912.34,7625.64,0.00
2024-12-10 17:39:23,55,6785,25,30,4023.52,7626.00,0.00
2024-12-10 17:39:23,56,6785,26,30,3951.68,7626.02,0.00
2024-12-10 17:39:23,55,6785,25,30,3961.13,7626.06,0.00
2024-12-10 17:39:24,55,6786,25,30,4028.21,7627.00,0.00
2024-12-10 17:39:24,56,6786,25,31,3956.28,7627.02,0.00
2024-12-10 17:39:24,55,6786,25,30,4025.44,7627.04,0.00
2024-12-10 17:39:24,54,6786,24,30,4090.14,7627.17,0.00
2024-12-10 17:39:24,54,6787,24,30,4111.82,7628.00,0.00
2024-12-10 17:39:24,55,6787,25,30,4037.06,7628.02,0.00
2024-12-10 17:39:24,54,6787,24,30,4072.31,7628.17,0.00
2024-12-10 17:39:24,53,6787,23,30,4114.20,7628.62,0.00
2024-12-10 17:39:24,52,6787,22,30,4191.95,7628.64,0.00
2024-12-10 17:39:24,52,6788,22,30,4253.98,7629.00,0.00
2024-12-10 17:39:24,53,6788,22,31,4173.72,7629.02,0.00
2024-12-10 17:39:24,52,6788,22,30,4248.11,7629.04,0.00
2024-12-10 17:39:24,51,6788,21,30,4322.47,7629.16,0.00
2024-12-10 17:39:24,51,6789,21,30,4348.43,7630.00,0.00
2024-12-10 17:39:24,52,6789,21,31,4264.81,7630.02,0.00
2024-12-10 17:39:24,51,6789,20,31,4299.11,7630.20,0.00
2024-12-10 17:39:24,51,6790,20,31,4387.90,7631.00,0.00
2024-12-10 17:39:24,52,6790,20,32,4303.52,7631.02,0.00
2024-12-10 17:39:24,51,6790,20,31,4372.95,7631.06,0.00
2024-12-10 17:39:24,51,6791,20,31,4391.47,7632.00,0.00
2024-12-10 17:39:24,52,6791,21,31,4307.02,7632.02,0.00
2024-12-10 17:39:24,51,6791,20,31,4298.90,7632.73,0.00
2024-12-10 17:39:24,51,6792,20,31,4427.83,7633.00,0.00
2024-12-10 17:39:24,52,6792,20,32,4342.68,7633.02,0.00
2024-12-10 17:39:24,51,6792,20,31,4412.87,7633.06,0.00
2024-12-10 17:39:24,50,6792,19,31,4447.71,7633.10,0.00
2024-12-10 17:39:24,50,6793,19,31,4532.25,7634.00,0.00
2024-12-10 17:39:24,51,6793,19,32,4443.38,7634.02,0.00
2024-12-10 17:39:24,51,6794,19,32,4428.99,7635.00,0.00
2024-12-10 17:39:24,52,6794,19,33,4343.82,7635.02,0.00
2024-12-10 17:39:24,51,6794,19,32,4415.52,7635.06,0.00
2024-12-10 17:39:24,51,6795,19,32,4434.06,7636.00,0.00
2024-12-10 17:39:24,52,6795,19,33,4348.79,7636.02,0.00
2024-12-10 17:39:24,51,6795,18,33,4396.65,7636.12,0.00
2024-12-10 17:39:24,50,6795,17,33,4396.52,7636.94,0.00
2024-12-10 17:39:24,50,6796,17,33,4544.72,7637.00,0.00
2024-12-10 17:39:24,51,6796,18,33,4455.61,7637.02,0.00
2024-12-10 17:39:24,50,6796,18,32,4530.98,7637.06,0.00
2024-12-10 17:39:24,50,6797,18,32,4551.43,7638.00,0.00
2024-12-10 17:39:24,51,6797,18,33,4462.18,7638.02,0.00
2024-12-10 17:39:24,50,6797,17,33,4525.46,7638.04,0.00
2024-12-10 17:39:24,50,6798,17,33,4574.94,7639.00,0.00
2024-12-10 17:39:24,51,6798,18,33,4485.23,7639.02,0.00
2024-12-10 17:39:24,50,6798,18,32,4556.61,7639.04,0.00
2024-12-10 17:39:24,50,6799,18,32,4575.54,7640.00,0.00
2024-12-10 17:39:24,51,6799,18,33,4485.82,7640.02,0.00
2024-12-10 17:39:24,50,6799,17,33,4538.88,7640.08,0.00
2024-12-10 17:39:24,50,6800,17,33,4621.98,7641.00,0.00
2024-12-10 17:39:24,51,6800,17,34,4531.35,7641.02,0.00
2024-12-10 17:39:24,50,6800,17,33,4602.12,7641.04,0.00
2024-12-10 17:39:24,49,6800,16,33,4630.55,7641.06,0.00
2024-12-10 17:39:24,49,6801,16,33,4715.37,7642.00,0.00
2024-12-10 17:39:24,50,6801,16,34,4621.06,7642.02,0.00
2024-12-10 17:39:24,49,6801,15,34,4639.03,7642.27,0.00
2024-12-10 17:39:24,49,6802,15,34,4739.38,7643.00,0.00
2024-12-10 17:39:24,50,6802,16,34,4644.59,7643.02,0.00
2024-12-10 17:39:24,49,6802,16,33,4714.42,7643.04,0.00
2024-12-10 17:39:24,49,6803,16,33,4735.32,7644.00,0.00
2024-12-10 17:39:24,50,6803,16,34,4640.61,7644.02,0.00
2024-12-10 17:39:24,49,6803,15,34,4658.44,7644.59,0.00
2024-12-10 17:39:24,49,6804,15,34,4783.58,7645.00,0.00
2024-12-10 17:39:24,50,6804,16,34,4687.91,7645.02,0.00
2024-12-10 17:39:24,49,6804,15,34,4782.02,7645.02,0.00
2024-12-10 17:39:24,48,6804,15,33,4852.98,7645.02,0.00
2024-12-10 17:39:24,48,6805,15,33,4874.32,7646.00,0.00
2024-12-10 17:39:24,49,6805,16,33,4774.85,7646.02,0.00
2024-12-10 17:39:24,49,6806,16,33,4766.40,7647.00,0.00
2024-12-10 17:39:24,50,6806,17,33,4671.07,7647.02,0.00
2024-12-10 17:39:24,49,6806,17,32,4739.87,7647.02,0.00
2024-12-10 17:39:24,48,6806,16,32,4837.03,7647.04,0.00
2024-12-10 17:39:24,48,6807,16,32,4859.96,7648.00,0.00
2024-12-10 17:39:24,49,6807,17,32,4760.78,7648.02,0.00
2024-12-10 17:39:24,49,6808,17,32,4751.96,7649.00,0.00
2024-12-10 17:39:24,50,6808,17,33,4656.92,7649.02,0.00
2024-12-10 17:39:24,49,6808,17,32,4725.43,7649.02,0.00
2024-12-10 17:39:24,48,6808,16,32,4779.55,7649.60,0.00
2024-12-10 17:39:24,48,6809,16,32,4845.22,7650.00,0.00
2024-12-10 17:39:24,49,6809,17,32,4746.34,7650.02,0.00
2024-12-10 17:39:24,49,6810,17,32,4740.07,7651.00,0.00
2024-12-10 17:39:24,50,6810,18,32,4645.27,7651.02,0.00
2024-12-10 17:39:24,50,6811,18,32,4638.13,7652.00,0.00
2024-12-10 17:39:24,51,6811,18,33,4547.19,7652.02,0.00
2024-12-10 17:39:24,50,6811,18,32,4610.59,7652.02,0.00
2024-12-10 17:39:24,50,6812,18,32,4628.03,7653.00,0.00
2024-12-10 17:39:24,51,6812,19,32,4537.28,7653.02,0.00
2024-12-10 17:39:24,50,6812,19,31,4600.48,7653.02,0.00
2024-12-10 17:39:24,49,6812,18,31,4692.80,7653.02,0.00
2024-12-10 17:39:24,49,6813,18,31,4712.16,7654.00,0.00
2024-12-10 17:39:24,50,6813,18,32,4617.92,7654.02,0.00
2024-12-10 17:39:24,50,6814,18,32,4612.36,7655.00,0.00
2024-12-10 17:39:24,51,6814,18,33,4521.92,7655.02,0.00
2024-12-10 17:39:24,50,6814,18,32,4581.74,7655.02,0.00
2024-12-10 17:39:24,49,6814,17,32,4634.72,7655.16,0.00
2024-12-10 17:39:24,49,6815,17,32,4727.45,7656.00,0.00
2024-12-10 17:39:24,50,6815,18,32,4632.90,7656.02,0.00
2024-12-10 17:39:24,50,6816,18,32,4627.84,7657.00,0.00
2024-12-10 17:39:24,51,6816,19,32,4537.10,7657.02,0.00
2024-12-10 17:39:24,50,6816,19,31,4597.21,7657.02,0.00
2024-12-10 17:39:24,49,6816,18,31,4620.21,7657.74,0.00
2024-12-10 17:39:24,49,6817,18,31,4756.36,7658.00,0.00
2024-12-10 17:39:24,50,6817,18,32,4661.24,7658.02,0.00
2024-12-10 17:39:24,50,6818,18,32,4653.99,7659.00,0.00
2024-12-10 17:39:24,51,6818,19,32,4562.74,7659.02,0.00
2024-12-10 17:39:24,50,6818,19,31,4624.89,7659.02,0.00
2024-12-10 17:39:24,50,6819,19,31,4642.35,7660.00,0.00
2024-12-10 17:39:24,51,6819,19,32,4551.32,7660.02,0.00
2024-12-10 17:39:25,51,6820,19,32,4543.91,7661.00,0.00
2024-12-10 17:39:25,52,6820,20,32,4456.53,7661.02,0.00
2024-12-10 17:39:25,51,6820,20,31,4515.37,7661.02,0.00
2024-12-10 17:39:25,50,6820,19,31,4506.62,7661.86,0.00
2024-12-10 17:39:25,50,6821,19,31,4649.23,7662.00,0.00
2024-12-10 17:39:25,51,6821,20,31,4558.07,7662.02,0.00
2024-12-10 17:39:25,50,6821,19,31,4559.01,7662.32,0.00
2024-12-10 17:39:25,50,6822,19,31,4660.64,7663.00,0.00
2024-12-10 17:39:25,51,6822,19,32,4569.26,7663.02,0.00
2024-12-10 17:39:25,50,6822,18,32,4660.35,7663.02,0.00
2024-12-10 17:39:25,49,6822,18,31,4724.19,7663.02,0.00
2024-12-10 17:39:25,49,6823,18,31,4743.57,7664.00,0.00
2024-12-10 17:39:25,50,6823,18,32,4648.70,7664.02,0.00
2024-12-10 17:39:25,50,6824,18,32,4641.86,7665.00,0.00
2024-12-10 17:39:25,51,6824,18,33,4550.84,7665.02,0.00
2024-12-10 17:39:25,50,6824,18,32,4611.20,7665.02,0.00
2024-12-10 17:39:25,49,6824,17,32,4599.29,7665.96,0.00
2024-12-10 17:39:25,49,6825,17,32,4752.63,7666.00,0.00
2024-12-10 17:39:25,50,6825,18,32,4657.58,7666.02,0.00
2024-12-10 17:39:25,50,6826,18,32,4650.20,7667.00,0.00
2024-12-10 17:39:25,51,6826,19,32,4559.02,7667.02,0.00
2024-12-10 17:39:25,50,6826,19,31,4621.07,7667.02,0.00
2024-12-10 17:39:25,50,6827,19,31,4638.54,7668.00,0.00
2024-12-10 17:39:25,51,6827,19,32,4547.59,7668.02,0.00
2024-12-10 17:39:25,50,6827,18,32,4632.41,7668.04,0.00
2024-12-10 17:39:25,50,6828,18,32,4682.09,7669.00,0.00
2024-12-10 17:39:25,51,6828,18,33,4590.29,7669.02,0.00
2024-12-10 17:39:25,50,6828,17,33,4619.21,7669.02,0.00
2024-12-10 17:39:25,50,6829,17,33,4667.36,7670.00,0.00
2024-12-10 17:39:25,51,6829,17,34,4575.85,7670.02,0.00
2024-12-10 17:39:25,50,6829,16,34,4580.36,7670.66,0.00
2024-12-10 17:39:25,50,6830,16,34,4707.95,7671.00,0.00
2024-12-10 17:39:25,51,6830,17,34,4615.64,7671.02,0.00
2024-12-10 17:39:25,50,6830,17,33,4706.42,7671.02,0.00
2024-12-10 17:39:25,50,6831,17,33,4693.22,7672.00,0.00
2024-12-10 17:39:25,51,6831,17,34,4601.20,7672.02,0.00
2024-12-10 17:39:25,50,6831,17,33,4691.69,7672.02,0.00
2024-12-10 17:39:25,49,6831,16,33,4726.77,7672.71,0.00
2024-12-10 17:39:25,49,6832,16,33,4861.66,7673.00,0.00
2024-12-10 17:39:25,50,6832,17,33,4764.42,7673.02,0.00
2024-12-10 17:39:25,50,6833,17,33,4756.98,7674.00,0.00
2024-12-10 17:39:25,51,6833,18,33,4663.71,7674.02,0.00
2024-12-10 17:39:25,50,6833,18,32,4726.28,7674.02,0.00
2024-12-10 17:39:25,50,6834,18,32,4743.78,7675.00,0.00
2024-12-10 17:39:25,51,6834,19,32,4650.77,7675.02,0.00
2024-12-10 17:39:25,51,6835,19,32,4642.09,7676.00,0.00
2024-12-10 17:39:25,52,6835,20,32,4552.82,7676.02,0.00
2024-12-10 17:39:25,51,6835,20,31,4613.49,7676.02,0.00
2024-12-10 17:39:25,51,6836,20,31,4629.15,7677.00,0.00
2024-12-10 17:39:25,52,6836,21,31,4540.12,7677.02,0.00
2024-12-10 17:39:25,52,6837,21,31,4530.31,7678.00,0.00
2024-12-10 17:39:25,53,6837,22,31,4444.84,7678.02,0.00
2024-12-10 17:39:25,52,6837,22,30,4503.74,7678.02,0.00
2024-12-10 17:39:25,51,6837,21,30,4589.04,7678.04,0.00
2024-12-10 17:39:25,51,6838,21,30,4606.19,7679.00,0.00
2024-12-10 17:39:25,52,6838,21,31,4517.61,7679.02,0.00
2024-12-10 17:39:25,52,6839,21,31,4506.54,7680.00,0.00
2024-12-10 17:39:25,53,6839,22,31,4421.51,7680.02,0.00
2024-12-10 17:39:25,52,6839,22,30,4479.96,7680.02,0.00
2024-12-10 17:39:25,51,6839,21,30,4563.12,7680.02,0.00
2024-12-10 17:39:25,51,6840,21,30,4639.02,7681.00,0.00
2024-12-10 17:39:25,52,6840,21,31,4549.81,7681.02,0.00
2024-12-10 17:39:25,51,6840,20,31,4542.81,7681.39,0.00
2024-12-10 17:39:25,51,6841,20,31,4647.16,7682.00,0.00
2024-12-10 17:39:25,52,6841,20,32,4557.79,7682.02,0.00
2024-12-10 17:39:25,51,6841,20,31,4617.03,7682.02,0.00
2024-12-10 17:39:25,51,6842,20,31,4632.70,7683.00,0.00
2024-12-10 17:39:25,52,6842,21,31,4543.61,7683.02,0.00
2024-12-10 17:39:25,51,6842,20,31,4518.69,7683.86,0.00
2024-12-10 17:39:25,51,6843,20,31,4658.91,7684.00,0.00
2024-12-10 17:39:25,52,6843,20,32,4569.32,7684.02,0.00
2024-12-10 17:39:25,51,6843,20,31,4627.27,7684.02,0.00
2024-12-10 17:39:25,51,6844,20,31,4642.94,7685.00,0.00
2024-12-10 17:39:25,52,6844,21,31,4553.66,7685.02,0.00
2024-12-10 17:39:25,51,6844,20,31,4516.02,7685.59,0.00
2024-12-10 17:39:25,51,6845,20,31,4635.38,7686.00,0.00
2024-12-10 17:39:25,52,6845,20,32,4546.24,7686.02,0.00
2024-12-10 17:39:25,51,6845,20,31,4605.24,7686.02,0.00
2024-12-10 17:39:25,51,6846,20,31,4620.91,7687.00,0.00
2024-12-10 17:39:25,52,6846,21,31,4532.05,7687.02,0.00
2024-12-10 17:39:25,51,6846,20,31,4620.91,7687.02,0.00
2024-12-10 17:39:25,51,6847,20,31,4666.73,7688.00,0.00
2024-12-10 17:39:25,52,6847,21,31,4576.99,7688.02,0.00
2024-12-10 17:39:25,51,6847,21,30,4636.58,7688.02,0.00
2024-12-10 17:39:25,51,6848,21,30,4652.26,7689.00,0.00
2024-12-10 17:39:25,52,6848,21,31,4562.80,7689.02,0.00
2024-12-10 17:39:25,52,6849,21,31,4552.86,7690.00,0.00
2024-12-10 17:39:25,53,6849,22,31,4466.96,7690.02,0.00
2024-12-10 17:39:25,52,6849,22,30,4523.28,7690.02,0.00
2024-12-10 17:39:25,51,6849,21,30,4585.07,7690.14,0.00
2024-12-10 17:39:25,51,6850,21,30,4670.06,7691.00,0.00
2024-12-10 17:39:25,52,6850,22,30,4580.25,7691.02,0.00
2024-12-10 17:39:25,52,6851,22,30,4569.73,7692.00,0.00
2024-12-10 17:39:25,53,6851,22,31,4483.51,7692.02,0.00
2024-12-10 17:39:25,52,6851,22,30,4541.63,7692.02,0.00
2024-12-10 17:39:25,51,6851,21,30,4564.01,7692.69,0.00
2024-12-10 17:39:25,51,6852,21,30,4690.95,7693.00,0.00
2024-12-10 17:39:25,52,6852,21,31,4600.74,7693.02,0.00
2024-12-10 17:39:25,52,6853,21,31,4589.55,7694.00,0.00
2024-12-10 17:39:25,53,6853,21,32,4502.95,7694.02,0.00
2024-12-10 17:39:25,52,6853,21,31,4562.92,7694.02,0.00
2024-12-10 17:39:26,52,6854,21,31,4576.83,7695.00,0.00
2024-12-10 17:39:26,53,6854,22,31,4490.47,7695.02,0.00
2024-12-10 17:39:26,53,6855,22,31,4480.33,7696.00,0.00
2024-12-10 17:39:26,54,6855,22,32,4397.36,7696.02,0.00
2024-12-10 17:39:26,53,6855,22,31,4454.19,7696.02,0.00
2024-12-10 17:39:26,53,6856,22,31,4466.39,7697.00,0.00
2024-12-10 17:39:26,54,6856,22,32,4383.68,7697.02,0.00
2024-12-10 17:39:26,54,6857,22,32,4372.37,7698.00,0.00
2024-12-10 17:39:26,55,6857,23,32,4292.87,7698.02,0.00
2024-12-10 17:39:26,54,6857,23,31,4348.14,7698.02,0.00
2024-12-10 17:39:26,53,6857,22,31,4332.93,7698.87,0.00
2024-12-10 17:39:26,53,6858,22,31,4468.11,7699.00,0.00
2024-12-10 17:39:26,54,6858,22,32,4385.37,7699.02,0.00
2024-12-10 17:39:26,54,6859,22,32,4373.81,7700.00,0.00
2024-12-10 17:39:26,55,6859,22,33,4294.28,7700.02,0.00
2024-12-10 17:39:26,54,6859,22,32,4350.99,7700.02,0.00
2024-12-10 17:39:26,54,6860,22,32,4361.54,7701.00,0.00
2024-12-10 17:39:26,55,6860,22,33,4282.24,7701.02,0.00
2024-12-10 17:39:26,54,6860,21,33,4228.74,7701.96,0.00
2024-12-10 17:39:26,54,6861,21,33,4368.54,7702.00,0.00
2024-12-10 17:39:26,55,6861,21,34,4289.11,7702.02,0.00
2024-12-10 17:39:26,54,6861,21,33,4347.14,7702.02,0.00
2024-12-10 17:39:26,54,6862,21,33,4357.69,7703.00,0.00
2024-12-10 17:39:26,55,6862,21,34,4278.46,7703.02,0.00
2024-12-10 17:39:26,55,6863,21,34,4267.48,7704.00,0.00
2024-12-10 17:39:26,56,6863,22,34,4191.28,7704.02,0.00
2024-12-10 17:39:26,55,6863,22,33,4246.47,7704.02,0.00
2024-12-10 17:39:26,54,6863,21,33,4322.59,7704.02,0.00
2024-12-10 17:39:26,54,6864,21,33,4390.21,7705.00,0.00
2024-12-10 17:39:26,55,6864,21,34,4310.39,7705.02,0.00
2024-12-10 17:39:26,55,6865,21,34,4299.61,7706.00,0.00
2024-12-10 17:39:26,56,6865,21,35,4222.83,7706.02,0.00
2024-12-10 17:39:26,55,6865,21,34,4278.59,7706.02,0.00
2024-12-10 17:39:26,54,6865,20,34,4262.57,7706.54,0.00
2024-12-10 17:39:26,54,6866,20,34,4369.94,7707.00,0.00
2024-12-10 17:39:26,55,6866,21,34,4290.49,7707.02,0.00
2024-12-10 17:39:26,55,6867,21,34,4279.57,7708.00,0.00
2024-12-10 17:39:26,56,6867,22,34,4203.15,7708.02,0.00
2024-12-10 17:39:26,55,6867,22,33,4259.95,7708.02,0.00
2024-12-10 17:39:26,55,6868,22,33,4268.91,7709.00,0.00
2024-12-10 17:39:26,56,6868,22,34,4192.68,7709.02,0.00
2024-12-10 17:39:26,55,6868,21,34,4235.29,7709.09,0.00
2024-12-10 17:39:26,55,6869,21,34,4258.34,7710.00,0.00
2024-12-10 17:39:26,56,6869,22,34,4182.30,7710.02,0.00
2024-12-10 17:39:26,55,6869,22,33,4240.12,7710.02,0.00
2024-12-10 17:39:26,54,6869,21,33,4277.37,7710.56,0.00
2024-12-10 17:39:26,53,6869,20,33,4304.27,7710.59,0.00
2024-12-10 17:39:26,53,6870,20,33,4418.06,7711.00,0.00
2024-12-10 17:39:26,54,6870,20,34,4336.24,7711.02,0.00
2024-12-10 17:39:26,53,6870,19,34,4338.38,7711.30,0.00
2024-12-10 17:39:26,53,6871,19,34,4430.52,7712.00,0.00
2024-12-10 17:39:26,54,6871,20,34,4348.47,7712.02,0.00
2024-12-10 17:39:26,53,6871,20,33,4411.60,7712.02,0.00
2024-12-10 17:39:26,52,6871,19,33,4492.01,7712.08,0.00
2024-12-10 17:39:26,52,6872,19,33,4510.37,7713.00,0.00
2024-12-10 17:39:26,53,6872,20,33,4425.27,7713.02,0.00
2024-12-10 17:39:26,52,6872,19,33,4406.98,7713.40,0.00
2024-12-10 17:39:26,52,6873,19,33,4509.76,7714.00,0.00
2024-12-10 17:39:26,53,6873,20,33,4424.67,7714.02,0.00
2024-12-10 17:39:26,52,6873,20,32,4483.07,7714.06,0.00
2024-12-10 17:39:26,52,6874,20,32,4499.95,7715.00,0.00
2024-12-10 17:39:26,53,6874,20,33,4415.05,7715.02,0.00
2024-12-10 17:39:26,52,6874,19,33,4377.79,7715.58,0.00
2024-12-10 17:39:26,52,6875,19,33,4493.85,7716.00,0.00
2024-12-10 17:39:26,53,6875,19,34,4409.06,7716.02,0.00
2024-12-10 17:39:26,52,6875,19,33,4465.67,7716.06,0.00
2024-12-10 17:39:26,51,6875,18,33,4457.34,7716.53,0.00
2024-12-10 17:39:26,50,6875,17,33,4540.37,7716.62,0.00
2024-12-10 17:39:26,50,6876,17,33,4665.69,7717.00,0.00
2024-12-10 17:39:26,51,6876,18,33,4574.20,7717.02,0.00
2024-12-10 17:39:26,50,6876,17,33,4582.47,7717.36,0.00
2024-12-10 17:39:26,50,6877,17,33,4687.90,7718.00,0.00
2024-12-10 17:39:26,51,6877,17,34,4595.98,7718.02,0.00
2024-12-10 17:39:26,50,6877,17,33,4658.58,7718.06,0.00
2024-12-10 17:39:26,50,6878,17,33,4679.25,7719.00,0.00
2024-12-10 17:39:26,51,6878,18,33,4587.50,7719.02,0.00
2024-12-10 17:39:26,50,6878,17,33,4594.45,7719.34,0.00
2024-12-10 17:39:26,50,6879,17,33,4698.38,7720.00,0.00
2024-12-10 17:39:26,51,6879,18,33,4606.26,7720.02,0.00
2024-12-10 17:39:26,50,6879,18,32,4670.60,7720.06,0.00
2024-12-10 17:39:26,50,6880,18,32,4691.27,7721.00,0.00
2024-12-10 17:39:26,51,6880,19,32,4599.28,7721.02,0.00
2024-12-10 17:39:26,50,6880,18,32,4686.84,7721.06,0.00
2024-12-10 17:39:26,50,6881,18,32,4738.40,7722.00,0.00
2024-12-10 17:39:26,51,6881,18,33,4645.49,7722.02,0.00
2024-12-10 17:39:26,50,6881,18,32,4709.07,7722.06,0.00
2024-12-10 17:39:26,50,6882,18,32,4729.75,7723.00,0.00
2024-12-10 17:39:26,51,6882,19,32,4637.01,7723.02,0.00
2024-12-10 17:39:26,51,6883,19,32,4626.50,7724.00,0.00
2024-12-10 17:39:26,52,6883,20,32,4537.53,7724.02,0.00
2024-12-10 17:39:26,51,6883,20,31,4596.22,7724.08,0.00
2024-12-10 17:39:26,51,6884,20,31,4616.50,7725.00,0.00
2024-12-10 17:39:26,52,6884,20,32,4527.72,7725.02,0.00
2024-12-10 17:39:26,51,6884,19,32,4612.91,7725.06,0.00
2024-12-10 17:39:26,51,6885,19,32,4607.96,7726.00,0.00
2024-12-10 17:39:26,52,6885,19,33,4519.34,7726.02,0.00
2024-12-10 17:39:26,51,6885,19,32,4577.67,7726.06,0.00
2024-12-10 17:39:26,50,6885,18,32,4589.28,7726.78,0.00
2024-12-10 17:39:26,50,6886,18,32,4726.98,7727.00,0.00
2024-12-10 17:39:26,51,6886,18,33,4634.30,7727.02,0.00
2024-12-10 17:39:26,50,6886,17,33,4696.07,7727.02,0.00
2024-12-10 17:39:27,50,6887,17,33,4744.60,7728.00,0.00
2024-12-10 17:39:27,51,6887,17,34,4651.56,7728.02,0.00
2024-12-10 17:39:27,50,6887,17,33,4716.78,7728.04,0.00
2024-12-10 17:39:27,49,6887,16,33,4706.12,7728.61,0.00
2024-12-10 17:39:27,49,6888,16,33,4834.16,7729.00,0.00
2024-12-10 17:39:27,50,6888,17,33,4737.48,7729.02,0.00
2024-12-10 17:39:27,49,6888,16,33,4804.19,7729.02,0.00
2024-12-10 17:39:27,49,6889,16,33,4855.30,7730.00,0.00
2024-12-10 17:39:27,50,6889,16,34,4758.19,7730.02,0.00
2024-12-10 17:39:27,49,6889,16,33,4830.06,7730.02,0.00
2024-12-10 17:39:27,49,6890,16,33,4849.61,7731.00,0.00
2024-12-10 17:39:27,50,6890,16,34,4752.62,7731.02,0.00
2024-12-10 17:39:27,49,6890,15,34,4848.44,7731.02,0.00
2024-12-10 17:39:27,49,6891,15,34,4838.80,7732.00,0.00
2024-12-10 17:39:27,50,6891,15,35,4742.03,7732.02,0.00
2024-12-10 17:39:27,49,6891,15,34,4808.83,7732.04,0.00
2024-12-10 17:39:27,49,6892,15,34,4829.96,7733.00,0.00
2024-12-10 17:39:27,50,6892,16,34,4733.36,7733.02,0.00
2024-12-10 17:39:27,50,6893,16,34,4721.38,7734.00,0.00
2024-12-10 17:39:27,51,6893,17,34,4628.81,7734.02,0.00
2024-12-10 17:39:27,50,6893,17,33,4693.55,7734.04,0.00
2024-12-10 17:39:27,49,6893,16,33,4733.11,7734.67,0.00
2024-12-10 17:39:27,49,6894,16,33,4865.94,7735.00,0.00
2024-12-10 17:39:27,50,6894,17,33,4768.62,7735.02,0.00
2024-12-10 17:39:27,50,6895,17,33,4756.82,7736.00,0.00
2024-12-10 17:39:27,51,6895,17,34,4663.55,7736.02,0.00
2024-12-10 17:39:27,50,6895,17,33,4727.44,7736.06,0.00
2024-12-10 17:39:27,50,6896,17,33,4748.15,7737.00,0.00
2024-12-10 17:39:27,51,6896,17,34,4655.05,7737.02,0.00
2024-12-10 17:39:27,50,6896,16,34,4658.00,7737.68,0.00
2024-12-10 17:39:27,50,6897,16,34,4788.24,7738.00,0.00
2024-12-10 17:39:27,51,6897,17,34,4694.35,7738.02,0.00
2024-12-10 17:39:27,51,6898,17,34,4688.11,7739.00,0.00
2024-12-10 17:39:27,52,6898,18,34,4597.96,7739.02,0.00
2024-12-10 17:39:27,51,6898,18,33,4653.22,7739.06,0.00
2024-12-10 17:39:27,50,6898,17,33,4707.11,7739.56,0.00
2024-12-10 17:39:27,50,6899,17,33,4828.18,7740.00,0.00
2024-12-10 17:39:27,51,6899,17,34,4733.51,7740.02,0.00
2024-12-10 17:39:27,51,6900,17,34,4727.16,7741.00,0.00
2024-12-10 17:39:27,52,6900,17,35,4636.25,7741.02,0.00
2024-12-10 17:39:27,51,6900,17,34,4715.01,7741.02,0.00
2024-12-10 17:39:27,51,6901,17,34,4730.80,7742.00,0.00
2024-12-10 17:39:27,52,6901,17,35,4639.83,7742.02,0.00
2024-12-10 17:39:27,51,6901,17,34,4697.42,7742.06,0.00
2024-12-10 17:39:27,50,6901,16,34,4748.34,7742.60,0.00
2024-12-10 17:39:27,50,6902,16,34,4810.59,7743.00,0.00
2024-12-10 17:39:27,51,6902,17,34,4716.27,7743.02,0.00
2024-12-10 17:39:27,51,6903,17,34,4706.48,7744.00,0.00
2024-12-10 17:39:27,52,6903,17,35,4615.97,7744.02,0.00
2024-12-10 17:39:27,51,6903,17,34,4674.60,7744.06,0.00
2024-12-10 17:39:27,51,6904,17,34,4693.42,7745.00,0.00
2024-12-10 17:39:27,52,6904,17,35,4603.16,7745.02,0.00
2024-12-10 17:39:27,52,6905,17,35,4594.65,7746.00,0.00
2024-12-10 17:39:27,53,6905,17,36,4507.96,7746.02,0.00
2024-12-10 17:39:27,52,6905,17,35,4563.38,7746.06,0.00
2024-12-10 17:39:27,52,6906,17,35,4580.34,7747.00,0.00
2024-12-10 17:39:27,53,6906,18,35,4493.92,7747.02,0.00
2024-12-10 17:39:27,53,6907,18,35,4486.90,7748.00,0.00
2024-12-10 17:39:27,54,6907,18,36,4403.81,7748.02,0.00
2024-12-10 17:39:27,53,6907,18,35,4456.21,7748.06,0.00
2024-12-10 17:39:27,52,6907,17,35,4541.91,7748.06,0.00
2024-12-10 17:39:27,51,6907,16,35,4540.05,7748.53,0.00
2024-12-10 17:39:27,51,6908,16,35,4655.86,7749.00,0.00
2024-12-10 17:39:27,52,6908,17,35,4566.33,7749.02,0.00
2024-12-10 17:39:27,52,6909,17,35,4561.03,7750.00,0.00
2024-12-10 17:39:27,53,6909,18,35,4474.97,7750.02,0.00
2024-12-10 17:39:27,52,6909,18,34,4528.25,7750.06,0.00
2024-12-10 17:39:27,52,6910,18,34,4545.22,7751.00,0.00
2024-12-10 17:39:27,53,6910,19,34,4459.46,7751.02,0.00
2024-12-10 17:39:27,52,6910,18,34,4459.05,7751.31,0.00
2024-12-10 17:39:27,52,6911,18,34,4554.92,7752.00,0.00
2024-12-10 17:39:27,53,6911,19,34,4468.97,7752.02,0.00
2024-12-10 17:39:27,52,6911,19,33,4520.64,7752.06,0.00
2024-12-10 17:39:27,52,6912,19,33,4537.61,7753.00,0.00
2024-12-10 17:39:27,53,6912,19,34,4452.00,7753.02,0.00
2024-12-10 17:39:27,52,6912,18,34,4466.07,7753.56,0.00
2024-12-10 17:39:27,52,6913,18,34,4533.94,7754.00,0.00
2024-12-10 17:39:27,53,6913,19,34,4448.40,7754.02,0.00
2024-12-10 17:39:27,52,6913,19,33,4501.14,7754.06,0.00
2024-12-10 17:39:27,51,6913,18,33,4480.03,7754.96,0.00
2024-12-10 17:39:27,51,6914,18,33,4629.07,7755.00,0.00
2024-12-10 17:39:27,52,6914,19,33,4540.05,7755.02,0.00
2024-12-10 17:39:27,51,6914,18,33,4530.39,7755.41,0.00
2024-12-10 17:39:27,51,6915,18,33,4637.27,7756.00,0.00
2024-12-10 17:39:27,52,6915,18,34,4548.09,7756.02,0.00
2024-12-10 17:39:27,51,6915,18,33,4605.34,7756.06,0.00
2024-12-10 17:39:27,51,6916,18,33,4624.18,7757.00,0.00
2024-12-10 17:39:27,52,6916,18,34,4535.25,7757.02,0.00
2024-12-10 17:39:27,52,6917,18,34,4529.53,7758.00,0.00
2024-12-10 17:39:27,53,6917,19,34,4444.07,7758.02,0.00
2024-12-10 17:39:27,52,6917,19,33,4498.21,7758.06,0.00
2024-12-10 17:39:27,52,6918,19,33,4515.20,7759.00,0.00
2024-12-10 17:39:27,53,6918,19,34,4430.00,7759.02,0.00
2024-12-10 17:39:27,53,6919,19,34,4424.11,7760.00,0.00
2024-12-10 17:39:27,54,6919,19,35,4342.18,7760.02,0.00
2024-12-10 17:39:27,53,6919,19,34,4394.83,7760.06,0.00
2024-12-10 17:39:27,53,6920,19,34,4410.04,7761.00,0.00
2024-12-10 17:39:27,54,6920,19,35,4328.37,7761.02,0.00
2024-12-10 17:39:27,53,6920,18,35,4354.36,7761.15,0.00
2024-12-10 17:39:28,53,6921,18,35,4435.43,7762.00,0.00
2024-12-10 17:39:28,54,6921,18,36,4353.29,7762.02,0.00
2024-12-10 17:39:28,53,6921,18,35,4406.15,7762.06,0.00
2024-12-10 17:39:28,52,6921,17,35,4454.09,7762.52,0.00
2024-12-10 17:39:28,51,6921,16,35,4495.06,7762.80,0.00
2024-12-10 17:39:28,51,6922,16,35,4632.21,7763.00,0.00
2024-12-10 17:39:28,52,6922,17,35,4543.13,7763.02,0.00
2024-12-10 17:39:28,51,6922,16,35,4550.33,7763.67,0.00
2024-12-10 17:39:28,51,6923,16,35,4625.01,7764.00,0.00
2024-12-10 17:39:28,52,6923,16,36,4536.07,7764.02,0.00
2024-12-10 17:39:28,51,6923,16,35,4596.09,7764.06,0.00
2024-12-10 17:39:28,51,6924,16,35,4614.95,7765.00,0.00
2024-12-10 17:39:28,52,6924,17,35,4526.20,7765.02,0.00
2024-12-10 17:39:28,51,6924,16,35,4487.72,7765.88,0.00
2024-12-10 17:39:28,51,6925,16,35,4630.95,7766.00,0.00
2024-12-10 17:39:28,52,6925,16,36,4541.90,7766.02,0.00
2024-12-10 17:39:28,51,6925,16,35,4603.55,7766.06,0.00
2024-12-10 17:39:28,50,6925,15,35,4655.83,7766.56,0.00
2024-12-10 17:39:28,50,6926,15,35,4715.21,7767.00,0.00
2024-12-10 17:39:28,51,6926,15,36,4622.75,7767.02,0.00
2024-12-10 17:39:28,51,6927,15,36,4612.57,7768.00,0.00
2024-12-10 17:39:28,52,6927,15,37,4523.86,7768.02,0.00
2024-12-10 17:39:28,51,6927,15,36,4586.68,7768.06,0.00
2024-12-10 17:39:28,51,6928,15,36,4605.54,7769.00,0.00
2024-12-10 17:39:28,52,6928,15,37,4516.98,7769.02,0.00
2024-12-10 17:39:28,52,6929,15,37,4506.42,7770.00,0.00
2024-12-10 17:39:28,53,6929,16,37,4421.40,7770.02,0.00
2024-12-10 17:39:28,52,6929,16,36,4482.52,7770.06,0.00
2024-12-10 17:39:28,51,6929,15,36,4474.11,7770.92,0.00
2024-12-10 17:39:28,51,6930,15,36,4620.44,7771.00,0.00
2024-12-10 17:39:28,52,6930,16,36,4531.59,7771.02,0.00
2024-12-10 17:39:28,51,6930,15,36,4618.92,7771.02,0.00
2024-12-10 17:39:28,50,6930,14,36,4674.02,7771.10,0.00
2024-12-10 17:39:28,50,6931,14,36,4760.09,7772.00,0.00
2024-12-10 17:39:28,51,6931,15,36,4666.76,7772.02,0.00
2024-12-10 17:39:28,50,6931,15,35,4736.78,7772.04,0.00
2024-12-10 17:39:28,50,6932,15,35,4756.04,7773.00,0.00
2024-12-10 17:39:28,51,6932,15,36,4662.78,7773.02,0.00
2024-12-10 17:39:28,50,6932,14,36,4662.90,7773.38,0.00
2024-12-10 17:39:28,50,6933,14,36,4770.65,7774.00,0.00
2024-12-10 17:39:28,51,6933,14,37,4677.10,7774.02,0.00
2024-12-10 17:39:28,50,6933,14,36,4748.88,7774.04,0.00
2024-12-10 17:39:28,49,6933,13,36,4790.40,7774.35,0.00
2024-12-10 17:39:28,49,6934,13,36,4898.78,7775.00,0.00
2024-12-10 17:39:28,50,6934,13,37,4800.80,7775.02,0.00
2024-12-10 17:39:28,50,6935,13,37,4788.47,7776.00,0.00
2024-12-10 17:39:28,51,6935,14,37,4694.58,7776.02,0.00
2024-12-10 17:39:28,50,6935,14,36,4765.14,7776.04,0.00
2024-12-10 17:39:28,50,6936,14,36,4784.42,7777.00,0.00
2024-12-10 17:39:28,51,6936,14,37,4690.61,7777.02,0.00
2024-12-10 17:39:28,50,6936,13,37,4730.02,7777.16,0.00
2024-12-10 17:39:28,50,6937,13,37,4820.81,7778.00,0.00
2024-12-10 17:39:28,51,6937,13,38,4726.29,7778.02,0.00
2024-12-10 17:39:28,50,6937,13,37,4797.48,7778.04,0.00
2024-12-10 17:39:28,49,6937,12,37,4894.73,7778.04,0.00
2024-12-10 17:39:28,49,6938,12,37,4979.50,7779.00,0.00
2024-12-10 17:39:28,50,6938,12,38,4879.91,7779.02,0.00
2024-12-10 17:39:28,50,6939,12,38,4868.86,7780.00,0.00
2024-12-10 17:39:28,51,6939,12,39,4773.39,7780.02,0.00
2024-12-10 17:39:28,50,6939,11,39,4867.30,7780.02,0.00
2024-12-10 17:39:28,49,6939,11,38,4938.06,7780.04,0.00
2024-12-10 17:39:28,48,6939,10,38,4944.78,7780.52,0.00
2024-12-10 17:39:28,48,6940,10,38,5069.96,7781.00,0.00
2024-12-10 17:39:28,49,6940,11,38,4966.49,7781.02,0.00
2024-12-10 17:39:28,48,6940,10,38,4942.16,7781.52,0.00
2024-12-10 17:39:28,48,6941,10,38,5067.37,7782.00,0.00
2024-12-10 17:39:28,49,6941,10,39,4963.95,7782.02,0.00
2024-12-10 17:39:28,48,6941,10,38,5038.19,7782.04,0.00
2024-12-10 17:39:28,48,6942,10,38,5061.53,7783.00,0.00
2024-12-10 17:39:28,49,6942,10,39,4958.23,7783.02,0.00
2024-12-10 17:39:28,48,6942,9,39,4955.49,7783.77,0.00
2024-12-10 17:39:28,48,6943,9,39,5100.01,7784.00,0.00
2024-12-10 17:39:28,49,6943,9,40,4995.93,7784.02,0.00
2024-12-10 17:39:28,49,6944,9,40,4983.86,7785.00,0.00
2024-12-10 17:39:28,50,6944,9,41,4884.18,7785.02,0.00
2024-12-10 17:39:28,49,6944,9,40,4966.38,7785.02,0.00
2024-12-10 17:39:28,48,6944,8,40,5005.15,7785.38,0.00
2024-12-10 17:39:28,48,6945,8,40,5119.16,7786.00,0.00
2024-12-10 17:39:28,49,6945,9,40,5014.69,7786.02,0.00
2024-12-10 17:39:28,48,6945,9,39,5091.59,7786.02,0.00
2024-12-10 17:39:28,47,6945,8,39,5155.63,7786.58,0.00
2024-12-10 17:39:28,47,6946,8,39,5222.26,7787.00,0.00
2024-12-10 17:39:28,48,6946,8,40,5113.46,7787.02,0.00
2024-12-10 17:39:28,48,6947,8,40,5102.76,7788.00,0.00
2024-12-10 17:39:28,49,6947,9,40,4998.62,7788.02,0.00
2024-12-10 17:39:28,48,6947,9,39,5073.56,7788.02,0.00
2024-12-10 17:39:28,48,6948,9,39,5095.30,7789.00,0.00
2024-12-10 17:39:28,49,6948,10,39,4991.31,7789.02,0.00
2024-12-10 17:39:28,49,6949,10,39,4979.24,7790.00,0.00
2024-12-10 17:39:28,50,6949,10,40,4879.65,7790.02,0.00
2024-12-10 17:39:28,49,6949,10,39,4952.21,7790.02,0.00
2024-12-10 17:39:28,49,6950,10,39,4971.93,7791.00,0.00
2024-12-10 17:39:28,50,6950,11,39,4872.49,7791.02,0.00
2024-12-10 17:39:28,49,6950,10,39,4879.85,7791.35,0.00
2024-12-10 17:39:28,49,6951,10,39,4988.47,7792.00,0.00
2024-12-10 17:39:28,50,6951,10,40,4888.70,7792.02,0.00
2024-12-10 17:39:28,49,6951,10,39,4963.02,7792.02,0.00
2024-12-10 17:39:28,49,6952,10,39,4982.75,7793.00,0.00
2024-12-10 17:39:28,50,6952,11,39,4883.09,7793.02,0.00
2024-12-10 17:39:28,50,6953,11,39,4869.69,7794.00,0.00
2024-12-10 17:39:28,51,6953,11,40,4774.20,7794.02,0.00
2024-12-10 17:39:28,50,6953,11,39,4846.31,7794.02,0.00
2024-12-10 17:39:28,50,6954,11,39,4864.08,7795.00,0.00
2024-12-10 17:39:28,51,6954,11,40,4768.70,7795.02,0.00
2024-12-10 17:39:29,51,6955,11,40,4754.03,7796.00,0.00
2024-12-10 17:39:29,52,6955,11,41,4662.61,7796.02,0.00
2024-12-10 17:39:29,51,6955,11,40,4731.10,7796.02,0.00
2024-12-10 17:39:29,50,6955,10,40,4731.17,7796.92,0.00
2024-12-10 17:39:29,50,6956,10,40,4880.92,7797.00,0.00
2024-12-10 17:39:29,51,6956,10,41,4785.22,7797.02,0.00
2024-12-10 17:39:29,51,6957,10,41,4770.54,7798.00,0.00
2024-12-10 17:39:29,52,6957,10,42,4678.80,7798.02,0.00
2024-12-10 17:39:29,51,6957,10,41,4749.13,7798.02,0.00
2024-12-10 17:39:29,50,6957,9,41,4750.80,7798.52,0.00
2024-12-10 17:39:29,50,6958,9,41,4869.69,7799.00,0.00
2024-12-10 17:39:29,51,6958,9,42,4774.21,7799.02,0.00
2024-12-10 17:39:29,50,6958,8,42,4735.85,7799.58,0.00
2024-12-10 17:39:29,50,6959,8,42,4859.40,7800.00,0.00
2024-12-10 17:39:29,51,6959,9,42,4764.12,7800.02,0.00
2024-12-10 17:39:29,50,6959,9,41,4831.32,7800.04,0.00
2024-12-10 17:39:29,50,6960,9,41,4850.66,7801.00,0.00
2024-12-10 17:39:29,51,6960,9,42,4755.55,7801.02,0.00
2024-12-10 17:39:29,51,6961,9,42,4747.83,7802.00,0.00
2024-12-10 17:39:29,52,6961,10,42,4656.53,7802.02,0.00
2024-12-10 17:39:29,51,6961,10,41,4714.20,7802.08,0.00
2024-12-10 17:39:29,51,6962,10,41,4734.67,7803.00,0.00
2024-12-10 17:39:29,52,6962,10,42,4643.62,7803.02,0.00
2024-12-10 17:39:29,51,6962,9,42,4644.79,7803.71,0.00
2024-12-10 17:39:29,51,6963,9,42,4775.07,7804.00,0.00
2024-12-10 17:39:29,52,6963,9,43,4683.24,7804.02,0.00
2024-12-10 17:39:29,51,6963,9,42,4742.95,7804.08,0.00
2024-12-10 17:39:29,51,6964,9,42,4763.43,7805.00,0.00
2024-12-10 17:39:29,52,6964,10,42,4671.83,7805.02,0.00
2024-12-10 17:39:29,51,6964,9,42,4670.47,7805.73,0.00
2024-12-10 17:39:29,51,6965,9,42,4802.31,7806.00,0.00
2024-12-10 17:39:29,52,6965,9,43,4709.96,7806.02,0.00
2024-12-10 17:39:29,51,6965,9,42,4771.72,7806.08,0.00
2024-12-10 17:39:29,51,6966,9,42,4792.21,7807.00,0.00
2024-12-10 17:39:29,52,6966,10,42,4700.05,7807.02,0.00
2024-12-10 17:39:29,51,6966,9,42,4740.17,7807.06,0.00
2024-12-10 17:39:29,51,6967,9,42,4789.76,7808.00,0.00
2024-12-10 17:39:29,52,6967,10,42,4697.65,7808.02,0.00
2024-12-10 17:39:29,51,6967,10,41,4760.68,7808.06,0.00
2024-12-10 17:39:29,51,6968,10,41,4779.66,7809.00,0.00
2024-12-10 17:39:29,52,6968,10,42,4687.74,7809.02,0.00
2024-12-10 17:39:29,52,6969,10,42,4675.27,7810.00,0.00
2024-12-10 17:39:29,53,6969,10,43,4587.05,7810.02,0.00
2024-12-10 17:39:29,52,6969,10,42,4648.24,7810.06,0.00
2024-12-10 17:39:29,51,6969,9,42,4736.33,7810.10,0.00
2024-12-10 17:39:29,51,6970,9,42,4758.36,7811.00,0.00
2024-12-10 17:39:29,52,6970,10,42,4666.85,7811.02,0.00
2024-12-10 17:39:29,52,6971,10,42,4652.92,7812.00,0.00
2024-12-10 17:39:29,53,6971,10,43,4565.13,7812.02,0.00
2024-12-10 17:39:29,52,6971,10,42,4627.39,7812.06,0.00
2024-12-10 17:39:29,52,6972,10,42,4644.50,7813.00,0.00
2024-12-10 17:39:29,53,6972,10,43,4556.87,7813.02,0.00
2024-12-10 17:39:29,53,6973,10,43,4544.02,7814.00,0.00
2024-12-10 17:39:29,54,6973,10,44,4459.87,7814.02,0.00
2024-12-10 17:39:29,53,6973,10,43,4518.97,7814.06,0.00
2024-12-10 17:39:29,52,6973,9,43,4562.60,7814.62,0.00
2024-12-10 17:39:29,52,6974,9,43,4622.98,7815.00,0.00
2024-12-10 17:39:29,53,6974,9,44,4535.76,7815.02,0.00
2024-12-10 17:39:29,52,6974,8,44,4500.02,7815.56,0.00
2024-12-10 17:39:29,52,6975,8,44,4616.06,7816.00,0.00
2024-12-10 17:39:29,53,6975,9,44,4528.96,7816.02,0.00
2024-12-10 17:39:29,52,6975,9,43,4586.00,7816.06,0.00
2024-12-10 17:39:29,51,6975,8,43,4611.09,7816.71,0.00
2024-12-10 17:39:29,51,6976,8,43,4741.57,7817.00,0.00
2024-12-10 17:39:29,52,6976,9,43,4650.38,7817.02,0.00
2024-12-10 17:39:29,51,6976,8,43,4640.60,7817.43,0.00
2024-12-10 17:39:29,51,6977,8,43,4749.84,7818.00,0.00
2024-12-10 17:39:29,52,6977,9,43,4658.49,7818.02,0.00
2024-12-10 17:39:29,51,6977,9,42,4717.65,7818.06,0.00
2024-12-10 17:39:29,51,6978,9,42,4736.65,7819.00,0.00
2024-12-10 17:39:29,52,6978,9,43,4645.56,7819.02,0.00
2024-12-10 17:39:29,52,6979,9,43,4636.04,7820.00,0.00
2024-12-10 17:39:29,53,6979,9,44,4548.57,7820.02,0.00
2024-12-10 17:39:29,52,6979,9,43,4605.97,7820.06,0.00
2024-12-10 17:39:29,51,6979,8,43,4659.14,7820.24,0.00
2024-12-10 17:39:29,51,6980,8,43,4753.19,7821.00,0.00
2024-12-10 17:39:29,52,6980,9,43,4661.79,7821.02,0.00
2024-12-10 17:39:29,52,6981,9,43,4661.75,7822.00,0.00
2024-12-10 17:39:29,53,6981,10,43,4573.79,7822.02,0.00
2024-12-10 17:39:29,53,6982,10,43,4564.49,7823.00,0.00
2024-12-10 17:39:29,54,6982,11,43,4479.97,7823.02,0.00
2024-12-10 17:39:29,53,6982,11,42,4536.45,7823.06,0.00
2024-12-10 17:39:29,53,6983,11,42,4551.79,7824.00,0.00
2024-12-10 17:39:29,54,6983,12,42,4467.50,7824.02,0.00
2024-12-10 17:39:29,54,6984,12,42,4456.89,7825.00,0.00
2024-12-10 17:39:29,55,6984,12,43,4375.86,7825.02,0.00
2024-12-10 17:39:29,54,6984,12,42,4430.81,7825.06,0.00
2024-12-10 17:39:29,53,6984,11,42,4472.05,7825.59,0.00
2024-12-10 17:39:29,53,6985,11,42,4528.44,7826.00,0.00
2024-12-10 17:39:29,54,6985,12,42,4444.58,7826.02,0.00
2024-12-10 17:39:29,54,6986,12,42,4432.91,7827.00,0.00
2024-12-10 17:39:29,55,6986,13,42,4352.32,7827.02,0.00
2024-12-10 17:39:29,54,6986,13,41,4408.28,7827.06,0.00
2024-12-10 17:39:29,53,6986,12,41,4448.44,7827.60,0.00
2024-12-10 17:39:29,53,6987,12,41,4506.30,7828.00,0.00
2024-12-10 17:39:29,54,6987,12,42,4422.85,7828.02,0.00
2024-12-10 17:39:29,54,6988,12,42,4409.18,7829.00,0.00
2024-12-10 17:39:29,55,6988,13,42,4329.01,7829.02,0.00
2024-12-10 17:39:29,54,6988,13,41,4385.98,7829.06,0.00
2024-12-10 17:39:29,53,6988,12,41,4367.09,7829.96,0.00
2024-12-10 17:39:30,53,6989,12,41,4511.89,7830.00,0.00
2024-12-10 17:39:30,54,6989,13,41,4428.33,7830.02,0.00
2024-12-10 17:39:30,54,6990,13,41,4415.49,7831.00,0.00
2024-12-10 17:39:30,55,6990,14,41,4335.21,7831.02,0.00
2024-12-10 17:39:30,54,6990,14,40,4392.29,7831.06,0.00
2024-12-10 17:39:30,53,6990,13,40,4432.16,7831.60,0.00
2024-12-10 17:39:30,53,6991,13,40,4490.07,7832.00,0.00
2024-12-10 17:39:30,54,6991,14,40,4406.92,7832.02,0.00
2024-12-10 17:39:30,53,6991,14,39,4488.59,7832.02,0.00
2024-12-10 17:39:30,53,6992,14,39,4475.92,7833.00,0.00
2024-12-10 17:39:30,54,6992,15,39,4393.04,7833.02,0.00
2024-12-10 17:39:30,53,6992,15,38,4453.75,7833.04,0.00
2024-12-10 17:39:30,53,6993,15,38,4467.63,7834.00,0.00
2024-12-10 17:39:30,54,6993,15,39,4384.89,7834.02,0.00
2024-12-10 17:39:30,53,6993,15,38,4445.45,7834.04,0.00
2024-12-10 17:39:30,53,6994,15,38,4459.33,7835.00,0.00
2024-12-10 17:39:30,54,6994,16,38,4376.75,7835.02,0.00
2024-12-10 17:39:30,54,6995,16,38,4361.22,7836.00,0.00
2024-12-10 17:39:30,55,6995,17,38,4281.92,7836.02,0.00
2024-12-10 17:39:30,54,6995,17,37,4340.90,7836.04,0.00
2024-12-10 17:39:30,53,6995,16,37,4330.28,7836.91,0.00
2024-12-10 17:39:30,53,6996,16,37,4470.82,7837.00,0.00
2024-12-10 17:39:30,54,6996,17,37,4388.02,7837.02,0.00
2024-12-10 17:39:30,53,6996,17,36,4469.34,7837.02,0.00
2024-12-10 17:39:30,53,6997,17,36,4454.79,7838.00,0.00
2024-12-10 17:39:30,54,6997,17,37,4372.29,7838.02,0.00
2024-12-10 17:39:30,53,6997,17,36,4437.04,7838.02,0.00
2024-12-10 17:39:30,52,6997,16,36,4485.55,7838.48,0.00
2024-12-10 17:39:30,51,6997,15,36,4517.61,7838.86,0.00
2024-12-10 17:39:30,51,6998,15,36,4660.65,7839.00,0.00
2024-12-10 17:39:30,52,6998,16,36,4571.02,7839.02,0.00
2024-12-10 17:39:30,52,6999,16,36,4556.11,7840.00,0.00
2024-12-10 17:39:30,53,6999,17,36,4470.15,7840.02,0.00
2024-12-10 17:39:30,52,6999,17,35,4535.00,7840.02,0.00
2024-12-10 17:39:30,52,7000,17,35,4549.15,7841.00,0.00
2024-12-10 17:39:30,53,7000,18,35,4463.32,7841.02,0.00
2024-12-10 17:39:30,53,7001,18,35,4447.74,7842.00,0.00
2024-12-10 17:39:30,54,7001,19,35,4365.37,7842.02,0.00
2024-12-10 17:39:30,53,7001,19,34,4428.50,7842.02,0.00
2024-12-10 17:39:30,53,7002,19,34,4440.91,7843.00,0.00
2024-12-10 17:39:30,54,7002,20,34,4358.67,7843.02,0.00
2024-12-10 17:39:30,53,7002,19,34,4317.29,7843.57,0.00
2024-12-10 17:39:30,53,7003,19,34,4431.52,7844.00,0.00
2024-12-10 17:39:30,54,7003,20,34,4349.46,7844.02,0.00
2024-12-10 17:39:30,53,7003,20,33,4413.76,7844.02,0.00
2024-12-10 17:39:30,53,7004,20,33,4426.17,7845.00,0.00
2024-12-10 17:39:30,54,7004,21,33,4344.20,7845.02,0.00
2024-12-10 17:39:30,53,7004,20,33,4322.76,7845.45,0.00
2024-12-10 17:39:30,54,7003,21,33,4205.24,7845.96,0.00
2024-12-10 17:39:30,54,7004,21,33,4350.57,7846.00,0.00
2024-12-10 17:39:30,55,7004,22,33,4271.47,7846.02,0.00
2024-12-10 17:39:30,54,7004,22,32,4333.13,7846.02,0.00
2024-12-10 17:39:30,54,7005,22,32,4489.17,7847.00,0.00
2024-12-10 17:39:30,55,7005,23,32,4407.55,7847.02,0.00
2024-12-10 17:39:30,55,7006,23,32,4389.72,7848.00,0.00
2024-12-10 17:39:30,56,7006,23,33,4311.33,7848.02,0.00
2024-12-10 17:39:30,55,7006,23,32,4374.02,7848.02,0.00
2024-12-10 17:39:30,54,7006,22,32,4411.29,7848.57,0.00
2024-12-10 17:39:30,53,7006,21,32,4492.99,7848.60,0.00
2024-12-10 17:39:30,52,7006,20,32,4525.13,7848.94,0.00
2024-12-10 17:39:30,52,7007,20,32,4671.59,7849.00,0.00
2024-12-10 17:39:30,53,7007,20,33,4583.44,7849.02,0.00
2024-12-10 17:39:30,53,7008,20,33,4566.25,7850.00,0.00
2024-12-10 17:39:30,54,7008,20,34,4481.69,7850.02,0.00
2024-12-10 17:39:30,53,7008,20,33,4551.44,7850.02,0.00
2024-12-10 17:39:30,52,7008,19,33,4557.68,7850.50,0.00
2024-12-10 17:39:30,52,7009,19,33,4669.76,7851.00,0.00
2024-12-10 17:39:30,53,7009,20,33,4581.65,7851.02,0.00
2024-12-10 17:39:30,53,7010,20,33,4564.45,7852.00,0.00
2024-12-10 17:39:30,54,7010,20,34,4479.93,7852.02,0.00
2024-12-10 17:39:30,53,7010,20,33,4551.12,7852.02,0.00
2024-12-10 17:39:30,53,7011,20,33,4563.55,7853.00,0.00
2024-12-10 17:39:30,54,7011,20,34,4479.04,7853.02,0.00
2024-12-10 17:39:30,53,7011,19,34,4462.99,7853.45,0.00
2024-12-10 17:39:30,53,7012,19,34,4568.58,7854.00,0.00
2024-12-10 17:39:30,54,7012,20,34,4483.98,7854.02,0.00
2024-12-10 17:39:30,53,7012,20,33,4555.24,7854.02,0.00
2024-12-10 17:39:30,53,7013,20,33,4567.68,7855.00,0.00
2024-12-10 17:39:30,54,7013,20,34,4483.09,7855.02,0.00
2024-12-10 17:39:30,53,7013,19,34,4474.55,7855.72,0.00
2024-12-10 17:39:30,53,7014,19,34,4600.75,7856.00,0.00
2024-12-10 17:39:30,54,7014,20,34,4515.55,7856.02,0.00
2024-12-10 17:39:30,53,7014,20,33,4588.89,7856.02,0.00
2024-12-10 17:39:30,53,7015,20,33,4601.33,7857.00,0.00
2024-12-10 17:39:30,54,7015,20,34,4516.12,7857.02,0.00
2024-12-10 17:39:30,54,7016,20,34,4497.78,7858.00,0.00
2024-12-10 17:39:30,55,7016,21,34,4416.00,7858.02,0.00
2024-12-10 17:39:30,54,7016,21,33,4487.59,7858.02,0.00
2024-12-10 17:39:30,54,7017,21,33,4498.35,7859.00,0.00
2024-12-10 17:39:30,55,7017,21,34,4416.56,7859.02,0.00
2024-12-10 17:39:30,54,7017,20,34,4369.23,7859.96,0.00
2024-12-10 17:39:30,54,7018,20,34,4511.89,7860.00,0.00
2024-12-10 17:39:30,55,7018,20,35,4429.86,7860.02,0.00
2024-12-10 17:39:30,54,7018,20,34,4503.16,7860.02,0.00
2024-12-10 17:39:30,54,7019,20,34,4513.92,7861.00,0.00
2024-12-10 17:39:30,55,7019,21,34,4431.85,7861.02,0.00
2024-12-10 17:39:30,55,7020,21,34,4411.52,7862.00,0.00
2024-12-10 17:39:30,56,7020,22,34,4332.75,7862.02,0.00
2024-12-10 17:39:30,55,7020,22,33,4402.95,7862.02,0.00
2024-12-10 17:39:31,55,7021,22,33,4408.90,7863.00,0.00
2024-12-10 17:39:31,56,7021,22,34,4330.17,7863.02,0.00
2024-12-10 17:39:31,56,7022,22,34,4303.80,7864.00,0.00
2024-12-10 17:39:31,57,7022,22,35,4228.30,7864.02,0.00
2024-12-10 17:39:31,56,7022,22,34,4293.97,7864.02,0.00
2024-12-10 17:39:31,55,7022,21,34,4322.31,7864.66,0.00
2024-12-10 17:39:31,54,7022,20,34,4400.90,7864.67,0.00
2024-12-10 17:39:31,54,7023,20,34,4514.48,7865.00,0.00
2024-12-10 17:39:31,55,7023,21,34,4432.40,7865.02,0.00
2024-12-10 17:39:31,55,7024,21,34,4403.51,7866.00,0.00
2024-12-10 17:39:31,56,7024,21,35,4324.88,7866.02,0.00
2024-12-10 17:39:31,55,7024,21,34,4393.50,7866.02,0.00
2024-12-10 17:39:31,55,7025,21,34,4391.41,7867.00,0.00
2024-12-10 17:39:31,56,7025,22,34,4312.99,7867.02,0.00
2024-12-10 17:39:31,55,7025,21,34,4256.03,7867.93,0.00
2024-12-10 17:39:31,55,7026,21,34,4393.41,7868.00,0.00
2024-12-10 17:39:31,56,7026,22,34,4314.96,7868.02,0.00
2024-12-10 17:39:31,55,7026,22,33,4383.40,7868.02,0.00
2024-12-10 17:39:31,55,7027,22,33,4376.36,7869.00,0.00
2024-12-10 17:39:31,56,7027,22,34,4298.21,7869.02,0.00
2024-12-10 17:39:31,56,7028,22,34,4259.07,7870.00,0.00
2024-12-10 17:39:31,57,7028,23,34,4184.35,7870.02,0.00
2024-12-10 17:39:31,56,7028,23,33,4250.64,7870.02,0.00
2024-12-10 17:39:31,56,7029,23,33,4238.88,7871.00,0.00
2024-12-10 17:39:31,57,7029,24,33,4164.52,7871.02,0.00
2024-12-10 17:39:31,56,7029,24,32,4140.13,7871.73,0.00
2024-12-10 17:39:31,56,7030,24,32,4203.58,7872.00,0.00
2024-12-10 17:39:31,57,7030,24,33,4129.83,7872.02,0.00
2024-12-10 17:39:31,56,7030,24,32,4196.55,7872.02,0.00
2024-12-10 17:39:31,56,7031,24,32,4204.12,7873.00,0.00
2024-12-10 17:39:31,57,7031,25,32,4130.36,7873.02,0.00
2024-12-10 17:39:31,56,7031,24,32,4086.25,7873.57,0.00
2024-12-10 17:39:31,56,7032,24,32,4193.40,7874.00,0.00
2024-12-10 17:39:31,57,7032,25,32,4119.83,7874.02,0.00
2024-12-10 17:39:31,56,7032,25,31,4187.78,7874.02,0.00
2024-12-10 17:39:31,56,7033,25,31,4195.34,7875.00,0.00
2024-12-10 17:39:31,57,7033,26,31,4121.74,7875.02,0.00
2024-12-10 17:39:31,57,7034,26,31,4100.15,7876.00,0.00
2024-12-10 17:39:31,58,7034,26,32,4029.46,7876.02,0.00
2024-12-10 17:39:31,57,7034,26,31,4096.01,7876.02,0.00
2024-12-10 17:39:31,56,7034,25,31,4069.79,7876.96,0.00
2024-12-10 17:39:31,56,7035,25,31,4207.66,7877.00,0.00
2024-12-10 17:39:31,57,7035,25,32,4133.84,7877.02,0.00
2024-12-10 17:39:31,56,7035,24,32,4095.56,7877.88,0.00
2024-12-10 17:39:31,56,7036,24,32,4226.48,7878.00,0.00
2024-12-10 17:39:31,57,7036,25,32,4152.33,7878.02,0.00
2024-12-10 17:39:31,56,7036,25,31,4223.67,7878.02,0.00
2024-12-10 17:39:31,56,7037,25,31,4231.24,7879.00,0.00
2024-12-10 17:39:31,57,7037,25,32,4157.01,7879.02,0.00
2024-12-10 17:39:31,57,7038,25,32,4135.41,7880.00,0.00
2024-12-10 17:39:31,58,7038,25,33,4064.11,7880.02,0.00
2024-12-10 17:39:31,57,7038,25,32,4132.65,7880.02,0.00
2024-12-10 17:39:31,56,7038,24,32,4150.29,7880.41,0.00
2024-12-10 17:39:31,56,7039,24,32,4244.98,7881.00,0.00
2024-12-10 17:39:31,57,7039,25,32,4170.50,7881.02,0.00
2024-12-10 17:39:31,57,7040,25,32,4148.91,7882.00,0.00
2024-12-10 17:39:31,58,7040,26,32,4077.38,7882.02,0.00
2024-12-10 17:39:31,57,7040,26,31,4146.14,7882.02,0.00
2024-12-10 17:39:31,57,7041,26,31,4152.20,7883.00,0.00
2024-12-10 17:39:31,58,7041,26,32,4080.61,7883.02,0.00
2024-12-10 17:39:31,58,7042,26,32,4058.02,7884.00,0.00
2024-12-10 17:39:31,59,7042,26,33,3989.24,7884.02,0.00
2024-12-10 17:39:31,58,7042,26,32,4056.66,7884.02,0.00
2024-12-10 17:39:31,58,7043,26,32,4061.25,7885.00,0.00
2024-12-10 17:39:31,59,7043,26,33,3992.42,7885.02,0.00
2024-12-10 17:39:31,59,7044,26,33,3969.89,7886.00,0.00
2024-12-10 17:39:31,60,7044,27,33,3903.73,7886.02,0.00
2024-12-10 17:39:31,59,7044,27,32,3968.55,7886.02,0.00
2024-12-10 17:39:31,58,7044,26,32,3973.52,7886.43,0.00
2024-12-10 17:39:31,58,7045,26,32,4065.00,7887.00,0.00
2024-12-10 17:39:31,59,7045,27,32,3996.11,7887.02,0.00
2024-12-10 17:39:31,58,7045,26,32,4026.55,7887.16,0.00
2024-12-10 17:39:31,58,7046,26,32,4044.68,7888.00,0.00
2024-12-10 17:39:31,59,7046,26,33,3976.13,7888.02,0.00
2024-12-10 17:39:31,58,7046,26,32,4041.96,7888.02,0.00
2024-12-10 17:39:31,57,7046,25,32,4102.45,7888.14,0.00
2024-12-10 17:39:31,56,7046,24,32,4133.71,7888.68,0.00
2024-12-10 17:39:31,56,7047,24,32,4193.10,7889.00,0.00
2024-12-10 17:39:31,57,7047,25,32,4119.54,7889.02,0.00
2024-12-10 17:39:31,56,7047,24,32,4111.51,7889.38,0.00
2024-12-10 17:39:31,56,7048,24,32,4203.50,7890.00,0.00
2024-12-10 17:39:31,57,7048,24,33,4129.75,7890.02,0.00
2024-12-10 17:39:31,56,7048,24,32,4202.09,7890.02,0.00
2024-12-10 17:39:31,56,7049,24,32,4209.67,7891.00,0.00
2024-12-10 17:39:31,57,7049,24,33,4135.81,7891.02,0.00
2024-12-10 17:39:31,57,7050,24,33,4114.18,7892.00,0.00
2024-12-10 17:39:31,58,7050,24,34,4043.25,7892.02,0.00
2024-12-10 17:39:31,57,7050,24,33,4112.80,7892.02,0.00
2024-12-10 17:39:31,56,7050,23,33,4175.01,7892.16,0.00
2024-12-10 17:39:31,55,7050,22,33,4212.44,7892.64,0.00
2024-12-10 17:39:31,54,7050,21,33,4290.45,7892.65,0.00
2024-12-10 17:39:31,54,7051,21,33,4350.63,7893.00,0.00
2024-12-10 17:39:31,55,7051,22,33,4271.53,7893.02,0.00
2024-12-10 17:39:31,54,7051,22,32,4319.94,7893.02,0.00
2024-12-10 17:39:31,53,7051,21,32,4391.06,7893.15,0.00
2024-12-10 17:39:31,53,7052,21,32,4413.92,7894.00,0.00
2024-12-10 17:39:31,54,7052,22,32,4332.18,7894.02,0.00
2024-12-10 17:39:31,53,7052,22,31,4382.64,7894.02,0.00
2024-12-10 17:39:31,52,7052,21,31,4417.11,7894.64,0.00
2024-12-10 17:39:31,52,7053,21,31,4479.63,7895.00,0.00
2024-12-10 17:39:31,53,7053,22,31,4395.11,7895.02,0.00
2024-12-10 17:39:31,52,7053,22,30,4447.75,7895.02,0.00
2024-12-10 17:39:32,52,7054,22,30,4461.88,7896.00,0.00
2024-12-10 17:39:32,53,7054,23,30,4377.70,7896.02,0.00
2024-12-10 17:39:32,52,7054,22,30,4378.38,7896.08,0.00
2024-12-10 17:39:32,52,7055,22,30,4457.89,7897.00,0.00
2024-12-10 17:39:32,53,7055,23,30,4373.78,7897.02,0.00
2024-12-10 17:39:32,52,7055,23,29,4453.34,7897.02,0.00
2024-12-10 17:39:32,52,7056,23,29,4467.57,7898.00,0.00
2024-12-10 17:39:32,53,7056,24,29,4383.28,7898.02,0.00
2024-12-10 17:39:32,53,7057,24,29,4365.95,7899.00,0.00
2024-12-10 17:39:32,54,7057,25,29,4285.10,7899.02,0.00
2024-12-10 17:39:32,53,7057,25,28,4362.97,7899.02,0.00
2024-12-10 17:39:32,53,7058,25,28,4375.44,7900.00,0.00
2024-12-10 17:39:32,54,7058,25,29,4294.42,7900.02,0.00
2024-12-10 17:39:32,53,7058,24,29,4286.03,7900.09,0.00
2024-12-10 17:39:32,53,7059,24,29,4364.07,7901.00,0.00
2024-12-10 17:39:32,54,7059,24,30,4283.25,7901.02,0.00
2024-12-10 17:39:32,53,7059,24,29,4356.62,7901.02,0.00
2024-12-10 17:39:32,52,7059,23,29,4381.16,7901.08,0.00
2024-12-10 17:39:32,52,7060,23,29,4460.71,7902.00,0.00
2024-12-10 17:39:32,53,7060,24,29,4376.55,7902.02,0.00
2024-12-10 17:39:32,52,7060,23,29,4422.75,7902.12,0.00
2024-12-10 17:39:32,51,7060,22,29,4471.00,7902.61,0.00
2024-12-10 17:39:32,51,7061,22,29,4535.01,7903.00,0.00
2024-12-10 17:39:32,52,7061,23,29,4447.79,7903.02,0.00
2024-12-10 17:39:32,51,7061,23,28,4525.71,7903.02,0.00
2024-12-10 17:39:32,51,7062,23,28,4540.96,7904.00,0.00
2024-12-10 17:39:32,52,7062,24,28,4453.63,7904.02,0.00
2024-12-10 17:39:32,52,7063,24,28,4440.26,7905.00,0.00
2024-12-10 17:39:32,53,7063,24,29,4356.48,7905.02,0.00
2024-12-10 17:39:32,52,7063,24,28,4423.55,7905.04,0.00
2024-12-10 17:39:32,52,7064,24,28,4439.30,7906.00,0.00
2024-12-10 17:39:32,53,7064,24,29,4355.54,7906.02,0.00
2024-12-10 17:39:32,52,7064,23,29,4357.57,7906.64,0.00
2024-12-10 17:39:32,52,7065,23,29,4426.86,7907.00,0.00
2024-12-10 17:39:32,53,7065,24,29,4343.34,7907.02,0.00
2024-12-10 17:39:32,52,7065,24,28,4407.10,7907.04,0.00
2024-12-10 17:39:32,51,7065,23,28,4399.78,7907.82,0.00
2024-12-10 17:39:32,51,7066,23,28,4541.01,7908.00,0.00
2024-12-10 17:39:32,52,7066,24,28,4453.68,7908.02,0.00
2024-12-10 17:39:32,51,7066,23,28,4494.53,7908.14,0.00
2024-12-10 17:39:32,50,7066,22,28,4543.76,7908.62,0.00
2024-12-10 17:39:32,50,7067,22,28,4672.16,7909.00,0.00
2024-12-10 17:39:32,51,7067,22,29,4580.55,7909.02,0.00
2024-12-10 17:39:32,50,7067,22,28,4635.79,7909.08,0.00
2024-12-10 17:39:32,50,7068,22,28,4658.51,7910.00,0.00
2024-12-10 17:39:32,51,7068,22,29,4567.17,7910.02,0.00
2024-12-10 17:39:32,51,7069,22,29,4562.76,7911.00,0.00
2024-12-10 17:39:32,52,7069,23,29,4475.02,7911.02,0.00
2024-12-10 17:39:32,51,7069,23,28,4528.65,7911.08,0.00
2024-12-10 17:39:32,50,7069,22,28,4600.76,7911.12,0.00
2024-12-10 17:39:32,50,7070,22,28,4689.92,7912.00,0.00
2024-12-10 17:39:32,51,7070,22,29,4597.96,7912.02,0.00
2024-12-10 17:39:32,51,7071,22,29,4592.66,7913.00,0.00
2024-12-10 17:39:32,52,7071,23,29,4504.34,7913.02,0.00
2024-12-10 17:39:32,51,7071,23,28,4560.09,7913.08,0.00
2024-12-10 17:39:32,50,7071,22,28,4608.48,7913.56,0.00
2024-12-10 17:39:32,50,7072,22,28,4732.26,7914.00,0.00
2024-12-10 17:39:32,51,7072,22,29,4639.47,7914.02,0.00
2024-12-10 17:39:32,51,7073,22,29,4634.15,7915.00,0.00
2024-12-10 17:39:32,52,7073,22,30,4545.04,7915.02,0.00
2024-12-10 17:39:32,51,7073,22,29,4601.58,7915.08,0.00
2024-12-10 17:39:32,51,7074,22,29,4622.32,7916.00,0.00
2024-12-10 17:39:32,52,7074,23,29,4533.43,7916.02,0.00
2024-12-10 17:39:32,51,7074,22,29,4558.75,7916.24,0.00
2024-12-10 17:39:32,50,7074,21,29,4616.94,7916.64,0.00
2024-12-10 17:39:32,50,7075,21,29,4747.03,7917.00,0.00
2024-12-10 17:39:32,51,7075,21,30,4653.95,7917.02,0.00
2024-12-10 17:39:32,50,7075,21,29,4712.21,7917.08,0.00
2024-12-10 17:39:32,50,7076,21,29,4734.96,7918.00,0.00
2024-12-10 17:39:32,51,7076,22,29,4642.12,7918.02,0.00
2024-12-10 17:39:32,50,7076,21,29,4695.39,7918.10,0.00
2024-12-10 17:39:32,51,7075,22,29,4572.49,7918.53,0.00
2024-12-10 17:39:32,51,7076,22,29,4731.21,7919.00,0.00
2024-12-10 17:39:32,52,7076,23,29,4640.23,7919.02,0.00
2024-12-10 17:39:32,51,7076,23,28,4697.07,7919.08,0.00
2024-12-10 17:39:32,51,7077,23,28,4872.81,7920.00,0.00
2024-12-10 17:39:32,52,7077,24,28,4779.11,7920.02,0.00
2024-12-10 17:39:32,52,7078,24,28,4768.86,7921.00,0.00
2024-12-10 17:39:32,53,7078,25,28,4678.88,7921.02,0.00
2024-12-10 17:39:32,52,7078,25,27,4735.36,7921.08,0.00
2024-12-10 17:39:32,52,7079,25,27,4752.71,7922.00,0.00
2024-12-10 17:39:32,53,7079,26,27,4663.03,7922.02,0.00
2024-12-10 17:39:32,52,7079,25,27,4716.16,7922.10,0.00
2024-12-10 17:39:32,52,7080,25,27,4745.14,7923.00,0.00
2024-12-10 17:39:32,53,7080,25,28,4655.60,7923.02,0.00
2024-12-10 17:39:32,52,7080,25,27,4713.15,7923.08,0.00
2024-12-10 17:39:32,52,7081,25,27,4732.02,7924.00,0.00
2024-12-10 17:39:32,53,7081,26,27,4642.74,7924.02,0.00
2024-12-10 17:39:32,52,7081,25,27,4616.35,7924.79,0.00
2024-12-10 17:39:33,52,7082,25,27,4752.13,7925.00,0.00
2024-12-10 17:39:33,53,7082,25,28,4662.47,7925.02,0.00
2024-12-10 17:39:33,52,7082,25,27,4718.61,7925.08,0.00
2024-12-10 17:39:33,51,7082,24,27,4769.72,7925.59,0.00
2024-12-10 17:39:33,51,7083,24,27,4830.63,7926.00,0.00
2024-12-10 17:39:33,52,7083,25,27,4737.73,7926.02,0.00
2024-12-10 17:39:33,52,7084,25,27,4727.44,7927.00,0.00
2024-12-10 17:39:33,53,7084,25,28,4638.24,7927.02,0.00
2024-12-10 17:39:33,52,7084,25,27,4695.43,7927.08,0.00
2024-12-10 17:39:33,52,7085,25,27,4714.31,7928.00,0.00
2024-12-10 17:39:33,53,7085,26,27,4625.36,7928.02,0.00
2024-12-10 17:39:33,53,7086,26,27,4615.64,7929.00,0.00
2024-12-10 17:39:33,54,7086,27,27,4530.16,7929.02,0.00
2024-12-10 17:39:33,53,7086,27,26,4584.23,7929.08,0.00
2024-12-10 17:39:33,53,7087,27,26,4601.26,7930.00,0.00
2024-12-10 17:39:33,54,7087,28,26,4516.05,7930.02,0.00
2024-12-10 17:39:33,54,7088,28,26,4508.16,7931.00,0.00
2024-12-10 17:39:33,55,7088,28,27,4426.19,7931.02,0.00
2024-12-10 17:39:33,54,7088,28,26,4475.85,7931.07,0.00
2024-12-10 17:39:33,54,7089,28,26,4491.10,7932.00,0.00
2024-12-10 17:39:33,55,7089,28,27,4409.45,7932.02,0.00
2024-12-10 17:39:33,54,7089,27,27,4394.52,7932.37,0.00
2024-12-10 17:39:33,54,7090,27,27,4491.88,7933.00,0.00
2024-12-10 17:39:33,55,7090,28,27,4410.21,7933.02,0.00
2024-12-10 17:39:33,54,7090,27,27,4490.42,7933.02,0.00
2024-12-10 17:39:33,53,7090,27,26,4542.21,7933.06,0.00
2024-12-10 17:39:33,53,7091,27,26,4557.75,7934.00,0.00
2024-12-10 17:39:33,54,7091,27,27,4473.35,7934.02,0.00
2024-12-10 17:39:33,55,7090,28,27,4305.84,7934.24,0.00
2024-12-10 17:39:33,55,7091,28,27,4470.85,7935.00,0.00
2024-12-10 17:39:33,56,7091,28,28,4391.01,7935.02,0.00
2024-12-10 17:39:33,55,7091,27,28,4451.77,7935.06,0.00
2024-12-10 17:39:33,55,7092,27,28,4637.02,7936.00,0.00
2024-12-10 17:39:33,56,7092,27,29,4554.22,7936.02,0.00
2024-12-10 17:39:33,55,7092,26,29,4621.15,7936.04,0.00
2024-12-10 17:39:33,54,7092,26,28,4705.26,7936.04,0.00
2024-12-10 17:39:33,54,7093,26,28,4775.96,7937.00,0.00
2024-12-10 17:39:33,55,7093,27,28,4689.12,7937.02,0.00
2024-12-10 17:39:33,55,7094,27,28,4678.52,7938.00,0.00
2024-12-10 17:39:33,56,7094,27,29,4594.97,7938.02,0.00
2024-12-10 17:39:33,55,7094,27,28,4648.21,7938.04,0.00
2024-12-10 17:39:33,55,7095,27,28,4658.90,7939.00,0.00
2024-12-10 17:39:33,56,7095,28,28,4575.70,7939.02,0.00
2024-12-10 17:39:33,56,7096,28,28,4567.33,7940.00,0.00
2024-12-10 17:39:33,57,7096,29,28,4487.20,7940.02,0.00
2024-12-10 17:39:33,56,7096,28,28,4565.92,7940.02,0.00
2024-12-10 17:39:33,55,7096,28,27,4618.62,7940.04,0.00
2024-12-10 17:39:33,54,7096,27,27,4622.44,7940.39,0.00
2024-12-10 17:39:34,54,7097,27,27,4721.37,7941.00,0.00
2024-12-10 17:39:34,55,7097,27,28,4635.53,7941.02,0.00
2024-12-10 17:39:34,55,7098,27,28,4629.71,7942.00,0.00
2024-12-10 17:39:34,56,7098,28,28,4547.03,7942.02,0.00
2024-12-10 17:39:34,55,7098,27,28,4562.00,7942.51,0.00
2024-12-10 17:39:34,55,7099,27,28,4609.99,7943.00,0.00
2024-12-10 17:39:34,56,7099,27,29,4527.67,7943.02,0.00
2024-12-10 17:39:34,55,7099,27,28,4604.22,7943.07,0.00
2024-12-10 17:39:34,55,7100,27,28,4612.24,7944.00,0.00
2024-12-10 17:39:34,56,7100,27,29,4529.88,7944.02,0.00
2024-12-10 17:39:34,55,7100,26,29,4540.28,7944.51,0.00
2024-12-10 17:39:34,55,7101,26,29,4631.93,7945.00,0.00
2024-12-10 17:39:34,56,7101,27,29,4549.22,7945.02,0.00
2024-12-10 17:39:34,55,7101,26,29,4525.78,7945.82,0.00
2024-12-10 17:39:34,55,7102,26,29,4655.95,7946.00,0.00
2024-12-10 17:39:34,56,7102,26,30,4572.81,7946.02,0.00
2024-12-10 17:39:34,55,7102,25,30,4655.34,7946.02,0.00
2024-12-10 17:39:34,55,7103,25,30,4649.46,7947.00,0.00
2024-12-10 17:39:34,56,7103,26,30,4566.43,7947.02,0.00
2024-12-10 17:39:34,56,7104,26,30,4545.72,7948.00,0.00
2024-12-10 17:39:34,57,7104,27,30,4465.97,7948.02,0.00
2024-12-10 17:39:34,56,7104,26,30,4544.15,7948.04,0.00
2024-12-10 17:39:34,55,7104,26,29,4625.60,7948.04,0.00
2024-12-10 17:39:34,54,7104,25,29,4597.71,7948.96,0.00
2024-12-10 17:39:34,54,7105,25,29,4737.01,7949.00,0.00
2024-12-10 17:39:34,55,7105,26,29,4650.88,7949.02,0.00
2024-12-10 17:39:34,54,7105,25,29,4604.86,7949.65,0.00
2024-12-10 17:39:34,54,7106,25,29,4720.16,7950.00,0.00
2024-12-10 17:39:34,55,7106,25,30,4634.33,7950.02,0.00
2024-12-10 17:39:34,54,7106,25,29,4695.13,7950.04,0.00
2024-12-10 17:39:34,53,7106,24,29,4701.39,7950.45,0.00
2024-12-10 17:39:34,53,7107,24,29,4808.29,7951.00,0.00
2024-12-10 17:39:34,54,7107,24,30,4719.25,7951.02,0.00
2024-12-10 17:39:34,54,7108,24,30,4706.53,7952.00,0.00
2024-12-10 17:39:34,55,7108,25,30,4620.95,7952.02,0.00
2024-12-10 17:39:34,54,7108,25,29,4680.02,7952.04,0.00
2024-12-10 17:39:34,53,7108,24,29,4717.66,7952.62,0.00
2024-12-10 17:39:34,53,7109,24,29,4838.01,7953.00,0.00
2024-12-10 17:39:34,54,7109,25,29,4748.42,7953.02,0.00
2024-12-10 17:39:34,53,7109,24,29,4713.71,7953.57,0.00
2024-12-10 17:39:34,53,7110,24,29,4829.61,7954.00,0.00
2024-12-10 17:39:34,54,7110,25,29,4740.18,7954.02,0.00
2024-12-10 17:39:34,53,7110,25,28,4802.61,7954.04,0.00
2024-12-10 17:39:34,53,7111,25,28,4816.71,7955.00,0.00
2024-12-10 17:39:34,54,7111,26,28,4727.52,7955.02,0.00
2024-12-10 17:39:34,54,7112,26,28,4742.66,7956.00,0.00
2024-12-10 17:39:34,55,7112,26,29,4656.43,7956.02,0.00
2024-12-10 17:39:34,55,7113,26,29,4647.99,7957.00,0.00
2024-12-10 17:39:34,56,7113,26,30,4564.99,7957.02,0.00
2024-12-10 17:39:34,56,7114,26,30,4542.82,7958.00,0.00
2024-12-10 17:39:34,57,7114,27,30,4463.12,7958.02,0.00
2024-12-10 17:39:34,56,7114,27,29,4539.98,7958.04,0.00
2024-12-10 17:39:34,55,7114,26,29,4510.83,7958.96,0.00
2024-12-10 17:39:34,55,7115,26,29,4652.66,7959.00,0.00
2024-12-10 17:39:34,56,7115,26,30,4569.58,7959.02,0.00
2024-12-10 17:39:34,55,7115,25,30,4617.95,7959.09,0.00
2024-12-10 17:39:34,54,7115,24,30,4678.46,7959.22,0.00
2024-12-10 17:39:35,54,7116,24,30,4764.13,7960.00,0.00
2024-12-10 17:39:35,55,7116,24,31,4677.51,7960.02,0.00
2024-12-10 17:39:35,54,7116,24,30,4743.50,7960.04,0.00
2024-12-10 17:39:35,54,7117,24,30,4754.05,7961.00,0.00
2024-12-10 17:39:35,55,7117,25,30,4667.61,7961.02,0.00
2024-12-10 17:39:35,55,7118,25,30,4652.70,7962.00,0.00
2024-12-10 17:39:35,56,7118,25,31,4569.62,7962.02,0.00
2024-12-10 17:39:35,55,7118,25,30,4619.42,7962.09,0.00
2024-12-10 17:39:35,55,7119,25,30,4628.79,7963.00,0.00
2024-12-10 17:39:35,56,7119,26,30,4546.13,7963.02,0.00
2024-12-10 17:39:35,55,7119,25,30,4625.55,7963.06,0.00
2024-12-10 17:39:35,54,7119,24,30,4678.78,7963.09,0.00
2024-12-10 17:39:35,53,7119,23,30,4722.54,7963.60,0.00
2024-12-10 17:39:35,53,7120,23,30,4833.15,7964.00,0.00
2024-12-10 17:39:35,54,7120,24,30,4743.65,7964.02,0.00
2024-12-10 17:39:35,53,7120,24,29,4801.61,7964.08,0.00
2024-12-10 17:39:35,53,7121,24,29,4809.47,7965.00,0.00
2024-12-10 17:39:35,54,7121,25,29,4720.41,7965.02,0.00
2024-12-10 17:39:35,54,7122,25,29,4700.55,7966.00,0.00
2024-12-10 17:39:35,55,7122,26,29,4615.08,7966.02,0.00
2024-12-10 17:39:35,54,7122,26,28,4665.17,7966.09,0.00
2024-12-10 17:39:35,54,7123,26,28,4673.11,7967.00,0.00
2024-12-10 17:39:35,55,7123,26,29,4588.15,7967.02,0.00
2024-12-10 17:39:35,55,7124,26,29,4565.85,7968.00,0.00
2024-12-10 17:39:35,56,7124,26,30,4484.32,7968.02,0.00
2024-12-10 17:39:35,55,7124,25,30,4556.88,7968.07,0.00
2024-12-10 17:39:35,54,7124,25,29,4613.23,7968.07,0.00
2024-12-10 17:39:35,54,7125,25,29,4675.73,7969.00,0.00
2024-12-10 17:39:35,55,7125,26,29,4590.72,7969.02,0.00
2024-12-10 17:39:35,55,7126,26,29,4571.34,7970.00,0.00
2024-12-10 17:39:35,56,7126,27,29,4489.71,7970.02,0.00
2024-12-10 17:39:35,55,7126,27,28,4538.02,7970.07,0.00
2024-12-10 17:39:35,54,7126,27,27,4557.96,7970.59,0.00
2024-12-10 17:39:35,54,7127,27,27,4612.34,7971.00,0.00
2024-12-10 17:39:35,55,7127,27,28,4528.48,7971.02,0.00
2024-12-10 17:39:35,55,7128,27,28,4512.52,7972.00,0.00
2024-12-10 17:39:35,56,7128,27,29,4431.93,7972.02,0.00
2024-12-10 17:39:35,55,7128,27,28,4486.72,7972.07,0.00
2024-12-10 17:39:35,54,7128,26,28,4565.42,7972.07,0.00
2024-12-10 17:39:35,54,7129,26,28,4637.68,7973.00,0.00
2024-12-10 17:39:35,55,7129,27,28,4553.36,7973.02,0.00
2024-12-10 17:39:35,56,7128,28,28,4401.10,7973.59,0.00
2024-12-10 17:39:35,56,7129,28,28,4501.28,7974.00,0.00
2024-12-10 17:39:35,57,7129,28,29,4422.31,7974.02,0.00
2024-12-10 17:39:35,56,7129,28,28,4469.96,7974.07,0.00
2024-12-10 17:39:35,56,7130,28,28,4616.64,7975.00,0.00
2024-12-10 17:39:35,57,7130,29,28,4535.65,7975.02,0.00
2024-12-10 17:39:35,56,7130,28,28,4520.91,7975.63,0.00
2024-12-10 17:39:35,56,7131,28,28,4630.36,7976.00,0.00
2024-12-10 17:39:35,57,7131,28,29,4549.13,7976.02,0.00
2024-12-10 17:39:35,56,7131,28,28,4599.04,7976.07,0.00
2024-12-10 17:39:35,56,7132,28,28,4589.52,7977.00,0.00
2024-12-10 17:39:35,57,7132,29,28,4509.01,7977.02,0.00
2024-12-10 17:39:35,57,7133,29,28,4486.29,7978.00,0.00
2024-12-10 17:39:35,58,7133,29,29,4408.94,7978.02,0.00
2024-12-10 17:39:35,57,7133,29,28,4456.91,7978.07,0.00
2024-12-10 17:39:35,57,7134,29,28,4460.42,7979.00,0.00
2024-12-10 17:39:35,58,7134,29,29,4383.52,7979.02,0.00
2024-12-10 17:39:35,57,7134,28,29,4422.64,7979.11,0.00
2024-12-10 17:39:35,57,7135,28,29,4482.66,7980.00,0.00
2024-12-10 17:39:35,58,7135,28,30,4405.38,7980.02,0.00
2024-12-10 17:39:35,57,7135,28,29,4481.26,7980.02,0.00
2024-12-10 17:39:35,56,7135,27,29,4541.34,7980.02,0.00
2024-12-10 17:39:35,55,7135,27,28,4596.34,7980.04,0.00
2024-12-10 17:39:35,55,7136,27,28,4654.90,7981.00,0.00
2024-12-10 17:39:35,56,7136,28,28,4571.78,7981.02,0.00
2024-12-10 17:39:35,56,7137,28,28,4552.54,7982.00,0.00
2024-12-10 17:39:35,57,7137,29,28,4472.67,7982.02,0.00
2024-12-10 17:39:35,57,7138,29,28,4435.59,7983.00,0.00
2024-12-10 17:39:35,58,7138,30,28,4359.11,7983.02,0.00
2024-12-10 17:39:35,57,7138,29,28,4431.40,7983.07,0.00
2024-12-10 17:39:35,56,7138,29,27,4509.10,7983.07,0.00
2024-12-10 17:39:35,56,7139,29,27,4502.38,7984.00,0.00
2024-12-10 17:39:35,57,7139,30,27,4423.39,7984.02,0.00
2024-12-10 17:39:35,57,7140,30,27,4402.00,7985.00,0.00
2024-12-10 17:39:35,58,7140,30,28,4326.10,7985.02,0.00
2024-12-10 17:39:35,57,7140,29,28,4397.80,7985.07,0.00
2024-12-10 17:39:35,56,7140,29,27,4446.39,7985.07,0.00
2024-12-10 17:39:35,56,7141,29,27,4446.13,7986.00,0.00
2024-12-10 17:39:35,57,7141,29,28,4368.13,7986.02,0.00
2024-12-10 17:39:35,56,7141,28,28,4378.62,7986.50,0.00
2024-12-10 17:39:35,56,7142,28,28,4426.51,7987.00,0.00
2024-12-10 17:39:35,57,7142,29,28,4348.85,7987.02,0.00
2024-12-10 17:39:35,56,7142,29,27,4392.29,7987.07,0.00
2024-12-10 17:39:35,55,7142,28,27,4351.57,7987.93,0.00
2024-12-10 17:39:35,55,7143,28,27,4491.04,7988.00,0.00
2024-12-10 17:39:35,56,7143,28,28,4410.84,7988.02,0.00
2024-12-10 17:39:35,55,7143,28,27,4351.48,7988.71,0.00
2024-12-10 17:39:35,55,7144,28,27,4473.69,7989.00,0.00
2024-12-10 17:39:35,56,7144,28,28,4393.81,7989.02,0.00
2024-12-10 17:39:35,55,7144,27,28,4471.42,7989.04,0.00
2024-12-10 17:39:35,54,7144,26,28,4442.12,7989.41,0.00
2024-12-10 17:39:35,53,7144,25,28,4514.99,7989.55,0.00
2024-12-10 17:39:35,53,7145,25,28,4629.88,7990.00,0.00
2024-12-10 17:39:35,54,7145,26,28,4544.14,7990.02,0.00
2024-12-10 17:39:35,53,7145,26,27,4622.35,7990.08,0.00
2024-12-10 17:39:36,53,7146,26,27,4639.50,7991.00,0.00
2024-12-10 17:39:36,54,7146,26,28,4553.59,7991.02,0.00
2024-12-10 17:39:36,53,7146,25,28,4519.36,7991.89,0.00
2024-12-10 17:39:36,53,7147,25,28,4661.19,7992.00,0.00
2024-12-10 17:39:36,54,7147,26,28,4574.88,7992.02,0.00
2024-12-10 17:39:36,53,7147,26,27,4625.02,7992.08,0.00
2024-12-10 17:39:36,53,7148,26,27,4642.17,7993.00,0.00
2024-12-10 17:39:36,54,7148,26,28,4556.21,7993.02,0.00
2024-12-10 17:39:36,53,7148,25,28,4580.41,7993.23,0.00
2024-12-10 17:39:36,53,7149,25,28,4669.90,7994.00,0.00
2024-12-10 17:39:36,54,7149,26,28,4583.42,7994.02,0.00
2024-12-10 17:39:36,53,7149,26,27,4632.22,7994.09,0.00
2024-12-10 17:39:36,53,7150,26,27,4650.88,7995.00,0.00
2024-12-10 17:39:36,54,7150,27,27,4564.75,7995.02,0.00
2024-12-10 17:39:36,53,7150,26,27,4586.32,7995.25,0.00
2024-12-10 17:39:36,53,7151,26,27,4676.15,7996.00,0.00
2024-12-10 17:39:36,54,7151,27,27,4589.56,7996.02,0.00
2024-12-10 17:39:36,53,7151,27,26,4639.96,7996.09,0.00
2024-12-10 17:39:36,53,7152,27,26,4653.64,7997.00,0.00
2024-12-10 17:39:36,54,7152,27,27,4567.46,7997.02,0.00
2024-12-10 17:39:36,54,7153,27,27,4553.13,7998.00,0.00
2024-12-10 17:39:36,55,7153,28,27,4470.34,7998.02,0.00
2024-12-10 17:39:36,54,7153,28,26,4519.08,7998.09,0.00
2024-12-10 17:39:36,53,7153,27,26,4604.34,7998.09,0.00
2024-12-10 17:39:36,52,7153,26,26,4616.41,7998.73,0.00
2024-12-10 17:39:36,52,7154,26,26,4748.92,7999.00,0.00
2024-12-10 17:39:36,53,7154,27,26,4659.31,7999.02,0.00
2024-12-10 17:39:36,52,7154,26,26,4747.38,7999.02,0.00
2024-12-10 17:39:36,52,7155,26,26,4733.48,8000.00,0.00
2024-12-10 17:39:36,53,7155,27,26,4644.17,8000.02,0.00
2024-12-10 17:39:36,52,7155,27,25,4699.65,8000.08,0.00
2024-12-10 17:39:36,52,7156,27,25,4710.17,8001.00,0.00
2024-12-10 17:39:36,53,7156,28,25,4621.29,8001.02,0.00
2024-12-10 17:39:36,52,7156,27,25,4626.44,8001.15,0.00
2024-12-10 17:39:36,51,7156,26,25,4688.20,8001.51,0.00
2024-12-10 17:39:36,51,7157,26,25,4795.58,8002.00,0.00
2024-12-10 17:39:36,52,7157,27,25,4703.36,8002.02,0.00
2024-12-10 17:39:36,51,7157,27,24,4757.95,8002.10,0.00
2024-12-10 17:39:36,51,7158,27,24,4767.89,8003.00,0.00
2024-12-10 17:39:36,52,7158,28,24,4676.20,8003.02,0.00
2024-12-10 17:39:36,52,7159,28,24,4655.62,8004.00,0.00
2024-12-10 17:39:36,53,7159,28,25,4567.78,8004.02,0.00
2024-12-10 17:39:36,52,7159,28,24,4618.70,8004.10,0.00
2024-12-10 17:39:36,52,7160,28,24,4624.94,8005.00,0.00
2024-12-10 17:39:36,53,7160,29,24,4537.68,8005.02,0.00
2024-12-10 17:39:36,52,7160,28,24,4549.47,8005.46,0.00
2024-12-10 17:39:36,52,7161,28,24,4610.03,8006.00,0.00
2024-12-10 17:39:36,53,7161,29,24,4523.05,8006.02,0.00
2024-12-10 17:39:36,52,7161,29,23,4574.64,8006.10,0.00
2024-12-10 17:39:36,51,7161,28,23,4634.64,8006.47,0.00
2024-12-10 17:39:36,51,7162,28,23,4686.82,8007.00,0.00
2024-12-10 17:39:36,52,7162,29,23,4596.69,8007.02,0.00
2024-12-10 17:39:36,52,7163,29,23,4593.62,8008.00,0.00
2024-12-10 17:39:36,53,7163,29,24,4506.95,8008.02,0.00
2024-12-10 17:39:37,53,7164,29,24,4489.38,8009.00,0.00
2024-12-10 17:39:37,54,7164,29,25,4406.24,8009.02,0.00
2024-12-10 17:39:37,53,7164,29,24,4478.82,8009.11,0.00
2024-12-10 17:39:37,53,7165,29,24,4499.01,8010.00,0.00
2024-12-10 17:39:37,54,7165,29,25,4415.69,8010.02,0.00
2024-12-10 17:39:37,54,7166,29,25,4410.05,8011.00,0.00
2024-12-10 17:39:37,55,7166,30,25,4329.87,8011.02,0.00
2024-12-10 17:39:37,54,7166,30,24,4371.50,8011.11,0.00
2024-12-10 17:39:37,55,7165,31,24,4249.60,8011.67,0.00
2024-12-10 17:39:37,55,7166,31,24,4439.93,8012.00,0.00
2024-12-10 17:39:37,56,7166,32,24,4360.65,8012.02,0.00
2024-12-10 17:39:37,55,7166,31,24,4403.70,8012.09,0.00
2024-12-10 17:39:37,56,7165,32,24,4250.99,8012.70,0.00
2024-12-10 17:39:37,56,7166,32,24,4593.17,8013.00,0.00
2024-12-10 17:39:37,57,7166,33,24,4512.59,8013.02,0.00
2024-12-10 17:39:37,57,7167,33,24,4631.25,8014.00,0.00
2024-12-10 17:39:37,58,7167,34,24,4551.40,8014.02,0.00
2024-12-10 17:39:37,57,7167,34,23,4620.02,8014.11,0.00
2024-12-10 17:39:37,57,7168,34,23,4633.24,8015.00,0.00
2024-12-10 17:39:37,58,7168,35,23,4553.35,8015.02,0.00
2024-12-10 17:39:37,58,7169,35,23,4544.11,8016.00,0.00
2024-12-10 17:39:37,59,7169,36,23,4467.09,8016.02,0.00
2024-12-10 17:39:37,59,7170,36,23,4443.19,8017.00,0.00
2024-12-10 17:39:37,60,7170,36,24,4369.14,8017.02,0.00
2024-12-10 17:39:37,59,7170,36,23,4435.05,8017.10,0.00
2024-12-10 17:39:37,59,7171,36,23,4445.10,8018.00,0.00
2024-12-10 17:39:37,60,7171,37,23,4371.02,8018.02,0.00
2024-12-10 17:39:37,59,7171,36,23,4342.21,8018.80,0.00
2024-12-10 17:39:37,59,7172,36,23,4461.97,8019.00,0.00
2024-12-10 17:39:37,60,7172,36,24,4387.60,8019.02,0.00
2024-12-10 17:39:37,59,7172,36,23,4426.65,8019.10,0.00
2024-12-10 17:39:37,59,7173,36,23,4436.70,8020.00,0.00
2024-12-10 17:39:37,60,7173,36,24,4362.75,8020.02,0.00
2024-12-10 17:39:37,60,7174,36,24,4351.61,8021.00,0.00
2024-12-10 17:39:37,61,7174,37,24,4280.27,8021.02,0.00
2024-12-10 17:39:37,60,7174,36,24,4350.27,8021.02,0.00
2024-12-10 17:39:37,59,7174,36,23,4391.39,8021.09,0.00
2024-12-10 17:39:37,59,7175,36,23,4400.08,8022.00,0.00
2024-12-10 17:39:37,60,7175,36,24,4326.75,8022.02,0.00
2024-12-10 17:39:37,59,7175,35,24,4357.96,8022.14,0.00
2024-12-10 17:39:37,59,7176,35,24,4425.11,8023.00,0.00
2024-12-10 17:39:37,60,7176,36,24,4351.35,8023.02,0.00
2024-12-10 17:39:37,59,7176,36,23,4391.13,8023.10,0.00
2024-12-10 17:39:37,59,7177,36,23,4401.18,8024.00,0.00
2024-12-10 17:39:37,60,7177,36,24,4327.83,8024.02,0.00
2024-12-10 17:39:37,59,7177,35,24,4393.04,8024.10,0.00
2024-12-10 17:39:37,59,7178,35,24,4393.70,8025.00,0.00
2024-12-10 17:39:37,60,7178,36,24,4320.47,8025.02,0.00
2024-12-10 17:39:37,60,7179,36,24,4295.59,8026.00,0.00
2024-12-10 17:39:37,61,7179,37,24,4225.17,8026.02,0.00
2024-12-10 17:39:37,60,7179,37,23,4284.91,8026.12,0.00
2024-12-10 17:39:37,60,7180,37,23,4294.79,8027.00,0.00
2024-12-10 17:39:37,61,7180,37,24,4224.38,8027.02,0.00
2024-12-10 17:39:37,60,7180,36,24,4273.38,8027.05,0.00
2024-12-10 17:39:38,60,7181,36,24,4304.69,8028.00,0.00
2024-12-10 17:39:38,61,7181,36,25,4234.12,8028.02,0.00
2024-12-10 17:39:38,60,7181,36,24,4269.92,8028.10,0.00
2024-12-10 17:39:38,60,7181,36,24,4277.57,8029.00,0.00
2024-12-10 17:39:38,61,7181,36,25,4207.44,8029.02,0.00
2024-12-10 17:39:38,60,7181,35,25,4276.23,8029.02,0.00
2024-12-10 17:39:38,59,7181,34,25,4282.37,8029.49,0.00
2024-12-10 17:39:38,59,7182,34,25,4334.99,8030.00,0.00
2024-12-10 17:39:38,60,7182,34,26,4262.74,8030.02,0.00
2024-12-10 17:39:38,59,7182,33,26,4329.56,8030.09,0.00
2024-12-10 17:39:38,58,7182,33,25,4376.39,8030.10,0.00
2024-12-10 17:39:38,58,7183,33,25,4379.78,8031.00,0.00
2024-12-10 17:39:38,59,7183,33,26,4305.54,8031.02,0.00
2024-12-10 17:39:38,58,7183,32,26,4332.73,8031.14,0.00
2024-12-10 17:39:38,58,7184,32,26,4392.89,8032.00,0.00
2024-12-10 17:39:38,59,7184,32,27,4318.43,8032.02,0.00
2024-12-10 17:39:38,58,7184,31,27,4359.65,8032.04,0.00
2024-12-10 17:39:38,58,7185,31,27,4385.96,8033.00,0.00
2024-12-10 17:39:38,59,7185,31,28,4311.62,8033.02,0.00
2024-12-10 17:39:38,58,7185,30,28,4384.58,8033.02,0.00
2024-12-10 17:39:38,57,7185,30,27,4454.46,8033.07,0.00
2024-12-10 17:39:38,57,7186,30,27,4458.08,8034.00,0.00
2024-12-10 17:39:38,58,7186,31,27,4381.22,8034.02,0.00
2024-12-10 17:39:38,57,7186,30,27,4396.12,8034.42,0.00
2024-12-10 17:39:38,56,7186,29,27,4457.52,8034.64,0.00
2024-12-10 17:39:38,56,7187,29,27,4532.84,8035.00,0.00
2024-12-10 17:39:38,57,7187,30,27,4453.32,8035.02,0.00
2024-12-10 17:39:38,56,7187,29,27,4442.78,8035.71,0.00
2024-12-10 17:39:38,56,7188,29,27,4563.54,8036.00,0.00
2024-12-10 17:39:38,57,7188,29,28,4483.48,8036.02,0.00
2024-12-10 17:39:38,56,7188,29,27,4557.81,8036.07,0.00
2024-12-10 17:39:38,56,7189,29,27,4569.85,8037.00,0.00
2024-12-10 17:39:38,57,7189,30,27,4489.67,8037.02,0.00
2024-12-10 17:39:38,57,7190,30,27,4482.39,8038.00,0.00
2024-12-10 17:39:38,58,7190,31,27,4405.10,8038.02,0.00
2024-12-10 17:39:38,57,7190,31,26,4448.55,8038.07,0.00
2024-12-10 17:39:38,56,7190,30,26,4495.75,8038.46,0.00
2024-12-10 17:39:38,56,7191,30,26,4539.19,8039.00,0.00
2024-12-10 17:39:38,57,7191,30,27,4459.55,8039.02,0.00
2024-12-10 17:39:38,56,7191,29,27,4535.42,8039.05,0.00
2024-12-10 17:39:38,56,7192,29,27,4531.38,8040.00,0.00
2024-12-10 17:39:38,57,7192,29,28,4451.88,8040.02,0.00
2024-12-10 17:39:38,56,7192,29,27,4499.80,8040.05,0.00
2024-12-10 17:39:38,55,7192,28,27,4513.34,8040.35,0.00
2024-12-10 17:39:38,55,7193,28,27,4607.32,8041.00,0.00
2024-12-10 17:39:38,56,7193,28,28,4525.05,8041.02,0.00
2024-12-10 17:39:38,55,7193,27,28,4559.47,8041.07,0.00
2024-12-10 17:39:38,55,7194,27,28,4631.67,8042.00,0.00
2024-12-10 17:39:38,56,7194,28,28,4548.96,8042.02,0.00
2024-12-10 17:39:38,55,7194,28,27,4600.97,8042.06,0.00
2024-12-10 17:39:38,55,7195,28,27,4613.23,8043.00,0.00
2024-12-10 17:39:38,56,7195,29,27,4530.85,8043.02,0.00
2024-12-10 17:39:38,56,7196,29,27,4525.67,8044.00,0.00
2024-12-10 17:39:38,57,7196,30,27,4446.28,8044.02,0.00
2024-12-10 17:39:38,57,7197,30,27,4424.25,8045.00,0.00
2024-12-10 17:39:38,58,7197,30,28,4347.97,8045.02,0.00
2024-12-10 17:39:38,57,7197,30,27,4420.02,8045.05,0.00
2024-12-10 17:39:38,56,7197,29,27,4464.30,8045.48,0.00
2024-12-10 17:39:38,55,7197,28,27,4530.93,8045.66,0.00
2024-12-10 17:39:38,54,7197,27,27,4548.04,8045.96,0.00
2024-12-10 17:39:38,54,7198,27,27,4694.08,8046.00,0.00
2024-12-10 17:39:38,55,7198,27,28,4608.73,8046.02,0.00
2024-12-10 17:39:38,55,7199,27,28,4601.57,8047.00,0.00
2024-12-10 17:39:38,56,7199,27,29,4519.40,8047.02,0.00
2024-12-10 17:39:38,55,7199,27,28,4569.39,8047.06,0.00
2024-12-10 17:39:38,54,7199,26,28,4643.60,8047.11,0.00
2024-12-10 17:39:38,54,7200,26,28,4721.65,8048.00,0.00
2024-12-10 17:39:38,55,7200,27,28,4635.80,8048.02,0.00
2024-12-10 17:39:38,55,7201,27,28,4627.63,8049.00,0.00
2024-12-10 17:39:38,56,7201,28,28,4544.99,8049.02,0.00
2024-12-10 17:39:38,55,7201,28,27,4593.98,8049.07,0.00
2024-12-10 17:39:38,54,7201,27,27,4650.95,8049.37,0.00
2024-12-10 17:39:38,53,7201,26,27,4732.17,8049.45,0.00
2024-12-10 17:39:38,53,7202,26,27,4840.43,8050.00,0.00
2024-12-10 17:39:38,54,7202,27,27,4750.79,8050.02,0.00
2024-12-10 17:39:38,54,7203,27,27,4739.88,8051.00,0.00
2024-12-10 17:39:38,55,7203,28,27,4653.70,8051.02,0.00
2024-12-10 17:39:38,54,7203,28,26,4707.09,8051.07,0.00
2024-12-10 17:39:38,54,7204,28,26,4718.33,8052.00,0.00
2024-12-10 17:39:38,55,7204,29,26,4632.54,8052.02,0.00
2024-12-10 17:39:38,54,7204,28,26,4615.31,8052.35,0.00
2024-12-10 17:39:38,54,7205,28,26,4711.29,8053.00,0.00
2024-12-10 17:39:38,55,7205,28,27,4625.63,8053.02,0.00
2024-12-10 17:39:38,54,7205,28,26,4678.48,8053.07,0.00
2024-12-10 17:39:39,54,7206,28,26,4689.10,8054.00,0.00
2024-12-10 17:39:39,55,7206,29,26,4603.85,8054.02,0.00
2024-12-10 17:39:39,54,7206,28,26,4684.92,8054.06,0.00
2024-12-10 17:39:39,54,7207,28,26,4676.51,8055.00,0.00
2024-12-10 17:39:39,55,7207,28,27,4591.48,8055.02,0.00
2024-12-10 17:39:39,54,7207,28,26,4643.71,8055.07,0.00
2024-12-10 17:39:39,54,7208,28,26,4653.06,8056.00,0.00
2024-12-10 17:39:39,55,7208,29,26,4568.46,8056.02,0.00
2024-12-10 17:39:39,54,7208,28,26,4592.01,8056.15,0.00
2024-12-10 17:39:39,54,7209,28,26,4673.12,8057.00,0.00
2024-12-10 17:39:39,55,7209,28,27,4588.16,8057.02,0.00
2024-12-10 17:39:39,54,7209,28,26,4625.91,8057.13,0.00
2024-12-10 17:39:39,53,7209,27,26,4690.36,8057.42,0.00
2024-12-10 17:39:39,53,7209,27,26,4734.89,8058.00,0.00
2024-12-10 17:39:39,54,7209,28,26,4647.21,8058.02,0.00
2024-12-10 17:39:39,54,7210,28,26,4640.55,8059.00,0.00
2024-12-10 17:39:39,55,7210,28,27,4556.17,8059.02,0.00
2024-12-10 17:39:39,55,7211,28,27,4530.45,8060.00,0.00
2024-12-10 17:39:39,56,7211,28,28,4449.55,8060.02,0.00
2024-12-10 17:39:39,55,7211,27,28,4520.68,8060.11,0.00
2024-12-10 17:39:39,54,7211,26,28,4589.33,8060.11,0.00
2024-12-10 17:39:39,53,7211,26,27,4666.80,8060.13,0.00
2024-12-10 17:39:39,53,7212,26,27,4749.49,8061.00,0.00
2024-12-10 17:39:39,54,7212,27,27,4661.53,8061.02,0.00
2024-12-10 17:39:39,53,7212,26,27,4747.96,8061.02,0.00
2024-12-10 17:39:39,53,7213,26,27,4750.23,8062.00,0.00
2024-12-10 17:39:39,54,7213,26,28,4662.26,8062.02,0.00
2024-12-10 17:39:39,54,7214,26,28,4643.43,8063.00,0.00
2024-12-10 17:39:39,55,7214,27,28,4559.00,8063.02,0.00
2024-12-10 17:39:39,54,7214,26,28,4639.79,8063.06,0.00
2024-12-10 17:39:39,53,7214,26,27,4713.65,8063.11,0.00
2024-12-10 17:39:39,53,7215,26,27,4734.00,8064.00,0.00
2024-12-10 17:39:39,54,7215,26,28,4646.33,8064.02,0.00
2024-12-10 17:39:39,53,7215,25,28,4729.45,8064.08,0.00
2024-12-10 17:39:39,52,7215,24,28,4770.79,8064.14,0.00
2024-12-10 17:39:39,52,7216,24,28,4856.65,8065.00,0.00
2024-12-10 17:39:39,53,7216,25,28,4765.02,8065.02,0.00
2024-12-10 17:39:39,52,7216,24,28,4761.96,8065.23,0.00
2024-12-10 17:39:39,52,7217,24,28,4855.55,8066.00,0.00
2024-12-10 17:39:39,53,7217,24,29,4763.93,8066.02,0.00
2024-12-10 17:39:39,52,7217,23,29,4854.00,8066.02,0.00
2024-12-10 17:39:39,51,7217,22,29,4946.03,8066.06,0.00
2024-12-10 17:39:39,50,7217,22,28,5038.50,8066.06,0.00
2024-12-10 17:39:39,50,7218,22,28,5060.08,8067.00,0.00
2024-12-10 17:39:39,51,7218,22,29,4960.86,8067.02,0.00
2024-12-10 17:39:39,51,7219,22,29,4954.47,8068.00,0.00
2024-12-10 17:39:39,52,7219,22,30,4859.19,8068.02,0.00
2024-12-10 17:39:39,52,7220,22,30,4842.72,8069.00,0.00
2024-12-10 17:39:39,53,7220,22,31,4751.35,8069.02,0.00
2024-12-10 17:39:39,52,7220,22,30,4836.53,8069.06,0.00
2024-12-10 17:39:39,51,7220,21,30,4869.12,8069.67,0.00
2024-12-10 17:39:39,51,7221,21,30,5000.68,8070.00,0.00
2024-12-10 17:39:39,52,7221,21,31,4904.52,8070.02,0.00
2024-12-10 17:39:39,51,7221,20,31,4986.46,8070.08,0.00
2024-12-10 17:39:39,51,7222,20,31,5039.28,8071.00,0.00
2024-12-10 17:39:39,52,7222,21,31,4942.37,8071.02,0.00
2024-12-10 17:39:39,52,7223,21,31,4925.91,8072.00,0.00
2024-12-10 17:39:39,53,7223,21,32,4832.97,8072.02,0.00
2024-12-10 17:39:39,52,7223,21,31,4911.96,8072.08,0.00
2024-12-10 17:39:39,52,7224,21,31,4931.18,8073.00,0.00
2024-12-10 17:39:39,53,7224,21,32,4838.14,8073.02,0.00
2024-12-10 17:39:39,53,7225,21,32,4834.87,8074.00,0.00
2024-12-10 17:39:39,54,7225,22,32,4745.34,8074.02,0.00
2024-12-10 17:39:39,54,7226,22,32,4726.49,8075.00,0.00
2024-12-10 17:39:39,55,7226,23,32,4640.55,8075.02,0.00
2024-12-10 17:39:39,54,7226,23,31,4714.54,8075.07,0.00
2024-12-10 17:39:39,54,7227,23,31,4730.06,8076.00,0.00
2024-12-10 17:39:39,55,7227,24,31,4644.06,8076.02,0.00
2024-12-10 17:39:39,55,7228,24,31,4638.88,8077.00,0.00
2024-12-10 17:39:39,56,7228,25,31,4556.04,8077.02,0.00
2024-12-10 17:39:39,56,7229,25,31,4534.96,8078.00,0.00
2024-12-10 17:39:39,57,7229,25,32,4455.40,8078.02,0.00
2024-12-10 17:39:39,56,7229,25,31,4526.33,8078.07,0.00
2024-12-10 17:39:39,56,7230,25,31,4538.41,8079.00,0.00
2024-12-10 17:39:39,57,7230,26,31,4458.79,8079.02,0.00
2024-12-10 17:39:39,57,7231,26,31,4452.51,8080.00,0.00
2024-12-10 17:39:39,58,7231,26,32,4375.75,8080.02,0.00
2024-12-10 17:39:39,58,7232,26,32,4352.60,8081.00,0.00
2024-12-10 17:39:39,59,7232,26,33,4278.83,8081.02,0.00
2024-12-10 17:39:39,58,7232,26,32,4345.65,8081.07,0.00
2024-12-10 17:39:39,57,7232,25,32,4372.56,8081.67,0.00
2024-12-10 17:39:39,57,7233,25,32,4430.93,8082.00,0.00
2024-12-10 17:39:39,58,7233,25,33,4354.53,8082.02,0.00
2024-12-10 17:39:39,57,7233,24,33,4300.49,8082.97,0.00
2024-12-10 17:39:39,57,7234,24,33,4439.48,8083.00,0.00
2024-12-10 17:39:39,58,7234,24,34,4362.94,8083.02,0.00
2024-12-10 17:39:39,57,7234,23,34,4383.93,8083.09,0.00
2024-12-10 17:39:40,57,7235,23,34,4452.53,8084.00,0.00
2024-12-10 17:39:40,58,7235,23,35,4375.76,8084.02,0.00
2024-12-10 17:39:40,57,7235,23,34,4446.87,8084.07,0.00
2024-12-10 17:39:40,56,7235,22,34,4491.71,8084.25,0.00
2024-12-10 17:39:40,56,7236,22,34,4575.91,8085.00,0.00
2024-12-10 17:39:40,57,7236,23,34,4495.64,8085.02,0.00
2024-12-10 17:39:40,57,7237,23,34,4489.47,8086.00,0.00
2024-12-10 17:39:40,58,7237,24,34,4412.06,8086.02,0.00
2024-12-10 17:39:40,58,7238,24,34,4388.90,8087.00,0.00
2024-12-10 17:39:40,59,7238,25,34,4314.52,8087.02,0.00
2024-12-10 17:39:40,58,7238,25,33,4380.56,8087.09,0.00
2024-12-10 17:39:40,58,7239,25,33,4389.82,8088.00,0.00
2024-12-10 17:39:40,59,7239,25,34,4315.42,8088.02,0.00
2024-12-10 17:39:40,58,7239,24,34,4319.56,8088.50,0.00
2024-12-10 17:39:40,58,7240,24,34,4418.92,8089.00,0.00
2024-12-10 17:39:40,59,7240,25,34,4344.03,8089.02,0.00
2024-12-10 17:39:40,58,7240,25,33,4384.08,8089.09,0.00
2024-12-10 17:39:40,57,7240,24,33,4401.92,8089.40,0.00
2024-12-10 17:39:40,57,7241,24,33,4495.99,8090.00,0.00
2024-12-10 17:39:40,58,7241,24,34,4418.47,8090.02,0.00
2024-12-10 17:39:40,58,7242,24,34,4402.10,8091.00,0.00
2024-12-10 17:39:40,59,7242,25,34,4327.48,8091.02,0.00
2024-12-10 17:39:40,58,7242,25,33,4378.56,8091.09,0.00
2024-12-10 17:39:40,58,7243,25,33,4388.85,8092.00,0.00
2024-12-10 17:39:40,59,7243,26,33,4314.46,8092.02,0.00
2024-12-10 17:39:40,59,7244,26,33,4304.86,8093.00,0.00
2024-12-10 17:39:40,60,7244,26,34,4233.12,8093.02,0.00
2024-12-10 17:39:40,59,7244,25,34,4235.84,8093.53,0.00
2024-12-10 17:39:40,58,7244,24,34,4263.06,8093.88,0.00
2024-12-10 17:39:40,58,7245,24,34,4392.93,8094.00,0.00
2024-12-10 17:39:40,59,7245,25,34,4318.48,8094.02,0.00
2024-12-10 17:39:40,58,7245,25,33,4369.22,8094.07,0.00
2024-12-10 17:39:40,58,7246,25,33,4378.12,8095.00,0.00
2024-12-10 17:39:40,59,7246,26,33,4303.92,8095.02,0.00
2024-12-10 17:39:40,58,7246,26,32,4350.22,8095.07,0.00
2024-12-10 17:39:40,58,7247,26,32,4359.12,8096.00,0.00
2024-12-10 17:39:40,59,7247,26,33,4285.24,8096.02,0.00
2024-12-10 17:39:40,58,7247,25,33,4322.85,8096.12,0.00
2024-12-10 17:39:40,58,7248,25,33,4347.84,8097.00,0.00
2024-12-10 17:39:40,59,7248,26,33,4274.15,8097.02,0.00
2024-12-10 17:39:40,58,7248,26,32,4321.32,8097.07,0.00
2024-12-10 17:39:40,58,7249,26,32,4330.23,8098.00,0.00
2024-12-10 17:39:40,59,7249,26,33,4256.83,8098.02,0.00
2024-12-10 17:39:40,59,7250,26,33,4243.60,8099.00,0.00
2024-12-10 17:39:40,60,7250,27,33,4172.87,8099.02,0.00
2024-12-10 17:39:40,59,7250,27,32,4218.90,8099.07,0.00
2024-12-10 17:39:40,58,7250,26,32,4208.27,8099.81,0.00
2024-12-10 17:39:40,58,7251,26,32,4332.69,8100.00,0.00
2024-12-10 17:39:40,59,7251,26,33,4259.26,8100.02,0.00
2024-12-10 17:39:40,59,7252,26,33,4247.60,8101.00,0.00
2024-12-10 17:39:40,60,7252,26,34,4176.80,8101.02,0.00
2024-12-10 17:39:40,59,7252,26,33,4220.14,8101.09,0.00
2024-12-10 17:39:40,58,7252,25,33,4238.51,8101.66,0.00
2024-12-10 17:39:40,58,7253,25,33,4350.52,8102.00,0.00
2024-12-10 17:39:40,59,7253,26,33,4276.79,8102.02,0.00
2024-12-10 17:39:40,58,7253,25,33,4237.58,8102.55,0.00
2024-12-10 17:39:40,58,7254,25,33,4341.28,8103.00,0.00
2024-12-10 17:39:40,59,7254,26,33,4267.70,8103.02,0.00
2024-12-10 17:39:40,58,7254,26,32,4310.55,8103.10,0.00
2024-12-10 17:39:40,58,7255,26,32,4322.25,8104.00,0.00
2024-12-10 17:39:40,59,7255,26,33,4249.00,8104.02,0.00
2024-12-10 17:39:40,59,7256,26,33,4238.11,8105.00,0.00
2024-12-10 17:39:40,60,7256,27,33,4167.47,8105.02,0.00
2024-12-10 17:39:40,59,7256,26,33,4233.89,8105.07,0.00
2024-12-10 17:39:40,58,7256,26,32,4283.13,8105.09,0.00
2024-12-10 17:39:40,57,7256,25,32,4341.66,8105.12,0.00
2024-12-10 17:39:40,57,7257,25,32,4413.28,8106.00,0.00
2024-12-10 17:39:40,58,7257,25,33,4337.19,8106.02,0.00
2024-12-10 17:39:40,58,7258,25,33,4325.81,8107.00,0.00
2024-12-10 17:39:40,59,7258,25,34,4252.49,8107.02,0.00
2024-12-10 17:39:40,58,7258,25,33,4299.26,8107.09,0.00
2024-12-10 17:39:40,58,7259,25,33,4309.57,8108.00,0.00
2024-12-10 17:39:40,59,7259,25,34,4236.53,8108.02,0.00
2024-12-10 17:39:40,58,7259,24,34,4168.21,8108.97,0.00
2024-12-10 17:39:40,58,7260,24,34,4305.24,8109.00,0.00
2024-12-10 17:39:40,59,7260,25,34,4232.27,8109.02,0.00
2024-12-10 17:39:40,58,7260,24,34,4250.72,8109.09,0.00
2024-12-10 17:39:40,57,7260,24,33,4301.11,8109.09,0.00
2024-12-10 17:39:40,56,7260,23,33,4372.14,8109.14,0.00
2024-12-10 17:39:40,57,7259,24,33,4248.79,8109.75,0.00
2024-12-10 17:39:40,57,7260,24,33,4392.70,8110.00,0.00
2024-12-10 17:39:40,58,7260,24,34,4316.96,8110.02,0.00
2024-12-10 17:39:40,57,7260,23,34,4389.85,8110.02,0.00
2024-12-10 17:39:40,56,7260,22,34,4464.97,8110.05,0.00
2024-12-10 17:39:41,56,7261,22,34,4649.46,8111.00,0.00
2024-12-10 17:39:41,57,7261,22,35,4567.90,8111.02,0.00
2024-12-10 17:39:41,56,7261,22,34,4623.39,8111.05,0.00
2024-12-10 17:39:41,55,7261,21,34,4649.95,8111.07,0.00
2024-12-10 17:39:41,55,7262,21,34,4722.79,8112.00,0.00
2024-12-10 17:39:41,56,7262,21,35,4638.45,8112.02,0.00
2024-12-10 17:39:41,55,7262,20,35,4721.31,8112.02,0.00
2024-12-10 17:39:41,54,7262,19,35,4807.24,8112.02,0.00
2024-12-10 17:39:41,53,7262,18,35,4864.27,8112.04,0.00
2024-12-10 17:39:41,53,7263,18,35,4939.88,8113.00,0.00
2024-12-10 17:39:41,54,7263,19,35,4848.40,8113.02,0.00
2024-12-10 17:39:41,53,7263,19,34,4916.92,8113.02,0.00
2024-12-10 17:39:41,52,7263,18,34,4963.46,8113.56,0.00
2024-12-10 17:39:41,52,7264,18,34,5083.96,8114.00,0.00
2024-12-10 17:39:41,53,7264,19,34,4988.03,8114.02,0.00
2024-12-10 17:39:41,53,7265,19,34,4977.97,8115.00,0.00
2024-12-10 17:39:41,54,7265,19,35,4885.78,8115.02,0.00
2024-12-10 17:39:41,53,7265,19,34,4948.88,8115.02,0.00
2024-12-10 17:39:41,52,7265,18,34,5044.05,8115.02,0.00
2024-12-10 17:39:41,52,7266,18,34,5058.71,8116.00,0.00
2024-12-10 17:39:41,53,7266,19,34,4963.27,8116.02,0.00
2024-12-10 17:39:41,53,7267,19,34,4955.73,8117.00,0.00
2024-12-10 17:39:41,54,7267,19,35,4863.95,8117.02,0.00
2024-12-10 17:39:41,53,7267,19,34,4922.04,8117.04,0.00
2024-12-10 17:39:41,53,7268,19,34,4936.42,8118.00,0.00
2024-12-10 17:39:41,54,7268,20,34,4845.01,8118.02,0.00
2024-12-10 17:39:41,53,7268,19,34,4798.07,8118.92,0.00
2024-12-10 17:39:41,53,7269,19,34,4945.19,8119.00,0.00
2024-12-10 17:39:41,54,7269,20,34,4853.61,8119.02,0.00
2024-12-10 17:39:41,53,7269,19,34,4943.66,8119.04,0.00
2024-12-10 17:39:41,52,7269,19,33,5005.94,8119.04,0.00
2024-12-10 17:39:41,52,7270,19,33,5022.17,8120.00,0.00
2024-12-10 17:39:41,53,7270,19,34,4927.41,8120.02,0.00
2024-12-10 17:39:41,53,7271,19,34,4918.74,8121.00,0.00
2024-12-10 17:39:41,54,7271,20,34,4827.65,8121.02,0.00
2024-12-10 17:39:41,53,7271,20,33,4886.57,8121.04,0.00
2024-12-10 17:39:41,53,7272,20,33,4900.96,8122.00,0.00
2024-12-10 17:39:41,54,7272,20,34,4810.20,8122.02,0.00
2024-12-10 17:39:41,53,7272,19,34,4814.28,8122.25,0.00
2024-12-10 17:39:41,53,7273,19,34,4906.75,8123.00,0.00
2024-12-10 17:39:41,54,7273,19,35,4815.89,8123.02,0.00
2024-12-10 17:39:41,53,7273,19,34,4874.57,8123.04,0.00
2024-12-10 17:39:41,52,7273,18,34,4935.58,8123.21,0.00
2024-12-10 17:39:41,52,7274,18,34,5028.29,8124.00,0.00
2024-12-10 17:39:41,53,7274,19,34,4933.41,8124.02,0.00
2024-12-10 17:39:41,52,7274,18,34,4958.94,8124.48,0.00
2024-12-10 17:39:42,52,7275,18,34,5020.28,8125.00,0.00
2024-12-10 17:39:42,53,7275,19,34,4925.56,8125.02,0.00
2024-12-10 17:39:42,52,7275,19,33,4987.48,8125.04,0.00
2024-12-10 17:39:42,51,7275,18,33,5045.66,8125.53,0.00
2024-12-10 17:39:42,51,7276,18,33,5103.38,8126.00,0.00
2024-12-10 17:39:42,52,7276,18,34,5005.24,8126.02,0.00
2024-12-10 17:39:42,51,7276,17,34,5101.79,8126.04,0.00
2024-12-10 17:39:42,51,7277,17,34,5094.39,8127.00,0.00
2024-12-10 17:39:42,52,7277,17,35,4996.42,8127.02,0.00
2024-12-10 17:39:42,51,7277,17,34,5060.93,8127.04,0.00
2024-12-10 17:39:42,50,7277,16,34,5052.28,8127.96,0.00
2024-12-10 17:39:42,50,7278,16,34,5211.60,8128.00,0.00
2024-12-10 17:39:42,51,7278,17,34,5109.42,8128.02,0.00
2024-12-10 17:39:42,51,7279,17,34,5096.93,8129.00,0.00
2024-12-10 17:39:42,52,7279,18,34,4998.91,8129.02,0.00
2024-12-10 17:39:42,51,7279,18,33,5065.06,8129.04,0.00
2024-12-10 17:39:42,51,7280,18,33,5083.21,8130.00,0.00
2024-12-10 17:39:42,52,7280,19,33,4985.46,8130.02,0.00
2024-12-10 17:39:42,52,7281,19,33,4971.97,8131.00,0.00
2024-12-10 17:39:42,53,7281,19,34,4878.15,8131.02,0.00
2024-12-10 17:39:42,52,7281,19,33,4942.26,8131.04,0.00
2024-12-10 17:39:42,52,7282,19,33,4958.50,8132.00,0.00
2024-12-10 17:39:42,53,7282,20,33,4864.94,8132.02,0.00
2024-12-10 17:39:42,53,7283,20,33,4851.69,8133.00,0.00
2024-12-10 17:39:42,54,7283,20,34,4761.84,8133.02,0.00
2024-12-10 17:39:42,53,7283,20,33,4824.07,8133.04,0.00
2024-12-10 17:39:42,53,7284,20,33,4838.47,8134.00,0.00
2024-12-10 17:39:42,54,7284,21,33,4748.87,8134.02,0.00
2024-12-10 17:39:42,53,7284,20,33,4728.18,8134.45,0.00
2024-12-10 17:39:42,53,7285,20,33,4837.53,8135.00,0.00
2024-12-10 17:39:42,54,7285,21,33,4747.95,8135.02,0.00
2024-12-10 17:39:42,53,7285,21,32,4811.44,8135.04,0.00
2024-12-10 17:39:42,53,7286,21,32,4825.84,8136.00,0.00
2024-12-10 17:39:42,54,7286,21,33,4736.48,8136.02,0.00
2024-12-10 17:39:42,54,7287,21,33,4719.14,8137.00,0.00
2024-12-10 17:39:42,55,7287,22,33,4633.33,8137.02,0.00
2024-12-10 17:39:42,54,7287,22,32,4693.52,8137.04,0.00
2024-12-10 17:39:42,53,7287,21,32,4780.55,8137.06,0.00
2024-12-10 17:39:42,52,7287,20,32,4797.50,8137.40,0.00
2024-12-10 17:39:42,52,7288,20,32,4899.59,8138.00,0.00
2024-12-10 17:39:42,53,7288,21,32,4807.14,8138.02,0.00
2024-12-10 17:39:42,53,7289,21,32,4784.54,8139.00,0.00
2024-12-10 17:39:42,54,7289,22,32,4695.94,8139.02,0.00
2024-12-10 17:39:42,53,7289,22,31,4759.97,8139.04,0.00
2024-12-10 17:39:42,53,7290,22,31,4768.40,8140.00,0.00
2024-12-10 17:39:42,54,7290,22,32,4680.10,8140.02,0.00
2024-12-10 17:39:42,53,7290,21,32,4636.72,8140.59,0.00
2024-12-10 17:39:42,53,7291,21,32,4750.25,8141.00,0.00
2024-12-10 17:39:42,54,7291,21,33,4662.28,8141.02,0.00
2024-12-10 17:39:42,53,7291,21,32,4721.07,8141.04,0.00
2024-12-10 17:39:42,52,7291,20,32,4763.86,8141.54,0.00
2024-12-10 17:39:42,52,7292,20,32,4875.48,8142.00,0.00
2024-12-10 17:39:42,53,7292,21,32,4783.49,8142.02,0.00
2024-12-10 17:39:42,53,7293,21,32,4762.32,8143.00,0.00
2024-12-10 17:39:42,54,7293,22,32,4674.13,8143.02,0.00
2024-12-10 17:39:42,53,7293,22,31,4733.13,8143.04,0.00
2024-12-10 17:39:42,53,7294,22,31,4737.74,8144.00,0.00
2024-12-10 17:39:42,54,7294,22,32,4650.00,8144.02,0.00
2024-12-10 17:39:42,54,7295,22,32,4628.05,8145.00,0.00
2024-12-10 17:39:42,55,7295,23,32,4543.90,8145.02,0.00
2024-12-10 17:39:42,54,7295,23,31,4600.90,8145.04,0.00
2024-12-10 17:39:42,53,7295,22,31,4645.02,8145.55,0.00
2024-12-10 17:39:42,53,7296,22,31,4690.88,8146.00,0.00
2024-12-10 17:39:42,54,7296,23,31,4604.01,8146.02,0.00
2024-12-10 17:39:42,53,7296,22,31,4553.42,8146.94,0.00
2024-12-10 17:39:42,53,7297,22,31,4702.55,8147.00,0.00
2024-12-10 17:39:42,54,7297,23,31,4615.47,8147.02,0.00
2024-12-10 17:39:42,53,7297,23,30,4676.42,8147.04,0.00
2024-12-10 17:39:42,53,7298,23,30,4686.75,8148.00,0.00
2024-12-10 17:39:42,54,7298,23,31,4599.96,8148.02,0.00
2024-12-10 17:39:42,54,7299,23,31,4583.04,8149.00,0.00
2024-12-10 17:39:42,55,7299,24,31,4499.71,8149.02,0.00
2024-12-10 17:39:42,54,7299,24,30,4558.89,8149.04,0.00
2024-12-10 17:39:42,53,7299,23,30,4536.85,8149.96,0.00
2024-12-10 17:39:42,53,7300,23,30,4687.57,8150.00,0.00
2024-12-10 17:39:42,54,7300,23,31,4600.76,8150.02,0.00
2024-12-10 17:39:43,54,7301,23,31,4586.57,8151.00,0.00
2024-12-10 17:39:43,55,7301,24,31,4503.18,8151.02,0.00
2024-12-10 17:39:43,54,7301,24,30,4563.93,8151.04,0.00
2024-12-10 17:39:43,54,7302,24,30,4576.56,8152.00,0.00
2024-12-10 17:39:43,55,7302,25,30,4493.35,8152.02,0.00
2024-12-10 17:39:43,55,7303,25,30,4482.30,8153.00,0.00
2024-12-10 17:39:43,56,7303,25,31,4402.26,8153.02,0.00
2024-12-10 17:39:43,55,7303,25,30,4455.62,8153.06,0.00
2024-12-10 17:39:43,54,7303,24,30,4535.12,8153.09,0.00
2024-12-10 17:39:43,54,7304,24,30,4552.28,8154.00,0.00
2024-12-10 17:39:43,55,7304,24,31,4469.51,8154.02,0.00
2024-12-10 17:39:43,54,7304,23,31,4511.26,8154.07,0.00
2024-12-10 17:39:43,54,7305,23,31,4587.31,8155.00,0.00
2024-12-10 17:39:43,55,7305,24,31,4503.90,8155.02,0.00
2024-12-10 17:39:43,54,7305,24,30,4585.80,8155.02,0.00
2024-12-10 17:39:43,53,7305,24,29,4646.17,8155.04,0.00
2024-12-10 17:39:43,53,7306,24,29,4660.59,8156.00,0.00
2024-12-10 17:39:43,54,7306,24,30,4574.28,8156.02,0.00
2024-12-10 17:39:43,54,7307,24,30,4583.00,8157.00,0.00
2024-12-10 17:39:43,55,7307,25,30,4499.68,8157.02,0.00
2024-12-10 17:39:43,54,7307,24,30,4446.15,8157.78,0.00
2024-12-10 17:39:43,54,7308,24,30,4579.26,8158.00,0.00
2024-12-10 17:39:43,55,7308,25,30,4496.00,8158.02,0.00
2024-12-10 17:39:43,54,7308,25,29,4559.63,8158.04,0.00
2024-12-10 17:39:43,54,7309,25,29,4572.27,8159.00,0.00
2024-12-10 17:39:43,55,7309,26,29,4489.13,8159.02,0.00
2024-12-10 17:39:43,55,7310,26,29,4479.86,8160.00,0.00
2024-12-10 17:39:43,56,7310,26,30,4399.86,8160.02,0.00
2024-12-10 17:39:43,55,7310,26,29,4451.68,8160.06,0.00
2024-12-10 17:39:43,54,7310,25,29,4525.99,8160.06,0.00
2024-12-10 17:39:43,54,7311,25,29,4600.59,8161.00,0.00
2024-12-10 17:39:43,55,7311,26,29,4516.94,8161.02,0.00
2024-12-10 17:39:44,55,7312,26,29,4507.96,8162.00,0.00
2024-12-10 17:39:44,56,7312,27,29,4427.46,8162.02,0.00
2024-12-10 17:39:44,55,7312,27,28,4479.77,8162.06,0.00
2024-12-10 17:39:45,55,7313,27,28,4492.18,8163.00,0.00
2024-12-10 17:39:45,56,7313,28,28,4411.97,8163.02,0.00
2024-12-10 17:39:45,55,7313,28,27,4437.39,8163.31,0.00
2024-12-10 17:39:45,54,7313,27,27,4478.28,8163.37,0.00
2024-12-10 17:39:45,54,7314,27,27,4578.47,8164.00,0.00
2024-12-10 17:39:45,55,7314,28,27,4495.23,8164.02,0.00
2024-12-10 17:39:45,54,7314,28,26,4549.75,8164.06,0.00
2024-12-10 17:39:45,54,7315,28,26,4563.91,8165.00,0.00
2024-12-10 17:39:45,55,7315,28,27,4480.93,8165.02,0.00
2024-12-10 17:39:45,55,7316,28,27,4470.62,8166.00,0.00
2024-12-10 17:39:45,56,7316,28,28,4390.79,8166.02,0.00
2024-12-10 17:39:45,55,7316,28,27,4443.91,8166.06,0.00
2024-12-10 17:39:45,54,7316,27,27,4428.59,8166.54,0.00
2024-12-10 17:39:45,54,7317,27,27,4542.34,8167.00,0.00
2024-12-10 17:39:45,55,7317,27,28,4459.75,8167.02,0.00
2024-12-10 17:39:45,55,7318,27,28,4451.49,8168.00,0.00
2024-12-10 17:39:45,56,7318,28,28,4372.00,8168.02,0.00
2024-12-10 17:39:45,55,7318,28,27,4423.28,8168.06,0.00
2024-12-10 17:39:45,54,7318,27,27,4485.45,8168.11,0.00
2024-12-10 17:39:45,54,7319,27,27,4564.64,8169.00,0.00
2024-12-10 17:39:45,55,7319,28,27,4481.64,8169.02,0.00
2024-12-10 17:39:45,55,7320,28,27,4473.72,8170.00,0.00
2024-12-10 17:39:45,56,7320,28,28,4393.84,8170.02,0.00
2024-12-10 17:39:45,55,7320,28,27,4445.51,8170.06,0.00
2024-12-10 17:39:45,55,7321,28,27,4457.93,8171.00,0.00
2024-12-10 17:39:45,56,7321,28,28,4378.32,8171.02,0.00
2024-12-10 17:39:45,55,7321,27,28,4382.07,8171.58,0.00
2024-12-10 17:39:45,55,7322,27,28,4449.71,8172.00,0.00
2024-12-10 17:39:45,56,7322,27,29,4370.25,8172.02,0.00
2024-12-10 17:39:45,55,7322,27,28,4422.97,8172.06,0.00
2024-12-10 17:39:45,54,7322,26,28,4455.22,8172.65,0.00
2024-12-10 17:39:45,53,7322,25,28,4464.53,8172.94,0.00
2024-12-10 17:39:45,53,7323,25,28,4614.14,8173.00,0.00
2024-12-10 17:39:45,54,7323,25,29,4528.70,8173.02,0.00
2024-12-10 17:39:45,53,7323,24,29,4577.72,8173.08,0.00
2024-12-10 17:39:45,53,7324,24,29,4604.72,8174.00,0.00
2024-12-10 17:39:45,54,7324,24,30,4519.45,8174.02,0.00
2024-12-10 17:39:45,53,7324,24,29,4578.51,8174.06,0.00
2024-12-10 17:39:45,52,7324,23,29,4561.50,8174.92,0.00
2024-12-10 17:39:45,52,7325,23,29,4712.48,8175.00,0.00
2024-12-10 17:39:45,53,7325,24,29,4623.56,8175.02,0.00
2024-12-10 17:39:45,52,7325,23,29,4630.87,8175.29,0.00
2024-12-10 17:39:45,52,7326,23,29,4730.40,8176.00,0.00
2024-12-10 17:39:45,53,7326,23,30,4641.15,8176.02,0.00
2024-12-10 17:39:45,52,7326,23,29,4703.68,8176.06,0.00
2024-12-10 17:39:45,52,7327,23,29,4721.54,8177.00,0.00
2024-12-10 17:39:45,53,7327,24,29,4632.46,8177.02,0.00
2024-12-10 17:39:45,53,7328,24,29,4621.48,8178.00,0.00
2024-12-10 17:39:45,54,7328,25,29,4535.90,8178.02,0.00
2024-12-10 17:39:45,53,7328,25,28,4596.80,8178.06,0.00
2024-12-10 17:39:45,53,7329,25,28,4612.79,8179.00,0.00
2024-12-10 17:39:45,54,7329,25,29,4527.36,8179.02,0.00
2024-12-10 17:39:45,53,7329,24,29,4574.23,8179.11,0.00
2024-12-10 17:39:45,53,7330,24,29,4602.48,8180.00,0.00
2024-12-10 17:39:45,54,7330,25,29,4517.25,8180.02,0.00
2024-12-10 17:39:45,53,7330,25,28,4579.33,8180.06,0.00
2024-12-10 17:39:45,52,7330,24,28,4642.28,8180.19,0.00
2024-12-10 17:39:45,52,7331,24,28,4734.04,8181.00,0.00
2024-12-10 17:39:45,53,7331,24,29,4644.72,8181.02,0.00
2024-12-10 17:39:45,53,7332,24,29,4633.77,8182.00,0.00
2024-12-10 17:39:45,54,7332,24,30,4547.96,8182.02,0.00
2024-12-10 17:39:45,53,7332,24,29,4609.08,8182.06,0.00
2024-12-10 17:39:45,52,7332,23,29,4642.08,8182.65,0.00
2024-12-10 17:39:45,52,7333,23,29,4771.39,8183.00,0.00
2024-12-10 17:39:45,53,7333,23,30,4681.36,8183.02,0.00
2024-12-10 17:39:45,52,7333,22,30,4714.78,8183.17,0.00
2024-12-10 17:39:45,52,7334,22,30,4805.02,8184.00,0.00
2024-12-10 17:39:45,53,7334,22,31,4714.36,8184.02,0.00
2024-12-10 17:39:45,52,7334,22,30,4778.19,8184.06,0.00
2024-12-10 17:39:45,51,7334,21,30,4847.85,8184.18,0.00
2024-12-10 17:39:45,51,7335,21,30,4941.48,8185.00,0.00
2024-12-10 17:39:45,52,7335,22,30,4846.45,8185.02,0.00
2024-12-10 17:39:46,52,7336,22,30,4836.01,8186.00,0.00
2024-12-10 17:39:46,53,7336,22,31,4744.77,8186.02,0.00
2024-12-10 17:39:46,52,7336,21,31,4834.44,8186.02,0.00
2024-12-10 17:39:46,51,7336,21,30,4898.74,8186.06,0.00
2024-12-10 17:39:46,50,7336,20,30,4950.86,8186.24,0.00
2024-12-10 17:39:46,50,7337,20,30,5052.92,8187.00,0.00
2024-12-10 17:39:46,51,7337,21,30,4953.84,8187.02,0.00
2024-12-10 17:39:46,51,7338,21,30,4943.75,8188.00,0.00
2024-12-10 17:39:46,52,7338,21,31,4848.67,8188.02,0.00
2024-12-10 17:39:46,51,7338,21,30,4914.85,8188.06,0.00
2024-12-10 17:39:46,51,7339,21,30,4934.71,8189.00,0.00
2024-12-10 17:39:46,52,7339,21,31,4839.82,8189.02,0.00
2024-12-10 17:39:46,52,7340,21,31,4830.50,8190.00,0.00
2024-12-10 17:39:46,53,7340,22,31,4739.36,8190.02,0.00
2024-12-10 17:39:46,52,7340,22,30,4800.59,8190.06,0.00
2024-12-10 17:39:46,51,7340,21,30,4791.03,8190.55,0.00
2024-12-10 17:39:46,51,7341,21,30,4915.04,8191.00,0.00
2024-12-10 17:39:46,52,7341,21,31,4820.52,8191.02,0.00
2024-12-10 17:39:46,51,7341,20,31,4788.39,8191.53,0.00
2024-12-10 17:39:46,51,7342,20,31,4910.82,8192.00,0.00
2024-12-10 17:39:46,52,7342,21,31,4816.38,8192.02,0.00
2024-12-10 17:39:46,51,7342,20,31,4909.38,8192.02,0.00
2024-12-10 17:39:46,50,7342,20,30,4979.72,8192.04,0.00
2024-12-10 17:39:46,50,7343,20,30,4999.99,8193.00,0.00
2024-12-10 17:39:46,51,7343,21,30,4901.95,8193.02,0.00
2024-12-10 17:39:46,51,7344,21,30,4894.84,8194.00,0.00
2024-12-10 17:39:46,52,7344,21,31,4800.70,8194.02,0.00
2024-12-10 17:39:46,51,7344,21,30,4864.31,8194.04,0.00
2024-12-10 17:39:46,51,7345,21,30,4882.58,8195.00,0.00
2024-12-10 17:39:46,52,7345,21,31,4788.68,8195.02,0.00
2024-12-10 17:39:46,51,7345,20,31,4847.24,8195.06,0.00
2024-12-10 17:39:46,51,7346,20,31,4931.39,8196.00,0.00
2024-12-10 17:39:46,52,7346,20,32,4836.55,8196.02,0.00
2024-12-10 17:39:46,51,7346,20,31,4900.86,8196.04,0.00
2024-12-10 17:39:46,51,7347,20,31,4919.13,8197.00,0.00
2024-12-10 17:39:46,52,7347,21,31,4824.53,8197.02,0.00
2024-12-10 17:39:46,51,7347,20,31,4911.17,8197.04,0.00
2024-12-10 17:39:46,51,7348,20,31,4961.59,8198.00,0.00
2024-12-10 17:39:46,52,7348,21,31,4866.18,8198.02,0.00
2024-12-10 17:39:46,51,7348,21,30,4929.45,8198.04,0.00
2024-12-10 17:39:46,51,7349,21,30,4947.73,8199.00,0.00
2024-12-10 17:39:46,52,7349,21,31,4852.58,8199.02,0.00
2024-12-10 17:39:46,51,7349,20,31,4946.13,8199.04,0.00
2024-12-10 17:39:46,51,7350,20,31,4944.35,8200.00,0.00
2024-12-10 17:39:46,52,7350,21,31,4849.27,8200.02,0.00
2024-12-10 17:39:46,51,7350,21,30,4908.98,8200.04,0.00
2024-12-10 17:39:46,50,7350,20,30,4967.21,8200.52,0.00
2024-12-10 17:39:46,50,7351,20,30,5026.60,8201.00,0.00
2024-12-10 17:39:46,51,7351,20,31,4928.04,8201.02,0.00
2024-12-10 17:39:46,50,7351,19,31,4947.81,8201.54,0.00
2024-12-10 17:39:46,50,7352,19,31,5074.46,8202.00,0.00
2024-12-10 17:39:46,51,7352,20,31,4974.96,8202.02,0.00
2024-12-10 17:39:46,50,7352,20,30,5040.02,8202.04,0.00
2024-12-10 17:39:46,50,7353,20,30,5060.31,8203.00,0.00
2024-12-10 17:39:46,51,7353,20,31,4961.09,8203.02,0.00
2024-12-10 17:39:46,51,7354,20,31,4955.93,8204.00,0.00
2024-12-10 17:39:46,52,7354,20,32,4860.63,8204.02,0.00
2024-12-10 17:39:46,51,7354,20,31,4920.55,8204.04,0.00
2024-12-10 17:39:46,50,7354,19,31,5005.15,8204.04,0.00
2024-12-10 17:39:46,50,7355,19,31,5091.08,8205.00,0.00
2024-12-10 17:39:46,51,7355,20,31,4991.26,8205.02,0.00
2024-12-10 17:39:46,51,7356,20,31,4988.51,8206.00,0.00
2024-12-10 17:39:46,52,7356,21,31,4892.58,8206.02,0.00
2024-12-10 17:39:46,51,7356,20,31,4933.95,8206.06,0.00
2024-12-10 17:39:46,51,7357,20,31,5018.22,8207.00,0.00
2024-12-10 17:39:46,52,7357,20,32,4921.72,8207.02,0.00
2024-12-10 17:39:46,51,7357,20,31,5013.40,8207.04,0.00
2024-12-10 17:39:46,51,7358,20,31,5031.71,8208.00,0.00
2024-12-10 17:39:46,52,7358,21,31,4934.95,8208.02,0.00
2024-12-10 17:39:46,51,7358,20,31,4911.06,8208.47,0.00
2024-12-10 17:39:47,51,7359,20,31,5028.96,8209.00,0.00
2024-12-10 17:39:47,52,7359,20,32,4932.25,8209.02,0.00
2024-12-10 17:39:47,51,7359,19,32,4954.26,8209.18,0.00
2024-12-10 17:39:47,52,7358,20,32,4826.06,8209.62,0.00
2024-12-10 17:39:47,52,7359,20,32,4984.27,8210.00,0.00
2024-12-10 17:39:47,53,7359,20,33,4890.22,8210.02,0.00
2024-12-10 17:39:47,52,7359,20,32,4981.11,8210.04,0.00
2024-12-10 17:39:47,52,7360,20,32,5155.41,8211.00,0.00
2024-12-10 17:39:47,53,7360,21,32,5058.14,8211.02,0.00
2024-12-10 17:39:47,52,7360,20,32,5138.04,8211.02,0.00
2024-12-10 17:39:47,51,7360,19,32,5237.18,8211.02,0.00
2024-12-10 17:39:47,51,7361,19,32,5286.12,8212.00,0.00
2024-12-10 17:39:47,52,7361,20,32,5184.46,8212.02,0.00
2024-12-10 17:39:47,52,7362,20,32,5167.72,8213.00,0.00
2024-12-10 17:39:47,53,7362,21,32,5070.22,8213.02,0.00
2024-12-10 17:39:47,52,7362,21,31,5166.14,8213.02,0.00
2024-12-10 17:39:47,52,7363,21,31,5180.99,8214.00,0.00
2024-12-10 17:39:47,53,7363,21,32,5083.23,8214.02,0.00
2024-12-10 17:39:47,52,7363,20,32,5084.76,8214.33,0.00
2024-12-10 17:39:47,51,7363,19,32,5163.70,8214.59,0.00
2024-12-10 17:39:47,51,7364,19,32,5291.27,8215.00,0.00
2024-12-10 17:39:47,52,7364,20,32,5189.52,8215.02,0.00
2024-12-10 17:39:47,51,7364,20,31,5259.06,8215.02,0.00
2024-12-10 17:39:47,51,7365,20,31,5275.81,8216.00,0.00
2024-12-10 17:39:47,52,7365,20,32,5174.35,8216.02,0.00
2024-12-10 17:39:47,52,7366,20,32,5162.75,8217.00,0.00
2024-12-10 17:39:47,53,7366,21,32,5065.34,8217.02,0.00
2024-12-10 17:39:47,52,7366,21,31,5129.58,8217.04,0.00
2024-12-10 17:39:47,52,7367,21,31,5146.00,8218.00,0.00
2024-12-10 17:39:47,53,7367,21,32,5048.90,8218.02,0.00
2024-12-10 17:39:47,52,7367,20,32,5144.43,8218.04,0.00
2024-12-10 17:39:47,51,7367,19,32,5229.87,8218.04,0.00
2024-12-10 17:39:47,51,7368,19,32,5280.46,8219.00,0.00
2024-12-10 17:39:47,52,7368,19,33,5178.91,8219.02,0.00
2024-12-10 17:39:47,52,7369,19,33,5162.15,8220.00,0.00
2024-12-10 17:39:47,53,7369,19,34,5064.76,8220.02,0.00
2024-12-10 17:39:47,52,7369,19,33,5159.00,8220.04,0.00
2024-12-10 17:39:47,51,7369,18,33,5171.74,8220.47,0.00
2024-12-10 17:39:47,51,7370,18,33,5289.80,8221.00,0.00
2024-12-10 17:39:47,52,7370,18,34,5188.08,8221.02,0.00
2024-12-10 17:39:47,52,7371,18,34,5180.91,8222.00,0.00
2024-12-10 17:39:47,53,7371,19,34,5083.16,8222.02,0.00
2024-12-10 17:39:47,52,7371,18,34,5177.76,8222.04,0.00
2024-12-10 17:39:47,51,7371,17,34,5160.06,8222.41,0.00
2024-12-10 17:39:47,51,7372,17,34,5273.36,8223.00,0.00
2024-12-10 17:39:47,52,7372,18,34,5171.95,8223.02,0.00
2024-12-10 17:39:47,51,7372,18,33,5266.91,8223.04,0.00
2024-12-10 17:39:47,51,7373,18,33,5285.29,8224.00,0.00
2024-12-10 17:39:47,52,7373,18,34,5183.65,8224.02,0.00
2024-12-10 17:39:47,52,7374,18,34,5173.22,8225.00,0.00
2024-12-10 17:39:47,53,7374,19,34,5075.62,8225.02,0.00
2024-12-10 17:39:47,53,7375,19,34,5057.61,8226.00,0.00
2024-12-10 17:39:47,54,7375,19,35,4963.95,8226.02,0.00
2024-12-10 17:39:47,53,7375,19,34,5054.51,8226.04,0.00
2024-12-10 17:39:47,52,7375,18,34,5041.54,8226.96,0.00
2024-12-10 17:39:47,52,7376,18,34,5196.61,8227.00,0.00
2024-12-10 17:39:47,53,7376,19,34,5098.56,8227.02,0.00
2024-12-10 17:39:47,52,7376,18,34,5081.33,8227.44,0.00
2024-12-10 17:39:47,52,7377,18,34,5194.08,8228.00,0.00
2024-12-10 17:39:47,53,7377,19,34,5096.08,8228.02,0.00
2024-12-10 17:39:47,52,7377,19,33,5160.85,8228.04,0.00
2024-12-10 17:39:47,52,7378,19,33,5177.30,8229.00,0.00
2024-12-10 17:39:47,53,7378,20,33,5079.62,8229.02,0.00
2024-12-10 17:39:48,53,7379,20,33,5068.35,8230.00,0.00
2024-12-10 17:39:48,54,7379,20,34,4974.49,8230.02,0.00
2024-12-10 17:39:48,53,7379,20,33,5034.19,8230.04,0.00
2024-12-10 17:39:48,52,7379,19,33,5088.14,8230.56,0.00
2024-12-10 17:39:48,52,7380,19,33,5147.03,8231.00,0.00
2024-12-10 17:39:48,53,7380,19,34,5049.92,8231.02,0.00
2024-12-10 17:39:48,53,7381,19,34,5036.35,8232.00,0.00
2024-12-10 17:39:48,54,7381,19,35,4943.08,8232.02,0.00
2024-12-10 17:39:48,53,7381,19,34,5003.74,8232.04,0.00
2024-12-10 17:39:48,52,7381,18,34,4991.52,8232.96,0.00
2024-12-10 17:39:48,52,7382,18,34,5146.70,8233.00,0.00
2024-12-10 17:39:48,53,7382,19,34,5049.59,8233.02,0.00
2024-12-10 17:39:48,53,7383,19,34,5035.61,8234.00,0.00
2024-12-10 17:39:48,54,7383,19,35,4942.35,8234.02,0.00
2024-12-10 17:39:48,53,7383,19,34,5004.54,8234.04,0.00
2024-12-10 17:39:48,53,7384,19,34,5019.13,8235.00,0.00
2024-12-10 17:39:48,54,7384,19,35,4926.18,8235.02,0.00
2024-12-10 17:39:48,54,7385,19,35,4911.05,8236.00,0.00
2024-12-10 17:39:48,55,7385,19,36,4821.76,8236.02,0.00
2024-12-10 17:39:48,54,7385,19,35,4882.07,8236.04,0.00
2024-12-10 17:39:48,54,7386,19,35,4894.87,8237.00,0.00
2024-12-10 17:39:48,55,7386,19,36,4805.87,8237.02,0.00
2024-12-10 17:39:48,54,7386,18,36,4805.00,8237.33,0.00
2024-12-10 17:39:48,54,7387,18,36,4903.09,8238.00,0.00
2024-12-10 17:39:48,55,7387,18,37,4813.94,8238.02,0.00
2024-12-10 17:39:48,54,7387,18,36,4875.63,8238.04,0.00
2024-12-10 17:39:48,54,7388,18,36,4888.42,8239.00,0.00
2024-12-10 17:39:48,55,7388,19,36,4799.54,8239.02,0.00
2024-12-10 17:39:48,54,7388,18,36,4862.49,8239.02,0.00
2024-12-10 17:39:48,54,7389,18,36,4904.28,8240.00,0.00
2024-12-10 17:39:48,55,7389,18,37,4815.11,8240.02,0.00
2024-12-10 17:39:48,54,7389,18,36,4878.34,8240.02,0.00
2024-12-10 17:39:48,54,7390,18,36,4889.61,8241.00,0.00
2024-12-10 17:39:48,55,7390,18,37,4800.71,8241.02,0.00
2024-12-10 17:39:48,54,7390,17,37,4805.79,8241.30,0.00
2024-12-10 17:39:48,54,7391,17,37,4900.89,8242.00,0.00
2024-12-10 17:39:48,55,7391,17,38,4811.78,8242.02,0.00
2024-12-10 17:39:48,54,7391,17,37,4873.42,8242.02,0.00
2024-12-10 17:39:48,54,7392,17,37,4884.69,8243.00,0.00
2024-12-10 17:39:48,55,7392,18,37,4795.88,8243.02,0.00
2024-12-10 17:39:48,54,7392,17,37,4811.62,8243.54,0.00
2024-12-10 17:39:48,53,7392,16,37,4893.16,8243.66,0.00
2024-12-10 17:39:48,53,7393,16,37,4968.56,8244.00,0.00
2024-12-10 17:39:48,54,7393,16,38,4876.55,8244.02,0.00
2024-12-10 17:39:48,53,7393,16,37,4940.56,8244.02,0.00
2024-12-10 17:39:48,53,7394,16,37,4953.60,8245.00,0.00
2024-12-10 17:39:48,54,7394,17,37,4861.87,8245.02,0.00
2024-12-10 17:39:48,53,7394,16,37,4858.56,8245.66,0.00
2024-12-10 17:39:48,53,7395,16,37,4986.40,8246.00,0.00
2024-12-10 17:39:48,54,7395,17,37,4894.06,8246.02,0.00
2024-12-10 17:39:48,53,7395,17,36,4959.95,8246.02,0.00
2024-12-10 17:39:48,53,7396,17,36,4973.00,8247.00,0.00
2024-12-10 17:39:48,54,7396,18,36,4880.91,8247.02,0.00
2024-12-10 17:39:48,54,7397,18,36,4866.76,8248.00,0.00
2024-12-10 17:39:48,55,7397,18,37,4778.28,8248.02,0.00
2024-12-10 17:39:48,54,7397,18,36,4842.33,8248.02,0.00
2024-12-10 17:39:48,53,7397,17,36,4929.04,8248.08,0.00
2024-12-10 17:39:48,53,7398,17,36,4946.74,8249.00,0.00
2024-12-10 17:39:48,54,7398,17,37,4855.13,8249.02,0.00
2024-12-10 17:39:48,53,7398,16,37,4913.54,8249.04,0.00
2024-12-10 17:39:48,53,7399,16,37,4932.21,8250.00,0.00
2024-12-10 17:39:48,54,7399,17,37,4840.87,8250.02,0.00
2024-12-10 17:39:48,53,7399,17,36,4908.86,8250.02,0.00
2024-12-10 17:39:48,52,7399,16,36,4964.29,8250.19,0.00
2024-12-10 17:39:48,52,7400,16,36,5056.84,8251.00,0.00
2024-12-10 17:39:48,53,7400,16,37,4961.43,8251.02,0.00
2024-12-10 17:39:48,53,7401,16,37,4945.57,8252.00,0.00
2024-12-10 17:39:48,54,7401,17,37,4853.99,8252.02,0.00
2024-12-10 17:39:48,53,7401,17,36,4922.22,8252.02,0.00
2024-12-10 17:39:48,52,7401,16,36,4963.95,8252.29,0.00
2024-12-10 17:39:48,52,7402,16,36,5064.42,8253.00,0.00
2024-12-10 17:39:48,53,7402,17,36,4968.86,8253.02,0.00
2024-12-10 17:39:48,53,7403,17,36,4978.18,8254.00,0.00
2024-12-10 17:39:48,54,7403,17,37,4885.99,8254.02,0.00
2024-12-10 17:39:48,53,7403,16,37,4897.50,8254.62,0.00
2024-12-10 17:39:48,53,7404,16,37,4964.14,8255.00,0.00
2024-12-10 17:39:48,54,7404,16,38,4872.21,8255.02,0.00
2024-12-10 17:39:48,53,7404,16,37,4940.77,8255.02,0.00
2024-12-10 17:39:48,53,7405,16,37,4953.83,8256.00,0.00
2024-12-10 17:39:48,54,7405,16,38,4862.10,8256.02,0.00
2024-12-10 17:39:48,54,7406,16,38,4844.22,8257.00,0.00
2024-12-10 17:39:48,55,7406,17,38,4756.15,8257.02,0.00
2024-12-10 17:39:48,54,7406,17,37,4824.35,8257.02,0.00
2024-12-10 17:39:48,54,7407,17,37,4835.64,8258.00,0.00
2024-12-10 17:39:49,55,7407,18,37,4747.72,8258.02,0.00
2024-12-10 17:39:49,54,7407,17,37,4726.06,8258.80,0.00
2024-12-10 17:39:49,54,7408,17,37,4862.33,8259.00,0.00
2024-12-10 17:39:49,55,7408,17,38,4773.93,8259.02,0.00
2024-12-10 17:39:49,54,7408,17,37,4842.45,8259.02,0.00
2024-12-10 17:39:49,54,7409,17,37,4853.74,8260.00,0.00
2024-12-10 17:39:49,55,7409,17,38,4765.49,8260.02,0.00
2024-12-10 17:39:49,56,7408,18,38,4527.27,8260.89,0.00
2024-12-10 17:39:49,56,7409,18,38,4789.06,8261.00,0.00
2024-12-10 17:39:49,57,7409,19,38,4705.04,8261.02,0.00
2024-12-10 17:39:49,56,7409,19,37,4768.40,8261.02,0.00
2024-12-10 17:39:49,56,7410,19,37,4923.89,8262.00,0.00
2024-12-10 17:39:49,57,7410,19,38,4837.51,8262.02,0.00
2024-12-10 17:39:49,56,7410,18,38,4813.84,8262.79,0.00
2024-12-10 17:39:49,56,7411,18,38,4943.86,8263.00,0.00
2024-12-10 17:39:49,57,7411,19,38,4857.13,8263.02,0.00
2024-12-10 17:39:49,56,7411,19,37,4924.68,8263.02,0.00
2024-12-10 17:39:49,57,7410,19,38,4823.85,8263.23,0.00
2024-12-10 17:39:49,56,7410,18,38,4953.96,8263.61,0.00
2024-12-10 17:39:49,56,7411,18,38,5069.37,8264.00,0.00
2024-12-10 17:39:49,57,7411,18,39,4980.44,8264.02,0.00
2024-12-10 17:39:49,56,7411,17,39,5007.47,8264.23,0.00
2024-12-10 17:39:49,56,7412,17,39,5239.72,8265.00,0.00
2024-12-10 17:39:49,57,7412,17,40,5147.79,8265.02,0.00
2024-12-10 17:39:49,56,7412,17,39,5222.01,8265.02,0.00
2024-12-10 17:39:49,56,7413,17,39,5230.02,8266.00,0.00
2024-12-10 17:39:49,57,7413,17,40,5138.26,8266.02,0.00
2024-12-10 17:39:49,57,7414,17,40,5115.68,8267.00,0.00
2024-12-10 17:39:49,58,7414,18,40,5027.48,8267.02,0.00
2024-12-10 17:39:49,57,7414,18,39,5096.82,8267.02,0.00
2024-12-10 17:39:49,56,7414,17,39,5088.02,8267.93,0.00
2024-12-10 17:39:49,56,7415,17,39,5229.81,8268.00,0.00
2024-12-10 17:39:49,57,7415,18,39,5138.05,8268.02,0.00
2024-12-10 17:39:49,57,7416,18,39,5115.47,8269.00,0.00
2024-12-10 17:39:49,58,7416,19,39,5027.27,8269.02,0.00
2024-12-10 17:39:49,57,7416,19,38,5096.61,8269.02,0.00
2024-12-10 17:39:49,56,7416,18,38,5181.74,8269.09,0.00
2024-12-10 17:39:49,56,7417,18,38,5195.63,8270.00,0.00
2024-12-10 17:39:49,57,7417,19,38,5104.48,8270.02,0.00
2024-12-10 17:39:49,57,7418,19,38,5081.88,8271.00,0.00
2024-12-10 17:39:49,58,7418,19,39,4994.26,8271.02,0.00
2024-12-10 17:39:49,57,7418,19,38,5063.01,8271.02,0.00
2024-12-10 17:39:49,57,7419,19,38,5069.43,8272.00,0.00
2024-12-10 17:39:49,58,7419,19,39,4982.03,8272.02,0.00
2024-12-10 17:39:49,58,7420,19,39,4958.38,8273.00,0.00
2024-12-10 17:39:49,59,7420,19,40,4874.34,8273.02,0.00
2024-12-10 17:39:49,58,7420,19,39,4941.26,8273.02,0.00
2024-12-10 17:39:49,57,7420,18,39,5020.74,8273.11,0.00
2024-12-10 17:39:49,56,7420,17,39,5013.44,8273.96,0.00
2024-12-10 17:39:49,56,7421,17,39,5158.25,8274.00,0.00
2024-12-10 17:39:49,57,7421,17,40,5067.75,8274.02,0.00
2024-12-10 17:39:49,56,7421,16,40,5112.50,8274.14,0.00
2024-12-10 17:39:49,56,7422,16,40,5189.90,8275.00,0.00
2024-12-10 17:39:49,57,7422,17,40,5098.85,8275.02,0.00
2024-12-10 17:39:49,56,7422,16,40,5144.10,8275.02,0.00
2024-12-10 17:39:49,55,7422,16,39,5218.07,8275.02,0.00
2024-12-10 17:39:49,55,7423,16,39,5287.91,8276.00,0.00
2024-12-10 17:39:49,56,7423,16,40,5193.49,8276.02,0.00
2024-12-10 17:39:49,56,7424,16,40,5171.94,8277.00,0.00
2024-12-10 17:39:49,57,7424,17,40,5081.21,8277.02,0.00
2024-12-10 17:39:49,56,7424,17,39,5152.73,8277.02,0.00
2024-12-10 17:39:49,56,7425,17,39,5160.74,8278.00,0.00
2024-12-10 17:39:49,57,7425,18,39,5070.20,8278.02,0.00
2024-12-10 17:39:50,57,7426,18,39,5047.58,8279.00,0.00
2024-12-10 17:39:50,58,7426,18,40,4960.55,8279.02,0.00
2024-12-10 17:39:50,57,7426,18,39,5030.15,8279.02,0.00
2024-12-10 17:39:50,57,7427,18,39,5036.56,8280.00,0.00
2024-12-10 17:39:50,58,7427,18,40,4949.73,8280.02,0.00
2024-12-10 17:39:50,57,7427,17,40,4930.73,8280.46,0.00
2024-12-10 17:39:50,58,7426,18,40,4841.47,8280.53,0.00
2024-12-10 17:39:50,58,7427,18,40,5016.58,8281.00,0.00
2024-12-10 17:39:50,59,7427,19,40,4931.55,8281.02,0.00
2024-12-10 17:39:50,58,7427,19,39,4995.17,8281.03,0.00
2024-12-10 17:39:50,58,7428,19,39,5144.27,8282.00,0.00
2024-12-10 17:39:50,59,7428,20,39,5057.08,8282.02,0.00
2024-12-10 17:39:50,58,7428,19,39,5019.15,8282.91,0.00
2024-12-10 17:39:50,58,7429,19,39,5154.89,8283.00,0.00
2024-12-10 17:39:50,59,7429,19,40,5067.52,8283.02,0.00
2024-12-10 17:39:50,58,7429,19,39,5133.48,8283.03,0.00
2024-12-10 17:39:50,58,7430,19,39,5138.84,8284.00,0.00
2024-12-10 17:39:50,59,7430,19,40,5051.74,8284.02,0.00
2024-12-10 17:39:50,59,7431,19,40,5026.23,8285.00,0.00
2024-12-10 17:39:50,60,7431,20,40,4942.46,8285.02,0.00
2024-12-10 17:39:50,59,7431,20,39,5005.18,8285.03,0.00
2024-12-10 17:39:50,59,7432,20,39,5007.02,8286.00,0.00
2024-12-10 17:39:50,60,7432,21,39,4923.57,8286.02,0.00
2024-12-10 17:39:50,60,7433,21,39,4895.63,8287.00,0.00
2024-12-10 17:39:50,61,7433,21,40,4815.37,8287.02,0.00
2024-12-10 17:39:50,60,7433,21,39,4876.30,8287.03,0.00
2024-12-10 17:39:50,59,7433,20,39,4897.56,8287.70,0.00
2024-12-10 17:39:50,59,7434,20,39,4956.78,8288.00,0.00
2024-12-10 17:39:50,60,7434,20,40,4874.17,8288.02,0.00
2024-12-10 17:39:50,59,7434,19,40,4921.70,8288.10,0.00
2024-12-10 17:39:50,59,7435,19,40,4929.26,8289.00,0.00
2024-12-10 17:39:50,60,7435,19,41,4847.10,8289.02,0.00
2024-12-10 17:39:50,59,7435,19,40,4911.01,8289.03,0.00
2024-12-10 17:39:50,58,7435,18,40,4902.77,8289.57,0.00
2024-12-10 17:39:50,57,7435,17,40,4979.02,8289.67,0.00
2024-12-10 17:39:50,57,7436,17,40,5097.08,8290.00,0.00
2024-12-10 17:39:50,58,7436,17,41,5009.19,8290.02,0.00
2024-12-10 17:39:50,58,7437,17,41,4985.50,8291.00,0.00
2024-12-10 17:39:50,59,7437,17,42,4901.00,8291.02,0.00
2024-12-10 17:39:50,58,7437,17,41,4968.36,8291.03,0.00
2024-12-10 17:39:50,57,7437,16,41,5051.74,8291.07,0.00
2024-12-10 17:39:50,56,7437,15,41,5047.73,8291.93,0.00
2024-12-10 17:39:50,56,7438,15,41,5189.93,8292.00,0.00
2024-12-10 17:39:50,57,7438,16,41,5098.88,8292.02,0.00
2024-12-10 17:39:50,56,7438,15,41,5119.30,8292.27,0.00
2024-12-10 17:39:50,56,7439,15,41,5207.18,8293.00,0.00
2024-12-10 17:39:50,57,7439,16,41,5115.82,8293.02,0.00
2024-12-10 17:39:50,56,7439,16,40,5187.94,8293.04,0.00
2024-12-10 17:39:50,56,7440,16,40,5197.44,8294.00,0.00
2024-12-10 17:39:50,57,7440,17,40,5106.26,8294.02,0.00
2024-12-10 17:39:50,57,7441,17,40,5083.59,8295.00,0.00
2024-12-10 17:39:50,58,7441,18,40,4995.94,8295.02,0.00
2024-12-10 17:39:50,57,7441,18,39,5064.68,8295.04,0.00
2024-12-10 17:39:50,56,7441,17,39,5100.67,8295.68,0.00
2024-12-10 17:39:50,56,7442,17,39,5163.14,8296.00,0.00
2024-12-10 17:39:50,57,7442,17,40,5072.56,8296.02,0.00
2024-12-10 17:39:50,57,7443,17,40,5049.88,8297.00,0.00
2024-12-10 17:39:50,58,7443,18,40,4962.81,8297.02,0.00
2024-12-10 17:39:50,57,7443,18,39,5028.06,8297.04,0.00
2024-12-10 17:39:50,57,7444,18,39,5035.93,8298.00,0.00
2024-12-10 17:39:50,58,7444,19,39,4949.10,8298.02,0.00
2024-12-10 17:39:50,58,7445,19,39,4925.37,8299.00,0.00
2024-12-10 17:39:50,59,7445,20,39,4841.89,8299.02,0.00
2024-12-10 17:39:50,58,7445,20,38,4905.35,8299.03,0.00
2024-12-10 17:39:50,58,7446,20,38,4911.66,8300.00,0.00
2024-12-10 17:39:50,59,7446,21,38,4828.41,8300.02,0.00
2024-12-10 17:39:50,59,7447,21,38,4803.67,8301.00,0.00
2024-12-10 17:39:50,60,7447,21,39,4723.60,8301.02,0.00
2024-12-10 17:39:50,59,7447,21,38,4785.39,8301.03,0.00
2024-12-10 17:39:50,58,7447,20,38,4812.43,8301.69,0.00
2024-12-10 17:39:50,57,7447,19,38,4849.00,8301.97,0.00
2024-12-10 17:39:50,57,7448,19,38,4991.75,8302.00,0.00
2024-12-10 17:39:50,58,7448,20,38,4905.68,8302.02,0.00
2024-12-10 17:39:50,58,7449,20,38,4881.94,8303.00,0.00
2024-12-10 17:39:50,59,7449,20,39,4799.19,8303.02,0.00
2024-12-10 17:39:50,58,7449,20,38,4863.34,8303.03,0.00
2024-12-10 17:39:50,58,7450,20,38,4869.64,8304.00,0.00
2024-12-10 17:39:50,59,7450,21,38,4787.11,8304.02,0.00
2024-12-10 17:39:50,59,7451,21,38,4762.34,8305.00,0.00
2024-12-10 17:39:50,60,7451,22,38,4682.97,8305.02,0.00
2024-12-10 17:39:50,59,7451,22,37,4745.46,8305.03,0.00
2024-12-10 17:39:51,59,7452,22,37,4750.25,8306.00,0.00
2024-12-10 17:39:51,60,7452,23,37,4671.08,8306.02,0.00
2024-12-10 17:39:51,59,7452,22,37,4710.88,8306.15,0.00
2024-12-10 17:39:51,59,7453,22,37,4725.48,8307.00,0.00
2024-12-10 17:39:51,60,7453,22,38,4646.72,8307.02,0.00
2024-12-10 17:39:51,59,7453,22,37,4710.00,8307.03,0.00
2024-12-10 17:39:51,59,7454,22,37,4714.78,8308.00,0.00
2024-12-10 17:39:51,60,7454,22,38,4636.20,8308.02,0.00
2024-12-10 17:39:51,60,7455,22,38,4610.45,8309.00,0.00
2024-12-10 17:39:51,61,7455,23,38,4534.87,8309.02,0.00
2024-12-10 17:39:51,60,7455,23,37,4596.61,8309.03,0.00
2024-12-10 17:39:51,59,7455,22,37,4591.87,8309.85,0.00
2024-12-10 17:39:51,59,7456,22,37,4720.14,8310.00,0.00
2024-12-10 17:39:51,60,7456,23,37,4641.47,8310.02,0.00
2024-12-10 17:39:51,60,7457,23,37,4615.71,8311.00,0.00
2024-12-10 17:39:51,61,7457,24,37,4540.04,8311.02,0.00
2024-12-10 17:39:51,60,7457,24,36,4603.25,8311.03,0.00
2024-12-10 17:39:51,60,7458,24,36,4606.57,8312.00,0.00
2024-12-10 17:39:51,61,7458,24,37,4531.05,8312.02,0.00
2024-12-10 17:39:51,60,7458,23,37,4522.22,8312.40,0.00
2024-12-10 17:39:51,60,7459,23,37,4611.28,8313.00,0.00
2024-12-10 17:39:51,61,7459,24,37,4535.69,8313.02,0.00
2024-12-10 17:39:51,60,7459,24,36,4598.82,8313.03,0.00
2024-12-10 17:39:51,60,7460,24,36,4602.14,8314.00,0.00
2024-12-10 17:39:51,61,7460,24,37,4526.69,8314.02,0.00
2024-12-10 17:39:51,60,7460,23,37,4465.30,8314.68,0.00
2024-12-10 17:39:51,60,7461,23,37,4577.74,8315.00,0.00
2024-12-10 17:39:51,61,7461,24,37,4502.70,8315.02,0.00
2024-12-10 17:39:51,60,7461,24,36,4566.67,8315.03,0.00
2024-12-10 17:39:51,59,7461,23,36,4535.88,8315.68,0.00
2024-12-10 17:39:51,59,7462,23,36,4650.25,8316.00,0.00
2024-12-10 17:39:51,60,7462,24,36,4572.75,8316.02,0.00
2024-12-10 17:39:51,60,7463,24,36,4546.96,8317.00,0.00
2024-12-10 17:39:51,61,7463,25,36,4472.42,8317.02,0.00
2024-12-10 17:39:51,60,7463,25,35,4537.27,8317.03,0.00
2024-12-10 17:39:51,60,7464,25,35,4540.58,8318.00,0.00
2024-12-10 17:39:51,61,7464,26,35,4466.14,8318.02,0.00
2024-12-10 17:39:51,60,7464,25,35,4409.18,8318.65,0.00
2024-12-10 17:39:51,59,7464,24,35,4481.12,8318.70,0.00
2024-12-10 17:39:51,59,7465,24,35,4596.94,8319.00,0.00
2024-12-10 17:39:51,60,7465,24,36,4520.33,8319.02,0.00
2024-12-10 17:39:51,59,7465,24,35,4587.08,8319.03,0.00
2024-12-10 17:39:51,58,7465,23,35,4653.32,8319.19,0.00
2024-12-10 17:39:51,58,7466,23,35,4671.47,8320.00,0.00
2024-12-10 17:39:51,59,7466,24,35,4592.29,8320.02,0.00
2024-12-10 17:39:51,59,7467,24,35,4565.74,8321.00,0.00
2024-12-10 17:39:51,60,7467,25,35,4489.64,8321.02,0.00
2024-12-10 17:39:51,59,7467,25,34,4553.05,8321.03,0.00
2024-12-10 17:39:51,59,7468,25,34,4554.94,8322.00,0.00
2024-12-10 17:39:51,60,7468,25,35,4479.03,8322.02,0.00
2024-12-10 17:39:51,59,7468,24,35,4435.00,8322.86,0.00
2024-12-10 17:39:51,59,7469,24,35,4564.88,8323.00,0.00
2024-12-10 17:39:51,60,7469,25,35,4488.80,8323.02,0.00
2024-12-10 17:39:51,59,7469,25,34,4553.60,8323.03,0.00
2024-12-10 17:39:51,59,7470,25,34,4552.76,8324.00,0.00
2024-12-10 17:39:51,60,7470,25,35,4476.88,8324.02,0.00
2024-12-10 17:39:51,60,7471,25,35,4446.46,8325.00,0.00
2024-12-10 17:39:51,61,7471,25,36,4373.56,8325.02,0.00
2024-12-10 17:39:51,60,7471,25,35,4435.36,8325.03,0.00
2024-12-10 17:39:51,59,7471,24,35,4487.96,8325.03,0.00
2024-12-10 17:39:51,59,7472,24,35,4547.41,8326.00,0.00
2024-12-10 17:39:51,60,7472,24,36,4471.62,8326.02,0.00
2024-12-10 17:39:51,59,7472,23,36,4496.61,8326.03,0.00
2024-12-10 17:39:51,59,7473,23,36,4529.60,8327.00,0.00
2024-12-10 17:39:51,60,7473,24,36,4454.11,8327.02,0.00
2024-12-10 17:39:51,59,7473,24,35,4516.91,8327.03,0.00
2024-12-10 17:39:51,58,7473,23,35,4484.53,8327.67,0.00
2024-12-10 17:39:51,58,7474,23,35,4601.07,8328.00,0.00
2024-12-10 17:39:51,59,7474,24,35,4523.09,8328.02,0.00
2024-12-10 17:39:51,58,7474,23,35,4525.10,8328.36,0.00
2024-12-10 17:39:51,58,7475,23,35,4615.99,8329.00,0.00
2024-12-10 17:39:51,59,7475,23,36,4537.75,8329.02,0.00
2024-12-10 17:39:51,58,7475,23,35,4604.51,8329.03,0.00
2024-12-10 17:39:51,58,7476,23,35,4610.80,8330.00,0.00
2024-12-10 17:39:51,59,7476,23,36,4532.65,8330.02,0.00
2024-12-10 17:39:51,59,7477,23,36,4507.78,8331.00,0.00
2024-12-10 17:39:51,60,7477,24,36,4432.65,8331.02,0.00
2024-12-10 17:39:51,59,7477,24,35,4497.90,8331.03,0.00
2024-12-10 17:39:51,59,7478,24,35,4502.67,8332.00,0.00
2024-12-10 17:39:51,60,7478,24,36,4427.62,8332.02,0.00
2024-12-10 17:39:51,59,7478,24,35,4465.41,8332.12,0.00
2024-12-10 17:39:51,59,7479,24,35,4478.38,8333.00,0.00
2024-12-10 17:39:51,60,7479,25,35,4403.74,8333.02,0.00
2024-12-10 17:39:51,59,7479,25,34,4465.68,8333.05,0.00
2024-12-10 17:39:51,59,7480,25,34,4471.86,8334.00,0.00
2024-12-10 17:39:51,60,7480,25,35,4397.33,8334.02,0.00
2024-12-10 17:39:52,60,7481,25,35,4371.72,8335.00,0.00
2024-12-10 17:39:52,61,7481,26,35,4300.06,8335.02,0.00
2024-12-10 17:39:52,60,7481,26,34,4360.62,8335.05,0.00
2024-12-10 17:39:52,59,7481,25,34,4396.21,8335.32,0.00
2024-12-10 17:39:52,59,7482,25,34,4481.41,8336.00,0.00
2024-12-10 17:39:52,60,7482,25,35,4406.72,8336.02,0.00
2024-12-10 17:39:52,60,7483,25,35,4382.04,8337.00,0.00
2024-12-10 17:39:52,61,7483,26,35,4310.20,8337.02,0.00
2024-12-10 17:39:52,60,7483,26,34,4369.54,8337.07,0.00
2024-12-10 17:39:52,59,7483,25,34,4391.60,8337.68,0.00
2024-12-10 17:39:52,59,7484,25,34,4449.78,8338.00,0.00
2024-12-10 17:39:52,60,7484,26,34,4375.61,8338.02,0.00
2024-12-10 17:39:52,60,7485,26,34,4351.17,8339.00,0.00
2024-12-10 17:39:52,61,7485,26,35,4279.84,8339.02,0.00
2024-12-10 17:39:52,60,7485,26,34,4338.67,8339.07,0.00
2024-12-10 17:39:52,60,7486,26,34,4344.74,8340.00,0.00
2024-12-10 17:39:52,61,7486,27,34,4273.52,8340.02,0.00
2024-12-10 17:39:52,61,7487,27,34,4249.11,8341.00,0.00
2024-12-10 17:39:52,62,7487,27,35,4180.58,8341.02,0.00
2024-12-10 17:39:52,61,7487,27,34,4238.18,8341.07,0.00
2024-12-10 17:39:52,61,7488,27,34,4242.78,8342.00,0.00
2024-12-10 17:39:52,62,7488,27,35,4174.35,8342.02,0.00
2024-12-10 17:39:52,61,7488,26,35,4114.48,8342.62,0.00
2024-12-10 17:39:52,60,7488,25,35,4181.62,8342.65,0.00
2024-12-10 17:39:52,60,7489,25,35,4291.72,8343.00,0.00
2024-12-10 17:39:52,61,7489,25,36,4221.36,8343.02,0.00
2024-12-10 17:39:52,60,7489,25,35,4281.99,8343.07,0.00
2024-12-10 17:39:52,59,7489,24,35,4343.30,8343.20,0.00
2024-12-10 17:39:52,59,7490,24,35,4362.15,8344.00,0.00
2024-12-10 17:39:52,60,7490,24,36,4289.45,8344.02,0.00
2024-12-10 17:39:52,59,7490,23,36,4273.08,8344.15,0.00
2024-12-10 17:39:52,59,7491,23,36,4344.29,8345.00,0.00
2024-12-10 17:39:52,60,7491,23,37,4271.88,8345.02,0.00
2024-12-10 17:39:52,59,7491,22,37,4324.49,8345.03,0.00
2024-12-10 17:39:52,59,7492,22,37,4357.54,8346.00,0.00
2024-12-10 17:39:52,60,7492,23,37,4284.91,8346.02,0.00
2024-12-10 17:39:52,60,7493,23,37,4271.12,8347.00,0.00
2024-12-10 17:39:52,61,7493,23,38,4201.10,8347.02,0.00
2024-12-10 17:39:52,60,7493,23,37,4240.54,8347.15,0.00
2024-12-10 17:39:52,60,7494,23,37,4253.54,8348.00,0.00
2024-12-10 17:39:52,61,7494,24,37,4183.81,8348.02,0.00
2024-12-10 17:39:52,61,7495,24,37,4172.11,8349.00,0.00
2024-12-10 17:39:52,62,7495,25,37,4104.82,8349.02,0.00
2024-12-10 17:39:52,61,7495,25,36,4137.92,8349.16,0.00
2024-12-10 17:39:52,61,7496,25,36,4150.71,8350.00,0.00
2024-12-10 17:39:52,62,7496,25,37,4083.76,8350.02,0.00
2024-12-10 17:39:52,62,7497,25,37,4073.11,8351.00,0.00
2024-12-10 17:39:52,63,7497,25,38,4008.45,8351.02,0.00
2024-12-10 17:39:52,62,7497,25,37,4069.07,8351.05,0.00
2024-12-10 17:39:52,61,7497,25,36,4104.31,8351.15,0.00
2024-12-10 17:39:52,60,7497,24,36,4062.19,8351.97,0.00
2024-12-10 17:39:52,60,7498,24,36,4198.62,8352.00,0.00
2024-12-10 17:39:52,61,7498,24,37,4129.79,8352.02,0.00
2024-12-10 17:39:52,60,7498,23,37,4114.23,8352.68,0.00
2024-12-10 17:39:52,59,7498,22,37,4172.89,8352.75,0.00
2024-12-10 17:39:52,59,7499,22,37,4293.40,8353.00,0.00
2024-12-10 17:39:52,60,7499,22,38,4221.85,8353.02,0.00
2024-12-10 17:39:52,59,7499,22,37,4259.45,8353.15,0.00
2024-12-10 17:39:52,59,7500,22,37,4274.10,8354.00,0.00
2024-12-10 17:39:52,60,7500,22,38,4202.86,8354.02,0.00
2024-12-10 17:39:52,60,7501,22,38,4192.11,8355.00,0.00
2024-12-10 17:39:52,61,7501,23,38,4123.39,8355.02,0.00
2024-12-10 17:39:52,60,7501,23,37,4160.10,8355.15,0.00
2024-12-10 17:39:52,59,7501,22,37,4157.68,8355.78,0.00
2024-12-10 17:39:52,59,7502,22,37,4281.08,8356.00,0.00
2024-12-10 17:39:52,60,7502,23,37,4209.73,8356.02,0.00
2024-12-10 17:39:52,59,7502,23,36,4272.59,8356.10,0.00
2024-12-10 17:39:52,58,7502,22,36,4258.48,8356.45,0.00
2024-12-10 17:39:52,58,7503,22,36,4356.85,8357.00,0.00
2024-12-10 17:39:52,59,7503,23,36,4283.00,8357.02,0.00
2024-12-10 17:39:52,58,7503,23,35,4326.61,8357.14,0.00
2024-12-10 17:39:52,57,7503,22,35,4354.41,8357.70,0.00
2024-12-10 17:39:52,57,7504,22,35,4417.69,8358.00,0.00
2024-12-10 17:39:52,58,7504,22,36,4341.52,8358.02,0.00
2024-12-10 17:39:52,58,7505,22,36,4329.77,8359.00,0.00
2024-12-10 17:39:52,59,7505,23,36,4256.38,8359.02,0.00
2024-12-10 17:39:52,58,7505,23,35,4300.96,8359.14,0.00
2024-12-10 17:39:52,58,7506,23,35,4315.87,8360.00,0.00
2024-12-10 17:39:52,59,7506,24,35,4242.72,8360.02,0.00
2024-12-10 17:39:52,58,7506,23,35,4312.99,8360.03,0.00
2024-12-10 17:39:52,57,7506,22,35,4322.71,8360.30,0.00
2024-12-10 17:39:52,56,7506,21,35,4369.09,8360.66,0.00
2024-12-10 17:39:52,56,7507,21,35,4490.29,8361.00,0.00
2024-12-10 17:39:52,57,7507,22,35,4411.51,8361.02,0.00
2024-12-10 17:39:52,56,7507,22,34,4455.96,8361.14,0.00
2024-12-10 17:39:52,55,7507,21,34,4536.98,8361.15,0.00
2024-12-10 17:39:52,55,7508,21,34,4557.27,8362.00,0.00
2024-12-10 17:39:52,56,7508,21,35,4475.89,8362.02,0.00
2024-12-10 17:39:52,55,7508,21,34,4523.83,8362.09,0.00
2024-12-10 17:39:52,54,7508,20,34,4565.87,8362.33,0.00
2024-12-10 17:39:53,54,7509,20,34,4665.45,8363.00,0.00
2024-12-10 17:39:53,55,7509,20,35,4580.63,8363.02,0.00
2024-12-10 17:39:53,54,7509,19,35,4663.90,8363.02,0.00
2024-12-10 17:39:53,53,7509,18,35,4710.89,8363.13,0.00
2024-12-10 17:39:53,52,7509,17,35,4780.61,8363.23,0.00
2024-12-10 17:39:53,52,7510,17,35,4877.64,8364.00,0.00
2024-12-10 17:39:53,53,7510,17,36,4785.61,8364.02,0.00
2024-12-10 17:39:53,52,7510,17,35,4840.65,8364.12,0.00
2024-12-10 17:39:53,51,7510,16,35,4932.30,8364.14,0.00
2024-12-10 17:39:53,51,7511,16,35,5024.72,8365.00,0.00
2024-12-10 17:39:53,52,7511,16,36,4928.09,8365.02,0.00
2024-12-10 17:39:53,52,7512,16,36,4919.95,8366.00,0.00
2024-12-10 17:39:53,53,7512,17,36,4827.12,8366.02,0.00
2024-12-10 17:39:53,52,7512,17,35,4882.95,8366.12,0.00
2024-12-10 17:39:53,51,7512,16,35,4954.82,8366.18,0.00
2024-12-10 17:39:53,51,7513,16,35,5050.53,8367.00,0.00
2024-12-10 17:39:53,52,7513,16,36,4953.41,8367.02,0.00
2024-12-10 17:39:53,51,7513,15,36,5043.84,8367.10,0.00
2024-12-10 17:39:53,51,7514,15,36,5046.34,8368.00,0.00
2024-12-10 17:39:53,52,7514,16,36,4949.29,8368.02,0.00
2024-12-10 17:39:53,51,7514,16,35,5005.33,8368.12,0.00
2024-12-10 17:39:53,51,7515,16,35,5030.53,8369.00,0.00
2024-12-10 17:39:53,52,7515,17,35,4933.79,8369.02,0.00
2024-12-10 17:39:53,52,7516,17,35,4927.10,8370.00,0.00
2024-12-10 17:39:53,53,7516,17,36,4834.13,8370.02,0.00
2024-12-10 17:39:53,52,7516,17,35,4888.48,8370.12,0.00
2024-12-10 17:39:53,52,7517,17,35,4911.59,8371.00,0.00
2024-12-10 17:39:53,53,7517,18,35,4818.92,8371.02,0.00
2024-12-10 17:39:53,53,7518,18,35,4814.27,8372.00,0.00
2024-12-10 17:39:53,54,7518,18,36,4725.12,8372.02,0.00
2024-12-10 17:39:53,53,7518,18,35,4812.69,8372.02,0.00
2024-12-10 17:39:53,52,7518,17,35,4896.08,8372.08,0.00
2024-12-10 17:39:53,51,7518,17,34,4957.61,8372.08,0.00
2024-12-10 17:39:53,51,7519,17,34,5045.21,8373.00,0.00
2024-12-10 17:39:53,52,7519,18,34,4948.19,8373.02,0.00
2024-12-10 17:39:53,51,7519,18,33,5043.57,8373.02,0.00
2024-12-10 17:39:53,51,7520,18,33,5040.08,8374.00,0.00
2024-12-10 17:39:53,52,7520,19,33,4943.15,8374.02,0.00
2024-12-10 17:39:53,51,7520,19,32,5038.43,8374.02,0.00
2024-12-10 17:39:53,50,7520,19,31,5102.36,8374.04,0.00
2024-12-10 17:39:53,50,7521,19,31,5123.07,8375.00,0.00
2024-12-10 17:39:53,51,7521,20,31,5022.61,8375.02,0.00
2024-12-10 17:39:53,51,7522,20,31,5021.07,8376.00,0.00
2024-12-10 17:39:53,52,7522,21,31,4924.51,8376.02,0.00
2024-12-10 17:39:53,51,7522,20,31,4926.68,8376.49,0.00
2024-12-10 17:39:53,51,7523,20,31,5048.58,8377.00,0.00
2024-12-10 17:39:53,52,7523,20,32,4951.49,8377.02,0.00
2024-12-10 17:39:53,51,7523,20,31,5042.01,8377.04,0.00
2024-12-10 17:39:53,50,7523,19,31,5073.66,8377.66,0.00
2024-12-10 17:39:53,50,7524,19,31,5212.99,8378.00,0.00
2024-12-10 17:39:53,51,7524,20,31,5110.78,8378.02,0.00
2024-12-10 17:39:53,51,7525,20,31,5108.20,8379.00,0.00
2024-12-10 17:39:53,52,7525,21,31,5009.96,8379.02,0.00
2024-12-10 17:39:53,52,7526,21,31,4992.83,8380.00,0.00
2024-12-10 17:39:53,53,7526,22,31,4898.63,8380.02,0.00
2024-12-10 17:39:53,52,7526,22,30,4984.78,8380.06,0.00
2024-12-10 17:39:53,52,7527,22,30,5003.10,8381.00,0.00
2024-12-10 17:39:53,53,7527,22,31,4908.70,8381.02,0.00
2024-12-10 17:39:53,52,7527,21,31,4946.73,8381.15,0.00
2024-12-10 17:39:53,52,7528,21,31,5037.55,8382.00,0.00
2024-12-10 17:39:53,53,7528,21,32,4942.50,8382.02,0.00
2024-12-10 17:39:53,53,7529,21,32,4924.11,8383.00,0.00
2024-12-10 17:39:53,54,7529,21,33,4832.92,8383.02,0.00
2024-12-10 17:39:53,53,7529,21,32,4922.53,8383.02,0.00
2024-12-10 17:39:53,52,7529,21,31,5010.76,8383.06,0.00
2024-12-10 17:39:53,51,7529,20,31,5097.52,8383.10,0.00
2024-12-10 17:39:53,51,7530,20,31,5186.86,8384.00,0.00
2024-12-10 17:39:53,52,7530,21,31,5087.12,8384.02,0.00
2024-12-10 17:39:53,53,7529,22,31,4858.83,8384.60,0.00
2024-12-10 17:39:53,53,7530,22,31,5017.36,8385.00,0.00
2024-12-10 17:39:53,54,7530,23,31,4924.44,8385.02,0.00
2024-12-10 17:39:53,53,7530,23,30,4980.99,8385.06,0.00
2024-12-10 17:39:53,52,7530,22,30,5047.46,8385.14,0.00
2024-12-10 17:39:53,52,7531,22,30,5297.98,8386.00,0.00
2024-12-10 17:39:53,53,7531,22,31,5198.02,8386.02,0.00
2024-12-10 17:39:53,52,7531,21,31,5228.08,8386.46,0.00
2024-12-10 17:39:53,52,7532,21,31,5286.96,8387.00,0.00
2024-12-10 17:39:53,53,7532,21,32,5187.21,8387.02,0.00
2024-12-10 17:39:53,52,7532,21,31,5251.49,8387.06,0.00
2024-12-10 17:39:53,52,7533,21,31,5269.85,8388.00,0.00
2024-12-10 17:39:53,53,7533,21,32,5170.42,8388.02,0.00
2024-12-10 17:39:53,52,7533,20,32,5123.23,8388.96,0.00
2024-12-10 17:39:53,52,7534,20,32,5281.35,8389.00,0.00
2024-12-10 17:39:53,53,7534,21,32,5181.70,8389.02,0.00
2024-12-10 17:39:53,52,7534,21,31,5244.25,8389.06,0.00
2024-12-10 17:39:53,51,7534,20,31,5312.49,8389.47,0.00
2024-12-10 17:39:53,51,7535,20,31,5367.18,8390.00,0.00
2024-12-10 17:39:53,52,7535,21,31,5263.97,8390.02,0.00
2024-12-10 17:39:53,52,7536,21,31,5250.38,8391.00,0.00
2024-12-10 17:39:53,53,7536,21,32,5151.32,8391.02,0.00
2024-12-10 17:39:53,52,7536,21,31,5214.89,8391.06,0.00
2024-12-10 17:39:54,52,7537,21,31,5233.25,8392.00,0.00
2024-12-10 17:39:54,53,7537,22,31,5134.51,8392.02,0.00
2024-12-10 17:39:54,52,7537,21,31,5105.96,8392.87,0.00
2024-12-10 17:39:54,52,7538,21,31,5256.17,8393.00,0.00
2024-12-10 17:39:54,53,7538,21,32,5156.99,8393.02,0.00
2024-12-10 17:39:54,52,7538,21,31,5220.67,8393.06,0.00
2024-12-10 17:39:54,52,7539,21,31,5239.04,8394.00,0.00
2024-12-10 17:39:54,53,7539,21,32,5140.19,8394.02,0.00
2024-12-10 17:39:54,53,7540,21,32,5127.26,8395.00,0.00
2024-12-10 17:39:54,54,7540,22,32,5032.31,8395.02,0.00
2024-12-10 17:39:54,53,7540,22,31,5092.42,8395.06,0.00
2024-12-10 17:39:54,52,7540,21,31,5123.81,8395.71,0.00
2024-12-10 17:39:54,52,7541,21,31,5261.27,8396.00,0.00
2024-12-10 17:39:54,53,7541,21,32,5162.01,8396.02,0.00
2024-12-10 17:39:54,53,7542,21,32,5142.03,8397.00,0.00
2024-12-10 17:39:54,54,7542,21,33,5046.81,8397.02,0.00
2024-12-10 17:39:54,53,7542,21,32,5107.18,8397.06,0.00
2024-12-10 17:39:54,53,7543,21,32,5110.01,8398.00,0.00
2024-12-10 17:39:54,54,7543,21,33,5015.38,8398.02,0.00
2024-12-10 17:39:54,54,7544,21,33,4987.67,8399.00,0.00
2024-12-10 17:39:54,55,7544,22,33,4896.98,8399.02,0.00
2024-12-10 17:39:54,54,7544,22,32,4951.90,8399.06,0.00
2024-12-10 17:39:54,53,7544,21,32,4989.92,8399.28,0.00
2024-12-10 17:39:54,53,7545,21,32,5067.94,8400.00,0.00
2024-12-10 17:39:54,54,7545,22,32,4974.09,8400.02,0.00
2024-12-10 17:39:54,54,7546,22,32,4942.08,8401.00,0.00
2024-12-10 17:39:54,55,7546,22,33,4852.22,8401.02,0.00
2024-12-10 17:39:54,54,7546,22,32,4906.30,8401.06,0.00
2024-12-10 17:39:54,54,7547,22,32,4896.96,8402.00,0.00
2024-12-10 17:39:54,55,7547,23,32,4807.93,8402.02,0.00
2024-12-10 17:39:54,54,7547,22,32,4744.21,8402.89,0.00
2024-12-10 17:39:54,54,7548,22,32,4890.57,8403.00,0.00
2024-12-10 17:39:54,55,7548,22,33,4801.65,8403.02,0.00
2024-12-10 17:39:54,54,7548,22,32,4856.34,8403.06,0.00
2024-12-10 17:39:54,53,7548,21,32,4843.60,8403.60,0.00
2024-12-10 17:39:54,54,7547,22,32,4750.83,8403.67,0.00
2024-12-10 17:39:54,54,7548,22,32,4939.66,8404.00,0.00
2024-12-10 17:39:54,55,7548,22,33,4849.84,8404.02,0.00
2024-12-10 17:39:54,55,7549,22,33,4974.32,8405.00,0.00
2024-12-10 17:39:54,56,7549,23,33,4885.49,8405.02,0.00
2024-12-10 17:39:54,55,7549,23,32,4942.23,8405.06,0.00
2024-12-10 17:39:54,55,7550,23,32,4940.98,8406.00,0.00
2024-12-10 17:39:54,56,7550,23,33,4852.75,8406.02,0.00
2024-12-10 17:39:54,56,7551,23,33,4830.18,8407.00,0.00
2024-12-10 17:39:54,57,7551,24,33,4745.44,8407.02,0.00
2024-12-10 17:39:54,56,7551,24,32,4800.16,8407.05,0.00
2024-12-10 17:39:54,55,7551,23,32,4885.92,8407.07,0.00
2024-12-10 17:39:54,54,7551,22,32,4856.87,8407.69,0.00
2024-12-10 17:39:54,54,7552,22,32,4985.08,8408.00,0.00
2024-12-10 17:39:54,55,7552,22,33,4894.44,8408.02,0.00
2024-12-10 17:39:54,54,7552,21,33,4909.70,8408.54,0.00
2024-12-10 17:39:54,54,7553,21,33,4973.88,8409.00,0.00
2024-12-10 17:39:54,55,7553,22,33,4883.45,8409.02,0.00
2024-12-10 17:39:54,54,7553,22,32,4944.30,8409.06,0.00
2024-12-10 17:39:54,54,7554,22,32,4958.90,8410.00,0.00
2024-12-10 17:39:54,55,7554,23,32,4868.74,8410.02,0.00
2024-12-10 17:39:54,55,7555,23,32,4857.51,8411.00,0.00
2024-12-10 17:39:54,56,7555,24,32,4770.77,8411.02,0.00
2024-12-10 17:39:54,55,7555,24,31,4828.46,8411.06,0.00
2024-12-10 17:39:54,55,7556,24,31,4841.27,8412.00,0.00
2024-12-10 17:39:54,56,7556,25,31,4754.81,8412.02,0.00
2024-12-10 17:39:54,55,7556,24,31,4766.12,8412.55,0.00
2024-12-10 17:39:54,55,7557,24,31,4832.28,8413.00,0.00
2024-12-10 17:39:54,56,7557,25,31,4745.98,8413.02,0.00
2024-12-10 17:39:54,55,7557,25,30,4801.69,8413.06,0.00
2024-12-10 17:39:54,55,7558,25,30,4814.49,8414.00,0.00
2024-12-10 17:39:54,56,7558,26,30,4728.52,8414.02,0.00
2024-12-10 17:39:54,56,7559,26,30,4717.23,8415.00,0.00
2024-12-10 17:39:54,57,7559,27,30,4634.47,8415.02,0.00
2024-12-10 17:39:54,56,7559,27,29,4688.69,8415.05,0.00
2024-12-10 17:39:54,56,7560,27,29,4699.76,8416.00,0.00
2024-12-10 17:39:54,57,7560,28,29,4617.31,8416.02,0.00
2024-12-10 17:39:54,56,7560,27,29,4593.11,8416.41,0.00
2024-12-10 17:39:54,56,7561,27,29,4694.07,8417.00,0.00
2024-12-10 17:39:54,57,7561,27,30,4611.71,8417.02,0.00
2024-12-10 17:39:54,56,7561,27,29,4667.01,8417.05,0.00
2024-12-10 17:39:54,55,7561,26,29,4748.82,8417.09,0.00
2024-12-10 17:39:54,55,7562,26,29,4760.75,8418.00,0.00
2024-12-10 17:39:54,56,7562,26,30,4675.73,8418.02,0.00
2024-12-10 17:39:54,56,7563,26,30,4654.87,8419.00,0.00
2024-12-10 17:39:54,57,7563,27,30,4573.20,8419.02,0.00
2024-12-10 17:39:54,56,7563,27,29,4629.31,8419.05,0.00
2024-12-10 17:39:54,55,7563,26,29,4589.20,8419.96,0.00
2024-12-10 17:39:54,55,7564,26,29,4739.24,8420.00,0.00
2024-12-10 17:39:54,56,7564,27,29,4654.61,8420.02,0.00
2024-12-10 17:39:54,56,7565,27,29,4629.06,8421.00,0.00
2024-12-10 17:39:54,57,7565,28,29,4547.84,8421.02,0.00
2024-12-10 17:39:54,56,7565,27,29,4627.55,8421.02,0.00
2024-12-10 17:39:54,55,7565,27,28,4688.72,8421.04,0.00
2024-12-10 17:39:54,54,7565,26,28,4774.00,8421.06,0.00
2024-12-10 17:39:54,54,7566,26,28,4773.74,8422.00,0.00
2024-12-10 17:39:54,55,7566,27,28,4686.94,8422.02,0.00
2024-12-10 17:39:54,54,7566,26,28,4661.64,8422.44,0.00
2024-12-10 17:39:55,54,7567,26,28,4754.82,8423.00,0.00
2024-12-10 17:39:55,55,7567,27,28,4668.37,8423.02,0.00
2024-12-10 17:39:55,54,7567,26,28,4753.26,8423.02,0.00
2024-12-10 17:39:55,53,7567,26,27,4817.52,8423.02,0.00
2024-12-10 17:39:55,53,7568,26,27,4813.44,8424.00,0.00
2024-12-10 17:39:55,54,7568,26,28,4724.30,8424.02,0.00
2024-12-10 17:39:55,54,7569,26,28,4724.62,8425.00,0.00
2024-12-10 17:39:55,55,7569,26,29,4638.72,8425.02,0.00
2024-12-10 17:39:55,54,7569,25,29,4633.47,8425.63,0.00
2024-12-10 17:39:55,54,7570,25,29,4710.27,8426.00,0.00
2024-12-10 17:39:55,55,7570,26,29,4624.63,8426.02,0.00
2024-12-10 17:39:55,54,7570,26,28,4680.62,8426.02,0.00
2024-12-10 17:39:55,53,7570,25,28,4725.09,8426.53,0.00
2024-12-10 17:39:55,53,7571,25,28,4781.05,8427.00,0.00
2024-12-10 17:39:55,54,7571,26,28,4692.52,8427.02,0.00
2024-12-10 17:39:55,53,7571,25,28,4734.98,8427.13,0.00
2024-12-10 17:39:55,53,7572,25,28,4821.38,8428.00,0.00
2024-12-10 17:39:55,54,7572,26,28,4732.09,8428.02,0.00
2024-12-10 17:39:55,53,7572,26,27,4795.93,8428.02,0.00
2024-12-10 17:39:55,53,7573,26,27,4809.23,8429.00,0.00
2024-12-10 17:39:55,54,7573,26,28,4720.17,8429.02,0.00
2024-12-10 17:39:55,54,7574,26,28,4708.46,8430.00,0.00
2024-12-10 17:39:55,55,7574,27,28,4622.85,8430.02,0.00
2024-12-10 17:39:55,54,7574,27,27,4685.05,8430.02,0.00
2024-12-10 17:39:55,54,7575,27,27,4696.53,8431.00,0.00
2024-12-10 17:39:55,55,7575,28,27,4611.14,8431.02,0.00
2024-12-10 17:39:55,54,7575,27,27,4659.88,8431.04,0.00
2024-12-10 17:39:55,54,7576,27,27,4735.38,8432.00,0.00
2024-12-10 17:39:55,55,7576,27,28,4649.28,8432.02,0.00
2024-12-10 17:39:55,54,7576,27,27,4713.52,8432.02,0.00
2024-12-10 17:39:55,54,7577,27,27,4721.63,8433.00,0.00
2024-12-10 17:39:55,55,7577,27,28,4635.79,8433.02,0.00
2024-12-10 17:39:55,54,7577,26,28,4642.72,8433.52,0.00
2024-12-10 17:39:55,54,7578,26,28,4704.79,8434.00,0.00
2024-12-10 17:39:55,55,7578,27,28,4619.25,8434.02,0.00
2024-12-10 17:39:55,54,7578,27,27,4682.93,8434.02,0.00
2024-12-10 17:39:55,53,7578,26,27,4720.73,8434.53,0.00
2024-12-10 17:39:55,52,7578,25,27,4804.16,8434.58,0.00
2024-12-10 17:39:55,51,7578,24,27,4883.38,8434.77,0.00
2024-12-10 17:39:55,51,7579,24,27,5029.10,8435.00,0.00
2024-12-10 17:39:55,52,7579,24,28,4932.39,8435.02,0.00
2024-12-10 17:39:55,52,7580,24,28,4911.15,8436.00,0.00
2024-12-10 17:39:55,53,7580,25,28,4818.49,8436.02,0.00
2024-12-10 17:39:55,52,7580,25,27,4885.20,8436.04,0.00
2024-12-10 17:39:55,51,7580,24,27,4867.33,8436.92,0.00
2024-12-10 17:39:55,51,7581,24,27,5026.21,8437.00,0.00
2024-12-10 17:39:55,52,7581,24,28,4929.55,8437.02,0.00
2024-12-10 17:39:55,51,7581,23,28,4876.71,8437.57,0.00
2024-12-10 17:39:55,51,7582,23,28,5006.08,8438.00,0.00
2024-12-10 17:39:55,52,7582,23,29,4909.81,8438.02,0.00
2024-12-10 17:39:55,51,7582,22,29,5003.97,8438.04,0.00
2024-12-10 17:39:55,50,7582,22,28,5078.73,8438.04,0.00
2024-12-10 17:39:55,49,7582,21,28,5100.32,8438.39,0.00
2024-12-10 17:39:55,49,7583,21,28,5221.32,8439.00,0.00
2024-12-10 17:39:55,50,7583,21,29,5116.89,8439.02,0.00
2024-12-10 17:39:55,49,7583,20,29,5159.32,8439.04,0.00
2024-12-10 17:39:55,49,7583,20,29,5211.20,8440.00,0.00
2024-12-10 17:39:55,50,7583,20,30,5106.98,8440.02,0.00
2024-12-10 17:39:55,49,7583,19,30,5149.20,8440.04,0.00
2024-12-10 17:39:55,48,7583,19,29,5223.07,8440.06,0.00
2024-12-10 17:39:55,48,7584,19,29,5317.26,8441.00,0.00
2024-12-10 17:39:55,49,7584,19,30,5208.74,8441.02,0.00
2024-12-10 17:39:55,49,7585,19,30,5202.11,8442.00,0.00
2024-12-10 17:39:55,50,7585,20,30,5098.07,8442.02,0.00
2024-12-10 17:39:55,49,7585,20,29,5164.22,8442.06,0.00
2024-12-10 17:39:55,49,7586,20,29,5188.94,8443.00,0.00
2024-12-10 17:39:55,50,7586,21,29,5085.17,8443.02,0.00
2024-12-10 17:39:55,49,7586,21,28,5152.51,8443.06,0.00
2024-12-10 17:39:55,49,7587,21,28,5177.24,8444.00,0.00
2024-12-10 17:39:55,50,7587,22,28,5073.69,8444.02,0.00
2024-12-10 17:39:55,50,7588,22,28,5067.65,8445.00,0.00
2024-12-10 17:39:55,51,7588,22,29,4968.28,8445.02,0.00
2024-12-10 17:39:55,50,7588,22,28,5032.19,8445.06,0.00
2024-12-10 17:39:55,50,7589,22,28,5054.74,8446.00,0.00
2024-12-10 17:39:55,51,7589,23,28,4955.62,8446.02,0.00
2024-12-10 17:39:55,51,7590,23,28,4951.38,8447.00,0.00
2024-12-10 17:39:55,52,7590,23,29,4856.16,8447.02,0.00
2024-12-10 17:39:55,51,7590,23,28,4914.95,8447.06,0.00
2024-12-10 17:39:55,51,7591,23,28,4935.40,8448.00,0.00
2024-12-10 17:39:55,52,7591,23,29,4840.49,8448.02,0.00
2024-12-10 17:39:55,51,7591,22,29,4857.51,8448.55,0.00
2024-12-10 17:39:55,51,7592,22,29,4985.41,8449.00,0.00
2024-12-10 17:39:55,52,7592,22,30,4889.54,8449.02,0.00
2024-12-10 17:39:55,51,7592,22,29,4950.63,8449.06,0.00
2024-12-10 17:39:55,51,7593,22,29,4971.09,8450.00,0.00
2024-12-10 17:39:55,52,7593,23,29,4875.49,8450.02,0.00
2024-12-10 17:39:55,52,7594,23,29,4869.06,8451.00,0.00
2024-12-10 17:39:55,53,7594,24,29,4777.19,8451.02,0.00
2024-12-10 17:39:55,52,7594,24,28,4836.57,8451.06,0.00
2024-12-10 17:39:55,52,7595,24,28,4855.01,8452.00,0.00
2024-12-10 17:39:55,53,7595,24,29,4763.41,8452.02,0.00
2024-12-10 17:39:55,52,7595,23,29,4733.30,8452.48,0.00
2024-12-10 17:39:55,52,7596,23,29,4852.33,8453.00,0.00
2024-12-10 17:39:55,53,7596,23,30,4760.78,8453.02,0.00
2024-12-10 17:39:55,52,7596,23,29,4818.20,8453.06,0.00
2024-12-10 17:39:55,51,7596,22,29,4912.68,8453.06,0.00
2024-12-10 17:39:55,50,7596,21,29,4923.35,8453.80,0.00
2024-12-10 17:39:55,50,7597,21,29,5075.65,8454.00,0.00
2024-12-10 17:39:55,51,7597,21,30,4976.13,8454.02,0.00
2024-12-10 17:39:56,50,7597,20,30,4960.86,8454.44,0.00
2024-12-10 17:39:56,50,7598,20,30,5083.02,8455.00,0.00
2024-12-10 17:39:56,51,7598,20,31,4983.35,8455.02,0.00
2024-12-10 17:39:56,50,7598,20,30,5047.51,8455.06,0.00
2024-12-10 17:39:56,49,7598,19,30,5100.58,8455.29,0.00
2024-12-10 17:39:56,49,7599,19,30,5213.25,8456.00,0.00
2024-12-10 17:39:56,50,7599,19,31,5108.99,8456.02,0.00
2024-12-10 17:39:56,49,7599,18,31,5177.01,8456.04,0.00
2024-12-10 17:39:56,49,7600,18,31,5234.58,8457.00,0.00
2024-12-10 17:39:56,50,7600,18,32,5129.89,8457.02,0.00
2024-12-10 17:39:56,49,7600,18,31,5201.79,8457.04,0.00
2024-12-10 17:39:56,49,7601,18,31,5224.84,8458.00,0.00
2024-12-10 17:39:56,50,7601,19,31,5120.34,8458.02,0.00
2024-12-10 17:39:56,49,7601,18,31,5159.22,8458.12,0.00
2024-12-10 17:39:56,49,7602,18,31,5258.20,8459.00,0.00
2024-12-10 17:39:56,50,7602,18,32,5153.04,8459.02,0.00
2024-12-10 17:39:56,49,7602,18,31,5225.41,8459.04,0.00
2024-12-10 17:39:56,49,7603,18,31,5248.47,8460.00,0.00
2024-12-10 17:39:56,50,7603,19,31,5143.50,8460.02,0.00
2024-12-10 17:39:56,50,7604,19,31,5134.27,8461.00,0.00
2024-12-10 17:39:56,51,7604,20,31,5033.60,8461.02,0.00
2024-12-10 17:39:56,50,7604,20,30,5103.81,8461.04,0.00
2024-12-10 17:39:56,50,7605,20,30,5124.73,8462.00,0.00
2024-12-10 17:39:56,51,7605,21,30,5024.24,8462.02,0.00
2024-12-10 17:39:56,51,7606,21,30,5014.50,8463.00,0.00
2024-12-10 17:39:56,52,7606,22,30,4918.07,8463.02,0.00
2024-12-10 17:39:56,51,7606,22,29,4986.30,8463.04,0.00
2024-12-10 17:39:56,50,7606,21,29,4990.13,8463.46,0.00
2024-12-10 17:39:56,50,7607,21,29,5114.09,8464.00,0.00
2024-12-10 17:39:56,51,7607,21,30,5013.81,8464.02,0.00
2024-12-10 17:39:56,51,7608,21,30,5006.09,8465.00,0.00
2024-12-10 17:39:56,52,7608,22,30,4909.82,8465.02,0.00
2024-12-10 17:39:56,51,7608,22,29,4976.21,8465.04,0.00
2024-12-10 17:39:56,51,7609,22,29,4995.06,8466.00,0.00
2024-12-10 17:39:56,52,7609,23,29,4899.00,8466.02,0.00
2024-12-10 17:39:56,51,7609,22,29,4920.44,8466.24,0.00
2024-12-10 17:39:56,50,7609,21,29,4985.21,8466.62,0.00
2024-12-10 17:39:56,50,7610,21,29,5122.66,8467.00,0.00
2024-12-10 17:39:56,51,7610,22,29,5022.22,8467.02,0.00
2024-12-10 17:39:56,50,7610,22,28,5092.18,8467.04,0.00
2024-12-10 17:39:56,50,7611,22,28,5113.10,8468.00,0.00
2024-12-10 17:39:56,51,7611,23,28,5012.85,8468.02,0.00
2024-12-10 17:39:56,50,7611,22,28,5111.41,8468.02,0.00
2024-12-10 17:39:56,50,7612,22,28,5103.11,8469.00,0.00
2024-12-10 17:39:56,51,7612,22,29,5003.05,8469.02,0.00
2024-12-10 17:39:56,50,7612,22,28,5076.01,8469.02,0.00
2024-12-10 17:39:56,50,7613,22,28,5095.24,8470.00,0.00
2024-12-10 17:39:56,51,7613,23,28,4995.34,8470.02,0.00
2024-12-10 17:39:56,51,7614,23,28,4980.84,8471.00,0.00
2024-12-10 17:39:56,52,7614,24,28,4885.05,8471.02,0.00
2024-12-10 17:39:56,51,7614,24,27,4954.26,8471.02,0.00
2024-12-10 17:39:56,51,7615,24,27,4962.85,8472.00,0.00
2024-12-10 17:39:56,52,7615,24,28,4867.41,8472.02,0.00
2024-12-10 17:39:56,51,7615,23,28,4889.86,8472.49,0.00
2024-12-10 17:39:56,51,7616,23,28,4943.60,8473.00,0.00
2024-12-10 17:39:56,52,7616,23,29,4848.53,8473.02,0.00
2024-12-10 17:39:56,51,7616,23,28,4917.02,8473.02,0.00
2024-12-10 17:39:56,51,7617,23,28,4923.29,8474.00,0.00
2024-12-10 17:39:56,52,7617,24,28,4828.61,8474.02,0.00
2024-12-10 17:39:56,51,7617,23,28,4911.46,8474.04,0.00
2024-12-10 17:39:56,51,7618,23,28,4952.74,8475.00,0.00
2024-12-10 17:39:56,52,7618,23,29,4857.50,8475.02,0.00
2024-12-10 17:39:56,52,7619,23,29,4829.56,8476.00,0.00
2024-12-10 17:39:56,53,7619,24,29,4738.44,8476.02,0.00
2024-12-10 17:39:56,52,7619,24,28,4821.44,8476.08,0.00
2024-12-10 17:39:56,52,7620,24,28,4831.00,8477.00,0.00
2024-12-10 17:39:56,53,7620,25,28,4739.85,8477.02,0.00
2024-12-10 17:39:56,53,7621,25,28,4726.38,8478.00,0.00
2024-12-10 17:39:56,54,7621,25,29,4638.85,8478.02,0.00
2024-12-10 17:39:56,53,7621,25,28,4688.01,8478.08,0.00
2024-12-10 17:39:56,52,7621,24,28,4672.82,8478.83,0.00
2024-12-10 17:39:56,52,7622,24,28,4821.31,8479.00,0.00
2024-12-10 17:39:56,53,7622,24,29,4730.34,8479.02,0.00
2024-12-10 17:39:56,52,7622,23,29,4680.24,8479.87,0.00
2024-12-10 17:39:56,52,7623,23,29,4832.00,8480.00,0.00
2024-12-10 17:39:56,53,7623,24,29,4740.83,8480.02,0.00
2024-12-10 17:39:56,52,7623,23,29,4783.08,8480.02,0.00
2024-12-10 17:39:56,52,7624,23,29,4824.88,8481.00,0.00
2024-12-10 17:39:56,53,7624,24,29,4733.84,8481.02,0.00
2024-12-10 17:39:56,52,7624,24,28,4815.11,8481.06,0.00
2024-12-10 17:39:56,52,7625,24,28,4830.57,8482.00,0.00
2024-12-10 17:39:56,53,7625,25,28,4739.42,8482.02,0.00
2024-12-10 17:39:56,52,7625,24,28,4748.99,8482.60,0.00
2024-12-10 17:39:56,52,7626,24,28,4831.61,8483.00,0.00
2024-12-10 17:39:56,53,7626,25,28,4740.45,8483.02,0.00
2024-12-10 17:39:56,53,7627,25,28,4721.80,8484.00,0.00
2024-12-10 17:39:56,54,7627,26,28,4634.36,8484.02,0.00
2024-12-10 17:39:56,53,7627,26,27,4715.41,8484.06,0.00
2024-12-10 17:39:56,53,7628,26,27,4731.96,8485.00,0.00
2024-12-10 17:39:56,54,7628,27,27,4644.33,8485.02,0.00
2024-12-10 17:39:57,54,7629,27,27,4644.26,8486.00,0.00
2024-12-10 17:39:57,55,7629,27,28,4559.82,8486.02,0.00
2024-12-10 17:39:57,55,7630,27,28,4538.75,8487.00,0.00
2024-12-10 17:39:57,56,7630,27,29,4457.70,8487.02,0.00
2024-12-10 17:39:57,55,7630,27,28,4526.42,8487.11,0.00
2024-12-10 17:39:57,55,7631,27,28,4543.92,8488.00,0.00
2024-12-10 17:39:57,56,7631,28,28,4462.78,8488.02,0.00
2024-12-10 17:39:57,55,7631,27,28,4539.30,8488.07,0.00
2024-12-10 17:39:57,54,7631,26,28,4506.60,8488.59,0.00
2024-12-10 17:39:57,54,7632,26,28,4629.49,8489.00,0.00
2024-12-10 17:39:57,55,7632,27,28,4545.31,8489.02,0.00
2024-12-10 17:39:57,54,7632,26,28,4624.99,8489.06,0.00
2024-12-10 17:39:57,53,7632,25,28,4651.58,8489.38,0.00
2024-12-10 17:39:57,53,7633,25,28,4695.24,8490.00,0.00
2024-12-10 17:39:57,54,7633,26,28,4608.29,8490.02,0.00
2024-12-10 17:39:57,53,7633,26,27,4684.05,8490.10,0.00
2024-12-10 17:39:57,53,7634,26,27,4703.80,8491.00,0.00
2024-12-10 17:39:57,54,7634,26,28,4616.70,8491.02,0.00
2024-12-10 17:39:57,54,7635,26,28,4614.01,8492.00,0.00
2024-12-10 17:39:57,55,7635,27,28,4530.12,8492.02,0.00
2024-12-10 17:39:57,55,7636,27,28,4509.03,8493.00,0.00
2024-12-10 17:39:57,56,7636,28,28,4428.52,8493.02,0.00
2024-12-10 17:39:57,55,7636,28,27,4501.33,8493.09,0.00
2024-12-10 17:39:57,54,7636,27,27,4548.80,8493.50,0.00
2024-12-10 17:39:57,54,7637,27,27,4663.94,8494.00,0.00
2024-12-10 17:39:57,55,7637,28,27,4579.14,8494.02,0.00
2024-12-10 17:39:57,54,7637,27,27,4577.72,8494.65,0.00
2024-12-10 17:39:57,54,7638,27,27,4659.89,8495.00,0.00
2024-12-10 17:39:57,55,7638,28,27,4575.16,8495.02,0.00
2024-12-10 17:39:57,54,7638,28,26,4620.58,8495.09,0.00
2024-12-10 17:39:57,54,7639,28,26,4638.41,8496.00,0.00
2024-12-10 17:39:57,55,7639,29,26,4554.08,8496.02,0.00
2024-12-10 17:39:57,55,7640,29,26,4550.41,8497.00,0.00
2024-12-10 17:39:57,56,7640,30,26,4469.15,8497.02,0.00
2024-12-10 17:39:57,55,7640,30,25,4510.25,8497.11,0.00
2024-12-10 17:39:57,55,7641,30,25,4527.77,8498.00,0.00
2024-12-10 17:39:57,56,7641,30,26,4446.91,8498.02,0.00
2024-12-10 17:39:57,56,7642,30,26,4442.37,8499.00,0.00
2024-12-10 17:39:57,57,7642,30,27,4364.43,8499.02,0.00
2024-12-10 17:39:57,56,7642,30,26,4404.44,8499.11,0.00
2024-12-10 17:39:57,56,7643,30,26,4420.12,8500.00,0.00
2024-12-10 17:39:57,57,7643,31,26,4342.58,8500.02,0.00
2024-12-10 17:39:57,56,7643,30,26,4326.15,8500.39,0.00
2024-12-10 17:39:57,56,7644,30,26,4426.72,8501.00,0.00
2024-12-10 17:39:57,57,7644,30,27,4349.05,8501.02,0.00
2024-12-10 17:39:57,56,7644,30,26,4390.29,8501.11,0.00
2024-12-10 17:39:57,56,7645,30,26,4405.98,8502.00,0.00
2024-12-10 17:39:57,57,7645,31,26,4328.68,8502.02,0.00
2024-12-10 17:39:57,57,7646,31,26,4322.45,8503.00,0.00
2024-12-10 17:39:57,58,7646,32,26,4247.93,8503.02,0.00
2024-12-10 17:39:57,57,7646,31,26,4317.08,8503.07,0.00
2024-12-10 17:39:57,56,7646,31,25,4365.33,8503.09,0.00
2024-12-10 17:39:57,56,7647,31,25,4379.50,8504.00,0.00
2024-12-10 17:39:57,57,7647,31,26,4302.66,8504.02,0.00
2024-12-10 17:39:57,57,7648,31,26,4295.51,8505.00,0.00
2024-12-10 17:39:57,58,7648,31,27,4221.45,8505.02,0.00
2024-12-10 17:39:57,57,7648,31,26,4264.18,8505.09,0.00
2024-12-10 17:39:57,56,7648,30,26,4290.48,8505.66,0.00
2024-12-10 17:39:57,55,7648,29,26,4305.47,8505.93,0.00
2024-12-10 17:39:57,55,7649,29,26,4453.99,8506.00,0.00
2024-12-10 17:39:57,56,7649,29,27,4374.45,8506.02,0.00
2024-12-10 17:39:57,55,7649,28,27,4440.56,8506.09,0.00
2024-12-10 17:39:57,55,7650,28,27,4487.47,8507.00,0.00
2024-12-10 17:39:57,56,7650,28,28,4407.34,8507.02,0.00
2024-12-10 17:39:57,55,7650,28,27,4451.90,8507.09,0.00
2024-12-10 17:39:57,54,7650,27,27,4523.34,8507.15,0.00
2024-12-10 17:39:57,54,7651,27,27,4608.92,8508.00,0.00
2024-12-10 17:39:57,55,7651,28,27,4525.12,8508.02,0.00
2024-12-10 17:39:57,55,7652,28,27,4520.53,8509.00,0.00
2024-12-10 17:39:57,56,7652,28,28,4439.80,8509.02,0.00
2024-12-10 17:39:57,55,7652,28,27,4484.95,8509.09,0.00
2024-12-10 17:39:57,55,7653,28,27,4500.94,8510.00,0.00
2024-12-10 17:39:57,56,7653,28,28,4420.57,8510.02,0.00
2024-12-10 17:39:57,55,7653,27,28,4493.91,8510.07,0.00
2024-12-10 17:39:57,55,7654,27,28,4539.31,8511.00,0.00
2024-12-10 17:39:57,56,7654,28,28,4458.25,8511.02,0.00
2024-12-10 17:39:57,55,7654,28,27,4506.81,8511.07,0.00
2024-12-10 17:39:57,54,7654,27,27,4481.78,8511.63,0.00
2024-12-10 17:39:57,54,7655,27,27,4608.15,8512.00,0.00
2024-12-10 17:39:57,55,7655,27,28,4524.36,8512.02,0.00
2024-12-10 17:39:57,55,7656,27,28,4517.98,8513.00,0.00
2024-12-10 17:39:57,56,7656,28,28,4437.30,8513.02,0.00
2024-12-10 17:39:57,55,7656,28,27,4487.02,8513.07,0.00
2024-12-10 17:39:57,55,7657,28,27,4501.48,8514.00,0.00
2024-12-10 17:39:57,56,7657,29,27,4421.09,8514.02,0.00
2024-12-10 17:39:57,55,7657,28,27,4499.93,8514.02,0.00
2024-12-10 17:39:57,55,7658,28,27,4496.11,8515.00,0.00
2024-12-10 17:39:57,56,7658,29,27,4415.82,8515.02,0.00
2024-12-10 17:39:57,55,7658,28,27,4494.56,8515.02,0.00
2024-12-10 17:39:57,54,7658,28,26,4547.84,8515.04,0.00
2024-12-10 17:39:57,54,7659,28,26,4560.98,8516.00,0.00
2024-12-10 17:39:57,55,7659,28,27,4478.06,8516.02,0.00
2024-12-10 17:39:58,55,7660,28,27,4471.65,8517.00,0.00
2024-12-10 17:39:58,56,7660,28,28,4391.80,8517.02,0.00
2024-12-10 17:39:58,55,7660,28,27,4443.78,8517.04,0.00
2024-12-10 17:39:58,54,7660,27,27,4404.30,8517.96,0.00
2024-12-10 17:39:58,54,7661,27,27,4558.90,8518.00,0.00
2024-12-10 17:39:58,55,7661,27,28,4476.01,8518.02,0.00
2024-12-10 17:39:58,54,7661,26,28,4487.99,8518.24,0.00
2024-12-10 17:39:58,54,7662,26,28,4581.52,8519.00,0.00
2024-12-10 17:39:58,55,7662,27,28,4498.22,8519.02,0.00
2024-12-10 17:39:58,54,7662,27,27,4554.70,8519.04,0.00
2024-12-10 17:39:58,53,7662,26,27,4569.25,8519.30,0.00
2024-12-10 17:39:58,53,7663,26,27,4670.96,8520.00,0.00
2024-12-10 17:39:58,54,7663,27,27,4584.46,8520.02,0.00
2024-12-10 17:39:58,53,7663,26,27,4548.86,8520.47,0.00
2024-12-10 17:39:58,53,7664,26,27,4664.98,8521.00,0.00
2024-12-10 17:39:58,54,7664,26,28,4578.60,8521.02,0.00
2024-12-10 17:39:58,53,7664,26,27,4639.26,8521.04,0.00
2024-12-10 17:39:58,52,7664,25,27,4669.54,8521.27,0.00
2024-12-10 17:39:58,52,7665,25,27,4771.61,8522.00,0.00
2024-12-10 17:39:58,53,7665,26,27,4681.58,8522.02,0.00
2024-12-10 17:39:58,52,7665,25,27,4709.80,8522.17,0.00
2024-12-10 17:39:58,52,7666,25,27,4803.73,8523.00,0.00
2024-12-10 17:39:58,53,7666,25,28,4713.10,8523.02,0.00
2024-12-10 17:39:58,52,7666,25,27,4779.15,8523.04,0.00
2024-12-10 17:39:58,52,7667,25,27,4796.10,8524.00,0.00
2024-12-10 17:39:58,53,7667,25,28,4705.61,8524.02,0.00
2024-12-10 17:39:58,53,7668,25,28,4696.08,8525.00,0.00
2024-12-10 17:39:58,54,7668,26,28,4609.12,8525.02,0.00
2024-12-10 17:39:58,53,7668,26,27,4673.57,8525.04,0.00
2024-12-10 17:39:58,52,7668,25,27,4757.32,8525.06,0.00
2024-12-10 17:39:58,51,7668,24,27,4818.53,8525.43,0.00
2024-12-10 17:39:58,51,7669,24,27,4937.64,8526.00,0.00
2024-12-10 17:39:58,52,7669,25,27,4842.68,8526.02,0.00
2024-12-10 17:39:58,52,7670,25,27,4832.92,8527.00,0.00
2024-12-10 17:39:58,53,7670,25,28,4741.73,8527.02,0.00
2024-12-10 17:39:58,52,7670,25,27,4809.96,8527.04,0.00
2024-12-10 17:39:58,51,7670,24,27,4900.95,8527.08,0.00
2024-12-10 17:39:58,51,7671,24,27,4923.24,8528.00,0.00
2024-12-10 17:39:58,52,7671,24,28,4828.57,8528.02,0.00
2024-12-10 17:39:58,51,7671,23,28,4921.57,8528.02,0.00
2024-12-10 17:39:58,50,7671,22,28,4894.72,8528.42,0.00
2024-12-10 17:39:58,49,7671,21,28,4984.76,8528.53,0.00
2024-12-10 17:39:58,49,7672,21,28,5119.14,8529.00,0.00
2024-12-10 17:39:58,50,7672,22,28,5016.76,8529.02,0.00
2024-12-10 17:39:58,49,7672,22,27,5091.29,8529.02,0.00
2024-12-10 17:39:58,48,7672,21,27,5190.05,8529.02,0.00
2024-12-10 17:39:58,48,7673,21,27,5284.84,8530.00,0.00
2024-12-10 17:39:58,49,7673,21,28,5176.99,8530.02,0.00
2024-12-10 17:39:58,49,7674,21,28,5173.19,8531.00,0.00
2024-12-10 17:39:58,50,7674,21,29,5069.73,8531.02,0.00
2024-12-10 17:39:58,49,7674,21,28,5140.11,8531.02,0.00
2024-12-10 17:39:58,49,7675,21,28,5161.61,8532.00,0.00
2024-12-10 17:39:58,50,7675,21,29,5058.38,8532.02,0.00
2024-12-10 17:39:58,49,7675,20,29,5102.45,8532.12,0.00
2024-12-10 17:39:58,49,7676,20,29,5202.27,8533.00,0.00
2024-12-10 17:39:58,50,7676,20,30,5098.22,8533.02,0.00
2024-12-10 17:39:58,49,7676,20,29,5167.44,8533.02,0.00
2024-12-10 17:39:58,48,7676,19,29,5244.91,8533.15,0.00
2024-12-10 17:39:58,48,7677,19,29,5350.38,8534.00,0.00
2024-12-10 17:39:58,49,7677,20,29,5241.19,8534.02,0.00
2024-12-10 17:39:58,49,7678,20,29,5236.66,8535.00,0.00
2024-12-10 17:39:58,50,7678,20,30,5131.92,8535.02,0.00
2024-12-10 17:39:58,49,7678,20,29,5203.56,8535.02,0.00
2024-12-10 17:39:58,49,7679,20,29,5225.08,8536.00,0.00
2024-12-10 17:39:58,50,7679,21,29,5120.57,8536.02,0.00
2024-12-10 17:39:58,49,7679,20,29,5098.25,8536.80,0.00
2024-12-10 17:39:58,49,7680,20,29,5255.23,8537.00,0.00
2024-12-10 17:39:58,50,7680,20,30,5150.13,8537.02,0.00
2024-12-10 17:39:58,49,7680,20,29,5222.13,8537.02,0.00
2024-12-10 17:39:58,49,7681,20,29,5243.65,8538.00,0.00
2024-12-10 17:39:58,50,7681,20,30,5138.78,8538.02,0.00
2024-12-10 17:39:58,49,7681,19,30,5137.50,8538.35,0.00
2024-12-10 17:39:58,49,7682,19,30,5256.46,8539.00,0.00
2024-12-10 17:39:58,50,7682,20,30,5151.33,8539.02,0.00
2024-12-10 17:39:58,49,7682,20,29,5221.61,8539.02,0.00
2024-12-10 17:39:58,49,7683,20,29,5243.13,8540.00,0.00
2024-12-10 17:39:58,50,7683,21,29,5138.27,8540.02,0.00
2024-12-10 17:39:58,50,7684,21,29,5134.88,8541.00,0.00
2024-12-10 17:39:58,51,7684,22,29,5034.20,8541.02,0.00
2024-12-10 17:39:58,50,7684,22,28,5102.43,8541.02,0.00
2024-12-10 17:39:58,49,7684,21,28,5169.23,8541.45,0.00
2024-12-10 17:39:58,48,7684,20,28,5204.87,8541.88,0.00
2024-12-10 17:39:58,48,7685,20,28,5372.25,8542.00,0.00
2024-12-10 17:39:58,49,7685,21,28,5262.62,8542.02,0.00
2024-12-10 17:39:58,49,7686,21,28,5264.84,8543.00,0.00
2024-12-10 17:39:58,50,7686,22,28,5159.54,8543.02,0.00
2024-12-10 17:39:58,49,7686,21,28,5263.10,8543.04,0.00
2024-12-10 17:39:58,48,7686,20,28,5287.61,8543.63,0.00
2024-12-10 17:39:58,48,7687,20,28,5362.69,8544.00,0.00
2024-12-10 17:39:58,49,7687,21,28,5253.25,8544.02,0.00
2024-12-10 17:39:58,48,7687,21,27,5353.80,8544.06,0.00
2024-12-10 17:39:58,48,7688,21,27,5381.12,8545.00,0.00
2024-12-10 17:39:58,49,7688,21,28,5271.30,8545.02,0.00
2024-12-10 17:39:58,48,7688,20,28,5300.43,8545.54,0.00
2024-12-10 17:39:58,48,7689,20,28,5380.18,8546.00,0.00
2024-12-10 17:39:59,49,7689,20,29,5270.38,8546.02,0.00
2024-12-10 17:39:59,49,7690,20,29,5257.04,8547.00,0.00
2024-12-10 17:39:59,50,7690,20,30,5151.90,8547.02,0.00
2024-12-10 17:39:59,49,7690,20,29,5251.81,8547.06,0.00
2024-12-10 17:39:59,49,7691,20,29,5276.84,8548.00,0.00
2024-12-10 17:39:59,50,7691,20,30,5171.31,8548.02,0.00
2024-12-10 17:39:59,50,7692,20,30,5170.60,8549.00,0.00
2024-12-10 17:39:59,51,7692,21,30,5069.22,8549.02,0.00
2024-12-10 17:39:59,51,7693,21,30,5053.05,8550.00,0.00
2024-12-10 17:39:59,52,7693,21,31,4955.88,8550.02,0.00
2024-12-10 17:39:59,51,7693,21,30,5044.67,8550.08,0.00
2024-12-10 17:39:59,50,7693,20,30,5085.62,8550.62,0.00
2024-12-10 17:39:59,50,7694,20,30,5224.43,8551.00,0.00
2024-12-10 17:39:59,51,7694,20,31,5121.99,8551.02,0.00
2024-12-10 17:39:59,50,7694,19,31,5221.01,8551.06,0.00
2024-12-10 17:39:59,50,7695,19,31,5229.76,8552.00,0.00
2024-12-10 17:39:59,51,7695,20,31,5127.21,8552.02,0.00
2024-12-10 17:39:59,50,7695,19,31,5085.26,8552.84,0.00
2024-12-10 17:39:59,50,7696,19,31,5242.75,8553.00,0.00
2024-12-10 17:39:59,51,7696,20,31,5139.96,8553.02,0.00
2024-12-10 17:39:59,50,7696,19,31,5241.93,8553.02,0.00
2024-12-10 17:39:59,49,7696,19,30,5329.74,8553.12,0.00
2024-12-10 17:39:59,49,7697,19,30,5360.01,8554.00,0.00
2024-12-10 17:39:59,50,7697,20,30,5252.81,8554.02,0.00
2024-12-10 17:39:59,50,7698,20,30,5252.87,8555.00,0.00
2024-12-10 17:39:59,51,7698,20,31,5149.87,8555.02,0.00
2024-12-10 17:39:59,50,7698,19,31,5251.70,8555.02,0.00
2024-12-10 17:39:59,50,7699,19,31,5236.91,8556.00,0.00
2024-12-10 17:39:59,51,7699,19,32,5134.23,8556.02,0.00
2024-12-10 17:39:59,50,7699,19,31,5223.25,8556.10,0.00
2024-12-10 17:39:59,49,7699,18,31,5210.49,8556.96,0.00
2024-12-10 17:39:59,49,7700,18,31,5381.65,8557.00,0.00
2024-12-10 17:39:59,50,7700,19,31,5274.02,8557.02,0.00
2024-12-10 17:39:59,50,7701,19,31,5272.00,8558.00,0.00
2024-12-10 17:39:59,51,7701,20,31,5168.63,8558.02,0.00
2024-12-10 17:39:59,51,7702,20,31,5152.45,8559.00,0.00
2024-12-10 17:39:59,52,7702,20,32,5053.36,8559.02,0.00
2024-12-10 17:39:59,51,7702,20,31,5140.72,8559.10,0.00
2024-12-10 17:39:59,51,7703,20,31,5164.80,8560.00,0.00
2024-12-10 17:39:59,52,7703,20,32,5065.48,8560.02,0.00
2024-12-10 17:39:59,52,7704,20,32,5063.36,8561.00,0.00
2024-12-10 17:39:59,53,7704,21,32,4967.82,8561.02,0.00
2024-12-10 17:39:59,52,7704,20,32,4905.28,8561.96,0.00
2024-12-10 17:39:59,52,7705,20,32,5066.66,8562.00,0.00
2024-12-10 17:39:59,53,7705,21,32,4971.06,8562.02,0.00
2024-12-10 17:39:59,52,7705,21,31,5055.15,8562.10,0.00
2024-12-10 17:39:59,52,7706,21,31,5077.13,8563.00,0.00
2024-12-10 17:39:59,53,7706,21,32,4981.34,8563.02,0.00
2024-12-10 17:39:59,53,7707,21,32,4976.82,8564.00,0.00
2024-12-10 17:39:59,54,7707,21,33,4884.65,8564.02,0.00
2024-12-10 17:39:59,53,7707,20,33,4886.66,8564.68,0.00
2024-12-10 17:39:59,52,7707,19,33,4925.07,8564.90,0.00
2024-12-10 17:39:59,52,7708,19,33,5081.61,8565.00,0.00
2024-12-10 17:39:59,53,7708,20,33,4985.73,8565.02,0.00
2024-12-10 17:39:59,52,7708,20,32,5073.39,8565.10,0.00
2024-12-10 17:39:59,51,7708,19,32,5130.16,8565.24,0.00
2024-12-10 17:39:59,51,7709,19,32,5233.15,8566.00,0.00
2024-12-10 17:39:59,52,7709,20,32,5132.51,8566.02,0.00
2024-12-10 17:39:59,51,7709,19,32,5226.58,8566.08,0.00
2024-12-10 17:39:59,51,7710,19,32,5225.51,8567.00,0.00
2024-12-10 17:39:59,52,7710,20,32,5125.02,8567.02,0.00
2024-12-10 17:39:59,51,7710,20,31,5186.89,8567.08,0.00
2024-12-10 17:39:59,50,7710,19,31,5184.89,8567.90,0.00
2024-12-10 17:40:00,50,7711,19,31,5347.76,8568.00,0.00
2024-12-10 17:40:00,51,7711,19,32,5242.90,8568.02,0.00
2024-12-10 17:40:00,51,7712,19,32,5233.68,8569.00,0.00
2024-12-10 17:40:00,52,7712,20,32,5133.04,8569.02,0.00
2024-12-10 17:40:00,51,7712,20,31,5196.73,8569.08,0.00
2024-12-10 17:40:00,50,7712,19,31,5300.67,8569.08,0.00
2024-12-10 17:40:00,49,7712,18,31,5364.39,8569.59,0.00
2024-12-10 17:40:00,49,7713,18,31,5434.67,8570.00,0.00
2024-12-10 17:40:00,50,7713,18,32,5325.98,8570.02,0.00
2024-12-10 17:40:00,50,7714,18,32,5315.27,8571.00,0.00
2024-12-10 17:40:00,51,7714,19,32,5211.05,8571.02,0.00
2024-12-10 17:40:00,50,7714,19,31,5277.57,8571.08,0.00
2024-12-10 17:40:00,49,7714,18,31,5286.89,8571.55,0.00
2024-12-10 17:40:00,49,7715,18,31,5423.69,8572.00,0.00
2024-12-10 17:40:00,50,7715,19,31,5315.22,8572.02,0.00
2024-12-10 17:40:00,49,7715,18,31,5378.22,8572.06,0.00
2024-12-10 17:40:00,49,7716,18,31,5438.32,8573.00,0.00
2024-12-10 17:40:00,50,7716,19,31,5329.56,8573.02,0.00
2024-12-10 17:40:00,49,7716,19,30,5403.34,8573.06,0.00
2024-12-10 17:40:00,49,7717,19,30,5428.46,8574.00,0.00
2024-12-10 17:40:00,50,7717,19,31,5319.89,8574.02,0.00
2024-12-10 17:40:00,49,7717,18,31,5368.65,8574.08,0.00
2024-12-10 17:40:00,49,7718,18,31,5465.51,8575.00,0.00
2024-12-10 17:40:00,50,7718,19,31,5356.20,8575.02,0.00
2024-12-10 17:40:00,49,7718,19,30,5430.52,8575.06,0.00
2024-12-10 17:40:00,49,7719,19,30,5455.65,8576.00,0.00
2024-12-10 17:40:00,50,7719,19,31,5346.53,8576.02,0.00
2024-12-10 17:40:00,49,7719,18,31,5340.28,8576.73,0.00
2024-12-10 17:40:00,49,7720,18,31,5492.78,8577.00,0.00
2024-12-10 17:40:00,50,7720,19,31,5382.92,8577.02,0.00
2024-12-10 17:40:00,49,7720,19,30,5454.28,8577.06,0.00
2024-12-10 17:40:00,49,7721,19,30,5479.41,8578.00,0.00
2024-12-10 17:40:00,50,7721,19,31,5369.82,8578.02,0.00
2024-12-10 17:40:00,50,7722,19,31,5356.96,8579.00,0.00
2024-12-10 17:40:00,51,7722,20,31,5251.93,8579.02,0.00
2024-12-10 17:40:00,50,7722,20,30,5320.94,8579.06,0.00
2024-12-10 17:40:00,49,7722,19,30,5357.91,8579.73,0.00
2024-12-10 17:40:00,49,7722,19,30,5510.46,8580.00,0.00
2024-12-10 17:40:00,50,7722,20,30,5400.25,8580.02,0.00
2024-12-10 17:40:00,50,7723,20,30,5386.27,8581.00,0.00
2024-12-10 17:40:00,51,7723,20,31,5280.65,8581.02,0.00
2024-12-10 17:40:00,50,7723,20,30,5351.95,8581.06,0.00
2024-12-10 17:40:00,50,7724,20,30,5374.88,8582.00,0.00
2024-12-10 17:40:00,51,7724,21,30,5269.49,8582.02,0.00
2024-12-10 17:40:00,51,7725,21,30,5257.14,8583.00,0.00
2024-12-10 17:40:00,52,7725,22,30,5156.04,8583.02,0.00
2024-12-10 17:40:00,51,7725,22,29,5220.13,8583.08,0.00
2024-12-10 17:40:00,51,7726,22,29,5242.61,8584.00,0.00
2024-12-10 17:40:00,52,7726,22,30,5141.79,8584.02,0.00
2024-12-10 17:40:00,51,7726,21,30,5227.46,8584.02,0.00
2024-12-10 17:40:00,51,7727,21,30,5278.57,8585.00,0.00
2024-12-10 17:40:00,52,7727,22,30,5177.06,8585.02,0.00
2024-12-10 17:40:00,51,7727,22,29,5243.22,8585.06,0.00
2024-12-10 17:40:00,51,7728,22,29,5264.03,8586.00,0.00
2024-12-10 17:40:00,52,7728,22,30,5162.80,8586.02,0.00
2024-12-10 17:40:00,51,7728,21,30,5203.42,8586.04,0.00
2024-12-10 17:40:00,50,7728,20,30,5269.72,8586.06,0.00
2024-12-10 17:40:00,50,7729,20,30,5361.35,8587.00,0.00
2024-12-10 17:40:00,51,7729,20,31,5256.22,8587.02,0.00
2024-12-10 17:40:00,50,7729,20,30,5328.72,8587.04,0.00
2024-12-10 17:40:00,50,7730,20,30,5349.95,8588.00,0.00
2024-12-10 17:40:00,51,7730,21,30,5245.05,8588.02,0.00
2024-12-10 17:40:00,51,7731,21,30,5235.12,8589.00,0.00
2024-12-10 17:40:00,52,7731,22,30,5134.44,8589.02,0.00
2024-12-10 17:40:00,51,7731,22,29,5201.44,8589.04,0.00
2024-12-10 17:40:00,51,7732,22,29,5220.57,8590.00,0.00
2024-12-10 17:40:00,52,7732,22,30,5120.17,8590.02,0.00
2024-12-10 17:40:00,52,7733,22,30,5108.81,8591.00,0.00
2024-12-10 17:40:00,53,7733,23,30,5012.41,8591.02,0.00
2024-12-10 17:40:00,52,7733,23,29,5077.42,8591.04,0.00
2024-12-10 17:40:00,51,7733,22,29,5115.18,8591.31,0.00
2024-12-10 17:40:00,51,7734,22,29,5225.15,8592.00,0.00
2024-12-10 17:40:00,52,7734,22,30,5124.67,8592.02,0.00
2024-12-10 17:40:00,52,7735,22,30,5114.10,8593.00,0.00
2024-12-10 17:40:00,53,7735,23,30,5017.61,8593.02,0.00
2024-12-10 17:40:00,52,7735,23,29,5082.71,8593.04,0.00
2024-12-10 17:40:00,52,7736,23,29,5099.83,8594.00,0.00
2024-12-10 17:40:00,53,7736,24,29,5003.60,8594.02,0.00
2024-12-10 17:40:00,52,7736,23,29,5098.17,8594.02,0.00
2024-12-10 17:40:00,51,7736,22,29,5053.33,8594.92,0.00
2024-12-10 17:40:00,51,7737,22,29,5215.18,8595.00,0.00
2024-12-10 17:40:00,52,7737,22,30,5114.89,8595.02,0.00
2024-12-10 17:40:00,51,7737,22,29,5186.53,8595.02,0.00
2024-12-10 17:40:00,51,7738,22,29,5203.99,8596.00,0.00
2024-12-10 17:40:00,52,7738,23,29,5103.91,8596.02,0.00
2024-12-10 17:40:00,52,7739,23,29,5090.33,8597.00,0.00
2024-12-10 17:40:00,53,7739,24,29,4994.29,8597.02,0.00
2024-12-10 17:40:00,52,7739,24,28,5063.88,8597.02,0.00
2024-12-10 17:40:01,52,7740,24,28,5079.35,8598.00,0.00
2024-12-10 17:40:01,53,7740,25,28,4983.52,8598.02,0.00
2024-12-10 17:40:01,53,7741,25,28,4968.79,8599.00,0.00
2024-12-10 17:40:01,54,7741,26,28,4876.78,8599.02,0.00
2024-12-10 17:40:01,53,7741,26,27,4944.46,8599.02,0.00
2024-12-10 17:40:01,53,7742,26,27,4958.01,8600.00,0.00
2024-12-10 17:40:01,54,7742,26,28,4866.20,8600.02,0.00
2024-12-10 17:40:01,53,7742,25,28,4915.86,8600.11,0.00
2024-12-10 17:40:01,53,7743,25,28,4943.58,8601.00,0.00
2024-12-10 17:40:01,54,7743,26,28,4852.04,8601.02,0.00
2024-12-10 17:40:01,53,7743,26,27,4919.24,8601.02,0.00
2024-12-10 17:40:01,52,7743,25,27,4903.95,8601.92,0.00
2024-12-10 17:40:01,52,7744,25,27,5062.81,8602.00,0.00
2024-12-10 17:40:01,53,7744,26,27,4967.28,8602.02,0.00
2024-12-10 17:40:01,53,7745,26,27,4952.99,8603.00,0.00
2024-12-10 17:40:01,54,7745,26,28,4861.27,8603.02,0.00
2024-12-10 17:40:01,53,7745,26,27,4927.02,8603.04,0.00
2024-12-10 17:40:01,52,7745,25,27,4971.95,8603.62,0.00
2024-12-10 17:40:01,52,7746,25,27,5037.63,8604.00,0.00
2024-12-10 17:40:01,53,7746,26,27,4942.58,8604.02,0.00
2024-12-10 17:40:01,52,7746,25,27,4941.67,8604.06,0.00
2024-12-10 17:40:01,52,7747,25,27,5026.63,8605.00,0.00
2024-12-10 17:40:01,53,7747,25,28,4931.79,8605.02,0.00
2024-12-10 17:40:01,52,7747,25,27,5001.82,8605.04,0.00
2024-12-10 17:40:01,52,7748,25,27,5018.94,8606.00,0.00
2024-12-10 17:40:01,53,7748,26,27,4924.25,8606.02,0.00
2024-12-10 17:40:01,52,7748,25,27,4962.72,8606.15,0.00
2024-12-10 17:40:01,52,7749,25,27,5055.94,8607.00,0.00
2024-12-10 17:40:01,53,7749,26,27,4960.54,8607.02,0.00
2024-12-10 17:40:01,52,7749,26,26,5022.84,8607.04,0.00
2024-12-10 17:40:01,52,7750,26,26,5039.97,8608.00,0.00
2024-12-10 17:40:01,53,7750,27,26,4944.88,8608.02,0.00
2024-12-10 17:40:01,53,7751,27,26,4934.07,8609.00,0.00
2024-12-10 17:40:01,54,7751,27,27,4842.69,8609.02,0.00
2024-12-10 17:40:01,53,7751,27,26,4903.21,8609.04,0.00
2024-12-10 17:40:01,52,7751,26,26,4879.78,8609.96,0.00
2024-12-10 17:40:01,52,7752,26,26,5042.06,8610.00,0.00
2024-12-10 17:40:01,53,7752,26,27,4946.93,8610.02,0.00
2024-12-10 17:40:01,53,7753,26,27,4930.96,8611.00,0.00
2024-12-10 17:40:01,54,7753,27,27,4839.64,8611.02,0.00
2024-12-10 17:40:01,53,7753,27,26,4901.72,8611.04,0.00
2024-12-10 17:40:01,53,7754,27,26,4913.06,8612.00,0.00
2024-12-10 17:40:01,54,7754,28,26,4822.08,8612.02,0.00
2024-12-10 17:40:01,54,7755,28,26,4809.66,8613.00,0.00
2024-12-10 17:40:01,55,7755,29,26,4722.22,8613.02,0.00
2024-12-10 17:40:01,54,7755,29,25,4782.55,8613.04,0.00
2024-12-10 17:40:01,54,7756,29,25,4795.86,8614.00,0.00
2024-12-10 17:40:01,55,7756,29,26,4708.67,8614.02,0.00
2024-12-10 17:40:01,55,7757,29,26,4698.17,8615.00,0.00
2024-12-10 17:40:01,56,7757,29,27,4614.27,8615.02,0.00
2024-12-10 17:40:01,55,7757,29,26,4671.55,8615.04,0.00
2024-12-10 17:40:01,54,7757,28,26,4716.52,8615.52,0.00
2024-12-10 17:40:01,53,7757,27,26,4738.63,8615.60,0.00
2024-12-10 17:40:01,53,7758,27,26,4867.34,8616.00,0.00
2024-12-10 17:40:01,54,7758,28,26,4777.20,8616.02,0.00
2024-12-10 17:40:01,54,7759,28,26,4762.53,8617.00,0.00
2024-12-10 17:40:01,55,7759,28,27,4675.94,8617.02,0.00
2024-12-10 17:40:01,54,7759,28,26,4737.00,8617.04,0.00
2024-12-10 17:40:01,53,7759,27,26,4820.28,8617.04,0.00
2024-12-10 17:40:01,54,7758,27,27,4677.44,8617.63,0.00
2024-12-10 17:40:01,54,7759,27,27,4904.33,8618.00,0.00
2024-12-10 17:40:01,55,7759,28,27,4815.16,8618.02,0.00
2024-12-10 17:40:01,55,7760,28,27,4960.03,8619.00,0.00
2024-12-10 17:40:01,56,7760,29,27,4871.45,8619.02,0.00
2024-12-10 17:40:01,55,7760,29,26,4931.82,8619.04,0.00
2024-12-10 17:40:01,55,7761,29,26,4943.36,8620.00,0.00
2024-12-10 17:40:01,56,7761,29,27,4855.09,8620.02,0.00
2024-12-10 17:40:01,57,7760,29,28,4732.13,8620.14,0.00
2024-12-10 17:40:01,56,7760,28,28,4860.23,8620.61,0.00
2024-12-10 17:40:01,56,7761,28,28,4928.88,8621.00,0.00
2024-12-10 17:40:01,57,7761,28,29,4842.41,8621.02,0.00
2024-12-10 17:40:01,56,7761,28,28,4902.71,8621.04,0.00
2024-12-10 17:40:01,56,7762,28,28,5066.48,8622.00,0.00
2024-12-10 17:40:01,57,7762,28,29,4977.60,8622.02,0.00
2024-12-10 17:40:01,57,7763,28,29,4964.51,8623.00,0.00
2024-12-10 17:40:01,58,7763,28,30,4878.91,8623.02,0.00
2024-12-10 17:40:01,57,7763,28,29,4937.28,8623.04,0.00
2024-12-10 17:40:01,56,7763,27,29,5003.97,8623.09,0.00
2024-12-10 17:40:01,56,7764,27,29,5079.98,8624.00,0.00
2024-12-10 17:40:01,57,7764,27,30,4990.85,8624.02,0.00
2024-12-10 17:40:01,56,7764,26,30,5029.99,8624.13,0.00
2024-12-10 17:40:01,56,7765,26,30,5108.60,8625.00,0.00
2024-12-10 17:40:01,57,7765,26,31,5018.98,8625.02,0.00
2024-12-10 17:40:01,56,7765,26,30,5082.42,8625.04,0.00
2024-12-10 17:40:01,55,7765,25,30,5167.01,8625.07,0.00
2024-12-10 17:40:01,55,7766,25,30,5242.86,8626.00,0.00
2024-12-10 17:40:01,56,7766,25,31,5149.23,8626.02,0.00
2024-12-10 17:40:01,56,7767,25,31,5133.28,8627.00,0.00
2024-12-10 17:40:01,57,7767,26,31,5043.23,8627.02,0.00
2024-12-10 17:40:01,56,7767,26,30,5105.56,8627.04,0.00
2024-12-10 17:40:01,56,7768,26,30,5111.72,8628.00,0.00
2024-12-10 17:40:01,57,7768,26,31,5022.04,8628.02,0.00
2024-12-10 17:40:02,57,7769,26,31,5039.95,8629.00,0.00
2024-12-10 17:40:02,58,7769,26,32,4953.06,8629.02,0.00
2024-12-10 17:40:02,58,7770,26,32,4959.65,8630.00,0.00
2024-12-10 17:40:02,59,7770,27,32,4875.59,8630.02,0.00
2024-12-10 17:40:02,59,7771,27,32,4860.19,8631.00,0.00
2024-12-10 17:40:02,60,7771,27,33,4779.18,8631.02,0.00
2024-12-10 17:40:02,59,7771,26,33,4785.19,8631.54,0.00
2024-12-10 17:40:02,59,7772,26,33,4823.29,8632.00,0.00
2024-12-10 17:40:02,60,7772,26,34,4742.90,8632.02,0.00
2024-12-10 17:40:02,59,7772,26,33,4808.65,8632.03,0.00
2024-12-10 17:40:02,59,7773,26,33,4798.33,8633.00,0.00
2024-12-10 17:40:02,60,7773,26,34,4718.35,8633.02,0.00
2024-12-10 17:40:02,59,7773,25,34,4763.22,8633.09,0.00
2024-12-10 17:40:02,58,7773,24,34,4756.69,8633.55,0.00
2024-12-10 17:40:02,57,7773,23,34,4835.64,8633.61,0.00
2024-12-10 17:40:02,57,7774,23,34,4940.51,8634.00,0.00
2024-12-10 17:40:02,58,7774,24,34,4855.33,8634.02,0.00
2024-12-10 17:40:02,57,7774,24,33,4916.27,8634.04,0.00
2024-12-10 17:40:02,56,7774,23,33,5001.65,8634.05,0.00
2024-12-10 17:40:02,55,7774,22,33,5067.36,8634.13,0.00
2024-12-10 17:40:02,55,7775,22,33,5135.31,8635.00,0.00
2024-12-10 17:40:02,56,7775,22,34,5043.61,8635.02,0.00
2024-12-10 17:40:02,55,7775,21,34,5070.32,8635.20,0.00
2024-12-10 17:40:02,55,7776,21,34,5143.61,8636.00,0.00
2024-12-10 17:40:02,56,7776,21,35,5051.76,8636.02,0.00
2024-12-10 17:40:02,55,7776,20,35,5142.04,8636.02,0.00
2024-12-10 17:40:02,54,7776,20,34,5213.27,8636.02,0.00
2024-12-10 17:40:02,53,7776,19,34,5288.87,8636.15,0.00
2024-12-10 17:40:02,52,7776,19,33,5346.26,8636.56,0.00
2024-12-10 17:40:02,52,7777,19,33,5474.50,8637.00,0.00
2024-12-10 17:40:02,53,7777,19,34,5371.21,8637.02,0.00
2024-12-10 17:40:02,52,7777,18,34,5337.30,8637.89,0.00
2024-12-10 17:40:02,52,7778,18,34,5493.55,8638.00,0.00
2024-12-10 17:40:02,53,7778,19,34,5389.89,8638.02,0.00
2024-12-10 17:40:02,52,7778,19,33,5463.65,8638.04,0.00
2024-12-10 17:40:02,51,7778,18,33,5557.45,8638.10,0.00
2024-12-10 17:40:02,51,7779,18,33,5649.53,8639.00,0.00
2024-12-10 17:40:02,52,7779,18,34,5540.89,8639.02,0.00
2024-12-10 17:40:02,51,7779,17,34,5601.06,8639.04,0.00
2024-12-10 17:40:02,51,7780,17,34,5654.22,8640.00,0.00
2024-12-10 17:40:02,52,7780,17,35,5545.49,8640.02,0.00
2024-12-10 17:40:02,51,7780,17,34,5623.73,8640.04,0.00
2024-12-10 17:40:02,51,7781,17,34,5643.01,8641.00,0.00
2024-12-10 17:40:02,52,7781,18,34,5534.50,8641.02,0.00
2024-12-10 17:40:02,52,7782,18,34,5516.87,8642.00,0.00
2024-12-10 17:40:02,53,7782,18,35,5412.78,8642.02,0.00
2024-12-10 17:40:02,52,7782,18,34,5486.96,8642.04,0.00
2024-12-10 17:40:02,51,7782,17,34,5562.39,8642.18,0.00
2024-12-10 17:40:02,51,7783,17,34,5661.27,8643.00,0.00
2024-12-10 17:40:02,52,7783,18,34,5552.40,8643.02,0.00
2024-12-10 17:40:02,51,7783,17,34,5612.83,8643.18,0.00
2024-12-10 17:40:02,51,7784,17,34,5645.50,8644.00,0.00
2024-12-10 17:40:02,52,7784,18,34,5536.94,8644.02,0.00
2024-12-10 17:40:02,51,7784,18,33,5613.31,8644.04,0.00
2024-12-10 17:40:02,51,7785,18,33,5632.60,8645.00,0.00
2024-12-10 17:40:02,52,7785,18,34,5524.28,8645.02,0.00
2024-12-10 17:40:02,51,7785,17,34,5585.16,8645.10,0.00
2024-12-10 17:40:02,51,7786,17,34,5677.32,8646.00,0.00
2024-12-10 17:40:02,52,7786,18,34,5568.15,8646.02,0.00
2024-12-10 17:40:02,51,7786,18,33,5643.42,8646.04,0.00
2024-12-10 17:40:02,51,7787,18,33,5662.72,8647.00,0.00
2024-12-10 17:40:02,52,7787,19,33,5553.82,8647.02,0.00
2024-12-10 17:40:02,52,7788,19,33,5537.09,8648.00,0.00
2024-12-10 17:40:02,53,7788,19,34,5432.62,8648.02,0.00
2024-12-10 17:40:02,52,7788,19,33,5503.83,8648.04,0.00
2024-12-10 17:40:02,52,7789,19,33,5521.10,8649.00,0.00
2024-12-10 17:40:02,53,7789,19,34,5416.93,8649.02,0.00
2024-12-10 17:40:02,53,7790,19,34,5400.69,8650.00,0.00
2024-12-10 17:40:02,54,7790,20,34,5300.68,8650.02,0.00
2024-12-10 17:40:02,53,7790,20,33,5369.69,8650.04,0.00
2024-12-10 17:40:02,52,7790,19,33,5440.27,8650.15,0.00
2024-12-10 17:40:02,52,7791,19,33,5534.02,8651.00,0.00
2024-12-10 17:40:02,53,7791,19,34,5429.60,8651.02,0.00
2024-12-10 17:40:02,53,7792,19,34,5410.64,8652.00,0.00
2024-12-10 17:40:02,54,7792,19,35,5310.45,8652.02,0.00
2024-12-10 17:40:02,53,7792,19,34,5389.22,8652.04,0.00
2024-12-10 17:40:02,52,7792,18,34,5436.39,8652.27,0.00
2024-12-10 17:40:02,52,7793,18,34,5535.07,8653.00,0.00
2024-12-10 17:40:02,53,7793,19,34,5430.63,8653.02,0.00
2024-12-10 17:40:02,53,7794,19,34,5405.28,8654.00,0.00
2024-12-10 17:40:02,54,7794,19,35,5305.19,8654.02,0.00
2024-12-10 17:40:02,53,7794,19,34,5372.63,8654.04,0.00
2024-12-10 17:40:03,53,7795,19,34,5373.91,8655.00,0.00
2024-12-10 17:40:03,54,7795,20,34,5274.39,8655.02,0.00
2024-12-10 17:40:03,53,7795,19,34,5245.14,8655.51,0.00
2024-12-10 17:40:03,53,7796,19,34,5351.94,8656.00,0.00
2024-12-10 17:40:03,54,7796,19,35,5252.83,8656.02,0.00
2024-12-10 17:40:03,53,7796,19,34,5317.64,8656.04,0.00
2024-12-10 17:40:03,53,7797,19,34,5318.43,8657.00,0.00
2024-12-10 17:40:03,54,7797,19,35,5219.94,8657.02,0.00
2024-12-10 17:40:03,54,7798,19,35,5197.76,8658.00,0.00
2024-12-10 17:40:03,55,7798,19,36,5103.25,8658.02,0.00
2024-12-10 17:40:03,55,7799,19,36,5068.64,8659.00,0.00
2024-12-10 17:40:03,56,7799,19,37,4978.13,8659.02,0.00
2024-12-10 17:40:03,55,7799,18,37,5067.07,8659.04,0.00
2024-12-10 17:40:03,54,7799,18,36,5156.09,8659.06,0.00
2024-12-10 17:40:03,53,7799,17,36,5182.32,8659.68,0.00
2024-12-10 17:40:03,53,7800,17,36,5318.17,8660.00,0.00
2024-12-10 17:40:03,54,7800,17,37,5219.68,8660.02,0.00
2024-12-10 17:40:03,53,7800,16,37,5315.02,8660.04,0.00
2024-12-10 17:40:03,53,7801,16,37,5300.32,8661.00,0.00
2024-12-10 17:40:03,54,7801,17,37,5202.17,8661.02,0.00
2024-12-10 17:40:03,53,7801,16,37,5283.16,8661.04,0.00
2024-12-10 17:40:03,53,7802,16,37,5323.13,8662.00,0.00
2024-12-10 17:40:03,54,7802,16,38,5224.56,8662.02,0.00
2024-12-10 17:40:03,53,7802,16,37,5318.23,8662.04,0.00
2024-12-10 17:40:03,52,7802,16,36,5381.29,8662.48,0.00
2024-12-10 17:40:03,52,7803,16,36,5436.65,8663.00,0.00
2024-12-10 17:40:03,53,7803,16,37,5334.07,8663.02,0.00
2024-12-10 17:40:03,53,7804,16,37,5323.02,8664.00,0.00
2024-12-10 17:40:03,54,7804,17,37,5224.44,8664.02,0.00
2024-12-10 17:40:03,53,7804,16,37,5215.76,8664.68,0.00
2024-12-10 17:40:03,53,7805,16,37,5351.70,8665.00,0.00
2024-12-10 17:40:03,54,7805,17,37,5252.59,8665.02,0.00
2024-12-10 17:40:03,53,7805,17,36,5348.43,8665.04,0.00
2024-12-10 17:40:03,53,7806,17,36,5363.63,8666.00,0.00
2024-12-10 17:40:03,54,7806,17,37,5264.31,8666.02,0.00
2024-12-10 17:40:03,54,7807,17,37,5252.99,8667.00,0.00
2024-12-10 17:40:03,55,7807,17,38,5157.48,8667.02,0.00
2024-12-10 17:40:03,54,7807,16,38,5173.54,8667.20,0.00
2024-12-10 17:40:03,54,7808,16,38,5261.66,8668.00,0.00
2024-12-10 17:40:03,55,7808,16,39,5166.00,8668.02,0.00
2024-12-10 17:40:03,54,7808,16,38,5255.25,8668.06,0.00
2024-12-10 17:40:03,54,7809,16,38,5263.53,8669.00,0.00
2024-12-10 17:40:03,55,7809,17,38,5167.83,8669.02,0.00
2024-12-10 17:40:03,54,7809,16,38,5202.57,8669.17,0.00
2024-12-10 17:40:03,54,7810,16,38,5280.20,8670.00,0.00
2024-12-10 17:40:03,55,7810,17,38,5184.20,8670.02,0.00
2024-12-10 17:40:03,54,7810,17,37,5243.28,8670.06,0.00
2024-12-10 17:40:03,54,7811,17,37,5242.86,8671.00,0.00
2024-12-10 17:40:03,55,7811,17,38,5147.53,8671.02,0.00
2024-12-10 17:40:03,54,7811,16,38,5238.05,8671.06,0.00
2024-12-10 17:40:03,55,7810,16,39,5090.89,8671.33,0.00
2024-12-10 17:40:03,55,7811,16,39,5190.38,8672.00,0.00
2024-12-10 17:40:03,56,7811,17,39,5097.70,8672.02,0.00
2024-12-10 17:40:03,55,7811,16,39,5020.57,8672.95,0.00
2024-12-10 17:40:03,55,7812,16,39,5331.24,8673.00,0.00
2024-12-10 17:40:03,56,7812,17,39,5236.04,8673.02,0.00
2024-12-10 17:40:03,55,7812,16,39,5329.66,8673.02,0.00
2024-12-10 17:40:03,54,7812,16,38,5421.94,8673.04,0.00
2024-12-10 17:40:03,54,7813,16,38,5420.15,8674.00,0.00
2024-12-10 17:40:03,55,7813,16,39,5321.60,8674.02,0.00
2024-12-10 17:40:03,54,7813,15,39,5401.16,8674.04,0.00
2024-12-10 17:40:03,54,7814,15,39,5431.28,8675.00,0.00
2024-12-10 17:40:03,55,7814,16,39,5332.53,8675.02,0.00
2024-12-10 17:40:03,54,7814,15,39,5356.71,8675.50,0.00
2024-12-10 17:40:03,54,7815,15,39,5393.37,8676.00,0.00
2024-12-10 17:40:04,55,7815,15,40,5295.31,8676.02,0.00
2024-12-10 17:40:04,54,7815,15,39,5388.56,8676.04,0.00
2024-12-10 17:40:04,53,7815,15,38,5443.25,8676.55,0.00
2024-12-10 17:40:04,53,7816,15,38,5502.53,8677.00,0.00
2024-12-10 17:40:04,54,7816,16,38,5400.63,8677.02,0.00
2024-12-10 17:40:04,53,7816,15,38,5362.02,8677.57,0.00
2024-12-10 17:40:04,53,7817,15,38,5488.42,8678.00,0.00
2024-12-10 17:40:04,54,7817,16,38,5386.79,8678.02,0.00
2024-12-10 17:40:04,53,7817,16,37,5454.04,8678.04,0.00
2024-12-10 17:40:04,53,7818,16,37,5469.40,8679.00,0.00
2024-12-10 17:40:04,54,7818,16,38,5368.12,8679.02,0.00
2024-12-10 17:40:04,54,7819,16,38,5353.89,8680.00,0.00
2024-12-10 17:40:04,55,7819,17,38,5256.55,8680.02,0.00
2024-12-10 17:40:04,54,7819,17,37,5318.53,8680.04,0.00
2024-12-10 17:40:04,53,7819,16,37,5319.88,8680.87,0.00
2024-12-10 17:40:04,53,7820,16,37,5472.30,8681.00,0.00
2024-12-10 17:40:04,54,7820,17,37,5370.96,8681.02,0.00
2024-12-10 17:40:04,53,7820,16,37,5384.00,8681.32,0.00
2024-12-10 17:40:04,53,7821,16,37,5489.31,8682.00,0.00
2024-12-10 17:40:04,54,7821,17,37,5387.66,8682.02,0.00
2024-12-10 17:40:04,53,7821,17,36,5456.56,8682.04,0.00
2024-12-10 17:40:04,53,7822,17,36,5471.93,8683.00,0.00
2024-12-10 17:40:04,54,7822,17,37,5370.59,8683.02,0.00
2024-12-10 17:40:04,53,7822,16,37,5342.75,8683.51,0.00
2024-12-10 17:40:04,53,7823,16,37,5464.36,8684.00,0.00
2024-12-10 17:40:04,54,7823,17,37,5363.17,8684.02,0.00
2024-12-10 17:40:04,53,7823,17,36,5433.24,8684.04,0.00
2024-12-10 17:40:04,53,7824,17,36,5448.61,8685.00,0.00
2024-12-10 17:40:04,54,7824,17,37,5347.71,8685.02,0.00
2024-12-10 17:40:04,53,7824,16,37,5306.35,8685.59,0.00
2024-12-10 17:40:04,52,7824,15,37,5405.08,8685.64,0.00
2024-12-10 17:40:04,52,7825,15,37,5540.66,8686.00,0.00
2024-12-10 17:40:04,53,7825,16,37,5436.12,8686.02,0.00
2024-12-10 17:40:04,52,7825,16,36,5510.60,8686.04,0.00
2024-12-10 17:40:04,52,7826,16,36,5527.94,8687.00,0.00
2024-12-10 17:40:04,53,7826,17,36,5423.63,8687.02,0.00
2024-12-10 17:40:04,52,7826,16,36,5436.19,8687.35,0.00
2024-12-10 17:40:04,52,7827,16,36,5546.95,8688.00,0.00
2024-12-10 17:40:04,53,7827,17,36,5442.29,8688.02,0.00
2024-12-10 17:40:04,52,7827,17,35,5518.55,8688.04,0.00
2024-12-10 17:40:04,52,7828,17,35,5535.89,8689.00,0.00
2024-12-10 17:40:04,53,7828,17,36,5431.44,8689.02,0.00
2024-12-10 17:40:04,53,7829,17,36,5412.39,8690.00,0.00
2024-12-10 17:40:04,54,7829,17,37,5312.16,8690.02,0.00
2024-12-10 17:40:04,53,7829,17,36,5386.16,8690.04,0.00
2024-12-10 17:40:04,52,7829,16,36,5436.60,8690.64,0.00
2024-12-10 17:40:04,51,7829,15,36,5505.88,8690.84,0.00
2024-12-10 17:40:04,51,7830,15,36,5662.78,8691.00,0.00
2024-12-10 17:40:04,52,7830,16,36,5553.88,8691.02,0.00
2024-12-10 17:40:04,52,7831,16,36,5536.13,8692.00,0.00
2024-12-10 17:40:04,53,7831,17,36,5431.68,8692.02,0.00
2024-12-10 17:40:04,52,7831,17,35,5511.06,8692.04,0.00
2024-12-10 17:40:04,52,7832,17,35,5528.41,8693.00,0.00
2024-12-10 17:40:04,53,7832,18,35,5424.10,8693.02,0.00
2024-12-10 17:40:04,53,7833,18,35,5405.04,8694.00,0.00
2024-12-10 17:40:04,54,7833,19,35,5304.95,8694.02,0.00
2024-12-10 17:40:04,53,7833,19,34,5382.08,8694.04,0.00
2024-12-10 17:40:04,52,7833,18,34,5420.77,8694.71,0.00
2024-12-10 17:40:04,52,7834,18,34,5563.13,8695.00,0.00
2024-12-10 17:40:04,53,7834,18,35,5458.16,8695.02,0.00
2024-12-10 17:40:04,53,7835,18,35,5437.42,8696.00,0.00
2024-12-10 17:40:04,54,7835,18,36,5336.73,8696.02,0.00
2024-12-10 17:40:04,53,7835,18,35,5414.45,8696.04,0.00
2024-12-10 17:40:04,52,7835,17,35,5423.09,8696.87,0.00
2024-12-10 17:40:04,52,7836,17,35,5578.74,8697.00,0.00
2024-12-10 17:40:04,53,7836,18,35,5473.48,8697.02,0.00
2024-12-10 17:40:04,53,7837,18,35,5496.77,8698.00,0.00
2024-12-10 17:40:04,54,7837,19,35,5394.98,8698.02,0.00
2024-12-10 17:40:04,54,7838,19,35,5396.47,8699.00,0.00
2024-12-10 17:40:04,55,7838,19,36,5298.35,8699.02,0.00
2024-12-10 17:40:04,55,7839,19,36,5276.82,8700.00,0.00
2024-12-10 17:40:04,56,7839,19,37,5182.59,8700.02,0.00
2024-12-10 17:40:04,55,7839,19,36,5256.26,8700.04,0.00
2024-12-10 17:40:04,54,7839,18,36,5222.80,8700.96,0.00
2024-12-10 17:40:04,54,7840,18,36,5380.73,8701.00,0.00
2024-12-10 17:40:04,55,7840,18,37,5282.90,8701.02,0.00
2024-12-10 17:40:04,55,7841,18,37,5261.35,8702.00,0.00
2024-12-10 17:40:04,56,7841,18,38,5167.40,8702.02,0.00
2024-12-10 17:40:04,55,7841,18,37,5243.95,8702.04,0.00
2024-12-10 17:40:05,55,7842,18,37,5255.63,8703.00,0.00
2024-12-10 17:40:05,56,7842,19,37,5161.78,8703.02,0.00
2024-12-10 17:40:05,55,7842,18,37,5137.40,8703.84,0.00
2024-12-10 17:40:05,55,7843,18,37,5281.55,8704.00,0.00
2024-12-10 17:40:05,56,7843,18,38,5187.24,8704.02,0.00
2024-12-10 17:40:05,55,7843,18,37,5265.73,8704.04,0.00
2024-12-10 17:40:05,54,7843,17,37,5352.00,8704.17,0.00
2024-12-10 17:40:05,54,7844,17,37,5376.75,8705.00,0.00
2024-12-10 17:40:05,55,7844,17,38,5278.99,8705.02,0.00
2024-12-10 17:40:05,55,7845,17,38,5257.44,8706.00,0.00
2024-12-10 17:40:05,56,7845,17,39,5163.56,8706.02,0.00
2024-12-10 17:40:05,55,7845,17,38,5238.45,8706.06,0.00
2024-12-10 17:40:05,54,7845,16,38,5314.55,8706.20,0.00
2024-12-10 17:40:05,54,7846,16,38,5407.01,8707.00,0.00
2024-12-10 17:40:05,55,7846,16,39,5308.70,8707.02,0.00
2024-12-10 17:40:05,54,7846,15,39,5405.40,8707.02,0.00
2024-12-10 17:40:05,54,7847,15,39,5385.06,8708.00,0.00
2024-12-10 17:40:05,55,7847,16,39,5287.15,8708.02,0.00
2024-12-10 17:40:05,54,7847,16,38,5368.93,8708.04,0.00
2024-12-10 17:40:05,53,7847,15,38,5349.00,8708.68,0.00
2024-12-10 17:40:05,53,7848,15,38,5485.65,8709.00,0.00
2024-12-10 17:40:05,54,7848,15,39,5384.06,8709.02,0.00
2024-12-10 17:40:05,54,7849,15,39,5363.71,8710.00,0.00
2024-12-10 17:40:05,55,7849,16,39,5266.19,8710.02,0.00
2024-12-10 17:40:05,54,7849,16,38,5349.20,8710.04,0.00
2024-12-10 17:40:05,54,7850,16,38,5362.71,8711.00,0.00
2024-12-10 17:40:05,55,7850,16,39,5265.21,8711.02,0.00
2024-12-10 17:40:05,55,7851,16,39,5243.64,8712.00,0.00
2024-12-10 17:40:05,56,7851,16,40,5150.00,8712.02,0.00
2024-12-10 17:40:05,55,7851,16,39,5229.39,8712.04,0.00
2024-12-10 17:40:05,55,7852,16,39,5241.07,8713.00,0.00
2024-12-10 17:40:05,56,7852,16,40,5147.48,8713.02,0.00
2024-12-10 17:40:05,56,7853,16,40,5124.73,8714.00,0.00
2024-12-10 17:40:05,57,7853,17,40,5034.82,8714.02,0.00
2024-12-10 17:40:05,56,7853,17,39,5112.29,8714.04,0.00
2024-12-10 17:40:05,55,7853,16,39,5121.69,8714.82,0.00
2024-12-10 17:40:05,55,7854,16,39,5264.46,8715.00,0.00
2024-12-10 17:40:05,56,7854,17,39,5170.45,8715.02,0.00
2024-12-10 17:40:05,55,7854,16,39,5164.99,8715.73,0.00
2024-12-10 17:40:05,55,7855,16,39,5299.93,8716.00,0.00
2024-12-10 17:40:05,56,7855,17,39,5205.29,8716.02,0.00
2024-12-10 17:40:05,55,7855,17,38,5287.25,8716.04,0.00
2024-12-10 17:40:05,55,7856,17,38,5298.95,8717.00,0.00
2024-12-10 17:40:05,56,7856,17,39,5204.33,8717.02,0.00
2024-12-10 17:40:05,56,7857,17,39,5181.57,8718.00,0.00
2024-12-10 17:40:05,57,7857,17,40,5090.67,8718.02,0.00
2024-12-10 17:40:05,56,7857,17,39,5167.56,8718.04,0.00
2024-12-10 17:40:05,55,7857,16,39,5195.12,8718.42,0.00
2024-12-10 17:40:05,55,7858,16,39,5303.34,8719.00,0.00
2024-12-10 17:40:05,56,7858,17,39,5208.63,8719.02,0.00
2024-12-10 17:40:05,55,7858,16,39,5162.52,8719.62,0.00
2024-12-10 17:40:05,55,7859,16,39,5288.09,8720.00,0.00
2024-12-10 17:40:05,56,7859,17,39,5193.66,8720.02,0.00
2024-12-10 17:40:05,55,7859,17,38,5272.24,8720.04,0.00
2024-12-10 17:40:05,55,7860,17,38,5283.94,8721.00,0.00
2024-12-10 17:40:05,56,7860,17,39,5189.58,8721.02,0.00
2024-12-10 17:40:05,56,7861,17,39,5166.82,8722.00,0.00
2024-12-10 17:40:05,57,7861,18,39,5076.17,8722.02,0.00
2024-12-10 17:40:05,56,7861,18,38,5152.80,8722.04,0.00
2024-12-10 17:40:05,56,7862,18,38,5162.74,8723.00,0.00
2024-12-10 17:40:05,57,7862,18,39,5072.16,8723.02,0.00
2024-12-10 17:40:05,57,7863,18,39,5048.25,8724.00,0.00
2024-12-10 17:40:05,58,7863,19,39,4961.22,8724.02,0.00
2024-12-10 17:40:05,57,7863,19,38,5032.95,8724.04,0.00
2024-12-10 17:40:05,56,7863,18,38,5056.01,8724.43,0.00
2024-12-10 17:40:05,56,7864,18,38,5162.36,8725.00,0.00
2024-12-10 17:40:05,57,7864,18,39,5071.79,8725.02,0.00
2024-12-10 17:40:05,56,7864,17,39,5042.53,8725.52,0.00
2024-12-10 17:40:05,57,7863,17,40,4931.29,8725.81,0.00
2024-12-10 17:40:05,57,7864,17,40,5084.55,8726.00,0.00
2024-12-10 17:40:05,58,7864,17,41,4996.89,8726.02,0.00
2024-12-10 17:40:05,57,7864,17,40,5069.24,8726.04,0.00
2024-12-10 17:40:05,56,7864,16,40,5086.57,8726.16,0.00
2024-12-10 17:40:05,56,7865,16,40,5325.54,8727.00,0.00
2024-12-10 17:40:05,57,7865,16,41,5232.11,8727.02,0.00
2024-12-10 17:40:05,57,7866,16,41,5208.21,8728.00,0.00
2024-12-10 17:40:05,58,7866,16,42,5118.42,8728.02,0.00
2024-12-10 17:40:05,57,7866,16,41,5192.90,8728.04,0.00
2024-12-10 17:40:05,56,7866,15,41,5231.39,8728.64,0.00
2024-12-10 17:40:05,56,7867,15,41,5294.03,8729.00,0.00
2024-12-10 17:40:05,57,7867,15,42,5201.15,8729.02,0.00
2024-12-10 17:40:05,57,7868,15,42,5177.24,8730.00,0.00
2024-12-10 17:40:05,58,7868,15,43,5087.98,8730.02,0.00
2024-12-10 17:40:05,57,7868,15,42,5163.46,8730.04,0.00
2024-12-10 17:40:06,57,7869,15,42,5171.71,8731.00,0.00
2024-12-10 17:40:06,58,7869,16,42,5082.54,8731.02,0.00
2024-12-10 17:40:06,58,7870,16,42,5056.21,8732.00,0.00
2024-12-10 17:40:06,59,7870,16,43,4970.51,8732.02,0.00
2024-12-10 17:40:06,58,7870,16,42,5044.16,8732.03,0.00
2024-12-10 17:40:06,58,7871,16,42,5048.75,8733.00,0.00
2024-12-10 17:40:06,59,7871,17,42,4963.18,8733.02,0.00
2024-12-10 17:40:06,60,7870,18,42,4816.93,8733.43,0.00
2024-12-10 17:40:06,59,7870,17,42,4912.15,8733.78,0.00
2024-12-10 17:40:06,59,7871,17,42,5041.11,8734.00,0.00
2024-12-10 17:40:06,60,7871,18,42,4957.09,8734.02,0.00
2024-12-10 17:40:06,59,7871,17,42,5039.63,8734.02,0.00
2024-12-10 17:40:06,58,7871,17,41,5117.48,8734.02,0.00
2024-12-10 17:40:06,58,7872,17,41,5273.19,8735.00,0.00
2024-12-10 17:40:06,59,7872,17,42,5183.81,8735.02,0.00
2024-12-10 17:40:06,58,7872,16,42,5199.50,8735.31,0.00
2024-12-10 17:40:06,58,7873,16,42,5290.36,8736.00,0.00
2024-12-10 17:40:06,59,7873,17,42,5200.69,8736.02,0.00
2024-12-10 17:40:06,58,7873,17,41,5282.83,8736.02,0.00
2024-12-10 17:40:06,57,7873,16,41,5344.08,8736.33,0.00
2024-12-10 17:40:06,57,7874,16,41,5439.60,8737.00,0.00
2024-12-10 17:40:06,58,7874,17,41,5345.81,8737.02,0.00
2024-12-10 17:40:06,58,7875,17,41,5320.82,8738.00,0.00
2024-12-10 17:40:06,59,7875,18,41,5230.63,8738.02,0.00
2024-12-10 17:40:06,58,7875,18,40,5313.28,8738.02,0.00
2024-12-10 17:40:06,58,7876,18,40,5318.41,8739.00,0.00
2024-12-10 17:40:06,59,7876,18,41,5228.27,8739.02,0.00
2024-12-10 17:40:06,59,7877,18,41,5202.20,8740.00,0.00
2024-12-10 17:40:06,60,7877,18,42,5115.50,8740.02,0.00
2024-12-10 17:40:06,59,7877,18,41,5196.28,8740.02,0.00
2024-12-10 17:40:06,58,7877,17,41,5231.95,8740.64,0.00
2024-12-10 17:40:06,57,7877,16,41,5311.51,8740.70,0.00
2024-12-10 17:40:06,57,7877,16,41,5439.03,8741.00,0.00
2024-12-10 17:40:06,58,7877,17,41,5345.25,8741.02,0.00
2024-12-10 17:40:06,57,7877,16,41,5343.98,8741.14,0.00
2024-12-10 17:40:06,57,7878,16,41,5422.78,8742.00,0.00
2024-12-10 17:40:06,58,7878,17,41,5329.28,8742.02,0.00
2024-12-10 17:40:06,57,7878,17,40,5415.11,8742.02,0.00
2024-12-10 17:40:06,57,7879,17,40,5421.86,8743.00,0.00
2024-12-10 17:40:06,58,7879,18,40,5328.38,8743.02,0.00
2024-12-10 17:40:06,58,7880,18,40,5303.36,8744.00,0.00
2024-12-10 17:40:06,59,7880,19,40,5213.48,8744.02,0.00
2024-12-10 17:40:06,58,7880,19,39,5297.33,8744.02,0.00
2024-12-10 17:40:06,58,7881,19,39,5302.46,8745.00,0.00
2024-12-10 17:40:06,59,7881,20,39,5212.59,8745.02,0.00
2024-12-10 17:40:06,59,7882,20,39,5186.50,8746.00,0.00
2024-12-10 17:40:06,60,7882,21,39,5100.06,8746.02,0.00
2024-12-10 17:40:06,59,7882,21,38,5182.06,8746.02,0.00
2024-12-10 17:40:06,59,7883,21,38,5185.61,8747.00,0.00
2024-12-10 17:40:06,60,7883,21,39,5099.19,8747.02,0.00
2024-12-10 17:40:06,59,7883,20,39,5112.97,8747.05,0.00
2024-12-10 17:40:06,59,7884,20,39,5178.79,8748.00,0.00
2024-12-10 17:40:06,60,7884,21,39,5092.48,8748.02,0.00
2024-12-10 17:40:06,59,7884,21,38,5172.86,8748.02,0.00
2024-12-10 17:40:06,58,7884,20,38,5215.63,8748.09,0.00
2024-12-10 17:40:06,58,7885,20,38,5287.11,8749.00,0.00
2024-12-10 17:40:06,59,7885,21,38,5197.50,8749.02,0.00
2024-12-10 17:40:06,59,7886,21,38,5171.40,8750.00,0.00
2024-12-10 17:40:06,60,7886,21,39,5085.21,8750.02,0.00
2024-12-10 17:40:06,59,7886,21,38,5168.43,8750.02,0.00
2024-12-10 17:40:06,59,7887,21,38,5171.99,8751.00,0.00
2024-12-10 17:40:06,60,7887,21,39,5085.79,8751.02,0.00
2024-12-10 17:40:06,60,7888,21,39,5058.65,8752.00,0.00
2024-12-10 17:40:06,61,7888,21,40,4975.72,8752.02,0.00
2024-12-10 17:40:06,60,7888,21,39,5054.28,8752.02,0.00
2024-12-10 17:40:06,59,7888,20,39,5051.41,8752.85,0.00
2024-12-10 17:40:06,59,7889,20,39,5186.52,8753.00,0.00
2024-12-10 17:40:06,60,7889,21,39,5100.08,8753.02,0.00
2024-12-10 17:40:06,60,7890,21,39,5072.94,8754.00,0.00
2024-12-10 17:40:06,61,7890,22,39,4989.78,8754.02,0.00
2024-12-10 17:40:06,60,7890,22,38,5068.56,8754.02,0.00
2024-12-10 17:40:06,60,7891,22,38,5070.60,8755.00,0.00
2024-12-10 17:40:06,61,7891,22,39,4987.48,8755.02,0.00
2024-12-10 17:40:06,61,7892,22,39,4959.34,8756.00,0.00
2024-12-10 17:40:06,62,7892,22,40,4879.35,8756.02,0.00
2024-12-10 17:40:06,61,7892,22,39,4953.60,8756.02,0.00
2024-12-10 17:40:06,61,7893,22,39,4954.16,8757.00,0.00
2024-12-10 17:40:06,62,7893,22,40,4874.26,8757.02,0.00
2024-12-10 17:40:06,62,7894,22,40,4845.15,8758.00,0.00
2024-12-10 17:40:06,63,7894,23,40,4768.24,8758.02,0.00
2024-12-10 17:40:06,62,7894,23,39,4835.26,8758.03,0.00
2024-12-10 17:40:06,61,7894,22,39,4812.89,8758.61,0.00
2024-12-10 17:40:06,61,7895,22,39,4922.27,8759.00,0.00
2024-12-10 17:40:06,62,7895,23,39,4842.88,8759.02,0.00
2024-12-10 17:40:06,61,7895,22,39,4780.44,8759.67,0.00
2024-12-10 17:40:07,61,7896,22,39,4895.55,8760.00,0.00
2024-12-10 17:40:07,62,7896,22,40,4816.58,8760.02,0.00
2024-12-10 17:40:07,61,7896,22,39,4885.50,8760.03,0.00
2024-12-10 17:40:07,61,7897,22,39,4887.49,8761.00,0.00
2024-12-10 17:40:07,62,7897,22,40,4808.66,8761.02,0.00
2024-12-10 17:40:07,61,7897,21,40,4855.89,8761.02,0.00
2024-12-10 17:40:07,61,7898,21,40,4885.17,8762.00,0.00
2024-12-10 17:40:07,62,7898,21,41,4806.38,8762.02,0.00
2024-12-10 17:40:07,61,7898,21,40,4873.68,8762.02,0.00
2024-12-10 17:40:07,61,7899,21,40,4874.24,8763.00,0.00
2024-12-10 17:40:07,62,7899,21,41,4795.62,8763.02,0.00
2024-12-10 17:40:07,61,7899,20,41,4728.03,8763.69,0.00
2024-12-10 17:40:07,61,7900,20,41,4844.62,8764.00,0.00
2024-12-10 17:40:07,62,7900,20,42,4766.48,8764.02,0.00
2024-12-10 17:40:07,61,7900,20,41,4834.56,8764.02,0.00
2024-12-10 17:40:07,60,7900,19,41,4877.27,8764.27,0.00
2024-12-10 17:40:07,60,7901,19,41,4959.53,8765.00,0.00
2024-12-10 17:40:07,61,7901,19,42,4878.22,8765.02,0.00
2024-12-10 17:40:07,61,7902,19,42,4888.55,8766.00,0.00
2024-12-10 17:40:07,62,7902,20,42,4809.70,8766.02,0.00
2024-12-10 17:40:07,62,7903,20,42,4801.46,8767.00,0.00
2024-12-10 17:40:07,63,7903,20,43,4725.25,8767.02,0.00
2024-12-10 17:40:07,63,7904,20,43,4695.69,8768.00,0.00
2024-12-10 17:40:07,64,7904,21,43,4622.32,8768.02,0.00
2024-12-10 17:40:07,63,7904,21,42,4687.34,8768.02,0.00
2024-12-10 17:40:07,62,7904,20,42,4702.44,8768.69,0.00
2024-12-10 17:40:07,62,7905,20,42,4760.66,8769.00,0.00
2024-12-10 17:40:07,63,7905,20,43,4685.09,8769.02,0.00
2024-12-10 17:40:07,62,7905,19,43,4643.69,8769.85,0.00
2024-12-10 17:40:07,62,7906,19,43,4772.52,8770.00,0.00
2024-12-10 17:40:07,63,7906,19,44,4696.76,8770.02,0.00
2024-12-10 17:40:07,62,7906,19,43,4762.61,8770.02,0.00
2024-12-10 17:40:07,61,7906,18,43,4824.09,8770.16,0.00
2024-12-10 17:40:07,61,7907,18,43,4895.04,8771.00,0.00
2024-12-10 17:40:07,62,7907,18,44,4816.09,8771.02,0.00
2024-12-10 17:40:07,61,7907,17,44,4762.71,8771.94,0.00
2024-12-10 17:40:07,61,7908,17,44,4900.81,8772.00,0.00
2024-12-10 17:40:07,62,7908,18,44,4821.77,8772.02,0.00
2024-12-10 17:40:07,61,7908,18,43,4889.31,8772.02,0.00
2024-12-10 17:40:07,61,7909,18,43,4889.87,8773.00,0.00
2024-12-10 17:40:07,62,7909,18,44,4811.00,8773.02,0.00
2024-12-10 17:40:07,62,7910,18,44,4781.83,8774.00,0.00
2024-12-10 17:40:07,63,7910,18,45,4705.93,8774.02,0.00
2024-12-10 17:40:07,62,7910,18,44,4771.92,8774.02,0.00
2024-12-10 17:40:07,62,7911,18,44,4771.05,8775.00,0.00
2024-12-10 17:40:07,63,7911,18,45,4695.32,8775.02,0.00
2024-12-10 17:40:07,63,7912,18,45,4665.94,8776.00,0.00
2024-12-10 17:40:07,64,7912,18,46,4593.03,8776.02,0.00
2024-12-10 17:40:07,63,7912,18,45,4657.58,8776.02,0.00
2024-12-10 17:40:07,62,7912,17,45,4720.01,8776.16,0.00
2024-12-10 17:40:07,61,7912,16,45,4715.04,8776.89,0.00
2024-12-10 17:40:07,61,7913,16,45,4848.93,8777.00,0.00
2024-12-10 17:40:07,62,7913,16,46,4770.72,8777.02,0.00
2024-12-10 17:40:07,61,7913,15,46,4717.04,8777.94,0.00
2024-12-10 17:40:07,61,7914,15,46,4855.24,8778.00,0.00
2024-12-10 17:40:07,62,7914,15,47,4776.93,8778.02,0.00
2024-12-10 17:40:07,61,7914,15,46,4848.04,8778.02,0.00
2024-12-10 17:40:07,61,7915,15,46,4848.60,8779.00,0.00
2024-12-10 17:40:07,62,7915,16,46,4770.39,8779.02,0.00
2024-12-10 17:40:07,61,7915,15,46,4765.26,8779.39,0.00
2024-12-10 17:40:07,61,7916,15,46,4856.34,8780.00,0.00
2024-12-10 17:40:07,62,7916,16,46,4778.02,8780.02,0.00
2024-12-10 17:40:07,61,7916,16,45,4849.15,8780.02,0.00
2024-12-10 17:40:07,61,7917,16,45,4849.70,8781.00,0.00
2024-12-10 17:40:07,62,7917,17,45,4771.48,8781.02,0.00
2024-12-10 17:40:07,61,7917,16,45,4763.47,8781.41,0.00
2024-12-10 17:40:07,61,7918,16,45,4856.01,8782.00,0.00
2024-12-10 17:40:07,62,7918,16,46,4777.69,8782.02,0.00
2024-12-10 17:40:07,61,7918,16,45,4850.25,8782.02,0.00
2024-12-10 17:40:07,60,7918,15,45,4915.04,8782.18,0.00
2024-12-10 17:40:07,60,7919,15,45,4931.65,8783.00,0.00
2024-12-10 17:40:07,61,7919,15,46,4850.81,8783.02,0.00
2024-12-10 17:40:07,61,7920,15,46,4822.56,8784.00,0.00
2024-12-10 17:40:07,62,7920,15,47,4744.77,8784.02,0.00
2024-12-10 17:40:07,61,7920,15,46,4818.24,8784.02,0.00
2024-12-10 17:40:07,60,7920,14,46,4789.27,8784.97,0.00
2024-12-10 17:40:08,60,7921,14,46,4932.78,8785.00,0.00
2024-12-10 17:40:08,61,7921,15,46,4851.91,8785.02,0.00
2024-12-10 17:40:08,60,7921,14,46,4852.36,8785.37,0.00
2024-12-10 17:40:08,60,7922,14,46,4943.59,8786.00,0.00
2024-12-10 17:40:08,61,7922,14,47,4862.54,8786.02,0.00
2024-12-10 17:40:08,60,7922,14,46,4940.66,8786.02,0.00
2024-12-10 17:40:08,60,7923,14,46,4942.69,8787.00,0.00
2024-12-10 17:40:08,61,7923,15,46,4861.66,8787.02,0.00
2024-12-10 17:40:08,61,7924,15,46,4833.40,8788.00,0.00
2024-12-10 17:40:08,62,7924,15,47,4755.44,8788.02,0.00
2024-12-10 17:40:08,61,7924,15,46,4830.52,8788.02,0.00
2024-12-10 17:40:08,61,7925,15,46,4831.07,8789.00,0.00
2024-12-10 17:40:08,62,7925,15,47,4753.15,8789.02,0.00
2024-12-10 17:40:08,62,7926,15,47,4723.91,8790.00,0.00
2024-12-10 17:40:08,63,7926,16,47,4648.93,8790.02,0.00
2024-12-10 17:40:08,62,7926,16,46,4721.08,8790.02,0.00
2024-12-10 17:40:08,61,7926,15,46,4695.21,8790.94,0.00
2024-12-10 17:40:08,61,7927,15,46,4833.61,8791.00,0.00
2024-12-10 17:40:08,62,7927,15,47,4755.65,8791.02,0.00
2024-12-10 17:40:08,62,7928,15,47,4726.41,8792.00,0.00
2024-12-10 17:40:08,63,7928,16,47,4651.38,8792.02,0.00
2024-12-10 17:40:08,62,7928,16,46,4724.99,8792.02,0.00
2024-12-10 17:40:08,61,7928,15,46,4783.78,8792.23,0.00
2024-12-10 17:40:08,61,7929,15,46,4802.99,8793.00,0.00
2024-12-10 17:40:08,62,7929,15,47,4725.53,8793.02,0.00
2024-12-10 17:40:08,61,7929,14,47,4693.84,8793.82,0.00
2024-12-10 17:40:08,61,7930,14,47,4822.28,8794.00,0.00
2024-12-10 17:40:08,62,7930,14,48,4744.50,8794.02,0.00
2024-12-10 17:40:08,61,7930,14,47,4804.98,8794.02,0.00
2024-12-10 17:40:08,60,7930,13,47,4864.61,8794.23,0.00
2024-12-10 17:40:08,61,7929,13,48,4740.46,8794.77,0.00
2024-12-10 17:40:08,61,7930,13,48,4831.48,8795.00,0.00
2024-12-10 17:40:08,62,7930,13,49,4753.55,8795.02,0.00
2024-12-10 17:40:08,62,7931,13,49,4866.17,8796.00,0.00
2024-12-10 17:40:08,63,7931,13,50,4788.93,8796.02,0.00
2024-12-10 17:40:08,62,7931,13,49,4861.92,8796.03,0.00
2024-12-10 17:40:08,61,7931,12,49,4868.25,8796.49,0.00
2024-12-10 17:40:08,61,7932,12,49,4968.14,8797.00,0.00
2024-12-10 17:40:08,62,7932,12,50,4888.01,8797.02,0.00
2024-12-10 17:40:08,61,7932,11,50,4939.30,8797.02,0.00
2024-12-10 17:40:08,61,7933,11,50,4968.70,8798.00,0.00
2024-12-10 17:40:08,62,7933,12,50,4888.56,8798.02,0.00
2024-12-10 17:40:08,61,7933,12,49,4967.26,8798.02,0.00
2024-12-10 17:40:08,61,7934,12,49,4967.83,8799.00,0.00
2024-12-10 17:40:08,62,7934,13,49,4887.70,8799.02,0.00
2024-12-10 17:40:08,61,7934,12,49,4848.53,8799.85,0.00
2024-12-10 17:40:08,61,7935,12,49,4979.93,8800.00,0.00
2024-12-10 17:40:08,62,7935,12,50,4899.61,8800.02,0.00
2024-12-10 17:40:08,61,7935,12,49,4977.05,8800.02,0.00
2024-12-10 17:40:08,61,7936,12,49,4977.61,8801.00,0.00
2024-12-10 17:40:08,62,7936,12,50,4897.33,8801.02,0.00
2024-12-10 17:40:08,63,7935,13,50,4712.09,8801.32,0.00
2024-12-10 17:40:08,63,7936,13,50,4919.34,8802.00,0.00
2024-12-10 17:40:08,64,7936,14,50,4842.47,8802.02,0.00
2024-12-10 17:40:08,63,7936,14,49,4916.54,8802.02,0.00
2024-12-10 17:40:08,62,7936,13,49,4980.28,8802.19,0.00
2024-12-10 17:40:08,62,7937,13,49,5136.97,8803.00,0.00
2024-12-10 17:40:08,63,7937,14,49,5055.43,8803.02,0.00
2024-12-10 17:40:08,63,7938,14,49,5025.26,8804.00,0.00
2024-12-10 17:40:08,64,7938,14,50,4946.74,8804.02,0.00
2024-12-10 17:40:08,63,7938,14,49,5022.47,8804.02,0.00
2024-12-10 17:40:08,62,7938,13,49,5087.90,8804.18,0.00
2024-12-10 17:40:08,62,7939,13,49,5101.22,8805.00,0.00
2024-12-10 17:40:08,63,7939,13,50,5020.25,8805.02,0.00
2024-12-10 17:40:08,62,7939,13,49,5071.39,8805.02,0.00
2024-12-10 17:40:08,62,7940,13,49,5070.55,8806.00,0.00
2024-12-10 17:40:08,63,7940,14,49,4990.06,8806.02,0.00
2024-12-10 17:40:08,62,7940,14,48,5040.72,8806.02,0.00
2024-12-10 17:40:08,61,7940,13,48,5111.84,8806.15,0.00
2024-12-10 17:40:08,60,7940,12,48,5195.57,8806.15,0.00
2024-12-10 17:40:08,60,7941,12,48,5209.34,8807.00,0.00
2024-12-10 17:40:08,61,7941,13,48,5123.94,8807.02,0.00
2024-12-10 17:40:08,60,7941,13,47,5178.51,8807.02,0.00
2024-12-10 17:40:08,60,7942,13,47,5180.57,8808.00,0.00
2024-12-10 17:40:08,61,7942,13,48,5095.64,8808.02,0.00
2024-12-10 17:40:08,60,7942,13,47,5149.74,8808.02,0.00
2024-12-10 17:40:08,59,7942,12,47,5181.93,8808.65,0.00
2024-12-10 17:40:08,59,7943,12,47,5240.42,8809.00,0.00
2024-12-10 17:40:08,60,7943,13,47,5153.08,8809.02,0.00
2024-12-10 17:40:08,59,7943,13,46,5209.06,8809.02,0.00
2024-12-10 17:40:08,58,7943,12,46,5212.98,8809.81,0.00
2024-12-10 17:40:08,58,7944,12,46,5348.29,8810.00,0.00
2024-12-10 17:40:08,59,7944,13,46,5257.65,8810.02,0.00
2024-12-10 17:40:08,58,7944,13,45,5316.40,8810.02,0.00
2024-12-10 17:40:08,58,7945,13,45,5319.26,8811.00,0.00
2024-12-10 17:40:08,59,7945,14,45,5229.10,8811.02,0.00
2024-12-10 17:40:09,59,7946,14,45,5199.41,8812.00,0.00
2024-12-10 17:40:09,60,7946,14,46,5112.75,8812.02,0.00
2024-12-10 17:40:09,59,7946,14,45,5197.91,8812.02,0.00
2024-12-10 17:40:09,58,7946,13,45,5172.72,8812.97,0.00
2024-12-10 17:40:09,58,7947,13,45,5321.64,8813.00,0.00
2024-12-10 17:40:09,59,7947,14,45,5231.45,8813.02,0.00
2024-12-10 17:40:09,58,7947,13,45,5169.05,8813.66,0.00
2024-12-10 17:40:09,58,7948,13,45,5290.20,8814.00,0.00
2024-12-10 17:40:09,59,7948,14,45,5200.54,8814.02,0.00
2024-12-10 17:40:09,58,7948,14,44,5287.16,8814.02,0.00
2024-12-10 17:40:09,57,7948,13,44,5369.15,8814.14,0.00
2024-12-10 17:40:09,57,7949,13,44,5377.56,8815.00,0.00
2024-12-10 17:40:09,58,7949,14,44,5284.84,8815.02,0.00
2024-12-10 17:40:09,57,7949,13,44,5250.58,8815.82,0.00
2024-12-10 17:40:09,57,7950,13,44,5389.92,8816.00,0.00
2024-12-10 17:40:09,58,7950,13,45,5296.99,8816.02,0.00
2024-12-10 17:40:09,57,7950,13,44,5383.73,8816.02,0.00
2024-12-10 17:40:09,56,7950,12,44,5431.90,8816.48,0.00
2024-12-10 17:40:09,56,7951,12,44,5475.49,8817.00,0.00
2024-12-10 17:40:09,57,7951,12,45,5379.43,8817.02,0.00
2024-12-10 17:40:09,57,7952,12,45,5347.69,8818.00,0.00
2024-12-10 17:40:09,58,7952,12,46,5255.49,8818.02,0.00
2024-12-10 17:40:09,57,7952,12,45,5343.05,8818.02,0.00
2024-12-10 17:40:09,57,7953,12,45,5339.43,8819.00,0.00
2024-12-10 17:40:09,58,7953,13,45,5247.38,8819.02,0.00
2024-12-10 17:40:09,57,7953,12,45,5224.04,8819.75,0.00
2024-12-10 17:40:09,57,7954,12,45,5357.30,8820.00,0.00
2024-12-10 17:40:09,58,7954,12,46,5264.93,8820.02,0.00
2024-12-10 17:40:09,57,7954,12,45,5344.92,8820.02,0.00
2024-12-10 17:40:09,57,7955,12,45,5335.70,8821.00,0.00
2024-12-10 17:40:09,58,7955,13,45,5243.70,8821.02,0.00
2024-12-10 17:40:09,57,7955,12,45,5245.97,8821.09,0.00
2024-12-10 17:40:09,57,7956,12,45,5303.30,8822.00,0.00
2024-12-10 17:40:09,58,7956,13,45,5211.86,8822.02,0.00
2024-12-10 17:40:09,57,7956,13,44,5284.74,8822.05,0.00
2024-12-10 17:40:09,57,7957,13,44,5275.35,8823.00,0.00
2024-12-10 17:40:09,58,7957,14,44,5184.40,8823.02,0.00
2024-12-10 17:40:09,58,7958,14,44,5140.03,8824.00,0.00
2024-12-10 17:40:09,59,7958,14,45,5052.91,8824.02,0.00
2024-12-10 17:40:09,58,7958,14,44,5123.31,8824.05,0.00
2024-12-10 17:40:09,57,7958,13,44,5155.42,8824.67,0.00
2024-12-10 17:40:09,57,7959,13,44,5219.13,8825.00,0.00
2024-12-10 17:40:09,58,7959,14,44,5129.15,8825.02,0.00
2024-12-10 17:40:09,58,7960,14,44,5103.86,8826.00,0.00
2024-12-10 17:40:09,59,7960,15,44,5017.35,8826.02,0.00
2024-12-10 17:40:09,58,7960,15,43,5085.62,8826.05,0.00
2024-12-10 17:40:09,57,7960,14,43,5117.89,8826.69,0.00
2024-12-10 17:40:09,56,7960,13,43,5182.58,8826.82,0.00
2024-12-10 17:40:09,56,7961,13,43,5324.57,8827.00,0.00
2024-12-10 17:40:09,57,7961,14,43,5231.16,8827.02,0.00
2024-12-10 17:40:09,57,7961,14,43,5206.97,8828.00,0.00
2024-12-10 17:40:09,58,7961,14,44,5117.19,8828.02,0.00
2024-12-10 17:40:09,57,7961,14,43,5189.95,8828.05,0.00
2024-12-10 17:40:09,57,7962,14,43,5199.81,8829.00,0.00
2024-12-10 17:40:09,58,7962,14,44,5110.16,8829.02,0.00
2024-12-10 17:40:09,58,7963,14,44,5084.86,8830.00,0.00
2024-12-10 17:40:09,59,7963,14,45,4998.68,8830.02,0.00
2024-12-10 17:40:09,58,7963,14,44,5069.65,8830.05,0.00
2024-12-10 17:40:09,57,7963,13,44,5047.36,8830.65,0.00
2024-12-10 17:40:09,57,7964,13,44,5171.55,8831.00,0.00
2024-12-10 17:40:09,58,7964,13,45,5082.39,8831.02,0.00
2024-12-10 17:40:09,58,7965,13,45,5057.08,8832.00,0.00
2024-12-10 17:40:09,59,7965,14,45,4971.36,8832.02,0.00
2024-12-10 17:40:09,58,7965,14,44,5040.34,8832.05,0.00
2024-12-10 17:40:09,57,7965,13,44,5012.88,8832.67,0.00
2024-12-10 17:40:09,57,7966,13,44,5138.63,8833.00,0.00
2024-12-10 17:40:09,58,7966,14,44,5050.04,8833.02,0.00
2024-12-10 17:40:09,58,7967,14,44,5024.72,8834.00,0.00
2024-12-10 17:40:09,59,7967,15,44,4939.55,8834.02,0.00
2024-12-10 17:40:09,58,7967,15,43,4997.31,8834.03,0.00
2024-12-10 17:40:09,58,7968,15,43,5003.96,8835.00,0.00
2024-12-10 17:40:10,59,7968,15,44,4919.15,8835.02,0.00
2024-12-10 17:40:10,58,7968,15,43,4991.78,8835.03,0.00
2024-12-10 17:40:10,59,7967,16,43,4850.60,8835.71,0.00
2024-12-10 17:40:10,59,7968,16,43,4940.67,8836.00,0.00
2024-12-10 17:40:10,60,7968,16,44,4858.33,8836.02,0.00
2024-12-10 17:40:10,60,7969,16,44,4978.17,8837.00,0.00
2024-12-10 17:40:10,61,7969,16,45,4896.56,8837.02,0.00
2024-12-10 17:40:10,60,7969,16,44,4967.87,8837.03,0.00
2024-12-10 17:40:10,59,7969,15,44,4950.72,8837.92,0.00
2024-12-10 17:40:10,59,7970,15,44,5093.08,8838.00,0.00
2024-12-10 17:40:10,60,7970,15,45,5008.20,8838.02,0.00
2024-12-10 17:40:10,59,7970,14,45,4960.26,8838.92,0.00
2024-12-10 17:40:10,59,7971,14,45,5102.65,8839.00,0.00
2024-12-10 17:40:10,60,7971,14,46,5017.60,8839.02,0.00
2024-12-10 17:40:10,59,7971,14,45,5093.67,8839.03,0.00
2024-12-10 17:40:10,58,7971,13,45,5078.13,8839.60,0.00
2024-12-10 17:40:10,58,7972,13,45,5195.78,8840.00,0.00
2024-12-10 17:40:10,59,7972,13,46,5107.72,8840.02,0.00
2024-12-10 17:40:10,58,7972,12,46,5046.74,8840.67,0.00
2024-12-10 17:40:10,58,7973,12,46,5170.46,8841.00,0.00
2024-12-10 17:40:10,59,7973,12,47,5082.82,8841.02,0.00
2024-12-10 17:40:10,58,7973,12,46,5162.85,8841.03,0.00
2024-12-10 17:40:10,58,7974,12,46,5169.52,8842.00,0.00
2024-12-10 17:40:10,59,7974,12,47,5081.90,8842.02,0.00
2024-12-10 17:40:10,58,7974,11,47,5038.67,8842.59,0.00
2024-12-10 17:40:10,57,7974,10,47,5117.82,8842.69,0.00
2024-12-10 17:40:10,57,7975,10,47,5245.29,8843.00,0.00
2024-12-10 17:40:10,58,7975,11,47,5154.86,8843.02,0.00
2024-12-10 17:40:10,57,7975,11,46,5239.10,8843.04,0.00
2024-12-10 17:40:10,56,7975,10,46,5269.65,8843.45,0.00
2024-12-10 17:40:10,56,7976,10,46,5378.54,8844.00,0.00
2024-12-10 17:40:10,57,7976,11,46,5284.18,8844.02,0.00
2024-12-10 17:40:10,57,7977,11,46,5259.95,8845.00,0.00
2024-12-10 17:40:10,58,7977,11,47,5169.26,8845.02,0.00
2024-12-10 17:40:10,57,7977,11,46,5253.74,8845.04,0.00
2024-12-10 17:40:10,57,7978,11,46,5262.09,8846.00,0.00
2024-12-10 17:40:10,58,7978,11,47,5171.37,8846.02,0.00
2024-12-10 17:40:10,58,7979,11,47,5146.02,8847.00,0.00
2024-12-10 17:40:10,59,7979,11,48,5058.80,8847.02,0.00
2024-12-10 17:40:10,58,7979,11,47,5139.92,8847.03,0.00
2024-12-10 17:40:10,57,7979,10,47,5115.54,8847.65,0.00
2024-12-10 17:40:11,57,7980,10,47,5240.00,8848.00,0.00
2024-12-10 17:40:11,58,7980,11,47,5149.65,8848.02,0.00
2024-12-10 17:40:11,58,7981,11,47,5124.30,8849.00,0.00
2024-12-10 17:40:11,59,7981,11,48,5037.45,8849.02,0.00
2024-12-10 17:40:11,58,7981,11,47,5119.72,8849.03,0.00
2024-12-10 17:40:11,58,7982,11,47,5126.41,8850.00,0.00
2024-12-10 17:40:11,59,7982,11,48,5039.52,8850.02,0.00
2024-12-10 17:40:11,59,7983,11,48,5013.08,8851.00,0.00
2024-12-10 17:40:11,60,7983,12,48,4929.53,8851.02,0.00
2024-12-10 17:40:11,59,7983,12,47,5010.08,8851.03,0.00
2024-12-10 17:40:11,58,7983,11,47,5031.18,8851.71,0.00
2024-12-10 17:40:11,58,7984,11,47,5158.09,8852.00,0.00
2024-12-10 17:40:11,59,7984,12,47,5070.66,8852.02,0.00
2024-12-10 17:40:11,59,7985,12,47,5044.23,8853.00,0.00
2024-12-10 17:40:11,60,7985,12,48,4960.15,8853.02,0.00
2024-12-10 17:40:11,59,7985,12,47,5041.23,8853.03,0.00
2024-12-10 17:40:11,58,7985,11,47,5024.87,8853.93,0.00
2024-12-10 17:40:11,58,7986,11,47,5171.46,8854.00,0.00
2024-12-10 17:40:11,59,7986,12,47,5083.81,8854.02,0.00
2024-12-10 17:40:11,58,7986,12,46,5137.88,8854.03,0.00
2024-12-10 17:40:11,58,7987,12,46,5144.57,8855.00,0.00
2024-12-10 17:40:11,59,7987,13,46,5057.37,8855.02,0.00
2024-12-10 17:40:11,58,7987,13,45,5110.98,8855.03,0.00
2024-12-10 17:40:11,58,7988,13,45,5117.66,8856.00,0.00
2024-12-10 17:40:11,59,7988,13,46,5030.92,8856.02,0.00
2024-12-10 17:40:11,59,7989,13,46,5013.55,8857.00,0.00
2024-12-10 17:40:11,60,7989,13,47,4929.99,8857.02,0.00
2024-12-10 17:40:11,59,7989,13,46,4985.03,8857.03,0.00
2024-12-10 17:40:11,58,7989,12,46,4952.33,8857.97,0.00
2024-12-10 17:40:11,58,7990,12,46,5102.02,8858.00,0.00
2024-12-10 17:40:11,59,7990,12,47,5015.55,8858.02,0.00
2024-12-10 17:40:11,58,7990,12,46,5069.95,8858.03,0.00
2024-12-10 17:40:11,58,7991,12,46,5076.63,8859.00,0.00
2024-12-10 17:40:11,59,7991,12,47,4990.59,8859.02,0.00
2024-12-10 17:40:11,58,7991,12,46,5044.56,8859.03,0.00
2024-12-10 17:40:11,58,7992,12,46,5051.23,8860.00,0.00
2024-12-10 17:40:11,59,7992,13,46,4965.62,8860.02,0.00
2024-12-10 17:40:11,59,7993,13,46,4939.15,8861.00,0.00
2024-12-10 17:40:11,60,7993,14,46,4856.83,8861.02,0.00
2024-12-10 17:40:11,59,7993,13,46,4937.65,8861.02,0.00
2024-12-10 17:40:11,58,7993,13,45,5019.72,8861.02,0.00
2024-12-10 17:40:11,58,7994,13,45,5024.87,8862.00,0.00
2024-12-10 17:40:11,59,7994,14,45,4939.71,8862.02,0.00
2024-12-10 17:40:11,59,7995,14,45,4913.22,8863.00,0.00
2024-12-10 17:40:11,60,7995,14,46,4831.33,8863.02,0.00
2024-12-10 17:40:11,59,7995,14,45,4911.72,8863.02,0.00
2024-12-10 17:40:11,58,7995,13,45,4934.10,8863.71,0.00
2024-12-10 17:40:11,58,7996,13,45,5000.03,8864.00,0.00
2024-12-10 17:40:11,59,7996,13,46,4915.28,8864.02,0.00
2024-12-10 17:40:11,58,7996,13,45,4967.93,8864.02,0.00
2024-12-10 17:40:11,58,7997,13,45,4973.08,8865.00,0.00
2024-12-10 17:40:11,59,7997,13,46,4888.79,8865.02,0.00
2024-12-10 17:40:11,59,7998,13,46,4862.29,8866.00,0.00
2024-12-10 17:40:11,60,7998,13,47,4781.25,8866.02,0.00
2024-12-10 17:40:11,59,7998,13,46,4860.79,8866.02,0.00
2024-12-10 17:40:11,58,7998,12,46,4865.51,8866.79,0.00
2024-12-10 17:40:11,58,7999,12,46,5000.19,8867.00,0.00
2024-12-10 17:40:11,59,7999,13,46,4915.44,8867.02,0.00
2024-12-10 17:40:11,59,8000,13,46,4888.94,8868.00,0.00
2024-12-10 17:40:11,60,8000,14,46,4807.46,8868.02,0.00
2024-12-10 17:40:11,59,8000,14,45,4887.44,8868.02,0.00
2024-12-10 17:40:11,59,8001,14,45,4890.99,8869.00,0.00
2024-12-10 17:40:11,60,8001,14,46,4809.48,8869.02,0.00
2024-12-10 17:40:11,59,8001,14,45,4859.43,8869.02,0.00
2024-12-10 17:40:11,58,8001,13,45,4844.29,8869.90,0.00
2024-12-10 17:40:12,58,8002,13,45,4988.12,8870.00,0.00
2024-12-10 17:40:12,59,8002,13,46,4903.57,8870.02,0.00
2024-12-10 17:40:12,58,8002,12,46,4937.70,8870.23,0.00
2024-12-10 17:40:12,58,8003,12,46,4961.15,8871.00,0.00
2024-12-10 17:40:12,59,8003,12,47,4877.06,8871.02,0.00
2024-12-10 17:40:12,58,8003,12,46,4959.62,8871.02,0.00
2024-12-10 17:40:12,57,8003,11,46,4983.17,8871.72,0.00
2024-12-10 17:40:12,56,8003,10,46,5043.74,8871.86,0.00
2024-12-10 17:40:12,56,8004,10,46,5189.61,8872.00,0.00
2024-12-10 17:40:12,57,8004,10,47,5098.56,8872.02,0.00
2024-12-10 17:40:12,57,8005,10,47,5074.23,8873.00,0.00
2024-12-10 17:40:12,58,8005,10,48,4986.75,8873.02,0.00
2024-12-10 17:40:12,57,8005,10,47,5072.68,8873.02,0.00
2024-12-10 17:40:12,57,8006,10,47,5079.47,8874.00,0.00
2024-12-10 17:40:12,58,8006,11,47,4991.90,8874.02,0.00
2024-12-10 17:40:12,57,8006,11,46,5046.78,8874.02,0.00
2024-12-10 17:40:12,56,8006,10,46,5072.27,8874.71,0.00
2024-12-10 17:40:12,56,8007,10,46,5205.63,8875.00,0.00
2024-12-10 17:40:12,57,8007,10,47,5114.30,8875.02,0.00
2024-12-10 17:40:12,56,8007,10,46,5173.93,8875.02,0.00
2024-12-10 17:40:12,56,8008,10,46,5182.44,8876.00,0.00
2024-12-10 17:40:12,57,8008,10,47,5091.52,8876.02,0.00
2024-12-10 17:40:12,56,8008,10,46,5150.74,8876.02,0.00
2024-12-10 17:40:12,56,8009,10,46,5159.24,8877.00,0.00
2024-12-10 17:40:12,57,8009,10,47,5068.73,8877.02,0.00
2024-12-10 17:40:12,56,8009,10,46,5127.54,8877.02,0.00
2024-12-10 17:40:12,56,8010,10,46,5136.05,8878.00,0.00
2024-12-10 17:40:12,57,8010,10,47,5045.94,8878.02,0.00
2024-12-10 17:40:12,56,8010,10,46,5104.34,8878.02,0.00
2024-12-10 17:40:12,56,8011,10,46,5112.84,8879.00,0.00
2024-12-10 17:40:12,57,8011,10,47,5023.14,8879.02,0.00
2024-12-10 17:40:12,57,8012,10,47,4998.78,8880.00,0.00
2024-12-10 17:40:12,58,8012,10,48,4912.60,8880.02,0.00
2024-12-10 17:40:12,57,8012,10,47,4997.22,8880.02,0.00
2024-12-10 17:40:12,56,8012,9,47,5024.94,8880.70,0.00
2024-12-10 17:40:12,56,8013,9,47,5156.81,8881.00,0.00
2024-12-10 17:40:12,57,8013,10,47,5066.34,8881.02,0.00
2024-12-10 17:40:12,56,8013,10,46,5123.51,8881.02,0.00
2024-12-10 17:40:12,55,8013,9,46,5163.49,8881.35,0.00
2024-12-10 17:40:12,55,8014,9,46,5267.31,8882.00,0.00
2024-12-10 17:40:12,56,8014,9,47,5173.25,8882.02,0.00
2024-12-10 17:40:12,55,8014,8,47,5222.14,8882.16,0.00
2024-12-10 17:40:12,55,8015,8,47,5245.29,8883.00,0.00
2024-12-10 17:40:12,56,8015,9,47,5151.63,8883.02,0.00
2024-12-10 17:40:12,55,8015,9,46,5242.06,8883.02,0.00
2024-12-10 17:40:12,54,8015,8,46,5326.02,8883.15,0.00
2024-12-10 17:40:12,54,8016,8,46,5349.61,8884.00,0.00
2024-12-10 17:40:12,55,8016,8,47,5252.35,8884.02,0.00
2024-12-10 17:40:12,54,8016,7,47,5295.37,8884.19,0.00
2024-12-10 17:40:12,54,8017,7,47,5388.06,8885.00,0.00
2024-12-10 17:40:12,55,8017,7,48,5290.09,8885.02,0.00
2024-12-10 17:40:12,54,8017,7,47,5386.41,8885.02,0.00
2024-12-10 17:40:12,54,8018,7,47,5398.54,8886.00,0.00
2024-12-10 17:40:12,55,8018,8,47,5300.38,8886.02,0.00
2024-12-10 17:40:12,54,8018,7,47,5286.68,8886.15,0.00
2024-12-10 17:40:12,54,8019,7,47,5376.10,8887.00,0.00
2024-12-10 17:40:12,55,8019,7,48,5278.36,8887.02,0.00
2024-12-10 17:40:12,54,8019,7,47,5372.81,8887.02,0.00
2024-12-10 17:40:12,54,8020,7,47,5384.94,8888.00,0.00
2024-12-10 17:40:12,55,8020,8,47,5287.03,8888.02,0.00
2024-12-10 17:40:13,54,8020,7,47,5228.90,8888.65,0.00
2024-12-10 17:40:13,54,8021,7,47,5362.50,8889.00,0.00
2024-12-10 17:40:13,55,8021,8,47,5265.00,8889.02,0.00
2024-12-10 17:40:13,54,8021,8,46,5355.92,8889.02,0.00
2024-12-10 17:40:13,54,8022,8,46,5368.04,8890.00,0.00
2024-12-10 17:40:13,55,8022,8,47,5270.44,8890.02,0.00
2024-12-10 17:40:13,54,8022,7,47,5241.76,8890.85,0.00
2024-12-10 17:40:13,54,8023,7,47,5393.34,8891.00,0.00
2024-12-10 17:40:13,55,8023,8,47,5295.28,8891.02,0.00
2024-12-10 17:40:13,54,8023,8,46,5383.46,8891.02,0.00
2024-12-10 17:40:13,54,8024,8,46,5395.60,8892.00,0.00
2024-12-10 17:40:13,55,8024,9,46,5297.49,8892.02,0.00
2024-12-10 17:40:13,55,8025,9,46,5287.31,8893.00,0.00
2024-12-10 17:40:13,56,8025,9,47,5192.89,8893.02,0.00
2024-12-10 17:40:13,56,8026,9,47,5168.56,8894.00,0.00
2024-12-10 17:40:13,57,8026,10,47,5077.89,8894.02,0.00
2024-12-10 17:40:13,56,8026,10,46,5165.39,8894.02,0.00
2024-12-10 17:40:13,55,8026,9,46,5132.60,8894.96,0.00
2024-12-10 17:40:13,55,8027,9,46,5291.11,8895.00,0.00
2024-12-10 17:40:13,56,8027,10,46,5196.63,8895.02,0.00
2024-12-10 17:40:13,56,8028,10,46,5169.53,8896.00,0.00
2024-12-10 17:40:13,57,8028,11,46,5078.84,8896.02,0.00
2024-12-10 17:40:13,56,8028,11,45,5164.76,8896.02,0.00
2024-12-10 17:40:13,56,8029,11,45,5167.60,8897.00,0.00
2024-12-10 17:40:13,57,8029,11,46,5076.94,8897.02,0.00
2024-12-10 17:40:13,57,8030,11,46,5044.12,8898.00,0.00
2024-12-10 17:40:13,58,8030,12,46,4957.15,8898.02,0.00
2024-12-10 17:40:13,57,8030,12,45,5039.43,8898.02,0.00
2024-12-10 17:40:13,56,8030,11,45,5042.07,8898.77,0.00
2024-12-10 17:40:13,56,8031,11,45,5180.49,8899.00,0.00
2024-12-10 17:40:13,57,8031,12,45,5089.60,8899.02,0.00
2024-12-10 17:40:13,57,8032,12,45,5051.10,8900.00,0.00
2024-12-10 17:40:13,58,8032,12,46,4964.01,8900.02,0.00
2024-12-10 17:40:13,57,8032,12,45,5043.29,8900.02,0.00
2024-12-10 17:40:13,56,8032,11,45,5072.77,8900.61,0.00
2024-12-10 17:40:13,56,8033,11,45,5133.46,8901.00,0.00
2024-12-10 17:40:13,57,8033,12,45,5043.40,8901.02,0.00
2024-12-10 17:40:13,57,8034,12,45,5018.97,8902.00,0.00
2024-12-10 17:40:13,58,8034,12,46,4932.44,8902.02,0.00
2024-12-10 17:40:13,57,8034,12,45,5008.54,8902.02,0.00
2024-12-10 17:40:13,57,8035,12,45,5015.35,8903.00,0.00
2024-12-10 17:40:13,58,8035,13,45,4928.88,8903.02,0.00
2024-12-10 17:40:13,58,8036,13,45,4903.34,8904.00,0.00
2024-12-10 17:40:13,59,8036,14,45,4820.23,8904.02,0.00
2024-12-10 17:40:13,58,8036,14,44,4894.13,8904.02,0.00
2024-12-10 17:40:13,58,8037,14,44,4899.28,8905.00,0.00
2024-12-10 17:40:13,59,8037,14,45,4816.24,8905.02,0.00
2024-12-10 17:40:13,58,8037,13,45,4853.27,8905.19,0.00
2024-12-10 17:40:13,58,8038,13,45,4873.73,8906.00,0.00
2024-12-10 17:40:13,59,8038,14,45,4791.12,8906.02,0.00
2024-12-10 17:40:13,58,8038,14,44,4866.05,8906.02,0.00
2024-12-10 17:40:13,57,8038,13,44,4839.45,8906.97,0.00
2024-12-10 17:40:13,57,8039,13,44,4992.61,8907.00,0.00
2024-12-10 17:40:13,58,8039,13,45,4906.53,8907.02,0.00
2024-12-10 17:40:13,57,8039,12,45,4902.31,8907.69,0.00
2024-12-10 17:40:13,57,8040,12,45,4968.16,8908.00,0.00
2024-12-10 17:40:13,58,8040,13,45,4882.50,8908.02,0.00
2024-12-10 17:40:13,57,8040,13,44,4961.91,8908.02,0.00
2024-12-10 17:40:13,56,8040,12,44,4949.20,8908.91,0.00
2024-12-10 17:40:13,56,8041,12,44,5100.40,8909.00,0.00
2024-12-10 17:40:13,57,8041,12,45,5010.92,8909.02,0.00
2024-12-10 17:40:13,56,8041,11,45,5003.51,8909.41,0.00
2024-12-10 17:40:13,56,8042,11,45,5110.52,8910.00,0.00
2024-12-10 17:40:13,57,8042,12,45,5020.86,8910.02,0.00
2024-12-10 17:40:13,56,8042,12,44,5100.97,8910.02,0.00
2024-12-10 17:40:13,55,8042,11,44,5072.03,8910.67,0.00
2024-12-10 17:40:13,55,8043,11,44,5205.11,8911.00,0.00
2024-12-10 17:40:13,56,8043,11,45,5112.17,8911.02,0.00
2024-12-10 17:40:13,56,8044,11,45,5086.59,8912.00,0.00
2024-12-10 17:40:13,57,8044,11,46,4997.35,8912.02,0.00
2024-12-10 17:40:13,56,8044,11,45,5078.64,8912.02,0.00
2024-12-10 17:40:13,56,8045,11,45,5083.16,8913.00,0.00
2024-12-10 17:40:13,57,8045,12,45,4993.99,8913.02,0.00
2024-12-10 17:40:13,56,8045,11,45,4933.61,8913.96,0.00
2024-12-10 17:40:13,56,8046,11,45,5089.62,8914.00,0.00
2024-12-10 17:40:13,57,8046,12,45,5000.33,8914.02,0.00
2024-12-10 17:40:13,56,8046,12,44,5083.26,8914.02,0.00
2024-12-10 17:40:14,56,8047,12,44,5085.75,8915.00,0.00
2024-12-10 17:40:14,57,8047,12,45,4996.53,8915.02,0.00
2024-12-10 17:40:14,56,8047,11,45,4987.24,8915.70,0.00
2024-12-10 17:40:14,56,8048,11,45,5055.93,8916.00,0.00
2024-12-10 17:40:14,57,8048,12,45,4967.23,8916.02,0.00
2024-12-10 17:40:14,56,8048,12,44,5051.16,8916.02,0.00
2024-12-10 17:40:14,57,8047,12,45,4956.30,8916.12,0.00
2024-12-10 17:40:14,56,8047,11,45,5046.67,8916.96,0.00
2024-12-10 17:40:14,56,8048,11,45,5202.73,8917.00,0.00
2024-12-10 17:40:14,57,8048,11,46,5111.46,8917.02,0.00
2024-12-10 17:40:14,57,8049,11,46,5236.31,8918.00,0.00
2024-12-10 17:40:14,58,8049,12,46,5146.03,8918.02,0.00
2024-12-10 17:40:14,57,8049,12,45,5233.18,8918.02,0.00
2024-12-10 17:40:14,57,8050,12,45,5231.74,8919.00,0.00
2024-12-10 17:40:14,58,8050,12,46,5141.54,8919.02,0.00
2024-12-10 17:40:14,58,8051,12,46,5106.58,8920.00,0.00
2024-12-10 17:40:14,59,8051,13,46,5020.03,8920.02,0.00
2024-12-10 17:40:14,58,8051,13,45,5105.04,8920.02,0.00
2024-12-10 17:40:14,58,8052,13,45,5099.54,8921.00,0.00
2024-12-10 17:40:14,59,8052,14,45,5013.10,8921.02,0.00
2024-12-10 17:40:14,58,8052,14,44,5067.24,8921.02,0.00
2024-12-10 17:40:14,58,8053,14,44,5060.68,8922.00,0.00
2024-12-10 17:40:14,59,8053,14,45,4974.91,8922.02,0.00
2024-12-10 17:40:14,58,8053,14,44,5028.38,8922.02,0.00
2024-12-10 17:40:14,57,8053,14,43,5071.62,8922.40,0.00
2024-12-10 17:40:14,57,8054,14,43,5112.72,8923.00,0.00
2024-12-10 17:40:14,58,8054,14,44,5024.57,8923.02,0.00
2024-12-10 17:40:14,58,8055,14,44,4998.98,8924.00,0.00
2024-12-10 17:40:14,59,8055,14,45,4914.25,8924.02,0.00
2024-12-10 17:40:14,58,8055,14,44,4992.84,8924.03,0.00
2024-12-10 17:40:14,57,8055,13,44,4980.47,8924.58,0.00
2024-12-10 17:40:14,57,8056,13,44,5099.77,8925.00,0.00
2024-12-10 17:40:14,58,8056,14,44,5011.85,8925.02,0.00
2024-12-10 17:40:14,57,8056,13,44,4971.62,8925.56,0.00
2024-12-10 17:40:14,57,8057,13,44,5089.38,8926.00,0.00
2024-12-10 17:40:14,58,8057,13,45,5001.64,8926.02,0.00
2024-12-10 17:40:14,57,8057,13,44,5084.70,8926.04,0.00
2024-12-10 17:40:15,57,8058,13,44,5093.09,8927.00,0.00
2024-12-10 17:40:15,58,8058,14,44,5005.27,8927.02,0.00
2024-12-10 17:40:15,57,8058,13,44,4985.22,8927.47,0.00
2024-12-10 17:40:15,57,8059,13,44,5095.22,8928.00,0.00
2024-12-10 17:40:15,58,8059,14,44,5007.37,8928.02,0.00
2024-12-10 17:40:15,57,8059,14,43,5090.54,8928.04,0.00
2024-12-10 17:40:15,57,8060,14,43,5098.93,8929.00,0.00
2024-12-10 17:40:15,58,8060,14,44,5011.01,8929.02,0.00
2024-12-10 17:40:15,57,8060,13,44,4980.30,8929.82,0.00
2024-12-10 17:40:15,57,8061,13,44,5121.43,8930.00,0.00
2024-12-10 17:40:15,58,8061,13,45,5033.13,8930.02,0.00
2024-12-10 17:40:15,57,8061,13,44,5118.31,8930.04,0.00
2024-12-10 17:40:15,56,8061,12,44,5133.55,8930.77,0.00
2024-12-10 17:40:15,56,8062,12,44,5272.48,8931.00,0.00
2024-12-10 17:40:15,57,8062,13,44,5179.98,8931.02,0.00
2024-12-10 17:40:15,57,8063,13,44,5155.49,8932.00,0.00
2024-12-10 17:40:15,58,8063,13,45,5066.60,8932.02,0.00
2024-12-10 17:40:15,57,8063,13,44,5150.80,8932.04,0.00
2024-12-10 17:40:15,57,8064,13,44,5159.20,8933.00,0.00
2024-12-10 17:40:15,58,8064,13,45,5070.25,8933.02,0.00
2024-12-10 17:40:15,58,8065,13,45,5044.63,8934.00,0.00
2024-12-10 17:40:15,59,8065,13,46,4959.12,8934.02,0.00
2024-12-10 17:40:15,58,8065,13,45,5038.48,8934.03,0.00
2024-12-10 17:40:15,57,8065,12,45,5050.45,8934.77,0.00
2024-12-10 17:40:15,57,8066,12,45,5187.00,8935.00,0.00
2024-12-10 17:40:15,58,8066,12,46,5097.57,8935.02,0.00
2024-12-10 17:40:15,58,8067,12,46,5071.95,8936.00,0.00
2024-12-10 17:40:15,59,8067,13,46,4985.98,8936.02,0.00
2024-12-10 17:40:15,58,8067,13,45,5067.34,8936.03,0.00
2024-12-10 17:40:15,58,8068,13,45,5074.06,8937.00,0.00
2024-12-10 17:40:15,59,8068,14,45,4988.05,8937.02,0.00
2024-12-10 17:40:15,58,8068,13,45,4967.90,8937.47,0.00
2024-12-10 17:40:15,58,8069,13,45,5074.62,8938.00,0.00
2024-12-10 17:40:15,59,8069,13,46,4988.61,8938.02,0.00
2024-12-10 17:40:15,58,8069,13,45,5071.56,8938.03,0.00
2024-12-10 17:40:15,58,8070,13,45,5078.27,8939.00,0.00
2024-12-10 17:40:15,59,8070,14,45,4992.20,8939.02,0.00
2024-12-10 17:40:15,58,8070,14,44,5044.38,8939.03,0.00
2024-12-10 17:40:15,58,8071,14,44,5051.10,8940.00,0.00
2024-12-10 17:40:15,59,8071,14,45,4965.49,8940.02,0.00
2024-12-10 17:40:15,58,8071,13,45,4938.97,8940.79,0.00
2024-12-10 17:40:15,58,8072,13,45,5074.79,8941.00,0.00
2024-12-10 17:40:15,59,8072,13,46,4988.77,8941.02,0.00
2024-12-10 17:40:15,58,8072,13,45,5068.63,8941.03,0.00
2024-12-10 17:40:15,57,8072,12,45,5035.51,8941.69,0.00
2024-12-10 17:40:15,57,8073,12,45,5164.40,8942.00,0.00
2024-12-10 17:40:15,58,8073,13,45,5075.35,8942.02,0.00
2024-12-10 17:40:15,57,8073,12,45,5029.73,8942.60,0.00
2024-12-10 17:40:15,57,8074,12,45,5150.85,8943.00,0.00
2024-12-10 17:40:15,58,8074,12,46,5062.04,8943.02,0.00
2024-12-10 17:40:15,57,8074,12,45,5146.16,8943.04,0.00
2024-12-10 17:40:15,57,8075,12,45,5149.05,8944.00,0.00
2024-12-10 17:40:15,58,8075,13,45,5060.27,8944.02,0.00
2024-12-10 17:40:15,58,8076,13,45,5023.19,8945.00,0.00
2024-12-10 17:40:15,59,8076,14,45,4938.06,8945.02,0.00
2024-12-10 17:40:15,58,8076,14,44,5020.12,8945.03,0.00
2024-12-10 17:40:15,58,8077,14,44,5014.64,8946.00,0.00
2024-12-10 17:40:15,59,8077,14,45,4929.64,8946.02,0.00
2024-12-10 17:40:15,58,8077,14,44,4980.72,8946.03,0.00
2024-12-10 17:40:16,58,8078,14,44,4976.58,8947.00,0.00
2024-12-10 17:40:16,59,8078,15,44,4892.23,8947.02,0.00
2024-12-10 17:40:16,59,8079,15,44,4857.96,8948.00,0.00
2024-12-10 17:40:16,60,8079,16,44,4777.00,8948.02,0.00
2024-12-10 17:40:16,59,8079,16,43,4853.42,8948.03,0.00
2024-12-10 17:40:16,59,8080,16,43,4855.66,8949.00,0.00
2024-12-10 17:40:16,60,8080,17,43,4774.73,8949.02,0.00
2024-12-10 17:40:16,60,8081,17,43,4745.11,8950.00,0.00
2024-12-10 17:40:16,61,8081,17,44,4667.32,8950.02,0.00
2024-12-10 17:40:16,60,8081,17,43,4742.14,8950.03,0.00
2024-12-10 17:40:16,60,8082,17,43,4742.80,8951.00,0.00
2024-12-10 17:40:16,61,8082,18,43,4665.05,8951.02,0.00
2024-12-10 17:40:16,60,8082,18,42,4709.99,8951.03,0.00
2024-12-10 17:40:16,59,8082,17,42,4678.04,8951.95,0.00
2024-12-10 17:40:16,59,8083,17,42,4825.24,8952.00,0.00
2024-12-10 17:40:16,60,8083,17,43,4744.82,8952.02,0.00
2024-12-10 17:40:16,59,8083,17,42,4791.87,8952.03,0.00
2024-12-10 17:40:16,58,8083,16,42,4856.02,8952.23,0.00
2024-12-10 17:40:16,57,8083,15,42,4895.01,8952.67,0.00
2024-12-10 17:40:16,57,8084,15,42,4959.65,8953.00,0.00
2024-12-10 17:40:16,58,8084,15,43,4874.14,8953.02,0.00
2024-12-10 17:40:16,57,8084,15,42,4925.10,8953.04,0.00
2024-12-10 17:40:16,57,8085,15,42,4924.80,8954.00,0.00
2024-12-10 17:40:16,58,8085,16,42,4839.89,8954.02,0.00
2024-12-10 17:40:16,57,8085,16,41,4853.83,8954.35,0.00
2024-12-10 17:40:16,56,8085,15,41,4903.97,8954.71,0.00
2024-12-10 17:40:16,56,8086,15,41,5038.49,8955.00,0.00
2024-12-10 17:40:16,57,8086,16,41,4950.09,8955.02,0.00
2024-12-10 17:40:16,56,8086,16,40,5035.30,8955.04,0.00
2024-12-10 17:40:16,56,8087,16,40,5045.45,8956.00,0.00
2024-12-10 17:40:16,57,8087,16,41,4956.93,8956.02,0.00
2024-12-10 17:40:16,56,8087,16,40,5010.27,8956.04,0.00
2024-12-10 17:40:16,56,8088,16,40,5018.53,8957.00,0.00
2024-12-10 17:40:16,57,8088,17,40,4930.49,8957.02,0.00
2024-12-10 17:40:16,56,8088,17,39,4983.36,8957.04,0.00
2024-12-10 17:40:16,56,8089,17,39,4989.90,8958.00,0.00
2024-12-10 17:40:16,57,8089,17,40,4902.36,8958.02,0.00
2024-12-10 17:40:16,56,8089,16,40,4883.32,8958.75,0.00
2024-12-10 17:40:16,56,8090,16,40,5021.08,8959.00,0.00
2024-12-10 17:40:16,57,8090,16,41,4932.99,8959.02,0.00
2024-12-10 17:40:16,56,8090,16,40,5017.89,8959.04,0.00
2024-12-10 17:40:16,55,8090,15,40,5096.14,8959.18,0.00
2024-12-10 17:40:16,55,8091,15,40,5121.09,8960.00,0.00
2024-12-10 17:40:16,56,8091,15,41,5029.64,8960.02,0.00
2024-12-10 17:40:16,55,8091,15,40,5085.26,8960.04,0.00
2024-12-10 17:40:16,56,8090,16,40,4941.93,8960.66,0.00
2024-12-10 17:40:16,55,8090,15,40,5036.79,8960.82,0.00
2024-12-10 17:40:16,55,8091,15,40,5183.57,8961.00,0.00
2024-12-10 17:40:16,56,8091,15,41,5091.01,8961.02,0.00
2024-12-10 17:40:16,55,8091,14,41,5071.33,8961.45,0.00
2024-12-10 17:40:16,55,8092,14,41,5348.73,8962.00,0.00
2024-12-10 17:40:16,56,8092,14,42,5253.21,8962.02,0.00
2024-12-10 17:40:16,55,8092,14,41,5345.48,8962.04,0.00
2024-12-10 17:40:16,55,8093,14,41,5357.47,8963.00,0.00
2024-12-10 17:40:16,56,8093,15,41,5261.80,8963.02,0.00
2024-12-10 17:40:16,55,8093,14,41,5307.00,8963.18,0.00
2024-12-10 17:40:16,55,8094,14,41,5397.18,8964.00,0.00
2024-12-10 17:40:16,56,8094,14,42,5300.81,8964.02,0.00
2024-12-10 17:40:16,55,8094,14,41,5393.93,8964.04,0.00
2024-12-10 17:40:16,54,8094,13,41,5436.04,8964.67,0.00
2024-12-10 17:40:16,54,8095,13,41,5506.05,8965.00,0.00
2024-12-10 17:40:16,55,8095,14,41,5405.94,8965.02,0.00
2024-12-10 17:40:16,54,8095,14,40,5469.53,8965.04,0.00
2024-12-10 17:40:16,54,8096,14,40,5483.42,8966.00,0.00
2024-12-10 17:40:16,55,8096,14,41,5383.72,8966.02,0.00
2024-12-10 17:40:16,54,8096,13,41,5435.31,8966.17,0.00
2024-12-10 17:40:17,54,8097,13,41,5527.20,8967.00,0.00
2024-12-10 17:40:17,55,8097,13,42,5426.71,8967.02,0.00
2024-12-10 17:40:17,54,8097,13,41,5523.89,8967.04,0.00
2024-12-10 17:40:17,54,8098,13,41,5537.78,8968.00,0.00
2024-12-10 17:40:17,55,8098,14,41,5437.09,8968.02,0.00
2024-12-10 17:40:17,55,8099,14,41,5414.73,8969.00,0.00
2024-12-10 17:40:17,56,8099,15,41,5318.03,8969.02,0.00
2024-12-10 17:40:17,55,8099,15,40,5409.84,8969.04,0.00
2024-12-10 17:40:17,55,8100,15,40,5420.41,8970.00,0.00
2024-12-10 17:40:17,56,8100,15,41,5323.62,8970.02,0.00
2024-12-10 17:40:17,56,8101,15,41,5296.55,8971.00,0.00
2024-12-10 17:40:17,57,8101,15,42,5203.63,8971.02,0.00
2024-12-10 17:40:17,56,8101,15,41,5290.15,8971.04,0.00
2024-12-10 17:40:17,56,8102,15,41,5292.27,8972.00,0.00
2024-12-10 17:40:17,57,8102,16,41,5199.42,8972.02,0.00
2024-12-10 17:40:17,56,8102,15,41,5158.36,8972.86,0.00
2024-12-10 17:40:17,56,8103,15,41,5305.88,8973.00,0.00
2024-12-10 17:40:17,57,8103,15,42,5212.79,8973.02,0.00
2024-12-10 17:40:17,56,8103,15,41,5296.27,8973.04,0.00
2024-12-10 17:40:17,56,8104,15,41,5298.83,8974.00,0.00
2024-12-10 17:40:17,57,8104,16,41,5205.86,8974.02,0.00
2024-12-10 17:40:17,58,8103,16,42,5065.19,8974.21,0.00
2024-12-10 17:40:17,58,8104,16,42,5175.58,8975.00,0.00
2024-12-10 17:40:17,59,8104,16,43,5087.86,8975.02,0.00
2024-12-10 17:40:17,58,8104,16,42,5164.75,8975.03,0.00
2024-12-10 17:40:17,58,8105,16,42,5321.81,8976.00,0.00
2024-12-10 17:40:17,59,8105,16,43,5231.61,8976.02,0.00
2024-12-10 17:40:17,58,8105,15,43,5281.92,8976.07,0.00
2024-12-10 17:40:17,58,8106,15,43,5291.78,8977.00,0.00
2024-12-10 17:40:17,59,8106,15,44,5202.09,8977.02,0.00
2024-12-10 17:40:17,60,8105,15,45,5115.39,8977.05,0.00
2024-12-10 17:40:17,59,8105,15,44,5284.27,8977.05,0.00
2024-12-10 17:40:17,58,8105,14,44,5319.99,8977.66,0.00
2024-12-10 17:40:17,57,8105,13,44,5366.25,8977.91,0.00
2024-12-10 17:40:17,57,8106,13,44,5515.95,8978.00,0.00
2024-12-10 17:40:17,58,8106,13,45,5420.85,8978.02,0.00
2024-12-10 17:40:17,58,8107,13,45,5549.95,8979.00,0.00
2024-12-10 17:40:17,59,8107,14,45,5455.88,8979.02,0.00
2024-12-10 17:40:17,58,8107,14,44,5537.58,8979.03,0.00
2024-12-10 17:40:17,57,8107,13,44,5550.11,8979.81,0.00
2024-12-10 17:40:17,57,8108,13,44,5690.48,8980.00,0.00
2024-12-10 17:40:17,58,8108,14,44,5592.37,8980.02,0.00
2024-12-10 17:40:17,58,8109,14,44,5566.67,8981.00,0.00
2024-12-10 17:40:17,59,8109,15,44,5472.32,8981.02,0.00
2024-12-10 17:40:17,58,8109,15,43,5551.20,8981.03,0.00
2024-12-10 17:40:17,58,8110,15,43,5558.00,8982.00,0.00
2024-12-10 17:40:17,59,8110,15,44,5463.79,8982.02,0.00
2024-12-10 17:40:17,59,8111,15,44,5437.00,8983.00,0.00
2024-12-10 17:40:17,60,8111,15,45,5346.38,8983.02,0.00
2024-12-10 17:40:17,59,8111,15,44,5421.79,8983.03,0.00
2024-12-10 17:40:17,59,8112,15,44,5426.94,8984.00,0.00
2024-12-10 17:40:17,60,8112,16,44,5336.49,8984.02,0.00
2024-12-10 17:40:17,59,8112,15,44,5373.72,8984.19,0.00
2024-12-10 17:40:17,59,8113,15,44,5453.44,8985.00,0.00
2024-12-10 17:40:17,60,8113,16,44,5362.55,8985.02,0.00
2024-12-10 17:40:17,59,8113,16,43,5439.75,8985.03,0.00
2024-12-10 17:40:17,58,8113,15,43,5475.02,8985.67,0.00
2024-12-10 17:40:17,58,8114,15,43,5538.78,8986.00,0.00
2024-12-10 17:40:17,59,8114,16,43,5444.90,8986.02,0.00
2024-12-10 17:40:17,59,8115,16,43,5418.09,8987.00,0.00
2024-12-10 17:40:17,60,8115,16,44,5327.79,8987.02,0.00
2024-12-10 17:40:17,59,8115,16,43,5402.88,8987.03,0.00
2024-12-10 17:40:17,59,8116,16,43,5408.03,8988.00,0.00
2024-12-10 17:40:17,60,8116,16,44,5317.90,8988.02,0.00
2024-12-10 17:40:17,60,8117,16,44,5290.02,8989.00,0.00
2024-12-10 17:40:17,61,8117,17,44,5203.30,8989.02,0.00
2024-12-10 17:40:17,60,8117,17,43,5273.57,8989.05,0.00
2024-12-10 17:40:17,59,8117,16,43,5245.95,8989.66,0.00
2024-12-10 17:40:17,59,8118,16,43,5368.09,8990.00,0.00
2024-12-10 17:40:17,60,8118,16,44,5278.63,8990.02,0.00
2024-12-10 17:40:17,59,8118,15,44,5299.64,8990.27,0.00
2024-12-10 17:40:17,59,8119,15,44,5386.98,8991.00,0.00
2024-12-10 17:40:17,60,8119,15,45,5297.20,8991.02,0.00
2024-12-10 17:40:17,59,8119,15,44,5370.24,8991.05,0.00
2024-12-10 17:40:17,59,8120,15,44,5376.91,8992.00,0.00
2024-12-10 17:40:17,60,8120,15,45,5287.29,8992.02,0.00
2024-12-10 17:40:17,59,8120,14,45,5258.50,8992.83,0.00
2024-12-10 17:40:17,59,8121,14,45,5395.80,8993.00,0.00
2024-12-10 17:40:17,60,8121,15,45,5305.87,8993.02,0.00
2024-12-10 17:40:17,59,8121,15,44,5377.53,8993.05,0.00
2024-12-10 17:40:17,58,8121,14,44,5428.48,8993.29,0.00
2024-12-10 17:40:17,58,8122,14,44,5520.45,8994.00,0.00
2024-12-10 17:40:17,59,8122,15,44,5426.89,8994.02,0.00
2024-12-10 17:40:18,59,8123,15,44,5400.05,8995.00,0.00
2024-12-10 17:40:18,60,8123,15,45,5310.05,8995.02,0.00
2024-12-10 17:40:18,59,8123,15,44,5383.30,8995.05,0.00
2024-12-10 17:40:18,59,8124,15,44,5389.97,8996.00,0.00
2024-12-10 17:40:18,60,8124,15,45,5300.14,8996.02,0.00
2024-12-10 17:40:18,60,8125,15,45,5272.24,8997.00,0.00
2024-12-10 17:40:18,61,8125,16,45,5185.81,8997.02,0.00
2024-12-10 17:40:18,60,8125,16,44,5257.27,8997.05,0.00
2024-12-10 17:40:18,59,8125,15,44,5237.12,8997.97,0.00
2024-12-10 17:40:18,59,8126,15,44,5386.60,8998.00,0.00
2024-12-10 17:40:18,60,8126,16,44,5296.82,8998.02,0.00
2024-12-10 17:40:18,59,8126,15,44,5342.43,8998.17,0.00
2024-12-10 17:40:18,60,8125,16,44,5214.64,8998.63,0.00
2024-12-10 17:40:18,60,8126,16,44,5306.41,8999.00,0.00
2024-12-10 17:40:18,61,8126,16,45,5219.42,8999.02,0.00
2024-12-10 17:40:18,61,8127,16,45,5380.26,9000.00,0.00
2024-12-10 17:40:18,62,8127,16,46,5293.48,9000.02,0.00
2024-12-10 17:40:18,61,8127,15,46,5290.62,9000.69,0.00
2024-12-10 17:40:18,61,8128,15,46,5379.97,9001.00,0.00
2024-12-10 17:40:18,62,8128,16,46,5293.19,9001.02,0.00
2024-12-10 17:40:18,61,8128,15,46,5290.31,9001.69,0.00
2024-12-10 17:40:18,61,8129,15,46,5356.10,9002.00,0.00
2024-12-10 17:40:18,62,8129,16,46,5269.71,9002.02,0.00
2024-12-10 17:40:18,61,8129,16,45,5332.49,9002.02,0.00
2024-12-10 17:40:18,60,8129,15,45,5295.23,9002.95,0.00
2024-12-10 17:40:18,60,8130,15,45,5440.81,9003.00,0.00
2024-12-10 17:40:18,61,8130,16,45,5351.62,9003.02,0.00
2024-12-10 17:40:18,61,8131,16,45,5361.80,9004.00,0.00
2024-12-10 17:40:18,62,8131,16,46,5275.32,9004.02,0.00
2024-12-10 17:40:18,62,8132,16,46,5265.98,9005.00,0.00
2024-12-10 17:40:18,63,8132,17,46,5182.39,9005.02,0.00
2024-12-10 17:40:18,63,8133,17,46,5151.52,9006.00,0.00
2024-12-10 17:40:18,64,8133,18,46,5071.03,9006.02,0.00
2024-12-10 17:40:18,63,8133,18,45,5138.65,9006.02,0.00
2024-12-10 17:40:18,62,8133,18,44,5220.08,9006.02,0.00
2024-12-10 17:40:18,62,8134,18,44,5219.21,9007.00,0.00
2024-12-10 17:40:18,63,8134,19,44,5136.36,9007.02,0.00
2024-12-10 17:40:18,62,8134,18,44,5074.26,9007.68,0.00
2024-12-10 17:40:18,62,8135,18,44,5190.73,9008.00,0.00
2024-12-10 17:40:18,63,8135,18,45,5108.34,9008.02,0.00
2024-12-10 17:40:18,62,8135,18,44,5187.82,9008.02,0.00
2024-12-10 17:40:18,62,8136,18,44,5186.95,9009.00,0.00
2024-12-10 17:40:18,63,8136,19,44,5104.62,9009.02,0.00
2024-12-10 17:40:18,63,8137,19,44,5073.72,9010.00,0.00
2024-12-10 17:40:18,64,8137,20,44,4994.44,9010.02,0.00
2024-12-10 17:40:18,63,8137,20,43,5072.29,9010.02,0.00
2024-12-10 17:40:18,62,8137,19,43,5109.16,9010.34,0.00
2024-12-10 17:40:18,62,8138,19,43,5195.37,9011.00,0.00
2024-12-10 17:40:18,63,8138,20,43,5112.90,9011.02,0.00
2024-12-10 17:40:18,62,8138,19,43,5148.91,9011.19,0.00
2024-12-10 17:40:18,62,8139,19,43,5163.96,9012.00,0.00
2024-12-10 17:40:18,63,8139,20,43,5082.00,9012.02,0.00
2024-12-10 17:40:18,62,8139,20,42,5162.51,9012.02,0.00
2024-12-10 17:40:18,63,8138,21,42,5042.12,9012.48,0.00
2024-12-10 17:40:18,63,8139,21,42,5099.73,9013.00,0.00
2024-12-10 17:40:18,64,8139,22,42,5020.05,9013.02,0.00
2024-12-10 17:40:18,63,8139,22,41,5069.69,9013.02,0.00
2024-12-10 17:40:18,62,8139,21,41,5031.13,9013.69,0.00
2024-12-10 17:40:18,62,8140,21,41,5294.51,9014.00,0.00
2024-12-10 17:40:18,63,8140,21,42,5210.47,9014.02,0.00
2024-12-10 17:40:18,62,8140,21,41,5263.98,9014.02,0.00
2024-12-10 17:40:18,62,8141,21,41,5263.10,9015.00,0.00
2024-12-10 17:40:18,63,8141,22,41,5179.56,9015.02,0.00
2024-12-10 17:40:18,62,8141,22,40,5232.57,9015.02,0.00
2024-12-10 17:40:18,61,8141,21,40,5305.10,9015.16,0.00
2024-12-10 17:40:18,60,8141,20,40,5392.01,9015.17,0.00
2024-12-10 17:40:18,59,8141,19,40,5391.96,9015.59,0.00
2024-12-10 17:40:18,59,8142,19,40,5508.41,9016.00,0.00
2024-12-10 17:40:18,60,8142,19,41,5416.60,9016.02,0.00
2024-12-10 17:40:18,60,8143,19,41,5401.22,9017.00,0.00
2024-12-10 17:40:18,61,8143,19,42,5312.67,9017.02,0.00
2024-12-10 17:40:18,60,8143,18,42,5300.12,9017.37,0.00
2024-12-10 17:40:18,60,8144,18,42,5393.76,9018.00,0.00
2024-12-10 17:40:18,61,8144,19,42,5305.34,9018.02,0.00
2024-12-10 17:40:18,61,8145,19,42,5276.35,9019.00,0.00
2024-12-10 17:40:18,62,8145,20,42,5191.25,9019.02,0.00
2024-12-10 17:40:18,61,8145,20,41,5271.92,9019.03,0.00
2024-12-10 17:40:18,61,8146,20,41,5273.98,9020.00,0.00
2024-12-10 17:40:18,62,8146,20,42,5188.92,9020.02,0.00
2024-12-10 17:40:18,61,8146,20,41,5272.50,9020.02,0.00
2024-12-10 17:40:18,61,8147,20,41,5242.22,9021.00,0.00
2024-12-10 17:40:18,62,8147,20,42,5157.67,9021.02,0.00
2024-12-10 17:40:18,61,8147,20,41,5240.74,9021.02,0.00
2024-12-10 17:40:18,61,8148,20,41,5237.71,9022.00,0.00
2024-12-10 17:40:18,62,8148,21,41,5153.23,9022.02,0.00
2024-12-10 17:40:18,61,8148,20,41,5165.24,9022.05,0.00
2024-12-10 17:40:19,61,8149,20,41,5222.22,9023.00,0.00
2024-12-10 17:40:19,62,8149,20,42,5137.99,9023.02,0.00
2024-12-10 17:40:19,61,8149,20,41,5220.74,9023.02,0.00
2024-12-10 17:40:19,61,8150,20,41,5213.11,9024.00,0.00
2024-12-10 17:40:19,62,8150,21,41,5129.03,9024.02,0.00
2024-12-10 17:40:19,62,8151,21,41,5088.35,9025.00,0.00
2024-12-10 17:40:19,63,8151,22,41,5007.58,9025.02,0.00
2024-12-10 17:40:19,62,8151,22,40,5085.44,9025.02,0.00
2024-12-10 17:40:19,62,8152,22,40,5070.60,9026.00,0.00
2024-12-10 17:40:19,63,8152,22,41,4990.11,9026.02,0.00
2024-12-10 17:40:19,63,8153,22,41,4942.23,9027.00,0.00
2024-12-10 17:40:19,64,8153,22,42,4865.01,9027.02,0.00
2024-12-10 17:40:19,63,8153,22,41,4936.50,9027.02,0.00
2024-12-10 17:40:19,62,8153,21,41,4890.60,9027.94,0.00
2024-12-10 17:40:19,62,8154,21,41,5030.43,9028.00,0.00
2024-12-10 17:40:19,63,8154,21,42,4950.58,9028.02,0.00
2024-12-10 17:40:19,62,8154,20,42,4941.93,9028.68,0.00
2024-12-10 17:40:19,62,8155,20,42,5036.99,9029.00,0.00
2024-12-10 17:40:19,63,8155,20,43,4957.04,9029.02,0.00
2024-12-10 17:40:19,62,8155,20,42,5031.17,9029.02,0.00
2024-12-10 17:40:19,62,8156,20,42,5007.69,9030.00,0.00
2024-12-10 17:40:19,63,8156,21,42,4928.20,9030.02,0.00
2024-12-10 17:40:19,64,8155,22,42,4758.43,9030.77,0.00
2024-12-10 17:40:19,64,8156,22,42,4821.69,9031.00,0.00
2024-12-10 17:40:19,65,8156,23,42,4747.51,9031.02,0.00
2024-12-10 17:40:19,64,8156,23,41,4817.46,9031.02,0.00
2024-12-10 17:40:19,63,8156,22,41,4832.62,9031.68,0.00
2024-12-10 17:40:19,63,8157,22,41,5008.57,9032.00,0.00
2024-12-10 17:40:19,64,8157,23,41,4930.31,9032.02,0.00
2024-12-10 17:40:19,63,8157,23,40,4842.55,9032.76,0.00
2024-12-10 17:40:19,63,8158,23,40,4954.54,9033.00,0.00
2024-12-10 17:40:19,64,8158,24,40,4877.12,9033.02,0.00
2024-12-10 17:40:19,63,8158,24,39,4948.80,9033.02,0.00
2024-12-10 17:40:19,63,8159,24,39,4936.03,9034.00,0.00
2024-12-10 17:40:19,64,8159,24,40,4858.90,9034.02,0.00
2024-12-10 17:40:19,64,8160,24,40,4816.47,9035.00,0.00
2024-12-10 17:40:19,65,8160,25,40,4742.37,9035.02,0.00
2024-12-10 17:40:19,64,8160,25,39,4810.82,9035.02,0.00
2024-12-10 17:40:19,63,8160,24,39,4822.98,9035.71,0.00
2024-12-10 17:40:19,63,8161,24,39,4872.36,9036.00,0.00
2024-12-10 17:40:19,64,8161,25,39,4796.23,9036.02,0.00
2024-12-10 17:40:19,64,8162,25,39,4753.16,9037.00,0.00
2024-12-10 17:40:19,65,8162,26,39,4680.04,9037.02,0.00
2024-12-10 17:40:19,64,8162,26,38,4748.93,9037.02,0.00
2024-12-10 17:40:19,63,8162,26,37,4762.19,9037.70,0.00
2024-12-10 17:40:19,63,8163,26,37,4821.22,9038.00,0.00
2024-12-10 17:40:19,64,8163,26,38,4745.88,9038.02,0.00
2024-12-10 17:40:19,63,8163,25,38,4746.59,9038.52,0.00
2024-12-10 17:40:19,63,8164,25,38,4789.95,9039.00,0.00
2024-12-10 17:40:19,64,8164,25,39,4715.11,9039.02,0.00
2024-12-10 17:40:19,63,8164,25,38,4787.08,9039.02,0.00
2024-12-10 17:40:19,62,8164,24,38,4804.82,9039.68,0.00
2024-12-10 17:40:19,61,8164,23,38,4882.11,9039.69,0.00
2024-12-10 17:40:19,61,8165,23,38,4943.10,9040.00,0.00
2024-12-10 17:40:19,62,8165,24,38,4863.37,9040.02,0.00
2024-12-10 17:40:19,62,8166,24,38,4833.29,9041.00,0.00
2024-12-10 17:40:19,63,8166,25,38,4756.57,9041.02,0.00
2024-12-10 17:40:19,62,8166,25,37,4831.83,9041.02,0.00
2024-12-10 17:40:19,62,8167,25,37,4830.90,9042.00,0.00
2024-12-10 17:40:19,63,8167,26,37,4754.22,9042.02,0.00
2024-12-10 17:40:19,62,8167,26,36,4800.28,9042.02,0.00
2024-12-10 17:40:19,63,8166,26,37,4714.07,9042.16,0.00
2024-12-10 17:40:19,63,8167,26,37,4818.23,9043.00,0.00
2024-12-10 17:40:19,64,8167,26,38,4742.95,9043.02,0.00
2024-12-10 17:40:19,64,8168,26,38,4851.65,9044.00,0.00
2024-12-10 17:40:19,65,8168,27,38,4777.00,9044.02,0.00
2024-12-10 17:40:19,64,8168,27,37,4850.23,9044.02,0.00
2024-12-10 17:40:19,64,8169,27,37,4846.53,9045.00,0.00
2024-12-10 17:40:19,65,8169,27,38,4771.97,9045.02,0.00
2024-12-10 17:40:19,64,8169,26,38,4799.96,9045.22,0.00
2024-12-10 17:40:19,64,8170,26,38,4814.56,9046.00,0.00
2024-12-10 17:40:19,65,8170,27,38,4740.49,9046.02,0.00
2024-12-10 17:40:19,64,8170,27,37,4813.14,9046.02,0.00
2024-12-10 17:40:19,63,8170,26,37,4840.85,9046.35,0.00
2024-12-10 17:40:19,63,8171,26,37,4925.98,9047.00,0.00
2024-12-10 17:40:19,64,8171,27,37,4849.01,9047.02,0.00
2024-12-10 17:40:19,63,8171,27,36,4895.83,9047.02,0.00
2024-12-10 17:40:19,62,8171,26,36,4958.81,9047.19,0.00
2024-12-10 17:40:19,62,8172,26,36,4973.88,9048.00,0.00
2024-12-10 17:40:19,63,8172,26,37,4894.93,9048.02,0.00
2024-12-10 17:40:19,62,8172,25,37,4872.10,9048.74,0.00
2024-12-10 17:40:19,62,8173,25,37,4994.86,9049.00,0.00
2024-12-10 17:40:19,63,8173,25,38,4915.58,9049.02,0.00
2024-12-10 17:40:19,62,8173,25,37,4991.94,9049.02,0.00
2024-12-10 17:40:19,62,8174,25,37,4991.04,9050.00,0.00
2024-12-10 17:40:19,63,8174,26,37,4911.81,9050.02,0.00
2024-12-10 17:40:20,63,8175,26,37,4880.75,9051.00,0.00
2024-12-10 17:40:20,64,8175,27,37,4804.49,9051.02,0.00
2024-12-10 17:40:20,63,8175,27,36,4879.31,9051.02,0.00
2024-12-10 17:40:20,63,8176,27,36,4876.98,9052.00,0.00
2024-12-10 17:40:20,64,8176,28,36,4800.78,9052.02,0.00
2024-12-10 17:40:20,63,8176,27,36,4763.87,9052.81,0.00
2024-12-10 17:40:20,63,8177,27,36,4890.45,9053.00,0.00
2024-12-10 17:40:20,64,8177,27,37,4814.04,9053.02,0.00
2024-12-10 17:40:20,63,8177,27,36,4889.01,9053.02,0.00
2024-12-10 17:40:20,63,8178,27,36,4886.68,9054.00,0.00
2024-12-10 17:40:20,64,8178,28,36,4810.32,9054.02,0.00
2024-12-10 17:40:20,64,8179,28,36,4811.63,9055.00,0.00
2024-12-10 17:40:20,65,8179,29,36,4737.61,9055.02,0.00
2024-12-10 17:40:20,64,8179,28,36,4677.05,9055.70,0.00
2024-12-10 17:40:20,64,8180,28,36,4791.86,9056.00,0.00
2024-12-10 17:40:20,65,8180,28,37,4718.14,9056.02,0.00
2024-12-10 17:40:20,64,8180,28,36,4767.81,9056.02,0.00
2024-12-10 17:40:20,63,8180,27,36,4807.37,9056.35,0.00
2024-12-10 17:40:20,62,8180,26,36,4852.98,9056.69,0.00
2024-12-10 17:40:20,62,8181,26,36,4971.52,9057.00,0.00
2024-12-10 17:40:20,63,8181,26,37,4892.61,9057.02,0.00
2024-12-10 17:40:20,62,8181,25,37,4920.47,9057.24,0.00
2024-12-10 17:40:20,62,8182,25,37,4984.87,9058.00,0.00
2024-12-10 17:40:20,63,8182,25,38,4905.75,9058.02,0.00
2024-12-10 17:40:20,63,8183,25,38,4911.71,9059.00,0.00
2024-12-10 17:40:20,64,8183,25,39,4834.96,9059.02,0.00
2024-12-10 17:40:20,64,8183,25,39,4821.03,9060.00,0.00
2024-12-10 17:40:20,65,8183,25,40,4746.86,9060.02,0.00
2024-12-10 17:40:20,64,8183,24,40,4674.57,9060.77,0.00
2024-12-10 17:40:20,64,8184,24,40,4795.09,9061.00,0.00
2024-12-10 17:40:20,65,8184,24,41,4721.32,9061.02,0.00
2024-12-10 17:40:20,64,8184,24,40,4792.25,9061.02,0.00
2024-12-10 17:40:20,63,8184,23,40,4804.49,9061.70,0.00
2024-12-10 17:40:20,63,8185,23,40,4863.69,9062.00,0.00
2024-12-10 17:40:20,64,8185,24,40,4787.70,9062.02,0.00
2024-12-10 17:40:20,63,8185,24,39,4842.12,9062.02,0.00
2024-12-10 17:40:20,62,8185,23,39,4857.66,9062.69,0.00
2024-12-10 17:40:20,62,8186,23,39,4976.30,9063.00,0.00
2024-12-10 17:40:20,63,8186,23,40,4897.32,9063.02,0.00
2024-12-10 17:40:20,62,8186,23,39,4954.38,9063.02,0.00
2024-12-10 17:40:20,62,8187,23,39,4953.46,9064.00,0.00
2024-12-10 17:40:20,63,8187,23,40,4874.84,9064.02,0.00
2024-12-10 17:40:20,62,8187,23,39,4933.00,9064.02,0.00
2024-12-10 17:40:20,61,8187,22,39,4936.61,9064.23,0.00
2024-12-10 17:40:20,61,8188,22,39,5015.86,9065.00,0.00
2024-12-10 17:40:20,62,8188,22,40,4934.96,9065.02,0.00
2024-12-10 17:40:20,61,8188,22,39,4995.05,9065.02,0.00
2024-12-10 17:40:20,61,8189,22,39,4994.34,9066.00,0.00
2024-12-10 17:40:20,62,8189,23,39,4913.79,9066.02,0.00
2024-12-10 17:40:20,61,8189,23,38,4969.08,9066.02,0.00
2024-12-10 17:40:20,60,8189,22,38,5030.87,9066.22,0.00
2024-12-10 17:40:20,60,8190,22,38,5051.02,9067.00,0.00
2024-12-10 17:40:20,61,8190,22,39,4968.22,9067.02,0.00
2024-12-10 17:40:20,60,8190,22,38,5025.33,9067.02,0.00
2024-12-10 17:40:20,59,8190,21,38,5029.29,9067.76,0.00
2024-12-10 17:40:20,59,8191,21,38,5161.67,9068.00,0.00
2024-12-10 17:40:20,60,8191,21,39,5075.64,9068.02,0.00
2024-12-10 17:40:20,59,8191,21,38,5130.93,9068.02,0.00
2024-12-10 17:40:20,59,8192,21,38,5133.08,9069.00,0.00
2024-12-10 17:40:20,60,8192,22,38,5047.52,9069.02,0.00
2024-12-10 17:40:20,59,8192,22,37,5102.33,9069.02,0.00
2024-12-10 17:40:20,58,8192,21,37,5134.23,9069.35,0.00
2024-12-10 17:40:20,58,8193,21,37,5231.64,9070.00,0.00
2024-12-10 17:40:20,59,8193,22,37,5142.97,9070.02,0.00
2024-12-10 17:40:20,58,8193,22,36,5198.80,9070.02,0.00
2024-12-10 17:40:20,59,8192,23,36,5054.10,9070.68,0.00
2024-12-10 17:40:20,59,8193,23,36,5148.15,9071.00,0.00
2024-12-10 17:40:20,60,8193,24,36,5062.35,9071.02,0.00
2024-12-10 17:40:20,60,8194,24,36,5185.38,9072.00,0.00
2024-12-10 17:40:20,61,8194,24,37,5100.37,9072.02,0.00
2024-12-10 17:40:20,60,8194,24,36,5166.04,9072.05,0.00
2024-12-10 17:40:20,60,8195,24,36,5171.14,9073.00,0.00
2024-12-10 17:40:20,61,8195,25,36,5086.37,9073.02,0.00
2024-12-10 17:40:20,60,8195,25,35,5166.32,9073.03,0.00
2024-12-10 17:40:20,59,8195,24,35,5210.86,9073.17,0.00
2024-12-10 17:40:20,58,8195,23,35,5215.11,9073.88,0.00
2024-12-10 17:40:20,58,8196,23,35,5360.70,9074.00,0.00
2024-12-10 17:40:20,59,8196,23,36,5269.84,9074.02,0.00
2024-12-10 17:40:20,58,8196,23,35,5354.44,9074.03,0.00
2024-12-10 17:40:20,59,8195,23,36,5262.15,9074.09,0.00
2024-12-10 17:40:20,59,8196,23,36,5384.24,9075.00,0.00
2024-12-10 17:40:20,60,8196,23,37,5294.50,9075.02,0.00
2024-12-10 17:40:20,60,8197,23,37,5466.10,9076.00,0.00
2024-12-10 17:40:20,61,8197,23,38,5376.49,9076.02,0.00
2024-12-10 17:40:20,61,8198,23,38,5389.75,9077.00,0.00
2024-12-10 17:40:20,62,8198,24,38,5302.82,9077.02,0.00
2024-12-10 17:40:21,62,8199,24,38,5301.47,9078.00,0.00
2024-12-10 17:40:21,63,8199,24,39,5217.32,9078.02,0.00
2024-12-10 17:40:21,64,8198,24,40,5096.12,9078.17,0.00
2024-12-10 17:40:21,64,8199,24,40,5205.80,9079.00,0.00
2024-12-10 17:40:21,65,8199,24,41,5125.71,9079.02,0.00
2024-12-10 17:40:21,64,8199,24,40,5180.27,9079.05,0.00
2024-12-10 17:40:21,64,8200,24,40,5321.29,9080.00,0.00
2024-12-10 17:40:21,65,8200,25,40,5239.43,9080.02,0.00
2024-12-10 17:40:21,65,8201,25,40,5206.47,9081.00,0.00
2024-12-10 17:40:21,66,8201,26,40,5127.59,9081.02,0.00
2024-12-10 17:40:21,65,8201,26,39,5196.70,9081.06,0.00
2024-12-10 17:40:21,65,8202,26,39,5195.87,9082.00,0.00
2024-12-10 17:40:21,66,8202,27,39,5117.14,9082.02,0.00
2024-12-10 17:40:21,66,8203,27,39,5083.30,9083.00,0.00
2024-12-10 17:40:21,67,8203,27,40,5007.43,9083.02,0.00
2024-12-10 17:40:21,66,8203,27,39,5070.92,9083.06,0.00
2024-12-10 17:40:21,66,8204,27,39,5068.72,9084.00,0.00
2024-12-10 17:40:21,67,8204,28,39,4993.07,9084.02,0.00
2024-12-10 17:40:21,66,8204,27,39,5009.61,9084.26,0.00
2024-12-10 17:40:21,66,8205,27,39,5080.29,9085.00,0.00
2024-12-10 17:40:21,67,8205,27,40,5004.47,9085.02,0.00
2024-12-10 17:40:21,66,8205,27,39,5056.91,9085.12,0.00
2024-12-10 17:40:21,67,8204,27,40,4918.10,9085.85,0.00
2024-12-10 17:40:21,67,8205,27,40,4998.24,9086.00,0.00
2024-12-10 17:40:21,68,8205,27,41,4924.73,9086.02,0.00
2024-12-10 17:40:21,68,8206,27,41,5031.56,9087.00,0.00
2024-12-10 17:40:21,69,8206,28,41,4958.64,9087.02,0.00
2024-12-10 17:40:21,68,8206,28,40,5003.52,9087.12,0.00
2024-12-10 17:40:21,67,8206,27,40,5067.98,9087.15,0.00
2024-12-10 17:40:21,67,8207,27,40,5126.84,9088.00,0.00
2024-12-10 17:40:21,68,8207,27,41,5051.44,9088.02,0.00
2024-12-10 17:40:21,67,8207,26,41,5123.45,9088.05,0.00
2024-12-10 17:40:21,67,8208,26,41,5098.36,9089.00,0.00
2024-12-10 17:40:21,68,8208,26,42,5023.39,9089.02,0.00
2024-12-10 17:40:21,67,8208,26,41,5072.60,9089.10,0.00
2024-12-10 17:40:21,67,8209,26,41,5073.15,9090.00,0.00
2024-12-10 17:40:21,68,8209,26,42,4998.54,9090.02,0.00
2024-12-10 17:40:21,68,8210,26,42,4970.16,9091.00,0.00
2024-12-10 17:40:21,69,8210,26,43,4898.13,9091.02,0.00
2024-12-10 17:40:21,68,8210,26,42,4968.83,9091.02,0.00
2024-12-10 17:40:21,67,8210,26,41,5018.58,9091.09,0.00
2024-12-10 17:40:21,66,8210,25,41,5066.61,9091.21,0.00
2024-12-10 17:40:21,66,8211,25,41,5133.24,9092.00,0.00
2024-12-10 17:40:21,67,8211,26,41,5056.62,9092.02,0.00
2024-12-10 17:40:21,67,8212,26,41,5029.66,9093.00,0.00
2024-12-10 17:40:21,68,8212,26,42,4955.69,9093.02,0.00
2024-12-10 17:40:21,67,8212,26,41,5003.88,9093.09,0.00
2024-12-10 17:40:21,66,8212,25,41,5071.46,9093.17,0.00
2024-12-10 17:40:21,66,8213,25,41,5078.11,9094.00,0.00
2024-12-10 17:40:21,67,8213,25,42,5002.32,9094.02,0.00
2024-12-10 17:40:21,67,8214,25,42,4972.35,9095.00,0.00
2024-12-10 17:40:21,68,8214,26,42,4899.23,9095.02,0.00
2024-12-10 17:40:21,67,8214,26,41,4947.93,9095.09,0.00
2024-12-10 17:40:21,66,8214,25,41,4979.41,9095.56,0.00
2024-12-10 17:40:21,65,8214,24,41,4982.30,9095.97,0.00
2024-12-10 17:40:21,65,8215,24,41,5119.45,9096.00,0.00
2024-12-10 17:40:21,66,8215,25,41,5041.89,9096.02,0.00
2024-12-10 17:40:21,66,8216,25,41,5008.33,9097.00,0.00
2024-12-10 17:40:21,67,8216,25,42,4933.58,9097.02,0.00
2024-12-10 17:40:21,66,8216,25,41,4984.91,9097.09,0.00
2024-12-10 17:40:21,66,8217,25,41,4978.62,9098.00,0.00
2024-12-10 17:40:21,67,8217,26,41,4904.31,9098.02,0.00
2024-12-10 17:40:21,66,8217,25,41,4973.11,9098.06,0.00
2024-12-10 17:40:21,65,8217,24,41,4969.85,9098.11,0.00
2024-12-10 17:40:21,65,8218,24,41,5021.31,9099.00,0.00
2024-12-10 17:40:21,66,8218,25,41,4945.23,9099.02,0.00
2024-12-10 17:40:21,65,8218,25,40,5019.91,9099.02,0.00
2024-12-10 17:40:21,64,8218,25,39,5078.45,9099.06,0.00
2024-12-10 17:40:21,64,8219,25,39,5070.46,9100.00,0.00
2024-12-10 17:40:21,65,8219,26,39,4992.46,9100.02,0.00
2024-12-10 17:40:21,66,8218,26,40,4832.99,9100.67,0.00
2024-12-10 17:40:21,66,8219,26,40,4913.79,9101.00,0.00
2024-12-10 17:40:21,67,8219,27,40,4840.45,9101.02,0.00
2024-12-10 17:40:21,66,8219,27,39,4888.98,9101.08,0.00
2024-12-10 17:40:21,66,8220,27,39,5015.69,9102.00,0.00
2024-12-10 17:40:21,67,8220,27,40,4940.83,9102.02,0.00
2024-12-10 17:40:21,66,8220,26,40,4933.29,9102.61,0.00
2024-12-10 17:40:21,67,8219,27,40,4843.54,9102.69,0.00
2024-12-10 17:40:21,68,8218,27,41,4793.77,9102.77,0.00
2024-12-10 17:40:21,68,8219,27,41,4885.12,9103.00,0.00
2024-12-10 17:40:21,69,8219,28,41,4814.32,9103.02,0.00
2024-12-10 17:40:21,68,8219,28,40,4858.35,9103.07,0.00
2024-12-10 17:40:21,68,8220,28,40,5111.45,9104.00,0.00
2024-12-10 17:40:21,69,8220,29,40,5037.37,9104.02,0.00
2024-12-10 17:40:21,70,8219,29,41,4819.45,9104.79,0.00
2024-12-10 17:40:22,70,8220,29,41,4947.09,9105.00,0.00
2024-12-10 17:40:22,71,8220,30,41,4877.41,9105.01,0.00
2024-12-10 17:40:22,70,8220,30,40,4922.38,9105.07,0.00
2024-12-10 17:40:22,70,8221,30,40,5037.16,9106.00,0.00
2024-12-10 17:40:22,71,8221,31,40,4966.21,9106.01,0.00
2024-12-10 17:40:22,70,8221,30,40,5029.35,9106.03,0.00
2024-12-10 17:40:22,69,8221,29,40,5022.33,9106.58,0.00
2024-12-10 17:40:22,69,8222,29,40,5116.34,9107.00,0.00
2024-12-10 17:40:22,70,8222,30,40,5043.25,9107.02,0.00
2024-12-10 17:40:22,69,8222,30,39,5091.27,9107.06,0.00
2024-12-10 17:40:22,68,8222,29,39,5163.48,9107.09,0.00
2024-12-10 17:40:22,68,8223,29,39,5161.35,9108.00,0.00
2024-12-10 17:40:22,69,8223,29,40,5086.54,9108.02,0.00
2024-12-10 17:40:22,68,8223,28,40,5127.87,9108.09,0.00
2024-12-10 17:40:22,67,8223,27,40,5194.91,9108.14,0.00
2024-12-10 17:40:22,68,8222,27,41,5087.87,9108.50,0.00
2024-12-10 17:40:22,68,8223,27,41,5218.17,9109.00,0.00
2024-12-10 17:40:22,69,8223,28,41,5142.55,9109.02,0.00
2024-12-10 17:40:22,68,8223,27,41,5216.83,9109.02,0.00
2024-12-10 17:40:22,67,8223,27,40,5271.59,9109.05,0.00
2024-12-10 17:40:22,66,8223,26,40,5285.37,9109.39,0.00
2024-12-10 17:40:22,65,8223,25,40,5351.92,9109.55,0.00
2024-12-10 17:40:22,65,8224,25,40,5591.90,9110.00,0.00
2024-12-10 17:40:22,66,8224,26,40,5507.18,9110.02,0.00
2024-12-10 17:40:22,67,8223,27,40,5378.82,9110.25,0.00
2024-12-10 17:40:22,66,8223,26,40,5508.65,9110.26,0.00
2024-12-10 17:40:22,66,8224,26,40,5579.56,9111.00,0.00
2024-12-10 17:40:22,67,8224,26,41,5496.29,9111.02,0.00
2024-12-10 17:40:22,66,8224,26,40,5556.10,9111.05,0.00
2024-12-10 17:40:22,65,8224,25,40,5638.79,9111.08,0.00
2024-12-10 17:40:22,65,8225,25,40,5779.58,9112.00,0.00
2024-12-10 17:40:22,66,8225,25,41,5692.01,9112.02,0.00
2024-12-10 17:40:22,66,8226,25,41,5660.39,9113.00,0.00
2024-12-10 17:40:22,67,8226,25,42,5575.91,9113.02,0.00
2024-12-10 17:40:22,66,8226,25,41,5635.54,9113.05,0.00
2024-12-10 17:40:22,65,8226,24,41,5677.53,9113.54,0.00
2024-12-10 17:40:22,66,8225,25,41,5570.95,9113.79,0.00
2024-12-10 17:40:22,66,8226,25,41,5648.46,9114.00,0.00
2024-12-10 17:40:22,67,8226,26,41,5564.15,9114.02,0.00
2024-12-10 17:40:22,66,8226,25,41,5569.87,9114.30,0.00
2024-12-10 17:40:22,67,8225,26,41,5451.63,9114.72,0.00
2024-12-10 17:40:22,67,8226,26,41,5715.77,9115.00,0.00
2024-12-10 17:40:22,68,8226,27,41,5631.72,9115.02,0.00
2024-12-10 17:40:22,67,8226,26,41,5682.79,9115.07,0.00
2024-12-10 17:40:22,67,8227,26,41,5819.48,9116.00,0.00
2024-12-10 17:40:22,68,8227,27,41,5733.90,9116.02,0.00
2024-12-10 17:40:22,67,8227,27,40,5796.35,9116.05,0.00
2024-12-10 17:40:22,68,8226,28,40,5680.46,9116.41,0.00
2024-12-10 17:40:22,67,8226,27,40,5721.15,9116.87,0.00
2024-12-10 17:40:22,67,8227,27,40,5845.09,9117.00,0.00
2024-12-10 17:40:22,68,8227,28,40,5759.13,9117.02,0.00
2024-12-10 17:40:22,68,8228,28,40,5859.82,9118.00,0.00
2024-12-10 17:40:22,69,8228,28,41,5774.90,9118.02,0.00
2024-12-10 17:40:22,68,8228,28,40,5835.69,9118.04,0.00
2024-12-10 17:40:22,68,8229,28,40,5829.62,9119.00,0.00
2024-12-10 17:40:22,69,8229,29,40,5745.14,9119.02,0.00
2024-12-10 17:40:22,68,8229,28,40,5777.33,9119.04,0.00
2024-12-10 17:40:22,68,8230,28,40,5797.85,9120.00,0.00
2024-12-10 17:40:22,69,8230,28,41,5713.82,9120.02,0.00
2024-12-10 17:40:22,68,8230,28,40,5772.37,9120.04,0.00
2024-12-10 17:40:22,67,8230,27,40,5804.44,9120.60,0.00
2024-12-10 17:40:22,67,8231,27,40,5848.11,9121.00,0.00
2024-12-10 17:40:22,68,8231,28,40,5762.11,9121.02,0.00
2024-12-10 17:40:22,68,8232,28,40,5719.47,9122.00,0.00
2024-12-10 17:40:22,69,8232,29,40,5636.58,9122.02,0.00
2024-12-10 17:40:22,68,8232,29,39,5695.33,9122.04,0.00
2024-12-10 17:40:22,68,8233,29,39,5678.67,9123.00,0.00
2024-12-10 17:40:22,69,8233,29,40,5596.37,9123.02,0.00
2024-12-10 17:40:22,70,8232,30,40,5469.59,9123.27,0.00
2024-12-10 17:40:22,69,8232,29,40,5541.07,9123.71,0.00
2024-12-10 17:40:22,69,8233,29,40,5645.26,9124.00,0.00
2024-12-10 17:40:22,70,8233,29,41,5564.61,9124.02,0.00
2024-12-10 17:40:22,69,8233,29,40,5622.78,9124.04,0.00
2024-12-10 17:40:22,69,8234,29,40,5733.63,9125.00,0.00
2024-12-10 17:40:22,70,8234,30,40,5651.72,9125.02,0.00
2024-12-10 17:40:22,70,8235,30,40,5600.45,9126.00,0.00
2024-12-10 17:40:22,71,8235,31,40,5521.57,9126.01,0.00
2024-12-10 17:40:22,70,8235,31,39,5579.59,9126.04,0.00
2024-12-10 17:40:22,70,8236,31,39,5554.87,9127.00,0.00
2024-12-10 17:40:22,71,8236,31,40,5476.64,9127.01,0.00
2024-12-10 17:40:22,70,8236,30,40,5445.86,9127.70,0.00
2024-12-10 17:40:22,70,8237,30,40,5545.31,9128.00,0.00
2024-12-10 17:40:22,71,8237,31,40,5467.21,9128.01,0.00
2024-12-10 17:40:22,70,8237,31,39,5525.75,9128.04,0.00
2024-12-10 17:40:22,70,8238,31,39,5499.16,9129.00,0.00
2024-12-10 17:40:22,71,8238,32,39,5421.71,9129.01,0.00
2024-12-10 17:40:22,71,8239,32,39,5402.53,9130.00,0.00
2024-12-10 17:40:22,72,8239,33,39,5327.49,9130.01,0.00
2024-12-10 17:40:22,71,8239,32,39,5401.24,9130.01,0.00
2024-12-10 17:40:22,70,8239,31,39,5477.10,9130.02,0.00
2024-12-10 17:40:22,70,8240,31,39,5450.15,9131.00,0.00
2024-12-10 17:40:22,71,8240,31,40,5373.39,9131.01,0.00
2024-12-10 17:40:22,70,8240,31,39,5414.24,9131.04,0.00
2024-12-10 17:40:22,69,8240,30,39,5427.87,9131.65,0.00
2024-12-10 17:40:23,69,8241,30,39,5483.87,9132.00,0.00
2024-12-10 17:40:23,70,8241,31,39,5405.53,9132.02,0.00
2024-12-10 17:40:23,69,8241,31,38,5458.73,9132.02,0.00
2024-12-10 17:40:23,69,8242,31,38,5439.75,9133.00,0.00
2024-12-10 17:40:23,70,8242,31,39,5362.04,9133.02,0.00
2024-12-10 17:40:23,69,8242,30,39,5406.67,9133.09,0.00
2024-12-10 17:40:23,70,8241,30,40,5282.37,9133.53,0.00
2024-12-10 17:40:23,69,8241,29,40,5309.34,9133.96,0.00
2024-12-10 17:40:23,69,8242,29,40,5437.77,9134.00,0.00
2024-12-10 17:40:23,70,8242,29,41,5360.08,9134.02,0.00
2024-12-10 17:40:23,69,8242,29,40,5424.53,9134.02,0.00
2024-12-10 17:40:23,69,8243,29,40,5536.02,9135.00,0.00
2024-12-10 17:40:23,70,8243,30,40,5456.93,9135.02,0.00
2024-12-10 17:40:23,69,8243,29,40,5458.67,9135.48,0.00
2024-12-10 17:40:23,68,8243,28,40,5469.22,9135.66,0.00
2024-12-10 17:40:23,68,8244,28,40,5572.92,9136.00,0.00
2024-12-10 17:40:23,69,8244,28,41,5492.15,9136.02,0.00
2024-12-10 17:40:23,68,8244,28,40,5559.49,9136.02,0.00
2024-12-10 17:40:23,68,8245,28,40,5550.69,9137.00,0.00
2024-12-10 17:40:23,69,8245,28,41,5470.24,9137.02,0.00
2024-12-10 17:40:23,69,8246,28,41,5433.76,9138.00,0.00
2024-12-10 17:40:23,70,8246,29,41,5356.14,9138.02,0.00
2024-12-10 17:40:23,69,8246,29,40,5420.52,9138.02,0.00
2024-12-10 17:40:23,68,8246,28,40,5498.50,9138.03,0.00
2024-12-10 17:40:23,67,8246,27,40,5470.67,9138.97,0.00
2024-12-10 17:40:23,67,8247,27,40,5604.36,9139.00,0.00
2024-12-10 17:40:23,68,8247,27,41,5521.95,9139.02,0.00
2024-12-10 17:40:23,67,8247,26,41,5558.05,9139.16,0.00
2024-12-10 17:40:23,67,8248,26,41,5618.62,9140.00,0.00
2024-12-10 17:40:23,68,8248,26,42,5535.99,9140.02,0.00
2024-12-10 17:40:23,67,8248,26,41,5606.34,9140.02,0.00
2024-12-10 17:40:23,67,8249,26,41,5598.77,9141.00,0.00
2024-12-10 17:40:23,68,8249,27,41,5516.43,9141.02,0.00
2024-12-10 17:40:23,67,8249,26,41,5506.37,9141.72,0.00
2024-12-10 17:40:23,67,8250,26,41,5562.54,9142.00,0.00
2024-12-10 17:40:23,68,8250,26,42,5480.74,9142.02,0.00
2024-12-10 17:40:23,67,8250,26,41,5547.53,9142.02,0.00
2024-12-10 17:40:23,68,8249,27,41,5421.82,9142.53,0.00
2024-12-10 17:40:23,68,8250,27,41,5504.19,9143.00,0.00
2024-12-10 17:40:23,69,8250,27,42,5424.42,9143.02,0.00
2024-12-10 17:40:23,68,8250,26,42,5372.97,9143.93,0.00
2024-12-10 17:40:23,68,8251,26,42,5635.23,9144.00,0.00
2024-12-10 17:40:23,69,8251,26,43,5553.56,9144.02,0.00
2024-12-10 17:40:23,68,8251,26,42,5620.44,9144.02,0.00
2024-12-10 17:40:23,68,8252,26,42,5611.64,9145.00,0.00
2024-12-10 17:40:23,69,8252,26,43,5530.31,9145.02,0.00
2024-12-10 17:40:23,69,8253,26,43,5493.80,9146.00,0.00
2024-12-10 17:40:23,70,8253,27,43,5415.32,9146.02,0.00
2024-12-10 17:40:23,69,8253,27,42,5481.87,9146.02,0.00
2024-12-10 17:40:23,68,8253,26,42,5449.86,9146.69,0.00
2024-12-10 17:40:23,68,8254,26,42,5556.37,9147.00,0.00
2024-12-10 17:40:23,69,8254,26,43,5475.85,9147.02,0.00
2024-12-10 17:40:23,69,8255,26,43,5476.38,9148.00,0.00
2024-12-10 17:40:23,70,8255,26,44,5398.15,9148.02,0.00
2024-12-10 17:40:23,70,8256,26,44,5383.93,9149.00,0.00
2024-12-10 17:40:23,71,8256,27,44,5308.10,9149.01,0.00
2024-12-10 17:40:23,71,8257,27,44,5272.96,9150.00,0.00
2024-12-10 17:40:23,72,8257,28,44,5199.72,9150.01,0.00
2024-12-10 17:40:23,71,8257,28,43,5254.92,9150.01,0.00
2024-12-10 17:40:23,71,8258,28,43,5242.60,9151.00,0.00
2024-12-10 17:40:23,72,8258,29,43,5169.79,9151.01,0.00
2024-12-10 17:40:23,72,8259,29,43,5157.75,9152.00,0.00
2024-12-10 17:40:23,73,8259,30,43,5087.09,9152.01,0.00
2024-12-10 17:40:23,74,8258,31,43,4933.31,9152.70,0.00
2024-12-10 17:40:23,74,8259,31,43,5016.30,9153.00,0.00
2024-12-10 17:40:23,75,8259,32,43,4949.41,9153.01,0.00
2024-12-10 17:40:23,74,8259,32,42,4996.51,9153.01,0.00
2024-12-10 17:40:23,74,8260,32,42,5103.66,9154.00,0.00
2024-12-10 17:40:23,75,8260,32,43,5035.61,9154.01,0.00
2024-12-10 17:40:23,75,8261,32,43,5009.28,9155.00,0.00
2024-12-10 17:40:23,76,8261,32,44,4943.37,9155.01,0.00
2024-12-10 17:40:23,76,8262,32,44,4898.28,9156.00,0.00
2024-12-10 17:40:23,77,8262,33,44,4834.66,9156.01,0.00
2024-12-10 17:40:23,76,8262,33,43,4892.25,9156.01,0.00
2024-12-10 17:40:23,75,8262,32,43,4835.10,9156.92,0.00
2024-12-10 17:40:23,75,8263,32,43,4949.92,9157.00,0.00
2024-12-10 17:40:23,76,8263,33,43,4884.79,9157.01,0.00
2024-12-10 17:40:23,75,8263,32,43,4908.46,9157.20,0.00
2024-12-10 17:40:23,75,8264,32,43,4903.61,9158.00,0.00
2024-12-10 17:40:23,76,8264,32,44,4839.09,9158.01,0.00
2024-12-10 17:40:23,75,8264,32,43,4902.39,9158.01,0.00
2024-12-10 17:40:23,76,8263,33,43,4797.09,9158.49,0.00
2024-12-10 17:40:24,76,8264,33,43,4864.81,9159.00,0.00
2024-12-10 17:40:24,77,8264,34,43,4801.63,9159.01,0.00
2024-12-10 17:40:24,76,8264,34,42,4839.50,9159.01,0.00
2024-12-10 17:40:24,75,8264,33,42,4888.20,9159.19,0.00
2024-12-10 17:40:24,75,8265,33,42,5000.85,9160.00,0.00
2024-12-10 17:40:24,76,8265,34,42,4935.05,9160.01,0.00
2024-12-10 17:40:24,76,8266,34,42,4883.78,9161.00,0.00
2024-12-10 17:40:24,77,8266,34,43,4820.35,9161.01,0.00
2024-12-10 17:40:24,76,8266,34,42,4878.96,9161.03,0.00
2024-12-10 17:40:24,76,8267,34,42,4851.78,9162.00,0.00
2024-12-10 17:40:24,77,8267,34,43,4788.77,9162.01,0.00
2024-12-10 17:40:24,76,8267,33,43,4815.53,9162.15,0.00
2024-12-10 17:40:24,75,8267,32,43,4832.09,9162.16,0.00
2024-12-10 17:40:24,75,8268,32,43,4865.57,9163.00,0.00
2024-12-10 17:40:24,76,8268,33,43,4801.55,9163.01,0.00
2024-12-10 17:40:24,75,8268,33,42,4860.68,9163.03,0.00
2024-12-10 17:40:24,74,8268,32,42,4859.56,9163.20,0.00
2024-12-10 17:40:24,74,8269,32,42,4897.39,9164.00,0.00
2024-12-10 17:40:24,75,8269,32,43,4832.09,9164.01,0.00
2024-12-10 17:40:24,75,8270,32,43,4790.08,9165.00,0.00
2024-12-10 17:40:24,76,8270,33,43,4727.05,9165.01,0.00
2024-12-10 17:40:24,75,8270,33,42,4766.86,9165.03,0.00
2024-12-10 17:40:24,74,8270,32,42,4816.47,9165.19,0.00
2024-12-10 17:40:24,73,8270,31,42,4879.94,9165.21,0.00
2024-12-10 17:40:24,72,8270,30,42,4849.46,9165.79,0.00
2024-12-10 17:40:24,72,8271,30,42,4957.83,9166.00,0.00
2024-12-10 17:40:24,73,8271,31,42,4889.91,9166.01,0.00
2024-12-10 17:40:24,72,8271,31,41,4929.83,9166.03,0.00
2024-12-10 17:40:24,72,8272,31,41,4898.84,9167.00,0.00
2024-12-10 17:40:24,73,8272,32,41,4831.73,9167.01,0.00
2024-12-10 17:40:24,72,8272,31,41,4828.78,9167.31,0.00
2024-12-10 17:40:24,72,8273,31,41,4876.98,9168.00,0.00
2024-12-10 17:40:24,73,8273,32,41,4810.18,9168.01,0.00
2024-12-10 17:40:24,72,8273,32,40,4874.44,9168.03,0.00
2024-12-10 17:40:24,71,8273,31,40,4896.73,9168.38,0.00
2024-12-10 17:40:24,71,8274,31,40,4915.03,9169.00,0.00
2024-12-10 17:40:24,72,8274,32,40,4846.76,9169.01,0.00
2024-12-10 17:40:24,71,8274,32,39,4886.62,9169.03,0.00
2024-12-10 17:40:24,71,8275,32,39,4863.30,9170.00,0.00
2024-12-10 17:40:24,72,8275,32,40,4795.75,9170.01,0.00
2024-12-10 17:40:24,71,8275,31,40,4828.33,9170.11,0.00
2024-12-10 17:40:24,70,8275,30,40,4882.38,9170.24,0.00
2024-12-10 17:40:24,69,8275,30,39,4930.30,9170.49,0.00
2024-12-10 17:40:24,69,8276,30,39,5017.04,9171.00,0.00
2024-12-10 17:40:24,70,8276,31,39,4945.37,9171.02,0.00
2024-12-10 17:40:24,69,8276,31,38,4997.10,9171.03,0.00
2024-12-10 17:40:24,69,8277,31,38,4988.34,9172.00,0.00
2024-12-10 17:40:24,70,8277,31,39,4917.08,9172.02,0.00
2024-12-10 17:40:24,69,8277,31,38,4960.43,9172.03,0.00
2024-12-10 17:40:24,69,8278,31,38,4950.79,9173.00,0.00
2024-12-10 17:40:24,70,8278,32,38,4880.06,9173.02,0.00
2024-12-10 17:40:24,69,8278,32,37,4921.54,9173.03,0.00
2024-12-10 17:40:24,70,8277,33,37,4810.80,9173.50,0.00
2024-12-10 17:40:24,69,8277,32,37,4911.21,9173.68,0.00
2024-12-10 17:40:24,69,8278,32,37,4958.76,9174.00,0.00
2024-12-10 17:40:24,70,8278,33,37,4887.92,9174.02,0.00
2024-12-10 17:40:24,69,8278,33,36,4929.51,9174.03,0.00
2024-12-10 17:40:24,68,8278,32,36,4948.44,9174.60,0.00
2024-12-10 17:40:24,68,8279,32,36,5122.60,9175.00,0.00
2024-12-10 17:40:24,69,8279,32,37,5048.36,9175.02,0.00
2024-12-10 17:40:24,68,8279,32,36,5101.18,9175.03,0.00
2024-12-10 17:40:24,67,8279,31,36,5064.11,9175.94,0.00
2024-12-10 17:40:24,67,8280,31,36,5195.63,9176.00,0.00
2024-12-10 17:40:24,68,8280,32,36,5119.22,9176.02,0.00
2024-12-10 17:40:24,67,8280,31,36,5106.57,9176.19,0.00
2024-12-10 17:40:24,67,8281,31,36,5162.49,9177.00,0.00
2024-12-10 17:40:24,68,8281,32,36,5086.57,9177.02,0.00
2024-12-10 17:40:24,67,8281,32,35,5136.47,9177.03,0.00
2024-12-10 17:40:24,66,8281,31,35,5193.59,9177.17,0.00
2024-12-10 17:40:24,66,8282,31,35,5249.12,9178.00,0.00
2024-12-10 17:40:24,67,8282,31,36,5170.77,9178.02,0.00
2024-12-10 17:40:24,66,8282,30,36,5206.07,9178.18,0.00
2024-12-10 17:40:24,66,8283,30,36,5208.31,9179.00,0.00
2024-12-10 17:40:24,67,8283,31,36,5130.57,9179.02,0.00
2024-12-10 17:40:24,66,8283,31,35,5201.36,9179.03,0.00
2024-12-10 17:40:25,65,8283,30,35,5174.06,9179.91,0.00
2024-12-10 17:40:25,65,8284,30,35,5306.90,9180.00,0.00
2024-12-10 17:40:25,66,8284,30,36,5226.49,9180.02,0.00
2024-12-10 17:40:25,65,8284,29,36,5263.18,9180.19,0.00
2024-12-10 17:40:25,64,8284,28,36,5313.88,9180.47,0.00
2024-12-10 17:40:25,64,8284,28,36,5403.50,9181.00,0.00
2024-12-10 17:40:25,65,8284,29,36,5320.37,9181.02,0.00
2024-12-10 17:40:25,64,8284,28,36,5260.22,9181.64,0.00
2024-12-10 17:40:25,63,8284,27,36,5339.38,9181.70,0.00
2024-12-10 17:40:25,63,8285,27,36,5457.68,9182.00,0.00
2024-12-10 17:40:25,64,8285,28,36,5372.40,9182.02,0.00
2024-12-10 17:40:25,63,8285,28,35,5438.73,9182.03,0.00
2024-12-10 17:40:25,63,8286,28,35,5433.85,9183.00,0.00
2024-12-10 17:40:25,64,8286,29,35,5348.94,9183.02,0.00
2024-12-10 17:40:25,64,8287,29,35,5312.67,9184.00,0.00
2024-12-10 17:40:25,65,8287,29,36,5230.93,9184.02,0.00
2024-12-10 17:40:25,64,8287,29,35,5309.80,9184.03,0.00
2024-12-10 17:40:25,64,8288,29,35,5304.03,9185.00,0.00
2024-12-10 17:40:25,65,8288,29,36,5222.43,9185.02,0.00
2024-12-10 17:40:25,65,8289,29,36,5186.98,9186.00,0.00
2024-12-10 17:40:25,66,8289,29,37,5108.39,9186.02,0.00
2024-12-10 17:40:25,65,8289,29,36,5179.92,9186.05,0.00
2024-12-10 17:40:25,64,8289,28,36,5247.99,9186.19,0.00
2024-12-10 17:40:25,63,8289,27,36,5290.56,9186.38,0.00
2024-12-10 17:40:25,63,8290,27,36,5379.23,9187.00,0.00
2024-12-10 17:40:25,64,8290,28,36,5295.18,9187.02,0.00
2024-12-10 17:40:25,64,8291,28,36,5289.60,9188.00,0.00
2024-12-10 17:40:25,65,8291,29,36,5208.22,9188.02,0.00
2024-12-10 17:40:25,65,8292,29,36,5179.09,9189.00,0.00
2024-12-10 17:40:25,66,8292,29,37,5100.62,9189.02,0.00
2024-12-10 17:40:25,65,8292,29,36,5156.48,9189.05,0.00
2024-12-10 17:40:25,65,8293,29,36,5154.21,9190.00,0.00
2024-12-10 17:40:25,66,8293,29,37,5076.12,9190.02,0.00
2024-12-10 17:40:25,66,8294,29,37,5041.85,9191.00,0.00
2024-12-10 17:40:25,67,8294,30,37,4966.60,9191.02,0.00
2024-12-10 17:40:25,66,8294,30,36,5037.68,9191.05,0.00
2024-12-10 17:40:25,65,8294,29,36,5095.45,9191.23,0.00
2024-12-10 17:40:25,66,8293,30,36,4994.70,9191.52,0.00
2024-12-10 17:40:25,66,8294,30,36,5201.24,9192.00,0.00
2024-12-10 17:40:25,67,8294,30,37,5123.61,9192.02,0.00
2024-12-10 17:40:25,66,8294,30,36,5169.21,9192.05,0.00
2024-12-10 17:40:25,66,8295,30,36,5304.88,9193.00,0.00
2024-12-10 17:40:25,67,8295,30,37,5225.70,9193.02,0.00
2024-12-10 17:40:25,66,8295,30,36,5272.85,9193.05,0.00
2024-12-10 17:40:25,67,8294,30,37,5160.01,9193.45,0.00
2024-12-10 17:40:25,66,8294,29,37,5211.90,9193.70,0.00
2024-12-10 17:40:25,66,8295,29,37,5323.57,9194.00,0.00
2024-12-10 17:40:25,67,8295,30,37,5244.11,9194.02,0.00
2024-12-10 17:40:25,66,8295,29,37,5255.50,9194.12,0.00
2024-12-10 17:40:25,66,8296,29,37,5453.88,9195.00,0.00
2024-12-10 17:40:25,67,8296,30,37,5372.47,9195.02,0.00
2024-12-10 17:40:25,66,8296,30,36,5444.13,9195.06,0.00
2024-12-10 17:40:25,66,8297,30,36,5441.93,9196.00,0.00
2024-12-10 17:40:25,67,8297,30,37,5360.71,9196.02,0.00
2024-12-10 17:40:25,66,8297,29,37,5318.19,9196.58,0.00
2024-12-10 17:40:25,66,8298,29,37,5418.83,9197.00,0.00
2024-12-10 17:40:25,67,8298,30,37,5337.95,9197.02,0.00
2024-12-10 17:40:25,66,8298,29,37,5417.69,9197.02,0.00
2024-12-10 17:40:25,65,8298,29,36,5486.91,9197.06,0.00
2024-12-10 17:40:25,64,8298,28,36,5568.18,9197.11,0.00
2024-12-10 17:40:25,63,8298,27,36,5569.22,9197.56,0.00
2024-12-10 17:40:25,63,8299,27,36,5674.67,9198.00,0.00
2024-12-10 17:40:25,64,8299,27,37,5586.00,9198.02,0.00
2024-12-10 17:40:25,65,8298,28,37,5408.46,9198.74,0.00
2024-12-10 17:40:25,65,8299,28,37,5520.88,9199.00,0.00
2024-12-10 17:40:25,66,8299,29,37,5437.23,9199.02,0.00
2024-12-10 17:40:25,65,8299,29,36,5508.16,9199.06,0.00
2024-12-10 17:40:25,64,8299,28,36,5527.04,9199.72,0.00
2024-12-10 17:40:25,64,8300,28,36,5787.81,9200.00,0.00
2024-12-10 17:40:25,65,8300,29,36,5698.77,9200.02,0.00
2024-12-10 17:40:25,65,8301,29,36,5660.18,9201.00,0.00
2024-12-10 17:40:25,66,8301,29,37,5574.42,9201.02,0.00
2024-12-10 17:40:25,65,8301,29,36,5646.04,9201.06,0.00
2024-12-10 17:40:25,65,8302,29,36,5635.57,9202.00,0.00
2024-12-10 17:40:25,66,8302,30,36,5550.19,9202.02,0.00
2024-12-10 17:40:25,66,8303,30,36,5501.85,9203.00,0.00
2024-12-10 17:40:25,67,8303,30,37,5419.73,9203.02,0.00
2024-12-10 17:40:25,66,8303,30,36,5483.74,9203.08,0.00
2024-12-10 17:40:26,66,8304,30,36,5465.04,9204.00,0.00
2024-12-10 17:40:26,67,8304,30,37,5383.47,9204.02,0.00
2024-12-10 17:40:26,66,8304,29,37,5320.47,9204.86,0.00
2024-12-10 17:40:26,66,8305,29,37,5447.50,9205.00,0.00
2024-12-10 17:40:26,67,8305,29,38,5366.20,9205.02,0.00
2024-12-10 17:40:26,66,8305,29,37,5429.39,9205.08,0.00
2024-12-10 17:40:26,67,8304,29,38,5255.98,9205.84,0.00
2024-12-10 17:40:26,67,8305,29,38,5338.55,9206.00,0.00
2024-12-10 17:40:26,68,8305,30,38,5260.05,9206.02,0.00
2024-12-10 17:40:26,67,8305,29,38,5222.97,9206.70,0.00
2024-12-10 17:40:26,67,8306,29,38,5416.12,9207.00,0.00
2024-12-10 17:40:26,68,8306,29,39,5336.47,9207.02,0.00
2024-12-10 17:40:26,67,8306,28,39,5414.75,9207.02,0.00
2024-12-10 17:40:26,66,8306,28,38,5481.46,9207.06,0.00
2024-12-10 17:40:26,66,8307,28,38,5477.41,9208.00,0.00
2024-12-10 17:40:26,67,8307,29,38,5395.66,9208.02,0.00
2024-12-10 17:40:26,66,8307,28,38,5361.02,9208.82,0.00
2024-12-10 17:40:26,66,8308,28,38,5483.96,9209.00,0.00
2024-12-10 17:40:26,67,8308,29,38,5402.10,9209.02,0.00
2024-12-10 17:40:26,66,8308,29,37,5468.62,9209.06,0.00
2024-12-10 17:40:26,66,8309,29,37,5466.41,9210.00,0.00
2024-12-10 17:40:26,67,8309,30,37,5384.82,9210.02,0.00
2024-12-10 17:40:26,66,8309,29,37,5421.82,9210.20,0.00
2024-12-10 17:40:26,65,8309,28,37,5462.98,9210.65,0.00
2024-12-10 17:40:26,65,8310,28,37,5548.80,9211.00,0.00
2024-12-10 17:40:26,66,8310,28,38,5464.73,9211.02,0.00
2024-12-10 17:40:26,67,8309,29,38,5343.34,9211.18,0.00
2024-12-10 17:40:26,67,8310,29,38,5450.16,9212.00,0.00
2024-12-10 17:40:26,68,8310,29,39,5370.01,9212.02,0.00
2024-12-10 17:40:26,67,8310,29,38,5436.42,9212.03,0.00
2024-12-10 17:40:26,67,8311,29,38,5567.63,9213.00,0.00
2024-12-10 17:40:26,68,8311,30,38,5485.75,9213.02,0.00
2024-12-10 17:40:26,67,8311,30,37,5536.02,9213.05,0.00
2024-12-10 17:40:26,67,8312,30,37,5531.10,9214.00,0.00
2024-12-10 17:40:26,68,8312,30,38,5449.76,9214.02,0.00
2024-12-10 17:40:26,68,8313,30,38,5413.77,9215.00,0.00
2024-12-10 17:40:26,69,8313,30,39,5335.31,9215.02,0.00
2024-12-10 17:40:26,68,8313,30,38,5404.29,9215.04,0.00
2024-12-10 17:40:26,67,8313,29,38,5426.03,9215.69,0.00
2024-12-10 17:40:26,67,8314,29,38,5479.91,9216.00,0.00
2024-12-10 17:40:26,68,8314,30,38,5399.32,9216.02,0.00
2024-12-10 17:40:26,67,8314,29,38,5380.63,9216.73,0.00
2024-12-10 17:40:26,67,8315,29,38,5493.64,9217.00,0.00
2024-12-10 17:40:26,68,8315,30,38,5412.85,9217.02,0.00
2024-12-10 17:40:26,67,8315,30,37,5485.40,9217.05,0.00
2024-12-10 17:40:26,67,8316,30,37,5479.73,9218.00,0.00
2024-12-10 17:40:26,68,8316,30,38,5399.14,9218.02,0.00
2024-12-10 17:40:26,68,8317,30,38,5362.79,9219.00,0.00
2024-12-10 17:40:26,69,8317,31,38,5285.07,9219.02,0.00
2024-12-10 17:40:26,68,8317,31,37,5354.66,9219.04,0.00
2024-12-10 17:40:26,69,8316,32,37,5274.40,9219.10,0.00
2024-12-10 17:40:26,69,8317,32,37,5281.63,9220.00,0.00
2024-12-10 17:40:26,70,8317,32,38,5206.18,9220.02,0.00
2024-12-10 17:40:26,70,8318,32,38,5300.27,9221.00,0.00
2024-12-10 17:40:26,71,8318,33,38,5225.62,9221.01,0.00
2024-12-10 17:40:26,70,8318,33,37,5293.69,9221.04,0.00
2024-12-10 17:40:26,70,8319,33,37,5285.04,9222.00,0.00
2024-12-10 17:40:26,71,8319,34,37,5210.60,9222.01,0.00
2024-12-10 17:40:26,71,8320,34,37,5172.19,9223.00,0.00
2024-12-10 17:40:26,72,8320,34,38,5100.36,9223.01,0.00
2024-12-10 17:40:26,71,8320,34,37,5167.01,9223.04,0.00
2024-12-10 17:40:26,71,8321,34,37,5157.17,9224.00,0.00
2024-12-10 17:40:26,72,8321,34,38,5085.54,9224.01,0.00
2024-12-10 17:40:26,71,8321,33,38,5111.78,9224.23,0.00
2024-12-10 17:40:26,71,8322,33,38,5160.26,9225.00,0.00
2024-12-10 17:40:26,72,8322,34,38,5088.59,9225.01,0.00
2024-12-10 17:40:26,71,8322,33,38,5112.27,9225.24,0.00
2024-12-10 17:40:26,71,8323,33,38,5157.60,9226.00,0.00
2024-12-10 17:40:26,72,8323,33,39,5085.97,9226.01,0.00
2024-12-10 17:40:26,72,8324,33,39,5071.32,9227.00,0.00
2024-12-10 17:40:26,73,8324,34,39,5001.85,9227.01,0.00
2024-12-10 17:40:26,73,8325,34,39,4966.73,9228.00,0.00
2024-12-10 17:40:26,74,8325,35,39,4899.61,9228.01,0.00
2024-12-10 17:40:26,73,8325,35,38,4949.04,9228.04,0.00
2024-12-10 17:40:26,72,8325,34,38,4879.96,9228.97,0.00
2024-12-10 17:40:26,72,8326,34,38,5005.59,9229.00,0.00
2024-12-10 17:40:26,73,8326,35,38,4937.02,9229.01,0.00
2024-12-10 17:40:26,72,8326,35,37,4978.68,9229.04,0.00
2024-12-10 17:40:26,73,8325,35,38,4794.52,9229.78,0.00
2024-12-10 17:40:27,73,8326,35,38,4921.12,9230.00,0.00
2024-12-10 17:40:27,74,8326,36,38,4854.61,9230.01,0.00
2024-12-10 17:40:27,73,8326,36,37,4894.57,9230.04,0.00
2024-12-10 17:40:27,73,8327,36,37,4998.11,9231.00,0.00
2024-12-10 17:40:27,74,8327,36,38,4930.57,9231.01,0.00
2024-12-10 17:40:27,74,8328,36,38,4903.10,9232.00,0.00
2024-12-10 17:40:27,75,8328,37,38,4837.72,9232.01,0.00
2024-12-10 17:40:27,75,8329,37,38,4805.06,9233.00,0.00
2024-12-10 17:40:27,76,8329,38,38,4741.83,9233.01,0.00
2024-12-10 17:40:27,75,8329,38,37,4774.29,9233.07,0.00
2024-12-10 17:40:27,74,8329,37,37,4769.88,9233.73,0.00
2024-12-10 17:40:27,74,8330,37,37,4819.99,9234.00,0.00
2024-12-10 17:40:27,75,8330,38,37,4755.72,9234.01,0.00
2024-12-10 17:40:27,74,8330,38,36,4791.23,9234.07,0.00
2024-12-10 17:40:27,73,8330,37,36,4841.73,9234.22,0.00
2024-12-10 17:40:27,73,8331,37,36,4838.50,9235.00,0.00
2024-12-10 17:40:27,74,8331,37,37,4773.12,9235.01,0.00
2024-12-10 17:40:27,73,8331,36,37,4790.86,9235.25,0.00
2024-12-10 17:40:27,72,8331,35,37,4844.59,9235.29,0.00
2024-12-10 17:40:27,72,8332,35,37,4901.28,9236.00,0.00
2024-12-10 17:40:27,73,8332,36,37,4834.14,9236.01,0.00
2024-12-10 17:40:27,72,8332,36,36,4891.03,9236.08,0.00
2024-12-10 17:40:27,71,8332,35,36,4919.33,9236.28,0.00
2024-12-10 17:40:27,71,8333,35,36,4976.50,9237.00,0.00
2024-12-10 17:40:27,72,8333,36,36,4907.38,9237.01,0.00
2024-12-10 17:40:27,71,8333,35,36,4871.65,9237.75,0.00
2024-12-10 17:40:27,72,8332,36,36,4803.98,9237.76,0.00
2024-12-10 17:40:27,72,8333,36,36,4957.53,9238.00,0.00
2024-12-10 17:40:27,73,8333,36,37,4889.62,9238.01,0.00
2024-12-10 17:40:27,72,8333,36,36,4943.43,9238.11,0.00
2024-12-10 17:40:27,71,8333,35,36,4959.82,9238.61,0.00
2024-12-10 17:40:27,70,8333,34,36,4972.66,9238.69,0.00
2024-12-10 17:40:27,70,8334,34,36,5207.84,9239.00,0.00
2024-12-10 17:40:27,71,8334,34,37,5134.49,9239.01,0.00
2024-12-10 17:40:27,70,8334,34,36,5133.14,9239.50,0.00
2024-12-10 17:40:27,70,8335,34,36,5166.52,9240.00,0.00
2024-12-10 17:40:27,71,8335,34,37,5093.75,9240.01,0.00
2024-12-10 17:40:27,70,8335,34,36,5153.34,9240.11,0.00
2024-12-10 17:40:27,69,8335,33,36,5126.52,9240.67,0.00
2024-12-10 17:40:27,69,8336,33,36,5229.91,9241.00,0.00
2024-12-10 17:40:27,70,8336,33,37,5155.20,9241.02,0.00
2024-12-10 17:40:27,69,8336,32,37,5084.24,9241.71,0.00
2024-12-10 17:40:27,69,8337,32,37,5191.63,9242.00,0.00
2024-12-10 17:40:27,70,8337,33,37,5117.47,9242.02,0.00
2024-12-10 17:40:27,69,8337,33,36,5178.25,9242.12,0.00
2024-12-10 17:40:27,68,8337,32,36,5202.89,9242.43,0.00
2024-12-10 17:40:27,68,8338,32,36,5286.22,9243.00,0.00
2024-12-10 17:40:27,69,8338,33,36,5209.61,9243.02,0.00
2024-12-10 17:40:27,68,8338,32,36,5189.75,9243.22,0.00
2024-12-10 17:40:27,69,8337,32,37,5069.28,9243.74,0.00
2024-12-10 17:40:27,69,8338,32,37,5200.80,9244.00,0.00
2024-12-10 17:40:27,70,8338,32,38,5126.50,9244.02,0.00
2024-12-10 17:40:27,69,8338,32,37,5179.38,9244.15,0.00
2024-12-10 17:40:27,69,8339,32,37,5315.25,9245.00,0.00
2024-12-10 17:40:27,70,8339,33,37,5239.31,9245.02,0.00
2024-12-10 17:40:27,69,8339,32,37,5276.40,9245.12,0.00
2024-12-10 17:40:27,69,8340,32,37,5302.42,9246.00,0.00
2024-12-10 17:40:27,70,8340,33,37,5226.67,9246.02,0.00
2024-12-10 17:40:27,69,8340,33,36,5282.33,9246.13,0.00
2024-12-10 17:40:27,69,8341,33,36,5282.89,9247.00,0.00
2024-12-10 17:40:27,70,8341,34,36,5207.42,9247.02,0.00
2024-12-10 17:40:27,70,8342,34,36,5171.29,9248.00,0.00
2024-12-10 17:40:27,71,8342,35,36,5098.45,9248.01,0.00
2024-12-10 17:40:27,70,8342,35,35,5150.16,9248.13,0.00
2024-12-10 17:40:27,70,8343,35,35,5149.38,9249.00,0.00
2024-12-10 17:40:27,71,8343,35,36,5076.86,9249.01,0.00
2024-12-10 17:40:27,71,8344,35,36,5041.70,9250.00,0.00
2024-12-10 17:40:27,72,8344,36,36,4971.68,9250.01,0.00
2024-12-10 17:40:28,71,8344,36,35,5018.27,9250.14,0.00
2024-12-10 17:40:28,71,8345,36,35,5017.49,9251.00,0.00
2024-12-10 17:40:28,72,8345,36,36,4947.81,9251.01,0.00
2024-12-10 17:40:28,71,8345,35,36,5010.98,9251.07,0.00
2024-12-10 17:40:28,70,8345,34,36,5069.35,9251.09,0.00
2024-12-10 17:40:28,70,8346,34,36,5091.04,9252.00,0.00
2024-12-10 17:40:28,71,8346,34,37,5019.34,9252.01,0.00
2024-12-10 17:40:28,70,8346,33,37,5088.40,9252.03,0.00
2024-12-10 17:40:28,69,8346,32,37,5160.81,9252.03,0.00
2024-12-10 17:40:28,68,8346,31,37,5209.49,9252.06,0.00
2024-12-10 17:40:28,68,8347,31,37,5231.82,9253.00,0.00
2024-12-10 17:40:28,69,8347,32,37,5156.00,9253.02,0.00
2024-12-10 17:40:28,68,8347,31,37,5229.10,9253.03,0.00
2024-12-10 17:40:28,67,8347,31,36,5286.44,9253.07,0.00
2024-12-10 17:40:28,67,8348,31,36,5284.24,9254.00,0.00
2024-12-10 17:40:28,68,8348,32,36,5206.53,9254.02,0.00
2024-12-10 17:40:28,68,8349,32,36,5173.01,9255.00,0.00
2024-12-10 17:40:28,69,8349,33,36,5098.04,9255.02,0.00
2024-12-10 17:40:28,68,8349,33,35,5152.60,9255.07,0.00
2024-12-10 17:40:28,67,8349,32,35,5202.91,9255.36,0.00
2024-12-10 17:40:28,67,8350,32,35,5226.85,9256.00,0.00
2024-12-10 17:40:28,68,8350,33,35,5149.98,9256.02,0.00
2024-12-10 17:40:28,68,8351,33,35,5116.19,9257.00,0.00
2024-12-10 17:40:28,69,8351,33,36,5042.04,9257.02,0.00
2024-12-10 17:40:28,68,8351,33,35,5096.81,9257.07,0.00
2024-12-10 17:40:28,69,8350,33,36,4985.56,9257.51,0.00
2024-12-10 17:40:28,69,8351,33,36,5063.73,9258.00,0.00
2024-12-10 17:40:28,70,8351,33,37,4991.39,9258.02,0.00
2024-12-10 17:40:28,69,8351,32,37,5062.39,9258.02,0.00
2024-12-10 17:40:28,68,8351,31,37,5135.48,9258.02,0.00
2024-12-10 17:40:28,67,8351,31,36,5208.78,9258.03,0.00
2024-12-10 17:40:28,67,8352,31,36,5318.72,9259.00,0.00
2024-12-10 17:40:28,68,8352,32,36,5240.51,9259.02,0.00
2024-12-10 17:40:28,67,8352,32,35,5302.14,9259.03,0.00
2024-12-10 17:40:28,67,8353,32,35,5295.80,9260.00,0.00
2024-12-10 17:40:28,68,8353,32,36,5217.92,9260.02,0.00
2024-12-10 17:40:28,67,8353,31,36,5221.17,9260.05,0.00
2024-12-10 17:40:28,67,8354,31,36,5271.49,9261.00,0.00
2024-12-10 17:40:28,68,8354,31,37,5193.97,9261.02,0.00
2024-12-10 17:40:28,67,8354,30,37,5232.82,9261.14,0.00
2024-12-10 17:40:28,67,8355,30,37,5239.22,9262.00,0.00
2024-12-10 17:40:28,68,8355,30,38,5162.17,9262.02,0.00
2024-12-10 17:40:28,67,8355,30,37,5219.87,9262.06,0.00
2024-12-10 17:40:28,67,8356,30,37,5216.28,9263.00,0.00
2024-12-10 17:40:28,68,8356,30,38,5139.57,9263.02,0.00
2024-12-10 17:40:28,67,8356,29,38,5177.60,9263.14,0.00
2024-12-10 17:40:28,66,8356,28,38,5172.26,9263.86,0.00
2024-12-10 17:40:28,66,8357,28,38,5300.10,9264.00,0.00
2024-12-10 17:40:28,67,8357,28,39,5220.99,9264.02,0.00
2024-12-10 17:40:28,66,8357,28,38,5281.86,9264.06,0.00
2024-12-10 17:40:28,66,8358,28,38,5279.61,9265.00,0.00
2024-12-10 17:40:28,67,8358,28,39,5200.81,9265.02,0.00
2024-12-10 17:40:28,67,8359,28,39,5178.12,9266.00,0.00
2024-12-10 17:40:28,68,8359,29,39,5101.98,9266.02,0.00
2024-12-10 17:40:28,67,8359,29,38,5146.32,9266.06,0.00
2024-12-10 17:40:28,66,8359,28,38,5214.50,9266.15,0.00
2024-12-10 17:40:28,66,8360,28,38,5220.64,9267.00,0.00
2024-12-10 17:40:28,67,8360,29,38,5142.72,9267.02,0.00
2024-12-10 17:40:28,66,8360,28,38,5175.75,9267.17,0.00
2024-12-10 17:40:28,65,8360,27,38,5214.08,9267.62,0.00
2024-12-10 17:40:28,65,8361,27,38,5321.27,9268.00,0.00
2024-12-10 17:40:28,66,8361,27,39,5240.65,9268.02,0.00
2024-12-10 17:40:28,65,8361,27,38,5315.57,9268.03,0.00
2024-12-10 17:40:28,65,8362,27,38,5311.87,9269.00,0.00
2024-12-10 17:40:28,66,8362,27,39,5231.38,9269.02,0.00
2024-12-10 17:40:28,65,8362,27,38,5297.61,9269.05,0.00
2024-12-10 17:40:28,65,8363,27,38,5295.32,9270.00,0.00
2024-12-10 17:40:28,66,8363,28,38,5215.09,9270.02,0.00
2024-12-10 17:40:28,65,8363,27,38,5165.83,9270.59,0.00
2024-12-10 17:40:28,65,8364,27,38,5270.22,9271.00,0.00
2024-12-10 17:40:28,66,8364,28,38,5190.37,9271.02,0.00
2024-12-10 17:40:28,65,8364,28,37,5255.96,9271.05,0.00
2024-12-10 17:40:28,64,8364,27,37,5281.04,9271.66,0.00
2024-12-10 17:40:28,64,8365,27,37,5336.35,9272.00,0.00
2024-12-10 17:40:28,65,8365,28,37,5254.25,9272.02,0.00
2024-12-10 17:40:28,64,8365,27,37,5266.55,9272.25,0.00
2024-12-10 17:40:28,64,8366,27,37,5342.37,9273.00,0.00
2024-12-10 17:40:28,65,8366,27,38,5260.18,9273.02,0.00
2024-12-10 17:40:28,64,8366,27,37,5326.44,9273.05,0.00
2024-12-10 17:40:28,64,8367,27,37,5325.56,9274.00,0.00
2024-12-10 17:40:28,65,8367,27,38,5243.63,9274.02,0.00
2024-12-10 17:40:28,65,8368,27,38,5209.95,9275.00,0.00
2024-12-10 17:40:28,66,8368,28,38,5131.01,9275.02,0.00
2024-12-10 17:40:28,65,8368,28,37,5192.83,9275.05,0.00
2024-12-10 17:40:28,64,8368,27,37,5162.91,9275.97,0.00
2024-12-10 17:40:28,64,8369,27,37,5304.97,9276.00,0.00
2024-12-10 17:40:28,65,8369,27,38,5223.35,9276.02,0.00
2024-12-10 17:40:28,64,8369,26,38,5303.52,9276.02,0.00
2024-12-10 17:40:28,64,8370,26,38,5270.75,9277.00,0.00
2024-12-10 17:40:28,65,8370,26,39,5189.66,9277.02,0.00
2024-12-10 17:40:28,64,8370,26,38,5256.26,9277.03,0.00
2024-12-10 17:40:28,65,8369,27,38,5144.14,9277.40,0.00
2024-12-10 17:40:28,66,8368,28,38,5121.05,9277.45,0.00
2024-12-10 17:40:29,66,8369,28,38,5209.98,9278.00,0.00
2024-12-10 17:40:29,67,8369,28,39,5132.22,9278.02,0.00
2024-12-10 17:40:29,68,8368,29,39,4898.58,9278.88,0.00
2024-12-10 17:40:29,68,8369,29,39,5361.24,9279.00,0.00
2024-12-10 17:40:29,69,8369,30,39,5283.54,9279.02,0.00
2024-12-10 17:40:29,68,8369,30,38,5350.32,9279.03,0.00
2024-12-10 17:40:29,69,8368,30,39,5244.68,9279.36,0.00
2024-12-10 17:40:29,69,8369,30,39,5402.46,9280.00,0.00
2024-12-10 17:40:29,70,8369,31,39,5325.28,9280.02,0.00
2024-12-10 17:40:29,69,8369,30,39,5273.83,9280.88,0.00
2024-12-10 17:40:29,69,8370,30,39,5532.17,9281.00,0.00
2024-12-10 17:40:29,70,8370,30,40,5453.14,9281.02,0.00
2024-12-10 17:40:29,69,8370,30,39,5521.41,9281.03,0.00
2024-12-10 17:40:29,69,8371,30,39,5512.53,9282.00,0.00
2024-12-10 17:40:29,70,8371,30,40,5433.78,9282.02,0.00
2024-12-10 17:40:29,69,8371,29,40,5385.16,9282.58,0.00
2024-12-10 17:40:29,69,8372,29,40,5480.99,9283.00,0.00
2024-12-10 17:40:29,70,8372,29,41,5402.69,9283.02,0.00
2024-12-10 17:40:29,69,8372,29,40,5467.54,9283.03,0.00
2024-12-10 17:40:29,69,8373,29,40,5457.82,9284.00,0.00
2024-12-10 17:40:29,70,8373,29,41,5379.85,9284.02,0.00
2024-12-10 17:40:29,70,8374,29,41,5341.63,9285.00,0.00
2024-12-10 17:40:29,71,8374,30,41,5266.40,9285.01,0.00
2024-12-10 17:40:29,70,8374,30,40,5324.40,9285.06,0.00
2024-12-10 17:40:29,69,8374,29,40,5313.95,9285.54,0.00
2024-12-10 17:40:29,69,8375,29,40,5402.28,9286.00,0.00
2024-12-10 17:40:29,70,8375,29,41,5325.10,9286.02,0.00
2024-12-10 17:40:29,70,8376,29,41,5279.60,9287.00,0.00
2024-12-10 17:40:29,71,8376,30,41,5205.24,9287.01,0.00
2024-12-10 17:40:29,70,8376,30,40,5263.69,9287.06,0.00
2024-12-10 17:40:29,69,8376,29,40,5284.88,9287.58,0.00
2024-12-10 17:40:29,68,8376,28,40,5353.46,9287.68,0.00
2024-12-10 17:40:29,67,8376,27,40,5431.97,9287.69,0.00
2024-12-10 17:40:29,67,8377,27,40,5478.89,9288.00,0.00
2024-12-10 17:40:29,68,8377,27,41,5398.32,9288.02,0.00
2024-12-10 17:40:29,67,8377,26,41,5356.16,9288.54,0.00
2024-12-10 17:40:29,68,8376,27,41,5276.04,9288.57,0.00
2024-12-10 17:40:29,68,8377,27,41,5405.14,9289.00,0.00
2024-12-10 17:40:29,69,8377,28,41,5326.80,9289.02,0.00
2024-12-10 17:40:29,68,8377,28,40,5387.39,9289.06,0.00
2024-12-10 17:40:29,67,8377,27,40,5358.56,9289.87,0.00
2024-12-10 17:40:29,67,8378,27,40,5623.48,9290.00,0.00
2024-12-10 17:40:29,68,8378,28,40,5540.78,9290.02,0.00
2024-12-10 17:40:29,67,8378,27,40,5579.37,9290.16,0.00
2024-12-10 17:40:29,67,8379,27,40,5569.57,9291.00,0.00
2024-12-10 17:40:29,68,8379,28,40,5487.67,9291.02,0.00
2024-12-10 17:40:29,67,8379,27,40,5568.18,9291.02,0.00
2024-12-10 17:40:29,66,8379,27,39,5632.71,9291.06,0.00
2024-12-10 17:40:29,66,8380,27,39,5613.68,9292.00,0.00
2024-12-10 17:40:29,67,8380,28,39,5529.89,9292.02,0.00
2024-12-10 17:40:29,67,8381,28,39,5478.34,9293.00,0.00
2024-12-10 17:40:29,68,8381,28,40,5397.77,9293.02,0.00
2024-12-10 17:40:29,67,8381,28,39,5458.93,9293.06,0.00
2024-12-10 17:40:29,66,8381,27,39,5531.83,9293.17,0.00
2024-12-10 17:40:29,66,8382,27,39,5524.63,9294.00,0.00
2024-12-10 17:40:29,67,8382,27,40,5442.17,9294.02,0.00
2024-12-10 17:40:29,67,8383,27,40,5426.21,9295.00,0.00
2024-12-10 17:40:29,68,8383,27,41,5346.41,9295.02,0.00
2024-12-10 17:40:29,67,8383,26,41,5322.13,9295.70,0.00
2024-12-10 17:40:29,67,8384,26,41,5390.71,9296.00,0.00
2024-12-10 17:40:29,68,8384,26,42,5311.43,9296.02,0.00
2024-12-10 17:40:29,68,8385,26,42,5275.09,9297.00,0.00
2024-12-10 17:40:29,69,8385,27,42,5198.64,9297.02,0.00
2024-12-10 17:40:29,68,8385,27,41,5269.63,9297.06,0.00
2024-12-10 17:40:29,69,8384,28,41,5190.58,9297.12,0.00
2024-12-10 17:40:29,68,8384,27,41,5282.91,9297.88,0.00
2024-12-10 17:40:29,68,8385,27,41,5408.78,9298.00,0.00
2024-12-10 17:40:29,69,8385,28,41,5330.39,9298.02,0.00
2024-12-10 17:40:29,70,8384,29,41,5178.62,9298.17,0.00
2024-12-10 17:40:29,70,8385,29,41,5452.79,9299.00,0.00
2024-12-10 17:40:29,71,8385,30,41,5375.99,9299.01,0.00
2024-12-10 17:40:29,70,8385,29,41,5419.54,9299.07,0.00
2024-12-10 17:40:29,70,8386,29,41,5599.48,9300.00,0.00
2024-12-10 17:40:29,71,8386,29,42,5520.61,9300.01,0.00
2024-12-10 17:40:29,70,8386,29,41,5590.19,9300.06,0.00
2024-12-10 17:40:29,70,8387,29,41,5582.80,9301.00,0.00
2024-12-10 17:40:29,71,8387,30,41,5504.17,9301.01,0.00
2024-12-10 17:40:29,71,8388,30,41,5465.88,9302.00,0.00
2024-12-10 17:40:29,72,8388,31,41,5389.97,9302.01,0.00
2024-12-10 17:40:29,71,8388,31,40,5444.95,9302.10,0.00
2024-12-10 17:40:29,71,8389,31,40,5440.24,9303.00,0.00
2024-12-10 17:40:29,72,8389,32,40,5364.68,9303.01,0.00
2024-12-10 17:40:30,72,8390,32,40,5359.07,9304.00,0.00
2024-12-10 17:40:30,73,8390,32,41,5285.66,9304.01,0.00
2024-12-10 17:40:30,73,8391,32,41,5265.51,9305.00,0.00
2024-12-10 17:40:30,74,8391,33,41,5194.35,9305.01,0.00
2024-12-10 17:40:30,74,8392,33,41,5153.02,9306.00,0.00
2024-12-10 17:40:30,75,8392,34,41,5084.31,9306.01,0.00
2024-12-10 17:40:30,74,8392,34,40,5119.25,9306.12,0.00
2024-12-10 17:40:30,73,8392,33,40,5177.95,9306.25,0.00
2024-12-10 17:40:30,73,8393,33,40,5182.38,9307.00,0.00
2024-12-10 17:40:30,74,8393,34,40,5112.35,9307.01,0.00
2024-12-10 17:40:30,73,8393,33,40,5078.39,9307.69,0.00
2024-12-10 17:40:30,73,8394,33,40,5129.68,9308.00,0.00
2024-12-10 17:40:30,74,8394,34,40,5060.36,9308.01,0.00
2024-12-10 17:40:30,73,8394,34,39,5081.27,9308.16,0.00
2024-12-10 17:40:30,72,8394,33,39,5145.11,9308.24,0.00
2024-12-10 17:40:30,71,8394,32,39,5217.58,9308.24,0.00
2024-12-10 17:40:30,70,8394,31,39,5237.20,9308.73,0.00
2024-12-10 17:40:30,70,8395,31,39,5344.32,9309.00,0.00
2024-12-10 17:40:30,71,8395,31,40,5269.05,9309.01,0.00
2024-12-10 17:40:30,72,8394,32,40,5089.98,9309.61,0.00
2024-12-10 17:40:30,72,8395,32,40,5167.27,9310.00,0.00
2024-12-10 17:40:30,73,8395,33,40,5096.48,9310.01,0.00
2024-12-10 17:40:30,72,8395,33,39,5110.85,9310.17,0.00
2024-12-10 17:40:30,71,8395,32,39,5086.76,9310.66,0.00
2024-12-10 17:40:30,70,8395,31,39,5157.87,9310.69,0.00
2024-12-10 17:40:30,70,8396,31,39,5394.39,9311.00,0.00
2024-12-10 17:40:30,71,8396,31,40,5318.41,9311.01,0.00
2024-12-10 17:40:30,70,8396,30,40,5393.06,9311.02,0.00
2024-12-10 17:40:30,69,8396,29,40,5461.59,9311.04,0.00
2024-12-10 17:40:30,68,8396,28,40,5498.11,9311.12,0.00
2024-12-10 17:40:30,67,8396,27,40,5544.07,9311.21,0.00
2024-12-10 17:40:30,67,8397,27,40,5608.54,9312.00,0.00
2024-12-10 17:40:30,68,8397,28,40,5526.06,9312.02,0.00
2024-12-10 17:40:30,67,8397,28,39,5584.95,9312.14,0.00
2024-12-10 17:40:30,67,8398,28,39,5586.01,9313.00,0.00
2024-12-10 17:40:30,68,8398,29,39,5503.86,9313.02,0.00
2024-12-10 17:40:30,69,8397,30,39,5424.10,9313.04,0.00
2024-12-10 17:40:30,70,8396,31,39,5453.07,9313.11,0.00
2024-12-10 17:40:30,70,8397,31,39,5439.34,9314.00,0.00
2024-12-10 17:40:30,71,8397,31,40,5362.73,9314.01,0.00
2024-12-10 17:40:30,71,8398,31,40,5616.51,9315.00,0.00
2024-12-10 17:40:30,72,8398,31,41,5538.51,9315.01,0.00
2024-12-10 17:40:30,72,8399,31,41,5510.55,9316.00,0.00
2024-12-10 17:40:30,73,8399,31,42,5435.07,9316.01,0.00
2024-12-10 17:40:30,73,8400,31,42,5386.51,9317.00,0.00
2024-12-10 17:40:30,74,8400,32,42,5313.71,9317.01,0.00
2024-12-10 17:40:30,74,8401,32,42,5240.30,9318.00,0.00
2024-12-10 17:40:30,75,8401,32,43,5170.43,9318.01,0.00
2024-12-10 17:40:30,74,8401,32,42,5220.15,9318.01,0.00
2024-12-10 17:40:30,74,8402,32,42,5164.83,9319.00,0.00
2024-12-10 17:40:30,75,8402,33,42,5095.96,9319.01,0.00
2024-12-10 17:40:30,76,8401,33,43,5025.24,9319.08,0.00
2024-12-10 17:40:30,75,8401,33,42,5091.02,9319.12,0.00
2024-12-10 17:40:30,75,8402,33,42,5044.44,9320.00,0.00
2024-12-10 17:40:30,76,8402,33,43,4978.07,9320.01,0.00
2024-12-10 17:40:30,77,8401,34,43,4849.40,9320.47,0.00
2024-12-10 17:40:30,76,8401,34,42,4885.71,9320.62,0.00
2024-12-10 17:40:30,76,8402,34,42,5036.83,9321.00,0.00
2024-12-10 17:40:30,77,8402,34,43,4971.42,9321.01,0.00
2024-12-10 17:40:30,76,8402,34,42,5024.64,9321.11,0.00
2024-12-10 17:40:30,75,8402,33,42,4986.19,9321.60,0.00
2024-12-10 17:40:30,74,8402,32,42,5040.83,9321.70,0.00
2024-12-10 17:40:30,74,8403,32,42,5263.83,9322.00,0.00
2024-12-10 17:40:30,75,8403,32,43,5193.65,9322.01,0.00
2024-12-10 17:40:30,75,8404,32,43,5135.83,9323.00,0.00
2024-12-10 17:40:30,76,8404,33,43,5068.25,9323.01,0.00
2024-12-10 17:40:30,75,8404,32,43,5134.00,9323.01,0.00
2024-12-10 17:40:30,74,8404,32,42,5193.33,9323.10,0.00
2024-12-10 17:40:30,73,8404,31,42,5233.90,9323.30,0.00
2024-12-10 17:40:30,72,8404,31,41,5269.18,9323.56,0.00
2024-12-10 17:40:30,73,8403,31,42,5177.46,9323.77,0.00
2024-12-10 17:40:30,73,8404,31,42,5351.35,9324.00,0.00
2024-12-10 17:40:30,74,8404,31,43,5279.04,9324.01,0.00
2024-12-10 17:40:30,75,8403,31,44,5094.34,9324.91,0.00
2024-12-10 17:40:30,75,8404,31,44,5289.62,9325.00,0.00
2024-12-10 17:40:30,76,8404,31,45,5220.02,9325.01,0.00
2024-12-10 17:40:30,75,8404,31,44,5275.97,9325.09,0.00
2024-12-10 17:40:30,75,8405,31,44,5382.45,9326.00,0.00
2024-12-10 17:40:30,76,8405,31,45,5311.63,9326.01,0.00
2024-12-10 17:40:30,77,8404,31,46,5155.47,9326.62,0.00
2024-12-10 17:40:30,77,8405,31,46,5221.18,9327.00,0.00
2024-12-10 17:40:30,78,8405,31,47,5154.24,9327.01,0.00
2024-12-10 17:40:30,77,8405,31,46,5201.02,9327.10,0.00
2024-12-10 17:40:30,76,8405,30,46,5204.47,9327.70,0.00
2024-12-10 17:40:30,76,8406,30,46,5421.94,9328.00,0.00
2024-12-10 17:40:30,77,8406,31,46,5351.52,9328.01,0.00
2024-12-10 17:40:30,77,8407,31,46,5299.81,9329.00,0.00
2024-12-10 17:40:30,78,8407,31,47,5231.87,9329.01,0.00
2024-12-10 17:40:30,77,8407,31,46,5298.60,9329.01,0.00
2024-12-10 17:40:30,76,8407,31,45,5344.72,9329.09,0.00
2024-12-10 17:40:30,76,8408,31,45,5329.38,9330.00,0.00
2024-12-10 17:40:30,77,8408,31,46,5260.17,9330.01,0.00
2024-12-10 17:40:30,76,8408,30,46,5328.16,9330.01,0.00
2024-12-10 17:40:30,76,8409,30,46,5292.26,9331.00,0.00
2024-12-10 17:40:30,77,8409,30,47,5223.53,9331.01,0.00
2024-12-10 17:40:30,76,8409,29,47,5223.64,9331.28,0.00
2024-12-10 17:40:31,75,8409,28,47,5249.96,9331.69,0.00
2024-12-10 17:40:31,75,8410,28,47,5346.02,9332.00,0.00
2024-12-10 17:40:31,76,8410,29,47,5275.67,9332.01,0.00
2024-12-10 17:40:31,75,8410,29,46,5334.97,9332.08,0.00
2024-12-10 17:40:31,76,8409,29,47,5256.20,9332.20,0.00
2024-12-10 17:40:31,76,8410,29,47,5324.09,9333.00,0.00
2024-12-10 17:40:31,77,8410,29,48,5254.94,9333.01,0.00
2024-12-10 17:40:31,77,8411,29,48,5317.94,9334.00,0.00
2024-12-10 17:40:31,78,8411,29,49,5249.76,9334.01,0.00
2024-12-10 17:40:31,77,8411,28,49,5315.52,9334.03,0.00
2024-12-10 17:40:31,76,8411,28,48,5375.64,9334.07,0.00
2024-12-10 17:40:31,75,8411,27,48,5329.88,9334.64,0.00
2024-12-10 17:40:31,75,8412,27,48,5417.84,9335.00,0.00
2024-12-10 17:40:31,76,8412,28,48,5346.55,9335.01,0.00
2024-12-10 17:40:31,75,8412,27,48,5334.83,9335.39,0.00
2024-12-10 17:40:31,75,8413,27,48,5384.05,9336.00,0.00
2024-12-10 17:40:31,76,8413,28,48,5313.21,9336.01,0.00
2024-12-10 17:40:31,75,8413,27,48,5381.57,9336.03,0.00
2024-12-10 17:40:31,74,8413,27,47,5442.95,9336.07,0.00
2024-12-10 17:40:31,75,8412,28,47,5318.08,9336.53,0.00
2024-12-10 17:40:31,76,8411,28,48,5322.70,9336.66,0.00
2024-12-10 17:40:31,76,8412,28,48,5382.27,9337.00,0.00
2024-12-10 17:40:31,77,8412,29,48,5312.38,9337.01,0.00
2024-12-10 17:40:31,77,8413,29,48,5490.41,9338.00,0.00
2024-12-10 17:40:31,78,8413,30,48,5420.02,9338.01,0.00
2024-12-10 17:40:31,77,8413,30,47,5479.51,9338.06,0.00
2024-12-10 17:40:31,78,8412,31,47,5377.23,9338.42,0.00
2024-12-10 17:40:31,79,8411,31,48,5386.12,9338.56,0.00
2024-12-10 17:40:31,79,8412,31,48,5415.08,9339.00,0.00
2024-12-10 17:40:31,80,8412,32,48,5347.39,9339.01,0.00
2024-12-10 17:40:31,80,8413,32,48,5506.73,9340.00,0.00
2024-12-10 17:40:31,81,8413,33,48,5438.75,9340.01,0.00
2024-12-10 17:40:31,82,8412,34,48,5372.42,9340.04,0.00
2024-12-10 17:40:31,81,8412,34,47,5453.75,9340.07,0.00
2024-12-10 17:40:31,81,8413,34,47,5404.76,9341.00,0.00
2024-12-10 17:40:31,82,8413,35,47,5338.85,9341.01,0.00
2024-12-10 17:40:31,81,8413,34,47,5403.24,9341.02,0.00
2024-12-10 17:40:31,80,8413,33,47,5369.78,9341.46,0.00
2024-12-10 17:40:31,79,8413,33,46,5383.14,9341.71,0.00
2024-12-10 17:40:31,79,8414,33,46,5592.47,9342.00,0.00
2024-12-10 17:40:31,80,8414,33,47,5522.57,9342.01,0.00
2024-12-10 17:40:31,79,8414,33,46,5585.39,9342.05,0.00
2024-12-10 17:40:31,79,8415,33,46,5551.91,9343.00,0.00
2024-12-10 17:40:31,80,8415,34,46,5482.51,9343.01,0.00
2024-12-10 17:40:31,79,8415,33,46,5403.18,9343.66,0.00
2024-12-10 17:40:31,79,8416,33,46,5486.06,9344.00,0.00
2024-12-10 17:40:31,80,8416,34,46,5417.48,9344.01,0.00
2024-12-10 17:40:31,79,8416,34,45,5480.15,9344.05,0.00
2024-12-10 17:40:31,79,8417,34,45,5440.23,9345.00,0.00
2024-12-10 17:40:31,80,8417,34,46,5372.22,9345.01,0.00
2024-12-10 17:40:31,81,8416,34,47,5302.45,9345.07,0.00
2024-12-10 17:40:31,80,8416,34,46,5328.28,9345.36,0.00
2024-12-10 17:40:31,80,8417,34,46,5316.43,9346.00,0.00
2024-12-10 17:40:31,81,8417,34,47,5250.79,9346.01,0.00
2024-12-10 17:40:31,80,8417,34,46,5300.10,9346.09,0.00
2024-12-10 17:40:31,79,8417,33,46,5259.83,9346.80,0.00
2024-12-10 17:40:31,79,8418,33,46,5476.29,9347.00,0.00
2024-12-10 17:40:31,80,8418,33,47,5407.84,9347.01,0.00
2024-12-10 17:40:31,81,8417,33,48,5162.34,9347.86,0.00
2024-12-10 17:40:31,81,8418,33,48,5274.40,9348.00,0.00
2024-12-10 17:40:31,82,8418,34,48,5210.08,9348.01,0.00
2024-12-10 17:40:31,81,8418,34,47,5259.42,9348.09,0.00
2024-12-10 17:40:31,81,8419,34,47,5324.75,9349.00,0.00
2024-12-10 17:40:31,82,8419,35,47,5259.82,9349.01,0.00
2024-12-10 17:40:31,81,8419,35,46,5295.92,9349.06,0.00
2024-12-10 17:40:31,80,8419,34,46,5291.30,9349.66,0.00
2024-12-10 17:40:31,80,8420,34,46,5313.18,9350.00,0.00
2024-12-10 17:40:31,81,8420,34,47,5247.58,9350.01,0.00
2024-12-10 17:40:31,81,8421,34,47,5203.81,9351.00,0.00
2024-12-10 17:40:31,82,8421,35,47,5140.35,9351.01,0.00
2024-12-10 17:40:31,81,8421,35,46,5201.51,9351.02,0.00
2024-12-10 17:40:31,80,8421,35,45,5233.30,9351.13,0.00
2024-12-10 17:40:31,79,8421,34,45,5291.28,9351.20,0.00
2024-12-10 17:40:31,78,8421,34,44,5341.84,9351.31,0.00
2024-12-10 17:40:31,77,8421,34,43,5352.28,9351.66,0.00
2024-12-10 17:40:31,77,8422,34,43,5427.84,9352.00,0.00
2024-12-10 17:40:31,78,8422,35,43,5358.25,9352.01,0.00
2024-12-10 17:40:31,78,8423,35,43,5316.77,9353.00,0.00
2024-12-10 17:40:31,79,8423,35,44,5249.46,9353.01,0.00
2024-12-10 17:40:31,79,8424,35,44,5186.88,9354.00,0.00
2024-12-10 17:40:31,80,8424,36,44,5122.04,9354.01,0.00
2024-12-10 17:40:31,79,8424,36,43,5170.31,9354.04,0.00
2024-12-10 17:40:32,79,8425,36,43,5125.72,9355.00,0.00
2024-12-10 17:40:32,80,8425,37,43,5061.65,9355.01,0.00
2024-12-10 17:40:32,79,8425,36,43,5081.11,9355.23,0.00
2024-12-10 17:40:32,78,8425,35,43,5135.53,9355.28,0.00
2024-12-10 17:40:32,79,8424,35,44,5046.35,9355.44,0.00
2024-12-10 17:40:32,80,8423,36,44,5025.38,9355.46,0.00
2024-12-10 17:40:32,79,8423,35,44,5082.98,9355.73,0.00
2024-12-10 17:40:32,79,8424,35,44,5176.74,9356.00,0.00
2024-12-10 17:40:32,80,8424,35,45,5112.03,9356.01,0.00
2024-12-10 17:40:32,79,8424,35,44,5172.01,9356.05,0.00
2024-12-10 17:40:32,79,8425,35,44,5368.57,9357.00,0.00
2024-12-10 17:40:32,80,8425,36,44,5301.46,9357.01,0.00
2024-12-10 17:40:32,79,8425,36,43,5340.15,9357.05,0.00
2024-12-10 17:40:32,78,8425,36,42,5367.28,9357.35,0.00
2024-12-10 17:40:32,78,8426,36,42,5365.94,9358.00,0.00
2024-12-10 17:40:32,79,8426,36,43,5298.01,9358.01,0.00
2024-12-10 17:40:32,78,8426,36,42,5337.15,9358.05,0.00
2024-12-10 17:40:32,77,8426,35,42,5378.51,9358.06,0.00
2024-12-10 17:40:32,76,8426,34,42,5431.65,9358.17,0.00
2024-12-10 17:40:32,75,8426,34,41,5460.31,9358.55,0.00
2024-12-10 17:40:32,75,8427,34,41,5538.84,9359.00,0.00
2024-12-10 17:40:32,76,8427,35,41,5465.96,9359.01,0.00
2024-12-10 17:40:32,75,8427,34,41,5493.74,9359.17,0.00
2024-12-10 17:40:32,75,8428,34,41,5473.86,9360.00,0.00
2024-12-10 17:40:32,76,8428,35,41,5401.83,9360.01,0.00
2024-12-10 17:40:32,75,8428,35,40,5471.37,9360.03,0.00
2024-12-10 17:40:32,74,8428,35,39,5540.25,9360.05,0.00
2024-12-10 17:40:32,74,8429,35,39,5498.10,9361.00,0.00
2024-12-10 17:40:32,75,8429,36,39,5424.79,9361.01,0.00
2024-12-10 17:40:32,76,8428,37,39,5312.26,9361.19,0.00
2024-12-10 17:40:32,77,8427,37,40,5362.43,9361.22,0.00
2024-12-10 17:40:32,76,8427,36,40,5362.36,9361.62,0.00
2024-12-10 17:40:32,76,8428,36,40,5446.11,9362.00,0.00
2024-12-10 17:40:32,77,8428,37,40,5375.38,9362.01,0.00
2024-12-10 17:40:32,76,8428,37,39,5441.19,9362.05,0.00
2024-12-10 17:40:32,75,8428,36,39,5422.41,9362.65,0.00
2024-12-10 17:40:32,75,8429,36,39,5714.77,9363.00,0.00
2024-12-10 17:40:32,76,8429,36,40,5639.57,9363.01,0.00
2024-12-10 17:40:32,75,8429,36,39,5684.82,9363.05,0.00
2024-12-10 17:40:32,76,8428,36,40,5532.41,9363.50,0.00
2024-12-10 17:40:32,76,8429,36,40,5593.60,9364.00,0.00
2024-12-10 17:40:32,77,8429,37,40,5520.96,9364.01,0.00
2024-12-10 17:40:32,76,8429,37,39,5564.04,9364.05,0.00
2024-12-10 17:40:32,76,8430,37,39,5615.06,9365.00,0.00
2024-12-10 17:40:32,77,8430,38,39,5542.14,9365.01,0.00
2024-12-10 17:40:32,76,8430,37,39,5563.88,9365.19,0.00
2024-12-10 17:40:32,76,8431,37,39,5511.45,9366.00,0.00
2024-12-10 17:40:32,77,8431,38,39,5439.87,9366.01,0.00
2024-12-10 17:40:32,76,8431,38,38,5506.52,9366.05,0.00
2024-12-10 17:40:32,75,8431,38,37,5546.89,9366.23,0.00
2024-12-10 17:40:32,74,8431,37,37,5606.57,9366.30,0.00
2024-12-10 17:40:32,75,8430,38,37,5514.48,9366.44,0.00
2024-12-10 17:40:32,75,8431,38,37,5509.88,9367.00,0.00
2024-12-10 17:40:32,76,8431,38,38,5437.38,9367.01,0.00
2024-12-10 17:40:32,76,8432,38,38,5448.90,9368.00,0.00
2024-12-10 17:40:32,77,8432,38,39,5378.13,9368.01,0.00
2024-12-10 17:40:32,76,8432,38,38,5443.98,9368.05,0.00
2024-12-10 17:40:32,75,8432,38,37,5463.75,9368.31,0.00
2024-12-10 17:40:32,76,8431,39,37,5352.05,9368.62,0.00
2024-12-10 17:40:32,75,8431,38,37,5423.48,9368.76,0.00
2024-12-10 17:40:32,75,8432,38,37,5486.71,9369.00,0.00
2024-12-10 17:40:32,76,8432,39,37,5414.52,9369.01,0.00
2024-12-10 17:40:32,75,8432,38,37,5356.76,9369.65,0.00
2024-12-10 17:40:32,75,8433,38,37,5467.72,9370.00,0.00
2024-12-10 17:40:32,76,8433,38,38,5395.77,9370.01,0.00
2024-12-10 17:40:32,75,8433,38,37,5458.98,9370.05,0.00
2024-12-10 17:40:32,74,8433,37,37,5449.54,9370.45,0.00
2024-12-10 17:40:32,74,8434,37,37,5399.08,9371.00,0.00
2024-12-10 17:40:32,75,8434,37,38,5327.10,9371.01,0.00
2024-12-10 17:40:32,74,8434,37,37,5390.99,9371.05,0.00
2024-12-10 17:40:32,73,8434,37,36,5225.90,9371.84,0.00
2024-12-10 17:40:32,73,8435,37,36,5339.01,9372.00,0.00
2024-12-10 17:40:32,74,8435,37,37,5266.86,9372.01,0.00
2024-12-10 17:40:32,73,8435,36,37,5318.70,9372.10,0.00
2024-12-10 17:40:32,74,8434,37,37,5215.18,9372.19,0.00
2024-12-10 17:40:32,73,8434,37,36,5220.27,9372.71,0.00
2024-12-10 17:40:32,73,8435,37,36,5258.04,9373.00,0.00
2024-12-10 17:40:32,74,8435,38,36,5186.98,9373.01,0.00
2024-12-10 17:40:32,73,8435,38,35,5227.26,9373.11,0.00
2024-12-10 17:40:32,72,8435,38,34,5281.85,9373.18,0.00
2024-12-10 17:40:32,71,8435,37,34,5239.38,9373.69,0.00
2024-12-10 17:40:32,70,8435,36,34,5275.74,9373.84,0.00
2024-12-10 17:40:32,70,8436,36,34,5528.94,9374.00,0.00
2024-12-10 17:40:32,71,8436,37,34,5451.07,9374.01,0.00
2024-12-10 17:40:32,71,8437,37,34,5367.79,9375.00,0.00
2024-12-10 17:40:32,72,8437,37,35,5293.24,9375.01,0.00
2024-12-10 17:40:32,71,8437,37,34,5336.14,9375.11,0.00
2024-12-10 17:40:32,70,8437,36,34,5407.27,9375.11,0.00
2024-12-10 17:40:32,71,8436,37,34,5256.16,9375.51,0.00
2024-12-10 17:40:33,71,8437,37,34,5415.62,9376.00,0.00
2024-12-10 17:40:33,72,8437,38,34,5340.40,9376.01,0.00
2024-12-10 17:40:33,71,8437,38,33,5320.64,9376.41,0.00
2024-12-10 17:40:33,70,8437,37,33,5365.04,9376.61,0.00
2024-12-10 17:40:33,69,8437,36,33,5436.84,9376.64,0.00
2024-12-10 17:40:33,69,8438,36,33,5663.10,9377.00,0.00
2024-12-10 17:40:33,70,8438,36,34,5582.20,9377.02,0.00
2024-12-10 17:40:33,70,8439,36,34,5540.91,9378.00,0.00
2024-12-10 17:40:33,71,8439,36,35,5462.87,9378.01,0.00
2024-12-10 17:40:33,70,8439,35,35,5538.24,9378.03,0.00
2024-12-10 17:40:33,69,8439,34,35,5617.14,9378.03,0.00
2024-12-10 17:40:33,68,8439,33,35,5663.93,9378.12,0.00
2024-12-10 17:40:33,67,8439,32,35,5690.05,9378.42,0.00
2024-12-10 17:40:33,67,8440,32,35,5741.34,9379.00,0.00
2024-12-10 17:40:33,68,8440,33,35,5656.91,9379.02,0.00
2024-12-10 17:40:33,67,8440,33,34,5659.37,9379.31,0.00
2024-12-10 17:40:33,67,8441,33,34,5676.49,9380.00,0.00
2024-12-10 17:40:33,68,8441,34,34,5593.01,9380.02,0.00
2024-12-10 17:40:33,67,8441,34,33,5649.93,9380.10,0.00
2024-12-10 17:40:33,66,8441,34,32,5723.76,9380.14,0.00
2024-12-10 17:40:33,65,8441,33,32,5762.98,9380.62,0.00
2024-12-10 17:40:33,65,8442,33,32,5813.78,9381.00,0.00
2024-12-10 17:40:33,66,8442,34,32,5725.69,9381.02,0.00
2024-12-10 17:40:33,65,8442,34,31,5792.76,9381.12,0.00
2024-12-10 17:40:33,65,8443,34,31,5792.74,9382.00,0.00
2024-12-10 17:40:33,66,8443,35,31,5704.97,9382.02,0.00
2024-12-10 17:40:33,67,8442,36,31,5526.71,9382.69,0.00
2024-12-10 17:40:33,67,8443,36,31,5611.53,9383.00,0.00
2024-12-10 17:40:33,68,8443,36,32,5529.01,9383.02,0.00
2024-12-10 17:40:33,67,8443,36,31,5575.23,9383.12,0.00
2024-12-10 17:40:33,67,8444,36,31,5711.62,9384.00,0.00
2024-12-10 17:40:33,68,8444,36,32,5627.63,9384.02,0.00
2024-12-10 17:40:33,69,8443,37,32,5542.01,9384.09,0.00
2024-12-10 17:40:33,69,8444,37,32,5587.44,9385.00,0.00
2024-12-10 17:40:33,70,8444,38,32,5507.62,9385.02,0.00
2024-12-10 17:40:33,69,8444,38,31,5553.49,9385.12,0.00
2024-12-10 17:40:33,70,8443,39,31,5466.14,9385.23,0.00
2024-12-10 17:40:33,70,8444,39,31,5679.00,9386.00,0.00
2024-12-10 17:40:33,71,8444,39,32,5599.02,9386.01,0.00
2024-12-10 17:40:33,71,8445,39,32,5690.40,9387.00,0.00
2024-12-10 17:40:33,72,8445,40,32,5611.36,9387.01,0.00
2024-12-10 17:40:33,71,8445,40,31,5657.39,9387.11,0.00
2024-12-10 17:40:33,71,8446,40,31,5644.32,9388.00,0.00
2024-12-10 17:40:33,72,8446,41,31,5565.92,9388.01,0.00
2024-12-10 17:40:33,72,8447,41,31,5525.09,9389.00,0.00
2024-12-10 17:40:33,73,8447,41,32,5449.40,9389.01,0.00
2024-12-10 17:40:33,72,8447,41,31,5493.83,9389.11,0.00
2024-12-10 17:40:33,71,8447,41,30,5533.58,9389.44,0.00
2024-12-10 17:40:33,72,8446,42,30,5446.35,9389.57,0.00
2024-12-10 17:40:33,72,8447,42,30,5491.93,9390.00,0.00
2024-12-10 17:40:33,73,8447,43,30,5416.70,9390.01,0.00
2024-12-10 17:40:33,72,8447,42,30,5413.13,9390.57,0.00
2024-12-10 17:40:33,72,8448,42,30,5586.93,9391.00,0.00
2024-12-10 17:40:33,73,8448,42,31,5510.39,9391.01,0.00
2024-12-10 17:40:33,72,8448,42,30,5556.97,9391.11,0.00
2024-12-10 17:40:33,72,8449,42,30,5548.24,9392.00,0.00
2024-12-10 17:40:33,73,8449,42,31,5472.23,9392.01,0.00
2024-12-10 17:40:33,74,8448,43,31,5395.75,9392.07,0.00
2024-12-10 17:40:33,74,8449,43,31,5395.82,9393.00,0.00
2024-12-10 17:40:33,75,8449,44,31,5323.88,9393.01,0.00
2024-12-10 17:40:33,74,8449,44,30,5369.21,9393.11,0.00
2024-12-10 17:40:33,74,8450,44,30,5481.99,9394.00,0.00
2024-12-10 17:40:33,75,8450,45,30,5408.90,9394.01,0.00
2024-12-10 17:40:33,74,8450,44,30,5357.86,9394.58,0.00
2024-12-10 17:40:33,74,8451,44,30,5437.66,9395.00,0.00
2024-12-10 17:40:33,75,8451,44,31,5365.16,9395.01,0.00
2024-12-10 17:40:33,74,8451,44,30,5412.31,9395.11,0.00
2024-12-10 17:40:33,74,8452,44,30,5396.45,9396.00,0.00
2024-12-10 17:40:33,75,8452,45,30,5324.50,9396.01,0.00
2024-12-10 17:40:33,75,8453,45,30,5278.67,9397.00,0.00
2024-12-10 17:40:33,76,8453,46,30,5209.22,9397.01,0.00
2024-12-10 17:40:33,75,8453,46,29,5253.65,9397.11,0.00
2024-12-10 17:40:33,75,8454,46,29,5235.66,9398.00,0.00
2024-12-10 17:40:33,76,8454,46,30,5166.77,9398.01,0.00
2024-12-10 17:40:33,76,8455,46,30,5121.79,9399.00,0.00
2024-12-10 17:40:33,77,8455,47,30,5055.27,9399.01,0.00
2024-12-10 17:40:33,76,8455,47,29,5094.63,9399.12,0.00
2024-12-10 17:40:33,75,8455,46,29,5079.59,9399.52,0.00
2024-12-10 17:40:33,75,8456,46,29,5148.71,9400.00,0.00
2024-12-10 17:40:33,76,8456,47,29,5080.97,9400.01,0.00
2024-12-10 17:40:33,75,8456,46,29,5108.67,9400.17,0.00
2024-12-10 17:40:33,74,8456,45,29,5176.43,9400.18,0.00
2024-12-10 17:40:33,73,8456,44,29,5208.41,9400.55,0.00
2024-12-10 17:40:33,72,8456,43,29,5278.81,9400.57,0.00
2024-12-10 17:40:33,72,8457,43,29,5325.07,9401.00,0.00
2024-12-10 17:40:33,73,8457,43,30,5252.13,9401.01,0.00
2024-12-10 17:40:33,72,8457,42,30,5325.07,9401.01,0.00
2024-12-10 17:40:33,71,8457,42,29,5372.32,9401.11,0.00
2024-12-10 17:40:33,71,8458,42,29,5365.18,9402.00,0.00
2024-12-10 17:40:33,72,8458,43,29,5290.67,9402.01,0.00
2024-12-10 17:40:33,71,8458,42,29,5238.25,9402.58,0.00
2024-12-10 17:40:34,71,8459,42,29,5325.69,9403.00,0.00
2024-12-10 17:40:34,72,8459,42,30,5251.72,9403.01,0.00
2024-12-10 17:40:34,71,8459,42,29,5296.60,9403.13,0.00
2024-12-10 17:40:34,71,8460,42,29,5286.54,9404.00,0.00
2024-12-10 17:40:34,72,8460,43,29,5213.11,9404.01,0.00
2024-12-10 17:40:34,71,8460,42,29,5204.56,9404.35,0.00
2024-12-10 17:40:34,71,8461,42,29,5266.48,9405.00,0.00
2024-12-10 17:40:34,72,8461,42,30,5193.34,9405.01,0.00
2024-12-10 17:40:34,71,8461,42,29,5230.77,9405.14,0.00
2024-12-10 17:40:34,72,8460,42,30,5121.73,9405.56,0.00
2024-12-10 17:40:34,72,8461,42,30,5202.62,9406.00,0.00
2024-12-10 17:40:34,73,8461,43,30,5131.35,9406.01,0.00
2024-12-10 17:40:34,73,8462,43,30,5210.26,9407.00,0.00
2024-12-10 17:40:34,74,8462,44,30,5139.85,9407.01,0.00
2024-12-10 17:40:34,73,8462,43,30,5205.13,9407.06,0.00
2024-12-10 17:40:34,72,8462,43,29,5243.49,9407.15,0.00
2024-12-10 17:40:34,71,8462,42,29,5311.98,9407.21,0.00
2024-12-10 17:40:34,71,8463,42,29,5294.85,9408.00,0.00
2024-12-10 17:40:34,72,8463,42,30,5221.31,9408.01,0.00
2024-12-10 17:40:34,71,8463,41,30,5192.01,9408.62,0.00
2024-12-10 17:40:34,71,8464,41,30,5262.44,9409.00,0.00
2024-12-10 17:40:34,72,8464,42,30,5189.35,9409.01,0.00
2024-12-10 17:40:34,73,8463,43,30,5048.63,9409.51,0.00
2024-12-10 17:40:34,73,8464,43,30,5106.71,9410.00,0.00
2024-12-10 17:40:34,74,8464,44,30,5037.70,9410.01,0.00
2024-12-10 17:40:34,75,8463,44,31,4968.04,9410.07,0.00
2024-12-10 17:40:34,74,8463,44,30,5074.73,9410.16,0.00
2024-12-10 17:40:34,74,8464,44,30,5160.09,9411.00,0.00
2024-12-10 17:40:34,75,8464,44,31,5091.29,9411.01,0.00
2024-12-10 17:40:34,74,8464,43,31,5093.48,9411.26,0.00
2024-12-10 17:40:34,74,8465,43,31,5236.98,9412.00,0.00
2024-12-10 17:40:34,75,8465,44,31,5167.16,9412.01,0.00
2024-12-10 17:40:34,74,8465,44,30,5199.21,9412.15,0.00
2024-12-10 17:40:34,73,8465,43,30,5240.38,9412.26,0.00
2024-12-10 17:40:34,73,8466,43,30,5255.79,9413.00,0.00
2024-12-10 17:40:34,74,8466,43,31,5184.76,9413.01,0.00
2024-12-10 17:40:34,73,8466,42,31,5250.66,9413.06,0.00
2024-12-10 17:40:34,72,8466,41,31,5284.28,9413.08,0.00
2024-12-10 17:40:34,72,8467,41,31,5257.92,9414.00,0.00
2024-12-10 17:40:34,73,8467,41,32,5185.89,9414.01,0.00
2024-12-10 17:40:34,72,8467,40,32,5253.01,9414.06,0.00
2024-12-10 17:40:34,71,8467,40,31,5303.15,9414.11,0.00
2024-12-10 17:40:34,70,8467,40,30,5323.30,9414.39,0.00
2024-12-10 17:40:34,70,8468,40,30,5329.39,9415.00,0.00
2024-12-10 17:40:34,71,8468,41,30,5254.33,9415.01,0.00
2024-12-10 17:40:34,70,8468,40,30,5279.67,9415.07,0.00
2024-12-10 17:40:34,70,8469,40,30,5282.95,9416.00,0.00
2024-12-10 17:40:34,71,8469,40,31,5208.54,9416.01,0.00
2024-12-10 17:40:34,70,8469,40,30,5258.78,9416.10,0.00
2024-12-10 17:40:34,70,8470,40,30,5236.05,9417.00,0.00
2024-12-10 17:40:34,71,8470,40,31,5162.30,9417.01,0.00
2024-12-10 17:40:34,70,8470,39,31,5152.69,9417.11,0.00
2024-12-10 17:40:34,70,8471,39,31,5178.16,9418.00,0.00
2024-12-10 17:40:34,71,8471,39,32,5105.23,9418.01,0.00
2024-12-10 17:40:34,72,8470,40,32,4934.60,9418.60,0.00
2024-12-10 17:40:34,73,8469,41,32,4889.02,9418.73,0.00
2024-12-10 17:40:34,73,8470,41,32,5014.70,9419.00,0.00
2024-12-10 17:40:34,74,8470,42,32,4946.94,9419.01,0.00
2024-12-10 17:40:34,73,8470,42,31,4982.49,9419.11,0.00
2024-12-10 17:40:34,72,8470,42,30,5020.42,9419.32,0.00
2024-12-10 17:40:34,71,8470,41,30,5019.49,9419.73,0.00
2024-12-10 17:40:34,71,8471,41,30,5382.34,9420.00,0.00
2024-12-10 17:40:34,72,8471,42,30,5307.59,9420.01,0.00
2024-12-10 17:40:34,71,8471,41,30,5322.74,9420.34,0.00
2024-12-10 17:40:34,70,8471,40,30,5309.32,9420.81,0.00
2024-12-10 17:40:34,70,8472,40,30,5426.56,9421.00,0.00
2024-12-10 17:40:34,71,8472,41,30,5350.13,9421.01,0.00
2024-12-10 17:40:34,70,8472,41,29,5391.55,9421.13,0.00
2024-12-10 17:40:34,69,8472,40,29,5468.33,9421.13,0.00
2024-12-10 17:40:34,69,8473,40,29,5468.86,9422.00,0.00
2024-12-10 17:40:34,70,8473,40,30,5390.73,9422.02,0.00
2024-12-10 17:40:34,70,8474,40,30,5361.71,9423.00,0.00
2024-12-10 17:40:34,71,8474,40,31,5286.19,9423.01,0.00
2024-12-10 17:40:34,70,8474,40,30,5321.63,9423.13,0.00
2024-12-10 17:40:34,69,8474,39,30,5301.89,9423.83,0.00
2024-12-10 17:40:34,69,8475,39,30,5422.22,9424.00,0.00
2024-12-10 17:40:34,70,8475,39,31,5344.76,9424.02,0.00
2024-12-10 17:40:34,71,8474,40,31,5179.01,9424.41,0.00
2024-12-10 17:40:34,71,8475,40,31,5306.87,9425.00,0.00
2024-12-10 17:40:34,72,8475,40,32,5233.16,9425.01,0.00
2024-12-10 17:40:34,72,8476,40,32,5326.18,9426.00,0.00
2024-12-10 17:40:34,73,8476,41,32,5253.22,9426.01,0.00
2024-12-10 17:40:34,72,8476,41,31,5312.19,9426.10,0.00
2024-12-10 17:40:34,71,8476,40,31,5357.81,9426.13,0.00
2024-12-10 17:40:34,70,8476,39,31,5433.14,9426.13,0.00
2024-12-10 17:40:34,69,8476,38,31,5476.57,9426.29,0.00
2024-12-10 17:40:34,69,8477,38,31,5534.21,9427.00,0.00
2024-12-10 17:40:34,70,8477,38,32,5455.15,9427.02,0.00
2024-12-10 17:40:34,69,8477,37,32,5523.89,9427.10,0.00
2024-12-10 17:40:34,68,8477,37,31,5600.97,9427.10,0.00
2024-12-10 17:40:35,68,8478,37,31,5584.28,9428.00,0.00
2024-12-10 17:40:35,69,8478,37,32,5503.35,9428.02,0.00
2024-12-10 17:40:35,69,8479,37,32,5455.58,9429.00,0.00
2024-12-10 17:40:35,70,8479,37,33,5377.65,9429.02,0.00
2024-12-10 17:40:35,69,8479,37,32,5421.46,9429.10,0.00
2024-12-10 17:40:35,68,8479,36,32,5395.95,9429.50,0.00
2024-12-10 17:40:35,68,8480,36,32,5479.15,9430.00,0.00
2024-12-10 17:40:35,69,8480,36,33,5399.75,9430.02,0.00
2024-12-10 17:40:35,68,8480,36,32,5414.77,9430.25,0.00
2024-12-10 17:40:35,67,8480,35,32,5436.59,9430.48,0.00
2024-12-10 17:40:35,67,8481,35,32,5518.03,9431.00,0.00
2024-12-10 17:40:35,68,8481,36,32,5436.89,9431.02,0.00
2024-12-10 17:40:35,67,8481,36,31,5484.29,9431.10,0.00
2024-12-10 17:40:35,66,8481,35,31,5551.67,9431.23,0.00
2024-12-10 17:40:35,65,8481,34,31,5539.90,9431.59,0.00
2024-12-10 17:40:35,65,8482,34,31,5646.15,9432.00,0.00
2024-12-10 17:40:35,66,8482,34,32,5560.60,9432.02,0.00
2024-12-10 17:40:35,67,8481,35,32,5415.81,9432.40,0.00
2024-12-10 17:40:35,66,8481,34,32,5480.75,9432.44,0.00
2024-12-10 17:40:35,66,8482,34,32,5559.17,9433.00,0.00
2024-12-10 17:40:35,67,8482,35,32,5476.20,9433.02,0.00
2024-12-10 17:40:35,66,8482,35,31,5524.91,9433.11,0.00
2024-12-10 17:40:35,66,8483,35,31,5657.23,9434.00,0.00
2024-12-10 17:40:35,67,8483,36,31,5572.80,9434.02,0.00
2024-12-10 17:40:35,67,8484,36,31,5532.47,9435.00,0.00
2024-12-10 17:40:35,68,8484,37,31,5451.11,9435.02,0.00
2024-12-10 17:40:35,69,8483,38,31,5366.67,9435.10,0.00
2024-12-10 17:40:35,68,8483,38,30,5502.49,9435.12,0.00
2024-12-10 17:40:35,67,8483,38,29,5539.21,9435.46,0.00
2024-12-10 17:40:35,66,8483,37,29,5596.35,9435.65,0.00
2024-12-10 17:40:35,66,8484,37,29,5706.72,9436.00,0.00
2024-12-10 17:40:35,67,8484,37,30,5621.54,9436.02,0.00
2024-12-10 17:40:35,67,8485,37,30,5732.35,9437.00,0.00
2024-12-10 17:40:35,68,8485,37,31,5648.05,9437.02,0.00
2024-12-10 17:40:35,67,8485,37,30,5701.40,9437.10,0.00
2024-12-10 17:40:35,66,8485,36,30,5718.76,9437.70,0.00
2024-12-10 17:40:35,66,8486,36,30,5833.41,9438.00,0.00
2024-12-10 17:40:35,67,8486,36,31,5746.35,9438.02,0.00
2024-12-10 17:40:35,66,8486,35,31,5831.98,9438.02,0.00
2024-12-10 17:40:35,65,8486,34,31,5857.49,9438.19,0.00
2024-12-10 17:40:35,65,8487,34,31,5924.91,9439.00,0.00
2024-12-10 17:40:35,66,8487,34,32,5835.13,9439.02,0.00
2024-12-10 17:40:35,65,8487,33,32,5915.58,9439.09,0.00
2024-12-10 17:40:35,64,8487,33,31,5982.94,9439.09,0.00
2024-12-10 17:40:35,63,8487,32,31,6051.86,9439.21,0.00
2024-12-10 17:40:35,63,8488,32,31,6124.54,9440.00,0.00
2024-12-10 17:40:35,64,8488,32,32,6028.84,9440.02,0.00
2024-12-10 17:40:35,63,8488,31,32,6114.12,9440.11,0.00
2024-12-10 17:40:35,64,8487,32,32,5980.28,9440.23,0.00
2024-12-10 17:40:35,64,8488,32,32,6075.80,9441.00,0.00
2024-12-10 17:40:35,65,8488,33,32,5982.32,9441.02,0.00
2024-12-10 17:40:35,65,8489,33,32,6086.54,9442.00,0.00
2024-12-10 17:40:35,66,8489,33,33,5994.32,9442.02,0.00
2024-12-10 17:40:35,65,8489,33,32,6072.06,9442.12,0.00
2024-12-10 17:40:35,64,8489,32,32,6063.00,9442.84,0.00
2024-12-10 17:40:35,64,8490,32,32,6195.92,9443.00,0.00
2024-12-10 17:40:35,65,8490,32,33,6100.60,9443.02,0.00
2024-12-10 17:40:35,65,8491,32,33,6066.58,9444.00,0.00
2024-12-10 17:40:35,66,8491,32,34,5974.67,9444.02,0.00
2024-12-10 17:40:35,65,8491,31,34,6059.35,9444.08,0.00
2024-12-10 17:40:35,64,8491,30,34,6131.13,9444.14,0.00
2024-12-10 17:40:35,64,8492,30,34,6153.10,9445.00,0.00
2024-12-10 17:40:35,65,8492,31,34,6058.44,9445.02,0.00
2024-12-10 17:40:35,64,8492,31,33,6133.97,9445.14,0.00
2024-12-10 17:40:35,63,8492,30,33,6220.86,9445.16,0.00
2024-12-10 17:40:35,63,8493,30,33,6269.71,9446.00,0.00
2024-12-10 17:40:35,64,8493,30,34,6171.74,9446.02,0.00
2024-12-10 17:40:35,64,8494,30,34,6113.85,9447.00,0.00
2024-12-10 17:40:35,65,8494,31,34,6019.80,9447.02,0.00
2024-12-10 17:40:35,64,8494,31,33,6074.05,9447.13,0.00
2024-12-10 17:40:35,63,8494,31,32,6143.48,9447.35,0.00
2024-12-10 17:40:35,64,8493,31,33,6023.22,9447.53,0.00
2024-12-10 17:40:35,64,8494,31,33,6109.23,9448.00,0.00
2024-12-10 17:40:35,65,8494,31,34,6015.24,9448.02,0.00
2024-12-10 17:40:35,65,8495,31,34,6123.69,9449.00,0.00
2024-12-10 17:40:35,66,8495,31,35,6030.91,9449.02,0.00
2024-12-10 17:40:35,65,8495,30,35,6115.89,9449.09,0.00
2024-12-10 17:40:35,65,8496,30,35,6075.42,9450.00,0.00
2024-12-10 17:40:35,66,8496,30,36,5983.37,9450.02,0.00
2024-12-10 17:40:35,65,8496,30,35,6061.15,9450.12,0.00
2024-12-10 17:40:35,66,8495,30,36,5901.96,9450.71,0.00
2024-12-10 17:40:35,66,8496,30,36,5985.26,9451.00,0.00
2024-12-10 17:40:35,67,8496,30,37,5895.92,9451.02,0.00
2024-12-10 17:40:35,68,8495,30,38,5767.54,9451.18,0.00
2024-12-10 17:40:35,67,8495,29,38,5975.09,9451.21,0.00
2024-12-10 17:40:35,67,8496,29,38,6149.65,9452.00,0.00
2024-12-10 17:40:35,68,8496,29,39,6059.22,9452.02,0.00
2024-12-10 17:40:35,67,8496,29,38,6071.50,9452.39,0.00
2024-12-10 17:40:35,66,8496,28,38,6134.71,9452.44,0.00
2024-12-10 17:40:35,66,8497,28,38,6368.58,9453.00,0.00
2024-12-10 17:40:35,67,8497,29,38,6273.53,9453.02,0.00
2024-12-10 17:40:35,67,8498,29,38,6237.54,9454.00,0.00
2024-12-10 17:40:35,68,8498,30,38,6145.81,9454.02,0.00
2024-12-10 17:40:35,67,8498,30,37,6200.90,9454.12,0.00
2024-12-10 17:40:36,67,8499,30,37,6202.92,9455.00,0.00
2024-12-10 17:40:36,68,8499,31,37,6111.70,9455.02,0.00
2024-12-10 17:40:36,68,8500,31,37,6078.09,9456.00,0.00
2024-12-10 17:40:36,69,8500,32,37,5990.00,9456.02,0.00
2024-12-10 17:40:36,68,8500,32,36,6037.82,9456.15,0.00
2024-12-10 17:40:36,68,8501,32,36,6041.18,9457.00,0.00
2024-12-10 17:40:36,69,8501,32,37,5953.63,9457.02,0.00
2024-12-10 17:40:36,68,8501,31,37,5926.72,9457.74,0.00
2024-12-10 17:40:36,69,8500,31,38,5827.23,9457.90,0.00
2024-12-10 17:40:36,69,8501,31,38,5963.01,9458.00,0.00
2024-12-10 17:40:36,70,8501,32,38,5877.83,9458.02,0.00
2024-12-10 17:40:36,69,8501,32,37,5921.95,9458.15,0.00
2024-12-10 17:40:36,69,8502,32,37,6060.98,9459.00,0.00
2024-12-10 17:40:36,70,8502,33,37,5974.39,9459.02,0.00
2024-12-10 17:40:36,71,8501,33,38,5831.78,9459.38,0.00
2024-12-10 17:40:36,71,8502,33,38,5879.40,9460.00,0.00
2024-12-10 17:40:36,72,8502,34,38,5797.74,9460.01,0.00
2024-12-10 17:40:36,72,8503,34,38,5889.02,9461.00,0.00
2024-12-10 17:40:36,73,8503,35,38,5808.35,9461.01,0.00
2024-12-10 17:40:36,72,8503,35,37,5866.76,9461.18,0.00
2024-12-10 17:40:36,73,8502,36,37,5765.77,9461.43,0.00
2024-12-10 17:40:36,73,8503,36,37,5835.58,9462.00,0.00
2024-12-10 17:40:36,74,8503,36,38,5756.72,9462.01,0.00
2024-12-10 17:40:36,73,8503,35,38,5795.39,9462.01,0.00
2024-12-10 17:40:36,73,8504,35,38,5932.49,9463.00,0.00
2024-12-10 17:40:36,74,8504,36,38,5852.32,9463.01,0.00
2024-12-10 17:40:36,73,8504,35,38,5920.88,9463.14,0.00
2024-12-10 17:40:36,74,8503,35,39,5750.02,9463.80,0.00
2024-12-10 17:40:36,74,8504,35,39,5835.33,9464.00,0.00
2024-12-10 17:40:36,75,8504,36,39,5757.53,9464.01,0.00
2024-12-10 17:40:36,74,8504,36,38,5821.38,9464.15,0.00
2024-12-10 17:40:36,74,8505,36,38,5914.56,9465.00,0.00
2024-12-10 17:40:36,75,8505,36,39,5835.70,9465.01,0.00
2024-12-10 17:40:36,76,8504,37,39,5755.19,9465.08,0.00
2024-12-10 17:40:36,75,8504,37,38,5925.39,9465.20,0.00
2024-12-10 17:40:36,75,8505,37,38,5919.86,9466.00,0.00
2024-12-10 17:40:36,76,8505,37,39,5841.97,9466.01,0.00
2024-12-10 17:40:36,76,8506,37,39,5928.08,9467.00,0.00
2024-12-10 17:40:36,77,8506,37,40,5851.09,9467.01,0.00
2024-12-10 17:40:36,78,8505,38,40,5704.95,9467.46,0.00
2024-12-10 17:40:36,77,8505,37,40,5780.40,9467.65,0.00
2024-12-10 17:40:36,77,8506,37,40,5821.24,9468.00,0.00
2024-12-10 17:40:36,78,8506,38,40,5746.61,9468.01,0.00
2024-12-10 17:40:36,77,8506,38,39,5800.41,9468.18,0.00
2024-12-10 17:40:36,78,8505,38,40,5721.21,9468.26,0.00
2024-12-10 17:40:36,77,8505,37,40,5815.30,9468.61,0.00
2024-12-10 17:40:36,76,8505,36,40,5839.47,9468.87,0.00
2024-12-10 17:40:36,76,8506,36,40,6076.29,9469.00,0.00
2024-12-10 17:40:36,77,8506,37,40,5997.37,9469.01,0.00
2024-12-10 17:40:36,78,8505,37,41,5847.69,9469.48,0.00
2024-12-10 17:40:36,77,8505,36,41,5918.97,9469.82,0.00
2024-12-10 17:40:36,77,8506,36,41,6147.86,9470.00,0.00
2024-12-10 17:40:36,78,8506,36,42,6069.04,9470.01,0.00
2024-12-10 17:40:36,77,8506,35,42,6134.40,9470.16,0.00
2024-12-10 17:40:36,78,8505,36,42,5954.87,9470.91,0.00
2024-12-10 17:40:36,78,8506,36,42,6145.58,9471.00,0.00
2024-12-10 17:40:36,79,8506,36,43,6067.78,9471.01,0.00
2024-12-10 17:40:36,78,8506,35,43,6145.55,9471.01,0.00
2024-12-10 17:40:36,77,8506,35,42,6208.21,9471.16,0.00
2024-12-10 17:40:36,77,8507,35,42,6317.72,9472.00,0.00
2024-12-10 17:40:36,78,8507,35,43,6236.72,9472.01,0.00
2024-12-10 17:40:36,79,8506,36,43,6119.48,9472.19,0.00
2024-12-10 17:40:36,78,8506,36,42,6250.49,9472.30,0.00
2024-12-10 17:40:36,77,8506,35,42,6248.49,9472.95,0.00
2024-12-10 17:40:36,77,8507,35,42,6366.63,9473.00,0.00
2024-12-10 17:40:36,78,8507,36,42,6285.01,9473.01,0.00
2024-12-10 17:40:36,78,8508,36,42,6360.15,9474.00,0.00
2024-12-10 17:40:36,79,8508,36,43,6279.64,9474.01,0.00
2024-12-10 17:40:36,78,8508,36,42,6345.64,9474.15,0.00
2024-12-10 17:40:36,78,8509,36,42,6331.46,9475.00,0.00
2024-12-10 17:40:36,79,8509,36,43,6251.31,9475.01,0.00
2024-12-10 17:40:36,78,8509,35,43,6244.39,9475.67,0.00
2024-12-10 17:40:36,78,8510,35,43,6311.02,9476.00,0.00
2024-12-10 17:40:36,79,8510,36,43,6231.13,9476.01,0.00
2024-12-10 17:40:36,80,8509,36,44,6114.23,9476.20,0.00
2024-12-10 17:40:36,80,8510,36,44,6130.80,9477.00,0.00
2024-12-10 17:40:36,81,8510,36,45,6055.11,9477.01,0.00
2024-12-10 17:40:36,80,8510,35,45,6130.17,9477.01,0.00
2024-12-10 17:40:36,81,8509,35,46,6053.33,9477.05,0.00
2024-12-10 17:40:36,81,8510,35,46,6130.88,9478.00,0.00
2024-12-10 17:40:36,82,8510,35,47,6056.11,9478.01,0.00
2024-12-10 17:40:36,82,8511,35,47,6091.89,9479.00,0.00
2024-12-10 17:40:36,83,8511,35,48,6018.49,9479.01,0.00
2024-12-10 17:40:36,82,8511,35,47,6064.20,9479.13,0.00
2024-12-10 17:40:36,81,8511,34,47,5983.31,9479.95,0.00
2024-12-10 17:40:36,81,8512,34,47,6095.71,9480.00,0.00
2024-12-10 17:40:36,82,8512,34,48,6021.37,9480.01,0.00
2024-12-10 17:40:36,81,8512,33,48,6053.62,9480.11,0.00
2024-12-10 17:40:36,80,8512,33,47,6044.43,9480.63,0.00
2024-12-10 17:40:36,80,8513,33,47,6104.35,9481.00,0.00
2024-12-10 17:40:37,81,8513,33,48,6028.99,9481.01,0.00
2024-12-10 17:40:37,80,8513,33,47,6072.40,9481.13,0.00
2024-12-10 17:40:37,79,8513,32,47,6095.44,9481.63,0.00
2024-12-10 17:40:37,79,8514,32,47,6132.94,9482.00,0.00
2024-12-10 17:40:37,80,8514,32,48,6056.27,9482.01,0.00
2024-12-10 17:40:37,79,8514,31,48,6012.25,9482.89,0.00
2024-12-10 17:40:37,79,8515,31,48,6121.58,9483.00,0.00
2024-12-10 17:40:37,80,8515,31,49,6045.06,9483.01,0.00
2024-12-10 17:40:37,79,8515,31,48,6083.24,9483.17,0.00
2024-12-10 17:40:37,80,8514,32,48,5993.05,9483.34,0.00
2024-12-10 17:40:37,79,8514,31,48,6051.12,9483.68,0.00
2024-12-10 17:40:37,79,8515,31,48,6093.41,9484.00,0.00
2024-12-10 17:40:37,80,8515,32,48,6017.24,9484.01,0.00
2024-12-10 17:40:37,81,8514,32,49,5942.96,9484.04,0.00
2024-12-10 17:40:37,81,8515,32,49,6074.33,9485.00,0.00
2024-12-10 17:40:37,82,8515,32,50,6000.26,9485.01,0.00
2024-12-10 17:40:37,81,8515,32,49,6038.11,9485.16,0.00
2024-12-10 17:40:37,81,8516,32,49,6146.41,9486.00,0.00
2024-12-10 17:40:37,82,8516,33,49,6071.45,9486.01,0.00
2024-12-10 17:40:37,83,8515,33,50,5885.09,9486.52,0.00
2024-12-10 17:40:37,83,8516,33,50,5979.19,9487.00,0.00
2024-12-10 17:40:37,84,8516,33,51,5908.01,9487.01,0.00
2024-12-10 17:40:37,83,8516,33,50,5944.97,9487.16,0.00
2024-12-10 17:40:37,82,8516,32,50,6016.33,9487.17,0.00
2024-12-10 17:40:37,81,8516,31,50,6055.60,9487.54,0.00
2024-12-10 17:40:37,81,8517,31,50,6200.04,9488.00,0.00
2024-12-10 17:40:37,82,8517,32,50,6124.43,9488.01,0.00
2024-12-10 17:40:37,82,8518,32,50,6078.14,9489.00,0.00
2024-12-10 17:40:37,83,8518,32,51,6004.91,9489.01,0.00
2024-12-10 17:40:37,82,8518,32,50,6041.19,9489.17,0.00
2024-12-10 17:40:37,81,8518,31,50,6084.56,9489.35,0.00
2024-12-10 17:40:37,81,8519,31,50,6140.09,9490.00,0.00
2024-12-10 17:40:37,82,8519,31,51,6065.21,9490.01,0.00
2024-12-10 17:40:37,82,8520,31,51,6018.74,9491.00,0.00
2024-12-10 17:40:37,83,8520,31,52,5946.23,9491.01,0.00
2024-12-10 17:40:37,82,8520,31,51,5982.94,9491.17,0.00
2024-12-10 17:40:37,81,8520,30,51,6052.95,9491.20,0.00
2024-12-10 17:40:37,81,8521,30,51,6094.51,9492.00,0.00
2024-12-10 17:40:37,82,8521,30,52,6020.19,9492.01,0.00
2024-12-10 17:40:37,81,8521,29,52,6088.68,9492.06,0.00
2024-12-10 17:40:37,82,8520,29,53,5978.60,9492.22,0.00
2024-12-10 17:40:37,81,8520,28,53,6018.60,9492.52,0.00
2024-12-10 17:40:37,81,8521,28,53,6090.47,9493.00,0.00
2024-12-10 17:40:37,82,8521,28,54,6016.19,9493.01,0.00
2024-12-10 17:40:37,81,8521,28,53,6056.55,9493.16,0.00
2024-12-10 17:40:37,81,8522,28,53,6164.95,9494.00,0.00
2024-12-10 17:40:37,82,8522,29,53,6089.77,9494.01,0.00
2024-12-10 17:40:37,81,8522,28,53,6049.43,9494.85,0.00
2024-12-10 17:40:37,81,8523,28,53,6152.71,9495.00,0.00
2024-12-10 17:40:37,82,8523,28,54,6077.67,9495.01,0.00
2024-12-10 17:40:37,81,8523,28,53,6119.95,9495.16,0.00
2024-12-10 17:40:37,82,8522,28,54,6009.63,9495.56,0.00
2024-12-10 17:40:37,82,8523,28,54,6065.57,9496.00,0.00
2024-12-10 17:40:37,83,8523,28,55,5992.49,9496.01,0.00
2024-12-10 17:40:37,82,8523,27,55,5950.08,9496.59,0.00
2024-12-10 17:40:37,82,8524,27,55,6142.65,9497.00,0.00
2024-12-10 17:40:37,83,8524,27,56,6068.64,9497.01,0.00
2024-12-10 17:40:37,82,8524,27,55,6110.29,9497.16,0.00
2024-12-10 17:40:37,82,8525,27,55,6100.44,9498.00,0.00
2024-12-10 17:40:37,83,8525,27,56,6026.94,9498.01,0.00
2024-12-10 17:40:37,84,8524,28,56,5884.70,9498.54,0.00
2024-12-10 17:40:37,83,8524,27,56,5899.86,9498.95,0.00
2024-12-10 17:40:37,83,8525,27,56,6009.76,9499.00,0.00
2024-12-10 17:40:37,84,8525,28,56,5938.22,9499.01,0.00
2024-12-10 17:40:37,83,8525,27,56,5988.06,9499.10,0.00
2024-12-10 17:40:37,83,8526,27,56,6107.45,9500.00,0.00
2024-12-10 17:40:37,84,8526,28,56,6034.74,9500.01,0.00
2024-12-10 17:40:37,85,8525,29,56,5949.29,9500.19,0.00
2024-12-10 17:40:37,84,8525,29,55,6008.30,9500.25,0.00
2024-12-10 17:40:37,84,8526,29,55,6005.43,9501.00,0.00
2024-12-10 17:40:37,85,8526,29,56,5934.77,9501.01,0.00
2024-12-10 17:40:37,86,8525,29,57,5862.47,9501.07,0.00
2024-12-10 17:40:37,87,8524,30,57,5788.82,9501.62,0.00
2024-12-10 17:40:37,87,8525,30,57,5988.40,9502.00,0.00
2024-12-10 17:40:37,88,8525,31,57,5920.35,9502.01,0.00
2024-12-10 17:40:37,89,8524,31,58,5846.40,9502.11,0.00
2024-12-10 17:40:37,88,8524,31,57,5905.34,9502.24,0.00
2024-12-10 17:40:37,88,8525,31,57,6112.72,9503.00,0.00
2024-12-10 17:40:37,89,8525,31,58,6044.04,9503.01,0.00
2024-12-10 17:40:37,88,8525,31,57,6105.20,9503.08,0.00
2024-12-10 17:40:37,88,8526,31,57,6173.16,9504.00,0.00
2024-12-10 17:40:37,89,8526,31,58,6103.80,9504.01,0.00
2024-12-10 17:40:37,89,8527,31,58,6047.95,9505.00,0.00
2024-12-10 17:40:37,90,8527,32,58,5980.75,9505.01,0.00
2024-12-10 17:40:37,89,8527,31,58,6021.66,9505.12,0.00
2024-12-10 17:40:37,88,8527,31,57,6076.09,9505.24,0.00
2024-12-10 17:40:37,88,8528,31,57,6104.17,9506.00,0.00
2024-12-10 17:40:37,89,8528,31,58,6035.58,9506.01,0.00
2024-12-10 17:40:37,88,8528,30,58,6084.76,9506.07,0.00
2024-12-10 17:40:37,87,8528,29,58,6073.01,9506.70,0.00
2024-12-10 17:40:37,88,8527,29,59,5985.30,9506.83,0.00
2024-12-10 17:40:37,88,8528,29,59,6088.08,9507.00,0.00
2024-12-10 17:40:37,89,8528,30,59,6019.67,9507.01,0.00
2024-12-10 17:40:37,90,8527,30,60,5836.88,9507.59,0.00
2024-12-10 17:40:37,90,8528,30,60,6032.38,9508.00,0.00
2024-12-10 17:40:37,91,8528,30,61,5966.09,9508.01,0.00
2024-12-10 17:40:37,90,8528,30,60,5998.68,9508.26,0.00
2024-12-10 17:40:38,90,8529,30,60,6089.63,9509.00,0.00
2024-12-10 17:40:38,91,8529,30,61,6022.71,9509.01,0.00
2024-12-10 17:40:38,91,8530,30,61,5991.12,9510.00,0.00
2024-12-10 17:40:38,92,8530,30,62,5925.99,9510.01,0.00
2024-12-10 17:40:38,93,8529,31,62,5839.75,9510.27,0.00
2024-12-10 17:40:38,94,8528,31,63,5753.64,9510.92,0.00
2024-12-10 17:40:38,94,8529,31,63,5828.68,9511.00,0.00
2024-12-10 17:40:38,95,8529,32,63,5767.32,9511.01,0.00
2024-12-10 17:40:38,95,8530,32,63,5937.25,9512.00,0.00
2024-12-10 17:40:38,96,8530,33,63,5875.40,9512.01,0.00
2024-12-10 17:40:38,96,8531,33,63,5840.57,9513.00,0.00
2024-12-10 17:40:38,97,8531,33,64,5780.35,9513.01,0.00
2024-12-10 17:40:38,97,8532,33,64,5735.59,9514.00,0.00
2024-12-10 17:40:38,98,8532,33,65,5677.06,9514.01,0.00
2024-12-10 17:40:38,97,8532,32,65,5690.61,9514.27,0.00
2024-12-10 17:40:38,96,8532,32,64,5709.01,9514.65,0.00
2024-12-10 17:40:38,96,8533,32,64,5738.27,9515.00,0.00
2024-12-10 17:40:38,97,8533,32,65,5679.11,9515.01,0.00
2024-12-10 17:40:38,98,8532,32,66,5620.20,9515.04,0.00
2024-12-10 17:40:38,97,8532,32,65,5678.39,9515.25,0.00
2024-12-10 17:40:38,96,8532,31,65,5642.15,9515.97,0.00
2024-12-10 17:40:38,96,8533,31,65,5738.32,9516.00,0.00
2024-12-10 17:40:38,97,8533,31,66,5679.16,9516.01,0.00
2024-12-10 17:40:38,98,8532,31,67,5518.93,9516.89,0.00
2024-12-10 17:40:38,98,8533,31,67,5749.42,9517.00,0.00
2024-12-10 17:40:38,99,8533,31,68,5691.35,9517.01,0.00
2024-12-10 17:40:38,98,8533,30,68,5746.96,9517.03,0.00
2024-12-10 17:40:38,97,8533,29,68,5801.71,9517.07,0.00
2024-12-10 17:40:38,96,8533,29,67,5856.22,9517.13,0.00
2024-12-10 17:40:38,95,8533,29,66,5894.85,9517.21,0.00
2024-12-10 17:40:38,95,8534,29,66,5979.65,9518.00,0.00
2024-12-10 17:40:38,96,8534,30,66,5917.36,9518.01,0.00
2024-12-10 17:40:38,96,8535,30,66,5862.47,9519.00,0.00
2024-12-10 17:40:38,97,8535,30,67,5802.03,9519.01,0.00
2024-12-10 17:40:38,96,8535,29,67,5856.55,9519.06,0.00
2024-12-10 17:40:38,95,8535,29,66,5891.19,9519.20,0.00
2024-12-10 17:40:38,95,8536,29,66,5874.61,9520.00,0.00
2024-12-10 17:40:38,96,8536,29,67,5813.42,9520.01,0.00
2024-12-10 17:40:38,96,8537,29,67,5759.77,9521.00,0.00
2024-12-10 17:40:38,97,8537,29,68,5700.39,9521.01,0.00
2024-12-10 17:40:38,98,8536,30,68,5640.30,9521.05,0.00
2024-12-10 17:40:38,97,8536,29,68,5711.95,9521.06,0.00
2024-12-10 17:40:38,96,8536,29,67,5740.74,9521.21,0.00
2024-12-10 17:40:38,96,8537,29,67,5761.16,9522.00,0.00
2024-12-10 17:40:38,97,8537,29,68,5701.77,9522.01,0.00
2024-12-10 17:40:38,96,8537,28,68,5676.84,9522.68,0.00
2024-12-10 17:40:38,96,8538,28,68,5806.52,9523.00,0.00
2024-12-10 17:40:38,97,8538,28,69,5746.66,9523.01,0.00
2024-12-10 17:40:38,96,8538,28,68,5771.86,9523.20,0.00
2024-12-10 17:40:38,96,8539,28,68,5753.15,9524.00,0.00
2024-12-10 17:40:38,97,8539,29,68,5693.84,9524.01,0.00
2024-12-10 17:40:38,96,8539,28,68,5734.78,9524.19,0.00
2024-12-10 17:40:39,96,8540,28,68,5734.61,9525.00,0.00
2024-12-10 17:40:39,97,8540,29,68,5675.49,9525.01,0.00
2024-12-10 17:40:39,96,8540,29,67,5698.95,9525.20,0.00
2024-12-10 17:40:39,96,8541,29,67,5679.81,9526.00,0.00
2024-12-10 17:40:39,97,8541,30,67,5621.26,9526.01,0.00
2024-12-10 17:40:39,97,8542,30,67,5565.60,9527.00,0.00
2024-12-10 17:40:39,98,8542,30,68,5508.80,9527.01,0.00
2024-12-10 17:40:39,97,8542,30,67,5531.28,9527.20,0.00
2024-12-10 17:40:39,98,8541,31,67,5472.90,9527.23,0.00
2024-12-10 17:40:39,98,8542,31,67,5480.96,9528.00,0.00
2024-12-10 17:40:39,99,8542,32,67,5425.59,9528.01,0.00
2024-12-10 17:40:39,99,8543,32,67,5468.58,9529.00,0.00
2024-12-10 17:40:39,100,8543,32,68,5413.90,9529.01,0.00
2024-12-10 17:40:39,101,8542,32,69,5356.55,9529.07,0.00
2024-12-10 17:40:39,100,8542,32,68,5444.45,9529.21,0.00
2024-12-10 17:40:39,100,8543,32,68,5422.98,9530.00,0.00
2024-12-10 17:40:39,101,8543,32,69,5369.29,9530.01,0.00
2024-12-10 17:40:39,101,8544,32,69,5410.75,9531.00,0.00
2024-12-10 17:40:39,102,8544,33,69,5357.70,9531.01,0.00
2024-12-10 17:40:39,101,8544,32,69,5389.27,9531.23,0.00
2024-12-10 17:40:39,100,8544,32,68,5426.00,9531.23,0.00
2024-12-10 17:40:39,99,8544,31,68,5402.85,9531.85,0.00
2024-12-10 17:40:39,99,8545,31,68,5484.81,9532.00,0.00
2024-12-10 17:40:39,100,8545,31,69,5429.96,9532.01,0.00
2024-12-10 17:40:39,100,8546,31,69,5375.62,9533.00,0.00
2024-12-10 17:40:39,101,8546,31,70,5322.39,9533.01,0.00
2024-12-10 17:40:39,100,8546,31,69,5338.51,9533.23,0.00
2024-12-10 17:40:39,100,8547,31,69,5317.51,9534.00,0.00
2024-12-10 17:40:39,101,8547,32,69,5264.86,9534.01,0.00
2024-12-10 17:40:39,100,8547,31,69,5311.82,9534.06,0.00
2024-12-10 17:40:39,99,8547,31,68,5360.94,9534.10,0.00
2024-12-10 17:40:39,98,8547,30,68,5328.28,9534.55,0.00
2024-12-10 17:40:39,99,8546,30,69,5253.66,9534.73,0.00
2024-12-10 17:40:39,99,8547,30,69,5354.52,9535.00,0.00
2024-12-10 17:40:39,100,8547,30,70,5300.97,9535.01,0.00
2024-12-10 17:40:39,99,8547,29,70,5347.81,9535.07,0.00
2024-12-10 17:40:39,98,8547,29,69,5400.44,9535.07,0.00
2024-12-10 17:40:39,98,8548,29,69,5462.14,9536.00,0.00
2024-12-10 17:40:39,99,8548,29,70,5406.96,9536.01,0.00
2024-12-10 17:40:39,100,8547,30,70,5351.94,9536.04,0.00
2024-12-10 17:40:39,99,8547,30,69,5405.08,9536.12,0.00
2024-12-10 17:40:39,98,8547,29,69,5416.74,9536.57,0.00
2024-12-10 17:40:39,97,8547,28,69,5459.53,9536.71,0.00
2024-12-10 17:40:39,97,8548,28,69,5491.21,9537.00,0.00
2024-12-10 17:40:39,98,8548,28,70,5435.18,9537.01,0.00
2024-12-10 17:40:39,97,8548,27,70,5363.93,9537.96,0.00
2024-12-10 17:40:39,97,8549,27,70,5556.68,9538.00,0.00
2024-12-10 17:40:39,98,8549,27,71,5499.98,9538.01,0.00
2024-12-10 17:40:39,97,8549,27,70,5549.84,9538.07,0.00
2024-12-10 17:40:39,98,8548,28,70,5432.07,9538.53,0.00
2024-12-10 17:40:39,98,8549,28,70,5521.00,9539.00,0.00
2024-12-10 17:40:39,99,8549,29,70,5465.23,9539.01,0.00
2024-12-10 17:40:39,98,8549,29,69,5444.18,9539.23,0.00
2024-12-10 17:40:39,98,8550,29,69,5566.36,9540.00,0.00
2024-12-10 17:40:39,99,8550,30,69,5510.13,9540.01,0.00
2024-12-10 17:40:39,100,8549,30,70,5440.77,9540.18,0.00
2024-12-10 17:40:39,99,8549,29,70,5504.74,9540.61,0.00
2024-12-10 17:40:39,99,8550,29,70,5530.24,9541.00,0.00
2024-12-10 17:40:39,100,8550,29,71,5474.94,9541.01,0.00
2024-12-10 17:40:39,99,8550,29,70,5493.70,9541.23,0.00
2024-12-10 17:40:39,99,8551,29,70,5575.16,9542.00,0.00
2024-12-10 17:40:39,100,8551,30,70,5519.41,9542.01,0.00
2024-12-10 17:40:39,100,8552,30,70,5467.55,9543.00,0.00
2024-12-10 17:40:39,101,8552,30,71,5413.42,9543.01,0.00
2024-12-10 17:40:39,100,8552,30,70,5460.91,9543.07,0.00
2024-12-10 17:40:39,99,8552,30,69,5487.19,9543.22,0.00
2024-12-10 17:40:39,100,8551,31,69,5432.32,9543.24,0.00
2024-12-10 17:40:39,101,8550,32,69,5393.74,9543.45,0.00
2024-12-10 17:40:39,101,8550,32,69,5439.81,9544.00,0.00
2024-12-10 17:40:39,102,8550,32,70,5386.48,9544.01,0.00
2024-12-10 17:40:39,101,8550,32,69,5433.23,9544.07,0.00
2024-12-10 17:40:39,100,8550,31,69,5423.86,9544.71,0.00
2024-12-10 17:40:39,100,8551,31,69,5642.99,9545.00,0.00
2024-12-10 17:40:39,101,8551,31,70,5587.12,9545.01,0.00
2024-12-10 17:40:39,100,8551,31,69,5635.39,9545.07,0.00
2024-12-10 17:40:39,100,8552,31,69,5601.76,9546.00,0.00
2024-12-10 17:40:39,101,8552,32,69,5546.30,9546.01,0.00
2024-12-10 17:40:39,100,8552,32,68,5592.25,9546.07,0.00
2024-12-10 17:40:39,99,8552,32,67,5643.92,9546.11,0.00
2024-12-10 17:40:39,98,8552,31,67,5598.61,9546.98,0.00
2024-12-10 17:40:39,98,8553,31,67,5694.09,9547.00,0.00
2024-12-10 17:40:39,99,8553,32,67,5636.58,9547.01,0.00
2024-12-10 17:40:39,98,8553,32,66,5684.38,9547.07,0.00
2024-12-10 17:40:39,98,8554,32,66,5651.27,9548.00,0.00
2024-12-10 17:40:39,99,8554,32,67,5594.18,9548.01,0.00
2024-12-10 17:40:40,99,8555,32,67,5565.53,9549.00,0.00
2024-12-10 17:40:40,100,8555,32,68,5509.88,9549.01,0.00
2024-12-10 17:40:40,101,8554,32,69,5451.56,9549.07,0.00
2024-12-10 17:40:40,101,8555,32,69,5440.79,9550.00,0.00
2024-12-10 17:40:40,102,8555,32,70,5387.45,9550.01,0.00
2024-12-10 17:40:40,103,8554,33,70,5334.22,9550.04,0.00
2024-12-10 17:40:40,102,8554,33,69,5371.58,9550.12,0.00
2024-12-10 17:40:40,102,8555,33,69,5448.18,9551.00,0.00
2024-12-10 17:40:40,103,8555,34,69,5395.29,9551.01,0.00
2024-12-10 17:40:40,102,8555,33,69,5444.46,9551.04,0.00
2024-12-10 17:40:40,103,8554,33,70,5387.90,9551.10,0.00
2024-12-10 17:40:40,104,8553,33,71,5327.43,9551.58,0.00
2024-12-10 17:40:40,103,8553,32,71,5367.08,9551.94,0.00
2024-12-10 17:40:40,103,8554,32,71,5547.03,9552.00,0.00
2024-12-10 17:40:40,104,8554,32,72,5493.70,9552.01,0.00
2024-12-10 17:40:40,103,8554,32,71,5531.31,9552.09,0.00
2024-12-10 17:40:40,103,8555,32,71,5679.49,9553.00,0.00
2024-12-10 17:40:40,104,8555,33,71,5624.88,9553.01,0.00
2024-12-10 17:40:40,103,8555,33,70,5653.56,9553.10,0.00
2024-12-10 17:40:40,102,8555,32,70,5650.66,9553.66,0.00
2024-12-10 17:40:40,103,8554,32,71,5593.03,9553.70,0.00
2024-12-10 17:40:40,103,8555,32,71,5639.11,9554.00,0.00
2024-12-10 17:40:40,104,8555,32,72,5584.88,9554.01,0.00
2024-12-10 17:40:40,103,8555,32,71,5613.18,9554.10,0.00
2024-12-10 17:40:40,103,8556,32,71,5667.23,9555.00,0.00
2024-12-10 17:40:40,104,8556,33,71,5612.73,9555.01,0.00
2024-12-10 17:40:40,103,8556,33,70,5639.44,9555.11,0.00
2024-12-10 17:40:40,103,8557,33,70,5601.43,9556.00,0.00
2024-12-10 17:40:40,104,8557,33,71,5547.57,9556.01,0.00
2024-12-10 17:40:40,104,8558,33,71,5509.22,9557.00,0.00
2024-12-10 17:40:40,105,8558,34,71,5456.75,9557.01,0.00
2024-12-10 17:40:40,106,8557,34,72,5402.59,9557.06,0.00
2024-12-10 17:40:40,107,8556,34,73,5333.37,9557.15,0.00
2024-12-10 17:40:40,108,8555,35,73,5313.21,9557.54,0.00
2024-12-10 17:40:40,108,8556,35,73,5375.92,9558.00,0.00
2024-12-10 17:40:40,109,8556,36,73,5326.60,9558.01,0.00
2024-12-10 17:40:40,109,8557,36,73,5533.49,9559.00,0.00
2024-12-10 17:40:40,110,8557,36,74,5483.18,9559.01,0.00
2024-12-10 17:40:40,111,8556,37,74,5398.54,9559.22,0.00
2024-12-10 17:40:40,110,8556,37,73,5493.37,9559.46,0.00
2024-12-10 17:40:40,110,8557,37,73,5489.90,9560.00,0.00
2024-12-10 17:40:40,111,8557,38,73,5440.44,9560.01,0.00
2024-12-10 17:40:40,110,8557,38,72,5477.77,9560.10,0.00
2024-12-10 17:40:40,110,8558,38,72,5526.36,9561.00,0.00
2024-12-10 17:40:40,111,8558,38,73,5476.58,9561.01,0.00
2024-12-10 17:40:40,110,8558,37,73,5521.17,9561.06,0.00
2024-12-10 17:40:40,109,8558,37,72,5552.54,9561.09,0.00
2024-12-10 17:40:40,109,8559,37,72,5507.09,9562.00,0.00
2024-12-10 17:40:40,110,8559,37,73,5457.03,9562.01,0.00
2024-12-10 17:40:40,109,8559,37,72,5481.70,9562.10,0.00
2024-12-10 17:40:40,110,8558,38,72,5349.34,9562.85,0.00
2024-12-10 17:40:40,110,8559,38,72,5396.41,9563.00,0.00
2024-12-10 17:40:40,111,8559,38,73,5347.79,9563.01,0.00
2024-12-10 17:40:40,112,8558,39,73,5294.10,9563.09,0.00
2024-12-10 17:40:40,111,8558,39,72,5402.98,9563.11,0.00
2024-12-10 17:40:40,111,8559,39,72,5444.37,9564.00,0.00
2024-12-10 17:40:40,112,8559,40,72,5395.76,9564.01,0.00
2024-12-10 17:40:40,111,8559,39,72,5439.22,9564.05,0.00
2024-12-10 17:40:40,110,8559,39,71,5468.70,9564.09,0.00
2024-12-10 17:40:40,111,8558,40,71,5365.05,9564.66,0.00
2024-12-10 17:40:40,112,8557,41,71,5319.02,9564.80,0.00
2024-12-10 17:40:40,112,8558,41,71,5448.12,9565.00,0.00
2024-12-10 17:40:40,113,8558,42,71,5399.91,9565.01,0.00
2024-12-10 17:40:40,112,8558,41,71,5444.57,9565.05,0.00
2024-12-10 17:40:40,111,8558,41,70,5473.83,9565.08,0.00
2024-12-10 17:40:40,110,8558,41,69,5474.90,9565.57,0.00
2024-12-10 17:40:40,110,8559,41,69,5660.42,9566.00,0.00
2024-12-10 17:40:40,111,8559,41,70,5609.43,9566.01,0.00
2024-12-10 17:40:40,110,8559,41,69,5636.12,9566.09,0.00
2024-12-10 17:40:40,109,8559,40,69,5646.63,9566.22,0.00
2024-12-10 17:40:40,110,8558,40,70,5563.29,9566.57,0.00
2024-12-10 17:40:40,110,8559,40,70,5636.66,9567.00,0.00
2024-12-10 17:40:40,111,8559,40,71,5585.88,9567.01,0.00
2024-12-10 17:40:40,112,8558,41,71,5535.15,9567.04,0.00
2024-12-10 17:40:40,111,8558,41,70,5576.45,9567.10,0.00
2024-12-10 17:40:40,112,8557,41,71,5452.74,9567.85,0.00
2024-12-10 17:40:40,112,8558,41,71,5579.42,9568.00,0.00
2024-12-10 17:40:40,113,8558,41,72,5530.04,9568.01,0.00
2024-12-10 17:40:40,112,8558,41,71,5555.55,9568.09,0.00
2024-12-10 17:40:40,112,8559,41,71,5662.41,9569.00,0.00
2024-12-10 17:40:40,113,8559,42,71,5612.30,9569.01,0.00
2024-12-10 17:40:40,114,8558,42,72,5484.87,9569.59,0.00
2024-12-10 17:40:40,114,8559,42,72,5545.41,9570.00,0.00
2024-12-10 17:40:40,115,8559,42,73,5497.19,9570.01,0.00
2024-12-10 17:40:40,114,8559,41,73,5512.29,9570.10,0.00
2024-12-10 17:40:40,115,8558,41,74,5416.33,9570.62,0.00
2024-12-10 17:40:40,114,8558,41,73,5507.56,9570.69,0.00
2024-12-10 17:40:40,113,8558,41,72,5511.13,9570.80,0.00
2024-12-10 17:40:41,113,8559,41,72,5661.21,9571.00,0.00
2024-12-10 17:40:41,114,8559,41,73,5611.55,9571.01,0.00
2024-12-10 17:40:41,114,8560,41,73,5644.15,9572.00,0.00
2024-12-10 17:40:41,115,8560,42,73,5595.07,9572.01,0.00
2024-12-10 17:40:41,116,8559,43,73,5546.84,9572.03,0.00
2024-12-10 17:40:41,115,8559,42,73,5586.80,9572.70,0.00
2024-12-10 17:40:41,115,8560,42,73,5607.85,9573.00,0.00
2024-12-10 17:40:41,116,8560,43,73,5559.51,9573.01,0.00
2024-12-10 17:40:41,115,8560,43,72,5594.59,9573.09,0.00
2024-12-10 17:40:41,116,8559,44,72,5523.33,9573.35,0.00
2024-12-10 17:40:41,117,8558,44,73,5465.62,9573.60,0.00
2024-12-10 17:40:41,116,8558,43,73,5526.86,9573.72,0.00
2024-12-10 17:40:41,116,8559,43,73,5631.89,9574.00,0.00
2024-12-10 17:40:41,117,8559,43,74,5583.75,9574.01,0.00
2024-12-10 17:40:41,116,8559,43,73,5610.96,9574.09,0.00
2024-12-10 17:40:41,115,8559,42,73,5598.46,9574.71,0.00
2024-12-10 17:40:41,116,8558,43,73,5550.20,9574.73,0.00
2024-12-10 17:40:41,116,8559,43,73,5785.66,9575.00,0.00
2024-12-10 17:40:41,117,8559,44,73,5736.21,9575.01,0.00
2024-12-10 17:40:41,116,8559,44,72,5764.25,9575.09,0.00
2024-12-10 17:40:41,117,8558,44,73,5653.94,9575.74,0.00
2024-12-10 17:40:41,116,8558,43,73,5767.13,9575.82,0.00
2024-12-10 17:40:41,116,8559,43,73,5915.04,9576.00,0.00
2024-12-10 17:40:41,117,8559,44,73,5864.49,9576.01,0.00
2024-12-10 17:40:41,116,8559,44,72,5893.63,9576.09,0.00
2024-12-10 17:40:41,116,8560,44,72,5938.78,9577.00,0.00
2024-12-10 17:40:41,117,8560,45,72,5888.02,9577.01,0.00
2024-12-10 17:40:41,116,8560,45,71,5918.19,9577.09,0.00
2024-12-10 17:40:41,115,8560,44,71,5934.71,9577.20,0.00
2024-12-10 17:40:41,115,8561,44,71,5941.91,9578.00,0.00
2024-12-10 17:40:41,116,8561,44,72,5890.68,9578.01,0.00
2024-12-10 17:40:41,115,8561,44,71,5921.13,9578.09,0.00
2024-12-10 17:40:41,116,8560,45,71,5851.98,9578.29,0.00
2024-12-10 17:40:41,117,8559,45,72,5790.58,9578.46,0.00
2024-12-10 17:40:41,117,8560,45,72,5797.55,9579.00,0.00
2024-12-10 17:40:41,118,8560,46,72,5748.42,9579.01,0.00
2024-12-10 17:40:41,117,8560,46,71,5776.31,9579.09,0.00
2024-12-10 17:40:41,118,8559,47,71,5671.64,9579.69,0.00
2024-12-10 17:40:41,118,8560,47,71,5869.99,9580.00,0.00
2024-12-10 17:40:41,119,8560,48,71,5820.66,9580.01,0.00
2024-12-10 17:40:41,119,8561,48,71,5838.98,9581.00,0.00
2024-12-10 17:40:41,120,8561,49,71,5790.32,9581.01,0.00
2024-12-10 17:40:41,119,8561,49,70,5826.95,9581.08,0.00
2024-12-10 17:40:41,120,8560,50,70,5748.96,9581.41,0.00
2024-12-10 17:40:41,121,8559,51,70,5756.84,9581.54,0.00
2024-12-10 17:40:41,121,8560,51,70,5789.67,9582.00,0.00
2024-12-10 17:40:41,122,8560,51,71,5742.22,9582.01,0.00
2024-12-10 17:40:41,122,8561,51,71,5853.02,9583.00,0.00
2024-12-10 17:40:41,123,8561,51,72,5805.44,9583.01,0.00
2024-12-10 17:40:41,122,8561,50,72,5846.00,9583.07,0.00
2024-12-10 17:40:41,121,8561,49,72,5830.12,9583.53,0.00
2024-12-10 17:40:41,122,8560,50,72,5772.97,9583.64,0.00
2024-12-10 17:40:41,122,8561,50,72,5819.62,9584.00,0.00
2024-12-10 17:40:41,123,8561,50,73,5772.30,9584.01,0.00
2024-12-10 17:40:41,122,8561,50,72,5797.66,9584.07,0.00
2024-12-10 17:40:41,122,8562,50,72,5835.15,9585.00,0.00
2024-12-10 17:40:41,123,8562,50,73,5787.71,9585.01,0.00
2024-12-10 17:40:41,122,8562,50,72,5818.69,9585.07,0.00
2024-12-10 17:40:41,121,8562,49,72,5845.46,9585.30,0.00
2024-12-10 17:40:41,122,8561,50,72,5775.68,9585.54,0.00
2024-12-10 17:40:41,121,8561,49,72,5822.75,9585.71,0.00
2024-12-10 17:40:41,120,8561,48,72,5848.23,9585.87,0.00
2024-12-10 17:40:41,120,8562,48,72,5915.45,9586.00,0.00
2024-12-10 17:40:41,121,8562,48,73,5866.56,9586.01,0.00
2024-12-10 17:40:41,120,8562,47,73,5885.10,9586.03,0.00
2024-12-10 17:40:41,119,8562,47,72,5915.26,9586.09,0.00
2024-12-10 17:40:41,120,8561,48,72,5855.60,9586.22,0.00
2024-12-10 17:40:41,121,8560,49,72,5814.45,9586.44,0.00
2024-12-10 17:40:41,121,8561,49,72,5954.65,9587.00,0.00
2024-12-10 17:40:41,122,8561,49,73,5905.84,9587.01,0.00
2024-12-10 17:40:41,121,8561,49,72,5933.31,9587.10,0.00
2024-12-10 17:40:41,121,8562,49,72,6050.13,9588.00,0.00
2024-12-10 17:40:41,122,8562,49,73,6000.54,9588.01,0.00
2024-12-10 17:40:41,123,8561,50,73,5878.79,9588.63,0.00
2024-12-10 17:40:41,123,8562,50,73,5903.67,9589.00,0.00
2024-12-10 17:40:41,124,8562,50,74,5856.06,9589.01,0.00
2024-12-10 17:40:41,123,8562,50,73,5893.58,9589.10,0.00
2024-12-10 17:40:41,122,8562,49,73,5923.87,9589.29,0.00
2024-12-10 17:40:41,123,8561,50,73,5840.09,9589.68,0.00
2024-12-10 17:40:41,123,8562,50,73,5941.86,9590.00,0.00
2024-12-10 17:40:41,124,8562,51,73,5893.94,9590.01,0.00
2024-12-10 17:40:41,123,8562,51,72,5921.63,9590.10,0.00
2024-12-10 17:40:41,122,8562,50,72,5961.53,9590.15,0.00
2024-12-10 17:40:41,122,8563,50,72,6024.97,9591.00,0.00
2024-12-10 17:40:41,123,8563,51,72,5975.99,9591.01,0.00
2024-12-10 17:40:41,122,8563,51,71,6003.79,9591.10,0.00
2024-12-10 17:40:41,123,8562,51,72,5888.62,9591.74,0.00
2024-12-10 17:40:41,123,8563,51,72,5912.54,9592.00,0.00
2024-12-10 17:40:41,124,8563,51,73,5864.86,9592.01,0.00
2024-12-10 17:40:41,123,8563,51,72,5892.30,9592.10,0.00
2024-12-10 17:40:41,123,8564,51,72,5908.44,9593.00,0.00
2024-12-10 17:40:41,124,8564,52,72,5860.79,9593.01,0.00
2024-12-10 17:40:41,123,8564,52,71,5885.08,9593.11,0.00
2024-12-10 17:40:41,122,8564,51,71,5880.81,9593.66,0.00
2024-12-10 17:40:42,122,8565,51,71,5867.35,9594.00,0.00
2024-12-10 17:40:42,123,8565,51,72,5819.65,9594.01,0.00
2024-12-10 17:40:42,122,8565,51,71,5843.80,9594.12,0.00
2024-12-10 17:40:42,123,8564,51,72,5793.96,9594.15,0.00
2024-12-10 17:40:42,122,8564,50,72,5797.61,9594.71,0.00
2024-12-10 17:40:42,122,8565,50,72,5815.24,9595.00,0.00
2024-12-10 17:40:42,123,8565,50,73,5767.96,9595.01,0.00
2024-12-10 17:40:42,122,8565,50,72,5790.11,9595.12,0.00
2024-12-10 17:40:42,123,8564,50,73,5675.43,9595.82,0.00
2024-12-10 17:40:42,123,8565,50,73,5824.59,9596.00,0.00
2024-12-10 17:40:42,124,8565,51,73,5777.62,9596.01,0.00
2024-12-10 17:40:42,123,8565,51,72,5799.66,9596.11,0.00
2024-12-10 17:40:42,124,8564,51,73,5708.25,9596.60,0.00
2024-12-10 17:40:42,123,8564,50,73,5726.96,9596.97,0.00
2024-12-10 17:40:42,123,8565,50,73,5879.90,9597.00,0.00
2024-12-10 17:40:42,124,8565,51,73,5832.48,9597.01,0.00
2024-12-10 17:40:42,123,8565,50,73,5792.96,9597.73,0.00
2024-12-10 17:40:42,124,8564,50,74,5720.94,9597.93,0.00
2024-12-10 17:40:42,124,8565,50,74,5904.45,9598.00,0.00
2024-12-10 17:40:42,125,8565,50,75,5857.21,9598.01,0.00
2024-12-10 17:40:42,124,8565,50,74,5898.29,9598.06,0.00
2024-12-10 17:40:42,124,8566,50,74,5934.13,9599.00,0.00
2024-12-10 17:40:42,125,8566,51,74,5886.65,9599.01,0.00
2024-12-10 17:40:42,126,8565,51,75,5801.75,9599.26,0.00
2024-12-10 17:40:42,126,8566,51,75,5795.85,9600.00,0.00
2024-12-10 17:40:42,127,8566,51,76,5750.21,9600.01,0.00
2024-12-10 17:40:42,127,8567,51,76,5756.31,9601.00,0.00
2024-12-10 17:40:42,128,8567,52,76,5711.34,9601.01,0.00
2024-12-10 17:40:42,127,8567,51,76,5751.80,9601.05,0.00
2024-12-10 17:40:42,126,8567,51,75,5795.17,9601.06,0.00
2024-12-10 17:40:42,125,8567,50,75,5840.76,9601.06,0.00
2024-12-10 17:40:42,124,8567,50,74,5881.67,9601.08,0.00
2024-12-10 17:40:42,125,8566,50,75,5813.11,9601.28,0.00
2024-12-10 17:40:42,124,8566,49,75,5883.24,9601.29,0.00
2024-12-10 17:40:42,125,8565,50,75,5834.64,9601.32,0.00
2024-12-10 17:40:42,125,8566,50,75,5835.04,9602.00,0.00
2024-12-10 17:40:42,126,8566,51,75,5788.73,9602.01,0.00
2024-12-10 17:40:42,127,8565,52,75,5677.46,9602.44,0.00
2024-12-10 17:40:42,127,8566,52,75,5856.59,9603.00,0.00
2024-12-10 17:40:42,128,8566,52,76,5810.84,9603.01,0.00
2024-12-10 17:40:42,127,8566,52,75,5814.47,9603.21,0.00
2024-12-10 17:40:42,127,8567,52,75,5875.26,9604.00,0.00
2024-12-10 17:40:42,128,8567,53,75,5829.36,9604.01,0.00
2024-12-10 17:40:42,129,8566,53,76,5694.62,9604.57,0.00
2024-12-10 17:40:42,129,8567,53,76,5749.13,9605.00,0.00
2024-12-10 17:40:42,130,8567,54,76,5704.90,9605.01,0.00
2024-12-10 17:40:42,131,8566,55,76,5581.02,9605.66,0.00
2024-12-10 17:40:42,131,8567,55,76,5682.37,9606.00,0.00
2024-12-10 17:40:42,132,8567,55,77,5639.32,9606.01,0.00
2024-12-10 17:40:42,131,8567,55,76,5669.20,9606.08,0.00
2024-12-10 17:40:42,131,8568,55,76,5691.48,9607.00,0.00
2024-12-10 17:40:42,132,8568,55,77,5648.36,9607.01,0.00
2024-12-10 17:40:42,131,8568,55,76,5684.27,9607.06,0.00
2024-12-10 17:40:42,130,8568,55,75,5719.12,9607.08,0.00
2024-12-10 17:40:42,131,8567,55,76,5607.95,9607.75,0.00
2024-12-10 17:40:42,131,8568,55,76,5649.88,9608.00,0.00
2024-12-10 17:40:42,132,8568,55,77,5607.08,9608.01,0.00
2024-12-10 17:40:42,131,8568,55,76,5643.56,9608.06,0.00
2024-12-10 17:40:42,130,8568,55,75,5678.85,9608.07,0.00
2024-12-10 17:40:42,131,8567,56,75,5613.58,9608.31,0.00
2024-12-10 17:40:42,132,8566,57,75,5503.84,9608.86,0.00
2024-12-10 17:40:42,133,8565,57,76,5494.53,9608.96,0.00
2024-12-10 17:40:42,133,8566,57,76,5665.79,9609.00,0.00
2024-12-10 17:40:42,134,8566,58,76,5623.51,9609.01,0.00
2024-12-10 17:40:42,133,8566,58,75,5652.09,9609.07,0.00
2024-12-10 17:40:42,134,8565,58,76,5573.35,9609.16,0.00
2024-12-10 17:40:42,134,8566,58,76,5785.97,9610.00,0.00
2024-12-10 17:40:42,135,8566,58,77,5743.12,9610.01,0.00
2024-12-10 17:40:42,134,8566,58,76,5772.37,9610.07,0.00
2024-12-10 17:40:42,135,8565,59,76,5700.17,9610.39,0.00
2024-12-10 17:40:42,136,8564,60,76,5683.75,9610.49,0.00
2024-12-10 17:40:42,135,8564,59,76,5677.61,9610.74,0.00
2024-12-10 17:40:43,135,8565,59,76,5795.29,9611.00,0.00
2024-12-10 17:40:43,136,8565,60,76,5752.68,9611.01,0.00
2024-12-10 17:40:43,135,8565,60,75,5781.79,9611.07,0.00
2024-12-10 17:40:43,134,8565,59,75,5812.74,9611.08,0.00
2024-12-10 17:40:43,135,8564,60,75,5704.87,9611.76,0.00
2024-12-10 17:40:43,135,8565,60,75,5907.27,9612.00,0.00
2024-12-10 17:40:43,136,8565,61,75,5863.84,9612.01,0.00
2024-12-10 17:40:43,135,8565,61,74,5893.77,9612.07,0.00
2024-12-10 17:40:43,134,8565,60,74,5929.90,9612.14,0.00
2024-12-10 17:40:43,134,8566,60,74,5961.44,9613.00,0.00
2024-12-10 17:40:43,135,8566,61,74,5917.28,9613.01,0.00
2024-12-10 17:40:43,134,8566,61,73,5944.25,9613.07,0.00
2024-12-10 17:40:43,134,8567,61,73,5897.72,9614.00,0.00
2024-12-10 17:40:43,135,8567,62,73,5854.03,9614.01,0.00
2024-12-10 17:40:43,135,8568,62,73,5789.49,9615.00,0.00
2024-12-10 17:40:43,136,8568,63,73,5746.92,9615.01,0.00
2024-12-10 17:40:43,135,8568,63,72,5768.86,9615.08,0.00
2024-12-10 17:40:43,134,8568,62,72,5763.44,9615.57,0.00
2024-12-10 17:40:43,134,8569,62,72,5764.38,9616.00,0.00
2024-12-10 17:40:43,135,8569,62,73,5721.68,9616.01,0.00
2024-12-10 17:40:43,134,8569,62,72,5758.66,9616.06,0.00
2024-12-10 17:40:43,133,8569,62,71,5790.39,9616.08,0.00
2024-12-10 17:40:43,132,8569,61,71,5739.48,9616.73,0.00
2024-12-10 17:40:43,132,8570,61,71,5787.06,9617.00,0.00
2024-12-10 17:40:43,133,8570,61,72,5743.55,9617.01,0.00
2024-12-10 17:40:43,132,8570,61,71,5770.32,9617.08,0.00
2024-12-10 17:40:43,133,8569,62,71,5705.35,9617.32,0.00
2024-12-10 17:40:43,133,8570,62,71,5734.90,9618.00,0.00
2024-12-10 17:40:43,134,8570,63,71,5692.10,9618.01,0.00
2024-12-10 17:40:43,135,8569,64,71,5621.50,9618.17,0.00
2024-12-10 17:40:43,136,8568,65,71,5583.66,9618.68,0.00
2024-12-10 17:40:43,136,8569,65,71,5706.18,9619.00,0.00
2024-12-10 17:40:43,137,8569,66,71,5664.53,9619.01,0.00
2024-12-10 17:40:43,138,8568,67,71,5551.88,9619.61,0.00
2024-12-10 17:40:43,137,8568,66,71,5587.60,9619.74,0.00
2024-12-10 17:40:43,138,8567,67,71,5532.59,9619.90,0.00
2024-12-10 17:40:43,138,8568,67,71,5727.86,9620.00,0.00
2024-12-10 17:40:43,139,8568,68,71,5686.65,9620.01,0.00
2024-12-10 17:40:43,140,8567,68,72,5544.10,9620.92,0.00
2024-12-10 17:40:43,140,8568,68,72,5728.70,9621.00,0.00
2024-12-10 17:40:43,141,8568,68,73,5688.07,9621.01,0.00
2024-12-10 17:40:43,141,8569,68,73,5683.05,9622.00,0.00
2024-12-10 17:40:43,142,8569,68,74,5643.03,9622.01,0.00
2024-12-10 17:40:43,141,8569,68,73,5670.78,9622.08,0.00
2024-12-10 17:40:43,140,8569,67,73,5679.07,9622.31,0.00
2024-12-10 17:40:43,140,8570,67,73,5651.09,9623.00,0.00
2024-12-10 17:40:43,141,8570,67,74,5611.01,9623.01,0.00
2024-12-10 17:40:43,142,8569,67,75,5571.50,9623.02,0.00
2024-12-10 17:40:43,141,8569,67,74,5640.38,9623.06,0.00
2024-12-10 17:40:43,140,8569,67,73,5668.99,9623.09,0.00
2024-12-10 17:40:43,141,8568,67,74,5538.29,9623.56,0.00
2024-12-10 17:40:43,142,8567,67,75,5522.35,9623.59,0.00
2024-12-10 17:40:43,142,8568,67,75,5573.52,9624.00,0.00
2024-12-10 17:40:43,143,8568,67,76,5534.55,9624.01,0.00
2024-12-10 17:40:43,142,8568,67,75,5557.28,9624.08,0.00
2024-12-10 17:40:43,143,8567,67,76,5514.40,9624.13,0.00
2024-12-10 17:40:43,142,8567,66,76,5515.75,9624.30,0.00
2024-12-10 17:40:43,141,8567,65,76,5543.59,9624.38,0.00
2024-12-10 17:40:43,140,8567,64,76,5578.56,9624.43,0.00
2024-12-10 17:40:43,139,8567,63,76,5605.56,9624.45,0.00
2024-12-10 17:40:43,139,8568,63,76,5826.58,9625.00,0.00
2024-12-10 17:40:43,140,8568,63,77,5784.96,9625.01,0.00
2024-12-10 17:40:43,139,8568,62,77,5753.82,9625.26,0.00
2024-12-10 17:40:43,139,8569,62,77,5818.05,9626.00,0.00
2024-12-10 17:40:43,140,8569,63,77,5776.49,9626.01,0.00
2024-12-10 17:40:43,139,8569,63,76,5797.99,9626.08,0.00
2024-12-10 17:40:43,140,8568,63,77,5694.84,9626.45,0.00
2024-12-10 17:40:43,140,8569,63,77,5766.31,9627.00,0.00
2024-12-10 17:40:43,141,8569,64,77,5725.41,9627.01,0.00
2024-12-10 17:40:43,142,8568,64,78,5682.39,9627.05,0.00
2024-12-10 17:40:43,141,8568,63,78,5763.67,9627.06,0.00
2024-12-10 17:40:44,141,8569,63,78,5773.32,9628.00,0.00
2024-12-10 17:40:44,142,8569,63,79,5732.66,9628.01,0.00
2024-12-10 17:40:44,141,8569,62,79,5738.97,9628.22,0.00
2024-12-10 17:40:44,142,8568,63,79,5693.83,9628.28,0.00
2024-12-10 17:40:44,141,8568,62,79,5770.00,9628.35,0.00
2024-12-10 17:40:44,141,8569,62,79,5812.33,9629.00,0.00
2024-12-10 17:40:44,142,8569,62,80,5771.40,9629.01,0.00
2024-12-10 17:40:44,141,8569,62,79,5800.75,9629.09,0.00
2024-12-10 17:40:44,140,8569,61,79,5759.24,9629.81,0.00
2024-12-10 17:40:44,140,8570,61,79,5875.40,9630.00,0.00
2024-12-10 17:40:44,141,8570,61,80,5833.73,9630.01,0.00
2024-12-10 17:40:44,142,8569,62,80,5738.84,9630.34,0.00
2024-12-10 17:40:44,142,8570,62,80,5777.88,9631.00,0.00
2024-12-10 17:40:44,143,8570,62,81,5737.48,9631.01,0.00
2024-12-10 17:40:44,142,8570,61,81,5736.99,9631.20,0.00
2024-12-10 17:40:44,142,8571,61,81,5783.71,9632.00,0.00
2024-12-10 17:40:44,143,8571,62,81,5743.26,9632.01,0.00
2024-12-10 17:40:44,144,8570,62,82,5702.71,9632.03,0.00
2024-12-10 17:40:44,143,8570,62,81,5723.71,9632.29,0.00
2024-12-10 17:40:44,144,8569,63,81,5672.95,9632.42,0.00
2024-12-10 17:40:44,144,8570,63,81,5728.29,9633.00,0.00
2024-12-10 17:40:44,145,8570,64,81,5688.78,9633.01,0.00
2024-12-10 17:40:44,144,8570,64,80,5685.49,9633.31,0.00
2024-12-10 17:40:44,144,8571,64,80,5793.15,9634.00,0.00
2024-12-10 17:40:44,145,8571,65,80,5753.20,9634.01,0.00
2024-12-10 17:40:44,144,8571,65,79,5777.13,9634.10,0.00
2024-12-10 17:40:44,144,8572,65,79,5730.10,9635.00,0.00
2024-12-10 17:40:44,145,8572,65,80,5690.58,9635.01,0.00
2024-12-10 17:40:44,144,8572,65,79,5724.10,9635.06,0.00
2024-12-10 17:40:44,145,8571,65,80,5611.85,9635.70,0.00
2024-12-10 17:40:44,146,8570,66,80,5612.13,9635.71,0.00
2024-12-10 17:40:44,147,8569,66,81,5542.26,9635.88,0.00
2024-12-10 17:40:44,147,8570,66,81,5603.33,9636.00,0.00
2024-12-10 17:40:44,148,8570,66,82,5565.47,9636.01,0.00
2024-12-10 17:40:44,149,8569,66,83,5528.11,9636.02,0.00
2024-12-10 17:40:44,148,8569,66,82,5557.05,9636.14,0.00
2024-12-10 17:40:44,147,8569,65,82,5519.11,9636.69,0.00
2024-12-10 17:40:44,147,8570,65,82,5752.07,9637.00,0.00
2024-12-10 17:40:44,148,8570,65,83,5713.20,9637.01,0.00
2024-12-10 17:40:44,147,8570,65,82,5729.82,9637.14,0.00
2024-12-10 17:40:44,148,8569,65,83,5683.32,9637.23,0.00
2024-12-10 17:40:44,149,8568,65,84,5647.78,9637.27,0.00
2024-12-10 17:40:44,150,8567,66,84,5653.82,9637.28,0.00
2024-12-10 17:40:44,151,8566,67,84,5612.67,9637.50,0.00
2024-12-10 17:40:44,151,8567,67,84,5683.25,9638.00,0.00
2024-12-10 17:40:44,152,8567,67,85,5645.86,9638.01,0.00
2024-12-10 17:40:44,151,8567,66,85,5678.81,9638.05,0.00
2024-12-10 17:40:44,150,8567,66,84,5698.05,9638.13,0.00
2024-12-10 17:40:44,151,8566,67,84,5615.47,9638.58,0.00
2024-12-10 17:40:44,150,8566,66,84,5664.56,9638.69,0.00
2024-12-10 17:40:44,151,8565,66,85,5616.91,9638.81,0.00
2024-12-10 17:40:44,151,8566,66,85,5918.99,9639.00,0.00
2024-12-10 17:40:44,152,8566,67,85,5880.05,9639.01,0.00
2024-12-10 17:40:44,151,8566,66,85,5868.61,9639.15,0.00
2024-12-10 17:40:44,150,8566,66,84,5883.95,9639.37,0.00
2024-12-10 17:40:44,150,8567,66,84,6016.51,9640.00,0.00
2024-12-10 17:40:44,151,8567,66,85,5976.67,9640.01,0.00
2024-12-10 17:40:44,152,8566,67,85,5934.82,9640.05,0.00
2024-12-10 17:40:44,151,8566,67,84,5978.61,9640.07,0.00
2024-12-10 17:40:44,150,8566,67,83,6002.41,9640.14,0.00
2024-12-10 17:40:44,149,8566,66,83,6035.03,9640.22,0.00
2024-12-10 17:40:44,150,8565,66,84,5980.10,9640.38,0.00
2024-12-10 17:40:44,150,8566,66,84,5992.71,9641.00,0.00
2024-12-10 17:40:44,151,8566,67,84,5953.02,9641.01,0.00
2024-12-10 17:40:44,150,8566,66,84,5988.23,9641.05,0.00
2024-12-10 17:40:44,149,8566,66,83,6009.67,9641.13,0.00
2024-12-10 17:40:44,150,8565,66,84,5930.46,9641.28,0.00
2024-12-10 17:40:44,151,8564,66,85,5888.25,9641.54,0.00
2024-12-10 17:40:44,151,8565,66,85,6037.39,9642.00,0.00
2024-12-10 17:40:44,152,8565,67,85,5997.67,9642.01,0.00
2024-12-10 17:40:44,153,8564,67,86,5927.85,9642.14,0.00
2024-12-10 17:40:44,154,8563,68,86,5907.63,9642.36,0.00
2024-12-10 17:40:44,154,8564,68,86,6044.50,9643.00,0.00
2024-12-10 17:40:44,155,8564,69,86,6005.50,9643.01,0.00
2024-12-10 17:40:44,156,8563,69,87,5954.68,9643.15,0.00
2024-12-10 17:40:44,156,8564,69,87,6078.05,9644.00,0.00
2024-12-10 17:40:44,157,8564,70,87,6039.34,9644.01,0.00
2024-12-10 17:40:44,156,8564,70,86,6071.28,9644.07,0.00
2024-12-10 17:40:44,156,8565,70,86,6086.69,9645.00,0.00
2024-12-10 17:40:44,157,8565,70,87,6047.92,9645.01,0.00
2024-12-10 17:40:44,156,8565,70,86,6079.91,9645.07,0.00
2024-12-10 17:40:44,156,8566,70,86,6031.08,9646.00,0.00
2024-12-10 17:40:44,157,8566,70,87,5992.67,9646.01,0.00
2024-12-10 17:40:44,157,8567,70,87,5930.35,9647.00,0.00
2024-12-10 17:40:44,158,8567,71,87,5892.82,9647.01,0.00
2024-12-10 17:40:44,159,8566,71,88,5855.75,9647.02,0.00
2024-12-10 17:40:44,160,8565,72,88,5787.29,9647.49,0.00
2024-12-10 17:40:44,161,8564,72,89,5769.29,9647.54,0.00
2024-12-10 17:40:44,161,8565,72,89,5784.27,9648.00,0.00
2024-12-10 17:40:44,162,8565,73,89,5748.57,9648.01,0.00
2024-12-10 17:40:44,161,8565,73,88,5777.71,9648.07,0.00
2024-12-10 17:40:44,160,8565,73,87,5799.96,9648.11,0.00
2024-12-10 17:40:44,161,8564,73,88,5759.16,9648.17,0.00
2024-12-10 17:40:44,162,8563,73,89,5673.43,9648.76,0.00
2024-12-10 17:40:45,162,8564,73,89,5873.31,9649.00,0.00
2024-12-10 17:40:45,163,8564,74,89,5837.27,9649.01,0.00
2024-12-10 17:40:45,162,8564,74,88,5866.78,9649.07,0.00
2024-12-10 17:40:45,161,8564,73,88,5887.05,9649.10,0.00
2024-12-10 17:40:45,162,8563,74,88,5792.09,9649.59,0.00
2024-12-10 17:40:45,162,8564,74,88,5979.53,9650.00,0.00
2024-12-10 17:40:45,163,8564,75,88,5942.85,9650.01,0.00
2024-12-10 17:40:45,162,8564,75,87,5973.00,9650.07,0.00
2024-12-10 17:40:45,162,8565,75,87,5981.97,9651.00,0.00
2024-12-10 17:40:45,163,8565,76,87,5945.27,9651.01,0.00
2024-12-10 17:40:45,164,8564,77,87,5908.44,9651.02,0.00
2024-12-10 17:40:45,163,8564,76,87,5954.17,9651.03,0.00
2024-12-10 17:40:45,164,8563,76,88,5910.23,9651.12,0.00
2024-12-10 17:40:45,165,8562,76,89,5866.83,9651.17,0.00
2024-12-10 17:40:45,166,8561,77,89,5773.58,9651.87,0.00
2024-12-10 17:40:45,166,8562,77,89,5801.60,9652.00,0.00
2024-12-10 17:40:45,167,8562,78,89,5766.86,9652.01,0.00
2024-12-10 17:40:45,166,8562,77,89,5800.42,9652.02,0.00
2024-12-10 17:40:45,165,8562,77,88,5830.91,9652.06,0.00
2024-12-10 17:40:45,164,8562,77,87,5860.00,9652.10,0.00
2024-12-10 17:40:45,165,8561,77,88,5800.04,9652.36,0.00
2024-12-10 17:40:45,166,8560,78,88,5774.03,9652.56,0.00
2024-12-10 17:40:45,166,8561,78,88,6016.45,9653.00,0.00
2024-12-10 17:40:45,167,8561,79,88,5980.42,9653.01,0.00
2024-12-10 17:40:45,168,8560,79,89,5880.63,9653.34,0.00
2024-12-10 17:40:45,168,8561,79,89,6006.80,9654.00,0.00
2024-12-10 17:40:45,169,8561,80,89,5971.26,9654.01,0.00
2024-12-10 17:40:45,168,8561,80,88,6001.08,9654.06,0.00
2024-12-10 17:40:45,167,8561,80,87,6024.89,9654.09,0.00
2024-12-10 17:40:45,166,8561,79,87,6028.10,9654.27,0.00
2024-12-10 17:40:45,166,8562,79,87,6065.02,9655.00,0.00
2024-12-10 17:40:45,167,8562,80,87,6028.70,9655.01,0.00
2024-12-10 17:40:45,166,8562,79,87,6061.46,9655.04,0.00
2024-12-10 17:40:45,166,8563,79,87,5999.00,9656.00,0.00
2024-12-10 17:40:45,167,8563,80,87,5963.08,9656.01,0.00
2024-12-10 17:40:45,167,8564,80,87,5893.74,9657.00,0.00
2024-12-10 17:40:45,168,8564,80,88,5858.65,9657.01,0.00
2024-12-10 17:40:45,167,8564,80,87,5891.44,9657.02,0.00
2024-12-10 17:40:45,168,8563,81,87,5811.11,9657.39,0.00
2024-12-10 17:40:45,169,8562,81,88,5797.28,9657.57,0.00
2024-12-10 17:40:45,170,8561,82,88,5756.76,9657.84,0.00
2024-12-10 17:40:45,171,8560,82,89,5722.60,9657.93,0.00
2024-12-10 17:40:45,171,8561,82,89,5778.31,9658.00,0.00
2024-12-10 17:40:45,172,8561,82,90,5744.72,9658.01,0.00
2024-12-10 17:40:45,171,8561,82,89,5759.71,9658.08,0.00
2024-12-10 17:40:45,172,8560,83,89,5724.55,9658.11,0.00
2024-12-10 17:40:45,172,8561,83,89,5931.55,9659.00,0.00
2024-12-10 17:40:45,173,8561,83,90,5897.26,9659.01,0.00
2024-12-10 17:40:45,173,8562,83,90,5882.35,9660.00,0.00
2024-12-10 17:40:45,174,8562,83,91,5848.55,9660.01,0.00
2024-12-10 17:40:45,175,8561,83,92,5777.35,9660.29,0.00
2024-12-10 17:40:45,175,8562,83,92,5743.55,9661.00,0.00
2024-12-10 17:40:45,176,8562,84,92,5710.91,9661.01,0.00
2024-12-10 17:40:45,175,8562,83,92,5675.92,9661.46,0.00
2024-12-10 17:40:45,175,8563,83,92,5714.53,9662.00,0.00
2024-12-10 17:40:45,176,8563,83,93,5682.06,9662.01,0.00
2024-12-10 17:40:45,175,8563,83,92,5709.58,9662.05,0.00
2024-12-10 17:40:45,176,8562,84,92,5639.37,9662.34,0.00
2024-12-10 17:40:45,175,8562,83,92,5646.72,9662.70,0.00
2024-12-10 17:40:45,175,8563,83,92,5668.76,9663.00,0.00
2024-12-10 17:40:45,176,8563,84,92,5636.55,9663.01,0.00
2024-12-10 17:40:45,175,8563,84,91,5663.82,9663.05,0.00
2024-12-10 17:40:45,174,8563,83,91,5695.81,9663.05,0.00
2024-12-10 17:40:45,173,8563,83,90,5724.27,9663.06,0.00
2024-12-10 17:40:45,172,8563,82,90,5721.67,9663.34,0.00
2024-12-10 17:40:45,172,8564,82,90,5742.35,9664.00,0.00
2024-12-10 17:40:45,173,8564,83,90,5709.16,9664.01,0.00
2024-12-10 17:40:45,174,8563,84,90,5676.34,9664.02,0.00
2024-12-10 17:40:45,173,8563,84,89,5711.91,9664.07,0.00
2024-12-10 17:40:45,174,8562,84,90,5613.54,9664.72,0.00
2024-12-10 17:40:45,175,8561,84,91,5578.78,9664.82,0.00
2024-12-10 17:40:45,175,8562,84,91,5601.51,9665.00,0.00
2024-12-10 17:40:45,176,8562,85,91,5569.68,9665.01,0.00
2024-12-10 17:40:45,177,8561,85,92,5506.08,9665.24,0.00
2024-12-10 17:40:45,178,8560,86,92,5461.12,9665.50,0.00
2024-12-10 17:40:45,178,8561,86,92,5626.17,9666.00,0.00
2024-12-10 17:40:46,179,8561,86,93,5594.74,9666.01,0.00
2024-12-10 17:40:46,178,8561,86,92,5574.70,9666.36,0.00
2024-12-10 17:40:46,179,8560,86,93,5497.93,9666.84,0.00
2024-12-10 17:40:46,179,8561,86,93,5642.10,9667.00,0.00
2024-12-10 17:40:46,180,8561,86,94,5610.75,9667.01,0.00
2024-12-10 17:40:46,179,8561,86,93,5636.72,9667.06,0.00
2024-12-10 17:40:46,179,8562,86,93,5625.29,9668.00,0.00
2024-12-10 17:40:46,180,8562,87,93,5594.04,9668.01,0.00
2024-12-10 17:40:46,181,8561,87,94,5562.60,9668.02,0.00
2024-12-10 17:40:46,182,8560,87,95,5509.81,9668.24,0.00
2024-12-10 17:40:46,183,8559,87,96,5512.48,9668.31,0.00
2024-12-10 17:40:46,184,8558,87,97,5505.19,9668.44,0.00
2024-12-10 17:40:46,184,8559,87,97,5527.00,9669.00,0.00
2024-12-10 17:40:46,185,8559,87,98,5497.12,9669.01,0.00
2024-12-10 17:40:46,184,8559,87,97,5520.72,9669.06,0.00
2024-12-10 17:40:46,184,8560,87,97,5669.15,9670.00,0.00
2024-12-10 17:40:46,185,8560,87,98,5638.51,9670.01,0.00
2024-12-10 17:40:46,184,8560,87,97,5661.83,9670.06,0.00
2024-12-10 17:40:46,183,8560,86,97,5641.70,9670.49,0.00
2024-12-10 17:40:46,184,8559,86,98,5592.24,9670.70,0.00
2024-12-10 17:40:46,184,8560,86,98,5627.55,9671.00,0.00
2024-12-10 17:40:46,185,8560,87,98,5597.13,9671.01,0.00
2024-12-10 17:40:46,184,8560,87,97,5618.65,9671.07,0.00
2024-12-10 17:40:46,185,8559,87,98,5570.04,9671.27,0.00
2024-12-10 17:40:46,184,8559,86,98,5595.44,9671.69,0.00
2024-12-10 17:40:46,185,8558,87,98,5563.12,9671.72,0.00
2024-12-10 17:40:46,185,8559,87,98,5630.30,9672.00,0.00
2024-12-10 17:40:46,186,8559,87,99,5600.03,9672.01,0.00
2024-12-10 17:40:46,187,8558,88,99,5540.16,9672.22,0.00
2024-12-10 17:40:46,187,8559,88,99,5650.75,9673.00,0.00
2024-12-10 17:40:46,188,8559,89,99,5620.69,9673.01,0.00
2024-12-10 17:40:46,187,8559,89,98,5625.63,9673.16,0.00
2024-12-10 17:40:46,188,8558,90,98,5591.60,9673.21,0.00
2024-12-10 17:40:46,189,8557,91,98,5563.05,9673.23,0.00
2024-12-10 17:40:46,190,8556,91,99,5554.74,9673.42,0.00
2024-12-10 17:40:46,191,8555,92,99,5528.60,9673.74,0.00
2024-12-10 17:40:46,191,8556,92,99,5611.91,9674.00,0.00
2024-12-10 17:40:46,192,8556,93,99,5582.68,9674.01,0.00
2024-12-10 17:40:46,191,8556,93,98,5606.36,9674.06,0.00
2024-12-10 17:40:46,190,8556,92,98,5635.36,9674.06,0.00
2024-12-10 17:40:46,189,8556,91,98,5598.02,9674.53,0.00
2024-12-10 17:40:46,189,8557,91,98,5807.92,9675.00,0.00
2024-12-10 17:40:46,190,8557,92,98,5777.35,9675.01,0.00
2024-12-10 17:40:46,189,8557,92,97,5791.07,9675.14,0.00
2024-12-10 17:40:46,190,8556,93,97,5757.54,9675.18,0.00
2024-12-10 17:40:46,190,8557,93,97,5713.04,9676.00,0.00
2024-12-10 17:40:46,191,8557,93,98,5683.13,9676.01,0.00
2024-12-10 17:40:46,190,8557,93,97,5692.72,9676.14,0.00
2024-12-10 17:40:46,189,8557,92,97,5686.57,9676.32,0.00
2024-12-10 17:40:46,190,8556,93,97,5640.44,9676.50,0.00
2024-12-10 17:40:46,189,8556,92,97,5685.89,9676.77,0.00
2024-12-10 17:40:46,190,8555,92,98,5655.97,9676.78,0.00
2024-12-10 17:40:46,190,8556,92,98,5745.79,9677.00,0.00
2024-12-10 17:40:46,191,8556,93,98,5715.71,9677.01,0.00
2024-12-10 17:40:46,190,8556,92,98,5738.67,9677.03,0.00
2024-12-10 17:40:46,189,8556,92,97,5750.13,9677.14,0.00
2024-12-10 17:40:46,189,8557,92,97,5821.34,9678.00,0.00
2024-12-10 17:40:46,190,8557,93,97,5790.70,9678.01,0.00
2024-12-10 17:40:46,189,8557,93,96,5816.24,9678.05,0.00
2024-12-10 17:40:46,188,8557,92,96,5846.67,9678.05,0.00
2024-12-10 17:40:46,187,8557,92,95,5862.43,9678.13,0.00
2024-12-10 17:40:46,188,8556,92,96,5779.54,9678.68,0.00
2024-12-10 17:40:46,188,8557,92,96,5781.86,9679.00,0.00
2024-12-10 17:40:46,189,8557,92,97,5751.27,9679.01,0.00
2024-12-10 17:40:46,188,8557,91,97,5776.22,9679.06,0.00
2024-12-10 17:40:46,187,8557,91,96,5792.12,9679.13,0.00
2024-12-10 17:40:46,188,8556,91,97,5681.22,9679.74,0.00
2024-12-10 17:40:46,188,8557,91,97,5770.00,9680.00,0.00
2024-12-10 17:40:46,189,8557,91,98,5739.47,9680.01,0.00
2024-12-10 17:40:46,190,8556,91,99,5651.91,9680.51,0.00
2024-12-10 17:40:46,191,8555,91,100,5634.65,9680.55,0.00
2024-12-10 17:40:46,192,8554,92,100,5607.36,9680.61,0.00
2024-12-10 17:40:46,193,8553,92,101,5591.02,9680.87,0.00
2024-12-10 17:40:46,193,8554,92,101,5679.57,9681.00,0.00
2024-12-10 17:40:46,194,8554,93,101,5650.29,9681.01,0.00
2024-12-10 17:40:46,193,8554,92,101,5677.07,9681.03,0.00
2024-12-10 17:40:46,192,8554,91,101,5703.13,9681.06,0.00
2024-12-10 17:40:46,191,8554,90,101,5677.28,9681.50,0.00
2024-12-10 17:40:46,192,8553,90,102,5646.70,9681.52,0.00
2024-12-10 17:40:46,191,8553,89,102,5670.27,9681.80,0.00
2024-12-10 17:40:46,191,8554,89,102,5897.63,9682.00,0.00
2024-12-10 17:40:46,192,8554,90,102,5866.91,9682.01,0.00
2024-12-10 17:40:46,191,8554,90,101,5891.58,9682.06,0.00
2024-12-10 17:40:46,190,8554,89,101,5851.30,9682.69,0.00
2024-12-10 17:40:46,190,8555,89,101,5911.35,9683.00,0.00
2024-12-10 17:40:46,191,8555,90,101,5880.40,9683.01,0.00
2024-12-10 17:40:46,190,8555,90,100,5905.26,9683.06,0.00
2024-12-10 17:40:46,189,8555,89,100,5935.99,9683.06,0.00
2024-12-10 17:40:46,190,8554,90,100,5871.21,9683.32,0.00
2024-12-10 17:40:46,191,8553,91,100,5830.41,9683.48,0.00
2024-12-10 17:40:46,191,8554,91,100,5833.14,9684.00,0.00
2024-12-10 17:40:46,192,8554,91,101,5802.76,9684.01,0.00
2024-12-10 17:40:46,191,8554,91,100,5827.09,9684.06,0.00
2024-12-10 17:40:46,190,8554,91,99,5848.59,9684.10,0.00
2024-12-10 17:40:47,190,8555,91,99,5891.10,9685.00,0.00
2024-12-10 17:40:47,191,8555,91,100,5860.25,9685.01,0.00
2024-12-10 17:40:47,190,8555,91,99,5885.01,9685.06,0.00
2024-12-10 17:40:47,189,8555,91,98,5907.96,9685.09,0.00
2024-12-10 17:40:47,190,8554,91,99,5847.43,9685.41,0.00
2024-12-10 17:40:47,191,8553,92,99,5829.08,9685.56,0.00
2024-12-10 17:40:47,190,8553,91,99,5845.97,9685.67,0.00
2024-12-10 17:40:47,190,8554,91,99,5858.81,9686.00,0.00
2024-12-10 17:40:47,191,8554,91,100,5828.14,9686.01,0.00
2024-12-10 17:40:47,192,8553,92,100,5797.78,9686.02,0.00
2024-12-10 17:40:47,192,8554,92,100,5838.30,9687.00,0.00
2024-12-10 17:40:47,193,8554,93,100,5808.05,9687.01,0.00
2024-12-10 17:40:47,194,8553,93,101,5741.77,9687.29,0.00
2024-12-10 17:40:47,195,8552,93,102,5713.82,9687.30,0.00
2024-12-10 17:40:47,196,8551,94,102,5715.82,9687.32,0.00
2024-12-10 17:40:47,197,8550,94,103,5664.87,9687.67,0.00
2024-12-10 17:40:47,197,8551,94,103,5708.78,9688.00,0.00
2024-12-10 17:40:47,198,8551,95,103,5679.95,9688.01,0.00
2024-12-10 17:40:47,197,8551,94,103,5701.44,9688.08,0.00
2024-12-10 17:40:47,196,8551,94,102,5635.43,9688.72,0.00
2024-12-10 17:40:47,196,8552,94,102,5841.36,9689.00,0.00
2024-12-10 17:40:47,197,8552,94,103,5811.71,9689.01,0.00
2024-12-10 17:40:47,198,8551,95,103,5749.18,9689.26,0.00
2024-12-10 17:40:47,199,8550,95,104,5720.82,9689.36,0.00
2024-12-10 17:40:47,198,8550,94,104,5734.11,9689.70,0.00
2024-12-10 17:40:47,198,8551,94,104,5734.85,9690.00,0.00
2024-12-10 17:40:47,199,8551,95,104,5706.03,9690.01,0.00
2024-12-10 17:40:47,200,8550,96,104,5670.26,9690.09,0.00
2024-12-10 17:40:47,200,8551,96,104,5746.89,9691.00,0.00
2024-12-10 17:40:47,201,8551,97,104,5718.30,9691.01,0.00
2024-12-10 17:40:47,201,8552,97,104,5703.23,9692.00,0.00
2024-12-10 17:40:47,202,8552,98,104,5674.99,9692.01,0.00
2024-12-10 17:40:47,201,8552,97,104,5682.60,9692.11,0.00
2024-12-10 17:40:47,202,8551,97,105,5651.61,9692.15,0.00
2024-12-10 17:40:47,202,8552,97,105,5650.26,9693.00,0.00
2024-12-10 17:40:47,203,8552,97,106,5622.43,9693.01,0.00
2024-12-10 17:40:47,204,8551,98,106,5591.56,9693.05,0.00
2024-12-10 17:40:47,203,8551,97,106,5606.51,9693.25,0.00
2024-12-10 17:40:47,202,8551,96,106,5623.29,9693.36,0.00
2024-12-10 17:40:47,203,8550,97,106,5548.31,9693.83,0.00
2024-12-10 17:40:47,203,8551,97,106,5619.05,9694.00,0.00
2024-12-10 17:40:47,204,8551,98,106,5591.51,9694.01,0.00
2024-12-10 17:40:47,203,8551,98,105,5602.37,9694.08,0.00
2024-12-10 17:40:47,203,8552,98,105,5630.29,9695.00,0.00
2024-12-10 17:40:47,204,8552,98,106,5602.69,9695.01,0.00
2024-12-10 17:40:47,203,8552,97,106,5565.16,9695.57,0.00
2024-12-10 17:40:47,203,8553,97,106,5557.59,9696.00,0.00
2024-12-10 17:40:47,204,8553,98,106,5530.35,9696.01,0.00
2024-12-10 17:40:47,205,8552,99,106,5471.76,9696.24,0.00
2024-12-10 17:40:47,206,8551,100,106,5466.45,9696.40,0.00
2024-12-10 17:40:47,207,8550,101,106,5425.19,9696.64,0.00
2024-12-10 17:40:47,208,8549,101,107,5410.38,9696.79,0.00
2024-12-10 17:40:47,209,8548,102,107,5386.06,9696.84,0.00
2024-12-10 17:40:47,209,8549,102,107,5423.77,9697.00,0.00
2024-12-10 17:40:47,210,8549,103,107,5397.94,9697.01,0.00
2024-12-10 17:40:47,209,8549,102,107,5416.84,9697.07,0.00
2024-12-10 17:40:47,209,8550,102,107,5562.75,9698.00,0.00
2024-12-10 17:40:47,210,8550,103,107,5536.26,9698.01,0.00
2024-12-10 17:40:47,209,8550,103,106,5549.32,9698.07,0.00
2024-12-10 17:40:47,208,8550,103,105,5574.61,9698.08,0.00
2024-12-10 17:40:47,209,8549,104,105,5489.30,9698.70,0.00
2024-12-10 17:40:47,208,8549,103,105,5519.77,9698.77,0.00
2024-12-10 17:40:47,208,8550,103,105,5525.95,9699.00,0.00
2024-12-10 17:40:47,209,8550,103,106,5499.51,9699.01,0.00
2024-12-10 17:40:47,210,8549,104,106,5469.64,9699.05,0.00
2024-12-10 17:40:47,211,8548,104,107,5452.95,9699.14,0.00
2024-12-10 17:40:47,212,8547,105,107,5401.73,9699.80,0.00
2024-12-10 17:40:47,212,8548,105,107,5479.80,9700.00,0.00
2024-12-10 17:40:47,213,8548,105,108,5454.07,9700.01,0.00
2024-12-10 17:40:47,212,8548,105,107,5462.45,9700.09,0.00
2024-12-10 17:40:47,211,8548,104,107,5479.82,9700.17,0.00
2024-12-10 17:40:47,210,8548,103,107,5485.68,9700.38,0.00
2024-12-10 17:40:47,211,8547,103,108,5453.28,9700.46,0.00
2024-12-10 17:40:47,212,8546,103,109,5450.44,9700.47,0.00
2024-12-10 17:40:47,212,8547,103,109,5598.26,9701.00,0.00
2024-12-10 17:40:47,213,8547,103,110,5571.97,9701.01,0.00
2024-12-10 17:40:47,212,8547,102,110,5596.43,9701.02,0.00
2024-12-10 17:40:47,213,8546,103,110,5568.35,9701.05,0.00
2024-12-10 17:40:47,212,8546,103,109,5600.12,9701.09,0.00
2024-12-10 17:40:47,211,8546,102,109,5626.20,9701.09,0.00
2024-12-10 17:40:47,212,8545,102,110,5559.13,9701.51,0.00
2024-12-10 17:40:47,212,8546,102,110,5658.10,9702.00,0.00
2024-12-10 17:40:47,213,8546,102,111,5631.53,9702.01,0.00
2024-12-10 17:40:48,214,8545,103,111,5574.48,9702.24,0.00
2024-12-10 17:40:48,213,8545,102,111,5574.91,9702.78,0.00
2024-12-10 17:40:48,213,8546,102,111,5678.70,9703.00,0.00
2024-12-10 17:40:48,214,8546,102,112,5652.16,9703.01,0.00
2024-12-10 17:40:48,215,8545,102,113,5602.01,9703.17,0.00
2024-12-10 17:40:48,216,8544,102,114,5610.23,9703.20,0.00
2024-12-10 17:40:48,215,8544,101,114,5655.37,9703.40,0.00
2024-12-10 17:40:48,215,8545,101,114,5668.98,9704.00,0.00
2024-12-10 17:40:48,216,8545,101,115,5642.73,9704.01,0.00
2024-12-10 17:40:48,217,8544,102,115,5601.55,9704.08,0.00
2024-12-10 17:40:48,216,8544,101,115,5562.77,9704.88,0.00
2024-12-10 17:40:48,216,8545,101,115,5676.94,9705.00,0.00
2024-12-10 17:40:48,217,8545,102,115,5650.78,9705.01,0.00
2024-12-10 17:40:48,216,8545,101,115,5658.12,9705.10,0.00
2024-12-10 17:40:48,217,8544,102,115,5563.99,9705.82,0.00
2024-12-10 17:40:48,217,8545,102,115,5627.68,9706.00,0.00
2024-12-10 17:40:48,218,8545,103,115,5601.87,9706.01,0.00
2024-12-10 17:40:48,217,8545,103,114,5617.41,9706.04,0.00
2024-12-10 17:40:48,218,8544,103,115,5516.80,9706.82,0.00
2024-12-10 17:40:48,217,8544,102,115,5527.42,9706.95,0.00
2024-12-10 17:40:48,217,8545,102,115,5612.45,9707.00,0.00
2024-12-10 17:40:48,218,8545,102,116,5586.70,9707.01,0.00
2024-12-10 17:40:48,217,8545,102,115,5603.51,9707.02,0.00
2024-12-10 17:40:48,216,8545,102,114,5621.85,9707.10,0.00
2024-12-10 17:40:48,215,8545,102,113,5647.55,9707.10,0.00
2024-12-10 17:40:48,216,8544,102,114,5582.03,9707.51,0.00
2024-12-10 17:40:48,216,8545,102,114,5628.68,9708.00,0.00
2024-12-10 17:40:48,217,8545,102,115,5602.74,9708.01,0.00
2024-12-10 17:40:48,216,8545,101,115,5626.89,9708.02,0.00
2024-12-10 17:40:48,215,8545,101,114,5636.39,9708.09,0.00
2024-12-10 17:40:48,214,8545,100,114,5661.82,9708.10,0.00
2024-12-10 17:40:48,215,8544,101,114,5579.12,9708.65,0.00
2024-12-10 17:40:48,216,8543,102,114,5573.62,9708.79,0.00
2024-12-10 17:40:48,215,8543,101,114,5599.55,9708.80,0.00
2024-12-10 17:40:48,216,8542,102,114,5572.74,9708.81,0.00
2024-12-10 17:40:48,216,8543,102,114,5652.90,9709.00,0.00
2024-12-10 17:40:48,217,8543,102,115,5626.85,9709.01,0.00
2024-12-10 17:40:48,218,8542,102,116,5601.04,9709.01,0.00
2024-12-10 17:40:48,217,8542,102,115,5618.40,9709.11,0.00
2024-12-10 17:40:48,218,8541,102,116,5577.98,9709.27,0.00
2024-12-10 17:40:48,219,8540,102,117,5564.49,9709.30,0.00
2024-12-10 17:40:48,220,8539,102,118,5504.65,9709.94,0.00
2024-12-10 17:40:48,220,8540,102,118,5677.27,9710.00,0.00
2024-12-10 17:40:48,221,8540,102,119,5651.58,9710.01,0.00
2024-12-10 17:40:48,220,8540,101,119,5658.34,9710.10,0.00
2024-12-10 17:40:48,221,8539,101,120,5562.66,9710.74,0.00
2024-12-10 17:40:48,221,8540,101,120,5766.81,9711.00,0.00
2024-12-10 17:40:48,222,8540,101,121,5740.83,9711.01,0.00
2024-12-10 17:40:48,221,8540,100,121,5747.96,9711.10,0.00
2024-12-10 17:40:48,220,8540,99,121,5745.96,9711.40,0.00
2024-12-10 17:40:48,221,8539,100,121,5714.27,9711.46,0.00
2024-12-10 17:40:48,220,8539,99,121,5746.50,9711.60,0.00
2024-12-10 17:40:48,220,8540,99,121,5795.35,9712.00,0.00
2024-12-10 17:40:48,221,8540,100,121,5769.13,9712.01,0.00
2024-12-10 17:40:48,220,8540,100,120,5784.78,9712.06,0.00
2024-12-10 17:40:48,219,8540,99,120,5775.87,9712.42,0.00
2024-12-10 17:40:48,219,8541,99,120,5787.94,9713.00,0.00
2024-12-10 17:40:48,220,8541,100,120,5761.64,9713.01,0.00
2024-12-10 17:40:48,221,8540,101,120,5716.27,9713.12,0.00
2024-12-10 17:40:48,222,8539,101,121,5714.17,9713.17,0.00
2024-12-10 17:40:48,222,8540,101,121,5674.03,9714.00,0.00
2024-12-10 17:40:48,223,8540,102,121,5648.59,9714.01,0.00
2024-12-10 17:40:48,223,8541,102,121,5654.46,9715.00,0.00
2024-12-10 17:40:48,224,8541,103,121,5629.22,9715.01,0.00
2024-12-10 17:40:48,223,8541,103,120,5644.90,9715.07,0.00
2024-12-10 17:40:48,224,8540,103,121,5564.88,9715.64,0.00
2024-12-10 17:40:48,224,8541,103,121,5561.67,9716.00,0.00
2024-12-10 17:40:48,225,8541,104,121,5536.95,9716.01,0.00
2024-12-10 17:40:48,224,8541,104,120,5543.49,9716.10,0.00
2024-12-10 17:40:48,225,8540,104,121,5486.18,9716.44,0.00
2024-12-10 17:40:48,226,8539,104,122,5444.03,9716.62,0.00
2024-12-10 17:40:48,226,8540,104,122,5506.28,9717.00,0.00
2024-12-10 17:40:48,227,8540,105,122,5482.02,9717.01,0.00
2024-12-10 17:40:48,228,8539,105,123,5441.39,9717.10,0.00
2024-12-10 17:40:48,227,8539,105,122,5499.18,9717.10,0.00
2024-12-10 17:40:48,228,8538,106,122,5424.83,9717.54,0.00
2024-12-10 17:40:48,229,8537,106,123,5394.87,9717.69,0.00
2024-12-10 17:40:48,229,8538,106,123,5502.85,9718.00,0.00
2024-12-10 17:40:48,230,8538,107,123,5478.92,9718.00,0.00
2024-12-10 17:40:48,231,8537,108,123,5369.37,9718.66,0.00
2024-12-10 17:40:48,231,8538,108,123,5515.83,9719.00,0.00
2024-12-10 17:40:48,232,8538,109,123,5492.06,9719.00,0.00
2024-12-10 17:40:48,231,8538,108,123,5512.06,9719.04,0.00
2024-12-10 17:40:48,232,8537,108,124,5485.79,9719.07,0.00
2024-12-10 17:40:48,233,8536,109,124,5467.79,9719.37,0.00
2024-12-10 17:40:49,233,8537,109,124,5488.25,9720.00,0.00
2024-12-10 17:40:49,234,8537,109,125,5464.79,9720.00,0.00
2024-12-10 17:40:49,235,8536,109,126,5401.13,9720.35,0.00
2024-12-10 17:40:49,235,8537,109,126,5486.27,9721.00,0.00
2024-12-10 17:40:49,236,8537,110,126,5463.02,9721.00,0.00
2024-12-10 17:40:49,235,8537,110,125,5466.47,9721.12,0.00
2024-12-10 17:40:49,235,8538,110,125,5456.51,9722.00,0.00
2024-12-10 17:40:49,236,8538,111,125,5433.39,9722.00,0.00
2024-12-10 17:40:49,235,8538,111,124,5436.71,9722.12,0.00
2024-12-10 17:40:49,236,8537,111,125,5382.07,9722.45,0.00
2024-12-10 17:40:49,237,8536,112,125,5362.35,9722.67,0.00
2024-12-10 17:40:49,238,8535,112,126,5340.26,9722.72,0.00
2024-12-10 17:40:49,238,8536,112,126,5352.22,9723.00,0.00
2024-12-10 17:40:49,239,8536,112,127,5329.82,9723.00,0.00
2024-12-10 17:40:49,238,8536,111,127,5348.96,9723.03,0.00
2024-12-10 17:40:49,237,8536,111,126,5354.97,9723.11,0.00
2024-12-10 17:40:49,236,8536,111,125,5376.84,9723.12,0.00
2024-12-10 17:40:49,237,8535,111,126,5334.11,9723.33,0.00
2024-12-10 17:40:49,236,8535,111,125,5313.60,9723.75,0.00
2024-12-10 17:40:49,236,8536,111,125,5439.71,9724.00,0.00
2024-12-10 17:40:49,237,8536,111,126,5416.75,9724.00,0.00
2024-12-10 17:40:49,236,8536,111,125,5430.66,9724.06,0.00
2024-12-10 17:40:49,235,8536,111,124,5447.60,9724.12,0.00
2024-12-10 17:40:49,234,8536,111,123,5470.47,9724.12,0.00
2024-12-10 17:40:49,235,8535,111,124,5425.33,9724.35,0.00
2024-12-10 17:40:49,236,8534,112,124,5392.39,9724.76,0.00
2024-12-10 17:40:49,236,8535,112,124,5444.52,9725.00,0.00
2024-12-10 17:40:49,237,8535,113,124,5421.54,9725.00,0.00
2024-12-10 17:40:49,236,8535,113,123,5424.07,9725.12,0.00
2024-12-10 17:40:49,237,8534,114,123,5338.09,9725.72,0.00
2024-12-10 17:40:49,237,8535,114,123,5461.07,9726.00,0.00
2024-12-10 17:40:49,238,8535,114,124,5438.12,9726.00,0.00
2024-12-10 17:40:49,237,8535,113,124,5458.61,9726.03,0.00
2024-12-10 17:40:49,236,8535,112,124,5463.85,9726.11,0.00
2024-12-10 17:40:49,235,8535,112,123,5486.69,9726.12,0.00
2024-12-10 17:40:49,236,8534,113,123,5403.23,9726.74,0.00
2024-12-10 17:40:49,236,8535,113,123,5460.10,9727.00,0.00
2024-12-10 17:40:49,237,8535,114,123,5437.06,9727.00,0.00
2024-12-10 17:40:49,236,8535,114,122,5440.78,9727.11,0.00
2024-12-10 17:40:49,236,8536,114,122,5420.15,9728.00,0.00
2024-12-10 17:40:49,237,8536,115,122,5397.28,9728.00,0.00
2024-12-10 17:40:49,236,8536,115,121,5411.62,9728.06,0.00
2024-12-10 17:40:49,237,8535,115,122,5387.15,9728.08,0.00
2024-12-10 17:40:49,236,8535,115,121,5412.07,9728.11,0.00
2024-12-10 17:40:49,235,8535,114,121,5434.68,9728.12,0.00
2024-12-10 17:40:49,236,8534,115,121,5393.58,9728.31,0.00
2024-12-10 17:40:49,237,8533,116,121,5365.64,9728.63,0.00
2024-12-10 17:40:49,238,8532,117,121,5337.47,9728.77,0.00
2024-12-10 17:40:49,238,8533,117,121,5348.70,9729.00,0.00
2024-12-10 17:40:49,239,8533,117,122,5326.32,9729.00,0.00
2024-12-10 17:40:49,240,8532,117,123,5304.13,9729.01,0.00
2024-12-10 17:40:49,241,8531,117,124,5284.56,9729.07,0.00
2024-12-10 17:40:49,242,8530,118,124,5250.17,9729.26,0.00
2024-12-10 17:40:49,241,8530,117,124,5268.80,9729.41,0.00
2024-12-10 17:40:49,241,8531,117,124,5409.11,9730.00,0.00
2024-12-10 17:40:49,242,8531,118,124,5386.76,9730.00,0.00
2024-12-10 17:40:49,243,8530,119,124,5362.60,9730.03,0.00
2024-12-10 17:40:49,242,8530,119,123,5407.32,9730.12,0.00
2024-12-10 17:40:49,241,8530,118,123,5407.07,9730.35,0.00
2024-12-10 17:40:49,242,8529,119,123,5365.52,9730.55,0.00
2024-12-10 17:40:49,242,8530,119,123,5484.10,9731.00,0.00
2024-12-10 17:40:49,243,8530,119,124,5461.53,9731.00,0.00
2024-12-10 17:40:49,242,8530,119,123,5464.85,9731.12,0.00
2024-12-10 17:40:49,243,8529,119,124,5417.62,9731.38,0.00
2024-12-10 17:40:49,244,8528,119,125,5402.69,9731.57,0.00
2024-12-10 17:40:49,244,8529,119,125,5479.84,9732.00,0.00
2024-12-10 17:40:49,245,8529,119,126,5457.47,9732.00,0.00
2024-12-10 17:40:49,246,8528,120,126,5433.71,9732.03,0.00
2024-12-10 17:40:49,245,8528,119,126,5453.55,9732.12,0.00
2024-12-10 17:40:49,246,8527,119,127,5355.85,9732.91,0.00
2024-12-10 17:40:49,246,8528,119,127,5461.22,9733.00,0.00
2024-12-10 17:40:49,247,8528,120,127,5439.11,9733.00,0.00
2024-12-10 17:40:49,248,8527,121,127,5416.79,9733.02,0.00
2024-12-10 17:40:49,247,8527,120,127,5401.45,9733.58,0.00
2024-12-10 17:40:49,246,8527,119,127,5402.98,9733.79,0.00
2024-12-10 17:40:49,246,8528,119,127,5488.43,9734.00,0.00
2024-12-10 17:40:49,247,8528,120,127,5466.21,9734.00,0.00
2024-12-10 17:40:49,246,8528,120,126,5476.58,9734.06,0.00
2024-12-10 17:40:49,245,8528,119,126,5493.01,9734.12,0.00
2024-12-10 17:40:49,244,8528,118,126,5420.36,9734.96,0.00
2024-12-10 17:40:49,244,8529,118,126,5496.19,9735.00,0.00
2024-12-10 17:40:49,245,8529,119,126,5473.75,9735.00,0.00
2024-12-10 17:40:49,244,8529,118,126,5490.62,9735.06,0.00
2024-12-10 17:40:49,243,8529,118,125,5490.35,9735.12,0.00
2024-12-10 17:40:49,242,8529,118,124,5512.64,9735.12,0.00
2024-12-10 17:40:49,241,8529,118,123,5535.11,9735.12,0.00
2024-12-10 17:40:49,240,8529,117,123,5551.55,9735.18,0.00
2024-12-10 17:40:49,241,8528,118,123,5512.79,9735.35,0.00
2024-12-10 17:40:49,240,8528,117,123,5530.11,9735.42,0.00
2024-12-10 17:40:49,241,8527,118,123,5497.92,9735.52,0.00
2024-12-10 17:40:49,242,8526,118,124,5473.67,9735.65,0.00
2024-12-10 17:40:49,242,8527,118,124,5493.66,9736.00,0.00
2024-12-10 17:40:49,243,8527,119,124,5471.06,9736.00,0.00
2024-12-10 17:40:49,242,8527,119,123,5459.85,9736.12,0.00
2024-12-10 17:40:50,243,8526,120,123,5370.09,9736.81,0.00
2024-12-10 17:40:50,244,8525,120,124,5355.27,9736.82,0.00
2024-12-10 17:40:50,244,8526,120,124,5519.82,9737.00,0.00
2024-12-10 17:40:50,245,8526,121,124,5497.29,9737.00,0.00
2024-12-10 17:40:50,244,8526,121,123,5507.49,9737.09,0.00
2024-12-10 17:40:50,243,8526,121,122,5526.17,9737.12,0.00
2024-12-10 17:40:50,242,8526,120,122,5548.60,9737.12,0.00
2024-12-10 17:40:50,242,8527,120,122,5567.23,9738.00,0.00
2024-12-10 17:40:50,243,8527,120,123,5544.32,9738.00,0.00
2024-12-10 17:40:50,244,8526,121,123,5521.21,9738.02,0.00
2024-12-10 17:40:50,243,8526,121,122,5526.35,9738.13,0.00
2024-12-10 17:40:50,242,8526,121,121,5548.78,9738.13,0.00
2024-12-10 17:40:50,243,8525,122,121,5508.77,9738.31,0.00
2024-12-10 17:40:50,244,8524,122,122,5495.90,9738.53,0.00
2024-12-10 17:40:50,244,8525,122,122,5509.42,9739.00,0.00
2024-12-10 17:40:50,245,8525,123,122,5486.93,9739.00,0.00
2024-12-10 17:40:50,244,8525,122,122,5492.21,9739.10,0.00
2024-12-10 17:40:50,245,8524,123,122,5400.23,9739.80,0.00
2024-12-10 17:40:50,246,8523,124,122,5379.52,9739.87,0.00
2024-12-10 17:40:50,246,8524,124,122,5535.67,9740.00,0.00
2024-12-10 17:40:50,247,8524,124,123,5513.26,9740.00,0.00
2024-12-10 17:40:50,246,8524,123,123,5534.49,9740.01,0.00
2024-12-10 17:40:50,245,8524,122,123,5555.68,9740.02,0.00
2024-12-10 17:40:50,246,8523,122,124,5528.75,9740.08,0.00
2024-12-10 17:40:50,245,8523,122,123,5553.09,9740.12,0.00
2024-12-10 17:40:50,244,8523,121,123,5569.65,9740.19,0.00
2024-12-10 17:40:50,245,8522,121,124,5515.83,9740.49,0.00
2024-12-10 17:40:50,245,8523,121,124,5572.06,9741.00,0.00
2024-12-10 17:40:50,246,8523,121,125,5549.41,9741.00,0.00
2024-12-10 17:40:50,245,8523,121,124,5559.77,9741.08,0.00
2024-12-10 17:40:50,244,8523,120,124,5578.45,9741.12,0.00
2024-12-10 17:40:50,243,8523,120,123,5601.00,9741.12,0.00
2024-12-10 17:40:50,242,8523,120,122,5623.75,9741.12,0.00
2024-12-10 17:40:50,243,8522,120,123,5580.83,9741.31,0.00
2024-12-10 17:40:50,242,8522,119,123,5629.92,9741.34,0.00
2024-12-10 17:40:50,243,8521,119,124,5596.77,9741.44,0.00
2024-12-10 17:40:50,244,8520,120,124,5558.78,9741.65,0.00
2024-12-10 17:40:50,244,8521,120,124,5637.28,9742.00,0.00
2024-12-10 17:40:50,245,8521,120,125,5614.27,9742.00,0.00
2024-12-10 17:40:50,244,8521,120,124,5618.10,9742.12,0.00
2024-12-10 17:40:50,245,8520,121,124,5568.87,9742.37,0.00
2024-12-10 17:40:50,246,8519,122,124,5509.96,9742.78,0.00
2024-12-10 17:40:50,246,8520,122,124,5650.29,9743.00,0.00
2024-12-10 17:40:50,247,8520,123,124,5627.42,9743.00,0.00
2024-12-10 17:40:50,248,8519,123,125,5545.13,9743.52,0.00
2024-12-10 17:40:50,247,8519,122,125,5544.71,9743.80,0.00
2024-12-10 17:40:50,248,8518,123,125,5518.46,9743.85,0.00
2024-12-10 17:40:50,248,8519,123,125,5624.13,9744.00,0.00
2024-12-10 17:40:50,249,8519,123,126,5601.54,9744.00,0.00
2024-12-10 17:40:50,248,8519,123,125,5609.62,9744.08,0.00
2024-12-10 17:40:50,247,8519,122,125,5578.87,9744.57,0.00
2024-12-10 17:40:50,247,8520,122,125,5652.95,9745.00,0.00
2024-12-10 17:40:50,248,8520,123,125,5630.16,9745.00,0.00
2024-12-10 17:40:50,249,8519,124,125,5607.16,9745.02,0.00
2024-12-10 17:40:50,248,8519,123,125,5628.34,9745.05,0.00
2024-12-10 17:40:50,247,8519,123,124,5636.56,9745.12,0.00
2024-12-10 17:40:50,248,8518,124,124,5521.35,9745.91,0.00
2024-12-10 17:40:50,248,8519,124,124,5552.03,9746.00,0.00
2024-12-10 17:40:50,249,8519,125,124,5529.74,9746.00,0.00
2024-12-10 17:40:50,248,8519,125,123,5533.22,9746.11,0.00
2024-12-10 17:40:50,247,8519,124,123,5491.75,9746.74,0.00
2024-12-10 17:40:50,248,8518,125,123,5468.83,9746.75,0.00
2024-12-10 17:40:50,248,8519,125,123,5546.56,9747.00,0.00
2024-12-10 17:40:50,249,8519,125,124,5524.28,9747.00,0.00
2024-12-10 17:40:50,248,8519,124,124,5542.64,9747.04,0.00
2024-12-10 17:40:50,247,8519,123,124,5564.69,9747.04,0.00
2024-12-10 17:40:50,248,8518,123,125,5542.25,9747.05,0.00
2024-12-10 17:40:50,247,8518,123,124,5568.65,9747.07,0.00
2024-12-10 17:40:50,246,8518,123,123,5586.15,9747.12,0.00
2024-12-10 17:40:50,245,8518,123,122,5600.12,9747.21,0.00
2024-12-10 17:40:50,244,8518,122,122,5586.51,9747.57,0.00
2024-12-10 17:40:50,244,8519,122,122,5590.79,9748.00,0.00
2024-12-10 17:40:50,245,8519,123,122,5567.97,9748.00,0.00
2024-12-10 17:40:50,246,8518,124,122,5525.18,9748.14,0.00
2024-12-10 17:40:50,245,8518,123,122,5540.84,9748.29,0.00
2024-12-10 17:40:50,244,8518,123,121,5506.00,9748.76,0.00
2024-12-10 17:40:50,244,8519,123,121,5541.83,9749.00,0.00
2024-12-10 17:40:50,245,8519,123,122,5519.21,9749.00,0.00
2024-12-10 17:40:50,246,8518,124,122,5494.41,9749.04,0.00
2024-12-10 17:40:50,245,8518,124,121,5545.11,9749.07,0.00
2024-12-10 17:40:50,244,8518,123,121,5561.87,9749.13,0.00
2024-12-10 17:40:50,245,8517,124,121,5529.02,9749.23,0.00
2024-12-10 17:40:50,246,8516,124,122,5517.34,9749.46,0.00
2024-12-10 17:40:50,247,8515,124,123,5510.43,9749.53,0.00
2024-12-10 17:40:50,248,8514,124,124,5474.02,9749.75,0.00
2024-12-10 17:40:50,248,8515,124,124,5513.73,9750.00,0.00
2024-12-10 17:40:50,249,8515,124,125,5491.59,9750.00,0.00
2024-12-10 17:40:50,250,8514,125,125,5449.79,9750.14,0.00
2024-12-10 17:40:50,251,8513,126,125,5440.45,9750.41,0.00
2024-12-10 17:40:50,252,8512,127,125,5410.13,9750.54,0.00
2024-12-10 17:40:50,253,8511,127,126,5355.40,9750.94,0.00
2024-12-10 17:40:50,253,8512,127,126,5579.72,9751.00,0.00
2024-12-10 17:40:50,254,8512,127,127,5557.75,9751.00,0.00
2024-12-10 17:40:50,255,8511,128,127,5535.96,9751.01,0.00
2024-12-10 17:40:50,254,8511,127,127,5565.05,9751.02,0.00
2024-12-10 17:40:50,253,8511,126,127,5568.60,9751.12,0.00
2024-12-10 17:40:50,252,8511,126,126,5589.92,9751.13,0.00
2024-12-10 17:40:50,252,8512,126,126,5680.06,9752.00,0.00
2024-12-10 17:40:50,253,8512,127,126,5657.61,9752.00,0.00
2024-12-10 17:40:51,254,8511,128,126,5633.43,9752.03,0.00
2024-12-10 17:40:51,253,8511,127,126,5670.35,9752.04,0.00
2024-12-10 17:40:51,254,8510,128,126,5577.52,9752.72,0.00
2024-12-10 17:40:51,254,8511,128,126,5644.98,9753.00,0.00
2024-12-10 17:40:51,255,8511,128,127,5622.84,9753.00,0.00
2024-12-10 17:40:51,254,8511,127,127,5625.07,9753.13,0.00
2024-12-10 17:40:51,255,8510,128,127,5590.35,9753.26,0.00
2024-12-10 17:40:51,256,8509,128,128,5580.78,9753.45,0.00
2024-12-10 17:40:51,255,8509,127,128,5550.96,9753.83,0.00
2024-12-10 17:40:51,255,8510,127,128,5637.11,9754.00,0.00
2024-12-10 17:40:51,256,8510,128,128,5615.09,9754.00,0.00
2024-12-10 17:40:51,255,8510,127,128,5616.90,9754.13,0.00
2024-12-10 17:40:51,256,8509,127,129,5581.05,9754.26,0.00
2024-12-10 17:40:51,256,8510,127,129,5614.47,9755.00,0.00
2024-12-10 17:40:51,257,8510,128,129,5592.62,9755.00,0.00
2024-12-10 17:40:51,258,8509,129,129,5570.94,9755.01,0.00
2024-12-10 17:40:51,259,8508,129,130,5537.41,9755.08,0.00
2024-12-10 17:40:51,260,8507,129,131,5497.95,9755.48,0.00
2024-12-10 17:40:51,259,8507,129,130,5513.19,9755.54,0.00
2024-12-10 17:40:51,260,8506,130,130,5491.24,9755.56,0.00
2024-12-10 17:40:51,259,8506,130,129,5520.69,9755.61,0.00
2024-12-10 17:40:51,260,8505,130,130,5483.61,9755.72,0.00
2024-12-10 17:40:51,259,8505,129,130,5476.72,9755.98,0.00
2024-12-10 17:40:51,259,8506,129,130,5542.82,9756.00,0.00
2024-12-10 17:40:51,260,8506,130,130,5521.50,9756.00,0.00
2024-12-10 17:40:51,260,8507,130,130,5622.61,9757.00,0.00
2024-12-10 17:40:51,261,8507,130,131,5601.07,9757.00,0.00
2024-12-10 17:40:51,260,8507,130,130,5614.74,9757.02,0.00
2024-12-10 17:40:51,259,8507,129,130,5631.17,9757.07,0.00
2024-12-10 17:40:51,258,8507,128,130,5647.35,9757.13,0.00
2024-12-10 17:40:51,257,8507,127,130,5652.77,9757.30,0.00
2024-12-10 17:40:51,258,8506,127,131,5610.91,9757.51,0.00
2024-12-10 17:40:51,259,8505,128,131,5588.68,9757.56,0.00
2024-12-10 17:40:51,258,8505,127,131,5614.20,9757.68,0.00
2024-12-10 17:40:51,258,8506,127,131,5605.39,9758.00,0.00
2024-12-10 17:40:51,259,8506,128,131,5583.74,9758.00,0.00
2024-12-10 17:40:51,258,8506,128,130,5585.02,9758.13,0.00
2024-12-10 17:40:51,257,8506,127,130,5578.38,9758.42,0.00
2024-12-10 17:40:51,258,8505,128,130,5551.87,9758.48,0.00
2024-12-10 17:40:51,259,8504,128,131,5545.16,9758.54,0.00
2024-12-10 17:40:51,260,8503,128,132,5512.72,9758.86,0.00
2024-12-10 17:40:51,260,8504,128,132,5619.36,9759.00,0.00
2024-12-10 17:40:51,261,8504,128,133,5597.83,9759.00,0.00
2024-12-10 17:40:51,260,8504,128,132,5598.78,9759.14,0.00
2024-12-10 17:40:51,261,8503,129,132,5574.71,9759.17,0.00
2024-12-10 17:40:51,260,8503,128,132,5595.34,9759.32,0.00
2024-12-10 17:40:51,259,8503,127,132,5616.14,9759.32,0.00
2024-12-10 17:40:51,259,8504,127,132,5681.93,9760.00,0.00
2024-12-10 17:40:51,260,8504,128,132,5660.07,9760.00,0.00
2024-12-10 17:40:51,259,8504,127,132,5680.06,9760.02,0.00
2024-12-10 17:40:51,258,8504,127,131,5696.37,9760.05,0.00
2024-12-10 17:40:51,259,8503,128,131,5669.87,9760.10,0.00
2024-12-10 17:40:51,258,8503,128,130,5692.24,9760.13,0.00
2024-12-10 17:40:51,257,8503,128,129,5714.01,9760.13,0.00
2024-12-10 17:40:51,256,8503,127,129,5715.12,9760.35,0.00
2024-12-10 17:40:51,256,8504,127,129,5704.76,9761.00,0.00
2024-12-10 17:40:51,257,8504,128,129,5682.56,9761.00,0.00
2024-12-10 17:40:51,258,8503,128,130,5656.02,9761.06,0.00
2024-12-10 17:40:51,257,8503,127,130,5676.21,9761.29,0.00
2024-12-10 17:40:51,258,8502,128,130,5643.67,9761.40,0.00
2024-12-10 17:40:51,259,8501,129,130,5607.52,9761.76,0.00
2024-12-10 17:40:51,259,8502,129,130,5681.55,9762.00,0.00
2024-12-10 17:40:51,260,8502,130,130,5659.70,9762.00,0.00
2024-12-10 17:40:51,259,8502,129,130,5661.64,9762.13,0.00
2024-12-10 17:40:51,258,8502,129,129,5615.31,9762.67,0.00
2024-12-10 17:40:51,259,8501,130,129,5587.27,9762.74,0.00
2024-12-10 17:40:51,259,8502,130,129,5709.64,9763.00,0.00
2024-12-10 17:40:51,260,8502,130,130,5687.67,9763.00,0.00
2024-12-10 17:40:51,259,8502,129,130,5689.71,9763.13,0.00
2024-12-10 17:40:51,260,8501,129,131,5666.33,9763.15,0.00
2024-12-10 17:40:51,261,8500,129,132,5643.89,9763.22,0.00
2024-12-10 17:40:51,262,8499,129,133,5632.82,9763.32,0.00
2024-12-10 17:40:51,261,8499,128,133,5671.81,9763.36,0.00
2024-12-10 17:40:51,262,8498,129,133,5642.01,9763.45,0.00
2024-12-10 17:40:51,262,8499,129,133,5665.63,9764.00,0.00
2024-12-10 17:40:51,263,8499,130,133,5644.08,9764.00,0.00
2024-12-10 17:40:51,262,8499,130,132,5650.01,9764.08,0.00
2024-12-10 17:40:51,261,8499,129,132,5667.56,9764.12,0.00
2024-12-10 17:40:51,260,8499,129,131,5688.98,9764.12,0.00
2024-12-10 17:40:51,261,8498,130,131,5575.68,9764.90,0.00
2024-12-10 17:40:51,261,8499,130,131,5744.11,9765.00,0.00
2024-12-10 17:40:51,262,8499,131,131,5722.19,9765.00,0.00
2024-12-10 17:40:51,261,8499,130,131,5713.26,9765.24,0.00
2024-12-10 17:40:51,260,8499,130,130,5707.42,9765.45,0.00
2024-12-10 17:40:51,261,8498,131,130,5656.07,9765.74,0.00
2024-12-10 17:40:51,261,8499,131,130,5696.17,9766.00,0.00
2024-12-10 17:40:51,262,8499,132,130,5674.42,9766.00,0.00
2024-12-10 17:40:51,263,8498,132,131,5650.26,9766.04,0.00
2024-12-10 17:40:51,262,8498,132,130,5692.71,9766.05,0.00
2024-12-10 17:40:51,263,8497,133,130,5667.00,9766.10,0.00
2024-12-10 17:40:51,264,8496,134,130,5649.64,9766.21,0.00
2024-12-10 17:40:51,265,8495,135,130,5589.57,9766.85,0.00
2024-12-10 17:40:51,264,8495,134,130,5589.21,9766.96,0.00
2024-12-10 17:40:51,264,8496,134,130,5659.53,9767.00,0.00
2024-12-10 17:40:51,265,8496,134,131,5638.18,9767.00,0.00
2024-12-10 17:40:51,264,8496,134,130,5639.25,9767.13,0.00
2024-12-10 17:40:51,265,8495,134,131,5552.22,9767.75,0.00
2024-12-10 17:40:51,265,8496,134,131,5713.69,9768.00,0.00
2024-12-10 17:40:51,266,8496,135,131,5692.21,9768.00,0.00
2024-12-10 17:40:51,265,8496,134,131,5711.48,9768.02,0.00
2024-12-10 17:40:51,264,8496,134,130,5715.04,9768.13,0.00
2024-12-10 17:40:51,263,8496,134,129,5736.03,9768.13,0.00
2024-12-10 17:40:52,264,8495,134,130,5677.51,9768.49,0.00
2024-12-10 17:40:52,265,8494,135,130,5670.85,9768.53,0.00
2024-12-10 17:40:52,266,8493,135,131,5649.23,9768.64,0.00
2024-12-10 17:40:52,266,8494,135,131,5690.23,9769.00,0.00
2024-12-10 17:40:52,267,8494,136,131,5668.92,9769.00,0.00
2024-12-10 17:40:52,266,8494,136,130,5669.72,9769.14,0.00
2024-12-10 17:40:52,267,8493,136,131,5626.98,9769.36,0.00
2024-12-10 17:40:52,267,8494,136,131,5717.69,9770.00,0.00
2024-12-10 17:40:52,268,8494,136,132,5696.36,9770.00,0.00
2024-12-10 17:40:52,267,8494,136,131,5704.91,9770.06,0.00
2024-12-10 17:40:52,266,8494,136,130,5721.12,9770.11,0.00
2024-12-10 17:40:52,265,8494,136,129,5740.50,9770.13,0.00
2024-12-10 17:40:52,264,8494,136,128,5761.88,9770.13,0.00
2024-12-10 17:40:52,265,8493,136,129,5721.77,9770.32,0.00
2024-12-10 17:40:52,266,8492,137,129,5699.55,9770.37,0.00
2024-12-10 17:40:52,265,8492,136,129,5672.18,9770.85,0.00
2024-12-10 17:40:52,265,8493,136,129,5712.82,9771.00,0.00
2024-12-10 17:40:52,266,8493,137,129,5691.34,9771.00,0.00
2024-12-10 17:40:52,265,8493,136,129,5710.99,9771.02,0.00
2024-12-10 17:40:52,264,8493,136,128,5728.56,9771.04,0.00
2024-12-10 17:40:52,263,8493,135,128,5748.49,9771.06,0.00
2024-12-10 17:40:52,262,8493,135,127,5763.75,9771.12,0.00
2024-12-10 17:40:52,261,8493,134,127,5785.46,9771.12,0.00
2024-12-10 17:40:52,262,8492,134,128,5712.98,9771.61,0.00
2024-12-10 17:40:52,262,8493,134,128,5778.71,9772.00,0.00
2024-12-10 17:40:52,263,8493,135,128,5756.73,9772.00,0.00
2024-12-10 17:40:52,262,8493,135,127,5771.27,9772.04,0.00
2024-12-10 17:40:52,261,8493,135,126,5785.56,9772.12,0.00
2024-12-10 17:40:52,260,8493,134,126,5781.18,9772.29,0.00
2024-12-10 17:40:52,261,8492,134,127,5759.03,9772.30,0.00
2024-12-10 17:40:52,260,8492,134,126,5798.35,9772.39,0.00
2024-12-10 17:40:52,261,8491,135,126,5750.68,9772.65,0.00
2024-12-10 17:40:52,261,8492,135,126,5792.75,9773.00,0.00
2024-12-10 17:40:52,262,8492,136,126,5770.64,9773.00,0.00
2024-12-10 17:40:52,261,8492,136,125,5773.34,9773.12,0.00
2024-12-10 17:40:52,262,8491,136,126,5695.84,9773.61,0.00
2024-12-10 17:40:52,263,8490,137,126,5679.05,9773.67,0.00
2024-12-10 17:40:52,262,8490,137,125,5684.14,9773.85,0.00
2024-12-10 17:40:52,262,8491,137,125,5782.00,9774.00,0.00
2024-12-10 17:40:52,263,8491,137,126,5760.01,9774.00,0.00
2024-12-10 17:40:52,264,8490,137,127,5650.10,9774.83,0.00
2024-12-10 17:40:52,264,8491,137,127,5735.81,9775.00,0.00
2024-12-10 17:40:52,265,8491,137,128,5714.17,9775.00,0.00
2024-12-10 17:40:52,264,8491,137,127,5725.84,9775.05,0.00
2024-12-10 17:40:52,265,8490,138,127,5651.25,9775.59,0.00
2024-12-10 17:40:52,265,8491,138,127,5682.33,9776.00,0.00
2024-12-10 17:40:52,266,8491,138,128,5660.96,9776.00,0.00
2024-12-10 17:40:52,267,8490,139,128,5620.78,9776.13,0.00
2024-12-10 17:40:52,266,8490,139,127,5644.86,9776.13,0.00
2024-12-10 17:40:52,265,8490,138,127,5665.79,9776.13,0.00
2024-12-10 17:40:52,264,8490,138,126,5686.88,9776.13,0.00
2024-12-10 17:40:52,264,8491,138,126,5661.37,9777.00,0.00
2024-12-10 17:40:52,265,8491,139,126,5640.00,9777.00,0.00
2024-12-10 17:40:52,264,8491,138,126,5587.09,9777.56,0.00
2024-12-10 17:40:52,264,8492,138,126,5614.71,9778.00,0.00
2024-12-10 17:40:52,265,8492,138,127,5593.52,9778.00,0.00
2024-12-10 17:40:52,264,8492,138,126,5608.80,9778.05,0.00
2024-12-10 17:40:52,263,8492,137,126,5622.73,9778.13,0.00
2024-12-10 17:40:52,264,8491,137,127,5543.62,9778.72,0.00
2024-12-10 17:40:52,264,8492,137,127,5543.95,9779.00,0.00
2024-12-10 17:40:52,265,8492,137,128,5523.03,9779.00,0.00
2024-12-10 17:40:52,264,8492,137,127,5529.54,9779.07,0.00
2024-12-10 17:40:52,263,8492,137,126,5545.02,9779.13,0.00
2024-12-10 17:40:52,262,8492,137,125,5565.81,9779.13,0.00
2024-12-10 17:40:52,261,8492,136,125,5516.65,9779.80,0.00
2024-12-10 17:40:52,262,8491,137,125,5476.95,9779.94,0.00
2024-12-10 17:40:52,262,8492,137,125,5548.66,9780.00,0.00
2024-12-10 17:40:52,263,8492,138,125,5527.57,9780.00,0.00
2024-12-10 17:40:52,262,8492,137,125,5544.58,9780.04,0.00
2024-12-10 17:40:52,261,8492,137,124,5553.10,9780.09,0.00
2024-12-10 17:40:52,260,8492,137,123,5571.47,9780.12,0.00
2024-12-10 17:40:52,259,8492,137,122,5591.85,9780.13,0.00
2024-12-10 17:40:52,258,8492,136,122,5607.78,9780.19,0.00
2024-12-10 17:40:52,257,8492,135,122,5616.57,9780.32,0.00
2024-12-10 17:40:52,258,8491,136,122,5565.72,9780.61,0.00
2024-12-10 17:40:52,257,8491,136,121,5561.77,9780.79,0.00
2024-12-10 17:40:52,257,8492,136,121,5617.88,9781.00,0.00
2024-12-10 17:40:52,258,8492,137,121,5596.10,9781.00,0.00
2024-12-10 17:40:52,257,8492,137,120,5597.77,9781.13,0.00
2024-12-10 17:40:52,258,8491,138,120,5546.24,9781.44,0.00
2024-12-10 17:40:52,258,8492,138,120,5572.47,9782.00,0.00
2024-12-10 17:40:52,259,8492,138,121,5550.95,9782.00,0.00
2024-12-10 17:40:52,258,8492,138,120,5560.36,9782.06,0.00
2024-12-10 17:40:52,259,8491,139,120,5534.38,9782.11,0.00
2024-12-10 17:40:52,258,8491,138,120,5498.96,9782.74,0.00
2024-12-10 17:40:52,258,8492,138,120,5534.81,9783.00,0.00
2024-12-10 17:40:52,259,8492,138,121,5513.44,9783.00,0.00
2024-12-10 17:40:52,258,8492,137,121,5529.90,9783.04,0.00
2024-12-10 17:40:52,257,8492,136,121,5535.09,9783.12,0.00
2024-12-10 17:40:52,256,8492,135,121,5556.33,9783.12,0.00
2024-12-10 17:40:52,255,8492,134,121,5534.97,9783.55,0.00
2024-12-10 17:40:52,256,8491,135,121,5503.85,9783.65,0.00
2024-12-10 17:40:52,257,8490,136,121,5501.54,9783.75,0.00
2024-12-10 17:40:52,258,8489,136,122,5482.93,9783.83,0.00
2024-12-10 17:40:53,258,8490,136,122,5549.43,9784.00,0.00
2024-12-10 17:40:53,259,8490,137,122,5528.00,9784.00,0.00
2024-12-10 17:40:53,258,8490,136,122,5542.24,9784.03,0.00
2024-12-10 17:40:53,257,8490,136,121,5553.15,9784.06,0.00
2024-12-10 17:40:53,256,8490,136,120,5568.76,9784.11,0.00
2024-12-10 17:40:53,257,8489,137,120,5527.37,9784.32,0.00
2024-12-10 17:40:53,258,8488,138,120,5513.92,9784.35,0.00
2024-12-10 17:40:53,257,8488,138,119,5548.87,9784.46,0.00
2024-12-10 17:40:53,257,8489,138,119,5648.24,9785.00,0.00
2024-12-10 17:40:53,258,8489,138,120,5626.34,9785.00,0.00
2024-12-10 17:40:53,257,8489,137,120,5644.83,9785.04,0.00
2024-12-10 17:40:53,256,8489,137,119,5664.21,9785.05,0.00
2024-12-10 17:40:53,255,8489,137,118,5680.69,9785.11,0.00
2024-12-10 17:40:53,256,8488,138,118,5598.70,9785.57,0.00
2024-12-10 17:40:53,256,8489,138,118,5687.70,9786.00,0.00
2024-12-10 17:40:53,257,8489,139,118,5665.56,9786.00,0.00
2024-12-10 17:40:53,257,8490,139,118,5621.97,9787.00,0.00
2024-12-10 17:40:53,258,8490,140,118,5600.18,9787.00,0.00
2024-12-10 17:40:53,257,8490,140,117,5615.52,9787.05,0.00
2024-12-10 17:40:53,256,8490,140,116,5630.99,9787.11,0.00
2024-12-10 17:40:53,255,8490,140,115,5652.69,9787.11,0.00
2024-12-10 17:40:53,254,8490,140,114,5674.18,9787.12,0.00
2024-12-10 17:40:53,255,8489,141,114,5630.89,9787.34,0.00
2024-12-10 17:40:53,254,8489,140,114,5645.08,9787.56,0.00
2024-12-10 17:40:53,255,8488,140,115,5609.98,9787.70,0.00
2024-12-10 17:40:53,255,8489,140,115,5627.49,9788.00,0.00
2024-12-10 17:40:53,256,8489,141,115,5605.51,9788.00,0.00
2024-12-10 17:40:53,257,8488,142,115,5560.53,9788.17,0.00
2024-12-10 17:40:53,257,8488,142,115,5602.61,9789.00,0.00
2024-12-10 17:40:53,258,8488,142,116,5580.89,9789.00,0.00
2024-12-10 17:40:53,259,8487,143,116,5558.97,9789.02,0.00
2024-12-10 17:40:53,260,8486,143,117,5541.38,9789.07,0.00
2024-12-10 17:40:53,261,8485,144,117,5487.39,9789.62,0.00
2024-12-10 17:40:53,260,8485,143,117,5502.62,9789.83,0.00
2024-12-10 17:40:53,261,8484,144,117,5477.81,9789.87,0.00
2024-12-10 17:40:53,261,8485,144,117,5538.14,9790.00,0.00
2024-12-10 17:40:53,262,8485,145,117,5517.00,9790.00,0.00
2024-12-10 17:40:53,263,8484,145,118,5409.23,9790.83,0.00
2024-12-10 17:40:53,263,8485,145,118,5572.12,9791.00,0.00
2024-12-10 17:40:53,264,8485,146,118,5551.02,9791.00,0.00
2024-12-10 17:40:53,265,8484,146,119,5530.07,9791.01,0.00
2024-12-10 17:40:53,266,8483,146,120,5518.87,9791.05,0.00
2024-12-10 17:40:53,265,8483,146,119,5542.66,9791.06,0.00
2024-12-10 17:40:53,264,8483,145,119,5557.01,9791.13,0.00
2024-12-10 17:40:53,265,8482,145,120,5482.36,9791.67,0.00
2024-12-10 17:40:53,265,8483,145,120,5522.52,9792.00,0.00
2024-12-10 17:40:53,266,8483,146,120,5501.76,9792.00,0.00
2024-12-10 17:40:53,265,8483,146,119,5503.37,9792.12,0.00
2024-12-10 17:40:53,266,8482,146,120,5448.03,9792.44,0.00
2024-12-10 17:40:53,267,8481,147,120,5436.50,9792.57,0.00
2024-12-10 17:40:53,267,8482,147,120,5543.35,9793.00,0.00
2024-12-10 17:40:53,268,8482,147,121,5522.67,9793.00,0.00
2024-12-10 17:40:53,269,8481,147,122,5488.34,9793.08,0.00
2024-12-10 17:40:53,268,8481,147,121,5507.74,9793.12,0.00
2024-12-10 17:40:53,267,8481,146,121,5528.00,9793.12,0.00
2024-12-10 17:40:53,268,8480,146,122,5480.83,9793.39,0.00
2024-12-10 17:40:53,268,8481,146,122,5550.77,9794.00,0.00
2024-12-10 17:40:53,269,8481,146,123,5530.13,9794.00,0.00
2024-12-10 17:40:53,270,8480,146,124,5460.98,9794.42,0.00
2024-12-10 17:40:53,271,8479,147,124,5415.19,9794.66,0.00
2024-12-10 17:40:53,272,8478,148,124,5402.13,9794.67,0.00
2024-12-10 17:40:53,272,8479,148,124,5483.29,9795.00,0.00
2024-12-10 17:40:53,273,8479,149,124,5463.20,9795.00,0.00
2024-12-10 17:40:53,273,8480,149,124,5486.08,9796.00,0.00
2024-12-10 17:40:53,274,8480,150,124,5466.06,9796.00,0.00
2024-12-10 17:40:53,273,8480,150,123,5476.06,9796.06,0.00
2024-12-10 17:40:53,272,8480,149,123,5489.38,9796.12,0.00
2024-12-10 17:40:53,271,8480,148,123,5509.27,9796.12,0.00
2024-12-10 17:40:53,270,8480,147,123,5529.31,9796.12,0.00
2024-12-10 17:40:53,269,8480,146,123,5549.14,9796.13,0.00
2024-12-10 17:40:53,270,8479,147,123,5526.06,9796.16,0.00
2024-12-10 17:40:53,269,8479,146,123,5539.54,9796.57,0.00
2024-12-10 17:40:53,270,8478,146,124,5481.94,9796.96,0.00
2024-12-10 17:40:53,270,8479,146,124,5501.21,9797.00,0.00
2024-12-10 17:40:53,271,8479,146,125,5480.91,9797.00,0.00
2024-12-10 17:40:53,272,8478,147,125,5431.06,9797.14,0.00
2024-12-10 17:40:53,271,8478,146,125,5445.74,9797.29,0.00
2024-12-10 17:40:53,272,8477,146,126,5414.60,9797.41,0.00
2024-12-10 17:40:53,271,8477,145,126,5443.27,9797.43,0.00
2024-12-10 17:40:53,272,8476,146,126,5384.24,9797.83,0.00
2024-12-10 17:40:53,272,8477,146,126,5482.00,9798.00,0.00
2024-12-10 17:40:53,273,8477,147,126,5461.92,9798.00,0.00
2024-12-10 17:40:53,272,8477,146,126,5459.93,9798.11,0.00
2024-12-10 17:40:53,271,8477,145,126,5461.45,9798.30,0.00
2024-12-10 17:40:53,270,8477,144,126,5435.84,9798.77,0.00
2024-12-10 17:40:53,270,8478,144,126,5558.32,9799.00,0.00
2024-12-10 17:40:53,271,8478,145,126,5537.81,9799.00,0.00
2024-12-10 17:40:53,270,8478,145,125,5552.18,9799.06,0.00
2024-12-10 17:40:53,269,8478,145,124,5569.92,9799.08,0.00
2024-12-10 17:40:53,270,8477,146,124,5509.89,9799.49,0.00
2024-12-10 17:40:53,271,8476,147,124,5492.19,9799.67,0.00
2024-12-10 17:40:53,271,8477,147,124,5494.26,9800.00,0.00
2024-12-10 17:40:53,272,8477,148,124,5474.06,9800.00,0.00
2024-12-10 17:40:53,271,8477,147,124,5491.02,9800.03,0.00
2024-12-10 17:40:53,272,8476,147,125,5458.97,9800.09,0.00
2024-12-10 17:40:53,271,8476,147,124,5497.94,9800.13,0.00
2024-12-10 17:40:54,272,8475,147,125,5412.49,9800.81,0.00
2024-12-10 17:40:54,272,8476,147,125,5524.22,9801.00,0.00
2024-12-10 17:40:54,273,8476,147,126,5503.98,9801.00,0.00
2024-12-10 17:40:54,272,8476,147,125,5520.27,9801.04,0.00
2024-12-10 17:40:54,271,8476,147,124,5524.05,9801.13,0.00
2024-12-10 17:40:54,271,8477,147,124,5533.59,9802.00,0.00
2024-12-10 17:40:54,272,8477,148,124,5513.25,9802.00,0.00
2024-12-10 17:40:54,271,8477,148,123,5527.12,9802.07,0.00
2024-12-10 17:40:54,272,8476,149,123,5461.28,9802.54,0.00
2024-12-10 17:40:54,272,8477,149,123,5455.83,9803.00,0.00
2024-12-10 17:40:54,273,8477,150,123,5435.85,9803.00,0.00
2024-12-10 17:40:54,272,8477,150,122,5445.05,9803.07,0.00
2024-12-10 17:40:54,271,8477,150,121,5458.30,9803.13,0.00
2024-12-10 17:40:54,270,8477,149,121,5465.14,9803.27,0.00
2024-12-10 17:40:54,271,8476,149,122,5435.18,9803.36,0.00
2024-12-10 17:40:54,272,8475,150,122,5396.56,9803.58,0.00
2024-12-10 17:40:54,271,8475,149,122,5408.75,9803.69,0.00
2024-12-10 17:40:54,272,8474,149,123,5382.42,9803.76,0.00
2024-12-10 17:40:54,272,8475,149,123,5440.19,9804.00,0.00
2024-12-10 17:40:54,273,8475,150,123,5420.26,9804.00,0.00
2024-12-10 17:40:54,274,8474,150,124,5381.93,9804.13,0.00
2024-12-10 17:40:54,274,8475,150,124,5429.16,9805.00,0.00
2024-12-10 17:40:54,275,8475,151,124,5409.42,9805.00,0.00
2024-12-10 17:40:54,274,8475,151,123,5417.03,9805.07,0.00
2024-12-10 17:40:54,273,8475,150,123,5429.54,9805.14,0.00
2024-12-10 17:40:54,274,8474,150,124,5387.99,9805.35,0.00
2024-12-10 17:40:54,273,8474,149,124,5369.46,9805.74,0.00
2024-12-10 17:40:54,274,8473,150,124,5345.96,9805.79,0.00
2024-12-10 17:40:54,274,8474,150,124,5404.18,9806.00,0.00
2024-12-10 17:40:54,275,8474,151,124,5384.52,9806.00,0.00
2024-12-10 17:40:54,274,8474,151,123,5383.12,9806.14,0.00
2024-12-10 17:40:54,273,8474,150,123,5372.49,9806.44,0.00
2024-12-10 17:40:54,274,8473,151,123,5352.53,9806.45,0.00
2024-12-10 17:40:54,275,8472,152,123,5333.87,9806.61,0.00
2024-12-10 17:40:54,276,8471,153,123,5299.75,9806.79,0.00
2024-12-10 17:40:54,276,8472,153,123,5390.34,9807.00,0.00
2024-12-10 17:40:54,277,8472,153,124,5370.88,9807.00,0.00
2024-12-10 17:40:54,276,8472,153,123,5369.44,9807.14,0.00
2024-12-10 17:40:54,275,8472,152,123,5359.33,9807.44,0.00
2024-12-10 17:40:54,276,8471,153,123,5326.13,9807.58,0.00
2024-12-10 17:40:54,277,8470,153,124,5312.99,9807.69,0.00
2024-12-10 17:40:54,277,8471,153,124,5431.69,9808.00,0.00
2024-12-10 17:40:54,278,8471,154,124,5412.15,9808.00,0.00
2024-12-10 17:40:54,277,8471,154,123,5410.51,9808.15,0.00
2024-12-10 17:40:54,276,8471,153,123,5429.76,9808.15,0.00
2024-12-10 17:40:54,275,8471,152,123,5449.14,9808.15,0.00
2024-12-10 17:40:54,276,8470,152,124,5352.84,9808.93,0.00
2024-12-10 17:40:54,276,8471,152,124,5447.63,9809.00,0.00
2024-12-10 17:40:54,277,8471,152,125,5427.96,9809.00,0.00
2024-12-10 17:40:54,276,8471,151,125,5444.80,9809.03,0.00
2024-12-10 17:40:54,275,8471,151,124,5448.23,9809.12,0.00
2024-12-10 17:40:54,274,8471,151,123,5465.97,9809.14,0.00
2024-12-10 17:40:54,273,8471,151,122,5485.64,9809.14,0.00
2024-12-10 17:40:54,272,8471,151,121,5505.44,9809.14,0.00
2024-12-10 17:40:54,273,8470,152,121,5475.60,9809.25,0.00
2024-12-10 17:40:54,274,8469,152,122,5450.78,9809.61,0.00
2024-12-10 17:40:54,274,8470,152,122,5485.70,9810.00,0.00
2024-12-10 17:40:54,275,8470,152,123,5465.75,9810.00,0.00
2024-12-10 17:40:54,274,8470,152,122,5476.06,9810.06,0.00
2024-12-10 17:40:54,273,8470,152,121,5488.60,9810.14,0.00
2024-12-10 17:40:54,274,8469,152,122,5465.35,9810.18,0.00
2024-12-10 17:40:54,273,8469,151,122,5469.52,9810.43,0.00
2024-12-10 17:40:54,273,8470,151,122,5505.95,9811.00,0.00
2024-12-10 17:40:54,274,8470,151,123,5485.86,9811.00,0.00
2024-12-10 17:40:54,273,8470,151,122,5485.52,9811.14,0.00
2024-12-10 17:40:54,272,8470,150,122,5505.33,9811.14,0.00
2024-12-10 17:40:54,272,8471,150,122,5482.70,9812.00,0.00
2024-12-10 17:40:54,273,8471,150,123,5462.61,9812.00,0.00
2024-12-10 17:40:54,272,8471,149,123,5462.19,9812.14,0.00
2024-12-10 17:40:54,271,8471,148,123,5468.25,9812.28,0.00
2024-12-10 17:40:54,272,8470,148,124,5442.76,9812.34,0.00
2024-12-10 17:40:54,272,8471,148,124,5412.78,9813.00,0.00
2024-12-10 17:40:54,273,8471,149,124,5392.95,9813.00,0.00
2024-12-10 17:40:54,272,8471,149,123,5402.34,9813.07,0.00
2024-12-10 17:40:54,271,8471,149,122,5415.42,9813.14,0.00
2024-12-10 17:40:54,272,8470,149,123,5364.24,9813.46,0.00
2024-12-10 17:40:54,273,8469,149,124,5347.94,9813.65,0.00
2024-12-10 17:40:54,272,8469,148,124,5366.34,9813.74,0.00
2024-12-10 17:40:54,272,8470,148,124,5411.26,9814.00,0.00
2024-12-10 17:40:54,273,8470,148,125,5391.44,9814.00,0.00
2024-12-10 17:40:54,272,8470,148,124,5399.38,9814.07,0.00
2024-12-10 17:40:54,271,8470,147,124,5416.93,9814.09,0.00
2024-12-10 17:40:54,270,8470,146,124,5433.01,9814.13,0.00
2024-12-10 17:40:54,270,8471,146,124,5439.14,9815.00,0.00
2024-12-10 17:40:54,271,8471,147,124,5419.07,9815.00,0.00
2024-12-10 17:40:54,270,8471,146,124,5424.24,9815.03,0.00
2024-12-10 17:40:54,269,8471,146,123,5437.49,9815.07,0.00
2024-12-10 17:40:54,268,8471,145,123,5452.31,9815.12,0.00
2024-12-10 17:40:54,267,8471,145,122,5472.36,9815.12,0.00
2024-12-10 17:40:54,266,8471,144,122,5475.56,9815.30,0.00
2024-12-10 17:40:54,266,8472,144,122,5439.04,9816.00,0.00
2024-12-10 17:40:54,267,8472,144,123,5418.67,9816.00,0.00
2024-12-10 17:40:54,266,8472,143,123,5435.74,9816.03,0.00
2024-12-10 17:40:54,265,8472,142,123,5439.99,9816.12,0.00
2024-12-10 17:40:54,266,8471,143,123,5373.56,9816.59,0.00
2024-12-10 17:40:54,267,8470,143,124,5337.56,9816.75,0.00
2024-12-10 17:40:55,267,8471,143,124,5357.47,9817.00,0.00
2024-12-10 17:40:55,268,8471,144,124,5337.48,9817.00,0.00
2024-12-10 17:40:55,267,8471,143,124,5353.81,9817.04,0.00
2024-12-10 17:40:55,266,8471,142,124,5372.10,9817.05,0.00
2024-12-10 17:40:55,267,8470,142,125,5342.79,9817.08,0.00
2024-12-10 17:40:55,266,8470,141,125,5365.48,9817.12,0.00
2024-12-10 17:40:55,265,8470,140,125,5384.99,9817.13,0.00
2024-12-10 17:40:55,266,8469,140,126,5351.86,9817.26,0.00
2024-12-10 17:40:55,267,8468,141,126,5264.37,9817.92,0.00
2024-12-10 17:40:55,267,8469,141,126,5370.34,9818.00,0.00
2024-12-10 17:40:55,268,8469,142,126,5350.30,9818.00,0.00
2024-12-10 17:40:55,267,8469,141,126,5350.53,9818.13,0.00
2024-12-10 17:40:55,266,8469,140,126,5287.11,9818.71,0.00
2024-12-10 17:40:55,266,8470,140,126,5404.96,9819.00,0.00
2024-12-10 17:40:55,267,8470,141,126,5384.72,9819.00,0.00
2024-12-10 17:40:55,266,8470,141,125,5395.76,9819.06,0.00
2024-12-10 17:40:55,265,8470,141,124,5409.48,9819.13,0.00
2024-12-10 17:40:55,264,8470,140,124,5429.60,9819.13,0.00
2024-12-10 17:40:55,265,8469,140,125,5361.29,9819.60,0.00
2024-12-10 17:40:55,266,8468,140,126,5328.45,9819.89,0.00
2024-12-10 17:40:55,267,8467,141,126,5305.99,9819.97,0.00
2024-12-10 17:40:55,267,8468,141,126,5326.25,9820.00,0.00
2024-12-10 17:40:55,268,8468,142,126,5306.38,9820.00,0.00
2024-12-10 17:40:55,267,8468,142,125,5298.82,9820.13,0.00
2024-12-10 17:40:55,266,8468,141,125,5230.73,9820.82,0.00
2024-12-10 17:40:55,266,8469,141,125,5350.10,9821.00,0.00
2024-12-10 17:40:55,267,8469,141,126,5330.06,9821.00,0.00
2024-12-10 17:40:55,266,8469,140,126,5270.49,9821.58,0.00
2024-12-10 17:40:55,266,8470,140,126,5232.71,9822.00,0.00
2024-12-10 17:40:55,267,8470,141,126,5213.11,9822.00,0.00
2024-12-10 17:40:55,266,8470,141,125,5222.76,9822.06,0.00
2024-12-10 17:40:55,265,8470,141,124,5125.85,9822.99,0.00
2024-12-10 17:40:55,265,8471,141,124,5146.62,9823.00,0.00
2024-12-10 17:40:55,266,8471,142,124,5127.27,9823.00,0.00
2024-12-10 17:40:55,265,8471,142,123,5139.60,9823.07,0.00
2024-12-10 17:40:55,264,8471,142,122,5152.77,9823.13,0.00
2024-12-10 17:40:55,263,8471,142,121,5171.99,9823.13,0.00
2024-12-10 17:40:55,262,8471,141,121,5155.01,9823.35,0.00
2024-12-10 17:40:55,262,8472,141,121,5112.39,9824.00,0.00
2024-12-10 17:40:55,263,8472,142,121,5092.95,9824.00,0.00
2024-12-10 17:40:55,264,8471,143,121,5069.21,9824.06,0.00
2024-12-10 17:40:55,265,8470,144,121,5055.67,9824.11,0.00
2024-12-10 17:40:55,266,8469,144,122,5050.33,9824.12,0.00
2024-12-10 17:40:55,265,8469,143,122,5087.22,9824.23,0.00
2024-12-10 17:40:55,264,8469,142,122,5065.35,9824.61,0.00
2024-12-10 17:40:55,263,8469,141,122,5078.56,9824.62,0.00
2024-12-10 17:40:55,263,8470,141,122,5075.07,9825.00,0.00
2024-12-10 17:40:55,264,8470,142,122,5055.84,9825.00,0.00
2024-12-10 17:40:55,263,8470,141,122,5069.11,9825.06,0.00
2024-12-10 17:40:55,262,8470,141,121,5083.96,9825.06,0.00
2024-12-10 17:40:55,261,8470,140,121,5096.32,9825.13,0.00
2024-12-10 17:40:55,260,8470,139,121,5053.41,9825.72,0.00
2024-12-10 17:40:55,260,8471,139,121,5161.27,9826.00,0.00
2024-12-10 17:40:55,261,8471,139,122,5141.50,9826.00,0.00
2024-12-10 17:40:55,260,8471,138,122,5140.54,9826.14,0.00
2024-12-10 17:40:55,259,8471,137,122,5100.05,9826.71,0.00
2024-12-10 17:40:55,260,8470,137,123,5064.93,9826.83,0.00
2024-12-10 17:40:55,260,8471,137,123,5091.64,9827.00,0.00
2024-12-10 17:40:55,261,8471,137,124,5072.14,9827.00,0.00
2024-12-10 17:40:55,262,8470,138,124,5029.21,9827.18,0.00
2024-12-10 17:40:55,262,8471,138,124,5044.68,9828.00,0.00
2024-12-10 17:40:55,263,8471,138,125,5025.50,9828.00,0.00
2024-12-10 17:40:55,262,8471,137,125,5029.33,9828.08,0.00
2024-12-10 17:40:55,261,8471,136,125,5043.35,9828.13,0.00
2024-12-10 17:40:55,260,8471,136,124,5062.37,9828.13,0.00
2024-12-10 17:40:55,259,8471,135,124,5081.16,9828.14,0.00
2024-12-10 17:40:55,260,8470,135,125,5002.62,9828.69,0.00
2024-12-10 17:40:55,261,8469,136,125,4980.09,9828.75,0.00
2024-12-10 17:40:55,262,8468,137,125,4943.86,9828.98,0.00
2024-12-10 17:40:55,262,8469,137,125,5018.15,9829.00,0.00
2024-12-10 17:40:55,263,8469,138,125,4999.07,9829.00,0.00
2024-12-10 17:40:55,262,8469,138,124,5006.17,9829.06,0.00
2024-12-10 17:40:55,263,8468,139,124,4985.27,9829.09,0.00
2024-12-10 17:40:55,262,8468,139,123,5000.57,9829.14,0.00
2024-12-10 17:40:55,261,8468,138,123,5019.35,9829.14,0.00
2024-12-10 17:40:55,262,8467,139,123,4941.05,9829.70,0.00
2024-12-10 17:40:55,261,8467,138,123,4965.11,9829.73,0.00
2024-12-10 17:40:55,261,8468,138,123,5081.16,9830.00,0.00
2024-12-10 17:40:55,262,8468,139,123,5061.77,9830.00,0.00
2024-12-10 17:40:55,261,8468,138,123,5079.66,9830.02,0.00
2024-12-10 17:40:55,260,8468,137,123,5079.59,9830.14,0.00
2024-12-10 17:40:55,259,8468,137,122,5050.03,9830.51,0.00
2024-12-10 17:40:55,259,8469,137,122,5104.59,9831.00,0.00
2024-12-10 17:40:55,260,8469,138,122,5084.96,9831.00,0.00
2024-12-10 17:40:55,259,8469,138,121,5091.71,9831.06,0.00
2024-12-10 17:40:55,258,8469,138,120,5103.86,9831.14,0.00
2024-12-10 17:40:55,257,8469,138,119,5123.33,9831.14,0.00
2024-12-10 17:40:55,258,8468,139,119,5070.06,9831.48,0.00
2024-12-10 17:40:55,257,8468,138,119,5107.77,9831.49,0.00
2024-12-10 17:40:55,256,8468,137,119,5114.12,9831.62,0.00
2024-12-10 17:40:55,255,8468,137,118,5101.78,9831.88,0.00
2024-12-10 17:40:55,255,8469,137,118,5128.48,9832.00,0.00
2024-12-10 17:40:55,256,8469,138,118,5108.45,9832.00,0.00
2024-12-10 17:40:55,255,8469,137,118,5127.33,9832.01,0.00
2024-12-10 17:40:55,254,8469,137,117,5135.53,9832.06,0.00
2024-12-10 17:40:55,253,8469,137,116,5148.48,9832.13,0.00
2024-12-10 17:40:55,253,8470,137,116,5122.55,9833.00,0.00
2024-12-10 17:40:55,254,8470,138,116,5102.38,9833.00,0.00
2024-12-10 17:40:55,253,8470,137,116,5101.62,9833.14,0.00
2024-12-10 17:40:55,254,8469,138,116,5068.79,9833.27,0.00
2024-12-10 17:40:56,253,8469,137,116,5042.40,9833.78,0.00
2024-12-10 17:40:56,253,8470,137,116,5058.59,9834.00,0.00
2024-12-10 17:40:56,254,8470,137,117,5038.68,9834.00,0.00
2024-12-10 17:40:56,253,8470,136,117,5055.00,9834.04,0.00
2024-12-10 17:40:56,252,8470,136,116,5066.88,9834.06,0.00
2024-12-10 17:40:56,251,8470,135,116,5079.26,9834.13,0.00
2024-12-10 17:40:56,251,8471,135,116,5052.17,9835.00,0.00
2024-12-10 17:40:56,252,8471,135,117,5032.12,9835.00,0.00
2024-12-10 17:40:56,251,8471,134,117,5042.00,9835.04,0.00
2024-12-10 17:40:56,250,8471,133,117,5045.68,9835.13,0.00
2024-12-10 17:40:56,249,8471,132,117,5048.83,9835.30,0.00
2024-12-10 17:40:56,249,8472,132,117,5014.29,9836.00,0.00
2024-12-10 17:40:56,250,8472,132,118,4994.23,9836.00,0.00
2024-12-10 17:40:56,249,8472,132,117,5008.39,9836.06,0.00
2024-12-10 17:40:56,248,8472,132,116,5020.69,9836.13,0.00
2024-12-10 17:40:56,247,8472,131,116,5037.94,9836.15,0.00
2024-12-10 17:40:56,246,8472,131,115,5057.24,9836.16,0.00
2024-12-10 17:40:56,247,8471,131,116,5031.61,9836.22,0.00
2024-12-10 17:40:56,246,8471,130,116,5053.41,9836.54,0.00
2024-12-10 17:40:56,247,8470,130,117,5026.61,9836.61,0.00
2024-12-10 17:40:56,247,8471,130,117,5044.71,9837.00,0.00
2024-12-10 17:40:56,248,8471,130,118,5024.37,9837.00,0.00
2024-12-10 17:40:56,247,8471,129,118,5023.66,9837.13,0.00
2024-12-10 17:40:56,248,8470,130,118,4954.58,9837.58,0.00
2024-12-10 17:40:56,249,8469,130,119,4953.25,9837.59,0.00
2024-12-10 17:40:56,250,8468,130,120,4914.20,9837.85,0.00
2024-12-10 17:40:56,250,8469,130,120,5025.30,9838.00,0.00
2024-12-10 17:40:56,251,8469,130,121,5005.28,9838.00,0.00
2024-12-10 17:40:56,250,8469,130,120,5004.49,9838.13,0.00
2024-12-10 17:40:56,249,8469,130,119,5024.20,9838.13,0.00
2024-12-10 17:40:56,248,8469,129,119,4999.26,9838.54,0.00
2024-12-10 17:40:56,248,8470,129,119,5110.80,9839.00,0.00
2024-12-10 17:40:56,249,8470,129,120,5090.27,9839.00,0.00
2024-12-10 17:40:56,248,8470,129,119,5095.36,9839.08,0.00
2024-12-10 17:40:56,249,8469,129,120,5026.08,9839.53,0.00
2024-12-10 17:40:56,249,8470,129,120,5016.82,9840.00,0.00
2024-12-10 17:40:56,250,8470,130,120,4996.75,9840.00,0.00
2024-12-10 17:40:56,249,8470,129,120,5014.85,9840.02,0.00
2024-12-10 17:40:56,248,8470,129,119,5027.15,9840.06,0.00
2024-12-10 17:40:56,249,8469,129,120,5003.81,9840.10,0.00
2024-12-10 17:40:56,248,8469,129,119,5038.30,9840.13,0.00
2024-12-10 17:40:56,249,8468,130,119,5005.84,9840.27,0.00
2024-12-10 17:40:56,248,8468,129,119,5021.23,9840.46,0.00
2024-12-10 17:40:56,247,8468,128,119,5008.89,9840.68,0.00
2024-12-10 17:40:56,248,8467,128,120,4959.47,9840.96,0.00
2024-12-10 17:40:56,248,8468,128,120,5036.48,9841.00,0.00
2024-12-10 17:40:56,249,8468,128,121,5016.26,9841.00,0.00
2024-12-10 17:40:56,248,8468,128,120,5015.90,9841.13,0.00
2024-12-10 17:40:56,247,8468,128,119,5035.81,9841.13,0.00
2024-12-10 17:40:56,246,8468,127,119,5045.72,9841.24,0.00
2024-12-10 17:40:56,247,8467,128,119,4992.21,9841.58,0.00
2024-12-10 17:40:56,248,8466,129,119,4981.15,9841.69,0.00
2024-12-10 17:40:56,248,8467,129,119,5108.03,9842.00,0.00
2024-12-10 17:40:56,249,8467,130,119,5087.52,9842.00,0.00
2024-12-10 17:40:56,250,8466,130,120,5064.03,9842.04,0.00
2024-12-10 17:40:56,249,8466,130,119,5086.75,9842.06,0.00
2024-12-10 17:40:56,248,8466,129,119,5098.96,9842.14,0.00
2024-12-10 17:40:56,249,8465,129,120,5020.16,9842.73,0.00
2024-12-10 17:40:56,249,8466,129,120,5130.52,9843.00,0.00
2024-12-10 17:40:56,250,8466,129,121,5109.99,9843.00,0.00
2024-12-10 17:40:56,249,8466,129,120,5109.61,9843.09,0.00
2024-12-10 17:40:56,248,8466,128,120,5125.87,9843.13,0.00
2024-12-10 17:40:56,247,8466,128,119,5146.22,9843.13,0.00
2024-12-10 17:40:56,246,8466,127,119,5166.74,9843.13,0.00
2024-12-10 17:40:56,247,8465,128,119,5070.12,9843.86,0.00
2024-12-10 17:40:56,247,8466,128,119,5180.23,9844.00,0.00
2024-12-10 17:40:56,248,8466,128,120,5159.34,9844.00,0.00
2024-12-10 17:40:56,249,8465,129,120,5137.05,9844.03,0.00
2024-12-10 17:40:56,248,8465,128,120,5152.35,9844.21,0.00
2024-12-10 17:40:56,249,8464,129,120,5128.87,9844.23,0.00
2024-12-10 17:40:56,249,8465,129,120,5145.14,9845.00,0.00
2024-12-10 17:40:56,250,8465,129,121,5124.56,9845.00,0.00
2024-12-10 17:40:56,249,8465,128,121,5055.75,9845.79,0.00
2024-12-10 17:40:56,248,8465,127,121,5065.23,9845.81,0.00
2024-12-10 17:40:56,248,8466,127,121,5163.91,9846.00,0.00
2024-12-10 17:40:56,249,8466,127,122,5143.17,9846.00,0.00
2024-12-10 17:40:56,248,8466,126,122,5160.33,9846.02,0.00
2024-12-10 17:40:56,249,8465,126,123,5138.03,9846.05,0.00
2024-12-10 17:40:56,248,8465,126,122,5161.54,9846.06,0.00
2024-12-10 17:40:56,247,8465,126,121,5181.24,9846.06,0.00
2024-12-10 17:40:56,246,8465,125,121,5194.73,9846.14,0.00
2024-12-10 17:40:56,246,8466,125,121,5144.19,9847.00,0.00
2024-12-10 17:40:56,247,8466,125,122,5123.36,9847.00,0.00
2024-12-10 17:40:56,246,8466,124,122,5142.99,9847.01,0.00
2024-12-10 17:40:56,245,8466,124,121,5143.54,9847.14,0.00
2024-12-10 17:40:56,246,8465,124,122,5061.80,9847.72,0.00
2024-12-10 17:40:56,246,8466,124,122,5109.57,9848.00,0.00
2024-12-10 17:40:56,247,8466,124,123,5088.88,9848.00,0.00
2024-12-10 17:40:56,246,8466,124,122,5104.39,9848.05,0.00
2024-12-10 17:40:56,245,8466,123,122,5116.82,9848.14,0.00
2024-12-10 17:40:56,246,8465,124,122,5046.50,9848.62,0.00
2024-12-10 17:40:56,245,8465,123,122,5068.62,9848.74,0.00
2024-12-10 17:40:56,245,8466,123,122,5120.07,9849.00,0.00
2024-12-10 17:40:56,246,8466,124,122,5099.26,9849.00,0.00
2024-12-10 17:40:56,245,8466,123,122,5116.87,9849.03,0.00
2024-12-10 17:40:56,244,8466,123,121,5127.35,9849.05,0.00
2024-12-10 17:40:56,243,8466,123,120,5140.79,9849.13,0.00
2024-12-10 17:40:56,242,8466,122,120,5161.62,9849.13,0.00
2024-12-10 17:40:56,241,8466,122,119,5182.23,9849.13,0.00
2024-12-10 17:40:56,240,8466,121,119,5163.67,9849.40,0.00
2024-12-10 17:40:56,241,8465,121,120,5092.54,9849.87,0.00
2024-12-10 17:40:56,241,8466,121,120,5159.72,9850.00,0.00
2024-12-10 17:40:56,242,8466,122,120,5138.40,9850.00,0.00
2024-12-10 17:40:56,241,8466,122,119,5150.34,9850.05,0.00
2024-12-10 17:40:56,240,8466,122,118,5163.22,9850.13,0.00
2024-12-10 17:40:56,239,8466,121,118,5184.41,9850.13,0.00
2024-12-10 17:40:56,238,8466,121,117,5205.78,9850.14,0.00
2024-12-10 17:40:57,239,8465,122,117,5127.49,9850.65,0.00
2024-12-10 17:40:57,240,8464,122,118,5111.21,9850.77,0.00
2024-12-10 17:40:57,241,8463,122,119,5092.92,9850.85,0.00
2024-12-10 17:40:57,241,8464,122,119,5159.21,9851.00,0.00
2024-12-10 17:40:57,242,8464,122,120,5137.89,9851.00,0.00
2024-12-10 17:40:57,243,8463,122,121,5082.78,9851.28,0.00
2024-12-10 17:40:57,242,8463,121,121,5120.13,9851.46,0.00
2024-12-10 17:40:57,242,8464,121,121,5201.16,9852.00,0.00
2024-12-10 17:40:57,243,8464,121,122,5179.76,9852.00,0.00
2024-12-10 17:40:57,242,8464,121,121,5147.02,9852.46,0.00
2024-12-10 17:40:57,243,8463,121,122,5123.83,9852.49,0.00
2024-12-10 17:40:57,244,8462,121,123,5102.06,9852.70,0.00
2024-12-10 17:40:57,244,8463,121,123,5141.71,9853.00,0.00
2024-12-10 17:40:57,245,8463,122,123,5120.72,9853.00,0.00
2024-12-10 17:40:57,244,8463,121,123,5139.70,9853.02,0.00
2024-12-10 17:40:57,243,8463,121,122,5156.00,9853.06,0.00
2024-12-10 17:40:57,242,8463,121,121,5170.01,9853.13,0.00
2024-12-10 17:40:57,241,8463,120,121,5191.05,9853.13,0.00
2024-12-10 17:40:57,240,8463,119,121,5205.01,9853.20,0.00
2024-12-10 17:40:57,241,8462,120,121,5154.08,9853.50,0.00
2024-12-10 17:40:57,240,8462,119,121,5149.38,9853.88,0.00
2024-12-10 17:40:57,239,8462,118,121,5160.27,9853.89,0.00
2024-12-10 17:40:57,240,8461,118,122,5129.86,9853.97,0.00
2024-12-10 17:40:57,240,8462,118,122,5250.60,9854.00,0.00
2024-12-10 17:40:57,241,8462,119,122,5228.81,9854.00,0.00
2024-12-10 17:40:57,240,8462,119,121,5227.02,9854.14,0.00
2024-12-10 17:40:57,239,8462,118,121,5238.55,9854.24,0.00
2024-12-10 17:40:57,240,8461,118,122,5153.24,9854.75,0.00
2024-12-10 17:40:57,240,8462,118,122,5256.43,9855.00,0.00
2024-12-10 17:40:57,241,8462,118,123,5234.62,9855.00,0.00
2024-12-10 17:40:57,240,8462,117,123,5251.12,9855.05,0.00
2024-12-10 17:40:57,241,8461,117,124,5219.11,9855.08,0.00
2024-12-10 17:40:57,240,8461,117,123,5249.12,9855.15,0.00
2024-12-10 17:40:57,240,8462,117,123,5224.92,9856.00,0.00
2024-12-10 17:40:57,241,8462,118,123,5203.24,9856.00,0.00
2024-12-10 17:40:57,242,8461,119,123,5131.58,9856.42,0.00
2024-12-10 17:40:57,241,8461,118,123,5174.58,9856.47,0.00
2024-12-10 17:40:57,242,8460,118,124,5122.85,9856.76,0.00
2024-12-10 17:40:57,243,8459,119,124,5091.36,9856.91,0.00
2024-12-10 17:40:57,243,8460,119,124,5150.03,9857.00,0.00
2024-12-10 17:40:57,244,8460,120,124,5128.92,9857.00,0.00
2024-12-10 17:40:57,245,8459,120,125,5105.98,9857.03,0.00
2024-12-10 17:40:57,244,8459,120,124,5128.55,9857.07,0.00
2024-12-10 17:40:57,243,8459,120,123,5140.85,9857.15,0.00
2024-12-10 17:40:57,244,8458,121,123,5119.78,9857.16,0.00
2024-12-10 17:40:57,245,8457,122,123,5135.91,9857.19,0.00
2024-12-10 17:40:57,246,8456,123,123,5126.27,9857.28,0.00
2024-12-10 17:40:57,245,8456,122,123,5131.02,9857.77,0.00
2024-12-10 17:40:57,246,8455,122,124,5106.98,9857.81,0.00
2024-12-10 17:40:57,247,8454,122,125,5083.67,9857.85,0.00
2024-12-10 17:40:57,246,8454,121,125,5084.62,9857.97,0.00
2024-12-10 17:40:57,246,8455,121,125,5242.12,9858.00,0.00
2024-12-10 17:40:57,247,8455,121,126,5220.89,9858.00,0.00
2024-12-10 17:40:57,246,8455,121,125,5218.86,9858.15,0.00
2024-12-10 17:40:57,247,8454,122,125,5146.29,9858.62,0.00
2024-12-10 17:40:57,247,8455,122,125,5395.03,9859.00,0.00
2024-12-10 17:40:57,248,8455,122,126,5373.27,9859.00,0.00
2024-12-10 17:40:57,249,8454,122,127,5330.37,9859.15,0.00
2024-12-10 17:40:57,248,8454,121,127,5349.60,9859.16,0.00
2024-12-10 17:40:57,247,8454,120,127,5353.05,9859.30,0.00
2024-12-10 17:40:57,248,8453,120,128,5318.40,9859.44,0.00
2024-12-10 17:40:57,247,8453,119,128,5364.99,9859.47,0.00
2024-12-10 17:40:57,248,8452,120,128,5341.37,9859.50,0.00
2024-12-10 17:40:57,247,8452,120,127,5346.19,9859.81,0.00
2024-12-10 17:40:57,247,8453,120,127,5401.16,9860.00,0.00
2024-12-10 17:40:57,248,8453,121,127,5379.38,9860.00,0.00
2024-12-10 17:40:57,247,8453,120,127,5367.36,9860.15,0.00
2024-12-10 17:40:57,246,8453,119,127,5388.77,9860.15,0.00
2024-12-10 17:40:57,245,8453,119,126,5376.97,9860.49,0.00
2024-12-10 17:40:57,246,8452,119,127,5325.55,9860.79,0.00
2024-12-10 17:40:57,246,8453,119,127,5456.80,9861.00,0.00
2024-12-10 17:40:57,247,8453,119,128,5434.71,9861.00,0.00
2024-12-10 17:40:57,246,8453,119,127,5429.47,9861.15,0.00
2024-12-10 17:40:57,245,8453,118,127,5450.83,9861.16,0.00
2024-12-10 17:40:57,245,8454,118,127,5411.98,9862.00,0.00
2024-12-10 17:40:57,246,8454,118,128,5389.98,9862.00,0.00
2024-12-10 17:40:57,247,8453,118,129,5363.78,9862.06,0.00
2024-12-10 17:40:57,246,8453,117,129,5392.41,9862.07,0.00
2024-12-10 17:40:57,245,8453,117,128,5408.78,9862.07,0.00
2024-12-10 17:40:57,244,8453,116,128,5417.49,9862.16,0.00
2024-12-10 17:40:57,245,8452,117,128,5352.05,9862.60,0.00
2024-12-10 17:40:57,244,8452,117,127,5342.78,9862.85,0.00
2024-12-10 17:40:57,245,8451,117,128,5319.44,9862.86,0.00
2024-12-10 17:40:57,245,8452,117,128,5319.06,9863.00,0.00
2024-12-10 17:40:57,246,8452,118,128,5297.44,9863.00,0.00
2024-12-10 17:40:57,245,8452,117,128,5315.85,9863.03,0.00
2024-12-10 17:40:57,244,8452,117,127,5333.61,9863.06,0.00
2024-12-10 17:40:57,243,8452,117,126,5342.16,9863.14,0.00
2024-12-10 17:40:57,242,8452,117,125,5363.83,9863.15,0.00
2024-12-10 17:40:57,241,8452,117,124,5385.27,9863.15,0.00
2024-12-10 17:40:57,240,8452,116,124,5407.30,9863.15,0.00
2024-12-10 17:40:57,241,8451,116,125,5364.46,9863.37,0.00
2024-12-10 17:40:57,242,8450,117,125,5355.00,9863.52,0.00
2024-12-10 17:40:57,243,8449,118,125,5363.79,9863.58,0.00
2024-12-10 17:40:57,242,8449,117,125,5320.43,9863.93,0.00
2024-12-10 17:40:57,242,8450,117,125,5476.59,9864.00,0.00
2024-12-10 17:40:57,243,8450,117,126,5454.05,9864.00,0.00
2024-12-10 17:40:57,242,8450,116,126,5468.06,9864.06,0.00
2024-12-10 17:40:57,241,8450,115,126,5468.36,9864.15,0.00
2024-12-10 17:40:57,240,8450,114,126,5443.36,9864.60,0.00
2024-12-10 17:40:57,241,8449,115,126,5383.78,9864.84,0.00
2024-12-10 17:40:57,241,8450,115,126,5537.01,9865.00,0.00
2024-12-10 17:40:57,242,8450,116,126,5514.13,9865.00,0.00
2024-12-10 17:40:57,241,8450,116,125,5530.90,9865.06,0.00
2024-12-10 17:40:57,240,8450,115,125,5541.78,9865.13,0.00
2024-12-10 17:40:57,239,8450,114,125,5563.33,9865.14,0.00
2024-12-10 17:40:57,238,8450,113,125,5544.57,9865.53,0.00
2024-12-10 17:40:57,239,8449,114,125,5513.58,9865.62,0.00
2024-12-10 17:40:57,238,8449,114,124,5525.06,9865.80,0.00
2024-12-10 17:40:57,238,8450,114,124,5586.70,9866.00,0.00
2024-12-10 17:40:57,239,8450,114,125,5563.33,9866.00,0.00
2024-12-10 17:40:57,238,8450,113,125,5585.46,9866.01,0.00
2024-12-10 17:40:57,237,8450,113,124,5603.64,9866.06,0.00
2024-12-10 17:40:57,236,8450,112,124,5624.05,9866.09,0.00
2024-12-10 17:40:57,235,8450,111,124,5636.80,9866.14,0.00
2024-12-10 17:40:57,234,8450,110,124,5660.47,9866.14,0.00
2024-12-10 17:40:57,233,8450,109,124,5684.34,9866.14,0.00
2024-12-10 17:40:57,232,8450,108,124,5707.26,9866.16,0.00
2024-12-10 17:40:57,233,8449,109,124,5650.71,9866.49,0.00
2024-12-10 17:40:57,234,8448,110,124,5606.89,9866.87,0.00
2024-12-10 17:40:58,234,8449,110,124,5665.62,9867.00,0.00
2024-12-10 17:40:58,235,8449,111,124,5641.51,9867.00,0.00
2024-12-10 17:40:58,236,8448,112,124,5615.52,9867.03,0.00
2024-12-10 17:40:58,235,8448,112,123,5628.31,9867.12,0.00
2024-12-10 17:40:58,234,8448,112,122,5649.42,9867.14,0.00
2024-12-10 17:40:58,233,8448,112,121,5673.25,9867.14,0.00
2024-12-10 17:40:58,234,8447,113,121,5568.89,9867.83,0.00
2024-12-10 17:40:58,234,8448,113,121,5684.16,9868.00,0.00
2024-12-10 17:40:58,235,8448,114,121,5659.98,9868.00,0.00
2024-12-10 17:40:58,234,8448,114,120,5662.29,9868.14,0.00
2024-12-10 17:40:58,233,8448,114,119,5686.17,9868.14,0.00
2024-12-10 17:40:58,234,8447,115,119,5613.04,9868.63,0.00
2024-12-10 17:40:58,234,8448,115,119,5697.89,9869.00,0.00
2024-12-10 17:40:58,235,8448,115,120,5673.64,9869.00,0.00
2024-12-10 17:40:58,234,8448,114,120,5694.11,9869.04,0.00
2024-12-10 17:40:58,235,8447,114,121,5669.04,9869.06,0.00
2024-12-10 17:40:58,234,8447,113,121,5693.88,9869.22,0.00
2024-12-10 17:40:58,235,8446,114,121,5631.58,9869.60,0.00
2024-12-10 17:40:58,236,8445,115,121,5611.98,9869.61,0.00
2024-12-10 17:40:58,237,8444,115,122,5578.00,9869.78,0.00
2024-12-10 17:40:58,237,8445,115,122,5630.67,9870.00,0.00
2024-12-10 17:40:58,238,8445,115,123,5607.01,9870.00,0.00
2024-12-10 17:40:58,237,8445,115,122,5621.95,9870.06,0.00
2024-12-10 17:40:58,238,8444,115,123,5556.61,9870.50,0.00
2024-12-10 17:40:58,238,8445,115,123,5687.22,9871.00,0.00
2024-12-10 17:40:58,239,8445,115,124,5663.42,9871.00,0.00
2024-12-10 17:40:58,238,8445,114,124,5665.29,9871.14,0.00
2024-12-10 17:40:58,237,8445,114,123,5683.74,9871.19,0.00
2024-12-10 17:40:58,238,8444,115,123,5580.73,9871.84,0.00
2024-12-10 17:40:58,238,8445,115,123,5651.43,9872.00,0.00
2024-12-10 17:40:58,239,8445,115,124,5627.79,9872.00,0.00
2024-12-10 17:40:58,238,8445,114,124,5629.09,9872.14,0.00
2024-12-10 17:40:58,237,8445,113,124,5652.43,9872.14,0.00
2024-12-10 17:40:58,238,8444,113,125,5614.20,9872.30,0.00
2024-12-10 17:40:58,239,8443,114,125,5566.68,9872.68,0.00
2024-12-10 17:40:58,239,8444,114,125,5624.72,9873.00,0.00
2024-12-10 17:40:58,240,8444,115,125,5601.29,9873.00,0.00
2024-12-10 17:40:58,241,8443,116,125,5576.41,9873.03,0.00
2024-12-10 17:40:58,240,8443,116,124,5600.96,9873.07,0.00
2024-12-10 17:40:58,241,8442,117,124,5559.34,9873.27,0.00
2024-12-10 17:40:58,242,8441,117,125,5536.39,9873.31,0.00
2024-12-10 17:40:58,241,8441,116,125,5525.82,9873.60,0.00
2024-12-10 17:40:58,242,8440,117,125,5471.76,9873.86,0.00
2024-12-10 17:40:58,242,8441,117,125,5582.10,9874.00,0.00
2024-12-10 17:40:58,243,8441,118,125,5559.13,9874.00,0.00
2024-12-10 17:40:58,242,8441,118,124,5573.96,9874.07,0.00
2024-12-10 17:40:58,241,8441,118,123,5589.34,9874.14,0.00
2024-12-10 17:40:58,241,8442,118,123,5676.15,9875.00,0.00
2024-12-10 17:40:58,242,8442,118,124,5652.70,9875.00,0.00
2024-12-10 17:40:58,241,8442,118,123,5654.08,9875.14,0.00
2024-12-10 17:40:58,240,8442,117,123,5647.66,9875.33,0.00
2024-12-10 17:40:58,241,8441,118,123,5611.98,9875.46,0.00
2024-12-10 17:40:58,242,8440,119,123,5587.19,9875.53,0.00
2024-12-10 17:40:58,242,8441,119,123,5581.19,9876.00,0.00
2024-12-10 17:40:58,243,8441,120,123,5558.22,9876.00,0.00
2024-12-10 17:40:58,242,8441,119,123,5563.26,9876.06,0.00
2024-12-10 17:40:58,243,8440,120,123,5509.15,9876.30,0.00
2024-12-10 17:40:58,242,8440,119,123,5539.38,9876.53,0.00
2024-12-10 17:40:58,242,8441,119,123,5612.07,9877.00,0.00
2024-12-10 17:40:58,243,8441,119,124,5588.98,9877.00,0.00
2024-12-10 17:40:58,242,8441,119,123,5605.37,9877.07,0.00
2024-12-10 17:40:58,243,8440,120,123,5536.16,9877.54,0.00
2024-12-10 17:40:58,244,8439,121,123,5517.25,9877.69,0.00
2024-12-10 17:40:58,245,8438,121,124,5483.55,9877.82,0.00
2024-12-10 17:40:58,245,8439,121,124,5565.88,9878.00,0.00
2024-12-10 17:40:58,246,8439,121,125,5543.25,9878.00,0.00
2024-12-10 17:40:58,245,8439,121,124,5553.81,9878.07,0.00
2024-12-10 17:40:58,244,8439,121,123,5570.12,9878.13,0.00
2024-12-10 17:40:58,243,8439,121,122,5592.63,9878.13,0.00
2024-12-10 17:40:58,242,8439,120,122,5595.78,9878.26,0.00
2024-12-10 17:40:58,243,8438,121,122,5535.95,9878.64,0.00
2024-12-10 17:40:58,243,8439,121,122,5674.35,9879.00,0.00
2024-12-10 17:40:58,244,8439,122,122,5651.09,9879.00,0.00
2024-12-10 17:40:58,243,8439,122,121,5665.83,9879.07,0.00
2024-12-10 17:40:58,242,8439,122,120,5684.77,9879.11,0.00
2024-12-10 17:40:58,241,8439,122,119,5706.73,9879.12,0.00
2024-12-10 17:40:58,240,8439,121,119,5700.57,9879.43,0.00
2024-12-10 17:40:58,241,8438,121,120,5676.51,9879.44,0.00
2024-12-10 17:40:58,240,8438,120,120,5708.28,9879.65,0.00
2024-12-10 17:40:58,240,8439,120,120,5739.04,9880.00,0.00
2024-12-10 17:40:58,241,8439,120,121,5715.22,9880.00,0.00
2024-12-10 17:40:58,240,8439,119,121,5734.12,9880.05,0.00
2024-12-10 17:40:58,239,8439,118,121,5740.77,9880.13,0.00
2024-12-10 17:40:58,240,8438,118,122,5683.65,9880.48,0.00
2024-12-10 17:40:58,241,8437,118,123,5651.01,9880.68,0.00
2024-12-10 17:40:58,242,8436,118,124,5614.97,9880.92,0.00
2024-12-10 17:40:58,242,8437,118,124,5691.39,9881.00,0.00
2024-12-10 17:40:58,243,8437,119,124,5667.97,9881.00,0.00
2024-12-10 17:40:58,242,8437,118,124,5684.86,9881.02,0.00
2024-12-10 17:40:58,241,8437,118,123,5700.28,9881.07,0.00
2024-12-10 17:40:58,240,8437,117,123,5719.52,9881.12,0.00
2024-12-10 17:40:58,241,8436,118,123,5652.93,9881.56,0.00
2024-12-10 17:40:58,242,8435,118,124,5624.83,9881.69,0.00
2024-12-10 17:40:58,242,8436,118,124,5762.54,9882.00,0.00
2024-12-10 17:40:58,243,8436,118,125,5738.83,9882.00,0.00
2024-12-10 17:40:58,242,8436,118,124,5757.26,9882.05,0.00
2024-12-10 17:40:58,243,8435,118,125,5675.62,9882.40,0.00
2024-12-10 17:40:58,244,8434,118,126,5677.88,9882.41,0.00
2024-12-10 17:40:58,245,8433,119,126,5605.05,9882.90,0.00
2024-12-10 17:40:58,245,8434,119,126,5719.69,9883.00,0.00
2024-12-10 17:40:58,246,8434,120,126,5696.44,9883.00,0.00
2024-12-10 17:40:58,245,8434,119,126,5712.86,9883.07,0.00
2024-12-10 17:40:58,244,8434,119,125,5733.04,9883.07,0.00
2024-12-10 17:40:58,243,8434,119,124,5753.39,9883.10,0.00
2024-12-10 17:40:58,242,8434,119,123,5776.75,9883.10,0.00
2024-12-10 17:40:58,243,8433,119,124,5706.38,9883.42,0.00
2024-12-10 17:40:58,244,8432,120,124,5703.67,9883.45,0.00
2024-12-10 17:40:58,245,8431,121,124,5660.55,9883.81,0.00
2024-12-10 17:40:58,245,8432,121,124,5809.57,9884.00,0.00
2024-12-10 17:40:58,246,8432,122,124,5785.95,9884.00,0.00
2024-12-10 17:40:58,245,8432,121,124,5791.45,9884.10,0.00
2024-12-10 17:40:59,246,8431,121,125,5731.92,9884.47,0.00
2024-12-10 17:40:59,247,8430,121,126,5727.54,9884.49,0.00
2024-12-10 17:40:59,247,8431,121,126,5847.38,9885.00,0.00
2024-12-10 17:40:59,248,8431,122,126,5823.80,9885.00,0.00
2024-12-10 17:40:59,247,8431,122,125,5829.01,9885.11,0.00
2024-12-10 17:40:59,248,8430,122,126,5799.54,9885.17,0.00
2024-12-10 17:40:59,249,8429,122,127,5771.88,9885.57,0.00
2024-12-10 17:40:59,249,8430,122,127,5837.33,9886.00,0.00
2024-12-10 17:40:59,250,8430,123,127,5813.98,9886.00,0.00
2024-12-10 17:40:59,249,8430,123,126,5828.22,9886.07,0.00
2024-12-10 17:40:59,248,8430,122,126,5849.62,9886.09,0.00
2024-12-10 17:40:59,247,8430,121,126,5872.51,9886.10,0.00
2024-12-10 17:40:59,248,8429,121,127,5768.06,9886.78,0.00
2024-12-10 17:40:59,248,8430,121,127,5857.54,9887.00,0.00
2024-12-10 17:40:59,249,8430,121,128,5834.01,9887.00,0.00
2024-12-10 17:40:59,248,8430,120,128,5854.76,9887.03,0.00
2024-12-10 17:40:59,247,8430,119,128,5863.67,9887.09,0.00
2024-12-10 17:40:59,246,8430,118,128,5887.11,9887.09,0.00
2024-12-10 17:40:59,245,8430,118,127,5910.73,9887.09,0.00
2024-12-10 17:40:59,246,8429,118,128,5850.66,9887.45,0.00
2024-12-10 17:40:59,247,8428,118,129,5839.35,9887.54,0.00
2024-12-10 17:40:59,246,8428,118,128,5840.25,9887.70,0.00
2024-12-10 17:40:59,246,8429,118,128,5886.72,9888.00,0.00
2024-12-10 17:40:59,247,8429,118,129,5862.89,9888.00,0.00
2024-12-10 17:40:59,248,8428,118,130,5768.38,9888.56,0.00
2024-12-10 17:40:59,248,8429,118,130,5829.05,9889.00,0.00
2024-12-10 17:40:59,249,8429,119,130,5805.65,9889.00,0.00
2024-12-10 17:40:59,248,8429,118,130,5828.26,9889.01,0.00
2024-12-10 17:40:59,247,8429,118,129,5837.07,9889.07,0.00
2024-12-10 17:40:59,246,8429,118,128,5859.19,9889.09,0.00
2024-12-10 17:40:59,245,8429,117,128,5881.50,9889.10,0.00
2024-12-10 17:40:59,244,8429,117,127,5853.08,9889.51,0.00
2024-12-10 17:40:59,245,8428,117,128,5828.79,9889.52,0.00
2024-12-10 17:40:59,244,8428,116,128,5841.90,9889.58,0.00
2024-12-10 17:40:59,243,8428,115,128,5846.35,9889.75,0.00
2024-12-10 17:40:59,243,8429,115,128,5891.29,9890.00,0.00
2024-12-10 17:40:59,244,8429,115,129,5867.14,9890.00,0.00
2024-12-10 17:40:59,243,8429,115,128,5881.95,9890.07,0.00
2024-12-10 17:40:59,244,8428,115,129,5825.88,9890.38,0.00
2024-12-10 17:40:59,245,8427,116,129,5791.29,9890.53,0.00
2024-12-10 17:40:59,245,8428,116,129,5804.28,9891.00,0.00
2024-12-10 17:40:59,246,8428,117,129,5780.68,9891.00,0.00
2024-12-10 17:40:59,245,8428,116,129,5803.88,9891.00,0.00
2024-12-10 17:40:59,244,8428,115,129,5810.27,9891.10,0.00
2024-12-10 17:40:59,245,8427,116,129,5776.38,9891.18,0.00
2024-12-10 17:40:59,246,8426,116,130,5726.47,9891.42,0.00
2024-12-10 17:40:59,247,8425,117,130,5734.73,9891.47,0.00
2024-12-10 17:40:59,246,8425,116,130,5726.08,9891.79,0.00
2024-12-10 17:40:59,247,8424,116,131,5691.36,9891.89,0.00
2024-12-10 17:40:59,247,8425,116,131,5804.39,9892.00,0.00
2024-12-10 17:40:59,248,8425,117,131,5780.98,9892.00,0.00
2024-12-10 17:40:59,247,8425,116,131,5800.80,9892.04,0.00
2024-12-10 17:40:59,246,8425,116,130,5820.37,9892.06,0.00
2024-12-10 17:40:59,245,8425,115,130,5779.78,9892.67,0.00
2024-12-10 17:40:59,246,8424,116,130,5732.84,9892.90,0.00
2024-12-10 17:40:59,246,8425,116,130,5911.47,9893.00,0.00
2024-12-10 17:40:59,247,8425,117,130,5887.53,9893.00,0.00
2024-12-10 17:40:59,246,8425,117,129,5897.82,9893.06,0.00
2024-12-10 17:40:59,245,8425,117,128,5917.87,9893.09,0.00
2024-12-10 17:40:59,244,8425,116,128,5940.43,9893.11,0.00
2024-12-10 17:40:59,243,8425,115,128,5956.90,9893.14,0.00
2024-12-10 17:40:59,244,8424,115,129,5900.60,9893.47,0.00
2024-12-10 17:40:59,245,8423,115,130,5865.02,9893.80,0.00
2024-12-10 17:40:59,246,8422,116,130,5846.42,9893.82,0.00
2024-12-10 17:40:59,246,8423,116,130,5913.75,9894.00,0.00
2024-12-10 17:40:59,247,8423,116,131,5889.81,9894.00,0.00
2024-12-10 17:40:59,246,8423,115,131,5898.08,9894.02,0.00
2024-12-10 17:40:59,245,8423,114,131,5920.14,9894.04,0.00
2024-12-10 17:40:59,244,8423,114,130,5939.54,9894.05,0.00
2024-12-10 17:40:59,245,8422,114,131,5911.28,9894.10,0.00
2024-12-10 17:40:59,244,8422,114,130,5961.06,9894.10,0.00
2024-12-10 17:40:59,243,8422,113,130,5975.68,9894.17,0.00
2024-12-10 17:40:59,242,8422,113,129,5973.20,9894.45,0.00
2024-12-10 17:40:59,243,8421,114,129,5940.11,9894.54,0.00
2024-12-10 17:40:59,244,8420,115,129,5913.86,9894.73,0.00
2024-12-10 17:40:59,244,8421,115,129,6031.75,9895.00,0.00
2024-12-10 17:40:59,245,8421,116,129,6007.13,9895.00,0.00
2024-12-10 17:40:59,244,8421,115,129,6002.64,9895.15,0.00
2024-12-10 17:40:59,245,8420,116,129,5961.24,9895.33,0.00
2024-12-10 17:40:59,246,8419,116,130,5939.83,9895.35,0.00
2024-12-10 17:40:59,245,8419,116,129,5974.86,9895.48,0.00
2024-12-10 17:40:59,246,8418,117,129,5944.18,9895.55,0.00
2024-12-10 17:40:59,247,8417,117,130,5931.36,9895.60,0.00
2024-12-10 17:40:59,246,8417,117,129,5952.52,9895.81,0.00
2024-12-10 17:40:59,246,8418,117,129,6094.67,9896.00,0.00
2024-12-10 17:40:59,247,8418,118,129,6070.00,9896.00,0.00
2024-12-10 17:40:59,246,8418,118,128,6076.62,9896.10,0.00
2024-12-10 17:40:59,247,8417,118,129,6014.52,9896.47,0.00
2024-12-10 17:40:59,248,8416,118,130,5998.43,9896.74,0.00
2024-12-10 17:40:59,249,8415,118,131,5971.52,9896.83,0.00
2024-12-10 17:40:59,249,8416,118,131,6142.57,9897.00,0.00
2024-12-10 17:40:59,250,8416,118,132,6118.00,9897.00,0.00
2024-12-10 17:40:59,249,8416,118,131,6137.04,9897.06,0.00
2024-12-10 17:40:59,250,8415,118,132,6112.09,9897.07,0.00
2024-12-10 17:40:59,249,8415,118,131,6156.94,9897.10,0.00
2024-12-10 17:40:59,250,8414,118,132,6093.78,9897.46,0.00
2024-12-10 17:40:59,250,8415,118,132,6183.04,9898.00,0.00
2024-12-10 17:40:59,251,8415,119,132,6158.41,9898.00,0.00
2024-12-10 17:40:59,252,8414,120,132,6087.74,9898.36,0.00
2024-12-10 17:40:59,253,8413,120,133,6085.99,9898.38,0.00
2024-12-10 17:40:59,254,8412,120,134,6051.35,9898.73,0.00
2024-12-10 17:40:59,254,8413,120,134,6157.99,9899.00,0.00
2024-12-10 17:40:59,255,8413,120,135,6133.84,9899.00,0.00
2024-12-10 17:40:59,254,8413,119,135,6155.27,9899.03,0.00
2024-12-10 17:40:59,253,8413,118,135,6162.61,9899.10,0.00
2024-12-10 17:40:59,252,8413,117,135,6186.67,9899.10,0.00
2024-12-10 17:40:59,253,8412,117,136,6121.83,9899.49,0.00
2024-12-10 17:40:59,253,8413,117,136,6236.19,9900.00,0.00
2024-12-10 17:40:59,254,8413,117,137,6211.64,9900.00,0.00
2024-12-10 17:40:59,255,8412,117,138,6182.64,9900.06,0.00
2024-12-10 17:40:59,254,8412,116,138,6212.00,9900.10,0.00
2024-12-10 17:40:59,253,8412,116,137,6236.16,9900.10,0.00
2024-12-10 17:40:59,254,8411,117,137,6162.69,9900.60,0.00
2024-12-10 17:40:59,253,8411,116,137,6199.45,9900.74,0.00
2024-12-10 17:40:59,254,8410,116,138,6160.35,9900.89,0.00
2024-12-10 17:41:00,254,8411,116,138,6221.53,9901.00,0.00
2024-12-10 17:41:00,255,8411,116,139,6197.13,9901.00,0.00
2024-12-10 17:41:00,256,8410,116,140,6139.16,9901.27,0.00
2024-12-10 17:41:00,257,8409,116,141,6112.49,9901.35,0.00
2024-12-10 17:41:00,258,8408,117,141,6095.77,9901.45,0.00
2024-12-10 17:41:00,258,8409,117,141,6199.51,9902.00,0.00
2024-12-10 17:41:00,259,8409,117,142,6175.57,9902.00,0.00
2024-12-10 17:41:00,258,8409,117,141,6188.40,9902.06,0.00
2024-12-10 17:41:00,259,8408,117,142,6138.61,9902.32,0.00
2024-12-10 17:41:00,260,8407,118,142,6108.57,9902.41,0.00
2024-12-10 17:41:00,259,8407,117,142,6086.03,9902.88,0.00
2024-12-10 17:41:00,259,8408,117,142,6227.59,9903.00,0.00
2024-12-10 17:41:00,260,8408,118,142,6203.64,9903.00,0.00
2024-12-10 17:41:00,259,8408,117,142,6224.55,9903.03,0.00
2024-12-10 17:41:00,258,8408,116,142,6234.50,9903.09,0.00
2024-12-10 17:41:00,257,8408,115,142,6258.38,9903.09,0.00
2024-12-10 17:41:00,257,8409,115,142,6269.20,9904.00,0.00
2024-12-10 17:41:00,258,8409,116,142,6244.90,9904.00,0.00
2024-12-10 17:41:00,257,8409,116,141,6262.45,9904.05,0.00
2024-12-10 17:41:00,256,8409,116,140,6282.29,9904.09,0.00
2024-12-10 17:41:00,257,8408,116,141,6196.42,9904.57,0.00
2024-12-10 17:41:00,257,8409,116,141,6204.52,9905.00,0.00
2024-12-10 17:41:00,258,8409,117,141,6180.47,9905.00,0.00
2024-12-10 17:41:00,259,8408,118,141,6155.85,9905.02,0.00
2024-12-10 17:41:00,260,8407,118,142,6145.52,9905.03,0.00
2024-12-10 17:41:00,259,8407,118,141,6167.88,9905.10,0.00
2024-12-10 17:41:00,258,8407,118,140,6189.00,9905.13,0.00
2024-12-10 17:41:00,259,8406,118,141,6153.67,9905.26,0.00
2024-12-10 17:41:00,260,8405,119,141,6068.29,9905.90,0.00
2024-12-10 17:41:00,260,8406,119,141,6134.58,9906.00,0.00
2024-12-10 17:41:00,261,8406,120,141,6111.08,9906.00,0.00
2024-12-10 17:41:00,260,8406,119,141,6117.48,9906.10,0.00
2024-12-10 17:41:00,259,8406,118,141,6140.34,9906.10,0.00
2024-12-10 17:41:00,260,8405,119,141,6091.97,9906.35,0.00
2024-12-10 17:41:00,261,8404,119,142,6039.39,9906.77,0.00
2024-12-10 17:41:00,262,8403,119,143,6014.09,9906.85,0.00
2024-12-10 17:41:00,263,8402,120,143,5981.39,9906.89,0.00
2024-12-10 17:41:00,263,8403,120,143,6158.26,9907.00,0.00
2024-12-10 17:41:00,264,8403,121,143,6134.93,9907.00,0.00
2024-12-10 17:41:00,265,8402,122,143,6098.73,9907.07,0.00
2024-12-10 17:41:00,264,8402,122,142,6138.36,9907.10,0.00
2024-12-10 17:41:00,263,8402,122,141,6160.94,9907.11,0.00
2024-12-10 17:41:00,262,8402,121,141,6173.21,9907.21,0.00
2024-12-10 17:41:00,261,8402,120,141,6149.33,9907.61,0.00
2024-12-10 17:41:00,261,8403,120,141,6268.99,9908.00,0.00
2024-12-10 17:41:00,262,8403,120,142,6245.07,9908.00,0.00
2024-12-10 17:41:00,263,8402,121,142,6220.95,9908.02,0.00
2024-12-10 17:41:00,262,8402,121,141,6251.52,9908.05,0.00
2024-12-10 17:41:00,261,8402,121,140,6272.45,9908.08,0.00
2024-12-10 17:41:00,262,8401,121,141,6230.80,9908.27,0.00
2024-12-10 17:41:00,263,8400,121,142,6173.86,9908.68,0.00
2024-12-10 17:41:00,263,8401,121,142,6163.18,9909.00,0.00
2024-12-10 17:41:00,264,8401,121,143,6139.83,9909.00,0.00
2024-12-10 17:41:00,263,8401,120,143,6145.52,9909.10,0.00
2024-12-10 17:41:00,262,8401,120,142,6168.60,9909.10,0.00
2024-12-10 17:41:00,263,8400,120,143,6128.26,9909.28,0.00
2024-12-10 17:41:00,264,8399,120,144,6055.20,9909.76,0.00
2024-12-10 17:41:00,265,8398,120,145,6037.60,9909.78,0.00
2024-12-10 17:41:00,264,8398,120,144,6060.07,9909.84,0.00
2024-12-10 17:41:00,263,8398,119,144,6066.31,9909.96,0.00
2024-12-10 17:41:00,263,8399,119,144,6199.97,9910.00,0.00
2024-12-10 17:41:00,264,8399,120,144,6176.49,9910.00,0.00
2024-12-10 17:41:00,265,8398,120,145,6152.81,9910.02,0.00
2024-12-10 17:41:00,264,8398,120,144,6168.26,9910.05,0.00
2024-12-10 17:41:00,263,8398,120,143,6186.46,9910.10,0.00
2024-12-10 17:41:00,262,8398,120,142,6209.69,9910.10,0.00
2024-12-10 17:41:00,261,8398,120,141,6151.14,9910.73,0.00
2024-12-10 17:41:00,260,8398,120,140,6139.09,9910.95,0.00
2024-12-10 17:41:00,260,8399,120,140,6287.02,9911.00,0.00
2024-12-10 17:41:00,261,8399,120,141,6262.93,9911.00,0.00
2024-12-10 17:41:00,260,8399,120,140,6268.89,9911.10,0.00
2024-12-10 17:41:00,261,8398,121,140,6210.33,9911.44,0.00
2024-12-10 17:41:00,262,8397,121,141,6204.04,9911.46,0.00
2024-12-10 17:41:00,262,8398,121,141,6238.05,9912.00,0.00
2024-12-10 17:41:00,263,8398,122,141,6214.33,9912.00,0.00
2024-12-10 17:41:00,262,8398,122,140,6219.73,9912.10,0.00
2024-12-10 17:41:00,262,8399,122,140,6229.49,9913.00,0.00
2024-12-10 17:41:00,263,8399,122,141,6205.81,9913.00,0.00
2024-12-10 17:41:00,262,8399,122,140,6211.76,9913.10,0.00
2024-12-10 17:41:00,261,8399,122,139,6235.18,9913.10,0.00
2024-12-10 17:41:00,262,8398,123,139,6157.22,9913.60,0.00
2024-12-10 17:41:00,263,8397,123,140,6155.44,9913.67,0.00
2024-12-10 17:41:00,264,8396,123,141,6134.44,9913.77,0.00
2024-12-10 17:41:01,264,8397,123,141,6139.94,9914.00,0.00
2024-12-10 17:41:01,265,8397,124,141,6116.77,9914.00,0.00
2024-12-10 17:41:01,264,8397,124,140,6130.95,9914.05,0.00
2024-12-10 17:41:01,265,8396,125,140,6101.10,9914.13,0.00
2024-12-10 17:41:01,265,8397,125,140,6175.16,9915.00,0.00
2024-12-10 17:41:01,266,8397,125,141,6151.95,9915.00,0.00
2024-12-10 17:41:01,265,8397,124,141,6157.62,9915.10,0.00
2024-12-10 17:41:01,265,8398,124,141,6128.22,9916.00,0.00
2024-12-10 17:41:01,266,8398,124,142,6105.18,9916.00,0.00
2024-12-10 17:41:01,265,8398,124,141,6110.30,9916.11,0.00
2024-12-10 17:41:01,264,8398,123,141,6114.00,9916.30,0.00
2024-12-10 17:41:01,265,8397,123,142,6084.97,9916.37,0.00
2024-12-10 17:41:01,266,8396,123,143,6055.87,9916.62,0.00
2024-12-10 17:41:01,266,8397,123,143,6049.24,9917.00,0.00
2024-12-10 17:41:01,267,8397,123,144,6026.59,9917.00,0.00
2024-12-10 17:41:01,266,8397,122,144,6033.99,9917.08,0.00
2024-12-10 17:41:01,267,8396,122,145,5999.56,9917.21,0.00
2024-12-10 17:41:01,268,8395,123,145,5932.38,9917.64,0.00
2024-12-10 17:41:01,268,8396,123,145,5999.86,9918.00,0.00
2024-12-10 17:41:01,269,8396,123,146,5977.56,9918.00,0.00
2024-12-10 17:41:01,270,8395,124,146,5931.98,9918.17,0.00
2024-12-10 17:41:01,269,8395,123,146,5978.77,9918.25,0.00
2024-12-10 17:41:01,270,8394,123,147,5950.05,9918.33,0.00
2024-12-10 17:41:01,271,8393,123,148,5949.70,9918.35,0.00
2024-12-10 17:41:01,272,8392,124,148,5896.78,9918.74,0.00
2024-12-10 17:41:01,271,8392,123,148,5897.45,9918.90,0.00
2024-12-10 17:41:01,272,8391,123,149,5875.77,9918.90,0.00
2024-12-10 17:41:01,272,8392,123,149,5973.31,9919.00,0.00
2024-12-10 17:41:01,273,8392,124,149,5951.43,9919.00,0.00
2024-12-10 17:41:01,272,8392,124,148,5965.67,9919.05,0.00
2024-12-10 17:41:01,271,8392,123,148,5981.49,9919.11,0.00
2024-12-10 17:41:01,270,8392,122,148,6002.92,9919.11,0.00
2024-12-10 17:41:01,271,8391,123,148,5962.19,9919.31,0.00
2024-12-10 17:41:01,272,8390,123,149,5957.05,9919.33,0.00
2024-12-10 17:41:01,273,8389,124,149,5905.14,9919.62,0.00
2024-12-10 17:41:01,273,8390,124,149,6067.49,9920.00,0.00
2024-12-10 17:41:01,274,8390,125,149,6045.35,9920.00,0.00
2024-12-10 17:41:01,273,8390,124,149,6041.03,9920.16,0.00
2024-12-10 17:41:01,274,8389,125,149,6014.30,9920.22,0.00
2024-12-10 17:41:01,273,8389,125,148,6021.61,9920.33,0.00
2024-12-10 17:41:01,274,8388,126,148,5989.74,9920.42,0.00
2024-12-10 17:41:01,275,8387,127,148,5929.47,9920.83,0.00
2024-12-10 17:41:01,275,8388,127,148,6057.73,9921.00,0.00
2024-12-10 17:41:01,276,8388,128,148,6035.78,9921.00,0.00
2024-12-10 17:41:01,275,8388,128,147,6039.74,9921.11,0.00
2024-12-10 17:41:01,276,8387,128,148,6009.99,9921.20,0.00
2024-12-10 17:41:01,275,8387,127,148,6061.43,9921.20,0.00
2024-12-10 17:41:01,274,8387,126,148,6050.01,9921.52,0.00
2024-12-10 17:41:01,275,8386,126,149,6021.26,9921.56,0.00
2024-12-10 17:41:01,276,8385,126,150,6024.73,9921.59,0.00
2024-12-10 17:41:01,277,8384,126,151,6003.35,9921.60,0.00
2024-12-10 17:41:01,278,8383,127,151,6003.91,9921.65,0.00
2024-12-10 17:41:01,279,8382,127,152,5984.89,9921.67,0.00
2024-12-10 17:41:01,280,8381,127,153,5940.81,9921.92,0.00
2024-12-10 17:41:01,280,8382,127,153,6066.23,9922.00,0.00
2024-12-10 17:41:01,281,8382,127,154,6044.64,9922.00,0.00
2024-12-10 17:41:01,282,8381,128,154,5987.11,9922.31,0.00
2024-12-10 17:41:01,283,8380,129,154,5954.40,9922.43,0.00
2024-12-10 17:41:01,284,8379,130,154,5904.05,9922.76,0.00
2024-12-10 17:41:01,284,8380,130,154,6150.77,9923.00,0.00
2024-12-10 17:41:01,285,8380,131,154,6129.19,9923.00,0.00
2024-12-10 17:41:01,284,8380,131,153,6142.40,9923.05,0.00
2024-12-10 17:41:01,285,8379,132,153,6118.76,9923.07,0.00
2024-12-10 17:41:01,284,8379,131,153,6161.99,9923.11,0.00
2024-12-10 17:41:01,285,8378,132,153,6075.08,9923.69,0.00
2024-12-10 17:41:01,285,8379,132,153,6173.95,9924.00,0.00
2024-12-10 17:41:01,286,8379,133,153,6152.36,9924.00,0.00
2024-12-10 17:41:01,285,8379,133,152,6167.35,9924.05,0.00
2024-12-10 17:41:01,284,8379,133,151,6183.50,9924.11,0.00
2024-12-10 17:41:01,283,8379,132,151,6201.63,9924.13,0.00
2024-12-10 17:41:01,284,8378,132,152,6175.28,9924.18,0.00
2024-12-10 17:41:01,283,8378,132,151,6169.55,9924.50,0.00
2024-12-10 17:41:01,284,8377,132,152,6136.38,9924.62,0.00
2024-12-10 17:41:01,285,8376,132,153,6122.54,9924.66,0.00
2024-12-10 17:41:01,284,8376,132,152,6119.12,9924.84,0.00
2024-12-10 17:41:01,284,8377,132,152,6201.56,9925.00,0.00
2024-12-10 17:41:01,285,8377,133,152,6179.80,9925.00,0.00
2024-12-10 17:41:01,285,8378,133,152,6195.75,9926.00,0.00
2024-12-10 17:41:01,286,8378,134,152,6174.09,9926.00,0.00
2024-12-10 17:41:01,287,8377,135,152,6147.75,9926.06,0.00
2024-12-10 17:41:01,286,8377,134,152,6187.49,9926.06,0.00
2024-12-10 17:41:01,287,8376,134,153,6165.93,9926.07,0.00
2024-12-10 17:41:01,286,8376,134,152,6183.69,9926.11,0.00
2024-12-10 17:41:01,287,8375,135,152,6148.38,9926.26,0.00
2024-12-10 17:41:01,286,8375,134,152,6172.48,9926.33,0.00
2024-12-10 17:41:01,287,8374,135,152,6129.09,9926.55,0.00
2024-12-10 17:41:01,287,8375,135,152,6123.05,9927.00,0.00
2024-12-10 17:41:01,288,8375,136,152,6101.79,9927.00,0.00
2024-12-10 17:41:01,287,8375,135,152,6105.46,9927.11,0.00
2024-12-10 17:41:01,286,8375,134,152,6112.61,9927.25,0.00
2024-12-10 17:41:01,286,8376,134,152,6196.51,9928.00,0.00
2024-12-10 17:41:01,287,8376,135,152,6174.92,9928.00,0.00
2024-12-10 17:41:01,288,8375,136,152,6148.67,9928.06,0.00
2024-12-10 17:41:01,289,8374,136,153,6129.48,9928.12,0.00
2024-12-10 17:41:01,290,8373,137,153,6112.82,9928.16,0.00
2024-12-10 17:41:01,291,8372,137,154,6026.82,9928.81,0.00
2024-12-10 17:41:01,292,8371,138,154,5983.89,9928.90,0.00
2024-12-10 17:41:01,293,8370,139,154,5965.84,9928.90,0.00
2024-12-10 17:41:02,293,8371,139,154,5982.33,9929.00,0.00
2024-12-10 17:41:02,294,8371,140,154,5961.99,9929.00,0.00
2024-12-10 17:41:02,293,8371,139,154,5980.98,9929.01,0.00
2024-12-10 17:41:02,294,8370,139,155,5915.82,9929.39,0.00
2024-12-10 17:41:02,293,8370,139,154,5946.73,9929.44,0.00
2024-12-10 17:41:02,292,8370,138,154,5915.60,9929.81,0.00
2024-12-10 17:41:02,291,8370,137,154,5918.03,9929.94,0.00
2024-12-10 17:41:02,291,8371,137,154,6146.88,9930.00,0.00
2024-12-10 17:41:02,292,8371,138,154,6125.83,9930.00,0.00
2024-12-10 17:41:02,291,8371,137,154,6100.93,9930.39,0.00
2024-12-10 17:41:02,290,8371,137,153,6086.34,9930.66,0.00
2024-12-10 17:41:02,291,8370,137,154,6062.04,9930.70,0.00
2024-12-10 17:41:02,292,8369,137,155,6043.37,9930.78,0.00
2024-12-10 17:41:02,292,8370,137,155,6088.91,9931.00,0.00
2024-12-10 17:41:02,293,8370,137,156,6068.13,9931.00,0.00
2024-12-10 17:41:02,294,8369,138,156,6046.82,9931.02,0.00
2024-12-10 17:41:02,295,8368,139,156,6019.63,9931.11,0.00
2024-12-10 17:41:02,296,8367,139,157,5990.32,9931.30,0.00
2024-12-10 17:41:02,297,8366,139,158,5909.43,9931.90,0.00
2024-12-10 17:41:02,297,8367,139,158,5993.75,9932.00,0.00
2024-12-10 17:41:02,298,8367,140,158,5973.64,9932.00,0.00
2024-12-10 17:41:02,299,8366,140,159,5935.44,9932.13,0.00
2024-12-10 17:41:02,300,8365,140,160,5906.39,9932.38,0.00
2024-12-10 17:41:02,301,8364,140,161,5909.21,9932.46,0.00
2024-12-10 17:41:02,300,8364,139,161,5909.20,9932.77,0.00
2024-12-10 17:41:02,299,8364,138,161,5903.50,9932.93,0.00
2024-12-10 17:41:02,299,8365,138,161,6062.35,9933.00,0.00
2024-12-10 17:41:02,300,8365,139,161,6042.14,9933.00,0.00
2024-12-10 17:41:02,299,8365,139,160,6052.73,9933.05,0.00
2024-12-10 17:41:02,300,8364,140,160,6028.93,9933.09,0.00
2024-12-10 17:41:02,301,8363,140,161,6026.44,9933.19,0.00
2024-12-10 17:41:02,300,8363,139,161,6032.73,9933.41,0.00
2024-12-10 17:41:02,301,8362,139,162,6004.61,9933.49,0.00
2024-12-10 17:41:02,302,8361,140,162,5947.09,9933.87,0.00
2024-12-10 17:41:02,303,8360,140,163,5912.11,9933.94,0.00
2024-12-10 17:41:02,303,8361,140,163,6038.39,9934.00,0.00
2024-12-10 17:41:02,304,8361,141,163,6018.53,9934.00,0.00
2024-12-10 17:41:02,303,8361,141,162,6031.52,9934.05,0.00
2024-12-10 17:41:02,304,8360,141,163,6008.43,9934.09,0.00
2024-12-10 17:41:02,303,8360,141,162,6024.35,9934.12,0.00
2024-12-10 17:41:02,304,8359,142,162,5993.15,9934.24,0.00
2024-12-10 17:41:02,304,8360,142,162,6100.39,9935.00,0.00
2024-12-10 17:41:02,305,8360,142,163,6080.39,9935.00,0.00
2024-12-10 17:41:02,304,8360,142,162,6090.94,9935.06,0.00
2024-12-10 17:41:02,304,8361,142,162,6078.57,9936.00,0.00
2024-12-10 17:41:02,305,8361,143,162,6058.65,9936.00,0.00
2024-12-10 17:41:02,304,8361,142,162,6060.98,9936.11,0.00
2024-12-10 17:41:02,303,8361,141,162,6058.42,9936.26,0.00
2024-12-10 17:41:02,304,8360,142,162,6009.55,9936.56,0.00
2024-12-10 17:41:02,305,8359,143,162,5987.31,9936.68,0.00
2024-12-10 17:41:02,306,8358,143,163,5975.23,9936.71,0.00
2024-12-10 17:41:02,307,8357,144,163,5960.60,9936.75,0.00
2024-12-10 17:41:02,307,8358,144,163,5971.00,9937.00,0.00
2024-12-10 17:41:02,308,8358,144,164,5951.61,9937.00,0.00
2024-12-10 17:41:02,309,8357,145,164,5931.39,9937.02,0.00
2024-12-10 17:41:02,308,8357,144,164,5972.59,9937.04,0.00
2024-12-10 17:41:02,307,8357,144,163,5989.47,9937.06,0.00
2024-12-10 17:41:02,306,8357,144,162,6001.94,9937.12,0.00
2024-12-10 17:41:02,305,8357,143,162,5977.22,9937.56,0.00
2024-12-10 17:41:02,304,8357,143,161,5977.72,9937.74,0.00
2024-12-10 17:41:02,305,8356,143,162,5932.53,9937.91,0.00
2024-12-10 17:41:02,305,8357,143,162,6075.65,9938.00,0.00
2024-12-10 17:41:02,306,8357,144,162,6055.79,9938.00,0.00
2024-12-10 17:41:02,307,8356,145,162,6021.22,9938.10,0.00
2024-12-10 17:41:02,308,8355,146,162,6005.23,9938.13,0.00
2024-12-10 17:41:02,307,8355,145,162,6004.82,9938.29,0.00
2024-12-10 17:41:02,308,8354,146,162,5909.43,9938.89,0.00
2024-12-10 17:41:02,308,8355,146,162,5997.95,9939.00,0.00
2024-12-10 17:41:02,309,8355,147,162,5978.54,9939.00,0.00
2024-12-10 17:41:02,310,8354,148,162,5958.93,9939.01,0.00
2024-12-10 17:41:02,309,8354,147,162,5984.99,9939.03,0.00
2024-12-10 17:41:02,308,8354,147,161,5996.68,9939.06,0.00
2024-12-10 17:41:02,307,8354,147,160,6009.14,9939.12,0.00
2024-12-10 17:41:02,306,8354,147,159,6028.45,9939.12,0.00
2024-12-10 17:41:02,305,8354,146,159,5968.53,9939.87,0.00
2024-12-10 17:41:02,305,8355,146,159,6058.71,9940.00,0.00
2024-12-10 17:41:02,306,8355,147,159,6038.91,9940.00,0.00
2024-12-10 17:41:02,305,8355,147,158,6039.87,9940.13,0.00
2024-12-10 17:41:02,306,8354,148,158,6007.75,9940.21,0.00
2024-12-10 17:41:02,307,8353,148,159,5963.76,9940.53,0.00
2024-12-10 17:41:02,308,8352,149,159,5926.17,9940.79,0.00
2024-12-10 17:41:02,308,8353,149,159,5946.35,9941.00,0.00
2024-12-10 17:41:02,309,8353,149,160,5927.10,9941.00,0.00
2024-12-10 17:41:02,310,8352,150,160,5890.41,9941.12,0.00
2024-12-10 17:41:02,309,8352,150,159,5915.27,9941.13,0.00
2024-12-10 17:41:02,310,8351,150,160,5863.44,9941.45,0.00
2024-12-10 17:41:02,309,8351,149,160,5838.74,9941.87,0.00
2024-12-10 17:41:02,309,8352,149,160,5926.73,9942.00,0.00
2024-12-10 17:41:02,310,8352,150,160,5907.61,9942.00,0.00
2024-12-10 17:41:02,309,8352,150,159,5920.95,9942.05,0.00
2024-12-10 17:41:02,310,8351,151,159,5897.07,9942.10,0.00
2024-12-10 17:41:02,309,8351,150,159,5921.32,9942.12,0.00
2024-12-10 17:41:02,308,8351,150,158,5928.77,9942.24,0.00
2024-12-10 17:41:02,307,8351,149,158,5943.76,9942.28,0.00
2024-12-10 17:41:02,306,8351,148,158,5922.75,9942.61,0.00
2024-12-10 17:41:02,307,8350,148,159,5885.77,9942.80,0.00
2024-12-10 17:41:02,308,8349,148,160,5860.46,9942.82,0.00
2024-12-10 17:41:02,307,8349,148,159,5871.91,9942.92,0.00
2024-12-10 17:41:02,307,8350,148,159,5961.04,9943.00,0.00
2024-12-10 17:41:02,308,8350,149,159,5941.68,9943.00,0.00
2024-12-10 17:41:02,309,8349,150,159,5908.65,9943.08,0.00
2024-12-10 17:41:02,308,8349,149,159,5924.32,9943.13,0.00
2024-12-10 17:41:02,309,8348,149,160,5893.93,9943.25,0.00
2024-12-10 17:41:02,308,8348,148,160,5859.41,9943.88,0.00
2024-12-10 17:41:02,308,8349,148,160,5968.49,9944.00,0.00
2024-12-10 17:41:02,309,8349,148,161,5949.17,9944.00,0.00
2024-12-10 17:41:02,308,8349,147,161,5968.16,9944.00,0.00
2024-12-10 17:41:02,307,8349,146,161,5985.99,9944.02,0.00
2024-12-10 17:41:03,306,8349,146,160,5914.51,9944.80,0.00
2024-12-10 17:41:03,307,8348,146,161,5880.79,9944.95,0.00
2024-12-10 17:41:03,307,8349,146,161,5961.50,9945.00,0.00
2024-12-10 17:41:03,308,8349,146,162,5942.14,9945.00,0.00
2024-12-10 17:41:03,307,8349,146,161,5954.39,9945.04,0.00
2024-12-10 17:41:03,308,8348,146,162,5918.34,9945.22,0.00
2024-12-10 17:41:03,309,8347,146,163,5853.45,9945.65,0.00
2024-12-10 17:41:03,309,8348,146,163,5873.54,9946.00,0.00
2024-12-10 17:41:03,310,8348,147,163,5854.60,9946.00,0.00
2024-12-10 17:41:03,309,8348,147,162,5854.62,9946.13,0.00
2024-12-10 17:41:03,308,8348,147,161,5872.99,9946.13,0.00
2024-12-10 17:41:03,307,8348,146,161,5859.92,9946.40,0.00
2024-12-10 17:41:03,306,8348,146,160,5864.79,9946.51,0.00
2024-12-10 17:41:03,307,8347,147,160,5833.41,9946.63,0.00
2024-12-10 17:41:03,306,8347,146,160,5822.61,9946.98,0.00
2024-12-10 17:41:03,306,8348,146,160,5917.87,9947.00,0.00
2024-12-10 17:41:03,307,8348,146,161,5898.59,9947.00,0.00
2024-12-10 17:41:03,306,8348,146,160,5908.46,9947.05,0.00
2024-12-10 17:41:03,307,8347,146,161,5883.10,9947.11,0.00
2024-12-10 17:41:03,308,8346,146,162,5866.99,9947.33,0.00
2024-12-10 17:41:03,307,8346,146,161,5907.65,9947.38,0.00
2024-12-10 17:41:03,308,8345,146,162,5854.09,9947.70,0.00
2024-12-10 17:41:03,308,8346,146,162,5870.41,9948.00,0.00
2024-12-10 17:41:03,309,8346,146,163,5851.41,9948.00,0.00
2024-12-10 17:41:03,308,8346,146,162,5859.77,9948.05,0.00
2024-12-10 17:41:03,308,8347,146,162,5863.12,9949.00,0.00
2024-12-10 17:41:03,309,8347,147,162,5844.14,9949.00,0.00
2024-12-10 17:41:03,310,8346,148,162,5822.41,9949.04,0.00
2024-12-10 17:41:03,311,8345,148,163,5799.56,9949.09,0.00
2024-12-10 17:41:03,312,8344,148,164,5760.85,9949.41,0.00
2024-12-10 17:41:03,311,8344,148,163,5708.33,9949.96,0.00
2024-12-10 17:41:03,311,8345,148,163,5735.88,9950.00,0.00
2024-12-10 17:41:03,312,8345,149,163,5717.50,9950.00,0.00
2024-12-10 17:41:03,311,8345,149,162,5716.43,9950.13,0.00
2024-12-10 17:41:03,310,8345,148,162,5698.12,9950.41,0.00
2024-12-10 17:41:03,309,8345,148,161,5693.12,9950.60,0.00
2024-12-10 17:41:03,308,8345,147,161,5687.79,9950.75,0.00
2024-12-10 17:41:03,308,8346,147,161,5788.66,9951.00,0.00
2024-12-10 17:41:03,309,8346,147,162,5769.93,9951.00,0.00
2024-12-10 17:41:03,308,8346,146,162,5786.73,9951.02,0.00
2024-12-10 17:41:03,309,8345,147,162,5758.04,9951.06,0.00
2024-12-10 17:41:03,308,8345,147,161,5787.12,9951.13,0.00
2024-12-10 17:41:03,307,8345,147,160,5799.42,9951.20,0.00
2024-12-10 17:41:03,308,8344,148,160,5738.78,9951.62,0.00
2024-12-10 17:41:03,308,8345,148,160,5728.84,9952.00,0.00
2024-12-10 17:41:03,309,8345,148,161,5710.30,9952.00,0.00
2024-12-10 17:41:03,308,8345,148,160,5717.88,9952.05,0.00
2024-12-10 17:41:03,307,8345,147,160,5700.35,9952.41,0.00
2024-12-10 17:41:03,308,8344,147,161,5653.25,9952.71,0.00
2024-12-10 17:41:03,309,8343,148,161,5620.57,9952.86,0.00
2024-12-10 17:41:03,309,8344,148,161,5694.11,9953.00,0.00
2024-12-10 17:41:03,310,8344,148,162,5675.74,9953.00,0.00
2024-12-10 17:41:03,309,8344,148,161,5673.89,9953.14,0.00
2024-12-10 17:41:03,310,8343,148,162,5579.24,9953.81,0.00
2024-12-10 17:41:03,310,8344,148,162,5653.25,9954.00,0.00
2024-12-10 17:41:03,311,8344,149,162,5635.07,9954.00,0.00
2024-12-10 17:41:03,312,8343,150,162,5617.01,9954.01,0.00
2024-12-10 17:41:03,313,8342,151,162,5565.49,9954.34,0.00
2024-12-10 17:41:03,314,8341,151,163,5565.52,9954.36,0.00
2024-12-10 17:41:03,313,8341,150,163,5535.98,9954.73,0.00
2024-12-10 17:41:03,312,8341,150,162,5535.54,9954.84,0.00
2024-12-10 17:41:03,312,8342,150,162,5581.11,9955.00,0.00
2024-12-10 17:41:03,313,8342,151,162,5563.28,9955.00,0.00
2024-12-10 17:41:03,312,8342,151,161,5548.97,9955.14,0.00
2024-12-10 17:41:03,313,8341,152,161,5518.55,9955.27,0.00
2024-12-10 17:41:03,312,8341,152,160,5513.14,9955.70,0.00
2024-12-10 17:41:03,313,8340,152,161,5495.52,9955.70,0.00
2024-12-10 17:41:03,314,8339,152,162,5463.56,9955.89,0.00
2024-12-10 17:41:03,314,8340,152,162,5580.20,9956.00,0.00
2024-12-10 17:41:03,315,8340,153,162,5562.48,9956.00,0.00
2024-12-10 17:41:03,314,8340,153,161,5571.09,9956.05,0.00
2024-12-10 17:41:03,315,8339,154,161,5551.83,9956.07,0.00
2024-12-10 17:41:03,314,8339,153,161,5568.60,9956.15,0.00
2024-12-10 17:41:03,313,8339,152,161,5557.87,9956.44,0.00
2024-12-10 17:41:03,312,8339,151,161,5547.89,9956.65,0.00
2024-12-10 17:41:03,313,8338,151,162,5510.16,9956.85,0.00
2024-12-10 17:41:03,314,8337,151,163,5496.12,9956.87,0.00
2024-12-10 17:41:03,314,8338,151,163,5598.20,9957.00,0.00
2024-12-10 17:41:03,315,8338,152,163,5580.43,9957.00,0.00
2024-12-10 17:41:03,314,8338,151,163,5596.62,9957.02,0.00
2024-12-10 17:41:03,313,8338,150,163,5595.16,9957.14,0.00
2024-12-10 17:41:03,312,8338,150,162,5612.78,9957.15,0.00
2024-12-10 17:41:03,311,8338,149,162,5630.18,9957.15,0.00
2024-12-10 17:41:03,310,8338,149,161,5648.02,9957.15,0.00
2024-12-10 17:41:03,309,8338,149,160,5665.98,9957.15,0.00
2024-12-10 17:41:03,308,8338,148,160,5656.68,9957.43,0.00
2024-12-10 17:41:03,308,8339,148,160,5708.50,9958.00,0.00
2024-12-10 17:41:03,309,8339,148,161,5690.03,9958.00,0.00
2024-12-10 17:41:03,308,8339,148,160,5687.23,9958.15,0.00
2024-12-10 17:41:03,309,8338,149,160,5644.75,9958.40,0.00
2024-12-10 17:41:03,308,8338,149,159,5654.76,9958.55,0.00
2024-12-10 17:41:03,308,8339,149,159,5618.16,9959.00,0.00
2024-12-10 17:41:03,309,8339,150,159,5599.98,9959.00,0.00
2024-12-10 17:41:03,308,8339,149,159,5616.23,9959.02,0.00
2024-12-10 17:41:03,307,8339,149,158,5614.80,9959.15,0.00
2024-12-10 17:41:03,306,8339,149,157,5627.24,9959.21,0.00
2024-12-10 17:41:04,305,8339,148,157,5553.13,9959.89,0.00
2024-12-10 17:41:04,305,8340,148,157,5590.76,9960.00,0.00
2024-12-10 17:41:04,306,8340,148,158,5572.49,9960.00,0.00
2024-12-10 17:41:04,305,8340,148,157,5439.95,9960.90,0.00
2024-12-10 17:41:04,305,8341,148,157,5462.57,9961.00,0.00
2024-12-10 17:41:04,306,8341,148,158,5444.72,9961.00,0.00
2024-12-10 17:41:04,305,8341,148,157,5455.08,9961.04,0.00
2024-12-10 17:41:04,304,8341,148,156,5383.70,9961.73,0.00
2024-12-10 17:41:04,303,8341,148,155,5397.72,9961.75,0.00
2024-12-10 17:41:04,302,8341,148,154,5399.21,9961.88,0.00
2024-12-10 17:41:04,302,8342,148,154,5420.75,9962.00,0.00
2024-12-10 17:41:04,303,8342,149,154,5402.86,9962.00,0.00
2024-12-10 17:41:04,302,8342,148,154,5403.65,9962.11,0.00
2024-12-10 17:41:04,301,8342,148,153,5416.65,9962.15,0.00
2024-12-10 17:41:04,300,8342,148,152,5434.05,9962.16,0.00
2024-12-10 17:41:04,300,8343,148,152,5366.40,9963.00,0.00
2024-12-10 17:41:04,301,8343,148,153,5348.58,9963.00,0.00
2024-12-10 17:41:04,300,8343,147,153,5363.76,9963.03,0.00
2024-12-10 17:41:04,299,8343,146,153,5362.10,9963.15,0.00
2024-12-10 17:41:04,298,8343,146,152,5379.76,9963.15,0.00
2024-12-10 17:41:04,299,8342,146,153,5312.86,9963.62,0.00
2024-12-10 17:41:04,300,8341,147,153,5302.82,9963.66,0.00
2024-12-10 17:41:04,299,8341,146,153,5317.90,9963.77,0.00
2024-12-10 17:41:04,300,8340,146,154,5291.60,9963.86,0.00
2024-12-10 17:41:04,300,8341,146,154,5311.89,9964.00,0.00
2024-12-10 17:41:04,301,8341,147,154,5294.25,9964.00,0.00
2024-12-10 17:41:04,302,8340,148,154,5260.59,9964.11,0.00
2024-12-10 17:41:04,301,8340,148,153,5297.61,9964.11,0.00
2024-12-10 17:41:04,300,8340,148,152,5310.64,9964.15,0.00
2024-12-10 17:41:04,299,8340,147,152,5328.06,9964.15,0.00
2024-12-10 17:41:04,298,8340,147,151,5335.14,9964.26,0.00
2024-12-10 17:41:04,299,8339,148,151,5297.71,9964.46,0.00
2024-12-10 17:41:04,300,8338,148,152,5253.93,9964.83,0.00
2024-12-10 17:41:04,300,8339,148,152,5362.97,9965.00,0.00
2024-12-10 17:41:04,301,8339,148,153,5345.15,9965.00,0.00
2024-12-10 17:41:04,300,8339,148,152,5351.69,9965.06,0.00
2024-12-10 17:41:04,299,8339,147,152,5359.98,9965.15,0.00
2024-12-10 17:41:04,298,8339,147,151,5325.85,9965.66,0.00
2024-12-10 17:41:04,299,8338,148,151,5301.83,9965.73,0.00
2024-12-10 17:41:04,299,8339,148,151,5398.37,9966.00,0.00
2024-12-10 17:41:04,300,8339,148,152,5380.37,9966.00,0.00
2024-12-10 17:41:04,301,8338,148,153,5361.51,9966.02,0.00
2024-12-10 17:41:04,300,8338,147,153,5381.50,9966.16,0.00
2024-12-10 17:41:04,299,8338,146,153,5367.28,9966.48,0.00
2024-12-10 17:41:04,300,8337,147,153,5346.08,9966.52,0.00
2024-12-10 17:41:04,301,8336,148,153,5294.84,9966.92,0.00
2024-12-10 17:41:04,301,8337,148,153,5369.74,9967.00,0.00
2024-12-10 17:41:04,302,8337,149,153,5351.96,9967.00,0.00
2024-12-10 17:41:04,303,8336,149,154,5321.17,9967.08,0.00
2024-12-10 17:41:04,302,8336,148,154,5344.11,9967.16,0.00
2024-12-10 17:41:04,303,8335,149,154,5314.99,9967.28,0.00
2024-12-10 17:41:04,304,8334,149,155,5293.97,9967.47,0.00
2024-12-10 17:41:04,305,8333,149,156,5263.67,9967.71,0.00
2024-12-10 17:41:04,305,8334,149,156,5375.41,9968.00,0.00
2024-12-10 17:41:04,306,8334,150,156,5357.84,9968.00,0.00
2024-12-10 17:41:04,305,8334,149,156,5370.52,9968.05,0.00
2024-12-10 17:41:04,304,8334,149,155,5380.98,9968.05,0.00
2024-12-10 17:41:04,303,8334,148,155,5388.59,9968.15,0.00
2024-12-10 17:41:04,302,8334,147,155,5375.51,9968.46,0.00
2024-12-10 17:41:04,302,8335,147,155,5472.32,9969.00,0.00
2024-12-10 17:41:04,303,8335,148,155,5454.26,9969.00,0.00
2024-12-10 17:41:04,302,8335,147,155,5468.04,9969.04,0.00
2024-12-10 17:41:04,301,8335,147,154,5468.71,9969.15,0.00
2024-12-10 17:41:04,300,8335,147,153,5426.62,9969.58,0.00
2024-12-10 17:41:04,300,8336,147,153,5412.83,9970.00,0.00
2024-12-10 17:41:04,301,8336,148,153,5394.84,9970.00,0.00
2024-12-10 17:41:04,300,8336,147,153,5410.18,9970.03,0.00
2024-12-10 17:41:04,299,8336,147,152,5408.66,9970.15,0.00
2024-12-10 17:41:04,300,8335,147,153,5386.65,9970.20,0.00
2024-12-10 17:41:04,300,8336,147,153,5339.86,9971.00,0.00
2024-12-10 17:41:04,301,8336,148,153,5322.12,9971.00,0.00
2024-12-10 17:41:04,300,8336,147,153,5321.64,9971.12,0.00
2024-12-10 17:41:04,299,8336,147,152,5335.45,9971.15,0.00
2024-12-10 17:41:04,298,8336,146,152,5353.02,9971.15,0.00
2024-12-10 17:41:04,299,8335,147,152,5327.09,9971.23,0.00
2024-12-10 17:41:04,300,8334,148,152,5313.09,9971.50,0.00
2024-12-10 17:41:04,300,8335,148,152,5332.23,9972.00,0.00
2024-12-10 17:41:04,301,8335,149,152,5314.52,9972.00,0.00
2024-12-10 17:41:04,300,8335,149,151,5321.95,9972.05,0.00
2024-12-10 17:41:04,299,8335,149,150,5329.12,9972.15,0.00
2024-12-10 17:41:04,300,8334,149,151,5301.53,9972.25,0.00
2024-12-10 17:41:04,301,8333,149,152,5261.88,9972.63,0.00
2024-12-10 17:41:04,302,8332,149,153,5260.89,9972.75,0.00
2024-12-10 17:41:04,302,8333,149,153,5327.65,9973.00,0.00
2024-12-10 17:41:04,303,8333,149,154,5310.06,9973.00,0.00
2024-12-10 17:41:04,302,8333,148,154,5325.68,9973.02,0.00
2024-12-10 17:41:04,301,8333,148,153,5337.08,9973.04,0.00
2024-12-10 17:41:04,300,8333,148,152,5343.62,9973.15,0.00
2024-12-10 17:41:04,299,8333,147,152,5342.65,9973.27,0.00
2024-12-10 17:41:04,299,8334,147,152,5397.82,9974.00,0.00
2024-12-10 17:41:04,300,8334,148,152,5379.83,9974.00,0.00
2024-12-10 17:41:04,301,8333,149,152,5287.61,9974.69,0.00
2024-12-10 17:41:04,302,8332,149,153,5241.11,9974.94,0.00
2024-12-10 17:41:05,302,8333,149,153,5270.56,9975.00,0.00
2024-12-10 17:41:05,303,8333,150,153,5253.17,9975.00,0.00
2024-12-10 17:41:05,302,8333,150,152,5248.50,9975.16,0.00
2024-12-10 17:41:05,301,8333,149,152,5265.60,9975.16,0.00
2024-12-10 17:41:05,302,8332,150,152,5245.53,9975.19,0.00
2024-12-10 17:41:05,301,8332,150,151,5223.48,9975.75,0.00
2024-12-10 17:41:05,301,8333,150,151,5287.17,9976.00,0.00
2024-12-10 17:41:05,302,8333,151,151,5269.66,9976.00,0.00
2024-12-10 17:41:05,303,8332,151,152,5241.42,9976.05,0.00
2024-12-10 17:41:05,302,8332,150,152,5221.58,9976.45,0.00
2024-12-10 17:41:05,301,8332,149,152,5190.07,9976.88,0.00
2024-12-10 17:41:05,301,8333,149,152,5231.27,9977.00,0.00
2024-12-10 17:41:05,302,8333,149,153,5213.95,9977.00,0.00
2024-12-10 17:41:05,301,8333,149,152,5226.65,9977.04,0.00
2024-12-10 17:41:05,300,8333,148,152,5237.45,9977.11,0.00
2024-12-10 17:41:05,299,8333,148,151,5248.98,9977.16,0.00
2024-12-10 17:41:05,298,8333,147,151,5262.40,9977.21,0.00
2024-12-10 17:41:05,299,8332,148,151,5220.85,9977.45,0.00
2024-12-10 17:41:05,298,8332,148,150,5188.08,9977.76,0.00
2024-12-10 17:41:05,299,8331,148,151,5168.07,9977.79,0.00
2024-12-10 17:41:05,299,8332,148,151,5221.90,9978.00,0.00
2024-12-10 17:41:05,300,8332,148,152,5204.49,9978.00,0.00
2024-12-10 17:41:05,301,8331,148,153,5185.55,9978.03,0.00
2024-12-10 17:41:05,300,8331,148,152,5191.25,9978.17,0.00
2024-12-10 17:41:05,299,8331,147,152,5176.19,9978.49,0.00
2024-12-10 17:41:05,298,8331,146,152,5161.08,9978.78,0.00
2024-12-10 17:41:05,299,8330,147,152,5131.23,9978.90,0.00
2024-12-10 17:41:05,299,8331,147,152,5225.43,9979.00,0.00
2024-12-10 17:41:05,300,8331,147,153,5208.01,9979.00,0.00
2024-12-10 17:41:05,299,8331,146,153,5202.46,9979.16,0.00
2024-12-10 17:41:05,299,8332,146,153,5213.15,9980.00,0.00
2024-12-10 17:41:05,300,8332,146,154,5195.78,9980.00,0.00
2024-12-10 17:41:05,299,8332,146,153,5192.84,9980.14,0.00
2024-12-10 17:41:05,298,8332,146,152,5207.60,9980.16,0.00
2024-12-10 17:41:05,297,8332,146,151,5203.42,9980.38,0.00
2024-12-10 17:41:05,298,8331,146,152,5178.63,9980.46,0.00
2024-12-10 17:41:05,299,8330,147,152,5152.48,9980.68,0.00
2024-12-10 17:41:05,299,8331,147,152,5185.58,9981.00,0.00
2024-12-10 17:41:05,300,8331,148,152,5168.30,9981.00,0.00
2024-12-10 17:41:05,299,8331,147,152,5106.54,9981.59,0.00
2024-12-10 17:41:05,300,8330,147,153,5065.39,9981.84,0.00
2024-12-10 17:41:05,300,8331,147,153,5149.81,9982.00,0.00
2024-12-10 17:41:05,301,8331,147,154,5132.70,9982.00,0.00
2024-12-10 17:41:05,300,8331,146,154,5147.49,9982.02,0.00
2024-12-10 17:41:05,299,8331,146,153,5158.03,9982.04,0.00
2024-12-10 17:41:05,300,8330,147,153,5135.53,9982.10,0.00
2024-12-10 17:41:05,299,8330,146,153,5162.41,9982.14,0.00
2024-12-10 17:41:05,298,8330,146,152,5176.40,9982.17,0.00
2024-12-10 17:41:05,297,8330,146,151,5193.49,9982.17,0.00
2024-12-10 17:41:05,296,8330,145,151,5168.98,9982.49,0.00
2024-12-10 17:41:05,297,8329,145,152,5131.42,9982.68,0.00
2024-12-10 17:41:05,298,8328,145,153,5110.90,9982.75,0.00
2024-12-10 17:41:05,299,8327,145,154,5094.15,9982.76,0.00
2024-12-10 17:41:05,300,8326,145,155,5079.22,9982.84,0.00
2024-12-10 17:41:05,300,8327,145,155,5116.41,9983.00,0.00
2024-12-10 17:41:05,301,8327,146,155,5099.42,9983.00,0.00
2024-12-10 17:41:05,300,8327,145,155,5113.77,9983.03,0.00
2024-12-10 17:41:05,299,8327,144,155,5115.54,9983.11,0.00
2024-12-10 17:41:05,300,8326,144,156,5094.84,9983.15,0.00
2024-12-10 17:41:05,299,8326,143,156,5130.92,9983.16,0.00
2024-12-10 17:41:05,298,8326,143,155,5147.81,9983.16,0.00
2024-12-10 17:41:05,297,8326,142,155,5146.33,9983.22,0.00
2024-12-10 17:41:05,296,8326,142,154,5134.34,9983.42,0.00
2024-12-10 17:41:05,297,8325,142,155,5078.32,9983.75,0.00
2024-12-10 17:41:05,297,8326,142,155,5256.79,9984.00,0.00
2024-12-10 17:41:05,298,8326,143,155,5239.15,9984.00,0.00
2024-12-10 17:41:05,297,8326,143,154,5232.99,9984.17,0.00
2024-12-10 17:41:05,298,8325,143,155,5192.71,9984.41,0.00
2024-12-10 17:41:05,299,8324,144,155,5180.87,9984.57,0.00
2024-12-10 17:41:05,300,8323,145,155,5137.75,9984.83,0.00
2024-12-10 17:41:05,300,8324,145,155,5214.03,9985.00,0.00
2024-12-10 17:41:05,301,8324,146,155,5196.71,9985.00,0.00
2024-12-10 17:41:05,300,8324,146,154,5205.06,9985.04,0.00
2024-12-10 17:41:05,299,8324,146,153,5209.17,9985.17,0.00
2024-12-10 17:41:05,298,8324,146,152,5226.31,9985.17,0.00
2024-12-10 17:41:05,299,8323,147,152,5182.86,9985.44,0.00
2024-12-10 17:41:05,300,8322,148,152,5127.32,9985.91,0.00
2024-12-10 17:41:05,300,8323,148,152,5239.41,9986.00,0.00
2024-12-10 17:41:05,301,8323,148,153,5222.00,9986.00,0.00
2024-12-10 17:41:05,300,8323,147,153,5224.54,9986.08,0.00
2024-12-10 17:41:05,299,8323,146,153,5233.70,9986.16,0.00
2024-12-10 17:41:05,298,8323,145,153,5201.90,9986.57,0.00
2024-12-10 17:41:05,297,8323,144,153,5184.96,9986.80,0.00
2024-12-10 17:41:05,297,8324,144,153,5260.03,9987.00,0.00
2024-12-10 17:41:05,298,8324,145,153,5242.38,9987.00,0.00
2024-12-10 17:41:05,297,8324,145,152,5247.94,9987.05,0.00
2024-12-10 17:41:05,296,8324,145,151,5254.25,9987.17,0.00
2024-12-10 17:41:05,295,8324,145,150,5271.72,9987.17,0.00
2024-12-10 17:41:05,294,8324,144,150,5247.83,9987.46,0.00
2024-12-10 17:41:05,294,8325,144,150,5197.90,9988.00,0.00
2024-12-10 17:41:05,295,8325,144,151,5180.28,9988.00,0.00
2024-12-10 17:41:05,296,8324,144,152,5161.77,9988.02,0.00
2024-12-10 17:41:05,295,8324,144,151,5177.25,9988.04,0.00
2024-12-10 17:41:05,296,8323,144,152,5152.02,9988.13,0.00
2024-12-10 17:41:05,295,8323,144,151,5196.94,9988.17,0.00
2024-12-10 17:41:05,294,8323,144,150,5214.28,9988.17,0.00
2024-12-10 17:41:05,293,8323,143,150,5183.20,9988.61,0.00
2024-12-10 17:41:05,292,8323,142,150,5170.05,9988.82,0.00
2024-12-10 17:41:05,293,8322,142,151,5135.65,9988.88,0.00
2024-12-10 17:41:05,293,8323,142,151,5156.47,9989.00,0.00
2024-12-10 17:41:05,294,8323,143,151,5138.93,9989.00,0.00
2024-12-10 17:41:05,295,8322,144,151,5121.51,9989.01,0.00
2024-12-10 17:41:05,294,8322,144,150,5145.41,9989.04,0.00
2024-12-10 17:41:05,293,8322,143,150,5162.37,9989.05,0.00
2024-12-10 17:41:05,292,8322,143,149,5168.47,9989.16,0.00
2024-12-10 17:41:05,291,8322,142,149,5164.97,9989.31,0.00
2024-12-10 17:41:05,290,8322,141,149,5163.16,9989.49,0.00
2024-12-10 17:41:05,289,8322,140,149,5137.89,9989.84,0.00
2024-12-10 17:41:06,289,8323,140,149,5255.97,9990.00,0.00
2024-12-10 17:41:06,290,8323,140,150,5237.84,9990.00,0.00
2024-12-10 17:41:06,291,8322,141,150,5215.75,9990.05,0.00
2024-12-10 17:41:06,290,8322,141,149,5231.03,9990.16,0.00
2024-12-10 17:41:06,291,8321,142,149,5155.06,9990.70,0.00
2024-12-10 17:41:06,292,8320,142,150,5145.68,9990.73,0.00
2024-12-10 17:41:06,291,8320,142,149,5149.79,9990.91,0.00
2024-12-10 17:41:06,291,8321,142,149,5209.26,9991.00,0.00
2024-12-10 17:41:06,292,8321,143,149,5191.42,9991.00,0.00
2024-12-10 17:41:06,293,8320,144,149,5170.65,9991.04,0.00
2024-12-10 17:41:06,292,8320,143,149,5199.65,9991.04,0.00
2024-12-10 17:41:06,291,8320,142,149,5198.35,9991.16,0.00
2024-12-10 17:41:06,290,8320,141,149,5195.30,9991.37,0.00
2024-12-10 17:41:06,290,8321,141,149,5266.31,9992.00,0.00
2024-12-10 17:41:06,291,8321,141,150,5248.21,9992.00,0.00
2024-12-10 17:41:06,290,8321,140,150,5242.95,9992.17,0.00
2024-12-10 17:41:06,291,8320,141,150,5209.51,9992.33,0.00
2024-12-10 17:41:06,292,8319,142,150,5180.46,9992.53,0.00
2024-12-10 17:41:06,292,8320,142,150,5214.81,9993.00,0.00
2024-12-10 17:41:06,293,8320,142,151,5197.01,9993.00,0.00
2024-12-10 17:41:06,292,8320,141,151,5196.04,9993.12,0.00
2024-12-10 17:41:06,291,8320,140,151,5209.11,9993.17,0.00
2024-12-10 17:41:06,290,8320,140,150,5226.73,9993.17,0.00
2024-12-10 17:41:06,289,8320,140,149,5244.47,9993.17,0.00
2024-12-10 17:41:06,290,8319,140,150,5149.05,9993.85,0.00
2024-12-10 17:41:06,290,8320,140,150,5233.71,9994.00,0.00
2024-12-10 17:41:06,291,8320,141,150,5215.73,9994.00,0.00
2024-12-10 17:41:06,290,8320,141,149,5220.64,9994.06,0.00
2024-12-10 17:41:06,289,8320,141,148,5234.92,9994.10,0.00
2024-12-10 17:41:06,290,8319,142,148,5214.12,9994.13,0.00
2024-12-10 17:41:06,289,8319,141,148,5254.67,9994.17,0.00
2024-12-10 17:41:06,288,8319,140,148,5241.00,9994.49,0.00
2024-12-10 17:41:06,289,8318,140,149,5172.84,9994.73,0.00
2024-12-10 17:41:06,289,8319,140,149,5224.99,9995.00,0.00
2024-12-10 17:41:06,290,8319,141,149,5206.97,9995.00,0.00
2024-12-10 17:41:06,289,8319,140,149,5221.89,9995.03,0.00
2024-12-10 17:41:06,288,8319,140,148,5233.78,9995.04,0.00
2024-12-10 17:41:06,287,8319,139,148,5239.19,9995.16,0.00
2024-12-10 17:41:06,286,8319,139,147,5257.15,9995.16,0.00
2024-12-10 17:41:06,285,8319,139,146,5217.79,9995.71,0.00
2024-12-10 17:41:06,286,8318,140,146,5177.07,9995.91,0.00
2024-12-10 17:41:06,286,8319,140,146,5262.08,9996.00,0.00
2024-12-10 17:41:06,287,8319,141,146,5243.75,9996.00,0.00
2024-12-10 17:41:06,286,8319,141,145,5256.16,9996.04,0.00
2024-12-10 17:41:06,285,8319,140,145,5269.36,9996.09,0.00
2024-12-10 17:41:06,284,8319,140,144,5280.56,9996.16,0.00
2024-12-10 17:41:06,283,8319,139,144,5291.80,9996.22,0.00
2024-12-10 17:41:06,284,8318,140,144,5255.78,9996.39,0.00
2024-12-10 17:41:06,283,8318,139,144,5297.69,9996.41,0.00
2024-12-10 17:41:06,283,8319,139,144,5282.76,9997.00,0.00
2024-12-10 17:41:06,284,8319,140,144,5264.16,9997.00,0.00
2024-12-10 17:41:06,283,8319,139,144,5278.89,9997.04,0.00
2024-12-10 17:41:06,282,8319,139,143,5278.17,9997.16,0.00
2024-12-10 17:41:06,281,8319,139,142,5296.59,9997.16,0.00
2024-12-10 17:41:06,280,8319,139,141,5315.15,9997.16,0.00
2024-12-10 17:41:06,279,8319,138,141,5299.17,9997.40,0.00
2024-12-10 17:41:06,278,8319,137,141,5303.33,9997.52,0.00
2024-12-10 17:41:06,277,8319,136,141,5275.36,9997.87,0.00
2024-12-10 17:41:06,277,8320,136,141,5335.02,9998.00,0.00
2024-12-10 17:41:06,278,8320,137,141,5315.83,9998.00,0.00
2024-12-10 17:41:06,277,8320,137,140,5328.18,9998.04,0.00
2024-12-10 17:41:06,276,8320,136,140,5335.22,9998.16,0.00
2024-12-10 17:41:06,275,8320,135,140,5354.26,9998.16,0.00
2024-12-10 17:41:06,274,8320,135,139,5373.43,9998.16,0.00
2024-12-10 17:41:06,275,8319,136,139,5299.63,9998.62,0.00
2024-12-10 17:41:06,276,8318,136,140,5257.66,9998.79,0.00
2024-12-10 17:41:06,276,8319,136,140,5268.34,9999.00,0.00
2024-12-10 17:41:06,277,8319,137,140,5249.32,9999.00,0.00
2024-12-10 17:41:06,276,8319,137,139,5257.12,9999.04,0.00
2024-12-10 17:41:06,275,8319,137,138,5264.29,9999.16,0.00
2024-12-10 17:41:06,274,8319,137,137,5283.14,9999.16,0.00
2024-12-10 17:41:06,273,8319,136,137,5268.47,9999.47,0.00
2024-12-10 17:41:06,272,8319,135,137,5286.74,9999.48,0.00
2024-12-10 17:41:06,271,8319,134,137,5269.56,9999.73,0.00
2024-12-10 17:41:06,271,8320,134,137,5334.01,10000.00,0.00
2024-12-10 17:41:06,272,8320,135,137,5314.40,10000.00,0.00
2024-12-10 17:41:06,271,8320,134,137,5332.17,10000.02,0.00
2024-12-10 17:41:06,270,8320,134,136,5343.04,10000.04,0.00
2024-12-10 17:41:06,269,8320,133,136,5352.89,10000.09,0.00
2024-12-10 17:41:06,268,8320,133,135,5368.41,10000.13,0.00
2024-12-10 17:41:06,267,8320,133,134,5386.27,10000.15,0.00
2024-12-10 17:41:06,266,8320,133,133,5406.15,10000.15,0.00
2024-12-10 17:41:06,265,8320,132,133,5426.17,10000.15,0.00
2024-12-10 17:41:06,264,8320,132,132,5428.24,10000.32,0.00
2024-12-10 17:41:06,263,8320,132,131,5427.69,10000.52,0.00
2024-12-10 17:41:06,264,8319,133,131,5394.32,10000.66,0.00
2024-12-10 17:41:06,265,8318,134,131,5361.20,10000.85,0.00
2024-12-10 17:41:06,265,8319,134,131,5383.63,10001.00,0.00
2024-12-10 17:41:06,266,8319,135,131,5363.39,10001.00,0.00
2024-12-10 17:41:06,265,8319,135,130,5361.09,10001.15,0.00
2024-12-10 17:41:06,264,8319,135,129,5381.02,10001.15,0.00
2024-12-10 17:41:06,263,8319,135,128,5401.10,10001.15,0.00
2024-12-10 17:41:06,262,8319,134,128,5410.66,10001.22,0.00
2024-12-10 17:41:06,263,8318,135,128,5359.03,10001.54,0.00
2024-12-10 17:41:06,264,8317,135,129,5295.04,10001.94,0.00
2024-12-10 17:41:06,264,8318,135,129,5404.66,10002.00,0.00
2024-12-10 17:41:06,265,8318,136,129,5384.26,10002.00,0.00
2024-12-10 17:41:06,266,8317,137,129,5362.90,10002.02,0.00
2024-12-10 17:41:06,265,8317,137,128,5381.26,10002.04,0.00
2024-12-10 17:41:06,264,8317,137,127,5389.95,10002.16,0.00
2024-12-10 17:41:06,263,8317,136,127,5410.06,10002.16,0.00
2024-12-10 17:41:06,264,8316,136,128,5357.10,10002.49,0.00
2024-12-10 17:41:06,263,8316,135,128,5345.93,10002.87,0.00
2024-12-10 17:41:06,263,8317,135,128,5431.44,10003.00,0.00
2024-12-10 17:41:06,264,8317,135,129,5410.87,10003.00,0.00
2024-12-10 17:41:06,265,8316,135,130,5389.32,10003.02,0.00
2024-12-10 17:41:06,266,8315,136,130,5367.19,10003.05,0.00
2024-12-10 17:41:06,267,8314,137,130,5306.03,10003.47,0.00
2024-12-10 17:41:06,266,8314,137,129,5290.45,10003.82,0.00
2024-12-10 17:41:06,266,8315,137,129,5375.28,10004.00,0.00
2024-12-10 17:41:06,267,8315,138,129,5355.15,10004.00,0.00
2024-12-10 17:41:06,266,8315,138,128,5362.14,10004.06,0.00
2024-12-10 17:41:06,265,8315,137,128,5372.60,10004.15,0.00
2024-12-10 17:41:06,264,8315,137,127,5392.57,10004.15,0.00
2024-12-10 17:41:06,265,8314,138,127,5354.16,10004.34,0.00
2024-12-10 17:41:06,266,8313,138,128,5291.96,10004.82,0.00
2024-12-10 17:41:06,267,8312,139,128,5278.15,10004.84,0.00
2024-12-10 17:41:06,267,8313,139,128,5403.81,10005.00,0.00
2024-12-10 17:41:06,268,8313,139,129,5383.64,10005.00,0.00
2024-12-10 17:41:06,267,8313,139,128,5399.71,10005.04,0.00
2024-12-10 17:41:07,266,8313,138,128,5409.14,10005.15,0.00
2024-12-10 17:41:07,267,8312,138,129,5349.69,10005.55,0.00
2024-12-10 17:41:07,267,8313,138,129,5450.35,10006.00,0.00
2024-12-10 17:41:07,268,8313,139,129,5430.01,10006.00,0.00
2024-12-10 17:41:07,267,8313,139,128,5444.37,10006.04,0.00
2024-12-10 17:41:07,266,8313,139,127,5455.85,10006.13,0.00
2024-12-10 17:41:07,265,8313,139,126,5474.18,10006.15,0.00
2024-12-10 17:41:07,266,8312,140,126,5445.34,10006.24,0.00
2024-12-10 17:41:07,265,8312,140,125,5433.25,10006.67,0.00
2024-12-10 17:41:07,266,8311,141,125,5400.95,10006.78,0.00
2024-12-10 17:41:07,266,8312,141,125,5462.83,10007.00,0.00
2024-12-10 17:41:07,267,8312,141,126,5442.37,10007.00,0.00
2024-12-10 17:41:07,268,8311,141,127,5420.94,10007.02,0.00
2024-12-10 17:41:07,269,8310,141,128,5388.18,10007.09,0.00
2024-12-10 17:41:07,270,8309,141,129,5370.46,10007.12,0.00
2024-12-10 17:41:07,269,8309,140,129,5380.43,10007.42,0.00
2024-12-10 17:41:07,270,8308,140,130,5331.34,10007.71,0.00
2024-12-10 17:41:07,271,8307,140,131,5307.00,10007.88,0.00
2024-12-10 17:41:07,272,8306,140,132,5278.75,10007.99,0.00
2024-12-10 17:41:07,272,8307,140,132,5388.03,10008.00,0.00
2024-12-10 17:41:07,273,8307,140,133,5368.30,10008.00,0.00
2024-12-10 17:41:07,272,8307,139,133,5385.49,10008.03,0.00
2024-12-10 17:41:07,271,8307,139,132,5402.05,10008.05,0.00
2024-12-10 17:41:07,270,8307,138,132,5412.83,10008.14,0.00
2024-12-10 17:41:07,271,8306,138,133,5372.61,10008.35,0.00
2024-12-10 17:41:07,272,8305,139,133,5373.86,10008.42,0.00
2024-12-10 17:41:07,273,8304,139,134,5383.42,10008.43,0.00
2024-12-10 17:41:07,272,8304,138,134,5401.57,10008.47,0.00
2024-12-10 17:41:07,273,8303,139,134,5331.29,10008.82,0.00
2024-12-10 17:41:07,273,8304,139,134,5578.81,10009.00,0.00
2024-12-10 17:41:07,274,8304,139,135,5558.45,10009.00,0.00
2024-12-10 17:41:07,273,8304,139,134,5557.24,10009.14,0.00
2024-12-10 17:41:07,272,8304,139,133,5576.94,10009.15,0.00
2024-12-10 17:41:07,272,8305,139,133,5668.46,10010.00,0.00
2024-12-10 17:41:07,273,8305,139,134,5647.69,10010.00,0.00
2024-12-10 17:41:07,272,8305,138,134,5646.44,10010.15,0.00
2024-12-10 17:41:07,273,8304,139,134,5579.96,10010.60,0.00
2024-12-10 17:41:07,274,8303,140,134,5540.39,10010.99,0.00
2024-12-10 17:41:07,274,8304,140,134,5576.20,10011.00,0.00
2024-12-10 17:41:07,275,8304,140,135,5555.93,10011.00,0.00
2024-12-10 17:41:07,274,8304,140,134,5553.98,10011.15,0.00
2024-12-10 17:41:07,273,8304,139,134,5573.02,10011.16,0.00
2024-12-10 17:41:07,274,8303,139,135,5514.40,10011.55,0.00
2024-12-10 17:41:07,275,8302,139,136,5508.56,10011.58,0.00
2024-12-10 17:41:07,275,8303,139,136,5571.84,10012.00,0.00
2024-12-10 17:41:07,276,8303,139,137,5551.65,10012.00,0.00
2024-12-10 17:41:07,277,8302,139,138,5526.21,10012.07,0.00
2024-12-10 17:41:07,276,8302,139,137,5559.66,10012.07,0.00
2024-12-10 17:41:07,277,8301,139,138,5538.16,10012.09,0.00
2024-12-10 17:41:07,278,8300,140,138,5515.41,10012.28,0.00
2024-12-10 17:41:07,277,8300,139,138,5487.92,10012.73,0.00
2024-12-10 17:41:07,278,8299,139,139,5453.88,10012.88,0.00
2024-12-10 17:41:07,279,8298,140,139,5458.35,10012.92,0.00
2024-12-10 17:41:07,279,8299,140,139,5559.06,10013.00,0.00
2024-12-10 17:41:07,280,8299,141,139,5539.20,10013.00,0.00
2024-12-10 17:41:07,280,8300,141,139,5643.17,10014.00,0.00
2024-12-10 17:41:07,281,8300,141,140,5623.08,10014.00,0.00
2024-12-10 17:41:07,282,8299,142,140,5514.50,10014.83,0.00
2024-12-10 17:41:07,282,8300,142,140,5536.27,10015.00,0.00
2024-12-10 17:41:07,283,8300,142,141,5516.70,10015.00,0.00
2024-12-10 17:41:07,284,8299,142,142,5455.78,10015.36,0.00
2024-12-10 17:41:07,285,8298,143,142,5426.91,10015.58,0.00
2024-12-10 17:41:07,285,8299,143,142,5462.05,10016.00,0.00
2024-12-10 17:41:07,286,8299,144,142,5442.95,10016.00,0.00
2024-12-10 17:41:07,287,8298,144,143,5408.67,10016.09,0.00
2024-12-10 17:41:07,286,8298,144,142,5453.87,10016.16,0.00
2024-12-10 17:41:07,285,8298,144,141,5472.72,10016.16,0.00
2024-12-10 17:41:07,286,8297,145,141,5443.80,10016.26,0.00
2024-12-10 17:41:07,285,8297,144,141,5441.09,10016.48,0.00
2024-12-10 17:41:07,286,8296,144,142,5362.07,10016.94,0.00
2024-12-10 17:41:07,287,8295,145,142,5342.37,10016.97,0.00
2024-12-10 17:41:07,287,8296,145,142,5445.35,10017.00,0.00
2024-12-10 17:41:07,288,8296,145,143,5426.44,10017.00,0.00
2024-12-10 17:41:07,287,8296,145,142,5435.26,10017.07,0.00
2024-12-10 17:41:07,286,8296,145,141,5445.54,10017.15,0.00
2024-12-10 17:41:07,285,8296,144,141,5464.30,10017.15,0.00
2024-12-10 17:41:07,285,8297,144,141,5536.75,10018.00,0.00
2024-12-10 17:41:07,286,8297,144,142,5517.39,10018.00,0.00
2024-12-10 17:41:07,285,8297,144,141,5510.41,10018.12,0.00
2024-12-10 17:41:07,284,8297,144,140,5527.00,10018.15,0.00
2024-12-10 17:41:07,283,8297,144,139,5546.24,10018.15,0.00
2024-12-10 17:41:07,282,8297,144,138,5565.55,10018.15,0.00
2024-12-10 17:41:07,281,8297,144,137,5563.31,10018.37,0.00
2024-12-10 17:41:07,282,8296,144,138,5522.07,10018.58,0.00
2024-12-10 17:41:07,282,8297,144,138,5527.56,10019.00,0.00
2024-12-10 17:41:07,283,8297,144,139,5508.03,10019.00,0.00
2024-12-10 17:41:07,282,8297,143,139,5522.62,10019.04,0.00
2024-12-10 17:41:07,281,8297,142,139,5523.07,10019.15,0.00
2024-12-10 17:41:07,281,8298,142,139,5505.60,10020.00,0.00
2024-12-10 17:41:07,282,8298,142,140,5486.07,10020.00,0.00
2024-12-10 17:41:07,281,8298,141,140,5502.05,10020.04,0.00
2024-12-10 17:41:07,280,8298,141,139,5513.48,10020.07,0.00
2024-12-10 17:41:07,279,8298,140,139,5529.66,10020.10,0.00
2024-12-10 17:41:07,278,8298,139,139,5544.17,10020.15,0.00
2024-12-10 17:41:07,277,8298,138,139,5563.82,10020.16,0.00
2024-12-10 17:41:07,278,8297,138,140,5510.05,10020.50,0.00
2024-12-10 17:41:07,279,8296,138,141,5508.68,10020.52,0.00
2024-12-10 17:41:07,280,8295,139,141,5451.60,10020.78,0.00
2024-12-10 17:41:07,280,8296,139,141,5463.00,10021.00,0.00
2024-12-10 17:41:07,281,8296,140,141,5443.56,10021.00,0.00
2024-12-10 17:41:07,280,8296,139,141,5456.23,10021.07,0.00
2024-12-10 17:41:07,279,8296,138,141,5459.30,10021.16,0.00
2024-12-10 17:41:07,278,8296,137,141,5473.89,10021.19,0.00
2024-12-10 17:41:07,277,8296,136,141,5475.57,10021.37,0.00
2024-12-10 17:41:07,276,8296,136,140,5491.81,10021.40,0.00
2024-12-10 17:41:08,277,8295,136,141,5458.17,10021.54,0.00
2024-12-10 17:41:08,278,8294,136,142,5449.36,10021.56,0.00
2024-12-10 17:41:08,278,8295,136,142,5559.90,10022.00,0.00
2024-12-10 17:41:08,279,8295,137,142,5539.97,10022.00,0.00
2024-12-10 17:41:08,278,8295,136,142,5556.31,10022.04,0.00
2024-12-10 17:41:08,277,8295,136,141,5570.59,10022.07,0.00
2024-12-10 17:41:08,276,8295,136,140,5588.24,10022.09,0.00
2024-12-10 17:41:08,275,8295,136,139,5601.66,10022.15,0.00
2024-12-10 17:41:08,276,8294,136,140,5537.24,10022.60,0.00
2024-12-10 17:41:08,277,8293,137,140,5520.07,10022.70,0.00
2024-12-10 17:41:08,277,8294,137,140,5585.73,10023.00,0.00
2024-12-10 17:41:08,278,8294,138,140,5565.64,10023.00,0.00
2024-12-10 17:41:08,277,8294,137,140,5562.64,10023.16,0.00
2024-12-10 17:41:08,276,8294,136,140,5574.81,10023.21,0.00
2024-12-10 17:41:08,275,8294,135,140,5567.02,10023.49,0.00
2024-12-10 17:41:08,275,8295,135,140,5609.68,10024.00,0.00
2024-12-10 17:41:08,276,8295,136,140,5589.35,10024.00,0.00
2024-12-10 17:41:08,277,8294,137,140,5568.45,10024.02,0.00
2024-12-10 17:41:08,276,8294,136,140,5605.37,10024.09,0.00
2024-12-10 17:41:08,277,8293,136,141,5579.73,10024.15,0.00
2024-12-10 17:41:08,276,8293,136,140,5628.28,10024.16,0.00
2024-12-10 17:41:08,275,8293,136,139,5648.38,10024.16,0.00
2024-12-10 17:41:08,276,8292,137,139,5626.83,10024.18,0.00
2024-12-10 17:41:08,277,8291,137,140,5602.34,10024.57,0.00
2024-12-10 17:41:08,277,8292,137,140,5588.12,10025.00,0.00
2024-12-10 17:41:08,278,8292,138,140,5568.02,10025.00,0.00
2024-12-10 17:41:08,279,8291,138,141,5543.41,10025.06,0.00
2024-12-10 17:41:08,278,8291,138,140,5479.79,10025.84,0.00
2024-12-10 17:41:08,278,8292,138,140,5635.54,10026.00,0.00
2024-12-10 17:41:08,279,8292,138,141,5615.35,10026.00,0.00
2024-12-10 17:41:08,280,8291,138,142,5543.54,10026.46,0.00
2024-12-10 17:41:08,279,8291,138,141,5541.33,10026.80,0.00
2024-12-10 17:41:08,280,8290,138,142,5512.88,10026.89,0.00
2024-12-10 17:41:08,280,8291,138,142,5564.24,10027.00,0.00
2024-12-10 17:41:08,281,8291,139,142,5544.44,10027.00,0.00
2024-12-10 17:41:08,280,8291,139,141,5554.60,10027.06,0.00
2024-12-10 17:41:08,281,8290,140,141,5527.01,10027.15,0.00
2024-12-10 17:41:08,280,8290,139,141,5568.25,10027.16,0.00
2024-12-10 17:41:08,281,8289,139,142,5521.21,10027.43,0.00
2024-12-10 17:41:08,281,8290,139,142,5571.28,10028.00,0.00
2024-12-10 17:41:08,282,8290,140,142,5551.52,10028.00,0.00
2024-12-10 17:41:08,281,8290,139,142,5551.35,10028.13,0.00
2024-12-10 17:41:08,280,8290,138,142,5568.68,10028.15,0.00
2024-12-10 17:41:08,279,8290,138,141,5587.56,10028.16,0.00
2024-12-10 17:41:08,278,8290,137,141,5607.30,10028.16,0.00
2024-12-10 17:41:08,279,8289,138,141,5509.49,10028.81,0.00
2024-12-10 17:41:08,279,8290,138,141,5604.11,10029.00,0.00
2024-12-10 17:41:08,280,8290,138,142,5584.09,10029.00,0.00
2024-12-10 17:41:08,279,8290,138,141,5581.17,10029.16,0.00
2024-12-10 17:41:08,278,8290,137,141,5591.91,10029.23,0.00
2024-12-10 17:41:08,279,8289,138,141,5571.15,10029.25,0.00
2024-12-10 17:41:08,280,8288,139,141,5552.92,10029.30,0.00
2024-12-10 17:41:08,279,8288,138,141,5538.10,10029.72,0.00
2024-12-10 17:41:08,279,8289,138,141,5579.68,10030.00,0.00
2024-12-10 17:41:08,280,8289,139,141,5559.75,10030.00,0.00
2024-12-10 17:41:08,279,8289,138,141,5556.74,10030.16,0.00
2024-12-10 17:41:08,278,8289,138,140,5576.37,10030.16,0.00
2024-12-10 17:41:08,277,8289,137,140,5541.76,10030.65,0.00
2024-12-10 17:41:08,278,8288,138,140,5502.82,10030.82,0.00
2024-12-10 17:41:08,278,8289,138,140,5587.75,10031.00,0.00
2024-12-10 17:41:08,279,8289,138,141,5567.73,10031.00,0.00
2024-12-10 17:41:08,278,8289,137,141,5587.04,10031.01,0.00
2024-12-10 17:41:08,277,8289,137,140,5595.64,10031.06,0.00
2024-12-10 17:41:08,276,8289,137,139,5606.50,10031.15,0.00
2024-12-10 17:41:08,275,8289,137,138,5626.53,10031.15,0.00
2024-12-10 17:41:08,274,8289,137,137,5646.70,10031.15,0.00
2024-12-10 17:41:08,274,8290,137,137,5610.80,10032.00,0.00
2024-12-10 17:41:08,275,8290,137,138,5590.40,10032.00,0.00
2024-12-10 17:41:08,274,8290,136,138,5607.52,10032.03,0.00
2024-12-10 17:41:08,273,8290,136,137,5623.30,10032.06,0.00
2024-12-10 17:41:08,272,8290,136,136,5634.02,10032.09,0.00
2024-12-10 17:41:08,271,8290,135,136,5602.94,10032.42,0.00
2024-12-10 17:41:08,272,8289,136,136,5569.13,10032.56,0.00
2024-12-10 17:41:08,272,8290,136,136,5561.24,10033.00,0.00
2024-12-10 17:41:08,273,8290,136,137,5540.87,10033.00,0.00
2024-12-10 17:41:08,272,8290,135,137,5558.67,10033.03,0.00
2024-12-10 17:41:08,271,8290,135,136,5572.90,10033.06,0.00
2024-12-10 17:41:08,270,8290,134,136,5584.66,10033.14,0.00
2024-12-10 17:41:08,269,8290,134,135,5604.68,10033.15,0.00
2024-12-10 17:41:08,268,8290,133,135,5624.84,10033.15,0.00
2024-12-10 17:41:08,268,8291,133,135,5602.60,10034.00,0.00
2024-12-10 17:41:08,269,8291,134,135,5581.77,10034.00,0.00
2024-12-10 17:41:08,268,8291,133,135,5600.74,10034.02,0.00
2024-12-10 17:41:08,267,8291,133,134,5601.10,10034.15,0.00
2024-12-10 17:41:08,266,8291,132,134,5580.82,10034.49,0.00
2024-12-10 17:41:08,265,8291,132,133,5574.55,10034.71,0.00
2024-12-10 17:41:08,265,8292,132,133,5583.87,10035.00,0.00
2024-12-10 17:41:08,266,8292,132,134,5562.88,10035.00,0.00
2024-12-10 17:41:08,265,8292,132,133,5574.81,10035.06,0.00
2024-12-10 17:41:08,264,8292,131,133,5577.59,10035.20,0.00
2024-12-10 17:41:08,263,8292,131,132,5564.42,10035.54,0.00
2024-12-10 17:41:08,264,8291,132,132,5514.27,10035.83,0.00
2024-12-10 17:41:08,264,8292,132,132,5542.54,10036.00,0.00
2024-12-10 17:41:08,265,8292,132,133,5521.62,10036.00,0.00
2024-12-10 17:41:08,264,8292,131,133,5514.54,10036.06,0.00
2024-12-10 17:41:08,263,8292,131,132,5535.13,10036.06,0.00
2024-12-10 17:41:08,262,8292,131,131,5555.11,10036.07,0.00
2024-12-10 17:41:08,261,8292,130,131,5569.12,10036.14,0.00
2024-12-10 17:41:08,260,8292,129,131,5590.15,10036.14,0.00
2024-12-10 17:41:08,260,8293,129,131,5579.34,10037.00,0.00
2024-12-10 17:41:08,261,8293,129,132,5557.96,10037.00,0.00
2024-12-10 17:41:08,260,8293,128,132,5565.49,10037.02,0.00
2024-12-10 17:41:08,259,8293,128,131,5577.64,10037.05,0.00
2024-12-10 17:41:08,258,8293,128,130,5590.74,10037.14,0.00
2024-12-10 17:41:08,257,8293,127,130,5612.10,10037.14,0.00
2024-12-10 17:41:08,256,8293,127,129,5633.63,10037.14,0.00
2024-12-10 17:41:09,257,8292,128,129,5589.92,10037.36,0.00
2024-12-10 17:41:09,257,8293,128,129,5566.11,10038.00,0.00
2024-12-10 17:41:09,258,8293,129,129,5544.53,10038.00,0.00
2024-12-10 17:41:09,257,8293,129,128,5554.23,10038.05,0.00
2024-12-10 17:41:09,256,8293,128,128,5567.72,10038.13,0.00
2024-12-10 17:41:09,255,8293,127,128,5581.31,10038.18,0.00
2024-12-10 17:41:09,256,8292,127,129,5536.85,10038.41,0.00
2024-12-10 17:41:09,256,8293,127,129,5569.84,10039.00,0.00
2024-12-10 17:41:09,257,8293,127,130,5548.16,10039.00,0.00
2024-12-10 17:41:09,258,8292,128,130,5488.78,10039.27,0.00
2024-12-10 17:41:09,257,8292,127,130,5533.20,10039.33,0.00
2024-12-10 17:41:09,258,8291,127,131,5505.94,10039.40,0.00
2024-12-10 17:41:09,258,8292,127,131,5520.99,10040.00,0.00
2024-12-10 17:41:09,259,8292,127,132,5499.67,10040.00,0.00
2024-12-10 17:41:09,258,8292,127,131,5495.40,10040.14,0.00
2024-12-10 17:41:09,259,8291,128,131,5412.38,10040.61,0.00
2024-12-10 17:41:09,259,8292,128,131,5511.93,10041.00,0.00
2024-12-10 17:41:09,260,8292,129,131,5490.73,10041.00,0.00
2024-12-10 17:41:09,261,8291,129,132,5467.01,10041.04,0.00
2024-12-10 17:41:09,262,8290,130,132,5466.80,10041.05,0.00
2024-12-10 17:41:09,261,8290,130,131,5487.37,10041.06,0.00
2024-12-10 17:41:09,260,8290,129,131,5482.92,10041.29,0.00
2024-12-10 17:41:09,261,8289,130,131,5452.34,10041.39,0.00
2024-12-10 17:41:09,260,8289,129,131,5490.53,10041.40,0.00
2024-12-10 17:41:09,261,8288,130,131,5468.72,10041.42,0.00
2024-12-10 17:41:09,261,8289,130,131,5493.16,10042.00,0.00
2024-12-10 17:41:09,262,8289,130,132,5472.19,10042.00,0.00
2024-12-10 17:41:09,263,8288,131,132,5434.16,10042.06,0.00
2024-12-10 17:41:09,262,8288,130,132,5472.94,10042.10,0.00
2024-12-10 17:41:09,261,8288,129,132,5488.54,10042.15,0.00
2024-12-10 17:41:09,260,8288,128,132,5479.59,10042.33,0.00
2024-12-10 17:41:09,261,8287,129,132,5418.30,10042.71,0.00
2024-12-10 17:41:09,260,8287,129,131,5437.85,10042.72,0.00
2024-12-10 17:41:09,260,8288,129,131,5578.65,10043.00,0.00
2024-12-10 17:41:09,261,8288,130,131,5557.27,10043.00,0.00
2024-12-10 17:41:09,260,8288,130,130,5560.04,10043.05,0.00
2024-12-10 17:41:09,261,8287,131,130,5533.38,10043.12,0.00
2024-12-10 17:41:09,260,8287,130,130,5563.95,10043.15,0.00
2024-12-10 17:41:09,259,8287,130,129,5585.04,10043.15,0.00
2024-12-10 17:41:09,260,8286,131,129,5542.39,10043.37,0.00
2024-12-10 17:41:09,259,8286,130,129,5538.71,10043.55,0.00
2024-12-10 17:41:09,258,8286,129,129,5524.65,10043.77,0.00
2024-12-10 17:41:09,257,8286,129,128,5531.66,10043.85,0.00
2024-12-10 17:41:09,257,8287,129,128,5622.69,10044.00,0.00
2024-12-10 17:41:09,258,8287,129,129,5600.90,10044.00,0.00
2024-12-10 17:41:09,259,8286,130,129,5533.41,10044.27,0.00
2024-12-10 17:41:09,260,8285,131,129,5518.34,10044.34,0.00
2024-12-10 17:41:09,261,8284,132,129,5517.25,10044.42,0.00
2024-12-10 17:41:09,262,8283,132,130,5503.87,10044.43,0.00
2024-12-10 17:41:09,262,8284,132,130,5546.51,10045.00,0.00
2024-12-10 17:41:09,263,8284,132,131,5525.42,10045.00,0.00
2024-12-10 17:41:09,264,8283,132,132,5504.49,10045.01,0.00
2024-12-10 17:41:09,263,8283,131,132,5534.83,10045.03,0.00
2024-12-10 17:41:09,262,8283,131,131,5536.83,10045.15,0.00
2024-12-10 17:41:09,261,8283,130,131,5549.01,10045.23,0.00
2024-12-10 17:41:09,260,8283,129,131,5551.90,10045.42,0.00
2024-12-10 17:41:09,260,8284,129,131,5642.14,10046.00,0.00
2024-12-10 17:41:09,261,8284,129,132,5620.52,10046.00,0.00
2024-12-10 17:41:09,262,8283,130,132,5573.44,10046.19,0.00
2024-12-10 17:41:09,263,8282,131,132,5551.60,10046.44,0.00
2024-12-10 17:41:09,262,8282,130,132,5540.95,10046.84,0.00
2024-12-10 17:41:09,261,8282,130,131,5531.04,10046.94,0.00
2024-12-10 17:41:09,261,8283,130,131,5594.49,10047.00,0.00
2024-12-10 17:41:09,262,8283,131,131,5573.13,10047.00,0.00
2024-12-10 17:41:09,263,8282,132,131,5550.81,10047.02,0.00
2024-12-10 17:41:09,262,8282,132,130,5586.58,10047.06,0.00
2024-12-10 17:41:09,263,8281,132,131,5565.34,10047.06,0.00
2024-12-10 17:41:09,264,8280,132,132,5554.18,10047.13,0.00
2024-12-10 17:41:09,263,8280,132,131,5584.48,10047.15,0.00
2024-12-10 17:41:09,262,8280,132,130,5605.41,10047.15,0.00
2024-12-10 17:41:09,261,8280,131,130,5613.05,10047.24,0.00
2024-12-10 17:41:09,262,8279,132,130,5568.73,10047.47,0.00
2024-12-10 17:41:09,263,8278,133,130,5567.69,10047.57,0.00
2024-12-10 17:41:09,264,8277,134,130,5548.58,10047.71,0.00
2024-12-10 17:41:09,265,8276,135,130,5537.90,10047.73,0.00
2024-12-10 17:41:09,266,8275,135,131,5530.62,10047.80,0.00
2024-12-10 17:41:09,265,8275,135,130,5549.50,10047.85,0.00
2024-12-10 17:41:09,265,8276,135,130,5642.01,10048.00,0.00
2024-12-10 17:41:09,266,8276,136,130,5620.79,10048.00,0.00
2024-12-10 17:41:09,265,8276,136,129,5631.79,10048.05,0.00
2024-12-10 17:41:09,264,8276,136,128,5644.41,10048.13,0.00
2024-12-10 17:41:09,263,8276,136,127,5630.54,10048.48,0.00
2024-12-10 17:41:09,264,8275,137,127,5592.51,10048.63,0.00
2024-12-10 17:41:09,264,8276,137,127,5888.18,10049.00,0.00
2024-12-10 17:41:09,265,8276,138,127,5865.96,10049.00,0.00
2024-12-10 17:41:09,264,8276,138,126,5866.93,10049.14,0.00
2024-12-10 17:41:09,263,8276,138,125,5888.86,10049.14,0.00
2024-12-10 17:41:09,264,8275,139,125,5851.76,10049.29,0.00
2024-12-10 17:41:09,263,8275,138,125,5848.18,10049.78,0.00
2024-12-10 17:41:09,263,8276,138,125,5878.35,10050.00,0.00
2024-12-10 17:41:09,264,8276,138,126,5856.08,10050.00,0.00
2024-12-10 17:41:09,263,8276,138,125,5867.17,10050.05,0.00
2024-12-10 17:41:09,262,8276,138,124,5878.98,10050.16,0.00
2024-12-10 17:41:09,261,8276,138,123,5812.70,10050.81,0.00
2024-12-10 17:41:09,262,8275,139,123,5790.13,10050.82,0.00
2024-12-10 17:41:09,262,8276,139,123,5854.28,10051.00,0.00
2024-12-10 17:41:09,263,8276,140,123,5832.02,10051.00,0.00
2024-12-10 17:41:09,264,8275,141,123,5789.81,10051.14,0.00
2024-12-10 17:41:09,263,8275,140,123,5819.09,10051.14,0.00
2024-12-10 17:41:09,262,8275,139,123,5826.34,10051.29,0.00
2024-12-10 17:41:09,263,8274,139,124,5794.68,10051.39,0.00
2024-12-10 17:41:09,262,8274,138,124,5819.12,10051.44,0.00
2024-12-10 17:41:09,261,8274,137,124,5840.91,10051.44,0.00
2024-12-10 17:41:09,262,8273,137,125,5791.94,10051.70,0.00
2024-12-10 17:41:09,263,8272,137,126,5778.27,10051.86,0.00
2024-12-10 17:41:09,263,8273,137,126,5844.34,10052.00,0.00
2024-12-10 17:41:09,264,8273,138,126,5822.20,10052.00,0.00
2024-12-10 17:41:09,263,8273,138,125,5830.60,10052.06,0.00
2024-12-10 17:41:09,262,8273,138,124,5845.21,10052.13,0.00
2024-12-10 17:41:09,261,8273,137,124,5866.84,10052.14,0.00
2024-12-10 17:41:09,262,8272,137,125,5802.45,10052.54,0.00
2024-12-10 17:41:09,262,8273,137,125,5945.35,10053.00,0.00
2024-12-10 17:41:09,263,8273,138,125,5922.74,10053.00,0.00
2024-12-10 17:41:10,263,8274,138,125,5859.51,10054.00,0.00
2024-12-10 17:41:10,264,8274,138,126,5837.31,10054.00,0.00
2024-12-10 17:41:10,263,8274,137,126,5856.09,10054.03,0.00
2024-12-10 17:41:10,262,8274,137,125,5872.30,10054.05,0.00
2024-12-10 17:41:10,261,8274,136,125,5885.60,10054.14,0.00
2024-12-10 17:41:10,261,8275,136,125,5801.08,10055.00,0.00
2024-12-10 17:41:10,262,8275,137,125,5778.94,10055.00,0.00
2024-12-10 17:41:10,261,8275,136,125,5798.78,10055.02,0.00
2024-12-10 17:41:10,260,8275,136,124,5818.00,10055.05,0.00
2024-12-10 17:41:10,261,8274,137,124,5789.19,10055.12,0.00
2024-12-10 17:41:10,260,8274,136,124,5836.99,10055.14,0.00
2024-12-10 17:41:10,259,8274,136,123,5859.14,10055.14,0.00
2024-12-10 17:41:10,258,8274,136,122,5881.46,10055.14,0.00
2024-12-10 17:41:10,257,8274,135,122,5877.47,10055.41,0.00
2024-12-10 17:41:10,256,8274,134,122,5898.47,10055.43,0.00
2024-12-10 17:41:10,257,8273,135,122,5871.24,10055.47,0.00
2024-12-10 17:41:10,258,8272,135,123,5820.90,10055.86,0.00
2024-12-10 17:41:10,258,8273,135,123,5833.82,10056.00,0.00
2024-12-10 17:41:10,259,8273,135,124,5811.29,10056.00,0.00
2024-12-10 17:41:10,260,8272,136,124,5787.79,10056.02,0.00
2024-12-10 17:41:10,259,8272,135,124,5809.38,10056.06,0.00
2024-12-10 17:41:10,258,8272,134,124,5820.61,10056.09,0.00
2024-12-10 17:41:10,257,8272,134,123,5842.48,10056.09,0.00
2024-12-10 17:41:10,256,8272,133,123,5861.00,10056.13,0.00
2024-12-10 17:41:10,257,8271,134,123,5783.01,10056.61,0.00
2024-12-10 17:41:10,256,8271,133,123,5799.84,10056.75,0.00
2024-12-10 17:41:10,256,8272,133,123,5911.72,10057.00,0.00
2024-12-10 17:41:10,257,8272,134,123,5888.71,10057.00,0.00
2024-12-10 17:41:10,258,8271,135,123,5850.72,10057.08,0.00
2024-12-10 17:41:10,259,8270,136,123,5836.78,10057.32,0.00
2024-12-10 17:41:10,258,8270,136,122,5839.07,10057.64,0.00
2024-12-10 17:41:10,257,8270,135,122,5839.69,10057.85,0.00
2024-12-10 17:41:10,257,8270,135,122,5936.83,10058.00,0.00
2024-12-10 17:41:10,258,8270,135,123,5913.82,10058.00,0.00
2024-12-10 17:41:10,257,8270,134,123,5932.94,10058.04,0.00
2024-12-10 17:41:10,256,8270,134,122,5938.48,10058.13,0.00
2024-12-10 17:41:10,255,8270,133,122,5961.37,10058.13,0.00
2024-12-10 17:41:10,254,8270,132,122,5945.46,10058.49,0.00
2024-12-10 17:41:10,253,8270,132,121,5917.23,10058.94,0.00
2024-12-10 17:41:10,253,8271,132,121,6030.59,10059.00,0.00
2024-12-10 17:41:10,254,8271,132,122,6006.85,10059.00,0.00
2024-12-10 17:41:10,253,8271,132,121,6023.46,10059.05,0.00
2024-12-10 17:41:10,254,8270,132,122,5997.38,10059.08,0.00
2024-12-10 17:41:10,255,8269,133,122,5975.46,10059.12,0.00
2024-12-10 17:41:10,256,8268,133,123,5932.97,10059.36,0.00
2024-12-10 17:41:10,257,8267,133,124,5914.53,10059.47,0.00
2024-12-10 17:41:10,258,8266,133,125,5881.29,10059.79,0.00
2024-12-10 17:41:10,258,8267,133,125,5885.81,10060.00,0.00
2024-12-10 17:41:10,259,8267,134,125,5863.08,10060.00,0.00
2024-12-10 17:41:10,258,8267,134,124,5877.65,10060.05,0.00
2024-12-10 17:41:10,257,8267,134,123,5893.12,10060.13,0.00
2024-12-10 17:41:10,256,8267,133,123,5905.94,10060.18,0.00
2024-12-10 17:41:10,256,8268,133,123,6050.53,10061.00,0.00
2024-12-10 17:41:10,257,8268,134,123,6026.99,10061.00,0.00
2024-12-10 17:41:10,256,8268,133,123,6036.79,10061.02,0.00
2024-12-10 17:41:10,257,8267,133,124,5977.02,10061.31,0.00
2024-12-10 17:41:10,258,8266,133,125,5928.61,10061.50,0.00
2024-12-10 17:41:10,258,8267,133,125,5929.82,10062.00,0.00
2024-12-10 17:41:10,259,8267,134,125,5906.92,10062.00,0.00
2024-12-10 17:41:10,258,8267,134,124,5923.99,10062.05,0.00
2024-12-10 17:41:10,259,8266,135,124,5870.57,10062.36,0.00
2024-12-10 17:41:10,258,8266,135,123,5901.98,10062.42,0.00
2024-12-10 17:41:10,258,8267,135,123,5944.04,10063.00,0.00
2024-12-10 17:41:10,259,8267,135,124,5921.09,10063.00,0.00
2024-12-10 17:41:10,258,8267,134,124,5940.16,10063.04,0.00
2024-12-10 17:41:10,257,8267,134,123,5951.54,10063.07,0.00
2024-12-10 17:41:10,258,8266,135,123,5910.22,10063.26,0.00
2024-12-10 17:41:10,259,8265,135,124,5879.31,10063.42,0.00
2024-12-10 17:41:10,260,8264,135,125,5876.84,10063.45,0.00
2024-12-10 17:41:10,261,8263,135,126,5860.58,10063.61,0.00
2024-12-10 17:41:10,261,8264,135,126,5909.58,10064.00,0.00
2024-12-10 17:41:10,262,8264,136,126,5887.02,10064.00,0.00
2024-12-10 17:41:10,261,8264,136,125,5894.97,10064.07,0.00
2024-12-10 17:41:10,260,8264,135,125,5912.63,10064.12,0.00
2024-12-10 17:41:10,261,8263,135,126,5862.33,10064.40,0.00
2024-12-10 17:41:10,261,8264,135,126,6009.61,10065.00,0.00
2024-12-10 17:41:10,262,8264,136,126,5986.67,10065.00,0.00
2024-12-10 17:41:10,261,8264,136,125,5989.62,10065.12,0.00
2024-12-10 17:41:10,260,8264,135,125,6012.27,10065.12,0.00
2024-12-10 17:41:10,261,8263,136,125,5984.24,10065.18,0.00
2024-12-10 17:41:10,260,8263,135,125,6002.71,10065.40,0.00
2024-12-10 17:41:10,261,8262,135,126,5945.59,10065.75,0.00
2024-12-10 17:41:10,261,8263,135,126,5986.68,10066.00,0.00
2024-12-10 17:41:10,262,8263,136,126,5963.83,10066.00,0.00
2024-12-10 17:41:10,261,8263,136,125,5975.52,10066.05,0.00
2024-12-10 17:41:10,260,8263,135,125,5993.88,10066.09,0.00
2024-12-10 17:41:10,260,8264,135,125,6002.15,10067.00,0.00
2024-12-10 17:41:10,261,8264,136,125,5979.15,10067.00,0.00
2024-12-10 17:41:10,260,8264,136,124,5981.69,10067.13,0.00
2024-12-10 17:41:10,259,8264,136,123,6003.63,10067.13,0.00
2024-12-10 17:41:10,260,8263,136,124,5913.60,10067.81,0.00
2024-12-10 17:41:10,261,8262,137,124,5883.22,10067.92,0.00
2024-12-10 17:41:10,261,8263,137,124,5916.47,10068.00,0.00
2024-12-10 17:41:10,262,8263,137,125,5893.89,10068.00,0.00
2024-12-10 17:41:10,262,8263,137,125,5895.27,10069.00,0.00
2024-12-10 17:41:10,263,8263,137,126,5872.86,10069.00,0.00
2024-12-10 17:41:10,264,8262,137,127,5817.17,10069.27,0.00
2024-12-10 17:41:10,264,8263,137,127,5800.67,10070.00,0.00
2024-12-10 17:41:10,265,8263,137,128,5778.78,10070.00,0.00
2024-12-10 17:41:10,266,8262,138,128,5753.29,10070.05,0.00
2024-12-10 17:41:11,267,8261,139,128,5700.63,10070.49,0.00
2024-12-10 17:41:11,266,8261,138,128,5691.93,10070.88,0.00
2024-12-10 17:41:11,266,8262,138,128,5756.02,10071.00,0.00
2024-12-10 17:41:11,267,8262,139,128,5734.46,10071.00,0.00
2024-12-10 17:41:11,266,8262,138,128,5753.38,10071.03,0.00
2024-12-10 17:41:11,265,8262,138,127,5770.54,10071.04,0.00
2024-12-10 17:41:11,265,8263,138,127,5769.95,10072.00,0.00
2024-12-10 17:41:11,266,8263,139,127,5748.26,10072.00,0.00
2024-12-10 17:41:11,265,8263,138,127,5749.87,10072.13,0.00
2024-12-10 17:41:11,264,8263,138,126,5771.27,10072.13,0.00
2024-12-10 17:41:11,264,8264,138,126,5712.88,10073.00,0.00
2024-12-10 17:41:11,265,8264,139,126,5691.32,10073.00,0.00
2024-12-10 17:41:11,264,8264,139,125,5691.96,10073.13,0.00
2024-12-10 17:41:11,264,8265,139,125,5633.38,10074.00,0.00
2024-12-10 17:41:11,265,8265,139,126,5612.12,10074.00,0.00
2024-12-10 17:41:11,266,8264,140,126,5547.99,10074.36,0.00
2024-12-10 17:41:11,267,8263,141,126,5494.11,10074.75,0.00
2024-12-10 17:41:11,267,8264,141,126,5503.27,10075.00,0.00
2024-12-10 17:41:11,268,8264,141,127,5482.74,10075.00,0.00
2024-12-10 17:41:11,267,8264,141,126,5489.72,10075.06,0.00
2024-12-10 17:41:11,267,8265,141,126,5491.37,10076.00,0.00
2024-12-10 17:41:11,268,8265,141,127,5470.88,10076.00,0.00
2024-12-10 17:41:11,269,8264,141,128,5445.32,10076.06,0.00
2024-12-10 17:41:11,268,8264,141,127,5472.04,10076.06,0.00
2024-12-10 17:41:11,269,8263,142,127,5443.87,10076.15,0.00
2024-12-10 17:41:11,270,8262,142,128,5405.90,10076.45,0.00
2024-12-10 17:41:11,271,8261,143,128,5352.09,10076.86,0.00
2024-12-10 17:41:11,271,8262,143,128,5366.34,10077.00,0.00
2024-12-10 17:41:11,272,8262,144,128,5346.61,10077.00,0.00
2024-12-10 17:41:11,271,8262,144,127,5344.03,10077.14,0.00
2024-12-10 17:41:11,270,8262,144,126,5363.45,10077.14,0.00
2024-12-10 17:41:11,269,8262,143,126,5317.32,10077.65,0.00
2024-12-10 17:41:11,270,8261,143,127,5272.72,10077.88,0.00
2024-12-10 17:41:11,270,8262,143,127,5452.72,10078.00,0.00
2024-12-10 17:41:11,271,8262,143,128,5432.60,10078.00,0.00
2024-12-10 17:41:11,272,8261,144,128,5393.78,10078.13,0.00
2024-12-10 17:41:11,271,8261,144,127,5421.51,10078.15,0.00
2024-12-10 17:41:11,272,8260,145,127,5401.21,10078.16,0.00
2024-12-10 17:41:11,273,8259,145,128,5414.67,10078.20,0.00
2024-12-10 17:41:11,274,8258,145,129,5382.59,10078.59,0.00
2024-12-10 17:41:11,275,8257,145,130,5367.08,10078.66,0.00
2024-12-10 17:41:11,274,8257,144,130,5397.65,10078.75,0.00
2024-12-10 17:41:11,274,8258,144,130,5440.68,10079.00,0.00
2024-12-10 17:41:11,275,8258,144,131,5420.89,10079.00,0.00
2024-12-10 17:41:11,276,8257,145,131,5385.59,10079.09,0.00
2024-12-10 17:41:11,275,8257,145,130,5433.43,10079.15,0.00
2024-12-10 17:41:11,276,8256,146,130,5358.25,10079.70,0.00
2024-12-10 17:41:11,277,8255,147,130,5326.00,10079.97,0.00
2024-12-10 17:41:11,277,8256,147,130,5531.32,10080.00,0.00
2024-12-10 17:41:11,278,8256,148,130,5511.43,10080.00,0.00
2024-12-10 17:41:11,277,8256,148,129,5518.61,10080.06,0.00
2024-12-10 17:41:11,276,8256,148,128,5529.52,10080.14,0.00
2024-12-10 17:41:11,276,8257,148,128,5571.82,10081.00,0.00
2024-12-10 17:41:11,277,8257,148,129,5551.70,10081.00,0.00
2024-12-10 17:41:11,278,8256,149,129,5530.65,10081.02,0.00
2024-12-10 17:41:11,277,8256,148,129,5556.44,10081.02,0.00
2024-12-10 17:41:11,276,8256,148,128,5568.56,10081.07,0.00
2024-12-10 17:41:11,275,8256,148,127,5580.42,10081.15,0.00
2024-12-10 17:41:11,276,8255,148,128,5480.55,10081.90,0.00
2024-12-10 17:41:11,276,8256,148,128,5510.21,10082.00,0.00
2024-12-10 17:41:11,277,8256,149,128,5490.32,10082.00,0.00
2024-12-10 17:41:11,278,8255,150,128,5470.57,10082.01,0.00
2024-12-10 17:41:11,277,8255,150,127,5482.38,10082.14,0.00
2024-12-10 17:41:11,276,8255,150,126,5501.52,10082.15,0.00
2024-12-10 17:41:11,275,8255,150,125,5520.79,10082.15,0.00
2024-12-10 17:41:11,276,8254,150,126,5494.97,10082.22,0.00
2024-12-10 17:41:11,275,8254,150,125,5539.07,10082.31,0.00
2024-12-10 17:41:11,274,8254,149,125,5541.71,10082.46,0.00
2024-12-10 17:41:11,275,8253,149,126,5488.35,10082.73,0.00
2024-12-10 17:41:11,276,8252,149,127,5459.48,10082.93,0.00
2024-12-10 17:41:11,276,8253,149,127,5563.71,10083.00,0.00
2024-12-10 17:41:11,277,8253,150,127,5543.62,10083.00,0.00
2024-12-10 17:41:11,278,8252,151,127,5521.52,10083.03,0.00
2024-12-10 17:41:11,277,8252,151,126,5534.24,10083.16,0.00
2024-12-10 17:41:11,278,8251,151,127,5495.17,10083.35,0.00
2024-12-10 17:41:11,279,8250,152,127,5482.59,10083.58,0.00
2024-12-10 17:41:11,280,8249,152,128,5450.47,10083.79,0.00
2024-12-10 17:41:11,281,8248,153,128,5435.41,10083.83,0.00
2024-12-10 17:41:11,281,8249,153,128,5605.46,10084.00,0.00
2024-12-10 17:41:11,282,8249,153,129,5585.59,10084.00,0.00
2024-12-10 17:41:11,281,8249,153,128,5594.01,10084.06,0.00
2024-12-10 17:41:11,282,8248,154,128,5567.06,10084.14,0.00
2024-12-10 17:41:11,281,8248,153,128,5606.26,10084.15,0.00
2024-12-10 17:41:12,281,8249,153,128,5717.56,10085.00,0.00
2024-12-10 17:41:12,282,8249,154,128,5697.29,10085.00,0.00
2024-12-10 17:41:12,281,8249,153,128,5702.85,10085.01,0.00
2024-12-10 17:41:12,282,8248,153,129,5681.21,10085.03,0.00
2024-12-10 17:41:12,281,8248,153,128,5692.83,10085.06,0.00
2024-12-10 17:41:12,282,8247,154,128,5664.82,10085.15,0.00
2024-12-10 17:41:12,281,8247,153,128,5686.42,10085.15,0.00
2024-12-10 17:41:12,280,8247,152,128,5706.37,10085.15,0.00
2024-12-10 17:41:12,279,8247,151,128,5706.65,10085.33,0.00
2024-12-10 17:41:12,280,8246,151,129,5656.51,10085.64,0.00
2024-12-10 17:41:12,280,8247,151,129,5700.05,10086.00,0.00
2024-12-10 17:41:12,281,8247,152,129,5679.76,10086.00,0.00
2024-12-10 17:41:12,282,8246,152,130,5617.47,10086.35,0.00
2024-12-10 17:41:12,281,8246,151,130,5578.10,10086.85,0.00
2024-12-10 17:41:12,281,8247,151,130,5706.38,10087.00,0.00
2024-12-10 17:41:12,282,8247,152,130,5686.14,10087.00,0.00
2024-12-10 17:41:12,283,8246,152,131,5662.86,10087.04,0.00
2024-12-10 17:41:12,284,8245,152,132,5639.75,10087.11,0.00
2024-12-10 17:41:12,283,8245,152,131,5652.45,10087.39,0.00
2024-12-10 17:41:12,283,8246,152,131,5645.18,10088.00,0.00
2024-12-10 17:41:12,284,8246,152,132,5625.30,10088.00,0.00
2024-12-10 17:41:12,283,8246,152,131,5633.80,10088.06,0.00
2024-12-10 17:41:12,282,8246,152,130,5644.53,10088.15,0.00
2024-12-10 17:41:12,281,8246,152,129,5663.90,10088.15,0.00
2024-12-10 17:41:12,280,8246,151,129,5656.48,10088.42,0.00
2024-12-10 17:41:12,279,8246,150,129,5653.94,10088.55,0.00
2024-12-10 17:41:12,280,8245,150,130,5618.70,10088.71,0.00
2024-12-10 17:41:12,280,8246,150,130,5704.59,10089.00,0.00
2024-12-10 17:41:12,281,8246,151,130,5684.29,10089.00,0.00
2024-12-10 17:41:12,280,8246,151,129,5697.05,10089.06,0.00
2024-12-10 17:41:12,279,8246,150,129,5708.13,10089.15,0.00
2024-12-10 17:41:12,278,8246,149,129,5728.29,10089.15,0.00
2024-12-10 17:41:12,279,8245,150,129,5663.10,10089.60,0.00
2024-12-10 17:41:12,279,8246,150,129,5694.02,10090.00,0.00
2024-12-10 17:41:12,280,8246,150,130,5673.69,10090.00,0.00
2024-12-10 17:41:12,279,8246,150,129,5672.04,10090.15,0.00
2024-12-10 17:41:12,278,8246,149,129,5691.72,10090.15,0.00
2024-12-10 17:41:12,279,8245,149,130,5620.89,10090.66,0.00
2024-12-10 17:41:12,279,8246,149,130,5657.75,10091.00,0.00
2024-12-10 17:41:12,280,8246,149,131,5637.55,10091.00,0.00
2024-12-10 17:41:12,281,8245,150,131,5614.99,10091.04,0.00
2024-12-10 17:41:12,280,8245,150,130,5633.25,10091.06,0.00
2024-12-10 17:41:12,279,8245,149,130,5613.34,10091.46,0.00
2024-12-10 17:41:12,280,8244,150,130,5588.63,10091.51,0.00
2024-12-10 17:41:12,279,8244,149,130,5584.63,10091.66,0.00
2024-12-10 17:41:12,280,8243,149,131,5550.44,10091.79,0.00
2024-12-10 17:41:12,280,8244,149,131,5607.17,10092.00,0.00
2024-12-10 17:41:12,281,8244,149,132,5587.21,10092.00,0.00
2024-12-10 17:41:12,280,8244,148,132,5603.94,10092.03,0.00
2024-12-10 17:41:12,279,8244,148,131,5603.93,10092.15,0.00
2024-12-10 17:41:12,278,8244,147,131,5623.73,10092.15,0.00
2024-12-10 17:41:12,277,8244,147,130,5637.62,10092.21,0.00
2024-12-10 17:41:12,278,8243,147,131,5563.24,10092.62,0.00
2024-12-10 17:41:12,277,8243,146,131,5597.09,10092.63,0.00
2024-12-10 17:41:12,276,8243,145,131,5604.36,10092.76,0.00
2024-12-10 17:41:12,276,8244,145,131,5722.34,10093.00,0.00
2024-12-10 17:41:12,277,8244,146,131,5701.68,10093.00,0.00
2024-12-10 17:41:12,276,8244,146,130,5714.33,10093.06,0.00
2024-12-10 17:41:12,277,8243,147,130,5662.49,10093.38,0.00
2024-12-10 17:41:12,276,8243,146,130,5683.48,10093.46,0.00
2024-12-10 17:41:12,275,8243,145,130,5663.77,10093.82,0.00
2024-12-10 17:41:12,275,8244,145,130,5718.75,10094.00,0.00
2024-12-10 17:41:12,276,8244,145,131,5698.03,10094.00,0.00
2024-12-10 17:41:12,275,8244,145,130,5707.30,10094.06,0.00
2024-12-10 17:41:12,276,8243,145,131,5665.44,10094.13,0.00
2024-12-10 17:41:12,277,8242,146,131,5649.40,10094.25,0.00
2024-12-10 17:41:12,278,8241,146,132,5642.47,10094.43,0.00
2024-12-10 17:41:12,278,8242,146,132,5676.53,10095.00,0.00
2024-12-10 17:41:12,279,8242,146,133,5656.19,10095.00,0.00
2024-12-10 17:41:12,280,8241,147,133,5633.47,10095.04,0.00
2024-12-10 17:41:12,281,8240,148,133,5613.79,10095.05,0.00
2024-12-10 17:41:12,280,8240,148,132,5655.13,10095.07,0.00
2024-12-10 17:41:12,279,8240,147,132,5666.40,10095.16,0.00
2024-12-10 17:41:12,278,8240,146,132,5646.87,10095.43,0.00
2024-12-10 17:41:12,277,8240,145,132,5666.17,10095.44,0.00
2024-12-10 17:41:12,278,8239,145,133,5637.11,10095.53,0.00
2024-12-10 17:41:12,279,8238,146,133,5609.26,10095.75,0.00
2024-12-10 17:41:12,280,8237,146,134,5574.67,10095.88,0.00
2024-12-10 17:41:12,280,8238,146,134,5725.13,10096.00,0.00
2024-12-10 17:41:12,281,8238,146,135,5704.76,10096.00,0.00
2024-12-10 17:41:12,280,8238,145,135,5702.86,10096.15,0.00
2024-12-10 17:41:12,281,8237,145,136,5668.49,10096.29,0.00
2024-12-10 17:41:12,282,8236,146,136,5664.19,10096.35,0.00
2024-12-10 17:41:12,283,8235,147,136,5670.93,10096.36,0.00
2024-12-10 17:41:12,284,8234,147,137,5643.26,10096.67,0.00
2024-12-10 17:41:12,284,8235,147,137,5829.92,10097.00,0.00
2024-12-10 17:41:12,285,8235,147,138,5809.46,10097.00,0.00
2024-12-10 17:41:12,284,8235,146,138,5781.82,10097.32,0.00
2024-12-10 17:41:12,284,8236,146,138,5879.96,10098.00,0.00
2024-12-10 17:41:12,285,8236,146,139,5859.33,10098.00,0.00
2024-12-10 17:41:12,284,8236,145,139,5875.36,10098.05,0.00
2024-12-10 17:41:12,283,8236,145,138,5892.20,10098.06,0.00
2024-12-10 17:41:12,282,8236,144,138,5904.55,10098.14,0.00
2024-12-10 17:41:12,281,8236,143,138,5925.20,10098.14,0.00
2024-12-10 17:41:12,280,8236,143,137,5935.46,10098.25,0.00
2024-12-10 17:41:12,281,8235,144,137,5908.97,10098.31,0.00
2024-12-10 17:41:12,282,8234,145,137,5914.52,10098.34,0.00
2024-12-10 17:41:12,281,8234,145,136,5895.21,10098.71,0.00
2024-12-10 17:41:12,281,8235,145,136,5881.79,10099.00,0.00
2024-12-10 17:41:12,282,8235,146,136,5860.93,10099.00,0.00
2024-12-10 17:41:12,281,8235,145,136,5859.94,10099.15,0.00
2024-12-10 17:41:12,280,8235,144,136,5880.77,10099.15,0.00
2024-12-10 17:41:12,281,8234,145,136,5801.42,10099.66,0.00
2024-12-10 17:41:12,282,8233,146,136,5790.18,10099.70,0.00
2024-12-10 17:41:13,283,8232,147,136,5760.24,10099.84,0.00
2024-12-10 17:41:13,283,8233,147,136,5856.03,10100.00,0.00
2024-12-10 17:41:13,284,8233,148,136,5835.41,10100.00,0.00
2024-12-10 17:41:13,283,8233,147,136,5834.33,10100.14,0.00
2024-12-10 17:41:13,282,8233,146,136,5854.66,10100.15,0.00
2024-12-10 17:41:13,281,8233,145,136,5815.13,10100.70,0.00
2024-12-10 17:41:13,281,8234,145,136,5917.92,10101.00,0.00
2024-12-10 17:41:13,282,8234,146,136,5896.93,10101.00,0.00
2024-12-10 17:41:13,281,8234,145,136,5895.71,10101.15,0.00
2024-12-10 17:41:13,280,8234,145,135,5916.40,10101.15,0.00
2024-12-10 17:41:13,279,8234,144,135,5900.62,10101.51,0.00
2024-12-10 17:41:13,280,8233,144,136,5858.03,10101.73,0.00
2024-12-10 17:41:13,280,8234,144,136,5868.85,10102.00,0.00
2024-12-10 17:41:13,281,8234,145,136,5847.96,10102.00,0.00
2024-12-10 17:41:13,280,8234,145,135,5856.97,10102.06,0.00
2024-12-10 17:41:13,281,8233,145,136,5809.27,10102.33,0.00
2024-12-10 17:41:13,282,8232,146,136,5814.11,10102.36,0.00
2024-12-10 17:41:13,281,8232,145,136,5818.57,10102.55,0.00
2024-12-10 17:41:13,281,8233,145,136,5823.32,10103.00,0.00
2024-12-10 17:41:13,282,8233,146,136,5802.67,10103.00,0.00
2024-12-10 17:41:13,281,8233,145,136,5800.38,10103.16,0.00
2024-12-10 17:41:13,280,8233,145,135,5813.83,10103.23,0.00
2024-12-10 17:41:13,281,8232,145,136,5767.00,10103.50,0.00
2024-12-10 17:41:13,282,8231,145,137,5767.68,10103.57,0.00
2024-12-10 17:41:13,282,8232,145,137,5852.65,10104.00,0.00
2024-12-10 17:41:13,283,8232,145,138,5831.97,10104.00,0.00
2024-12-10 17:41:13,282,8232,144,138,5829.43,10104.16,0.00
2024-12-10 17:41:13,283,8231,145,138,5803.41,10104.22,0.00
2024-12-10 17:41:13,282,8231,144,138,5836.79,10104.42,0.00
2024-12-10 17:41:13,283,8230,145,138,5795.22,10104.64,0.00
2024-12-10 17:41:13,283,8231,145,138,5875.86,10105.00,0.00
2024-12-10 17:41:13,284,8231,146,138,5855.17,10105.00,0.00
2024-12-10 17:41:13,283,8231,145,138,5871.24,10105.05,0.00
2024-12-10 17:41:13,282,8231,145,137,5883.11,10105.06,0.00
2024-12-10 17:41:13,283,8230,146,137,5816.50,10105.52,0.00
2024-12-10 17:41:13,282,8230,145,137,5840.25,10105.63,0.00
2024-12-10 17:41:13,283,8229,146,137,5818.19,10105.65,0.00
2024-12-10 17:41:13,284,8228,146,138,5797.72,10105.67,0.00
2024-12-10 17:41:13,285,8227,147,138,5783.19,10105.70,0.00
2024-12-10 17:41:13,285,8228,147,138,5864.43,10106.00,0.00
2024-12-10 17:41:13,286,8228,148,138,5843.92,10106.00,0.00
2024-12-10 17:41:13,285,8228,147,138,5863.95,10106.01,0.00
2024-12-10 17:41:13,284,8228,147,137,5847.75,10106.17,0.00
2024-12-10 17:41:13,285,8227,147,138,5767.81,10106.73,0.00
2024-12-10 17:41:13,285,8228,147,138,5923.14,10107.00,0.00
2024-12-10 17:41:13,286,8228,147,139,5902.43,10107.00,0.00
2024-12-10 17:41:13,285,8228,146,139,5917.14,10107.06,0.00
2024-12-10 17:41:13,284,8228,146,138,5933.35,10107.06,0.00
2024-12-10 17:41:13,283,8228,146,137,5948.98,10107.11,0.00
2024-12-10 17:41:13,282,8228,146,136,5966.15,10107.15,0.00
2024-12-10 17:41:13,281,8228,146,135,5986.66,10107.15,0.00
2024-12-10 17:41:13,280,8228,146,134,6007.68,10107.15,0.00
2024-12-10 17:41:13,279,8228,146,133,6028.85,10107.15,0.00
2024-12-10 17:41:13,280,8227,146,134,5947.72,10107.72,0.00
2024-12-10 17:41:13,281,8226,146,135,5912.73,10107.90,0.00
2024-12-10 17:41:13,281,8227,146,135,5963.13,10108.00,0.00
2024-12-10 17:41:13,282,8227,147,135,5941.98,10108.00,0.00
2024-12-10 17:41:13,281,8227,147,134,5940.54,10108.15,0.00
2024-12-10 17:41:13,280,8227,147,133,5961.39,10108.15,0.00
2024-12-10 17:41:13,279,8227,146,133,5982.04,10108.16,0.00
2024-12-10 17:41:13,278,8227,145,133,5986.64,10108.26,0.00
2024-12-10 17:41:13,277,8227,144,133,5992.62,10108.42,0.00
2024-12-10 17:41:13,278,8226,144,134,5959.49,10108.54,0.00
2024-12-10 17:41:13,279,8225,144,135,5916.68,10108.78,0.00
2024-12-10 17:41:13,279,8226,144,135,6008.03,10109.00,0.00
2024-12-10 17:41:13,280,8226,144,136,5986.58,10109.00,0.00
2024-12-10 17:41:13,279,8226,144,135,5997.20,10109.06,0.00
2024-12-10 17:41:13,278,8226,144,134,6007.06,10109.17,0.00
2024-12-10 17:41:13,277,8226,144,133,5967.45,10109.73,0.00
2024-12-10 17:41:13,277,8227,144,133,6030.70,10110.00,0.00
2024-12-10 17:41:13,278,8227,144,134,6009.00,10110.00,0.00
2024-12-10 17:41:13,279,8226,145,134,5980.98,10110.08,0.00
2024-12-10 17:41:13,280,8225,146,134,5942.91,10110.26,0.00
2024-12-10 17:41:13,280,8226,146,134,5922.16,10111.00,0.00
2024-12-10 17:41:13,281,8226,146,135,5901.08,10111.00,0.00
2024-12-10 17:41:13,280,8226,145,135,5904.72,10111.10,0.00
2024-12-10 17:41:13,279,8226,145,134,5922.72,10111.13,0.00
2024-12-10 17:41:13,278,8226,145,133,5940.95,10111.16,0.00
2024-12-10 17:41:13,277,8226,144,133,5935.04,10111.39,0.00
2024-12-10 17:41:13,277,8227,144,133,5974.03,10112.00,0.00
2024-12-10 17:41:13,278,8227,145,133,5952.54,10112.00,0.00
2024-12-10 17:41:13,277,8227,144,133,5972.57,10112.01,0.00
2024-12-10 17:41:13,276,8227,143,133,5985.80,10112.04,0.00
2024-12-10 17:41:13,275,8227,143,132,6000.60,10112.07,0.00
2024-12-10 17:41:13,274,8227,142,132,6018.09,10112.11,0.00
2024-12-10 17:41:13,273,8227,142,131,6034.59,10112.15,0.00
2024-12-10 17:41:13,274,8226,142,132,5984.62,10112.44,0.00
2024-12-10 17:41:13,275,8225,142,133,5930.95,10112.83,0.00
2024-12-10 17:41:13,275,8226,142,133,5950.74,10113.00,0.00
2024-12-10 17:41:13,276,8226,143,133,5929.18,10113.00,0.00
2024-12-10 17:41:13,277,8225,144,133,5902.33,10113.07,0.00
2024-12-10 17:41:13,278,8224,144,134,5882.18,10113.24,0.00
2024-12-10 17:41:13,279,8223,145,134,5845.76,10113.66,0.00
2024-12-10 17:41:13,279,8224,145,134,5910.17,10114.00,0.00
2024-12-10 17:41:13,280,8224,145,135,5889.06,10114.00,0.00
2024-12-10 17:41:13,281,8223,146,135,5848.73,10114.13,0.00
2024-12-10 17:41:13,280,8223,146,134,5874.46,10114.14,0.00
2024-12-10 17:41:13,279,8223,145,134,5872.10,10114.32,0.00
2024-12-10 17:41:13,280,8222,146,134,5827.04,10114.56,0.00
2024-12-10 17:41:13,280,8223,146,134,5911.40,10115.00,0.00
2024-12-10 17:41:13,281,8223,146,135,5890.36,10115.00,0.00
2024-12-10 17:41:13,280,8223,146,134,5888.00,10115.16,0.00
2024-12-10 17:41:14,279,8223,145,134,5908.38,10115.17,0.00
2024-12-10 17:41:14,280,8222,146,134,5877.91,10115.26,0.00
2024-12-10 17:41:14,281,8221,147,134,5841.21,10115.71,0.00
2024-12-10 17:41:14,281,8222,147,134,5876.77,10116.00,0.00
2024-12-10 17:41:14,282,8222,147,135,5855.93,10116.00,0.00
2024-12-10 17:41:14,283,8221,147,136,5834.53,10116.02,0.00
2024-12-10 17:41:14,282,8221,147,135,5872.83,10116.07,0.00
2024-12-10 17:41:14,281,8221,147,134,5883.63,10116.17,0.00
2024-12-10 17:41:14,282,8220,148,134,5823.48,10116.56,0.00
2024-12-10 17:41:14,281,8220,148,133,5838.37,10116.75,0.00
2024-12-10 17:41:14,282,8219,148,134,5810.35,10116.82,0.00
2024-12-10 17:41:14,281,8219,147,134,5821.59,10116.89,0.00
2024-12-10 17:41:14,281,8220,147,134,5903.47,10117.00,0.00
2024-12-10 17:41:14,282,8220,148,134,5882.53,10117.00,0.00
2024-12-10 17:41:14,283,8219,148,135,5831.69,10117.24,0.00
2024-12-10 17:41:14,284,8218,149,135,5826.18,10117.41,0.00
2024-12-10 17:41:14,285,8217,150,135,5776.48,10117.74,0.00
2024-12-10 17:41:14,284,8217,150,134,5756.51,10117.87,0.00
2024-12-10 17:41:14,284,8218,150,134,5871.08,10118.00,0.00
2024-12-10 17:41:14,285,8218,151,134,5850.48,10118.00,0.00
2024-12-10 17:41:14,284,8218,151,133,5857.58,10118.07,0.00
2024-12-10 17:41:14,283,8218,151,132,5868.07,10118.16,0.00
2024-12-10 17:41:14,284,8217,151,133,5807.68,10118.56,0.00
2024-12-10 17:41:14,283,8217,150,133,5807.91,10118.79,0.00
2024-12-10 17:41:14,283,8218,150,133,5892.61,10119.00,0.00
2024-12-10 17:41:14,284,8218,151,133,5871.86,10119.00,0.00
2024-12-10 17:41:14,283,8218,151,132,5868.84,10119.16,0.00
2024-12-10 17:41:14,284,8217,152,132,5788.38,10119.66,0.00
2024-12-10 17:41:14,285,8216,152,133,5744.01,10119.92,0.00
2024-12-10 17:41:14,286,8215,152,134,5704.33,10119.98,0.00
2024-12-10 17:41:14,286,8216,152,134,5786.77,10120.00,0.00
2024-12-10 17:41:14,287,8216,153,134,5766.61,10120.00,0.00
2024-12-10 17:41:14,288,8215,153,135,5740.29,10120.07,0.00
2024-12-10 17:41:14,287,8215,153,134,5759.60,10120.09,0.00
2024-12-10 17:41:14,286,8215,153,133,5772.57,10120.16,0.00
2024-12-10 17:41:14,285,8215,153,132,5792.74,10120.16,0.00
2024-12-10 17:41:14,284,8215,152,132,5784.38,10120.44,0.00
2024-12-10 17:41:14,285,8214,153,132,5737.96,10120.71,0.00
2024-12-10 17:41:14,286,8213,153,133,5714.05,10120.81,0.00
2024-12-10 17:41:14,285,8213,153,132,5740.39,10120.82,0.00
2024-12-10 17:41:14,284,8213,153,131,5729.37,10120.96,0.00
2024-12-10 17:41:14,284,8214,153,131,5828.51,10121.00,0.00
2024-12-10 17:41:14,285,8214,154,131,5808.06,10121.00,0.00
2024-12-10 17:41:14,284,8214,154,130,5821.42,10121.07,0.00
2024-12-10 17:41:14,283,8214,154,129,5832.02,10121.17,0.00
2024-12-10 17:41:14,282,8214,154,128,5814.48,10121.54,0.00
2024-12-10 17:41:14,283,8213,155,128,5760.60,10121.83,0.00
2024-12-10 17:41:14,284,8212,155,129,5742.86,10121.91,0.00
2024-12-10 17:41:14,283,8212,155,128,5751.70,10121.95,0.00
2024-12-10 17:41:14,283,8213,155,128,5864.02,10122.00,0.00
2024-12-10 17:41:14,284,8213,155,129,5843.37,10122.00,0.00
2024-12-10 17:41:14,283,8213,155,128,5848.68,10122.08,0.00
2024-12-10 17:41:14,284,8212,156,128,5823.83,10122.13,0.00
2024-12-10 17:41:14,283,8212,155,128,5853.01,10122.17,0.00
2024-12-10 17:41:14,282,8212,155,127,5873.41,10122.17,0.00
2024-12-10 17:41:14,281,8212,154,127,5885.99,10122.25,0.00
2024-12-10 17:41:14,280,8212,153,127,5889.01,10122.43,0.00
2024-12-10 17:41:14,281,8211,153,128,5867.70,10122.44,0.00
2024-12-10 17:41:14,282,8210,153,129,5816.96,10122.77,0.00
2024-12-10 17:41:14,282,8211,153,129,5889.62,10123.00,0.00
2024-12-10 17:41:14,283,8211,153,130,5868.80,10123.00,0.00
2024-12-10 17:41:14,282,8211,152,130,5819.31,10123.58,0.00
2024-12-10 17:41:14,281,8211,152,129,5791.00,10123.96,0.00
2024-12-10 17:41:14,281,8212,152,129,5929.66,10124.00,0.00
2024-12-10 17:41:14,282,8212,152,130,5908.63,10124.00,0.00
2024-12-10 17:41:14,281,8212,152,129,5915.29,10124.08,0.00
2024-12-10 17:41:14,280,8212,151,129,5927.77,10124.16,0.00
2024-12-10 17:41:14,279,8212,151,128,5947.58,10124.17,0.00
2024-12-10 17:41:14,278,8212,151,127,5898.58,10124.75,0.00
2024-12-10 17:41:14,278,8213,151,127,5904.40,10125.00,0.00
2024-12-10 17:41:14,279,8213,152,127,5883.23,10125.00,0.00
2024-12-10 17:41:14,278,8213,151,127,5874.28,10125.23,0.00
2024-12-10 17:41:14,277,8213,150,127,5883.80,10125.27,0.00
2024-12-10 17:41:14,277,8214,150,127,5836.04,10126.00,0.00
2024-12-10 17:41:14,278,8214,151,127,5815.05,10126.00,0.00
2024-12-10 17:41:14,277,8214,151,126,5820.73,10126.09,0.00
2024-12-10 17:41:14,276,8214,151,125,5837.07,10126.13,0.00
2024-12-10 17:41:14,275,8214,151,124,5854.27,10126.17,0.00
2024-12-10 17:41:14,274,8214,151,123,5875.27,10126.17,0.00
2024-12-10 17:41:14,273,8214,151,122,5896.42,10126.17,0.00
2024-12-10 17:41:14,273,8215,151,122,5824.12,10127.00,0.00
2024-12-10 17:41:14,274,8215,152,122,5802.86,10127.00,0.00
2024-12-10 17:41:14,273,8215,151,122,5822.27,10127.02,0.00
2024-12-10 17:41:14,272,8215,151,121,5820.30,10127.17,0.00
2024-12-10 17:41:14,273,8214,152,121,5718.04,10127.85,0.00
2024-12-10 17:41:14,273,8215,152,121,5745.41,10128.00,0.00
2024-12-10 17:41:14,274,8215,153,121,5724.44,10128.00,0.00
2024-12-10 17:41:14,275,8214,153,122,5685.26,10128.12,0.00
2024-12-10 17:41:14,274,8214,152,122,5731.55,10128.17,0.00
2024-12-10 17:41:14,274,8215,152,122,5706.87,10129.00,0.00
2024-12-10 17:41:14,275,8215,152,123,5686.12,10129.00,0.00
2024-12-10 17:41:14,274,8215,151,123,5704.30,10129.03,0.00
2024-12-10 17:41:14,273,8215,150,123,5703.00,10129.17,0.00
2024-12-10 17:41:14,273,8216,150,123,5673.21,10130.00,0.00
2024-12-10 17:41:14,274,8216,150,124,5652.51,10130.00,0.00
2024-12-10 17:41:14,275,8215,151,124,5601.10,10130.24,0.00
2024-12-10 17:41:14,274,8215,150,124,5631.62,10130.45,0.00
2024-12-10 17:41:14,273,8215,149,124,5597.02,10130.78,0.00
2024-12-10 17:41:14,273,8216,149,124,5611.13,10131.00,0.00
2024-12-10 17:41:14,274,8216,149,125,5590.65,10131.00,0.00
2024-12-10 17:41:14,275,8215,150,125,5569.59,10131.02,0.00
2024-12-10 17:41:14,274,8215,150,124,5585.51,10131.10,0.00
2024-12-10 17:41:15,275,8214,151,124,5518.36,10131.57,0.00
2024-12-10 17:41:15,274,8214,150,124,5539.47,10131.67,0.00
2024-12-10 17:41:15,275,8213,151,124,5490.88,10131.92,0.00
2024-12-10 17:41:15,275,8214,151,124,5558.65,10132.00,0.00
2024-12-10 17:41:15,276,8214,151,125,5538.51,10132.00,0.00
2024-12-10 17:41:15,277,8213,152,125,5494.02,10132.17,0.00
2024-12-10 17:41:15,277,8214,152,125,5560.27,10133.00,0.00
2024-12-10 17:41:15,278,8214,153,125,5540.27,10133.00,0.00
2024-12-10 17:41:15,279,8213,154,125,5498.68,10133.15,0.00
2024-12-10 17:41:15,278,8213,154,124,5527.23,10133.17,0.00
2024-12-10 17:41:15,279,8212,154,125,5470.87,10133.54,0.00
2024-12-10 17:41:15,278,8212,153,125,5479.58,10133.68,0.00
2024-12-10 17:41:15,277,8212,152,125,5493.05,10133.71,0.00
2024-12-10 17:41:15,278,8211,152,126,5448.75,10133.94,0.00
2024-12-10 17:41:15,278,8212,152,126,5518.80,10134.00,0.00
2024-12-10 17:41:15,279,8212,153,126,5499.02,10134.00,0.00
2024-12-10 17:41:15,280,8211,153,127,5472.54,10134.08,0.00
2024-12-10 17:41:15,279,8211,153,126,5516.50,10134.10,0.00
2024-12-10 17:41:15,278,8211,152,126,5528.15,10134.18,0.00
2024-12-10 17:41:15,277,8211,151,126,5489.19,10134.73,0.00
2024-12-10 17:41:15,276,8211,150,126,5500.34,10134.81,0.00
2024-12-10 17:41:15,277,8210,151,126,5480.49,10134.82,0.00
2024-12-10 17:41:15,277,8211,151,126,5596.84,10135.00,0.00
2024-12-10 17:41:15,278,8211,151,127,5576.70,10135.00,0.00
2024-12-10 17:41:15,277,8211,150,127,5577.13,10135.12,0.00
2024-12-10 17:41:15,276,8211,150,126,5592.96,10135.16,0.00
2024-12-10 17:41:15,277,8210,150,127,5570.58,10135.19,0.00
2024-12-10 17:41:15,278,8209,151,127,5540.47,10135.62,0.00
2024-12-10 17:41:15,279,8208,151,128,5504.24,10135.91,0.00
2024-12-10 17:41:15,279,8209,151,128,5601.46,10136.00,0.00
2024-12-10 17:41:15,280,8209,151,129,5581.46,10136.00,0.00
2024-12-10 17:41:15,279,8209,151,128,5577.93,10136.16,0.00
2024-12-10 17:41:15,280,8208,151,129,5460.14,10136.97,0.00
2024-12-10 17:41:15,280,8209,151,129,5603.15,10137.00,0.00
2024-12-10 17:41:15,281,8209,151,130,5583.21,10137.00,0.00
2024-12-10 17:41:15,280,8209,150,130,5599.55,10137.04,0.00
2024-12-10 17:41:15,279,8209,150,129,5599.70,10137.16,0.00
2024-12-10 17:41:15,279,8210,150,129,5556.18,10138.00,0.00
2024-12-10 17:41:15,280,8210,151,129,5536.34,10138.00,0.00
2024-12-10 17:41:15,279,8210,151,128,5533.00,10138.16,0.00
2024-12-10 17:41:15,278,8210,150,128,5470.25,10138.87,0.00
2024-12-10 17:41:15,277,8210,149,128,5474.72,10138.91,0.00
2024-12-10 17:41:15,276,8210,148,128,5477.22,10138.93,0.00
2024-12-10 17:41:15,276,8211,148,128,5507.40,10139.00,0.00
2024-12-10 17:41:15,277,8211,148,129,5487.52,10139.00,0.00
2024-12-10 17:41:15,276,8211,147,129,5503.38,10139.04,0.00
2024-12-10 17:41:15,275,8211,147,128,5514.20,10139.09,0.00
2024-12-10 17:41:15,274,8211,147,127,5528.07,10139.15,0.00
2024-12-10 17:41:15,273,8211,146,127,5474.99,10139.85,0.00
2024-12-10 17:41:15,273,8212,146,127,5481.80,10140.00,0.00
2024-12-10 17:41:15,274,8212,146,128,5461.80,10140.00,0.00
2024-12-10 17:41:15,273,8212,145,128,5474.78,10140.07,0.00
2024-12-10 17:41:15,272,8212,145,127,5484.85,10140.11,0.00
2024-12-10 17:41:15,271,8212,145,126,5500.26,10140.15,0.00
2024-12-10 17:41:15,270,8212,144,126,5500.38,10140.29,0.00
2024-12-10 17:41:15,271,8211,145,126,5456.24,10140.53,0.00
2024-12-10 17:41:15,270,8211,144,126,5494.39,10140.55,0.00
2024-12-10 17:41:15,269,8211,144,125,5502.98,10140.65,0.00
2024-12-10 17:41:15,269,8212,144,125,5505.88,10141.00,0.00
2024-12-10 17:41:15,270,8212,145,125,5485.49,10141.00,0.00
2024-12-10 17:41:15,269,8212,144,125,5482.59,10141.16,0.00
2024-12-10 17:41:15,270,8211,144,126,5439.81,10141.38,0.00
2024-12-10 17:41:15,271,8210,144,127,5407.14,10141.65,0.00
2024-12-10 17:41:15,271,8211,144,127,5456.25,10142.00,0.00
2024-12-10 17:41:15,272,8211,144,128,5436.19,10142.00,0.00
2024-12-10 17:41:15,273,8210,145,128,5414.80,10142.03,0.00
2024-12-10 17:41:15,272,8210,145,127,5430.30,10142.16,0.00
2024-12-10 17:41:15,272,8211,145,127,5445.66,10143.00,0.00
2024-12-10 17:41:15,273,8211,146,127,5425.71,10143.00,0.00
2024-12-10 17:41:15,272,8211,146,126,5429.30,10143.11,0.00
2024-12-10 17:41:15,271,8211,145,126,5444.12,10143.16,0.00
2024-12-10 17:41:15,270,8211,144,126,5463.91,10143.16,0.00
2024-12-10 17:41:15,269,8211,143,126,5483.85,10143.16,0.00
2024-12-10 17:41:15,268,8211,142,126,5453.98,10143.63,0.00
2024-12-10 17:41:15,269,8210,142,127,5428.03,10143.69,0.00
2024-12-10 17:41:15,270,8209,142,128,5418.10,10143.73,0.00
2024-12-10 17:41:15,270,8210,142,128,5478.42,10144.00,0.00
2024-12-10 17:41:15,271,8210,142,129,5458.21,10144.00,0.00
2024-12-10 17:41:15,270,8210,141,129,5473.19,10144.05,0.00
2024-12-10 17:41:15,269,8210,140,129,5487.89,10144.07,0.00
2024-12-10 17:41:15,268,8210,140,128,5492.89,10144.15,0.00
2024-12-10 17:41:15,267,8210,140,127,5512.70,10144.15,0.00
2024-12-10 17:41:15,268,8209,140,128,5442.74,10144.65,0.00
2024-12-10 17:41:15,269,8208,141,128,5423.11,10144.80,0.00
2024-12-10 17:41:15,269,8209,141,128,5525.48,10145.00,0.00
2024-12-10 17:41:15,270,8209,141,129,5505.01,10145.00,0.00
2024-12-10 17:41:15,269,8209,141,128,5502.73,10145.15,0.00
2024-12-10 17:41:15,268,8209,140,128,5519.86,10145.18,0.00
2024-12-10 17:41:15,268,8210,140,128,5549.59,10146.00,0.00
2024-12-10 17:41:15,269,8210,140,129,5528.96,10146.00,0.00
2024-12-10 17:41:15,268,8210,140,128,5512.19,10146.16,0.00
2024-12-10 17:41:15,267,8210,139,128,5507.75,10146.40,0.00
2024-12-10 17:41:15,268,8209,140,128,5445.14,10146.81,0.00
2024-12-10 17:41:15,268,8210,140,128,5471.10,10147.00,0.00
2024-12-10 17:41:15,269,8210,140,129,5450.76,10147.00,0.00
2024-12-10 17:41:15,268,8210,139,129,5458.58,10147.09,0.00
2024-12-10 17:41:15,267,8210,138,129,5478.27,10147.09,0.00
2024-12-10 17:41:15,266,8210,138,128,5495.05,10147.09,0.00
2024-12-10 17:41:15,265,8210,138,127,5508.93,10147.16,0.00
2024-12-10 17:41:15,264,8210,138,126,5528.65,10147.17,0.00
2024-12-10 17:41:15,263,8210,138,125,5544.49,10147.20,0.00
2024-12-10 17:41:16,263,8211,138,125,5531.23,10148.00,0.00
2024-12-10 17:41:16,264,8211,138,126,5510.28,10148.00,0.00
2024-12-10 17:41:16,263,8211,137,126,5506.61,10148.17,0.00
2024-12-10 17:41:16,264,8210,137,127,5400.79,10148.88,0.00
2024-12-10 17:41:16,264,8211,137,127,5419.25,10149.00,0.00
2024-12-10 17:41:16,265,8211,138,127,5398.80,10149.00,0.00
2024-12-10 17:41:16,264,8211,138,126,5413.51,10149.06,0.00
2024-12-10 17:41:16,263,8211,137,126,5415.23,10149.16,0.00
2024-12-10 17:41:16,262,8211,136,126,5435.51,10149.16,0.00
2024-12-10 17:41:16,263,8210,137,126,5384.46,10149.47,0.00
2024-12-10 17:41:16,262,8210,136,126,5407.33,10149.58,0.00
2024-12-10 17:41:16,263,8209,137,126,5320.90,10149.97,0.00
2024-12-10 17:41:16,263,8210,137,126,5396.95,10150.00,0.00
2024-12-10 17:41:16,264,8210,138,126,5376.51,10150.00,0.00
2024-12-10 17:41:16,263,8210,138,125,5384.26,10150.09,0.00
2024-12-10 17:41:16,262,8210,138,124,5397.87,10150.16,0.00
2024-12-10 17:41:16,261,8210,137,124,5418.16,10150.16,0.00
2024-12-10 17:41:16,260,8210,136,124,5435.31,10150.20,0.00
2024-12-10 17:41:16,259,8210,135,124,5429.30,10150.35,0.00
2024-12-10 17:41:16,260,8209,135,125,5375.09,10150.66,0.00
2024-12-10 17:41:16,259,8209,134,125,5376.57,10150.93,0.00
2024-12-10 17:41:16,259,8210,134,125,5463.61,10151.00,0.00
2024-12-10 17:41:16,260,8210,135,125,5442.60,10151.00,0.00
2024-12-10 17:41:16,259,8210,134,125,5438.99,10151.17,0.00
2024-12-10 17:41:16,259,8211,134,125,5406.34,10152.00,0.00
2024-12-10 17:41:16,260,8211,135,125,5385.54,10152.00,0.00
2024-12-10 17:41:16,259,8211,135,124,5303.02,10152.79,0.00
2024-12-10 17:41:16,259,8212,135,124,5306.84,10153.00,0.00
2024-12-10 17:41:16,260,8212,136,124,5286.43,10153.00,0.00
2024-12-10 17:41:16,261,8211,136,125,5232.32,10153.27,0.00
2024-12-10 17:41:16,260,8211,136,124,5251.33,10153.45,0.00
2024-12-10 17:41:16,261,8210,137,124,5218.42,10153.59,0.00
2024-12-10 17:41:16,262,8209,137,125,5190.14,10153.68,0.00
2024-12-10 17:41:16,261,8209,137,124,5194.30,10153.92,0.00
2024-12-10 17:41:16,261,8210,137,124,5214.52,10154.00,0.00
2024-12-10 17:41:16,262,8210,137,125,5194.62,10154.00,0.00
2024-12-10 17:41:16,261,8210,137,124,5197.05,10154.10,0.00
2024-12-10 17:41:16,262,8209,138,124,5086.21,10154.96,0.00
2024-12-10 17:41:16,262,8210,138,124,5223.44,10155.00,0.00
2024-12-10 17:41:16,263,8210,139,124,5203.58,10155.00,0.00
2024-12-10 17:41:16,264,8209,139,125,5178.89,10155.06,0.00
2024-12-10 17:41:16,263,8209,138,125,5192.07,10155.17,0.00
2024-12-10 17:41:16,262,8209,137,125,5211.50,10155.18,0.00
2024-12-10 17:41:16,261,8209,137,124,5231.08,10155.18,0.00
2024-12-10 17:41:16,262,8208,137,125,5209.18,10155.20,0.00
2024-12-10 17:41:16,263,8207,137,126,5197.38,10155.46,0.00
2024-12-10 17:41:16,264,8206,138,126,5181.33,10155.66,0.00
2024-12-10 17:41:16,264,8207,138,126,5216.28,10156.00,0.00
2024-12-10 17:41:16,265,8207,139,126,5196.60,10156.00,0.00
2024-12-10 17:41:16,266,8206,140,126,5169.45,10156.09,0.00
2024-12-10 17:41:16,265,8206,140,125,5191.68,10156.17,0.00
2024-12-10 17:41:16,266,8205,140,126,5150.11,10156.39,0.00
2024-12-10 17:41:16,267,8204,141,126,5102.76,10156.73,0.00
2024-12-10 17:41:16,267,8205,141,126,5268.08,10157.00,0.00
2024-12-10 17:41:16,268,8205,141,127,5248.42,10157.00,0.00
2024-12-10 17:41:16,269,8204,142,127,5227.40,10157.03,0.00
2024-12-10 17:41:16,268,8204,142,126,5236.33,10157.11,0.00
2024-12-10 17:41:16,268,8205,142,126,5276.41,10158.00,0.00
2024-12-10 17:41:16,269,8205,143,126,5256.79,10158.00,0.00
2024-12-10 17:41:16,270,8204,143,127,5232.82,10158.06,0.00
2024-12-10 17:41:16,269,8204,143,126,5250.06,10158.17,0.00
2024-12-10 17:41:16,268,8204,142,126,5266.30,10158.21,0.00
2024-12-10 17:41:16,267,8204,141,126,5227.85,10158.64,0.00
2024-12-10 17:41:16,268,8203,142,126,5179.43,10158.85,0.00
2024-12-10 17:41:16,268,8204,142,126,5242.67,10159.00,0.00
2024-12-10 17:41:16,269,8204,142,127,5223.18,10159.00,0.00
2024-12-10 17:41:16,268,8204,141,127,5237.01,10159.06,0.00
2024-12-10 17:41:16,267,8204,141,126,5246.37,10159.11,0.00
2024-12-10 17:41:16,266,8204,140,126,5259.25,10159.17,0.00
2024-12-10 17:41:16,265,8204,140,125,5278.71,10159.17,0.00
2024-12-10 17:41:16,264,8204,140,124,5298.32,10159.17,0.00
2024-12-10 17:41:16,265,8203,140,125,5250.43,10159.46,0.00
2024-12-10 17:41:16,264,8203,139,125,5288.87,10159.54,0.00
2024-12-10 17:41:16,264,8204,139,125,5337.61,10160.00,0.00
2024-12-10 17:41:16,265,8204,139,126,5317.47,10160.00,0.00
2024-12-10 17:41:16,264,8204,138,126,5287.69,10160.33,0.00
2024-12-10 17:41:16,265,8203,138,127,5248.26,10160.53,0.00
2024-12-10 17:41:16,264,8203,138,126,5259.37,10160.78,0.00
2024-12-10 17:41:16,264,8204,138,126,5301.15,10161.00,0.00
2024-12-10 17:41:16,265,8204,139,126,5281.14,10161.00,0.00
2024-12-10 17:41:16,264,8204,138,126,5292.68,10161.00,0.00
2024-12-10 17:41:16,263,8204,137,126,5305.88,10161.07,0.00
2024-12-10 17:41:16,262,8204,137,125,5315.68,10161.11,0.00
2024-12-10 17:41:16,261,8204,137,124,5330.22,10161.17,0.00
2024-12-10 17:41:16,260,8204,136,124,5324.59,10161.34,0.00
2024-12-10 17:41:16,261,8203,136,125,5258.65,10161.75,0.00
2024-12-10 17:41:16,260,8203,135,125,5268.35,10161.89,0.00
2024-12-10 17:41:16,260,8204,135,125,5334.00,10162.00,0.00
2024-12-10 17:41:16,261,8204,135,126,5313.57,10162.00,0.00
2024-12-10 17:41:16,260,8204,134,126,5282.68,10162.43,0.00
2024-12-10 17:41:16,259,8204,133,126,5296.82,10162.49,0.00
2024-12-10 17:41:16,260,8203,134,126,5228.07,10162.76,0.00
2024-12-10 17:41:16,261,8202,134,127,5213.36,10162.80,0.00
2024-12-10 17:41:16,261,8203,134,127,5278.79,10163.00,0.00
2024-12-10 17:41:16,262,8203,135,127,5258.65,10163.00,0.00
2024-12-10 17:41:16,261,8203,134,127,5272.98,10163.06,0.00
2024-12-10 17:41:16,260,8203,133,127,5292.48,10163.06,0.00
2024-12-10 17:41:16,259,8203,133,126,5304.69,10163.12,0.00
2024-12-10 17:41:16,258,8203,133,125,5319.76,10163.17,0.00
2024-12-10 17:41:16,257,8203,132,125,5340.06,10163.17,0.00
2024-12-10 17:41:16,256,8203,132,124,5360.53,10163.17,0.00
2024-12-10 17:41:16,255,8203,132,123,5380.75,10163.17,0.00
2024-12-10 17:41:16,254,8203,131,123,5367.29,10163.48,0.00
2024-12-10 17:41:16,255,8202,131,124,5327.22,10163.59,0.00
2024-12-10 17:41:16,256,8201,131,125,5318.76,10163.66,0.00
2024-12-10 17:41:16,256,8202,131,125,5413.11,10164.00,0.00
2024-12-10 17:41:16,257,8202,131,126,5392.05,10164.00,0.00
2024-12-10 17:41:16,256,8202,131,125,5378.33,10164.18,0.00
2024-12-10 17:41:17,256,8203,131,125,5390.07,10165.00,0.00
2024-12-10 17:41:17,257,8203,131,126,5369.09,10165.00,0.00
2024-12-10 17:41:17,256,8203,131,125,5349.23,10165.18,0.00
2024-12-10 17:41:17,257,8202,131,126,5313.82,10165.33,0.00
2024-12-10 17:41:17,257,8203,131,126,5292.52,10166.00,0.00
2024-12-10 17:41:17,258,8203,131,127,5272.01,10166.00,0.00
2024-12-10 17:41:17,257,8203,130,127,5280.60,10166.09,0.00
2024-12-10 17:41:17,256,8203,130,126,5295.28,10166.13,0.00
2024-12-10 17:41:17,255,8203,129,126,5310.88,10166.17,0.00
2024-12-10 17:41:17,254,8203,129,125,5288.01,10166.47,0.00
2024-12-10 17:41:17,253,8203,128,125,5284.89,10166.68,0.00
2024-12-10 17:41:17,254,8202,128,126,5229.81,10166.98,0.00
2024-12-10 17:41:17,254,8203,128,126,5308.68,10167.00,0.00
2024-12-10 17:41:17,255,8203,129,126,5287.86,10167.00,0.00
2024-12-10 17:41:17,256,8202,129,127,5262.06,10167.06,0.00
2024-12-10 17:41:17,255,8202,128,127,5289.10,10167.12,0.00
2024-12-10 17:41:17,254,8202,128,126,5296.34,10167.17,0.00
2024-12-10 17:41:17,253,8202,127,126,5316.87,10167.17,0.00
2024-12-10 17:41:17,252,8202,126,126,5314.87,10167.33,0.00
2024-12-10 17:41:17,253,8201,127,126,5283.86,10167.43,0.00
2024-12-10 17:41:17,252,8201,126,126,5331.69,10167.45,0.00
2024-12-10 17:41:17,251,8201,125,126,5341.73,10167.48,0.00
2024-12-10 17:41:17,251,8202,125,126,5362.01,10168.00,0.00
2024-12-10 17:41:17,252,8202,125,127,5340.74,10168.00,0.00
2024-12-10 17:41:17,253,8201,126,127,5224.81,10168.83,0.00
2024-12-10 17:41:17,253,8202,126,127,5314.43,10169.00,0.00
2024-12-10 17:41:17,254,8202,126,128,5293.51,10169.00,0.00
2024-12-10 17:41:17,255,8201,127,128,5262.82,10169.11,0.00
2024-12-10 17:41:17,254,8201,127,127,5293.56,10169.13,0.00
2024-12-10 17:41:17,253,8201,126,127,5278.42,10169.48,0.00
2024-12-10 17:41:17,253,8202,126,127,5277.26,10170.00,0.00
2024-12-10 17:41:17,254,8202,127,127,5256.48,10170.00,0.00
2024-12-10 17:41:17,253,8202,126,127,5270.05,10170.07,0.00
2024-12-10 17:41:17,252,8202,126,126,5277.66,10170.12,0.00
2024-12-10 17:41:17,251,8202,125,126,5293.04,10170.17,0.00
2024-12-10 17:41:17,250,8202,124,126,5290.25,10170.33,0.00
2024-12-10 17:41:17,249,8202,124,125,5236.09,10170.92,0.00
2024-12-10 17:41:17,249,8203,124,125,5309.69,10171.00,0.00
2024-12-10 17:41:17,250,8203,124,126,5288.45,10171.00,0.00
2024-12-10 17:41:17,249,8203,123,126,5284.40,10171.12,0.00
2024-12-10 17:41:17,248,8203,123,125,5302.84,10171.13,0.00
2024-12-10 17:41:17,247,8203,122,125,5272.03,10171.56,0.00
2024-12-10 17:41:17,247,8204,122,125,5266.60,10172.00,0.00
2024-12-10 17:41:17,248,8204,122,126,5245.36,10172.00,0.00
2024-12-10 17:41:17,247,8204,121,126,5257.76,10172.09,0.00
2024-12-10 17:41:17,248,8203,121,127,5235.74,10172.10,0.00
2024-12-10 17:41:17,249,8202,122,127,5173.49,10172.42,0.00
2024-12-10 17:41:17,249,8203,122,127,5166.73,10173.00,0.00
2024-12-10 17:41:17,250,8203,123,127,5146.06,10173.00,0.00
2024-12-10 17:41:17,249,8203,122,127,5142.27,10173.16,0.00
2024-12-10 17:41:17,248,8203,122,126,5144.90,10173.31,0.00
2024-12-10 17:41:17,249,8202,123,126,5094.83,10173.57,0.00
2024-12-10 17:41:17,249,8203,123,126,5168.31,10174.00,0.00
2024-12-10 17:41:17,250,8203,124,126,5147.63,10174.00,0.00
2024-12-10 17:41:17,249,8203,123,126,5162.20,10174.06,0.00
2024-12-10 17:41:17,248,8203,122,126,5178.52,10174.10,0.00
2024-12-10 17:41:17,247,8203,121,126,5184.68,10174.16,0.00
2024-12-10 17:41:17,248,8202,121,127,5162.13,10174.19,0.00
2024-12-10 17:41:17,249,8201,121,128,5131.44,10174.53,0.00
2024-12-10 17:41:17,249,8202,121,128,5166.67,10175.00,0.00
2024-12-10 17:41:17,250,8202,121,129,5146.00,10175.00,0.00
2024-12-10 17:41:17,249,8202,120,129,5157.17,10175.10,0.00
2024-12-10 17:41:17,248,8202,120,128,5168.12,10175.11,0.00
2024-12-10 17:41:17,247,8202,120,127,5184.12,10175.15,0.00
2024-12-10 17:41:17,246,8202,119,127,5200.49,10175.20,0.00
2024-12-10 17:41:17,245,8202,118,127,5160.11,10175.70,0.00
2024-12-10 17:41:17,245,8203,118,127,5222.34,10176.00,0.00
2024-12-10 17:41:17,246,8203,118,128,5201.11,10176.00,0.00
2024-12-10 17:41:17,245,8203,117,128,5219.44,10176.03,0.00
2024-12-10 17:41:17,244,8203,116,128,5239.58,10176.04,0.00
2024-12-10 17:41:17,245,8202,116,129,5205.03,10176.08,0.00
2024-12-10 17:41:17,244,8202,116,128,5234.73,10176.15,0.00
2024-12-10 17:41:17,243,8202,115,128,5255.44,10176.16,0.00
2024-12-10 17:41:17,244,8201,115,129,5215.60,10176.34,0.00
2024-12-10 17:41:17,243,8201,115,128,5217.29,10176.79,0.00
2024-12-10 17:41:17,243,8202,115,128,5223.60,10177.00,0.00
2024-12-10 17:41:17,244,8202,116,128,5202.19,10177.00,0.00
2024-12-10 17:41:17,245,8201,117,128,5180.54,10177.02,0.00
2024-12-10 17:41:17,244,8201,116,128,5186.55,10177.12,0.00
2024-12-10 17:41:17,243,8201,116,127,5203.30,10177.16,0.00
2024-12-10 17:41:17,244,8200,117,127,5176.56,10177.22,0.00
2024-12-10 17:41:17,245,8199,117,128,5159.57,10177.53,0.00
2024-12-10 17:41:17,246,8198,117,129,5160.54,10177.55,0.00
2024-12-10 17:41:17,245,8198,117,128,5137.23,10177.91,0.00
2024-12-10 17:41:17,245,8199,117,128,5253.20,10178.00,0.00
2024-12-10 17:41:17,246,8199,117,129,5231.85,10178.00,0.00
2024-12-10 17:41:17,245,8199,116,129,5240.47,10178.04,0.00
2024-12-10 17:41:17,244,8199,115,129,5257.80,10178.08,0.00
2024-12-10 17:41:17,243,8199,115,128,5275.26,10178.10,0.00
2024-12-10 17:41:17,244,8198,116,128,5253.64,10178.11,0.00
2024-12-10 17:41:17,243,8198,116,127,5303.76,10178.14,0.00
2024-12-10 17:41:17,242,8198,116,126,5325.26,10178.14,0.00
2024-12-10 17:41:17,241,8198,116,125,5346.93,10178.15,0.00
2024-12-10 17:41:17,240,8198,116,124,5368.79,10178.15,0.00
2024-12-10 17:41:17,239,8198,116,123,5361.87,10178.43,0.00
2024-12-10 17:41:17,238,8198,115,123,5380.14,10178.47,0.00
2024-12-10 17:41:17,238,8199,115,123,5532.96,10179.00,0.00
2024-12-10 17:41:17,239,8199,115,124,5509.81,10179.00,0.00
2024-12-10 17:41:17,238,8199,114,124,5529.98,10179.03,0.00
2024-12-10 17:41:17,237,8199,114,123,5533.18,10179.14,0.00
2024-12-10 17:41:17,236,8199,113,123,5556.19,10179.14,0.00
2024-12-10 17:41:17,237,8198,114,123,5485.33,10179.57,0.00
2024-12-10 17:41:17,238,8197,114,124,5476.01,10179.64,0.00
2024-12-10 17:41:17,239,8196,114,125,5460.82,10179.74,0.00
2024-12-10 17:41:17,240,8195,114,126,5460.63,10179.75,0.00
2024-12-10 17:41:17,240,8196,114,126,5525.55,10180.00,0.00
2024-12-10 17:41:17,241,8196,115,126,5502.62,10180.00,0.00
2024-12-10 17:41:17,240,8196,114,126,5502.70,10180.14,0.00
2024-12-10 17:41:17,241,8195,115,126,5463.44,10180.31,0.00
2024-12-10 17:41:17,240,8195,114,126,5490.98,10180.31,0.00
2024-12-10 17:41:17,240,8196,114,126,5621.92,10181.00,0.00
2024-12-10 17:41:17,241,8196,115,126,5598.59,10181.00,0.00
2024-12-10 17:41:18,240,8196,114,126,5621.49,10181.00,0.00
2024-12-10 17:41:18,239,8196,114,125,5622.50,10181.14,0.00
2024-12-10 17:41:18,240,8195,114,126,5596.11,10181.17,0.00
2024-12-10 17:41:18,239,8195,114,125,5604.00,10181.50,0.00
2024-12-10 17:41:18,238,8195,114,124,5593.69,10181.80,0.00
2024-12-10 17:41:18,239,8194,115,124,5565.63,10181.85,0.00
2024-12-10 17:41:18,239,8195,115,124,5634.26,10182.00,0.00
2024-12-10 17:41:18,240,8195,115,125,5610.79,10182.00,0.00
2024-12-10 17:41:18,239,8195,115,124,5610.89,10182.15,0.00
2024-12-10 17:41:18,239,8196,115,124,5634.61,10183.00,0.00
2024-12-10 17:41:18,240,8196,116,124,5611.13,10183.00,0.00
2024-12-10 17:41:18,241,8195,117,124,5449.91,10183.92,0.00
2024-12-10 17:41:18,241,8196,117,124,5485.57,10184.00,0.00
2024-12-10 17:41:18,242,8196,117,125,5462.90,10184.00,0.00
2024-12-10 17:41:18,243,8195,118,125,5436.66,10184.05,0.00
2024-12-10 17:41:18,242,8195,118,124,5464.20,10184.09,0.00
2024-12-10 17:41:18,241,8195,118,123,5478.45,10184.17,0.00
2024-12-10 17:41:18,242,8194,119,123,5444.06,10184.29,0.00
2024-12-10 17:41:18,242,8195,119,123,5417.07,10185.00,0.00
2024-12-10 17:41:18,243,8195,120,123,5394.78,10185.00,0.00
2024-12-10 17:41:18,242,8195,119,123,5416.23,10185.01,0.00
2024-12-10 17:41:18,241,8195,119,122,5425.21,10185.08,0.00
2024-12-10 17:41:18,240,8195,119,121,5438.94,10185.17,0.00
2024-12-10 17:41:18,239,8195,118,121,5461.27,10185.17,0.00
2024-12-10 17:41:18,238,8195,118,120,5483.79,10185.17,0.00
2024-12-10 17:41:18,237,8195,117,120,5493.94,10185.29,0.00
2024-12-10 17:41:18,236,8195,117,119,5492.45,10185.49,0.00
2024-12-10 17:41:18,237,8194,118,119,5456.88,10185.62,0.00
2024-12-10 17:41:18,236,8194,118,118,5479.24,10185.78,0.00
2024-12-10 17:41:18,237,8193,119,118,5453.99,10185.81,0.00
2024-12-10 17:41:18,237,8194,119,118,5545.98,10186.00,0.00
2024-12-10 17:41:18,238,8194,119,119,5522.67,10186.00,0.00
2024-12-10 17:41:18,237,8194,118,119,5491.20,10186.38,0.00
2024-12-10 17:41:18,236,8194,117,119,5502.98,10186.47,0.00
2024-12-10 17:41:18,237,8193,117,120,5459.24,10186.67,0.00
2024-12-10 17:41:18,237,8194,117,120,5555.62,10187.00,0.00
2024-12-10 17:41:18,238,8194,118,120,5532.28,10187.00,0.00
2024-12-10 17:41:18,237,8194,117,120,5554.34,10187.01,0.00
2024-12-10 17:41:18,236,8194,116,120,5577.01,10187.02,0.00
2024-12-10 17:41:18,235,8194,116,119,5576.96,10187.16,0.00
2024-12-10 17:41:18,234,8194,116,118,5600.36,10187.16,0.00
2024-12-10 17:41:18,233,8194,115,118,5612.58,10187.28,0.00
2024-12-10 17:41:18,234,8193,115,119,5539.58,10187.74,0.00
2024-12-10 17:41:18,234,8194,115,119,5609.69,10188.00,0.00
2024-12-10 17:41:18,235,8194,115,120,5585.82,10188.00,0.00
2024-12-10 17:41:18,234,8194,114,120,5602.32,10188.07,0.00
2024-12-10 17:41:18,233,8194,114,119,5619.38,10188.08,0.00
2024-12-10 17:41:18,234,8193,115,119,5578.87,10188.25,0.00
2024-12-10 17:41:18,233,8193,115,118,5602.21,10188.27,0.00
2024-12-10 17:41:18,233,8194,115,118,5593.96,10189.00,0.00
2024-12-10 17:41:18,234,8194,116,118,5570.06,10189.00,0.00
2024-12-10 17:41:18,235,8193,117,118,5545.50,10189.02,0.00
2024-12-10 17:41:18,236,8192,118,118,5558.71,10189.06,0.00
2024-12-10 17:41:18,235,8192,117,118,5568.10,10189.17,0.00
2024-12-10 17:41:18,236,8191,117,119,5533.32,10189.28,0.00
2024-12-10 17:41:18,237,8190,118,119,5498.61,10189.70,0.00
2024-12-10 17:41:18,237,8191,118,119,5549.24,10190.00,0.00
2024-12-10 17:41:18,238,8191,119,119,5525.92,10190.00,0.00
2024-12-10 17:41:18,237,8191,119,118,5538.96,10190.08,0.00
2024-12-10 17:41:18,238,8190,119,119,5508.86,10190.16,0.00
2024-12-10 17:41:18,237,8190,119,118,5574.24,10190.16,0.00
2024-12-10 17:41:18,237,8191,119,118,5676.40,10191.00,0.00
2024-12-10 17:41:18,238,8191,119,119,5652.55,10191.00,0.00
2024-12-10 17:41:18,237,8191,118,119,5650.22,10191.11,0.00
2024-12-10 17:41:18,236,8191,118,118,5667.71,10191.17,0.00
2024-12-10 17:41:18,237,8190,118,119,5603.54,10191.55,0.00
2024-12-10 17:41:18,238,8189,118,120,5572.34,10191.66,0.00
2024-12-10 17:41:18,238,8190,118,120,5636.01,10192.00,0.00
2024-12-10 17:41:18,239,8190,118,121,5612.43,10192.00,0.00
2024-12-10 17:41:18,238,8190,117,121,5612.06,10192.07,0.00
2024-12-10 17:41:18,237,8190,117,120,5630.58,10192.09,0.00
2024-12-10 17:41:18,236,8190,117,119,5647.13,10192.16,0.00
2024-12-10 17:41:18,235,8190,116,119,5598.71,10192.74,0.00
2024-12-10 17:41:18,236,8189,117,119,5560.13,10192.88,0.00
2024-12-10 17:41:18,237,8188,118,119,5544.97,10192.92,0.00
2024-12-10 17:41:18,237,8189,118,119,5658.40,10193.00,0.00
2024-12-10 17:41:18,238,8189,119,119,5634.63,10193.00,0.00
2024-12-10 17:41:18,237,8189,119,118,5642.96,10193.10,0.00
2024-12-10 17:41:18,236,8189,118,118,5660.85,10193.15,0.00
2024-12-10 17:41:18,237,8188,118,119,5560.75,10193.78,0.00
2024-12-10 17:41:18,238,8187,119,119,5545.88,10193.79,0.00
2024-12-10 17:41:18,238,8188,119,119,5631.77,10194.00,0.00
2024-12-10 17:41:18,239,8188,120,119,5608.20,10194.00,0.00
2024-12-10 17:41:18,238,8188,120,118,5607.42,10194.16,0.00
2024-12-10 17:41:18,237,8188,120,117,5630.65,10194.16,0.00
2024-12-10 17:41:18,236,8188,120,116,5617.95,10194.36,0.00
2024-12-10 17:41:18,237,8187,121,116,5589.95,10194.41,0.00
2024-12-10 17:41:18,236,8187,120,116,5618.40,10194.42,0.00
2024-12-10 17:41:18,235,8187,119,116,5613.86,10194.62,0.00
2024-12-10 17:41:18,235,8188,119,116,5694.16,10195.00,0.00
2024-12-10 17:41:18,236,8188,119,117,5670.04,10195.00,0.00
2024-12-10 17:41:18,235,8188,119,116,5686.39,10195.08,0.00
2024-12-10 17:41:18,234,8188,119,115,5700.67,10195.09,0.00
2024-12-10 17:41:18,233,8188,118,115,5724.27,10195.10,0.00
2024-12-10 17:41:18,232,8188,118,114,5743.69,10195.15,0.00
2024-12-10 17:41:18,231,8188,117,114,5767.67,10195.15,0.00
2024-12-10 17:41:18,230,8188,117,113,5791.87,10195.16,0.00
2024-12-10 17:41:18,231,8187,118,113,5738.52,10195.41,0.00
2024-12-10 17:41:18,232,8186,119,113,5741.04,10195.41,0.00
2024-12-10 17:41:18,233,8185,120,113,5686.05,10195.86,0.00
2024-12-10 17:41:18,232,8185,120,112,5696.70,10195.97,0.00
2024-12-10 17:41:18,232,8186,120,112,5763.53,10196.00,0.00
2024-12-10 17:41:18,233,8186,121,112,5738.79,10196.00,0.00
2024-12-10 17:41:18,232,8186,120,112,5754.86,10196.04,0.00
2024-12-10 17:41:18,231,8186,120,111,5759.08,10196.15,0.00
2024-12-10 17:41:18,230,8186,120,110,5783.68,10196.15,0.00
2024-12-10 17:41:18,231,8185,120,111,5755.56,10196.19,0.00
2024-12-10 17:41:18,232,8184,120,112,5696.48,10196.73,0.00
2024-12-10 17:41:18,232,8185,120,112,5854.92,10197.00,0.00
2024-12-10 17:41:18,233,8185,120,113,5829.80,10197.00,0.00
2024-12-10 17:41:18,234,8184,120,114,5751.14,10197.43,0.00
2024-12-10 17:41:18,234,8185,120,114,5842.75,10198.00,0.00
2024-12-10 17:41:18,235,8185,120,115,5817.88,10198.00,0.00
2024-12-10 17:41:19,235,8186,120,115,5779.92,10199.00,0.00
2024-12-10 17:41:19,236,8186,120,116,5755.42,10199.00,0.00
2024-12-10 17:41:19,235,8186,120,115,5763.02,10199.09,0.00
2024-12-10 17:41:19,234,8186,119,115,5786.35,10199.10,0.00
2024-12-10 17:41:19,235,8185,120,115,5757.84,10199.14,0.00
2024-12-10 17:41:19,234,8185,119,115,5790.73,10199.15,0.00
2024-12-10 17:41:19,233,8185,118,115,5787.34,10199.43,0.00
2024-12-10 17:41:19,233,8186,118,115,5754.65,10200.00,0.00
2024-12-10 17:41:19,234,8186,119,115,5730.05,10200.00,0.00
2024-12-10 17:41:19,235,8185,120,115,5619.95,10200.75,0.00
2024-12-10 17:41:19,236,8184,121,115,5602.56,10200.78,0.00
2024-12-10 17:41:19,236,8185,121,115,5670.02,10201.00,0.00
2024-12-10 17:41:19,237,8185,121,116,5646.10,10201.00,0.00
2024-12-10 17:41:19,238,8184,122,116,5598.86,10201.16,0.00
2024-12-10 17:41:19,237,8184,121,116,5633.62,10201.25,0.00
2024-12-10 17:41:19,236,8184,120,116,5649.75,10201.30,0.00
2024-12-10 17:41:19,237,8183,121,116,5599.46,10201.56,0.00
2024-12-10 17:41:19,237,8184,121,116,5694.90,10202.00,0.00
2024-12-10 17:41:19,238,8184,122,116,5670.97,10202.00,0.00
2024-12-10 17:41:19,239,8183,123,116,5626.80,10202.13,0.00
2024-12-10 17:41:19,238,8183,122,116,5683.05,10202.16,0.00
2024-12-10 17:41:19,239,8182,122,117,5649.47,10202.26,0.00
2024-12-10 17:41:19,240,8181,122,118,5582.46,10202.81,0.00
2024-12-10 17:41:19,240,8182,122,118,5684.54,10203.00,0.00
2024-12-10 17:41:19,241,8182,122,119,5660.95,10203.00,0.00
2024-12-10 17:41:19,240,8182,121,119,5678.61,10203.06,0.00
2024-12-10 17:41:19,241,8181,122,119,5655.05,10203.07,0.00
2024-12-10 17:41:19,240,8181,122,118,5688.82,10203.09,0.00
2024-12-10 17:41:19,241,8180,122,119,5643.28,10203.32,0.00
2024-12-10 17:41:19,242,8179,123,119,5633.12,10203.50,0.00
2024-12-10 17:41:19,243,8178,124,119,5604.13,10203.63,0.00
2024-12-10 17:41:19,244,8177,124,120,5583.35,10203.76,0.00
2024-12-10 17:41:19,245,8176,125,120,5563.49,10203.78,0.00
2024-12-10 17:41:19,245,8177,125,120,5692.66,10204.00,0.00
2024-12-10 17:41:19,246,8177,125,121,5669.52,10204.00,0.00
2024-12-10 17:41:19,245,8177,124,121,5686.45,10204.06,0.00
2024-12-10 17:41:19,246,8176,124,122,5647.60,10204.14,0.00
2024-12-10 17:41:19,247,8175,124,123,5524.93,10204.91,0.00
2024-12-10 17:41:19,247,8176,124,123,5808.00,10205.00,0.00
2024-12-10 17:41:19,248,8176,125,123,5784.58,10205.00,0.00
2024-12-10 17:41:19,247,8176,125,122,5801.83,10205.06,0.00
2024-12-10 17:41:19,246,8176,125,121,5809.27,10205.13,0.00
2024-12-10 17:41:19,245,8176,124,121,5742.05,10205.67,0.00
2024-12-10 17:41:19,246,8175,124,122,5694.99,10205.89,0.00
2024-12-10 17:41:19,246,8176,124,122,5811.67,10206.00,0.00
2024-12-10 17:41:19,247,8176,124,123,5788.14,10206.00,0.00
2024-12-10 17:41:19,248,8175,124,124,5762.34,10206.04,0.00
2024-12-10 17:41:19,247,8175,124,123,5784.87,10206.09,0.00
2024-12-10 17:41:19,248,8174,125,123,5745.13,10206.26,0.00
2024-12-10 17:41:19,249,8173,125,124,5729.34,10206.51,0.00
2024-12-10 17:41:19,250,8172,126,124,5703.19,10206.56,0.00
2024-12-10 17:41:19,251,8171,126,125,5675.69,10206.75,0.00
2024-12-10 17:41:19,251,8172,126,125,5721.72,10207.00,0.00
2024-12-10 17:41:19,252,8172,127,125,5699.01,10207.00,0.00
2024-12-10 17:41:19,251,8172,127,124,5699.83,10207.14,0.00
2024-12-10 17:41:19,250,8172,127,123,5722.22,10207.14,0.00
2024-12-10 17:41:19,249,8172,127,122,5744.79,10207.14,0.00
2024-12-10 17:41:19,248,8172,126,122,5679.91,10207.86,0.00
2024-12-10 17:41:19,248,8173,126,122,5912.58,10208.00,0.00
2024-12-10 17:41:19,249,8173,127,122,5888.83,10208.00,0.00
2024-12-10 17:41:19,248,8173,127,121,5890.32,10208.14,0.00
2024-12-10 17:41:19,247,8173,127,120,5913.75,10208.14,0.00
2024-12-10 17:41:19,248,8172,128,120,5824.83,10208.73,0.00
2024-12-10 17:41:19,247,8172,127,120,5855.55,10208.76,0.00
2024-12-10 17:41:19,248,8171,127,121,5813.76,10208.84,0.00
2024-12-10 17:41:19,248,8172,127,121,5843.96,10209.00,0.00
2024-12-10 17:41:19,249,8172,127,122,5820.49,10209.00,0.00
2024-12-10 17:41:19,250,8171,127,123,5788.73,10209.08,0.00
2024-12-10 17:41:19,249,8171,127,122,5815.29,10209.14,0.00
2024-12-10 17:41:19,250,8170,128,122,5758.66,10209.46,0.00
2024-12-10 17:41:19,250,8171,128,122,5829.03,10210.00,0.00
2024-12-10 17:41:19,251,8171,128,123,5805.81,10210.00,0.00
2024-12-10 17:41:19,250,8171,127,123,5825.37,10210.04,0.00
2024-12-10 17:41:19,249,8171,126,123,5845.52,10210.06,0.00
2024-12-10 17:41:19,248,8171,126,122,5859.22,10210.08,0.00
2024-12-10 17:41:19,247,8171,126,121,5866.65,10210.23,0.00
2024-12-10 17:41:19,246,8171,125,121,5873.36,10210.39,0.00
2024-12-10 17:41:19,247,8170,126,121,5847.94,10210.42,0.00
2024-12-10 17:41:19,246,8170,125,121,5850.47,10210.68,0.00
2024-12-10 17:41:19,245,8170,124,121,5867.73,10210.75,0.00
2024-12-10 17:41:19,245,8171,124,121,5947.89,10211.00,0.00
2024-12-10 17:41:19,246,8171,124,122,5923.71,10211.00,0.00
2024-12-10 17:41:19,245,8171,124,121,5936.25,10211.08,0.00
2024-12-10 17:41:19,245,8172,124,121,5897.10,10212.00,0.00
2024-12-10 17:41:19,246,8172,124,122,5873.13,10212.00,0.00
2024-12-10 17:41:19,245,8172,123,122,5895.02,10212.02,0.00
2024-12-10 17:41:19,244,8172,122,122,5903.31,10212.09,0.00
2024-12-10 17:41:19,243,8172,121,122,5922.58,10212.13,0.00
2024-12-10 17:41:19,242,8172,121,121,5946.64,10212.13,0.00
2024-12-10 17:41:19,241,8172,120,121,5928.98,10212.50,0.00
2024-12-10 17:41:19,241,8173,120,121,5915.47,10213.00,0.00
2024-12-10 17:41:19,242,8173,121,121,5891.03,10213.00,0.00
2024-12-10 17:41:19,241,8173,120,121,5912.10,10213.03,0.00
2024-12-10 17:41:19,240,8173,119,121,5909.12,10213.13,0.00
2024-12-10 17:41:19,239,8173,119,120,5933.41,10213.13,0.00
2024-12-10 17:41:19,240,8172,119,121,5868.77,10213.52,0.00
2024-12-10 17:41:19,241,8171,120,121,5842.97,10213.60,0.00
2024-12-10 17:41:19,241,8172,120,121,5853.34,10214.00,0.00
2024-12-10 17:41:19,242,8172,120,122,5829.15,10214.00,0.00
2024-12-10 17:41:19,241,8172,120,121,5843.35,10214.08,0.00
2024-12-10 17:41:19,240,8172,120,120,5862.62,10214.13,0.00
2024-12-10 17:41:19,239,8172,119,120,5859.36,10214.38,0.00
2024-12-10 17:41:19,238,8172,119,119,5837.78,10214.76,0.00
2024-12-10 17:41:19,238,8173,119,119,5925.52,10215.00,0.00
2024-12-10 17:41:19,239,8173,120,119,5900.73,10215.00,0.00
2024-12-10 17:41:19,238,8173,120,118,5903.70,10215.13,0.00
2024-12-10 17:41:19,237,8173,119,118,5928.18,10215.13,0.00
2024-12-10 17:41:19,236,8173,118,118,5951.51,10215.15,0.00
2024-12-10 17:41:20,236,8174,118,118,5900.02,10216.00,0.00
2024-12-10 17:41:20,237,8174,119,118,5875.12,10216.00,0.00
2024-12-10 17:41:20,238,8173,120,118,5850.44,10216.01,0.00
2024-12-10 17:41:20,237,8173,119,118,5886.78,10216.05,0.00
2024-12-10 17:41:20,236,8173,119,117,5894.88,10216.13,0.00
2024-12-10 17:41:20,235,8173,118,117,5919.53,10216.13,0.00
2024-12-10 17:41:20,236,8172,119,117,5844.94,10216.59,0.00
2024-12-10 17:41:20,237,8171,119,118,5817.40,10216.79,0.00
2024-12-10 17:41:20,238,8170,120,118,5796.82,10216.79,0.00
2024-12-10 17:41:20,238,8171,120,118,5816.61,10217.00,0.00
2024-12-10 17:41:20,239,8171,121,118,5792.27,10217.00,0.00
2024-12-10 17:41:20,238,8171,120,118,5814.80,10217.02,0.00
2024-12-10 17:41:20,237,8171,119,118,5835.94,10217.05,0.00
2024-12-10 17:41:20,236,8171,118,118,5844.25,10217.12,0.00
2024-12-10 17:41:20,235,8171,117,118,5840.65,10217.39,0.00
2024-12-10 17:41:20,235,8172,117,118,5980.68,10218.00,0.00
2024-12-10 17:41:20,236,8172,118,118,5955.34,10218.00,0.00
2024-12-10 17:41:20,235,8172,118,117,5959.44,10218.12,0.00
2024-12-10 17:41:20,235,8173,118,117,5892.27,10219.00,0.00
2024-12-10 17:41:20,236,8173,118,118,5867.30,10219.00,0.00
2024-12-10 17:41:20,235,8173,118,117,5885.35,10219.07,0.00
2024-12-10 17:41:20,234,8173,118,116,5906.15,10219.11,0.00
2024-12-10 17:41:20,233,8173,118,115,5929.75,10219.12,0.00
2024-12-10 17:41:20,234,8172,119,115,5877.19,10219.38,0.00
2024-12-10 17:41:20,235,8171,120,115,5847.01,10219.49,0.00
2024-12-10 17:41:20,236,8170,120,116,5838.42,10219.52,0.00
2024-12-10 17:41:20,237,8169,120,117,5836.59,10219.58,0.00
2024-12-10 17:41:20,238,8168,120,118,5815.96,10219.63,0.00
2024-12-10 17:41:20,239,8167,121,118,5820.30,10219.67,0.00
2024-12-10 17:41:20,240,8166,122,118,5790.65,10219.86,0.00
2024-12-10 17:41:20,240,8167,122,118,5808.23,10220.00,0.00
2024-12-10 17:41:20,241,8167,122,119,5784.13,10220.00,0.00
2024-12-10 17:41:20,242,8166,122,120,5743.80,10220.09,0.00
2024-12-10 17:41:20,243,8165,122,121,5711.29,10220.28,0.00
2024-12-10 17:41:20,242,8165,121,121,5752.03,10220.48,0.00
2024-12-10 17:41:20,242,8166,121,121,6030.70,10221.00,0.00
2024-12-10 17:41:20,243,8166,122,121,6005.88,10221.00,0.00
2024-12-10 17:41:20,244,8165,122,122,5976.26,10221.06,0.00
2024-12-10 17:41:20,245,8164,123,122,5940.92,10221.41,0.00
2024-12-10 17:41:20,246,8163,124,122,5893.97,10221.77,0.00
2024-12-10 17:41:20,246,8164,124,122,6001.69,10222.00,0.00
2024-12-10 17:41:20,247,8164,124,123,5977.40,10222.00,0.00
2024-12-10 17:41:20,246,8164,123,123,5999.21,10222.02,0.00
2024-12-10 17:41:20,245,8164,123,122,6004.56,10222.13,0.00
2024-12-10 17:41:20,244,8164,122,122,6028.75,10222.13,0.00
2024-12-10 17:41:20,245,8163,123,122,5904.65,10222.93,0.00
2024-12-10 17:41:20,245,8164,123,122,6064.76,10223.00,0.00
2024-12-10 17:41:20,246,8164,123,123,6040.11,10223.00,0.00
2024-12-10 17:41:20,245,8164,123,122,6056.03,10223.07,0.00
2024-12-10 17:41:20,244,8164,123,121,6074.60,10223.12,0.00
2024-12-10 17:41:20,243,8164,123,120,6074.24,10223.21,0.00
2024-12-10 17:41:20,242,8164,122,120,6039.95,10223.75,0.00
2024-12-10 17:41:20,243,8163,123,120,6000.06,10223.90,0.00
2024-12-10 17:41:20,243,8164,123,120,6082.43,10224.00,0.00
2024-12-10 17:41:20,244,8164,124,120,6057.50,10224.00,0.00
2024-12-10 17:41:20,245,8163,124,121,5994.88,10224.29,0.00
2024-12-10 17:41:20,246,8162,124,122,6000.44,10224.30,0.00
2024-12-10 17:41:20,246,8163,124,122,6040.53,10225.00,0.00
2024-12-10 17:41:20,247,8163,125,122,6016.07,10225.00,0.00
2024-12-10 17:41:20,248,8162,126,122,5931.30,10225.49,0.00
2024-12-10 17:41:20,248,8163,126,122,6003.29,10226.00,0.00
2024-12-10 17:41:20,249,8163,126,123,5979.18,10226.00,0.00
2024-12-10 17:41:20,248,8163,125,123,5982.73,10226.12,0.00
2024-12-10 17:41:20,249,8162,125,124,5936.73,10226.30,0.00
2024-12-10 17:41:20,250,8161,125,125,5893.64,10226.79,0.00
2024-12-10 17:41:20,250,8162,125,125,5946.02,10227.00,0.00
2024-12-10 17:41:20,251,8162,126,125,5922.33,10227.00,0.00
2024-12-10 17:41:20,250,8162,125,125,5911.69,10227.09,0.00
2024-12-10 17:41:20,250,8163,125,125,5932.61,10228.00,0.00
2024-12-10 17:41:20,251,8163,126,125,5908.97,10228.00,0.00
2024-12-10 17:41:20,250,8163,126,124,5919.97,10228.07,0.00
2024-12-10 17:41:20,249,8163,126,123,5938.42,10228.12,0.00
2024-12-10 17:41:20,248,8163,125,123,5942.41,10228.29,0.00
2024-12-10 17:41:20,249,8162,125,124,5895.65,10228.53,0.00
2024-12-10 17:41:20,250,8161,125,125,5870.50,10228.64,0.00
2024-12-10 17:41:20,250,8162,125,125,5846.82,10229.00,0.00
2024-12-10 17:41:20,251,8162,126,125,5823.52,10229.00,0.00
2024-12-10 17:41:20,250,8162,126,124,5832.54,10229.09,0.00
2024-12-10 17:41:20,251,8161,127,124,5758.46,10229.58,0.00
2024-12-10 17:41:20,251,8162,127,124,5813.50,10230.00,0.00
2024-12-10 17:41:20,252,8162,128,124,5790.43,10230.00,0.00
2024-12-10 17:41:20,251,8162,128,123,5793.99,10230.11,0.00
2024-12-10 17:41:20,250,8162,127,123,5816.75,10230.11,0.00
2024-12-10 17:41:20,251,8161,127,124,5789.92,10230.16,0.00
2024-12-10 17:41:20,250,8161,127,123,5849.68,10230.19,0.00
2024-12-10 17:41:20,251,8160,128,123,5759.72,10230.77,0.00
2024-12-10 17:41:20,250,8160,127,123,5768.89,10230.82,0.00
2024-12-10 17:41:20,250,8161,127,123,5824.55,10231.00,0.00
2024-12-10 17:41:20,251,8161,128,123,5801.35,10231.00,0.00
2024-12-10 17:41:20,250,8161,127,123,5815.59,10231.09,0.00
2024-12-10 17:41:20,249,8161,127,122,5828.27,10231.11,0.00
2024-12-10 17:41:20,249,8162,127,122,5845.18,10232.00,0.00
2024-12-10 17:41:20,250,8162,127,123,5821.80,10232.00,0.00
2024-12-10 17:41:20,251,8161,127,124,5792.12,10232.08,0.00
2024-12-10 17:41:20,250,8161,127,123,5806.52,10232.12,0.00
2024-12-10 17:41:20,249,8161,127,122,5793.86,10232.45,0.00
2024-12-10 17:41:20,250,8160,127,123,5767.43,10232.49,0.00
2024-12-10 17:41:20,251,8159,128,123,5724.06,10232.86,0.00
2024-12-10 17:41:20,251,8160,128,123,5736.42,10233.00,0.00
2024-12-10 17:41:20,252,8160,128,124,5713.66,10233.00,0.00
2024-12-10 17:41:20,251,8160,128,123,5721.79,10233.09,0.00
2024-12-10 17:41:20,250,8160,128,122,5741.41,10233.12,0.00
2024-12-10 17:41:21,250,8161,128,122,5786.43,10234.00,0.00
2024-12-10 17:41:21,251,8161,128,123,5763.38,10234.00,0.00
2024-12-10 17:41:21,252,8160,129,123,5720.66,10234.13,0.00
2024-12-10 17:41:21,251,8160,129,122,5783.41,10234.13,0.00
2024-12-10 17:41:21,251,8161,129,122,5708.28,10235.00,0.00
2024-12-10 17:41:21,252,8161,129,123,5685.62,10235.00,0.00
2024-12-10 17:41:21,251,8161,128,123,5705.43,10235.03,0.00
2024-12-10 17:41:21,250,8161,127,123,5725.81,10235.05,0.00
2024-12-10 17:41:21,249,8161,127,122,5741.42,10235.08,0.00
2024-12-10 17:41:21,248,8161,127,121,5760.88,10235.12,0.00
2024-12-10 17:41:21,247,8161,127,120,5783.79,10235.12,0.00
2024-12-10 17:41:21,246,8161,126,120,5806.88,10235.12,0.00
2024-12-10 17:41:21,245,8161,126,119,5747.14,10235.87,0.00
2024-12-10 17:41:21,244,8161,125,119,5748.47,10235.94,0.00
2024-12-10 17:41:21,244,8162,125,119,5809.35,10236.00,0.00
2024-12-10 17:41:21,245,8162,126,119,5785.64,10236.00,0.00
2024-12-10 17:41:21,246,8161,126,120,5756.73,10236.07,0.00
2024-12-10 17:41:21,245,8161,126,119,5791.55,10236.13,0.00
2024-12-10 17:41:21,246,8160,126,120,5692.85,10236.75,0.00
2024-12-10 17:41:21,245,8160,125,120,5703.49,10236.93,0.00
2024-12-10 17:41:21,245,8161,125,120,5738.64,10237.00,0.00
2024-12-10 17:41:21,246,8161,126,120,5715.31,10237.00,0.00
2024-12-10 17:41:21,247,8160,127,120,5608.01,10237.71,0.00
2024-12-10 17:41:21,247,8161,127,120,5695.11,10238.00,0.00
2024-12-10 17:41:21,248,8161,128,120,5672.14,10238.00,0.00
2024-12-10 17:41:21,249,8160,128,121,5649.36,10238.01,0.00
2024-12-10 17:41:21,248,8160,128,120,5661.47,10238.12,0.00
2024-12-10 17:41:21,247,8160,128,119,5678.84,10238.15,0.00
2024-12-10 17:41:21,247,8161,128,119,5642.84,10239.00,0.00
2024-12-10 17:41:21,248,8161,128,120,5620.09,10239.00,0.00
2024-12-10 17:41:21,247,8161,127,120,5625.05,10239.08,0.00
2024-12-10 17:41:21,246,8161,127,119,5643.36,10239.12,0.00
2024-12-10 17:41:21,247,8160,127,120,5608.62,10239.24,0.00
2024-12-10 17:41:21,248,8159,127,121,5600.55,10239.46,0.00
2024-12-10 17:41:21,247,8159,126,121,5634.04,10239.47,0.00
2024-12-10 17:41:21,246,8159,125,121,5631.99,10239.72,0.00
2024-12-10 17:41:21,245,8159,125,120,5643.72,10239.75,0.00
2024-12-10 17:41:21,246,8158,125,121,5615.81,10239.81,0.00
2024-12-10 17:41:21,246,8159,125,121,5682.01,10240.00,0.00
2024-12-10 17:41:21,247,8159,125,122,5659.01,10240.00,0.00
2024-12-10 17:41:21,246,8159,124,122,5676.21,10240.05,0.00
2024-12-10 17:41:21,245,8159,124,121,5691.89,10240.12,0.00
2024-12-10 17:41:21,244,8159,123,121,5714.28,10240.12,0.00
2024-12-10 17:41:21,243,8159,123,120,5735.10,10240.14,0.00
2024-12-10 17:41:21,244,8158,124,120,5638.48,10240.87,0.00
2024-12-10 17:41:21,244,8159,124,120,5798.24,10241.00,0.00
2024-12-10 17:41:21,245,8159,125,120,5774.57,10241.00,0.00
2024-12-10 17:41:21,244,8159,125,119,5784.45,10241.13,0.00
2024-12-10 17:41:21,245,8158,126,119,5710.01,10241.62,0.00
2024-12-10 17:41:21,245,8159,126,119,5753.24,10242.00,0.00
2024-12-10 17:41:21,246,8159,127,119,5729.85,10242.00,0.00
2024-12-10 17:41:21,245,8159,127,118,5737.41,10242.13,0.00
2024-12-10 17:41:21,246,8158,127,119,5656.35,10242.68,0.00
2024-12-10 17:41:21,245,8158,126,119,5654.03,10242.81,0.00
2024-12-10 17:41:21,245,8159,126,119,5717.44,10243.00,0.00
2024-12-10 17:41:21,246,8159,126,120,5694.20,10243.00,0.00
2024-12-10 17:41:21,245,8159,125,120,5710.37,10243.07,0.00
2024-12-10 17:41:21,244,8159,124,120,5728.75,10243.12,0.00
2024-12-10 17:41:21,243,8159,124,119,5751.91,10243.12,0.00
2024-12-10 17:41:21,242,8159,124,118,5771.44,10243.13,0.00
2024-12-10 17:41:21,243,8158,125,118,5721.24,10243.40,0.00
2024-12-10 17:41:21,243,8159,125,118,5727.16,10244.00,0.00
2024-12-10 17:41:21,244,8159,126,118,5703.69,10244.00,0.00
2024-12-10 17:41:21,245,8158,127,118,5678.74,10244.03,0.00
2024-12-10 17:41:21,246,8157,128,118,5666.51,10244.08,0.00
2024-12-10 17:41:21,245,8157,127,118,5712.02,10244.12,0.00
2024-12-10 17:41:21,244,8157,127,117,5729.55,10244.13,0.00
2024-12-10 17:41:21,245,8156,128,117,5623.47,10244.76,0.00
2024-12-10 17:41:21,245,8157,128,117,5692.10,10245.00,0.00
2024-12-10 17:41:21,246,8157,129,117,5668.96,10245.00,0.00
2024-12-10 17:41:21,245,8157,128,117,5677.05,10245.08,0.00
2024-12-10 17:41:21,244,8157,128,116,5696.37,10245.11,0.00
2024-12-10 17:41:21,245,8156,128,117,5631.06,10245.44,0.00
2024-12-10 17:41:21,244,8156,127,117,5682.54,10245.55,0.00
2024-12-10 17:41:21,245,8155,128,117,5656.85,10245.58,0.00
2024-12-10 17:41:21,245,8156,128,117,5798.50,10246.00,0.00
2024-12-10 17:41:21,246,8156,129,117,5774.93,10246.00,0.00
2024-12-10 17:41:21,247,8155,129,118,5747.84,10246.05,0.00
2024-12-10 17:41:21,246,8155,128,118,5779.24,10246.11,0.00
2024-12-10 17:41:21,247,8154,129,118,5694.65,10246.64,0.00
2024-12-10 17:41:21,248,8153,130,118,5691.04,10246.66,0.00
2024-12-10 17:41:21,248,8154,130,118,5781.19,10247.00,0.00
2024-12-10 17:41:21,249,8154,130,119,5757.97,10247.00,0.00
2024-12-10 17:41:21,248,8154,130,118,5770.08,10247.11,0.00
2024-12-10 17:41:21,247,8154,130,117,5784.33,10247.13,0.00
2024-12-10 17:41:21,248,8153,131,117,5752.35,10247.22,0.00
2024-12-10 17:41:21,249,8152,132,117,5737.12,10247.49,0.00
2024-12-10 17:41:21,250,8151,132,118,5702.81,10247.68,0.00
2024-12-10 17:41:21,251,8150,132,119,5681.00,10247.80,0.00
2024-12-10 17:41:21,251,8151,132,119,5816.04,10248.00,0.00
2024-12-10 17:41:21,252,8151,133,119,5792.96,10248.00,0.00
2024-12-10 17:41:21,253,8150,133,120,5757.56,10248.13,0.00
2024-12-10 17:41:21,252,8150,133,119,5790.94,10248.13,0.00
2024-12-10 17:41:21,252,8151,133,119,5889.11,10249.00,0.00
2024-12-10 17:41:21,253,8151,134,119,5865.84,10249.00,0.00
2024-12-10 17:41:21,252,8151,133,119,5885.05,10249.02,0.00
2024-12-10 17:41:22,251,8151,133,118,5893.86,10249.13,0.00
2024-12-10 17:41:22,252,8150,133,119,5835.45,10249.48,0.00
2024-12-10 17:41:22,253,8149,134,119,5818.90,10249.55,0.00
2024-12-10 17:41:22,254,8148,135,119,5810.54,10249.59,0.00
2024-12-10 17:41:22,255,8147,136,119,5795.80,10249.60,0.00
2024-12-10 17:41:22,255,8148,136,119,5836.65,10250.00,0.00
2024-12-10 17:41:22,256,8148,136,120,5813.85,10250.00,0.00
2024-12-10 17:41:22,255,8148,136,119,5830.65,10250.06,0.00
2024-12-10 17:41:22,254,8148,136,118,5848.38,10250.11,0.00
2024-12-10 17:41:22,253,8148,136,117,5867.46,10250.12,0.00
2024-12-10 17:41:22,254,8147,137,117,5789.50,10250.51,0.00
2024-12-10 17:41:22,255,8146,138,117,5770.00,10250.66,0.00
2024-12-10 17:41:22,255,8147,138,117,5949.55,10251.00,0.00
2024-12-10 17:41:22,256,8147,139,117,5926.31,10251.00,0.00
2024-12-10 17:41:22,255,8147,139,116,5935.54,10251.12,0.00
2024-12-10 17:41:22,254,8147,138,116,5942.39,10251.21,0.00
2024-12-10 17:41:22,255,8146,139,116,5911.47,10251.29,0.00
2024-12-10 17:41:22,256,8145,140,116,5898.05,10251.56,0.00
2024-12-10 17:41:22,255,8145,139,116,5903.11,10251.75,0.00
2024-12-10 17:41:22,254,8145,138,116,5923.64,10251.77,0.00
2024-12-10 17:41:22,254,8146,138,116,6021.49,10252.00,0.00
2024-12-10 17:41:22,255,8146,138,117,5997.88,10252.00,0.00
2024-12-10 17:41:22,254,8146,138,116,6007.03,10252.13,0.00
2024-12-10 17:41:22,255,8145,139,116,5957.84,10252.38,0.00
2024-12-10 17:41:22,255,8146,139,116,6008.51,10253.00,0.00
2024-12-10 17:41:22,256,8146,140,116,5985.04,10253.00,0.00
2024-12-10 17:41:22,255,8146,140,115,5992.09,10253.14,0.00
2024-12-10 17:41:22,256,8145,141,115,5946.51,10253.36,0.00
2024-12-10 17:41:22,255,8145,140,115,5976.35,10253.42,0.00
2024-12-10 17:41:22,254,8145,139,115,5994.29,10253.47,0.00
2024-12-10 17:41:22,255,8144,139,116,5915.95,10253.86,0.00
2024-12-10 17:41:22,255,8145,139,116,5986.45,10254.00,0.00
2024-12-10 17:41:22,256,8145,139,117,5963.06,10254.00,0.00
2024-12-10 17:41:22,255,8145,138,117,5901.87,10254.64,0.00
2024-12-10 17:41:22,255,8146,138,117,5985.31,10255.00,0.00
2024-12-10 17:41:22,256,8146,138,118,5961.93,10255.00,0.00
2024-12-10 17:41:22,255,8146,137,118,5970.09,10255.14,0.00
2024-12-10 17:41:22,254,8146,137,117,5991.17,10255.14,0.00
2024-12-10 17:41:22,253,8146,136,117,5984.04,10255.41,0.00
2024-12-10 17:41:22,254,8145,136,118,5945.22,10255.57,0.00
2024-12-10 17:41:22,255,8144,136,119,5917.14,10255.65,0.00
2024-12-10 17:41:22,255,8145,136,119,5940.17,10256.00,0.00
2024-12-10 17:41:22,256,8145,136,120,5916.97,10256.00,0.00
2024-12-10 17:41:22,257,8144,137,120,5806.52,10256.62,0.00
2024-12-10 17:41:22,256,8144,136,120,5829.01,10256.75,0.00
2024-12-10 17:41:22,256,8145,136,120,5923.37,10257.00,0.00
2024-12-10 17:41:22,257,8145,137,120,5900.32,10257.00,0.00
2024-12-10 17:41:22,256,8145,136,120,5922.57,10257.01,0.00
2024-12-10 17:41:22,255,8145,136,119,5933.38,10257.13,0.00
2024-12-10 17:41:22,254,8145,135,119,5956.34,10257.13,0.00
2024-12-10 17:41:22,253,8145,135,118,5975.02,10257.13,0.00
2024-12-10 17:41:22,252,8145,134,118,5987.50,10257.13,0.00
2024-12-10 17:41:22,252,8146,134,118,5979.42,10258.00,0.00
2024-12-10 17:41:22,253,8146,135,118,5955.79,10258.00,0.00
2024-12-10 17:41:22,252,8146,134,118,5955.29,10258.07,0.00
2024-12-10 17:41:22,251,8146,134,117,5976.57,10258.09,0.00
2024-12-10 17:41:22,250,8146,133,117,5996.80,10258.12,0.00
2024-12-10 17:41:22,249,8146,133,116,6019.24,10258.12,0.00
2024-12-10 17:41:22,250,8145,133,117,5961.31,10258.46,0.00
2024-12-10 17:41:22,251,8144,133,118,5933.33,10258.72,0.00
2024-12-10 17:41:22,252,8143,134,118,5913.88,10258.86,0.00
2024-12-10 17:41:22,253,8142,135,118,5906.31,10258.89,0.00
2024-12-10 17:41:22,253,8143,135,118,5939.26,10259.00,0.00
2024-12-10 17:41:22,254,8143,135,119,5915.87,10259.00,0.00
2024-12-10 17:41:22,255,8142,135,120,5889.07,10259.05,0.00
2024-12-10 17:41:22,254,8142,134,120,5919.27,10259.05,0.00
2024-12-10 17:41:22,253,8142,134,119,5938.63,10259.08,0.00
2024-12-10 17:41:22,254,8141,135,119,5871.36,10259.43,0.00
2024-12-10 17:41:22,254,8142,135,119,6017.62,10260.00,0.00
2024-12-10 17:41:22,255,8142,135,120,5994.03,10260.00,0.00
2024-12-10 17:41:22,256,8141,136,120,5963.43,10260.08,0.00
2024-12-10 17:41:22,255,8141,135,120,5953.72,10260.42,0.00
2024-12-10 17:41:22,256,8140,135,121,5885.48,10260.71,0.00
2024-12-10 17:41:22,256,8141,135,121,5979.17,10261.00,0.00
2024-12-10 17:41:22,257,8141,136,121,5955.90,10261.00,0.00
2024-12-10 17:41:22,258,8140,137,121,5923.71,10261.10,0.00
2024-12-10 17:41:22,259,8139,137,122,5879.90,10261.28,0.00
2024-12-10 17:41:22,258,8139,137,121,5916.56,10261.31,0.00
2024-12-10 17:41:22,257,8139,136,121,5928.45,10261.42,0.00
2024-12-10 17:41:22,256,8139,136,120,5921.66,10261.65,0.00
2024-12-10 17:41:22,256,8140,136,120,5991.05,10262.00,0.00
2024-12-10 17:41:22,257,8140,137,120,5967.74,10262.00,0.00
2024-12-10 17:41:22,256,8140,137,119,5979.88,10262.11,0.00
2024-12-10 17:41:22,257,8139,137,120,5946.23,10262.14,0.00
2024-12-10 17:41:22,258,8138,138,120,5942.32,10262.31,0.00
2024-12-10 17:41:22,257,8138,137,120,5966.53,10262.33,0.00
2024-12-10 17:41:22,258,8137,137,121,5933.90,10262.43,0.00
2024-12-10 17:41:22,259,8136,137,122,5916.15,10262.44,0.00
2024-12-10 17:41:22,259,8137,137,122,5977.19,10263.00,0.00
2024-12-10 17:41:22,260,8137,137,123,5954.20,10263.00,0.00
2024-12-10 17:41:22,259,8137,137,122,5965.75,10263.11,0.00
2024-12-10 17:41:22,258,8137,137,121,5986.89,10263.11,0.00
2024-12-10 17:41:22,259,8136,137,122,5920.84,10263.52,0.00
2024-12-10 17:41:22,260,8135,137,123,5890.58,10263.63,0.00
2024-12-10 17:41:22,261,8134,138,123,5870.04,10263.67,0.00
2024-12-10 17:41:22,261,8135,138,123,6004.89,10264.00,0.00
2024-12-10 17:41:22,262,8135,138,124,5981.97,10264.00,0.00
2024-12-10 17:41:22,261,8135,138,123,5977.81,10264.11,0.00
2024-12-10 17:41:22,262,8134,138,124,5942.49,10264.24,0.00
2024-12-10 17:41:22,263,8133,138,125,5903.13,10264.47,0.00
2024-12-10 17:41:22,262,8133,138,124,5907.35,10264.69,0.00
2024-12-10 17:41:22,262,8134,138,124,6017.07,10265.00,0.00
2024-12-10 17:41:22,263,8134,138,125,5994.19,10265.00,0.00
2024-12-10 17:41:22,262,8134,137,125,6006.14,10265.09,0.00
2024-12-10 17:41:22,261,8134,137,124,6026.80,10265.11,0.00
2024-12-10 17:41:22,262,8133,138,124,5999.50,10265.16,0.00
2024-12-10 17:41:22,263,8132,139,124,5942.50,10265.75,0.00
2024-12-10 17:41:22,262,8132,138,124,5959.91,10265.76,0.00
2024-12-10 17:41:23,262,8133,138,124,6051.89,10266.00,0.00
2024-12-10 17:41:23,263,8133,138,125,6028.88,10266.00,0.00
2024-12-10 17:41:23,262,8133,137,125,5987.21,10266.43,0.00
2024-12-10 17:41:23,262,8134,137,125,6038.00,10267.00,0.00
2024-12-10 17:41:23,263,8134,138,125,6015.04,10267.00,0.00
2024-12-10 17:41:23,262,8134,138,124,6002.78,10267.11,0.00
2024-12-10 17:41:23,261,8134,137,124,6008.44,10267.25,0.00
2024-12-10 17:41:23,261,8135,137,124,5961.66,10268.00,0.00
2024-12-10 17:41:23,262,8135,138,124,5938.91,10268.00,0.00
2024-12-10 17:41:23,261,8135,137,124,5953.43,10268.08,0.00
2024-12-10 17:41:23,262,8134,137,125,5928.76,10268.11,0.00
2024-12-10 17:41:23,261,8134,137,124,5973.11,10268.11,0.00
2024-12-10 17:41:23,260,8134,137,123,5994.91,10268.12,0.00
2024-12-10 17:41:23,261,8133,138,123,5940.01,10268.43,0.00
2024-12-10 17:41:23,261,8134,138,123,5902.77,10269.00,0.00
2024-12-10 17:41:23,262,8134,138,124,5880.24,10269.00,0.00
2024-12-10 17:41:23,261,8134,137,124,5893.76,10269.09,0.00
2024-12-10 17:41:23,260,8134,137,123,5906.17,10269.11,0.00
2024-12-10 17:41:23,261,8133,137,124,5785.48,10269.92,0.00
2024-12-10 17:41:23,261,8134,137,124,5898.48,10270.00,0.00
2024-12-10 17:41:23,262,8134,137,125,5875.97,10270.00,0.00
2024-12-10 17:41:23,261,8134,136,125,5843.97,10270.46,0.00
2024-12-10 17:41:23,260,8134,136,124,5860.75,10270.51,0.00
2024-12-10 17:41:23,261,8133,136,125,5798.24,10270.82,0.00
2024-12-10 17:41:23,261,8134,136,125,5861.71,10271.00,0.00
2024-12-10 17:41:23,262,8134,137,125,5839.34,10271.00,0.00
2024-12-10 17:41:23,261,8134,136,125,5861.39,10271.00,0.00
2024-12-10 17:41:23,260,8134,136,124,5865.02,10271.11,0.00
2024-12-10 17:41:23,261,8133,137,124,5823.32,10271.30,0.00
2024-12-10 17:41:23,262,8132,138,124,5814.90,10271.46,0.00
2024-12-10 17:41:23,262,8133,138,124,5817.64,10272.00,0.00
2024-12-10 17:41:23,263,8133,138,125,5795.52,10272.00,0.00
2024-12-10 17:41:23,262,8133,137,125,5816.07,10272.02,0.00
2024-12-10 17:41:23,261,8133,137,124,5818.21,10272.10,0.00
2024-12-10 17:41:23,260,8133,136,124,5839.79,10272.11,0.00
2024-12-10 17:41:23,261,8132,137,124,5793.88,10272.34,0.00
2024-12-10 17:41:23,262,8131,138,124,5747.98,10272.61,0.00
2024-12-10 17:41:23,261,8131,138,123,5776.61,10272.66,0.00
2024-12-10 17:41:23,261,8132,138,123,5831.30,10273.00,0.00
2024-12-10 17:41:23,262,8132,138,124,5809.04,10273.00,0.00
2024-12-10 17:41:23,261,8132,138,123,5807.70,10273.09,0.00
2024-12-10 17:41:23,262,8131,138,124,5709.48,10273.76,0.00
2024-12-10 17:41:23,262,8132,138,124,5776.41,10274.00,0.00
2024-12-10 17:41:23,263,8132,139,124,5754.44,10274.00,0.00
2024-12-10 17:41:23,262,8132,138,124,5774.45,10274.02,0.00
2024-12-10 17:41:23,261,8132,137,124,5771.54,10274.06,0.00
2024-12-10 17:41:23,260,8132,137,123,5764.91,10274.11,0.00
2024-12-10 17:41:23,259,8132,137,122,5786.78,10274.11,0.00
2024-12-10 17:41:23,258,8132,136,122,5703.70,10274.86,0.00
2024-12-10 17:41:23,258,8133,136,122,5768.25,10275.00,0.00
2024-12-10 17:41:23,259,8133,136,123,5745.98,10275.00,0.00
2024-12-10 17:41:23,258,8133,136,122,5758.33,10275.09,0.00
2024-12-10 17:41:23,257,8133,136,121,5779.15,10275.11,0.00
2024-12-10 17:41:23,256,8133,135,121,5792.40,10275.20,0.00
2024-12-10 17:41:23,255,8133,135,120,5814.96,10275.20,0.00
2024-12-10 17:41:23,254,8133,135,119,5799.53,10275.56,0.00
2024-12-10 17:41:23,255,8132,135,120,5764.37,10275.69,0.00
2024-12-10 17:41:23,254,8132,135,119,5786.30,10275.81,0.00
2024-12-10 17:41:23,254,8133,135,119,5788.63,10276.00,0.00
2024-12-10 17:41:23,255,8133,135,120,5765.93,10276.00,0.00
2024-12-10 17:41:23,254,8133,135,119,5769.26,10276.11,0.00
2024-12-10 17:41:23,253,8133,135,118,5791.66,10276.11,0.00
2024-12-10 17:41:23,252,8133,135,117,5811.42,10276.14,0.00
2024-12-10 17:41:23,253,8132,136,117,5740.03,10276.49,0.00
2024-12-10 17:41:23,253,8133,136,117,5788.20,10277.00,0.00
2024-12-10 17:41:23,254,8133,137,117,5765.41,10277.00,0.00
2024-12-10 17:41:23,253,8133,136,117,5783.93,10277.04,0.00
2024-12-10 17:41:23,252,8133,136,116,5793.86,10277.10,0.00
2024-12-10 17:41:23,251,8133,136,115,5815.72,10277.11,0.00
2024-12-10 17:41:23,252,8132,137,115,5773.94,10277.30,0.00
2024-12-10 17:41:23,251,8132,136,115,5795.31,10277.41,0.00
2024-12-10 17:41:23,251,8133,136,115,5807.38,10278.00,0.00
2024-12-10 17:41:23,252,8133,137,115,5784.34,10278.00,0.00
2024-12-10 17:41:23,251,8133,137,114,5795.96,10278.11,0.00
2024-12-10 17:41:23,250,8133,136,114,5811.32,10278.19,0.00
2024-12-10 17:41:23,249,8133,136,113,5755.61,10278.61,0.00
2024-12-10 17:41:23,250,8132,137,113,5728.10,10278.66,0.00
2024-12-10 17:41:23,250,8133,137,113,5787.63,10279.00,0.00
2024-12-10 17:41:23,251,8133,137,114,5764.58,10279.00,0.00
2024-12-10 17:41:23,250,8133,136,114,5778.63,10279.09,0.00
2024-12-10 17:41:23,249,8133,135,114,5790.29,10279.12,0.00
2024-12-10 17:41:23,248,8133,135,113,5813.22,10279.12,0.00
2024-12-10 17:41:23,247,8133,135,112,5836.34,10279.12,0.00
2024-12-10 17:41:23,246,8133,134,112,5849.62,10279.12,0.00
2024-12-10 17:41:23,245,8133,133,112,5843.41,10279.41,0.00
2024-12-10 17:41:23,246,8132,134,112,5795.55,10279.65,0.00
2024-12-10 17:41:23,247,8131,134,113,5782.92,10279.68,0.00
2024-12-10 17:41:23,248,8130,135,113,5752.38,10279.88,0.00
2024-12-10 17:41:23,248,8131,135,113,5828.59,10280.00,0.00
2024-12-10 17:41:23,249,8131,135,114,5805.18,10280.00,0.00
2024-12-10 17:41:23,248,8131,135,113,5809.15,10280.11,0.00
2024-12-10 17:41:23,247,8131,134,113,5818.96,10280.19,0.00
2024-12-10 17:41:23,248,8130,135,113,5772.80,10280.42,0.00
2024-12-10 17:41:23,249,8129,135,114,5743.57,10280.73,0.00
2024-12-10 17:41:23,249,8130,135,114,5888.95,10281.00,0.00
2024-12-10 17:41:23,250,8130,136,114,5865.40,10281.00,0.00
2024-12-10 17:41:23,251,8129,136,115,5836.72,10281.06,0.00
2024-12-10 17:41:23,250,8129,136,114,5872.85,10281.12,0.00
2024-12-10 17:41:23,251,8128,136,115,5848.23,10281.14,0.00
2024-12-10 17:41:23,250,8128,135,115,5847.83,10281.29,0.00
2024-12-10 17:41:23,250,8129,135,115,5892.50,10282.00,0.00
2024-12-10 17:41:23,251,8129,135,116,5869.03,10282.00,0.00
2024-12-10 17:41:23,250,8129,135,115,5880.22,10282.12,0.00
2024-12-10 17:41:23,251,8128,135,116,5807.02,10282.61,0.00
2024-12-10 17:41:24,251,8129,135,116,5873.37,10283.00,0.00
2024-12-10 17:41:24,252,8129,135,117,5850.06,10283.00,0.00
2024-12-10 17:41:24,251,8129,135,116,5859.90,10283.13,0.00
2024-12-10 17:41:24,251,8129,135,116,5821.92,10284.00,0.00
2024-12-10 17:41:24,252,8129,136,116,5798.82,10284.00,0.00
2024-12-10 17:41:24,253,8128,136,117,5715.75,10284.47,0.00
2024-12-10 17:41:24,252,8128,135,117,5702.98,10284.92,0.00
2024-12-10 17:41:24,252,8129,135,117,5734.65,10285.00,0.00
2024-12-10 17:41:24,253,8129,135,118,5711.98,10285.00,0.00
2024-12-10 17:41:24,253,8130,135,118,5667.47,10286.00,0.00
2024-12-10 17:41:24,254,8130,135,119,5645.16,10286.00,0.00
2024-12-10 17:41:24,253,8130,134,119,5666.15,10286.02,0.00
2024-12-10 17:41:24,254,8129,134,120,5598.62,10286.39,0.00
2024-12-10 17:41:24,254,8130,134,120,5582.95,10287.00,0.00
2024-12-10 17:41:24,255,8130,135,120,5561.05,10287.00,0.00
2024-12-10 17:41:24,254,8130,135,119,5563.56,10287.13,0.00
2024-12-10 17:41:24,253,8130,135,118,5585.14,10287.13,0.00
2024-12-10 17:41:24,254,8129,136,118,5543.77,10287.33,0.00
2024-12-10 17:41:24,253,8129,135,118,5594.70,10287.35,0.00
2024-12-10 17:41:24,254,8128,135,119,5567.83,10287.40,0.00
2024-12-10 17:41:24,253,8128,135,118,5577.83,10287.73,0.00
2024-12-10 17:41:24,254,8127,135,119,5553.05,10287.76,0.00
2024-12-10 17:41:24,255,8126,136,119,5549.49,10287.84,0.00
2024-12-10 17:41:24,255,8127,136,119,5603.92,10288.00,0.00
2024-12-10 17:41:24,256,8127,136,120,5582.03,10288.00,0.00
2024-12-10 17:41:24,255,8127,136,119,5588.24,10288.15,0.00
2024-12-10 17:41:24,254,8127,135,119,5586.80,10288.29,0.00
2024-12-10 17:41:24,253,8127,134,119,5573.84,10288.47,0.00
2024-12-10 17:41:24,253,8128,134,119,5719.90,10289.00,0.00
2024-12-10 17:41:24,254,8128,134,120,5697.38,10289.00,0.00
2024-12-10 17:41:24,253,8128,133,120,5719.49,10289.00,0.00
2024-12-10 17:41:24,252,8128,132,120,5741.37,10289.01,0.00
2024-12-10 17:41:24,251,8128,132,119,5762.21,10289.02,0.00
2024-12-10 17:41:24,250,8128,131,119,5767.17,10289.09,0.00
2024-12-10 17:41:24,249,8128,131,118,5786.22,10289.12,0.00
2024-12-10 17:41:24,248,8128,131,117,5807.89,10289.13,0.00
2024-12-10 17:41:24,247,8128,130,117,5824.90,10289.19,0.00
2024-12-10 17:41:24,247,8129,130,117,5779.80,10290.00,0.00
2024-12-10 17:41:24,248,8129,130,118,5756.50,10290.00,0.00
2024-12-10 17:41:24,247,8129,129,118,5750.13,10290.13,0.00
2024-12-10 17:41:24,246,8129,129,117,5772.67,10290.13,0.00
2024-12-10 17:41:24,247,8128,130,117,5740.16,10290.22,0.00
2024-12-10 17:41:24,248,8127,130,118,5722.02,10290.29,0.00
2024-12-10 17:41:24,248,8128,130,118,5718.74,10291.00,0.00
2024-12-10 17:41:24,249,8128,130,119,5695.77,10291.00,0.00
2024-12-10 17:41:24,248,8128,130,118,5705.12,10291.13,0.00
2024-12-10 17:41:24,248,8129,130,118,5715.62,10292.00,0.00
2024-12-10 17:41:24,249,8129,131,118,5692.67,10292.00,0.00
2024-12-10 17:41:24,250,8128,131,119,5665.79,10292.05,0.00
2024-12-10 17:41:24,249,8128,130,119,5704.77,10292.12,0.00
2024-12-10 17:41:24,248,8128,129,119,5725.85,10292.13,0.00
2024-12-10 17:41:24,249,8127,130,119,5643.55,10292.63,0.00
2024-12-10 17:41:24,249,8128,130,119,5644.11,10293.00,0.00
2024-12-10 17:41:24,250,8128,130,120,5621.54,10293.00,0.00
2024-12-10 17:41:24,249,8128,129,120,5635.88,10293.08,0.00
2024-12-10 17:41:24,248,8128,128,120,5653.12,10293.12,0.00
2024-12-10 17:41:24,249,8127,129,120,5630.00,10293.13,0.00
2024-12-10 17:41:24,248,8127,129,119,5600.80,10293.73,0.00
2024-12-10 17:41:24,249,8126,130,119,5573.87,10293.76,0.00
2024-12-10 17:41:24,249,8127,130,119,5668.97,10294.00,0.00
2024-12-10 17:41:24,250,8127,131,119,5646.29,10294.00,0.00
2024-12-10 17:41:24,249,8127,130,119,5666.09,10294.03,0.00
2024-12-10 17:41:24,248,8127,129,119,5595.11,10294.80,0.00
2024-12-10 17:41:24,249,8126,129,120,5560.04,10294.91,0.00
2024-12-10 17:41:24,248,8126,128,120,5586.48,10294.92,0.00
2024-12-10 17:41:24,248,8127,128,120,5699.09,10295.00,0.00
2024-12-10 17:41:24,249,8127,128,121,5676.20,10295.00,0.00
2024-12-10 17:41:24,248,8127,127,121,5696.19,10295.03,0.00
2024-12-10 17:41:24,247,8127,126,121,5718.84,10295.03,0.00
2024-12-10 17:41:24,246,8127,125,121,5721.50,10295.11,0.00
2024-12-10 17:41:24,245,8127,124,121,5744.43,10295.11,0.00
2024-12-10 17:41:24,244,8127,123,121,5724.37,10295.54,0.00
2024-12-10 17:41:24,245,8126,123,122,5655.79,10295.91,0.00
2024-12-10 17:41:24,245,8127,123,122,5730.26,10296.00,0.00
2024-12-10 17:41:24,246,8127,124,122,5706.97,10296.00,0.00
2024-12-10 17:41:24,245,8127,124,121,5706.61,10296.12,0.00
2024-12-10 17:41:24,244,8127,124,120,5696.62,10296.44,0.00
2024-12-10 17:41:24,245,8126,124,121,5645.74,10296.69,0.00
2024-12-10 17:41:24,246,8125,124,122,5653.35,10296.70,0.00
2024-12-10 17:41:24,246,8126,124,122,5705.90,10297.00,0.00
2024-12-10 17:41:24,247,8126,125,122,5682.80,10297.00,0.00
2024-12-10 17:41:24,246,8126,125,121,5682.18,10297.12,0.00
2024-12-10 17:41:24,245,8126,125,120,5704.95,10297.12,0.00
2024-12-10 17:41:24,244,8126,124,120,5696.43,10297.43,0.00
2024-12-10 17:41:24,244,8127,124,120,5741.97,10298.00,0.00
2024-12-10 17:41:24,245,8127,125,120,5718.53,10298.00,0.00
2024-12-10 17:41:24,244,8127,125,119,5722.29,10298.11,0.00
2024-12-10 17:41:24,243,8127,125,118,5744.57,10298.12,0.00
2024-12-10 17:41:24,242,8127,124,118,5736.44,10298.42,0.00
2024-12-10 17:41:24,242,8128,124,118,5695.00,10299.00,0.00
2024-12-10 17:41:24,243,8128,124,119,5671.56,10299.00,0.00
2024-12-10 17:41:24,242,8128,123,119,5689.91,10299.05,0.00
2024-12-10 17:41:24,241,8128,123,118,5698.32,10299.11,0.00
2024-12-10 17:41:24,240,8128,123,117,5721.63,10299.11,0.00
2024-12-10 17:41:24,239,8128,122,117,5722.04,10299.25,0.00
2024-12-10 17:41:24,239,8129,122,117,5681.00,10300.00,0.00
2024-12-10 17:41:24,240,8129,123,117,5657.33,10300.00,0.00
2024-12-10 17:41:24,239,8129,122,117,5666.71,10300.10,0.00
2024-12-10 17:41:24,238,8129,122,116,5667.62,10300.22,0.00
2024-12-10 17:41:24,239,8128,123,116,5578.23,10300.83,0.00
2024-12-10 17:41:25,239,8129,123,116,5639.52,10301.00,0.00
2024-12-10 17:41:25,240,8129,123,117,5616.02,10301.00,0.00
2024-12-10 17:41:25,241,8128,124,117,5535.17,10301.49,0.00
2024-12-10 17:41:25,240,8128,123,117,5568.04,10301.56,0.00
2024-12-10 17:41:25,240,8129,123,117,5594.15,10302.00,0.00
2024-12-10 17:41:25,241,8129,123,118,5570.94,10302.00,0.00
2024-12-10 17:41:25,240,8129,123,117,5575.73,10302.11,0.00
2024-12-10 17:41:25,239,8129,122,117,5598.20,10302.11,0.00
2024-12-10 17:41:25,240,8128,123,117,5521.87,10302.64,0.00
2024-12-10 17:41:25,240,8129,123,117,5568.88,10303.00,0.00
2024-12-10 17:41:25,241,8129,123,118,5545.77,10303.00,0.00
2024-12-10 17:41:25,240,8129,122,118,5563.32,10303.05,0.00
2024-12-10 17:41:25,239,8129,122,117,5570.25,10303.13,0.00
2024-12-10 17:41:25,238,8129,121,117,5592.79,10303.13,0.00
2024-12-10 17:41:25,237,8129,121,116,5615.95,10303.13,0.00
2024-12-10 17:41:25,238,8128,121,117,5580.71,10303.25,0.00
2024-12-10 17:41:25,239,8127,122,117,5556.79,10303.66,0.00
2024-12-10 17:41:25,239,8128,122,117,5617.47,10304.00,0.00
2024-12-10 17:41:25,240,8128,123,117,5594.07,10304.00,0.00
2024-12-10 17:41:25,239,8128,123,116,5595.54,10304.13,0.00
2024-12-10 17:41:25,238,8128,123,115,5618.62,10304.13,0.00
2024-12-10 17:41:25,237,8128,123,114,5641.89,10304.13,0.00
2024-12-10 17:41:25,236,8128,122,114,5650.38,10304.28,0.00
2024-12-10 17:41:25,235,8128,121,114,5654.02,10304.48,0.00
2024-12-10 17:41:25,235,8129,121,114,5718.94,10305.00,0.00
2024-12-10 17:41:25,236,8129,121,115,5694.70,10305.00,0.00
2024-12-10 17:41:25,235,8129,120,115,5708.92,10305.10,0.00
2024-12-10 17:41:25,236,8128,120,116,5660.77,10305.25,0.00
2024-12-10 17:41:25,235,8128,119,116,5681.40,10305.41,0.00
2024-12-10 17:41:25,236,8127,120,116,5652.55,10305.46,0.00
2024-12-10 17:41:25,235,8127,119,116,5660.27,10305.72,0.00
2024-12-10 17:41:25,236,8126,119,117,5634.55,10305.75,0.00
2024-12-10 17:41:25,236,8127,119,117,5663.22,10306.00,0.00
2024-12-10 17:41:25,237,8127,120,117,5639.33,10306.00,0.00
2024-12-10 17:41:25,238,8126,121,117,5611.32,10306.05,0.00
2024-12-10 17:41:25,237,8126,121,116,5663.72,10306.11,0.00
2024-12-10 17:41:25,236,8126,121,115,5685.11,10306.13,0.00
2024-12-10 17:41:25,235,8126,121,114,5707.12,10306.15,0.00
2024-12-10 17:41:25,234,8126,120,114,5711.52,10306.34,0.00
2024-12-10 17:41:25,235,8125,121,114,5638.79,10306.80,0.00
2024-12-10 17:41:25,235,8126,121,114,5781.48,10307.00,0.00
2024-12-10 17:41:25,236,8126,122,114,5756.98,10307.00,0.00
2024-12-10 17:41:25,237,8125,122,115,5705.80,10307.19,0.00
2024-12-10 17:41:25,236,8125,121,115,5746.66,10307.41,0.00
2024-12-10 17:41:25,236,8126,121,115,5811.14,10308.00,0.00
2024-12-10 17:41:25,237,8126,121,116,5786.62,10308.00,0.00
2024-12-10 17:41:25,236,8126,120,116,5802.00,10308.09,0.00
2024-12-10 17:41:25,237,8125,121,116,5711.23,10308.66,0.00
2024-12-10 17:41:25,237,8126,121,116,5769.56,10309.00,0.00
2024-12-10 17:41:25,238,8126,121,117,5745.32,10309.00,0.00
2024-12-10 17:41:25,239,8125,121,118,5712.26,10309.10,0.00
2024-12-10 17:41:25,238,8125,121,117,5747.55,10309.15,0.00
2024-12-10 17:41:25,237,8125,120,117,5740.60,10309.45,0.00
2024-12-10 17:41:25,237,8126,120,117,5754.25,10310.00,0.00
2024-12-10 17:41:25,238,8126,121,117,5730.07,10310.00,0.00
2024-12-10 17:41:25,237,8126,121,116,5740.81,10310.10,0.00
2024-12-10 17:41:25,236,8126,120,116,5757.30,10310.17,0.00
2024-12-10 17:41:25,235,8126,119,116,5770.64,10310.28,0.00
2024-12-10 17:41:25,235,8127,119,116,5767.14,10311.00,0.00
2024-12-10 17:41:25,236,8127,119,117,5742.70,10311.00,0.00
2024-12-10 17:41:25,235,8127,119,116,5742.63,10311.15,0.00
2024-12-10 17:41:25,236,8126,120,116,5659.37,10311.57,0.00
2024-12-10 17:41:25,237,8125,120,117,5650.74,10311.63,0.00
2024-12-10 17:41:25,237,8126,120,117,5668.73,10312.00,0.00
2024-12-10 17:41:25,238,8126,120,118,5644.92,10312.00,0.00
2024-12-10 17:41:25,237,8126,120,117,5654.42,10312.10,0.00
2024-12-10 17:41:25,238,8125,120,118,5612.09,10312.29,0.00
2024-12-10 17:41:25,237,8125,119,118,5638.58,10312.46,0.00
2024-12-10 17:41:25,237,8126,119,118,5706.01,10313.00,0.00
2024-12-10 17:41:25,238,8126,120,118,5682.04,10313.00,0.00
2024-12-10 17:41:25,239,8125,121,118,5554.62,10313.82,0.00
2024-12-10 17:41:25,239,8126,121,118,5617.94,10314.00,0.00
2024-12-10 17:41:25,240,8126,122,118,5594.53,10314.00,0.00
2024-12-10 17:41:25,239,8126,122,117,5599.42,10314.11,0.00
2024-12-10 17:41:25,238,8126,122,116,5618.63,10314.15,0.00
2024-12-10 17:41:25,239,8125,122,117,5512.36,10314.80,0.00
2024-12-10 17:41:25,239,8126,122,117,5570.79,10315.00,0.00
2024-12-10 17:41:25,240,8126,122,118,5547.57,10315.00,0.00
2024-12-10 17:41:25,241,8125,122,119,5504.06,10315.13,0.00
2024-12-10 17:41:25,240,8125,122,118,5485.93,10315.60,0.00
2024-12-10 17:41:25,240,8126,122,118,5513.15,10316.00,0.00
2024-12-10 17:41:25,241,8126,122,119,5490.28,10316.00,0.00
2024-12-10 17:41:25,240,8126,122,118,5501.59,10316.11,0.00
2024-12-10 17:41:25,241,8125,122,119,5453.97,10316.35,0.00
2024-12-10 17:41:25,242,8124,123,119,5432.35,10316.49,0.00
2024-12-10 17:41:25,242,8125,123,119,5472.34,10317.00,0.00
2024-12-10 17:41:25,243,8125,124,119,5449.82,10317.00,0.00
2024-12-10 17:41:25,244,8124,124,120,5395.86,10317.24,0.00
2024-12-10 17:41:25,245,8123,125,120,5376.06,10317.43,0.00
2024-12-10 17:41:25,245,8124,125,120,5471.07,10318.00,0.00
2024-12-10 17:41:25,246,8124,125,121,5448.83,10318.00,0.00
2024-12-10 17:41:25,245,8124,125,120,5458.12,10318.11,0.00
2024-12-10 17:41:25,245,8125,125,120,5474.75,10319.00,0.00
2024-12-10 17:41:25,246,8125,126,120,5452.50,10319.00,0.00
2024-12-10 17:41:25,245,8125,125,120,5466.97,10319.06,0.00
2024-12-10 17:41:25,244,8125,124,120,5487.26,10319.07,0.00
2024-12-10 17:41:25,243,8125,124,119,5498.40,10319.11,0.00
2024-12-10 17:41:25,242,8125,124,118,5516.87,10319.15,0.00
2024-12-10 17:41:26,241,8125,123,118,5538.48,10319.16,0.00
2024-12-10 17:41:26,242,8124,123,119,5488.66,10319.41,0.00
2024-12-10 17:41:26,242,8125,123,119,5453.31,10320.00,0.00
2024-12-10 17:41:26,243,8125,124,119,5430.87,10320.00,0.00
2024-12-10 17:41:26,242,8125,123,119,5440.48,10320.04,0.00
2024-12-10 17:41:26,243,8124,123,120,5399.34,10320.13,0.00
2024-12-10 17:41:26,242,8124,123,119,5423.80,10320.16,0.00
2024-12-10 17:41:26,243,8123,123,120,5393.43,10320.24,0.00
2024-12-10 17:41:26,242,8123,123,119,5412.20,10320.28,0.00
2024-12-10 17:41:26,242,8124,123,119,5421.39,10321.00,0.00
2024-12-10 17:41:26,243,8124,123,120,5399.08,10321.00,0.00
2024-12-10 17:41:26,242,8124,122,120,5420.11,10321.01,0.00
2024-12-10 17:41:26,241,8124,121,120,5435.17,10321.01,0.00
2024-12-10 17:41:26,240,8124,120,120,5432.10,10321.15,0.00
2024-12-10 17:41:26,239,8124,119,120,5454.40,10321.16,0.00
2024-12-10 17:41:26,240,8123,120,120,5412.81,10321.35,0.00
2024-12-10 17:41:26,239,8123,119,120,5415.75,10321.81,0.00
2024-12-10 17:41:26,239,8124,119,120,5515.22,10322.00,0.00
2024-12-10 17:41:26,240,8124,119,121,5492.24,10322.00,0.00
2024-12-10 17:41:26,239,8124,119,120,5490.64,10322.16,0.00
2024-12-10 17:41:26,238,8124,118,120,5513.28,10322.16,0.00
2024-12-10 17:41:26,237,8124,117,120,5501.03,10322.49,0.00
2024-12-10 17:41:26,237,8124,117,120,5517.09,10323.00,0.00
2024-12-10 17:41:26,238,8124,117,121,5493.91,10323.00,0.00
2024-12-10 17:41:26,237,8124,117,120,5503.63,10323.10,0.00
2024-12-10 17:41:26,236,8124,116,120,5525.64,10323.11,0.00
2024-12-10 17:41:26,235,8124,116,119,5544.78,10323.15,0.00
2024-12-10 17:41:26,234,8124,115,119,5568.04,10323.15,0.00
2024-12-10 17:41:26,235,8123,116,119,5505.27,10323.54,0.00
2024-12-10 17:41:26,234,8123,115,119,5495.83,10323.98,0.00
2024-12-10 17:41:26,234,8124,115,119,5537.77,10324.00,0.00
2024-12-10 17:41:26,235,8124,116,119,5514.20,10324.00,0.00
2024-12-10 17:41:26,236,8123,116,120,5486.48,10324.05,0.00
2024-12-10 17:41:26,235,8123,116,119,5533.60,10324.15,0.00
2024-12-10 17:41:26,234,8123,115,119,5479.77,10324.76,0.00
2024-12-10 17:41:26,234,8124,115,119,5541.02,10325.00,0.00
2024-12-10 17:41:26,235,8124,116,119,5517.44,10325.00,0.00
2024-12-10 17:41:26,236,8123,116,120,5430.00,10325.54,0.00
2024-12-10 17:41:26,235,8123,115,120,5442.30,10325.83,0.00
2024-12-10 17:41:26,235,8124,115,120,5492.68,10326.00,0.00
2024-12-10 17:41:26,236,8124,115,121,5469.40,10326.00,0.00
2024-12-10 17:41:26,235,8124,115,120,5479.54,10326.11,0.00
2024-12-10 17:41:26,234,8124,115,119,5498.12,10326.15,0.00
2024-12-10 17:41:26,233,8124,115,118,5520.84,10326.15,0.00
2024-12-10 17:41:26,232,8124,114,118,5543.63,10326.16,0.00
2024-12-10 17:41:26,232,8125,114,118,5519.17,10327.00,0.00
2024-12-10 17:41:26,233,8125,115,118,5495.48,10327.00,0.00
2024-12-10 17:41:26,232,8125,114,118,5485.29,10327.25,0.00
2024-12-10 17:41:26,232,8126,114,118,5425.18,10328.00,0.00
2024-12-10 17:41:26,233,8126,114,119,5401.89,10328.00,0.00
2024-12-10 17:41:26,232,8126,113,119,5418.97,10328.06,0.00
2024-12-10 17:41:26,231,8126,113,118,5433.51,10328.11,0.00
2024-12-10 17:41:26,230,8126,113,117,5452.66,10328.15,0.00
2024-12-10 17:41:26,229,8126,112,117,5439.49,10328.48,0.00
2024-12-10 17:41:26,229,8127,112,117,5404.74,10329.00,0.00
2024-12-10 17:41:26,230,8127,113,117,5381.24,10329.00,0.00
2024-12-10 17:41:26,229,8127,113,116,5386.74,10329.11,0.00
2024-12-10 17:41:26,228,8127,112,116,5390.52,10329.23,0.00
2024-12-10 17:41:26,227,8127,111,116,5353.63,10329.76,0.00
2024-12-10 17:41:26,228,8126,112,116,5304.71,10329.96,0.00
2024-12-10 17:41:26,228,8127,112,116,5348.68,10330.00,0.00
2024-12-10 17:41:26,229,8127,113,116,5325.33,10330.00,0.00
2024-12-10 17:41:26,228,8127,112,116,5340.53,10330.01,0.00
2024-12-10 17:41:26,228,8128,112,116,5308.57,10331.00,0.00
2024-12-10 17:41:26,229,8128,112,117,5285.39,10331.00,0.00
2024-12-10 17:41:26,230,8127,113,117,5203.53,10331.47,0.00
2024-12-10 17:41:26,229,8127,112,117,5251.54,10331.51,0.00
2024-12-10 17:41:26,229,8128,112,117,5219.02,10332.00,0.00
2024-12-10 17:41:26,230,8128,113,117,5196.33,10332.00,0.00
2024-12-10 17:41:26,229,8128,112,117,5218.12,10332.01,0.00
2024-12-10 17:41:26,228,8128,112,116,5226.55,10332.11,0.00
2024-12-10 17:41:26,227,8128,112,115,5245.95,10332.14,0.00
2024-12-10 17:41:26,226,8128,112,114,5268.71,10332.14,0.00
2024-12-10 17:41:26,227,8127,113,114,5178.30,10332.73,0.00
2024-12-10 17:41:26,228,8126,114,114,5156.24,10332.84,0.00
2024-12-10 17:41:26,228,8127,114,114,5217.86,10333.00,0.00
2024-12-10 17:41:26,229,8127,115,114,5195.07,10333.00,0.00
2024-12-10 17:41:26,230,8126,115,115,5103.12,10333.53,0.00
2024-12-10 17:41:26,231,8125,116,115,5071.76,10333.91,0.00
2024-12-10 17:41:26,231,8126,116,115,5202.01,10334.00,0.00
2024-12-10 17:41:26,232,8126,117,115,5179.59,10334.00,0.00
2024-12-10 17:41:26,231,8126,117,114,5177.92,10334.15,0.00
2024-12-10 17:41:26,230,8126,116,114,5199.98,10334.15,0.00
2024-12-10 17:41:26,231,8125,116,115,5144.75,10334.45,0.00
2024-12-10 17:41:26,232,8124,116,116,5091.86,10334.79,0.00
2024-12-10 17:41:26,232,8125,116,116,5212.68,10335.00,0.00
2024-12-10 17:41:26,233,8125,116,117,5190.31,10335.00,0.00
2024-12-10 17:41:26,232,8125,116,116,5188.69,10335.15,0.00
2024-12-10 17:41:26,231,8125,115,116,5171.60,10335.50,0.00
2024-12-10 17:41:26,230,8125,115,115,5146.73,10335.83,0.00
2024-12-10 17:41:26,230,8126,115,115,5246.64,10336.00,0.00
2024-12-10 17:41:26,231,8126,115,116,5223.93,10336.00,0.00
2024-12-10 17:41:26,230,8126,115,115,5230.51,10336.12,0.00
2024-12-10 17:41:26,229,8126,115,114,5250.20,10336.14,0.00
2024-12-10 17:41:26,230,8125,115,115,5204.07,10336.38,0.00
2024-12-10 17:41:26,231,8124,116,115,5124.54,10337.00,0.00
2024-12-10 17:41:26,231,8125,116,115,5168.58,10337.00,0.00
2024-12-10 17:41:26,232,8125,117,115,5146.30,10337.00,0.00
2024-12-10 17:41:26,231,8125,117,114,5074.66,10337.67,0.00
2024-12-10 17:41:27,231,8126,117,114,5162.31,10338.00,0.00
2024-12-10 17:41:27,232,8126,118,114,5140.06,10338.00,0.00
2024-12-10 17:41:27,231,8126,117,114,5138.65,10338.14,0.00
2024-12-10 17:41:27,232,8125,118,114,5089.68,10338.39,0.00
2024-12-10 17:41:27,231,8125,118,113,5097.35,10338.77,0.00
2024-12-10 17:41:27,231,8126,118,113,5103.87,10339.00,0.00
2024-12-10 17:41:27,232,8126,118,114,5081.87,10339.00,0.00
2024-12-10 17:41:27,231,8126,117,114,5093.61,10339.10,0.00
2024-12-10 17:41:27,230,8126,117,113,5102.29,10339.14,0.00
2024-12-10 17:41:27,229,8126,117,112,5124.11,10339.14,0.00
2024-12-10 17:41:27,229,8127,117,112,5098.23,10340.00,0.00
2024-12-10 17:41:27,230,8127,118,112,5076.07,10340.00,0.00
2024-12-10 17:41:27,229,8127,118,111,5078.41,10340.12,0.00
2024-12-10 17:41:27,228,8127,117,111,5098.42,10340.14,0.00
2024-12-10 17:41:27,227,8127,117,110,5114.02,10340.20,0.00
2024-12-10 17:41:27,226,8127,117,109,5096.37,10340.58,0.00
2024-12-10 17:41:27,226,8128,117,109,5069.67,10341.00,0.00
2024-12-10 17:41:27,227,8128,118,109,5047.34,10341.00,0.00
2024-12-10 17:41:27,226,8128,117,109,5035.19,10341.14,0.00
2024-12-10 17:41:27,226,8129,117,109,4976.19,10342.00,0.00
2024-12-10 17:41:27,227,8129,118,109,4954.27,10342.00,0.00
2024-12-10 17:41:27,226,8129,117,109,4952.44,10342.14,0.00
2024-12-10 17:41:27,225,8129,117,108,4973.99,10342.14,0.00
2024-12-10 17:41:27,224,8129,117,107,4953.84,10342.52,0.00
2024-12-10 17:41:27,224,8130,117,107,4908.57,10343.00,0.00
2024-12-10 17:41:27,225,8130,118,107,4886.76,10343.00,0.00
2024-12-10 17:41:27,224,8130,118,106,4895.68,10343.12,0.00
2024-12-10 17:41:27,223,8130,118,105,4915.32,10343.14,0.00
2024-12-10 17:41:27,222,8130,117,105,4937.02,10343.14,0.00
2024-12-10 17:41:27,223,8129,118,105,4875.72,10343.45,0.00
2024-12-10 17:41:27,223,8130,118,105,4845.99,10344.00,0.00
2024-12-10 17:41:27,224,8130,118,106,4824.35,10344.00,0.00
2024-12-10 17:41:27,223,8130,117,106,4845.52,10344.00,0.00
2024-12-10 17:41:27,222,8130,116,106,4866.89,10344.00,0.00
2024-12-10 17:41:27,221,8130,116,105,4739.25,10344.96,0.00
2024-12-10 17:41:27,221,8131,116,105,4822.67,10345.00,0.00
2024-12-10 17:41:27,222,8131,117,105,4800.94,10345.00,0.00
2024-12-10 17:41:27,221,8131,116,105,4817.53,10345.05,0.00
2024-12-10 17:41:27,220,8131,115,105,4804.93,10345.27,0.00
2024-12-10 17:41:27,219,8131,114,105,4811.89,10345.31,0.00
2024-12-10 17:41:27,220,8130,115,105,4787.21,10345.35,0.00
2024-12-10 17:41:27,221,8129,115,106,4793.21,10345.45,0.00
2024-12-10 17:41:27,221,8130,115,106,4798.58,10346.00,0.00
2024-12-10 17:41:27,222,8130,116,106,4776.96,10346.00,0.00
2024-12-10 17:41:27,221,8130,115,106,4774.28,10346.14,0.00
2024-12-10 17:41:27,220,8130,114,106,4795.51,10346.15,0.00
2024-12-10 17:41:27,220,8131,114,106,4816.48,10347.00,0.00
2024-12-10 17:41:27,221,8131,114,107,4794.69,10347.00,0.00
2024-12-10 17:41:27,220,8131,114,106,4798.64,10347.11,0.00
2024-12-10 17:41:27,219,8131,113,106,4816.79,10347.15,0.00
2024-12-10 17:41:27,218,8131,112,106,4810.66,10347.42,0.00
2024-12-10 17:41:27,218,8132,112,106,4758.67,10348.00,0.00
2024-12-10 17:41:27,219,8132,112,107,4736.94,10348.00,0.00
2024-12-10 17:41:27,218,8132,111,107,4733.36,10348.15,0.00
2024-12-10 17:41:27,219,8131,112,107,4709.39,10348.18,0.00
2024-12-10 17:41:27,218,8131,111,107,4774.66,10348.19,0.00
2024-12-10 17:41:27,217,8131,111,106,4742.53,10348.69,0.00
2024-12-10 17:41:27,218,8130,111,107,4707.57,10348.82,0.00
2024-12-10 17:41:27,217,8130,110,107,4727.43,10348.93,0.00
2024-12-10 17:41:27,217,8131,110,107,4764.78,10349.00,0.00
2024-12-10 17:41:27,218,8131,110,108,4742.93,10349.00,0.00
2024-12-10 17:41:27,219,8130,111,108,4721.27,10349.01,0.00
2024-12-10 17:41:27,218,8130,110,108,4769.06,10349.06,0.00
2024-12-10 17:41:27,217,8130,110,107,4783.90,10349.12,0.00
2024-12-10 17:41:27,216,8130,110,106,4801.75,10349.15,0.00
2024-12-10 17:41:27,215,8130,109,106,4823.12,10349.16,0.00
2024-12-10 17:41:27,216,8129,110,106,4793.14,10349.24,0.00
2024-12-10 17:41:27,216,8130,110,106,4838.36,10350.00,0.00
2024-12-10 17:41:27,217,8130,110,107,4816.06,10350.00,0.00
2024-12-10 17:41:27,216,8130,109,107,4832.63,10350.06,0.00
2024-12-10 17:41:27,217,8129,109,108,4793.21,10350.14,0.00
2024-12-10 17:41:27,218,8128,109,109,4793.07,10350.16,0.00
2024-12-10 17:41:27,217,8128,109,108,4850.94,10350.16,0.00
2024-12-10 17:41:27,216,8128,108,108,4872.44,10350.16,0.00
2024-12-10 17:41:27,217,8127,108,109,4820.75,10350.43,0.00
2024-12-10 17:41:27,216,8127,108,108,4803.47,10350.89,0.00
2024-12-10 17:41:27,216,8128,108,108,4931.81,10351.00,0.00
2024-12-10 17:41:27,217,8128,109,108,4909.08,10351.00,0.00
2024-12-10 17:41:27,216,8128,108,108,4927.99,10351.04,0.00
2024-12-10 17:41:27,215,8128,108,107,4939.38,10351.11,0.00
2024-12-10 17:41:27,215,8129,108,107,4994.69,10352.00,0.00
2024-12-10 17:41:27,216,8129,109,107,4971.56,10352.00,0.00
2024-12-10 17:41:27,215,8129,108,107,4869.53,10352.85,0.00
2024-12-10 17:41:27,215,8130,108,107,4882.89,10353.00,0.00
2024-12-10 17:41:27,216,8130,108,108,4860.29,10353.00,0.00
2024-12-10 17:41:27,215,8130,107,108,4872.33,10353.10,0.00
2024-12-10 17:41:27,214,8130,107,107,4890.75,10353.11,0.00
2024-12-10 17:41:27,215,8129,108,107,4866.09,10353.14,0.00
2024-12-10 17:41:27,214,8129,107,107,4876.28,10353.15,0.00
2024-12-10 17:41:27,213,8129,107,106,4898.68,10353.16,0.00
2024-12-10 17:41:27,214,8128,108,106,4866.13,10353.26,0.00
2024-12-10 17:41:27,215,8127,108,107,4826.25,10353.47,0.00
2024-12-10 17:41:27,214,8127,108,106,4869.65,10353.67,0.00
2024-12-10 17:41:27,213,8127,107,106,4850.99,10353.95,0.00
2024-12-10 17:41:27,213,8128,107,106,4875.34,10354.00,0.00
2024-12-10 17:41:27,214,8128,108,106,4852.56,10354.00,0.00
2024-12-10 17:41:27,213,8128,107,106,4817.42,10354.13,0.00
2024-12-10 17:41:27,212,8128,107,105,4838.19,10354.15,0.00
2024-12-10 17:41:27,213,8127,108,105,4783.62,10354.40,0.00
2024-12-10 17:41:27,214,8126,108,106,4789.84,10354.47,0.00
2024-12-10 17:41:27,214,8127,108,106,4943.49,10355.00,0.00
2024-12-10 17:41:27,215,8127,109,106,4920.49,10355.00,0.00
2024-12-10 17:41:27,214,8127,108,106,4941.00,10355.03,0.00
2024-12-10 17:41:27,213,8127,107,106,4960.32,10355.06,0.00
2024-12-10 17:41:27,212,8127,107,105,4965.67,10355.14,0.00
2024-12-10 17:41:27,211,8127,107,104,4988.72,10355.14,0.00
2024-12-10 17:41:27,212,8126,108,104,4887.59,10355.78,0.00
2024-12-10 17:41:27,211,8126,107,104,4922.37,10355.79,0.00
2024-12-10 17:41:27,210,8126,106,104,4892.08,10355.98,0.00
2024-12-10 17:41:27,210,8127,106,104,5037.56,10356.00,0.00
2024-12-10 17:41:27,211,8127,107,104,5013.69,10356.00,0.00
2024-12-10 17:41:28,210,8127,107,103,5013.45,10356.14,0.00
2024-12-10 17:41:28,209,8127,106,103,5036.94,10356.14,0.00
2024-12-10 17:41:28,208,8127,106,102,5053.10,10356.22,0.00
2024-12-10 17:41:28,207,8127,105,102,5043.78,10356.48,0.00
2024-12-10 17:41:28,206,8127,104,102,5028.72,10356.84,0.00
2024-12-10 17:41:28,206,8128,104,102,5104.58,10357.00,0.00
2024-12-10 17:41:28,207,8128,104,103,5079.92,10357.00,0.00
2024-12-10 17:41:28,206,8128,103,103,5079.99,10357.14,0.00
2024-12-10 17:41:28,206,8129,103,103,5017.53,10358.00,0.00
2024-12-10 17:41:28,207,8129,104,103,4993.29,10358.00,0.00
2024-12-10 17:41:28,206,8129,104,102,5000.47,10358.11,0.00
2024-12-10 17:41:28,205,8129,103,102,5021.34,10358.14,0.00
2024-12-10 17:41:28,204,8129,103,101,5045.44,10358.14,0.00
2024-12-10 17:41:28,204,8130,103,101,4977.84,10359.00,0.00
2024-12-10 17:41:28,205,8130,103,102,4953.55,10359.00,0.00
2024-12-10 17:41:28,204,8130,102,102,4968.69,10359.09,0.00
2024-12-10 17:41:28,203,8130,102,101,4977.88,10359.14,0.00
2024-12-10 17:41:28,202,8130,102,100,5002.01,10359.14,0.00
2024-12-10 17:41:28,201,8130,101,100,5026.38,10359.14,0.00
2024-12-10 17:41:28,200,8130,101,99,5036.40,10359.29,0.00
2024-12-10 17:41:28,199,8130,101,98,5039.29,10359.43,0.00
2024-12-10 17:41:28,199,8131,101,98,5020.42,10360.00,0.00
2024-12-10 17:41:28,200,8131,101,99,4995.32,10360.00,0.00
2024-12-10 17:41:28,199,8131,101,98,4995.48,10360.14,0.00
2024-12-10 17:41:28,198,8131,101,97,5020.19,10360.14,0.00
2024-12-10 17:41:28,197,8131,101,96,5044.49,10360.15,0.00
2024-12-10 17:41:28,198,8130,101,97,4990.51,10360.41,0.00
2024-12-10 17:41:28,197,8130,100,97,4994.62,10360.52,0.00
2024-12-10 17:41:28,197,8131,100,97,4996.71,10361.00,0.00
2024-12-10 17:41:28,198,8131,101,97,4971.48,10361.00,0.00
2024-12-10 17:41:28,197,8131,100,97,4995.14,10361.02,0.00
2024-12-10 17:41:28,196,8131,99,97,5008.71,10361.02,0.00
2024-12-10 17:41:28,195,8131,99,96,5023.27,10361.10,0.00
2024-12-10 17:41:28,194,8131,98,96,5030.44,10361.27,0.00
2024-12-10 17:41:28,193,8131,97,96,5002.55,10361.78,0.00
2024-12-10 17:41:28,193,8132,97,96,5087.55,10362.00,0.00
2024-12-10 17:41:28,194,8132,97,97,5061.32,10362.00,0.00
2024-12-10 17:41:28,193,8132,96,97,5061.83,10362.15,0.00
2024-12-10 17:41:28,193,8133,96,97,5017.24,10363.00,0.00
2024-12-10 17:41:28,194,8133,96,98,4991.38,10363.00,0.00
2024-12-10 17:41:28,193,8133,95,98,5008.68,10363.08,0.00
2024-12-10 17:41:28,193,8134,95,98,4939.95,10364.00,0.00
2024-12-10 17:41:28,194,8134,96,98,4914.49,10364.00,0.00
2024-12-10 17:41:28,193,8134,95,98,4937.28,10364.03,0.00
2024-12-10 17:41:28,192,8134,95,97,4946.82,10364.09,0.00
2024-12-10 17:41:28,191,8134,95,96,4965.69,10364.15,0.00
2024-12-10 17:41:28,190,8134,94,96,4936.41,10364.61,0.00
2024-12-10 17:41:28,189,8134,93,96,4942.88,10364.80,0.00
2024-12-10 17:41:28,189,8135,93,96,4977.58,10365.00,0.00
2024-12-10 17:41:28,190,8135,93,97,4951.39,10365.00,0.00
2024-12-10 17:41:28,189,8135,93,96,4958.43,10365.11,0.00
2024-12-10 17:41:28,188,8135,93,95,4979.31,10365.15,0.00
2024-12-10 17:41:28,187,8135,92,95,5005.38,10365.16,0.00
2024-12-10 17:41:28,186,8135,91,95,5031.74,10365.16,0.00
2024-12-10 17:41:28,185,8135,90,95,5041.41,10365.26,0.00
2024-12-10 17:41:28,186,8134,90,96,4999.30,10365.41,0.00
2024-12-10 17:41:28,185,8134,89,96,5058.85,10365.48,0.00
2024-12-10 17:41:28,185,8135,89,96,5039.01,10366.00,0.00
2024-12-10 17:41:28,186,8135,89,97,5011.92,10366.01,0.00
2024-12-10 17:41:28,185,8135,88,97,5033.42,10366.04,0.00
2024-12-10 17:41:28,185,8136,88,97,5034.62,10367.00,0.00
2024-12-10 17:41:28,186,8136,88,98,5007.55,10367.01,0.00
2024-12-10 17:41:28,186,8137,88,98,4926.97,10368.00,0.00
2024-12-10 17:41:28,187,8137,89,98,4900.62,10368.00,0.00
2024-12-10 17:41:28,186,8137,88,98,4925.30,10368.02,0.00
2024-12-10 17:41:28,185,8137,87,98,4939.28,10368.07,0.00
2024-12-10 17:41:28,184,8137,87,97,4959.38,10368.11,0.00
2024-12-10 17:41:28,183,8137,86,97,4982.53,10368.15,0.00
2024-12-10 17:41:28,182,8137,86,96,4989.41,10368.35,0.00
2024-12-10 17:41:28,183,8136,87,96,4948.59,10368.49,0.00
2024-12-10 17:41:28,183,8137,87,96,5004.49,10369.00,0.00
2024-12-10 17:41:28,184,8137,88,96,4977.29,10369.01,0.00
2024-12-10 17:41:28,183,8137,88,95,4977.92,10369.15,0.00
2024-12-10 17:41:28,183,8138,88,95,4994.06,10370.00,0.00
2024-12-10 17:41:28,184,8138,88,96,4966.92,10370.01,0.00
2024-12-10 17:41:28,183,8138,88,95,4966.91,10370.15,0.00
2024-12-10 17:41:28,183,8139,88,95,4923.72,10371.00,0.00
2024-12-10 17:41:28,184,8139,88,96,4896.96,10371.01,0.00
2024-12-10 17:41:28,183,8139,87,96,4896.01,10371.16,0.00
2024-12-10 17:41:28,183,8140,87,96,4846.48,10372.00,0.00
2024-12-10 17:41:28,184,8140,87,97,4820.14,10372.01,0.00
2024-12-10 17:41:28,183,8140,87,96,4818.76,10372.16,0.00
2024-12-10 17:41:28,182,8140,86,96,4844.67,10372.16,0.00
2024-12-10 17:41:28,183,8139,87,96,4748.20,10372.85,0.00
2024-12-10 17:41:28,183,8140,87,96,4771.59,10373.00,0.00
2024-12-10 17:41:28,184,8140,88,96,4745.66,10373.01,0.00
2024-12-10 17:41:28,183,8140,87,96,4769.47,10373.02,0.00
2024-12-10 17:41:28,182,8140,87,95,4786.01,10373.11,0.00
2024-12-10 17:41:28,181,8140,87,94,4807.89,10373.15,0.00
2024-12-10 17:41:28,180,8140,87,93,4834.02,10373.15,0.00
2024-12-10 17:41:28,179,8140,86,93,4781.70,10373.85,0.00
2024-12-10 17:41:28,179,8141,86,93,4872.22,10374.00,0.00
2024-12-10 17:41:28,180,8141,87,93,4845.15,10374.01,0.00
2024-12-10 17:41:28,179,8141,86,93,4810.02,10374.49,0.00
2024-12-10 17:41:28,178,8141,86,92,4791.10,10374.87,0.00
2024-12-10 17:41:28,178,8142,86,92,4815.58,10375.00,0.00
2024-12-10 17:41:28,179,8142,86,93,4788.68,10375.01,0.00
2024-12-10 17:41:28,178,8142,85,93,4808.61,10375.07,0.00
2024-12-10 17:41:28,177,8142,85,92,4826.41,10375.11,0.00
2024-12-10 17:41:28,176,8142,85,91,4849.72,10375.14,0.00
2024-12-10 17:41:28,175,8142,84,91,4861.71,10375.29,0.00
2024-12-10 17:41:28,174,8142,83,91,4875.79,10375.42,0.00
2024-12-10 17:41:28,174,8143,83,91,4849.03,10376.00,0.00
2024-12-10 17:41:28,175,8143,83,92,4821.32,10376.01,0.00
2024-12-10 17:41:29,175,8144,83,92,4755.89,10377.00,0.00
2024-12-10 17:41:29,176,8144,84,92,4728.87,10377.01,0.00
2024-12-10 17:41:29,176,8145,84,92,4658.35,10378.00,0.00
2024-12-10 17:41:29,177,8145,85,92,4632.03,10378.01,0.00
2024-12-10 17:41:29,176,8145,84,92,4631.27,10378.15,0.00
2024-12-10 17:41:29,175,8145,83,92,4657.14,10378.15,0.00
2024-12-10 17:41:29,174,8145,82,92,4647.00,10378.50,0.00
2024-12-10 17:41:29,175,8144,82,93,4619.26,10378.52,0.00
2024-12-10 17:41:29,175,8145,82,93,4641.11,10379.00,0.00
2024-12-10 17:41:29,176,8145,83,93,4614.74,10379.01,0.00
2024-12-10 17:41:29,175,8145,83,92,4626.31,10379.11,0.00
2024-12-10 17:41:29,174,8145,83,91,4648.74,10379.14,0.00
2024-12-10 17:41:29,173,8145,82,91,4675.01,10379.14,0.00
2024-12-10 17:41:29,172,8145,81,91,4663.36,10379.51,0.00
2024-12-10 17:41:29,172,8146,81,91,4703.97,10380.00,0.00
2024-12-10 17:41:29,173,8146,81,92,4676.78,10380.01,0.00
2024-12-10 17:41:29,174,8145,82,92,4649.91,10380.02,0.00
2024-12-10 17:41:29,175,8144,83,92,4634.04,10380.10,0.00
2024-12-10 17:41:29,174,8144,83,91,4707.54,10380.12,0.00
2024-12-10 17:41:29,173,8144,82,91,4729.18,10380.16,0.00
2024-12-10 17:41:29,172,8144,82,90,4756.07,10380.16,0.00
2024-12-10 17:41:29,171,8144,81,90,4772.97,10380.22,0.00
2024-12-10 17:41:29,171,8145,81,90,4747.57,10381.00,0.00
2024-12-10 17:41:29,172,8145,82,90,4719.97,10381.01,0.00
2024-12-10 17:41:29,171,8145,82,89,4708.63,10381.16,0.00
2024-12-10 17:41:29,171,8146,82,89,4797.65,10382.00,0.00
2024-12-10 17:41:29,172,8146,82,90,4769.76,10382.01,0.00
2024-12-10 17:41:29,171,8146,82,89,4748.63,10382.16,0.00
2024-12-10 17:41:29,171,8147,82,89,4716.65,10383.00,0.00
2024-12-10 17:41:29,172,8147,82,90,4689.23,10383.01,0.00
2024-12-10 17:41:29,171,8147,82,89,4700.29,10383.11,0.00
2024-12-10 17:41:29,170,8147,81,89,4725.35,10383.11,0.00
2024-12-10 17:41:29,169,8147,81,88,4745.36,10383.15,0.00
2024-12-10 17:41:29,170,8146,82,88,4705.26,10383.28,0.00
2024-12-10 17:41:29,171,8145,82,89,4680.18,10383.56,0.00
2024-12-10 17:41:29,171,8146,82,89,4707.49,10384.00,0.00
2024-12-10 17:41:29,172,8146,83,89,4680.12,10384.01,0.00
2024-12-10 17:41:29,171,8146,83,88,4679.05,10384.13,0.00
2024-12-10 17:41:29,170,8146,82,88,4633.72,10384.68,0.00
2024-12-10 17:41:29,171,8145,83,88,4574.64,10384.96,0.00
2024-12-10 17:41:29,171,8146,83,88,4754.43,10385.00,0.00
2024-12-10 17:41:29,172,8146,84,88,4726.79,10385.01,0.00
2024-12-10 17:41:29,171,8146,84,87,4736.99,10385.11,0.00
2024-12-10 17:41:29,170,8146,84,86,4760.59,10385.15,0.00
2024-12-10 17:41:29,170,8147,84,86,4762.84,10386.00,0.00
2024-12-10 17:41:29,171,8147,85,86,4734.99,10386.01,0.00
2024-12-10 17:41:29,170,8147,84,86,4757.35,10386.05,0.00
2024-12-10 17:41:29,169,8147,84,85,4763.41,10386.14,0.00
2024-12-10 17:41:29,168,8147,84,84,4791.15,10386.14,0.00
2024-12-10 17:41:29,169,8146,84,85,4751.76,10386.26,0.00
2024-12-10 17:41:29,168,8146,83,85,4825.69,10386.27,0.00
2024-12-10 17:41:29,167,8146,82,85,4832.77,10386.48,0.00
2024-12-10 17:41:29,166,8146,81,85,4861.26,10386.49,0.00
2024-12-10 17:41:29,165,8146,80,85,4853.53,10386.76,0.00
2024-12-10 17:41:29,165,8147,80,85,4891.75,10387.00,0.00
2024-12-10 17:41:29,166,8147,80,86,4862.28,10387.01,0.00
2024-12-10 17:41:29,165,8147,79,86,4887.35,10387.04,0.00
2024-12-10 17:41:29,164,8147,79,85,4915.26,10387.05,0.00
2024-12-10 17:41:29,163,8147,78,85,4942.24,10387.08,0.00
2024-12-10 17:41:29,162,8147,78,84,4959.28,10387.09,0.00
2024-12-10 17:41:29,161,8147,77,84,4986.23,10387.12,0.00
2024-12-10 17:41:29,160,8147,77,83,5016.74,10387.13,0.00
2024-12-10 17:41:29,160,8148,77,83,5021.17,10388.00,0.00
2024-12-10 17:41:29,161,8148,78,83,4989.98,10388.01,0.00
2024-12-10 17:41:29,160,8148,78,82,4994.59,10388.13,0.00
2024-12-10 17:41:29,159,8148,77,82,4990.82,10388.47,0.00
2024-12-10 17:41:29,158,8148,77,81,4998.11,10388.64,0.00
2024-12-10 17:41:29,158,8149,77,81,5014.72,10389.00,0.00
2024-12-10 17:41:29,159,8149,78,81,4983.18,10389.01,0.00
2024-12-10 17:41:29,158,8149,78,80,4939.88,10389.41,0.00
2024-12-10 17:41:29,157,8149,77,80,4967.12,10389.45,0.00
2024-12-10 17:41:29,157,8150,77,80,4947.62,10390.00,0.00
2024-12-10 17:41:29,158,8150,77,81,4916.30,10390.01,0.00
2024-12-10 17:41:29,157,8150,76,81,4944.32,10390.03,0.00
2024-12-10 17:41:29,156,8150,76,80,4960.71,10390.09,0.00
2024-12-10 17:41:29,155,8150,76,79,4988.04,10390.13,0.00
2024-12-10 17:41:29,154,8150,75,79,5019.76,10390.13,0.00
2024-12-10 17:41:29,153,8150,74,79,5009.51,10390.51,0.00
2024-12-10 17:41:29,152,8150,74,78,5031.80,10390.60,0.00
2024-12-10 17:41:29,151,8150,73,78,5049.86,10390.75,0.00
2024-12-10 17:41:29,151,8151,73,78,5059.30,10391.00,0.00
2024-12-10 17:41:29,152,8151,73,79,5026.01,10391.01,0.00
2024-12-10 17:41:29,152,8152,73,79,4960.19,10392.00,0.00
2024-12-10 17:41:29,153,8152,73,80,4927.77,10392.01,0.00
2024-12-10 17:41:29,152,8152,72,80,4958.83,10392.01,0.00
2024-12-10 17:41:29,151,8152,72,79,4965.56,10392.13,0.00
2024-12-10 17:41:29,152,8151,73,79,4847.78,10392.79,0.00
2024-12-10 17:41:29,152,8152,73,79,4901.44,10393.00,0.00
2024-12-10 17:41:29,153,8152,74,79,4869.40,10393.01,0.00
2024-12-10 17:41:29,152,8152,74,78,4880.96,10393.09,0.00
2024-12-10 17:41:29,151,8152,74,77,4908.48,10393.13,0.00
2024-12-10 17:41:29,150,8152,73,77,4940.51,10393.13,0.00
2024-12-10 17:41:29,149,8152,72,77,4892.99,10393.64,0.00
2024-12-10 17:41:29,149,8153,72,77,4986.77,10394.00,0.00
2024-12-10 17:41:29,150,8153,72,78,4953.53,10394.01,0.00
2024-12-10 17:41:29,149,8153,72,77,4968.67,10394.09,0.00
2024-12-10 17:41:29,148,8153,71,77,4998.74,10394.12,0.00
2024-12-10 17:41:29,147,8153,71,76,5022.77,10394.22,0.00
2024-12-10 17:41:29,147,8154,71,76,4977.64,10395.00,0.00
2024-12-10 17:41:29,148,8154,71,77,4944.01,10395.01,0.00
2024-12-10 17:41:29,147,8154,71,76,4967.77,10395.10,0.00
2024-12-10 17:41:29,146,8154,71,75,4998.25,10395.12,0.00
2024-12-10 17:41:29,145,8154,71,74,5032.00,10395.12,0.00
2024-12-10 17:41:29,145,8155,71,74,4979.61,10396.00,0.00
2024-12-10 17:41:29,146,8155,72,74,4945.51,10396.01,0.00
2024-12-10 17:41:29,145,8155,72,73,4971.04,10396.08,0.00
2024-12-10 17:41:29,144,8155,72,72,4986.80,10396.12,0.00
2024-12-10 17:41:29,144,8156,72,72,4956.41,10397.00,0.00
2024-12-10 17:41:29,145,8156,72,73,4922.23,10397.01,0.00
2024-12-10 17:41:29,145,8157,72,73,4859.39,10398.00,0.00
2024-12-10 17:41:29,146,8157,72,74,4826.11,10398.01,0.00
2024-12-10 17:41:29,145,8157,71,74,4832.19,10398.12,0.00
2024-12-10 17:41:29,146,8156,72,74,4719.98,10398.88,0.00
2024-12-10 17:41:30,146,8157,72,74,4762.67,10399.00,0.00
2024-12-10 17:41:30,147,8157,73,74,4730.27,10399.01,0.00
2024-12-10 17:41:30,146,8157,73,73,4747.03,10399.11,0.00
2024-12-10 17:41:30,146,8158,73,73,4762.17,10400.00,0.00
2024-12-10 17:41:30,147,8158,74,73,4729.78,10400.01,0.00
2024-12-10 17:41:30,148,8157,74,74,4686.62,10400.13,0.00
2024-12-10 17:41:30,147,8157,74,73,4726.29,10400.13,0.00
2024-12-10 17:41:30,147,8158,74,73,4668.40,10401.00,0.00
2024-12-10 17:41:30,148,8158,74,74,4636.86,10401.01,0.00
2024-12-10 17:41:30,147,8158,74,73,4655.01,10401.12,0.00
2024-12-10 17:41:30,147,8159,74,73,4663.87,10402.00,0.00
2024-12-10 17:41:30,148,8159,75,73,4632.36,10402.01,0.00
2024-12-10 17:41:30,147,8159,74,73,4656.11,10402.08,0.00
2024-12-10 17:41:30,146,8159,73,73,4683.03,10402.12,0.00
2024-12-10 17:41:30,145,8159,73,72,4713.90,10402.12,0.00
2024-12-10 17:41:30,144,8159,72,72,4686.04,10402.70,0.00
2024-12-10 17:41:30,143,8159,71,72,4686.19,10402.89,0.00
2024-12-10 17:41:30,143,8160,71,72,4747.40,10403.00,0.00
2024-12-10 17:41:30,144,8160,71,73,4714.43,10403.01,0.00
2024-12-10 17:41:30,143,8160,70,73,4743.04,10403.04,0.00
2024-12-10 17:41:30,144,8159,71,73,4705.07,10403.10,0.00
2024-12-10 17:41:30,143,8159,71,72,4800.55,10403.12,0.00
2024-12-10 17:41:30,143,8160,71,72,4782.05,10404.00,0.00
2024-12-10 17:41:30,144,8160,72,72,4748.84,10404.01,0.00
2024-12-10 17:41:30,143,8160,72,71,4769.73,10404.11,0.00
2024-12-10 17:41:30,142,8160,71,71,4717.45,10404.93,0.00
2024-12-10 17:41:30,142,8161,71,71,4827.42,10405.00,0.00
2024-12-10 17:41:30,143,8161,72,71,4793.66,10405.01,0.00
2024-12-10 17:41:30,144,8160,73,71,4757.49,10405.05,0.00
2024-12-10 17:41:30,143,8160,73,70,4844.23,10405.12,0.00
2024-12-10 17:41:30,143,8161,73,70,4794.41,10406.00,0.00
2024-12-10 17:41:30,144,8161,73,71,4761.11,10406.01,0.00
2024-12-10 17:41:30,143,8161,72,71,4782.82,10406.11,0.00
2024-12-10 17:41:30,142,8161,72,70,4813.57,10406.13,0.00
2024-12-10 17:41:30,142,8162,72,70,4836.78,10407.00,0.00
2024-12-10 17:41:30,143,8162,72,71,4802.96,10407.01,0.00
2024-12-10 17:41:30,142,8162,71,71,4827.99,10407.03,0.00
2024-12-10 17:41:30,141,8162,70,71,4852.69,10407.11,0.00
2024-12-10 17:41:30,140,8162,70,70,4884.37,10407.12,0.00
2024-12-10 17:41:30,140,8163,70,70,4863.06,10408.00,0.00
2024-12-10 17:41:30,141,8163,70,71,4828.57,10408.01,0.00
2024-12-10 17:41:30,140,8163,69,71,4851.22,10408.11,0.00
2024-12-10 17:41:30,139,8163,69,70,4882.38,10408.12,0.00
2024-12-10 17:41:30,139,8164,69,70,4830.48,10409.00,0.00
2024-12-10 17:41:30,140,8164,70,70,4795.98,10409.01,0.00
2024-12-10 17:41:30,139,8164,69,70,4828.24,10409.02,0.00
2024-12-10 17:41:30,138,8164,68,70,4852.72,10409.11,0.00
2024-12-10 17:41:30,137,8164,68,69,4884.34,10409.12,0.00
2024-12-10 17:41:30,137,8165,68,69,4862.66,10410.00,0.00
2024-12-10 17:41:30,138,8165,69,69,4827.43,10410.01,0.00
2024-12-10 17:41:30,137,8165,69,68,4849.04,10410.12,0.00
2024-12-10 17:41:30,137,8166,69,68,4796.16,10411.00,0.00
2024-12-10 17:41:30,138,8166,70,68,4761.40,10411.01,0.00
2024-12-10 17:41:30,137,8166,70,67,4779.97,10411.13,0.00
2024-12-10 17:41:30,137,8167,70,67,4728.19,10412.00,0.00
2024-12-10 17:41:30,138,8167,70,68,4693.92,10412.01,0.00
2024-12-10 17:41:30,137,8167,69,68,4696.28,10412.03,0.00
2024-12-10 17:41:30,136,8167,69,67,4717.83,10412.13,0.00
2024-12-10 17:41:30,135,8167,69,66,4734.63,10412.29,0.00
2024-12-10 17:41:30,134,8167,69,65,4730.10,10412.63,0.00
2024-12-10 17:41:30,134,8168,69,65,4766.92,10413.00,0.00
2024-12-10 17:41:30,135,8168,70,65,4731.60,10413.01,0.00
2024-12-10 17:41:30,134,8168,69,65,4755.31,10413.11,0.00
2024-12-10 17:41:30,135,8167,69,66,4720.08,10413.13,0.00
2024-12-10 17:41:30,134,8167,69,65,4828.36,10413.13,0.00
2024-12-10 17:41:30,133,8167,68,65,4830.12,10413.45,0.00
2024-12-10 17:41:30,132,8167,68,64,4832.61,10413.78,0.00
2024-12-10 17:41:30,132,8168,68,64,4856.49,10414.00,0.00
2024-12-10 17:41:30,133,8168,69,64,4819.98,10414.01,0.00
2024-12-10 17:41:30,134,8167,70,64,4781.69,10414.04,0.00
2024-12-10 17:41:30,133,8167,70,63,4880.33,10414.13,0.00
2024-12-10 17:41:30,132,8167,69,63,4880.39,10414.47,0.00
2024-12-10 17:41:30,132,8168,69,63,4950.39,10415.00,0.00
2024-12-10 17:41:30,133,8168,69,64,4913.17,10415.01,0.00
2024-12-10 17:41:30,132,8168,69,63,4936.25,10415.12,0.00
2024-12-10 17:41:30,131,8168,68,63,4937.39,10415.29,0.00
2024-12-10 17:41:30,131,8169,68,63,5020.42,10416.00,0.00
2024-12-10 17:41:30,132,8169,68,64,4982.39,10416.01,0.00
2024-12-10 17:41:30,133,8168,68,65,4841.27,10416.86,0.00
2024-12-10 17:41:30,133,8169,68,65,4903.82,10417.00,0.00
2024-12-10 17:41:30,134,8169,68,66,4867.22,10417.01,0.00
2024-12-10 17:41:30,133,8169,67,66,4891.35,10417.12,0.00
2024-12-10 17:41:30,132,8169,66,66,4889.56,10417.34,0.00
2024-12-10 17:41:30,131,8169,65,66,4866.94,10417.89,0.00
2024-12-10 17:41:30,131,8170,65,66,4994.94,10418.00,0.00
2024-12-10 17:41:30,132,8170,65,67,4957.10,10418.01,0.00
2024-12-10 17:41:30,131,8170,65,66,4968.89,10418.12,0.00
2024-12-10 17:41:30,130,8170,64,66,4985.47,10418.33,0.00
2024-12-10 17:41:30,129,8170,63,66,5011.23,10418.45,0.00
2024-12-10 17:41:30,129,8171,63,66,5002.86,10419.00,0.00
2024-12-10 17:41:30,130,8171,63,67,4964.37,10419.01,0.00
2024-12-10 17:41:30,129,8171,63,66,4983.77,10419.12,0.00
2024-12-10 17:41:30,130,8170,64,66,4897.48,10419.60,0.00
2024-12-10 17:41:30,130,8171,64,66,4962.42,10420.00,0.00
2024-12-10 17:41:30,131,8171,64,67,4924.54,10420.01,0.00
2024-12-10 17:41:30,130,8171,64,66,4949.65,10420.12,0.00
2024-12-10 17:41:30,129,8171,63,66,4930.69,10420.56,0.00
2024-12-10 17:41:30,129,8172,63,66,5046.51,10421.00,0.00
2024-12-10 17:41:30,130,8172,64,66,5007.69,10421.01,0.00
2024-12-10 17:41:30,129,8172,64,65,5033.64,10421.12,0.00
2024-12-10 17:41:30,128,8172,63,65,5072.15,10421.13,0.00
2024-12-10 17:41:30,128,8173,63,65,5024.50,10422.00,0.00
2024-12-10 17:41:30,129,8173,64,65,4985.55,10422.01,0.00
2024-12-10 17:41:31,128,8173,64,64,5011.52,10422.13,0.00
2024-12-10 17:41:31,127,8173,63,64,5030.63,10422.24,0.00
2024-12-10 17:41:31,126,8173,62,64,5049.88,10422.27,0.00
2024-12-10 17:41:31,125,8173,61,64,5077.70,10422.39,0.00
2024-12-10 17:41:31,125,8174,61,64,5098.09,10423.00,0.00
2024-12-10 17:41:31,126,8174,61,65,5057.63,10423.01,0.00
2024-12-10 17:41:31,127,8173,61,66,5012.08,10423.08,0.00
2024-12-10 17:41:31,126,8173,61,65,5097.40,10423.13,0.00
2024-12-10 17:41:31,125,8173,60,65,5128.18,10423.18,0.00
2024-12-10 17:41:31,125,8174,60,65,5126.10,10424.00,0.00
2024-12-10 17:41:31,126,8174,61,65,5085.41,10424.01,0.00
2024-12-10 17:41:31,125,8174,60,65,5124.43,10424.02,0.00
2024-12-10 17:41:31,124,8174,60,64,5154.05,10424.12,0.00
2024-12-10 17:41:31,123,8174,59,64,5184.94,10424.16,0.00
2024-12-10 17:41:31,122,8174,58,64,5201.01,10424.41,0.00
2024-12-10 17:41:31,121,8174,57,64,5204.58,10424.79,0.00
2024-12-10 17:41:31,121,8175,57,64,5355.51,10425.00,0.00
2024-12-10 17:41:31,122,8175,58,64,5311.62,10425.01,0.00
2024-12-10 17:41:31,121,8175,58,63,5342.65,10425.12,0.00
2024-12-10 17:41:31,121,8176,58,63,5303.46,10426.00,0.00
2024-12-10 17:41:31,122,8176,58,64,5259.99,10426.01,0.00
2024-12-10 17:41:31,121,8176,58,63,5290.60,10426.12,0.00
2024-12-10 17:41:31,120,8176,57,63,5298.22,10426.28,0.00
2024-12-10 17:41:31,120,8177,57,63,5309.94,10427.00,0.00
2024-12-10 17:41:31,121,8177,57,64,5266.06,10427.01,0.00
2024-12-10 17:41:31,120,8177,57,63,5296.10,10427.13,0.00
2024-12-10 17:41:31,119,8177,56,63,5333.60,10427.14,0.00
2024-12-10 17:41:31,119,8178,56,63,5331.40,10428.00,0.00
2024-12-10 17:41:31,120,8178,57,63,5286.97,10428.01,0.00
2024-12-10 17:41:31,119,8178,56,63,5320.93,10428.10,0.00
2024-12-10 17:41:31,118,8178,56,62,5359.85,10428.13,0.00
2024-12-10 17:41:31,118,8179,56,62,5321.12,10429.00,0.00
2024-12-10 17:41:31,119,8179,57,62,5276.40,10429.01,0.00
2024-12-10 17:41:31,118,8179,57,61,5301.74,10429.14,0.00
2024-12-10 17:41:31,118,8180,57,61,5264.31,10430.00,0.00
2024-12-10 17:41:31,119,8180,57,62,5220.07,10430.01,0.00
2024-12-10 17:41:31,118,8180,56,62,5247.58,10430.14,0.00
2024-12-10 17:41:31,117,8180,56,61,5287.08,10430.14,0.00
2024-12-10 17:41:31,117,8181,56,61,5284.94,10431.00,0.00
2024-12-10 17:41:31,118,8181,56,62,5240.15,10431.01,0.00
2024-12-10 17:41:31,119,8180,56,63,5196.12,10431.03,0.00
2024-12-10 17:41:31,118,8180,56,62,5266.74,10431.14,0.00
2024-12-10 17:41:31,117,8180,55,62,5208.64,10431.79,0.00
2024-12-10 17:41:31,117,8181,55,62,5274.16,10432.00,0.00
2024-12-10 17:41:31,118,8181,55,63,5229.47,10432.01,0.00
2024-12-10 17:41:31,117,8181,54,63,5270.30,10432.04,0.00
2024-12-10 17:41:31,116,8181,53,63,5309.46,10432.09,0.00
2024-12-10 17:41:31,115,8181,52,63,5352.93,10432.11,0.00
2024-12-10 17:41:31,114,8181,52,62,5392.56,10432.11,0.00
2024-12-10 17:41:31,113,8181,51,62,5431.97,10432.12,0.00
2024-12-10 17:41:31,113,8182,51,62,5523.55,10433.00,0.00
2024-12-10 17:41:31,114,8182,51,63,5475.10,10433.01,0.00
2024-12-10 17:41:31,113,8182,51,62,5499.61,10433.13,0.00
2024-12-10 17:41:31,112,8182,50,62,5532.31,10433.23,0.00
2024-12-10 17:41:31,113,8181,51,62,5438.29,10433.68,0.00
2024-12-10 17:41:31,113,8182,51,62,5525.43,10434.00,0.00
2024-12-10 17:41:31,114,8182,52,62,5476.96,10434.01,0.00
2024-12-10 17:41:31,113,8182,52,61,5499.65,10434.13,0.00
2024-12-10 17:41:31,112,8182,51,61,5535.52,10434.21,0.00
2024-12-10 17:41:31,112,8183,51,61,5639.72,10435.00,0.00
2024-12-10 17:41:31,113,8183,52,61,5589.82,10435.01,0.00
2024-12-10 17:41:31,112,8183,52,60,5576.43,10435.13,0.00
2024-12-10 17:41:31,112,8184,52,60,5579.32,10436.00,0.00
2024-12-10 17:41:31,113,8184,53,60,5529.95,10436.01,0.00
2024-12-10 17:41:31,114,8183,54,60,5471.42,10436.12,0.00
2024-12-10 17:41:31,113,8183,54,59,5553.10,10436.14,0.00
2024-12-10 17:41:31,112,8183,53,59,5572.93,10436.39,0.00
2024-12-10 17:41:31,112,8184,53,59,5602.82,10437.00,0.00
2024-12-10 17:41:31,113,8184,53,60,5553.24,10437.01,0.00
2024-12-10 17:41:31,112,8184,53,59,5575.86,10437.14,0.00
2024-12-10 17:41:31,111,8184,52,59,5574.42,10437.32,0.00
2024-12-10 17:41:31,111,8185,52,59,5691.15,10438.00,0.00
2024-12-10 17:41:31,112,8185,53,59,5640.34,10438.01,0.00
2024-12-10 17:41:31,111,8185,53,58,5664.89,10438.14,0.00
2024-12-10 17:41:31,112,8184,53,59,5584.57,10438.45,0.00
2024-12-10 17:41:31,112,8185,53,59,5669.48,10439.00,0.00
2024-12-10 17:41:31,113,8185,53,60,5619.31,10439.01,0.00
2024-12-10 17:41:31,114,8184,53,61,5564.55,10439.08,0.00
2024-12-10 17:41:31,113,8184,53,60,5630.46,10439.15,0.00
2024-12-10 17:41:31,112,8184,52,60,5661.20,10439.34,0.00
2024-12-10 17:41:31,112,8185,52,60,5778.79,10440.00,0.00
2024-12-10 17:41:31,113,8185,53,60,5727.65,10440.01,0.00
2024-12-10 17:41:31,112,8185,53,59,5754.62,10440.14,0.00
2024-12-10 17:41:31,112,8186,53,59,5814.47,10441.00,0.00
2024-12-10 17:41:31,113,8186,54,59,5763.02,10441.01,0.00
2024-12-10 17:41:31,112,8186,54,58,5788.44,10441.14,0.00
2024-12-10 17:41:31,111,8186,53,58,5829.45,10441.24,0.00
2024-12-10 17:41:31,110,8186,52,58,5871.09,10441.35,0.00
2024-12-10 17:41:31,110,8187,52,58,5859.87,10442.00,0.00
2024-12-10 17:41:31,111,8187,53,58,5807.08,10442.01,0.00
2024-12-10 17:41:31,110,8187,52,58,5847.59,10442.12,0.00
2024-12-10 17:41:31,109,8187,52,57,5887.83,10442.14,0.00
2024-12-10 17:41:31,109,8188,52,57,5855.68,10443.00,0.00
2024-12-10 17:41:31,110,8188,53,57,5802.45,10443.01,0.00
2024-12-10 17:41:31,109,8188,52,57,5847.10,10443.08,0.00
2024-12-10 17:41:31,108,8188,51,57,5897.40,10443.11,0.00
2024-12-10 17:41:31,107,8188,51,56,5936.90,10443.12,0.00
2024-12-10 17:41:31,107,8189,51,56,5904.21,10444.00,0.00
2024-12-10 17:41:31,108,8189,51,57,5849.55,10444.01,0.00
2024-12-10 17:41:31,107,8189,51,56,5876.95,10444.12,0.00
2024-12-10 17:41:31,108,8188,52,56,5818.67,10444.18,0.00
2024-12-10 17:41:31,108,8189,52,56,5866.55,10445.00,0.00
2024-12-10 17:41:31,109,8189,52,57,5812.72,10445.01,0.00
2024-12-10 17:41:31,108,8189,52,56,5839.53,10445.12,0.00
2024-12-10 17:41:31,107,8189,51,56,5869.78,10445.35,0.00
2024-12-10 17:41:31,106,8189,50,56,5874.02,10445.58,0.00
2024-12-10 17:41:31,106,8190,50,56,6028.07,10446.00,0.00
2024-12-10 17:41:31,107,8190,51,56,5971.73,10446.01,0.00
2024-12-10 17:41:31,106,8190,51,55,5998.57,10446.13,0.00
2024-12-10 17:41:31,105,8190,50,55,5986.23,10446.57,0.00
2024-12-10 17:41:31,105,8191,50,55,6041.29,10447.00,0.00
2024-12-10 17:41:31,106,8191,51,55,5984.29,10447.01,0.00
2024-12-10 17:41:31,105,8191,51,54,6011.50,10447.13,0.00
2024-12-10 17:41:31,104,8191,50,54,6046.55,10447.34,0.00
2024-12-10 17:41:31,105,8190,50,55,5941.47,10447.81,0.00
2024-12-10 17:41:31,106,8189,50,56,5883.60,10447.98,0.00
2024-12-10 17:41:32,106,8190,50,56,5982.18,10448.00,0.00
2024-12-10 17:41:32,107,8190,50,57,5926.27,10448.01,0.00
2024-12-10 17:41:32,107,8191,50,57,6088.27,10449.00,0.00
2024-12-10 17:41:32,108,8191,51,57,6031.90,10449.01,0.00
2024-12-10 17:41:32,107,8191,50,57,6076.61,10449.11,0.00
2024-12-10 17:41:32,106,8191,49,57,6090.63,10449.33,0.00
2024-12-10 17:41:32,106,8192,49,57,6107.59,10450.00,0.00
2024-12-10 17:41:32,107,8192,49,58,6050.51,10450.01,0.00
2024-12-10 17:41:32,107,8193,49,58,6004.07,10451.00,0.00
2024-12-10 17:41:32,108,8193,50,58,5948.48,10451.01,0.00
2024-12-10 17:41:32,108,8194,50,58,5887.20,10452.00,0.00
2024-12-10 17:41:32,109,8194,50,59,5833.19,10452.01,0.00
2024-12-10 17:41:32,108,8194,50,58,5863.06,10452.12,0.00
2024-12-10 17:41:32,108,8195,50,58,5829.69,10453.00,0.00
2024-12-10 17:41:32,109,8195,50,59,5776.21,10453.01,0.00
2024-12-10 17:41:32,108,8195,50,58,5805.55,10453.12,0.00
2024-12-10 17:41:32,109,8194,50,59,5679.51,10453.47,0.00
2024-12-10 17:41:32,109,8195,50,59,5804.57,10454.00,0.00
2024-12-10 17:41:32,110,8195,51,59,5751.80,10454.01,0.00
2024-12-10 17:41:32,109,8195,50,59,5799.80,10454.05,0.00
2024-12-10 17:41:32,108,8195,49,59,5841.90,10454.06,0.00
2024-12-10 17:41:32,107,8195,49,58,5879.90,10454.10,0.00
2024-12-10 17:41:32,107,8196,49,58,5982.03,10455.00,0.00
2024-12-10 17:41:32,108,8196,50,58,5926.64,10455.01,0.00
2024-12-10 17:41:32,107,8196,50,57,5959.41,10455.10,0.00
2024-12-10 17:41:32,106,8196,49,57,6001.82,10455.10,0.00
2024-12-10 17:41:32,106,8197,49,57,6007.28,10456.00,0.00
2024-12-10 17:41:32,107,8197,50,57,5951.13,10456.01,0.00
2024-12-10 17:41:32,106,8197,50,56,5980.70,10456.11,0.00
2024-12-10 17:41:32,105,8197,49,56,6019.73,10456.11,0.00
2024-12-10 17:41:32,106,8196,49,57,5918.73,10456.56,0.00
2024-12-10 17:41:32,106,8197,49,57,6019.39,10457.00,0.00
2024-12-10 17:41:32,107,8197,49,58,5963.14,10457.01,0.00
2024-12-10 17:41:32,108,8196,49,59,5861.48,10457.10,0.00
2024-12-10 17:41:32,107,8196,49,58,5915.30,10457.12,0.00
2024-12-10 17:41:32,107,8197,49,58,6019.42,10458.00,0.00
2024-12-10 17:41:32,108,8197,50,58,5963.68,10458.01,0.00
2024-12-10 17:41:32,107,8197,50,57,5990.14,10458.11,0.00
2024-12-10 17:41:32,106,8197,49,57,6024.70,10458.31,0.00
2024-12-10 17:41:32,106,8198,49,57,6111.01,10459.00,0.00
2024-12-10 17:41:32,107,8198,50,57,6053.89,10459.01,0.00
2024-12-10 17:41:32,106,8198,50,56,6089.35,10459.10,0.00
2024-12-10 17:41:32,105,8198,49,56,6125.12,10459.30,0.00
2024-12-10 17:41:32,105,8199,49,56,6112.64,10460.00,0.00
2024-12-10 17:41:32,106,8199,50,56,6054.98,10460.01,0.00
2024-12-10 17:41:32,105,8199,50,55,6102.73,10460.10,0.00
2024-12-10 17:41:32,104,8199,50,54,6145.76,10460.11,0.00
2024-12-10 17:41:32,103,8199,49,54,6185.18,10460.29,0.00
2024-12-10 17:41:32,103,8200,49,54,6172.46,10461.00,0.00
2024-12-10 17:41:32,104,8200,49,55,6113.11,10461.01,0.00
2024-12-10 17:41:32,103,8200,48,55,6094.34,10461.24,0.00
2024-12-10 17:41:32,103,8201,48,55,6117.19,10462.00,0.00
2024-12-10 17:41:32,104,8201,49,55,6058.37,10462.01,0.00
2024-12-10 17:41:32,103,8201,48,55,6112.32,10462.02,0.00
2024-12-10 17:41:32,102,8201,48,54,6139.47,10462.13,0.00
2024-12-10 17:41:32,102,8202,48,54,6151.29,10463.00,0.00
2024-12-10 17:41:32,103,8202,48,55,6091.57,10463.01,0.00
2024-12-10 17:41:32,102,8202,48,54,6074.40,10463.15,0.00
2024-12-10 17:41:32,102,8203,48,54,6087.59,10464.00,0.00
2024-12-10 17:41:32,103,8203,48,55,6028.49,10464.01,0.00
2024-12-10 17:41:32,102,8203,48,54,6036.34,10464.10,0.00
2024-12-10 17:41:32,103,8202,48,55,5931.20,10464.56,0.00
2024-12-10 17:41:32,103,8203,48,55,6021.66,10465.00,0.00
2024-12-10 17:41:32,104,8203,48,56,5963.76,10465.01,0.00
2024-12-10 17:41:32,104,8204,48,56,6001.56,10466.00,0.00
2024-12-10 17:41:32,105,8204,49,56,5944.40,10466.01,0.00
2024-12-10 17:41:32,104,8204,49,55,5984.50,10466.15,0.00
2024-12-10 17:41:32,104,8205,49,55,5955.33,10467.00,0.00
2024-12-10 17:41:32,105,8205,50,55,5898.62,10467.01,0.00
2024-12-10 17:41:32,104,8205,49,55,5843.05,10467.60,0.00
2024-12-10 17:41:32,103,8205,48,55,5882.61,10467.76,0.00
2024-12-10 17:41:32,103,8206,48,55,5959.03,10468.00,0.00
2024-12-10 17:41:32,104,8206,49,55,5901.73,10468.01,0.00
2024-12-10 17:41:32,103,8206,49,54,5940.78,10468.16,0.00
2024-12-10 17:41:32,104,8205,49,55,5805.85,10468.88,0.00
2024-12-10 17:41:32,104,8206,49,55,5864.35,10469.00,0.00
2024-12-10 17:41:32,105,8206,50,55,5808.49,10469.01,0.00
2024-12-10 17:41:32,104,8206,49,55,5842.23,10469.11,0.00
2024-12-10 17:41:32,105,8205,49,56,5703.51,10469.64,0.00
2024-12-10 17:41:32,105,8206,49,56,5895.24,10470.00,0.00
2024-12-10 17:41:32,106,8206,49,57,5839.62,10470.01,0.00
2024-12-10 17:41:32,105,8206,49,56,5879.32,10470.14,0.00
2024-12-10 17:41:32,105,8207,49,56,5935.78,10471.00,0.00
2024-12-10 17:41:32,106,8207,49,57,5879.79,10471.01,0.00
2024-12-10 17:41:32,106,8208,49,57,5798.03,10472.00,0.00
2024-12-10 17:41:32,107,8208,49,58,5743.84,10472.01,0.00
2024-12-10 17:41:32,106,8208,49,57,5783.25,10472.14,0.00
2024-12-10 17:41:32,105,8208,48,57,5753.06,10472.55,0.00
2024-12-10 17:41:32,105,8209,48,57,5804.62,10473.00,0.00
2024-12-10 17:41:32,106,8209,48,58,5749.86,10473.01,0.00
2024-12-10 17:41:32,106,8210,48,58,5664.91,10474.00,0.00
2024-12-10 17:41:32,107,8210,48,59,5611.97,10474.01,0.00
2024-12-10 17:41:32,106,8210,47,59,5662.94,10474.02,0.00
2024-12-10 17:41:32,105,8210,47,58,5702.94,10474.14,0.00
2024-12-10 17:41:32,104,8210,46,58,5710.46,10474.21,0.00
2024-12-10 17:41:32,103,8210,45,58,5732.95,10474.47,0.00
2024-12-10 17:41:32,103,8211,45,58,5776.22,10475.00,0.00
2024-12-10 17:41:32,104,8211,46,58,5720.68,10475.01,0.00
2024-12-10 17:41:32,103,8211,46,57,5740.67,10475.15,0.00
2024-12-10 17:41:32,103,8212,46,57,5706.13,10476.00,0.00
2024-12-10 17:41:33,104,8212,46,58,5651.26,10476.01,0.00
2024-12-10 17:41:33,104,8213,46,58,5580.78,10477.00,0.00
2024-12-10 17:41:33,105,8213,47,58,5527.63,10477.01,0.00
2024-12-10 17:41:33,104,8213,47,57,5565.71,10477.14,0.00
2024-12-10 17:41:33,103,8213,46,57,5510.40,10477.75,0.00
2024-12-10 17:41:33,103,8214,46,57,5584.59,10478.00,0.00
2024-12-10 17:41:33,104,8214,47,57,5530.89,10478.01,0.00
2024-12-10 17:41:33,103,8214,46,57,5576.11,10478.09,0.00
2024-12-10 17:41:33,102,8214,46,56,5604.08,10478.14,0.00
2024-12-10 17:41:33,101,8214,45,56,5609.80,10478.25,0.00
2024-12-10 17:41:33,101,8215,45,56,5619.79,10479.00,0.00
2024-12-10 17:41:33,102,8215,45,57,5564.69,10479.01,0.00
2024-12-10 17:41:33,101,8215,44,57,5570.01,10479.08,0.00
2024-12-10 17:41:33,102,8214,45,57,5438.18,10479.56,0.00
2024-12-10 17:41:33,103,8213,45,58,5414.94,10479.66,0.00
2024-12-10 17:41:33,103,8214,45,58,5496.95,10480.00,0.00
2024-12-10 17:41:33,104,8214,45,59,5444.09,10480.01,0.00
2024-12-10 17:41:33,103,8214,44,59,5494.92,10480.02,0.00
2024-12-10 17:41:33,102,8214,43,59,5544.68,10480.02,0.00
2024-12-10 17:41:33,101,8214,43,58,5583.01,10480.14,0.00
2024-12-10 17:41:33,102,8213,43,59,5502.76,10480.37,0.00
2024-12-10 17:41:33,102,8214,43,59,5781.10,10481.00,0.00
2024-12-10 17:41:33,103,8214,44,59,5724.97,10481.01,0.00
2024-12-10 17:41:33,103,8215,44,59,5742.66,10482.00,0.00
2024-12-10 17:41:33,104,8215,44,60,5687.44,10482.01,0.00
2024-12-10 17:41:33,103,8215,44,59,5723.62,10482.15,0.00
2024-12-10 17:41:33,102,8215,43,59,5763.34,10482.29,0.00
2024-12-10 17:41:33,102,8216,43,59,5730.86,10483.00,0.00
2024-12-10 17:41:33,103,8216,43,60,5675.22,10483.01,0.00
2024-12-10 17:41:33,102,8216,43,59,5725.42,10483.06,0.00
2024-12-10 17:41:33,101,8216,42,59,5777.96,10483.08,0.00
2024-12-10 17:41:33,101,8217,42,59,5742.51,10484.00,0.00
2024-12-10 17:41:33,102,8217,42,60,5686.21,10484.01,0.00
2024-12-10 17:41:33,101,8217,41,60,5684.92,10484.30,0.00
2024-12-10 17:41:33,100,8217,40,60,5721.89,10484.39,0.00
2024-12-10 17:41:33,100,8218,40,60,5749.17,10485.00,0.00
2024-12-10 17:41:33,101,8218,41,60,5692.25,10485.01,0.00
2024-12-10 17:41:33,100,8218,40,60,5703.08,10485.16,0.00
2024-12-10 17:41:33,99,8218,39,60,5721.93,10485.29,0.00
2024-12-10 17:41:33,98,8218,39,59,5739.84,10485.66,0.00
2024-12-10 17:41:33,98,8219,39,59,5806.01,10486.00,0.00
2024-12-10 17:41:33,99,8219,40,59,5747.37,10486.01,0.00
2024-12-10 17:41:33,98,8219,40,58,5783.58,10486.15,0.00
2024-12-10 17:41:33,97,8219,39,58,5810.78,10486.17,0.00
2024-12-10 17:41:33,98,8218,40,58,5731.23,10486.38,0.00
2024-12-10 17:41:33,98,8219,40,58,5822.59,10487.00,0.00
2024-12-10 17:41:33,99,8219,40,59,5763.77,10487.01,0.00
2024-12-10 17:41:33,98,8219,40,58,5787.31,10487.13,0.00
2024-12-10 17:41:33,98,8220,40,58,5860.47,10488.00,0.00
2024-12-10 17:41:33,99,8220,40,59,5801.27,10488.01,0.00
2024-12-10 17:41:33,98,8220,40,58,5834.82,10488.16,0.00
2024-12-10 17:41:33,98,8221,40,58,5783.41,10489.00,0.00
2024-12-10 17:41:33,99,8221,40,59,5724.99,10489.01,0.00
2024-12-10 17:41:33,98,8221,39,59,5704.26,10489.22,0.00
2024-12-10 17:41:33,97,8221,38,59,5719.48,10489.62,0.00
2024-12-10 17:41:33,97,8222,38,59,5782.30,10490.00,0.00
2024-12-10 17:41:33,98,8222,39,59,5723.30,10490.01,0.00
2024-12-10 17:41:33,97,8222,39,58,5713.12,10490.17,0.00
2024-12-10 17:41:33,96,8222,38,58,5736.77,10490.51,0.00
2024-12-10 17:41:33,96,8223,38,58,5785.51,10491.00,0.00
2024-12-10 17:41:33,97,8223,39,58,5725.87,10491.01,0.00
2024-12-10 17:41:33,97,8224,39,58,5654.68,10492.00,0.00
2024-12-10 17:41:33,98,8224,39,59,5596.98,10492.01,0.00
2024-12-10 17:41:33,97,8224,38,59,5646.04,10492.08,0.00
2024-12-10 17:41:33,96,8224,38,58,5688.47,10492.17,0.00
2024-12-10 17:41:33,97,8223,39,58,5623.36,10492.25,0.00
2024-12-10 17:41:33,97,8224,39,58,5665.16,10493.00,0.00
2024-12-10 17:41:33,98,8224,39,59,5607.36,10493.01,0.00
2024-12-10 17:41:33,97,8224,39,58,5651.13,10493.13,0.00
2024-12-10 17:41:33,96,8224,39,57,5696.02,10493.16,0.00
2024-12-10 17:41:33,95,8224,38,57,5636.58,10493.86,0.00
2024-12-10 17:41:33,95,8225,38,57,5839.14,10494.00,0.00
2024-12-10 17:41:33,96,8225,39,57,5778.31,10494.01,0.00
2024-12-10 17:41:33,95,8225,38,57,5766.37,10494.39,0.00
2024-12-10 17:41:33,95,8226,38,57,5810.60,10495.00,0.00
2024-12-10 17:41:33,96,8226,38,58,5750.07,10495.01,0.00
2024-12-10 17:41:33,95,8226,38,57,5787.43,10495.17,0.00
2024-12-10 17:41:33,95,8227,38,57,5762.00,10496.00,0.00
2024-12-10 17:41:33,96,8227,38,58,5701.98,10496.01,0.00
2024-12-10 17:41:33,95,8227,37,58,5673.27,10496.58,0.00
2024-12-10 17:41:33,95,8228,37,58,5696.79,10497.00,0.00
2024-12-10 17:41:33,96,8228,38,58,5637.45,10497.01,0.00
2024-12-10 17:41:33,95,8228,38,57,5672.51,10497.17,0.00
2024-12-10 17:41:33,96,8227,39,57,5546.69,10497.72,0.00
2024-12-10 17:41:33,96,8228,39,57,5608.14,10498.00,0.00
2024-12-10 17:41:33,97,8228,39,58,5550.33,10498.01,0.00
2024-12-10 17:41:33,96,8228,38,58,5601.59,10498.06,0.00
2024-12-10 17:41:33,95,8228,37,58,5659.45,10498.06,0.00
2024-12-10 17:41:33,95,8229,37,58,5729.69,10499.00,0.00
2024-12-10 17:41:33,96,8229,37,59,5670.00,10499.01,0.00
2024-12-10 17:41:33,96,8230,37,59,5604.88,10500.00,0.00
2024-12-10 17:41:33,97,8230,37,60,5547.10,10500.01,0.00
2024-12-10 17:41:33,96,8230,37,59,5601.61,10500.03,0.00
2024-12-10 17:41:33,95,8230,36,59,5587.97,10500.33,0.00
2024-12-10 17:41:33,96,8229,37,59,5512.34,10500.51,0.00
2024-12-10 17:41:33,96,8230,37,59,5622.50,10501.00,0.00
2024-12-10 17:41:33,97,8230,37,60,5564.54,10501.01,0.00
2024-12-10 17:41:33,98,8229,37,61,5502.41,10501.08,0.00
2024-12-10 17:41:33,98,8230,37,61,5587.08,10502.00,0.00
2024-12-10 17:41:33,99,8230,38,61,5530.64,10502.01,0.00
2024-12-10 17:41:33,98,8230,37,61,5579.60,10502.07,0.00
2024-12-10 17:41:33,98,8231,37,61,5579.10,10503.00,0.00
2024-12-10 17:41:33,99,8231,38,61,5522.74,10503.01,0.00
2024-12-10 17:41:33,98,8231,38,60,5565.18,10503.08,0.00
2024-12-10 17:41:33,97,8231,37,60,5572.22,10503.46,0.00
2024-12-10 17:41:34,97,8232,37,60,5520.15,10504.00,0.00
2024-12-10 17:41:34,98,8232,38,60,5463.83,10504.01,0.00
2024-12-10 17:41:34,97,8232,37,60,5375.72,10504.96,0.00
2024-12-10 17:41:34,97,8233,37,60,5455.82,10505.00,0.00
2024-12-10 17:41:34,98,8233,37,61,5400.14,10505.01,0.00
2024-12-10 17:41:34,97,8233,36,61,5448.25,10505.07,0.00
2024-12-10 17:41:34,97,8234,36,61,5377.00,10506.00,0.00
2024-12-10 17:41:34,98,8234,37,61,5322.13,10506.01,0.00
2024-12-10 17:41:34,97,8234,37,60,5357.53,10506.12,0.00
2024-12-10 17:41:34,96,8234,36,60,5333.64,10506.75,0.00
2024-12-10 17:41:34,96,8235,36,60,5366.23,10507.00,0.00
2024-12-10 17:41:34,97,8235,37,60,5310.91,10507.01,0.00
2024-12-10 17:41:34,96,8235,36,60,5290.85,10507.42,0.00
2024-12-10 17:41:34,96,8236,36,60,5320.37,10508.00,0.00
2024-12-10 17:41:34,97,8236,37,60,5265.52,10508.01,0.00
2024-12-10 17:41:34,96,8236,36,60,5307.92,10508.13,0.00
2024-12-10 17:41:34,95,8236,36,59,5360.48,10508.13,0.00
2024-12-10 17:41:34,95,8237,36,59,5320.92,10509.00,0.00
2024-12-10 17:41:34,96,8237,37,59,5265.50,10509.01,0.00
2024-12-10 17:41:34,95,8237,37,58,5247.86,10509.46,0.00
2024-12-10 17:41:34,95,8238,37,58,5252.24,10510.00,0.00
2024-12-10 17:41:34,96,8238,38,58,5197.53,10510.01,0.00
2024-12-10 17:41:34,95,8238,38,57,5237.88,10510.13,0.00
2024-12-10 17:41:34,94,8238,37,57,5263.37,10510.42,0.00
2024-12-10 17:41:34,94,8239,37,57,5263.19,10511.00,0.00
2024-12-10 17:41:34,95,8239,37,58,5207.79,10511.01,0.00
2024-12-10 17:41:34,96,8238,37,59,5153.54,10511.03,0.00
2024-12-10 17:41:34,96,8239,37,59,5211.36,10512.00,0.00
2024-12-10 17:41:34,97,8239,37,60,5157.64,10512.01,0.00
2024-12-10 17:41:34,96,8239,37,59,5188.39,10512.10,0.00
2024-12-10 17:41:34,95,8239,36,59,5186.63,10512.27,0.00
2024-12-10 17:41:34,94,8239,35,59,5237.35,10512.32,0.00
2024-12-10 17:41:34,93,8239,34,59,5250.92,10512.73,0.00
2024-12-10 17:41:34,93,8240,34,59,5445.65,10513.00,0.00
2024-12-10 17:41:34,94,8240,34,60,5387.72,10513.01,0.00
2024-12-10 17:41:34,93,8240,33,60,5397.05,10513.03,0.00
2024-12-10 17:41:34,92,8240,33,59,5430.59,10513.11,0.00
2024-12-10 17:41:34,92,8241,33,59,5449.41,10514.00,0.00
2024-12-10 17:41:34,93,8241,34,59,5390.81,10514.01,0.00
2024-12-10 17:41:34,92,8241,34,58,5432.29,10514.10,0.00
2024-12-10 17:41:34,92,8242,34,58,5405.22,10515.00,0.00
2024-12-10 17:41:34,93,8242,35,58,5347.10,10515.01,0.00
2024-12-10 17:41:34,92,8242,35,57,5398.38,10515.07,0.00
2024-12-10 17:41:34,91,8242,35,56,5434.59,10515.09,0.00
2024-12-10 17:41:34,90,8242,34,56,5398.75,10515.64,0.00
2024-12-10 17:41:34,90,8243,34,56,5477.74,10516.00,0.00
2024-12-10 17:41:34,91,8243,34,57,5417.54,10516.01,0.00
2024-12-10 17:41:34,90,8243,34,56,5473.07,10516.04,0.00
2024-12-10 17:41:34,89,8243,34,55,5532.21,10516.06,0.00
2024-12-10 17:41:34,88,8243,33,55,5528.19,10516.17,0.00
2024-12-10 17:41:34,88,8244,33,55,5559.23,10517.00,0.00
2024-12-10 17:41:34,89,8244,33,56,5496.77,10517.01,0.00
2024-12-10 17:41:34,88,8244,33,55,5548.50,10517.10,0.00
2024-12-10 17:41:34,88,8245,33,55,5501.63,10518.00,0.00
2024-12-10 17:41:34,89,8245,34,55,5439.81,10518.01,0.00
2024-12-10 17:41:34,88,8245,33,55,5499.24,10518.03,0.00
2024-12-10 17:41:34,87,8245,33,54,5541.94,10518.15,0.00
2024-12-10 17:41:34,86,8245,33,53,5544.22,10518.69,0.00
2024-12-10 17:41:34,86,8246,33,53,5584.81,10519.00,0.00
2024-12-10 17:41:34,87,8246,33,54,5520.62,10519.01,0.00
2024-12-10 17:41:34,86,8246,32,54,5579.93,10519.05,0.00
2024-12-10 17:41:34,85,8246,31,54,5625.10,10519.14,0.00
2024-12-10 17:41:34,85,8247,31,54,5627.05,10520.00,0.00
2024-12-10 17:41:34,86,8247,32,54,5561.62,10520.01,0.00
2024-12-10 17:41:34,85,8247,32,53,5601.11,10520.17,0.00
2024-12-10 17:41:34,85,8248,32,53,5580.25,10521.00,0.00
2024-12-10 17:41:34,86,8248,33,53,5515.36,10521.01,0.00
2024-12-10 17:41:34,86,8249,33,53,5480.46,10522.00,0.00
2024-12-10 17:41:34,87,8249,33,54,5417.47,10522.01,0.00
2024-12-10 17:41:34,86,8249,33,53,5393.97,10522.54,0.00
2024-12-10 17:41:34,86,8250,33,53,5427.91,10523.00,0.00
2024-12-10 17:41:34,87,8250,34,53,5365.52,10523.01,0.00
2024-12-10 17:41:34,86,8250,34,52,5391.25,10523.16,0.00
2024-12-10 17:41:34,86,8251,34,52,5370.31,10524.00,0.00
2024-12-10 17:41:34,87,8251,35,52,5308.58,10524.01,0.00
2024-12-10 17:41:34,86,8251,34,52,5264.27,10524.74,0.00
2024-12-10 17:41:34,86,8252,34,52,5310.91,10525.00,0.00
2024-12-10 17:41:34,87,8252,34,53,5249.87,10525.01,0.00
2024-12-10 17:41:34,86,8252,34,52,5287.70,10525.16,0.00
2024-12-10 17:41:34,86,8253,34,52,5264.57,10526.00,0.00
2024-12-10 17:41:34,87,8253,34,53,5204.06,10526.01,0.00
2024-12-10 17:41:34,88,8252,35,53,5098.57,10526.24,0.00
2024-12-10 17:41:34,87,8252,34,53,5240.28,10526.29,0.00
2024-12-10 17:41:34,87,8253,34,53,5231.97,10527.00,0.00
2024-12-10 17:41:34,88,8253,34,54,5172.51,10527.01,0.00
2024-12-10 17:41:34,87,8253,34,53,5209.02,10527.16,0.00
2024-12-10 17:41:34,86,8253,33,53,5238.47,10527.38,0.00
2024-12-10 17:41:34,86,8254,33,53,5366.54,10528.00,0.00
2024-12-10 17:41:34,87,8254,33,54,5304.86,10528.01,0.00
2024-12-10 17:41:34,86,8254,32,54,5311.48,10528.27,0.00
2024-12-10 17:41:34,85,8254,31,54,5369.02,10528.29,0.00
2024-12-10 17:41:34,84,8254,30,54,5389.58,10528.70,0.00
2024-12-10 17:41:34,84,8255,30,54,5480.14,10529.00,0.00
2024-12-10 17:41:34,85,8255,30,55,5415.66,10529.01,0.00
2024-12-10 17:41:34,84,8255,30,54,5457.61,10529.17,0.00
2024-12-10 17:41:34,84,8256,30,54,5411.37,10530.00,0.00
2024-12-10 17:41:34,85,8256,31,54,5347.71,10530.01,0.00
2024-12-10 17:41:34,84,8256,31,53,5339.46,10530.24,0.00
2024-12-10 17:41:34,84,8257,31,53,5371.95,10531.00,0.00
2024-12-10 17:41:34,85,8257,31,54,5308.75,10531.01,0.00
2024-12-10 17:41:34,85,8258,31,54,5281.79,10532.00,0.00
2024-12-10 17:41:34,86,8258,32,54,5220.37,10532.01,0.00
2024-12-10 17:41:34,86,8259,32,54,5184.26,10533.00,0.00
2024-12-10 17:41:34,87,8259,33,54,5124.67,10533.01,0.00
2024-12-10 17:41:34,86,8259,33,53,5179.38,10533.05,0.00
2024-12-10 17:41:35,86,8260,33,53,5128.01,10534.00,0.00
2024-12-10 17:41:35,87,8260,33,54,5069.07,10534.01,0.00
2024-12-10 17:41:35,86,8260,33,53,5112.11,10534.09,0.00
2024-12-10 17:41:35,86,8261,33,53,5080.98,10535.00,0.00
2024-12-10 17:41:35,87,8261,34,53,5022.58,10535.01,0.00
2024-12-10 17:41:35,86,8261,34,52,5053.32,10535.17,0.00
2024-12-10 17:41:35,86,8262,34,52,5033.30,10536.00,0.00
2024-12-10 17:41:35,87,8262,35,52,4975.45,10536.01,0.00
2024-12-10 17:41:35,86,8262,34,52,5027.19,10536.06,0.00
2024-12-10 17:41:35,85,8262,33,52,5054.12,10536.14,0.00
2024-12-10 17:41:35,85,8263,33,52,5056.84,10537.00,0.00
2024-12-10 17:41:35,86,8263,33,53,4998.04,10537.01,0.00
2024-12-10 17:41:35,85,8263,33,52,5035.79,10537.15,0.00
2024-12-10 17:41:35,84,8263,32,52,5029.12,10537.73,0.00
2024-12-10 17:41:35,84,8264,32,52,5075.73,10538.00,0.00
2024-12-10 17:41:35,85,8264,32,53,5016.01,10538.01,0.00
2024-12-10 17:41:35,84,8264,31,53,5069.47,10538.06,0.00
2024-12-10 17:41:35,83,8264,30,53,5079.82,10538.29,0.00
2024-12-10 17:41:35,82,8264,29,53,5109.71,10538.43,0.00
2024-12-10 17:41:35,82,8265,29,53,5172.62,10539.00,0.00
2024-12-10 17:41:35,83,8265,30,53,5110.30,10539.01,0.00
2024-12-10 17:41:35,82,8265,30,52,5170.06,10539.02,0.00
2024-12-10 17:41:35,81,8265,30,51,5228.70,10539.06,0.00
2024-12-10 17:41:35,80,8265,30,50,5287.56,10539.11,0.00
2024-12-10 17:41:35,79,8265,29,50,5311.81,10539.14,0.00
2024-12-10 17:41:35,78,8265,29,49,5291.05,10539.68,0.00
2024-12-10 17:41:35,78,8266,29,49,5392.61,10540.00,0.00
2024-12-10 17:41:35,79,8266,30,49,5324.35,10540.01,0.00
2024-12-10 17:41:35,78,8266,30,48,5364.27,10540.15,0.00
2024-12-10 17:41:35,78,8267,30,48,5356.64,10541.00,0.00
2024-12-10 17:41:35,79,8267,31,48,5288.83,10541.01,0.00
2024-12-10 17:41:35,79,8268,31,48,5243.54,10542.00,0.00
2024-12-10 17:41:35,80,8268,31,49,5177.99,10542.01,0.00
2024-12-10 17:41:35,79,8268,31,48,5228.89,10542.05,0.00
2024-12-10 17:41:35,80,8267,31,49,5074.33,10542.92,0.00
2024-12-10 17:41:35,80,8268,31,49,5153.81,10543.00,0.00
2024-12-10 17:41:35,81,8268,31,50,5090.19,10543.01,0.00
2024-12-10 17:41:35,80,8268,31,49,5129.34,10543.13,0.00
2024-12-10 17:41:35,80,8269,31,49,5248.42,10544.00,0.00
2024-12-10 17:41:35,81,8269,31,50,5183.63,10544.01,0.00
2024-12-10 17:41:35,82,8268,32,50,5078.02,10544.20,0.00
2024-12-10 17:41:35,82,8268,32,50,5163.53,10545.00,0.00
2024-12-10 17:41:35,83,8268,33,50,5101.32,10545.01,0.00
2024-12-10 17:41:35,82,8268,33,49,5157.12,10545.06,0.00
2024-12-10 17:41:35,81,8268,33,48,5215.59,10545.10,0.00
2024-12-10 17:41:35,80,8268,33,47,5272.87,10545.10,0.00
2024-12-10 17:41:35,79,8268,32,47,5287.23,10545.39,0.00
2024-12-10 17:41:35,79,8269,32,47,5490.50,10546.00,0.00
2024-12-10 17:41:35,80,8269,33,47,5421.87,10546.01,0.00
2024-12-10 17:41:35,80,8270,33,47,5373.99,10547.00,0.00
2024-12-10 17:41:35,81,8270,34,47,5307.65,10547.01,0.00
2024-12-10 17:41:35,80,8270,34,46,5367.42,10547.06,0.00
2024-12-10 17:41:35,79,8270,34,45,5423.35,10547.10,0.00
2024-12-10 17:41:35,78,8270,33,45,5388.60,10547.63,0.00
2024-12-10 17:41:35,77,8270,32,45,5455.50,10547.66,0.00
2024-12-10 17:41:35,77,8271,32,45,5557.12,10548.00,0.00
2024-12-10 17:41:35,78,8271,33,45,5485.87,10548.01,0.00
2024-12-10 17:41:35,79,8270,33,46,5336.51,10548.54,0.00
2024-12-10 17:41:35,79,8271,33,46,5460.25,10549.00,0.00
2024-12-10 17:41:35,80,8271,34,46,5391.99,10549.01,0.00
2024-12-10 17:41:35,80,8272,34,46,5511.58,10550.00,0.00
2024-12-10 17:41:35,81,8272,35,46,5443.54,10550.01,0.00
2024-12-10 17:41:35,81,8273,35,46,5420.35,10551.00,0.00
2024-12-10 17:41:35,82,8273,35,47,5354.25,10551.01,0.00
2024-12-10 17:41:35,82,8274,35,47,5310.19,10552.00,0.00
2024-12-10 17:41:35,83,8274,35,48,5246.21,10552.01,0.00
2024-12-10 17:41:35,82,8274,35,47,5283.19,10552.11,0.00
2024-12-10 17:41:35,81,8274,34,47,5294.83,10552.59,0.00
2024-12-10 17:41:35,81,8275,34,47,5325.79,10553.00,0.00
2024-12-10 17:41:35,82,8275,34,48,5260.84,10553.01,0.00
2024-12-10 17:41:35,81,8275,34,47,5319.29,10553.06,0.00
2024-12-10 17:41:35,80,8275,33,47,5221.84,10553.97,0.00
2024-12-10 17:41:35,80,8276,33,47,5351.14,10554.00,0.00
2024-12-10 17:41:35,81,8276,33,48,5285.07,10554.01,0.00
2024-12-10 17:41:35,80,8276,33,47,5332.68,10554.06,0.00
2024-12-10 17:41:35,81,8275,33,48,5122.88,10554.89,0.00
2024-12-10 17:41:35,81,8276,33,48,5263.15,10555.00,0.00
2024-12-10 17:41:35,82,8276,33,49,5198.97,10555.01,0.00
2024-12-10 17:41:35,81,8276,33,48,5252.75,10555.09,0.00
2024-12-10 17:41:35,80,8276,32,48,5299.99,10555.26,0.00
2024-12-10 17:41:35,80,8277,32,48,5424.08,10556.00,0.00
2024-12-10 17:41:35,81,8277,33,48,5357.11,10556.01,0.00
2024-12-10 17:41:35,81,8278,33,48,5296.43,10557.00,0.00
2024-12-10 17:41:35,82,8278,33,49,5231.84,10557.01,0.00
2024-12-10 17:41:35,81,8278,33,48,5283.42,10557.10,0.00
2024-12-10 17:41:35,80,8278,32,48,5270.25,10557.78,0.00
2024-12-10 17:41:35,80,8279,32,48,5374.36,10558.00,0.00
2024-12-10 17:41:35,81,8279,32,49,5308.01,10558.01,0.00
2024-12-10 17:41:35,80,8279,31,49,5255.76,10558.55,0.00
2024-12-10 17:41:35,80,8280,31,49,5340.45,10559.00,0.00
2024-12-10 17:41:35,81,8280,32,49,5274.52,10559.01,0.00
2024-12-10 17:41:35,80,8280,32,48,5328.59,10559.11,0.00
2024-12-10 17:41:35,80,8281,32,48,5289.34,10560.00,0.00
2024-12-10 17:41:35,81,8281,33,48,5224.04,10560.01,0.00
2024-12-10 17:41:35,80,8281,33,47,5277.72,10560.11,0.00
2024-12-10 17:41:35,80,8282,33,47,5254.30,10561.00,0.00
2024-12-10 17:41:35,81,8282,33,48,5189.43,10561.01,0.00
2024-12-10 17:41:35,80,8282,33,47,5217.35,10561.11,0.00
2024-12-10 17:41:35,79,8282,32,47,5220.60,10561.24,0.00
2024-12-10 17:41:35,78,8282,31,47,5256.02,10561.54,0.00
2024-12-10 17:41:35,77,8282,30,47,5307.66,10561.70,0.00
2024-12-10 17:41:35,77,8283,30,47,5404.44,10562.00,0.00
2024-12-10 17:41:35,78,8283,30,48,5335.16,10562.01,0.00
2024-12-10 17:41:35,77,8283,29,48,5403.10,10562.01,0.00
2024-12-10 17:41:35,76,8283,28,48,5382.59,10562.43,0.00
2024-12-10 17:41:35,76,8284,28,48,5458.11,10563.00,0.00
2024-12-10 17:41:35,77,8284,29,48,5387.23,10563.01,0.00
2024-12-10 17:41:35,76,8284,29,47,5447.01,10563.11,0.00
2024-12-10 17:41:35,75,8284,28,47,5470.40,10563.29,0.00
2024-12-10 17:41:35,74,8284,27,47,5502.15,10563.68,0.00
2024-12-10 17:41:36,74,8285,27,47,5610.90,10564.00,0.00
2024-12-10 17:41:36,75,8285,28,47,5536.09,10564.01,0.00
2024-12-10 17:41:36,76,8284,29,47,5456.31,10564.11,0.00
2024-12-10 17:41:36,75,8284,29,46,5634.73,10564.17,0.00
2024-12-10 17:41:36,75,8285,29,46,5632.40,10565.00,0.00
2024-12-10 17:41:36,76,8285,30,46,5558.29,10565.01,0.00
2024-12-10 17:41:36,77,8284,30,47,5414.88,10565.45,0.00
2024-12-10 17:41:36,77,8285,30,47,5646.62,10566.00,0.00
2024-12-10 17:41:36,78,8285,30,48,5574.22,10566.01,0.00
2024-12-10 17:41:36,77,8285,30,47,5612.46,10566.19,0.00
2024-12-10 17:41:36,77,8286,30,47,5747.43,10567.00,0.00
2024-12-10 17:41:36,78,8286,31,47,5673.75,10567.01,0.00
2024-12-10 17:41:36,77,8286,30,47,5658.51,10567.40,0.00
2024-12-10 17:41:36,77,8287,30,47,5733.05,10568.00,0.00
2024-12-10 17:41:36,78,8287,31,47,5659.55,10568.01,0.00
2024-12-10 17:41:36,77,8287,31,46,5698.79,10568.19,0.00
2024-12-10 17:41:36,76,8287,30,46,5765.45,10568.28,0.00
2024-12-10 17:41:36,76,8288,30,46,5772.88,10569.00,0.00
2024-12-10 17:41:36,77,8288,31,46,5697.91,10569.01,0.00
2024-12-10 17:41:36,76,8288,31,45,5764.54,10569.05,0.00
2024-12-10 17:41:36,75,8288,30,45,5749.17,10569.55,0.00
2024-12-10 17:41:36,75,8289,30,45,5842.52,10570.00,0.00
2024-12-10 17:41:36,76,8289,31,45,5765.64,10570.01,0.00
2024-12-10 17:41:36,75,8289,30,45,5787.53,10570.27,0.00
2024-12-10 17:41:36,74,8289,29,45,5865.74,10570.27,0.00
2024-12-10 17:41:36,73,8289,28,45,5944.64,10570.27,0.00
2024-12-10 17:41:36,73,8289,28,45,5957.71,10571.00,0.00
2024-12-10 17:41:36,74,8289,29,45,5877.20,10571.01,0.00
2024-12-10 17:41:36,73,8289,29,44,5943.23,10571.05,0.00
2024-12-10 17:41:36,73,8290,29,44,5929.85,10572.00,0.00
2024-12-10 17:41:36,74,8290,29,45,5849.72,10572.01,0.00
2024-12-10 17:41:36,74,8291,29,45,5800.57,10573.00,0.00
2024-12-10 17:41:36,75,8291,30,45,5723.23,10573.01,0.00
2024-12-10 17:41:36,74,8291,30,44,5773.46,10573.18,0.00
2024-12-10 17:41:36,74,8292,30,44,5765.71,10574.00,0.00
2024-12-10 17:41:36,75,8292,31,44,5688.83,10574.01,0.00
2024-12-10 17:41:36,75,8293,31,44,5636.96,10575.00,0.00
2024-12-10 17:41:36,76,8293,31,45,5562.79,10575.01,0.00
2024-12-10 17:41:36,75,8293,31,44,5608.79,10575.19,0.00
2024-12-10 17:41:36,75,8294,31,44,5599.80,10576.00,0.00
2024-12-10 17:41:36,76,8294,32,44,5526.12,10576.01,0.00
2024-12-10 17:41:36,75,8294,31,44,5506.77,10576.21,0.00
2024-12-10 17:41:36,75,8295,31,44,5556.65,10577.00,0.00
2024-12-10 17:41:36,76,8295,32,44,5483.54,10577.01,0.00
2024-12-10 17:41:36,75,8295,32,43,5524.25,10577.20,0.00
2024-12-10 17:41:36,75,8296,32,43,5510.95,10578.00,0.00
2024-12-10 17:41:36,76,8296,33,43,5438.43,10578.01,0.00
2024-12-10 17:41:36,77,8295,33,44,5348.60,10578.22,0.00
2024-12-10 17:41:36,76,8295,32,44,5322.22,10578.89,0.00
2024-12-10 17:41:36,76,8296,32,44,5450.36,10579.00,0.00
2024-12-10 17:41:36,77,8296,32,45,5379.58,10579.01,0.00
2024-12-10 17:41:36,76,8296,31,45,5446.19,10579.04,0.00
2024-12-10 17:41:36,75,8296,30,45,5516.00,10579.05,0.00
2024-12-10 17:41:36,74,8296,30,44,5547.69,10579.22,0.00
2024-12-10 17:41:36,74,8297,30,44,5668.75,10580.00,0.00
2024-12-10 17:41:36,75,8297,30,45,5593.17,10580.01,0.00
2024-12-10 17:41:36,74,8297,30,44,5573.79,10580.43,0.00
2024-12-10 17:41:36,74,8298,30,44,5614.13,10581.00,0.00
2024-12-10 17:41:36,75,8298,31,44,5539.28,10581.01,0.00
2024-12-10 17:41:36,74,8298,31,43,5568.42,10581.22,0.00
2024-12-10 17:41:36,73,8298,30,43,5627.26,10581.32,0.00
2024-12-10 17:41:36,73,8299,30,43,5637.69,10582.00,0.00
2024-12-10 17:41:36,74,8299,31,43,5561.50,10582.01,0.00
2024-12-10 17:41:36,74,8300,31,43,5554.48,10583.00,0.00
2024-12-10 17:41:36,75,8300,32,43,5480.42,10583.01,0.00
2024-12-10 17:41:36,75,8301,32,43,5466.53,10584.00,0.00
2024-12-10 17:41:36,76,8301,33,43,5394.60,10584.01,0.00
2024-12-10 17:41:36,75,8301,33,42,5460.89,10584.05,0.00
2024-12-10 17:41:36,75,8302,33,42,5436.06,10585.00,0.00
2024-12-10 17:41:36,76,8302,34,42,5364.53,10585.01,0.00
2024-12-10 17:41:36,75,8302,34,41,5426.20,10585.07,0.00
2024-12-10 17:41:36,74,8302,34,40,5498.88,10585.07,0.00
2024-12-10 17:41:36,74,8303,34,40,5485.60,10586.00,0.00
2024-12-10 17:41:36,75,8303,34,41,5412.46,10586.01,0.00
2024-12-10 17:41:36,74,8303,33,41,5482.74,10586.03,0.00
2024-12-10 17:41:36,73,8303,32,41,5554.96,10586.04,0.00
2024-12-10 17:41:36,72,8303,32,40,5590.97,10586.15,0.00
2024-12-10 17:41:36,73,8302,33,40,5499.93,10586.32,0.00
2024-12-10 17:41:36,74,8301,33,41,5532.35,10586.37,0.00
2024-12-10 17:41:36,74,8302,33,41,5613.41,10587.00,0.00
2024-12-10 17:41:36,75,8302,34,41,5538.57,10587.01,0.00
2024-12-10 17:41:36,76,8301,35,41,5404.52,10587.36,0.00
2024-12-10 17:41:36,76,8302,35,41,5786.40,10588.00,0.00
2024-12-10 17:41:36,77,8302,35,42,5711.25,10588.01,0.00
2024-12-10 17:41:36,76,8302,35,41,5750.73,10588.14,0.00
2024-12-10 17:41:36,76,8303,35,41,5883.60,10589.00,0.00
2024-12-10 17:41:36,77,8303,36,41,5807.19,10589.01,0.00
2024-12-10 17:41:36,76,8303,35,41,5781.58,10589.70,0.00
2024-12-10 17:41:36,77,8302,35,42,5681.91,10589.95,0.00
2024-12-10 17:41:36,77,8303,35,42,5817.20,10590.00,0.00
2024-12-10 17:41:36,78,8303,35,43,5742.62,10590.01,0.00
2024-12-10 17:41:36,77,8303,35,42,5812.09,10590.04,0.00
2024-12-10 17:41:36,76,8303,35,41,5856.54,10590.13,0.00
2024-12-10 17:41:36,75,8303,34,41,5886.81,10590.59,0.00
2024-12-10 17:41:36,74,8303,33,41,5933.60,10590.72,0.00
2024-12-10 17:41:36,74,8304,33,41,6190.00,10591.00,0.00
2024-12-10 17:41:36,75,8304,34,41,6107.46,10591.01,0.00
2024-12-10 17:41:36,75,8305,34,41,6063.61,10592.00,0.00
2024-12-10 17:41:36,76,8305,34,42,5983.83,10592.01,0.00
2024-12-10 17:41:36,75,8305,33,42,6059.39,10592.04,0.00
2024-12-10 17:41:36,76,8304,34,42,5975.48,10592.11,0.00
2024-12-10 17:41:36,75,8304,34,41,6042.46,10592.12,0.00
2024-12-10 17:41:36,75,8305,34,41,6023.72,10593.00,0.00
2024-12-10 17:41:36,76,8305,34,42,5944.46,10593.01,0.00
2024-12-10 17:41:36,76,8306,34,42,6066.37,10594.00,0.00
2024-12-10 17:41:36,77,8306,34,43,5987.59,10594.01,0.00
2024-12-10 17:41:37,77,8307,34,43,5963.37,10595.00,0.00
2024-12-10 17:41:37,78,8307,35,43,5886.91,10595.01,0.00
2024-12-10 17:41:37,77,8307,35,42,5959.25,10595.04,0.00
2024-12-10 17:41:37,77,8308,35,42,5927.22,10596.00,0.00
2024-12-10 17:41:37,78,8308,36,42,5851.23,10596.01,0.00
2024-12-10 17:41:37,78,8309,36,42,5796.01,10597.00,0.00
2024-12-10 17:41:37,79,8309,36,43,5722.65,10597.01,0.00
2024-12-10 17:41:37,78,8309,36,42,5768.85,10597.06,0.00
2024-12-10 17:41:37,77,8309,35,42,5817.98,10597.30,0.00
2024-12-10 17:41:37,76,8309,34,42,5874.19,10597.42,0.00
2024-12-10 17:41:37,76,8310,34,42,5896.37,10598.00,0.00
2024-12-10 17:41:37,77,8310,35,42,5819.79,10598.01,0.00
2024-12-10 17:41:37,76,8310,35,41,5874.07,10598.09,0.00
2024-12-10 17:41:37,75,8310,34,41,5930.26,10598.29,0.00
2024-12-10 17:41:37,74,8310,33,41,5935.35,10598.73,0.00
2024-12-10 17:41:37,75,8309,33,42,5841.82,10598.88,0.00
2024-12-10 17:41:37,75,8310,33,42,5981.83,10599.00,0.00
2024-12-10 17:41:37,76,8310,33,43,5903.12,10599.01,0.00
2024-12-10 17:41:37,75,8310,32,43,5940.36,10599.13,0.00
2024-12-10 17:41:37,76,8309,33,43,5816.24,10599.58,0.00
2024-12-10 17:41:37,76,8310,33,43,6035.42,10600.00,0.00
2024-12-10 17:41:37,77,8310,33,44,5957.03,10600.01,0.00
2024-12-10 17:41:37,76,8310,33,43,6031.24,10600.04,0.00
2024-12-10 17:41:37,75,8310,33,42,6094.70,10600.08,0.00
2024-12-10 17:41:37,75,8311,33,42,6221.19,10601.00,0.00
2024-12-10 17:41:37,76,8311,34,42,6139.33,10601.01,0.00
2024-12-10 17:41:37,75,8311,34,41,6219.78,10601.01,0.00
2024-12-10 17:41:37,74,8311,34,40,6300.97,10601.03,0.00
2024-12-10 17:41:37,73,8311,33,40,6250.18,10601.55,0.00
2024-12-10 17:41:37,73,8312,33,40,6344.74,10602.00,0.00
2024-12-10 17:41:37,74,8312,33,41,6259.00,10602.01,0.00
2024-12-10 17:41:37,73,8312,33,40,6328.77,10602.05,0.00
2024-12-10 17:41:37,73,8313,33,40,6304.76,10603.00,0.00
2024-12-10 17:41:37,74,8313,34,40,6219.56,10603.01,0.00
2024-12-10 17:41:37,73,8313,33,40,6177.60,10603.49,0.00
2024-12-10 17:41:37,73,8314,33,40,6264.75,10604.00,0.00
2024-12-10 17:41:37,74,8314,34,40,6180.09,10604.01,0.00
2024-12-10 17:41:37,73,8314,34,39,6241.52,10604.08,0.00
2024-12-10 17:41:37,73,8315,34,39,6221.51,10605.00,0.00
2024-12-10 17:41:37,74,8315,34,40,6137.44,10605.01,0.00
2024-12-10 17:41:37,74,8316,34,40,6084.65,10606.00,0.00
2024-12-10 17:41:37,75,8316,34,41,6003.52,10606.01,0.00
2024-12-10 17:41:37,74,8316,34,40,6057.49,10606.09,0.00
2024-12-10 17:41:37,73,8316,33,40,6131.75,10606.16,0.00
2024-12-10 17:41:37,73,8317,33,40,6186.43,10607.00,0.00
2024-12-10 17:41:37,74,8317,33,41,6102.83,10607.01,0.00
2024-12-10 17:41:37,75,8316,34,41,5894.46,10607.81,0.00
2024-12-10 17:41:37,75,8317,34,41,6031.08,10608.00,0.00
2024-12-10 17:41:37,76,8317,34,42,5951.72,10608.01,0.00
2024-12-10 17:41:37,75,8317,33,42,6006.45,10608.07,0.00
2024-12-10 17:41:37,76,8316,33,43,5924.63,10608.12,0.00
2024-12-10 17:41:37,76,8317,33,43,6165.66,10609.00,0.00
2024-12-10 17:41:37,77,8317,33,44,6085.59,10609.01,0.00
2024-12-10 17:41:37,76,8317,32,44,6123.69,10609.14,0.00
2024-12-10 17:41:37,77,8316,32,45,5985.16,10609.62,0.00
2024-12-10 17:41:37,77,8316,32,45,6247.05,10610.00,0.00
2024-12-10 17:41:37,78,8316,32,46,6166.96,10610.01,0.00
2024-12-10 17:41:37,78,8317,32,46,6286.52,10611.00,0.00
2024-12-10 17:41:37,79,8317,32,47,6206.94,10611.01,0.00
2024-12-10 17:41:37,78,8317,32,46,6283.80,10611.03,0.00
2024-12-10 17:41:37,79,8316,32,47,6147.85,10611.29,0.00
2024-12-10 17:41:37,79,8317,32,47,6243.34,10612.00,0.00
2024-12-10 17:41:37,80,8317,33,47,6165.30,10612.01,0.00
2024-12-10 17:41:37,80,8318,33,47,6238.19,10613.00,0.00
2024-12-10 17:41:37,81,8318,33,48,6161.17,10613.01,0.00
2024-12-10 17:41:37,80,8318,33,47,6207.32,10613.08,0.00
2024-12-10 17:41:37,81,8317,33,48,6080.05,10613.56,0.00
2024-12-10 17:41:37,82,8316,33,49,6127.62,10613.63,0.00
2024-12-10 17:41:37,81,8316,32,49,6225.07,10613.65,0.00
2024-12-10 17:41:37,81,8317,32,49,6253.96,10614.00,0.00
2024-12-10 17:41:37,82,8317,33,49,6177.69,10614.01,0.00
2024-12-10 17:41:37,83,8316,33,50,5936.34,10614.94,0.00
2024-12-10 17:41:37,83,8317,33,50,6313.48,10615.00,0.00
2024-12-10 17:41:37,84,8317,34,50,6238.32,10615.01,0.00
2024-12-10 17:41:37,84,8318,34,50,6283.09,10616.00,0.00
2024-12-10 17:41:37,85,8318,34,51,6209.17,10616.01,0.00
2024-12-10 17:41:37,86,8317,35,51,6136.97,10616.04,0.00
2024-12-10 17:41:37,86,8318,35,51,6108.13,10617.00,0.00
2024-12-10 17:41:37,87,8318,36,51,6037.92,10617.01,0.00
2024-12-10 17:41:37,86,8318,36,50,6099.24,10617.07,0.00
2024-12-10 17:41:37,86,8319,36,50,6155.50,10618.00,0.00
2024-12-10 17:41:37,87,8319,37,50,6084.75,10618.01,0.00
2024-12-10 17:41:37,87,8320,37,50,5984.33,10619.00,0.00
2024-12-10 17:41:37,88,8320,37,51,5916.33,10619.01,0.00
2024-12-10 17:41:37,87,8320,37,50,5970.62,10619.07,0.00
2024-12-10 17:41:37,86,8320,36,50,6025.59,10619.20,0.00
2024-12-10 17:41:37,86,8321,36,50,5967.90,10620.00,0.00
2024-12-10 17:41:37,87,8321,37,50,5899.31,10620.01,0.00
2024-12-10 17:41:37,86,8321,36,50,5833.86,10620.57,0.00
2024-12-10 17:41:37,87,8320,36,51,5724.76,10620.84,0.00
2024-12-10 17:41:37,87,8321,36,51,5818.74,10621.00,0.00
2024-12-10 17:41:37,88,8321,36,52,5752.62,10621.01,0.00
2024-12-10 17:41:37,87,8321,36,51,5802.37,10621.08,0.00
2024-12-10 17:41:37,86,8321,35,51,5849.44,10621.24,0.00
2024-12-10 17:41:37,85,8321,35,50,5870.39,10621.62,0.00
2024-12-10 17:41:37,85,8322,35,50,6009.43,10622.00,0.00
2024-12-10 17:41:37,86,8322,35,51,5939.56,10622.01,0.00
2024-12-10 17:41:37,85,8322,34,51,5987.95,10622.08,0.00
2024-12-10 17:41:37,84,8322,33,51,5971.02,10622.65,0.00
2024-12-10 17:41:37,85,8321,34,51,5894.57,10622.73,0.00
2024-12-10 17:41:37,85,8322,34,51,6010.33,10623.00,0.00
2024-12-10 17:41:37,86,8322,34,52,5940.44,10623.01,0.00
2024-12-10 17:41:37,85,8322,34,51,5989.64,10623.08,0.00
2024-12-10 17:41:37,85,8323,34,51,6069.76,10624.00,0.00
2024-12-10 17:41:37,86,8323,34,52,5999.19,10624.01,0.00
2024-12-10 17:41:37,86,8324,34,52,5921.87,10625.00,0.00
2024-12-10 17:41:37,87,8324,35,52,5853.80,10625.01,0.00
2024-12-10 17:41:37,86,8324,35,51,5902.15,10625.08,0.00
2024-12-10 17:41:38,85,8324,34,51,5956.34,10625.20,0.00
2024-12-10 17:41:38,86,8323,34,52,5864.93,10625.43,0.00
2024-12-10 17:41:38,87,8322,35,52,5807.35,10625.53,0.00
2024-12-10 17:41:38,87,8323,35,52,5899.85,10626.00,0.00
2024-12-10 17:41:38,88,8323,35,53,5832.80,10626.01,0.00
2024-12-10 17:41:38,87,8323,35,52,5852.35,10626.02,0.00
2024-12-10 17:41:38,86,8323,35,51,5877.90,10626.15,0.00
2024-12-10 17:41:38,86,8324,35,51,6138.42,10627.00,0.00
2024-12-10 17:41:38,87,8324,36,51,6067.86,10627.01,0.00
2024-12-10 17:41:38,86,8324,36,50,6067.36,10627.08,0.00
2024-12-10 17:41:38,86,8325,36,50,6069.97,10628.00,0.00
2024-12-10 17:41:38,87,8325,37,50,6000.20,10628.01,0.00
2024-12-10 17:41:38,86,8325,36,50,6023.95,10628.19,0.00
2024-12-10 17:41:38,86,8326,36,50,5988.32,10629.00,0.00
2024-12-10 17:41:38,87,8326,37,50,5919.48,10629.01,0.00
2024-12-10 17:41:38,86,8326,37,49,5967.97,10629.08,0.00
2024-12-10 17:41:38,87,8325,37,50,5872.59,10629.36,0.00
2024-12-10 17:41:38,87,8326,37,50,5872.05,10630.00,0.00
2024-12-10 17:41:38,88,8326,38,50,5805.32,10630.01,0.00
2024-12-10 17:41:38,87,8326,38,49,5861.46,10630.05,0.00
2024-12-10 17:41:38,87,8327,38,49,5903.29,10631.00,0.00
2024-12-10 17:41:38,88,8327,38,50,5836.21,10631.01,0.00
2024-12-10 17:41:38,87,8327,38,49,5901.58,10631.02,0.00
2024-12-10 17:41:38,86,8327,38,48,5960.32,10631.06,0.00
2024-12-10 17:41:38,87,8326,39,48,5865.03,10631.33,0.00
2024-12-10 17:41:38,88,8325,40,48,5744.93,10631.69,0.00
2024-12-10 17:41:38,88,8326,40,48,5872.91,10632.00,0.00
2024-12-10 17:41:38,89,8326,40,49,5806.92,10632.01,0.00
2024-12-10 17:41:38,88,8326,40,48,5716.00,10632.60,0.00
2024-12-10 17:41:38,88,8327,40,48,6017.80,10633.00,0.00
2024-12-10 17:41:38,89,8327,40,49,5950.19,10633.01,0.00
2024-12-10 17:41:38,88,8327,40,48,6006.93,10633.06,0.00
2024-12-10 17:41:38,87,8327,39,48,6038.89,10633.32,0.00
2024-12-10 17:41:38,86,8327,39,47,6070.74,10633.57,0.00
2024-12-10 17:41:38,85,8327,38,47,6112.50,10633.68,0.00
2024-12-10 17:41:38,85,8328,38,47,6193.85,10634.00,0.00
2024-12-10 17:41:38,86,8328,38,48,6121.83,10634.01,0.00
2024-12-10 17:41:38,85,8328,37,48,6191.82,10634.02,0.00
2024-12-10 17:41:38,85,8329,37,48,6106.00,10635.00,0.00
2024-12-10 17:41:38,86,8329,37,49,6035.00,10635.01,0.00
2024-12-10 17:41:38,85,8329,37,48,6097.25,10635.05,0.00
2024-12-10 17:41:38,84,8329,36,48,6154.68,10635.15,0.00
2024-12-10 17:41:38,85,8328,37,48,6022.87,10635.60,0.00
2024-12-10 17:41:38,85,8329,37,48,6136.76,10636.00,0.00
2024-12-10 17:41:38,86,8329,37,49,6065.41,10636.01,0.00
2024-12-10 17:41:38,85,8329,37,48,5966.65,10636.75,0.00
2024-12-10 17:41:38,85,8330,37,48,6181.45,10637.00,0.00
2024-12-10 17:41:38,86,8330,38,48,6109.57,10637.01,0.00
2024-12-10 17:41:38,85,8330,38,47,6150.19,10637.12,0.00
2024-12-10 17:41:38,84,8330,37,47,6222.15,10637.13,0.00
2024-12-10 17:41:38,83,8330,36,47,6251.78,10637.29,0.00
2024-12-10 17:41:38,83,8331,36,47,6296.59,10638.00,0.00
2024-12-10 17:41:38,84,8331,37,47,6221.63,10638.01,0.00
2024-12-10 17:41:38,84,8332,37,47,6152.06,10639.00,0.00
2024-12-10 17:41:38,85,8332,37,48,6079.69,10639.01,0.00
2024-12-10 17:41:38,84,8332,37,47,6135.62,10639.08,0.00
2024-12-10 17:41:38,83,8332,36,47,6205.71,10639.12,0.00
2024-12-10 17:41:38,82,8332,35,47,6269.72,10639.17,0.00
2024-12-10 17:41:38,81,8332,34,47,6278.97,10639.67,0.00
2024-12-10 17:41:38,82,8331,35,47,6161.75,10639.96,0.00
2024-12-10 17:41:38,82,8332,35,47,6291.54,10640.00,0.00
2024-12-10 17:41:38,83,8332,36,47,6215.74,10640.01,0.00
2024-12-10 17:41:38,82,8332,35,47,6291.41,10640.01,0.00
2024-12-10 17:41:38,81,8332,34,47,6320.52,10640.16,0.00
2024-12-10 17:41:38,82,8331,35,47,6186.88,10640.58,0.00
2024-12-10 17:41:38,82,8332,35,47,6419.95,10641.00,0.00
2024-12-10 17:41:38,83,8332,35,48,6342.60,10641.01,0.00
2024-12-10 17:41:38,82,8332,35,47,6391.43,10641.10,0.00
2024-12-10 17:41:38,81,8332,34,47,6465.10,10641.14,0.00
2024-12-10 17:41:38,82,8331,34,48,6318.60,10641.57,0.00
2024-12-10 17:41:38,82,8332,34,48,6538.47,10642.00,0.00
2024-12-10 17:41:38,83,8332,34,49,6459.69,10642.01,0.00
2024-12-10 17:41:38,83,8333,34,49,6490.62,10643.00,0.00
2024-12-10 17:41:38,84,8333,35,49,6413.35,10643.01,0.00
2024-12-10 17:41:38,83,8333,35,48,6475.24,10643.02,0.00
2024-12-10 17:41:38,84,8332,35,49,6391.84,10643.11,0.00
2024-12-10 17:41:38,83,8332,34,49,6490.33,10643.61,0.00
2024-12-10 17:41:38,83,8333,34,49,6521.04,10644.00,0.00
2024-12-10 17:41:38,84,8333,34,50,6443.41,10644.01,0.00
2024-12-10 17:41:38,84,8334,34,50,6515.13,10645.00,0.00
2024-12-10 17:41:38,85,8334,34,51,6438.48,10645.01,0.00
2024-12-10 17:41:38,85,8335,34,51,6384.15,10646.00,0.00
2024-12-10 17:41:38,86,8335,34,52,6309.91,10646.01,0.00
2024-12-10 17:41:38,85,8335,33,52,6300.02,10646.40,0.00
2024-12-10 17:41:38,85,8336,33,52,6338.17,10647.00,0.00
2024-12-10 17:41:38,86,8336,34,52,6264.47,10647.01,0.00
2024-12-10 17:41:38,85,8336,33,52,6295.94,10647.14,0.00
2024-12-10 17:41:38,84,8336,32,52,6346.86,10647.25,0.00
2024-12-10 17:41:38,85,8335,32,53,6252.25,10647.46,0.00
2024-12-10 17:41:38,85,8336,32,53,6313.80,10648.00,0.00
2024-12-10 17:41:38,86,8336,32,54,6240.38,10648.01,0.00
2024-12-10 17:41:38,85,8336,32,53,6286.26,10648.08,0.00
2024-12-10 17:41:38,84,8336,31,53,6354.78,10648.14,0.00
2024-12-10 17:41:38,84,8337,31,53,6439.58,10649.00,0.00
2024-12-10 17:41:38,85,8337,32,53,6363.82,10649.01,0.00
2024-12-10 17:41:38,84,8337,31,53,6357.20,10649.11,0.00
2024-12-10 17:41:38,83,8337,30,53,6385.47,10649.51,0.00
2024-12-10 17:41:38,83,8338,30,53,6455.32,10650.00,0.00
2024-12-10 17:41:38,84,8338,30,54,6378.47,10650.01,0.00
2024-12-10 17:41:38,83,8338,30,53,6434.81,10650.08,0.00
2024-12-10 17:41:38,83,8339,30,53,6396.88,10651.00,0.00
2024-12-10 17:41:38,84,8339,30,54,6320.73,10651.01,0.00
2024-12-10 17:41:38,83,8339,29,54,6277.09,10651.66,0.00
2024-12-10 17:41:38,83,8340,29,54,6318.44,10652.00,0.00
2024-12-10 17:41:38,84,8340,29,55,6243.22,10652.01,0.00
2024-12-10 17:41:38,83,8340,29,54,6255.33,10652.06,0.00
2024-12-10 17:41:38,84,8339,30,54,6134.26,10652.39,0.00
2024-12-10 17:41:38,84,8340,30,54,6227.85,10653.00,0.00
2024-12-10 17:41:38,85,8340,31,54,6154.58,10653.01,0.00
2024-12-10 17:41:38,84,8340,31,53,6211.37,10653.07,0.00
2024-12-10 17:41:38,85,8339,31,54,6037.87,10653.67,0.00
2024-12-10 17:41:39,85,8340,31,54,6234.80,10654.00,0.00
2024-12-10 17:41:39,86,8340,32,54,6162.30,10654.01,0.00
2024-12-10 17:41:39,85,8340,31,54,6233.54,10654.01,0.00
2024-12-10 17:41:39,84,8340,31,53,6156.38,10654.61,0.00
2024-12-10 17:41:39,84,8341,31,53,6351.95,10655.00,0.00
2024-12-10 17:41:39,85,8341,31,54,6277.23,10655.01,0.00
2024-12-10 17:41:39,84,8341,30,54,6251.64,10655.49,0.00
2024-12-10 17:41:39,84,8342,30,54,6293.36,10656.00,0.00
2024-12-10 17:41:39,85,8342,31,54,6219.32,10656.01,0.00
2024-12-10 17:41:39,84,8342,31,53,6281.89,10656.07,0.00
2024-12-10 17:41:39,83,8342,31,52,6334.11,10656.29,0.00
2024-12-10 17:41:39,82,8342,31,51,6399.39,10656.37,0.00
2024-12-10 17:41:39,82,8343,31,51,6359.49,10657.00,0.00
2024-12-10 17:41:39,83,8343,31,52,6282.87,10657.01,0.00
2024-12-10 17:41:39,82,8343,30,52,6235.57,10657.68,0.00
2024-12-10 17:41:39,82,8344,30,52,6269.72,10658.00,0.00
2024-12-10 17:41:39,83,8344,30,53,6194.19,10658.01,0.00
2024-12-10 17:41:39,82,8344,30,52,6248.94,10658.07,0.00
2024-12-10 17:41:39,82,8345,30,52,6198.43,10659.00,0.00
2024-12-10 17:41:39,83,8345,30,53,6123.75,10659.01,0.00
2024-12-10 17:41:39,84,8344,31,53,5998.90,10659.29,0.00
2024-12-10 17:41:39,83,8344,30,53,6082.90,10659.67,0.00
2024-12-10 17:41:39,83,8345,30,53,6134.52,10660.00,0.00
2024-12-10 17:41:39,84,8345,30,54,6061.49,10660.01,0.00
2024-12-10 17:41:39,83,8345,29,54,5992.11,10660.93,0.00
2024-12-10 17:41:39,83,8346,29,54,6181.38,10661.00,0.00
2024-12-10 17:41:39,84,8346,29,55,6107.80,10661.01,0.00
2024-12-10 17:41:39,83,8346,29,54,6170.89,10661.07,0.00
2024-12-10 17:41:39,83,8347,29,54,6114.88,10662.00,0.00
2024-12-10 17:41:39,84,8347,29,55,6042.08,10662.01,0.00
2024-12-10 17:41:39,83,8347,29,54,6112.31,10662.02,0.00
2024-12-10 17:41:39,82,8347,28,54,6182.95,10662.02,0.00
2024-12-10 17:41:39,83,8346,28,55,6055.89,10662.30,0.00
2024-12-10 17:41:39,83,8347,28,55,6082.15,10663.00,0.00
2024-12-10 17:41:39,84,8347,29,55,6009.74,10663.01,0.00
2024-12-10 17:41:39,83,8347,28,55,6046.70,10663.10,0.00
2024-12-10 17:41:39,84,8346,29,55,5903.04,10663.63,0.00
2024-12-10 17:41:39,84,8347,29,55,6132.62,10664.00,0.00
2024-12-10 17:41:39,85,8347,30,55,6060.47,10664.01,0.00
2024-12-10 17:41:39,84,8347,29,55,6090.77,10664.17,0.00
2024-12-10 17:41:39,84,8348,29,55,6190.39,10665.00,0.00
2024-12-10 17:41:39,85,8348,30,55,6117.57,10665.01,0.00
2024-12-10 17:41:39,84,8348,30,54,6157.39,10665.07,0.00
2024-12-10 17:41:39,84,8349,30,54,6102.08,10666.00,0.00
2024-12-10 17:41:39,85,8349,31,54,6030.30,10666.01,0.00
2024-12-10 17:41:39,84,8349,31,53,6020.04,10666.35,0.00
2024-12-10 17:41:39,85,8348,32,53,5940.47,10666.45,0.00
2024-12-10 17:41:39,84,8348,31,53,6045.03,10666.50,0.00
2024-12-10 17:41:39,84,8349,31,53,6076.94,10667.00,0.00
2024-12-10 17:41:39,85,8349,32,53,6005.45,10667.01,0.00
2024-12-10 17:41:39,84,8349,32,52,6043.94,10667.07,0.00
2024-12-10 17:41:39,83,8349,31,52,6079.53,10667.29,0.00
2024-12-10 17:41:39,84,8348,31,53,5998.31,10667.39,0.00
2024-12-10 17:41:39,84,8349,31,53,6185.44,10668.00,0.00
2024-12-10 17:41:39,85,8349,31,54,6112.67,10668.01,0.00
2024-12-10 17:41:39,84,8349,31,53,6153.67,10668.07,0.00
2024-12-10 17:41:39,83,8349,31,52,6214.36,10668.19,0.00
2024-12-10 17:41:39,84,8348,31,53,6088.72,10668.57,0.00
2024-12-10 17:41:39,83,8348,30,53,6163.09,10668.86,0.00
2024-12-10 17:41:39,83,8349,30,53,6353.43,10669.00,0.00
2024-12-10 17:41:39,84,8349,31,53,6277.80,10669.01,0.00
2024-12-10 17:41:39,83,8349,30,53,6308.45,10669.07,0.00
2024-12-10 17:41:39,84,8348,30,54,6188.83,10669.24,0.00
2024-12-10 17:41:39,84,8349,30,54,6453.52,10670.00,0.00
2024-12-10 17:41:39,85,8349,31,54,6377.60,10670.01,0.00
2024-12-10 17:41:39,84,8349,31,53,6426.86,10670.11,0.00
2024-12-10 17:41:39,84,8350,31,53,6482.90,10671.00,0.00
2024-12-10 17:41:39,85,8350,31,54,6406.63,10671.01,0.00
2024-12-10 17:41:39,84,8350,30,54,6481.63,10671.01,0.00
2024-12-10 17:41:39,83,8350,29,54,6522.43,10671.01,0.00
2024-12-10 17:41:39,83,8351,29,54,6465.94,10672.00,0.00
2024-12-10 17:41:39,84,8351,30,54,6388.97,10672.01,0.00
2024-12-10 17:41:39,83,8351,30,53,6462.09,10672.04,0.00
2024-12-10 17:41:39,82,8351,29,53,6503.16,10672.05,0.00
2024-12-10 17:41:39,83,8350,29,54,6393.96,10672.12,0.00
2024-12-10 17:41:39,83,8351,29,54,6398.98,10673.00,0.00
2024-12-10 17:41:39,84,8351,29,55,6322.80,10673.01,0.00
2024-12-10 17:41:39,83,8351,29,54,6373.27,10673.08,0.00
2024-12-10 17:41:39,83,8352,29,54,6429.75,10674.00,0.00
2024-12-10 17:41:39,84,8352,30,54,6353.20,10674.01,0.00
2024-12-10 17:41:39,85,8351,31,54,6213.62,10674.28,0.00
2024-12-10 17:41:39,85,8352,31,54,6227.74,10675.00,0.00
2024-12-10 17:41:39,86,8352,32,54,6155.33,10675.01,0.00
2024-12-10 17:41:39,87,8351,33,54,6028.62,10675.18,0.00
2024-12-10 17:41:39,87,8352,33,54,6220.69,10676.00,0.00
2024-12-10 17:41:39,88,8352,34,54,6150.00,10676.01,0.00
2024-12-10 17:41:39,88,8353,34,54,6182.46,10677.00,0.00
2024-12-10 17:41:39,89,8353,34,55,6113.00,10677.01,0.00
2024-12-10 17:41:39,88,8353,34,54,6125.32,10677.15,0.00
2024-12-10 17:41:39,87,8353,33,54,6139.45,10677.54,0.00
2024-12-10 17:41:39,87,8354,33,54,6148.39,10678.00,0.00
2024-12-10 17:41:39,88,8354,33,55,6078.52,10678.01,0.00
2024-12-10 17:41:39,87,8354,33,54,6122.63,10678.08,0.00
2024-12-10 17:41:39,87,8355,33,54,6050.29,10679.00,0.00
2024-12-10 17:41:39,88,8355,34,54,5981.54,10679.01,0.00
2024-12-10 17:41:39,87,8355,34,53,6035.57,10679.07,0.00
2024-12-10 17:41:39,86,8355,33,53,6013.27,10679.64,0.00
2024-12-10 17:41:39,86,8356,33,53,6031.89,10680.00,0.00
2024-12-10 17:41:39,87,8356,34,53,5962.56,10680.01,0.00
2024-12-10 17:41:39,88,8355,34,54,5818.37,10680.36,0.00
2024-12-10 17:41:39,88,8356,34,54,5849.10,10681.00,0.00
2024-12-10 17:41:39,89,8356,35,54,5783.38,10681.01,0.00
2024-12-10 17:41:39,88,8356,35,53,5832.12,10681.07,0.00
2024-12-10 17:41:39,89,8355,36,53,5657.64,10681.83,0.00
2024-12-10 17:41:39,89,8356,36,53,5913.24,10682.00,0.00
2024-12-10 17:41:39,90,8356,37,53,5847.54,10682.01,0.00
2024-12-10 17:41:39,89,8356,37,52,5884.09,10682.07,0.00
2024-12-10 17:41:39,88,8356,36,52,5937.23,10682.08,0.00
2024-12-10 17:41:39,88,8357,36,52,6032.11,10683.00,0.00
2024-12-10 17:41:39,89,8357,36,53,5964.34,10683.01,0.00
2024-12-10 17:41:40,90,8356,37,53,5769.39,10683.78,0.00
2024-12-10 17:41:40,90,8357,37,53,5870.44,10684.00,0.00
2024-12-10 17:41:40,91,8357,38,53,5805.93,10684.01,0.00
2024-12-10 17:41:40,90,8357,37,53,5810.52,10684.26,0.00
2024-12-10 17:41:40,90,8358,37,53,5903.62,10685.00,0.00
2024-12-10 17:41:40,91,8358,38,53,5838.74,10685.01,0.00
2024-12-10 17:41:40,91,8359,38,53,5741.75,10686.00,0.00
2024-12-10 17:41:40,92,8359,38,54,5679.34,10686.01,0.00
2024-12-10 17:41:40,91,8359,38,53,5740.58,10686.01,0.00
2024-12-10 17:41:40,90,8359,38,52,5779.43,10686.06,0.00
2024-12-10 17:41:40,89,8359,37,52,5827.68,10686.15,0.00
2024-12-10 17:41:40,89,8360,37,52,5766.72,10687.00,0.00
2024-12-10 17:41:40,90,8360,38,52,5702.64,10687.01,0.00
2024-12-10 17:41:40,89,8360,38,51,5657.57,10687.53,0.00
2024-12-10 17:41:40,89,8361,38,51,5652.77,10688.00,0.00
2024-12-10 17:41:40,90,8361,38,52,5589.96,10688.01,0.00
2024-12-10 17:41:40,89,8361,38,51,5646.31,10688.06,0.00
2024-12-10 17:41:40,90,8360,38,52,5554.68,10688.32,0.00
2024-12-10 17:41:40,89,8360,38,51,5691.51,10688.43,0.00
2024-12-10 17:41:40,90,8359,38,52,5584.36,10688.73,0.00
2024-12-10 17:41:40,90,8360,38,52,5646.20,10689.00,0.00
2024-12-10 17:41:40,91,8360,39,52,5584.15,10689.01,0.00
2024-12-10 17:41:40,90,8360,38,52,5604.69,10689.18,0.00
2024-12-10 17:41:40,89,8360,37,52,5649.85,10689.30,0.00
2024-12-10 17:41:40,88,8360,36,52,5630.00,10689.81,0.00
2024-12-10 17:41:40,88,8361,36,52,5964.03,10690.00,0.00
2024-12-10 17:41:40,89,8361,36,53,5897.02,10690.01,0.00
2024-12-10 17:41:40,88,8361,36,52,5962.81,10690.01,0.00
2024-12-10 17:41:40,87,8361,35,52,5988.57,10690.17,0.00
2024-12-10 17:41:40,88,8360,36,52,5829.73,10690.84,0.00
2024-12-10 17:41:40,88,8361,36,52,5967.01,10691.00,0.00
2024-12-10 17:41:40,89,8361,37,52,5899.97,10691.01,0.00
2024-12-10 17:41:40,90,8360,37,53,5782.15,10691.29,0.00
2024-12-10 17:41:40,90,8361,37,53,5881.37,10692.00,0.00
2024-12-10 17:41:40,91,8361,37,54,5816.74,10692.01,0.00
2024-12-10 17:41:40,91,8362,37,54,5830.01,10693.00,0.00
2024-12-10 17:41:40,92,8362,37,55,5766.64,10693.01,0.00
2024-12-10 17:41:40,91,8362,37,54,5825.07,10693.04,0.00
2024-12-10 17:41:40,90,8362,36,54,5794.28,10693.68,0.00
2024-12-10 17:41:40,91,8361,37,54,5721.77,10693.75,0.00
2024-12-10 17:41:40,91,8362,37,54,5790.31,10694.00,0.00
2024-12-10 17:41:40,92,8362,38,54,5727.37,10694.01,0.00
2024-12-10 17:41:40,91,8362,37,54,5704.75,10694.36,0.00
2024-12-10 17:41:40,90,8362,36,54,5711.50,10694.69,0.00
2024-12-10 17:41:40,90,8363,36,54,5881.68,10695.00,0.00
2024-12-10 17:41:40,91,8363,36,55,5817.05,10695.01,0.00
2024-12-10 17:41:40,90,8363,36,54,5869.80,10695.07,0.00
2024-12-10 17:41:40,90,8364,36,54,5782.72,10696.00,0.00
2024-12-10 17:41:40,91,8364,37,54,5719.17,10696.01,0.00
2024-12-10 17:41:40,92,8363,37,55,5605.82,10696.26,0.00
2024-12-10 17:41:40,91,8363,37,54,5659.70,10696.35,0.00
2024-12-10 17:41:40,91,8364,37,54,5626.74,10697.00,0.00
2024-12-10 17:41:40,92,8364,37,55,5565.58,10697.01,0.00
2024-12-10 17:41:40,91,8364,37,54,5613.81,10697.07,0.00
2024-12-10 17:41:40,90,8364,36,54,5649.49,10697.22,0.00
2024-12-10 17:41:40,90,8365,36,54,5715.08,10698.00,0.00
2024-12-10 17:41:40,91,8365,37,54,5652.28,10698.01,0.00
2024-12-10 17:41:40,92,8364,38,54,5475.46,10698.76,0.00
2024-12-10 17:41:40,92,8365,38,54,5592.86,10699.00,0.00
2024-12-10 17:41:40,93,8365,38,55,5532.72,10699.01,0.00
2024-12-10 17:41:40,92,8365,38,54,5591.69,10699.01,0.00
2024-12-10 17:41:40,91,8365,38,53,5642.56,10699.05,0.00
2024-12-10 17:41:40,90,8365,37,53,5690.98,10699.17,0.00
2024-12-10 17:41:40,89,8365,36,53,5588.61,10699.93,0.00
2024-12-10 17:41:40,89,8366,36,53,5803.93,10700.00,0.00
2024-12-10 17:41:40,90,8366,36,54,5739.44,10700.01,0.00
2024-12-10 17:41:40,89,8366,36,53,5802.73,10700.01,0.00
2024-12-10 17:41:40,88,8366,35,53,5845.57,10700.03,0.00
2024-12-10 17:41:40,87,8366,34,53,5767.23,10700.79,0.00
2024-12-10 17:41:40,87,8367,34,53,5837.11,10701.00,0.00
2024-12-10 17:41:40,88,8367,35,53,5770.78,10701.01,0.00
2024-12-10 17:41:40,87,8367,35,52,5829.73,10701.03,0.00
2024-12-10 17:41:40,88,8366,35,53,5732.52,10701.34,0.00
2024-12-10 17:41:40,87,8366,35,52,5886.37,10701.37,0.00
2024-12-10 17:41:40,86,8366,34,52,5849.35,10701.74,0.00
2024-12-10 17:41:40,86,8367,34,52,5922.68,10702.00,0.00
2024-12-10 17:41:40,87,8367,35,52,5854.60,10702.01,0.00
2024-12-10 17:41:40,87,8368,35,52,5910.73,10703.00,0.00
2024-12-10 17:41:40,88,8368,35,53,5843.56,10703.01,0.00
2024-12-10 17:41:40,88,8369,35,53,5735.44,10704.00,0.00
2024-12-10 17:41:40,89,8369,35,54,5671.00,10704.01,0.00
2024-12-10 17:41:40,88,8369,34,54,5734.22,10704.01,0.00
2024-12-10 17:41:40,87,8369,34,53,5777.72,10704.02,0.00
2024-12-10 17:41:40,86,8369,34,52,5779.51,10704.51,0.00
2024-12-10 17:41:40,85,8369,33,52,5818.01,10704.56,0.00
2024-12-10 17:41:40,85,8370,33,52,5861.81,10705.00,0.00
2024-12-10 17:41:40,86,8370,33,53,5793.65,10705.01,0.00
2024-12-10 17:41:40,85,8370,32,53,5859.79,10705.02,0.00
2024-12-10 17:41:40,85,8371,32,53,5746.14,10706.00,0.00
2024-12-10 17:41:40,86,8371,33,53,5679.33,10706.01,0.00
2024-12-10 17:41:40,85,8371,33,52,5734.81,10706.05,0.00
2024-12-10 17:41:40,86,8370,33,53,5586.74,10706.65,0.00
2024-12-10 17:41:40,86,8371,33,53,5657.85,10707.00,0.00
2024-12-10 17:41:40,87,8371,33,54,5592.82,10707.01,0.00
2024-12-10 17:41:40,87,8372,33,54,5583.02,10708.00,0.00
2024-12-10 17:41:40,88,8372,33,55,5519.57,10708.01,0.00
2024-12-10 17:41:40,87,8372,33,54,5568.26,10708.07,0.00
2024-12-10 17:41:40,86,8372,32,54,5572.80,10708.36,0.00
2024-12-10 17:41:40,86,8373,32,54,5529.99,10709.00,0.00
2024-12-10 17:41:40,87,8373,33,54,5466.42,10709.01,0.00
2024-12-10 17:41:40,86,8373,33,53,5436.54,10709.44,0.00
2024-12-10 17:41:40,85,8373,33,52,5424.70,10709.76,0.00
2024-12-10 17:41:40,84,8373,32,52,5456.44,10709.86,0.00
2024-12-10 17:41:40,84,8374,32,52,5556.51,10710.00,0.00
2024-12-10 17:41:40,85,8374,32,53,5491.14,10710.01,0.00
2024-12-10 17:41:40,85,8375,32,53,5399.84,10711.00,0.00
2024-12-10 17:41:40,86,8375,32,54,5337.05,10711.01,0.00
2024-12-10 17:41:40,85,8375,31,54,5248.46,10711.74,0.00
2024-12-10 17:41:41,85,8376,31,54,5289.82,10712.00,0.00
2024-12-10 17:41:41,86,8376,31,55,5228.31,10712.01,0.00
2024-12-10 17:41:41,85,8376,31,54,5272.19,10712.07,0.00
2024-12-10 17:41:41,84,8376,31,53,5301.99,10712.30,0.00
2024-12-10 17:41:41,83,8376,31,52,5343.64,10712.42,0.00
2024-12-10 17:41:41,83,8377,31,52,5308.58,10713.00,0.00
2024-12-10 17:41:41,84,8377,32,52,5245.38,10713.01,0.00
2024-12-10 17:41:41,83,8377,32,51,5218.64,10713.16,0.00
2024-12-10 17:41:41,83,8378,32,51,5203.98,10714.00,0.00
2024-12-10 17:41:41,84,8378,33,51,5142.03,10714.01,0.00
2024-12-10 17:41:41,83,8378,33,50,5203.67,10714.01,0.00
2024-12-10 17:41:41,82,8378,33,49,5247.56,10714.10,0.00
2024-12-10 17:41:41,82,8379,33,49,5170.09,10715.00,0.00
2024-12-10 17:41:41,83,8379,34,49,5107.80,10715.01,0.00
2024-12-10 17:41:41,82,8379,33,49,5035.24,10715.46,0.00
2024-12-10 17:41:41,81,8379,33,48,5049.56,10715.62,0.00
2024-12-10 17:41:41,80,8379,32,48,5059.90,10715.94,0.00
2024-12-10 17:41:41,80,8380,32,48,5187.19,10716.00,0.00
2024-12-10 17:41:41,81,8380,33,48,5123.15,10716.01,0.00
2024-12-10 17:41:41,80,8380,33,47,5169.80,10716.10,0.00
2024-12-10 17:41:41,79,8380,32,47,5157.18,10716.56,0.00
2024-12-10 17:41:41,79,8381,32,47,5175.15,10717.00,0.00
2024-12-10 17:41:41,80,8381,33,47,5110.46,10717.01,0.00
2024-12-10 17:41:41,79,8381,32,47,5127.07,10717.20,0.00
2024-12-10 17:41:41,78,8381,31,47,5160.51,10717.33,0.00
2024-12-10 17:41:41,77,8381,30,47,5192.10,10717.53,0.00
2024-12-10 17:41:41,76,8381,29,47,5225.10,10717.82,0.00
2024-12-10 17:41:41,76,8382,29,47,5336.09,10718.00,0.00
2024-12-10 17:41:41,77,8382,29,48,5266.79,10718.01,0.00
2024-12-10 17:41:41,76,8382,29,47,5313.56,10718.13,0.00
2024-12-10 17:41:41,75,8382,28,47,5361.41,10718.29,0.00
2024-12-10 17:41:41,75,8383,28,47,5355.55,10719.00,0.00
2024-12-10 17:41:41,76,8383,28,48,5285.09,10719.01,0.00
2024-12-10 17:41:41,75,8383,28,47,5200.35,10719.85,0.00
2024-12-10 17:41:41,75,8384,28,47,5327.67,10720.00,0.00
2024-12-10 17:41:41,76,8384,28,48,5257.57,10720.01,0.00
2024-12-10 17:41:41,75,8384,27,48,5197.77,10720.47,0.00
2024-12-10 17:41:41,75,8385,27,48,5274.17,10721.00,0.00
2024-12-10 17:41:41,76,8385,28,48,5204.77,10721.01,0.00
2024-12-10 17:41:41,75,8385,28,47,5265.59,10721.01,0.00
2024-12-10 17:41:41,74,8385,27,47,5194.19,10721.76,0.00
2024-12-10 17:41:41,74,8386,27,47,5312.06,10722.00,0.00
2024-12-10 17:41:41,75,8386,28,47,5241.24,10722.01,0.00
2024-12-10 17:41:41,75,8387,28,47,5200.05,10723.00,0.00
2024-12-10 17:41:41,76,8387,28,48,5131.63,10723.01,0.00
2024-12-10 17:41:41,75,8387,28,47,5192.91,10723.07,0.00
2024-12-10 17:41:41,74,8387,27,47,5262.88,10723.07,0.00
2024-12-10 17:41:41,73,8387,27,46,5317.36,10723.12,0.00
2024-12-10 17:41:41,74,8386,27,47,5212.27,10723.46,0.00
2024-12-10 17:41:41,74,8387,27,47,5298.36,10724.00,0.00
2024-12-10 17:41:41,75,8387,27,48,5227.71,10724.01,0.00
2024-12-10 17:41:41,74,8387,26,48,5211.43,10724.15,0.00
2024-12-10 17:41:41,74,8388,26,48,5396.78,10725.00,0.00
2024-12-10 17:41:41,75,8388,26,49,5324.82,10725.01,0.00
2024-12-10 17:41:41,74,8388,26,48,5356.84,10725.13,0.00
2024-12-10 17:41:41,75,8387,26,49,5279.72,10725.21,0.00
2024-12-10 17:41:41,74,8387,25,49,5439.49,10725.23,0.00
2024-12-10 17:41:41,75,8386,25,50,5310.56,10725.72,0.00
2024-12-10 17:41:41,75,8387,25,50,5394.52,10726.00,0.00
2024-12-10 17:41:41,76,8387,26,50,5323.54,10726.01,0.00
2024-12-10 17:41:41,75,8387,25,50,5344.52,10726.21,0.00
2024-12-10 17:41:41,74,8387,24,50,5415.29,10726.22,0.00
2024-12-10 17:41:41,75,8386,24,51,5312.09,10726.51,0.00
2024-12-10 17:41:41,75,8387,24,51,5744.89,10727.00,0.00
2024-12-10 17:41:41,76,8387,24,52,5669.30,10727.01,0.00
2024-12-10 17:41:41,75,8387,23,52,5683.96,10727.31,0.00
2024-12-10 17:41:41,74,8387,22,52,5696.61,10727.53,0.00
2024-12-10 17:41:41,74,8388,22,52,5926.60,10728.00,0.00
2024-12-10 17:41:41,75,8388,22,53,5847.58,10728.01,0.00
2024-12-10 17:41:41,75,8389,22,53,5783.64,10729.00,0.00
2024-12-10 17:41:41,76,8389,23,53,5707.54,10729.01,0.00
2024-12-10 17:41:41,75,8389,23,52,5752.18,10729.13,0.00
2024-12-10 17:41:41,74,8389,23,51,5794.27,10729.43,0.00
2024-12-10 17:41:41,74,8390,23,51,5800.81,10730.00,0.00
2024-12-10 17:41:41,75,8390,24,51,5723.46,10730.01,0.00
2024-12-10 17:41:41,74,8390,23,51,5748.65,10730.23,0.00
2024-12-10 17:41:41,74,8391,23,51,5738.82,10731.00,0.00
2024-12-10 17:41:41,75,8391,23,52,5662.30,10731.01,0.00
2024-12-10 17:41:41,74,8391,23,51,5725.78,10731.12,0.00
2024-12-10 17:41:41,73,8391,23,50,5790.99,10731.14,0.00
2024-12-10 17:41:41,72,8391,22,50,5863.22,10731.21,0.00
2024-12-10 17:41:41,71,8391,21,50,5836.45,10731.83,0.00
2024-12-10 17:41:41,71,8392,21,50,5967.52,10732.00,0.00
2024-12-10 17:41:41,72,8392,22,50,5884.64,10732.01,0.00
2024-12-10 17:41:41,71,8392,22,49,5964.51,10732.03,0.00
2024-12-10 17:41:41,70,8392,21,49,5954.31,10732.33,0.00
2024-12-10 17:41:41,70,8393,21,49,6017.64,10733.00,0.00
2024-12-10 17:41:41,71,8393,21,50,5932.88,10733.01,0.00
2024-12-10 17:41:41,70,8393,21,49,6014.58,10733.03,0.00
2024-12-10 17:41:41,69,8393,21,48,6073.77,10733.14,0.00
2024-12-10 17:41:41,68,8393,20,48,6129.77,10733.35,0.00
2024-12-10 17:41:41,68,8394,20,48,6139.29,10734.00,0.00
2024-12-10 17:41:41,69,8394,20,49,6050.32,10734.01,0.00
2024-12-10 17:41:41,68,8394,19,49,6019.77,10734.47,0.00
2024-12-10 17:41:41,68,8394,19,49,6115.64,10735.00,0.00
2024-12-10 17:41:41,69,8394,19,50,6027.01,10735.01,0.00
2024-12-10 17:41:41,69,8395,19,50,5990.34,10736.00,0.00
2024-12-10 17:41:41,70,8395,20,50,5904.77,10736.01,0.00
2024-12-10 17:41:41,69,8395,20,49,5987.24,10736.03,0.00
2024-12-10 17:41:41,68,8395,19,49,5882.39,10736.96,0.00
2024-12-10 17:41:41,68,8396,19,49,6035.58,10737.00,0.00
2024-12-10 17:41:41,69,8396,19,50,5948.10,10737.01,0.00
2024-12-10 17:41:41,68,8396,19,49,6024.43,10737.10,0.00
2024-12-10 17:41:41,67,8396,19,48,6099.96,10737.21,0.00
2024-12-10 17:41:41,67,8397,19,48,6099.30,10738.00,0.00
2024-12-10 17:41:41,68,8397,19,49,6009.60,10738.01,0.00
2024-12-10 17:41:41,67,8397,19,48,6059.24,10738.09,0.00
2024-12-10 17:41:41,68,8396,20,48,5968.57,10738.13,0.00
2024-12-10 17:41:41,67,8396,20,47,6123.26,10738.49,0.00
2024-12-10 17:41:41,67,8397,20,47,6165.31,10739.00,0.00
2024-12-10 17:41:41,68,8397,20,48,6074.64,10739.01,0.00
2024-12-10 17:41:41,69,8396,20,49,5981.94,10739.09,0.00
2024-12-10 17:41:41,69,8397,20,49,6256.64,10740.00,0.00
2024-12-10 17:41:41,70,8397,21,49,6167.26,10740.01,0.00
2024-12-10 17:41:41,69,8397,20,49,6067.54,10740.93,0.00
2024-12-10 17:41:42,69,8398,20,49,6371.13,10741.00,0.00
2024-12-10 17:41:42,70,8398,20,50,6280.11,10741.01,0.00
2024-12-10 17:41:42,71,8397,20,51,6107.14,10741.46,0.00
2024-12-10 17:41:42,71,8398,20,51,6158.73,10742.00,0.00
2024-12-10 17:41:42,72,8398,21,51,6073.19,10742.01,0.00
2024-12-10 17:41:42,71,8398,21,50,6155.71,10742.03,0.00
2024-12-10 17:41:42,70,8398,21,49,6217.47,10742.13,0.00
2024-12-10 17:41:42,70,8398,21,49,6352.51,10743.00,0.00
2024-12-10 17:41:42,71,8398,22,49,6263.04,10743.01,0.00
2024-12-10 17:41:42,70,8398,21,49,6349.45,10743.03,0.00
2024-12-10 17:41:42,69,8398,21,48,6404.64,10743.09,0.00
2024-12-10 17:41:42,68,8398,21,47,6487.80,10743.18,0.00
2024-12-10 17:41:42,68,8399,21,47,6474.78,10744.00,0.00
2024-12-10 17:41:42,69,8399,22,47,6380.94,10744.01,0.00
2024-12-10 17:41:42,68,8399,22,46,6444.87,10744.12,0.00
2024-12-10 17:41:42,68,8400,22,46,6417.71,10745.00,0.00
2024-12-10 17:41:42,69,8400,22,47,6324.70,10745.01,0.00
2024-12-10 17:41:42,68,8400,21,47,6350.48,10745.16,0.00
2024-12-10 17:41:42,67,8400,21,46,6404.41,10745.24,0.00
2024-12-10 17:41:42,67,8401,21,46,6460.91,10746.00,0.00
2024-12-10 17:41:42,68,8401,22,46,6365.89,10746.01,0.00
2024-12-10 17:41:42,67,8401,22,45,6456.11,10746.04,0.00
2024-12-10 17:41:42,66,8401,21,45,6525.80,10746.11,0.00
2024-12-10 17:41:42,65,8401,21,44,6588.19,10746.14,0.00
2024-12-10 17:41:42,65,8402,21,44,6634.57,10747.00,0.00
2024-12-10 17:41:42,66,8402,22,44,6534.05,10747.02,0.00
2024-12-10 17:41:42,66,8403,22,44,6480.93,10748.00,0.00
2024-12-10 17:41:42,67,8403,22,45,6384.20,10748.01,0.00
2024-12-10 17:41:42,66,8403,22,44,6433.77,10748.14,0.00
2024-12-10 17:41:42,66,8404,22,44,6406.79,10749.00,0.00
2024-12-10 17:41:42,67,8404,22,45,6311.16,10749.01,0.00
2024-12-10 17:41:42,67,8405,22,45,6274.92,10750.00,0.00
2024-12-10 17:41:42,68,8405,23,45,6182.64,10750.01,0.00
2024-12-10 17:41:42,69,8404,24,45,5955.21,10750.78,0.00
2024-12-10 17:41:42,68,8404,23,45,6000.15,10750.90,0.00
2024-12-10 17:41:42,68,8405,23,45,6147.26,10751.00,0.00
2024-12-10 17:41:42,69,8405,23,46,6058.17,10751.01,0.00
2024-12-10 17:41:42,68,8405,23,45,6139.40,10751.07,0.00
2024-12-10 17:41:42,67,8405,23,44,6201.58,10751.12,0.00
2024-12-10 17:41:42,67,8406,23,44,6320.97,10752.00,0.00
2024-12-10 17:41:42,68,8406,23,45,6228.02,10752.01,0.00
2024-12-10 17:41:42,67,8406,23,44,6262.98,10752.24,0.00
2024-12-10 17:41:42,66,8406,22,44,6295.70,10752.38,0.00
2024-12-10 17:41:42,65,8406,22,43,6361.33,10752.62,0.00
2024-12-10 17:41:42,64,8406,22,42,6455.63,10752.63,0.00
2024-12-10 17:41:42,64,8407,22,42,6580.93,10753.00,0.00
2024-12-10 17:41:42,65,8407,23,42,6479.68,10753.02,0.00
2024-12-10 17:41:42,64,8407,23,41,6535.63,10753.14,0.00
2024-12-10 17:41:42,63,8407,22,41,6590.05,10753.59,0.00
2024-12-10 17:41:42,63,8408,22,41,6641.84,10754.00,0.00
2024-12-10 17:41:42,64,8408,22,42,6538.06,10754.02,0.00
2024-12-10 17:41:42,64,8409,22,42,6500.33,10755.00,0.00
2024-12-10 17:41:42,65,8409,22,43,6400.33,10755.02,0.00
2024-12-10 17:41:42,66,8408,23,43,6248.04,10755.26,0.00
2024-12-10 17:41:42,65,8408,22,43,6286.21,10755.48,0.00
2024-12-10 17:41:42,65,8409,22,43,6380.36,10756.00,0.00
2024-12-10 17:41:42,66,8409,23,43,6283.69,10756.02,0.00
2024-12-10 17:41:42,65,8409,23,42,6362.22,10756.17,0.00
2024-12-10 17:41:42,64,8409,22,42,6412.99,10756.34,0.00
2024-12-10 17:41:42,64,8410,22,42,6661.28,10757.00,0.00
2024-12-10 17:41:42,65,8410,22,43,6558.80,10757.02,0.00
2024-12-10 17:41:42,64,8410,21,43,6646.22,10757.16,0.00
2024-12-10 17:41:42,64,8411,21,43,6676.16,10758.00,0.00
2024-12-10 17:41:42,65,8411,22,43,6573.45,10758.02,0.00
2024-12-10 17:41:42,64,8411,21,43,6661.04,10758.02,0.00
2024-12-10 17:41:42,64,8412,21,43,6675.45,10759.00,0.00
2024-12-10 17:41:42,65,8412,22,43,6572.75,10759.02,0.00
2024-12-10 17:41:42,66,8411,22,44,6359.21,10759.74,0.00
2024-12-10 17:41:42,65,8411,21,44,6545.11,10759.80,0.00
2024-12-10 17:41:42,65,8412,21,44,6615.93,10760.00,0.00
2024-12-10 17:41:42,66,8412,21,45,6515.69,10760.02,0.00
2024-12-10 17:41:42,65,8412,21,44,6597.79,10760.17,0.00
2024-12-10 17:41:42,65,8413,21,44,6753.73,10761.00,0.00
2024-12-10 17:41:42,66,8413,21,45,6651.40,10761.02,0.00
2024-12-10 17:41:42,66,8414,21,45,6633.10,10762.00,0.00
2024-12-10 17:41:42,67,8414,21,46,6534.10,10762.01,0.00
2024-12-10 17:41:42,67,8415,21,46,6481.53,10763.00,0.00
2024-12-10 17:41:42,68,8415,21,47,6386.21,10763.01,0.00
2024-12-10 17:41:42,67,8415,20,47,6358.84,10763.64,0.00
2024-12-10 17:41:42,66,8415,19,47,6417.65,10763.77,0.00
2024-12-10 17:41:42,66,8416,19,47,6530.87,10764.00,0.00
2024-12-10 17:41:42,67,8416,20,47,6433.39,10764.01,0.00
2024-12-10 17:41:42,68,8415,21,47,6139.83,10764.72,0.00
2024-12-10 17:41:42,68,8416,21,47,6237.51,10765.00,0.00
2024-12-10 17:41:42,69,8416,21,48,6147.11,10765.01,0.00
2024-12-10 17:41:42,68,8416,21,47,6204.32,10765.16,0.00
2024-12-10 17:41:42,69,8415,21,48,6080.01,10765.46,0.00
2024-12-10 17:41:42,69,8416,21,48,6246.56,10766.00,0.00
2024-12-10 17:41:42,70,8416,22,48,6157.32,10766.01,0.00
2024-12-10 17:41:42,69,8416,21,48,6116.84,10766.46,0.00
2024-12-10 17:41:42,69,8417,21,48,6303.29,10767.00,0.00
2024-12-10 17:41:42,70,8417,22,48,6213.24,10767.01,0.00
2024-12-10 17:41:42,69,8417,22,47,6251.86,10767.19,0.00
2024-12-10 17:41:42,68,8417,21,47,6312.25,10767.44,0.00
2024-12-10 17:41:42,67,8417,21,46,6378.91,10767.57,0.00
2024-12-10 17:41:42,67,8418,21,46,6387.99,10768.00,0.00
2024-12-10 17:41:42,68,8418,22,46,6294.05,10768.01,0.00
2024-12-10 17:41:42,68,8419,22,46,6204.06,10769.00,0.00
2024-12-10 17:41:42,69,8419,22,47,6114.14,10769.01,0.00
2024-12-10 17:41:42,68,8419,22,46,6153.44,10769.19,0.00
2024-12-10 17:41:42,69,8418,23,46,6058.04,10769.28,0.00
2024-12-10 17:41:42,70,8417,23,47,6082.23,10769.51,0.00
2024-12-10 17:41:42,69,8417,23,46,6163.22,10769.65,0.00
2024-12-10 17:41:42,69,8418,23,46,6200.28,10770.00,0.00
2024-12-10 17:41:42,70,8418,24,46,6111.70,10770.01,0.00
2024-12-10 17:41:42,69,8418,23,46,6161.35,10770.26,0.00
2024-12-10 17:41:42,69,8419,23,46,6503.93,10771.00,0.00
2024-12-10 17:41:42,70,8419,23,47,6411.01,10771.01,0.00
2024-12-10 17:41:42,70,8420,23,47,6354.10,10772.00,0.00
2024-12-10 17:41:42,71,8420,24,47,6264.60,10772.01,0.00
2024-12-10 17:41:42,70,8420,24,46,6317.25,10772.26,0.00
2024-12-10 17:41:43,70,8421,24,46,6308.43,10773.00,0.00
2024-12-10 17:41:43,71,8421,24,47,6219.58,10773.01,0.00
2024-12-10 17:41:43,70,8421,24,46,6302.30,10773.06,0.00
2024-12-10 17:41:43,70,8422,24,46,6250.83,10774.00,0.00
2024-12-10 17:41:43,71,8422,25,46,6162.79,10774.01,0.00
2024-12-10 17:41:43,70,8422,24,46,6023.88,10774.89,0.00
2024-12-10 17:41:43,70,8423,24,46,6165.57,10775.00,0.00
2024-12-10 17:41:43,71,8423,25,46,6078.73,10775.01,0.00
2024-12-10 17:41:43,70,8423,25,45,6124.10,10775.27,0.00
2024-12-10 17:41:43,70,8424,25,45,6084.38,10776.00,0.00
2024-12-10 17:41:43,71,8424,25,46,5998.69,10776.01,0.00
2024-12-10 17:41:43,70,8424,24,46,6032.10,10776.21,0.00
2024-12-10 17:41:43,70,8425,24,46,5989.97,10777.00,0.00
2024-12-10 17:41:43,71,8425,24,47,5905.60,10777.01,0.00
2024-12-10 17:41:43,70,8425,24,46,5977.69,10777.11,0.00
2024-12-10 17:41:43,69,8425,24,45,6034.66,10777.17,0.00
2024-12-10 17:41:43,70,8424,25,45,5916.05,10777.47,0.00
2024-12-10 17:41:43,69,8424,25,44,5996.63,10777.75,0.00
2024-12-10 17:41:43,69,8425,25,44,6028.65,10778.00,0.00
2024-12-10 17:41:43,70,8425,26,44,5942.52,10778.01,0.00
2024-12-10 17:41:43,69,8425,25,44,5792.25,10778.96,0.00
2024-12-10 17:41:43,69,8426,25,44,6100.02,10779.00,0.00
2024-12-10 17:41:43,70,8426,26,44,6012.87,10779.01,0.00
2024-12-10 17:41:43,69,8426,26,43,6064.12,10779.10,0.00
2024-12-10 17:41:43,68,8426,26,42,6068.91,10779.69,0.00
2024-12-10 17:41:43,68,8427,26,42,6096.06,10780.00,0.00
2024-12-10 17:41:43,69,8427,26,43,6007.71,10780.01,0.00
2024-12-10 17:41:43,68,8427,26,42,6064.40,10780.15,0.00
2024-12-10 17:41:43,67,8427,26,41,6124.68,10780.42,0.00
2024-12-10 17:41:43,67,8428,26,41,6111.09,10781.00,0.00
2024-12-10 17:41:43,68,8428,26,42,6021.23,10781.01,0.00
2024-12-10 17:41:43,67,8428,25,42,6103.08,10781.07,0.00
2024-12-10 17:41:43,66,8428,24,42,6077.29,10781.71,0.00
2024-12-10 17:41:43,65,8428,24,41,6149.55,10781.74,0.00
2024-12-10 17:41:43,65,8429,24,41,6236.84,10782.00,0.00
2024-12-10 17:41:43,66,8429,25,41,6142.34,10782.02,0.00
2024-12-10 17:41:43,66,8429,25,41,6092.30,10783.00,0.00
2024-12-10 17:41:43,67,8429,26,41,6001.37,10783.01,0.00
2024-12-10 17:41:43,67,8430,26,41,5924.99,10784.00,0.00
2024-12-10 17:41:43,68,8430,27,41,5837.86,10784.01,0.00
2024-12-10 17:41:43,67,8430,27,40,5920.17,10784.03,0.00
2024-12-10 17:41:43,67,8431,27,40,5877.76,10785.00,0.00
2024-12-10 17:41:43,68,8431,27,41,5791.32,10785.01,0.00
2024-12-10 17:41:43,67,8431,26,41,5765.93,10785.57,0.00
2024-12-10 17:41:43,67,8432,26,41,5823.15,10786.00,0.00
2024-12-10 17:41:43,68,8432,27,41,5737.52,10786.01,0.00
2024-12-10 17:41:43,67,8432,27,40,5782.96,10786.16,0.00
2024-12-10 17:41:43,66,8432,26,40,5792.72,10786.71,0.00
2024-12-10 17:41:43,66,8433,26,40,5922.00,10787.00,0.00
2024-12-10 17:41:43,67,8433,26,41,5833.61,10787.01,0.00
2024-12-10 17:41:43,66,8433,26,40,5877.92,10787.17,0.00
2024-12-10 17:41:43,65,8433,25,40,5842.24,10787.89,0.00
2024-12-10 17:41:43,65,8434,25,40,5996.67,10788.00,0.00
2024-12-10 17:41:43,66,8434,26,40,5905.81,10788.02,0.00
2024-12-10 17:41:43,65,8434,26,39,5836.88,10788.65,0.00
2024-12-10 17:41:43,65,8435,26,39,5958.12,10789.00,0.00
2024-12-10 17:41:43,66,8435,27,39,5867.85,10789.02,0.00
2024-12-10 17:41:43,65,8435,27,38,5911.64,10789.18,0.00
2024-12-10 17:41:43,66,8434,27,39,5786.03,10789.50,0.00
2024-12-10 17:41:43,66,8435,27,39,5906.76,10790.00,0.00
2024-12-10 17:41:43,67,8435,28,39,5818.60,10790.01,0.00
2024-12-10 17:41:43,66,8435,27,39,5898.90,10790.06,0.00
2024-12-10 17:41:43,65,8435,26,39,5922.31,10790.35,0.00
2024-12-10 17:41:43,64,8435,25,39,5968.42,10790.70,0.00
2024-12-10 17:41:43,64,8436,25,39,6212.96,10791.00,0.00
2024-12-10 17:41:43,65,8436,25,40,6117.37,10791.02,0.00
2024-12-10 17:41:43,64,8436,25,39,6173.92,10791.19,0.00
2024-12-10 17:41:43,64,8437,25,39,6180.82,10792.00,0.00
2024-12-10 17:41:43,65,8437,25,40,6085.73,10792.02,0.00
2024-12-10 17:41:43,65,8438,25,40,6037.05,10793.00,0.00
2024-12-10 17:41:43,66,8438,26,40,5945.58,10793.02,0.00
2024-12-10 17:41:43,65,8438,26,39,6009.62,10793.05,0.00
2024-12-10 17:41:43,64,8438,25,39,6020.35,10793.72,0.00
2024-12-10 17:41:43,64,8439,25,39,6158.85,10794.00,0.00
2024-12-10 17:41:43,65,8439,25,40,6064.10,10794.02,0.00
2024-12-10 17:41:43,65,8440,25,40,6050.24,10795.00,0.00
2024-12-10 17:41:43,66,8440,25,41,5958.57,10795.02,0.00
2024-12-10 17:41:43,66,8441,25,41,5921.04,10796.00,0.00
2024-12-10 17:41:43,67,8441,26,41,5832.67,10796.01,0.00
2024-12-10 17:41:43,66,8441,26,40,5869.67,10796.17,0.00
2024-12-10 17:41:43,65,8441,25,40,5869.07,10796.92,0.00
2024-12-10 17:41:43,65,8442,25,40,6026.94,10797.00,0.00
2024-12-10 17:41:43,66,8442,26,40,5935.62,10797.02,0.00
2024-12-10 17:41:43,67,8441,26,41,5768.67,10797.42,0.00
2024-12-10 17:41:43,66,8441,25,41,5844.65,10797.62,0.00
2024-12-10 17:41:43,66,8442,25,41,5910.84,10798.00,0.00
2024-12-10 17:41:43,67,8442,25,42,5822.62,10798.01,0.00
2024-12-10 17:41:43,66,8442,25,41,5865.86,10798.17,0.00
2024-12-10 17:41:43,67,8441,26,41,5702.99,10798.90,0.00
2024-12-10 17:41:43,67,8442,26,41,5959.34,10799.00,0.00
2024-12-10 17:41:43,68,8442,26,42,5871.70,10799.01,0.00
2024-12-10 17:41:43,67,8442,26,41,5949.19,10799.04,0.00
2024-12-10 17:41:43,67,8443,26,41,6083.12,10800.00,0.00
2024-12-10 17:41:43,68,8443,27,41,5993.67,10800.01,0.00
2024-12-10 17:41:43,67,8443,27,40,6041.91,10800.15,0.00
2024-12-10 17:41:43,66,8443,26,40,6102.82,10800.26,0.00
2024-12-10 17:41:43,67,8442,26,41,5951.30,10800.84,0.00
2024-12-10 17:41:43,67,8443,26,41,6111.04,10801.00,0.00
2024-12-10 17:41:43,68,8443,26,42,6021.18,10801.01,0.00
2024-12-10 17:41:43,68,8444,26,42,6133.29,10802.00,0.00
2024-12-10 17:41:43,69,8444,27,42,6044.40,10802.01,0.00
2024-12-10 17:41:43,68,8444,27,41,6129.88,10802.01,0.00
2024-12-10 17:41:43,69,8443,28,41,6028.54,10802.16,0.00
2024-12-10 17:41:43,68,8443,28,40,6201.40,10802.16,0.00
2024-12-10 17:41:43,67,8443,27,40,6256.65,10802.28,0.00
2024-12-10 17:41:44,67,8444,27,40,6325.97,10803.00,0.00
2024-12-10 17:41:44,68,8444,28,40,6232.94,10803.01,0.00
2024-12-10 17:41:44,69,8443,29,40,6141.05,10803.06,0.00
2024-12-10 17:41:44,69,8444,29,40,6450.72,10804.00,0.00
2024-12-10 17:41:44,70,8444,29,41,6358.57,10804.01,0.00
2024-12-10 17:41:44,71,8443,30,41,6194.62,10804.45,0.00
2024-12-10 17:41:44,72,8442,30,42,6151.49,10804.82,0.00
2024-12-10 17:41:44,72,8443,30,42,6431.56,10805.00,0.00
2024-12-10 17:41:44,73,8443,31,42,6343.46,10805.01,0.00
2024-12-10 17:41:44,74,8442,32,42,6186.24,10805.43,0.00
2024-12-10 17:41:44,74,8443,32,42,6544.62,10806.00,0.00
2024-12-10 17:41:44,75,8443,32,43,6457.36,10806.01,0.00
2024-12-10 17:41:44,74,8443,31,43,6511.04,10806.04,0.00
2024-12-10 17:41:44,74,8444,31,43,6665.31,10807.00,0.00
2024-12-10 17:41:44,75,8444,32,43,6576.44,10807.01,0.00
2024-12-10 17:41:44,75,8445,32,43,6528.05,10808.00,0.00
2024-12-10 17:41:44,76,8445,33,43,6442.15,10808.01,0.00
2024-12-10 17:41:44,75,8445,33,42,6503.56,10808.03,0.00
2024-12-10 17:41:44,75,8446,33,42,6475.22,10809.00,0.00
2024-12-10 17:41:44,76,8446,33,43,6390.02,10809.01,0.00
2024-12-10 17:41:44,75,8446,33,42,6455.05,10809.05,0.00
2024-12-10 17:41:44,75,8446,33,42,6425.42,10810.00,0.00
2024-12-10 17:41:44,76,8446,34,42,6340.88,10810.01,0.00
2024-12-10 17:41:44,76,8447,34,42,6320.77,10811.00,0.00
2024-12-10 17:41:44,77,8447,34,43,6238.68,10811.01,0.00
2024-12-10 17:41:44,77,8448,34,43,6202.28,10812.00,0.00
2024-12-10 17:41:44,78,8448,34,44,6122.76,10812.01,0.00
2024-12-10 17:41:44,77,8448,34,43,6199.48,10812.03,0.00
2024-12-10 17:41:44,77,8449,34,43,6144.10,10813.00,0.00
2024-12-10 17:41:44,78,8449,34,44,6065.33,10813.01,0.00
2024-12-10 17:41:44,77,8449,34,43,6124.45,10813.06,0.00
2024-12-10 17:41:44,77,8450,34,43,6096.41,10814.00,0.00
2024-12-10 17:41:44,78,8450,35,43,6018.26,10814.01,0.00
2024-12-10 17:41:44,78,8451,35,43,5969.79,10815.00,0.00
2024-12-10 17:41:44,79,8451,36,43,5894.22,10815.01,0.00
2024-12-10 17:41:44,78,8451,35,43,5964.38,10815.03,0.00
2024-12-10 17:41:44,77,8451,34,43,6001.61,10815.13,0.00
2024-12-10 17:41:44,78,8450,34,44,5800.68,10815.99,0.00
2024-12-10 17:41:44,78,8451,34,44,5939.36,10816.00,0.00
2024-12-10 17:41:44,79,8451,35,44,5864.18,10816.01,0.00
2024-12-10 17:41:44,78,8451,35,43,5915.79,10816.05,0.00
2024-12-10 17:41:44,78,8452,35,43,5993.49,10817.00,0.00
2024-12-10 17:41:44,79,8452,35,44,5917.63,10817.01,0.00
2024-12-10 17:41:44,80,8451,35,45,5787.56,10817.29,0.00
2024-12-10 17:41:44,80,8452,35,45,5822.89,10818.00,0.00
2024-12-10 17:41:44,81,8452,35,46,5751.00,10818.01,0.00
2024-12-10 17:41:44,80,8452,35,45,5817.49,10818.05,0.00
2024-12-10 17:41:44,79,8452,34,45,5742.23,10818.62,0.00
2024-12-10 17:41:44,79,8453,34,45,5961.26,10819.00,0.00
2024-12-10 17:41:44,80,8453,34,46,5886.74,10819.01,0.00
2024-12-10 17:41:44,79,8453,34,45,5927.02,10819.06,0.00
2024-12-10 17:41:44,78,8453,33,45,5986.66,10819.19,0.00
2024-12-10 17:41:44,77,8453,32,45,5994.61,10819.42,0.00
2024-12-10 17:41:44,76,8453,31,45,6058.25,10819.55,0.00
2024-12-10 17:41:44,76,8454,31,45,6121.95,10820.00,0.00
2024-12-10 17:41:44,77,8454,32,45,6042.44,10820.01,0.00
2024-12-10 17:41:44,76,8454,31,45,6070.85,10820.20,0.00
2024-12-10 17:41:44,77,8453,32,45,5990.61,10820.23,0.00
2024-12-10 17:41:44,77,8454,32,45,6041.81,10821.00,0.00
2024-12-10 17:41:44,78,8454,33,45,5964.35,10821.01,0.00
2024-12-10 17:41:44,79,8453,34,45,5757.74,10821.63,0.00
2024-12-10 17:41:44,79,8454,34,45,5949.56,10822.00,0.00
2024-12-10 17:41:44,80,8454,34,46,5875.19,10822.01,0.00
2024-12-10 17:41:44,79,8454,34,45,5926.06,10822.06,0.00
2024-12-10 17:41:44,78,8454,34,44,5918.65,10822.53,0.00
2024-12-10 17:41:44,79,8453,34,45,5803.44,10822.77,0.00
2024-12-10 17:41:44,79,8454,34,45,6061.19,10823.00,0.00
2024-12-10 17:41:44,80,8454,35,45,5985.42,10823.01,0.00
2024-12-10 17:41:44,81,8453,35,46,5869.08,10823.16,0.00
2024-12-10 17:41:44,80,8453,34,46,5914.23,10823.63,0.00
2024-12-10 17:41:44,80,8454,34,46,6123.27,10824.00,0.00
2024-12-10 17:41:44,81,8454,34,47,6047.68,10824.01,0.00
2024-12-10 17:41:44,80,8454,34,46,6120.57,10824.03,0.00
2024-12-10 17:41:44,79,8454,34,45,6186.29,10824.05,0.00
2024-12-10 17:41:44,78,8454,33,45,6171.17,10824.44,0.00
2024-12-10 17:41:44,78,8455,33,45,6369.67,10825.00,0.00
2024-12-10 17:41:44,79,8455,33,46,6289.04,10825.01,0.00
2024-12-10 17:41:44,78,8455,33,45,6366.89,10825.03,0.00
2024-12-10 17:41:44,77,8455,33,44,6443.37,10825.04,0.00
2024-12-10 17:41:44,76,8455,32,44,6447.84,10825.63,0.00
2024-12-10 17:41:44,76,8456,32,44,6480.55,10826.00,0.00
2024-12-10 17:41:44,77,8456,33,44,6396.39,10826.01,0.00
2024-12-10 17:41:44,77,8457,33,44,6316.04,10827.00,0.00
2024-12-10 17:41:44,78,8457,34,44,6235.06,10827.01,0.00
2024-12-10 17:41:44,77,8457,34,43,6306.30,10827.04,0.00
2024-12-10 17:41:44,76,8457,33,43,6375.10,10827.17,0.00
2024-12-10 17:41:44,76,8458,33,43,6347.66,10828.00,0.00
2024-12-10 17:41:44,77,8458,33,44,6265.23,10828.01,0.00
2024-12-10 17:41:44,78,8457,34,44,6096.12,10828.42,0.00
2024-12-10 17:41:44,78,8458,34,44,6213.12,10829.00,0.00
2024-12-10 17:41:44,79,8458,35,44,6134.48,10829.01,0.00
2024-12-10 17:41:44,78,8458,34,44,6166.02,10829.05,0.00
2024-12-10 17:41:44,78,8459,34,44,6314.38,10830.00,0.00
2024-12-10 17:41:44,79,8459,34,45,6234.46,10830.01,0.00
2024-12-10 17:41:44,80,8458,34,46,6084.94,10830.45,0.00
2024-12-10 17:41:44,81,8457,34,47,6078.30,10830.63,0.00
2024-12-10 17:41:44,81,8458,34,47,6149.78,10831.00,0.00
2024-12-10 17:41:44,82,8458,34,48,6074.78,10831.01,0.00
2024-12-10 17:41:44,81,8458,34,47,6137.75,10831.04,0.00
2024-12-10 17:41:44,81,8459,34,47,6347.87,10832.00,0.00
2024-12-10 17:41:44,82,8459,34,48,6270.45,10832.01,0.00
2024-12-10 17:41:44,81,8459,33,48,6183.40,10832.95,0.00
2024-12-10 17:41:44,81,8460,33,48,6299.97,10833.00,0.00
2024-12-10 17:41:44,82,8460,34,48,6223.14,10833.01,0.00
2024-12-10 17:41:44,81,8460,34,47,6294.62,10833.04,0.00
2024-12-10 17:41:44,80,8460,33,47,6339.46,10833.05,0.00
2024-12-10 17:41:45,80,8461,33,47,6356.43,10834.00,0.00
2024-12-10 17:41:45,81,8461,34,47,6277.95,10834.01,0.00
2024-12-10 17:41:45,80,8461,33,47,6305.04,10834.20,0.00
2024-12-10 17:41:45,79,8461,32,47,6328.69,10834.66,0.00
2024-12-10 17:41:45,79,8462,32,47,6414.12,10835.00,0.00
2024-12-10 17:41:45,80,8462,32,48,6333.95,10835.01,0.00
2024-12-10 17:41:45,80,8463,32,48,6313.09,10836.00,0.00
2024-12-10 17:41:45,81,8463,32,49,6235.15,10836.01,0.00
2024-12-10 17:41:45,81,8464,32,49,6185.57,10837.00,0.00
2024-12-10 17:41:45,82,8464,32,50,6110.14,10837.01,0.00
2024-12-10 17:41:45,82,8465,32,50,6030.09,10838.00,0.00
2024-12-10 17:41:45,83,8465,33,50,5957.43,10838.01,0.00
2024-12-10 17:41:45,82,8465,32,50,6028.76,10838.01,0.00
2024-12-10 17:41:45,81,8465,31,50,6101.85,10838.01,0.00
2024-12-10 17:41:45,80,8465,31,49,6170.00,10838.01,0.00
2024-12-10 17:41:45,79,8465,30,49,6139.99,10838.72,0.00
2024-12-10 17:41:45,78,8465,29,49,6165.45,10838.96,0.00
2024-12-10 17:41:45,78,8466,29,49,6300.27,10839.00,0.00
2024-12-10 17:41:45,79,8466,29,50,6220.52,10839.01,0.00
2024-12-10 17:41:45,78,8466,29,49,6273.87,10839.01,0.00
2024-12-10 17:41:45,77,8466,28,49,6339.91,10839.16,0.00
2024-12-10 17:41:45,76,8466,28,48,6375.50,10839.33,0.00
2024-12-10 17:41:45,76,8467,28,48,6423.63,10840.00,0.00
2024-12-10 17:41:45,77,8467,28,49,6340.20,10840.01,0.00
2024-12-10 17:41:45,76,8467,27,49,6344.64,10840.32,0.00
2024-12-10 17:41:45,76,8468,27,49,6383.73,10841.00,0.00
2024-12-10 17:41:45,77,8468,28,49,6300.83,10841.01,0.00
2024-12-10 17:41:45,77,8469,28,49,6228.23,10842.00,0.00
2024-12-10 17:41:45,78,8469,28,50,6148.38,10842.01,0.00
2024-12-10 17:41:45,77,8469,28,49,6071.83,10842.86,0.00
2024-12-10 17:41:45,77,8470,28,49,6140.95,10843.00,0.00
2024-12-10 17:41:45,78,8470,28,50,6062.22,10843.01,0.00
2024-12-10 17:41:45,77,8470,28,49,6136.57,10843.03,0.00
2024-12-10 17:41:45,76,8470,27,49,6194.18,10843.24,0.00
2024-12-10 17:41:45,77,8469,27,50,6109.53,10843.30,0.00
2024-12-10 17:41:45,77,8470,27,50,6172.57,10844.00,0.00
2024-12-10 17:41:45,78,8470,28,50,6093.43,10844.01,0.00
2024-12-10 17:41:45,77,8470,27,50,6127.55,10844.17,0.00
2024-12-10 17:41:45,78,8469,28,50,5902.16,10844.95,0.00
2024-12-10 17:41:45,78,8470,28,50,6178.70,10845.00,0.00
2024-12-10 17:41:45,79,8470,28,51,6100.48,10845.01,0.00
2024-12-10 17:41:45,78,8470,28,50,6153.89,10845.04,0.00
2024-12-10 17:41:45,78,8471,28,50,6250.35,10846.00,0.00
2024-12-10 17:41:45,79,8471,29,50,6171.23,10846.01,0.00
2024-12-10 17:41:45,78,8471,28,50,6203.12,10846.18,0.00
2024-12-10 17:41:45,78,8472,28,50,6172.84,10847.00,0.00
2024-12-10 17:41:45,79,8472,29,50,6094.70,10847.01,0.00
2024-12-10 17:41:45,78,8472,29,49,6167.41,10847.05,0.00
2024-12-10 17:41:45,78,8473,29,49,6120.69,10848.00,0.00
2024-12-10 17:41:45,79,8473,29,50,6043.22,10848.01,0.00
2024-12-10 17:41:45,78,8473,28,50,6052.56,10848.06,0.00
2024-12-10 17:41:45,77,8473,27,50,6082.24,10848.36,0.00
2024-12-10 17:41:45,76,8473,26,50,6134.37,10848.59,0.00
2024-12-10 17:41:45,76,8474,26,50,6218.97,10849.00,0.00
2024-12-10 17:41:45,77,8474,27,50,6138.21,10849.01,0.00
2024-12-10 17:41:45,76,8474,27,49,6150.74,10849.29,0.00
2024-12-10 17:41:45,75,8474,26,49,6215.43,10849.43,0.00
2024-12-10 17:41:45,76,8473,26,50,6059.35,10849.93,0.00
2024-12-10 17:41:45,76,8474,26,50,6200.75,10850.00,0.00
2024-12-10 17:41:45,77,8474,27,50,6120.22,10850.01,0.00
2024-12-10 17:41:45,76,8474,27,49,6159.38,10850.16,0.00
2024-12-10 17:41:45,75,8474,26,49,6220.37,10850.29,0.00
2024-12-10 17:41:45,75,8475,26,49,6347.03,10851.00,0.00
2024-12-10 17:41:45,76,8475,27,49,6263.52,10851.01,0.00
2024-12-10 17:41:45,75,8475,27,48,6341.25,10851.05,0.00
2024-12-10 17:41:45,74,8475,27,47,6327.09,10851.55,0.00
2024-12-10 17:41:45,74,8475,27,47,6361.68,10852.00,0.00
2024-12-10 17:41:45,75,8475,28,47,6276.86,10852.01,0.00
2024-12-10 17:41:45,76,8474,28,48,6110.24,10852.43,0.00
2024-12-10 17:41:45,76,8475,28,48,6136.67,10853.00,0.00
2024-12-10 17:41:45,77,8475,29,48,6056.97,10853.01,0.00
2024-12-10 17:41:45,76,8475,29,47,6111.00,10853.14,0.00
2024-12-10 17:41:45,75,8475,28,47,6140.33,10853.51,0.00
2024-12-10 17:41:45,75,8476,28,47,6247.11,10854.00,0.00
2024-12-10 17:41:45,76,8476,29,47,6164.91,10854.01,0.00
2024-12-10 17:41:45,77,8475,29,48,6070.78,10854.17,0.00
2024-12-10 17:41:45,76,8475,28,48,6119.89,10854.59,0.00
2024-12-10 17:41:45,75,8475,27,48,6200.15,10854.60,0.00
2024-12-10 17:41:45,74,8475,27,47,6262.24,10854.61,0.00
2024-12-10 17:41:45,73,8475,26,47,6325.30,10854.78,0.00
2024-12-10 17:41:45,73,8476,26,47,6422.23,10855.00,0.00
2024-12-10 17:41:45,74,8476,26,48,6335.44,10855.01,0.00
2024-12-10 17:41:45,74,8477,26,48,6452.82,10856.00,0.00
2024-12-10 17:41:45,75,8477,27,48,6366.78,10856.01,0.00
2024-12-10 17:41:45,75,8478,27,48,6335.09,10857.00,0.00
2024-12-10 17:41:45,76,8478,27,49,6251.74,10857.01,0.00
2024-12-10 17:41:45,76,8479,27,49,6210.46,10858.00,0.00
2024-12-10 17:41:45,77,8479,28,49,6129.80,10858.01,0.00
2024-12-10 17:41:45,76,8479,27,49,6160.50,10858.20,0.00
2024-12-10 17:41:45,76,8480,27,49,6150.98,10859.00,0.00
2024-12-10 17:41:45,77,8480,27,50,6071.09,10859.01,0.00
2024-12-10 17:41:45,78,8479,28,50,5979.36,10859.17,0.00
2024-12-10 17:41:45,78,8480,28,50,6062.43,10860.00,0.00
2024-12-10 17:41:45,79,8480,29,50,5985.69,10860.01,0.00
2024-12-10 17:41:45,78,8480,29,49,6061.04,10860.01,0.00
2024-12-10 17:41:45,78,8481,29,49,6170.67,10861.00,0.00
2024-12-10 17:41:45,79,8481,29,50,6092.56,10861.01,0.00
2024-12-10 17:41:45,79,8482,29,50,6060.91,10862.00,0.00
2024-12-10 17:41:45,80,8482,30,50,5985.15,10862.01,0.00
2024-12-10 17:41:45,79,8482,29,50,5914.57,10862.92,0.00
2024-12-10 17:41:45,79,8483,29,50,6014.23,10863.00,0.00
2024-12-10 17:41:45,80,8483,30,50,5939.05,10863.01,0.00
2024-12-10 17:41:45,80,8484,30,50,5874.76,10864.00,0.00
2024-12-10 17:41:45,81,8484,30,51,5802.24,10864.01,0.00
2024-12-10 17:41:45,82,8483,31,51,5719.57,10864.15,0.00
2024-12-10 17:41:45,82,8484,31,51,5793.32,10865.00,0.00
2024-12-10 17:41:45,83,8484,32,51,5723.52,10865.01,0.00
2024-12-10 17:41:46,83,8485,32,51,5822.04,10866.00,0.00
2024-12-10 17:41:46,84,8485,32,52,5752.73,10866.01,0.00
2024-12-10 17:41:46,83,8485,31,52,5751.00,10866.37,0.00
2024-12-10 17:41:46,83,8486,31,52,5783.23,10867.00,0.00
2024-12-10 17:41:46,84,8486,32,52,5714.39,10867.01,0.00
2024-12-10 17:41:46,85,8485,32,53,5642.05,10867.08,0.00
2024-12-10 17:41:46,85,8486,32,53,5713.73,10868.00,0.00
2024-12-10 17:41:46,86,8486,33,53,5647.29,10868.01,0.00
2024-12-10 17:41:46,86,8487,33,53,5706.31,10869.00,0.00
2024-12-10 17:41:46,87,8487,33,54,5640.72,10869.01,0.00
2024-12-10 17:41:46,86,8487,33,53,5703.78,10869.02,0.00
2024-12-10 17:41:46,85,8487,33,52,5754.28,10869.11,0.00
2024-12-10 17:41:46,84,8487,32,52,5808.82,10869.23,0.00
2024-12-10 17:41:46,83,8487,32,51,5865.70,10869.35,0.00
2024-12-10 17:41:46,83,8488,32,51,5855.73,10870.00,0.00
2024-12-10 17:41:46,84,8488,33,51,5786.02,10870.01,0.00
2024-12-10 17:41:46,85,8487,34,51,5654.12,10870.39,0.00
2024-12-10 17:41:46,86,8486,34,52,5616.35,10870.64,0.00
2024-12-10 17:41:46,87,8485,34,53,5495.72,10870.93,0.00
2024-12-10 17:41:46,87,8486,34,53,5629.94,10871.00,0.00
2024-12-10 17:41:46,88,8486,35,53,5565.96,10871.01,0.00
2024-12-10 17:41:46,87,8486,34,53,5525.12,10871.61,0.00
2024-12-10 17:41:46,87,8487,34,53,5916.57,10872.00,0.00
2024-12-10 17:41:46,88,8487,35,53,5849.34,10872.01,0.00
2024-12-10 17:41:46,87,8487,35,52,5897.87,10872.12,0.00
2024-12-10 17:41:46,87,8488,35,52,5856.69,10873.00,0.00
2024-12-10 17:41:46,88,8488,35,53,5790.14,10873.01,0.00
2024-12-10 17:41:46,87,8488,35,52,5854.19,10873.02,0.00
2024-12-10 17:41:46,86,8488,34,52,5865.45,10873.28,0.00
2024-12-10 17:41:46,86,8489,34,52,5897.97,10874.00,0.00
2024-12-10 17:41:46,87,8489,35,52,5830.18,10874.01,0.00
2024-12-10 17:41:46,86,8489,35,51,5879.03,10874.12,0.00
2024-12-10 17:41:46,86,8490,35,51,5841.92,10875.00,0.00
2024-12-10 17:41:46,87,8490,35,52,5774.77,10875.01,0.00
2024-12-10 17:41:46,86,8490,34,52,5711.19,10875.49,0.00
2024-12-10 17:41:46,85,8490,34,51,5765.99,10875.56,0.00
2024-12-10 17:41:46,85,8491,34,51,5836.13,10876.00,0.00
2024-12-10 17:41:46,86,8491,35,51,5768.27,10876.01,0.00
2024-12-10 17:41:46,85,8491,35,50,5833.57,10876.02,0.00
2024-12-10 17:41:46,84,8491,34,50,5815.01,10876.20,0.00
2024-12-10 17:41:46,84,8492,34,50,5844.95,10877.00,0.00
2024-12-10 17:41:46,85,8492,34,51,5776.18,10877.01,0.00
2024-12-10 17:41:46,84,8492,34,50,5819.07,10877.15,0.00
2024-12-10 17:41:46,83,8492,34,49,5888.83,10877.16,0.00
2024-12-10 17:41:46,83,8493,34,49,5865.11,10878.00,0.00
2024-12-10 17:41:46,84,8493,35,49,5795.29,10878.01,0.00
2024-12-10 17:41:46,85,8492,36,49,5589.13,10878.81,0.00
2024-12-10 17:41:46,85,8493,36,49,5728.30,10879.00,0.00
2024-12-10 17:41:46,86,8493,37,49,5661.69,10879.01,0.00
2024-12-10 17:41:46,85,8493,36,49,5653.32,10879.17,0.00
2024-12-10 17:41:46,86,8492,37,49,5523.89,10879.73,0.00
2024-12-10 17:41:46,86,8493,37,49,5765.92,10880.00,0.00
2024-12-10 17:41:46,87,8493,38,49,5699.65,10880.01,0.00
2024-12-10 17:41:46,86,8493,38,48,5757.24,10880.04,0.00
2024-12-10 17:41:46,85,8493,38,47,5816.02,10880.11,0.00
2024-12-10 17:41:46,84,8493,38,46,5868.42,10880.13,0.00
2024-12-10 17:41:46,84,8494,38,46,5963.15,10881.00,0.00
2024-12-10 17:41:46,85,8494,38,47,5893.00,10881.01,0.00
2024-12-10 17:41:46,84,8494,37,47,5957.96,10881.01,0.00
2024-12-10 17:41:46,83,8494,37,46,6027.13,10881.02,0.00
2024-12-10 17:41:46,82,8494,36,46,6094.00,10881.07,0.00
2024-12-10 17:41:46,81,8494,35,46,6011.64,10881.69,0.00
2024-12-10 17:41:46,81,8495,35,46,6104.48,10882.00,0.00
2024-12-10 17:41:46,82,8495,36,46,6030.03,10882.01,0.00
2024-12-10 17:41:46,81,8495,36,45,6080.32,10882.11,0.00
2024-12-10 17:41:46,80,8495,35,45,6067.67,10882.51,0.00
2024-12-10 17:41:46,81,8494,35,46,5973.42,10882.67,0.00
2024-12-10 17:41:46,81,8495,35,46,6166.07,10883.00,0.00
2024-12-10 17:41:46,82,8495,36,46,6090.88,10883.01,0.00
2024-12-10 17:41:46,81,8495,35,46,6130.59,10883.09,0.00
2024-12-10 17:41:46,81,8496,35,46,6234.64,10884.00,0.00
2024-12-10 17:41:46,82,8496,35,47,6158.61,10884.01,0.00
2024-12-10 17:41:46,81,8496,34,47,6205.09,10884.02,0.00
2024-12-10 17:41:46,81,8497,34,47,6139.65,10885.00,0.00
2024-12-10 17:41:46,82,8497,34,48,6064.77,10885.01,0.00
2024-12-10 17:41:46,81,8497,34,47,6110.08,10885.02,0.00
2024-12-10 17:41:46,81,8498,34,47,6016.72,10886.00,0.00
2024-12-10 17:41:46,82,8498,35,47,5943.34,10886.01,0.00
2024-12-10 17:41:46,82,8499,35,47,5800.96,10887.00,0.00
2024-12-10 17:41:46,83,8499,35,48,5731.07,10887.01,0.00
2024-12-10 17:41:46,82,8499,35,47,5799.64,10887.01,0.00
2024-12-10 17:41:46,83,8498,36,47,5689.88,10887.39,0.00
2024-12-10 17:41:46,82,8498,35,47,5765.58,10887.58,0.00
2024-12-10 17:41:46,82,8499,35,47,5745.64,10888.00,0.00
2024-12-10 17:41:46,83,8499,36,47,5676.41,10888.01,0.00
2024-12-10 17:41:46,82,8499,36,46,5653.34,10888.54,0.00
2024-12-10 17:41:46,81,8499,35,46,5710.46,10888.57,0.00
2024-12-10 17:41:46,80,8499,34,46,5694.40,10888.94,0.00
2024-12-10 17:41:46,80,8500,34,46,5959.85,10889.00,0.00
2024-12-10 17:41:46,81,8500,34,47,5886.28,10889.01,0.00
2024-12-10 17:41:46,80,8500,34,46,5954.41,10889.05,0.00
2024-12-10 17:41:46,81,8499,35,46,5868.85,10889.19,0.00
2024-12-10 17:41:46,82,8498,35,47,5864.37,10889.35,0.00
2024-12-10 17:41:46,81,8498,35,46,5942.19,10889.69,0.00
2024-12-10 17:41:46,81,8499,35,46,5974.70,10890.00,0.00
2024-12-10 17:41:46,82,8499,36,46,5901.84,10890.01,0.00
2024-12-10 17:41:46,82,8500,36,46,6072.42,10891.00,0.00
2024-12-10 17:41:46,83,8500,36,47,5999.26,10891.01,0.00
2024-12-10 17:41:46,82,8500,36,46,6065.78,10891.05,0.00
2024-12-10 17:41:46,82,8501,36,46,5985.13,10892.00,0.00
2024-12-10 17:41:46,83,8501,37,46,5913.02,10892.01,0.00
2024-12-10 17:41:46,82,8501,37,45,5983.80,10892.01,0.00
2024-12-10 17:41:46,81,8501,36,45,6052.85,10892.02,0.00
2024-12-10 17:41:46,81,8502,36,45,5991.38,10893.00,0.00
2024-12-10 17:41:46,82,8502,36,46,5918.31,10893.01,0.00
2024-12-10 17:41:47,81,8502,36,45,5984.66,10893.04,0.00
2024-12-10 17:41:47,82,8501,36,46,5905.06,10893.12,0.00
2024-12-10 17:41:47,81,8501,35,46,6055.56,10893.22,0.00
2024-12-10 17:41:47,80,8501,34,46,6003.57,10893.84,0.00
2024-12-10 17:41:47,80,8502,34,46,6057.87,10894.00,0.00
2024-12-10 17:41:47,81,8502,35,46,5983.08,10894.01,0.00
2024-12-10 17:41:47,80,8502,35,45,5944.96,10894.53,0.00
2024-12-10 17:41:47,81,8501,35,46,5870.23,10894.56,0.00
2024-12-10 17:41:47,80,8501,34,46,5947.69,10894.79,0.00
2024-12-10 17:41:47,80,8502,34,46,6128.11,10895.00,0.00
2024-12-10 17:41:47,81,8502,34,47,6052.46,10895.01,0.00
2024-12-10 17:41:47,80,8502,34,46,6121.31,10895.04,0.00
2024-12-10 17:41:47,81,8501,35,46,5901.64,10895.80,0.00
2024-12-10 17:41:47,81,8502,35,46,6153.39,10896.00,0.00
2024-12-10 17:41:47,82,8502,36,46,6078.35,10896.01,0.00
2024-12-10 17:41:47,81,8502,36,45,6096.07,10896.20,0.00
2024-12-10 17:41:47,81,8503,36,45,6129.04,10897.00,0.00
2024-12-10 17:41:47,82,8503,37,45,6054.30,10897.01,0.00
2024-12-10 17:41:47,81,8503,37,44,6114.27,10897.07,0.00
2024-12-10 17:41:47,81,8504,37,44,5994.39,10898.00,0.00
2024-12-10 17:41:47,82,8504,38,44,5921.28,10898.01,0.00
2024-12-10 17:41:47,81,8504,38,43,5993.04,10898.01,0.00
2024-12-10 17:41:47,80,8504,37,43,5978.96,10898.49,0.00
2024-12-10 17:41:47,80,8505,37,43,5980.90,10899.00,0.00
2024-12-10 17:41:47,81,8505,37,44,5907.07,10899.01,0.00
2024-12-10 17:41:47,82,8504,38,44,5715.67,10899.63,0.00
2024-12-10 17:41:47,83,8503,38,45,5649.05,10899.76,0.00
2024-12-10 17:41:47,83,8504,38,45,5737.81,10900.00,0.00
2024-12-10 17:41:47,84,8504,39,45,5669.50,10900.01,0.00
2024-12-10 17:41:47,83,8504,39,44,5628.13,10900.55,0.00
2024-12-10 17:41:47,83,8505,39,44,5905.08,10901.00,0.00
2024-12-10 17:41:47,84,8505,40,44,5834.79,10901.01,0.00
2024-12-10 17:41:47,83,8505,40,43,5776.64,10901.70,0.00
2024-12-10 17:41:47,83,8506,40,43,5808.36,10902.00,0.00
2024-12-10 17:41:47,84,8506,40,44,5739.21,10902.01,0.00
2024-12-10 17:41:47,83,8506,40,43,5791.31,10902.07,0.00
2024-12-10 17:41:47,83,8507,40,43,5742.44,10903.00,0.00
2024-12-10 17:41:47,84,8507,40,44,5674.07,10903.01,0.00
2024-12-10 17:41:47,83,8507,40,43,5717.49,10903.04,0.00
2024-12-10 17:41:47,83,8508,40,43,5669.60,10904.00,0.00
2024-12-10 17:41:47,84,8508,41,43,5602.10,10904.01,0.00
2024-12-10 17:41:47,83,8508,41,42,5638.95,10904.07,0.00
2024-12-10 17:41:47,82,8508,40,42,5593.49,10904.52,0.00
2024-12-10 17:41:47,82,8509,40,42,5665.17,10905.00,0.00
2024-12-10 17:41:47,83,8509,40,43,5596.92,10905.01,0.00
2024-12-10 17:41:47,83,8510,40,43,5533.32,10906.00,0.00
2024-12-10 17:41:47,84,8510,41,43,5467.44,10906.01,0.00
2024-12-10 17:41:47,83,8510,41,42,5514.93,10906.02,0.00
2024-12-10 17:41:47,84,8509,42,42,5404.42,10906.45,0.00
2024-12-10 17:41:47,83,8509,41,42,5558.70,10906.71,0.00
2024-12-10 17:41:47,83,8510,41,42,5653.29,10907.00,0.00
2024-12-10 17:41:47,84,8510,42,42,5585.99,10907.01,0.00
2024-12-10 17:41:47,83,8510,42,41,5641.50,10907.07,0.00
2024-12-10 17:41:47,82,8510,41,41,5695.71,10907.21,0.00
2024-12-10 17:41:47,81,8510,40,41,5764.68,10907.21,0.00
2024-12-10 17:41:47,80,8510,39,41,5728.97,10907.70,0.00
2024-12-10 17:41:47,79,8510,38,41,5782.51,10907.82,0.00
2024-12-10 17:41:47,79,8511,38,41,6039.46,10908.00,0.00
2024-12-10 17:41:47,80,8511,39,41,5963.96,10908.01,0.00
2024-12-10 17:41:47,81,8510,40,41,5783.44,10908.69,0.00
2024-12-10 17:41:47,81,8511,40,41,5855.28,10909.00,0.00
2024-12-10 17:41:47,82,8511,41,41,5783.88,10909.01,0.00
2024-12-10 17:41:47,81,8511,41,40,5845.88,10909.07,0.00
2024-12-10 17:41:47,81,8512,41,40,5936.67,10910.00,0.00
2024-12-10 17:41:47,82,8512,42,40,5864.27,10910.01,0.00
2024-12-10 17:41:47,81,8512,41,40,5878.11,10910.21,0.00
2024-12-10 17:41:47,81,8513,41,40,5857.70,10911.00,0.00
2024-12-10 17:41:47,82,8513,42,40,5786.27,10911.01,0.00
2024-12-10 17:41:47,81,8513,42,39,5844.82,10911.09,0.00
2024-12-10 17:41:47,82,8512,42,40,5662.53,10911.96,0.00
2024-12-10 17:41:47,82,8513,42,40,5793.76,10912.00,0.00
2024-12-10 17:41:47,83,8513,42,41,5723.95,10912.01,0.00
2024-12-10 17:41:47,82,8513,41,41,5733.00,10912.21,0.00
2024-12-10 17:41:47,82,8514,41,41,5848.16,10913.00,0.00
2024-12-10 17:41:47,83,8514,41,42,5777.70,10913.01,0.00
2024-12-10 17:41:47,82,8514,41,41,5834.88,10913.08,0.00
2024-12-10 17:41:47,81,8514,40,41,5884.61,10913.20,0.00
2024-12-10 17:41:47,81,8515,40,41,5860.20,10914.00,0.00
2024-12-10 17:41:47,82,8515,40,42,5788.73,10914.01,0.00
2024-12-10 17:41:47,81,8515,39,42,5786.36,10914.30,0.00
2024-12-10 17:41:47,80,8515,38,42,5777.16,10914.75,0.00
2024-12-10 17:41:47,80,8516,38,42,5883.88,10915.00,0.00
2024-12-10 17:41:47,81,8516,39,42,5811.24,10915.01,0.00
2024-12-10 17:41:47,80,8516,39,41,5871.63,10915.09,0.00
2024-12-10 17:41:48,80,8517,39,41,5828.26,10916.00,0.00
2024-12-10 17:41:48,81,8517,40,41,5756.31,10916.01,0.00
2024-12-10 17:41:48,80,8517,40,40,5820.05,10916.08,0.00
2024-12-10 17:41:48,80,8518,40,40,5773.93,10917.00,0.00
2024-12-10 17:41:48,81,8518,41,40,5702.65,10917.01,0.00
2024-12-10 17:41:48,80,8518,40,40,5717.34,10917.20,0.00
2024-12-10 17:41:48,79,8518,39,40,5760.28,10917.32,0.00
2024-12-10 17:41:48,78,8518,38,40,5769.85,10917.53,0.00
2024-12-10 17:41:48,77,8518,37,40,5827.34,10917.69,0.00
2024-12-10 17:41:48,77,8519,37,40,5935.33,10918.00,0.00
2024-12-10 17:41:48,78,8519,38,40,5859.24,10918.01,0.00
2024-12-10 17:41:48,77,8519,38,39,5925.43,10918.08,0.00
2024-12-10 17:41:48,78,8518,38,40,5845.28,10918.14,0.00
2024-12-10 17:41:48,77,8518,38,39,5983.23,10918.17,0.00
2024-12-10 17:41:48,76,8518,38,38,6056.29,10918.21,0.00
2024-12-10 17:41:48,76,8519,38,38,6041.52,10919.00,0.00
2024-12-10 17:41:48,77,8519,38,39,5963.06,10919.01,0.00
2024-12-10 17:41:48,76,8519,38,38,5920.74,10919.63,0.00
2024-12-10 17:41:48,76,8520,38,38,6168.14,10920.00,0.00
2024-12-10 17:41:48,77,8520,38,39,6088.04,10920.01,0.00
2024-12-10 17:41:48,78,8519,38,40,5942.71,10920.35,0.00
2024-12-10 17:41:48,78,8520,38,40,6065.00,10921.00,0.00
2024-12-10 17:41:48,79,8520,39,40,5988.23,10921.01,0.00
2024-12-10 17:41:48,78,8520,38,40,5950.67,10921.41,0.00
2024-12-10 17:41:48,78,8521,38,40,6166.70,10922.00,0.00
2024-12-10 17:41:48,79,8521,38,41,6088.65,10922.01,0.00
2024-12-10 17:41:48,80,8520,38,42,6011.18,10922.05,0.00
2024-12-10 17:41:48,79,8520,38,41,6142.59,10922.09,0.00
2024-12-10 17:41:48,78,8520,37,41,6198.31,10922.26,0.00
2024-12-10 17:41:48,77,8520,36,41,6276.46,10922.27,0.00
2024-12-10 17:41:48,76,8520,35,41,6316.15,10922.67,0.00
2024-12-10 17:41:48,76,8521,35,41,6366.00,10923.00,0.00
2024-12-10 17:41:48,77,8521,35,42,6283.32,10923.01,0.00
2024-12-10 17:41:48,76,8521,35,41,6347.40,10923.08,0.00
2024-12-10 17:41:48,75,8521,34,41,6370.75,10923.64,0.00
2024-12-10 17:41:48,75,8522,34,41,6562.57,10924.00,0.00
2024-12-10 17:41:48,76,8522,34,42,6476.22,10924.01,0.00
2024-12-10 17:41:48,75,8522,34,41,6556.77,10924.05,0.00
2024-12-10 17:41:48,74,8522,34,40,6626.39,10924.07,0.00
2024-12-10 17:41:48,74,8523,34,40,6613.15,10925.00,0.00
2024-12-10 17:41:48,75,8523,34,41,6524.97,10925.01,0.00
2024-12-10 17:41:48,75,8524,34,41,6520.18,10926.00,0.00
2024-12-10 17:41:48,76,8524,34,42,6434.39,10926.01,0.00
2024-12-10 17:41:48,76,8525,34,42,6417.15,10927.00,0.00
2024-12-10 17:41:48,77,8525,34,43,6333.81,10927.01,0.00
2024-12-10 17:41:48,76,8525,33,43,6366.53,10927.14,0.00
2024-12-10 17:41:48,75,8525,32,43,6447.43,10927.17,0.00
2024-12-10 17:41:48,75,8526,32,43,6465.28,10928.00,0.00
2024-12-10 17:41:48,76,8526,32,44,6380.21,10928.01,0.00
2024-12-10 17:41:48,75,8526,31,44,6459.48,10928.05,0.00
2024-12-10 17:41:48,74,8526,30,44,6442.92,10928.39,0.00
2024-12-10 17:41:48,74,8527,30,44,6524.18,10929.00,0.00
2024-12-10 17:41:48,75,8527,30,45,6437.19,10929.01,0.00
2024-12-10 17:41:48,74,8527,30,44,6505.00,10929.05,0.00
2024-12-10 17:41:48,74,8528,30,44,6478.29,10930.00,0.00
2024-12-10 17:41:48,75,8528,30,45,6391.91,10930.01,0.00
2024-12-10 17:41:48,74,8528,29,45,6320.96,10930.88,0.00
2024-12-10 17:41:48,74,8529,29,45,6446.33,10931.00,0.00
2024-12-10 17:41:48,75,8529,30,45,6360.38,10931.01,0.00
2024-12-10 17:41:48,74,8529,30,44,6371.38,10931.11,0.00
2024-12-10 17:41:48,75,8528,31,44,6202.66,10931.77,0.00
2024-12-10 17:41:48,75,8529,31,44,6394.94,10932.00,0.00
2024-12-10 17:41:48,76,8529,31,45,6310.80,10932.01,0.00
2024-12-10 17:41:48,77,8528,31,46,6187.70,10932.16,0.00
2024-12-10 17:41:48,77,8529,31,46,6395.95,10933.00,0.00
2024-12-10 17:41:48,78,8529,32,46,6313.95,10933.01,0.00
2024-12-10 17:41:48,77,8529,32,45,6378.25,10933.10,0.00
2024-12-10 17:41:48,76,8529,31,45,6443.46,10933.17,0.00
2024-12-10 17:41:48,76,8530,31,45,6579.62,10934.00,0.00
2024-12-10 17:41:48,77,8530,32,45,6494.17,10934.01,0.00
2024-12-10 17:41:48,77,8531,32,45,6454.60,10935.00,0.00
2024-12-10 17:41:48,78,8531,33,45,6371.85,10935.01,0.00
2024-12-10 17:41:48,78,8532,33,45,6313.22,10936.00,0.00
2024-12-10 17:41:48,79,8532,34,45,6233.30,10936.01,0.00
2024-12-10 17:41:48,78,8532,34,44,6296.41,10936.10,0.00
2024-12-10 17:41:48,79,8531,34,45,6139.18,10936.82,0.00
2024-12-10 17:41:48,79,8532,34,45,6210.57,10937.00,0.00
2024-12-10 17:41:48,80,8532,35,45,6132.93,10937.01,0.00
2024-12-10 17:41:48,79,8532,34,45,6161.48,10937.19,0.00
2024-12-10 17:41:48,79,8533,34,45,6318.59,10938.00,0.00
2024-12-10 17:41:48,80,8533,34,46,6239.61,10938.01,0.00
2024-12-10 17:41:48,80,8534,34,46,6194.28,10939.00,0.00
2024-12-10 17:41:48,81,8534,34,47,6117.80,10939.01,0.00
2024-12-10 17:41:48,81,8535,34,47,6050.12,10940.00,0.00
2024-12-10 17:41:48,82,8535,35,47,5976.34,10940.01,0.00
2024-12-10 17:41:48,81,8535,34,47,5996.24,10940.21,0.00
2024-12-10 17:41:48,82,8534,34,48,5864.53,10940.72,0.00
2024-12-10 17:41:48,82,8535,34,48,5929.13,10941.00,0.00
2024-12-10 17:41:48,83,8535,34,49,5857.70,10941.01,0.00
2024-12-10 17:41:48,82,8535,34,48,5926.59,10941.01,0.00
2024-12-10 17:41:48,81,8535,34,47,5973.17,10941.09,0.00
2024-12-10 17:41:48,80,8535,33,47,6036.33,10941.19,0.00
2024-12-10 17:41:48,79,8535,33,46,6009.70,10941.77,0.00
2024-12-10 17:41:48,78,8535,32,46,6022.36,10941.95,0.00
2024-12-10 17:41:48,78,8536,32,46,6292.83,10942.00,0.00
2024-12-10 17:41:48,79,8536,32,47,6213.17,10942.01,0.00
2024-12-10 17:41:48,78,8536,31,47,6285.91,10942.04,0.00
2024-12-10 17:41:48,79,8535,32,47,6157.92,10942.25,0.00
2024-12-10 17:41:48,80,8534,33,47,6145.27,10942.34,0.00
2024-12-10 17:41:48,80,8535,33,47,6154.27,10943.00,0.00
2024-12-10 17:41:48,81,8535,34,47,6078.29,10943.01,0.00
2024-12-10 17:41:48,80,8535,34,46,6140.61,10943.08,0.00
2024-12-10 17:41:48,79,8535,33,46,6102.60,10943.62,0.00
2024-12-10 17:41:48,80,8534,34,46,5988.02,10943.72,0.00
2024-12-10 17:41:48,79,8534,33,46,6064.69,10943.80,0.00
2024-12-10 17:41:48,80,8533,33,47,5963.04,10943.95,0.00
2024-12-10 17:41:48,80,8534,33,47,6363.15,10944.00,0.00
2024-12-10 17:41:48,81,8534,34,47,6284.59,10944.01,0.00
2024-12-10 17:41:48,81,8535,34,47,6377.26,10945.00,0.00
2024-12-10 17:41:49,82,8535,35,47,6299.48,10945.01,0.00
2024-12-10 17:41:49,81,8535,35,46,6369.16,10945.04,0.00
2024-12-10 17:41:49,81,8536,35,46,6229.99,10946.00,0.00
2024-12-10 17:41:49,82,8536,36,46,6154.01,10946.01,0.00
2024-12-10 17:41:49,83,8535,37,46,6073.29,10946.10,0.00
2024-12-10 17:41:49,83,8536,37,46,6046.86,10947.00,0.00
2024-12-10 17:41:49,84,8536,38,46,5974.87,10947.01,0.00
2024-12-10 17:41:49,83,8536,38,45,5928.44,10947.61,0.00
2024-12-10 17:41:49,82,8536,37,45,5971.94,10947.77,0.00
2024-12-10 17:41:49,82,8537,37,45,6162.23,10948.00,0.00
2024-12-10 17:41:49,83,8537,37,46,6087.98,10948.01,0.00
2024-12-10 17:41:49,82,8537,37,45,6007.69,10948.85,0.00
2024-12-10 17:41:49,82,8538,37,45,6095.76,10949.00,0.00
2024-12-10 17:41:49,83,8538,38,45,6022.32,10949.01,0.00
2024-12-10 17:41:49,84,8537,39,45,5855.43,10949.61,0.00
2024-12-10 17:41:49,83,8537,39,44,5894.99,10949.93,0.00
2024-12-10 17:41:49,83,8538,39,44,5995.11,10950.00,0.00
2024-12-10 17:41:49,84,8538,39,45,5923.74,10950.01,0.00
2024-12-10 17:41:49,85,8537,40,45,5760.35,10950.60,0.00
2024-12-10 17:41:49,85,8538,40,45,5909.75,10951.00,0.00
2024-12-10 17:41:49,86,8538,41,45,5841.04,10951.01,0.00
2024-12-10 17:41:49,85,8538,41,44,5882.71,10951.07,0.00
2024-12-10 17:41:49,84,8538,41,43,5898.98,10951.56,0.00
2024-12-10 17:41:49,84,8539,41,43,6028.35,10952.00,0.00
2024-12-10 17:41:49,85,8539,42,43,5957.43,10952.01,0.00
2024-12-10 17:41:49,84,8539,42,42,6024.45,10952.04,0.00
2024-12-10 17:41:49,83,8539,42,41,6091.76,10952.06,0.00
2024-12-10 17:41:49,84,8538,43,41,6009.89,10952.17,0.00
2024-12-10 17:41:49,83,8538,42,41,6077.39,10952.72,0.00
2024-12-10 17:41:49,83,8539,42,41,6126.43,10953.00,0.00
2024-12-10 17:41:49,84,8539,43,41,6053.49,10953.01,0.00
2024-12-10 17:41:49,83,8539,42,41,6122.48,10953.04,0.00
2024-12-10 17:41:49,82,8539,41,41,6153.12,10953.20,0.00
2024-12-10 17:41:49,83,8538,41,42,6043.07,10953.51,0.00
2024-12-10 17:41:49,83,8539,41,42,6193.31,10954.00,0.00
2024-12-10 17:41:49,84,8539,41,43,6119.58,10954.01,0.00
2024-12-10 17:41:49,83,8539,41,42,6185.40,10954.06,0.00
2024-12-10 17:41:49,83,8540,41,42,6246.00,10955.00,0.00
2024-12-10 17:41:49,84,8540,42,42,6171.64,10955.01,0.00
2024-12-10 17:41:49,83,8540,42,41,6226.82,10955.06,0.00
2024-12-10 17:41:49,82,8540,41,41,6270.69,10955.06,0.00
2024-12-10 17:41:49,81,8540,40,41,6334.65,10955.19,0.00
2024-12-10 17:41:49,80,8540,40,40,6363.11,10955.50,0.00
2024-12-10 17:41:49,81,8539,41,40,6222.55,10955.74,0.00
2024-12-10 17:41:49,81,8540,41,40,6347.20,10956.00,0.00
2024-12-10 17:41:49,82,8540,41,41,6269.79,10956.01,0.00
2024-12-10 17:41:49,81,8540,40,41,6240.54,10956.47,0.00
2024-12-10 17:41:49,80,8540,40,40,6311.48,10956.53,0.00
2024-12-10 17:41:49,79,8540,39,40,6380.33,10956.63,0.00
2024-12-10 17:41:49,79,8541,39,40,6617.78,10957.00,0.00
2024-12-10 17:41:49,80,8541,39,41,6535.06,10957.01,0.00
2024-12-10 17:41:49,80,8542,39,41,6486.95,10958.00,0.00
2024-12-10 17:41:49,81,8542,39,42,6406.86,10958.01,0.00
2024-12-10 17:41:49,80,8542,38,42,6404.47,10958.30,0.00
2024-12-10 17:41:49,81,8541,39,42,6273.31,10958.75,0.00
2024-12-10 17:41:49,81,8542,39,42,6395.28,10959.00,0.00
2024-12-10 17:41:49,82,8542,40,42,6317.29,10959.01,0.00
2024-12-10 17:41:49,81,8542,40,41,6387.17,10959.07,0.00
2024-12-10 17:41:49,81,8543,40,41,6493.43,10960.00,0.00
2024-12-10 17:41:49,82,8543,40,42,6414.24,10960.01,0.00
2024-12-10 17:41:49,81,8543,39,42,6489.31,10960.05,0.00
2024-12-10 17:41:49,81,8543,39,42,6417.28,10961.00,0.00
2024-12-10 17:41:49,82,8543,40,42,6339.02,10961.01,0.00
2024-12-10 17:41:49,81,8543,40,41,6411.87,10961.05,0.00
2024-12-10 17:41:49,80,8543,40,40,6485.17,10961.05,0.00
2024-12-10 17:41:49,80,8544,40,40,6437.58,10962.00,0.00
2024-12-10 17:41:49,81,8544,40,41,6358.10,10962.01,0.00
2024-12-10 17:41:49,80,8544,39,41,6318.29,10962.65,0.00
2024-12-10 17:41:49,80,8545,39,41,6404.38,10963.00,0.00
2024-12-10 17:41:49,81,8545,40,41,6325.32,10963.01,0.00
2024-12-10 17:41:49,82,8544,41,41,6074.77,10963.93,0.00
2024-12-10 17:41:49,82,8545,41,41,6207.22,10964.00,0.00
2024-12-10 17:41:49,83,8545,41,42,6132.43,10964.01,0.00
2024-12-10 17:41:49,83,8546,41,42,6188.99,10965.00,0.00
2024-12-10 17:41:49,84,8546,42,42,6115.31,10965.01,0.00
2024-12-10 17:41:49,83,8546,41,42,6137.32,10965.24,0.00
2024-12-10 17:41:49,83,8547,41,42,6093.91,10966.00,0.00
2024-12-10 17:41:49,84,8547,41,43,6021.37,10966.01,0.00
2024-12-10 17:41:49,83,8547,41,42,6080.71,10966.05,0.00
2024-12-10 17:41:49,82,8547,40,42,6126.74,10966.28,0.00
2024-12-10 17:41:49,81,8547,39,42,6200.09,10966.28,0.00
2024-12-10 17:41:49,81,8548,39,42,6192.61,10967.00,0.00
2024-12-10 17:41:49,82,8548,40,42,6117.09,10967.01,0.00
2024-12-10 17:41:49,82,8549,40,42,6096.54,10968.00,0.00
2024-12-10 17:41:49,83,8549,40,43,6023.08,10968.01,0.00
2024-12-10 17:41:49,82,8549,39,43,6045.62,10968.23,0.00
2024-12-10 17:41:49,82,8550,39,43,6061.29,10969.00,0.00
2024-12-10 17:41:49,83,8550,40,43,5988.27,10969.01,0.00
2024-12-10 17:41:49,82,8550,39,43,5949.32,10969.68,0.00
2024-12-10 17:41:49,82,8551,39,43,5999.71,10970.00,0.00
2024-12-10 17:41:49,83,8551,39,44,5927.43,10970.01,0.00
2024-12-10 17:41:49,82,8551,38,44,5995.70,10970.04,0.00
2024-12-10 17:41:49,81,8551,38,43,6052.12,10970.04,0.00
2024-12-10 17:41:50,81,8552,38,43,6019.19,10971.00,0.00
2024-12-10 17:41:50,82,8552,39,43,5945.79,10971.01,0.00
2024-12-10 17:41:50,81,8552,39,42,5990.99,10971.04,0.00
2024-12-10 17:41:50,81,8553,39,42,5954.43,10972.00,0.00
2024-12-10 17:41:50,82,8553,40,42,5881.81,10972.01,0.00
2024-12-10 17:41:50,81,8553,40,41,5923.28,10972.05,0.00
2024-12-10 17:41:50,80,8553,39,41,5847.35,10972.89,0.00
2024-12-10 17:41:50,80,8554,39,41,5972.26,10973.00,0.00
2024-12-10 17:41:50,81,8554,39,42,5898.52,10973.01,0.00
2024-12-10 17:41:50,81,8555,39,42,5865.48,10974.00,0.00
2024-12-10 17:41:50,82,8555,39,43,5793.95,10974.01,0.00
2024-12-10 17:41:50,81,8555,38,43,5854.51,10974.02,0.00
2024-12-10 17:41:50,82,8554,38,44,5698.15,10974.56,0.00
2024-12-10 17:41:50,82,8555,38,44,5785.27,10975.00,0.00
2024-12-10 17:41:50,83,8555,39,44,5715.56,10975.01,0.00
2024-12-10 17:41:50,83,8556,39,44,5774.46,10976.00,0.00
2024-12-10 17:41:50,84,8556,40,44,5705.72,10976.01,0.00
2024-12-10 17:41:50,83,8556,40,43,5762.59,10976.05,0.00
2024-12-10 17:41:50,84,8555,40,44,5673.13,10976.26,0.00
2024-12-10 17:41:50,84,8556,40,44,5671.96,10977.00,0.00
2024-12-10 17:41:50,85,8556,41,44,5605.23,10977.01,0.00
2024-12-10 17:41:50,84,8556,40,44,5652.36,10977.02,0.00
2024-12-10 17:41:50,83,8556,40,43,5694.01,10977.04,0.00
2024-12-10 17:41:50,82,8556,40,42,5731.72,10977.32,0.00
2024-12-10 17:41:50,82,8557,40,42,5895.71,10978.00,0.00
2024-12-10 17:41:50,83,8557,40,43,5824.68,10978.01,0.00
2024-12-10 17:41:50,83,8558,40,43,5740.69,10979.00,0.00
2024-12-10 17:41:50,84,8558,40,44,5672.35,10979.01,0.00
2024-12-10 17:41:50,83,8558,40,43,5732.76,10979.07,0.00
2024-12-10 17:41:50,82,8558,40,42,5777.56,10979.29,0.00
2024-12-10 17:41:50,81,8558,39,42,5726.06,10979.74,0.00
2024-12-10 17:41:50,81,8559,39,42,5822.60,10980.00,0.00
2024-12-10 17:41:50,82,8559,40,42,5751.59,10980.01,0.00
2024-12-10 17:41:50,81,8559,39,42,5716.25,10980.44,0.00
2024-12-10 17:41:50,80,8559,38,42,5764.42,10980.55,0.00
2024-12-10 17:41:50,80,8560,38,42,5839.03,10981.00,0.00
2024-12-10 17:41:50,81,8560,38,43,5766.95,10981.01,0.00
2024-12-10 17:41:50,80,8560,38,42,5826.69,10981.09,0.00
2024-12-10 17:41:50,80,8561,38,42,5787.66,10982.00,0.00
2024-12-10 17:41:50,81,8561,39,42,5716.21,10982.01,0.00
2024-12-10 17:41:50,80,8561,38,42,5786.29,10982.01,0.00
2024-12-10 17:41:50,79,8561,37,42,5808.12,10982.13,0.00
2024-12-10 17:41:50,78,8561,37,41,5877.61,10982.13,0.00
2024-12-10 17:41:50,78,8562,37,41,5893.70,10983.00,0.00
2024-12-10 17:41:50,79,8562,38,41,5819.09,10983.01,0.00
2024-12-10 17:41:50,78,8562,37,41,5823.38,10983.28,0.00
2024-12-10 17:41:50,77,8562,36,41,5892.81,10983.31,0.00
2024-12-10 17:41:50,78,8561,37,41,5748.27,10983.82,0.00
2024-12-10 17:41:50,78,8562,37,41,5865.95,10984.00,0.00
2024-12-10 17:41:50,79,8562,37,42,5791.70,10984.01,0.00
2024-12-10 17:41:50,78,8562,37,41,5840.61,10984.04,0.00
2024-12-10 17:41:50,77,8562,36,41,5796.62,10984.81,0.00
2024-12-10 17:41:50,77,8563,36,41,6003.62,10985.00,0.00
2024-12-10 17:41:50,78,8563,37,41,5926.65,10985.01,0.00
2024-12-10 17:41:50,77,8563,37,40,5973.67,10985.05,0.00
2024-12-10 17:41:50,77,8564,37,40,5927.57,10986.00,0.00
2024-12-10 17:41:50,78,8564,38,40,5851.58,10986.01,0.00
2024-12-10 17:41:50,77,8564,38,39,5893.34,10986.06,0.00
2024-12-10 17:41:50,77,8565,38,39,5842.01,10987.00,0.00
2024-12-10 17:41:50,78,8565,39,39,5767.11,10987.01,0.00
2024-12-10 17:41:50,79,8564,39,40,5609.77,10987.35,0.00
2024-12-10 17:41:50,79,8565,39,40,5665.54,10988.00,0.00
2024-12-10 17:41:50,80,8565,39,41,5594.73,10988.01,0.00
2024-12-10 17:41:50,79,8565,39,40,5650.25,10988.09,0.00
2024-12-10 17:41:50,78,8565,38,40,5551.12,10988.92,0.00
2024-12-10 17:41:50,78,8566,38,40,5824.48,10989.00,0.00
2024-12-10 17:41:50,79,8566,38,41,5750.75,10989.01,0.00
2024-12-10 17:41:50,78,8566,38,40,5752.75,10989.31,0.00
2024-12-10 17:41:50,77,8566,37,40,5811.52,10989.39,0.00
2024-12-10 17:41:50,76,8566,36,40,5774.36,10989.95,0.00
2024-12-10 17:41:50,76,8567,36,40,5913.22,10990.00,0.00
2024-12-10 17:41:50,77,8567,36,41,5836.42,10990.01,0.00
2024-12-10 17:41:50,76,8567,36,40,5898.77,10990.09,0.00
2024-12-10 17:41:50,75,8567,35,40,5884.07,10990.59,0.00
2024-12-10 17:41:50,75,8568,35,40,5924.13,10991.00,0.00
2024-12-10 17:41:50,76,8568,36,40,5846.18,10991.01,0.00
2024-12-10 17:41:50,75,8568,36,39,5909.48,10991.09,0.00
2024-12-10 17:41:50,75,8569,36,39,5845.43,10992.00,0.00
2024-12-10 17:41:50,76,8569,37,39,5768.52,10992.01,0.00
2024-12-10 17:41:50,75,8569,36,39,5821.99,10992.05,0.00
2024-12-10 17:41:50,75,8570,36,39,5765.31,10993.00,0.00
2024-12-10 17:41:50,76,8570,37,39,5689.46,10993.01,0.00
2024-12-10 17:41:50,75,8570,37,38,5763.85,10993.01,0.00
2024-12-10 17:41:50,74,8570,36,38,5803.43,10993.07,0.00
2024-12-10 17:41:50,73,8570,35,38,5809.59,10993.32,0.00
2024-12-10 17:41:50,73,8571,35,38,5827.94,10994.00,0.00
2024-12-10 17:41:50,74,8571,35,39,5749.19,10994.01,0.00
2024-12-10 17:41:50,73,8571,34,39,5822.01,10994.05,0.00
2024-12-10 17:41:50,72,8571,34,38,5875.39,10994.07,0.00
2024-12-10 17:41:50,71,8571,34,37,5919.69,10994.32,0.00
2024-12-10 17:41:50,71,8572,34,37,5931.31,10995.00,0.00
2024-12-10 17:41:50,72,8572,34,38,5848.93,10995.01,0.00
2024-12-10 17:41:50,71,8572,33,38,5858.71,10995.23,0.00
2024-12-10 17:41:50,72,8571,34,38,5738.06,10995.51,0.00
2024-12-10 17:41:50,71,8571,33,38,5870.51,10995.52,0.00
2024-12-10 17:41:50,71,8572,33,38,5973.07,10996.00,0.00
2024-12-10 17:41:50,72,8572,34,38,5890.11,10996.01,0.00
2024-12-10 17:41:50,71,8572,34,37,5957.00,10996.07,0.00
2024-12-10 17:41:50,70,8572,33,37,5887.16,10996.94,0.00
2024-12-10 17:41:50,70,8573,33,37,6195.10,10997.00,0.00
2024-12-10 17:41:50,71,8573,33,38,6107.85,10997.01,0.00
2024-12-10 17:41:50,70,8573,32,38,6193.53,10997.01,0.00
2024-12-10 17:41:50,69,8573,32,37,6247.32,10997.06,0.00
2024-12-10 17:41:50,68,8573,31,37,6236.99,10997.31,0.00
2024-12-10 17:41:50,68,8574,31,37,6323.19,10998.00,0.00
2024-12-10 17:41:50,69,8574,31,38,6231.55,10998.01,0.00
2024-12-10 17:41:50,68,8574,31,37,6303.91,10998.07,0.00
2024-12-10 17:41:50,67,8574,30,37,6346.41,10998.28,0.00
2024-12-10 17:41:51,67,8575,30,37,6432.28,10999.00,0.00
2024-12-10 17:41:51,68,8575,30,38,6337.68,10999.01,0.00
2024-12-10 17:41:51,67,8575,29,38,6430.64,10999.01,0.00
2024-12-10 17:41:51,66,8575,29,37,6523.02,10999.06,0.00
2024-12-10 17:41:51,65,8575,28,37,6566.52,10999.23,0.00
2024-12-10 17:41:51,65,8576,28,37,6650.77,11000.00,0.00
2024-12-10 17:41:51,66,8576,28,38,6550.00,11000.02,0.00
2024-12-10 17:41:51,65,8576,27,38,6501.90,11000.62,0.00
2024-12-10 17:41:51,65,8577,27,38,6620.70,11001.00,0.00
2024-12-10 17:41:51,66,8577,28,38,6520.38,11001.02,0.00
2024-12-10 17:41:51,65,8577,28,37,6591.94,11001.09,0.00
2024-12-10 17:41:51,65,8578,28,37,6563.57,11002.00,0.00
2024-12-10 17:41:51,66,8578,29,37,6464.12,11002.02,0.00
2024-12-10 17:41:51,67,8577,29,38,6318.42,11002.19,0.00
2024-12-10 17:41:51,67,8578,29,38,6378.33,11003.00,0.00
2024-12-10 17:41:51,68,8578,29,39,6284.53,11003.01,0.00
2024-12-10 17:41:51,67,8578,29,38,6352.06,11003.04,0.00
2024-12-10 17:41:51,66,8578,28,38,6436.67,11003.14,0.00
2024-12-10 17:41:51,66,8579,28,38,6550.61,11004.00,0.00
2024-12-10 17:41:51,67,8579,29,38,6452.84,11004.01,0.00
2024-12-10 17:41:51,68,8578,29,39,6312.67,11004.16,0.00
2024-12-10 17:41:51,69,8577,30,39,6038.43,11004.99,0.00
2024-12-10 17:41:51,69,8578,30,39,6197.84,11005.00,0.00
2024-12-10 17:41:51,70,8578,30,40,6109.30,11005.01,0.00
2024-12-10 17:41:51,69,8578,30,39,6167.55,11005.09,0.00
2024-12-10 17:41:51,69,8579,30,39,6426.09,11006.00,0.00
2024-12-10 17:41:51,70,8579,30,40,6334.29,11006.01,0.00
2024-12-10 17:41:51,71,8578,31,40,6166.10,11006.35,0.00
2024-12-10 17:41:51,70,8578,30,40,6225.33,11006.83,0.00
2024-12-10 17:41:51,70,8579,30,40,6346.50,11007.00,0.00
2024-12-10 17:41:51,71,8579,31,40,6257.11,11007.01,0.00
2024-12-10 17:41:51,70,8579,30,40,6282.95,11007.14,0.00
2024-12-10 17:41:51,69,8579,29,40,6286.46,11007.51,0.00
2024-12-10 17:41:51,69,8580,29,40,6512.97,11008.00,0.00
2024-12-10 17:41:51,70,8580,29,41,6419.93,11008.01,0.00
2024-12-10 17:41:51,69,8580,29,40,6504.99,11008.04,0.00
2024-12-10 17:41:51,69,8581,29,40,6432.58,11009.00,0.00
2024-12-10 17:41:51,70,8581,29,41,6340.69,11009.01,0.00
2024-12-10 17:41:51,69,8581,29,40,6283.24,11009.75,0.00
2024-12-10 17:41:51,69,8582,29,40,6324.52,11010.00,0.00
2024-12-10 17:41:51,70,8582,29,41,6234.17,11010.01,0.00
2024-12-10 17:41:51,69,8582,29,40,6308.57,11010.06,0.00
2024-12-10 17:41:51,68,8582,28,40,6198.79,11010.97,0.00
2024-12-10 17:41:51,68,8583,28,40,6357.49,11011.00,0.00
2024-12-10 17:41:51,69,8583,29,40,6265.35,11011.01,0.00
2024-12-10 17:41:51,68,8583,28,40,6355.87,11011.01,0.00
2024-12-10 17:41:51,67,8583,28,39,6432.66,11011.04,0.00
2024-12-10 17:41:51,66,8583,27,39,6511.76,11011.06,0.00
2024-12-10 17:41:51,66,8584,27,39,6456.82,11012.00,0.00
2024-12-10 17:41:51,67,8584,28,39,6360.45,11012.01,0.00
2024-12-10 17:41:51,66,8584,28,38,6433.54,11012.03,0.00
2024-12-10 17:41:51,66,8585,28,38,6361.59,11013.00,0.00
2024-12-10 17:41:51,67,8585,28,39,6266.64,11013.01,0.00
2024-12-10 17:41:51,66,8585,27,39,6296.99,11013.11,0.00
2024-12-10 17:41:51,67,8584,28,39,6201.37,11013.15,0.00
2024-12-10 17:41:51,66,8584,28,38,6265.54,11013.86,0.00
2024-12-10 17:41:51,66,8585,28,38,6401.99,11014.00,0.00
2024-12-10 17:41:51,67,8585,29,38,6306.43,11014.01,0.00
2024-12-10 17:41:51,66,8585,28,38,6354.13,11014.09,0.00
2024-12-10 17:41:51,66,8586,28,38,6536.34,11015.00,0.00
2024-12-10 17:41:51,67,8586,28,39,6438.78,11015.01,0.00
2024-12-10 17:41:51,67,8587,28,39,6335.26,11016.00,0.00
2024-12-10 17:41:51,68,8587,28,40,6242.10,11016.01,0.00
2024-12-10 17:41:51,67,8587,27,40,6333.62,11016.01,0.00
2024-12-10 17:41:51,66,8587,27,39,6409.55,11016.02,0.00
2024-12-10 17:41:51,66,8588,27,39,6325.58,11017.00,0.00
2024-12-10 17:41:51,67,8588,28,39,6231.17,11017.01,0.00
2024-12-10 17:41:51,66,8588,27,39,6178.58,11017.73,0.00
2024-12-10 17:41:51,65,8588,26,39,6251.16,11017.80,0.00
2024-12-10 17:41:51,65,8589,26,39,6384.94,11018.00,0.00
2024-12-10 17:41:51,66,8589,27,39,6288.20,11018.02,0.00
2024-12-10 17:41:51,66,8590,27,39,6264.94,11019.00,0.00
2024-12-10 17:41:51,67,8590,28,39,6171.43,11019.01,0.00
2024-12-10 17:41:51,67,8591,28,39,6133.52,11020.00,0.00
2024-12-10 17:41:51,68,8591,29,39,6043.33,11020.01,0.00
2024-12-10 17:41:51,67,8591,29,38,6062.45,11020.36,0.00
2024-12-10 17:41:51,67,8592,29,38,6079.76,11021.00,0.00
2024-12-10 17:41:51,68,8592,29,39,5990.35,11021.01,0.00
2024-12-10 17:41:51,67,8592,29,38,6051.80,11021.07,0.00
2024-12-10 17:41:51,66,8592,29,37,6075.87,11021.65,0.00
2024-12-10 17:41:51,65,8592,28,37,6079.70,11021.89,0.00
2024-12-10 17:41:51,65,8593,28,37,6237.48,11022.00,0.00
2024-12-10 17:41:51,66,8593,29,37,6142.97,11022.02,0.00
2024-12-10 17:41:51,66,8594,29,37,6109.21,11023.00,0.00
2024-12-10 17:41:51,67,8594,29,38,6018.03,11023.01,0.00
2024-12-10 17:41:51,66,8594,29,37,6075.83,11023.11,0.00
2024-12-10 17:41:51,66,8595,29,37,6071.74,11024.00,0.00
2024-12-10 17:41:51,67,8595,30,37,5981.11,11024.01,0.00
2024-12-10 17:41:51,67,8596,30,37,5951.31,11025.00,0.00
2024-12-10 17:41:51,68,8596,31,37,5863.79,11025.01,0.00
2024-12-10 17:41:51,67,8596,31,36,5910.19,11025.10,0.00
2024-12-10 17:41:51,66,8596,31,35,5976.19,11025.32,0.00
2024-12-10 17:41:51,66,8597,31,35,5993.92,11026.00,0.00
2024-12-10 17:41:51,67,8597,32,35,5904.46,11026.01,0.00
2024-12-10 17:41:51,66,8597,31,35,5942.18,11026.18,0.00
2024-12-10 17:41:51,66,8598,31,35,5960.58,11027.00,0.00
2024-12-10 17:41:51,67,8598,32,35,5871.62,11027.01,0.00
2024-12-10 17:41:51,66,8598,32,34,5930.53,11027.11,0.00
2024-12-10 17:41:51,66,8599,32,34,5932.72,11028.00,0.00
2024-12-10 17:41:51,67,8599,32,35,5844.17,11028.01,0.00
2024-12-10 17:41:51,66,8599,31,35,5932.03,11028.02,0.00
2024-12-10 17:41:51,65,8599,30,35,5976.06,11028.12,0.00
2024-12-10 17:41:51,65,8600,30,35,6025.62,11029.00,0.00
2024-12-10 17:41:51,66,8600,30,36,5934.32,11029.02,0.00
2024-12-10 17:41:52,66,8601,30,36,5909.71,11030.00,0.00
2024-12-10 17:41:52,67,8601,30,37,5821.51,11030.01,0.00
2024-12-10 17:41:52,68,8600,30,38,5684.05,11030.21,0.00
2024-12-10 17:41:52,68,8601,30,38,5840.27,11031.00,0.00
2024-12-10 17:41:52,69,8601,31,38,5755.63,11031.01,0.00
2024-12-10 17:41:52,68,8601,31,37,5823.03,11031.09,0.00
2024-12-10 17:41:52,67,8601,30,37,5765.84,11031.94,0.00
2024-12-10 17:41:52,67,8602,30,37,6088.60,11032.00,0.00
2024-12-10 17:41:52,68,8602,30,38,5999.06,11032.01,0.00
2024-12-10 17:41:52,68,8603,30,38,5979.79,11033.00,0.00
2024-12-10 17:41:52,69,8603,30,39,5893.12,11033.01,0.00
2024-12-10 17:41:52,68,8603,29,39,5878.16,11033.54,0.00
2024-12-10 17:41:52,68,8604,29,39,5950.58,11034.00,0.00
2024-12-10 17:41:52,69,8604,30,39,5864.34,11034.01,0.00
2024-12-10 17:41:52,68,8604,29,39,5820.33,11034.62,0.00
2024-12-10 17:41:52,68,8605,29,39,5936.72,11035.00,0.00
2024-12-10 17:41:52,69,8605,30,39,5850.68,11035.01,0.00
2024-12-10 17:41:52,68,8605,30,38,5909.15,11035.09,0.00
2024-12-10 17:41:52,68,8606,30,38,5888.53,11036.00,0.00
2024-12-10 17:41:52,69,8606,30,39,5803.19,11036.01,0.00
2024-12-10 17:41:52,68,8606,29,39,5763.20,11036.69,0.00
2024-12-10 17:41:52,68,8607,29,39,5891.66,11037.00,0.00
2024-12-10 17:41:52,69,8607,30,39,5806.27,11037.01,0.00
2024-12-10 17:41:52,69,8608,30,39,5747.58,11038.00,0.00
2024-12-10 17:41:52,70,8608,31,39,5665.47,11038.01,0.00
2024-12-10 17:41:52,69,8608,31,38,5723.59,11038.10,0.00
2024-12-10 17:41:52,69,8609,31,38,5699.89,11039.00,0.00
2024-12-10 17:41:52,70,8609,31,39,5618.47,11039.01,0.00
2024-12-10 17:41:52,69,8609,31,38,5682.30,11039.09,0.00
2024-12-10 17:41:52,70,8608,31,39,5599.55,11039.13,0.00
2024-12-10 17:41:52,69,8608,30,39,5763.51,11039.28,0.00
2024-12-10 17:41:52,69,8609,30,39,5775.31,11040.00,0.00
2024-12-10 17:41:52,70,8609,30,40,5692.80,11040.01,0.00
2024-12-10 17:41:52,69,8609,30,39,5771.08,11040.04,0.00
2024-12-10 17:41:52,70,8608,31,39,5582.58,11040.39,0.00
2024-12-10 17:41:52,70,8609,31,39,5902.72,11041.00,0.00
2024-12-10 17:41:52,71,8609,31,40,5819.58,11041.01,0.00
2024-12-10 17:41:52,70,8609,31,39,5902.68,11041.01,0.00
2024-12-10 17:41:52,69,8609,30,39,5921.57,11041.16,0.00
2024-12-10 17:41:52,68,8609,29,39,6005.42,11041.19,0.00
2024-12-10 17:41:52,68,8610,29,39,6237.93,11042.00,0.00
2024-12-10 17:41:52,69,8610,30,39,6147.52,11042.01,0.00
2024-12-10 17:41:52,68,8610,29,39,6190.84,11042.06,0.00
2024-12-10 17:41:52,67,8610,29,38,6276.68,11042.09,0.00
2024-12-10 17:41:52,67,8611,29,38,6336.28,11043.00,0.00
2024-12-10 17:41:52,68,8611,29,39,6243.10,11043.01,0.00
2024-12-10 17:41:52,67,8611,28,39,6215.23,11043.67,0.00
2024-12-10 17:41:52,67,8612,28,39,6344.05,11044.00,0.00
2024-12-10 17:41:52,68,8612,29,39,6250.76,11044.01,0.00
2024-12-10 17:41:52,67,8612,29,38,6306.18,11044.13,0.00
2024-12-10 17:41:52,67,8613,29,38,6298.25,11045.00,0.00
2024-12-10 17:41:52,68,8613,30,38,6205.63,11045.01,0.00
2024-12-10 17:41:52,67,8613,30,37,6215.16,11045.36,0.00
2024-12-10 17:41:52,67,8614,30,37,6252.77,11046.00,0.00
2024-12-10 17:41:52,68,8614,30,38,6160.82,11046.01,0.00
2024-12-10 17:41:52,67,8614,30,37,6216.54,11046.13,0.00
2024-12-10 17:41:52,67,8615,30,37,6220.36,11047.00,0.00
2024-12-10 17:41:52,68,8615,30,38,6128.89,11047.01,0.00
2024-12-10 17:41:52,67,8615,29,38,6169.30,11047.18,0.00
2024-12-10 17:41:52,67,8616,29,38,6191.36,11048.00,0.00
2024-12-10 17:41:52,68,8616,30,38,6100.31,11048.01,0.00
2024-12-10 17:41:52,67,8616,30,37,6146.88,11048.16,0.00
2024-12-10 17:41:52,66,8616,29,37,6240.02,11048.17,0.00
2024-12-10 17:41:52,66,8617,29,37,6248.90,11049.00,0.00
2024-12-10 17:41:52,67,8617,29,38,6155.64,11049.01,0.00
2024-12-10 17:41:52,67,8618,29,38,6128.20,11050.00,0.00
2024-12-10 17:41:52,68,8618,29,39,6038.08,11050.01,0.00
2024-12-10 17:41:52,67,8618,29,38,6078.77,11050.18,0.00
2024-12-10 17:41:52,67,8619,29,38,6087.52,11051.00,0.00
2024-12-10 17:41:52,68,8619,30,38,5997.99,11051.01,0.00
2024-12-10 17:41:52,67,8619,29,38,5931.20,11051.85,0.00
2024-12-10 17:41:52,67,8620,29,38,6079.78,11052.00,0.00
2024-12-10 17:41:52,68,8620,29,39,5990.37,11052.01,0.00
2024-12-10 17:41:52,67,8620,28,39,6078.13,11052.01,0.00
2024-12-10 17:41:52,66,8620,28,38,6123.38,11052.17,0.00
2024-12-10 17:41:52,66,8621,28,38,6131.08,11053.00,0.00
2024-12-10 17:41:52,67,8621,29,38,6039.57,11053.01,0.00
2024-12-10 17:41:52,67,8622,29,38,6004.25,11054.00,0.00
2024-12-10 17:41:52,68,8622,29,39,5915.96,11054.01,0.00
2024-12-10 17:41:52,67,8622,29,38,5959.75,11054.16,0.00
2024-12-10 17:41:52,67,8623,29,38,5959.71,11055.00,0.00
2024-12-10 17:41:52,68,8623,30,38,5872.06,11055.01,0.00
2024-12-10 17:41:52,67,8623,29,38,5958.06,11055.01,0.00
2024-12-10 17:41:52,66,8623,28,38,6046.66,11055.02,0.00
2024-12-10 17:41:52,65,8623,27,38,6032.14,11055.35,0.00
2024-12-10 17:41:52,65,8624,27,38,6127.87,11056.00,0.00
2024-12-10 17:41:52,66,8624,27,39,6035.02,11056.02,0.00
2024-12-10 17:41:52,65,8624,27,38,6078.59,11056.17,0.00
2024-12-10 17:41:52,64,8624,27,37,6161.30,11056.22,0.00
2024-12-10 17:41:52,64,8625,27,37,6179.06,11057.00,0.00
2024-12-10 17:41:52,65,8625,27,38,6084.00,11057.02,0.00
2024-12-10 17:41:52,65,8626,27,38,6060.52,11058.00,0.00
2024-12-10 17:41:52,66,8626,27,39,5968.69,11058.02,0.00
2024-12-10 17:41:52,65,8626,26,39,6035.25,11058.15,0.00
2024-12-10 17:41:52,64,8626,26,38,6093.28,11058.17,0.00
2024-12-10 17:41:52,63,8626,25,38,6135.85,11058.67,0.00
2024-12-10 17:41:52,63,8627,25,38,6274.77,11059.00,0.00
2024-12-10 17:41:52,64,8627,26,38,6176.72,11059.02,0.00
2024-12-10 17:41:52,64,8628,26,38,6148.40,11060.00,0.00
2024-12-10 17:41:52,65,8628,27,38,6053.81,11060.02,0.00
2024-12-10 17:41:52,64,8628,27,37,6098.74,11060.22,0.00
2024-12-10 17:41:52,63,8628,26,37,6163.31,11060.29,0.00
2024-12-10 17:41:52,63,8629,26,37,6260.34,11061.00,0.00
2024-12-10 17:41:52,64,8629,27,37,6162.53,11061.02,0.00
2024-12-10 17:41:53,63,8629,27,36,6254.81,11061.06,0.00
2024-12-10 17:41:53,62,8629,26,36,6251.50,11061.63,0.00
2024-12-10 17:41:53,62,8630,26,36,6389.17,11062.00,0.00
2024-12-10 17:41:53,63,8630,26,37,6287.75,11062.02,0.00
2024-12-10 17:41:53,62,8630,26,36,6367.79,11062.11,0.00
2024-12-10 17:41:53,62,8631,26,36,6377.25,11063.00,0.00
2024-12-10 17:41:53,63,8631,26,37,6276.02,11063.02,0.00
2024-12-10 17:41:53,63,8632,26,37,6265.71,11064.00,0.00
2024-12-10 17:41:53,64,8632,27,37,6167.80,11064.02,0.00
2024-12-10 17:41:53,63,8632,26,37,6120.44,11064.41,0.00
2024-12-10 17:41:53,63,8633,26,37,6231.49,11065.00,0.00
2024-12-10 17:41:53,64,8633,26,38,6134.13,11065.02,0.00
2024-12-10 17:41:53,63,8633,25,38,6213.98,11065.17,0.00
2024-12-10 17:41:53,62,8633,25,37,6291.03,11065.24,0.00
2024-12-10 17:41:53,62,8633,25,37,6314.73,11066.00,0.00
2024-12-10 17:41:53,63,8633,25,38,6214.49,11066.02,0.00
2024-12-10 17:41:53,62,8633,24,38,6200.63,11066.39,0.00
2024-12-10 17:41:53,62,8634,24,38,6311.73,11067.00,0.00
2024-12-10 17:41:53,63,8634,24,39,6211.54,11067.02,0.00
2024-12-10 17:41:53,62,8634,23,39,6134.43,11067.66,0.00
2024-12-10 17:41:53,62,8635,23,39,6275.71,11068.00,0.00
2024-12-10 17:41:53,63,8635,24,39,6176.09,11068.02,0.00
2024-12-10 17:41:53,62,8635,24,38,6232.45,11068.24,0.00
2024-12-10 17:41:53,63,8634,25,38,6102.05,11068.56,0.00
2024-12-10 17:41:53,63,8635,25,38,6207.81,11069.00,0.00
2024-12-10 17:41:53,64,8635,26,38,6110.81,11069.02,0.00
2024-12-10 17:41:53,63,8635,25,38,6197.17,11069.11,0.00
2024-12-10 17:41:53,63,8636,25,38,6366.37,11070.00,0.00
2024-12-10 17:41:53,64,8636,26,38,6266.89,11070.02,0.00
2024-12-10 17:41:53,64,8637,26,38,6223.42,11071.00,0.00
2024-12-10 17:41:53,65,8637,27,38,6127.68,11071.02,0.00
2024-12-10 17:41:53,64,8637,27,37,6188.36,11071.22,0.00
2024-12-10 17:41:53,64,8638,27,37,6204.23,11072.00,0.00
2024-12-10 17:41:53,65,8638,27,38,6108.78,11072.02,0.00
2024-12-10 17:41:53,64,8638,26,38,6199.06,11072.05,0.00
2024-12-10 17:41:53,63,8638,26,37,6295.76,11072.05,0.00
2024-12-10 17:41:53,62,8638,25,37,6337.32,11072.21,0.00
2024-12-10 17:41:53,62,8639,25,37,6388.35,11073.00,0.00
2024-12-10 17:41:53,63,8639,26,37,6286.94,11073.02,0.00
2024-12-10 17:41:53,63,8640,26,37,6240.94,11074.00,0.00
2024-12-10 17:41:53,64,8640,27,37,6143.42,11074.02,0.00
2024-12-10 17:41:53,65,8639,28,37,6048.91,11074.05,0.00
2024-12-10 17:41:53,64,8639,28,36,6169.89,11074.25,0.00
2024-12-10 17:41:53,65,8638,29,36,6063.09,11074.38,0.00
2024-12-10 17:41:53,65,8639,29,36,6156.92,11075.00,0.00
2024-12-10 17:41:53,66,8639,29,37,6063.64,11075.02,0.00
2024-12-10 17:41:53,66,8640,29,37,6394.16,11076.00,0.00
2024-12-10 17:41:53,67,8640,29,38,6298.72,11076.01,0.00
2024-12-10 17:41:53,67,8641,29,38,6269.04,11077.00,0.00
2024-12-10 17:41:53,68,8641,30,38,6176.85,11077.01,0.00
2024-12-10 17:41:53,68,8642,30,38,6105.85,11078.00,0.00
2024-12-10 17:41:53,69,8642,30,39,6017.36,11078.01,0.00
2024-12-10 17:41:53,70,8641,31,39,5868.18,11078.33,0.00
2024-12-10 17:41:53,70,8642,31,39,5940.23,11079.00,0.00
2024-12-10 17:41:53,71,8642,32,39,5856.56,11079.01,0.00
2024-12-10 17:41:53,70,8642,32,38,5914.90,11079.01,0.00
2024-12-10 17:41:53,69,8642,32,37,5841.41,11079.87,0.00
2024-12-10 17:41:53,69,8643,32,37,6041.61,11080.00,0.00
2024-12-10 17:41:53,70,8643,32,38,5955.31,11080.01,0.00
2024-12-10 17:41:53,69,8643,31,38,5919.76,11080.46,0.00
2024-12-10 17:41:53,68,8643,30,38,5998.04,11080.54,0.00
2024-12-10 17:41:53,67,8643,29,38,6071.53,11080.60,0.00
2024-12-10 17:41:53,66,8643,28,38,6119.03,11080.86,0.00
2024-12-10 17:41:53,66,8644,28,38,6271.91,11081.00,0.00
2024-12-10 17:41:53,67,8644,28,39,6178.30,11081.01,0.00
2024-12-10 17:41:53,66,8644,28,38,6268.56,11081.03,0.00
2024-12-10 17:41:53,66,8645,28,38,6214.29,11082.00,0.00
2024-12-10 17:41:53,67,8645,28,39,6121.54,11082.01,0.00
2024-12-10 17:41:53,66,8645,28,38,6190.82,11082.20,0.00
2024-12-10 17:41:53,66,8646,28,38,6176.84,11083.00,0.00
2024-12-10 17:41:53,67,8646,29,38,6084.65,11083.01,0.00
2024-12-10 17:41:53,66,8646,28,38,6173.49,11083.03,0.00
2024-12-10 17:41:53,65,8646,27,38,6181.57,11083.26,0.00
2024-12-10 17:41:53,65,8647,27,38,6231.00,11084.00,0.00
2024-12-10 17:41:53,66,8647,27,39,6136.59,11084.02,0.00
2024-12-10 17:41:53,65,8647,27,38,6124.63,11084.55,0.00
2024-12-10 17:41:53,65,8648,27,38,6131.83,11085.00,0.00
2024-12-10 17:41:53,66,8648,27,39,6038.93,11085.02,0.00
2024-12-10 17:41:53,65,8648,26,39,6113.11,11085.18,0.00
2024-12-10 17:41:53,64,8648,26,38,6201.70,11085.19,0.00
2024-12-10 17:41:53,63,8648,25,38,6163.57,11085.79,0.00
2024-12-10 17:41:53,63,8649,25,38,6246.43,11086.00,0.00
2024-12-10 17:41:53,64,8649,26,38,6148.83,11086.02,0.00
2024-12-10 17:41:53,64,8650,26,38,6130.29,11087.00,0.00
2024-12-10 17:41:53,65,8650,27,38,6035.97,11087.02,0.00
2024-12-10 17:41:53,65,8651,27,38,5995.58,11088.00,0.00
2024-12-10 17:41:53,66,8651,28,38,5904.74,11088.02,0.00
2024-12-10 17:41:53,65,8651,28,37,5973.44,11088.18,0.00
2024-12-10 17:41:53,65,8652,28,37,5985.88,11089.00,0.00
2024-12-10 17:41:53,66,8652,28,38,5895.19,11089.02,0.00
2024-12-10 17:41:53,65,8652,27,38,5826.00,11089.92,0.00
2024-12-10 17:41:53,65,8653,27,38,5988.13,11090.00,0.00
2024-12-10 17:41:53,66,8653,27,39,5897.40,11090.02,0.00
2024-12-10 17:41:53,65,8653,27,38,5979.52,11090.09,0.00
2024-12-10 17:41:53,64,8653,27,37,6027.91,11090.17,0.00
2024-12-10 17:41:53,64,8654,27,37,6040.56,11091.00,0.00
2024-12-10 17:41:53,65,8654,27,38,5947.62,11091.02,0.00
2024-12-10 17:41:53,65,8655,27,38,5958.87,11092.00,0.00
2024-12-10 17:41:53,66,8655,28,38,5868.58,11092.02,0.00
2024-12-10 17:41:53,67,8654,29,38,5728.06,11092.22,0.00
2024-12-10 17:41:53,66,8654,28,38,5826.57,11092.92,0.00
2024-12-10 17:41:53,66,8655,28,38,5986.30,11093.00,0.00
2024-12-10 17:41:53,67,8655,29,38,5896.95,11093.01,0.00
2024-12-10 17:41:53,67,8656,29,38,6040.80,11094.00,0.00
2024-12-10 17:41:53,68,8656,29,39,5951.97,11094.01,0.00
2024-12-10 17:41:53,67,8656,29,38,5987.38,11094.18,0.00
2024-12-10 17:41:54,67,8657,29,38,5996.17,11095.00,0.00
2024-12-10 17:41:54,68,8657,29,39,5907.99,11095.01,0.00
2024-12-10 17:41:54,67,8657,28,39,5992.86,11095.03,0.00
2024-12-10 17:41:54,66,8657,27,39,6032.67,11095.18,0.00
2024-12-10 17:41:54,66,8658,27,39,6097.00,11096.00,0.00
2024-12-10 17:41:54,67,8658,27,40,6006.00,11096.01,0.00
2024-12-10 17:41:54,66,8658,27,39,6094.47,11096.03,0.00
2024-12-10 17:41:54,67,8657,27,40,5996.89,11096.12,0.00
2024-12-10 17:41:54,67,8658,27,40,6142.93,11097.00,0.00
2024-12-10 17:41:54,68,8658,27,41,6052.59,11097.01,0.00
2024-12-10 17:41:54,68,8659,27,41,6206.48,11098.00,0.00
2024-12-10 17:41:54,69,8659,27,42,6116.53,11098.01,0.00
2024-12-10 17:41:54,69,8660,27,42,6081.88,11099.00,0.00
2024-12-10 17:41:54,70,8660,28,42,5994.99,11099.01,0.00
2024-12-10 17:41:54,69,8660,28,41,6044.91,11099.14,0.00
2024-12-10 17:41:54,68,8660,27,41,6015.27,11099.90,0.00
2024-12-10 17:41:54,68,8661,27,41,6167.16,11100.00,0.00
2024-12-10 17:41:54,69,8661,27,42,6077.78,11100.01,0.00
2024-12-10 17:41:54,68,8661,26,42,6082.34,11100.49,0.00
2024-12-10 17:41:54,68,8662,26,42,6136.66,11101.00,0.00
2024-12-10 17:41:54,69,8662,26,43,6047.73,11101.01,0.00
2024-12-10 17:41:54,68,8662,26,42,6094.25,11101.16,0.00
2024-12-10 17:41:54,67,8662,25,42,6084.23,11101.54,0.00
2024-12-10 17:41:54,67,8663,25,42,6198.90,11102.00,0.00
2024-12-10 17:41:54,68,8663,25,43,6107.74,11102.01,0.00
2024-12-10 17:41:54,68,8664,25,43,6106.20,11103.00,0.00
2024-12-10 17:41:54,69,8664,26,43,6017.70,11103.01,0.00
2024-12-10 17:41:54,68,8664,26,42,6102.93,11103.03,0.00
2024-12-10 17:41:54,68,8665,26,42,6079.54,11104.00,0.00
2024-12-10 17:41:54,69,8665,26,43,5991.43,11104.01,0.00
2024-12-10 17:41:54,69,8666,26,43,5928.03,11105.00,0.00
2024-12-10 17:41:54,70,8666,26,44,5843.34,11105.01,0.00
2024-12-10 17:41:54,69,8666,25,44,5918.09,11105.10,0.00
2024-12-10 17:41:54,68,8666,25,43,5995.33,11105.13,0.00
2024-12-10 17:41:54,67,8666,24,43,6032.18,11105.60,0.00
2024-12-10 17:41:54,67,8667,24,43,6087.19,11106.00,0.00
2024-12-10 17:41:54,68,8667,24,44,5997.68,11106.01,0.00
2024-12-10 17:41:54,67,8667,23,44,6047.41,11106.01,0.00
2024-12-10 17:41:54,66,8667,23,43,6137.36,11106.02,0.00
2024-12-10 17:41:54,66,8668,23,43,6163.15,11107.00,0.00
2024-12-10 17:41:54,67,8668,23,44,6071.16,11107.01,0.00
2024-12-10 17:41:54,66,8668,22,44,6011.91,11107.59,0.00
2024-12-10 17:41:54,66,8669,22,44,6135.10,11108.00,0.00
2024-12-10 17:41:54,67,8669,23,44,6043.53,11108.01,0.00
2024-12-10 17:41:54,66,8669,23,43,6091.38,11108.17,0.00
2024-12-10 17:41:54,65,8669,22,43,6179.97,11108.20,0.00
2024-12-10 17:41:54,65,8670,22,43,6194.15,11109.00,0.00
2024-12-10 17:41:54,66,8670,23,43,6100.30,11109.02,0.00
2024-12-10 17:41:54,65,8670,23,42,6192.44,11109.02,0.00
2024-12-10 17:41:54,66,8669,24,42,6009.54,11109.53,0.00
2024-12-10 17:41:54,66,8670,24,42,6128.93,11110.00,0.00
2024-12-10 17:41:54,67,8670,24,43,6037.45,11110.01,0.00
2024-12-10 17:41:54,66,8670,24,42,6127.25,11110.02,0.00
2024-12-10 17:41:54,65,8670,24,41,6178.09,11110.14,0.00
2024-12-10 17:41:54,65,8671,24,41,6356.39,11111.00,0.00
2024-12-10 17:41:54,66,8671,24,42,6260.08,11111.02,0.00
2024-12-10 17:41:54,65,8671,23,42,6342.87,11111.03,0.00
2024-12-10 17:41:54,65,8672,23,42,6372.49,11112.00,0.00
2024-12-10 17:41:54,66,8672,24,42,6275.93,11112.02,0.00
2024-12-10 17:41:54,65,8672,23,42,6316.12,11112.18,0.00
2024-12-10 17:41:54,65,8673,23,42,6397.00,11113.00,0.00
2024-12-10 17:41:54,66,8673,23,43,6300.07,11113.02,0.00
2024-12-10 17:41:54,65,8673,23,42,6354.29,11113.14,0.00
2024-12-10 17:41:54,65,8674,23,42,6361.67,11114.00,0.00
2024-12-10 17:41:54,66,8674,24,42,6265.28,11114.02,0.00
2024-12-10 17:41:54,66,8675,24,42,6240.05,11115.00,0.00
2024-12-10 17:41:54,67,8675,25,42,6146.91,11115.01,0.00
2024-12-10 17:41:54,66,8675,25,41,6189.57,11115.17,0.00
2024-12-10 17:41:54,65,8675,24,41,6149.02,11115.97,0.00
2024-12-10 17:41:54,65,8676,24,41,6316.64,11116.00,0.00
2024-12-10 17:41:54,66,8676,24,42,6220.93,11116.02,0.00
2024-12-10 17:41:54,65,8676,23,42,6221.59,11116.55,0.00
2024-12-10 17:41:54,65,8677,23,42,6285.70,11117.00,0.00
2024-12-10 17:41:54,66,8677,23,43,6190.46,11117.02,0.00
2024-12-10 17:41:54,65,8677,23,42,6246.37,11117.14,0.00
2024-12-10 17:41:54,65,8678,23,42,6253.75,11118.00,0.00
2024-12-10 17:41:54,66,8678,24,42,6158.99,11118.02,0.00
2024-12-10 17:41:54,67,8677,25,42,6006.44,11118.21,0.00
2024-12-10 17:41:54,66,8677,24,42,6069.55,11118.97,0.00
2024-12-10 17:41:54,66,8678,24,42,6234.66,11119.00,0.00
2024-12-10 17:41:54,67,8678,25,42,6141.61,11119.01,0.00
2024-12-10 17:41:54,66,8678,25,41,6212.73,11119.06,0.00
2024-12-10 17:41:54,65,8678,25,40,6277.53,11119.12,0.00
2024-12-10 17:41:54,65,8679,25,40,6444.57,11120.00,0.00
2024-12-10 17:41:54,66,8679,25,41,6346.92,11120.02,0.00
2024-12-10 17:41:54,65,8679,25,40,6401.77,11120.11,0.00
2024-12-10 17:41:54,66,8678,25,41,6298.07,11120.20,0.00
2024-12-10 17:41:54,67,8677,26,41,6358.47,11120.30,0.00
2024-12-10 17:41:54,67,8678,26,41,6509.98,11121.00,0.00
2024-12-10 17:41:54,68,8678,27,41,6414.25,11121.01,0.00
2024-12-10 17:41:54,67,8678,26,41,6410.73,11121.28,0.00
2024-12-10 17:41:54,67,8679,26,41,6793.03,11122.00,0.00
2024-12-10 17:41:54,68,8679,27,41,6693.13,11122.01,0.00
2024-12-10 17:41:54,67,8679,27,40,6715.58,11122.18,0.00
2024-12-10 17:41:54,67,8680,27,40,6675.36,11123.00,0.00
2024-12-10 17:41:54,68,8680,28,40,6577.19,11123.01,0.00
2024-12-10 17:41:54,67,8680,28,39,6541.77,11123.58,0.00
2024-12-10 17:41:54,67,8681,28,39,6608.30,11124.00,0.00
2024-12-10 17:41:54,68,8681,28,40,6511.11,11124.01,0.00
2024-12-10 17:41:54,67,8681,27,40,6607.18,11124.01,0.00
2024-12-10 17:41:54,66,8681,27,39,6656.77,11124.17,0.00
2024-12-10 17:41:54,67,8680,27,40,6542.54,11124.33,0.00
2024-12-10 17:41:54,68,8679,27,41,6498.81,11124.57,0.00
2024-12-10 17:41:54,67,8679,26,41,6629.31,11124.67,0.00
2024-12-10 17:41:54,67,8680,26,41,6692.67,11125.00,0.00
2024-12-10 17:41:54,68,8680,26,42,6594.25,11125.01,0.00
2024-12-10 17:41:54,67,8680,25,42,6656.15,11125.07,0.00
2024-12-10 17:41:55,66,8680,24,42,6678.74,11125.47,0.00
2024-12-10 17:41:55,66,8681,24,42,7125.85,11126.00,0.00
2024-12-10 17:41:55,67,8681,25,42,7019.49,11126.01,0.00
2024-12-10 17:41:55,66,8681,25,41,7077.01,11126.15,0.00
2024-12-10 17:41:55,66,8682,25,41,7084.34,11127.00,0.00
2024-12-10 17:41:55,67,8682,26,41,6978.60,11127.01,0.00
2024-12-10 17:41:55,67,8683,26,41,6944.49,11128.00,0.00
2024-12-10 17:41:55,68,8683,26,42,6842.37,11128.01,0.00
2024-12-10 17:41:55,67,8683,26,41,6894.71,11128.16,0.00
2024-12-10 17:41:55,67,8684,26,41,6901.93,11129.00,0.00
2024-12-10 17:41:55,68,8684,26,42,6800.43,11129.01,0.00
2024-12-10 17:41:55,68,8685,26,42,6802.78,11130.00,0.00
2024-12-10 17:41:55,69,8685,27,42,6704.19,11130.01,0.00
2024-12-10 17:41:55,68,8685,27,41,6801.14,11130.01,0.00
2024-12-10 17:41:55,67,8685,26,41,6886.10,11130.16,0.00
2024-12-10 17:41:55,67,8686,26,41,6893.04,11131.00,0.00
2024-12-10 17:41:55,68,8686,26,42,6791.67,11131.01,0.00
2024-12-10 17:41:55,68,8687,26,42,6755.25,11132.00,0.00
2024-12-10 17:41:55,69,8687,27,42,6657.34,11132.01,0.00
2024-12-10 17:41:55,70,8686,27,43,6544.81,11132.20,0.00
2024-12-10 17:41:55,69,8686,27,42,6761.91,11132.22,0.00
2024-12-10 17:41:55,69,8687,27,42,6772.12,11133.00,0.00
2024-12-10 17:41:55,70,8687,27,43,6675.37,11133.01,0.00
2024-12-10 17:41:55,70,8688,27,43,6805.30,11134.00,0.00
2024-12-10 17:41:55,71,8688,28,43,6709.45,11134.01,0.00
2024-12-10 17:41:55,71,8689,28,43,6663.00,11135.00,0.00
2024-12-10 17:41:55,72,8689,28,44,6570.46,11135.01,0.00
2024-12-10 17:41:55,71,8689,27,44,6661.43,11135.01,0.00
2024-12-10 17:41:55,70,8689,27,43,6729.64,11135.20,0.00
2024-12-10 17:41:55,70,8690,27,43,6736.52,11136.00,0.00
2024-12-10 17:41:55,71,8690,28,43,6641.64,11136.01,0.00
2024-12-10 17:41:55,72,8689,29,43,6481.50,11136.38,0.00
2024-12-10 17:41:55,72,8690,29,43,6585.31,11137.00,0.00
2024-12-10 17:41:55,73,8690,29,44,6495.10,11137.01,0.00
2024-12-10 17:41:55,72,8690,29,43,6579.12,11137.01,0.00
2024-12-10 17:41:55,72,8691,29,43,6717.39,11138.00,0.00
2024-12-10 17:41:55,73,8691,30,43,6625.37,11138.01,0.00
2024-12-10 17:41:55,72,8691,30,42,6711.20,11138.01,0.00
2024-12-10 17:41:55,72,8692,30,42,6694.78,11139.00,0.00
2024-12-10 17:41:55,73,8692,31,42,6603.08,11139.01,0.00
2024-12-10 17:41:56,72,8692,30,42,6608.66,11139.50,0.00
2024-12-10 17:41:56,72,8693,30,42,6646.13,11140.00,0.00
2024-12-10 17:41:56,73,8693,30,43,6555.09,11140.01,0.00
2024-12-10 17:41:56,72,8693,30,42,6627.59,11140.08,0.00
2024-12-10 17:41:56,73,8692,30,43,6536.80,11140.11,0.00
2024-12-10 17:41:56,73,8693,30,43,6558.73,11141.00,0.00
2024-12-10 17:41:56,74,8693,31,43,6470.10,11141.01,0.00
2024-12-10 17:41:56,74,8694,31,43,6582.80,11142.00,0.00
2024-12-10 17:41:56,75,8694,31,44,6495.03,11142.01,0.00
2024-12-10 17:41:56,74,8694,31,43,6537.70,11142.16,0.00
2024-12-10 17:41:56,74,8695,31,43,6535.20,11143.00,0.00
2024-12-10 17:41:56,75,8695,31,44,6448.07,11143.01,0.00
2024-12-10 17:41:56,74,8695,30,44,6430.16,11143.68,0.00
2024-12-10 17:41:56,73,8695,29,44,6466.50,11143.93,0.00
2024-12-10 17:41:56,73,8696,29,44,6611.58,11144.00,0.00
2024-12-10 17:41:56,74,8696,30,44,6522.24,11144.01,0.00
2024-12-10 17:41:56,73,8696,30,43,6564.98,11144.16,0.00
2024-12-10 17:41:56,73,8697,30,43,6563.97,11145.00,0.00
2024-12-10 17:41:56,74,8697,31,43,6475.26,11145.01,0.00
2024-12-10 17:41:56,73,8697,31,42,6514.43,11145.16,0.00
2024-12-10 17:41:56,72,8697,30,42,6507.81,11145.88,0.00
2024-12-10 17:41:56,72,8698,30,42,6648.77,11146.00,0.00
2024-12-10 17:41:56,73,8698,30,43,6557.69,11146.01,0.00
2024-12-10 17:41:56,72,8698,29,43,6626.56,11146.13,0.00
2024-12-10 17:41:56,73,8697,30,43,6474.85,11146.42,0.00
2024-12-10 17:41:56,73,8697,30,43,6570.89,11147.00,0.00
2024-12-10 17:41:56,74,8697,31,43,6482.09,11147.01,0.00
2024-12-10 17:41:56,73,8697,31,42,6516.79,11147.15,0.00
2024-12-10 17:41:56,72,8697,30,42,6556.34,11147.61,0.00
2024-12-10 17:41:56,72,8698,30,42,6760.98,11148.00,0.00
2024-12-10 17:41:56,73,8698,31,42,6668.36,11148.01,0.00
2024-12-10 17:41:56,72,8698,30,42,6573.58,11148.96,0.00
2024-12-10 17:41:56,72,8699,30,42,6723.81,11149.00,0.00
2024-12-10 17:41:56,73,8699,30,43,6631.70,11149.01,0.00
2024-12-10 17:41:56,72,8699,30,42,6662.45,11149.15,0.00
2024-12-10 17:41:56,72,8700,30,42,6661.44,11150.00,0.00
2024-12-10 17:41:56,73,8700,30,43,6570.19,11150.01,0.00
2024-12-10 17:41:56,74,8699,30,44,6451.77,11150.09,0.00
2024-12-10 17:41:56,74,8700,30,44,6464.51,11151.00,0.00
2024-12-10 17:41:56,75,8700,31,44,6378.31,11151.01,0.00
2024-12-10 17:41:56,74,8700,30,44,6443.48,11151.04,0.00
2024-12-10 17:41:56,73,8700,30,43,6490.56,11151.15,0.00
2024-12-10 17:41:56,73,8701,30,43,6640.79,11152.00,0.00
2024-12-10 17:41:56,74,8701,31,43,6551.05,11152.01,0.00
2024-12-10 17:41:56,74,8702,31,43,6510.95,11153.00,0.00
2024-12-10 17:41:56,75,8702,32,43,6424.14,11153.01,0.00
2024-12-10 17:41:56,74,8702,32,42,6468.81,11153.15,0.00
2024-12-10 17:41:57,74,8703,32,42,6464.81,11154.00,0.00
2024-12-10 17:41:57,75,8703,32,43,6378.61,11154.01,0.00
2024-12-10 17:41:57,74,8703,31,43,6305.52,11154.91,0.00
2024-12-10 17:41:57,74,8704,31,43,6445.79,11155.00,0.00
2024-12-10 17:41:57,75,8704,32,43,6359.84,11155.01,0.00
2024-12-10 17:41:57,74,8704,32,42,6405.14,11155.15,0.00
2024-12-10 17:41:57,73,8704,31,42,6436.05,11155.66,0.00
2024-12-10 17:41:57,73,8705,31,42,6489.78,11156.00,0.00
2024-12-10 17:41:57,74,8705,31,43,6402.08,11156.01,0.00
2024-12-10 17:41:57,74,8706,31,43,6391.90,11157.00,0.00
2024-12-10 17:41:57,75,8706,31,44,6306.67,11157.01,0.00
2024-12-10 17:41:57,74,8706,31,43,6390.39,11157.01,0.00
2024-12-10 17:41:57,74,8707,31,43,6362.25,11158.00,0.00
2024-12-10 17:41:57,75,8707,31,44,6277.42,11158.01,0.00
2024-12-10 17:41:57,74,8707,31,43,6360.74,11158.01,0.00
2024-12-10 17:41:57,73,8707,30,43,6365.74,11158.32,0.00
2024-12-10 17:41:57,73,8708,30,43,6442.60,11159.00,0.00
2024-12-10 17:41:57,74,8708,31,43,6355.54,11159.01,0.00
2024-12-10 17:41:57,73,8708,30,43,6327.58,11159.70,0.00
2024-12-10 17:41:57,73,8709,30,43,6447.05,11160.00,0.00
2024-12-10 17:41:57,74,8709,31,43,6359.93,11160.01,0.00
2024-12-10 17:41:57,73,8709,30,43,6445.53,11160.01,0.00
2024-12-10 17:41:57,73,8710,30,43,6427.77,11161.00,0.00
2024-12-10 17:41:57,74,8710,31,43,6340.91,11161.01,0.00
2024-12-10 17:41:57,74,8711,31,43,6298.73,11162.00,0.00
2024-12-10 17:41:57,75,8711,31,44,6214.75,11162.01,0.00
2024-12-10 17:41:57,74,8711,31,43,6264.08,11162.12,0.00
2024-12-10 17:41:57,74,8712,31,43,6257.06,11163.00,0.00
2024-12-10 17:41:57,75,8712,31,44,6173.63,11163.01,0.00
2024-12-10 17:41:57,74,8712,30,44,6201.49,11163.18,0.00
2024-12-10 17:41:57,73,8712,29,44,6240.29,11163.59,0.00
2024-12-10 17:41:57,73,8713,29,44,6347.64,11164.00,0.00
2024-12-10 17:41:57,74,8713,30,44,6261.86,11164.01,0.00
2024-12-10 17:41:57,73,8713,30,43,6340.03,11164.07,0.00
2024-12-10 17:41:57,72,8713,29,43,6272.48,11164.94,0.00
2024-12-10 17:41:57,72,8714,29,43,6421.39,11165.00,0.00
2024-12-10 17:41:57,73,8714,30,43,6333.42,11165.01,0.00
2024-12-10 17:41:57,73,8715,30,43,6296.47,11166.00,0.00
2024-12-10 17:41:57,74,8715,30,44,6211.38,11166.01,0.00
2024-12-10 17:41:57,73,8715,30,43,6255.21,11166.12,0.00
2024-12-10 17:41:57,74,8714,31,43,6118.09,11166.62,0.00
2024-12-10 17:41:57,73,8714,30,43,6185.97,11166.75,0.00
2024-12-10 17:41:57,73,8715,30,43,6311.61,11167.00,0.00
2024-12-10 17:41:57,74,8715,30,44,6226.31,11167.01,0.00
2024-12-10 17:41:57,73,8715,29,44,6300.92,11167.04,0.00
2024-12-10 17:41:57,73,8716,29,44,6469.75,11168.00,0.00
2024-12-10 17:41:57,74,8716,30,44,6382.32,11168.01,0.00
2024-12-10 17:41:57,75,8715,31,44,6219.39,11168.45,0.00
2024-12-10 17:41:57,75,8716,31,44,6314.27,11169.00,0.00
2024-12-10 17:41:57,76,8716,32,44,6231.19,11169.01,0.00
2024-12-10 17:41:57,75,8716,32,43,6294.95,11169.09,0.00
2024-12-10 17:41:57,75,8717,32,43,6426.32,11170.00,0.00
2024-12-10 17:41:57,76,8717,33,43,6341.76,11170.01,0.00
2024-12-10 17:41:57,75,8717,33,42,6405.50,11170.09,0.00
2024-12-10 17:41:57,75,8718,33,42,6388.03,11171.00,0.00
2024-12-10 17:41:57,76,8718,34,42,6303.98,11171.01,0.00
2024-12-10 17:41:57,75,8718,34,41,6367.21,11171.09,0.00
2024-12-10 17:41:57,74,8718,33,41,6387.54,11171.65,0.00
2024-12-10 17:41:57,74,8719,33,41,6439.15,11172.00,0.00
2024-12-10 17:41:57,75,8719,34,41,6353.29,11172.01,0.00
2024-12-10 17:41:57,75,8720,34,41,6301.75,11173.00,0.00
2024-12-10 17:41:57,76,8720,34,42,6218.83,11173.01,0.00
2024-12-10 17:41:57,75,8720,34,41,6280.92,11173.09,0.00
2024-12-10 17:41:57,74,8720,33,41,6321.68,11173.35,0.00
2024-12-10 17:41:57,74,8721,33,41,6400.64,11174.00,0.00
2024-12-10 17:41:57,75,8721,33,42,6315.30,11174.01,0.00
2024-12-10 17:41:57,75,8722,33,42,6265.38,11175.00,0.00
2024-12-10 17:41:57,76,8722,33,43,6182.94,11175.01,0.00
2024-12-10 17:41:57,75,8722,33,42,6246.04,11175.09,0.00
2024-12-10 17:41:57,75,8723,33,42,6234.65,11176.00,0.00
2024-12-10 17:41:57,76,8723,33,43,6152.61,11176.01,0.00
2024-12-10 17:41:58,76,8724,33,43,6102.65,11177.00,0.00
2024-12-10 17:41:58,77,8724,33,44,6023.40,11177.01,0.00
2024-12-10 17:41:58,76,8724,33,43,6085.03,11177.09,0.00
2024-12-10 17:41:58,75,8724,32,43,6158.88,11177.15,0.00
2024-12-10 17:41:58,75,8725,32,43,6153.42,11178.00,0.00
2024-12-10 17:41:58,76,8725,33,43,6072.45,11178.01,0.00
2024-12-10 17:41:58,77,8724,34,43,5935.60,11178.30,0.00
2024-12-10 17:41:58,77,8725,34,43,6029.51,11179.00,0.00
2024-12-10 17:41:58,78,8725,34,44,5952.21,11179.01,0.00
2024-12-10 17:41:58,77,8725,33,44,6023.73,11179.05,0.00
2024-12-10 17:41:58,76,8725,33,43,6091.23,11179.08,0.00
2024-12-10 17:41:58,75,8725,32,43,6159.07,11179.20,0.00
2024-12-10 17:41:58,75,8726,32,43,6308.62,11180.00,0.00
2024-12-10 17:41:58,76,8726,33,43,6225.61,11180.01,0.00
2024-12-10 17:41:58,75,8726,32,43,6196.88,11180.21,0.00
2024-12-10 17:41:58,75,8727,32,43,6258.49,11181.00,0.00
2024-12-10 17:41:58,76,8727,32,44,6176.14,11181.01,0.00
2024-12-10 17:41:58,75,8727,32,43,6243.61,11181.08,0.00
2024-12-10 17:41:58,74,8727,31,43,6259.30,11181.69,0.00
2024-12-10 17:41:58,74,8728,31,43,6315.45,11182.00,0.00
2024-12-10 17:41:58,75,8728,32,43,6231.24,11182.01,0.00
2024-12-10 17:41:58,75,8729,32,43,6218.31,11183.00,0.00
2024-12-10 17:41:58,76,8729,33,43,6136.49,11183.01,0.00
2024-12-10 17:41:58,77,8728,34,43,5946.77,11183.77,0.00
2024-12-10 17:41:58,77,8729,34,43,6049.06,11184.00,0.00
2024-12-10 17:41:58,78,8729,34,44,5971.51,11184.01,0.00
2024-12-10 17:41:58,78,8730,34,44,6062.39,11185.00,0.00
2024-12-10 17:41:58,79,8730,35,44,5985.65,11185.01,0.00
2024-12-10 17:41:58,78,8730,35,43,6052.37,11185.08,0.00
2024-12-10 17:41:58,77,8730,34,43,5988.67,11185.96,0.00
2024-12-10 17:41:58,77,8731,34,43,6129.61,11186.00,0.00
2024-12-10 17:41:58,78,8731,35,43,6051.02,11186.01,0.00
2024-12-10 17:41:58,79,8730,35,44,5973.02,11186.05,0.00
2024-12-10 17:41:58,78,8730,34,44,6042.11,11186.58,0.00
2024-12-10 17:41:58,78,8731,34,44,6138.51,11187.00,0.00
2024-12-10 17:41:58,79,8731,35,44,6060.81,11187.01,0.00
2024-12-10 17:41:58,78,8731,35,43,6129.93,11187.08,0.00
2024-12-10 17:41:58,78,8732,35,43,6256.68,11188.00,0.00
2024-12-10 17:41:58,79,8732,36,43,6177.48,11188.01,0.00
2024-12-10 17:41:58,78,8732,35,43,6250.97,11188.05,0.00
2024-12-10 17:41:58,77,8732,34,43,6323.43,11188.05,0.00
2024-12-10 17:41:58,76,8732,33,43,6353.72,11188.24,0.00
2024-12-10 17:41:58,75,8732,32,43,6438.44,11188.24,0.00
2024-12-10 17:41:58,76,8731,32,44,6347.85,11188.32,0.00
2024-12-10 17:41:58,75,8731,31,44,6468.53,11188.71,0.00
2024-12-10 17:41:58,75,8732,31,44,6585.12,11189.00,0.00
2024-12-10 17:41:58,76,8732,32,44,6498.48,11189.01,0.00
2024-12-10 17:41:58,75,8732,32,43,6577.69,11189.05,0.00
2024-12-10 17:41:58,75,8733,32,43,6709.24,11190.00,0.00
2024-12-10 17:41:58,76,8733,32,44,6620.96,11190.01,0.00
2024-12-10 17:41:58,77,8732,33,44,6451.94,11190.52,0.00
2024-12-10 17:41:58,77,8733,33,44,6580.81,11191.00,0.00
2024-12-10 17:41:58,78,8733,34,44,6496.44,11191.01,0.00
2024-12-10 17:41:58,78,8734,34,44,6623.57,11192.00,0.00
2024-12-10 17:41:58,79,8734,35,44,6539.73,11192.01,0.00
2024-12-10 17:41:58,79,8735,35,44,6503.24,11193.00,0.00
2024-12-10 17:41:58,80,8735,36,44,6421.95,11193.01,0.00
2024-12-10 17:41:58,79,8735,35,44,6398.56,11193.70,0.00
2024-12-10 17:41:58,79,8736,35,44,6449.81,11194.00,0.00
2024-12-10 17:41:58,80,8736,36,44,6369.19,11194.01,0.00
2024-12-10 17:41:58,79,8736,36,43,6428.60,11194.14,0.00
2024-12-10 17:41:58,79,8737,36,43,6417.79,11195.00,0.00
2024-12-10 17:41:58,80,8737,37,43,6337.57,11195.01,0.00
2024-12-10 17:41:58,81,8736,38,43,6208.26,11195.25,0.00
2024-12-10 17:41:58,80,8736,37,43,6371.25,11195.28,0.00
2024-12-10 17:41:58,79,8736,36,43,6361.41,11195.65,0.00
2024-12-10 17:41:58,79,8737,36,43,6463.72,11196.00,0.00
2024-12-10 17:41:58,80,8737,36,44,6382.92,11196.01,0.00
2024-12-10 17:41:58,79,8737,36,43,6435.41,11196.15,0.00
2024-12-10 17:41:58,79,8738,36,43,6567.76,11197.00,0.00
2024-12-10 17:41:58,80,8738,37,43,6485.66,11197.01,0.00
2024-12-10 17:41:58,80,8739,37,43,6469.27,11198.00,0.00
2024-12-10 17:41:58,81,8739,38,43,6389.41,11198.01,0.00
2024-12-10 17:41:58,81,8740,38,43,6356.11,11199.00,0.00
2024-12-10 17:41:58,82,8740,39,43,6278.60,11199.01,0.00
2024-12-10 17:41:58,82,8741,39,43,6224.08,11200.00,0.00
2024-12-10 17:41:58,83,8741,39,44,6149.10,11200.01,0.00
2024-12-10 17:41:58,82,8741,39,43,6196.80,11200.15,0.00
2024-12-10 17:41:58,81,8741,38,43,6260.91,11200.26,0.00
2024-12-10 17:41:58,81,8742,38,43,6261.38,11201.00,0.00
2024-12-10 17:41:58,82,8742,39,43,6185.02,11201.01,0.00
2024-12-10 17:41:59,82,8743,39,43,6079.52,11202.00,0.00
2024-12-10 17:41:59,83,8743,40,43,6006.27,11202.01,0.00
2024-12-10 17:41:59,82,8743,40,42,6060.42,11202.15,0.00
2024-12-10 17:41:59,83,8742,41,42,5939.03,11202.60,0.00
2024-12-10 17:41:59,82,8742,40,42,6021.11,11202.67,0.00
2024-12-10 17:41:59,82,8743,40,42,6066.43,11203.00,0.00
2024-12-10 17:41:59,83,8743,40,43,5993.34,11203.01,0.00
2024-12-10 17:41:59,83,8744,40,43,6072.17,11204.00,0.00
2024-12-10 17:41:59,84,8744,41,43,5999.88,11204.01,0.00
2024-12-10 17:41:59,83,8744,41,42,6059.43,11204.12,0.00
2024-12-10 17:41:59,82,8744,41,41,6129.23,11204.13,0.00
2024-12-10 17:41:59,83,8743,42,41,5997.61,11204.67,0.00
2024-12-10 17:41:59,83,8744,42,41,6072.09,11205.00,0.00
2024-12-10 17:41:59,84,8744,43,41,5999.81,11205.01,0.00
2024-12-10 17:41:59,84,8745,43,41,6076.38,11206.00,0.00
2024-12-10 17:41:59,85,8745,43,42,6004.90,11206.01,0.00
2024-12-10 17:41:59,84,8745,43,41,6059.07,11206.13,0.00
2024-12-10 17:41:59,83,8745,42,41,6039.30,11206.84,0.00
2024-12-10 17:41:59,83,8746,42,41,6156.89,11207.00,0.00
2024-12-10 17:41:59,84,8746,42,42,6083.60,11207.01,0.00
2024-12-10 17:41:59,84,8747,42,42,6026.77,11208.00,0.00
2024-12-10 17:41:59,85,8747,43,42,5955.86,11208.01,0.00
2024-12-10 17:41:59,84,8747,43,41,6010.78,11208.13,0.00
2024-12-10 17:41:59,84,8748,43,41,5993.94,11209.00,0.00
2024-12-10 17:41:59,85,8748,43,42,5923.43,11209.01,0.00
2024-12-10 17:41:59,84,8748,42,42,5939.31,11209.26,0.00
2024-12-10 17:41:59,84,8749,42,42,5978.34,11210.00,0.00
2024-12-10 17:41:59,85,8749,42,43,5908.01,11210.01,0.00
2024-12-10 17:41:59,85,8750,42,43,5885.39,11211.00,0.00
2024-12-10 17:41:59,86,8750,43,43,5816.95,11211.01,0.00
2024-12-10 17:41:59,85,8750,43,42,5880.13,11211.05,0.00
2024-12-10 17:41:59,85,8751,43,42,5846.45,11212.00,0.00
2024-12-10 17:41:59,86,8751,44,42,5778.46,11212.01,0.00
2024-12-10 17:41:59,86,8752,44,42,5720.65,11213.00,0.00
2024-12-10 17:41:59,87,8752,44,43,5654.90,11213.01,0.00
2024-12-10 17:41:59,86,8752,44,42,5715.45,11213.05,0.00
2024-12-10 17:41:59,85,8752,44,41,5772.14,11213.11,0.00
2024-12-10 17:41:59,84,8752,43,41,5822.23,11213.27,0.00
2024-12-10 17:41:59,84,8753,43,41,5821.34,11214.00,0.00
2024-12-10 17:41:59,85,8753,44,41,5752.85,11214.01,0.00
2024-12-10 17:41:59,84,8753,43,41,5793.31,11214.04,0.00
2024-12-10 17:41:59,83,8753,42,41,5861.76,11214.04,0.00
2024-12-10 17:41:59,82,8753,42,40,5901.79,11214.08,0.00
2024-12-10 17:41:59,82,8754,42,40,5936.50,11215.00,0.00
2024-12-10 17:41:59,83,8754,42,41,5864.97,11215.01,0.00
2024-12-10 17:41:59,84,8753,43,41,5732.51,11215.36,0.00
2024-12-10 17:41:59,83,8753,42,41,5817.77,11215.75,0.00
2024-12-10 17:41:59,83,8754,42,41,5924.71,11216.00,0.00
2024-12-10 17:41:59,84,8754,43,41,5854.18,11216.01,0.00
2024-12-10 17:41:59,83,8754,43,40,5920.67,11216.04,0.00
2024-12-10 17:41:59,83,8755,43,40,6008.24,11217.00,0.00
2024-12-10 17:41:59,84,8755,44,40,5936.71,11217.01,0.00
2024-12-10 17:41:59,83,8755,44,39,6004.20,11217.04,0.00
2024-12-10 17:41:59,82,8755,44,38,6059.65,11217.07,0.00
2024-12-10 17:41:59,82,8756,44,38,6038.27,11218.00,0.00
2024-12-10 17:41:59,83,8756,44,39,5965.52,11218.01,0.00
2024-12-10 17:41:59,82,8756,43,39,6034.18,11218.04,0.00
2024-12-10 17:41:59,81,8756,42,39,6104.52,11218.04,0.00
2024-12-10 17:41:59,80,8756,42,38,6151.39,11218.05,0.00
2024-12-10 17:41:59,81,8755,42,39,5996.84,11218.78,0.00
2024-12-10 17:41:59,81,8756,42,39,6131.37,11219.00,0.00
2024-12-10 17:41:59,82,8756,42,40,6056.60,11219.01,0.00
2024-12-10 17:41:59,81,8756,41,40,6041.39,11219.16,0.00
2024-12-10 17:41:59,81,8757,41,40,6224.73,11220.00,0.00
2024-12-10 17:41:59,82,8757,41,41,6148.82,11220.01,0.00
2024-12-10 17:41:59,81,8757,41,40,6219.21,11220.05,0.00
2024-12-10 17:41:59,81,8758,41,40,6196.19,11221.00,0.00
2024-12-10 17:41:59,82,8758,42,40,6120.63,11221.01,0.00
2024-12-10 17:41:59,81,8758,42,39,6164.35,11221.05,0.00
2024-12-10 17:41:59,80,8758,41,39,6223.22,11221.20,0.00
2024-12-10 17:41:59,79,8758,40,39,6255.21,11221.39,0.00
2024-12-10 17:41:59,79,8759,40,39,6295.43,11222.00,0.00
2024-12-10 17:41:59,80,8759,41,39,6216.74,11222.01,0.00
2024-12-10 17:41:59,79,8759,40,39,6191.94,11222.59,0.00
2024-12-10 17:41:59,79,8760,40,39,6268.90,11223.00,0.00
2024-12-10 17:41:59,80,8760,40,40,6190.54,11223.01,0.00
2024-12-10 17:42:00,80,8761,40,40,6154.90,11224.00,0.00
2024-12-10 17:42:00,81,8761,40,41,6078.91,11224.01,0.00
2024-12-10 17:42:00,81,8762,40,41,6024.02,11225.00,0.00
2024-12-10 17:42:00,82,8762,40,42,5950.56,11225.01,0.00
2024-12-10 17:42:00,81,8762,40,41,6015.72,11225.04,0.00
2024-12-10 17:42:00,82,8761,41,41,5908.24,11225.37,0.00
2024-12-10 17:42:00,81,8761,40,41,5936.95,11225.98,0.00
2024-12-10 17:42:00,81,8762,40,41,6072.78,11226.00,0.00
2024-12-10 17:42:00,82,8762,40,42,5998.72,11226.01,0.00
2024-12-10 17:42:00,81,8762,40,41,6045.07,11226.05,0.00
2024-12-10 17:42:00,80,8762,39,41,6010.48,11226.61,0.00
2024-12-10 17:42:00,80,8763,39,41,6247.93,11227.00,0.00
2024-12-10 17:42:00,81,8763,39,42,6170.79,11227.01,0.00
2024-12-10 17:42:00,80,8763,39,41,6219.87,11227.05,0.00
2024-12-10 17:42:00,79,8763,38,41,6250.31,11227.11,0.00
2024-12-10 17:42:00,79,8764,38,41,6293.26,11228.00,0.00
2024-12-10 17:42:00,80,8764,39,41,6214.60,11228.01,0.00
2024-12-10 17:42:00,79,8764,39,40,6262.01,11228.05,0.00
2024-12-10 17:42:00,80,8763,39,41,6172.54,11228.17,0.00
2024-12-10 17:42:00,79,8763,38,41,6337.13,11228.21,0.00
2024-12-10 17:42:00,79,8764,38,41,6333.92,11229.00,0.00
2024-12-10 17:42:00,80,8764,38,42,6254.75,11229.01,0.00
2024-12-10 17:42:00,79,8764,38,41,6299.82,11229.05,0.00
2024-12-10 17:42:00,78,8764,37,41,6308.77,11229.44,0.00
2024-12-10 17:42:00,78,8765,37,41,6532.54,11230.00,0.00
2024-12-10 17:42:00,79,8765,38,41,6449.85,11230.01,0.00
2024-12-10 17:42:00,78,8765,38,40,6497.99,11230.05,0.00
2024-12-10 17:42:00,78,8766,38,40,6477.03,11231.00,0.00
2024-12-10 17:42:00,79,8766,39,40,6395.04,11231.01,0.00
2024-12-10 17:42:00,78,8766,38,40,6448.23,11231.01,0.00
2024-12-10 17:42:00,77,8766,38,39,6499.89,11231.04,0.00
2024-12-10 17:42:00,76,8766,37,39,6566.27,11231.20,0.00
2024-12-10 17:42:00,76,8767,37,39,6623.04,11232.00,0.00
2024-12-10 17:42:00,77,8767,38,39,6537.02,11232.01,0.00
2024-12-10 17:42:00,77,8768,38,39,6513.96,11233.00,0.00
2024-12-10 17:42:00,78,8768,38,40,6430.44,11233.01,0.00
2024-12-10 17:42:00,78,8769,38,40,6386.62,11234.00,0.00
2024-12-10 17:42:00,79,8769,39,40,6305.78,11234.01,0.00
2024-12-10 17:42:00,78,8769,39,39,6359.27,11234.04,0.00
2024-12-10 17:42:00,78,8770,39,39,6338.21,11235.00,0.00
2024-12-10 17:42:00,79,8770,40,39,6257.98,11235.01,0.00
2024-12-10 17:42:00,78,8770,39,39,6202.26,11235.47,0.00
2024-12-10 17:42:00,78,8771,39,39,6287.62,11236.00,0.00
2024-12-10 17:42:00,79,8771,40,39,6208.03,11236.01,0.00
2024-12-10 17:42:00,78,8771,40,38,6283.31,11236.04,0.00
2024-12-10 17:42:00,78,8772,40,38,6262.25,11237.00,0.00
2024-12-10 17:42:00,79,8772,40,39,6182.98,11237.01,0.00
2024-12-10 17:42:00,78,8772,40,38,6229.13,11237.04,0.00
2024-12-10 17:42:00,77,8772,39,38,6272.30,11237.13,0.00
2024-12-10 17:42:00,77,8773,39,38,6320.97,11238.00,0.00
2024-12-10 17:42:00,78,8773,40,38,6239.93,11238.01,0.00
2024-12-10 17:42:00,77,8773,40,37,6287.41,11238.04,0.00
2024-12-10 17:42:00,76,8773,39,37,6293.40,11238.43,0.00
2024-12-10 17:42:00,76,8774,39,37,6378.10,11239.00,0.00
2024-12-10 17:42:00,77,8774,40,37,6295.26,11239.01,0.00
2024-12-10 17:42:00,77,8775,40,37,6288.22,11240.00,0.00
2024-12-10 17:42:00,78,8775,40,38,6207.60,11240.01,0.00
2024-12-10 17:42:00,79,8774,40,39,6090.64,11240.13,0.00
2024-12-10 17:42:00,80,8773,41,39,6035.97,11240.86,0.00
2024-12-10 17:42:00,80,8774,41,39,6157.52,11241.00,0.00
2024-12-10 17:42:00,81,8774,41,40,6081.50,11241.01,0.00
2024-12-10 17:42:00,80,8774,40,40,6154.71,11241.03,0.00
2024-12-10 17:42:00,79,8774,39,40,6185.74,11241.19,0.00
2024-12-10 17:42:00,79,8775,39,40,6487.88,11242.00,0.00
2024-12-10 17:42:00,80,8775,40,40,6406.78,11242.01,0.00
2024-12-10 17:42:00,81,8774,40,41,6245.99,11242.52,0.00
2024-12-10 17:42:00,81,8775,40,41,6322.69,11243.00,0.00
2024-12-10 17:42:00,82,8775,41,41,6245.59,11243.01,0.00
2024-12-10 17:42:00,81,8775,41,40,6311.60,11243.04,0.00
2024-12-10 17:42:00,82,8774,42,40,6223.70,11243.16,0.00
2024-12-10 17:42:00,81,8774,41,40,6318.61,11243.20,0.00
2024-12-10 17:42:00,81,8775,41,40,6450.97,11244.00,0.00
2024-12-10 17:42:00,82,8775,41,41,6372.30,11244.01,0.00
2024-12-10 17:42:00,81,8775,40,41,6398.30,11244.21,0.00
2024-12-10 17:42:00,81,8776,40,41,6587.59,11245.00,0.00
2024-12-10 17:42:00,82,8776,40,42,6507.25,11245.01,0.00
2024-12-10 17:42:00,81,8776,40,41,6579.28,11245.06,0.00
2024-12-10 17:42:00,81,8777,40,41,6557.63,11246.00,0.00
2024-12-10 17:42:00,82,8777,41,41,6477.66,11246.01,0.00
2024-12-10 17:42:00,81,8777,40,41,6486.93,11246.30,0.00
2024-12-10 17:42:00,81,8778,40,41,6547.11,11247.00,0.00
2024-12-10 17:42:00,82,8778,40,42,6467.27,11247.01,0.00
2024-12-10 17:42:00,83,8777,40,43,6354.14,11247.11,0.00
2024-12-10 17:42:00,82,8777,39,43,6481.06,11247.21,0.00
2024-12-10 17:42:00,82,8778,39,43,6512.02,11248.00,0.00
2024-12-10 17:42:00,83,8778,39,44,6433.56,11248.01,0.00
2024-12-10 17:42:00,83,8779,39,44,6536.00,11249.00,0.00
2024-12-10 17:42:00,84,8779,40,44,6458.19,11249.01,0.00
2024-12-10 17:42:00,83,8779,39,44,6483.22,11249.23,0.00
2024-12-10 17:42:00,82,8779,38,44,6551.83,11249.26,0.00
2024-12-10 17:42:00,82,8780,38,44,6605.83,11250.00,0.00
2024-12-10 17:42:00,83,8780,39,44,6526.24,11250.01,0.00
2024-12-10 17:42:00,82,8780,39,43,6585.27,11250.06,0.00
2024-12-10 17:42:00,82,8781,39,43,6562.51,11251.00,0.00
2024-12-10 17:42:00,83,8781,40,43,6483.44,11251.01,0.00
2024-12-10 17:42:00,82,8781,40,42,6544.67,11251.02,0.00
2024-12-10 17:42:00,82,8782,40,42,6517.81,11252.00,0.00
2024-12-10 17:42:01,83,8782,40,43,6439.28,11252.01,0.00
2024-12-10 17:42:01,83,8783,40,43,6425.69,11253.00,0.00
2024-12-10 17:42:01,84,8783,40,44,6349.19,11253.01,0.00
2024-12-10 17:42:01,84,8784,40,44,6329.60,11254.00,0.00
2024-12-10 17:42:01,85,8784,41,44,6255.13,11254.01,0.00
2024-12-10 17:42:01,84,8784,40,44,6277.42,11254.23,0.00
2024-12-10 17:42:01,85,8783,41,44,6173.23,11254.52,0.00
2024-12-10 17:42:01,85,8784,41,44,6270.09,11255.00,0.00
2024-12-10 17:42:01,86,8784,42,44,6197.18,11255.01,0.00
2024-12-10 17:42:01,86,8785,42,44,6257.04,11256.00,0.00
2024-12-10 17:42:01,87,8785,43,44,6185.12,11256.01,0.00
2024-12-10 17:42:01,86,8785,43,43,6236.11,11256.06,0.00
2024-12-10 17:42:01,86,8786,43,43,6203.55,11257.00,0.00
2024-12-10 17:42:01,87,8786,43,44,6132.25,11257.01,0.00
2024-12-10 17:42:01,86,8786,43,43,6174.77,11257.06,0.00
2024-12-10 17:42:01,86,8787,43,43,6144.74,11258.00,0.00
2024-12-10 17:42:01,87,8787,44,43,6074.11,11258.01,0.00
2024-12-10 17:42:01,86,8787,44,42,6115.95,11258.06,0.00
2024-12-10 17:42:01,85,8787,43,42,6138.93,11258.14,0.00
2024-12-10 17:42:01,85,8788,43,42,6174.00,11259.00,0.00
2024-12-10 17:42:01,86,8788,44,42,6102.21,11259.01,0.00
2024-12-10 17:42:01,85,8788,43,42,6078.10,11259.62,0.00
2024-12-10 17:42:01,85,8789,43,42,6146.68,11260.00,0.00
2024-12-10 17:42:01,86,8789,44,42,6075.21,11260.01,0.00
2024-12-10 17:42:01,87,8788,44,43,5952.38,11260.28,0.00
2024-12-10 17:42:01,87,8789,44,43,6022.27,11261.00,0.00
2024-12-10 17:42:01,88,8789,45,43,5953.83,11261.01,0.00
2024-12-10 17:42:01,87,8789,44,43,5963.55,11261.30,0.00
2024-12-10 17:42:01,86,8789,43,43,5973.82,11261.80,0.00
2024-12-10 17:42:01,86,8790,43,43,6130.36,11262.00,0.00
2024-12-10 17:42:01,87,8790,43,44,6059.90,11262.01,0.00
2024-12-10 17:42:01,86,8790,42,44,6083.26,11262.20,0.00
2024-12-10 17:42:01,85,8790,41,44,6101.54,11262.67,0.00
2024-12-10 17:42:01,84,8790,40,44,6141.60,11262.83,0.00
2024-12-10 17:42:01,84,8791,40,44,6203.41,11263.00,0.00
2024-12-10 17:42:01,85,8791,40,45,6130.43,11263.01,0.00
2024-12-10 17:42:01,84,8791,40,44,6196.72,11263.06,0.00
2024-12-10 17:42:01,84,8792,40,44,6171.78,11264.00,0.00
2024-12-10 17:42:01,85,8792,41,44,6099.17,11264.01,0.00
2024-12-10 17:42:01,84,8792,41,43,6147.65,11264.06,0.00
2024-12-10 17:42:01,85,8791,41,44,6067.39,11264.15,0.00
2024-12-10 17:42:01,85,8792,41,44,6148.75,11265.00,0.00
2024-12-10 17:42:01,86,8792,41,45,6077.25,11265.01,0.00
2024-12-10 17:42:01,85,8792,40,45,6144.78,11265.04,0.00
2024-12-10 17:42:01,84,8792,40,44,6196.48,11265.05,0.00
2024-12-10 17:42:01,83,8792,39,44,6196.55,11265.22,0.00
2024-12-10 17:42:01,83,8793,39,44,6380.27,11266.00,0.00
2024-12-10 17:42:01,84,8793,40,44,6304.31,11266.01,0.00
2024-12-10 17:42:01,84,8794,40,44,6257.89,11267.00,0.00
2024-12-10 17:42:01,85,8794,40,45,6184.27,11267.01,0.00
2024-12-10 17:42:01,84,8794,40,44,6229.73,11267.05,0.00
2024-12-10 17:42:01,84,8795,40,44,6203.45,11268.00,0.00
2024-12-10 17:42:01,85,8795,40,45,6130.47,11268.01,0.00
2024-12-10 17:42:01,84,8795,40,44,6121.63,11268.06,0.00
2024-12-10 17:42:01,84,8796,40,44,6150.34,11269.00,0.00
2024-12-10 17:42:01,85,8796,40,45,6077.98,11269.01,0.00
2024-12-10 17:42:01,84,8796,40,44,6120.83,11269.06,0.00
2024-12-10 17:42:01,84,8797,40,44,6095.87,11270.00,0.00
2024-12-10 17:42:01,85,8797,40,45,6024.16,11270.01,0.00
2024-12-10 17:42:01,84,8797,39,45,6091.85,11270.04,0.00
2024-12-10 17:42:01,83,8797,39,44,6138.09,11270.05,0.00
2024-12-10 17:42:01,82,8797,38,44,6177.29,11270.28,0.00
2024-12-10 17:42:01,82,8798,38,44,6234.11,11271.00,0.00
2024-12-10 17:42:01,83,8798,38,45,6159.00,11271.01,0.00
2024-12-10 17:42:01,82,8798,37,45,6200.38,11271.06,0.00
2024-12-10 17:42:01,82,8799,37,45,6221.06,11272.00,0.00
2024-12-10 17:42:01,83,8799,38,45,6146.11,11272.01,0.00
2024-12-10 17:42:01,82,8799,37,45,6172.65,11272.20,0.00
2024-12-10 17:42:01,82,8800,37,45,6203.40,11273.00,0.00
2024-12-10 17:42:01,83,8800,38,45,6128.66,11273.01,0.00
2024-12-10 17:42:01,82,8800,37,45,6155.34,11273.20,0.00
2024-12-10 17:42:01,83,8799,37,46,6037.89,11273.60,0.00
2024-12-10 17:42:01,83,8800,37,46,6146.59,11274.00,0.00
2024-12-10 17:42:01,84,8800,37,47,6073.42,11274.01,0.00
2024-12-10 17:42:01,84,8801,37,47,6155.14,11275.00,0.00
2024-12-10 17:42:01,85,8801,37,48,6082.73,11275.01,0.00
2024-12-10 17:42:01,84,8801,36,48,6152.46,11275.02,0.00
2024-12-10 17:42:01,83,8801,36,47,6211.64,11275.04,0.00
2024-12-10 17:42:01,82,8801,35,47,6266.83,11275.21,0.00
2024-12-10 17:42:01,82,8802,35,47,6260.45,11276.00,0.00
2024-12-10 17:42:01,83,8802,35,48,6185.02,11276.01,0.00
2024-12-10 17:42:01,82,8802,35,47,6228.82,11276.04,0.00
2024-12-10 17:42:01,82,8803,35,47,6203.24,11277.00,0.00
2024-12-10 17:42:01,83,8803,36,47,6128.51,11277.01,0.00
2024-12-10 17:42:01,82,8803,35,47,6103.00,11277.43,0.00
2024-12-10 17:42:01,82,8804,35,47,6176.29,11278.00,0.00
2024-12-10 17:42:01,83,8804,36,47,6101.87,11278.01,0.00
2024-12-10 17:42:01,82,8804,36,46,6169.41,11278.04,0.00
2024-12-10 17:42:01,81,8804,35,46,6244.18,11278.04,0.00
2024-12-10 17:42:01,81,8805,35,46,6219.67,11279.00,0.00
2024-12-10 17:42:01,82,8805,35,47,6143.82,11279.01,0.00
2024-12-10 17:42:01,81,8805,34,47,6150.05,11279.06,0.00
2024-12-10 17:42:01,81,8806,34,47,6184.01,11280.00,0.00
2024-12-10 17:42:01,82,8806,35,47,6108.60,11280.01,0.00
2024-12-10 17:42:01,81,8806,34,47,6149.20,11280.04,0.00
2024-12-10 17:42:01,80,8806,33,47,6076.90,11280.66,0.00
2024-12-10 17:42:01,80,8807,33,47,6180.08,11281.00,0.00
2024-12-10 17:42:01,81,8807,34,47,6103.78,11281.01,0.00
2024-12-10 17:42:01,80,8807,34,46,6165.99,11281.06,0.00
2024-12-10 17:42:01,79,8807,33,46,6226.96,11281.20,0.00
2024-12-10 17:42:01,78,8807,32,46,6246.33,11281.73,0.00
2024-12-10 17:42:01,78,8808,32,46,6302.95,11282.00,0.00
2024-12-10 17:42:02,79,8808,33,46,6223.16,11282.01,0.00
2024-12-10 17:42:02,80,8807,33,47,6039.92,11282.72,0.00
2024-12-10 17:42:02,80,8808,33,47,6123.35,11283.00,0.00
2024-12-10 17:42:02,81,8808,33,48,6047.76,11283.01,0.00
2024-12-10 17:42:02,80,8808,32,48,6120.53,11283.03,0.00
2024-12-10 17:42:02,79,8808,32,47,6196.58,11283.03,0.00
2024-12-10 17:42:02,79,8809,32,47,6320.95,11284.00,0.00
2024-12-10 17:42:02,80,8809,33,47,6241.94,11284.01,0.00
2024-12-10 17:42:02,80,8810,33,47,6198.72,11285.00,0.00
2024-12-10 17:42:02,81,8810,34,47,6122.20,11285.01,0.00
2024-12-10 17:42:02,82,8809,35,47,6047.54,11285.04,0.00
2024-12-10 17:42:02,81,8809,35,46,6232.28,11285.05,0.00
2024-12-10 17:42:02,80,8809,35,45,6309.72,11285.05,0.00
2024-12-10 17:42:02,80,8810,35,45,6254.90,11286.00,0.00
2024-12-10 17:42:02,81,8810,35,46,6177.67,11286.01,0.00
2024-12-10 17:42:02,80,8810,34,46,6140.25,11286.51,0.00
2024-12-10 17:42:02,79,8810,33,46,6161.08,11286.87,0.00
2024-12-10 17:42:02,79,8811,33,46,6432.62,11287.00,0.00
2024-12-10 17:42:02,80,8811,34,46,6352.21,11287.01,0.00
2024-12-10 17:42:02,79,8811,34,45,6424.06,11287.04,0.00
2024-12-10 17:42:02,79,8812,34,45,6401.75,11288.00,0.00
2024-12-10 17:42:02,80,8812,34,46,6321.73,11288.01,0.00
2024-12-10 17:42:02,79,8812,33,46,6323.19,11288.08,0.00
2024-12-10 17:42:02,78,8812,32,46,6388.39,11288.21,0.00
2024-12-10 17:42:02,78,8813,32,46,6443.88,11289.00,0.00
2024-12-10 17:42:02,79,8813,33,46,6362.31,11289.01,0.00
2024-12-10 17:42:02,78,8813,32,46,6387.51,11289.23,0.00
2024-12-10 17:42:02,79,8812,33,46,6279.62,11289.49,0.00
2024-12-10 17:42:02,79,8813,33,46,6418.61,11290.00,0.00
2024-12-10 17:42:02,80,8813,33,47,6338.38,11290.01,0.00
2024-12-10 17:42:02,79,8813,33,46,6398.62,11290.08,0.00
2024-12-10 17:42:02,79,8814,33,46,6523.51,11291.00,0.00
2024-12-10 17:42:02,80,8814,34,46,6441.97,11291.01,0.00
2024-12-10 17:42:02,79,8814,33,46,6470.70,11291.21,0.00
2024-12-10 17:42:02,79,8815,33,46,6468.34,11292.00,0.00
2024-12-10 17:42:02,80,8815,34,46,6387.49,11292.01,0.00
2024-12-10 17:42:02,79,8815,34,45,6448.36,11292.09,0.00
2024-12-10 17:42:02,78,8815,33,45,6425.60,11292.60,0.00
2024-12-10 17:42:02,78,8816,33,45,6525.79,11293.00,0.00
2024-12-10 17:42:02,79,8816,33,46,6443.19,11293.01,0.00
2024-12-10 17:42:02,79,8817,33,46,6389.43,11294.00,0.00
2024-12-10 17:42:02,80,8817,34,46,6309.56,11294.01,0.00
2024-12-10 17:42:02,79,8817,34,45,6370.87,11294.09,0.00
2024-12-10 17:42:02,78,8817,33,45,6334.30,11294.94,0.00
2024-12-10 17:42:02,78,8818,33,45,6471.92,11295.00,0.00
2024-12-10 17:42:02,79,8818,34,45,6390.00,11295.01,0.00
2024-12-10 17:42:02,78,8818,33,45,6458.96,11295.05,0.00
2024-12-10 17:42:02,77,8818,33,44,6541.38,11295.05,0.00
2024-12-10 17:42:02,78,8817,34,44,6375.18,11295.55,0.00
2024-12-10 17:42:02,79,8816,35,44,6298.86,11295.68,0.00
2024-12-10 17:42:02,80,8815,35,45,6231.56,11295.89,0.00
2024-12-10 17:42:02,80,8816,35,45,6372.86,11296.00,0.00
2024-12-10 17:42:02,81,8816,36,45,6294.18,11296.01,0.00
2024-12-10 17:42:02,80,8816,36,44,6355.94,11296.06,0.00
2024-12-10 17:42:02,80,8817,36,44,6758.94,11297.00,0.00
2024-12-10 17:42:02,81,8817,37,44,6675.49,11297.01,0.00
2024-12-10 17:42:02,82,8816,38,44,6558.29,11297.11,0.00
2024-12-10 17:42:02,81,8816,37,44,6676.53,11297.65,0.00
2024-12-10 17:42:02,81,8817,37,44,6721.44,11298.00,0.00
2024-12-10 17:42:02,82,8817,38,44,6639.47,11298.01,0.00
2024-12-10 17:42:02,81,8817,38,43,6706.12,11298.06,0.00
2024-12-10 17:42:02,81,8818,38,43,6823.86,11299.00,0.00
2024-12-10 17:42:02,82,8818,38,44,6740.65,11299.01,0.00
2024-12-10 17:42:02,82,8819,38,44,6684.75,11300.00,0.00
2024-12-10 17:42:02,83,8819,39,44,6604.21,11300.01,0.00
2024-12-10 17:42:02,82,8819,39,43,6670.99,11300.06,0.00
2024-12-10 17:42:02,82,8820,39,43,6648.12,11301.00,0.00
2024-12-10 17:42:02,83,8820,39,44,6568.03,11301.01,0.00
2024-12-10 17:42:02,82,8820,38,44,6550.33,11301.17,0.00
2024-12-10 17:42:02,82,8821,38,44,6594.96,11302.00,0.00
2024-12-10 17:42:02,83,8821,38,45,6515.50,11302.01,0.00
2024-12-10 17:42:02,82,8821,37,45,6540.76,11302.24,0.00
2024-12-10 17:42:02,82,8822,37,45,6538.50,11303.00,0.00
2024-12-10 17:42:02,83,8822,38,45,6459.72,11303.01,0.00
2024-12-10 17:42:02,82,8822,38,44,6526.12,11303.07,0.00
2024-12-10 17:42:02,81,8822,37,44,6547.40,11303.21,0.00
2024-12-10 17:42:02,81,8823,37,44,6461.95,11304.00,0.00
2024-12-10 17:42:02,82,8823,37,45,6383.15,11304.01,0.00
2024-12-10 17:42:02,81,8823,37,44,6449.42,11304.07,0.00
2024-12-10 17:42:02,80,8823,37,43,6522.30,11304.08,0.00
2024-12-10 17:42:02,79,8823,36,43,6482.98,11304.72,0.00
2024-12-10 17:42:02,78,8823,35,43,6544.43,11304.81,0.00
2024-12-10 17:42:02,78,8824,35,43,6667.76,11305.00,0.00
2024-12-10 17:42:02,79,8824,36,43,6583.36,11305.01,0.00
2024-12-10 17:42:02,78,8824,35,43,6585.19,11305.10,0.00
2024-12-10 17:42:02,78,8825,35,43,6629.22,11306.00,0.00
2024-12-10 17:42:02,79,8825,35,44,6545.30,11306.01,0.00
2024-12-10 17:42:02,78,8825,35,43,6616.20,11306.08,0.00
2024-12-10 17:42:02,78,8826,35,43,6599.36,11307.00,0.00
2024-12-10 17:42:02,79,8826,35,44,6515.82,11307.01,0.00
2024-12-10 17:42:02,79,8827,35,44,6462.01,11308.00,0.00
2024-12-10 17:42:02,80,8827,36,44,6381.23,11308.01,0.00
2024-12-10 17:42:02,79,8827,36,43,6446.29,11308.08,0.00
2024-12-10 17:42:02,80,8826,37,43,6348.81,11308.25,0.00
2024-12-10 17:42:02,79,8826,36,43,6406.74,11308.97,0.00
2024-12-10 17:42:02,79,8827,36,43,6547.04,11309.00,0.00
2024-12-10 17:42:02,80,8827,36,44,6465.20,11309.01,0.00
2024-12-10 17:42:02,79,8827,35,44,6499.83,11309.08,0.00
2024-12-10 17:42:02,80,8826,36,44,6341.04,11309.54,0.00
2024-12-10 17:42:02,80,8827,36,44,6619.87,11310.00,0.00
2024-12-10 17:42:03,81,8827,36,45,6538.15,11310.01,0.00
2024-12-10 17:42:03,80,8827,36,44,6601.52,11310.08,0.00
2024-12-10 17:42:03,80,8828,36,44,6723.67,11311.00,0.00
2024-12-10 17:42:03,81,8828,36,45,6640.66,11311.01,0.00
2024-12-10 17:42:03,81,8829,36,45,6585.39,11312.00,0.00
2024-12-10 17:42:03,82,8829,37,45,6505.08,11312.01,0.00
2024-12-10 17:42:03,81,8829,37,44,6565.86,11312.07,0.00
2024-12-10 17:42:03,81,8830,37,44,6545.47,11313.00,0.00
2024-12-10 17:42:03,82,8830,37,45,6465.64,11313.01,0.00
2024-12-10 17:42:03,81,8830,37,44,6541.29,11313.04,0.00
2024-12-10 17:42:03,80,8830,36,44,6494.18,11313.45,0.00
2024-12-10 17:42:03,80,8831,36,44,6573.76,11314.00,0.00
2024-12-10 17:42:03,81,8831,37,44,6492.60,11314.01,0.00
2024-12-10 17:42:03,81,8832,37,44,6447.35,11315.00,0.00
2024-12-10 17:42:03,82,8832,38,44,6368.73,11315.01,0.00
2024-12-10 17:42:03,81,8832,38,43,6416.63,11315.04,0.00
2024-12-10 17:42:03,80,8832,37,43,6463.46,11315.22,0.00
2024-12-10 17:42:03,79,8832,36,43,6491.10,11315.70,0.00
2024-12-10 17:42:03,79,8833,36,43,6595.12,11316.00,0.00
2024-12-10 17:42:03,80,8833,36,44,6512.68,11316.01,0.00
2024-12-10 17:42:03,79,8833,36,43,6583.68,11316.05,0.00
2024-12-10 17:42:03,78,8833,35,43,6581.25,11316.50,0.00
2024-12-10 17:42:03,77,8833,34,43,6640.41,11316.73,0.00
2024-12-10 17:42:03,77,8834,34,43,6748.70,11317.00,0.00
2024-12-10 17:42:03,78,8834,35,43,6662.18,11317.01,0.00
2024-12-10 17:42:03,78,8835,35,43,6588.84,11318.00,0.00
2024-12-10 17:42:03,79,8835,36,43,6505.44,11318.01,0.00
2024-12-10 17:42:03,78,8835,36,42,6577.26,11318.06,0.00
2024-12-10 17:42:03,78,8836,36,42,6545.74,11319.00,0.00
2024-12-10 17:42:03,79,8836,37,42,6462.88,11319.01,0.00
2024-12-10 17:42:03,78,8836,36,42,6491.63,11319.19,0.00
2024-12-10 17:42:03,78,8837,36,42,6510.85,11320.00,0.00
2024-12-10 17:42:03,79,8837,36,43,6428.43,11320.01,0.00
2024-12-10 17:42:03,80,8836,37,43,6264.54,11320.51,0.00
2024-12-10 17:42:03,80,8837,37,43,6351.92,11321.00,0.00
2024-12-10 17:42:03,81,8837,38,43,6273.50,11321.01,0.00
2024-12-10 17:42:03,80,8837,38,42,6327.89,11321.06,0.00
2024-12-10 17:42:03,81,8836,39,42,6190.86,11321.58,0.00
2024-12-10 17:42:03,81,8837,39,42,6410.62,11322.00,0.00
2024-12-10 17:42:03,82,8837,40,42,6332.44,11322.01,0.00
2024-12-10 17:42:03,83,8836,41,42,6253.42,11322.06,0.00
2024-12-10 17:42:03,82,8836,40,42,6273.13,11322.18,0.00
2024-12-10 17:42:03,82,8837,40,42,6453.25,11323.00,0.00
2024-12-10 17:42:03,83,8837,41,42,6375.50,11323.01,0.00
2024-12-10 17:42:03,82,8837,41,41,6436.71,11323.10,0.00
2024-12-10 17:42:03,81,8837,40,41,6471.18,11323.47,0.00
2024-12-10 17:42:03,81,8838,40,41,6635.13,11324.00,0.00
2024-12-10 17:42:03,82,8838,41,41,6554.21,11324.01,0.00
2024-12-10 17:42:03,82,8839,41,41,6498.17,11325.00,0.00
2024-12-10 17:42:03,83,8839,41,42,6419.88,11325.01,0.00
2024-12-10 17:42:03,82,8839,41,41,6484.38,11325.10,0.00
2024-12-10 17:42:03,82,8840,41,41,6465.59,11326.00,0.00
2024-12-10 17:42:03,83,8840,41,42,6387.69,11326.01,0.00
2024-12-10 17:42:03,82,8840,40,42,6347.05,11326.77,0.00
2024-12-10 17:42:03,82,8841,40,42,6459.11,11327.00,0.00
2024-12-10 17:42:03,83,8841,40,43,6381.29,11327.01,0.00
2024-12-10 17:42:03,82,8841,39,43,6403.94,11327.26,0.00
2024-12-10 17:42:03,82,8842,39,43,6406.62,11328.00,0.00
2024-12-10 17:42:03,83,8842,39,44,6329.43,11328.01,0.00
2024-12-10 17:42:03,82,8842,38,44,6403.89,11328.02,0.00
2024-12-10 17:42:03,81,8842,38,43,6455.00,11328.06,0.00
2024-12-10 17:42:03,81,8843,38,43,6395.41,11329.00,0.00
2024-12-10 17:42:03,82,8843,38,44,6317.41,11329.01,0.00
2024-12-10 17:42:03,81,8843,37,44,6241.33,11329.72,0.00
2024-12-10 17:42:03,81,8844,37,44,6305.25,11330.00,0.00
2024-12-10 17:42:03,82,8844,38,44,6228.36,11330.01,0.00
2024-12-10 17:42:03,81,8844,38,43,6271.70,11330.07,0.00
2024-12-10 17:42:03,80,8844,37,43,6224.61,11330.75,0.00
2024-12-10 17:42:03,80,8845,37,43,6338.10,11331.00,0.00
2024-12-10 17:42:03,81,8845,37,44,6259.86,11331.01,0.00
2024-12-10 17:42:03,80,8845,37,43,6317.64,11331.09,0.00
2024-12-10 17:42:03,80,8846,37,43,6299.76,11332.00,0.00
2024-12-10 17:42:03,81,8846,38,43,6221.98,11332.01,0.00
2024-12-10 17:42:03,80,8846,37,43,6219.13,11332.35,0.00
2024-12-10 17:42:03,80,8847,37,43,6287.56,11333.00,0.00
2024-12-10 17:42:03,81,8847,38,43,6209.94,11333.01,0.00
2024-12-10 17:42:03,80,8847,38,42,6277.67,11333.09,0.00
2024-12-10 17:42:03,81,8846,38,43,6197.38,11333.14,0.00
2024-12-10 17:42:03,81,8847,38,43,6306.67,11334.00,0.00
2024-12-10 17:42:03,82,8847,39,43,6229.76,11334.01,0.00
2024-12-10 17:42:03,81,8847,38,43,6245.98,11334.05,0.00
2024-12-10 17:42:03,80,8847,37,43,6288.30,11334.11,0.00
2024-12-10 17:42:03,79,8847,36,43,6344.07,11334.32,0.00
2024-12-10 17:42:03,79,8848,36,43,6554.00,11335.00,0.00
2024-12-10 17:42:03,80,8848,37,43,6472.07,11335.01,0.00
2024-12-10 17:42:03,79,8848,37,42,6542.54,11335.08,0.00
2024-12-10 17:42:03,79,8849,37,42,6524.44,11336.00,0.00
2024-12-10 17:42:03,80,8849,38,42,6442.88,11336.01,0.00
2024-12-10 17:42:03,80,8850,38,42,6411.24,11337.00,0.00
2024-12-10 17:42:03,81,8850,38,43,6332.09,11337.01,0.00
2024-12-10 17:42:03,81,8851,38,43,6279.20,11338.00,0.00
2024-12-10 17:42:03,82,8851,38,44,6202.62,11338.01,0.00
2024-12-10 17:42:03,81,8851,38,43,6255.76,11338.10,0.00
2024-12-10 17:42:03,80,8851,37,43,6314.17,11338.26,0.00
2024-12-10 17:42:04,80,8852,37,43,6316.06,11339.00,0.00
2024-12-10 17:42:04,81,8852,38,43,6238.08,11339.01,0.00
2024-12-10 17:42:04,81,8853,38,43,6182.63,11340.00,0.00
2024-12-10 17:42:04,82,8853,39,43,6107.23,11340.01,0.00
2024-12-10 17:42:04,81,8853,38,43,6178.44,11340.04,0.00
2024-12-10 17:42:04,80,8853,38,42,6245.77,11340.09,0.00
2024-12-10 17:42:04,80,8854,38,42,6227.86,11341.00,0.00
2024-12-10 17:42:04,81,8854,38,43,6150.97,11341.01,0.00
2024-12-10 17:42:04,80,8854,37,43,6127.37,11341.44,0.00
2024-12-10 17:42:04,81,8853,38,43,6014.13,11341.79,0.00
2024-12-10 17:42:04,81,8854,38,43,6154.07,11342.00,0.00
2024-12-10 17:42:04,82,8854,38,44,6079.02,11342.01,0.00
2024-12-10 17:42:04,81,8854,38,43,6142.90,11342.09,0.00
2024-12-10 17:42:04,80,8854,37,43,6108.38,11342.90,0.00
2024-12-10 17:42:04,80,8855,37,43,6323.95,11343.00,0.00
2024-12-10 17:42:04,81,8855,37,44,6245.88,11343.01,0.00
2024-12-10 17:42:04,80,8855,36,44,6221.45,11343.66,0.00
2024-12-10 17:42:04,80,8856,36,44,6268.50,11344.00,0.00
2024-12-10 17:42:04,81,8856,36,45,6191.11,11344.01,0.00
2024-12-10 17:42:04,80,8856,36,44,6258.60,11344.09,0.00
2024-12-10 17:42:04,80,8857,36,44,6240.69,11345.00,0.00
2024-12-10 17:42:04,81,8857,37,44,6163.65,11345.01,0.00
2024-12-10 17:42:04,80,8857,36,44,6239.27,11345.01,0.00
2024-12-10 17:42:04,79,8857,36,43,6315.39,11345.03,0.00
2024-12-10 17:42:04,78,8857,36,42,6361.47,11345.06,0.00
2024-12-10 17:42:04,77,8857,35,42,6339.61,11345.58,0.00
2024-12-10 17:42:04,78,8856,35,43,6239.55,11345.77,0.00
2024-12-10 17:42:04,78,8857,35,43,6383.73,11346.00,0.00
2024-12-10 17:42:04,79,8857,36,43,6302.92,11346.01,0.00
2024-12-10 17:42:04,79,8858,36,43,6392.34,11347.00,0.00
2024-12-10 17:42:04,80,8858,36,44,6312.44,11347.01,0.00
2024-12-10 17:42:04,79,8858,36,43,6385.19,11347.06,0.00
2024-12-10 17:42:04,78,8858,35,43,6446.74,11347.23,0.00
2024-12-10 17:42:04,78,8858,35,43,6446.15,11348.00,0.00
2024-12-10 17:42:04,79,8858,35,44,6364.55,11348.01,0.00
2024-12-10 17:42:04,78,8858,35,43,6409.81,11348.06,0.00
2024-12-10 17:42:04,77,8858,34,43,6400.41,11348.53,0.00
2024-12-10 17:42:04,78,8857,34,44,6312.56,11348.60,0.00
2024-12-10 17:42:04,78,8858,34,44,6450.54,11349.00,0.00
2024-12-10 17:42:04,79,8858,34,45,6368.89,11349.01,0.00
2024-12-10 17:42:04,78,8858,34,44,6414.20,11349.06,0.00
2024-12-10 17:42:04,78,8859,34,44,6538.65,11350.00,0.00
2024-12-10 17:42:04,79,8859,34,45,6455.88,11350.01,0.00
2024-12-10 17:42:04,78,8859,33,45,6428.42,11350.72,0.00
2024-12-10 17:42:04,78,8860,33,45,6498.32,11351.00,0.00
2024-12-10 17:42:04,79,8860,34,45,6416.06,11351.01,0.00
2024-12-10 17:42:04,78,8860,33,45,6380.00,11351.78,0.00
2024-12-10 17:42:04,78,8861,33,45,6442.74,11352.00,0.00
2024-12-10 17:42:04,79,8861,34,45,6361.19,11352.01,0.00
2024-12-10 17:42:04,78,8861,34,44,6429.67,11352.08,0.00
2024-12-10 17:42:04,78,8862,34,44,6412.75,11353.00,0.00
2024-12-10 17:42:04,79,8862,34,45,6331.57,11353.01,0.00
2024-12-10 17:42:04,78,8862,34,44,6374.93,11353.08,0.00
2024-12-10 17:42:04,79,8861,35,44,6267.01,11353.34,0.00
2024-12-10 17:42:04,79,8862,35,44,6393.09,11354.00,0.00
2024-12-10 17:42:04,80,8862,36,44,6313.18,11354.01,0.00
2024-12-10 17:42:04,79,8862,35,44,6337.13,11354.24,0.00
2024-12-10 17:42:04,79,8863,35,44,6510.49,11355.00,0.00
2024-12-10 17:42:04,80,8863,36,44,6429.11,11355.01,0.00
2024-12-10 17:42:04,81,8862,36,45,6236.56,11355.79,0.00
2024-12-10 17:42:04,82,8861,37,45,6170.27,11355.88,0.00
2024-12-10 17:42:04,82,8862,37,45,6311.70,11356.00,0.00
2024-12-10 17:42:04,83,8862,37,46,6235.66,11356.01,0.00
2024-12-10 17:42:04,84,8861,37,47,6158.73,11356.06,0.00
2024-12-10 17:42:04,83,8861,37,46,6343.78,11356.08,0.00
2024-12-10 17:42:04,84,8860,38,46,6180.67,11356.88,0.00
2024-12-10 17:42:04,84,8861,38,46,6528.22,11357.00,0.00
2024-12-10 17:42:04,85,8861,38,47,6451.42,11357.01,0.00
2024-12-10 17:42:04,84,8861,38,46,6495.81,11357.07,0.00
2024-12-10 17:42:04,83,8861,37,46,6529.72,11357.22,0.00
2024-12-10 17:42:04,83,8862,37,46,6851.79,11358.00,0.00
2024-12-10 17:42:04,84,8862,37,47,6770.22,11358.01,0.00
2024-12-10 17:42:04,83,8862,37,46,6818.98,11358.07,0.00
2024-12-10 17:42:04,82,8862,36,46,6881.42,11358.22,0.00
2024-12-10 17:42:04,82,8863,36,46,6876.40,11359.00,0.00
2024-12-10 17:42:04,83,8863,37,46,6793.55,11359.01,0.00
2024-12-10 17:42:04,83,8864,37,46,6758.50,11360.00,0.00
2024-12-10 17:42:04,84,8864,38,46,6678.04,11360.01,0.00
2024-12-10 17:42:04,83,8864,37,46,6707.35,11360.19,0.00
2024-12-10 17:42:04,83,8865,37,46,6708.04,11361.00,0.00
2024-12-10 17:42:04,84,8865,37,47,6628.18,11361.01,0.00
2024-12-10 17:42:04,83,8865,37,46,6672.48,11361.08,0.00
2024-12-10 17:42:04,83,8866,37,46,6651.13,11362.00,0.00
2024-12-10 17:42:04,84,8866,37,47,6571.95,11362.01,0.00
2024-12-10 17:42:04,83,8866,36,47,6581.35,11362.10,0.00
2024-12-10 17:42:04,83,8867,36,47,6616.13,11363.00,0.00
2024-12-10 17:42:04,84,8867,36,48,6537.36,11363.01,0.00
2024-12-10 17:42:04,85,8866,37,48,6456.46,11363.07,0.00
2024-12-10 17:42:04,84,8866,37,47,6568.51,11363.10,0.00
2024-12-10 17:42:04,84,8867,37,47,6520.35,11364.00,0.00
2024-12-10 17:42:04,85,8867,37,48,6443.64,11364.01,0.00
2024-12-10 17:42:04,84,8867,37,47,6498.75,11364.12,0.00
2024-12-10 17:42:04,83,8867,36,47,6488.19,11364.45,0.00
2024-12-10 17:42:04,83,8868,36,47,6684.24,11365.00,0.00
2024-12-10 17:42:04,84,8868,36,48,6604.66,11365.01,0.00
2024-12-10 17:42:04,85,8867,37,48,6437.63,11365.59,0.00
2024-12-10 17:42:04,84,8867,36,48,6495.36,11365.63,0.00
2024-12-10 17:42:04,83,8867,35,48,6494.41,11365.82,0.00
2024-12-10 17:42:04,83,8868,35,48,6564.00,11366.00,0.00
2024-12-10 17:42:04,84,8868,36,48,6485.85,11366.01,0.00
2024-12-10 17:42:04,83,8868,35,48,6411.70,11366.81,0.00
2024-12-10 17:42:04,83,8869,35,48,6663.84,11367.00,0.00
2024-12-10 17:42:04,84,8869,36,48,6584.51,11367.01,0.00
2024-12-10 17:42:04,84,8870,36,48,6558.98,11368.00,0.00
2024-12-10 17:42:04,85,8870,36,49,6481.81,11368.01,0.00
2024-12-10 17:42:04,86,8869,36,50,6317.02,11368.57,0.00
2024-12-10 17:42:05,86,8870,36,50,6403.90,11369.00,0.00
2024-12-10 17:42:05,87,8870,36,51,6330.29,11369.01,0.00
2024-12-10 17:42:05,87,8871,36,51,6350.52,11370.00,0.00
2024-12-10 17:42:05,88,8871,36,52,6278.36,11370.01,0.00
2024-12-10 17:42:05,87,8871,36,51,6344.02,11370.06,0.00
2024-12-10 17:42:05,86,8871,36,50,6401.94,11370.15,0.00
2024-12-10 17:42:05,87,8870,37,50,6282.09,11370.58,0.00
2024-12-10 17:42:05,86,8870,37,49,6356.15,11370.79,0.00
2024-12-10 17:42:05,86,8871,37,49,6411.85,11371.00,0.00
2024-12-10 17:42:05,87,8871,37,50,6338.15,11371.01,0.00
2024-12-10 17:42:05,86,8871,36,50,6385.41,11371.02,0.00
2024-12-10 17:42:05,86,8872,36,50,6512.91,11372.00,0.00
2024-12-10 17:42:05,87,8872,37,50,6438.05,11372.01,0.00
2024-12-10 17:42:05,86,8872,36,50,6477.24,11372.09,0.00
2024-12-10 17:42:05,85,8872,36,49,6532.05,11372.15,0.00
2024-12-10 17:42:05,85,8873,36,49,6570.04,11373.00,0.00
2024-12-10 17:42:05,86,8873,36,50,6493.65,11373.01,0.00
2024-12-10 17:42:05,85,8873,36,49,6559.37,11373.09,0.00
2024-12-10 17:42:05,85,8874,36,49,6515.20,11374.00,0.00
2024-12-10 17:42:05,86,8874,37,49,6439.44,11374.01,0.00
2024-12-10 17:42:05,86,8875,37,49,6379.45,11375.00,0.00
2024-12-10 17:42:05,87,8875,38,49,6306.13,11375.01,0.00
2024-12-10 17:42:05,86,8875,38,48,6368.90,11375.09,0.00
2024-12-10 17:42:05,85,8875,37,48,6401.56,11375.31,0.00
2024-12-10 17:42:05,86,8874,37,49,6320.52,11375.38,0.00
2024-12-10 17:42:05,87,8873,37,50,6235.10,11375.85,0.00
2024-12-10 17:42:05,87,8874,37,50,6362.07,11376.00,0.00
2024-12-10 17:42:05,88,8874,37,51,6289.78,11376.01,0.00
2024-12-10 17:42:05,87,8874,37,50,6318.81,11376.14,0.00
2024-12-10 17:42:05,86,8874,36,50,6359.81,11376.30,0.00
2024-12-10 17:42:05,86,8875,36,50,6618.58,11377.00,0.00
2024-12-10 17:42:05,87,8875,36,51,6542.50,11377.01,0.00
2024-12-10 17:42:05,86,8875,35,51,6604.37,11377.13,0.00
2024-12-10 17:42:05,85,8875,34,51,6609.80,11377.15,0.00
2024-12-10 17:42:05,84,8875,34,50,6577.37,11377.70,0.00
2024-12-10 17:42:05,84,8876,34,50,6679.21,11378.00,0.00
2024-12-10 17:42:05,85,8876,34,51,6600.63,11378.01,0.00
2024-12-10 17:42:05,84,8876,34,50,6653.51,11378.13,0.00
2024-12-10 17:42:05,85,8875,35,50,6571.23,11378.19,0.00
2024-12-10 17:42:05,84,8875,34,50,6736.17,11378.21,0.00
2024-12-10 17:42:05,83,8875,33,50,6784.51,11378.51,0.00
2024-12-10 17:42:05,83,8876,33,50,6865.77,11379.00,0.00
2024-12-10 17:42:05,84,8876,33,51,6784.04,11379.01,0.00
2024-12-10 17:42:05,83,8876,33,50,6860.31,11379.05,0.00
2024-12-10 17:42:05,82,8876,32,50,6811.01,11379.57,0.00
2024-12-10 17:42:05,82,8877,32,50,7040.32,11380.00,0.00
2024-12-10 17:42:05,83,8877,33,50,6955.50,11380.01,0.00
2024-12-10 17:42:05,82,8877,33,49,6961.25,11380.12,0.00
2024-12-10 17:42:05,82,8878,33,49,7000.69,11381.00,0.00
2024-12-10 17:42:05,83,8878,34,49,6916.34,11381.01,0.00
2024-12-10 17:42:05,82,8878,33,49,6948.02,11381.22,0.00
2024-12-10 17:42:05,82,8879,33,49,6985.95,11382.00,0.00
2024-12-10 17:42:05,83,8879,33,50,6901.78,11382.01,0.00
2024-12-10 17:42:05,83,8880,33,50,6881.89,11383.00,0.00
2024-12-10 17:42:05,84,8880,34,50,6799.96,11383.01,0.00
2024-12-10 17:42:05,83,8880,33,50,6831.21,11383.22,0.00
2024-12-10 17:42:05,82,8880,32,50,6913.13,11383.22,0.00
2024-12-10 17:42:05,82,8881,32,50,6932.41,11384.00,0.00
2024-12-10 17:42:05,83,8881,32,51,6848.89,11384.01,0.00
2024-12-10 17:42:05,83,8882,32,51,6795.41,11385.00,0.00
2024-12-10 17:42:05,84,8882,33,51,6714.51,11385.01,0.00
2024-12-10 17:42:05,83,8882,33,50,6761.15,11385.14,0.00
2024-12-10 17:42:05,82,8882,32,50,6717.62,11385.96,0.00
2024-12-10 17:42:05,82,8883,32,50,6852.33,11386.00,0.00
2024-12-10 17:42:05,83,8883,32,51,6769.77,11386.01,0.00
2024-12-10 17:42:05,82,8883,32,50,6846.79,11386.05,0.00
2024-12-10 17:42:05,81,8883,31,50,6770.00,11386.72,0.00
2024-12-10 17:42:05,81,8884,31,50,6878.49,11387.00,0.00
2024-12-10 17:42:05,82,8884,31,51,6794.61,11387.01,0.00
2024-12-10 17:42:05,81,8884,31,50,6854.62,11387.14,0.00
2024-12-10 17:42:05,82,8883,32,50,6746.13,11387.38,0.00
2024-12-10 17:42:05,81,8883,31,50,6822.48,11387.51,0.00
2024-12-10 17:42:05,81,8884,31,50,6907.21,11388.00,0.00
2024-12-10 17:42:05,82,8884,31,51,6822.98,11388.01,0.00
2024-12-10 17:42:05,81,8884,31,50,6901.61,11388.05,0.00
2024-12-10 17:42:05,81,8885,31,50,6990.78,11389.00,0.00
2024-12-10 17:42:05,82,8885,32,50,6905.53,11389.01,0.00
2024-12-10 17:42:05,81,8885,32,49,6966.91,11389.12,0.00
2024-12-10 17:42:05,80,8885,31,49,7027.00,11389.28,0.00
2024-12-10 17:42:05,80,8886,31,49,7087.33,11390.00,0.00
2024-12-10 17:42:05,81,8886,32,49,6999.83,11390.01,0.00
2024-12-10 17:42:05,81,8887,32,49,6948.21,11391.00,0.00
2024-12-10 17:42:05,82,8887,32,50,6863.48,11391.01,0.00
2024-12-10 17:42:05,81,8887,32,49,6907.48,11391.17,0.00
2024-12-10 17:42:05,81,8888,32,49,6898.19,11392.00,0.00
2024-12-10 17:42:05,82,8888,33,49,6814.07,11392.01,0.00
2024-12-10 17:42:05,81,8888,32,49,6775.01,11392.84,0.00
2024-12-10 17:42:05,81,8889,32,49,6882.08,11393.00,0.00
2024-12-10 17:42:05,82,8889,32,50,6798.15,11393.01,0.00
2024-12-10 17:42:05,81,8889,31,50,6830.10,11393.22,0.00
2024-12-10 17:42:05,80,8889,30,50,6914.05,11393.22,0.00
2024-12-10 17:42:05,81,8888,30,51,6827.29,11393.26,0.00
2024-12-10 17:42:05,81,8889,30,51,6871.92,11394.00,0.00
2024-12-10 17:42:05,82,8889,31,51,6788.11,11394.01,0.00
2024-12-10 17:42:05,82,8889,31,51,6805.47,11395.00,0.00
2024-12-10 17:42:05,83,8889,32,51,6723.47,11395.01,0.00
2024-12-10 17:42:05,82,8889,32,50,6758.26,11395.17,0.00
2024-12-10 17:42:05,81,8889,32,49,6819.79,11395.31,0.00
2024-12-10 17:42:05,81,8890,32,49,6729.28,11396.00,0.00
2024-12-10 17:42:05,82,8890,33,49,6647.21,11396.01,0.00
2024-12-10 17:42:05,81,8890,32,49,6684.28,11396.12,0.00
2024-12-10 17:42:05,80,8890,31,49,6645.05,11396.83,0.00
2024-12-10 17:42:05,80,8891,31,49,6767.71,11397.00,0.00
2024-12-10 17:42:06,81,8891,31,50,6684.16,11397.01,0.00
2024-12-10 17:42:06,80,8891,31,49,6730.71,11397.17,0.00
2024-12-10 17:42:06,80,8892,31,49,6718.15,11398.00,0.00
2024-12-10 17:42:06,81,8892,31,50,6635.21,11398.01,0.00
2024-12-10 17:42:06,80,8892,30,50,6711.04,11398.06,0.00
2024-12-10 17:42:06,80,8893,30,50,6665.73,11399.00,0.00
2024-12-10 17:42:06,81,8893,30,51,6583.44,11399.01,0.00
2024-12-10 17:42:06,80,8893,30,50,6630.14,11399.16,0.00
2024-12-10 17:42:06,79,8893,29,50,6592.24,11399.97,0.00
2024-12-10 17:42:06,79,8894,29,50,6733.67,11400.00,0.00
2024-12-10 17:42:06,80,8894,29,51,6649.50,11400.01,0.00
2024-12-10 17:42:06,79,8894,28,51,6726.47,11400.06,0.00
2024-12-10 17:42:06,78,8894,27,51,6768.91,11400.19,0.00
2024-12-10 17:42:06,78,8894,27,51,6810.64,11401.00,0.00
2024-12-10 17:42:06,79,8894,27,52,6724.43,11401.01,0.00
2024-12-10 17:42:06,78,8894,27,51,6803.35,11401.06,0.00
2024-12-10 17:42:06,77,8894,26,51,6830.53,11401.34,0.00
2024-12-10 17:42:06,77,8895,26,51,6884.11,11402.00,0.00
2024-12-10 17:42:06,78,8895,26,52,6795.85,11402.01,0.00
2024-12-10 17:42:06,77,8895,25,52,6780.62,11402.42,0.00
2024-12-10 17:42:06,77,8896,25,52,6862.50,11403.00,0.00
2024-12-10 17:42:06,78,8896,26,52,6774.52,11403.01,0.00
2024-12-10 17:42:06,77,8896,25,52,6724.86,11403.45,0.00
2024-12-10 17:42:06,77,8897,25,52,6811.17,11404.00,0.00
2024-12-10 17:42:06,78,8897,26,52,6723.85,11404.01,0.00
2024-12-10 17:42:06,77,8897,26,51,6780.11,11404.16,0.00
2024-12-10 17:42:06,77,8898,26,51,6773.26,11405.00,0.00
2024-12-10 17:42:06,78,8898,26,52,6686.43,11405.01,0.00
2024-12-10 17:42:06,77,8898,25,52,6702.90,11405.36,0.00
2024-12-10 17:42:06,77,8899,25,52,6751.78,11406.00,0.00
2024-12-10 17:42:06,78,8899,26,52,6665.22,11406.01,0.00
2024-12-10 17:42:06,78,8900,26,52,6619.68,11407.00,0.00
2024-12-10 17:42:06,79,8900,26,53,6535.89,11407.01,0.00
2024-12-10 17:42:06,78,8900,26,52,6580.22,11407.12,0.00
2024-12-10 17:42:06,78,8901,26,52,6563.80,11408.00,0.00
2024-12-10 17:42:06,79,8901,27,52,6480.72,11408.01,0.00
2024-12-10 17:42:06,78,8901,27,51,6526.68,11408.14,0.00
2024-12-10 17:42:06,78,8902,27,51,6467.36,11409.00,0.00
2024-12-10 17:42:06,79,8902,28,51,6385.49,11409.01,0.00
2024-12-10 17:42:06,78,8902,28,50,6460.05,11409.06,0.00
2024-12-10 17:42:06,78,8903,28,50,6428.22,11410.00,0.00
2024-12-10 17:42:06,79,8903,29,50,6346.85,11410.01,0.00
2024-12-10 17:42:06,78,8903,29,49,6420.92,11410.06,0.00
2024-12-10 17:42:06,78,8904,29,49,6389.30,11411.00,0.00
2024-12-10 17:42:06,79,8904,29,50,6308.43,11411.01,0.00
2024-12-10 17:42:06,78,8904,28,50,6368.74,11411.08,0.00
2024-12-10 17:42:06,77,8904,27,50,6327.22,11411.91,0.00
2024-12-10 17:42:06,77,8905,27,50,6449.81,11412.00,0.00
2024-12-10 17:42:06,78,8905,27,51,6367.12,11412.01,0.00
2024-12-10 17:42:06,77,8905,27,50,6414.26,11412.12,0.00
2024-12-10 17:42:06,77,8906,27,50,6385.74,11413.00,0.00
2024-12-10 17:42:06,78,8906,27,51,6303.87,11413.01,0.00
2024-12-10 17:42:06,78,8907,27,51,6221.08,11414.00,0.00
2024-12-10 17:42:06,79,8907,28,51,6142.33,11414.01,0.00
2024-12-10 17:42:06,78,8907,28,50,6193.30,11414.13,0.00
2024-12-10 17:42:06,77,8907,27,50,6134.02,11414.71,0.00
2024-12-10 17:42:06,77,8908,27,50,6222.94,11415.00,0.00
2024-12-10 17:42:06,78,8908,28,50,6143.15,11415.01,0.00
2024-12-10 17:42:06,79,8907,28,51,5996.16,11415.39,0.00
2024-12-10 17:42:06,78,8907,28,50,6095.23,11415.65,0.00
2024-12-10 17:42:06,79,8906,29,50,6016.64,11415.68,0.00
2024-12-10 17:42:06,79,8907,29,50,6102.02,11416.00,0.00
2024-12-10 17:42:06,80,8907,30,50,6025.74,11416.01,0.00
2024-12-10 17:42:06,79,8907,29,50,6099.13,11416.03,0.00
2024-12-10 17:42:06,78,8907,29,49,6152.46,11416.12,0.00
2024-12-10 17:42:06,78,8908,29,49,6427.87,11417.00,0.00
2024-12-10 17:42:06,79,8908,29,50,6346.50,11417.01,0.00
2024-12-10 17:42:06,79,8909,29,50,6279.96,11418.00,0.00
2024-12-10 17:42:06,80,8909,29,51,6201.46,11418.01,0.00
2024-12-10 17:42:06,79,8909,29,50,6252.52,11418.13,0.00
2024-12-10 17:42:06,78,8909,28,50,6186.12,11418.86,0.00
2024-12-10 17:42:06,78,8910,28,50,6316.53,11419.00,0.00
2024-12-10 17:42:06,79,8910,28,51,6236.57,11419.01,0.00
2024-12-10 17:42:06,79,8911,28,51,6173.53,11420.00,0.00
2024-12-10 17:42:06,80,8911,28,52,6096.36,11420.01,0.00
2024-12-10 17:42:06,79,8911,28,51,6167.76,11420.05,0.00
2024-12-10 17:42:06,78,8911,28,50,6226.35,11420.12,0.00
2024-12-10 17:42:06,77,8911,27,50,6226.76,11420.53,0.00
2024-12-10 17:42:06,77,8912,27,50,6310.28,11421.00,0.00
2024-12-10 17:42:06,78,8912,28,50,6229.37,11421.01,0.00
2024-12-10 17:42:06,77,8912,27,50,6305.83,11421.04,0.00
2024-12-10 17:42:06,77,8913,27,50,6250.90,11422.00,0.00
2024-12-10 17:42:06,78,8913,28,50,6170.76,11422.01,0.00
2024-12-10 17:42:06,77,8913,27,50,6249.42,11422.01,0.00
2024-12-10 17:42:06,76,8913,27,49,6300.10,11422.09,0.00
2024-12-10 17:42:06,76,8914,27,49,6281.05,11423.00,0.00
2024-12-10 17:42:06,77,8914,28,49,6199.48,11423.01,0.00
2024-12-10 17:42:06,76,8914,27,49,6186.51,11423.41,0.00
2024-12-10 17:42:06,76,8915,27,49,6265.95,11424.00,0.00
2024-12-10 17:42:06,77,8915,27,50,6184.58,11424.01,0.00
2024-12-10 17:42:06,76,8915,27,49,6247.93,11424.09,0.00
2024-12-10 17:42:06,75,8915,26,49,6282.98,11424.51,0.00
2024-12-10 17:42:06,75,8916,26,49,6309.95,11425.00,0.00
2024-12-10 17:42:06,76,8916,27,49,6226.93,11425.01,0.00
2024-12-10 17:42:06,75,8916,26,49,6200.67,11425.17,0.00
2024-12-10 17:42:06,75,8917,26,49,6249.10,11426.00,0.00
2024-12-10 17:42:06,76,8917,26,50,6166.88,11426.01,0.00
2024-12-10 17:42:06,75,8917,26,49,6221.70,11426.12,0.00
2024-12-10 17:42:06,76,8916,27,49,6124.86,11426.28,0.00
2024-12-10 17:42:06,76,8917,27,49,6238.37,11427.00,0.00
2024-12-10 17:42:06,77,8917,28,49,6157.35,11427.01,0.00
2024-12-10 17:42:07,77,8918,28,49,6234.60,11428.00,0.00
2024-12-10 17:42:07,78,8918,28,50,6154.67,11428.01,0.00
2024-12-10 17:42:07,77,8918,28,49,6231.63,11428.03,0.00
2024-12-10 17:42:07,76,8918,28,48,6297.10,11428.09,0.00
2024-12-10 17:42:07,76,8919,28,48,6265.18,11429.00,0.00
2024-12-10 17:42:07,77,8919,29,48,6183.82,11429.01,0.00
2024-12-10 17:42:07,77,8920,29,48,6120.46,11430.00,0.00
2024-12-10 17:42:07,78,8920,30,48,6041.99,11430.01,0.00
2024-12-10 17:42:07,77,8920,30,47,6095.24,11430.12,0.00
2024-12-10 17:42:07,77,8921,30,47,6072.85,11431.00,0.00
2024-12-10 17:42:07,78,8921,30,48,5995.00,11431.01,0.00
2024-12-10 17:42:07,77,8921,29,48,5955.27,11431.66,0.00
2024-12-10 17:42:07,77,8922,29,48,6064.50,11432.00,0.00
2024-12-10 17:42:07,78,8922,30,48,5986.75,11432.01,0.00
2024-12-10 17:42:07,77,8922,29,48,6061.22,11432.04,0.00
2024-12-10 17:42:07,76,8922,28,48,6100.37,11432.08,0.00
2024-12-10 17:42:07,76,8923,28,48,6100.36,11433.00,0.00
2024-12-10 17:42:07,77,8923,28,49,6021.13,11433.01,0.00
2024-12-10 17:42:07,76,8923,28,48,6097.35,11433.03,0.00
2024-12-10 17:42:07,77,8922,29,48,5973.65,11433.18,0.00
2024-12-10 17:42:07,78,8921,30,48,5943.87,11433.86,0.00
2024-12-10 17:42:07,78,8922,30,48,6049.47,11434.00,0.00
2024-12-10 17:42:07,79,8922,30,49,5972.89,11434.01,0.00
2024-12-10 17:42:07,78,8922,29,49,5866.55,11434.83,0.00
2024-12-10 17:42:07,78,8923,29,49,6287.42,11435.00,0.00
2024-12-10 17:42:07,79,8923,30,49,6207.83,11435.01,0.00
2024-12-10 17:42:07,78,8923,30,48,6274.24,11435.12,0.00
2024-12-10 17:42:07,78,8924,30,48,6207.72,11436.00,0.00
2024-12-10 17:42:07,79,8924,31,48,6129.14,11436.01,0.00
2024-12-10 17:42:07,78,8924,31,47,6181.34,11436.12,0.00
2024-12-10 17:42:07,77,8924,31,46,6195.25,11436.58,0.00
2024-12-10 17:42:07,77,8925,31,46,6235.19,11437.00,0.00
2024-12-10 17:42:07,78,8925,32,46,6155.25,11437.01,0.00
2024-12-10 17:42:07,77,8925,31,46,6195.09,11437.01,0.00
2024-12-10 17:42:07,76,8925,31,45,6263.06,11437.07,0.00
2024-12-10 17:42:07,77,8924,31,46,6180.24,11437.10,0.00
2024-12-10 17:42:07,77,8925,31,46,6351.38,11438.00,0.00
2024-12-10 17:42:07,78,8925,32,46,6269.95,11438.01,0.00
2024-12-10 17:42:07,77,8925,32,45,6270.54,11438.43,0.00
2024-12-10 17:42:07,76,8925,31,45,6323.76,11438.68,0.00
2024-12-10 17:42:07,76,8926,31,45,6574.97,11439.00,0.00
2024-12-10 17:42:07,77,8926,32,45,6489.58,11439.01,0.00
2024-12-10 17:42:07,78,8925,32,46,6331.75,11439.44,0.00
2024-12-10 17:42:07,78,8926,32,46,6411.55,11440.00,0.00
2024-12-10 17:42:07,79,8926,33,46,6330.39,11440.01,0.00
2024-12-10 17:42:07,78,8926,33,45,6407.15,11440.01,0.00
2024-12-10 17:42:07,77,8926,33,44,6402.56,11440.44,0.00
2024-12-10 17:42:07,77,8927,33,44,6576.79,11441.00,0.00
2024-12-10 17:42:07,78,8927,34,44,6492.47,11441.01,0.00
2024-12-10 17:42:07,78,8928,34,44,6485.07,11442.00,0.00
2024-12-10 17:42:07,79,8928,34,45,6402.98,11442.01,0.00
2024-12-10 17:42:07,80,8927,35,45,6250.13,11442.42,0.00
2024-12-10 17:42:07,80,8928,35,45,6435.32,11443.00,0.00
2024-12-10 17:42:07,81,8928,35,46,6355.87,11443.01,0.00
2024-12-10 17:42:07,80,8928,35,45,6422.44,11443.03,0.00
2024-12-10 17:42:07,79,8928,34,45,6444.40,11443.17,0.00
2024-12-10 17:42:07,79,8929,34,45,6637.30,11444.00,0.00
2024-12-10 17:42:07,80,8929,35,45,6554.33,11444.01,0.00
2024-12-10 17:42:07,80,8930,35,45,6520.02,11445.00,0.00
2024-12-10 17:42:07,81,8930,35,46,6439.53,11445.01,0.00
2024-12-10 17:42:07,81,8931,35,46,6381.15,11446.00,0.00
2024-12-10 17:42:07,82,8931,36,46,6303.34,11446.01,0.00
2024-12-10 17:42:07,81,8931,36,45,6359.96,11446.05,0.00
2024-12-10 17:42:07,80,8931,35,45,6368.22,11446.67,0.00
2024-12-10 17:42:07,80,8932,35,45,6406.18,11447.00,0.00
2024-12-10 17:42:07,81,8932,36,45,6327.10,11447.01,0.00
2024-12-10 17:42:07,81,8933,36,45,6272.62,11448.00,0.00
2024-12-10 17:42:07,82,8933,37,45,6196.13,11448.01,0.00
2024-12-10 17:42:07,81,8933,37,44,6238.72,11448.07,0.00
2024-12-10 17:42:07,81,8934,37,44,6205.54,11449.00,0.00
2024-12-10 17:42:07,82,8934,37,45,6129.87,11449.01,0.00
2024-12-10 17:42:07,81,8934,37,44,6171.42,11449.07,0.00
2024-12-10 17:42:07,81,8935,37,44,6139.24,11450.00,0.00
2024-12-10 17:42:07,82,8935,38,44,6064.37,11450.01,0.00
2024-12-10 17:42:07,81,8935,38,43,6103.91,11450.07,0.00
2024-12-10 17:42:07,80,8935,37,43,6088.44,11450.81,0.00
2024-12-10 17:42:07,79,8935,36,43,6158.23,11450.83,0.00
2024-12-10 17:42:07,79,8936,36,43,6282.21,11451.00,0.00
2024-12-10 17:42:07,80,8936,37,43,6203.68,11451.01,0.00
2024-12-10 17:42:07,79,8936,37,42,6245.99,11451.08,0.00
2024-12-10 17:42:07,79,8937,37,42,6221.89,11452.00,0.00
2024-12-10 17:42:07,80,8937,38,42,6144.12,11452.01,0.00
2024-12-10 17:42:07,80,8938,38,42,6078.58,11453.00,0.00
2024-12-10 17:42:07,81,8938,39,42,6003.54,11453.01,0.00
2024-12-10 17:42:07,80,8938,39,41,6061.43,11453.13,0.00
2024-12-10 17:42:07,80,8939,39,41,6033.83,11454.00,0.00
2024-12-10 17:42:07,81,8939,39,42,5959.34,11454.01,0.00
2024-12-10 17:42:07,81,8940,39,42,5891.62,11455.00,0.00
2024-12-10 17:42:07,82,8940,40,42,5819.78,11455.01,0.00
2024-12-10 17:42:07,81,8940,39,42,5890.21,11455.01,0.00
2024-12-10 17:42:07,80,8940,39,41,5933.80,11455.17,0.00
2024-12-10 17:42:07,79,8940,38,41,5900.55,11455.85,0.00
2024-12-10 17:42:07,79,8941,38,41,6021.55,11456.00,0.00
2024-12-10 17:42:07,80,8941,39,41,5946.28,11456.01,0.00
2024-12-10 17:42:07,79,8941,39,40,6020.10,11456.01,0.00
2024-12-10 17:42:07,78,8941,38,40,6027.08,11456.24,0.00
2024-12-10 17:42:07,77,8941,37,40,6051.60,11456.44,0.00
2024-12-10 17:42:07,77,8942,37,40,6129.87,11457.00,0.00
2024-12-10 17:42:07,78,8942,37,41,6051.28,11457.01,0.00
2024-12-10 17:42:07,77,8942,37,40,6100.14,11457.17,0.00
2024-12-10 17:42:08,76,8942,36,40,6121.10,11457.66,0.00
2024-12-10 17:42:08,76,8943,36,40,6165.89,11458.00,0.00
2024-12-10 17:42:08,77,8943,36,41,6085.81,11458.01,0.00
2024-12-10 17:42:08,78,8942,37,41,5959.34,11458.21,0.00
2024-12-10 17:42:08,77,8942,36,41,6045.77,11458.44,0.00
2024-12-10 17:42:08,78,8941,36,42,5925.02,11458.81,0.00
2024-12-10 17:42:08,78,8942,36,42,6065.22,11459.00,0.00
2024-12-10 17:42:08,79,8942,37,42,5988.45,11459.01,0.00
2024-12-10 17:42:08,78,8942,37,41,6034.40,11459.17,0.00
2024-12-10 17:42:08,77,8942,36,41,6093.95,11459.32,0.00
2024-12-10 17:42:08,77,8943,36,41,6393.69,11460.00,0.00
2024-12-10 17:42:08,78,8943,37,41,6311.72,11460.01,0.00
2024-12-10 17:42:08,78,8944,37,41,6255.32,11461.00,0.00
2024-12-10 17:42:08,79,8944,37,42,6176.14,11461.01,0.00
2024-12-10 17:42:08,78,8944,37,41,6217.17,11461.21,0.00
2024-12-10 17:42:08,78,8945,37,41,6205.49,11462.00,0.00
2024-12-10 17:42:08,79,8945,38,41,6126.94,11462.01,0.00
2024-12-10 17:42:08,78,8945,38,40,6204.02,11462.01,0.00
2024-12-10 17:42:08,78,8946,38,40,6182.73,11463.00,0.00
2024-12-10 17:42:08,79,8946,38,41,6104.47,11463.01,0.00
2024-12-10 17:42:08,79,8947,38,41,6070.83,11464.00,0.00
2024-12-10 17:42:08,80,8947,39,41,5994.95,11464.01,0.00
2024-12-10 17:42:08,81,8946,39,42,5816.50,11464.70,0.00
2024-12-10 17:42:08,81,8947,39,42,5947.35,11465.00,0.00
2024-12-10 17:42:08,82,8947,40,42,5874.83,11465.01,0.00
2024-12-10 17:42:08,81,8947,39,42,5945.94,11465.01,0.00
2024-12-10 17:42:08,80,8947,39,41,5980.17,11465.17,0.00
2024-12-10 17:42:08,79,8947,39,40,6049.84,11465.23,0.00
2024-12-10 17:42:08,80,8946,40,40,5917.18,11465.75,0.00
2024-12-10 17:42:08,79,8946,40,39,6002.96,11465.77,0.00
2024-12-10 17:42:08,79,8947,40,39,6209.22,11466.00,0.00
2024-12-10 17:42:08,80,8947,41,39,6131.60,11466.01,0.00
2024-12-10 17:42:08,80,8948,41,39,6228.48,11467.00,0.00
2024-12-10 17:42:08,81,8948,41,40,6151.58,11467.01,0.00
2024-12-10 17:42:08,80,8948,41,39,6189.83,11467.20,0.00
2024-12-10 17:42:08,80,8949,41,39,6184.09,11468.00,0.00
2024-12-10 17:42:08,81,8949,42,39,6107.75,11468.01,0.00
2024-12-10 17:42:08,80,8949,41,39,6029.04,11468.67,0.00
2024-12-10 17:42:08,80,8950,41,39,6135.37,11469.00,0.00
2024-12-10 17:42:08,81,8950,41,40,6059.62,11469.01,0.00
2024-12-10 17:42:08,80,8950,41,39,6094.28,11469.21,0.00
2024-12-10 17:42:08,80,8951,41,39,6086.60,11470.00,0.00
2024-12-10 17:42:08,81,8951,42,39,6011.46,11470.01,0.00
2024-12-10 17:42:08,80,8951,41,39,6083.74,11470.03,0.00
2024-12-10 17:42:08,79,8951,40,39,6108.52,11470.23,0.00
2024-12-10 17:42:08,79,8952,40,39,6110.24,11471.00,0.00
2024-12-10 17:42:08,80,8952,40,40,6033.86,11471.01,0.00
2024-12-10 17:42:08,79,8952,40,39,6107.35,11471.03,0.00
2024-12-10 17:42:08,78,8952,40,38,6138.57,11471.19,0.00
2024-12-10 17:42:08,77,8952,40,37,6201.05,11471.29,0.00
2024-12-10 17:42:08,77,8953,40,37,6208.96,11472.00,0.00
2024-12-10 17:42:08,78,8953,40,38,6129.36,11472.01,0.00
2024-12-10 17:42:08,77,8953,39,38,6116.78,11472.32,0.00
2024-12-10 17:42:08,77,8954,39,38,6188.75,11473.00,0.00
2024-12-10 17:42:08,78,8954,39,39,6109.40,11473.01,0.00
2024-12-10 17:42:08,77,8954,39,38,6185.77,11473.03,0.00
2024-12-10 17:42:08,76,8954,39,37,6255.04,11473.12,0.00
2024-12-10 17:42:08,75,8954,39,36,6297.17,11473.21,0.00
2024-12-10 17:42:08,74,8954,38,36,6364.20,11473.24,0.00
2024-12-10 17:42:08,74,8955,38,36,6432.91,11474.00,0.00
2024-12-10 17:42:08,75,8955,39,36,6347.14,11474.01,0.00
2024-12-10 17:42:08,74,8955,38,36,6429.82,11474.03,0.00
2024-12-10 17:42:08,74,8956,38,36,6394.43,11475.00,0.00
2024-12-10 17:42:08,75,8956,39,36,6309.17,11475.01,0.00
2024-12-10 17:42:08,74,8956,39,35,6391.33,11475.03,0.00
2024-12-10 17:42:08,73,8956,39,34,6430.20,11475.19,0.00
2024-12-10 17:42:08,73,8957,39,34,6432.28,11476.00,0.00
2024-12-10 17:42:08,74,8957,40,34,6345.36,11476.01,0.00
2024-12-10 17:42:08,73,8957,40,33,6429.14,11476.03,0.00
2024-12-10 17:42:08,74,8956,41,33,6200.69,11476.59,0.00
2024-12-10 17:42:08,74,8957,41,33,6350.74,11477.00,0.00
2024-12-10 17:42:08,75,8957,41,34,6266.07,11477.01,0.00
2024-12-10 17:42:08,74,8957,41,33,6347.65,11477.03,0.00
2024-12-10 17:42:08,73,8957,41,32,6389.05,11477.16,0.00
2024-12-10 17:42:08,73,8958,41,32,6537.95,11478.00,0.00
2024-12-10 17:42:08,74,8958,41,33,6449.60,11478.01,0.00
2024-12-10 17:42:08,73,8958,41,32,6497.21,11478.03,0.00
2024-12-10 17:42:08,73,8959,41,32,6501.43,11479.00,0.00
2024-12-10 17:42:08,74,8959,41,33,6413.57,11479.01,0.00
2024-12-10 17:42:08,73,8959,40,33,6452.54,11479.01,0.00
2024-12-10 17:42:08,72,8959,40,32,6540.57,11479.01,0.00
2024-12-10 17:42:08,72,8960,40,32,6550.01,11480.00,0.00
2024-12-10 17:42:08,73,8960,40,33,6460.28,11480.01,0.00
2024-12-10 17:42:08,74,8959,40,34,6349.79,11480.24,0.00
2024-12-10 17:42:08,75,8958,40,35,6284.18,11480.49,0.00
2024-12-10 17:42:08,76,8957,40,36,6220.00,11480.55,0.00
2024-12-10 17:42:08,76,8958,40,36,6421.20,11481.00,0.00
2024-12-10 17:42:08,77,8958,40,37,6337.81,11481.01,0.00
2024-12-10 17:42:08,77,8959,40,37,6730.35,11482.00,0.00
2024-12-10 17:42:08,78,8959,41,37,6644.06,11482.01,0.00
2024-12-10 17:42:08,77,8959,41,36,6667.85,11482.35,0.00
2024-12-10 17:42:08,76,8959,40,36,6720.59,11482.45,0.00
2024-12-10 17:42:08,77,8958,40,37,6588.18,11482.81,0.00
2024-12-10 17:42:08,77,8959,40,37,6791.17,11483.00,0.00
2024-12-10 17:42:08,78,8959,41,37,6704.10,11483.01,0.00
2024-12-10 17:42:08,79,8958,42,37,6539.92,11483.46,0.00
2024-12-10 17:42:08,78,8958,41,37,6603.39,11483.55,0.00
2024-12-10 17:42:08,78,8959,41,37,6844.00,11484.00,0.00
2024-12-10 17:42:08,79,8959,41,38,6757.37,11484.01,0.00
2024-12-10 17:42:08,79,8960,41,38,6836.32,11485.00,0.00
2024-12-10 17:42:08,80,8960,42,38,6750.87,11485.01,0.00
2024-12-10 17:42:08,79,8960,42,37,6738.92,11485.35,0.00
2024-12-10 17:42:08,80,8959,43,37,6637.56,11485.53,0.00
2024-12-10 17:42:09,80,8960,43,37,6756.13,11486.00,0.00
2024-12-10 17:42:09,81,8960,43,38,6672.72,11486.01,0.00
2024-12-10 17:42:09,80,8960,43,37,6679.46,11486.30,0.00
2024-12-10 17:42:09,80,8961,43,37,6819.16,11487.00,0.00
2024-12-10 17:42:09,81,8961,43,38,6734.97,11487.01,0.00
2024-12-10 17:42:09,80,8961,43,37,6801.95,11487.10,0.00
2024-12-10 17:42:09,80,8962,43,37,6773.54,11488.00,0.00
2024-12-10 17:42:09,81,8962,44,37,6689.91,11488.01,0.00
2024-12-10 17:42:09,80,8962,44,36,6750.62,11488.20,0.00
2024-12-10 17:42:09,80,8963,44,36,6740.77,11489.00,0.00
2024-12-10 17:42:09,81,8963,44,37,6657.55,11489.01,0.00
2024-12-10 17:42:09,80,8963,43,37,6737.90,11489.03,0.00
2024-12-10 17:42:09,79,8963,42,37,6634.57,11489.91,0.00
2024-12-10 17:42:09,79,8964,42,37,6725.80,11490.00,0.00
2024-12-10 17:42:09,80,8964,42,38,6641.72,11490.01,0.00
2024-12-10 17:42:09,79,8964,41,38,6702.59,11490.20,0.00
2024-12-10 17:42:09,80,8963,41,39,6558.57,11490.49,0.00
2024-12-10 17:42:09,80,8964,41,39,6622.33,11491.00,0.00
2024-12-10 17:42:09,81,8964,41,40,6540.57,11491.01,0.00
2024-12-10 17:42:09,80,8964,41,39,6576.47,11491.31,0.00
2024-12-10 17:42:09,81,8963,41,40,6491.05,11491.37,0.00
2024-12-10 17:42:09,82,8962,42,40,6323.60,11491.83,0.00
2024-12-10 17:42:09,81,8962,41,40,6348.94,11491.96,0.00
2024-12-10 17:42:09,81,8963,41,40,6570.67,11492.00,0.00
2024-12-10 17:42:09,82,8963,42,40,6490.54,11492.01,0.00
2024-12-10 17:42:09,81,8963,42,39,6468.61,11492.44,0.00
2024-12-10 17:42:09,82,8962,42,40,6361.83,11492.71,0.00
2024-12-10 17:42:09,82,8963,42,40,6705.67,11493.00,0.00
2024-12-10 17:42:09,83,8963,43,40,6624.88,11493.01,0.00
2024-12-10 17:42:09,82,8963,42,40,6617.85,11493.52,0.00
2024-12-10 17:42:09,81,8963,42,39,6625.10,11493.94,0.00
2024-12-10 17:42:09,81,8964,42,39,6880.58,11494.00,0.00
2024-12-10 17:42:09,82,8964,43,39,6796.67,11494.01,0.00
2024-12-10 17:42:09,82,8965,43,39,6751.17,11495.00,0.00
2024-12-10 17:42:09,83,8965,43,40,6669.83,11495.01,0.00
2024-12-10 17:42:09,82,8965,42,40,6746.98,11495.04,0.00
2024-12-10 17:42:09,83,8964,43,40,6635.30,11495.33,0.00
2024-12-10 17:42:09,83,8965,43,40,6737.86,11496.00,0.00
2024-12-10 17:42:09,84,8965,43,41,6657.64,11496.01,0.00
2024-12-10 17:42:09,84,8966,43,41,6769.23,11497.00,0.00
2024-12-10 17:42:09,85,8966,44,41,6689.59,11497.01,0.00
2024-12-10 17:42:09,85,8967,44,41,6593.12,11498.00,0.00
2024-12-10 17:42:09,86,8967,44,42,6516.45,11498.01,0.00
2024-12-10 17:42:09,85,8967,44,41,6480.30,11498.54,0.00
2024-12-10 17:42:09,85,8968,44,41,6523.52,11499.00,0.00
2024-12-10 17:42:09,86,8968,45,41,6447.66,11499.01,0.00
2024-12-10 17:42:09,85,8968,45,40,6519.47,11499.04,0.00
2024-12-10 17:42:09,85,8969,45,40,6401.04,11500.00,0.00
2024-12-10 17:42:09,86,8969,46,40,6326.60,11500.01,0.00
2024-12-10 17:42:09,85,8969,45,40,6378.58,11500.20,0.00
2024-12-10 17:42:09,84,8969,45,39,6424.43,11500.27,0.00
2024-12-10 17:42:09,83,8969,44,39,6314.52,11500.95,0.00
2024-12-10 17:42:09,83,8970,44,39,6447.58,11501.00,0.00
2024-12-10 17:42:09,84,8970,45,39,6370.82,11501.01,0.00
2024-12-10 17:42:09,83,8970,44,39,6265.81,11501.74,0.00
2024-12-10 17:42:09,83,8971,44,39,6336.46,11502.00,0.00
2024-12-10 17:42:09,84,8971,44,40,6261.03,11502.01,0.00
2024-12-10 17:42:09,83,8971,43,40,6314.96,11502.19,0.00
2024-12-10 17:42:09,82,8971,43,39,6347.35,11502.34,0.00
2024-12-10 17:42:09,81,8971,42,39,6403.08,11502.53,0.00
2024-12-10 17:42:09,81,8972,42,39,6318.72,11503.00,0.00
2024-12-10 17:42:09,82,8972,42,40,6241.66,11503.01,0.00
2024-12-10 17:42:09,81,8972,42,39,6173.61,11503.68,0.00
2024-12-10 17:42:09,82,8971,43,39,6087.18,11503.79,0.00
2024-12-10 17:42:09,81,8971,42,39,6148.06,11503.89,0.00
2024-12-10 17:42:09,80,8971,41,39,6203.62,11503.90,0.00
2024-12-10 17:42:09,80,8972,41,39,6334.91,11504.00,0.00
2024-12-10 17:42:09,81,8972,41,40,6256.70,11504.01,0.00
2024-12-10 17:42:09,82,8971,41,41,6160.80,11504.21,0.00
2024-12-10 17:42:09,81,8971,40,41,6277.43,11504.35,0.00
2024-12-10 17:42:09,81,8972,40,41,6453.41,11505.00,0.00
2024-12-10 17:42:09,82,8972,40,42,6374.71,11505.01,0.00
2024-12-10 17:42:09,81,8972,39,42,6406.66,11505.32,0.00
2024-12-10 17:42:09,80,8972,39,41,6466.62,11505.34,0.00
2024-12-10 17:42:09,80,8973,39,41,6668.82,11506.00,0.00
2024-12-10 17:42:09,81,8973,39,42,6586.49,11506.01,0.00
2024-12-10 17:42:09,80,8973,38,42,6616.23,11506.20,0.00
2024-12-10 17:42:09,80,8974,38,42,6623.08,11507.00,0.00
2024-12-10 17:42:09,81,8974,39,42,6541.31,11507.01,0.00
2024-12-10 17:42:09,80,8974,39,41,6618.77,11507.04,0.00
2024-12-10 17:42:09,79,8974,38,41,6641.42,11507.19,0.00
2024-12-10 17:42:09,80,8973,38,42,6549.81,11507.29,0.00
2024-12-10 17:42:09,81,8972,38,43,6459.08,11507.47,0.00
2024-12-10 17:42:09,81,8973,38,43,6627.65,11508.00,0.00
2024-12-10 17:42:09,82,8973,38,44,6546.83,11508.01,0.00
2024-12-10 17:42:09,81,8973,38,43,6578.04,11508.31,0.00
2024-12-10 17:42:09,81,8974,38,43,6838.88,11509.00,0.00
2024-12-10 17:42:09,82,8974,38,44,6755.48,11509.01,0.00
2024-12-10 17:42:09,81,8974,37,44,6726.73,11509.49,0.00
2024-12-10 17:42:09,81,8975,37,44,6731.34,11510.00,0.00
2024-12-10 17:42:09,82,8975,38,44,6649.25,11510.01,0.00
2024-12-10 17:42:09,81,8975,37,44,6727.08,11510.04,0.00
2024-12-10 17:42:09,80,8975,37,43,6738.27,11510.33,0.00
2024-12-10 17:42:09,79,8975,36,43,6641.06,11510.83,0.00
2024-12-10 17:42:09,79,8976,36,43,6767.97,11511.00,0.00
2024-12-10 17:42:09,80,8976,37,43,6683.37,11511.01,0.00
2024-12-10 17:42:09,80,8977,37,43,6507.85,11512.00,0.00
2024-12-10 17:42:09,81,8977,38,43,6427.51,11512.01,0.00
2024-12-10 17:42:09,82,8976,39,43,6266.48,11512.51,0.00
2024-12-10 17:42:09,81,8976,39,42,6303.28,11512.80,0.00
2024-12-10 17:42:09,80,8976,38,42,6360.11,11512.81,0.00
2024-12-10 17:42:09,80,8977,38,42,6431.39,11513.00,0.00
2024-12-10 17:42:09,81,8977,39,42,6351.99,11513.01,0.00
2024-12-10 17:42:10,80,8977,39,41,6378.25,11513.34,0.00
2024-12-10 17:42:10,80,8978,39,41,6502.30,11514.00,0.00
2024-12-10 17:42:10,81,8978,39,42,6422.03,11514.01,0.00
2024-12-10 17:42:10,80,8978,38,42,6466.25,11514.33,0.00
2024-12-10 17:42:10,80,8979,38,42,6433.84,11515.00,0.00
2024-12-10 17:42:10,81,8979,39,42,6354.41,11515.01,0.00
2024-12-10 17:42:10,80,8979,38,42,6269.68,11515.76,0.00
2024-12-10 17:42:10,79,8979,37,42,6293.93,11515.87,0.00
2024-12-10 17:42:10,79,8980,37,42,6425.22,11516.00,0.00
2024-12-10 17:42:10,80,8980,38,42,6344.90,11516.01,0.00
2024-12-10 17:42:10,79,8980,38,41,6375.76,11516.33,0.00
2024-12-10 17:42:10,79,8981,38,41,6324.54,11517.00,0.00
2024-12-10 17:42:10,80,8981,38,42,6245.48,11517.01,0.00
2024-12-10 17:42:10,79,8981,37,42,6292.48,11517.08,0.00
2024-12-10 17:42:10,78,8981,36,42,6369.10,11517.10,0.00
2024-12-10 17:42:10,77,8981,35,42,6297.55,11517.70,0.00
2024-12-10 17:42:10,77,8982,35,42,6397.67,11518.00,0.00
2024-12-10 17:42:10,78,8982,35,43,6315.65,11518.01,0.00
2024-12-10 17:42:10,77,8982,35,42,6393.19,11518.04,0.00
2024-12-10 17:42:10,77,8983,35,42,6313.25,11519.00,0.00
2024-12-10 17:42:10,78,8983,35,43,6232.31,11519.01,0.00
2024-12-10 17:42:10,77,8983,35,42,6308.77,11519.04,0.00
2024-12-10 17:42:10,76,8983,34,42,6356.51,11519.25,0.00
2024-12-10 17:42:10,75,8983,34,41,6407.51,11519.36,0.00
2024-12-10 17:42:10,75,8984,34,41,6443.69,11520.00,0.00
2024-12-10 17:42:10,76,8984,35,41,6358.90,11520.01,0.00
2024-12-10 17:42:10,75,8984,35,40,6407.16,11520.04,0.00
2024-12-10 17:42:10,75,8985,35,40,6373.12,11521.00,0.00
2024-12-10 17:42:10,76,8985,36,40,6289.26,11521.01,0.00
2024-12-10 17:42:10,75,8985,35,40,6345.54,11521.25,0.00
2024-12-10 17:42:10,74,8985,35,39,6336.43,11521.68,0.00
2024-12-10 17:42:10,74,8986,35,39,6402.24,11522.00,0.00
2024-12-10 17:42:10,75,8986,36,39,6316.87,11522.01,0.00
2024-12-10 17:42:10,74,8986,36,38,6389.79,11522.05,0.00
2024-12-10 17:42:10,73,8986,35,38,6439.46,11522.12,0.00
2024-12-10 17:42:10,73,8987,35,38,6477.09,11523.00,0.00
2024-12-10 17:42:10,74,8987,35,39,6389.56,11523.01,0.00
2024-12-10 17:42:10,73,8987,35,38,6418.00,11523.32,0.00
2024-12-10 17:42:10,72,8987,34,38,6439.24,11523.61,0.00
2024-12-10 17:42:10,72,8988,34,38,6489.62,11524.00,0.00
2024-12-10 17:42:10,73,8988,35,38,6400.73,11524.01,0.00
2024-12-10 17:42:10,72,8988,35,37,6484.83,11524.04,0.00
2024-12-10 17:42:10,72,8989,35,37,6462.27,11525.00,0.00
2024-12-10 17:42:10,73,8989,36,37,6373.75,11525.01,0.00
2024-12-10 17:42:10,72,8989,35,37,6448.32,11525.11,0.00
2024-12-10 17:42:10,71,8989,34,37,6448.81,11525.48,0.00
2024-12-10 17:42:10,71,8990,34,37,6523.24,11526.00,0.00
2024-12-10 17:42:10,72,8990,35,37,6432.64,11526.01,0.00
2024-12-10 17:42:10,71,8990,34,37,6501.85,11526.20,0.00
2024-12-10 17:42:10,71,8991,34,37,6484.16,11527.00,0.00
2024-12-10 17:42:10,72,8991,35,37,6394.10,11527.01,0.00
2024-12-10 17:42:10,71,8991,34,37,6459.88,11527.23,0.00
2024-12-10 17:42:10,71,8992,34,37,6423.87,11528.00,0.00
2024-12-10 17:42:10,72,8992,34,38,6334.65,11528.01,0.00
2024-12-10 17:42:10,71,8992,34,37,6368.32,11528.31,0.00
2024-12-10 17:42:10,71,8993,34,37,6386.64,11529.00,0.00
2024-12-10 17:42:10,72,8993,34,38,6297.93,11529.01,0.00
2024-12-10 17:42:10,71,8993,33,38,6380.15,11529.06,0.00
2024-12-10 17:42:10,71,8994,33,38,6349.60,11530.00,0.00
2024-12-10 17:42:10,72,8994,34,38,6261.41,11530.01,0.00
2024-12-10 17:42:10,71,8994,33,38,6336.26,11530.01,0.00
2024-12-10 17:42:10,70,8994,33,37,6336.23,11530.40,0.00
2024-12-10 17:42:10,70,8995,33,37,6430.73,11531.00,0.00
2024-12-10 17:42:10,71,8995,33,38,6340.16,11531.01,0.00
2024-12-10 17:42:10,70,8995,33,37,6425.80,11531.04,0.00
2024-12-10 17:42:10,71,8994,34,37,6286.62,11531.21,0.00
2024-12-10 17:42:10,71,8995,34,37,6439.10,11532.00,0.00
2024-12-10 17:42:10,72,8995,35,37,6349.67,11532.01,0.00
2024-12-10 17:42:10,72,8996,35,37,6445.72,11533.00,0.00
2024-12-10 17:42:10,73,8996,35,38,6357.43,11533.01,0.00
2024-12-10 17:42:10,72,8996,35,37,6423.31,11533.04,0.00
2024-12-10 17:42:10,72,8997,35,37,6377.19,11534.00,0.00
2024-12-10 17:42:10,73,8997,36,37,6289.83,11534.01,0.00
2024-12-10 17:42:10,74,8996,37,37,6195.50,11534.12,0.00
2024-12-10 17:42:10,74,8997,37,37,6251.96,11535.00,0.00
2024-12-10 17:42:10,75,8997,38,37,6168.60,11535.01,0.00
2024-12-10 17:42:10,76,8996,39,37,6087.44,11535.04,0.00
2024-12-10 17:42:10,75,8996,38,37,6277.75,11535.21,0.00
2024-12-10 17:42:10,74,8996,38,36,6353.23,11535.24,0.00
2024-12-10 17:42:10,74,8997,38,36,6481.46,11536.00,0.00
2024-12-10 17:42:10,75,8997,38,37,6395.04,11536.01,0.00
2024-12-10 17:42:10,75,8998,38,37,6451.66,11537.00,0.00
2024-12-10 17:42:10,76,8998,39,37,6366.77,11537.01,0.00
2024-12-10 17:42:10,75,8998,39,36,6396.29,11537.19,0.00
2024-12-10 17:42:10,74,8998,38,36,6482.73,11537.19,0.00
2024-12-10 17:42:10,73,8998,37,36,6491.73,11537.75,0.00
2024-12-10 17:42:10,72,8998,36,36,6557.11,11537.90,0.00
2024-12-10 17:42:10,72,8999,36,36,6706.22,11538.00,0.00
2024-12-10 17:42:10,73,8999,37,36,6614.35,11538.01,0.00
2024-12-10 17:42:10,72,8999,36,36,6702.46,11538.04,0.00
2024-12-10 17:42:10,72,9000,36,36,6645.12,11539.00,0.00
2024-12-10 17:42:10,73,9000,37,36,6554.09,11539.01,0.00
2024-12-10 17:42:10,72,9000,37,35,6568.80,11539.19,0.00
2024-12-10 17:42:10,71,9000,36,35,6632.46,11539.27,0.00
2024-12-10 17:42:10,72,8999,36,36,6532.36,11539.36,0.00
2024-12-10 17:42:10,72,9000,36,36,6694.67,11540.00,0.00
2024-12-10 17:42:10,73,9000,36,37,6602.97,11540.01,0.00
2024-12-10 17:42:10,73,9001,36,37,6706.34,11541.00,0.00
2024-12-10 17:42:10,74,9001,37,37,6615.72,11541.01,0.00
2024-12-10 17:42:10,73,9001,36,37,6688.15,11541.15,0.00
2024-12-10 17:42:10,72,9001,36,36,6745.78,11541.18,0.00
2024-12-10 17:42:10,72,9002,36,36,6746.72,11542.00,0.00
2024-12-10 17:42:10,73,9002,36,37,6654.30,11542.01,0.00
2024-12-10 17:42:10,74,9001,37,37,6506.74,11542.27,0.00
2024-12-10 17:42:10,74,9002,37,37,6606.54,11543.00,0.00
2024-12-10 17:42:10,75,9002,37,38,6518.45,11543.01,0.00
2024-12-10 17:42:11,74,9002,37,37,6601.88,11543.04,0.00
2024-12-10 17:42:11,73,9002,37,36,6649.66,11543.16,0.00
2024-12-10 17:42:11,73,9003,37,36,6801.44,11544.00,0.00
2024-12-10 17:42:11,74,9003,37,37,6709.53,11544.01,0.00
2024-12-10 17:42:11,73,9003,36,37,6694.65,11544.59,0.00
2024-12-10 17:42:11,73,9004,36,37,6751.05,11545.00,0.00
2024-12-10 17:42:11,74,9004,36,38,6659.82,11545.01,0.00
2024-12-10 17:42:11,73,9004,36,37,6705.26,11545.18,0.00
2024-12-10 17:42:11,72,9004,35,37,6795.18,11545.19,0.00
2024-12-10 17:42:11,72,9005,35,37,6792.08,11546.00,0.00
2024-12-10 17:42:11,73,9005,35,38,6699.04,11546.01,0.00
2024-12-10 17:42:11,73,9006,35,38,6652.05,11547.00,0.00
2024-12-10 17:42:11,74,9006,35,39,6562.16,11547.01,0.00
2024-12-10 17:42:11,73,9006,35,38,6607.82,11547.18,0.00
2024-12-10 17:42:11,73,9007,35,38,6598.35,11548.00,0.00
2024-12-10 17:42:11,74,9007,36,38,6509.18,11548.01,0.00
2024-12-10 17:42:11,73,9007,35,38,6446.52,11548.78,0.00
2024-12-10 17:42:11,73,9008,35,38,6579.59,11549.00,0.00
2024-12-10 17:42:11,74,9008,35,39,6490.67,11549.01,0.00
2024-12-10 17:42:11,73,9008,35,38,6543.25,11549.16,0.00
2024-12-10 17:42:11,73,9009,35,38,6532.50,11550.00,0.00
2024-12-10 17:42:11,74,9009,35,39,6444.22,11550.01,0.00
2024-12-10 17:42:11,75,9008,36,39,6355.23,11550.07,0.00
2024-12-10 17:42:11,75,9009,36,39,6456.89,11551.00,0.00
2024-12-10 17:42:11,76,9009,37,39,6371.93,11551.01,0.00
2024-12-10 17:42:11,75,9009,36,39,6447.69,11551.08,0.00
2024-12-10 17:42:11,74,9009,35,39,6398.68,11551.88,0.00
2024-12-10 17:42:11,74,9010,35,39,6696.93,11552.00,0.00
2024-12-10 17:42:11,75,9010,35,40,6607.64,11552.01,0.00
2024-12-10 17:42:11,75,9011,35,40,6579.16,11553.00,0.00
2024-12-10 17:42:11,76,9011,35,41,6492.59,11553.01,0.00
2024-12-10 17:42:11,76,9012,35,41,6440.17,11554.00,0.00
2024-12-10 17:42:11,77,9012,35,42,6356.53,11554.01,0.00
2024-12-10 17:42:11,76,9012,35,41,6411.33,11554.14,0.00
2024-12-10 17:42:11,75,9012,34,41,6346.74,11554.97,0.00
2024-12-10 17:42:11,75,9013,34,41,6497.74,11555.00,0.00
2024-12-10 17:42:11,76,9013,35,41,6412.24,11555.01,0.00
2024-12-10 17:42:11,77,9012,35,42,6325.98,11555.06,0.00
2024-12-10 17:42:11,76,9012,34,42,6409.37,11555.11,0.00
2024-12-10 17:42:11,76,9013,34,42,6385.67,11556.00,0.00
2024-12-10 17:42:11,77,9013,34,43,6302.74,11556.01,0.00
2024-12-10 17:42:11,76,9013,34,42,6336.25,11556.16,0.00
2024-12-10 17:42:11,76,9014,34,42,6484.48,11557.00,0.00
2024-12-10 17:42:11,77,9014,35,42,6400.27,11557.01,0.00
2024-12-10 17:42:11,76,9014,35,41,6460.20,11557.13,0.00
2024-12-10 17:42:11,76,9015,35,41,6451.32,11558.00,0.00
2024-12-10 17:42:11,77,9015,36,41,6367.54,11558.01,0.00
2024-12-10 17:42:11,76,9015,35,41,6322.10,11558.49,0.00
2024-12-10 17:42:11,76,9016,35,41,6415.22,11559.00,0.00
2024-12-10 17:42:11,77,9016,35,42,6331.91,11559.01,0.00
2024-12-10 17:42:11,76,9016,35,41,6384.85,11559.13,0.00
2024-12-10 17:42:11,76,9017,35,41,6376.23,11560.00,0.00
2024-12-10 17:42:11,77,9017,35,42,6293.42,11560.01,0.00
2024-12-10 17:42:11,76,9017,34,42,6249.43,11560.75,0.00
2024-12-10 17:42:11,76,9018,34,42,6372.84,11561.00,0.00
2024-12-10 17:42:11,77,9018,34,43,6290.08,11561.01,0.00
2024-12-10 17:42:11,76,9018,33,43,6336.38,11561.12,0.00
2024-12-10 17:42:11,76,9019,33,43,6356.42,11562.00,0.00
2024-12-10 17:42:11,77,9019,34,43,6273.87,11562.01,0.00
2024-12-10 17:42:11,76,9019,34,42,6327.56,11562.13,0.00
2024-12-10 17:42:11,76,9020,34,42,6318.86,11563.00,0.00
2024-12-10 17:42:11,77,9020,34,43,6236.80,11563.01,0.00
2024-12-10 17:42:11,76,9020,33,43,6212.41,11563.16,0.00
2024-12-10 17:42:11,76,9021,33,43,6267.67,11564.00,0.00
2024-12-10 17:42:11,77,9021,33,44,6186.27,11564.01,0.00
2024-12-10 17:42:11,76,9021,32,44,6176.51,11564.38,0.00
2024-12-10 17:42:11,76,9022,32,44,6257.56,11565.00,0.00
2024-12-10 17:42:11,77,9022,33,44,6176.29,11565.01,0.00
2024-12-10 17:42:11,76,9022,32,44,6218.03,11565.08,0.00
2024-12-10 17:42:11,75,9022,31,44,6299.40,11565.08,0.00
2024-12-10 17:42:11,75,9023,31,44,6316.87,11566.00,0.00
2024-12-10 17:42:11,76,9023,32,44,6233.75,11566.01,0.00
2024-12-10 17:42:11,75,9023,32,43,6276.82,11566.13,0.00
2024-12-10 17:42:11,75,9024,32,43,6269.61,11567.00,0.00
2024-12-10 17:42:11,76,9024,33,43,6187.11,11567.01,0.00
2024-12-10 17:42:11,75,9024,33,42,6257.96,11567.11,0.00
2024-12-10 17:42:11,74,9024,32,42,6261.88,11567.26,0.00
2024-12-10 17:42:11,74,9025,32,42,6332.67,11568.00,0.00
2024-12-10 17:42:11,75,9025,32,43,6248.24,11568.01,0.00
2024-12-10 17:42:11,74,9025,32,42,6289.21,11568.15,0.00
2024-12-10 17:42:11,74,9026,32,42,6285.02,11569.00,0.00
2024-12-10 17:42:11,75,9026,33,42,6201.22,11569.01,0.00
2024-12-10 17:42:11,74,9026,33,41,6276.97,11569.08,0.00
2024-12-10 17:42:11,73,9026,32,41,6247.41,11569.48,0.00
2024-12-10 17:42:11,73,9027,32,41,6346.04,11570.00,0.00
2024-12-10 17:42:11,74,9027,33,41,6260.28,11570.01,0.00
2024-12-10 17:42:11,73,9027,33,40,6308.05,11570.14,0.00
2024-12-10 17:42:11,74,9026,34,40,6208.77,11570.28,0.00
2024-12-10 17:42:11,75,9025,35,40,6192.40,11570.48,0.00
2024-12-10 17:42:11,75,9026,35,40,6283.80,11571.00,0.00
2024-12-10 17:42:11,76,9026,36,40,6201.12,11571.01,0.00
2024-12-10 17:42:11,76,9027,36,40,6465.27,11572.00,0.00
2024-12-10 17:42:11,77,9027,36,41,6381.30,11572.01,0.00
2024-12-10 17:42:11,76,9027,36,40,6455.16,11572.09,0.00
2024-12-10 17:42:11,75,9027,36,39,6513.47,11572.13,0.00
2024-12-10 17:42:11,74,9027,35,39,6568.80,11572.41,0.00
2024-12-10 17:42:11,74,9028,35,39,6594.25,11573.00,0.00
2024-12-10 17:42:11,75,9028,35,40,6506.32,11573.01,0.00
2024-12-10 17:42:11,74,9028,34,40,6541.13,11573.20,0.00
2024-12-10 17:42:11,74,9029,34,40,6551.25,11574.00,0.00
2024-12-10 17:42:11,75,9029,35,40,6463.90,11574.01,0.00
2024-12-10 17:42:11,74,9029,35,39,6515.32,11574.13,0.00
2024-12-10 17:42:11,73,9029,34,39,6549.09,11574.62,0.00
2024-12-10 17:42:12,73,9030,34,39,6663.54,11575.00,0.00
2024-12-10 17:42:12,74,9030,34,40,6573.49,11575.01,0.00
2024-12-10 17:42:12,73,9030,34,39,6636.62,11575.14,0.00
2024-12-10 17:42:12,72,9030,33,39,6661.24,11575.69,0.00
2024-12-10 17:42:12,72,9031,33,39,6786.88,11576.00,0.00
2024-12-10 17:42:12,73,9031,34,39,6693.91,11576.01,0.00
2024-12-10 17:42:12,72,9031,33,39,6736.42,11576.17,0.00
2024-12-10 17:42:12,73,9030,34,39,6617.28,11576.42,0.00
2024-12-10 17:42:12,73,9031,34,39,6713.02,11577.00,0.00
2024-12-10 17:42:12,74,9031,35,39,6622.30,11577.01,0.00
2024-12-10 17:42:12,73,9031,35,38,6679.76,11577.14,0.00
2024-12-10 17:42:12,72,9031,34,38,6655.47,11577.92,0.00
2024-12-10 17:42:12,72,9032,34,38,6967.48,11578.00,0.00
2024-12-10 17:42:12,73,9032,35,38,6872.04,11578.01,0.00
2024-12-10 17:42:12,74,9031,36,38,6708.90,11578.38,0.00
2024-12-10 17:42:12,74,9032,36,38,6812.17,11579.00,0.00
2024-12-10 17:42:12,75,9032,37,38,6721.34,11579.01,0.00
2024-12-10 17:42:12,74,9032,37,37,6771.51,11579.08,0.00
2024-12-10 17:42:12,74,9033,37,37,6916.04,11580.00,0.00
2024-12-10 17:42:12,75,9033,37,38,6823.83,11580.01,0.00
2024-12-10 17:42:12,74,9033,36,38,6912.92,11580.03,0.00
2024-12-10 17:42:12,74,9034,36,38,6863.31,11581.00,0.00
2024-12-10 17:42:12,75,9034,37,38,6771.80,11581.01,0.00
2024-12-10 17:42:12,74,9034,37,37,6838.31,11581.11,0.00
2024-12-10 17:42:12,73,9034,36,37,6843.34,11581.78,0.00
2024-12-10 17:42:12,73,9035,36,37,6976.79,11582.00,0.00
2024-12-10 17:42:12,74,9035,36,38,6882.51,11582.01,0.00
2024-12-10 17:42:12,75,9034,37,38,6684.51,11582.69,0.00
2024-12-10 17:42:12,75,9035,37,38,6776.96,11583.00,0.00
2024-12-10 17:42:12,76,9035,38,38,6687.79,11583.01,0.00
2024-12-10 17:42:12,75,9035,38,37,6744.58,11583.13,0.00
2024-12-10 17:42:12,75,9036,38,37,6891.84,11584.00,0.00
2024-12-10 17:42:12,76,9036,39,37,6801.16,11584.01,0.00
2024-12-10 17:42:12,77,9035,39,38,6709.84,11584.06,0.00
2024-12-10 17:42:12,76,9035,38,38,6828.23,11584.37,0.00
2024-12-10 17:42:12,76,9036,38,38,6907.94,11585.00,0.00
2024-12-10 17:42:12,77,9036,38,39,6818.23,11585.01,0.00
2024-12-10 17:42:12,78,9035,39,39,6730.81,11585.04,0.00
2024-12-10 17:42:12,77,9035,39,38,6860.41,11585.14,0.00
2024-12-10 17:42:12,77,9036,39,38,7002.38,11586.00,0.00
2024-12-10 17:42:12,78,9036,40,38,6912.61,11586.01,0.00
2024-12-10 17:42:12,78,9037,40,38,7010.45,11587.00,0.00
2024-12-10 17:42:12,79,9037,40,39,6921.71,11587.01,0.00
2024-12-10 17:42:12,78,9037,40,38,6979.31,11587.13,0.00
2024-12-10 17:42:12,77,9037,39,38,7062.45,11587.19,0.00
2024-12-10 17:42:12,76,9037,38,38,7112.69,11587.57,0.00
2024-12-10 17:42:12,76,9038,38,38,7154.19,11588.00,0.00
2024-12-10 17:42:12,77,9038,39,38,7061.28,11588.01,0.00
2024-12-10 17:42:12,76,9038,38,38,7102.42,11588.20,0.00
2024-12-10 17:42:12,75,9038,37,38,7082.56,11588.93,0.00
2024-12-10 17:42:12,75,9039,37,38,7229.40,11589.00,0.00
2024-12-10 17:42:12,76,9039,38,38,7134.28,11589.01,0.00
2024-12-10 17:42:12,75,9039,38,37,7198.56,11589.13,0.00
2024-12-10 17:42:12,75,9040,38,37,7142.64,11590.00,0.00
2024-12-10 17:42:12,76,9040,38,38,7048.66,11590.01,0.00
2024-12-10 17:42:12,75,9040,38,37,7047.81,11590.32,0.00
2024-12-10 17:42:12,75,9041,38,37,7063.72,11591.00,0.00
2024-12-10 17:42:12,76,9041,38,38,6970.77,11591.01,0.00
2024-12-10 17:42:12,75,9041,38,37,7028.23,11591.15,0.00
2024-12-10 17:42:12,74,9041,37,37,7004.70,11591.95,0.00
2024-12-10 17:42:12,74,9042,37,37,7155.11,11592.00,0.00
2024-12-10 17:42:12,75,9042,37,38,7059.71,11592.01,0.00
2024-12-10 17:42:12,75,9043,37,38,7012.62,11593.00,0.00
2024-12-10 17:42:12,76,9043,38,38,6920.35,11593.01,0.00
2024-12-10 17:42:12,75,9043,37,38,6985.44,11593.11,0.00
2024-12-10 17:42:12,75,9044,37,38,7006.10,11594.00,0.00
2024-12-10 17:42:12,76,9044,38,38,6913.91,11594.01,0.00
2024-12-10 17:42:12,75,9044,38,37,6962.88,11594.17,0.00
2024-12-10 17:42:12,75,9045,38,37,6960.32,11595.00,0.00
2024-12-10 17:42:12,76,9045,39,37,6868.74,11595.01,0.00
2024-12-10 17:42:12,75,9045,38,37,6907.84,11595.20,0.00
2024-12-10 17:42:12,75,9046,38,37,6950.63,11596.00,0.00
2024-12-10 17:42:12,76,9046,39,37,6859.17,11596.01,0.00
2024-12-10 17:42:12,77,9045,39,38,6756.59,11596.16,0.00
2024-12-10 17:42:12,78,9044,40,38,6739.83,11596.41,0.00
2024-12-10 17:42:12,78,9045,40,38,6853.34,11597.00,0.00
2024-12-10 17:42:12,79,9045,40,39,6766.59,11597.01,0.00
2024-12-10 17:42:12,80,9044,40,40,6680.57,11597.05,0.00
2024-12-10 17:42:12,80,9045,40,40,6983.55,11598.00,0.00
2024-12-10 17:42:12,81,9045,40,41,6897.33,11598.01,0.00
2024-12-10 17:42:12,80,9045,40,40,6947.37,11598.16,0.00
2024-12-10 17:42:12,80,9046,40,40,7082.74,11599.00,0.00
2024-12-10 17:42:12,81,9046,40,41,6995.30,11599.01,0.00
2024-12-10 17:42:12,80,9046,39,41,7067.27,11599.14,0.00
2024-12-10 17:42:12,79,9046,38,41,7122.78,11599.18,0.00
2024-12-10 17:42:12,78,9046,37,41,7209.65,11599.21,0.00
2024-12-10 17:42:12,78,9047,37,41,7248.91,11600.00,0.00
2024-12-10 17:42:12,79,9047,38,41,7157.15,11600.01,0.00
2024-12-10 17:42:12,80,9046,39,41,7067.68,11600.04,0.00
2024-12-10 17:42:12,80,9047,39,41,7061.08,11601.00,0.00
2024-12-10 17:42:12,81,9047,39,42,6973.91,11601.01,0.00
2024-12-10 17:42:12,82,9046,39,43,6876.18,11601.15,0.00
2024-12-10 17:42:12,81,9046,38,43,6875.86,11601.68,0.00
2024-12-10 17:42:12,80,9046,37,43,6887.98,11601.90,0.00
2024-12-10 17:42:12,80,9047,37,43,7166.50,11602.00,0.00
2024-12-10 17:42:12,81,9047,37,44,7078.03,11602.01,0.00
2024-12-10 17:42:12,80,9047,37,43,7125.96,11602.15,0.00
2024-12-10 17:42:12,80,9048,37,43,7259.94,11603.00,0.00
2024-12-10 17:42:12,81,9048,38,43,7170.31,11603.01,0.00
2024-12-10 17:42:12,80,9048,38,42,7252.73,11603.06,0.00
2024-12-10 17:42:12,79,9048,37,42,7343.07,11603.06,0.00
2024-12-10 17:42:12,79,9049,37,42,7294.37,11604.00,0.00
2024-12-10 17:42:12,80,9049,38,42,7203.19,11604.01,0.00
2024-12-10 17:42:12,79,9049,38,41,7260.66,11604.14,0.00
2024-12-10 17:42:12,79,9050,38,41,7249.46,11605.00,0.00
2024-12-10 17:42:12,80,9050,38,42,7158.84,11605.01,0.00
2024-12-10 17:42:12,79,9050,38,41,7242.15,11605.06,0.00
2024-12-10 17:42:13,80,9049,39,41,7151.62,11605.09,0.00
2024-12-10 17:42:13,79,9049,38,41,7203.19,11605.59,0.00
2024-12-10 17:42:13,79,9050,38,41,7246.63,11606.00,0.00
2024-12-10 17:42:13,80,9050,39,41,7156.05,11606.01,0.00
2024-12-10 17:42:13,79,9050,39,40,7209.98,11606.14,0.00
2024-12-10 17:42:13,78,9050,38,40,7200.93,11606.58,0.00
2024-12-10 17:42:13,78,9051,38,40,7449.75,11607.00,0.00
2024-12-10 17:42:13,79,9051,38,41,7355.45,11607.01,0.00
2024-12-10 17:42:13,79,9052,38,41,7300.24,11608.00,0.00
2024-12-10 17:42:13,80,9052,39,41,7208.99,11608.01,0.00
2024-12-10 17:42:13,79,9052,39,40,7288.55,11608.10,0.00
2024-12-10 17:42:13,78,9052,39,39,7356.71,11608.13,0.00
2024-12-10 17:42:13,77,9052,38,39,7368.01,11608.51,0.00
2024-12-10 17:42:13,78,9051,38,40,7272.07,11608.54,0.00
2024-12-10 17:42:13,78,9052,38,40,7413.82,11609.00,0.00
2024-12-10 17:42:13,79,9052,38,41,7319.98,11609.01,0.00
2024-12-10 17:42:13,78,9052,37,41,7357.34,11609.12,0.00
2024-12-10 17:42:13,77,9052,36,41,7359.04,11609.66,0.00
2024-12-10 17:42:13,77,9053,36,41,7621.66,11610.00,0.00
2024-12-10 17:42:13,78,9053,37,41,7523.95,11610.01,0.00
2024-12-10 17:42:13,77,9053,37,40,7588.56,11610.12,0.00
2024-12-10 17:42:13,77,9054,37,40,7577.08,11611.00,0.00
2024-12-10 17:42:13,78,9054,38,40,7479.94,11611.01,0.00
2024-12-10 17:42:13,78,9055,38,40,7425.50,11612.00,0.00
2024-12-10 17:42:13,79,9055,38,41,7331.51,11612.01,0.00
2024-12-10 17:42:13,78,9055,38,40,7394.30,11612.12,0.00
2024-12-10 17:42:13,78,9056,38,40,7381.47,11613.00,0.00
2024-12-10 17:42:13,79,9056,39,40,7288.04,11613.01,0.00
2024-12-10 17:42:13,79,9057,39,40,7232.80,11614.00,0.00
2024-12-10 17:42:13,80,9057,39,41,7142.39,11614.01,0.00
2024-12-10 17:42:13,79,9057,39,40,7203.46,11614.11,0.00
2024-12-10 17:42:13,78,9057,38,40,7252.25,11614.49,0.00
2024-12-10 17:42:13,78,9058,38,40,7282.41,11615.00,0.00
2024-12-10 17:42:13,79,9058,38,41,7190.23,11615.01,0.00
2024-12-10 17:42:13,80,9057,38,42,7027.93,11615.41,0.00
2024-12-10 17:42:13,80,9058,38,42,7111.13,11616.00,0.00
2024-12-10 17:42:13,81,9058,38,43,7023.33,11616.01,0.00
2024-12-10 17:42:13,80,9058,38,42,7083.60,11616.11,0.00
2024-12-10 17:42:13,80,9059,38,42,7213.39,11617.00,0.00
2024-12-10 17:42:13,81,9059,39,42,7124.33,11617.01,0.00
2024-12-10 17:42:13,80,9059,38,42,7080.26,11617.81,0.00
2024-12-10 17:42:13,80,9060,38,42,7203.84,11618.00,0.00
2024-12-10 17:42:13,81,9060,38,43,7114.91,11618.01,0.00
2024-12-10 17:42:13,80,9060,38,42,7177.76,11618.11,0.00
2024-12-10 17:42:13,80,9061,38,42,7162.34,11619.00,0.00
2024-12-10 17:42:13,81,9061,38,43,7073.92,11619.01,0.00
2024-12-10 17:42:13,81,9062,38,43,7017.15,11620.00,0.00
2024-12-10 17:42:13,82,9062,39,43,6931.57,11620.01,0.00
2024-12-10 17:42:13,81,9062,39,42,6991.65,11620.11,0.00
2024-12-10 17:42:13,81,9063,39,42,6974.98,11621.00,0.00
2024-12-10 17:42:13,82,9063,40,42,6889.92,11621.01,0.00
2024-12-10 17:42:13,81,9063,39,42,6964.97,11621.07,0.00
2024-12-10 17:42:13,81,9064,39,42,6972.71,11622.00,0.00
2024-12-10 17:42:13,82,9064,40,42,6887.68,11622.01,0.00
2024-12-10 17:42:13,81,9064,40,41,6949.81,11622.10,0.00
2024-12-10 17:42:13,82,9063,41,41,6818.47,11622.52,0.00
2024-12-10 17:42:13,82,9064,41,41,6896.77,11623.00,0.00
2024-12-10 17:42:13,83,9064,42,41,6813.68,11623.01,0.00
2024-12-10 17:42:13,84,9063,42,42,6722.93,11623.12,0.00
2024-12-10 17:42:13,84,9064,42,42,6850.77,11624.00,0.00
2024-12-10 17:42:13,85,9064,42,43,6770.17,11624.01,0.00
2024-12-10 17:42:13,84,9064,42,42,6827.31,11624.11,0.00
2024-12-10 17:42:13,83,9064,41,42,6797.98,11624.90,0.00
2024-12-10 17:42:13,83,9065,41,42,7066.96,11625.00,0.00
2024-12-10 17:42:13,84,9065,42,42,6982.83,11625.01,0.00
2024-12-10 17:42:13,84,9066,42,42,6923.92,11626.00,0.00
2024-12-10 17:42:13,85,9066,43,42,6842.46,11626.01,0.00
2024-12-10 17:42:13,84,9066,43,41,6901.83,11626.11,0.00
2024-12-10 17:42:13,83,9066,42,41,6971.02,11626.23,0.00
2024-12-10 17:42:13,83,9067,42,41,6965.91,11627.00,0.00
2024-12-10 17:42:13,84,9067,42,42,6882.99,11627.01,0.00
2024-12-10 17:42:13,85,9066,43,42,6701.12,11627.67,0.00
2024-12-10 17:42:13,84,9066,42,42,6762.92,11627.69,0.00
2024-12-10 17:42:13,84,9067,42,42,6865.58,11628.00,0.00
2024-12-10 17:42:13,85,9067,43,42,6784.81,11628.01,0.00
2024-12-10 17:42:13,84,9067,43,41,6844.88,11628.11,0.00
2024-12-10 17:42:13,84,9068,43,41,6963.08,11629.00,0.00
2024-12-10 17:42:13,85,9068,44,41,6881.16,11629.01,0.00
2024-12-10 17:42:13,85,9069,44,41,6821.55,11630.00,0.00
2024-12-10 17:42:13,86,9069,45,41,6742.23,11630.01,0.00
2024-12-10 17:42:13,85,9069,45,40,6802.45,11630.11,0.00
2024-12-10 17:42:13,84,9069,44,40,6869.63,11630.23,0.00
2024-12-10 17:42:13,83,9069,43,40,6886.68,11630.49,0.00
2024-12-10 17:42:13,82,9069,42,40,6942.45,11630.73,0.00
2024-12-10 17:42:13,82,9070,42,40,7053.29,11631.00,0.00
2024-12-10 17:42:13,83,9070,43,40,6968.31,11631.01,0.00
2024-12-10 17:42:13,83,9071,43,40,6910.05,11632.00,0.00
2024-12-10 17:42:13,84,9071,43,41,6827.79,11632.01,0.00
2024-12-10 17:42:13,83,9071,43,40,6891.89,11632.11,0.00
2024-12-10 17:42:13,83,9072,43,40,6872.80,11633.00,0.00
2024-12-10 17:42:13,84,9072,43,41,6790.98,11633.01,0.00
2024-12-10 17:42:13,84,9073,43,41,6732.01,11634.00,0.00
2024-12-10 17:42:13,85,9073,43,42,6652.81,11634.01,0.00
2024-12-10 17:42:13,84,9073,42,42,6726.49,11634.05,0.00
2024-12-10 17:42:13,83,9073,42,41,6792.15,11634.11,0.00
2024-12-10 17:42:13,82,9073,41,41,6833.93,11634.34,0.00
2024-12-10 17:42:13,82,9074,41,41,6899.64,11635.00,0.00
2024-12-10 17:42:13,83,9074,42,41,6816.51,11635.01,0.00
2024-12-10 17:42:13,83,9075,42,41,6758.21,11636.00,0.00
2024-12-10 17:42:13,84,9075,43,41,6677.76,11636.01,0.00
2024-12-10 17:42:13,83,9075,43,40,6737.24,11636.12,0.00
2024-12-10 17:42:13,82,9075,42,40,6781.71,11636.44,0.00
2024-12-10 17:42:14,82,9076,42,40,6801.96,11637.00,0.00
2024-12-10 17:42:14,83,9076,42,41,6720.01,11637.01,0.00
2024-12-10 17:42:14,83,9077,42,41,6661.70,11638.00,0.00
2024-12-10 17:42:14,84,9077,43,41,6582.39,11638.01,0.00
2024-12-10 17:42:14,83,9077,43,40,6639.32,11638.13,0.00
2024-12-10 17:42:14,82,9077,42,40,6660.69,11638.18,0.00
2024-12-10 17:42:14,82,9078,42,40,6708.04,11639.00,0.00
2024-12-10 17:42:14,83,9078,42,41,6627.22,11639.01,0.00
2024-12-10 17:42:14,83,9079,42,41,6568.88,11640.00,0.00
2024-12-10 17:42:14,84,9079,43,41,6490.68,11640.01,0.00
2024-12-10 17:42:14,83,9079,43,40,6539.49,11640.16,0.00
2024-12-10 17:42:14,82,9079,42,40,6605.08,11640.26,0.00
2024-12-10 17:42:14,82,9080,42,40,6660.92,11641.00,0.00
2024-12-10 17:42:14,83,9080,43,40,6580.67,11641.01,0.00
2024-12-10 17:42:14,82,9080,42,40,6599.94,11641.17,0.00
2024-12-10 17:42:14,82,9081,42,40,6617.48,11642.00,0.00
2024-12-10 17:42:14,83,9081,42,41,6537.75,11642.01,0.00
2024-12-10 17:42:14,82,9081,42,40,6583.47,11642.17,0.00
2024-12-10 17:42:14,81,9081,41,40,6654.71,11642.25,0.00
2024-12-10 17:42:14,81,9082,41,40,6653.38,11643.00,0.00
2024-12-10 17:42:14,82,9082,42,40,6572.24,11643.01,0.00
2024-12-10 17:42:14,81,9082,41,40,6525.69,11643.54,0.00
2024-12-10 17:42:14,80,9082,40,40,6584.09,11643.74,0.00
2024-12-10 17:42:14,80,9083,40,40,6699.28,11644.00,0.00
2024-12-10 17:42:14,81,9083,40,41,6616.57,11644.01,0.00
2024-12-10 17:42:14,80,9083,39,41,6694.93,11644.04,0.00
2024-12-10 17:42:14,79,9083,39,40,6750.24,11644.17,0.00
2024-12-10 17:42:14,79,9084,39,40,6741.92,11645.00,0.00
2024-12-10 17:42:14,80,9084,39,41,6657.64,11645.01,0.00
2024-12-10 17:42:14,80,9085,39,41,6601.44,11646.00,0.00
2024-12-10 17:42:14,81,9085,39,42,6519.94,11646.01,0.00
2024-12-10 17:42:14,80,9085,39,41,6569.47,11646.16,0.00
2024-12-10 17:42:14,80,9086,39,41,6559.79,11647.00,0.00
2024-12-10 17:42:14,81,9086,40,41,6478.80,11647.01,0.00
2024-12-10 17:42:14,81,9087,40,41,6425.60,11648.00,0.00
2024-12-10 17:42:14,82,9087,41,41,6347.24,11648.01,0.00
2024-12-10 17:42:14,81,9087,41,40,6386.84,11648.19,0.00
2024-12-10 17:42:14,80,9087,40,40,6398.55,11648.76,0.00
2024-12-10 17:42:14,80,9088,40,40,6458.43,11649.00,0.00
2024-12-10 17:42:14,81,9088,40,41,6378.69,11649.01,0.00
2024-12-10 17:42:14,81,9089,40,41,6326.53,11650.00,0.00
2024-12-10 17:42:14,82,9089,41,41,6249.38,11650.01,0.00
2024-12-10 17:42:14,81,9089,41,40,6297.80,11650.10,0.00
2024-12-10 17:42:14,80,9089,40,40,6338.16,11650.15,0.00
2024-12-10 17:42:14,80,9090,40,40,6385.26,11651.00,0.00
2024-12-10 17:42:14,81,9090,41,40,6306.43,11651.01,0.00
2024-12-10 17:42:14,80,9090,40,40,6366.36,11651.09,0.00
2024-12-10 17:42:14,80,9091,40,40,6377.07,11652.00,0.00
2024-12-10 17:42:14,81,9091,40,41,6298.34,11652.01,0.00
2024-12-10 17:42:14,80,9091,40,40,6345.07,11652.15,0.00
2024-12-10 17:42:14,81,9090,41,40,6253.83,11652.28,0.00
2024-12-10 17:42:14,81,9091,41,40,6336.29,11653.00,0.00
2024-12-10 17:42:14,82,9091,42,40,6259.02,11653.01,0.00
2024-12-10 17:42:14,82,9092,42,40,6348.47,11654.00,0.00
2024-12-10 17:42:14,83,9092,42,41,6271.98,11654.01,0.00
2024-12-10 17:42:14,82,9092,42,40,6317.25,11654.15,0.00
2024-12-10 17:42:14,81,9092,41,40,6385.20,11654.23,0.00
2024-12-10 17:42:14,81,9093,41,40,6382.79,11655.00,0.00
2024-12-10 17:42:14,82,9093,42,40,6304.96,11655.01,0.00
2024-12-10 17:42:14,81,9093,41,40,6283.57,11655.19,0.00
2024-12-10 17:42:14,81,9094,41,40,6332.98,11656.00,0.00
2024-12-10 17:42:14,82,9094,42,40,6255.74,11656.01,0.00
2024-12-10 17:42:14,81,9094,42,39,6302.80,11656.15,0.00
2024-12-10 17:42:14,81,9095,42,39,6290.34,11657.00,0.00
2024-12-10 17:42:14,82,9095,43,39,6213.63,11657.01,0.00
2024-12-10 17:42:14,82,9096,43,39,6193.67,11658.00,0.00
2024-12-10 17:42:14,83,9096,44,39,6119.05,11658.01,0.00
2024-12-10 17:42:14,83,9097,44,39,6080.60,11659.00,0.00
2024-12-10 17:42:14,84,9097,45,39,6008.22,11659.01,0.00
2024-12-10 17:42:14,85,9096,45,40,5888.20,11659.22,0.00
2024-12-10 17:42:14,86,9095,46,40,5795.46,11659.52,0.00
2024-12-10 17:42:14,86,9096,46,40,5874.77,11660.00,0.00
2024-12-10 17:42:14,87,9096,46,41,5807.25,11660.01,0.00
2024-12-10 17:42:14,86,9096,46,40,5854.47,11660.15,0.00
2024-12-10 17:42:14,86,9097,46,40,6104.55,11661.00,0.00
2024-12-10 17:42:14,87,9097,47,40,6034.38,11661.01,0.00
2024-12-10 17:42:14,87,9098,47,40,5978.37,11662.00,0.00
2024-12-10 17:42:14,88,9098,48,40,5910.44,11662.01,0.00
2024-12-10 17:42:14,87,9098,47,40,5969.02,11662.08,0.00
2024-12-10 17:42:14,87,9099,47,40,5922.22,11663.00,0.00
2024-12-10 17:42:14,88,9099,47,41,5854.93,11663.01,0.00
2024-12-10 17:42:14,87,9099,47,40,5896.78,11663.14,0.00
2024-12-10 17:42:14,86,9099,46,40,5898.33,11663.71,0.00
2024-12-10 17:42:14,86,9100,46,40,5946.01,11664.00,0.00
2024-12-10 17:42:14,87,9100,46,41,5877.66,11664.01,0.00
2024-12-10 17:42:14,88,9099,46,42,5802.94,11664.10,0.00
2024-12-10 17:42:14,87,9099,46,41,5986.30,11664.15,0.00
2024-12-10 17:42:14,87,9100,46,41,5968.00,11665.00,0.00
2024-12-10 17:42:14,88,9100,47,41,5900.18,11665.01,0.00
2024-12-10 17:42:14,87,9100,46,41,5955.97,11665.09,0.00
2024-12-10 17:42:14,87,9101,46,41,6091.87,11666.00,0.00
2024-12-10 17:42:14,88,9101,47,41,6022.65,11666.01,0.00
2024-12-10 17:42:14,87,9101,47,40,6069.12,11666.13,0.00
2024-12-10 17:42:14,87,9102,47,40,6048.14,11667.00,0.00
2024-12-10 17:42:14,88,9102,48,40,5979.41,11667.01,0.00
2024-12-10 17:42:14,87,9102,47,40,5990.57,11667.28,0.00
2024-12-10 17:42:15,87,9103,47,40,6029.91,11668.00,0.00
2024-12-10 17:42:15,88,9103,47,41,5961.39,11668.01,0.00
2024-12-10 17:42:15,88,9104,47,41,5937.61,11669.00,0.00
2024-12-10 17:42:15,89,9104,47,42,5870.90,11669.01,0.00
2024-12-10 17:42:15,90,9103,48,42,5755.16,11669.24,0.00
2024-12-10 17:42:15,90,9104,48,42,5824.95,11670.00,0.00
2024-12-10 17:42:15,91,9104,48,43,5760.94,11670.01,0.00
2024-12-10 17:42:15,90,9104,47,43,5779.58,11670.04,0.00
2024-12-10 17:42:15,89,9104,46,43,5839.29,11670.08,0.00
2024-12-10 17:42:15,89,9105,46,43,5968.28,11671.00,0.00
2024-12-10 17:42:15,90,9105,47,43,5901.96,11671.01,0.00
2024-12-10 17:42:15,89,9105,47,42,5946.01,11671.10,0.00
2024-12-10 17:42:15,90,9104,48,42,5843.75,11671.43,0.00
2024-12-10 17:42:15,90,9105,48,42,5916.73,11672.00,0.00
2024-12-10 17:42:15,91,9105,48,43,5851.71,11672.01,0.00
2024-12-10 17:42:15,90,9105,47,43,5861.05,11672.27,0.00
2024-12-10 17:42:15,90,9106,47,43,5988.08,11673.00,0.00
2024-12-10 17:42:15,91,9106,47,44,5922.28,11673.01,0.00
2024-12-10 17:42:15,90,9106,47,43,5969.96,11673.11,0.00
2024-12-10 17:42:15,89,9106,46,43,5965.66,11673.70,0.00
2024-12-10 17:42:15,89,9107,46,43,6061.63,11674.00,0.00
2024-12-10 17:42:15,90,9107,47,43,5994.27,11674.01,0.00
2024-12-10 17:42:15,89,9107,46,43,6028.84,11674.02,0.00
2024-12-10 17:42:15,90,9106,46,44,5920.38,11674.18,0.00
2024-12-10 17:42:15,89,9106,45,44,6070.89,11674.27,0.00
2024-12-10 17:42:15,89,9107,45,44,6117.24,11675.00,0.00
2024-12-10 17:42:15,90,9107,45,45,6049.27,11675.01,0.00
2024-12-10 17:42:15,89,9107,45,44,6102.84,11675.10,0.00
2024-12-10 17:42:15,89,9108,45,44,6208.29,11676.00,0.00
2024-12-10 17:42:15,90,9108,46,44,6139.31,11676.01,0.00
2024-12-10 17:42:15,89,9108,45,44,6204.36,11676.03,0.00
2024-12-10 17:42:15,88,9108,44,44,6270.90,11676.06,0.00
2024-12-10 17:42:15,87,9108,43,44,6265.59,11676.37,0.00
2024-12-10 17:42:15,87,9109,43,44,6326.39,11677.00,0.00
2024-12-10 17:42:15,88,9109,44,44,6254.50,11677.01,0.00
2024-12-10 17:42:15,87,9109,44,43,6315.68,11677.08,0.00
2024-12-10 17:42:15,87,9110,44,43,6288.31,11678.00,0.00
2024-12-10 17:42:15,88,9110,45,43,6216.85,11678.01,0.00
2024-12-10 17:42:15,87,9110,44,43,6177.94,11678.71,0.00
2024-12-10 17:42:15,87,9111,44,43,6225.14,11679.00,0.00
2024-12-10 17:42:15,88,9111,45,43,6154.40,11679.01,0.00
2024-12-10 17:42:15,87,9111,45,42,6215.77,11679.08,0.00
2024-12-10 17:42:15,87,9112,45,42,6189.43,11680.00,0.00
2024-12-10 17:42:15,88,9112,46,42,6119.09,11680.01,0.00
2024-12-10 17:42:15,88,9113,46,42,6099.75,11681.00,0.00
2024-12-10 17:42:15,89,9113,47,42,6031.22,11681.01,0.00
2024-12-10 17:42:15,89,9114,47,42,6006.56,11682.00,0.00
2024-12-10 17:42:15,90,9114,47,43,5939.82,11682.01,0.00
2024-12-10 17:42:15,89,9114,46,43,5948.90,11682.28,0.00
2024-12-10 17:42:15,88,9114,45,43,6015.17,11682.28,0.00
2024-12-10 17:42:15,87,9114,44,43,6030.83,11682.74,0.00
2024-12-10 17:42:15,87,9115,44,43,6109.47,11683.00,0.00
2024-12-10 17:42:15,88,9115,45,43,6040.05,11683.01,0.00
2024-12-10 17:42:15,88,9116,45,43,5983.04,11684.00,0.00
2024-12-10 17:42:15,89,9116,46,43,5915.81,11684.01,0.00
2024-12-10 17:42:15,88,9116,46,42,5957.84,11684.10,0.00
2024-12-10 17:42:15,87,9116,45,42,5989.20,11684.37,0.00
2024-12-10 17:42:15,87,9117,45,42,5996.31,11685.00,0.00
2024-12-10 17:42:15,88,9117,45,43,5928.17,11685.01,0.00
2024-12-10 17:42:15,87,9117,44,43,5989.61,11685.06,0.00
2024-12-10 17:42:15,88,9116,44,44,5864.70,11685.30,0.00
2024-12-10 17:42:15,88,9116,44,44,5920.98,11686.00,0.00
2024-12-10 17:42:15,89,9116,44,45,5854.45,11686.01,0.00
2024-12-10 17:42:15,89,9117,44,45,5954.86,11687.00,0.00
2024-12-10 17:42:15,90,9117,44,46,5888.70,11687.01,0.00
2024-12-10 17:42:15,89,9117,43,46,5894.75,11687.29,0.00
2024-12-10 17:42:15,89,9118,43,46,5910.58,11688.00,0.00
2024-12-10 17:42:15,90,9118,43,47,5844.91,11688.01,0.00
2024-12-10 17:42:15,89,9118,42,47,5751.42,11688.76,0.00
2024-12-10 17:42:15,88,9118,41,47,5798.36,11688.92,0.00
2024-12-10 17:42:15,88,9119,41,47,5921.95,11689.00,0.00
2024-12-10 17:42:15,89,9119,41,48,5855.42,11689.01,0.00
2024-12-10 17:42:15,88,9119,41,47,5911.35,11689.09,0.00
2024-12-10 17:42:15,89,9118,41,48,5844.93,11689.11,0.00
2024-12-10 17:42:15,88,9118,40,48,5951.27,11689.31,0.00
2024-12-10 17:42:15,88,9119,40,48,6003.49,11690.00,0.00
2024-12-10 17:42:15,89,9119,40,49,5936.04,11690.01,0.00
2024-12-10 17:42:15,88,9119,40,48,5966.33,11690.13,0.00
2024-12-10 17:42:15,87,9119,39,48,5954.45,11690.54,0.00
2024-12-10 17:42:15,88,9118,39,49,5880.17,11690.61,0.00
2024-12-10 17:42:15,88,9119,39,49,6140.84,11691.00,0.00
2024-12-10 17:42:15,89,9119,39,50,6071.84,11691.01,0.00
2024-12-10 17:42:15,88,9119,39,49,6103.68,11691.13,0.00
2024-12-10 17:42:15,88,9120,39,49,6213.54,11692.00,0.00
2024-12-10 17:42:15,89,9120,39,50,6143.73,11692.01,0.00
2024-12-10 17:42:15,88,9120,39,49,6176.37,11692.13,0.00
2024-12-10 17:42:15,87,9120,38,49,6199.08,11692.40,0.00
2024-12-10 17:42:15,87,9121,38,49,6261.27,11693.00,0.00
2024-12-10 17:42:15,88,9121,39,49,6190.12,11693.01,0.00
2024-12-10 17:42:15,87,9121,38,49,6243.81,11693.07,0.00
2024-12-10 17:42:15,88,9120,38,50,6089.34,11693.58,0.00
2024-12-10 17:42:15,88,9121,38,50,6211.71,11694.00,0.00
2024-12-10 17:42:15,89,9121,39,50,6141.92,11694.01,0.00
2024-12-10 17:42:15,88,9121,39,49,6194.47,11694.14,0.00
2024-12-10 17:42:15,87,9121,38,49,6251.51,11694.25,0.00
2024-12-10 17:42:15,87,9122,38,49,6371.28,11695.00,0.00
2024-12-10 17:42:15,88,9122,39,49,6298.88,11695.01,0.00
2024-12-10 17:42:15,87,9122,39,48,6328.29,11695.14,0.00
2024-12-10 17:42:15,87,9123,39,48,6297.45,11696.00,0.00
2024-12-10 17:42:15,88,9123,40,48,6225.89,11696.01,0.00
2024-12-10 17:42:15,87,9123,39,48,6290.74,11696.06,0.00
2024-12-10 17:42:15,86,9123,39,47,6327.19,11696.13,0.00
2024-12-10 17:42:15,85,9123,38,47,6386.54,11696.26,0.00
2024-12-10 17:42:16,85,9124,38,47,6368.55,11697.00,0.00
2024-12-10 17:42:16,86,9124,39,47,6294.50,11697.01,0.00
2024-12-10 17:42:16,85,9124,38,47,6255.04,11697.60,0.00
2024-12-10 17:42:16,84,9124,37,47,6265.72,11697.95,0.00
2024-12-10 17:42:16,84,9125,37,47,6399.45,11698.00,0.00
2024-12-10 17:42:16,85,9125,37,48,6324.16,11698.01,0.00
2024-12-10 17:42:16,84,9125,37,47,6384.16,11698.13,0.00
2024-12-10 17:42:16,83,9125,36,47,6442.80,11698.28,0.00
2024-12-10 17:42:16,84,9124,36,48,6299.05,11698.70,0.00
2024-12-10 17:42:16,84,9125,36,48,6380.08,11699.00,0.00
2024-12-10 17:42:16,85,9125,36,49,6305.02,11699.01,0.00
2024-12-10 17:42:16,84,9125,36,48,6368.12,11699.08,0.00
2024-12-10 17:42:16,83,9125,36,47,6317.46,11699.54,0.00
2024-12-10 17:42:16,83,9125,36,47,6546.16,11700.00,0.00
2024-12-10 17:42:16,84,9125,36,48,6468.23,11700.01,0.00
2024-12-10 17:42:16,83,9125,35,48,6544.75,11700.01,0.00
2024-12-10 17:42:16,82,9125,34,48,6618.87,11700.05,0.00
2024-12-10 17:42:16,82,9126,34,48,6565.20,11701.00,0.00
2024-12-10 17:42:16,83,9126,34,49,6486.10,11701.01,0.00
2024-12-10 17:42:16,84,9125,35,49,6406.10,11701.06,0.00
2024-12-10 17:42:16,83,9125,35,48,6522.67,11701.11,0.00
2024-12-10 17:42:16,82,9125,34,48,6521.17,11701.46,0.00
2024-12-10 17:42:16,82,9126,34,48,6601.48,11702.00,0.00
2024-12-10 17:42:16,83,9126,35,48,6521.94,11702.01,0.00
2024-12-10 17:42:16,82,9126,34,48,6545.90,11702.24,0.00
2024-12-10 17:42:16,82,9127,34,48,6731.75,11703.00,0.00
2024-12-10 17:42:16,83,9127,35,48,6650.64,11703.01,0.00
2024-12-10 17:42:16,84,9126,36,48,6463.11,11703.73,0.00
2024-12-10 17:42:16,84,9127,36,48,6579.87,11704.00,0.00
2024-12-10 17:42:16,85,9127,36,49,6502.46,11704.01,0.00
2024-12-10 17:42:16,85,9128,36,49,6609.25,11705.00,0.00
2024-12-10 17:42:16,86,9128,36,50,6532.40,11705.01,0.00
2024-12-10 17:42:16,85,9128,35,50,6607.87,11705.01,0.00
2024-12-10 17:42:16,84,9128,34,50,6653.11,11705.05,0.00
2024-12-10 17:42:16,84,9129,34,50,6634.80,11706.00,0.00
2024-12-10 17:42:16,85,9129,34,51,6556.74,11706.01,0.00
2024-12-10 17:42:16,84,9129,34,50,6611.11,11706.02,0.00
2024-12-10 17:42:16,84,9130,34,50,6579.91,11707.00,0.00
2024-12-10 17:42:16,85,9130,35,50,6502.49,11707.01,0.00
2024-12-10 17:42:16,86,9129,36,50,6278.68,11707.94,0.00
2024-12-10 17:42:16,86,9130,36,50,6428.99,11708.00,0.00
2024-12-10 17:42:16,87,9130,36,51,6355.09,11708.01,0.00
2024-12-10 17:42:16,88,9129,36,52,6231.04,11708.25,0.00
2024-12-10 17:42:16,88,9130,36,52,6467.27,11709.00,0.00
2024-12-10 17:42:16,89,9130,36,53,6394.61,11709.01,0.00
2024-12-10 17:42:16,88,9130,35,53,6462.13,11709.01,0.00
2024-12-10 17:42:16,88,9131,35,53,6584.89,11710.00,0.00
2024-12-10 17:42:16,89,9131,35,54,6510.90,11710.01,0.00
2024-12-10 17:42:16,88,9131,35,53,6556.96,11710.07,0.00
2024-12-10 17:42:16,87,9131,34,53,6609.50,11710.25,0.00
2024-12-10 17:42:16,87,9132,34,53,6600.59,11711.00,0.00
2024-12-10 17:42:16,88,9132,34,54,6525.58,11711.01,0.00
2024-12-10 17:42:16,87,9132,34,53,6575.02,11711.07,0.00
2024-12-10 17:42:16,88,9131,35,53,6492.33,11711.16,0.00
2024-12-10 17:42:16,88,9132,35,53,6568.85,11712.00,0.00
2024-12-10 17:42:16,89,9132,36,53,6495.05,11712.01,0.00
2024-12-10 17:42:16,88,9132,36,52,6566.20,11712.02,0.00
2024-12-10 17:42:16,87,9132,36,51,6616.10,11712.06,0.00
2024-12-10 17:42:16,86,9132,35,51,6543.95,11712.86,0.00
2024-12-10 17:42:16,86,9133,35,51,6799.98,11713.00,0.00
2024-12-10 17:42:16,87,9133,36,51,6721.82,11713.01,0.00
2024-12-10 17:42:16,86,9133,36,50,6765.94,11713.07,0.00
2024-12-10 17:42:16,86,9134,36,50,6739.26,11714.00,0.00
2024-12-10 17:42:16,87,9134,36,51,6661.80,11714.01,0.00
2024-12-10 17:42:16,86,9134,36,50,6736.55,11714.02,0.00
2024-12-10 17:42:16,86,9135,36,50,6720.13,11715.00,0.00
2024-12-10 17:42:16,87,9135,36,51,6642.89,11715.01,0.00
2024-12-10 17:42:16,87,9136,36,51,6613.93,11716.00,0.00
2024-12-10 17:42:16,88,9136,36,52,6538.77,11716.01,0.00
2024-12-10 17:42:16,87,9136,35,52,6561.48,11716.23,0.00
2024-12-10 17:42:16,87,9137,35,52,6565.50,11717.00,0.00
2024-12-10 17:42:16,88,9137,36,52,6490.89,11717.01,0.00
2024-12-10 17:42:16,87,9137,35,52,6510.34,11717.24,0.00
2024-12-10 17:42:16,87,9138,35,52,6489.06,11718.00,0.00
2024-12-10 17:42:16,88,9138,36,52,6415.33,11718.01,0.00
2024-12-10 17:42:16,87,9138,36,51,6460.79,11718.09,0.00
2024-12-10 17:42:16,87,9139,36,51,6406.53,11719.00,0.00
2024-12-10 17:42:16,88,9139,36,52,6333.73,11719.01,0.00
2024-12-10 17:42:16,87,9139,36,51,6368.83,11719.09,0.00
2024-12-10 17:42:16,86,9139,35,51,6397.94,11719.14,0.00
2024-12-10 17:42:16,85,9139,35,50,6405.01,11719.54,0.00
2024-12-10 17:42:16,85,9140,35,50,6477.58,11720.00,0.00
2024-12-10 17:42:16,86,9140,36,50,6402.26,11720.01,0.00
2024-12-10 17:42:16,85,9140,35,50,6474.83,11720.02,0.00
2024-12-10 17:42:16,84,9140,34,50,6447.31,11720.20,0.00
2024-12-10 17:42:16,84,9141,34,50,6474.00,11721.00,0.00
2024-12-10 17:42:16,85,9141,34,51,6397.83,11721.01,0.00
2024-12-10 17:42:16,84,9141,34,50,6451.68,11721.05,0.00
2024-12-10 17:42:16,84,9142,34,50,6403.45,11722.00,0.00
2024-12-10 17:42:16,85,9142,34,51,6328.12,11722.01,0.00
2024-12-10 17:42:16,84,9142,33,51,6400.67,11722.02,0.00
2024-12-10 17:42:16,83,9142,33,50,6472.14,11722.06,0.00
2024-12-10 17:42:16,82,9142,32,50,6539.22,11722.16,0.00
2024-12-10 17:42:16,82,9143,32,50,6518.34,11723.00,0.00
2024-12-10 17:42:16,83,9143,32,51,6439.81,11723.01,0.00
2024-12-10 17:42:16,83,9144,32,51,6378.87,11724.00,0.00
2024-12-10 17:42:16,84,9144,33,51,6302.94,11724.01,0.00
2024-12-10 17:42:16,83,9144,33,50,6369.00,11724.07,0.00
2024-12-10 17:42:16,82,9144,32,50,6333.97,11724.62,0.00
2024-12-10 17:42:16,82,9145,32,50,6431.60,11725.00,0.00
2024-12-10 17:42:16,83,9145,32,51,6354.11,11725.01,0.00
2024-12-10 17:42:16,83,9146,32,51,6335.11,11726.00,0.00
2024-12-10 17:42:16,84,9146,33,51,6259.69,11726.01,0.00
2024-12-10 17:42:16,83,9146,32,51,6287.50,11726.17,0.00
2024-12-10 17:42:16,82,9146,31,51,6361.33,11726.20,0.00
2024-12-10 17:42:16,83,9145,32,51,6262.15,11726.41,0.00
2024-12-10 17:42:17,83,9146,32,51,6370.12,11727.00,0.00
2024-12-10 17:42:17,84,9146,32,52,6294.28,11727.01,0.00
2024-12-10 17:42:17,85,9145,32,53,6181.62,11727.13,0.00
2024-12-10 17:42:17,85,9146,32,53,6405.92,11728.00,0.00
2024-12-10 17:42:17,86,9146,33,53,6331.43,11728.01,0.00
2024-12-10 17:42:17,85,9146,33,52,6370.05,11728.07,0.00
2024-12-10 17:42:17,84,9146,32,52,6294.87,11728.80,0.00
2024-12-10 17:42:17,84,9147,32,52,6550.54,11729.00,0.00
2024-12-10 17:42:17,85,9147,33,52,6473.48,11729.01,0.00
2024-12-10 17:42:17,84,9147,32,52,6547.76,11729.02,0.00
2024-12-10 17:42:17,83,9147,32,51,6591.32,11729.07,0.00
2024-12-10 17:42:17,84,9146,32,52,6453.06,11729.61,0.00
2024-12-10 17:42:17,83,9146,32,51,6563.85,11729.67,0.00
2024-12-10 17:42:17,82,9146,31,51,6603.99,11729.88,0.00
2024-12-10 17:42:17,82,9147,31,51,6732.84,11730.00,0.00
2024-12-10 17:42:17,83,9147,32,51,6651.72,11730.01,0.00
2024-12-10 17:42:17,82,9147,31,51,6602.89,11730.55,0.00
2024-12-10 17:42:17,82,9148,31,51,6836.41,11731.00,0.00
2024-12-10 17:42:17,83,9148,31,52,6754.05,11731.01,0.00
2024-12-10 17:42:17,82,9148,31,51,6808.89,11731.12,0.00
2024-12-10 17:42:17,82,9149,31,51,6792.27,11732.00,0.00
2024-12-10 17:42:17,83,9149,31,52,6710.44,11732.01,0.00
2024-12-10 17:42:17,82,9149,30,52,6666.90,11732.60,0.00
2024-12-10 17:42:17,82,9150,30,52,6759.07,11733.00,0.00
2024-12-10 17:42:17,83,9150,31,52,6677.64,11733.01,0.00
2024-12-10 17:42:17,84,9149,31,53,6588.39,11733.12,0.00
2024-12-10 17:42:17,84,9150,31,53,6652.04,11734.00,0.00
2024-12-10 17:42:17,85,9150,31,54,6573.78,11734.01,0.00
2024-12-10 17:42:17,84,9150,31,53,6649.25,11734.02,0.00
2024-12-10 17:42:17,83,9150,31,52,6702.54,11734.12,0.00
2024-12-10 17:42:17,84,9149,31,53,6608.82,11734.26,0.00
2024-12-10 17:42:17,84,9150,31,53,6827.23,11735.00,0.00
2024-12-10 17:42:17,85,9150,32,53,6746.91,11735.01,0.00
2024-12-10 17:42:17,84,9150,31,53,6806.27,11735.07,0.00
2024-12-10 17:42:17,83,9150,30,53,6844.50,11735.21,0.00
2024-12-10 17:42:17,83,9151,30,53,7034.48,11736.00,0.00
2024-12-10 17:42:17,84,9151,30,54,6950.74,11736.01,0.00
2024-12-10 17:42:17,83,9151,29,54,7031.66,11736.02,0.00
2024-12-10 17:42:17,82,9151,29,53,7085.96,11736.12,0.00
2024-12-10 17:42:17,82,9152,29,53,7069.34,11737.00,0.00
2024-12-10 17:42:17,83,9152,30,53,6984.17,11737.01,0.00
2024-12-10 17:42:17,82,9152,29,53,7017.90,11737.21,0.00
2024-12-10 17:42:17,81,9152,28,53,7051.42,11737.65,0.00
2024-12-10 17:42:17,81,9153,28,53,7100.95,11738.00,0.00
2024-12-10 17:42:17,82,9153,29,53,7014.36,11738.01,0.00
2024-12-10 17:42:17,83,9152,30,53,6918.57,11738.13,0.00
2024-12-10 17:42:17,82,9152,30,52,7083.12,11738.13,0.00
2024-12-10 17:42:17,81,9152,29,52,7161.91,11738.21,0.00
2024-12-10 17:42:17,81,9153,29,52,7146.31,11739.00,0.00
2024-12-10 17:42:17,82,9153,30,52,7059.16,11739.01,0.00
2024-12-10 17:42:17,81,9153,29,52,7095.67,11739.20,0.00
2024-12-10 17:42:17,82,9152,30,52,6951.44,11739.61,0.00
2024-12-10 17:42:17,82,9153,30,52,7220.66,11740.00,0.00
2024-12-10 17:42:17,83,9153,31,52,7133.66,11740.01,0.00
2024-12-10 17:42:17,83,9154,31,52,7255.99,11741.00,0.00
2024-12-10 17:42:17,84,9154,32,52,7169.61,11741.01,0.00
2024-12-10 17:42:17,84,9155,32,52,7125.37,11742.00,0.00
2024-12-10 17:42:17,85,9155,32,53,7041.54,11742.01,0.00
2024-12-10 17:42:17,86,9154,32,54,6914.66,11742.19,0.00
2024-12-10 17:42:17,87,9153,32,55,6854.94,11742.51,0.00
2024-12-10 17:42:17,88,9152,33,55,6813.16,11742.64,0.00
2024-12-10 17:42:17,88,9153,33,55,6875.86,11743.00,0.00
2024-12-10 17:42:17,89,9153,33,56,6798.60,11743.01,0.00
2024-12-10 17:42:17,88,9153,33,55,6866.55,11743.08,0.00
2024-12-10 17:42:17,87,9153,33,54,6922.53,11743.09,0.00
2024-12-10 17:42:17,86,9153,32,54,6989.42,11743.20,0.00
2024-12-10 17:42:17,86,9154,32,54,7365.60,11744.00,0.00
2024-12-10 17:42:17,87,9154,32,55,7280.94,11744.01,0.00
2024-12-10 17:42:17,86,9154,32,54,7362.88,11744.02,0.00
2024-12-10 17:42:17,86,9155,32,54,7286.19,11745.00,0.00
2024-12-10 17:42:17,87,9155,32,55,7202.44,11745.01,0.00
2024-12-10 17:42:17,87,9156,32,55,7138.36,11746.00,0.00
2024-12-10 17:42:17,88,9156,32,56,7057.24,11746.01,0.00
2024-12-10 17:42:17,87,9156,31,56,7048.61,11746.33,0.00
2024-12-10 17:42:17,87,9157,31,56,7097.33,11747.00,0.00
2024-12-10 17:42:17,88,9157,31,57,7016.68,11747.01,0.00
2024-12-10 17:42:17,87,9157,31,56,7078.46,11747.10,0.00
2024-12-10 17:42:17,87,9158,31,56,7049.17,11748.00,0.00
2024-12-10 17:42:17,88,9158,31,57,6969.07,11748.01,0.00
2024-12-10 17:42:17,87,9158,30,57,7046.47,11748.02,0.00
2024-12-10 17:42:17,86,9158,29,57,6989.67,11748.80,0.00
2024-12-10 17:42:17,86,9159,29,57,7103.21,11749.00,0.00
2024-12-10 17:42:17,87,9159,30,57,7021.57,11749.01,0.00
2024-12-10 17:42:17,86,9159,29,57,6974.76,11749.70,0.00
2024-12-10 17:42:17,86,9160,29,57,7072.92,11750.00,0.00
2024-12-10 17:42:17,87,9160,30,57,6991.62,11750.01,0.00
2024-12-10 17:42:17,86,9160,30,56,7067.48,11750.05,0.00
2024-12-10 17:42:17,85,9160,29,56,7080.03,11750.41,0.00
2024-12-10 17:42:17,85,9161,29,56,7120.19,11751.00,0.00
2024-12-10 17:42:17,86,9161,30,56,7037.40,11751.01,0.00
2024-12-10 17:42:17,87,9160,31,56,6955.16,11751.05,0.00
2024-12-10 17:42:17,87,9161,31,56,6937.33,11752.00,0.00
2024-12-10 17:42:17,88,9161,31,57,6858.50,11752.01,0.00
2024-12-10 17:42:17,87,9161,31,56,6828.02,11752.67,0.00
2024-12-10 17:42:17,88,9160,32,56,6747.77,11752.70,0.00
2024-12-10 17:42:17,88,9161,32,56,6995.18,11753.00,0.00
2024-12-10 17:42:17,89,9161,32,57,6916.58,11753.01,0.00
2024-12-10 17:42:17,88,9161,32,56,6959.14,11753.08,0.00
2024-12-10 17:42:17,88,9162,32,56,7103.35,11754.00,0.00
2024-12-10 17:42:17,89,9162,33,56,7023.53,11754.01,0.00
2024-12-10 17:42:17,89,9163,33,56,6985.37,11755.00,0.00
2024-12-10 17:42:17,90,9163,34,56,6907.75,11755.01,0.00
2024-12-10 17:42:17,90,9164,34,56,6845.13,11756.00,0.00
2024-12-10 17:42:17,91,9164,35,56,6769.91,11756.01,0.00
2024-12-10 17:42:17,90,9164,35,55,6822.93,11756.02,0.00
2024-12-10 17:42:18,90,9165,35,55,6778.82,11757.00,0.00
2024-12-10 17:42:18,91,9165,36,55,6704.32,11757.01,0.00
2024-12-10 17:42:18,92,9164,37,55,6596.97,11757.11,0.00
2024-12-10 17:42:18,92,9165,37,55,6655.60,11758.00,0.00
2024-12-10 17:42:18,93,9165,38,55,6584.03,11758.01,0.00
2024-12-10 17:42:18,92,9165,38,54,6642.83,11758.07,0.00
2024-12-10 17:42:18,91,9165,37,54,6589.30,11758.88,0.00
2024-12-10 17:42:18,91,9166,37,54,6833.60,11759.00,0.00
2024-12-10 17:42:18,92,9166,38,54,6759.33,11759.01,0.00
2024-12-10 17:42:18,93,9165,38,55,6682.86,11759.06,0.00
2024-12-10 17:42:18,93,9166,38,55,6753.51,11760.00,0.00
2024-12-10 17:42:18,94,9166,38,56,6681.66,11760.01,0.00
2024-12-10 17:42:18,93,9166,37,56,6748.29,11760.05,0.00
2024-12-10 17:42:18,93,9167,37,56,6847.64,11761.00,0.00
2024-12-10 17:42:18,94,9167,37,57,6774.79,11761.01,0.00
2024-12-10 17:42:18,94,9168,37,57,6694.29,11762.00,0.00
2024-12-10 17:42:18,95,9168,38,57,6623.82,11762.01,0.00
2024-12-10 17:42:18,94,9168,38,56,6673.04,11762.05,0.00
2024-12-10 17:42:18,94,9169,38,56,6618.14,11763.00,0.00
2024-12-10 17:42:18,95,9169,39,56,6548.48,11763.01,0.00
2024-12-10 17:42:18,94,9169,39,55,6515.52,11763.58,0.00
2024-12-10 17:42:18,94,9170,39,55,6570.90,11764.00,0.00
2024-12-10 17:42:18,95,9170,40,55,6501.73,11764.01,0.00
2024-12-10 17:42:18,94,9170,39,55,6462.40,11764.70,0.00
2024-12-10 17:42:18,95,9169,40,55,6372.38,11764.88,0.00
2024-12-10 17:42:18,95,9170,40,55,6552.97,11765.00,0.00
2024-12-10 17:42:18,96,9170,41,55,6484.71,11765.01,0.00
2024-12-10 17:42:18,96,9171,41,55,6536.28,11766.00,0.00
2024-12-10 17:42:18,97,9171,41,56,6468.90,11766.01,0.00
2024-12-10 17:42:18,96,9171,40,56,6532.62,11766.03,0.00
2024-12-10 17:42:18,95,9171,40,55,6596.45,11766.06,0.00
2024-12-10 17:42:18,95,9172,40,55,6557.97,11767.00,0.00
2024-12-10 17:42:18,96,9172,40,56,6489.66,11767.01,0.00
2024-12-10 17:42:18,95,9172,40,55,6522.09,11767.09,0.00
2024-12-10 17:42:18,94,9172,39,55,6488.05,11767.61,0.00
2024-12-10 17:42:18,94,9173,39,55,6564.85,11768.00,0.00
2024-12-10 17:42:18,95,9173,40,55,6495.75,11768.01,0.00
2024-12-10 17:42:18,94,9173,40,54,6528.58,11768.10,0.00
2024-12-10 17:42:18,94,9174,40,54,6495.70,11769.00,0.00
2024-12-10 17:42:18,95,9174,40,55,6427.32,11769.01,0.00
2024-12-10 17:42:18,94,9174,39,55,6489.69,11769.05,0.00
2024-12-10 17:42:18,93,9174,39,54,6529.10,11769.09,0.00
2024-12-10 17:42:18,93,9175,39,54,6496.40,11770.00,0.00
2024-12-10 17:42:18,94,9175,39,55,6427.29,11770.01,0.00
2024-12-10 17:42:18,93,9175,38,55,6459.70,11770.05,0.00
2024-12-10 17:42:18,92,9175,38,54,6501.77,11770.08,0.00
2024-12-10 17:42:18,92,9176,38,54,6519.05,11771.00,0.00
2024-12-10 17:42:18,93,9176,38,55,6448.95,11771.01,0.00
2024-12-10 17:42:18,94,9175,38,56,6331.57,11771.23,0.00
2024-12-10 17:42:18,93,9175,37,56,6378.21,11771.49,0.00
2024-12-10 17:42:18,93,9176,37,56,6440.10,11772.00,0.00
2024-12-10 17:42:18,94,9176,37,57,6371.59,11772.01,0.00
2024-12-10 17:42:18,93,9176,37,56,6416.09,11772.14,0.00
2024-12-10 17:42:18,93,9177,37,56,6506.83,11773.00,0.00
2024-12-10 17:42:18,94,9177,37,57,6437.61,11773.01,0.00
2024-12-10 17:42:18,94,9178,37,57,6352.48,11774.00,0.00
2024-12-10 17:42:18,95,9178,37,58,6285.62,11774.01,0.00
2024-12-10 17:42:18,94,9178,37,57,6331.23,11774.14,0.00
2024-12-10 17:42:18,94,9179,37,57,6283.07,11775.00,0.00
2024-12-10 17:42:18,95,9179,37,58,6216.94,11775.01,0.00
2024-12-10 17:42:18,94,9179,36,58,6227.27,11775.21,0.00
2024-12-10 17:42:18,94,9180,36,58,6206.42,11776.00,0.00
2024-12-10 17:42:18,95,9180,36,59,6141.08,11776.01,0.00
2024-12-10 17:42:18,96,9179,37,59,6055.97,11776.20,0.00
2024-12-10 17:42:18,95,9179,37,58,6194.19,11776.21,0.00
2024-12-10 17:42:18,96,9178,38,58,6123.56,11776.28,0.00
2024-12-10 17:42:18,96,9179,38,58,6196.67,11777.00,0.00
2024-12-10 17:42:18,97,9179,39,58,6132.79,11777.01,0.00
2024-12-10 17:42:18,96,9179,39,57,6181.12,11777.14,0.00
2024-12-10 17:42:18,95,9179,38,57,6141.39,11777.74,0.00
2024-12-10 17:42:18,94,9179,37,57,6197.11,11777.77,0.00
2024-12-10 17:42:18,94,9180,37,57,6541.32,11778.00,0.00
2024-12-10 17:42:18,95,9180,37,58,6472.46,11778.01,0.00
2024-12-10 17:42:18,94,9180,37,57,6506.30,11778.19,0.00
2024-12-10 17:42:18,93,9180,36,57,6563.53,11778.28,0.00
2024-12-10 17:42:18,92,9180,35,57,6586.32,11778.68,0.00
2024-12-10 17:42:18,92,9181,35,57,6622.39,11779.00,0.00
2024-12-10 17:42:18,93,9181,35,58,6551.18,11779.01,0.00
2024-12-10 17:42:18,93,9182,35,58,6513.06,11780.00,0.00
2024-12-10 17:42:18,94,9182,35,59,6443.77,11780.01,0.00
2024-12-10 17:42:18,94,9183,35,59,6387.48,11781.00,0.00
2024-12-10 17:42:18,95,9183,36,59,6320.25,11781.01,0.00
2024-12-10 17:42:18,95,9184,36,59,6241.77,11782.00,0.00
2024-12-10 17:42:18,96,9184,36,60,6176.75,11782.01,0.00
2024-12-10 17:42:18,95,9184,35,60,6196.96,11782.04,0.00
2024-12-10 17:42:18,94,9184,34,60,6120.50,11782.71,0.00
2024-12-10 17:42:18,94,9185,34,60,6212.23,11783.00,0.00
2024-12-10 17:42:18,95,9185,35,60,6146.84,11783.01,0.00
2024-12-10 17:42:18,96,9184,35,61,6082.81,11783.03,0.00
2024-12-10 17:42:18,95,9184,35,60,6233.70,11783.18,0.00
2024-12-10 17:42:18,96,9183,35,61,6147.97,11783.38,0.00
2024-12-10 17:42:18,96,9184,35,61,6215.89,11784.00,0.00
2024-12-10 17:42:18,97,9184,36,61,6151.81,11784.01,0.00
2024-12-10 17:42:18,96,9184,35,61,6151.19,11784.30,0.00
2024-12-10 17:42:18,95,9184,34,61,6164.07,11784.74,0.00
2024-12-10 17:42:18,95,9185,34,61,6505.41,11785.00,0.00
2024-12-10 17:42:19,96,9185,35,61,6437.65,11785.01,0.00
2024-12-10 17:42:19,95,9185,35,60,6500.47,11785.04,0.00
2024-12-10 17:42:19,94,9185,35,59,6568.37,11785.04,0.00
2024-12-10 17:42:19,93,9185,35,58,6620.42,11785.15,0.00
2024-12-10 17:42:19,93,9186,35,58,6596.45,11786.00,0.00
2024-12-10 17:42:19,94,9186,36,58,6526.28,11786.01,0.00
2024-12-10 17:42:19,94,9187,36,58,6457.70,11787.00,0.00
2024-12-10 17:42:19,95,9187,37,58,6389.72,11787.01,0.00
2024-12-10 17:42:19,94,9187,37,57,6437.67,11787.15,0.00
2024-12-10 17:42:19,94,9188,37,57,6411.66,11788.00,0.00
2024-12-10 17:42:19,95,9188,38,57,6344.17,11788.01,0.00
2024-12-10 17:42:19,94,9188,37,57,6348.35,11788.32,0.00
2024-12-10 17:42:19,94,9189,37,57,6365.74,11789.00,0.00
2024-12-10 17:42:19,95,9189,37,58,6298.73,11789.01,0.00
2024-12-10 17:42:19,94,9189,36,58,6349.31,11789.13,0.00
2024-12-10 17:42:19,94,9190,36,58,6301.73,11790.00,0.00
2024-12-10 17:42:19,95,9190,37,58,6235.40,11790.01,0.00
2024-12-10 17:42:19,94,9190,37,57,6296.74,11790.04,0.00
2024-12-10 17:42:19,93,9190,37,56,6363.18,11790.04,0.00
2024-12-10 17:42:19,94,9189,38,56,6287.96,11790.13,0.00
2024-12-10 17:42:19,93,9189,38,55,6359.39,11790.13,0.00
2024-12-10 17:42:19,93,9190,38,55,6331.40,11791.00,0.00
2024-12-10 17:42:19,94,9190,39,55,6264.05,11791.01,0.00
2024-12-10 17:42:19,93,9190,39,54,6326.36,11791.04,0.00
2024-12-10 17:42:19,92,9190,38,54,6278.78,11791.42,0.00
2024-12-10 17:42:19,92,9191,38,54,6462.88,11792.00,0.00
2024-12-10 17:42:19,93,9191,38,55,6393.39,11792.01,0.00
2024-12-10 17:42:19,92,9191,38,54,6457.78,11792.04,0.00
2024-12-10 17:42:19,91,9191,38,53,6515.81,11792.12,0.00
2024-12-10 17:42:19,91,9192,38,53,6482.38,11793.00,0.00
2024-12-10 17:42:19,92,9192,38,54,6411.92,11793.01,0.00
2024-12-10 17:42:19,91,9192,38,53,6477.22,11793.04,0.00
2024-12-10 17:42:19,91,9193,38,53,6420.69,11794.00,0.00
2024-12-10 17:42:19,92,9193,38,54,6350.90,11794.01,0.00
2024-12-10 17:42:19,91,9193,37,54,6415.52,11794.04,0.00
2024-12-10 17:42:19,90,9193,36,54,6437.08,11794.24,0.00
2024-12-10 17:42:19,89,9193,35,54,6360.24,11794.98,0.00
2024-12-10 17:42:19,89,9194,35,54,6490.13,11795.00,0.00
2024-12-10 17:42:19,90,9194,36,54,6418.02,11795.01,0.00
2024-12-10 17:42:19,89,9194,36,53,6475.61,11795.10,0.00
2024-12-10 17:42:19,88,9194,35,53,6515.69,11795.11,0.00
2024-12-10 17:42:19,88,9195,35,53,6520.02,11796.00,0.00
2024-12-10 17:42:19,89,9195,35,54,6446.76,11796.01,0.00
2024-12-10 17:42:19,88,9195,35,53,6481.19,11796.10,0.00
2024-12-10 17:42:19,87,9195,34,53,6490.84,11796.51,0.00
2024-12-10 17:42:19,87,9196,34,53,6509.27,11797.00,0.00
2024-12-10 17:42:19,88,9196,34,54,6435.30,11797.01,0.00
2024-12-10 17:42:19,87,9196,33,54,6423.90,11797.16,0.00
2024-12-10 17:42:19,87,9197,33,54,6453.61,11798.00,0.00
2024-12-10 17:42:19,88,9197,34,54,6380.27,11798.01,0.00
2024-12-10 17:42:19,88,9198,34,54,6309.17,11799.00,0.00
2024-12-10 17:42:19,89,9198,34,55,6238.28,11799.01,0.00
2024-12-10 17:42:19,88,9198,34,54,6287.76,11799.14,0.00
2024-12-10 17:42:19,88,9199,34,54,6256.87,11800.00,0.00
2024-12-10 17:42:19,89,9199,35,54,6186.57,11800.01,0.00
2024-12-10 17:42:19,90,9198,35,55,6034.10,11800.52,0.00
2024-12-10 17:42:19,91,9197,36,55,6001.24,11800.58,0.00
2024-12-10 17:42:19,91,9198,36,55,6073.68,11801.00,0.00
2024-12-10 17:42:19,92,9198,36,56,6007.66,11801.01,0.00
2024-12-10 17:42:19,91,9198,36,55,6067.22,11801.05,0.00
2024-12-10 17:42:19,90,9198,36,54,6128.10,11801.10,0.00
2024-12-10 17:42:19,89,9198,36,53,6189.00,11801.11,0.00
2024-12-10 17:42:19,89,9199,36,53,6417.16,11802.00,0.00
2024-12-10 17:42:19,90,9199,37,53,6345.86,11802.01,0.00
2024-12-10 17:42:19,91,9198,37,54,6276.13,11802.03,0.00
2024-12-10 17:42:19,91,9199,37,54,6263.02,11803.00,0.00
2024-12-10 17:42:19,92,9199,37,55,6194.94,11803.01,0.00
2024-12-10 17:42:19,93,9198,38,55,6059.92,11803.40,0.00
2024-12-10 17:42:19,92,9198,37,55,6210.33,11803.50,0.00
2024-12-10 17:42:19,92,9199,37,55,6388.44,11804.00,0.00
2024-12-10 17:42:19,93,9199,37,56,6319.75,11804.01,0.00
2024-12-10 17:42:19,93,9200,37,56,6394.88,11805.00,0.00
2024-12-10 17:42:19,94,9200,38,56,6326.85,11805.01,0.00
2024-12-10 17:42:19,93,9200,38,55,6358.11,11805.12,0.00
2024-12-10 17:42:19,92,9200,37,55,6416.05,11805.21,0.00
2024-12-10 17:42:19,91,9200,36,55,6424.56,11805.74,0.00
2024-12-10 17:42:19,90,9200,35,55,6474.60,11805.91,0.00
2024-12-10 17:42:19,90,9201,35,55,6595.36,11806.00,0.00
2024-12-10 17:42:19,91,9201,35,56,6522.88,11806.01,0.00
2024-12-10 17:42:19,90,9201,34,56,6510.23,11806.40,0.00
2024-12-10 17:42:19,90,9202,34,56,6570.99,11807.00,0.00
2024-12-10 17:42:19,91,9202,34,57,6498.78,11807.01,0.00
2024-12-10 17:42:19,90,9202,34,56,6556.95,11807.12,0.00
2024-12-10 17:42:19,89,9202,33,56,6598.51,11807.35,0.00
2024-12-10 17:42:19,89,9203,33,56,6654.67,11808.00,0.00
2024-12-10 17:42:19,90,9203,34,56,6580.73,11808.01,0.00
2024-12-10 17:42:19,91,9202,34,57,6337.52,11808.82,0.00
2024-12-10 17:42:19,91,9203,34,57,6463.55,11809.00,0.00
2024-12-10 17:42:19,92,9203,35,57,6393.29,11809.01,0.00
2024-12-10 17:42:19,91,9203,35,56,6446.72,11809.12,0.00
2024-12-10 17:42:19,91,9204,35,56,6551.05,11810.00,0.00
2024-12-10 17:42:19,92,9204,36,56,6479.84,11810.01,0.00
2024-12-10 17:42:19,91,9204,35,56,6398.21,11810.69,0.00
2024-12-10 17:42:19,91,9205,35,56,6491.90,11811.00,0.00
2024-12-10 17:42:19,92,9205,36,56,6421.34,11811.01,0.00
2024-12-10 17:42:19,91,9205,36,55,6484.14,11811.07,0.00
2024-12-10 17:42:19,90,9205,36,54,6544.39,11811.12,0.00
2024-12-10 17:42:19,90,9206,36,54,6519.96,11812.00,0.00
2024-12-10 17:42:19,91,9206,37,54,6448.31,11812.01,0.00
2024-12-10 17:42:19,90,9206,36,54,6369.32,11812.68,0.00
2024-12-10 17:42:19,90,9207,36,54,6462.76,11813.00,0.00
2024-12-10 17:42:19,91,9207,37,54,6391.75,11813.01,0.00
2024-12-10 17:42:19,90,9207,37,53,6447.05,11813.12,0.00
2024-12-10 17:42:19,89,9207,36,53,6453.29,11813.69,0.00
2024-12-10 17:42:19,89,9208,36,53,6495.97,11814.00,0.00
2024-12-10 17:42:19,90,9208,37,53,6423.80,11814.01,0.00
2024-12-10 17:42:19,89,9208,36,53,6441.59,11814.17,0.00
2024-12-10 17:42:20,90,9207,37,53,6303.22,11814.53,0.00
2024-12-10 17:42:20,90,9208,37,53,6428.75,11815.00,0.00
2024-12-10 17:42:20,91,9208,37,54,6358.10,11815.01,0.00
2024-12-10 17:42:20,92,9207,38,54,6288.99,11815.03,0.00
2024-12-10 17:42:20,91,9207,38,53,6370.69,11815.05,0.00
2024-12-10 17:42:20,90,9207,38,52,6417.87,11815.17,0.00
2024-12-10 17:42:20,90,9208,38,52,6528.67,11816.00,0.00
2024-12-10 17:42:20,91,9208,38,53,6456.93,11816.01,0.00
2024-12-10 17:42:20,91,9209,38,53,6561.12,11817.00,0.00
2024-12-10 17:42:20,92,9209,38,54,6489.80,11817.01,0.00
2024-12-10 17:42:20,93,9208,39,54,6328.05,11817.56,0.00
2024-12-10 17:42:20,93,9209,39,54,6434.24,11818.00,0.00
2024-12-10 17:42:20,94,9209,39,55,6365.79,11818.01,0.00
2024-12-10 17:42:20,93,9209,38,55,6392.71,11818.14,0.00
2024-12-10 17:42:20,93,9210,38,55,6511.01,11819.00,0.00
2024-12-10 17:42:20,94,9210,39,55,6441.75,11819.01,0.00
2024-12-10 17:42:20,93,9210,39,54,6477.99,11819.06,0.00
2024-12-10 17:42:20,92,9210,38,54,6506.11,11819.37,0.00
2024-12-10 17:42:20,93,9209,38,55,6323.16,11819.98,0.00
2024-12-10 17:42:20,93,9210,38,55,6449.01,11820.00,0.00
2024-12-10 17:42:20,94,9210,38,56,6380.40,11820.01,0.00
2024-12-10 17:42:20,93,9210,38,55,6428.67,11820.01,0.00
2024-12-10 17:42:20,93,9211,38,55,6507.67,11821.00,0.00
2024-12-10 17:42:20,94,9211,38,56,6438.43,11821.01,0.00
2024-12-10 17:42:20,93,9211,37,56,6399.53,11821.26,0.00
2024-12-10 17:42:20,93,9212,37,56,6438.89,11822.00,0.00
2024-12-10 17:42:20,94,9212,37,57,6370.39,11822.01,0.00
2024-12-10 17:42:20,93,9212,37,56,6432.55,11822.05,0.00
2024-12-10 17:42:20,92,9212,37,55,6494.77,11822.11,0.00
2024-12-10 17:42:20,91,9212,36,55,6538.48,11822.27,0.00
2024-12-10 17:42:20,91,9213,36,55,6531.17,11823.00,0.00
2024-12-10 17:42:20,92,9213,37,55,6460.17,11823.01,0.00
2024-12-10 17:42:20,91,9213,37,54,6493.51,11823.11,0.00
2024-12-10 17:42:20,90,9213,37,53,6547.56,11823.21,0.00
2024-12-10 17:42:20,90,9214,37,53,6533.61,11824.00,0.00
2024-12-10 17:42:20,91,9214,38,53,6461.81,11824.01,0.00
2024-12-10 17:42:20,90,9214,37,53,6504.72,11824.09,0.00
2024-12-10 17:42:20,89,9214,37,52,6549.91,11824.10,0.00
2024-12-10 17:42:20,89,9215,37,52,6573.78,11825.00,0.00
2024-12-10 17:42:20,90,9215,38,52,6500.74,11825.01,0.00
2024-12-10 17:42:20,89,9215,38,51,6536.60,11825.10,0.00
2024-12-10 17:42:20,88,9215,37,51,6547.87,11825.44,0.00
2024-12-10 17:42:20,88,9216,37,51,6614.93,11826.00,0.00
2024-12-10 17:42:20,89,9216,38,51,6540.60,11826.01,0.00
2024-12-10 17:42:20,88,9216,37,51,6608.22,11826.06,0.00
2024-12-10 17:42:20,88,9217,37,51,6548.88,11827.00,0.00
2024-12-10 17:42:20,89,9217,37,52,6475.30,11827.01,0.00
2024-12-10 17:42:20,88,9217,36,52,6503.19,11827.02,0.00
2024-12-10 17:42:20,87,9217,36,51,6560.28,11827.06,0.00
2024-12-10 17:42:20,86,9217,36,50,6631.06,11827.09,0.00
2024-12-10 17:42:20,86,9218,36,50,6658.31,11828.00,0.00
2024-12-10 17:42:20,87,9218,37,50,6581.78,11828.01,0.00
2024-12-10 17:42:20,88,9217,37,51,6390.81,11828.63,0.00
2024-12-10 17:42:20,88,9218,37,51,6511.36,11829.00,0.00
2024-12-10 17:42:20,89,9218,38,51,6438.20,11829.01,0.00
2024-12-10 17:42:20,88,9218,37,51,6362.51,11829.70,0.00
2024-12-10 17:42:20,88,9219,37,51,6596.64,11830.00,0.00
2024-12-10 17:42:20,89,9219,38,51,6522.52,11830.01,0.00
2024-12-10 17:42:20,88,9219,37,51,6585.24,11830.03,0.00
2024-12-10 17:42:20,87,9219,36,51,6658.43,11830.05,0.00
2024-12-10 17:42:20,88,9218,36,52,6470.91,11830.68,0.00
2024-12-10 17:42:20,88,9219,36,52,6598.88,11831.00,0.00
2024-12-10 17:42:20,89,9219,37,52,6524.73,11831.01,0.00
2024-12-10 17:42:20,88,9219,37,51,6570.66,11831.10,0.00
2024-12-10 17:42:20,88,9220,37,51,6667.06,11832.00,0.00
2024-12-10 17:42:20,89,9220,37,52,6592.15,11832.01,0.00
2024-12-10 17:42:20,89,9221,37,52,6550.74,11833.00,0.00
2024-12-10 17:42:20,90,9221,37,53,6477.96,11833.01,0.00
2024-12-10 17:42:20,89,9221,37,52,6549.41,11833.01,0.00
2024-12-10 17:42:20,88,9221,37,51,6621.16,11833.02,0.00
2024-12-10 17:42:20,88,9222,37,51,6566.43,11834.00,0.00
2024-12-10 17:42:20,89,9222,38,51,6492.65,11834.01,0.00
2024-12-10 17:42:20,89,9223,38,51,6409.50,11835.00,0.00
2024-12-10 17:42:20,90,9223,39,51,6338.28,11835.01,0.00
2024-12-10 17:42:20,91,9222,40,51,6239.04,11835.13,0.00
2024-12-10 17:42:20,90,9222,39,51,6352.94,11835.13,0.00
2024-12-10 17:42:20,89,9222,39,50,6415.02,11835.15,0.00
2024-12-10 17:42:20,89,9223,39,50,6385.87,11836.00,0.00
2024-12-10 17:42:20,90,9223,40,50,6314.92,11836.01,0.00
2024-12-10 17:42:20,89,9223,39,50,6372.39,11836.07,0.00
2024-12-10 17:42:20,88,9223,38,50,6440.34,11836.07,0.00
2024-12-10 17:42:20,88,9224,38,50,6510.37,11837.00,0.00
2024-12-10 17:42:20,89,9224,38,51,6437.22,11837.01,0.00
2024-12-10 17:42:20,88,9224,37,51,6502.20,11837.06,0.00
2024-12-10 17:42:20,87,9224,37,50,6570.13,11837.07,0.00
2024-12-10 17:42:20,87,9225,37,50,6531.79,11838.00,0.00
2024-12-10 17:42:20,88,9225,37,51,6457.57,11838.01,0.00
2024-12-10 17:42:20,87,9225,36,51,6478.80,11838.23,0.00
2024-12-10 17:42:20,88,9224,36,52,6341.80,11838.69,0.00
2024-12-10 17:42:20,88,9225,36,52,6551.15,11839.00,0.00
2024-12-10 17:42:20,89,9225,37,52,6477.54,11839.01,0.00
2024-12-10 17:42:20,88,9225,36,52,6463.26,11839.51,0.00
2024-12-10 17:42:20,89,9224,37,52,6389.31,11839.54,0.00
2024-12-10 17:42:20,88,9224,36,52,6484.45,11839.70,0.00
2024-12-10 17:42:20,88,9225,36,52,6700.72,11840.00,0.00
2024-12-10 17:42:20,89,9225,36,53,6625.43,11840.01,0.00
2024-12-10 17:42:20,90,9224,37,53,6505.82,11840.20,0.00
2024-12-10 17:42:20,91,9223,37,54,6436.53,11840.46,0.00
2024-12-10 17:42:20,91,9224,37,54,6646.07,11841.00,0.00
2024-12-10 17:42:20,92,9224,37,55,6573.83,11841.01,0.00
2024-12-10 17:42:20,92,9225,37,55,6758.36,11842.00,0.00
2024-12-10 17:42:20,93,9225,37,56,6685.69,11842.01,0.00
2024-12-10 17:42:20,92,9225,37,55,6733.91,11842.07,0.00
2024-12-10 17:42:20,92,9226,37,55,6683.01,11843.00,0.00
2024-12-10 17:42:20,93,9226,38,55,6611.15,11843.01,0.00
2024-12-10 17:42:21,94,9225,39,55,6335.06,11843.99,0.00
2024-12-10 17:42:21,94,9226,39,55,6461.07,11844.00,0.00
2024-12-10 17:42:21,95,9226,39,56,6393.05,11844.01,0.00
2024-12-10 17:42:21,94,9226,39,55,6442.18,11844.10,0.00
2024-12-10 17:42:21,93,9226,38,55,6494.14,11844.24,0.00
2024-12-10 17:42:21,94,9225,38,56,6397.45,11844.49,0.00
2024-12-10 17:42:21,94,9226,38,56,6538.01,11845.00,0.00
2024-12-10 17:42:21,95,9226,38,57,6469.18,11845.01,0.00
2024-12-10 17:42:21,94,9226,38,56,6535.49,11845.02,0.00
2024-12-10 17:42:21,95,9225,39,56,6433.04,11845.12,0.00
2024-12-10 17:42:21,94,9225,38,56,6438.40,11845.89,0.00
2024-12-10 17:42:21,94,9226,38,56,6677.93,11846.00,0.00
2024-12-10 17:42:21,95,9226,39,56,6607.63,11846.01,0.00
2024-12-10 17:42:21,94,9226,39,55,6675.41,11846.02,0.00
2024-12-10 17:42:21,93,9226,39,54,6733.19,11846.08,0.00
2024-12-10 17:42:21,92,9226,38,54,6716.51,11846.50,0.00
2024-12-10 17:42:21,92,9226,38,54,6907.50,11847.00,0.00
2024-12-10 17:42:21,93,9226,39,54,6833.23,11847.01,0.00
2024-12-10 17:42:21,94,9225,40,54,6661.59,11847.64,0.00
2024-12-10 17:42:21,94,9226,40,54,6757.48,11848.00,0.00
2024-12-10 17:42:21,95,9226,40,55,6686.35,11848.01,0.00
2024-12-10 17:42:21,94,9226,40,54,6754.96,11848.02,0.00
2024-12-10 17:42:21,95,9225,41,54,6612.92,11848.43,0.00
2024-12-10 17:42:21,95,9226,41,54,6779.06,11849.00,0.00
2024-12-10 17:42:21,96,9226,42,54,6708.45,11849.01,0.00
2024-12-10 17:42:21,95,9226,41,54,6671.83,11849.62,0.00
2024-12-10 17:42:21,95,9227,41,54,6852.07,11850.00,0.00
2024-12-10 17:42:21,96,9227,41,55,6780.69,11850.01,0.00
2024-12-10 17:42:21,96,9228,41,55,6714.94,11851.00,0.00
2024-12-10 17:42:21,97,9228,42,55,6645.71,11851.01,0.00
2024-12-10 17:42:21,96,9228,42,54,6690.26,11851.06,0.00
2024-12-10 17:42:21,95,9228,41,54,6749.43,11851.13,0.00
2024-12-10 17:42:21,95,9229,41,54,6721.27,11852.00,0.00
2024-12-10 17:42:21,96,9229,42,54,6651.26,11852.01,0.00
2024-12-10 17:42:21,95,9229,42,53,6688.85,11852.06,0.00
2024-12-10 17:42:21,95,9230,42,53,6653.22,11853.00,0.00
2024-12-10 17:42:21,96,9230,43,53,6583.91,11853.01,0.00
2024-12-10 17:42:21,95,9230,43,52,6620.79,11853.06,0.00
2024-12-10 17:42:21,94,9230,42,52,6657.19,11853.10,0.00
2024-12-10 17:42:21,94,9231,42,52,6676.64,11854.00,0.00
2024-12-10 17:42:21,95,9231,42,53,6606.36,11854.01,0.00
2024-12-10 17:42:21,94,9231,42,52,6643.86,11854.06,0.00
2024-12-10 17:42:21,93,9231,41,52,6654.17,11854.18,0.00
2024-12-10 17:42:21,93,9232,41,52,6685.27,11855.00,0.00
2024-12-10 17:42:21,94,9232,41,53,6614.15,11855.01,0.00
2024-12-10 17:42:21,94,9233,41,53,6585.79,11856.00,0.00
2024-12-10 17:42:21,95,9233,41,54,6516.46,11856.01,0.00
2024-12-10 17:42:21,94,9233,40,54,6536.65,11856.21,0.00
2024-12-10 17:42:21,93,9233,39,54,6569.97,11856.43,0.00
2024-12-10 17:42:21,93,9234,39,54,6630.30,11857.00,0.00
2024-12-10 17:42:21,94,9234,40,54,6559.76,11857.01,0.00
2024-12-10 17:42:21,94,9235,40,54,6508.99,11858.00,0.00
2024-12-10 17:42:21,95,9235,41,54,6440.47,11858.01,0.00
2024-12-10 17:42:21,94,9235,41,53,6492.59,11858.04,0.00
2024-12-10 17:42:21,93,9235,40,53,6502.60,11858.39,0.00
2024-12-10 17:42:21,93,9236,40,53,6557.85,11859.00,0.00
2024-12-10 17:42:21,94,9236,40,54,6488.09,11859.01,0.00
2024-12-10 17:42:21,93,9236,40,53,6555.31,11859.02,0.00
2024-12-10 17:42:21,92,9236,39,53,6577.63,11859.22,0.00
2024-12-10 17:42:21,92,9237,39,53,6562.66,11860.00,0.00
2024-12-10 17:42:21,93,9237,40,53,6492.09,11860.01,0.00
2024-12-10 17:42:21,92,9237,40,52,6557.51,11860.04,0.00
2024-12-10 17:42:21,91,9237,39,52,6606.17,11860.23,0.00
2024-12-10 17:42:21,90,9237,38,52,6661.12,11860.39,0.00
2024-12-10 17:42:21,90,9238,38,52,6668.14,11861.00,0.00
2024-12-10 17:42:21,91,9238,38,53,6594.86,11861.01,0.00
2024-12-10 17:42:21,90,9238,38,52,6643.10,11861.04,0.00
2024-12-10 17:42:21,90,9239,38,52,6609.39,11862.00,0.00
2024-12-10 17:42:21,91,9239,38,53,6536.76,11862.01,0.00
2024-12-10 17:42:21,90,9239,38,52,6583.03,11862.04,0.00
2024-12-10 17:42:21,89,9239,38,51,6625.44,11862.30,0.00
2024-12-10 17:42:21,90,9238,39,51,6495.45,11862.80,0.00
2024-12-10 17:42:21,90,9239,39,51,6609.12,11863.00,0.00
2024-12-10 17:42:21,91,9239,40,51,6536.50,11863.01,0.00
2024-12-10 17:42:21,91,9240,40,51,6616.33,11864.00,0.00
2024-12-10 17:42:21,92,9240,40,52,6544.42,11864.01,0.00
2024-12-10 17:42:21,92,9241,40,52,6460.23,11865.00,0.00
2024-12-10 17:42:21,93,9241,40,53,6390.77,11865.01,0.00
2024-12-10 17:42:21,92,9241,39,53,6457.65,11865.02,0.00
2024-12-10 17:42:21,91,9241,39,52,6510.36,11865.03,0.00
2024-12-10 17:42:21,91,9242,39,52,6432.80,11866.00,0.00
2024-12-10 17:42:21,92,9242,39,53,6362.88,11866.01,0.00
2024-12-10 17:42:21,91,9242,39,52,6410.63,11866.03,0.00
2024-12-10 17:42:21,90,9242,38,52,6342.47,11866.76,0.00
2024-12-10 17:42:21,89,9242,37,52,6366.74,11866.85,0.00
2024-12-10 17:42:21,89,9243,37,52,6482.85,11867.00,0.00
2024-12-10 17:42:21,90,9243,38,52,6410.81,11867.01,0.00
2024-12-10 17:42:21,89,9243,38,51,6458.85,11867.03,0.00
2024-12-10 17:42:21,89,9244,38,51,6420.11,11868.00,0.00
2024-12-10 17:42:21,90,9244,38,52,6348.78,11868.01,0.00
2024-12-10 17:42:21,89,9244,38,51,6396.11,11868.03,0.00
2024-12-10 17:42:21,89,9245,38,51,6343.63,11869.00,0.00
2024-12-10 17:42:21,90,9245,39,51,6273.14,11869.01,0.00
2024-12-10 17:42:21,89,9245,39,50,6340.96,11869.02,0.00
2024-12-10 17:42:21,88,9245,39,49,6392.78,11869.02,0.00
2024-12-10 17:42:21,87,9245,38,49,6404.91,11869.15,0.00
2024-12-10 17:42:21,88,9244,38,50,6246.76,11869.72,0.00
2024-12-10 17:42:21,89,9243,38,51,6204.61,11869.75,0.00
2024-12-10 17:42:21,89,9244,38,51,6381.29,11870.00,0.00
2024-12-10 17:42:21,90,9244,38,52,6310.38,11870.01,0.00
2024-12-10 17:42:21,89,9244,37,52,6380.05,11870.01,0.00
2024-12-10 17:42:21,88,9244,37,51,6424.22,11870.02,0.00
2024-12-10 17:42:21,87,9244,36,51,6469.41,11870.02,0.00
2024-12-10 17:42:21,87,9245,36,51,6726.75,11871.00,0.00
2024-12-10 17:42:21,88,9245,36,52,6650.31,11871.01,0.00
2024-12-10 17:42:21,87,9245,35,52,6674.39,11871.20,0.00
2024-12-10 17:42:21,88,9244,36,52,6595.86,11871.24,0.00
2024-12-10 17:42:21,87,9244,36,51,6703.59,11871.45,0.00
2024-12-10 17:42:21,87,9245,36,51,6715.02,11872.00,0.00
2024-12-10 17:42:21,88,9245,36,52,6638.72,11872.01,0.00
2024-12-10 17:42:22,87,9245,36,51,6700.02,11872.07,0.00
2024-12-10 17:42:22,88,9244,36,52,6603.10,11872.26,0.00
2024-12-10 17:42:22,87,9244,35,52,6670.63,11872.67,0.00
2024-12-10 17:42:22,87,9245,35,52,6900.41,11873.00,0.00
2024-12-10 17:42:22,88,9245,35,53,6821.99,11873.01,0.00
2024-12-10 17:42:22,89,9244,36,53,6685.42,11873.31,0.00
2024-12-10 17:42:22,89,9245,36,53,6878.57,11874.00,0.00
2024-12-10 17:42:22,90,9245,37,53,6802.15,11874.01,0.00
2024-12-10 17:42:22,89,9245,37,52,6863.91,11874.07,0.00
2024-12-10 17:42:22,90,9244,37,53,6781.07,11874.14,0.00
2024-12-10 17:42:22,89,9244,36,53,6771.07,11874.71,0.00
2024-12-10 17:42:22,89,9245,36,53,7000.58,11875.00,0.00
2024-12-10 17:42:22,90,9245,36,54,6922.79,11875.01,0.00
2024-12-10 17:42:22,89,9245,35,54,6953.94,11875.18,0.00
2024-12-10 17:42:22,90,9244,35,55,6847.77,11875.44,0.00
2024-12-10 17:42:22,89,9244,34,55,7006.88,11875.66,0.00
2024-12-10 17:42:22,90,9243,34,56,6912.75,11875.79,0.00
2024-12-10 17:42:22,90,9244,34,56,7166.97,11876.00,0.00
2024-12-10 17:42:22,91,9244,35,56,7088.21,11876.01,0.00
2024-12-10 17:42:22,90,9244,34,56,7084.06,11876.43,0.00
2024-12-10 17:42:22,90,9245,34,56,7403.63,11877.00,0.00
2024-12-10 17:42:22,91,9245,35,56,7322.27,11877.01,0.00
2024-12-10 17:42:22,90,9245,34,56,7295.77,11877.69,0.00
2024-12-10 17:42:22,90,9246,34,56,7322.55,11878.00,0.00
2024-12-10 17:42:22,91,9246,35,56,7242.08,11878.01,0.00
2024-12-10 17:42:22,90,9246,35,55,7312.00,11878.07,0.00
2024-12-10 17:42:22,90,9247,35,55,7257.21,11879.00,0.00
2024-12-10 17:42:22,91,9247,35,56,7177.46,11879.01,0.00
2024-12-10 17:42:22,92,9246,36,56,7026.02,11879.43,0.00
2024-12-10 17:42:22,92,9247,36,56,7079.84,11880.00,0.00
2024-12-10 17:42:22,93,9247,37,56,7003.71,11880.01,0.00
2024-12-10 17:42:22,92,9247,36,56,7027.82,11880.21,0.00
2024-12-10 17:42:22,92,9248,36,56,7114.79,11881.00,0.00
2024-12-10 17:42:22,93,9248,37,56,7038.28,11881.01,0.00
2024-12-10 17:42:22,92,9248,37,55,7108.80,11881.04,0.00
2024-12-10 17:42:22,91,9248,37,54,7175.17,11881.05,0.00
2024-12-10 17:42:22,90,9248,36,54,7104.76,11881.89,0.00
2024-12-10 17:42:22,90,9249,36,54,7215.02,11882.00,0.00
2024-12-10 17:42:22,91,9249,37,54,7135.73,11882.01,0.00
2024-12-10 17:42:22,90,9249,37,53,7182.02,11882.06,0.00
2024-12-10 17:42:22,89,9249,36,53,7182.41,11882.48,0.00
2024-12-10 17:42:22,89,9250,36,53,7221.02,11883.00,0.00
2024-12-10 17:42:22,90,9250,37,53,7140.79,11883.01,0.00
2024-12-10 17:42:22,89,9250,37,52,7187.65,11883.06,0.00
2024-12-10 17:42:22,90,9249,37,53,6978.07,11883.66,0.00
2024-12-10 17:42:22,90,9250,37,53,7142.68,11884.00,0.00
2024-12-10 17:42:22,91,9250,38,53,7064.19,11884.01,0.00
2024-12-10 17:42:22,90,9250,38,52,7109.67,11884.06,0.00
2024-12-10 17:42:22,90,9251,38,52,7153.08,11885.00,0.00
2024-12-10 17:42:22,91,9251,39,52,7074.48,11885.01,0.00
2024-12-10 17:42:22,90,9251,38,52,7059.59,11885.32,0.00
2024-12-10 17:42:22,91,9250,38,53,6953.43,11885.58,0.00
2024-12-10 17:42:22,91,9251,38,53,7043.46,11886.00,0.00
2024-12-10 17:42:22,92,9251,39,53,6966.90,11886.01,0.00
2024-12-10 17:42:22,91,9251,39,52,6866.99,11886.86,0.00
2024-12-10 17:42:22,91,9252,39,52,7056.64,11887.00,0.00
2024-12-10 17:42:22,92,9252,39,53,6979.94,11887.01,0.00
2024-12-10 17:42:22,91,9252,38,53,7055.34,11887.01,0.00
2024-12-10 17:42:22,90,9252,38,52,7104.68,11887.06,0.00
2024-12-10 17:42:22,91,9251,38,53,7018.79,11887.14,0.00
2024-12-10 17:42:22,91,9252,38,53,6968.20,11888.00,0.00
2024-12-10 17:42:22,92,9252,38,54,6892.46,11888.01,0.00
2024-12-10 17:42:22,91,9252,37,54,6916.02,11888.22,0.00
2024-12-10 17:42:22,90,9252,36,54,6916.62,11888.62,0.00
2024-12-10 17:42:22,90,9253,36,54,7105.52,11889.00,0.00
2024-12-10 17:42:22,91,9253,36,55,7027.43,11889.01,0.00
2024-12-10 17:42:22,90,9253,36,54,7104.19,11889.02,0.00
2024-12-10 17:42:22,90,9254,36,54,7023.05,11890.00,0.00
2024-12-10 17:42:22,91,9254,36,55,6945.87,11890.01,0.00
2024-12-10 17:42:22,90,9254,36,54,6893.50,11890.59,0.00
2024-12-10 17:42:22,90,9255,36,54,6899.38,11891.00,0.00
2024-12-10 17:42:22,91,9255,36,55,6823.56,11891.01,0.00
2024-12-10 17:42:22,90,9255,36,54,6863.72,11891.08,0.00
2024-12-10 17:42:22,89,9255,35,54,6916.41,11891.22,0.00
2024-12-10 17:42:22,88,9255,35,53,6934.60,11891.51,0.00
2024-12-10 17:42:22,87,9255,35,52,6980.39,11891.59,0.00
2024-12-10 17:42:22,86,9255,34,52,7020.28,11891.70,0.00
2024-12-10 17:42:22,86,9256,34,52,7111.07,11892.00,0.00
2024-12-10 17:42:22,87,9256,35,52,7029.33,11892.01,0.00
2024-12-10 17:42:22,86,9256,35,51,7109.68,11892.01,0.00
2024-12-10 17:42:22,86,9257,35,51,7003.43,11893.00,0.00
2024-12-10 17:42:22,87,9257,35,52,6922.93,11893.01,0.00
2024-12-10 17:42:22,86,9257,35,51,6991.00,11893.07,0.00
2024-12-10 17:42:22,85,9257,35,50,7056.92,11893.09,0.00
2024-12-10 17:42:22,85,9258,35,50,6987.32,11894.00,0.00
2024-12-10 17:42:22,86,9258,36,50,6906.07,11894.01,0.00
2024-12-10 17:42:22,85,9258,36,49,6898.23,11894.38,0.00
2024-12-10 17:42:22,85,9259,36,49,6926.54,11895.00,0.00
2024-12-10 17:42:22,86,9259,37,49,6846.00,11895.01,0.00
2024-12-10 17:42:22,87,9258,38,49,6673.55,11895.56,0.00
2024-12-10 17:42:22,86,9258,38,48,6727.75,11895.88,0.00
2024-12-10 17:42:22,86,9259,38,48,6834.87,11896.00,0.00
2024-12-10 17:42:22,87,9259,38,49,6756.31,11896.01,0.00
2024-12-10 17:42:22,86,9259,38,48,6833.48,11896.01,0.00
2024-12-10 17:42:22,86,9260,38,48,6918.14,11897.00,0.00
2024-12-10 17:42:22,87,9260,38,49,6838.63,11897.01,0.00
2024-12-10 17:42:22,88,9259,38,50,6701.52,11897.31,0.00
2024-12-10 17:42:22,88,9260,38,50,6763.53,11898.00,0.00
2024-12-10 17:42:22,89,9260,38,51,6687.53,11898.01,0.00
2024-12-10 17:42:22,88,9260,38,50,6743.25,11898.07,0.00
2024-12-10 17:42:22,87,9260,37,50,6662.18,11898.94,0.00
2024-12-10 17:42:23,87,9261,37,50,6928.91,11899.00,0.00
2024-12-10 17:42:23,88,9261,38,50,6850.18,11899.01,0.00
2024-12-10 17:42:23,87,9261,37,50,6815.48,11899.26,0.00
2024-12-10 17:42:23,87,9262,37,50,6825.23,11900.00,0.00
2024-12-10 17:42:23,88,9262,37,51,6747.67,11900.01,0.00
2024-12-10 17:42:23,87,9262,37,50,6817.04,11900.07,0.00
2024-12-10 17:42:23,86,9262,37,49,6769.59,11900.79,0.00
2024-12-10 17:42:23,86,9263,37,49,6821.64,11901.00,0.00
2024-12-10 17:42:23,87,9263,37,50,6743.23,11901.01,0.00
2024-12-10 17:42:23,86,9263,37,49,6789.82,11901.06,0.00
2024-12-10 17:42:23,87,9262,38,49,6592.75,11901.62,0.00
2024-12-10 17:42:23,87,9263,38,49,6718.33,11902.00,0.00
2024-12-10 17:42:23,88,9263,38,50,6641.98,11902.01,0.00
2024-12-10 17:42:23,88,9264,38,50,6731.92,11903.00,0.00
2024-12-10 17:42:23,89,9264,39,50,6656.28,11903.01,0.00
2024-12-10 17:42:23,88,9264,38,50,6673.90,11903.25,0.00
2024-12-10 17:42:23,88,9265,38,50,6665.33,11904.00,0.00
2024-12-10 17:42:23,89,9265,38,51,6590.44,11904.01,0.00
2024-12-10 17:42:23,88,9265,38,50,6663.70,11904.02,0.00
2024-12-10 17:42:23,87,9265,38,49,6732.08,11904.05,0.00
2024-12-10 17:42:23,86,9265,37,49,6798.16,11904.14,0.00
2024-12-10 17:42:23,86,9266,37,49,6768.50,11905.00,0.00
2024-12-10 17:42:23,87,9266,37,50,6690.70,11905.01,0.00
2024-12-10 17:42:23,87,9267,37,50,6643.51,11906.00,0.00
2024-12-10 17:42:23,88,9267,38,50,6568.02,11906.01,0.00
2024-12-10 17:42:23,88,9268,38,50,6491.25,11907.00,0.00
2024-12-10 17:42:23,89,9268,38,51,6418.31,11907.01,0.00
2024-12-10 17:42:23,90,9267,38,52,6302.05,11907.19,0.00
2024-12-10 17:42:23,90,9268,38,52,6271.98,11908.00,0.00
2024-12-10 17:42:23,91,9268,38,53,6203.06,11908.01,0.00
2024-12-10 17:42:23,90,9268,38,52,6260.08,11908.04,0.00
2024-12-10 17:42:23,89,9268,37,52,6298.41,11908.30,0.00
2024-12-10 17:42:23,88,9268,37,51,6300.25,11908.81,0.00
2024-12-10 17:42:23,88,9269,37,51,6493.91,11909.00,0.00
2024-12-10 17:42:23,89,9269,38,51,6420.94,11909.01,0.00
2024-12-10 17:42:23,88,9269,37,51,6491.20,11909.02,0.00
2024-12-10 17:42:23,87,9269,37,50,6534.34,11909.07,0.00
2024-12-10 17:42:23,86,9269,36,50,6559.14,11909.34,0.00
2024-12-10 17:42:23,86,9270,36,50,6619.12,11910.00,0.00
2024-12-10 17:42:23,87,9270,37,50,6543.04,11910.01,0.00
2024-12-10 17:42:23,86,9270,36,50,6590.05,11910.06,0.00
2024-12-10 17:42:23,85,9270,36,49,6640.96,11910.06,0.00
2024-12-10 17:42:23,85,9271,36,49,6665.40,11911.00,0.00
2024-12-10 17:42:23,86,9271,37,49,6587.89,11911.01,0.00
2024-12-10 17:42:23,85,9271,36,49,6592.54,11911.09,0.00
2024-12-10 17:42:23,85,9272,36,49,6621.94,11912.00,0.00
2024-12-10 17:42:23,86,9272,37,49,6544.94,11912.01,0.00
2024-12-10 17:42:23,85,9272,37,48,6610.73,11912.08,0.00
2024-12-10 17:42:23,86,9271,38,48,6462.36,11912.69,0.00
2024-12-10 17:42:23,87,9270,38,49,6412.78,11912.77,0.00
2024-12-10 17:42:23,87,9271,38,49,6489.65,11913.00,0.00
2024-12-10 17:42:23,88,9271,38,50,6415.91,11913.01,0.00
2024-12-10 17:42:23,87,9271,37,50,6486.92,11913.02,0.00
2024-12-10 17:42:23,87,9272,37,50,6737.66,11914.00,0.00
2024-12-10 17:42:23,88,9272,38,50,6661.10,11914.01,0.00
2024-12-10 17:42:23,88,9273,38,50,6626.86,11915.00,0.00
2024-12-10 17:42:23,89,9273,39,50,6552.41,11915.01,0.00
2024-12-10 17:42:23,89,9274,39,50,6503.12,11916.00,0.00
2024-12-10 17:42:23,90,9274,40,50,6430.87,11916.01,0.00
2024-12-10 17:42:23,89,9274,39,50,6423.25,11916.36,0.00
2024-12-10 17:42:23,89,9275,39,50,6433.93,11917.00,0.00
2024-12-10 17:42:23,90,9275,39,51,6362.44,11917.01,0.00
2024-12-10 17:42:23,89,9275,39,50,6411.18,11917.08,0.00
2024-12-10 17:42:23,88,9275,39,49,6455.98,11917.25,0.00
2024-12-10 17:42:23,88,9276,39,49,6441.22,11918.00,0.00
2024-12-10 17:42:23,89,9276,39,50,6368.84,11918.01,0.00
2024-12-10 17:42:23,88,9276,39,49,6403.31,11918.09,0.00
2024-12-10 17:42:23,87,9276,38,49,6389.44,11918.75,0.00
2024-12-10 17:42:23,87,9277,38,49,6496.49,11919.00,0.00
2024-12-10 17:42:23,88,9277,39,49,6422.66,11919.01,0.00
2024-12-10 17:42:23,87,9277,38,49,6419.79,11919.14,0.00
2024-12-10 17:42:23,87,9278,38,49,6446.85,11920.00,0.00
2024-12-10 17:42:23,88,9278,39,49,6373.59,11920.01,0.00
2024-12-10 17:42:23,87,9278,39,48,6434.55,11920.10,0.00
2024-12-10 17:42:23,87,9279,39,48,6400.63,11921.00,0.00
2024-12-10 17:42:23,88,9279,39,49,6327.90,11921.01,0.00
2024-12-10 17:42:23,87,9279,39,48,6293.15,11921.22,0.00
2024-12-10 17:42:23,87,9280,39,48,6337.48,11922.00,0.00
2024-12-10 17:42:23,88,9280,40,48,6265.46,11922.01,0.00
2024-12-10 17:42:23,87,9280,39,48,6311.45,11922.07,0.00
2024-12-10 17:42:23,86,9280,39,47,6379.30,11922.09,0.00
2024-12-10 17:42:23,86,9281,39,47,6409.18,11923.00,0.00
2024-12-10 17:42:23,87,9281,40,47,6335.52,11923.01,0.00
2024-12-10 17:42:23,86,9281,40,46,6371.77,11923.09,0.00
2024-12-10 17:42:23,86,9282,40,46,6346.02,11924.00,0.00
2024-12-10 17:42:23,87,9282,40,47,6273.08,11924.01,0.00
2024-12-10 17:42:23,86,9282,39,47,6343.25,11924.02,0.00
2024-12-10 17:42:23,86,9283,39,47,6318.42,11925.00,0.00
2024-12-10 17:42:23,87,9283,39,48,6245.80,11925.01,0.00
2024-12-10 17:42:23,86,9283,38,48,6315.65,11925.02,0.00
2024-12-10 17:42:23,86,9284,38,48,6280.16,11926.00,0.00
2024-12-10 17:42:23,87,9284,39,48,6207.98,11926.01,0.00
2024-12-10 17:42:23,87,9285,39,48,6150.03,11927.00,0.00
2024-12-10 17:42:23,88,9285,40,48,6080.15,11927.01,0.00
2024-12-10 17:42:23,87,9285,40,47,6129.47,11927.05,0.00
2024-12-10 17:42:23,86,9285,39,47,6115.51,11927.73,0.00
2024-12-10 17:42:23,86,9286,39,47,6167.02,11928.00,0.00
2024-12-10 17:42:23,87,9286,40,47,6096.14,11928.01,0.00
2024-12-10 17:42:23,86,9286,40,46,6149.00,11928.05,0.00
2024-12-10 17:42:24,86,9287,40,46,6115.61,11929.00,0.00
2024-12-10 17:42:24,87,9287,41,46,6045.32,11929.01,0.00
2024-12-10 17:42:24,86,9287,40,46,6112.84,11929.02,0.00
2024-12-10 17:42:24,85,9287,40,45,6176.28,11929.04,0.00
2024-12-10 17:42:24,86,9286,41,45,6101.28,11929.08,0.00
2024-12-10 17:42:24,85,9286,40,45,6243.08,11929.19,0.00
2024-12-10 17:42:24,84,9286,39,45,6259.28,11929.46,0.00
2024-12-10 17:42:24,84,9287,39,45,6337.76,11930.00,0.00
2024-12-10 17:42:24,85,9287,40,45,6263.20,11930.01,0.00
2024-12-10 17:42:24,84,9287,40,44,6334.92,11930.02,0.00
2024-12-10 17:42:24,83,9287,39,44,6339.57,11930.08,0.00
2024-12-10 17:42:24,83,9288,39,44,6513.39,11931.00,0.00
2024-12-10 17:42:24,84,9288,40,44,6435.85,11931.01,0.00
2024-12-10 17:42:24,83,9288,40,43,6489.21,11931.02,0.00
2024-12-10 17:42:24,83,9289,40,43,6439.54,11932.00,0.00
2024-12-10 17:42:24,84,9289,41,43,6362.88,11932.01,0.00
2024-12-10 17:42:24,83,9289,41,42,6353.30,11932.05,0.00
2024-12-10 17:42:24,83,9290,41,42,6355.91,11933.00,0.00
2024-12-10 17:42:24,84,9290,41,43,6280.24,11933.01,0.00
2024-12-10 17:42:24,83,9290,41,42,6325.73,11933.05,0.00
2024-12-10 17:42:24,83,9291,41,42,6281.93,11934.00,0.00
2024-12-10 17:42:24,84,9291,41,43,6207.15,11934.01,0.00
2024-12-10 17:42:24,83,9291,40,43,6280.49,11934.01,0.00
2024-12-10 17:42:24,82,9291,40,42,6323.62,11934.04,0.00
2024-12-10 17:42:24,81,9291,39,42,6358.98,11934.33,0.00
2024-12-10 17:42:24,81,9292,39,42,6358.13,11935.00,0.00
2024-12-10 17:42:24,82,9292,40,42,6280.59,11935.01,0.00
2024-12-10 17:42:24,81,9292,39,42,6347.00,11935.04,0.00
2024-12-10 17:42:24,82,9291,39,43,6269.60,11935.06,0.00
2024-12-10 17:42:24,81,9291,38,43,6420.62,11935.20,0.00
2024-12-10 17:42:24,81,9292,38,43,6460.62,11936.00,0.00
2024-12-10 17:42:24,82,9292,38,44,6381.83,11936.01,0.00
2024-12-10 17:42:24,82,9293,38,44,6500.75,11937.00,0.00
2024-12-10 17:42:24,83,9293,39,44,6422.43,11937.01,0.00
2024-12-10 17:42:24,82,9293,38,44,6446.97,11937.22,0.00
2024-12-10 17:42:24,83,9292,39,44,6364.99,11937.28,0.00
2024-12-10 17:42:24,82,9292,38,44,6535.59,11937.33,0.00
2024-12-10 17:42:24,82,9293,38,44,6584.64,11938.00,0.00
2024-12-10 17:42:24,83,9293,39,44,6505.30,11938.01,0.00
2024-12-10 17:42:24,82,9293,39,43,6544.63,11938.10,0.00
2024-12-10 17:42:24,81,9293,38,43,6612.21,11938.21,0.00
2024-12-10 17:42:24,81,9294,38,43,6785.75,11939.00,0.00
2024-12-10 17:42:24,82,9294,39,43,6703.00,11939.01,0.00
2024-12-10 17:42:24,82,9295,39,43,6650.32,11940.00,0.00
2024-12-10 17:42:24,83,9295,39,44,6570.20,11940.01,0.00
2024-12-10 17:42:24,82,9295,39,43,6624.12,11940.04,0.00
2024-12-10 17:42:24,82,9296,39,43,6597.00,11941.00,0.00
2024-12-10 17:42:24,83,9296,39,44,6517.51,11941.01,0.00
2024-12-10 17:42:24,82,9296,38,44,6501.96,11941.38,0.00
2024-12-10 17:42:24,82,9297,38,44,6573.72,11942.00,0.00
2024-12-10 17:42:24,83,9297,39,44,6494.52,11942.01,0.00
2024-12-10 17:42:24,84,9296,39,45,6274.10,11942.54,0.00
2024-12-10 17:42:24,84,9297,39,45,6409.48,11943.00,0.00
2024-12-10 17:42:24,85,9297,39,46,6334.07,11943.01,0.00
2024-12-10 17:42:24,84,9297,39,45,6387.35,11943.05,0.00
2024-12-10 17:42:24,84,9298,39,45,6489.44,11944.00,0.00
2024-12-10 17:42:24,85,9298,39,46,6413.10,11944.01,0.00
2024-12-10 17:42:24,84,9298,38,46,6377.19,11944.24,0.00
2024-12-10 17:42:24,85,9297,39,46,6294.61,11944.31,0.00
2024-12-10 17:42:24,85,9298,39,46,6407.68,11945.00,0.00
2024-12-10 17:42:24,86,9298,40,46,6333.17,11945.01,0.00
2024-12-10 17:42:24,87,9297,41,46,6260.38,11945.03,0.00
2024-12-10 17:42:24,86,9297,41,45,6441.53,11945.06,0.00
2024-12-10 17:42:24,87,9296,42,45,6325.85,11945.41,0.00
2024-12-10 17:42:24,87,9297,42,45,6560.18,11946.00,0.00
2024-12-10 17:42:24,88,9297,43,45,6485.63,11946.01,0.00
2024-12-10 17:42:24,87,9297,42,45,6355.81,11946.70,0.00
2024-12-10 17:42:24,87,9298,42,45,6703.71,11947.00,0.00
2024-12-10 17:42:24,88,9298,43,45,6627.54,11947.01,0.00
2024-12-10 17:42:24,87,9298,43,44,6694.12,11947.06,0.00
2024-12-10 17:42:24,87,9299,43,44,6601.04,11948.00,0.00
2024-12-10 17:42:24,88,9299,44,44,6526.03,11948.01,0.00
2024-12-10 17:42:24,87,9299,44,43,6496.03,11948.37,0.00
2024-12-10 17:42:24,87,9300,44,43,6488.45,11949.00,0.00
2024-12-10 17:42:24,88,9300,44,44,6414.72,11949.01,0.00
2024-12-10 17:42:24,87,9300,44,43,6480.23,11949.06,0.00
2024-12-10 17:42:24,86,9300,43,43,6442.05,11949.60,0.00
2024-12-10 17:42:24,86,9301,43,43,6526.64,11950.00,0.00
2024-12-10 17:42:24,87,9301,44,43,6451.62,11950.01,0.00
2024-12-10 17:42:24,86,9301,43,43,6436.37,11950.17,0.00
2024-12-10 17:42:24,86,9302,43,43,6469.73,11951.00,0.00
2024-12-10 17:42:24,87,9302,43,44,6395.36,11951.01,0.00
2024-12-10 17:42:24,86,9302,43,43,6455.86,11951.09,0.00
2024-12-10 17:42:24,86,9303,43,43,6425.79,11952.00,0.00
2024-12-10 17:42:24,87,9303,43,44,6351.93,11952.01,0.00
2024-12-10 17:42:24,86,9303,42,44,6228.53,11952.93,0.00
2024-12-10 17:42:24,86,9304,42,44,6359.22,11953.00,0.00
2024-12-10 17:42:24,87,9304,42,45,6286.13,11953.01,0.00
2024-12-10 17:42:24,86,9304,41,45,6280.15,11953.13,0.00
2024-12-10 17:42:24,85,9304,40,45,6336.73,11953.25,0.00
2024-12-10 17:42:24,85,9305,40,45,6384.60,11954.00,0.00
2024-12-10 17:42:24,86,9305,41,45,6310.36,11954.01,0.00
2024-12-10 17:42:24,85,9305,41,44,6369.90,11954.09,0.00
2024-12-10 17:42:24,84,9305,41,43,6441.47,11954.11,0.00
2024-12-10 17:42:24,83,9305,40,43,6455.06,11954.58,0.00
2024-12-10 17:42:24,83,9306,40,43,6546.16,11955.00,0.00
2024-12-10 17:42:24,84,9306,41,43,6468.23,11955.01,0.00
2024-12-10 17:42:24,83,9306,41,42,6513.12,11955.07,0.00
2024-12-10 17:42:24,82,9306,40,42,6559.75,11955.13,0.00
2024-12-10 17:42:25,82,9307,40,42,6601.01,11956.00,0.00
2024-12-10 17:42:25,83,9307,40,43,6521.48,11956.01,0.00
2024-12-10 17:42:25,82,9307,39,43,6514.96,11956.12,0.00
2024-12-10 17:42:25,82,9308,39,43,6555.52,11957.00,0.00
2024-12-10 17:42:25,83,9308,39,44,6476.54,11957.01,0.00
2024-12-10 17:42:25,82,9308,39,43,6538.53,11957.10,0.00
2024-12-10 17:42:25,82,9308,39,43,6516.03,11958.00,0.00
2024-12-10 17:42:25,83,9308,39,44,6437.52,11958.01,0.00
2024-12-10 17:42:25,83,9309,39,44,6374.60,11959.00,0.00
2024-12-10 17:42:25,84,9309,39,45,6298.71,11959.01,0.00
2024-12-10 17:42:25,83,9309,39,44,6353.92,11959.11,0.00
2024-12-10 17:42:25,82,9309,38,44,6375.15,11959.39,0.00
2024-12-10 17:42:25,82,9310,38,44,6444.01,11960.00,0.00
2024-12-10 17:42:25,83,9310,39,44,6366.37,11960.01,0.00
2024-12-10 17:42:25,83,9311,39,44,6342.47,11961.00,0.00
2024-12-10 17:42:25,84,9311,40,44,6266.96,11961.01,0.00
2024-12-10 17:42:25,85,9310,40,45,6183.40,11961.12,0.00
2024-12-10 17:42:25,85,9311,40,45,6193.29,11962.00,0.00
2024-12-10 17:42:25,86,9311,41,45,6121.27,11962.01,0.00
2024-12-10 17:42:25,85,9311,40,45,6189.08,11962.04,0.00
2024-12-10 17:42:25,85,9312,40,45,6282.05,11963.00,0.00
2024-12-10 17:42:25,86,9312,40,46,6209.00,11963.01,0.00
2024-12-10 17:42:25,86,9313,40,46,6138.52,11964.00,0.00
2024-12-10 17:42:25,87,9313,40,47,6067.96,11964.01,0.00
2024-12-10 17:42:25,86,9313,40,46,6124.64,11964.12,0.00
2024-12-10 17:42:25,85,9313,39,46,6176.50,11964.24,0.00
2024-12-10 17:42:25,84,9313,38,46,6117.45,11964.96,0.00
2024-12-10 17:42:25,84,9314,38,46,6255.65,11965.00,0.00
2024-12-10 17:42:25,85,9314,39,46,6182.05,11965.01,0.00
2024-12-10 17:42:25,85,9315,39,46,6125.16,11966.00,0.00
2024-12-10 17:42:25,86,9315,40,46,6053.94,11966.01,0.00
2024-12-10 17:42:25,85,9315,40,45,6092.82,11966.15,0.00
2024-12-10 17:42:25,85,9316,40,45,6074.26,11967.00,0.00
2024-12-10 17:42:25,86,9316,40,46,6003.63,11967.01,0.00
2024-12-10 17:42:25,85,9316,39,46,5980.06,11967.41,0.00
2024-12-10 17:42:25,85,9317,39,46,6050.84,11968.00,0.00
2024-12-10 17:42:25,86,9317,40,46,5980.48,11968.01,0.00
2024-12-10 17:42:25,85,9317,40,45,6046.62,11968.04,0.00
2024-12-10 17:42:25,84,9317,40,44,6090.14,11968.15,0.00
2024-12-10 17:42:25,83,9317,39,44,6160.03,11968.18,0.00
2024-12-10 17:42:25,82,9317,38,44,6187.07,11968.40,0.00
2024-12-10 17:42:25,82,9318,38,44,6261.90,11969.00,0.00
2024-12-10 17:42:25,83,9318,38,45,6186.46,11969.01,0.00
2024-12-10 17:42:25,82,9318,37,45,6107.42,11969.65,0.00
2024-12-10 17:42:25,82,9319,37,45,6211.33,11970.00,0.00
2024-12-10 17:42:25,83,9319,37,46,6136.50,11970.01,0.00
2024-12-10 17:42:25,83,9320,37,46,6085.16,11971.00,0.00
2024-12-10 17:42:25,84,9320,37,47,6012.72,11971.01,0.00
2024-12-10 17:42:25,83,9320,37,46,6081.01,11971.04,0.00
2024-12-10 17:42:25,82,9320,37,45,6126.00,11971.16,0.00
2024-12-10 17:42:25,81,9320,36,45,6132.86,11971.70,0.00
2024-12-10 17:42:25,80,9320,35,45,6205.06,11971.75,0.00
2024-12-10 17:42:25,80,9321,35,45,6324.99,11972.00,0.00
2024-12-10 17:42:25,81,9321,36,45,6246.90,11972.01,0.00
2024-12-10 17:42:25,80,9321,35,45,6265.20,11972.26,0.00
2024-12-10 17:42:25,79,9321,34,45,6342.99,11972.27,0.00
2024-12-10 17:42:25,79,9322,34,45,6349.63,11973.00,0.00
2024-12-10 17:42:25,80,9322,34,46,6270.26,11973.01,0.00
2024-12-10 17:42:25,79,9322,34,45,6333.32,11973.14,0.00
2024-12-10 17:42:25,78,9322,34,44,6397.64,11973.15,0.00
2024-12-10 17:42:25,79,9321,34,45,6237.09,11973.72,0.00
2024-12-10 17:42:25,79,9322,34,45,6329.78,11974.00,0.00
2024-12-10 17:42:25,80,9322,34,46,6250.66,11974.01,0.00
2024-12-10 17:42:25,79,9322,33,46,6247.78,11974.42,0.00
2024-12-10 17:42:25,79,9323,33,46,6406.50,11975.00,0.00
2024-12-10 17:42:25,80,9323,33,47,6326.42,11975.01,0.00
2024-12-10 17:42:25,79,9323,33,46,6400.45,11975.05,0.00
2024-12-10 17:42:25,78,9323,32,46,6473.38,11975.12,0.00
2024-12-10 17:42:25,77,9323,32,45,6540.34,11975.13,0.00
2024-12-10 17:42:25,76,9323,31,45,6546.48,11975.64,0.00
2024-12-10 17:42:25,76,9324,31,45,6637.32,11976.00,0.00
2024-12-10 17:42:25,77,9324,32,45,6551.12,11976.01,0.00
2024-12-10 17:42:25,76,9324,31,45,6502.86,11976.51,0.00
2024-12-10 17:42:25,76,9325,31,45,6584.37,11977.00,0.00
2024-12-10 17:42:25,77,9325,32,45,6498.86,11977.01,0.00
2024-12-10 17:42:25,76,9325,32,44,6556.03,11977.13,0.00
2024-12-10 17:42:25,75,9325,31,44,6629.11,11977.25,0.00
2024-12-10 17:42:25,75,9326,31,44,6624.95,11978.00,0.00
2024-12-10 17:42:25,76,9326,32,44,6537.78,11978.01,0.00
2024-12-10 17:42:25,75,9326,32,43,6610.61,11978.12,0.00
2024-12-10 17:42:25,74,9326,31,43,6612.62,11978.38,0.00
2024-12-10 17:42:25,74,9327,31,43,6698.05,11979.00,0.00
2024-12-10 17:42:25,75,9327,31,44,6608.75,11979.01,0.00
2024-12-10 17:42:25,74,9327,31,43,6665.72,11979.15,0.00
2024-12-10 17:42:25,74,9328,31,43,6661.38,11980.00,0.00
2024-12-10 17:42:25,75,9328,32,43,6572.56,11980.01,0.00
2024-12-10 17:42:25,74,9328,32,42,6643.14,11980.04,0.00
2024-12-10 17:42:25,73,9328,31,42,6713.41,11980.21,0.00
2024-12-10 17:42:25,73,9329,31,42,6717.20,11981.00,0.00
2024-12-10 17:42:25,74,9329,31,43,6626.42,11981.01,0.00
2024-12-10 17:42:25,75,9328,32,43,6534.89,11981.07,0.00
2024-12-10 17:42:25,74,9328,31,43,6550.83,11981.65,0.00
2024-12-10 17:42:25,73,9328,30,43,6617.68,11981.78,0.00
2024-12-10 17:42:25,73,9329,30,43,6755.73,11982.00,0.00
2024-12-10 17:42:26,74,9329,31,43,6664.44,11982.01,0.00
2024-12-10 17:42:26,73,9329,31,42,6719.67,11982.16,0.00
2024-12-10 17:42:26,73,9330,31,42,6882.69,11983.00,0.00
2024-12-10 17:42:26,74,9330,32,42,6789.68,11983.01,0.00
2024-12-10 17:42:26,73,9330,32,41,6861.37,11983.08,0.00
2024-12-10 17:42:26,73,9331,32,41,6850.43,11984.00,0.00
2024-12-10 17:42:26,74,9331,32,42,6757.86,11984.01,0.00
2024-12-10 17:42:26,74,9332,32,42,6706.69,11985.00,0.00
2024-12-10 17:42:26,75,9332,33,42,6617.27,11985.01,0.00
2024-12-10 17:42:26,74,9332,33,41,6611.17,11985.15,0.00
2024-12-10 17:42:26,74,9333,33,41,6671.62,11986.00,0.00
2024-12-10 17:42:26,75,9333,34,41,6582.66,11986.01,0.00
2024-12-10 17:42:26,75,9334,34,41,6539.43,11987.00,0.00
2024-12-10 17:42:26,76,9334,35,41,6453.38,11987.01,0.00
2024-12-10 17:42:26,75,9334,35,40,6533.72,11987.05,0.00
2024-12-10 17:42:26,74,9334,35,39,6583.16,11987.18,0.00
2024-12-10 17:42:26,74,9335,35,39,6582.06,11988.00,0.00
2024-12-10 17:42:26,75,9335,35,40,6494.30,11988.01,0.00
2024-12-10 17:42:26,74,9335,35,39,6575.59,11988.05,0.00
2024-12-10 17:42:26,74,9336,35,39,6539.98,11989.00,0.00
2024-12-10 17:42:26,75,9336,35,40,6452.78,11989.01,0.00
2024-12-10 17:42:26,74,9336,35,39,6496.27,11989.16,0.00
2024-12-10 17:42:26,73,9336,34,39,6577.06,11989.22,0.00
2024-12-10 17:42:26,74,9335,35,39,6484.96,11989.27,0.00
2024-12-10 17:42:26,73,9335,34,39,6630.93,11989.53,0.00
2024-12-10 17:42:26,73,9336,34,39,6739.68,11990.00,0.00
2024-12-10 17:42:26,74,9336,34,40,6648.60,11990.01,0.00
2024-12-10 17:42:26,73,9336,33,40,6738.05,11990.03,0.00
2024-12-10 17:42:26,73,9337,33,40,6862.37,11991.00,0.00
2024-12-10 17:42:26,74,9337,34,40,6769.64,11991.01,0.00
2024-12-10 17:42:26,73,9337,34,39,6857.45,11991.04,0.00
2024-12-10 17:42:26,72,9337,34,38,6916.08,11991.14,0.00
2024-12-10 17:42:26,73,9336,35,38,6790.24,11991.42,0.00
2024-12-10 17:42:26,72,9336,34,38,6918.95,11991.43,0.00
2024-12-10 17:42:26,73,9335,34,39,6804.56,11991.62,0.00
2024-12-10 17:42:26,73,9336,34,39,6965.86,11992.00,0.00
2024-12-10 17:42:26,74,9336,35,39,6871.73,11992.01,0.00
2024-12-10 17:42:26,74,9337,35,39,7158.62,11993.00,0.00
2024-12-10 17:42:26,75,9337,35,40,7063.17,11993.01,0.00
2024-12-10 17:42:26,74,9337,34,40,7147.93,11993.09,0.00
2024-12-10 17:42:26,73,9337,34,39,7201.52,11993.18,0.00
2024-12-10 17:42:26,73,9338,34,39,7202.07,11994.00,0.00
2024-12-10 17:42:26,74,9338,34,40,7104.75,11994.01,0.00
2024-12-10 17:42:26,74,9339,34,40,7102.51,11995.00,0.00
2024-12-10 17:42:26,75,9339,34,41,7007.81,11995.01,0.00
2024-12-10 17:42:26,75,9340,34,41,6996.72,11996.00,0.00
2024-12-10 17:42:26,76,9340,34,42,6904.66,11996.01,0.00
2024-12-10 17:42:26,76,9341,34,42,6873.91,11997.00,0.00
2024-12-10 17:42:26,77,9341,34,43,6784.64,11997.01,0.00
2024-12-10 17:42:26,77,9342,34,43,6724.57,11998.00,0.00
2024-12-10 17:42:26,78,9342,35,43,6638.36,11998.01,0.00
2024-12-10 17:42:26,77,9342,35,42,6705.88,11998.04,0.00
2024-12-10 17:42:26,76,9342,34,42,6738.31,11998.21,0.00
2024-12-10 17:42:26,76,9343,34,42,6773.22,11999.00,0.00
2024-12-10 17:42:26,77,9343,34,43,6685.25,11999.01,0.00
2024-12-10 17:42:26,76,9343,34,42,6738.51,11999.16,0.00
2024-12-10 17:42:26,77,9342,35,42,6632.36,11999.34,0.00
2024-12-10 17:42:26,76,9342,34,42,6675.80,11999.68,0.00
2024-12-10 17:42:26,75,9342,33,42,6708.74,11999.85,0.00
2024-12-10 17:42:26,75,9343,33,42,6851.26,12000.00,0.00
2024-12-10 17:42:26,76,9343,34,42,6761.11,12000.01,0.00
2024-12-10 17:42:26,77,9342,35,42,6671.75,12000.05,0.00
2024-12-10 17:42:26,76,9342,34,42,6860.55,12000.22,0.00
2024-12-10 17:42:26,76,9343,34,42,6980.91,12001.00,0.00
2024-12-10 17:42:26,77,9343,35,42,6890.25,12001.01,0.00
2024-12-10 17:42:26,76,9343,35,41,6938.32,12001.17,0.00
2024-12-10 17:42:26,76,9344,35,41,7032.13,12002.00,0.00
2024-12-10 17:42:26,77,9344,35,42,6940.80,12002.01,0.00
2024-12-10 17:42:26,76,9344,35,41,6932.73,12002.39,0.00
2024-12-10 17:42:26,75,9344,34,41,6963.74,12002.69,0.00
2024-12-10 17:42:26,75,9345,34,41,7030.38,12003.00,0.00
2024-12-10 17:42:26,76,9345,34,42,6937.88,12003.01,0.00
2024-12-10 17:42:26,75,9345,34,41,6988.82,12003.17,0.00
2024-12-10 17:42:26,74,9345,33,41,7031.49,12003.61,0.00
2024-12-10 17:42:26,73,9345,32,41,7050.02,12003.96,0.00
2024-12-10 17:42:26,73,9346,32,41,7209.55,12004.00,0.00
2024-12-10 17:42:26,74,9346,33,41,7112.13,12004.01,0.00
2024-12-10 17:42:26,74,9347,33,41,7039.94,12005.00,0.00
2024-12-10 17:42:26,75,9347,33,42,6946.07,12005.01,0.00
2024-12-10 17:42:26,74,9347,33,41,6992.93,12005.19,0.00
2024-12-10 17:42:26,73,9347,33,40,7053.08,12005.32,0.00
2024-12-10 17:42:26,73,9348,33,40,7070.01,12006.00,0.00
2024-12-10 17:42:26,74,9348,34,40,6974.47,12006.01,0.00
2024-12-10 17:42:26,73,9348,33,40,6938.18,12006.37,0.00
2024-12-10 17:42:26,73,9349,33,40,7025.29,12007.00,0.00
2024-12-10 17:42:26,74,9349,33,41,6930.35,12007.01,0.00
2024-12-10 17:42:26,74,9350,33,41,6883.44,12008.00,0.00
2024-12-10 17:42:26,75,9350,34,41,6791.66,12008.01,0.00
2024-12-10 17:42:26,74,9350,34,40,6833.18,12008.22,0.00
2024-12-10 17:42:26,73,9350,33,40,6816.33,12008.59,0.00
2024-12-10 17:42:26,73,9351,33,40,6931.81,12009.00,0.00
2024-12-10 17:42:26,74,9351,34,40,6838.14,12009.01,0.00
2024-12-10 17:42:26,73,9351,33,40,6925.25,12009.05,0.00
2024-12-10 17:42:26,72,9351,33,39,7001.42,12009.08,0.00
2024-12-10 17:42:26,72,9352,33,39,6984.62,12010.00,0.00
2024-12-10 17:42:26,73,9352,34,39,6888.94,12010.01,0.00
2024-12-10 17:42:26,72,9352,33,39,6977.97,12010.06,0.00
2024-12-10 17:42:26,71,9352,33,38,7035.68,12010.18,0.00
2024-12-10 17:42:26,72,9351,34,38,6911.38,12010.43,0.00
2024-12-10 17:42:26,72,9352,34,38,6995.34,12011.00,0.00
2024-12-10 17:42:26,73,9352,34,39,6899.51,12011.01,0.00
2024-12-10 17:42:26,73,9353,34,39,7029.37,12012.00,0.00
2024-12-10 17:42:26,74,9353,35,39,6934.38,12012.01,0.00
2024-12-10 17:42:26,73,9353,34,39,7007.06,12012.19,0.00
2024-12-10 17:42:26,73,9354,34,39,6969.36,12013.00,0.00
2024-12-10 17:42:27,74,9354,34,40,6875.18,12013.01,0.00
2024-12-10 17:42:27,73,9354,34,39,6911.82,12013.21,0.00
2024-12-10 17:42:27,73,9355,34,39,6894.99,12014.00,0.00
2024-12-10 17:42:27,74,9355,34,40,6801.81,12014.01,0.00
2024-12-10 17:42:27,75,9354,34,41,6706.33,12014.08,0.00
2024-12-10 17:42:27,74,9354,34,40,6854.85,12014.50,0.00
2024-12-10 17:42:27,74,9355,34,40,6903.90,12015.00,0.00
2024-12-10 17:42:27,75,9355,34,41,6811.84,12015.01,0.00
2024-12-10 17:42:27,74,9355,34,40,6853.62,12015.20,0.00
2024-12-10 17:42:27,73,9355,33,40,6836.37,12015.86,0.00
2024-12-10 17:42:27,73,9356,33,40,7149.21,12016.00,0.00
2024-12-10 17:42:27,74,9356,33,41,7052.60,12016.01,0.00
2024-12-10 17:42:27,75,9355,34,41,6849.92,12016.68,0.00
2024-12-10 17:42:27,75,9356,34,41,6949.69,12017.00,0.00
2024-12-10 17:42:27,76,9356,35,41,6858.25,12017.01,0.00
2024-12-10 17:42:27,75,9356,35,40,6900.08,12017.20,0.00
2024-12-10 17:42:27,74,9356,34,40,6866.11,12017.92,0.00
2024-12-10 17:42:27,74,9357,34,40,7177.49,12018.00,0.00
2024-12-10 17:42:27,75,9357,35,40,7081.79,12018.01,0.00
2024-12-10 17:42:27,74,9357,34,40,7163.62,12018.12,0.00
2024-12-10 17:42:27,74,9358,34,40,7121.85,12019.00,0.00
2024-12-10 17:42:27,75,9358,35,40,7026.90,12019.01,0.00
2024-12-10 17:42:27,74,9358,35,39,7071.56,12019.19,0.00
2024-12-10 17:42:27,74,9359,35,39,7057.63,12020.00,0.00
2024-12-10 17:42:27,75,9359,36,39,6963.52,12020.01,0.00
2024-12-10 17:42:27,74,9359,35,39,7040.58,12020.11,0.00
2024-12-10 17:42:27,74,9360,35,39,7047.32,12021.00,0.00
2024-12-10 17:42:27,75,9360,36,39,6953.35,12021.01,0.00
2024-12-10 17:42:27,74,9360,36,38,7000.26,12021.18,0.00
2024-12-10 17:42:27,73,9360,35,38,7084.43,12021.27,0.00
2024-12-10 17:42:27,73,9361,35,38,7077.35,12022.00,0.00
2024-12-10 17:42:27,74,9361,35,39,6981.71,12022.01,0.00
2024-12-10 17:42:27,73,9361,34,39,7039.50,12022.11,0.00
2024-12-10 17:42:27,73,9362,34,39,7043.19,12023.00,0.00
2024-12-10 17:42:27,74,9362,35,39,6948.01,12023.01,0.00
2024-12-10 17:42:27,73,9362,34,39,7007.71,12023.14,0.00
2024-12-10 17:42:27,73,9363,34,39,7012.97,12024.00,0.00
2024-12-10 17:42:27,74,9363,34,40,6918.20,12024.01,0.00
2024-12-10 17:42:27,73,9363,33,40,7002.80,12024.10,0.00
2024-12-10 17:42:27,72,9363,33,39,7056.67,12024.18,0.00
2024-12-10 17:42:27,72,9364,33,39,7033.17,12025.00,0.00
2024-12-10 17:42:27,73,9364,34,39,6936.83,12025.01,0.00
2024-12-10 17:42:27,73,9365,34,39,6899.45,12026.00,0.00
2024-12-10 17:42:27,74,9365,34,40,6806.21,12026.01,0.00
2024-12-10 17:42:27,73,9365,33,40,6843.49,12026.19,0.00
2024-12-10 17:42:27,72,9365,33,39,6883.24,12026.53,0.00
2024-12-10 17:42:27,72,9366,33,39,6936.83,12027.00,0.00
2024-12-10 17:42:27,73,9366,33,40,6841.80,12027.01,0.00
2024-12-10 17:42:27,72,9366,32,40,6928.50,12027.07,0.00
2024-12-10 17:42:27,72,9367,32,40,6871.43,12028.00,0.00
2024-12-10 17:42:27,73,9367,32,41,6777.30,12028.01,0.00
2024-12-10 17:42:27,72,9367,31,41,6863.10,12028.07,0.00
2024-12-10 17:42:27,71,9367,31,40,6942.85,12028.16,0.00
2024-12-10 17:42:27,70,9367,30,40,6881.06,12028.97,0.00
2024-12-10 17:42:27,70,9368,30,40,7049.48,12029.00,0.00
2024-12-10 17:42:27,71,9368,31,40,6950.19,12029.01,0.00
2024-12-10 17:42:27,71,9369,31,40,6898.72,12030.00,0.00
2024-12-10 17:42:27,72,9369,31,41,6802.90,12030.01,0.00
2024-12-10 17:42:27,73,9368,32,41,6696.57,12030.15,0.00
2024-12-10 17:42:27,72,9368,32,40,6904.88,12030.17,0.00
2024-12-10 17:42:27,73,9367,32,41,6800.45,12030.27,0.00
2024-12-10 17:42:27,72,9367,31,41,6975.01,12030.83,0.00
2024-12-10 17:42:27,72,9368,31,41,7055.33,12031.00,0.00
2024-12-10 17:42:27,73,9368,31,42,6958.69,12031.01,0.00
2024-12-10 17:42:27,73,9369,31,42,7289.35,12032.00,0.00
2024-12-10 17:42:27,74,9369,31,43,7190.85,12032.01,0.00
2024-12-10 17:42:27,74,9370,31,43,7184.36,12033.00,0.00
2024-12-10 17:42:27,75,9370,32,43,7088.57,12033.01,0.00
2024-12-10 17:42:27,75,9371,32,43,7065.53,12034.00,0.00
2024-12-10 17:42:27,76,9371,32,44,6972.57,12034.01,0.00
2024-12-10 17:42:27,77,9370,32,45,6802.48,12034.44,0.00
2024-12-10 17:42:27,77,9371,32,45,6900.65,12035.00,0.00
2024-12-10 17:42:27,78,9371,32,46,6812.18,12035.01,0.00
2024-12-10 17:42:27,77,9371,32,45,6863.17,12035.12,0.00
2024-12-10 17:42:27,77,9372,32,45,7007.51,12036.00,0.00
2024-12-10 17:42:27,78,9372,32,46,6917.67,12036.01,0.00
2024-12-10 17:42:27,78,9373,32,46,6902.86,12037.00,0.00
2024-12-10 17:42:27,79,9373,33,46,6815.48,12037.01,0.00
2024-12-10 17:42:27,78,9373,33,45,6890.52,12037.04,0.00
2024-12-10 17:42:27,79,9372,34,45,6741.39,12037.56,0.00
2024-12-10 17:42:27,79,9373,34,45,6830.09,12038.00,0.00
2024-12-10 17:42:27,80,9373,35,45,6744.71,12038.01,0.00
2024-12-10 17:42:27,79,9373,35,44,6823.57,12038.05,0.00
2024-12-10 17:42:27,80,9372,35,45,6733.77,12038.11,0.00
2024-12-10 17:42:27,79,9372,34,45,6817.80,12038.58,0.00
2024-12-10 17:42:27,79,9373,34,45,7072.59,12039.00,0.00
2024-12-10 17:42:27,80,9373,34,46,6984.18,12039.01,0.00
2024-12-10 17:42:27,80,9374,34,46,7078.92,12040.00,0.00
2024-12-10 17:42:27,81,9374,34,47,6991.53,12040.01,0.00
2024-12-10 17:42:27,80,9374,34,46,7051.87,12040.10,0.00
2024-12-10 17:42:27,80,9375,34,46,7034.36,12041.00,0.00
2024-12-10 17:42:27,81,9375,35,46,6947.51,12041.01,0.00
2024-12-10 17:42:27,80,9375,34,46,6927.56,12041.19,0.00
2024-12-10 17:42:27,80,9376,34,46,6980.75,12042.00,0.00
2024-12-10 17:42:27,81,9376,35,46,6894.57,12042.01,0.00
2024-12-10 17:42:27,80,9376,35,45,6974.75,12042.05,0.00
2024-12-10 17:42:27,79,9376,35,44,7041.72,12042.10,0.00
2024-12-10 17:42:27,79,9377,35,44,7025.49,12043.00,0.00
2024-12-10 17:42:27,80,9377,36,44,6937.67,12043.01,0.00
2024-12-10 17:42:27,81,9376,37,44,6780.81,12043.38,0.00
2024-12-10 17:42:27,82,9375,37,45,6762.76,12043.43,0.00
2024-12-10 17:42:27,81,9375,36,45,6884.19,12043.64,0.00
2024-12-10 17:42:28,81,9376,36,45,6930.54,12044.00,0.00
2024-12-10 17:42:28,82,9376,37,45,6846.02,12044.01,0.00
2024-12-10 17:42:28,81,9376,37,44,6911.25,12044.09,0.00
2024-12-10 17:42:28,81,9377,37,44,7188.38,12045.00,0.00
2024-12-10 17:42:28,82,9377,37,45,7100.71,12045.01,0.00
2024-12-10 17:42:28,81,9377,36,45,7186.89,12045.01,0.00
2024-12-10 17:42:28,81,9378,36,45,7128.00,12046.00,0.00
2024-12-10 17:42:28,82,9378,36,46,7041.07,12046.01,0.00
2024-12-10 17:42:28,81,9378,36,45,7107.22,12046.09,0.00
2024-12-10 17:42:28,80,9378,35,45,7083.39,12046.60,0.00
2024-12-10 17:42:28,80,9379,35,45,7186.07,12047.00,0.00
2024-12-10 17:42:28,81,9379,35,46,7097.36,12047.01,0.00
2024-12-10 17:42:28,80,9379,34,46,7134.95,12047.19,0.00
2024-12-10 17:42:28,79,9379,33,46,7162.74,12047.19,0.00
2024-12-10 17:42:28,79,9380,33,46,7218.16,12048.00,0.00
2024-12-10 17:42:28,80,9380,34,46,7127.94,12048.01,0.00
2024-12-10 17:42:28,79,9380,34,45,7199.90,12048.09,0.00
2024-12-10 17:42:28,79,9380,34,45,7182.16,12049.00,0.00
2024-12-10 17:42:28,80,9380,35,45,7092.38,12049.01,0.00
2024-12-10 17:42:28,80,9381,35,45,7077.86,12050.00,0.00
2024-12-10 17:42:28,81,9381,36,45,6990.48,12050.01,0.00
2024-12-10 17:42:28,81,9382,36,45,6964.14,12051.00,0.00
2024-12-10 17:42:28,82,9382,37,45,6879.21,12051.01,0.00
2024-12-10 17:42:28,81,9382,36,45,6909.17,12051.21,0.00
2024-12-10 17:42:28,81,9383,36,45,6915.51,12052.00,0.00
2024-12-10 17:42:28,82,9383,36,46,6831.18,12052.01,0.00
2024-12-10 17:42:28,81,9383,36,45,6878.35,12052.09,0.00
2024-12-10 17:42:28,81,9384,36,45,6858.05,12053.00,0.00
2024-12-10 17:42:28,82,9384,36,46,6774.42,12053.01,0.00
2024-12-10 17:42:28,81,9384,35,46,6803.07,12053.22,0.00
2024-12-10 17:42:28,81,9385,35,46,6799.09,12054.00,0.00
2024-12-10 17:42:28,82,9385,36,46,6716.18,12054.01,0.00
2024-12-10 17:42:28,81,9385,36,45,6787.22,12054.09,0.00
2024-12-10 17:42:28,80,9385,35,45,6811.92,12054.39,0.00
2024-12-10 17:42:28,80,9386,35,45,6889.18,12055.00,0.00
2024-12-10 17:42:28,81,9386,36,45,6804.12,12055.01,0.00
2024-12-10 17:42:28,81,9387,36,45,6745.15,12056.00,0.00
2024-12-10 17:42:28,82,9387,36,46,6662.89,12056.01,0.00
2024-12-10 17:42:28,81,9387,36,45,6727.32,12056.09,0.00
2024-12-10 17:42:28,81,9388,36,45,6707.01,12057.00,0.00
2024-12-10 17:42:28,82,9388,37,45,6625.22,12057.01,0.00
2024-12-10 17:42:28,81,9388,36,45,6660.90,12057.09,0.00
2024-12-10 17:42:28,82,9387,36,46,6493.14,12057.58,0.00
2024-12-10 17:42:28,81,9387,35,46,6664.81,12057.65,0.00
2024-12-10 17:42:28,81,9388,35,46,6772.24,12058.00,0.00
2024-12-10 17:42:28,82,9388,35,47,6689.65,12058.01,0.00
2024-12-10 17:42:28,81,9388,35,46,6766.31,12058.05,0.00
2024-12-10 17:42:28,80,9388,35,45,6835.83,12058.09,0.00
2024-12-10 17:42:28,80,9389,35,45,6964.93,12059.00,0.00
2024-12-10 17:42:28,81,9389,36,45,6878.94,12059.01,0.00
2024-12-10 17:42:28,81,9390,36,45,6805.34,12060.00,0.00
2024-12-10 17:42:28,82,9390,37,45,6722.34,12060.01,0.00
2024-12-10 17:42:28,81,9390,37,44,6781.55,12060.10,0.00
2024-12-10 17:42:28,80,9390,36,44,6767.84,12060.69,0.00
2024-12-10 17:42:28,80,9391,36,44,6820.83,12061.00,0.00
2024-12-10 17:42:28,81,9391,37,44,6736.62,12061.01,0.00
2024-12-10 17:42:28,80,9391,37,43,6767.37,12061.15,0.00
2024-12-10 17:42:28,80,9392,37,43,6755.82,12062.00,0.00
2024-12-10 17:42:28,81,9392,38,43,6672.41,12062.01,0.00
2024-12-10 17:42:28,80,9392,38,42,6733.23,12062.10,0.00
2024-12-10 17:42:28,79,9392,37,42,6742.45,12062.72,0.00
2024-12-10 17:42:28,79,9393,37,42,6800.67,12063.00,0.00
2024-12-10 17:42:28,80,9393,38,42,6715.66,12063.01,0.00
2024-12-10 17:42:28,80,9394,38,42,6657.41,12064.00,0.00
2024-12-10 17:42:28,81,9394,39,42,6575.22,12064.01,0.00
2024-12-10 17:42:28,80,9394,39,41,6636.33,12064.10,0.00
2024-12-10 17:42:28,80,9395,39,41,6618.75,12065.00,0.00
2024-12-10 17:42:28,81,9395,39,42,6537.04,12065.01,0.00
2024-12-10 17:42:28,80,9395,38,42,6541.10,12065.25,0.00
2024-12-10 17:42:28,80,9396,38,42,6587.42,12066.00,0.00
2024-12-10 17:42:28,81,9396,38,43,6506.09,12066.01,0.00
2024-12-10 17:42:28,80,9396,37,43,6496.46,12066.21,0.00
2024-12-10 17:42:28,80,9397,37,43,6523.13,12067.00,0.00
2024-12-10 17:42:28,81,9397,38,43,6442.60,12067.01,0.00
2024-12-10 17:42:28,80,9397,37,43,6464.80,12067.05,0.00
2024-12-10 17:42:28,80,9398,37,43,6432.33,12068.00,0.00
2024-12-10 17:42:28,81,9398,38,43,6352.92,12068.01,0.00
2024-12-10 17:42:28,80,9398,38,42,6411.23,12068.10,0.00
2024-12-10 17:42:28,79,9398,38,41,6360.00,12068.81,0.00
2024-12-10 17:42:28,79,9399,38,41,6428.87,12069.00,0.00
2024-12-10 17:42:28,80,9399,39,41,6348.51,12069.01,0.00
2024-12-10 17:42:28,79,9399,38,41,6352.42,12069.39,0.00
2024-12-10 17:42:28,78,9399,37,41,6392.27,12069.74,0.00
2024-12-10 17:42:28,77,9399,36,41,6459.65,12069.81,0.00
2024-12-10 17:42:28,77,9400,36,41,6593.03,12070.00,0.00
2024-12-10 17:42:28,78,9400,37,41,6508.50,12070.01,0.00
2024-12-10 17:42:28,77,9400,37,40,6572.67,12070.10,0.00
2024-12-10 17:42:28,77,9401,37,40,6559.08,12071.00,0.00
2024-12-10 17:42:28,78,9401,38,40,6474.99,12071.01,0.00
2024-12-10 17:42:28,78,9402,38,40,6462.47,12072.00,0.00
2024-12-10 17:42:28,79,9402,38,41,6380.67,12072.01,0.00
2024-12-10 17:42:28,78,9402,37,41,6456.29,12072.05,0.00
2024-12-10 17:42:28,78,9403,37,41,6434.09,12073.00,0.00
2024-12-10 17:42:28,79,9403,38,41,6352.64,12073.01,0.00
2024-12-10 17:42:29,79,9404,38,41,6298.37,12074.00,0.00
2024-12-10 17:42:29,80,9404,39,41,6219.64,12074.01,0.00
2024-12-10 17:42:29,79,9404,39,40,6273.94,12074.09,0.00
2024-12-10 17:42:29,78,9404,38,40,6186.00,12074.97,0.00
2024-12-10 17:42:29,78,9405,38,40,6337.73,12075.00,0.00
2024-12-10 17:42:29,79,9405,38,41,6257.50,12075.01,0.00
2024-12-10 17:42:29,79,9406,38,41,6199.93,12076.00,0.00
2024-12-10 17:42:29,80,9406,39,41,6122.43,12076.01,0.00
2024-12-10 17:42:29,79,9406,39,40,6187.72,12076.09,0.00
2024-12-10 17:42:29,80,9405,39,41,6081.77,12076.35,0.00
2024-12-10 17:42:29,79,9405,38,41,6148.42,12076.94,0.00
2024-12-10 17:42:29,79,9406,38,41,6293.70,12077.00,0.00
2024-12-10 17:42:29,80,9406,39,41,6215.02,12077.01,0.00
2024-12-10 17:42:29,80,9407,39,41,6348.84,12078.00,0.00
2024-12-10 17:42:29,81,9407,40,41,6270.46,12078.01,0.00
2024-12-10 17:42:29,81,9408,40,41,6234.66,12079.00,0.00
2024-12-10 17:42:29,82,9408,40,42,6158.63,12079.01,0.00
2024-12-10 17:42:29,81,9408,39,42,6172.10,12079.28,0.00
2024-12-10 17:42:29,81,9409,39,42,6170.96,12080.00,0.00
2024-12-10 17:42:29,82,9409,40,42,6095.70,12080.01,0.00
2024-12-10 17:42:29,81,9409,40,41,6154.56,12080.10,0.00
2024-12-10 17:42:29,80,9409,39,41,6144.28,12080.78,0.00
2024-12-10 17:42:29,80,9410,39,41,6194.54,12081.00,0.00
2024-12-10 17:42:29,81,9410,39,42,6118.06,12081.01,0.00
2024-12-10 17:42:29,80,9410,38,42,6132.68,12081.28,0.00
2024-12-10 17:42:29,80,9411,38,42,6108.56,12082.00,0.00
2024-12-10 17:42:29,81,9411,39,42,6033.15,12082.01,0.00
2024-12-10 17:42:29,80,9411,39,41,6093.48,12082.13,0.00
2024-12-10 17:42:29,79,9411,38,41,6103.47,12082.48,0.00
2024-12-10 17:42:29,79,9412,38,41,6158.94,12083.00,0.00
2024-12-10 17:42:29,80,9412,38,42,6081.96,12083.01,0.00
2024-12-10 17:42:29,79,9412,37,42,6152.83,12083.05,0.00
2024-12-10 17:42:29,79,9413,37,42,6095.22,12084.00,0.00
2024-12-10 17:42:29,80,9413,37,43,6019.02,12084.01,0.00
2024-12-10 17:42:29,79,9413,36,43,5912.63,12084.86,0.00
2024-12-10 17:42:29,80,9412,36,44,5832.73,12084.92,0.00
2024-12-10 17:42:29,80,9413,36,44,5972.32,12085.00,0.00
2024-12-10 17:42:29,81,9413,37,44,5898.59,12085.01,0.00
2024-12-10 17:42:29,80,9413,36,44,5966.28,12085.05,0.00
2024-12-10 17:42:29,79,9413,36,43,6015.81,12085.10,0.00
2024-12-10 17:42:29,80,9412,36,44,5921.02,12085.29,0.00
2024-12-10 17:42:29,80,9413,36,44,6139.23,12086.00,0.00
2024-12-10 17:42:29,81,9413,36,45,6063.44,12086.01,0.00
2024-12-10 17:42:29,80,9413,36,44,6098.45,12086.10,0.00
2024-12-10 17:42:29,81,9412,36,45,5940.59,12086.57,0.00
2024-12-10 17:42:29,80,9412,35,45,6016.62,12086.94,0.00
2024-12-10 17:42:29,80,9413,35,45,6311.28,12087.00,0.00
2024-12-10 17:42:29,81,9413,36,45,6233.36,12087.01,0.00
2024-12-10 17:42:29,80,9413,36,44,6268.98,12087.10,0.00
2024-12-10 17:42:29,79,9413,35,44,6205.89,12087.57,0.00
2024-12-10 17:42:29,79,9414,35,44,6460.20,12088.00,0.00
2024-12-10 17:42:29,80,9414,36,44,6379.44,12088.01,0.00
2024-12-10 17:42:29,79,9414,36,43,6318.62,12088.43,0.00
2024-12-10 17:42:29,79,9415,36,43,6396.11,12089.00,0.00
2024-12-10 17:42:29,80,9415,37,43,6316.16,12089.01,0.00
2024-12-10 17:42:29,79,9415,37,42,6377.76,12089.13,0.00
2024-12-10 17:42:29,79,9416,37,42,6364.50,12090.00,0.00
2024-12-10 17:42:29,80,9416,38,42,6284.94,12090.01,0.00
2024-12-10 17:42:29,80,9417,38,42,6228.97,12091.00,0.00
2024-12-10 17:42:29,81,9417,39,42,6152.07,12091.01,0.00
2024-12-10 17:42:29,80,9417,38,42,6222.93,12091.05,0.00
2024-12-10 17:42:29,79,9417,38,41,6289.47,12091.11,0.00
2024-12-10 17:42:29,78,9417,37,41,6351.27,12091.27,0.00
2024-12-10 17:42:29,78,9418,37,41,6356.37,12092.00,0.00
2024-12-10 17:42:29,79,9418,37,42,6275.91,12092.01,0.00
2024-12-10 17:42:29,78,9418,36,42,6340.87,12092.05,0.00
2024-12-10 17:42:29,78,9419,36,42,6350.70,12093.00,0.00
2024-12-10 17:42:29,79,9419,37,42,6270.31,12093.01,0.00
2024-12-10 17:42:29,79,9420,37,42,6213.98,12094.00,0.00
2024-12-10 17:42:29,80,9420,37,43,6136.31,12094.01,0.00
2024-12-10 17:42:29,79,9420,37,42,6201.74,12094.10,0.00
2024-12-10 17:42:29,78,9420,37,41,6276.60,12094.12,0.00
2024-12-10 17:42:29,79,9419,37,42,6131.57,12094.68,0.00
2024-12-10 17:42:29,79,9420,37,42,6223.68,12095.00,0.00
2024-12-10 17:42:29,80,9420,38,42,6145.89,12095.01,0.00
2024-12-10 17:42:29,79,9420,37,42,6150.17,12095.32,0.00
2024-12-10 17:42:29,79,9421,37,42,6372.50,12096.00,0.00
2024-12-10 17:42:29,80,9421,38,42,6292.85,12096.01,0.00
2024-12-10 17:42:29,79,9421,38,41,6358.73,12096.11,0.00
2024-12-10 17:42:29,79,9422,38,41,6343.93,12097.00,0.00
2024-12-10 17:42:29,80,9422,38,42,6264.63,12097.01,0.00
2024-12-10 17:42:29,81,9421,38,43,6018.96,12097.74,0.00
2024-12-10 17:42:29,81,9422,38,43,6282.15,12098.00,0.00
2024-12-10 17:42:29,82,9422,39,43,6205.54,12098.01,0.00
2024-12-10 17:42:29,81,9422,39,42,6256.78,12098.14,0.00
2024-12-10 17:42:29,81,9423,39,42,6391.71,12099.00,0.00
2024-12-10 17:42:29,82,9423,40,42,6313.76,12099.01,0.00
2024-12-10 17:42:29,81,9423,39,42,6387.23,12099.04,0.00
2024-12-10 17:42:29,80,9423,38,42,6465.56,12099.04,0.00
2024-12-10 17:42:29,81,9422,39,42,6321.59,12099.35,0.00
2024-12-10 17:42:29,81,9423,39,42,6473.93,12100.00,0.00
2024-12-10 17:42:29,82,9423,40,42,6394.98,12100.01,0.00
2024-12-10 17:42:29,81,9423,39,42,6472.44,12100.01,0.00
2024-12-10 17:42:29,80,9423,38,42,6550.32,12100.03,0.00
2024-12-10 17:42:29,80,9424,38,42,6687.12,12101.00,0.00
2024-12-10 17:42:29,81,9424,38,43,6604.57,12101.01,0.00
2024-12-10 17:42:29,81,9425,38,43,6576.32,12102.00,0.00
2024-12-10 17:42:29,82,9425,38,44,6496.12,12102.01,0.00
2024-12-10 17:42:29,81,9425,37,44,6516.62,12102.26,0.00
2024-12-10 17:42:29,81,9426,37,44,6527.79,12103.00,0.00
2024-12-10 17:42:29,82,9426,38,44,6448.18,12103.01,0.00
2024-12-10 17:42:29,81,9426,38,43,6499.40,12103.07,0.00
2024-12-10 17:42:30,81,9427,38,43,6477.34,12104.00,0.00
2024-12-10 17:42:30,82,9427,39,43,6398.35,12104.01,0.00
2024-12-10 17:42:30,81,9427,39,42,6462.41,12104.09,0.00
2024-12-10 17:42:30,81,9428,39,42,6440.12,12105.00,0.00
2024-12-10 17:42:30,82,9428,39,43,6361.58,12105.01,0.00
2024-12-10 17:42:30,82,9429,39,43,6300.12,12106.00,0.00
2024-12-10 17:42:30,83,9429,39,44,6224.22,12106.01,0.00
2024-12-10 17:42:30,84,9428,40,44,6150.12,12106.04,0.00
2024-12-10 17:42:30,83,9428,40,43,6345.30,12106.10,0.00
2024-12-10 17:42:30,83,9429,40,43,6318.96,12107.00,0.00
2024-12-10 17:42:30,84,9429,40,44,6243.73,12107.01,0.00
2024-12-10 17:42:30,84,9430,40,44,6361.16,12108.00,0.00
2024-12-10 17:42:30,85,9430,40,45,6286.33,12108.01,0.00
2024-12-10 17:42:30,84,9430,39,45,6285.06,12108.39,0.00
2024-12-10 17:42:30,84,9431,39,45,6332.93,12109.00,0.00
2024-12-10 17:42:30,85,9431,40,45,6258.42,12109.01,0.00
2024-12-10 17:42:30,84,9431,39,45,6188.32,12109.89,0.00
2024-12-10 17:42:30,84,9432,39,45,6295.80,12110.00,0.00
2024-12-10 17:42:30,85,9432,39,46,6221.73,12110.01,0.00
2024-12-10 17:42:30,84,9432,38,46,6264.09,12110.02,0.00
2024-12-10 17:42:30,83,9432,37,46,6338.10,12110.02,0.00
2024-12-10 17:42:30,84,9431,37,47,6151.63,12110.89,0.00
2024-12-10 17:42:30,84,9432,37,47,6251.58,12111.00,0.00
2024-12-10 17:42:30,85,9432,37,48,6178.03,12111.01,0.00
2024-12-10 17:42:30,84,9432,37,47,6228.51,12111.01,0.00
2024-12-10 17:42:30,83,9432,36,47,6135.07,12111.94,0.00
2024-12-10 17:42:30,83,9433,36,47,6419.66,12112.00,0.00
2024-12-10 17:42:30,84,9433,37,47,6343.24,12112.01,0.00
2024-12-10 17:42:30,83,9433,37,46,6386.11,12112.06,0.00
2024-12-10 17:42:30,82,9433,36,46,6438.94,12112.27,0.00
2024-12-10 17:42:30,82,9434,36,46,6427.80,12113.00,0.00
2024-12-10 17:42:30,83,9434,37,46,6350.36,12113.01,0.00
2024-12-10 17:42:30,84,9433,38,46,6271.88,12113.06,0.00
2024-12-10 17:42:30,84,9434,38,46,6243.72,12114.00,0.00
2024-12-10 17:42:30,85,9434,38,47,6170.27,12114.01,0.00
2024-12-10 17:42:30,84,9434,38,46,6242.28,12114.01,0.00
2024-12-10 17:42:30,84,9435,38,46,6355.81,12115.00,0.00
2024-12-10 17:42:30,85,9435,38,47,6281.03,12115.01,0.00
2024-12-10 17:42:30,84,9435,38,46,6314.00,12115.11,0.00
2024-12-10 17:42:30,84,9436,38,46,6316.02,12116.00,0.00
2024-12-10 17:42:30,85,9436,38,47,6241.72,12116.01,0.00
2024-12-10 17:42:30,84,9436,37,47,6178.14,12116.73,0.00
2024-12-10 17:42:30,84,9436,37,47,6265.67,12117.00,0.00
2024-12-10 17:42:30,85,9436,37,48,6191.96,12117.01,0.00
2024-12-10 17:42:30,84,9436,37,47,6213.47,12117.11,0.00
2024-12-10 17:42:30,84,9437,37,47,6192.89,12118.00,0.00
2024-12-10 17:42:30,85,9437,37,48,6120.04,12118.01,0.00
2024-12-10 17:42:30,84,9437,37,47,6168.37,12118.02,0.00
2024-12-10 17:42:30,83,9437,36,47,6215.00,12118.25,0.00
2024-12-10 17:42:30,82,9437,35,47,6144.76,12118.95,0.00
2024-12-10 17:42:30,82,9438,35,47,6286.68,12119.00,0.00
2024-12-10 17:42:30,83,9438,36,47,6210.93,12119.01,0.00
2024-12-10 17:42:30,82,9438,35,47,6284.28,12119.02,0.00
2024-12-10 17:42:30,83,9437,35,48,6204.19,12119.08,0.00
2024-12-10 17:42:30,82,9437,34,48,6340.41,12119.37,0.00
2024-12-10 17:42:30,82,9438,34,48,6333.85,12120.00,0.00
2024-12-10 17:42:30,83,9438,34,49,6257.54,12120.01,0.00
2024-12-10 17:42:30,82,9438,34,48,6322.05,12120.10,0.00
2024-12-10 17:42:30,83,9437,34,49,6221.12,12120.33,0.00
2024-12-10 17:42:30,83,9438,34,49,6425.75,12121.00,0.00
2024-12-10 17:42:30,84,9438,35,49,6349.26,12121.01,0.00
2024-12-10 17:42:30,83,9438,34,49,6424.29,12121.01,0.00
2024-12-10 17:42:30,83,9439,34,49,6517.57,12122.00,0.00
2024-12-10 17:42:30,84,9439,34,50,6439.98,12122.01,0.00
2024-12-10 17:42:30,83,9439,34,49,6498.59,12122.04,0.00
2024-12-10 17:42:30,83,9440,34,49,6413.94,12123.00,0.00
2024-12-10 17:42:30,84,9440,35,49,6337.59,12123.01,0.00
2024-12-10 17:42:30,83,9440,34,49,6335.44,12123.40,0.00
2024-12-10 17:42:30,82,9440,34,48,6409.66,12123.40,0.00
2024-12-10 17:42:30,81,9440,33,48,6456.10,12123.67,0.00
2024-12-10 17:42:30,80,9440,32,48,6505.57,12123.69,0.00
2024-12-10 17:42:30,81,9439,33,48,6411.86,12123.81,0.00
2024-12-10 17:42:30,81,9440,33,48,6530.54,12124.00,0.00
2024-12-10 17:42:30,82,9440,34,48,6450.90,12124.01,0.00
2024-12-10 17:42:30,81,9440,33,48,6470.73,12124.26,0.00
2024-12-10 17:42:30,80,9440,32,48,6489.19,12124.70,0.00
2024-12-10 17:42:30,80,9441,32,48,6708.62,12125.00,0.00
2024-12-10 17:42:30,81,9441,32,49,6625.80,12125.01,0.00
2024-12-10 17:42:30,80,9441,32,48,6676.50,12125.10,0.00
2024-12-10 17:42:30,79,9441,31,48,6671.08,12125.70,0.00
2024-12-10 17:42:30,79,9442,31,48,6726.59,12126.00,0.00
2024-12-10 17:42:30,80,9442,32,48,6642.51,12126.01,0.00
2024-12-10 17:42:30,80,9443,32,48,6595.51,12127.00,0.00
2024-12-10 17:42:30,81,9443,33,48,6514.09,12127.01,0.00
2024-12-10 17:42:30,80,9443,32,48,6499.94,12127.35,0.00
2024-12-10 17:42:30,80,9444,32,48,6529.21,12128.00,0.00
2024-12-10 17:42:30,81,9444,33,48,6448.60,12128.01,0.00
2024-12-10 17:42:30,80,9444,33,47,6485.26,12128.14,0.00
2024-12-10 17:42:30,79,9444,32,47,6550.52,12128.28,0.00
2024-12-10 17:42:30,79,9445,32,47,6555.60,12129.00,0.00
2024-12-10 17:42:30,80,9445,32,48,6473.65,12129.01,0.00
2024-12-10 17:42:30,79,9445,31,48,6541.84,12129.08,0.00
2024-12-10 17:42:30,80,9444,32,48,6404.03,12129.31,0.00
2024-12-10 17:42:30,80,9445,32,48,6562.29,12130.00,0.00
2024-12-10 17:42:30,81,9445,33,48,6481.28,12130.01,0.00
2024-12-10 17:42:30,80,9445,33,47,6560.78,12130.01,0.00
2024-12-10 17:42:30,79,9445,33,46,6625.42,12130.13,0.00
2024-12-10 17:42:30,79,9446,33,46,6765.68,12131.00,0.00
2024-12-10 17:42:30,80,9446,33,47,6681.11,12131.01,0.00
2024-12-10 17:42:30,79,9446,33,46,6764.15,12131.01,0.00
2024-12-10 17:42:30,78,9446,32,46,6838.58,12131.10,0.00
2024-12-10 17:42:30,78,9447,32,46,6794.85,12132.00,0.00
2024-12-10 17:42:30,79,9447,33,46,6708.84,12132.01,0.00
2024-12-10 17:42:30,78,9447,32,46,6789.01,12132.05,0.00
2024-12-10 17:42:30,77,9447,31,46,6876.72,12132.05,0.00
2024-12-10 17:42:30,76,9447,31,45,6951.25,12132.11,0.00
2024-12-10 17:42:30,77,9446,32,45,6824.86,12132.43,0.00
2024-12-10 17:42:30,76,9446,31,45,6945.76,12132.45,0.00
2024-12-10 17:42:31,76,9447,31,45,7038.76,12133.00,0.00
2024-12-10 17:42:31,77,9447,31,46,6947.35,12133.01,0.00
2024-12-10 17:42:31,77,9448,31,46,7066.31,12134.00,0.00
2024-12-10 17:42:31,78,9448,32,46,6975.72,12134.01,0.00
2024-12-10 17:42:31,77,9448,32,45,7063.17,12134.03,0.00
2024-12-10 17:42:31,76,9448,31,45,6964.76,12134.88,0.00
2024-12-10 17:42:31,76,9449,31,45,7110.16,12135.00,0.00
2024-12-10 17:42:31,77,9449,31,46,7017.82,12135.01,0.00
2024-12-10 17:42:31,76,9449,31,45,7089.41,12135.04,0.00
2024-12-10 17:42:31,75,9449,30,45,7106.42,12135.43,0.00
2024-12-10 17:42:31,75,9450,30,45,7199.08,12136.00,0.00
2024-12-10 17:42:31,76,9450,31,45,7104.35,12136.01,0.00
2024-12-10 17:42:31,75,9450,31,44,7173.26,12136.21,0.00
2024-12-10 17:42:31,75,9451,31,44,7175.40,12137.00,0.00
2024-12-10 17:42:31,76,9451,32,44,7080.98,12137.01,0.00
2024-12-10 17:42:31,75,9451,31,44,7093.17,12137.29,0.00
2024-12-10 17:42:31,75,9452,31,44,7169.73,12138.00,0.00
2024-12-10 17:42:31,76,9452,32,44,7075.39,12138.01,0.00
2024-12-10 17:42:31,75,9452,32,43,7166.50,12138.03,0.00
2024-12-10 17:42:31,76,9451,32,44,6979.79,12138.55,0.00
2024-12-10 17:42:31,76,9452,32,44,7067.99,12139.00,0.00
2024-12-10 17:42:31,77,9452,33,44,6976.19,12139.01,0.00
2024-12-10 17:42:31,76,9452,33,43,7037.71,12139.22,0.00
2024-12-10 17:42:31,76,9453,33,43,7199.55,12140.00,0.00
2024-12-10 17:42:31,77,9453,34,43,7106.05,12140.01,0.00
2024-12-10 17:42:31,76,9453,33,43,7088.07,12140.67,0.00
2024-12-10 17:42:31,76,9454,33,43,7159.83,12141.00,0.00
2024-12-10 17:42:31,77,9454,33,44,7066.84,12141.01,0.00
2024-12-10 17:42:31,76,9454,32,44,7134.67,12141.21,0.00
2024-12-10 17:42:31,76,9455,32,44,7103.23,12142.00,0.00
2024-12-10 17:42:31,77,9455,32,45,7010.98,12142.01,0.00
2024-12-10 17:42:31,78,9454,33,45,6918.00,12142.06,0.00
2024-12-10 17:42:31,77,9454,33,44,7138.73,12142.22,0.00
2024-12-10 17:42:31,78,9453,33,45,7020.84,12142.46,0.00
2024-12-10 17:42:31,78,9454,33,45,7109.98,12143.00,0.00
2024-12-10 17:42:31,79,9454,33,46,7019.98,12143.01,0.00
2024-12-10 17:42:31,79,9455,33,46,7270.26,12144.00,0.00
2024-12-10 17:42:31,80,9455,33,47,7179.38,12144.01,0.00
2024-12-10 17:42:31,79,9455,33,46,7239.56,12144.15,0.00
2024-12-10 17:42:31,78,9455,32,46,7262.97,12144.71,0.00
2024-12-10 17:42:31,78,9456,32,46,7383.08,12145.00,0.00
2024-12-10 17:42:31,79,9456,32,47,7289.63,12145.01,0.00
2024-12-10 17:42:31,78,9456,31,47,7216.79,12145.92,0.00
2024-12-10 17:42:31,78,9457,31,47,7363.23,12146.00,0.00
2024-12-10 17:42:31,79,9457,32,47,7270.02,12146.01,0.00
2024-12-10 17:42:31,78,9457,32,46,7360.12,12146.03,0.00
2024-12-10 17:42:31,77,9457,31,46,7376.89,12146.17,0.00
2024-12-10 17:42:31,77,9458,31,46,7402.53,12147.00,0.00
2024-12-10 17:42:31,78,9458,31,47,7307.63,12147.01,0.00
2024-12-10 17:42:31,77,9458,31,46,7372.95,12147.18,0.00
2024-12-10 17:42:31,78,9457,31,47,7247.13,12147.46,0.00
2024-12-10 17:42:31,78,9458,31,47,7333.19,12148.00,0.00
2024-12-10 17:42:31,79,9458,32,47,7240.37,12148.01,0.00
2024-12-10 17:42:31,79,9459,32,47,7343.83,12149.00,0.00
2024-12-10 17:42:31,80,9459,33,47,7252.04,12149.01,0.00
2024-12-10 17:42:31,79,9459,33,46,7294.37,12149.19,0.00
2024-12-10 17:42:31,78,9459,32,46,7384.78,12149.22,0.00
2024-12-10 17:42:31,78,9460,32,46,7383.76,12150.00,0.00
2024-12-10 17:42:31,79,9460,32,47,7290.30,12150.01,0.00
2024-12-10 17:42:31,80,9459,33,47,7158.18,12150.13,0.00
2024-12-10 17:42:31,80,9460,33,47,7226.07,12151.00,0.00
2024-12-10 17:42:31,81,9460,33,48,7136.85,12151.01,0.00
2024-12-10 17:42:31,80,9460,32,48,7169.94,12151.22,0.00
2024-12-10 17:42:31,80,9461,32,48,7339.36,12152.00,0.00
2024-12-10 17:42:31,81,9461,33,48,7248.75,12152.01,0.00
2024-12-10 17:42:31,80,9461,32,48,7191.53,12152.60,0.00
2024-12-10 17:42:31,80,9462,32,48,7295.13,12153.00,0.00
2024-12-10 17:42:31,81,9462,33,48,7205.06,12153.01,0.00
2024-12-10 17:42:31,80,9462,33,47,7284.49,12153.01,0.00
2024-12-10 17:42:31,81,9461,33,48,7194.56,12153.04,0.00
2024-12-10 17:42:31,82,9460,33,49,7083.24,12153.38,0.00
2024-12-10 17:42:31,82,9461,33,49,7163.73,12154.00,0.00
2024-12-10 17:42:31,83,9461,33,50,7077.42,12154.01,0.00
2024-12-10 17:42:31,82,9461,33,49,7160.03,12154.02,0.00
2024-12-10 17:42:31,83,9460,33,50,7059.15,12154.17,0.00
2024-12-10 17:42:31,83,9461,33,50,7438.98,12155.00,0.00
2024-12-10 17:42:31,84,9461,34,50,7350.42,12155.01,0.00
2024-12-10 17:42:31,84,9462,34,50,7478.37,12156.00,0.00
2024-12-10 17:42:31,85,9462,34,51,7390.39,12156.01,0.00
2024-12-10 17:42:31,85,9463,34,51,7366.21,12157.00,0.00
2024-12-10 17:42:31,86,9463,34,52,7280.56,12157.01,0.00
2024-12-10 17:42:31,86,9464,34,52,7239.93,12158.00,0.00
2024-12-10 17:42:31,87,9464,34,53,7156.71,12158.01,0.00
2024-12-10 17:42:31,86,9464,34,52,7237.11,12158.02,0.00
2024-12-10 17:42:31,86,9465,34,52,7178.01,12159.00,0.00
2024-12-10 17:42:31,87,9465,34,53,7095.51,12159.01,0.00
2024-12-10 17:42:31,86,9465,34,52,7155.40,12159.06,0.00
2024-12-10 17:42:31,85,9465,33,52,7111.85,12159.87,0.00
2024-12-10 17:42:31,86,9464,34,52,7016.52,12159.99,0.00
2024-12-10 17:42:31,86,9465,34,52,7157.93,12160.00,0.00
2024-12-10 17:42:31,87,9465,35,52,7075.65,12160.01,0.00
2024-12-10 17:42:31,86,9465,34,52,7153.70,12160.02,0.00
2024-12-10 17:42:31,86,9466,34,52,7290.03,12161.00,0.00
2024-12-10 17:42:31,87,9466,35,52,7206.23,12161.01,0.00
2024-12-10 17:42:31,86,9466,35,51,7268.85,12161.12,0.00
2024-12-10 17:42:31,86,9467,35,51,7246.79,12162.00,0.00
2024-12-10 17:42:31,87,9467,35,52,7163.49,12162.01,0.00
2024-12-10 17:42:31,86,9467,34,52,7243.97,12162.02,0.00
2024-12-10 17:42:31,85,9467,33,52,7172.11,12162.65,0.00
2024-12-10 17:42:32,85,9468,33,52,7272.55,12163.00,0.00
2024-12-10 17:42:32,86,9468,33,53,7187.98,12163.01,0.00
2024-12-10 17:42:32,85,9468,33,52,7203.88,12163.08,0.00
2024-12-10 17:42:32,86,9467,33,53,7118.71,12163.12,0.00
2024-12-10 17:42:32,86,9468,33,53,7259.30,12164.00,0.00
2024-12-10 17:42:32,87,9468,33,54,7175.86,12164.01,0.00
2024-12-10 17:42:32,86,9468,32,54,7256.47,12164.02,0.00
2024-12-10 17:42:32,85,9468,32,53,7318.99,12164.11,0.00
2024-12-10 17:42:32,86,9467,32,54,7178.95,12164.58,0.00
2024-12-10 17:42:32,86,9468,32,54,7452.27,12165.00,0.00
2024-12-10 17:42:32,87,9468,33,54,7366.61,12165.01,0.00
2024-12-10 17:42:32,86,9468,32,54,7306.87,12165.59,0.00
2024-12-10 17:42:32,86,9469,32,54,7540.59,12166.00,0.00
2024-12-10 17:42:32,87,9469,33,54,7453.92,12166.01,0.00
2024-12-10 17:42:32,86,9469,33,53,7537.77,12166.02,0.00
2024-12-10 17:42:32,85,9469,33,52,7605.01,12166.09,0.00
2024-12-10 17:42:32,85,9470,33,52,7581.26,12167.00,0.00
2024-12-10 17:42:32,86,9470,34,52,7493.11,12167.01,0.00
2024-12-10 17:42:32,87,9469,35,52,7355.32,12167.23,0.00
2024-12-10 17:42:32,87,9470,35,52,7385.21,12168.00,0.00
2024-12-10 17:42:32,88,9470,36,52,7301.29,12168.01,0.00
2024-12-10 17:42:32,87,9470,36,51,7358.68,12168.12,0.00
2024-12-10 17:42:32,87,9471,36,51,7475.34,12169.00,0.00
2024-12-10 17:42:32,88,9471,37,51,7390.39,12169.01,0.00
2024-12-10 17:42:32,89,9470,38,51,7161.31,12169.56,0.00
2024-12-10 17:42:32,89,9471,38,51,7286.07,12170.00,0.00
2024-12-10 17:42:32,90,9471,39,51,7205.12,12170.01,0.00
2024-12-10 17:42:32,89,9471,38,51,7283.34,12170.02,0.00
2024-12-10 17:42:32,88,9471,38,50,7347.91,12170.10,0.00
2024-12-10 17:42:32,88,9472,38,50,7460.50,12171.00,0.00
2024-12-10 17:42:32,89,9472,39,50,7376.67,12171.01,0.00
2024-12-10 17:42:32,90,9471,39,51,7144.54,12171.66,0.00
2024-12-10 17:42:32,90,9472,39,51,7269.23,12172.00,0.00
2024-12-10 17:42:32,91,9472,40,51,7189.35,12172.01,0.00
2024-12-10 17:42:32,90,9472,40,50,7231.41,12172.11,0.00
2024-12-10 17:42:32,89,9472,39,50,7285.69,12172.33,0.00
2024-12-10 17:42:32,89,9473,39,50,7422.91,12173.00,0.00
2024-12-10 17:42:32,90,9473,40,50,7340.43,12173.01,0.00
2024-12-10 17:42:32,90,9474,40,50,7308.94,12174.00,0.00
2024-12-10 17:42:32,91,9474,40,51,7228.62,12174.01,0.00
2024-12-10 17:42:32,91,9475,40,51,7178.81,12175.00,0.00
2024-12-10 17:42:32,92,9475,40,52,7100.78,12175.01,0.00
2024-12-10 17:42:32,91,9475,40,51,7174.80,12175.03,0.00
2024-12-10 17:42:32,90,9475,39,51,7171.82,12175.49,0.00
2024-12-10 17:42:32,90,9476,39,51,7191.13,12176.00,0.00
2024-12-10 17:42:32,91,9476,40,51,7112.11,12176.01,0.00
2024-12-10 17:42:32,90,9476,40,50,7170.88,12176.10,0.00
2024-12-10 17:42:32,90,9477,40,50,7143.01,12177.00,0.00
2024-12-10 17:42:32,91,9477,41,50,7064.52,12177.01,0.00
2024-12-10 17:42:32,90,9477,40,50,7102.46,12177.09,0.00
2024-12-10 17:42:32,90,9478,40,50,7100.30,12178.00,0.00
2024-12-10 17:42:32,91,9478,41,50,7022.27,12178.01,0.00
2024-12-10 17:42:32,90,9478,41,49,7080.04,12178.09,0.00
2024-12-10 17:42:32,90,9479,41,49,7050.81,12179.00,0.00
2024-12-10 17:42:32,91,9479,42,49,6973.33,12179.01,0.00
2024-12-10 17:42:32,90,9479,41,49,6934.81,12179.73,0.00
2024-12-10 17:42:32,90,9480,41,49,6983.73,12180.00,0.00
2024-12-10 17:42:32,91,9480,42,49,6906.98,12180.01,0.00
2024-12-10 17:42:32,90,9480,42,48,6964.81,12180.09,0.00
2024-12-10 17:42:32,90,9481,42,48,6935.57,12181.00,0.00
2024-12-10 17:42:32,91,9481,43,48,6859.36,12181.01,0.00
2024-12-10 17:42:32,92,9480,44,48,6775.57,12181.11,0.00
2024-12-10 17:42:32,92,9481,44,48,6819.74,12182.00,0.00
2024-12-10 17:42:32,93,9481,45,48,6746.41,12182.01,0.00
2024-12-10 17:42:32,94,9480,46,48,6579.00,12182.61,0.00
2024-12-10 17:42:32,94,9481,46,48,6817.25,12183.00,0.00
2024-12-10 17:42:32,95,9481,46,49,6745.48,12183.01,0.00
2024-12-10 17:42:32,94,9481,45,49,6759.02,12183.27,0.00
2024-12-10 17:42:32,94,9482,45,49,6915.56,12184.00,0.00
2024-12-10 17:42:32,95,9482,45,50,6842.76,12184.01,0.00
2024-12-10 17:42:32,95,9483,45,50,6801.42,12185.00,0.00
2024-12-10 17:42:32,96,9483,45,51,6730.57,12185.01,0.00
2024-12-10 17:42:32,96,9484,45,51,6668.87,12186.00,0.00
2024-12-10 17:42:32,97,9484,46,51,6600.12,12186.01,0.00
2024-12-10 17:42:32,96,9484,46,50,6639.70,12186.08,0.00
2024-12-10 17:42:32,95,9484,45,50,6572.41,12186.95,0.00
2024-12-10 17:42:32,95,9485,45,50,6694.32,12187.00,0.00
2024-12-10 17:42:32,96,9485,45,51,6624.59,12187.01,0.00
2024-12-10 17:42:32,96,9486,45,51,6593.40,12188.00,0.00
2024-12-10 17:42:32,97,9486,45,52,6525.43,12188.01,0.00
2024-12-10 17:42:32,98,9485,46,52,6458.85,12188.03,0.00
2024-12-10 17:42:32,97,9485,45,52,6544.23,12188.27,0.00
2024-12-10 17:42:32,97,9486,45,52,6581.13,12189.00,0.00
2024-12-10 17:42:32,98,9486,46,52,6513.97,12189.01,0.00
2024-12-10 17:42:32,97,9486,45,52,6483.71,12189.28,0.00
2024-12-10 17:42:32,97,9487,45,52,6647.53,12190.00,0.00
2024-12-10 17:42:32,98,9487,46,52,6579.70,12190.01,0.00
2024-12-10 17:42:32,97,9487,46,51,6616.15,12190.08,0.00
2024-12-10 17:42:32,96,9487,45,51,6683.40,12190.08,0.00
2024-12-10 17:42:32,96,9488,45,51,6699.15,12191.00,0.00
2024-12-10 17:42:32,97,9488,46,51,6630.08,12191.01,0.00
2024-12-10 17:42:32,96,9488,46,50,6663.63,12191.09,0.00
2024-12-10 17:42:32,97,9487,46,51,6558.59,12191.41,0.00
2024-12-10 17:42:32,96,9487,45,51,6634.65,12191.80,0.00
2024-12-10 17:42:32,96,9488,45,51,6737.68,12192.00,0.00
2024-12-10 17:42:32,97,9488,45,52,6668.21,12192.01,0.00
2024-12-10 17:42:33,96,9488,45,51,6702.15,12192.09,0.00
2024-12-10 17:42:33,96,9489,45,51,6795.13,12193.00,0.00
2024-12-10 17:42:33,97,9489,46,51,6725.08,12193.01,0.00
2024-12-10 17:42:33,96,9489,45,51,6743.47,12193.22,0.00
2024-12-10 17:42:33,95,9489,44,51,6706.62,12193.72,0.00
2024-12-10 17:42:33,95,9490,44,51,6800.54,12194.00,0.00
2024-12-10 17:42:33,96,9490,44,52,6729.70,12194.01,0.00
2024-12-10 17:42:33,95,9490,44,51,6792.87,12194.06,0.00
2024-12-10 17:42:33,94,9490,44,50,6843.10,12194.17,0.00
2024-12-10 17:42:33,94,9491,44,50,6820.16,12195.00,0.00
2024-12-10 17:42:33,95,9491,44,51,6748.37,12195.01,0.00
2024-12-10 17:42:33,95,9492,44,51,6679.60,12196.00,0.00
2024-12-10 17:42:33,96,9492,44,52,6610.02,12196.01,0.00
2024-12-10 17:42:33,95,9492,43,52,6671.92,12196.06,0.00
2024-12-10 17:42:33,94,9492,43,51,6724.75,12196.16,0.00
2024-12-10 17:42:33,93,9492,42,51,6691.10,12196.68,0.00
2024-12-10 17:42:33,93,9493,42,51,6783.14,12197.00,0.00
2024-12-10 17:42:33,94,9493,42,52,6710.98,12197.01,0.00
2024-12-10 17:42:33,93,9493,41,52,6773.46,12197.09,0.00
2024-12-10 17:42:33,93,9494,41,52,6767.43,12198.00,0.00
2024-12-10 17:42:33,94,9494,42,52,6695.43,12198.01,0.00
2024-12-10 17:42:33,95,9493,43,52,6568.54,12198.28,0.00
2024-12-10 17:42:33,96,9492,44,52,6514.18,12198.48,0.00
2024-12-10 17:42:33,96,9493,44,52,6583.17,12199.00,0.00
2024-12-10 17:42:33,97,9493,45,52,6515.30,12199.01,0.00
2024-12-10 17:42:33,96,9493,45,51,6556.52,12199.16,0.00
2024-12-10 17:42:33,96,9494,45,51,6784.50,12200.00,0.00
2024-12-10 17:42:33,97,9494,46,51,6714.56,12200.01,0.00
2024-12-10 17:42:33,96,9494,45,51,6710.91,12200.33,0.00
2024-12-10 17:42:33,96,9495,45,51,6757.09,12201.00,0.00
2024-12-10 17:42:33,97,9495,45,52,6687.43,12201.01,0.00
2024-12-10 17:42:33,96,9495,45,51,6727.90,12201.16,0.00
2024-12-10 17:42:33,97,9494,45,52,6568.40,12201.92,0.00
2024-12-10 17:42:33,97,9495,45,52,6641.44,12202.00,0.00
2024-12-10 17:42:33,98,9495,46,52,6573.67,12202.01,0.00
2024-12-10 17:42:33,99,9494,47,52,6503.58,12202.06,0.00
2024-12-10 17:42:33,98,9494,47,51,6604.84,12202.15,0.00
2024-12-10 17:42:33,97,9494,46,51,6606.26,12202.17,0.00
2024-12-10 17:42:33,98,9493,46,52,6522.73,12202.33,0.00
2024-12-10 17:42:33,98,9494,46,52,6758.00,12203.00,0.00
2024-12-10 17:42:33,99,9494,46,53,6689.74,12203.01,0.00
2024-12-10 17:42:33,98,9494,46,52,6729.41,12203.15,0.00
2024-12-10 17:42:33,98,9495,46,52,6950.33,12204.00,0.00
2024-12-10 17:42:33,99,9495,46,53,6880.13,12204.01,0.00
2024-12-10 17:42:33,99,9496,46,53,6811.21,12205.00,0.00
2024-12-10 17:42:33,100,9496,47,53,6743.09,12205.01,0.00
2024-12-10 17:42:33,99,9496,47,52,6781.66,12205.16,0.00
2024-12-10 17:42:33,98,9496,46,52,6791.67,12205.46,0.00
2024-12-10 17:42:33,98,9497,46,52,6850.59,12206.00,0.00
2024-12-10 17:42:33,99,9497,46,53,6781.39,12206.01,0.00
2024-12-10 17:42:33,98,9497,45,53,6784.68,12206.31,0.00
2024-12-10 17:42:33,98,9498,45,53,6824.99,12207.00,0.00
2024-12-10 17:42:33,99,9498,45,54,6756.05,12207.01,0.00
2024-12-10 17:42:33,99,9499,45,54,6723.46,12208.00,0.00
2024-12-10 17:42:33,100,9499,46,54,6656.23,12208.01,0.00
2024-12-10 17:42:33,101,9498,47,54,6523.97,12208.38,0.00
2024-12-10 17:42:33,102,9497,47,55,6494.84,12208.63,0.00
2024-12-10 17:42:33,102,9498,47,55,6637.83,12209.00,0.00
2024-12-10 17:42:33,103,9498,48,55,6573.39,12209.01,0.00
2024-12-10 17:42:33,102,9498,47,55,6580.47,12209.28,0.00
2024-12-10 17:42:33,103,9497,47,56,6494.15,12209.49,0.00
2024-12-10 17:42:33,103,9498,47,56,6858.99,12210.00,0.00
2024-12-10 17:42:33,104,9498,47,57,6793.04,12210.01,0.00
2024-12-10 17:42:33,105,9497,48,57,6656.39,12210.43,0.00
2024-12-10 17:42:33,105,9498,48,57,6830.47,12211.00,0.00
2024-12-10 17:42:33,106,9498,48,58,6766.03,12211.01,0.00
2024-12-10 17:42:33,105,9498,48,57,6806.09,12211.16,0.00
2024-12-10 17:42:33,105,9499,48,57,6890.35,12212.00,0.00
2024-12-10 17:42:33,106,9499,48,58,6825.34,12212.01,0.00
2024-12-10 17:42:33,105,9499,47,58,6882.23,12212.07,0.00
2024-12-10 17:42:33,104,9499,47,57,6928.46,12212.16,0.00
2024-12-10 17:42:33,105,9498,48,57,6852.04,12212.27,0.00
2024-12-10 17:42:33,105,9499,48,57,6903.70,12213.00,0.00
2024-12-10 17:42:33,106,9499,49,57,6838.57,12213.01,0.00
2024-12-10 17:42:33,105,9499,48,57,6849.12,12213.27,0.00
2024-12-10 17:42:33,106,9498,48,58,6692.44,12213.69,0.00
2024-12-10 17:42:33,106,9499,48,58,6910.46,12214.00,0.00
2024-12-10 17:42:33,107,9499,48,59,6845.87,12214.01,0.00
2024-12-10 17:42:33,106,9499,48,58,6902.41,12214.07,0.00
2024-12-10 17:42:33,105,9499,48,57,6943.74,12214.18,0.00
2024-12-10 17:42:33,105,9500,48,57,7030.35,12215.00,0.00
2024-12-10 17:42:33,106,9500,48,58,6964.03,12215.01,0.00
2024-12-10 17:42:33,105,9500,48,57,7022.23,12215.07,0.00
2024-12-10 17:42:33,104,9500,48,56,7080.36,12215.10,0.00
2024-12-10 17:42:33,105,9499,48,57,6934.17,12215.76,0.00
2024-12-10 17:42:33,105,9500,48,57,6993.70,12216.00,0.00
2024-12-10 17:42:33,106,9500,48,58,6927.72,12216.01,0.00
2024-12-10 17:42:33,105,9500,48,57,6985.58,12216.07,0.00
2024-12-10 17:42:33,105,9501,48,57,7035.75,12217.00,0.00
2024-12-10 17:42:33,106,9501,49,57,6969.37,12217.01,0.00
2024-12-10 17:42:33,105,9501,49,56,7027.62,12217.07,0.00
2024-12-10 17:42:33,104,9501,49,55,7077.59,12217.14,0.00
2024-12-10 17:42:33,104,9502,49,55,7044.06,12218.00,0.00
2024-12-10 17:42:33,105,9502,49,56,6976.98,12218.01,0.00
2024-12-10 17:42:33,104,9502,49,55,7035.86,12218.07,0.00
2024-12-10 17:42:33,103,9502,48,55,6996.99,12218.73,0.00
2024-12-10 17:42:33,103,9503,48,55,7082.61,12219.00,0.00
2024-12-10 17:42:33,104,9503,48,56,7014.51,12219.01,0.00
2024-12-10 17:42:34,104,9504,48,56,6960.93,12220.00,0.00
2024-12-10 17:42:34,105,9504,49,56,6894.64,12220.01,0.00
2024-12-10 17:42:34,104,9504,48,56,6847.35,12220.64,0.00
2024-12-10 17:42:34,104,9505,48,56,6921.65,12221.00,0.00
2024-12-10 17:42:34,105,9505,48,57,6855.73,12221.01,0.00
2024-12-10 17:42:34,104,9505,48,56,6893.48,12221.13,0.00
2024-12-10 17:42:34,103,9505,47,56,6942.68,12221.28,0.00
2024-12-10 17:42:34,103,9506,47,56,6926.53,12222.00,0.00
2024-12-10 17:42:34,104,9506,47,57,6859.93,12222.01,0.00
2024-12-10 17:42:34,105,9505,48,57,6753.90,12222.17,0.00
2024-12-10 17:42:34,106,9504,49,57,6703.04,12222.56,0.00
2024-12-10 17:42:34,106,9505,49,57,6758.72,12223.00,0.00
2024-12-10 17:42:34,107,9505,50,57,6695.56,12223.01,0.00
2024-12-10 17:42:34,106,9505,50,56,6751.82,12223.06,0.00
2024-12-10 17:42:34,105,9505,50,55,6804.50,12223.12,0.00
2024-12-10 17:42:34,104,9505,49,55,6787.86,12223.55,0.00
2024-12-10 17:42:34,104,9506,49,55,7085.55,12224.00,0.00
2024-12-10 17:42:34,105,9506,49,56,7018.07,12224.01,0.00
2024-12-10 17:42:34,104,9506,48,56,7011.65,12224.36,0.00
2024-12-10 17:42:34,104,9507,48,56,7050.87,12225.00,0.00
2024-12-10 17:42:34,105,9507,48,57,6983.72,12225.01,0.00
2024-12-10 17:42:34,105,9508,48,57,6933.73,12226.00,0.00
2024-12-10 17:42:34,106,9508,48,58,6868.32,12226.01,0.00
2024-12-10 17:42:34,105,9508,47,58,6814.58,12226.65,0.00
2024-12-10 17:42:34,105,9509,47,58,6888.21,12227.00,0.00
2024-12-10 17:42:34,106,9509,47,59,6823.22,12227.01,0.00
2024-12-10 17:42:34,106,9510,47,59,6785.15,12228.00,0.00
2024-12-10 17:42:34,107,9510,48,59,6721.74,12228.01,0.00
2024-12-10 17:42:34,107,9511,48,59,6678.96,12229.00,0.00
2024-12-10 17:42:34,108,9511,49,59,6617.12,12229.01,0.00
2024-12-10 17:42:34,107,9511,48,59,6676.68,12229.02,0.00
2024-12-10 17:42:34,108,9510,49,59,6508.73,12229.72,0.00
2024-12-10 17:42:34,108,9511,49,59,6589.27,12230.00,0.00
2024-12-10 17:42:34,109,9511,50,59,6528.81,12230.01,0.00
2024-12-10 17:42:34,110,9510,50,60,6467.24,12230.05,0.00
2024-12-10 17:42:34,109,9510,49,60,6554.64,12230.05,0.00
2024-12-10 17:42:34,108,9510,48,60,6555.87,12230.35,0.00
2024-12-10 17:42:34,108,9511,48,60,6665.32,12231.00,0.00
2024-12-10 17:42:34,109,9511,48,61,6604.17,12231.01,0.00
2024-12-10 17:42:34,108,9511,48,60,6639.30,12231.11,0.00
2024-12-10 17:42:34,108,9512,48,60,6712.31,12232.00,0.00
2024-12-10 17:42:34,109,9512,49,60,6650.73,12232.01,0.00
2024-12-10 17:42:34,108,9512,48,60,6707.79,12232.04,0.00
2024-12-10 17:42:34,107,9512,47,60,6769.34,12232.04,0.00
2024-12-10 17:42:34,106,9512,46,60,6777.90,12232.30,0.00
2024-12-10 17:42:34,105,9512,45,60,6793.35,12232.71,0.00
2024-12-10 17:42:34,105,9513,45,60,6861.79,12233.00,0.00
2024-12-10 17:42:34,106,9513,45,61,6797.05,12233.01,0.00
2024-12-10 17:42:34,106,9514,45,61,6748.80,12234.00,0.00
2024-12-10 17:42:34,107,9514,46,61,6685.73,12234.01,0.00
2024-12-10 17:42:34,106,9514,46,60,6733.82,12234.06,0.00
2024-12-10 17:42:34,107,9513,47,60,6520.25,12234.93,0.00
2024-12-10 17:42:34,107,9514,47,60,6655.32,12235.00,0.00
2024-12-10 17:42:34,108,9514,48,60,6593.70,12235.01,0.00
2024-12-10 17:42:34,108,9515,48,60,6641.32,12236.00,0.00
2024-12-10 17:42:34,109,9515,48,61,6580.39,12236.01,0.00
2024-12-10 17:42:34,108,9515,47,61,6635.67,12236.05,0.00
2024-12-10 17:42:34,107,9515,47,60,6674.79,12236.08,0.00
2024-12-10 17:42:34,108,9514,48,60,6510.16,12236.94,0.00
2024-12-10 17:42:34,108,9515,48,60,6621.25,12237.00,0.00
2024-12-10 17:42:34,109,9515,49,60,6560.51,12237.01,0.00
2024-12-10 17:42:34,108,9515,49,59,6609.94,12237.05,0.00
2024-12-10 17:42:34,107,9515,48,59,6613.21,12237.21,0.00
2024-12-10 17:42:34,107,9516,48,59,6746.24,12238.00,0.00
2024-12-10 17:42:34,108,9516,48,60,6683.78,12238.01,0.00
2024-12-10 17:42:34,107,9516,48,59,6723.05,12238.07,0.00
2024-12-10 17:42:34,108,9515,49,59,6658.53,12238.10,0.00
2024-12-10 17:42:34,108,9516,49,59,6661.09,12239.00,0.00
2024-12-10 17:42:34,109,9516,50,59,6599.98,12239.01,0.00
2024-12-10 17:42:34,108,9516,50,58,6635.74,12239.07,0.00
2024-12-10 17:42:34,107,9516,49,58,6673.91,12239.26,0.00
2024-12-10 17:42:34,106,9516,48,58,6735.73,12239.27,0.00
2024-12-10 17:42:34,106,9517,48,58,6831.78,12240.00,0.00
2024-12-10 17:42:34,107,9517,48,59,6767.93,12240.01,0.00
2024-12-10 17:42:34,106,9517,47,59,6775.91,12240.27,0.00
2024-12-10 17:42:34,107,9516,48,59,6684.09,12240.52,0.00
2024-12-10 17:42:34,108,9515,49,59,6624.65,12240.86,0.00
2024-12-10 17:42:34,108,9516,49,59,6761.79,12241.00,0.00
2024-12-10 17:42:34,109,9516,49,60,6699.76,12241.01,0.00
2024-12-10 17:42:34,108,9516,49,59,6755.42,12241.06,0.00
2024-12-10 17:42:34,108,9517,49,59,6945.15,12242.00,0.00
2024-12-10 17:42:34,109,9517,50,59,6881.44,12242.01,0.00
2024-12-10 17:42:34,108,9517,49,59,6939.50,12242.05,0.00
2024-12-10 17:42:34,107,9517,48,59,6976.15,12242.08,0.00
2024-12-10 17:42:34,106,9517,47,59,7018.91,12242.26,0.00
2024-12-10 17:42:34,107,9516,47,60,6919.14,12242.56,0.00
2024-12-10 17:42:34,107,9517,47,60,6995.62,12243.00,0.00
2024-12-10 17:42:34,108,9517,47,61,6930.84,12243.01,0.00
2024-12-10 17:42:34,108,9518,47,61,6974.71,12244.00,0.00
2024-12-10 17:42:34,109,9518,48,61,6910.72,12244.01,0.00
2024-12-10 17:42:34,110,9517,48,62,6843.46,12244.06,0.00
2024-12-10 17:42:34,109,9517,48,61,6957.92,12244.06,0.00
2024-12-10 17:42:34,109,9518,48,61,6911.28,12245.00,0.00
2024-12-10 17:42:34,110,9518,49,61,6848.45,12245.01,0.00
2024-12-10 17:42:34,109,9518,49,60,6885.48,12245.08,0.00
2024-12-10 17:42:34,108,9518,48,60,6914.10,12245.16,0.00
2024-12-10 17:42:34,108,9519,48,60,7038.21,12246.00,0.00
2024-12-10 17:42:35,109,9519,48,61,6973.64,12246.01,0.00
2024-12-10 17:42:35,110,9518,48,62,6909.13,12246.04,0.00
2024-12-10 17:42:35,111,9517,49,62,6834.01,12246.80,0.00
2024-12-10 17:42:35,111,9518,49,62,6919.63,12247.00,0.00
2024-12-10 17:42:35,112,9518,50,62,6857.84,12247.01,0.00
2024-12-10 17:42:35,112,9519,50,62,7012.11,12248.00,0.00
2024-12-10 17:42:35,113,9519,50,63,6950.06,12248.01,0.00
2024-12-10 17:42:35,113,9520,50,63,6872.34,12249.00,0.00
2024-12-10 17:42:35,114,9520,50,64,6812.06,12249.01,0.00
2024-12-10 17:42:35,113,9520,50,63,6859.37,12249.10,0.00
2024-12-10 17:42:35,114,9519,50,64,6788.47,12249.20,0.00
2024-12-10 17:42:35,113,9519,49,64,6799.77,12249.88,0.00
2024-12-10 17:42:35,113,9520,49,64,6894.18,12250.00,0.00
2024-12-10 17:42:35,114,9520,49,65,6833.70,12250.01,0.00
2024-12-10 17:42:35,113,9520,49,64,6868.20,12250.10,0.00
2024-12-10 17:42:35,112,9520,48,64,6822.40,12250.67,0.00
2024-12-10 17:42:35,112,9521,48,64,7000.95,12251.00,0.00
2024-12-10 17:42:35,113,9521,48,65,6939.00,12251.01,0.00
2024-12-10 17:42:35,112,9521,48,64,6975.83,12251.10,0.00
2024-12-10 17:42:35,112,9522,48,64,6931.51,12252.00,0.00
2024-12-10 17:42:35,113,9522,49,64,6870.17,12252.01,0.00
2024-12-10 17:42:35,112,9522,49,63,6906.39,12252.10,0.00
2024-12-10 17:42:35,112,9523,49,63,6862.06,12253.00,0.00
2024-12-10 17:42:35,113,9523,50,63,6801.33,12253.01,0.00
2024-12-10 17:42:35,112,9523,50,62,6838.03,12253.10,0.00
2024-12-10 17:42:35,111,9523,49,62,6855.57,12253.37,0.00
2024-12-10 17:42:35,111,9524,49,62,6889.12,12254.00,0.00
2024-12-10 17:42:35,112,9524,49,63,6827.61,12254.01,0.00
2024-12-10 17:42:35,111,9524,49,62,6881.42,12254.06,0.00
2024-12-10 17:42:35,110,9524,48,62,6923.93,12254.10,0.00
2024-12-10 17:42:35,109,9524,48,61,6966.09,12254.11,0.00
2024-12-10 17:42:35,109,9525,48,61,6970.00,12255.00,0.00
2024-12-10 17:42:35,110,9525,49,61,6906.64,12255.01,0.00
2024-12-10 17:42:35,109,9525,49,60,6935.18,12255.11,0.00
2024-12-10 17:42:35,108,9525,48,60,6942.70,12255.23,0.00
2024-12-10 17:42:35,108,9526,48,60,6962.48,12256.00,0.00
2024-12-10 17:42:35,109,9526,48,61,6898.60,12256.01,0.00
2024-12-10 17:42:35,108,9526,48,60,6954.57,12256.06,0.00
2024-12-10 17:42:35,107,9526,48,59,6992.08,12256.10,0.00
2024-12-10 17:42:35,107,9527,48,59,6951.38,12257.00,0.00
2024-12-10 17:42:35,108,9527,48,60,6887.01,12257.01,0.00
2024-12-10 17:42:35,107,9527,47,60,6939.99,12257.09,0.00
2024-12-10 17:42:35,106,9527,46,60,6880.75,12257.82,0.00
2024-12-10 17:42:35,106,9528,46,60,6974.56,12258.00,0.00
2024-12-10 17:42:35,107,9528,46,61,6909.38,12258.01,0.00
2024-12-10 17:42:35,106,9528,46,60,6966.50,12258.07,0.00
2024-12-10 17:42:35,105,9528,46,59,7018.85,12258.12,0.00
2024-12-10 17:42:35,104,9528,45,59,7042.75,12258.17,0.00
2024-12-10 17:42:35,105,9527,46,59,6896.65,12258.84,0.00
2024-12-10 17:42:35,105,9528,46,59,7008.87,12259.00,0.00
2024-12-10 17:42:35,106,9528,46,60,6942.75,12259.01,0.00
2024-12-10 17:42:35,105,9528,46,59,7000.73,12259.07,0.00
2024-12-10 17:42:35,104,9528,45,59,7037.41,12259.10,0.00
2024-12-10 17:42:35,103,9528,44,59,7066.49,12259.22,0.00
2024-12-10 17:42:35,103,9529,44,59,7209.82,12260.00,0.00
2024-12-10 17:42:35,104,9529,45,59,7140.50,12260.01,0.00
2024-12-10 17:42:35,103,9529,45,58,7192.01,12260.11,0.00
2024-12-10 17:42:35,103,9530,45,58,7093.00,12261.00,0.00
2024-12-10 17:42:35,104,9530,45,59,7024.80,12261.01,0.00
2024-12-10 17:42:35,105,9529,46,59,6957.90,12261.03,0.00
2024-12-10 17:42:35,106,9528,46,60,6822.04,12261.74,0.00
2024-12-10 17:42:35,105,9528,46,59,6905.79,12261.84,0.00
2024-12-10 17:42:35,105,9529,46,59,7002.85,12262.00,0.00
2024-12-10 17:42:35,106,9529,47,59,6936.78,12262.01,0.00
2024-12-10 17:42:35,105,9529,47,58,6939.83,12262.10,0.00
2024-12-10 17:42:35,104,9529,46,58,6971.83,12262.38,0.00
2024-12-10 17:42:35,104,9530,46,58,7250.52,12263.00,0.00
2024-12-10 17:42:35,105,9530,46,59,7181.47,12263.01,0.00
2024-12-10 17:42:35,105,9531,46,59,7107.30,12264.00,0.00
2024-12-10 17:42:35,106,9531,46,60,7040.25,12264.01,0.00
2024-12-10 17:42:35,105,9531,45,60,7102.65,12264.04,0.00
2024-12-10 17:42:35,104,9531,44,60,7169.77,12264.04,0.00
2024-12-10 17:42:35,103,9531,43,60,7210.82,12264.09,0.00
2024-12-10 17:42:35,102,9531,43,59,7276.70,12264.09,0.00
2024-12-10 17:42:35,102,9532,43,59,7285.67,12265.00,0.00
2024-12-10 17:42:35,103,9532,43,60,7214.94,12265.01,0.00
2024-12-10 17:42:35,103,9533,43,60,7141.69,12266.00,0.00
2024-12-10 17:42:35,104,9533,44,60,7073.02,12266.01,0.00
2024-12-10 17:42:35,103,9533,43,60,7135.76,12266.05,0.00
2024-12-10 17:42:35,102,9533,43,59,7198.52,12266.08,0.00
2024-12-10 17:42:35,101,9533,42,59,7172.82,12266.52,0.00
2024-12-10 17:42:35,101,9534,42,59,7236.34,12267.00,0.00
2024-12-10 17:42:35,102,9534,42,60,7165.39,12267.01,0.00
2024-12-10 17:42:35,102,9535,42,60,7092.61,12268.00,0.00
2024-12-10 17:42:35,103,9535,42,61,7023.75,12268.01,0.00
2024-12-10 17:42:35,102,9535,42,60,7075.81,12268.10,0.00
2024-12-10 17:42:35,102,9536,42,60,7037.86,12269.00,0.00
2024-12-10 17:42:35,103,9536,42,61,6969.53,12269.01,0.00
2024-12-10 17:42:35,103,9537,42,61,6895.11,12270.00,0.00
2024-12-10 17:42:35,104,9537,43,61,6828.81,12270.01,0.00
2024-12-10 17:42:35,103,9537,43,60,6876.09,12270.11,0.00
2024-12-10 17:42:35,104,9536,44,60,6754.71,12270.58,0.00
2024-12-10 17:42:35,103,9536,43,60,6800.75,12270.72,0.00
2024-12-10 17:42:35,103,9537,43,60,6885.56,12271.00,0.00
2024-12-10 17:42:35,104,9537,43,61,6819.35,12271.01,0.00
2024-12-10 17:42:35,103,9537,42,61,6828.48,12271.28,0.00
2024-12-10 17:42:35,103,9538,42,61,6929.83,12272.00,0.00
2024-12-10 17:42:35,104,9538,43,61,6863.19,12272.01,0.00
2024-12-10 17:42:35,103,9538,43,60,6911.99,12272.11,0.00
2024-12-10 17:42:35,103,9539,43,60,6872.67,12273.00,0.00
2024-12-10 17:42:36,104,9539,44,60,6806.58,12273.01,0.00
2024-12-10 17:42:36,103,9539,43,60,6863.17,12273.08,0.00
2024-12-10 17:42:36,104,9538,43,61,6752.39,12273.27,0.00
2024-12-10 17:42:36,103,9538,42,61,6830.00,12273.55,0.00
2024-12-10 17:42:36,103,9539,42,61,6891.62,12274.00,0.00
2024-12-10 17:42:36,104,9539,43,61,6825.35,12274.01,0.00
2024-12-10 17:42:36,103,9539,43,60,6876.17,12274.10,0.00
2024-12-10 17:42:36,102,9539,42,60,6921.99,12274.27,0.00
2024-12-10 17:42:36,102,9540,42,60,7020.80,12275.00,0.00
2024-12-10 17:42:36,103,9540,43,60,6952.64,12275.01,0.00
2024-12-10 17:42:36,103,9541,43,60,6871.88,12276.00,0.00
2024-12-10 17:42:36,104,9541,43,61,6805.81,12276.01,0.00
2024-12-10 17:42:36,103,9541,43,60,6844.52,12276.16,0.00
2024-12-10 17:42:36,104,9540,44,60,6730.23,12276.57,0.00
2024-12-10 17:42:36,104,9541,44,60,6755.57,12277.00,0.00
2024-12-10 17:42:36,105,9541,44,61,6691.23,12277.01,0.00
2024-12-10 17:42:36,104,9541,43,61,6744.57,12277.10,0.00
2024-12-10 17:42:36,103,9541,42,61,6744.51,12277.16,0.00
2024-12-10 17:42:36,103,9542,42,61,6868.83,12278.00,0.00
2024-12-10 17:42:36,104,9542,42,62,6802.78,12278.01,0.00
2024-12-10 17:42:36,103,9542,41,62,6722.26,12278.63,0.00
2024-12-10 17:42:36,103,9543,41,62,6796.44,12279.00,0.00
2024-12-10 17:42:36,104,9543,42,62,6731.09,12279.01,0.00
2024-12-10 17:42:36,103,9543,42,61,6769.07,12279.16,0.00
2024-12-10 17:42:36,103,9544,42,61,6724.42,12280.00,0.00
2024-12-10 17:42:36,104,9544,42,62,6659.77,12280.01,0.00
2024-12-10 17:42:36,103,9544,41,62,6717.30,12280.06,0.00
2024-12-10 17:42:36,102,9544,40,62,6630.25,12280.76,0.00
2024-12-10 17:42:36,102,9545,40,62,6721.94,12281.00,0.00
2024-12-10 17:42:36,103,9545,41,62,6656.68,12281.01,0.00
2024-12-10 17:42:36,102,9545,40,62,6661.84,12281.30,0.00
2024-12-10 17:42:36,101,9545,39,62,6701.10,12281.34,0.00
2024-12-10 17:42:36,101,9546,39,62,6728.37,12282.00,0.00
2024-12-10 17:42:36,102,9546,39,63,6662.40,12282.01,0.00
2024-12-10 17:42:36,101,9546,38,63,6721.10,12282.06,0.00
2024-12-10 17:42:36,100,9546,38,62,6768.68,12282.14,0.00
2024-12-10 17:42:36,99,9546,38,61,6780.06,12282.54,0.00
2024-12-10 17:42:36,99,9547,38,61,6797.55,12283.00,0.00
2024-12-10 17:42:36,100,9547,38,62,6729.58,12283.01,0.00
2024-12-10 17:42:36,100,9548,38,62,6656.22,12284.00,0.00
2024-12-10 17:42:36,101,9548,39,62,6590.31,12284.01,0.00
2024-12-10 17:42:36,100,9548,38,62,6623.09,12284.11,0.00
2024-12-10 17:42:36,99,9548,38,61,6687.51,12284.12,0.00
2024-12-10 17:42:36,98,9548,38,60,6744.48,12284.15,0.00
2024-12-10 17:42:36,99,9547,39,60,6665.22,12284.26,0.00
2024-12-10 17:42:36,98,9547,38,60,6796.15,12284.40,0.00
2024-12-10 17:42:36,98,9548,38,60,6847.95,12285.00,0.00
2024-12-10 17:42:36,99,9548,39,60,6778.78,12285.01,0.00
2024-12-10 17:42:36,98,9548,39,59,6813.88,12285.11,0.00
2024-12-10 17:42:36,98,9549,39,59,6904.18,12286.00,0.00
2024-12-10 17:42:36,99,9549,39,60,6834.44,12286.01,0.00
2024-12-10 17:42:36,98,9549,38,60,6891.08,12286.11,0.00
2024-12-10 17:42:36,98,9550,38,60,6881.03,12287.00,0.00
2024-12-10 17:42:36,99,9550,38,61,6811.52,12287.01,0.00
2024-12-10 17:42:36,98,9550,38,60,6852.22,12287.09,0.00
2024-12-10 17:42:36,98,9551,38,60,6814.22,12288.00,0.00
2024-12-10 17:42:36,99,9551,39,60,6745.39,12288.01,0.00
2024-12-10 17:42:36,99,9552,39,60,6703.38,12289.00,0.00
2024-12-10 17:42:36,100,9552,40,60,6636.35,12289.01,0.00
2024-12-10 17:42:36,100,9553,40,60,6577.64,12290.00,0.00
2024-12-10 17:42:36,101,9553,41,60,6512.51,12290.01,0.00
2024-12-10 17:42:36,100,9553,40,60,6455.69,12290.77,0.00
2024-12-10 17:42:36,100,9554,40,60,6501.34,12291.00,0.00
2024-12-10 17:42:36,101,9554,40,61,6436.97,12291.01,0.00
2024-12-10 17:42:36,100,9554,40,60,6493.99,12291.06,0.00
2024-12-10 17:42:36,99,9554,40,59,6549.66,12291.11,0.00
2024-12-10 17:42:36,99,9555,40,59,6511.81,12292.00,0.00
2024-12-10 17:42:36,100,9555,40,60,6446.69,12292.01,0.00
2024-12-10 17:42:36,99,9555,40,59,6474.59,12292.11,0.00
2024-12-10 17:42:36,98,9555,39,59,6474.33,12292.49,0.00
2024-12-10 17:42:36,98,9556,39,59,6532.90,12293.00,0.00
2024-12-10 17:42:36,99,9556,40,59,6466.91,12293.01,0.00
2024-12-10 17:42:36,98,9556,39,59,6496.55,12293.07,0.00
2024-12-10 17:42:36,97,9556,39,58,6534.38,12293.10,0.00
2024-12-10 17:42:36,97,9557,39,58,6546.63,12294.00,0.00
2024-12-10 17:42:36,98,9557,39,59,6479.83,12294.01,0.00
2024-12-10 17:42:36,97,9557,39,58,6509.91,12294.10,0.00
2024-12-10 17:42:36,97,9558,39,58,6471.28,12295.00,0.00
2024-12-10 17:42:36,98,9558,40,58,6405.24,12295.01,0.00
2024-12-10 17:42:36,97,9558,40,57,6434.55,12295.10,0.00
2024-12-10 17:42:36,96,9558,39,57,6421.06,12295.54,0.00
2024-12-10 17:42:36,97,9557,39,58,6346.04,12295.63,0.00
2024-12-10 17:42:36,97,9558,39,58,6464.51,12296.00,0.00
2024-12-10 17:42:36,98,9558,40,58,6398.55,12296.01,0.00
2024-12-10 17:42:36,97,9558,40,57,6427.78,12296.10,0.00
2024-12-10 17:42:36,96,9558,39,57,6477.34,12296.18,0.00
2024-12-10 17:42:36,96,9559,39,57,6628.30,12297.00,0.00
2024-12-10 17:42:36,97,9559,39,58,6559.96,12297.01,0.00
2024-12-10 17:42:36,96,9559,39,57,6592.46,12297.10,0.00
2024-12-10 17:42:36,95,9559,38,57,6634.74,12297.32,0.00
2024-12-10 17:42:36,94,9559,37,57,6667.42,12297.39,0.00
2024-12-10 17:42:36,94,9560,37,57,6719.09,12298.00,0.00
2024-12-10 17:42:36,95,9560,38,57,6648.36,12298.01,0.00
2024-12-10 17:42:36,94,9560,38,56,6682.48,12298.11,0.00
2024-12-10 17:42:36,95,9559,38,57,6612.14,12298.13,0.00
2024-12-10 17:42:36,95,9560,38,57,6705.42,12299.00,0.00
2024-12-10 17:42:36,96,9560,38,58,6635.57,12299.01,0.00
2024-12-10 17:42:36,95,9560,37,58,6567.82,12299.83,0.00
2024-12-10 17:42:36,95,9561,37,58,6806.18,12300.00,0.00
2024-12-10 17:42:36,96,9561,37,59,6735.28,12300.01,0.00
2024-12-10 17:42:36,97,9560,38,59,6608.86,12300.29,0.00
2024-12-10 17:42:37,97,9561,38,59,6666.02,12301.00,0.00
2024-12-10 17:42:37,98,9561,38,60,6598.00,12301.01,0.00
2024-12-10 17:42:37,97,9561,38,59,6658.43,12301.06,0.00
2024-12-10 17:42:37,96,9561,38,58,6726.51,12301.06,0.00
2024-12-10 17:42:37,97,9560,38,59,6616.62,12301.21,0.00
2024-12-10 17:42:37,97,9561,38,59,6846.87,12302.00,0.00
2024-12-10 17:42:37,98,9561,39,59,6777.01,12302.01,0.00
2024-12-10 17:42:37,99,9560,40,59,6615.59,12302.59,0.00
2024-12-10 17:42:37,99,9561,40,59,6807.27,12303.00,0.00
2024-12-10 17:42:37,100,9561,40,60,6739.20,12303.01,0.00
2024-12-10 17:42:37,99,9561,40,59,6794.88,12303.09,0.00
2024-12-10 17:42:37,100,9560,41,59,6671.76,12303.56,0.00
2024-12-10 17:42:37,100,9561,41,59,6860.33,12304.00,0.00
2024-12-10 17:42:37,101,9561,41,60,6792.40,12304.01,0.00
2024-12-10 17:42:37,100,9561,41,59,6781.61,12304.09,0.00
2024-12-10 17:42:37,101,9560,42,59,6663.47,12304.52,0.00
2024-12-10 17:42:37,100,9560,41,59,6790.91,12304.76,0.00
2024-12-10 17:42:37,100,9561,41,59,7007.66,12305.00,0.00
2024-12-10 17:42:37,101,9561,41,60,6938.28,12305.01,0.00
2024-12-10 17:42:37,100,9561,41,59,6968.32,12305.12,0.00
2024-12-10 17:42:37,100,9562,41,59,7057.46,12306.00,0.00
2024-12-10 17:42:37,101,9562,42,59,6987.58,12306.01,0.00
2024-12-10 17:42:37,100,9562,42,58,7018.10,12306.12,0.00
2024-12-10 17:42:37,99,9562,41,58,7030.63,12306.25,0.00
2024-12-10 17:42:37,99,9563,41,58,7063.44,12307.00,0.00
2024-12-10 17:42:37,100,9563,42,58,6992.80,12307.01,0.00
2024-12-10 17:42:37,99,9563,42,57,7023.68,12307.12,0.00
2024-12-10 17:42:37,98,9563,41,57,7005.16,12307.58,0.00
2024-12-10 17:42:37,98,9564,41,57,7079.58,12308.00,0.00
2024-12-10 17:42:37,99,9564,42,57,7008.07,12308.01,0.00
2024-12-10 17:42:37,98,9564,41,57,7048.19,12308.03,0.00
2024-12-10 17:42:37,97,9564,41,56,7119.58,12308.03,0.00
2024-12-10 17:42:37,96,9564,41,55,7189.90,12308.05,0.00
2024-12-10 17:42:37,97,9563,41,56,7049.91,12308.40,0.00
2024-12-10 17:42:37,97,9564,41,56,7165.31,12309.00,0.00
2024-12-10 17:42:37,98,9564,42,56,7092.19,12309.01,0.00
2024-12-10 17:42:37,97,9564,42,55,7128.54,12309.12,0.00
2024-12-10 17:42:37,96,9564,41,55,7127.72,12309.72,0.00
2024-12-10 17:42:37,96,9565,41,55,7298.49,12310.00,0.00
2024-12-10 17:42:37,97,9565,42,55,7223.25,12310.01,0.00
2024-12-10 17:42:37,97,9566,42,55,7151.23,12311.00,0.00
2024-12-10 17:42:37,98,9566,42,56,7078.26,12311.01,0.00
2024-12-10 17:42:37,97,9566,42,55,7136.03,12311.12,0.00
2024-12-10 17:42:37,97,9567,42,55,7102.77,12312.00,0.00
2024-12-10 17:42:37,98,9567,43,55,7030.30,12312.01,0.00
2024-12-10 17:42:37,97,9567,43,54,7093.79,12312.08,0.00
2024-12-10 17:42:37,96,9567,42,54,7113.89,12312.30,0.00
2024-12-10 17:42:37,96,9568,42,54,7102.74,12313.00,0.00
2024-12-10 17:42:37,97,9568,43,54,7029.52,12313.01,0.00
2024-12-10 17:42:37,96,9568,43,53,7088.66,12313.11,0.00
2024-12-10 17:42:37,95,9568,42,53,7140.01,12313.29,0.00
2024-12-10 17:42:37,96,9567,42,54,7005.02,12313.78,0.00
2024-12-10 17:42:37,96,9568,42,54,7073.19,12314.00,0.00
2024-12-10 17:42:37,97,9568,42,55,7000.27,12314.01,0.00
2024-12-10 17:42:37,97,9569,42,55,7053.06,12315.00,0.00
2024-12-10 17:42:37,98,9569,43,55,6981.09,12315.01,0.00
2024-12-10 17:42:37,97,9569,43,54,7035.32,12315.13,0.00
2024-12-10 17:42:37,97,9570,43,54,7001.33,12316.00,0.00
2024-12-10 17:42:37,98,9570,44,54,6929.88,12316.01,0.00
2024-12-10 17:42:37,99,9569,44,55,6812.66,12316.21,0.00
2024-12-10 17:42:37,99,9570,44,55,6876.39,12317.00,0.00
2024-12-10 17:42:37,100,9570,45,55,6807.62,12317.01,0.00
2024-12-10 17:42:37,99,9570,45,54,6857.76,12317.14,0.00
2024-12-10 17:42:37,99,9571,45,54,6947.77,12318.00,0.00
2024-12-10 17:42:37,100,9571,45,55,6878.29,12318.01,0.00
2024-12-10 17:42:37,100,9572,45,55,6842.74,12319.00,0.00
2024-12-10 17:42:37,101,9572,45,56,6774.99,12319.01,0.00
2024-12-10 17:42:37,101,9573,45,56,6735.69,12320.00,0.00
2024-12-10 17:42:37,102,9573,46,56,6669.66,12320.01,0.00
2024-12-10 17:42:37,101,9573,46,55,6715.19,12320.17,0.00
2024-12-10 17:42:37,101,9574,46,55,6686.80,12321.00,0.00
2024-12-10 17:42:37,102,9574,46,56,6621.25,12321.01,0.00
2024-12-10 17:42:37,101,9574,46,55,6679.50,12321.06,0.00
2024-12-10 17:42:37,100,9574,45,55,6646.38,12321.48,0.00
2024-12-10 17:42:37,101,9573,45,56,6545.89,12321.75,0.00
2024-12-10 17:42:37,101,9574,45,56,6660.77,12322.00,0.00
2024-12-10 17:42:37,102,9574,45,57,6595.47,12322.01,0.00
2024-12-10 17:42:37,101,9574,45,56,6653.46,12322.06,0.00
2024-12-10 17:42:37,100,9574,45,55,6690.45,12322.15,0.00
2024-12-10 17:42:37,99,9574,44,55,6702.42,12322.57,0.00
2024-12-10 17:42:37,99,9575,44,55,6848.37,12323.00,0.00
2024-12-10 17:42:37,100,9575,45,55,6779.89,12323.01,0.00
2024-12-10 17:42:37,101,9574,46,55,6709.11,12323.06,0.00
2024-12-10 17:42:37,101,9575,46,55,6734.59,12324.00,0.00
2024-12-10 17:42:37,102,9575,46,56,6668.57,12324.01,0.00
2024-12-10 17:42:37,101,9575,46,55,6712.67,12324.16,0.00
2024-12-10 17:42:37,102,9574,46,56,6584.69,12324.63,0.00
2024-12-10 17:42:37,103,9573,47,56,6585.48,12324.77,0.00
2024-12-10 17:42:37,103,9574,47,56,6771.13,12325.00,0.00
2024-12-10 17:42:37,104,9574,47,57,6706.02,12325.01,0.00
2024-12-10 17:42:37,105,9573,48,57,6510.88,12325.52,0.00
2024-12-10 17:42:37,106,9572,48,58,6469.67,12325.67,0.00
2024-12-10 17:42:37,106,9573,48,58,6805.96,12326.00,0.00
2024-12-10 17:42:37,107,9573,48,59,6742.36,12326.01,0.00
2024-12-10 17:42:37,106,9573,48,58,6785.07,12326.15,0.00
2024-12-10 17:42:37,105,9573,47,58,6786.44,12326.49,0.00
2024-12-10 17:42:37,106,9572,48,58,6721.27,12326.51,0.00
2024-12-10 17:42:37,106,9573,48,58,7103.56,12327.00,0.00
2024-12-10 17:42:37,107,9573,48,59,7037.18,12327.01,0.00
2024-12-10 17:42:37,106,9573,47,59,7013.01,12327.43,0.00
2024-12-10 17:42:37,107,9572,48,59,6902.00,12327.75,0.00
2024-12-10 17:42:38,107,9573,48,59,7113.75,12328.00,0.00
2024-12-10 17:42:38,108,9573,48,60,7047.88,12328.01,0.00
2024-12-10 17:42:38,107,9573,48,59,7084.98,12328.12,0.00
2024-12-10 17:42:38,107,9574,48,59,7143.98,12329.00,0.00
2024-12-10 17:42:38,108,9574,48,60,7077.83,12329.01,0.00
2024-12-10 17:42:38,107,9574,47,60,7117.48,12329.03,0.00
2024-12-10 17:42:38,106,9574,47,59,7170.70,12329.13,0.00
2024-12-10 17:42:38,105,9574,47,58,7214.33,12329.13,0.00
2024-12-10 17:42:38,105,9575,47,58,7207.14,12330.00,0.00
2024-12-10 17:42:38,106,9575,48,58,7139.14,12330.01,0.00
2024-12-10 17:42:38,105,9575,48,57,7167.24,12330.13,0.00
2024-12-10 17:42:38,105,9576,48,57,7112.91,12331.00,0.00
2024-12-10 17:42:38,106,9576,49,57,7045.81,12331.01,0.00
2024-12-10 17:42:38,105,9576,49,56,7073.01,12331.13,0.00
2024-12-10 17:42:38,105,9577,49,56,7019.92,12332.00,0.00
2024-12-10 17:42:38,106,9577,50,56,6953.70,12332.01,0.00
2024-12-10 17:42:38,105,9577,49,56,7011.72,12332.05,0.00
2024-12-10 17:42:38,104,9577,48,56,6961.94,12332.72,0.00
2024-12-10 17:42:38,104,9578,48,56,7033.04,12333.00,0.00
2024-12-10 17:42:38,105,9578,49,56,6966.05,12333.01,0.00
2024-12-10 17:42:38,104,9578,49,55,7016.46,12333.13,0.00
2024-12-10 17:42:38,104,9579,49,55,6946.57,12334.00,0.00
2024-12-10 17:42:38,105,9579,50,55,6880.41,12334.01,0.00
2024-12-10 17:42:38,104,9579,49,55,6938.28,12334.07,0.00
2024-12-10 17:42:38,104,9580,49,55,6845.23,12335.00,0.00
2024-12-10 17:42:38,105,9580,49,56,6780.03,12335.01,0.00
2024-12-10 17:42:38,104,9580,49,55,6829.83,12335.12,0.00
2024-12-10 17:42:38,104,9581,49,55,6778.15,12336.00,0.00
2024-12-10 17:42:38,105,9581,49,56,6713.60,12336.01,0.00
2024-12-10 17:42:38,104,9581,48,56,6771.05,12336.06,0.00
2024-12-10 17:42:38,103,9581,47,56,6834.40,12336.07,0.00
2024-12-10 17:42:38,102,9581,47,55,6888.10,12336.09,0.00
2024-12-10 17:42:38,101,9581,46,55,6931.95,12336.29,0.00
2024-12-10 17:42:38,100,9581,45,55,6988.95,12336.33,0.00
2024-12-10 17:42:38,99,9581,44,55,6972.01,12336.90,0.00
2024-12-10 17:42:38,99,9582,44,55,7084.24,12337.00,0.00
2024-12-10 17:42:38,100,9582,44,56,7013.40,12337.01,0.00
2024-12-10 17:42:38,99,9582,44,55,7048.13,12337.09,0.00
2024-12-10 17:42:38,98,9582,43,55,7091.10,12337.10,0.00
2024-12-10 17:42:38,97,9582,43,54,7132.39,12337.35,0.00
2024-12-10 17:42:38,97,9583,43,54,7179.22,12338.00,0.00
2024-12-10 17:42:38,98,9583,44,54,7105.97,12338.01,0.00
2024-12-10 17:42:38,97,9583,43,54,7175.42,12338.04,0.00
2024-12-10 17:42:38,97,9584,43,54,7140.90,12339.00,0.00
2024-12-10 17:42:38,98,9584,44,54,7068.03,12339.01,0.00
2024-12-10 17:42:38,98,9585,44,54,7012.60,12340.00,0.00
2024-12-10 17:42:38,99,9585,44,55,6941.77,12340.01,0.00
2024-12-10 17:42:38,98,9585,43,55,7003.81,12340.07,0.00
2024-12-10 17:42:38,98,9586,43,55,6935.17,12341.00,0.00
2024-12-10 17:42:38,99,9586,44,55,6865.12,12341.01,0.00
2024-12-10 17:42:38,100,9585,45,55,6792.77,12341.06,0.00
2024-12-10 17:42:38,99,9585,45,54,6947.42,12341.08,0.00
2024-12-10 17:42:38,98,9585,44,54,6859.87,12341.98,0.00
2024-12-10 17:42:38,98,9586,44,54,6983.30,12342.00,0.00
2024-12-10 17:42:38,99,9586,44,55,6912.76,12342.01,0.00
2024-12-10 17:42:38,98,9586,44,54,6953.10,12342.07,0.00
2024-12-10 17:42:38,97,9586,43,54,6994.26,12342.10,0.00
2024-12-10 17:42:38,98,9585,43,55,6909.07,12342.23,0.00
2024-12-10 17:42:38,99,9584,43,56,6846.09,12342.80,0.00
2024-12-10 17:42:38,99,9585,43,56,7091.72,12343.00,0.00
2024-12-10 17:42:38,100,9585,43,57,7020.80,12343.01,0.00
2024-12-10 17:42:38,101,9584,43,58,6946.42,12343.07,0.00
2024-12-10 17:42:38,100,9584,43,57,7043.05,12343.08,0.00
2024-12-10 17:42:38,100,9585,43,57,7238.83,12344.00,0.00
2024-12-10 17:42:38,101,9585,44,57,7167.16,12344.01,0.00
2024-12-10 17:42:38,100,9585,43,57,7129.61,12344.44,0.00
2024-12-10 17:42:38,99,9585,42,57,7161.58,12344.71,0.00
2024-12-10 17:42:38,99,9586,42,57,7375.04,12345.00,0.00
2024-12-10 17:42:38,100,9586,42,58,7301.28,12345.01,0.00
2024-12-10 17:42:38,101,9585,42,59,7229.00,12345.03,0.00
2024-12-10 17:42:38,101,9586,42,59,7251.68,12346.00,0.00
2024-12-10 17:42:38,102,9586,42,60,7180.58,12346.01,0.00
2024-12-10 17:42:38,101,9586,42,59,7249.24,12346.02,0.00
2024-12-10 17:42:38,100,9586,42,58,7303.24,12346.07,0.00
2024-12-10 17:42:38,100,9587,42,58,7377.13,12347.00,0.00
2024-12-10 17:42:38,101,9587,43,58,7304.09,12347.01,0.00
2024-12-10 17:42:38,102,9586,44,58,7067.48,12347.89,0.00
2024-12-10 17:42:39,102,9587,44,58,7182.58,12348.00,0.00
2024-12-10 17:42:39,103,9587,44,59,7112.85,12348.01,0.00
2024-12-10 17:42:39,104,9586,45,59,6967.47,12348.46,0.00
2024-12-10 17:42:39,104,9587,45,59,7165.66,12349.00,0.00
2024-12-10 17:42:39,105,9587,46,59,7097.42,12349.01,0.00
2024-12-10 17:42:39,104,9587,46,58,7139.58,12349.07,0.00
2024-12-10 17:42:39,104,9588,46,58,7195.71,12350.00,0.00
2024-12-10 17:42:39,105,9588,46,59,7127.18,12350.01,0.00
2024-12-10 17:42:39,104,9588,46,58,7178.23,12350.07,0.00
2024-12-10 17:42:39,103,9588,45,58,7185.47,12350.50,0.00
2024-12-10 17:42:39,102,9588,44,58,7206.33,12350.60,0.00
2024-12-10 17:42:39,102,9589,44,58,7270.02,12351.00,0.00
2024-12-10 17:42:39,103,9589,45,58,7199.44,12351.01,0.00
2024-12-10 17:42:39,104,9588,45,59,7016.63,12351.68,0.00
2024-12-10 17:42:39,104,9589,45,59,7091.80,12352.00,0.00
2024-12-10 17:42:39,105,9589,45,60,7024.26,12352.01,0.00
2024-12-10 17:42:39,104,9589,44,60,7086.11,12352.05,0.00
2024-12-10 17:42:39,104,9590,44,60,7124.90,12353.00,0.00
2024-12-10 17:42:39,105,9590,45,60,7057.05,12353.01,0.00
2024-12-10 17:42:39,104,9590,45,59,7105.93,12353.06,0.00
2024-12-10 17:42:39,103,9590,44,59,7150.99,12353.24,0.00
2024-12-10 17:42:39,102,9590,43,59,7150.96,12353.74,0.00
2024-12-10 17:42:39,102,9591,43,59,7187.80,12354.00,0.00
2024-12-10 17:42:39,103,9591,43,60,7118.02,12354.01,0.00
2024-12-10 17:42:39,102,9591,43,59,7163.62,12354.07,0.00
2024-12-10 17:42:39,103,9590,44,59,7062.97,12354.34,0.00
2024-12-10 17:42:39,104,9589,44,60,7021.23,12354.41,0.00
2024-12-10 17:42:39,104,9590,44,60,7072.50,12355.00,0.00
2024-12-10 17:42:39,105,9590,44,61,7005.14,12355.01,0.00
2024-12-10 17:42:39,104,9590,44,60,7048.78,12355.07,0.00
2024-12-10 17:42:39,103,9590,43,60,7095.67,12355.23,0.00
2024-12-10 17:42:39,102,9590,42,60,7080.70,12355.71,0.00
2024-12-10 17:42:39,102,9591,42,60,7397.36,12356.00,0.00
2024-12-10 17:42:39,103,9591,42,61,7325.54,12356.01,0.00
2024-12-10 17:42:39,102,9591,42,60,7373.17,12356.07,0.00
2024-12-10 17:42:39,101,9591,41,60,7422.93,12356.09,0.00
2024-12-10 17:42:39,101,9592,41,60,7415.42,12357.00,0.00
2024-12-10 17:42:39,102,9592,42,60,7342.71,12357.01,0.00
2024-12-10 17:42:39,101,9592,42,59,7384.87,12357.09,0.00
2024-12-10 17:42:39,100,9592,41,59,7379.70,12357.47,0.00
2024-12-10 17:42:39,101,9591,41,60,7243.82,12357.98,0.00
2024-12-10 17:42:39,101,9592,41,60,7376.46,12358.00,0.00
2024-12-10 17:42:39,102,9592,41,61,7304.15,12358.01,0.00
2024-12-10 17:42:39,101,9592,41,60,7337.36,12358.12,0.00
2024-12-10 17:42:39,100,9592,40,60,7358.37,12358.38,0.00
2024-12-10 17:42:39,100,9593,40,60,7503.38,12359.00,0.00
2024-12-10 17:42:39,101,9593,40,61,7429.09,12359.01,0.00
2024-12-10 17:42:39,101,9594,40,61,7320.21,12360.00,0.00
2024-12-10 17:42:39,102,9594,40,62,7248.44,12360.01,0.00
2024-12-10 17:42:39,101,9594,40,61,7305.57,12360.12,0.00
2024-12-10 17:42:39,101,9595,40,61,7242.57,12361.00,0.00
2024-12-10 17:42:39,102,9595,40,62,7171.56,12361.01,0.00
2024-12-10 17:42:39,101,9595,39,62,7236.48,12361.05,0.00
2024-12-10 17:42:39,100,9595,38,62,7190.56,12361.71,0.00
2024-12-10 17:42:39,99,9595,37,62,7225.04,12361.87,0.00
2024-12-10 17:42:39,99,9596,37,62,7326.79,12362.00,0.00
2024-12-10 17:42:39,100,9596,38,62,7253.52,12362.01,0.00
2024-12-10 17:42:39,99,9596,38,61,7313.10,12362.11,0.00
2024-12-10 17:42:39,99,9597,38,61,7263.49,12363.00,0.00
2024-12-10 17:42:39,100,9597,38,62,7190.85,12363.01,0.00
2024-12-10 17:42:39,100,9598,38,62,7132.64,12364.00,0.00
2024-12-10 17:42:39,101,9598,38,63,7062.02,12364.01,0.00
2024-12-10 17:42:39,101,9599,38,63,6982.43,12365.00,0.00
2024-12-10 17:42:39,102,9599,39,63,6913.97,12365.01,0.00
2024-12-10 17:42:39,101,9599,39,62,6943.30,12365.12,0.00
2024-12-10 17:42:39,100,9599,38,62,6914.36,12365.53,0.00
2024-12-10 17:42:39,101,9598,39,62,6825.73,12365.67,0.00
2024-12-10 17:42:39,100,9598,38,62,6907.49,12365.74,0.00
2024-12-10 17:42:39,100,9599,38,62,6981.82,12366.00,0.00
2024-12-10 17:42:39,101,9599,38,63,6912.70,12366.01,0.00
2024-12-10 17:42:39,100,9599,37,63,6937.35,12366.12,0.00
2024-12-10 17:42:39,100,9600,37,63,7024.25,12367.00,0.00
2024-12-10 17:42:39,101,9600,37,64,6954.70,12367.01,0.00
2024-12-10 17:42:39,100,9600,37,63,7004.50,12367.12,0.00
2024-12-10 17:42:39,101,9599,37,64,6893.66,12367.48,0.00
2024-12-10 17:42:39,100,9599,36,64,6951.91,12367.59,0.00
2024-12-10 17:42:39,100,9600,36,64,6998.34,12368.00,0.00
2024-12-10 17:42:39,101,9600,36,65,6929.05,12368.01,0.00
2024-12-10 17:42:39,102,9599,37,65,6855.09,12368.08,0.00
2024-12-10 17:42:39,103,9598,38,65,6861.84,12368.25,0.00
2024-12-10 17:42:39,103,9599,38,65,6988.44,12369.00,0.00
2024-12-10 17:42:39,104,9599,38,66,6921.24,12369.01,0.00
2024-12-10 17:42:39,103,9599,38,65,6970.48,12369.12,0.00
2024-12-10 17:42:39,102,9599,37,65,7013.43,12369.31,0.00
2024-12-10 17:42:39,103,9598,38,65,6920.22,12369.53,0.00
2024-12-10 17:42:39,102,9598,37,65,7008.69,12369.55,0.00
2024-12-10 17:42:39,101,9598,36,65,7053.14,12369.73,0.00
2024-12-10 17:42:39,102,9597,37,65,6970.11,12369.80,0.00
2024-12-10 17:42:39,102,9598,37,65,7312.65,12370.00,0.00
2024-12-10 17:42:39,103,9598,38,65,7241.65,12370.01,0.00
2024-12-10 17:42:39,102,9598,37,65,7192.92,12370.46,0.00
2024-12-10 17:42:39,103,9597,38,65,7093.22,12370.72,0.00
2024-12-10 17:42:39,102,9597,38,64,7189.14,12370.78,0.00
2024-12-10 17:42:39,102,9598,38,64,7526.48,12371.00,0.00
2024-12-10 17:42:39,103,9598,38,65,7453.41,12371.01,0.00
2024-12-10 17:42:39,102,9598,38,64,7518.03,12371.07,0.00
2024-12-10 17:42:39,101,9598,38,63,7582.67,12371.11,0.00
2024-12-10 17:42:39,101,9599,38,63,7659.77,12372.00,0.00
2024-12-10 17:42:39,102,9599,38,64,7584.67,12372.01,0.00
2024-12-10 17:42:39,103,9598,38,65,7393.46,12372.40,0.00
2024-12-10 17:42:39,103,9599,38,65,7493.13,12373.00,0.00
2024-12-10 17:42:39,104,9599,39,65,7421.08,12373.01,0.00
2024-12-10 17:42:39,103,9599,39,64,7477.56,12373.11,0.00
2024-12-10 17:42:39,102,9599,38,64,7533.60,12373.24,0.00
2024-12-10 17:42:39,101,9599,37,64,7556.92,12373.64,0.00
2024-12-10 17:42:39,101,9600,37,64,7750.67,12374.00,0.00
2024-12-10 17:42:39,102,9600,38,64,7674.68,12374.01,0.00
2024-12-10 17:42:39,101,9600,37,64,7691.97,12374.29,0.00
2024-12-10 17:42:40,102,9599,37,65,7614.14,12374.32,0.00
2024-12-10 17:42:40,101,9599,36,65,7742.74,12374.47,0.00
2024-12-10 17:42:40,101,9600,36,65,7743.71,12375.00,0.00
2024-12-10 17:42:40,102,9600,36,66,7667.79,12375.01,0.00
2024-12-10 17:42:40,101,9600,36,65,7726.60,12375.12,0.00
2024-12-10 17:42:40,100,9600,35,65,7698.40,12375.62,0.00
2024-12-10 17:42:40,100,9601,35,65,7896.46,12376.00,0.00
2024-12-10 17:42:40,101,9601,35,66,7818.28,12376.01,0.00
2024-12-10 17:42:40,100,9601,35,65,7886.60,12376.08,0.00
2024-12-10 17:42:40,99,9601,34,65,7915.02,12376.11,0.00
2024-12-10 17:42:40,100,9600,34,66,7801.25,12376.21,0.00
2024-12-10 17:42:40,100,9601,34,66,7905.79,12377.00,0.00
2024-12-10 17:42:40,101,9601,35,66,7827.51,12377.01,0.00
2024-12-10 17:42:40,100,9601,35,65,7846.42,12377.08,0.00
2024-12-10 17:42:40,100,9602,35,65,7963.14,12378.00,0.00
2024-12-10 17:42:40,101,9602,35,66,7884.29,12378.01,0.00
2024-12-10 17:42:40,100,9602,35,65,7901.29,12378.10,0.00
2024-12-10 17:42:40,100,9603,35,65,7896.84,12379.00,0.00
2024-12-10 17:42:40,101,9603,36,65,7818.65,12379.01,0.00
2024-12-10 17:42:40,101,9604,36,65,7764.34,12380.00,0.00
2024-12-10 17:42:40,102,9604,36,66,7688.22,12380.01,0.00
2024-12-10 17:42:40,102,9605,36,66,7622.33,12381.00,0.00
2024-12-10 17:42:40,103,9605,36,67,7548.32,12381.01,0.00
2024-12-10 17:42:40,104,9604,37,67,7395.00,12381.49,0.00
2024-12-10 17:42:40,104,9605,37,67,7435.31,12382.00,0.00
2024-12-10 17:42:40,105,9605,38,67,7364.50,12382.01,0.00
2024-12-10 17:42:40,105,9606,38,67,7374.63,12383.00,0.00
2024-12-10 17:42:40,106,9606,38,68,7305.05,12383.01,0.00
2024-12-10 17:42:40,105,9606,37,68,7372.27,12383.02,0.00
2024-12-10 17:42:40,104,9606,37,67,7436.04,12383.07,0.00
2024-12-10 17:42:40,103,9606,37,66,7495.02,12383.12,0.00
2024-12-10 17:42:40,102,9606,37,65,7479.27,12383.65,0.00
2024-12-10 17:42:40,101,9606,36,65,7495.22,12383.96,0.00
2024-12-10 17:42:40,101,9607,36,65,7612.96,12384.00,0.00
2024-12-10 17:42:40,102,9607,36,66,7538.32,12384.01,0.00
2024-12-10 17:42:40,102,9608,36,66,7447.06,12385.00,0.00
2024-12-10 17:42:40,103,9608,37,66,7374.75,12385.01,0.00
2024-12-10 17:42:40,102,9608,37,65,7360.19,12385.48,0.00
2024-12-10 17:42:40,103,9607,38,65,7244.57,12385.79,0.00
2024-12-10 17:42:40,103,9608,38,65,7315.66,12386.00,0.00
2024-12-10 17:42:40,104,9608,39,65,7245.31,12386.01,0.00
2024-12-10 17:42:40,103,9608,39,64,7292.13,12386.18,0.00
2024-12-10 17:42:40,102,9608,38,64,7241.57,12386.86,0.00
2024-12-10 17:42:40,102,9609,38,64,7467.56,12387.00,0.00
2024-12-10 17:42:40,103,9609,39,64,7395.06,12387.01,0.00
2024-12-10 17:42:40,103,9610,39,64,7297.79,12388.00,0.00
2024-12-10 17:42:40,104,9610,39,65,7227.62,12388.01,0.00
2024-12-10 17:42:40,103,9610,39,64,7271.39,12388.18,0.00
2024-12-10 17:42:40,102,9610,38,64,7227.03,12388.69,0.00
2024-12-10 17:42:40,102,9611,38,64,7290.17,12389.00,0.00
2024-12-10 17:42:40,103,9611,38,65,7219.39,12389.01,0.00
2024-12-10 17:42:40,103,9612,38,65,7119.75,12390.00,0.00
2024-12-10 17:42:40,104,9612,38,66,7051.29,12390.01,0.00
2024-12-10 17:42:40,103,9612,38,65,7090.93,12390.19,0.00
2024-12-10 17:42:40,102,9612,38,64,7056.82,12390.63,0.00
2024-12-10 17:42:40,102,9613,38,64,7109.94,12391.00,0.00
2024-12-10 17:42:40,103,9613,39,64,7040.91,12391.01,0.00
2024-12-10 17:42:40,102,9613,38,64,6935.67,12391.76,0.00
2024-12-10 17:42:40,102,9614,38,64,7013.02,12392.00,0.00
2024-12-10 17:42:40,103,9614,39,64,6944.93,12392.01,0.00
2024-12-10 17:42:40,102,9614,39,63,6982.70,12392.21,0.00
2024-12-10 17:42:40,102,9615,39,63,6939.90,12393.00,0.00
2024-12-10 17:42:40,103,9615,39,64,6872.52,12393.01,0.00
2024-12-10 17:42:40,103,9616,39,64,6784.50,12394.00,0.00
2024-12-10 17:42:40,104,9616,39,65,6719.26,12394.01,0.00
2024-12-10 17:42:40,103,9616,38,65,6760.48,12394.19,0.00
2024-12-10 17:42:40,102,9616,38,64,6819.47,12394.21,0.00
2024-12-10 17:42:40,102,9617,38,64,6777.24,12395.00,0.00
2024-12-10 17:42:40,103,9617,39,64,6711.44,12395.01,0.00
2024-12-10 17:42:40,102,9617,39,63,6756.61,12395.11,0.00
2024-12-10 17:42:40,101,9617,38,63,6802.66,12395.16,0.00
2024-12-10 17:42:40,100,9617,37,63,6850.91,12395.32,0.00
2024-12-10 17:42:40,101,9616,37,64,6753.75,12395.57,0.00
2024-12-10 17:42:40,101,9617,37,64,6846.75,12396.00,0.00
2024-12-10 17:42:40,102,9617,37,65,6779.62,12396.01,0.00
2024-12-10 17:42:40,101,9617,37,64,6817.33,12396.15,0.00
2024-12-10 17:42:40,100,9617,37,63,6802.53,12396.73,0.00
2024-12-10 17:42:40,100,9618,37,63,6949.51,12397.00,0.00
2024-12-10 17:42:40,101,9618,37,64,6880.70,12397.01,0.00
2024-12-10 17:42:40,101,9619,37,64,6779.19,12398.00,0.00
2024-12-10 17:42:40,102,9619,38,64,6712.73,12398.01,0.00
2024-12-10 17:42:40,101,9619,38,63,6755.91,12398.18,0.00
2024-12-10 17:42:40,100,9619,37,63,6710.94,12398.73,0.00
2024-12-10 17:42:40,100,9620,37,63,6760.31,12399.00,0.00
2024-12-10 17:42:40,101,9620,38,63,6693.38,12399.01,0.00
2024-12-10 17:42:40,100,9620,38,62,6750.42,12399.08,0.00
2024-12-10 17:42:40,99,9620,37,62,6615.47,12399.93,0.00
2024-12-10 17:42:40,99,9621,37,62,6732.01,12400.00,0.00
2024-12-10 17:42:40,100,9621,37,63,6664.69,12400.01,0.00
2024-12-10 17:42:40,99,9621,37,62,6722.02,12400.08,0.00
2024-12-10 17:42:40,99,9622,37,62,6620.14,12401.00,0.00
2024-12-10 17:42:40,100,9622,37,63,6553.93,12401.01,0.00
2024-12-10 17:42:40,99,9622,37,62,6456.44,12401.82,0.00
2024-12-10 17:42:41,99,9623,37,62,6502.27,12402.00,0.00
2024-12-10 17:42:41,100,9623,38,62,6437.24,12402.01,0.00
2024-12-10 17:42:41,99,9623,37,62,6497.26,12402.04,0.00
2024-12-10 17:42:41,98,9623,36,62,6557.25,12402.08,0.00
2024-12-10 17:42:41,97,9623,36,61,6603.13,12402.14,0.00
2024-12-10 17:42:41,96,9623,36,60,6590.00,12402.76,0.00
2024-12-10 17:42:41,96,9624,36,60,6609.62,12403.00,0.00
2024-12-10 17:42:41,97,9624,36,61,6541.48,12403.01,0.00
2024-12-10 17:42:41,96,9624,35,61,6605.76,12403.03,0.00
2024-12-10 17:42:41,95,9624,35,60,6668.78,12403.07,0.00
2024-12-10 17:42:41,94,9624,35,59,6708.07,12403.13,0.00
2024-12-10 17:42:41,95,9623,36,59,6493.90,12403.77,0.00
2024-12-10 17:42:41,95,9624,36,59,6610.81,12404.00,0.00
2024-12-10 17:42:41,96,9624,36,60,6541.94,12404.01,0.00
2024-12-10 17:42:41,95,9624,36,59,6600.39,12404.08,0.00
2024-12-10 17:42:41,94,9624,36,58,6641.58,12404.12,0.00
2024-12-10 17:42:41,93,9624,35,58,6602.55,12404.86,0.00
2024-12-10 17:42:41,92,9624,34,58,6664.84,12404.95,0.00
2024-12-10 17:42:41,92,9625,34,58,6927.80,12405.00,0.00
2024-12-10 17:42:41,93,9625,35,58,6853.31,12405.01,0.00
2024-12-10 17:42:41,92,9625,34,58,6895.46,12405.05,0.00
2024-12-10 17:42:41,91,9625,34,57,6934.45,12405.13,0.00
2024-12-10 17:42:41,90,9625,34,56,6926.69,12405.73,0.00
2024-12-10 17:42:41,90,9626,34,56,7031.26,12406.00,0.00
2024-12-10 17:42:41,91,9626,35,56,6953.99,12406.01,0.00
2024-12-10 17:42:41,90,9626,35,55,6987.20,12406.14,0.00
2024-12-10 17:42:41,90,9627,35,55,6962.90,12407.00,0.00
2024-12-10 17:42:41,91,9627,35,56,6886.39,12407.01,0.00
2024-12-10 17:42:41,90,9627,34,56,6953.28,12407.08,0.00
2024-12-10 17:42:41,90,9628,34,56,6926.92,12408.00,0.00
2024-12-10 17:42:41,91,9628,35,56,6850.80,12408.01,0.00
2024-12-10 17:42:41,92,9627,35,57,6769.62,12408.09,0.00
2024-12-10 17:42:41,91,9627,34,57,6746.51,12408.73,0.00
2024-12-10 17:42:41,91,9628,34,57,6849.01,12409.00,0.00
2024-12-10 17:42:41,92,9628,34,58,6774.56,12409.01,0.00
2024-12-10 17:42:41,91,9628,34,57,6802.69,12409.15,0.00
2024-12-10 17:42:41,91,9629,34,57,6915.05,12410.00,0.00
2024-12-10 17:42:41,92,9629,34,58,6839.89,12410.01,0.00
2024-12-10 17:42:41,92,9630,34,58,6770.15,12411.00,0.00
2024-12-10 17:42:41,93,9630,34,59,6697.35,12411.01,0.00
2024-12-10 17:42:41,92,9630,33,59,6759.37,12411.05,0.00
2024-12-10 17:42:41,91,9630,33,58,6814.58,12411.15,0.00
2024-12-10 17:42:41,91,9631,33,58,6844.56,12412.00,0.00
2024-12-10 17:42:41,92,9631,34,58,6770.16,12412.01,0.00
2024-12-10 17:42:41,93,9630,34,59,6696.03,12412.04,0.00
2024-12-10 17:42:41,92,9630,33,59,6781.00,12412.18,0.00
2024-12-10 17:42:41,92,9631,33,59,6812.54,12413.00,0.00
2024-12-10 17:42:41,93,9631,33,60,6739.28,12413.01,0.00
2024-12-10 17:42:41,92,9631,33,59,6804.47,12413.07,0.00
2024-12-10 17:42:41,91,9631,33,58,6864.26,12413.14,0.00
2024-12-10 17:42:41,90,9631,32,58,6918.51,12413.31,0.00
2024-12-10 17:42:41,90,9632,32,58,7047.03,12414.00,0.00
2024-12-10 17:42:41,91,9632,33,58,6969.59,12414.01,0.00
2024-12-10 17:42:41,91,9633,33,58,6889.42,12415.00,0.00
2024-12-10 17:42:41,92,9633,34,58,6814.53,12415.01,0.00
2024-12-10 17:42:41,91,9633,34,57,6869.00,12415.14,0.00
2024-12-10 17:42:41,91,9634,34,57,6826.95,12416.00,0.00
2024-12-10 17:42:41,92,9634,35,57,6752.74,12416.01,0.00
2024-12-10 17:42:41,91,9634,34,57,6736.51,12416.51,0.00
2024-12-10 17:42:41,91,9635,34,57,6758.24,12417.00,0.00
2024-12-10 17:42:41,92,9635,34,58,6684.78,12417.01,0.00
2024-12-10 17:42:41,91,9635,33,58,6750.09,12417.07,0.00
2024-12-10 17:42:41,91,9636,33,58,6662.10,12418.00,0.00
2024-12-10 17:42:41,92,9636,33,59,6589.69,12418.01,0.00
2024-12-10 17:42:41,91,9636,32,59,6623.89,12418.01,0.00
2024-12-10 17:42:41,90,9636,32,58,6672.69,12418.10,0.00
2024-12-10 17:42:41,89,9636,31,58,6664.27,12418.76,0.00
2024-12-10 17:42:41,89,9637,31,58,6734.48,12419.00,0.00
2024-12-10 17:42:41,90,9637,31,59,6659.65,12419.01,0.00
2024-12-10 17:42:41,89,9637,31,58,6712.19,12419.11,0.00
2024-12-10 17:42:41,89,9638,31,58,6637.72,12420.00,0.00
2024-12-10 17:42:41,90,9638,31,59,6563.96,12420.01,0.00
2024-12-10 17:42:41,89,9638,31,58,6587.67,12420.18,0.00
2024-12-10 17:42:41,88,9638,30,58,6485.06,12420.85,0.00
2024-12-10 17:42:41,88,9639,30,58,6606.80,12421.00,0.00
2024-12-10 17:42:41,89,9639,30,59,6532.57,12421.01,0.00
2024-12-10 17:42:41,88,9639,30,58,6589.91,12421.13,0.00
2024-12-10 17:42:41,87,9639,29,58,6637.16,12421.33,0.00
2024-12-10 17:42:41,87,9640,29,58,6655.65,12422.00,0.00
2024-12-10 17:42:41,88,9640,29,59,6580.01,12422.01,0.00
2024-12-10 17:42:41,87,9640,28,59,6541.50,12422.29,0.00
2024-12-10 17:42:41,88,9639,29,59,6432.02,12422.59,0.00
2024-12-10 17:42:41,87,9639,29,58,6497.46,12422.83,0.00
2024-12-10 17:42:41,87,9639,29,58,6617.18,12423.00,0.00
2024-12-10 17:42:41,88,9639,30,58,6541.98,12423.01,0.00
2024-12-10 17:42:41,87,9639,30,57,6600.08,12423.14,0.00
2024-12-10 17:42:41,86,9639,29,57,6670.67,12423.19,0.00
2024-12-10 17:42:41,86,9640,29,57,6776.18,12424.00,0.00
2024-12-10 17:42:41,87,9640,29,58,6698.29,12424.01,0.00
2024-12-10 17:42:41,86,9640,29,57,6767.54,12424.07,0.00
2024-12-10 17:42:41,85,9640,29,56,6810.63,12424.13,0.00
2024-12-10 17:42:41,86,9639,29,57,6721.34,12424.23,0.00
2024-12-10 17:42:41,87,9638,29,58,6684.22,12424.55,0.00
2024-12-10 17:42:41,86,9638,29,57,6792.14,12424.77,0.00
2024-12-10 17:42:41,86,9639,29,57,6905.44,12425.00,0.00
2024-12-10 17:42:41,87,9639,30,57,6826.07,12425.01,0.00
2024-12-10 17:42:41,86,9639,30,56,6896.81,12425.07,0.00
2024-12-10 17:42:41,85,9639,30,55,6941.41,12425.12,0.00
2024-12-10 17:42:41,85,9640,30,55,7209.85,12426.00,0.00
2024-12-10 17:42:41,86,9640,31,55,7126.02,12426.01,0.00
2024-12-10 17:42:41,85,9640,31,54,7201.11,12426.07,0.00
2024-12-10 17:42:41,84,9640,31,53,7258.74,12426.10,0.00
2024-12-10 17:42:41,84,9641,31,53,7233.31,12427.00,0.00
2024-12-10 17:42:41,85,9641,32,53,7148.21,12427.01,0.00
2024-12-10 17:42:41,84,9641,31,53,7206.69,12427.04,0.00
2024-12-10 17:42:41,83,9641,31,52,7257.61,12427.08,0.00
2024-12-10 17:42:41,83,9642,31,52,7291.94,12428.00,0.00
2024-12-10 17:42:41,84,9642,31,53,7205.13,12428.01,0.00
2024-12-10 17:42:41,83,9642,31,52,7251.55,12428.08,0.00
2024-12-10 17:42:41,82,9642,30,52,7252.15,12428.29,0.00
2024-12-10 17:42:41,82,9643,30,52,7314.50,12429.00,0.00
2024-12-10 17:42:41,83,9643,30,53,7226.38,12429.01,0.00
2024-12-10 17:42:41,82,9643,30,52,7306.95,12429.06,0.00
2024-12-10 17:42:42,82,9644,30,52,7250.31,12430.00,0.00
2024-12-10 17:42:42,83,9644,31,52,7162.96,12430.01,0.00
2024-12-10 17:42:42,82,9644,31,51,7241.25,12430.07,0.00
2024-12-10 17:42:42,82,9645,31,51,7217.11,12431.00,0.00
2024-12-10 17:42:42,83,9645,32,51,7130.16,12431.01,0.00
2024-12-10 17:42:42,82,9645,32,50,7177.73,12431.07,0.00
2024-12-10 17:42:42,82,9646,32,50,7152.40,12432.00,0.00
2024-12-10 17:42:42,83,9646,33,50,7066.22,12432.01,0.00
2024-12-10 17:42:42,82,9646,33,49,7113.01,12432.07,0.00
2024-12-10 17:42:42,82,9647,33,49,7085.31,12433.00,0.00
2024-12-10 17:42:42,83,9647,33,50,6999.94,12433.01,0.00
2024-12-10 17:42:42,83,9648,33,50,6931.01,12434.00,0.00
2024-12-10 17:42:42,84,9648,34,50,6848.50,12434.01,0.00
2024-12-10 17:42:42,83,9648,34,49,6922.06,12434.07,0.00
2024-12-10 17:42:42,84,9647,35,49,6673.06,12434.89,0.00
2024-12-10 17:42:42,84,9648,35,49,6821.18,12435.00,0.00
2024-12-10 17:42:42,85,9648,35,50,6740.93,12435.01,0.00
2024-12-10 17:42:42,84,9648,35,49,6781.25,12435.08,0.00
2024-12-10 17:42:42,84,9649,35,49,6895.82,12436.00,0.00
2024-12-10 17:42:42,85,9649,36,49,6814.70,12436.01,0.00
2024-12-10 17:42:42,85,9650,36,49,6743.07,12437.00,0.00
2024-12-10 17:42:42,86,9650,37,49,6664.66,12437.01,0.00
2024-12-10 17:42:42,85,9650,36,49,6724.07,12437.07,0.00
2024-12-10 17:42:42,84,9650,36,48,6796.73,12437.10,0.00
2024-12-10 17:42:42,85,9649,37,48,6617.51,12437.85,0.00
2024-12-10 17:42:42,85,9650,37,48,6747.87,12438.00,0.00
2024-12-10 17:42:42,86,9650,38,48,6669.41,12438.01,0.00
2024-12-10 17:42:42,85,9650,37,48,6572.03,12438.67,0.00
2024-12-10 17:42:42,85,9651,37,48,6823.63,12439.00,0.00
2024-12-10 17:42:42,86,9651,38,48,6744.29,12439.01,0.00
2024-12-10 17:42:42,85,9651,38,47,6809.03,12439.09,0.00
2024-12-10 17:42:42,86,9650,39,47,6715.43,12439.23,0.00
2024-12-10 17:42:42,85,9650,38,47,6849.95,12439.68,0.00
2024-12-10 17:42:42,85,9651,38,47,6898.48,12440.00,0.00
2024-12-10 17:42:42,86,9651,39,47,6818.27,12440.01,0.00
2024-12-10 17:42:42,87,9650,39,48,6737.05,12440.06,0.00
2024-12-10 17:42:42,87,9651,39,48,6845.80,12441.00,0.00
2024-12-10 17:42:42,88,9651,40,48,6768.01,12441.01,0.00
2024-12-10 17:42:42,87,9651,40,47,6831.54,12441.09,0.00
2024-12-10 17:42:42,87,9652,40,47,6929.36,12442.00,0.00
2024-12-10 17:42:42,88,9652,40,48,6850.62,12442.01,0.00
2024-12-10 17:42:42,87,9652,39,48,6851.81,12442.32,0.00
2024-12-10 17:42:42,87,9653,39,48,6853.29,12443.00,0.00
2024-12-10 17:42:42,88,9653,40,48,6775.41,12443.01,0.00
2024-12-10 17:42:42,87,9653,40,47,6840.45,12443.09,0.00
2024-12-10 17:42:42,86,9653,39,47,6834.80,12443.51,0.00
2024-12-10 17:42:42,85,9653,38,47,6890.44,12443.71,0.00
2024-12-10 17:42:42,85,9654,38,47,7000.46,12444.00,0.00
2024-12-10 17:42:42,86,9654,38,48,6919.06,12444.01,0.00
2024-12-10 17:42:42,86,9655,38,48,6854.50,12445.00,0.00
2024-12-10 17:42:42,87,9655,39,48,6775.71,12445.01,0.00
2024-12-10 17:42:42,86,9655,39,47,6840.06,12445.10,0.00
2024-12-10 17:42:42,86,9656,39,47,6815.98,12446.00,0.00
2024-12-10 17:42:42,87,9656,39,48,6737.63,12446.01,0.00
2024-12-10 17:42:42,86,9656,38,48,6699.08,12446.72,0.00
2024-12-10 17:42:42,86,9657,38,48,6751.39,12447.00,0.00
2024-12-10 17:42:42,87,9657,39,48,6673.79,12447.01,0.00
2024-12-10 17:42:42,86,9657,39,47,6738.40,12447.10,0.00
2024-12-10 17:42:42,85,9657,38,47,6789.93,12447.32,0.00
2024-12-10 17:42:42,84,9657,37,47,6819.13,12447.73,0.00
2024-12-10 17:42:42,84,9658,37,47,6874.17,12448.00,0.00
2024-12-10 17:42:42,85,9658,37,48,6793.29,12448.01,0.00
2024-12-10 17:42:42,84,9658,36,48,6840.10,12448.05,0.00
2024-12-10 17:42:42,83,9658,36,47,6886.53,12448.10,0.00
2024-12-10 17:42:42,83,9659,36,47,6924.55,12449.00,0.00
2024-12-10 17:42:42,84,9659,36,48,6842.11,12449.01,0.00
2024-12-10 17:42:42,83,9659,35,48,6828.98,12449.53,0.00
2024-12-10 17:42:42,82,9659,34,48,6885.06,12449.73,0.00
2024-12-10 17:42:42,82,9660,34,48,7003.70,12450.00,0.00
2024-12-10 17:42:42,83,9660,34,49,6919.32,12450.01,0.00
2024-12-10 17:42:42,82,9660,34,48,6982.50,12450.16,0.00
2024-12-10 17:42:42,81,9660,33,48,6946.20,12450.95,0.00
2024-12-10 17:42:42,81,9660,33,48,7093.80,12451.00,0.00
2024-12-10 17:42:42,82,9660,33,49,7007.29,12451.01,0.00
2024-12-10 17:42:42,82,9661,33,49,6943.90,12452.00,0.00
2024-12-10 17:42:42,83,9661,33,50,6860.24,12452.01,0.00
2024-12-10 17:42:42,82,9661,33,49,6924.21,12452.16,0.00
2024-12-10 17:42:42,81,9661,32,49,6960.59,12452.42,0.00
2024-12-10 17:42:42,81,9662,32,49,7037.60,12453.00,0.00
2024-12-10 17:42:42,82,9662,33,49,6951.77,12453.01,0.00
2024-12-10 17:42:42,82,9663,33,49,6882.05,12454.00,0.00
2024-12-10 17:42:42,83,9663,33,50,6799.13,12454.01,0.00
2024-12-10 17:42:42,82,9663,33,49,6862.35,12454.16,0.00
2024-12-10 17:42:42,82,9664,33,49,6838.60,12455.00,0.00
2024-12-10 17:42:42,83,9664,33,50,6756.21,12455.01,0.00
2024-12-10 17:42:42,82,9664,32,50,6824.23,12455.08,0.00
2024-12-10 17:42:42,81,9664,32,49,6868.53,12455.15,0.00
2024-12-10 17:42:42,82,9663,33,49,6678.98,12455.93,0.00
2024-12-10 17:42:42,82,9664,33,49,6830.94,12456.00,0.00
2024-12-10 17:42:42,83,9664,33,50,6748.64,12456.01,0.00
2024-12-10 17:42:42,82,9664,33,49,6823.37,12456.06,0.00
2024-12-10 17:42:42,81,9664,33,48,6864.58,12456.15,0.00
2024-12-10 17:42:42,80,9664,32,48,6897.47,12456.20,0.00
2024-12-10 17:42:42,79,9664,31,48,6975.34,12456.28,0.00
2024-12-10 17:42:42,79,9665,31,48,7185.08,12457.00,0.00
2024-12-10 17:42:42,80,9665,32,48,7095.27,12457.01,0.00
2024-12-10 17:42:42,79,9665,31,48,7092.10,12457.18,0.00
2024-12-10 17:42:42,79,9666,31,48,7128.78,12458.00,0.00
2024-12-10 17:42:42,80,9666,32,48,7039.67,12458.01,0.00
2024-12-10 17:42:43,80,9667,32,48,6960.09,12459.00,0.00
2024-12-10 17:42:43,81,9667,33,48,6874.16,12459.01,0.00
2024-12-10 17:42:43,80,9667,33,47,6933.66,12459.16,0.00
2024-12-10 17:42:43,80,9668,33,47,6902.90,12460.00,0.00
2024-12-10 17:42:43,81,9668,33,48,6817.67,12460.01,0.00
2024-12-10 17:42:43,81,9669,33,48,6772.48,12461.00,0.00
2024-12-10 17:42:43,82,9669,33,49,6689.89,12461.01,0.00
2024-12-10 17:42:43,81,9669,32,49,6690.14,12461.42,0.00
2024-12-10 17:42:43,81,9670,32,49,6745.00,12462.00,0.00
2024-12-10 17:42:43,82,9670,33,49,6662.75,12462.01,0.00
2024-12-10 17:42:43,83,9669,34,49,6509.01,12462.39,0.00
2024-12-10 17:42:43,82,9669,34,48,6640.91,12462.54,0.00
2024-12-10 17:42:43,82,9670,34,48,6653.90,12463.00,0.00
2024-12-10 17:42:43,83,9670,34,49,6573.74,12463.01,0.00
2024-12-10 17:42:43,82,9670,34,48,6632.67,12463.16,0.00
2024-12-10 17:42:43,82,9671,34,48,6745.59,12464.00,0.00
2024-12-10 17:42:43,83,9671,35,48,6664.31,12464.01,0.00
2024-12-10 17:42:43,82,9671,34,48,6563.17,12464.70,0.00
2024-12-10 17:42:43,82,9672,34,48,6653.75,12465.00,0.00
2024-12-10 17:42:43,83,9672,34,49,6573.58,12465.01,0.00
2024-12-10 17:42:43,82,9672,34,48,6627.94,12465.17,0.00
2024-12-10 17:42:43,81,9672,33,48,6661.16,12465.47,0.00
2024-12-10 17:42:43,81,9673,33,48,6664.41,12466.00,0.00
2024-12-10 17:42:43,82,9673,34,48,6583.14,12466.01,0.00
2024-12-10 17:42:43,82,9674,34,48,6499.88,12467.00,0.00
2024-12-10 17:42:43,83,9674,34,49,6421.57,12467.01,0.00
2024-12-10 17:42:43,82,9674,34,48,6475.53,12467.17,0.00
2024-12-10 17:42:43,82,9675,34,48,6443.78,12468.00,0.00
2024-12-10 17:42:43,83,9675,35,48,6366.15,12468.01,0.00
2024-12-10 17:42:43,82,9675,34,48,6440.75,12468.02,0.00
2024-12-10 17:42:43,81,9675,34,47,6514.12,12468.06,0.00
2024-12-10 17:42:43,81,9676,34,47,6438.90,12469.00,0.00
2024-12-10 17:42:43,82,9676,35,47,6360.38,12469.01,0.00
2024-12-10 17:42:43,81,9676,35,46,6429.69,12469.07,0.00
2024-12-10 17:42:43,80,9676,34,46,6508.50,12469.08,0.00
2024-12-10 17:42:43,79,9676,34,45,6577.19,12469.13,0.00
2024-12-10 17:42:43,79,9677,34,45,6547.35,12470.00,0.00
2024-12-10 17:42:43,80,9677,34,46,6465.50,12470.01,0.00
2024-12-10 17:42:43,79,9677,34,45,6424.49,12470.62,0.00
2024-12-10 17:42:43,79,9678,34,45,6465.10,12471.00,0.00
2024-12-10 17:42:43,80,9678,34,46,6384.29,12471.01,0.00
2024-12-10 17:42:43,79,9678,33,46,6443.63,12471.11,0.00
2024-12-10 17:42:43,78,9678,33,45,6521.45,12471.12,0.00
2024-12-10 17:42:43,77,9678,32,45,6473.50,12471.92,0.00
2024-12-10 17:42:43,77,9679,32,45,6625.80,12472.00,0.00
2024-12-10 17:42:43,78,9679,33,45,6540.86,12472.01,0.00
2024-12-10 17:42:43,78,9680,33,45,6471.83,12473.00,0.00
2024-12-10 17:42:43,79,9680,33,46,6389.91,12473.01,0.00
2024-12-10 17:42:43,78,9680,33,45,6455.87,12473.12,0.00
2024-12-10 17:42:43,78,9681,33,45,6430.84,12474.00,0.00
2024-12-10 17:42:43,79,9681,34,45,6349.44,12474.01,0.00
2024-12-10 17:42:43,78,9681,34,44,6236.96,12474.72,0.00
2024-12-10 17:42:43,77,9681,33,44,6317.96,12474.73,0.00
2024-12-10 17:42:43,77,9682,33,44,6443.29,12475.00,0.00
2024-12-10 17:42:43,78,9682,33,45,6360.68,12475.01,0.00
2024-12-10 17:42:43,77,9682,33,44,6422.26,12475.14,0.00
2024-12-10 17:42:43,77,9683,33,44,6400.23,12476.00,0.00
2024-12-10 17:42:43,78,9683,34,44,6318.18,12476.01,0.00
2024-12-10 17:42:43,77,9683,34,43,6388.92,12476.09,0.00
2024-12-10 17:42:43,78,9682,35,43,6186.57,12476.76,0.00
2024-12-10 17:42:43,78,9682,35,43,6283.05,12477.00,0.00
2024-12-10 17:42:43,79,9682,35,44,6203.52,12477.01,0.00
2024-12-10 17:42:43,78,9682,34,44,6271.88,12477.09,0.00
2024-12-10 17:42:43,77,9682,34,43,6343.62,12477.12,0.00
2024-12-10 17:42:43,78,9681,34,44,6257.50,12477.18,0.00
2024-12-10 17:42:43,78,9682,34,44,6512.59,12478.00,0.00
2024-12-10 17:42:43,79,9682,34,45,6430.15,12478.01,0.00
2024-12-10 17:42:43,79,9683,34,45,6517.29,12479.00,0.00
2024-12-10 17:42:43,80,9683,34,46,6435.82,12479.01,0.00
2024-12-10 17:42:43,79,9683,34,45,6499.94,12479.11,0.00
2024-12-10 17:42:43,78,9683,33,45,6473.01,12479.90,0.00
2024-12-10 17:42:43,77,9683,32,45,6522.44,12479.95,0.00
2024-12-10 17:42:43,77,9684,32,45,6678.07,12480.00,0.00
2024-12-10 17:42:43,78,9684,32,46,6592.45,12480.01,0.00
2024-12-10 17:42:43,77,9684,31,46,6545.35,12480.53,0.00
2024-12-10 17:42:43,77,9685,31,46,6644.62,12481.00,0.00
2024-12-10 17:42:43,78,9685,32,46,6559.43,12481.01,0.00
2024-12-10 17:42:43,77,9685,31,46,6639.76,12481.04,0.00
2024-12-10 17:42:43,76,9685,31,45,6714.01,12481.11,0.00
2024-12-10 17:42:43,76,9686,31,45,6691.70,12482.00,0.00
2024-12-10 17:42:43,77,9686,31,46,6604.80,12482.01,0.00
2024-12-10 17:42:43,77,9687,31,46,6535.24,12483.00,0.00
2024-12-10 17:42:43,78,9687,31,47,6451.46,12483.01,0.00
2024-12-10 17:42:43,77,9687,31,46,6446.11,12483.13,0.00
2024-12-10 17:42:43,77,9688,31,46,6481.45,12484.00,0.00
2024-12-10 17:42:43,78,9688,32,46,6398.36,12484.01,0.00
2024-12-10 17:42:43,77,9688,32,45,6447.54,12484.13,0.00
2024-12-10 17:42:43,76,9688,31,45,6484.83,12484.37,0.00
2024-12-10 17:42:44,76,9689,31,45,6549.38,12485.00,0.00
2024-12-10 17:42:44,77,9689,31,46,6464.32,12485.01,0.00
2024-12-10 17:42:44,76,9689,30,46,6542.82,12485.05,0.00
2024-12-10 17:42:44,77,9688,30,47,6410.85,12485.19,0.00
2024-12-10 17:42:44,77,9689,30,47,6546.51,12486.00,0.00
2024-12-10 17:42:44,78,9689,31,47,6462.58,12486.01,0.00
2024-12-10 17:42:44,78,9690,31,47,6586.16,12487.00,0.00
2024-12-10 17:42:44,79,9690,31,48,6502.79,12487.01,0.00
2024-12-10 17:42:44,78,9690,30,48,6464.73,12487.73,0.00
2024-12-10 17:42:44,78,9691,30,48,6531.83,12488.00,0.00
2024-12-10 17:42:44,79,9691,30,49,6449.15,12488.01,0.00
2024-12-10 17:42:44,78,9691,30,48,6495.03,12488.12,0.00
2024-12-10 17:42:44,78,9692,30,48,6475.40,12489.00,0.00
2024-12-10 17:42:44,79,9692,31,48,6393.43,12489.01,0.00
2024-12-10 17:42:44,78,9692,30,48,6436.97,12489.01,0.00
2024-12-10 17:42:44,78,9693,30,48,6435.99,12490.00,0.00
2024-12-10 17:42:44,79,9693,30,49,6354.53,12490.01,0.00
2024-12-10 17:42:44,78,9693,30,48,6418.40,12490.12,0.00
2024-12-10 17:42:44,78,9694,30,48,6397.39,12491.00,0.00
2024-12-10 17:42:44,79,9694,31,48,6316.41,12491.01,0.00
2024-12-10 17:42:44,80,9693,32,48,6235.90,12491.05,0.00
2024-12-10 17:42:44,79,9693,31,48,6403.45,12491.28,0.00
2024-12-10 17:42:44,78,9693,30,48,6425.64,12491.36,0.00
2024-12-10 17:42:44,77,9693,30,47,6457.45,12491.75,0.00
2024-12-10 17:42:44,77,9694,30,47,6589.05,12492.00,0.00
2024-12-10 17:42:44,78,9694,30,48,6504.58,12492.01,0.00
2024-12-10 17:42:44,78,9695,30,48,6657.73,12493.00,0.00
2024-12-10 17:42:44,79,9695,31,48,6573.45,12493.01,0.00
2024-12-10 17:42:44,78,9695,31,47,6611.31,12493.12,0.00
2024-12-10 17:42:44,78,9696,31,47,6643.74,12494.00,0.00
2024-12-10 17:42:44,79,9696,31,48,6559.65,12494.01,0.00
2024-12-10 17:42:44,80,9695,32,48,6329.30,12494.95,0.00
2024-12-10 17:42:44,80,9696,32,48,6457.68,12495.00,0.00
2024-12-10 17:42:44,81,9696,33,48,6377.96,12495.01,0.00
2024-12-10 17:42:44,80,9696,33,47,6420.21,12495.05,0.00
2024-12-10 17:42:44,80,9697,33,47,6563.38,12496.00,0.00
2024-12-10 17:42:44,81,9697,33,48,6482.35,12496.01,0.00
2024-12-10 17:42:44,80,9697,33,47,6536.84,12496.03,0.00
2024-12-10 17:42:44,79,9697,33,46,6616.42,12496.04,0.00
2024-12-10 17:42:44,78,9697,32,46,6670.88,12496.27,0.00
2024-12-10 17:42:44,78,9698,32,46,6670.03,12497.00,0.00
2024-12-10 17:42:44,79,9698,33,46,6585.60,12497.01,0.00
2024-12-10 17:42:44,79,9699,33,46,6567.19,12498.00,0.00
2024-12-10 17:42:44,80,9699,34,46,6485.10,12498.01,0.00
2024-12-10 17:42:44,80,9700,34,46,6456.75,12499.00,0.00
2024-12-10 17:42:44,81,9700,34,47,6377.04,12499.01,0.00
2024-12-10 17:42:44,80,9700,33,47,6450.91,12499.05,0.00
2024-12-10 17:42:44,79,9700,32,47,6474.08,12499.27,0.00
2024-12-10 17:42:44,78,9700,31,47,6553.88,12499.28,0.00
2024-12-10 17:42:44,78,9701,31,47,6575.45,12500.00,0.00
2024-12-10 17:42:44,79,9701,32,47,6492.22,12500.01,0.00
2024-12-10 17:42:44,78,9701,31,47,6510.78,12500.27,0.00
2024-12-10 17:42:44,78,9702,31,47,6503.01,12501.00,0.00
2024-12-10 17:42:44,79,9702,31,48,6420.69,12501.01,0.00
2024-12-10 17:42:44,78,9702,31,47,6488.60,12501.06,0.00
2024-12-10 17:42:44,78,9703,31,47,6451.86,12502.00,0.00
2024-12-10 17:42:44,79,9703,32,47,6370.19,12502.01,0.00
2024-12-10 17:42:44,78,9703,32,46,6415.01,12502.08,0.00
2024-12-10 17:42:44,78,9704,32,46,6379.04,12503.00,0.00
2024-12-10 17:42:44,79,9704,33,46,6298.29,12503.01,0.00
2024-12-10 17:42:44,78,9704,32,46,6374.24,12503.04,0.00
2024-12-10 17:42:44,77,9704,32,45,6424.55,12503.06,0.00
2024-12-10 17:42:44,77,9705,32,45,6388.40,12504.00,0.00
2024-12-10 17:42:44,78,9705,32,46,6306.49,12504.01,0.00
2024-12-10 17:42:44,77,9705,32,45,6352.68,12504.06,0.00
2024-12-10 17:42:44,76,9705,31,45,6357.44,12504.45,0.00
2024-12-10 17:42:44,75,9705,30,45,6403.15,12504.67,0.00
2024-12-10 17:42:44,75,9706,30,45,6528.43,12505.00,0.00
2024-12-10 17:42:44,76,9706,31,45,6442.53,12505.01,0.00
2024-12-10 17:42:44,75,9706,31,44,6491.76,12505.07,0.00
2024-12-10 17:42:44,75,9707,31,44,6475.59,12506.00,0.00
2024-12-10 17:42:44,76,9707,31,45,6390.39,12506.01,0.00
2024-12-10 17:42:44,75,9707,30,45,6417.23,12506.01,0.00
2024-12-10 17:42:44,74,9707,30,44,6466.78,12506.05,0.00
2024-12-10 17:42:44,74,9708,30,44,6516.89,12507.00,0.00
2024-12-10 17:42:44,75,9708,31,44,6430.00,12507.01,0.00
2024-12-10 17:42:44,74,9708,31,43,6481.40,12507.05,0.00
2024-12-10 17:42:44,73,9708,30,43,6512.04,12507.36,0.00
2024-12-10 17:42:44,72,9708,29,43,6543.43,12507.81,0.00
2024-12-10 17:42:44,72,9709,29,43,6691.52,12508.00,0.00
2024-12-10 17:42:44,73,9709,30,43,6599.85,12508.01,0.00
2024-12-10 17:42:44,72,9709,30,42,6648.10,12508.07,0.00
2024-12-10 17:42:44,71,9709,29,42,6680.09,12508.14,0.00
2024-12-10 17:42:44,70,9709,28,42,6751.90,12508.33,0.00
2024-12-10 17:42:44,70,9710,28,42,6839.65,12509.00,0.00
2024-12-10 17:42:44,71,9710,28,43,6743.32,12509.01,0.00
2024-12-10 17:42:44,70,9710,28,42,6794.99,12509.07,0.00
2024-12-10 17:42:44,69,9710,27,42,6759.57,12509.62,0.00
2024-12-10 17:42:44,69,9711,27,42,6883.93,12510.00,0.00
2024-12-10 17:42:44,70,9711,28,42,6785.59,12510.01,0.00
2024-12-10 17:42:45,69,9711,27,42,6744.50,12510.48,0.00
2024-12-10 17:42:45,69,9712,27,42,6849.60,12511.00,0.00
2024-12-10 17:42:45,70,9712,27,43,6751.75,12511.01,0.00
2024-12-10 17:42:45,69,9712,27,42,6845.97,12511.03,0.00
2024-12-10 17:42:45,68,9712,27,41,6935.62,12511.07,0.00
2024-12-10 17:42:45,68,9713,27,41,6918.65,12512.00,0.00
2024-12-10 17:42:45,69,9713,28,41,6818.38,12512.01,0.00
2024-12-10 17:42:45,69,9714,28,41,6756.49,12513.00,0.00
2024-12-10 17:42:45,70,9714,29,41,6659.97,12513.01,0.00
2024-12-10 17:42:45,69,9714,29,40,6741.99,12513.09,0.00
2024-12-10 17:42:45,68,9714,28,40,6687.34,12513.97,0.00
2024-12-10 17:42:45,68,9715,28,40,6867.70,12514.00,0.00
2024-12-10 17:42:45,69,9715,29,40,6768.17,12514.01,0.00
2024-12-10 17:42:45,68,9715,28,40,6751.79,12514.15,0.00
2024-12-10 17:42:45,68,9716,28,40,6820.45,12515.00,0.00
2024-12-10 17:42:45,69,9716,28,41,6721.60,12515.01,0.00
2024-12-10 17:42:45,68,9716,28,40,6789.18,12515.12,0.00
2024-12-10 17:42:45,68,9717,28,40,6782.77,12516.00,0.00
2024-12-10 17:42:45,69,9717,29,40,6684.47,12516.01,0.00
2024-12-10 17:42:45,68,9717,28,40,6676.16,12516.57,0.00
2024-12-10 17:42:45,68,9718,28,40,6735.73,12517.00,0.00
2024-12-10 17:42:45,69,9718,29,40,6638.11,12517.01,0.00
2024-12-10 17:42:45,68,9718,29,39,6704.45,12517.12,0.00
2024-12-10 17:42:45,67,9718,28,39,6654.34,12517.97,0.00
2024-12-10 17:42:45,67,9719,28,39,6837.46,12518.00,0.00
2024-12-10 17:42:45,68,9719,29,39,6736.91,12518.01,0.00
2024-12-10 17:42:45,67,9719,29,38,6833.72,12518.03,0.00
2024-12-10 17:42:45,68,9718,29,39,6617.54,12518.69,0.00
2024-12-10 17:42:45,68,9719,29,39,6799.72,12519.00,0.00
2024-12-10 17:42:45,69,9719,29,40,6701.17,12519.01,0.00
2024-12-10 17:42:45,68,9719,29,39,6766.60,12519.12,0.00
2024-12-10 17:42:45,69,9718,30,39,6586.57,12519.80,0.00
2024-12-10 17:42:45,69,9719,30,39,6876.90,12520.00,0.00
2024-12-10 17:42:45,70,9719,30,40,6778.66,12520.01,0.00
2024-12-10 17:42:45,69,9719,29,40,6750.21,12520.72,0.00
2024-12-10 17:42:45,69,9720,29,40,7006.00,12521.00,0.00
2024-12-10 17:42:45,70,9720,30,40,6905.91,12521.01,0.00
2024-12-10 17:42:45,69,9720,30,39,6986.95,12521.12,0.00
2024-12-10 17:42:45,69,9721,30,39,6985.47,12522.00,0.00
2024-12-10 17:42:45,70,9721,30,40,6885.68,12522.01,0.00
2024-12-10 17:42:45,69,9721,29,40,6858.48,12522.19,0.00
2024-12-10 17:42:45,69,9722,29,40,6938.84,12523.00,0.00
2024-12-10 17:42:45,70,9722,30,40,6839.72,12523.01,0.00
2024-12-10 17:42:45,69,9722,30,39,6909.82,12523.12,0.00
2024-12-10 17:42:45,69,9723,30,39,6908.54,12524.00,0.00
2024-12-10 17:42:45,70,9723,30,40,6809.85,12524.01,0.00
2024-12-10 17:42:45,70,9724,30,40,6686.88,12525.00,0.00
2024-12-10 17:42:45,71,9724,30,41,6592.69,12525.01,0.00
2024-12-10 17:42:45,70,9724,30,40,6656.47,12525.11,0.00
2024-12-10 17:42:45,69,9724,29,40,6718.01,12525.26,0.00
2024-12-10 17:42:45,70,9723,30,40,6606.00,12525.41,0.00
2024-12-10 17:42:45,69,9723,30,39,6702.85,12525.61,0.00
2024-12-10 17:42:45,69,9724,30,39,6830.04,12526.00,0.00
2024-12-10 17:42:45,70,9724,30,40,6732.47,12526.01,0.00
2024-12-10 17:42:45,69,9724,29,40,6826.41,12526.03,0.00
2024-12-10 17:42:45,69,9725,29,40,6965.38,12527.00,0.00
2024-12-10 17:42:45,70,9725,29,41,6865.87,12527.01,0.00
2024-12-10 17:42:45,69,9725,29,40,6938.15,12527.10,0.00
2024-12-10 17:42:45,68,9725,28,40,6939.01,12527.57,0.00
2024-12-10 17:42:45,69,9724,28,41,6831.22,12527.65,0.00
2024-12-10 17:42:45,69,9725,28,41,6978.38,12528.00,0.00
2024-12-10 17:42:45,70,9725,28,42,6878.69,12528.01,0.00
2024-12-10 17:42:45,70,9726,28,42,7031.47,12529.00,0.00
2024-12-10 17:42:45,71,9726,28,43,6932.43,12529.01,0.00
2024-12-10 17:42:45,70,9726,27,43,6970.65,12529.21,0.00
2024-12-10 17:42:45,70,9727,27,43,6978.35,12530.00,0.00
2024-12-10 17:42:45,71,9727,27,44,6880.07,12530.01,0.00
2024-12-10 17:42:45,70,9727,27,43,6953.31,12530.11,0.00
2024-12-10 17:42:45,69,9727,26,43,6990.10,12530.62,0.00
2024-12-10 17:42:45,68,9727,25,43,7030.16,12530.75,0.00
2024-12-10 17:42:45,68,9728,25,43,7171.79,12531.00,0.00
2024-12-10 17:42:45,69,9728,26,43,7067.85,12531.01,0.00
2024-12-10 17:42:45,68,9728,25,43,7160.74,12531.04,0.00
2024-12-10 17:42:45,68,9729,25,43,7181.38,12532.00,0.00
2024-12-10 17:42:45,69,9729,25,44,7077.30,12532.01,0.00
2024-12-10 17:42:45,68,9729,24,44,7177.69,12532.03,0.00
2024-12-10 17:42:45,67,9729,24,43,7260.51,12532.09,0.00
2024-12-10 17:42:45,67,9730,24,43,7248.20,12533.00,0.00
2024-12-10 17:42:45,68,9730,25,43,7141.61,12533.01,0.00
2024-12-10 17:42:45,67,9730,25,42,7227.62,12533.03,0.00
2024-12-10 17:42:45,67,9731,25,42,7206.65,12534.00,0.00
2024-12-10 17:42:45,68,9731,25,43,7100.67,12534.01,0.00
2024-12-10 17:42:45,68,9732,25,43,7042.57,12535.00,0.00
2024-12-10 17:42:45,69,9732,25,44,6940.50,12535.01,0.00
2024-12-10 17:42:45,68,9732,25,43,7037.26,12535.04,0.00
2024-12-10 17:42:45,69,9731,25,44,6935.27,12535.07,0.00
2024-12-10 17:42:45,68,9731,25,43,7170.00,12535.07,0.00
2024-12-10 17:42:45,67,9731,24,43,7275.84,12535.07,0.00
2024-12-10 17:42:45,66,9731,23,43,7241.41,12535.64,0.00
2024-12-10 17:42:45,66,9732,23,43,7373.76,12536.00,0.00
2024-12-10 17:42:45,67,9732,24,43,7263.70,12536.01,0.00
2024-12-10 17:42:45,66,9732,23,43,7316.82,12536.15,0.00
2024-12-10 17:42:45,66,9732,23,43,7506.77,12537.00,0.00
2024-12-10 17:42:45,67,9732,24,43,7394.73,12537.01,0.00
2024-12-10 17:42:45,66,9732,24,42,7487.79,12537.06,0.00
2024-12-10 17:42:45,67,9731,24,43,7353.65,12537.27,0.00
2024-12-10 17:42:45,66,9731,23,43,7540.13,12537.44,0.00
2024-12-10 17:42:45,66,9732,23,43,7570.45,12538.00,0.00
2024-12-10 17:42:45,67,9732,23,44,7457.45,12538.01,0.00
2024-12-10 17:42:45,68,9731,23,45,7281.51,12538.28,0.00
2024-12-10 17:42:45,69,9730,24,45,7254.18,12538.43,0.00
2024-12-10 17:42:45,68,9730,23,45,7416.19,12538.62,0.00
2024-12-10 17:42:45,68,9731,23,45,7636.13,12539.00,0.00
2024-12-10 17:42:45,69,9731,23,46,7525.46,12539.01,0.00
2024-12-10 17:42:45,68,9731,22,46,7634.29,12539.01,0.00
2024-12-10 17:42:45,67,9731,22,45,7731.41,12539.04,0.00
2024-12-10 17:42:45,68,9730,22,46,7592.00,12539.28,0.00
2024-12-10 17:42:46,67,9730,21,46,7747.35,12539.63,0.00
2024-12-10 17:42:46,67,9731,21,46,8187.46,12540.00,0.00
2024-12-10 17:42:46,68,9731,21,47,8067.05,12540.01,0.00
2024-12-10 17:42:46,67,9731,20,47,8021.40,12540.84,0.00
2024-12-10 17:42:46,67,9731,20,47,8375.29,12541.00,0.00
2024-12-10 17:42:46,68,9731,21,47,8252.12,12541.01,0.00
2024-12-10 17:42:46,67,9731,21,46,8350.97,12541.06,0.00
2024-12-10 17:42:46,66,9731,20,46,8375.12,12541.47,0.00
2024-12-10 17:42:46,66,9732,20,46,8499.06,12542.00,0.00
2024-12-10 17:42:46,67,9732,20,47,8372.21,12542.01,0.00
2024-12-10 17:42:46,67,9733,20,47,8324.21,12543.00,0.00
2024-12-10 17:42:46,68,9733,20,48,8201.79,12543.01,0.00
2024-12-10 17:42:46,67,9733,19,48,8322.33,12543.01,0.00
2024-12-10 17:42:46,66,9733,19,47,8427.54,12543.05,0.00
2024-12-10 17:42:46,65,9733,18,47,8530.11,12543.26,0.00
2024-12-10 17:42:46,65,9734,18,47,8553.82,12544.00,0.00
2024-12-10 17:42:46,66,9734,18,48,8424.22,12544.02,0.00
2024-12-10 17:42:46,66,9735,18,48,8377.37,12545.00,0.00
2024-12-10 17:42:46,67,9735,19,48,8252.34,12545.01,0.00
2024-12-10 17:42:46,66,9735,19,47,8352.68,12545.05,0.00
2024-12-10 17:42:46,65,9735,18,47,8408.00,12545.35,0.00
2024-12-10 17:42:46,65,9736,18,47,8520.44,12546.00,0.00
2024-12-10 17:42:46,66,9736,18,48,8391.35,12546.02,0.00
2024-12-10 17:42:46,66,9737,18,48,8344.49,12547.00,0.00
2024-12-10 17:42:46,67,9737,19,48,8219.94,12547.01,0.00
2024-12-10 17:42:46,66,9737,19,47,8319.79,12547.05,0.00
2024-12-10 17:42:46,65,9737,18,47,8312.96,12547.55,0.00
2024-12-10 17:42:46,65,9738,18,47,8450.38,12548.00,0.00
2024-12-10 17:42:46,66,9738,19,47,8322.34,12548.02,0.00
2024-12-10 17:42:46,66,9739,19,47,8275.47,12549.00,0.00
2024-12-10 17:42:46,67,9739,19,48,8151.95,12549.01,0.00
2024-12-10 17:42:46,66,9739,19,47,8254.57,12549.05,0.00
2024-12-10 17:42:46,66,9740,19,47,8249.51,12550.00,0.00
2024-12-10 17:42:46,67,9740,20,47,8126.38,12550.01,0.00
2024-12-10 17:42:46,66,9740,19,47,8190.65,12550.18,0.00
2024-12-10 17:42:46,66,9741,19,47,8200.15,12551.00,0.00
2024-12-10 17:42:46,67,9741,20,47,8077.76,12551.01,0.00
2024-12-10 17:42:46,66,9741,20,46,8181.15,12551.05,0.00
2024-12-10 17:42:46,67,9740,21,46,8003.10,12551.52,0.00
2024-12-10 17:42:46,67,9741,21,46,8096.02,12552.00,0.00
2024-12-10 17:42:46,68,9741,22,46,7976.96,12552.01,0.00
2024-12-10 17:42:46,67,9741,22,45,8064.19,12552.03,0.00
2024-12-10 17:42:46,66,9741,21,45,8111.52,12552.62,0.00
2024-12-10 17:42:46,66,9742,21,45,8354.64,12553.00,0.00
2024-12-10 17:42:46,67,9742,21,46,8229.94,12553.01,0.00
2024-12-10 17:42:46,67,9743,21,46,8164.74,12554.00,0.00
2024-12-10 17:42:46,68,9743,22,46,8044.67,12554.01,0.00
2024-12-10 17:42:46,67,9743,22,45,8151.64,12554.03,0.00
2024-12-10 17:42:46,66,9743,21,45,8108.90,12554.94,0.00
2024-12-10 17:42:46,66,9744,21,45,8291.55,12555.00,0.00
2024-12-10 17:42:46,67,9744,22,45,8167.80,12555.01,0.00
2024-12-10 17:42:46,67,9745,22,45,8098.91,12556.00,0.00
2024-12-10 17:42:46,68,9745,22,46,7979.81,12556.01,0.00
2024-12-10 17:42:46,67,9745,22,45,8087.68,12556.03,0.00
2024-12-10 17:42:46,66,9745,21,45,8060.13,12556.88,0.00
2024-12-10 17:42:46,66,9746,21,45,8235.25,12557.00,0.00
2024-12-10 17:42:46,67,9746,22,45,8112.34,12557.01,0.00
2024-12-10 17:42:46,67,9746,22,45,8071.84,12558.00,0.00
2024-12-10 17:42:46,68,9746,23,45,7953.14,12558.01,0.00
2024-12-10 17:42:46,69,9745,24,45,7739.86,12558.54,0.00
2024-12-10 17:42:46,69,9746,24,45,7814.15,12559.00,0.00
2024-12-10 17:42:46,70,9746,25,45,7702.52,12559.01,0.00
2024-12-10 17:42:46,69,9746,25,44,7631.28,12559.77,0.00
2024-12-10 17:42:46,69,9747,25,44,7893.57,12560.00,0.00
2024-12-10 17:42:46,70,9747,26,44,7780.81,12560.01,0.00
2024-12-10 17:42:46,69,9747,26,43,7880.84,12560.03,0.00
2024-12-10 17:42:46,69,9748,26,43,7827.16,12561.00,0.00
2024-12-10 17:42:46,70,9748,26,44,7715.34,12561.01,0.00
2024-12-10 17:42:46,69,9748,25,44,7687.31,12561.68,0.00
2024-12-10 17:42:46,68,9748,24,44,7793.00,12561.74,0.00
2024-12-10 17:42:46,68,9749,24,44,7922.40,12562.00,0.00
2024-12-10 17:42:46,69,9749,24,45,7807.59,12562.01,0.00
2024-12-10 17:42:46,69,9750,24,45,7784.97,12563.00,0.00
2024-12-10 17:42:46,70,9750,25,45,7673.75,12563.01,0.00
2024-12-10 17:42:46,70,9751,25,45,7620.79,12564.00,0.00
2024-12-10 17:42:46,71,9751,25,46,7513.46,12564.01,0.00
2024-12-10 17:42:46,70,9751,25,45,7588.51,12564.06,0.00
2024-12-10 17:42:46,70,9752,25,45,7575.61,12565.00,0.00
2024-12-10 17:42:46,71,9752,25,46,7468.91,12565.01,0.00
2024-12-10 17:42:46,70,9752,25,45,7543.92,12565.09,0.00
2024-12-10 17:42:46,69,9752,24,45,7624.94,12565.13,0.00
2024-12-10 17:42:46,69,9753,24,45,7694.55,12566.00,0.00
2024-12-10 17:42:46,70,9753,24,46,7584.63,12566.01,0.00
2024-12-10 17:42:46,70,9754,24,46,7528.24,12567.00,0.00
2024-12-10 17:42:46,71,9754,25,46,7422.21,12567.01,0.00
2024-12-10 17:42:46,70,9754,25,45,7506.73,12567.10,0.00
2024-12-10 17:42:46,69,9754,24,45,7555.42,12567.12,0.00
2024-12-10 17:42:46,69,9755,24,45,7620.42,12568.00,0.00
2024-12-10 17:42:46,70,9755,24,46,7511.55,12568.01,0.00
2024-12-10 17:42:46,71,9754,24,47,7402.23,12568.07,0.00
2024-12-10 17:42:46,71,9755,24,47,7400.75,12569.00,0.00
2024-12-10 17:42:46,72,9755,25,47,7297.96,12569.01,0.00
2024-12-10 17:42:46,73,9754,25,48,7191.13,12569.10,0.00
2024-12-10 17:42:46,72,9754,25,47,7329.43,12569.11,0.00
2024-12-10 17:42:46,71,9754,24,47,7350.45,12569.66,0.00
2024-12-10 17:42:46,71,9755,24,47,7590.34,12570.00,0.00
2024-12-10 17:42:46,72,9755,24,48,7484.92,12570.01,0.00
2024-12-10 17:42:47,72,9756,24,48,7586.80,12571.00,0.00
2024-12-10 17:42:47,73,9756,24,49,7482.87,12571.01,0.00
2024-12-10 17:42:47,72,9756,24,48,7560.65,12571.10,0.00
2024-12-10 17:42:47,73,9755,24,49,7455.36,12571.14,0.00
2024-12-10 17:42:47,74,9754,25,49,7349.21,12571.65,0.00
2024-12-10 17:42:47,74,9755,25,49,7441.55,12572.00,0.00
2024-12-10 17:42:47,75,9755,26,49,7342.33,12572.01,0.00
2024-12-10 17:42:47,74,9755,25,49,7281.33,12572.77,0.00
2024-12-10 17:42:47,74,9756,25,49,7753.04,12573.00,0.00
2024-12-10 17:42:47,75,9756,26,49,7649.67,12573.01,0.00
2024-12-10 17:42:47,74,9756,25,49,7743.39,12573.08,0.00
2024-12-10 17:42:47,73,9756,25,48,7833.96,12573.08,0.00
2024-12-10 17:42:47,73,9757,25,48,7790.14,12574.00,0.00
2024-12-10 17:42:47,74,9757,25,49,7684.87,12574.01,0.00
2024-12-10 17:42:47,73,9757,24,49,7648.01,12574.45,0.00
2024-12-10 17:42:47,73,9758,24,49,7732.20,12575.00,0.00
2024-12-10 17:42:47,74,9758,24,50,7627.71,12575.01,0.00
2024-12-10 17:42:47,73,9758,24,49,7704.69,12575.10,0.00
2024-12-10 17:42:47,72,9758,24,48,7786.74,12575.19,0.00
2024-12-10 17:42:47,72,9759,24,48,7770.54,12576.00,0.00
2024-12-10 17:42:47,73,9759,24,49,7664.09,12576.01,0.00
2024-12-10 17:42:47,72,9759,23,49,7608.39,12576.57,0.00
2024-12-10 17:42:47,72,9760,23,49,7709.81,12577.00,0.00
2024-12-10 17:42:47,73,9760,24,49,7604.19,12577.01,0.00
2024-12-10 17:42:47,72,9760,24,48,7681.91,12577.10,0.00
2024-12-10 17:42:47,73,9759,24,49,7556.06,12577.29,0.00
2024-12-10 17:42:47,73,9760,24,49,7666.20,12578.00,0.00
2024-12-10 17:42:47,74,9760,24,50,7562.61,12578.01,0.00
2024-12-10 17:42:47,75,9759,24,51,7371.44,12578.49,0.00
2024-12-10 17:42:47,75,9760,24,51,7618.07,12579.00,0.00
2024-12-10 17:42:47,76,9760,24,52,7517.83,12579.01,0.00
2024-12-10 17:42:47,75,9760,24,51,7587.93,12579.11,0.00
2024-12-10 17:42:47,74,9760,24,50,7598.13,12579.70,0.00
2024-12-10 17:42:47,73,9760,23,50,7693.60,12579.71,0.00
2024-12-10 17:42:47,73,9761,23,50,8000.90,12580.00,0.00
2024-12-10 17:42:47,74,9761,24,50,7892.78,12580.01,0.00
2024-12-10 17:42:47,74,9762,24,50,7835.08,12581.00,0.00
2024-12-10 17:42:47,75,9762,24,51,7730.62,12581.01,0.00
2024-12-10 17:42:47,74,9762,24,50,7804.53,12581.11,0.00
2024-12-10 17:42:47,73,9762,23,50,7901.12,12581.18,0.00
2024-12-10 17:42:47,73,9763,23,50,7898.42,12582.00,0.00
2024-12-10 17:42:47,74,9763,24,50,7791.68,12582.01,0.00
2024-12-10 17:42:47,73,9763,23,50,7777.82,12582.37,0.00
2024-12-10 17:42:47,73,9764,23,50,7866.77,12583.00,0.00
2024-12-10 17:42:47,74,9764,23,51,7760.46,12583.01,0.00
2024-12-10 17:42:47,73,9764,23,50,7863.33,12583.03,0.00
2024-12-10 17:42:47,72,9764,23,49,7939.38,12583.11,0.00
2024-12-10 17:42:47,72,9765,23,49,7926.90,12584.00,0.00
2024-12-10 17:42:47,73,9765,24,49,7818.31,12584.01,0.00
2024-12-10 17:42:47,73,9766,24,49,7757.11,12585.00,0.00
2024-12-10 17:42:47,74,9766,24,50,7652.28,12585.01,0.00
2024-12-10 17:42:47,73,9766,24,49,7717.51,12585.12,0.00
2024-12-10 17:42:47,73,9767,24,49,7702.73,12586.00,0.00
2024-12-10 17:42:47,74,9767,24,50,7598.64,12586.01,0.00
2024-12-10 17:42:47,74,9768,24,50,7533.06,12587.00,0.00
2024-12-10 17:42:47,75,9768,24,51,7432.62,12587.01,0.00
2024-12-10 17:42:47,74,9768,24,50,7527.97,12587.04,0.00
2024-12-10 17:42:47,73,9768,24,49,7598.37,12587.11,0.00
2024-12-10 17:42:47,72,9768,23,49,7634.27,12587.65,0.00
2024-12-10 17:42:47,71,9768,22,49,7656.73,12587.97,0.00
2024-12-10 17:42:47,71,9769,22,49,7830.50,12588.00,0.00
2024-12-10 17:42:47,72,9769,23,49,7721.74,12588.01,0.00
2024-12-10 17:42:47,73,9768,23,50,7521.36,12588.52,0.00
2024-12-10 17:42:47,73,9769,23,50,7643.50,12589.00,0.00
2024-12-10 17:42:47,74,9769,24,50,7540.21,12589.01,0.00
2024-12-10 17:42:47,75,9768,25,50,7327.54,12589.67,0.00
2024-12-10 17:42:47,75,9769,25,50,7583.73,12590.00,0.00
2024-12-10 17:42:47,76,9769,26,50,7483.95,12590.01,0.00
2024-12-10 17:42:47,76,9770,26,50,7577.05,12591.00,0.00
2024-12-10 17:42:47,77,9770,26,51,7478.65,12591.01,0.00
2024-12-10 17:42:47,76,9770,26,50,7562.19,12591.12,0.00
2024-12-10 17:42:47,76,9771,26,50,7538.33,12592.00,0.00
2024-12-10 17:42:47,77,9771,27,50,7440.43,12592.01,0.00
2024-12-10 17:42:47,77,9772,27,50,7372.51,12593.00,0.00
2024-12-10 17:42:47,78,9772,28,50,7277.99,12593.01,0.00
2024-12-10 17:42:47,77,9772,28,49,7338.21,12593.12,0.00
2024-12-10 17:42:47,77,9773,28,49,7316.65,12594.00,0.00
2024-12-10 17:42:47,78,9773,28,50,7222.85,12594.01,0.00
2024-12-10 17:42:47,77,9773,27,50,7265.98,12594.09,0.00
2024-12-10 17:42:47,78,9772,28,50,7106.75,12594.38,0.00
2024-12-10 17:42:47,78,9773,28,50,7255.96,12595.00,0.00
2024-12-10 17:42:47,79,9773,29,50,7164.12,12595.01,0.00
2024-12-10 17:42:47,78,9773,28,50,7217.25,12595.08,0.00
2024-12-10 17:42:47,78,9774,28,50,7388.90,12596.00,0.00
2024-12-10 17:42:47,79,9774,28,51,7295.37,12596.01,0.00
2024-12-10 17:42:47,78,9774,28,50,7359.88,12596.10,0.00
2024-12-10 17:42:47,79,9773,28,51,7223.83,12596.47,0.00
2024-12-10 17:42:47,79,9774,28,51,7373.15,12597.00,0.00
2024-12-10 17:42:47,80,9774,29,51,7280.99,12597.01,0.00
2024-12-10 17:42:47,79,9774,29,50,7344.49,12597.10,0.00
2024-12-10 17:42:47,80,9773,30,50,7241.70,12597.21,0.00
2024-12-10 17:42:47,80,9774,30,50,7489.40,12598.00,0.00
2024-12-10 17:42:47,81,9774,30,51,7396.94,12598.01,0.00
2024-12-10 17:42:47,81,9775,30,51,7522.82,12599.00,0.00
2024-12-10 17:42:47,82,9775,31,51,7431.08,12599.01,0.00
2024-12-10 17:42:47,81,9775,30,51,7361.82,12599.73,0.00
2024-12-10 17:42:47,81,9776,30,51,7483.35,12600.00,0.00
2024-12-10 17:42:47,82,9776,30,52,7392.08,12600.01,0.00
2024-12-10 17:42:47,81,9776,30,51,7442.94,12600.10,0.00
2024-12-10 17:42:48,81,9777,30,51,7415.33,12601.00,0.00
2024-12-10 17:42:48,82,9777,31,51,7324.90,12601.01,0.00
2024-12-10 17:42:48,81,9777,30,51,7331.60,12601.42,0.00
2024-12-10 17:42:48,80,9777,29,51,7374.85,12601.72,0.00
2024-12-10 17:42:48,80,9778,29,51,7497.93,12602.00,0.00
2024-12-10 17:42:48,81,9778,30,51,7405.36,12602.01,0.00
2024-12-10 17:42:48,80,9778,30,50,7475.91,12602.10,0.00
2024-12-10 17:42:48,81,9777,30,51,7365.76,12602.25,0.00
2024-12-10 17:42:48,81,9778,30,51,7394.15,12603.00,0.00
2024-12-10 17:42:48,82,9778,30,52,7303.98,12603.01,0.00
2024-12-10 17:42:48,82,9779,30,52,7386.85,12604.00,0.00
2024-12-10 17:42:48,83,9779,30,53,7297.85,12604.01,0.00
2024-12-10 17:42:48,82,9779,30,52,7363.83,12604.11,0.00
2024-12-10 17:42:48,83,9778,30,53,7270.57,12604.17,0.00
2024-12-10 17:42:48,83,9779,30,53,7265.28,12605.00,0.00
2024-12-10 17:42:48,84,9779,31,53,7178.79,12605.01,0.00
2024-12-10 17:42:48,84,9780,31,53,7254.87,12606.00,0.00
2024-12-10 17:42:48,85,9780,32,53,7169.52,12606.01,0.00
2024-12-10 17:42:48,85,9781,32,53,7094.21,12607.00,0.00
2024-12-10 17:42:48,86,9781,33,53,7011.72,12607.01,0.00
2024-12-10 17:42:48,85,9781,33,52,7079.41,12607.09,0.00
2024-12-10 17:42:48,85,9782,33,52,7050.19,12608.00,0.00
2024-12-10 17:42:48,86,9782,34,52,6968.21,12608.01,0.00
2024-12-10 17:42:48,85,9782,33,52,7042.80,12608.06,0.00
2024-12-10 17:42:48,84,9782,33,51,7116.14,12608.08,0.00
2024-12-10 17:42:48,83,9782,33,50,7147.60,12608.48,0.00
2024-12-10 17:42:48,83,9783,33,50,7173.76,12609.00,0.00
2024-12-10 17:42:48,84,9783,34,50,7088.36,12609.01,0.00
2024-12-10 17:42:48,85,9782,34,51,6996.10,12609.11,0.00
2024-12-10 17:42:48,85,9783,34,51,7051.48,12610.00,0.00
2024-12-10 17:42:48,86,9783,34,52,6969.49,12610.01,0.00
2024-12-10 17:42:48,85,9783,34,51,7032.24,12610.09,0.00
2024-12-10 17:42:48,85,9784,34,51,7155.85,12611.00,0.00
2024-12-10 17:42:48,86,9784,35,51,7072.65,12611.01,0.00
2024-12-10 17:42:48,85,9784,34,51,7080.51,12611.22,0.00
2024-12-10 17:42:48,85,9785,34,51,7131.42,12612.00,0.00
2024-12-10 17:42:48,86,9785,34,52,7048.49,12612.01,0.00
2024-12-10 17:42:48,85,9785,33,52,7074.44,12612.22,0.00
2024-12-10 17:42:48,84,9785,32,52,7101.73,12612.68,0.00
2024-12-10 17:42:48,84,9786,32,52,7180.69,12613.00,0.00
2024-12-10 17:42:48,85,9786,33,52,7096.21,12613.01,0.00
2024-12-10 17:42:48,84,9786,33,51,7174.59,12613.06,0.00
2024-12-10 17:42:48,84,9787,33,51,7120.06,12614.00,0.00
2024-12-10 17:42:48,85,9787,34,51,7036.29,12614.01,0.00
2024-12-10 17:42:48,84,9787,34,50,7092.21,12614.08,0.00
2024-12-10 17:42:48,84,9788,34,50,7064.68,12615.00,0.00
2024-12-10 17:42:48,85,9788,35,50,6981.56,12615.01,0.00
2024-12-10 17:42:48,84,9788,34,50,6952.24,12615.44,0.00
2024-12-10 17:42:48,83,9788,33,50,7001.21,12615.71,0.00
2024-12-10 17:42:48,84,9787,33,51,6885.47,12615.98,0.00
2024-12-10 17:42:48,84,9788,33,51,7031.95,12616.00,0.00
2024-12-10 17:42:48,85,9788,33,52,6949.22,12616.01,0.00
2024-12-10 17:42:48,84,9788,33,51,7015.47,12616.11,0.00
2024-12-10 17:42:48,83,9788,32,51,7039.09,12616.59,0.00
2024-12-10 17:42:48,83,9789,32,51,7216.69,12617.00,0.00
2024-12-10 17:42:48,84,9789,33,51,7130.78,12617.01,0.00
2024-12-10 17:42:48,84,9790,33,51,7042.19,12618.00,0.00
2024-12-10 17:42:48,85,9790,34,51,6959.34,12618.01,0.00
2024-12-10 17:42:48,84,9790,34,50,7027.21,12618.11,0.00
2024-12-10 17:42:48,84,9791,34,50,6969.81,12619.00,0.00
2024-12-10 17:42:48,85,9791,34,51,6887.81,12619.01,0.00
2024-12-10 17:42:48,84,9791,33,51,6824.52,12619.83,0.00
2024-12-10 17:42:48,84,9792,33,51,6911.94,12620.00,0.00
2024-12-10 17:42:48,85,9792,33,52,6830.63,12620.01,0.00
2024-12-10 17:42:48,84,9792,33,51,6896.97,12620.12,0.00
2024-12-10 17:42:48,84,9793,33,51,6833.10,12621.00,0.00
2024-12-10 17:42:48,85,9793,33,52,6752.71,12621.01,0.00
2024-12-10 17:42:48,86,9792,33,53,6458.18,12621.91,0.00
2024-12-10 17:42:48,86,9793,33,53,6688.45,12622.00,0.00
2024-12-10 17:42:48,87,9793,34,53,6611.57,12622.01,0.00
2024-12-10 17:42:48,86,9793,34,52,6672.35,12622.12,0.00
2024-12-10 17:42:48,85,9793,33,52,6675.14,12622.72,0.00
2024-12-10 17:42:48,84,9793,32,52,6753.10,12622.73,0.00
2024-12-10 17:42:48,83,9793,31,52,6817.78,12622.79,0.00
2024-12-10 17:42:48,83,9794,31,52,7044.60,12623.00,0.00
2024-12-10 17:42:48,84,9794,31,53,6960.73,12623.01,0.00
2024-12-10 17:42:48,83,9794,30,53,6951.98,12623.39,0.00
2024-12-10 17:42:48,82,9794,29,53,6976.70,12623.84,0.00
2024-12-10 17:42:48,82,9795,29,53,7075.63,12624.00,0.00
2024-12-10 17:42:48,83,9795,30,53,6990.38,12624.01,0.00
2024-12-10 17:42:48,82,9795,29,53,7074.93,12624.01,0.00
2024-12-10 17:42:48,81,9795,29,52,7148.29,12624.11,0.00
2024-12-10 17:42:48,81,9796,29,52,7102.61,12625.00,0.00
2024-12-10 17:42:48,82,9796,29,53,7015.99,12625.01,0.00
2024-12-10 17:42:48,81,9796,28,53,7047.02,12625.20,0.00
2024-12-10 17:42:48,80,9796,27,53,7018.58,12625.76,0.00
2024-12-10 17:42:48,80,9797,27,53,7127.19,12626.00,0.00
2024-12-10 17:42:48,81,9797,27,54,7039.20,12626.01,0.00
2024-12-10 17:42:48,80,9797,26,54,7024.94,12626.35,0.00
2024-12-10 17:42:48,80,9798,26,54,7088.68,12627.00,0.00
2024-12-10 17:42:48,81,9798,26,55,7001.16,12627.01,0.00
2024-12-10 17:42:48,80,9798,26,54,7070.02,12627.11,0.00
2024-12-10 17:42:48,79,9798,25,54,7106.79,12627.17,0.00
2024-12-10 17:42:48,79,9799,25,54,7152.47,12628.00,0.00
2024-12-10 17:42:48,80,9799,26,54,7063.07,12628.01,0.00
2024-12-10 17:42:48,80,9800,26,54,7030.52,12629.00,0.00
2024-12-10 17:42:48,81,9800,27,54,6943.72,12629.01,0.00
2024-12-10 17:42:49,81,9801,27,54,6877.63,12630.00,0.00
2024-12-10 17:42:49,82,9801,28,54,6793.76,12630.01,0.00
2024-12-10 17:42:49,82,9802,28,54,6698.31,12631.00,0.00
2024-12-10 17:42:49,83,9802,28,55,6617.61,12631.01,0.00
2024-12-10 17:42:49,82,9802,28,54,6679.86,12631.11,0.00
2024-12-10 17:42:49,82,9803,28,54,6619.74,12632.00,0.00
2024-12-10 17:42:49,83,9803,29,54,6539.98,12632.01,0.00
2024-12-10 17:42:49,82,9803,28,54,6418.56,12632.77,0.00
2024-12-10 17:42:49,82,9804,28,54,6536.67,12633.00,0.00
2024-12-10 17:42:49,83,9804,29,54,6457.91,12633.01,0.00
2024-12-10 17:42:49,82,9804,29,53,6521.30,12633.12,0.00
2024-12-10 17:42:49,82,9805,29,53,6455.94,12634.00,0.00
2024-12-10 17:42:49,83,9805,30,53,6378.16,12634.01,0.00
2024-12-10 17:42:49,82,9805,30,52,6373.59,12634.21,0.00
2024-12-10 17:42:49,82,9806,30,52,6344.70,12635.00,0.00
2024-12-10 17:42:49,83,9806,30,53,6268.26,12635.01,0.00
2024-12-10 17:42:49,82,9806,30,52,6304.70,12635.20,0.00
2024-12-10 17:42:49,82,9807,30,52,6260.92,12636.00,0.00
2024-12-10 17:42:49,83,9807,30,53,6185.49,12636.01,0.00
2024-12-10 17:42:49,82,9807,29,53,6132.57,12636.73,0.00
2024-12-10 17:42:49,82,9808,29,53,6196.41,12637.00,0.00
2024-12-10 17:42:49,83,9808,29,54,6121.76,12637.01,0.00
2024-12-10 17:42:49,82,9808,29,53,6187.19,12637.07,0.00
2024-12-10 17:42:49,83,9807,29,54,6108.09,12637.13,0.00
2024-12-10 17:42:49,83,9808,29,54,6166.55,12638.00,0.00
2024-12-10 17:42:49,84,9808,30,54,6093.14,12638.01,0.00
2024-12-10 17:42:49,83,9808,30,53,6157.44,12638.07,0.00
2024-12-10 17:42:49,82,9808,30,52,6200.21,12638.18,0.00
2024-12-10 17:42:49,81,9808,29,52,6209.37,12638.69,0.00
2024-12-10 17:42:49,80,9808,29,51,6252.39,12638.75,0.00
2024-12-10 17:42:49,79,9808,28,51,6300.97,12638.90,0.00
2024-12-10 17:42:49,79,9809,28,51,6605.53,12639.00,0.00
2024-12-10 17:42:49,80,9809,29,51,6522.96,12639.01,0.00
2024-12-10 17:42:49,80,9810,29,51,6459.18,12640.00,0.00
2024-12-10 17:42:49,81,9810,30,51,6379.44,12640.01,0.00
2024-12-10 17:42:49,80,9810,30,50,6407.12,12640.24,0.00
2024-12-10 17:42:49,80,9811,30,50,6382.24,12641.00,0.00
2024-12-10 17:42:49,81,9811,31,50,6303.45,12641.01,0.00
2024-12-10 17:42:49,80,9811,31,49,6241.09,12641.76,0.00
2024-12-10 17:42:49,79,9811,30,49,6304.13,12641.77,0.00
2024-12-10 17:42:49,80,9810,31,49,6212.77,12641.89,0.00
2024-12-10 17:42:49,80,9811,31,49,6432.38,12642.00,0.00
2024-12-10 17:42:49,81,9811,31,50,6352.97,12642.01,0.00
2024-12-10 17:42:49,80,9811,31,49,6381.89,12642.24,0.00
2024-12-10 17:42:49,79,9811,31,48,6461.43,12642.24,0.00
2024-12-10 17:42:49,78,9811,30,48,6542.74,12642.24,0.00
2024-12-10 17:42:49,78,9812,30,48,6682.29,12643.00,0.00
2024-12-10 17:42:49,79,9812,31,48,6597.71,12643.01,0.00
2024-12-10 17:42:49,79,9813,31,48,6520.39,12644.00,0.00
2024-12-10 17:42:49,80,9813,31,49,6438.88,12644.01,0.00
2024-12-10 17:42:49,81,9812,31,50,6340.71,12644.19,0.00
2024-12-10 17:42:49,80,9812,31,49,6514.83,12644.25,0.00
2024-12-10 17:42:49,80,9813,31,49,6484.76,12645.00,0.00
2024-12-10 17:42:49,81,9813,31,50,6404.70,12645.01,0.00
2024-12-10 17:42:49,80,9813,31,49,6428.89,12645.24,0.00
2024-12-10 17:42:49,80,9814,31,49,6555.91,12646.00,0.00
2024-12-10 17:42:49,81,9814,31,50,6474.98,12646.01,0.00
2024-12-10 17:42:49,80,9814,31,49,6525.92,12646.11,0.00
2024-12-10 17:42:49,81,9813,32,49,6370.66,12646.73,0.00
2024-12-10 17:42:49,81,9814,32,49,6420.48,12647.00,0.00
2024-12-10 17:42:49,82,9814,33,49,6342.18,12647.01,0.00
2024-12-10 17:42:49,81,9814,32,49,6244.32,12647.69,0.00
2024-12-10 17:42:49,81,9815,32,49,6469.05,12648.00,0.00
2024-12-10 17:42:49,82,9815,32,50,6390.16,12648.01,0.00
2024-12-10 17:42:49,81,9815,32,49,6433.81,12648.23,0.00
2024-12-10 17:42:49,81,9816,32,49,6374.39,12649.00,0.00
2024-12-10 17:42:49,82,9816,33,49,6296.65,12649.01,0.00
2024-12-10 17:42:49,81,9816,32,49,6335.35,12649.04,0.00
2024-12-10 17:42:49,81,9817,32,49,6278.25,12650.00,0.00
2024-12-10 17:42:49,82,9817,33,49,6201.68,12650.01,0.00
2024-12-10 17:42:49,82,9818,33,49,6113.91,12651.00,0.00
2024-12-10 17:42:49,83,9818,33,50,6040.24,12651.01,0.00
2024-12-10 17:42:49,83,9819,33,50,5928.57,12652.00,0.00
2024-12-10 17:42:49,84,9819,33,51,5857.99,12652.01,0.00
2024-12-10 17:42:49,83,9819,33,50,5896.57,12652.05,0.00
2024-12-10 17:42:49,82,9819,32,50,5965.40,12652.06,0.00
2024-12-10 17:42:49,81,9819,31,50,5945.28,12652.72,0.00
2024-12-10 17:42:49,80,9819,30,50,6014.56,12652.72,0.00
2024-12-10 17:42:49,80,9820,30,50,6039.03,12653.00,0.00
2024-12-10 17:42:49,81,9820,30,51,5964.47,12653.01,0.00
2024-12-10 17:42:49,80,9820,30,50,6013.75,12653.10,0.00
2024-12-10 17:42:49,79,9820,29,50,6064.31,12653.30,0.00
2024-12-10 17:42:49,79,9821,29,50,6020.92,12654.00,0.00
2024-12-10 17:42:49,80,9821,29,51,5945.66,12654.01,0.00
2024-12-10 17:42:49,80,9822,29,51,5869.37,12655.00,0.00
2024-12-10 17:42:49,81,9822,29,52,5796.91,12655.01,0.00
2024-12-10 17:42:49,81,9823,29,52,5699.92,12656.00,0.00
2024-12-10 17:42:49,82,9823,30,52,5630.40,12656.01,0.00
2024-12-10 17:42:49,81,9823,30,51,5604.13,12656.52,0.00
2024-12-10 17:42:49,80,9823,29,51,5665.77,12656.55,0.00
2024-12-10 17:42:49,79,9823,29,50,5663.57,12656.73,0.00
2024-12-10 17:42:49,78,9823,29,49,5701.18,12656.85,0.00
2024-12-10 17:42:49,78,9824,29,49,5837.20,12657.00,0.00
2024-12-10 17:42:49,79,9824,30,49,5763.32,12657.01,0.00
2024-12-10 17:42:49,78,9824,29,49,5757.78,12657.37,0.00
2024-12-10 17:42:49,78,9825,29,49,5720.00,12658.00,0.00
2024-12-10 17:42:49,79,9825,29,50,5647.59,12658.01,0.00
2024-12-10 17:42:49,78,9825,29,49,5697.51,12658.10,0.00
2024-12-10 17:42:50,78,9826,29,49,5603.66,12659.00,0.00
2024-12-10 17:42:50,79,9826,30,49,5532.72,12659.01,0.00
2024-12-10 17:42:50,78,9826,30,48,5567.98,12659.14,0.00
2024-12-10 17:42:50,77,9826,30,47,5552.34,12659.58,0.00
2024-12-10 17:42:50,76,9826,29,47,5587.61,12659.76,0.00
2024-12-10 17:42:50,75,9826,28,47,5581.87,12659.89,0.00
2024-12-10 17:42:50,75,9827,28,47,5726.85,12660.00,0.00
2024-12-10 17:42:50,76,9827,29,47,5651.50,12660.01,0.00
2024-12-10 17:42:50,75,9827,28,47,5715.06,12660.09,0.00
2024-12-10 17:42:50,74,9827,28,46,5766.63,12660.13,0.00
2024-12-10 17:42:50,73,9827,27,46,5816.20,12660.37,0.00
2024-12-10 17:42:50,73,9828,27,46,5781.74,12661.00,0.00
2024-12-10 17:42:50,74,9828,27,47,5703.61,12661.01,0.00
2024-12-10 17:42:50,73,9828,27,46,5762.69,12661.15,0.00
2024-12-10 17:42:50,72,9828,26,46,5828.66,12661.26,0.00
2024-12-10 17:42:50,71,9828,26,45,5864.70,12661.52,0.00
2024-12-10 17:42:50,71,9829,26,45,5862.36,12662.00,0.00
2024-12-10 17:42:50,72,9829,27,45,5780.94,12662.01,0.00
2024-12-10 17:42:50,72,9830,27,45,5682.16,12663.00,0.00
2024-12-10 17:42:50,73,9830,27,46,5604.33,12663.01,0.00
2024-12-10 17:42:50,72,9830,27,45,5662.85,12663.15,0.00
2024-12-10 17:42:50,71,9830,26,45,5653.75,12663.73,0.00
2024-12-10 17:42:50,70,9830,25,45,5632.13,12663.91,0.00
2024-12-10 17:42:50,70,9831,25,45,5802.25,12664.00,0.00
2024-12-10 17:42:50,71,9831,26,45,5720.53,12664.01,0.00
2024-12-10 17:42:50,70,9831,25,45,5616.14,12664.69,0.00
2024-12-10 17:42:50,69,9831,25,44,5663.04,12664.75,0.00
2024-12-10 17:42:50,69,9832,25,44,5801.01,12665.00,0.00
2024-12-10 17:42:50,70,9832,25,45,5718.14,12665.01,0.00
2024-12-10 17:42:50,69,9832,25,44,5780.85,12665.16,0.00
2024-12-10 17:42:50,69,9833,25,44,5749.26,12666.00,0.00
2024-12-10 17:42:50,70,9833,25,45,5667.13,12666.01,0.00
2024-12-10 17:42:50,71,9832,25,46,5580.18,12666.10,0.00
2024-12-10 17:42:50,70,9832,25,45,5663.54,12666.17,0.00
2024-12-10 17:42:50,71,9831,26,45,5555.29,12666.42,0.00
2024-12-10 17:42:50,71,9832,26,45,5662.84,12667.00,0.00
2024-12-10 17:42:50,72,9832,27,45,5584.19,12667.01,0.00
2024-12-10 17:42:50,71,9832,26,45,5564.75,12667.18,0.00
2024-12-10 17:42:50,71,9833,26,45,5964.48,12668.00,0.00
2024-12-10 17:42:50,72,9833,26,46,5881.64,12668.01,0.00
2024-12-10 17:42:50,71,9833,26,45,5962.69,12668.01,0.00
2024-12-10 17:42:50,70,9833,26,44,6044.26,12668.01,0.00
2024-12-10 17:42:50,69,9833,26,43,6122.70,12668.07,0.00
2024-12-10 17:42:50,69,9834,26,43,6083.69,12669.00,0.00
2024-12-10 17:42:50,70,9834,26,44,5996.78,12669.01,0.00
2024-12-10 17:42:50,69,9834,26,43,6056.15,12669.03,0.00
2024-12-10 17:42:50,68,9834,25,43,6139.64,12669.06,0.00
2024-12-10 17:42:50,67,9834,25,42,6229.39,12669.06,0.00
2024-12-10 17:42:50,68,9833,25,43,6087.60,12669.49,0.00
2024-12-10 17:42:50,68,9834,25,43,6228.67,12670.00,0.00
2024-12-10 17:42:50,69,9834,26,43,6138.40,12670.01,0.00
2024-12-10 17:42:50,68,9834,26,42,6187.70,12670.07,0.00
2024-12-10 17:42:50,67,9834,25,42,6251.75,12670.30,0.00
2024-12-10 17:42:50,67,9835,25,42,6435.74,12671.00,0.00
2024-12-10 17:42:50,68,9835,26,42,6341.10,12671.01,0.00
2024-12-10 17:42:50,67,9835,26,41,6318.50,12671.07,0.00
2024-12-10 17:42:50,66,9835,26,40,6324.70,12671.58,0.00
2024-12-10 17:42:50,67,9834,26,41,6203.70,12671.75,0.00
2024-12-10 17:42:50,67,9835,26,41,6535.19,12672.00,0.00
2024-12-10 17:42:50,68,9835,26,42,6439.08,12672.01,0.00
2024-12-10 17:42:50,67,9835,25,42,6413.25,12672.54,0.00
2024-12-10 17:42:50,66,9835,24,42,6463.53,12672.73,0.00
2024-12-10 17:42:50,66,9836,24,42,6812.18,12673.00,0.00
2024-12-10 17:42:50,67,9836,24,43,6710.50,12673.01,0.00
2024-12-10 17:42:50,66,9836,24,42,6796.84,12673.11,0.00
2024-12-10 17:42:50,66,9837,24,42,6781.74,12674.00,0.00
2024-12-10 17:42:50,67,9837,25,42,6680.52,12674.01,0.00
2024-12-10 17:42:50,66,9837,24,42,6615.37,12674.62,0.00
2024-12-10 17:42:50,66,9838,24,42,6747.26,12675.00,0.00
2024-12-10 17:42:50,67,9838,25,42,6646.56,12675.01,0.00
2024-12-10 17:42:50,66,9838,25,41,6729.99,12675.12,0.00
2024-12-10 17:42:50,66,9839,25,41,6706.15,12676.00,0.00
2024-12-10 17:42:50,67,9839,26,41,6606.06,12676.01,0.00
2024-12-10 17:42:50,66,9839,25,41,6661.99,12676.05,0.00
2024-12-10 17:42:50,65,9839,25,40,6715.73,12676.11,0.00
2024-12-10 17:42:50,66,9838,25,41,6501.33,12676.83,0.00
2024-12-10 17:42:50,66,9839,25,41,6677.37,12677.00,0.00
2024-12-10 17:42:50,67,9839,26,41,6577.71,12677.01,0.00
2024-12-10 17:42:50,66,9839,25,41,6675.45,12677.02,0.00
2024-12-10 17:42:50,66,9840,25,41,6773.50,12678.00,0.00
2024-12-10 17:42:50,67,9840,25,42,6672.40,12678.01,0.00
2024-12-10 17:42:50,68,9839,26,42,6574.28,12678.04,0.00
2024-12-10 17:42:50,67,9839,26,41,6767.03,12678.04,0.00
2024-12-10 17:42:50,66,9839,26,40,6859.96,12678.11,0.00
2024-12-10 17:42:50,65,9839,25,40,6765.36,12678.94,0.00
2024-12-10 17:42:50,65,9840,25,40,6952.67,12679.00,0.00
2024-12-10 17:42:50,66,9840,26,40,6847.32,12679.02,0.00
2024-12-10 17:42:50,65,9840,25,40,6884.46,12679.25,0.00
2024-12-10 17:42:50,65,9840,25,40,7033.86,12680.00,0.00
2024-12-10 17:42:50,66,9840,26,40,6927.29,12680.02,0.00
2024-12-10 17:42:50,65,9840,26,39,7022.18,12680.09,0.00
2024-12-10 17:42:50,64,9840,25,39,7072.90,12680.47,0.00
2024-12-10 17:42:50,64,9841,25,39,7075.80,12681.00,0.00
2024-12-10 17:42:50,65,9841,26,39,6966.94,12681.02,0.00
2024-12-10 17:42:50,64,9841,25,39,7069.22,12681.06,0.00
2024-12-10 17:42:50,65,9840,25,40,6888.37,12681.35,0.00
2024-12-10 17:42:50,65,9841,25,40,7052.49,12682.00,0.00
2024-12-10 17:42:50,66,9841,26,40,6945.64,12682.02,0.00
2024-12-10 17:42:50,65,9841,26,39,7038.86,12682.09,0.00
2024-12-10 17:42:50,66,9840,27,39,6922.63,12682.20,0.00
2024-12-10 17:42:50,65,9840,27,38,7150.36,12682.54,0.00
2024-12-10 17:42:50,66,9839,28,38,7015.26,12682.77,0.00
2024-12-10 17:42:50,66,9840,28,38,7303.83,12683.00,0.00
2024-12-10 17:42:50,67,9840,28,39,7194.82,12683.01,0.00
2024-12-10 17:42:50,68,9839,29,39,6884.23,12683.78,0.00
2024-12-10 17:42:50,68,9840,29,39,7546.75,12684.00,0.00
2024-12-10 17:42:50,69,9840,30,39,7437.38,12684.01,0.00
2024-12-10 17:42:50,68,9840,30,38,7535.58,12684.09,0.00
2024-12-10 17:42:50,68,9841,30,38,7688.61,12685.00,0.00
2024-12-10 17:42:50,69,9841,31,38,7577.18,12685.01,0.00
2024-12-10 17:42:50,68,9841,30,38,7658.77,12685.06,0.00
2024-12-10 17:42:50,67,9841,30,37,7744.71,12685.07,0.00
2024-12-10 17:42:50,68,9840,30,38,7558.37,12685.65,0.00
2024-12-10 17:42:50,68,9841,30,38,7854.95,12686.00,0.00
2024-12-10 17:42:50,69,9841,31,38,7741.11,12686.01,0.00
2024-12-10 17:42:51,68,9841,30,38,7754.13,12686.51,0.00
2024-12-10 17:42:51,68,9842,30,38,7955.78,12687.00,0.00
2024-12-10 17:42:51,69,9842,30,39,7840.48,12687.01,0.00
2024-12-10 17:42:51,68,9842,30,38,7940.88,12687.09,0.00
2024-12-10 17:42:51,68,9843,30,38,7890.71,12688.00,0.00
2024-12-10 17:42:51,69,9843,30,39,7776.35,12688.01,0.00
2024-12-10 17:42:51,69,9844,30,39,7669.53,12689.00,0.00
2024-12-10 17:42:51,70,9844,31,39,7559.96,12689.01,0.00
2024-12-10 17:42:51,69,9844,30,39,7665.86,12689.03,0.00
2024-12-10 17:42:51,68,9844,30,38,7769.28,12689.07,0.00
2024-12-10 17:42:51,67,9844,29,38,7808.40,12689.63,0.00
2024-12-10 17:42:51,67,9845,29,38,7891.04,12690.00,0.00
2024-12-10 17:42:51,68,9845,29,39,7775.00,12690.01,0.00
2024-12-10 17:42:51,67,9845,28,39,7832.40,12690.18,0.00
2024-12-10 17:42:51,67,9846,28,39,7829.02,12691.00,0.00
2024-12-10 17:42:51,68,9846,29,39,7713.89,12691.01,0.00
2024-12-10 17:42:51,67,9846,29,38,7825.25,12691.03,0.00
2024-12-10 17:42:51,66,9846,28,38,7705.34,12691.88,0.00
2024-12-10 17:42:51,66,9847,28,38,7882.35,12692.00,0.00
2024-12-10 17:42:51,67,9847,29,38,7764.70,12692.01,0.00
2024-12-10 17:42:51,66,9847,28,38,7762.16,12692.61,0.00
2024-12-10 17:42:51,66,9848,28,38,7852.23,12693.00,0.00
2024-12-10 17:42:51,67,9848,28,39,7735.04,12693.01,0.00
2024-12-10 17:42:51,67,9849,28,39,7686.39,12694.00,0.00
2024-12-10 17:42:51,68,9849,29,39,7573.35,12694.01,0.00
2024-12-10 17:42:51,67,9849,29,38,7663.68,12694.06,0.00
2024-12-10 17:42:51,67,9850,29,38,7658.57,12695.00,0.00
2024-12-10 17:42:51,68,9850,29,39,7545.94,12695.01,0.00
2024-12-10 17:42:51,67,9850,28,39,7465.61,12695.63,0.00
2024-12-10 17:42:51,67,9851,28,39,7608.01,12696.00,0.00
2024-12-10 17:42:51,68,9851,28,40,7496.13,12696.01,0.00
2024-12-10 17:42:51,67,9851,28,39,7600.45,12696.06,0.00
2024-12-10 17:42:51,66,9851,27,39,7658.11,12696.50,0.00
2024-12-10 17:42:51,66,9852,27,39,7710.43,12697.00,0.00
2024-12-10 17:42:51,67,9852,27,40,7595.34,12697.01,0.00
2024-12-10 17:42:51,66,9852,26,40,7644.75,12697.23,0.00
2024-12-10 17:42:51,66,9853,26,40,7662.58,12698.00,0.00
2024-12-10 17:42:51,67,9853,27,40,7548.21,12698.01,0.00
2024-12-10 17:42:51,66,9853,27,39,7649.14,12698.06,0.00
2024-12-10 17:42:51,65,9853,26,39,7696.67,12698.62,0.00
2024-12-10 17:42:51,65,9854,26,39,7765.33,12699.00,0.00
2024-12-10 17:42:51,66,9854,26,40,7647.68,12699.02,0.00
2024-12-10 17:42:51,65,9854,25,40,7679.47,12699.25,0.00
2024-12-10 17:42:51,65,9855,25,40,7779.63,12700.00,0.00
2024-12-10 17:42:51,66,9855,26,40,7661.75,12700.02,0.00
2024-12-10 17:42:51,65,9855,26,39,7765.97,12700.06,0.00
2024-12-10 17:42:51,65,9856,26,39,7764.61,12701.00,0.00
2024-12-10 17:42:51,66,9856,27,39,7646.96,12701.02,0.00
2024-12-10 17:42:51,66,9857,27,39,7599.45,12702.00,0.00
2024-12-10 17:42:51,67,9857,27,40,7486.02,12702.01,0.00
2024-12-10 17:42:51,66,9857,27,39,7595.61,12702.03,0.00
2024-12-10 17:42:51,65,9857,27,38,7700.75,12702.05,0.00
2024-12-10 17:42:51,65,9858,27,38,7697.42,12703.00,0.00
2024-12-10 17:42:51,66,9858,28,38,7580.80,12703.02,0.00
2024-12-10 17:42:51,66,9859,28,38,7533.27,12704.00,0.00
2024-12-10 17:42:51,67,9859,28,39,7420.84,12704.01,0.00
2024-12-10 17:42:51,66,9859,28,38,7521.75,12704.05,0.00
2024-12-10 17:42:51,65,9859,27,38,7504.82,12704.55,0.00
2024-12-10 17:42:51,65,9860,27,38,7643.91,12705.00,0.00
2024-12-10 17:42:51,66,9860,28,38,7528.09,12705.02,0.00
2024-12-10 17:42:51,65,9860,27,38,7522.77,12705.14,0.00
2024-12-10 17:42:51,65,9861,27,38,7609.32,12706.00,0.00
2024-12-10 17:42:51,66,9861,27,39,7494.03,12706.02,0.00
2024-12-10 17:42:51,65,9861,27,38,7576.14,12706.11,0.00
2024-12-10 17:42:51,65,9862,27,38,7580.60,12707.00,0.00
2024-12-10 17:42:51,66,9862,27,39,7465.74,12707.02,0.00
2024-12-10 17:42:51,66,9863,27,39,7418.19,12708.00,0.00
2024-12-10 17:42:51,67,9863,27,40,7307.47,12708.01,0.00
2024-12-10 17:42:51,66,9863,26,40,7372.00,12708.05,0.00
2024-12-10 17:42:51,65,9863,26,39,7460.01,12708.09,0.00
2024-12-10 17:42:51,65,9864,26,39,7540.73,12709.00,0.00
2024-12-10 17:42:51,66,9864,27,39,7426.48,12709.02,0.00
2024-12-10 17:42:51,65,9864,26,39,7338.60,12709.71,0.00
2024-12-10 17:42:51,65,9865,26,39,7497.20,12710.00,0.00
2024-12-10 17:42:51,66,9865,27,39,7383.61,12710.02,0.00
2024-12-10 17:42:51,65,9865,27,38,7458.13,12710.09,0.00
2024-12-10 17:42:51,66,9864,28,38,7316.33,12710.35,0.00
2024-12-10 17:42:51,65,9864,27,38,7406.60,12710.45,0.00
2024-12-10 17:42:51,65,9865,27,38,7531.07,12711.00,0.00
2024-12-10 17:42:51,66,9865,28,38,7416.96,12711.02,0.00
2024-12-10 17:42:51,66,9866,28,38,7570.98,12712.00,0.00
2024-12-10 17:42:51,67,9866,28,39,7457.98,12712.01,0.00
2024-12-10 17:42:51,66,9866,28,38,7526.72,12712.11,0.00
2024-12-10 17:42:51,65,9866,27,38,7531.79,12712.46,0.00
2024-12-10 17:42:51,64,9866,26,38,7619.82,12712.69,0.00
2024-12-10 17:42:51,64,9867,26,38,7778.98,12713.00,0.00
2024-12-10 17:42:51,65,9867,27,38,7659.31,12713.02,0.00
2024-12-10 17:42:51,65,9868,27,38,7612.97,12714.00,0.00
2024-12-10 17:42:51,66,9868,28,38,7497.62,12714.02,0.00
2024-12-10 17:42:51,65,9868,28,37,7577.79,12714.09,0.00
2024-12-10 17:42:51,65,9869,28,37,7580.31,12715.00,0.00
2024-12-10 17:42:51,66,9869,29,37,7465.46,12715.02,0.00
2024-12-10 17:42:51,65,9869,28,37,7511.90,12715.17,0.00
2024-12-10 17:42:51,65,9870,28,37,7602.43,12716.00,0.00
2024-12-10 17:42:51,66,9870,29,37,7487.24,12716.02,0.00
2024-12-10 17:42:51,65,9870,29,36,7561.37,12716.09,0.00
2024-12-10 17:42:51,65,9871,29,36,7556.18,12717.00,0.00
2024-12-10 17:42:51,66,9871,29,37,7441.69,12717.02,0.00
2024-12-10 17:42:52,65,9871,28,37,7390.13,12717.55,0.00
2024-12-10 17:42:52,65,9872,28,37,7512.02,12718.00,0.00
2024-12-10 17:42:52,66,9872,29,37,7398.20,12718.02,0.00
2024-12-10 17:42:52,65,9872,29,36,7472.91,12718.09,0.00
2024-12-10 17:42:52,65,9873,29,36,7449.29,12719.00,0.00
2024-12-10 17:42:52,66,9873,30,36,7336.42,12719.02,0.00
2024-12-10 17:42:52,66,9874,30,36,7260.11,12720.00,0.00
2024-12-10 17:42:52,67,9874,30,37,7151.75,12720.01,0.00
2024-12-10 17:42:52,66,9874,30,36,7223.51,12720.09,0.00
2024-12-10 17:42:52,67,9873,30,37,7066.51,12720.51,0.00
2024-12-10 17:42:52,67,9874,30,37,7143.77,12721.00,0.00
2024-12-10 17:42:52,68,9874,30,38,7038.71,12721.01,0.00
2024-12-10 17:42:52,67,9874,29,38,7079.26,12721.16,0.00
2024-12-10 17:42:52,66,9874,28,38,7077.33,12721.71,0.00
2024-12-10 17:42:52,66,9875,28,38,7426.42,12722.00,0.00
2024-12-10 17:42:52,67,9875,29,38,7315.58,12722.01,0.00
2024-12-10 17:42:52,66,9875,29,37,7391.75,12722.09,0.00
2024-12-10 17:42:52,65,9875,28,37,7422.92,12722.38,0.00
2024-12-10 17:42:52,65,9876,28,37,7536.87,12723.00,0.00
2024-12-10 17:42:52,66,9876,28,38,7422.68,12723.02,0.00
2024-12-10 17:42:52,66,9877,28,38,7376.31,12724.00,0.00
2024-12-10 17:42:52,67,9877,28,39,7266.21,12724.01,0.00
2024-12-10 17:42:52,66,9877,28,38,7337.77,12724.09,0.00
2024-12-10 17:42:52,66,9878,28,38,7331.81,12725.00,0.00
2024-12-10 17:42:52,67,9878,29,38,7222.38,12725.01,0.00
2024-12-10 17:42:52,67,9879,29,38,7174.96,12726.00,0.00
2024-12-10 17:42:52,68,9879,29,39,7069.45,12726.01,0.00
2024-12-10 17:42:52,67,9879,29,38,7133.20,12726.10,0.00
2024-12-10 17:42:52,67,9880,29,38,7122.26,12727.00,0.00
2024-12-10 17:42:52,68,9880,30,38,7017.52,12727.01,0.00
2024-12-10 17:42:52,68,9881,30,38,6964.02,12728.00,0.00
2024-12-10 17:42:52,69,9881,30,39,6863.09,12728.01,0.00
2024-12-10 17:42:52,68,9881,30,38,6922.86,12728.10,0.00
2024-12-10 17:42:52,68,9881,30,38,6904.15,12729.00,0.00
2024-12-10 17:42:52,69,9881,31,38,6804.09,12729.01,0.00
2024-12-10 17:42:52,68,9881,30,38,6703.38,12729.91,0.00
2024-12-10 17:42:52,68,9882,30,38,6879.41,12730.00,0.00
2024-12-10 17:42:52,69,9882,30,39,6779.71,12730.01,0.00
2024-12-10 17:42:52,68,9882,30,38,6862.96,12730.10,0.00
2024-12-10 17:42:52,67,9882,29,38,6872.96,12730.70,0.00
2024-12-10 17:42:52,67,9883,29,38,6945.85,12731.00,0.00
2024-12-10 17:42:52,68,9883,29,39,6843.70,12731.01,0.00
2024-12-10 17:42:52,67,9883,29,38,6940.16,12731.04,0.00
2024-12-10 17:42:52,66,9883,28,38,6866.03,12731.83,0.00
2024-12-10 17:42:52,66,9884,28,38,7032.41,12732.00,0.00
2024-12-10 17:42:52,67,9884,29,38,6927.45,12732.01,0.00
2024-12-10 17:42:52,66,9884,29,37,6993.85,12732.09,0.00
2024-12-10 17:42:52,65,9884,28,37,7060.38,12732.26,0.00
2024-12-10 17:42:52,65,9885,28,37,7133.91,12733.00,0.00
2024-12-10 17:42:52,66,9885,28,38,7025.82,12733.02,0.00
2024-12-10 17:42:52,67,9884,29,38,6687.19,12733.84,0.00
2024-12-10 17:42:52,67,9885,29,38,6876.97,12734.00,0.00
2024-12-10 17:42:52,68,9885,29,39,6775.84,12734.01,0.00
2024-12-10 17:42:52,67,9885,28,39,6860.36,12734.01,0.00
2024-12-10 17:42:52,66,9885,28,38,6931.52,12734.08,0.00
2024-12-10 17:42:52,65,9885,28,37,6960.47,12734.49,0.00
2024-12-10 17:42:52,65,9886,28,37,7225.32,12735.00,0.00
2024-12-10 17:42:52,66,9886,28,38,7115.84,12735.02,0.00
2024-12-10 17:42:52,65,9886,28,37,7219.45,12735.05,0.00
2024-12-10 17:42:52,65,9887,28,37,7120.97,12736.00,0.00
2024-12-10 17:42:52,66,9887,28,38,7013.08,12736.02,0.00
2024-12-10 17:42:52,65,9887,27,38,7011.09,12736.25,0.00
2024-12-10 17:42:52,64,9887,26,38,7058.73,12736.48,0.00
2024-12-10 17:42:52,64,9888,26,38,7143.72,12737.00,0.00
2024-12-10 17:42:52,65,9888,26,39,7033.82,12737.02,0.00
2024-12-10 17:42:52,64,9888,26,38,7119.87,12737.11,0.00
2024-12-10 17:42:52,63,9888,25,38,7103.49,12737.51,0.00
2024-12-10 17:42:52,63,9889,25,38,7206.94,12738.00,0.00
2024-12-10 17:42:52,64,9889,25,39,7094.33,12738.02,0.00
2024-12-10 17:42:52,63,9889,25,38,7176.46,12738.11,0.00
2024-12-10 17:42:52,62,9889,25,37,7238.15,12738.39,0.00
2024-12-10 17:42:52,62,9890,25,37,7254.26,12739.00,0.00
2024-12-10 17:42:52,63,9890,25,38,7139.12,12739.02,0.00
2024-12-10 17:42:52,62,9890,24,38,7069.67,12739.84,0.00
2024-12-10 17:42:52,62,9891,24,38,7246.80,12740.00,0.00
2024-12-10 17:42:52,63,9891,24,39,7131.77,12740.02,0.00
2024-12-10 17:42:52,62,9891,23,39,7185.19,12740.18,0.00
2024-12-10 17:42:52,62,9892,23,39,7186.19,12741.00,0.00
2024-12-10 17:42:52,63,9892,23,40,7072.13,12741.02,0.00
2024-12-10 17:42:52,62,9892,22,40,7182.09,12741.03,0.00
2024-12-10 17:42:52,61,9892,22,39,7262.26,12741.12,0.00
2024-12-10 17:42:52,60,9892,21,39,7356.06,12741.20,0.00
2024-12-10 17:42:52,60,9893,21,39,7434.15,12742.00,0.00
2024-12-10 17:42:52,61,9893,22,39,7312.27,12742.02,0.00
2024-12-10 17:42:52,61,9894,22,39,7250.29,12743.00,0.00
2024-12-10 17:42:52,62,9894,23,39,7133.35,12743.02,0.00
2024-12-10 17:42:52,61,9894,23,38,7202.27,12743.13,0.00
2024-12-10 17:42:52,61,9895,23,38,7190.80,12744.00,0.00
2024-12-10 17:42:52,62,9895,23,39,7074.82,12744.02,0.00
2024-12-10 17:42:52,62,9896,23,39,7023.71,12745.00,0.00
2024-12-10 17:42:52,63,9896,24,39,6912.23,12745.02,0.00
2024-12-10 17:42:52,62,9896,24,38,6966.19,12745.16,0.00
2024-12-10 17:42:52,62,9897,24,38,6955.82,12746.00,0.00
2024-12-10 17:42:52,63,9897,25,38,6845.41,12746.02,0.00
2024-12-10 17:42:52,62,9897,24,38,6858.52,12746.34,0.00
2024-12-10 17:42:52,62,9898,24,38,6890.85,12747.00,0.00
2024-12-10 17:42:52,63,9898,25,38,6781.47,12747.02,0.00
2024-12-10 17:42:52,62,9898,25,37,6880.59,12747.06,0.00
2024-12-10 17:42:52,61,9898,24,37,6897.41,12747.43,0.00
2024-12-10 17:42:53,61,9899,24,37,7024.67,12748.00,0.00
2024-12-10 17:42:53,62,9899,24,38,6911.37,12748.02,0.00
2024-12-10 17:42:53,62,9900,24,38,6855.98,12749.00,0.00
2024-12-10 17:42:53,63,9900,24,39,6747.15,12749.02,0.00
2024-12-10 17:42:53,62,9900,24,38,6847.77,12749.06,0.00
2024-12-10 17:42:53,62,9901,24,38,6826.64,12750.00,0.00
2024-12-10 17:42:53,63,9901,25,38,6718.28,12750.02,0.00
2024-12-10 17:42:53,62,9901,24,38,6740.35,12750.29,0.00
2024-12-10 17:42:53,61,9901,23,38,6805.52,12750.61,0.00
2024-12-10 17:42:53,61,9902,23,38,6867.70,12751.00,0.00
2024-12-10 17:42:53,62,9902,24,38,6756.93,12751.02,0.00
2024-12-10 17:42:53,61,9902,24,37,6846.81,12751.08,0.00
2024-12-10 17:42:53,61,9903,24,37,6830.23,12752.00,0.00
2024-12-10 17:42:53,62,9903,24,38,6720.07,12752.02,0.00
2024-12-10 17:42:53,61,9903,24,37,6821.88,12752.07,0.00
2024-12-10 17:42:53,60,9903,23,37,6714.86,12752.93,0.00
2024-12-10 17:42:53,60,9904,23,37,6918.95,12753.00,0.00
2024-12-10 17:42:53,61,9904,23,38,6805.53,12753.02,0.00
2024-12-10 17:42:53,61,9905,23,38,6741.73,12754.00,0.00
2024-12-10 17:42:53,62,9905,24,38,6632.99,12754.02,0.00
2024-12-10 17:42:53,61,9905,24,37,6697.85,12754.13,0.00
2024-12-10 17:42:53,61,9906,24,37,6671.47,12755.00,0.00
2024-12-10 17:42:53,62,9906,24,38,6563.87,12755.02,0.00
2024-12-10 17:42:53,63,9905,24,39,6364.69,12755.48,0.00
2024-12-10 17:42:53,63,9906,24,39,6545.95,12756.00,0.00
2024-12-10 17:42:53,64,9906,25,39,6443.67,12756.02,0.00
2024-12-10 17:42:53,63,9906,25,38,6505.48,12756.13,0.00
2024-12-10 17:42:53,63,9907,25,38,6652.02,12757.00,0.00
2024-12-10 17:42:53,64,9907,26,38,6548.08,12757.02,0.00
2024-12-10 17:42:53,64,9907,26,38,6457.36,12758.00,0.00
2024-12-10 17:42:53,65,9907,27,38,6358.02,12758.02,0.00
2024-12-10 17:42:53,64,9907,27,37,6417.52,12758.13,0.00
2024-12-10 17:42:53,64,9908,27,37,6380.54,12759.00,0.00
2024-12-10 17:42:53,65,9908,27,38,6282.37,12759.02,0.00
2024-12-10 17:42:53,64,9908,26,38,6372.32,12759.08,0.00
2024-12-10 17:42:53,63,9908,26,37,6366.13,12759.49,0.00
2024-12-10 17:42:53,62,9908,25,37,6417.14,12759.60,0.00
2024-12-10 17:42:53,62,9909,25,37,6559.89,12760.00,0.00
2024-12-10 17:42:53,63,9909,26,37,6455.76,12760.02,0.00
2024-12-10 17:42:53,62,9909,25,37,6555.77,12760.03,0.00
2024-12-10 17:42:53,61,9909,25,36,6539.84,12760.12,0.00
2024-12-10 17:42:53,60,9909,25,35,6552.65,12760.58,0.00
2024-12-10 17:42:53,60,9910,25,35,6692.53,12761.00,0.00
2024-12-10 17:42:53,61,9910,25,36,6582.81,12761.02,0.00
2024-12-10 17:42:53,60,9910,24,36,6549.02,12761.55,0.00
2024-12-10 17:42:53,59,9910,23,36,6633.07,12761.70,0.00
2024-12-10 17:42:53,59,9911,23,36,6777.61,12762.00,0.00
2024-12-10 17:42:53,60,9911,24,36,6664.65,12762.02,0.00
2024-12-10 17:42:53,59,9911,24,35,6730.04,12762.14,0.00
2024-12-10 17:42:53,60,9910,25,35,6603.04,12762.28,0.00
2024-12-10 17:42:53,60,9911,25,35,6755.08,12763.00,0.00
2024-12-10 17:42:53,61,9911,25,36,6644.34,12763.02,0.00
2024-12-10 17:42:53,60,9911,24,36,6740.73,12763.12,0.00
2024-12-10 17:42:53,60,9912,24,36,6853.55,12764.00,0.00
2024-12-10 17:42:53,61,9912,25,36,6741.20,12764.02,0.00
2024-12-10 17:42:53,60,9912,24,36,6841.48,12764.10,0.00
2024-12-10 17:42:53,59,9912,24,35,6927.15,12764.10,0.00
2024-12-10 17:42:53,58,9912,24,34,6969.85,12764.48,0.00
2024-12-10 17:42:53,57,9912,24,33,6931.99,12764.84,0.00
2024-12-10 17:42:53,57,9913,24,33,7135.43,12765.00,0.00
2024-12-10 17:42:53,58,9913,24,34,7012.41,12765.02,0.00
2024-12-10 17:42:53,57,9913,24,33,7124.25,12765.09,0.00
2024-12-10 17:42:53,58,9912,25,33,6994.84,12765.17,0.00
2024-12-10 17:42:53,58,9913,25,33,7101.37,12766.00,0.00
2024-12-10 17:42:53,59,9913,26,33,6981.01,12766.02,0.00
2024-12-10 17:42:53,58,9913,25,33,7099.17,12766.02,0.00
2024-12-10 17:42:53,57,9913,24,33,7115.73,12766.30,0.00
2024-12-10 17:42:53,58,9912,24,34,6993.04,12766.33,0.00
2024-12-10 17:42:53,58,9913,24,34,7466.92,12767.00,0.00
2024-12-10 17:42:53,59,9913,25,34,7340.36,12767.02,0.00
2024-12-10 17:42:53,59,9914,25,34,7567.04,12768.00,0.00
2024-12-10 17:42:53,60,9914,26,34,7440.92,12768.02,0.00
2024-12-10 17:42:53,60,9915,26,34,7427.20,12769.00,0.00
2024-12-10 17:42:53,61,9915,27,34,7305.44,12769.02,0.00
2024-12-10 17:42:53,61,9916,27,34,7259.06,12770.00,0.00
2024-12-10 17:42:53,62,9916,28,34,7141.98,12770.02,0.00
2024-12-10 17:42:53,61,9916,28,33,7213.03,12770.12,0.00
2024-12-10 17:42:53,61,9917,28,33,7204.61,12771.00,0.00
2024-12-10 17:42:53,62,9917,28,34,7088.41,12771.02,0.00
2024-12-10 17:42:53,61,9917,28,33,7120.09,12771.28,0.00
2024-12-10 17:42:53,60,9917,27,33,7208.66,12771.52,0.00
2024-12-10 17:42:53,59,9917,26,33,7320.07,12771.61,0.00
2024-12-10 17:42:53,59,9918,26,33,7405.76,12772.00,0.00
2024-12-10 17:42:53,60,9918,27,33,7282.34,12772.02,0.00
2024-12-10 17:42:53,59,9918,27,32,7356.00,12772.12,0.00
2024-12-10 17:42:53,59,9919,27,32,7353.25,12773.00,0.00
2024-12-10 17:42:53,60,9919,28,32,7230.70,12773.02,0.00
2024-12-10 17:42:53,61,9918,29,32,7105.89,12773.10,0.00
2024-12-10 17:42:53,60,9918,29,31,7313.58,12773.17,0.00
2024-12-10 17:42:53,60,9919,29,31,7322.84,12774.00,0.00
2024-12-10 17:42:53,61,9919,29,32,7202.80,12774.02,0.00
2024-12-10 17:42:53,60,9919,29,31,7303.69,12774.03,0.00
2024-12-10 17:42:53,59,9919,28,31,7360.01,12774.49,0.00
2024-12-10 17:42:53,59,9920,28,31,7627.99,12775.00,0.00
2024-12-10 17:42:53,60,9920,28,32,7500.86,12775.02,0.00
2024-12-10 17:42:53,60,9921,28,32,7504.96,12776.00,0.00
2024-12-10 17:42:53,61,9921,28,33,7381.92,12776.02,0.00
2024-12-10 17:42:53,60,9921,27,33,7432.48,12776.17,0.00
2024-12-10 17:42:53,59,9921,26,33,7457.60,12776.85,0.00
2024-12-10 17:42:53,59,9922,26,33,7629.39,12777.00,0.00
2024-12-10 17:42:53,60,9922,27,33,7502.23,12777.02,0.00
2024-12-10 17:42:53,60,9922,27,33,7474.61,12778.00,0.00
2024-12-10 17:42:53,61,9922,27,34,7352.08,12778.02,0.00
2024-12-10 17:42:54,61,9923,27,34,7292.49,12779.00,0.00
2024-12-10 17:42:54,62,9923,28,34,7174.87,12779.02,0.00
2024-12-10 17:42:54,61,9923,28,33,7256.88,12779.05,0.00
2024-12-10 17:42:54,61,9924,28,33,7232.05,12780.00,0.00
2024-12-10 17:42:54,62,9924,29,33,7115.40,12780.02,0.00
2024-12-10 17:42:54,61,9924,28,33,7228.13,12780.03,0.00
2024-12-10 17:42:54,60,9924,27,33,7193.56,12780.68,0.00
2024-12-10 17:42:54,60,9925,27,33,7281.11,12781.00,0.00
2024-12-10 17:42:54,61,9925,28,33,7161.75,12781.02,0.00
2024-12-10 17:42:54,60,9925,28,32,7270.47,12781.03,0.00
2024-12-10 17:42:54,61,9924,29,32,7147.10,12781.10,0.00
2024-12-10 17:42:54,60,9924,29,31,7415.95,12781.20,0.00
2024-12-10 17:42:54,60,9925,29,31,7439.43,12782.00,0.00
2024-12-10 17:42:54,61,9925,29,32,7317.47,12782.02,0.00
2024-12-10 17:42:54,60,9925,28,32,7316.46,12782.50,0.00
2024-12-10 17:42:54,60,9926,28,32,7665.10,12783.00,0.00
2024-12-10 17:42:54,61,9926,29,32,7539.44,12783.02,0.00
2024-12-10 17:42:54,60,9926,29,31,7604.95,12783.13,0.00
2024-12-10 17:42:54,61,9925,30,31,7459.40,12783.33,0.00
2024-12-10 17:42:54,60,9925,29,31,7610.26,12783.65,0.00
2024-12-10 17:42:54,60,9925,29,31,7768.08,12784.00,0.00
2024-12-10 17:42:54,61,9925,29,32,7640.74,12784.02,0.00
2024-12-10 17:42:54,61,9926,29,32,7851.37,12785.00,0.00
2024-12-10 17:42:54,62,9926,29,33,7724.74,12785.02,0.00
2024-12-10 17:42:54,62,9927,29,33,7711.38,12786.00,0.00
2024-12-10 17:42:54,63,9927,29,34,7588.98,12786.02,0.00
2024-12-10 17:42:54,63,9928,29,34,7535.33,12787.00,0.00
2024-12-10 17:42:54,64,9928,30,34,7417.59,12787.02,0.00
2024-12-10 17:42:54,63,9928,29,34,7505.10,12787.06,0.00
2024-12-10 17:42:54,62,9928,29,33,7578.73,12787.11,0.00
2024-12-10 17:42:54,62,9929,29,33,7648.18,12788.00,0.00
2024-12-10 17:42:54,63,9929,29,34,7526.78,12788.02,0.00
2024-12-10 17:42:54,62,9929,28,34,7590.46,12788.15,0.00
2024-12-10 17:42:54,61,9929,27,34,7634.48,12788.74,0.00
2024-12-10 17:42:54,61,9930,27,34,7697.37,12789.00,0.00
2024-12-10 17:42:54,62,9930,27,35,7573.22,12789.02,0.00
2024-12-10 17:42:54,61,9930,27,34,7657.55,12789.12,0.00
2024-12-10 17:42:54,60,9930,26,34,7578.16,12789.92,0.00
2024-12-10 17:42:54,60,9931,26,34,7759.76,12790.00,0.00
2024-12-10 17:42:54,61,9931,26,35,7632.55,12790.02,0.00
2024-12-10 17:42:54,61,9932,26,35,7569.01,12791.00,0.00
2024-12-10 17:42:54,62,9932,27,35,7446.92,12791.02,0.00
2024-12-10 17:42:54,61,9932,27,34,7516.61,12791.13,0.00
2024-12-10 17:42:54,61,9933,27,34,7501.55,12792.00,0.00
2024-12-10 17:42:54,62,9933,27,35,7380.56,12792.02,0.00
2024-12-10 17:42:54,62,9934,27,35,7323.75,12793.00,0.00
2024-12-10 17:42:54,63,9934,27,36,7207.50,12793.02,0.00
2024-12-10 17:42:54,62,9934,27,35,7263.94,12793.15,0.00
2024-12-10 17:42:54,62,9935,27,35,7245.92,12794.00,0.00
2024-12-10 17:42:54,63,9935,27,36,7130.90,12794.02,0.00
2024-12-10 17:42:54,63,9936,27,36,7074.54,12795.00,0.00
2024-12-10 17:42:54,64,9936,27,37,6964.00,12795.02,0.00
2024-12-10 17:42:54,63,9936,27,36,7015.67,12795.14,0.00
2024-12-10 17:42:54,63,9937,27,36,6995.20,12796.00,0.00
2024-12-10 17:42:54,64,9937,27,37,6885.90,12796.02,0.00
2024-12-10 17:42:54,63,9937,27,36,6970.83,12796.03,0.00
2024-12-10 17:42:54,62,9937,26,36,7019.89,12796.52,0.00
2024-12-10 17:42:54,62,9938,26,36,7046.12,12797.00,0.00
2024-12-10 17:42:54,63,9938,26,37,6934.27,12797.02,0.00
2024-12-10 17:42:54,63,9939,26,37,6871.27,12798.00,0.00
2024-12-10 17:42:54,64,9939,26,38,6763.91,12798.02,0.00
2024-12-10 17:42:54,63,9939,26,37,6818.47,12798.13,0.00
2024-12-10 17:42:54,62,9939,25,37,6846.85,12798.48,0.00
2024-12-10 17:42:54,62,9940,25,37,6944.39,12799.00,0.00
2024-12-10 17:42:54,63,9940,26,37,6834.17,12799.02,0.00
2024-12-10 17:42:54,62,9940,25,37,6755.42,12799.68,0.00
2024-12-10 17:42:54,61,9940,24,37,6852.63,12799.75,0.00
2024-12-10 17:42:54,61,9941,24,37,7015.40,12800.00,0.00
2024-12-10 17:42:54,62,9941,24,38,6902.25,12800.02,0.00
2024-12-10 17:42:54,61,9941,24,37,6962.96,12800.13,0.00
2024-12-10 17:42:54,61,9942,24,37,6961.33,12801.00,0.00
2024-12-10 17:42:54,62,9942,25,37,6849.05,12801.02,0.00
2024-12-10 17:42:54,61,9942,24,37,6792.85,12801.52,0.00
2024-12-10 17:42:54,60,9942,24,36,6872.00,12801.75,0.00
2024-12-10 17:42:54,60,9943,24,36,7050.19,12802.00,0.00
2024-12-10 17:42:54,61,9943,24,37,6934.61,12802.02,0.00
2024-12-10 17:42:54,60,9943,24,36,6990.48,12802.17,0.00
2024-12-10 17:42:54,59,9943,23,36,7048.86,12802.63,0.00
2024-12-10 17:42:54,59,9944,23,36,7124.37,12803.00,0.00
2024-12-10 17:42:54,60,9944,24,36,7005.63,12803.02,0.00
2024-12-10 17:42:54,59,9944,23,36,7011.65,12803.32,0.00
2024-12-10 17:42:54,59,9945,23,36,7124.77,12804.00,0.00
2024-12-10 17:42:54,60,9945,23,37,7006.02,12804.02,0.00
2024-12-10 17:42:54,59,9945,23,36,7066.21,12804.17,0.00
2024-12-10 17:42:54,59,9946,23,36,7058.40,12805.00,0.00
2024-12-10 17:42:54,60,9946,23,37,6940.76,12805.02,0.00
2024-12-10 17:42:54,60,9947,23,37,6886.97,12806.00,0.00
2024-12-10 17:42:54,61,9947,24,37,6774.07,12806.02,0.00
2024-12-10 17:42:54,61,9948,24,37,6682.83,12807.00,0.00
2024-12-10 17:42:54,62,9948,24,38,6575.04,12807.02,0.00
2024-12-10 17:42:54,61,9948,23,38,6516.27,12807.51,0.00
2024-12-10 17:42:54,62,9947,23,39,6400.90,12807.61,0.00
2024-12-10 17:42:54,62,9948,23,39,6703.06,12808.00,0.00
2024-12-10 17:42:54,63,9948,24,39,6596.66,12808.02,0.00
2024-12-10 17:42:54,62,9948,24,38,6649.38,12808.16,0.00
2024-12-10 17:42:54,61,9948,23,38,6678.41,12808.36,0.00
2024-12-10 17:42:54,60,9948,23,37,6730.86,12808.73,0.00
2024-12-10 17:42:55,60,9949,23,37,7106.56,12809.00,0.00
2024-12-10 17:42:55,61,9949,24,37,6990.06,12809.02,0.00
2024-12-10 17:42:55,60,9949,23,37,7102.29,12809.03,0.00
2024-12-10 17:42:55,59,9949,23,36,7194.23,12809.24,0.00
2024-12-10 17:42:55,58,9949,22,36,7261.09,12809.64,0.00
2024-12-10 17:42:55,58,9950,22,36,7322.41,12810.00,0.00
2024-12-10 17:42:55,59,9950,22,37,7198.31,12810.02,0.00
2024-12-10 17:42:55,58,9950,21,37,7320.21,12810.02,0.00
2024-12-10 17:42:55,58,9951,21,37,7266.69,12811.00,0.00
2024-12-10 17:42:55,59,9951,21,38,7143.52,12811.02,0.00
2024-12-10 17:42:55,59,9952,21,38,7048.33,12812.00,0.00
2024-12-10 17:42:55,60,9952,22,38,6930.86,12812.02,0.00
2024-12-10 17:42:55,59,9952,22,37,7013.64,12812.22,0.00
2024-12-10 17:42:55,58,9952,21,37,7037.16,12812.66,0.00
2024-12-10 17:42:55,57,9952,21,36,7144.39,12812.67,0.00
2024-12-10 17:42:55,57,9953,21,36,7326.73,12813.00,0.00
2024-12-10 17:42:55,58,9953,21,37,7200.41,12813.02,0.00
2024-12-10 17:42:55,57,9953,20,37,7324.48,12813.02,0.00
2024-12-10 17:42:55,57,9954,20,37,7307.01,12814.00,0.00
2024-12-10 17:42:55,58,9954,20,38,7181.03,12814.02,0.00
2024-12-10 17:42:55,57,9954,19,38,7304.76,12814.02,0.00
2024-12-10 17:42:55,56,9954,18,38,7367.24,12814.21,0.00
2024-12-10 17:42:55,57,9953,18,39,7147.53,12814.51,0.00
2024-12-10 17:42:55,57,9954,18,39,7323.28,12815.00,0.00
2024-12-10 17:42:55,58,9954,19,39,7197.02,12815.02,0.00
2024-12-10 17:42:55,57,9954,18,39,7318.79,12815.02,0.00
2024-12-10 17:42:55,57,9955,18,39,7586.99,12816.00,0.00
2024-12-10 17:42:55,58,9955,19,39,7456.18,12816.02,0.00
2024-12-10 17:42:55,58,9956,19,39,7408.40,12817.00,0.00
2024-12-10 17:42:55,59,9956,19,40,7282.83,12817.02,0.00
2024-12-10 17:42:55,58,9956,19,39,7370.88,12817.22,0.00
2024-12-10 17:42:55,58,9957,19,39,7393.78,12818.00,0.00
2024-12-10 17:42:55,59,9957,20,39,7268.46,12818.02,0.00
2024-12-10 17:42:55,58,9957,19,39,7373.94,12818.17,0.00
2024-12-10 17:42:55,57,9957,19,38,7441.10,12818.25,0.00
2024-12-10 17:42:55,57,9958,19,38,7508.46,12819.00,0.00
2024-12-10 17:42:55,58,9958,20,38,7379.00,12819.02,0.00
2024-12-10 17:42:55,57,9958,20,37,7486.02,12819.18,0.00
2024-12-10 17:42:55,57,9959,20,37,7470.81,12820.00,0.00
2024-12-10 17:42:55,58,9959,21,37,7342.00,12820.02,0.00
2024-12-10 17:42:55,57,9959,20,37,7401.10,12820.09,0.00
2024-12-10 17:42:55,57,9960,20,37,7464.64,12821.00,0.00
2024-12-10 17:42:55,58,9960,20,38,7335.94,12821.02,0.00
2024-12-10 17:42:55,57,9960,20,37,7437.67,12821.09,0.00
2024-12-10 17:42:55,57,9961,20,37,7456.23,12822.00,0.00
2024-12-10 17:42:55,58,9961,20,38,7327.67,12822.02,0.00
2024-12-10 17:42:55,57,9961,20,37,7433.77,12822.16,0.00
2024-12-10 17:42:55,57,9962,20,37,7461.31,12823.00,0.00
2024-12-10 17:42:55,58,9962,20,38,7332.67,12823.02,0.00
2024-12-10 17:42:55,58,9963,20,38,7331.72,12824.00,0.00
2024-12-10 17:42:55,59,9963,20,39,7207.45,12824.02,0.00
2024-12-10 17:42:55,58,9963,20,38,7329.51,12824.02,0.00
2024-12-10 17:42:55,58,9964,20,38,7297.20,12825.00,0.00
2024-12-10 17:42:55,59,9964,21,38,7173.52,12825.02,0.00
2024-12-10 17:42:55,58,9964,21,37,7248.61,12825.22,0.00
2024-12-10 17:42:55,57,9964,20,37,7302.82,12825.30,0.00
2024-12-10 17:42:55,57,9965,20,37,7438.30,12826.00,0.00
2024-12-10 17:42:55,58,9965,21,37,7310.06,12826.02,0.00
2024-12-10 17:42:55,58,9966,21,37,7306.30,12827.00,0.00
2024-12-10 17:42:55,59,9966,22,37,7182.46,12827.02,0.00
2024-12-10 17:42:55,59,9967,22,37,7146.72,12828.00,0.00
2024-12-10 17:42:55,60,9967,23,37,7027.61,12828.02,0.00
2024-12-10 17:42:55,59,9967,23,36,7103.29,12828.22,0.00
2024-12-10 17:42:55,59,9968,23,36,7134.24,12829.00,0.00
2024-12-10 17:42:55,60,9968,23,37,7015.33,12829.02,0.00
2024-12-10 17:42:55,60,9969,23,37,7008.24,12830.00,0.00
2024-12-10 17:42:55,61,9969,24,37,6893.35,12830.02,0.00
2024-12-10 17:42:55,60,9969,24,36,7006.10,12830.02,0.00
2024-12-10 17:42:55,59,9969,23,36,7107.48,12830.15,0.00
2024-12-10 17:42:55,59,9970,23,36,7112.32,12831.00,0.00
2024-12-10 17:42:55,60,9970,23,37,6993.78,12831.02,0.00
2024-12-10 17:42:55,59,9970,23,36,7049.29,12831.15,0.00
2024-12-10 17:42:55,58,9970,22,36,7139.88,12831.16,0.00
2024-12-10 17:42:55,58,9971,22,36,7253.24,12832.00,0.00
2024-12-10 17:42:55,59,9971,22,37,7130.30,12832.02,0.00
2024-12-10 17:42:55,60,9970,23,37,6947.34,12832.22,0.00
2024-12-10 17:42:55,60,9971,23,37,7138.11,12833.00,0.00
2024-12-10 17:42:55,61,9971,23,38,7021.09,12833.02,0.00
2024-12-10 17:42:55,60,9971,23,37,7112.48,12833.15,0.00
2024-12-10 17:42:55,59,9971,22,37,7070.34,12833.86,0.00
2024-12-10 17:42:55,59,9972,22,37,7488.07,12834.00,0.00
2024-12-10 17:42:55,60,9972,23,37,7363.27,12834.02,0.00
2024-12-10 17:42:55,60,9973,23,37,7335.36,12835.00,0.00
2024-12-10 17:42:55,61,9973,24,37,7215.11,12835.02,0.00
2024-12-10 17:42:55,60,9973,23,37,7318.53,12835.13,0.00
2024-12-10 17:42:55,61,9972,23,38,7059.62,12835.77,0.00
2024-12-10 17:42:55,61,9973,23,38,7273.88,12836.00,0.00
2024-12-10 17:42:55,62,9973,24,38,7156.55,12836.02,0.00
2024-12-10 17:42:55,61,9973,24,37,7238.15,12836.18,0.00
2024-12-10 17:42:55,61,9974,24,37,7449.97,12837.00,0.00
2024-12-10 17:42:55,62,9974,24,38,7329.81,12837.02,0.00
2024-12-10 17:42:55,62,9975,24,38,7295.03,12838.00,0.00
2024-12-10 17:42:55,63,9975,24,39,7179.24,12838.02,0.00
2024-12-10 17:42:55,62,9975,23,39,7203.21,12838.40,0.00
2024-12-10 17:42:55,62,9976,23,39,7231.17,12839.00,0.00
2024-12-10 17:42:55,63,9976,23,40,7116.39,12839.02,0.00
2024-12-10 17:42:55,62,9976,23,39,7227.04,12839.03,0.00
2024-12-10 17:42:55,61,9976,23,38,7316.08,12839.16,0.00
2024-12-10 17:42:55,60,9976,22,38,7352.90,12839.65,0.00
2024-12-10 17:42:55,59,9976,21,38,7366.65,12839.97,0.00
2024-12-10 17:42:55,59,9977,21,38,7579.94,12840.00,0.00
2024-12-10 17:42:55,60,9977,21,39,7453.61,12840.02,0.00
2024-12-10 17:42:55,59,9977,21,38,7457.88,12840.51,0.00
2024-12-10 17:42:56,59,9978,21,38,7552.99,12841.00,0.00
2024-12-10 17:42:56,60,9978,22,38,7427.11,12841.02,0.00
2024-12-10 17:42:56,59,9978,21,38,7334.69,12841.92,0.00
2024-12-10 17:42:56,59,9979,21,38,7541.53,12842.00,0.00
2024-12-10 17:42:56,60,9979,22,38,7415.84,12842.02,0.00
2024-12-10 17:42:56,59,9979,22,37,7511.10,12842.17,0.00
2024-12-10 17:42:56,59,9980,22,37,7535.59,12843.00,0.00
2024-12-10 17:42:56,60,9980,22,38,7409.99,12843.02,0.00
2024-12-10 17:42:56,60,9981,22,38,7398.67,12844.00,0.00
2024-12-10 17:42:56,61,9981,22,39,7277.38,12844.02,0.00
2024-12-10 17:42:56,61,9982,22,39,7236.26,12845.00,0.00
2024-12-10 17:42:56,62,9982,23,39,7119.55,12845.02,0.00
2024-12-10 17:42:56,61,9982,23,38,7213.11,12845.07,0.00
2024-12-10 17:42:56,61,9983,23,38,7219.98,12846.00,0.00
2024-12-10 17:42:56,62,9983,24,38,7103.53,12846.02,0.00
2024-12-10 17:42:56,61,9983,24,37,7209.46,12846.03,0.00
2024-12-10 17:42:56,61,9984,24,37,7212.12,12847.00,0.00
2024-12-10 17:42:56,62,9984,24,38,7095.79,12847.02,0.00
2024-12-10 17:42:56,61,9984,24,37,7184.78,12847.16,0.00
2024-12-10 17:42:56,60,9984,23,37,7222.83,12847.42,0.00
2024-12-10 17:42:56,60,9985,23,37,7362.42,12848.00,0.00
2024-12-10 17:42:56,61,9985,24,37,7241.73,12848.02,0.00
2024-12-10 17:42:56,62,9984,24,38,7038.02,12848.40,0.00
2024-12-10 17:42:56,61,9984,23,38,7223.56,12848.51,0.00
2024-12-10 17:42:56,60,9984,22,38,7326.25,12848.65,0.00
2024-12-10 17:42:56,60,9985,22,38,7438.29,12849.00,0.00
2024-12-10 17:42:56,61,9985,23,38,7316.35,12849.02,0.00
2024-12-10 17:42:56,61,9986,23,38,7481.08,12850.00,0.00
2024-12-10 17:42:56,62,9986,24,38,7360.42,12850.02,0.00
2024-12-10 17:42:56,61,9986,24,37,7451.63,12850.16,0.00
2024-12-10 17:42:56,61,9987,24,37,7465.07,12851.00,0.00
2024-12-10 17:42:56,62,9987,24,38,7344.67,12851.02,0.00
2024-12-10 17:42:56,61,9987,23,38,7460.86,12851.03,0.00
2024-12-10 17:42:56,60,9987,23,37,7550.94,12851.05,0.00
2024-12-10 17:42:56,60,9988,23,37,7635.67,12852.00,0.00
2024-12-10 17:42:56,61,9988,23,38,7510.49,12852.02,0.00
2024-12-10 17:42:56,61,9989,23,38,7476.23,12853.00,0.00
2024-12-10 17:42:56,62,9989,24,38,7355.65,12853.02,0.00
2024-12-10 17:42:56,62,9990,24,38,7287.61,12854.00,0.00
2024-12-10 17:42:56,63,9990,24,39,7171.94,12854.02,0.00
2024-12-10 17:42:56,62,9990,24,38,7268.98,12854.13,0.00
2024-12-10 17:42:56,62,9991,24,38,7243.63,12855.00,0.00
2024-12-10 17:42:56,63,9991,24,39,7128.65,12855.02,0.00
2024-12-10 17:42:56,62,9991,23,39,7171.11,12855.18,0.00
2024-12-10 17:42:56,61,9991,22,39,7250.87,12855.46,0.00
2024-12-10 17:42:56,61,9992,22,39,7346.26,12856.00,0.00
2024-12-10 17:42:56,62,9992,23,39,7227.77,12856.02,0.00
2024-12-10 17:42:56,61,9992,23,38,7287.27,12856.13,0.00
2024-12-10 17:42:56,61,9993,23,38,7248.93,12857.00,0.00
2024-12-10 17:42:56,62,9993,24,38,7132.01,12857.02,0.00
2024-12-10 17:42:56,61,9993,23,38,6982.41,12857.90,0.00
2024-12-10 17:42:56,61,9994,23,38,7180.63,12858.00,0.00
2024-12-10 17:42:56,62,9994,23,39,7064.81,12858.02,0.00
2024-12-10 17:42:56,61,9994,23,38,7168.97,12858.10,0.00
2024-12-10 17:42:56,60,9994,23,37,7243.45,12858.12,0.00
2024-12-10 17:42:56,60,9995,23,37,7194.08,12859.00,0.00
2024-12-10 17:42:56,61,9995,23,38,7076.15,12859.02,0.00
2024-12-10 17:42:56,60,9995,23,37,7058.60,12859.65,0.00
2024-12-10 17:42:56,59,9995,22,37,7073.26,12859.92,0.00
2024-12-10 17:42:56,59,9996,22,37,7280.40,12860.00,0.00
2024-12-10 17:42:56,60,9996,22,38,7159.06,12860.02,0.00
2024-12-10 17:42:56,59,9996,21,38,7276.04,12860.03,0.00
2024-12-10 17:42:56,58,9996,20,38,7395.93,12860.07,0.00
2024-12-10 17:42:56,57,9996,20,37,7480.57,12860.09,0.00
2024-12-10 17:42:56,57,9997,20,37,7454.83,12861.00,0.00
2024-12-10 17:42:56,58,9997,20,38,7326.30,12861.02,0.00
2024-12-10 17:42:56,57,9997,20,37,7312.12,12861.67,0.00
2024-12-10 17:42:56,57,9998,20,37,7399.77,12862.00,0.00
2024-12-10 17:42:56,58,9998,20,38,7272.19,12862.02,0.00
2024-12-10 17:42:56,57,9998,20,37,7347.90,12862.09,0.00
2024-12-10 17:42:56,56,9998,19,37,7479.11,12862.09,0.00
2024-12-10 17:42:56,55,9998,18,37,7426.91,12862.93,0.00
2024-12-10 17:42:56,55,9999,18,37,7651.48,12863.00,0.00
2024-12-10 17:42:56,56,9999,18,38,7514.84,12863.02,0.00
2024-12-10 17:42:56,57,9998,18,39,7319.86,12863.19,0.00
2024-12-10 17:42:56,56,9998,17,39,7516.23,12863.25,0.00
2024-12-10 17:42:56,56,9999,17,39,7621.37,12864.00,0.00
2024-12-10 17:42:56,57,9999,18,39,7487.67,12864.02,0.00
2024-12-10 17:42:56,56,9999,18,38,7568.56,12864.09,0.00
2024-12-10 17:42:56,55,9999,17,38,7571.40,12864.55,0.00
2024-12-10 17:42:56,54,9999,16,38,7696.86,12864.63,0.00
2024-12-10 17:42:56,55,9998,16,39,7552.27,12864.69,0.00
2024-12-10 17:42:56,55,9999,16,39,8022.66,12865.00,0.00
2024-12-10 17:42:56,56,9999,17,39,7879.40,12865.02,0.00
2024-12-10 17:42:56,56,10000,17,39,8087.94,12866.00,0.00
2024-12-10 17:42:56,57,10000,17,40,7946.05,12866.02,0.00
2024-12-10 17:42:56,56,10000,17,39,8035.12,12866.09,0.00
2024-12-10 17:42:56,56,10001,17,39,8056.40,12867.00,0.00
2024-12-10 17:42:56,57,10001,17,40,7915.06,12867.02,0.00
2024-12-10 17:42:56,56,10001,16,40,7998.98,12867.11,0.00
2024-12-10 17:42:56,56,10002,16,40,8114.47,12868.00,0.00
2024-12-10 17:42:56,57,10002,17,40,7972.11,12868.02,0.00
2024-12-10 17:42:56,56,10002,17,39,8063.94,12868.09,0.00
2024-12-10 17:42:56,56,10003,17,39,8085.23,12869.00,0.00
2024-12-10 17:42:56,57,10003,18,39,7943.39,12869.02,0.00
2024-12-10 17:42:56,57,10004,18,39,7977.63,12870.00,0.00
2024-12-10 17:42:56,58,10004,19,39,7840.09,12870.02,0.00
2024-12-10 17:42:56,57,10004,18,39,7818.58,12870.67,0.00
2024-12-10 17:42:56,57,10005,18,39,8001.76,12871.00,0.00
2024-12-10 17:42:56,58,10005,18,40,7863.80,12871.02,0.00
2024-12-10 17:42:56,58,10006,18,40,7857.83,12872.00,0.00
2024-12-10 17:42:56,59,10006,19,40,7724.64,12872.02,0.00
2024-12-10 17:42:57,60,10005,19,41,7501.67,12872.45,0.00
2024-12-10 17:42:57,60,10006,19,41,7642.77,12873.00,0.00
2024-12-10 17:42:57,61,10006,19,42,7517.48,12873.02,0.00
2024-12-10 17:42:57,60,10006,19,41,7610.61,12873.08,0.00
2024-12-10 17:42:57,59,10006,18,41,7556.22,12873.95,0.00
2024-12-10 17:42:57,59,10007,18,41,7986.10,12874.00,0.00
2024-12-10 17:42:57,60,10007,19,41,7853.00,12874.02,0.00
2024-12-10 17:42:57,59,10007,18,41,7799.28,12874.83,0.00
2024-12-10 17:42:57,59,10008,18,41,7995.82,12875.00,0.00
2024-12-10 17:42:57,60,10008,18,42,7862.56,12875.02,0.00
2024-12-10 17:42:57,59,10008,18,41,7945.66,12875.12,0.00
2024-12-10 17:42:57,59,10009,18,41,7962.93,12876.00,0.00
2024-12-10 17:42:57,60,10009,18,42,7830.21,12876.02,0.00
2024-12-10 17:42:57,60,10010,18,42,7803.93,12877.00,0.00
2024-12-10 17:42:57,61,10010,18,43,7676.00,12877.02,0.00
2024-12-10 17:42:57,60,10010,17,43,7784.67,12877.17,0.00
2024-12-10 17:42:57,59,10010,17,42,7870.77,12877.17,0.00
2024-12-10 17:42:57,59,10011,17,42,7895.35,12878.00,0.00
2024-12-10 17:42:57,60,10011,17,43,7763.76,12878.02,0.00
2024-12-10 17:42:57,59,10011,17,42,7890.98,12878.03,0.00
2024-12-10 17:42:57,58,10011,16,42,7968.68,12878.16,0.00
2024-12-10 17:42:57,59,10010,16,43,7712.74,12878.76,0.00
2024-12-10 17:42:57,59,10011,16,43,7931.22,12879.00,0.00
2024-12-10 17:42:57,60,10011,17,43,7799.04,12879.02,0.00
2024-12-10 17:42:57,60,10012,17,43,7962.62,12880.00,0.00
2024-12-10 17:42:57,61,10012,17,44,7832.08,12880.02,0.00
2024-12-10 17:42:57,60,10012,17,43,7936.91,12880.17,0.00
2024-12-10 17:42:57,60,10013,17,43,7945.05,12881.00,0.00
2024-12-10 17:42:57,61,10013,17,44,7814.80,12881.02,0.00
2024-12-10 17:42:57,60,10013,16,44,7838.06,12881.38,0.00
2024-12-10 17:42:57,60,10014,16,44,7915.47,12882.00,0.00
2024-12-10 17:42:57,61,10014,17,44,7785.71,12882.02,0.00
2024-12-10 17:42:57,61,10015,17,44,7744.08,12883.00,0.00
2024-12-10 17:42:57,62,10015,17,45,7619.17,12883.02,0.00
2024-12-10 17:42:57,61,10015,17,44,7741.97,12883.02,0.00
2024-12-10 17:42:57,62,10014,18,44,7602.59,12883.16,0.00
2024-12-10 17:42:57,61,10014,18,43,7824.43,12883.26,0.00
2024-12-10 17:42:57,62,10013,18,44,7694.09,12883.32,0.00
2024-12-10 17:42:57,62,10014,18,44,7840.82,12884.00,0.00
2024-12-10 17:42:57,63,10014,19,44,7716.36,12884.02,0.00
2024-12-10 17:42:57,63,10015,19,44,8145.50,12885.00,0.00
2024-12-10 17:42:57,64,10015,20,44,8018.22,12885.02,0.00
2024-12-10 17:42:57,64,10016,20,44,8023.03,12886.00,0.00
2024-12-10 17:42:57,65,10016,20,45,7899.59,12886.02,0.00
2024-12-10 17:42:57,65,10017,20,45,7878.36,12887.00,0.00
2024-12-10 17:42:57,66,10017,21,45,7758.99,12887.02,0.00
2024-12-10 17:42:57,66,10018,21,45,7708.14,12888.00,0.00
2024-12-10 17:42:57,67,10018,21,46,7593.09,12888.01,0.00
2024-12-10 17:42:57,66,10018,21,45,7663.26,12888.12,0.00
2024-12-10 17:42:57,66,10019,21,45,7667.42,12889.00,0.00
2024-12-10 17:42:57,67,10019,21,46,7552.98,12889.01,0.00
2024-12-10 17:42:57,66,10019,21,45,7663.52,12889.03,0.00
2024-12-10 17:42:57,65,10019,20,45,7686.67,12889.32,0.00
2024-12-10 17:42:57,65,10020,20,45,7798.19,12890.00,0.00
2024-12-10 17:42:57,66,10020,20,46,7680.03,12890.02,0.00
2024-12-10 17:42:57,66,10021,20,46,7631.80,12891.00,0.00
2024-12-10 17:42:57,67,10021,21,46,7517.89,12891.01,0.00
2024-12-10 17:42:57,66,10021,21,45,7591.45,12891.24,0.00
2024-12-10 17:42:57,65,10021,20,45,7668.61,12891.31,0.00
2024-12-10 17:42:57,65,10022,20,45,7778.17,12892.00,0.00
2024-12-10 17:42:57,66,10022,20,46,7660.32,12892.02,0.00
2024-12-10 17:42:57,67,10021,20,47,7452.58,12892.36,0.00
2024-12-10 17:42:57,67,10022,20,47,7588.32,12893.00,0.00
2024-12-10 17:42:57,68,10022,21,47,7476.72,12893.01,0.00
2024-12-10 17:42:57,67,10022,20,47,7445.32,12893.54,0.00
2024-12-10 17:42:57,67,10023,20,47,7763.15,12894.00,0.00
2024-12-10 17:42:57,68,10023,21,47,7648.99,12894.01,0.00
2024-12-10 17:42:57,69,10022,22,47,7538.13,12894.04,0.00
2024-12-10 17:42:57,69,10023,22,47,7577.37,12895.00,0.00
2024-12-10 17:42:57,70,10023,22,48,7469.12,12895.01,0.00
2024-12-10 17:42:57,70,10024,22,48,7538.02,12896.00,0.00
2024-12-10 17:42:57,71,10024,22,49,7431.85,12896.01,0.00
2024-12-10 17:42:57,70,10024,22,48,7490.95,12896.21,0.00
2024-12-10 17:42:57,69,10024,22,47,7577.58,12896.25,0.00
2024-12-10 17:42:57,68,10024,21,47,7650.38,12896.54,0.00
2024-12-10 17:42:57,68,10025,21,47,7693.02,12897.00,0.00
2024-12-10 17:42:57,69,10025,21,48,7581.53,12897.01,0.00
2024-12-10 17:42:57,69,10026,21,48,7534.01,12898.00,0.00
2024-12-10 17:42:57,70,10026,22,48,7426.38,12898.01,0.00
2024-12-10 17:42:57,69,10026,21,48,7376.57,12898.68,0.00
2024-12-10 17:42:57,69,10027,21,48,7506.57,12899.00,0.00
2024-12-10 17:42:57,70,10027,22,48,7399.34,12899.01,0.00
2024-12-10 17:42:57,69,10027,22,47,7472.24,12899.23,0.00
2024-12-10 17:42:57,68,10027,22,46,7570.74,12899.24,0.00
2024-12-10 17:42:57,68,10028,22,46,7569.58,12900.00,0.00
2024-12-10 17:42:57,69,10028,22,47,7459.88,12900.01,0.00
2024-12-10 17:42:57,69,10029,22,47,7404.83,12901.00,0.00
2024-12-10 17:42:57,70,10029,22,48,7299.04,12901.01,0.00
2024-12-10 17:42:57,69,10029,21,48,7156.21,12901.97,0.00
2024-12-10 17:42:57,69,10030,21,48,7339.47,12902.00,0.00
2024-12-10 17:42:57,70,10030,22,48,7234.62,12902.01,0.00
2024-12-10 17:42:57,71,10029,22,49,7130.92,12902.06,0.00
2024-12-10 17:42:57,70,10029,22,48,7287.90,12902.24,0.00
2024-12-10 17:42:57,69,10029,22,47,7326.52,12902.72,0.00
2024-12-10 17:42:57,69,10030,22,47,7403.40,12903.00,0.00
2024-12-10 17:42:57,70,10030,22,48,7297.63,12903.01,0.00
2024-12-10 17:42:57,70,10031,22,48,7449.32,12904.00,0.00
2024-12-10 17:42:57,71,10031,22,49,7344.40,12904.01,0.00
2024-12-10 17:42:58,70,10031,21,49,7427.57,12904.17,0.00
2024-12-10 17:42:58,69,10031,20,49,7419.83,12904.30,0.00
2024-12-10 17:42:58,69,10032,20,49,7517.57,12905.00,0.00
2024-12-10 17:42:58,70,10032,21,49,7410.17,12905.01,0.00
2024-12-10 17:42:58,69,10032,21,48,7490.65,12905.20,0.00
2024-12-10 17:42:58,68,10032,20,48,7593.21,12905.21,0.00
2024-12-10 17:42:58,67,10032,20,47,7687.31,12905.24,0.00
2024-12-10 17:42:58,67,10033,20,47,7782.21,12906.00,0.00
2024-12-10 17:42:58,68,10033,21,47,7667.76,12906.01,0.00
2024-12-10 17:42:58,68,10034,21,47,7641.65,12907.00,0.00
2024-12-10 17:42:58,69,10034,21,48,7530.90,12907.01,0.00
2024-12-10 17:42:58,69,10035,21,48,7479.10,12908.00,0.00
2024-12-10 17:42:58,70,10035,22,48,7372.26,12908.01,0.00
2024-12-10 17:42:58,69,10035,21,48,7473.52,12908.04,0.00
2024-12-10 17:42:58,68,10035,21,47,7547.40,12908.22,0.00
2024-12-10 17:42:58,67,10035,20,47,7628.86,12908.46,0.00
2024-12-10 17:42:58,67,10036,20,47,7675.49,12909.00,0.00
2024-12-10 17:42:58,68,10036,20,48,7562.61,12909.01,0.00
2024-12-10 17:42:58,68,10037,20,48,7538.44,12910.00,0.00
2024-12-10 17:42:58,69,10037,20,49,7429.19,12910.01,0.00
2024-12-10 17:42:58,70,10036,21,49,7310.17,12910.14,0.00
2024-12-10 17:42:58,70,10037,21,49,7425.39,12911.00,0.00
2024-12-10 17:42:58,71,10037,22,49,7320.80,12911.01,0.00
2024-12-10 17:42:58,70,10037,22,48,7383.05,12911.23,0.00
2024-12-10 17:42:58,69,10037,21,48,7398.69,12911.91,0.00
2024-12-10 17:42:58,69,10038,21,48,7761.77,12912.00,0.00
2024-12-10 17:42:58,70,10038,22,48,7650.88,12912.01,0.00
2024-12-10 17:42:58,70,10039,22,48,7620.77,12913.00,0.00
2024-12-10 17:42:58,71,10039,23,48,7513.44,12913.01,0.00
2024-12-10 17:42:58,70,10039,23,47,7615.26,12913.04,0.00
2024-12-10 17:42:58,70,10040,23,47,7566.02,12914.00,0.00
2024-12-10 17:42:58,71,10040,23,48,7459.45,12914.01,0.00
2024-12-10 17:42:58,70,10040,23,47,7560.51,12914.04,0.00
2024-12-10 17:42:58,69,10040,23,46,7668.21,12914.04,0.00
2024-12-10 17:42:58,68,10040,23,45,7750.65,12914.19,0.00
2024-12-10 17:42:58,68,10041,23,45,7760.66,12915.00,0.00
2024-12-10 17:42:58,69,10041,23,46,7648.19,12915.01,0.00
2024-12-10 17:42:58,68,10041,22,46,7634.97,12915.69,0.00
2024-12-10 17:42:58,68,10042,22,46,7728.99,12916.00,0.00
2024-12-10 17:42:58,69,10042,23,46,7616.97,12916.01,0.00
2024-12-10 17:42:58,68,10042,22,46,7514.20,12916.97,0.00
2024-12-10 17:42:58,68,10043,22,46,7700.37,12917.00,0.00
2024-12-10 17:42:58,69,10043,23,46,7588.77,12917.01,0.00
2024-12-10 17:42:58,68,10043,23,45,7670.06,12917.19,0.00
2024-12-10 17:42:58,68,10044,23,45,7680.07,12918.00,0.00
2024-12-10 17:42:58,69,10044,23,46,7568.77,12918.01,0.00
2024-12-10 17:42:58,69,10045,23,46,7534.24,12919.00,0.00
2024-12-10 17:42:58,70,10045,23,47,7426.61,12919.01,0.00
2024-12-10 17:42:58,69,10045,22,47,7322.76,12919.97,0.00
2024-12-10 17:42:58,69,10046,22,47,7506.28,12920.00,0.00
2024-12-10 17:42:58,70,10046,23,47,7399.04,12920.01,0.00
2024-12-10 17:42:58,69,10046,23,46,7480.13,12920.19,0.00
2024-12-10 17:42:58,69,10047,23,46,7488.13,12921.00,0.00
2024-12-10 17:42:58,70,10047,24,46,7381.16,12921.01,0.00
2024-12-10 17:42:58,70,10048,24,46,7330.20,12922.00,0.00
2024-12-10 17:42:58,71,10048,25,46,7226.96,12922.01,0.00
2024-12-10 17:42:58,70,10048,25,45,7293.34,12922.16,0.00
2024-12-10 17:42:58,70,10049,25,45,7295.69,12923.00,0.00
2024-12-10 17:42:58,71,10049,25,46,7192.94,12923.01,0.00
2024-12-10 17:42:58,70,10049,25,45,7290.18,12923.04,0.00
2024-12-10 17:42:58,70,10050,25,45,7248.61,12924.00,0.00
2024-12-10 17:42:58,71,10050,26,45,7146.52,12924.01,0.00
2024-12-10 17:42:58,70,10050,26,44,7243.09,12924.04,0.00
2024-12-10 17:42:58,69,10050,26,43,7314.38,12924.13,0.00
2024-12-10 17:42:58,68,10050,25,43,7347.95,12924.71,0.00
2024-12-10 17:42:58,68,10051,25,43,7424.20,12925.00,0.00
2024-12-10 17:42:58,69,10051,26,43,7316.60,12925.01,0.00
2024-12-10 17:42:58,68,10051,25,43,7272.16,12925.78,0.00
2024-12-10 17:42:58,68,10052,25,43,7433.91,12926.00,0.00
2024-12-10 17:42:58,69,10052,26,43,7326.17,12926.01,0.00
2024-12-10 17:42:58,68,10052,26,42,7386.44,12926.13,0.00
2024-12-10 17:42:58,67,10052,25,42,7456.17,12926.45,0.00
2024-12-10 17:42:58,66,10052,24,42,7530.16,12926.74,0.00
2024-12-10 17:42:58,66,10053,24,42,7614.58,12927.00,0.00
2024-12-10 17:42:58,67,10053,25,42,7500.93,12927.01,0.00
2024-12-10 17:42:58,67,10054,25,42,7458.64,12928.00,0.00
2024-12-10 17:42:58,68,10054,26,42,7348.95,12928.01,0.00
2024-12-10 17:42:58,67,10054,25,42,7450.95,12928.06,0.00
2024-12-10 17:42:58,68,10053,25,43,7337.58,12928.12,0.00
2024-12-10 17:42:58,67,10053,25,42,7520.44,12928.13,0.00
2024-12-10 17:42:58,67,10054,25,42,7524.83,12929.00,0.00
2024-12-10 17:42:58,68,10054,26,42,7414.17,12929.01,0.00
2024-12-10 17:42:58,67,10054,26,41,7517.14,12929.06,0.00
2024-12-10 17:42:58,67,10055,26,41,7691.86,12930.00,0.00
2024-12-10 17:42:58,68,10055,26,42,7578.75,12930.01,0.00
2024-12-10 17:42:58,68,10056,26,42,7522.68,12931.00,0.00
2024-12-10 17:42:58,69,10056,27,42,7413.66,12931.01,0.00
2024-12-10 17:42:58,68,10056,27,41,7496.12,12931.10,0.00
2024-12-10 17:42:58,68,10057,27,41,7487.28,12932.00,0.00
2024-12-10 17:42:58,69,10057,27,42,7378.77,12932.01,0.00
2024-12-10 17:42:58,68,10057,27,41,7479.70,12932.06,0.00
2024-12-10 17:42:58,67,10057,26,41,7541.61,12932.13,0.00
2024-12-10 17:42:58,67,10058,26,41,7540.81,12933.00,0.00
2024-12-10 17:42:58,68,10058,27,41,7429.92,12933.01,0.00
2024-12-10 17:42:58,69,10057,27,42,7316.64,12933.09,0.00
2024-12-10 17:42:58,68,10057,27,41,7407.15,12933.10,0.00
2024-12-10 17:42:58,67,10057,26,41,7511.92,12933.15,0.00
2024-12-10 17:42:58,66,10057,25,41,7599.12,12933.33,0.00
2024-12-10 17:42:58,67,10056,26,41,7464.55,12933.52,0.00
2024-12-10 17:42:58,67,10057,26,41,7655.18,12934.00,0.00
2024-12-10 17:42:58,68,10057,27,41,7542.60,12934.01,0.00
2024-12-10 17:42:59,68,10058,27,41,7863.20,12935.00,0.00
2024-12-10 17:42:59,69,10058,27,42,7749.24,12935.01,0.00
2024-12-10 17:42:59,68,10058,27,41,7830.92,12935.09,0.00
2024-12-10 17:42:59,68,10059,27,41,7816.40,12936.00,0.00
2024-12-10 17:42:59,69,10059,27,42,7703.12,12936.01,0.00
2024-12-10 17:42:59,70,10058,27,43,7593.08,12936.04,0.00
2024-12-10 17:42:59,70,10059,27,43,7610.73,12937.00,0.00
2024-12-10 17:42:59,71,10059,27,44,7503.53,12937.01,0.00
2024-12-10 17:42:59,70,10059,27,43,7571.97,12937.10,0.00
2024-12-10 17:42:59,69,10059,26,43,7548.90,12937.83,0.00
2024-12-10 17:42:59,69,10060,26,43,7901.53,12938.00,0.00
2024-12-10 17:42:59,70,10060,27,43,7788.65,12938.01,0.00
2024-12-10 17:42:59,70,10061,27,43,7725.18,12939.00,0.00
2024-12-10 17:42:59,71,10061,28,43,7616.38,12939.01,0.00
2024-12-10 17:42:59,72,10060,29,43,7508.81,12939.06,0.00
2024-12-10 17:42:59,71,10060,29,42,7649.99,12939.11,0.00
2024-12-10 17:42:59,72,10059,30,42,7504.33,12939.44,0.00
2024-12-10 17:42:59,72,10060,30,42,7539.28,12940.00,0.00
2024-12-10 17:42:59,73,10060,30,43,7436.00,12940.01,0.00
2024-12-10 17:42:59,73,10061,30,43,7779.72,12941.00,0.00
2024-12-10 17:42:59,74,10061,31,43,7674.59,12941.01,0.00
2024-12-10 17:42:59,74,10062,31,43,7656.27,12942.00,0.00
2024-12-10 17:42:59,75,10062,31,44,7554.19,12942.01,0.00
2024-12-10 17:42:59,75,10063,31,44,7520.57,12943.00,0.00
2024-12-10 17:42:59,76,10063,32,44,7421.61,12943.01,0.00
2024-12-10 17:42:59,75,10063,31,44,7461.97,12943.20,0.00
2024-12-10 17:42:59,75,10064,31,44,7462.99,12944.00,0.00
2024-12-10 17:42:59,76,10064,32,44,7364.80,12944.01,0.00
2024-12-10 17:42:59,75,10064,32,43,7433.67,12944.03,0.00
2024-12-10 17:42:59,74,10064,31,43,7468.38,12944.53,0.00
2024-12-10 17:42:59,74,10065,31,43,7504.03,12945.00,0.00
2024-12-10 17:42:59,75,10065,31,44,7403.97,12945.01,0.00
2024-12-10 17:42:59,74,10065,30,44,7387.43,12945.63,0.00
2024-12-10 17:42:59,74,10066,30,44,7468.17,12946.00,0.00
2024-12-10 17:42:59,75,10066,30,45,7368.60,12946.01,0.00
2024-12-10 17:42:59,75,10067,30,45,7310.47,12947.00,0.00
2024-12-10 17:42:59,76,10067,31,45,7214.28,12947.01,0.00
2024-12-10 17:42:59,75,10067,31,44,7294.96,12947.05,0.00
2024-12-10 17:42:59,74,10067,30,44,7266.78,12947.93,0.00
2024-12-10 17:42:59,74,10068,30,44,7433.05,12948.00,0.00
2024-12-10 17:42:59,75,10068,31,44,7333.95,12948.01,0.00
2024-12-10 17:42:59,76,10067,32,44,7179.59,12948.22,0.00
2024-12-10 17:42:59,75,10067,31,44,7380.64,12948.23,0.00
2024-12-10 17:42:59,75,10068,31,44,7384.58,12949.00,0.00
2024-12-10 17:42:59,76,10068,32,44,7287.42,12949.01,0.00
2024-12-10 17:42:59,75,10068,32,43,7369.07,12949.07,0.00
2024-12-10 17:42:59,74,10068,31,43,7388.47,12949.68,0.00
2024-12-10 17:42:59,74,10069,31,43,7626.71,12950.00,0.00
2024-12-10 17:42:59,75,10069,31,44,7525.02,12950.01,0.00
2024-12-10 17:42:59,74,10069,30,44,7487.09,12950.76,0.00
2024-12-10 17:42:59,74,10070,30,44,7630.79,12951.00,0.00
2024-12-10 17:42:59,75,10070,30,45,7529.05,12951.01,0.00
2024-12-10 17:42:59,74,10070,30,44,7615.07,12951.07,0.00
2024-12-10 17:42:59,73,10070,29,44,7579.51,12951.64,0.00
2024-12-10 17:42:59,73,10071,29,44,7711.08,12952.00,0.00
2024-12-10 17:42:59,74,10071,30,44,7606.88,12952.01,0.00
2024-12-10 17:42:59,74,10072,30,44,7549.70,12953.00,0.00
2024-12-10 17:42:59,75,10072,31,44,7449.04,12953.01,0.00
2024-12-10 17:42:59,74,10072,31,43,7535.72,12953.07,0.00
2024-12-10 17:42:59,74,10073,31,43,7520.53,12954.00,0.00
2024-12-10 17:42:59,75,10073,32,43,7420.25,12954.01,0.00
2024-12-10 17:42:59,75,10074,32,43,7362.09,12955.00,0.00
2024-12-10 17:42:59,76,10074,32,44,7265.22,12955.01,0.00
2024-12-10 17:42:59,75,10074,32,43,7350.03,12955.07,0.00
2024-12-10 17:42:59,76,10073,33,43,7200.64,12955.50,0.00
2024-12-10 17:42:59,76,10074,33,43,7369.77,12956.00,0.00
2024-12-10 17:42:59,77,10074,33,44,7274.06,12956.01,0.00
2024-12-10 17:42:59,77,10075,33,44,7382.32,12957.00,0.00
2024-12-10 17:42:59,78,10075,33,45,7287.67,12957.01,0.00
2024-12-10 17:42:59,77,10075,33,44,7372.25,12957.06,0.00
2024-12-10 17:42:59,78,10074,34,44,7191.70,12957.76,0.00
2024-12-10 17:42:59,77,10074,33,44,7371.84,12957.87,0.00
2024-12-10 17:42:59,77,10075,33,44,7523.39,12958.00,0.00
2024-12-10 17:42:59,78,10075,34,44,7426.94,12958.01,0.00
2024-12-10 17:42:59,77,10075,34,43,7481.34,12958.06,0.00
2024-12-10 17:42:59,77,10076,34,43,7630.00,12959.00,0.00
2024-12-10 17:42:59,78,10076,34,44,7532.18,12959.01,0.00
2024-12-10 17:42:59,78,10077,34,44,7471.28,12960.00,0.00
2024-12-10 17:42:59,79,10077,34,45,7376.71,12960.01,0.00
2024-12-10 17:42:59,78,10077,34,44,7463.00,12960.06,0.00
2024-12-10 17:42:59,77,10077,33,44,7534.74,12960.26,0.00
2024-12-10 17:42:59,76,10077,32,44,7542.17,12960.84,0.00
2024-12-10 17:42:59,76,10078,32,44,7692.36,12961.00,0.00
2024-12-10 17:42:59,77,10078,32,45,7592.46,12961.01,0.00
2024-12-10 17:43:00,77,10079,32,45,7532.45,12962.00,0.00
2024-12-10 17:43:00,78,10079,33,45,7435.88,12962.01,0.00
2024-12-10 17:43:00,77,10079,33,44,7520.69,12962.08,0.00
2024-12-10 17:43:00,77,10080,33,44,7502.73,12963.00,0.00
2024-12-10 17:43:00,78,10080,34,44,7406.54,12963.01,0.00
2024-12-10 17:43:00,78,10081,34,44,7395.86,12964.00,0.00
2024-12-10 17:43:00,79,10081,35,44,7302.25,12964.01,0.00
2024-12-10 17:43:00,79,10082,35,44,7281.16,12965.00,0.00
2024-12-10 17:43:00,80,10082,36,44,7190.15,12965.01,0.00
2024-12-10 17:43:00,81,10081,36,45,7098.19,12965.06,0.00
2024-12-10 17:43:00,81,10082,36,45,7172.66,12966.00,0.00
2024-12-10 17:43:00,82,10082,36,46,7085.19,12966.01,0.00
2024-12-10 17:43:00,82,10083,36,46,7179.03,12967.00,0.00
2024-12-10 17:43:00,83,10083,37,46,7092.54,12967.01,0.00
2024-12-10 17:43:00,82,10083,37,45,7172.73,12967.05,0.00
2024-12-10 17:43:00,81,10083,37,44,7254.88,12967.07,0.00
2024-12-10 17:43:00,81,10084,37,44,7231.40,12968.00,0.00
2024-12-10 17:43:00,82,10084,38,44,7143.21,12968.01,0.00
2024-12-10 17:43:00,81,10084,38,43,7189.80,12968.07,0.00
2024-12-10 17:43:00,80,10084,37,43,7270.63,12968.14,0.00
2024-12-10 17:43:00,79,10084,36,43,7284.19,12968.73,0.00
2024-12-10 17:43:00,79,10085,36,43,7348.42,12969.00,0.00
2024-12-10 17:43:00,80,10085,37,43,7256.56,12969.01,0.00
2024-12-10 17:43:00,79,10085,37,42,7322.18,12969.05,0.00
2024-12-10 17:43:00,79,10086,37,42,7298.09,12970.00,0.00
2024-12-10 17:43:00,80,10086,38,42,7206.86,12970.01,0.00
2024-12-10 17:43:00,79,10086,38,41,7258.71,12970.06,0.00
2024-12-10 17:43:00,79,10087,38,41,7236.26,12971.00,0.00
2024-12-10 17:43:00,80,10087,39,41,7145.81,12971.01,0.00
2024-12-10 17:43:00,79,10087,39,40,7197.47,12971.06,0.00
2024-12-10 17:43:00,78,10087,38,40,7254.82,12971.06,0.00
2024-12-10 17:43:00,78,10088,38,40,7300.26,12972.00,0.00
2024-12-10 17:43:00,79,10088,39,40,7207.85,12972.01,0.00
2024-12-10 17:43:00,78,10088,39,39,7258.71,12972.06,0.00
2024-12-10 17:43:00,77,10088,38,39,7196.60,12972.71,0.00
2024-12-10 17:43:00,77,10089,38,39,7328.22,12973.00,0.00
2024-12-10 17:43:00,78,10089,38,40,7234.27,12973.01,0.00
2024-12-10 17:43:00,77,10089,38,39,7287.81,12973.06,0.00
2024-12-10 17:43:00,77,10090,38,39,7259.81,12974.00,0.00
2024-12-10 17:43:00,78,10090,39,39,7166.73,12974.01,0.00
2024-12-10 17:43:00,78,10091,39,39,7095.15,12975.00,0.00
2024-12-10 17:43:00,79,10091,40,39,7005.34,12975.01,0.00
2024-12-10 17:43:00,78,10091,39,39,7089.07,12975.05,0.00
2024-12-10 17:43:00,77,10091,39,38,7177.76,12975.06,0.00
2024-12-10 17:43:00,76,10091,38,38,7180.05,12975.45,0.00
2024-12-10 17:43:00,76,10092,38,38,7277.83,12976.00,0.00
2024-12-10 17:43:00,77,10092,39,38,7183.32,12976.01,0.00
2024-12-10 17:43:00,77,10093,39,38,7149.94,12977.00,0.00
2024-12-10 17:43:00,78,10093,40,38,7058.27,12977.01,0.00
2024-12-10 17:43:00,78,10094,40,38,6997.61,12978.00,0.00
2024-12-10 17:43:00,79,10094,41,38,6909.03,12978.01,0.00
2024-12-10 17:43:00,79,10095,41,38,6827.33,12979.00,0.00
2024-12-10 17:43:00,80,10095,42,38,6741.99,12979.01,0.00
2024-12-10 17:43:00,79,10095,42,37,6819.14,12979.06,0.00
2024-12-10 17:43:00,78,10095,42,36,6880.66,12979.26,0.00
2024-12-10 17:43:00,78,10096,42,36,6880.04,12980.00,0.00
2024-12-10 17:43:00,79,10096,43,36,6792.95,12980.01,0.00
2024-12-10 17:43:00,78,10096,43,35,6843.45,12980.06,0.00
2024-12-10 17:43:00,78,10097,43,35,6820.73,12981.00,0.00
2024-12-10 17:43:00,79,10097,43,36,6734.40,12981.01,0.00
2024-12-10 17:43:00,78,10097,43,35,6780.82,12981.06,0.00
2024-12-10 17:43:00,77,10097,42,35,6843.65,12981.25,0.00
2024-12-10 17:43:00,77,10098,42,35,6847.47,12982.00,0.00
2024-12-10 17:43:00,78,10098,43,35,6759.68,12982.01,0.00
2024-12-10 17:43:00,77,10098,43,34,6803.66,12982.08,0.00
2024-12-10 17:43:00,77,10099,43,34,6785.61,12983.00,0.00
2024-12-10 17:43:00,78,10099,43,35,6698.61,12983.01,0.00
2024-12-10 17:43:00,77,10099,43,34,6741.79,12983.08,0.00
2024-12-10 17:43:00,78,10098,43,35,6514.13,12983.68,0.00
2024-12-10 17:43:00,78,10099,43,35,6704.16,12984.00,0.00
2024-12-10 17:43:00,79,10099,44,35,6619.30,12984.01,0.00
2024-12-10 17:43:00,78,10099,44,34,6660.90,12984.08,0.00
2024-12-10 17:43:00,77,10099,43,34,6691.78,12984.13,0.00
2024-12-10 17:43:00,76,10099,42,34,6746.24,12984.38,0.00
2024-12-10 17:43:00,75,10099,41,34,6791.37,12984.72,0.00
2024-12-10 17:43:00,75,10100,41,34,7101.47,12985.00,0.00
2024-12-10 17:43:00,76,10100,42,34,7008.03,12985.01,0.00
2024-12-10 17:43:00,76,10101,42,34,6948.77,12986.00,0.00
2024-12-10 17:43:00,77,10101,43,34,6858.52,12986.01,0.00
2024-12-10 17:43:00,76,10101,43,33,6936.83,12986.08,0.00
2024-12-10 17:43:00,75,10101,42,33,7012.05,12986.21,0.00
2024-12-10 17:43:00,74,10101,41,33,7105.05,12986.22,0.00
2024-12-10 17:43:00,74,10101,41,33,7109.04,12987.00,0.00
2024-12-10 17:43:00,75,10101,41,34,7014.25,12987.01,0.00
2024-12-10 17:43:00,75,10102,41,34,6955.91,12988.00,0.00
2024-12-10 17:43:00,76,10102,42,34,6864.39,12988.01,0.00
2024-12-10 17:43:00,75,10102,42,33,6943.81,12988.08,0.00
2024-12-10 17:43:00,75,10103,42,33,6928.74,12989.00,0.00
2024-12-10 17:43:00,76,10103,43,33,6837.57,12989.01,0.00
2024-12-10 17:43:00,76,10104,43,33,6778.28,12990.00,0.00
2024-12-10 17:43:00,77,10104,43,34,6690.25,12990.01,0.00
2024-12-10 17:43:00,76,10104,43,33,6768.04,12990.08,0.00
2024-12-10 17:43:00,77,10103,44,33,6604.50,12990.69,0.00
2024-12-10 17:43:00,76,10103,43,33,6667.67,12990.96,0.00
2024-12-10 17:43:00,76,10104,43,33,6833.50,12991.00,0.00
2024-12-10 17:43:00,77,10104,43,34,6744.75,12991.01,0.00
2024-12-10 17:43:00,76,10104,42,34,6772.02,12991.21,0.00
2024-12-10 17:43:00,75,10104,41,34,6746.67,12991.92,0.00
2024-12-10 17:43:01,75,10105,41,34,7082.78,12992.00,0.00
2024-12-10 17:43:01,76,10105,41,35,6989.58,12992.01,0.00
2024-12-10 17:43:01,75,10105,41,34,7067.21,12992.09,0.00
2024-12-10 17:43:01,75,10106,41,34,7053.87,12993.00,0.00
2024-12-10 17:43:01,76,10106,42,34,6961.06,12993.01,0.00
2024-12-10 17:43:01,76,10107,42,34,6901.76,12994.00,0.00
2024-12-10 17:43:01,77,10107,43,34,6812.12,12994.01,0.00
2024-12-10 17:43:01,76,10107,42,34,6894.93,12994.05,0.00
2024-12-10 17:43:01,75,10107,42,33,6979.94,12994.08,0.00
2024-12-10 17:43:01,75,10108,42,33,6964.86,12995.00,0.00
2024-12-10 17:43:01,76,10108,42,34,6873.22,12995.01,0.00
2024-12-10 17:43:01,75,10108,41,34,6873.05,12995.11,0.00
2024-12-10 17:43:01,75,10109,41,34,6930.74,12996.00,0.00
2024-12-10 17:43:01,76,10109,41,35,6839.55,12996.01,0.00
2024-12-10 17:43:01,75,10109,40,35,6887.44,12996.08,0.00
2024-12-10 17:43:01,74,10109,40,34,6975.24,12996.08,0.00
2024-12-10 17:43:01,74,10110,40,34,7031.57,12997.00,0.00
2024-12-10 17:43:01,75,10110,41,34,6937.82,12997.01,0.00
2024-12-10 17:43:01,75,10111,41,34,6877.08,12998.00,0.00
2024-12-10 17:43:01,76,10111,41,35,6786.59,12998.01,0.00
2024-12-10 17:43:01,75,10111,41,34,6858.04,12998.08,0.00
2024-12-10 17:43:01,74,10111,40,34,6818.11,12998.88,0.00
2024-12-10 17:43:01,74,10112,40,34,6978.06,12999.00,0.00
2024-12-10 17:43:01,75,10112,41,34,6885.02,12999.01,0.00
2024-12-10 17:43:01,74,10112,40,34,6847.19,12999.24,0.00
2024-12-10 17:43:01,74,10113,40,34,6907.90,13000.00,0.00
2024-12-10 17:43:01,75,10113,40,35,6815.80,13000.01,0.00
2024-12-10 17:43:01,74,10113,39,35,6852.64,13000.04,0.00
2024-12-10 17:43:01,73,10113,39,34,6925.15,13000.08,0.00
2024-12-10 17:43:01,74,10112,40,34,6814.05,13000.24,0.00
2024-12-10 17:43:01,74,10113,40,34,6968.97,13001.00,0.00
2024-12-10 17:43:01,75,10113,41,34,6876.05,13001.01,0.00
2024-12-10 17:43:01,74,10113,41,33,6963.71,13001.04,0.00
2024-12-10 17:43:01,73,10113,40,33,6866.16,13001.68,0.00
2024-12-10 17:43:01,74,10112,40,34,6766.38,13001.76,0.00
2024-12-10 17:43:01,74,10113,40,34,7117.99,13002.00,0.00
2024-12-10 17:43:01,75,10113,41,34,7023.08,13002.01,0.00
2024-12-10 17:43:01,74,10113,41,33,7095.15,13002.07,0.00
2024-12-10 17:43:01,74,10114,41,33,7255.59,13003.00,0.00
2024-12-10 17:43:01,75,10114,41,34,7158.85,13003.01,0.00
2024-12-10 17:43:01,75,10115,41,34,7105.37,13004.00,0.00
2024-12-10 17:43:01,76,10115,42,34,7011.88,13004.01,0.00
2024-12-10 17:43:01,75,10115,42,33,7082.84,13004.07,0.00
2024-12-10 17:43:01,74,10115,41,33,7161.04,13004.20,0.00
2024-12-10 17:43:01,73,10115,40,33,7158.03,13004.56,0.00
2024-12-10 17:43:01,73,10116,40,33,7279.51,13005.00,0.00
2024-12-10 17:43:01,74,10116,40,34,7181.14,13005.01,0.00
2024-12-10 17:43:01,73,10116,39,34,7173.15,13005.15,0.00
2024-12-10 17:43:01,74,10115,40,34,7021.93,13005.59,0.00
2024-12-10 17:43:01,74,10116,40,34,7198.01,13006.00,0.00
2024-12-10 17:43:01,75,10116,40,35,7102.03,13006.01,0.00
2024-12-10 17:43:01,75,10117,40,35,7223.98,13007.00,0.00
2024-12-10 17:43:01,76,10117,40,36,7128.93,13007.01,0.00
2024-12-10 17:43:01,75,10117,40,35,7197.98,13007.09,0.00
2024-12-10 17:43:01,74,10117,39,35,7277.72,13007.22,0.00
2024-12-10 17:43:01,75,10116,40,35,7170.31,13007.32,0.00
2024-12-10 17:43:01,74,10116,39,35,7276.09,13007.53,0.00
2024-12-10 17:43:01,74,10117,39,35,7390.72,13008.00,0.00
2024-12-10 17:43:01,75,10117,39,36,7292.18,13008.01,0.00
2024-12-10 17:43:01,75,10118,39,36,7412.10,13009.00,0.00
2024-12-10 17:43:01,76,10118,39,37,7314.58,13009.01,0.00
2024-12-10 17:43:01,75,10118,39,36,7387.83,13009.09,0.00
2024-12-10 17:43:01,75,10119,39,36,7374.51,13010.00,0.00
2024-12-10 17:43:01,76,10119,39,37,7277.48,13010.01,0.00
2024-12-10 17:43:01,75,10119,38,37,7327.67,13010.01,0.00
2024-12-10 17:43:01,74,10119,37,37,7424.94,13010.01,0.00
2024-12-10 17:43:01,73,10119,36,37,7524.87,13010.01,0.00
2024-12-10 17:43:01,73,10120,36,37,7539.70,13011.00,0.00
2024-12-10 17:43:01,74,10120,37,37,7437.82,13011.01,0.00
2024-12-10 17:43:01,73,10120,37,36,7523.67,13011.05,0.00
2024-12-10 17:43:01,74,10119,38,36,7385.19,13011.37,0.00
2024-12-10 17:43:01,73,10119,37,36,7608.61,13011.42,0.00
2024-12-10 17:43:01,73,10120,37,36,7712.41,13012.00,0.00
2024-12-10 17:43:01,74,10120,37,37,7608.19,13012.01,0.00
2024-12-10 17:43:01,75,10119,38,37,7411.52,13012.51,0.00
2024-12-10 17:43:01,74,10119,37,37,7573.79,13012.84,0.00
2024-12-10 17:43:01,74,10120,37,37,7904.52,13013.00,0.00
2024-12-10 17:43:01,75,10120,37,38,7799.13,13013.01,0.00
2024-12-10 17:43:01,74,10120,37,37,7899.25,13013.04,0.00
2024-12-10 17:43:01,73,10120,37,36,7998.55,13013.04,0.00
2024-12-10 17:43:01,72,10120,36,36,8074.98,13013.31,0.00
2024-12-10 17:43:01,72,10121,36,36,8274.32,13014.00,0.00
2024-12-10 17:43:01,73,10121,36,37,8160.97,13014.01,0.00
2024-12-10 17:43:01,73,10122,36,37,8156.42,13015.00,0.00
2024-12-10 17:43:01,74,10122,37,37,8046.20,13015.01,0.00
2024-12-10 17:43:01,73,10122,36,37,8070.01,13015.16,0.00
2024-12-10 17:43:01,73,10123,36,37,8140.12,13016.00,0.00
2024-12-10 17:43:01,74,10123,36,38,8030.12,13016.01,0.00
2024-12-10 17:43:01,74,10124,36,38,7987.55,13017.00,0.00
2024-12-10 17:43:01,75,10124,36,39,7881.05,13017.01,0.00
2024-12-10 17:43:01,74,10124,35,39,7924.28,13017.22,0.00
2024-12-10 17:43:01,74,10125,35,39,7928.35,13018.00,0.00
2024-12-10 17:43:01,75,10125,35,40,7822.64,13018.01,0.00
2024-12-10 17:43:01,74,10125,35,39,7917.80,13018.05,0.00
2024-12-10 17:43:01,73,10125,34,39,7860.21,13018.97,0.00
2024-12-10 17:43:01,73,10126,34,39,8034.99,13019.00,0.00
2024-12-10 17:43:01,74,10126,35,39,7926.41,13019.01,0.00
2024-12-10 17:43:01,74,10127,35,39,7868.96,13020.00,0.00
2024-12-10 17:43:01,75,10127,35,40,7764.04,13020.01,0.00
2024-12-10 17:43:01,74,10127,35,39,7858.41,13020.05,0.00
2024-12-10 17:43:01,74,10128,35,39,7841.41,13021.00,0.00
2024-12-10 17:43:01,75,10128,35,40,7736.86,13021.01,0.00
2024-12-10 17:43:02,75,10129,35,40,7678.42,13022.00,0.00
2024-12-10 17:43:02,76,10129,36,40,7577.39,13022.01,0.00
2024-12-10 17:43:02,75,10129,36,39,7664.53,13022.07,0.00
2024-12-10 17:43:02,74,10129,35,39,7614.93,13022.97,0.00
2024-12-10 17:43:02,74,10130,35,39,7787.41,13023.00,0.00
2024-12-10 17:43:02,75,10130,36,39,7683.58,13023.01,0.00
2024-12-10 17:43:02,74,10130,35,39,7743.42,13023.05,0.00
2024-12-10 17:43:02,74,10131,35,39,7754.87,13024.00,0.00
2024-12-10 17:43:02,75,10131,36,39,7651.47,13024.01,0.00
2024-12-10 17:43:02,74,10131,35,39,7753.11,13024.01,0.00
2024-12-10 17:43:02,73,10131,35,38,7850.40,13024.04,0.00
2024-12-10 17:43:02,74,10130,35,39,7698.70,13024.42,0.00
2024-12-10 17:43:02,74,10131,35,39,7833.86,13025.00,0.00
2024-12-10 17:43:02,75,10131,35,40,7729.41,13025.01,0.00
2024-12-10 17:43:02,74,10131,34,40,7741.63,13025.13,0.00
2024-12-10 17:43:02,74,10132,34,40,7980.80,13026.00,0.00
2024-12-10 17:43:02,75,10132,34,41,7874.39,13026.01,0.00
2024-12-10 17:43:02,74,10132,33,41,7924.48,13026.07,0.00
2024-12-10 17:43:02,73,10132,33,40,8015.19,13026.07,0.00
2024-12-10 17:43:02,73,10133,33,40,8072.90,13027.00,0.00
2024-12-10 17:43:02,74,10133,33,41,7963.81,13027.01,0.00
2024-12-10 17:43:02,74,10134,33,41,7956.19,13028.00,0.00
2024-12-10 17:43:02,75,10134,34,41,7850.11,13028.01,0.00
2024-12-10 17:43:02,74,10134,33,41,7881.79,13028.31,0.00
2024-12-10 17:43:02,74,10135,33,41,7968.55,13029.00,0.00
2024-12-10 17:43:02,75,10135,34,41,7862.30,13029.01,0.00
2024-12-10 17:43:02,74,10135,33,41,7965.72,13029.03,0.00
2024-12-10 17:43:02,74,10136,33,41,7918.09,13030.00,0.00
2024-12-10 17:43:02,75,10136,34,41,7812.52,13030.01,0.00
2024-12-10 17:43:02,74,10136,34,40,7879.36,13030.07,0.00
2024-12-10 17:43:02,75,10135,35,40,7762.18,13030.19,0.00
2024-12-10 17:43:02,74,10135,34,40,7934.00,13030.20,0.00
2024-12-10 17:43:02,74,10136,34,40,7936.31,13031.00,0.00
2024-12-10 17:43:02,75,10136,35,40,7830.49,13031.01,0.00
2024-12-10 17:43:02,75,10137,35,40,7945.77,13032.00,0.00
2024-12-10 17:43:02,76,10137,36,40,7841.22,13032.01,0.00
2024-12-10 17:43:02,75,10137,36,39,7911.02,13032.03,0.00
2024-12-10 17:43:02,75,10138,36,39,7889.04,13033.00,0.00
2024-12-10 17:43:02,76,10138,37,39,7785.24,13033.01,0.00
2024-12-10 17:43:02,75,10138,36,39,7887.30,13033.01,0.00
2024-12-10 17:43:02,74,10138,36,38,7981.56,13033.04,0.00
2024-12-10 17:43:02,74,10139,36,38,7962.80,13034.00,0.00
2024-12-10 17:43:02,75,10139,37,38,7856.63,13034.01,0.00
2024-12-10 17:43:02,74,10139,36,38,7771.39,13034.97,0.00
2024-12-10 17:43:02,74,10140,36,38,7944.03,13035.00,0.00
2024-12-10 17:43:02,75,10140,36,39,7838.11,13035.01,0.00
2024-12-10 17:43:02,74,10140,36,38,7931.71,13035.04,0.00
2024-12-10 17:43:02,75,10139,36,39,7805.16,13035.23,0.00
2024-12-10 17:43:02,75,10140,36,39,7847.40,13036.00,0.00
2024-12-10 17:43:02,76,10140,37,39,7744.15,13036.01,0.00
2024-12-10 17:43:02,77,10139,37,40,7579.34,13036.27,0.00
2024-12-10 17:43:02,78,10138,37,41,7539.12,13036.53,0.00
2024-12-10 17:43:02,78,10139,37,41,7817.10,13037.00,0.00
2024-12-10 17:43:02,79,10139,38,41,7718.15,13037.01,0.00
2024-12-10 17:43:02,78,10139,38,40,7807.08,13037.04,0.00
2024-12-10 17:43:02,78,10140,38,40,8115.80,13038.00,0.00
2024-12-10 17:43:02,79,10140,38,41,8013.07,13038.01,0.00
2024-12-10 17:43:02,78,10140,37,41,8020.56,13038.10,0.00
2024-12-10 17:43:02,78,10141,37,41,8065.56,13039.00,0.00
2024-12-10 17:43:02,79,10141,37,42,7963.47,13039.01,0.00
2024-12-10 17:43:02,78,10141,37,41,8057.21,13039.04,0.00
2024-12-10 17:43:02,78,10142,37,41,8029.05,13040.00,0.00
2024-12-10 17:43:02,79,10142,37,42,7927.41,13040.01,0.00
2024-12-10 17:43:02,79,10143,37,42,7865.29,13041.00,0.00
2024-12-10 17:43:02,80,10143,37,43,7766.97,13041.01,0.00
2024-12-10 17:43:02,79,10143,37,42,7850.45,13041.06,0.00
2024-12-10 17:43:02,78,10143,36,42,7939.44,13041.15,0.00
2024-12-10 17:43:02,78,10144,36,42,7929.95,13042.00,0.00
2024-12-10 17:43:02,79,10144,36,43,7829.57,13042.01,0.00
2024-12-10 17:43:02,79,10145,36,43,7817.58,13043.00,0.00
2024-12-10 17:43:02,80,10145,36,44,7719.86,13043.01,0.00
2024-12-10 17:43:02,80,10146,36,44,7697.51,13044.00,0.00
2024-12-10 17:43:02,81,10146,37,44,7602.48,13044.01,0.00
2024-12-10 17:43:02,80,10146,37,43,7684.47,13044.01,0.00
2024-12-10 17:43:02,79,10146,36,43,7692.94,13044.70,0.00
2024-12-10 17:43:02,79,10147,36,43,7752.61,13045.00,0.00
2024-12-10 17:43:02,80,10147,37,43,7655.70,13045.01,0.00
2024-12-10 17:43:02,79,10147,36,43,7582.46,13045.80,0.00
2024-12-10 17:43:02,79,10148,36,43,7721.33,13046.00,0.00
2024-12-10 17:43:02,80,10148,37,43,7624.82,13046.01,0.00
2024-12-10 17:43:02,79,10148,36,43,7665.26,13046.19,0.00
2024-12-10 17:43:02,79,10149,36,43,7659.17,13047.00,0.00
2024-12-10 17:43:02,80,10149,37,43,7563.43,13047.01,0.00
2024-12-10 17:43:02,79,10149,37,42,7647.62,13047.05,0.00
2024-12-10 17:43:02,79,10150,37,42,7623.42,13048.00,0.00
2024-12-10 17:43:02,80,10150,37,43,7528.12,13048.01,0.00
2024-12-10 17:43:02,79,10150,36,43,7578.27,13048.10,0.00
2024-12-10 17:43:02,79,10151,36,43,7560.65,13049.00,0.00
2024-12-10 17:43:02,80,10151,37,43,7466.15,13049.01,0.00
2024-12-10 17:43:02,79,10151,37,42,7545.80,13049.06,0.00
2024-12-10 17:43:02,78,10151,36,42,7510.69,13049.64,0.00
2024-12-10 17:43:02,78,10152,36,42,7631.41,13050.00,0.00
2024-12-10 17:43:02,79,10152,37,42,7534.81,13050.01,0.00
2024-12-10 17:43:02,79,10153,37,42,7472.60,13051.00,0.00
2024-12-10 17:43:02,80,10153,37,43,7379.20,13051.01,0.00
2024-12-10 17:43:02,79,10153,37,42,7442.90,13051.10,0.00
2024-12-10 17:43:02,80,10152,38,42,7250.78,13051.89,0.00
2024-12-10 17:43:03,80,10153,38,42,7348.76,13052.00,0.00
2024-12-10 17:43:03,81,10153,38,43,7258.04,13052.01,0.00
2024-12-10 17:43:03,81,10154,38,43,7403.87,13053.00,0.00
2024-12-10 17:43:03,82,10154,38,44,7313.58,13053.01,0.00
2024-12-10 17:43:03,82,10155,38,44,7283.72,13054.00,0.00
2024-12-10 17:43:03,83,10155,38,45,7195.97,13054.01,0.00
2024-12-10 17:43:03,82,10155,37,45,7217.66,13054.15,0.00
2024-12-10 17:43:03,81,10155,36,45,7300.34,13054.20,0.00
2024-12-10 17:43:03,80,10155,35,45,7320.12,13054.71,0.00
2024-12-10 17:43:03,80,10156,35,45,7446.00,13055.00,0.00
2024-12-10 17:43:03,81,10156,35,46,7354.07,13055.01,0.00
2024-12-10 17:43:03,80,10156,34,46,7444.36,13055.01,0.00
2024-12-10 17:43:03,80,10157,34,46,7381.28,13056.00,0.00
2024-12-10 17:43:03,81,10157,35,46,7290.16,13056.01,0.00
2024-12-10 17:43:03,80,10157,34,46,7355.17,13056.01,0.00
2024-12-10 17:43:03,79,10157,34,45,7436.74,13056.09,0.00
2024-12-10 17:43:03,79,10158,34,45,7483.56,13057.00,0.00
2024-12-10 17:43:03,80,10158,34,46,7390.01,13057.01,0.00
2024-12-10 17:43:03,79,10158,33,46,7358.01,13057.20,0.00
2024-12-10 17:43:03,79,10159,33,46,7419.67,13058.00,0.00
2024-12-10 17:43:03,80,10159,33,47,7326.92,13058.01,0.00
2024-12-10 17:43:03,79,10159,33,46,7391.60,13058.10,0.00
2024-12-10 17:43:03,79,10160,33,46,7373.95,13059.00,0.00
2024-12-10 17:43:03,80,10160,33,47,7281.77,13059.01,0.00
2024-12-10 17:43:03,80,10161,33,47,7219.89,13060.00,0.00
2024-12-10 17:43:03,81,10161,34,47,7130.76,13060.01,0.00
2024-12-10 17:43:03,80,10161,34,46,7190.54,13060.10,0.00
2024-12-10 17:43:03,81,10160,35,46,7010.23,13060.83,0.00
2024-12-10 17:43:03,80,10160,34,46,7139.19,13060.96,0.00
2024-12-10 17:43:03,80,10161,34,46,7297.58,13061.00,0.00
2024-12-10 17:43:03,81,10161,34,47,7207.49,13061.01,0.00
2024-12-10 17:43:03,80,10161,33,47,7193.13,13061.14,0.00
2024-12-10 17:43:03,80,10162,33,47,7407.53,13062.00,0.00
2024-12-10 17:43:03,81,10162,33,48,7316.08,13062.01,0.00
2024-12-10 17:43:03,80,10162,33,47,7378.18,13062.11,0.00
2024-12-10 17:43:03,81,10161,34,47,7201.96,13062.79,0.00
2024-12-10 17:43:03,81,10162,34,47,7361.80,13063.00,0.00
2024-12-10 17:43:03,82,10162,35,47,7272.02,13063.01,0.00
2024-12-10 17:43:03,82,10163,35,47,7368.35,13064.00,0.00
2024-12-10 17:43:03,83,10163,36,47,7279.58,13064.01,0.00
2024-12-10 17:43:03,82,10163,36,46,7341.30,13064.11,0.00
2024-12-10 17:43:03,82,10164,36,46,7321.12,13065.00,0.00
2024-12-10 17:43:03,83,10164,36,47,7232.91,13065.01,0.00
2024-12-10 17:43:03,82,10164,35,47,7319.52,13065.01,0.00
2024-12-10 17:43:03,82,10165,35,47,7258.09,13066.00,0.00
2024-12-10 17:43:03,83,10165,36,47,7170.64,13066.01,0.00
2024-12-10 17:43:03,82,10165,36,46,7231.03,13066.10,0.00
2024-12-10 17:43:03,82,10166,36,46,7209.25,13067.00,0.00
2024-12-10 17:43:03,83,10166,37,46,7122.39,13067.01,0.00
2024-12-10 17:43:03,84,10165,38,46,6952.19,13067.45,0.00
2024-12-10 17:43:03,84,10166,38,46,7104.80,13068.00,0.00
2024-12-10 17:43:03,85,10166,38,47,7021.22,13068.01,0.00
2024-12-10 17:43:03,84,10166,38,46,7079.94,13068.10,0.00
2024-12-10 17:43:03,83,10166,37,46,7146.40,13068.24,0.00
2024-12-10 17:43:03,83,10167,37,46,7299.60,13069.00,0.00
2024-12-10 17:43:03,84,10167,38,46,7212.70,13069.01,0.00
2024-12-10 17:43:03,84,10168,38,46,7147.92,13070.00,0.00
2024-12-10 17:43:03,85,10168,38,47,7063.83,13070.01,0.00
2024-12-10 17:43:03,84,10168,37,47,7146.37,13070.01,0.00
2024-12-10 17:43:03,83,10168,37,46,7208.87,13070.08,0.00
2024-12-10 17:43:03,82,10168,36,46,7164.94,13070.92,0.00
2024-12-10 17:43:03,82,10169,36,46,7313.24,13071.00,0.00
2024-12-10 17:43:03,83,10169,37,46,7225.12,13071.01,0.00
2024-12-10 17:43:03,84,10168,37,47,7075.40,13071.29,0.00
2024-12-10 17:43:03,84,10169,37,47,7169.28,13072.00,0.00
2024-12-10 17:43:03,85,10169,38,47,7084.94,13072.01,0.00
2024-12-10 17:43:03,84,10169,38,46,7144.41,13072.10,0.00
2024-12-10 17:43:03,83,10169,37,46,7205.36,13072.28,0.00
2024-12-10 17:43:03,83,10170,37,46,7363.32,13073.00,0.00
2024-12-10 17:43:03,84,10170,38,46,7275.66,13073.01,0.00
2024-12-10 17:43:03,84,10171,38,46,7247.82,13074.00,0.00
2024-12-10 17:43:03,85,10171,39,46,7162.55,13074.01,0.00
2024-12-10 17:43:03,85,10172,39,46,7112.79,13075.00,0.00
2024-12-10 17:43:03,86,10172,40,46,7030.08,13075.01,0.00
2024-12-10 17:43:03,85,10172,39,46,7109.72,13075.02,0.00
2024-12-10 17:43:03,85,10173,39,46,7044.11,13076.00,0.00
2024-12-10 17:43:03,86,10173,39,47,6962.20,13076.01,0.00
2024-12-10 17:43:03,85,10173,39,46,7030.29,13076.11,0.00
2024-12-10 17:43:03,85,10174,39,46,7006.19,13077.00,0.00
2024-12-10 17:43:03,86,10174,39,47,6924.72,13077.01,0.00
2024-12-10 17:43:03,85,10174,38,47,6918.52,13077.12,0.00
2024-12-10 17:43:03,85,10175,38,47,6957.48,13078.00,0.00
2024-12-10 17:43:03,86,10175,39,47,6876.58,13078.01,0.00
2024-12-10 17:43:03,85,10175,39,46,6935.97,13078.11,0.00
2024-12-10 17:43:03,85,10176,39,46,6911.85,13079.00,0.00
2024-12-10 17:43:03,86,10176,39,47,6831.48,13079.01,0.00
2024-12-10 17:43:03,85,10176,38,47,6750.56,13079.64,0.00
2024-12-10 17:43:03,85,10177,38,47,6856.99,13080.00,0.00
2024-12-10 17:43:03,86,10177,38,48,6777.25,13080.01,0.00
2024-12-10 17:43:03,85,10177,38,47,6830.85,13080.13,0.00
2024-12-10 17:43:03,84,10177,37,47,6817.38,13080.56,0.00
2024-12-10 17:43:03,84,10178,37,47,6915.79,13081.00,0.00
2024-12-10 17:43:03,85,10178,37,48,6834.43,13081.01,0.00
2024-12-10 17:43:03,84,10178,36,48,6813.14,13081.40,0.00
2024-12-10 17:43:04,84,10179,36,48,6891.40,13082.00,0.00
2024-12-10 17:43:04,85,10179,36,49,6810.32,13082.01,0.00
2024-12-10 17:43:04,84,10179,36,48,6866.51,13082.13,0.00
2024-12-10 17:43:04,83,10179,35,48,6810.65,13082.71,0.00
2024-12-10 17:43:04,83,10180,35,48,6930.65,13083.00,0.00
2024-12-10 17:43:04,84,10180,36,48,6848.14,13083.01,0.00
2024-12-10 17:43:04,83,10180,36,47,6924.35,13083.05,0.00
2024-12-10 17:43:04,82,10180,35,47,6900.44,13083.45,0.00
2024-12-10 17:43:04,82,10181,35,47,6988.58,13084.00,0.00
2024-12-10 17:43:04,83,10181,36,47,6904.38,13084.01,0.00
2024-12-10 17:43:04,82,10181,36,46,6966.26,13084.12,0.00
2024-12-10 17:43:04,82,10182,36,46,6947.62,13085.00,0.00
2024-12-10 17:43:04,83,10182,37,46,6863.91,13085.01,0.00
2024-12-10 17:43:04,82,10182,36,46,6864.74,13085.34,0.00
2024-12-10 17:43:04,82,10183,36,46,6938.58,13086.00,0.00
2024-12-10 17:43:04,83,10183,37,46,6854.98,13086.01,0.00
2024-12-10 17:43:04,82,10183,37,45,6917.85,13086.12,0.00
2024-12-10 17:43:04,82,10184,37,45,6899.21,13087.00,0.00
2024-12-10 17:43:04,83,10184,38,45,6816.08,13087.01,0.00
2024-12-10 17:43:04,82,10184,37,45,6776.48,13087.71,0.00
2024-12-10 17:43:04,82,10185,37,45,6834.79,13088.00,0.00
2024-12-10 17:43:04,83,10185,38,45,6752.44,13088.01,0.00
2024-12-10 17:43:04,82,10185,38,44,6807.69,13088.16,0.00
2024-12-10 17:43:04,82,10186,38,44,6793.81,13089.00,0.00
2024-12-10 17:43:04,83,10186,39,44,6711.96,13089.01,0.00
2024-12-10 17:43:04,83,10187,39,44,6646.23,13090.00,0.00
2024-12-10 17:43:04,84,10187,39,45,6567.11,13090.01,0.00
2024-12-10 17:43:04,83,10187,38,45,6639.93,13090.05,0.00
2024-12-10 17:43:04,82,10187,38,44,6701.77,13090.15,0.00
2024-12-10 17:43:04,81,10187,37,44,6660.50,13090.93,0.00
2024-12-10 17:43:04,81,10188,37,44,6812.47,13091.00,0.00
2024-12-10 17:43:04,82,10188,38,44,6729.39,13091.01,0.00
2024-12-10 17:43:04,81,10188,37,44,6778.93,13091.04,0.00
2024-12-10 17:43:04,81,10189,37,44,6782.68,13092.00,0.00
2024-12-10 17:43:04,82,10189,37,45,6699.96,13092.01,0.00
2024-12-10 17:43:04,81,10189,37,44,6761.69,13092.14,0.00
2024-12-10 17:43:04,81,10190,37,44,6746.02,13093.00,0.00
2024-12-10 17:43:04,82,10190,37,45,6663.75,13093.01,0.00
2024-12-10 17:43:04,81,10190,36,45,6680.45,13093.26,0.00
2024-12-10 17:43:04,81,10191,36,45,6680.90,13094.00,0.00
2024-12-10 17:43:04,82,10191,37,45,6599.42,13094.01,0.00
2024-12-10 17:43:04,81,10191,37,44,6659.91,13094.14,0.00
2024-12-10 17:43:04,80,10191,36,44,6604.50,13094.97,0.00
2024-12-10 17:43:04,80,10192,36,44,6764.93,13095.00,0.00
2024-12-10 17:43:04,81,10192,37,44,6681.41,13095.01,0.00
2024-12-10 17:43:04,81,10193,37,44,6617.25,13096.00,0.00
2024-12-10 17:43:04,82,10193,37,45,6536.55,13096.01,0.00
2024-12-10 17:43:04,81,10193,37,44,6597.87,13096.14,0.00
2024-12-10 17:43:04,82,10192,38,44,6405.95,13096.99,0.00
2024-12-10 17:43:04,82,10193,38,44,6629.56,13097.00,0.00
2024-12-10 17:43:04,83,10193,38,45,6549.69,13097.01,0.00
2024-12-10 17:43:04,82,10193,37,45,6549.93,13097.28,0.00
2024-12-10 17:43:04,82,10194,37,45,6711.69,13098.00,0.00
2024-12-10 17:43:04,83,10194,38,45,6630.83,13098.01,0.00
2024-12-10 17:43:04,82,10194,38,44,6694.14,13098.13,0.00
2024-12-10 17:43:04,82,10195,38,44,6659.13,13099.00,0.00
2024-12-10 17:43:04,83,10195,39,44,6578.90,13099.01,0.00
2024-12-10 17:43:04,82,10195,38,44,6654.35,13099.04,0.00
2024-12-10 17:43:04,81,10195,38,43,6699.80,13099.12,0.00
2024-12-10 17:43:04,80,10195,38,42,6772.43,13099.15,0.00
2024-12-10 17:43:04,79,10195,37,42,6722.46,13099.72,0.00
2024-12-10 17:43:04,79,10196,37,42,6849.46,13100.00,0.00
2024-12-10 17:43:04,80,10196,38,42,6763.84,13100.01,0.00
2024-12-10 17:43:04,79,10196,37,42,6844.49,13100.04,0.00
2024-12-10 17:43:04,78,10196,37,41,6894.39,13100.12,0.00
2024-12-10 17:43:04,78,10197,37,41,6862.20,13101.00,0.00
2024-12-10 17:43:04,79,10197,37,42,6775.34,13101.01,0.00
2024-12-10 17:43:04,78,10197,36,42,6857.17,13101.04,0.00
2024-12-10 17:43:04,77,10197,35,42,6713.68,13101.91,0.00
2024-12-10 17:43:04,77,10198,35,42,6863.20,13102.00,0.00
2024-12-10 17:43:04,78,10198,35,43,6775.21,13102.01,0.00
2024-12-10 17:43:04,77,10198,35,42,6842.81,13102.12,0.00
2024-12-10 17:43:04,77,10199,35,42,6826.42,13103.00,0.00
2024-12-10 17:43:04,78,10199,35,43,6738.91,13103.01,0.00
2024-12-10 17:43:04,77,10199,34,43,6670.99,13103.84,0.00
2024-12-10 17:43:04,77,10200,34,43,6820.88,13104.00,0.00
2024-12-10 17:43:04,78,10200,35,43,6733.44,13104.01,0.00
2024-12-10 17:43:04,77,10200,35,42,6802.19,13104.12,0.00
2024-12-10 17:43:04,77,10201,35,42,6784.65,13105.00,0.00
2024-12-10 17:43:04,78,10201,35,43,6697.67,13105.01,0.00
2024-12-10 17:43:04,77,10201,34,43,6782.95,13105.01,0.00
2024-12-10 17:43:04,76,10201,34,42,6868.75,13105.03,0.00
2024-12-10 17:43:04,75,10201,33,42,6958.59,13105.03,0.00
2024-12-10 17:43:04,75,10202,33,42,6959.91,13106.00,0.00
2024-12-10 17:43:04,76,10202,33,43,6868.33,13106.01,0.00
2024-12-10 17:43:04,76,10203,33,43,6793.62,13107.00,0.00
2024-12-10 17:43:04,77,10203,34,43,6705.39,13107.01,0.00
2024-12-10 17:43:04,76,10203,34,42,6783.29,13107.08,0.00
2024-12-10 17:43:04,75,10203,34,41,6854.52,13107.11,0.00
2024-12-10 17:43:04,74,10203,33,41,6845.60,13107.78,0.00
2024-12-10 17:43:04,74,10204,33,41,6971.69,13108.00,0.00
2024-12-10 17:43:04,75,10204,34,41,6878.73,13108.01,0.00
2024-12-10 17:43:04,74,10204,33,41,6961.06,13108.04,0.00
2024-12-10 17:43:04,74,10205,33,41,6949.57,13109.00,0.00
2024-12-10 17:43:04,75,10205,33,42,6856.91,13109.01,0.00
2024-12-10 17:43:04,74,10205,33,41,6923.03,13109.11,0.00
2024-12-10 17:43:04,73,10205,32,41,6996.37,13109.26,0.00
2024-12-10 17:43:04,73,10206,32,41,6966.66,13110.00,0.00
2024-12-10 17:43:04,74,10206,32,42,6872.52,13110.01,0.00
2024-12-10 17:43:05,73,10206,32,41,6963.07,13110.03,0.00
2024-12-10 17:43:05,72,10206,31,41,6905.23,13110.58,0.00
2024-12-10 17:43:05,72,10207,31,41,6987.16,13111.00,0.00
2024-12-10 17:43:05,73,10207,32,41,6891.45,13111.01,0.00
2024-12-10 17:43:05,72,10207,32,40,6965.34,13111.10,0.00
2024-12-10 17:43:05,71,10207,31,40,6939.37,13111.56,0.00
2024-12-10 17:43:05,70,10207,30,40,6995.51,13111.80,0.00
2024-12-10 17:43:05,70,10208,30,40,7156.77,13112.00,0.00
2024-12-10 17:43:05,71,10208,31,40,7055.97,13112.01,0.00
2024-12-10 17:43:05,71,10209,31,40,6994.87,13113.00,0.00
2024-12-10 17:43:05,72,10209,32,40,6897.72,13113.01,0.00
2024-12-10 17:43:05,71,10209,32,39,6969.04,13113.11,0.00
2024-12-10 17:43:05,70,10209,31,39,7051.71,13113.24,0.00
2024-12-10 17:43:05,70,10210,31,39,7055.89,13114.00,0.00
2024-12-10 17:43:05,71,10210,32,39,6956.51,13114.01,0.00
2024-12-10 17:43:05,71,10211,32,39,6890.51,13115.00,0.00
2024-12-10 17:43:05,72,10211,33,39,6794.81,13115.01,0.00
2024-12-10 17:43:05,71,10211,33,38,6866.53,13115.11,0.00
2024-12-10 17:43:05,70,10211,32,38,6878.23,13115.51,0.00
2024-12-10 17:43:05,70,10212,32,38,6987.18,13116.00,0.00
2024-12-10 17:43:05,71,10212,32,39,6888.77,13116.01,0.00
2024-12-10 17:43:05,71,10213,32,39,6827.00,13117.00,0.00
2024-12-10 17:43:05,72,10213,32,40,6732.18,13117.01,0.00
2024-12-10 17:43:05,71,10213,32,39,6786.38,13117.11,0.00
2024-12-10 17:43:05,70,10213,32,38,6817.24,13117.50,0.00
2024-12-10 17:43:05,70,10214,32,38,6864.44,13118.00,0.00
2024-12-10 17:43:05,71,10214,33,38,6767.76,13118.01,0.00
2024-12-10 17:43:05,71,10215,33,38,6715.56,13119.00,0.00
2024-12-10 17:43:05,72,10215,33,39,6622.28,13119.01,0.00
2024-12-10 17:43:05,71,10215,33,38,6691.56,13119.13,0.00
2024-12-10 17:43:05,70,10215,32,38,6698.32,13119.50,0.00
2024-12-10 17:43:05,70,10216,32,38,6814.92,13120.00,0.00
2024-12-10 17:43:05,71,10216,32,39,6718.94,13120.01,0.00
2024-12-10 17:43:05,70,10216,31,39,6738.16,13120.30,0.00
2024-12-10 17:43:05,69,10216,30,39,6794.03,13120.45,0.00
2024-12-10 17:43:05,69,10217,30,39,6884.59,13121.00,0.00
2024-12-10 17:43:05,70,10217,30,40,6786.24,13121.01,0.00
2024-12-10 17:43:05,69,10217,29,40,6866.94,13121.14,0.00
2024-12-10 17:43:05,68,10217,29,39,6950.56,13121.16,0.00
2024-12-10 17:43:05,68,10218,29,39,6889.85,13122.00,0.00
2024-12-10 17:43:05,69,10218,30,39,6790.00,13122.01,0.00
2024-12-10 17:43:05,69,10219,30,39,6633.23,13123.00,0.00
2024-12-10 17:43:05,70,10219,31,39,6538.47,13123.01,0.00
2024-12-10 17:43:05,69,10219,31,38,6591.41,13123.10,0.00
2024-12-10 17:43:05,68,10219,31,37,6602.98,13123.63,0.00
2024-12-10 17:43:05,68,10220,31,37,6582.02,13124.00,0.00
2024-12-10 17:43:05,69,10220,32,37,6486.62,13124.01,0.00
2024-12-10 17:43:05,68,10220,32,36,6545.38,13124.16,0.00
2024-12-10 17:43:05,67,10220,31,36,6566.07,13124.64,0.00
2024-12-10 17:43:05,67,10221,31,36,6592.98,13125.00,0.00
2024-12-10 17:43:05,68,10221,32,36,6496.03,13125.01,0.00
2024-12-10 17:43:05,68,10222,32,36,6405.52,13126.00,0.00
2024-12-10 17:43:05,69,10222,33,36,6312.69,13126.01,0.00
2024-12-10 17:43:05,68,10222,33,35,6370.81,13126.16,0.00
2024-12-10 17:43:05,67,10222,33,34,6358.51,13126.78,0.00
2024-12-10 17:43:05,67,10223,33,34,6446.83,13127.00,0.00
2024-12-10 17:43:05,68,10223,33,35,6352.02,13127.01,0.00
2024-12-10 17:43:05,68,10224,33,35,6312.27,13128.00,0.00
2024-12-10 17:43:05,69,10224,33,36,6220.79,13128.01,0.00
2024-12-10 17:43:05,68,10224,33,35,6279.48,13128.16,0.00
2024-12-10 17:43:05,67,10224,32,35,6355.89,13128.28,0.00
2024-12-10 17:43:05,66,10224,31,35,6452.19,13128.29,0.00
2024-12-10 17:43:05,66,10225,31,35,6478.48,13129.00,0.00
2024-12-10 17:43:05,67,10225,31,36,6381.78,13129.01,0.00
2024-12-10 17:43:05,66,10225,30,36,6265.78,13129.97,0.00
2024-12-10 17:43:05,66,10226,30,36,6460.76,13130.00,0.00
2024-12-10 17:43:05,67,10226,30,37,6364.33,13130.01,0.00
2024-12-10 17:43:05,66,10226,29,37,6452.81,13130.06,0.00
2024-12-10 17:43:05,67,10225,30,37,6350.62,13130.13,0.00
2024-12-10 17:43:05,66,10225,30,36,6564.24,13130.17,0.00
2024-12-10 17:43:05,67,10224,31,36,6456.49,13130.27,0.00
2024-12-10 17:43:05,66,10224,30,36,6559.07,13130.94,0.00
2024-12-10 17:43:05,66,10225,30,36,6750.11,13131.00,0.00
2024-12-10 17:43:05,67,10225,31,36,6649.36,13131.01,0.00
2024-12-10 17:43:05,67,10226,31,36,7000.65,13132.00,0.00
2024-12-10 17:43:05,68,10226,31,37,6897.70,13132.01,0.00
2024-12-10 17:43:05,67,10226,30,37,6992.83,13132.06,0.00
2024-12-10 17:43:05,66,10226,30,36,7076.91,13132.14,0.00
2024-12-10 17:43:05,65,10226,29,36,7058.95,13132.86,0.00
2024-12-10 17:43:05,65,10227,29,36,7242.93,13133.00,0.00
2024-12-10 17:43:05,66,10227,30,36,7133.19,13133.02,0.00
2024-12-10 17:43:05,65,10227,29,36,7111.90,13133.71,0.00
2024-12-10 17:43:05,65,10228,29,36,7199.10,13134.00,0.00
2024-12-10 17:43:05,66,10228,30,36,7090.02,13134.02,0.00
2024-12-10 17:43:05,65,10228,30,35,7172.86,13134.14,0.00
2024-12-10 17:43:05,64,10228,29,35,7268.66,13134.25,0.00
2024-12-10 17:43:05,64,10229,29,35,7293.77,13135.00,0.00
2024-12-10 17:43:05,65,10229,30,35,7181.56,13135.02,0.00
2024-12-10 17:43:05,64,10229,29,35,7291.72,13135.02,0.00
2024-12-10 17:43:05,63,10229,29,34,7401.22,13135.05,0.00
2024-12-10 17:43:05,64,10228,29,35,7162.72,13135.70,0.00
2024-12-10 17:43:05,63,10228,28,35,7247.37,13135.95,0.00
2024-12-10 17:43:05,63,10229,28,35,7449.65,13136.00,0.00
2024-12-10 17:43:05,64,10229,29,35,7333.25,13136.02,0.00
2024-12-10 17:43:05,63,10229,29,34,7428.83,13136.11,0.00
2024-12-10 17:43:05,63,10230,29,34,7645.47,13137.00,0.00
2024-12-10 17:43:05,64,10230,29,35,7526.01,13137.02,0.00
2024-12-10 17:43:05,63,10230,28,35,7572.49,13137.02,0.00
2024-12-10 17:43:05,63,10231,28,35,7610.44,13138.00,0.00
2024-12-10 17:43:05,64,10231,28,36,7491.53,13138.02,0.00
2024-12-10 17:43:05,63,10231,28,35,7572.92,13138.08,0.00
2024-12-10 17:43:05,63,10232,28,35,7577.65,13139.00,0.00
2024-12-10 17:43:05,64,10232,29,35,7459.25,13139.02,0.00
2024-12-10 17:43:05,63,10232,29,34,7563.07,13139.08,0.00
2024-12-10 17:43:06,63,10233,29,34,7567.80,13140.00,0.00
2024-12-10 17:43:06,64,10233,30,34,7449.55,13140.02,0.00
2024-12-10 17:43:06,64,10234,30,34,7402.89,13141.00,0.00
2024-12-10 17:43:06,65,10234,31,34,7289.00,13141.02,0.00
2024-12-10 17:43:06,64,10234,31,33,7390.59,13141.08,0.00
2024-12-10 17:43:06,64,10235,31,33,7393.19,13142.00,0.00
2024-12-10 17:43:06,65,10235,31,34,7279.45,13142.02,0.00
2024-12-10 17:43:06,64,10235,31,33,7389.08,13142.03,0.00
2024-12-10 17:43:06,64,10236,31,33,7342.08,13143.00,0.00
2024-12-10 17:43:06,65,10236,31,34,7229.12,13143.02,0.00
2024-12-10 17:43:06,64,10236,31,33,7327.74,13143.08,0.00
2024-12-10 17:43:06,63,10236,30,33,7375.62,13143.59,0.00
2024-12-10 17:43:06,63,10237,30,33,7446.88,13144.00,0.00
2024-12-10 17:43:06,64,10237,31,33,7330.52,13144.02,0.00
2024-12-10 17:43:06,63,10237,30,33,7376.01,13144.22,0.00
2024-12-10 17:43:06,62,10237,29,33,7387.25,13144.85,0.00
2024-12-10 17:43:06,62,10238,29,33,7580.28,13145.00,0.00
2024-12-10 17:43:06,63,10238,29,34,7459.96,13145.02,0.00
2024-12-10 17:43:06,62,10238,29,33,7561.24,13145.10,0.00
2024-12-10 17:43:06,62,10239,29,33,7570.26,13146.00,0.00
2024-12-10 17:43:06,63,10239,30,33,7450.10,13146.02,0.00
2024-12-10 17:43:06,62,10239,29,33,7502.47,13146.21,0.00
2024-12-10 17:43:06,62,10240,29,33,7526.30,13147.00,0.00
2024-12-10 17:43:06,63,10240,30,33,7406.84,13147.02,0.00
2024-12-10 17:43:06,62,10240,29,33,7519.96,13147.05,0.00
2024-12-10 17:43:06,61,10240,29,32,7630.32,13147.08,0.00
2024-12-10 17:43:06,60,10240,28,32,7743.50,13147.18,0.00
2024-12-10 17:43:06,60,10241,28,32,7768.13,13148.00,0.00
2024-12-10 17:43:06,61,10241,28,33,7640.78,13148.02,0.00
2024-12-10 17:43:06,60,10241,27,33,7702.45,13148.18,0.00
2024-12-10 17:43:06,61,10240,28,33,7565.43,13148.29,0.00
2024-12-10 17:43:06,61,10241,28,33,7709.33,13149.00,0.00
2024-12-10 17:43:06,62,10241,29,33,7584.99,13149.02,0.00
2024-12-10 17:43:06,61,10241,29,32,7679.19,13149.10,0.00
2024-12-10 17:43:06,60,10241,28,32,7686.86,13149.52,0.00
2024-12-10 17:43:06,60,10242,28,32,8061.97,13150.00,0.00
2024-12-10 17:43:06,61,10242,28,33,7929.81,13150.02,0.00
2024-12-10 17:43:06,62,10241,28,34,7732.00,13150.26,0.00
2024-12-10 17:43:06,62,10242,28,34,7903.24,13151.00,0.00
2024-12-10 17:43:06,63,10242,29,34,7777.79,13151.02,0.00
2024-12-10 17:43:06,62,10242,29,33,7865.11,13151.13,0.00
2024-12-10 17:43:06,61,10242,28,33,7927.33,13151.36,0.00
2024-12-10 17:43:06,61,10243,28,33,8274.89,13152.00,0.00
2024-12-10 17:43:06,62,10243,29,33,8141.43,13152.02,0.00
2024-12-10 17:43:06,62,10244,29,33,8097.50,13153.00,0.00
2024-12-10 17:43:06,63,10244,29,34,7968.96,13153.02,0.00
2024-12-10 17:43:06,62,10244,29,33,8061.47,13153.13,0.00
2024-12-10 17:43:06,61,10244,28,33,8122.79,13153.66,0.00
2024-12-10 17:43:06,61,10245,28,33,8207.15,13154.00,0.00
2024-12-10 17:43:06,62,10245,28,34,8074.78,13154.02,0.00
2024-12-10 17:43:06,62,10246,28,34,8036.84,13155.00,0.00
2024-12-10 17:43:06,63,10246,29,34,7909.27,13155.02,0.00
2024-12-10 17:43:06,62,10246,29,33,7988.07,13155.13,0.00
2024-12-10 17:43:06,61,10246,28,33,8072.02,13155.28,0.00
2024-12-10 17:43:06,61,10247,28,33,8193.30,13156.00,0.00
2024-12-10 17:43:06,62,10247,29,33,8061.15,13156.02,0.00
2024-12-10 17:43:06,61,10247,28,33,7977.78,13156.66,0.00
2024-12-10 17:43:06,61,10248,28,33,8148.44,13157.00,0.00
2024-12-10 17:43:06,62,10248,28,34,8017.01,13157.02,0.00
2024-12-10 17:43:06,61,10248,28,33,8109.73,13157.13,0.00
2024-12-10 17:43:06,61,10249,28,33,8125.41,13158.00,0.00
2024-12-10 17:43:06,62,10249,29,33,7994.35,13158.02,0.00
2024-12-10 17:43:06,62,10250,29,33,7954.73,13159.00,0.00
2024-12-10 17:43:06,63,10250,29,34,7828.46,13159.02,0.00
2024-12-10 17:43:06,62,10250,29,33,7908.07,13159.13,0.00
2024-12-10 17:43:06,61,10250,28,33,7981.60,13159.31,0.00
2024-12-10 17:43:06,61,10251,28,33,8107.23,13160.00,0.00
2024-12-10 17:43:06,62,10251,29,33,7976.47,13160.02,0.00
2024-12-10 17:43:06,61,10251,28,33,8040.41,13160.18,0.00
2024-12-10 17:43:06,61,10252,28,33,8128.11,13161.00,0.00
2024-12-10 17:43:06,62,10252,28,34,7997.01,13161.02,0.00
2024-12-10 17:43:06,61,10252,28,33,8095.77,13161.08,0.00
2024-12-10 17:43:06,61,10253,28,33,8104.99,13162.00,0.00
2024-12-10 17:43:06,62,10253,29,33,7974.27,13162.02,0.00
2024-12-10 17:43:06,62,10254,29,33,7982.63,13163.00,0.00
2024-12-10 17:43:06,63,10254,29,34,7855.92,13163.02,0.00
2024-12-10 17:43:06,63,10255,29,34,7834.54,13164.00,0.00
2024-12-10 17:43:06,64,10255,30,34,7712.13,13164.02,0.00
2024-12-10 17:43:06,64,10256,30,34,7662.81,13165.00,0.00
2024-12-10 17:43:06,65,10256,30,35,7544.92,13165.02,0.00
2024-12-10 17:43:06,64,10256,30,34,7635.56,13165.13,0.00
2024-12-10 17:43:06,63,10256,29,34,7688.09,13165.65,0.00
2024-12-10 17:43:06,63,10257,29,34,7767.77,13166.00,0.00
2024-12-10 17:43:06,64,10257,30,34,7646.40,13166.02,0.00
2024-12-10 17:43:06,64,10258,30,34,7607.08,13167.00,0.00
2024-12-10 17:43:06,65,10258,30,35,7490.05,13167.02,0.00
2024-12-10 17:43:06,64,10258,29,35,7605.02,13167.02,0.00
2024-12-10 17:43:06,63,10258,28,35,7719.49,13167.05,0.00
2024-12-10 17:43:06,62,10258,28,34,7803.66,13167.11,0.00
2024-12-10 17:43:06,62,10259,28,34,7814.83,13168.00,0.00
2024-12-10 17:43:06,63,10259,28,35,7690.79,13168.02,0.00
2024-12-10 17:43:06,63,10260,28,35,7648.28,13169.00,0.00
2024-12-10 17:43:06,64,10260,29,35,7528.78,13169.02,0.00
2024-12-10 17:43:06,63,10260,29,34,7606.51,13169.11,0.00
2024-12-10 17:43:06,62,10260,28,34,7722.84,13169.16,0.00
2024-12-10 17:43:06,61,10260,27,34,7702.33,13169.97,0.00
2024-12-10 17:43:06,61,10261,27,34,7913.93,13170.00,0.00
2024-12-10 17:43:06,62,10261,27,35,7786.28,13170.02,0.00
2024-12-10 17:43:06,62,10262,27,35,7742.26,13171.00,0.00
2024-12-10 17:43:06,63,10262,27,36,7619.37,13171.02,0.00
2024-12-10 17:43:06,62,10262,27,35,7701.93,13171.11,0.00
2024-12-10 17:43:06,61,10262,26,35,7748.65,13171.71,0.00
2024-12-10 17:43:07,61,10263,26,35,7839.55,13172.00,0.00
2024-12-10 17:43:07,62,10263,26,36,7713.11,13172.02,0.00
2024-12-10 17:43:07,62,10264,26,36,7670.82,13173.00,0.00
2024-12-10 17:43:07,63,10264,27,36,7549.07,13173.02,0.00
2024-12-10 17:43:07,62,10264,27,35,7626.24,13173.13,0.00
2024-12-10 17:43:07,63,10263,28,35,7503.10,13173.17,0.00
2024-12-10 17:43:07,62,10263,27,35,7672.40,13173.69,0.00
2024-12-10 17:43:07,62,10264,27,35,7844.73,13174.00,0.00
2024-12-10 17:43:07,63,10264,27,36,7720.21,13174.02,0.00
2024-12-10 17:43:07,63,10265,27,36,7894.07,13175.00,0.00
2024-12-10 17:43:07,64,10265,27,37,7770.72,13175.02,0.00
2024-12-10 17:43:07,63,10265,26,37,7814.17,13175.16,0.00
2024-12-10 17:43:07,63,10266,26,37,7864.79,13176.00,0.00
2024-12-10 17:43:07,64,10266,26,38,7741.90,13176.02,0.00
2024-12-10 17:43:07,63,10266,26,37,7843.93,13176.16,0.00
2024-12-10 17:43:07,63,10267,26,37,7836.53,13177.00,0.00
2024-12-10 17:43:07,64,10267,27,37,7714.08,13177.02,0.00
2024-12-10 17:43:07,64,10268,27,37,7667.31,13178.00,0.00
2024-12-10 17:43:07,65,10268,28,37,7549.35,13178.02,0.00
2024-12-10 17:43:07,64,10268,28,36,7642.65,13178.17,0.00
2024-12-10 17:43:07,63,10268,27,36,7709.37,13178.57,0.00
2024-12-10 17:43:07,63,10269,27,36,7862.40,13179.00,0.00
2024-12-10 17:43:07,64,10269,27,37,7739.55,13179.02,0.00
2024-12-10 17:43:07,63,10269,27,36,7856.14,13179.05,0.00
2024-12-10 17:43:07,62,10269,26,36,7844.84,13179.42,0.00
2024-12-10 17:43:07,62,10270,26,36,7981.31,13180.00,0.00
2024-12-10 17:43:07,63,10270,26,37,7854.62,13180.02,0.00
2024-12-10 17:43:07,62,10270,26,36,7974.95,13180.05,0.00
2024-12-10 17:43:07,61,10270,25,36,7973.38,13180.39,0.00
2024-12-10 17:43:07,61,10271,25,36,8109.95,13181.00,0.00
2024-12-10 17:43:07,62,10271,25,37,7979.14,13181.02,0.00
2024-12-10 17:43:07,61,10271,25,36,8068.97,13181.21,0.00
2024-12-10 17:43:07,61,10272,25,36,8095.44,13182.00,0.00
2024-12-10 17:43:07,62,10272,26,36,7964.87,13182.02,0.00
2024-12-10 17:43:07,61,10272,25,36,7961.61,13182.38,0.00
2024-12-10 17:43:07,61,10273,25,36,8096.05,13183.00,0.00
2024-12-10 17:43:07,62,10273,25,37,7965.47,13183.02,0.00
2024-12-10 17:43:07,63,10272,25,38,7713.81,13183.68,0.00
2024-12-10 17:43:07,63,10273,25,38,7982.88,13184.00,0.00
2024-12-10 17:43:07,64,10273,25,39,7858.15,13184.02,0.00
2024-12-10 17:43:07,63,10273,25,38,7947.38,13184.21,0.00
2024-12-10 17:43:07,63,10274,25,38,8178.12,13185.00,0.00
2024-12-10 17:43:07,64,10274,26,38,8050.34,13185.02,0.00
2024-12-10 17:43:07,63,10274,25,38,7975.69,13185.95,0.00
2024-12-10 17:43:07,63,10275,25,38,8178.74,13186.00,0.00
2024-12-10 17:43:07,64,10275,25,39,8050.95,13186.02,0.00
2024-12-10 17:43:07,64,10276,25,39,8004.17,13187.00,0.00
2024-12-10 17:43:07,65,10276,25,40,7881.03,13187.02,0.00
2024-12-10 17:43:07,64,10276,25,39,7973.33,13187.20,0.00
2024-12-10 17:43:07,64,10277,25,39,7992.41,13188.00,0.00
2024-12-10 17:43:07,65,10277,25,40,7869.45,13188.02,0.00
2024-12-10 17:43:07,65,10278,25,40,7836.98,13189.00,0.00
2024-12-10 17:43:07,66,10278,25,41,7718.24,13189.02,0.00
2024-12-10 17:43:07,65,10278,24,41,7805.17,13189.18,0.00
2024-12-10 17:43:07,66,10277,24,42,7642.96,13189.24,0.00
2024-12-10 17:43:07,65,10277,23,42,7817.44,13189.69,0.00
2024-12-10 17:43:07,65,10278,23,42,7980.03,13190.00,0.00
2024-12-10 17:43:07,66,10278,24,42,7859.12,13190.02,0.00
2024-12-10 17:43:07,65,10278,24,41,7955.73,13190.18,0.00
2024-12-10 17:43:07,65,10279,24,41,8172.99,13191.00,0.00
2024-12-10 17:43:07,66,10279,24,42,8049.16,13191.02,0.00
2024-12-10 17:43:07,67,10278,24,43,7842.54,13191.40,0.00
2024-12-10 17:43:07,67,10279,24,43,7977.72,13192.00,0.00
2024-12-10 17:43:07,68,10279,24,44,7860.40,13192.01,0.00
2024-12-10 17:43:07,67,10279,24,43,7910.84,13192.21,0.00
2024-12-10 17:43:07,67,10280,24,43,8122.06,13193.00,0.00
2024-12-10 17:43:07,68,10280,24,44,8002.62,13193.01,0.00
2024-12-10 17:43:07,67,10280,23,44,7911.10,13193.96,0.00
2024-12-10 17:43:07,67,10281,23,44,8102.15,13194.00,0.00
2024-12-10 17:43:07,68,10281,23,45,7983.00,13194.01,0.00
2024-12-10 17:43:07,67,10281,22,45,8098.18,13194.04,0.00
2024-12-10 17:43:07,66,10281,21,45,8118.98,13194.20,0.00
2024-12-10 17:43:07,66,10282,21,45,8173.51,13195.00,0.00
2024-12-10 17:43:07,67,10282,22,45,8051.52,13195.01,0.00
2024-12-10 17:43:07,66,10282,21,45,8002.05,13195.85,0.00
2024-12-10 17:43:07,66,10283,21,45,8182.13,13196.00,0.00
2024-12-10 17:43:07,67,10283,21,46,8060.01,13196.01,0.00
2024-12-10 17:43:07,67,10284,21,46,8009.40,13197.00,0.00
2024-12-10 17:43:07,68,10284,22,46,7891.62,13197.01,0.00
2024-12-10 17:43:07,67,10284,22,45,7981.89,13197.21,0.00
2024-12-10 17:43:07,66,10284,22,44,8088.84,13197.23,0.00
2024-12-10 17:43:07,66,10285,22,44,8103.75,13198.00,0.00
2024-12-10 17:43:07,67,10285,22,45,7982.80,13198.01,0.00
2024-12-10 17:43:07,67,10286,22,45,7945.38,13199.00,0.00
2024-12-10 17:43:07,68,10286,22,46,7828.54,13199.01,0.00
2024-12-10 17:43:07,67,10286,21,46,7835.44,13199.27,0.00
2024-12-10 17:43:07,67,10287,21,46,7929.77,13200.00,0.00
2024-12-10 17:43:07,68,10287,22,46,7813.15,13200.01,0.00
2024-12-10 17:43:07,67,10287,22,45,7894.37,13200.22,0.00
2024-12-10 17:43:07,66,10287,21,45,7865.74,13200.94,0.00
2024-12-10 17:43:07,66,10288,21,45,8057.79,13201.00,0.00
2024-12-10 17:43:07,67,10288,21,46,7937.53,13201.01,0.00
2024-12-10 17:43:07,67,10289,21,46,7876.43,13202.00,0.00
2024-12-10 17:43:07,68,10289,22,46,7760.60,13202.01,0.00
2024-12-10 17:43:08,68,10290,22,46,7655.17,13203.00,0.00
2024-12-10 17:43:08,69,10290,23,46,7544.23,13203.01,0.00
2024-12-10 17:43:08,68,10290,23,45,7612.52,13203.25,0.00
2024-12-10 17:43:08,68,10291,23,45,7555.21,13204.00,0.00
2024-12-10 17:43:08,69,10291,24,45,7445.72,13204.01,0.00
2024-12-10 17:43:08,68,10291,24,44,7334.73,13204.72,0.00
2024-12-10 17:43:08,68,10292,24,44,7492.26,13205.00,0.00
2024-12-10 17:43:08,69,10292,24,45,7383.68,13205.01,0.00
2024-12-10 17:43:08,68,10292,24,44,7484.50,13205.06,0.00
2024-12-10 17:43:08,67,10292,23,44,7474.53,13205.31,0.00
2024-12-10 17:43:08,67,10293,23,44,7550.36,13206.00,0.00
2024-12-10 17:43:08,68,10293,23,45,7439.33,13206.01,0.00
2024-12-10 17:43:08,67,10293,22,45,7520.85,13206.22,0.00
2024-12-10 17:43:08,66,10293,22,44,7622.81,13206.24,0.00
2024-12-10 17:43:08,66,10294,22,44,7605.24,13207.00,0.00
2024-12-10 17:43:08,67,10294,23,44,7491.73,13207.01,0.00
2024-12-10 17:43:08,66,10294,22,44,7528.51,13207.29,0.00
2024-12-10 17:43:08,65,10294,21,44,7613.32,13207.37,0.00
2024-12-10 17:43:08,65,10295,21,44,7733.66,13208.00,0.00
2024-12-10 17:43:08,66,10295,22,44,7616.48,13208.02,0.00
2024-12-10 17:43:08,67,10294,22,45,7414.22,13208.42,0.00
2024-12-10 17:43:08,67,10295,22,45,7538.86,13209.00,0.00
2024-12-10 17:43:08,68,10295,23,45,7427.99,13209.01,0.00
2024-12-10 17:43:08,67,10295,22,45,7534.92,13209.04,0.00
2024-12-10 17:43:08,66,10295,22,44,7647.09,13209.05,0.00
2024-12-10 17:43:08,65,10295,22,43,7738.37,13209.22,0.00
2024-12-10 17:43:08,64,10295,21,43,7816.86,13209.53,0.00
2024-12-10 17:43:08,64,10295,21,43,8085.54,13210.00,0.00
2024-12-10 17:43:08,65,10295,21,44,7961.15,13210.02,0.00
2024-12-10 17:43:08,65,10296,21,44,7929.12,13211.00,0.00
2024-12-10 17:43:08,66,10296,22,44,7808.98,13211.02,0.00
2024-12-10 17:43:08,65,10296,21,44,7768.83,13211.45,0.00
2024-12-10 17:43:08,65,10297,21,44,7899.34,13212.00,0.00
2024-12-10 17:43:08,66,10297,22,44,7779.65,13212.02,0.00
2024-12-10 17:43:08,66,10298,22,44,7730.19,13213.00,0.00
2024-12-10 17:43:08,67,10298,23,44,7614.82,13213.01,0.00
2024-12-10 17:43:08,66,10298,23,43,7698.20,13213.17,0.00
2024-12-10 17:43:08,65,10298,23,42,7810.55,13213.20,0.00
2024-12-10 17:43:08,65,10299,23,42,7827.35,13214.00,0.00
2024-12-10 17:43:08,66,10299,24,42,7708.76,13214.02,0.00
2024-12-10 17:43:08,65,10299,23,42,7747.39,13214.31,0.00
2024-12-10 17:43:08,65,10300,23,42,7779.38,13215.00,0.00
2024-12-10 17:43:08,66,10300,23,43,7661.51,13215.02,0.00
2024-12-10 17:43:08,65,10300,23,42,7736.71,13215.17,0.00
2024-12-10 17:43:08,65,10301,23,42,7749.47,13216.00,0.00
2024-12-10 17:43:08,66,10301,24,42,7632.05,13216.02,0.00
2024-12-10 17:43:08,66,10302,24,42,7593.71,13217.00,0.00
2024-12-10 17:43:08,67,10302,25,42,7480.37,13217.01,0.00
2024-12-10 17:43:08,66,10302,25,41,7585.71,13217.06,0.00
2024-12-10 17:43:08,65,10302,25,40,7651.60,13217.17,0.00
2024-12-10 17:43:08,65,10303,25,40,7664.34,13218.00,0.00
2024-12-10 17:43:08,66,10303,25,41,7548.22,13218.02,0.00
2024-12-10 17:43:08,65,10303,24,41,7541.05,13218.22,0.00
2024-12-10 17:43:08,65,10304,24,41,7641.22,13219.00,0.00
2024-12-10 17:43:08,66,10304,25,41,7525.44,13219.02,0.00
2024-12-10 17:43:08,66,10305,25,41,7486.61,13220.00,0.00
2024-12-10 17:43:08,67,10305,26,41,7374.87,13220.01,0.00
2024-12-10 17:43:08,66,10305,26,40,7478.60,13220.06,0.00
2024-12-10 17:43:08,65,10305,25,40,7577.47,13220.17,0.00
2024-12-10 17:43:08,64,10305,25,39,7661.41,13220.17,0.00
2024-12-10 17:43:08,64,10306,25,39,7676.41,13221.00,0.00
2024-12-10 17:43:08,65,10306,26,39,7558.31,13221.02,0.00
2024-12-10 17:43:08,64,10306,26,38,7668.16,13221.06,0.00
2024-12-10 17:43:08,64,10307,26,38,7642.80,13222.00,0.00
2024-12-10 17:43:08,65,10307,27,38,7525.22,13222.02,0.00
2024-12-10 17:43:08,64,10307,27,37,7582.93,13222.16,0.00
2024-12-10 17:43:08,64,10308,27,37,7595.86,13223.00,0.00
2024-12-10 17:43:08,65,10308,27,38,7479.00,13223.02,0.00
2024-12-10 17:43:08,64,10308,26,38,7587.61,13223.06,0.00
2024-12-10 17:43:08,64,10309,26,38,7561.35,13224.00,0.00
2024-12-10 17:43:08,65,10309,26,39,7445.02,13224.02,0.00
2024-12-10 17:43:08,64,10309,25,39,7475.01,13224.11,0.00
2024-12-10 17:43:08,63,10309,25,38,7549.58,13224.13,0.00
2024-12-10 17:43:08,63,10310,25,38,7640.93,13225.00,0.00
2024-12-10 17:43:08,64,10310,25,39,7521.54,13225.02,0.00
2024-12-10 17:43:08,64,10311,25,39,7532.57,13226.00,0.00
2024-12-10 17:43:08,65,10311,26,39,7416.69,13226.02,0.00
2024-12-10 17:43:08,64,10311,26,38,7495.54,13226.11,0.00
2024-12-10 17:43:08,64,10312,26,38,7490.31,13227.00,0.00
2024-12-10 17:43:08,65,10312,26,39,7375.08,13227.02,0.00
2024-12-10 17:43:08,65,10313,26,39,7362.76,13228.00,0.00
2024-12-10 17:43:08,66,10313,27,39,7251.20,13228.02,0.00
2024-12-10 17:43:08,65,10313,26,39,7234.87,13228.68,0.00
2024-12-10 17:43:08,64,10313,25,39,7316.64,13228.69,0.00
2024-12-10 17:43:08,64,10314,25,39,7466.23,13229.00,0.00
2024-12-10 17:43:08,65,10314,26,39,7351.37,13229.02,0.00
2024-12-10 17:43:08,64,10314,26,38,7412.51,13229.11,0.00
2024-12-10 17:43:08,64,10315,26,38,7392.06,13230.00,0.00
2024-12-10 17:43:08,65,10315,26,39,7278.33,13230.02,0.00
2024-12-10 17:43:08,64,10315,25,39,7389.99,13230.02,0.00
2024-12-10 17:43:08,63,10315,24,39,7505.19,13230.02,0.00
2024-12-10 17:43:08,62,10315,23,39,7621.98,13230.03,0.00
2024-12-10 17:43:08,61,10315,22,39,7626.72,13230.61,0.00
2024-12-10 17:43:08,61,10316,22,39,7677.82,13231.00,0.00
2024-12-10 17:43:08,62,10316,23,39,7553.98,13231.02,0.00
2024-12-10 17:43:08,61,10316,23,38,7634.46,13231.07,0.00
2024-12-10 17:43:08,61,10317,23,38,7577.16,13232.00,0.00
2024-12-10 17:43:08,62,10317,23,39,7454.94,13232.02,0.00
2024-12-10 17:43:08,61,10317,22,39,7406.67,13232.77,0.00
2024-12-10 17:43:08,60,10317,22,38,7445.39,13232.87,0.00
2024-12-10 17:43:08,60,10318,22,38,7648.40,13233.00,0.00
2024-12-10 17:43:08,61,10318,22,39,7523.02,13233.02,0.00
2024-12-10 17:43:08,60,10318,22,38,7606.51,13233.07,0.00
2024-12-10 17:43:09,60,10319,22,38,7577.86,13234.00,0.00
2024-12-10 17:43:09,61,10319,23,38,7453.64,13234.02,0.00
2024-12-10 17:43:09,61,10320,23,38,7371.66,13235.00,0.00
2024-12-10 17:43:09,62,10320,24,38,7252.77,13235.02,0.00
2024-12-10 17:43:09,61,10320,24,37,7365.17,13235.05,0.00
2024-12-10 17:43:09,60,10320,24,36,7452.63,13235.05,0.00
2024-12-10 17:43:09,60,10321,24,36,7407.06,13236.00,0.00
2024-12-10 17:43:09,61,10321,25,36,7285.63,13236.02,0.00
2024-12-10 17:43:09,60,10321,24,36,7227.46,13236.77,0.00
2024-12-10 17:43:09,60,10322,24,36,7322.67,13237.00,0.00
2024-12-10 17:43:09,61,10322,25,36,7202.63,13237.02,0.00
2024-12-10 17:43:09,60,10322,25,35,7285.18,13237.05,0.00
2024-12-10 17:43:09,60,10323,25,35,7273.32,13238.00,0.00
2024-12-10 17:43:09,61,10323,25,36,7154.08,13238.02,0.00
2024-12-10 17:43:09,61,10324,25,36,7090.93,13239.00,0.00
2024-12-10 17:43:09,62,10324,25,37,6976.56,13239.02,0.00
2024-12-10 17:43:09,61,10324,25,36,7056.22,13239.05,0.00
2024-12-10 17:43:09,61,10325,25,36,7026.89,13240.00,0.00
2024-12-10 17:43:09,62,10325,26,36,6913.55,13240.02,0.00
2024-12-10 17:43:09,62,10326,26,36,6840.12,13241.00,0.00
2024-12-10 17:43:09,63,10326,27,36,6731.54,13241.02,0.00
2024-12-10 17:43:09,62,10326,27,35,6795.30,13241.10,0.00
2024-12-10 17:43:09,61,10326,27,34,6802.14,13241.74,0.00
2024-12-10 17:43:09,61,10327,27,34,6897.28,13242.00,0.00
2024-12-10 17:43:09,62,10327,28,34,6786.03,13242.02,0.00
2024-12-10 17:43:09,61,10327,27,34,6757.44,13242.43,0.00
2024-12-10 17:43:09,60,10327,26,34,6844.89,13242.62,0.00
2024-12-10 17:43:09,60,10328,26,34,7008.83,13243.00,0.00
2024-12-10 17:43:09,61,10328,26,35,6893.94,13243.02,0.00
2024-12-10 17:43:09,60,10328,26,34,6958.10,13243.12,0.00
2024-12-10 17:43:09,60,10329,26,34,6961.45,13244.00,0.00
2024-12-10 17:43:09,61,10329,27,34,6847.33,13244.02,0.00
2024-12-10 17:43:09,61,10330,27,34,6800.76,13245.00,0.00
2024-12-10 17:43:09,62,10330,28,34,6691.07,13245.02,0.00
2024-12-10 17:43:09,61,10330,27,34,6788.33,13245.10,0.00
2024-12-10 17:43:09,60,10330,27,33,6866.15,13245.10,0.00
2024-12-10 17:43:09,59,10330,26,33,6789.16,13245.97,0.00
2024-12-10 17:43:09,59,10331,26,33,7009.19,13246.00,0.00
2024-12-10 17:43:09,60,10331,27,33,6892.38,13246.02,0.00
2024-12-10 17:43:09,60,10332,27,33,6848.32,13247.00,0.00
2024-12-10 17:43:09,61,10332,27,34,6736.06,13247.02,0.00
2024-12-10 17:43:09,60,10332,27,33,6804.19,13247.10,0.00
2024-12-10 17:43:09,60,10333,27,33,6803.36,13248.00,0.00
2024-12-10 17:43:09,61,10333,27,34,6691.83,13248.02,0.00
2024-12-10 17:43:09,61,10334,27,34,6658.26,13249.00,0.00
2024-12-10 17:43:09,62,10334,27,35,6550.87,13249.02,0.00
2024-12-10 17:43:09,61,10334,27,34,6614.84,13249.10,0.00
2024-12-10 17:43:09,61,10335,27,34,6621.29,13250.00,0.00
2024-12-10 17:43:09,62,10335,27,35,6514.49,13250.02,0.00
2024-12-10 17:43:09,61,10335,26,35,6402.01,13250.93,0.00
2024-12-10 17:43:09,61,10336,26,35,6610.60,13251.00,0.00
2024-12-10 17:43:09,62,10336,26,36,6503.98,13251.02,0.00
2024-12-10 17:43:09,61,10336,26,35,6569.35,13251.10,0.00
2024-12-10 17:43:09,60,10336,25,35,6515.06,13251.60,0.00
2024-12-10 17:43:09,60,10337,25,35,6683.18,13252.00,0.00
2024-12-10 17:43:09,61,10337,26,35,6573.62,13252.02,0.00
2024-12-10 17:43:09,61,10338,26,35,6528.38,13253.00,0.00
2024-12-10 17:43:09,62,10338,26,36,6423.08,13253.02,0.00
2024-12-10 17:43:09,61,10338,26,35,6487.12,13253.10,0.00
2024-12-10 17:43:09,61,10339,26,35,6467.20,13254.00,0.00
2024-12-10 17:43:09,62,10339,27,35,6362.89,13254.02,0.00
2024-12-10 17:43:09,63,10338,27,36,6162.68,13254.43,0.00
2024-12-10 17:43:09,63,10339,27,36,6331.17,13255.00,0.00
2024-12-10 17:43:09,64,10339,28,36,6232.25,13255.02,0.00
2024-12-10 17:43:09,63,10339,28,35,6293.32,13255.10,0.00
2024-12-10 17:43:09,62,10339,27,35,6260.05,13255.65,0.00
2024-12-10 17:43:09,62,10340,27,35,6517.73,13256.00,0.00
2024-12-10 17:43:09,63,10340,28,35,6414.28,13256.02,0.00
2024-12-10 17:43:09,63,10341,28,35,6283.21,13257.00,0.00
2024-12-10 17:43:09,64,10341,28,36,6185.03,13257.02,0.00
2024-12-10 17:43:09,63,10341,28,35,6247.45,13257.10,0.00
2024-12-10 17:43:09,62,10341,27,35,6323.82,13257.23,0.00
2024-12-10 17:43:09,61,10341,26,35,6364.87,13257.36,0.00
2024-12-10 17:43:09,60,10341,25,35,6431.95,13257.65,0.00
2024-12-10 17:43:09,60,10342,25,35,6500.46,13258.00,0.00
2024-12-10 17:43:09,61,10342,25,36,6393.89,13258.02,0.00
2024-12-10 17:43:09,61,10343,25,36,6355.98,13259.00,0.00
2024-12-10 17:43:09,62,10343,25,37,6253.47,13259.02,0.00
2024-12-10 17:43:09,61,10343,25,36,6321.22,13259.10,0.00
2024-12-10 17:43:09,60,10343,24,36,6252.59,13259.97,0.00
2024-12-10 17:43:09,60,10344,24,36,6469.18,13260.00,0.00
2024-12-10 17:43:09,61,10344,25,36,6363.13,13260.02,0.00
2024-12-10 17:43:09,60,10344,24,36,6438.24,13260.02,0.00
2024-12-10 17:43:09,60,10345,24,36,6484.71,13261.00,0.00
2024-12-10 17:43:09,61,10345,24,37,6378.40,13261.02,0.00
2024-12-10 17:43:09,60,10345,24,36,6455.99,13261.08,0.00
2024-12-10 17:43:09,60,10346,24,36,6467.34,13262.00,0.00
2024-12-10 17:43:09,61,10346,25,36,6361.32,13262.02,0.00
2024-12-10 17:43:09,61,10347,25,36,6332.00,13263.00,0.00
2024-12-10 17:43:09,62,10347,26,36,6229.87,13263.02,0.00
2024-12-10 17:43:09,61,10347,26,35,6303.74,13263.08,0.00
2024-12-10 17:43:09,60,10347,25,35,6391.16,13263.22,0.00
2024-12-10 17:43:09,60,10348,25,35,6417.21,13264.00,0.00
2024-12-10 17:43:09,61,10348,26,35,6312.01,13264.02,0.00
2024-12-10 17:43:09,61,10349,26,35,6283.72,13265.00,0.00
2024-12-10 17:43:09,62,10349,26,36,6182.37,13265.02,0.00
2024-12-10 17:43:09,61,10349,26,35,6255.47,13265.10,0.00
2024-12-10 17:43:09,60,10349,26,34,6354.74,13265.13,0.00
2024-12-10 17:43:09,61,10348,27,34,6209.35,13265.48,0.00
2024-12-10 17:43:10,61,10349,27,34,6435.86,13266.00,0.00
2024-12-10 17:43:10,62,10349,27,35,6332.06,13266.02,0.00
2024-12-10 17:43:10,63,10348,28,35,6132.71,13266.48,0.00
2024-12-10 17:43:10,63,10349,28,35,6489.20,13267.00,0.00
2024-12-10 17:43:10,64,10349,29,35,6387.80,13267.02,0.00
2024-12-10 17:43:10,63,10349,29,34,6463.94,13267.10,0.00
2024-12-10 17:43:10,62,10349,28,34,6395.51,13267.92,0.00
2024-12-10 17:43:10,62,10350,28,34,6812.85,13268.00,0.00
2024-12-10 17:43:10,63,10350,28,35,6704.71,13268.02,0.00
2024-12-10 17:43:10,63,10351,28,35,6668.63,13269.00,0.00
2024-12-10 17:43:10,64,10351,29,35,6564.43,13269.02,0.00
2024-12-10 17:43:10,63,10351,29,34,6645.47,13269.10,0.00
2024-12-10 17:43:10,62,10351,28,34,6601.91,13269.90,0.00
2024-12-10 17:43:10,62,10352,28,34,6803.18,13270.00,0.00
2024-12-10 17:43:10,63,10352,29,34,6695.19,13270.02,0.00
2024-12-10 17:43:10,63,10353,29,34,6660.10,13271.00,0.00
2024-12-10 17:43:10,64,10353,30,34,6556.04,13271.02,0.00
2024-12-10 17:43:10,63,10353,30,33,6632.73,13271.10,0.00
2024-12-10 17:43:10,63,10354,30,33,6628.64,13272.00,0.00
2024-12-10 17:43:10,64,10354,30,34,6525.06,13272.02,0.00
2024-12-10 17:43:10,63,10354,29,34,6561.26,13272.21,0.00
2024-12-10 17:43:10,62,10354,28,34,6636.68,13272.34,0.00
2024-12-10 17:43:10,61,10354,27,34,6618.76,13272.93,0.00
2024-12-10 17:43:10,61,10355,27,34,6827.70,13273.00,0.00
2024-12-10 17:43:10,62,10355,27,35,6717.57,13273.02,0.00
2024-12-10 17:43:10,61,10355,26,35,6823.35,13273.03,0.00
2024-12-10 17:43:10,60,10355,26,34,6914.95,13273.08,0.00
2024-12-10 17:43:10,59,10355,25,34,7018.69,13273.19,0.00
2024-12-10 17:43:10,59,10356,25,34,7042.83,13274.00,0.00
2024-12-10 17:43:10,60,10356,26,34,6925.45,13274.02,0.00
2024-12-10 17:43:10,59,10356,26,33,7038.33,13274.03,0.00
2024-12-10 17:43:10,58,10356,25,33,6992.78,13274.48,0.00
2024-12-10 17:43:10,58,10357,25,33,7153.35,13275.00,0.00
2024-12-10 17:43:10,59,10357,26,33,7032.11,13275.02,0.00
2024-12-10 17:43:10,58,10357,26,32,7148.78,13275.03,0.00
2024-12-10 17:43:10,57,10357,26,31,7264.31,13275.05,0.00
2024-12-10 17:43:10,57,10358,26,31,7278.83,13276.00,0.00
2024-12-10 17:43:10,58,10358,26,32,7153.33,13276.02,0.00
2024-12-10 17:43:10,57,10358,25,32,7209.00,13276.18,0.00
2024-12-10 17:43:10,57,10359,25,32,7332.95,13277.00,0.00
2024-12-10 17:43:10,58,10359,26,32,7206.52,13277.02,0.00
2024-12-10 17:43:10,57,10359,26,31,7305.01,13277.07,0.00
2024-12-10 17:43:10,56,10359,25,31,7346.80,13277.34,0.00
2024-12-10 17:43:10,56,10360,25,31,7495.25,13278.00,0.00
2024-12-10 17:43:10,57,10360,26,31,7363.75,13278.02,0.00
2024-12-10 17:43:10,57,10361,26,31,7328.96,13279.00,0.00
2024-12-10 17:43:10,58,10361,26,32,7202.60,13279.02,0.00
2024-12-10 17:43:10,57,10361,26,31,7303.35,13279.07,0.00
2024-12-10 17:43:10,57,10362,26,31,7315.57,13280.00,0.00
2024-12-10 17:43:10,58,10362,26,32,7189.44,13280.02,0.00
2024-12-10 17:43:10,57,10362,25,32,7250.37,13280.16,0.00
2024-12-10 17:43:10,57,10363,25,32,7274.59,13281.00,0.00
2024-12-10 17:43:10,58,10363,25,33,7149.17,13281.02,0.00
2024-12-10 17:43:10,57,10363,25,32,7256.33,13281.07,0.00
2024-12-10 17:43:10,57,10364,25,32,7251.57,13282.00,0.00
2024-12-10 17:43:10,58,10364,25,33,7126.55,13282.02,0.00
2024-12-10 17:43:10,57,10364,24,33,7188.68,13282.14,0.00
2024-12-10 17:43:10,56,10364,23,33,7264.93,13282.27,0.00
2024-12-10 17:43:10,55,10364,22,33,7356.72,13282.49,0.00
2024-12-10 17:43:10,55,10365,22,33,7502.11,13283.00,0.00
2024-12-10 17:43:10,56,10365,23,33,7368.14,13283.02,0.00
2024-12-10 17:43:10,55,10365,23,32,7475.55,13283.07,0.00
2024-12-10 17:43:10,54,10365,22,32,7552.57,13283.26,0.00
2024-12-10 17:43:10,54,10366,22,32,7650.16,13284.00,0.00
2024-12-10 17:43:10,55,10366,23,32,7511.07,13284.02,0.00
2024-12-10 17:43:10,55,10367,23,32,7427.01,13285.00,0.00
2024-12-10 17:43:10,56,10367,23,33,7294.38,13285.02,0.00
2024-12-10 17:43:10,55,10367,23,32,7390.79,13285.09,0.00
2024-12-10 17:43:10,54,10367,22,32,7435.77,13285.33,0.00
2024-12-10 17:43:10,54,10367,22,32,7531.42,13286.00,0.00
2024-12-10 17:43:10,55,10367,23,32,7394.48,13286.02,0.00
2024-12-10 17:43:10,54,10367,22,32,7463.69,13286.15,0.00
2024-12-10 17:43:10,53,10367,21,32,7438.99,13286.62,0.00
2024-12-10 17:43:10,53,10368,21,32,7639.84,13287.00,0.00
2024-12-10 17:43:10,54,10368,22,32,7498.36,13287.02,0.00
2024-12-10 17:43:10,53,10368,22,31,7579.69,13287.11,0.00
2024-12-10 17:43:10,52,10368,22,30,7697.05,13287.33,0.00
2024-12-10 17:43:10,52,10369,22,30,7744.50,13288.00,0.00
2024-12-10 17:43:10,53,10369,23,30,7598.38,13288.02,0.00
2024-12-10 17:43:10,53,10370,23,30,7567.18,13289.00,0.00
2024-12-10 17:43:10,54,10370,24,30,7427.05,13289.02,0.00
2024-12-10 17:43:10,53,10370,23,30,7564.68,13289.02,0.00
2024-12-10 17:43:10,52,10370,23,29,7651.39,13289.10,0.00
2024-12-10 17:43:10,52,10371,23,29,7656.87,13290.00,0.00
2024-12-10 17:43:10,53,10371,24,29,7512.40,13290.02,0.00
2024-12-10 17:43:10,54,10370,24,30,7365.91,13290.11,0.00
2024-12-10 17:43:10,54,10371,24,30,7528.17,13291.00,0.00
2024-12-10 17:43:10,55,10371,24,31,7391.29,13291.02,0.00
2024-12-10 17:43:10,54,10371,24,30,7525.71,13291.02,0.00
2024-12-10 17:43:10,53,10371,23,30,7364.90,13291.91,0.00
2024-12-10 17:43:10,53,10372,23,30,7853.99,13292.00,0.00
2024-12-10 17:43:10,54,10372,23,31,7708.55,13292.02,0.00
2024-12-10 17:43:10,53,10372,23,30,7838.99,13292.11,0.00
2024-12-10 17:43:10,52,10372,22,30,7956.50,13292.37,0.00
2024-12-10 17:43:10,51,10372,21,30,7992.69,13292.84,0.00
2024-12-10 17:43:10,51,10373,21,30,8232.61,13293.00,0.00
2024-12-10 17:43:10,52,10373,22,30,8074.29,13293.02,0.00
2024-12-10 17:43:10,52,10374,22,30,8059.85,13294.00,0.00
2024-12-10 17:43:10,53,10374,23,30,7907.77,13294.02,0.00
2024-12-10 17:43:10,52,10374,23,29,7995.98,13294.12,0.00
2024-12-10 17:43:10,52,10375,23,29,8030.90,13295.00,0.00
2024-12-10 17:43:10,53,10375,23,30,7879.38,13295.02,0.00
2024-12-10 17:43:10,53,10376,23,30,7865.44,13296.00,0.00
2024-12-10 17:43:10,54,10376,24,30,7719.79,13296.02,0.00
2024-12-10 17:43:10,53,10376,23,30,7619.74,13296.89,0.00
2024-12-10 17:43:10,53,10377,23,30,7855.66,13297.00,0.00
2024-12-10 17:43:11,54,10377,23,31,7710.18,13297.02,0.00
2024-12-10 17:43:11,54,10378,23,31,7670.78,13298.00,0.00
2024-12-10 17:43:11,55,10378,23,32,7531.31,13298.02,0.00
2024-12-10 17:43:11,54,10378,23,31,7628.95,13298.09,0.00
2024-12-10 17:43:11,53,10378,23,30,7770.38,13298.09,0.00
2024-12-10 17:43:11,52,10378,23,29,7880.63,13298.29,0.00
2024-12-10 17:43:11,52,10379,23,29,7938.23,13299.00,0.00
2024-12-10 17:43:11,53,10379,24,29,7788.46,13299.02,0.00
2024-12-10 17:43:11,53,10380,24,29,7776.31,13300.00,0.00
2024-12-10 17:43:11,54,10380,24,30,7632.30,13300.02,0.00
2024-12-10 17:43:11,53,10380,24,29,7716.12,13300.09,0.00
2024-12-10 17:43:11,53,10381,24,29,7746.78,13301.00,0.00
2024-12-10 17:43:11,54,10381,24,30,7603.32,13301.02,0.00
2024-12-10 17:43:11,53,10381,23,30,7596.34,13301.36,0.00
2024-12-10 17:43:11,53,10382,23,30,7762.42,13302.00,0.00
2024-12-10 17:43:11,54,10382,24,30,7618.67,13302.02,0.00
2024-12-10 17:43:11,54,10383,24,30,7585.93,13303.00,0.00
2024-12-10 17:43:11,55,10383,24,31,7448.00,13303.02,0.00
2024-12-10 17:43:11,54,10383,23,31,7583.46,13303.02,0.00
2024-12-10 17:43:11,53,10383,23,30,7714.04,13303.09,0.00
2024-12-10 17:43:11,53,10384,23,30,7725.55,13304.00,0.00
2024-12-10 17:43:11,54,10384,24,30,7582.49,13304.02,0.00
2024-12-10 17:43:11,53,10384,23,30,7622.71,13304.21,0.00
2024-12-10 17:43:11,53,10385,23,30,7727.06,13305.00,0.00
2024-12-10 17:43:11,54,10385,24,30,7583.96,13305.02,0.00
2024-12-10 17:43:11,53,10385,23,30,7539.30,13305.55,0.00
2024-12-10 17:43:11,53,10386,23,30,7630.00,13306.00,0.00
2024-12-10 17:43:11,54,10386,24,30,7488.70,13306.02,0.00
2024-12-10 17:43:11,53,10386,24,29,7612.46,13306.11,0.00
2024-12-10 17:43:11,52,10386,23,29,7704.58,13306.33,0.00
2024-12-10 17:43:11,52,10387,23,29,7768.99,13307.00,0.00
2024-12-10 17:43:11,53,10387,24,29,7622.41,13307.02,0.00
2024-12-10 17:43:11,53,10388,24,29,7616.94,13308.00,0.00
2024-12-10 17:43:11,54,10388,25,29,7475.89,13308.02,0.00
2024-12-10 17:43:11,54,10389,25,29,7444.41,13309.00,0.00
2024-12-10 17:43:11,55,10389,26,29,7309.06,13309.02,0.00
2024-12-10 17:43:11,54,10389,26,28,7424.73,13309.13,0.00
2024-12-10 17:43:11,54,10390,26,28,7457.29,13310.00,0.00
2024-12-10 17:43:11,55,10390,27,28,7321.71,13310.02,0.00
2024-12-10 17:43:11,55,10391,27,28,7312.20,13311.00,0.00
2024-12-10 17:43:11,56,10391,27,29,7181.62,13311.02,0.00
2024-12-10 17:43:11,55,10391,27,28,7246.89,13311.13,0.00
2024-12-10 17:43:11,55,10392,27,28,7276.44,13312.00,0.00
2024-12-10 17:43:11,56,10392,27,29,7146.50,13312.02,0.00
2024-12-10 17:43:11,55,10392,26,29,7054.61,13312.89,0.00
2024-12-10 17:43:11,55,10393,26,29,7282.21,13313.00,0.00
2024-12-10 17:43:11,56,10393,26,30,7152.17,13313.02,0.00
2024-12-10 17:43:11,55,10393,25,30,7279.79,13313.02,0.00
2024-12-10 17:43:11,54,10393,25,29,7350.53,13313.11,0.00
2024-12-10 17:43:11,54,10394,25,29,7380.64,13314.00,0.00
2024-12-10 17:43:11,55,10394,25,30,7246.44,13314.02,0.00
2024-12-10 17:43:11,54,10394,24,30,7372.45,13314.07,0.00
2024-12-10 17:43:11,54,10395,24,30,7378.54,13315.00,0.00
2024-12-10 17:43:11,55,10395,24,31,7244.39,13315.02,0.00
2024-12-10 17:43:11,54,10395,23,31,7153.79,13315.87,0.00
2024-12-10 17:43:11,54,10396,23,31,7383.21,13316.00,0.00
2024-12-10 17:43:11,55,10396,24,31,7248.97,13316.02,0.00
2024-12-10 17:43:11,54,10396,24,30,7368.45,13316.09,0.00
2024-12-10 17:43:11,54,10397,24,30,7396.04,13317.00,0.00
2024-12-10 17:43:11,55,10397,24,31,7261.56,13317.02,0.00
2024-12-10 17:43:11,55,10398,24,31,7250.33,13318.00,0.00
2024-12-10 17:43:11,56,10398,24,32,7120.86,13318.02,0.00
2024-12-10 17:43:11,55,10398,24,31,7189.82,13318.09,0.00
2024-12-10 17:43:11,54,10398,23,31,7158.34,13318.83,0.00
2024-12-10 17:43:11,54,10399,23,31,7382.92,13319.00,0.00
2024-12-10 17:43:11,55,10399,24,31,7248.69,13319.02,0.00
2024-12-10 17:43:11,54,10399,23,31,7225.25,13319.65,0.00
2024-12-10 17:43:11,54,10400,23,31,7352.61,13320.00,0.00
2024-12-10 17:43:11,55,10400,23,32,7218.93,13320.02,0.00
2024-12-10 17:43:11,54,10400,23,31,7293.44,13320.09,0.00
2024-12-10 17:43:11,53,10400,22,31,7248.74,13320.83,0.00
2024-12-10 17:43:11,53,10401,22,31,7477.60,13321.00,0.00
2024-12-10 17:43:11,54,10401,22,32,7339.13,13321.02,0.00
2024-12-10 17:43:11,53,10401,21,32,7467.58,13321.09,0.00
2024-12-10 17:43:11,52,10401,20,32,7499.85,13321.48,0.00
2024-12-10 17:43:11,52,10402,20,32,7687.24,13322.00,0.00
2024-12-10 17:43:11,53,10402,20,33,7542.20,13322.02,0.00
2024-12-10 17:43:11,52,10402,20,32,7625.79,13322.10,0.00
2024-12-10 17:43:11,51,10402,19,32,7720.52,13322.25,0.00
2024-12-10 17:43:11,51,10403,19,32,7869.08,13323.00,0.00
2024-12-10 17:43:11,52,10403,20,32,7717.75,13323.02,0.00
2024-12-10 17:43:11,51,10403,19,32,7775.09,13323.18,0.00
2024-12-10 17:43:11,51,10404,19,32,7908.03,13324.00,0.00
2024-12-10 17:43:11,52,10404,19,33,7755.95,13324.02,0.00
2024-12-10 17:43:11,52,10405,19,33,7707.05,13325.00,0.00
2024-12-10 17:43:11,53,10405,19,34,7561.63,13325.02,0.00
2024-12-10 17:43:11,52,10405,19,33,7694.26,13325.10,0.00
2024-12-10 17:43:11,51,10405,18,33,7788.50,13325.39,0.00
2024-12-10 17:43:11,50,10405,17,33,7907.13,13325.68,0.00
2024-12-10 17:43:11,50,10406,17,33,8024.66,13326.00,0.00
2024-12-10 17:43:11,51,10406,18,33,7867.31,13326.02,0.00
2024-12-10 17:43:11,50,10406,17,33,7875.54,13326.36,0.00
2024-12-10 17:43:11,50,10407,17,33,8057.24,13327.00,0.00
2024-12-10 17:43:11,51,10407,18,33,7899.26,13327.02,0.00
2024-12-10 17:43:11,50,10407,18,32,7993.30,13327.10,0.00
2024-12-10 17:43:11,50,10408,18,32,8033.86,13328.00,0.00
2024-12-10 17:43:11,51,10408,18,33,7876.33,13328.02,0.00
2024-12-10 17:43:11,51,10409,18,33,7875.69,13329.00,0.00
2024-12-10 17:43:11,52,10409,18,34,7724.23,13329.02,0.00
2024-12-10 17:43:11,51,10409,17,34,7712.57,13329.65,0.00
2024-12-10 17:43:12,51,10410,17,34,7927.17,13330.00,0.00
2024-12-10 17:43:12,52,10410,18,34,7774.73,13330.02,0.00
2024-12-10 17:43:12,51,10410,18,33,7901.08,13330.16,0.00
2024-12-10 17:43:12,51,10411,18,33,7946.07,13331.00,0.00
2024-12-10 17:43:12,52,10411,18,34,7793.26,13331.02,0.00
2024-12-10 17:43:12,52,10412,18,34,7788.32,13332.00,0.00
2024-12-10 17:43:12,53,10412,19,34,7641.37,13332.02,0.00
2024-12-10 17:43:12,52,10412,18,34,7757.57,13332.06,0.00
2024-12-10 17:43:12,52,10413,18,34,7837.62,13333.00,0.00
2024-12-10 17:43:12,53,10413,19,34,7689.74,13333.02,0.00
2024-12-10 17:43:12,52,10413,19,33,7788.93,13333.08,0.00
2024-12-10 17:43:12,52,10414,19,33,7820.26,13334.00,0.00
2024-12-10 17:43:12,53,10414,20,33,7672.71,13334.02,0.00
2024-12-10 17:43:12,52,10414,20,32,7756.18,13334.12,0.00
2024-12-10 17:43:12,51,10414,19,32,7752.24,13334.86,0.00
2024-12-10 17:43:12,51,10415,19,32,7995.52,13335.00,0.00
2024-12-10 17:43:12,52,10415,20,32,7841.76,13335.02,0.00
2024-12-10 17:43:12,52,10416,20,32,7834.61,13336.00,0.00
2024-12-10 17:43:12,53,10416,21,32,7686.79,13336.02,0.00
2024-12-10 17:43:12,52,10416,21,31,7765.40,13336.13,0.00
2024-12-10 17:43:12,51,10416,20,31,7818.43,13336.35,0.00
2024-12-10 17:43:12,51,10417,20,31,7994.10,13337.00,0.00
2024-12-10 17:43:12,52,10417,20,32,7840.37,13337.02,0.00
2024-12-10 17:43:12,51,10417,19,32,7970.15,13337.14,0.00
2024-12-10 17:43:12,51,10418,19,32,8064.87,13338.00,0.00
2024-12-10 17:43:12,52,10418,20,32,7909.77,13338.02,0.00
2024-12-10 17:43:12,52,10419,20,32,7882.15,13339.00,0.00
2024-12-10 17:43:12,53,10419,21,32,7733.43,13339.02,0.00
2024-12-10 17:43:12,52,10419,20,32,7872.95,13339.08,0.00
2024-12-10 17:43:12,51,10419,20,31,8019.48,13339.12,0.00
2024-12-10 17:43:12,51,10420,20,31,8059.29,13340.00,0.00
2024-12-10 17:43:12,52,10420,21,31,7904.30,13340.02,0.00
2024-12-10 17:43:12,52,10421,21,31,7894.45,13341.00,0.00
2024-12-10 17:43:12,53,10421,21,32,7745.50,13341.02,0.00
2024-12-10 17:43:12,52,10421,21,31,7830.34,13341.12,0.00
2024-12-10 17:43:12,51,10421,20,31,7934.38,13341.18,0.00
2024-12-10 17:43:12,51,10422,20,31,8086.66,13342.00,0.00
2024-12-10 17:43:12,52,10422,20,32,7931.15,13342.02,0.00
2024-12-10 17:43:12,52,10423,20,32,7921.85,13343.00,0.00
2024-12-10 17:43:12,53,10423,21,32,7772.38,13343.02,0.00
2024-12-10 17:43:12,52,10423,21,31,7855.17,13343.13,0.00
2024-12-10 17:43:12,51,10423,20,31,7938.84,13343.65,0.00
2024-12-10 17:43:12,51,10424,20,31,8049.01,13344.00,0.00
2024-12-10 17:43:12,52,10424,20,32,7894.22,13344.02,0.00
2024-12-10 17:43:12,51,10424,19,32,7902.61,13344.35,0.00
2024-12-10 17:43:12,51,10425,19,32,8078.39,13345.00,0.00
2024-12-10 17:43:12,52,10425,19,33,7923.04,13345.02,0.00
2024-12-10 17:43:12,51,10425,19,32,8007.77,13345.14,0.00
2024-12-10 17:43:12,51,10426,19,32,8050.21,13346.00,0.00
2024-12-10 17:43:12,52,10426,19,33,7895.40,13346.02,0.00
2024-12-10 17:43:12,52,10427,19,33,7895.81,13347.00,0.00
2024-12-10 17:43:12,53,10427,19,34,7746.83,13347.02,0.00
2024-12-10 17:43:12,53,10428,19,34,7717.19,13348.00,0.00
2024-12-10 17:43:12,54,10428,20,34,7574.28,13348.02,0.00
2024-12-10 17:43:12,53,10428,20,33,7689.52,13348.15,0.00
2024-12-10 17:43:12,52,10428,19,33,7707.04,13348.77,0.00
2024-12-10 17:43:12,52,10429,19,33,7933.12,13349.00,0.00
2024-12-10 17:43:12,53,10429,19,34,7783.43,13349.02,0.00
2024-12-10 17:43:12,52,10429,19,33,7925.43,13349.06,0.00
2024-12-10 17:43:12,52,10430,19,33,7929.57,13350.00,0.00
2024-12-10 17:43:12,53,10430,20,33,7779.95,13350.02,0.00
2024-12-10 17:43:12,54,10429,21,33,7633.42,13350.07,0.00
2024-12-10 17:43:12,54,10430,21,33,7814.47,13351.00,0.00
2024-12-10 17:43:12,55,10430,22,33,7672.39,13351.02,0.00
2024-12-10 17:43:12,54,10430,22,32,7794.73,13351.13,0.00
2024-12-10 17:43:12,53,10430,21,32,7761.67,13351.94,0.00
2024-12-10 17:43:12,53,10431,21,32,8257.98,13352.00,0.00
2024-12-10 17:43:12,54,10431,22,32,8105.05,13352.02,0.00
2024-12-10 17:43:12,54,10432,22,32,8092.54,13353.00,0.00
2024-12-10 17:43:12,55,10432,23,32,7945.40,13353.02,0.00
2024-12-10 17:43:12,55,10433,23,32,7908.54,13354.00,0.00
2024-12-10 17:43:12,56,10433,24,32,7767.32,13354.02,0.00
2024-12-10 17:43:12,55,10433,23,32,7894.01,13354.13,0.00
2024-12-10 17:43:12,54,10433,23,31,8035.25,13354.13,0.00
2024-12-10 17:43:12,54,10434,23,31,8063.08,13355.00,0.00
2024-12-10 17:43:12,55,10434,23,32,7916.48,13355.02,0.00
2024-12-10 17:43:12,55,10435,23,32,7897.32,13356.00,0.00
2024-12-10 17:43:12,56,10435,23,33,7756.29,13356.02,0.00
2024-12-10 17:43:12,55,10435,22,33,7752.14,13356.65,0.00
2024-12-10 17:43:12,55,10436,22,33,7851.97,13357.00,0.00
2024-12-10 17:43:12,56,10436,23,33,7711.75,13357.02,0.00
2024-12-10 17:43:12,55,10436,23,32,7835.01,13357.13,0.00
2024-12-10 17:43:12,54,10436,22,32,7813.31,13357.87,0.00
2024-12-10 17:43:12,54,10437,22,32,8043.46,13358.00,0.00
2024-12-10 17:43:12,55,10437,23,32,7897.21,13358.02,0.00
2024-12-10 17:43:12,55,10438,23,32,7865.23,13359.00,0.00
2024-12-10 17:43:12,56,10438,23,33,7724.78,13359.02,0.00
2024-12-10 17:43:12,55,10438,23,32,7802.12,13359.13,0.00
2024-12-10 17:43:12,55,10439,23,32,7813.31,13360.00,0.00
2024-12-10 17:43:12,56,10439,23,33,7673.79,13360.02,0.00
2024-12-10 17:43:12,55,10439,22,33,7798.77,13360.13,0.00
2024-12-10 17:43:12,55,10440,22,33,7779.51,13361.00,0.00
2024-12-10 17:43:12,56,10440,23,33,7640.59,13361.02,0.00
2024-12-10 17:43:12,55,10440,23,32,7716.39,13361.13,0.00
2024-12-10 17:43:12,54,10440,23,31,7854.04,13361.13,0.00
2024-12-10 17:43:12,54,10441,23,31,7886.76,13362.00,0.00
2024-12-10 17:43:12,55,10441,23,32,7743.37,13362.02,0.00
2024-12-10 17:43:12,54,10441,22,32,7768.07,13362.26,0.00
2024-12-10 17:43:13,54,10442,22,32,7917.05,13363.00,0.00
2024-12-10 17:43:13,55,10442,22,33,7773.10,13363.02,0.00
2024-12-10 17:43:13,54,10442,22,32,7850.26,13363.13,0.00
2024-12-10 17:43:13,54,10443,22,32,7882.99,13364.00,0.00
2024-12-10 17:43:13,55,10443,22,33,7739.67,13364.02,0.00
2024-12-10 17:43:13,55,10444,22,33,7737.57,13365.00,0.00
2024-12-10 17:43:13,56,10444,23,33,7599.40,13365.02,0.00
2024-12-10 17:43:13,55,10444,22,33,7538.73,13365.44,0.00
2024-12-10 17:43:13,55,10445,22,33,7706.80,13366.00,0.00
2024-12-10 17:43:13,56,10445,23,33,7569.18,13366.02,0.00
2024-12-10 17:43:13,55,10445,22,33,7689.82,13366.13,0.00
2024-12-10 17:43:13,54,10445,22,32,7817.37,13366.13,0.00
2024-12-10 17:43:13,54,10446,22,32,7850.11,13367.00,0.00
2024-12-10 17:43:13,55,10446,23,32,7707.38,13367.02,0.00
2024-12-10 17:43:13,54,10446,22,32,7663.29,13367.52,0.00
2024-12-10 17:43:13,54,10447,22,32,7846.83,13368.00,0.00
2024-12-10 17:43:13,55,10447,23,32,7704.16,13368.02,0.00
2024-12-10 17:43:13,55,10448,23,32,7670.71,13369.00,0.00
2024-12-10 17:43:13,56,10448,24,32,7533.73,13369.02,0.00
2024-12-10 17:43:13,55,10448,24,31,7646.42,13369.13,0.00
2024-12-10 17:43:13,55,10449,24,31,7676.14,13370.00,0.00
2024-12-10 17:43:13,56,10449,25,31,7539.07,13370.02,0.00
2024-12-10 17:43:13,56,10450,25,31,7530.29,13371.00,0.00
2024-12-10 17:43:13,57,10450,25,32,7398.18,13371.02,0.00
2024-12-10 17:43:13,56,10450,24,32,7523.14,13371.05,0.00
2024-12-10 17:43:13,56,10451,24,32,7492.65,13372.00,0.00
2024-12-10 17:43:13,57,10451,25,32,7361.20,13372.02,0.00
2024-12-10 17:43:13,56,10451,24,32,7486.14,13372.05,0.00
2024-12-10 17:43:13,55,10451,24,31,7612.54,13372.09,0.00
2024-12-10 17:43:13,55,10452,24,31,7637.40,13373.00,0.00
2024-12-10 17:43:13,56,10452,25,31,7501.01,13373.02,0.00
2024-12-10 17:43:13,55,10452,24,31,7528.93,13373.38,0.00
2024-12-10 17:43:13,55,10453,24,31,7687.79,13374.00,0.00
2024-12-10 17:43:13,56,10453,25,31,7550.51,13374.02,0.00
2024-12-10 17:43:13,55,10453,25,30,7627.02,13374.09,0.00
2024-12-10 17:43:13,55,10454,25,30,7647.40,13375.00,0.00
2024-12-10 17:43:13,56,10454,26,30,7510.84,13375.02,0.00
2024-12-10 17:43:13,55,10454,25,30,7447.21,13375.87,0.00
2024-12-10 17:43:13,55,10455,25,30,7673.47,13376.00,0.00
2024-12-10 17:43:13,56,10455,26,30,7536.44,13376.02,0.00
2024-12-10 17:43:13,55,10455,26,29,7615.12,13376.09,0.00
2024-12-10 17:43:13,55,10456,26,29,7631.81,13377.00,0.00
2024-12-10 17:43:13,56,10456,26,30,7495.52,13377.02,0.00
2024-12-10 17:43:13,55,10456,25,30,7527.30,13377.24,0.00
2024-12-10 17:43:13,55,10457,25,30,7658.10,13378.00,0.00
2024-12-10 17:43:13,56,10457,25,31,7521.35,13378.02,0.00
2024-12-10 17:43:13,55,10457,25,30,7599.74,13378.09,0.00
2024-12-10 17:43:13,55,10458,25,30,7610.65,13379.00,0.00
2024-12-10 17:43:13,56,10458,26,30,7474.75,13379.02,0.00
2024-12-10 17:43:13,55,10458,25,30,7547.43,13379.11,0.00
2024-12-10 17:43:13,55,10459,25,30,7578.38,13380.00,0.00
2024-12-10 17:43:13,56,10459,25,31,7443.06,13380.02,0.00
2024-12-10 17:43:13,55,10459,25,30,7522.45,13380.09,0.00
2024-12-10 17:43:13,54,10459,24,30,7586.03,13380.50,0.00
2024-12-10 17:43:13,54,10460,24,30,7668.14,13381.00,0.00
2024-12-10 17:43:13,55,10460,24,31,7528.72,13381.02,0.00
2024-12-10 17:43:13,54,10460,24,30,7660.72,13381.06,0.00
2024-12-10 17:43:13,54,10461,24,30,7630.74,13382.00,0.00
2024-12-10 17:43:13,55,10461,24,31,7492.00,13382.02,0.00
2024-12-10 17:43:13,54,10461,24,30,7576.24,13382.07,0.00
2024-12-10 17:43:13,54,10462,24,30,7577.33,13383.00,0.00
2024-12-10 17:43:13,55,10462,25,30,7439.56,13383.02,0.00
2024-12-10 17:43:13,54,10462,25,29,7378.71,13383.37,0.00
2024-12-10 17:43:13,54,10463,25,29,7542.70,13384.00,0.00
2024-12-10 17:43:13,55,10463,26,29,7405.56,13384.02,0.00
2024-12-10 17:43:13,54,10463,26,28,7490.67,13384.07,0.00
2024-12-10 17:43:13,54,10464,26,28,7516.00,13385.00,0.00
2024-12-10 17:43:13,55,10464,27,28,7379.34,13385.02,0.00
2024-12-10 17:43:13,54,10464,26,28,7424.34,13385.19,0.00
2024-12-10 17:43:13,54,10465,26,28,7563.66,13386.00,0.00
2024-12-10 17:43:13,55,10465,26,29,7426.14,13386.02,0.00
2024-12-10 17:43:13,54,10465,26,28,7514.10,13386.07,0.00
2024-12-10 17:43:13,54,10466,26,28,7539.44,13387.00,0.00
2024-12-10 17:43:13,55,10466,26,29,7402.35,13387.02,0.00
2024-12-10 17:43:13,55,10467,26,29,7387.25,13388.00,0.00
2024-12-10 17:43:13,56,10467,27,29,7255.33,13388.02,0.00
2024-12-10 17:43:13,55,10467,27,28,7338.58,13388.07,0.00
2024-12-10 17:43:13,54,10467,26,28,7389.05,13388.61,0.00
2024-12-10 17:43:13,54,10468,26,28,7585.19,13389.00,0.00
2024-12-10 17:43:13,55,10468,26,29,7447.28,13389.02,0.00
2024-12-10 17:43:13,55,10469,26,29,7430.87,13390.00,0.00
2024-12-10 17:43:13,56,10469,26,30,7298.18,13390.02,0.00
2024-12-10 17:43:13,55,10469,26,29,7428.44,13390.02,0.00
2024-12-10 17:43:13,54,10469,26,28,7562.52,13390.04,0.00
2024-12-10 17:43:13,53,10469,26,27,7664.78,13390.04,0.00
2024-12-10 17:43:13,52,10469,25,27,7730.09,13390.63,0.00
2024-12-10 17:43:13,52,10470,25,27,7835.93,13391.00,0.00
2024-12-10 17:43:13,53,10470,25,28,7688.08,13391.02,0.00
2024-12-10 17:43:13,52,10470,24,28,7666.93,13391.67,0.00
2024-12-10 17:43:13,52,10471,24,28,7880.93,13392.00,0.00
2024-12-10 17:43:13,53,10471,24,29,7732.23,13392.02,0.00
2024-12-10 17:43:13,52,10471,24,28,7834.58,13392.04,0.00
2024-12-10 17:43:13,51,10471,23,28,7804.84,13392.94,0.00
2024-12-10 17:43:13,51,10472,23,28,8059.61,13393.00,0.00
2024-12-10 17:43:13,52,10472,24,28,7904.61,13393.02,0.00
2024-12-10 17:43:13,52,10473,24,28,7885.91,13394.00,0.00
2024-12-10 17:43:13,53,10473,25,28,7737.12,13394.02,0.00
2024-12-10 17:43:13,52,10473,25,27,7842.13,13394.04,0.00
2024-12-10 17:43:13,52,10474,25,27,7868.47,13395.00,0.00
2024-12-10 17:43:13,53,10474,25,28,7720.00,13395.02,0.00
2024-12-10 17:43:13,52,10474,24,28,7747.38,13395.54,0.00
2024-12-10 17:43:14,52,10475,24,28,7854.03,13396.00,0.00
2024-12-10 17:43:14,53,10475,25,28,7705.84,13396.02,0.00
2024-12-10 17:43:14,52,10475,25,27,7810.24,13396.04,0.00
2024-12-10 17:43:14,52,10476,25,27,7836.58,13397.00,0.00
2024-12-10 17:43:14,53,10476,25,28,7688.72,13397.02,0.00
2024-12-10 17:43:14,53,10477,25,28,7679.47,13398.00,0.00
2024-12-10 17:43:14,54,10477,26,28,7537.25,13398.02,0.00
2024-12-10 17:43:14,53,10477,26,27,7623.86,13398.06,0.00
2024-12-10 17:43:14,52,10477,25,27,7723.83,13398.13,0.00
2024-12-10 17:43:14,52,10478,25,27,7866.09,13399.00,0.00
2024-12-10 17:43:14,53,10478,26,27,7717.67,13399.02,0.00
2024-12-10 17:43:14,53,10479,26,27,7712.54,13400.00,0.00
2024-12-10 17:43:14,54,10479,26,28,7569.72,13400.02,0.00
2024-12-10 17:43:14,53,10479,25,28,7585.10,13400.58,0.00
2024-12-10 17:43:14,53,10480,25,28,7681.49,13401.00,0.00
2024-12-10 17:43:14,54,10480,26,28,7539.24,13401.02,0.00
2024-12-10 17:43:14,53,10480,26,27,7668.86,13401.09,0.00
2024-12-10 17:43:14,53,10481,26,27,7699.77,13402.00,0.00
2024-12-10 17:43:14,54,10481,27,27,7557.18,13402.02,0.00
2024-12-10 17:43:14,53,10481,26,27,7696.77,13402.04,0.00
2024-12-10 17:43:14,52,10481,25,27,7744.32,13402.19,0.00
2024-12-10 17:43:14,52,10482,25,27,7894.33,13403.00,0.00
2024-12-10 17:43:14,53,10482,26,27,7745.38,13403.02,0.00
2024-12-10 17:43:14,52,10482,26,26,7835.06,13403.08,0.00
2024-12-10 17:43:14,52,10483,26,26,7866.56,13404.00,0.00
2024-12-10 17:43:14,53,10483,26,27,7718.14,13404.02,0.00
2024-12-10 17:43:14,52,10483,25,27,7668.30,13404.50,0.00
2024-12-10 17:43:14,52,10484,25,27,7859.42,13405.00,0.00
2024-12-10 17:43:14,53,10484,26,27,7711.13,13405.02,0.00
2024-12-10 17:43:14,52,10484,26,26,7800.14,13405.08,0.00
2024-12-10 17:43:14,52,10485,26,26,7831.65,13406.00,0.00
2024-12-10 17:43:14,53,10485,26,27,7683.88,13406.02,0.00
2024-12-10 17:43:14,53,10486,26,27,7676.04,13407.00,0.00
2024-12-10 17:43:14,54,10486,27,27,7533.89,13407.02,0.00
2024-12-10 17:43:14,53,10486,26,27,7671.77,13407.04,0.00
2024-12-10 17:43:14,52,10486,26,26,7765.16,13407.06,0.00
2024-12-10 17:43:14,51,10486,25,26,7826.34,13407.27,0.00
2024-12-10 17:43:14,51,10487,25,26,7992.46,13408.00,0.00
2024-12-10 17:43:14,52,10487,26,26,7838.76,13408.02,0.00
2024-12-10 17:43:14,52,10488,26,26,7829.60,13409.00,0.00
2024-12-10 17:43:14,53,10488,26,27,7681.87,13409.02,0.00
2024-12-10 17:43:14,52,10488,26,26,7775.46,13409.06,0.00
2024-12-10 17:43:14,52,10489,26,26,7804.40,13410.00,0.00
2024-12-10 17:43:14,53,10489,27,26,7657.14,13410.02,0.00
2024-12-10 17:43:14,52,10489,26,26,7799.91,13410.04,0.00
2024-12-10 17:43:14,52,10490,26,26,7795.48,13411.00,0.00
2024-12-10 17:43:14,53,10490,26,27,7648.40,13411.02,0.00
2024-12-10 17:43:14,52,10490,26,26,7743.91,13411.04,0.00
2024-12-10 17:43:14,52,10491,26,26,7770.27,13412.00,0.00
2024-12-10 17:43:14,53,10491,26,27,7623.66,13412.02,0.00
2024-12-10 17:43:14,53,10492,26,27,7621.32,13413.00,0.00
2024-12-10 17:43:14,54,10492,26,28,7480.18,13413.02,0.00
2024-12-10 17:43:14,54,10493,26,28,7448.45,13414.00,0.00
2024-12-10 17:43:14,55,10493,26,29,7313.02,13414.02,0.00
2024-12-10 17:43:14,54,10493,25,29,7443.49,13414.06,0.00
2024-12-10 17:43:14,53,10493,25,28,7576.35,13414.08,0.00
2024-12-10 17:43:14,52,10493,24,28,7570.64,13414.81,0.00
2024-12-10 17:43:14,52,10494,24,28,7802.96,13415.00,0.00
2024-12-10 17:43:14,53,10494,24,29,7655.74,13415.02,0.00
2024-12-10 17:43:14,53,10495,24,29,7649.46,13416.00,0.00
2024-12-10 17:43:14,54,10495,25,29,7507.80,13416.02,0.00
2024-12-10 17:43:14,53,10495,24,29,7623.42,13416.06,0.00
2024-12-10 17:43:14,52,10495,24,28,7715.84,13416.06,0.00
2024-12-10 17:43:14,52,10496,24,28,7847.99,13417.00,0.00
2024-12-10 17:43:14,53,10496,25,28,7699.92,13417.02,0.00
2024-12-10 17:43:14,52,10496,24,28,7620.64,13417.83,0.00
2024-12-10 17:43:14,52,10497,24,28,7855.59,13418.00,0.00
2024-12-10 17:43:14,53,10497,25,28,7707.37,13418.02,0.00
2024-12-10 17:43:14,53,10498,25,28,7677.57,13419.00,0.00
2024-12-10 17:43:14,54,10498,25,29,7535.39,13419.02,0.00
2024-12-10 17:43:14,53,10498,24,29,7669.98,13419.08,0.00
2024-12-10 17:43:14,52,10498,24,28,7814.90,13419.08,0.00
2024-12-10 17:43:14,51,10498,23,28,7904.53,13419.55,0.00
2024-12-10 17:43:14,50,10498,22,28,8046.58,13419.66,0.00
2024-12-10 17:43:14,50,10499,22,28,8162.26,13420.00,0.00
2024-12-10 17:43:14,51,10499,23,28,8002.22,13420.02,0.00
2024-12-10 17:43:14,51,10500,23,28,7991.18,13421.00,0.00
2024-12-10 17:43:14,52,10500,24,28,7837.51,13421.02,0.00
2024-12-10 17:43:14,51,10500,24,27,7930.67,13421.08,0.00
2024-12-10 17:43:14,51,10501,24,27,7965.46,13422.00,0.00
2024-12-10 17:43:14,52,10501,24,28,7812.28,13422.02,0.00
2024-12-10 17:43:14,52,10502,24,28,7801.36,13423.00,0.00
2024-12-10 17:43:14,53,10502,25,28,7654.17,13423.02,0.00
2024-12-10 17:43:14,52,10502,25,27,7742.00,13423.08,0.00
2024-12-10 17:43:14,51,10502,24,27,7734.67,13423.51,0.00
2024-12-10 17:43:14,51,10503,24,27,7932.43,13424.00,0.00
2024-12-10 17:43:14,52,10503,24,28,7779.88,13424.02,0.00
2024-12-10 17:43:14,51,10503,23,28,7785.15,13424.33,0.00
2024-12-10 17:43:14,51,10504,23,28,7959.35,13425.00,0.00
2024-12-10 17:43:14,52,10504,24,28,7806.28,13425.02,0.00
2024-12-10 17:43:14,51,10504,23,28,7953.87,13425.06,0.00
2024-12-10 17:43:14,50,10504,23,27,8061.93,13425.06,0.00
2024-12-10 17:43:14,50,10505,23,27,8097.43,13426.00,0.00
2024-12-10 17:43:14,51,10505,23,28,7938.66,13426.02,0.00
2024-12-10 17:43:14,51,10506,23,28,7923.49,13427.00,0.00
2024-12-10 17:43:14,52,10506,24,28,7771.12,13427.02,0.00
2024-12-10 17:43:14,51,10506,24,27,7870.85,13427.06,0.00
2024-12-10 17:43:14,50,10506,23,27,7883.41,13427.46,0.00
2024-12-10 17:43:14,50,10507,23,27,8079.84,13428.00,0.00
2024-12-10 17:43:14,51,10507,23,28,7921.41,13428.02,0.00
2024-12-10 17:43:14,50,10507,22,28,7999.30,13428.12,0.00
2024-12-10 17:43:15,50,10508,22,28,8150.27,13429.00,0.00
2024-12-10 17:43:15,51,10508,23,28,7990.46,13429.02,0.00
2024-12-10 17:43:15,50,10508,22,28,8045.58,13429.18,0.00
2024-12-10 17:43:15,50,10509,22,28,8204.60,13430.00,0.00
2024-12-10 17:43:15,51,10509,22,29,8043.72,13430.02,0.00
2024-12-10 17:43:15,50,10509,22,28,8188.51,13430.10,0.00
2024-12-10 17:43:15,50,10510,22,28,8229.39,13431.00,0.00
2024-12-10 17:43:15,51,10510,22,29,8068.02,13431.02,0.00
2024-12-10 17:43:15,52,10509,23,29,7796.87,13431.54,0.00
2024-12-10 17:43:15,52,10510,23,29,7979.13,13432.00,0.00
2024-12-10 17:43:15,53,10510,24,29,7828.58,13432.02,0.00
2024-12-10 17:43:15,54,10509,24,30,7678.64,13432.09,0.00
2024-12-10 17:43:15,53,10509,23,30,7779.82,13432.83,0.00
2024-12-10 17:43:15,53,10510,23,30,8264.03,13433.00,0.00
2024-12-10 17:43:15,54,10510,23,31,8110.99,13433.02,0.00
2024-12-10 17:43:15,53,10510,23,30,8238.72,13433.11,0.00
2024-12-10 17:43:15,53,10511,23,30,8525.72,13434.00,0.00
2024-12-10 17:43:15,54,10511,24,30,8367.84,13434.02,0.00
2024-12-10 17:43:15,54,10512,24,30,8353.52,13435.00,0.00
2024-12-10 17:43:15,55,10512,25,30,8201.64,13435.02,0.00
2024-12-10 17:43:15,55,10513,25,30,8168.05,13436.00,0.00
2024-12-10 17:43:15,56,10513,25,31,8022.19,13436.02,0.00
2024-12-10 17:43:15,55,10513,25,30,8148.55,13436.11,0.00
2024-12-10 17:43:15,55,10514,25,30,8175.99,13437.00,0.00
2024-12-10 17:43:15,56,10514,25,31,8029.99,13437.02,0.00
2024-12-10 17:43:15,56,10515,25,31,8013.43,13438.00,0.00
2024-12-10 17:43:15,57,10515,26,31,7872.85,13438.02,0.00
2024-12-10 17:43:15,56,10515,25,31,7793.53,13438.89,0.00
2024-12-10 17:43:15,56,10516,25,31,8019.19,13439.00,0.00
2024-12-10 17:43:15,57,10516,26,31,7878.50,13439.02,0.00
2024-12-10 17:43:15,56,10516,26,30,8002.42,13439.11,0.00
2024-12-10 17:43:15,56,10517,26,30,8026.98,13440.00,0.00
2024-12-10 17:43:15,57,10517,26,31,7886.16,13440.02,0.00
2024-12-10 17:43:15,57,10517,26,31,7858.79,13441.00,0.00
2024-12-10 17:43:15,58,10517,27,31,7723.29,13441.02,0.00
2024-12-10 17:43:15,57,10517,27,30,7797.51,13441.11,0.00
2024-12-10 17:43:15,57,10518,27,30,7797.35,13442.00,0.00
2024-12-10 17:43:15,58,10518,27,31,7662.91,13442.02,0.00
2024-12-10 17:43:15,57,10518,26,31,7582.75,13442.74,0.00
2024-12-10 17:43:15,57,10519,26,31,7783.41,13443.00,0.00
2024-12-10 17:43:15,58,10519,27,31,7649.22,13443.02,0.00
2024-12-10 17:43:15,57,10519,27,30,7724.48,13443.11,0.00
2024-12-10 17:43:15,57,10520,27,30,7690.99,13444.00,0.00
2024-12-10 17:43:15,58,10520,27,31,7558.39,13444.02,0.00
2024-12-10 17:43:15,57,10520,26,31,7522.75,13444.32,0.00
2024-12-10 17:43:15,57,10521,26,31,7667.09,13445.00,0.00
2024-12-10 17:43:15,58,10521,26,32,7534.90,13445.02,0.00
2024-12-10 17:43:15,57,10521,25,32,7650.60,13445.12,0.00
2024-12-10 17:43:15,57,10522,25,32,7721.91,13446.00,0.00
2024-12-10 17:43:15,58,10522,26,32,7588.78,13446.02,0.00
2024-12-10 17:43:15,57,10522,25,32,7686.83,13446.11,0.00
2024-12-10 17:43:15,56,10522,25,31,7821.70,13446.11,0.00
2024-12-10 17:43:15,56,10523,25,31,7942.32,13447.00,0.00
2024-12-10 17:43:15,57,10523,26,31,7802.98,13447.02,0.00
2024-12-10 17:43:15,57,10524,26,31,7784.98,13448.00,0.00
2024-12-10 17:43:15,58,10524,27,31,7650.75,13448.02,0.00
2024-12-10 17:43:15,57,10524,27,30,7726.02,13448.11,0.00
2024-12-10 17:43:15,56,10524,26,30,7765.49,13448.61,0.00
2024-12-10 17:43:15,56,10525,26,30,7953.11,13449.00,0.00
2024-12-10 17:43:15,57,10525,26,31,7813.58,13449.02,0.00
2024-12-10 17:43:15,57,10526,26,31,7796.18,13450.00,0.00
2024-12-10 17:43:15,58,10526,26,32,7661.76,13450.02,0.00
2024-12-10 17:43:15,57,10526,25,32,7793.82,13450.02,0.00
2024-12-10 17:43:15,56,10526,24,32,7930.59,13450.02,0.00
2024-12-10 17:43:15,55,10526,24,31,8018.56,13450.07,0.00
2024-12-10 17:43:15,54,10526,23,31,8041.94,13450.74,0.00
2024-12-10 17:43:15,54,10527,23,31,8256.37,13451.00,0.00
2024-12-10 17:43:15,55,10527,23,32,8106.25,13451.02,0.00
2024-12-10 17:43:15,55,10528,23,32,8086.81,13452.00,0.00
2024-12-10 17:43:15,56,10528,23,33,7942.40,13452.02,0.00
2024-12-10 17:43:15,55,10528,23,32,8033.02,13452.07,0.00
2024-12-10 17:43:15,54,10528,22,32,8017.62,13452.59,0.00
2024-12-10 17:43:15,54,10529,22,32,8212.26,13453.00,0.00
2024-12-10 17:43:15,55,10529,22,33,8062.95,13453.02,0.00
2024-12-10 17:43:15,55,10530,22,33,8042.48,13454.00,0.00
2024-12-10 17:43:15,56,10530,22,34,7898.86,13454.02,0.00
2024-12-10 17:43:15,55,10530,22,33,7991.13,13454.07,0.00
2024-12-10 17:43:15,56,10529,22,34,7774.24,13454.66,0.00
2024-12-10 17:43:15,56,10530,22,34,7921.07,13455.00,0.00
2024-12-10 17:43:15,57,10530,23,34,7782.11,13455.02,0.00
2024-12-10 17:43:15,57,10531,23,34,7997.61,13456.00,0.00
2024-12-10 17:43:15,58,10531,23,35,7859.72,13456.02,0.00
2024-12-10 17:43:15,57,10531,23,34,7950.42,13456.07,0.00
2024-12-10 17:43:15,57,10532,23,34,7967.51,13457.00,0.00
2024-12-10 17:43:15,58,10532,24,34,7830.14,13457.02,0.00
2024-12-10 17:43:15,58,10533,24,34,7808.36,13458.00,0.00
2024-12-10 17:43:15,59,10533,24,35,7676.01,13458.02,0.00
2024-12-10 17:43:15,58,10533,24,34,7759.65,13458.07,0.00
2024-12-10 17:43:15,57,10533,23,34,7891.07,13458.09,0.00
2024-12-10 17:43:15,56,10533,22,34,7853.82,13458.96,0.00
2024-12-10 17:43:15,56,10534,22,34,8089.37,13459.00,0.00
2024-12-10 17:43:15,57,10534,23,34,7947.45,13459.02,0.00
2024-12-10 17:43:15,56,10534,22,34,7888.77,13459.64,0.00
2024-12-10 17:43:15,56,10535,22,34,8081.33,13460.00,0.00
2024-12-10 17:43:15,57,10535,23,34,7939.55,13460.02,0.00
2024-12-10 17:43:15,57,10536,23,34,7902.36,13461.00,0.00
2024-12-10 17:43:15,58,10536,23,35,7766.11,13461.02,0.00
2024-12-10 17:43:15,57,10536,22,35,7894.31,13461.02,0.00
2024-12-10 17:43:15,56,10536,22,34,8013.67,13461.11,0.00
2024-12-10 17:43:16,56,10537,22,34,8134.44,13462.00,0.00
2024-12-10 17:43:16,57,10537,23,34,7991.73,13462.02,0.00
2024-12-10 17:43:16,57,10538,23,34,7979.45,13463.00,0.00
2024-12-10 17:43:16,58,10538,24,34,7841.87,13463.02,0.00
2024-12-10 17:43:16,57,10538,23,34,7970.02,13463.09,0.00
2024-12-10 17:43:16,57,10539,23,34,7942.25,13464.00,0.00
2024-12-10 17:43:16,58,10539,23,35,7805.31,13464.02,0.00
2024-12-10 17:43:16,57,10539,23,34,7923.38,13464.11,0.00
2024-12-10 17:43:16,57,10540,23,34,7945.20,13465.00,0.00
2024-12-10 17:43:16,58,10540,24,34,7808.21,13465.02,0.00
2024-12-10 17:43:16,57,10540,23,34,7910.78,13465.11,0.00
2024-12-10 17:43:16,57,10541,23,34,7979.85,13466.00,0.00
2024-12-10 17:43:16,58,10541,24,34,7842.27,13466.02,0.00
2024-12-10 17:43:16,58,10542,24,34,7803.38,13467.00,0.00
2024-12-10 17:43:16,59,10542,24,35,7671.12,13467.02,0.00
2024-12-10 17:43:16,58,10542,24,34,7784.83,13467.10,0.00
2024-12-10 17:43:16,57,10542,23,34,7859.29,13467.56,0.00
2024-12-10 17:43:16,57,10543,23,34,7942.32,13468.00,0.00
2024-12-10 17:43:16,58,10543,23,35,7805.38,13468.02,0.00
2024-12-10 17:43:16,57,10543,22,35,7838.42,13468.25,0.00
2024-12-10 17:43:16,57,10544,22,35,7973.63,13469.00,0.00
2024-12-10 17:43:16,58,10544,23,35,7836.15,13469.02,0.00
2024-12-10 17:43:16,57,10544,22,35,7971.27,13469.02,0.00
2024-12-10 17:43:16,56,10544,21,35,7975.27,13469.27,0.00
2024-12-10 17:43:16,56,10545,21,35,8117.70,13470.00,0.00
2024-12-10 17:43:16,57,10545,22,35,7975.29,13470.02,0.00
2024-12-10 17:43:16,56,10545,22,34,8100.89,13470.11,0.00
2024-12-10 17:43:16,56,10546,22,34,8125.52,13471.00,0.00
2024-12-10 17:43:16,57,10546,22,35,7982.97,13471.02,0.00
2024-12-10 17:43:16,56,10546,21,35,8115.92,13471.09,0.00
2024-12-10 17:43:16,56,10547,21,35,8108.34,13472.00,0.00
2024-12-10 17:43:16,57,10547,22,35,7966.09,13472.02,0.00
2024-12-10 17:43:16,56,10547,22,34,8048.22,13472.09,0.00
2024-12-10 17:43:16,56,10548,22,34,8070.45,13473.00,0.00
2024-12-10 17:43:16,57,10548,22,35,7928.86,13473.02,0.00
2024-12-10 17:43:16,57,10549,22,35,7908.39,13474.00,0.00
2024-12-10 17:43:16,58,10549,22,36,7772.03,13474.02,0.00
2024-12-10 17:43:16,57,10549,21,36,7906.02,13474.02,0.00
2024-12-10 17:43:16,56,10549,21,35,7991.88,13474.07,0.00
2024-12-10 17:43:16,56,10550,21,35,8011.70,13475.00,0.00
2024-12-10 17:43:16,57,10550,22,35,7871.15,13475.02,0.00
2024-12-10 17:43:16,56,10550,21,35,7941.96,13475.13,0.00
2024-12-10 17:43:16,56,10551,21,35,8065.24,13476.00,0.00
2024-12-10 17:43:16,57,10551,22,35,7923.74,13476.02,0.00
2024-12-10 17:43:16,56,10551,22,34,8012.32,13476.07,0.00
2024-12-10 17:43:16,56,10552,22,34,8032.15,13477.00,0.00
2024-12-10 17:43:16,57,10552,22,35,7891.23,13477.02,0.00
2024-12-10 17:43:16,57,10553,22,35,7866.28,13478.00,0.00
2024-12-10 17:43:16,58,10553,22,36,7730.66,13478.02,0.00
2024-12-10 17:43:16,57,10553,22,35,7816.65,13478.07,0.00
2024-12-10 17:43:16,56,10553,21,35,7946.11,13478.07,0.00
2024-12-10 17:43:16,56,10554,21,35,8062.22,13479.00,0.00
2024-12-10 17:43:16,57,10554,22,35,7920.78,13479.02,0.00
2024-12-10 17:43:16,56,10554,21,35,7946.33,13479.46,0.00
2024-12-10 17:43:16,56,10555,21,35,8115.20,13480.00,0.00
2024-12-10 17:43:16,57,10555,22,35,7972.83,13480.02,0.00
2024-12-10 17:43:16,57,10556,22,35,7934.68,13481.00,0.00
2024-12-10 17:43:16,58,10556,22,36,7797.88,13481.02,0.00
2024-12-10 17:43:16,57,10556,21,36,7925.24,13481.09,0.00
2024-12-10 17:43:16,56,10556,21,35,8061.95,13481.09,0.00
2024-12-10 17:43:16,56,10557,21,35,8084.19,13482.00,0.00
2024-12-10 17:43:16,57,10557,22,35,7942.37,13482.02,0.00
2024-12-10 17:43:16,56,10557,21,35,7868.62,13482.66,0.00
2024-12-10 17:43:16,56,10558,21,35,8063.86,13483.00,0.00
2024-12-10 17:43:16,57,10558,22,35,7922.39,13483.02,0.00
2024-12-10 17:43:16,57,10559,22,35,7885.13,13484.00,0.00
2024-12-10 17:43:16,58,10559,23,35,7749.18,13484.02,0.00
2024-12-10 17:43:16,57,10559,23,34,7852.01,13484.02,0.00
2024-12-10 17:43:16,56,10559,23,33,7982.61,13484.07,0.00
2024-12-10 17:43:16,56,10560,23,33,8002.45,13485.00,0.00
2024-12-10 17:43:16,57,10560,24,33,7862.05,13485.02,0.00
2024-12-10 17:43:16,56,10560,23,33,7906.20,13485.20,0.00
2024-12-10 17:43:16,56,10561,23,33,8039.17,13486.00,0.00
2024-12-10 17:43:16,57,10561,23,34,7898.13,13486.02,0.00
2024-12-10 17:43:16,56,10561,23,33,7981.38,13486.07,0.00
2024-12-10 17:43:16,56,10562,23,33,8001.23,13487.00,0.00
2024-12-10 17:43:16,57,10562,24,33,7860.85,13487.02,0.00
2024-12-10 17:43:16,56,10562,23,33,7789.16,13487.64,0.00
2024-12-10 17:43:16,56,10563,23,33,7982.09,13488.00,0.00
2024-12-10 17:43:16,57,10563,24,33,7842.06,13488.02,0.00
2024-12-10 17:43:16,56,10563,24,32,7924.30,13488.07,0.00
2024-12-10 17:43:16,56,10564,24,32,7944.15,13489.00,0.00
2024-12-10 17:43:16,57,10564,25,32,7804.78,13489.02,0.00
2024-12-10 17:43:16,57,10565,25,32,7783.70,13490.00,0.00
2024-12-10 17:43:16,58,10565,26,32,7649.50,13490.02,0.00
2024-12-10 17:43:16,57,10565,26,31,7726.91,13490.07,0.00
2024-12-10 17:43:16,57,10566,26,31,7744.04,13491.00,0.00
2024-12-10 17:43:16,58,10566,27,31,7610.52,13491.02,0.00
2024-12-10 17:43:16,57,10566,26,31,7624.52,13491.54,0.00
2024-12-10 17:43:16,57,10567,26,31,7721.83,13492.00,0.00
2024-12-10 17:43:16,58,10567,27,31,7588.70,13492.02,0.00
2024-12-10 17:43:16,57,10567,27,30,7667.40,13492.07,0.00
2024-12-10 17:43:16,57,10568,27,30,7684.53,13493.00,0.00
2024-12-10 17:43:16,58,10568,27,31,7552.04,13493.02,0.00
2024-12-10 17:43:16,58,10569,27,31,7527.99,13494.00,0.00
2024-12-10 17:43:17,59,10569,28,31,7400.39,13494.02,0.00
2024-12-10 17:43:17,58,10569,27,31,7515.37,13494.03,0.00
2024-12-10 17:43:17,57,10569,27,30,7597.52,13494.07,0.00
2024-12-10 17:43:17,57,10570,27,30,7709.34,13495.00,0.00
2024-12-10 17:43:17,58,10570,27,31,7576.42,13495.02,0.00
2024-12-10 17:43:17,58,10571,27,31,7590.30,13496.00,0.00
2024-12-10 17:43:17,59,10571,27,32,7461.65,13496.02,0.00
2024-12-10 17:43:17,58,10571,26,32,7467.65,13496.12,0.00
2024-12-10 17:43:17,58,10572,26,32,7582.20,13497.00,0.00
2024-12-10 17:43:17,59,10572,26,33,7453.69,13497.02,0.00
2024-12-10 17:43:17,58,10572,26,32,7533.34,13497.07,0.00
2024-12-10 17:43:17,58,10573,26,32,7547.85,13498.00,0.00
2024-12-10 17:43:17,59,10573,27,32,7419.93,13498.02,0.00
2024-12-10 17:43:17,59,10574,27,32,7397.62,13499.00,0.00
2024-12-10 17:43:17,60,10574,27,33,7274.32,13499.02,0.00
2024-12-10 17:43:17,59,10574,27,32,7349.58,13499.07,0.00
2024-12-10 17:43:17,59,10575,27,32,7361.55,13500.00,0.00
2024-12-10 17:43:17,60,10575,28,32,7238.86,13500.02,0.00
2024-12-10 17:43:17,59,10575,28,31,7361.04,13500.02,0.00
2024-12-10 17:43:17,58,10575,27,31,7371.61,13500.53,0.00
2024-12-10 17:43:17,57,10575,26,31,7458.44,13500.75,0.00
2024-12-10 17:43:17,57,10576,26,31,7662.31,13501.00,0.00
2024-12-10 17:43:17,58,10576,27,31,7530.20,13501.02,0.00
2024-12-10 17:43:17,57,10576,27,30,7617.31,13501.05,0.00
2024-12-10 17:43:17,57,10577,27,30,7632.08,13502.00,0.00
2024-12-10 17:43:17,58,10577,27,31,7500.49,13502.02,0.00
2024-12-10 17:43:17,58,10578,27,31,7476.36,13503.00,0.00
2024-12-10 17:43:17,59,10578,28,31,7349.64,13503.02,0.00
2024-12-10 17:43:17,58,10578,28,30,7429.80,13503.05,0.00
2024-12-10 17:43:17,58,10579,28,30,7441.99,13504.00,0.00
2024-12-10 17:43:17,59,10579,29,30,7315.85,13504.02,0.00
2024-12-10 17:43:17,59,10580,29,30,7293.05,13505.00,0.00
2024-12-10 17:43:17,60,10580,29,31,7171.50,13505.02,0.00
2024-12-10 17:43:17,59,10580,29,30,7247.28,13505.05,0.00
2024-12-10 17:43:17,59,10581,29,30,7256.96,13506.00,0.00
2024-12-10 17:43:17,60,10581,30,30,7136.02,13506.02,0.00
2024-12-10 17:43:17,59,10581,29,30,7180.74,13506.10,0.00
2024-12-10 17:43:17,58,10581,28,30,7239.62,13506.57,0.00
2024-12-10 17:43:17,58,10582,28,30,7414.56,13507.00,0.00
2024-12-10 17:43:17,59,10582,29,30,7288.89,13507.02,0.00
2024-12-10 17:43:17,58,10582,29,29,7365.67,13507.07,0.00
2024-12-10 17:43:17,58,10583,29,29,7380.17,13508.00,0.00
2024-12-10 17:43:17,59,10583,29,30,7255.08,13508.02,0.00
2024-12-10 17:43:17,58,10583,28,30,7355.01,13508.09,0.00
2024-12-10 17:43:17,58,10584,28,30,7418.43,13509.00,0.00
2024-12-10 17:43:17,59,10584,29,30,7292.69,13509.02,0.00
2024-12-10 17:43:17,58,10584,29,29,7360.21,13509.09,0.00
2024-12-10 17:43:17,57,10584,28,29,7354.47,13509.53,0.00
2024-12-10 17:43:17,57,10585,28,29,7527.80,13510.00,0.00
2024-12-10 17:43:17,58,10585,28,30,7398.01,13510.02,0.00
2024-12-10 17:43:17,58,10586,28,30,7380.03,13511.00,0.00
2024-12-10 17:43:17,59,10586,29,30,7254.94,13511.02,0.00
2024-12-10 17:43:17,58,10586,29,29,7324.13,13511.09,0.00
2024-12-10 17:43:17,57,10586,28,29,7391.11,13511.53,0.00
2024-12-10 17:43:17,57,10587,28,29,7564.47,13512.00,0.00
2024-12-10 17:43:17,58,10587,29,29,7434.05,13512.02,0.00
2024-12-10 17:43:17,58,10588,29,29,7414.74,13513.00,0.00
2024-12-10 17:43:17,59,10588,29,30,7289.06,13513.02,0.00
2024-12-10 17:43:17,58,10588,29,29,7361.17,13513.09,0.00
2024-12-10 17:43:17,58,10589,29,29,7378.01,13514.00,0.00
2024-12-10 17:43:17,59,10589,30,29,7252.96,13514.02,0.00
2024-12-10 17:43:17,59,10590,30,29,7232.98,13515.00,0.00
2024-12-10 17:43:17,60,10590,30,30,7112.43,13515.02,0.00
2024-12-10 17:43:17,59,10590,30,29,7182.60,13515.08,0.00
2024-12-10 17:43:17,58,10590,29,29,7220.68,13515.55,0.00
2024-12-10 17:43:17,58,10591,29,29,7393.43,13516.00,0.00
2024-12-10 17:43:17,59,10591,30,29,7268.12,13516.02,0.00
2024-12-10 17:43:17,58,10591,29,29,7261.31,13516.59,0.00
2024-12-10 17:43:17,58,10592,29,29,7438.72,13517.00,0.00
2024-12-10 17:43:17,59,10592,30,29,7312.64,13517.02,0.00
2024-12-10 17:43:17,58,10592,30,28,7389.80,13517.09,0.00
2024-12-10 17:43:17,58,10593,30,28,7406.64,13518.00,0.00
2024-12-10 17:43:17,59,10593,31,28,7281.11,13518.02,0.00
2024-12-10 17:43:17,59,10594,31,28,7258.08,13519.00,0.00
2024-12-10 17:43:17,60,10594,32,28,7137.11,13519.02,0.00
2024-12-10 17:43:17,59,10594,32,27,7255.78,13519.02,0.00
2024-12-10 17:43:17,58,10594,32,26,7336.61,13519.07,0.00
2024-12-10 17:43:17,58,10595,32,26,7351.13,13520.00,0.00
2024-12-10 17:43:17,59,10595,32,27,7226.53,13520.02,0.00
2024-12-10 17:43:17,59,10596,32,27,7200.97,13521.00,0.00
2024-12-10 17:43:17,60,10596,33,27,7080.95,13521.02,0.00
2024-12-10 17:43:17,59,10596,33,26,7162.02,13521.07,0.00
2024-12-10 17:43:17,59,10597,33,26,7174.00,13522.00,0.00
2024-12-10 17:43:17,60,10597,34,26,7054.43,13522.02,0.00
2024-12-10 17:43:17,59,10597,33,26,7108.75,13522.08,0.00
2024-12-10 17:43:17,59,10598,33,26,7214.70,13523.00,0.00
2024-12-10 17:43:17,60,10598,33,27,7094.45,13523.02,0.00
2024-12-10 17:43:17,59,10598,33,26,7175.74,13523.07,0.00
2024-12-10 17:43:17,59,10599,33,26,7187.72,13524.00,0.00
2024-12-10 17:43:17,60,10599,34,26,7067.93,13524.02,0.00
2024-12-10 17:43:18,60,10600,34,26,7043.06,13525.00,0.00
2024-12-10 17:43:18,61,10600,34,27,6927.60,13525.02,0.00
2024-12-10 17:43:18,60,10600,34,26,7004.74,13525.07,0.00
2024-12-10 17:43:18,59,10600,33,26,7055.81,13525.56,0.00
2024-12-10 17:43:18,59,10601,33,26,7134.05,13526.00,0.00
2024-12-10 17:43:18,60,10601,33,27,7015.15,13526.02,0.00
2024-12-10 17:43:18,59,10601,32,27,7000.53,13526.14,0.00
2024-12-10 17:43:18,59,10602,32,27,7113.36,13527.00,0.00
2024-12-10 17:43:18,60,10602,33,27,6994.81,13527.02,0.00
2024-12-10 17:43:18,59,10602,32,27,7097.90,13527.08,0.00
2024-12-10 17:43:18,58,10602,32,26,7185.30,13527.09,0.00
2024-12-10 17:43:18,58,10603,32,26,7295.44,13528.00,0.00
2024-12-10 17:43:18,59,10603,32,27,7171.79,13528.02,0.00
2024-12-10 17:43:18,58,10603,31,27,7104.59,13528.53,0.00
2024-12-10 17:43:18,57,10603,30,27,7228.29,13528.54,0.00
2024-12-10 17:43:18,57,10604,30,27,7404.25,13529.00,0.00
2024-12-10 17:43:18,58,10604,31,27,7276.60,13529.02,0.00
2024-12-10 17:43:18,57,10604,31,26,7356.80,13529.09,0.00
2024-12-10 17:43:18,56,10604,30,26,7454.85,13529.14,0.00
2024-12-10 17:43:18,56,10605,30,26,7581.01,13530.00,0.00
2024-12-10 17:43:18,57,10605,31,26,7448.01,13530.02,0.00
2024-12-10 17:43:18,56,10605,30,26,7518.21,13530.13,0.00
2024-12-10 17:43:18,56,10606,30,26,7564.50,13531.00,0.00
2024-12-10 17:43:18,57,10606,30,27,7431.79,13531.02,0.00
2024-12-10 17:43:18,56,10606,29,27,7562.09,13531.02,0.00
2024-12-10 17:43:18,55,10606,29,26,7650.38,13531.07,0.00
2024-12-10 17:43:18,55,10607,29,26,7673.08,13532.00,0.00
2024-12-10 17:43:18,56,10607,29,27,7536.06,13532.02,0.00
2024-12-10 17:43:18,56,10608,29,27,7514.38,13533.00,0.00
2024-12-10 17:43:18,57,10608,30,27,7382.54,13533.02,0.00
2024-12-10 17:43:18,56,10608,30,26,7468.47,13533.07,0.00
2024-12-10 17:43:18,55,10608,29,26,7411.05,13533.95,0.00
2024-12-10 17:43:18,55,10609,29,26,7649.77,13534.00,0.00
2024-12-10 17:43:18,56,10609,30,26,7513.16,13534.02,0.00
2024-12-10 17:43:18,56,10610,30,26,7494.79,13535.00,0.00
2024-12-10 17:43:18,57,10610,30,27,7363.30,13535.02,0.00
2024-12-10 17:43:18,56,10610,30,26,7446.45,13535.07,0.00
2024-12-10 17:43:18,55,10610,29,26,7409.66,13535.93,0.00
2024-12-10 17:43:18,55,10611,29,26,7645.97,13536.00,0.00
2024-12-10 17:43:18,56,10611,30,26,7509.44,13536.02,0.00
2024-12-10 17:43:18,55,10611,29,26,7584.46,13536.11,0.00
2024-12-10 17:43:18,55,10612,29,26,7630.89,13537.00,0.00
2024-12-10 17:43:18,56,10612,29,27,7494.62,13537.02,0.00
2024-12-10 17:43:18,55,10612,29,26,7581.67,13537.07,0.00
2024-12-10 17:43:18,55,10613,29,26,7604.38,13538.00,0.00
2024-12-10 17:43:18,56,10613,29,27,7468.59,13538.02,0.00
2024-12-10 17:43:18,56,10614,29,27,7448.79,13539.00,0.00
2024-12-10 17:43:18,57,10614,29,28,7318.11,13539.02,0.00
2024-12-10 17:43:18,56,10614,29,27,7402.86,13539.07,0.00
2024-12-10 17:43:18,55,10614,28,27,7356.84,13539.96,0.00
2024-12-10 17:43:18,55,10615,28,27,7598.12,13540.00,0.00
2024-12-10 17:43:18,56,10615,29,27,7462.43,13540.02,0.00
2024-12-10 17:43:18,55,10615,28,27,7394.21,13540.56,0.00
2024-12-10 17:43:18,55,10616,28,27,7581.64,13541.00,0.00
2024-12-10 17:43:18,56,10616,28,28,7446.25,13541.02,0.00
2024-12-10 17:43:18,55,10616,27,28,7564.87,13541.07,0.00
2024-12-10 17:43:18,54,10616,27,27,7662.33,13541.07,0.00
2024-12-10 17:43:18,54,10617,27,27,7788.28,13542.00,0.00
2024-12-10 17:43:18,55,10617,28,27,7646.67,13542.02,0.00
2024-12-10 17:43:18,55,10618,28,27,7627.99,13543.00,0.00
2024-12-10 17:43:18,56,10618,28,28,7491.78,13543.02,0.00
2024-12-10 17:43:18,55,10618,27,28,7625.53,13543.02,0.00
2024-12-10 17:43:18,54,10618,27,27,7721.61,13543.06,0.00
2024-12-10 17:43:18,54,10619,27,27,7744.75,13544.00,0.00
2024-12-10 17:43:18,55,10619,28,27,7603.93,13544.02,0.00
2024-12-10 17:43:18,55,10620,28,27,7586.10,13545.00,0.00
2024-12-10 17:43:18,56,10620,28,28,7450.63,13545.02,0.00
2024-12-10 17:43:18,55,10620,28,27,7583.64,13545.02,0.00
2024-12-10 17:43:18,54,10620,28,26,7678.93,13545.04,0.00
2024-12-10 17:43:18,54,10621,28,26,7699.56,13546.00,0.00
2024-12-10 17:43:18,55,10621,28,27,7559.57,13546.02,0.00
2024-12-10 17:43:18,54,10621,27,27,7561.69,13546.31,0.00
2024-12-10 17:43:18,54,10622,27,27,7720.20,13547.00,0.00
2024-12-10 17:43:18,55,10622,28,27,7579.83,13547.02,0.00
2024-12-10 17:43:18,54,10622,28,26,7662.51,13547.07,0.00
2024-12-10 17:43:18,53,10622,27,26,7664.16,13547.53,0.00
2024-12-10 17:43:18,53,10623,27,26,7856.22,13548.00,0.00
2024-12-10 17:43:18,54,10623,27,27,7710.73,13548.02,0.00
2024-12-10 17:43:18,53,10623,26,27,7848.57,13548.08,0.00
2024-12-10 17:43:18,52,10623,25,27,7972.06,13548.10,0.00
2024-12-10 17:43:18,52,10624,25,27,8058.62,13549.00,0.00
2024-12-10 17:43:18,53,10624,25,28,7906.57,13549.02,0.00
2024-12-10 17:43:18,53,10625,25,28,7876.47,13550.00,0.00
2024-12-10 17:43:18,54,10625,26,28,7730.61,13550.02,0.00
2024-12-10 17:43:18,53,10625,25,28,7868.82,13550.08,0.00
2024-12-10 17:43:18,52,10625,25,27,8007.11,13550.10,0.00
2024-12-10 17:43:18,51,10625,24,27,8057.99,13550.39,0.00
2024-12-10 17:43:18,51,10626,24,27,8241.76,13551.00,0.00
2024-12-10 17:43:18,52,10626,24,28,8083.26,13551.02,0.00
2024-12-10 17:43:18,52,10627,24,28,8078.05,13552.00,0.00
2024-12-10 17:43:18,53,10627,24,29,7925.64,13552.02,0.00
2024-12-10 17:43:18,52,10627,23,29,7945.79,13552.21,0.00
2024-12-10 17:43:18,52,10628,23,29,8100.09,13553.00,0.00
2024-12-10 17:43:18,53,10628,23,30,7947.26,13553.02,0.00
2024-12-10 17:43:18,52,10628,23,29,8079.26,13553.12,0.00
2024-12-10 17:43:18,52,10629,23,29,8116.33,13554.00,0.00
2024-12-10 17:43:18,53,10629,24,29,7963.19,13554.02,0.00
2024-12-10 17:43:18,53,10630,24,29,7955.27,13555.00,0.00
2024-12-10 17:43:18,54,10630,25,29,7807.95,13555.02,0.00
2024-12-10 17:43:18,53,10630,24,29,7756.77,13555.43,0.00
2024-12-10 17:43:18,53,10631,24,29,7936.23,13556.00,0.00
2024-12-10 17:43:18,54,10631,24,30,7789.26,13556.02,0.00
2024-12-10 17:43:18,53,10631,24,29,7920.90,13556.11,0.00
2024-12-10 17:43:19,53,10632,24,29,7954.72,13557.00,0.00
2024-12-10 17:43:19,54,10632,25,29,7807.41,13557.02,0.00
2024-12-10 17:43:19,53,10632,24,29,7839.68,13557.25,0.00
2024-12-10 17:43:19,53,10633,24,29,7993.68,13558.00,0.00
2024-12-10 17:43:19,54,10633,25,29,7845.65,13558.02,0.00
2024-12-10 17:43:19,53,10633,25,28,7929.74,13558.11,0.00
2024-12-10 17:43:19,53,10634,25,28,7963.57,13559.00,0.00
2024-12-10 17:43:19,54,10634,26,28,7816.10,13559.02,0.00
2024-12-10 17:43:19,53,10634,25,28,7961.01,13559.02,0.00
2024-12-10 17:43:19,52,10634,24,28,8048.92,13559.02,0.00
2024-12-10 17:43:19,52,10635,24,28,8125.14,13560.00,0.00
2024-12-10 17:43:19,53,10635,25,28,7971.83,13560.02,0.00
2024-12-10 17:43:19,52,10635,25,27,8065.17,13560.08,0.00
2024-12-10 17:43:19,52,10636,25,27,8097.05,13561.00,0.00
2024-12-10 17:43:19,53,10636,26,27,7944.28,13561.02,0.00
2024-12-10 17:43:19,52,10636,25,27,8094.42,13561.04,0.00
2024-12-10 17:43:19,51,10636,24,27,8130.90,13561.24,0.00
2024-12-10 17:43:19,51,10637,24,27,8293.63,13562.00,0.00
2024-12-10 17:43:19,52,10637,25,27,8134.14,13562.02,0.00
2024-12-10 17:43:19,51,10637,25,26,8232.48,13562.06,0.00
2024-12-10 17:43:19,51,10638,25,26,8264.99,13563.00,0.00
2024-12-10 17:43:19,52,10638,25,27,8106.05,13563.02,0.00
2024-12-10 17:43:19,52,10639,25,27,8095.78,13564.00,0.00
2024-12-10 17:43:19,53,10639,26,27,7943.03,13564.02,0.00
2024-12-10 17:43:19,53,10640,26,27,7912.90,13565.00,0.00
2024-12-10 17:43:19,54,10640,26,28,7766.36,13565.02,0.00
2024-12-10 17:43:19,53,10640,26,27,7905.23,13565.06,0.00
2024-12-10 17:43:19,53,10641,26,27,7931.40,13566.00,0.00
2024-12-10 17:43:19,54,10641,26,28,7784.52,13566.02,0.00
2024-12-10 17:43:19,54,10642,26,28,7774.50,13567.00,0.00
2024-12-10 17:43:19,55,10642,27,28,7633.15,13567.02,0.00
2024-12-10 17:43:19,54,10642,26,28,7769.49,13567.06,0.00
2024-12-10 17:43:19,54,10643,26,28,7742.41,13568.00,0.00
2024-12-10 17:43:19,55,10643,26,29,7601.64,13568.02,0.00
2024-12-10 17:43:19,54,10643,26,28,7732.38,13568.07,0.00
2024-12-10 17:43:19,54,10644,26,28,7758.06,13569.00,0.00
2024-12-10 17:43:19,55,10644,26,29,7617.01,13569.02,0.00
2024-12-10 17:43:19,55,10645,26,29,7604.62,13570.00,0.00
2024-12-10 17:43:19,56,10645,26,30,7468.82,13570.02,0.00
2024-12-10 17:43:19,55,10645,25,30,7583.03,13570.05,0.00
2024-12-10 17:43:19,54,10645,25,29,7670.69,13570.06,0.00
2024-12-10 17:43:19,54,10646,25,29,7794.39,13571.00,0.00
2024-12-10 17:43:19,55,10646,25,30,7652.67,13571.02,0.00
2024-12-10 17:43:19,55,10647,25,30,7642.73,13572.00,0.00
2024-12-10 17:43:19,56,10647,26,30,7506.25,13572.02,0.00
2024-12-10 17:43:19,55,10647,25,30,7446.37,13572.78,0.00
2024-12-10 17:43:19,55,10648,25,30,7663.67,13573.00,0.00
2024-12-10 17:43:19,56,10648,26,30,7526.82,13573.02,0.00
2024-12-10 17:43:19,55,10648,26,29,7653.81,13573.07,0.00
2024-12-10 17:43:19,55,10649,26,29,7676.58,13574.00,0.00
2024-12-10 17:43:19,56,10649,26,30,7539.50,13574.02,0.00
2024-12-10 17:43:19,55,10649,25,30,7486.74,13574.49,0.00
2024-12-10 17:43:19,55,10650,25,30,7664.80,13575.00,0.00
2024-12-10 17:43:19,56,10650,25,31,7527.93,13575.02,0.00
2024-12-10 17:43:19,55,10650,24,31,7612.97,13575.04,0.00
2024-12-10 17:43:19,54,10650,24,30,7698.65,13575.06,0.00
2024-12-10 17:43:19,54,10651,24,30,7822.40,13576.00,0.00
2024-12-10 17:43:19,55,10651,25,30,7680.18,13576.02,0.00
2024-12-10 17:43:19,55,10652,25,30,7674.72,13577.00,0.00
2024-12-10 17:43:19,56,10652,25,31,7537.67,13577.02,0.00
2024-12-10 17:43:19,56,10653,25,31,7501.86,13578.00,0.00
2024-12-10 17:43:19,57,10653,26,31,7370.25,13578.02,0.00
2024-12-10 17:43:19,56,10653,26,30,7484.90,13578.09,0.00
2024-12-10 17:43:19,55,10653,25,30,7511.29,13578.67,0.00
2024-12-10 17:43:19,55,10654,25,30,7713.97,13579.00,0.00
2024-12-10 17:43:19,56,10654,25,31,7576.22,13579.02,0.00
2024-12-10 17:43:19,55,10654,24,31,7634.98,13579.13,0.00
2024-12-10 17:43:19,55,10655,24,31,7763.92,13580.00,0.00
2024-12-10 17:43:19,56,10655,24,32,7625.28,13580.02,0.00
2024-12-10 17:43:19,55,10655,23,32,7682.44,13580.04,0.00
2024-12-10 17:43:19,54,10655,22,32,7822.20,13580.06,0.00
2024-12-10 17:43:19,54,10656,22,32,7895.70,13581.00,0.00
2024-12-10 17:43:19,55,10656,22,33,7752.14,13581.02,0.00
2024-12-10 17:43:19,54,10656,21,33,7885.65,13581.06,0.00
2024-12-10 17:43:19,53,10656,21,32,8026.75,13581.06,0.00
2024-12-10 17:43:19,53,10657,21,32,8155.46,13582.00,0.00
2024-12-10 17:43:19,54,10657,21,33,8004.44,13582.02,0.00
2024-12-10 17:43:19,53,10657,20,33,8005.12,13582.60,0.00
2024-12-10 17:43:19,53,10658,20,33,8207.87,13583.00,0.00
2024-12-10 17:43:19,54,10658,21,33,8055.88,13583.02,0.00
2024-12-10 17:43:19,54,10659,21,33,8023.77,13584.00,0.00
2024-12-10 17:43:19,55,10659,22,33,7877.88,13584.02,0.00
2024-12-10 17:43:19,54,10659,21,33,8021.25,13584.02,0.00
2024-12-10 17:43:19,53,10659,21,32,8164.91,13584.04,0.00
2024-12-10 17:43:19,53,10660,21,32,8188.58,13585.00,0.00
2024-12-10 17:43:19,54,10660,22,32,8036.94,13585.02,0.00
2024-12-10 17:43:19,53,10660,21,32,8074.20,13585.15,0.00
2024-12-10 17:43:19,53,10661,21,32,8215.73,13586.00,0.00
2024-12-10 17:43:19,54,10661,22,32,8063.59,13586.02,0.00
2024-12-10 17:43:19,54,10662,22,32,8031.47,13587.00,0.00
2024-12-10 17:43:19,55,10662,23,32,7885.45,13587.02,0.00
2024-12-10 17:43:19,54,10662,23,31,8018.91,13587.07,0.00
2024-12-10 17:43:19,55,10661,24,31,7821.44,13587.49,0.00
2024-12-10 17:43:19,55,10662,24,31,8076.26,13588.00,0.00
2024-12-10 17:43:19,56,10662,24,32,7932.04,13588.02,0.00
2024-12-10 17:43:19,57,10661,24,33,7671.57,13588.60,0.00
2024-12-10 17:43:20,56,10661,23,33,7772.45,13588.95,0.00
2024-12-10 17:43:20,56,10662,23,33,8250.51,13589.00,0.00
2024-12-10 17:43:20,57,10662,23,34,8105.76,13589.02,0.00
2024-12-10 17:43:20,56,10662,22,34,8133.65,13589.20,0.00
2024-12-10 17:43:20,55,10662,21,34,8237.65,13589.51,0.00
2024-12-10 17:43:20,55,10663,21,34,8665.47,13590.00,0.00
2024-12-10 17:43:20,56,10663,22,34,8510.73,13590.02,0.00
2024-12-10 17:43:20,55,10663,22,33,8653.14,13590.07,0.00
2024-12-10 17:43:20,55,10664,22,33,8676.00,13591.00,0.00
2024-12-10 17:43:20,56,10664,23,33,8521.07,13591.02,0.00
2024-12-10 17:43:20,55,10664,22,33,8572.28,13591.20,0.00
2024-12-10 17:43:20,55,10665,22,33,8711.23,13592.00,0.00
2024-12-10 17:43:20,56,10665,22,34,8555.68,13592.02,0.00
2024-12-10 17:43:20,55,10665,22,33,8651.94,13592.07,0.00
2024-12-10 17:43:20,55,10666,22,33,8674.80,13593.00,0.00
2024-12-10 17:43:20,56,10666,23,33,8519.89,13593.02,0.00
2024-12-10 17:43:20,55,10666,22,33,8544.14,13593.62,0.00
2024-12-10 17:43:20,55,10667,22,33,8652.77,13594.00,0.00
2024-12-10 17:43:20,56,10667,23,33,8498.26,13594.02,0.00
2024-12-10 17:43:20,55,10667,22,33,8477.49,13594.44,0.00
2024-12-10 17:43:20,55,10668,22,33,8648.47,13595.00,0.00
2024-12-10 17:43:20,56,10668,22,34,8494.03,13595.02,0.00
2024-12-10 17:43:20,55,10668,22,33,8616.34,13595.04,0.00
2024-12-10 17:43:20,55,10669,22,33,8634.27,13596.00,0.00
2024-12-10 17:43:20,56,10669,22,34,8480.09,13596.02,0.00
2024-12-10 17:43:20,55,10669,22,33,8577.43,13596.07,0.00
2024-12-10 17:43:20,55,10670,22,33,8600.29,13597.00,0.00
2024-12-10 17:43:20,56,10670,22,34,8446.72,13597.02,0.00
2024-12-10 17:43:20,56,10671,22,34,8418.20,13598.00,0.00
2024-12-10 17:43:20,57,10671,22,35,8270.52,13598.02,0.00
2024-12-10 17:43:20,56,10671,22,34,8362.37,13598.07,0.00
2024-12-10 17:43:20,55,10671,21,34,8351.79,13598.93,0.00
2024-12-10 17:43:20,55,10672,21,34,8589.20,13599.00,0.00
2024-12-10 17:43:20,56,10672,22,34,8435.82,13599.02,0.00
2024-12-10 17:43:20,55,10672,21,34,8402.15,13599.78,0.00
2024-12-10 17:43:20,55,10673,21,34,8619.92,13600.00,0.00
2024-12-10 17:43:20,56,10673,21,35,8466.00,13600.02,0.00
2024-12-10 17:43:20,55,10673,21,34,8565.54,13600.07,0.00
2024-12-10 17:43:20,55,10674,21,34,8588.41,13601.00,0.00
2024-12-10 17:43:20,56,10674,21,35,8435.04,13601.02,0.00
2024-12-10 17:43:20,56,10675,21,35,8402.62,13602.00,0.00
2024-12-10 17:43:20,57,10675,22,35,8255.21,13602.02,0.00
2024-12-10 17:43:20,56,10675,22,34,8351.63,13602.07,0.00
2024-12-10 17:43:20,55,10675,21,34,8334.90,13602.96,0.00
2024-12-10 17:43:20,55,10676,21,34,8577.30,13603.00,0.00
2024-12-10 17:43:20,56,10676,21,35,8424.14,13603.02,0.00
2024-12-10 17:43:20,56,10677,21,35,8392.98,13604.00,0.00
2024-12-10 17:43:20,57,10677,22,35,8245.73,13604.02,0.00
2024-12-10 17:43:20,56,10677,22,34,8341.98,13604.07,0.00
2024-12-10 17:43:20,55,10677,21,34,8368.16,13604.82,0.00
2024-12-10 17:43:20,55,10677,21,34,8590.93,13605.00,0.00
2024-12-10 17:43:20,56,10677,21,35,8437.52,13605.02,0.00
2024-12-10 17:43:20,56,10678,21,35,8407.11,13606.00,0.00
2024-12-10 17:43:20,57,10678,21,36,8259.62,13606.02,0.00
2024-12-10 17:43:20,56,10678,21,35,8356.10,13606.07,0.00
2024-12-10 17:43:20,56,10679,21,35,8376.14,13607.00,0.00
2024-12-10 17:43:20,57,10679,22,35,8229.19,13607.02,0.00
2024-12-10 17:43:20,57,10680,22,35,8200.46,13608.00,0.00
2024-12-10 17:43:20,58,10680,23,35,8059.07,13608.02,0.00
2024-12-10 17:43:20,57,10680,23,34,8150.33,13608.07,0.00
2024-12-10 17:43:20,57,10681,23,34,8167.64,13609.00,0.00
2024-12-10 17:43:20,58,10681,24,34,8026.82,13609.02,0.00
2024-12-10 17:43:20,58,10682,24,34,7998.06,13610.00,0.00
2024-12-10 17:43:20,59,10682,25,34,7862.50,13610.02,0.00
2024-12-10 17:43:20,58,10682,25,33,7951.14,13610.07,0.00
2024-12-10 17:43:20,58,10683,25,33,7965.79,13611.00,0.00
2024-12-10 17:43:20,59,10683,25,34,7830.78,13611.02,0.00
2024-12-10 17:43:20,58,10683,24,34,7949.37,13611.02,0.00
2024-12-10 17:43:20,58,10684,24,34,8003.93,13612.00,0.00
2024-12-10 17:43:20,59,10684,25,34,7868.27,13612.02,0.00
2024-12-10 17:43:20,58,10684,25,33,7957.00,13612.07,0.00
2024-12-10 17:43:20,57,10684,24,33,8001.08,13612.09,0.00
2024-12-10 17:43:20,57,10685,24,33,8116.29,13613.00,0.00
2024-12-10 17:43:20,58,10685,24,34,7976.35,13613.02,0.00
2024-12-10 17:43:20,58,10686,24,34,7946.55,13614.00,0.00
2024-12-10 17:43:20,59,10686,25,34,7811.86,13614.02,0.00
2024-12-10 17:43:20,58,10686,25,33,7901.96,13614.07,0.00
2024-12-10 17:43:20,58,10687,25,33,7916.61,13615.00,0.00
2024-12-10 17:43:20,59,10687,25,34,7782.43,13615.02,0.00
2024-12-10 17:43:20,59,10688,25,34,7753.77,13616.00,0.00
2024-12-10 17:43:20,60,10688,26,34,7624.54,13616.02,0.00
2024-12-10 17:43:20,59,10688,26,33,7709.93,13616.07,0.00
2024-12-10 17:43:20,58,10688,25,33,7738.92,13616.38,0.00
2024-12-10 17:43:20,58,10689,25,33,7889.60,13617.00,0.00
2024-12-10 17:43:20,59,10689,26,33,7755.88,13617.02,0.00
2024-12-10 17:43:20,59,10690,26,33,7726.89,13618.00,0.00
2024-12-10 17:43:20,60,10690,27,33,7598.10,13618.02,0.00
2024-12-10 17:43:21,59,10690,27,32,7685.35,13618.07,0.00
2024-12-10 17:43:21,58,10690,26,32,7813.84,13618.09,0.00
2024-12-10 17:43:21,57,10690,25,32,7946.17,13618.12,0.00
2024-12-10 17:43:21,57,10691,25,32,7970.61,13619.00,0.00
2024-12-10 17:43:21,58,10691,25,33,7833.19,13619.02,0.00
2024-12-10 17:43:21,58,10692,25,33,7800.49,13620.00,0.00
2024-12-10 17:43:21,59,10692,25,34,7668.28,13620.02,0.00
2024-12-10 17:43:21,58,10692,25,33,7760.57,13620.07,0.00
2024-12-10 17:43:21,57,10692,24,33,7763.76,13620.82,0.00
2024-12-10 17:43:21,57,10693,24,33,7978.95,13621.00,0.00
2024-12-10 17:43:21,58,10693,24,34,7841.38,13621.02,0.00
2024-12-10 17:43:21,57,10693,23,34,7909.65,13621.05,0.00
2024-12-10 17:43:21,57,10694,23,34,7972.37,13622.00,0.00
2024-12-10 17:43:21,58,10694,23,35,7834.91,13622.02,0.00
2024-12-10 17:43:21,57,10694,23,34,7929.36,13622.07,0.00
2024-12-10 17:43:21,56,10694,22,34,7945.88,13622.45,0.00
2024-12-10 17:43:21,56,10695,22,34,8114.12,13623.00,0.00
2024-12-10 17:43:21,57,10695,23,34,7971.77,13623.02,0.00
2024-12-10 17:43:21,57,10696,23,34,7951.43,13624.00,0.00
2024-12-10 17:43:21,58,10696,23,35,7814.34,13624.02,0.00
2024-12-10 17:43:21,57,10696,23,34,7896.47,13624.07,0.00
2024-12-10 17:43:21,57,10697,23,34,7913.77,13625.00,0.00
2024-12-10 17:43:21,58,10697,23,35,7777.33,13625.02,0.00
2024-12-10 17:43:21,57,10697,22,35,7906.61,13625.07,0.00
2024-12-10 17:43:21,58,10696,22,36,7709.25,13625.21,0.00
2024-12-10 17:43:21,58,10697,22,36,7923.66,13626.00,0.00
2024-12-10 17:43:21,59,10697,23,36,7789.36,13626.02,0.00
2024-12-10 17:43:21,59,10698,23,36,8002.28,13627.00,0.00
2024-12-10 17:43:21,60,10698,24,36,7868.91,13627.02,0.00
2024-12-10 17:43:21,59,10698,23,36,7999.97,13627.02,0.00
2024-12-10 17:43:21,58,10698,22,36,8008.47,13627.62,0.00
2024-12-10 17:43:21,57,10698,21,36,8082.28,13627.93,0.00
2024-12-10 17:43:21,57,10699,21,36,8311.85,13628.00,0.00
2024-12-10 17:43:21,58,10699,21,37,8168.55,13628.02,0.00
2024-12-10 17:43:21,57,10699,21,36,8304.69,13628.05,0.00
2024-12-10 17:43:21,56,10699,20,36,8450.56,13628.07,0.00
2024-12-10 17:43:21,56,10700,20,36,8470.64,13629.00,0.00
2024-12-10 17:43:21,57,10700,20,37,8322.03,13629.02,0.00
2024-12-10 17:43:21,56,10700,19,37,8346.65,13629.30,0.00
2024-12-10 17:43:21,56,10701,19,37,8495.60,13630.00,0.00
2024-12-10 17:43:21,57,10701,20,37,8346.55,13630.02,0.00
2024-12-10 17:43:21,56,10701,20,36,8449.37,13630.05,0.00
2024-12-10 17:43:21,56,10702,20,36,8467.01,13631.00,0.00
2024-12-10 17:43:21,57,10702,20,37,8318.47,13631.02,0.00
2024-12-10 17:43:21,56,10702,19,37,8313.89,13631.68,0.00
2024-12-10 17:43:21,56,10703,19,37,8513.76,13632.00,0.00
2024-12-10 17:43:21,57,10703,19,38,8364.39,13632.02,0.00
2024-12-10 17:43:21,56,10703,19,37,8467.52,13632.05,0.00
2024-12-10 17:43:21,56,10704,19,37,8485.17,13633.00,0.00
2024-12-10 17:43:21,57,10704,19,38,8336.31,13633.02,0.00
2024-12-10 17:43:21,56,10704,18,38,8482.73,13633.02,0.00
2024-12-10 17:43:21,55,10704,17,38,8575.03,13633.09,0.00
2024-12-10 17:43:21,55,10705,17,38,8677.48,13634.00,0.00
2024-12-10 17:43:21,56,10705,18,38,8522.53,13634.02,0.00
2024-12-10 17:43:21,56,10706,18,38,8549.51,13635.00,0.00
2024-12-10 17:43:21,57,10706,18,39,8399.52,13635.02,0.00
2024-12-10 17:43:21,57,10707,18,39,8387.89,13636.00,0.00
2024-12-10 17:43:21,58,10707,18,40,8243.27,13636.02,0.00
2024-12-10 17:43:21,58,10708,18,40,8203.91,13637.00,0.00
2024-12-10 17:43:21,59,10708,18,41,8064.86,13637.02,0.00
2024-12-10 17:43:21,58,10708,18,40,8175.71,13637.07,0.00
2024-12-10 17:43:21,58,10709,18,40,8190.40,13638.00,0.00
2024-12-10 17:43:21,59,10709,18,41,8051.58,13638.02,0.00
2024-12-10 17:43:21,58,10709,17,41,8061.21,13638.33,0.00
2024-12-10 17:43:21,58,10710,17,41,8205.11,13639.00,0.00
2024-12-10 17:43:21,59,10710,17,42,8066.04,13639.02,0.00
2024-12-10 17:43:21,58,10710,17,41,8160.45,13639.07,0.00
2024-12-10 17:43:21,57,10710,16,41,8177.02,13639.49,0.00
2024-12-10 17:43:21,57,10711,16,41,8347.28,13640.00,0.00
2024-12-10 17:43:21,58,10711,17,41,8203.36,13640.02,0.00
2024-12-10 17:43:21,57,10711,16,41,8141.76,13640.56,0.00
2024-12-10 17:43:21,57,10712,16,41,8321.57,13641.00,0.00
2024-12-10 17:43:21,58,10712,16,42,8178.09,13641.02,0.00
2024-12-10 17:43:21,57,10712,16,41,8278.51,13641.07,0.00
2024-12-10 17:43:21,57,10713,16,41,8295.85,13642.00,0.00
2024-12-10 17:43:21,58,10713,16,42,8152.82,13642.02,0.00
2024-12-10 17:43:21,57,10713,15,42,8074.05,13642.88,0.00
2024-12-10 17:43:21,57,10714,15,42,8296.74,13643.00,0.00
2024-12-10 17:43:21,58,10714,16,42,8153.69,13643.02,0.00
2024-12-10 17:43:21,57,10714,16,41,8253.68,13643.07,0.00
2024-12-10 17:43:21,56,10714,15,41,8313.36,13643.07,0.00
2024-12-10 17:43:21,56,10715,15,41,8430.90,13644.00,0.00
2024-12-10 17:43:21,57,10715,16,41,8282.99,13644.02,0.00
2024-12-10 17:43:21,57,10716,16,41,8245.31,13645.00,0.00
2024-12-10 17:43:21,58,10716,17,41,8103.15,13645.02,0.00
2024-12-10 17:43:21,57,10716,17,40,8202.24,13645.07,0.00
2024-12-10 17:43:21,57,10717,17,40,8219.58,13646.00,0.00
2024-12-10 17:43:21,58,10717,18,40,8077.86,13646.02,0.00
2024-12-10 17:43:21,59,10716,19,40,7804.83,13646.71,0.00
2024-12-10 17:43:21,59,10717,19,40,8039.22,13647.00,0.00
2024-12-10 17:43:21,60,10717,19,41,7905.23,13647.02,0.00
2024-12-10 17:43:21,59,10717,19,40,7999.91,13647.07,0.00
2024-12-10 17:43:21,59,10718,19,40,8243.37,13648.00,0.00
2024-12-10 17:43:21,60,10718,19,41,8105.98,13648.02,0.00
2024-12-10 17:43:21,60,10719,19,41,8063.36,13649.00,0.00
2024-12-10 17:43:21,61,10719,20,41,7931.17,13649.02,0.00
2024-12-10 17:43:21,60,10719,20,40,8026.97,13649.07,0.00
2024-12-10 17:43:21,59,10719,19,40,8001.62,13649.95,0.00
2024-12-10 17:43:21,59,10720,19,40,8226.07,13650.00,0.00
2024-12-10 17:43:21,60,10720,19,41,8088.97,13650.02,0.00
2024-12-10 17:43:22,60,10721,19,41,8046.34,13651.00,0.00
2024-12-10 17:43:22,61,10721,19,42,7914.43,13651.02,0.00
2024-12-10 17:43:22,60,10721,19,41,8012.22,13651.07,0.00
2024-12-10 17:43:22,59,10721,18,41,8002.75,13651.90,0.00
2024-12-10 17:43:22,59,10722,18,41,8220.33,13652.00,0.00
2024-12-10 17:43:22,60,10722,19,41,8083.33,13652.02,0.00
2024-12-10 17:43:22,59,10722,18,41,8130.11,13652.08,0.00
2024-12-10 17:43:22,59,10723,18,41,8190.85,13653.00,0.00
2024-12-10 17:43:22,60,10723,18,42,8054.34,13653.02,0.00
2024-12-10 17:43:22,59,10723,18,41,8144.59,13653.08,0.00
2024-12-10 17:43:22,59,10724,18,41,8159.06,13654.00,0.00
2024-12-10 17:43:22,60,10724,19,41,8023.07,13654.02,0.00
2024-12-10 17:43:22,60,10725,19,41,7984.39,13655.00,0.00
2024-12-10 17:43:22,61,10725,20,41,7853.50,13655.02,0.00
2024-12-10 17:43:22,60,10725,20,40,7943.44,13655.08,0.00
2024-12-10 17:43:22,59,10725,19,40,8029.82,13655.42,0.00
2024-12-10 17:43:22,58,10725,18,40,8072.41,13655.55,0.00
2024-12-10 17:43:22,58,10726,18,40,8246.99,13656.00,0.00
2024-12-10 17:43:22,59,10726,18,41,8107.21,13656.02,0.00
2024-12-10 17:43:22,58,10726,17,41,8105.74,13656.10,0.00
2024-12-10 17:43:22,58,10727,17,41,8219.34,13657.00,0.00
2024-12-10 17:43:22,59,10727,18,41,8080.03,13657.02,0.00
2024-12-10 17:43:22,58,10727,18,40,8179.32,13657.09,0.00
2024-12-10 17:43:22,58,10728,18,40,8196.39,13658.00,0.00
2024-12-10 17:43:22,59,10728,18,41,8057.47,13658.02,0.00
2024-12-10 17:43:22,58,10728,17,41,8071.09,13658.28,0.00
2024-12-10 17:43:22,58,10729,17,41,8208.19,13659.00,0.00
2024-12-10 17:43:22,59,10729,17,42,8069.07,13659.02,0.00
2024-12-10 17:43:22,58,10729,16,42,8139.90,13659.07,0.00
2024-12-10 17:43:22,57,10729,16,41,8239.58,13659.09,0.00
2024-12-10 17:43:22,57,10730,16,41,8355.20,13660.00,0.00
2024-12-10 17:43:22,58,10730,17,41,8211.15,13660.02,0.00
2024-12-10 17:43:22,58,10731,17,41,8178.68,13661.00,0.00
2024-12-10 17:43:22,59,10731,18,41,8040.06,13661.02,0.00
2024-12-10 17:43:22,58,10731,18,40,8131.59,13661.09,0.00
2024-12-10 17:43:22,58,10732,18,40,8148.66,13662.00,0.00
2024-12-10 17:43:22,59,10732,18,41,8010.55,13662.02,0.00
2024-12-10 17:43:22,58,10732,17,41,8080.39,13662.16,0.00
2024-12-10 17:43:22,58,10733,17,41,8113.92,13663.00,0.00
2024-12-10 17:43:22,59,10733,17,42,7976.39,13663.02,0.00
2024-12-10 17:43:22,58,10733,17,41,8069.17,13663.09,0.00
2024-12-10 17:43:22,58,10734,17,41,8086.24,13664.00,0.00
2024-12-10 17:43:22,59,10734,17,42,7949.19,13664.02,0.00
2024-12-10 17:43:22,59,10735,17,42,7913.40,13665.00,0.00
2024-12-10 17:43:22,60,10735,17,43,7781.51,13665.02,0.00
2024-12-10 17:43:22,59,10735,17,42,7871.72,13665.08,0.00
2024-12-10 17:43:22,58,10735,16,42,7849.41,13665.93,0.00
2024-12-10 17:43:22,58,10736,16,42,8075.65,13666.00,0.00
2024-12-10 17:43:22,59,10736,17,42,7938.77,13666.02,0.00
2024-12-10 17:43:22,59,10737,17,42,7904.27,13667.00,0.00
2024-12-10 17:43:22,60,10737,17,43,7772.54,13667.02,0.00
2024-12-10 17:43:22,59,10737,16,43,7693.98,13667.92,0.00
2024-12-10 17:43:22,59,10738,16,43,7914.12,13668.00,0.00
2024-12-10 17:43:22,60,10738,17,43,7782.22,13668.02,0.00
2024-12-10 17:43:22,59,10738,17,42,7874.75,13668.08,0.00
2024-12-10 17:43:22,59,10739,17,42,7889.22,13669.00,0.00
2024-12-10 17:43:22,60,10739,17,43,7757.73,13669.02,0.00
2024-12-10 17:43:22,59,10739,17,42,7884.59,13669.03,0.00
2024-12-10 17:43:22,59,10740,17,42,7852.73,13670.00,0.00
2024-12-10 17:43:22,60,10740,17,43,7721.85,13670.02,0.00
2024-12-10 17:43:22,59,10740,17,42,7848.10,13670.03,0.00
2024-12-10 17:43:22,58,10740,17,41,7976.34,13670.03,0.00
2024-12-10 17:43:22,57,10740,16,41,8006.33,13670.74,0.00
2024-12-10 17:43:22,57,10741,16,41,8210.40,13671.00,0.00
2024-12-10 17:43:22,58,10741,17,41,8068.84,13671.02,0.00
2024-12-10 17:43:22,57,10741,17,40,8181.62,13671.04,0.00
2024-12-10 17:43:22,57,10742,17,40,8194.21,13672.00,0.00
2024-12-10 17:43:22,58,10742,17,41,8052.93,13672.02,0.00
2024-12-10 17:43:22,58,10743,17,41,8015.35,13673.00,0.00
2024-12-10 17:43:22,59,10743,17,42,7879.50,13673.02,0.00
2024-12-10 17:43:22,58,10743,17,41,7980.00,13673.05,0.00
2024-12-10 17:43:22,57,10743,16,41,7960.26,13673.93,0.00
2024-12-10 17:43:22,57,10744,16,41,8190.61,13674.00,0.00
2024-12-10 17:43:22,58,10744,17,41,8049.39,13674.02,0.00
2024-12-10 17:43:22,57,10744,16,41,8010.91,13674.51,0.00
2024-12-10 17:43:22,57,10745,16,41,8184.01,13675.00,0.00
2024-12-10 17:43:22,58,10745,17,41,8042.91,13675.02,0.00
2024-12-10 17:43:22,57,10745,17,40,8133.65,13675.09,0.00
2024-12-10 17:43:22,57,10746,17,40,8153.42,13676.00,0.00
2024-12-10 17:43:22,58,10746,18,40,8012.84,13676.02,0.00
2024-12-10 17:43:22,58,10747,18,40,7983.90,13677.00,0.00
2024-12-10 17:43:22,59,10747,19,40,7848.58,13677.02,0.00
2024-12-10 17:43:22,58,10747,19,39,7934.40,13677.09,0.00
2024-12-10 17:43:22,58,10748,19,39,7951.47,13678.00,0.00
2024-12-10 17:43:22,59,10748,20,39,7816.70,13678.02,0.00
2024-12-10 17:43:22,58,10748,19,39,7890.17,13678.12,0.00
2024-12-10 17:43:22,58,10749,19,39,7925.63,13679.00,0.00
2024-12-10 17:43:22,59,10749,20,39,7791.30,13679.02,0.00
2024-12-10 17:43:22,58,10749,20,38,7876.12,13679.09,0.00
2024-12-10 17:43:22,58,10750,20,38,7893.19,13680.00,0.00
2024-12-10 17:43:22,59,10750,20,39,7759.40,13680.02,0.00
2024-12-10 17:43:22,59,10751,20,39,7735.22,13681.00,0.00
2024-12-10 17:43:22,60,10751,20,40,7606.30,13681.02,0.00
2024-12-10 17:43:22,59,10751,20,39,7679.58,13681.10,0.00
2024-12-10 17:43:23,59,10752,20,39,7696.36,13682.00,0.00
2024-12-10 17:43:23,60,10752,20,40,7568.09,13682.02,0.00
2024-12-10 17:43:23,59,10752,19,40,7686.65,13682.08,0.00
2024-12-10 17:43:23,58,10752,18,40,7729.59,13682.24,0.00
2024-12-10 17:43:23,57,10752,17,40,7819.00,13682.58,0.00
2024-12-10 17:43:23,57,10753,17,40,8001.74,13683.00,0.00
2024-12-10 17:43:23,58,10753,17,41,7863.78,13683.02,0.00
2024-12-10 17:43:23,57,10753,16,41,7989.74,13683.02,0.00
2024-12-10 17:43:23,56,10753,16,40,8081.11,13683.07,0.00
2024-12-10 17:43:23,55,10753,15,40,8154.13,13683.60,0.00
2024-12-10 17:43:23,55,10754,15,40,8348.50,13684.00,0.00
2024-12-10 17:43:23,56,10754,16,40,8199.42,13684.02,0.00
2024-12-10 17:43:23,56,10755,16,40,8168.90,13685.00,0.00
2024-12-10 17:43:23,57,10755,17,40,8025.59,13685.02,0.00
2024-12-10 17:43:23,56,10755,17,39,8120.04,13685.07,0.00
2024-12-10 17:43:23,56,10756,17,39,8140.17,13686.00,0.00
2024-12-10 17:43:23,57,10756,17,40,7997.36,13686.02,0.00
2024-12-10 17:43:23,57,10757,17,40,7965.23,13687.00,0.00
2024-12-10 17:43:23,58,10757,17,41,7827.90,13687.02,0.00
2024-12-10 17:43:23,57,10757,17,40,7919.61,13687.07,0.00
2024-12-10 17:43:23,56,10757,16,40,7999.04,13687.13,0.00
2024-12-10 17:43:23,57,10756,16,41,7760.68,13687.88,0.00
2024-12-10 17:43:23,57,10757,16,41,8000.93,13688.00,0.00
2024-12-10 17:43:23,58,10757,16,42,7862.99,13688.02,0.00
2024-12-10 17:43:23,58,10758,16,42,8069.95,13689.00,0.00
2024-12-10 17:43:23,59,10758,17,42,7933.17,13689.02,0.00
2024-12-10 17:43:23,58,10758,17,41,8025.12,13689.07,0.00
2024-12-10 17:43:23,57,10758,16,41,8035.34,13689.47,0.00
2024-12-10 17:43:23,58,10757,16,42,7866.28,13689.72,0.00
2024-12-10 17:43:23,58,10758,16,42,8100.17,13690.00,0.00
2024-12-10 17:43:23,59,10758,16,43,7962.88,13690.02,0.00
2024-12-10 17:43:23,59,10759,16,43,8162.96,13691.00,0.00
2024-12-10 17:43:23,60,10759,16,44,8026.91,13691.02,0.00
2024-12-10 17:43:23,59,10759,16,43,8121.20,13691.07,0.00
2024-12-10 17:43:23,58,10759,15,43,8178.77,13691.33,0.00
2024-12-10 17:43:23,58,10760,15,43,8323.26,13692.00,0.00
2024-12-10 17:43:23,59,10760,15,44,8182.18,13692.02,0.00
2024-12-10 17:43:23,58,10760,14,44,8273.69,13692.05,0.00
2024-12-10 17:43:23,58,10761,14,44,8333.31,13693.00,0.00
2024-12-10 17:43:23,59,10761,15,44,8192.06,13693.02,0.00
2024-12-10 17:43:23,58,10761,15,43,8297.90,13693.05,0.00
2024-12-10 17:43:23,58,10762,15,43,8310.31,13694.00,0.00
2024-12-10 17:43:23,59,10762,15,44,8169.45,13694.02,0.00
2024-12-10 17:43:23,59,10763,15,44,8132.89,13695.00,0.00
2024-12-10 17:43:23,60,10763,16,44,7997.34,13695.02,0.00
2024-12-10 17:43:23,59,10763,16,43,8095.75,13695.05,0.00
2024-12-10 17:43:23,58,10763,15,43,8080.02,13695.90,0.00
2024-12-10 17:43:23,58,10764,15,43,8302.07,13696.00,0.00
2024-12-10 17:43:23,59,10764,16,43,8161.36,13696.02,0.00
2024-12-10 17:43:23,59,10765,16,43,8124.17,13697.00,0.00
2024-12-10 17:43:23,60,10765,16,44,7988.76,13697.02,0.00
2024-12-10 17:43:23,59,10765,16,43,8089.35,13697.05,0.00
2024-12-10 17:43:23,59,10766,16,43,8099.22,13698.00,0.00
2024-12-10 17:43:23,60,10766,16,44,7964.23,13698.02,0.00
2024-12-10 17:43:23,59,10766,15,44,7957.92,13698.64,0.00
2024-12-10 17:43:23,59,10767,15,44,8141.63,13699.00,0.00
2024-12-10 17:43:23,60,10767,15,45,8005.94,13699.02,0.00
2024-12-10 17:43:23,59,10767,15,44,8106.80,13699.05,0.00
2024-12-10 17:43:23,59,10768,15,44,8116.68,13700.00,0.00
2024-12-10 17:43:23,60,10768,15,45,7981.41,13700.02,0.00
2024-12-10 17:43:23,59,10768,14,45,8027.96,13700.22,0.00
2024-12-10 17:43:23,58,10768,13,45,8115.85,13700.59,0.00
2024-12-10 17:43:23,58,10769,13,45,8295.71,13701.00,0.00
2024-12-10 17:43:23,59,10769,14,45,8155.10,13701.02,0.00
2024-12-10 17:43:23,58,10769,14,44,8262.63,13701.05,0.00
2024-12-10 17:43:23,57,10769,13,44,8249.50,13701.93,0.00
2024-12-10 17:43:23,57,10770,13,44,8480.32,13702.00,0.00
2024-12-10 17:43:23,58,10770,13,45,8334.11,13702.02,0.00
2024-12-10 17:43:23,58,10771,13,45,8294.55,13703.00,0.00
2024-12-10 17:43:23,59,10771,14,45,8153.96,13703.02,0.00
2024-12-10 17:43:23,58,10771,14,44,8292.19,13703.02,0.00
2024-12-10 17:43:23,57,10771,14,43,8408.82,13703.04,0.00
2024-12-10 17:43:23,57,10772,14,43,8421.45,13704.00,0.00
2024-12-10 17:43:23,58,10772,14,44,8276.26,13704.02,0.00
2024-12-10 17:43:23,57,10772,13,44,8340.24,13704.16,0.00
2024-12-10 17:43:23,57,10773,13,44,8465.84,13705.00,0.00
2024-12-10 17:43:23,58,10773,14,44,8319.87,13705.02,0.00
2024-12-10 17:43:23,57,10773,14,43,8436.99,13705.04,0.00
2024-12-10 17:43:23,56,10773,13,43,8436.16,13705.54,0.00
2024-12-10 17:43:23,56,10774,13,43,8617.64,13706.00,0.00
2024-12-10 17:43:23,57,10774,13,44,8466.46,13706.02,0.00
2024-12-10 17:43:23,56,10774,13,43,8615.19,13706.02,0.00
2024-12-10 17:43:23,56,10775,13,43,8579.11,13707.00,0.00
2024-12-10 17:43:23,57,10775,14,43,8428.60,13707.02,0.00
2024-12-10 17:43:23,56,10775,14,42,8554.63,13707.02,0.00
2024-12-10 17:43:23,55,10775,13,42,8640.63,13707.51,0.00
2024-12-10 17:43:23,55,10776,13,42,8723.27,13708.00,0.00
2024-12-10 17:43:23,56,10776,14,42,8567.49,13708.02,0.00
2024-12-10 17:43:23,56,10777,14,42,8531.40,13709.00,0.00
2024-12-10 17:43:23,57,10777,14,43,8381.73,13709.02,0.00
2024-12-10 17:43:23,56,10777,14,42,8509.37,13709.02,0.00
2024-12-10 17:43:23,56,10778,14,42,8522.23,13710.00,0.00
2024-12-10 17:43:23,57,10778,15,42,8372.72,13710.02,0.00
2024-12-10 17:43:23,57,10779,15,42,8334.84,13711.00,0.00
2024-12-10 17:43:23,58,10779,16,42,8191.14,13711.02,0.00
2024-12-10 17:43:23,57,10779,16,41,8315.60,13711.02,0.00
2024-12-10 17:43:23,57,10780,16,41,8325.83,13712.00,0.00
2024-12-10 17:43:23,58,10780,17,41,8182.28,13712.02,0.00
2024-12-10 17:43:23,58,10781,17,41,8142.68,13713.00,0.00
2024-12-10 17:43:23,59,10781,18,41,8004.67,13713.02,0.00
2024-12-10 17:43:23,58,10781,18,40,8126.13,13713.02,0.00
2024-12-10 17:43:24,58,10782,18,40,8133.82,13714.00,0.00
2024-12-10 17:43:24,59,10782,18,41,7995.96,13714.02,0.00
2024-12-10 17:43:24,59,10782,18,41,7954.70,13715.00,0.00
2024-12-10 17:43:24,60,10782,18,42,7822.12,13715.02,0.00
2024-12-10 17:43:24,59,10782,18,41,7938.42,13715.02,0.00
2024-12-10 17:43:24,58,10782,17,41,7971.41,13715.40,0.00
2024-12-10 17:43:24,57,10782,16,41,8070.55,13715.68,0.00
2024-12-10 17:43:24,57,10783,16,41,8268.10,13716.00,0.00
2024-12-10 17:43:24,58,10783,16,42,8125.54,13716.02,0.00
2024-12-10 17:43:24,57,10783,15,42,8076.08,13716.86,0.00
2024-12-10 17:43:24,57,10784,15,42,8297.58,13717.00,0.00
2024-12-10 17:43:24,58,10784,16,42,8154.52,13717.02,0.00
2024-12-10 17:43:24,57,10784,16,41,8283.14,13717.02,0.00
2024-12-10 17:43:24,57,10785,16,41,8293.37,13718.00,0.00
2024-12-10 17:43:24,58,10785,17,41,8150.38,13718.02,0.00
2024-12-10 17:43:24,57,10785,16,41,8163.42,13718.05,0.00
2024-12-10 17:43:24,57,10786,16,41,8274.72,13719.00,0.00
2024-12-10 17:43:24,58,10786,16,42,8132.05,13719.02,0.00
2024-12-10 17:43:24,57,10786,16,41,8253.06,13719.02,0.00
2024-12-10 17:43:24,57,10787,16,41,8263.29,13720.00,0.00
2024-12-10 17:43:24,58,10787,17,41,8120.82,13720.02,0.00
2024-12-10 17:43:24,58,10788,17,41,8081.19,13721.00,0.00
2024-12-10 17:43:24,59,10788,17,42,7944.22,13721.02,0.00
2024-12-10 17:43:24,58,10788,17,41,8062.27,13721.02,0.00
2024-12-10 17:43:24,58,10789,17,41,8069.95,13722.00,0.00
2024-12-10 17:43:24,59,10789,17,42,7933.17,13722.02,0.00
2024-12-10 17:43:24,59,10790,17,42,7891.88,13723.00,0.00
2024-12-10 17:43:24,60,10790,17,43,7760.35,13723.02,0.00
2024-12-10 17:43:24,59,10790,17,42,7873.28,13723.02,0.00
2024-12-10 17:43:24,58,10790,16,42,7829.54,13723.66,0.00
2024-12-10 17:43:24,58,10791,16,42,8019.07,13724.00,0.00
2024-12-10 17:43:24,59,10791,17,42,7883.15,13724.02,0.00
2024-12-10 17:43:24,59,10792,17,42,7841.86,13725.00,0.00
2024-12-10 17:43:24,60,10792,18,42,7711.16,13725.02,0.00
2024-12-10 17:43:24,59,10792,18,41,7825.57,13725.02,0.00
2024-12-10 17:43:24,58,10792,17,41,7866.19,13725.69,0.00
2024-12-10 17:43:24,57,10792,16,41,7972.96,13725.79,0.00
2024-12-10 17:43:24,57,10793,16,41,8185.03,13726.00,0.00
2024-12-10 17:43:24,58,10793,17,41,8043.91,13726.02,0.00
2024-12-10 17:43:24,58,10794,17,41,8004.26,13727.00,0.00
2024-12-10 17:43:24,59,10794,18,41,7868.59,13727.02,0.00
2024-12-10 17:43:24,58,10794,18,40,7987.69,13727.02,0.00
2024-12-10 17:43:24,57,10794,17,40,8111.01,13727.14,0.00
2024-12-10 17:43:24,57,10795,17,40,8138.05,13728.00,0.00
2024-12-10 17:43:24,58,10795,17,41,7997.74,13728.02,0.00
2024-12-10 17:43:24,58,10796,17,41,7958.08,13729.00,0.00
2024-12-10 17:43:24,59,10796,17,42,7823.20,13729.02,0.00
2024-12-10 17:43:24,58,10796,17,41,7939.15,13729.02,0.00
2024-12-10 17:43:24,58,10797,17,41,7946.83,13730.00,0.00
2024-12-10 17:43:24,59,10797,18,41,7812.13,13730.02,0.00
2024-12-10 17:43:24,59,10798,18,41,7770.81,13731.00,0.00
2024-12-10 17:43:24,60,10798,18,42,7641.30,13731.02,0.00
2024-12-10 17:43:24,59,10798,18,41,7752.19,13731.02,0.00
2024-12-10 17:43:24,58,10798,17,41,7864.59,13731.16,0.00
2024-12-10 17:43:24,58,10799,17,41,7891.16,13732.00,0.00
2024-12-10 17:43:24,59,10799,18,41,7757.41,13732.02,0.00
2024-12-10 17:43:24,59,10800,18,41,7716.08,13733.00,0.00
2024-12-10 17:43:24,60,10800,19,41,7587.48,13733.02,0.00
2024-12-10 17:43:24,59,10800,19,40,7699.79,13733.02,0.00
2024-12-10 17:43:24,58,10800,18,40,7740.53,13733.67,0.00
2024-12-10 17:43:24,58,10801,18,40,7837.85,13734.00,0.00
2024-12-10 17:43:24,59,10801,19,40,7705.00,13734.02,0.00
2024-12-10 17:43:24,58,10801,18,40,7637.06,13734.90,0.00
2024-12-10 17:43:24,58,10802,18,40,7859.73,13735.00,0.00
2024-12-10 17:43:24,59,10802,18,41,7726.52,13735.02,0.00
2024-12-10 17:43:24,58,10802,18,40,7840.79,13735.02,0.00
2024-12-10 17:43:24,57,10802,17,40,7959.12,13735.16,0.00
2024-12-10 17:43:24,57,10803,17,40,7988.56,13736.00,0.00
2024-12-10 17:43:24,58,10803,18,40,7850.83,13736.02,0.00
2024-12-10 17:43:24,58,10804,18,40,7811.14,13737.00,0.00
2024-12-10 17:43:24,59,10804,18,41,7678.75,13737.02,0.00
2024-12-10 17:43:24,58,10804,18,40,7794.56,13737.02,0.00
2024-12-10 17:43:24,58,10805,18,40,7802.23,13738.00,0.00
2024-12-10 17:43:24,59,10805,19,40,7669.99,13738.02,0.00
2024-12-10 17:43:24,58,10805,18,40,7660.46,13738.69,0.00
2024-12-10 17:43:24,58,10806,18,40,7760.16,13739.00,0.00
2024-12-10 17:43:24,59,10806,19,40,7628.64,13739.02,0.00
2024-12-10 17:43:24,58,10806,19,39,7745.95,13739.02,0.00
2024-12-10 17:43:24,58,10807,19,39,7753.62,13740.00,0.00
2024-12-10 17:43:24,59,10807,20,39,7622.20,13740.02,0.00
2024-12-10 17:43:24,59,10808,20,39,7580.84,13741.00,0.00
2024-12-10 17:43:24,60,10808,21,39,7454.49,13741.02,0.00
2024-12-10 17:43:24,59,10808,21,38,7569.19,13741.02,0.00
2024-12-10 17:43:24,59,10809,21,38,7574.40,13742.00,0.00
2024-12-10 17:43:24,60,10809,22,38,7448.16,13742.02,0.00
2024-12-10 17:43:24,59,10809,21,38,7369.92,13742.92,0.00
2024-12-10 17:43:24,59,10810,21,38,7591.26,13743.00,0.00
2024-12-10 17:43:24,60,10810,22,38,7464.73,13743.02,0.00
2024-12-10 17:43:24,59,10810,22,37,7579.61,13743.02,0.00
2024-12-10 17:43:24,59,10811,22,37,7584.82,13744.00,0.00
2024-12-10 17:43:24,60,10811,22,38,7458.41,13744.02,0.00
2024-12-10 17:43:24,60,10812,22,38,7415.42,13745.00,0.00
2024-12-10 17:43:24,61,10812,23,38,7293.86,13745.02,0.00
2024-12-10 17:43:24,60,10812,23,37,7403.97,13745.02,0.00
2024-12-10 17:43:24,59,10812,22,37,7513.19,13745.14,0.00
2024-12-10 17:43:24,58,10812,21,37,7505.72,13745.90,0.00
2024-12-10 17:43:25,58,10813,21,37,7728.57,13746.00,0.00
2024-12-10 17:43:25,59,10813,22,37,7597.57,13746.02,0.00
2024-12-10 17:43:25,59,10814,22,37,7556.19,13747.00,0.00
2024-12-10 17:43:25,60,10814,22,38,7430.25,13747.02,0.00
2024-12-10 17:43:25,59,10814,22,37,7546.87,13747.02,0.00
2024-12-10 17:43:25,58,10814,21,37,7582.53,13747.71,0.00
2024-12-10 17:43:25,58,10815,21,37,7684.65,13748.00,0.00
2024-12-10 17:43:25,59,10815,21,38,7554.41,13748.02,0.00
2024-12-10 17:43:25,59,10816,21,38,7513.01,13749.00,0.00
2024-12-10 17:43:25,60,10816,22,38,7387.79,13749.02,0.00
2024-12-10 17:43:25,59,10816,22,37,7503.69,13749.02,0.00
2024-12-10 17:43:25,59,10817,22,37,7508.90,13750.00,0.00
2024-12-10 17:43:25,60,10817,22,38,7383.75,13750.02,0.00
2024-12-10 17:43:25,61,10816,23,38,7181.65,13750.31,0.00
2024-12-10 17:43:25,61,10817,23,38,7358.98,13751.00,0.00
2024-12-10 17:43:25,62,10817,23,39,7240.29,13751.02,0.00
2024-12-10 17:43:25,61,10817,23,38,7316.15,13751.02,0.00
2024-12-10 17:43:25,61,10818,23,38,7542.12,13752.00,0.00
2024-12-10 17:43:25,62,10818,24,38,7420.48,13752.02,0.00
2024-12-10 17:43:25,62,10819,24,38,7375.60,13753.00,0.00
2024-12-10 17:43:25,63,10819,25,38,7258.52,13753.02,0.00
2024-12-10 17:43:25,62,10819,25,37,7357.85,13753.02,0.00
2024-12-10 17:43:25,62,10820,25,37,7356.17,13754.00,0.00
2024-12-10 17:43:25,63,10820,25,38,7239.40,13754.02,0.00
2024-12-10 17:43:25,62,10820,24,38,7196.50,13754.21,0.00
2024-12-10 17:43:25,62,10821,24,38,7310.11,13755.00,0.00
2024-12-10 17:43:25,63,10821,25,38,7194.08,13755.02,0.00
2024-12-10 17:43:25,62,10821,25,37,7294.58,13755.02,0.00
2024-12-10 17:43:25,62,10822,25,37,7292.89,13756.00,0.00
2024-12-10 17:43:25,63,10822,26,37,7177.13,13756.02,0.00
2024-12-10 17:43:25,62,10822,25,37,7177.53,13756.05,0.00
2024-12-10 17:43:25,62,10822,25,37,7269.02,13757.00,0.00
2024-12-10 17:43:25,63,10822,26,37,7153.64,13757.02,0.00
2024-12-10 17:43:25,62,10822,26,36,7255.70,13757.02,0.00
2024-12-10 17:43:25,62,10823,26,36,7254.01,13758.00,0.00
2024-12-10 17:43:25,63,10823,26,37,7138.87,13758.02,0.00
2024-12-10 17:43:25,62,10823,25,37,7058.99,13758.58,0.00
2024-12-10 17:43:25,62,10824,25,37,7223.47,13759.00,0.00
2024-12-10 17:43:25,63,10824,26,37,7108.81,13759.02,0.00
2024-12-10 17:43:25,62,10824,26,36,7212.38,13759.02,0.00
2024-12-10 17:43:25,61,10824,25,36,7203.32,13759.51,0.00
2024-12-10 17:43:25,61,10825,25,36,7361.54,13760.00,0.00
2024-12-10 17:43:25,62,10825,25,37,7242.81,13760.02,0.00
2024-12-10 17:43:25,62,10826,25,37,7199.25,13761.00,0.00
2024-12-10 17:43:25,63,10826,25,38,7084.98,13761.02,0.00
2024-12-10 17:43:25,62,10826,25,37,7185.94,13761.02,0.00
2024-12-10 17:43:25,62,10827,25,37,7184.24,13762.00,0.00
2024-12-10 17:43:25,63,10827,26,37,7070.20,13762.02,0.00
2024-12-10 17:43:25,62,10827,25,37,6966.89,13762.97,0.00
2024-12-10 17:43:25,62,10828,25,37,7184.45,13763.00,0.00
2024-12-10 17:43:25,63,10828,25,38,7070.41,13763.02,0.00
2024-12-10 17:43:25,62,10828,25,37,7173.35,13763.02,0.00
2024-12-10 17:43:25,61,10828,24,37,7261.69,13763.21,0.00
2024-12-10 17:43:25,60,10828,23,37,7316.43,13763.68,0.00
2024-12-10 17:43:25,60,10829,23,37,7410.71,13764.00,0.00
2024-12-10 17:43:25,61,10829,24,37,7289.22,13764.02,0.00
2024-12-10 17:43:25,61,10830,24,37,7244.62,13765.00,0.00
2024-12-10 17:43:25,62,10830,25,37,7127.77,13765.02,0.00
2024-12-10 17:43:25,61,10830,25,36,7237.85,13765.02,0.00
2024-12-10 17:43:25,60,10830,24,36,7264.71,13765.68,0.00
2024-12-10 17:43:25,60,10831,24,36,7359.01,13766.00,0.00
2024-12-10 17:43:25,61,10831,25,36,7238.37,13766.02,0.00
2024-12-10 17:43:25,61,10832,25,36,7193.76,13767.00,0.00
2024-12-10 17:43:25,62,10832,25,37,7077.73,13767.02,0.00
2024-12-10 17:43:25,61,10832,25,36,7189.25,13767.02,0.00
2024-12-10 17:43:25,60,10832,24,36,7185.54,13767.80,0.00
2024-12-10 17:43:25,60,10833,24,36,7387.62,13768.00,0.00
2024-12-10 17:43:25,61,10833,24,37,7266.51,13768.02,0.00
2024-12-10 17:43:25,60,10833,23,37,7185.92,13768.60,0.00
2024-12-10 17:43:25,60,10834,23,37,7360.62,13769.00,0.00
2024-12-10 17:43:25,61,10834,24,37,7239.95,13769.02,0.00
2024-12-10 17:43:25,60,10834,24,36,7358.32,13769.02,0.00
2024-12-10 17:43:25,59,10834,23,36,7333.91,13769.58,0.00
2024-12-10 17:43:25,59,10835,23,36,7509.26,13770.00,0.00
2024-12-10 17:43:25,60,10835,23,37,7384.10,13770.02,0.00
2024-12-10 17:43:25,59,10835,23,36,7460.24,13770.02,0.00
2024-12-10 17:43:25,58,10835,22,36,7496.43,13770.41,0.00
2024-12-10 17:43:25,58,10836,22,36,7653.53,13771.00,0.00
2024-12-10 17:43:25,59,10836,23,36,7523.81,13771.02,0.00
2024-12-10 17:43:25,58,10836,23,35,7603.67,13771.02,0.00
2024-12-10 17:43:25,57,10836,22,35,7710.55,13771.21,0.00
2024-12-10 17:43:25,57,10837,22,35,7747.29,13772.00,0.00
2024-12-10 17:43:25,58,10837,23,35,7613.72,13772.02,0.00
2024-12-10 17:43:25,57,10837,23,34,7696.55,13772.02,0.00
2024-12-10 17:43:25,57,10838,23,34,7706.78,13773.00,0.00
2024-12-10 17:43:25,58,10838,23,35,7573.90,13773.02,0.00
2024-12-10 17:43:25,57,10838,22,35,7554.70,13773.42,0.00
2024-12-10 17:43:25,56,10838,21,35,7655.32,13773.68,0.00
2024-12-10 17:43:25,56,10839,21,35,7857.27,13774.00,0.00
2024-12-10 17:43:25,57,10839,21,36,7719.42,13774.02,0.00
2024-12-10 17:43:25,56,10839,21,35,7854.81,13774.02,0.00
2024-12-10 17:43:25,56,10840,21,35,7867.67,13775.00,0.00
2024-12-10 17:43:25,57,10840,22,35,7729.64,13775.02,0.00
2024-12-10 17:43:25,56,10840,21,35,7746.18,13775.54,0.00
2024-12-10 17:43:25,56,10841,21,35,7899.60,13776.00,0.00
2024-12-10 17:43:25,57,10841,21,36,7761.01,13776.02,0.00
2024-12-10 17:43:25,57,10842,21,36,7768.93,13777.00,0.00
2024-12-10 17:43:25,58,10842,22,36,7634.99,13777.02,0.00
2024-12-10 17:43:25,57,10842,21,36,7686.82,13777.25,0.00
2024-12-10 17:43:26,57,10843,21,36,7739.77,13778.00,0.00
2024-12-10 17:43:26,58,10843,21,37,7606.33,13778.02,0.00
2024-12-10 17:43:26,57,10843,21,36,7708.35,13778.02,0.00
2024-12-10 17:43:26,57,10844,21,36,7718.58,13779.00,0.00
2024-12-10 17:43:26,58,10844,22,36,7585.50,13779.02,0.00
2024-12-10 17:43:26,57,10844,22,35,7670.23,13779.02,0.00
2024-12-10 17:43:26,57,10845,22,35,7680.46,13780.00,0.00
2024-12-10 17:43:26,58,10845,22,36,7548.03,13780.02,0.00
2024-12-10 17:43:26,57,10845,22,35,7632.10,13780.02,0.00
2024-12-10 17:43:26,57,10846,22,35,7642.33,13781.00,0.00
2024-12-10 17:43:26,58,10846,23,35,7510.57,13781.02,0.00
2024-12-10 17:43:26,57,10846,23,34,7593.98,13781.02,0.00
2024-12-10 17:43:26,56,10846,22,34,7705.03,13781.20,0.00
2024-12-10 17:43:26,56,10847,22,34,7742.45,13782.00,0.00
2024-12-10 17:43:26,57,10847,22,35,7606.62,13782.02,0.00
2024-12-10 17:43:26,56,10847,22,34,7690.77,13782.02,0.00
2024-12-10 17:43:26,55,10847,21,34,7757.94,13782.05,0.00
2024-12-10 17:43:26,55,10848,21,34,7878.78,13783.00,0.00
2024-12-10 17:43:26,56,10848,21,35,7738.09,13783.02,0.00
2024-12-10 17:43:26,56,10849,21,35,7701.73,13784.00,0.00
2024-12-10 17:43:26,57,10849,21,36,7566.61,13784.02,0.00
2024-12-10 17:43:26,56,10849,21,35,7699.27,13784.02,0.00
2024-12-10 17:43:26,56,10850,21,35,7712.13,13785.00,0.00
2024-12-10 17:43:26,57,10850,21,36,7576.83,13785.02,0.00
2024-12-10 17:43:26,56,10850,20,36,7572.11,13785.66,0.00
2024-12-10 17:43:26,56,10851,20,36,7771.77,13786.00,0.00
2024-12-10 17:43:26,57,10851,21,36,7635.43,13786.02,0.00
2024-12-10 17:43:26,56,10851,21,35,7769.31,13786.02,0.00
2024-12-10 17:43:26,55,10851,20,35,7727.88,13786.64,0.00
2024-12-10 17:43:26,55,10852,20,35,7928.69,13787.00,0.00
2024-12-10 17:43:26,56,10852,20,36,7787.11,13787.02,0.00
2024-12-10 17:43:26,56,10853,20,36,7750.74,13788.00,0.00
2024-12-10 17:43:26,57,10853,20,37,7614.76,13788.02,0.00
2024-12-10 17:43:26,56,10853,20,36,7745.82,13788.02,0.00
2024-12-10 17:43:26,56,10854,20,36,7758.69,13789.00,0.00
2024-12-10 17:43:26,57,10854,20,37,7622.58,13789.02,0.00
2024-12-10 17:43:26,56,10854,19,37,7569.52,13789.84,0.00
2024-12-10 17:43:26,56,10855,19,37,7793.73,13790.00,0.00
2024-12-10 17:43:26,57,10855,20,37,7657.00,13790.02,0.00
2024-12-10 17:43:26,56,10855,19,37,7739.55,13790.02,0.00
2024-12-10 17:43:26,55,10855,19,36,7867.74,13790.02,0.00
2024-12-10 17:43:26,55,10856,19,36,7983.65,13791.00,0.00
2024-12-10 17:43:26,56,10856,20,36,7841.09,13791.02,0.00
2024-12-10 17:43:26,56,10857,20,36,7804.71,13792.00,0.00
2024-12-10 17:43:26,57,10857,21,36,7667.79,13792.02,0.00
2024-12-10 17:43:26,56,10857,21,35,7794.86,13792.02,0.00
2024-12-10 17:43:26,56,10858,21,35,7807.74,13793.00,0.00
2024-12-10 17:43:26,57,10858,22,35,7670.76,13793.02,0.00
2024-12-10 17:43:26,56,10858,21,35,7603.79,13793.89,0.00
2024-12-10 17:43:26,56,10859,21,35,7835.40,13794.00,0.00
2024-12-10 17:43:26,57,10859,21,36,7697.94,13794.02,0.00
2024-12-10 17:43:26,56,10859,21,35,7828.01,13794.02,0.00
2024-12-10 17:43:26,56,10860,21,35,7840.90,13795.00,0.00
2024-12-10 17:43:26,57,10860,22,35,7703.34,13795.02,0.00
2024-12-10 17:43:26,56,10860,21,35,7771.96,13795.16,0.00
2024-12-10 17:43:26,56,10861,21,35,7804.51,13796.00,0.00
2024-12-10 17:43:26,57,10861,22,35,7667.59,13796.02,0.00
2024-12-10 17:43:26,56,10861,22,34,7794.66,13796.02,0.00
2024-12-10 17:43:26,55,10861,21,34,7858.73,13796.31,0.00
2024-12-10 17:43:26,55,10862,21,34,8014.72,13797.00,0.00
2024-12-10 17:43:26,56,10862,22,34,7871.60,13797.02,0.00
2024-12-10 17:43:26,56,10862,22,34,7835.21,13798.00,0.00
2024-12-10 17:43:26,57,10862,23,34,7697.75,13798.02,0.00
2024-12-10 17:43:26,56,10862,23,33,7825.35,13798.02,0.00
2024-12-10 17:43:26,56,10863,23,33,7838.24,13799.00,0.00
2024-12-10 17:43:26,57,10863,24,33,7700.73,13799.02,0.00
2024-12-10 17:43:26,57,10864,24,33,7662.55,13800.00,0.00
2024-12-10 17:43:26,58,10864,24,34,7530.44,13800.02,0.00
2024-12-10 17:43:26,57,10864,24,33,7655.29,13800.02,0.00
2024-12-10 17:43:26,57,10865,24,33,7665.53,13801.00,0.00
2024-12-10 17:43:26,58,10865,24,34,7533.36,13801.02,0.00
2024-12-10 17:43:26,58,10866,24,34,7493.45,13802.00,0.00
2024-12-10 17:43:26,59,10866,24,35,7366.45,13802.02,0.00
2024-12-10 17:43:26,58,10866,24,34,7488.69,13802.02,0.00
2024-12-10 17:43:26,57,10866,23,34,7446.25,13802.96,0.00
2024-12-10 17:43:26,57,10867,23,34,7683.59,13803.00,0.00
2024-12-10 17:43:26,58,10867,23,35,7551.11,13803.02,0.00
2024-12-10 17:43:26,57,10867,22,35,7526.21,13803.12,0.00
2024-12-10 17:43:26,56,10867,21,35,7660.61,13803.13,0.00
2024-12-10 17:43:26,56,10868,21,35,7786.85,13804.00,0.00
2024-12-10 17:43:26,57,10868,22,35,7650.24,13804.02,0.00
2024-12-10 17:43:26,56,10868,22,34,7774.53,13804.02,0.00
2024-12-10 17:43:26,56,10869,22,34,7787.42,13805.00,0.00
2024-12-10 17:43:26,57,10869,22,35,7650.80,13805.02,0.00
2024-12-10 17:43:26,56,10869,21,35,7706.11,13805.16,0.00
2024-12-10 17:43:26,56,10870,21,35,7837.29,13806.00,0.00
2024-12-10 17:43:26,57,10870,21,36,7699.79,13806.02,0.00
2024-12-10 17:43:26,56,10870,21,35,7827.43,13806.02,0.00
2024-12-10 17:43:26,56,10871,21,35,7840.32,13807.00,0.00
2024-12-10 17:43:26,57,10871,21,36,7702.77,13807.02,0.00
2024-12-10 17:43:26,57,10872,21,36,7664.57,13808.00,0.00
2024-12-10 17:43:26,58,10872,21,37,7532.42,13808.02,0.00
2024-12-10 17:43:26,57,10872,21,36,7654.88,13808.02,0.00
2024-12-10 17:43:26,56,10872,20,36,7688.37,13808.71,0.00
2024-12-10 17:43:26,56,10873,20,36,7895.71,13809.00,0.00
2024-12-10 17:43:26,57,10873,20,37,7757.18,13809.02,0.00
2024-12-10 17:43:27,57,10874,20,37,7718.98,13810.00,0.00
2024-12-10 17:43:27,58,10874,21,37,7585.90,13810.02,0.00
2024-12-10 17:43:27,57,10874,21,36,7702.03,13810.04,0.00
2024-12-10 17:43:27,56,10874,20,36,7682.21,13810.91,0.00
2024-12-10 17:43:27,56,10875,20,36,7916.58,13811.00,0.00
2024-12-10 17:43:27,57,10875,21,36,7777.69,13811.02,0.00
2024-12-10 17:43:27,56,10875,20,36,7832.25,13811.27,0.00
2024-12-10 17:43:27,56,10876,20,36,7879.61,13812.00,0.00
2024-12-10 17:43:27,57,10876,21,36,7741.37,13812.02,0.00
2024-12-10 17:43:27,56,10876,21,35,7862.35,13812.04,0.00
2024-12-10 17:43:27,56,10877,21,35,7877.71,13813.00,0.00
2024-12-10 17:43:27,57,10877,22,35,7739.51,13813.02,0.00
2024-12-10 17:43:27,57,10878,22,35,7708.76,13814.00,0.00
2024-12-10 17:43:27,58,10878,23,35,7575.85,13814.02,0.00
2024-12-10 17:43:27,57,10878,23,34,7679.68,13814.04,0.00
2024-12-10 17:43:27,57,10879,23,34,7692.35,13815.00,0.00
2024-12-10 17:43:27,58,10879,23,35,7559.72,13815.02,0.00
2024-12-10 17:43:27,57,10879,22,35,7626.94,13815.12,0.00
2024-12-10 17:43:27,57,10880,22,35,7663.59,13816.00,0.00
2024-12-10 17:43:27,58,10880,22,36,7531.46,13816.02,0.00
2024-12-10 17:43:27,57,10880,22,35,7632.08,13816.04,0.00
2024-12-10 17:43:27,56,10880,21,35,7674.94,13816.70,0.00
2024-12-10 17:43:27,56,10881,21,35,7781.26,13817.00,0.00
2024-12-10 17:43:27,57,10881,21,36,7644.75,13817.02,0.00
2024-12-10 17:43:27,56,10881,20,36,7719.60,13817.11,0.00
2024-12-10 17:43:27,55,10881,19,36,7857.45,13817.11,0.00
2024-12-10 17:43:27,55,10882,19,36,7893.74,13818.00,0.00
2024-12-10 17:43:27,56,10882,20,36,7752.78,13818.02,0.00
2024-12-10 17:43:27,55,10882,20,35,7863.60,13818.04,0.00
2024-12-10 17:43:27,55,10883,20,35,7881.75,13819.00,0.00
2024-12-10 17:43:27,56,10883,21,35,7741.01,13819.02,0.00
2024-12-10 17:43:27,55,10883,20,35,7787.03,13819.33,0.00
2024-12-10 17:43:27,54,10883,19,35,7816.25,13819.87,0.00
2024-12-10 17:43:27,54,10884,19,35,8054.33,13820.00,0.00
2024-12-10 17:43:27,55,10884,19,36,7907.89,13820.02,0.00
2024-12-10 17:43:27,54,10884,19,35,8023.62,13820.04,0.00
2024-12-10 17:43:27,54,10885,19,35,8044.67,13821.00,0.00
2024-12-10 17:43:27,55,10885,19,36,7898.41,13821.02,0.00
2024-12-10 17:43:27,55,10886,19,36,7863.80,13822.00,0.00
2024-12-10 17:43:27,56,10886,19,37,7723.37,13822.02,0.00
2024-12-10 17:43:27,55,10886,19,36,7836.16,13822.04,0.00
2024-12-10 17:43:27,54,10886,18,36,7838.39,13822.85,0.00
2024-12-10 17:43:27,54,10887,18,36,8074.00,13823.00,0.00
2024-12-10 17:43:27,55,10887,18,37,7927.20,13823.02,0.00
2024-12-10 17:43:27,55,10888,18,37,7894.72,13824.00,0.00
2024-12-10 17:43:27,56,10888,18,38,7753.74,13824.02,0.00
2024-12-10 17:43:27,55,10888,18,37,7864.56,13824.04,0.00
2024-12-10 17:43:27,54,10888,17,37,7964.56,13824.20,0.00
2024-12-10 17:43:27,54,10889,17,37,8111.01,13825.00,0.00
2024-12-10 17:43:27,55,10889,18,37,7963.53,13825.02,0.00
2024-12-10 17:43:27,54,10889,17,37,7990.77,13825.28,0.00
2024-12-10 17:43:27,54,10890,17,37,8147.44,13826.00,0.00
2024-12-10 17:43:27,55,10890,17,38,7999.30,13826.02,0.00
2024-12-10 17:43:27,54,10890,17,37,8111.60,13826.04,0.00
2024-12-10 17:43:27,54,10891,17,37,8132.67,13827.00,0.00
2024-12-10 17:43:27,55,10891,18,37,7984.80,13827.02,0.00
2024-12-10 17:43:27,55,10892,18,37,7955.84,13828.00,0.00
2024-12-10 17:43:27,56,10892,19,37,7813.77,13828.02,0.00
2024-12-10 17:43:27,55,10892,19,36,7920.64,13828.04,0.00
2024-12-10 17:43:27,55,10893,19,36,7938.81,13829.00,0.00
2024-12-10 17:43:27,56,10893,20,36,7797.05,13829.02,0.00
2024-12-10 17:43:27,55,10893,19,36,7870.95,13829.13,0.00
2024-12-10 17:43:27,55,10894,19,36,7908.75,13830.00,0.00
2024-12-10 17:43:27,56,10894,20,36,7767.52,13830.02,0.00
2024-12-10 17:43:27,55,10894,20,35,7876.06,13830.04,0.00
2024-12-10 17:43:27,55,10895,20,35,7894.23,13831.00,0.00
2024-12-10 17:43:27,56,10895,20,36,7753.26,13831.02,0.00
2024-12-10 17:43:27,56,10896,20,36,7723.76,13832.00,0.00
2024-12-10 17:43:27,57,10896,20,37,7588.25,13832.02,0.00
2024-12-10 17:43:27,56,10896,20,36,7691.65,13832.04,0.00
2024-12-10 17:43:27,56,10897,20,36,7707.02,13833.00,0.00
2024-12-10 17:43:27,57,10897,20,37,7571.81,13833.02,0.00
2024-12-10 17:43:27,56,10897,19,37,7704.55,13833.02,0.00
2024-12-10 17:43:27,56,10898,19,37,7681.88,13834.00,0.00
2024-12-10 17:43:27,57,10898,19,38,7547.11,13834.02,0.00
2024-12-10 17:43:27,56,10898,19,37,7644.83,13834.04,0.00
2024-12-10 17:43:27,55,10898,18,37,7767.25,13834.07,0.00
2024-12-10 17:43:27,55,10899,18,37,7891.05,13835.00,0.00
2024-12-10 17:43:27,56,10899,18,38,7750.14,13835.02,0.00
2024-12-10 17:43:27,56,10900,18,38,7723.54,13836.00,0.00
2024-12-10 17:43:27,57,10900,19,38,7588.04,13836.02,0.00
2024-12-10 17:43:27,56,10900,19,37,7688.95,13836.04,0.00
2024-12-10 17:43:27,55,10900,18,37,7750.48,13836.60,0.00
2024-12-10 17:43:27,54,10900,17,37,7860.74,13836.70,0.00
2024-12-10 17:43:27,54,10901,17,37,8076.19,13837.00,0.00
2024-12-10 17:43:27,55,10901,17,38,7929.35,13837.02,0.00
2024-12-10 17:43:27,54,10901,16,38,7888.92,13837.80,0.00
2024-12-10 17:43:27,54,10902,16,38,8117.13,13838.00,0.00
2024-12-10 17:43:27,55,10902,16,39,7969.55,13838.02,0.00
2024-12-10 17:43:27,54,10902,16,38,8081.26,13838.04,0.00
2024-12-10 17:43:27,53,10902,15,38,8152.92,13838.32,0.00
2024-12-10 17:43:27,53,10903,15,38,8320.49,13839.00,0.00
2024-12-10 17:43:27,54,10903,15,39,8166.41,13839.02,0.00
2024-12-10 17:43:27,53,10903,14,39,8247.38,13839.02,0.00
2024-12-10 17:43:27,52,10903,13,39,8273.44,13839.58,0.00
2024-12-10 17:43:27,52,10904,13,39,8481.37,13840.00,0.00
2024-12-10 17:43:27,53,10904,14,39,8321.34,13840.02,0.00
2024-12-10 17:43:27,52,10904,14,38,8438.79,13840.04,0.00
2024-12-10 17:43:27,52,10905,14,38,8466.01,13841.00,0.00
2024-12-10 17:43:27,53,10905,15,38,8306.27,13841.02,0.00
2024-12-10 17:43:27,52,10905,14,38,8285.89,13841.75,0.00
2024-12-10 17:43:27,52,10906,14,38,8517.66,13842.00,0.00
2024-12-10 17:43:28,53,10906,14,39,8356.95,13842.02,0.00
2024-12-10 17:43:28,52,10906,14,38,8475.07,13842.04,0.00
2024-12-10 17:43:28,52,10907,14,38,8502.30,13843.00,0.00
2024-12-10 17:43:28,53,10907,15,38,8341.88,13843.02,0.00
2024-12-10 17:43:28,53,10908,15,38,8313.63,13844.00,0.00
2024-12-10 17:43:28,54,10908,16,38,8159.67,13844.02,0.00
2024-12-10 17:43:28,53,10908,16,37,8271.84,13844.04,0.00
2024-12-10 17:43:28,53,10909,16,37,8295.94,13845.00,0.00
2024-12-10 17:43:28,54,10909,16,38,8142.32,13845.02,0.00
2024-12-10 17:43:28,54,10910,16,38,8116.39,13846.00,0.00
2024-12-10 17:43:28,55,10910,16,39,7968.82,13846.02,0.00
2024-12-10 17:43:28,54,10910,16,38,8075.37,13846.04,0.00
2024-12-10 17:43:28,53,10910,15,38,8179.05,13846.21,0.00
2024-12-10 17:43:28,53,10911,15,38,8331.10,13847.00,0.00
2024-12-10 17:43:28,54,10911,15,39,8176.83,13847.02,0.00
2024-12-10 17:43:28,54,10912,15,39,8153.54,13848.00,0.00
2024-12-10 17:43:28,55,10912,15,40,8005.29,13848.02,0.00
2024-12-10 17:43:28,54,10912,15,39,8104.83,13848.07,0.00
2024-12-10 17:43:28,53,10912,14,39,8099.67,13848.89,0.00
2024-12-10 17:43:28,53,10913,14,39,8345.37,13849.00,0.00
2024-12-10 17:43:28,54,10913,15,39,8190.83,13849.02,0.00
2024-12-10 17:43:28,53,10913,14,39,8199.84,13849.64,0.00
2024-12-10 17:43:28,53,10914,14,39,8411.79,13850.00,0.00
2024-12-10 17:43:28,54,10914,15,39,8256.01,13850.02,0.00
2024-12-10 17:43:28,54,10915,15,39,8225.13,13851.00,0.00
2024-12-10 17:43:28,55,10915,15,40,8075.59,13851.02,0.00
2024-12-10 17:43:28,54,10915,15,39,8189.23,13851.06,0.00
2024-12-10 17:43:28,53,10915,14,39,8260.54,13851.64,0.00
2024-12-10 17:43:28,53,10916,14,39,8367.99,13852.00,0.00
2024-12-10 17:43:28,54,10916,15,39,8213.02,13852.02,0.00
2024-12-10 17:43:28,53,10916,15,38,8328.79,13852.06,0.00
2024-12-10 17:43:28,52,10916,14,38,8478.33,13852.13,0.00
2024-12-10 17:43:28,52,10917,14,38,8518.87,13853.00,0.00
2024-12-10 17:43:28,53,10917,15,38,8358.13,13853.02,0.00
2024-12-10 17:43:28,53,10918,15,38,8327.37,13854.00,0.00
2024-12-10 17:43:28,54,10918,16,38,8173.16,13854.02,0.00
2024-12-10 17:43:28,53,10918,16,37,8290.78,13854.06,0.00
2024-12-10 17:43:28,53,10919,16,37,8317.51,13855.00,0.00
2024-12-10 17:43:28,54,10919,16,38,8163.49,13855.02,0.00
2024-12-10 17:43:28,54,10920,16,38,8130.72,13856.00,0.00
2024-12-10 17:43:28,55,10920,17,38,7982.89,13856.02,0.00
2024-12-10 17:43:28,54,10920,17,37,8094.80,13856.06,0.00
2024-12-10 17:43:28,53,10920,16,37,8239.71,13856.11,0.00
2024-12-10 17:43:28,53,10921,16,37,8274.27,13857.00,0.00
2024-12-10 17:43:28,54,10921,17,37,8121.04,13857.02,0.00
2024-12-10 17:43:28,54,10922,17,37,8088.27,13858.00,0.00
2024-12-10 17:43:28,55,10922,18,37,7941.21,13858.02,0.00
2024-12-10 17:43:28,54,10922,18,36,8054.91,13858.06,0.00
2024-12-10 17:43:28,54,10923,18,36,8078.58,13859.00,0.00
2024-12-10 17:43:28,55,10923,19,36,7931.70,13859.02,0.00
2024-12-10 17:43:28,54,10923,18,36,7881.19,13859.50,0.00
2024-12-10 17:43:28,54,10924,18,36,8068.90,13860.00,0.00
2024-12-10 17:43:28,55,10924,18,37,7922.19,13860.02,0.00
2024-12-10 17:43:28,54,10924,18,36,8038.11,13860.06,0.00
2024-12-10 17:43:28,54,10925,18,36,8061.78,13861.00,0.00
2024-12-10 17:43:28,55,10925,19,36,7915.20,13861.02,0.00
2024-12-10 17:43:28,55,10926,19,36,7883.44,13862.00,0.00
2024-12-10 17:43:28,56,10926,20,36,7742.67,13862.02,0.00
2024-12-10 17:43:28,55,10926,20,35,7845.64,13862.05,0.00
2024-12-10 17:43:28,55,10927,20,35,7866.37,13863.00,0.00
2024-12-10 17:43:28,56,10927,21,35,7725.90,13863.02,0.00
2024-12-10 17:43:28,55,10927,20,35,7815.96,13863.04,0.00
2024-12-10 17:43:28,55,10928,20,35,7884.58,13864.00,0.00
2024-12-10 17:43:28,56,10928,20,36,7743.79,13864.02,0.00
2024-12-10 17:43:28,55,10928,20,35,7834.18,13864.07,0.00
2024-12-10 17:43:28,55,10929,20,35,7857.42,13865.00,0.00
2024-12-10 17:43:28,56,10929,20,36,7717.11,13865.02,0.00
2024-12-10 17:43:28,55,10929,19,36,7771.71,13865.04,0.00
2024-12-10 17:43:28,55,10930,19,36,7840.34,13866.00,0.00
2024-12-10 17:43:28,56,10930,19,37,7700.33,13866.02,0.00
2024-12-10 17:43:28,55,10930,19,36,7794.97,13866.05,0.00
2024-12-10 17:43:28,55,10931,19,36,7815.69,13867.00,0.00
2024-12-10 17:43:28,56,10931,19,37,7676.13,13867.02,0.00
2024-12-10 17:43:28,55,10931,18,37,7732.49,13867.04,0.00
2024-12-10 17:43:28,55,10932,18,37,7801.13,13868.00,0.00
2024-12-10 17:43:28,56,10932,19,37,7661.82,13868.02,0.00
2024-12-10 17:43:28,55,10932,19,36,7760.78,13868.04,0.00
2024-12-10 17:43:28,55,10933,19,36,7778.99,13869.00,0.00
2024-12-10 17:43:28,56,10933,19,37,7640.08,13869.02,0.00
2024-12-10 17:43:28,56,10934,19,37,7614.93,13870.00,0.00
2024-12-10 17:43:28,57,10934,20,37,7481.34,13870.02,0.00
2024-12-10 17:43:28,56,10934,20,36,7577.78,13870.04,0.00
2024-12-10 17:43:28,55,10934,19,36,7688.80,13870.13,0.00
2024-12-10 17:43:28,54,10934,18,36,7760.26,13870.63,0.00
2024-12-10 17:43:28,53,10934,17,36,7904.07,13870.64,0.00
2024-12-10 17:43:28,53,10935,17,36,8116.29,13871.00,0.00
2024-12-10 17:43:28,54,10935,18,36,7965.99,13871.02,0.00
2024-12-10 17:43:28,54,10936,18,36,7939.06,13872.00,0.00
2024-12-10 17:43:28,55,10936,18,37,7794.71,13872.02,0.00
2024-12-10 17:43:28,54,10936,18,36,7900.53,13872.04,0.00
2024-12-10 17:43:28,54,10937,18,36,7921.65,13873.00,0.00
2024-12-10 17:43:28,55,10937,19,36,7777.62,13873.02,0.00
2024-12-10 17:43:28,54,10937,19,35,7919.08,13873.02,0.00
2024-12-10 17:43:28,54,10938,19,35,7891.84,13874.00,0.00
2024-12-10 17:43:28,55,10938,19,36,7748.36,13874.02,0.00
2024-12-10 17:43:28,54,10938,19,35,7858.44,13874.02,0.00
2024-12-10 17:43:28,53,10938,18,35,7918.05,13874.64,0.00
2024-12-10 17:43:28,53,10939,18,35,8025.62,13875.00,0.00
2024-12-10 17:43:28,54,10939,18,36,7877.00,13875.02,0.00
2024-12-10 17:43:29,54,10940,18,36,7844.16,13876.00,0.00
2024-12-10 17:43:29,55,10940,19,36,7701.54,13876.02,0.00
2024-12-10 17:43:29,54,10940,19,35,7813.33,13876.02,0.00
2024-12-10 17:43:29,53,10940,18,35,7856.38,13876.70,0.00
2024-12-10 17:43:29,53,10941,18,35,8076.52,13877.00,0.00
2024-12-10 17:43:29,54,10941,19,35,7926.96,13877.02,0.00
2024-12-10 17:43:29,54,10942,19,35,7894.12,13878.00,0.00
2024-12-10 17:43:29,55,10942,19,36,7750.59,13878.02,0.00
2024-12-10 17:43:29,54,10942,19,35,7865.85,13878.02,0.00
2024-12-10 17:43:29,54,10943,19,35,7884.41,13879.00,0.00
2024-12-10 17:43:29,55,10943,19,36,7741.05,13879.02,0.00
2024-12-10 17:43:29,55,10944,19,36,7706.52,13880.00,0.00
2024-12-10 17:43:29,56,10944,19,37,7568.91,13880.02,0.00
2024-12-10 17:43:29,55,10944,19,36,7681.29,13880.02,0.00
2024-12-10 17:43:29,54,10944,18,36,7666.97,13880.89,0.00
2024-12-10 17:43:29,54,10945,18,36,7908.68,13881.00,0.00
2024-12-10 17:43:29,55,10945,19,36,7764.89,13881.02,0.00
2024-12-10 17:43:29,55,10946,19,36,7739.71,13882.00,0.00
2024-12-10 17:43:29,56,10946,20,36,7601.50,13882.02,0.00
2024-12-10 17:43:29,55,10946,20,35,7704.37,13882.02,0.00
2024-12-10 17:43:29,55,10947,20,35,7720.07,13883.00,0.00
2024-12-10 17:43:29,56,10947,21,35,7582.21,13883.02,0.00
2024-12-10 17:43:29,55,10947,20,35,7573.68,13883.05,0.00
2024-12-10 17:43:29,55,10948,20,35,7695.39,13884.00,0.00
2024-12-10 17:43:29,56,10948,20,36,7557.97,13884.02,0.00
2024-12-10 17:43:29,55,10948,20,35,7662.57,13884.02,0.00
2024-12-10 17:43:29,54,10948,19,35,7717.36,13884.65,0.00
2024-12-10 17:43:29,54,10949,19,35,7823.03,13885.00,0.00
2024-12-10 17:43:29,55,10949,19,36,7680.79,13885.02,0.00
2024-12-10 17:43:29,55,10950,19,36,7653.12,13886.00,0.00
2024-12-10 17:43:29,56,10950,19,37,7516.46,13886.02,0.00
2024-12-10 17:43:29,55,10950,19,36,7622.83,13886.02,0.00
2024-12-10 17:43:29,54,10950,18,36,7636.30,13886.76,0.00
2024-12-10 17:43:29,54,10951,18,36,7860.20,13887.00,0.00
2024-12-10 17:43:29,55,10951,19,36,7717.29,13887.02,0.00
2024-12-10 17:43:29,55,10952,19,36,7692.15,13888.00,0.00
2024-12-10 17:43:29,56,10952,19,37,7554.79,13888.02,0.00
2024-12-10 17:43:29,55,10952,19,36,7659.32,13888.02,0.00
2024-12-10 17:43:29,54,10952,18,36,7742.54,13888.20,0.00
2024-12-10 17:43:29,54,10953,18,36,7889.63,13889.00,0.00
2024-12-10 17:43:29,55,10953,19,36,7746.18,13889.02,0.00
2024-12-10 17:43:29,55,10954,19,36,7720.25,13890.00,0.00
2024-12-10 17:43:29,56,10954,19,37,7582.39,13890.02,0.00
2024-12-10 17:43:29,55,10954,19,36,7689.95,13890.02,0.00
2024-12-10 17:43:29,55,10955,19,36,7705.65,13891.00,0.00
2024-12-10 17:43:29,56,10955,19,37,7568.05,13891.02,0.00
2024-12-10 17:43:29,56,10956,19,37,7539.85,13892.00,0.00
2024-12-10 17:43:29,57,10956,20,37,7407.57,13892.02,0.00
2024-12-10 17:43:29,56,10956,20,36,7512.56,13892.02,0.00
2024-12-10 17:43:29,55,10956,19,36,7465.45,13892.93,0.00
2024-12-10 17:43:29,55,10957,19,36,7707.99,13893.00,0.00
2024-12-10 17:43:29,56,10957,20,36,7570.35,13893.02,0.00
2024-12-10 17:43:29,57,10956,20,37,7345.04,13893.37,0.00
2024-12-10 17:43:29,56,10956,19,37,7493.65,13893.52,0.00
2024-12-10 17:43:29,56,10957,19,37,7675.10,13894.00,0.00
2024-12-10 17:43:29,57,10957,20,37,7540.45,13894.02,0.00
2024-12-10 17:43:29,56,10957,20,36,7650.29,13894.02,0.00
2024-12-10 17:43:29,56,10958,20,36,7911.37,13895.00,0.00
2024-12-10 17:43:29,57,10958,21,36,7772.58,13895.02,0.00
2024-12-10 17:43:29,56,10958,20,36,7685.13,13895.61,0.00
2024-12-10 17:43:29,56,10959,20,36,7878.96,13896.00,0.00
2024-12-10 17:43:29,57,10959,21,36,7740.73,13896.02,0.00
2024-12-10 17:43:29,56,10959,21,35,7856.63,13896.02,0.00
2024-12-10 17:43:29,55,10959,20,35,7908.83,13896.65,0.00
2024-12-10 17:43:29,55,10960,20,35,8012.69,13897.00,0.00
2024-12-10 17:43:29,56,10960,20,36,7869.60,13897.02,0.00
2024-12-10 17:43:29,56,10961,20,36,7835.93,13898.00,0.00
2024-12-10 17:43:29,57,10961,20,37,7698.46,13898.02,0.00
2024-12-10 17:43:29,56,10961,20,36,7813.59,13898.02,0.00
2024-12-10 17:43:29,56,10962,20,36,7826.57,13899.00,0.00
2024-12-10 17:43:29,57,10962,20,37,7689.26,13899.02,0.00
2024-12-10 17:43:29,56,10962,19,37,7739.75,13899.20,0.00
2024-12-10 17:43:29,55,10962,18,37,7822.06,13899.62,0.00
2024-12-10 17:43:29,55,10963,18,37,8022.00,13900.00,0.00
2024-12-10 17:43:29,56,10963,18,38,7878.75,13900.02,0.00
2024-12-10 17:43:29,55,10963,18,37,7991.67,13900.02,0.00
2024-12-10 17:43:29,54,10963,17,37,8103.68,13900.19,0.00
2024-12-10 17:43:29,54,10964,17,37,8248.37,13901.00,0.00
2024-12-10 17:43:29,55,10964,17,38,8098.40,13901.02,0.00
2024-12-10 17:43:29,55,10965,17,38,8067.11,13902.00,0.00
2024-12-10 17:43:29,56,10965,18,38,7923.05,13902.02,0.00
2024-12-10 17:43:29,55,10965,18,37,8039.30,13902.02,0.00
2024-12-10 17:43:29,55,10965,18,37,8055.05,13903.00,0.00
2024-12-10 17:43:29,56,10965,19,37,7911.21,13903.02,0.00
2024-12-10 17:43:29,55,10965,18,37,7988.90,13903.13,0.00
2024-12-10 17:43:29,55,10966,18,37,8025.02,13904.00,0.00
2024-12-10 17:43:29,56,10966,18,38,7881.71,13904.02,0.00
2024-12-10 17:43:29,55,10966,18,37,7999.74,13904.02,0.00
2024-12-10 17:43:29,54,10966,17,37,7996.23,13904.85,0.00
2024-12-10 17:43:29,54,10967,17,37,8233.26,13905.00,0.00
2024-12-10 17:43:29,55,10967,18,37,8083.56,13905.02,0.00
2024-12-10 17:43:29,55,10968,18,37,8049.92,13906.00,0.00
2024-12-10 17:43:29,56,10968,18,38,7906.17,13906.02,0.00
2024-12-10 17:43:29,55,10968,18,37,8027.17,13906.02,0.00
2024-12-10 17:43:29,54,10968,17,37,8091.59,13906.61,0.00
2024-12-10 17:43:29,54,10969,17,37,8192.32,13907.00,0.00
2024-12-10 17:43:29,55,10969,17,38,8043.37,13907.02,0.00
2024-12-10 17:43:29,55,10970,17,38,8008.55,13908.00,0.00
2024-12-10 17:43:29,56,10970,17,39,7865.54,13908.02,0.00
2024-12-10 17:43:29,55,10970,17,38,7988.32,13908.02,0.00
2024-12-10 17:43:29,54,10970,16,38,7969.09,13908.57,0.00
2024-12-10 17:43:30,54,10971,16,38,8167.74,13909.00,0.00
2024-12-10 17:43:30,55,10971,17,38,8019.24,13909.02,0.00
2024-12-10 17:43:30,54,10971,16,38,8059.64,13909.26,0.00
2024-12-10 17:43:30,54,10972,16,38,8214.70,13910.00,0.00
2024-12-10 17:43:30,55,10972,17,38,8065.34,13910.02,0.00
2024-12-10 17:43:30,54,10972,17,37,8194.09,13910.02,0.00
2024-12-10 17:43:30,54,10973,17,37,8212.71,13911.00,0.00
2024-12-10 17:43:30,55,10973,18,37,8063.39,13911.02,0.00
2024-12-10 17:43:30,55,10974,18,37,8028.56,13912.00,0.00
2024-12-10 17:43:30,56,10974,19,37,7885.19,13912.02,0.00
2024-12-10 17:43:30,55,10974,19,36,8010.85,13912.02,0.00
2024-12-10 17:43:30,55,10975,19,36,8026.60,13913.00,0.00
2024-12-10 17:43:30,56,10975,20,36,7883.27,13913.02,0.00
2024-12-10 17:43:30,56,10976,20,36,7846.57,13914.00,0.00
2024-12-10 17:43:30,57,10976,21,36,7708.91,13914.02,0.00
2024-12-10 17:43:30,56,10976,21,35,7831.66,13914.02,0.00
2024-12-10 17:43:30,55,10976,20,35,7956.40,13914.15,0.00
2024-12-10 17:43:30,55,10977,20,35,7989.81,13915.00,0.00
2024-12-10 17:43:30,56,10977,21,35,7847.13,13915.02,0.00
2024-12-10 17:43:30,55,10977,20,35,7827.93,13915.13,0.00
2024-12-10 17:43:30,55,10978,20,35,7960.02,13916.00,0.00
2024-12-10 17:43:30,56,10978,21,35,7817.88,13916.02,0.00
2024-12-10 17:43:30,55,10978,21,34,7942.31,13916.02,0.00
2024-12-10 17:43:30,54,10978,20,34,8003.65,13916.63,0.00
2024-12-10 17:43:30,54,10979,20,34,8107.00,13917.00,0.00
2024-12-10 17:43:30,55,10979,21,34,7959.60,13917.02,0.00
2024-12-10 17:43:30,54,10979,20,34,8040.03,13917.13,0.00
2024-12-10 17:43:30,54,10980,20,34,8074.08,13918.00,0.00
2024-12-10 17:43:30,55,10980,20,35,7927.28,13918.02,0.00
2024-12-10 17:43:30,54,10980,20,34,8053.46,13918.02,0.00
2024-12-10 17:43:30,54,10981,20,34,8072.08,13919.00,0.00
2024-12-10 17:43:30,55,10981,21,34,7925.32,13919.02,0.00
2024-12-10 17:43:30,55,10982,21,34,7890.45,13920.00,0.00
2024-12-10 17:43:30,56,10982,22,34,7749.55,13920.02,0.00
2024-12-10 17:43:30,55,10982,22,33,7872.74,13920.02,0.00
2024-12-10 17:43:30,54,10982,21,33,8007.80,13920.09,0.00
2024-12-10 17:43:30,53,10982,20,33,8119.55,13920.21,0.00
2024-12-10 17:43:30,53,10983,20,33,8272.39,13921.00,0.00
2024-12-10 17:43:30,54,10983,20,34,8119.20,13921.02,0.00
2024-12-10 17:43:30,54,10984,20,34,8086.27,13922.00,0.00
2024-12-10 17:43:30,55,10984,21,34,7939.25,13922.02,0.00
2024-12-10 17:43:30,54,10984,21,33,8070.80,13922.02,0.00
2024-12-10 17:43:30,54,10985,21,33,8089.43,13923.00,0.00
2024-12-10 17:43:30,55,10985,22,33,7942.35,13923.02,0.00
2024-12-10 17:43:30,55,10986,22,33,7975.49,13924.00,0.00
2024-12-10 17:43:30,56,10986,22,34,7833.07,13924.02,0.00
2024-12-10 17:43:30,55,10986,21,34,7837.93,13924.64,0.00
2024-12-10 17:43:30,55,10987,21,34,7978.41,13925.00,0.00
2024-12-10 17:43:30,56,10987,21,35,7835.93,13925.02,0.00
2024-12-10 17:43:30,56,10988,21,35,7799.20,13926.00,0.00
2024-12-10 17:43:30,57,10988,21,36,7662.37,13926.02,0.00
2024-12-10 17:43:30,56,10988,21,35,7779.30,13926.02,0.00
2024-12-10 17:43:30,55,10988,20,35,7705.07,13926.96,0.00
2024-12-10 17:43:30,55,10989,20,35,7953.24,13927.00,0.00
2024-12-10 17:43:30,56,10989,21,35,7811.22,13927.02,0.00
2024-12-10 17:43:30,56,10990,21,35,7774.47,13928.00,0.00
2024-12-10 17:43:30,57,10990,21,36,7638.08,13928.02,0.00
2024-12-10 17:43:30,56,10990,21,35,7764.52,13928.02,0.00
2024-12-10 17:43:30,56,10991,21,35,7777.52,13929.00,0.00
2024-12-10 17:43:30,57,10991,21,36,7641.07,13929.02,0.00
2024-12-10 17:43:30,56,10991,20,36,7670.90,13929.05,0.00
2024-12-10 17:43:30,55,10991,19,36,7722.08,13929.67,0.00
2024-12-10 17:43:30,55,10992,19,36,7929.96,13930.00,0.00
2024-12-10 17:43:30,56,10992,19,37,7788.36,13930.02,0.00
2024-12-10 17:43:30,55,10992,19,36,7914.77,13930.02,0.00
2024-12-10 17:43:30,54,10992,18,36,7945.43,13930.41,0.00
2024-12-10 17:43:30,53,10992,17,36,8058.72,13930.66,0.00
2024-12-10 17:43:30,53,10993,17,36,8274.48,13931.00,0.00
2024-12-10 17:43:30,54,10993,18,36,8121.25,13931.02,0.00
2024-12-10 17:43:30,53,10993,17,36,8025.11,13931.66,0.00
2024-12-10 17:43:30,53,10993,17,36,8240.90,13932.00,0.00
2024-12-10 17:43:30,54,10993,18,36,8088.29,13932.02,0.00
2024-12-10 17:43:30,53,10993,18,35,8217.25,13932.02,0.00
2024-12-10 17:43:30,53,10994,18,35,8238.87,13933.00,0.00
2024-12-10 17:43:30,54,10994,19,35,8086.30,13933.02,0.00
2024-12-10 17:43:30,54,10995,19,35,8053.33,13934.00,0.00
2024-12-10 17:43:30,55,10995,19,36,7906.91,13934.02,0.00
2024-12-10 17:43:30,54,10995,19,35,8024.95,13934.02,0.00
2024-12-10 17:43:30,54,10996,19,35,8043.59,13935.00,0.00
2024-12-10 17:43:30,55,10996,19,36,7897.34,13935.02,0.00
2024-12-10 17:43:30,55,10997,19,36,7862.43,13936.00,0.00
2024-12-10 17:43:30,56,10997,19,37,7722.03,13936.02,0.00
2024-12-10 17:43:30,55,10997,19,36,7837.09,13936.02,0.00
2024-12-10 17:43:30,54,10997,18,36,7884.49,13936.69,0.00
2024-12-10 17:43:30,54,10998,18,36,8098.94,13937.00,0.00
2024-12-10 17:43:30,55,10998,18,37,7951.69,13937.02,0.00
2024-12-10 17:43:30,55,10999,18,37,7916.78,13938.00,0.00
2024-12-10 17:43:30,56,10999,18,38,7775.41,13938.02,0.00
2024-12-10 17:43:30,55,10999,18,37,7893.97,13938.02,0.00
2024-12-10 17:43:30,55,11000,18,37,7909.75,13939.00,0.00
2024-12-10 17:43:30,56,11000,19,37,7768.50,13939.02,0.00
2024-12-10 17:43:30,55,11000,18,37,7664.23,13939.67,0.00
2024-12-10 17:43:30,55,11001,18,37,7872.29,13940.00,0.00
2024-12-10 17:43:30,56,11001,18,38,7731.72,13940.02,0.00
2024-12-10 17:43:30,55,11001,18,37,7852.02,13940.02,0.00
2024-12-10 17:43:30,55,11002,18,37,7867.79,13941.00,0.00
2024-12-10 17:43:30,56,11002,19,37,7727.29,13941.02,0.00
2024-12-10 17:43:31,56,11003,19,37,7694.61,13942.00,0.00
2024-12-10 17:43:31,57,11003,20,37,7559.62,13942.02,0.00
2024-12-10 17:43:31,56,11003,20,36,7664.74,13942.04,0.00
2024-12-10 17:43:31,55,11003,19,36,7791.46,13942.13,0.00
2024-12-10 17:43:31,55,11004,19,36,7822.40,13943.00,0.00
2024-12-10 17:43:31,56,11004,19,37,7682.72,13943.02,0.00
2024-12-10 17:43:31,56,11005,19,37,7650.45,13944.00,0.00
2024-12-10 17:43:31,57,11005,20,37,7516.23,13944.02,0.00
2024-12-10 17:43:31,56,11005,19,37,7419.84,13944.96,0.00
2024-12-10 17:43:31,56,11006,19,37,7663.90,13945.00,0.00
2024-12-10 17:43:31,57,11006,20,37,7529.44,13945.02,0.00
2024-12-10 17:43:31,56,11006,20,36,7651.45,13945.02,0.00
2024-12-10 17:43:31,56,11007,20,36,7664.45,13946.00,0.00
2024-12-10 17:43:31,57,11007,21,36,7529.98,13946.02,0.00
2024-12-10 17:43:31,56,11007,21,35,7642.03,13946.02,0.00
2024-12-10 17:43:31,56,11008,21,35,7655.03,13947.00,0.00
2024-12-10 17:43:31,57,11008,21,36,7520.73,13947.02,0.00
2024-12-10 17:43:31,57,11009,21,36,7483.67,13948.00,0.00
2024-12-10 17:43:31,58,11009,21,37,7354.64,13948.02,0.00
2024-12-10 17:43:31,57,11009,21,36,7464.09,13948.02,0.00
2024-12-10 17:43:31,56,11009,20,36,7483.16,13948.75,0.00
2024-12-10 17:43:31,56,11010,20,36,7697.56,13949.00,0.00
2024-12-10 17:43:31,57,11010,21,36,7562.51,13949.02,0.00
2024-12-10 17:43:31,56,11010,20,36,7491.95,13949.55,0.00
2024-12-10 17:43:31,56,11011,20,36,7679.10,13950.00,0.00
2024-12-10 17:43:31,57,11011,21,36,7544.38,13950.02,0.00
2024-12-10 17:43:31,56,11011,21,35,7656.68,13950.02,0.00
2024-12-10 17:43:31,55,11011,20,35,7780.71,13950.13,0.00
2024-12-10 17:43:31,55,11012,20,35,7811.67,13951.00,0.00
2024-12-10 17:43:31,56,11012,20,36,7672.18,13951.02,0.00
2024-12-10 17:43:31,56,11012,20,36,7635.35,13952.00,0.00
2024-12-10 17:43:31,57,11012,20,37,7501.40,13952.02,0.00
2024-12-10 17:43:31,56,11012,20,36,7615.42,13952.02,0.00
2024-12-10 17:43:31,55,11012,19,36,7597.07,13952.89,0.00
2024-12-10 17:43:31,55,11013,19,36,7835.62,13953.00,0.00
2024-12-10 17:43:31,56,11013,20,36,7695.70,13953.02,0.00
2024-12-10 17:43:31,56,11014,20,36,7658.88,13954.00,0.00
2024-12-10 17:43:31,57,11014,20,37,7524.51,13954.02,0.00
2024-12-10 17:43:31,56,11014,20,36,7641.43,13954.02,0.00
2024-12-10 17:43:31,55,11014,19,36,7763.53,13954.13,0.00
2024-12-10 17:43:31,55,11015,19,36,7794.50,13955.00,0.00
2024-12-10 17:43:31,56,11015,20,36,7655.31,13955.02,0.00
2024-12-10 17:43:31,56,11016,20,36,7618.72,13956.00,0.00
2024-12-10 17:43:31,57,11016,21,36,7485.06,13956.02,0.00
2024-12-10 17:43:31,56,11016,21,35,7596.29,13956.02,0.00
2024-12-10 17:43:31,55,11016,20,35,7592.48,13956.84,0.00
2024-12-10 17:43:31,55,11017,20,35,7823.53,13957.00,0.00
2024-12-10 17:43:31,56,11017,21,35,7683.82,13957.02,0.00
2024-12-10 17:43:31,56,11018,21,35,7646.99,13958.00,0.00
2024-12-10 17:43:31,57,11018,22,35,7512.83,13958.02,0.00
2024-12-10 17:43:31,56,11018,22,34,7627.05,13958.02,0.00
2024-12-10 17:43:31,56,11019,22,34,7640.06,13959.00,0.00
2024-12-10 17:43:31,57,11019,22,35,7506.02,13959.02,0.00
2024-12-10 17:43:31,57,11020,22,35,7467.37,13960.00,0.00
2024-12-10 17:43:31,58,11020,23,35,7338.62,13960.02,0.00
2024-12-10 17:43:31,57,11020,23,34,7450.23,13960.02,0.00
2024-12-10 17:43:31,56,11020,22,34,7426.68,13960.89,0.00
2024-12-10 17:43:31,56,11021,22,34,7661.10,13961.00,0.00
2024-12-10 17:43:31,57,11021,22,35,7526.69,13961.02,0.00
2024-12-10 17:43:31,57,11022,22,35,7488.94,13962.00,0.00
2024-12-10 17:43:31,58,11022,23,35,7359.82,13962.02,0.00
2024-12-10 17:43:31,57,11022,23,34,7471.79,13962.02,0.00
2024-12-10 17:43:31,56,11022,22,34,7580.34,13962.18,0.00
2024-12-10 17:43:31,56,11023,22,34,7615.73,13963.00,0.00
2024-12-10 17:43:31,57,11023,22,35,7482.13,13963.02,0.00
2024-12-10 17:43:31,56,11023,21,35,7470.51,13963.70,0.00
2024-12-10 17:43:31,56,11024,21,35,7677.70,13964.00,0.00
2024-12-10 17:43:31,57,11024,22,35,7543.01,13964.02,0.00
2024-12-10 17:43:31,56,11024,22,34,7660.25,13964.02,0.00
2024-12-10 17:43:31,56,11025,22,34,7673.27,13965.00,0.00
2024-12-10 17:43:31,57,11025,22,35,7538.65,13965.02,0.00
2024-12-10 17:43:31,57,11026,22,35,7499.98,13966.00,0.00
2024-12-10 17:43:31,58,11026,23,35,7370.67,13966.02,0.00
2024-12-10 17:43:31,57,11026,23,34,7485.28,13966.02,0.00
2024-12-10 17:43:31,56,11026,22,34,7447.37,13966.95,0.00
2024-12-10 17:43:31,56,11027,22,34,7689.33,13967.00,0.00
2024-12-10 17:43:31,57,11027,22,35,7554.43,13967.02,0.00
2024-12-10 17:43:31,56,11027,21,35,7552.26,13967.36,0.00
2024-12-10 17:43:31,56,11028,21,35,7712.33,13968.00,0.00
2024-12-10 17:43:31,57,11028,21,36,7577.02,13968.02,0.00
2024-12-10 17:43:31,56,11028,21,35,7697.36,13968.02,0.00
2024-12-10 17:43:31,55,11028,20,35,7733.33,13968.40,0.00
2024-12-10 17:43:31,55,11029,20,35,7903.91,13969.00,0.00
2024-12-10 17:43:31,56,11029,21,35,7762.77,13969.02,0.00
2024-12-10 17:43:31,56,11030,21,35,7727.88,13970.00,0.00
2024-12-10 17:43:31,57,11030,22,35,7592.30,13970.02,0.00
2024-12-10 17:43:31,56,11030,22,34,7705.43,13970.04,0.00
2024-12-10 17:43:31,55,11030,21,34,7753.91,13970.67,0.00
2024-12-10 17:43:31,55,11031,21,34,7860.86,13971.00,0.00
2024-12-10 17:43:31,56,11031,22,34,7720.49,13971.02,0.00
2024-12-10 17:43:31,55,11031,21,34,7692.71,13971.44,0.00
2024-12-10 17:43:31,55,11032,21,34,7868.40,13972.00,0.00
2024-12-10 17:43:31,56,11032,22,34,7727.89,13972.02,0.00
2024-12-10 17:43:31,55,11032,22,33,7848.08,13972.04,0.00
2024-12-10 17:43:31,55,11033,22,33,7856.12,13973.00,0.00
2024-12-10 17:43:31,56,11033,22,34,7715.83,13973.02,0.00
2024-12-10 17:43:31,56,11034,22,34,7665.00,13974.00,0.00
2024-12-10 17:43:31,57,11034,22,35,7530.53,13974.02,0.00
2024-12-10 17:43:31,56,11034,22,34,7647.54,13974.04,0.00
2024-12-10 17:43:32,55,11034,21,34,7766.30,13974.18,0.00
2024-12-10 17:43:32,55,11035,21,34,7788.27,13975.00,0.00
2024-12-10 17:43:32,56,11035,21,35,7649.20,13975.02,0.00
2024-12-10 17:43:32,56,11036,21,35,7593.01,13976.00,0.00
2024-12-10 17:43:32,57,11036,21,36,7459.80,13976.02,0.00
2024-12-10 17:43:32,56,11036,21,35,7578.04,13976.04,0.00
2024-12-10 17:43:32,55,11036,20,35,7695.54,13976.18,0.00
2024-12-10 17:43:32,54,11036,19,35,7671.74,13976.93,0.00
2024-12-10 17:43:32,54,11037,19,35,7920.26,13977.00,0.00
2024-12-10 17:43:32,55,11037,20,35,7776.26,13977.02,0.00
2024-12-10 17:43:32,54,11037,19,35,7845.25,13977.19,0.00
2024-12-10 17:43:32,53,11037,19,34,7974.84,13977.19,0.00
2024-12-10 17:43:32,52,11037,18,34,7983.53,13977.92,0.00
2024-12-10 17:43:32,52,11038,18,34,8241.64,13978.00,0.00
2024-12-10 17:43:32,53,11038,18,35,8086.14,13978.02,0.00
2024-12-10 17:43:32,52,11038,18,34,8228.20,13978.04,0.00
2024-12-10 17:43:32,52,11039,18,34,8255.67,13979.00,0.00
2024-12-10 17:43:32,53,11039,18,35,8099.90,13979.02,0.00
2024-12-10 17:43:32,52,11039,17,35,8207.28,13979.02,0.00
2024-12-10 17:43:32,52,11040,17,35,8285.83,13980.00,0.00
2024-12-10 17:43:32,53,11040,17,36,8129.50,13980.02,0.00
2024-12-10 17:43:32,52,11040,17,35,8272.39,13980.02,0.00
2024-12-10 17:43:32,51,11040,16,35,8324.98,13980.12,0.00
2024-12-10 17:43:32,51,11040,16,35,8476.32,13981.00,0.00
2024-12-10 17:43:32,52,11040,16,36,8313.31,13981.02,0.00
2024-12-10 17:43:32,51,11040,15,36,8407.78,13981.02,0.00
2024-12-10 17:43:32,51,11041,15,36,8490.63,13982.00,0.00
2024-12-10 17:43:32,52,11041,15,37,8327.35,13982.02,0.00
2024-12-10 17:43:32,52,11042,15,37,8298.37,13983.00,0.00
2024-12-10 17:43:32,53,11042,15,38,8141.80,13983.02,0.00
2024-12-10 17:43:32,52,11042,15,37,8282.23,13983.04,0.00
2024-12-10 17:43:32,52,11043,15,37,8309.72,13984.00,0.00
2024-12-10 17:43:32,53,11043,15,38,8152.93,13984.02,0.00
2024-12-10 17:43:32,53,11044,15,38,8121.85,13985.00,0.00
2024-12-10 17:43:32,54,11044,16,38,7971.45,13985.02,0.00
2024-12-10 17:43:32,53,11044,16,37,8108.66,13985.04,0.00
2024-12-10 17:43:32,52,11044,15,37,8071.27,13985.65,0.00
2024-12-10 17:43:32,52,11045,15,37,8292.08,13986.00,0.00
2024-12-10 17:43:32,53,11045,16,37,8135.63,13986.02,0.00
2024-12-10 17:43:32,52,11045,16,36,8289.39,13986.02,0.00
2024-12-10 17:43:32,51,11045,15,36,8377.88,13986.02,0.00
2024-12-10 17:43:32,50,11045,14,36,8397.52,13986.66,0.00
2024-12-10 17:43:32,50,11046,14,36,8629.97,13987.00,0.00
2024-12-10 17:43:32,51,11046,15,36,8460.76,13987.02,0.00
2024-12-10 17:43:32,50,11046,15,35,8588.01,13987.02,0.00
2024-12-10 17:43:32,50,11047,15,35,8619.40,13988.00,0.00
2024-12-10 17:43:32,51,11047,15,36,8450.39,13988.02,0.00
2024-12-10 17:43:32,51,11048,15,36,8429.40,13989.00,0.00
2024-12-10 17:43:32,52,11048,16,36,8267.29,13989.02,0.00
2024-12-10 17:43:32,51,11048,16,35,8385.51,13989.02,0.00
2024-12-10 17:43:32,50,11048,15,35,8366.00,13989.96,0.00
2024-12-10 17:43:32,50,11049,15,35,8640.22,13990.00,0.00
2024-12-10 17:43:32,51,11049,15,36,8470.80,13990.02,0.00
2024-12-10 17:43:32,51,11050,15,36,8448.80,13991.00,0.00
2024-12-10 17:43:32,52,11050,16,36,8286.33,13991.02,0.00
2024-12-10 17:43:32,51,11050,16,35,8407.65,13991.02,0.00
2024-12-10 17:43:32,51,11051,16,35,8435.69,13992.00,0.00
2024-12-10 17:43:32,52,11051,16,36,8273.46,13992.02,0.00
2024-12-10 17:43:32,51,11051,15,36,8206.42,13992.92,0.00
2024-12-10 17:43:32,51,11052,15,36,8469.88,13993.00,0.00
2024-12-10 17:43:32,52,11052,16,36,8306.99,13993.02,0.00
2024-12-10 17:43:32,51,11052,16,35,8431.46,13993.02,0.00
2024-12-10 17:43:32,51,11053,16,35,8459.51,13994.00,0.00
2024-12-10 17:43:32,52,11053,17,35,8296.82,13994.02,0.00
2024-12-10 17:43:32,51,11053,16,35,8396.41,13994.08,0.00
2024-12-10 17:43:32,51,11054,16,35,8438.28,13995.00,0.00
2024-12-10 17:43:32,52,11054,16,36,8276.00,13995.02,0.00
2024-12-10 17:43:32,51,11054,16,35,8399.86,13995.02,0.00
2024-12-10 17:43:32,51,11055,16,35,8427.90,13996.00,0.00
2024-12-10 17:43:32,52,11055,17,35,8265.83,13996.02,0.00
2024-12-10 17:43:32,52,11056,17,35,8239.74,13997.00,0.00
2024-12-10 17:43:32,53,11056,17,36,8084.28,13997.02,0.00
2024-12-10 17:43:32,52,11056,17,35,8204.75,13997.02,0.00
2024-12-10 17:43:32,52,11057,17,35,8229.56,13998.00,0.00
2024-12-10 17:43:32,53,11057,18,35,8074.29,13998.02,0.00
2024-12-10 17:43:32,53,11058,18,35,8045.89,13999.00,0.00
2024-12-10 17:43:32,54,11058,19,35,7896.89,13999.02,0.00
2024-12-10 17:43:32,53,11058,19,34,8014.19,13999.02,0.00
2024-12-10 17:43:32,53,11059,19,34,8035.90,14000.00,0.00
2024-12-10 17:43:32,54,11059,19,35,7887.08,14000.02,0.00
2024-12-10 17:43:32,53,11059,18,35,7969.89,14000.11,0.00
2024-12-10 17:43:32,52,11059,17,35,7988.73,14000.50,0.00
2024-12-10 17:43:32,52,11060,17,35,8188.33,14001.00,0.00
2024-12-10 17:43:32,53,11060,18,35,8033.83,14001.02,0.00
2024-12-10 17:43:32,52,11060,18,34,8150.63,14001.02,0.00
2024-12-10 17:43:32,52,11061,18,34,8175.45,14002.00,0.00
2024-12-10 17:43:32,53,11061,19,34,8021.19,14002.02,0.00
2024-12-10 17:43:32,52,11061,18,34,7979.08,14002.48,0.00
2024-12-10 17:43:32,52,11062,18,34,8176.03,14003.00,0.00
2024-12-10 17:43:32,53,11062,18,35,8021.77,14003.02,0.00
2024-12-10 17:43:32,52,11062,18,34,8141.02,14003.02,0.00
2024-12-10 17:43:32,52,11063,18,34,8165.84,14004.00,0.00
2024-12-10 17:43:32,53,11063,18,35,8011.77,14004.02,0.00
2024-12-10 17:43:32,53,11064,18,35,7985.03,14005.00,0.00
2024-12-10 17:43:32,54,11064,19,35,7837.16,14005.02,0.00
2024-12-10 17:43:32,53,11064,19,34,7953.33,14005.02,0.00
2024-12-10 17:43:32,52,11064,18,34,8095.53,14005.10,0.00
2024-12-10 17:43:32,51,11064,17,34,8079.96,14005.96,0.00
2024-12-10 17:43:32,51,11065,17,34,8349.12,14006.00,0.00
2024-12-10 17:43:32,52,11065,18,34,8188.56,14006.02,0.00
2024-12-10 17:43:32,51,11065,17,34,8137.89,14006.51,0.00
2024-12-10 17:43:33,51,11066,17,34,8344.22,14007.00,0.00
2024-12-10 17:43:33,52,11066,17,35,8183.75,14007.02,0.00
2024-12-10 17:43:33,51,11066,17,34,8314.01,14007.02,0.00
2024-12-10 17:43:33,51,11067,17,34,8342.07,14008.00,0.00
2024-12-10 17:43:33,52,11067,17,35,8181.64,14008.02,0.00
2024-12-10 17:43:33,52,11068,17,35,8152.59,14009.00,0.00
2024-12-10 17:43:33,53,11068,18,35,7998.77,14009.02,0.00
2024-12-10 17:43:33,52,11068,18,34,8125.65,14009.02,0.00
2024-12-10 17:43:33,52,11069,18,34,8150.48,14010.00,0.00
2024-12-10 17:43:33,53,11069,18,35,7996.70,14010.02,0.00
2024-12-10 17:43:33,53,11070,18,35,7966.94,14011.00,0.00
2024-12-10 17:43:33,54,11070,19,35,7819.40,14011.02,0.00
2024-12-10 17:43:33,53,11070,19,34,7940.50,14011.02,0.00
2024-12-10 17:43:33,52,11070,18,34,7929.35,14011.90,0.00
2024-12-10 17:43:33,52,11071,18,34,8185.40,14012.00,0.00
2024-12-10 17:43:33,53,11071,18,35,8030.96,14012.02,0.00
2024-12-10 17:43:33,52,11071,17,35,8096.53,14012.17,0.00
2024-12-10 17:43:33,52,11072,17,35,8250.66,14013.00,0.00
2024-12-10 17:43:33,53,11072,17,36,8094.98,14013.02,0.00
2024-12-10 17:43:33,52,11072,17,35,8221.01,14013.02,0.00
2024-12-10 17:43:33,52,11073,17,35,8245.86,14014.00,0.00
2024-12-10 17:43:33,53,11073,18,35,8090.27,14014.02,0.00
2024-12-10 17:43:33,52,11073,17,35,8108.59,14014.62,0.00
2024-12-10 17:43:33,52,11074,17,35,8223.27,14015.00,0.00
2024-12-10 17:43:33,53,11074,17,36,8068.11,14015.02,0.00
2024-12-10 17:43:33,52,11074,17,35,8188.23,14015.02,0.00
2024-12-10 17:43:33,52,11075,17,35,8213.07,14016.00,0.00
2024-12-10 17:43:33,53,11075,18,35,8058.11,14016.02,0.00
2024-12-10 17:43:33,52,11075,17,35,8062.13,14016.04,0.00
2024-12-10 17:43:33,52,11076,17,35,8197.49,14017.00,0.00
2024-12-10 17:43:33,53,11076,17,36,8042.82,14017.02,0.00
2024-12-10 17:43:33,52,11076,17,35,8165.14,14017.02,0.00
2024-12-10 17:43:33,52,11077,17,35,8189.98,14018.00,0.00
2024-12-10 17:43:33,53,11077,18,35,8035.45,14018.02,0.00
2024-12-10 17:43:33,52,11077,17,35,8125.31,14018.10,0.00
2024-12-10 17:43:33,51,11077,16,35,8210.62,14018.63,0.00
2024-12-10 17:43:33,51,11078,16,35,8433.55,14019.00,0.00
2024-12-10 17:43:33,52,11078,17,35,8271.37,14019.02,0.00
2024-12-10 17:43:33,51,11078,17,34,8397.82,14019.02,0.00
2024-12-10 17:43:33,51,11079,17,34,8425.90,14020.00,0.00
2024-12-10 17:43:33,52,11079,18,34,8263.87,14020.02,0.00
2024-12-10 17:43:33,51,11079,17,34,8354.46,14020.12,0.00
2024-12-10 17:43:33,51,11080,17,34,8396.26,14021.00,0.00
2024-12-10 17:43:33,52,11080,17,35,8234.80,14021.02,0.00
2024-12-10 17:43:33,51,11080,17,34,8363.27,14021.02,0.00
2024-12-10 17:43:33,50,11080,16,34,8348.84,14021.96,0.00
2024-12-10 17:43:33,50,11081,16,34,8623.69,14022.00,0.00
2024-12-10 17:43:33,51,11081,16,35,8454.60,14022.02,0.00
2024-12-10 17:43:33,50,11081,15,35,8458.24,14022.06,0.00
2024-12-10 17:43:33,50,11082,15,35,8607.48,14023.00,0.00
2024-12-10 17:43:33,51,11082,16,35,8438.71,14023.02,0.00
2024-12-10 17:43:33,50,11082,16,34,8573.82,14023.02,0.00
2024-12-10 17:43:33,50,11083,16,34,8605.29,14024.00,0.00
2024-12-10 17:43:33,51,11083,16,35,8436.56,14024.02,0.00
2024-12-10 17:43:33,50,11083,15,35,8515.54,14024.02,0.00
2024-12-10 17:43:33,50,11084,15,35,8603.10,14025.00,0.00
2024-12-10 17:43:33,51,11084,16,35,8434.41,14025.02,0.00
2024-12-10 17:43:33,50,11084,16,34,8561.02,14025.02,0.00
2024-12-10 17:43:33,50,11085,16,34,8592.49,14026.00,0.00
2024-12-10 17:43:33,51,11085,17,34,8424.01,14026.02,0.00
2024-12-10 17:43:33,51,11086,17,34,8397.11,14027.00,0.00
2024-12-10 17:43:33,52,11086,17,35,8235.62,14027.02,0.00
2024-12-10 17:43:33,51,11086,17,34,8355.85,14027.02,0.00
2024-12-10 17:43:33,50,11086,16,34,8427.73,14027.32,0.00
2024-12-10 17:43:33,50,11087,16,34,8613.35,14028.00,0.00
2024-12-10 17:43:33,51,11087,17,34,8444.47,14028.02,0.00
2024-12-10 17:43:33,51,11088,17,34,8417.56,14029.00,0.00
2024-12-10 17:43:33,52,11088,17,35,8255.68,14029.02,0.00
2024-12-10 17:43:33,51,11088,17,34,8376.30,14029.02,0.00
2024-12-10 17:43:33,51,11089,17,34,8404.41,14030.00,0.00
2024-12-10 17:43:33,52,11089,17,35,8242.78,14030.02,0.00
2024-12-10 17:43:33,52,11090,17,35,8214.41,14031.00,0.00
2024-12-10 17:43:33,53,11090,18,35,8059.42,14031.02,0.00
2024-12-10 17:43:33,52,11090,18,34,8173.93,14031.02,0.00
2024-12-10 17:43:33,51,11090,17,34,8152.46,14031.96,0.00
2024-12-10 17:43:33,51,11091,17,34,8422.11,14032.00,0.00
2024-12-10 17:43:33,52,11091,18,34,8260.15,14032.02,0.00
2024-12-10 17:43:33,51,11091,17,34,8254.44,14032.37,0.00
2024-12-10 17:43:33,51,11092,17,34,8441.97,14033.00,0.00
2024-12-10 17:43:33,52,11092,18,34,8279.63,14033.02,0.00
2024-12-10 17:43:33,51,11092,18,33,8400.70,14033.02,0.00
2024-12-10 17:43:33,51,11093,18,33,8428.82,14034.00,0.00
2024-12-10 17:43:33,52,11093,19,33,8266.72,14034.02,0.00
2024-12-10 17:43:33,52,11094,19,33,8237.62,14035.00,0.00
2024-12-10 17:43:33,53,11094,19,34,8082.19,14035.02,0.00
2024-12-10 17:43:33,52,11094,19,33,8199.84,14035.02,0.00
2024-12-10 17:43:33,52,11095,19,33,8224.71,14036.00,0.00
2024-12-10 17:43:33,53,11095,19,34,8069.53,14036.02,0.00
2024-12-10 17:43:33,52,11095,18,34,8037.45,14036.42,0.00
2024-12-10 17:43:33,52,11096,18,34,8226.80,14037.00,0.00
2024-12-10 17:43:33,53,11096,18,35,8071.58,14037.02,0.00
2024-12-10 17:43:33,52,11096,18,34,8180.91,14037.02,0.00
2024-12-10 17:43:33,51,11096,17,34,8198.40,14037.45,0.00
2024-12-10 17:43:33,51,11097,17,34,8396.96,14038.00,0.00
2024-12-10 17:43:33,52,11097,18,34,8235.48,14038.02,0.00
2024-12-10 17:43:33,52,11098,18,34,8213.39,14039.00,0.00
2024-12-10 17:43:33,53,11098,19,34,8058.42,14039.02,0.00
2024-12-10 17:43:33,52,11098,19,33,8170.19,14039.02,0.00
2024-12-10 17:43:33,52,11099,19,33,8195.07,14040.00,0.00
2024-12-10 17:43:34,53,11099,19,34,8040.45,14040.02,0.00
2024-12-10 17:43:34,52,11099,18,34,8046.70,14040.33,0.00
2024-12-10 17:43:34,52,11100,18,34,8222.66,14041.00,0.00
2024-12-10 17:43:34,53,11100,19,34,8067.51,14041.02,0.00
2024-12-10 17:43:34,52,11100,19,33,8182.15,14041.02,0.00
2024-12-10 17:43:34,52,11101,19,33,8207.04,14042.00,0.00
2024-12-10 17:43:34,53,11101,20,33,8052.19,14042.02,0.00
2024-12-10 17:43:34,53,11102,20,33,8028.39,14043.00,0.00
2024-12-10 17:43:34,54,11102,21,33,7879.72,14043.02,0.00
2024-12-10 17:43:34,53,11102,21,32,7991.29,14043.02,0.00
2024-12-10 17:43:34,53,11103,21,32,8013.06,14044.00,0.00
2024-12-10 17:43:34,54,11103,21,33,7864.67,14044.02,0.00
2024-12-10 17:43:34,54,11104,21,33,7840.44,14045.00,0.00
2024-12-10 17:43:34,55,11104,22,33,7697.88,14045.02,0.00
2024-12-10 17:43:34,54,11104,22,32,7804.03,14045.02,0.00
2024-12-10 17:43:34,53,11104,21,32,7783.56,14045.89,0.00
2024-12-10 17:43:34,53,11105,21,32,8032.76,14046.00,0.00
2024-12-10 17:43:34,54,11105,21,33,7884.00,14046.02,0.00
2024-12-10 17:43:34,54,11106,21,33,7861.16,14047.00,0.00
2024-12-10 17:43:34,55,11106,22,33,7718.23,14047.02,0.00
2024-12-10 17:43:34,54,11106,22,32,7822.14,14047.04,0.00
2024-12-10 17:43:34,53,11106,21,32,7792.64,14047.92,0.00
2024-12-10 17:43:34,53,11107,21,32,8047.15,14048.00,0.00
2024-12-10 17:43:34,54,11107,21,33,7898.13,14048.02,0.00
2024-12-10 17:43:34,54,11108,21,33,7876.58,14049.00,0.00
2024-12-10 17:43:34,55,11108,22,33,7733.37,14049.02,0.00
2024-12-10 17:43:34,54,11108,22,32,7834.97,14049.06,0.00
2024-12-10 17:43:34,54,11109,22,32,7858.93,14050.00,0.00
2024-12-10 17:43:34,55,11109,23,32,7716.04,14050.02,0.00
2024-12-10 17:43:34,54,11109,22,32,7694.03,14050.70,0.00
2024-12-10 17:43:34,54,11110,22,32,7912.83,14051.00,0.00
2024-12-10 17:43:34,55,11110,22,33,7768.96,14051.02,0.00
2024-12-10 17:43:34,54,11110,22,32,7873.81,14051.06,0.00
2024-12-10 17:43:34,53,11110,21,32,8016.84,14051.09,0.00
2024-12-10 17:43:34,53,11111,21,32,8049.21,14052.00,0.00
2024-12-10 17:43:34,54,11111,21,33,7900.15,14052.02,0.00
2024-12-10 17:43:34,53,11111,20,33,7901.04,14052.68,0.00
2024-12-10 17:43:34,53,11112,20,33,8023.30,14053.00,0.00
2024-12-10 17:43:34,54,11112,20,34,7874.73,14053.02,0.00
2024-12-10 17:43:34,53,11112,20,33,7986.19,14053.06,0.00
2024-12-10 17:43:34,53,11113,20,33,8013.27,14054.00,0.00
2024-12-10 17:43:34,54,11113,20,34,7864.87,14054.02,0.00
2024-12-10 17:43:34,54,11114,20,34,7843.36,14055.00,0.00
2024-12-10 17:43:34,55,11114,20,35,7700.75,14055.02,0.00
2024-12-10 17:43:34,54,11114,20,34,7801.72,14055.06,0.00
2024-12-10 17:43:34,54,11115,20,34,7825.70,14056.00,0.00
2024-12-10 17:43:34,55,11115,20,35,7683.41,14056.02,0.00
2024-12-10 17:43:34,55,11116,20,35,7663.99,14057.00,0.00
2024-12-10 17:43:34,56,11116,20,36,7527.13,14057.02,0.00
2024-12-10 17:43:34,55,11116,20,35,7623.10,14057.05,0.00
2024-12-10 17:43:34,54,11116,19,35,7753.38,14057.07,0.00
2024-12-10 17:43:34,54,11117,19,35,7884.08,14058.00,0.00
2024-12-10 17:43:34,55,11117,19,36,7740.74,14058.02,0.00
2024-12-10 17:43:34,54,11117,18,36,7813.82,14058.11,0.00
2024-12-10 17:43:34,54,11118,18,36,7949.73,14059.00,0.00
2024-12-10 17:43:34,55,11118,19,36,7805.19,14059.02,0.00
2024-12-10 17:43:34,54,11118,19,35,7908.08,14059.06,0.00
2024-12-10 17:43:34,53,11118,18,35,7981.88,14059.58,0.00
2024-12-10 17:43:34,53,11119,18,35,8083.01,14060.00,0.00
2024-12-10 17:43:34,54,11119,19,35,7933.33,14060.02,0.00
2024-12-10 17:43:34,53,11119,18,35,7863.06,14060.57,0.00
2024-12-10 17:43:34,53,11120,18,35,8067.67,14061.00,0.00
2024-12-10 17:43:34,54,11120,19,35,7918.27,14061.02,0.00
2024-12-10 17:43:34,53,11120,19,34,8022.57,14061.06,0.00
2024-12-10 17:43:34,53,11121,19,34,8049.67,14062.00,0.00
2024-12-10 17:43:34,54,11121,19,35,7900.60,14062.02,0.00
2024-12-10 17:43:34,54,11122,19,35,7883.77,14063.00,0.00
2024-12-10 17:43:34,55,11122,20,35,7740.43,14063.02,0.00
2024-12-10 17:43:34,54,11122,20,34,7839.50,14063.06,0.00
2024-12-10 17:43:34,54,11123,20,34,7863.49,14064.00,0.00
2024-12-10 17:43:34,55,11123,21,34,7720.52,14064.02,0.00
2024-12-10 17:43:34,54,11123,20,34,7726.23,14064.61,0.00
2024-12-10 17:43:34,54,11124,20,34,7849.61,14065.00,0.00
2024-12-10 17:43:34,55,11124,20,35,7706.89,14065.02,0.00
2024-12-10 17:43:34,54,11124,20,34,7802.74,14065.06,0.00
2024-12-10 17:43:34,54,11125,20,34,7826.73,14066.00,0.00
2024-12-10 17:43:34,55,11125,21,34,7684.42,14066.02,0.00
2024-12-10 17:43:34,55,11126,21,34,7671.71,14067.00,0.00
2024-12-10 17:43:34,56,11126,22,34,7534.71,14067.02,0.00
2024-12-10 17:43:34,55,11126,22,33,7623.12,14067.05,0.00
2024-12-10 17:43:34,55,11127,22,33,7644.11,14068.00,0.00
2024-12-10 17:43:34,56,11127,22,34,7507.61,14068.02,0.00
2024-12-10 17:43:34,56,11128,22,34,7493.55,14069.00,0.00
2024-12-10 17:43:34,57,11128,23,34,7362.09,14069.02,0.00
2024-12-10 17:43:34,56,11128,23,33,7448.33,14069.05,0.00
2024-12-10 17:43:34,55,11128,22,33,7473.82,14069.58,0.00
2024-12-10 17:43:34,55,11129,22,33,7671.09,14070.00,0.00
2024-12-10 17:43:34,56,11129,22,34,7534.10,14070.02,0.00
2024-12-10 17:43:34,55,11129,21,34,7608.36,14070.09,0.00
2024-12-10 17:43:34,55,11130,21,34,7660.02,14071.00,0.00
2024-12-10 17:43:34,56,11130,22,34,7523.23,14071.02,0.00
2024-12-10 17:43:34,55,11130,22,33,7611.41,14071.05,0.00
2024-12-10 17:43:35,55,11131,22,33,7632.42,14072.00,0.00
2024-12-10 17:43:35,56,11131,22,34,7496.12,14072.02,0.00
2024-12-10 17:43:35,55,11131,21,34,7564.38,14072.09,0.00
2024-12-10 17:43:35,55,11132,21,34,7692.84,14073.00,0.00
2024-12-10 17:43:35,56,11132,22,34,7555.47,14073.02,0.00
2024-12-10 17:43:35,55,11132,22,33,7646.78,14073.05,0.00
2024-12-10 17:43:35,54,11132,21,33,7611.36,14073.57,0.00
2024-12-10 17:43:35,54,11133,21,33,7812.36,14074.00,0.00
2024-12-10 17:43:35,55,11133,21,34,7670.31,14074.02,0.00
2024-12-10 17:43:35,54,11133,20,34,7632.67,14074.44,0.00
2024-12-10 17:43:35,53,11133,19,34,7765.27,14074.53,0.00
2024-12-10 17:43:35,53,11134,19,34,7964.79,14075.00,0.00
2024-12-10 17:43:35,54,11134,19,35,7817.29,14075.02,0.00
2024-12-10 17:43:35,53,11134,19,34,7916.99,14075.06,0.00
2024-12-10 17:43:35,52,11134,18,34,8063.84,14075.10,0.00
2024-12-10 17:43:35,52,11135,18,34,8099.59,14076.00,0.00
2024-12-10 17:43:35,53,11135,18,35,7946.76,14076.02,0.00
2024-12-10 17:43:35,53,11136,18,35,7933.41,14077.00,0.00
2024-12-10 17:43:35,54,11136,18,36,7786.49,14077.02,0.00
2024-12-10 17:43:35,53,11136,18,35,7885.60,14077.06,0.00
2024-12-10 17:43:35,52,11136,17,35,8031.85,14077.10,0.00
2024-12-10 17:43:35,51,11136,16,35,8132.22,14077.49,0.00
2024-12-10 17:43:35,51,11137,16,35,8336.86,14078.00,0.00
2024-12-10 17:43:35,52,11137,17,35,8176.54,14078.02,0.00
2024-12-10 17:43:35,51,11137,16,35,8240.29,14078.20,0.00
2024-12-10 17:43:35,51,11138,16,35,8403.71,14079.00,0.00
2024-12-10 17:43:35,52,11138,16,36,8242.10,14079.02,0.00
2024-12-10 17:43:35,51,11138,16,35,8400.95,14079.02,0.00
2024-12-10 17:43:35,50,11138,16,34,8523.92,14079.04,0.00
2024-12-10 17:43:35,50,11139,16,34,8558.31,14080.00,0.00
2024-12-10 17:43:35,51,11139,16,35,8390.50,14080.02,0.00
2024-12-10 17:43:35,51,11140,16,35,8371.57,14081.00,0.00
2024-12-10 17:43:35,52,11140,16,36,8210.58,14081.02,0.00
2024-12-10 17:43:35,51,11140,16,35,8368.81,14081.02,0.00
2024-12-10 17:43:35,50,11140,16,34,8493.94,14081.02,0.00
2024-12-10 17:43:35,49,11140,15,34,8661.56,14081.06,0.00
2024-12-10 17:43:35,49,11141,15,34,8702.39,14082.00,0.00
2024-12-10 17:43:35,50,11141,16,34,8528.34,14082.02,0.00
2024-12-10 17:43:35,49,11141,15,34,8510.46,14082.75,0.00
2024-12-10 17:43:35,49,11142,15,34,8763.58,14083.00,0.00
2024-12-10 17:43:35,50,11142,16,34,8588.30,14083.02,0.00
2024-12-10 17:43:35,49,11142,16,33,8720.46,14083.02,0.00
2024-12-10 17:43:35,49,11143,16,33,8755.57,14084.00,0.00
2024-12-10 17:43:35,50,11143,17,33,8580.46,14084.02,0.00
2024-12-10 17:43:35,49,11143,16,33,8652.10,14084.02,0.00
2024-12-10 17:43:35,49,11144,16,33,8743.94,14085.00,0.00
2024-12-10 17:43:35,50,11144,16,34,8569.06,14085.02,0.00
2024-12-10 17:43:35,49,11144,16,33,8695.07,14085.02,0.00
2024-12-10 17:43:35,49,11145,16,33,8725.86,14086.00,0.00
2024-12-10 17:43:35,50,11145,16,34,8551.35,14086.02,0.00
2024-12-10 17:43:35,50,11146,16,34,8522.92,14087.00,0.00
2024-12-10 17:43:35,51,11146,16,35,8355.80,14087.02,0.00
2024-12-10 17:43:35,50,11146,16,34,8477.84,14087.02,0.00
2024-12-10 17:43:35,49,11146,15,34,8645.12,14087.06,0.00
2024-12-10 17:43:35,48,11146,14,34,8665.67,14087.83,0.00
2024-12-10 17:43:35,48,11147,14,34,8935.81,14088.00,0.00
2024-12-10 17:43:35,49,11147,14,35,8753.45,14088.02,0.00
2024-12-10 17:43:35,49,11148,14,35,8717.09,14089.00,0.00
2024-12-10 17:43:35,50,11148,14,36,8542.74,14089.02,0.00
2024-12-10 17:43:35,49,11148,14,35,8671.08,14089.02,0.00
2024-12-10 17:43:35,48,11148,13,35,8662.76,14089.92,0.00
2024-12-10 17:43:35,48,11149,13,35,8944.62,14090.00,0.00
2024-12-10 17:43:35,49,11149,13,36,8762.08,14090.02,0.00
2024-12-10 17:43:35,48,11149,12,36,8733.51,14090.46,0.00
2024-12-10 17:43:35,48,11150,12,36,8934.00,14091.00,0.00
2024-12-10 17:43:35,49,11150,13,36,8751.68,14091.02,0.00
2024-12-10 17:43:35,49,11151,13,36,8711.84,14092.00,0.00
2024-12-10 17:43:35,50,11151,14,36,8537.60,14092.02,0.00
2024-12-10 17:43:35,49,11151,14,35,8688.86,14092.10,0.00
2024-12-10 17:43:35,49,11152,14,35,8716.14,14093.00,0.00
2024-12-10 17:43:35,50,11152,14,36,8541.81,14093.02,0.00
2024-12-10 17:43:35,50,11153,14,36,8516.32,14094.00,0.00
2024-12-10 17:43:35,51,11153,15,36,8349.33,14094.02,0.00
2024-12-10 17:43:35,50,11153,14,36,8293.10,14094.46,0.00
2024-12-10 17:43:35,50,11154,14,36,8474.49,14095.00,0.00
2024-12-10 17:43:35,51,11154,14,37,8308.32,14095.02,0.00
2024-12-10 17:43:35,50,11154,14,36,8457.60,14095.10,0.00
2024-12-10 17:43:35,50,11155,14,36,8471.32,14096.00,0.00
2024-12-10 17:43:35,51,11155,15,36,8305.21,14096.02,0.00
2024-12-10 17:43:35,50,11155,14,36,8349.78,14096.48,0.00
2024-12-10 17:43:35,49,11155,14,35,8483.68,14096.53,0.00
2024-12-10 17:43:35,49,11156,14,35,8612.29,14097.00,0.00
2024-12-10 17:43:35,50,11156,14,36,8440.04,14097.02,0.00
2024-12-10 17:43:35,49,11156,14,35,8540.39,14097.10,0.00
2024-12-10 17:43:35,48,11156,13,35,8662.75,14097.48,0.00
2024-12-10 17:43:35,48,11157,13,35,8765.94,14098.00,0.00
2024-12-10 17:43:35,49,11157,13,36,8587.04,14098.02,0.00
2024-12-10 17:43:35,49,11158,13,36,8580.54,14099.00,0.00
2024-12-10 17:43:35,50,11158,13,37,8408.93,14099.02,0.00
2024-12-10 17:43:35,49,11158,12,37,8329.10,14099.92,0.00
2024-12-10 17:43:35,49,11159,12,37,8605.39,14100.00,0.00
2024-12-10 17:43:35,50,11159,12,38,8433.29,14100.02,0.00
2024-12-10 17:43:35,49,11159,12,37,8591.03,14100.10,0.00
2024-12-10 17:43:35,48,11159,11,37,8586.88,14100.94,0.00
2024-12-10 17:43:35,48,11160,11,37,8871.87,14101.00,0.00
2024-12-10 17:43:35,49,11160,11,38,8690.82,14101.02,0.00
2024-12-10 17:43:35,48,11160,10,38,8686.97,14101.42,0.00
2024-12-10 17:43:36,48,11161,10,38,8898.94,14102.00,0.00
2024-12-10 17:43:36,49,11161,11,38,8717.33,14102.02,0.00
2024-12-10 17:43:36,48,11161,10,38,8678.82,14102.50,0.00
2024-12-10 17:43:36,48,11162,10,38,8902.51,14103.00,0.00
2024-12-10 17:43:36,49,11162,11,38,8720.83,14103.02,0.00
2024-12-10 17:43:36,48,11162,11,37,8881.97,14103.13,0.00
2024-12-10 17:43:36,48,11163,11,37,8935.47,14104.00,0.00
2024-12-10 17:43:36,49,11163,11,38,8753.11,14104.02,0.00
2024-12-10 17:43:36,49,11164,11,38,8744.63,14105.00,0.00
2024-12-10 17:43:36,50,11164,12,38,8569.74,14105.02,0.00
2024-12-10 17:43:36,50,11165,12,38,8544.96,14106.00,0.00
2024-12-10 17:43:36,51,11165,12,39,8377.41,14106.02,0.00
2024-12-10 17:43:36,50,11165,11,39,8488.53,14106.02,0.00
2024-12-10 17:43:36,49,11165,11,38,8589.82,14106.10,0.00
2024-12-10 17:43:36,49,11166,11,38,8751.63,14107.00,0.00
2024-12-10 17:43:36,50,11166,12,38,8576.60,14107.02,0.00
2024-12-10 17:43:36,50,11167,12,38,8581.86,14108.00,0.00
2024-12-10 17:43:36,51,11167,13,38,8413.58,14108.02,0.00
2024-12-10 17:43:36,50,11167,12,38,8554.64,14108.08,0.00
2024-12-10 17:43:36,51,11166,12,39,8303.99,14108.31,0.00
2024-12-10 17:43:36,50,11166,11,39,8561.00,14108.58,0.00
2024-12-10 17:43:36,51,11165,11,40,8390.38,14108.63,0.00
2024-12-10 17:43:36,51,11166,11,40,8672.88,14109.00,0.00
2024-12-10 17:43:36,52,11166,12,40,8506.09,14109.02,0.00
2024-12-10 17:43:36,51,11166,12,39,8636.96,14109.16,0.00
2024-12-10 17:43:36,51,11167,12,39,9237.90,14110.00,0.00
2024-12-10 17:43:36,52,11167,12,40,9060.24,14110.02,0.00
2024-12-10 17:43:36,51,11167,12,39,9229.60,14110.06,0.00
2024-12-10 17:43:36,51,11168,12,39,9226.47,14111.00,0.00
2024-12-10 17:43:36,52,11168,12,40,9049.04,14111.02,0.00
2024-12-10 17:43:36,52,11169,12,40,9018.41,14112.00,0.00
2024-12-10 17:43:36,53,11169,12,41,8848.25,14112.02,0.00
2024-12-10 17:43:36,52,11169,12,40,8991.31,14112.13,0.00
2024-12-10 17:43:36,51,11169,11,40,8980.78,14112.96,0.00
2024-12-10 17:43:36,51,11170,11,40,9251.99,14113.00,0.00
2024-12-10 17:43:36,52,11170,12,40,9074.07,14113.02,0.00
2024-12-10 17:43:36,51,11170,11,40,9152.43,14113.20,0.00
2024-12-10 17:43:36,51,11171,11,40,9312.36,14114.00,0.00
2024-12-10 17:43:36,52,11171,11,41,9133.27,14114.02,0.00
2024-12-10 17:43:36,52,11172,11,41,9096.05,14115.00,0.00
2024-12-10 17:43:36,53,11172,12,41,8924.42,14115.02,0.00
2024-12-10 17:43:36,52,11172,12,40,9074.37,14115.13,0.00
2024-12-10 17:43:36,52,11173,12,40,9102.72,14116.00,0.00
2024-12-10 17:43:36,53,11173,12,41,8930.97,14116.02,0.00
2024-12-10 17:43:36,53,11174,12,41,8889.80,14117.00,0.00
2024-12-10 17:43:36,54,11174,13,41,8725.18,14117.02,0.00
2024-12-10 17:43:36,53,11174,13,40,8817.91,14117.13,0.00
2024-12-10 17:43:36,52,11174,12,40,8819.04,14117.83,0.00
2024-12-10 17:43:36,52,11175,12,40,9066.23,14118.00,0.00
2024-12-10 17:43:36,53,11175,13,40,8895.17,14118.02,0.00
2024-12-10 17:43:36,53,11176,13,40,8839.43,14119.00,0.00
2024-12-10 17:43:36,54,11176,13,41,8675.74,14119.02,0.00
2024-12-10 17:43:36,53,11176,13,40,8770.20,14119.13,0.00
2024-12-10 17:43:36,52,11176,12,40,8897.59,14119.21,0.00
2024-12-10 17:43:36,52,11177,12,40,8949.74,14120.00,0.00
2024-12-10 17:43:36,53,11177,13,40,8780.87,14120.02,0.00
2024-12-10 17:43:36,53,11178,13,40,8764.36,14121.00,0.00
2024-12-10 17:43:36,54,11178,13,41,8602.06,14121.02,0.00
2024-12-10 17:43:36,54,11179,13,41,8568.67,14122.00,0.00
2024-12-10 17:43:36,55,11179,13,42,8412.87,14122.02,0.00
2024-12-10 17:43:36,54,11179,13,41,8547.79,14122.15,0.00
2024-12-10 17:43:36,53,11179,12,41,8596.01,14122.74,0.00
2024-12-10 17:43:36,54,11178,13,41,8436.82,14122.76,0.00
2024-12-10 17:43:36,54,11179,13,41,8698.56,14123.00,0.00
2024-12-10 17:43:36,55,11179,14,41,8540.40,14123.02,0.00
2024-12-10 17:43:36,55,11180,14,41,8781.70,14124.00,0.00
2024-12-10 17:43:36,56,11180,14,42,8624.88,14124.02,0.00
2024-12-10 17:43:36,56,11181,14,42,8587.66,14125.00,0.00
2024-12-10 17:43:36,57,11181,15,42,8437.00,14125.02,0.00
2024-12-10 17:43:36,56,11181,15,41,8567.52,14125.14,0.00
2024-12-10 17:43:36,56,11182,15,41,8598.36,14126.00,0.00
2024-12-10 17:43:36,57,11182,16,41,8447.51,14126.02,0.00
2024-12-10 17:43:36,56,11182,15,41,8464.77,14126.30,0.00
2024-12-10 17:43:36,56,11183,15,41,8619.14,14127.00,0.00
2024-12-10 17:43:36,57,11183,16,41,8467.93,14127.02,0.00
2024-12-10 17:43:36,56,11183,16,40,8616.62,14127.02,0.00
2024-12-10 17:43:36,56,11184,16,40,8579.39,14128.00,0.00
2024-12-10 17:43:36,57,11184,16,41,8428.87,14128.02,0.00
2024-12-10 17:43:36,56,11184,16,40,8561.76,14128.13,0.00
2024-12-10 17:43:36,56,11185,16,40,8590.09,14129.00,0.00
2024-12-10 17:43:36,57,11185,16,41,8439.39,14129.02,0.00
2024-12-10 17:43:36,56,11185,16,40,8587.57,14129.02,0.00
2024-12-10 17:43:36,55,11185,15,40,8611.09,14129.55,0.00
2024-12-10 17:43:36,55,11186,15,40,8804.11,14130.00,0.00
2024-12-10 17:43:36,56,11186,15,41,8646.90,14130.02,0.00
2024-12-10 17:43:36,56,11187,15,41,8609.66,14131.00,0.00
2024-12-10 17:43:36,57,11187,16,41,8458.61,14131.02,0.00
2024-12-10 17:43:36,56,11187,16,40,8592.02,14131.11,0.00
2024-12-10 17:43:36,55,11187,15,40,8607.42,14131.87,0.00
2024-12-10 17:43:36,55,11188,15,40,8846.47,14132.00,0.00
2024-12-10 17:43:36,56,11188,16,40,8688.50,14132.02,0.00
2024-12-10 17:43:37,56,11189,16,40,8665.86,14133.00,0.00
2024-12-10 17:43:37,57,11189,16,41,8513.83,14133.02,0.00
2024-12-10 17:43:37,56,11189,15,41,8522.35,14133.66,0.00
2024-12-10 17:43:37,56,11190,15,41,8626.09,14134.00,0.00
2024-12-10 17:43:37,57,11190,16,41,8474.76,14134.02,0.00
2024-12-10 17:43:37,56,11190,16,40,8610.97,14134.11,0.00
2024-12-10 17:43:37,56,11191,16,40,8636.80,14135.00,0.00
2024-12-10 17:43:37,57,11191,17,40,8485.28,14135.02,0.00
2024-12-10 17:43:37,57,11192,17,40,8458.46,14136.00,0.00
2024-12-10 17:43:37,58,11192,17,41,8312.63,14136.02,0.00
2024-12-10 17:43:37,57,11192,17,40,8396.49,14136.11,0.00
2024-12-10 17:43:37,56,11192,16,40,8363.35,14136.93,0.00
2024-12-10 17:43:37,56,11193,16,40,8605.74,14137.00,0.00
2024-12-10 17:43:37,57,11193,16,41,8454.76,14137.02,0.00
2024-12-10 17:43:37,57,11194,16,41,8435.19,14138.00,0.00
2024-12-10 17:43:37,58,11194,17,41,8289.75,14138.02,0.00
2024-12-10 17:43:37,57,11194,16,41,8230.10,14138.82,0.00
2024-12-10 17:43:37,57,11195,16,41,8453.48,14139.00,0.00
2024-12-10 17:43:37,58,11195,17,41,8307.73,14139.02,0.00
2024-12-10 17:43:37,57,11195,17,40,8428.71,14139.16,0.00
2024-12-10 17:43:37,57,11196,17,40,8459.04,14140.00,0.00
2024-12-10 17:43:37,58,11196,18,40,8313.19,14140.02,0.00
2024-12-10 17:43:37,58,11197,18,40,8290.20,14141.00,0.00
2024-12-10 17:43:37,59,11197,18,41,8149.68,14141.02,0.00
2024-12-10 17:43:37,58,11197,18,40,8219.53,14141.16,0.00
2024-12-10 17:43:37,58,11198,18,40,8246.89,14142.00,0.00
2024-12-10 17:43:37,59,11198,18,41,8107.12,14142.02,0.00
2024-12-10 17:43:37,59,11199,18,41,8097.65,14143.00,0.00
2024-12-10 17:43:37,60,11199,19,41,7962.69,14143.02,0.00
2024-12-10 17:43:37,59,11199,18,41,7956.75,14143.27,0.00
2024-12-10 17:43:37,59,11200,18,41,8093.88,14144.00,0.00
2024-12-10 17:43:37,60,11200,19,41,7958.98,14144.02,0.00
2024-12-10 17:43:37,59,11200,19,40,8046.01,14144.24,0.00
2024-12-10 17:43:37,59,11201,19,40,8082.46,14145.00,0.00
2024-12-10 17:43:37,60,11201,20,40,7947.76,14145.02,0.00
2024-12-10 17:43:37,60,11202,20,40,7938.37,14146.00,0.00
2024-12-10 17:43:37,61,11202,21,40,7808.23,14146.02,0.00
2024-12-10 17:43:37,61,11203,21,40,7763.58,14147.00,0.00
2024-12-10 17:43:37,62,11203,21,41,7638.36,14147.02,0.00
2024-12-10 17:43:37,61,11203,21,40,7714.94,14147.25,0.00
2024-12-10 17:43:37,61,11204,21,40,7747.90,14148.00,0.00
2024-12-10 17:43:37,62,11204,21,41,7622.93,14148.02,0.00
2024-12-10 17:43:37,61,11204,21,40,7745.58,14148.02,0.00
2024-12-10 17:43:37,61,11205,21,40,7736.15,14149.00,0.00
2024-12-10 17:43:37,62,11205,22,40,7611.37,14149.02,0.00
2024-12-10 17:43:37,61,11205,21,40,7558.99,14149.57,0.00
2024-12-10 17:43:37,61,11206,21,40,7730.95,14150.00,0.00
2024-12-10 17:43:37,62,11206,21,41,7606.25,14150.02,0.00
2024-12-10 17:43:37,61,11206,21,40,7686.93,14150.23,0.00
2024-12-10 17:43:37,61,11207,21,40,7717.57,14151.00,0.00
2024-12-10 17:43:37,62,11207,22,40,7593.10,14151.02,0.00
2024-12-10 17:43:37,61,11207,22,39,7715.25,14151.02,0.00
2024-12-10 17:43:37,62,11206,22,40,7586.25,14151.08,0.00
2024-12-10 17:43:37,61,11206,21,40,7669.19,14151.71,0.00
2024-12-10 17:43:37,61,11207,21,40,7859.64,14152.00,0.00
2024-12-10 17:43:37,62,11207,21,41,7732.87,14152.02,0.00
2024-12-10 17:43:37,61,11207,21,40,7857.32,14152.02,0.00
2024-12-10 17:43:37,60,11207,20,40,7964.75,14152.18,0.00
2024-12-10 17:43:37,60,11208,20,40,8179.90,14153.00,0.00
2024-12-10 17:43:37,61,11208,21,40,8045.81,14153.02,0.00
2024-12-10 17:43:37,60,11208,21,39,8177.54,14153.02,0.00
2024-12-10 17:43:37,59,11208,21,38,8282.62,14153.17,0.00
2024-12-10 17:43:37,59,11209,21,38,8309.54,14154.00,0.00
2024-12-10 17:43:37,60,11209,21,39,8171.04,14154.02,0.00
2024-12-10 17:43:37,60,11210,21,39,8150.63,14155.00,0.00
2024-12-10 17:43:37,61,11210,22,39,8017.02,14155.02,0.00
2024-12-10 17:43:37,60,11210,21,39,7919.68,14155.90,0.00
2024-12-10 17:43:37,60,11211,21,39,8141.53,14156.00,0.00
2024-12-10 17:43:37,61,11211,21,40,8008.06,14156.02,0.00
2024-12-10 17:43:37,60,11211,21,39,8113.27,14156.17,0.00
2024-12-10 17:43:37,60,11212,21,39,8137.38,14157.00,0.00
2024-12-10 17:43:37,61,11212,21,40,8003.98,14157.02,0.00
2024-12-10 17:43:37,61,11213,21,40,7980.70,14158.00,0.00
2024-12-10 17:43:37,62,11213,21,41,7851.98,14158.02,0.00
2024-12-10 17:43:37,61,11213,20,41,7860.72,14158.25,0.00
2024-12-10 17:43:37,61,11214,20,41,7986.54,14159.00,0.00
2024-12-10 17:43:37,62,11214,20,42,7857.73,14159.02,0.00
2024-12-10 17:43:37,61,11214,20,41,7963.38,14159.16,0.00
2024-12-10 17:43:37,61,11215,20,41,7984.79,14160.00,0.00
2024-12-10 17:43:37,62,11215,20,42,7856.00,14160.02,0.00
2024-12-10 17:43:37,62,11216,20,42,7830.92,14161.00,0.00
2024-12-10 17:43:37,63,11216,21,42,7706.62,14161.02,0.00
2024-12-10 17:43:37,62,11216,21,41,7764.73,14161.16,0.00
2024-12-10 17:43:37,61,11216,20,41,7820.32,14161.67,0.00
2024-12-10 17:43:37,60,11216,19,41,7859.31,14161.92,0.00
2024-12-10 17:43:37,60,11217,19,41,8083.61,14162.00,0.00
2024-12-10 17:43:37,61,11217,19,42,7951.09,14162.02,0.00
2024-12-10 17:43:37,61,11218,19,42,7925.40,14163.00,0.00
2024-12-10 17:43:37,62,11218,19,43,7797.58,14163.02,0.00
2024-12-10 17:43:37,61,11218,19,42,7860.44,14163.16,0.00
2024-12-10 17:43:37,60,11218,18,42,7991.45,14163.17,0.00
2024-12-10 17:43:37,59,11218,17,42,8010.14,14163.46,0.00
2024-12-10 17:43:37,59,11219,17,42,8173.77,14164.00,0.00
2024-12-10 17:43:38,60,11219,18,42,8037.54,14164.02,0.00
2024-12-10 17:43:38,59,11219,17,42,8036.42,14164.61,0.00
2024-12-10 17:43:38,59,11220,17,42,8221.58,14165.00,0.00
2024-12-10 17:43:38,60,11220,17,43,8084.55,14165.02,0.00
2024-12-10 17:43:38,59,11220,17,42,8151.99,14165.17,0.00
2024-12-10 17:43:38,59,11221,17,42,8178.94,14166.00,0.00
2024-12-10 17:43:38,60,11221,17,43,8042.62,14166.02,0.00
2024-12-10 17:43:38,60,11222,17,43,8045.93,14167.00,0.00
2024-12-10 17:43:38,61,11222,17,44,7914.03,14167.02,0.00
2024-12-10 17:43:38,60,11222,16,44,7871.10,14167.63,0.00
2024-12-10 17:43:38,60,11223,16,44,8055.56,14168.00,0.00
2024-12-10 17:43:38,61,11223,16,45,7923.50,14168.02,0.00
2024-12-10 17:43:38,60,11223,16,44,7996.57,14168.18,0.00
2024-12-10 17:43:38,60,11224,16,44,8023.07,14169.00,0.00
2024-12-10 17:43:38,61,11224,17,44,7891.55,14169.02,0.00
2024-12-10 17:43:38,62,11223,17,45,7532.99,14169.89,0.00
2024-12-10 17:43:38,62,11224,17,45,7761.64,14170.00,0.00
2024-12-10 17:43:38,63,11224,17,46,7638.44,14170.02,0.00
2024-12-10 17:43:38,62,11224,17,45,7688.55,14170.19,0.00
2024-12-10 17:43:38,62,11225,17,45,7940.46,14171.00,0.00
2024-12-10 17:43:38,63,11225,18,45,7814.42,14171.02,0.00
2024-12-10 17:43:38,62,11225,17,45,7731.97,14171.68,0.00
2024-12-10 17:43:38,62,11226,17,45,7915.10,14172.00,0.00
2024-12-10 17:43:38,63,11226,17,46,7789.46,14172.02,0.00
2024-12-10 17:43:38,62,11226,17,45,7844.28,14172.19,0.00
2024-12-10 17:43:38,62,11227,17,45,7867.65,14173.00,0.00
2024-12-10 17:43:38,63,11227,18,45,7742.77,14173.02,0.00
2024-12-10 17:43:38,62,11227,17,45,7729.32,14173.60,0.00
2024-12-10 17:43:38,62,11228,17,45,7901.10,14174.00,0.00
2024-12-10 17:43:38,63,11228,18,45,7775.69,14174.02,0.00
2024-12-10 17:43:38,62,11228,18,44,7832.56,14174.19,0.00
2024-12-10 17:43:38,62,11229,18,44,7855.94,14175.00,0.00
2024-12-10 17:43:38,63,11229,19,44,7731.24,14175.02,0.00
2024-12-10 17:43:38,62,11229,18,44,7665.61,14175.55,0.00
2024-12-10 17:43:38,62,11230,18,44,7830.58,14176.00,0.00
2024-12-10 17:43:38,63,11230,19,44,7706.28,14176.02,0.00
2024-12-10 17:43:38,62,11230,19,43,7826.02,14176.03,0.00
2024-12-10 17:43:38,61,11230,19,42,7889.27,14176.18,0.00
2024-12-10 17:43:38,60,11230,18,42,7986.91,14176.22,0.00
2024-12-10 17:43:38,60,11231,18,42,8112.66,14177.00,0.00
2024-12-10 17:43:38,61,11231,19,42,7979.67,14177.02,0.00
2024-12-10 17:43:38,60,11231,19,41,8107.95,14177.03,0.00
2024-12-10 17:43:38,60,11232,19,41,8087.33,14178.00,0.00
2024-12-10 17:43:38,61,11232,20,41,7954.75,14178.02,0.00
2024-12-10 17:43:38,60,11232,20,40,8018.84,14178.18,0.00
2024-12-10 17:43:38,60,11233,20,40,8045.37,14179.00,0.00
2024-12-10 17:43:38,61,11233,20,41,7913.48,14179.02,0.00
2024-12-10 17:43:38,60,11233,20,40,8040.65,14179.03,0.00
2024-12-10 17:43:38,59,11233,19,40,8157.88,14179.15,0.00
2024-12-10 17:43:38,58,11233,18,40,8298.53,14179.16,0.00
2024-12-10 17:43:38,58,11234,18,40,8374.87,14180.00,0.00
2024-12-10 17:43:38,59,11234,19,40,8232.93,14180.02,0.00
2024-12-10 17:43:38,58,11234,19,39,8306.45,14180.16,0.00
2024-12-10 17:43:38,58,11235,19,39,8333.90,14181.00,0.00
2024-12-10 17:43:38,59,11235,19,40,8192.65,14181.02,0.00
2024-12-10 17:43:38,58,11235,18,40,8164.10,14181.43,0.00
2024-12-10 17:43:38,58,11236,18,40,8328.35,14182.00,0.00
2024-12-10 17:43:38,59,11236,19,40,8187.19,14182.02,0.00
2024-12-10 17:43:38,58,11236,19,39,8259.91,14182.16,0.00
2024-12-10 17:43:38,57,11236,18,39,8298.22,14182.77,0.00
2024-12-10 17:43:38,57,11237,18,39,8514.87,14183.00,0.00
2024-12-10 17:43:38,58,11237,19,39,8368.06,14183.02,0.00
2024-12-10 17:43:38,58,11238,19,39,8342.39,14184.00,0.00
2024-12-10 17:43:38,59,11238,19,40,8200.99,14184.02,0.00
2024-12-10 17:43:38,58,11238,19,39,8276.38,14184.16,0.00
2024-12-10 17:43:38,58,11239,19,39,8303.85,14185.00,0.00
2024-12-10 17:43:38,59,11239,19,40,8163.10,14185.02,0.00
2024-12-10 17:43:38,58,11239,19,39,8298.96,14185.03,0.00
2024-12-10 17:43:38,58,11240,19,39,8278.05,14186.00,0.00
2024-12-10 17:43:38,59,11240,20,39,8137.74,14186.02,0.00
2024-12-10 17:43:38,58,11240,20,38,8212.04,14186.16,0.00
2024-12-10 17:43:38,57,11240,19,38,8273.72,14186.63,0.00
2024-12-10 17:43:38,57,11241,19,38,8470.63,14187.00,0.00
2024-12-10 17:43:38,58,11241,20,38,8324.58,14187.02,0.00
2024-12-10 17:43:38,57,11241,20,37,8463.18,14187.05,0.00
2024-12-10 17:43:38,57,11242,20,37,8448.31,14188.00,0.00
2024-12-10 17:43:38,58,11242,20,38,8302.65,14188.02,0.00
2024-12-10 17:43:38,57,11242,20,37,8440.86,14188.05,0.00
2024-12-10 17:43:38,56,11242,19,37,8581.47,14188.13,0.00
2024-12-10 17:43:38,55,11242,19,36,8683.32,14188.13,0.00
2024-12-10 17:43:38,55,11243,19,36,8714.86,14189.00,0.00
2024-12-10 17:43:38,56,11243,20,36,8559.24,14189.02,0.00
2024-12-10 17:43:38,55,11243,20,35,8707.14,14189.05,0.00
2024-12-10 17:43:38,55,11244,20,35,8688.54,14190.00,0.00
2024-12-10 17:43:38,56,11244,21,35,8533.39,14190.02,0.00
2024-12-10 17:43:38,55,11244,21,34,8624.07,14190.11,0.00
2024-12-10 17:43:38,54,11244,20,34,8748.16,14190.17,0.00
2024-12-10 17:43:38,54,11245,20,34,8893.27,14191.00,0.00
2024-12-10 17:43:38,55,11245,20,35,8731.57,14191.02,0.00
2024-12-10 17:43:38,55,11246,20,35,8702.45,14192.00,0.00
2024-12-10 17:43:38,56,11246,21,35,8547.05,14192.02,0.00
2024-12-10 17:43:38,55,11246,21,34,8640.55,14192.11,0.00
2024-12-10 17:43:38,55,11247,21,34,8669.52,14193.00,0.00
2024-12-10 17:43:38,56,11247,22,34,8514.70,14193.02,0.00
2024-12-10 17:43:38,56,11248,22,34,8489.73,14194.00,0.00
2024-12-10 17:43:38,57,11248,22,35,8340.78,14194.02,0.00
2024-12-10 17:43:38,56,11248,22,34,8426.38,14194.11,0.00
2024-12-10 17:43:38,56,11248,22,34,8452.30,14195.00,0.00
2024-12-10 17:43:38,57,11248,23,34,8304.02,14195.02,0.00
2024-12-10 17:43:38,56,11248,22,34,8231.09,14195.91,0.00
2024-12-10 17:43:38,56,11249,22,34,8471.97,14196.00,0.00
2024-12-10 17:43:39,57,11249,22,35,8323.34,14196.02,0.00
2024-12-10 17:43:39,56,11249,22,34,8403.55,14196.13,0.00
2024-12-10 17:43:39,56,11250,22,34,8432.01,14197.00,0.00
2024-12-10 17:43:39,57,11250,22,35,8284.08,14197.02,0.00
2024-12-10 17:43:39,57,11251,22,35,8261.08,14198.00,0.00
2024-12-10 17:43:39,58,11251,22,36,8118.65,14198.02,0.00
2024-12-10 17:43:39,57,11251,22,35,8196.33,14198.12,0.00
2024-12-10 17:43:39,57,11252,22,35,8221.80,14199.00,0.00
2024-12-10 17:43:39,58,11252,22,36,8080.05,14199.02,0.00
2024-12-10 17:43:39,57,11252,21,36,8207.10,14199.11,0.00
2024-12-10 17:43:39,56,11252,20,36,8331.36,14199.11,0.00
2024-12-10 17:43:39,56,11253,20,36,8408.00,14200.00,0.00
2024-12-10 17:43:39,57,11253,21,36,8260.49,14200.02,0.00
2024-12-10 17:43:39,57,11254,21,36,8221.21,14201.00,0.00
2024-12-10 17:43:39,58,11254,21,37,8079.46,14201.02,0.00
2024-12-10 17:43:39,57,11254,21,36,8206.28,14201.11,0.00
2024-12-10 17:43:39,57,11255,21,36,8229.26,14202.00,0.00
2024-12-10 17:43:39,58,11255,21,37,8087.38,14202.02,0.00
2024-12-10 17:43:39,57,11255,20,37,8037.63,14202.49,0.00
2024-12-10 17:43:39,57,11256,20,37,8214.89,14203.00,0.00
2024-12-10 17:43:39,58,11256,20,38,8073.25,14203.02,0.00
2024-12-10 17:43:39,57,11256,20,37,8152.61,14203.11,0.00
2024-12-10 17:43:39,57,11257,20,37,8175.60,14204.00,0.00
2024-12-10 17:43:39,58,11257,21,37,8034.64,14204.02,0.00
2024-12-10 17:43:39,57,11257,20,37,7983.94,14204.49,0.00
2024-12-10 17:43:39,57,11258,20,37,8161.22,14205.00,0.00
2024-12-10 17:43:39,58,11258,21,37,8020.51,14205.02,0.00
2024-12-10 17:43:39,58,11259,21,37,7979.44,14206.00,0.00
2024-12-10 17:43:39,59,11259,21,38,7844.19,14206.02,0.00
2024-12-10 17:43:39,58,11259,21,37,7972.10,14206.05,0.00
2024-12-10 17:43:39,57,11259,21,36,8101.99,14206.09,0.00
2024-12-10 17:43:39,57,11260,21,36,8122.49,14207.00,0.00
2024-12-10 17:43:39,58,11260,21,37,7982.45,14207.02,0.00
2024-12-10 17:43:39,58,11261,21,37,7963.77,14208.00,0.00
2024-12-10 17:43:39,59,11261,21,38,7828.79,14208.02,0.00
2024-12-10 17:43:39,58,11261,21,37,7958.87,14208.03,0.00
2024-12-10 17:43:39,57,11261,21,36,8096.01,14208.04,0.00
2024-12-10 17:43:39,56,11261,21,35,8184.77,14208.05,0.00
2024-12-10 17:43:39,55,11261,20,35,8250.82,14208.56,0.00
2024-12-10 17:43:39,54,11261,19,35,8393.13,14208.65,0.00
2024-12-10 17:43:39,54,11262,19,35,8606.52,14209.00,0.00
2024-12-10 17:43:39,55,11262,19,36,8450.04,14209.02,0.00
2024-12-10 17:43:39,55,11263,19,36,8428.74,14210.00,0.00
2024-12-10 17:43:39,56,11263,19,37,8278.23,14210.02,0.00
2024-12-10 17:43:39,55,11263,19,36,8369.32,14210.05,0.00
2024-12-10 17:43:39,55,11264,19,36,8390.25,14211.00,0.00
2024-12-10 17:43:39,56,11264,19,37,8240.43,14211.02,0.00
2024-12-10 17:43:39,56,11265,19,37,8217.06,14212.00,0.00
2024-12-10 17:43:39,57,11265,19,38,8072.90,14212.02,0.00
2024-12-10 17:43:39,56,11265,18,38,8200.31,14212.02,0.00
2024-12-10 17:43:39,55,11265,18,37,8298.14,14212.04,0.00
2024-12-10 17:43:39,55,11266,18,37,8420.18,14213.00,0.00
2024-12-10 17:43:39,56,11266,19,37,8269.82,14213.02,0.00
2024-12-10 17:43:39,55,11266,18,37,8289.86,14213.56,0.00
2024-12-10 17:43:39,54,11266,17,37,8420.98,14213.63,0.00
2024-12-10 17:43:39,54,11267,17,37,8631.84,14214.00,0.00
2024-12-10 17:43:39,55,11267,17,38,8474.90,14214.02,0.00
2024-12-10 17:43:39,54,11267,17,37,8579.20,14214.04,0.00
2024-12-10 17:43:39,54,11268,17,37,8600.86,14215.00,0.00
2024-12-10 17:43:39,55,11268,18,37,8444.48,14215.02,0.00
2024-12-10 17:43:39,54,11268,17,37,8403.65,14215.50,0.00
2024-12-10 17:43:39,54,11269,17,37,8596.20,14216.00,0.00
2024-12-10 17:43:39,55,11269,18,37,8439.90,14216.02,0.00
2024-12-10 17:43:39,54,11269,18,36,8540.92,14216.06,0.00
2024-12-10 17:43:39,54,11270,18,36,8565.21,14217.00,0.00
2024-12-10 17:43:39,55,11270,18,37,8409.48,14217.02,0.00
2024-12-10 17:43:39,55,11271,18,37,8385.06,14218.00,0.00
2024-12-10 17:43:39,56,11271,19,37,8235.33,14218.02,0.00
2024-12-10 17:43:39,55,11271,19,36,8330.78,14218.05,0.00
2024-12-10 17:43:39,55,11272,19,36,8352.04,14219.00,0.00
2024-12-10 17:43:39,56,11272,19,37,8202.90,14219.02,0.00
2024-12-10 17:43:39,56,11273,19,37,8179.73,14220.00,0.00
2024-12-10 17:43:39,57,11273,19,38,8036.22,14220.02,0.00
2024-12-10 17:43:39,56,11273,19,37,8128.95,14220.05,0.00
2024-12-10 17:43:39,56,11274,19,37,8147.29,14221.00,0.00
2024-12-10 17:43:39,57,11274,19,38,8004.35,14221.02,0.00
2024-12-10 17:43:39,56,11274,18,38,8060.95,14221.04,0.00
2024-12-10 17:43:39,56,11275,18,38,8127.54,14222.00,0.00
2024-12-10 17:43:39,57,11275,19,38,7984.96,14222.02,0.00
2024-12-10 17:43:39,56,11275,18,38,8125.00,14222.02,0.00
2024-12-10 17:43:39,55,11275,18,37,8228.77,14222.02,0.00
2024-12-10 17:43:39,55,11276,18,37,8244.87,14223.00,0.00
2024-12-10 17:43:39,56,11276,19,37,8097.64,14223.02,0.00
2024-12-10 17:43:39,56,11277,19,37,8073.70,14224.00,0.00
2024-12-10 17:43:39,57,11277,19,38,7932.05,14224.02,0.00
2024-12-10 17:43:39,56,11277,19,37,8033.06,14224.02,0.00
2024-12-10 17:43:39,56,11278,19,37,8046.32,14225.00,0.00
2024-12-10 17:43:39,57,11278,20,37,7905.16,14225.02,0.00
2024-12-10 17:43:39,57,11279,20,37,7880.92,14226.00,0.00
2024-12-10 17:43:39,58,11279,21,37,7745.05,14226.02,0.00
2024-12-10 17:43:39,57,11279,21,36,7843.49,14226.02,0.00
2024-12-10 17:43:39,56,11279,20,36,7906.69,14226.55,0.00
2024-12-10 17:43:39,56,11280,20,36,7995.92,14227.00,0.00
2024-12-10 17:43:39,57,11280,20,37,7855.64,14227.02,0.00
2024-12-10 17:43:39,57,11281,20,37,7831.77,14228.00,0.00
2024-12-10 17:43:39,58,11281,20,38,7696.74,14228.02,0.00
2024-12-10 17:43:39,57,11281,20,37,7791.83,14228.04,0.00
2024-12-10 17:43:39,56,11281,19,37,7747.99,14228.93,0.00
2024-12-10 17:43:40,56,11282,19,37,7991.96,14229.00,0.00
2024-12-10 17:43:40,57,11282,19,38,7851.75,14229.02,0.00
2024-12-10 17:43:40,57,11283,19,38,7827.34,14230.00,0.00
2024-12-10 17:43:40,58,11283,19,39,7692.39,14230.02,0.00
2024-12-10 17:43:40,57,11283,19,38,7789.89,14230.04,0.00
2024-12-10 17:43:40,56,11283,18,38,7814.77,14230.36,0.00
2024-12-10 17:43:40,56,11284,18,38,7977.84,14231.00,0.00
2024-12-10 17:43:40,57,11284,19,38,7837.88,14231.02,0.00
2024-12-10 17:43:40,56,11284,18,38,7759.57,14231.88,0.00
2024-12-10 17:43:40,56,11285,18,38,7996.02,14232.00,0.00
2024-12-10 17:43:40,57,11285,19,38,7855.74,14232.02,0.00
2024-12-10 17:43:40,56,11285,19,37,7957.90,14232.04,0.00
2024-12-10 17:43:40,56,11286,19,37,7973.71,14233.00,0.00
2024-12-10 17:43:40,57,11286,19,38,7833.82,14233.02,0.00
2024-12-10 17:43:40,56,11286,18,38,7869.57,14233.25,0.00
2024-12-10 17:43:40,56,11287,18,38,8017.48,14234.00,0.00
2024-12-10 17:43:40,57,11287,19,38,7876.82,14234.02,0.00
2024-12-10 17:43:40,56,11287,18,38,7935.34,14234.14,0.00
2024-12-10 17:43:40,55,11287,17,38,8004.85,14234.67,0.00
2024-12-10 17:43:40,55,11288,17,38,8217.33,14235.00,0.00
2024-12-10 17:43:40,56,11288,17,39,8070.60,14235.02,0.00
2024-12-10 17:43:40,55,11288,17,38,8183.69,14235.04,0.00
2024-12-10 17:43:40,55,11289,17,38,8202.38,14236.00,0.00
2024-12-10 17:43:40,56,11289,18,38,8055.91,14236.02,0.00
2024-12-10 17:43:40,55,11289,17,38,8201.71,14236.02,0.00
2024-12-10 17:43:40,54,11289,17,37,8316.69,14236.04,0.00
2024-12-10 17:43:40,54,11290,17,37,8338.36,14237.00,0.00
2024-12-10 17:43:40,55,11290,18,37,8186.75,14237.02,0.00
2024-12-10 17:43:40,55,11291,18,37,8157.70,14238.00,0.00
2024-12-10 17:43:40,56,11291,18,38,8012.03,14238.02,0.00
2024-12-10 17:43:40,55,11291,18,37,8124.06,14238.04,0.00
2024-12-10 17:43:40,54,11291,17,37,8263.97,14238.11,0.00
2024-12-10 17:43:40,54,11292,17,37,8296.17,14239.00,0.00
2024-12-10 17:43:40,55,11292,17,38,8145.33,14239.02,0.00
2024-12-10 17:43:40,55,11293,17,38,8113.28,14240.00,0.00
2024-12-10 17:43:40,56,11293,18,38,7968.40,14240.02,0.00
2024-12-10 17:43:40,55,11293,18,37,8082.21,14240.04,0.00
2024-12-10 17:43:40,55,11294,18,37,8100.90,14241.00,0.00
2024-12-10 17:43:40,56,11294,19,37,7956.24,14241.02,0.00
2024-12-10 17:43:40,55,11294,18,37,7889.07,14241.89,0.00
2024-12-10 17:43:40,55,11295,18,37,8132.54,14242.00,0.00
2024-12-10 17:43:40,56,11295,18,38,7987.32,14242.02,0.00
2024-12-10 17:43:40,55,11295,18,37,8101.48,14242.04,0.00
2024-12-10 17:43:40,54,11295,17,37,8170.94,14242.59,0.00
2024-12-10 17:43:40,54,11296,17,37,8271.47,14243.00,0.00
2024-12-10 17:43:40,55,11296,17,38,8121.08,14243.02,0.00
2024-12-10 17:43:40,55,11297,17,38,8098.01,14244.00,0.00
2024-12-10 17:43:40,56,11297,17,39,7953.41,14244.02,0.00
2024-12-10 17:43:40,55,11297,17,38,8046.23,14244.09,0.00
2024-12-10 17:43:40,55,11298,17,38,8072.68,14245.00,0.00
2024-12-10 17:43:40,56,11298,18,38,7928.52,14245.02,0.00
2024-12-10 17:43:40,55,11298,17,38,8069.99,14245.04,0.00
2024-12-10 17:43:40,55,11299,17,38,8140.49,14246.00,0.00
2024-12-10 17:43:40,56,11299,17,39,7995.12,14246.02,0.00
2024-12-10 17:43:40,55,11299,16,39,7940.45,14246.84,0.00
2024-12-10 17:43:40,55,11300,16,39,8176.29,14247.00,0.00
2024-12-10 17:43:40,56,11300,16,40,8030.29,14247.02,0.00
2024-12-10 17:43:40,55,11300,16,39,8173.70,14247.02,0.00
2024-12-10 17:43:40,54,11300,16,38,8280.23,14247.06,0.00
2024-12-10 17:43:40,54,11301,16,38,8304.54,14248.00,0.00
2024-12-10 17:43:40,55,11301,17,38,8153.55,14248.02,0.00
2024-12-10 17:43:40,54,11301,16,38,8159.54,14248.33,0.00
2024-12-10 17:43:40,54,11302,16,38,8328.87,14249.00,0.00
2024-12-10 17:43:40,55,11302,16,39,8177.44,14249.02,0.00
2024-12-10 17:43:40,54,11302,16,38,8281.39,14249.06,0.00
2024-12-10 17:43:40,54,11303,16,38,8305.71,14250.00,0.00
2024-12-10 17:43:40,55,11303,16,39,8154.70,14250.02,0.00
2024-12-10 17:43:40,55,11304,16,39,8128.63,14251.00,0.00
2024-12-10 17:43:40,56,11304,16,40,7983.48,14251.02,0.00
2024-12-10 17:43:40,55,11304,16,39,8084.59,14251.05,0.00
2024-12-10 17:43:40,54,11304,15,39,8106.11,14251.76,0.00
2024-12-10 17:43:40,54,11305,15,39,8335.91,14252.00,0.00
2024-12-10 17:43:40,55,11305,16,39,8184.35,14252.02,0.00
2024-12-10 17:43:40,55,11306,16,39,8166.93,14253.00,0.00
2024-12-10 17:43:40,56,11306,16,40,8021.09,14253.02,0.00
2024-12-10 17:43:40,55,11306,16,39,8109.94,14253.07,0.00
2024-12-10 17:43:40,55,11307,16,39,8133.81,14254.00,0.00
2024-12-10 17:43:40,56,11307,16,40,7988.57,14254.02,0.00
2024-12-10 17:43:40,55,11307,15,40,8126.05,14254.07,0.00
2024-12-10 17:43:40,54,11307,14,40,8215.83,14254.09,0.00
2024-12-10 17:43:40,54,11308,14,40,8351.02,14255.00,0.00
2024-12-10 17:43:40,55,11308,15,40,8199.18,14255.02,0.00
2024-12-10 17:43:40,54,11308,15,39,8290.32,14255.07,0.00
2024-12-10 17:43:40,54,11309,15,39,8317.28,14256.00,0.00
2024-12-10 17:43:40,55,11309,15,40,8166.06,14256.02,0.00
2024-12-10 17:43:40,55,11310,15,40,8150.00,14257.00,0.00
2024-12-10 17:43:40,56,11310,16,40,8004.47,14257.02,0.00
2024-12-10 17:43:40,55,11310,16,39,8090.40,14257.07,0.00
2024-12-10 17:43:40,54,11310,15,39,8161.62,14257.61,0.00
2024-12-10 17:43:40,53,11310,14,39,8209.36,14257.92,0.00
2024-12-10 17:43:40,53,11311,14,39,8467.68,14258.00,0.00
2024-12-10 17:43:40,54,11311,15,39,8310.87,14258.02,0.00
2024-12-10 17:43:40,54,11312,15,39,8293.18,14259.00,0.00
2024-12-10 17:43:40,55,11312,16,39,8142.40,14259.02,0.00
2024-12-10 17:43:40,55,11313,16,39,8108.03,14260.00,0.00
2024-12-10 17:43:40,56,11313,16,40,7963.24,14260.02,0.00
2024-12-10 17:43:40,55,11313,16,39,8079.51,14260.05,0.00
2024-12-10 17:43:40,54,11313,15,39,8168.20,14260.48,0.00
2024-12-10 17:43:40,54,11314,15,39,8253.10,14261.00,0.00
2024-12-10 17:43:40,55,11314,16,39,8103.04,14261.02,0.00
2024-12-10 17:43:41,54,11314,16,38,8202.92,14261.06,0.00
2024-12-10 17:43:41,54,11315,16,38,8227.27,14262.00,0.00
2024-12-10 17:43:41,55,11315,16,39,8077.68,14262.02,0.00
2024-12-10 17:43:41,54,11315,15,39,7996.64,14262.94,0.00
2024-12-10 17:43:41,54,11316,15,39,8252.87,14263.00,0.00
2024-12-10 17:43:41,55,11316,16,39,8102.82,14263.02,0.00
2024-12-10 17:43:41,54,11316,16,38,8205.34,14263.06,0.00
2024-12-10 17:43:41,54,11317,16,38,8229.68,14264.00,0.00
2024-12-10 17:43:41,55,11317,17,38,8080.05,14264.02,0.00
2024-12-10 17:43:41,55,11318,17,38,8055.97,14265.00,0.00
2024-12-10 17:43:41,56,11318,18,38,7912.12,14265.02,0.00
2024-12-10 17:43:41,55,11318,18,37,8011.88,14265.05,0.00
2024-12-10 17:43:41,54,11318,17,37,8152.35,14265.11,0.00
2024-12-10 17:43:41,53,11318,16,37,8141.12,14265.91,0.00
2024-12-10 17:43:41,53,11319,16,37,8396.90,14266.00,0.00
2024-12-10 17:43:41,54,11319,17,37,8241.40,14266.02,0.00
2024-12-10 17:43:41,54,11320,17,37,8217.32,14267.00,0.00
2024-12-10 17:43:41,55,11320,17,38,8067.92,14267.02,0.00
2024-12-10 17:43:41,54,11320,17,37,8172.41,14267.06,0.00
2024-12-10 17:43:41,54,11321,17,37,8196.76,14268.00,0.00
2024-12-10 17:43:41,55,11321,17,38,8047.73,14268.02,0.00
2024-12-10 17:43:41,54,11321,16,38,7975.06,14268.57,0.00
2024-12-10 17:43:41,54,11322,16,38,8178.84,14269.00,0.00
2024-12-10 17:43:41,55,11322,16,39,8030.13,14269.02,0.00
2024-12-10 17:43:41,54,11322,16,38,8136.56,14269.06,0.00
2024-12-10 17:43:41,54,11323,16,38,8160.91,14270.00,0.00
2024-12-10 17:43:41,55,11323,17,38,8012.53,14270.02,0.00
2024-12-10 17:43:41,54,11323,16,38,7952.36,14270.54,0.00
2024-12-10 17:43:41,54,11324,16,38,8150.92,14271.00,0.00
2024-12-10 17:43:41,55,11324,17,38,8002.72,14271.02,0.00
2024-12-10 17:43:41,54,11324,17,37,8111.28,14271.06,0.00
2024-12-10 17:43:41,54,11325,17,37,8135.63,14272.00,0.00
2024-12-10 17:43:41,55,11325,18,37,7987.71,14272.02,0.00
2024-12-10 17:43:41,54,11325,17,37,8025.86,14272.24,0.00
2024-12-10 17:43:41,54,11326,17,37,8182.31,14273.00,0.00
2024-12-10 17:43:41,55,11326,17,38,8033.54,14273.02,0.00
2024-12-10 17:43:41,54,11326,17,37,8140.02,14273.06,0.00
2024-12-10 17:43:41,54,11327,17,37,8164.38,14274.00,0.00
2024-12-10 17:43:41,55,11327,18,37,8015.93,14274.02,0.00
2024-12-10 17:43:41,54,11327,17,37,8082.48,14274.19,0.00
2024-12-10 17:43:41,54,11328,17,37,8231.04,14275.00,0.00
2024-12-10 17:43:41,55,11328,17,38,8081.38,14275.02,0.00
2024-12-10 17:43:41,54,11328,17,37,8191.38,14275.06,0.00
2024-12-10 17:43:41,54,11329,17,37,8215.75,14276.00,0.00
2024-12-10 17:43:41,55,11329,18,37,8066.37,14276.02,0.00
2024-12-10 17:43:41,54,11329,17,37,8213.11,14276.02,0.00
2024-12-10 17:43:41,54,11330,17,37,8184.08,14277.00,0.00
2024-12-10 17:43:41,55,11330,17,38,8035.28,14277.02,0.00
2024-12-10 17:43:41,54,11330,17,37,8149.71,14277.04,0.00
2024-12-10 17:43:41,53,11330,16,37,8118.68,14277.96,0.00
2024-12-10 17:43:41,53,11331,16,37,8382.71,14278.00,0.00
2024-12-10 17:43:41,54,11331,17,37,8227.48,14278.02,0.00
2024-12-10 17:43:41,53,11331,16,37,8380.02,14278.02,0.00
2024-12-10 17:43:41,53,11332,16,37,8348.67,14279.00,0.00
2024-12-10 17:43:41,54,11332,16,38,8194.06,14279.02,0.00
2024-12-10 17:43:41,53,11332,16,37,8319.03,14279.02,0.00
2024-12-10 17:43:41,53,11333,16,37,8341.17,14280.00,0.00
2024-12-10 17:43:41,54,11333,17,37,8186.70,14280.02,0.00
2024-12-10 17:43:41,54,11334,17,37,8152.89,14281.00,0.00
2024-12-10 17:43:41,55,11334,17,38,8004.66,14281.02,0.00
2024-12-10 17:43:41,54,11334,17,37,8126.45,14281.02,0.00
2024-12-10 17:43:41,54,11335,17,37,8145.53,14282.00,0.00
2024-12-10 17:43:41,55,11335,18,37,7997.43,14282.02,0.00
2024-12-10 17:43:41,54,11335,17,37,7926.13,14282.91,0.00
2024-12-10 17:43:41,54,11336,17,37,8177.46,14283.00,0.00
2024-12-10 17:43:41,55,11336,18,37,8028.78,14283.02,0.00
2024-12-10 17:43:41,54,11336,18,36,8140.44,14283.06,0.00
2024-12-10 17:43:41,54,11337,18,36,8164.80,14284.00,0.00
2024-12-10 17:43:41,55,11337,18,37,8016.35,14284.02,0.00
2024-12-10 17:43:41,55,11338,18,37,7985.55,14285.00,0.00
2024-12-10 17:43:41,56,11338,19,37,7842.95,14285.02,0.00
2024-12-10 17:43:41,55,11338,19,36,7946.60,14285.05,0.00
2024-12-10 17:43:41,54,11338,18,36,8080.56,14285.13,0.00
2024-12-10 17:43:41,53,11338,17,36,8071.99,14285.92,0.00
2024-12-10 17:43:41,53,11339,17,36,8330.80,14286.00,0.00
2024-12-10 17:43:41,54,11339,18,36,8176.53,14286.02,0.00
2024-12-10 17:43:41,55,11338,19,36,7944.82,14286.27,0.00
2024-12-10 17:43:41,54,11338,18,36,8142.31,14286.43,0.00
2024-12-10 17:43:41,54,11339,18,36,8325.26,14287.00,0.00
2024-12-10 17:43:41,55,11339,18,37,8173.90,14287.02,0.00
2024-12-10 17:43:41,54,11339,18,36,8285.59,14287.06,0.00
2024-12-10 17:43:41,54,11340,18,36,8574.56,14288.00,0.00
2024-12-10 17:43:41,55,11340,19,36,8418.66,14288.02,0.00
2024-12-10 17:43:41,55,11341,19,36,8382.88,14289.00,0.00
2024-12-10 17:43:41,56,11341,19,37,8233.19,14289.02,0.00
2024-12-10 17:43:41,55,11341,19,36,8346.52,14289.05,0.00
2024-12-10 17:43:41,54,11341,18,36,8326.98,14289.94,0.00
2024-12-10 17:43:41,54,11342,18,36,8583.70,14290.00,0.00
2024-12-10 17:43:41,55,11342,18,37,8427.64,14290.02,0.00
2024-12-10 17:43:41,55,11343,18,37,8391.85,14291.00,0.00
2024-12-10 17:43:41,56,11343,19,37,8241.99,14291.02,0.00
2024-12-10 17:43:41,55,11343,19,36,8358.08,14291.05,0.00
2024-12-10 17:43:41,54,11343,18,36,8380.74,14291.48,0.00
2024-12-10 17:43:41,54,11344,18,36,8571.67,14292.00,0.00
2024-12-10 17:43:41,55,11344,18,37,8415.82,14292.02,0.00
2024-12-10 17:43:41,54,11344,17,37,8500.25,14292.15,0.00
2024-12-10 17:43:41,53,11344,16,37,8504.47,14292.58,0.00
2024-12-10 17:43:42,53,11345,16,37,8715.13,14293.00,0.00
2024-12-10 17:43:42,54,11345,16,38,8553.74,14293.02,0.00
2024-12-10 17:43:42,53,11345,16,37,8677.39,14293.06,0.00
2024-12-10 17:43:42,52,11345,15,37,8704.29,14293.48,0.00
2024-12-10 17:43:42,52,11346,15,37,8905.35,14294.00,0.00
2024-12-10 17:43:42,53,11346,15,38,8737.32,14294.02,0.00
2024-12-10 17:43:42,53,11347,15,38,8705.56,14295.00,0.00
2024-12-10 17:43:42,54,11347,16,38,8544.35,14295.02,0.00
2024-12-10 17:43:42,53,11347,16,37,8665.11,14295.06,0.00
2024-12-10 17:43:42,52,11347,15,37,8691.76,14295.48,0.00
2024-12-10 17:43:42,52,11348,15,37,8892.85,14296.00,0.00
2024-12-10 17:43:42,53,11348,15,38,8725.06,14296.02,0.00
2024-12-10 17:43:42,53,11349,15,38,8693.30,14297.00,0.00
2024-12-10 17:43:42,54,11349,16,38,8532.31,14297.02,0.00
2024-12-10 17:43:42,53,11349,16,37,8655.54,14297.06,0.00
2024-12-10 17:43:42,53,11350,16,37,8683.11,14298.00,0.00
2024-12-10 17:43:42,54,11350,16,38,8522.31,14298.02,0.00
2024-12-10 17:43:42,53,11350,15,38,8446.28,14298.96,0.00
2024-12-10 17:43:42,53,11351,15,38,8710.70,14299.00,0.00
2024-12-10 17:43:42,54,11351,16,38,8549.39,14299.02,0.00
2024-12-10 17:43:42,53,11351,16,37,8675.63,14299.06,0.00
2024-12-10 17:43:42,53,11352,16,37,8703.21,14300.00,0.00
2024-12-10 17:43:42,54,11352,16,38,8542.04,14300.02,0.00
2024-12-10 17:43:42,53,11352,16,37,8670.84,14300.02,0.00
2024-12-10 17:43:42,53,11353,16,37,8693.03,14301.00,0.00
2024-12-10 17:43:42,54,11353,16,38,8532.05,14301.02,0.00
2024-12-10 17:43:42,54,11354,16,38,8498.21,14302.00,0.00
2024-12-10 17:43:42,55,11354,16,39,8343.70,14302.02,0.00
2024-12-10 17:43:42,54,11354,16,38,8471.73,14302.04,0.00
2024-12-10 17:43:42,54,11355,16,38,8493.51,14303.00,0.00
2024-12-10 17:43:42,55,11355,16,39,8339.08,14303.02,0.00
2024-12-10 17:43:42,54,11355,15,39,8244.83,14303.65,0.00
2024-12-10 17:43:42,53,11355,14,39,8397.69,14303.66,0.00
2024-12-10 17:43:42,53,11356,14,39,8619.28,14304.00,0.00
2024-12-10 17:43:42,54,11356,14,40,8459.67,14304.02,0.00
2024-12-10 17:43:42,53,11356,14,39,8589.60,14304.04,0.00
2024-12-10 17:43:42,52,11356,13,39,8579.00,14304.60,0.00
2024-12-10 17:43:42,52,11357,13,39,8796.66,14305.00,0.00
2024-12-10 17:43:42,53,11357,13,40,8630.68,14305.02,0.00
2024-12-10 17:43:42,53,11358,13,40,8676.54,14306.00,0.00
2024-12-10 17:43:42,54,11358,13,41,8515.86,14306.02,0.00
2024-12-10 17:43:42,53,11358,12,41,8603.70,14306.15,0.00
2024-12-10 17:43:42,53,11359,12,41,8701.46,14307.00,0.00
2024-12-10 17:43:42,54,11359,12,42,8540.32,14307.02,0.00
2024-12-10 17:43:42,53,11359,11,42,8489.00,14307.47,0.00
2024-12-10 17:43:42,53,11359,11,42,8683.79,14308.00,0.00
2024-12-10 17:43:42,54,11359,11,43,8522.98,14308.02,0.00
2024-12-10 17:43:42,53,11359,11,42,8629.79,14308.04,0.00
2024-12-10 17:43:42,53,11360,11,42,8654.69,14309.00,0.00
2024-12-10 17:43:42,54,11360,12,42,8494.42,14309.02,0.00
2024-12-10 17:43:42,54,11361,12,42,8460.57,14310.00,0.00
2024-12-10 17:43:42,55,11361,12,43,8306.74,14310.02,0.00
2024-12-10 17:43:42,54,11361,12,42,8434.07,14310.04,0.00
2024-12-10 17:43:42,54,11362,12,42,8455.86,14311.00,0.00
2024-12-10 17:43:42,55,11362,13,42,8302.11,14311.02,0.00
2024-12-10 17:43:42,55,11363,13,42,8266.26,14312.00,0.00
2024-12-10 17:43:42,56,11363,14,42,8118.65,14312.02,0.00
2024-12-10 17:43:42,55,11363,14,41,8263.66,14312.02,0.00
2024-12-10 17:43:42,54,11363,14,40,8395.49,14312.02,0.00
2024-12-10 17:43:42,53,11363,13,40,8389.39,14312.53,0.00
2024-12-10 17:43:42,53,11364,13,40,8592.30,14313.00,0.00
2024-12-10 17:43:42,54,11364,14,40,8433.18,14313.02,0.00
2024-12-10 17:43:42,53,11364,13,40,8438.50,14313.38,0.00
2024-12-10 17:43:42,53,11365,13,40,8619.91,14314.00,0.00
2024-12-10 17:43:42,54,11365,13,41,8460.28,14314.02,0.00
2024-12-10 17:43:42,53,11365,13,40,8595.60,14314.02,0.00
2024-12-10 17:43:42,53,11366,13,40,8617.81,14315.00,0.00
2024-12-10 17:43:42,54,11366,13,41,8458.22,14315.02,0.00
2024-12-10 17:43:42,54,11367,13,41,8424.35,14316.00,0.00
2024-12-10 17:43:42,55,11367,14,41,8271.18,14316.02,0.00
2024-12-10 17:43:42,54,11367,14,40,8403.14,14316.02,0.00
2024-12-10 17:43:42,53,11367,13,40,8400.12,14316.89,0.00
2024-12-10 17:43:42,53,11368,13,40,8654.13,14317.00,0.00
2024-12-10 17:43:42,54,11368,13,41,8493.87,14317.02,0.00
2024-12-10 17:43:42,54,11369,13,41,8459.99,14318.00,0.00
2024-12-10 17:43:42,55,11369,13,42,8306.17,14318.02,0.00
2024-12-10 17:43:42,54,11369,13,41,8441.43,14318.02,0.00
2024-12-10 17:43:42,54,11370,13,41,8460.58,14319.00,0.00
2024-12-10 17:43:42,55,11370,14,41,8306.75,14319.02,0.00
2024-12-10 17:43:42,55,11371,14,41,8270.88,14320.00,0.00
2024-12-10 17:43:42,56,11371,15,41,8123.19,14320.02,0.00
2024-12-10 17:43:42,55,11371,15,40,8252.66,14320.02,0.00
2024-12-10 17:43:42,55,11372,15,40,8268.86,14321.00,0.00
2024-12-10 17:43:42,56,11372,15,41,8121.20,14321.02,0.00
2024-12-10 17:43:42,55,11372,14,41,8081.55,14321.45,0.00
2024-12-10 17:43:42,55,11373,14,41,8264.23,14322.00,0.00
2024-12-10 17:43:42,56,11373,15,41,8116.65,14322.02,0.00
2024-12-10 17:43:42,55,11373,15,40,8248.60,14322.02,0.00
2024-12-10 17:43:42,54,11373,14,40,8250.65,14322.85,0.00
2024-12-10 17:43:42,54,11374,14,40,8494.78,14323.00,0.00
2024-12-10 17:43:42,55,11374,14,41,8340.33,14323.02,0.00
2024-12-10 17:43:42,54,11374,13,41,8269.56,14323.57,0.00
2024-12-10 17:43:42,54,11375,13,41,8474.15,14324.00,0.00
2024-12-10 17:43:42,55,11375,13,42,8320.07,14324.02,0.00
2024-12-10 17:43:42,54,11375,13,41,8458.23,14324.02,0.00
2024-12-10 17:43:42,53,11375,12,41,8593.55,14324.17,0.00
2024-12-10 17:43:43,53,11376,12,41,8637.34,14325.00,0.00
2024-12-10 17:43:43,54,11376,13,41,8477.39,14325.02,0.00
2024-12-10 17:43:43,53,11376,12,41,8432.40,14325.85,0.00
2024-12-10 17:43:43,53,11377,12,41,8681.19,14326.00,0.00
2024-12-10 17:43:43,54,11377,13,41,8520.43,14326.02,0.00
2024-12-10 17:43:43,53,11377,13,40,8667.68,14326.02,0.00
2024-12-10 17:43:43,53,11378,13,40,8689.91,14327.00,0.00
2024-12-10 17:43:43,54,11378,13,41,8528.99,14327.02,0.00
2024-12-10 17:43:43,54,11379,13,41,8495.09,14328.00,0.00
2024-12-10 17:43:43,55,11379,14,41,8340.63,14328.02,0.00
2024-12-10 17:43:43,54,11379,14,40,8484.47,14328.02,0.00
2024-12-10 17:43:43,54,11380,14,40,8503.64,14329.00,0.00
2024-12-10 17:43:43,55,11380,14,41,8349.03,14329.02,0.00
2024-12-10 17:43:43,54,11380,13,41,8373.63,14329.06,0.00
2024-12-10 17:43:43,53,11380,12,41,8521.72,14329.11,0.00
2024-12-10 17:43:43,54,11379,12,42,8279.35,14329.74,0.00
2024-12-10 17:43:43,54,11380,12,42,8656.38,14330.00,0.00
2024-12-10 17:43:43,55,11380,12,43,8498.99,14330.02,0.00
2024-12-10 17:43:43,54,11380,12,42,8645.76,14330.02,0.00
2024-12-10 17:43:43,54,11381,12,42,8930.33,14331.00,0.00
2024-12-10 17:43:43,55,11381,13,42,8767.96,14331.02,0.00
2024-12-10 17:43:43,55,11382,13,42,8732.09,14332.00,0.00
2024-12-10 17:43:43,56,11382,14,42,8576.16,14332.02,0.00
2024-12-10 17:43:43,55,11382,14,41,8724.27,14332.02,0.00
2024-12-10 17:43:43,55,11383,14,41,8740.52,14333.00,0.00
2024-12-10 17:43:43,56,11383,15,41,8584.44,14333.02,0.00
2024-12-10 17:43:43,55,11383,14,41,8672.79,14333.13,0.00
2024-12-10 17:43:43,55,11384,14,41,8704.64,14334.00,0.00
2024-12-10 17:43:43,56,11384,14,42,8549.20,14334.02,0.00
2024-12-10 17:43:43,55,11384,14,41,8696.82,14334.02,0.00
2024-12-10 17:43:43,55,11385,14,41,8713.07,14335.00,0.00
2024-12-10 17:43:43,56,11385,15,41,8557.48,14335.02,0.00
2024-12-10 17:43:43,56,11386,15,41,8519.67,14336.00,0.00
2024-12-10 17:43:43,57,11386,15,42,8370.21,14336.02,0.00
2024-12-10 17:43:43,56,11386,15,41,8506.87,14336.02,0.00
2024-12-10 17:43:43,56,11387,15,41,8520.27,14337.00,0.00
2024-12-10 17:43:43,57,11387,15,42,8370.79,14337.02,0.00
2024-12-10 17:43:43,57,11388,15,42,8331.13,14338.00,0.00
2024-12-10 17:43:43,58,11388,15,43,8187.49,14338.02,0.00
2024-12-10 17:43:43,57,11388,15,42,8318.55,14338.02,0.00
2024-12-10 17:43:43,56,11388,14,42,8285.87,14338.96,0.00
2024-12-10 17:43:43,56,11389,14,42,8536.82,14339.00,0.00
2024-12-10 17:43:43,57,11389,15,42,8387.05,14339.02,0.00
2024-12-10 17:43:43,56,11389,14,42,8383.32,14339.36,0.00
2024-12-10 17:43:43,56,11390,14,42,8547.66,14340.00,0.00
2024-12-10 17:43:43,57,11390,15,42,8397.70,14340.02,0.00
2024-12-10 17:43:43,56,11390,15,41,8527.17,14340.02,0.00
2024-12-10 17:43:43,56,11391,15,41,8540.57,14341.00,0.00
2024-12-10 17:43:43,57,11391,15,42,8390.74,14341.02,0.00
2024-12-10 17:43:43,57,11392,15,42,8351.07,14342.00,0.00
2024-12-10 17:43:43,58,11392,15,43,8207.08,14342.02,0.00
2024-12-10 17:43:43,57,11392,15,42,8333.45,14342.02,0.00
2024-12-10 17:43:43,57,11393,15,42,8344.10,14343.00,0.00
2024-12-10 17:43:43,58,11393,16,42,8200.23,14343.02,0.00
2024-12-10 17:43:43,57,11393,15,42,8153.08,14343.49,0.00
2024-12-10 17:43:43,57,11394,15,42,8332.10,14344.00,0.00
2024-12-10 17:43:43,58,11394,16,42,8188.44,14344.02,0.00
2024-12-10 17:43:43,57,11394,16,41,8317.00,14344.02,0.00
2024-12-10 17:43:43,57,11395,16,41,8327.65,14345.00,0.00
2024-12-10 17:43:43,58,11395,17,41,8184.07,14345.02,0.00
2024-12-10 17:43:43,57,11395,16,41,8096.40,14345.61,0.00
2024-12-10 17:43:43,56,11395,15,41,8233.32,14345.66,0.00
2024-12-10 17:43:43,56,11396,15,41,8441.08,14346.00,0.00
2024-12-10 17:43:43,57,11396,15,42,8292.99,14346.02,0.00
2024-12-10 17:43:43,56,11396,15,41,8420.58,14346.02,0.00
2024-12-10 17:43:43,55,11396,14,41,8558.07,14346.11,0.00
2024-12-10 17:43:43,55,11397,14,41,8587.33,14347.00,0.00
2024-12-10 17:43:43,56,11397,14,42,8433.98,14347.02,0.00
2024-12-10 17:43:43,55,11397,13,42,8342.43,14347.64,0.00
2024-12-10 17:43:43,55,11398,13,42,8551.40,14348.00,0.00
2024-12-10 17:43:43,56,11398,14,42,8398.70,14348.02,0.00
2024-12-10 17:43:43,55,11398,14,41,8530.53,14348.02,0.00
2024-12-10 17:43:43,55,11399,14,41,8546.78,14349.00,0.00
2024-12-10 17:43:43,56,11399,14,42,8394.16,14349.02,0.00
2024-12-10 17:43:43,55,11399,13,42,8432.17,14349.44,0.00
2024-12-10 17:43:43,55,11400,13,42,8508.24,14350.00,0.00
2024-12-10 17:43:43,56,11400,13,43,8356.31,14350.02,0.00
2024-12-10 17:43:43,55,11400,13,42,8487.37,14350.02,0.00
2024-12-10 17:43:43,55,11401,13,42,8503.62,14351.00,0.00
2024-12-10 17:43:43,56,11401,13,43,8351.77,14351.02,0.00
2024-12-10 17:43:43,55,11401,12,43,8433.20,14351.13,0.00
2024-12-10 17:43:43,54,11401,11,43,8422.47,14351.96,0.00
2024-12-10 17:43:43,54,11402,11,43,8682.95,14352.00,0.00
2024-12-10 17:43:43,55,11402,11,44,8525.08,14352.02,0.00
2024-12-10 17:43:43,54,11402,11,43,8661.69,14352.02,0.00
2024-12-10 17:43:43,53,11402,10,43,8722.59,14352.70,0.00
2024-12-10 17:43:43,53,11403,10,43,8950.31,14353.00,0.00
2024-12-10 17:43:43,54,11403,11,43,8784.56,14353.02,0.00
2024-12-10 17:43:43,54,11404,11,43,8750.62,14354.00,0.00
2024-12-10 17:43:43,55,11404,12,43,8591.52,14354.02,0.00
2024-12-10 17:43:43,54,11404,12,42,8729.35,14354.02,0.00
2024-12-10 17:43:43,54,11405,12,42,8748.57,14355.00,0.00
2024-12-10 17:43:43,55,11405,12,43,8589.51,14355.02,0.00
2024-12-10 17:43:43,55,11406,12,43,8553.56,14356.00,0.00
2024-12-10 17:43:43,56,11406,12,44,8400.82,14356.02,0.00
2024-12-10 17:43:43,55,11406,12,43,8530.07,14356.02,0.00
2024-12-10 17:43:43,55,11407,12,43,8546.32,14357.00,0.00
2024-12-10 17:43:43,56,11407,12,44,8393.71,14357.02,0.00
2024-12-10 17:43:44,56,11408,12,44,8355.84,14358.00,0.00
2024-12-10 17:43:44,57,11408,13,44,8209.24,14358.02,0.00
2024-12-10 17:43:44,56,11408,13,43,8330.20,14358.02,0.00
2024-12-10 17:43:44,55,11408,12,43,8348.95,14358.80,0.00
2024-12-10 17:43:44,55,11409,12,43,8581.45,14359.00,0.00
2024-12-10 17:43:44,56,11409,13,43,8428.21,14359.02,0.00
2024-12-10 17:43:44,56,11410,13,43,8390.34,14360.00,0.00
2024-12-10 17:43:44,57,11410,14,43,8243.14,14360.02,0.00
2024-12-10 17:43:44,56,11410,14,42,8364.69,14360.02,0.00
2024-12-10 17:43:44,56,11411,14,42,8378.10,14361.00,0.00
2024-12-10 17:43:44,57,11411,15,42,8231.11,14361.02,0.00
2024-12-10 17:43:44,57,11412,15,42,8191.38,14362.00,0.00
2024-12-10 17:43:44,58,11412,15,43,8050.14,14362.02,0.00
2024-12-10 17:43:44,57,11412,15,42,8168.70,14362.02,0.00
2024-12-10 17:43:44,57,11413,15,42,8179.35,14363.00,0.00
2024-12-10 17:43:44,58,11413,16,42,8038.32,14363.02,0.00
2024-12-10 17:43:44,58,11414,16,42,7996.78,14364.00,0.00
2024-12-10 17:43:44,59,11414,17,42,7861.24,14364.02,0.00
2024-12-10 17:43:44,58,11414,17,41,7974.49,14364.02,0.00
2024-12-10 17:43:44,59,11413,17,42,7805.34,14364.29,0.00
2024-12-10 17:43:44,59,11414,17,42,7968.92,14365.00,0.00
2024-12-10 17:43:44,60,11414,18,42,7836.10,14365.02,0.00
2024-12-10 17:43:44,60,11415,18,42,8031.13,14366.00,0.00
2024-12-10 17:43:44,61,11415,19,42,7899.48,14366.02,0.00
2024-12-10 17:43:44,60,11415,19,41,8011.98,14366.02,0.00
2024-12-10 17:43:44,60,11416,19,41,8014.93,14367.00,0.00
2024-12-10 17:43:44,61,11416,20,41,7883.54,14367.02,0.00
2024-12-10 17:43:44,61,11417,20,41,7836.98,14368.00,0.00
2024-12-10 17:43:44,62,11417,21,41,7710.58,14368.02,0.00
2024-12-10 17:43:44,61,11417,21,40,7820.49,14368.02,0.00
2024-12-10 17:43:44,61,11418,21,40,7821.03,14369.00,0.00
2024-12-10 17:43:44,62,11418,21,41,7694.89,14369.02,0.00
2024-12-10 17:43:44,62,11419,21,41,7646.75,14370.00,0.00
2024-12-10 17:43:44,63,11419,21,42,7525.38,14370.02,0.00
2024-12-10 17:43:44,62,11419,21,41,7630.53,14370.02,0.00
2024-12-10 17:43:44,62,11420,21,41,7628.74,14371.00,0.00
2024-12-10 17:43:44,63,11420,22,41,7507.65,14371.02,0.00
2024-12-10 17:43:44,62,11420,21,41,7404.40,14371.97,0.00
2024-12-10 17:43:44,62,11421,21,41,7631.59,14372.00,0.00
2024-12-10 17:43:44,63,11421,22,41,7510.45,14372.02,0.00
2024-12-10 17:43:44,62,11421,22,40,7615.36,14372.02,0.00
2024-12-10 17:43:44,62,11422,22,40,7613.58,14373.00,0.00
2024-12-10 17:43:44,63,11422,23,40,7492.73,14373.02,0.00
2024-12-10 17:43:44,63,11423,23,40,7446.18,14374.00,0.00
2024-12-10 17:43:44,64,11423,23,41,7329.84,14374.02,0.00
2024-12-10 17:43:44,63,11423,23,40,7430.21,14374.02,0.00
2024-12-10 17:43:44,62,11423,22,40,7450.68,14374.69,0.00
2024-12-10 17:43:44,62,11424,22,40,7545.94,14375.00,0.00
2024-12-10 17:43:44,63,11424,22,41,7426.16,14375.02,0.00
2024-12-10 17:43:44,63,11425,22,41,7377.30,14376.00,0.00
2024-12-10 17:43:44,64,11425,23,41,7262.03,14376.02,0.00
2024-12-10 17:43:44,63,11425,23,40,7363.61,14376.02,0.00
2024-12-10 17:43:44,63,11426,23,40,7359.56,14377.00,0.00
2024-12-10 17:43:44,64,11426,23,41,7244.56,14377.02,0.00
2024-12-10 17:43:44,64,11427,23,41,7195.76,14378.00,0.00
2024-12-10 17:43:44,65,11427,23,42,7085.05,14378.02,0.00
2024-12-10 17:43:44,64,11427,23,41,7184.52,14378.02,0.00
2024-12-10 17:43:44,63,11427,22,41,7182.39,14378.75,0.00
2024-12-10 17:43:44,63,11428,22,41,7374.27,14379.00,0.00
2024-12-10 17:43:44,64,11428,23,41,7259.05,14379.02,0.00
2024-12-10 17:43:44,63,11428,22,41,7301.30,14379.19,0.00
2024-12-10 17:43:44,63,11429,22,41,7324.61,14380.00,0.00
2024-12-10 17:43:44,64,11429,23,41,7210.16,14380.02,0.00
2024-12-10 17:43:44,63,11429,23,40,7315.48,14380.02,0.00
2024-12-10 17:43:44,62,11429,22,40,7408.01,14380.18,0.00
2024-12-10 17:43:44,62,11430,22,40,7429.35,14381.00,0.00
2024-12-10 17:43:44,63,11430,23,40,7311.42,14381.02,0.00
2024-12-10 17:43:44,64,11429,23,41,7136.55,14381.16,0.00
2024-12-10 17:43:44,64,11430,23,41,7296.56,14382.00,0.00
2024-12-10 17:43:44,65,11430,23,42,7184.30,14382.02,0.00
2024-12-10 17:43:44,64,11430,23,41,7289.82,14382.02,0.00
2024-12-10 17:43:44,64,11431,23,41,7508.31,14383.00,0.00
2024-12-10 17:43:44,65,11431,24,41,7392.80,14383.02,0.00
2024-12-10 17:43:44,64,11431,23,41,7355.66,14383.44,0.00
2024-12-10 17:43:44,64,11432,23,41,7499.85,14384.00,0.00
2024-12-10 17:43:44,65,11432,24,41,7384.47,14384.02,0.00
2024-12-10 17:43:44,64,11432,24,40,7495.35,14384.02,0.00
2024-12-10 17:43:44,64,11433,24,40,7489.13,14385.00,0.00
2024-12-10 17:43:44,65,11433,25,40,7373.91,14385.02,0.00
2024-12-10 17:43:44,64,11433,24,40,7259.64,14385.67,0.00
2024-12-10 17:43:44,64,11434,24,40,7437.44,14386.00,0.00
2024-12-10 17:43:44,65,11434,24,41,7323.02,14386.02,0.00
2024-12-10 17:43:44,64,11434,24,40,7435.19,14386.02,0.00
2024-12-10 17:43:44,64,11435,24,40,7428.97,14387.00,0.00
2024-12-10 17:43:44,65,11435,24,41,7314.68,14387.02,0.00
2024-12-10 17:43:44,64,11435,24,40,7381.76,14387.02,0.00
2024-12-10 17:43:44,63,11435,23,40,7403.16,14387.40,0.00
2024-12-10 17:43:44,63,11436,23,40,7545.13,14388.00,0.00
2024-12-10 17:43:44,64,11436,24,40,7427.23,14388.02,0.00
2024-12-10 17:43:44,63,11436,24,39,7497.17,14388.02,0.00
2024-12-10 17:43:44,62,11436,23,39,7594.95,14388.16,0.00
2024-12-10 17:43:44,62,11437,23,39,7613.98,14389.00,0.00
2024-12-10 17:43:44,63,11437,24,39,7493.12,14389.02,0.00
2024-12-10 17:43:44,62,11437,23,39,7532.83,14389.21,0.00
2024-12-10 17:43:44,62,11438,23,39,7651.64,14390.00,0.00
2024-12-10 17:43:44,63,11438,24,39,7530.19,14390.02,0.00
2024-12-10 17:43:45,62,11438,24,38,7649.32,14390.02,0.00
2024-12-10 17:43:45,62,11439,24,38,7647.53,14391.00,0.00
2024-12-10 17:43:45,63,11439,24,39,7526.14,14391.02,0.00
2024-12-10 17:43:45,63,11440,24,39,7542.60,14392.00,0.00
2024-12-10 17:43:45,64,11440,25,39,7424.75,14392.02,0.00
2024-12-10 17:43:45,64,11441,25,39,7420.76,14393.00,0.00
2024-12-10 17:43:45,65,11441,25,40,7306.59,14393.02,0.00
2024-12-10 17:43:45,64,11441,24,40,7280.80,14393.67,0.00
2024-12-10 17:43:45,63,11441,23,40,7314.32,14393.89,0.00
2024-12-10 17:43:45,63,11441,23,40,7526.89,14394.00,0.00
2024-12-10 17:43:45,64,11441,23,41,7409.28,14394.02,0.00
2024-12-10 17:43:45,63,11441,23,40,7501.76,14394.02,0.00
2024-12-10 17:43:45,62,11441,22,40,7599.56,14394.18,0.00
2024-12-10 17:43:45,62,11442,22,40,7620.92,14395.00,0.00
2024-12-10 17:43:45,63,11442,23,40,7499.96,14395.02,0.00
2024-12-10 17:43:45,63,11443,23,40,7521.79,14396.00,0.00
2024-12-10 17:43:45,64,11443,24,40,7404.27,14396.02,0.00
2024-12-10 17:43:45,64,11444,24,40,7413.81,14397.00,0.00
2024-12-10 17:43:45,65,11444,24,41,7299.75,14397.02,0.00
2024-12-10 17:43:45,65,11445,24,41,7282.05,14398.00,0.00
2024-12-10 17:43:45,66,11445,25,41,7171.71,14398.02,0.00
2024-12-10 17:43:45,66,11446,25,41,7119.74,14399.00,0.00
2024-12-10 17:43:45,67,11446,26,41,7013.48,14399.01,0.00
2024-12-10 17:43:45,66,11446,26,40,7113.20,14399.02,0.00
2024-12-10 17:43:45,66,11447,26,40,7102.78,14400.00,0.00
2024-12-10 17:43:45,67,11447,26,41,6996.77,14400.01,0.00
2024-12-10 17:43:45,66,11447,26,40,7063.51,14400.02,0.00
2024-12-10 17:43:45,65,11447,25,40,7145.65,14400.20,0.00
2024-12-10 17:43:45,64,11447,24,40,7255.05,14400.20,0.00
2024-12-10 17:43:45,64,11448,24,40,7275.75,14401.00,0.00
2024-12-10 17:43:45,65,11448,24,41,7163.82,14401.02,0.00
2024-12-10 17:43:45,64,11448,24,40,7235.25,14401.02,0.00
2024-12-10 17:43:45,63,11448,23,40,7213.32,14401.83,0.00
2024-12-10 17:43:45,63,11449,23,40,7416.90,14402.00,0.00
2024-12-10 17:43:45,64,11449,24,40,7301.01,14402.02,0.00
2024-12-10 17:43:45,63,11449,24,39,7371.18,14402.02,0.00
2024-12-10 17:43:45,62,11449,23,39,7336.96,14402.56,0.00
2024-12-10 17:43:45,62,11450,23,39,7506.85,14403.00,0.00
2024-12-10 17:43:45,63,11450,23,40,7387.69,14403.02,0.00
2024-12-10 17:43:45,62,11450,23,39,7458.06,14403.02,0.00
2024-12-10 17:43:45,62,11451,23,39,7456.26,14404.00,0.00
2024-12-10 17:43:45,63,11451,24,39,7337.90,14404.02,0.00
2024-12-10 17:43:45,62,11451,24,38,7407.47,14404.02,0.00
2024-12-10 17:43:45,61,11451,23,38,7430.02,14404.71,0.00
2024-12-10 17:43:45,61,11452,23,38,7529.43,14405.00,0.00
2024-12-10 17:43:45,62,11452,23,39,7407.98,14405.02,0.00
2024-12-10 17:43:45,62,11453,23,39,7359.70,14406.00,0.00
2024-12-10 17:43:45,63,11453,24,39,7242.88,14406.02,0.00
2024-12-10 17:43:45,62,11453,24,38,7355.06,14406.02,0.00
2024-12-10 17:43:45,62,11454,24,38,7353.24,14407.00,0.00
2024-12-10 17:43:45,63,11454,25,38,7236.53,14407.02,0.00
2024-12-10 17:43:45,63,11455,25,38,7187.94,14408.00,0.00
2024-12-10 17:43:45,64,11455,26,38,7075.63,14408.02,0.00
2024-12-10 17:43:45,63,11455,26,37,7183.36,14408.02,0.00
2024-12-10 17:43:45,63,11456,26,37,7179.29,14409.00,0.00
2024-12-10 17:43:45,64,11456,27,37,7067.11,14409.02,0.00
2024-12-10 17:43:45,63,11456,27,36,7131.26,14409.02,0.00
2024-12-10 17:43:45,62,11456,26,36,7090.78,14409.58,0.00
2024-12-10 17:43:45,62,11457,26,36,7263.05,14410.00,0.00
2024-12-10 17:43:45,63,11457,27,36,7147.76,14410.02,0.00
2024-12-10 17:43:45,62,11457,27,35,7214.24,14410.02,0.00
2024-12-10 17:43:45,62,11458,27,35,7212.42,14411.00,0.00
2024-12-10 17:43:45,63,11458,27,36,7097.93,14411.02,0.00
2024-12-10 17:43:45,62,11458,26,36,7022.01,14411.55,0.00
2024-12-10 17:43:45,62,11459,26,36,7189.67,14412.00,0.00
2024-12-10 17:43:45,63,11459,27,36,7075.55,14412.02,0.00
2024-12-10 17:43:45,62,11459,27,35,7182.70,14412.02,0.00
2024-12-10 17:43:45,62,11460,27,35,7180.87,14413.00,0.00
2024-12-10 17:43:45,63,11460,27,36,7066.89,14413.02,0.00
2024-12-10 17:43:45,62,11460,26,36,7093.31,14413.29,0.00
2024-12-10 17:43:45,61,11460,25,36,7171.80,14413.34,0.00
2024-12-10 17:43:45,61,11461,25,36,7313.98,14414.00,0.00
2024-12-10 17:43:45,62,11461,25,37,7196.02,14414.02,0.00
2024-12-10 17:43:45,61,11461,25,36,7306.90,14414.02,0.00
2024-12-10 17:43:45,60,11461,24,36,7404.70,14414.18,0.00
2024-12-10 17:43:45,59,11461,23,36,7491.15,14414.29,0.00
2024-12-10 17:43:45,59,11462,23,36,7633.29,14415.00,0.00
2024-12-10 17:43:45,60,11462,24,36,7506.07,14415.02,0.00
2024-12-10 17:43:45,60,11463,24,36,7460.94,14416.00,0.00
2024-12-10 17:43:45,61,11463,25,36,7338.63,14416.02,0.00
2024-12-10 17:43:45,60,11463,25,35,7456.13,14416.02,0.00
2024-12-10 17:43:45,59,11463,24,35,7516.62,14416.29,0.00
2024-12-10 17:43:45,59,11464,24,35,7658.79,14417.00,0.00
2024-12-10 17:43:45,60,11464,24,36,7531.14,14417.02,0.00
2024-12-10 17:43:45,60,11465,24,36,7486.01,14418.00,0.00
2024-12-10 17:43:45,61,11465,25,36,7363.28,14418.02,0.00
2024-12-10 17:43:45,60,11465,25,35,7483.60,14418.02,0.00
2024-12-10 17:43:45,60,11466,25,35,7486.52,14419.00,0.00
2024-12-10 17:43:45,61,11466,25,36,7363.79,14419.02,0.00
2024-12-10 17:43:45,60,11466,24,36,7412.08,14419.20,0.00
2024-12-10 17:43:45,59,11466,23,36,7371.09,14419.68,0.00
2024-12-10 17:43:45,59,11467,23,36,7569.28,14420.00,0.00
2024-12-10 17:43:45,60,11467,24,36,7443.13,14420.02,0.00
2024-12-10 17:43:45,59,11467,24,35,7564.40,14420.02,0.00
2024-12-10 17:43:45,58,11467,23,35,7670.01,14420.19,0.00
2024-12-10 17:43:45,57,11467,22,35,7704.18,14420.44,0.00
2024-12-10 17:43:45,57,11468,22,35,7876.59,14421.00,0.00
2024-12-10 17:43:45,58,11468,23,35,7740.78,14421.02,0.00
2024-12-10 17:43:46,58,11469,23,35,7699.05,14422.00,0.00
2024-12-10 17:43:46,59,11469,24,35,7568.56,14422.02,0.00
2024-12-10 17:43:46,58,11469,24,34,7696.56,14422.02,0.00
2024-12-10 17:43:46,57,11469,23,34,7735.73,14422.67,0.00
2024-12-10 17:43:46,57,11470,23,34,7839.72,14423.00,0.00
2024-12-10 17:43:46,58,11470,24,34,7704.55,14423.02,0.00
2024-12-10 17:43:46,58,11471,24,34,7662.81,14424.00,0.00
2024-12-10 17:43:46,59,11471,24,35,7532.93,14424.02,0.00
2024-12-10 17:43:46,58,11471,24,34,7655.35,14424.02,0.00
2024-12-10 17:43:46,57,11471,23,34,7592.56,14424.67,0.00
2024-12-10 17:43:46,57,11472,23,34,7797.79,14425.00,0.00
2024-12-10 17:43:46,58,11472,23,35,7663.34,14425.02,0.00
2024-12-10 17:43:46,58,11473,23,35,7621.59,14426.00,0.00
2024-12-10 17:43:46,59,11473,23,36,7492.41,14426.02,0.00
2024-12-10 17:43:46,58,11473,23,35,7616.62,14426.02,0.00
2024-12-10 17:43:46,58,11474,23,35,7624.61,14427.00,0.00
2024-12-10 17:43:46,59,11474,24,35,7495.38,14427.02,0.00
2024-12-10 17:43:46,58,11474,23,35,7492.87,14427.33,0.00
2024-12-10 17:43:46,58,11475,23,35,7645.04,14428.00,0.00
2024-12-10 17:43:46,59,11475,24,35,7515.46,14428.02,0.00
2024-12-10 17:43:46,58,11475,24,34,7640.06,14428.02,0.00
2024-12-10 17:43:46,57,11475,23,34,7753.89,14428.16,0.00
2024-12-10 17:43:46,57,11476,23,34,7784.76,14429.00,0.00
2024-12-10 17:43:46,58,11476,24,34,7650.54,14429.02,0.00
2024-12-10 17:43:46,58,11477,24,34,7608.78,14430.00,0.00
2024-12-10 17:43:46,59,11477,25,34,7479.81,14430.02,0.00
2024-12-10 17:43:46,58,11477,25,33,7606.29,14430.02,0.00
2024-12-10 17:43:46,58,11478,25,33,7614.28,14431.00,0.00
2024-12-10 17:43:46,59,11478,26,33,7485.23,14431.02,0.00
2024-12-10 17:43:46,58,11478,26,32,7562.03,14431.02,0.00
2024-12-10 17:43:46,58,11479,26,32,7570.02,14432.00,0.00
2024-12-10 17:43:46,59,11479,27,32,7441.71,14432.02,0.00
2024-12-10 17:43:46,58,11479,27,31,7517.77,14432.02,0.00
2024-12-10 17:43:46,57,11479,26,31,7631.97,14432.14,0.00
2024-12-10 17:43:46,56,11479,25,31,7634.64,14432.86,0.00
2024-12-10 17:43:46,56,11479,25,31,7871.85,14433.00,0.00
2024-12-10 17:43:46,57,11479,25,32,7733.74,14433.02,0.00
2024-12-10 17:43:46,56,11479,24,32,7759.31,14433.43,0.00
2024-12-10 17:43:46,56,11480,24,32,7831.86,14434.00,0.00
2024-12-10 17:43:46,57,11480,24,33,7694.46,14434.02,0.00
2024-12-10 17:43:46,56,11480,24,32,7826.70,14434.02,0.00
2024-12-10 17:43:46,55,11480,23,32,7777.71,14434.64,0.00
2024-12-10 17:43:46,55,11481,23,32,7987.93,14435.00,0.00
2024-12-10 17:43:46,56,11481,24,32,7845.29,14435.02,0.00
2024-12-10 17:43:46,57,11480,24,33,7551.00,14435.79,0.00
2024-12-10 17:43:46,56,11480,23,33,7773.57,14435.89,0.00
2024-12-10 17:43:46,56,11481,23,33,8015.97,14436.00,0.00
2024-12-10 17:43:46,57,11481,24,33,7875.34,14436.02,0.00
2024-12-10 17:43:46,56,11481,24,32,8013.39,14436.02,0.00
2024-12-10 17:43:46,55,11481,23,32,8062.28,14436.67,0.00
2024-12-10 17:43:46,55,11481,23,32,8435.27,14437.00,0.00
2024-12-10 17:43:46,56,11481,24,32,8284.64,14437.02,0.00
2024-12-10 17:43:46,55,11481,24,31,8380.15,14437.02,0.00
2024-12-10 17:43:46,55,11482,24,31,8396.48,14438.00,0.00
2024-12-10 17:43:46,56,11482,25,31,8246.54,14438.02,0.00
2024-12-10 17:43:46,55,11482,24,31,8189.31,14438.53,0.00
2024-12-10 17:43:46,55,11483,24,31,8383.94,14439.00,0.00
2024-12-10 17:43:46,56,11483,24,32,8234.22,14439.02,0.00
2024-12-10 17:43:46,55,11483,24,31,8373.43,14439.02,0.00
2024-12-10 17:43:46,55,11484,24,31,8389.77,14440.00,0.00
2024-12-10 17:43:46,56,11484,24,32,8239.95,14440.02,0.00
2024-12-10 17:43:46,56,11485,24,32,8201.84,14441.00,0.00
2024-12-10 17:43:46,57,11485,25,32,8057.95,14441.02,0.00
2024-12-10 17:43:46,56,11485,25,31,8191.52,14441.02,0.00
2024-12-10 17:43:46,55,11485,24,31,8143.84,14441.65,0.00
2024-12-10 17:43:46,55,11486,24,31,8356.79,14442.00,0.00
2024-12-10 17:43:46,56,11486,24,32,8207.56,14442.02,0.00
2024-12-10 17:43:46,56,11487,24,32,8169.44,14443.00,0.00
2024-12-10 17:43:46,57,11487,24,33,8026.12,14443.02,0.00
2024-12-10 17:43:46,56,11487,24,32,8151.39,14443.02,0.00
2024-12-10 17:43:46,55,11487,23,32,8202.45,14443.07,0.00
2024-12-10 17:43:46,55,11488,23,32,8331.69,14444.00,0.00
2024-12-10 17:43:46,56,11488,24,32,8182.91,14444.02,0.00
2024-12-10 17:43:46,55,11488,23,32,8119.18,14444.55,0.00
2024-12-10 17:43:46,55,11489,23,32,8316.51,14445.00,0.00
2024-12-10 17:43:46,56,11489,23,33,8168.00,14445.02,0.00
2024-12-10 17:43:46,55,11489,23,32,8300.75,14445.02,0.00
2024-12-10 17:43:46,55,11490,23,32,8317.08,14446.00,0.00
2024-12-10 17:43:46,56,11490,24,32,8168.56,14446.02,0.00
2024-12-10 17:43:46,56,11491,24,32,8132.63,14447.00,0.00
2024-12-10 17:43:46,57,11491,24,33,7989.95,14447.02,0.00
2024-12-10 17:43:46,56,11491,24,32,8111.99,14447.02,0.00
2024-12-10 17:43:46,55,11491,23,32,8123.67,14447.78,0.00
2024-12-10 17:43:46,55,11492,23,32,8355.01,14448.00,0.00
2024-12-10 17:43:46,56,11492,24,32,8205.81,14448.02,0.00
2024-12-10 17:43:46,55,11492,23,32,8281.49,14448.15,0.00
2024-12-10 17:43:46,55,11493,23,32,8320.98,14449.00,0.00
2024-12-10 17:43:46,56,11493,23,33,8172.39,14449.02,0.00
2024-12-10 17:43:46,55,11493,23,32,8294.71,14449.04,0.00
2024-12-10 17:43:46,55,11494,23,32,8313.67,14450.00,0.00
2024-12-10 17:43:46,56,11494,23,33,8165.21,14450.02,0.00
2024-12-10 17:43:46,56,11495,23,33,8130.21,14451.00,0.00
2024-12-10 17:43:46,57,11495,24,33,7987.57,14451.02,0.00
2024-12-10 17:43:46,56,11495,24,32,8106.99,14451.04,0.00
2024-12-10 17:43:46,55,11495,23,32,8242.50,14451.11,0.00
2024-12-10 17:43:46,54,11495,22,32,8320.47,14451.63,0.00
2024-12-10 17:43:46,54,11496,22,32,8427.80,14452.00,0.00
2024-12-10 17:43:46,55,11496,22,33,8274.57,14452.02,0.00
2024-12-10 17:43:46,54,11496,21,33,8282.99,14452.63,0.00
2024-12-10 17:43:46,54,11497,21,33,8497.40,14453.00,0.00
2024-12-10 17:43:46,55,11497,22,33,8342.90,14453.02,0.00
2024-12-10 17:43:46,54,11497,22,32,8470.64,14453.04,0.00
2024-12-10 17:43:46,53,11497,21,32,8619.58,14453.11,0.00
2024-12-10 17:43:46,52,11497,20,32,8621.59,14453.58,0.00
2024-12-10 17:43:47,52,11498,20,32,8838.73,14454.00,0.00
2024-12-10 17:43:47,53,11498,20,33,8671.96,14454.02,0.00
2024-12-10 17:43:47,54,11497,21,33,8246.76,14454.78,0.00
2024-12-10 17:43:47,54,11498,21,33,8514.63,14455.00,0.00
2024-12-10 17:43:47,55,11498,22,33,8359.82,14455.02,0.00
2024-12-10 17:43:47,54,11498,22,32,8490.55,14455.04,0.00
2024-12-10 17:43:47,54,11499,22,32,8780.25,14456.00,0.00
2024-12-10 17:43:47,55,11499,23,32,8620.61,14456.02,0.00
2024-12-10 17:43:47,54,11499,22,32,8649.16,14456.30,0.00
2024-12-10 17:43:47,53,11499,21,32,8763.48,14456.62,0.00
2024-12-10 17:43:47,53,11500,21,32,8981.99,14457.00,0.00
2024-12-10 17:43:47,54,11500,21,33,8815.66,14457.02,0.00
2024-12-10 17:43:47,53,11500,21,32,8951.99,14457.04,0.00
2024-12-10 17:43:47,53,11501,21,32,8977.16,14458.00,0.00
2024-12-10 17:43:47,54,11501,22,32,8810.92,14458.02,0.00
2024-12-10 17:43:47,54,11502,22,32,8776.72,14459.00,0.00
2024-12-10 17:43:47,55,11502,23,32,8617.14,14459.02,0.00
2024-12-10 17:43:47,54,11502,23,31,8749.94,14459.04,0.00
2024-12-10 17:43:47,53,11502,22,31,8901.43,14459.13,0.00
2024-12-10 17:43:47,53,11503,22,31,8940.20,14460.00,0.00
2024-12-10 17:43:47,54,11503,23,31,8774.65,14460.02,0.00
2024-12-10 17:43:47,53,11503,22,31,8801.82,14460.58,0.00
2024-12-10 17:43:47,53,11504,22,31,8905.83,14461.00,0.00
2024-12-10 17:43:47,54,11504,23,31,8740.91,14461.02,0.00
2024-12-10 17:43:47,53,11504,23,30,8873.09,14461.04,0.00
2024-12-10 17:43:47,53,11505,23,30,8898.26,14462.00,0.00
2024-12-10 17:43:47,54,11505,23,31,8733.48,14462.02,0.00
2024-12-10 17:43:47,54,11506,23,31,8696.00,14463.00,0.00
2024-12-10 17:43:47,55,11506,23,32,8537.90,14463.02,0.00
2024-12-10 17:43:47,54,11506,23,31,8657.30,14463.04,0.00
2024-12-10 17:43:47,53,11506,22,31,8774.31,14463.21,0.00
2024-12-10 17:43:47,53,11507,22,31,8933.15,14464.00,0.00
2024-12-10 17:43:47,54,11507,23,31,8767.72,14464.02,0.00
2024-12-10 17:43:47,54,11508,23,31,8724.78,14465.00,0.00
2024-12-10 17:43:47,55,11508,24,31,8566.15,14465.02,0.00
2024-12-10 17:43:47,54,11508,24,30,8713.86,14465.02,0.00
2024-12-10 17:43:47,53,11508,24,29,8850.98,14465.02,0.00
2024-12-10 17:43:47,53,11509,24,29,8873.43,14466.00,0.00
2024-12-10 17:43:47,54,11509,25,29,8709.10,14466.02,0.00
2024-12-10 17:43:47,53,11509,24,29,8619.90,14466.62,0.00
2024-12-10 17:43:47,53,11510,24,29,8838.56,14467.00,0.00
2024-12-10 17:43:47,54,11510,25,29,8674.88,14467.02,0.00
2024-12-10 17:43:47,53,11510,25,28,8805.80,14467.04,0.00
2024-12-10 17:43:47,53,11511,25,28,8830.97,14468.00,0.00
2024-12-10 17:43:47,54,11511,26,28,8667.44,14468.02,0.00
2024-12-10 17:43:47,53,11511,25,28,8656.29,14468.11,0.00
2024-12-10 17:43:47,52,11511,24,28,8822.76,14468.12,0.00
2024-12-10 17:43:47,52,11512,24,28,8973.60,14469.00,0.00
2024-12-10 17:43:47,53,11512,24,29,8804.29,14469.02,0.00
2024-12-10 17:43:47,52,11512,24,28,8937.43,14469.04,0.00
2024-12-10 17:43:47,52,11513,24,28,8965.87,14470.00,0.00
2024-12-10 17:43:47,53,11513,25,28,8796.70,14470.02,0.00
2024-12-10 17:43:47,54,11512,26,28,8553.48,14470.24,0.00
2024-12-10 17:43:47,54,11513,26,28,8696.03,14471.00,0.00
2024-12-10 17:43:47,55,11513,26,29,8537.92,14471.02,0.00
2024-12-10 17:43:47,54,11513,26,28,8663.88,14471.04,0.00
2024-12-10 17:43:47,53,11513,25,28,8647.72,14471.94,0.00
2024-12-10 17:43:47,53,11514,25,28,9185.66,14472.00,0.00
2024-12-10 17:43:47,54,11514,26,28,9015.56,14472.02,0.00
2024-12-10 17:43:47,54,11515,26,28,8981.34,14473.00,0.00
2024-12-10 17:43:47,55,11515,26,29,8818.04,14473.02,0.00
2024-12-10 17:43:47,54,11515,26,28,8949.17,14473.04,0.00
2024-12-10 17:43:47,54,11516,26,28,8971.23,14474.00,0.00
2024-12-10 17:43:47,55,11516,27,28,8808.12,14474.02,0.00
2024-12-10 17:43:47,55,11517,27,28,8771.88,14475.00,0.00
2024-12-10 17:43:47,56,11517,28,28,8615.24,14475.02,0.00
2024-12-10 17:43:47,55,11517,28,27,8740.30,14475.04,0.00
2024-12-10 17:43:47,55,11518,28,27,8759.33,14476.00,0.00
2024-12-10 17:43:47,56,11518,29,27,8602.91,14476.02,0.00
2024-12-10 17:43:47,56,11519,29,27,8569.82,14477.00,0.00
2024-12-10 17:43:47,57,11519,29,28,8419.47,14477.02,0.00
2024-12-10 17:43:47,56,11519,29,27,8528.46,14477.04,0.00
2024-12-10 17:43:47,56,11520,29,27,8544.56,14478.00,0.00
2024-12-10 17:43:47,57,11520,30,27,8394.65,14478.02,0.00
2024-12-10 17:43:47,56,11520,29,27,8366.34,14478.41,0.00
2024-12-10 17:43:47,56,11521,29,27,8539.98,14479.00,0.00
2024-12-10 17:43:47,57,11521,29,28,8390.15,14479.02,0.00
2024-12-10 17:43:47,56,11521,29,27,8498.61,14479.04,0.00
2024-12-10 17:43:47,55,11521,28,27,8566.59,14479.64,0.00
2024-12-10 17:43:47,55,11522,28,27,8672.15,14480.00,0.00
2024-12-10 17:43:47,56,11522,29,27,8517.29,14480.02,0.00
2024-12-10 17:43:47,56,11523,29,27,8482.54,14481.00,0.00
2024-12-10 17:43:47,57,11523,29,28,8333.72,14481.02,0.00
2024-12-10 17:43:47,56,11523,29,27,8443.75,14481.04,0.00
2024-12-10 17:43:47,56,11524,29,27,8459.85,14482.00,0.00
2024-12-10 17:43:47,57,11524,30,27,8311.43,14482.02,0.00
2024-12-10 17:43:47,56,11524,29,27,8307.27,14482.05,0.00
2024-12-10 17:43:47,55,11524,28,27,8450.43,14482.09,0.00
2024-12-10 17:43:47,55,11525,28,27,8582.66,14483.00,0.00
2024-12-10 17:43:47,56,11525,29,27,8429.39,14483.02,0.00
2024-12-10 17:43:47,55,11525,28,27,8582.62,14483.02,0.00
2024-12-10 17:43:47,54,11525,28,26,8701.32,14483.02,0.00
2024-12-10 17:43:47,54,11526,28,26,8720.70,14484.00,0.00
2024-12-10 17:43:47,55,11526,28,27,8562.14,14484.02,0.00
2024-12-10 17:43:47,55,11527,28,27,8528.05,14485.00,0.00
2024-12-10 17:43:47,56,11527,29,27,8375.76,14485.02,0.00
2024-12-10 17:43:47,55,11527,29,26,8488.54,14485.02,0.00
2024-12-10 17:43:47,54,11527,28,26,8530.95,14485.24,0.00
2024-12-10 17:43:47,54,11528,28,26,8689.71,14486.00,0.00
2024-12-10 17:43:47,55,11528,28,27,8531.72,14486.02,0.00
2024-12-10 17:43:47,55,11529,28,27,8506.02,14487.00,0.00
2024-12-10 17:43:47,56,11529,29,27,8354.12,14487.02,0.00
2024-12-10 17:43:48,55,11529,29,26,8455.98,14487.04,0.00
2024-12-10 17:43:48,55,11530,29,26,8474.99,14488.00,0.00
2024-12-10 17:43:48,56,11530,29,27,8323.65,14488.02,0.00
2024-12-10 17:43:48,56,11531,29,27,8298.39,14489.00,0.00
2024-12-10 17:43:48,57,11531,30,27,8152.80,14489.02,0.00
2024-12-10 17:43:48,56,11531,30,26,8251.83,14489.04,0.00
2024-12-10 17:43:48,56,11532,30,26,8267.90,14490.00,0.00
2024-12-10 17:43:48,57,11532,30,27,8122.85,14490.02,0.00
2024-12-10 17:43:48,57,11533,30,27,8098.23,14491.00,0.00
2024-12-10 17:43:48,58,11533,30,28,7958.61,14491.02,0.00
2024-12-10 17:43:48,57,11533,30,27,8055.03,14491.04,0.00
2024-12-10 17:43:48,56,11533,29,27,8196.36,14491.04,0.00
2024-12-10 17:43:48,55,11533,28,27,8226.71,14491.33,0.00
2024-12-10 17:43:48,55,11534,28,27,8393.13,14492.00,0.00
2024-12-10 17:43:48,56,11534,29,27,8243.25,14492.02,0.00
2024-12-10 17:43:48,55,11534,28,27,8387.87,14492.04,0.00
2024-12-10 17:43:48,55,11535,28,27,8378.43,14493.00,0.00
2024-12-10 17:43:48,56,11535,28,28,8228.81,14493.02,0.00
2024-12-10 17:43:48,55,11535,28,27,8320.47,14493.04,0.00
2024-12-10 17:43:48,54,11535,27,27,8402.31,14493.54,0.00
2024-12-10 17:43:48,54,11536,27,27,8496.56,14494.00,0.00
2024-12-10 17:43:48,55,11536,27,28,8342.08,14494.02,0.00
2024-12-10 17:43:48,56,11535,27,29,7994.91,14494.48,0.00
2024-12-10 17:43:48,56,11536,27,29,8256.68,14495.00,0.00
2024-12-10 17:43:48,57,11536,27,30,8111.83,14495.02,0.00
2024-12-10 17:43:48,56,11536,27,29,8098.79,14495.04,0.00
2024-12-10 17:43:48,56,11537,27,29,8477.28,14496.00,0.00
2024-12-10 17:43:48,57,11537,27,30,8328.55,14496.02,0.00
2024-12-10 17:43:48,56,11537,26,30,8471.22,14496.02,0.00
2024-12-10 17:43:48,56,11538,26,30,8536.53,14497.00,0.00
2024-12-10 17:43:48,57,11538,27,30,8386.76,14497.02,0.00
2024-12-10 17:43:48,56,11538,27,29,8487.34,14497.02,0.00
2024-12-10 17:43:48,56,11539,27,29,8500.87,14498.00,0.00
2024-12-10 17:43:48,57,11539,27,30,8351.73,14498.02,0.00
2024-12-10 17:43:48,56,11539,26,30,8361.29,14498.59,0.00
2024-12-10 17:43:48,56,11540,26,30,8560.96,14499.00,0.00
2024-12-10 17:43:48,57,11540,27,30,8410.77,14499.02,0.00
2024-12-10 17:43:48,56,11540,27,29,8504.01,14499.04,0.00
2024-12-10 17:43:48,56,11541,27,29,8520.12,14500.00,0.00
2024-12-10 17:43:48,57,11541,28,29,8370.65,14500.02,0.00
2024-12-10 17:43:48,56,11541,27,29,8388.17,14500.27,0.00
2024-12-10 17:43:48,55,11541,26,29,8492.53,14500.60,0.00
2024-12-10 17:43:48,55,11542,26,29,8698.49,14501.00,0.00
2024-12-10 17:43:48,56,11542,27,29,8543.16,14501.02,0.00
2024-12-10 17:43:48,55,11542,27,28,8643.13,14501.04,0.00
2024-12-10 17:43:48,55,11543,27,28,8662.17,14502.00,0.00
2024-12-10 17:43:48,56,11543,28,28,8507.49,14502.02,0.00
2024-12-10 17:43:48,56,11544,28,28,8487.03,14503.00,0.00
2024-12-10 17:43:48,57,11544,28,29,8338.14,14503.02,0.00
2024-12-10 17:43:48,56,11544,28,28,8432.65,14503.04,0.00
2024-12-10 17:43:48,56,11545,28,28,8448.77,14504.00,0.00
2024-12-10 17:43:48,57,11545,29,28,8300.55,14504.02,0.00
2024-12-10 17:43:48,57,11546,29,28,8279.69,14505.00,0.00
2024-12-10 17:43:48,58,11546,30,28,8136.94,14505.02,0.00
2024-12-10 17:43:48,57,11546,30,27,8228.81,14505.04,0.00
2024-12-10 17:43:48,57,11547,30,27,8242.09,14506.00,0.00
2024-12-10 17:43:48,58,11547,30,28,8099.99,14506.02,0.00
2024-12-10 17:43:48,58,11548,30,28,8079.89,14507.00,0.00
2024-12-10 17:43:48,59,11548,30,29,7942.94,14507.02,0.00
2024-12-10 17:43:48,58,11548,30,28,8029.87,14507.03,0.00
2024-12-10 17:43:48,57,11548,29,28,8076.70,14507.33,0.00
2024-12-10 17:43:48,56,11548,28,28,8192.84,14507.52,0.00
2024-12-10 17:43:48,56,11549,28,28,8382.31,14508.00,0.00
2024-12-10 17:43:48,57,11549,28,29,8235.25,14508.02,0.00
2024-12-10 17:43:48,56,11549,27,29,8265.80,14508.23,0.00
2024-12-10 17:43:48,56,11550,27,29,8413.98,14509.00,0.00
2024-12-10 17:43:48,57,11550,27,30,8266.36,14509.02,0.00
2024-12-10 17:43:48,56,11550,27,29,8362.16,14509.04,0.00
2024-12-10 17:43:48,55,11550,26,29,8514.20,14509.04,0.00
2024-12-10 17:43:48,54,11550,25,29,8559.17,14509.37,0.00
2024-12-10 17:43:48,54,11551,25,29,8736.96,14510.00,0.00
2024-12-10 17:43:48,55,11551,25,30,8578.10,14510.02,0.00
2024-12-10 17:43:48,55,11552,25,30,8556.55,14511.00,0.00
2024-12-10 17:43:48,56,11552,25,31,8403.76,14511.02,0.00
2024-12-10 17:43:48,55,11552,25,30,8503.79,14511.04,0.00
2024-12-10 17:43:48,54,11552,24,30,8493.22,14511.48,0.00
2024-12-10 17:43:48,54,11553,24,30,8687.10,14512.00,0.00
2024-12-10 17:43:48,55,11553,24,31,8529.15,14512.02,0.00
2024-12-10 17:43:48,55,11554,24,31,8507.38,14513.00,0.00
2024-12-10 17:43:48,56,11554,25,31,8355.46,14513.02,0.00
2024-12-10 17:43:48,55,11554,25,30,8457.24,14513.04,0.00
2024-12-10 17:43:48,54,11554,24,30,8601.70,14513.04,0.00
2024-12-10 17:43:48,54,11555,24,30,8731.30,14514.00,0.00
2024-12-10 17:43:48,55,11555,25,30,8572.55,14514.02,0.00
2024-12-10 17:43:48,54,11555,24,30,8666.80,14514.02,0.00
2024-12-10 17:43:48,54,11556,24,30,8739.97,14515.00,0.00
2024-12-10 17:43:48,55,11556,25,30,8581.06,14515.02,0.00
2024-12-10 17:43:48,54,11556,25,29,8691.58,14515.02,0.00
2024-12-10 17:43:48,54,11557,25,29,8711.00,14516.00,0.00
2024-12-10 17:43:48,55,11557,26,29,8552.62,14516.02,0.00
2024-12-10 17:43:48,54,11557,25,29,8627.14,14516.06,0.00
2024-12-10 17:43:48,54,11558,25,29,8759.45,14517.00,0.00
2024-12-10 17:43:48,55,11558,26,29,8600.19,14517.02,0.00
2024-12-10 17:43:48,54,11558,26,28,8711.06,14517.02,0.00
2024-12-10 17:43:48,54,11559,26,28,8730.48,14518.00,0.00
2024-12-10 17:43:48,55,11559,27,28,8571.74,14518.02,0.00
2024-12-10 17:43:48,55,11560,27,28,8551.14,14519.00,0.00
2024-12-10 17:43:48,56,11560,28,28,8398.44,14519.02,0.00
2024-12-10 17:43:48,55,11560,28,27,8498.35,14519.04,0.00
2024-12-10 17:43:49,55,11561,28,27,8517.41,14520.00,0.00
2024-12-10 17:43:49,56,11561,29,27,8365.31,14520.02,0.00
2024-12-10 17:43:49,55,11561,28,27,8414.50,14520.16,0.00
2024-12-10 17:43:49,55,11562,28,27,8557.60,14521.00,0.00
2024-12-10 17:43:49,56,11562,28,28,8404.79,14521.02,0.00
2024-12-10 17:43:49,56,11563,28,28,8366.47,14522.00,0.00
2024-12-10 17:43:49,57,11563,29,28,8219.69,14522.02,0.00
2024-12-10 17:43:49,56,11563,29,27,8356.11,14522.07,0.00
2024-12-10 17:43:49,56,11564,29,27,8377.42,14523.00,0.00
2024-12-10 17:43:49,57,11564,29,28,8230.44,14523.02,0.00
2024-12-10 17:43:49,56,11564,28,28,8141.96,14523.96,0.00
2024-12-10 17:43:49,56,11565,28,28,8396.15,14524.00,0.00
2024-12-10 17:43:49,57,11565,29,28,8248.85,14524.02,0.00
2024-12-10 17:43:49,56,11565,28,28,8289.86,14524.20,0.00
2024-12-10 17:43:49,56,11566,28,28,8433.04,14525.00,0.00
2024-12-10 17:43:49,57,11566,29,28,8285.09,14525.02,0.00
2024-12-10 17:43:49,56,11566,28,28,8422.69,14525.09,0.00
2024-12-10 17:43:49,55,11566,28,27,8559.99,14525.11,0.00
2024-12-10 17:43:49,55,11567,28,27,8589.60,14526.00,0.00
2024-12-10 17:43:49,56,11567,29,27,8436.21,14526.02,0.00
2024-12-10 17:43:49,56,11568,29,27,8426.51,14527.00,0.00
2024-12-10 17:43:49,57,11568,29,28,8278.67,14527.02,0.00
2024-12-10 17:43:49,56,11568,28,28,8162.36,14527.96,0.00
2024-12-10 17:43:49,56,11569,28,28,8416.62,14528.00,0.00
2024-12-10 17:43:49,57,11569,29,28,8268.96,14528.02,0.00
2024-12-10 17:43:49,56,11569,29,27,8390.71,14528.13,0.00
2024-12-10 17:43:49,56,11570,29,27,8419.79,14529.00,0.00
2024-12-10 17:43:49,57,11570,29,28,8272.08,14529.02,0.00
2024-12-10 17:43:49,57,11571,29,28,8260.79,14530.00,0.00
2024-12-10 17:43:49,58,11571,30,28,8118.36,14530.02,0.00
2024-12-10 17:43:49,57,11571,29,28,8245.52,14530.11,0.00
2024-12-10 17:43:49,56,11571,28,28,8274.72,14530.55,0.00
2024-12-10 17:43:49,56,11572,28,28,8365.86,14531.00,0.00
2024-12-10 17:43:49,57,11572,29,28,8219.09,14531.02,0.00
2024-12-10 17:43:49,56,11572,28,28,8352.98,14531.09,0.00
2024-12-10 17:43:49,55,11572,28,27,8496.93,14531.09,0.00
2024-12-10 17:43:49,55,11573,28,27,8523.91,14532.00,0.00
2024-12-10 17:43:49,56,11573,29,27,8371.69,14532.02,0.00
2024-12-10 17:43:49,55,11573,28,27,8500.15,14532.09,0.00
2024-12-10 17:43:49,55,11574,28,27,8579.98,14533.00,0.00
2024-12-10 17:43:49,56,11574,29,27,8426.77,14533.02,0.00
2024-12-10 17:43:49,55,11574,28,27,8432.13,14533.31,0.00
2024-12-10 17:43:49,55,11575,28,27,8596.43,14534.00,0.00
2024-12-10 17:43:49,56,11575,29,27,8442.92,14534.02,0.00
2024-12-10 17:43:49,55,11575,29,26,8575.31,14534.09,0.00
2024-12-10 17:43:49,55,11576,29,26,8602.31,14535.00,0.00
2024-12-10 17:43:49,56,11576,30,26,8448.69,14535.02,0.00
2024-12-10 17:43:49,55,11576,29,26,8401.68,14535.49,0.00
2024-12-10 17:43:49,55,11577,29,26,8592.32,14536.00,0.00
2024-12-10 17:43:49,56,11577,30,26,8438.89,14536.02,0.00
2024-12-10 17:43:49,56,11578,30,26,8400.53,14537.00,0.00
2024-12-10 17:43:49,57,11578,31,26,8253.16,14537.02,0.00
2024-12-10 17:43:49,56,11578,31,25,8382.39,14537.09,0.00
2024-12-10 17:43:49,56,11579,31,25,8406.30,14538.00,0.00
2024-12-10 17:43:49,57,11579,32,25,8258.83,14538.02,0.00
2024-12-10 17:43:49,57,11580,32,25,8243.34,14539.00,0.00
2024-12-10 17:43:49,58,11580,33,25,8101.22,14539.02,0.00
2024-12-10 17:43:49,58,11581,33,25,8059.16,14540.00,0.00
2024-12-10 17:43:49,59,11581,33,26,7922.56,14540.02,0.00
2024-12-10 17:43:49,58,11581,33,25,8044.13,14540.09,0.00
2024-12-10 17:43:49,58,11582,33,25,8062.22,14541.00,0.00
2024-12-10 17:43:49,59,11582,33,26,7925.57,14541.02,0.00
2024-12-10 17:43:49,59,11583,33,26,7910.62,14542.00,0.00
2024-12-10 17:43:49,60,11583,33,27,7778.78,14542.02,0.00
2024-12-10 17:43:49,59,11583,32,27,7764.60,14542.59,0.00
2024-12-10 17:43:49,59,11584,32,27,7952.21,14543.00,0.00
2024-12-10 17:43:49,60,11584,33,27,7819.67,14543.02,0.00
2024-12-10 17:43:49,59,11584,32,27,7942.37,14543.08,0.00
2024-12-10 17:43:49,58,11584,32,26,8074.29,14543.09,0.00
2024-12-10 17:43:49,57,11584,31,26,8137.82,14543.56,0.00
2024-12-10 17:43:49,57,11585,31,26,8329.49,14544.00,0.00
2024-12-10 17:43:49,58,11585,31,27,8185.88,14544.02,0.00
2024-12-10 17:43:49,58,11586,31,27,8167.54,14545.00,0.00
2024-12-10 17:43:49,59,11586,31,28,8029.10,14545.02,0.00
2024-12-10 17:43:49,59,11586,31,28,7985.28,14546.00,0.00
2024-12-10 17:43:49,60,11586,31,29,7852.19,14546.02,0.00
2024-12-10 17:43:49,59,11586,31,28,7970.51,14546.10,0.00
2024-12-10 17:43:49,58,11586,30,28,7995.85,14546.38,0.00
2024-12-10 17:43:49,58,11587,30,28,8156.77,14547.00,0.00
2024-12-10 17:43:49,59,11587,30,29,8018.52,14547.02,0.00
2024-12-10 17:43:49,58,11587,29,29,8141.74,14547.10,0.00
2024-12-10 17:43:49,58,11588,29,29,8137.24,14548.00,0.00
2024-12-10 17:43:49,59,11588,29,30,7999.32,14548.02,0.00
2024-12-10 17:43:49,58,11588,29,29,8072.05,14548.10,0.00
2024-12-10 17:43:49,57,11588,28,29,8183.06,14548.11,0.00
2024-12-10 17:43:49,57,11589,28,29,8308.67,14549.00,0.00
2024-12-10 17:43:49,58,11589,28,30,8165.42,14549.02,0.00
2024-12-10 17:43:49,57,11589,27,30,8119.99,14549.47,0.00
2024-12-10 17:43:49,57,11590,27,30,8299.03,14550.00,0.00
2024-12-10 17:43:49,58,11590,28,30,8155.95,14550.02,0.00
2024-12-10 17:43:49,57,11590,28,29,8232.68,14550.11,0.00
2024-12-10 17:43:49,57,11591,28,29,8256.21,14551.00,0.00
2024-12-10 17:43:49,58,11591,29,29,8113.86,14551.02,0.00
2024-12-10 17:43:49,58,11592,29,29,8094.19,14552.00,0.00
2024-12-10 17:43:49,59,11592,29,30,7957.00,14552.02,0.00
2024-12-10 17:43:49,58,11592,29,29,8031.48,14552.10,0.00
2024-12-10 17:43:50,58,11593,29,29,8052.08,14553.00,0.00
2024-12-10 17:43:50,59,11593,30,29,7915.61,14553.02,0.00
2024-12-10 17:43:50,59,11594,30,29,7896.89,14554.00,0.00
2024-12-10 17:43:50,60,11594,31,29,7765.28,14554.02,0.00
2024-12-10 17:43:50,59,11594,30,29,7894.43,14554.02,0.00
2024-12-10 17:43:50,58,11594,30,28,7970.33,14554.09,0.00
2024-12-10 17:43:50,58,11595,30,28,7988.43,14555.00,0.00
2024-12-10 17:43:50,59,11595,31,28,7853.03,14555.02,0.00
2024-12-10 17:43:50,58,11595,30,28,7820.45,14555.41,0.00
2024-12-10 17:43:50,58,11596,30,28,7986.47,14556.00,0.00
2024-12-10 17:43:50,59,11596,30,29,7851.10,14556.02,0.00
2024-12-10 17:43:50,58,11596,30,28,7928.76,14556.09,0.00
2024-12-10 17:43:50,58,11597,30,28,7946.86,14557.00,0.00
2024-12-10 17:43:50,59,11597,31,28,7812.17,14557.02,0.00
2024-12-10 17:43:50,59,11598,31,28,7791.37,14558.00,0.00
2024-12-10 17:43:50,60,11598,31,29,7661.51,14558.02,0.00
2024-12-10 17:43:50,59,11598,31,28,7734.64,14558.10,0.00
2024-12-10 17:43:50,58,11598,30,28,7782.93,14558.67,0.00
2024-12-10 17:43:50,57,11598,29,28,7808.96,14558.96,0.00
2024-12-10 17:43:50,57,11599,29,28,8059.29,14559.00,0.00
2024-12-10 17:43:50,58,11599,30,28,7920.34,14559.02,0.00
2024-12-10 17:43:50,57,11599,29,28,8056.74,14559.02,0.00
2024-12-10 17:43:50,57,11600,29,28,8037.56,14560.00,0.00
2024-12-10 17:43:50,58,11600,29,29,7898.98,14560.02,0.00
2024-12-10 17:43:50,57,11600,29,28,7983.94,14560.09,0.00
2024-12-10 17:43:50,57,11601,29,28,8004.91,14561.00,0.00
2024-12-10 17:43:50,58,11601,30,28,7866.89,14561.02,0.00
2024-12-10 17:43:50,57,11601,29,28,8002.35,14561.02,0.00
2024-12-10 17:43:50,56,11601,28,28,8077.67,14561.13,0.00
2024-12-10 17:43:50,56,11602,28,28,8127.84,14562.00,0.00
2024-12-10 17:43:50,57,11602,28,29,7985.25,14562.02,0.00
2024-12-10 17:43:50,56,11602,28,28,8073.26,14562.09,0.00
2024-12-10 17:43:50,57,11601,28,29,7906.15,14562.30,0.00
2024-12-10 17:43:50,56,11601,27,29,8070.57,14562.41,0.00
2024-12-10 17:43:50,56,11601,27,29,8245.19,14563.00,0.00
2024-12-10 17:43:50,57,11601,27,30,8100.54,14563.02,0.00
2024-12-10 17:43:50,56,11601,26,30,8093.42,14563.59,0.00
2024-12-10 17:43:50,56,11602,26,30,8554.04,14564.00,0.00
2024-12-10 17:43:50,57,11602,27,30,8403.97,14564.02,0.00
2024-12-10 17:43:50,56,11602,27,29,8486.45,14564.13,0.00
2024-12-10 17:43:50,55,11602,26,29,8587.48,14564.49,0.00
2024-12-10 17:43:50,55,11603,26,29,8672.58,14565.00,0.00
2024-12-10 17:43:50,56,11603,26,30,8517.72,14565.02,0.00
2024-12-10 17:43:50,56,11604,26,30,8500.03,14566.00,0.00
2024-12-10 17:43:50,57,11604,26,31,8350.90,14566.02,0.00
2024-12-10 17:43:50,56,11604,26,30,8429.82,14566.13,0.00
2024-12-10 17:43:50,55,11604,25,30,8456.39,14566.75,0.00
2024-12-10 17:43:50,55,11605,25,30,8684.37,14567.00,0.00
2024-12-10 17:43:50,56,11605,25,31,8529.29,14567.02,0.00
2024-12-10 17:43:50,55,11605,24,31,8668.66,14567.09,0.00
2024-12-10 17:43:50,54,11605,23,31,8711.49,14567.52,0.00
2024-12-10 17:43:50,54,11606,23,31,8911.50,14568.00,0.00
2024-12-10 17:43:50,55,11606,24,31,8749.47,14568.02,0.00
2024-12-10 17:43:50,54,11606,24,30,8844.08,14568.11,0.00
2024-12-10 17:43:50,54,11607,24,30,8877.04,14569.00,0.00
2024-12-10 17:43:50,55,11607,25,30,8715.64,14569.02,0.00
2024-12-10 17:43:50,54,11607,24,30,8650.66,14569.56,0.00
2024-12-10 17:43:50,54,11608,24,30,8856.06,14570.00,0.00
2024-12-10 17:43:50,55,11608,25,30,8695.05,14570.02,0.00
2024-12-10 17:43:50,54,11608,25,29,8791.33,14570.11,0.00
2024-12-10 17:43:50,54,11609,25,29,8824.29,14571.00,0.00
2024-12-10 17:43:50,55,11609,25,30,8663.85,14571.02,0.00
2024-12-10 17:43:50,55,11610,25,30,8639.97,14572.00,0.00
2024-12-10 17:43:50,56,11610,25,31,8485.69,14572.02,0.00
2024-12-10 17:43:50,55,11610,25,30,8579.05,14572.11,0.00
2024-12-10 17:43:50,54,11610,24,30,8552.92,14572.96,0.00
2024-12-10 17:43:50,54,11611,24,30,8817.41,14573.00,0.00
2024-12-10 17:43:50,55,11611,24,31,8657.09,14573.02,0.00
2024-12-10 17:43:50,55,11612,24,31,8632.50,14574.00,0.00
2024-12-10 17:43:50,56,11612,24,32,8478.35,14574.02,0.00
2024-12-10 17:43:50,57,11611,24,33,8319.39,14574.12,0.00
2024-12-10 17:43:50,56,11611,24,32,8611.11,14574.13,0.00
2024-12-10 17:43:50,56,11612,24,32,8640.30,14575.00,0.00
2024-12-10 17:43:50,57,11612,25,32,8488.71,14575.02,0.00
2024-12-10 17:43:50,56,11612,24,32,8452.00,14575.75,0.00
2024-12-10 17:43:50,56,11613,24,32,8936.33,14576.00,0.00
2024-12-10 17:43:50,57,11613,24,33,8779.55,14576.02,0.00
2024-12-10 17:43:50,56,11613,24,32,8881.70,14576.11,0.00
2024-12-10 17:43:50,56,11614,24,32,8908.31,14577.00,0.00
2024-12-10 17:43:50,57,11614,25,32,8752.02,14577.02,0.00
2024-12-10 17:43:50,57,11615,25,32,8719.54,14578.00,0.00
2024-12-10 17:43:50,58,11615,25,33,8569.20,14578.02,0.00
2024-12-10 17:43:50,57,11615,25,32,8668.42,14578.11,0.00
2024-12-10 17:43:50,57,11616,25,32,8692.01,14579.00,0.00
2024-12-10 17:43:50,58,11616,25,33,8542.14,14579.02,0.00
2024-12-10 17:43:50,57,11616,24,33,8594.88,14579.21,0.00
2024-12-10 17:43:50,57,11617,24,33,8736.08,14580.00,0.00
2024-12-10 17:43:50,58,11617,24,34,8585.46,14580.02,0.00
2024-12-10 17:43:50,58,11618,24,34,8543.31,14581.00,0.00
2024-12-10 17:43:50,59,11618,25,34,8398.51,14581.02,0.00
2024-12-10 17:43:50,58,11618,25,33,8520.73,14581.16,0.00
2024-12-10 17:43:50,57,11618,24,33,8665.10,14581.16,0.00
2024-12-10 17:43:50,57,11619,24,33,8798.68,14582.00,0.00
2024-12-10 17:43:50,58,11619,24,34,8646.98,14582.02,0.00
2024-12-10 17:43:51,58,11620,24,34,8624.47,14583.00,0.00
2024-12-10 17:43:51,59,11620,24,35,8478.29,14583.02,0.00
2024-12-10 17:43:51,58,11620,24,34,8551.60,14583.16,0.00
2024-12-10 17:43:51,57,11620,23,34,8635.63,14583.26,0.00
2024-12-10 17:43:51,57,11621,23,34,8784.54,14584.00,0.00
2024-12-10 17:43:51,58,11621,23,35,8633.08,14584.02,0.00
2024-12-10 17:43:51,58,11622,23,35,8614.95,14585.00,0.00
2024-12-10 17:43:51,59,11622,24,35,8468.94,14585.02,0.00
2024-12-10 17:43:51,58,11622,23,35,8609.92,14585.03,0.00
2024-12-10 17:43:51,58,11623,23,35,8570.27,14586.00,0.00
2024-12-10 17:43:51,59,11623,24,35,8425.02,14586.02,0.00
2024-12-10 17:43:51,58,11623,24,34,8547.68,14586.14,0.00
2024-12-10 17:43:51,58,11624,24,34,8573.38,14587.00,0.00
2024-12-10 17:43:51,59,11624,24,35,8428.07,14587.02,0.00
2024-12-10 17:43:51,58,11624,23,35,8405.03,14587.41,0.00
2024-12-10 17:43:51,58,11625,23,35,8571.45,14588.00,0.00
2024-12-10 17:43:51,59,11625,23,36,8426.17,14588.02,0.00
2024-12-10 17:43:51,58,11625,22,36,8483.44,14588.10,0.00
2024-12-10 17:43:51,58,11626,22,36,8554.43,14589.00,0.00
2024-12-10 17:43:51,59,11626,22,37,8409.44,14589.02,0.00
2024-12-10 17:43:51,58,11626,22,36,8534.34,14589.14,0.00
2024-12-10 17:43:51,58,11627,22,36,8560.05,14590.00,0.00
2024-12-10 17:43:51,59,11627,22,37,8414.96,14590.02,0.00
2024-12-10 17:43:51,58,11627,21,37,8514.82,14590.21,0.00
2024-12-10 17:43:51,58,11628,21,37,8600.89,14591.00,0.00
2024-12-10 17:43:51,59,11628,21,38,8455.11,14591.02,0.00
2024-12-10 17:43:51,58,11628,20,38,8583.31,14591.14,0.00
2024-12-10 17:43:51,58,11629,20,38,8560.87,14592.00,0.00
2024-12-10 17:43:51,59,11629,21,38,8415.77,14592.02,0.00
2024-12-10 17:43:51,58,11629,21,37,8513.11,14592.19,0.00
2024-12-10 17:43:51,57,11629,20,37,8573.55,14592.72,0.00
2024-12-10 17:43:51,57,11630,20,37,8788.82,14593.00,0.00
2024-12-10 17:43:51,58,11630,21,37,8637.29,14593.02,0.00
2024-12-10 17:43:51,58,11631,21,37,8627.71,14594.00,0.00
2024-12-10 17:43:51,59,11631,22,37,8481.48,14594.02,0.00
2024-12-10 17:43:51,58,11631,22,36,8625.20,14594.02,0.00
2024-12-10 17:43:51,57,11631,22,35,8773.95,14594.02,0.00
2024-12-10 17:43:51,57,11632,22,35,8733.59,14595.00,0.00
2024-12-10 17:43:51,58,11632,23,35,8583.01,14595.02,0.00
2024-12-10 17:43:51,57,11632,23,34,8695.22,14595.16,0.00
2024-12-10 17:43:51,57,11633,23,34,8726.50,14596.00,0.00
2024-12-10 17:43:51,58,11633,23,35,8576.05,14596.02,0.00
2024-12-10 17:43:51,57,11633,22,35,8708.62,14596.14,0.00
2024-12-10 17:43:51,57,11634,22,35,8715.03,14597.00,0.00
2024-12-10 17:43:51,58,11634,22,36,8564.77,14597.02,0.00
2024-12-10 17:43:51,57,11634,21,36,8712.47,14597.02,0.00
2024-12-10 17:43:51,56,11634,20,36,8693.02,14597.54,0.00
2024-12-10 17:43:51,56,11635,20,36,8886.27,14598.00,0.00
2024-12-10 17:43:51,57,11635,20,37,8730.37,14598.02,0.00
2024-12-10 17:43:51,56,11635,20,36,8857.63,14598.13,0.00
2024-12-10 17:43:51,56,11636,20,36,8886.87,14599.00,0.00
2024-12-10 17:43:51,57,11636,20,37,8730.96,14599.02,0.00
2024-12-10 17:43:51,57,11637,20,37,8715.34,14600.00,0.00
2024-12-10 17:43:51,58,11637,20,38,8565.08,14600.02,0.00
2024-12-10 17:43:51,58,11638,20,38,8522.87,14601.00,0.00
2024-12-10 17:43:51,59,11638,21,38,8378.41,14601.02,0.00
2024-12-10 17:43:51,58,11638,21,37,8497.73,14601.12,0.00
2024-12-10 17:43:51,57,11638,20,37,8484.17,14601.86,0.00
2024-12-10 17:43:51,57,11639,20,37,8719.95,14602.00,0.00
2024-12-10 17:43:51,58,11639,21,37,8569.60,14602.02,0.00
2024-12-10 17:43:51,58,11640,21,37,8550.75,14603.00,0.00
2024-12-10 17:43:51,59,11640,21,38,8405.82,14603.02,0.00
2024-12-10 17:43:51,59,11641,21,38,8361.84,14604.00,0.00
2024-12-10 17:43:51,60,11641,22,38,8222.48,14604.02,0.00
2024-12-10 17:43:51,59,11641,22,37,8342.07,14604.12,0.00
2024-12-10 17:43:51,58,11641,21,37,8294.36,14604.97,0.00
2024-12-10 17:43:51,58,11642,21,37,8541.15,14605.00,0.00
2024-12-10 17:43:51,59,11642,21,38,8396.38,14605.02,0.00
2024-12-10 17:43:51,59,11643,21,38,8374.47,14606.00,0.00
2024-12-10 17:43:51,60,11643,21,39,8234.90,14606.02,0.00
2024-12-10 17:43:51,61,11642,22,39,8099.90,14606.05,0.00
2024-12-10 17:43:51,60,11642,22,38,8247.10,14606.13,0.00
2024-12-10 17:43:51,59,11642,21,38,8305.49,14606.70,0.00
2024-12-10 17:43:51,59,11643,21,38,8409.71,14607.00,0.00
2024-12-10 17:43:51,60,11643,21,39,8269.55,14607.02,0.00
2024-12-10 17:43:51,60,11644,21,39,8489.69,14608.00,0.00
2024-12-10 17:43:51,61,11644,22,39,8350.51,14608.02,0.00
2024-12-10 17:43:51,60,11644,22,38,8426.42,14608.12,0.00
2024-12-10 17:43:51,59,11644,21,38,8452.53,14608.41,0.00
2024-12-10 17:43:51,59,11645,21,38,8613.90,14609.00,0.00
2024-12-10 17:43:51,60,11645,21,39,8470.33,14609.02,0.00
2024-12-10 17:43:51,60,11646,21,39,8443.37,14610.00,0.00
2024-12-10 17:43:51,61,11646,22,39,8304.95,14610.02,0.00
2024-12-10 17:43:51,60,11646,22,38,8382.52,14610.12,0.00
2024-12-10 17:43:51,60,11647,22,38,8400.11,14611.00,0.00
2024-12-10 17:43:51,61,11647,22,39,8262.41,14611.02,0.00
2024-12-10 17:43:51,61,11648,22,39,8234.49,14612.00,0.00
2024-12-10 17:43:51,62,11648,23,39,8101.68,14612.02,0.00
2024-12-10 17:43:51,61,11648,23,38,8177.03,14612.12,0.00
2024-12-10 17:43:51,60,11648,22,38,8198.90,14612.72,0.00
2024-12-10 17:43:51,60,11649,22,38,8401.26,14613.00,0.00
2024-12-10 17:43:51,61,11649,23,38,8263.54,14613.02,0.00
2024-12-10 17:43:51,60,11649,22,38,8206.64,14613.53,0.00
2024-12-10 17:43:51,60,11650,22,38,8382.35,14614.00,0.00
2024-12-10 17:43:51,61,11650,22,39,8244.94,14614.02,0.00
2024-12-10 17:43:51,60,11650,22,38,8321.49,14614.12,0.00
2024-12-10 17:43:51,59,11650,21,38,8462.53,14614.12,0.00
2024-12-10 17:43:51,58,11650,20,38,8528.11,14614.67,0.00
2024-12-10 17:43:52,58,11651,20,38,8631.68,14615.00,0.00
2024-12-10 17:43:52,59,11651,20,39,8485.38,14615.02,0.00
2024-12-10 17:43:52,58,11651,19,39,8543.52,14615.19,0.00
2024-12-10 17:43:52,58,11652,19,39,8677.63,14616.00,0.00
2024-12-10 17:43:52,59,11652,20,39,8530.55,14616.02,0.00
2024-12-10 17:43:52,58,11652,19,39,8662.52,14616.05,0.00
2024-12-10 17:43:52,57,11652,19,38,8750.40,14616.12,0.00
2024-12-10 17:43:52,57,11653,19,38,8879.19,14617.00,0.00
2024-12-10 17:43:52,58,11653,20,38,8726.10,14617.02,0.00
2024-12-10 17:43:52,58,11654,20,38,8702.54,14618.00,0.00
2024-12-10 17:43:52,59,11654,21,38,8555.04,14618.02,0.00
2024-12-10 17:43:52,58,11654,21,37,8632.00,14618.14,0.00
2024-12-10 17:43:52,58,11655,21,37,8657.77,14619.00,0.00
2024-12-10 17:43:52,59,11655,21,38,8511.03,14619.02,0.00
2024-12-10 17:43:52,58,11655,20,38,8624.33,14619.12,0.00
2024-12-10 17:43:52,58,11656,20,38,8697.99,14620.00,0.00
2024-12-10 17:43:52,59,11656,20,39,8550.57,14620.02,0.00
2024-12-10 17:43:52,58,11656,20,38,8629.96,14620.12,0.00
2024-12-10 17:43:52,58,11657,20,38,8653.21,14621.00,0.00
2024-12-10 17:43:52,59,11657,21,38,8506.55,14621.02,0.00
2024-12-10 17:43:52,59,11658,21,38,8483.40,14622.00,0.00
2024-12-10 17:43:52,60,11658,21,39,8342.01,14622.02,0.00
2024-12-10 17:43:52,59,11658,21,38,8416.51,14622.12,0.00
2024-12-10 17:43:52,59,11659,21,38,8436.89,14623.00,0.00
2024-12-10 17:43:52,60,11659,21,39,8296.27,14623.02,0.00
2024-12-10 17:43:52,59,11659,20,39,8426.82,14623.03,0.00
2024-12-10 17:43:52,59,11660,20,39,8484.40,14624.00,0.00
2024-12-10 17:43:52,60,11660,21,39,8342.99,14624.02,0.00
2024-12-10 17:43:52,59,11660,20,39,8473.12,14624.08,0.00
2024-12-10 17:43:52,58,11660,20,38,8571.30,14624.09,0.00
2024-12-10 17:43:52,57,11660,19,38,8657.62,14624.28,0.00
2024-12-10 17:43:52,57,11661,19,38,8809.49,14625.00,0.00
2024-12-10 17:43:52,58,11661,19,39,8657.61,14625.02,0.00
2024-12-10 17:43:52,57,11661,18,39,8656.05,14625.60,0.00
2024-12-10 17:43:52,57,11662,18,39,8853.93,14626.00,0.00
2024-12-10 17:43:52,58,11662,19,39,8701.27,14626.02,0.00
2024-12-10 17:43:52,57,11662,19,38,8797.49,14626.09,0.00
2024-12-10 17:43:52,56,11662,18,38,8852.73,14626.09,0.00
2024-12-10 17:43:52,56,11663,18,38,8981.30,14627.00,0.00
2024-12-10 17:43:52,57,11663,19,38,8823.74,14627.02,0.00
2024-12-10 17:43:52,58,11662,19,39,8593.49,14627.24,0.00
2024-12-10 17:43:52,58,11663,19,39,8775.75,14628.00,0.00
2024-12-10 17:43:52,59,11663,19,40,8627.01,14628.02,0.00
2024-12-10 17:43:52,58,11663,18,40,8770.72,14628.03,0.00
2024-12-10 17:43:52,57,11663,18,39,8873.27,14628.07,0.00
2024-12-10 17:43:52,56,11663,17,39,8923.64,14628.32,0.00
2024-12-10 17:43:52,56,11664,17,39,9347.30,14629.00,0.00
2024-12-10 17:43:52,57,11664,17,40,9183.31,14629.02,0.00
2024-12-10 17:43:52,56,11664,16,40,9128.21,14629.86,0.00
2024-12-10 17:43:52,56,11665,16,40,9368.69,14630.00,0.00
2024-12-10 17:43:52,57,11665,16,41,9204.32,14630.02,0.00
2024-12-10 17:43:52,56,11665,16,40,9316.45,14630.07,0.00
2024-12-10 17:43:52,56,11666,16,40,9337.97,14631.00,0.00
2024-12-10 17:43:52,57,11666,16,41,9174.15,14631.02,0.00
2024-12-10 17:43:52,56,11666,15,41,9332.76,14631.04,0.00
2024-12-10 17:43:52,55,11666,14,41,9351.96,14631.60,0.00
2024-12-10 17:43:52,55,11667,14,41,9559.78,14632.00,0.00
2024-12-10 17:43:52,56,11667,15,41,9389.07,14632.02,0.00
2024-12-10 17:43:52,55,11667,14,41,9554.48,14632.04,0.00
2024-12-10 17:43:52,54,11667,14,40,9688.06,14632.04,0.00
2024-12-10 17:43:52,54,11668,14,40,9710.38,14633.00,0.00
2024-12-10 17:43:52,55,11668,14,41,9533.83,14633.02,0.00
2024-12-10 17:43:52,55,11669,14,41,9497.23,14634.00,0.00
2024-12-10 17:43:52,56,11669,15,41,9327.64,14634.02,0.00
2024-12-10 17:43:52,57,11668,15,42,9164.00,14634.05,0.00
2024-12-10 17:43:52,56,11668,15,41,9351.18,14634.05,0.00
2024-12-10 17:43:52,55,11668,14,41,9345.89,14634.58,0.00
2024-12-10 17:43:52,55,11669,14,41,9551.10,14635.00,0.00
2024-12-10 17:43:52,56,11669,15,41,9380.55,14635.02,0.00
2024-12-10 17:43:52,56,11670,15,41,9603.69,14636.00,0.00
2024-12-10 17:43:52,57,11670,16,41,9435.20,14636.02,0.00
2024-12-10 17:43:52,56,11670,16,40,9556.66,14636.04,0.00
2024-12-10 17:43:52,56,11671,16,40,9572.98,14637.00,0.00
2024-12-10 17:43:52,57,11671,16,41,9405.03,14637.02,0.00
2024-12-10 17:43:52,57,11672,16,41,9364.58,14638.00,0.00
2024-12-10 17:43:52,58,11672,16,42,9203.12,14638.02,0.00
2024-12-10 17:43:52,57,11672,16,41,9320.94,14638.04,0.00
2024-12-10 17:43:52,57,11673,16,41,9334.41,14639.00,0.00
2024-12-10 17:43:52,58,11673,17,41,9173.47,14639.02,0.00
2024-12-10 17:43:52,57,11673,16,41,9116.39,14639.54,0.00
2024-12-10 17:43:52,57,11674,16,41,9306.79,14640.00,0.00
2024-12-10 17:43:52,58,11674,17,41,9146.33,14640.02,0.00
2024-12-10 17:43:52,57,11674,17,40,9265.71,14640.04,0.00
2024-12-10 17:43:52,58,11673,17,41,9048.10,14640.47,0.00
2024-12-10 17:43:52,58,11674,17,41,9205.01,14641.00,0.00
2024-12-10 17:43:52,59,11674,18,41,9048.99,14641.02,0.00
2024-12-10 17:43:52,59,11675,18,41,9254.53,14642.00,0.00
2024-12-10 17:43:52,60,11675,19,41,9100.29,14642.02,0.00
2024-12-10 17:43:52,61,11674,19,42,8948.72,14642.07,0.00
2024-12-10 17:43:52,60,11674,19,41,9095.44,14642.07,0.00
2024-12-10 17:43:52,60,11675,19,41,9105.79,14643.00,0.00
2024-12-10 17:43:52,61,11675,19,42,8956.52,14643.02,0.00
2024-12-10 17:43:52,61,11676,19,42,9153.14,14644.00,0.00
2024-12-10 17:43:52,62,11676,20,42,9005.51,14644.02,0.00
2024-12-10 17:43:52,61,11676,20,41,9112.36,14644.05,0.00
2024-12-10 17:43:52,60,11676,19,41,9197.56,14644.50,0.00
2024-12-10 17:43:52,60,11677,19,41,9271.15,14645.00,0.00
2024-12-10 17:43:52,61,11677,20,41,9119.16,14645.02,0.00
2024-12-10 17:43:52,61,11678,20,41,9071.76,14646.00,0.00
2024-12-10 17:43:52,62,11678,20,42,8925.44,14646.02,0.00
2024-12-10 17:43:52,61,11678,20,41,9033.38,14646.05,0.00
2024-12-10 17:43:52,60,11678,19,41,9104.52,14646.58,0.00
2024-12-10 17:43:53,60,11679,19,41,9190.27,14647.00,0.00
2024-12-10 17:43:53,61,11679,19,42,9039.61,14647.02,0.00
2024-12-10 17:43:53,61,11680,19,42,8992.20,14648.00,0.00
2024-12-10 17:43:53,62,11680,19,43,8847.16,14648.02,0.00
2024-12-10 17:43:53,61,11680,19,42,8956.21,14648.05,0.00
2024-12-10 17:43:53,60,11680,18,42,8927.56,14648.60,0.00
2024-12-10 17:43:53,60,11681,18,42,9113.40,14649.00,0.00
2024-12-10 17:43:53,61,11681,19,42,8964.00,14649.02,0.00
2024-12-10 17:43:53,60,11681,18,42,8947.57,14649.42,0.00
2024-12-10 17:43:53,60,11682,18,42,9106.69,14650.00,0.00
2024-12-10 17:43:53,61,11682,18,43,8957.40,14650.02,0.00
2024-12-10 17:43:53,60,11682,18,42,9070.10,14650.05,0.00
2024-12-10 17:43:53,60,11683,18,42,9078.01,14651.00,0.00
2024-12-10 17:43:53,61,11683,18,43,8929.19,14651.02,0.00
2024-12-10 17:43:53,62,11682,18,44,8530.40,14651.82,0.00
2024-12-10 17:43:53,62,11683,18,44,8764.51,14652.00,0.00
2024-12-10 17:43:53,63,11683,18,45,8625.39,14652.02,0.00
2024-12-10 17:43:53,62,11683,18,44,8731.45,14652.05,0.00
2024-12-10 17:43:53,61,11683,17,44,8788.43,14652.62,0.00
2024-12-10 17:43:53,60,11683,16,44,8893.48,14652.77,0.00
2024-12-10 17:43:53,60,11684,16,44,9347.89,14653.00,0.00
2024-12-10 17:43:53,61,11684,16,45,9194.65,14653.02,0.00
2024-12-10 17:43:53,61,11685,16,45,9147.23,14654.00,0.00
2024-12-10 17:43:53,62,11685,16,46,8999.69,14654.02,0.00
2024-12-10 17:43:53,61,11685,16,45,9116.03,14654.05,0.00
2024-12-10 17:43:53,60,11685,15,45,9102.41,14654.92,0.00
2024-12-10 17:43:53,60,11686,15,45,9334.51,14655.00,0.00
2024-12-10 17:43:53,61,11686,16,45,9181.49,14655.02,0.00
2024-12-10 17:43:53,60,11686,15,45,9168.47,14655.13,0.00
2024-12-10 17:43:53,60,11687,15,45,9286.29,14656.00,0.00
2024-12-10 17:43:53,61,11687,15,46,9134.06,14656.02,0.00
2024-12-10 17:43:53,60,11687,15,45,9252.12,14656.05,0.00
2024-12-10 17:43:53,60,11688,15,45,9260.06,14657.00,0.00
2024-12-10 17:43:53,61,11688,15,46,9108.25,14657.02,0.00
2024-12-10 17:43:53,61,11689,15,46,9060.82,14658.00,0.00
2024-12-10 17:43:53,62,11689,16,46,8914.67,14658.02,0.00
2024-12-10 17:43:53,61,11689,16,45,9029.60,14658.05,0.00
2024-12-10 17:43:53,60,11689,15,45,9002.33,14658.97,0.00
2024-12-10 17:43:53,60,11690,15,45,9241.78,14659.00,0.00
2024-12-10 17:43:53,61,11690,15,46,9090.27,14659.02,0.00
2024-12-10 17:43:53,61,11691,15,46,9042.82,14660.00,0.00
2024-12-10 17:43:53,62,11691,16,46,8896.97,14660.02,0.00
2024-12-10 17:43:53,61,11691,16,45,9014.01,14660.05,0.00
2024-12-10 17:43:53,60,11691,15,45,9072.77,14660.67,0.00
2024-12-10 17:43:53,60,11692,15,45,9170.77,14661.00,0.00
2024-12-10 17:43:53,61,11692,16,45,9020.43,14661.02,0.00
2024-12-10 17:43:53,62,11691,16,46,8874.94,14661.05,0.00
2024-12-10 17:43:53,62,11692,16,46,8892.10,14662.00,0.00
2024-12-10 17:43:53,63,11692,16,47,8750.96,14662.02,0.00
2024-12-10 17:43:53,62,11692,16,46,8866.12,14662.05,0.00
2024-12-10 17:43:53,61,11692,15,46,8918.06,14662.67,0.00
2024-12-10 17:43:53,61,11693,15,46,9350.98,14663.00,0.00
2024-12-10 17:43:53,62,11693,16,46,9200.16,14663.02,0.00
2024-12-10 17:43:53,62,11694,16,46,9151.12,14664.00,0.00
2024-12-10 17:43:53,63,11694,16,47,9005.86,14664.02,0.00
2024-12-10 17:43:53,62,11694,16,46,9127.50,14664.05,0.00
2024-12-10 17:43:53,61,11694,15,46,9260.33,14664.15,0.00
2024-12-10 17:43:53,61,11695,15,46,9280.13,14665.00,0.00
2024-12-10 17:43:53,62,11695,15,47,9130.45,14665.02,0.00
2024-12-10 17:43:53,61,11695,14,47,9071.51,14665.88,0.00
2024-12-10 17:43:53,61,11696,14,47,9295.19,14666.00,0.00
2024-12-10 17:43:53,62,11696,14,48,9145.27,14666.02,0.00
2024-12-10 17:43:53,61,11696,14,47,9263.96,14666.05,0.00
2024-12-10 17:43:53,61,11697,14,47,9269.38,14667.00,0.00
2024-12-10 17:43:53,62,11697,15,47,9119.87,14667.02,0.00
2024-12-10 17:43:53,62,11698,15,47,9070.81,14668.00,0.00
2024-12-10 17:43:53,63,11698,16,47,8926.83,14668.02,0.00
2024-12-10 17:43:53,62,11698,16,46,9042.45,14668.05,0.00
2024-12-10 17:43:53,62,11699,16,46,9045.40,14669.00,0.00
2024-12-10 17:43:53,63,11699,17,46,8901.83,14669.02,0.00
2024-12-10 17:43:53,63,11700,17,46,8851.20,14670.00,0.00
2024-12-10 17:43:53,64,11700,17,47,8712.90,14670.02,0.00
2024-12-10 17:43:53,63,11700,17,46,8825.62,14670.05,0.00
2024-12-10 17:43:53,63,11701,17,46,8826.19,14671.00,0.00
2024-12-10 17:43:53,64,11701,17,47,8688.28,14671.02,0.00
2024-12-10 17:43:53,64,11702,17,47,8636.15,14672.00,0.00
2024-12-10 17:43:53,65,11702,17,48,8503.28,14672.02,0.00
2024-12-10 17:43:53,64,11702,17,47,8613.25,14672.05,0.00
2024-12-10 17:43:53,63,11702,16,47,8601.39,14672.87,0.00
2024-12-10 17:43:53,63,11703,16,47,8815.75,14673.00,0.00
2024-12-10 17:43:53,64,11703,16,48,8678.00,14673.02,0.00
2024-12-10 17:43:53,64,11704,16,48,8625.86,14674.00,0.00
2024-12-10 17:43:53,65,11704,16,49,8493.15,14674.02,0.00
2024-12-10 17:43:53,64,11704,16,48,8605.25,14674.05,0.00
2024-12-10 17:43:53,63,11704,15,48,8616.48,14674.79,0.00
2024-12-10 17:43:53,63,11705,15,48,8819.28,14675.00,0.00
2024-12-10 17:43:53,64,11705,16,48,8681.48,14675.02,0.00
2024-12-10 17:43:53,64,11706,16,48,8629.33,14676.00,0.00
2024-12-10 17:43:53,65,11706,16,49,8496.57,14676.02,0.00
2024-12-10 17:43:53,64,11706,16,48,8606.42,14676.05,0.00
2024-12-10 17:43:53,64,11707,16,48,8604.69,14677.00,0.00
2024-12-10 17:43:53,65,11707,16,49,8472.31,14677.02,0.00
2024-12-10 17:43:53,65,11708,16,49,8418.69,14678.00,0.00
2024-12-10 17:43:53,66,11708,17,49,8291.14,14678.02,0.00
2024-12-10 17:43:53,65,11708,17,48,8396.13,14678.05,0.00
2024-12-10 17:43:53,64,11708,16,48,8408.25,14678.48,0.00
2024-12-10 17:43:54,64,11709,16,48,8562.28,14679.00,0.00
2024-12-10 17:43:54,65,11709,17,48,8430.56,14679.02,0.00
2024-12-10 17:43:54,64,11709,16,48,8493.54,14679.17,0.00
2024-12-10 17:43:54,64,11710,16,48,8510.11,14680.00,0.00
2024-12-10 17:43:54,65,11710,16,49,8379.19,14680.02,0.00
2024-12-10 17:43:54,66,11709,17,49,8250.02,14680.06,0.00
2024-12-10 17:43:54,65,11709,17,48,8444.71,14680.06,0.00
2024-12-10 17:43:54,65,11710,17,48,8443.00,14681.00,0.00
2024-12-10 17:43:54,66,11710,17,49,8315.08,14681.02,0.00
2024-12-10 17:43:54,66,11711,17,49,8554.94,14682.00,0.00
2024-12-10 17:43:54,67,11711,18,49,8427.26,14682.01,0.00
2024-12-10 17:43:54,66,11711,17,49,8412.91,14682.68,0.00
2024-12-10 17:43:54,66,11712,17,49,8565.08,14683.00,0.00
2024-12-10 17:43:54,67,11712,18,49,8437.24,14683.01,0.00
2024-12-10 17:43:54,67,11713,18,49,8425.63,14684.00,0.00
2024-12-10 17:43:54,68,11713,19,49,8301.72,14684.01,0.00
2024-12-10 17:43:54,68,11714,19,49,8252.07,14685.00,0.00
2024-12-10 17:43:54,69,11714,19,50,8132.48,14685.01,0.00
2024-12-10 17:43:54,68,11714,19,49,8215.37,14685.03,0.00
2024-12-10 17:43:54,68,11715,19,49,8202.96,14686.00,0.00
2024-12-10 17:43:54,69,11715,19,50,8084.08,14686.01,0.00
2024-12-10 17:43:54,68,11715,18,50,8090.77,14686.34,0.00
2024-12-10 17:43:54,68,11716,18,50,8210.00,14687.00,0.00
2024-12-10 17:43:54,69,11716,19,50,8091.01,14687.01,0.00
2024-12-10 17:43:54,68,11716,19,49,8203.54,14687.04,0.00
2024-12-10 17:43:54,67,11716,18,49,8270.98,14687.30,0.00
2024-12-10 17:43:54,67,11717,18,49,8387.62,14688.00,0.00
2024-12-10 17:43:54,68,11717,19,49,8264.27,14688.01,0.00
2024-12-10 17:43:54,68,11718,19,49,8206.51,14689.00,0.00
2024-12-10 17:43:54,69,11718,20,49,8087.57,14689.01,0.00
2024-12-10 17:43:54,68,11718,20,48,8200.05,14689.04,0.00
2024-12-10 17:43:54,68,11719,20,48,8189.79,14690.00,0.00
2024-12-10 17:43:54,69,11719,20,49,8071.09,14690.01,0.00
2024-12-10 17:43:54,70,11718,21,49,7897.07,14690.16,0.00
2024-12-10 17:43:54,69,11718,20,49,7999.02,14690.67,0.00
2024-12-10 17:43:54,69,11719,20,49,8163.20,14691.00,0.00
2024-12-10 17:43:54,70,11719,20,50,8046.58,14691.01,0.00
2024-12-10 17:43:54,69,11719,20,49,8156.83,14691.04,0.00
2024-12-10 17:43:54,68,11719,19,49,8229.34,14691.28,0.00
2024-12-10 17:43:54,68,11720,19,49,8556.04,14692.00,0.00
2024-12-10 17:43:54,69,11720,19,50,8432.04,14692.01,0.00
2024-12-10 17:43:54,69,11721,19,50,8372.99,14693.00,0.00
2024-12-10 17:43:54,70,11721,20,50,8253.37,14693.01,0.00
2024-12-10 17:43:54,69,11721,20,49,8364.49,14693.04,0.00
2024-12-10 17:43:54,69,11722,20,49,8352.26,14694.00,0.00
2024-12-10 17:43:54,70,11722,21,49,8232.94,14694.01,0.00
2024-12-10 17:43:54,69,11722,20,49,8252.19,14694.06,0.00
2024-12-10 17:43:54,69,11723,20,49,8327.28,14695.00,0.00
2024-12-10 17:43:54,70,11723,21,49,8208.31,14695.01,0.00
2024-12-10 17:43:54,69,11723,21,48,8320.90,14695.04,0.00
2024-12-10 17:43:54,69,11724,21,48,8308.67,14696.00,0.00
2024-12-10 17:43:54,70,11724,21,49,8189.98,14696.01,0.00
2024-12-10 17:43:54,70,11725,21,49,8129.65,14697.00,0.00
2024-12-10 17:43:54,71,11725,21,50,8015.15,14697.01,0.00
2024-12-10 17:43:54,72,11724,22,50,7901.79,14697.06,0.00
2024-12-10 17:43:54,71,11724,22,49,8122.81,14697.06,0.00
2024-12-10 17:43:54,71,11725,22,49,8108.85,14698.00,0.00
2024-12-10 17:43:54,72,11725,23,49,7996.22,14698.01,0.00
2024-12-10 17:43:54,71,11725,22,49,7910.75,14698.73,0.00
2024-12-10 17:43:54,71,11726,22,49,8285.65,14699.00,0.00
2024-12-10 17:43:54,72,11726,23,49,8170.57,14699.01,0.00
2024-12-10 17:43:54,71,11726,23,48,8277.39,14699.04,0.00
2024-12-10 17:43:54,71,11727,23,48,8261.37,14700.00,0.00
2024-12-10 17:43:54,72,11727,23,49,8146.63,14700.01,0.00
2024-12-10 17:43:54,72,11728,23,49,8148.98,14701.00,0.00
2024-12-10 17:43:54,73,11728,23,50,8037.35,14701.01,0.00
2024-12-10 17:43:54,73,11729,23,50,8029.35,14702.00,0.00
2024-12-10 17:43:54,74,11729,23,51,7920.84,14702.01,0.00
2024-12-10 17:43:54,74,11730,23,51,7887.59,14703.00,0.00
2024-12-10 17:43:54,75,11730,24,51,7782.42,14703.01,0.00
2024-12-10 17:43:54,76,11729,25,51,7629.75,14703.12,0.00
2024-12-10 17:43:54,76,11730,25,51,7761.80,14704.00,0.00
2024-12-10 17:43:54,77,11730,26,51,7661.00,14704.01,0.00
2024-12-10 17:43:54,76,11730,26,50,7744.41,14704.04,0.00
2024-12-10 17:43:54,75,11730,25,50,7719.40,14704.84,0.00
2024-12-10 17:43:54,75,11731,25,50,8088.11,14705.00,0.00
2024-12-10 17:43:54,76,11731,26,50,7981.69,14705.01,0.00
2024-12-10 17:43:54,75,11731,26,49,8046.96,14705.04,0.00
2024-12-10 17:43:54,74,11731,25,49,8048.46,14705.23,0.00
2024-12-10 17:43:54,74,11732,25,49,8134.37,14706.00,0.00
2024-12-10 17:43:54,75,11732,26,49,8025.92,14706.01,0.00
2024-12-10 17:43:54,74,11732,26,48,8090.67,14706.04,0.00
2024-12-10 17:43:54,73,11732,25,48,8175.38,14706.22,0.00
2024-12-10 17:43:54,72,11732,24,48,8166.57,14706.60,0.00
2024-12-10 17:43:54,72,11733,24,48,8311.87,14707.00,0.00
2024-12-10 17:43:54,73,11733,25,48,8198.01,14707.01,0.00
2024-12-10 17:43:54,73,11734,25,48,8199.09,14708.00,0.00
2024-12-10 17:43:54,74,11734,26,48,8088.29,14708.01,0.00
2024-12-10 17:43:54,74,11735,26,48,8080.81,14709.00,0.00
2024-12-10 17:43:54,75,11735,27,48,7973.07,14709.01,0.00
2024-12-10 17:43:54,75,11736,27,48,7947.32,14710.00,0.00
2024-12-10 17:43:55,76,11736,28,48,7842.75,14710.01,0.00
2024-12-10 17:43:55,77,11735,29,48,7735.19,14710.08,0.00
2024-12-10 17:43:55,76,11735,28,48,7866.31,14710.74,0.00
2024-12-10 17:43:55,76,11736,28,48,7953.75,14711.00,0.00
2024-12-10 17:43:55,77,11736,29,48,7850.45,14711.01,0.00
2024-12-10 17:43:55,77,11737,29,48,8035.85,14712.00,0.00
2024-12-10 17:43:55,78,11737,29,49,7932.83,14712.01,0.00
2024-12-10 17:43:55,78,11738,29,49,7919.79,14713.00,0.00
2024-12-10 17:43:55,79,11738,30,49,7819.54,14713.01,0.00
2024-12-10 17:43:55,79,11739,30,49,7792.40,14714.00,0.00
2024-12-10 17:43:55,80,11739,31,49,7695.00,14714.01,0.00
2024-12-10 17:43:55,80,11740,31,49,7639.08,14715.00,0.00
2024-12-10 17:43:55,81,11740,31,50,7544.77,14715.01,0.00
2024-12-10 17:43:55,80,11740,31,49,7604.15,14715.05,0.00
2024-12-10 17:43:55,80,11741,31,49,7575.21,14716.00,0.00
2024-12-10 17:43:55,81,11741,31,50,7481.69,14716.01,0.00
2024-12-10 17:43:55,80,11741,31,49,7545.80,14716.05,0.00
2024-12-10 17:43:55,79,11741,30,49,7527.85,14716.52,0.00
2024-12-10 17:43:55,79,11742,30,49,7643.68,14717.00,0.00
2024-12-10 17:43:55,80,11742,30,50,7548.13,14717.01,0.00
2024-12-10 17:43:55,79,11742,30,49,7613.89,14717.05,0.00
2024-12-10 17:43:55,80,11741,31,49,7419.67,14717.75,0.00
2024-12-10 17:43:55,80,11742,31,49,7600.16,14718.00,0.00
2024-12-10 17:43:55,81,11742,32,49,7506.33,14718.01,0.00
2024-12-10 17:43:55,80,11742,32,48,7570.74,14718.05,0.00
2024-12-10 17:43:55,80,11743,32,48,7725.79,14719.00,0.00
2024-12-10 17:43:55,81,11743,33,48,7630.41,14719.01,0.00
2024-12-10 17:43:55,80,11743,33,47,7696.37,14719.05,0.00
2024-12-10 17:43:55,80,11744,33,47,7667.43,14720.00,0.00
2024-12-10 17:43:55,81,11744,33,48,7572.77,14720.01,0.00
2024-12-10 17:43:55,80,11744,33,47,7636.17,14720.05,0.00
2024-12-10 17:43:55,79,11744,32,47,7673.30,14720.34,0.00
2024-12-10 17:43:55,79,11745,32,47,7763.15,14721.00,0.00
2024-12-10 17:43:55,80,11745,33,47,7666.11,14721.01,0.00
2024-12-10 17:43:55,79,11745,32,47,7686.75,14721.01,0.00
2024-12-10 17:43:55,78,11745,32,46,7755.12,14721.04,0.00
2024-12-10 17:43:55,79,11744,33,46,7625.33,14721.28,0.00
2024-12-10 17:43:55,79,11745,33,46,7815.86,14722.00,0.00
2024-12-10 17:43:55,80,11745,34,46,7718.16,14722.01,0.00
2024-12-10 17:43:55,79,11745,34,45,7782.33,14722.04,0.00
2024-12-10 17:43:55,78,11745,33,45,7778.60,14722.72,0.00
2024-12-10 17:43:55,78,11746,33,45,8114.80,14723.00,0.00
2024-12-10 17:43:55,79,11746,34,45,8012.08,14723.01,0.00
2024-12-10 17:43:55,78,11746,34,44,8080.83,14723.04,0.00
2024-12-10 17:43:55,78,11747,34,44,8053.05,14724.00,0.00
2024-12-10 17:43:55,79,11747,34,45,7951.11,14724.01,0.00
2024-12-10 17:43:55,78,11747,33,45,7878.71,14724.44,0.00
2024-12-10 17:43:55,78,11748,33,45,7984.81,14725.00,0.00
2024-12-10 17:43:55,79,11748,33,46,7883.74,14725.01,0.00
2024-12-10 17:43:55,78,11748,33,45,7945.18,14725.05,0.00
2024-12-10 17:43:55,78,11749,33,45,7919.28,14726.00,0.00
2024-12-10 17:43:55,79,11749,34,45,7819.03,14726.01,0.00
2024-12-10 17:43:55,78,11749,33,45,7915.51,14726.03,0.00
2024-12-10 17:43:55,77,11749,33,44,7981.97,14726.04,0.00
2024-12-10 17:43:55,78,11748,33,45,7806.19,14726.56,0.00
2024-12-10 17:43:55,78,11749,33,45,7987.78,14727.00,0.00
2024-12-10 17:43:55,79,11749,34,45,7886.67,14727.01,0.00
2024-12-10 17:43:55,78,11749,34,44,7946.26,14727.04,0.00
2024-12-10 17:43:55,79,11748,35,44,7758.32,14727.66,0.00
2024-12-10 17:43:55,79,11749,35,44,8063.84,14728.00,0.00
2024-12-10 17:43:55,80,11749,36,44,7963.04,14728.01,0.00
2024-12-10 17:43:55,79,11749,36,43,8022.84,14728.04,0.00
2024-12-10 17:43:55,79,11750,36,43,8179.98,14729.00,0.00
2024-12-10 17:43:55,80,11750,36,44,8077.73,14729.01,0.00
2024-12-10 17:43:55,79,11750,36,43,8172.53,14729.03,0.00
2024-12-10 17:43:55,79,11751,36,43,8141.38,14730.00,0.00
2024-12-10 17:43:55,80,11751,36,44,8039.62,14730.01,0.00
2024-12-10 17:43:55,79,11751,36,43,8104.10,14730.03,0.00
2024-12-10 17:43:55,78,11751,35,43,8181.62,14730.21,0.00
2024-12-10 17:43:55,79,11750,36,43,8013.01,14730.67,0.00
2024-12-10 17:43:55,79,11751,36,43,8217.15,14731.00,0.00
2024-12-10 17:43:55,80,11751,37,43,8114.44,14731.01,0.00
2024-12-10 17:43:55,79,11751,37,42,8178.00,14731.03,0.00
2024-12-10 17:43:55,80,11750,37,43,8035.36,14731.33,0.00
2024-12-10 17:43:55,79,11750,36,43,8126.04,14731.59,0.00
2024-12-10 17:43:55,79,11751,36,43,8439.62,14732.00,0.00
2024-12-10 17:43:55,80,11751,36,44,8334.12,14732.01,0.00
2024-12-10 17:43:55,79,11751,36,43,8400.47,14732.03,0.00
2024-12-10 17:43:55,79,11752,36,43,8555.82,14733.00,0.00
2024-12-10 17:43:55,80,11752,36,44,8448.87,14733.01,0.00
2024-12-10 17:43:55,79,11752,36,43,8518.53,14733.03,0.00
2024-12-10 17:43:55,78,11752,35,43,8527.77,14733.42,0.00
2024-12-10 17:43:55,78,11753,35,43,8632.10,14734.00,0.00
2024-12-10 17:43:55,79,11753,36,43,8522.83,14734.01,0.00
2024-12-10 17:43:55,78,11753,36,42,8594.32,14734.03,0.00
2024-12-10 17:43:55,78,11754,36,42,8564.67,14735.00,0.00
2024-12-10 17:43:55,79,11754,37,42,8456.26,14735.01,0.00
2024-12-10 17:43:55,78,11754,37,41,8526.90,14735.03,0.00
2024-12-10 17:43:55,78,11755,37,41,8497.24,14736.00,0.00
2024-12-10 17:43:55,79,11755,38,41,8389.68,14736.01,0.00
2024-12-10 17:43:55,78,11755,38,40,8459.46,14736.03,0.00
2024-12-10 17:43:55,77,11755,37,40,8544.50,14736.19,0.00
2024-12-10 17:43:55,77,11756,37,40,8541.19,14737.00,0.00
2024-12-10 17:43:55,78,11756,38,40,8431.69,14737.01,0.00
2024-12-10 17:43:55,77,11756,38,39,8501.01,14737.03,0.00
2024-12-10 17:43:55,77,11757,38,39,8472.87,14738.00,0.00
2024-12-10 17:43:55,78,11757,39,39,8364.24,14738.01,0.00
2024-12-10 17:43:55,77,11757,39,38,8432.68,14738.03,0.00
2024-12-10 17:43:55,76,11757,38,38,8445.07,14738.68,0.00
2024-12-10 17:43:55,77,11756,39,38,8329.67,14738.74,0.00
2024-12-10 17:43:55,77,11757,39,38,8437.07,14739.00,0.00
2024-12-10 17:43:55,78,11757,39,39,8328.91,14739.01,0.00
2024-12-10 17:43:56,77,11757,39,38,8394.97,14739.03,0.00
2024-12-10 17:43:56,76,11757,38,38,8408.78,14739.67,0.00
2024-12-10 17:43:56,76,11758,38,38,8670.85,14740.00,0.00
2024-12-10 17:43:56,77,11758,38,39,8558.24,14740.01,0.00
2024-12-10 17:43:56,77,11759,38,39,8545.44,14741.00,0.00
2024-12-10 17:43:56,78,11759,39,39,8435.89,14741.01,0.00
2024-12-10 17:43:56,77,11759,38,39,8457.47,14741.26,0.00
2024-12-10 17:43:56,78,11758,39,39,8313.26,14741.53,0.00
2024-12-10 17:43:56,78,11759,39,39,8491.27,14742.00,0.00
2024-12-10 17:43:56,79,11759,39,40,8383.79,14742.01,0.00
2024-12-10 17:43:56,78,11759,38,40,8353.63,14742.68,0.00
2024-12-10 17:43:56,78,11760,38,40,8625.47,14743.00,0.00
2024-12-10 17:43:56,79,11760,39,40,8516.29,14743.01,0.00
2024-12-10 17:43:56,78,11760,39,39,8587.68,14743.03,0.00
2024-12-10 17:43:56,79,11759,39,40,8378.55,14743.73,0.00
2024-12-10 17:43:56,79,11760,39,40,8481.41,14744.00,0.00
2024-12-10 17:43:56,80,11760,39,41,8375.39,14744.01,0.00
2024-12-10 17:43:56,79,11760,39,40,8444.09,14744.03,0.00
2024-12-10 17:43:56,79,11761,39,40,8599.57,14745.00,0.00
2024-12-10 17:43:56,80,11761,40,40,8492.08,14745.01,0.00
2024-12-10 17:43:56,79,11761,40,39,8560.38,14745.03,0.00
2024-12-10 17:43:56,78,11761,39,39,8647.49,14745.18,0.00
2024-12-10 17:43:56,78,11762,39,39,8640.46,14746.00,0.00
2024-12-10 17:43:56,79,11762,39,40,8531.09,14746.01,0.00
2024-12-10 17:43:56,78,11762,39,39,8600.77,14746.03,0.00
2024-12-10 17:43:56,78,11763,39,39,8571.09,14747.00,0.00
2024-12-10 17:43:56,79,11763,40,39,8462.60,14747.01,0.00
2024-12-10 17:43:56,78,11763,40,38,8531.40,14747.03,0.00
2024-12-10 17:43:56,77,11763,39,38,8623.56,14747.14,0.00
2024-12-10 17:43:56,77,11764,39,38,8612.61,14748.00,0.00
2024-12-10 17:43:56,78,11764,39,39,8502.19,14748.01,0.00
2024-12-10 17:43:56,77,11764,38,39,8459.76,14748.74,0.00
2024-12-10 17:43:56,77,11765,38,39,8613.19,14749.00,0.00
2024-12-10 17:43:56,78,11765,39,39,8502.77,14749.01,0.00
2024-12-10 17:43:56,77,11765,39,38,8607.45,14749.03,0.00
2024-12-10 17:43:56,76,11765,38,38,8701.35,14749.16,0.00
2024-12-10 17:43:56,75,11765,37,38,8815.40,14749.16,0.00
2024-12-10 17:43:56,75,11766,37,38,8810.05,14750.00,0.00
2024-12-10 17:43:56,76,11766,38,38,8694.13,14750.01,0.00
2024-12-10 17:43:56,76,11767,38,38,8626.78,14751.00,0.00
2024-12-10 17:43:56,77,11767,38,39,8514.75,14751.01,0.00
2024-12-10 17:43:56,76,11767,38,38,8622.91,14751.03,0.00
2024-12-10 17:43:56,76,11768,38,38,8596.31,14752.00,0.00
2024-12-10 17:43:56,77,11768,38,39,8484.67,14752.01,0.00
2024-12-10 17:43:56,76,11768,38,38,8553.61,14752.03,0.00
2024-12-10 17:43:56,76,11769,38,38,8527.01,14753.00,0.00
2024-12-10 17:43:56,77,11769,38,39,8416.27,14753.01,0.00
2024-12-10 17:43:56,76,11769,38,38,8484.31,14753.03,0.00
2024-12-10 17:43:56,76,11770,38,38,8457.70,14754.00,0.00
2024-12-10 17:43:56,77,11770,39,38,8347.86,14754.01,0.00
2024-12-10 17:43:56,76,11770,39,37,8415.00,14754.03,0.00
2024-12-10 17:43:56,76,11771,39,37,8388.38,14755.00,0.00
2024-12-10 17:43:56,77,11771,39,38,8279.44,14755.01,0.00
2024-12-10 17:43:56,76,11771,38,38,8248.94,14755.70,0.00
2024-12-10 17:43:56,76,11772,38,38,8320.99,14756.00,0.00
2024-12-10 17:43:56,77,11772,38,39,8212.93,14756.01,0.00
2024-12-10 17:43:56,76,11772,38,38,8317.12,14756.03,0.00
2024-12-10 17:43:56,76,11773,38,38,8290.49,14757.00,0.00
2024-12-10 17:43:56,77,11773,39,38,8182.82,14757.01,0.00
2024-12-10 17:43:56,76,11773,39,37,8247.78,14757.03,0.00
2024-12-10 17:43:56,76,11774,39,37,8221.15,14758.00,0.00
2024-12-10 17:43:56,77,11774,39,38,8114.38,14758.01,0.00
2024-12-10 17:43:56,77,11775,39,38,8045.92,14759.00,0.00
2024-12-10 17:43:56,78,11775,39,39,7942.77,14759.01,0.00
2024-12-10 17:43:56,77,11775,39,38,8040.18,14759.03,0.00
2024-12-10 17:43:56,76,11775,38,38,8122.72,14759.17,0.00
2024-12-10 17:43:56,76,11776,38,38,8117.39,14760.00,0.00
2024-12-10 17:43:56,77,11776,38,39,8011.97,14760.01,0.00
2024-12-10 17:43:56,77,11777,38,39,7996.85,14761.00,0.00
2024-12-10 17:43:56,78,11777,39,39,7894.32,14761.01,0.00
2024-12-10 17:43:56,78,11778,39,39,7859.31,14762.00,0.00
2024-12-10 17:43:56,79,11778,39,40,7759.82,14762.01,0.00
2024-12-10 17:43:56,79,11779,39,40,7697.14,14763.00,0.00
2024-12-10 17:43:56,80,11779,39,41,7600.93,14763.01,0.00
2024-12-10 17:43:56,79,11779,39,40,7678.46,14763.03,0.00
2024-12-10 17:43:56,78,11779,38,40,7669.35,14763.74,0.00
2024-12-10 17:43:56,78,11780,38,40,7745.25,14764.00,0.00
2024-12-10 17:43:56,79,11780,38,41,7647.21,14764.01,0.00
2024-12-10 17:43:56,78,11780,37,41,7639.35,14764.33,0.00
2024-12-10 17:43:56,78,11781,37,41,7730.63,14765.00,0.00
2024-12-10 17:43:56,79,11781,37,42,7632.77,14765.01,0.00
2024-12-10 17:43:56,78,11781,37,41,7726.85,14765.03,0.00
2024-12-10 17:43:56,77,11781,36,41,7723.70,14765.19,0.00
2024-12-10 17:43:56,77,11782,36,41,7797.04,14766.00,0.00
2024-12-10 17:43:56,78,11782,37,41,7697.08,14766.01,0.00
2024-12-10 17:43:56,77,11782,37,40,7754.85,14766.03,0.00
2024-12-10 17:43:56,76,11782,36,40,7831.68,14766.18,0.00
2024-12-10 17:43:56,75,11782,35,40,7812.26,14766.60,0.00
2024-12-10 17:43:57,75,11783,35,40,7950.37,14767.00,0.00
2024-12-10 17:43:57,76,11783,35,41,7845.76,14767.01,0.00
2024-12-10 17:43:57,75,11783,34,41,7771.43,14767.57,0.00
2024-12-10 17:43:57,75,11784,34,41,7905.62,14768.00,0.00
2024-12-10 17:43:57,76,11784,34,42,7801.60,14768.01,0.00
2024-12-10 17:43:57,75,11784,34,41,7897.75,14768.03,0.00
2024-12-10 17:43:57,75,11785,34,41,7872.68,14769.00,0.00
2024-12-10 17:43:57,76,11785,34,42,7769.09,14769.01,0.00
2024-12-10 17:43:57,75,11785,33,42,7802.24,14769.21,0.00
2024-12-10 17:43:57,74,11785,32,42,7827.90,14769.35,0.00
2024-12-10 17:43:57,74,11786,32,42,7932.10,14770.00,0.00
2024-12-10 17:43:57,75,11786,32,43,7826.34,14770.01,0.00
2024-12-10 17:43:57,74,11786,32,42,7926.12,14770.03,0.00
2024-12-10 17:43:57,73,11786,31,42,7948.56,14770.60,0.00
2024-12-10 17:43:57,72,11786,30,42,7956.47,14770.74,0.00
2024-12-10 17:43:57,72,11787,30,42,8122.84,14771.00,0.00
2024-12-10 17:43:57,73,11787,31,42,8011.57,14771.01,0.00
2024-12-10 17:43:57,72,11787,30,42,7987.58,14771.42,0.00
2024-12-10 17:43:57,72,11788,30,42,8106.97,14772.00,0.00
2024-12-10 17:43:57,73,11788,30,43,7995.92,14772.01,0.00
2024-12-10 17:43:57,72,11788,30,42,8102.87,14772.03,0.00
2024-12-10 17:43:57,72,11789,30,42,8082.90,14773.00,0.00
2024-12-10 17:43:57,73,11789,30,43,7972.18,14773.01,0.00
2024-12-10 17:43:57,73,11790,30,43,7907.95,14774.00,0.00
2024-12-10 17:43:57,74,11790,30,44,7801.09,14774.01,0.00
2024-12-10 17:43:57,73,11790,30,43,7897.84,14774.04,0.00
2024-12-10 17:43:57,72,11790,29,43,7952.22,14774.31,0.00
2024-12-10 17:43:57,71,11790,28,43,7999.96,14774.73,0.00
2024-12-10 17:43:57,71,11791,28,43,8168.72,14775.00,0.00
2024-12-10 17:43:57,72,11791,29,43,8055.27,14775.01,0.00
2024-12-10 17:43:57,72,11792,29,43,7992.19,14776.00,0.00
2024-12-10 17:43:57,73,11792,29,44,7882.71,14776.01,0.00
2024-12-10 17:43:57,72,11792,29,43,7983.99,14776.04,0.00
2024-12-10 17:43:57,72,11793,29,43,7966.05,14777.00,0.00
2024-12-10 17:43:57,73,11793,29,44,7856.93,14777.01,0.00
2024-12-10 17:43:57,72,11793,28,44,7957.85,14777.06,0.00
2024-12-10 17:43:57,71,11793,27,44,7997.15,14777.25,0.00
2024-12-10 17:43:57,71,11794,27,44,8012.19,14778.00,0.00
2024-12-10 17:43:57,72,11794,28,44,7900.91,14778.01,0.00
2024-12-10 17:43:57,71,11794,28,43,7999.71,14778.06,0.00
2024-12-10 17:43:57,72,11793,29,43,7857.89,14778.29,0.00
2024-12-10 17:43:57,71,11793,28,43,7979.31,14778.84,0.00
2024-12-10 17:43:57,71,11794,28,43,8164.69,14779.00,0.00
2024-12-10 17:43:57,72,11794,29,43,8051.29,14779.01,0.00
2024-12-10 17:43:57,73,11793,30,43,7862.12,14779.30,0.00
2024-12-10 17:43:57,73,11794,30,43,8190.57,14780.00,0.00
2024-12-10 17:43:57,74,11794,30,44,8079.88,14780.01,0.00
2024-12-10 17:43:57,73,11794,30,43,8180.45,14780.05,0.00
2024-12-10 17:43:57,73,11795,30,43,8365.26,14781.00,0.00
2024-12-10 17:43:57,74,11795,30,44,8252.21,14781.01,0.00
2024-12-10 17:43:57,75,11794,30,45,8081.12,14781.19,0.00
2024-12-10 17:43:57,75,11795,30,45,8274.17,14782.00,0.00
2024-12-10 17:43:57,76,11795,31,45,8165.30,14782.01,0.00
2024-12-10 17:43:57,75,11795,31,44,8266.29,14782.05,0.00
2024-12-10 17:43:57,74,11795,30,44,8210.72,14782.95,0.00
2024-12-10 17:43:57,74,11796,30,44,8602.30,14783.00,0.00
2024-12-10 17:43:57,75,11796,30,45,8487.60,14783.01,0.00
2024-12-10 17:43:57,74,11796,29,45,8586.45,14783.11,0.00
2024-12-10 17:43:57,74,11797,29,45,8537.32,14784.00,0.00
2024-12-10 17:43:57,75,11797,30,45,8423.49,14784.01,0.00
2024-12-10 17:43:57,74,11797,29,45,8467.42,14784.11,0.00
2024-12-10 17:43:57,73,11797,29,44,8565.18,14784.11,0.00
2024-12-10 17:43:57,73,11798,29,44,8636.62,14785.00,0.00
2024-12-10 17:43:57,74,11798,29,45,8519.91,14785.01,0.00
2024-12-10 17:43:57,74,11799,29,45,8458.25,14786.00,0.00
2024-12-10 17:43:57,75,11799,30,45,8345.48,14786.01,0.00
2024-12-10 17:43:57,74,11799,29,45,8454.26,14786.03,0.00
2024-12-10 17:43:57,73,11799,29,44,8456.67,14786.11,0.00
2024-12-10 17:43:57,72,11799,28,44,8559.79,14786.19,0.00
2024-12-10 17:43:57,71,11799,27,44,8613.57,14786.65,0.00
2024-12-10 17:43:57,71,11800,27,44,8770.05,14787.00,0.00
2024-12-10 17:43:57,72,11800,28,44,8648.24,14787.01,0.00
2024-12-10 17:43:57,72,11801,28,44,8585.16,14788.00,0.00
2024-12-10 17:43:57,73,11801,29,44,8467.56,14788.01,0.00
2024-12-10 17:43:57,72,11801,29,43,8552.32,14788.11,0.00
2024-12-10 17:43:57,72,11802,29,43,8544.66,14789.00,0.00
2024-12-10 17:43:57,73,11802,29,44,8427.61,14789.01,0.00
2024-12-10 17:43:57,72,11802,28,44,8474.89,14789.21,0.00
2024-12-10 17:43:57,73,11801,29,44,8308.31,14789.58,0.00
2024-12-10 17:43:57,73,11802,29,44,8511.25,14790.00,0.00
2024-12-10 17:43:57,74,11802,30,44,8396.23,14790.01,0.00
2024-12-10 17:43:57,73,11802,30,43,8480.88,14790.11,0.00
2024-12-10 17:43:57,74,11801,31,43,8290.59,14790.65,0.00
2024-12-10 17:43:57,74,11802,31,43,8606.67,14791.00,0.00
2024-12-10 17:43:57,75,11802,32,43,8491.91,14791.01,0.00
2024-12-10 17:43:57,75,11803,32,43,8625.28,14792.00,0.00
2024-12-10 17:43:57,76,11803,33,43,8511.79,14792.01,0.00
2024-12-10 17:43:57,75,11803,33,42,8593.74,14792.11,0.00
2024-12-10 17:43:57,74,11803,32,42,8695.67,14792.20,0.00
2024-12-10 17:43:57,74,11804,32,42,8698.19,14793.00,0.00
2024-12-10 17:43:57,75,11804,32,43,8582.21,14793.01,0.00
2024-12-10 17:43:57,75,11805,32,43,8574.61,14794.00,0.00
2024-12-10 17:43:57,76,11805,33,43,8461.78,14794.01,0.00
2024-12-10 17:43:58,76,11806,33,43,8441.47,14795.00,0.00
2024-12-10 17:43:58,77,11806,34,43,8331.84,14795.01,0.00
2024-12-10 17:43:58,77,11807,34,43,8285.25,14796.00,0.00
2024-12-10 17:43:58,78,11807,35,43,8179.03,14796.01,0.00
2024-12-10 17:43:58,77,11807,34,43,8277.64,14796.05,0.00
2024-12-10 17:43:58,76,11807,33,43,8320.43,14796.22,0.00
2024-12-10 17:43:58,77,11806,34,43,8137.71,14796.75,0.00
2024-12-10 17:43:58,77,11807,34,43,8247.45,14797.00,0.00
2024-12-10 17:43:58,78,11807,35,43,8141.72,14797.01,0.00
2024-12-10 17:43:58,77,11807,34,43,8245.53,14797.01,0.00
2024-12-10 17:43:58,76,11807,33,43,8352.08,14797.01,0.00
2024-12-10 17:43:58,75,11807,33,42,8449.65,14797.08,0.00
2024-12-10 17:43:58,75,11808,33,42,8629.75,14798.00,0.00
2024-12-10 17:43:58,76,11808,34,42,8516.20,14798.01,0.00
2024-12-10 17:43:58,76,11809,34,42,8506.20,14799.00,0.00
2024-12-10 17:43:58,77,11809,34,43,8395.73,14799.01,0.00
2024-12-10 17:43:58,76,11809,33,43,8370.21,14799.67,0.00
2024-12-10 17:43:58,76,11810,33,43,8482.97,14800.00,0.00
2024-12-10 17:43:58,77,11810,34,43,8372.80,14800.01,0.00
2024-12-10 17:43:58,76,11810,33,43,8416.17,14800.20,0.00
2024-12-10 17:43:58,77,11809,34,43,8199.69,14800.95,0.00
2024-12-10 17:43:58,77,11810,34,43,8403.86,14801.00,0.00
2024-12-10 17:43:58,78,11810,35,43,8296.12,14801.01,0.00
2024-12-10 17:43:58,77,11810,35,42,8357.74,14801.08,0.00
2024-12-10 17:43:58,78,11809,35,43,8129.63,14801.92,0.00
2024-12-10 17:43:58,78,11810,35,43,8421.93,14802.00,0.00
2024-12-10 17:43:58,79,11810,36,43,8315.32,14802.01,0.00
2024-12-10 17:43:58,79,11811,36,43,8432.06,14803.00,0.00
2024-12-10 17:43:58,80,11811,36,44,8326.66,14803.01,0.00
2024-12-10 17:43:58,79,11811,35,44,8424.85,14803.05,0.00
2024-12-10 17:43:58,78,11811,35,43,8513.90,14803.09,0.00
2024-12-10 17:43:58,79,11810,36,43,8331.42,14803.62,0.00
2024-12-10 17:43:58,79,11811,36,43,8556.35,14804.00,0.00
2024-12-10 17:43:58,80,11811,37,43,8449.40,14804.01,0.00
2024-12-10 17:43:58,80,11812,37,43,8562.86,14805.00,0.00
2024-12-10 17:43:58,81,11812,37,44,8457.15,14805.01,0.00
2024-12-10 17:43:58,80,11812,37,43,8540.67,14805.09,0.00
2024-12-10 17:43:58,80,11813,37,43,8517.17,14806.00,0.00
2024-12-10 17:43:58,81,11813,37,44,8412.02,14806.01,0.00
2024-12-10 17:43:58,80,11813,36,44,8450.60,14806.21,0.00
2024-12-10 17:43:58,79,11813,35,44,8469.62,14806.48,0.00
2024-12-10 17:43:58,79,11814,35,44,8580.58,14807.00,0.00
2024-12-10 17:43:58,80,11814,36,44,8473.32,14807.01,0.00
2024-12-10 17:43:58,79,11814,36,43,8556.23,14807.10,0.00
2024-12-10 17:43:58,79,11815,36,43,8536.17,14808.00,0.00
2024-12-10 17:43:58,80,11815,36,44,8429.47,14808.01,0.00
2024-12-10 17:43:58,80,11816,36,44,8357.85,14809.00,0.00
2024-12-10 17:43:58,81,11816,36,45,8254.66,14809.01,0.00
2024-12-10 17:43:58,80,11816,36,44,8335.65,14809.10,0.00
2024-12-10 17:43:58,79,11816,35,44,8420.59,14809.23,0.00
2024-12-10 17:43:58,79,11817,35,44,8419.22,14810.00,0.00
2024-12-10 17:43:58,80,11817,35,45,8313.98,14810.01,0.00
2024-12-10 17:43:58,79,11817,34,45,8282.42,14810.20,0.00
2024-12-10 17:43:58,79,11818,34,45,8352.30,14811.00,0.00
2024-12-10 17:43:58,80,11818,35,45,8247.89,14811.01,0.00
2024-12-10 17:43:58,79,11818,34,45,8286.69,14811.10,0.00
2024-12-10 17:43:58,78,11818,34,44,8375.85,14811.10,0.00
2024-12-10 17:43:58,78,11819,34,44,8433.23,14812.00,0.00
2024-12-10 17:43:58,79,11819,35,44,8326.48,14812.01,0.00
2024-12-10 17:43:58,78,11819,34,44,8425.62,14812.05,0.00
2024-12-10 17:43:58,78,11820,34,44,8437.58,14813.00,0.00
2024-12-10 17:43:58,79,11820,35,44,8330.78,14813.01,0.00
2024-12-10 17:43:58,78,11820,35,43,8411.01,14813.09,0.00
2024-12-10 17:43:58,78,11821,35,43,8390.67,14814.00,0.00
2024-12-10 17:43:58,79,11821,36,43,8284.46,14814.01,0.00
2024-12-10 17:43:58,78,11821,36,42,8347.00,14814.08,0.00
2024-12-10 17:43:58,77,11821,35,42,8315.22,14814.58,0.00
2024-12-10 17:43:58,77,11822,35,42,8446.34,14815.00,0.00
2024-12-10 17:43:58,78,11822,35,43,8338.05,14815.01,0.00
2024-12-10 17:43:58,78,11823,35,43,8268.33,14816.00,0.00
2024-12-10 17:43:58,79,11823,35,44,8163.67,14816.01,0.00
2024-12-10 17:43:58,78,11823,35,43,8247.45,14816.05,0.00
2024-12-10 17:43:58,77,11823,34,43,8260.59,14816.69,0.00
2024-12-10 17:43:58,78,11822,35,43,8130.11,14816.87,0.00
2024-12-10 17:43:58,78,11823,35,43,8244.20,14817.00,0.00
2024-12-10 17:43:58,79,11823,36,43,8139.84,14817.01,0.00
2024-12-10 17:43:58,80,11822,36,44,7932.72,14817.50,0.00
2024-12-10 17:43:58,80,11823,36,44,8220.15,14818.00,0.00
2024-12-10 17:43:58,81,11823,36,45,8118.67,14818.01,0.00
2024-12-10 17:43:58,80,11823,36,44,8201.64,14818.08,0.00
2024-12-10 17:43:58,80,11824,36,44,8361.49,14819.00,0.00
2024-12-10 17:43:58,81,11824,37,44,8258.26,14819.01,0.00
2024-12-10 17:43:58,80,11824,36,44,8239.37,14819.38,0.00
2024-12-10 17:43:58,80,11825,36,44,8332.41,14820.00,0.00
2024-12-10 17:43:58,81,11825,37,44,8229.55,14820.01,0.00
2024-12-10 17:43:58,80,11825,37,43,8315.75,14820.08,0.00
2024-12-10 17:43:58,81,11824,38,43,8145.62,14820.56,0.00
2024-12-10 17:43:58,81,11825,38,43,8244.74,14821.00,0.00
2024-12-10 17:43:58,82,11825,38,44,8144.19,14821.01,0.00
2024-12-10 17:43:58,81,11825,37,44,8053.09,14821.89,0.00
2024-12-10 17:43:58,81,11826,37,44,8402.66,14822.00,0.00
2024-12-10 17:43:58,82,11826,37,45,8300.19,14822.01,0.00
2024-12-10 17:43:59,82,11827,37,45,8226.64,14823.00,0.00
2024-12-10 17:43:59,83,11827,37,46,8127.52,14823.01,0.00
2024-12-10 17:43:59,82,11827,37,45,8208.57,14823.08,0.00
2024-12-10 17:43:59,82,11828,37,45,8181.88,14824.00,0.00
2024-12-10 17:43:59,83,11828,37,46,8083.30,14824.01,0.00
2024-12-10 17:43:59,82,11828,37,45,8171.03,14824.07,0.00
2024-12-10 17:43:59,81,11828,36,45,8111.09,14824.56,0.00
2024-12-10 17:43:59,81,11829,36,45,8228.54,14825.00,0.00
2024-12-10 17:43:59,82,11829,36,46,8128.19,14825.01,0.00
2024-12-10 17:43:59,81,11829,36,45,8212.08,14825.07,0.00
2024-12-10 17:43:59,80,11829,35,45,8196.35,14825.54,0.00
2024-12-10 17:43:59,80,11830,35,45,8313.43,14826.00,0.00
2024-12-10 17:43:59,81,11830,36,45,8210.79,14826.01,0.00
2024-12-10 17:43:59,80,11830,35,45,8100.63,14826.71,0.00
2024-12-10 17:43:59,80,11831,35,45,8243.56,14827.00,0.00
2024-12-10 17:43:59,81,11831,36,45,8141.79,14827.01,0.00
2024-12-10 17:43:59,80,11831,35,45,8241.70,14827.01,0.00
2024-12-10 17:43:59,79,11831,34,45,8340.40,14827.04,0.00
2024-12-10 17:43:59,78,11831,34,44,8435.93,14827.05,0.00
2024-12-10 17:43:59,79,11830,34,45,8258.05,14827.56,0.00
2024-12-10 17:43:59,78,11830,33,45,8384.95,14827.73,0.00
2024-12-10 17:43:59,78,11831,33,45,8459.31,14828.00,0.00
2024-12-10 17:43:59,79,11831,34,45,8352.23,14828.01,0.00
2024-12-10 17:43:59,79,11832,34,45,8469.17,14829.00,0.00
2024-12-10 17:43:59,80,11832,34,46,8363.30,14829.01,0.00
2024-12-10 17:43:59,79,11832,34,45,8456.03,14829.05,0.00
2024-12-10 17:43:59,79,11833,34,45,8428.44,14830.00,0.00
2024-12-10 17:43:59,80,11833,35,45,8323.09,14830.01,0.00
2024-12-10 17:43:59,79,11833,34,45,8426.56,14830.01,0.00
2024-12-10 17:43:59,78,11833,33,45,8325.98,14830.95,0.00
2024-12-10 17:43:59,78,11834,33,45,8508.55,14831.00,0.00
2024-12-10 17:43:59,79,11834,33,46,8400.85,14831.01,0.00
2024-12-10 17:43:59,78,11834,33,45,8499.05,14831.04,0.00
2024-12-10 17:43:59,78,11835,33,45,8470.92,14832.00,0.00
2024-12-10 17:43:59,79,11835,33,46,8363.70,14832.01,0.00
2024-12-10 17:43:59,79,11836,33,46,8291.57,14833.00,0.00
2024-12-10 17:43:59,80,11836,33,47,8187.93,14833.01,0.00
2024-12-10 17:43:59,79,11836,33,46,8282.19,14833.04,0.00
2024-12-10 17:43:59,80,11835,34,46,8097.67,14833.60,0.00
2024-12-10 17:43:59,79,11835,33,46,8241.57,14833.72,0.00
2024-12-10 17:43:59,78,11835,32,46,8277.06,14833.97,0.00
2024-12-10 17:43:59,78,11836,32,46,8463.45,14834.00,0.00
2024-12-10 17:43:59,79,11836,33,46,8356.32,14834.01,0.00
2024-12-10 17:43:59,80,11835,34,46,8161.15,14834.40,0.00
2024-12-10 17:43:59,80,11836,34,46,8454.34,14835.00,0.00
2024-12-10 17:43:59,81,11836,35,46,8349.96,14835.01,0.00
2024-12-10 17:43:59,80,11836,35,45,8446.92,14835.04,0.00
2024-12-10 17:43:59,79,11836,34,45,8396.39,14835.91,0.00
2024-12-10 17:43:59,79,11837,34,45,8758.90,14836.00,0.00
2024-12-10 17:43:59,80,11837,35,45,8649.41,14836.01,0.00
2024-12-10 17:43:59,81,11836,36,45,8469.44,14836.28,0.00
2024-12-10 17:43:59,81,11837,36,45,8562.68,14837.00,0.00
2024-12-10 17:43:59,82,11837,36,46,8458.26,14837.01,0.00
2024-12-10 17:43:59,81,11837,36,45,8553.53,14837.05,0.00
2024-12-10 17:43:59,81,11838,36,45,8704.86,14838.00,0.00
2024-12-10 17:43:59,82,11838,36,46,8598.71,14838.01,0.00
2024-12-10 17:43:59,81,11838,35,46,8490.88,14838.72,0.00
2024-12-10 17:43:59,81,11839,35,46,8632.17,14839.00,0.00
2024-12-10 17:43:59,82,11839,36,46,8526.90,14839.01,0.00
2024-12-10 17:43:59,81,11839,36,45,8624.85,14839.05,0.00
2024-12-10 17:43:59,81,11840,36,45,8594.28,14840.00,0.00
2024-12-10 17:43:59,82,11840,37,45,8489.47,14840.01,0.00
2024-12-10 17:43:59,81,11840,37,44,8550.31,14840.05,0.00
2024-12-10 17:43:59,80,11840,36,44,8542.40,14840.54,0.00
2024-12-10 17:43:59,80,11841,36,44,8659.62,14841.00,0.00
2024-12-10 17:43:59,81,11841,36,45,8552.72,14841.01,0.00
2024-12-10 17:43:59,80,11841,35,45,8657.77,14841.01,0.00
2024-12-10 17:43:59,79,11841,34,45,8765.48,14841.01,0.00
2024-12-10 17:43:59,79,11842,34,45,8694.08,14842.00,0.00
2024-12-10 17:43:59,80,11842,35,45,8585.40,14842.01,0.00
2024-12-10 17:43:59,79,11842,35,44,8690.33,14842.03,0.00
2024-12-10 17:43:59,78,11842,34,44,8735.28,14842.36,0.00
2024-12-10 17:43:59,79,11841,34,45,8533.01,14842.99,0.00
2024-12-10 17:43:59,79,11842,34,45,8720.91,14843.00,0.00
2024-12-10 17:43:59,80,11842,35,45,8611.90,14843.01,0.00
2024-12-10 17:43:59,79,11842,34,45,8649.60,14843.24,0.00
2024-12-10 17:43:59,79,11843,34,45,8835.30,14844.00,0.00
2024-12-10 17:43:59,80,11843,34,46,8724.86,14844.01,0.00
2024-12-10 17:43:59,79,11843,34,45,8829.68,14844.04,0.00
2024-12-10 17:43:59,78,11843,33,45,8910.60,14844.24,0.00
2024-12-10 17:43:59,78,11844,33,45,8909.74,14845.00,0.00
2024-12-10 17:43:59,79,11844,34,45,8796.96,14845.01,0.00
2024-12-10 17:43:59,80,11843,35,45,8570.75,14845.55,0.00
2024-12-10 17:43:59,80,11844,35,45,8698.15,14846.00,0.00
2024-12-10 17:43:59,81,11844,35,46,8590.76,14846.01,0.00
2024-12-10 17:43:59,81,11845,35,46,8698.12,14847.00,0.00
2024-12-10 17:43:59,82,11845,35,47,8592.04,14847.01,0.00
2024-12-10 17:43:59,81,11845,35,46,8687.13,14847.04,0.00
2024-12-10 17:43:59,82,11844,36,46,8466.76,14847.82,0.00
2024-12-10 17:43:59,82,11845,36,46,8570.12,14848.00,0.00
2024-12-10 17:43:59,83,11845,37,46,8466.86,14848.01,0.00
2024-12-10 17:43:59,82,11845,37,45,8530.29,14848.04,0.00
2024-12-10 17:43:59,81,11845,36,45,8604.52,14848.23,0.00
2024-12-10 17:43:59,80,11845,35,45,8693.34,14848.34,0.00
2024-12-10 17:43:59,80,11846,35,45,8966.65,14849.00,0.00
2024-12-10 17:43:59,81,11846,35,46,8855.95,14849.01,0.00
2024-12-10 17:43:59,80,11846,35,45,8925.82,14849.04,0.00
2024-12-10 17:43:59,80,11847,35,45,8893.34,14850.00,0.00
2024-12-10 17:43:59,81,11847,35,46,8783.55,14850.01,0.00
2024-12-10 17:43:59,80,11847,35,45,8852.51,14850.04,0.00
2024-12-10 17:43:59,79,11847,34,45,8932.70,14850.24,0.00
2024-12-10 17:43:59,79,11848,34,45,8930.43,14851.00,0.00
2024-12-10 17:43:59,80,11848,34,46,8818.80,14851.01,0.00
2024-12-10 17:43:59,79,11848,34,45,8889.08,14851.04,0.00
2024-12-10 17:44:00,78,11848,33,45,8896.12,14851.46,0.00
2024-12-10 17:44:00,78,11849,33,45,9004.58,14852.00,0.00
2024-12-10 17:44:00,79,11849,33,46,8890.60,14852.01,0.00
2024-12-10 17:44:00,78,11849,33,45,8960.79,14852.04,0.00
2024-12-10 17:44:00,78,11850,33,45,8929.86,14853.00,0.00
2024-12-10 17:44:00,79,11850,34,45,8816.83,14853.01,0.00
2024-12-10 17:44:00,78,11850,34,44,8886.07,14853.04,0.00
2024-12-10 17:44:00,78,11851,34,44,8856.31,14854.00,0.00
2024-12-10 17:44:00,79,11851,34,45,8744.21,14854.01,0.00
2024-12-10 17:44:00,78,11851,34,44,8812.52,14854.04,0.00
2024-12-10 17:44:00,77,11851,33,44,8901.50,14854.21,0.00
2024-12-10 17:44:00,77,11852,33,44,8896.81,14855.00,0.00
2024-12-10 17:44:00,78,11852,34,44,8782.75,14855.01,0.00
2024-12-10 17:44:00,79,11851,34,45,8624.58,14855.10,0.00
2024-12-10 17:44:00,78,11851,33,45,8602.18,14855.71,0.00
2024-12-10 17:44:00,78,11852,33,45,8743.55,14856.00,0.00
2024-12-10 17:44:00,79,11852,34,45,8632.87,14856.01,0.00
2024-12-10 17:44:00,78,11852,34,44,8737.84,14856.04,0.00
2024-12-10 17:44:00,77,11852,33,44,8737.70,14856.48,0.00
2024-12-10 17:44:00,77,11853,33,44,9044.87,14857.00,0.00
2024-12-10 17:44:00,78,11853,34,44,8928.91,14857.01,0.00
2024-12-10 17:44:00,77,11853,34,43,9000.50,14857.04,0.00
2024-12-10 17:44:00,78,11852,35,43,8885.11,14857.06,0.00
2024-12-10 17:44:00,77,11852,34,43,9025.75,14857.39,0.00
2024-12-10 17:44:00,78,11851,34,44,8868.31,14857.69,0.00
2024-12-10 17:44:00,78,11852,34,44,9050.10,14858.00,0.00
2024-12-10 17:44:00,79,11852,34,45,8935.54,14858.01,0.00
2024-12-10 17:44:00,79,11853,34,45,9234.70,14859.00,0.00
2024-12-10 17:44:00,80,11853,34,46,9119.26,14859.01,0.00
2024-12-10 17:44:00,79,11853,34,45,9223.44,14859.06,0.00
2024-12-10 17:44:00,79,11854,34,45,9186.35,14860.00,0.00
2024-12-10 17:44:00,80,11854,34,46,9071.52,14860.01,0.00
2024-12-10 17:44:00,81,11853,34,47,8849.69,14860.53,0.00
2024-12-10 17:44:00,80,11853,33,47,8968.13,14860.83,0.00
2024-12-10 17:44:00,80,11854,33,47,9128.04,14861.00,0.00
2024-12-10 17:44:00,81,11854,33,48,9015.34,14861.01,0.00
2024-12-10 17:44:00,80,11854,33,47,9118.27,14861.06,0.00
2024-12-10 17:44:00,79,11854,32,47,9213.06,14861.20,0.00
2024-12-10 17:44:00,79,11855,32,47,9367.66,14862.00,0.00
2024-12-10 17:44:00,80,11855,33,47,9250.56,14862.01,0.00
2024-12-10 17:44:00,80,11856,33,47,9181.63,14863.00,0.00
2024-12-10 17:44:00,81,11856,34,47,9068.28,14863.01,0.00
2024-12-10 17:44:00,80,11856,34,46,9177.92,14863.03,0.00
2024-12-10 17:44:00,80,11857,34,46,9085.39,14864.00,0.00
2024-12-10 17:44:00,81,11857,35,46,8973.22,14864.01,0.00
2024-12-10 17:44:00,80,11857,35,45,9053.83,14864.05,0.00
2024-12-10 17:44:00,80,11858,35,45,8998.10,14865.00,0.00
2024-12-10 17:44:00,81,11858,36,45,8887.02,14865.01,0.00
2024-12-10 17:44:00,80,11858,36,44,8957.25,14865.05,0.00
2024-12-10 17:44:00,79,11858,35,44,8878.89,14865.70,0.00
2024-12-10 17:44:00,79,11859,35,44,9021.31,14866.00,0.00
2024-12-10 17:44:00,80,11859,36,44,8908.54,14866.01,0.00
2024-12-10 17:44:00,79,11859,36,43,8978.05,14866.05,0.00
2024-12-10 17:44:00,79,11860,36,43,8936.42,14867.00,0.00
2024-12-10 17:44:00,80,11860,37,43,8824.71,14867.01,0.00
2024-12-10 17:44:00,80,11861,37,43,8737.09,14868.00,0.00
2024-12-10 17:44:00,81,11861,37,44,8629.22,14868.01,0.00
2024-12-10 17:44:00,80,11861,37,43,8725.97,14868.06,0.00
2024-12-10 17:44:00,80,11862,37,43,8676.53,14869.00,0.00
2024-12-10 17:44:00,81,11862,38,43,8569.41,14869.01,0.00
2024-12-10 17:44:00,81,11863,38,43,8466.55,14870.00,0.00
2024-12-10 17:44:00,82,11863,38,44,8363.30,14870.01,0.00
2024-12-10 17:44:00,81,11863,38,43,8450.07,14870.07,0.00
2024-12-10 17:44:00,81,11864,38,43,8396.96,14871.00,0.00
2024-12-10 17:44:00,82,11864,39,43,8294.55,14871.01,0.00
2024-12-10 17:44:00,82,11865,39,43,8198.89,14872.00,0.00
2024-12-10 17:44:00,83,11865,40,43,8100.11,14872.01,0.00
2024-12-10 17:44:00,82,11865,40,42,8165.56,14872.11,0.00
2024-12-10 17:44:00,82,11866,40,42,8132.15,14873.00,0.00
2024-12-10 17:44:00,83,11866,41,42,8034.17,14873.01,0.00
2024-12-10 17:44:00,82,11866,40,42,7977.11,14873.57,0.00
2024-12-10 17:44:00,82,11867,40,42,8095.31,14874.00,0.00
2024-12-10 17:44:00,83,11867,40,43,7997.78,14874.01,0.00
2024-12-10 17:44:00,83,11868,40,43,7937.62,14875.00,0.00
2024-12-10 17:44:00,84,11868,41,43,7843.13,14875.01,0.00
2024-12-10 17:44:00,83,11868,41,42,7882.18,14875.13,0.00
2024-12-10 17:44:00,82,11868,40,42,7910.52,14875.44,0.00
2024-12-10 17:44:00,82,11869,40,42,8008.85,14876.00,0.00
2024-12-10 17:44:00,83,11869,40,43,7912.36,14876.01,0.00
2024-12-10 17:44:00,82,11869,39,43,7931.73,14876.24,0.00
2024-12-10 17:44:00,81,11869,38,43,7938.10,14876.52,0.00
2024-12-10 17:44:00,81,11870,38,43,8050.47,14877.00,0.00
2024-12-10 17:44:00,82,11870,39,43,7952.29,14877.01,0.00
2024-12-10 17:44:00,81,11870,39,42,8014.61,14877.14,0.00
2024-12-10 17:44:00,80,11870,38,42,8090.67,14877.26,0.00
2024-12-10 17:44:00,79,11870,38,41,8178.06,14877.35,0.00
2024-12-10 17:44:00,79,11871,38,41,8270.77,14878.00,0.00
2024-12-10 17:44:00,80,11871,39,41,8167.38,14878.01,0.00
2024-12-10 17:44:00,81,11870,40,41,7833.95,14878.94,0.00
2024-12-10 17:44:00,81,11871,40,41,8017.70,14879.00,0.00
2024-12-10 17:44:00,82,11871,40,42,7919.92,14879.01,0.00
2024-12-10 17:44:00,81,11871,40,41,7964.47,14879.15,0.00
2024-12-10 17:44:00,82,11870,40,42,7811.26,14879.55,0.00
2024-12-10 17:44:00,82,11871,40,42,8092.85,14880.00,0.00
2024-12-10 17:44:00,83,11871,41,42,7995.34,14880.01,0.00
2024-12-10 17:44:00,82,11871,40,42,7954.64,14880.45,0.00
2024-12-10 17:44:01,82,11872,40,42,8236.29,14881.00,0.00
2024-12-10 17:44:01,83,11872,41,42,8137.06,14881.01,0.00
2024-12-10 17:44:01,82,11872,41,41,8205.48,14881.15,0.00
2024-12-10 17:44:01,82,11873,41,41,8187.85,14882.00,0.00
2024-12-10 17:44:01,83,11873,42,41,8089.20,14882.01,0.00
2024-12-10 17:44:01,82,11873,41,41,8129.80,14882.13,0.00
2024-12-10 17:44:01,83,11872,41,42,7942.36,14882.52,0.00
2024-12-10 17:44:01,83,11873,41,42,8111.26,14883.00,0.00
2024-12-10 17:44:01,84,11873,41,43,8014.69,14883.01,0.00
2024-12-10 17:44:01,83,11873,41,42,8082.60,14883.13,0.00
2024-12-10 17:44:01,83,11874,41,42,8240.50,14884.00,0.00
2024-12-10 17:44:01,84,11874,42,42,8142.40,14884.01,0.00
2024-12-10 17:44:01,83,11874,41,42,8192.10,14884.12,0.00
2024-12-10 17:44:01,84,11873,42,42,8023.80,14884.38,0.00
2024-12-10 17:44:01,84,11874,42,42,8153.65,14885.00,0.00
2024-12-10 17:44:01,85,11874,42,43,8057.72,14885.01,0.00
2024-12-10 17:44:01,84,11874,42,42,8128.87,14885.12,0.00
2024-12-10 17:44:01,84,11875,42,42,8278.79,14886.00,0.00
2024-12-10 17:44:01,85,11875,43,42,8181.39,14886.01,0.00
2024-12-10 17:44:01,84,11875,42,42,8263.30,14886.11,0.00
2024-12-10 17:44:01,84,11876,42,42,8240.11,14887.00,0.00
2024-12-10 17:44:01,85,11876,42,43,8143.17,14887.01,0.00
2024-12-10 17:44:01,86,11875,42,44,7931.01,14887.59,0.00
2024-12-10 17:44:01,86,11876,42,44,8107.64,14888.00,0.00
2024-12-10 17:44:01,87,11876,43,44,8014.45,14888.01,0.00
2024-12-10 17:44:01,86,11876,42,44,8095.04,14888.09,0.00
2024-12-10 17:44:01,85,11876,42,43,8158.75,14888.09,0.00
2024-12-10 17:44:01,85,11877,42,43,8304.66,14889.00,0.00
2024-12-10 17:44:01,86,11877,43,43,8208.10,14889.01,0.00
2024-12-10 17:44:01,85,11877,42,43,8302.91,14889.01,0.00
2024-12-10 17:44:01,85,11878,42,43,8226.39,14890.00,0.00
2024-12-10 17:44:01,86,11878,42,44,8130.74,14890.01,0.00
2024-12-10 17:44:01,85,11878,42,43,8205.39,14890.08,0.00
2024-12-10 17:44:01,84,11878,41,43,8211.20,14890.70,0.00
2024-12-10 17:44:01,84,11879,41,43,8273.48,14891.00,0.00
2024-12-10 17:44:01,85,11879,42,43,8176.14,14891.01,0.00
2024-12-10 17:44:01,84,11879,41,43,8130.06,14891.46,0.00
2024-12-10 17:44:01,84,11880,41,43,8227.94,14892.00,0.00
2024-12-10 17:44:01,85,11880,41,44,8131.14,14892.01,0.00
2024-12-10 17:44:01,84,11880,41,43,8208.45,14892.08,0.00
2024-12-10 17:44:01,84,11881,41,43,8178.20,14893.00,0.00
2024-12-10 17:44:01,85,11881,42,43,8081.99,14893.01,0.00
2024-12-10 17:44:01,84,11881,41,43,7993.74,14893.61,0.00
2024-12-10 17:44:01,84,11882,41,43,8112.82,14894.00,0.00
2024-12-10 17:44:01,85,11882,42,43,8017.37,14894.01,0.00
2024-12-10 17:44:01,84,11882,42,42,8095.10,14894.08,0.00
2024-12-10 17:44:01,84,11882,42,42,8058.69,14895.00,0.00
2024-12-10 17:44:01,85,11882,42,43,7963.88,14895.01,0.00
2024-12-10 17:44:01,84,11882,41,43,7923.41,14895.63,0.00
2024-12-10 17:44:01,84,11883,41,43,7975.10,14896.00,0.00
2024-12-10 17:44:01,85,11883,42,43,7881.28,14896.01,0.00
2024-12-10 17:44:01,84,11883,41,43,7964.48,14896.07,0.00
2024-12-10 17:44:01,83,11883,41,42,8055.05,14896.07,0.00
2024-12-10 17:44:01,82,11883,40,42,8033.43,14896.78,0.00
2024-12-10 17:44:01,83,11882,41,42,7927.71,14896.86,0.00
2024-12-10 17:44:01,83,11883,41,42,8105.51,14897.00,0.00
2024-12-10 17:44:01,84,11883,41,43,8009.02,14897.01,0.00
2024-12-10 17:44:01,83,11883,40,43,8037.37,14897.23,0.00
2024-12-10 17:44:01,83,11884,40,43,8205.60,14898.00,0.00
2024-12-10 17:44:01,84,11884,41,43,8107.91,14898.01,0.00
2024-12-10 17:44:01,83,11884,41,42,8187.67,14898.08,0.00
2024-12-10 17:44:01,82,11884,40,42,8135.12,14898.92,0.00
2024-12-10 17:44:01,82,11885,40,42,8304.16,14899.00,0.00
2024-12-10 17:44:01,83,11885,40,43,8204.11,14899.01,0.00
2024-12-10 17:44:01,82,11885,39,43,8207.73,14899.30,0.00
2024-12-10 17:44:01,82,11886,39,43,8282.31,14900.00,0.00
2024-12-10 17:44:01,83,11886,40,43,8182.52,14900.01,0.00
2024-12-10 17:44:01,82,11886,40,42,8261.90,14900.08,0.00
2024-12-10 17:44:01,83,11885,41,42,8086.79,14900.60,0.00
2024-12-10 17:44:01,84,11884,42,42,8033.43,14900.74,0.00
2024-12-10 17:44:01,84,11885,42,42,8136.53,14901.00,0.00
2024-12-10 17:44:01,85,11885,42,43,8040.80,14901.01,0.00
2024-12-10 17:44:01,85,11886,42,43,8313.61,14902.00,0.00
2024-12-10 17:44:01,86,11886,43,43,8216.94,14902.01,0.00
2024-12-10 17:44:01,85,11886,43,42,8298.04,14902.08,0.00
2024-12-10 17:44:01,85,11887,43,42,8265.42,14903.00,0.00
2024-12-10 17:44:01,86,11887,44,42,8169.31,14903.01,0.00
2024-12-10 17:44:01,87,11886,44,43,8075.41,14903.03,0.00
2024-12-10 17:44:01,87,11887,44,43,8070.51,14904.00,0.00
2024-12-10 17:44:01,88,11887,45,43,7978.80,14904.01,0.00
2024-12-10 17:44:01,87,11887,44,43,8059.19,14904.06,0.00
2024-12-10 17:44:01,86,11887,44,42,8149.44,14904.07,0.00
2024-12-10 17:44:01,85,11887,43,42,8222.57,14904.22,0.00
2024-12-10 17:44:01,85,11888,43,42,8380.49,14905.00,0.00
2024-12-10 17:44:01,86,11888,43,43,8283.04,14905.01,0.00
2024-12-10 17:44:01,85,11888,43,42,8330.13,14905.07,0.00
2024-12-10 17:44:01,84,11888,42,42,8322.86,14905.36,0.00
2024-12-10 17:44:01,84,11889,42,42,8398.51,14906.00,0.00
2024-12-10 17:44:01,85,11889,43,42,8299.70,14906.01,0.00
2024-12-10 17:44:01,84,11889,42,42,8284.59,14906.13,0.00
2024-12-10 17:44:01,85,11888,43,42,8073.57,14906.92,0.00
2024-12-10 17:44:01,85,11889,43,42,8259.89,14907.00,0.00
2024-12-10 17:44:01,86,11889,43,43,8163.84,14907.01,0.00
2024-12-10 17:44:01,85,11889,43,42,8233.52,14907.08,0.00
2024-12-10 17:44:01,84,11889,42,42,8308.52,14907.23,0.00
2024-12-10 17:44:01,84,11890,42,42,8466.44,14908.00,0.00
2024-12-10 17:44:01,85,11890,42,43,8366.84,14908.01,0.00
2024-12-10 17:44:01,84,11890,41,43,8410.16,14908.07,0.00
2024-12-10 17:44:01,83,11890,41,42,8461.59,14908.16,0.00
2024-12-10 17:44:02,83,11891,41,42,8504.69,14909.00,0.00
2024-12-10 17:44:02,84,11891,41,43,8403.44,14909.01,0.00
2024-12-10 17:44:02,83,11891,41,42,8477.71,14909.07,0.00
2024-12-10 17:44:02,84,11890,42,42,8293.26,14909.65,0.00
2024-12-10 17:44:02,84,11891,42,42,8358.58,14910.00,0.00
2024-12-10 17:44:02,85,11891,42,43,8260.24,14910.01,0.00
2024-12-10 17:44:02,84,11891,41,43,8342.80,14910.04,0.00
2024-12-10 17:44:02,83,11891,40,43,8236.43,14910.94,0.00
2024-12-10 17:44:02,83,11892,40,43,8580.33,14911.00,0.00
2024-12-10 17:44:02,84,11892,40,44,8478.18,14911.01,0.00
2024-12-10 17:44:02,83,11892,40,43,8557.44,14911.06,0.00
2024-12-10 17:44:02,83,11893,40,43,8516.10,14912.00,0.00
2024-12-10 17:44:02,84,11893,40,44,8414.71,14912.01,0.00
2024-12-10 17:44:02,85,11892,41,44,8208.34,14912.42,0.00
2024-12-10 17:44:02,84,11892,40,44,8254.15,14912.56,0.00
2024-12-10 17:44:02,84,11893,40,44,8358.57,14913.00,0.00
2024-12-10 17:44:02,85,11893,40,45,8260.23,14913.01,0.00
2024-12-10 17:44:02,84,11893,40,44,8337.16,14913.06,0.00
2024-12-10 17:44:02,84,11894,40,44,8463.18,14914.00,0.00
2024-12-10 17:44:02,85,11894,41,44,8363.62,14914.01,0.00
2024-12-10 17:44:02,85,11895,41,44,8249.02,14915.00,0.00
2024-12-10 17:44:02,86,11895,42,44,8153.10,14915.01,0.00
2024-12-10 17:44:02,85,11895,41,44,8234.85,14915.02,0.00
2024-12-10 17:44:02,84,11895,41,43,8320.47,14915.07,0.00
2024-12-10 17:44:02,83,11895,40,43,8321.32,14915.59,0.00
2024-12-10 17:44:02,83,11896,40,43,8360.34,14916.00,0.00
2024-12-10 17:44:02,84,11896,41,43,8260.81,14916.01,0.00
2024-12-10 17:44:02,85,11895,42,43,8025.01,14916.58,0.00
2024-12-10 17:44:02,85,11896,42,43,8073.40,14917.00,0.00
2024-12-10 17:44:02,86,11896,42,44,7979.52,14917.01,0.00
2024-12-10 17:44:02,85,11896,42,43,8060.98,14917.07,0.00
2024-12-10 17:44:02,84,11896,41,43,8116.63,14917.21,0.00
2024-12-10 17:44:02,84,11897,41,43,8275.33,14918.00,0.00
2024-12-10 17:44:02,85,11897,41,44,8177.97,14918.01,0.00
2024-12-10 17:44:02,84,11897,40,44,8064.28,14918.67,0.00
2024-12-10 17:44:02,83,11897,39,44,8156.07,14918.70,0.00
2024-12-10 17:44:02,83,11898,39,44,8282.03,14919.00,0.00
2024-12-10 17:44:02,84,11898,39,45,8183.44,14919.01,0.00
2024-12-10 17:44:02,83,11898,39,44,8255.92,14919.07,0.00
2024-12-10 17:44:02,84,11897,39,45,8078.69,14919.58,0.00
2024-12-10 17:44:02,83,11897,38,45,8177.83,14919.59,0.00
2024-12-10 17:44:02,83,11898,38,45,8287.02,14920.00,0.00
2024-12-10 17:44:02,84,11898,39,45,8188.36,14920.01,0.00
2024-12-10 17:44:02,83,11898,38,45,8278.67,14920.02,0.00
2024-12-10 17:44:02,82,11898,37,45,8377.81,14920.02,0.00
2024-12-10 17:44:02,81,11898,36,45,8354.20,14920.17,0.00
2024-12-10 17:44:02,81,11899,36,45,8579.14,14921.00,0.00
2024-12-10 17:44:02,82,11899,37,45,8474.52,14921.01,0.00
2024-12-10 17:44:02,81,11899,37,44,8564.75,14921.05,0.00
2024-12-10 17:44:02,80,11899,36,44,8593.51,14921.14,0.00
2024-12-10 17:44:02,79,11899,35,44,8615.03,14921.66,0.00
2024-12-10 17:44:02,79,11900,35,44,8738.75,14922.00,0.00
2024-12-10 17:44:02,80,11900,36,44,8629.51,14922.01,0.00
2024-12-10 17:44:02,79,11900,35,44,8735.60,14922.01,0.00
2024-12-10 17:44:02,80,11899,35,45,8489.25,14922.38,0.00
2024-12-10 17:44:02,79,11899,34,45,8627.38,14922.70,0.00
2024-12-10 17:44:02,79,11900,34,45,8758.01,14923.00,0.00
2024-12-10 17:44:02,80,11900,35,45,8648.53,14923.01,0.00
2024-12-10 17:44:02,79,11900,34,45,8689.16,14923.21,0.00
2024-12-10 17:44:02,79,11901,34,45,8844.41,14924.00,0.00
2024-12-10 17:44:02,80,11901,34,46,8733.85,14924.01,0.00
2024-12-10 17:44:02,79,11901,34,45,8810.41,14924.04,0.00
2024-12-10 17:44:02,79,11902,34,45,8739.73,14925.00,0.00
2024-12-10 17:44:02,80,11902,35,45,8630.48,14925.01,0.00
2024-12-10 17:44:02,80,11903,35,45,8560.52,14926.00,0.00
2024-12-10 17:44:02,81,11903,36,45,8454.83,14926.01,0.00
2024-12-10 17:44:02,82,11902,37,45,8298.97,14926.15,0.00
2024-12-10 17:44:02,81,11902,36,45,8474.94,14926.23,0.00
2024-12-10 17:44:02,81,11903,36,45,8510.22,14927.00,0.00
2024-12-10 17:44:02,82,11903,36,46,8406.44,14927.01,0.00
2024-12-10 17:44:02,83,11902,37,46,8303.36,14927.05,0.00
2024-12-10 17:44:02,82,11902,37,45,8451.96,14927.05,0.00
2024-12-10 17:44:02,82,11903,37,45,8563.91,14928.00,0.00
2024-12-10 17:44:02,83,11903,37,46,8460.73,14928.01,0.00
2024-12-10 17:44:02,82,11903,36,46,8563.69,14928.01,0.00
2024-12-10 17:44:02,82,11904,36,46,8622.94,14929.00,0.00
2024-12-10 17:44:02,83,11904,37,46,8519.05,14929.01,0.00
2024-12-10 17:44:02,82,11904,37,45,8619.31,14929.02,0.00
2024-12-10 17:44:02,81,11904,36,45,8539.25,14929.79,0.00
2024-12-10 17:44:02,81,11905,36,45,8691.03,14930.00,0.00
2024-12-10 17:44:02,82,11905,37,45,8585.04,14930.01,0.00
2024-12-10 17:44:02,81,11905,37,44,8650.49,14930.02,0.00
2024-12-10 17:44:02,80,11905,36,44,8639.60,14930.55,0.00
2024-12-10 17:44:02,80,11906,36,44,8670.80,14931.00,0.00
2024-12-10 17:44:02,81,11906,36,45,8563.75,14931.01,0.00
2024-12-10 17:44:02,80,11906,35,45,8565.29,14931.29,0.00
2024-12-10 17:44:02,80,11907,35,45,8605.96,14932.00,0.00
2024-12-10 17:44:02,81,11907,36,45,8499.72,14932.01,0.00
2024-12-10 17:44:02,80,11907,36,44,8600.38,14932.04,0.00
2024-12-10 17:44:02,79,11907,35,44,8668.13,14932.19,0.00
2024-12-10 17:44:02,80,11906,36,44,8557.91,14932.22,0.00
2024-12-10 17:44:02,81,11905,37,44,8472.25,14932.72,0.00
2024-12-10 17:44:02,81,11906,37,44,8615.05,14933.00,0.00
2024-12-10 17:44:02,82,11906,38,44,8509.99,14933.01,0.00
2024-12-10 17:44:02,81,11906,38,43,8540.72,14933.17,0.00
2024-12-10 17:44:02,80,11906,38,42,8589.27,14933.38,0.00
2024-12-10 17:44:02,79,11906,37,42,8587.89,14933.57,0.00
2024-12-10 17:44:02,79,11907,37,42,9085.96,14934.00,0.00
2024-12-10 17:44:02,80,11907,37,43,8972.39,14934.01,0.00
2024-12-10 17:44:02,79,11907,37,42,9080.30,14934.04,0.00
2024-12-10 17:44:02,78,11907,36,42,9068.65,14934.51,0.00
2024-12-10 17:44:02,78,11908,36,42,9172.69,14935.00,0.00
2024-12-10 17:44:02,79,11908,36,43,9056.58,14935.01,0.00
2024-12-10 17:44:02,78,11908,36,42,9128.66,14935.04,0.00
2024-12-10 17:44:02,77,11908,36,41,9239.24,14935.09,0.00
2024-12-10 17:44:02,78,11907,37,41,9111.23,14935.18,0.00
2024-12-10 17:44:02,77,11907,36,41,9075.90,14935.66,0.00
2024-12-10 17:44:03,77,11908,36,41,9206.33,14936.00,0.00
2024-12-10 17:44:03,78,11908,36,42,9088.30,14936.01,0.00
2024-12-10 17:44:03,77,11908,35,42,9142.39,14936.18,0.00
2024-12-10 17:44:03,78,11907,36,42,8990.82,14936.44,0.00
2024-12-10 17:44:03,78,11908,36,42,9398.95,14937.00,0.00
2024-12-10 17:44:03,79,11908,36,43,9279.97,14937.01,0.00
2024-12-10 17:44:03,79,11909,36,43,9418.40,14938.00,0.00
2024-12-10 17:44:03,80,11909,36,44,9300.67,14938.01,0.00
2024-12-10 17:44:03,79,11909,36,43,9311.91,14938.47,0.00
2024-12-10 17:44:03,80,11908,37,43,9077.20,14938.90,0.00
2024-12-10 17:44:03,81,11907,37,44,8974.37,14938.91,0.00
2024-12-10 17:44:03,81,11908,37,44,9155.20,14939.00,0.00
2024-12-10 17:44:03,82,11908,37,45,9043.55,14939.01,0.00
2024-12-10 17:44:03,83,11907,38,45,8825.03,14939.53,0.00
2024-12-10 17:44:03,82,11907,37,45,8890.74,14939.77,0.00
2024-12-10 17:44:03,82,11908,37,45,9402.89,14940.00,0.00
2024-12-10 17:44:03,83,11908,37,46,9289.60,14940.01,0.00
2024-12-10 17:44:03,82,11908,37,45,9386.51,14940.04,0.00
2024-12-10 17:44:03,81,11908,36,45,9460.05,14940.26,0.00
2024-12-10 17:44:03,82,11907,36,46,9310.20,14940.51,0.00
2024-12-10 17:44:03,82,11908,36,46,9602.13,14941.00,0.00
2024-12-10 17:44:03,83,11908,36,47,9486.44,14941.01,0.00
2024-12-10 17:44:03,82,11908,36,46,9565.70,14941.04,0.00
2024-12-10 17:44:03,82,11909,36,46,9712.51,14942.00,0.00
2024-12-10 17:44:03,83,11909,37,46,9595.49,14942.01,0.00
2024-12-10 17:44:03,82,11909,37,45,9676.07,14942.04,0.00
2024-12-10 17:44:03,82,11910,37,45,9641.14,14943.00,0.00
2024-12-10 17:44:03,83,11910,37,46,9524.98,14943.01,0.00
2024-12-10 17:44:03,82,11910,37,45,9604.70,14943.04,0.00
2024-12-10 17:44:03,82,11911,37,45,9568.16,14944.00,0.00
2024-12-10 17:44:03,83,11911,37,46,9452.88,14944.01,0.00
2024-12-10 17:44:03,82,11911,37,45,9531.72,14944.04,0.00
2024-12-10 17:44:03,82,11912,37,45,9487.95,14945.00,0.00
2024-12-10 17:44:03,83,11912,38,45,9373.64,14945.01,0.00
2024-12-10 17:44:03,82,11912,37,45,9407.85,14945.24,0.00
2024-12-10 17:44:03,82,11913,37,45,9461.61,14946.00,0.00
2024-12-10 17:44:03,83,11913,38,45,9347.62,14946.01,0.00
2024-12-10 17:44:03,82,11913,38,44,9432.48,14946.10,0.00
2024-12-10 17:44:03,82,11914,38,44,9385.54,14947.00,0.00
2024-12-10 17:44:03,83,11914,39,44,9272.46,14947.01,0.00
2024-12-10 17:44:03,84,11913,40,44,9048.46,14947.56,0.00
2024-12-10 17:44:03,83,11913,39,44,9240.30,14947.77,0.00
2024-12-10 17:44:03,83,11914,39,44,9385.86,14948.00,0.00
2024-12-10 17:44:03,84,11914,39,45,9274.13,14948.01,0.00
2024-12-10 17:44:03,83,11914,38,45,9242.02,14948.58,0.00
2024-12-10 17:44:03,83,11915,38,45,9465.30,14949.00,0.00
2024-12-10 17:44:03,84,11915,39,45,9352.62,14949.01,0.00
2024-12-10 17:44:03,84,11916,39,45,9228.90,14950.00,0.00
2024-12-10 17:44:03,85,11916,40,45,9120.33,14950.01,0.00
2024-12-10 17:44:03,86,11915,41,45,9007.33,14950.08,0.00
2024-12-10 17:44:03,85,11915,41,44,9229.41,14950.11,0.00
2024-12-10 17:44:03,85,11916,41,44,9164.81,14951.00,0.00
2024-12-10 17:44:03,86,11916,41,45,9058.24,14951.01,0.00
2024-12-10 17:44:03,85,11916,41,44,9161.30,14951.02,0.00
2024-12-10 17:44:03,85,11917,41,44,9294.93,14952.00,0.00
2024-12-10 17:44:03,86,11917,42,44,9186.85,14952.01,0.00
2024-12-10 17:44:03,86,11918,42,44,9141.51,14953.00,0.00
2024-12-10 17:44:03,87,11918,42,45,9036.44,14953.01,0.00
2024-12-10 17:44:03,87,11919,42,45,8973.88,14954.00,0.00
2024-12-10 17:44:03,88,11919,42,46,8871.91,14954.01,0.00
2024-12-10 17:44:03,87,11919,41,46,8908.64,14954.22,0.00
2024-12-10 17:44:03,87,11920,41,46,8882.74,14955.00,0.00
2024-12-10 17:44:03,88,11920,41,47,8781.80,14955.01,0.00
2024-12-10 17:44:03,87,11920,41,46,8850.09,14955.05,0.00
2024-12-10 17:44:03,86,11920,40,46,8729.36,14955.98,0.00
2024-12-10 17:44:03,86,11921,40,46,8899.80,14956.00,0.00
2024-12-10 17:44:03,87,11921,40,47,8797.51,14956.01,0.00
2024-12-10 17:44:03,86,11921,39,47,8702.41,14956.62,0.00
2024-12-10 17:44:03,86,11922,39,47,8809.11,14957.00,0.00
2024-12-10 17:44:03,87,11922,40,47,8707.85,14957.01,0.00
2024-12-10 17:44:03,86,11922,40,46,8791.74,14957.09,0.00
2024-12-10 17:44:03,85,11922,39,46,8814.38,14957.41,0.00
2024-12-10 17:44:03,85,11923,39,46,8878.76,14958.00,0.00
2024-12-10 17:44:03,86,11923,39,47,8775.52,14958.01,0.00
2024-12-10 17:44:03,87,11922,39,48,8519.46,14958.47,0.00
2024-12-10 17:44:03,87,11923,39,48,8742.65,14959.00,0.00
2024-12-10 17:44:03,88,11923,40,48,8643.30,14959.01,0.00
2024-12-10 17:44:03,87,11923,39,48,8655.68,14959.25,0.00
2024-12-10 17:44:03,87,11924,39,48,8849.18,14960.00,0.00
2024-12-10 17:44:03,88,11924,40,48,8748.62,14960.01,0.00
2024-12-10 17:44:03,87,11924,40,47,8835.45,14960.09,0.00
2024-12-10 17:44:03,86,11924,39,47,8800.83,14960.85,0.00
2024-12-10 17:44:03,86,11925,39,47,8869.39,14961.00,0.00
2024-12-10 17:44:03,87,11925,40,47,8767.44,14961.01,0.00
2024-12-10 17:44:03,87,11926,40,47,8658.93,14962.00,0.00
2024-12-10 17:44:03,88,11926,41,47,8560.53,14962.01,0.00
2024-12-10 17:44:03,87,11926,41,46,8643.48,14962.10,0.00
2024-12-10 17:44:03,86,11926,40,46,8551.28,14962.98,0.00
2024-12-10 17:44:03,86,11927,40,46,8721.80,14963.00,0.00
2024-12-10 17:44:03,87,11927,41,46,8621.55,14963.01,0.00
2024-12-10 17:44:03,86,11927,40,46,8674.85,14963.09,0.00
2024-12-10 17:44:03,85,11927,40,45,8739.94,14963.09,0.00
2024-12-10 17:44:03,86,11926,41,45,8603.61,14963.35,0.00
2024-12-10 17:44:03,86,11927,41,45,8704.69,14964.00,0.00
2024-12-10 17:44:03,87,11927,42,45,8604.64,14964.01,0.00
2024-12-10 17:44:03,86,11927,41,45,8701.22,14964.02,0.00
2024-12-10 17:44:03,85,11927,40,45,8770.15,14964.07,0.00
2024-12-10 17:44:04,85,11928,40,45,8922.63,14965.00,0.00
2024-12-10 17:44:04,86,11928,40,46,8818.88,14965.01,0.00
2024-12-10 17:44:04,85,11928,39,46,8919.12,14965.02,0.00
2024-12-10 17:44:04,84,11928,39,45,9016.41,14965.07,0.00
2024-12-10 17:44:04,84,11929,39,45,8964.80,14966.00,0.00
2024-12-10 17:44:04,85,11929,39,46,8859.33,14966.01,0.00
2024-12-10 17:44:04,86,11928,39,47,8688.52,14966.26,0.00
2024-12-10 17:44:04,86,11929,39,47,8711.82,14967.00,0.00
2024-12-10 17:44:04,87,11929,40,47,8611.69,14967.01,0.00
2024-12-10 17:44:04,86,11929,40,46,8701.40,14967.07,0.00
2024-12-10 17:44:04,85,11929,39,46,8693.67,14967.47,0.00
2024-12-10 17:44:04,85,11930,39,46,8963.17,14968.00,0.00
2024-12-10 17:44:04,86,11930,40,46,8858.95,14968.01,0.00
2024-12-10 17:44:04,85,11930,39,46,8738.47,14968.72,0.00
2024-12-10 17:44:04,85,11931,39,46,8872.22,14969.00,0.00
2024-12-10 17:44:04,86,11931,40,46,8769.05,14969.01,0.00
2024-12-10 17:44:04,85,11931,40,45,8859.91,14969.07,0.00
2024-12-10 17:44:04,84,11931,40,44,8920.73,14969.33,0.00
2024-12-10 17:44:04,84,11932,40,44,8924.36,14970.00,0.00
2024-12-10 17:44:04,85,11932,41,44,8819.37,14970.01,0.00
2024-12-10 17:44:04,84,11932,40,44,8805.01,14970.15,0.00
2024-12-10 17:44:04,84,11933,40,44,8847.22,14971.00,0.00
2024-12-10 17:44:04,85,11933,41,44,8743.14,14971.01,0.00
2024-12-10 17:44:04,86,11932,42,44,8641.47,14971.04,0.00
2024-12-10 17:44:04,85,11932,42,43,8808.33,14971.08,0.00
2024-12-10 17:44:04,85,11933,42,43,8760.50,14972.00,0.00
2024-12-10 17:44:04,86,11933,42,44,8658.63,14972.01,0.00
2024-12-10 17:44:04,86,11934,42,44,8728.13,14973.00,0.00
2024-12-10 17:44:04,87,11934,43,44,8627.80,14973.01,0.00
2024-12-10 17:44:04,86,11934,43,43,8705.53,14973.10,0.00
2024-12-10 17:44:04,86,11935,43,43,8639.72,14974.00,0.00
2024-12-10 17:44:04,87,11935,43,44,8540.41,14974.01,0.00
2024-12-10 17:44:04,86,11935,43,43,8477.21,14974.80,0.00
2024-12-10 17:44:04,87,11934,43,44,8374.64,14974.85,0.00
2024-12-10 17:44:04,87,11935,43,44,8472.87,14975.00,0.00
2024-12-10 17:44:04,88,11935,44,44,8376.59,14975.01,0.00
2024-12-10 17:44:04,87,11935,44,43,8450.53,14975.10,0.00
2024-12-10 17:44:04,87,11936,44,43,8582.59,14976.00,0.00
2024-12-10 17:44:04,88,11936,45,43,8485.06,14976.01,0.00
2024-12-10 17:44:04,87,11936,44,43,8386.56,14976.88,0.00
2024-12-10 17:44:04,87,11937,44,43,8541.57,14977.00,0.00
2024-12-10 17:44:04,88,11937,45,43,8444.51,14977.01,0.00
2024-12-10 17:44:04,89,11936,45,44,8349.62,14977.03,0.00
2024-12-10 17:44:04,88,11936,44,44,8447.93,14977.06,0.00
2024-12-10 17:44:04,87,11936,44,43,8529.55,14977.10,0.00
2024-12-10 17:44:04,87,11937,44,43,8487.73,14978.00,0.00
2024-12-10 17:44:04,88,11937,44,44,8391.27,14978.01,0.00
2024-12-10 17:44:04,87,11937,43,44,8484.29,14978.02,0.00
2024-12-10 17:44:04,87,11937,43,44,8567.63,14979.00,0.00
2024-12-10 17:44:04,88,11937,43,45,8470.27,14979.01,0.00
2024-12-10 17:44:04,87,11937,43,44,8545.28,14979.08,0.00
2024-12-10 17:44:04,87,11938,43,44,8498.37,14980.00,0.00
2024-12-10 17:44:04,88,11938,44,44,8401.80,14980.01,0.00
2024-12-10 17:44:04,87,11938,43,44,8395.94,14980.38,0.00
2024-12-10 17:44:04,87,11939,43,44,8406.69,14981.00,0.00
2024-12-10 17:44:04,88,11939,44,44,8311.15,14981.01,0.00
2024-12-10 17:44:04,87,11939,44,43,8384.33,14981.08,0.00
2024-12-10 17:44:04,87,11940,44,43,8350.42,14982.00,0.00
2024-12-10 17:44:04,88,11940,44,44,8255.53,14982.01,0.00
2024-12-10 17:44:04,87,11940,43,44,8230.33,14982.58,0.00
2024-12-10 17:44:04,87,11941,43,44,8270.18,14983.00,0.00
2024-12-10 17:44:04,88,11941,43,45,8176.20,14983.01,0.00
2024-12-10 17:44:04,87,11941,43,44,8249.54,14983.08,0.00
2024-12-10 17:44:04,86,11941,42,44,8178.44,14983.98,0.00
2024-12-10 17:44:04,86,11942,42,44,8349.20,14984.00,0.00
2024-12-10 17:44:04,87,11942,43,44,8253.23,14984.01,0.00
2024-12-10 17:44:04,87,11943,43,44,8171.09,14985.00,0.00
2024-12-10 17:44:04,88,11943,43,45,8078.24,14985.01,0.00
2024-12-10 17:44:04,87,11943,43,44,8152.17,14985.08,0.00
2024-12-10 17:44:04,87,11944,43,44,8112.23,14986.00,0.00
2024-12-10 17:44:04,88,11944,44,44,8020.05,14986.01,0.00
2024-12-10 17:44:04,88,11945,44,44,7933.15,14987.00,0.00
2024-12-10 17:44:04,89,11945,45,44,7844.01,14987.01,0.00
2024-12-10 17:44:04,90,11944,45,45,7753.54,14987.06,0.00
2024-12-10 17:44:04,89,11944,45,44,7945.09,14987.10,0.00
2024-12-10 17:44:04,88,11944,44,44,8011.59,14987.26,0.00
2024-12-10 17:44:04,87,11944,43,44,7966.67,14987.94,0.00
2024-12-10 17:44:04,87,11945,43,44,8130.38,14988.00,0.00
2024-12-10 17:44:04,88,11945,43,45,8037.99,14988.01,0.00
2024-12-10 17:44:04,89,11944,44,45,7759.24,14988.61,0.00
2024-12-10 17:44:04,89,11945,44,45,8081.19,14989.00,0.00
2024-12-10 17:44:04,90,11945,44,46,7991.40,14989.01,0.00
2024-12-10 17:44:04,89,11945,44,45,8064.39,14989.09,0.00
2024-12-10 17:44:04,90,11944,44,46,7924.32,14989.43,0.00
2024-12-10 17:44:04,89,11944,43,46,8043.73,14989.54,0.00
2024-12-10 17:44:04,89,11945,43,46,8296.40,14990.00,0.00
2024-12-10 17:44:04,90,11945,43,47,8204.22,14990.01,0.00
2024-12-10 17:44:04,91,11944,43,48,7956.42,14990.73,0.00
2024-12-10 17:44:04,91,11945,43,48,8279.50,14991.00,0.00
2024-12-10 17:44:04,92,11945,44,48,8189.50,14991.01,0.00
2024-12-10 17:44:04,91,11945,44,47,8264.71,14991.09,0.00
2024-12-10 17:44:04,90,11945,43,47,8233.70,14991.73,0.00
2024-12-10 17:44:04,90,11946,43,47,8460.45,14992.00,0.00
2024-12-10 17:44:04,91,11946,43,48,8367.48,14992.01,0.00
2024-12-10 17:44:04,90,11946,42,48,8387.25,14992.27,0.00
2024-12-10 17:44:04,89,11946,41,48,8341.69,14992.91,0.00
2024-12-10 17:44:04,89,11947,41,48,8496.75,14993.00,0.00
2024-12-10 17:44:04,90,11947,42,48,8402.34,14993.01,0.00
2024-12-10 17:44:04,89,11947,42,47,8481.63,14993.10,0.00
2024-12-10 17:44:04,90,11946,43,47,8327.65,14993.49,0.00
2024-12-10 17:44:05,91,11945,43,48,8260.93,14993.78,0.00
2024-12-10 17:44:05,91,11946,43,48,8356.68,14994.00,0.00
2024-12-10 17:44:05,92,11946,44,48,8265.85,14994.01,0.00
2024-12-10 17:44:05,91,11946,43,48,8350.12,14994.04,0.00
2024-12-10 17:44:05,91,11947,43,48,8592.32,14995.00,0.00
2024-12-10 17:44:05,92,11947,44,48,8498.92,14995.01,0.00
2024-12-10 17:44:05,91,11947,44,47,8585.75,14995.04,0.00
2024-12-10 17:44:05,90,11947,44,46,8669.50,14995.09,0.00
2024-12-10 17:44:05,90,11948,44,46,8616.30,14996.00,0.00
2024-12-10 17:44:05,91,11948,45,46,8521.61,14996.01,0.00
2024-12-10 17:44:05,92,11947,45,47,8381.59,14996.13,0.00
2024-12-10 17:44:05,91,11947,44,47,8412.63,14996.75,0.00
2024-12-10 17:44:05,91,11948,44,47,8539.73,14997.00,0.00
2024-12-10 17:44:05,92,11948,45,47,8446.91,14997.01,0.00
2024-12-10 17:44:05,91,11948,45,46,8524.94,14997.09,0.00
2024-12-10 17:44:05,91,11949,45,46,8626.41,14998.00,0.00
2024-12-10 17:44:05,92,11949,46,46,8532.65,14998.01,0.00
2024-12-10 17:44:05,91,11949,45,46,8430.50,14998.56,0.00
2024-12-10 17:44:05,91,11950,45,46,8529.72,14999.00,0.00
2024-12-10 17:44:05,92,11950,46,46,8437.01,14999.01,0.00
2024-12-10 17:44:05,91,11950,46,45,8516.58,14999.09,0.00
2024-12-10 17:44:05,91,11951,46,45,8479.19,15000.00,0.00
2024-12-10 17:44:05,92,11951,46,46,8387.03,15000.01,0.00
2024-12-10 17:44:05,91,11951,45,46,8280.06,15000.70,0.00
2024-12-10 17:44:05,91,11952,45,46,8400.63,15001.00,0.00
2024-12-10 17:44:05,92,11952,46,46,8309.32,15001.01,0.00
2024-12-10 17:44:05,91,11952,46,45,8382.55,15001.11,0.00
2024-12-10 17:44:05,91,11953,46,45,8348.43,15002.00,0.00
2024-12-10 17:44:05,92,11953,46,46,8257.69,15002.01,0.00
2024-12-10 17:44:05,91,11953,45,46,8297.38,15002.11,0.00
2024-12-10 17:44:05,90,11953,44,46,8319.64,15002.34,0.00
2024-12-10 17:44:05,90,11954,44,46,8388.41,15003.00,0.00
2024-12-10 17:44:05,91,11954,45,46,8296.23,15003.01,0.00
2024-12-10 17:44:05,90,11954,45,45,8370.13,15003.11,0.00
2024-12-10 17:44:05,89,11954,44,45,8425.40,15003.11,0.00
2024-12-10 17:44:05,89,11955,44,45,8461.32,15004.00,0.00
2024-12-10 17:44:05,90,11955,45,45,8367.30,15004.01,0.00
2024-12-10 17:44:05,91,11954,46,45,8275.35,15004.03,0.00
2024-12-10 17:44:05,91,11955,46,45,8239.63,15005.00,0.00
2024-12-10 17:44:05,92,11955,47,45,8150.07,15005.01,0.00
2024-12-10 17:44:05,91,11955,47,44,8219.89,15005.11,0.00
2024-12-10 17:44:05,92,11954,47,45,8081.73,15005.46,0.00
2024-12-10 17:44:05,92,11955,47,45,8336.43,15006.00,0.00
2024-12-10 17:44:05,93,11955,48,45,8246.79,15006.01,0.00
2024-12-10 17:44:05,92,11955,47,45,8222.41,15006.42,0.00
2024-12-10 17:44:05,92,11956,47,45,8460.13,15007.00,0.00
2024-12-10 17:44:05,93,11956,48,45,8369.16,15007.01,0.00
2024-12-10 17:44:05,92,11956,48,44,8440.61,15007.12,0.00
2024-12-10 17:44:05,92,11957,48,44,8403.49,15008.00,0.00
2024-12-10 17:44:05,93,11957,48,45,8313.13,15008.01,0.00
2024-12-10 17:44:05,93,11958,48,45,8227.24,15009.00,0.00
2024-12-10 17:44:05,94,11958,49,45,8139.72,15009.01,0.00
2024-12-10 17:44:05,93,11958,49,44,8206.31,15009.12,0.00
2024-12-10 17:44:05,93,11959,49,44,8170.38,15010.00,0.00
2024-12-10 17:44:05,94,11959,49,45,8083.46,15010.01,0.00
2024-12-10 17:44:05,93,11959,48,45,8091.40,15010.32,0.00
2024-12-10 17:44:05,93,11960,48,45,8086.99,15011.00,0.00
2024-12-10 17:44:05,94,11960,48,46,8000.96,15011.01,0.00
2024-12-10 17:44:05,93,11960,48,45,8062.83,15011.13,0.00
2024-12-10 17:44:05,93,11961,48,45,8029.42,15012.00,0.00
2024-12-10 17:44:05,94,11961,49,45,7944.00,15012.01,0.00
2024-12-10 17:44:05,93,11961,48,45,7934.23,15012.16,0.00
2024-12-10 17:44:05,92,11961,48,44,8015.06,15012.20,0.00
2024-12-10 17:44:05,93,11960,48,45,7909.55,15012.34,0.00
2024-12-10 17:44:05,93,11961,48,45,8008.02,15013.00,0.00
2024-12-10 17:44:05,94,11961,49,45,7922.82,15013.01,0.00
2024-12-10 17:44:05,93,11961,49,44,7985.46,15013.13,0.00
2024-12-10 17:44:05,92,11961,48,44,8029.72,15013.39,0.00
2024-12-10 17:44:05,91,11961,47,44,8065.37,15013.74,0.00
2024-12-10 17:44:05,91,11962,47,44,8289.82,15014.00,0.00
2024-12-10 17:44:05,92,11962,48,44,8199.71,15014.01,0.00
2024-12-10 17:44:05,92,11963,48,44,8114.88,15015.00,0.00
2024-12-10 17:44:05,93,11963,48,45,8027.63,15015.01,0.00
2024-12-10 17:44:05,93,11964,48,45,7938.38,15016.00,0.00
2024-12-10 17:44:05,94,11964,49,45,7853.93,15016.01,0.00
2024-12-10 17:44:05,93,11964,48,45,7927.11,15016.08,0.00
2024-12-10 17:44:05,92,11964,47,45,8006.25,15016.12,0.00
2024-12-10 17:44:05,91,11964,47,44,8092.58,15016.12,0.00
2024-12-10 17:44:05,91,11965,47,44,8050.24,15017.00,0.00
2024-12-10 17:44:05,92,11965,47,45,7962.74,15017.01,0.00
2024-12-10 17:44:05,91,11965,47,44,8032.03,15017.12,0.00
2024-12-10 17:44:05,90,11965,46,44,8095.80,15017.24,0.00
2024-12-10 17:44:05,90,11966,46,44,8082.39,15018.00,0.00
2024-12-10 17:44:05,91,11966,46,45,7993.57,15018.01,0.00
2024-12-10 17:44:05,91,11967,46,45,7910.83,15019.00,0.00
2024-12-10 17:44:05,92,11967,47,45,7824.84,15019.01,0.00
2024-12-10 17:44:05,91,11967,47,44,7889.42,15019.14,0.00
2024-12-10 17:44:05,90,11967,46,44,7819.79,15019.98,0.00
2024-12-10 17:44:05,90,11968,46,44,7983.35,15020.00,0.00
2024-12-10 17:44:05,91,11968,47,44,7895.62,15020.01,0.00
2024-12-10 17:44:05,90,11968,47,43,7926.66,15020.16,0.00
2024-12-10 17:44:05,90,11969,47,43,7895.87,15021.00,0.00
2024-12-10 17:44:05,91,11969,47,44,7809.10,15021.01,0.00
2024-12-10 17:44:05,90,11969,46,44,7815.79,15021.09,0.00
2024-12-10 17:44:06,89,11969,46,43,7861.43,15021.15,0.00
2024-12-10 17:44:06,89,11970,46,43,7894.25,15022.00,0.00
2024-12-10 17:44:06,90,11970,46,44,7806.53,15022.01,0.00
2024-12-10 17:44:06,89,11970,46,43,7840.28,15022.15,0.00
2024-12-10 17:44:06,88,11970,45,43,7759.74,15022.75,0.00
2024-12-10 17:44:06,88,11971,45,43,7893.07,15023.00,0.00
2024-12-10 17:44:06,89,11971,46,43,7804.38,15023.01,0.00
2024-12-10 17:44:06,90,11970,46,44,7717.67,15023.03,0.00
2024-12-10 17:44:06,89,11970,46,43,7780.79,15023.16,0.00
2024-12-10 17:44:06,90,11969,46,44,7538.22,15023.69,0.00
2024-12-10 17:44:06,90,11970,46,44,7768.80,15024.00,0.00
2024-12-10 17:44:06,91,11970,46,45,7683.43,15024.01,0.00
2024-12-10 17:44:06,90,11970,46,44,7713.75,15024.14,0.00
2024-12-10 17:44:06,90,11971,46,44,8004.57,15025.00,0.00
2024-12-10 17:44:06,91,11971,47,44,7916.61,15025.01,0.00
2024-12-10 17:44:06,90,11971,46,44,7922.86,15025.27,0.00
2024-12-10 17:44:06,89,11971,45,44,7996.71,15025.31,0.00
2024-12-10 17:44:06,89,11972,45,44,8055.76,15026.00,0.00
2024-12-10 17:44:06,90,11972,46,44,7966.25,15026.01,0.00
2024-12-10 17:44:06,89,11972,45,44,8047.33,15026.06,0.00
2024-12-10 17:44:06,89,11973,45,44,7982.76,15027.00,0.00
2024-12-10 17:44:06,90,11973,45,45,7894.06,15027.01,0.00
2024-12-10 17:44:06,89,11973,44,45,7970.97,15027.08,0.00
2024-12-10 17:44:06,88,11973,43,45,7903.07,15027.76,0.00
2024-12-10 17:44:06,88,11974,43,45,7972.43,15028.00,0.00
2024-12-10 17:44:06,89,11974,44,45,7882.85,15028.01,0.00
2024-12-10 17:44:06,88,11974,44,44,7943.43,15028.14,0.00
2024-12-10 17:44:06,89,11973,44,45,7777.59,15028.58,0.00
2024-12-10 17:44:06,89,11974,44,45,7907.70,15029.00,0.00
2024-12-10 17:44:06,90,11974,44,46,7819.84,15029.01,0.00
2024-12-10 17:44:06,89,11974,43,46,7770.48,15029.42,0.00
2024-12-10 17:44:06,89,11975,43,46,8000.19,15030.00,0.00
2024-12-10 17:44:06,90,11975,43,47,7911.30,15030.01,0.00
2024-12-10 17:44:06,89,11975,43,46,7957.41,15030.15,0.00
2024-12-10 17:44:06,89,11976,43,46,7900.16,15031.00,0.00
2024-12-10 17:44:06,90,11976,44,46,7812.38,15031.01,0.00
2024-12-10 17:44:06,89,11976,43,46,7798.38,15031.27,0.00
2024-12-10 17:44:06,90,11975,43,47,7535.71,15031.94,0.00
2024-12-10 17:44:06,90,11976,43,47,7829.45,15032.00,0.00
2024-12-10 17:44:06,91,11976,44,47,7743.41,15032.01,0.00
2024-12-10 17:44:06,90,11976,43,47,7813.74,15032.06,0.00
2024-12-10 17:44:06,89,11976,43,46,7864.73,15032.16,0.00
2024-12-10 17:44:06,88,11976,42,46,7793.53,15032.70,0.00
2024-12-10 17:44:06,88,11977,42,46,8086.87,15033.00,0.00
2024-12-10 17:44:06,89,11977,43,46,7996.00,15033.01,0.00
2024-12-10 17:44:06,88,11977,43,45,8052.17,15033.14,0.00
2024-12-10 17:44:06,88,11978,43,45,8021.58,15034.00,0.00
2024-12-10 17:44:06,89,11978,43,46,7931.45,15034.01,0.00
2024-12-10 17:44:06,88,11978,42,46,7935.93,15034.17,0.00
2024-12-10 17:44:06,89,11977,43,46,7799.59,15034.51,0.00
2024-12-10 17:44:06,88,11977,42,46,7905.53,15034.75,0.00
2024-12-10 17:44:06,88,11978,42,46,8039.00,15035.00,0.00
2024-12-10 17:44:06,89,11978,42,47,7948.67,15035.01,0.00
2024-12-10 17:44:06,88,11978,41,47,8035.59,15035.02,0.00
2024-12-10 17:44:06,87,11978,40,47,8053.71,15035.28,0.00
2024-12-10 17:44:06,88,11977,41,47,7848.33,15035.92,0.00
2024-12-10 17:44:06,88,11978,41,47,8114.66,15036.00,0.00
2024-12-10 17:44:06,89,11978,41,48,8023.48,15036.01,0.00
2024-12-10 17:44:06,88,11978,40,48,8109.55,15036.03,0.00
2024-12-10 17:44:06,87,11978,40,47,8171.67,15036.13,0.00
2024-12-10 17:44:06,87,11979,40,47,8286.90,15037.00,0.00
2024-12-10 17:44:06,88,11979,41,47,8192.73,15037.01,0.00
2024-12-10 17:44:06,88,11980,41,47,8085.61,15038.00,0.00
2024-12-10 17:44:06,89,11980,41,48,7994.76,15038.01,0.00
2024-12-10 17:44:06,88,11980,40,48,8078.80,15038.05,0.00
2024-12-10 17:44:06,87,11980,40,47,8171.39,15038.05,0.00
2024-12-10 17:44:06,86,11980,39,47,8264.66,15038.05,0.00
2024-12-10 17:44:06,85,11980,39,46,8337.13,15038.12,0.00
2024-12-10 17:44:06,85,11981,39,46,8279.29,15039.00,0.00
2024-12-10 17:44:06,86,11981,39,47,8183.02,15039.01,0.00
2024-12-10 17:44:06,86,11982,39,47,8065.75,15040.00,0.00
2024-12-10 17:44:06,87,11982,39,48,7973.04,15040.01,0.00
2024-12-10 17:44:06,86,11982,39,47,8033.24,15040.12,0.00
2024-12-10 17:44:06,85,11982,38,47,8040.51,15040.42,0.00
2024-12-10 17:44:06,84,11982,38,46,8075.11,15040.63,0.00
2024-12-10 17:44:06,84,11983,38,46,8197.90,15041.00,0.00
2024-12-10 17:44:06,85,11983,39,46,8101.45,15041.01,0.00
2024-12-10 17:44:06,84,11983,38,46,8080.38,15041.14,0.00
2024-12-10 17:44:06,83,11983,37,46,8084.40,15041.67,0.00
2024-12-10 17:44:06,83,11984,37,46,8212.83,15042.00,0.00
2024-12-10 17:44:06,84,11984,37,47,8115.06,15042.01,0.00
2024-12-10 17:44:06,83,11984,37,46,8199.23,15042.07,0.00
2024-12-10 17:44:06,82,11984,37,45,8282.82,15042.11,0.00
2024-12-10 17:44:06,82,11985,37,45,8237.37,15043.00,0.00
2024-12-10 17:44:06,83,11985,37,46,8138.12,15043.01,0.00
2024-12-10 17:44:06,83,11986,37,46,8035.42,15044.00,0.00
2024-12-10 17:44:06,84,11986,37,47,7939.76,15044.01,0.00
2024-12-10 17:44:06,83,11986,36,47,8000.80,15044.11,0.00
2024-12-10 17:44:06,82,11986,36,46,8081.86,15044.11,0.00
2024-12-10 17:44:06,82,11987,36,46,8094.60,15045.00,0.00
2024-12-10 17:44:06,83,11987,36,47,7997.08,15045.01,0.00
2024-12-10 17:44:06,84,11986,37,47,7900.09,15045.05,0.00
2024-12-10 17:44:06,83,11986,37,46,7999.83,15045.36,0.00
2024-12-10 17:44:06,83,11987,37,46,7997.12,15046.00,0.00
2024-12-10 17:44:06,84,11987,37,47,7901.91,15046.01,0.00
2024-12-10 17:44:06,83,11987,36,47,7988.08,15046.06,0.00
2024-12-10 17:44:06,82,11987,36,46,8056.80,15046.11,0.00
2024-12-10 17:44:07,81,11987,35,46,8141.44,15046.20,0.00
2024-12-10 17:44:07,80,11987,34,46,8181.95,15046.39,0.00
2024-12-10 17:44:07,80,11988,34,46,8441.58,15047.00,0.00
2024-12-10 17:44:07,81,11988,34,47,8337.36,15047.01,0.00
2024-12-10 17:44:07,82,11987,35,47,8230.21,15047.07,0.00
2024-12-10 17:44:07,81,11987,35,46,8511.33,15047.07,0.00
2024-12-10 17:44:07,82,11986,36,46,8299.45,15047.57,0.00
2024-12-10 17:44:07,82,11987,36,46,8379.00,15048.00,0.00
2024-12-10 17:44:07,83,11987,37,46,8278.05,15048.01,0.00
2024-12-10 17:44:07,82,11987,37,45,8346.02,15048.11,0.00
2024-12-10 17:44:07,82,11988,37,45,8663.63,15049.00,0.00
2024-12-10 17:44:07,83,11988,38,45,8559.24,15049.01,0.00
2024-12-10 17:44:07,83,11989,38,45,8459.91,15050.00,0.00
2024-12-10 17:44:07,84,11989,39,45,8359.19,15050.01,0.00
2024-12-10 17:44:07,83,11989,39,44,8428.96,15050.11,0.00
2024-12-10 17:44:07,84,11988,39,45,8264.30,15050.56,0.00
2024-12-10 17:44:07,84,11989,39,45,8331.22,15051.00,0.00
2024-12-10 17:44:07,85,11989,40,45,8233.21,15051.01,0.00
2024-12-10 17:44:07,85,11990,40,45,8313.76,15052.00,0.00
2024-12-10 17:44:07,86,11990,41,45,8217.09,15052.01,0.00
2024-12-10 17:44:07,85,11990,41,44,8283.12,15052.11,0.00
2024-12-10 17:44:07,84,11990,40,44,8363.85,15052.23,0.00
2024-12-10 17:44:07,84,11991,40,44,8335.20,15053.00,0.00
2024-12-10 17:44:07,85,11991,41,44,8237.14,15053.01,0.00
2024-12-10 17:44:07,85,11992,41,44,8143.80,15054.00,0.00
2024-12-10 17:44:07,86,11992,41,45,8049.11,15054.01,0.00
2024-12-10 17:44:07,85,11992,41,44,8111.99,15054.11,0.00
2024-12-10 17:44:07,84,11992,41,43,8125.55,15054.62,0.00
2024-12-10 17:44:07,84,11993,41,43,8166.70,15055.00,0.00
2024-12-10 17:44:07,85,11993,41,44,8070.63,15055.01,0.00
2024-12-10 17:44:07,84,11993,40,44,8030.92,15055.24,0.00
2024-12-10 17:44:07,83,11993,39,44,8045.41,15055.72,0.00
2024-12-10 17:44:07,83,11994,39,44,8185.29,15056.00,0.00
2024-12-10 17:44:07,84,11994,39,45,8087.84,15056.01,0.00
2024-12-10 17:44:07,83,11994,39,44,8156.30,15056.11,0.00
2024-12-10 17:44:07,82,11994,38,44,8237.09,15056.22,0.00
2024-12-10 17:44:07,82,11995,38,44,8303.25,15057.00,0.00
2024-12-10 17:44:07,83,11995,39,44,8203.21,15057.01,0.00
2024-12-10 17:44:07,83,11996,39,44,8130.95,15058.00,0.00
2024-12-10 17:44:07,84,11996,39,45,8034.15,15058.01,0.00
2024-12-10 17:44:07,83,11996,39,44,8101.96,15058.11,0.00
2024-12-10 17:44:07,83,11997,39,44,8075.23,15059.00,0.00
2024-12-10 17:44:07,84,11997,40,44,7979.09,15059.01,0.00
2024-12-10 17:44:07,83,11997,39,44,8000.58,15059.24,0.00
2024-12-10 17:44:07,82,11997,38,44,8039.48,15059.63,0.00
2024-12-10 17:44:07,82,11998,38,44,8098.40,15060.00,0.00
2024-12-10 17:44:07,83,11998,39,44,8000.83,15060.01,0.00
2024-12-10 17:44:07,82,11998,38,44,8089.25,15060.06,0.00
2024-12-10 17:44:07,81,11998,38,43,8159.67,15060.10,0.00
2024-12-10 17:44:07,81,11999,38,43,8132.39,15061.00,0.00
2024-12-10 17:44:07,82,11999,38,44,8033.21,15061.01,0.00
2024-12-10 17:44:07,81,11999,37,44,7934.06,15061.58,0.00
2024-12-10 17:44:07,81,12000,37,44,8052.70,15062.00,0.00
2024-12-10 17:44:07,82,12000,38,44,7954.50,15062.01,0.00
2024-12-10 17:44:07,81,12000,37,44,8043.44,15062.06,0.00
2024-12-10 17:44:07,80,12000,37,43,8132.85,15062.08,0.00
2024-12-10 17:44:07,79,12000,37,42,8222.45,15062.08,0.00
2024-12-10 17:44:07,79,12001,37,42,8193.42,15063.00,0.00
2024-12-10 17:44:07,80,12001,37,43,8091.00,15063.01,0.00
2024-12-10 17:44:07,79,12001,36,43,8083.53,15063.48,0.00
2024-12-10 17:44:07,80,12000,36,44,7936.56,15063.78,0.00
2024-12-10 17:44:07,79,12000,35,44,8014.27,15063.94,0.00
2024-12-10 17:44:07,79,12001,35,44,8195.47,15064.00,0.00
2024-12-10 17:44:07,80,12001,36,44,8093.02,15064.01,0.00
2024-12-10 17:44:07,79,12001,36,43,8172.62,15064.09,0.00
2024-12-10 17:44:07,78,12001,35,43,8260.06,15064.21,0.00
2024-12-10 17:44:07,77,12001,34,43,8253.68,15064.55,0.00
2024-12-10 17:44:07,77,12002,34,43,8572.10,15065.00,0.00
2024-12-10 17:44:07,78,12002,35,43,8462.20,15065.01,0.00
2024-12-10 17:44:07,77,12002,34,43,8515.39,15065.08,0.00
2024-12-10 17:44:07,76,12002,33,43,8569.99,15065.20,0.00
2024-12-10 17:44:07,75,12002,32,43,8612.41,15065.64,0.00
2024-12-10 17:44:07,75,12003,32,43,8759.32,15066.00,0.00
2024-12-10 17:44:07,76,12003,32,44,8644.06,15066.01,0.00
2024-12-10 17:44:07,75,12003,32,43,8741.27,15066.08,0.00
2024-12-10 17:44:07,75,12004,32,43,8719.47,15067.00,0.00
2024-12-10 17:44:07,76,12004,33,43,8604.74,15067.01,0.00
2024-12-10 17:44:07,75,12004,32,43,8647.23,15067.23,0.00
2024-12-10 17:44:07,75,12005,32,43,8728.79,15068.00,0.00
2024-12-10 17:44:07,76,12005,32,44,8613.94,15068.01,0.00
2024-12-10 17:44:07,75,12005,32,43,8712.75,15068.08,0.00
2024-12-10 17:44:07,74,12005,31,43,8739.31,15068.66,0.00
2024-12-10 17:44:07,74,12006,31,43,8810.84,15069.00,0.00
2024-12-10 17:44:07,75,12006,32,43,8693.36,15069.01,0.00
2024-12-10 17:44:07,74,12006,31,43,8792.55,15069.07,0.00
2024-12-10 17:44:07,74,12007,31,43,8813.96,15070.00,0.00
2024-12-10 17:44:07,75,12007,32,43,8696.44,15070.01,0.00
2024-12-10 17:44:07,74,12007,32,42,8803.81,15070.07,0.00
2024-12-10 17:44:07,74,12008,32,42,8784.78,15071.00,0.00
2024-12-10 17:44:07,75,12008,33,42,8667.65,15071.01,0.00
2024-12-10 17:44:07,76,12007,33,43,8504.06,15071.11,0.00
2024-12-10 17:44:07,76,12008,33,43,8581.90,15072.00,0.00
2024-12-10 17:44:07,77,12008,33,44,8470.45,15072.01,0.00
2024-12-10 17:44:07,76,12008,33,43,8572.01,15072.07,0.00
2024-12-10 17:44:07,76,12009,33,43,8749.07,15073.00,0.00
2024-12-10 17:44:07,77,12009,33,44,8635.44,15073.01,0.00
2024-12-10 17:44:07,76,12009,32,44,8697.52,15073.04,0.00
2024-12-10 17:44:07,75,12009,31,44,8749.23,15073.20,0.00
2024-12-10 17:44:07,75,12010,31,44,8830.13,15074.00,0.00
2024-12-10 17:44:07,76,12010,32,44,8713.95,15074.01,0.00
2024-12-10 17:44:07,75,12010,31,44,8761.87,15074.20,0.00
2024-12-10 17:44:08,74,12010,30,44,8739.97,15074.65,0.00
2024-12-10 17:44:08,74,12011,30,44,8890.98,15075.00,0.00
2024-12-10 17:44:08,75,12011,31,44,8772.43,15075.01,0.00
2024-12-10 17:44:08,74,12011,31,43,8866.57,15075.09,0.00
2024-12-10 17:44:08,74,12012,31,43,8852.85,15076.00,0.00
2024-12-10 17:44:08,75,12012,31,44,8734.81,15076.01,0.00
2024-12-10 17:44:08,74,12012,31,43,8842.71,15076.07,0.00
2024-12-10 17:44:08,73,12012,30,43,8854.39,15076.11,0.00
2024-12-10 17:44:08,73,12013,30,43,8926.82,15077.00,0.00
2024-12-10 17:44:08,74,12013,30,44,8806.19,15077.01,0.00
2024-12-10 17:44:08,74,12014,30,44,8739.04,15078.00,0.00
2024-12-10 17:44:08,75,12014,31,44,8622.52,15078.01,0.00
2024-12-10 17:44:08,74,12014,31,43,8700.37,15078.12,0.00
2024-12-10 17:44:08,74,12015,31,43,8690.71,15079.00,0.00
2024-12-10 17:44:08,75,12015,31,44,8574.84,15079.01,0.00
2024-12-10 17:44:08,75,12016,31,44,8508.78,15080.00,0.00
2024-12-10 17:44:08,76,12016,31,45,8396.82,15080.01,0.00
2024-12-10 17:44:08,77,12015,31,46,8285.82,15080.05,0.00
2024-12-10 17:44:08,76,12015,31,45,8428.62,15080.13,0.00
2024-12-10 17:44:08,75,12015,30,45,8495.10,15080.31,0.00
2024-12-10 17:44:08,75,12016,30,45,8592.06,15081.00,0.00
2024-12-10 17:44:08,76,12016,30,46,8479.01,15081.01,0.00
2024-12-10 17:44:08,76,12017,30,46,8612.06,15082.00,0.00
2024-12-10 17:44:08,77,12017,30,47,8500.22,15082.01,0.00
2024-12-10 17:44:08,76,12017,30,46,8600.20,15082.08,0.00
2024-12-10 17:44:08,75,12017,30,45,8690.74,15082.11,0.00
2024-12-10 17:44:08,76,12016,30,46,8511.11,15082.57,0.00
2024-12-10 17:44:08,75,12016,29,46,8623.23,15082.84,0.00
2024-12-10 17:44:08,76,12015,30,46,8505.82,15082.88,0.00
2024-12-10 17:44:08,76,12016,30,46,8702.41,15083.00,0.00
2024-12-10 17:44:08,77,12016,30,47,8589.39,15083.01,0.00
2024-12-10 17:44:08,77,12017,30,47,8958.92,15084.00,0.00
2024-12-10 17:44:08,78,12017,31,47,8844.07,15084.01,0.00
2024-12-10 17:44:08,79,12016,32,47,8728.31,15084.06,0.00
2024-12-10 17:44:08,78,12016,31,47,8851.88,15084.19,0.00
2024-12-10 17:44:08,77,12016,30,47,8886.81,15084.71,0.00
2024-12-10 17:44:08,77,12017,30,47,8980.36,15085.00,0.00
2024-12-10 17:44:08,78,12017,30,48,8865.23,15085.01,0.00
2024-12-10 17:44:08,78,12018,30,48,8987.08,15086.00,0.00
2024-12-10 17:44:08,79,12018,31,48,8873.32,15086.01,0.00
2024-12-10 17:44:08,78,12018,31,47,8967.79,15086.12,0.00
2024-12-10 17:44:08,77,12018,30,47,8968.72,15086.82,0.00
2024-12-10 17:44:08,77,12019,30,47,9137.39,15087.00,0.00
2024-12-10 17:44:08,78,12019,30,48,9020.24,15087.01,0.00
2024-12-10 17:44:08,77,12019,29,48,9054.22,15087.29,0.00
2024-12-10 17:44:08,77,12020,29,48,9065.08,15088.00,0.00
2024-12-10 17:44:08,78,12020,30,48,8948.86,15088.01,0.00
2024-12-10 17:44:08,79,12019,30,49,8835.58,15088.04,0.00
2024-12-10 17:44:08,78,12019,30,48,9036.18,15088.13,0.00
2024-12-10 17:44:08,79,12018,31,48,8898.94,15088.30,0.00
2024-12-10 17:44:08,78,12018,30,48,9051.25,15088.46,0.00
2024-12-10 17:44:08,77,12018,29,48,9133.67,15088.70,0.00
2024-12-10 17:44:08,77,12019,29,48,9284.81,15089.00,0.00
2024-12-10 17:44:08,78,12019,30,48,9165.77,15089.01,0.00
2024-12-10 17:44:08,77,12019,30,47,9239.79,15089.09,0.00
2024-12-10 17:44:08,77,12020,30,47,9608.82,15090.00,0.00
2024-12-10 17:44:08,78,12020,31,47,9485.64,15090.01,0.00
2024-12-10 17:44:08,78,12021,31,47,9408.03,15091.00,0.00
2024-12-10 17:44:08,79,12021,31,48,9288.94,15091.01,0.00
2024-12-10 17:44:08,78,12021,31,47,9394.30,15091.09,0.00
2024-12-10 17:44:08,78,12022,31,47,9366.72,15092.00,0.00
2024-12-10 17:44:08,79,12022,32,47,9248.15,15092.01,0.00
2024-12-10 17:44:08,79,12023,32,47,9199.08,15093.00,0.00
2024-12-10 17:44:08,80,12023,33,47,9084.09,15093.01,0.00
2024-12-10 17:44:08,80,12024,33,47,9007.51,15094.00,0.00
2024-12-10 17:44:08,81,12024,33,48,8896.31,15094.01,0.00
2024-12-10 17:44:08,80,12024,33,47,8962.28,15094.10,0.00
2024-12-10 17:44:08,80,12025,33,47,8926.99,15095.00,0.00
2024-12-10 17:44:08,81,12025,33,48,8816.78,15095.01,0.00
2024-12-10 17:44:08,82,12024,33,49,8707.43,15095.05,0.00
2024-12-10 17:44:08,83,12023,34,49,8412.27,15095.69,0.00
2024-12-10 17:44:08,83,12024,34,49,8568.94,15096.00,0.00
2024-12-10 17:44:08,84,12024,35,49,8466.93,15096.01,0.00
2024-12-10 17:44:08,83,12024,35,48,8543.53,15096.10,0.00
2024-12-10 17:44:08,82,12024,35,47,8630.55,15096.16,0.00
2024-12-10 17:44:08,81,12024,34,47,8632.90,15096.52,0.00
2024-12-10 17:44:08,81,12025,34,47,9119.70,15097.00,0.00
2024-12-10 17:44:08,82,12025,35,47,9008.48,15097.01,0.00
2024-12-10 17:44:08,81,12025,34,47,9110.42,15097.06,0.00
2024-12-10 17:44:08,80,12025,33,47,9085.98,15097.35,0.00
2024-12-10 17:44:08,80,12026,33,47,9177.02,15098.00,0.00
2024-12-10 17:44:08,81,12026,34,47,9063.72,15098.01,0.00
2024-12-10 17:44:08,80,12026,34,46,9154.42,15098.09,0.00
2024-12-10 17:44:08,79,12026,33,46,9253.14,15098.20,0.00
2024-12-10 17:44:08,79,12027,33,46,9247.93,15099.00,0.00
2024-12-10 17:44:08,80,12027,34,46,9132.33,15099.01,0.00
2024-12-10 17:44:08,79,12027,33,46,9133.41,15099.35,0.00
2024-12-10 17:44:08,80,12026,33,47,8944.08,15099.88,0.00
2024-12-10 17:44:08,80,12027,33,47,9129.16,15100.00,0.00
2024-12-10 17:44:08,81,12027,33,48,9016.45,15100.01,0.00
2024-12-10 17:44:08,80,12027,33,47,9106.56,15100.10,0.00
2024-12-10 17:44:08,81,12026,34,47,8945.80,15100.44,0.00
2024-12-10 17:44:08,81,12027,34,47,9233.31,15101.00,0.00
2024-12-10 17:44:08,82,12027,34,48,9120.71,15101.01,0.00
2024-12-10 17:44:08,81,12027,33,48,9162.51,15101.10,0.00
2024-12-10 17:44:08,81,12028,33,48,9360.27,15102.00,0.00
2024-12-10 17:44:08,82,12028,34,48,9246.12,15102.01,0.00
2024-12-10 17:44:08,81,12028,34,47,9336.08,15102.10,0.00
2024-12-10 17:44:08,81,12029,34,47,9308.26,15103.00,0.00
2024-12-10 17:44:08,82,12029,34,48,9194.75,15103.01,0.00
2024-12-10 17:44:08,83,12028,35,48,9083.97,15103.04,0.00
2024-12-10 17:44:09,83,12029,35,48,9033.14,15104.00,0.00
2024-12-10 17:44:09,84,12029,36,48,8925.60,15104.01,0.00
2024-12-10 17:44:09,85,12028,37,48,8818.83,15104.05,0.00
2024-12-10 17:44:09,84,12028,36,48,8932.84,15104.07,0.00
2024-12-10 17:44:09,83,12028,36,47,9024.09,15104.10,0.00
2024-12-10 17:44:09,82,12028,35,47,8999.90,15104.56,0.00
2024-12-10 17:44:09,83,12027,36,47,8835.00,15104.93,0.00
2024-12-10 17:44:09,83,12028,36,47,9195.40,15105.00,0.00
2024-12-10 17:44:09,84,12028,37,47,9085.93,15105.01,0.00
2024-12-10 17:44:09,84,12029,37,47,9366.70,15106.00,0.00
2024-12-10 17:44:09,85,12029,37,48,9256.50,15106.01,0.00
2024-12-10 17:44:09,84,12029,37,47,9337.97,15106.10,0.00
2024-12-10 17:44:09,84,12030,37,47,9309.00,15107.00,0.00
2024-12-10 17:44:09,85,12030,38,47,9199.48,15107.01,0.00
2024-12-10 17:44:09,85,12031,38,47,9172.02,15108.00,0.00
2024-12-10 17:44:09,86,12031,39,47,9065.36,15108.01,0.00
2024-12-10 17:44:09,85,12031,38,47,9035.50,15108.67,0.00
2024-12-10 17:44:09,85,12032,38,47,9128.84,15109.00,0.00
2024-12-10 17:44:09,86,12032,38,48,9022.69,15109.01,0.00
2024-12-10 17:44:09,85,12032,37,48,8988.54,15109.69,0.00
2024-12-10 17:44:09,85,12033,37,48,9059.18,15110.00,0.00
2024-12-10 17:44:09,86,12033,37,49,8953.84,15110.01,0.00
2024-12-10 17:44:09,85,12033,37,48,9013.01,15110.09,0.00
2024-12-10 17:44:09,86,12032,37,49,8818.38,15110.71,0.00
2024-12-10 17:44:09,86,12033,37,49,8930.03,15111.00,0.00
2024-12-10 17:44:09,87,12033,38,49,8827.39,15111.01,0.00
2024-12-10 17:44:09,86,12033,38,48,8898.44,15111.07,0.00
2024-12-10 17:44:09,86,12034,38,48,9030.42,15112.00,0.00
2024-12-10 17:44:09,87,12034,39,48,8926.62,15112.01,0.00
2024-12-10 17:44:09,86,12034,38,48,8960.22,15112.23,0.00
2024-12-10 17:44:09,85,12034,37,48,8946.44,15112.94,0.00
2024-12-10 17:44:09,85,12035,37,48,9112.61,15113.00,0.00
2024-12-10 17:44:09,86,12035,38,48,9006.65,15113.01,0.00
2024-12-10 17:44:09,87,12034,39,48,8901.39,15113.05,0.00
2024-12-10 17:44:09,86,12034,39,47,9004.93,15113.09,0.00
2024-12-10 17:44:09,85,12034,38,47,9091.49,15113.21,0.00
2024-12-10 17:44:09,85,12035,38,47,9067.87,15114.00,0.00
2024-12-10 17:44:09,86,12035,39,47,8962.43,15114.01,0.00
2024-12-10 17:44:09,85,12035,38,47,9048.35,15114.06,0.00
2024-12-10 17:44:09,84,12035,37,47,9098.54,15114.20,0.00
2024-12-10 17:44:09,84,12036,37,47,9324.82,15115.00,0.00
2024-12-10 17:44:09,85,12036,38,47,9215.12,15115.01,0.00
2024-12-10 17:44:09,84,12036,38,46,9308.66,15115.07,0.00
2024-12-10 17:44:09,85,12035,39,46,9137.10,15115.51,0.00
2024-12-10 17:44:09,85,12036,39,46,9212.20,15116.00,0.00
2024-12-10 17:44:09,86,12036,39,47,9105.09,15116.01,0.00
2024-12-10 17:44:09,86,12037,39,47,9189.16,15117.00,0.00
2024-12-10 17:44:09,87,12037,40,47,9083.54,15117.01,0.00
2024-12-10 17:44:09,86,12037,40,46,9175.14,15117.07,0.00
2024-12-10 17:44:09,86,12038,40,46,9128.40,15118.00,0.00
2024-12-10 17:44:09,87,12038,40,47,9023.48,15118.01,0.00
2024-12-10 17:44:09,88,12037,40,48,8756.19,15118.44,0.00
2024-12-10 17:44:09,88,12038,40,48,8900.93,15119.00,0.00
2024-12-10 17:44:09,89,12038,41,48,8800.92,15119.01,0.00
2024-12-10 17:44:09,90,12037,41,49,8693.09,15119.10,0.00
2024-12-10 17:44:09,89,12037,41,48,8911.39,15119.10,0.00
2024-12-10 17:44:09,88,12037,40,48,8959.47,15119.32,0.00
2024-12-10 17:44:09,88,12038,40,48,9195.35,15120.00,0.00
2024-12-10 17:44:09,89,12038,41,48,9092.03,15120.01,0.00
2024-12-10 17:44:09,88,12038,41,47,9167.89,15120.06,0.00
2024-12-10 17:44:09,87,12038,40,47,9252.47,15120.20,0.00
2024-12-10 17:44:09,87,12039,40,47,9402.93,15121.00,0.00
2024-12-10 17:44:09,88,12039,40,48,9296.07,15121.01,0.00
2024-12-10 17:44:09,87,12039,40,47,9361.25,15121.06,0.00
2024-12-10 17:44:09,88,12038,40,48,9201.77,15121.43,0.00
2024-12-10 17:44:09,88,12039,40,48,9308.50,15122.00,0.00
2024-12-10 17:44:09,89,12039,41,48,9203.91,15122.01,0.00
2024-12-10 17:44:09,88,12039,40,48,9164.60,15122.69,0.00
2024-12-10 17:44:09,88,12040,40,48,9388.15,15123.00,0.00
2024-12-10 17:44:09,89,12040,40,49,9282.67,15123.01,0.00
2024-12-10 17:44:09,88,12040,40,48,9376.17,15123.07,0.00
2024-12-10 17:44:09,88,12041,40,48,9326.94,15124.00,0.00
2024-12-10 17:44:09,89,12041,41,48,9222.14,15124.01,0.00
2024-12-10 17:44:09,89,12042,41,48,9125.54,15125.00,0.00
2024-12-10 17:44:09,90,12042,42,48,9024.14,15125.01,0.00
2024-12-10 17:44:09,89,12042,42,47,9111.98,15125.08,0.00
2024-12-10 17:44:09,88,12042,41,47,9041.38,15125.69,0.00
2024-12-10 17:44:09,88,12043,41,47,9162.81,15126.00,0.00
2024-12-10 17:44:09,89,12043,42,47,9059.86,15126.01,0.00
2024-12-10 17:44:09,88,12043,41,47,9099.30,15126.20,0.00
2024-12-10 17:44:09,87,12043,40,47,9080.83,15126.59,0.00
2024-12-10 17:44:09,87,12044,40,47,9189.36,15127.00,0.00
2024-12-10 17:44:09,88,12044,40,48,9084.93,15127.01,0.00
2024-12-10 17:44:09,87,12044,40,47,9149.41,15127.08,0.00
2024-12-10 17:44:09,88,12043,41,47,8948.77,15127.68,0.00
2024-12-10 17:44:09,88,12044,41,47,9040.57,15128.00,0.00
2024-12-10 17:44:09,89,12044,41,48,8938.99,15128.01,0.00
2024-12-10 17:44:09,90,12043,41,49,8679.62,15128.60,0.00
2024-12-10 17:44:09,90,12044,41,49,8994.25,15129.00,0.00
2024-12-10 17:44:09,91,12044,42,49,8895.42,15129.01,0.00
2024-12-10 17:44:09,91,12045,42,49,8981.54,15130.00,0.00
2024-12-10 17:44:09,92,12045,42,50,8883.91,15130.01,0.00
2024-12-10 17:44:09,91,12045,42,49,8948.32,15130.09,0.00
2024-12-10 17:44:09,90,12045,41,49,9030.98,15130.20,0.00
2024-12-10 17:44:09,90,12046,41,49,9011.32,15131.00,0.00
2024-12-10 17:44:09,91,12046,41,50,8912.29,15131.01,0.00
2024-12-10 17:44:09,91,12047,41,50,8829.74,15132.00,0.00
2024-12-10 17:44:09,92,12047,41,51,8733.77,15132.01,0.00
2024-12-10 17:44:09,91,12047,41,50,8813.15,15132.09,0.00
2024-12-10 17:44:09,90,12047,40,50,8805.35,15132.51,0.00
2024-12-10 17:44:09,90,12048,40,50,8899.85,15133.00,0.00
2024-12-10 17:44:09,91,12048,41,50,8802.06,15133.01,0.00
2024-12-10 17:44:10,91,12049,41,50,8719.48,15134.00,0.00
2024-12-10 17:44:10,92,12049,42,50,8624.71,15134.01,0.00
2024-12-10 17:44:10,91,12049,42,49,8691.25,15134.07,0.00
2024-12-10 17:44:10,91,12050,42,49,8650.20,15135.00,0.00
2024-12-10 17:44:10,92,12050,42,50,8556.18,15135.01,0.00
2024-12-10 17:44:10,91,12050,42,49,8638.60,15135.08,0.00
2024-12-10 17:44:10,90,12050,41,49,8716.13,15135.20,0.00
2024-12-10 17:44:10,91,12049,41,50,8585.53,15135.45,0.00
2024-12-10 17:44:10,91,12050,41,50,8669.07,15136.00,0.00
2024-12-10 17:44:10,92,12050,42,50,8574.85,15136.01,0.00
2024-12-10 17:44:10,91,12050,42,49,8624.20,15136.08,0.00
2024-12-10 17:44:10,91,12051,42,49,8751.15,15137.00,0.00
2024-12-10 17:44:10,92,12051,42,50,8656.03,15137.01,0.00
2024-12-10 17:44:10,91,12051,41,50,8649.07,15137.46,0.00
2024-12-10 17:44:10,91,12052,41,50,8667.74,15138.00,0.00
2024-12-10 17:44:10,92,12052,41,51,8573.52,15138.01,0.00
2024-12-10 17:44:10,91,12052,41,50,8656.13,15138.08,0.00
2024-12-10 17:44:10,90,12052,40,50,8623.66,15138.83,0.00
2024-12-10 17:44:10,90,12053,40,50,8766.77,15139.00,0.00
2024-12-10 17:44:10,91,12053,40,51,8670.43,15139.01,0.00
2024-12-10 17:44:10,90,12053,39,51,8618.02,15139.74,0.00
2024-12-10 17:44:10,90,12054,39,51,8680.46,15140.00,0.00
2024-12-10 17:44:10,91,12054,39,52,8585.07,15140.01,0.00
2024-12-10 17:44:10,90,12054,39,51,8665.36,15140.09,0.00
2024-12-10 17:44:10,91,12053,40,51,8510.54,15140.47,0.00
2024-12-10 17:44:10,91,12054,40,51,8549.18,15141.00,0.00
2024-12-10 17:44:10,92,12054,41,51,8456.25,15141.01,0.00
2024-12-10 17:44:10,91,12054,40,51,8351.98,15141.66,0.00
2024-12-10 17:44:10,91,12055,40,51,8633.43,15142.00,0.00
2024-12-10 17:44:10,92,12055,41,51,8539.59,15142.01,0.00
2024-12-10 17:44:10,91,12055,41,50,8618.49,15142.09,0.00
2024-12-10 17:44:10,91,12056,41,50,8570.57,15143.00,0.00
2024-12-10 17:44:10,92,12056,41,51,8477.41,15143.01,0.00
2024-12-10 17:44:10,91,12056,41,50,8524.02,15143.09,0.00
2024-12-10 17:44:10,91,12057,41,50,8474.35,15144.00,0.00
2024-12-10 17:44:10,92,12057,42,50,8382.24,15144.01,0.00
2024-12-10 17:44:10,91,12057,41,50,8283.98,15144.63,0.00
2024-12-10 17:44:10,90,12057,40,50,8355.92,15144.76,0.00
2024-12-10 17:44:10,90,12058,40,50,8487.36,15145.00,0.00
2024-12-10 17:44:10,91,12058,41,50,8394.09,15145.01,0.00
2024-12-10 17:44:10,90,12058,41,49,8472.25,15145.09,0.00
2024-12-10 17:44:10,90,12059,41,49,8423.73,15146.00,0.00
2024-12-10 17:44:10,91,12059,42,49,8331.16,15146.01,0.00
2024-12-10 17:44:10,90,12059,41,49,8357.43,15146.22,0.00
2024-12-10 17:44:10,89,12059,40,49,8340.87,15146.85,0.00
2024-12-10 17:44:10,89,12060,40,49,8489.05,15147.00,0.00
2024-12-10 17:44:10,90,12060,40,50,8394.73,15147.01,0.00
2024-12-10 17:44:10,89,12060,39,50,8478.87,15147.07,0.00
2024-12-10 17:44:10,88,12060,39,49,8570.06,15147.08,0.00
2024-12-10 17:44:10,87,12060,38,49,8567.66,15147.74,0.00
2024-12-10 17:44:10,87,12061,38,49,8632.30,15148.00,0.00
2024-12-10 17:44:10,88,12061,39,49,8534.20,15148.01,0.00
2024-12-10 17:44:10,88,12062,39,49,8449.48,15149.00,0.00
2024-12-10 17:44:10,89,12062,39,50,8354.54,15149.01,0.00
2024-12-10 17:44:10,88,12062,39,49,8430.57,15149.09,0.00
2024-12-10 17:44:10,87,12062,38,49,8499.69,15149.28,0.00
2024-12-10 17:44:10,88,12061,38,50,8403.10,15149.30,0.00
2024-12-10 17:44:10,88,12062,38,50,8477.82,15150.00,0.00
2024-12-10 17:44:10,89,12062,38,51,8382.56,15150.01,0.00
2024-12-10 17:44:10,90,12061,38,52,8202.03,15150.39,0.00
2024-12-10 17:44:10,90,12062,38,52,8409.68,15151.00,0.00
2024-12-10 17:44:10,91,12062,39,52,8317.27,15151.01,0.00
2024-12-10 17:44:10,90,12062,38,52,8253.63,15151.48,0.00
2024-12-10 17:44:10,90,12063,38,52,8506.18,15152.00,0.00
2024-12-10 17:44:10,91,12063,39,52,8412.71,15152.01,0.00
2024-12-10 17:44:10,90,12063,39,51,8487.69,15152.09,0.00
2024-12-10 17:44:10,91,12062,39,52,8287.79,15152.79,0.00
2024-12-10 17:44:10,91,12063,39,52,8382.88,15153.00,0.00
2024-12-10 17:44:10,92,12063,40,52,8291.76,15153.01,0.00
2024-12-10 17:44:10,92,12064,40,52,8369.84,15154.00,0.00
2024-12-10 17:44:10,93,12064,41,52,8279.85,15154.01,0.00
2024-12-10 17:44:10,92,12064,41,51,8350.11,15154.10,0.00
2024-12-10 17:44:10,91,12064,40,51,8415.29,15154.27,0.00
2024-12-10 17:44:10,90,12064,39,51,8434.69,15154.73,0.00
2024-12-10 17:44:10,89,12064,38,51,8485.31,15154.89,0.00
2024-12-10 17:44:10,89,12065,38,51,8638.65,15155.00,0.00
2024-12-10 17:44:10,90,12065,38,52,8542.67,15155.01,0.00
2024-12-10 17:44:10,90,12066,38,52,8449.79,15156.00,0.00
2024-12-10 17:44:10,91,12066,39,52,8356.94,15156.01,0.00
2024-12-10 17:44:10,90,12066,39,51,8429.62,15156.10,0.00
2024-12-10 17:44:10,91,12065,39,52,8318.70,15156.24,0.00
2024-12-10 17:44:10,90,12065,38,52,8428.85,15156.59,0.00
2024-12-10 17:44:10,90,12066,38,52,8521.09,15157.00,0.00
2024-12-10 17:44:10,91,12066,38,53,8427.46,15157.01,0.00
2024-12-10 17:44:10,92,12065,39,53,8334.21,15157.04,0.00
2024-12-10 17:44:10,91,12065,38,53,8430.50,15157.26,0.00
2024-12-10 17:44:10,91,12066,38,53,8580.26,15158.00,0.00
2024-12-10 17:44:10,92,12066,39,53,8486.99,15158.01,0.00
2024-12-10 17:44:10,91,12066,39,52,8561.97,15158.10,0.00
2024-12-10 17:44:10,90,12066,38,52,8556.78,15158.51,0.00
2024-12-10 17:44:10,90,12067,38,52,8819.89,15159.00,0.00
2024-12-10 17:44:10,91,12067,39,52,8722.96,15159.01,0.00
2024-12-10 17:44:10,91,12068,39,52,8667.54,15160.00,0.00
2024-12-10 17:44:10,92,12068,39,53,8573.32,15160.01,0.00
2024-12-10 17:44:10,93,12067,40,53,8477.89,15160.05,0.00
2024-12-10 17:44:10,92,12067,39,53,8624.52,15160.29,0.00
2024-12-10 17:44:10,91,12067,38,53,8714.33,15160.32,0.00
2024-12-10 17:44:10,92,12066,38,54,8613.04,15160.38,0.00
2024-12-10 17:44:10,92,12067,38,54,8702.06,15161.00,0.00
2024-12-10 17:44:10,93,12067,39,54,8608.49,15161.01,0.00
2024-12-10 17:44:10,92,12067,39,53,8659.25,15161.10,0.00
2024-12-10 17:44:10,93,12066,39,54,8562.88,15161.14,0.00
2024-12-10 17:44:10,92,12066,39,53,8662.70,15161.52,0.00
2024-12-10 17:44:11,92,12067,39,53,9019.02,15162.00,0.00
2024-12-10 17:44:11,93,12067,39,54,8922.04,15162.01,0.00
2024-12-10 17:44:11,92,12067,39,53,8972.91,15162.10,0.00
2024-12-10 17:44:11,91,12067,38,53,9028.21,15162.13,0.00
2024-12-10 17:44:11,92,12066,39,53,8897.22,15162.37,0.00
2024-12-10 17:44:11,92,12067,39,53,9207.02,15163.00,0.00
2024-12-10 17:44:11,93,12067,40,53,9108.02,15163.01,0.00
2024-12-10 17:44:11,92,12067,40,52,9160.91,15163.10,0.00
2024-12-10 17:44:11,92,12068,40,52,9276.15,15164.00,0.00
2024-12-10 17:44:11,93,12068,40,53,9176.40,15164.01,0.00
2024-12-10 17:44:11,92,12068,40,52,9228.39,15164.11,0.00
2024-12-10 17:44:11,92,12069,40,52,9180.53,15165.00,0.00
2024-12-10 17:44:11,93,12069,41,52,9081.81,15165.01,0.00
2024-12-10 17:44:11,92,12069,41,51,9129.47,15165.12,0.00
2024-12-10 17:44:11,91,12069,41,50,9194.34,15165.34,0.00
2024-12-10 17:44:11,92,12068,41,51,9015.62,15165.88,0.00
2024-12-10 17:44:11,92,12069,41,51,9108.04,15166.00,0.00
2024-12-10 17:44:11,93,12069,42,51,9010.10,15166.01,0.00
2024-12-10 17:44:11,92,12069,41,51,8910.56,15166.67,0.00
2024-12-10 17:44:11,92,12070,41,51,9191.07,15167.00,0.00
2024-12-10 17:44:11,93,12070,42,51,9092.24,15167.01,0.00
2024-12-10 17:44:11,92,12070,42,50,9171.33,15167.13,0.00
2024-12-10 17:44:11,92,12071,42,50,9138.91,15168.00,0.00
2024-12-10 17:44:11,93,12071,43,50,9040.65,15168.01,0.00
2024-12-10 17:44:11,94,12070,43,51,8889.67,15168.18,0.00
2024-12-10 17:44:11,94,12071,43,51,8962.94,15169.00,0.00
2024-12-10 17:44:11,95,12071,44,51,8868.59,15169.01,0.00
2024-12-10 17:44:11,96,12070,45,51,8645.05,15169.53,0.00
2024-12-10 17:44:11,95,12070,44,51,8772.88,15169.67,0.00
2024-12-10 17:44:11,95,12071,44,51,9043.00,15170.00,0.00
2024-12-10 17:44:11,96,12071,44,52,8948.80,15170.01,0.00
2024-12-10 17:44:11,95,12071,43,52,8961.76,15170.24,0.00
2024-12-10 17:44:11,96,12070,43,53,8803.86,15170.69,0.00
2024-12-10 17:44:11,96,12071,43,53,9102.79,15171.00,0.00
2024-12-10 17:44:11,97,12071,44,53,9008.94,15171.01,0.00
2024-12-10 17:44:11,96,12071,43,53,9096.49,15171.04,0.00
2024-12-10 17:44:11,95,12071,43,52,9187.46,15171.06,0.00
2024-12-10 17:44:11,96,12070,44,52,9087.02,15171.11,0.00
2024-12-10 17:44:11,96,12071,44,52,9304.31,15172.00,0.00
2024-12-10 17:44:11,97,12071,44,53,9208.39,15172.01,0.00
2024-12-10 17:44:11,96,12071,44,52,9282.23,15172.10,0.00
2024-12-10 17:44:11,96,12072,44,52,9394.44,15173.00,0.00
2024-12-10 17:44:11,97,12072,45,52,9297.59,15173.01,0.00
2024-12-10 17:44:11,96,12072,45,51,9375.42,15173.11,0.00
2024-12-10 17:44:11,95,12072,44,51,9440.50,15173.27,0.00
2024-12-10 17:44:11,95,12073,44,51,9426.62,15174.00,0.00
2024-12-10 17:44:11,96,12073,44,52,9328.42,15174.01,0.00
2024-12-10 17:44:11,97,12072,44,53,9037.58,15174.93,0.00
2024-12-10 17:44:11,97,12073,44,53,9251.97,15175.00,0.00
2024-12-10 17:44:11,98,12073,45,53,9157.56,15175.01,0.00
2024-12-10 17:44:11,97,12073,44,53,9140.17,15175.41,0.00
2024-12-10 17:44:11,97,12074,44,53,9364.32,15176.00,0.00
2024-12-10 17:44:11,98,12074,45,53,9268.76,15176.01,0.00
2024-12-10 17:44:11,97,12074,45,52,9354.96,15176.06,0.00
2024-12-10 17:44:11,96,12074,45,51,9384.90,15176.24,0.00
2024-12-10 17:44:11,97,12073,46,51,9210.23,15176.77,0.00
2024-12-10 17:44:11,97,12074,46,51,9314.19,15177.00,0.00
2024-12-10 17:44:11,98,12074,47,51,9219.15,15177.01,0.00
2024-12-10 17:44:11,99,12073,47,52,9124.50,15177.04,0.00
2024-12-10 17:44:11,99,12074,47,52,9251.44,15178.00,0.00
2024-12-10 17:44:11,100,12074,47,53,9158.93,15178.01,0.00
2024-12-10 17:44:11,99,12074,47,52,9220.83,15178.10,0.00
2024-12-10 17:44:11,99,12075,47,52,9330.24,15179.00,0.00
2024-12-10 17:44:11,100,12075,48,52,9236.94,15179.01,0.00
2024-12-10 17:44:11,99,12075,48,51,9290.43,15179.10,0.00
2024-12-10 17:44:11,99,12076,48,51,9246.52,15180.00,0.00
2024-12-10 17:44:11,100,12076,48,52,9154.06,15180.01,0.00
2024-12-10 17:44:11,99,12076,48,51,9207.76,15180.10,0.00
2024-12-10 17:44:11,99,12077,48,51,9163.85,15181.00,0.00
2024-12-10 17:44:11,100,12077,48,52,9072.21,15181.01,0.00
2024-12-10 17:44:11,100,12078,48,52,9021.31,15182.00,0.00
2024-12-10 17:44:11,101,12078,48,53,8931.99,15182.01,0.00
2024-12-10 17:44:11,101,12079,48,53,8861.35,15183.00,0.00
2024-12-10 17:44:11,102,12079,48,54,8774.47,15183.01,0.00
2024-12-10 17:44:11,101,12079,47,54,8810.20,15183.09,0.00
2024-12-10 17:44:11,100,12079,46,54,8839.14,15183.28,0.00
2024-12-10 17:44:11,100,12080,46,54,8882.14,15184.00,0.00
2024-12-10 17:44:11,101,12080,46,55,8794.20,15184.01,0.00
2024-12-10 17:44:11,100,12080,45,55,8870.01,15184.07,0.00
2024-12-10 17:44:11,99,12080,45,54,8945.81,15184.09,0.00
2024-12-10 17:44:11,99,12081,45,54,8900.35,15185.00,0.00
2024-12-10 17:44:11,100,12081,46,54,8811.34,15185.01,0.00
2024-12-10 17:44:11,99,12081,46,53,8861.93,15185.09,0.00
2024-12-10 17:44:11,98,12081,45,53,8873.47,15185.43,0.00
2024-12-10 17:44:11,98,12082,45,53,8942.06,15186.00,0.00
2024-12-10 17:44:11,99,12082,45,54,8851.74,15186.01,0.00
2024-12-10 17:44:11,98,12082,45,53,8899.27,15186.10,0.00
2024-12-10 17:44:11,99,12081,45,54,8666.97,15186.66,0.00
2024-12-10 17:44:11,99,12082,45,54,8782.30,15187.00,0.00
2024-12-10 17:44:11,100,12082,45,55,8694.48,15187.01,0.00
2024-12-10 17:44:11,99,12082,44,55,8766.69,15187.10,0.00
2024-12-10 17:44:11,98,12082,43,55,8843.15,15187.11,0.00
2024-12-10 17:44:11,97,12082,43,54,8903.01,15187.11,0.00
2024-12-10 17:44:11,96,12082,42,54,8923.78,15187.58,0.00
2024-12-10 17:44:11,95,12082,41,54,9000.22,15187.71,0.00
2024-12-10 17:44:11,95,12083,41,54,9275.43,15188.00,0.00
2024-12-10 17:44:11,96,12083,42,54,9178.81,15188.01,0.00
2024-12-10 17:44:12,96,12084,42,54,9092.40,15189.00,0.00
2024-12-10 17:44:12,97,12084,43,54,8998.66,15189.01,0.00
2024-12-10 17:44:12,96,12084,43,53,9056.07,15189.17,0.00
2024-12-10 17:44:12,96,12085,43,53,9024.96,15190.00,0.00
2024-12-10 17:44:12,97,12085,44,53,8931.92,15190.01,0.00
2024-12-10 17:44:12,97,12086,44,53,8844.80,15191.00,0.00
2024-12-10 17:44:12,98,12086,44,54,8754.55,15191.01,0.00
2024-12-10 17:44:12,97,12086,43,54,8771.23,15191.07,0.00
2024-12-10 17:44:12,96,12086,43,53,8837.30,15191.16,0.00
2024-12-10 17:44:12,96,12087,43,53,8867.18,15192.00,0.00
2024-12-10 17:44:12,97,12087,44,53,8775.77,15192.01,0.00
2024-12-10 17:44:12,98,12086,44,54,8621.19,15192.25,0.00
2024-12-10 17:44:12,97,12086,43,54,8667.96,15192.74,0.00
2024-12-10 17:44:12,97,12087,43,54,8785.63,15193.00,0.00
2024-12-10 17:44:12,98,12087,43,55,8695.98,15193.01,0.00
2024-12-10 17:44:12,97,12087,43,54,8754.35,15193.15,0.00
2024-12-10 17:44:12,97,12088,43,54,8874.79,15194.00,0.00
2024-12-10 17:44:12,98,12088,44,54,8784.23,15194.01,0.00
2024-12-10 17:44:12,98,12089,44,54,8693.80,15195.00,0.00
2024-12-10 17:44:12,99,12089,44,55,8605.99,15195.01,0.00
2024-12-10 17:44:12,98,12089,43,55,8682.98,15195.07,0.00
2024-12-10 17:44:12,97,12089,43,54,8753.71,15195.14,0.00
2024-12-10 17:44:12,97,12090,43,54,8715.48,15196.00,0.00
2024-12-10 17:44:12,98,12090,44,54,8626.54,15196.01,0.00
2024-12-10 17:44:12,99,12089,45,54,8539.40,15196.03,0.00
2024-12-10 17:44:12,98,12089,44,54,8763.95,15196.06,0.00
2024-12-10 17:44:12,97,12089,43,54,8726.53,15196.26,0.00
2024-12-10 17:44:12,97,12090,43,54,8770.87,15197.00,0.00
2024-12-10 17:44:12,98,12090,44,54,8681.37,15197.01,0.00
2024-12-10 17:44:12,97,12090,44,53,8744.29,15197.13,0.00
2024-12-10 17:44:12,96,12090,43,53,8741.74,15197.74,0.00
2024-12-10 17:44:12,97,12089,43,54,8636.04,15197.86,0.00
2024-12-10 17:44:12,97,12090,43,54,8944.81,15198.00,0.00
2024-12-10 17:44:12,98,12090,44,54,8853.53,15198.01,0.00
2024-12-10 17:44:12,99,12089,45,54,8606.23,15198.45,0.00
2024-12-10 17:44:12,99,12090,45,54,8893.72,15199.00,0.00
2024-12-10 17:44:12,100,12090,45,55,8804.78,15199.01,0.00
2024-12-10 17:44:12,99,12090,45,54,8867.66,15199.13,0.00
2024-12-10 17:44:12,99,12091,45,54,8980.98,15200.00,0.00
2024-12-10 17:44:12,100,12091,46,54,8891.17,15200.01,0.00
2024-12-10 17:44:12,99,12091,45,54,8910.17,15200.26,0.00
2024-12-10 17:44:12,99,12092,45,54,8890.69,15201.00,0.00
2024-12-10 17:44:12,100,12092,46,54,8801.78,15201.01,0.00
2024-12-10 17:44:12,99,12092,46,53,8881.51,15201.06,0.00
2024-12-10 17:44:12,98,12092,46,52,8951.99,15201.12,0.00
2024-12-10 17:44:12,98,12093,46,52,8912.20,15202.00,0.00
2024-12-10 17:44:12,99,12093,46,53,8822.17,15202.01,0.00
2024-12-10 17:44:12,100,12092,47,53,8729.41,15202.06,0.00
2024-12-10 17:44:12,101,12091,48,53,8766.41,15202.08,0.00
2024-12-10 17:44:12,100,12091,47,53,8857.19,15202.26,0.00
2024-12-10 17:44:12,100,12092,47,53,8836.39,15203.00,0.00
2024-12-10 17:44:12,101,12092,48,53,8748.90,15203.01,0.00
2024-12-10 17:44:12,101,12093,48,53,9008.62,15204.00,0.00
2024-12-10 17:44:12,102,12093,49,53,8920.30,15204.01,0.00
2024-12-10 17:44:12,103,12092,49,54,8735.00,15204.49,0.00
2024-12-10 17:44:12,104,12091,49,55,8674.56,15204.74,0.00
2024-12-10 17:44:12,104,12092,49,55,8794.17,15205.00,0.00
2024-12-10 17:44:12,105,12092,50,55,8710.41,15205.01,0.00
2024-12-10 17:44:12,105,12093,50,55,8937.62,15206.00,0.00
2024-12-10 17:44:12,106,12093,50,56,8853.31,15206.01,0.00
2024-12-10 17:44:12,107,12092,50,57,8698.20,15206.32,0.00
2024-12-10 17:44:12,107,12093,50,57,8761.98,15207.00,0.00
2024-12-10 17:44:12,108,12093,50,58,8680.85,15207.01,0.00
2024-12-10 17:44:12,107,12093,50,57,8734.99,15207.04,0.00
2024-12-10 17:44:12,108,12092,50,58,8519.44,15207.94,0.00
2024-12-10 17:44:12,108,12093,50,58,8783.98,15208.00,0.00
2024-12-10 17:44:12,109,12093,51,58,8703.40,15208.01,0.00
2024-12-10 17:44:12,108,12093,51,57,8738.96,15208.11,0.00
2024-12-10 17:44:12,108,12094,51,57,8873.77,15209.00,0.00
2024-12-10 17:44:12,109,12094,52,57,8792.35,15209.01,0.00
2024-12-10 17:44:12,109,12095,52,57,8736.18,15210.00,0.00
2024-12-10 17:44:12,110,12095,52,58,8656.76,15210.01,0.00
2024-12-10 17:44:12,111,12094,53,58,8498.05,15210.38,0.00
2024-12-10 17:44:12,110,12094,52,58,8612.32,15210.58,0.00
2024-12-10 17:44:12,110,12095,52,58,8655.77,15211.00,0.00
2024-12-10 17:44:12,111,12095,53,58,8577.79,15211.01,0.00
2024-12-10 17:44:12,110,12095,52,58,8618.46,15211.06,0.00
2024-12-10 17:44:12,110,12096,52,58,8701.58,15212.00,0.00
2024-12-10 17:44:12,111,12096,52,59,8623.19,15212.01,0.00
2024-12-10 17:44:12,110,12096,52,58,8682.23,15212.04,0.00
2024-12-10 17:44:12,109,12096,51,58,8729.85,15212.25,0.00
2024-12-10 17:44:12,109,12097,51,58,8699.65,15213.00,0.00
2024-12-10 17:44:12,110,12097,51,59,8620.56,15213.01,0.00
2024-12-10 17:44:12,109,12097,50,59,8635.46,15213.05,0.00
2024-12-10 17:44:12,108,12097,49,59,8714.01,15213.06,0.00
2024-12-10 17:44:12,107,12097,49,58,8769.86,15213.08,0.00
2024-12-10 17:44:12,106,12097,48,58,8825.39,15213.25,0.00
2024-12-10 17:44:12,106,12098,48,58,8854.59,15214.00,0.00
2024-12-10 17:44:12,107,12098,49,58,8771.84,15214.01,0.00
2024-12-10 17:44:12,106,12098,48,58,8788.65,15214.25,0.00
2024-12-10 17:44:12,107,12097,49,58,8594.54,15214.90,0.00
2024-12-10 17:44:12,107,12098,49,58,8839.84,15215.00,0.00
2024-12-10 17:44:12,108,12098,50,58,8757.99,15215.01,0.00
2024-12-10 17:44:12,107,12098,49,58,8831.33,15215.06,0.00
2024-12-10 17:44:12,106,12098,48,58,8798.64,15215.52,0.00
2024-12-10 17:44:12,106,12099,48,58,9012.87,15216.00,0.00
2024-12-10 17:44:12,107,12099,49,58,8928.64,15216.01,0.00
2024-12-10 17:44:13,107,12100,49,58,8839.66,15217.00,0.00
2024-12-10 17:44:13,108,12100,50,58,8757.81,15217.01,0.00
2024-12-10 17:44:13,107,12100,50,57,8808.39,15217.07,0.00
2024-12-10 17:44:13,107,12101,50,57,8751.29,15218.00,0.00
2024-12-10 17:44:13,108,12101,50,58,8670.26,15218.01,0.00
2024-12-10 17:44:13,108,12102,50,58,8597.80,15219.00,0.00
2024-12-10 17:44:13,109,12102,50,59,8518.92,15219.01,0.00
2024-12-10 17:44:13,108,12102,50,58,8588.92,15219.06,0.00
2024-12-10 17:44:13,107,12102,49,58,8549.61,15219.41,0.00
2024-12-10 17:44:13,107,12103,49,58,8602.65,15220.00,0.00
2024-12-10 17:44:13,108,12103,50,58,8522.99,15220.01,0.00
2024-12-10 17:44:13,107,12103,49,58,8598.39,15220.03,0.00
2024-12-10 17:44:13,106,12103,48,58,8678.07,15220.03,0.00
2024-12-10 17:44:13,105,12103,48,57,8743.33,15220.05,0.00
2024-12-10 17:44:13,106,12102,48,58,8556.15,15220.38,0.00
2024-12-10 17:44:13,106,12103,48,58,8678.63,15221.00,0.00
2024-12-10 17:44:13,107,12103,49,58,8597.52,15221.01,0.00
2024-12-10 17:44:13,106,12103,49,57,8651.37,15221.05,0.00
2024-12-10 17:44:13,105,12103,48,57,8703.39,15221.25,0.00
2024-12-10 17:44:13,104,12103,47,57,8673.15,15221.65,0.00
2024-12-10 17:44:13,104,12104,47,57,8913.44,15222.00,0.00
2024-12-10 17:44:13,105,12104,47,58,8828.55,15222.01,0.00
2024-12-10 17:44:13,104,12104,47,57,8882.72,15222.06,0.00
2024-12-10 17:44:13,104,12105,47,57,8827.51,15223.00,0.00
2024-12-10 17:44:13,105,12105,48,57,8743.44,15223.01,0.00
2024-12-10 17:44:13,104,12105,48,56,8796.79,15223.06,0.00
2024-12-10 17:44:13,103,12105,47,56,8846.82,15223.28,0.00
2024-12-10 17:44:13,103,12106,47,56,8825.61,15224.00,0.00
2024-12-10 17:44:13,104,12106,48,56,8740.75,15224.01,0.00
2024-12-10 17:44:13,103,12106,48,55,8794.59,15224.06,0.00
2024-12-10 17:44:13,103,12107,48,55,8738.53,15225.00,0.00
2024-12-10 17:44:13,104,12107,48,56,8654.51,15225.01,0.00
2024-12-10 17:44:13,103,12107,48,55,8707.51,15225.06,0.00
2024-12-10 17:44:13,104,12106,49,55,8577.50,15225.38,0.00
2024-12-10 17:44:13,105,12105,50,55,8506.22,15225.82,0.00
2024-12-10 17:44:13,105,12106,50,55,8607.40,15226.00,0.00
2024-12-10 17:44:13,106,12106,50,56,8526.19,15226.01,0.00
2024-12-10 17:44:13,105,12106,50,55,8574.06,15226.06,0.00
2024-12-10 17:44:13,104,12106,49,55,8534.42,15226.58,0.00
2024-12-10 17:44:13,104,12107,49,55,8909.54,15227.00,0.00
2024-12-10 17:44:13,105,12107,49,56,8824.69,15227.01,0.00
2024-12-10 17:44:13,104,12107,48,56,8903.70,15227.04,0.00
2024-12-10 17:44:13,103,12107,48,55,8956.14,15227.06,0.00
2024-12-10 17:44:13,103,12108,48,55,8897.27,15228.00,0.00
2024-12-10 17:44:13,104,12108,49,55,8811.72,15228.01,0.00
2024-12-10 17:44:13,104,12109,49,55,8713.06,15229.00,0.00
2024-12-10 17:44:13,105,12109,50,55,8630.08,15229.01,0.00
2024-12-10 17:44:13,104,12109,50,54,8704.29,15229.06,0.00
2024-12-10 17:44:13,104,12110,50,54,8649.20,15230.00,0.00
2024-12-10 17:44:13,105,12110,50,55,8566.83,15230.01,0.00
2024-12-10 17:44:13,104,12110,49,55,8555.53,15230.15,0.00
2024-12-10 17:44:13,104,12111,49,55,8572.69,15231.00,0.00
2024-12-10 17:44:13,105,12111,50,55,8491.05,15231.01,0.00
2024-12-10 17:44:13,104,12111,50,54,8550.76,15231.11,0.00
2024-12-10 17:44:13,105,12110,50,55,8420.54,15231.34,0.00
2024-12-10 17:44:13,105,12111,50,55,8489.14,15232.00,0.00
2024-12-10 17:44:13,106,12111,50,56,8409.05,15232.01,0.00
2024-12-10 17:44:13,106,12112,50,56,8480.02,15233.00,0.00
2024-12-10 17:44:13,107,12112,51,56,8400.77,15233.01,0.00
2024-12-10 17:44:13,106,12112,51,55,8406.43,15233.27,0.00
2024-12-10 17:44:13,106,12113,51,55,8401.45,15234.00,0.00
2024-12-10 17:44:13,107,12113,51,56,8322.93,15234.01,0.00
2024-12-10 17:44:13,107,12114,51,56,8229.51,15235.00,0.00
2024-12-10 17:44:13,108,12114,52,56,8153.31,15235.01,0.00
2024-12-10 17:44:13,107,12114,52,55,8208.18,15235.11,0.00
2024-12-10 17:44:13,106,12114,51,55,8151.93,15235.90,0.00
2024-12-10 17:44:13,106,12115,51,55,8279.94,15236.00,0.00
2024-12-10 17:44:13,107,12115,51,56,8202.56,15236.01,0.00
2024-12-10 17:44:13,106,12115,50,56,8165.12,15236.44,0.00
2024-12-10 17:44:13,106,12116,50,56,8224.43,15237.00,0.00
2024-12-10 17:44:13,107,12116,50,57,8147.56,15237.01,0.00
2024-12-10 17:44:13,106,12116,50,56,8207.20,15237.11,0.00
2024-12-10 17:44:13,105,12116,49,56,8220.20,15237.43,0.00
2024-12-10 17:44:13,105,12117,49,56,8278.63,15238.00,0.00
2024-12-10 17:44:13,106,12117,50,56,8200.53,15238.01,0.00
2024-12-10 17:44:13,105,12117,49,56,8120.96,15238.74,0.00
2024-12-10 17:44:13,105,12118,49,56,8227.11,15239.00,0.00
2024-12-10 17:44:13,106,12118,49,57,8149.50,15239.01,0.00
2024-12-10 17:44:13,105,12118,48,57,8147.40,15239.33,0.00
2024-12-10 17:44:13,105,12119,48,57,8160.76,15240.00,0.00
2024-12-10 17:44:13,106,12119,48,58,8083.77,15240.01,0.00
2024-12-10 17:44:13,106,12120,48,58,7996.03,15241.00,0.00
2024-12-10 17:44:13,107,12120,48,59,7921.30,15241.01,0.00
2024-12-10 17:44:13,106,12120,47,59,7961.19,15241.11,0.00
2024-12-10 17:44:13,105,12120,47,58,8022.50,15241.11,0.00
2024-12-10 17:44:13,106,12119,47,59,7867.97,15241.65,0.00
2024-12-10 17:44:13,106,12120,47,59,8006.27,15242.00,0.00
2024-12-10 17:44:13,107,12120,47,60,7931.44,15242.01,0.00
2024-12-10 17:44:13,106,12120,47,59,7958.84,15242.13,0.00
2024-12-10 17:44:13,107,12119,47,60,7824.80,15242.54,0.00
2024-12-10 17:44:13,107,12120,47,60,8049.99,15243.00,0.00
2024-12-10 17:44:13,108,12120,47,61,7975.45,15243.01,0.00
2024-12-10 17:44:13,109,12119,47,62,7900.89,15243.04,0.00
2024-12-10 17:44:13,108,12119,47,61,8022.06,15243.14,0.00
2024-12-10 17:44:13,107,12119,46,61,8061.42,15243.16,0.00
2024-12-10 17:44:13,108,12118,47,61,7947.37,15243.44,0.00
2024-12-10 17:44:14,108,12119,47,61,8210.28,15244.00,0.00
2024-12-10 17:44:14,109,12119,47,62,8134.95,15244.01,0.00
2024-12-10 17:44:14,108,12119,47,61,8193.36,15244.04,0.00
2024-12-10 17:44:14,107,12119,46,61,8160.57,15244.76,0.00
2024-12-10 17:44:14,107,12120,46,61,8494.14,15245.00,0.00
2024-12-10 17:44:14,108,12120,46,62,8415.49,15245.01,0.00
2024-12-10 17:44:14,107,12120,45,62,8488.46,15245.04,0.00
2024-12-10 17:44:14,106,12120,45,61,8551.29,15245.08,0.00
2024-12-10 17:44:14,106,12121,45,61,8497.17,15246.00,0.00
2024-12-10 17:44:14,107,12121,46,61,8417.76,15246.01,0.00
2024-12-10 17:44:14,106,12121,46,60,8454.06,15246.11,0.00
2024-12-10 17:44:14,106,12122,46,60,8405.67,15247.00,0.00
2024-12-10 17:44:14,107,12122,47,60,8327.11,15247.01,0.00
2024-12-10 17:44:14,106,12122,47,59,8362.55,15247.11,0.00
2024-12-10 17:44:14,105,12122,46,59,8398.72,15247.34,0.00
2024-12-10 17:44:14,105,12123,46,59,8444.17,15248.00,0.00
2024-12-10 17:44:14,106,12123,46,60,8364.51,15248.01,0.00
2024-12-10 17:44:14,105,12123,46,59,8394.84,15248.13,0.00
2024-12-10 17:44:14,104,12123,45,59,8326.49,15248.96,0.00
2024-12-10 17:44:14,104,12124,45,59,8467.27,15249.00,0.00
2024-12-10 17:44:14,105,12124,46,59,8386.63,15249.01,0.00
2024-12-10 17:44:14,104,12124,46,58,8461.42,15249.04,0.00
2024-12-10 17:44:14,103,12124,45,58,8432.88,15249.56,0.00
2024-12-10 17:44:14,103,12125,45,58,8455.41,15250.00,0.00
2024-12-10 17:44:14,104,12125,46,58,8374.11,15250.01,0.00
2024-12-10 17:44:14,103,12125,46,57,8448.03,15250.05,0.00
2024-12-10 17:44:14,102,12125,46,56,8517.42,15250.13,0.00
2024-12-10 17:44:14,102,12126,46,56,8474.57,15251.00,0.00
2024-12-10 17:44:14,103,12126,47,56,8392.29,15251.01,0.00
2024-12-10 17:44:14,103,12127,47,56,8342.97,15252.00,0.00
2024-12-10 17:44:14,104,12127,48,56,8262.74,15252.01,0.00
2024-12-10 17:44:14,104,12128,48,56,8200.04,15253.00,0.00
2024-12-10 17:44:14,105,12128,48,57,8121.95,15253.01,0.00
2024-12-10 17:44:14,106,12127,48,58,7954.80,15253.43,0.00
2024-12-10 17:44:14,107,12126,49,58,7823.74,15253.92,0.00
2024-12-10 17:44:14,107,12127,49,58,7917.26,15254.00,0.00
2024-12-10 17:44:14,108,12127,50,58,7843.95,15254.01,0.00
2024-12-10 17:44:14,107,12127,50,57,7881.66,15254.13,0.00
2024-12-10 17:44:14,106,12127,49,57,7912.44,15254.42,0.00
2024-12-10 17:44:14,106,12128,49,57,8197.77,15255.00,0.00
2024-12-10 17:44:14,107,12128,49,58,8121.16,15255.01,0.00
2024-12-10 17:44:14,106,12128,49,57,8148.88,15255.14,0.00
2024-12-10 17:44:14,105,12128,48,57,8180.08,15255.38,0.00
2024-12-10 17:44:14,104,12128,47,57,8198.82,15255.77,0.00
2024-12-10 17:44:14,104,12129,47,57,8310.50,15256.00,0.00
2024-12-10 17:44:14,105,12129,47,58,8231.35,15256.01,0.00
2024-12-10 17:44:14,104,12129,46,58,8301.71,15256.06,0.00
2024-12-10 17:44:14,104,12130,46,58,8259.11,15257.00,0.00
2024-12-10 17:44:14,105,12130,47,58,8180.46,15257.01,0.00
2024-12-10 17:44:14,104,12130,46,58,8233.82,15257.11,0.00
2024-12-10 17:44:14,103,12130,45,58,8266.38,15257.21,0.00
2024-12-10 17:44:14,104,12129,46,58,8109.40,15257.74,0.00
2024-12-10 17:44:14,103,12129,45,58,8193.60,15257.93,0.00
2024-12-10 17:44:14,103,12130,45,58,8331.42,15258.00,0.00
2024-12-10 17:44:14,104,12130,45,59,8251.31,15258.01,0.00
2024-12-10 17:44:14,105,12129,45,60,8165.48,15258.08,0.00
2024-12-10 17:44:14,105,12130,45,60,8377.89,15259.00,0.00
2024-12-10 17:44:14,106,12130,46,60,8298.85,15259.01,0.00
2024-12-10 17:44:14,105,12130,46,59,8340.39,15259.12,0.00
2024-12-10 17:44:14,104,12130,45,59,8392.77,15259.31,0.00
2024-12-10 17:44:14,104,12131,45,59,8521.15,15260.00,0.00
2024-12-10 17:44:14,105,12131,45,60,8439.99,15260.01,0.00
2024-12-10 17:44:14,104,12131,45,59,8474.94,15260.13,0.00
2024-12-10 17:44:14,104,12132,45,59,8431.43,15261.00,0.00
2024-12-10 17:44:14,105,12132,46,59,8351.13,15261.01,0.00
2024-12-10 17:44:14,104,12132,46,58,8385.98,15261.13,0.00
2024-12-10 17:44:14,103,12132,45,58,8394.84,15261.26,0.00
2024-12-10 17:44:14,102,12132,44,58,8471.17,15261.30,0.00
2024-12-10 17:44:14,103,12131,44,59,8363.82,15261.49,0.00
2024-12-10 17:44:14,103,12132,44,59,8501.99,15262.00,0.00
2024-12-10 17:44:14,104,12132,45,59,8420.24,15262.01,0.00
2024-12-10 17:44:14,103,12132,45,58,8497.56,15262.03,0.00
2024-12-10 17:44:14,102,12132,45,57,8537.51,15262.13,0.00
2024-12-10 17:44:14,103,12131,46,57,8366.00,15262.73,0.00
2024-12-10 17:44:14,102,12131,45,57,8416.84,15262.93,0.00
2024-12-10 17:44:14,102,12132,45,57,8705.69,15263.00,0.00
2024-12-10 17:44:14,103,12132,46,57,8621.17,15263.01,0.00
2024-12-10 17:44:14,103,12133,46,57,8678.05,15264.00,0.00
2024-12-10 17:44:14,104,12133,47,57,8594.61,15264.01,0.00
2024-12-10 17:44:14,103,12133,47,56,8649.94,15264.17,0.00
2024-12-10 17:44:14,102,12133,46,56,8630.18,15264.60,0.00
2024-12-10 17:44:14,102,12134,46,56,8718.80,15265.00,0.00
2024-12-10 17:44:14,103,12134,47,56,8634.15,15265.01,0.00
2024-12-10 17:44:14,102,12134,46,56,8678.42,15265.06,0.00
2024-12-10 17:44:14,103,12133,47,56,8524.59,15265.34,0.00
2024-12-10 17:44:14,103,12134,47,56,8645.10,15266.00,0.00
2024-12-10 17:44:14,104,12134,47,57,8561.98,15266.01,0.00
2024-12-10 17:44:14,105,12133,47,58,8478.98,15266.04,0.00
2024-12-10 17:44:14,104,12133,47,57,8572.30,15266.16,0.00
2024-12-10 17:44:14,104,12134,47,57,8673.24,15267.00,0.00
2024-12-10 17:44:14,105,12134,48,57,8590.64,15267.01,0.00
2024-12-10 17:44:14,104,12134,47,57,8662.99,15267.07,0.00
2024-12-10 17:44:14,103,12134,46,57,8650.79,15267.20,0.00
2024-12-10 17:44:14,103,12135,46,57,8814.44,15268.00,0.00
2024-12-10 17:44:14,104,12135,47,57,8729.68,15268.01,0.00
2024-12-10 17:44:14,103,12135,47,56,8784.83,15268.17,0.00
2024-12-10 17:44:14,104,12134,48,56,8597.11,15268.71,0.00
2024-12-10 17:44:14,104,12135,48,56,8661.96,15269.00,0.00
2024-12-10 17:44:14,105,12135,49,56,8579.47,15269.01,0.00
2024-12-10 17:44:14,106,12134,50,56,8425.17,15269.32,0.00
2024-12-10 17:44:14,105,12134,49,56,8587.32,15269.36,0.00
2024-12-10 17:44:14,105,12135,49,56,8689.38,15270.00,0.00
2024-12-10 17:44:14,106,12135,49,57,8607.40,15270.01,0.00
2024-12-10 17:44:14,105,12135,49,56,8685.02,15270.03,0.00
2024-12-10 17:44:14,104,12135,49,55,8745.07,15270.15,0.00
2024-12-10 17:44:14,103,12135,48,55,8801.89,15270.33,0.00
2024-12-10 17:44:14,102,12135,47,55,8868.75,15270.38,0.00
2024-12-10 17:44:14,101,12135,47,54,8908.03,15270.55,0.00
2024-12-10 17:44:15,101,12136,47,54,9142.74,15271.00,0.00
2024-12-10 17:44:15,102,12136,48,54,9053.10,15271.01,0.00
2024-12-10 17:44:15,101,12136,47,54,9132.19,15271.07,0.00
2024-12-10 17:44:15,100,12136,46,54,9182.28,15271.14,0.00
2024-12-10 17:44:15,100,12137,46,54,9173.68,15272.00,0.00
2024-12-10 17:44:15,101,12137,46,55,9082.85,15272.01,0.00
2024-12-10 17:44:15,100,12137,46,54,9141.66,15272.16,0.00
2024-12-10 17:44:15,100,12138,46,54,9105.55,15273.00,0.00
2024-12-10 17:44:15,101,12138,47,54,9015.40,15273.01,0.00
2024-12-10 17:44:15,100,12138,46,54,9094.89,15273.07,0.00
2024-12-10 17:44:15,100,12139,46,54,9014.51,15274.00,0.00
2024-12-10 17:44:15,101,12139,46,55,8925.25,15274.01,0.00
2024-12-10 17:44:15,100,12139,46,54,8982.48,15274.16,0.00
2024-12-10 17:44:15,100,12140,46,54,8946.36,15275.00,0.00
2024-12-10 17:44:15,101,12140,46,55,8857.78,15275.01,0.00
2024-12-10 17:44:15,100,12140,45,55,8894.45,15275.05,0.00
2024-12-10 17:44:15,100,12141,45,55,8872.09,15276.00,0.00
2024-12-10 17:44:15,101,12141,46,55,8784.25,15276.01,0.00
2024-12-10 17:44:15,100,12141,45,55,8821.69,15276.03,0.00
2024-12-10 17:44:15,99,12141,44,55,8906.18,15276.05,0.00
2024-12-10 17:44:15,98,12141,44,54,8964.36,15276.17,0.00
2024-12-10 17:44:15,98,12142,44,54,8994.51,15277.00,0.00
2024-12-10 17:44:15,99,12142,44,55,8903.66,15277.01,0.00
2024-12-10 17:44:15,98,12142,43,55,8927.53,15277.16,0.00
2024-12-10 17:44:15,99,12141,44,55,8781.87,15277.34,0.00
2024-12-10 17:44:15,99,12142,44,55,8922.76,15278.00,0.00
2024-12-10 17:44:15,100,12142,44,56,8833.53,15278.01,0.00
2024-12-10 17:44:15,99,12142,43,56,8854.91,15278.15,0.00
2024-12-10 17:44:15,98,12142,43,55,8928.12,15278.17,0.00
2024-12-10 17:44:15,99,12141,44,55,8748.77,15278.78,0.00
2024-12-10 17:44:15,100,12140,44,56,8667.50,15278.91,0.00
2024-12-10 17:44:15,100,12141,44,56,8971.62,15279.00,0.00
2024-12-10 17:44:15,101,12141,44,57,8882.79,15279.01,0.00
2024-12-10 17:44:15,102,12140,45,57,8773.28,15279.18,0.00
2024-12-10 17:44:15,102,12141,45,57,9026.98,15280.00,0.00
2024-12-10 17:44:15,103,12141,46,57,8939.34,15280.01,0.00
2024-12-10 17:44:15,102,12141,46,56,8992.58,15280.17,0.00
2024-12-10 17:44:15,102,12142,46,56,9105.47,15281.00,0.00
2024-12-10 17:44:15,103,12142,46,57,9017.07,15281.01,0.00
2024-12-10 17:44:15,102,12142,46,56,9098.00,15281.05,0.00
2024-12-10 17:44:15,103,12141,46,57,8954.84,15281.23,0.00
2024-12-10 17:44:15,102,12141,45,57,9065.13,15281.27,0.00
2024-12-10 17:44:15,101,12141,44,57,9129.95,15281.44,0.00
2024-12-10 17:44:15,101,12142,44,57,9180.36,15282.00,0.00
2024-12-10 17:44:15,102,12142,44,58,9090.36,15282.01,0.00
2024-12-10 17:44:15,101,12142,44,57,9172.82,15282.05,0.00
2024-12-10 17:44:15,101,12143,44,57,9277.12,15283.00,0.00
2024-12-10 17:44:15,102,12143,44,58,9186.17,15283.01,0.00
2024-12-10 17:44:15,102,12144,44,58,9111.37,15284.00,0.00
2024-12-10 17:44:15,103,12144,45,58,9022.91,15284.01,0.00
2024-12-10 17:44:15,102,12144,45,57,9102.40,15284.06,0.00
2024-12-10 17:44:15,101,12144,44,57,8986.73,15284.81,0.00
2024-12-10 17:44:15,101,12145,44,57,9109.46,15285.00,0.00
2024-12-10 17:44:15,102,12145,44,58,9020.16,15285.01,0.00
2024-12-10 17:44:15,101,12145,44,57,9082.27,15285.14,0.00
2024-12-10 17:44:15,100,12145,43,57,9153.28,15285.27,0.00
2024-12-10 17:44:15,100,12146,43,57,9133.90,15286.00,0.00
2024-12-10 17:44:15,101,12146,43,58,9043.47,15286.01,0.00
2024-12-10 17:44:15,100,12146,42,58,9001.02,15286.28,0.00
2024-12-10 17:44:15,100,12147,42,58,9044.31,15287.00,0.00
2024-12-10 17:44:15,101,12147,43,58,8954.76,15287.01,0.00
2024-12-10 17:44:15,100,12147,43,57,9035.16,15287.06,0.00
2024-12-10 17:44:15,99,12147,43,56,9115.61,15287.06,0.00
2024-12-10 17:44:15,98,12147,42,56,9141.61,15287.19,0.00
2024-12-10 17:44:15,98,12148,42,56,9174.89,15288.00,0.00
2024-12-10 17:44:15,99,12148,42,57,9082.21,15288.01,0.00
2024-12-10 17:44:15,98,12148,41,57,9148.39,15288.07,0.00
2024-12-10 17:44:15,97,12148,41,56,9223.82,15288.14,0.00
2024-12-10 17:44:15,98,12147,42,56,9070.62,15288.55,0.00
2024-12-10 17:44:15,98,12148,42,56,9209.81,15289.00,0.00
2024-12-10 17:44:15,99,12148,43,56,9116.78,15289.01,0.00
2024-12-10 17:44:15,98,12148,42,56,9141.27,15289.25,0.00
2024-12-10 17:44:15,98,12149,42,56,9339.91,15290.00,0.00
2024-12-10 17:44:15,99,12149,42,57,9245.57,15290.01,0.00
2024-12-10 17:44:15,98,12149,42,56,9300.98,15290.17,0.00
2024-12-10 17:44:15,98,12150,42,56,9268.75,15291.00,0.00
2024-12-10 17:44:15,99,12150,43,56,9175.12,15291.01,0.00
2024-12-10 17:44:15,98,12150,43,55,9240.69,15291.07,0.00
2024-12-10 17:44:15,97,12150,42,55,9307.65,15291.25,0.00
2024-12-10 17:44:15,96,12150,41,55,9264.74,15291.74,0.00
2024-12-10 17:44:15,96,12151,41,55,9384.41,15292.00,0.00
2024-12-10 17:44:15,97,12151,42,55,9287.67,15292.01,0.00
2024-12-10 17:44:15,97,12152,42,55,9220.44,15293.00,0.00
2024-12-10 17:44:15,98,12152,42,56,9126.36,15293.01,0.00
2024-12-10 17:44:15,98,12153,42,56,9038.00,15294.00,0.00
2024-12-10 17:44:15,99,12153,42,57,8946.70,15294.01,0.00
2024-12-10 17:44:15,98,12153,42,56,9014.60,15294.06,0.00
2024-12-10 17:44:15,98,12154,42,56,8965.23,15295.00,0.00
2024-12-10 17:44:15,99,12154,42,57,8874.68,15295.01,0.00
2024-12-10 17:44:15,100,12153,43,57,8703.47,15295.37,0.00
2024-12-10 17:44:15,101,12152,43,58,8631.04,15295.55,0.00
2024-12-10 17:44:16,101,12153,43,58,8707.08,15296.00,0.00
2024-12-10 17:44:16,102,12153,43,59,8621.72,15296.01,0.00
2024-12-10 17:44:16,101,12153,42,59,8705.57,15296.01,0.00
2024-12-10 17:44:16,100,12153,42,58,8755.95,15296.10,0.00
2024-12-10 17:44:16,99,12153,41,58,8747.40,15296.73,0.00
2024-12-10 17:44:16,99,12154,41,58,9107.61,15297.00,0.00
2024-12-10 17:44:16,100,12154,42,58,9016.53,15297.01,0.00
2024-12-10 17:44:16,101,12153,42,59,8924.24,15297.05,0.00
2024-12-10 17:44:16,102,12152,42,60,8949.24,15297.08,0.00
2024-12-10 17:44:16,101,12152,42,59,9087.86,15297.15,0.00
2024-12-10 17:44:16,100,12152,41,59,9043.07,15297.91,0.00
2024-12-10 17:44:16,100,12153,41,59,9182.34,15298.00,0.00
2024-12-10 17:44:16,101,12153,42,59,9091.43,15298.01,0.00
2024-12-10 17:44:16,101,12154,42,59,9347.50,15299.00,0.00
2024-12-10 17:44:16,102,12154,43,59,9255.86,15299.01,0.00
2024-12-10 17:44:16,102,12154,43,59,9193.26,15300.00,0.00
2024-12-10 17:44:16,103,12154,43,60,9104.01,15300.01,0.00
2024-12-10 17:44:16,103,12155,43,60,9017.92,15301.00,0.00
2024-12-10 17:44:16,104,12155,44,60,8931.21,15301.01,0.00
2024-12-10 17:44:16,103,12155,44,59,8974.90,15301.13,0.00
2024-12-10 17:44:16,104,12154,45,59,8851.92,15301.38,0.00
2024-12-10 17:44:16,103,12154,44,59,8879.10,15301.98,0.00
2024-12-10 17:44:16,103,12155,44,59,9024.71,15302.00,0.00
2024-12-10 17:44:16,104,12155,44,60,8937.93,15302.01,0.00
2024-12-10 17:44:16,105,12154,44,61,8852.81,15302.03,0.00
2024-12-10 17:44:16,104,12154,44,60,8940.93,15302.14,0.00
2024-12-10 17:44:16,104,12155,44,60,9045.93,15303.00,0.00
2024-12-10 17:44:16,105,12155,44,61,8959.78,15303.01,0.00
2024-12-10 17:44:16,106,12154,45,61,8793.11,15303.38,0.00
2024-12-10 17:44:16,105,12154,44,61,8846.59,15303.85,0.00
2024-12-10 17:44:16,105,12155,44,61,9114.89,15304.00,0.00
2024-12-10 17:44:16,106,12155,44,62,9028.90,15304.01,0.00
2024-12-10 17:44:16,105,12155,44,61,9109.09,15304.04,0.00
2024-12-10 17:44:16,104,12155,44,60,9193.74,15304.05,0.00
2024-12-10 17:44:16,103,12155,44,59,9266.68,15304.13,0.00
2024-12-10 17:44:16,102,12155,43,59,9236.40,15304.83,0.00
2024-12-10 17:44:16,102,12156,43,59,9511.13,15305.00,0.00
2024-12-10 17:44:16,103,12156,43,60,9418.79,15305.01,0.00
2024-12-10 17:44:16,104,12155,44,60,9328.23,15305.03,0.00
2024-12-10 17:44:16,103,12155,43,60,9383.18,15305.12,0.00
2024-12-10 17:44:16,103,12156,43,60,9367.40,15306.00,0.00
2024-12-10 17:44:16,104,12156,43,61,9277.33,15306.01,0.00
2024-12-10 17:44:16,103,12156,43,60,9348.13,15306.12,0.00
2024-12-10 17:44:16,102,12156,42,60,9354.44,15306.49,0.00
2024-12-10 17:44:16,102,12157,42,60,9576.91,15307.00,0.00
2024-12-10 17:44:16,103,12157,43,60,9483.93,15307.01,0.00
2024-12-10 17:44:16,104,12156,44,60,9386.88,15307.07,0.00
2024-12-10 17:44:16,104,12157,44,60,9343.31,15308.00,0.00
2024-12-10 17:44:16,105,12157,44,61,9254.32,15308.01,0.00
2024-12-10 17:44:16,104,12157,43,61,9318.34,15308.10,0.00
2024-12-10 17:44:16,103,12157,43,60,9399.89,15308.12,0.00
2024-12-10 17:44:16,104,12156,44,60,9275.75,15308.36,0.00
2024-12-10 17:44:16,105,12155,45,60,9193.33,15308.51,0.00
2024-12-10 17:44:16,106,12154,46,60,9118.37,15308.84,0.00
2024-12-10 17:44:16,106,12155,46,60,9398.69,15309.00,0.00
2024-12-10 17:44:16,107,12155,47,60,9310.86,15309.01,0.00
2024-12-10 17:44:16,106,12155,46,60,9270.27,15309.27,0.00
2024-12-10 17:44:16,107,12154,47,60,9125.19,15309.67,0.00
2024-12-10 17:44:16,107,12155,47,60,9684.91,15310.00,0.00
2024-12-10 17:44:16,108,12155,48,60,9595.24,15310.01,0.00
2024-12-10 17:44:16,107,12155,48,59,9664.93,15310.11,0.00
2024-12-10 17:44:16,108,12154,48,60,9545.76,15310.32,0.00
2024-12-10 17:44:16,108,12155,48,60,9671.00,15311.00,0.00
2024-12-10 17:44:16,109,12155,49,60,9582.28,15311.01,0.00
2024-12-10 17:44:16,110,12154,50,60,9491.01,15311.05,0.00
2024-12-10 17:44:16,109,12154,50,59,9559.85,15311.11,0.00
2024-12-10 17:44:16,108,12154,49,59,9578.95,15311.23,0.00
2024-12-10 17:44:16,109,12153,50,59,9451.87,15311.50,0.00
2024-12-10 17:44:16,110,12152,51,59,9398.06,15311.67,0.00
2024-12-10 17:44:16,110,12153,51,59,9661.43,15312.00,0.00
2024-12-10 17:44:16,111,12153,52,59,9574.39,15312.01,0.00
2024-12-10 17:44:16,110,12153,51,59,9529.43,15312.49,0.00
2024-12-10 17:44:16,111,12152,52,59,9436.71,15312.55,0.00
2024-12-10 17:44:16,112,12151,52,60,9390.77,15312.61,0.00
2024-12-10 17:44:16,112,12152,52,60,9918.84,15313.00,0.00
2024-12-10 17:44:16,113,12152,52,61,9831.06,15313.01,0.00
2024-12-10 17:44:16,112,12152,52,60,9907.94,15313.07,0.00
2024-12-10 17:44:16,111,12152,52,59,9987.56,15313.10,0.00
2024-12-10 17:44:16,112,12151,53,59,9818.00,15313.64,0.00
2024-12-10 17:44:16,113,12150,54,59,9751.52,15313.73,0.00
2024-12-10 17:44:16,113,12151,54,59,10083.78,15314.00,0.00
2024-12-10 17:44:16,114,12151,55,59,9995.32,15314.01,0.00
2024-12-10 17:44:16,114,12152,55,59,10166.12,15315.00,0.00
2024-12-10 17:44:16,115,12152,56,59,10077.72,15315.01,0.00
2024-12-10 17:44:16,114,12152,56,58,10148.71,15315.10,0.00
2024-12-10 17:44:16,114,12153,56,58,10089.35,15316.00,0.00
2024-12-10 17:44:16,115,12153,57,58,10001.61,15316.01,0.00
2024-12-10 17:44:16,116,12152,57,59,9863.97,15316.19,0.00
2024-12-10 17:44:16,116,12153,57,59,9909.21,15317.00,0.00
2024-12-10 17:44:16,117,12153,58,59,9824.52,15317.01,0.00
2024-12-10 17:44:16,116,12153,58,58,9892.09,15317.09,0.00
2024-12-10 17:44:16,117,12152,58,59,9754.03,15317.46,0.00
2024-12-10 17:44:16,117,12153,58,59,9928.71,15318.00,0.00
2024-12-10 17:44:16,118,12153,59,59,9844.57,15318.01,0.00
2024-12-10 17:44:16,117,12153,58,59,9798.12,15318.40,0.00
2024-12-10 17:44:16,118,12152,59,59,9651.79,15318.83,0.00
2024-12-10 17:44:16,118,12153,59,59,9893.07,15319.00,0.00
2024-12-10 17:44:16,119,12153,60,59,9809.93,15319.01,0.00
2024-12-10 17:44:16,118,12153,59,59,9810.40,15319.30,0.00
2024-12-10 17:44:16,118,12154,59,59,9958.05,15320.00,0.00
2024-12-10 17:44:16,119,12154,59,60,9874.36,15320.01,0.00
2024-12-10 17:44:16,118,12154,59,59,9941.21,15320.09,0.00
2024-12-10 17:44:16,118,12155,59,59,9870.45,15321.00,0.00
2024-12-10 17:44:16,119,12155,59,60,9787.50,15321.01,0.00
2024-12-10 17:44:16,118,12155,59,59,9830.24,15321.09,0.00
2024-12-10 17:44:17,118,12156,59,59,9749.07,15322.00,0.00
2024-12-10 17:44:17,119,12156,59,60,9667.15,15322.01,0.00
2024-12-10 17:44:17,118,12156,59,59,9710.16,15322.09,0.00
2024-12-10 17:44:17,119,12155,60,59,9624.70,15322.13,0.00
2024-12-10 17:44:17,118,12155,59,59,9714.14,15322.30,0.00
2024-12-10 17:44:17,118,12156,59,59,9651.65,15323.00,0.00
2024-12-10 17:44:17,119,12156,59,60,9570.54,15323.01,0.00
2024-12-10 17:44:17,118,12156,59,59,9612.74,15323.09,0.00
2024-12-10 17:44:17,119,12155,59,60,9330.24,15323.82,0.00
2024-12-10 17:44:17,119,12156,59,60,9571.43,15324.00,0.00
2024-12-10 17:44:17,120,12156,60,60,9491.67,15324.01,0.00
2024-12-10 17:44:17,119,12156,60,59,9534.12,15324.09,0.00
2024-12-10 17:44:17,118,12156,60,58,9475.95,15324.51,0.00
2024-12-10 17:44:17,118,12157,60,58,9657.50,15325.00,0.00
2024-12-10 17:44:17,119,12157,61,58,9576.34,15325.01,0.00
2024-12-10 17:44:17,118,12157,60,58,9648.44,15325.06,0.00
2024-12-10 17:44:17,117,12157,60,57,9728.29,15325.07,0.00
2024-12-10 17:44:17,116,12157,60,56,9785.73,15325.08,0.00
2024-12-10 17:44:17,116,12158,60,56,9719.29,15326.00,0.00
2024-12-10 17:44:17,117,12158,61,56,9636.22,15326.01,0.00
2024-12-10 17:44:17,116,12158,60,56,9654.67,15326.26,0.00
2024-12-10 17:44:17,116,12159,60,56,9649.99,15327.00,0.00
2024-12-10 17:44:17,117,12159,60,57,9567.51,15327.01,0.00
2024-12-10 17:44:17,118,12158,60,58,9375.01,15327.58,0.00
2024-12-10 17:44:17,119,12157,60,59,9325.88,15327.63,0.00
2024-12-10 17:44:17,119,12158,60,59,9390.99,15328.00,0.00
2024-12-10 17:44:17,120,12158,61,59,9312.73,15328.01,0.00
2024-12-10 17:44:17,119,12158,60,59,9321.62,15328.28,0.00
2024-12-10 17:44:17,118,12158,59,59,9399.31,15328.28,0.00
2024-12-10 17:44:17,119,12157,59,60,9299.79,15328.43,0.00
2024-12-10 17:44:17,119,12158,59,60,9589.24,15329.00,0.00
2024-12-10 17:44:17,120,12158,60,60,9509.33,15329.01,0.00
2024-12-10 17:44:17,119,12158,59,60,9437.00,15329.80,0.00
2024-12-10 17:44:17,119,12159,59,60,9612.35,15330.00,0.00
2024-12-10 17:44:17,120,12159,59,61,9532.24,15330.01,0.00
2024-12-10 17:44:17,119,12159,59,60,9585.33,15330.08,0.00
2024-12-10 17:44:17,119,12160,59,60,9515.89,15331.00,0.00
2024-12-10 17:44:17,120,12160,60,60,9436.59,15331.01,0.00
2024-12-10 17:44:17,119,12160,60,59,9436.04,15331.08,0.00
2024-12-10 17:44:17,119,12161,60,59,9417.69,15332.00,0.00
2024-12-10 17:44:17,120,12161,61,59,9339.21,15332.01,0.00
2024-12-10 17:44:17,121,12160,61,60,9154.72,15332.52,0.00
2024-12-10 17:44:17,121,12161,61,60,9217.66,15333.00,0.00
2024-12-10 17:44:17,122,12161,61,61,9142.11,15333.01,0.00
2024-12-10 17:44:17,121,12161,61,60,9160.16,15333.18,0.00
2024-12-10 17:44:17,120,12161,60,60,9152.50,15333.73,0.00
2024-12-10 17:44:17,120,12162,60,60,9345.28,15334.00,0.00
2024-12-10 17:44:17,121,12162,61,60,9268.05,15334.01,0.00
2024-12-10 17:44:17,120,12162,61,59,9328.69,15334.05,0.00
2024-12-10 17:44:17,119,12162,60,59,9355.65,15334.34,0.00
2024-12-10 17:44:17,119,12163,60,59,9383.19,15335.00,0.00
2024-12-10 17:44:17,120,12163,60,60,9305.00,15335.01,0.00
2024-12-10 17:44:17,120,12164,60,60,9211.93,15336.00,0.00
2024-12-10 17:44:17,121,12164,60,61,9135.80,15336.01,0.00
2024-12-10 17:44:17,120,12164,60,60,9176.17,15336.07,0.00
2024-12-10 17:44:17,121,12163,61,60,9040.94,15336.47,0.00
2024-12-10 17:44:17,121,12164,61,60,9070.48,15337.00,0.00
2024-12-10 17:44:17,122,12164,62,60,8996.13,15337.01,0.00
2024-12-10 17:44:17,121,12164,62,59,9035.03,15337.10,0.00
2024-12-10 17:44:17,120,12164,61,59,9050.29,15337.22,0.00
2024-12-10 17:44:17,119,12164,60,59,9118.64,15337.27,0.00
2024-12-10 17:44:17,120,12163,60,60,9003.18,15337.54,0.00
2024-12-10 17:44:17,120,12164,60,60,9231.03,15338.00,0.00
2024-12-10 17:44:17,121,12164,60,61,9154.74,15338.01,0.00
2024-12-10 17:44:17,120,12164,60,60,9196.55,15338.10,0.00
2024-12-10 17:44:17,119,12164,59,60,9223.60,15338.19,0.00
2024-12-10 17:44:17,119,12165,59,60,9358.19,15339.00,0.00
2024-12-10 17:44:17,120,12165,59,61,9280.20,15339.01,0.00
2024-12-10 17:44:17,119,12165,59,60,9335.01,15339.08,0.00
2024-12-10 17:44:17,120,12164,60,60,9199.88,15339.47,0.00
2024-12-10 17:44:17,119,12164,59,60,9227.13,15339.77,0.00
2024-12-10 17:44:17,119,12165,59,60,9321.41,15340.00,0.00
2024-12-10 17:44:17,120,12165,60,60,9243.73,15340.01,0.00
2024-12-10 17:44:17,119,12165,60,59,9285.36,15340.11,0.00
2024-12-10 17:44:17,118,12165,59,59,9240.81,15340.58,0.00
2024-12-10 17:44:17,119,12164,60,59,9105.43,15340.97,0.00
2024-12-10 17:44:17,119,12165,60,59,9361.99,15341.00,0.00
2024-12-10 17:44:17,120,12165,61,59,9283.97,15341.01,0.00
2024-12-10 17:44:17,119,12165,61,58,9325.93,15341.11,0.00
2024-12-10 17:44:17,118,12165,60,58,9369.87,15341.15,0.00
2024-12-10 17:44:17,119,12164,61,58,9282.14,15341.23,0.00
2024-12-10 17:44:17,118,12164,60,58,9289.19,15341.89,0.00
2024-12-10 17:44:17,118,12165,60,58,9532.41,15342.00,0.00
2024-12-10 17:44:17,119,12165,60,59,9452.31,15342.01,0.00
2024-12-10 17:44:17,118,12165,60,58,9493.45,15342.12,0.00
2024-12-10 17:44:17,118,12166,60,58,9566.84,15343.00,0.00
2024-12-10 17:44:17,119,12166,60,59,9486.45,15343.01,0.00
2024-12-10 17:44:17,118,12166,60,58,9522.91,15343.13,0.00
2024-12-10 17:44:17,118,12167,60,58,9467.58,15344.00,0.00
2024-12-10 17:44:17,119,12167,60,59,9388.02,15344.01,0.00
2024-12-10 17:44:17,119,12168,60,59,9283.89,15345.00,0.00
2024-12-10 17:44:17,120,12168,60,60,9206.52,15345.01,0.00
2024-12-10 17:44:17,119,12168,59,60,9243.09,15345.04,0.00
2024-12-10 17:44:17,118,12168,59,59,9291.54,15345.12,0.00
2024-12-10 17:44:17,117,12168,58,59,9348.72,15345.26,0.00
2024-12-10 17:44:17,117,12169,58,59,9367.60,15346.00,0.00
2024-12-10 17:44:17,118,12169,58,60,9288.21,15346.01,0.00
2024-12-10 17:44:17,117,12169,58,59,9365.07,15346.02,0.00
2024-12-10 17:44:17,118,12168,58,60,9277.91,15346.08,0.00
2024-12-10 17:44:17,117,12168,58,59,9378.22,15346.13,0.00
2024-12-10 17:44:18,118,12167,58,60,9143.07,15346.82,0.00
2024-12-10 17:44:18,118,12168,58,60,9266.79,15347.00,0.00
2024-12-10 17:44:18,119,12168,58,61,9188.92,15347.01,0.00
2024-12-10 17:44:18,118,12168,57,61,9259.00,15347.05,0.00
2024-12-10 17:44:18,117,12168,56,61,9260.86,15347.31,0.00
2024-12-10 17:44:18,117,12169,56,61,9548.62,15348.00,0.00
2024-12-10 17:44:18,118,12169,57,61,9467.70,15348.01,0.00
2024-12-10 17:44:18,117,12169,56,61,9525.04,15348.09,0.00
2024-12-10 17:44:18,118,12168,57,61,9374.23,15348.40,0.00
2024-12-10 17:44:18,117,12168,56,61,9423.10,15348.77,0.00
2024-12-10 17:44:18,117,12169,56,61,9519.07,15349.00,0.00
2024-12-10 17:44:18,118,12169,57,61,9438.40,15349.01,0.00
2024-12-10 17:44:18,119,12168,58,61,9348.80,15349.09,0.00
2024-12-10 17:44:18,118,12168,58,60,9448.85,15349.11,0.00
2024-12-10 17:44:18,118,12169,58,60,9520.97,15350.00,0.00
2024-12-10 17:44:18,119,12169,58,61,9440.97,15350.01,0.00
2024-12-10 17:44:18,119,12170,58,61,9496.23,15351.00,0.00
2024-12-10 17:44:18,120,12170,58,62,9417.10,15351.01,0.00
2024-12-10 17:44:18,121,12169,59,62,9199.19,15351.48,0.00
2024-12-10 17:44:18,121,12170,59,62,9349.29,15352.00,0.00
2024-12-10 17:44:18,122,12170,59,63,9272.66,15352.01,0.00
2024-12-10 17:44:18,121,12170,59,62,9309.99,15352.10,0.00
2024-12-10 17:44:18,120,12170,58,62,9327.81,15352.32,0.00
2024-12-10 17:44:18,121,12169,59,62,9229.24,15352.47,0.00
2024-12-10 17:44:18,121,12170,59,62,9455.48,15353.00,0.00
2024-12-10 17:44:18,122,12170,59,63,9377.98,15353.01,0.00
2024-12-10 17:44:18,121,12170,58,63,9445.36,15353.07,0.00
2024-12-10 17:44:18,120,12170,58,62,9494.65,15353.09,0.00
2024-12-10 17:44:18,121,12169,59,62,9284.50,15353.64,0.00
2024-12-10 17:44:18,121,12170,59,62,9532.18,15354.00,0.00
2024-12-10 17:44:18,122,12170,60,62,9454.05,15354.01,0.00
2024-12-10 17:44:18,123,12169,61,62,9196.56,15354.96,0.00
2024-12-10 17:44:18,123,12170,61,62,9442.52,15355.00,0.00
2024-12-10 17:44:18,124,12170,61,63,9366.37,15355.01,0.00
2024-12-10 17:44:18,124,12171,61,63,9417.27,15356.00,0.00
2024-12-10 17:44:18,125,12171,62,63,9341.93,15356.01,0.00
2024-12-10 17:44:18,125,12172,62,63,9250.35,15357.00,0.00
2024-12-10 17:44:18,126,12172,62,64,9176.94,15357.01,0.00
2024-12-10 17:44:18,125,12172,61,64,9244.22,15357.04,0.00
2024-12-10 17:44:18,124,12172,60,64,9313.84,15357.06,0.00
2024-12-10 17:44:18,124,12173,60,64,9220.28,15358.00,0.00
2024-12-10 17:44:18,125,12173,61,64,9146.52,15358.01,0.00
2024-12-10 17:44:18,124,12173,61,63,9202.98,15358.09,0.00
2024-12-10 17:44:18,124,12174,61,63,9137.90,15359.00,0.00
2024-12-10 17:44:18,125,12174,62,63,9064.79,15359.01,0.00
2024-12-10 17:44:18,124,12174,62,62,9098.29,15359.10,0.00
2024-12-10 17:44:18,124,12175,62,62,9035.68,15360.00,0.00
2024-12-10 17:44:18,125,12175,63,62,8963.39,15360.01,0.00
2024-12-10 17:44:18,125,12176,63,62,8860.75,15361.00,0.00
2024-12-10 17:44:18,126,12176,64,62,8790.43,15361.01,0.00
2024-12-10 17:44:18,125,12176,64,61,8842.35,15361.12,0.00
2024-12-10 17:44:18,126,12175,65,61,8678.63,15361.75,0.00
2024-12-10 17:44:18,126,12176,65,61,8738.58,15362.00,0.00
2024-12-10 17:44:18,127,12176,65,62,8669.77,15362.01,0.00
2024-12-10 17:44:18,126,12176,64,62,8711.78,15362.10,0.00
2024-12-10 17:44:18,126,12177,64,62,8792.79,15363.00,0.00
2024-12-10 17:44:18,127,12177,64,63,8723.56,15363.01,0.00
2024-12-10 17:44:18,126,12177,63,63,8783.06,15363.06,0.00
2024-12-10 17:44:18,127,12176,63,64,8680.05,15363.14,0.00
2024-12-10 17:44:18,127,12177,63,64,8683.00,15364.00,0.00
2024-12-10 17:44:18,128,12177,64,64,8615.16,15364.01,0.00
2024-12-10 17:44:18,127,12177,64,63,8657.62,15364.10,0.00
2024-12-10 17:44:18,126,12177,63,63,8631.43,15364.56,0.00
2024-12-10 17:44:18,126,12178,63,63,8807.35,15365.00,0.00
2024-12-10 17:44:18,127,12178,64,63,8738.00,15365.01,0.00
2024-12-10 17:44:18,128,12177,64,64,8559.54,15365.59,0.00
2024-12-10 17:44:18,129,12176,65,64,8489.91,15365.68,0.00
2024-12-10 17:44:18,130,12175,66,64,8424.77,15365.90,0.00
2024-12-10 17:44:18,130,12176,66,64,8558.88,15366.00,0.00
2024-12-10 17:44:18,131,12176,66,65,8493.55,15366.01,0.00
2024-12-10 17:44:18,130,12176,65,65,8440.73,15366.62,0.00
2024-12-10 17:44:18,130,12177,65,65,8808.63,15367.00,0.00
2024-12-10 17:44:18,131,12177,66,65,8741.39,15367.01,0.00
2024-12-10 17:44:18,132,12176,67,65,8675.16,15367.02,0.00
2024-12-10 17:44:18,133,12175,67,66,8678.12,15367.05,0.00
2024-12-10 17:44:18,132,12175,67,65,8830.04,15367.11,0.00
2024-12-10 17:44:18,131,12175,66,65,8867.02,15367.31,0.00
2024-12-10 17:44:18,132,12174,67,65,8760.39,15367.58,0.00
2024-12-10 17:44:18,132,12175,67,65,8810.78,15368.00,0.00
2024-12-10 17:44:18,133,12175,67,66,8744.53,15368.01,0.00
2024-12-10 17:44:18,134,12174,67,67,8622.02,15368.25,0.00
2024-12-10 17:44:18,134,12175,67,67,8967.07,15369.00,0.00
2024-12-10 17:44:18,135,12175,68,67,8900.65,15369.01,0.00
2024-12-10 17:44:18,136,12174,69,67,8781.04,15369.23,0.00
2024-12-10 17:44:18,137,12173,70,67,8691.54,15369.90,0.00
2024-12-10 17:44:19,137,12174,70,67,8870.93,15370.00,0.00
2024-12-10 17:44:19,138,12174,70,68,8806.65,15370.01,0.00
2024-12-10 17:44:19,137,12174,70,67,8857.50,15370.06,0.00
2024-12-10 17:44:19,138,12173,70,68,8784.42,15370.13,0.00
2024-12-10 17:44:19,138,12174,70,68,9031.10,15371.00,0.00
2024-12-10 17:44:19,139,12174,71,68,8966.13,15371.01,0.00
2024-12-10 17:44:19,138,12174,70,68,9027.77,15371.02,0.00
2024-12-10 17:44:19,137,12174,70,67,9064.52,15371.08,0.00
2024-12-10 17:44:19,138,12173,71,67,8977.73,15371.23,0.00
2024-12-10 17:44:19,137,12173,70,67,9065.75,15371.32,0.00
2024-12-10 17:44:19,136,12173,69,67,9130.15,15371.33,0.00
2024-12-10 17:44:19,136,12174,69,67,9208.59,15372.00,0.00
2024-12-10 17:44:19,137,12174,69,68,9141.38,15372.01,0.00
2024-12-10 17:44:19,137,12175,69,68,9180.71,15373.00,0.00
2024-12-10 17:44:19,138,12175,69,69,9114.18,15373.01,0.00
2024-12-10 17:44:19,139,12174,69,70,9011.05,15373.12,0.00
2024-12-10 17:44:19,140,12173,69,71,8921.51,15373.79,0.00
2024-12-10 17:44:19,140,12174,69,71,9017.23,15374.00,0.00
2024-12-10 17:44:19,141,12174,69,72,8953.27,15374.01,0.00
2024-12-10 17:44:19,140,12174,68,72,8944.17,15374.31,0.00
2024-12-10 17:44:19,140,12175,68,72,9168.66,15375.00,0.00
2024-12-10 17:44:19,141,12175,69,72,9103.63,15375.01,0.00
2024-12-10 17:44:19,140,12175,69,71,9161.00,15375.05,0.00
2024-12-10 17:44:19,139,12175,69,70,9209.21,15375.08,0.00
2024-12-10 17:44:19,138,12175,68,70,9192.49,15375.33,0.00
2024-12-10 17:44:19,138,12176,68,70,9201.86,15376.00,0.00
2024-12-10 17:44:19,139,12176,68,71,9135.66,15376.01,0.00
2024-12-10 17:44:19,138,12176,68,70,9191.86,15376.05,0.00
2024-12-10 17:44:19,139,12175,68,71,9063.95,15376.47,0.00
2024-12-10 17:44:19,138,12175,67,71,9137.63,15376.75,0.00
2024-12-10 17:44:19,137,12175,66,71,9181.94,15376.83,0.00
2024-12-10 17:44:19,137,12176,66,71,9268.51,15377.00,0.00
2024-12-10 17:44:19,138,12176,67,71,9201.35,15377.01,0.00
2024-12-10 17:44:19,137,12176,66,71,9185.94,15377.34,0.00
2024-12-10 17:44:19,137,12177,66,71,9308.75,15378.00,0.00
2024-12-10 17:44:19,138,12177,66,72,9241.30,15378.01,0.00
2024-12-10 17:44:19,139,12176,67,72,9014.91,15378.92,0.00
2024-12-10 17:44:19,139,12177,67,72,9107.10,15379.00,0.00
2024-12-10 17:44:19,140,12177,68,72,9042.05,15379.01,0.00
2024-12-10 17:44:19,139,12177,68,71,9099.38,15379.05,0.00
2024-12-10 17:44:19,140,12176,68,72,8981.72,15379.26,0.00
2024-12-10 17:44:19,141,12175,69,72,8910.70,15379.80,0.00
2024-12-10 17:44:19,141,12176,69,72,9089.02,15380.00,0.00
2024-12-10 17:44:19,142,12176,70,72,9025.01,15380.01,0.00
2024-12-10 17:44:19,141,12176,69,72,9081.41,15380.05,0.00
2024-12-10 17:44:19,141,12177,69,72,9200.65,15381.00,0.00
2024-12-10 17:44:19,142,12177,70,72,9135.85,15381.01,0.00
2024-12-10 17:44:19,141,12177,70,71,9176.68,15381.07,0.00
2024-12-10 17:44:19,141,12178,70,71,9099.78,15382.00,0.00
2024-12-10 17:44:19,142,12178,71,71,9035.70,15382.01,0.00
2024-12-10 17:44:19,141,12178,71,70,9076.91,15382.07,0.00
2024-12-10 17:44:19,142,12177,71,71,8867.08,15382.75,0.00
2024-12-10 17:44:19,142,12178,71,71,8957.21,15383.00,0.00
2024-12-10 17:44:19,143,12178,71,72,8894.57,15383.01,0.00
2024-12-10 17:44:19,142,12178,71,71,8934.49,15383.07,0.00
2024-12-10 17:44:19,141,12178,70,71,8920.48,15383.32,0.00
2024-12-10 17:44:19,141,12179,70,71,9034.42,15384.00,0.00
2024-12-10 17:44:19,142,12179,70,72,8970.79,15384.01,0.00
2024-12-10 17:44:19,141,12179,70,71,9011.53,15384.07,0.00
2024-12-10 17:44:19,142,12178,70,72,8930.78,15384.20,0.00
2024-12-10 17:44:19,143,12177,70,73,8849.35,15384.87,0.00
2024-12-10 17:44:19,142,12177,69,73,8892.47,15384.95,0.00
2024-12-10 17:44:19,142,12178,69,73,8993.27,15385.00,0.00
2024-12-10 17:44:19,143,12178,69,74,8930.38,15385.01,0.00
2024-12-10 17:44:19,142,12178,69,73,8971.63,15385.07,0.00
2024-12-10 17:44:19,141,12178,68,73,8963.33,15385.30,0.00
2024-12-10 17:44:19,140,12178,67,73,9019.68,15385.34,0.00
2024-12-10 17:44:19,141,12177,68,73,8901.36,15385.71,0.00
2024-12-10 17:44:19,141,12178,68,73,9200.59,15386.00,0.00
2024-12-10 17:44:19,142,12178,69,73,9135.80,15386.01,0.00
2024-12-10 17:44:19,143,12177,69,74,8909.95,15386.75,0.00
2024-12-10 17:44:19,143,12178,69,74,9107.07,15387.00,0.00
2024-12-10 17:44:19,144,12178,69,75,9043.83,15387.01,0.00
2024-12-10 17:44:19,143,12178,68,75,9098.49,15387.06,0.00
2024-12-10 17:44:19,144,12177,68,76,8902.11,15387.80,0.00
2024-12-10 17:44:19,144,12178,68,76,9060.67,15388.00,0.00
2024-12-10 17:44:19,145,12178,68,77,8998.18,15388.01,0.00
2024-12-10 17:44:19,144,12178,68,76,9042.53,15388.06,0.00
2024-12-10 17:44:19,145,12177,68,77,8948.40,15388.28,0.00
2024-12-10 17:44:19,145,12178,68,77,9082.61,15389.00,0.00
2024-12-10 17:44:19,146,12178,68,78,9020.40,15389.01,0.00
2024-12-10 17:44:19,145,12178,67,78,9073.81,15389.06,0.00
2024-12-10 17:44:19,144,12178,66,78,9062.07,15389.24,0.00
2024-12-10 17:44:19,143,12178,65,78,9114.03,15389.31,0.00
2024-12-10 17:44:19,143,12179,65,78,9223.20,15390.00,0.00
2024-12-10 17:44:19,144,12179,65,79,9159.15,15390.01,0.00
2024-12-10 17:44:19,145,12178,66,79,9057.82,15390.13,0.00
2024-12-10 17:44:19,145,12179,66,79,9007.42,15391.00,0.00
2024-12-10 17:44:19,146,12179,67,79,8945.72,15391.01,0.00
2024-12-10 17:44:19,145,12179,67,78,8996.83,15391.06,0.00
2024-12-10 17:44:19,144,12179,66,78,8996.39,15391.41,0.00
2024-12-10 17:44:19,145,12178,67,78,8929.05,15391.46,0.00
2024-12-10 17:44:19,145,12179,67,78,9107.78,15392.00,0.00
2024-12-10 17:44:19,146,12179,68,78,9045.40,15392.01,0.00
2024-12-10 17:44:19,145,12179,68,77,9092.95,15392.06,0.00
2024-12-10 17:44:19,144,12179,67,77,9037.47,15392.67,0.00
2024-12-10 17:44:19,144,12180,67,77,9200.22,15393.00,0.00
2024-12-10 17:44:19,145,12180,67,78,9136.77,15393.01,0.00
2024-12-10 17:44:19,146,12179,68,78,9033.12,15393.15,0.00
2024-12-10 17:44:20,146,12180,68,78,8986.73,15394.00,0.00
2024-12-10 17:44:20,147,12180,69,78,8925.59,15394.01,0.00
2024-12-10 17:44:20,148,12179,69,79,8773.94,15394.48,0.00
2024-12-10 17:44:20,149,12178,69,80,8717.32,15394.79,0.00
2024-12-10 17:44:20,150,12177,69,81,8654.22,15394.95,0.00
2024-12-10 17:44:20,150,12178,69,81,8815.39,15395.00,0.00
2024-12-10 17:44:20,151,12178,69,82,8757.01,15395.01,0.00
2024-12-10 17:44:20,150,12178,69,81,8802.07,15395.06,0.00
2024-12-10 17:44:20,151,12177,70,81,8702.08,15395.34,0.00
2024-12-10 17:44:20,151,12178,70,81,9028.79,15396.00,0.00
2024-12-10 17:44:20,152,12178,71,81,8969.39,15396.01,0.00
2024-12-10 17:44:20,151,12178,71,80,9014.54,15396.05,0.00
2024-12-10 17:44:20,152,12177,71,81,8940.07,15396.16,0.00
2024-12-10 17:44:20,152,12178,71,81,8989.22,15397.00,0.00
2024-12-10 17:44:20,153,12178,72,81,8930.47,15397.01,0.00
2024-12-10 17:44:20,152,12178,71,81,8987.20,15397.01,0.00
2024-12-10 17:44:20,151,12178,71,80,9033.48,15397.06,0.00
2024-12-10 17:44:20,150,12178,70,80,9054.74,15397.19,0.00
2024-12-10 17:44:20,150,12179,70,80,9135.33,15398.00,0.00
2024-12-10 17:44:20,151,12179,71,80,9074.83,15398.01,0.00
2024-12-10 17:44:20,150,12179,70,80,9093.28,15398.09,0.00
2024-12-10 17:44:20,150,12180,70,80,9056.88,15399.00,0.00
2024-12-10 17:44:20,151,12180,71,80,8996.90,15399.01,0.00
2024-12-10 17:44:20,152,12179,72,80,8782.18,15399.90,0.00
2024-12-10 17:44:20,152,12180,72,80,8850.42,15400.00,0.00
2024-12-10 17:44:20,153,12180,72,81,8792.57,15400.01,0.00
2024-12-10 17:44:20,152,12180,71,81,8777.59,15400.34,0.00
2024-12-10 17:44:20,151,12180,70,81,8832.85,15400.36,0.00
2024-12-10 17:44:20,152,12179,70,82,8732.35,15400.64,0.00
2024-12-10 17:44:20,152,12180,70,82,8871.53,15401.00,0.00
2024-12-10 17:44:20,153,12180,71,82,8813.54,15401.01,0.00
2024-12-10 17:44:20,152,12180,70,82,8868.49,15401.02,0.00
2024-12-10 17:44:20,151,12180,69,82,8923.16,15401.04,0.00
2024-12-10 17:44:20,150,12180,69,81,8973.41,15401.05,0.00
2024-12-10 17:44:20,150,12181,69,81,8991.43,15402.00,0.00
2024-12-10 17:44:20,151,12181,69,82,8931.88,15402.01,0.00
2024-12-10 17:44:20,150,12181,69,81,8983.24,15402.05,0.00
2024-12-10 17:44:20,150,12182,69,81,8898.57,15403.00,0.00
2024-12-10 17:44:20,151,12182,69,82,8839.63,15403.01,0.00
2024-12-10 17:44:20,150,12182,69,81,8889.35,15403.05,0.00
2024-12-10 17:44:20,149,12182,68,81,8800.50,15403.75,0.00
2024-12-10 17:44:20,149,12183,68,81,8865.82,15404.00,0.00
2024-12-10 17:44:20,150,12183,69,81,8806.72,15404.01,0.00
2024-12-10 17:44:20,149,12183,69,80,8856.55,15404.05,0.00
2024-12-10 17:44:20,150,12182,69,81,8782.12,15404.17,0.00
2024-12-10 17:44:20,150,12183,69,81,8731.29,15405.00,0.00
2024-12-10 17:44:20,151,12183,69,82,8673.47,15405.01,0.00
2024-12-10 17:44:20,150,12183,69,81,8722.08,15405.05,0.00
2024-12-10 17:44:20,151,12182,69,82,8643.95,15405.20,0.00
2024-12-10 17:44:20,152,12181,70,82,8586.37,15405.75,0.00
2024-12-10 17:44:20,152,12182,70,82,8731.50,15406.00,0.00
2024-12-10 17:44:20,153,12182,71,82,8674.43,15406.01,0.00
2024-12-10 17:44:20,152,12182,71,81,8720.38,15406.06,0.00
2024-12-10 17:44:20,153,12181,72,81,8661.37,15406.08,0.00
2024-12-10 17:44:20,152,12181,71,81,8657.62,15406.30,0.00
2024-12-10 17:44:20,152,12182,71,81,8854.71,15407.00,0.00
2024-12-10 17:44:20,153,12182,72,81,8796.83,15407.01,0.00
2024-12-10 17:44:20,152,12182,72,80,8796.97,15407.09,0.00
2024-12-10 17:44:20,151,12182,71,80,8753.33,15407.75,0.00
2024-12-10 17:44:20,151,12183,71,80,8919.85,15408.00,0.00
2024-12-10 17:44:20,152,12183,72,80,8861.17,15408.01,0.00
2024-12-10 17:44:20,151,12183,71,80,8910.69,15408.06,0.00
2024-12-10 17:44:20,150,12183,70,80,8969.07,15408.06,0.00
2024-12-10 17:44:20,149,12183,70,79,9018.94,15408.09,0.00
2024-12-10 17:44:20,150,12182,70,80,8890.18,15408.55,0.00
2024-12-10 17:44:20,150,12183,70,80,8923.40,15409.00,0.00
2024-12-10 17:44:20,151,12183,71,80,8864.30,15409.01,0.00
2024-12-10 17:44:20,150,12183,71,79,8900.84,15409.10,0.00
2024-12-10 17:44:20,149,12183,70,79,8926.53,15409.32,0.00
2024-12-10 17:44:20,150,12182,71,79,8846.54,15409.47,0.00
2024-12-10 17:44:20,150,12183,71,79,8955.82,15410.00,0.00
2024-12-10 17:44:20,151,12183,71,80,8896.51,15410.01,0.00
2024-12-10 17:44:20,150,12183,70,80,8944.56,15410.07,0.00
2024-12-10 17:44:20,150,12184,70,80,8978.51,15411.00,0.00
2024-12-10 17:44:20,151,12184,70,81,8919.05,15411.01,0.00
2024-12-10 17:44:20,150,12184,69,81,8925.03,15411.22,0.00
2024-12-10 17:44:20,150,12185,69,81,8895.22,15412.00,0.00
2024-12-10 17:44:20,151,12185,69,82,8836.31,15412.01,0.00
2024-12-10 17:44:20,150,12185,68,82,8882.92,15412.08,0.00
2024-12-10 17:44:20,151,12184,69,82,8774.15,15412.29,0.00
2024-12-10 17:44:20,152,12183,70,82,8778.29,15412.32,0.00
2024-12-10 17:44:20,152,12184,70,82,8813.85,15413.00,0.00
2024-12-10 17:44:20,153,12184,71,82,8756.24,15413.01,0.00
2024-12-10 17:44:20,152,12184,71,81,8801.71,15413.08,0.00
2024-12-10 17:44:20,153,12183,72,81,8684.85,15413.35,0.00
2024-12-10 17:44:20,152,12183,71,81,8798.11,15413.54,0.00
2024-12-10 17:44:20,152,12184,71,81,9030.89,15414.00,0.00
2024-12-10 17:44:20,153,12184,71,82,8971.86,15414.01,0.00
2024-12-10 17:44:20,152,12184,71,81,9007.60,15414.09,0.00
2024-12-10 17:44:20,153,12183,72,81,8938.67,15414.16,0.00
2024-12-10 17:44:20,154,12182,72,82,8847.97,15414.82,0.00
2024-12-10 17:44:20,154,12183,72,82,8997.26,15415.00,0.00
2024-12-10 17:44:20,155,12183,73,82,8939.22,15415.01,0.00
2024-12-10 17:44:20,154,12183,73,81,8979.28,15415.08,0.00
2024-12-10 17:44:20,155,12182,74,81,8848.98,15415.57,0.00
2024-12-10 17:44:20,154,12182,73,81,8913.06,15415.72,0.00
2024-12-10 17:44:20,154,12183,73,81,9170.53,15416.00,0.00
2024-12-10 17:44:20,155,12183,73,82,9111.37,15416.01,0.00
2024-12-10 17:44:21,154,12183,73,81,9152.55,15416.08,0.00
2024-12-10 17:44:21,153,12183,72,81,9072.67,15416.74,0.00
2024-12-10 17:44:21,153,12184,72,81,9234.10,15417.00,0.00
2024-12-10 17:44:21,154,12184,73,81,9174.13,15417.01,0.00
2024-12-10 17:44:21,153,12184,72,81,9222.04,15417.08,0.00
2024-12-10 17:44:21,152,12184,72,80,9276.62,15417.08,0.00
2024-12-10 17:44:21,153,12183,73,80,9172.78,15417.37,0.00
2024-12-10 17:44:21,153,12184,73,80,9233.69,15418.00,0.00
2024-12-10 17:44:21,154,12184,74,80,9173.73,15418.01,0.00
2024-12-10 17:44:21,153,12184,74,79,9215.58,15418.08,0.00
2024-12-10 17:44:21,153,12185,74,79,9236.30,15419.00,0.00
2024-12-10 17:44:21,154,12185,74,80,9176.32,15419.01,0.00
2024-12-10 17:44:21,155,12184,75,80,9109.19,15419.07,0.00
2024-12-10 17:44:21,156,12183,75,81,9035.00,15419.13,0.00
2024-12-10 17:44:21,157,12182,75,82,8954.94,15419.32,0.00
2024-12-10 17:44:21,157,12183,75,82,9002.81,15420.00,0.00
2024-12-10 17:44:21,158,12183,76,82,8945.83,15420.01,0.00
2024-12-10 17:44:21,158,12184,76,82,9148.96,15421.00,0.00
2024-12-10 17:44:21,159,12184,77,82,9091.42,15421.01,0.00
2024-12-10 17:44:21,158,12184,76,82,8984.87,15421.75,0.00
2024-12-10 17:44:21,159,12183,77,82,8915.81,15421.84,0.00
2024-12-10 17:44:21,159,12184,77,82,9001.31,15422.00,0.00
2024-12-10 17:44:21,160,12184,77,83,8945.05,15422.01,0.00
2024-12-10 17:44:21,160,12185,77,83,8927.31,15423.00,0.00
2024-12-10 17:44:21,161,12185,77,84,8871.86,15423.01,0.00
2024-12-10 17:44:21,160,12185,76,84,8916.74,15423.07,0.00
2024-12-10 17:44:21,159,12185,76,83,8968.94,15423.08,0.00
2024-12-10 17:44:21,159,12186,76,83,8885.09,15424.00,0.00
2024-12-10 17:44:21,160,12186,76,84,8829.56,15424.01,0.00
2024-12-10 17:44:21,159,12186,76,83,8870.57,15424.08,0.00
2024-12-10 17:44:21,159,12187,76,83,8786.72,15425.00,0.00
2024-12-10 17:44:21,160,12187,76,84,8731.80,15425.01,0.00
2024-12-10 17:44:21,160,12188,76,84,8622.32,15426.00,0.00
2024-12-10 17:44:21,161,12188,76,85,8568.77,15426.01,0.00
2024-12-10 17:44:21,160,12188,76,84,8592.46,15426.08,0.00
2024-12-10 17:44:21,161,12187,77,84,8497.04,15426.36,0.00
2024-12-10 17:44:21,161,12188,77,84,8491.93,15427.00,0.00
2024-12-10 17:44:21,162,12188,77,85,8439.51,15427.01,0.00
2024-12-10 17:44:21,161,12188,76,85,8411.14,15427.38,0.00
2024-12-10 17:44:21,161,12189,76,85,8466.78,15428.00,0.00
2024-12-10 17:44:21,162,12189,77,85,8414.52,15428.01,0.00
2024-12-10 17:44:21,161,12189,77,84,8428.44,15428.07,0.00
2024-12-10 17:44:21,160,12189,76,84,8424.24,15428.38,0.00
2024-12-10 17:44:21,161,12188,77,84,8294.37,15428.79,0.00
2024-12-10 17:44:21,161,12189,77,84,8415.29,15429.00,0.00
2024-12-10 17:44:21,162,12189,78,84,8363.34,15429.01,0.00
2024-12-10 17:44:21,161,12189,77,84,8400.44,15429.04,0.00
2024-12-10 17:44:21,161,12190,77,84,8385.09,15430.00,0.00
2024-12-10 17:44:21,162,12190,77,85,8333.33,15430.01,0.00
2024-12-10 17:44:21,161,12190,77,84,8353.49,15430.08,0.00
2024-12-10 17:44:21,160,12190,76,84,8358.35,15430.38,0.00
2024-12-10 17:44:21,159,12190,75,84,8309.72,15430.83,0.00
2024-12-10 17:44:21,159,12191,75,84,8380.71,15431.00,0.00
2024-12-10 17:44:21,160,12191,76,84,8328.33,15431.01,0.00
2024-12-10 17:44:21,161,12190,77,84,8275.64,15431.02,0.00
2024-12-10 17:44:21,160,12190,77,83,8374.65,15431.08,0.00
2024-12-10 17:44:21,159,12190,76,83,8425.38,15431.08,0.00
2024-12-10 17:44:21,160,12189,76,84,8284.75,15431.65,0.00
2024-12-10 17:44:21,160,12190,76,84,8315.32,15432.00,0.00
2024-12-10 17:44:21,161,12190,76,85,8263.68,15432.01,0.00
2024-12-10 17:44:21,160,12190,76,84,8303.78,15432.08,0.00
2024-12-10 17:44:21,159,12190,75,84,8224.44,15432.84,0.00
2024-12-10 17:44:21,159,12191,75,84,8490.52,15433.00,0.00
2024-12-10 17:44:21,160,12191,76,84,8437.46,15433.01,0.00
2024-12-10 17:44:21,159,12191,76,83,8478.91,15433.08,0.00
2024-12-10 17:44:21,159,12192,76,83,8388.50,15434.00,0.00
2024-12-10 17:44:21,160,12192,76,84,8336.07,15434.01,0.00
2024-12-10 17:44:21,161,12191,76,85,8232.60,15434.23,0.00
2024-12-10 17:44:21,160,12191,75,85,8180.71,15434.74,0.00
2024-12-10 17:44:21,160,12192,75,85,8237.84,15435.00,0.00
2024-12-10 17:44:21,161,12192,75,86,8186.67,15435.01,0.00
2024-12-10 17:44:21,160,12192,74,86,8115.13,15435.63,0.00
2024-12-10 17:44:21,160,12193,74,86,8227.33,15436.00,0.00
2024-12-10 17:44:21,161,12193,75,86,8176.23,15436.01,0.00
2024-12-10 17:44:21,160,12193,75,85,8197.45,15436.08,0.00
2024-12-10 17:44:21,159,12193,75,84,8248.04,15436.08,0.00
2024-12-10 17:44:21,160,12192,76,84,8189.74,15436.13,0.00
2024-12-10 17:44:21,159,12192,75,84,8228.32,15436.65,0.00
2024-12-10 17:44:21,159,12193,75,84,8232.47,15437.00,0.00
2024-12-10 17:44:21,160,12193,76,84,8181.02,15437.01,0.00
2024-12-10 17:44:21,159,12193,76,83,8216.97,15437.08,0.00
2024-12-10 17:44:21,158,12193,75,83,8263.11,15437.09,0.00
2024-12-10 17:44:21,157,12193,74,83,8241.70,15437.57,0.00
2024-12-10 17:44:21,157,12194,74,83,8371.81,15438.00,0.00
2024-12-10 17:44:21,158,12194,74,84,8318.82,15438.01,0.00
2024-12-10 17:44:21,159,12193,75,84,8264.57,15438.03,0.00
2024-12-10 17:44:21,158,12193,75,83,8396.05,15438.09,0.00
2024-12-10 17:44:21,159,12192,76,83,8342.28,15438.11,0.00
2024-12-10 17:44:21,159,12193,76,83,8353.83,15439.00,0.00
2024-12-10 17:44:21,160,12193,77,83,8301.61,15439.01,0.00
2024-12-10 17:44:22,161,12192,78,83,8184.68,15439.32,0.00
2024-12-10 17:44:22,161,12193,78,83,8397.04,15440.00,0.00
2024-12-10 17:44:22,162,12193,79,83,8345.20,15440.01,0.00
2024-12-10 17:44:22,161,12193,79,82,8383.65,15440.08,0.00
2024-12-10 17:44:22,161,12194,79,82,8395.50,15441.00,0.00
2024-12-10 17:44:22,162,12194,79,83,8343.68,15441.01,0.00
2024-12-10 17:44:22,161,12194,78,83,8339.02,15441.24,0.00
2024-12-10 17:44:22,160,12194,77,83,8361.31,15441.43,0.00
2024-12-10 17:44:22,159,12194,76,83,8353.91,15441.82,0.00
2024-12-10 17:44:22,159,12195,76,83,8415.42,15442.00,0.00
2024-12-10 17:44:22,160,12195,76,84,8362.83,15442.01,0.00
2024-12-10 17:44:22,159,12195,75,84,8335.38,15442.40,0.00
2024-12-10 17:44:22,159,12196,75,84,8329.06,15443.00,0.00
2024-12-10 17:44:22,160,12196,76,84,8277.01,15443.01,0.00
2024-12-10 17:44:22,161,12195,77,84,8117.44,15443.60,0.00
2024-12-10 17:44:22,161,12196,77,84,8173.97,15444.00,0.00
2024-12-10 17:44:22,162,12196,77,85,8123.51,15444.01,0.00
2024-12-10 17:44:22,163,12195,77,86,7947.01,15444.72,0.00
2024-12-10 17:44:22,163,12196,77,86,8090.59,15445.00,0.00
2024-12-10 17:44:22,164,12196,77,87,8041.26,15445.01,0.00
2024-12-10 17:44:22,163,12196,77,86,8065.99,15445.08,0.00
2024-12-10 17:44:22,162,12196,77,85,8112.93,15445.09,0.00
2024-12-10 17:44:22,161,12196,76,85,8009.10,15445.94,0.00
2024-12-10 17:44:22,161,12197,76,85,8192.39,15446.00,0.00
2024-12-10 17:44:22,162,12197,77,85,8141.82,15446.01,0.00
2024-12-10 17:44:22,161,12197,77,84,8157.89,15446.10,0.00
2024-12-10 17:44:22,160,12197,77,83,8207.91,15446.10,0.00
2024-12-10 17:44:22,159,12197,76,83,8239.15,15446.18,0.00
2024-12-10 17:44:22,159,12198,76,83,8209.51,15447.00,0.00
2024-12-10 17:44:22,160,12198,76,84,8158.20,15447.01,0.00
2024-12-10 17:44:22,160,12199,76,84,8043.86,15448.00,0.00
2024-12-10 17:44:22,161,12199,76,85,7993.90,15448.01,0.00
2024-12-10 17:44:22,160,12199,76,84,8028.44,15448.08,0.00
2024-12-10 17:44:22,159,12199,75,84,8075.06,15448.10,0.00
2024-12-10 17:44:22,159,12200,75,84,7994.90,15449.00,0.00
2024-12-10 17:44:22,160,12200,75,85,7944.93,15449.01,0.00
2024-12-10 17:44:22,159,12200,74,85,7991.02,15449.03,0.00
2024-12-10 17:44:22,158,12200,73,85,8009.36,15449.10,0.00
2024-12-10 17:44:22,158,12201,73,85,7960.32,15450.00,0.00
2024-12-10 17:44:22,159,12201,74,85,7910.26,15450.01,0.00
2024-12-10 17:44:22,160,12200,74,86,7828.03,15450.11,0.00
2024-12-10 17:44:22,159,12200,74,85,7912.25,15450.11,0.00
2024-12-10 17:44:22,159,12201,74,85,7859.56,15451.00,0.00
2024-12-10 17:44:22,160,12201,74,86,7810.44,15451.01,0.00
2024-12-10 17:44:22,159,12201,73,86,7823.65,15451.11,0.00
2024-12-10 17:44:22,159,12202,73,86,7857.88,15452.00,0.00
2024-12-10 17:44:22,160,12202,74,86,7808.76,15452.01,0.00
2024-12-10 17:44:22,159,12202,73,86,7850.12,15452.05,0.00
2024-12-10 17:44:22,158,12202,73,85,7871.46,15452.10,0.00
2024-12-10 17:44:22,158,12203,73,85,7793.29,15453.00,0.00
2024-12-10 17:44:22,159,12203,73,86,7744.28,15453.01,0.00
2024-12-10 17:44:22,158,12203,72,86,7785.49,15453.05,0.00
2024-12-10 17:44:22,157,12203,72,85,7829.18,15453.06,0.00
2024-12-10 17:44:22,156,12203,71,85,7872.45,15453.10,0.00
2024-12-10 17:44:22,156,12204,71,85,7793.66,15454.00,0.00
2024-12-10 17:44:22,157,12204,72,85,7744.02,15454.01,0.00
2024-12-10 17:44:22,156,12204,72,84,7761.01,15454.08,0.00
2024-12-10 17:44:22,156,12205,72,84,7703.97,15455.00,0.00
2024-12-10 17:44:22,157,12205,73,84,7654.90,15455.01,0.00
2024-12-10 17:44:22,157,12206,73,84,7551.02,15456.00,0.00
2024-12-10 17:44:22,158,12206,74,84,7503.23,15456.01,0.00
2024-12-10 17:44:22,159,12205,74,85,7449.26,15456.06,0.00
2024-12-10 17:44:22,158,12205,74,84,7514.02,15456.07,0.00
2024-12-10 17:44:22,157,12205,73,84,7499.98,15456.46,0.00
2024-12-10 17:44:22,157,12206,73,84,7474.25,15457.00,0.00
2024-12-10 17:44:22,158,12206,73,85,7426.95,15457.01,0.00
2024-12-10 17:44:22,157,12206,73,84,7438.85,15457.10,0.00
2024-12-10 17:44:22,157,12207,73,84,7467.89,15458.00,0.00
2024-12-10 17:44:22,158,12207,73,85,7420.63,15458.01,0.00
2024-12-10 17:44:22,157,12207,73,84,7442.32,15458.06,0.00
2024-12-10 17:44:22,156,12207,72,84,7484.10,15458.10,0.00
2024-12-10 17:44:22,157,12206,72,85,7354.89,15458.64,0.00
2024-12-10 17:44:22,158,12205,73,85,7323.12,15458.81,0.00
2024-12-10 17:44:22,158,12206,73,85,7372.71,15459.00,0.00
2024-12-10 17:44:22,159,12206,73,86,7326.34,15459.01,0.00
2024-12-10 17:44:22,158,12206,73,85,7345.35,15459.09,0.00
2024-12-10 17:44:22,157,12206,72,85,7391.15,15459.09,0.00
2024-12-10 17:44:22,157,12207,72,85,7505.15,15460.00,0.00
2024-12-10 17:44:22,158,12207,72,86,7457.65,15460.01,0.00
2024-12-10 17:44:22,157,12207,71,86,7487.46,15460.08,0.00
2024-12-10 17:44:22,157,12208,71,86,7423.28,15461.00,0.00
2024-12-10 17:44:22,158,12208,71,87,7376.30,15461.01,0.00
2024-12-10 17:44:22,157,12208,70,87,7409.53,15461.09,0.00
2024-12-10 17:44:22,156,12208,70,86,7452.08,15461.09,0.00
2024-12-10 17:44:22,157,12207,71,86,7327.96,15461.60,0.00
2024-12-10 17:44:22,156,12207,70,86,7362.14,15461.76,0.00
2024-12-10 17:44:22,156,12208,70,86,7419.34,15462.00,0.00
2024-12-10 17:44:22,157,12208,70,87,7372.08,15462.01,0.00
2024-12-10 17:44:23,157,12209,70,87,7364.19,15463.00,0.00
2024-12-10 17:44:23,158,12209,70,88,7317.59,15463.01,0.00
2024-12-10 17:44:23,157,12209,70,87,7329.76,15463.10,0.00
2024-12-10 17:44:23,156,12209,69,87,7284.46,15463.52,0.00
2024-12-10 17:44:23,156,12210,69,87,7286.59,15464.00,0.00
2024-12-10 17:44:23,157,12210,70,87,7240.18,15464.01,0.00
2024-12-10 17:44:23,156,12210,70,86,7228.14,15464.09,0.00
2024-12-10 17:44:23,155,12210,69,86,7145.98,15464.79,0.00
2024-12-10 17:44:23,155,12211,69,86,7212.99,15465.00,0.00
2024-12-10 17:44:23,156,12211,70,86,7166.75,15465.01,0.00
2024-12-10 17:44:23,155,12211,69,86,7204.03,15465.06,0.00
2024-12-10 17:44:23,156,12210,70,86,7155.88,15465.08,0.00
2024-12-10 17:44:23,155,12210,70,85,7229.00,15465.10,0.00
2024-12-10 17:44:23,154,12210,69,85,7274.93,15465.10,0.00
2024-12-10 17:44:23,153,12210,68,85,7269.00,15465.44,0.00
2024-12-10 17:44:23,152,12210,67,85,7310.72,15465.47,0.00
2024-12-10 17:44:23,152,12211,67,85,7331.41,15466.00,0.00
2024-12-10 17:44:23,153,12211,68,85,7283.49,15466.01,0.00
2024-12-10 17:44:23,152,12211,68,84,7296.85,15466.09,0.00
2024-12-10 17:44:23,151,12211,67,84,7288.93,15466.46,0.00
2024-12-10 17:44:23,152,12210,67,85,7186.23,15466.82,0.00
2024-12-10 17:44:23,152,12211,67,85,7376.48,15467.00,0.00
2024-12-10 17:44:23,153,12211,67,86,7328.27,15467.01,0.00
2024-12-10 17:44:23,152,12211,66,86,7375.46,15467.01,0.00
2024-12-10 17:44:23,151,12211,65,86,7278.13,15467.82,0.00
2024-12-10 17:44:23,151,12212,65,86,7445.59,15468.00,0.00
2024-12-10 17:44:23,152,12212,66,86,7396.60,15468.01,0.00
2024-12-10 17:44:23,151,12212,66,85,7409.77,15468.10,0.00
2024-12-10 17:44:23,152,12211,66,86,7337.64,15468.26,0.00
2024-12-10 17:44:23,151,12211,65,86,7408.26,15468.67,0.00
2024-12-10 17:44:23,151,12212,65,86,7444.52,15469.00,0.00
2024-12-10 17:44:23,152,12212,65,87,7395.54,15469.01,0.00
2024-12-10 17:44:23,153,12211,66,87,7347.20,15469.02,0.00
2024-12-10 17:44:23,152,12211,65,87,7470.86,15469.03,0.00
2024-12-10 17:44:23,152,12212,65,87,7477.08,15470.00,0.00
2024-12-10 17:44:23,153,12212,65,88,7428.21,15470.01,0.00
2024-12-10 17:44:23,152,12212,64,88,7474.04,15470.02,0.00
2024-12-10 17:44:23,151,12212,64,87,7502.04,15470.05,0.00
2024-12-10 17:44:23,150,12212,64,86,7543.82,15470.10,0.00
2024-12-10 17:44:23,149,12212,63,86,7499.56,15470.71,0.00
2024-12-10 17:44:23,149,12213,63,86,7621.26,15471.00,0.00
2024-12-10 17:44:23,150,12213,64,86,7570.45,15471.01,0.00
2024-12-10 17:44:23,151,12212,64,87,7478.36,15471.16,0.00
2024-12-10 17:44:23,151,12213,64,87,7536.29,15472.00,0.00
2024-12-10 17:44:23,152,12213,65,87,7486.71,15472.01,0.00
2024-12-10 17:44:23,151,12213,65,86,7498.42,15472.11,0.00
2024-12-10 17:44:23,151,12214,65,86,7545.73,15473.00,0.00
2024-12-10 17:44:23,152,12214,66,86,7496.09,15473.01,0.00
2024-12-10 17:44:23,151,12214,66,85,7507.86,15473.11,0.00
2024-12-10 17:44:23,150,12214,66,84,7556.88,15473.11,0.00
2024-12-10 17:44:23,149,12214,66,83,7606.56,15473.11,0.00
2024-12-10 17:44:23,148,12214,65,83,7623.23,15473.34,0.00
2024-12-10 17:44:23,148,12215,65,83,7589.68,15474.00,0.00
2024-12-10 17:44:23,149,12215,66,83,7538.74,15474.01,0.00
2024-12-10 17:44:23,148,12215,66,82,7572.98,15474.07,0.00
2024-12-10 17:44:23,149,12214,66,83,7486.89,15474.32,0.00
2024-12-10 17:44:23,149,12215,66,83,7525.73,15475.00,0.00
2024-12-10 17:44:23,150,12215,67,83,7475.56,15475.01,0.00
2024-12-10 17:44:23,151,12214,67,84,7422.99,15475.04,0.00
2024-12-10 17:44:23,150,12214,67,83,7497.27,15475.11,0.00
2024-12-10 17:44:23,149,12214,66,83,7477.09,15475.53,0.00
2024-12-10 17:44:23,149,12215,66,83,7612.42,15476.00,0.00
2024-12-10 17:44:23,150,12215,66,84,7561.67,15476.01,0.00
2024-12-10 17:44:23,149,12215,66,83,7595.84,15476.09,0.00
2024-12-10 17:44:23,148,12215,66,82,7641.90,15476.12,0.00
2024-12-10 17:44:23,147,12215,65,82,7608.69,15476.42,0.00
2024-12-10 17:44:23,147,12216,65,82,7728.95,15477.00,0.00
2024-12-10 17:44:23,148,12216,65,83,7676.73,15477.01,0.00
2024-12-10 17:44:23,147,12216,64,83,7604.66,15477.46,0.00
2024-12-10 17:44:23,146,12216,63,83,7655.68,15477.47,0.00
2024-12-10 17:44:23,147,12215,64,83,7539.29,15477.89,0.00
2024-12-10 17:44:23,147,12216,64,83,7653.98,15478.00,0.00
2024-12-10 17:44:23,148,12216,65,83,7602.27,15478.01,0.00
2024-12-10 17:44:23,147,12216,64,83,7637.25,15478.10,0.00
2024-12-10 17:44:23,146,12216,64,82,7669.43,15478.10,0.00
2024-12-10 17:44:23,145,12216,64,81,7721.25,15478.10,0.00
2024-12-10 17:44:23,144,12216,63,81,7773.80,15478.10,0.00
2024-12-10 17:44:23,143,12216,62,81,7737.36,15478.41,0.00
2024-12-10 17:44:23,144,12215,63,81,7669.70,15478.51,0.00
2024-12-10 17:44:23,145,12214,64,81,7633.55,15478.77,0.00
2024-12-10 17:44:23,145,12215,64,81,7834.42,15479.00,0.00
2024-12-10 17:44:23,146,12215,64,82,7780.76,15479.01,0.00
2024-12-10 17:44:23,145,12215,64,81,7775.75,15479.10,0.00
2024-12-10 17:44:23,144,12215,63,81,7828.68,15479.10,0.00
2024-12-10 17:44:23,144,12216,63,81,8010.22,15480.00,0.00
2024-12-10 17:44:23,145,12216,64,81,7954.97,15480.01,0.00
2024-12-10 17:44:23,144,12216,63,81,7994.13,15480.10,0.00
2024-12-10 17:44:23,143,12216,63,80,8046.79,15480.10,0.00
2024-12-10 17:44:23,142,12216,62,80,8091.47,15480.14,0.00
2024-12-10 17:44:23,143,12215,63,80,7948.18,15480.69,0.00
2024-12-10 17:44:23,144,12214,63,81,7979.75,15480.77,0.00
2024-12-10 17:44:23,144,12215,63,81,8074.55,15481.00,0.00
2024-12-10 17:44:23,145,12215,63,82,8018.87,15481.01,0.00
2024-12-10 17:44:23,146,12214,63,83,7916.28,15481.19,0.00
2024-12-10 17:44:23,146,12215,63,83,8160.53,15482.00,0.00
2024-12-10 17:44:23,147,12215,64,83,8105.02,15482.01,0.00
2024-12-10 17:44:23,146,12215,64,82,8141.49,15482.10,0.00
2024-12-10 17:44:23,147,12214,64,83,8071.38,15482.21,0.00
2024-12-10 17:44:23,146,12214,63,83,8191.17,15482.32,0.00
2024-12-10 17:44:23,146,12215,63,83,8294.15,15483.00,0.00
2024-12-10 17:44:23,147,12215,64,83,8237.73,15483.01,0.00
2024-12-10 17:44:23,146,12215,64,82,8276.16,15483.11,0.00
2024-12-10 17:44:23,145,12215,64,81,8318.08,15483.20,0.00
2024-12-10 17:44:23,146,12214,65,81,8245.23,15483.32,0.00
2024-12-10 17:44:23,147,12213,66,81,8245.02,15483.46,0.00
2024-12-10 17:44:23,146,12213,65,81,8292.85,15483.67,0.00
2024-12-10 17:44:23,146,12214,65,81,8454.31,15484.00,0.00
2024-12-10 17:44:23,147,12214,66,81,8396.80,15484.01,0.00
2024-12-10 17:44:23,146,12214,65,81,8441.62,15484.07,0.00
2024-12-10 17:44:23,145,12214,65,80,8494.50,15484.10,0.00
2024-12-10 17:44:23,144,12214,65,79,8548.12,15484.11,0.00
2024-12-10 17:44:23,145,12213,65,80,8440.16,15484.44,0.00
2024-12-10 17:44:23,144,12213,64,80,8479.42,15484.54,0.00
2024-12-10 17:44:23,144,12214,64,80,8731.40,15485.00,0.00
2024-12-10 17:44:23,145,12214,65,80,8671.18,15485.01,0.00
2024-12-10 17:44:23,144,12214,64,80,8719.65,15485.08,0.00
2024-12-10 17:44:23,143,12214,64,79,8776.30,15485.10,0.00
2024-12-10 17:44:23,142,12214,64,78,8834.83,15485.10,0.00
2024-12-10 17:44:24,143,12213,65,78,8644.43,15485.66,0.00
2024-12-10 17:44:24,143,12214,65,78,8839.63,15486.00,0.00
2024-12-10 17:44:24,144,12214,65,79,8778.25,15486.01,0.00
2024-12-10 17:44:24,143,12214,64,79,8826.67,15486.08,0.00
2024-12-10 17:44:24,142,12214,64,78,8884.48,15486.09,0.00
2024-12-10 17:44:24,143,12213,64,79,8806.14,15486.21,0.00
2024-12-10 17:44:24,144,12212,65,79,8753.87,15486.75,0.00
2024-12-10 17:44:24,144,12213,65,79,8939.06,15487.00,0.00
2024-12-10 17:44:24,145,12213,65,80,8877.41,15487.01,0.00
2024-12-10 17:44:24,144,12213,65,79,8924.05,15487.09,0.00
2024-12-10 17:44:24,145,12212,66,79,8844.38,15487.22,0.00
2024-12-10 17:44:24,146,12211,66,80,8807.34,15487.64,0.00
2024-12-10 17:44:24,146,12212,66,80,9059.05,15488.00,0.00
2024-12-10 17:44:24,147,12212,66,81,8997.42,15488.01,0.00
2024-12-10 17:44:24,146,12212,66,80,9040.74,15488.09,0.00
2024-12-10 17:44:24,147,12211,66,81,8924.59,15488.46,0.00
2024-12-10 17:44:24,147,12212,66,81,9145.20,15489.00,0.00
2024-12-10 17:44:24,148,12212,66,82,9083.41,15489.01,0.00
2024-12-10 17:44:24,147,12212,66,81,9110.28,15489.13,0.00
2024-12-10 17:44:24,146,12212,65,81,9132.47,15489.39,0.00
2024-12-10 17:44:24,146,12213,65,81,9250.66,15490.00,0.00
2024-12-10 17:44:24,147,12213,65,82,9187.73,15490.01,0.00
2024-12-10 17:44:24,148,12212,65,83,9094.43,15490.14,0.00
2024-12-10 17:44:24,147,12212,65,82,9163.68,15490.15,0.00
2024-12-10 17:44:24,147,12213,65,82,9095.72,15491.00,0.00
2024-12-10 17:44:24,148,12213,65,83,9034.26,15491.01,0.00
2024-12-10 17:44:24,147,12213,64,83,9064.24,15491.11,0.00
2024-12-10 17:44:24,148,12212,65,83,8864.56,15491.72,0.00
2024-12-10 17:44:24,148,12213,65,83,9053.21,15492.00,0.00
2024-12-10 17:44:24,149,12213,65,84,8992.45,15492.01,0.00
2024-12-10 17:44:24,148,12213,64,84,8917.39,15492.47,0.00
2024-12-10 17:44:24,149,12212,65,84,8798.55,15492.87,0.00
2024-12-10 17:44:24,149,12213,65,84,8995.19,15493.00,0.00
2024-12-10 17:44:24,150,12213,66,84,8935.22,15493.01,0.00
2024-12-10 17:44:24,149,12213,65,84,8992.08,15493.02,0.00
2024-12-10 17:44:24,148,12213,65,83,9025.07,15493.10,0.00
2024-12-10 17:44:24,147,12213,65,82,9070.67,15493.13,0.00
2024-12-10 17:44:24,146,12213,64,82,9097.80,15493.22,0.00
2024-12-10 17:44:24,147,12212,64,83,8950.85,15493.78,0.00
2024-12-10 17:44:24,147,12213,64,83,9142.87,15494.00,0.00
2024-12-10 17:44:24,148,12213,64,84,9081.10,15494.01,0.00
2024-12-10 17:44:24,147,12213,64,83,9122.14,15494.08,0.00
2024-12-10 17:44:24,146,12213,64,82,9183.56,15494.08,0.00
2024-12-10 17:44:24,145,12213,64,81,9233.03,15494.12,0.00
2024-12-10 17:44:24,144,12213,63,81,9211.23,15494.52,0.00
2024-12-10 17:44:24,144,12214,63,81,9352.57,15495.00,0.00
2024-12-10 17:44:24,145,12214,63,82,9288.07,15495.01,0.00
2024-12-10 17:44:24,144,12214,63,81,9325.73,15495.13,0.00
2024-12-10 17:44:24,145,12213,63,82,9157.05,15495.81,0.00
2024-12-10 17:44:24,145,12214,63,82,9206.39,15496.00,0.00
2024-12-10 17:44:24,146,12214,63,83,9143.33,15496.01,0.00
2024-12-10 17:44:24,145,12214,63,82,9179.73,15496.12,0.00
2024-12-10 17:44:24,146,12213,63,83,9098.84,15496.25,0.00
2024-12-10 17:44:24,147,12212,63,84,9087.63,15496.46,0.00
2024-12-10 17:44:24,147,12213,63,84,9225.09,15497.00,0.00
2024-12-10 17:44:24,148,12213,64,84,9162.75,15497.01,0.00
2024-12-10 17:44:24,149,12212,65,84,9016.13,15497.44,0.00
2024-12-10 17:44:24,150,12211,65,85,8949.99,15497.69,0.00
2024-12-10 17:44:24,150,12212,65,85,9224.29,15498.00,0.00
2024-12-10 17:44:24,151,12212,66,85,9163.20,15498.01,0.00
2024-12-10 17:44:24,152,12211,66,86,9099.87,15498.04,0.00
2024-12-10 17:44:24,153,12210,66,87,8992.97,15498.50,0.00
2024-12-10 17:44:24,153,12211,66,87,9223.54,15499.00,0.00
2024-12-10 17:44:24,154,12211,66,88,9163.64,15499.01,0.00
2024-12-10 17:44:24,153,12211,65,88,9211.41,15499.08,0.00
2024-12-10 17:44:24,154,12210,65,89,9051.20,15499.61,0.00
2024-12-10 17:44:24,154,12211,65,89,9295.58,15500.00,0.00
2024-12-10 17:44:24,155,12211,66,89,9235.61,15500.01,0.00
2024-12-10 17:44:24,154,12211,65,89,9218.21,15500.37,0.00
2024-12-10 17:44:24,155,12210,66,89,9129.85,15500.57,0.00
2024-12-10 17:44:24,156,12209,67,89,9051.61,15500.79,0.00
2024-12-10 17:44:24,156,12210,67,89,9192.89,15501.00,0.00
2024-12-10 17:44:24,157,12210,68,89,9134.34,15501.01,0.00
2024-12-10 17:44:24,156,12210,68,88,9170.09,15501.11,0.00
2024-12-10 17:44:24,157,12209,69,88,9079.16,15501.33,0.00
2024-12-10 17:44:24,156,12209,68,88,9112.02,15501.57,0.00
2024-12-10 17:44:24,157,12208,69,88,8969.58,15501.85,0.00
2024-12-10 17:44:24,157,12209,69,88,9253.08,15502.00,0.00
2024-12-10 17:44:24,158,12209,69,89,9194.52,15502.01,0.00
2024-12-10 17:44:24,159,12208,69,90,9059.80,15502.39,0.00
2024-12-10 17:44:24,160,12207,70,90,8988.72,15502.52,0.00
2024-12-10 17:44:24,159,12207,69,90,9047.72,15502.72,0.00
2024-12-10 17:44:24,159,12208,69,90,9284.85,15503.00,0.00
2024-12-10 17:44:24,160,12208,69,91,9226.82,15503.01,0.00
2024-12-10 17:44:24,161,12207,69,92,9056.17,15503.63,0.00
2024-12-10 17:44:24,161,12208,69,92,9300.95,15504.00,0.00
2024-12-10 17:44:24,162,12208,70,92,9243.53,15504.01,0.00
2024-12-10 17:44:24,163,12207,70,93,9183.04,15504.04,0.00
2024-12-10 17:44:24,163,12208,70,93,9224.59,15505.00,0.00
2024-12-10 17:44:24,164,12208,71,93,9168.35,15505.01,0.00
2024-12-10 17:44:24,163,12208,71,92,9198.94,15505.07,0.00
2024-12-10 17:44:24,162,12208,71,91,9249.99,15505.10,0.00
2024-12-10 17:44:24,161,12208,71,90,9306.48,15505.10,0.00
2024-12-10 17:44:24,162,12207,72,90,9205.10,15505.40,0.00
2024-12-10 17:44:24,163,12206,72,91,9162.94,15505.46,0.00
2024-12-10 17:44:24,164,12205,73,91,9104.45,15505.77,0.00
2024-12-10 17:44:24,164,12206,73,91,9236.07,15506.00,0.00
2024-12-10 17:44:24,165,12206,73,92,9180.10,15506.01,0.00
2024-12-10 17:44:24,164,12206,72,92,9202.07,15506.10,0.00
2024-12-10 17:44:24,164,12207,72,92,9430.44,15507.00,0.00
2024-12-10 17:44:24,165,12207,73,92,9373.28,15507.01,0.00
2024-12-10 17:44:24,166,12206,74,92,9248.72,15507.34,0.00
2024-12-10 17:44:24,165,12206,73,92,9255.92,15507.93,0.00
2024-12-10 17:44:25,165,12206,73,92,9338.69,15508.00,0.00
2024-12-10 17:44:25,166,12206,73,93,9282.44,15508.01,0.00
2024-12-10 17:44:25,165,12206,73,92,9330.26,15508.05,0.00
2024-12-10 17:44:25,164,12206,73,91,9361.63,15508.09,0.00
2024-12-10 17:44:25,164,12207,73,91,9380.60,15509.00,0.00
2024-12-10 17:44:25,165,12207,73,92,9323.75,15509.01,0.00
2024-12-10 17:44:25,166,12206,73,93,9099.13,15509.98,0.00
2024-12-10 17:44:25,166,12207,73,93,9154.27,15510.00,0.00
2024-12-10 17:44:25,167,12207,74,93,9099.46,15510.01,0.00
2024-12-10 17:44:25,166,12207,74,92,9144.02,15510.07,0.00
2024-12-10 17:44:25,165,12207,74,91,9194.75,15510.09,0.00
2024-12-10 17:44:25,164,12207,73,91,9088.40,15510.98,0.00
2024-12-10 17:44:25,164,12208,73,91,9273.79,15511.00,0.00
2024-12-10 17:44:25,165,12208,74,91,9217.58,15511.01,0.00
2024-12-10 17:44:25,164,12208,74,90,9259.64,15511.09,0.00
2024-12-10 17:44:25,163,12208,73,90,9276.51,15511.22,0.00
2024-12-10 17:44:25,164,12207,73,91,9151.15,15511.68,0.00
2024-12-10 17:44:25,164,12208,73,91,9219.52,15512.00,0.00
2024-12-10 17:44:25,165,12208,74,91,9163.64,15512.01,0.00
2024-12-10 17:44:25,164,12208,73,91,9213.86,15512.04,0.00
2024-12-10 17:44:25,163,12208,73,90,9261.84,15512.09,0.00
2024-12-10 17:44:25,163,12209,73,90,9272.88,15513.00,0.00
2024-12-10 17:44:25,164,12209,73,91,9216.34,15513.01,0.00
2024-12-10 17:44:25,163,12209,73,90,9258.64,15513.09,0.00
2024-12-10 17:44:25,164,12208,74,90,9132.38,15513.55,0.00
2024-12-10 17:44:25,164,12209,74,90,9152.60,15514.00,0.00
2024-12-10 17:44:25,165,12209,75,90,9097.13,15514.01,0.00
2024-12-10 17:44:25,164,12209,74,90,9142.22,15514.07,0.00
2024-12-10 17:44:25,163,12209,73,90,9195.46,15514.08,0.00
2024-12-10 17:44:25,162,12209,73,89,9251.27,15514.08,0.00
2024-12-10 17:44:25,162,12210,73,89,9300.67,15515.00,0.00
2024-12-10 17:44:25,163,12210,73,90,9243.61,15515.01,0.00
2024-12-10 17:44:25,162,12210,73,89,9281.56,15515.10,0.00
2024-12-10 17:44:25,161,12210,72,89,9293.95,15515.24,0.00
2024-12-10 17:44:25,162,12209,73,89,9208.90,15515.43,0.00
2024-12-10 17:44:25,163,12208,73,90,9138.24,15515.61,0.00
2024-12-10 17:44:25,163,12209,73,90,9203.28,15516.00,0.00
2024-12-10 17:44:25,164,12209,73,91,9147.16,15516.01,0.00
2024-12-10 17:44:25,165,12208,73,92,9009.14,15516.43,0.00
2024-12-10 17:44:25,165,12209,73,92,9237.60,15517.00,0.00
2024-12-10 17:44:25,166,12209,74,92,9181.96,15517.01,0.00
2024-12-10 17:44:25,165,12209,73,92,9231.98,15517.04,0.00
2024-12-10 17:44:25,164,12209,72,92,9205.87,15517.45,0.00
2024-12-10 17:44:25,164,12210,72,92,9290.54,15518.00,0.00
2024-12-10 17:44:25,165,12210,73,92,9234.23,15518.01,0.00
2024-12-10 17:44:25,164,12210,72,92,9277.33,15518.08,0.00
2024-12-10 17:44:25,164,12211,72,92,9177.98,15519.00,0.00
2024-12-10 17:44:25,165,12211,72,93,9122.36,15519.01,0.00
2024-12-10 17:44:25,164,12211,71,93,9164.77,15519.08,0.00
2024-12-10 17:44:25,163,12211,71,92,9203.86,15519.09,0.00
2024-12-10 17:44:25,162,12211,71,91,9259.71,15519.09,0.00
2024-12-10 17:44:25,163,12210,71,92,9172.50,15519.29,0.00
2024-12-10 17:44:25,163,12211,71,92,9205.99,15520.00,0.00
2024-12-10 17:44:25,164,12211,72,92,9149.86,15520.01,0.00
2024-12-10 17:44:25,165,12210,73,92,9045.52,15520.09,0.00
2024-12-10 17:44:25,164,12210,73,91,9154.63,15520.10,0.00
2024-12-10 17:44:25,163,12210,72,91,9203.07,15520.15,0.00
2024-12-10 17:44:25,163,12211,72,91,9258.12,15521.00,0.00
2024-12-10 17:44:25,164,12211,73,91,9201.66,15521.01,0.00
2024-12-10 17:44:25,165,12210,74,91,9138.99,15521.06,0.00
2024-12-10 17:44:25,164,12210,73,91,9206.10,15521.09,0.00
2024-12-10 17:44:25,164,12211,73,91,9242.93,15522.00,0.00
2024-12-10 17:44:25,165,12211,73,92,9186.91,15522.01,0.00
2024-12-10 17:44:25,165,12212,73,92,9185.82,15523.00,0.00
2024-12-10 17:44:25,166,12212,73,93,9130.48,15523.01,0.00
2024-12-10 17:44:25,165,12212,73,92,9151.32,15523.08,0.00
2024-12-10 17:44:25,166,12211,73,93,9090.59,15523.13,0.00
2024-12-10 17:44:25,165,12211,72,93,9162.80,15523.55,0.00
2024-12-10 17:44:25,165,12212,72,93,9168.24,15524.00,0.00
2024-12-10 17:44:25,166,12212,73,93,9113.01,15524.01,0.00
2024-12-10 17:44:25,166,12213,73,93,9090.53,15525.00,0.00
2024-12-10 17:44:25,167,12213,74,93,9036.10,15525.01,0.00
2024-12-10 17:44:25,166,12213,74,92,9058.90,15525.08,0.00
2024-12-10 17:44:25,165,12213,74,91,9111.93,15525.08,0.00
2024-12-10 17:44:25,166,12212,74,92,9049.56,15525.14,0.00
2024-12-10 17:44:25,167,12211,74,93,8957.45,15525.54,0.00
2024-12-10 17:44:25,167,12212,74,93,8964.30,15526.00,0.00
2024-12-10 17:44:25,168,12212,75,93,8910.94,15526.01,0.00
2024-12-10 17:44:25,167,12212,74,93,8953.96,15526.04,0.00
2024-12-10 17:44:25,166,12212,74,92,8981.73,15526.08,0.00
2024-12-10 17:44:25,165,12212,73,92,8960.07,15526.44,0.00
2024-12-10 17:44:25,165,12213,73,92,9155.25,15527.00,0.00
2024-12-10 17:44:25,166,12213,73,93,9100.10,15527.01,0.00
2024-12-10 17:44:25,165,12213,73,92,9119.30,15527.08,0.00
2024-12-10 17:44:25,165,12214,73,92,9034.77,15528.00,0.00
2024-12-10 17:44:25,166,12214,74,92,8980.34,15528.01,0.00
2024-12-10 17:44:25,165,12214,74,91,9010.44,15528.07,0.00
2024-12-10 17:44:25,164,12214,73,91,9063.49,15528.08,0.00
2024-12-10 17:44:25,164,12215,73,91,8977.87,15529.00,0.00
2024-12-10 17:44:25,165,12215,74,91,8923.46,15529.01,0.00
2024-12-10 17:44:25,164,12215,73,91,8976.93,15529.01,0.00
2024-12-10 17:44:25,164,12216,73,91,8886.94,15530.00,0.00
2024-12-10 17:44:25,165,12216,74,91,8833.08,15530.01,0.00
2024-12-10 17:44:25,166,12215,75,91,8699.04,15530.37,0.00
2024-12-10 17:44:25,167,12214,76,91,8651.70,15530.54,0.00
2024-12-10 17:44:25,168,12213,76,92,8577.37,15530.95,0.00
2024-12-10 17:44:26,168,12214,76,92,8655.82,15531.00,0.00
2024-12-10 17:44:26,169,12214,76,93,8604.60,15531.01,0.00
2024-12-10 17:44:26,168,12214,76,92,8637.42,15531.04,0.00
2024-12-10 17:44:26,167,12214,76,91,8664.97,15531.07,0.00
2024-12-10 17:44:26,167,12215,76,91,8872.73,15532.00,0.00
2024-12-10 17:44:26,168,12215,76,92,8819.92,15532.01,0.00
2024-12-10 17:44:26,167,12215,75,92,8857.09,15532.02,0.00
2024-12-10 17:44:26,166,12215,74,92,8909.52,15532.02,0.00
2024-12-10 17:44:26,165,12215,74,91,8938.11,15532.06,0.00
2024-12-10 17:44:26,164,12215,73,91,8904.34,15532.63,0.00
2024-12-10 17:44:26,165,12214,73,92,8843.67,15532.68,0.00
2024-12-10 17:44:26,165,12215,73,92,8880.36,15533.00,0.00
2024-12-10 17:44:26,166,12215,73,93,8826.87,15533.01,0.00
2024-12-10 17:44:26,165,12215,73,92,8862.50,15533.05,0.00
2024-12-10 17:44:26,166,12214,74,92,8799.77,15533.13,0.00
2024-12-10 17:44:26,165,12214,73,92,8714.61,15533.96,0.00
2024-12-10 17:44:26,165,12215,73,92,8897.28,15534.00,0.00
2024-12-10 17:44:26,166,12215,74,92,8843.68,15534.01,0.00
2024-12-10 17:44:26,165,12215,74,91,8888.83,15534.05,0.00
2024-12-10 17:44:26,164,12215,73,91,8883.45,15534.32,0.00
2024-12-10 17:44:26,164,12216,73,91,8955.95,15535.00,0.00
2024-12-10 17:44:26,165,12216,74,91,8901.67,15535.01,0.00
2024-12-10 17:44:26,164,12216,74,90,8927.55,15535.06,0.00
2024-12-10 17:44:26,165,12215,75,90,8764.76,15535.67,0.00
2024-12-10 17:44:26,165,12216,75,90,8838.45,15536.00,0.00
2024-12-10 17:44:26,166,12216,75,91,8785.20,15536.01,0.00
2024-12-10 17:44:26,165,12216,74,91,8810.22,15536.06,0.00
2024-12-10 17:44:26,164,12216,73,91,8863.00,15536.06,0.00
2024-12-10 17:44:26,163,12216,72,91,8855.44,15536.34,0.00
2024-12-10 17:44:26,163,12217,72,91,8941.33,15537.00,0.00
2024-12-10 17:44:26,164,12217,72,92,8886.81,15537.01,0.00
2024-12-10 17:44:26,165,12216,72,93,8790.63,15537.17,0.00
2024-12-10 17:44:26,165,12217,72,93,8766.05,15538.00,0.00
2024-12-10 17:44:26,166,12217,72,94,8713.24,15538.01,0.00
2024-12-10 17:44:26,165,12217,71,94,8765.11,15538.01,0.00
2024-12-10 17:44:26,164,12217,71,93,8804.36,15538.05,0.00
2024-12-10 17:44:26,163,12217,71,92,8857.42,15538.05,0.00
2024-12-10 17:44:26,162,12217,70,92,8847.90,15538.23,0.00
2024-12-10 17:44:26,163,12216,71,92,8770.81,15538.39,0.00
2024-12-10 17:44:26,162,12216,70,92,8868.87,15538.44,0.00
2024-12-10 17:44:26,162,12217,70,92,8973.01,15539.00,0.00
2024-12-10 17:44:26,163,12217,71,92,8917.97,15539.01,0.00
2024-12-10 17:44:26,162,12217,71,91,8963.44,15539.05,0.00
2024-12-10 17:44:26,161,12217,70,91,8939.11,15539.32,0.00
2024-12-10 17:44:26,161,12218,70,91,9023.96,15540.00,0.00
2024-12-10 17:44:26,162,12218,70,92,8968.26,15540.01,0.00
2024-12-10 17:44:26,161,12218,70,91,9014.33,15540.05,0.00
2024-12-10 17:44:26,161,12219,70,91,8923.89,15541.00,0.00
2024-12-10 17:44:26,162,12219,71,91,8868.80,15541.01,0.00
2024-12-10 17:44:26,161,12219,71,90,8912.33,15541.06,0.00
2024-12-10 17:44:26,160,12219,70,90,8927.34,15541.32,0.00
2024-12-10 17:44:26,161,12218,70,91,8805.75,15541.75,0.00
2024-12-10 17:44:26,161,12219,70,91,8849.39,15542.00,0.00
2024-12-10 17:44:26,162,12219,70,92,8794.76,15542.01,0.00
2024-12-10 17:44:26,163,12218,70,93,8713.18,15542.07,0.00
2024-12-10 17:44:26,164,12217,70,94,8624.12,15542.57,0.00
2024-12-10 17:44:26,165,12216,70,95,8606.73,15542.61,0.00
2024-12-10 17:44:26,165,12217,70,95,8731.93,15543.00,0.00
2024-12-10 17:44:26,166,12217,71,95,8679.32,15543.01,0.00
2024-12-10 17:44:26,166,12218,71,95,8860.73,15544.00,0.00
2024-12-10 17:44:26,167,12218,72,95,8807.67,15544.01,0.00
2024-12-10 17:44:26,168,12217,73,95,8754.32,15544.02,0.00
2024-12-10 17:44:26,168,12218,73,95,8684.52,15545.00,0.00
2024-12-10 17:44:26,169,12218,74,95,8633.13,15545.01,0.00
2024-12-10 17:44:26,169,12219,74,95,8602.67,15546.00,0.00
2024-12-10 17:44:26,170,12219,75,95,8552.07,15546.01,0.00
2024-12-10 17:44:26,169,12219,75,94,8587.97,15546.05,0.00
2024-12-10 17:44:26,168,12219,74,94,8458.65,15546.98,0.00
2024-12-10 17:44:26,168,12220,74,94,8548.43,15547.00,0.00
2024-12-10 17:44:26,169,12220,75,94,8497.85,15547.01,0.00
2024-12-10 17:44:26,168,12220,74,94,8545.66,15547.02,0.00
2024-12-10 17:44:26,169,12219,75,94,8491.43,15547.06,0.00
2024-12-10 17:44:26,168,12219,75,93,8544.75,15547.06,0.00
2024-12-10 17:44:26,169,12218,75,94,8470.32,15547.22,0.00
2024-12-10 17:44:26,168,12218,74,94,8471.11,15547.82,0.00
2024-12-10 17:44:26,168,12219,74,94,8534.70,15548.00,0.00
2024-12-10 17:44:26,169,12219,75,94,8484.20,15548.01,0.00
2024-12-10 17:44:26,168,12219,75,93,8507.89,15548.05,0.00
2024-12-10 17:44:26,169,12218,75,94,8408.90,15548.38,0.00
2024-12-10 17:44:26,168,12218,75,93,8454.61,15548.49,0.00
2024-12-10 17:44:26,168,12219,75,93,8638.48,15549.00,0.00
2024-12-10 17:44:26,169,12219,76,93,8587.36,15549.01,0.00
2024-12-10 17:44:26,168,12219,76,92,8611.66,15549.05,0.00
2024-12-10 17:44:26,167,12219,75,92,8645.42,15549.17,0.00
2024-12-10 17:44:26,167,12220,75,92,8688.37,15550.00,0.00
2024-12-10 17:44:26,168,12220,75,93,8636.66,15550.01,0.00
2024-12-10 17:44:26,167,12220,75,92,8660.47,15550.06,0.00
2024-12-10 17:44:26,168,12219,75,93,8581.21,15550.25,0.00
2024-12-10 17:44:26,169,12218,75,94,8504.86,15550.64,0.00
2024-12-10 17:44:26,169,12219,75,94,8558.75,15551.00,0.00
2024-12-10 17:44:26,170,12219,75,95,8508.41,15551.01,0.00
2024-12-10 17:44:26,169,12219,75,94,8531.17,15551.06,0.00
2024-12-10 17:44:26,169,12220,75,94,8630.93,15552.00,0.00
2024-12-10 17:44:26,170,12220,75,95,8580.16,15552.01,0.00
2024-12-10 17:44:26,169,12220,75,94,8609.79,15552.05,0.00
2024-12-10 17:44:26,169,12221,75,94,8517.37,15553.00,0.00
2024-12-10 17:44:26,170,12221,76,94,8467.27,15553.01,0.00
2024-12-10 17:44:26,169,12221,76,93,8509.11,15553.05,0.00
2024-12-10 17:44:27,169,12222,76,93,8417.59,15554.00,0.00
2024-12-10 17:44:27,170,12222,77,93,8368.08,15554.01,0.00
2024-12-10 17:44:27,170,12223,77,93,8278.61,15555.00,0.00
2024-12-10 17:44:27,171,12223,78,93,8230.20,15555.01,0.00
2024-12-10 17:44:27,172,12222,78,94,8034.43,15555.85,0.00
2024-12-10 17:44:27,172,12223,78,94,8103.73,15556.00,0.00
2024-12-10 17:44:27,173,12223,78,95,8056.88,15556.01,0.00
2024-12-10 17:44:27,173,12224,78,95,8040.11,15557.00,0.00
2024-12-10 17:44:27,174,12224,78,96,7993.90,15557.01,0.00
2024-12-10 17:44:27,173,12224,78,95,8012.25,15557.06,0.00
2024-12-10 17:44:27,174,12223,78,96,7910.00,15557.44,0.00
2024-12-10 17:44:27,174,12224,78,96,7895.19,15558.00,0.00
2024-12-10 17:44:27,175,12224,79,96,7850.08,15558.01,0.00
2024-12-10 17:44:27,174,12224,79,95,7866.60,15558.07,0.00
2024-12-10 17:44:27,173,12224,79,94,7753.27,15558.69,0.00
2024-12-10 17:44:27,173,12225,79,94,7884.81,15559.00,0.00
2024-12-10 17:44:27,174,12225,80,94,7839.49,15559.01,0.00
2024-12-10 17:44:27,173,12225,80,93,7867.74,15559.06,0.00
2024-12-10 17:44:27,172,12225,80,92,7910.78,15559.08,0.00
2024-12-10 17:44:27,172,12226,80,92,7821.70,15560.00,0.00
2024-12-10 17:44:27,173,12226,80,93,7776.48,15560.01,0.00
2024-12-10 17:44:27,172,12226,80,92,7793.67,15560.06,0.00
2024-12-10 17:44:27,171,12226,80,91,7837.43,15560.07,0.00
2024-12-10 17:44:27,171,12227,80,91,7747.82,15561.00,0.00
2024-12-10 17:44:27,172,12227,81,91,7702.78,15561.01,0.00
2024-12-10 17:44:27,171,12227,80,91,7743.28,15561.03,0.00
2024-12-10 17:44:27,170,12227,80,90,7782.44,15561.06,0.00
2024-12-10 17:44:27,169,12227,79,90,7827.57,15561.07,0.00
2024-12-10 17:44:27,168,12227,78,90,7829.74,15561.21,0.00
2024-12-10 17:44:27,168,12228,78,90,7800.53,15562.00,0.00
2024-12-10 17:44:27,169,12228,79,90,7754.38,15562.01,0.00
2024-12-10 17:44:27,169,12229,79,90,7649.47,15563.00,0.00
2024-12-10 17:44:27,170,12229,79,91,7604.48,15563.01,0.00
2024-12-10 17:44:27,169,12229,79,90,7621.87,15563.07,0.00
2024-12-10 17:44:27,168,12229,79,89,7666.31,15563.07,0.00
2024-12-10 17:44:27,168,12230,79,89,7569.62,15564.00,0.00
2024-12-10 17:44:27,169,12230,80,89,7524.83,15564.01,0.00
2024-12-10 17:44:27,170,12229,81,89,7477.83,15564.04,0.00
2024-12-10 17:44:27,169,12229,80,89,7589.33,15564.07,0.00
2024-12-10 17:44:27,168,12229,80,88,7630.80,15564.08,0.00
2024-12-10 17:44:27,167,12229,79,88,7590.86,15564.41,0.00
2024-12-10 17:44:27,168,12228,80,88,7493.96,15564.67,0.00
2024-12-10 17:44:27,168,12229,80,88,7570.97,15565.00,0.00
2024-12-10 17:44:27,169,12229,80,89,7526.17,15565.01,0.00
2024-12-10 17:44:27,168,12229,79,89,7560.81,15565.07,0.00
2024-12-10 17:44:27,167,12229,78,89,7574.40,15565.10,0.00
2024-12-10 17:44:27,166,12229,77,89,7551.98,15565.43,0.00
2024-12-10 17:44:27,165,12229,76,89,7595.86,15565.44,0.00
2024-12-10 17:44:27,164,12229,75,89,7604.37,15565.60,0.00
2024-12-10 17:44:27,163,12229,74,89,7611.83,15565.86,0.00
2024-12-10 17:44:27,163,12230,74,89,7876.03,15566.00,0.00
2024-12-10 17:44:27,164,12230,74,90,7828.01,15566.01,0.00
2024-12-10 17:44:27,163,12230,74,89,7845.94,15566.07,0.00
2024-12-10 17:44:27,162,12230,73,89,7825.97,15566.40,0.00
2024-12-10 17:44:27,163,12229,73,90,7709.67,15566.80,0.00
2024-12-10 17:44:27,163,12230,73,90,7795.78,15567.00,0.00
2024-12-10 17:44:27,164,12230,74,90,7748.25,15567.01,0.00
2024-12-10 17:44:27,163,12230,73,90,7749.97,15567.06,0.00
2024-12-10 17:44:27,162,12230,73,89,7788.20,15567.06,0.00
2024-12-10 17:44:27,161,12230,73,88,7747.39,15567.57,0.00
2024-12-10 17:44:27,161,12231,73,88,7874.36,15568.00,0.00
2024-12-10 17:44:27,162,12231,74,88,7825.75,15568.01,0.00
2024-12-10 17:44:27,163,12230,74,89,7587.07,15568.92,0.00
2024-12-10 17:44:27,163,12231,74,89,7679.79,15569.00,0.00
2024-12-10 17:44:27,164,12231,74,90,7632.96,15569.01,0.00
2024-12-10 17:44:27,163,12231,74,89,7660.71,15569.06,0.00
2024-12-10 17:44:27,162,12231,73,89,7620.70,15569.37,0.00
2024-12-10 17:44:27,162,12232,73,89,7715.27,15570.00,0.00
2024-12-10 17:44:27,163,12232,73,90,7667.93,15570.01,0.00
2024-12-10 17:44:27,162,12232,73,89,7704.72,15570.07,0.00
2024-12-10 17:44:27,163,12231,73,90,7606.92,15570.41,0.00
2024-12-10 17:44:27,163,12232,73,90,7655.32,15571.00,0.00
2024-12-10 17:44:27,164,12232,73,91,7608.64,15571.01,0.00
2024-12-10 17:44:27,163,12232,73,90,7644.84,15571.07,0.00
2024-12-10 17:44:27,164,12231,73,91,7550.84,15571.38,0.00
2024-12-10 17:44:27,163,12231,72,91,7657.19,15571.42,0.00
2024-12-10 17:44:27,163,12232,72,91,7719.65,15572.00,0.00
2024-12-10 17:44:27,164,12232,73,91,7672.58,15572.01,0.00
2024-12-10 17:44:27,163,12232,73,90,7706.31,15572.07,0.00
2024-12-10 17:44:27,164,12231,73,91,7656.47,15572.10,0.00
2024-12-10 17:44:27,163,12231,72,91,7670.12,15572.45,0.00
2024-12-10 17:44:27,164,12230,72,92,7508.76,15572.95,0.00
2024-12-10 17:44:27,164,12231,72,92,7695.86,15573.00,0.00
2024-12-10 17:44:27,165,12231,73,92,7649.22,15573.01,0.00
2024-12-10 17:44:27,164,12231,72,92,7608.64,15573.45,0.00
2024-12-10 17:44:27,163,12231,71,92,7646.14,15573.50,0.00
2024-12-10 17:44:27,163,12232,71,92,7854.75,15574.00,0.00
2024-12-10 17:44:27,164,12232,72,92,7806.86,15574.01,0.00
2024-12-10 17:44:27,163,12232,72,91,7833.85,15574.08,0.00
2024-12-10 17:44:27,164,12231,73,91,7689.46,15574.71,0.00
2024-12-10 17:44:27,164,12232,73,91,7708.68,15575.00,0.00
2024-12-10 17:44:27,165,12232,74,91,7661.96,15575.01,0.00
2024-12-10 17:44:27,164,12232,73,91,7707.73,15575.01,0.00
2024-12-10 17:44:27,163,12232,72,91,7744.54,15575.07,0.00
2024-12-10 17:44:27,163,12233,72,91,7764.57,15576.00,0.00
2024-12-10 17:44:27,164,12233,73,91,7717.22,15576.01,0.00
2024-12-10 17:44:28,163,12233,73,90,7754.09,15576.07,0.00
2024-12-10 17:44:28,163,12234,73,90,7675.19,15577.00,0.00
2024-12-10 17:44:28,164,12234,74,90,7628.39,15577.01,0.00
2024-12-10 17:44:28,164,12235,74,90,7529.75,15578.00,0.00
2024-12-10 17:44:28,165,12235,75,90,7484.12,15578.01,0.00
2024-12-10 17:44:28,165,12236,75,90,7374.16,15579.00,0.00
2024-12-10 17:44:28,166,12236,76,90,7329.73,15579.01,0.00
2024-12-10 17:44:28,165,12236,76,89,7351.52,15579.07,0.00
2024-12-10 17:44:28,164,12236,76,88,7394.45,15579.07,0.00
2024-12-10 17:44:28,163,12236,75,88,7379.70,15579.46,0.00
2024-12-10 17:44:28,164,12235,76,88,7298.72,15579.70,0.00
2024-12-10 17:44:28,164,12236,76,88,7340.16,15580.00,0.00
2024-12-10 17:44:28,165,12236,77,88,7295.67,15580.01,0.00
2024-12-10 17:44:28,164,12236,76,88,7328.79,15580.07,0.00
2024-12-10 17:44:28,163,12236,76,87,7372.79,15580.07,0.00
2024-12-10 17:44:28,162,12236,76,86,7401.96,15580.08,0.00
2024-12-10 17:44:28,161,12236,75,86,7370.59,15580.38,0.00
2024-12-10 17:44:28,162,12235,75,87,7294.40,15580.59,0.00
2024-12-10 17:44:28,162,12236,75,87,7465.88,15581.00,0.00
2024-12-10 17:44:28,163,12236,76,87,7420.08,15581.01,0.00
2024-12-10 17:44:28,162,12236,76,86,7454.37,15581.07,0.00
2024-12-10 17:44:28,162,12237,76,86,7462.72,15582.00,0.00
2024-12-10 17:44:28,163,12237,76,87,7416.94,15582.01,0.00
2024-12-10 17:44:28,163,12238,76,87,7304.57,15583.00,0.00
2024-12-10 17:44:28,164,12238,77,87,7260.03,15583.01,0.00
2024-12-10 17:44:28,163,12238,77,86,7287.39,15583.10,0.00
2024-12-10 17:44:28,162,12238,76,86,7310.05,15583.24,0.00
2024-12-10 17:44:28,162,12239,76,86,7249.87,15584.00,0.00
2024-12-10 17:44:28,163,12239,76,87,7205.39,15584.01,0.00
2024-12-10 17:44:28,162,12239,75,87,7246.03,15584.02,0.00
2024-12-10 17:44:28,161,12239,74,87,7280.41,15584.09,0.00
2024-12-10 17:44:28,160,12239,74,86,7322.01,15584.09,0.00
2024-12-10 17:44:28,159,12239,73,86,7350.43,15584.16,0.00
2024-12-10 17:44:28,158,12239,72,86,7395.34,15584.17,0.00
2024-12-10 17:44:28,158,12240,72,86,7364.21,15585.00,0.00
2024-12-10 17:44:28,159,12240,73,86,7317.89,15585.01,0.00
2024-12-10 17:44:28,158,12240,73,85,7348.46,15585.09,0.00
2024-12-10 17:44:28,159,12239,73,86,7257.22,15585.40,0.00
2024-12-10 17:44:28,158,12239,72,86,7364.33,15585.44,0.00
2024-12-10 17:44:28,157,12239,71,86,7410.24,15585.44,0.00
2024-12-10 17:44:28,157,12240,71,86,7382.81,15586.00,0.00
2024-12-10 17:44:28,158,12240,72,86,7336.08,15586.01,0.00
2024-12-10 17:44:28,157,12240,71,86,7367.95,15586.10,0.00
2024-12-10 17:44:28,156,12240,71,85,7413.18,15586.10,0.00
2024-12-10 17:44:28,157,12239,72,85,7323.33,15586.38,0.00
2024-12-10 17:44:28,157,12240,72,85,7494.47,15587.00,0.00
2024-12-10 17:44:28,158,12240,73,85,7447.04,15587.01,0.00
2024-12-10 17:44:28,157,12240,73,84,7461.74,15587.10,0.00
2024-12-10 17:44:28,158,12239,74,84,7390.86,15587.26,0.00
2024-12-10 17:44:28,157,12239,73,84,7346.82,15587.74,0.00
2024-12-10 17:44:28,157,12240,73,84,7504.88,15588.00,0.00
2024-12-10 17:44:28,158,12240,73,85,7457.38,15588.01,0.00
2024-12-10 17:44:28,157,12240,73,84,7489.03,15588.10,0.00
2024-12-10 17:44:28,156,12240,72,84,7445.19,15588.43,0.00
2024-12-10 17:44:28,157,12239,72,85,7363.13,15588.66,0.00
2024-12-10 17:44:28,156,12239,71,85,7442.15,15588.70,0.00
2024-12-10 17:44:28,156,12240,71,85,7595.26,15589.00,0.00
2024-12-10 17:44:28,157,12240,71,86,7546.88,15589.01,0.00
2024-12-10 17:44:28,156,12240,71,85,7579.30,15589.10,0.00
2024-12-10 17:44:28,155,12240,71,84,7626.19,15589.10,0.00
2024-12-10 17:44:28,156,12239,72,84,7526.43,15589.44,0.00
2024-12-10 17:44:28,155,12239,71,84,7604.21,15589.55,0.00
2024-12-10 17:44:28,156,12238,72,84,7505.71,15589.88,0.00
2024-12-10 17:44:28,156,12239,72,84,7726.06,15590.00,0.00
2024-12-10 17:44:28,157,12239,72,85,7676.85,15590.01,0.00
2024-12-10 17:44:28,156,12239,72,84,7708.10,15590.11,0.00
2024-12-10 17:44:28,156,12240,72,84,7829.50,15591.00,0.00
2024-12-10 17:44:28,157,12240,73,84,7779.63,15591.01,0.00
2024-12-10 17:44:28,156,12240,72,84,7795.53,15591.04,0.00
2024-12-10 17:44:28,155,12240,72,83,7833.77,15591.10,0.00
2024-12-10 17:44:28,155,12241,72,83,7795.01,15592.00,0.00
2024-12-10 17:44:28,156,12241,72,84,7745.04,15592.01,0.00
2024-12-10 17:44:28,157,12240,72,85,7695.71,15592.02,0.00
2024-12-10 17:44:28,156,12240,72,84,7783.04,15592.07,0.00
2024-12-10 17:44:28,155,12240,72,83,7825.22,15592.11,0.00
2024-12-10 17:44:28,154,12240,71,83,7862.88,15592.19,0.00
2024-12-10 17:44:28,154,12241,71,83,7797.53,15593.00,0.00
2024-12-10 17:44:28,155,12241,71,84,7747.22,15593.01,0.00
2024-12-10 17:44:28,154,12241,70,84,7788.44,15593.06,0.00
2024-12-10 17:44:28,153,12241,69,84,7833.24,15593.09,0.00
2024-12-10 17:44:28,152,12241,69,83,7876.56,15593.12,0.00
2024-12-10 17:44:28,153,12240,70,83,7815.92,15593.19,0.00
2024-12-10 17:44:28,152,12240,69,83,7775.32,15593.81,0.00
2024-12-10 17:44:28,153,12239,70,83,7723.49,15593.82,0.00
2024-12-10 17:44:28,153,12240,70,83,7918.30,15594.00,0.00
2024-12-10 17:44:28,154,12240,70,84,7866.88,15594.01,0.00
2024-12-10 17:44:28,155,12239,71,84,7808.10,15594.07,0.00
2024-12-10 17:44:28,156,12238,72,84,7813.03,15594.08,0.00
2024-12-10 17:44:28,155,12238,72,83,7937.90,15594.10,0.00
2024-12-10 17:44:28,155,12239,72,83,8065.98,15595.00,0.00
2024-12-10 17:44:28,156,12239,73,83,8014.27,15595.01,0.00
2024-12-10 17:44:28,155,12239,73,82,8051.93,15595.09,0.00
2024-12-10 17:44:28,154,12239,73,81,8103.20,15595.09,0.00
2024-12-10 17:44:28,153,12239,72,81,8091.61,15595.29,0.00
2024-12-10 17:44:28,154,12238,73,81,8010.78,15595.49,0.00
2024-12-10 17:44:28,154,12239,73,81,8255.21,15596.00,0.00
2024-12-10 17:44:28,155,12239,74,81,8201.95,15596.01,0.00
2024-12-10 17:44:28,156,12238,75,81,8149.37,15596.02,0.00
2024-12-10 17:44:28,155,12238,75,80,8191.93,15596.10,0.00
2024-12-10 17:44:28,154,12238,75,79,8244.11,15596.10,0.00
2024-12-10 17:44:28,154,12239,75,79,8246.16,15597.00,0.00
2024-12-10 17:44:28,155,12239,75,80,8192.96,15597.01,0.00
2024-12-10 17:44:28,154,12239,74,80,8232.02,15597.09,0.00
2024-12-10 17:44:28,153,12239,74,79,8284.80,15597.09,0.00
2024-12-10 17:44:28,154,12238,75,79,8123.10,15597.79,0.00
2024-12-10 17:44:29,154,12238,75,79,8270.14,15598.00,0.00
2024-12-10 17:44:29,155,12238,76,79,8216.79,15598.01,0.00
2024-12-10 17:44:29,154,12238,75,79,8264.08,15598.04,0.00
2024-12-10 17:44:29,153,12238,75,78,8309.96,15598.08,0.00
2024-12-10 17:44:29,152,12238,74,78,8310.32,15598.41,0.00
2024-12-10 17:44:29,152,12239,74,78,8424.63,15599.00,0.00
2024-12-10 17:44:29,153,12239,75,78,8369.57,15599.01,0.00
2024-12-10 17:44:29,152,12239,75,77,8411.32,15599.09,0.00
2024-12-10 17:44:29,151,12239,75,76,8465.99,15599.09,0.00
2024-12-10 17:44:29,152,12238,75,77,8375.56,15599.32,0.00
2024-12-10 17:44:29,153,12237,76,77,8223.18,15599.75,0.00
2024-12-10 17:44:29,153,12238,76,77,8309.03,15600.00,0.00
2024-12-10 17:44:29,154,12238,76,78,8255.08,15600.01,0.00
2024-12-10 17:44:29,155,12237,76,79,8200.82,15600.03,0.00
2024-12-10 17:44:29,154,12237,75,79,8321.98,15600.09,0.00
2024-12-10 17:44:29,153,12237,75,78,8373.31,15600.09,0.00
2024-12-10 17:44:29,152,12237,74,78,8404.06,15600.24,0.00
2024-12-10 17:44:29,152,12238,74,78,8552.32,15601.00,0.00
2024-12-10 17:44:29,153,12238,75,78,8496.42,15601.01,0.00
2024-12-10 17:44:29,152,12238,75,77,8540.04,15601.08,0.00
2024-12-10 17:44:29,151,12238,74,77,8556.47,15601.19,0.00
2024-12-10 17:44:29,150,12238,73,77,8583.87,15601.31,0.00
2024-12-10 17:44:29,150,12239,73,77,8685.21,15602.00,0.00
2024-12-10 17:44:29,151,12239,74,77,8627.69,15602.01,0.00
2024-12-10 17:44:29,152,12238,75,77,8563.77,15602.07,0.00
2024-12-10 17:44:29,151,12238,75,76,8602.94,15602.09,0.00
2024-12-10 17:44:29,151,12239,75,76,8519.82,15603.00,0.00
2024-12-10 17:44:29,152,12239,75,77,8463.77,15603.01,0.00
2024-12-10 17:44:29,151,12239,75,76,8506.43,15603.09,0.00
2024-12-10 17:44:29,150,12239,75,75,8550.27,15603.09,0.00
2024-12-10 17:44:29,151,12238,76,75,8460.63,15603.32,0.00
2024-12-10 17:44:29,152,12237,77,75,8375.37,15603.66,0.00
2024-12-10 17:44:29,152,12238,77,75,8518.33,15604.00,0.00
2024-12-10 17:44:29,153,12238,78,75,8462.66,15604.01,0.00
2024-12-10 17:44:29,152,12238,78,74,8490.75,15604.10,0.00
2024-12-10 17:44:29,151,12238,77,74,8524.76,15604.24,0.00
2024-12-10 17:44:29,152,12237,77,75,8346.19,15604.76,0.00
2024-12-10 17:44:29,152,12238,77,75,8634.87,15605.00,0.00
2024-12-10 17:44:29,153,12238,78,75,8578.43,15605.01,0.00
2024-12-10 17:44:29,152,12238,77,75,8629.75,15605.03,0.00
2024-12-10 17:44:29,151,12238,76,75,8629.16,15605.09,0.00
2024-12-10 17:44:29,150,12238,76,74,8681.49,15605.09,0.00
2024-12-10 17:44:29,149,12238,75,74,8642.31,15605.71,0.00
2024-12-10 17:44:29,149,12239,75,74,8802.15,15606.00,0.00
2024-12-10 17:44:29,150,12239,76,74,8743.47,15606.01,0.00
2024-12-10 17:44:29,151,12238,77,74,8684.54,15606.03,0.00
2024-12-10 17:44:29,150,12238,77,73,8731.62,15606.10,0.00
2024-12-10 17:44:29,149,12238,76,73,8785.55,15606.13,0.00
2024-12-10 17:44:29,150,12237,76,74,8722.82,15606.17,0.00
2024-12-10 17:44:29,151,12236,77,74,8606.48,15606.68,0.00
2024-12-10 17:44:29,150,12236,76,74,8695.09,15606.69,0.00
2024-12-10 17:44:29,150,12237,76,74,8751.53,15607.00,0.00
2024-12-10 17:44:29,151,12237,77,74,8693.57,15607.01,0.00
2024-12-10 17:44:29,150,12237,76,74,8747.38,15607.03,0.00
2024-12-10 17:44:29,149,12237,75,74,8796.69,15607.08,0.00
2024-12-10 17:44:29,148,12237,75,73,8851.90,15607.09,0.00
2024-12-10 17:44:29,148,12238,75,73,9086.34,15608.00,0.00
2024-12-10 17:44:29,149,12238,75,74,9025.36,15608.01,0.00
2024-12-10 17:44:29,148,12238,74,74,9074.77,15608.05,0.00
2024-12-10 17:44:29,148,12239,74,74,9007.99,15609.00,0.00
2024-12-10 17:44:29,149,12239,74,75,8947.53,15609.01,0.00
2024-12-10 17:44:29,148,12239,74,74,8996.49,15609.07,0.00
2024-12-10 17:44:29,147,12239,73,74,8904.75,15609.63,0.00
2024-12-10 17:44:29,148,12238,73,75,8820.44,15609.79,0.00
2024-12-10 17:44:29,148,12239,73,75,8909.22,15610.00,0.00
2024-12-10 17:44:29,149,12239,74,75,8849.43,15610.01,0.00
2024-12-10 17:44:29,148,12239,74,74,8896.65,15610.07,0.00
2024-12-10 17:44:29,147,12239,73,74,8847.94,15610.59,0.00
2024-12-10 17:44:29,147,12240,73,74,8996.94,15611.00,0.00
2024-12-10 17:44:29,148,12240,74,74,8936.15,15611.01,0.00
2024-12-10 17:44:29,147,12240,74,73,8982.11,15611.08,0.00
2024-12-10 17:44:29,146,12240,73,73,9023.53,15611.16,0.00
2024-12-10 17:44:29,146,12241,73,73,8998.37,15612.00,0.00
2024-12-10 17:44:29,147,12241,73,74,8937.16,15612.01,0.00
2024-12-10 17:44:29,146,12241,73,73,8978.99,15612.09,0.00
2024-12-10 17:44:29,146,12242,73,73,8901.47,15613.00,0.00
2024-12-10 17:44:29,147,12242,74,73,8840.91,15613.01,0.00
2024-12-10 17:44:29,147,12243,74,73,8757.44,15614.00,0.00
2024-12-10 17:44:29,148,12243,75,73,8698.27,15614.01,0.00
2024-12-10 17:44:29,147,12243,74,73,8745.80,15614.08,0.00
2024-12-10 17:44:29,148,12242,74,74,8601.39,15614.50,0.00
2024-12-10 17:44:29,148,12243,74,74,8696.89,15615.00,0.00
2024-12-10 17:44:29,149,12243,75,74,8638.52,15615.01,0.00
2024-12-10 17:44:29,148,12243,75,73,8685.32,15615.07,0.00
2024-12-10 17:44:29,148,12244,75,73,8693.44,15616.00,0.00
2024-12-10 17:44:29,149,12244,75,74,8635.09,15616.01,0.00
2024-12-10 17:44:29,148,12244,75,73,8671.31,15616.07,0.00
2024-12-10 17:44:29,148,12245,75,73,8590.59,15617.00,0.00
2024-12-10 17:44:29,149,12245,76,73,8532.93,15617.01,0.00
2024-12-10 17:44:29,150,12244,77,73,8356.57,15617.65,0.00
2024-12-10 17:44:29,150,12245,77,73,8427.58,15618.00,0.00
2024-12-10 17:44:29,151,12245,77,74,8371.77,15618.01,0.00
2024-12-10 17:44:29,152,12244,78,74,8278.72,15618.13,0.00
2024-12-10 17:44:29,152,12245,78,74,8427.35,15619.00,0.00
2024-12-10 17:44:29,153,12245,78,75,8372.27,15619.01,0.00
2024-12-10 17:44:29,152,12245,78,74,8394.50,15619.08,0.00
2024-12-10 17:44:29,151,12245,77,74,8401.57,15619.38,0.00
2024-12-10 17:44:29,151,12246,77,74,8488.10,15620.00,0.00
2024-12-10 17:44:29,152,12246,77,75,8432.26,15620.01,0.00
2024-12-10 17:44:29,151,12246,76,75,8296.08,15620.85,0.00
2024-12-10 17:44:29,151,12247,76,75,8375.87,15621.00,0.00
2024-12-10 17:44:29,152,12247,77,75,8320.76,15621.01,0.00
2024-12-10 17:44:30,151,12247,77,74,8359.34,15621.07,0.00
2024-12-10 17:44:30,150,12247,76,74,8414.03,15621.07,0.00
2024-12-10 17:44:30,149,12247,75,74,8421.32,15621.38,0.00
2024-12-10 17:44:30,149,12248,75,74,8388.17,15622.00,0.00
2024-12-10 17:44:30,150,12248,76,74,8332.25,15622.01,0.00
2024-12-10 17:44:30,151,12247,76,75,8276.04,15622.03,0.00
2024-12-10 17:44:30,150,12247,76,74,8334.11,15622.08,0.00
2024-12-10 17:44:30,149,12247,75,74,8236.25,15622.80,0.00
2024-12-10 17:44:30,150,12246,76,74,8160.62,15622.94,0.00
2024-12-10 17:44:30,150,12247,76,74,8262.75,15623.00,0.00
2024-12-10 17:44:30,151,12247,76,75,8208.03,15623.01,0.00
2024-12-10 17:44:30,150,12247,76,74,8250.11,15623.07,0.00
2024-12-10 17:44:30,149,12247,76,73,8304.43,15623.07,0.00
2024-12-10 17:44:30,148,12247,75,73,8313.09,15623.37,0.00
2024-12-10 17:44:30,149,12246,75,74,8121.67,15623.97,0.00
2024-12-10 17:44:30,149,12247,75,74,8434.17,15624.00,0.00
2024-12-10 17:44:30,150,12247,76,74,8377.94,15624.01,0.00
2024-12-10 17:44:30,149,12247,76,73,8422.66,15624.07,0.00
2024-12-10 17:44:30,150,12246,76,74,8343.08,15624.20,0.00
2024-12-10 17:44:30,149,12246,75,74,8445.29,15624.42,0.00
2024-12-10 17:44:30,149,12247,75,74,8560.04,15625.00,0.00
2024-12-10 17:44:30,150,12247,75,75,8502.98,15625.01,0.00
2024-12-10 17:44:30,150,12248,75,75,8498.43,15626.00,0.00
2024-12-10 17:44:30,151,12248,75,76,8442.15,15626.01,0.00
2024-12-10 17:44:30,152,12247,75,77,8250.48,15626.45,0.00
2024-12-10 17:44:30,152,12248,75,77,8322.84,15627.00,0.00
2024-12-10 17:44:30,153,12248,76,77,8268.44,15627.01,0.00
2024-12-10 17:44:30,152,12248,76,76,8313.61,15627.05,0.00
2024-12-10 17:44:30,151,12248,75,76,8340.72,15627.05,0.00
2024-12-10 17:44:30,151,12249,75,76,8394.81,15628.00,0.00
2024-12-10 17:44:30,152,12249,76,76,8339.58,15628.01,0.00
2024-12-10 17:44:30,153,12248,76,77,8283.04,15628.03,0.00
2024-12-10 17:44:30,152,12248,76,76,8380.73,15628.06,0.00
2024-12-10 17:44:30,151,12248,75,76,8376.05,15628.34,0.00
2024-12-10 17:44:30,152,12247,75,77,8260.39,15628.73,0.00
2024-12-10 17:44:30,152,12248,75,77,8349.04,15629.00,0.00
2024-12-10 17:44:30,153,12248,75,78,8294.47,15629.01,0.00
2024-12-10 17:44:30,154,12247,75,79,8204.11,15629.12,0.00
2024-12-10 17:44:30,155,12246,76,79,8173.64,15629.20,0.00
2024-12-10 17:44:30,155,12247,76,79,8429.08,15630.00,0.00
2024-12-10 17:44:30,156,12247,76,80,8375.05,15630.01,0.00
2024-12-10 17:44:30,155,12247,75,80,8424.06,15630.03,0.00
2024-12-10 17:44:30,154,12247,75,79,8453.40,15630.06,0.00
2024-12-10 17:44:30,154,12248,75,79,8597.60,15631.00,0.00
2024-12-10 17:44:30,155,12248,76,79,8542.13,15631.01,0.00
2024-12-10 17:44:30,154,12248,76,78,8568.19,15631.06,0.00
2024-12-10 17:44:30,153,12248,75,78,8597.96,15631.22,0.00
2024-12-10 17:44:30,154,12247,76,78,8481.41,15631.62,0.00
2024-12-10 17:44:30,154,12248,76,78,8535.20,15632.00,0.00
2024-12-10 17:44:30,155,12248,76,79,8480.14,15632.01,0.00
2024-12-10 17:44:30,154,12248,76,78,8505.79,15632.06,0.00
2024-12-10 17:44:30,153,12248,76,77,8560.37,15632.06,0.00
2024-12-10 17:44:30,152,12248,75,77,8600.39,15632.16,0.00
2024-12-10 17:44:30,151,12248,74,77,8622.78,15632.37,0.00
2024-12-10 17:44:30,152,12247,75,77,8556.83,15632.44,0.00
2024-12-10 17:44:30,152,12247,75,77,8692.67,15633.00,0.00
2024-12-10 17:44:30,153,12247,75,78,8635.85,15633.01,0.00
2024-12-10 17:44:30,152,12247,75,77,8680.35,15633.05,0.00
2024-12-10 17:44:30,151,12247,75,76,8735.77,15633.05,0.00
2024-12-10 17:44:30,150,12247,75,75,8748.59,15633.34,0.00
2024-12-10 17:44:30,149,12247,74,75,8689.97,15633.83,0.00
2024-12-10 17:44:30,149,12248,74,75,8873.73,15634.00,0.00
2024-12-10 17:44:30,150,12248,74,76,8814.57,15634.01,0.00
2024-12-10 17:44:30,149,12248,73,76,8865.37,15634.05,0.00
2024-12-10 17:44:30,148,12248,73,75,8917.21,15634.07,0.00
2024-12-10 17:44:30,147,12248,72,75,8919.07,15634.45,0.00
2024-12-10 17:44:30,148,12247,72,76,8807.25,15634.79,0.00
2024-12-10 17:44:30,148,12248,72,76,8891.95,15635.00,0.00
2024-12-10 17:44:30,149,12248,72,77,8832.27,15635.01,0.00
2024-12-10 17:44:30,148,12248,71,77,8883.53,15635.05,0.00
2024-12-10 17:44:30,147,12248,71,76,8936.88,15635.07,0.00
2024-12-10 17:44:30,146,12248,70,76,8969.77,15635.21,0.00
2024-12-10 17:44:30,145,12248,69,76,9023.97,15635.26,0.00
2024-12-10 17:44:30,145,12249,69,76,9124.36,15636.00,0.00
2024-12-10 17:44:30,146,12249,69,77,9061.86,15636.01,0.00
2024-12-10 17:44:30,145,12249,69,76,9111.71,15636.06,0.00
2024-12-10 17:44:30,144,12249,69,75,9171.73,15636.06,0.00
2024-12-10 17:44:30,145,12248,70,75,8931.92,15636.89,0.00
2024-12-10 17:44:30,145,12249,70,75,9030.93,15637.00,0.00
2024-12-10 17:44:30,146,12249,71,75,8969.08,15637.01,0.00
2024-12-10 17:44:30,145,12249,70,75,8989.79,15637.06,0.00
2024-12-10 17:44:30,144,12249,70,74,9047.88,15637.06,0.00
2024-12-10 17:44:30,144,12250,70,74,9103.86,15638.00,0.00
2024-12-10 17:44:30,145,12250,70,75,9041.07,15638.01,0.00
2024-12-10 17:44:30,146,12249,70,76,8788.78,15638.76,0.00
2024-12-10 17:44:30,146,12249,70,76,8878.19,15639.00,0.00
2024-12-10 17:44:31,147,12249,71,76,8817.79,15639.01,0.00
2024-12-10 17:44:31,146,12249,70,76,8822.77,15639.05,0.00
2024-12-10 17:44:31,147,12248,70,77,8739.35,15639.08,0.00
2024-12-10 17:44:31,147,12249,70,77,8826.73,15640.00,0.00
2024-12-10 17:44:31,148,12249,70,78,8767.09,15640.01,0.00
2024-12-10 17:44:31,147,12249,69,78,8790.67,15640.10,0.00
2024-12-10 17:44:31,146,12249,68,78,8849.28,15640.10,0.00
2024-12-10 17:44:31,145,12249,67,78,8808.24,15640.69,0.00
2024-12-10 17:44:31,146,12248,68,78,8724.46,15640.85,0.00
2024-12-10 17:44:31,146,12249,68,78,8922.65,15641.00,0.00
2024-12-10 17:44:31,147,12249,68,79,8861.96,15641.01,0.00
2024-12-10 17:44:31,146,12249,68,78,8914.11,15641.05,0.00
2024-12-10 17:44:31,147,12248,68,79,8753.66,15641.57,0.00
2024-12-10 17:44:31,148,12247,68,80,8682.99,15641.74,0.00
2024-12-10 17:44:31,148,12248,68,80,8829.21,15642.00,0.00
2024-12-10 17:44:31,149,12248,68,81,8769.96,15642.01,0.00
2024-12-10 17:44:31,148,12248,68,80,8818.67,15642.05,0.00
2024-12-10 17:44:31,147,12248,68,79,8876.54,15642.06,0.00
2024-12-10 17:44:31,147,12249,68,79,9000.43,15643.00,0.00
2024-12-10 17:44:31,148,12249,69,79,8939.61,15643.01,0.00
2024-12-10 17:44:31,149,12248,70,79,8818.42,15643.22,0.00
2024-12-10 17:44:31,150,12247,70,80,8698.44,15643.81,0.00
2024-12-10 17:44:31,150,12248,70,80,8768.06,15644.00,0.00
2024-12-10 17:44:31,151,12248,70,81,8709.99,15644.01,0.00
2024-12-10 17:44:31,151,12249,70,81,8820.80,15645.00,0.00
2024-12-10 17:44:31,152,12249,70,82,8762.76,15645.01,0.00
2024-12-10 17:44:31,151,12249,69,82,8727.96,15645.32,0.00
2024-12-10 17:44:31,152,12248,69,83,8622.33,15645.64,0.00
2024-12-10 17:44:31,152,12249,69,83,8680.38,15646.00,0.00
2024-12-10 17:44:31,153,12249,69,84,8623.65,15646.01,0.00
2024-12-10 17:44:31,152,12249,68,84,8657.78,15646.01,0.00
2024-12-10 17:44:31,151,12249,67,84,8684.06,15646.07,0.00
2024-12-10 17:44:31,152,12248,68,84,8574.55,15646.41,0.00
2024-12-10 17:44:31,153,12247,69,84,8519.65,15646.65,0.00
2024-12-10 17:44:31,152,12247,69,83,8547.01,15646.81,0.00
2024-12-10 17:44:31,152,12248,69,83,8721.33,15647.00,0.00
2024-12-10 17:44:31,153,12248,70,83,8664.32,15647.01,0.00
2024-12-10 17:44:31,152,12248,69,83,8718.25,15647.02,0.00
2024-12-10 17:44:31,151,12248,69,82,8759.41,15647.04,0.00
2024-12-10 17:44:31,150,12248,68,82,8814.69,15647.05,0.00
2024-12-10 17:44:31,149,12248,68,81,8872.80,15647.05,0.00
2024-12-10 17:44:31,149,12249,68,81,8989.74,15648.00,0.00
2024-12-10 17:44:31,150,12249,69,81,8929.81,15648.01,0.00
2024-12-10 17:44:31,149,12249,69,80,8960.36,15648.05,0.00
2024-12-10 17:44:31,149,12250,69,80,8894.27,15649.00,0.00
2024-12-10 17:44:31,150,12250,70,80,8834.97,15649.01,0.00
2024-12-10 17:44:31,151,12249,71,80,8676.85,15649.52,0.00
2024-12-10 17:44:31,151,12250,71,80,8730.58,15650.00,0.00
2024-12-10 17:44:31,152,12250,72,80,8673.15,15650.01,0.00
2024-12-10 17:44:31,151,12250,72,79,8701.58,15650.05,0.00
2024-12-10 17:44:31,150,12250,72,78,8757.51,15650.06,0.00
2024-12-10 17:44:31,151,12249,72,79,8614.40,15650.60,0.00
2024-12-10 17:44:31,151,12250,72,79,8786.87,15651.00,0.00
2024-12-10 17:44:31,152,12250,72,80,8729.06,15651.01,0.00
2024-12-10 17:44:31,151,12250,72,79,8762.01,15651.04,0.00
2024-12-10 17:44:31,150,12250,72,78,8817.29,15651.05,0.00
2024-12-10 17:44:31,151,12249,72,79,8646.80,15651.77,0.00
2024-12-10 17:44:31,151,12250,72,79,8783.43,15652.00,0.00
2024-12-10 17:44:31,152,12250,73,79,8725.64,15652.01,0.00
2024-12-10 17:44:31,151,12250,73,78,8754.43,15652.05,0.00
2024-12-10 17:44:31,151,12251,73,78,8763.98,15653.00,0.00
2024-12-10 17:44:31,152,12251,73,79,8706.32,15653.01,0.00
2024-12-10 17:44:31,151,12251,73,78,8741.19,15653.05,0.00
2024-12-10 17:44:31,150,12251,72,78,8798.42,15653.05,0.00
2024-12-10 17:44:31,149,12251,71,78,8837.54,15653.17,0.00
2024-12-10 17:44:31,148,12251,70,78,8872.51,15653.18,0.00
2024-12-10 17:44:31,147,12251,70,77,8838.18,15653.75,0.00
2024-12-10 17:44:31,147,12252,70,77,8906.54,15654.00,0.00
2024-12-10 17:44:31,148,12252,70,78,8846.36,15654.01,0.00
2024-12-10 17:44:31,147,12252,70,77,8898.04,15654.05,0.00
2024-12-10 17:44:31,148,12251,70,78,8708.78,15654.59,0.00
2024-12-10 17:44:31,149,12250,71,78,8657.72,15654.64,0.00
2024-12-10 17:44:31,150,12249,71,79,8596.01,15654.88,0.00
2024-12-10 17:44:31,150,12250,71,79,8704.45,15655.00,0.00
2024-12-10 17:44:31,151,12250,71,80,8646.80,15655.01,0.00
2024-12-10 17:44:31,150,12250,71,79,8696.11,15655.05,0.00
2024-12-10 17:44:31,151,12249,72,79,8630.23,15655.11,0.00
2024-12-10 17:44:31,150,12249,71,79,8613.04,15655.52,0.00
2024-12-10 17:44:31,150,12250,71,79,8955.74,15656.00,0.00
2024-12-10 17:44:31,151,12250,71,80,8896.43,15656.01,0.00
2024-12-10 17:44:31,150,12250,71,79,8905.66,15656.05,0.00
2024-12-10 17:44:31,151,12249,72,79,8819.77,15656.23,0.00
2024-12-10 17:44:31,151,12250,72,79,8941.00,15657.00,0.00
2024-12-10 17:44:31,152,12250,73,79,8882.17,15657.01,0.00
2024-12-10 17:44:31,151,12250,73,78,8922.35,15657.05,0.00
2024-12-10 17:44:31,150,12250,72,78,8932.56,15657.32,0.00
2024-12-10 17:44:31,149,12250,71,78,8991.47,15657.33,0.00
2024-12-10 17:44:31,150,12249,71,79,8846.29,15657.89,0.00
2024-12-10 17:44:31,150,12250,71,79,9005.06,15658.00,0.00
2024-12-10 17:44:31,151,12250,72,79,8945.42,15658.01,0.00
2024-12-10 17:44:31,150,12250,72,78,8995.67,15658.05,0.00
2024-12-10 17:44:31,149,12250,71,78,9022.73,15658.24,0.00
2024-12-10 17:44:31,149,12251,71,78,9071.57,15659.00,0.00
2024-12-10 17:44:31,150,12251,71,79,9011.09,15659.01,0.00
2024-12-10 17:44:31,151,12250,71,80,8949.35,15659.03,0.00
2024-12-10 17:44:31,150,12250,71,79,9100.89,15659.05,0.00
2024-12-10 17:44:31,149,12250,70,79,9009.93,15659.75,0.00
2024-12-10 17:44:32,149,12251,70,79,9076.36,15660.00,0.00
2024-12-10 17:44:32,150,12251,71,79,9015.85,15660.01,0.00
2024-12-10 17:44:32,149,12251,71,78,9062.71,15660.05,0.00
2024-12-10 17:44:32,150,12250,71,79,8980.41,15660.21,0.00
2024-12-10 17:44:32,149,12250,70,79,8958.34,15660.58,0.00
2024-12-10 17:44:32,149,12251,70,79,9103.72,15661.00,0.00
2024-12-10 17:44:32,150,12251,70,80,9043.03,15661.01,0.00
2024-12-10 17:44:32,149,12251,70,79,9090.07,15661.05,0.00
2024-12-10 17:44:32,148,12251,69,79,9025.53,15661.84,0.00
2024-12-10 17:44:32,148,12252,69,79,9170.64,15662.00,0.00
2024-12-10 17:44:32,149,12252,69,80,9109.09,15662.01,0.00
2024-12-10 17:44:32,148,12252,69,79,9151.61,15662.05,0.00
2024-12-10 17:44:32,147,12252,68,79,9166.03,15662.35,0.00
2024-12-10 17:44:32,147,12253,68,79,9125.63,15663.00,0.00
2024-12-10 17:44:32,148,12253,69,79,9063.97,15663.01,0.00
2024-12-10 17:44:32,147,12253,69,78,9110.74,15663.06,0.00
2024-12-10 17:44:32,147,12254,69,78,9025.96,15664.00,0.00
2024-12-10 17:44:32,148,12254,70,78,8964.98,15664.01,0.00
2024-12-10 17:44:32,147,12254,69,78,9018.52,15664.05,0.00
2024-12-10 17:44:32,146,12254,69,77,9072.79,15664.05,0.00
2024-12-10 17:44:32,146,12255,69,77,8989.26,15665.00,0.00
2024-12-10 17:44:32,147,12255,69,78,8928.11,15665.01,0.00
2024-12-10 17:44:32,146,12255,69,77,8975.34,15665.05,0.00
2024-12-10 17:44:32,145,12255,68,77,8877.86,15665.97,0.00
2024-12-10 17:44:32,145,12256,68,77,8980.53,15666.00,0.00
2024-12-10 17:44:32,146,12256,69,77,8919.02,15666.01,0.00
2024-12-10 17:44:32,145,12256,69,76,8966.50,15666.05,0.00
2024-12-10 17:44:32,144,12256,68,76,8978.77,15666.19,0.00
2024-12-10 17:44:32,143,12256,67,76,9016.42,15666.36,0.00
2024-12-10 17:44:32,143,12257,67,76,9025.63,15667.00,0.00
2024-12-10 17:44:32,144,12257,67,77,8962.96,15667.01,0.00
2024-12-10 17:44:32,144,12258,67,77,8875.22,15668.00,0.00
2024-12-10 17:44:32,145,12258,68,77,8814.01,15668.01,0.00
2024-12-10 17:44:32,145,12259,68,77,8709.08,15669.00,0.00
2024-12-10 17:44:32,146,12259,68,78,8649.42,15669.01,0.00
2024-12-10 17:44:32,147,12258,69,78,8583.15,15669.07,0.00
2024-12-10 17:44:32,147,12259,69,78,8585.80,15670.00,0.00
2024-12-10 17:44:32,148,12259,70,78,8527.79,15670.01,0.00
2024-12-10 17:44:32,148,12260,70,78,8555.11,15671.00,0.00
2024-12-10 17:44:32,149,12260,71,78,8497.70,15671.01,0.00
2024-12-10 17:44:32,150,12259,71,79,8409.73,15671.09,0.00
2024-12-10 17:44:32,151,12258,71,80,8329.47,15671.79,0.00
2024-12-10 17:44:33,151,12259,71,80,8411.65,15672.00,0.00
2024-12-10 17:44:33,152,12259,72,80,8356.31,15672.01,0.00
2024-12-10 17:44:33,151,12259,72,79,8380.54,15672.07,0.00
